time,subj_course_id,sec_code,sec_id,prof,available,waitlist,total,enrolled_ct
1658057196004,COGS 9,A01,083615,Shannon; Kyle Michael,11,0,75,64
1658057202038,COGS 11,A01,083617,Boyle; Mary E. T.,23,0,48,25
1658057208073,COGS 13,A01,083071,Bastos; Amalia Pinkusfeld,12,0,71,59
1658057214108,COGS 14A,A01,092681,Semenuks; Arturs,5,1,100,95
1658057220150,COGS 14B,A01,083073,Cheng; Tzu-Han,7,0,63,56
1658057226183,COGS 17,A01,092677,Semenuks; Arturs,7,0,81,74
1658057232217,COGS 100,A01,083619,Allen; Michael Gordon,17,0,70,53
1658057238251,COGS 101A,A01,083621,Davis; Joshua Daniel,9,0,68,59
1658057244283,COGS 101B,A01,091572,Allen; Michael Gordon,14,0,65,51
1658057250319,COGS 101C,A01,083625,Delgado; Tania,17,0,35,18
1658057256354,COGS 107A,A01,083627,Boyle; Mary E. T.,14,0,60,46
1658057262387,COGS 118A,A01,083075,Gupta; Anjum,21,0,76,55
1658057268426,CSE 3,A50,083646,Miranda; Gregory Joseph,24,0,50,26
1658057274455,CSE 8A,A50,083650,Miranda; Gregory Joseph,17,1,56,39
1658057280486,CSE 11,A01,083080,Cao; Yingjun,7,15,40,33
1658057286544,CSE 12,A01,083652,Krause-Levy; Sophia Louisa,30,1,120,90
1658057292575,CSE 15L,A01,083654,Morris; Justin Loren,9,0,50,41
1658057292575,CSE 15L,A02,083655,Morris; Justin Loren,11,0,50,39
1658057298602,CSE 20,A01,083657,Tran; Khoa Dang,39,0,80,41
1658057304638,CSE 21,A01,095574,Bach; Quang Tran,23,0,48,25
1658057310674,CSE 30,A01,083084,Eldon; John,8,0,80,72
1658057310674,CSE 30,B01,095061,Bhaskar; Nishant,9,0,50,41
1658057316706,CSE 100,A01,083659,Cao; Yingjun,5,4,70,65
1658057322739,CSE 134B,A01,083661,Powell; Thomas Allan,25,0,100,75
1658057328771,CSE 140,A01,083663,Gungor; Onat,17,0,85,68
1658057334806,CSE 140L,A01,083088,Eldon; John,23,0,100,77
1658057340836,CSE 175,A01,083665,Kumar; Rakesh,3,0,25,22
1658057346876,CSE 190,A00,092507,Dubnov; Shlomo,8,0,20,12
1658057352910,ECE 45,A01,083139,Congero; Spencer William,7,0,75,68
1658057358952,ECE 65,A50,083695,Saad; Andrew S,12,0,30,18
1658057358952,ECE 65,A51,095125,Saad; Andrew S,24,0,26,2
1658057364984,ECE 109,A01,091882,Touri; Behrouz,21,0,70,49
1658057371020,ECE 180,A00,083140,Abi Samra; Nicholas Camill,1,0,30,29
1658057371020,ECE 180,B00,083141,Abi Samra; Nicholas Camill,0,0,30,30
1658057377066,MATH 10A,A01,083735,Patchell; Gregory David,2,0,30,28
1658057377066,MATH 10A,A02,083736,Patchell; Gregory David,20,0,30,10
1658057377066,MATH 10A,A03,083737,Patchell; Gregory David,16,0,30,14
1658057383124,MATH 10B,A01,083207,Lim; Seonhee,9,0,34,25
1658057383124,MATH 10B,A02,083208,Lim; Seonhee,10,0,35,25
1658057383124,MATH 10B,A03,093472,Lim; Seonhee,7,0,34,27
1658057383124,MATH 10B,B01,083739,Sinha; Shubham,14,0,30,16
1658057389163,MATH 18,A01,083743,Cinel; Cameron Alexander,9,0,30,21
1658057389163,MATH 18,A02,083744,Cinel; Cameron Alexander,18,0,30,12
1658057389163,MATH 18,A03,083745,Cinel; Cameron Alexander,10,0,30,20
1658057389163,MATH 18,B01,083748,Rideout; David Porter,5,0,37,32
1658057389163,MATH 18,B02,083749,Rideout; David Porter,5,0,36,31
1658057389163,MATH 18,B03,083750,Rideout; David Porter,3,0,37,34
1658057389163,MATH 18,B04,083751,Rideout; David Porter,7,0,36,29
1658057389163,MATH 18,B05,093473,Rideout; David Porter,7,0,36,29
1658057389163,MATH 18,B06,093474,Rideout; David Porter,6,0,36,30
1658057395198,MATH 20A,A01,083754,Zheng; Zequn,14,0,40,26
1658057401234,MATH 20B,A01,083756,Briones; Jor-el Thomas Caparas,4,0,36,32
1658057401234,MATH 20B,A02,083757,Briones; Jor-el Thomas Caparas,1,0,36,35
1658057401234,MATH 20B,A03,093475,Briones; Jor-el Thomas Caparas,3,0,36,33
1658057407261,MATH 20C,A01,083760,Briones; Jor-el Thomas Caparas,1,0,35,34
1658057407261,MATH 20C,A02,083761,Briones; Jor-el Thomas Caparas,8,0,35,27
1658057407261,MATH 20C,A03,093476,Briones; Jor-el Thomas Caparas,0,1,36,36
1658057407261,MATH 20C,B01,083762,Bach; Quang Tran,1,0,30,29
1658057413297,MATH 20D,A01,083765,Tran; Brian Kha,5,0,30,25
1658057413297,MATH 20D,A02,083766,Tran; Brian Kha,5,0,30,25
1658057413297,MATH 20D,A03,083767,Tran; Brian Kha,6,0,30,24
1658057419331,MATH 20E,A01,083771,Ganguly; Soumya,12,0,32,20
1658057419331,MATH 20E,A02,083772,Ganguly; Soumya,7,0,32,25
1658057419331,MATH 20E,B01,083773,Ciotti; Benjamin,20,0,35,15
1658057419331,MATH 20E,B02,083774,Ciotti; Benjamin,18,0,35,17
1658057425364,MATH 103A,A01,083777,Greenfeld; Be'Eri,6,0,36,30
1658057425364,MATH 103A,A02,083778,Greenfeld; Be'Eri,5,0,36,31
1658057425364,MATH 103A,A03,093561,Greenfeld; Be'Eri,7,0,36,29
1658057425364,MATH 103A,B01,083779,Greenfeld; Be'Eri,8,0,36,28
1658057425364,MATH 103A,B02,083780,Greenfeld; Be'Eri,4,0,36,32
1658057425364,MATH 103A,B03,093562,Greenfeld; Be'Eri,3,0,36,33
1658057431395,MATH 105,A01,085443,Carter; Anne Toulson,15,0,35,20
1658057431395,MATH 105,A02,093477,Carter; Anne Toulson,20,0,35,15
1658057437432,MATH 109,A01,083213,Ganzberger; Geoffrey Michael,3,0,34,31
1658057437432,MATH 109,A02,083214,Ganzberger; Geoffrey Michael,4,0,34,30
1658057437432,MATH 109,A03,093478,Ganzberger; Geoffrey Michael,2,0,34,32
1658057437432,MATH 109,B01,083215,Ganzberger; Geoffrey Michael,3,0,32,29
1658057437432,MATH 109,B02,083216,Ganzberger; Geoffrey Michael,3,0,32,29
1658057437432,MATH 109,B03,093479,Ganzberger; Geoffrey Michael,8,0,32,24
1658057443472,MATH 142A,A01,083219,Chow; Bennett,7,0,32,25
1658057443472,MATH 142A,A02,083220,Chow; Bennett,10,0,32,22
1658057443472,MATH 142A,A03,093480,Chow; Bennett,9,0,32,23
1658057443472,MATH 142A,B03,093481,Chow; Bennett,8,0,32,24
1658057443472,MATH 142A,B04,093558,Chow; Bennett,14,0,32,18
1658057443472,MATH 142A,B05,093559,Chow; Bennett,7,0,32,25
1658057449505,MATH 193A,A01,083224,Rotar; Vladimir,9,0,34,25
1658057449505,MATH 193A,A02,083225,Rotar; Vladimir,11,0,34,23
1658057449505,MATH 193A,A03,083781,Rotar; Vladimir,5,0,34,29
1658057449505,MATH 193A,A04,083782,Rotar; Vladimir,12,0,34,22
1658057449505,MATH 193A,A05,093482,Rotar; Vladimir,11,0,34,23
1658057455538,MATH 197,001,091859,McAuley; Julian John,9999,0,9999,0
1658057455538,MATH 197,002,095566,Kedlaya; Kiran S.,9997,0,9999,2
1658057455538,MATH 197,003,095567,Xiao; Ming,9999,0,9999,0
1658057455538,MATH 197,004,095571,Perols; Johan Lars,9998,0,9999,1
1658057462637,COGS 9,A01,083615,Shannon; Kyle Michael,11,0,75,64
1658057468669,COGS 11,A01,083617,Boyle; Mary E. T.,23,0,48,25
1658057474702,COGS 13,A01,083071,Bastos; Amalia Pinkusfeld,12,0,71,59
1658057480730,COGS 14A,A01,092681,Semenuks; Arturs,5,1,100,95
1658057486761,COGS 14B,A01,083073,Cheng; Tzu-Han,7,0,63,56
1658057498597,COGS 17,A01,092677,Semenuks; Arturs,7,0,81,74
1658057504634,COGS 100,A01,083619,Allen; Michael Gordon,17,0,70,53
1658057518893,COGS 101A,A01,083621,Davis; Joshua Daniel,9,0,68,59
1658057524924,COGS 101B,A01,091572,Allen; Michael Gordon,14,0,65,51
1658057530973,COGS 101C,A01,083625,Delgado; Tania,17,0,35,18
1658057537009,COGS 107A,A01,083627,Boyle; Mary E. T.,14,0,60,46
1658057543044,COGS 118A,A01,083075,Gupta; Anjum,21,0,76,55
1658057549084,CSE 3,A50,083646,Miranda; Gregory Joseph,24,0,50,26
1658057555117,CSE 8A,A50,083650,Miranda; Gregory Joseph,17,1,56,39
1658057561154,CSE 11,A01,083080,Cao; Yingjun,7,15,40,33
1658057567189,CSE 12,A01,083652,Krause-Levy; Sophia Louisa,30,1,120,90
1658057573222,CSE 15L,A01,083654,Morris; Justin Loren,9,0,50,41
1658057573222,CSE 15L,A02,083655,Morris; Justin Loren,11,0,50,39
1658057579257,CSE 20,A01,083657,Tran; Khoa Dang,39,0,80,41
1658057585292,CSE 21,A01,095574,Bach; Quang Tran,23,0,48,25
1658057591324,CSE 30,A01,083084,Eldon; John,8,0,80,72
1658057591324,CSE 30,B01,095061,Bhaskar; Nishant,9,0,50,41
1658057597362,CSE 100,A01,083659,Cao; Yingjun,5,4,70,65
1658057603393,CSE 134B,A01,083661,Powell; Thomas Allan,25,0,100,75
1658057609428,CSE 140,A01,083663,Gungor; Onat,17,0,85,68
1658057615455,CSE 140L,A01,083088,Eldon; John,23,0,100,77
1658057621489,CSE 175,A01,083665,Kumar; Rakesh,3,0,25,22
1658057627525,CSE 190,A00,092507,Dubnov; Shlomo,8,0,20,12
1658057633564,ECE 45,A01,083139,Congero; Spencer William,7,0,75,68
1658057639597,ECE 65,A50,083695,Saad; Andrew S,12,0,30,18
1658057639597,ECE 65,A51,095125,Saad; Andrew S,24,0,26,2
1658057645635,ECE 109,A01,091882,Touri; Behrouz,21,0,70,49
1658057651670,ECE 180,A00,083140,Abi Samra; Nicholas Camill,1,0,30,29
1658057651670,ECE 180,B00,083141,Abi Samra; Nicholas Camill,0,0,30,30
1658057657702,MATH 10A,A01,083735,Patchell; Gregory David,2,0,30,28
1658057657702,MATH 10A,A02,083736,Patchell; Gregory David,20,0,30,10
1658057657702,MATH 10A,A03,083737,Patchell; Gregory David,16,0,30,14
1658057663736,MATH 10B,A01,083207,Lim; Seonhee,9,0,34,25
1658057663736,MATH 10B,A02,083208,Lim; Seonhee,10,0,35,25
1658057663736,MATH 10B,A03,093472,Lim; Seonhee,7,0,34,27
1658057663736,MATH 10B,B01,083739,Sinha; Shubham,14,0,30,16
1658057669773,MATH 18,A01,083743,Cinel; Cameron Alexander,9,0,30,21
1658057669773,MATH 18,A02,083744,Cinel; Cameron Alexander,18,0,30,12
1658057669773,MATH 18,A03,083745,Cinel; Cameron Alexander,10,0,30,20
1658057669773,MATH 18,B01,083748,Rideout; David Porter,5,0,37,32
1658057669773,MATH 18,B02,083749,Rideout; David Porter,5,0,36,31
1658057669773,MATH 18,B03,083750,Rideout; David Porter,3,0,37,34
1658057669773,MATH 18,B04,083751,Rideout; David Porter,7,0,36,29
1658057669773,MATH 18,B05,093473,Rideout; David Porter,7,0,36,29
1658057669773,MATH 18,B06,093474,Rideout; David Porter,6,0,36,30
1658057675804,MATH 20A,A01,083754,Zheng; Zequn,14,0,40,26
1658057681845,MATH 20B,A01,083756,Briones; Jor-el Thomas Caparas,4,0,36,32
1658057681845,MATH 20B,A02,083757,Briones; Jor-el Thomas Caparas,1,0,36,35
1658057681845,MATH 20B,A03,093475,Briones; Jor-el Thomas Caparas,3,0,36,33
1658057687880,MATH 20C,A01,083760,Briones; Jor-el Thomas Caparas,1,0,35,34
1658057687880,MATH 20C,A02,083761,Briones; Jor-el Thomas Caparas,8,0,35,27
1658057687880,MATH 20C,A03,093476,Briones; Jor-el Thomas Caparas,0,1,36,36
1658057687880,MATH 20C,B01,083762,Bach; Quang Tran,1,0,30,29
1658057693913,MATH 20D,A01,083765,Tran; Brian Kha,5,0,30,25
1658057693913,MATH 20D,A02,083766,Tran; Brian Kha,5,0,30,25
1658057693913,MATH 20D,A03,083767,Tran; Brian Kha,6,0,30,24
1658057699958,MATH 20E,A01,083771,Ganguly; Soumya,12,0,32,20
1658057699958,MATH 20E,A02,083772,Ganguly; Soumya,7,0,32,25
1658057699958,MATH 20E,B01,083773,Ciotti; Benjamin,20,0,35,15
1658057699958,MATH 20E,B02,083774,Ciotti; Benjamin,18,0,35,17
1658057705991,MATH 103A,A01,083777,Greenfeld; Be'Eri,6,0,36,30
1658057705991,MATH 103A,A02,083778,Greenfeld; Be'Eri,5,0,36,31
1658057705991,MATH 103A,A03,093561,Greenfeld; Be'Eri,7,0,36,29
1658057705991,MATH 103A,B01,083779,Greenfeld; Be'Eri,8,0,36,28
1658057705991,MATH 103A,B02,083780,Greenfeld; Be'Eri,4,0,36,32
1658057705991,MATH 103A,B03,093562,Greenfeld; Be'Eri,3,0,36,33
1658057712024,MATH 105,A01,085443,Carter; Anne Toulson,15,0,35,20
1658057712024,MATH 105,A02,093477,Carter; Anne Toulson,20,0,35,15
1658057718064,MATH 109,A01,083213,Ganzberger; Geoffrey Michael,3,0,34,31
1658057718064,MATH 109,A02,083214,Ganzberger; Geoffrey Michael,4,0,34,30
1658057718064,MATH 109,A03,093478,Ganzberger; Geoffrey Michael,2,0,34,32
1658057718064,MATH 109,B01,083215,Ganzberger; Geoffrey Michael,3,0,32,29
1658057718064,MATH 109,B02,083216,Ganzberger; Geoffrey Michael,3,0,32,29
1658057718064,MATH 109,B03,093479,Ganzberger; Geoffrey Michael,8,0,32,24
1658057724100,MATH 142A,A01,083219,Chow; Bennett,7,0,32,25
1658057724100,MATH 142A,A02,083220,Chow; Bennett,10,0,32,22
1658057724100,MATH 142A,A03,093480,Chow; Bennett,9,0,32,23
1658057724100,MATH 142A,B03,093481,Chow; Bennett,8,0,32,24
1658057724100,MATH 142A,B04,093558,Chow; Bennett,14,0,32,18
1658057724100,MATH 142A,B05,093559,Chow; Bennett,7,0,32,25
1658057730133,MATH 193A,A01,083224,Rotar; Vladimir,9,0,34,25
1658057730133,MATH 193A,A02,083225,Rotar; Vladimir,11,0,34,23
1658057730133,MATH 193A,A03,083781,Rotar; Vladimir,5,0,34,29
1658057730133,MATH 193A,A04,083782,Rotar; Vladimir,12,0,34,22
1658057730133,MATH 193A,A05,093482,Rotar; Vladimir,11,0,34,23
1658057736166,MATH 197,001,091859,McAuley; Julian John,9999,0,9999,0
1658057736166,MATH 197,002,095566,Kedlaya; Kiran S.,9997,0,9999,2
1658057736166,MATH 197,003,095567,Xiao; Ming,9999,0,9999,0
1658057736166,MATH 197,004,095571,Perols; Johan Lars,9998,0,9999,1
1658057743244,COGS 9,A01,083615,Shannon; Kyle Michael,11,0,75,64
1658057749276,COGS 11,A01,083617,Boyle; Mary E. T.,23,0,48,25
1658057755318,COGS 13,A01,083071,Bastos; Amalia Pinkusfeld,12,0,71,59
1658057761348,COGS 14A,A01,092681,Semenuks; Arturs,5,1,100,95
1658057767385,COGS 14B,A01,083073,Cheng; Tzu-Han,7,0,63,56
1658057773417,COGS 17,A01,092677,Semenuks; Arturs,7,0,81,74
1658057779447,COGS 100,A01,083619,Allen; Michael Gordon,17,0,70,53
1658057785584,COGS 101A,A01,083621,Davis; Joshua Daniel,9,0,68,59
1658057791620,COGS 101B,A01,091572,Allen; Michael Gordon,14,0,65,51
1658057797651,COGS 101C,A01,083625,Delgado; Tania,17,0,35,18
1658057803692,COGS 107A,A01,083627,Boyle; Mary E. T.,14,0,60,46
1658057809719,COGS 118A,A01,083075,Gupta; Anjum,21,0,76,55
1658057815749,CSE 3,A50,083646,Miranda; Gregory Joseph,24,0,50,26
1658057821786,CSE 8A,A50,083650,Miranda; Gregory Joseph,17,1,56,39
1658057827816,CSE 11,A01,083080,Cao; Yingjun,7,15,40,33
1658057833850,CSE 12,A01,083652,Krause-Levy; Sophia Louisa,30,1,120,90
1658057839881,CSE 15L,A01,083654,Morris; Justin Loren,9,0,50,41
1658057839881,CSE 15L,A02,083655,Morris; Justin Loren,11,0,50,39
1658057845912,CSE 20,A01,083657,Tran; Khoa Dang,39,0,80,41
1658057851947,CSE 21,A01,095574,Bach; Quang Tran,23,0,48,25
1658057857979,CSE 30,A01,083084,Eldon; John,8,0,80,72
1658057857979,CSE 30,B01,095061,Bhaskar; Nishant,9,0,50,41
1658057864007,CSE 100,A01,083659,Cao; Yingjun,5,4,70,65
1658057870036,CSE 134B,A01,083661,Powell; Thomas Allan,25,0,100,75
1658057876066,CSE 140,A01,083663,Gungor; Onat,17,0,85,68
1658057882099,CSE 140L,A01,083088,Eldon; John,23,0,100,77
1658057888130,CSE 175,A01,083665,Kumar; Rakesh,3,0,25,22
1658057894160,CSE 190,A00,092507,Dubnov; Shlomo,8,0,20,12
1658057900189,ECE 45,A01,083139,Congero; Spencer William,7,0,75,68
1658057906228,ECE 65,A50,083695,Saad; Andrew S,12,0,30,18
1658057906228,ECE 65,A51,095125,Saad; Andrew S,24,0,26,2
1658057912259,ECE 109,A01,091882,Touri; Behrouz,21,0,70,49
1658057918294,ECE 180,A00,083140,Abi Samra; Nicholas Camill,1,0,30,29
1658057918294,ECE 180,B00,083141,Abi Samra; Nicholas Camill,0,0,30,30
1658057924324,MATH 10A,A01,083735,Patchell; Gregory David,2,0,30,28
1658057924324,MATH 10A,A02,083736,Patchell; Gregory David,20,0,30,10
1658057924324,MATH 10A,A03,083737,Patchell; Gregory David,16,0,30,14
1658057930364,MATH 10B,A01,083207,Lim; Seonhee,9,0,34,25
1658057930364,MATH 10B,A02,083208,Lim; Seonhee,10,0,35,25
1658057930364,MATH 10B,A03,093472,Lim; Seonhee,7,0,34,27
1658057930364,MATH 10B,B01,083739,Sinha; Shubham,14,0,30,16
1658057936399,MATH 18,A01,083743,Cinel; Cameron Alexander,9,0,30,21
1658057936399,MATH 18,A02,083744,Cinel; Cameron Alexander,18,0,30,12
1658057936399,MATH 18,A03,083745,Cinel; Cameron Alexander,10,0,30,20
1658057936399,MATH 18,B01,083748,Rideout; David Porter,5,0,37,32
1658057936399,MATH 18,B02,083749,Rideout; David Porter,5,0,36,31
1658057936399,MATH 18,B03,083750,Rideout; David Porter,3,0,37,34
1658057936399,MATH 18,B04,083751,Rideout; David Porter,7,0,36,29
1658057936399,MATH 18,B05,093473,Rideout; David Porter,7,0,36,29
1658057936399,MATH 18,B06,093474,Rideout; David Porter,6,0,36,30
1658057942430,MATH 20A,A01,083754,Zheng; Zequn,14,0,40,26
1658057948467,MATH 20B,A01,083756,Briones; Jor-el Thomas Caparas,4,0,36,32
1658057948467,MATH 20B,A02,083757,Briones; Jor-el Thomas Caparas,1,0,36,35
1658057948467,MATH 20B,A03,093475,Briones; Jor-el Thomas Caparas,3,0,36,33
1658057954498,MATH 20C,A01,083760,Briones; Jor-el Thomas Caparas,1,0,35,34
1658057954498,MATH 20C,A02,083761,Briones; Jor-el Thomas Caparas,8,0,35,27
1658057954498,MATH 20C,A03,093476,Briones; Jor-el Thomas Caparas,0,1,36,36
1658057954498,MATH 20C,B01,083762,Bach; Quang Tran,1,0,30,29
1658057960529,MATH 20D,A01,083765,Tran; Brian Kha,5,0,30,25
1658057960529,MATH 20D,A02,083766,Tran; Brian Kha,5,0,30,25
1658057960529,MATH 20D,A03,083767,Tran; Brian Kha,6,0,30,24
1658057966572,MATH 20E,A01,083771,Ganguly; Soumya,12,0,32,20
1658057966572,MATH 20E,A02,083772,Ganguly; Soumya,7,0,32,25
1658057966572,MATH 20E,B01,083773,Ciotti; Benjamin,20,0,35,15
1658057966572,MATH 20E,B02,083774,Ciotti; Benjamin,18,0,35,17
1658057972615,MATH 103A,A01,083777,Greenfeld; Be'Eri,6,0,36,30
1658057972615,MATH 103A,A02,083778,Greenfeld; Be'Eri,5,0,36,31
1658057972615,MATH 103A,A03,093561,Greenfeld; Be'Eri,7,0,36,29
1658057972615,MATH 103A,B01,083779,Greenfeld; Be'Eri,8,0,36,28
1658057972615,MATH 103A,B02,083780,Greenfeld; Be'Eri,4,0,36,32
1658057972615,MATH 103A,B03,093562,Greenfeld; Be'Eri,3,0,36,33
1658057978646,MATH 105,A01,085443,Carter; Anne Toulson,15,0,35,20
1658057978646,MATH 105,A02,093477,Carter; Anne Toulson,20,0,35,15
1658057984696,MATH 109,A01,083213,Ganzberger; Geoffrey Michael,3,0,34,31
1658057984696,MATH 109,A02,083214,Ganzberger; Geoffrey Michael,4,0,34,30
1658057984696,MATH 109,A03,093478,Ganzberger; Geoffrey Michael,2,0,34,32
1658057984696,MATH 109,B01,083215,Ganzberger; Geoffrey Michael,3,0,32,29
1658057984696,MATH 109,B02,083216,Ganzberger; Geoffrey Michael,3,0,32,29
1658057984696,MATH 109,B03,093479,Ganzberger; Geoffrey Michael,8,0,32,24
1658057990727,MATH 142A,A01,083219,Chow; Bennett,7,0,32,25
1658057990727,MATH 142A,A02,083220,Chow; Bennett,10,0,32,22
1658057990727,MATH 142A,A03,093480,Chow; Bennett,9,0,32,23
1658057990727,MATH 142A,B03,093481,Chow; Bennett,8,0,32,24
1658057990727,MATH 142A,B04,093558,Chow; Bennett,14,0,32,18
1658057990727,MATH 142A,B05,093559,Chow; Bennett,7,0,32,25
1658057996760,MATH 193A,A01,083224,Rotar; Vladimir,9,0,34,25
1658057996760,MATH 193A,A02,083225,Rotar; Vladimir,11,0,34,23
1658057996760,MATH 193A,A03,083781,Rotar; Vladimir,5,0,34,29
1658057996760,MATH 193A,A04,083782,Rotar; Vladimir,12,0,34,22
1658057996760,MATH 193A,A05,093482,Rotar; Vladimir,11,0,34,23
1658058002793,MATH 197,001,091859,McAuley; Julian John,9999,0,9999,0
1658058002793,MATH 197,002,095566,Kedlaya; Kiran S.,9997,0,9999,2
1658058002793,MATH 197,003,095567,Xiao; Ming,9999,0,9999,0
1658058002793,MATH 197,004,095571,Perols; Johan Lars,9998,0,9999,1
1658058009888,COGS 9,A01,083615,Shannon; Kyle Michael,11,0,75,64
1658058015918,COGS 11,A01,083617,Boyle; Mary E. T.,23,0,48,25
1658058021949,COGS 13,A01,083071,Bastos; Amalia Pinkusfeld,12,0,71,59
1658058027979,COGS 14A,A01,092681,Semenuks; Arturs,5,1,100,95
1658058034010,COGS 14B,A01,083073,Cheng; Tzu-Han,7,0,63,56
1658058040038,COGS 17,A01,092677,Semenuks; Arturs,7,0,81,74
1658058046069,COGS 100,A01,083619,Allen; Michael Gordon,17,0,70,53
1658058052098,COGS 101A,A01,083621,Davis; Joshua Daniel,9,0,68,59
1658058058134,COGS 101B,A01,091572,Allen; Michael Gordon,14,0,65,51
1658058064166,COGS 101C,A01,083625,Delgado; Tania,17,0,35,18
1658058070202,COGS 107A,A01,083627,Boyle; Mary E. T.,14,0,60,46
1658058076232,COGS 118A,A01,083075,Gupta; Anjum,21,0,76,55
1658058082332,CSE 3,A50,083646,Miranda; Gregory Joseph,24,0,50,26
1658058088368,CSE 8A,A50,083650,Miranda; Gregory Joseph,17,1,56,39
1658058094413,CSE 11,A01,083080,Cao; Yingjun,7,15,40,33
1658058100444,CSE 12,A01,083652,Krause-Levy; Sophia Louisa,30,1,120,90
1658058106477,CSE 15L,A01,083654,Morris; Justin Loren,9,0,50,41
1658058106477,CSE 15L,A02,083655,Morris; Justin Loren,11,0,50,39
1658058112514,CSE 20,A01,083657,Tran; Khoa Dang,39,0,80,41
1658058118547,CSE 21,A01,095574,Bach; Quang Tran,23,0,48,25
1658058124586,CSE 30,A01,083084,Eldon; John,8,0,80,72
1658058124586,CSE 30,B01,095061,Bhaskar; Nishant,9,0,50,41
1658058130617,CSE 100,A01,083659,Cao; Yingjun,5,4,70,65
1658058136653,CSE 134B,A01,083661,Powell; Thomas Allan,25,0,100,75
1658058142688,CSE 140,A01,083663,Gungor; Onat,17,0,85,68
1658058148714,CSE 140L,A01,083088,Eldon; John,23,0,100,77
1658058154745,CSE 175,A01,083665,Kumar; Rakesh,3,0,25,22
1658058160781,CSE 190,A00,092507,Dubnov; Shlomo,8,0,20,12
1658058166813,ECE 45,A01,083139,Congero; Spencer William,7,0,75,68
1658058172843,ECE 65,A50,083695,Saad; Andrew S,12,0,30,18
1658058172843,ECE 65,A51,095125,Saad; Andrew S,24,0,26,2
1658058178874,ECE 109,A01,091882,Touri; Behrouz,21,0,70,49
1658058184906,ECE 180,A00,083140,Abi Samra; Nicholas Camill,1,0,30,29
1658058184906,ECE 180,B00,083141,Abi Samra; Nicholas Camill,0,0,30,30
1658058190943,MATH 10A,A01,083735,Patchell; Gregory David,2,0,30,28
1658058190943,MATH 10A,A02,083736,Patchell; Gregory David,20,0,30,10
1658058190943,MATH 10A,A03,083737,Patchell; Gregory David,16,0,30,14
1658058196974,MATH 10B,A01,083207,Lim; Seonhee,9,0,34,25
1658058196974,MATH 10B,A02,083208,Lim; Seonhee,10,0,35,25
1658058196974,MATH 10B,A03,093472,Lim; Seonhee,7,0,34,27
1658058196974,MATH 10B,B01,083739,Sinha; Shubham,14,0,30,16
1658058203007,MATH 18,A01,083743,Cinel; Cameron Alexander,9,0,30,21
1658058203007,MATH 18,A02,083744,Cinel; Cameron Alexander,18,0,30,12
1658058203007,MATH 18,A03,083745,Cinel; Cameron Alexander,10,0,30,20
1658058203007,MATH 18,B01,083748,Rideout; David Porter,5,0,37,32
1658058203007,MATH 18,B02,083749,Rideout; David Porter,5,0,36,31
1658058203007,MATH 18,B03,083750,Rideout; David Porter,3,0,37,34
1658058203007,MATH 18,B04,083751,Rideout; David Porter,7,0,36,29
1658058203007,MATH 18,B05,093473,Rideout; David Porter,7,0,36,29
1658058203007,MATH 18,B06,093474,Rideout; David Porter,6,0,36,30
1658058209035,MATH 20A,A01,083754,Zheng; Zequn,14,0,40,26
1658058215072,MATH 20B,A01,083756,Briones; Jor-el Thomas Caparas,4,0,36,32
1658058215072,MATH 20B,A02,083757,Briones; Jor-el Thomas Caparas,1,0,36,35
1658058215072,MATH 20B,A03,093475,Briones; Jor-el Thomas Caparas,3,0,36,33
1658058221103,MATH 20C,A01,083760,Briones; Jor-el Thomas Caparas,1,0,35,34
1658058221103,MATH 20C,A02,083761,Briones; Jor-el Thomas Caparas,8,0,35,27
1658058221103,MATH 20C,A03,093476,Briones; Jor-el Thomas Caparas,0,1,36,36
1658058221103,MATH 20C,B01,083762,Bach; Quang Tran,1,0,30,29
1658058227135,MATH 20D,A01,083765,Tran; Brian Kha,5,0,30,25
1658058227135,MATH 20D,A02,083766,Tran; Brian Kha,5,0,30,25
1658058227135,MATH 20D,A03,083767,Tran; Brian Kha,6,0,30,24
1658058233173,MATH 20E,A01,083771,Ganguly; Soumya,12,0,32,20
1658058233173,MATH 20E,A02,083772,Ganguly; Soumya,7,0,32,25
1658058233173,MATH 20E,B01,083773,Ciotti; Benjamin,20,0,35,15
1658058233173,MATH 20E,B02,083774,Ciotti; Benjamin,18,0,35,17
1658058239213,MATH 103A,A01,083777,Greenfeld; Be'Eri,6,0,36,30
1658058239213,MATH 103A,A02,083778,Greenfeld; Be'Eri,5,0,36,31
1658058239213,MATH 103A,A03,093561,Greenfeld; Be'Eri,7,0,36,29
1658058239213,MATH 103A,B01,083779,Greenfeld; Be'Eri,8,0,36,28
1658058239213,MATH 103A,B02,083780,Greenfeld; Be'Eri,4,0,36,32
1658058239213,MATH 103A,B03,093562,Greenfeld; Be'Eri,3,0,36,33
1658058245249,MATH 105,A01,085443,Carter; Anne Toulson,15,0,35,20
1658058245249,MATH 105,A02,093477,Carter; Anne Toulson,20,0,35,15
1658058251285,MATH 109,A01,083213,Ganzberger; Geoffrey Michael,3,0,34,31
1658058251285,MATH 109,A02,083214,Ganzberger; Geoffrey Michael,4,0,34,30
1658058251285,MATH 109,A03,093478,Ganzberger; Geoffrey Michael,2,0,34,32
1658058251285,MATH 109,B01,083215,Ganzberger; Geoffrey Michael,3,0,32,29
1658058251285,MATH 109,B02,083216,Ganzberger; Geoffrey Michael,3,0,32,29
1658058251285,MATH 109,B03,093479,Ganzberger; Geoffrey Michael,8,0,32,24
1658058257323,MATH 142A,A01,083219,Chow; Bennett,7,0,32,25
1658058257323,MATH 142A,A02,083220,Chow; Bennett,10,0,32,22
1658058257323,MATH 142A,A03,093480,Chow; Bennett,9,0,32,23
1658058257323,MATH 142A,B03,093481,Chow; Bennett,8,0,32,24
1658058257323,MATH 142A,B04,093558,Chow; Bennett,14,0,32,18
1658058257323,MATH 142A,B05,093559,Chow; Bennett,7,0,32,25
1658058263360,MATH 193A,A01,083224,Rotar; Vladimir,9,0,34,25
1658058263360,MATH 193A,A02,083225,Rotar; Vladimir,11,0,34,23
1658058263360,MATH 193A,A03,083781,Rotar; Vladimir,5,0,34,29
1658058263360,MATH 193A,A04,083782,Rotar; Vladimir,12,0,34,22
1658058263360,MATH 193A,A05,093482,Rotar; Vladimir,11,0,34,23
1658058269390,MATH 197,001,091859,McAuley; Julian John,9999,0,9999,0
1658058269390,MATH 197,002,095566,Kedlaya; Kiran S.,9997,0,9999,2
1658058269390,MATH 197,003,095567,Xiao; Ming,9999,0,9999,0
1658058269390,MATH 197,004,095571,Perols; Johan Lars,9998,0,9999,1
1658058276467,COGS 9,A01,083615,Shannon; Kyle Michael,11,0,75,64
1658058282495,COGS 11,A01,083617,Boyle; Mary E. T.,23,0,48,25
1658058288530,COGS 13,A01,083071,Bastos; Amalia Pinkusfeld,12,0,71,59
1658058294562,COGS 14A,A01,092681,Semenuks; Arturs,5,1,100,95
1658058300592,COGS 14B,A01,083073,Cheng; Tzu-Han,7,0,63,56
1658058306623,COGS 17,A01,092677,Semenuks; Arturs,7,0,81,74
1658058312659,COGS 100,A01,083619,Allen; Michael Gordon,17,0,70,53
1658058318696,COGS 101A,A01,083621,Davis; Joshua Daniel,9,0,68,59
1658058324726,COGS 101B,A01,091572,Allen; Michael Gordon,14,0,65,51
1658058330754,COGS 101C,A01,083625,Delgado; Tania,17,0,35,18
1658058336784,COGS 107A,A01,083627,Boyle; Mary E. T.,14,0,60,46
1658058342816,COGS 118A,A01,083075,Gupta; Anjum,21,0,76,55
1658058348847,CSE 3,A50,083646,Miranda; Gregory Joseph,24,0,50,26
1658058354877,CSE 8A,A50,083650,Miranda; Gregory Joseph,17,1,56,39
1658058360905,CSE 11,A01,083080,Cao; Yingjun,7,15,40,33
1658058366944,CSE 12,A01,083652,Krause-Levy; Sophia Louisa,30,1,120,90
1658058372974,CSE 15L,A01,083654,Morris; Justin Loren,9,0,50,41
1658058372974,CSE 15L,A02,083655,Morris; Justin Loren,11,0,50,39
1658058379014,CSE 20,A01,083657,Tran; Khoa Dang,39,0,80,41
1658058385112,CSE 21,A01,095574,Bach; Quang Tran,23,0,48,25
1658058391143,CSE 30,A01,083084,Eldon; John,8,0,80,72
1658058391143,CSE 30,B01,095061,Bhaskar; Nishant,9,0,50,41
1658058397174,CSE 100,A01,083659,Cao; Yingjun,5,4,70,65
1658058403207,CSE 134B,A01,083661,Powell; Thomas Allan,25,0,100,75
1658058409236,CSE 140,A01,083663,Gungor; Onat,17,0,85,68
1658058415263,CSE 140L,A01,083088,Eldon; John,23,0,100,77
1658058421298,CSE 175,A01,083665,Kumar; Rakesh,3,0,25,22
1658058427330,CSE 190,A00,092507,Dubnov; Shlomo,8,0,20,12
1658058433360,ECE 45,A01,083139,Congero; Spencer William,7,0,75,68
1658058439391,ECE 65,A50,083695,Saad; Andrew S,12,0,30,18
1658058439391,ECE 65,A51,095125,Saad; Andrew S,24,0,26,2
1658058445426,ECE 109,A01,091882,Touri; Behrouz,21,0,70,49
1658058451456,ECE 180,A00,083140,Abi Samra; Nicholas Camill,1,0,30,29
1658058451456,ECE 180,B00,083141,Abi Samra; Nicholas Camill,0,0,30,30
1658058457496,MATH 10A,A01,083735,Patchell; Gregory David,2,0,30,28
1658058457496,MATH 10A,A02,083736,Patchell; Gregory David,20,0,30,10
1658058457496,MATH 10A,A03,083737,Patchell; Gregory David,16,0,30,14
1658058463538,MATH 10B,A01,083207,Lim; Seonhee,9,0,34,25
1658058463538,MATH 10B,A02,083208,Lim; Seonhee,10,0,35,25
1658058463538,MATH 10B,A03,093472,Lim; Seonhee,7,0,34,27
1658058463538,MATH 10B,B01,083739,Sinha; Shubham,14,0,30,16
1658058469571,MATH 18,A01,083743,Cinel; Cameron Alexander,9,0,30,21
1658058469571,MATH 18,A02,083744,Cinel; Cameron Alexander,18,0,30,12
1658058469571,MATH 18,A03,083745,Cinel; Cameron Alexander,10,0,30,20
1658058469571,MATH 18,B01,083748,Rideout; David Porter,5,0,37,32
1658058469571,MATH 18,B02,083749,Rideout; David Porter,5,0,36,31
1658058469571,MATH 18,B03,083750,Rideout; David Porter,3,0,37,34
1658058469571,MATH 18,B04,083751,Rideout; David Porter,7,0,36,29
1658058469571,MATH 18,B05,093473,Rideout; David Porter,7,0,36,29
1658058469571,MATH 18,B06,093474,Rideout; David Porter,6,0,36,30
1658058475605,MATH 20A,A01,083754,Zheng; Zequn,14,0,40,26
1658058481637,MATH 20B,A01,083756,Briones; Jor-el Thomas Caparas,4,0,36,32
1658058481637,MATH 20B,A02,083757,Briones; Jor-el Thomas Caparas,1,0,36,35
1658058481637,MATH 20B,A03,093475,Briones; Jor-el Thomas Caparas,3,0,36,33
1658058487667,MATH 20C,A01,083760,Briones; Jor-el Thomas Caparas,1,0,35,34
1658058487667,MATH 20C,A02,083761,Briones; Jor-el Thomas Caparas,8,0,35,27
1658058487667,MATH 20C,A03,093476,Briones; Jor-el Thomas Caparas,0,1,36,36
1658058487667,MATH 20C,B01,083762,Bach; Quang Tran,1,0,30,29
1658058493703,MATH 20D,A01,083765,Tran; Brian Kha,5,0,30,25
1658058493703,MATH 20D,A02,083766,Tran; Brian Kha,5,0,30,25
1658058493703,MATH 20D,A03,083767,Tran; Brian Kha,6,0,30,24
1658058499739,MATH 20E,A01,083771,Ganguly; Soumya,12,0,32,20
1658058499739,MATH 20E,A02,083772,Ganguly; Soumya,7,0,32,25
1658058499739,MATH 20E,B01,083773,Ciotti; Benjamin,20,0,35,15
1658058499739,MATH 20E,B02,083774,Ciotti; Benjamin,18,0,35,17
1658058505772,MATH 103A,A01,083777,Greenfeld; Be'Eri,6,0,36,30
1658058505772,MATH 103A,A02,083778,Greenfeld; Be'Eri,5,0,36,31
1658058505772,MATH 103A,A03,093561,Greenfeld; Be'Eri,7,0,36,29
1658058505772,MATH 103A,B01,083779,Greenfeld; Be'Eri,8,0,36,28
1658058505772,MATH 103A,B02,083780,Greenfeld; Be'Eri,4,0,36,32
1658058505772,MATH 103A,B03,093562,Greenfeld; Be'Eri,3,0,36,33
1658058511805,MATH 105,A01,085443,Carter; Anne Toulson,15,0,35,20
1658058511805,MATH 105,A02,093477,Carter; Anne Toulson,20,0,35,15
1658058517831,MATH 109,A01,083213,Ganzberger; Geoffrey Michael,3,0,34,31
1658058517831,MATH 109,A02,083214,Ganzberger; Geoffrey Michael,4,0,34,30
1658058517831,MATH 109,A03,093478,Ganzberger; Geoffrey Michael,2,0,34,32
1658058517831,MATH 109,B01,083215,Ganzberger; Geoffrey Michael,3,0,32,29
1658058517831,MATH 109,B02,083216,Ganzberger; Geoffrey Michael,3,0,32,29
1658058517831,MATH 109,B03,093479,Ganzberger; Geoffrey Michael,8,0,32,24
1658058523858,MATH 142A,A01,083219,Chow; Bennett,7,0,32,25
1658058523858,MATH 142A,A02,083220,Chow; Bennett,10,0,32,22
1658058523858,MATH 142A,A03,093480,Chow; Bennett,9,0,32,23
1658058523858,MATH 142A,B03,093481,Chow; Bennett,8,0,32,24
1658058523858,MATH 142A,B04,093558,Chow; Bennett,14,0,32,18
1658058523858,MATH 142A,B05,093559,Chow; Bennett,7,0,32,25
1658058529901,MATH 193A,A01,083224,Rotar; Vladimir,9,0,34,25
1658058529901,MATH 193A,A02,083225,Rotar; Vladimir,11,0,34,23
1658058529901,MATH 193A,A03,083781,Rotar; Vladimir,5,0,34,29
1658058529901,MATH 193A,A04,083782,Rotar; Vladimir,12,0,34,22
1658058529901,MATH 193A,A05,093482,Rotar; Vladimir,11,0,34,23
1658058535930,MATH 197,001,091859,McAuley; Julian John,9999,0,9999,0
1658058535930,MATH 197,002,095566,Kedlaya; Kiran S.,9997,0,9999,2
1658058535930,MATH 197,003,095567,Xiao; Ming,9999,0,9999,0
1658058535930,MATH 197,004,095571,Perols; Johan Lars,9998,0,9999,1
1658058543003,COGS 9,A01,083615,Shannon; Kyle Michael,11,0,75,64
1658058549035,COGS 11,A01,083617,Boyle; Mary E. T.,23,0,48,25
1658058555070,COGS 13,A01,083071,Bastos; Amalia Pinkusfeld,12,0,71,59
1658058561098,COGS 14A,A01,092681,Semenuks; Arturs,5,1,100,95
1658058567130,COGS 14B,A01,083073,Cheng; Tzu-Han,7,0,63,56
1658058573166,COGS 17,A01,092677,Semenuks; Arturs,7,0,81,74
1658058579194,COGS 100,A01,083619,Allen; Michael Gordon,17,0,70,53
1658058585227,COGS 101A,A01,083621,Davis; Joshua Daniel,9,0,68,59
1658058591258,COGS 101B,A01,091572,Allen; Michael Gordon,14,0,65,51
1658058597287,COGS 101C,A01,083625,Delgado; Tania,17,0,35,18
1658058603320,COGS 107A,A01,083627,Boyle; Mary E. T.,14,0,60,46
1658058609352,COGS 118A,A01,083075,Gupta; Anjum,21,0,76,55
1658058615381,CSE 3,A50,083646,Miranda; Gregory Joseph,24,0,50,26
1658058621417,CSE 8A,A50,083650,Miranda; Gregory Joseph,17,1,56,39
1658058627447,CSE 11,A01,083080,Cao; Yingjun,7,15,40,33
1658058633476,CSE 12,A01,083652,Krause-Levy; Sophia Louisa,30,1,120,90
1658058639503,CSE 15L,A01,083654,Morris; Justin Loren,9,0,50,41
1658058639503,CSE 15L,A02,083655,Morris; Justin Loren,11,0,50,39
1658058645534,CSE 20,A01,083657,Tran; Khoa Dang,39,0,80,41
1658058651562,CSE 21,A01,095574,Bach; Quang Tran,23,0,48,25
1658058657592,CSE 30,A01,083084,Eldon; John,8,0,80,72
1658058657592,CSE 30,B01,095061,Bhaskar; Nishant,9,0,50,41
1658058663620,CSE 100,A01,083659,Cao; Yingjun,5,4,70,65
1658058669648,CSE 134B,A01,083661,Powell; Thomas Allan,25,0,100,75
1658058675675,CSE 140,A01,083663,Gungor; Onat,17,0,85,68
1658058681703,CSE 140L,A01,083088,Eldon; John,23,0,100,77
1658058687745,CSE 175,A01,083665,Kumar; Rakesh,3,0,25,22
1658058693773,CSE 190,A00,092507,Dubnov; Shlomo,8,0,20,12
1658058699802,ECE 45,A01,083139,Congero; Spencer William,7,0,75,68
1658058705839,ECE 65,A50,083695,Saad; Andrew S,12,0,30,18
1658058705839,ECE 65,A51,095125,Saad; Andrew S,24,0,26,2
1658058711867,ECE 109,A01,091882,Touri; Behrouz,21,0,70,49
1658058717900,ECE 180,A00,083140,Abi Samra; Nicholas Camill,1,0,30,29
1658058717900,ECE 180,B00,083141,Abi Samra; Nicholas Camill,0,0,30,30
1658058723928,MATH 10A,A01,083735,Patchell; Gregory David,2,0,30,28
1658058723928,MATH 10A,A02,083736,Patchell; Gregory David,20,0,30,10
1658058723928,MATH 10A,A03,083737,Patchell; Gregory David,16,0,30,14
1658058729959,MATH 10B,A01,083207,Lim; Seonhee,9,0,34,25
1658058729959,MATH 10B,A02,083208,Lim; Seonhee,10,0,35,25
1658058729959,MATH 10B,A03,093472,Lim; Seonhee,7,0,34,27
1658058729959,MATH 10B,B01,083739,Sinha; Shubham,14,0,30,16
1658058735991,MATH 18,A01,083743,Cinel; Cameron Alexander,9,0,30,21
1658058735991,MATH 18,A02,083744,Cinel; Cameron Alexander,18,0,30,12
1658058735991,MATH 18,A03,083745,Cinel; Cameron Alexander,10,0,30,20
1658058735991,MATH 18,B01,083748,Rideout; David Porter,5,0,37,32
1658058735991,MATH 18,B02,083749,Rideout; David Porter,5,0,36,31
1658058735991,MATH 18,B03,083750,Rideout; David Porter,3,0,37,34
1658058735991,MATH 18,B04,083751,Rideout; David Porter,7,0,36,29
1658058735991,MATH 18,B05,093473,Rideout; David Porter,7,0,36,29
1658058735991,MATH 18,B06,093474,Rideout; David Porter,6,0,36,30
1658058742019,MATH 20A,A01,083754,Zheng; Zequn,14,0,40,26
1658058748049,MATH 20B,A01,083756,Briones; Jor-el Thomas Caparas,4,0,36,32
1658058748049,MATH 20B,A02,083757,Briones; Jor-el Thomas Caparas,1,0,36,35
1658058748049,MATH 20B,A03,093475,Briones; Jor-el Thomas Caparas,3,0,36,33
1658058754079,MATH 20C,A01,083760,Briones; Jor-el Thomas Caparas,1,0,35,34
1658058754079,MATH 20C,A02,083761,Briones; Jor-el Thomas Caparas,8,0,35,27
1658058754079,MATH 20C,A03,093476,Briones; Jor-el Thomas Caparas,0,1,36,36
1658058754079,MATH 20C,B01,083762,Bach; Quang Tran,1,0,30,29
1658058760128,MATH 20D,A01,083765,Tran; Brian Kha,5,0,30,25
1658058760128,MATH 20D,A02,083766,Tran; Brian Kha,5,0,30,25
1658058760128,MATH 20D,A03,083767,Tran; Brian Kha,6,0,30,24
1658058766160,MATH 20E,A01,083771,Ganguly; Soumya,12,0,32,20
1658058766160,MATH 20E,A02,083772,Ganguly; Soumya,7,0,32,25
1658058766160,MATH 20E,B01,083773,Ciotti; Benjamin,20,0,35,15
1658058766160,MATH 20E,B02,083774,Ciotti; Benjamin,18,0,35,17
1658058772202,MATH 103A,A01,083777,Greenfeld; Be'Eri,6,0,36,30
1658058772202,MATH 103A,A02,083778,Greenfeld; Be'Eri,5,0,36,31
1658058772202,MATH 103A,A03,093561,Greenfeld; Be'Eri,7,0,36,29
1658058772202,MATH 103A,B01,083779,Greenfeld; Be'Eri,8,0,36,28
1658058772202,MATH 103A,B02,083780,Greenfeld; Be'Eri,4,0,36,32
1658058772202,MATH 103A,B03,093562,Greenfeld; Be'Eri,3,0,36,33
1658058778237,MATH 105,A01,085443,Carter; Anne Toulson,15,0,35,20
1658058778237,MATH 105,A02,093477,Carter; Anne Toulson,20,0,35,15
1658058784265,MATH 109,A01,083213,Ganzberger; Geoffrey Michael,3,0,34,31
1658058784265,MATH 109,A02,083214,Ganzberger; Geoffrey Michael,4,0,34,30
1658058784265,MATH 109,A03,093478,Ganzberger; Geoffrey Michael,2,0,34,32
1658058784265,MATH 109,B01,083215,Ganzberger; Geoffrey Michael,3,0,32,29
1658058784265,MATH 109,B02,083216,Ganzberger; Geoffrey Michael,3,0,32,29
1658058784265,MATH 109,B03,093479,Ganzberger; Geoffrey Michael,8,0,32,24
1658058790295,MATH 142A,A01,083219,Chow; Bennett,7,0,32,25
1658058790295,MATH 142A,A02,083220,Chow; Bennett,10,0,32,22
1658058790295,MATH 142A,A03,093480,Chow; Bennett,9,0,32,23
1658058790295,MATH 142A,B03,093481,Chow; Bennett,8,0,32,24
1658058790295,MATH 142A,B04,093558,Chow; Bennett,14,0,32,18
1658058790295,MATH 142A,B05,093559,Chow; Bennett,7,0,32,25
1658058796330,MATH 193A,A01,083224,Rotar; Vladimir,9,0,34,25
1658058796330,MATH 193A,A02,083225,Rotar; Vladimir,11,0,34,23
1658058796330,MATH 193A,A03,083781,Rotar; Vladimir,5,0,34,29
1658058796330,MATH 193A,A04,083782,Rotar; Vladimir,12,0,34,22
1658058796330,MATH 193A,A05,093482,Rotar; Vladimir,11,0,34,23
1658058802359,MATH 197,001,091859,McAuley; Julian John,9999,0,9999,0
1658058802359,MATH 197,002,095566,Kedlaya; Kiran S.,9997,0,9999,2
1658058802359,MATH 197,003,095567,Xiao; Ming,9999,0,9999,0
1658058802359,MATH 197,004,095571,Perols; Johan Lars,9998,0,9999,1
1658058809436,COGS 9,A01,083615,Shannon; Kyle Michael,11,0,75,64
1658058815463,COGS 11,A01,083617,Boyle; Mary E. T.,23,0,48,25
1658058821496,COGS 13,A01,083071,Bastos; Amalia Pinkusfeld,12,0,71,59
1658058827527,COGS 14A,A01,092681,Semenuks; Arturs,5,1,100,95
1658058833560,COGS 14B,A01,083073,Cheng; Tzu-Han,7,0,63,56
1658058839588,COGS 17,A01,092677,Semenuks; Arturs,7,0,81,74
1658058845616,COGS 100,A01,083619,Allen; Michael Gordon,17,0,70,53
1658058851644,COGS 101A,A01,083621,Davis; Joshua Daniel,9,0,68,59
1658058857673,COGS 101B,A01,091572,Allen; Michael Gordon,14,0,65,51
1658058863706,COGS 101C,A01,083625,Delgado; Tania,17,0,35,18
1658058869738,COGS 107A,A01,083627,Boyle; Mary E. T.,14,0,60,46
1658058875766,COGS 118A,A01,083075,Gupta; Anjum,21,0,76,55
1658058881795,CSE 3,A50,083646,Miranda; Gregory Joseph,24,0,50,26
1658058887822,CSE 8A,A50,083650,Miranda; Gregory Joseph,17,1,56,39
1658058893850,CSE 11,A01,083080,Cao; Yingjun,7,15,40,33
1658058899886,CSE 12,A01,083652,Krause-Levy; Sophia Louisa,30,1,120,90
1658058905914,CSE 15L,A01,083654,Morris; Justin Loren,9,0,50,41
1658058905914,CSE 15L,A02,083655,Morris; Justin Loren,11,0,50,39
1658058911947,CSE 20,A01,083657,Tran; Khoa Dang,39,0,80,41
1658058917975,CSE 21,A01,095574,Bach; Quang Tran,23,0,48,25
1658058924004,CSE 30,A01,083084,Eldon; John,8,0,80,72
1658058924004,CSE 30,B01,095061,Bhaskar; Nishant,9,0,50,41
1658058930039,CSE 100,A01,083659,Cao; Yingjun,5,4,70,65
1658058936068,CSE 134B,A01,083661,Powell; Thomas Allan,25,0,100,75
1658058942095,CSE 140,A01,083663,Gungor; Onat,17,0,85,68
1658058948120,CSE 140L,A01,083088,Eldon; John,23,0,100,77
1658058954148,CSE 175,A01,083665,Kumar; Rakesh,3,0,25,22
1658058960192,CSE 190,A00,092507,Dubnov; Shlomo,8,0,20,12
1658058966225,ECE 45,A01,083139,Congero; Spencer William,7,0,75,68
1658058972260,ECE 65,A50,083695,Saad; Andrew S,12,0,30,18
1658058972260,ECE 65,A51,095125,Saad; Andrew S,24,0,26,2
1658058978294,ECE 109,A01,091882,Touri; Behrouz,21,0,70,49
1658058984394,ECE 180,A00,083140,Abi Samra; Nicholas Camill,1,0,30,29
1658058984394,ECE 180,B00,083141,Abi Samra; Nicholas Camill,0,0,30,30
1658058990431,MATH 10A,A01,083735,Patchell; Gregory David,2,0,30,28
1658058990431,MATH 10A,A02,083736,Patchell; Gregory David,20,0,30,10
1658058990431,MATH 10A,A03,083737,Patchell; Gregory David,16,0,30,14
1658058996462,MATH 10B,A01,083207,Lim; Seonhee,9,0,34,25
1658058996462,MATH 10B,A02,083208,Lim; Seonhee,10,0,35,25
1658058996462,MATH 10B,A03,093472,Lim; Seonhee,7,0,34,27
1658058996462,MATH 10B,B01,083739,Sinha; Shubham,14,0,30,16
1658059002496,MATH 18,A01,083743,Cinel; Cameron Alexander,9,0,30,21
1658059002496,MATH 18,A02,083744,Cinel; Cameron Alexander,18,0,30,12
1658059002496,MATH 18,A03,083745,Cinel; Cameron Alexander,10,0,30,20
1658059002496,MATH 18,B01,083748,Rideout; David Porter,5,0,37,32
1658059002496,MATH 18,B02,083749,Rideout; David Porter,5,0,36,31
1658059002496,MATH 18,B03,083750,Rideout; David Porter,3,0,37,34
1658059002496,MATH 18,B04,083751,Rideout; David Porter,7,0,36,29
1658059002496,MATH 18,B05,093473,Rideout; David Porter,7,0,36,29
1658059002496,MATH 18,B06,093474,Rideout; David Porter,6,0,36,30
1658059008524,MATH 20A,A01,083754,Zheng; Zequn,14,0,40,26
1658059014555,MATH 20B,A01,083756,Briones; Jor-el Thomas Caparas,4,0,36,32
1658059014555,MATH 20B,A02,083757,Briones; Jor-el Thomas Caparas,1,0,36,35
1658059014555,MATH 20B,A03,093475,Briones; Jor-el Thomas Caparas,3,0,36,33
1658059020585,MATH 20C,A01,083760,Briones; Jor-el Thomas Caparas,1,0,35,34
1658059020585,MATH 20C,A02,083761,Briones; Jor-el Thomas Caparas,8,0,35,27
1658059020585,MATH 20C,A03,093476,Briones; Jor-el Thomas Caparas,0,1,36,36
1658059020585,MATH 20C,B01,083762,Bach; Quang Tran,1,0,30,29
1658059026612,MATH 20D,A01,083765,Tran; Brian Kha,5,0,30,25
1658059026612,MATH 20D,A02,083766,Tran; Brian Kha,5,0,30,25
1658059026612,MATH 20D,A03,083767,Tran; Brian Kha,6,0,30,24
1658059032643,MATH 20E,A01,083771,Ganguly; Soumya,12,0,32,20
1658059032643,MATH 20E,A02,083772,Ganguly; Soumya,7,0,32,25
1658059032643,MATH 20E,B01,083773,Ciotti; Benjamin,20,0,35,15
1658059032643,MATH 20E,B02,083774,Ciotti; Benjamin,18,0,35,17
1658059038682,MATH 103A,A01,083777,Greenfeld; Be'Eri,6,0,36,30
1658059038682,MATH 103A,A02,083778,Greenfeld; Be'Eri,5,0,36,31
1658059038682,MATH 103A,A03,093561,Greenfeld; Be'Eri,7,0,36,29
1658059038682,MATH 103A,B01,083779,Greenfeld; Be'Eri,8,0,36,28
1658059038682,MATH 103A,B02,083780,Greenfeld; Be'Eri,4,0,36,32
1658059038682,MATH 103A,B03,093562,Greenfeld; Be'Eri,3,0,36,33
1658059044709,MATH 105,A01,085443,Carter; Anne Toulson,15,0,35,20
1658059044709,MATH 105,A02,093477,Carter; Anne Toulson,20,0,35,15
1658059050741,MATH 109,A01,083213,Ganzberger; Geoffrey Michael,3,0,34,31
1658059050741,MATH 109,A02,083214,Ganzberger; Geoffrey Michael,4,0,34,30
1658059050741,MATH 109,A03,093478,Ganzberger; Geoffrey Michael,2,0,34,32
1658059050741,MATH 109,B01,083215,Ganzberger; Geoffrey Michael,3,0,32,29
1658059050741,MATH 109,B02,083216,Ganzberger; Geoffrey Michael,3,0,32,29
1658059050741,MATH 109,B03,093479,Ganzberger; Geoffrey Michael,8,0,32,24
1658059056772,MATH 142A,A01,083219,Chow; Bennett,7,0,32,25
1658059056772,MATH 142A,A02,083220,Chow; Bennett,10,0,32,22
1658059056772,MATH 142A,A03,093480,Chow; Bennett,9,0,32,23
1658059056772,MATH 142A,B03,093481,Chow; Bennett,8,0,32,24
1658059056772,MATH 142A,B04,093558,Chow; Bennett,14,0,32,18
1658059056772,MATH 142A,B05,093559,Chow; Bennett,7,0,32,25
1658059062801,MATH 193A,A01,083224,Rotar; Vladimir,9,0,34,25
1658059062801,MATH 193A,A02,083225,Rotar; Vladimir,11,0,34,23
1658059062801,MATH 193A,A03,083781,Rotar; Vladimir,5,0,34,29
1658059062801,MATH 193A,A04,083782,Rotar; Vladimir,12,0,34,22
1658059062801,MATH 193A,A05,093482,Rotar; Vladimir,11,0,34,23
1658059068828,MATH 197,001,091859,McAuley; Julian John,9999,0,9999,0
1658059068828,MATH 197,002,095566,Kedlaya; Kiran S.,9997,0,9999,2
1658059068828,MATH 197,003,095567,Xiao; Ming,9999,0,9999,0
1658059068828,MATH 197,004,095571,Perols; Johan Lars,9998,0,9999,1
1658059075894,COGS 9,A01,083615,Shannon; Kyle Michael,11,0,75,64
1658059081926,COGS 11,A01,083617,Boyle; Mary E. T.,23,0,48,25
1658059087953,COGS 13,A01,083071,Bastos; Amalia Pinkusfeld,12,0,71,59
1658059093982,COGS 14A,A01,092681,Semenuks; Arturs,5,1,100,95
1658059100015,COGS 14B,A01,083073,Cheng; Tzu-Han,7,0,63,56
1658059106041,COGS 17,A01,092677,Semenuks; Arturs,7,0,81,74
1658059112078,COGS 100,A01,083619,Allen; Michael Gordon,17,0,70,53
1658059118119,COGS 101A,A01,083621,Davis; Joshua Daniel,9,0,68,59
1658059124145,COGS 101B,A01,091572,Allen; Michael Gordon,14,0,65,51
1658059130176,COGS 101C,A01,083625,Delgado; Tania,17,0,35,18
1658059136204,COGS 107A,A01,083627,Boyle; Mary E. T.,14,0,60,46
1658059142231,COGS 118A,A01,083075,Gupta; Anjum,21,0,76,55
1658059148265,CSE 3,A50,083646,Miranda; Gregory Joseph,24,0,50,26
1658059154295,CSE 8A,A50,083650,Miranda; Gregory Joseph,17,1,56,39
1658059160327,CSE 11,A01,083080,Cao; Yingjun,7,15,40,33
1658059166352,CSE 12,A01,083652,Krause-Levy; Sophia Louisa,30,1,120,90
1658059172379,CSE 15L,A01,083654,Morris; Justin Loren,9,0,50,41
1658059172379,CSE 15L,A02,083655,Morris; Justin Loren,11,0,50,39
1658059178434,CSE 20,A01,083657,Tran; Khoa Dang,39,0,80,41
1658059184466,CSE 21,A01,095574,Bach; Quang Tran,23,0,48,25
1658059190502,CSE 30,A01,083084,Eldon; John,8,0,80,72
1658059190502,CSE 30,B01,095061,Bhaskar; Nishant,9,0,50,41
1658059196531,CSE 100,A01,083659,Cao; Yingjun,5,4,70,65
1658059202561,CSE 134B,A01,083661,Powell; Thomas Allan,25,0,100,75
1658059208589,CSE 140,A01,083663,Gungor; Onat,17,0,85,68
1658059214617,CSE 140L,A01,083088,Eldon; John,23,0,100,77
1658059220644,CSE 175,A01,083665,Kumar; Rakesh,3,0,25,22
1658059226671,CSE 190,A00,092507,Dubnov; Shlomo,8,0,20,12
1658059232702,ECE 45,A01,083139,Congero; Spencer William,7,0,75,68
1658059238731,ECE 65,A50,083695,Saad; Andrew S,12,0,30,18
1658059238731,ECE 65,A51,095125,Saad; Andrew S,24,0,26,2
1658059244759,ECE 109,A01,091882,Touri; Behrouz,21,0,70,49
1658059250786,ECE 180,A00,083140,Abi Samra; Nicholas Camill,1,0,30,29
1658059250786,ECE 180,B00,083141,Abi Samra; Nicholas Camill,0,0,30,30
1658059256813,MATH 10A,A01,083735,Patchell; Gregory David,2,0,30,28
1658059256813,MATH 10A,A02,083736,Patchell; Gregory David,20,0,30,10
1658059256813,MATH 10A,A03,083737,Patchell; Gregory David,16,0,30,14
1658059262858,MATH 10B,A01,083207,Lim; Seonhee,9,0,34,25
1658059262858,MATH 10B,A02,083208,Lim; Seonhee,10,0,35,25
1658059262858,MATH 10B,A03,093472,Lim; Seonhee,7,0,34,27
1658059262858,MATH 10B,B01,083739,Sinha; Shubham,14,0,30,16
1658059268908,MATH 18,A01,083743,Cinel; Cameron Alexander,9,0,30,21
1658059268908,MATH 18,A02,083744,Cinel; Cameron Alexander,18,0,30,12
1658059268908,MATH 18,A03,083745,Cinel; Cameron Alexander,10,0,30,20
1658059268908,MATH 18,B01,083748,Rideout; David Porter,5,0,37,32
1658059268908,MATH 18,B02,083749,Rideout; David Porter,5,0,36,31
1658059268908,MATH 18,B03,083750,Rideout; David Porter,3,0,37,34
1658059268908,MATH 18,B04,083751,Rideout; David Porter,7,0,36,29
1658059268908,MATH 18,B05,093473,Rideout; David Porter,7,0,36,29
1658059268908,MATH 18,B06,093474,Rideout; David Porter,6,0,36,30
1658059274935,MATH 20A,A01,083754,Zheng; Zequn,14,0,40,26
1658059280968,MATH 20B,A01,083756,Briones; Jor-el Thomas Caparas,4,0,36,32
1658059280968,MATH 20B,A02,083757,Briones; Jor-el Thomas Caparas,1,0,36,35
1658059280968,MATH 20B,A03,093475,Briones; Jor-el Thomas Caparas,3,0,36,33
1658059287011,MATH 20C,A01,083760,Briones; Jor-el Thomas Caparas,1,0,35,34
1658059287011,MATH 20C,A02,083761,Briones; Jor-el Thomas Caparas,8,0,35,27
1658059287011,MATH 20C,A03,093476,Briones; Jor-el Thomas Caparas,0,1,36,36
1658059287011,MATH 20C,B01,083762,Bach; Quang Tran,1,0,30,29
1658059293060,MATH 20D,A01,083765,Tran; Brian Kha,5,0,30,25
1658059293060,MATH 20D,A02,083766,Tran; Brian Kha,5,0,30,25
1658059293060,MATH 20D,A03,083767,Tran; Brian Kha,6,0,30,24
1658059299095,MATH 20E,A01,083771,Ganguly; Soumya,12,0,32,20
1658059299095,MATH 20E,A02,083772,Ganguly; Soumya,7,0,32,25
1658059299095,MATH 20E,B01,083773,Ciotti; Benjamin,20,0,35,15
1658059299095,MATH 20E,B02,083774,Ciotti; Benjamin,18,0,35,17
1658059305126,MATH 103A,A01,083777,Greenfeld; Be'Eri,6,0,36,30
1658059305126,MATH 103A,A02,083778,Greenfeld; Be'Eri,5,0,36,31
1658059305126,MATH 103A,A03,093561,Greenfeld; Be'Eri,7,0,36,29
1658059305126,MATH 103A,B01,083779,Greenfeld; Be'Eri,8,0,36,28
1658059305126,MATH 103A,B02,083780,Greenfeld; Be'Eri,4,0,36,32
1658059305126,MATH 103A,B03,093562,Greenfeld; Be'Eri,3,0,36,33
1658059311153,MATH 105,A01,085443,Carter; Anne Toulson,15,0,35,20
1658059311153,MATH 105,A02,093477,Carter; Anne Toulson,20,0,35,15
1658059317181,MATH 109,A01,083213,Ganzberger; Geoffrey Michael,3,0,34,31
1658059317181,MATH 109,A02,083214,Ganzberger; Geoffrey Michael,4,0,34,30
1658059317181,MATH 109,A03,093478,Ganzberger; Geoffrey Michael,2,0,34,32
1658059317181,MATH 109,B01,083215,Ganzberger; Geoffrey Michael,3,0,32,29
1658059317181,MATH 109,B02,083216,Ganzberger; Geoffrey Michael,3,0,32,29
1658059317181,MATH 109,B03,093479,Ganzberger; Geoffrey Michael,8,0,32,24
1658059323209,MATH 142A,A01,083219,Chow; Bennett,7,0,32,25
1658059323209,MATH 142A,A02,083220,Chow; Bennett,10,0,32,22
1658059323209,MATH 142A,A03,093480,Chow; Bennett,9,0,32,23
1658059323209,MATH 142A,B03,093481,Chow; Bennett,8,0,32,24
1658059323209,MATH 142A,B04,093558,Chow; Bennett,14,0,32,18
1658059323209,MATH 142A,B05,093559,Chow; Bennett,7,0,32,25
1658059329244,MATH 193A,A01,083224,Rotar; Vladimir,9,0,34,25
1658059329244,MATH 193A,A02,083225,Rotar; Vladimir,11,0,34,23
1658059329244,MATH 193A,A03,083781,Rotar; Vladimir,5,0,34,29
1658059329244,MATH 193A,A04,083782,Rotar; Vladimir,12,0,34,22
1658059329244,MATH 193A,A05,093482,Rotar; Vladimir,11,0,34,23
1658059335270,MATH 197,001,091859,McAuley; Julian John,9999,0,9999,0
1658059335270,MATH 197,002,095566,Kedlaya; Kiran S.,9997,0,9999,2
1658059335270,MATH 197,003,095567,Xiao; Ming,9999,0,9999,0
1658059335270,MATH 197,004,095571,Perols; Johan Lars,9998,0,9999,1
1658059342349,COGS 9,A01,083615,Shannon; Kyle Michael,11,0,75,64
1658059348376,COGS 11,A01,083617,Boyle; Mary E. T.,23,0,48,25
1658059354403,COGS 13,A01,083071,Bastos; Amalia Pinkusfeld,12,0,71,59
1658059360437,COGS 14A,A01,092681,Semenuks; Arturs,5,1,100,95
1658059366465,COGS 14B,A01,083073,Cheng; Tzu-Han,7,0,63,56
1658059372497,COGS 17,A01,092677,Semenuks; Arturs,7,0,81,74
1658059378532,COGS 100,A01,083619,Allen; Michael Gordon,17,0,70,53
1658059384562,COGS 101A,A01,083621,Davis; Joshua Daniel,9,0,68,59
1658059390590,COGS 101B,A01,091572,Allen; Michael Gordon,14,0,65,51
1658059396623,COGS 101C,A01,083625,Delgado; Tania,17,0,35,18
1658059402650,COGS 107A,A01,083627,Boyle; Mary E. T.,14,0,60,46
1658059408681,COGS 118A,A01,083075,Gupta; Anjum,21,0,76,55
1658059414713,CSE 3,A50,083646,Miranda; Gregory Joseph,24,0,50,26
1658059420738,CSE 8A,A50,083650,Miranda; Gregory Joseph,17,1,56,39
1658059426762,CSE 11,A01,083080,Cao; Yingjun,7,15,40,33
1658059432802,CSE 12,A01,083652,Krause-Levy; Sophia Louisa,30,1,120,90
1658059438831,CSE 15L,A01,083654,Morris; Justin Loren,9,0,50,41
1658059438831,CSE 15L,A02,083655,Morris; Justin Loren,11,0,50,39
1658059444858,CSE 20,A01,083657,Tran; Khoa Dang,39,0,80,41
1658059450889,CSE 21,A01,095574,Bach; Quang Tran,23,0,48,25
1658059456916,CSE 30,A01,083084,Eldon; John,8,0,80,72
1658059456916,CSE 30,B01,095061,Bhaskar; Nishant,9,0,50,41
1658059462949,CSE 100,A01,083659,Cao; Yingjun,5,4,70,65
1658059468978,CSE 134B,A01,083661,Powell; Thomas Allan,25,0,100,75
1658059475014,CSE 140,A01,083663,Gungor; Onat,17,0,85,68
1658059481037,CSE 140L,A01,083088,Eldon; John,23,0,100,77
1658059487065,CSE 175,A01,083665,Kumar; Rakesh,3,0,25,22
1658059493092,CSE 190,A00,092507,Dubnov; Shlomo,8,0,20,12
1658059499121,ECE 45,A01,083139,Congero; Spencer William,7,0,75,68
1658059505152,ECE 65,A50,083695,Saad; Andrew S,12,0,30,18
1658059505152,ECE 65,A51,095125,Saad; Andrew S,24,0,26,2
1658059511178,ECE 109,A01,091882,Touri; Behrouz,21,0,70,49
1658059517210,ECE 180,A00,083140,Abi Samra; Nicholas Camill,1,0,30,29
1658059517210,ECE 180,B00,083141,Abi Samra; Nicholas Camill,0,0,30,30
1658059523239,MATH 10A,A01,083735,Patchell; Gregory David,2,0,30,28
1658059523239,MATH 10A,A02,083736,Patchell; Gregory David,20,0,30,10
1658059523239,MATH 10A,A03,083737,Patchell; Gregory David,16,0,30,14
1658059529278,MATH 10B,A01,083207,Lim; Seonhee,9,0,34,25
1658059529278,MATH 10B,A02,083208,Lim; Seonhee,10,0,35,25
1658059529278,MATH 10B,A03,093472,Lim; Seonhee,7,0,34,27
1658059529278,MATH 10B,B01,083739,Sinha; Shubham,14,0,30,16
1658059535329,MATH 18,A01,083743,Cinel; Cameron Alexander,9,0,30,21
1658059535329,MATH 18,A02,083744,Cinel; Cameron Alexander,18,0,30,12
1658059535329,MATH 18,A03,083745,Cinel; Cameron Alexander,10,0,30,20
1658059535329,MATH 18,B01,083748,Rideout; David Porter,5,0,37,32
1658059535329,MATH 18,B02,083749,Rideout; David Porter,5,0,36,31
1658059535329,MATH 18,B03,083750,Rideout; David Porter,3,0,37,34
1658059535329,MATH 18,B04,083751,Rideout; David Porter,7,0,36,29
1658059535329,MATH 18,B05,093473,Rideout; David Porter,7,0,36,29
1658059535329,MATH 18,B06,093474,Rideout; David Porter,6,0,36,30
1658059541359,MATH 20A,A01,083754,Zheng; Zequn,14,0,40,26
1658059547395,MATH 20B,A01,083756,Briones; Jor-el Thomas Caparas,4,0,36,32
1658059547395,MATH 20B,A02,083757,Briones; Jor-el Thomas Caparas,1,0,36,35
1658059547395,MATH 20B,A03,093475,Briones; Jor-el Thomas Caparas,3,0,36,33
1658059553422,MATH 20C,A01,083760,Briones; Jor-el Thomas Caparas,1,0,35,34
1658059553422,MATH 20C,A02,083761,Briones; Jor-el Thomas Caparas,8,0,35,27
1658059553422,MATH 20C,A03,093476,Briones; Jor-el Thomas Caparas,0,1,36,36
1658059553422,MATH 20C,B01,083762,Bach; Quang Tran,1,0,30,29
1658059559450,MATH 20D,A01,083765,Tran; Brian Kha,5,0,30,25
1658059559450,MATH 20D,A02,083766,Tran; Brian Kha,5,0,30,25
1658059559450,MATH 20D,A03,083767,Tran; Brian Kha,6,0,30,24
1658059565479,MATH 20E,A01,083771,Ganguly; Soumya,12,0,32,20
1658059565479,MATH 20E,A02,083772,Ganguly; Soumya,7,0,32,25
1658059565479,MATH 20E,B01,083773,Ciotti; Benjamin,20,0,35,15
1658059565479,MATH 20E,B02,083774,Ciotti; Benjamin,18,0,35,17
1658059571522,MATH 103A,A01,083777,Greenfeld; Be'Eri,6,0,36,30
1658059571522,MATH 103A,A02,083778,Greenfeld; Be'Eri,5,0,36,31
1658059571522,MATH 103A,A03,093561,Greenfeld; Be'Eri,7,0,36,29
1658059571522,MATH 103A,B01,083779,Greenfeld; Be'Eri,8,0,36,28
1658059571522,MATH 103A,B02,083780,Greenfeld; Be'Eri,4,0,36,32
1658059571522,MATH 103A,B03,093562,Greenfeld; Be'Eri,3,0,36,33
1658059577563,MATH 105,A01,085443,Carter; Anne Toulson,15,0,35,20
1658059577563,MATH 105,A02,093477,Carter; Anne Toulson,20,0,35,15
1658059583680,MATH 109,A01,083213,Ganzberger; Geoffrey Michael,3,0,34,31
1658059583680,MATH 109,A02,083214,Ganzberger; Geoffrey Michael,4,0,34,30
1658059583680,MATH 109,A03,093478,Ganzberger; Geoffrey Michael,2,0,34,32
1658059583680,MATH 109,B01,083215,Ganzberger; Geoffrey Michael,3,0,32,29
1658059583680,MATH 109,B02,083216,Ganzberger; Geoffrey Michael,3,0,32,29
1658059583680,MATH 109,B03,093479,Ganzberger; Geoffrey Michael,8,0,32,24
1658059589708,MATH 142A,A01,083219,Chow; Bennett,7,0,32,25
1658059589708,MATH 142A,A02,083220,Chow; Bennett,10,0,32,22
1658059589708,MATH 142A,A03,093480,Chow; Bennett,9,0,32,23
1658059589708,MATH 142A,B03,093481,Chow; Bennett,8,0,32,24
1658059589708,MATH 142A,B04,093558,Chow; Bennett,14,0,32,18
1658059589708,MATH 142A,B05,093559,Chow; Bennett,7,0,32,25
1658059595735,MATH 193A,A01,083224,Rotar; Vladimir,9,0,34,25
1658059595735,MATH 193A,A02,083225,Rotar; Vladimir,11,0,34,23
1658059595735,MATH 193A,A03,083781,Rotar; Vladimir,5,0,34,29
1658059595735,MATH 193A,A04,083782,Rotar; Vladimir,12,0,34,22
1658059595735,MATH 193A,A05,093482,Rotar; Vladimir,11,0,34,23
1658059601768,MATH 197,001,091859,McAuley; Julian John,9999,0,9999,0
1658059601768,MATH 197,002,095566,Kedlaya; Kiran S.,9997,0,9999,2
1658059601768,MATH 197,003,095567,Xiao; Ming,9999,0,9999,0
1658059601768,MATH 197,004,095571,Perols; Johan Lars,9998,0,9999,1
1658059608833,COGS 9,A01,083615,Shannon; Kyle Michael,11,0,75,64
1658059614859,COGS 11,A01,083617,Boyle; Mary E. T.,23,0,48,25
1658059620890,COGS 13,A01,083071,Bastos; Amalia Pinkusfeld,12,0,71,59
1658059626917,COGS 14A,A01,092681,Semenuks; Arturs,5,1,100,95
1658059632948,COGS 14B,A01,083073,Cheng; Tzu-Han,7,0,63,56
1658059638974,COGS 17,A01,092677,Semenuks; Arturs,7,0,81,74
1658059645031,COGS 100,A01,083619,Allen; Michael Gordon,17,0,70,53
1658059651058,COGS 101A,A01,083621,Davis; Joshua Daniel,9,0,68,59
1658059657092,COGS 101B,A01,091572,Allen; Michael Gordon,14,0,65,51
1658059663125,COGS 101C,A01,083625,Delgado; Tania,17,0,35,18
1658059669153,COGS 107A,A01,083627,Boyle; Mary E. T.,14,0,60,46
1658059675180,COGS 118A,A01,083075,Gupta; Anjum,21,0,76,55
1658059681207,CSE 3,A50,083646,Miranda; Gregory Joseph,24,0,50,26
1658059687234,CSE 8A,A50,083650,Miranda; Gregory Joseph,17,1,56,39
1658059693261,CSE 11,A01,083080,Cao; Yingjun,7,15,40,33
1658059699299,CSE 12,A01,083652,Krause-Levy; Sophia Louisa,30,1,120,90
1658059705327,CSE 15L,A01,083654,Morris; Justin Loren,9,0,50,41
1658059705327,CSE 15L,A02,083655,Morris; Justin Loren,11,0,50,39
1658059711358,CSE 20,A01,083657,Tran; Khoa Dang,39,0,80,41
1658059717385,CSE 21,A01,095574,Bach; Quang Tran,23,0,48,25
1658059723413,CSE 30,A01,083084,Eldon; John,8,0,80,72
1658059723413,CSE 30,B01,095061,Bhaskar; Nishant,9,0,50,41
1658059729445,CSE 100,A01,083659,Cao; Yingjun,5,4,70,65
1658059735476,CSE 134B,A01,083661,Powell; Thomas Allan,25,0,100,75
1658059741507,CSE 140,A01,083663,Gungor; Onat,17,0,85,68
1658059747532,CSE 140L,A01,083088,Eldon; John,23,0,100,77
1658059753564,CSE 175,A01,083665,Kumar; Rakesh,3,0,25,22
1658059759590,CSE 190,A00,092507,Dubnov; Shlomo,8,0,20,12
1658059765622,ECE 45,A01,083139,Congero; Spencer William,7,0,75,68
1658059771664,ECE 65,A50,083695,Saad; Andrew S,12,0,30,18
1658059771664,ECE 65,A51,095125,Saad; Andrew S,24,0,26,2
1658059777700,ECE 109,A01,091882,Touri; Behrouz,21,0,70,49
1658059783730,ECE 180,A00,083140,Abi Samra; Nicholas Camill,1,0,30,29
1658059783730,ECE 180,B00,083141,Abi Samra; Nicholas Camill,0,0,30,30
1658059789765,MATH 10A,A01,083735,Patchell; Gregory David,2,0,30,28
1658059789765,MATH 10A,A02,083736,Patchell; Gregory David,20,0,30,10
1658059789765,MATH 10A,A03,083737,Patchell; Gregory David,16,0,30,14
1658059795792,MATH 10B,A01,083207,Lim; Seonhee,9,0,34,25
1658059795792,MATH 10B,A02,083208,Lim; Seonhee,10,0,35,25
1658059795792,MATH 10B,A03,093472,Lim; Seonhee,7,0,34,27
1658059795792,MATH 10B,B01,083739,Sinha; Shubham,14,0,30,16
1658059801823,MATH 18,A01,083743,Cinel; Cameron Alexander,9,0,30,21
1658059801823,MATH 18,A02,083744,Cinel; Cameron Alexander,18,0,30,12
1658059801823,MATH 18,A03,083745,Cinel; Cameron Alexander,10,0,30,20
1658059801823,MATH 18,B01,083748,Rideout; David Porter,5,0,37,32
1658059801823,MATH 18,B02,083749,Rideout; David Porter,5,0,36,31
1658059801823,MATH 18,B03,083750,Rideout; David Porter,3,0,37,34
1658059801823,MATH 18,B04,083751,Rideout; David Porter,7,0,36,29
1658059801823,MATH 18,B05,093473,Rideout; David Porter,7,0,36,29
1658059801823,MATH 18,B06,093474,Rideout; David Porter,6,0,36,30
1658059807847,MATH 20A,A01,083754,Zheng; Zequn,14,0,40,26
1658059813877,MATH 20B,A01,083756,Briones; Jor-el Thomas Caparas,4,0,36,32
1658059813877,MATH 20B,A02,083757,Briones; Jor-el Thomas Caparas,1,0,36,35
1658059813877,MATH 20B,A03,093475,Briones; Jor-el Thomas Caparas,3,0,36,33
1658059819912,MATH 20C,A01,083760,Briones; Jor-el Thomas Caparas,1,0,35,34
1658059819912,MATH 20C,A02,083761,Briones; Jor-el Thomas Caparas,8,0,35,27
1658059819912,MATH 20C,A03,093476,Briones; Jor-el Thomas Caparas,0,1,36,36
1658059819912,MATH 20C,B01,083762,Bach; Quang Tran,1,0,30,29
1658059825948,MATH 20D,A01,083765,Tran; Brian Kha,5,0,30,25
1658059825948,MATH 20D,A02,083766,Tran; Brian Kha,5,0,30,25
1658059825948,MATH 20D,A03,083767,Tran; Brian Kha,6,0,30,24
1658059831975,MATH 20E,A01,083771,Ganguly; Soumya,12,0,32,20
1658059831975,MATH 20E,A02,083772,Ganguly; Soumya,7,0,32,25
1658059831975,MATH 20E,B01,083773,Ciotti; Benjamin,20,0,35,15
1658059831975,MATH 20E,B02,083774,Ciotti; Benjamin,18,0,35,17
1658059838013,MATH 103A,A01,083777,Greenfeld; Be'Eri,6,0,36,30
1658059838013,MATH 103A,A02,083778,Greenfeld; Be'Eri,5,0,36,31
1658059838013,MATH 103A,A03,093561,Greenfeld; Be'Eri,7,0,36,29
1658059838013,MATH 103A,B01,083779,Greenfeld; Be'Eri,8,0,36,28
1658059838013,MATH 103A,B02,083780,Greenfeld; Be'Eri,4,0,36,32
1658059838013,MATH 103A,B03,093562,Greenfeld; Be'Eri,3,0,36,33
1658059844047,MATH 105,A01,085443,Carter; Anne Toulson,15,0,35,20
1658059844047,MATH 105,A02,093477,Carter; Anne Toulson,20,0,35,15
1658059850075,MATH 109,A01,083213,Ganzberger; Geoffrey Michael,3,0,34,31
1658059850075,MATH 109,A02,083214,Ganzberger; Geoffrey Michael,4,0,34,30
1658059850075,MATH 109,A03,093478,Ganzberger; Geoffrey Michael,2,0,34,32
1658059850075,MATH 109,B01,083215,Ganzberger; Geoffrey Michael,3,0,32,29
1658059850075,MATH 109,B02,083216,Ganzberger; Geoffrey Michael,3,0,32,29
1658059850075,MATH 109,B03,093479,Ganzberger; Geoffrey Michael,8,0,32,24
1658059856103,MATH 142A,A01,083219,Chow; Bennett,7,0,32,25
1658059856103,MATH 142A,A02,083220,Chow; Bennett,10,0,32,22
1658059856103,MATH 142A,A03,093480,Chow; Bennett,9,0,32,23
1658059856103,MATH 142A,B03,093481,Chow; Bennett,8,0,32,24
1658059856103,MATH 142A,B04,093558,Chow; Bennett,14,0,32,18
1658059856103,MATH 142A,B05,093559,Chow; Bennett,7,0,32,25
1658059862129,MATH 193A,A01,083224,Rotar; Vladimir,9,0,34,25
1658059862129,MATH 193A,A02,083225,Rotar; Vladimir,11,0,34,23
1658059862129,MATH 193A,A03,083781,Rotar; Vladimir,5,0,34,29
1658059862129,MATH 193A,A04,083782,Rotar; Vladimir,12,0,34,22
1658059862129,MATH 193A,A05,093482,Rotar; Vladimir,11,0,34,23
1658059868156,MATH 197,001,091859,McAuley; Julian John,9999,0,9999,0
1658059868156,MATH 197,002,095566,Kedlaya; Kiran S.,9997,0,9999,2
1658059868156,MATH 197,003,095567,Xiao; Ming,9999,0,9999,0
1658059868156,MATH 197,004,095571,Perols; Johan Lars,9998,0,9999,1
1658059875223,COGS 9,A01,083615,Shannon; Kyle Michael,11,0,75,64
1658059881254,COGS 11,A01,083617,Boyle; Mary E. T.,23,0,48,25
1658059887278,COGS 13,A01,083071,Bastos; Amalia Pinkusfeld,12,0,71,59
1658059893309,COGS 14A,A01,092681,Semenuks; Arturs,5,1,100,95
1658059899336,COGS 14B,A01,083073,Cheng; Tzu-Han,7,0,63,56
1658059905365,COGS 17,A01,092677,Semenuks; Arturs,7,0,81,74
1658059911391,COGS 100,A01,083619,Allen; Michael Gordon,17,0,70,53
1658059917423,COGS 101A,A01,083621,Davis; Joshua Daniel,9,0,68,59
1658059923448,COGS 101B,A01,091572,Allen; Michael Gordon,14,0,65,51
1658059929477,COGS 101C,A01,083625,Delgado; Tania,17,0,35,18
1658059935503,COGS 107A,A01,083627,Boyle; Mary E. T.,14,0,60,46
1658059941530,COGS 118A,A01,083075,Gupta; Anjum,21,0,76,55
1658059947559,CSE 3,A50,083646,Miranda; Gregory Joseph,24,0,50,26
1658059953588,CSE 8A,A50,083650,Miranda; Gregory Joseph,17,1,56,39
1658059959619,CSE 11,A01,083080,Cao; Yingjun,7,15,40,33
1658059965647,CSE 12,A01,083652,Krause-Levy; Sophia Louisa,30,1,120,90
1658059971675,CSE 15L,A01,083654,Morris; Justin Loren,9,0,50,41
1658059971675,CSE 15L,A02,083655,Morris; Justin Loren,11,0,50,39
1658059977708,CSE 20,A01,083657,Tran; Khoa Dang,39,0,80,41
1658059983737,CSE 21,A01,095574,Bach; Quang Tran,23,0,48,25
1658059989773,CSE 30,A01,083084,Eldon; John,8,0,80,72
1658059989773,CSE 30,B01,095061,Bhaskar; Nishant,9,0,50,41
1658059995799,CSE 100,A01,083659,Cao; Yingjun,5,4,70,65
1658060001830,CSE 134B,A01,083661,Powell; Thomas Allan,25,0,100,75
1658060007864,CSE 140,A01,083663,Gungor; Onat,17,0,85,68
1658060013890,CSE 140L,A01,083088,Eldon; John,23,0,100,77
1658060019926,CSE 175,A01,083665,Kumar; Rakesh,3,0,25,22
1658060025953,CSE 190,A00,092507,Dubnov; Shlomo,8,0,20,12
1658060031981,ECE 45,A01,083139,Congero; Spencer William,7,0,75,68
1658060038009,ECE 65,A50,083695,Saad; Andrew S,12,0,30,18
1658060038009,ECE 65,A51,095125,Saad; Andrew S,24,0,26,2
1658060044036,ECE 109,A01,091882,Touri; Behrouz,21,0,70,49
1658060050068,ECE 180,A00,083140,Abi Samra; Nicholas Camill,1,0,30,29
1658060050068,ECE 180,B00,083141,Abi Samra; Nicholas Camill,0,0,30,30
1658060056103,MATH 10A,A01,083735,Patchell; Gregory David,2,0,30,28
1658060056103,MATH 10A,A02,083736,Patchell; Gregory David,20,0,30,10
1658060056103,MATH 10A,A03,083737,Patchell; Gregory David,16,0,30,14
1658060062132,MATH 10B,A01,083207,Lim; Seonhee,9,0,34,25
1658060062132,MATH 10B,A02,083208,Lim; Seonhee,10,0,35,25
1658060062132,MATH 10B,A03,093472,Lim; Seonhee,7,0,34,27
1658060062132,MATH 10B,B01,083739,Sinha; Shubham,14,0,30,16
1658060068162,MATH 18,A01,083743,Cinel; Cameron Alexander,9,0,30,21
1658060068162,MATH 18,A02,083744,Cinel; Cameron Alexander,18,0,30,12
1658060068162,MATH 18,A03,083745,Cinel; Cameron Alexander,10,0,30,20
1658060068162,MATH 18,B01,083748,Rideout; David Porter,5,0,37,32
1658060068162,MATH 18,B02,083749,Rideout; David Porter,5,0,36,31
1658060068162,MATH 18,B03,083750,Rideout; David Porter,3,0,37,34
1658060068162,MATH 18,B04,083751,Rideout; David Porter,7,0,36,29
1658060068162,MATH 18,B05,093473,Rideout; David Porter,7,0,36,29
1658060068162,MATH 18,B06,093474,Rideout; David Porter,6,0,36,30
1658060074197,MATH 20A,A01,083754,Zheng; Zequn,14,0,40,26
1658060080229,MATH 20B,A01,083756,Briones; Jor-el Thomas Caparas,4,0,36,32
1658060080229,MATH 20B,A02,083757,Briones; Jor-el Thomas Caparas,1,0,36,35
1658060080229,MATH 20B,A03,093475,Briones; Jor-el Thomas Caparas,3,0,36,33
1658060086259,MATH 20C,A01,083760,Briones; Jor-el Thomas Caparas,1,0,35,34
1658060086259,MATH 20C,A02,083761,Briones; Jor-el Thomas Caparas,8,0,35,27
1658060086259,MATH 20C,A03,093476,Briones; Jor-el Thomas Caparas,0,1,36,36
1658060086259,MATH 20C,B01,083762,Bach; Quang Tran,1,0,30,29
1658060092289,MATH 20D,A01,083765,Tran; Brian Kha,5,0,30,25
1658060092289,MATH 20D,A02,083766,Tran; Brian Kha,5,0,30,25
1658060092289,MATH 20D,A03,083767,Tran; Brian Kha,6,0,30,24
1658060098325,MATH 20E,A01,083771,Ganguly; Soumya,12,0,32,20
1658060098325,MATH 20E,A02,083772,Ganguly; Soumya,7,0,32,25
1658060098325,MATH 20E,B01,083773,Ciotti; Benjamin,20,0,35,15
1658060098325,MATH 20E,B02,083774,Ciotti; Benjamin,18,0,35,17
1658060104357,MATH 103A,A01,083777,Greenfeld; Be'Eri,6,0,36,30
1658060104357,MATH 103A,A02,083778,Greenfeld; Be'Eri,5,0,36,31
1658060104357,MATH 103A,A03,093561,Greenfeld; Be'Eri,7,0,36,29
1658060104357,MATH 103A,B01,083779,Greenfeld; Be'Eri,8,0,36,28
1658060104357,MATH 103A,B02,083780,Greenfeld; Be'Eri,4,0,36,32
1658060104357,MATH 103A,B03,093562,Greenfeld; Be'Eri,3,0,36,33
1658060110393,MATH 105,A01,085443,Carter; Anne Toulson,15,0,35,20
1658060110393,MATH 105,A02,093477,Carter; Anne Toulson,20,0,35,15
1658060116505,MATH 109,A01,083213,Ganzberger; Geoffrey Michael,3,0,34,31
1658060116505,MATH 109,A02,083214,Ganzberger; Geoffrey Michael,4,0,34,30
1658060116505,MATH 109,A03,093478,Ganzberger; Geoffrey Michael,2,0,34,32
1658060116505,MATH 109,B01,083215,Ganzberger; Geoffrey Michael,3,0,32,29
1658060116505,MATH 109,B02,083216,Ganzberger; Geoffrey Michael,3,0,32,29
1658060116505,MATH 109,B03,093479,Ganzberger; Geoffrey Michael,8,0,32,24
1658060122536,MATH 142A,A01,083219,Chow; Bennett,7,0,32,25
1658060122536,MATH 142A,A02,083220,Chow; Bennett,10,0,32,22
1658060122536,MATH 142A,A03,093480,Chow; Bennett,9,0,32,23
1658060122536,MATH 142A,B03,093481,Chow; Bennett,8,0,32,24
1658060122536,MATH 142A,B04,093558,Chow; Bennett,14,0,32,18
1658060122536,MATH 142A,B05,093559,Chow; Bennett,7,0,32,25
1658060128564,MATH 193A,A01,083224,Rotar; Vladimir,9,0,34,25
1658060128564,MATH 193A,A02,083225,Rotar; Vladimir,11,0,34,23
1658060128564,MATH 193A,A03,083781,Rotar; Vladimir,5,0,34,29
1658060128564,MATH 193A,A04,083782,Rotar; Vladimir,12,0,34,22
1658060128564,MATH 193A,A05,093482,Rotar; Vladimir,11,0,34,23
1658060134591,MATH 197,001,091859,McAuley; Julian John,9999,0,9999,0
1658060134591,MATH 197,002,095566,Kedlaya; Kiran S.,9997,0,9999,2
1658060134591,MATH 197,003,095567,Xiao; Ming,9999,0,9999,0
1658060134591,MATH 197,004,095571,Perols; Johan Lars,9998,0,9999,1
1658060141675,COGS 9,A01,083615,Shannon; Kyle Michael,11,0,75,64
1658060147702,COGS 11,A01,083617,Boyle; Mary E. T.,23,0,48,25
1658060153727,COGS 13,A01,083071,Bastos; Amalia Pinkusfeld,12,0,71,59
1658060159760,COGS 14A,A01,092681,Semenuks; Arturs,5,1,100,95
1658060165792,COGS 14B,A01,083073,Cheng; Tzu-Han,7,0,63,56
1658060171819,COGS 17,A01,092677,Semenuks; Arturs,7,0,81,74
1658060177919,COGS 100,A01,083619,Allen; Michael Gordon,17,0,70,53
1658060183948,COGS 101A,A01,083621,Davis; Joshua Daniel,9,0,68,59
1658060189974,COGS 101B,A01,091572,Allen; Michael Gordon,14,0,65,51
1658060196002,COGS 101C,A01,083625,Delgado; Tania,17,0,35,18
1658060202038,COGS 107A,A01,083627,Boyle; Mary E. T.,14,0,60,46
1658060208077,COGS 118A,A01,083075,Gupta; Anjum,21,0,76,55
1658060214111,CSE 3,A50,083646,Miranda; Gregory Joseph,24,0,50,26
1658060220145,CSE 8A,A50,083650,Miranda; Gregory Joseph,17,1,56,39
1658060226173,CSE 11,A01,083080,Cao; Yingjun,7,15,40,33
1658060232202,CSE 12,A01,083652,Krause-Levy; Sophia Louisa,30,1,120,90
1658060238235,CSE 15L,A01,083654,Morris; Justin Loren,9,0,50,41
1658060238235,CSE 15L,A02,083655,Morris; Justin Loren,11,0,50,39
1658060244268,CSE 20,A01,083657,Tran; Khoa Dang,39,0,80,41
1658060250299,CSE 21,A01,095574,Bach; Quang Tran,23,0,48,25
1658060256333,CSE 30,A01,083084,Eldon; John,8,0,80,72
1658060256333,CSE 30,B01,095061,Bhaskar; Nishant,9,0,50,41
1658060262370,CSE 100,A01,083659,Cao; Yingjun,5,4,70,65
1658060268430,CSE 134B,A01,083661,Powell; Thomas Allan,25,0,100,75
1658060274460,CSE 140,A01,083663,Gungor; Onat,17,0,85,68
1658060280487,CSE 140L,A01,083088,Eldon; John,23,0,100,77
1658060286514,CSE 175,A01,083665,Kumar; Rakesh,3,0,25,22
1658060292545,CSE 190,A00,092507,Dubnov; Shlomo,8,0,20,12
1658060298573,ECE 45,A01,083139,Congero; Spencer William,7,0,75,68
1658060304608,ECE 65,A50,083695,Saad; Andrew S,12,0,30,18
1658060304608,ECE 65,A51,095125,Saad; Andrew S,24,0,26,2
1658060310640,ECE 109,A01,091882,Touri; Behrouz,21,0,70,49
1658060316669,ECE 180,A00,083140,Abi Samra; Nicholas Camill,1,0,30,29
1658060316669,ECE 180,B00,083141,Abi Samra; Nicholas Camill,0,0,30,30
1658060322698,MATH 10A,A01,083735,Patchell; Gregory David,2,0,30,28
1658060322698,MATH 10A,A02,083736,Patchell; Gregory David,20,0,30,10
1658060322698,MATH 10A,A03,083737,Patchell; Gregory David,16,0,30,14
1658060328731,MATH 10B,A01,083207,Lim; Seonhee,9,0,34,25
1658060328731,MATH 10B,A02,083208,Lim; Seonhee,10,0,35,25
1658060328731,MATH 10B,A03,093472,Lim; Seonhee,7,0,34,27
1658060328731,MATH 10B,B01,083739,Sinha; Shubham,14,0,30,16
1658060334764,MATH 18,A01,083743,Cinel; Cameron Alexander,9,0,30,21
1658060334764,MATH 18,A02,083744,Cinel; Cameron Alexander,18,0,30,12
1658060334764,MATH 18,A03,083745,Cinel; Cameron Alexander,10,0,30,20
1658060334764,MATH 18,B01,083748,Rideout; David Porter,5,0,37,32
1658060334764,MATH 18,B02,083749,Rideout; David Porter,5,0,36,31
1658060334764,MATH 18,B03,083750,Rideout; David Porter,3,0,37,34
1658060334764,MATH 18,B04,083751,Rideout; David Porter,7,0,36,29
1658060334764,MATH 18,B05,093473,Rideout; David Porter,7,0,36,29
1658060334764,MATH 18,B06,093474,Rideout; David Porter,6,0,36,30
1658060340791,MATH 20A,A01,083754,Zheng; Zequn,14,0,40,26
1658060346820,MATH 20B,A01,083756,Briones; Jor-el Thomas Caparas,4,0,36,32
1658060346820,MATH 20B,A02,083757,Briones; Jor-el Thomas Caparas,1,0,36,35
1658060346820,MATH 20B,A03,093475,Briones; Jor-el Thomas Caparas,3,0,36,33
1658060352848,MATH 20C,A01,083760,Briones; Jor-el Thomas Caparas,1,0,35,34
1658060352848,MATH 20C,A02,083761,Briones; Jor-el Thomas Caparas,8,0,35,27
1658060352848,MATH 20C,A03,093476,Briones; Jor-el Thomas Caparas,0,1,36,36
1658060352848,MATH 20C,B01,083762,Bach; Quang Tran,1,0,30,29
1658060358879,MATH 20D,A01,083765,Tran; Brian Kha,5,0,30,25
1658060358879,MATH 20D,A02,083766,Tran; Brian Kha,5,0,30,25
1658060358879,MATH 20D,A03,083767,Tran; Brian Kha,6,0,30,24
1658060364904,MATH 20E,A01,083771,Ganguly; Soumya,12,0,32,20
1658060364904,MATH 20E,A02,083772,Ganguly; Soumya,7,0,32,25
1658060364904,MATH 20E,B01,083773,Ciotti; Benjamin,20,0,35,15
1658060364904,MATH 20E,B02,083774,Ciotti; Benjamin,18,0,35,17
1658060370933,MATH 103A,A01,083777,Greenfeld; Be'Eri,6,0,36,30
1658060370933,MATH 103A,A02,083778,Greenfeld; Be'Eri,5,0,36,31
1658060370933,MATH 103A,A03,093561,Greenfeld; Be'Eri,7,0,36,29
1658060370933,MATH 103A,B01,083779,Greenfeld; Be'Eri,8,0,36,28
1658060370933,MATH 103A,B02,083780,Greenfeld; Be'Eri,4,0,36,32
1658060370933,MATH 103A,B03,093562,Greenfeld; Be'Eri,3,0,36,33
1658060376963,MATH 105,A01,085443,Carter; Anne Toulson,15,0,35,20
1658060376963,MATH 105,A02,093477,Carter; Anne Toulson,20,0,35,15
1658060383002,MATH 109,A01,083213,Ganzberger; Geoffrey Michael,3,0,34,31
1658060383002,MATH 109,A02,083214,Ganzberger; Geoffrey Michael,4,0,34,30
1658060383002,MATH 109,A03,093478,Ganzberger; Geoffrey Michael,2,0,34,32
1658060383002,MATH 109,B01,083215,Ganzberger; Geoffrey Michael,3,0,32,29
1658060383002,MATH 109,B02,083216,Ganzberger; Geoffrey Michael,3,0,32,29
1658060383002,MATH 109,B03,093479,Ganzberger; Geoffrey Michael,8,0,32,24
1658060389030,MATH 142A,A01,083219,Chow; Bennett,7,0,32,25
1658060389030,MATH 142A,A02,083220,Chow; Bennett,10,0,32,22
1658060389030,MATH 142A,A03,093480,Chow; Bennett,9,0,32,23
1658060389030,MATH 142A,B03,093481,Chow; Bennett,8,0,32,24
1658060389030,MATH 142A,B04,093558,Chow; Bennett,14,0,32,18
1658060389030,MATH 142A,B05,093559,Chow; Bennett,7,0,32,25
1658060395062,MATH 193A,A01,083224,Rotar; Vladimir,9,0,34,25
1658060395062,MATH 193A,A02,083225,Rotar; Vladimir,11,0,34,23
1658060395062,MATH 193A,A03,083781,Rotar; Vladimir,5,0,34,29
1658060395062,MATH 193A,A04,083782,Rotar; Vladimir,12,0,34,22
1658060395062,MATH 193A,A05,093482,Rotar; Vladimir,11,0,34,23
1658060401091,MATH 197,001,091859,McAuley; Julian John,9999,0,9999,0
1658060401091,MATH 197,002,095566,Kedlaya; Kiran S.,9997,0,9999,2
1658060401091,MATH 197,003,095567,Xiao; Ming,9999,0,9999,0
1658060401091,MATH 197,004,095571,Perols; Johan Lars,9998,0,9999,1
1658060408182,COGS 9,A01,083615,Shannon; Kyle Michael,11,0,75,64
1658060414212,COGS 11,A01,083617,Boyle; Mary E. T.,23,0,48,25
1658060420241,COGS 13,A01,083071,Bastos; Amalia Pinkusfeld,12,0,71,59
1658060426268,COGS 14A,A01,092681,Semenuks; Arturs,5,1,100,95
1658060432302,COGS 14B,A01,083073,Cheng; Tzu-Han,7,0,63,56
1658060438327,COGS 17,A01,092677,Semenuks; Arturs,7,0,81,74
1658060444354,COGS 100,A01,083619,Allen; Michael Gordon,17,0,70,53
1658060450386,COGS 101A,A01,083621,Davis; Joshua Daniel,9,0,68,59
1658060456414,COGS 101B,A01,091572,Allen; Michael Gordon,14,0,65,51
1658060462440,COGS 101C,A01,083625,Delgado; Tania,17,0,35,18
1658060468470,COGS 107A,A01,083627,Boyle; Mary E. T.,14,0,60,46
1658060474503,COGS 118A,A01,083075,Gupta; Anjum,21,0,76,55
1658060480535,CSE 3,A50,083646,Miranda; Gregory Joseph,24,0,50,26
1658060486565,CSE 8A,A50,083650,Miranda; Gregory Joseph,17,1,56,39
1658060492599,CSE 11,A01,083080,Cao; Yingjun,7,15,40,33
1658060498625,CSE 12,A01,083652,Krause-Levy; Sophia Louisa,30,1,120,90
1658060504652,CSE 15L,A01,083654,Morris; Justin Loren,9,0,50,41
1658060504652,CSE 15L,A02,083655,Morris; Justin Loren,11,0,50,39
1658060510685,CSE 20,A01,083657,Tran; Khoa Dang,39,0,80,41
1658060516711,CSE 21,A01,095574,Bach; Quang Tran,23,0,48,25
1658060522737,CSE 30,A01,083084,Eldon; John,8,0,80,72
1658060522737,CSE 30,B01,095061,Bhaskar; Nishant,9,0,50,41
1658060528769,CSE 100,A01,083659,Cao; Yingjun,5,4,70,65
1658060534801,CSE 134B,A01,083661,Powell; Thomas Allan,25,0,100,75
1658060540827,CSE 140,A01,083663,Gungor; Onat,17,0,85,68
1658060546866,CSE 140L,A01,083088,Eldon; John,23,0,100,77
1658060552934,CSE 175,A01,083665,Kumar; Rakesh,3,0,25,22
1658060558968,CSE 190,A00,092507,Dubnov; Shlomo,8,0,20,12
1658060564994,ECE 45,A01,083139,Congero; Spencer William,7,0,75,68
1658060571026,ECE 65,A50,083695,Saad; Andrew S,12,0,30,18
1658060571026,ECE 65,A51,095125,Saad; Andrew S,24,0,26,2
1658060577052,ECE 109,A01,091882,Touri; Behrouz,21,0,70,49
1658060583085,ECE 180,A00,083140,Abi Samra; Nicholas Camill,1,0,30,29
1658060583085,ECE 180,B00,083141,Abi Samra; Nicholas Camill,0,0,30,30
1658060589112,MATH 10A,A01,083735,Patchell; Gregory David,2,0,30,28
1658060589112,MATH 10A,A02,083736,Patchell; Gregory David,20,0,30,10
1658060589112,MATH 10A,A03,083737,Patchell; Gregory David,16,0,30,14
1658060595154,MATH 10B,A01,083207,Lim; Seonhee,9,0,34,25
1658060595154,MATH 10B,A02,083208,Lim; Seonhee,10,0,35,25
1658060595154,MATH 10B,A03,093472,Lim; Seonhee,7,0,34,27
1658060595154,MATH 10B,B01,083739,Sinha; Shubham,14,0,30,16
1658060601190,MATH 18,A01,083743,Cinel; Cameron Alexander,9,0,30,21
1658060601190,MATH 18,A02,083744,Cinel; Cameron Alexander,18,0,30,12
1658060601190,MATH 18,A03,083745,Cinel; Cameron Alexander,10,0,30,20
1658060601190,MATH 18,B01,083748,Rideout; David Porter,5,0,37,32
1658060601190,MATH 18,B02,083749,Rideout; David Porter,5,0,36,31
1658060601190,MATH 18,B03,083750,Rideout; David Porter,3,0,37,34
1658060601190,MATH 18,B04,083751,Rideout; David Porter,7,0,36,29
1658060601190,MATH 18,B05,093473,Rideout; David Porter,7,0,36,29
1658060601190,MATH 18,B06,093474,Rideout; David Porter,6,0,36,30
1658060607220,MATH 20A,A01,083754,Zheng; Zequn,14,0,40,26
1658060613253,MATH 20B,A01,083756,Briones; Jor-el Thomas Caparas,4,0,36,32
1658060613253,MATH 20B,A02,083757,Briones; Jor-el Thomas Caparas,1,0,36,35
1658060613253,MATH 20B,A03,093475,Briones; Jor-el Thomas Caparas,3,0,36,33
1658060619288,MATH 20C,A01,083760,Briones; Jor-el Thomas Caparas,1,0,35,34
1658060619288,MATH 20C,A02,083761,Briones; Jor-el Thomas Caparas,8,0,35,27
1658060619288,MATH 20C,A03,093476,Briones; Jor-el Thomas Caparas,0,1,36,36
1658060619288,MATH 20C,B01,083762,Bach; Quang Tran,1,0,30,29
1658060625316,MATH 20D,A01,083765,Tran; Brian Kha,5,0,30,25
1658060625316,MATH 20D,A02,083766,Tran; Brian Kha,5,0,30,25
1658060625316,MATH 20D,A03,083767,Tran; Brian Kha,6,0,30,24
1658060631352,MATH 20E,A01,083771,Ganguly; Soumya,12,0,32,20
1658060631352,MATH 20E,A02,083772,Ganguly; Soumya,7,0,32,25
1658060631352,MATH 20E,B01,083773,Ciotti; Benjamin,20,0,35,15
1658060631352,MATH 20E,B02,083774,Ciotti; Benjamin,18,0,35,17
1658060637387,MATH 103A,A01,083777,Greenfeld; Be'Eri,6,0,36,30
1658060637387,MATH 103A,A02,083778,Greenfeld; Be'Eri,5,0,36,31
1658060637387,MATH 103A,A03,093561,Greenfeld; Be'Eri,7,0,36,29
1658060637387,MATH 103A,B01,083779,Greenfeld; Be'Eri,8,0,36,28
1658060637387,MATH 103A,B02,083780,Greenfeld; Be'Eri,4,0,36,32
1658060637387,MATH 103A,B03,093562,Greenfeld; Be'Eri,3,0,36,33
1658060643420,MATH 105,A01,085443,Carter; Anne Toulson,15,0,35,20
1658060643420,MATH 105,A02,093477,Carter; Anne Toulson,20,0,35,15
1658060649448,MATH 109,A01,083213,Ganzberger; Geoffrey Michael,3,0,34,31
1658060649448,MATH 109,A02,083214,Ganzberger; Geoffrey Michael,4,0,34,30
1658060649448,MATH 109,A03,093478,Ganzberger; Geoffrey Michael,2,0,34,32
1658060649448,MATH 109,B01,083215,Ganzberger; Geoffrey Michael,3,0,32,29
1658060649448,MATH 109,B02,083216,Ganzberger; Geoffrey Michael,3,0,32,29
1658060649448,MATH 109,B03,093479,Ganzberger; Geoffrey Michael,8,0,32,24
1658060655475,MATH 142A,A01,083219,Chow; Bennett,7,0,32,25
1658060655475,MATH 142A,A02,083220,Chow; Bennett,10,0,32,22
1658060655475,MATH 142A,A03,093480,Chow; Bennett,9,0,32,23
1658060655475,MATH 142A,B03,093481,Chow; Bennett,8,0,32,24
1658060655475,MATH 142A,B04,093558,Chow; Bennett,14,0,32,18
1658060655475,MATH 142A,B05,093559,Chow; Bennett,7,0,32,25
1658060661506,MATH 193A,A01,083224,Rotar; Vladimir,9,0,34,25
1658060661506,MATH 193A,A02,083225,Rotar; Vladimir,11,0,34,23
1658060661506,MATH 193A,A03,083781,Rotar; Vladimir,5,0,34,29
1658060661506,MATH 193A,A04,083782,Rotar; Vladimir,12,0,34,22
1658060661506,MATH 193A,A05,093482,Rotar; Vladimir,11,0,34,23
1658060667539,MATH 197,001,091859,McAuley; Julian John,9999,0,9999,0
1658060667539,MATH 197,002,095566,Kedlaya; Kiran S.,9997,0,9999,2
1658060667539,MATH 197,003,095567,Xiao; Ming,9999,0,9999,0
1658060667539,MATH 197,004,095571,Perols; Johan Lars,9998,0,9999,1
1658060674610,COGS 9,A01,083615,Shannon; Kyle Michael,11,0,75,64
1658060680639,COGS 11,A01,083617,Boyle; Mary E. T.,23,0,48,25
1658060686669,COGS 13,A01,083071,Bastos; Amalia Pinkusfeld,12,0,71,59
1658060692696,COGS 14A,A01,092681,Semenuks; Arturs,5,1,100,95
1658060698722,COGS 14B,A01,083073,Cheng; Tzu-Han,7,0,63,56
1658060704749,COGS 17,A01,092677,Semenuks; Arturs,7,0,81,74
1658060710784,COGS 100,A01,083619,Allen; Michael Gordon,17,0,70,53
1658060716812,COGS 101A,A01,083621,Davis; Joshua Daniel,9,0,68,59
1658060722841,COGS 101B,A01,091572,Allen; Michael Gordon,14,0,65,51
1658060728870,COGS 101C,A01,083625,Delgado; Tania,17,0,35,18
1658060734898,COGS 107A,A01,083627,Boyle; Mary E. T.,14,0,60,46
1658060740922,COGS 118A,A01,083075,Gupta; Anjum,21,0,76,55
1658060746956,CSE 3,A50,083646,Miranda; Gregory Joseph,24,0,50,26
1658060752982,CSE 8A,A50,083650,Miranda; Gregory Joseph,17,1,56,39
1658060759012,CSE 11,A01,083080,Cao; Yingjun,7,15,40,33
1658060765042,CSE 12,A01,083652,Krause-Levy; Sophia Louisa,30,1,120,90
1658060771072,CSE 15L,A01,083654,Morris; Justin Loren,9,0,50,41
1658060771072,CSE 15L,A02,083655,Morris; Justin Loren,11,0,50,39
1658060777200,CSE 20,A01,083657,Tran; Khoa Dang,39,0,80,41
1658060783236,CSE 21,A01,095574,Bach; Quang Tran,23,0,48,25
1658060789273,CSE 30,A01,083084,Eldon; John,8,0,80,72
1658060789273,CSE 30,B01,095061,Bhaskar; Nishant,9,0,50,41
1658060795308,CSE 100,A01,083659,Cao; Yingjun,5,4,70,65
1658060801334,CSE 134B,A01,083661,Powell; Thomas Allan,25,0,100,75
1658060807361,CSE 140,A01,083663,Gungor; Onat,17,0,85,68
1658060813387,CSE 140L,A01,083088,Eldon; John,23,0,100,77
1658060819422,CSE 175,A01,083665,Kumar; Rakesh,3,0,25,22
1658060825449,CSE 190,A00,092507,Dubnov; Shlomo,8,0,20,12
1658060831490,ECE 45,A01,083139,Congero; Spencer William,7,0,75,68
1658060837517,ECE 65,A50,083695,Saad; Andrew S,12,0,30,18
1658060837517,ECE 65,A51,095125,Saad; Andrew S,24,0,26,2
1658060843544,ECE 109,A01,091882,Touri; Behrouz,21,0,70,49
1658060849569,ECE 180,A00,083140,Abi Samra; Nicholas Camill,1,0,30,29
1658060849569,ECE 180,B00,083141,Abi Samra; Nicholas Camill,0,0,30,30
1658060855598,MATH 10A,A01,083735,Patchell; Gregory David,2,0,30,28
1658060855598,MATH 10A,A02,083736,Patchell; Gregory David,20,0,30,10
1658060855598,MATH 10A,A03,083737,Patchell; Gregory David,16,0,30,14
1658060861635,MATH 10B,A01,083207,Lim; Seonhee,9,0,34,25
1658060861635,MATH 10B,A02,083208,Lim; Seonhee,10,0,35,25
1658060861635,MATH 10B,A03,093472,Lim; Seonhee,7,0,34,27
1658060861635,MATH 10B,B01,083739,Sinha; Shubham,14,0,30,16
1658060867676,MATH 18,A01,083743,Cinel; Cameron Alexander,9,0,30,21
1658060867676,MATH 18,A02,083744,Cinel; Cameron Alexander,18,0,30,12
1658060867676,MATH 18,A03,083745,Cinel; Cameron Alexander,10,0,30,20
1658060867676,MATH 18,B01,083748,Rideout; David Porter,5,0,37,32
1658060867676,MATH 18,B02,083749,Rideout; David Porter,5,0,36,31
1658060867676,MATH 18,B03,083750,Rideout; David Porter,3,0,37,34
1658060867676,MATH 18,B04,083751,Rideout; David Porter,7,0,36,29
1658060867676,MATH 18,B05,093473,Rideout; David Porter,7,0,36,29
1658060867676,MATH 18,B06,093474,Rideout; David Porter,6,0,36,30
1658060873713,MATH 20A,A01,083754,Zheng; Zequn,14,0,40,26
1658060879740,MATH 20B,A01,083756,Briones; Jor-el Thomas Caparas,4,0,36,32
1658060879740,MATH 20B,A02,083757,Briones; Jor-el Thomas Caparas,1,0,36,35
1658060879740,MATH 20B,A03,093475,Briones; Jor-el Thomas Caparas,3,0,36,33
1658060885778,MATH 20C,A01,083760,Briones; Jor-el Thomas Caparas,1,0,35,34
1658060885778,MATH 20C,A02,083761,Briones; Jor-el Thomas Caparas,8,0,35,27
1658060885778,MATH 20C,A03,093476,Briones; Jor-el Thomas Caparas,0,1,36,36
1658060885778,MATH 20C,B01,083762,Bach; Quang Tran,1,0,30,29
1658060891804,MATH 20D,A01,083765,Tran; Brian Kha,5,0,30,25
1658060891804,MATH 20D,A02,083766,Tran; Brian Kha,5,0,30,25
1658060891804,MATH 20D,A03,083767,Tran; Brian Kha,6,0,30,24
1658060897832,MATH 20E,A01,083771,Ganguly; Soumya,12,0,32,20
1658060897832,MATH 20E,A02,083772,Ganguly; Soumya,7,0,32,25
1658060897832,MATH 20E,B01,083773,Ciotti; Benjamin,20,0,35,15
1658060897832,MATH 20E,B02,083774,Ciotti; Benjamin,18,0,35,17
1658060903867,MATH 103A,A01,083777,Greenfeld; Be'Eri,6,0,36,30
1658060903867,MATH 103A,A02,083778,Greenfeld; Be'Eri,5,0,36,31
1658060903867,MATH 103A,A03,093561,Greenfeld; Be'Eri,7,0,36,29
1658060903867,MATH 103A,B01,083779,Greenfeld; Be'Eri,8,0,36,28
1658060903867,MATH 103A,B02,083780,Greenfeld; Be'Eri,4,0,36,32
1658060903867,MATH 103A,B03,093562,Greenfeld; Be'Eri,3,0,36,33
1658060909895,MATH 105,A01,085443,Carter; Anne Toulson,15,0,35,20
1658060909895,MATH 105,A02,093477,Carter; Anne Toulson,20,0,35,15
1658060915927,MATH 109,A01,083213,Ganzberger; Geoffrey Michael,3,0,34,31
1658060915927,MATH 109,A02,083214,Ganzberger; Geoffrey Michael,4,0,34,30
1658060915927,MATH 109,A03,093478,Ganzberger; Geoffrey Michael,2,0,34,32
1658060915927,MATH 109,B01,083215,Ganzberger; Geoffrey Michael,3,0,32,29
1658060915927,MATH 109,B02,083216,Ganzberger; Geoffrey Michael,3,0,32,29
1658060915927,MATH 109,B03,093479,Ganzberger; Geoffrey Michael,8,0,32,24
1658060921971,MATH 142A,A01,083219,Chow; Bennett,7,0,32,25
1658060921971,MATH 142A,A02,083220,Chow; Bennett,10,0,32,22
1658060921971,MATH 142A,A03,093480,Chow; Bennett,9,0,32,23
1658060921971,MATH 142A,B03,093481,Chow; Bennett,8,0,32,24
1658060921971,MATH 142A,B04,093558,Chow; Bennett,14,0,32,18
1658060921971,MATH 142A,B05,093559,Chow; Bennett,7,0,32,25
1658060928003,MATH 193A,A01,083224,Rotar; Vladimir,9,0,34,25
1658060928003,MATH 193A,A02,083225,Rotar; Vladimir,11,0,34,23
1658060928003,MATH 193A,A03,083781,Rotar; Vladimir,5,0,34,29
1658060928003,MATH 193A,A04,083782,Rotar; Vladimir,12,0,34,22
1658060928003,MATH 193A,A05,093482,Rotar; Vladimir,11,0,34,23
1658060934029,MATH 197,001,091859,McAuley; Julian John,9999,0,9999,0
1658060934029,MATH 197,002,095566,Kedlaya; Kiran S.,9997,0,9999,2
1658060934029,MATH 197,003,095567,Xiao; Ming,9999,0,9999,0
1658060934029,MATH 197,004,095571,Perols; Johan Lars,9998,0,9999,1
1658060941093,COGS 9,A01,083615,Shannon; Kyle Michael,11,0,75,64
1658060947134,COGS 11,A01,083617,Boyle; Mary E. T.,23,0,48,25
1658060953166,COGS 13,A01,083071,Bastos; Amalia Pinkusfeld,12,0,71,59
1658060959198,COGS 14A,A01,092681,Semenuks; Arturs,5,1,100,95
1658060965228,COGS 14B,A01,083073,Cheng; Tzu-Han,7,0,63,56
1658060971254,COGS 17,A01,092677,Semenuks; Arturs,7,0,81,74
1658060977282,COGS 100,A01,083619,Allen; Michael Gordon,17,0,70,53
1658060983309,COGS 101A,A01,083621,Davis; Joshua Daniel,9,0,68,59
1658060989339,COGS 101B,A01,091572,Allen; Michael Gordon,14,0,65,51
1658060995369,COGS 101C,A01,083625,Delgado; Tania,17,0,35,18
1658061001396,COGS 107A,A01,083627,Boyle; Mary E. T.,14,0,60,46
1658061007421,COGS 118A,A01,083075,Gupta; Anjum,21,0,76,55
1658061013456,CSE 3,A50,083646,Miranda; Gregory Joseph,24,0,50,26
1658061019488,CSE 8A,A50,083650,Miranda; Gregory Joseph,17,1,56,39
1658061025517,CSE 11,A01,083080,Cao; Yingjun,7,15,40,33
1658061031553,CSE 12,A01,083652,Krause-Levy; Sophia Louisa,30,1,120,90
1658061037579,CSE 15L,A01,083654,Morris; Justin Loren,9,0,50,41
1658061037579,CSE 15L,A02,083655,Morris; Justin Loren,11,0,50,39
1658061043604,CSE 20,A01,083657,Tran; Khoa Dang,39,0,80,41
1658061049634,CSE 21,A01,095574,Bach; Quang Tran,23,0,48,25
1658061055664,CSE 30,A01,083084,Eldon; John,8,0,80,72
1658061055664,CSE 30,B01,095061,Bhaskar; Nishant,9,0,50,41
1658061061700,CSE 100,A01,083659,Cao; Yingjun,5,4,70,65
1658061067735,CSE 134B,A01,083661,Powell; Thomas Allan,25,0,100,75
1658061073766,CSE 140,A01,083663,Gungor; Onat,17,0,85,68
1658061079796,CSE 140L,A01,083088,Eldon; John,23,0,100,77
1658061085821,CSE 175,A01,083665,Kumar; Rakesh,3,0,25,22
1658061091851,CSE 190,A00,092507,Dubnov; Shlomo,8,0,20,12
1658061097892,ECE 45,A01,083139,Congero; Spencer William,7,0,75,68
1658061103931,ECE 65,A50,083695,Saad; Andrew S,12,0,30,18
1658061103931,ECE 65,A51,095125,Saad; Andrew S,24,0,26,2
1658061109962,ECE 109,A01,091882,Touri; Behrouz,21,0,70,49
1658061115987,ECE 180,A00,083140,Abi Samra; Nicholas Camill,1,0,30,29
1658061115987,ECE 180,B00,083141,Abi Samra; Nicholas Camill,0,0,30,30
1658061122017,MATH 10A,A01,083735,Patchell; Gregory David,2,0,30,28
1658061122017,MATH 10A,A02,083736,Patchell; Gregory David,20,0,30,10
1658061122017,MATH 10A,A03,083737,Patchell; Gregory David,16,0,30,14
1658061128061,MATH 10B,A01,083207,Lim; Seonhee,9,0,34,25
1658061128061,MATH 10B,A02,083208,Lim; Seonhee,10,0,35,25
1658061128061,MATH 10B,A03,093472,Lim; Seonhee,7,0,34,27
1658061128061,MATH 10B,B01,083739,Sinha; Shubham,14,0,30,16
1658061134101,MATH 18,A01,083743,Cinel; Cameron Alexander,9,0,30,21
1658061134101,MATH 18,A02,083744,Cinel; Cameron Alexander,18,0,30,12
1658061134101,MATH 18,A03,083745,Cinel; Cameron Alexander,10,0,30,20
1658061134101,MATH 18,B01,083748,Rideout; David Porter,5,0,37,32
1658061134101,MATH 18,B02,083749,Rideout; David Porter,5,0,36,31
1658061134101,MATH 18,B03,083750,Rideout; David Porter,3,0,37,34
1658061134101,MATH 18,B04,083751,Rideout; David Porter,7,0,36,29
1658061134101,MATH 18,B05,093473,Rideout; David Porter,7,0,36,29
1658061134101,MATH 18,B06,093474,Rideout; David Porter,6,0,36,30
1658061140134,MATH 20A,A01,083754,Zheng; Zequn,14,0,40,26
1658061146162,MATH 20B,A01,083756,Briones; Jor-el Thomas Caparas,4,0,36,32
1658061146162,MATH 20B,A02,083757,Briones; Jor-el Thomas Caparas,1,0,36,35
1658061146162,MATH 20B,A03,093475,Briones; Jor-el Thomas Caparas,3,0,36,33
1658061152189,MATH 20C,A01,083760,Briones; Jor-el Thomas Caparas,1,0,35,34
1658061152189,MATH 20C,A02,083761,Briones; Jor-el Thomas Caparas,8,0,35,27
1658061152189,MATH 20C,A03,093476,Briones; Jor-el Thomas Caparas,0,1,36,36
1658061152189,MATH 20C,B01,083762,Bach; Quang Tran,1,0,30,29
1658061158221,MATH 20D,A01,083765,Tran; Brian Kha,5,0,30,25
1658061158221,MATH 20D,A02,083766,Tran; Brian Kha,5,0,30,25
1658061158221,MATH 20D,A03,083767,Tran; Brian Kha,6,0,30,24
1658061164247,MATH 20E,A01,083771,Ganguly; Soumya,12,0,32,20
1658061164247,MATH 20E,A02,083772,Ganguly; Soumya,7,0,32,25
1658061164247,MATH 20E,B01,083773,Ciotti; Benjamin,20,0,35,15
1658061164247,MATH 20E,B02,083774,Ciotti; Benjamin,18,0,35,17
1658061170276,MATH 103A,A01,083777,Greenfeld; Be'Eri,6,0,36,30
1658061170276,MATH 103A,A02,083778,Greenfeld; Be'Eri,5,0,36,31
1658061170276,MATH 103A,A03,093561,Greenfeld; Be'Eri,7,0,36,29
1658061170276,MATH 103A,B01,083779,Greenfeld; Be'Eri,8,0,36,28
1658061170276,MATH 103A,B02,083780,Greenfeld; Be'Eri,4,0,36,32
1658061170276,MATH 103A,B03,093562,Greenfeld; Be'Eri,3,0,36,33
1658061176319,MATH 105,A01,085443,Carter; Anne Toulson,15,0,35,20
1658061176319,MATH 105,A02,093477,Carter; Anne Toulson,20,0,35,15
1658061182355,MATH 109,A01,083213,Ganzberger; Geoffrey Michael,3,0,34,31
1658061182355,MATH 109,A02,083214,Ganzberger; Geoffrey Michael,4,0,34,30
1658061182355,MATH 109,A03,093478,Ganzberger; Geoffrey Michael,2,0,34,32
1658061182355,MATH 109,B01,083215,Ganzberger; Geoffrey Michael,3,0,32,29
1658061182355,MATH 109,B02,083216,Ganzberger; Geoffrey Michael,3,0,32,29
1658061182355,MATH 109,B03,093479,Ganzberger; Geoffrey Michael,8,0,32,24
1658061188394,MATH 142A,A01,083219,Chow; Bennett,7,0,32,25
1658061188394,MATH 142A,A02,083220,Chow; Bennett,10,0,32,22
1658061188394,MATH 142A,A03,093480,Chow; Bennett,9,0,32,23
1658061188394,MATH 142A,B03,093481,Chow; Bennett,8,0,32,24
1658061188394,MATH 142A,B04,093558,Chow; Bennett,14,0,32,18
1658061188394,MATH 142A,B05,093559,Chow; Bennett,7,0,32,25
1658061194428,MATH 193A,A01,083224,Rotar; Vladimir,9,0,34,25
1658061194428,MATH 193A,A02,083225,Rotar; Vladimir,11,0,34,23
1658061194428,MATH 193A,A03,083781,Rotar; Vladimir,5,0,34,29
1658061194428,MATH 193A,A04,083782,Rotar; Vladimir,12,0,34,22
1658061194428,MATH 193A,A05,093482,Rotar; Vladimir,11,0,34,23
1658061200454,MATH 197,001,091859,McAuley; Julian John,9999,0,9999,0
1658061200454,MATH 197,002,095566,Kedlaya; Kiran S.,9997,0,9999,2
1658061200454,MATH 197,003,095567,Xiao; Ming,9999,0,9999,0
1658061200454,MATH 197,004,095571,Perols; Johan Lars,9998,0,9999,1
1658061207527,COGS 9,A01,083615,Shannon; Kyle Michael,11,0,75,64
1658061213557,COGS 11,A01,083617,Boyle; Mary E. T.,23,0,48,25
1658061219586,COGS 13,A01,083071,Bastos; Amalia Pinkusfeld,12,0,71,59
1658061225612,COGS 14A,A01,092681,Semenuks; Arturs,5,1,100,95
1658061231636,COGS 14B,A01,083073,Cheng; Tzu-Han,7,0,63,56
1658061237665,COGS 17,A01,092677,Semenuks; Arturs,7,0,81,74
1658061243697,COGS 100,A01,083619,Allen; Michael Gordon,17,0,70,53
1658061249728,COGS 101A,A01,083621,Davis; Joshua Daniel,9,0,68,59
1658061255755,COGS 101B,A01,091572,Allen; Michael Gordon,14,0,65,51
1658061261781,COGS 101C,A01,083625,Delgado; Tania,17,0,35,18
1658061267806,COGS 107A,A01,083627,Boyle; Mary E. T.,14,0,60,46
1658061273834,COGS 118A,A01,083075,Gupta; Anjum,21,0,76,55
1658061279867,CSE 3,A50,083646,Miranda; Gregory Joseph,24,0,50,26
1658061285898,CSE 8A,A50,083650,Miranda; Gregory Joseph,17,1,56,39
1658061291935,CSE 11,A01,083080,Cao; Yingjun,7,15,40,33
1658061297965,CSE 12,A01,083652,Krause-Levy; Sophia Louisa,30,1,120,90
1658061303996,CSE 15L,A01,083654,Morris; Justin Loren,9,0,50,41
1658061303996,CSE 15L,A02,083655,Morris; Justin Loren,11,0,50,39
1658061310022,CSE 20,A01,083657,Tran; Khoa Dang,39,0,80,41
1658061316052,CSE 21,A01,095574,Bach; Quang Tran,23,0,48,25
1658061322079,CSE 30,A01,083084,Eldon; John,8,0,80,72
1658061322079,CSE 30,B01,095061,Bhaskar; Nishant,9,0,50,41
1658061328109,CSE 100,A01,083659,Cao; Yingjun,5,4,70,65
1658061334134,CSE 134B,A01,083661,Powell; Thomas Allan,25,0,100,75
1658061340160,CSE 140,A01,083663,Gungor; Onat,17,0,85,68
1658061346193,CSE 140L,A01,083088,Eldon; John,23,0,100,77
1658061352220,CSE 175,A01,083665,Kumar; Rakesh,3,0,25,22
1658061358247,CSE 190,A00,092507,Dubnov; Shlomo,8,0,20,12
1658061364280,ECE 45,A01,083139,Congero; Spencer William,7,0,75,68
1658061370306,ECE 65,A50,083695,Saad; Andrew S,12,0,30,18
1658061370306,ECE 65,A51,095125,Saad; Andrew S,24,0,26,2
1658061376427,ECE 109,A01,091882,Touri; Behrouz,21,0,70,49
1658061382452,ECE 180,A00,083140,Abi Samra; Nicholas Camill,1,0,30,29
1658061382452,ECE 180,B00,083141,Abi Samra; Nicholas Camill,0,0,30,30
1658061388485,MATH 10A,A01,083735,Patchell; Gregory David,2,0,30,28
1658061388485,MATH 10A,A02,083736,Patchell; Gregory David,20,0,30,10
1658061388485,MATH 10A,A03,083737,Patchell; Gregory David,16,0,30,14
1658061394512,MATH 10B,A01,083207,Lim; Seonhee,9,0,34,25
1658061394512,MATH 10B,A02,083208,Lim; Seonhee,10,0,35,25
1658061394512,MATH 10B,A03,093472,Lim; Seonhee,7,0,34,27
1658061394512,MATH 10B,B01,083739,Sinha; Shubham,14,0,30,16
1658061400543,MATH 18,A01,083743,Cinel; Cameron Alexander,9,0,30,21
1658061400543,MATH 18,A02,083744,Cinel; Cameron Alexander,18,0,30,12
1658061400543,MATH 18,A03,083745,Cinel; Cameron Alexander,10,0,30,20
1658061400543,MATH 18,B01,083748,Rideout; David Porter,5,0,37,32
1658061400543,MATH 18,B02,083749,Rideout; David Porter,5,0,36,31
1658061400543,MATH 18,B03,083750,Rideout; David Porter,3,0,37,34
1658061400543,MATH 18,B04,083751,Rideout; David Porter,7,0,36,29
1658061400543,MATH 18,B05,093473,Rideout; David Porter,7,0,36,29
1658061400543,MATH 18,B06,093474,Rideout; David Porter,6,0,36,30
1658061406569,MATH 20A,A01,083754,Zheng; Zequn,14,0,40,26
1658061412598,MATH 20B,A01,083756,Briones; Jor-el Thomas Caparas,4,0,36,32
1658061412598,MATH 20B,A02,083757,Briones; Jor-el Thomas Caparas,1,0,36,35
1658061412598,MATH 20B,A03,093475,Briones; Jor-el Thomas Caparas,3,0,36,33
1658061418630,MATH 20C,A01,083760,Briones; Jor-el Thomas Caparas,1,0,35,34
1658061418630,MATH 20C,A02,083761,Briones; Jor-el Thomas Caparas,8,0,35,27
1658061418630,MATH 20C,A03,093476,Briones; Jor-el Thomas Caparas,0,1,36,36
1658061418630,MATH 20C,B01,083762,Bach; Quang Tran,1,0,30,29
1658061424660,MATH 20D,A01,083765,Tran; Brian Kha,5,0,30,25
1658061424660,MATH 20D,A02,083766,Tran; Brian Kha,5,0,30,25
1658061424660,MATH 20D,A03,083767,Tran; Brian Kha,6,0,30,24
1658061430689,MATH 20E,A01,083771,Ganguly; Soumya,12,0,32,20
1658061430689,MATH 20E,A02,083772,Ganguly; Soumya,7,0,32,25
1658061430689,MATH 20E,B01,083773,Ciotti; Benjamin,20,0,35,15
1658061430689,MATH 20E,B02,083774,Ciotti; Benjamin,18,0,35,17
1658061436723,MATH 103A,A01,083777,Greenfeld; Be'Eri,6,0,36,30
1658061436723,MATH 103A,A02,083778,Greenfeld; Be'Eri,5,0,36,31
1658061436723,MATH 103A,A03,093561,Greenfeld; Be'Eri,7,0,36,29
1658061436723,MATH 103A,B01,083779,Greenfeld; Be'Eri,8,0,36,28
1658061436723,MATH 103A,B02,083780,Greenfeld; Be'Eri,4,0,36,32
1658061436723,MATH 103A,B03,093562,Greenfeld; Be'Eri,3,0,36,33
1658061442746,MATH 105,A01,085443,Carter; Anne Toulson,15,0,35,20
1658061442746,MATH 105,A02,093477,Carter; Anne Toulson,20,0,35,15
1658061448771,MATH 109,A01,083213,Ganzberger; Geoffrey Michael,3,0,34,31
1658061448771,MATH 109,A02,083214,Ganzberger; Geoffrey Michael,4,0,34,30
1658061448771,MATH 109,A03,093478,Ganzberger; Geoffrey Michael,2,0,34,32
1658061448771,MATH 109,B01,083215,Ganzberger; Geoffrey Michael,3,0,32,29
1658061448771,MATH 109,B02,083216,Ganzberger; Geoffrey Michael,3,0,32,29
1658061448771,MATH 109,B03,093479,Ganzberger; Geoffrey Michael,8,0,32,24
1658061454795,MATH 142A,A01,083219,Chow; Bennett,7,0,32,25
1658061454795,MATH 142A,A02,083220,Chow; Bennett,10,0,32,22
1658061454795,MATH 142A,A03,093480,Chow; Bennett,9,0,32,23
1658061454795,MATH 142A,B03,093481,Chow; Bennett,8,0,32,24
1658061454795,MATH 142A,B04,093558,Chow; Bennett,14,0,32,18
1658061454795,MATH 142A,B05,093559,Chow; Bennett,7,0,32,25
1658061460818,MATH 193A,A01,083224,Rotar; Vladimir,9,0,34,25
1658061460818,MATH 193A,A02,083225,Rotar; Vladimir,11,0,34,23
1658061460818,MATH 193A,A03,083781,Rotar; Vladimir,5,0,34,29
1658061460818,MATH 193A,A04,083782,Rotar; Vladimir,12,0,34,22
1658061460818,MATH 193A,A05,093482,Rotar; Vladimir,11,0,34,23
1658061466851,MATH 197,001,091859,McAuley; Julian John,9999,0,9999,0
1658061466851,MATH 197,002,095566,Kedlaya; Kiran S.,9997,0,9999,2
1658061466851,MATH 197,003,095567,Xiao; Ming,9999,0,9999,0
1658061466851,MATH 197,004,095571,Perols; Johan Lars,9998,0,9999,1
1658061473914,COGS 9,A01,083615,Shannon; Kyle Michael,11,0,75,64
1658061479938,COGS 11,A01,083617,Boyle; Mary E. T.,23,0,48,25
1658061485965,COGS 13,A01,083071,Bastos; Amalia Pinkusfeld,12,0,71,59
1658061491992,COGS 14A,A01,092681,Semenuks; Arturs,5,1,100,95
1658061498021,COGS 14B,A01,083073,Cheng; Tzu-Han,7,0,63,56
1658061504048,COGS 17,A01,092677,Semenuks; Arturs,7,0,81,74
1658061510075,COGS 100,A01,083619,Allen; Michael Gordon,17,0,70,53
1658061516107,COGS 101A,A01,083621,Davis; Joshua Daniel,9,0,68,59
1658061522135,COGS 101B,A01,091572,Allen; Michael Gordon,14,0,65,51
1658061528169,COGS 101C,A01,083625,Delgado; Tania,17,0,35,18
1658061534195,COGS 107A,A01,083627,Boyle; Mary E. T.,14,0,60,46
1658061540224,COGS 118A,A01,083075,Gupta; Anjum,21,0,76,55
1658061546257,CSE 3,A50,083646,Miranda; Gregory Joseph,24,0,50,26
1658061552288,CSE 8A,A50,083650,Miranda; Gregory Joseph,17,1,56,39
1658061558319,CSE 11,A01,083080,Cao; Yingjun,7,15,40,33
1658061564345,CSE 12,A01,083652,Krause-Levy; Sophia Louisa,30,1,120,90
1658061570379,CSE 15L,A01,083654,Morris; Justin Loren,9,0,50,41
1658061570379,CSE 15L,A02,083655,Morris; Justin Loren,11,0,50,39
1658061576409,CSE 20,A01,083657,Tran; Khoa Dang,39,0,80,41
1658061582440,CSE 21,A01,095574,Bach; Quang Tran,23,0,48,25
1658061588473,CSE 30,A01,083084,Eldon; John,8,0,80,72
1658061588473,CSE 30,B01,095061,Bhaskar; Nishant,9,0,50,41
1658061594498,CSE 100,A01,083659,Cao; Yingjun,5,4,70,65
1658061600523,CSE 134B,A01,083661,Powell; Thomas Allan,25,0,100,75
1658061606556,CSE 140,A01,083663,Gungor; Onat,17,0,85,68
1658061612584,CSE 140L,A01,083088,Eldon; John,23,0,100,77
1658061618613,CSE 175,A01,083665,Kumar; Rakesh,3,0,25,22
1658061624639,CSE 190,A00,092507,Dubnov; Shlomo,8,0,20,12
1658061630667,ECE 45,A01,083139,Congero; Spencer William,7,0,75,68
1658061636698,ECE 65,A50,083695,Saad; Andrew S,12,0,30,18
1658061636698,ECE 65,A51,095125,Saad; Andrew S,24,0,26,2
1658061642723,ECE 109,A01,091882,Touri; Behrouz,21,0,70,49
1658061648752,ECE 180,A00,083140,Abi Samra; Nicholas Camill,1,0,30,29
1658061648752,ECE 180,B00,083141,Abi Samra; Nicholas Camill,0,0,30,30
1658061654785,MATH 10A,A01,083735,Patchell; Gregory David,2,0,30,28
1658061654785,MATH 10A,A02,083736,Patchell; Gregory David,20,0,30,10
1658061654785,MATH 10A,A03,083737,Patchell; Gregory David,16,0,30,14
1658061660811,MATH 10B,A01,083207,Lim; Seonhee,9,0,34,25
1658061660811,MATH 10B,A02,083208,Lim; Seonhee,10,0,35,25
1658061660811,MATH 10B,A03,093472,Lim; Seonhee,7,0,34,27
1658061660811,MATH 10B,B01,083739,Sinha; Shubham,14,0,30,16
1658061666854,MATH 18,A01,083743,Cinel; Cameron Alexander,9,0,30,21
1658061666854,MATH 18,A02,083744,Cinel; Cameron Alexander,18,0,30,12
1658061666854,MATH 18,A03,083745,Cinel; Cameron Alexander,10,0,30,20
1658061666854,MATH 18,B01,083748,Rideout; David Porter,5,0,37,32
1658061666854,MATH 18,B02,083749,Rideout; David Porter,5,0,36,31
1658061666854,MATH 18,B03,083750,Rideout; David Porter,3,0,37,34
1658061666854,MATH 18,B04,083751,Rideout; David Porter,7,0,36,29
1658061666854,MATH 18,B05,093473,Rideout; David Porter,7,0,36,29
1658061666854,MATH 18,B06,093474,Rideout; David Porter,6,0,36,30
1658061672885,MATH 20A,A01,083754,Zheng; Zequn,14,0,40,26
1658061678916,MATH 20B,A01,083756,Briones; Jor-el Thomas Caparas,4,0,36,32
1658061678916,MATH 20B,A02,083757,Briones; Jor-el Thomas Caparas,1,0,36,35
1658061678916,MATH 20B,A03,093475,Briones; Jor-el Thomas Caparas,3,0,36,33
1658061684940,MATH 20C,A01,083760,Briones; Jor-el Thomas Caparas,1,0,35,34
1658061684940,MATH 20C,A02,083761,Briones; Jor-el Thomas Caparas,8,0,35,27
1658061684940,MATH 20C,A03,093476,Briones; Jor-el Thomas Caparas,0,1,36,36
1658061684940,MATH 20C,B01,083762,Bach; Quang Tran,1,0,30,29
1658061690966,MATH 20D,A01,083765,Tran; Brian Kha,5,0,30,25
1658061690966,MATH 20D,A02,083766,Tran; Brian Kha,5,0,30,25
1658061690966,MATH 20D,A03,083767,Tran; Brian Kha,6,0,30,24
1658061697006,MATH 20E,A01,083771,Ganguly; Soumya,12,0,32,20
1658061697006,MATH 20E,A02,083772,Ganguly; Soumya,7,0,32,25
1658061697006,MATH 20E,B01,083773,Ciotti; Benjamin,20,0,35,15
1658061697006,MATH 20E,B02,083774,Ciotti; Benjamin,18,0,35,17
1658061703035,MATH 103A,A01,083777,Greenfeld; Be'Eri,6,0,36,30
1658061703035,MATH 103A,A02,083778,Greenfeld; Be'Eri,5,0,36,31
1658061703035,MATH 103A,A03,093561,Greenfeld; Be'Eri,7,0,36,29
1658061703035,MATH 103A,B01,083779,Greenfeld; Be'Eri,8,0,36,28
1658061703035,MATH 103A,B02,083780,Greenfeld; Be'Eri,4,0,36,32
1658061703035,MATH 103A,B03,093562,Greenfeld; Be'Eri,3,0,36,33
1658061709061,MATH 105,A01,085443,Carter; Anne Toulson,15,0,35,20
1658061709061,MATH 105,A02,093477,Carter; Anne Toulson,20,0,35,15
1658061715093,MATH 109,A01,083213,Ganzberger; Geoffrey Michael,3,0,34,31
1658061715093,MATH 109,A02,083214,Ganzberger; Geoffrey Michael,4,0,34,30
1658061715093,MATH 109,A03,093478,Ganzberger; Geoffrey Michael,2,0,34,32
1658061715093,MATH 109,B01,083215,Ganzberger; Geoffrey Michael,3,0,32,29
1658061715093,MATH 109,B02,083216,Ganzberger; Geoffrey Michael,3,0,32,29
1658061715093,MATH 109,B03,093479,Ganzberger; Geoffrey Michael,8,0,32,24
1658061721127,MATH 142A,A01,083219,Chow; Bennett,7,0,32,25
1658061721127,MATH 142A,A02,083220,Chow; Bennett,10,0,32,22
1658061721127,MATH 142A,A03,093480,Chow; Bennett,9,0,32,23
1658061721127,MATH 142A,B03,093481,Chow; Bennett,8,0,32,24
1658061721127,MATH 142A,B04,093558,Chow; Bennett,14,0,32,18
1658061721127,MATH 142A,B05,093559,Chow; Bennett,7,0,32,25
1658061727161,MATH 193A,A01,083224,Rotar; Vladimir,9,0,34,25
1658061727161,MATH 193A,A02,083225,Rotar; Vladimir,11,0,34,23
1658061727161,MATH 193A,A03,083781,Rotar; Vladimir,5,0,34,29
1658061727161,MATH 193A,A04,083782,Rotar; Vladimir,12,0,34,22
1658061727161,MATH 193A,A05,093482,Rotar; Vladimir,11,0,34,23
1658061733189,MATH 197,001,091859,McAuley; Julian John,9999,0,9999,0
1658061733189,MATH 197,002,095566,Kedlaya; Kiran S.,9997,0,9999,2
1658061733189,MATH 197,003,095567,Xiao; Ming,9999,0,9999,0
1658061733189,MATH 197,004,095571,Perols; Johan Lars,9998,0,9999,1
1658061740255,COGS 9,A01,083615,Shannon; Kyle Michael,11,0,75,64
1658061746290,COGS 11,A01,083617,Boyle; Mary E. T.,23,0,48,25
1658061752315,COGS 13,A01,083071,Bastos; Amalia Pinkusfeld,12,0,71,59
1658061758344,COGS 14A,A01,092681,Semenuks; Arturs,5,1,100,95
1658061764376,COGS 14B,A01,083073,Cheng; Tzu-Han,7,0,63,56
1658061770404,COGS 17,A01,092677,Semenuks; Arturs,7,0,81,74
1658061776430,COGS 100,A01,083619,Allen; Michael Gordon,17,0,70,53
1658061782455,COGS 101A,A01,083621,Davis; Joshua Daniel,9,0,68,59
1658061788481,COGS 101B,A01,091572,Allen; Michael Gordon,14,0,65,51
1658061794506,COGS 101C,A01,083625,Delgado; Tania,17,0,35,18
1658061800531,COGS 107A,A01,083627,Boyle; Mary E. T.,14,0,60,46
1658061806556,COGS 118A,A01,083075,Gupta; Anjum,21,0,76,55
1658061812584,CSE 3,A50,083646,Miranda; Gregory Joseph,24,0,50,26
1658061818614,CSE 8A,A50,083650,Miranda; Gregory Joseph,17,1,56,39
1658061824640,CSE 11,A01,083080,Cao; Yingjun,7,15,40,33
1658061830665,CSE 12,A01,083652,Krause-Levy; Sophia Louisa,30,1,120,90
1658061836691,CSE 15L,A01,083654,Morris; Justin Loren,9,0,50,41
1658061836691,CSE 15L,A02,083655,Morris; Justin Loren,11,0,50,39
1658061842724,CSE 20,A01,083657,Tran; Khoa Dang,39,0,80,41
1658061848749,CSE 21,A01,095574,Bach; Quang Tran,23,0,48,25
1658061854773,CSE 30,A01,083084,Eldon; John,8,0,80,72
1658061854773,CSE 30,B01,095061,Bhaskar; Nishant,9,0,50,41
1658061860799,CSE 100,A01,083659,Cao; Yingjun,5,4,70,65
1658061866830,CSE 134B,A01,083661,Powell; Thomas Allan,25,0,100,75
1658061872855,CSE 140,A01,083663,Gungor; Onat,17,0,85,68
1658061878884,CSE 140L,A01,083088,Eldon; John,23,0,100,77
1658061884910,CSE 175,A01,083665,Kumar; Rakesh,3,0,25,22
1658061890935,CSE 190,A00,092507,Dubnov; Shlomo,8,0,20,12
1658061896966,ECE 45,A01,083139,Congero; Spencer William,7,0,75,68
1658061902991,ECE 65,A50,083695,Saad; Andrew S,12,0,30,18
1658061902991,ECE 65,A51,095125,Saad; Andrew S,24,0,26,2
1658061909019,ECE 109,A01,091882,Touri; Behrouz,21,0,70,49
1658061915047,ECE 180,A00,083140,Abi Samra; Nicholas Camill,1,0,30,29
1658061915047,ECE 180,B00,083141,Abi Samra; Nicholas Camill,0,0,30,30
1658061921079,MATH 10A,A01,083735,Patchell; Gregory David,2,0,30,28
1658061921079,MATH 10A,A02,083736,Patchell; Gregory David,20,0,30,10
1658061921079,MATH 10A,A03,083737,Patchell; Gregory David,16,0,30,14
1658061927107,MATH 10B,A01,083207,Lim; Seonhee,9,0,34,25
1658061927107,MATH 10B,A02,083208,Lim; Seonhee,10,0,35,25
1658061927107,MATH 10B,A03,093472,Lim; Seonhee,7,0,34,27
1658061927107,MATH 10B,B01,083739,Sinha; Shubham,14,0,30,16
1658061933133,MATH 18,A01,083743,Cinel; Cameron Alexander,9,0,30,21
1658061933133,MATH 18,A02,083744,Cinel; Cameron Alexander,18,0,30,12
1658061933133,MATH 18,A03,083745,Cinel; Cameron Alexander,10,0,30,20
1658061933133,MATH 18,B01,083748,Rideout; David Porter,5,0,37,32
1658061933133,MATH 18,B02,083749,Rideout; David Porter,5,0,36,31
1658061933133,MATH 18,B03,083750,Rideout; David Porter,3,0,37,34
1658061933133,MATH 18,B04,083751,Rideout; David Porter,7,0,36,29
1658061933133,MATH 18,B05,093473,Rideout; David Porter,7,0,36,29
1658061933133,MATH 18,B06,093474,Rideout; David Porter,6,0,36,30
1658061939159,MATH 20A,A01,083754,Zheng; Zequn,14,0,40,26
1658061945185,MATH 20B,A01,083756,Briones; Jor-el Thomas Caparas,4,0,36,32
1658061945185,MATH 20B,A02,083757,Briones; Jor-el Thomas Caparas,1,0,36,35
1658061945185,MATH 20B,A03,093475,Briones; Jor-el Thomas Caparas,3,0,36,33
1658061951212,MATH 20C,A01,083760,Briones; Jor-el Thomas Caparas,1,0,35,34
1658061951212,MATH 20C,A02,083761,Briones; Jor-el Thomas Caparas,8,0,35,27
1658061951212,MATH 20C,A03,093476,Briones; Jor-el Thomas Caparas,0,1,36,36
1658061951212,MATH 20C,B01,083762,Bach; Quang Tran,1,0,30,29
1658061957238,MATH 20D,A01,083765,Tran; Brian Kha,5,0,30,25
1658061957238,MATH 20D,A02,083766,Tran; Brian Kha,5,0,30,25
1658061957238,MATH 20D,A03,083767,Tran; Brian Kha,6,0,30,24
1658061963264,MATH 20E,A01,083771,Ganguly; Soumya,12,0,32,20
1658061963264,MATH 20E,A02,083772,Ganguly; Soumya,7,0,32,25
1658061963264,MATH 20E,B01,083773,Ciotti; Benjamin,20,0,35,15
1658061963264,MATH 20E,B02,083774,Ciotti; Benjamin,18,0,35,17
1658061969297,MATH 103A,A01,083777,Greenfeld; Be'Eri,6,0,36,30
1658061969297,MATH 103A,A02,083778,Greenfeld; Be'Eri,5,0,36,31
1658061969297,MATH 103A,A03,093561,Greenfeld; Be'Eri,7,0,36,29
1658061969297,MATH 103A,B01,083779,Greenfeld; Be'Eri,8,0,36,28
1658061969297,MATH 103A,B02,083780,Greenfeld; Be'Eri,4,0,36,32
1658061969297,MATH 103A,B03,093562,Greenfeld; Be'Eri,3,0,36,33
1658061975392,MATH 105,A01,085443,Carter; Anne Toulson,15,0,35,20
1658061975392,MATH 105,A02,093477,Carter; Anne Toulson,20,0,35,15
1658061981425,MATH 109,A01,083213,Ganzberger; Geoffrey Michael,3,0,34,31
1658061981425,MATH 109,A02,083214,Ganzberger; Geoffrey Michael,4,0,34,30
1658061981425,MATH 109,A03,093478,Ganzberger; Geoffrey Michael,2,0,34,32
1658061981425,MATH 109,B01,083215,Ganzberger; Geoffrey Michael,3,0,32,29
1658061981425,MATH 109,B02,083216,Ganzberger; Geoffrey Michael,3,0,32,29
1658061981425,MATH 109,B03,093479,Ganzberger; Geoffrey Michael,8,0,32,24
1658061987459,MATH 142A,A01,083219,Chow; Bennett,7,0,32,25
1658061987459,MATH 142A,A02,083220,Chow; Bennett,10,0,32,22
1658061987459,MATH 142A,A03,093480,Chow; Bennett,9,0,32,23
1658061987459,MATH 142A,B03,093481,Chow; Bennett,8,0,32,24
1658061987459,MATH 142A,B04,093558,Chow; Bennett,14,0,32,18
1658061987459,MATH 142A,B05,093559,Chow; Bennett,7,0,32,25
1658061993492,MATH 193A,A01,083224,Rotar; Vladimir,9,0,34,25
1658061993492,MATH 193A,A02,083225,Rotar; Vladimir,11,0,34,23
1658061993492,MATH 193A,A03,083781,Rotar; Vladimir,5,0,34,29
1658061993492,MATH 193A,A04,083782,Rotar; Vladimir,12,0,34,22
1658061993492,MATH 193A,A05,093482,Rotar; Vladimir,11,0,34,23
1658061999524,MATH 197,001,091859,McAuley; Julian John,9999,0,9999,0
1658061999524,MATH 197,002,095566,Kedlaya; Kiran S.,9997,0,9999,2
1658061999524,MATH 197,003,095567,Xiao; Ming,9999,0,9999,0
1658061999524,MATH 197,004,095571,Perols; Johan Lars,9998,0,9999,1
1658062006583,COGS 9,A01,083615,Shannon; Kyle Michael,11,0,75,64
1658062012614,COGS 11,A01,083617,Boyle; Mary E. T.,23,0,48,25
1658062018641,COGS 13,A01,083071,Bastos; Amalia Pinkusfeld,12,0,71,59
1658062024668,COGS 14A,A01,092681,Semenuks; Arturs,5,1,100,95
1658062030695,COGS 14B,A01,083073,Cheng; Tzu-Han,7,0,63,56
1658062036723,COGS 17,A01,092677,Semenuks; Arturs,7,0,81,74
1658062042750,COGS 100,A01,083619,Allen; Michael Gordon,17,0,70,53
1658062048781,COGS 101A,A01,083621,Davis; Joshua Daniel,9,0,68,59
1658062054811,COGS 101B,A01,091572,Allen; Michael Gordon,14,0,65,51
1658062060839,COGS 101C,A01,083625,Delgado; Tania,17,0,35,18
1658062066863,COGS 107A,A01,083627,Boyle; Mary E. T.,14,0,60,46
1658062072888,COGS 118A,A01,083075,Gupta; Anjum,21,0,76,55
1658062078919,CSE 3,A50,083646,Miranda; Gregory Joseph,24,0,50,26
1658062084944,CSE 8A,A50,083650,Miranda; Gregory Joseph,17,1,56,39
1658062090971,CSE 11,A01,083080,Cao; Yingjun,7,15,40,33
1658062097001,CSE 12,A01,083652,Krause-Levy; Sophia Louisa,30,1,120,90
1658062103028,CSE 15L,A01,083654,Morris; Justin Loren,9,0,50,41
1658062103028,CSE 15L,A02,083655,Morris; Justin Loren,11,0,50,39
1658062109058,CSE 20,A01,083657,Tran; Khoa Dang,39,0,80,41
1658062115090,CSE 21,A01,095574,Bach; Quang Tran,23,0,48,25
1658062121118,CSE 30,A01,083084,Eldon; John,8,0,80,72
1658062121118,CSE 30,B01,095061,Bhaskar; Nishant,9,0,50,41
1658062127153,CSE 100,A01,083659,Cao; Yingjun,5,4,70,65
1658062133184,CSE 134B,A01,083661,Powell; Thomas Allan,25,0,100,75
1658062139218,CSE 140,A01,083663,Gungor; Onat,17,0,85,68
1658062145246,CSE 140L,A01,083088,Eldon; John,23,0,100,77
1658062151274,CSE 175,A01,083665,Kumar; Rakesh,3,0,25,22
1658062157319,CSE 190,A00,092507,Dubnov; Shlomo,8,0,20,12
1658062163352,ECE 45,A01,083139,Congero; Spencer William,7,0,75,68
1658062169381,ECE 65,A50,083695,Saad; Andrew S,12,0,30,18
1658062169381,ECE 65,A51,095125,Saad; Andrew S,24,0,26,2
1658062175408,ECE 109,A01,091882,Touri; Behrouz,21,0,70,49
1658062181439,ECE 180,A00,083140,Abi Samra; Nicholas Camill,1,0,30,29
1658062181439,ECE 180,B00,083141,Abi Samra; Nicholas Camill,0,0,30,30
1658062187473,MATH 10A,A01,083735,Patchell; Gregory David,2,0,30,28
1658062187473,MATH 10A,A02,083736,Patchell; Gregory David,20,0,30,10
1658062187473,MATH 10A,A03,083737,Patchell; Gregory David,16,0,30,14
1658062193503,MATH 10B,A01,083207,Lim; Seonhee,9,0,34,25
1658062193503,MATH 10B,A02,083208,Lim; Seonhee,10,0,35,25
1658062193503,MATH 10B,A03,093472,Lim; Seonhee,7,0,34,27
1658062193503,MATH 10B,B01,083739,Sinha; Shubham,14,0,30,16
1658062199535,MATH 18,A01,083743,Cinel; Cameron Alexander,9,0,30,21
1658062199535,MATH 18,A02,083744,Cinel; Cameron Alexander,18,0,30,12
1658062199535,MATH 18,A03,083745,Cinel; Cameron Alexander,10,0,30,20
1658062199535,MATH 18,B01,083748,Rideout; David Porter,5,0,37,32
1658062199535,MATH 18,B02,083749,Rideout; David Porter,5,0,36,31
1658062199535,MATH 18,B03,083750,Rideout; David Porter,3,0,37,34
1658062199535,MATH 18,B04,083751,Rideout; David Porter,7,0,36,29
1658062199535,MATH 18,B05,093473,Rideout; David Porter,7,0,36,29
1658062199535,MATH 18,B06,093474,Rideout; David Porter,6,0,36,30
1658062205567,MATH 20A,A01,083754,Zheng; Zequn,14,0,40,26
1658062211610,MATH 20B,A01,083756,Briones; Jor-el Thomas Caparas,4,0,36,32
1658062211610,MATH 20B,A02,083757,Briones; Jor-el Thomas Caparas,1,0,36,35
1658062211610,MATH 20B,A03,093475,Briones; Jor-el Thomas Caparas,3,0,36,33
1658062217641,MATH 20C,A01,083760,Briones; Jor-el Thomas Caparas,1,0,35,34
1658062217641,MATH 20C,A02,083761,Briones; Jor-el Thomas Caparas,8,0,35,27
1658062217641,MATH 20C,A03,093476,Briones; Jor-el Thomas Caparas,0,1,36,36
1658062217641,MATH 20C,B01,083762,Bach; Quang Tran,1,0,30,29
1658062223678,MATH 20D,A01,083765,Tran; Brian Kha,5,0,30,25
1658062223678,MATH 20D,A02,083766,Tran; Brian Kha,5,0,30,25
1658062223678,MATH 20D,A03,083767,Tran; Brian Kha,6,0,30,24
1658062229707,MATH 20E,A01,083771,Ganguly; Soumya,12,0,32,20
1658062229707,MATH 20E,A02,083772,Ganguly; Soumya,7,0,32,25
1658062229707,MATH 20E,B01,083773,Ciotti; Benjamin,20,0,35,15
1658062229707,MATH 20E,B02,083774,Ciotti; Benjamin,18,0,35,17
1658062235738,MATH 103A,A01,083777,Greenfeld; Be'Eri,6,0,36,30
1658062235738,MATH 103A,A02,083778,Greenfeld; Be'Eri,5,0,36,31
1658062235738,MATH 103A,A03,093561,Greenfeld; Be'Eri,7,0,36,29
1658062235738,MATH 103A,B01,083779,Greenfeld; Be'Eri,8,0,36,28
1658062235738,MATH 103A,B02,083780,Greenfeld; Be'Eri,4,0,36,32
1658062235738,MATH 103A,B03,093562,Greenfeld; Be'Eri,3,0,36,33
1658062241767,MATH 105,A01,085443,Carter; Anne Toulson,15,0,35,20
1658062241767,MATH 105,A02,093477,Carter; Anne Toulson,20,0,35,15
1658062247796,MATH 109,A01,083213,Ganzberger; Geoffrey Michael,3,0,34,31
1658062247796,MATH 109,A02,083214,Ganzberger; Geoffrey Michael,4,0,34,30
1658062247796,MATH 109,A03,093478,Ganzberger; Geoffrey Michael,2,0,34,32
1658062247796,MATH 109,B01,083215,Ganzberger; Geoffrey Michael,3,0,32,29
1658062247796,MATH 109,B02,083216,Ganzberger; Geoffrey Michael,3,0,32,29
1658062247796,MATH 109,B03,093479,Ganzberger; Geoffrey Michael,8,0,32,24
1658062253825,MATH 142A,A01,083219,Chow; Bennett,7,0,32,25
1658062253825,MATH 142A,A02,083220,Chow; Bennett,10,0,32,22
1658062253825,MATH 142A,A03,093480,Chow; Bennett,9,0,32,23
1658062253825,MATH 142A,B03,093481,Chow; Bennett,8,0,32,24
1658062253825,MATH 142A,B04,093558,Chow; Bennett,14,0,32,18
1658062253825,MATH 142A,B05,093559,Chow; Bennett,7,0,32,25
1658062259858,MATH 193A,A01,083224,Rotar; Vladimir,9,0,34,25
1658062259858,MATH 193A,A02,083225,Rotar; Vladimir,11,0,34,23
1658062259858,MATH 193A,A03,083781,Rotar; Vladimir,5,0,34,29
1658062259858,MATH 193A,A04,083782,Rotar; Vladimir,12,0,34,22
1658062259858,MATH 193A,A05,093482,Rotar; Vladimir,11,0,34,23
1658062265886,MATH 197,001,091859,McAuley; Julian John,9999,0,9999,0
1658062265886,MATH 197,002,095566,Kedlaya; Kiran S.,9997,0,9999,2
1658062265886,MATH 197,003,095567,Xiao; Ming,9999,0,9999,0
1658062265886,MATH 197,004,095571,Perols; Johan Lars,9998,0,9999,1
1658062272971,COGS 9,A01,083615,Shannon; Kyle Michael,11,0,75,64
1658062278996,COGS 11,A01,083617,Boyle; Mary E. T.,23,0,48,25
1658062285023,COGS 13,A01,083071,Bastos; Amalia Pinkusfeld,12,0,71,59
1658062291051,COGS 14A,A01,092681,Semenuks; Arturs,5,1,100,95
1658062297084,COGS 14B,A01,083073,Cheng; Tzu-Han,7,0,63,56
1658062303115,COGS 17,A01,092677,Semenuks; Arturs,7,0,81,74
1658062309141,COGS 100,A01,083619,Allen; Michael Gordon,17,0,70,53
1658062315168,COGS 101A,A01,083621,Davis; Joshua Daniel,9,0,68,59
1658062321196,COGS 101B,A01,091572,Allen; Michael Gordon,14,0,65,51
1658062327224,COGS 101C,A01,083625,Delgado; Tania,17,0,35,18
1658062333251,COGS 107A,A01,083627,Boyle; Mary E. T.,14,0,60,46
1658062339284,COGS 118A,A01,083075,Gupta; Anjum,21,0,76,55
1658062345313,CSE 3,A50,083646,Miranda; Gregory Joseph,24,0,50,26
1658062351339,CSE 8A,A50,083650,Miranda; Gregory Joseph,17,1,56,39
1658062357365,CSE 11,A01,083080,Cao; Yingjun,7,15,40,33
1658062363392,CSE 12,A01,083652,Krause-Levy; Sophia Louisa,30,1,120,90
1658062369434,CSE 15L,A01,083654,Morris; Justin Loren,9,0,50,41
1658062369434,CSE 15L,A02,083655,Morris; Justin Loren,11,0,50,39
1658062375465,CSE 20,A01,083657,Tran; Khoa Dang,39,0,80,41
1658062381492,CSE 21,A01,095574,Bach; Quang Tran,23,0,48,25
1658062387520,CSE 30,A01,083084,Eldon; John,8,0,80,72
1658062387520,CSE 30,B01,095061,Bhaskar; Nishant,9,0,50,41
1658062393548,CSE 100,A01,083659,Cao; Yingjun,5,4,70,65
1658062399575,CSE 134B,A01,083661,Powell; Thomas Allan,25,0,100,75
1658062405607,CSE 140,A01,083663,Gungor; Onat,17,0,85,68
1658062411636,CSE 140L,A01,083088,Eldon; John,23,0,100,77
1658062417662,CSE 175,A01,083665,Kumar; Rakesh,3,0,25,22
1658062423696,CSE 190,A00,092507,Dubnov; Shlomo,8,0,20,12
1658062429725,ECE 45,A01,083139,Congero; Spencer William,7,0,75,68
1658062435758,ECE 65,A50,083695,Saad; Andrew S,12,0,30,18
1658062435758,ECE 65,A51,095125,Saad; Andrew S,24,0,26,2
1658062441785,ECE 109,A01,091882,Touri; Behrouz,21,0,70,49
1658062447811,ECE 180,A00,083140,Abi Samra; Nicholas Camill,1,0,30,29
1658062447811,ECE 180,B00,083141,Abi Samra; Nicholas Camill,0,0,30,30
1658062453842,MATH 10A,A01,083735,Patchell; Gregory David,2,0,30,28
1658062453842,MATH 10A,A02,083736,Patchell; Gregory David,20,0,30,10
1658062453842,MATH 10A,A03,083737,Patchell; Gregory David,16,0,30,14
1658062459869,MATH 10B,A01,083207,Lim; Seonhee,9,0,34,25
1658062459869,MATH 10B,A02,083208,Lim; Seonhee,10,0,35,25
1658062459869,MATH 10B,A03,093472,Lim; Seonhee,7,0,34,27
1658062459869,MATH 10B,B01,083739,Sinha; Shubham,14,0,30,16
1658062465900,MATH 18,A01,083743,Cinel; Cameron Alexander,9,0,30,21
1658062465900,MATH 18,A02,083744,Cinel; Cameron Alexander,18,0,30,12
1658062465900,MATH 18,A03,083745,Cinel; Cameron Alexander,10,0,30,20
1658062465900,MATH 18,B01,083748,Rideout; David Porter,5,0,37,32
1658062465900,MATH 18,B02,083749,Rideout; David Porter,5,0,36,31
1658062465900,MATH 18,B03,083750,Rideout; David Porter,3,0,37,34
1658062465900,MATH 18,B04,083751,Rideout; David Porter,7,0,36,29
1658062465900,MATH 18,B05,093473,Rideout; David Porter,7,0,36,29
1658062465900,MATH 18,B06,093474,Rideout; David Porter,6,0,36,30
1658062471931,MATH 20A,A01,083754,Zheng; Zequn,14,0,40,26
1658062477961,MATH 20B,A01,083756,Briones; Jor-el Thomas Caparas,4,0,36,32
1658062477961,MATH 20B,A02,083757,Briones; Jor-el Thomas Caparas,1,0,36,35
1658062477961,MATH 20B,A03,093475,Briones; Jor-el Thomas Caparas,3,0,36,33
1658062483985,MATH 20C,A01,083760,Briones; Jor-el Thomas Caparas,1,0,35,34
1658062483985,MATH 20C,A02,083761,Briones; Jor-el Thomas Caparas,8,0,35,27
1658062483985,MATH 20C,A03,093476,Briones; Jor-el Thomas Caparas,0,1,36,36
1658062483985,MATH 20C,B01,083762,Bach; Quang Tran,1,0,30,29
1658062490009,MATH 20D,A01,083765,Tran; Brian Kha,5,0,30,25
1658062490009,MATH 20D,A02,083766,Tran; Brian Kha,5,0,30,25
1658062490009,MATH 20D,A03,083767,Tran; Brian Kha,6,0,30,24
1658062496038,MATH 20E,A01,083771,Ganguly; Soumya,12,0,32,20
1658062496038,MATH 20E,A02,083772,Ganguly; Soumya,7,0,32,25
1658062496038,MATH 20E,B01,083773,Ciotti; Benjamin,20,0,35,15
1658062496038,MATH 20E,B02,083774,Ciotti; Benjamin,18,0,35,17
1658062502077,MATH 103A,A01,083777,Greenfeld; Be'Eri,6,0,36,30
1658062502077,MATH 103A,A02,083778,Greenfeld; Be'Eri,5,0,36,31
1658062502077,MATH 103A,A03,093561,Greenfeld; Be'Eri,7,0,36,29
1658062502077,MATH 103A,B01,083779,Greenfeld; Be'Eri,8,0,36,28
1658062502077,MATH 103A,B02,083780,Greenfeld; Be'Eri,4,0,36,32
1658062502077,MATH 103A,B03,093562,Greenfeld; Be'Eri,3,0,36,33
1658062508104,MATH 105,A01,085443,Carter; Anne Toulson,15,0,35,20
1658062508104,MATH 105,A02,093477,Carter; Anne Toulson,20,0,35,15
1658062514132,MATH 109,A01,083213,Ganzberger; Geoffrey Michael,3,0,34,31
1658062514132,MATH 109,A02,083214,Ganzberger; Geoffrey Michael,4,0,34,30
1658062514132,MATH 109,A03,093478,Ganzberger; Geoffrey Michael,2,0,34,32
1658062514132,MATH 109,B01,083215,Ganzberger; Geoffrey Michael,3,0,32,29
1658062514132,MATH 109,B02,083216,Ganzberger; Geoffrey Michael,3,0,32,29
1658062514132,MATH 109,B03,093479,Ganzberger; Geoffrey Michael,8,0,32,24
1658062520167,MATH 142A,A01,083219,Chow; Bennett,7,0,32,25
1658062520167,MATH 142A,A02,083220,Chow; Bennett,10,0,32,22
1658062520167,MATH 142A,A03,093480,Chow; Bennett,9,0,32,23
1658062520167,MATH 142A,B03,093481,Chow; Bennett,8,0,32,24
1658062520167,MATH 142A,B04,093558,Chow; Bennett,14,0,32,18
1658062520167,MATH 142A,B05,093559,Chow; Bennett,7,0,32,25
1658062526194,MATH 193A,A01,083224,Rotar; Vladimir,9,0,34,25
1658062526194,MATH 193A,A02,083225,Rotar; Vladimir,11,0,34,23
1658062526194,MATH 193A,A03,083781,Rotar; Vladimir,5,0,34,29
1658062526194,MATH 193A,A04,083782,Rotar; Vladimir,12,0,34,22
1658062526194,MATH 193A,A05,093482,Rotar; Vladimir,11,0,34,23
1658062532221,MATH 197,001,091859,McAuley; Julian John,9999,0,9999,0
1658062532221,MATH 197,002,095566,Kedlaya; Kiran S.,9997,0,9999,2
1658062532221,MATH 197,003,095567,Xiao; Ming,9999,0,9999,0
1658062532221,MATH 197,004,095571,Perols; Johan Lars,9998,0,9999,1
1658062539306,COGS 9,A01,083615,Shannon; Kyle Michael,11,0,75,64
1658062545335,COGS 11,A01,083617,Boyle; Mary E. T.,23,0,48,25
1658062551361,COGS 13,A01,083071,Bastos; Amalia Pinkusfeld,12,0,71,59
1658062557389,COGS 14A,A01,092681,Semenuks; Arturs,5,1,100,95
1658062563420,COGS 14B,A01,083073,Cheng; Tzu-Han,7,0,63,56
1658062569514,COGS 17,A01,092677,Semenuks; Arturs,7,0,81,74
1658062575546,COGS 100,A01,083619,Allen; Michael Gordon,17,0,70,53
1658062581572,COGS 101A,A01,083621,Davis; Joshua Daniel,9,0,68,59
1658062587598,COGS 101B,A01,091572,Allen; Michael Gordon,14,0,65,51
1658062593641,COGS 101C,A01,083625,Delgado; Tania,17,0,35,18
1658062599669,COGS 107A,A01,083627,Boyle; Mary E. T.,14,0,60,46
1658062605700,COGS 118A,A01,083075,Gupta; Anjum,21,0,76,55
1658062611727,CSE 3,A50,083646,Miranda; Gregory Joseph,24,0,50,26
1658062617755,CSE 8A,A50,083650,Miranda; Gregory Joseph,17,1,56,39
1658062623782,CSE 11,A01,083080,Cao; Yingjun,7,15,40,33
1658062629814,CSE 12,A01,083652,Krause-Levy; Sophia Louisa,30,1,120,90
1658062635847,CSE 15L,A01,083654,Morris; Justin Loren,9,0,50,41
1658062635847,CSE 15L,A02,083655,Morris; Justin Loren,11,0,50,39
1658062641873,CSE 20,A01,083657,Tran; Khoa Dang,39,0,80,41
1658062647903,CSE 21,A01,095574,Bach; Quang Tran,23,0,48,25
1658062653945,CSE 30,A01,083084,Eldon; John,8,0,80,72
1658062653945,CSE 30,B01,095061,Bhaskar; Nishant,9,0,50,41
1658062659981,CSE 100,A01,083659,Cao; Yingjun,5,4,70,65
1658062666005,CSE 134B,A01,083661,Powell; Thomas Allan,25,0,100,75
1658062672034,CSE 140,A01,083663,Gungor; Onat,17,0,85,68
1658062678059,CSE 140L,A01,083088,Eldon; John,23,0,100,77
1658062684085,CSE 175,A01,083665,Kumar; Rakesh,3,0,25,22
1658062690118,CSE 190,A00,092507,Dubnov; Shlomo,8,0,20,12
1658062696147,ECE 45,A01,083139,Congero; Spencer William,7,0,75,68
1658062702176,ECE 65,A50,083695,Saad; Andrew S,12,0,30,18
1658062702176,ECE 65,A51,095125,Saad; Andrew S,24,0,26,2
1658062708202,ECE 109,A01,091882,Touri; Behrouz,21,0,70,49
1658062714231,ECE 180,A00,083140,Abi Samra; Nicholas Camill,1,0,30,29
1658062714231,ECE 180,B00,083141,Abi Samra; Nicholas Camill,0,0,30,30
1658062720257,MATH 10A,A01,083735,Patchell; Gregory David,2,0,30,28
1658062720257,MATH 10A,A02,083736,Patchell; Gregory David,20,0,30,10
1658062720257,MATH 10A,A03,083737,Patchell; Gregory David,16,0,30,14
1658062726286,MATH 10B,A01,083207,Lim; Seonhee,9,0,34,25
1658062726286,MATH 10B,A02,083208,Lim; Seonhee,10,0,35,25
1658062726286,MATH 10B,A03,093472,Lim; Seonhee,7,0,34,27
1658062726286,MATH 10B,B01,083739,Sinha; Shubham,14,0,30,16
1658062732325,MATH 18,A01,083743,Cinel; Cameron Alexander,9,0,30,21
1658062732325,MATH 18,A02,083744,Cinel; Cameron Alexander,18,0,30,12
1658062732325,MATH 18,A03,083745,Cinel; Cameron Alexander,10,0,30,20
1658062732325,MATH 18,B01,083748,Rideout; David Porter,5,0,37,32
1658062732325,MATH 18,B02,083749,Rideout; David Porter,5,0,36,31
1658062732325,MATH 18,B03,083750,Rideout; David Porter,3,0,37,34
1658062732325,MATH 18,B04,083751,Rideout; David Porter,7,0,36,29
1658062732325,MATH 18,B05,093473,Rideout; David Porter,7,0,36,29
1658062732325,MATH 18,B06,093474,Rideout; David Porter,6,0,36,30
1658062738351,MATH 20A,A01,083754,Zheng; Zequn,14,0,40,26
1658062744384,MATH 20B,A01,083756,Briones; Jor-el Thomas Caparas,4,0,36,32
1658062744384,MATH 20B,A02,083757,Briones; Jor-el Thomas Caparas,1,0,36,35
1658062744384,MATH 20B,A03,093475,Briones; Jor-el Thomas Caparas,3,0,36,33
1658062750420,MATH 20C,A01,083760,Briones; Jor-el Thomas Caparas,1,0,35,34
1658062750420,MATH 20C,A02,083761,Briones; Jor-el Thomas Caparas,8,0,35,27
1658062750420,MATH 20C,A03,093476,Briones; Jor-el Thomas Caparas,0,1,36,36
1658062750420,MATH 20C,B01,083762,Bach; Quang Tran,1,0,30,29
1658062756451,MATH 20D,A01,083765,Tran; Brian Kha,5,0,30,25
1658062756451,MATH 20D,A02,083766,Tran; Brian Kha,5,0,30,25
1658062756451,MATH 20D,A03,083767,Tran; Brian Kha,6,0,30,24
1658062762489,MATH 20E,A01,083771,Ganguly; Soumya,12,0,32,20
1658062762489,MATH 20E,A02,083772,Ganguly; Soumya,7,0,32,25
1658062762489,MATH 20E,B01,083773,Ciotti; Benjamin,20,0,35,15
1658062762489,MATH 20E,B02,083774,Ciotti; Benjamin,18,0,35,17
1658062768516,MATH 103A,A01,083777,Greenfeld; Be'Eri,6,0,36,30
1658062768516,MATH 103A,A02,083778,Greenfeld; Be'Eri,5,0,36,31
1658062768516,MATH 103A,A03,093561,Greenfeld; Be'Eri,7,0,36,29
1658062768516,MATH 103A,B01,083779,Greenfeld; Be'Eri,8,0,36,28
1658062768516,MATH 103A,B02,083780,Greenfeld; Be'Eri,4,0,36,32
1658062768516,MATH 103A,B03,093562,Greenfeld; Be'Eri,3,0,36,33
1658062774542,MATH 105,A01,085443,Carter; Anne Toulson,15,0,35,20
1658062774542,MATH 105,A02,093477,Carter; Anne Toulson,20,0,35,15
1658062780574,MATH 109,A01,083213,Ganzberger; Geoffrey Michael,3,0,34,31
1658062780574,MATH 109,A02,083214,Ganzberger; Geoffrey Michael,4,0,34,30
1658062780574,MATH 109,A03,093478,Ganzberger; Geoffrey Michael,2,0,34,32
1658062780574,MATH 109,B01,083215,Ganzberger; Geoffrey Michael,3,0,32,29
1658062780574,MATH 109,B02,083216,Ganzberger; Geoffrey Michael,3,0,32,29
1658062780574,MATH 109,B03,093479,Ganzberger; Geoffrey Michael,8,0,32,24
1658062786603,MATH 142A,A01,083219,Chow; Bennett,7,0,32,25
1658062786603,MATH 142A,A02,083220,Chow; Bennett,10,0,32,22
1658062786603,MATH 142A,A03,093480,Chow; Bennett,9,0,32,23
1658062786603,MATH 142A,B03,093481,Chow; Bennett,8,0,32,24
1658062786603,MATH 142A,B04,093558,Chow; Bennett,14,0,32,18
1658062786603,MATH 142A,B05,093559,Chow; Bennett,7,0,32,25
1658062792634,MATH 193A,A01,083224,Rotar; Vladimir,9,0,34,25
1658062792634,MATH 193A,A02,083225,Rotar; Vladimir,11,0,34,23
1658062792634,MATH 193A,A03,083781,Rotar; Vladimir,5,0,34,29
1658062792634,MATH 193A,A04,083782,Rotar; Vladimir,12,0,34,22
1658062792634,MATH 193A,A05,093482,Rotar; Vladimir,11,0,34,23
1658062798665,MATH 197,001,091859,McAuley; Julian John,9999,0,9999,0
1658062798665,MATH 197,002,095566,Kedlaya; Kiran S.,9997,0,9999,2
1658062798665,MATH 197,003,095567,Xiao; Ming,9999,0,9999,0
1658062798665,MATH 197,004,095571,Perols; Johan Lars,9998,0,9999,1
1658062805741,COGS 9,A01,083615,Shannon; Kyle Michael,11,0,75,64
1658062811777,COGS 11,A01,083617,Boyle; Mary E. T.,23,0,48,25
1658062817803,COGS 13,A01,083071,Bastos; Amalia Pinkusfeld,12,0,71,59
1658062823833,COGS 14A,A01,092681,Semenuks; Arturs,5,1,100,95
1658062829859,COGS 14B,A01,083073,Cheng; Tzu-Han,7,0,63,56
1658062835887,COGS 17,A01,092677,Semenuks; Arturs,7,0,81,74
1658062841913,COGS 100,A01,083619,Allen; Michael Gordon,17,0,70,53
1658062847936,COGS 101A,A01,083621,Davis; Joshua Daniel,9,0,68,59
1658062853963,COGS 101B,A01,091572,Allen; Michael Gordon,14,0,65,51
1658062859994,COGS 101C,A01,083625,Delgado; Tania,17,0,35,18
1658062866029,COGS 107A,A01,083627,Boyle; Mary E. T.,14,0,60,46
1658062872056,COGS 118A,A01,083075,Gupta; Anjum,21,0,76,55
1658062878091,CSE 3,A50,083646,Miranda; Gregory Joseph,24,0,50,26
1658062884120,CSE 8A,A50,083650,Miranda; Gregory Joseph,17,1,56,39
1658062890151,CSE 11,A01,083080,Cao; Yingjun,7,15,40,33
1658062896177,CSE 12,A01,083652,Krause-Levy; Sophia Louisa,30,1,120,90
1658062902202,CSE 15L,A01,083654,Morris; Justin Loren,9,0,50,41
1658062902202,CSE 15L,A02,083655,Morris; Justin Loren,11,0,50,39
1658062908229,CSE 20,A01,083657,Tran; Khoa Dang,39,0,80,41
1658062914263,CSE 21,A01,095574,Bach; Quang Tran,23,0,48,25
1658062920291,CSE 30,A01,083084,Eldon; John,8,0,80,72
1658062920291,CSE 30,B01,095061,Bhaskar; Nishant,9,0,50,41
1658062926319,CSE 100,A01,083659,Cao; Yingjun,5,4,70,65
1658062932349,CSE 134B,A01,083661,Powell; Thomas Allan,25,0,100,75
1658062938375,CSE 140,A01,083663,Gungor; Onat,17,0,85,68
1658062944400,CSE 140L,A01,083088,Eldon; John,23,0,100,77
1658062950430,CSE 175,A01,083665,Kumar; Rakesh,3,0,25,22
1658062956456,CSE 190,A00,092507,Dubnov; Shlomo,8,0,20,12
1658062962488,ECE 45,A01,083139,Congero; Spencer William,7,0,75,68
1658062968517,ECE 65,A50,083695,Saad; Andrew S,12,0,30,18
1658062968517,ECE 65,A51,095125,Saad; Andrew S,24,0,26,2
1658062974542,ECE 109,A01,091882,Touri; Behrouz,21,0,70,49
1658062980573,ECE 180,A00,083140,Abi Samra; Nicholas Camill,1,0,30,29
1658062980573,ECE 180,B00,083141,Abi Samra; Nicholas Camill,0,0,30,30
1658062986599,MATH 10A,A01,083735,Patchell; Gregory David,2,0,30,28
1658062986599,MATH 10A,A02,083736,Patchell; Gregory David,20,0,30,10
1658062986599,MATH 10A,A03,083737,Patchell; Gregory David,16,0,30,14
1658062992626,MATH 10B,A01,083207,Lim; Seonhee,9,0,34,25
1658062992626,MATH 10B,A02,083208,Lim; Seonhee,10,0,35,25
1658062992626,MATH 10B,A03,093472,Lim; Seonhee,7,0,34,27
1658062992626,MATH 10B,B01,083739,Sinha; Shubham,14,0,30,16
1658062998653,MATH 18,A01,083743,Cinel; Cameron Alexander,9,0,30,21
1658062998653,MATH 18,A02,083744,Cinel; Cameron Alexander,18,0,30,12
1658062998653,MATH 18,A03,083745,Cinel; Cameron Alexander,10,0,30,20
1658062998653,MATH 18,B01,083748,Rideout; David Porter,5,0,37,32
1658062998653,MATH 18,B02,083749,Rideout; David Porter,5,0,36,31
1658062998653,MATH 18,B03,083750,Rideout; David Porter,3,0,37,34
1658062998653,MATH 18,B04,083751,Rideout; David Porter,7,0,36,29
1658062998653,MATH 18,B05,093473,Rideout; David Porter,7,0,36,29
1658062998653,MATH 18,B06,093474,Rideout; David Porter,6,0,36,30
1658063004683,MATH 20A,A01,083754,Zheng; Zequn,14,0,40,26
1658063010715,MATH 20B,A01,083756,Briones; Jor-el Thomas Caparas,4,0,36,32
1658063010715,MATH 20B,A02,083757,Briones; Jor-el Thomas Caparas,1,0,36,35
1658063010715,MATH 20B,A03,093475,Briones; Jor-el Thomas Caparas,3,0,36,33
1658063016745,MATH 20C,A01,083760,Briones; Jor-el Thomas Caparas,1,0,35,34
1658063016745,MATH 20C,A02,083761,Briones; Jor-el Thomas Caparas,8,0,35,27
1658063016745,MATH 20C,A03,093476,Briones; Jor-el Thomas Caparas,0,1,36,36
1658063016745,MATH 20C,B01,083762,Bach; Quang Tran,1,0,30,29
1658063022770,MATH 20D,A01,083765,Tran; Brian Kha,5,0,30,25
1658063022770,MATH 20D,A02,083766,Tran; Brian Kha,5,0,30,25
1658063022770,MATH 20D,A03,083767,Tran; Brian Kha,6,0,30,24
1658063028804,MATH 20E,A01,083771,Ganguly; Soumya,12,0,32,20
1658063028804,MATH 20E,A02,083772,Ganguly; Soumya,7,0,32,25
1658063028804,MATH 20E,B01,083773,Ciotti; Benjamin,20,0,35,15
1658063028804,MATH 20E,B02,083774,Ciotti; Benjamin,18,0,35,17
1658063034835,MATH 103A,A01,083777,Greenfeld; Be'Eri,6,0,36,30
1658063034835,MATH 103A,A02,083778,Greenfeld; Be'Eri,5,0,36,31
1658063034835,MATH 103A,A03,093561,Greenfeld; Be'Eri,7,0,36,29
1658063034835,MATH 103A,B01,083779,Greenfeld; Be'Eri,8,0,36,28
1658063034835,MATH 103A,B02,083780,Greenfeld; Be'Eri,4,0,36,32
1658063034835,MATH 103A,B03,093562,Greenfeld; Be'Eri,3,0,36,33
1658063040864,MATH 105,A01,085443,Carter; Anne Toulson,15,0,35,20
1658063040864,MATH 105,A02,093477,Carter; Anne Toulson,20,0,35,15
1658063046894,MATH 109,A01,083213,Ganzberger; Geoffrey Michael,3,0,34,31
1658063046894,MATH 109,A02,083214,Ganzberger; Geoffrey Michael,4,0,34,30
1658063046894,MATH 109,A03,093478,Ganzberger; Geoffrey Michael,2,0,34,32
1658063046894,MATH 109,B01,083215,Ganzberger; Geoffrey Michael,3,0,32,29
1658063046894,MATH 109,B02,083216,Ganzberger; Geoffrey Michael,3,0,32,29
1658063046894,MATH 109,B03,093479,Ganzberger; Geoffrey Michael,8,0,32,24
1658063052919,MATH 142A,A01,083219,Chow; Bennett,7,0,32,25
1658063052919,MATH 142A,A02,083220,Chow; Bennett,10,0,32,22
1658063052919,MATH 142A,A03,093480,Chow; Bennett,9,0,32,23
1658063052919,MATH 142A,B03,093481,Chow; Bennett,8,0,32,24
1658063052919,MATH 142A,B04,093558,Chow; Bennett,14,0,32,18
1658063052919,MATH 142A,B05,093559,Chow; Bennett,7,0,32,25
1658063058945,MATH 193A,A01,083224,Rotar; Vladimir,9,0,34,25
1658063058945,MATH 193A,A02,083225,Rotar; Vladimir,11,0,34,23
1658063058945,MATH 193A,A03,083781,Rotar; Vladimir,5,0,34,29
1658063058945,MATH 193A,A04,083782,Rotar; Vladimir,12,0,34,22
1658063058945,MATH 193A,A05,093482,Rotar; Vladimir,11,0,34,23
1658063064969,MATH 197,001,091859,McAuley; Julian John,9999,0,9999,0
1658063064969,MATH 197,002,095566,Kedlaya; Kiran S.,9997,0,9999,2
1658063064969,MATH 197,003,095567,Xiao; Ming,9999,0,9999,0
1658063064969,MATH 197,004,095571,Perols; Johan Lars,9998,0,9999,1
1658063072040,COGS 9,A01,083615,Shannon; Kyle Michael,11,0,75,64
1658063078068,COGS 11,A01,083617,Boyle; Mary E. T.,23,0,48,25
1658063084094,COGS 13,A01,083071,Bastos; Amalia Pinkusfeld,12,0,71,59
1658063090124,COGS 14A,A01,092681,Semenuks; Arturs,5,1,100,95
1658063096156,COGS 14B,A01,083073,Cheng; Tzu-Han,7,0,63,56
1658063102190,COGS 17,A01,092677,Semenuks; Arturs,7,0,81,74
1658063108215,COGS 100,A01,083619,Allen; Michael Gordon,17,0,70,53
1658063114238,COGS 101A,A01,083621,Davis; Joshua Daniel,9,0,68,59
1658063120266,COGS 101B,A01,091572,Allen; Michael Gordon,14,0,65,51
1658063126291,COGS 101C,A01,083625,Delgado; Tania,17,0,35,18
1658063132317,COGS 107A,A01,083627,Boyle; Mary E. T.,14,0,60,46
1658063138344,COGS 118A,A01,083075,Gupta; Anjum,21,0,76,55
1658063144380,CSE 3,A50,083646,Miranda; Gregory Joseph,24,0,50,26
1658063150409,CSE 8A,A50,083650,Miranda; Gregory Joseph,17,1,56,39
1658063156436,CSE 11,A01,083080,Cao; Yingjun,7,15,40,33
1658063162463,CSE 12,A01,083652,Krause-Levy; Sophia Louisa,30,1,120,90
1658063168574,CSE 15L,A01,083654,Morris; Justin Loren,9,0,50,41
1658063168574,CSE 15L,A02,083655,Morris; Justin Loren,11,0,50,39
1658063174608,CSE 20,A01,083657,Tran; Khoa Dang,39,0,80,41
1658063180641,CSE 21,A01,095574,Bach; Quang Tran,23,0,48,25
1658063186674,CSE 30,A01,083084,Eldon; John,8,0,80,72
1658063186674,CSE 30,B01,095061,Bhaskar; Nishant,9,0,50,41
1658063192700,CSE 100,A01,083659,Cao; Yingjun,5,4,70,65
1658063198727,CSE 134B,A01,083661,Powell; Thomas Allan,25,0,100,75
1658063204753,CSE 140,A01,083663,Gungor; Onat,17,0,85,68
1658063210785,CSE 140L,A01,083088,Eldon; John,23,0,100,77
1658063216811,CSE 175,A01,083665,Kumar; Rakesh,3,0,25,22
1658063222837,CSE 190,A00,092507,Dubnov; Shlomo,8,0,20,12
1658063228873,ECE 45,A01,083139,Congero; Spencer William,7,0,75,68
1658063234905,ECE 65,A50,083695,Saad; Andrew S,12,0,30,18
1658063234905,ECE 65,A51,095125,Saad; Andrew S,24,0,26,2
1658063240930,ECE 109,A01,091882,Touri; Behrouz,21,0,70,49
1658063246958,ECE 180,A00,083140,Abi Samra; Nicholas Camill,1,0,30,29
1658063246958,ECE 180,B00,083141,Abi Samra; Nicholas Camill,0,0,30,30
1658063253001,MATH 10A,A01,083735,Patchell; Gregory David,2,0,30,28
1658063253001,MATH 10A,A02,083736,Patchell; Gregory David,20,0,30,10
1658063253001,MATH 10A,A03,083737,Patchell; Gregory David,16,0,30,14
1658063259041,MATH 10B,A01,083207,Lim; Seonhee,9,0,34,25
1658063259041,MATH 10B,A02,083208,Lim; Seonhee,10,0,35,25
1658063259041,MATH 10B,A03,093472,Lim; Seonhee,7,0,34,27
1658063259041,MATH 10B,B01,083739,Sinha; Shubham,14,0,30,16
1658063265071,MATH 18,A01,083743,Cinel; Cameron Alexander,9,0,30,21
1658063265071,MATH 18,A02,083744,Cinel; Cameron Alexander,18,0,30,12
1658063265071,MATH 18,A03,083745,Cinel; Cameron Alexander,10,0,30,20
1658063265071,MATH 18,B01,083748,Rideout; David Porter,5,0,37,32
1658063265071,MATH 18,B02,083749,Rideout; David Porter,5,0,36,31
1658063265071,MATH 18,B03,083750,Rideout; David Porter,3,0,37,34
1658063265071,MATH 18,B04,083751,Rideout; David Porter,7,0,36,29
1658063265071,MATH 18,B05,093473,Rideout; David Porter,7,0,36,29
1658063265071,MATH 18,B06,093474,Rideout; David Porter,6,0,36,30
1658063271097,MATH 20A,A01,083754,Zheng; Zequn,14,0,40,26
1658063277130,MATH 20B,A01,083756,Briones; Jor-el Thomas Caparas,4,0,36,32
1658063277130,MATH 20B,A02,083757,Briones; Jor-el Thomas Caparas,1,0,36,35
1658063277130,MATH 20B,A03,093475,Briones; Jor-el Thomas Caparas,3,0,36,33
1658063283163,MATH 20C,A01,083760,Briones; Jor-el Thomas Caparas,1,0,35,34
1658063283163,MATH 20C,A02,083761,Briones; Jor-el Thomas Caparas,8,0,35,27
1658063283163,MATH 20C,A03,093476,Briones; Jor-el Thomas Caparas,0,1,36,36
1658063283163,MATH 20C,B01,083762,Bach; Quang Tran,1,0,30,29
1658063289190,MATH 20D,A01,083765,Tran; Brian Kha,5,0,30,25
1658063289190,MATH 20D,A02,083766,Tran; Brian Kha,5,0,30,25
1658063289190,MATH 20D,A03,083767,Tran; Brian Kha,6,0,30,24
1658063295219,MATH 20E,A01,083771,Ganguly; Soumya,12,0,32,20
1658063295219,MATH 20E,A02,083772,Ganguly; Soumya,7,0,32,25
1658063295219,MATH 20E,B01,083773,Ciotti; Benjamin,20,0,35,15
1658063295219,MATH 20E,B02,083774,Ciotti; Benjamin,18,0,35,17
1658063301257,MATH 103A,A01,083777,Greenfeld; Be'Eri,6,0,36,30
1658063301257,MATH 103A,A02,083778,Greenfeld; Be'Eri,5,0,36,31
1658063301257,MATH 103A,A03,093561,Greenfeld; Be'Eri,7,0,36,29
1658063301257,MATH 103A,B01,083779,Greenfeld; Be'Eri,8,0,36,28
1658063301257,MATH 103A,B02,083780,Greenfeld; Be'Eri,4,0,36,32
1658063301257,MATH 103A,B03,093562,Greenfeld; Be'Eri,3,0,36,33
1658063307289,MATH 105,A01,085443,Carter; Anne Toulson,15,0,35,20
1658063307289,MATH 105,A02,093477,Carter; Anne Toulson,20,0,35,15
1658063313321,MATH 109,A01,083213,Ganzberger; Geoffrey Michael,3,0,34,31
1658063313321,MATH 109,A02,083214,Ganzberger; Geoffrey Michael,4,0,34,30
1658063313321,MATH 109,A03,093478,Ganzberger; Geoffrey Michael,2,0,34,32
1658063313321,MATH 109,B01,083215,Ganzberger; Geoffrey Michael,3,0,32,29
1658063313321,MATH 109,B02,083216,Ganzberger; Geoffrey Michael,3,0,32,29
1658063313321,MATH 109,B03,093479,Ganzberger; Geoffrey Michael,8,0,32,24
1658063319357,MATH 142A,A01,083219,Chow; Bennett,7,0,32,25
1658063319357,MATH 142A,A02,083220,Chow; Bennett,10,0,32,22
1658063319357,MATH 142A,A03,093480,Chow; Bennett,9,0,32,23
1658063319357,MATH 142A,B03,093481,Chow; Bennett,8,0,32,24
1658063319357,MATH 142A,B04,093558,Chow; Bennett,14,0,32,18
1658063319357,MATH 142A,B05,093559,Chow; Bennett,7,0,32,25
1658063325390,MATH 193A,A01,083224,Rotar; Vladimir,9,0,34,25
1658063325390,MATH 193A,A02,083225,Rotar; Vladimir,11,0,34,23
1658063325390,MATH 193A,A03,083781,Rotar; Vladimir,5,0,34,29
1658063325390,MATH 193A,A04,083782,Rotar; Vladimir,12,0,34,22
1658063325390,MATH 193A,A05,093482,Rotar; Vladimir,11,0,34,23
1658063331423,MATH 197,001,091859,McAuley; Julian John,9999,0,9999,0
1658063331423,MATH 197,002,095566,Kedlaya; Kiran S.,9997,0,9999,2
1658063331423,MATH 197,003,095567,Xiao; Ming,9999,0,9999,0
1658063331423,MATH 197,004,095571,Perols; Johan Lars,9998,0,9999,1
1658063338507,COGS 9,A01,083615,Shannon; Kyle Michael,11,0,75,64
1658063344533,COGS 11,A01,083617,Boyle; Mary E. T.,23,0,48,25
1658063350559,COGS 13,A01,083071,Bastos; Amalia Pinkusfeld,12,0,71,59
1658063356593,COGS 14A,A01,092681,Semenuks; Arturs,5,1,100,95
1658063362620,COGS 14B,A01,083073,Cheng; Tzu-Han,7,0,63,56
1658063368648,COGS 17,A01,092677,Semenuks; Arturs,7,0,81,74
1658063374673,COGS 100,A01,083619,Allen; Michael Gordon,17,0,70,53
1658063380702,COGS 101A,A01,083621,Davis; Joshua Daniel,9,0,68,59
1658063386731,COGS 101B,A01,091572,Allen; Michael Gordon,14,0,65,51
1658063392758,COGS 101C,A01,083625,Delgado; Tania,17,0,35,18
1658063398786,COGS 107A,A01,083627,Boyle; Mary E. T.,14,0,60,46
1658063404813,COGS 118A,A01,083075,Gupta; Anjum,21,0,76,55
1658063410838,CSE 3,A50,083646,Miranda; Gregory Joseph,24,0,50,26
1658063416865,CSE 8A,A50,083650,Miranda; Gregory Joseph,17,1,56,39
1658063422895,CSE 11,A01,083080,Cao; Yingjun,7,15,40,33
1658063428928,CSE 12,A01,083652,Krause-Levy; Sophia Louisa,30,1,120,90
1658063434953,CSE 15L,A01,083654,Morris; Justin Loren,9,0,50,41
1658063434953,CSE 15L,A02,083655,Morris; Justin Loren,11,0,50,39
1658063440982,CSE 20,A01,083657,Tran; Khoa Dang,39,0,80,41
1658063447006,CSE 21,A01,095574,Bach; Quang Tran,23,0,48,25
1658063453039,CSE 30,A01,083084,Eldon; John,8,0,80,72
1658063453039,CSE 30,B01,095061,Bhaskar; Nishant,9,0,50,41
1658063459081,CSE 100,A01,083659,Cao; Yingjun,5,4,70,65
1658063465110,CSE 134B,A01,083661,Powell; Thomas Allan,25,0,100,75
1658063471141,CSE 140,A01,083663,Gungor; Onat,17,0,85,68
1658063477165,CSE 140L,A01,083088,Eldon; John,23,0,100,77
1658063483193,CSE 175,A01,083665,Kumar; Rakesh,3,0,25,22
1658063489218,CSE 190,A00,092507,Dubnov; Shlomo,8,0,20,12
1658063495245,ECE 45,A01,083139,Congero; Spencer William,7,0,75,68
1658063501274,ECE 65,A50,083695,Saad; Andrew S,12,0,30,18
1658063501274,ECE 65,A51,095125,Saad; Andrew S,24,0,26,2
1658063507307,ECE 109,A01,091882,Touri; Behrouz,21,0,70,49
1658063513336,ECE 180,A00,083140,Abi Samra; Nicholas Camill,1,0,30,29
1658063513336,ECE 180,B00,083141,Abi Samra; Nicholas Camill,0,0,30,30
1658063519372,MATH 10A,A01,083735,Patchell; Gregory David,2,0,30,28
1658063519372,MATH 10A,A02,083736,Patchell; Gregory David,20,0,30,10
1658063519372,MATH 10A,A03,083737,Patchell; Gregory David,16,0,30,14
1658063525408,MATH 10B,A01,083207,Lim; Seonhee,9,0,34,25
1658063525408,MATH 10B,A02,083208,Lim; Seonhee,10,0,35,25
1658063525408,MATH 10B,A03,093472,Lim; Seonhee,7,0,34,27
1658063525408,MATH 10B,B01,083739,Sinha; Shubham,14,0,30,16
1658063531439,MATH 18,A01,083743,Cinel; Cameron Alexander,9,0,30,21
1658063531439,MATH 18,A02,083744,Cinel; Cameron Alexander,18,0,30,12
1658063531439,MATH 18,A03,083745,Cinel; Cameron Alexander,10,0,30,20
1658063531439,MATH 18,B01,083748,Rideout; David Porter,5,0,37,32
1658063531439,MATH 18,B02,083749,Rideout; David Porter,5,0,36,31
1658063531439,MATH 18,B03,083750,Rideout; David Porter,3,0,37,34
1658063531439,MATH 18,B04,083751,Rideout; David Porter,7,0,36,29
1658063531439,MATH 18,B05,093473,Rideout; David Porter,7,0,36,29
1658063531439,MATH 18,B06,093474,Rideout; David Porter,6,0,36,30
1658063537465,MATH 20A,A01,083754,Zheng; Zequn,14,0,40,26
1658063543491,MATH 20B,A01,083756,Briones; Jor-el Thomas Caparas,4,0,36,32
1658063543491,MATH 20B,A02,083757,Briones; Jor-el Thomas Caparas,1,0,36,35
1658063543491,MATH 20B,A03,093475,Briones; Jor-el Thomas Caparas,3,0,36,33
1658063549517,MATH 20C,A01,083760,Briones; Jor-el Thomas Caparas,1,0,35,34
1658063549517,MATH 20C,A02,083761,Briones; Jor-el Thomas Caparas,8,0,35,27
1658063549517,MATH 20C,A03,093476,Briones; Jor-el Thomas Caparas,0,1,36,36
1658063549517,MATH 20C,B01,083762,Bach; Quang Tran,1,0,30,29
1658063555543,MATH 20D,A01,083765,Tran; Brian Kha,5,0,30,25
1658063555543,MATH 20D,A02,083766,Tran; Brian Kha,5,0,30,25
1658063555543,MATH 20D,A03,083767,Tran; Brian Kha,6,0,30,24
1658063561570,MATH 20E,A01,083771,Ganguly; Soumya,12,0,32,20
1658063561570,MATH 20E,A02,083772,Ganguly; Soumya,7,0,32,25
1658063561570,MATH 20E,B01,083773,Ciotti; Benjamin,20,0,35,15
1658063561570,MATH 20E,B02,083774,Ciotti; Benjamin,18,0,35,17
1658063567600,MATH 103A,A01,083777,Greenfeld; Be'Eri,6,0,36,30
1658063567600,MATH 103A,A02,083778,Greenfeld; Be'Eri,5,0,36,31
1658063567600,MATH 103A,A03,093561,Greenfeld; Be'Eri,7,0,36,29
1658063567600,MATH 103A,B01,083779,Greenfeld; Be'Eri,8,0,36,28
1658063567600,MATH 103A,B02,083780,Greenfeld; Be'Eri,4,0,36,32
1658063567600,MATH 103A,B03,093562,Greenfeld; Be'Eri,3,0,36,33
1658063573634,MATH 105,A01,085443,Carter; Anne Toulson,15,0,35,20
1658063573634,MATH 105,A02,093477,Carter; Anne Toulson,20,0,35,15
1658063579662,MATH 109,A01,083213,Ganzberger; Geoffrey Michael,3,0,34,31
1658063579662,MATH 109,A02,083214,Ganzberger; Geoffrey Michael,4,0,34,30
1658063579662,MATH 109,A03,093478,Ganzberger; Geoffrey Michael,2,0,34,32
1658063579662,MATH 109,B01,083215,Ganzberger; Geoffrey Michael,3,0,32,29
1658063579662,MATH 109,B02,083216,Ganzberger; Geoffrey Michael,3,0,32,29
1658063579662,MATH 109,B03,093479,Ganzberger; Geoffrey Michael,8,0,32,24
1658063585696,MATH 142A,A01,083219,Chow; Bennett,7,0,32,25
1658063585696,MATH 142A,A02,083220,Chow; Bennett,10,0,32,22
1658063585696,MATH 142A,A03,093480,Chow; Bennett,9,0,32,23
1658063585696,MATH 142A,B03,093481,Chow; Bennett,8,0,32,24
1658063585696,MATH 142A,B04,093558,Chow; Bennett,14,0,32,18
1658063585696,MATH 142A,B05,093559,Chow; Bennett,7,0,32,25
1658063591733,MATH 193A,A01,083224,Rotar; Vladimir,9,0,34,25
1658063591733,MATH 193A,A02,083225,Rotar; Vladimir,11,0,34,23
1658063591733,MATH 193A,A03,083781,Rotar; Vladimir,5,0,34,29
1658063591733,MATH 193A,A04,083782,Rotar; Vladimir,12,0,34,22
1658063591733,MATH 193A,A05,093482,Rotar; Vladimir,11,0,34,23
1658063597761,MATH 197,001,091859,McAuley; Julian John,9999,0,9999,0
1658063597761,MATH 197,002,095566,Kedlaya; Kiran S.,9997,0,9999,2
1658063597761,MATH 197,003,095567,Xiao; Ming,9999,0,9999,0
1658063597761,MATH 197,004,095571,Perols; Johan Lars,9998,0,9999,1
1658063604840,COGS 9,A01,083615,Shannon; Kyle Michael,11,0,75,64
1658063610871,COGS 11,A01,083617,Boyle; Mary E. T.,23,0,48,25
1658063616898,COGS 13,A01,083071,Bastos; Amalia Pinkusfeld,12,0,71,59
1658063622927,COGS 14A,A01,092681,Semenuks; Arturs,5,1,100,95
1658063628954,COGS 14B,A01,083073,Cheng; Tzu-Han,7,0,63,56
1658063634986,COGS 17,A01,092677,Semenuks; Arturs,7,0,81,74
1658063641013,COGS 100,A01,083619,Allen; Michael Gordon,17,0,70,53
1658063647040,COGS 101A,A01,083621,Davis; Joshua Daniel,9,0,68,59
1658063653066,COGS 101B,A01,091572,Allen; Michael Gordon,14,0,65,51
1658063659093,COGS 101C,A01,083625,Delgado; Tania,17,0,35,18
1658063665119,COGS 107A,A01,083627,Boyle; Mary E. T.,14,0,60,46
1658063671145,COGS 118A,A01,083075,Gupta; Anjum,21,0,76,55
1658063677173,CSE 3,A50,083646,Miranda; Gregory Joseph,24,0,50,26
1658063683204,CSE 8A,A50,083650,Miranda; Gregory Joseph,17,1,56,39
1658063689231,CSE 11,A01,083080,Cao; Yingjun,7,15,40,33
1658063695258,CSE 12,A01,083652,Krause-Levy; Sophia Louisa,30,1,120,90
1658063701288,CSE 15L,A01,083654,Morris; Justin Loren,9,0,50,41
1658063701288,CSE 15L,A02,083655,Morris; Justin Loren,11,0,50,39
1658063707317,CSE 20,A01,083657,Tran; Khoa Dang,39,0,80,41
1658063713344,CSE 21,A01,095574,Bach; Quang Tran,23,0,48,25
1658063719371,CSE 30,A01,083084,Eldon; John,8,0,80,72
1658063719371,CSE 30,B01,095061,Bhaskar; Nishant,9,0,50,41
1658063725398,CSE 100,A01,083659,Cao; Yingjun,5,4,70,65
1658063731434,CSE 134B,A01,083661,Powell; Thomas Allan,25,0,100,75
1658063737464,CSE 140,A01,083663,Gungor; Onat,17,0,85,68
1658063743493,CSE 140L,A01,083088,Eldon; John,23,0,100,77
1658063749519,CSE 175,A01,083665,Kumar; Rakesh,3,0,25,22
1658063755546,CSE 190,A00,092507,Dubnov; Shlomo,8,0,20,12
1658063761574,ECE 45,A01,083139,Congero; Spencer William,7,0,75,68
1658063767697,ECE 65,A50,083695,Saad; Andrew S,12,0,30,18
1658063767697,ECE 65,A51,095125,Saad; Andrew S,24,0,26,2
1658063773724,ECE 109,A01,091882,Touri; Behrouz,21,0,70,49
1658063779751,ECE 180,A00,083140,Abi Samra; Nicholas Camill,1,0,30,29
1658063779751,ECE 180,B00,083141,Abi Samra; Nicholas Camill,0,0,30,30
1658063785791,MATH 10A,A01,083735,Patchell; Gregory David,2,0,30,28
1658063785791,MATH 10A,A02,083736,Patchell; Gregory David,20,0,30,10
1658063785791,MATH 10A,A03,083737,Patchell; Gregory David,16,0,30,14
1658063791829,MATH 10B,A01,083207,Lim; Seonhee,9,0,34,25
1658063791829,MATH 10B,A02,083208,Lim; Seonhee,10,0,35,25
1658063791829,MATH 10B,A03,093472,Lim; Seonhee,7,0,34,27
1658063791829,MATH 10B,B01,083739,Sinha; Shubham,14,0,30,16
1658063797870,MATH 18,A01,083743,Cinel; Cameron Alexander,9,0,30,21
1658063797870,MATH 18,A02,083744,Cinel; Cameron Alexander,18,0,30,12
1658063797870,MATH 18,A03,083745,Cinel; Cameron Alexander,10,0,30,20
1658063797870,MATH 18,B01,083748,Rideout; David Porter,5,0,37,32
1658063797870,MATH 18,B02,083749,Rideout; David Porter,5,0,36,31
1658063797870,MATH 18,B03,083750,Rideout; David Porter,3,0,37,34
1658063797870,MATH 18,B04,083751,Rideout; David Porter,7,0,36,29
1658063797870,MATH 18,B05,093473,Rideout; David Porter,7,0,36,29
1658063797870,MATH 18,B06,093474,Rideout; David Porter,6,0,36,30
1658063803900,MATH 20A,A01,083754,Zheng; Zequn,14,0,40,26
1658063809934,MATH 20B,A01,083756,Briones; Jor-el Thomas Caparas,4,0,36,32
1658063809934,MATH 20B,A02,083757,Briones; Jor-el Thomas Caparas,1,0,36,35
1658063809934,MATH 20B,A03,093475,Briones; Jor-el Thomas Caparas,3,0,36,33
1658063815962,MATH 20C,A01,083760,Briones; Jor-el Thomas Caparas,1,0,35,34
1658063815962,MATH 20C,A02,083761,Briones; Jor-el Thomas Caparas,8,0,35,27
1658063815962,MATH 20C,A03,093476,Briones; Jor-el Thomas Caparas,0,1,36,36
1658063815962,MATH 20C,B01,083762,Bach; Quang Tran,1,0,30,29
1658063821995,MATH 20D,A01,083765,Tran; Brian Kha,5,0,30,25
1658063821995,MATH 20D,A02,083766,Tran; Brian Kha,5,0,30,25
1658063821995,MATH 20D,A03,083767,Tran; Brian Kha,6,0,30,24
1658063828022,MATH 20E,A01,083771,Ganguly; Soumya,12,0,32,20
1658063828022,MATH 20E,A02,083772,Ganguly; Soumya,7,0,32,25
1658063828022,MATH 20E,B01,083773,Ciotti; Benjamin,20,0,35,15
1658063828022,MATH 20E,B02,083774,Ciotti; Benjamin,18,0,35,17
1658063834048,MATH 103A,A01,083777,Greenfeld; Be'Eri,6,0,36,30
1658063834048,MATH 103A,A02,083778,Greenfeld; Be'Eri,5,0,36,31
1658063834048,MATH 103A,A03,093561,Greenfeld; Be'Eri,7,0,36,29
1658063834048,MATH 103A,B01,083779,Greenfeld; Be'Eri,8,0,36,28
1658063834048,MATH 103A,B02,083780,Greenfeld; Be'Eri,4,0,36,32
1658063834048,MATH 103A,B03,093562,Greenfeld; Be'Eri,3,0,36,33
1658063840078,MATH 105,A01,085443,Carter; Anne Toulson,15,0,35,20
1658063840078,MATH 105,A02,093477,Carter; Anne Toulson,20,0,35,15
1658063846112,MATH 109,A01,083213,Ganzberger; Geoffrey Michael,3,0,34,31
1658063846112,MATH 109,A02,083214,Ganzberger; Geoffrey Michael,4,0,34,30
1658063846112,MATH 109,A03,093478,Ganzberger; Geoffrey Michael,2,0,34,32
1658063846112,MATH 109,B01,083215,Ganzberger; Geoffrey Michael,3,0,32,29
1658063846112,MATH 109,B02,083216,Ganzberger; Geoffrey Michael,3,0,32,29
1658063846112,MATH 109,B03,093479,Ganzberger; Geoffrey Michael,8,0,32,24
1658063852148,MATH 142A,A01,083219,Chow; Bennett,7,0,32,25
1658063852148,MATH 142A,A02,083220,Chow; Bennett,10,0,32,22
1658063852148,MATH 142A,A03,093480,Chow; Bennett,9,0,32,23
1658063852148,MATH 142A,B03,093481,Chow; Bennett,8,0,32,24
1658063852148,MATH 142A,B04,093558,Chow; Bennett,14,0,32,18
1658063852148,MATH 142A,B05,093559,Chow; Bennett,7,0,32,25
1658063858175,MATH 193A,A01,083224,Rotar; Vladimir,9,0,34,25
1658063858175,MATH 193A,A02,083225,Rotar; Vladimir,11,0,34,23
1658063858175,MATH 193A,A03,083781,Rotar; Vladimir,5,0,34,29
1658063858175,MATH 193A,A04,083782,Rotar; Vladimir,12,0,34,22
1658063858175,MATH 193A,A05,093482,Rotar; Vladimir,11,0,34,23
1658063864206,MATH 197,001,091859,McAuley; Julian John,9999,0,9999,0
1658063864206,MATH 197,002,095566,Kedlaya; Kiran S.,9997,0,9999,2
1658063864206,MATH 197,003,095567,Xiao; Ming,9999,0,9999,0
1658063864206,MATH 197,004,095571,Perols; Johan Lars,9998,0,9999,1
1658063871274,COGS 9,A01,083615,Shannon; Kyle Michael,11,0,75,64
1658063877300,COGS 11,A01,083617,Boyle; Mary E. T.,23,0,48,25
1658063883324,COGS 13,A01,083071,Bastos; Amalia Pinkusfeld,12,0,71,59
1658063889351,COGS 14A,A01,092681,Semenuks; Arturs,5,1,100,95
1658063895381,COGS 14B,A01,083073,Cheng; Tzu-Han,7,0,63,56
1658063901408,COGS 17,A01,092677,Semenuks; Arturs,7,0,81,74
1658063907440,COGS 100,A01,083619,Allen; Michael Gordon,17,0,70,53
1658063913472,COGS 101A,A01,083621,Davis; Joshua Daniel,9,0,68,59
1658063919498,COGS 101B,A01,091572,Allen; Michael Gordon,14,0,65,51
1658063925527,COGS 101C,A01,083625,Delgado; Tania,17,0,35,18
1658063931554,COGS 107A,A01,083627,Boyle; Mary E. T.,14,0,60,46
1658063937580,COGS 118A,A01,083075,Gupta; Anjum,21,0,76,55
1658063943609,CSE 3,A50,083646,Miranda; Gregory Joseph,24,0,50,26
1658063949639,CSE 8A,A50,083650,Miranda; Gregory Joseph,17,1,56,39
1658063955669,CSE 11,A01,083080,Cao; Yingjun,7,15,40,33
1658063961695,CSE 12,A01,083652,Krause-Levy; Sophia Louisa,30,1,120,90
1658063967726,CSE 15L,A01,083654,Morris; Justin Loren,9,0,50,41
1658063967726,CSE 15L,A02,083655,Morris; Justin Loren,11,0,50,39
1658063973753,CSE 20,A01,083657,Tran; Khoa Dang,39,0,80,41
1658063979785,CSE 21,A01,095574,Bach; Quang Tran,23,0,48,25
1658063985817,CSE 30,A01,083084,Eldon; John,8,0,80,72
1658063985817,CSE 30,B01,095061,Bhaskar; Nishant,9,0,50,41
1658063991846,CSE 100,A01,083659,Cao; Yingjun,5,4,70,65
1658063997872,CSE 134B,A01,083661,Powell; Thomas Allan,25,0,100,75
1658064003899,CSE 140,A01,083663,Gungor; Onat,17,0,85,68
1658064009927,CSE 140L,A01,083088,Eldon; John,23,0,100,77
1658064015956,CSE 175,A01,083665,Kumar; Rakesh,3,0,25,22
1658064021991,CSE 190,A00,092507,Dubnov; Shlomo,8,0,20,12
1658064028018,ECE 45,A01,083139,Congero; Spencer William,7,0,75,68
1658064034053,ECE 65,A50,083695,Saad; Andrew S,12,0,30,18
1658064034053,ECE 65,A51,095125,Saad; Andrew S,24,0,26,2
1658064040084,ECE 109,A01,091882,Touri; Behrouz,21,0,70,49
1658064046109,ECE 180,A00,083140,Abi Samra; Nicholas Camill,1,0,30,29
1658064046109,ECE 180,B00,083141,Abi Samra; Nicholas Camill,0,0,30,30
1658064052143,MATH 10A,A01,083735,Patchell; Gregory David,2,0,30,28
1658064052143,MATH 10A,A02,083736,Patchell; Gregory David,20,0,30,10
1658064052143,MATH 10A,A03,083737,Patchell; Gregory David,16,0,30,14
1658064058169,MATH 10B,A01,083207,Lim; Seonhee,9,0,34,25
1658064058169,MATH 10B,A02,083208,Lim; Seonhee,10,0,35,25
1658064058169,MATH 10B,A03,093472,Lim; Seonhee,7,0,34,27
1658064058169,MATH 10B,B01,083739,Sinha; Shubham,14,0,30,16
1658064064199,MATH 18,A01,083743,Cinel; Cameron Alexander,9,0,30,21
1658064064199,MATH 18,A02,083744,Cinel; Cameron Alexander,18,0,30,12
1658064064199,MATH 18,A03,083745,Cinel; Cameron Alexander,10,0,30,20
1658064064199,MATH 18,B01,083748,Rideout; David Porter,5,0,37,32
1658064064199,MATH 18,B02,083749,Rideout; David Porter,5,0,36,31
1658064064199,MATH 18,B03,083750,Rideout; David Porter,3,0,37,34
1658064064199,MATH 18,B04,083751,Rideout; David Porter,7,0,36,29
1658064064199,MATH 18,B05,093473,Rideout; David Porter,7,0,36,29
1658064064199,MATH 18,B06,093474,Rideout; David Porter,6,0,36,30
1658064070226,MATH 20A,A01,083754,Zheng; Zequn,14,0,40,26
1658064076253,MATH 20B,A01,083756,Briones; Jor-el Thomas Caparas,4,0,36,32
1658064076253,MATH 20B,A02,083757,Briones; Jor-el Thomas Caparas,1,0,36,35
1658064076253,MATH 20B,A03,093475,Briones; Jor-el Thomas Caparas,3,0,36,33
1658064082287,MATH 20C,A01,083760,Briones; Jor-el Thomas Caparas,1,0,35,34
1658064082287,MATH 20C,A02,083761,Briones; Jor-el Thomas Caparas,8,0,35,27
1658064082287,MATH 20C,A03,093476,Briones; Jor-el Thomas Caparas,0,1,36,36
1658064082287,MATH 20C,B01,083762,Bach; Quang Tran,1,0,30,29
1658064088313,MATH 20D,A01,083765,Tran; Brian Kha,5,0,30,25
1658064088313,MATH 20D,A02,083766,Tran; Brian Kha,5,0,30,25
1658064088313,MATH 20D,A03,083767,Tran; Brian Kha,6,0,30,24
1658064094342,MATH 20E,A01,083771,Ganguly; Soumya,12,0,32,20
1658064094342,MATH 20E,A02,083772,Ganguly; Soumya,7,0,32,25
1658064094342,MATH 20E,B01,083773,Ciotti; Benjamin,20,0,35,15
1658064094342,MATH 20E,B02,083774,Ciotti; Benjamin,18,0,35,17
1658064100372,MATH 103A,A01,083777,Greenfeld; Be'Eri,6,0,36,30
1658064100372,MATH 103A,A02,083778,Greenfeld; Be'Eri,5,0,36,31
1658064100372,MATH 103A,A03,093561,Greenfeld; Be'Eri,7,0,36,29
1658064100372,MATH 103A,B01,083779,Greenfeld; Be'Eri,8,0,36,28
1658064100372,MATH 103A,B02,083780,Greenfeld; Be'Eri,4,0,36,32
1658064100372,MATH 103A,B03,093562,Greenfeld; Be'Eri,3,0,36,33
1658064106404,MATH 105,A01,085443,Carter; Anne Toulson,15,0,35,20
1658064106404,MATH 105,A02,093477,Carter; Anne Toulson,20,0,35,15
1658064112432,MATH 109,A01,083213,Ganzberger; Geoffrey Michael,3,0,34,31
1658064112432,MATH 109,A02,083214,Ganzberger; Geoffrey Michael,4,0,34,30
1658064112432,MATH 109,A03,093478,Ganzberger; Geoffrey Michael,2,0,34,32
1658064112432,MATH 109,B01,083215,Ganzberger; Geoffrey Michael,3,0,32,29
1658064112432,MATH 109,B02,083216,Ganzberger; Geoffrey Michael,3,0,32,29
1658064112432,MATH 109,B03,093479,Ganzberger; Geoffrey Michael,8,0,32,24
1658064118461,MATH 142A,A01,083219,Chow; Bennett,7,0,32,25
1658064118461,MATH 142A,A02,083220,Chow; Bennett,10,0,32,22
1658064118461,MATH 142A,A03,093480,Chow; Bennett,9,0,32,23
1658064118461,MATH 142A,B03,093481,Chow; Bennett,8,0,32,24
1658064118461,MATH 142A,B04,093558,Chow; Bennett,14,0,32,18
1658064118461,MATH 142A,B05,093559,Chow; Bennett,7,0,32,25
1658064124490,MATH 193A,A01,083224,Rotar; Vladimir,9,0,34,25
1658064124490,MATH 193A,A02,083225,Rotar; Vladimir,11,0,34,23
1658064124490,MATH 193A,A03,083781,Rotar; Vladimir,5,0,34,29
1658064124490,MATH 193A,A04,083782,Rotar; Vladimir,12,0,34,22
1658064124490,MATH 193A,A05,093482,Rotar; Vladimir,11,0,34,23
1658064130518,MATH 197,001,091859,McAuley; Julian John,9999,0,9999,0
1658064130518,MATH 197,002,095566,Kedlaya; Kiran S.,9997,0,9999,2
1658064130518,MATH 197,003,095567,Xiao; Ming,9999,0,9999,0
1658064130518,MATH 197,004,095571,Perols; Johan Lars,9998,0,9999,1
1658064137603,COGS 9,A01,083615,Shannon; Kyle Michael,11,0,75,64
1658064143634,COGS 11,A01,083617,Boyle; Mary E. T.,23,0,48,25
1658064149661,COGS 13,A01,083071,Bastos; Amalia Pinkusfeld,12,0,71,59
1658064155689,COGS 14A,A01,092681,Semenuks; Arturs,5,1,100,95
1658064161721,COGS 14B,A01,083073,Cheng; Tzu-Han,7,0,63,56
1658064167755,COGS 17,A01,092677,Semenuks; Arturs,7,0,81,74
1658064173785,COGS 100,A01,083619,Allen; Michael Gordon,17,0,70,53
1658064179812,COGS 101A,A01,083621,Davis; Joshua Daniel,9,0,68,59
1658064185844,COGS 101B,A01,091572,Allen; Michael Gordon,14,0,65,51
1658064191870,COGS 101C,A01,083625,Delgado; Tania,17,0,35,18
1658064197900,COGS 107A,A01,083627,Boyle; Mary E. T.,14,0,60,46
1658064203928,COGS 118A,A01,083075,Gupta; Anjum,21,0,76,55
1658064209956,CSE 3,A50,083646,Miranda; Gregory Joseph,24,0,50,26
1658064215982,CSE 8A,A50,083650,Miranda; Gregory Joseph,17,1,56,39
1658064222011,CSE 11,A01,083080,Cao; Yingjun,7,15,40,33
1658064228042,CSE 12,A01,083652,Krause-Levy; Sophia Louisa,30,1,120,90
1658064234082,CSE 15L,A01,083654,Morris; Justin Loren,9,0,50,41
1658064234082,CSE 15L,A02,083655,Morris; Justin Loren,11,0,50,39
1658064240126,CSE 20,A01,083657,Tran; Khoa Dang,39,0,80,41
1658064246153,CSE 21,A01,095574,Bach; Quang Tran,23,0,48,25
1658064252179,CSE 30,A01,083084,Eldon; John,8,0,80,72
1658064252179,CSE 30,B01,095061,Bhaskar; Nishant,9,0,50,41
1658064258210,CSE 100,A01,083659,Cao; Yingjun,5,4,70,65
1658064264236,CSE 134B,A01,083661,Powell; Thomas Allan,25,0,100,75
1658064270262,CSE 140,A01,083663,Gungor; Onat,17,0,85,68
1658064276289,CSE 140L,A01,083088,Eldon; John,23,0,100,77
1658064282316,CSE 175,A01,083665,Kumar; Rakesh,3,0,25,22
1658064288342,CSE 190,A00,092507,Dubnov; Shlomo,8,0,20,12
1658064294381,ECE 45,A01,083139,Congero; Spencer William,7,0,75,68
1658064300409,ECE 65,A50,083695,Saad; Andrew S,12,0,30,18
1658064300409,ECE 65,A51,095125,Saad; Andrew S,24,0,26,2
1658064306442,ECE 109,A01,091882,Touri; Behrouz,21,0,70,49
1658064312469,ECE 180,A00,083140,Abi Samra; Nicholas Camill,1,0,30,29
1658064312469,ECE 180,B00,083141,Abi Samra; Nicholas Camill,0,0,30,30
1658064318498,MATH 10A,A01,083735,Patchell; Gregory David,2,0,30,28
1658064318498,MATH 10A,A02,083736,Patchell; Gregory David,20,0,30,10
1658064318498,MATH 10A,A03,083737,Patchell; Gregory David,16,0,30,14
1658064324534,MATH 10B,A01,083207,Lim; Seonhee,9,0,34,25
1658064324534,MATH 10B,A02,083208,Lim; Seonhee,10,0,35,25
1658064324534,MATH 10B,A03,093472,Lim; Seonhee,7,0,34,27
1658064324534,MATH 10B,B01,083739,Sinha; Shubham,14,0,30,16
1658064330562,MATH 18,A01,083743,Cinel; Cameron Alexander,9,0,30,21
1658064330562,MATH 18,A02,083744,Cinel; Cameron Alexander,18,0,30,12
1658064330562,MATH 18,A03,083745,Cinel; Cameron Alexander,10,0,30,20
1658064330562,MATH 18,B01,083748,Rideout; David Porter,5,0,37,32
1658064330562,MATH 18,B02,083749,Rideout; David Porter,5,0,36,31
1658064330562,MATH 18,B03,083750,Rideout; David Porter,3,0,37,34
1658064330562,MATH 18,B04,083751,Rideout; David Porter,7,0,36,29
1658064330562,MATH 18,B05,093473,Rideout; David Porter,7,0,36,29
1658064330562,MATH 18,B06,093474,Rideout; David Porter,6,0,36,30
1658064336593,MATH 20A,A01,083754,Zheng; Zequn,14,0,40,26
1658064342620,MATH 20B,A01,083756,Briones; Jor-el Thomas Caparas,4,0,36,32
1658064342620,MATH 20B,A02,083757,Briones; Jor-el Thomas Caparas,1,0,36,35
1658064342620,MATH 20B,A03,093475,Briones; Jor-el Thomas Caparas,3,0,36,33
1658064348652,MATH 20C,A01,083760,Briones; Jor-el Thomas Caparas,1,0,35,34
1658064348652,MATH 20C,A02,083761,Briones; Jor-el Thomas Caparas,8,0,35,27
1658064348652,MATH 20C,A03,093476,Briones; Jor-el Thomas Caparas,0,1,36,36
1658064348652,MATH 20C,B01,083762,Bach; Quang Tran,1,0,30,29
1658064354679,MATH 20D,A01,083765,Tran; Brian Kha,5,0,30,25
1658064354679,MATH 20D,A02,083766,Tran; Brian Kha,5,0,30,25
1658064354679,MATH 20D,A03,083767,Tran; Brian Kha,6,0,30,24
1658064360708,MATH 20E,A01,083771,Ganguly; Soumya,12,0,32,20
1658064360708,MATH 20E,A02,083772,Ganguly; Soumya,7,0,32,25
1658064360708,MATH 20E,B01,083773,Ciotti; Benjamin,20,0,35,15
1658064360708,MATH 20E,B02,083774,Ciotti; Benjamin,18,0,35,17
1658064366834,MATH 103A,A01,083777,Greenfeld; Be'Eri,6,0,36,30
1658064366834,MATH 103A,A02,083778,Greenfeld; Be'Eri,5,0,36,31
1658064366834,MATH 103A,A03,093561,Greenfeld; Be'Eri,7,0,36,29
1658064366834,MATH 103A,B01,083779,Greenfeld; Be'Eri,8,0,36,28
1658064366834,MATH 103A,B02,083780,Greenfeld; Be'Eri,4,0,36,32
1658064366834,MATH 103A,B03,093562,Greenfeld; Be'Eri,3,0,36,33
1658064372865,MATH 105,A01,085443,Carter; Anne Toulson,15,0,35,20
1658064372865,MATH 105,A02,093477,Carter; Anne Toulson,20,0,35,15
1658064378899,MATH 109,A01,083213,Ganzberger; Geoffrey Michael,3,0,34,31
1658064378899,MATH 109,A02,083214,Ganzberger; Geoffrey Michael,4,0,34,30
1658064378899,MATH 109,A03,093478,Ganzberger; Geoffrey Michael,2,0,34,32
1658064378899,MATH 109,B01,083215,Ganzberger; Geoffrey Michael,3,0,32,29
1658064378899,MATH 109,B02,083216,Ganzberger; Geoffrey Michael,3,0,32,29
1658064378899,MATH 109,B03,093479,Ganzberger; Geoffrey Michael,8,0,32,24
1658064384927,MATH 142A,A01,083219,Chow; Bennett,7,0,32,25
1658064384927,MATH 142A,A02,083220,Chow; Bennett,10,0,32,22
1658064384927,MATH 142A,A03,093480,Chow; Bennett,9,0,32,23
1658064384927,MATH 142A,B03,093481,Chow; Bennett,8,0,32,24
1658064384927,MATH 142A,B04,093558,Chow; Bennett,14,0,32,18
1658064384927,MATH 142A,B05,093559,Chow; Bennett,7,0,32,25
1658064390960,MATH 193A,A01,083224,Rotar; Vladimir,9,0,34,25
1658064390960,MATH 193A,A02,083225,Rotar; Vladimir,11,0,34,23
1658064390960,MATH 193A,A03,083781,Rotar; Vladimir,5,0,34,29
1658064390960,MATH 193A,A04,083782,Rotar; Vladimir,12,0,34,22
1658064390960,MATH 193A,A05,093482,Rotar; Vladimir,11,0,34,23
1658064396990,MATH 197,001,091859,McAuley; Julian John,9999,0,9999,0
1658064396990,MATH 197,002,095566,Kedlaya; Kiran S.,9997,0,9999,2
1658064396990,MATH 197,003,095567,Xiao; Ming,9999,0,9999,0
1658064396990,MATH 197,004,095571,Perols; Johan Lars,9998,0,9999,1
1658064404051,COGS 9,A01,083615,Shannon; Kyle Michael,11,0,75,64
1658064410083,COGS 11,A01,083617,Boyle; Mary E. T.,23,0,48,25
1658064416116,COGS 13,A01,083071,Bastos; Amalia Pinkusfeld,12,0,71,59
1658064422146,COGS 14A,A01,092681,Semenuks; Arturs,5,1,100,95
1658064428171,COGS 14B,A01,083073,Cheng; Tzu-Han,7,0,63,56
1658064434199,COGS 17,A01,092677,Semenuks; Arturs,7,0,81,74
1658064440225,COGS 100,A01,083619,Allen; Michael Gordon,17,0,70,53
1658064446258,COGS 101A,A01,083621,Davis; Joshua Daniel,9,0,68,59
1658064452282,COGS 101B,A01,091572,Allen; Michael Gordon,14,0,65,51
1658064458310,COGS 101C,A01,083625,Delgado; Tania,17,0,35,18
1658064464333,COGS 107A,A01,083627,Boyle; Mary E. T.,14,0,60,46
1658064470359,COGS 118A,A01,083075,Gupta; Anjum,21,0,76,55
1658064476390,CSE 3,A50,083646,Miranda; Gregory Joseph,24,0,50,26
1658064482415,CSE 8A,A50,083650,Miranda; Gregory Joseph,17,1,56,39
1658064488439,CSE 11,A01,083080,Cao; Yingjun,7,15,40,33
1658064494464,CSE 12,A01,083652,Krause-Levy; Sophia Louisa,30,1,120,90
1658064500490,CSE 15L,A01,083654,Morris; Justin Loren,9,0,50,41
1658064500490,CSE 15L,A02,083655,Morris; Justin Loren,11,0,50,39
1658064506519,CSE 20,A01,083657,Tran; Khoa Dang,39,0,80,41
1658064512545,CSE 21,A01,095574,Bach; Quang Tran,23,0,48,25
1658064518571,CSE 30,A01,083084,Eldon; John,8,0,80,72
1658064518571,CSE 30,B01,095061,Bhaskar; Nishant,9,0,50,41
1658064524601,CSE 100,A01,083659,Cao; Yingjun,5,4,70,65
1658064530627,CSE 134B,A01,083661,Powell; Thomas Allan,25,0,100,75
1658064536654,CSE 140,A01,083663,Gungor; Onat,17,0,85,68
1658064542679,CSE 140L,A01,083088,Eldon; John,23,0,100,77
1658064548711,CSE 175,A01,083665,Kumar; Rakesh,3,0,25,22
1658064554742,CSE 190,A00,092507,Dubnov; Shlomo,8,0,20,12
1658064560769,ECE 45,A01,083139,Congero; Spencer William,7,0,75,68
1658064566802,ECE 65,A50,083695,Saad; Andrew S,12,0,30,18
1658064566802,ECE 65,A51,095125,Saad; Andrew S,24,0,26,2
1658064572839,ECE 109,A01,091882,Touri; Behrouz,21,0,70,49
1658064578864,ECE 180,A00,083140,Abi Samra; Nicholas Camill,1,0,30,29
1658064578864,ECE 180,B00,083141,Abi Samra; Nicholas Camill,0,0,30,30
1658064584897,MATH 10A,A01,083735,Patchell; Gregory David,2,0,30,28
1658064584897,MATH 10A,A02,083736,Patchell; Gregory David,20,0,30,10
1658064584897,MATH 10A,A03,083737,Patchell; Gregory David,16,0,30,14
1658064590926,MATH 10B,A01,083207,Lim; Seonhee,9,0,34,25
1658064590926,MATH 10B,A02,083208,Lim; Seonhee,10,0,35,25
1658064590926,MATH 10B,A03,093472,Lim; Seonhee,7,0,34,27
1658064590926,MATH 10B,B01,083739,Sinha; Shubham,14,0,30,16
1658064596956,MATH 18,A01,083743,Cinel; Cameron Alexander,9,0,30,21
1658064596956,MATH 18,A02,083744,Cinel; Cameron Alexander,18,0,30,12
1658064596956,MATH 18,A03,083745,Cinel; Cameron Alexander,10,0,30,20
1658064596956,MATH 18,B01,083748,Rideout; David Porter,5,0,37,32
1658064596956,MATH 18,B02,083749,Rideout; David Porter,5,0,36,31
1658064596956,MATH 18,B03,083750,Rideout; David Porter,3,0,37,34
1658064596956,MATH 18,B04,083751,Rideout; David Porter,7,0,36,29
1658064596956,MATH 18,B05,093473,Rideout; David Porter,7,0,36,29
1658064596956,MATH 18,B06,093474,Rideout; David Porter,6,0,36,30
1658064602992,MATH 20A,A01,083754,Zheng; Zequn,14,0,40,26
1658064609025,MATH 20B,A01,083756,Briones; Jor-el Thomas Caparas,4,0,36,32
1658064609025,MATH 20B,A02,083757,Briones; Jor-el Thomas Caparas,1,0,36,35
1658064609025,MATH 20B,A03,093475,Briones; Jor-el Thomas Caparas,3,0,36,33
1658064615050,MATH 20C,A01,083760,Briones; Jor-el Thomas Caparas,1,0,35,34
1658064615050,MATH 20C,A02,083761,Briones; Jor-el Thomas Caparas,8,0,35,27
1658064615050,MATH 20C,A03,093476,Briones; Jor-el Thomas Caparas,0,1,36,36
1658064615050,MATH 20C,B01,083762,Bach; Quang Tran,1,0,30,29
1658064621079,MATH 20D,A01,083765,Tran; Brian Kha,5,0,30,25
1658064621079,MATH 20D,A02,083766,Tran; Brian Kha,5,0,30,25
1658064621079,MATH 20D,A03,083767,Tran; Brian Kha,6,0,30,24
1658064627109,MATH 20E,A01,083771,Ganguly; Soumya,12,0,32,20
1658064627109,MATH 20E,A02,083772,Ganguly; Soumya,7,0,32,25
1658064627109,MATH 20E,B01,083773,Ciotti; Benjamin,20,0,35,15
1658064627109,MATH 20E,B02,083774,Ciotti; Benjamin,18,0,35,17
1658064633145,MATH 103A,A01,083777,Greenfeld; Be'Eri,6,0,36,30
1658064633145,MATH 103A,A02,083778,Greenfeld; Be'Eri,5,0,36,31
1658064633145,MATH 103A,A03,093561,Greenfeld; Be'Eri,7,0,36,29
1658064633145,MATH 103A,B01,083779,Greenfeld; Be'Eri,8,0,36,28
1658064633145,MATH 103A,B02,083780,Greenfeld; Be'Eri,4,0,36,32
1658064633145,MATH 103A,B03,093562,Greenfeld; Be'Eri,3,0,36,33
1658064639178,MATH 105,A01,085443,Carter; Anne Toulson,15,0,35,20
1658064639178,MATH 105,A02,093477,Carter; Anne Toulson,20,0,35,15
1658064645205,MATH 109,A01,083213,Ganzberger; Geoffrey Michael,3,0,34,31
1658064645205,MATH 109,A02,083214,Ganzberger; Geoffrey Michael,4,0,34,30
1658064645205,MATH 109,A03,093478,Ganzberger; Geoffrey Michael,2,0,34,32
1658064645205,MATH 109,B01,083215,Ganzberger; Geoffrey Michael,3,0,32,29
1658064645205,MATH 109,B02,083216,Ganzberger; Geoffrey Michael,3,0,32,29
1658064645205,MATH 109,B03,093479,Ganzberger; Geoffrey Michael,8,0,32,24
1658064651232,MATH 142A,A01,083219,Chow; Bennett,7,0,32,25
1658064651232,MATH 142A,A02,083220,Chow; Bennett,10,0,32,22
1658064651232,MATH 142A,A03,093480,Chow; Bennett,9,0,32,23
1658064651232,MATH 142A,B03,093481,Chow; Bennett,8,0,32,24
1658064651232,MATH 142A,B04,093558,Chow; Bennett,14,0,32,18
1658064651232,MATH 142A,B05,093559,Chow; Bennett,7,0,32,25
1658064657259,MATH 193A,A01,083224,Rotar; Vladimir,9,0,34,25
1658064657259,MATH 193A,A02,083225,Rotar; Vladimir,11,0,34,23
1658064657259,MATH 193A,A03,083781,Rotar; Vladimir,5,0,34,29
1658064657259,MATH 193A,A04,083782,Rotar; Vladimir,12,0,34,22
1658064657259,MATH 193A,A05,093482,Rotar; Vladimir,11,0,34,23
1658064663284,MATH 197,001,091859,McAuley; Julian John,9999,0,9999,0
1658064663284,MATH 197,002,095566,Kedlaya; Kiran S.,9997,0,9999,2
1658064663284,MATH 197,003,095567,Xiao; Ming,9999,0,9999,0
1658064663284,MATH 197,004,095571,Perols; Johan Lars,9998,0,9999,1
1658064670345,COGS 9,A01,083615,Shannon; Kyle Michael,11,0,75,64
1658064676373,COGS 11,A01,083617,Boyle; Mary E. T.,23,0,48,25
1658064682397,COGS 13,A01,083071,Bastos; Amalia Pinkusfeld,12,0,71,59
1658064688425,COGS 14A,A01,092681,Semenuks; Arturs,5,1,100,95
1658064694451,COGS 14B,A01,083073,Cheng; Tzu-Han,7,0,63,56
1658064700477,COGS 17,A01,092677,Semenuks; Arturs,7,0,81,74
1658064706506,COGS 100,A01,083619,Allen; Michael Gordon,17,0,70,53
1658064712531,COGS 101A,A01,083621,Davis; Joshua Daniel,9,0,68,59
1658064718561,COGS 101B,A01,091572,Allen; Michael Gordon,14,0,65,51
1658064724586,COGS 101C,A01,083625,Delgado; Tania,17,0,35,18
1658064730610,COGS 107A,A01,083627,Boyle; Mary E. T.,14,0,60,46
1658064736635,COGS 118A,A01,083075,Gupta; Anjum,21,0,76,55
1658064742664,CSE 3,A50,083646,Miranda; Gregory Joseph,24,0,50,26
1658064748687,CSE 8A,A50,083650,Miranda; Gregory Joseph,17,1,56,39
1658064754711,CSE 11,A01,083080,Cao; Yingjun,7,15,40,33
1658064760735,CSE 12,A01,083652,Krause-Levy; Sophia Louisa,30,1,120,90
1658064766758,CSE 15L,A01,083654,Morris; Justin Loren,9,0,50,41
1658064766758,CSE 15L,A02,083655,Morris; Justin Loren,11,0,50,39
1658064772785,CSE 20,A01,083657,Tran; Khoa Dang,39,0,80,41
1658064778812,CSE 21,A01,095574,Bach; Quang Tran,23,0,48,25
1658064784841,CSE 30,A01,083084,Eldon; John,8,0,80,72
1658064784841,CSE 30,B01,095061,Bhaskar; Nishant,9,0,50,41
1658064790868,CSE 100,A01,083659,Cao; Yingjun,5,4,70,65
1658064796895,CSE 134B,A01,083661,Powell; Thomas Allan,25,0,100,75
1658064802918,CSE 140,A01,083663,Gungor; Onat,17,0,85,68
1658064808941,CSE 140L,A01,083088,Eldon; John,23,0,100,77
1658064814965,CSE 175,A01,083665,Kumar; Rakesh,3,0,25,22
1658064820991,CSE 190,A00,092507,Dubnov; Shlomo,8,0,20,12
1658064827015,ECE 45,A01,083139,Congero; Spencer William,7,0,75,68
1658064833040,ECE 65,A50,083695,Saad; Andrew S,12,0,30,18
1658064833040,ECE 65,A51,095125,Saad; Andrew S,24,0,26,2
1658064839070,ECE 109,A01,091882,Touri; Behrouz,21,0,70,49
1658064845101,ECE 180,A00,083140,Abi Samra; Nicholas Camill,1,0,30,29
1658064845101,ECE 180,B00,083141,Abi Samra; Nicholas Camill,0,0,30,30
1658064851132,MATH 10A,A01,083735,Patchell; Gregory David,2,0,30,28
1658064851132,MATH 10A,A02,083736,Patchell; Gregory David,20,0,30,10
1658064851132,MATH 10A,A03,083737,Patchell; Gregory David,16,0,30,14
1658064857158,MATH 10B,A01,083207,Lim; Seonhee,9,0,34,25
1658064857158,MATH 10B,A02,083208,Lim; Seonhee,10,0,35,25
1658064857158,MATH 10B,A03,093472,Lim; Seonhee,7,0,34,27
1658064857158,MATH 10B,B01,083739,Sinha; Shubham,14,0,30,16
1658064863186,MATH 18,A01,083743,Cinel; Cameron Alexander,9,0,30,21
1658064863186,MATH 18,A02,083744,Cinel; Cameron Alexander,18,0,30,12
1658064863186,MATH 18,A03,083745,Cinel; Cameron Alexander,10,0,30,20
1658064863186,MATH 18,B01,083748,Rideout; David Porter,5,0,37,32
1658064863186,MATH 18,B02,083749,Rideout; David Porter,5,0,36,31
1658064863186,MATH 18,B03,083750,Rideout; David Porter,3,0,37,34
1658064863186,MATH 18,B04,083751,Rideout; David Porter,7,0,36,29
1658064863186,MATH 18,B05,093473,Rideout; David Porter,7,0,36,29
1658064863186,MATH 18,B06,093474,Rideout; David Porter,6,0,36,30
1658064869220,MATH 20A,A01,083754,Zheng; Zequn,14,0,40,26
1658064875246,MATH 20B,A01,083756,Briones; Jor-el Thomas Caparas,4,0,36,32
1658064875246,MATH 20B,A02,083757,Briones; Jor-el Thomas Caparas,1,0,36,35
1658064875246,MATH 20B,A03,093475,Briones; Jor-el Thomas Caparas,3,0,36,33
1658064881277,MATH 20C,A01,083760,Briones; Jor-el Thomas Caparas,1,0,35,34
1658064881277,MATH 20C,A02,083761,Briones; Jor-el Thomas Caparas,8,0,35,27
1658064881277,MATH 20C,A03,093476,Briones; Jor-el Thomas Caparas,0,1,36,36
1658064881277,MATH 20C,B01,083762,Bach; Quang Tran,1,0,30,29
1658064887308,MATH 20D,A01,083765,Tran; Brian Kha,5,0,30,25
1658064887308,MATH 20D,A02,083766,Tran; Brian Kha,5,0,30,25
1658064887308,MATH 20D,A03,083767,Tran; Brian Kha,6,0,30,24
1658064893346,MATH 20E,A01,083771,Ganguly; Soumya,12,0,32,20
1658064893346,MATH 20E,A02,083772,Ganguly; Soumya,7,0,32,25
1658064893346,MATH 20E,B01,083773,Ciotti; Benjamin,20,0,35,15
1658064893346,MATH 20E,B02,083774,Ciotti; Benjamin,18,0,35,17
1658064899377,MATH 103A,A01,083777,Greenfeld; Be'Eri,6,0,36,30
1658064899377,MATH 103A,A02,083778,Greenfeld; Be'Eri,5,0,36,31
1658064899377,MATH 103A,A03,093561,Greenfeld; Be'Eri,7,0,36,29
1658064899377,MATH 103A,B01,083779,Greenfeld; Be'Eri,8,0,36,28
1658064899377,MATH 103A,B02,083780,Greenfeld; Be'Eri,4,0,36,32
1658064899377,MATH 103A,B03,093562,Greenfeld; Be'Eri,3,0,36,33
1658064905403,MATH 105,A01,085443,Carter; Anne Toulson,15,0,35,20
1658064905403,MATH 105,A02,093477,Carter; Anne Toulson,20,0,35,15
1658064911432,MATH 109,A01,083213,Ganzberger; Geoffrey Michael,3,0,34,31
1658064911432,MATH 109,A02,083214,Ganzberger; Geoffrey Michael,4,0,34,30
1658064911432,MATH 109,A03,093478,Ganzberger; Geoffrey Michael,2,0,34,32
1658064911432,MATH 109,B01,083215,Ganzberger; Geoffrey Michael,3,0,32,29
1658064911432,MATH 109,B02,083216,Ganzberger; Geoffrey Michael,3,0,32,29
1658064911432,MATH 109,B03,093479,Ganzberger; Geoffrey Michael,8,0,32,24
1658064917458,MATH 142A,A01,083219,Chow; Bennett,7,0,32,25
1658064917458,MATH 142A,A02,083220,Chow; Bennett,10,0,32,22
1658064917458,MATH 142A,A03,093480,Chow; Bennett,9,0,32,23
1658064917458,MATH 142A,B03,093481,Chow; Bennett,8,0,32,24
1658064917458,MATH 142A,B04,093558,Chow; Bennett,14,0,32,18
1658064917458,MATH 142A,B05,093559,Chow; Bennett,7,0,32,25
1658064923488,MATH 193A,A01,083224,Rotar; Vladimir,9,0,34,25
1658064923488,MATH 193A,A02,083225,Rotar; Vladimir,11,0,34,23
1658064923488,MATH 193A,A03,083781,Rotar; Vladimir,5,0,34,29
1658064923488,MATH 193A,A04,083782,Rotar; Vladimir,12,0,34,22
1658064923488,MATH 193A,A05,093482,Rotar; Vladimir,11,0,34,23
1658064929514,MATH 197,001,091859,McAuley; Julian John,9999,0,9999,0
1658064929514,MATH 197,002,095566,Kedlaya; Kiran S.,9997,0,9999,2
1658064929514,MATH 197,003,095567,Xiao; Ming,9999,0,9999,0
1658064929514,MATH 197,004,095571,Perols; Johan Lars,9998,0,9999,1
1658064936592,COGS 9,A01,083615,Shannon; Kyle Michael,11,0,75,64
1658064942627,COGS 11,A01,083617,Boyle; Mary E. T.,23,0,48,25
1658064948656,COGS 13,A01,083071,Bastos; Amalia Pinkusfeld,12,0,71,59
1658064954686,COGS 14A,A01,092681,Semenuks; Arturs,5,1,100,95
1658064960784,COGS 14B,A01,083073,Cheng; Tzu-Han,7,0,63,56
1658064966810,COGS 17,A01,092677,Semenuks; Arturs,7,0,81,74
1658064972836,COGS 100,A01,083619,Allen; Michael Gordon,17,0,70,53
1658064978866,COGS 101A,A01,083621,Davis; Joshua Daniel,9,0,68,59
1658064984894,COGS 101B,A01,091572,Allen; Michael Gordon,14,0,65,51
1658064990921,COGS 101C,A01,083625,Delgado; Tania,17,0,35,18
1658064996953,COGS 107A,A01,083627,Boyle; Mary E. T.,14,0,60,46
1658065002979,COGS 118A,A01,083075,Gupta; Anjum,21,0,76,55
1658065009008,CSE 3,A50,083646,Miranda; Gregory Joseph,24,0,50,26
1658065015033,CSE 8A,A50,083650,Miranda; Gregory Joseph,17,1,56,39
1658065021063,CSE 11,A01,083080,Cao; Yingjun,7,15,40,33
1658065027093,CSE 12,A01,083652,Krause-Levy; Sophia Louisa,30,1,120,90
1658065033119,CSE 15L,A01,083654,Morris; Justin Loren,9,0,50,41
1658065033119,CSE 15L,A02,083655,Morris; Justin Loren,11,0,50,39
1658065039145,CSE 20,A01,083657,Tran; Khoa Dang,39,0,80,41
1658065045170,CSE 21,A01,095574,Bach; Quang Tran,23,0,48,25
1658065051196,CSE 30,A01,083084,Eldon; John,8,0,80,72
1658065051196,CSE 30,B01,095061,Bhaskar; Nishant,9,0,50,41
1658065057223,CSE 100,A01,083659,Cao; Yingjun,5,4,70,65
1658065063251,CSE 134B,A01,083661,Powell; Thomas Allan,25,0,100,75
1658065069277,CSE 140,A01,083663,Gungor; Onat,17,0,85,68
1658065075303,CSE 140L,A01,083088,Eldon; John,23,0,100,77
1658065081329,CSE 175,A01,083665,Kumar; Rakesh,3,0,25,22
1658065087357,CSE 190,A00,092507,Dubnov; Shlomo,8,0,20,12
1658065093382,ECE 45,A01,083139,Congero; Spencer William,7,0,75,68
1658065099413,ECE 65,A50,083695,Saad; Andrew S,12,0,30,18
1658065099413,ECE 65,A51,095125,Saad; Andrew S,24,0,26,2
1658065105443,ECE 109,A01,091882,Touri; Behrouz,21,0,70,49
1658065111467,ECE 180,A00,083140,Abi Samra; Nicholas Camill,1,0,30,29
1658065111467,ECE 180,B00,083141,Abi Samra; Nicholas Camill,0,0,30,30
1658065117492,MATH 10A,A01,083735,Patchell; Gregory David,2,0,30,28
1658065117492,MATH 10A,A02,083736,Patchell; Gregory David,20,0,30,10
1658065117492,MATH 10A,A03,083737,Patchell; Gregory David,16,0,30,14
1658065123517,MATH 10B,A01,083207,Lim; Seonhee,9,0,34,25
1658065123517,MATH 10B,A02,083208,Lim; Seonhee,10,0,35,25
1658065123517,MATH 10B,A03,093472,Lim; Seonhee,7,0,34,27
1658065123517,MATH 10B,B01,083739,Sinha; Shubham,14,0,30,16
1658065129545,MATH 18,A01,083743,Cinel; Cameron Alexander,9,0,30,21
1658065129545,MATH 18,A02,083744,Cinel; Cameron Alexander,18,0,30,12
1658065129545,MATH 18,A03,083745,Cinel; Cameron Alexander,10,0,30,20
1658065129545,MATH 18,B01,083748,Rideout; David Porter,5,0,37,32
1658065129545,MATH 18,B02,083749,Rideout; David Porter,5,0,36,31
1658065129545,MATH 18,B03,083750,Rideout; David Porter,3,0,37,34
1658065129545,MATH 18,B04,083751,Rideout; David Porter,7,0,36,29
1658065129545,MATH 18,B05,093473,Rideout; David Porter,7,0,36,29
1658065129545,MATH 18,B06,093474,Rideout; David Porter,6,0,36,30
1658065135574,MATH 20A,A01,083754,Zheng; Zequn,14,0,40,26
1658065141602,MATH 20B,A01,083756,Briones; Jor-el Thomas Caparas,4,0,36,32
1658065141602,MATH 20B,A02,083757,Briones; Jor-el Thomas Caparas,1,0,36,35
1658065141602,MATH 20B,A03,093475,Briones; Jor-el Thomas Caparas,3,0,36,33
1658065147631,MATH 20C,A01,083760,Briones; Jor-el Thomas Caparas,1,0,35,34
1658065147631,MATH 20C,A02,083761,Briones; Jor-el Thomas Caparas,8,0,35,27
1658065147631,MATH 20C,A03,093476,Briones; Jor-el Thomas Caparas,0,1,36,36
1658065147631,MATH 20C,B01,083762,Bach; Quang Tran,1,0,30,29
1658065153661,MATH 20D,A01,083765,Tran; Brian Kha,5,0,30,25
1658065153661,MATH 20D,A02,083766,Tran; Brian Kha,5,0,30,25
1658065153661,MATH 20D,A03,083767,Tran; Brian Kha,6,0,30,24
1658065159691,MATH 20E,A01,083771,Ganguly; Soumya,12,0,32,20
1658065159691,MATH 20E,A02,083772,Ganguly; Soumya,7,0,32,25
1658065159691,MATH 20E,B01,083773,Ciotti; Benjamin,20,0,35,15
1658065159691,MATH 20E,B02,083774,Ciotti; Benjamin,18,0,35,17
1658065165720,MATH 103A,A01,083777,Greenfeld; Be'Eri,6,0,36,30
1658065165720,MATH 103A,A02,083778,Greenfeld; Be'Eri,5,0,36,31
1658065165720,MATH 103A,A03,093561,Greenfeld; Be'Eri,7,0,36,29
1658065165720,MATH 103A,B01,083779,Greenfeld; Be'Eri,8,0,36,28
1658065165720,MATH 103A,B02,083780,Greenfeld; Be'Eri,4,0,36,32
1658065165720,MATH 103A,B03,093562,Greenfeld; Be'Eri,3,0,36,33
1658065171745,MATH 105,A01,085443,Carter; Anne Toulson,15,0,35,20
1658065171745,MATH 105,A02,093477,Carter; Anne Toulson,20,0,35,15
1658065177771,MATH 109,A01,083213,Ganzberger; Geoffrey Michael,3,0,34,31
1658065177771,MATH 109,A02,083214,Ganzberger; Geoffrey Michael,4,0,34,30
1658065177771,MATH 109,A03,093478,Ganzberger; Geoffrey Michael,2,0,34,32
1658065177771,MATH 109,B01,083215,Ganzberger; Geoffrey Michael,3,0,32,29
1658065177771,MATH 109,B02,083216,Ganzberger; Geoffrey Michael,3,0,32,29
1658065177771,MATH 109,B03,093479,Ganzberger; Geoffrey Michael,8,0,32,24
1658065183794,MATH 142A,A01,083219,Chow; Bennett,7,0,32,25
1658065183794,MATH 142A,A02,083220,Chow; Bennett,10,0,32,22
1658065183794,MATH 142A,A03,093480,Chow; Bennett,9,0,32,23
1658065183794,MATH 142A,B03,093481,Chow; Bennett,8,0,32,24
1658065183794,MATH 142A,B04,093558,Chow; Bennett,14,0,32,18
1658065183794,MATH 142A,B05,093559,Chow; Bennett,7,0,32,25
1658065189823,MATH 193A,A01,083224,Rotar; Vladimir,9,0,34,25
1658065189823,MATH 193A,A02,083225,Rotar; Vladimir,11,0,34,23
1658065189823,MATH 193A,A03,083781,Rotar; Vladimir,5,0,34,29
1658065189823,MATH 193A,A04,083782,Rotar; Vladimir,12,0,34,22
1658065189823,MATH 193A,A05,093482,Rotar; Vladimir,11,0,34,23
1658065195849,MATH 197,001,091859,McAuley; Julian John,9999,0,9999,0
1658065195849,MATH 197,002,095566,Kedlaya; Kiran S.,9997,0,9999,2
1658065195849,MATH 197,003,095567,Xiao; Ming,9999,0,9999,0
1658065195849,MATH 197,004,095571,Perols; Johan Lars,9998,0,9999,1
1658065202920,COGS 9,A01,083615,Shannon; Kyle Michael,11,0,75,64
1658065208945,COGS 11,A01,083617,Boyle; Mary E. T.,23,0,48,25
1658065214975,COGS 13,A01,083071,Bastos; Amalia Pinkusfeld,12,0,71,59
1658065221005,COGS 14A,A01,092681,Semenuks; Arturs,5,1,100,95
1658065227035,COGS 14B,A01,083073,Cheng; Tzu-Han,7,0,63,56
1658065233059,COGS 17,A01,092677,Semenuks; Arturs,7,0,81,74
1658065239087,COGS 100,A01,083619,Allen; Michael Gordon,17,0,70,53
1658065245116,COGS 101A,A01,083621,Davis; Joshua Daniel,9,0,68,59
1658065251140,COGS 101B,A01,091572,Allen; Michael Gordon,14,0,65,51
1658065257164,COGS 101C,A01,083625,Delgado; Tania,17,0,35,18
1658065263190,COGS 107A,A01,083627,Boyle; Mary E. T.,14,0,60,46
1658065269215,COGS 118A,A01,083075,Gupta; Anjum,21,0,76,55
1658065275248,CSE 3,A50,083646,Miranda; Gregory Joseph,24,0,50,26
1658065281277,CSE 8A,A50,083650,Miranda; Gregory Joseph,17,1,56,39
1658065287318,CSE 11,A01,083080,Cao; Yingjun,7,15,40,33
1658065293347,CSE 12,A01,083652,Krause-Levy; Sophia Louisa,30,1,120,90
1658065299375,CSE 15L,A01,083654,Morris; Justin Loren,9,0,50,41
1658065299375,CSE 15L,A02,083655,Morris; Justin Loren,11,0,50,39
1658065305404,CSE 20,A01,083657,Tran; Khoa Dang,39,0,80,41
1658065311439,CSE 21,A01,095574,Bach; Quang Tran,23,0,48,25
1658065317467,CSE 30,A01,083084,Eldon; John,8,0,80,72
1658065317467,CSE 30,B01,095061,Bhaskar; Nishant,9,0,50,41
1658065323492,CSE 100,A01,083659,Cao; Yingjun,5,4,70,65
1658065329520,CSE 134B,A01,083661,Powell; Thomas Allan,25,0,100,75
1658065335542,CSE 140,A01,083663,Gungor; Onat,17,0,85,68
1658065341570,CSE 140L,A01,083088,Eldon; John,23,0,100,77
1658065347606,CSE 175,A01,083665,Kumar; Rakesh,3,0,25,22
1658065353631,CSE 190,A00,092507,Dubnov; Shlomo,8,0,20,12
1658065359653,ECE 45,A01,083139,Congero; Spencer William,7,0,75,68
1658065365678,ECE 65,A50,083695,Saad; Andrew S,12,0,30,18
1658065365678,ECE 65,A51,095125,Saad; Andrew S,24,0,26,2
1658065371703,ECE 109,A01,091882,Touri; Behrouz,21,0,70,49
1658065377730,ECE 180,A00,083140,Abi Samra; Nicholas Camill,1,0,30,29
1658065377730,ECE 180,B00,083141,Abi Samra; Nicholas Camill,0,0,30,30
1658065383755,MATH 10A,A01,083735,Patchell; Gregory David,2,0,30,28
1658065383755,MATH 10A,A02,083736,Patchell; Gregory David,20,0,30,10
1658065383755,MATH 10A,A03,083737,Patchell; Gregory David,16,0,30,14
1658065389781,MATH 10B,A01,083207,Lim; Seonhee,9,0,34,25
1658065389781,MATH 10B,A02,083208,Lim; Seonhee,10,0,35,25
1658065389781,MATH 10B,A03,093472,Lim; Seonhee,7,0,34,27
1658065389781,MATH 10B,B01,083739,Sinha; Shubham,14,0,30,16
1658065395808,MATH 18,A01,083743,Cinel; Cameron Alexander,9,0,30,21
1658065395808,MATH 18,A02,083744,Cinel; Cameron Alexander,18,0,30,12
1658065395808,MATH 18,A03,083745,Cinel; Cameron Alexander,10,0,30,20
1658065395808,MATH 18,B01,083748,Rideout; David Porter,5,0,37,32
1658065395808,MATH 18,B02,083749,Rideout; David Porter,5,0,36,31
1658065395808,MATH 18,B03,083750,Rideout; David Porter,3,0,37,34
1658065395808,MATH 18,B04,083751,Rideout; David Porter,7,0,36,29
1658065395808,MATH 18,B05,093473,Rideout; David Porter,7,0,36,29
1658065395808,MATH 18,B06,093474,Rideout; David Porter,6,0,36,30
1658065401835,MATH 20A,A01,083754,Zheng; Zequn,14,0,40,26
1658065407865,MATH 20B,A01,083756,Briones; Jor-el Thomas Caparas,4,0,36,32
1658065407865,MATH 20B,A02,083757,Briones; Jor-el Thomas Caparas,1,0,36,35
1658065407865,MATH 20B,A03,093475,Briones; Jor-el Thomas Caparas,3,0,36,33
1658065413894,MATH 20C,A01,083760,Briones; Jor-el Thomas Caparas,1,0,35,34
1658065413894,MATH 20C,A02,083761,Briones; Jor-el Thomas Caparas,8,0,35,27
1658065413894,MATH 20C,A03,093476,Briones; Jor-el Thomas Caparas,0,1,36,36
1658065413894,MATH 20C,B01,083762,Bach; Quang Tran,1,0,30,29
1658065419930,MATH 20D,A01,083765,Tran; Brian Kha,5,0,30,25
1658065419930,MATH 20D,A02,083766,Tran; Brian Kha,5,0,30,25
1658065419930,MATH 20D,A03,083767,Tran; Brian Kha,6,0,30,24
1658065425955,MATH 20E,A01,083771,Ganguly; Soumya,12,0,32,20
1658065425955,MATH 20E,A02,083772,Ganguly; Soumya,7,0,32,25
1658065425955,MATH 20E,B01,083773,Ciotti; Benjamin,20,0,35,15
1658065425955,MATH 20E,B02,083774,Ciotti; Benjamin,18,0,35,17
1658065431980,MATH 103A,A01,083777,Greenfeld; Be'Eri,6,0,36,30
1658065431980,MATH 103A,A02,083778,Greenfeld; Be'Eri,5,0,36,31
1658065431980,MATH 103A,A03,093561,Greenfeld; Be'Eri,7,0,36,29
1658065431980,MATH 103A,B01,083779,Greenfeld; Be'Eri,8,0,36,28
1658065431980,MATH 103A,B02,083780,Greenfeld; Be'Eri,4,0,36,32
1658065431980,MATH 103A,B03,093562,Greenfeld; Be'Eri,3,0,36,33
1658065438005,MATH 105,A01,085443,Carter; Anne Toulson,15,0,35,20
1658065438005,MATH 105,A02,093477,Carter; Anne Toulson,20,0,35,15
1658065444032,MATH 109,A01,083213,Ganzberger; Geoffrey Michael,3,0,34,31
1658065444032,MATH 109,A02,083214,Ganzberger; Geoffrey Michael,4,0,34,30
1658065444032,MATH 109,A03,093478,Ganzberger; Geoffrey Michael,2,0,34,32
1658065444032,MATH 109,B01,083215,Ganzberger; Geoffrey Michael,3,0,32,29
1658065444032,MATH 109,B02,083216,Ganzberger; Geoffrey Michael,3,0,32,29
1658065444032,MATH 109,B03,093479,Ganzberger; Geoffrey Michael,8,0,32,24
1658065450062,MATH 142A,A01,083219,Chow; Bennett,7,0,32,25
1658065450062,MATH 142A,A02,083220,Chow; Bennett,10,0,32,22
1658065450062,MATH 142A,A03,093480,Chow; Bennett,9,0,32,23
1658065450062,MATH 142A,B03,093481,Chow; Bennett,8,0,32,24
1658065450062,MATH 142A,B04,093558,Chow; Bennett,14,0,32,18
1658065450062,MATH 142A,B05,093559,Chow; Bennett,7,0,32,25
1658065456091,MATH 193A,A01,083224,Rotar; Vladimir,9,0,34,25
1658065456091,MATH 193A,A02,083225,Rotar; Vladimir,11,0,34,23
1658065456091,MATH 193A,A03,083781,Rotar; Vladimir,5,0,34,29
1658065456091,MATH 193A,A04,083782,Rotar; Vladimir,12,0,34,22
1658065456091,MATH 193A,A05,093482,Rotar; Vladimir,11,0,34,23
1658065462120,MATH 197,001,091859,McAuley; Julian John,9999,0,9999,0
1658065462120,MATH 197,002,095566,Kedlaya; Kiran S.,9997,0,9999,2
1658065462120,MATH 197,003,095567,Xiao; Ming,9999,0,9999,0
1658065462120,MATH 197,004,095571,Perols; Johan Lars,9998,0,9999,1
1658065469183,COGS 9,A01,083615,Shannon; Kyle Michael,11,0,75,64
1658065475209,COGS 11,A01,083617,Boyle; Mary E. T.,23,0,48,25
1658065481234,COGS 13,A01,083071,Bastos; Amalia Pinkusfeld,12,0,71,59
1658065487262,COGS 14A,A01,092681,Semenuks; Arturs,5,1,100,95
1658065493290,COGS 14B,A01,083073,Cheng; Tzu-Han,7,0,63,56
1658065499317,COGS 17,A01,092677,Semenuks; Arturs,7,0,81,74
1658065505339,COGS 100,A01,083619,Allen; Michael Gordon,17,0,70,53
1658065511370,COGS 101A,A01,083621,Davis; Joshua Daniel,9,0,68,59
1658065517396,COGS 101B,A01,091572,Allen; Michael Gordon,14,0,65,51
1658065523423,COGS 101C,A01,083625,Delgado; Tania,17,0,35,18
1658065529452,COGS 107A,A01,083627,Boyle; Mary E. T.,14,0,60,46
1658065535479,COGS 118A,A01,083075,Gupta; Anjum,21,0,76,55
1658065541505,CSE 3,A50,083646,Miranda; Gregory Joseph,24,0,50,26
1658065547534,CSE 8A,A50,083650,Miranda; Gregory Joseph,17,1,56,39
1658065553562,CSE 11,A01,083080,Cao; Yingjun,7,15,40,33
1658065559656,CSE 12,A01,083652,Krause-Levy; Sophia Louisa,30,1,120,90
1658065565687,CSE 15L,A01,083654,Morris; Justin Loren,9,0,50,41
1658065565687,CSE 15L,A02,083655,Morris; Justin Loren,11,0,50,39
1658065571716,CSE 20,A01,083657,Tran; Khoa Dang,39,0,80,41
1658065577740,CSE 21,A01,095574,Bach; Quang Tran,23,0,48,25
1658065583765,CSE 30,A01,083084,Eldon; John,8,0,80,72
1658065583765,CSE 30,B01,095061,Bhaskar; Nishant,9,0,50,41
1658065589789,CSE 100,A01,083659,Cao; Yingjun,5,4,70,65
1658065595813,CSE 134B,A01,083661,Powell; Thomas Allan,25,0,100,75
1658065601837,CSE 140,A01,083663,Gungor; Onat,17,0,85,68
1658065607869,CSE 140L,A01,083088,Eldon; John,23,0,100,77
1658065613897,CSE 175,A01,083665,Kumar; Rakesh,3,0,25,22
1658065619924,CSE 190,A00,092507,Dubnov; Shlomo,8,0,20,12
1658065625953,ECE 45,A01,083139,Congero; Spencer William,7,0,75,68
1658065631982,ECE 65,A50,083695,Saad; Andrew S,12,0,30,18
1658065631982,ECE 65,A51,095125,Saad; Andrew S,24,0,26,2
1658065638007,ECE 109,A01,091882,Touri; Behrouz,21,0,70,49
1658065644032,ECE 180,A00,083140,Abi Samra; Nicholas Camill,1,0,30,29
1658065644032,ECE 180,B00,083141,Abi Samra; Nicholas Camill,0,0,30,30
1658065650056,MATH 10A,A01,083735,Patchell; Gregory David,2,0,30,28
1658065650056,MATH 10A,A02,083736,Patchell; Gregory David,20,0,30,10
1658065650056,MATH 10A,A03,083737,Patchell; Gregory David,16,0,30,14
1658065656081,MATH 10B,A01,083207,Lim; Seonhee,9,0,34,25
1658065656081,MATH 10B,A02,083208,Lim; Seonhee,10,0,35,25
1658065656081,MATH 10B,A03,093472,Lim; Seonhee,7,0,34,27
1658065656081,MATH 10B,B01,083739,Sinha; Shubham,14,0,30,16
1658065662115,MATH 18,A01,083743,Cinel; Cameron Alexander,9,0,30,21
1658065662115,MATH 18,A02,083744,Cinel; Cameron Alexander,18,0,30,12
1658065662115,MATH 18,A03,083745,Cinel; Cameron Alexander,10,0,30,20
1658065662115,MATH 18,B01,083748,Rideout; David Porter,5,0,37,32
1658065662115,MATH 18,B02,083749,Rideout; David Porter,5,0,36,31
1658065662115,MATH 18,B03,083750,Rideout; David Porter,3,0,37,34
1658065662115,MATH 18,B04,083751,Rideout; David Porter,7,0,36,29
1658065662115,MATH 18,B05,093473,Rideout; David Porter,7,0,36,29
1658065662115,MATH 18,B06,093474,Rideout; David Porter,6,0,36,30
1658065668140,MATH 20A,A01,083754,Zheng; Zequn,14,0,40,26
1658065674168,MATH 20B,A01,083756,Briones; Jor-el Thomas Caparas,4,0,36,32
1658065674168,MATH 20B,A02,083757,Briones; Jor-el Thomas Caparas,1,0,36,35
1658065674168,MATH 20B,A03,093475,Briones; Jor-el Thomas Caparas,3,0,36,33
1658065680194,MATH 20C,A01,083760,Briones; Jor-el Thomas Caparas,1,0,35,34
1658065680194,MATH 20C,A02,083761,Briones; Jor-el Thomas Caparas,8,0,35,27
1658065680194,MATH 20C,A03,093476,Briones; Jor-el Thomas Caparas,0,1,36,36
1658065680194,MATH 20C,B01,083762,Bach; Quang Tran,1,0,30,29
1658065686220,MATH 20D,A01,083765,Tran; Brian Kha,5,0,30,25
1658065686220,MATH 20D,A02,083766,Tran; Brian Kha,5,0,30,25
1658065686220,MATH 20D,A03,083767,Tran; Brian Kha,6,0,30,24
1658065692249,MATH 20E,A01,083771,Ganguly; Soumya,12,0,32,20
1658065692249,MATH 20E,A02,083772,Ganguly; Soumya,7,0,32,25
1658065692249,MATH 20E,B01,083773,Ciotti; Benjamin,20,0,35,15
1658065692249,MATH 20E,B02,083774,Ciotti; Benjamin,18,0,35,17
1658065698275,MATH 103A,A01,083777,Greenfeld; Be'Eri,6,0,36,30
1658065698275,MATH 103A,A02,083778,Greenfeld; Be'Eri,5,0,36,31
1658065698275,MATH 103A,A03,093561,Greenfeld; Be'Eri,7,0,36,29
1658065698275,MATH 103A,B01,083779,Greenfeld; Be'Eri,8,0,36,28
1658065698275,MATH 103A,B02,083780,Greenfeld; Be'Eri,4,0,36,32
1658065698275,MATH 103A,B03,093562,Greenfeld; Be'Eri,3,0,36,33
1658065704301,MATH 105,A01,085443,Carter; Anne Toulson,15,0,35,20
1658065704301,MATH 105,A02,093477,Carter; Anne Toulson,20,0,35,15
1658065710331,MATH 109,A01,083213,Ganzberger; Geoffrey Michael,3,0,34,31
1658065710331,MATH 109,A02,083214,Ganzberger; Geoffrey Michael,4,0,34,30
1658065710331,MATH 109,A03,093478,Ganzberger; Geoffrey Michael,2,0,34,32
1658065710331,MATH 109,B01,083215,Ganzberger; Geoffrey Michael,3,0,32,29
1658065710331,MATH 109,B02,083216,Ganzberger; Geoffrey Michael,3,0,32,29
1658065710331,MATH 109,B03,093479,Ganzberger; Geoffrey Michael,8,0,32,24
1658065716357,MATH 142A,A01,083219,Chow; Bennett,7,0,32,25
1658065716357,MATH 142A,A02,083220,Chow; Bennett,10,0,32,22
1658065716357,MATH 142A,A03,093480,Chow; Bennett,9,0,32,23
1658065716357,MATH 142A,B03,093481,Chow; Bennett,8,0,32,24
1658065716357,MATH 142A,B04,093558,Chow; Bennett,14,0,32,18
1658065716357,MATH 142A,B05,093559,Chow; Bennett,7,0,32,25
1658065722386,MATH 193A,A01,083224,Rotar; Vladimir,9,0,34,25
1658065722386,MATH 193A,A02,083225,Rotar; Vladimir,11,0,34,23
1658065722386,MATH 193A,A03,083781,Rotar; Vladimir,5,0,34,29
1658065722386,MATH 193A,A04,083782,Rotar; Vladimir,12,0,34,22
1658065722386,MATH 193A,A05,093482,Rotar; Vladimir,11,0,34,23
1658065728413,MATH 197,001,091859,McAuley; Julian John,9999,0,9999,0
1658065728413,MATH 197,002,095566,Kedlaya; Kiran S.,9997,0,9999,2
1658065728413,MATH 197,003,095567,Xiao; Ming,9999,0,9999,0
1658065728413,MATH 197,004,095571,Perols; Johan Lars,9998,0,9999,1
1658065735478,COGS 9,A01,083615,Shannon; Kyle Michael,11,0,75,64
1658065741505,COGS 11,A01,083617,Boyle; Mary E. T.,23,0,48,25
1658065747531,COGS 13,A01,083071,Bastos; Amalia Pinkusfeld,12,0,71,59
1658065753560,COGS 14A,A01,092681,Semenuks; Arturs,5,1,100,95
1658065759585,COGS 14B,A01,083073,Cheng; Tzu-Han,7,0,63,56
1658065765614,COGS 17,A01,092677,Semenuks; Arturs,7,0,81,74
1658065771638,COGS 100,A01,083619,Allen; Michael Gordon,17,0,70,53
1658065777663,COGS 101A,A01,083621,Davis; Joshua Daniel,9,0,68,59
1658065783690,COGS 101B,A01,091572,Allen; Michael Gordon,14,0,65,51
1658065789716,COGS 101C,A01,083625,Delgado; Tania,17,0,35,18
1658065795744,COGS 107A,A01,083627,Boyle; Mary E. T.,14,0,60,46
1658065801769,COGS 118A,A01,083075,Gupta; Anjum,21,0,76,55
1658065807794,CSE 3,A50,083646,Miranda; Gregory Joseph,24,0,50,26
1658065813829,CSE 8A,A50,083650,Miranda; Gregory Joseph,17,1,56,39
1658065819854,CSE 11,A01,083080,Cao; Yingjun,7,15,40,33
1658065825881,CSE 12,A01,083652,Krause-Levy; Sophia Louisa,30,1,120,90
1658065831906,CSE 15L,A01,083654,Morris; Justin Loren,9,0,50,41
1658065831906,CSE 15L,A02,083655,Morris; Justin Loren,11,0,50,39
1658065837936,CSE 20,A01,083657,Tran; Khoa Dang,39,0,80,41
1658065843961,CSE 21,A01,095574,Bach; Quang Tran,23,0,48,25
1658065849991,CSE 30,A01,083084,Eldon; John,8,0,80,72
1658065849991,CSE 30,B01,095061,Bhaskar; Nishant,9,0,50,41
1658065856015,CSE 100,A01,083659,Cao; Yingjun,5,4,70,65
1658065862045,CSE 134B,A01,083661,Powell; Thomas Allan,25,0,100,75
1658065868068,CSE 140,A01,083663,Gungor; Onat,17,0,85,68
1658065874097,CSE 140L,A01,083088,Eldon; John,23,0,100,77
1658065880124,CSE 175,A01,083665,Kumar; Rakesh,3,0,25,22
1658065886149,CSE 190,A00,092507,Dubnov; Shlomo,8,0,20,12
1658065892173,ECE 45,A01,083139,Congero; Spencer William,7,0,75,68
1658065898199,ECE 65,A50,083695,Saad; Andrew S,12,0,30,18
1658065898199,ECE 65,A51,095125,Saad; Andrew S,24,0,26,2
1658065904223,ECE 109,A01,091882,Touri; Behrouz,21,0,70,49
1658065910251,ECE 180,A00,083140,Abi Samra; Nicholas Camill,1,0,30,29
1658065910251,ECE 180,B00,083141,Abi Samra; Nicholas Camill,0,0,30,30
1658065916279,MATH 10A,A01,083735,Patchell; Gregory David,2,0,30,28
1658065916279,MATH 10A,A02,083736,Patchell; Gregory David,20,0,30,10
1658065916279,MATH 10A,A03,083737,Patchell; Gregory David,16,0,30,14
1658065922310,MATH 10B,A01,083207,Lim; Seonhee,9,0,34,25
1658065922310,MATH 10B,A02,083208,Lim; Seonhee,10,0,35,25
1658065922310,MATH 10B,A03,093472,Lim; Seonhee,7,0,34,27
1658065922310,MATH 10B,B01,083739,Sinha; Shubham,14,0,30,16
1658065928348,MATH 18,A01,083743,Cinel; Cameron Alexander,9,0,30,21
1658065928348,MATH 18,A02,083744,Cinel; Cameron Alexander,18,0,30,12
1658065928348,MATH 18,A03,083745,Cinel; Cameron Alexander,10,0,30,20
1658065928348,MATH 18,B01,083748,Rideout; David Porter,5,0,37,32
1658065928348,MATH 18,B02,083749,Rideout; David Porter,5,0,36,31
1658065928348,MATH 18,B03,083750,Rideout; David Porter,3,0,37,34
1658065928348,MATH 18,B04,083751,Rideout; David Porter,7,0,36,29
1658065928348,MATH 18,B05,093473,Rideout; David Porter,7,0,36,29
1658065928348,MATH 18,B06,093474,Rideout; David Porter,6,0,36,30
1658065934374,MATH 20A,A01,083754,Zheng; Zequn,14,0,40,26
1658065940399,MATH 20B,A01,083756,Briones; Jor-el Thomas Caparas,4,0,36,32
1658065940399,MATH 20B,A02,083757,Briones; Jor-el Thomas Caparas,1,0,36,35
1658065940399,MATH 20B,A03,093475,Briones; Jor-el Thomas Caparas,3,0,36,33
1658065946427,MATH 20C,A01,083760,Briones; Jor-el Thomas Caparas,1,0,35,34
1658065946427,MATH 20C,A02,083761,Briones; Jor-el Thomas Caparas,8,0,35,27
1658065946427,MATH 20C,A03,093476,Briones; Jor-el Thomas Caparas,0,1,36,36
1658065946427,MATH 20C,B01,083762,Bach; Quang Tran,1,0,30,29
1658065952452,MATH 20D,A01,083765,Tran; Brian Kha,5,0,30,25
1658065952452,MATH 20D,A02,083766,Tran; Brian Kha,5,0,30,25
1658065952452,MATH 20D,A03,083767,Tran; Brian Kha,6,0,30,24
1658065958480,MATH 20E,A01,083771,Ganguly; Soumya,12,0,32,20
1658065958480,MATH 20E,A02,083772,Ganguly; Soumya,7,0,32,25
1658065958480,MATH 20E,B01,083773,Ciotti; Benjamin,20,0,35,15
1658065958480,MATH 20E,B02,083774,Ciotti; Benjamin,18,0,35,17
1658065964504,MATH 103A,A01,083777,Greenfeld; Be'Eri,6,0,36,30
1658065964504,MATH 103A,A02,083778,Greenfeld; Be'Eri,5,0,36,31
1658065964504,MATH 103A,A03,093561,Greenfeld; Be'Eri,7,0,36,29
1658065964504,MATH 103A,B01,083779,Greenfeld; Be'Eri,8,0,36,28
1658065964504,MATH 103A,B02,083780,Greenfeld; Be'Eri,4,0,36,32
1658065964504,MATH 103A,B03,093562,Greenfeld; Be'Eri,3,0,36,33
1658065970533,MATH 105,A01,085443,Carter; Anne Toulson,15,0,35,20
1658065970533,MATH 105,A02,093477,Carter; Anne Toulson,20,0,35,15
1658065976564,MATH 109,A01,083213,Ganzberger; Geoffrey Michael,3,0,34,31
1658065976564,MATH 109,A02,083214,Ganzberger; Geoffrey Michael,4,0,34,30
1658065976564,MATH 109,A03,093478,Ganzberger; Geoffrey Michael,2,0,34,32
1658065976564,MATH 109,B01,083215,Ganzberger; Geoffrey Michael,3,0,32,29
1658065976564,MATH 109,B02,083216,Ganzberger; Geoffrey Michael,3,0,32,29
1658065976564,MATH 109,B03,093479,Ganzberger; Geoffrey Michael,8,0,32,24
1658065982595,MATH 142A,A01,083219,Chow; Bennett,7,0,32,25
1658065982595,MATH 142A,A02,083220,Chow; Bennett,10,0,32,22
1658065982595,MATH 142A,A03,093480,Chow; Bennett,9,0,32,23
1658065982595,MATH 142A,B03,093481,Chow; Bennett,8,0,32,24
1658065982595,MATH 142A,B04,093558,Chow; Bennett,14,0,32,18
1658065982595,MATH 142A,B05,093559,Chow; Bennett,7,0,32,25
1658065988621,MATH 193A,A01,083224,Rotar; Vladimir,9,0,34,25
1658065988621,MATH 193A,A02,083225,Rotar; Vladimir,11,0,34,23
1658065988621,MATH 193A,A03,083781,Rotar; Vladimir,5,0,34,29
1658065988621,MATH 193A,A04,083782,Rotar; Vladimir,12,0,34,22
1658065988621,MATH 193A,A05,093482,Rotar; Vladimir,11,0,34,23
1658065994644,MATH 197,001,091859,McAuley; Julian John,9999,0,9999,0
1658065994644,MATH 197,002,095566,Kedlaya; Kiran S.,9997,0,9999,2
1658065994644,MATH 197,003,095567,Xiao; Ming,9999,0,9999,0
1658065994644,MATH 197,004,095571,Perols; Johan Lars,9998,0,9999,1
1658066001703,COGS 9,A01,083615,Shannon; Kyle Michael,11,0,75,64
1658066007732,COGS 11,A01,083617,Boyle; Mary E. T.,23,0,48,25
1658066013757,COGS 13,A01,083071,Bastos; Amalia Pinkusfeld,12,0,71,59
1658066019781,COGS 14A,A01,092681,Semenuks; Arturs,5,1,100,95
1658066025806,COGS 14B,A01,083073,Cheng; Tzu-Han,7,0,63,56
1658066031831,COGS 17,A01,092677,Semenuks; Arturs,7,0,81,74
1658066037855,COGS 100,A01,083619,Allen; Michael Gordon,17,0,70,53
1658066043887,COGS 101A,A01,083621,Davis; Joshua Daniel,9,0,68,59
1658066049911,COGS 101B,A01,091572,Allen; Michael Gordon,14,0,65,51
1658066055947,COGS 101C,A01,083625,Delgado; Tania,17,0,35,18
1658066061975,COGS 107A,A01,083627,Boyle; Mary E. T.,14,0,60,46
1658066068002,COGS 118A,A01,083075,Gupta; Anjum,21,0,76,55
1658066074030,CSE 3,A50,083646,Miranda; Gregory Joseph,24,0,50,26
1658066080059,CSE 8A,A50,083650,Miranda; Gregory Joseph,17,1,56,39
1658066086083,CSE 11,A01,083080,Cao; Yingjun,7,15,40,33
1658066092109,CSE 12,A01,083652,Krause-Levy; Sophia Louisa,30,1,120,90
1658066098133,CSE 15L,A01,083654,Morris; Justin Loren,9,0,50,41
1658066098133,CSE 15L,A02,083655,Morris; Justin Loren,11,0,50,39
1658066104159,CSE 20,A01,083657,Tran; Khoa Dang,39,0,80,41
1658066110187,CSE 21,A01,095574,Bach; Quang Tran,23,0,48,25
1658066116211,CSE 30,A01,083084,Eldon; John,8,0,80,72
1658066116211,CSE 30,B01,095061,Bhaskar; Nishant,9,0,50,41
1658066122235,CSE 100,A01,083659,Cao; Yingjun,5,4,70,65
1658066128260,CSE 134B,A01,083661,Powell; Thomas Allan,25,0,100,75
1658066134288,CSE 140,A01,083663,Gungor; Onat,17,0,85,68
1658066140314,CSE 140L,A01,083088,Eldon; John,23,0,100,77
1658066146339,CSE 175,A01,083665,Kumar; Rakesh,3,0,25,22
1658066152364,CSE 190,A00,092507,Dubnov; Shlomo,8,0,20,12
1658066158459,ECE 45,A01,083139,Congero; Spencer William,7,0,75,68
1658066164483,ECE 65,A50,083695,Saad; Andrew S,12,0,30,18
1658066164483,ECE 65,A51,095125,Saad; Andrew S,24,0,26,2
1658066170507,ECE 109,A01,091882,Touri; Behrouz,21,0,70,49
1658066176532,ECE 180,A00,083140,Abi Samra; Nicholas Camill,1,0,30,29
1658066176532,ECE 180,B00,083141,Abi Samra; Nicholas Camill,0,0,30,30
1658066182561,MATH 10A,A01,083735,Patchell; Gregory David,2,0,30,28
1658066182561,MATH 10A,A02,083736,Patchell; Gregory David,20,0,30,10
1658066182561,MATH 10A,A03,083737,Patchell; Gregory David,16,0,30,14
1658066188590,MATH 10B,A01,083207,Lim; Seonhee,9,0,34,25
1658066188590,MATH 10B,A02,083208,Lim; Seonhee,10,0,35,25
1658066188590,MATH 10B,A03,093472,Lim; Seonhee,7,0,34,27
1658066188590,MATH 10B,B01,083739,Sinha; Shubham,14,0,30,16
1658066194615,MATH 18,A01,083743,Cinel; Cameron Alexander,9,0,30,21
1658066194615,MATH 18,A02,083744,Cinel; Cameron Alexander,18,0,30,12
1658066194615,MATH 18,A03,083745,Cinel; Cameron Alexander,10,0,30,20
1658066194615,MATH 18,B01,083748,Rideout; David Porter,5,0,37,32
1658066194615,MATH 18,B02,083749,Rideout; David Porter,5,0,36,31
1658066194615,MATH 18,B03,083750,Rideout; David Porter,3,0,37,34
1658066194615,MATH 18,B04,083751,Rideout; David Porter,7,0,36,29
1658066194615,MATH 18,B05,093473,Rideout; David Porter,7,0,36,29
1658066194615,MATH 18,B06,093474,Rideout; David Porter,6,0,36,30
1658066200640,MATH 20A,A01,083754,Zheng; Zequn,14,0,40,26
1658066206665,MATH 20B,A01,083756,Briones; Jor-el Thomas Caparas,4,0,36,32
1658066206665,MATH 20B,A02,083757,Briones; Jor-el Thomas Caparas,1,0,36,35
1658066206665,MATH 20B,A03,093475,Briones; Jor-el Thomas Caparas,3,0,36,33
1658066212690,MATH 20C,A01,083760,Briones; Jor-el Thomas Caparas,1,0,35,34
1658066212690,MATH 20C,A02,083761,Briones; Jor-el Thomas Caparas,8,0,35,27
1658066212690,MATH 20C,A03,093476,Briones; Jor-el Thomas Caparas,0,1,36,36
1658066212690,MATH 20C,B01,083762,Bach; Quang Tran,1,0,30,29
1658066218724,MATH 20D,A01,083765,Tran; Brian Kha,5,0,30,25
1658066218724,MATH 20D,A02,083766,Tran; Brian Kha,5,0,30,25
1658066218724,MATH 20D,A03,083767,Tran; Brian Kha,6,0,30,24
1658066224749,MATH 20E,A01,083771,Ganguly; Soumya,12,0,32,20
1658066224749,MATH 20E,A02,083772,Ganguly; Soumya,7,0,32,25
1658066224749,MATH 20E,B01,083773,Ciotti; Benjamin,20,0,35,15
1658066224749,MATH 20E,B02,083774,Ciotti; Benjamin,18,0,35,17
1658066230779,MATH 103A,A01,083777,Greenfeld; Be'Eri,6,0,36,30
1658066230779,MATH 103A,A02,083778,Greenfeld; Be'Eri,5,0,36,31
1658066230779,MATH 103A,A03,093561,Greenfeld; Be'Eri,7,0,36,29
1658066230779,MATH 103A,B01,083779,Greenfeld; Be'Eri,8,0,36,28
1658066230779,MATH 103A,B02,083780,Greenfeld; Be'Eri,4,0,36,32
1658066230779,MATH 103A,B03,093562,Greenfeld; Be'Eri,3,0,36,33
1658066236802,MATH 105,A01,085443,Carter; Anne Toulson,15,0,35,20
1658066236802,MATH 105,A02,093477,Carter; Anne Toulson,20,0,35,15
1658066242830,MATH 109,A01,083213,Ganzberger; Geoffrey Michael,3,0,34,31
1658066242830,MATH 109,A02,083214,Ganzberger; Geoffrey Michael,4,0,34,30
1658066242830,MATH 109,A03,093478,Ganzberger; Geoffrey Michael,2,0,34,32
1658066242830,MATH 109,B01,083215,Ganzberger; Geoffrey Michael,3,0,32,29
1658066242830,MATH 109,B02,083216,Ganzberger; Geoffrey Michael,3,0,32,29
1658066242830,MATH 109,B03,093479,Ganzberger; Geoffrey Michael,8,0,32,24
1658066248857,MATH 142A,A01,083219,Chow; Bennett,7,0,32,25
1658066248857,MATH 142A,A02,083220,Chow; Bennett,10,0,32,22
1658066248857,MATH 142A,A03,093480,Chow; Bennett,9,0,32,23
1658066248857,MATH 142A,B03,093481,Chow; Bennett,8,0,32,24
1658066248857,MATH 142A,B04,093558,Chow; Bennett,14,0,32,18
1658066248857,MATH 142A,B05,093559,Chow; Bennett,7,0,32,25
1658066254881,MATH 193A,A01,083224,Rotar; Vladimir,9,0,34,25
1658066254881,MATH 193A,A02,083225,Rotar; Vladimir,11,0,34,23
1658066254881,MATH 193A,A03,083781,Rotar; Vladimir,5,0,34,29
1658066254881,MATH 193A,A04,083782,Rotar; Vladimir,12,0,34,22
1658066254881,MATH 193A,A05,093482,Rotar; Vladimir,11,0,34,23
1658066260907,MATH 197,001,091859,McAuley; Julian John,9999,0,9999,0
1658066260907,MATH 197,002,095566,Kedlaya; Kiran S.,9997,0,9999,2
1658066260907,MATH 197,003,095567,Xiao; Ming,9999,0,9999,0
1658066260907,MATH 197,004,095571,Perols; Johan Lars,9998,0,9999,1
1658066267982,COGS 9,A01,083615,Shannon; Kyle Michael,11,0,75,64
1658066274011,COGS 11,A01,083617,Boyle; Mary E. T.,23,0,48,25
1658066280039,COGS 13,A01,083071,Bastos; Amalia Pinkusfeld,12,0,71,59
1658066286063,COGS 14A,A01,092681,Semenuks; Arturs,5,1,100,95
1658066292091,COGS 14B,A01,083073,Cheng; Tzu-Han,7,0,63,56
1658066298116,COGS 17,A01,092677,Semenuks; Arturs,7,0,81,74
1658066304140,COGS 100,A01,083619,Allen; Michael Gordon,17,0,70,53
1658066310170,COGS 101A,A01,083621,Davis; Joshua Daniel,9,0,68,59
1658066316199,COGS 101B,A01,091572,Allen; Michael Gordon,14,0,65,51
1658066322223,COGS 101C,A01,083625,Delgado; Tania,17,0,35,18
1658066328248,COGS 107A,A01,083627,Boyle; Mary E. T.,14,0,60,46
1658066334272,COGS 118A,A01,083075,Gupta; Anjum,21,0,76,55
1658066340297,CSE 3,A50,083646,Miranda; Gregory Joseph,24,0,50,26
1658066346321,CSE 8A,A50,083650,Miranda; Gregory Joseph,17,1,56,39
1658066352346,CSE 11,A01,083080,Cao; Yingjun,7,15,40,33
1658066358374,CSE 12,A01,083652,Krause-Levy; Sophia Louisa,30,1,120,90
1658066364402,CSE 15L,A01,083654,Morris; Justin Loren,9,0,50,41
1658066364402,CSE 15L,A02,083655,Morris; Justin Loren,11,0,50,39
1658066370431,CSE 20,A01,083657,Tran; Khoa Dang,39,0,80,41
1658066376456,CSE 21,A01,095574,Bach; Quang Tran,23,0,48,25
1658066382484,CSE 30,A01,083084,Eldon; John,8,0,80,72
1658066382484,CSE 30,B01,095061,Bhaskar; Nishant,9,0,50,41
1658066388516,CSE 100,A01,083659,Cao; Yingjun,5,4,70,65
1658066394540,CSE 134B,A01,083661,Powell; Thomas Allan,25,0,100,75
1658066400567,CSE 140,A01,083663,Gungor; Onat,17,0,85,68
1658066406592,CSE 140L,A01,083088,Eldon; John,23,0,100,77
1658066412619,CSE 175,A01,083665,Kumar; Rakesh,3,0,25,22
1658066418646,CSE 190,A00,092507,Dubnov; Shlomo,8,0,20,12
1658066424672,ECE 45,A01,083139,Congero; Spencer William,7,0,75,68
1658066430698,ECE 65,A50,083695,Saad; Andrew S,12,0,30,18
1658066430698,ECE 65,A51,095125,Saad; Andrew S,24,0,26,2
1658066436725,ECE 109,A01,091882,Touri; Behrouz,21,0,70,49
1658066442752,ECE 180,A00,083140,Abi Samra; Nicholas Camill,1,0,30,29
1658066442752,ECE 180,B00,083141,Abi Samra; Nicholas Camill,0,0,30,30
1658066448778,MATH 10A,A01,083735,Patchell; Gregory David,2,0,30,28
1658066448778,MATH 10A,A02,083736,Patchell; Gregory David,20,0,30,10
1658066448778,MATH 10A,A03,083737,Patchell; Gregory David,16,0,30,14
1658066454810,MATH 10B,A01,083207,Lim; Seonhee,9,0,34,25
1658066454810,MATH 10B,A02,083208,Lim; Seonhee,10,0,35,25
1658066454810,MATH 10B,A03,093472,Lim; Seonhee,7,0,34,27
1658066454810,MATH 10B,B01,083739,Sinha; Shubham,14,0,30,16
1658066460835,MATH 18,A01,083743,Cinel; Cameron Alexander,9,0,30,21
1658066460835,MATH 18,A02,083744,Cinel; Cameron Alexander,18,0,30,12
1658066460835,MATH 18,A03,083745,Cinel; Cameron Alexander,10,0,30,20
1658066460835,MATH 18,B01,083748,Rideout; David Porter,5,0,37,32
1658066460835,MATH 18,B02,083749,Rideout; David Porter,5,0,36,31
1658066460835,MATH 18,B03,083750,Rideout; David Porter,3,0,37,34
1658066460835,MATH 18,B04,083751,Rideout; David Porter,7,0,36,29
1658066460835,MATH 18,B05,093473,Rideout; David Porter,7,0,36,29
1658066460835,MATH 18,B06,093474,Rideout; David Porter,6,0,36,30
1658066466863,MATH 20A,A01,083754,Zheng; Zequn,14,0,40,26
1658066472890,MATH 20B,A01,083756,Briones; Jor-el Thomas Caparas,4,0,36,32
1658066472890,MATH 20B,A02,083757,Briones; Jor-el Thomas Caparas,1,0,36,35
1658066472890,MATH 20B,A03,093475,Briones; Jor-el Thomas Caparas,3,0,36,33
1658066478915,MATH 20C,A01,083760,Briones; Jor-el Thomas Caparas,1,0,35,34
1658066478915,MATH 20C,A02,083761,Briones; Jor-el Thomas Caparas,8,0,35,27
1658066478915,MATH 20C,A03,093476,Briones; Jor-el Thomas Caparas,0,1,36,36
1658066478915,MATH 20C,B01,083762,Bach; Quang Tran,1,0,30,29
1658066484944,MATH 20D,A01,083765,Tran; Brian Kha,5,0,30,25
1658066484944,MATH 20D,A02,083766,Tran; Brian Kha,5,0,30,25
1658066484944,MATH 20D,A03,083767,Tran; Brian Kha,6,0,30,24
1658066490972,MATH 20E,A01,083771,Ganguly; Soumya,12,0,32,20
1658066490972,MATH 20E,A02,083772,Ganguly; Soumya,7,0,32,25
1658066490972,MATH 20E,B01,083773,Ciotti; Benjamin,20,0,35,15
1658066490972,MATH 20E,B02,083774,Ciotti; Benjamin,18,0,35,17
1658066497004,MATH 103A,A01,083777,Greenfeld; Be'Eri,6,0,36,30
1658066497004,MATH 103A,A02,083778,Greenfeld; Be'Eri,5,0,36,31
1658066497004,MATH 103A,A03,093561,Greenfeld; Be'Eri,7,0,36,29
1658066497004,MATH 103A,B01,083779,Greenfeld; Be'Eri,8,0,36,28
1658066497004,MATH 103A,B02,083780,Greenfeld; Be'Eri,4,0,36,32
1658066497004,MATH 103A,B03,093562,Greenfeld; Be'Eri,3,0,36,33
1658066503029,MATH 105,A01,085443,Carter; Anne Toulson,15,0,35,20
1658066503029,MATH 105,A02,093477,Carter; Anne Toulson,20,0,35,15
1658066509054,MATH 109,A01,083213,Ganzberger; Geoffrey Michael,3,0,34,31
1658066509054,MATH 109,A02,083214,Ganzberger; Geoffrey Michael,4,0,34,30
1658066509054,MATH 109,A03,093478,Ganzberger; Geoffrey Michael,2,0,34,32
1658066509054,MATH 109,B01,083215,Ganzberger; Geoffrey Michael,3,0,32,29
1658066509054,MATH 109,B02,083216,Ganzberger; Geoffrey Michael,3,0,32,29
1658066509054,MATH 109,B03,093479,Ganzberger; Geoffrey Michael,8,0,32,24
1658066515080,MATH 142A,A01,083219,Chow; Bennett,7,0,32,25
1658066515080,MATH 142A,A02,083220,Chow; Bennett,10,0,32,22
1658066515080,MATH 142A,A03,093480,Chow; Bennett,9,0,32,23
1658066515080,MATH 142A,B03,093481,Chow; Bennett,8,0,32,24
1658066515080,MATH 142A,B04,093558,Chow; Bennett,14,0,32,18
1658066515080,MATH 142A,B05,093559,Chow; Bennett,7,0,32,25
1658066521105,MATH 193A,A01,083224,Rotar; Vladimir,9,0,34,25
1658066521105,MATH 193A,A02,083225,Rotar; Vladimir,11,0,34,23
1658066521105,MATH 193A,A03,083781,Rotar; Vladimir,5,0,34,29
1658066521105,MATH 193A,A04,083782,Rotar; Vladimir,12,0,34,22
1658066521105,MATH 193A,A05,093482,Rotar; Vladimir,11,0,34,23
1658066527132,MATH 197,001,091859,McAuley; Julian John,9999,0,9999,0
1658066527132,MATH 197,002,095566,Kedlaya; Kiran S.,9997,0,9999,2
1658066527132,MATH 197,003,095567,Xiao; Ming,9999,0,9999,0
1658066527132,MATH 197,004,095571,Perols; Johan Lars,9998,0,9999,1
1658066534189,COGS 9,A01,083615,Shannon; Kyle Michael,11,0,75,64
1658066540219,COGS 11,A01,083617,Boyle; Mary E. T.,23,0,48,25
1658066546249,COGS 13,A01,083071,Bastos; Amalia Pinkusfeld,12,0,71,59
1658066552274,COGS 14A,A01,092681,Semenuks; Arturs,5,1,100,95
1658066558300,COGS 14B,A01,083073,Cheng; Tzu-Han,7,0,63,56
1658066564325,COGS 17,A01,092677,Semenuks; Arturs,7,0,81,74
1658066570354,COGS 100,A01,083619,Allen; Michael Gordon,17,0,70,53
1658066576383,COGS 101A,A01,083621,Davis; Joshua Daniel,9,0,68,59
1658066582408,COGS 101B,A01,091572,Allen; Michael Gordon,14,0,65,51
1658066588435,COGS 101C,A01,083625,Delgado; Tania,17,0,35,18
1658066594467,COGS 107A,A01,083627,Boyle; Mary E. T.,14,0,60,46
1658066600495,COGS 118A,A01,083075,Gupta; Anjum,21,0,76,55
1658066606521,CSE 3,A50,083646,Miranda; Gregory Joseph,24,0,50,26
1658066612546,CSE 8A,A50,083650,Miranda; Gregory Joseph,17,1,56,39
1658066618571,CSE 11,A01,083080,Cao; Yingjun,7,15,40,33
1658066624598,CSE 12,A01,083652,Krause-Levy; Sophia Louisa,30,1,120,90
1658066630630,CSE 15L,A01,083654,Morris; Justin Loren,9,0,50,41
1658066630630,CSE 15L,A02,083655,Morris; Justin Loren,11,0,50,39
1658066636654,CSE 20,A01,083657,Tran; Khoa Dang,39,0,80,41
1658066642680,CSE 21,A01,095574,Bach; Quang Tran,23,0,48,25
1658066648705,CSE 30,A01,083084,Eldon; John,8,0,80,72
1658066648705,CSE 30,B01,095061,Bhaskar; Nishant,9,0,50,41
1658066654730,CSE 100,A01,083659,Cao; Yingjun,5,4,70,65
1658066660761,CSE 134B,A01,083661,Powell; Thomas Allan,25,0,100,75
1658066666788,CSE 140,A01,083663,Gungor; Onat,17,0,85,68
1658066672814,CSE 140L,A01,083088,Eldon; John,23,0,100,77
1658066678838,CSE 175,A01,083665,Kumar; Rakesh,3,0,25,22
1658066684863,CSE 190,A00,092507,Dubnov; Shlomo,8,0,20,12
1658066690890,ECE 45,A01,083139,Congero; Spencer William,7,0,75,68
1658066696914,ECE 65,A50,083695,Saad; Andrew S,12,0,30,18
1658066696914,ECE 65,A51,095125,Saad; Andrew S,24,0,26,2
1658066702939,ECE 109,A01,091882,Touri; Behrouz,21,0,70,49
1658066708965,ECE 180,A00,083140,Abi Samra; Nicholas Camill,1,0,30,29
1658066708965,ECE 180,B00,083141,Abi Samra; Nicholas Camill,0,0,30,30
1658066714989,MATH 10A,A01,083735,Patchell; Gregory David,2,0,30,28
1658066714989,MATH 10A,A02,083736,Patchell; Gregory David,20,0,30,10
1658066714989,MATH 10A,A03,083737,Patchell; Gregory David,16,0,30,14
1658066721015,MATH 10B,A01,083207,Lim; Seonhee,9,0,34,25
1658066721015,MATH 10B,A02,083208,Lim; Seonhee,10,0,35,25
1658066721015,MATH 10B,A03,093472,Lim; Seonhee,7,0,34,27
1658066721015,MATH 10B,B01,083739,Sinha; Shubham,14,0,30,16
1658066727041,MATH 18,A01,083743,Cinel; Cameron Alexander,9,0,30,21
1658066727041,MATH 18,A02,083744,Cinel; Cameron Alexander,18,0,30,12
1658066727041,MATH 18,A03,083745,Cinel; Cameron Alexander,10,0,30,20
1658066727041,MATH 18,B01,083748,Rideout; David Porter,5,0,37,32
1658066727041,MATH 18,B02,083749,Rideout; David Porter,5,0,36,31
1658066727041,MATH 18,B03,083750,Rideout; David Porter,3,0,37,34
1658066727041,MATH 18,B04,083751,Rideout; David Porter,7,0,36,29
1658066727041,MATH 18,B05,093473,Rideout; David Porter,7,0,36,29
1658066727041,MATH 18,B06,093474,Rideout; David Porter,6,0,36,30
1658066733065,MATH 20A,A01,083754,Zheng; Zequn,14,0,40,26
1658066739091,MATH 20B,A01,083756,Briones; Jor-el Thomas Caparas,4,0,36,32
1658066739091,MATH 20B,A02,083757,Briones; Jor-el Thomas Caparas,1,0,36,35
1658066739091,MATH 20B,A03,093475,Briones; Jor-el Thomas Caparas,3,0,36,33
1658066745123,MATH 20C,A01,083760,Briones; Jor-el Thomas Caparas,1,0,35,34
1658066745123,MATH 20C,A02,083761,Briones; Jor-el Thomas Caparas,8,0,35,27
1658066745123,MATH 20C,A03,093476,Briones; Jor-el Thomas Caparas,0,1,36,36
1658066745123,MATH 20C,B01,083762,Bach; Quang Tran,1,0,30,29
1658066751153,MATH 20D,A01,083765,Tran; Brian Kha,5,0,30,25
1658066751153,MATH 20D,A02,083766,Tran; Brian Kha,5,0,30,25
1658066751153,MATH 20D,A03,083767,Tran; Brian Kha,6,0,30,24
1658066757251,MATH 20E,A01,083771,Ganguly; Soumya,12,0,32,20
1658066757251,MATH 20E,A02,083772,Ganguly; Soumya,7,0,32,25
1658066757251,MATH 20E,B01,083773,Ciotti; Benjamin,20,0,35,15
1658066757251,MATH 20E,B02,083774,Ciotti; Benjamin,18,0,35,17
1658066763278,MATH 103A,A01,083777,Greenfeld; Be'Eri,6,0,36,30
1658066763278,MATH 103A,A02,083778,Greenfeld; Be'Eri,5,0,36,31
1658066763278,MATH 103A,A03,093561,Greenfeld; Be'Eri,7,0,36,29
1658066763278,MATH 103A,B01,083779,Greenfeld; Be'Eri,8,0,36,28
1658066763278,MATH 103A,B02,083780,Greenfeld; Be'Eri,4,0,36,32
1658066763278,MATH 103A,B03,093562,Greenfeld; Be'Eri,3,0,36,33
1658066769307,MATH 105,A01,085443,Carter; Anne Toulson,15,0,35,20
1658066769307,MATH 105,A02,093477,Carter; Anne Toulson,20,0,35,15
1658066775339,MATH 109,A01,083213,Ganzberger; Geoffrey Michael,3,0,34,31
1658066775339,MATH 109,A02,083214,Ganzberger; Geoffrey Michael,4,0,34,30
1658066775339,MATH 109,A03,093478,Ganzberger; Geoffrey Michael,2,0,34,32
1658066775339,MATH 109,B01,083215,Ganzberger; Geoffrey Michael,3,0,32,29
1658066775339,MATH 109,B02,083216,Ganzberger; Geoffrey Michael,3,0,32,29
1658066775339,MATH 109,B03,093479,Ganzberger; Geoffrey Michael,8,0,32,24
1658066781364,MATH 142A,A01,083219,Chow; Bennett,7,0,32,25
1658066781364,MATH 142A,A02,083220,Chow; Bennett,10,0,32,22
1658066781364,MATH 142A,A03,093480,Chow; Bennett,9,0,32,23
1658066781364,MATH 142A,B03,093481,Chow; Bennett,8,0,32,24
1658066781364,MATH 142A,B04,093558,Chow; Bennett,14,0,32,18
1658066781364,MATH 142A,B05,093559,Chow; Bennett,7,0,32,25
1658066787389,MATH 193A,A01,083224,Rotar; Vladimir,9,0,34,25
1658066787389,MATH 193A,A02,083225,Rotar; Vladimir,11,0,34,23
1658066787389,MATH 193A,A03,083781,Rotar; Vladimir,5,0,34,29
1658066787389,MATH 193A,A04,083782,Rotar; Vladimir,12,0,34,22
1658066787389,MATH 193A,A05,093482,Rotar; Vladimir,11,0,34,23
1658066793413,MATH 197,001,091859,McAuley; Julian John,9999,0,9999,0
1658066793413,MATH 197,002,095566,Kedlaya; Kiran S.,9997,0,9999,2
1658066793413,MATH 197,003,095567,Xiao; Ming,9999,0,9999,0
1658066793413,MATH 197,004,095571,Perols; Johan Lars,9998,0,9999,1
1658066800468,COGS 9,A01,083615,Shannon; Kyle Michael,11,0,75,64
1658066806493,COGS 11,A01,083617,Boyle; Mary E. T.,23,0,48,25
1658066812517,COGS 13,A01,083071,Bastos; Amalia Pinkusfeld,12,0,71,59
1658066818542,COGS 14A,A01,092681,Semenuks; Arturs,5,1,100,95
1658066824567,COGS 14B,A01,083073,Cheng; Tzu-Han,7,0,63,56
1658066830592,COGS 17,A01,092677,Semenuks; Arturs,7,0,81,74
1658066836617,COGS 100,A01,083619,Allen; Michael Gordon,17,0,70,53
1658066842651,COGS 101A,A01,083621,Davis; Joshua Daniel,9,0,68,59
1658066848675,COGS 101B,A01,091572,Allen; Michael Gordon,14,0,65,51
1658066854700,COGS 101C,A01,083625,Delgado; Tania,17,0,35,18
1658066860723,COGS 107A,A01,083627,Boyle; Mary E. T.,14,0,60,46
1658066866748,COGS 118A,A01,083075,Gupta; Anjum,21,0,76,55
1658066872778,CSE 3,A50,083646,Miranda; Gregory Joseph,24,0,50,26
1658066878813,CSE 8A,A50,083650,Miranda; Gregory Joseph,17,1,56,39
1658066884839,CSE 11,A01,083080,Cao; Yingjun,7,15,40,33
1658066890865,CSE 12,A01,083652,Krause-Levy; Sophia Louisa,30,1,120,90
1658066896890,CSE 15L,A01,083654,Morris; Justin Loren,9,0,50,41
1658066896890,CSE 15L,A02,083655,Morris; Justin Loren,11,0,50,39
1658066902918,CSE 20,A01,083657,Tran; Khoa Dang,39,0,80,41
1658066908947,CSE 21,A01,095574,Bach; Quang Tran,23,0,48,25
1658066914984,CSE 30,A01,083084,Eldon; John,8,0,80,72
1658066914984,CSE 30,B01,095061,Bhaskar; Nishant,9,0,50,41
1658066921011,CSE 100,A01,083659,Cao; Yingjun,5,4,70,65
1658066927041,CSE 134B,A01,083661,Powell; Thomas Allan,25,0,100,75
1658066933064,CSE 140,A01,083663,Gungor; Onat,17,0,85,68
1658066939089,CSE 140L,A01,083088,Eldon; John,23,0,100,77
1658066945116,CSE 175,A01,083665,Kumar; Rakesh,3,0,25,22
1658066951141,CSE 190,A00,092507,Dubnov; Shlomo,8,0,20,12
1658066957169,ECE 45,A01,083139,Congero; Spencer William,7,0,75,68
1658066963201,ECE 65,A50,083695,Saad; Andrew S,12,0,30,18
1658066963201,ECE 65,A51,095125,Saad; Andrew S,24,0,26,2
1658066969226,ECE 109,A01,091882,Touri; Behrouz,21,0,70,49
1658066975249,ECE 180,A00,083140,Abi Samra; Nicholas Camill,1,0,30,29
1658066975249,ECE 180,B00,083141,Abi Samra; Nicholas Camill,0,0,30,30
1658066981274,MATH 10A,A01,083735,Patchell; Gregory David,2,0,30,28
1658066981274,MATH 10A,A02,083736,Patchell; Gregory David,20,0,30,10
1658066981274,MATH 10A,A03,083737,Patchell; Gregory David,16,0,30,14
1658066987298,MATH 10B,A01,083207,Lim; Seonhee,9,0,34,25
1658066987298,MATH 10B,A02,083208,Lim; Seonhee,10,0,35,25
1658066987298,MATH 10B,A03,093472,Lim; Seonhee,7,0,34,27
1658066987298,MATH 10B,B01,083739,Sinha; Shubham,14,0,30,16
1658066993326,MATH 18,A01,083743,Cinel; Cameron Alexander,9,0,30,21
1658066993326,MATH 18,A02,083744,Cinel; Cameron Alexander,18,0,30,12
1658066993326,MATH 18,A03,083745,Cinel; Cameron Alexander,10,0,30,20
1658066993326,MATH 18,B01,083748,Rideout; David Porter,5,0,37,32
1658066993326,MATH 18,B02,083749,Rideout; David Porter,5,0,36,31
1658066993326,MATH 18,B03,083750,Rideout; David Porter,3,0,37,34
1658066993326,MATH 18,B04,083751,Rideout; David Porter,7,0,36,29
1658066993326,MATH 18,B05,093473,Rideout; David Porter,7,0,36,29
1658066993326,MATH 18,B06,093474,Rideout; David Porter,6,0,36,30
1658066999350,MATH 20A,A01,083754,Zheng; Zequn,14,0,40,26
1658067005381,MATH 20B,A01,083756,Briones; Jor-el Thomas Caparas,4,0,36,32
1658067005381,MATH 20B,A02,083757,Briones; Jor-el Thomas Caparas,1,0,36,35
1658067005381,MATH 20B,A03,093475,Briones; Jor-el Thomas Caparas,3,0,36,33
1658067011411,MATH 20C,A01,083760,Briones; Jor-el Thomas Caparas,1,0,35,34
1658067011411,MATH 20C,A02,083761,Briones; Jor-el Thomas Caparas,8,0,35,27
1658067011411,MATH 20C,A03,093476,Briones; Jor-el Thomas Caparas,0,1,36,36
1658067011411,MATH 20C,B01,083762,Bach; Quang Tran,1,0,30,29
1658067017441,MATH 20D,A01,083765,Tran; Brian Kha,5,0,30,25
1658067017441,MATH 20D,A02,083766,Tran; Brian Kha,5,0,30,25
1658067017441,MATH 20D,A03,083767,Tran; Brian Kha,6,0,30,24
1658067023467,MATH 20E,A01,083771,Ganguly; Soumya,12,0,32,20
1658067023467,MATH 20E,A02,083772,Ganguly; Soumya,7,0,32,25
1658067023467,MATH 20E,B01,083773,Ciotti; Benjamin,20,0,35,15
1658067023467,MATH 20E,B02,083774,Ciotti; Benjamin,18,0,35,17
1658067029497,MATH 103A,A01,083777,Greenfeld; Be'Eri,6,0,36,30
1658067029497,MATH 103A,A02,083778,Greenfeld; Be'Eri,5,0,36,31
1658067029497,MATH 103A,A03,093561,Greenfeld; Be'Eri,7,0,36,29
1658067029497,MATH 103A,B01,083779,Greenfeld; Be'Eri,8,0,36,28
1658067029497,MATH 103A,B02,083780,Greenfeld; Be'Eri,4,0,36,32
1658067029497,MATH 103A,B03,093562,Greenfeld; Be'Eri,3,0,36,33
1658067035523,MATH 105,A01,085443,Carter; Anne Toulson,15,0,35,20
1658067035523,MATH 105,A02,093477,Carter; Anne Toulson,20,0,35,15
1658067041550,MATH 109,A01,083213,Ganzberger; Geoffrey Michael,3,0,34,31
1658067041550,MATH 109,A02,083214,Ganzberger; Geoffrey Michael,4,0,34,30
1658067041550,MATH 109,A03,093478,Ganzberger; Geoffrey Michael,2,0,34,32
1658067041550,MATH 109,B01,083215,Ganzberger; Geoffrey Michael,3,0,32,29
1658067041550,MATH 109,B02,083216,Ganzberger; Geoffrey Michael,3,0,32,29
1658067041550,MATH 109,B03,093479,Ganzberger; Geoffrey Michael,8,0,32,24
1658067047578,MATH 142A,A01,083219,Chow; Bennett,7,0,32,25
1658067047578,MATH 142A,A02,083220,Chow; Bennett,10,0,32,22
1658067047578,MATH 142A,A03,093480,Chow; Bennett,9,0,32,23
1658067047578,MATH 142A,B03,093481,Chow; Bennett,8,0,32,24
1658067047578,MATH 142A,B04,093558,Chow; Bennett,14,0,32,18
1658067047578,MATH 142A,B05,093559,Chow; Bennett,7,0,32,25
1658067053603,MATH 193A,A01,083224,Rotar; Vladimir,9,0,34,25
1658067053603,MATH 193A,A02,083225,Rotar; Vladimir,11,0,34,23
1658067053603,MATH 193A,A03,083781,Rotar; Vladimir,5,0,34,29
1658067053603,MATH 193A,A04,083782,Rotar; Vladimir,12,0,34,22
1658067053603,MATH 193A,A05,093482,Rotar; Vladimir,11,0,34,23
1658067059632,MATH 197,001,091859,McAuley; Julian John,9999,0,9999,0
1658067059632,MATH 197,002,095566,Kedlaya; Kiran S.,9997,0,9999,2
1658067059632,MATH 197,003,095567,Xiao; Ming,9999,0,9999,0
1658067059632,MATH 197,004,095571,Perols; Johan Lars,9998,0,9999,1
1658067066694,COGS 9,A01,083615,Shannon; Kyle Michael,11,0,75,64
1658067072720,COGS 11,A01,083617,Boyle; Mary E. T.,23,0,48,25
1658067078744,COGS 13,A01,083071,Bastos; Amalia Pinkusfeld,12,0,71,59
1658067084767,COGS 14A,A01,092681,Semenuks; Arturs,5,1,100,95
1658067090795,COGS 14B,A01,083073,Cheng; Tzu-Han,7,0,63,56
1658067096821,COGS 17,A01,092677,Semenuks; Arturs,7,0,81,74
1658067102847,COGS 100,A01,083619,Allen; Michael Gordon,17,0,70,53
1658067108872,COGS 101A,A01,083621,Davis; Joshua Daniel,9,0,68,59
1658067114901,COGS 101B,A01,091572,Allen; Michael Gordon,14,0,65,51
1658067120926,COGS 101C,A01,083625,Delgado; Tania,17,0,35,18
1658067126950,COGS 107A,A01,083627,Boyle; Mary E. T.,14,0,60,46
1658067132989,COGS 118A,A01,083075,Gupta; Anjum,21,0,76,55
1658067139013,CSE 3,A50,083646,Miranda; Gregory Joseph,24,0,50,26
1658067145042,CSE 8A,A50,083650,Miranda; Gregory Joseph,17,1,56,39
1658067151069,CSE 11,A01,083080,Cao; Yingjun,7,15,40,33
1658067157093,CSE 12,A01,083652,Krause-Levy; Sophia Louisa,30,1,120,90
1658067163119,CSE 15L,A01,083654,Morris; Justin Loren,9,0,50,41
1658067163119,CSE 15L,A02,083655,Morris; Justin Loren,11,0,50,39
1658067169147,CSE 20,A01,083657,Tran; Khoa Dang,39,0,80,41
1658067175175,CSE 21,A01,095574,Bach; Quang Tran,23,0,48,25
1658067181204,CSE 30,A01,083084,Eldon; John,8,0,80,72
1658067181204,CSE 30,B01,095061,Bhaskar; Nishant,9,0,50,41
1658067187228,CSE 100,A01,083659,Cao; Yingjun,5,4,70,65
1658067193253,CSE 134B,A01,083661,Powell; Thomas Allan,25,0,100,75
1658067199277,CSE 140,A01,083663,Gungor; Onat,17,0,85,68
1658067205301,CSE 140L,A01,083088,Eldon; John,23,0,100,77
1658067211326,CSE 175,A01,083665,Kumar; Rakesh,3,0,25,22
1658067217353,CSE 190,A00,092507,Dubnov; Shlomo,8,0,20,12
1658067223376,ECE 45,A01,083139,Congero; Spencer William,7,0,75,68
1658067229405,ECE 65,A50,083695,Saad; Andrew S,12,0,30,18
1658067229405,ECE 65,A51,095125,Saad; Andrew S,24,0,26,2
1658067235436,ECE 109,A01,091882,Touri; Behrouz,21,0,70,49
1658067241460,ECE 180,A00,083140,Abi Samra; Nicholas Camill,1,0,30,29
1658067241460,ECE 180,B00,083141,Abi Samra; Nicholas Camill,0,0,30,30
1658067247485,MATH 10A,A01,083735,Patchell; Gregory David,2,0,30,28
1658067247485,MATH 10A,A02,083736,Patchell; Gregory David,20,0,30,10
1658067247485,MATH 10A,A03,083737,Patchell; Gregory David,16,0,30,14
1658067253514,MATH 10B,A01,083207,Lim; Seonhee,9,0,34,25
1658067253514,MATH 10B,A02,083208,Lim; Seonhee,10,0,35,25
1658067253514,MATH 10B,A03,093472,Lim; Seonhee,7,0,34,27
1658067253514,MATH 10B,B01,083739,Sinha; Shubham,14,0,30,16
1658067259548,MATH 18,A01,083743,Cinel; Cameron Alexander,9,0,30,21
1658067259548,MATH 18,A02,083744,Cinel; Cameron Alexander,18,0,30,12
1658067259548,MATH 18,A03,083745,Cinel; Cameron Alexander,10,0,30,20
1658067259548,MATH 18,B01,083748,Rideout; David Porter,5,0,37,32
1658067259548,MATH 18,B02,083749,Rideout; David Porter,5,0,36,31
1658067259548,MATH 18,B03,083750,Rideout; David Porter,3,0,37,34
1658067259548,MATH 18,B04,083751,Rideout; David Porter,7,0,36,29
1658067259548,MATH 18,B05,093473,Rideout; David Porter,7,0,36,29
1658067259548,MATH 18,B06,093474,Rideout; David Porter,6,0,36,30
1658067265576,MATH 20A,A01,083754,Zheng; Zequn,14,0,40,26
1658067271605,MATH 20B,A01,083756,Briones; Jor-el Thomas Caparas,4,0,36,32
1658067271605,MATH 20B,A02,083757,Briones; Jor-el Thomas Caparas,1,0,36,35
1658067271605,MATH 20B,A03,093475,Briones; Jor-el Thomas Caparas,3,0,36,33
1658067277630,MATH 20C,A01,083760,Briones; Jor-el Thomas Caparas,1,0,35,34
1658067277630,MATH 20C,A02,083761,Briones; Jor-el Thomas Caparas,8,0,35,27
1658067277630,MATH 20C,A03,093476,Briones; Jor-el Thomas Caparas,0,1,36,36
1658067277630,MATH 20C,B01,083762,Bach; Quang Tran,1,0,30,29
1658067283656,MATH 20D,A01,083765,Tran; Brian Kha,5,0,30,25
1658067283656,MATH 20D,A02,083766,Tran; Brian Kha,5,0,30,25
1658067283656,MATH 20D,A03,083767,Tran; Brian Kha,6,0,30,24
1658067289681,MATH 20E,A01,083771,Ganguly; Soumya,12,0,32,20
1658067289681,MATH 20E,A02,083772,Ganguly; Soumya,7,0,32,25
1658067289681,MATH 20E,B01,083773,Ciotti; Benjamin,20,0,35,15
1658067289681,MATH 20E,B02,083774,Ciotti; Benjamin,18,0,35,17
1658067295707,MATH 103A,A01,083777,Greenfeld; Be'Eri,6,0,36,30
1658067295707,MATH 103A,A02,083778,Greenfeld; Be'Eri,5,0,36,31
1658067295707,MATH 103A,A03,093561,Greenfeld; Be'Eri,7,0,36,29
1658067295707,MATH 103A,B01,083779,Greenfeld; Be'Eri,8,0,36,28
1658067295707,MATH 103A,B02,083780,Greenfeld; Be'Eri,4,0,36,32
1658067295707,MATH 103A,B03,093562,Greenfeld; Be'Eri,3,0,36,33
1658067301731,MATH 105,A01,085443,Carter; Anne Toulson,15,0,35,20
1658067301731,MATH 105,A02,093477,Carter; Anne Toulson,20,0,35,15
1658067307760,MATH 109,A01,083213,Ganzberger; Geoffrey Michael,3,0,34,31
1658067307760,MATH 109,A02,083214,Ganzberger; Geoffrey Michael,4,0,34,30
1658067307760,MATH 109,A03,093478,Ganzberger; Geoffrey Michael,2,0,34,32
1658067307760,MATH 109,B01,083215,Ganzberger; Geoffrey Michael,3,0,32,29
1658067307760,MATH 109,B02,083216,Ganzberger; Geoffrey Michael,3,0,32,29
1658067307760,MATH 109,B03,093479,Ganzberger; Geoffrey Michael,8,0,32,24
1658067313804,MATH 142A,A01,083219,Chow; Bennett,7,0,32,25
1658067313804,MATH 142A,A02,083220,Chow; Bennett,10,0,32,22
1658067313804,MATH 142A,A03,093480,Chow; Bennett,9,0,32,23
1658067313804,MATH 142A,B03,093481,Chow; Bennett,8,0,32,24
1658067313804,MATH 142A,B04,093558,Chow; Bennett,14,0,32,18
1658067313804,MATH 142A,B05,093559,Chow; Bennett,7,0,32,25
1658067319833,MATH 193A,A01,083224,Rotar; Vladimir,9,0,34,25
1658067319833,MATH 193A,A02,083225,Rotar; Vladimir,11,0,34,23
1658067319833,MATH 193A,A03,083781,Rotar; Vladimir,5,0,34,29
1658067319833,MATH 193A,A04,083782,Rotar; Vladimir,12,0,34,22
1658067319833,MATH 193A,A05,093482,Rotar; Vladimir,11,0,34,23
1658067325857,MATH 197,001,091859,McAuley; Julian John,9999,0,9999,0
1658067325857,MATH 197,002,095566,Kedlaya; Kiran S.,9997,0,9999,2
1658067325857,MATH 197,003,095567,Xiao; Ming,9999,0,9999,0
1658067325857,MATH 197,004,095571,Perols; Johan Lars,9998,0,9999,1
1658067332915,COGS 9,A01,083615,Shannon; Kyle Michael,11,0,75,64
1658067338947,COGS 11,A01,083617,Boyle; Mary E. T.,23,0,48,25
1658067344970,COGS 13,A01,083071,Bastos; Amalia Pinkusfeld,12,0,71,59
1658067351067,COGS 14A,A01,092681,Semenuks; Arturs,5,1,100,95
1658067357100,COGS 14B,A01,083073,Cheng; Tzu-Han,7,0,63,56
1658067363127,COGS 17,A01,092677,Semenuks; Arturs,7,0,81,74
1658067369156,COGS 100,A01,083619,Allen; Michael Gordon,17,0,70,53
1658067375184,COGS 101A,A01,083621,Davis; Joshua Daniel,9,0,68,59
1658067381211,COGS 101B,A01,091572,Allen; Michael Gordon,14,0,65,51
1658067387237,COGS 101C,A01,083625,Delgado; Tania,17,0,35,18
1658067393261,COGS 107A,A01,083627,Boyle; Mary E. T.,14,0,60,46
1658067399286,COGS 118A,A01,083075,Gupta; Anjum,21,0,76,55
1658067405310,CSE 3,A50,083646,Miranda; Gregory Joseph,24,0,50,26
1658067411339,CSE 8A,A50,083650,Miranda; Gregory Joseph,17,1,56,39
1658067417367,CSE 11,A01,083080,Cao; Yingjun,7,15,40,33
1658067423395,CSE 12,A01,083652,Krause-Levy; Sophia Louisa,30,1,120,90
1658067429419,CSE 15L,A01,083654,Morris; Justin Loren,9,0,50,41
1658067429419,CSE 15L,A02,083655,Morris; Justin Loren,11,0,50,39
1658067435452,CSE 20,A01,083657,Tran; Khoa Dang,39,0,80,41
1658067441480,CSE 21,A01,095574,Bach; Quang Tran,23,0,48,25
1658067447516,CSE 30,A01,083084,Eldon; John,8,0,80,72
1658067447516,CSE 30,B01,095061,Bhaskar; Nishant,9,0,50,41
1658067453547,CSE 100,A01,083659,Cao; Yingjun,5,4,70,65
1658067459577,CSE 134B,A01,083661,Powell; Thomas Allan,25,0,100,75
1658067465606,CSE 140,A01,083663,Gungor; Onat,17,0,85,68
1658067471633,CSE 140L,A01,083088,Eldon; John,23,0,100,77
1658067477657,CSE 175,A01,083665,Kumar; Rakesh,3,0,25,22
1658067483683,CSE 190,A00,092507,Dubnov; Shlomo,8,0,20,12
1658067489710,ECE 45,A01,083139,Congero; Spencer William,7,0,75,68
1658067495740,ECE 65,A50,083695,Saad; Andrew S,12,0,30,18
1658067495740,ECE 65,A51,095125,Saad; Andrew S,24,0,26,2
1658067501764,ECE 109,A01,091882,Touri; Behrouz,21,0,70,49
1658067507792,ECE 180,A00,083140,Abi Samra; Nicholas Camill,1,0,30,29
1658067507792,ECE 180,B00,083141,Abi Samra; Nicholas Camill,0,0,30,30
1658067513816,MATH 10A,A01,083735,Patchell; Gregory David,2,0,30,28
1658067513816,MATH 10A,A02,083736,Patchell; Gregory David,20,0,30,10
1658067513816,MATH 10A,A03,083737,Patchell; Gregory David,16,0,30,14
1658067519841,MATH 10B,A01,083207,Lim; Seonhee,9,0,34,25
1658067519841,MATH 10B,A02,083208,Lim; Seonhee,10,0,35,25
1658067519841,MATH 10B,A03,093472,Lim; Seonhee,7,0,34,27
1658067519841,MATH 10B,B01,083739,Sinha; Shubham,14,0,30,16
1658067525875,MATH 18,A01,083743,Cinel; Cameron Alexander,9,0,30,21
1658067525875,MATH 18,A02,083744,Cinel; Cameron Alexander,18,0,30,12
1658067525875,MATH 18,A03,083745,Cinel; Cameron Alexander,10,0,30,20
1658067525875,MATH 18,B01,083748,Rideout; David Porter,5,0,37,32
1658067525875,MATH 18,B02,083749,Rideout; David Porter,5,0,36,31
1658067525875,MATH 18,B03,083750,Rideout; David Porter,3,0,37,34
1658067525875,MATH 18,B04,083751,Rideout; David Porter,7,0,36,29
1658067525875,MATH 18,B05,093473,Rideout; David Porter,7,0,36,29
1658067525875,MATH 18,B06,093474,Rideout; David Porter,6,0,36,30
1658067531902,MATH 20A,A01,083754,Zheng; Zequn,14,0,40,26
1658067537931,MATH 20B,A01,083756,Briones; Jor-el Thomas Caparas,4,0,36,32
1658067537931,MATH 20B,A02,083757,Briones; Jor-el Thomas Caparas,1,0,36,35
1658067537931,MATH 20B,A03,093475,Briones; Jor-el Thomas Caparas,3,0,36,33
1658067543956,MATH 20C,A01,083760,Briones; Jor-el Thomas Caparas,1,0,35,34
1658067543956,MATH 20C,A02,083761,Briones; Jor-el Thomas Caparas,8,0,35,27
1658067543956,MATH 20C,A03,093476,Briones; Jor-el Thomas Caparas,0,1,36,36
1658067543956,MATH 20C,B01,083762,Bach; Quang Tran,1,0,30,29
1658067549982,MATH 20D,A01,083765,Tran; Brian Kha,5,0,30,25
1658067549982,MATH 20D,A02,083766,Tran; Brian Kha,5,0,30,25
1658067549982,MATH 20D,A03,083767,Tran; Brian Kha,6,0,30,24
1658067556013,MATH 20E,A01,083771,Ganguly; Soumya,12,0,32,20
1658067556013,MATH 20E,A02,083772,Ganguly; Soumya,7,0,32,25
1658067556013,MATH 20E,B01,083773,Ciotti; Benjamin,20,0,35,15
1658067556013,MATH 20E,B02,083774,Ciotti; Benjamin,18,0,35,17
1658067562044,MATH 103A,A01,083777,Greenfeld; Be'Eri,6,0,36,30
1658067562044,MATH 103A,A02,083778,Greenfeld; Be'Eri,5,0,36,31
1658067562044,MATH 103A,A03,093561,Greenfeld; Be'Eri,7,0,36,29
1658067562044,MATH 103A,B01,083779,Greenfeld; Be'Eri,8,0,36,28
1658067562044,MATH 103A,B02,083780,Greenfeld; Be'Eri,4,0,36,32
1658067562044,MATH 103A,B03,093562,Greenfeld; Be'Eri,3,0,36,33
1658067568070,MATH 105,A01,085443,Carter; Anne Toulson,15,0,35,20
1658067568070,MATH 105,A02,093477,Carter; Anne Toulson,20,0,35,15
1658067574100,MATH 109,A01,083213,Ganzberger; Geoffrey Michael,3,0,34,31
1658067574100,MATH 109,A02,083214,Ganzberger; Geoffrey Michael,4,0,34,30
1658067574100,MATH 109,A03,093478,Ganzberger; Geoffrey Michael,2,0,34,32
1658067574100,MATH 109,B01,083215,Ganzberger; Geoffrey Michael,3,0,32,29
1658067574100,MATH 109,B02,083216,Ganzberger; Geoffrey Michael,3,0,32,29
1658067574100,MATH 109,B03,093479,Ganzberger; Geoffrey Michael,8,0,32,24
1658067580126,MATH 142A,A01,083219,Chow; Bennett,7,0,32,25
1658067580126,MATH 142A,A02,083220,Chow; Bennett,10,0,32,22
1658067580126,MATH 142A,A03,093480,Chow; Bennett,9,0,32,23
1658067580126,MATH 142A,B03,093481,Chow; Bennett,8,0,32,24
1658067580126,MATH 142A,B04,093558,Chow; Bennett,14,0,32,18
1658067580126,MATH 142A,B05,093559,Chow; Bennett,7,0,32,25
1658067586152,MATH 193A,A01,083224,Rotar; Vladimir,9,0,34,25
1658067586152,MATH 193A,A02,083225,Rotar; Vladimir,11,0,34,23
1658067586152,MATH 193A,A03,083781,Rotar; Vladimir,5,0,34,29
1658067586152,MATH 193A,A04,083782,Rotar; Vladimir,12,0,34,22
1658067586152,MATH 193A,A05,093482,Rotar; Vladimir,11,0,34,23
1658067592180,MATH 197,001,091859,McAuley; Julian John,9999,0,9999,0
1658067592180,MATH 197,002,095566,Kedlaya; Kiran S.,9997,0,9999,2
1658067592180,MATH 197,003,095567,Xiao; Ming,9999,0,9999,0
1658067592180,MATH 197,004,095571,Perols; Johan Lars,9998,0,9999,1
1658067599236,COGS 9,A01,083615,Shannon; Kyle Michael,11,0,75,64
1658067605260,COGS 11,A01,083617,Boyle; Mary E. T.,23,0,48,25
1658067611284,COGS 13,A01,083071,Bastos; Amalia Pinkusfeld,12,0,71,59
1658067617308,COGS 14A,A01,092681,Semenuks; Arturs,5,1,100,95
1658067623331,COGS 14B,A01,083073,Cheng; Tzu-Han,7,0,63,56
1658067629363,COGS 17,A01,092677,Semenuks; Arturs,7,0,81,74
1658067635391,COGS 100,A01,083619,Allen; Michael Gordon,17,0,70,53
1658067641416,COGS 101A,A01,083621,Davis; Joshua Daniel,9,0,68,59
1658067647447,COGS 101B,A01,091572,Allen; Michael Gordon,14,0,65,51
1658067653474,COGS 101C,A01,083625,Delgado; Tania,17,0,35,18
1658067659501,COGS 107A,A01,083627,Boyle; Mary E. T.,14,0,60,46
1658067665529,COGS 118A,A01,083075,Gupta; Anjum,21,0,76,55
1658067671553,CSE 3,A50,083646,Miranda; Gregory Joseph,24,0,50,26
1658067677581,CSE 8A,A50,083650,Miranda; Gregory Joseph,17,1,56,39
1658067683605,CSE 11,A01,083080,Cao; Yingjun,7,15,40,33
1658067689649,CSE 12,A01,083652,Krause-Levy; Sophia Louisa,30,1,120,90
1658067695674,CSE 15L,A01,083654,Morris; Justin Loren,9,0,50,41
1658067695674,CSE 15L,A02,083655,Morris; Justin Loren,11,0,50,39
1658067701701,CSE 20,A01,083657,Tran; Khoa Dang,39,0,80,41
1658067707733,CSE 21,A01,095574,Bach; Quang Tran,23,0,48,25
1658067713757,CSE 30,A01,083084,Eldon; John,8,0,80,72
1658067713757,CSE 30,B01,095061,Bhaskar; Nishant,9,0,50,41
1658067719784,CSE 100,A01,083659,Cao; Yingjun,5,4,70,65
1658067725809,CSE 134B,A01,083661,Powell; Thomas Allan,25,0,100,75
1658067731838,CSE 140,A01,083663,Gungor; Onat,17,0,85,68
1658067737862,CSE 140L,A01,083088,Eldon; John,23,0,100,77
1658067743893,CSE 175,A01,083665,Kumar; Rakesh,3,0,25,22
1658067749921,CSE 190,A00,092507,Dubnov; Shlomo,8,0,20,12
1658067755945,ECE 45,A01,083139,Congero; Spencer William,7,0,75,68
1658067761969,ECE 65,A50,083695,Saad; Andrew S,12,0,30,18
1658067761969,ECE 65,A51,095125,Saad; Andrew S,24,0,26,2
1658067767995,ECE 109,A01,091882,Touri; Behrouz,21,0,70,49
1658067774019,ECE 180,A00,083140,Abi Samra; Nicholas Camill,1,0,30,29
1658067774019,ECE 180,B00,083141,Abi Samra; Nicholas Camill,0,0,30,30
1658067780049,MATH 10A,A01,083735,Patchell; Gregory David,2,0,30,28
1658067780049,MATH 10A,A02,083736,Patchell; Gregory David,20,0,30,10
1658067780049,MATH 10A,A03,083737,Patchell; Gregory David,16,0,30,14
1658067786075,MATH 10B,A01,083207,Lim; Seonhee,9,0,34,25
1658067786075,MATH 10B,A02,083208,Lim; Seonhee,10,0,35,25
1658067786075,MATH 10B,A03,093472,Lim; Seonhee,7,0,34,27
1658067786075,MATH 10B,B01,083739,Sinha; Shubham,14,0,30,16
1658067792109,MATH 18,A01,083743,Cinel; Cameron Alexander,9,0,30,21
1658067792109,MATH 18,A02,083744,Cinel; Cameron Alexander,18,0,30,12
1658067792109,MATH 18,A03,083745,Cinel; Cameron Alexander,10,0,30,20
1658067792109,MATH 18,B01,083748,Rideout; David Porter,5,0,37,32
1658067792109,MATH 18,B02,083749,Rideout; David Porter,5,0,36,31
1658067792109,MATH 18,B03,083750,Rideout; David Porter,3,0,37,34
1658067792109,MATH 18,B04,083751,Rideout; David Porter,7,0,36,29
1658067792109,MATH 18,B05,093473,Rideout; David Porter,7,0,36,29
1658067792109,MATH 18,B06,093474,Rideout; David Porter,6,0,36,30
1658067798135,MATH 20A,A01,083754,Zheng; Zequn,14,0,40,26
1658067804161,MATH 20B,A01,083756,Briones; Jor-el Thomas Caparas,4,0,36,32
1658067804161,MATH 20B,A02,083757,Briones; Jor-el Thomas Caparas,1,0,36,35
1658067804161,MATH 20B,A03,093475,Briones; Jor-el Thomas Caparas,3,0,36,33
1658067810187,MATH 20C,A01,083760,Briones; Jor-el Thomas Caparas,1,0,35,34
1658067810187,MATH 20C,A02,083761,Briones; Jor-el Thomas Caparas,8,0,35,27
1658067810187,MATH 20C,A03,093476,Briones; Jor-el Thomas Caparas,0,1,36,36
1658067810187,MATH 20C,B01,083762,Bach; Quang Tran,1,0,30,29
1658067816216,MATH 20D,A01,083765,Tran; Brian Kha,5,0,30,25
1658067816216,MATH 20D,A02,083766,Tran; Brian Kha,5,0,30,25
1658067816216,MATH 20D,A03,083767,Tran; Brian Kha,6,0,30,24
1658067822246,MATH 20E,A01,083771,Ganguly; Soumya,12,0,32,20
1658067822246,MATH 20E,A02,083772,Ganguly; Soumya,7,0,32,25
1658067822246,MATH 20E,B01,083773,Ciotti; Benjamin,20,0,35,15
1658067822246,MATH 20E,B02,083774,Ciotti; Benjamin,18,0,35,17
1658067828271,MATH 103A,A01,083777,Greenfeld; Be'Eri,6,0,36,30
1658067828271,MATH 103A,A02,083778,Greenfeld; Be'Eri,5,0,36,31
1658067828271,MATH 103A,A03,093561,Greenfeld; Be'Eri,7,0,36,29
1658067828271,MATH 103A,B01,083779,Greenfeld; Be'Eri,8,0,36,28
1658067828271,MATH 103A,B02,083780,Greenfeld; Be'Eri,4,0,36,32
1658067828271,MATH 103A,B03,093562,Greenfeld; Be'Eri,3,0,36,33
1658067834300,MATH 105,A01,085443,Carter; Anne Toulson,15,0,35,20
1658067834300,MATH 105,A02,093477,Carter; Anne Toulson,20,0,35,15
1658067840333,MATH 109,A01,083213,Ganzberger; Geoffrey Michael,3,0,34,31
1658067840333,MATH 109,A02,083214,Ganzberger; Geoffrey Michael,4,0,34,30
1658067840333,MATH 109,A03,093478,Ganzberger; Geoffrey Michael,2,0,34,32
1658067840333,MATH 109,B01,083215,Ganzberger; Geoffrey Michael,3,0,32,29
1658067840333,MATH 109,B02,083216,Ganzberger; Geoffrey Michael,3,0,32,29
1658067840333,MATH 109,B03,093479,Ganzberger; Geoffrey Michael,8,0,32,24
1658067846368,MATH 142A,A01,083219,Chow; Bennett,7,0,32,25
1658067846368,MATH 142A,A02,083220,Chow; Bennett,10,0,32,22
1658067846368,MATH 142A,A03,093480,Chow; Bennett,9,0,32,23
1658067846368,MATH 142A,B03,093481,Chow; Bennett,8,0,32,24
1658067846368,MATH 142A,B04,093558,Chow; Bennett,14,0,32,18
1658067846368,MATH 142A,B05,093559,Chow; Bennett,7,0,32,25
1658067852399,MATH 193A,A01,083224,Rotar; Vladimir,9,0,34,25
1658067852399,MATH 193A,A02,083225,Rotar; Vladimir,11,0,34,23
1658067852399,MATH 193A,A03,083781,Rotar; Vladimir,5,0,34,29
1658067852399,MATH 193A,A04,083782,Rotar; Vladimir,12,0,34,22
1658067852399,MATH 193A,A05,093482,Rotar; Vladimir,11,0,34,23
1658067858424,MATH 197,001,091859,McAuley; Julian John,9999,0,9999,0
1658067858424,MATH 197,002,095566,Kedlaya; Kiran S.,9997,0,9999,2
1658067858424,MATH 197,003,095567,Xiao; Ming,9999,0,9999,0
1658067858424,MATH 197,004,095571,Perols; Johan Lars,9998,0,9999,1
1658067865491,COGS 9,A01,083615,Shannon; Kyle Michael,11,0,75,64
1658067871515,COGS 11,A01,083617,Boyle; Mary E. T.,23,0,48,25
1658067877550,COGS 13,A01,083071,Bastos; Amalia Pinkusfeld,12,0,71,59
1658067883578,COGS 14A,A01,092681,Semenuks; Arturs,5,1,100,95
1658067889603,COGS 14B,A01,083073,Cheng; Tzu-Han,7,0,63,56
1658067895627,COGS 17,A01,092677,Semenuks; Arturs,7,0,81,74
1658067901650,COGS 100,A01,083619,Allen; Michael Gordon,17,0,70,53
1658067907680,COGS 101A,A01,083621,Davis; Joshua Daniel,9,0,68,59
1658067913706,COGS 101B,A01,091572,Allen; Michael Gordon,14,0,65,51
1658067919730,COGS 101C,A01,083625,Delgado; Tania,17,0,35,18
1658067925758,COGS 107A,A01,083627,Boyle; Mary E. T.,14,0,60,46
1658067931780,COGS 118A,A01,083075,Gupta; Anjum,21,0,76,55
1658067937803,CSE 3,A50,083646,Miranda; Gregory Joseph,24,0,50,26
1658067943831,CSE 8A,A50,083650,Miranda; Gregory Joseph,17,1,56,39
1658067949941,CSE 11,A01,083080,Cao; Yingjun,7,15,40,33
1658067955968,CSE 12,A01,083652,Krause-Levy; Sophia Louisa,30,1,120,90
1658067961992,CSE 15L,A01,083654,Morris; Justin Loren,9,0,50,41
1658067961992,CSE 15L,A02,083655,Morris; Justin Loren,11,0,50,39
1658067968014,CSE 20,A01,083657,Tran; Khoa Dang,39,0,80,41
1658067974038,CSE 21,A01,095574,Bach; Quang Tran,23,0,48,25
1658067980068,CSE 30,A01,083084,Eldon; John,8,0,80,72
1658067980068,CSE 30,B01,095061,Bhaskar; Nishant,9,0,50,41
1658067986097,CSE 100,A01,083659,Cao; Yingjun,5,4,70,65
1658067992121,CSE 134B,A01,083661,Powell; Thomas Allan,25,0,100,75
1658067998148,CSE 140,A01,083663,Gungor; Onat,17,0,85,68
1658068004177,CSE 140L,A01,083088,Eldon; John,23,0,100,77
1658068010201,CSE 175,A01,083665,Kumar; Rakesh,3,0,25,22
1658068016225,CSE 190,A00,092507,Dubnov; Shlomo,8,0,20,12
1658068022250,ECE 45,A01,083139,Congero; Spencer William,7,0,75,68
1658068028274,ECE 65,A50,083695,Saad; Andrew S,12,0,30,18
1658068028274,ECE 65,A51,095125,Saad; Andrew S,24,0,26,2
1658068034302,ECE 109,A01,091882,Touri; Behrouz,21,0,70,49
1658068040326,ECE 180,A00,083140,Abi Samra; Nicholas Camill,1,0,30,29
1658068040326,ECE 180,B00,083141,Abi Samra; Nicholas Camill,0,0,30,30
1658068046353,MATH 10A,A01,083735,Patchell; Gregory David,2,0,30,28
1658068046353,MATH 10A,A02,083736,Patchell; Gregory David,20,0,30,10
1658068046353,MATH 10A,A03,083737,Patchell; Gregory David,16,0,30,14
1658068052382,MATH 10B,A01,083207,Lim; Seonhee,9,0,34,25
1658068052382,MATH 10B,A02,083208,Lim; Seonhee,10,0,35,25
1658068052382,MATH 10B,A03,093472,Lim; Seonhee,7,0,34,27
1658068052382,MATH 10B,B01,083739,Sinha; Shubham,14,0,30,16
1658068058415,MATH 18,A01,083743,Cinel; Cameron Alexander,9,0,30,21
1658068058415,MATH 18,A02,083744,Cinel; Cameron Alexander,18,0,30,12
1658068058415,MATH 18,A03,083745,Cinel; Cameron Alexander,10,0,30,20
1658068058415,MATH 18,B01,083748,Rideout; David Porter,5,0,37,32
1658068058415,MATH 18,B02,083749,Rideout; David Porter,5,0,36,31
1658068058415,MATH 18,B03,083750,Rideout; David Porter,3,0,37,34
1658068058415,MATH 18,B04,083751,Rideout; David Porter,7,0,36,29
1658068058415,MATH 18,B05,093473,Rideout; David Porter,7,0,36,29
1658068058415,MATH 18,B06,093474,Rideout; David Porter,6,0,36,30
1658068064440,MATH 20A,A01,083754,Zheng; Zequn,14,0,40,26
1658068070468,MATH 20B,A01,083756,Briones; Jor-el Thomas Caparas,4,0,36,32
1658068070468,MATH 20B,A02,083757,Briones; Jor-el Thomas Caparas,1,0,36,35
1658068070468,MATH 20B,A03,093475,Briones; Jor-el Thomas Caparas,3,0,36,33
1658068076499,MATH 20C,A01,083760,Briones; Jor-el Thomas Caparas,1,0,35,34
1658068076499,MATH 20C,A02,083761,Briones; Jor-el Thomas Caparas,8,0,35,27
1658068076499,MATH 20C,A03,093476,Briones; Jor-el Thomas Caparas,0,1,36,36
1658068076499,MATH 20C,B01,083762,Bach; Quang Tran,1,0,30,29
1658068082523,MATH 20D,A01,083765,Tran; Brian Kha,5,0,30,25
1658068082523,MATH 20D,A02,083766,Tran; Brian Kha,5,0,30,25
1658068082523,MATH 20D,A03,083767,Tran; Brian Kha,6,0,30,24
1658068088553,MATH 20E,A01,083771,Ganguly; Soumya,12,0,32,20
1658068088553,MATH 20E,A02,083772,Ganguly; Soumya,7,0,32,25
1658068088553,MATH 20E,B01,083773,Ciotti; Benjamin,20,0,35,15
1658068088553,MATH 20E,B02,083774,Ciotti; Benjamin,18,0,35,17
1658068094579,MATH 103A,A01,083777,Greenfeld; Be'Eri,6,0,36,30
1658068094579,MATH 103A,A02,083778,Greenfeld; Be'Eri,5,0,36,31
1658068094579,MATH 103A,A03,093561,Greenfeld; Be'Eri,7,0,36,29
1658068094579,MATH 103A,B01,083779,Greenfeld; Be'Eri,8,0,36,28
1658068094579,MATH 103A,B02,083780,Greenfeld; Be'Eri,4,0,36,32
1658068094579,MATH 103A,B03,093562,Greenfeld; Be'Eri,3,0,36,33
1658068100605,MATH 105,A01,085443,Carter; Anne Toulson,15,0,35,20
1658068100605,MATH 105,A02,093477,Carter; Anne Toulson,20,0,35,15
1658068106635,MATH 109,A01,083213,Ganzberger; Geoffrey Michael,3,0,34,31
1658068106635,MATH 109,A02,083214,Ganzberger; Geoffrey Michael,4,0,34,30
1658068106635,MATH 109,A03,093478,Ganzberger; Geoffrey Michael,2,0,34,32
1658068106635,MATH 109,B01,083215,Ganzberger; Geoffrey Michael,3,0,32,29
1658068106635,MATH 109,B02,083216,Ganzberger; Geoffrey Michael,3,0,32,29
1658068106635,MATH 109,B03,093479,Ganzberger; Geoffrey Michael,8,0,32,24
1658068112665,MATH 142A,A01,083219,Chow; Bennett,7,0,32,25
1658068112665,MATH 142A,A02,083220,Chow; Bennett,10,0,32,22
1658068112665,MATH 142A,A03,093480,Chow; Bennett,9,0,32,23
1658068112665,MATH 142A,B03,093481,Chow; Bennett,8,0,32,24
1658068112665,MATH 142A,B04,093558,Chow; Bennett,14,0,32,18
1658068112665,MATH 142A,B05,093559,Chow; Bennett,7,0,32,25
1658068118692,MATH 193A,A01,083224,Rotar; Vladimir,9,0,34,25
1658068118692,MATH 193A,A02,083225,Rotar; Vladimir,11,0,34,23
1658068118692,MATH 193A,A03,083781,Rotar; Vladimir,5,0,34,29
1658068118692,MATH 193A,A04,083782,Rotar; Vladimir,12,0,34,22
1658068118692,MATH 193A,A05,093482,Rotar; Vladimir,11,0,34,23
1658068124720,MATH 197,001,091859,McAuley; Julian John,9999,0,9999,0
1658068124720,MATH 197,002,095566,Kedlaya; Kiran S.,9997,0,9999,2
1658068124720,MATH 197,003,095567,Xiao; Ming,9999,0,9999,0
1658068124720,MATH 197,004,095571,Perols; Johan Lars,9998,0,9999,1
1658068131774,COGS 9,A01,083615,Shannon; Kyle Michael,11,0,75,64
1658068137799,COGS 11,A01,083617,Boyle; Mary E. T.,23,0,48,25
1658068143830,COGS 13,A01,083071,Bastos; Amalia Pinkusfeld,12,0,71,59
1658068149855,COGS 14A,A01,092681,Semenuks; Arturs,5,1,100,95
1658068155880,COGS 14B,A01,083073,Cheng; Tzu-Han,7,0,63,56
1658068161906,COGS 17,A01,092677,Semenuks; Arturs,7,0,81,74
1658068167932,COGS 100,A01,083619,Allen; Michael Gordon,17,0,70,53
1658068173956,COGS 101A,A01,083621,Davis; Joshua Daniel,9,0,68,59
1658068179993,COGS 101B,A01,091572,Allen; Michael Gordon,14,0,65,51
1658068186017,COGS 101C,A01,083625,Delgado; Tania,17,0,35,18
1658068192041,COGS 107A,A01,083627,Boyle; Mary E. T.,14,0,60,46
1658068198068,COGS 118A,A01,083075,Gupta; Anjum,21,0,76,55
1658068204095,CSE 3,A50,083646,Miranda; Gregory Joseph,24,0,50,26
1658068210122,CSE 8A,A50,083650,Miranda; Gregory Joseph,17,1,56,39
1658068216151,CSE 11,A01,083080,Cao; Yingjun,7,15,40,33
1658068222175,CSE 12,A01,083652,Krause-Levy; Sophia Louisa,30,1,120,90
1658068228199,CSE 15L,A01,083654,Morris; Justin Loren,9,0,50,41
1658068228199,CSE 15L,A02,083655,Morris; Justin Loren,11,0,50,39
1658068234226,CSE 20,A01,083657,Tran; Khoa Dang,39,0,80,41
1658068240253,CSE 21,A01,095574,Bach; Quang Tran,23,0,48,25
1658068246281,CSE 30,A01,083084,Eldon; John,8,0,80,72
1658068246281,CSE 30,B01,095061,Bhaskar; Nishant,9,0,50,41
1658068252309,CSE 100,A01,083659,Cao; Yingjun,5,4,70,65
1658068258332,CSE 134B,A01,083661,Powell; Thomas Allan,25,0,100,75
1658068264358,CSE 140,A01,083663,Gungor; Onat,17,0,85,68
1658068270381,CSE 140L,A01,083088,Eldon; John,23,0,100,77
1658068276406,CSE 175,A01,083665,Kumar; Rakesh,3,0,25,22
1658068282429,CSE 190,A00,092507,Dubnov; Shlomo,8,0,20,12
1658068288453,ECE 45,A01,083139,Congero; Spencer William,7,0,75,68
1658068294484,ECE 65,A50,083695,Saad; Andrew S,12,0,30,18
1658068294484,ECE 65,A51,095125,Saad; Andrew S,24,0,26,2
1658068300509,ECE 109,A01,091882,Touri; Behrouz,21,0,70,49
1658068306537,ECE 180,A00,083140,Abi Samra; Nicholas Camill,1,0,30,29
1658068306537,ECE 180,B00,083141,Abi Samra; Nicholas Camill,0,0,30,30
1658068312562,MATH 10A,A01,083735,Patchell; Gregory David,2,0,30,28
1658068312562,MATH 10A,A02,083736,Patchell; Gregory David,20,0,30,10
1658068312562,MATH 10A,A03,083737,Patchell; Gregory David,16,0,30,14
1658068318594,MATH 10B,A01,083207,Lim; Seonhee,9,0,34,25
1658068318594,MATH 10B,A02,083208,Lim; Seonhee,10,0,35,25
1658068318594,MATH 10B,A03,093472,Lim; Seonhee,7,0,34,27
1658068318594,MATH 10B,B01,083739,Sinha; Shubham,14,0,30,16
1658068324619,MATH 18,A01,083743,Cinel; Cameron Alexander,9,0,30,21
1658068324619,MATH 18,A02,083744,Cinel; Cameron Alexander,18,0,30,12
1658068324619,MATH 18,A03,083745,Cinel; Cameron Alexander,10,0,30,20
1658068324619,MATH 18,B01,083748,Rideout; David Porter,5,0,37,32
1658068324619,MATH 18,B02,083749,Rideout; David Porter,5,0,36,31
1658068324619,MATH 18,B03,083750,Rideout; David Porter,3,0,37,34
1658068324619,MATH 18,B04,083751,Rideout; David Porter,7,0,36,29
1658068324619,MATH 18,B05,093473,Rideout; David Porter,7,0,36,29
1658068324619,MATH 18,B06,093474,Rideout; David Porter,6,0,36,30
1658068330643,MATH 20A,A01,083754,Zheng; Zequn,14,0,40,26
1658068336670,MATH 20B,A01,083756,Briones; Jor-el Thomas Caparas,4,0,36,32
1658068336670,MATH 20B,A02,083757,Briones; Jor-el Thomas Caparas,1,0,36,35
1658068336670,MATH 20B,A03,093475,Briones; Jor-el Thomas Caparas,3,0,36,33
1658068342697,MATH 20C,A01,083760,Briones; Jor-el Thomas Caparas,1,0,35,34
1658068342697,MATH 20C,A02,083761,Briones; Jor-el Thomas Caparas,8,0,35,27
1658068342697,MATH 20C,A03,093476,Briones; Jor-el Thomas Caparas,0,1,36,36
1658068342697,MATH 20C,B01,083762,Bach; Quang Tran,1,0,30,29
1658068348727,MATH 20D,A01,083765,Tran; Brian Kha,5,0,30,25
1658068348727,MATH 20D,A02,083766,Tran; Brian Kha,5,0,30,25
1658068348727,MATH 20D,A03,083767,Tran; Brian Kha,6,0,30,24
1658068354750,MATH 20E,A01,083771,Ganguly; Soumya,12,0,32,20
1658068354750,MATH 20E,A02,083772,Ganguly; Soumya,7,0,32,25
1658068354750,MATH 20E,B01,083773,Ciotti; Benjamin,20,0,35,15
1658068354750,MATH 20E,B02,083774,Ciotti; Benjamin,18,0,35,17
1658068360781,MATH 103A,A01,083777,Greenfeld; Be'Eri,6,0,36,30
1658068360781,MATH 103A,A02,083778,Greenfeld; Be'Eri,5,0,36,31
1658068360781,MATH 103A,A03,093561,Greenfeld; Be'Eri,7,0,36,29
1658068360781,MATH 103A,B01,083779,Greenfeld; Be'Eri,8,0,36,28
1658068360781,MATH 103A,B02,083780,Greenfeld; Be'Eri,4,0,36,32
1658068360781,MATH 103A,B03,093562,Greenfeld; Be'Eri,3,0,36,33
1658068366808,MATH 105,A01,085443,Carter; Anne Toulson,15,0,35,20
1658068366808,MATH 105,A02,093477,Carter; Anne Toulson,20,0,35,15
1658068372832,MATH 109,A01,083213,Ganzberger; Geoffrey Michael,3,0,34,31
1658068372832,MATH 109,A02,083214,Ganzberger; Geoffrey Michael,4,0,34,30
1658068372832,MATH 109,A03,093478,Ganzberger; Geoffrey Michael,2,0,34,32
1658068372832,MATH 109,B01,083215,Ganzberger; Geoffrey Michael,3,0,32,29
1658068372832,MATH 109,B02,083216,Ganzberger; Geoffrey Michael,3,0,32,29
1658068372832,MATH 109,B03,093479,Ganzberger; Geoffrey Michael,8,0,32,24
1658068378858,MATH 142A,A01,083219,Chow; Bennett,7,0,32,25
1658068378858,MATH 142A,A02,083220,Chow; Bennett,10,0,32,22
1658068378858,MATH 142A,A03,093480,Chow; Bennett,9,0,32,23
1658068378858,MATH 142A,B03,093481,Chow; Bennett,8,0,32,24
1658068378858,MATH 142A,B04,093558,Chow; Bennett,14,0,32,18
1658068378858,MATH 142A,B05,093559,Chow; Bennett,7,0,32,25
1658068384891,MATH 193A,A01,083224,Rotar; Vladimir,9,0,34,25
1658068384891,MATH 193A,A02,083225,Rotar; Vladimir,11,0,34,23
1658068384891,MATH 193A,A03,083781,Rotar; Vladimir,5,0,34,29
1658068384891,MATH 193A,A04,083782,Rotar; Vladimir,12,0,34,22
1658068384891,MATH 193A,A05,093482,Rotar; Vladimir,11,0,34,23
1658068390913,MATH 197,001,091859,McAuley; Julian John,9999,0,9999,0
1658068390913,MATH 197,002,095566,Kedlaya; Kiran S.,9997,0,9999,2
1658068390913,MATH 197,003,095567,Xiao; Ming,9999,0,9999,0
1658068390913,MATH 197,004,095571,Perols; Johan Lars,9998,0,9999,1
1658068397987,COGS 9,A01,083615,Shannon; Kyle Michael,11,0,75,64
1658068404016,COGS 11,A01,083617,Boyle; Mary E. T.,23,0,48,25
1658068410038,COGS 13,A01,083071,Bastos; Amalia Pinkusfeld,12,0,71,59
1658068416063,COGS 14A,A01,092681,Semenuks; Arturs,5,1,100,95
1658068422097,COGS 14B,A01,083073,Cheng; Tzu-Han,7,0,63,56
1658068428122,COGS 17,A01,092677,Semenuks; Arturs,7,0,81,74
1658068434149,COGS 100,A01,083619,Allen; Michael Gordon,17,0,70,53
1658068440174,COGS 101A,A01,083621,Davis; Joshua Daniel,9,0,68,59
1658068446197,COGS 101B,A01,091572,Allen; Michael Gordon,14,0,65,51
1658068452222,COGS 101C,A01,083625,Delgado; Tania,17,0,35,18
1658068458253,COGS 107A,A01,083627,Boyle; Mary E. T.,14,0,60,46
1658068464294,COGS 118A,A01,083075,Gupta; Anjum,21,0,76,55
1658068470324,CSE 3,A50,083646,Miranda; Gregory Joseph,24,0,50,26
1658068476348,CSE 8A,A50,083650,Miranda; Gregory Joseph,17,1,56,39
1658068482377,CSE 11,A01,083080,Cao; Yingjun,7,15,40,33
1658068488407,CSE 12,A01,083652,Krause-Levy; Sophia Louisa,30,1,120,90
1658068494431,CSE 15L,A01,083654,Morris; Justin Loren,9,0,50,41
1658068494431,CSE 15L,A02,083655,Morris; Justin Loren,11,0,50,39
1658068500459,CSE 20,A01,083657,Tran; Khoa Dang,39,0,80,41
1658068506488,CSE 21,A01,095574,Bach; Quang Tran,23,0,48,25
1658068512514,CSE 30,A01,083084,Eldon; John,8,0,80,72
1658068512514,CSE 30,B01,095061,Bhaskar; Nishant,9,0,50,41
1658068518539,CSE 100,A01,083659,Cao; Yingjun,5,4,70,65
1658068524567,CSE 134B,A01,083661,Powell; Thomas Allan,25,0,100,75
1658068530606,CSE 140,A01,083663,Gungor; Onat,17,0,85,68
1658068536630,CSE 140L,A01,083088,Eldon; John,23,0,100,77
1658068542658,CSE 175,A01,083665,Kumar; Rakesh,3,0,25,22
1658068548756,CSE 190,A00,092507,Dubnov; Shlomo,8,0,20,12
1658068554788,ECE 45,A01,083139,Congero; Spencer William,7,0,75,68
1658068560817,ECE 65,A50,083695,Saad; Andrew S,12,0,30,18
1658068560817,ECE 65,A51,095125,Saad; Andrew S,24,0,26,2
1658068566845,ECE 109,A01,091882,Touri; Behrouz,21,0,70,49
1658068572870,ECE 180,A00,083140,Abi Samra; Nicholas Camill,1,0,30,29
1658068572870,ECE 180,B00,083141,Abi Samra; Nicholas Camill,0,0,30,30
1658068578897,MATH 10A,A01,083735,Patchell; Gregory David,2,0,30,28
1658068578897,MATH 10A,A02,083736,Patchell; Gregory David,20,0,30,10
1658068578897,MATH 10A,A03,083737,Patchell; Gregory David,16,0,30,14
1658068584960,MATH 10B,A01,083207,Lim; Seonhee,9,0,34,25
1658068584960,MATH 10B,A02,083208,Lim; Seonhee,10,0,35,25
1658068584960,MATH 10B,A03,093472,Lim; Seonhee,7,0,34,27
1658068584960,MATH 10B,B01,083739,Sinha; Shubham,14,0,30,16
1658068590985,MATH 18,A01,083743,Cinel; Cameron Alexander,9,0,30,21
1658068590985,MATH 18,A02,083744,Cinel; Cameron Alexander,18,0,30,12
1658068590985,MATH 18,A03,083745,Cinel; Cameron Alexander,10,0,30,20
1658068590985,MATH 18,B01,083748,Rideout; David Porter,5,0,37,32
1658068590985,MATH 18,B02,083749,Rideout; David Porter,5,0,36,31
1658068590985,MATH 18,B03,083750,Rideout; David Porter,3,0,37,34
1658068590985,MATH 18,B04,083751,Rideout; David Porter,7,0,36,29
1658068590985,MATH 18,B05,093473,Rideout; David Porter,7,0,36,29
1658068590985,MATH 18,B06,093474,Rideout; David Porter,6,0,36,30
1658068597009,MATH 20A,A01,083754,Zheng; Zequn,14,0,40,26
1658068603033,MATH 20B,A01,083756,Briones; Jor-el Thomas Caparas,4,0,36,32
1658068603033,MATH 20B,A02,083757,Briones; Jor-el Thomas Caparas,1,0,36,35
1658068603033,MATH 20B,A03,093475,Briones; Jor-el Thomas Caparas,3,0,36,33
1658068609064,MATH 20C,A01,083760,Briones; Jor-el Thomas Caparas,1,0,35,34
1658068609064,MATH 20C,A02,083761,Briones; Jor-el Thomas Caparas,8,0,35,27
1658068609064,MATH 20C,A03,093476,Briones; Jor-el Thomas Caparas,0,1,36,36
1658068609064,MATH 20C,B01,083762,Bach; Quang Tran,1,0,30,29
1658068615087,MATH 20D,A01,083765,Tran; Brian Kha,5,0,30,25
1658068615087,MATH 20D,A02,083766,Tran; Brian Kha,5,0,30,25
1658068615087,MATH 20D,A03,083767,Tran; Brian Kha,6,0,30,24
1658068621115,MATH 20E,A01,083771,Ganguly; Soumya,12,0,32,20
1658068621115,MATH 20E,A02,083772,Ganguly; Soumya,7,0,32,25
1658068621115,MATH 20E,B01,083773,Ciotti; Benjamin,20,0,35,15
1658068621115,MATH 20E,B02,083774,Ciotti; Benjamin,18,0,35,17
1658068627146,MATH 103A,A01,083777,Greenfeld; Be'Eri,6,0,36,30
1658068627146,MATH 103A,A02,083778,Greenfeld; Be'Eri,5,0,36,31
1658068627146,MATH 103A,A03,093561,Greenfeld; Be'Eri,7,0,36,29
1658068627146,MATH 103A,B01,083779,Greenfeld; Be'Eri,8,0,36,28
1658068627146,MATH 103A,B02,083780,Greenfeld; Be'Eri,4,0,36,32
1658068627146,MATH 103A,B03,093562,Greenfeld; Be'Eri,3,0,36,33
1658068633171,MATH 105,A01,085443,Carter; Anne Toulson,15,0,35,20
1658068633171,MATH 105,A02,093477,Carter; Anne Toulson,20,0,35,15
1658068639200,MATH 109,A01,083213,Ganzberger; Geoffrey Michael,3,0,34,31
1658068639200,MATH 109,A02,083214,Ganzberger; Geoffrey Michael,4,0,34,30
1658068639200,MATH 109,A03,093478,Ganzberger; Geoffrey Michael,2,0,34,32
1658068639200,MATH 109,B01,083215,Ganzberger; Geoffrey Michael,3,0,32,29
1658068639200,MATH 109,B02,083216,Ganzberger; Geoffrey Michael,3,0,32,29
1658068639200,MATH 109,B03,093479,Ganzberger; Geoffrey Michael,8,0,32,24
1658068645230,MATH 142A,A01,083219,Chow; Bennett,7,0,32,25
1658068645230,MATH 142A,A02,083220,Chow; Bennett,10,0,32,22
1658068645230,MATH 142A,A03,093480,Chow; Bennett,9,0,32,23
1658068645230,MATH 142A,B03,093481,Chow; Bennett,8,0,32,24
1658068645230,MATH 142A,B04,093558,Chow; Bennett,14,0,32,18
1658068645230,MATH 142A,B05,093559,Chow; Bennett,7,0,32,25
1658068651260,MATH 193A,A01,083224,Rotar; Vladimir,9,0,34,25
1658068651260,MATH 193A,A02,083225,Rotar; Vladimir,11,0,34,23
1658068651260,MATH 193A,A03,083781,Rotar; Vladimir,5,0,34,29
1658068651260,MATH 193A,A04,083782,Rotar; Vladimir,12,0,34,22
1658068651260,MATH 193A,A05,093482,Rotar; Vladimir,11,0,34,23
1658068657285,MATH 197,001,091859,McAuley; Julian John,9999,0,9999,0
1658068657285,MATH 197,002,095566,Kedlaya; Kiran S.,9997,0,9999,2
1658068657285,MATH 197,003,095567,Xiao; Ming,9999,0,9999,0
1658068657285,MATH 197,004,095571,Perols; Johan Lars,9998,0,9999,1
1658068664344,COGS 9,A01,083615,Shannon; Kyle Michael,11,0,75,64
1658068670372,COGS 11,A01,083617,Boyle; Mary E. T.,23,0,48,25
1658068676396,COGS 13,A01,083071,Bastos; Amalia Pinkusfeld,12,0,71,59
1658068682421,COGS 14A,A01,092681,Semenuks; Arturs,5,1,100,95
1658068688444,COGS 14B,A01,083073,Cheng; Tzu-Han,7,0,63,56
1658068694472,COGS 17,A01,092677,Semenuks; Arturs,7,0,81,74
1658068700496,COGS 100,A01,083619,Allen; Michael Gordon,17,0,70,53
1658068706520,COGS 101A,A01,083621,Davis; Joshua Daniel,9,0,68,59
1658068712547,COGS 101B,A01,091572,Allen; Michael Gordon,14,0,65,51
1658068718580,COGS 101C,A01,083625,Delgado; Tania,17,0,35,18
1658068724606,COGS 107A,A01,083627,Boyle; Mary E. T.,14,0,60,46
1658068730634,COGS 118A,A01,083075,Gupta; Anjum,21,0,76,55
1658068736676,CSE 3,A50,083646,Miranda; Gregory Joseph,24,0,50,26
1658068742705,CSE 8A,A50,083650,Miranda; Gregory Joseph,17,1,56,39
1658068748731,CSE 11,A01,083080,Cao; Yingjun,7,15,40,33
1658068754756,CSE 12,A01,083652,Krause-Levy; Sophia Louisa,30,1,120,90
1658068760781,CSE 15L,A01,083654,Morris; Justin Loren,9,0,50,41
1658068760781,CSE 15L,A02,083655,Morris; Justin Loren,11,0,50,39
1658068766805,CSE 20,A01,083657,Tran; Khoa Dang,39,0,80,41
1658068772831,CSE 21,A01,095574,Bach; Quang Tran,23,0,48,25
1658068778855,CSE 30,A01,083084,Eldon; John,8,0,80,72
1658068778855,CSE 30,B01,095061,Bhaskar; Nishant,9,0,50,41
1658068784884,CSE 100,A01,083659,Cao; Yingjun,5,4,70,65
1658068790912,CSE 134B,A01,083661,Powell; Thomas Allan,25,0,100,75
1658068796938,CSE 140,A01,083663,Gungor; Onat,17,0,85,68
1658068802967,CSE 140L,A01,083088,Eldon; John,23,0,100,77
1658068808991,CSE 175,A01,083665,Kumar; Rakesh,3,0,25,22
1658068815018,CSE 190,A00,092507,Dubnov; Shlomo,8,0,20,12
1658068821043,ECE 45,A01,083139,Congero; Spencer William,7,0,75,68
1658068827073,ECE 65,A50,083695,Saad; Andrew S,12,0,30,18
1658068827073,ECE 65,A51,095125,Saad; Andrew S,24,0,26,2
1658068833101,ECE 109,A01,091882,Touri; Behrouz,21,0,70,49
1658068839127,ECE 180,A00,083140,Abi Samra; Nicholas Camill,1,0,30,29
1658068839127,ECE 180,B00,083141,Abi Samra; Nicholas Camill,0,0,30,30
1658068845155,MATH 10A,A01,083735,Patchell; Gregory David,2,0,30,28
1658068845155,MATH 10A,A02,083736,Patchell; Gregory David,20,0,30,10
1658068845155,MATH 10A,A03,083737,Patchell; Gregory David,16,0,30,14
1658068851183,MATH 10B,A01,083207,Lim; Seonhee,9,0,34,25
1658068851183,MATH 10B,A02,083208,Lim; Seonhee,10,0,35,25
1658068851183,MATH 10B,A03,093472,Lim; Seonhee,7,0,34,27
1658068851183,MATH 10B,B01,083739,Sinha; Shubham,14,0,30,16
1658068857213,MATH 18,A01,083743,Cinel; Cameron Alexander,9,0,30,21
1658068857213,MATH 18,A02,083744,Cinel; Cameron Alexander,18,0,30,12
1658068857213,MATH 18,A03,083745,Cinel; Cameron Alexander,10,0,30,20
1658068857213,MATH 18,B01,083748,Rideout; David Porter,5,0,37,32
1658068857213,MATH 18,B02,083749,Rideout; David Porter,5,0,36,31
1658068857213,MATH 18,B03,083750,Rideout; David Porter,3,0,37,34
1658068857213,MATH 18,B04,083751,Rideout; David Porter,7,0,36,29
1658068857213,MATH 18,B05,093473,Rideout; David Porter,7,0,36,29
1658068857213,MATH 18,B06,093474,Rideout; David Porter,6,0,36,30
1658068863241,MATH 20A,A01,083754,Zheng; Zequn,14,0,40,26
1658068869263,MATH 20B,A01,083756,Briones; Jor-el Thomas Caparas,4,0,36,32
1658068869263,MATH 20B,A02,083757,Briones; Jor-el Thomas Caparas,1,0,36,35
1658068869263,MATH 20B,A03,093475,Briones; Jor-el Thomas Caparas,3,0,36,33
1658068875301,MATH 20C,A01,083760,Briones; Jor-el Thomas Caparas,1,0,35,34
1658068875301,MATH 20C,A02,083761,Briones; Jor-el Thomas Caparas,8,0,35,27
1658068875301,MATH 20C,A03,093476,Briones; Jor-el Thomas Caparas,0,1,36,36
1658068875301,MATH 20C,B01,083762,Bach; Quang Tran,1,0,30,29
1658068881327,MATH 20D,A01,083765,Tran; Brian Kha,5,0,30,25
1658068881327,MATH 20D,A02,083766,Tran; Brian Kha,5,0,30,25
1658068881327,MATH 20D,A03,083767,Tran; Brian Kha,6,0,30,24
1658068887356,MATH 20E,A01,083771,Ganguly; Soumya,12,0,32,20
1658068887356,MATH 20E,A02,083772,Ganguly; Soumya,7,0,32,25
1658068887356,MATH 20E,B01,083773,Ciotti; Benjamin,20,0,35,15
1658068887356,MATH 20E,B02,083774,Ciotti; Benjamin,18,0,35,17
1658068893390,MATH 103A,A01,083777,Greenfeld; Be'Eri,6,0,36,30
1658068893390,MATH 103A,A02,083778,Greenfeld; Be'Eri,5,0,36,31
1658068893390,MATH 103A,A03,093561,Greenfeld; Be'Eri,7,0,36,29
1658068893390,MATH 103A,B01,083779,Greenfeld; Be'Eri,8,0,36,28
1658068893390,MATH 103A,B02,083780,Greenfeld; Be'Eri,4,0,36,32
1658068893390,MATH 103A,B03,093562,Greenfeld; Be'Eri,3,0,36,33
1658068899416,MATH 105,A01,085443,Carter; Anne Toulson,15,0,35,20
1658068899416,MATH 105,A02,093477,Carter; Anne Toulson,20,0,35,15
1658068905441,MATH 109,A01,083213,Ganzberger; Geoffrey Michael,3,0,34,31
1658068905441,MATH 109,A02,083214,Ganzberger; Geoffrey Michael,4,0,34,30
1658068905441,MATH 109,A03,093478,Ganzberger; Geoffrey Michael,2,0,34,32
1658068905441,MATH 109,B01,083215,Ganzberger; Geoffrey Michael,3,0,32,29
1658068905441,MATH 109,B02,083216,Ganzberger; Geoffrey Michael,3,0,32,29
1658068905441,MATH 109,B03,093479,Ganzberger; Geoffrey Michael,8,0,32,24
1658068911464,MATH 142A,A01,083219,Chow; Bennett,7,0,32,25
1658068911464,MATH 142A,A02,083220,Chow; Bennett,10,0,32,22
1658068911464,MATH 142A,A03,093480,Chow; Bennett,9,0,32,23
1658068911464,MATH 142A,B03,093481,Chow; Bennett,8,0,32,24
1658068911464,MATH 142A,B04,093558,Chow; Bennett,14,0,32,18
1658068911464,MATH 142A,B05,093559,Chow; Bennett,7,0,32,25
1658068917495,MATH 193A,A01,083224,Rotar; Vladimir,9,0,34,25
1658068917495,MATH 193A,A02,083225,Rotar; Vladimir,11,0,34,23
1658068917495,MATH 193A,A03,083781,Rotar; Vladimir,5,0,34,29
1658068917495,MATH 193A,A04,083782,Rotar; Vladimir,12,0,34,22
1658068917495,MATH 193A,A05,093482,Rotar; Vladimir,11,0,34,23
1658068923518,MATH 197,001,091859,McAuley; Julian John,9999,0,9999,0
1658068923518,MATH 197,002,095566,Kedlaya; Kiran S.,9997,0,9999,2
1658068923518,MATH 197,003,095567,Xiao; Ming,9999,0,9999,0
1658068923518,MATH 197,004,095571,Perols; Johan Lars,9998,0,9999,1
1658068930574,COGS 9,A01,083615,Shannon; Kyle Michael,11,0,75,64
1658068936601,COGS 11,A01,083617,Boyle; Mary E. T.,23,0,48,25
1658068942639,COGS 13,A01,083071,Bastos; Amalia Pinkusfeld,12,0,71,59
1658068948667,COGS 14A,A01,092681,Semenuks; Arturs,5,1,100,95
1658068954691,COGS 14B,A01,083073,Cheng; Tzu-Han,7,0,63,56
1658068960715,COGS 17,A01,092677,Semenuks; Arturs,7,0,81,74
1658068966743,COGS 100,A01,083619,Allen; Michael Gordon,17,0,70,53
1658068972769,COGS 101A,A01,083621,Davis; Joshua Daniel,9,0,68,59
1658068978794,COGS 101B,A01,091572,Allen; Michael Gordon,14,0,65,51
1658068984817,COGS 101C,A01,083625,Delgado; Tania,17,0,35,18
1658068990839,COGS 107A,A01,083627,Boyle; Mary E. T.,14,0,60,46
1658068996862,COGS 118A,A01,083075,Gupta; Anjum,21,0,76,55
1658069002887,CSE 3,A50,083646,Miranda; Gregory Joseph,24,0,50,26
1658069008915,CSE 8A,A50,083650,Miranda; Gregory Joseph,17,1,56,39
1658069014939,CSE 11,A01,083080,Cao; Yingjun,7,15,40,33
1658069020963,CSE 12,A01,083652,Krause-Levy; Sophia Louisa,30,1,120,90
1658069026987,CSE 15L,A01,083654,Morris; Justin Loren,9,0,50,41
1658069026987,CSE 15L,A02,083655,Morris; Justin Loren,11,0,50,39
1658069033010,CSE 20,A01,083657,Tran; Khoa Dang,39,0,80,41
1658069039036,CSE 21,A01,095574,Bach; Quang Tran,23,0,48,25
1658069045065,CSE 30,A01,083084,Eldon; John,8,0,80,72
1658069045065,CSE 30,B01,095061,Bhaskar; Nishant,9,0,50,41
1658069051090,CSE 100,A01,083659,Cao; Yingjun,5,4,70,65
1658069057118,CSE 134B,A01,083661,Powell; Thomas Allan,25,0,100,75
1658069063142,CSE 140,A01,083663,Gungor; Onat,17,0,85,68
1658069069167,CSE 140L,A01,083088,Eldon; John,23,0,100,77
1658069075192,CSE 175,A01,083665,Kumar; Rakesh,3,0,25,22
1658069081216,CSE 190,A00,092507,Dubnov; Shlomo,8,0,20,12
1658069087245,ECE 45,A01,083139,Congero; Spencer William,7,0,75,68
1658069093268,ECE 65,A50,083695,Saad; Andrew S,12,0,30,18
1658069093268,ECE 65,A51,095125,Saad; Andrew S,24,0,26,2
1658069099296,ECE 109,A01,091882,Touri; Behrouz,21,0,70,49
1658069105322,ECE 180,A00,083140,Abi Samra; Nicholas Camill,1,0,30,29
1658069105322,ECE 180,B00,083141,Abi Samra; Nicholas Camill,0,0,30,30
1658069111349,MATH 10A,A01,083735,Patchell; Gregory David,2,0,30,28
1658069111349,MATH 10A,A02,083736,Patchell; Gregory David,20,0,30,10
1658069111349,MATH 10A,A03,083737,Patchell; Gregory David,16,0,30,14
1658069117375,MATH 10B,A01,083207,Lim; Seonhee,9,0,34,25
1658069117375,MATH 10B,A02,083208,Lim; Seonhee,10,0,35,25
1658069117375,MATH 10B,A03,093472,Lim; Seonhee,7,0,34,27
1658069117375,MATH 10B,B01,083739,Sinha; Shubham,14,0,30,16
1658069123407,MATH 18,A01,083743,Cinel; Cameron Alexander,9,0,30,21
1658069123407,MATH 18,A02,083744,Cinel; Cameron Alexander,18,0,30,12
1658069123407,MATH 18,A03,083745,Cinel; Cameron Alexander,10,0,30,20
1658069123407,MATH 18,B01,083748,Rideout; David Porter,5,0,37,32
1658069123407,MATH 18,B02,083749,Rideout; David Porter,5,0,36,31
1658069123407,MATH 18,B03,083750,Rideout; David Porter,3,0,37,34
1658069123407,MATH 18,B04,083751,Rideout; David Porter,7,0,36,29
1658069123407,MATH 18,B05,093473,Rideout; David Porter,7,0,36,29
1658069123407,MATH 18,B06,093474,Rideout; David Porter,6,0,36,30
1658069129433,MATH 20A,A01,083754,Zheng; Zequn,14,0,40,26
1658069135462,MATH 20B,A01,083756,Briones; Jor-el Thomas Caparas,4,0,36,32
1658069135462,MATH 20B,A02,083757,Briones; Jor-el Thomas Caparas,1,0,36,35
1658069135462,MATH 20B,A03,093475,Briones; Jor-el Thomas Caparas,3,0,36,33
1658069141489,MATH 20C,A01,083760,Briones; Jor-el Thomas Caparas,1,0,35,34
1658069141489,MATH 20C,A02,083761,Briones; Jor-el Thomas Caparas,8,0,35,27
1658069141489,MATH 20C,A03,093476,Briones; Jor-el Thomas Caparas,0,1,36,36
1658069141489,MATH 20C,B01,083762,Bach; Quang Tran,1,0,30,29
1658069147591,MATH 20D,A01,083765,Tran; Brian Kha,5,0,30,25
1658069147591,MATH 20D,A02,083766,Tran; Brian Kha,5,0,30,25
1658069147591,MATH 20D,A03,083767,Tran; Brian Kha,6,0,30,24
1658069153615,MATH 20E,A01,083771,Ganguly; Soumya,12,0,32,20
1658069153615,MATH 20E,A02,083772,Ganguly; Soumya,7,0,32,25
1658069153615,MATH 20E,B01,083773,Ciotti; Benjamin,20,0,35,15
1658069153615,MATH 20E,B02,083774,Ciotti; Benjamin,18,0,35,17
1658069159646,MATH 103A,A01,083777,Greenfeld; Be'Eri,6,0,36,30
1658069159646,MATH 103A,A02,083778,Greenfeld; Be'Eri,5,0,36,31
1658069159646,MATH 103A,A03,093561,Greenfeld; Be'Eri,7,0,36,29
1658069159646,MATH 103A,B01,083779,Greenfeld; Be'Eri,8,0,36,28
1658069159646,MATH 103A,B02,083780,Greenfeld; Be'Eri,4,0,36,32
1658069159646,MATH 103A,B03,093562,Greenfeld; Be'Eri,3,0,36,33
1658069165674,MATH 105,A01,085443,Carter; Anne Toulson,15,0,35,20
1658069165674,MATH 105,A02,093477,Carter; Anne Toulson,20,0,35,15
1658069171700,MATH 109,A01,083213,Ganzberger; Geoffrey Michael,3,0,34,31
1658069171700,MATH 109,A02,083214,Ganzberger; Geoffrey Michael,4,0,34,30
1658069171700,MATH 109,A03,093478,Ganzberger; Geoffrey Michael,2,0,34,32
1658069171700,MATH 109,B01,083215,Ganzberger; Geoffrey Michael,3,0,32,29
1658069171700,MATH 109,B02,083216,Ganzberger; Geoffrey Michael,3,0,32,29
1658069171700,MATH 109,B03,093479,Ganzberger; Geoffrey Michael,8,0,32,24
1658069177724,MATH 142A,A01,083219,Chow; Bennett,7,0,32,25
1658069177724,MATH 142A,A02,083220,Chow; Bennett,10,0,32,22
1658069177724,MATH 142A,A03,093480,Chow; Bennett,9,0,32,23
1658069177724,MATH 142A,B03,093481,Chow; Bennett,8,0,32,24
1658069177724,MATH 142A,B04,093558,Chow; Bennett,14,0,32,18
1658069177724,MATH 142A,B05,093559,Chow; Bennett,7,0,32,25
1658069183750,MATH 193A,A01,083224,Rotar; Vladimir,9,0,34,25
1658069183750,MATH 193A,A02,083225,Rotar; Vladimir,11,0,34,23
1658069183750,MATH 193A,A03,083781,Rotar; Vladimir,5,0,34,29
1658069183750,MATH 193A,A04,083782,Rotar; Vladimir,12,0,34,22
1658069183750,MATH 193A,A05,093482,Rotar; Vladimir,11,0,34,23
1658069189778,MATH 197,001,091859,McAuley; Julian John,9999,0,9999,0
1658069189778,MATH 197,002,095566,Kedlaya; Kiran S.,9997,0,9999,2
1658069189778,MATH 197,003,095567,Xiao; Ming,9999,0,9999,0
1658069189778,MATH 197,004,095571,Perols; Johan Lars,9998,0,9999,1
1658069196834,COGS 9,A01,083615,Shannon; Kyle Michael,11,0,75,64
1658069202861,COGS 11,A01,083617,Boyle; Mary E. T.,23,0,48,25
1658069208887,COGS 13,A01,083071,Bastos; Amalia Pinkusfeld,12,0,71,59
1658069214911,COGS 14A,A01,092681,Semenuks; Arturs,5,1,100,95
1658069220936,COGS 14B,A01,083073,Cheng; Tzu-Han,7,0,63,56
1658069226960,COGS 17,A01,092677,Semenuks; Arturs,7,0,81,74
1658069232984,COGS 100,A01,083619,Allen; Michael Gordon,17,0,70,53
1658069239013,COGS 101A,A01,083621,Davis; Joshua Daniel,9,0,68,59
1658069245041,COGS 101B,A01,091572,Allen; Michael Gordon,14,0,65,51
1658069251067,COGS 101C,A01,083625,Delgado; Tania,17,0,35,18
1658069257092,COGS 107A,A01,083627,Boyle; Mary E. T.,14,0,60,46
1658069263116,COGS 118A,A01,083075,Gupta; Anjum,21,0,76,55
1658069269141,CSE 3,A50,083646,Miranda; Gregory Joseph,24,0,50,26
1658069275169,CSE 8A,A50,083650,Miranda; Gregory Joseph,17,1,56,39
1658069281194,CSE 11,A01,083080,Cao; Yingjun,7,15,40,33
1658069287220,CSE 12,A01,083652,Krause-Levy; Sophia Louisa,30,1,120,90
1658069293255,CSE 15L,A01,083654,Morris; Justin Loren,9,0,50,41
1658069293255,CSE 15L,A02,083655,Morris; Justin Loren,11,0,50,39
1658069299280,CSE 20,A01,083657,Tran; Khoa Dang,39,0,80,41
1658069305347,CSE 21,A01,095574,Bach; Quang Tran,23,0,48,25
1658069311372,CSE 30,A01,083084,Eldon; John,8,0,80,72
1658069311372,CSE 30,B01,095061,Bhaskar; Nishant,9,0,50,41
1658069317399,CSE 100,A01,083659,Cao; Yingjun,5,4,70,65
1658069323423,CSE 134B,A01,083661,Powell; Thomas Allan,25,0,100,75
1658069329451,CSE 140,A01,083663,Gungor; Onat,17,0,85,68
1658069335475,CSE 140L,A01,083088,Eldon; John,23,0,100,77
1658069341502,CSE 175,A01,083665,Kumar; Rakesh,3,0,25,22
1658069347526,CSE 190,A00,092507,Dubnov; Shlomo,8,0,20,12
1658069353554,ECE 45,A01,083139,Congero; Spencer William,7,0,75,68
1658069359583,ECE 65,A50,083695,Saad; Andrew S,12,0,30,18
1658069359583,ECE 65,A51,095125,Saad; Andrew S,24,0,26,2
1658069365611,ECE 109,A01,091882,Touri; Behrouz,21,0,70,49
1658069371636,ECE 180,A00,083140,Abi Samra; Nicholas Camill,1,0,30,29
1658069371636,ECE 180,B00,083141,Abi Samra; Nicholas Camill,0,0,30,30
1658069377680,MATH 10A,A01,083735,Patchell; Gregory David,2,0,30,28
1658069377680,MATH 10A,A02,083736,Patchell; Gregory David,20,0,30,10
1658069377680,MATH 10A,A03,083737,Patchell; Gregory David,16,0,30,14
1658069383706,MATH 10B,A01,083207,Lim; Seonhee,9,0,34,25
1658069383706,MATH 10B,A02,083208,Lim; Seonhee,10,0,35,25
1658069383706,MATH 10B,A03,093472,Lim; Seonhee,7,0,34,27
1658069383706,MATH 10B,B01,083739,Sinha; Shubham,14,0,30,16
1658069389738,MATH 18,A01,083743,Cinel; Cameron Alexander,9,0,30,21
1658069389738,MATH 18,A02,083744,Cinel; Cameron Alexander,18,0,30,12
1658069389738,MATH 18,A03,083745,Cinel; Cameron Alexander,10,0,30,20
1658069389738,MATH 18,B01,083748,Rideout; David Porter,5,0,37,32
1658069389738,MATH 18,B02,083749,Rideout; David Porter,5,0,36,31
1658069389738,MATH 18,B03,083750,Rideout; David Porter,3,0,37,34
1658069389738,MATH 18,B04,083751,Rideout; David Porter,7,0,36,29
1658069389738,MATH 18,B05,093473,Rideout; David Porter,7,0,36,29
1658069389738,MATH 18,B06,093474,Rideout; David Porter,6,0,36,30
1658069395762,MATH 20A,A01,083754,Zheng; Zequn,14,0,40,26
1658069401786,MATH 20B,A01,083756,Briones; Jor-el Thomas Caparas,4,0,36,32
1658069401786,MATH 20B,A02,083757,Briones; Jor-el Thomas Caparas,1,0,36,35
1658069401786,MATH 20B,A03,093475,Briones; Jor-el Thomas Caparas,3,0,36,33
1658069407820,MATH 20C,A01,083760,Briones; Jor-el Thomas Caparas,1,0,35,34
1658069407820,MATH 20C,A02,083761,Briones; Jor-el Thomas Caparas,8,0,35,27
1658069407820,MATH 20C,A03,093476,Briones; Jor-el Thomas Caparas,0,1,36,36
1658069407820,MATH 20C,B01,083762,Bach; Quang Tran,1,0,30,29
1658069413848,MATH 20D,A01,083765,Tran; Brian Kha,5,0,30,25
1658069413848,MATH 20D,A02,083766,Tran; Brian Kha,5,0,30,25
1658069413848,MATH 20D,A03,083767,Tran; Brian Kha,6,0,30,24
1658069419876,MATH 20E,A01,083771,Ganguly; Soumya,12,0,32,20
1658069419876,MATH 20E,A02,083772,Ganguly; Soumya,7,0,32,25
1658069419876,MATH 20E,B01,083773,Ciotti; Benjamin,20,0,35,15
1658069419876,MATH 20E,B02,083774,Ciotti; Benjamin,18,0,35,17
1658069425914,MATH 103A,A01,083777,Greenfeld; Be'Eri,6,0,36,30
1658069425914,MATH 103A,A02,083778,Greenfeld; Be'Eri,5,0,36,31
1658069425914,MATH 103A,A03,093561,Greenfeld; Be'Eri,7,0,36,29
1658069425914,MATH 103A,B01,083779,Greenfeld; Be'Eri,8,0,36,28
1658069425914,MATH 103A,B02,083780,Greenfeld; Be'Eri,4,0,36,32
1658069425914,MATH 103A,B03,093562,Greenfeld; Be'Eri,3,0,36,33
1658069431937,MATH 105,A01,085443,Carter; Anne Toulson,15,0,35,20
1658069431937,MATH 105,A02,093477,Carter; Anne Toulson,20,0,35,15
1658069437966,MATH 109,A01,083213,Ganzberger; Geoffrey Michael,3,0,34,31
1658069437966,MATH 109,A02,083214,Ganzberger; Geoffrey Michael,4,0,34,30
1658069437966,MATH 109,A03,093478,Ganzberger; Geoffrey Michael,2,0,34,32
1658069437966,MATH 109,B01,083215,Ganzberger; Geoffrey Michael,3,0,32,29
1658069437966,MATH 109,B02,083216,Ganzberger; Geoffrey Michael,3,0,32,29
1658069437966,MATH 109,B03,093479,Ganzberger; Geoffrey Michael,8,0,32,24
1658069443990,MATH 142A,A01,083219,Chow; Bennett,7,0,32,25
1658069443990,MATH 142A,A02,083220,Chow; Bennett,10,0,32,22
1658069443990,MATH 142A,A03,093480,Chow; Bennett,9,0,32,23
1658069443990,MATH 142A,B03,093481,Chow; Bennett,8,0,32,24
1658069443990,MATH 142A,B04,093558,Chow; Bennett,14,0,32,18
1658069443990,MATH 142A,B05,093559,Chow; Bennett,7,0,32,25
1658069450015,MATH 193A,A01,083224,Rotar; Vladimir,9,0,34,25
1658069450015,MATH 193A,A02,083225,Rotar; Vladimir,11,0,34,23
1658069450015,MATH 193A,A03,083781,Rotar; Vladimir,5,0,34,29
1658069450015,MATH 193A,A04,083782,Rotar; Vladimir,12,0,34,22
1658069450015,MATH 193A,A05,093482,Rotar; Vladimir,11,0,34,23
1658069456040,MATH 197,001,091859,McAuley; Julian John,9999,0,9999,0
1658069456040,MATH 197,002,095566,Kedlaya; Kiran S.,9997,0,9999,2
1658069456040,MATH 197,003,095567,Xiao; Ming,9999,0,9999,0
1658069456040,MATH 197,004,095571,Perols; Johan Lars,9998,0,9999,1
1658069463099,COGS 9,A01,083615,Shannon; Kyle Michael,11,0,75,64
1658069469122,COGS 11,A01,083617,Boyle; Mary E. T.,23,0,48,25
1658069475148,COGS 13,A01,083071,Bastos; Amalia Pinkusfeld,12,0,71,59
1658069481175,COGS 14A,A01,092681,Semenuks; Arturs,5,1,100,95
1658069487200,COGS 14B,A01,083073,Cheng; Tzu-Han,7,0,63,56
1658069493229,COGS 17,A01,092677,Semenuks; Arturs,7,0,81,74
1658069499253,COGS 100,A01,083619,Allen; Michael Gordon,17,0,70,53
1658069505280,COGS 101A,A01,083621,Davis; Joshua Daniel,9,0,68,59
1658069511302,COGS 101B,A01,091572,Allen; Michael Gordon,14,0,65,51
1658069517330,COGS 101C,A01,083625,Delgado; Tania,17,0,35,18
1658069523354,COGS 107A,A01,083627,Boyle; Mary E. T.,14,0,60,46
1658069529378,COGS 118A,A01,083075,Gupta; Anjum,21,0,76,55
1658069535406,CSE 3,A50,083646,Miranda; Gregory Joseph,24,0,50,26
1658069541428,CSE 8A,A50,083650,Miranda; Gregory Joseph,17,1,56,39
1658069547456,CSE 11,A01,083080,Cao; Yingjun,7,15,40,33
1658069553480,CSE 12,A01,083652,Krause-Levy; Sophia Louisa,30,1,120,90
1658069559505,CSE 15L,A01,083654,Morris; Justin Loren,9,0,50,41
1658069559505,CSE 15L,A02,083655,Morris; Justin Loren,11,0,50,39
1658069565533,CSE 20,A01,083657,Tran; Khoa Dang,39,0,80,41
1658069571564,CSE 21,A01,095574,Bach; Quang Tran,23,0,48,25
1658069577588,CSE 30,A01,083084,Eldon; John,8,0,80,72
1658069577588,CSE 30,B01,095061,Bhaskar; Nishant,9,0,50,41
1658069583616,CSE 100,A01,083659,Cao; Yingjun,5,4,70,65
1658069589643,CSE 134B,A01,083661,Powell; Thomas Allan,25,0,100,75
1658069595667,CSE 140,A01,083663,Gungor; Onat,17,0,85,68
1658069601694,CSE 140L,A01,083088,Eldon; John,23,0,100,77
1658069607722,CSE 175,A01,083665,Kumar; Rakesh,3,0,25,22
1658069613747,CSE 190,A00,092507,Dubnov; Shlomo,8,0,20,12
1658069619775,ECE 45,A01,083139,Congero; Spencer William,7,0,75,68
1658069625803,ECE 65,A50,083695,Saad; Andrew S,12,0,30,18
1658069625803,ECE 65,A51,095125,Saad; Andrew S,24,0,26,2
1658069631826,ECE 109,A01,091882,Touri; Behrouz,21,0,70,49
1658069637854,ECE 180,A00,083140,Abi Samra; Nicholas Camill,1,0,30,29
1658069637854,ECE 180,B00,083141,Abi Samra; Nicholas Camill,0,0,30,30
1658069643879,MATH 10A,A01,083735,Patchell; Gregory David,2,0,30,28
1658069643879,MATH 10A,A02,083736,Patchell; Gregory David,20,0,30,10
1658069643879,MATH 10A,A03,083737,Patchell; Gregory David,16,0,30,14
1658069649909,MATH 10B,A01,083207,Lim; Seonhee,9,0,34,25
1658069649909,MATH 10B,A02,083208,Lim; Seonhee,10,0,35,25
1658069649909,MATH 10B,A03,093472,Lim; Seonhee,7,0,34,27
1658069649909,MATH 10B,B01,083739,Sinha; Shubham,14,0,30,16
1658069655936,MATH 18,A01,083743,Cinel; Cameron Alexander,9,0,30,21
1658069655936,MATH 18,A02,083744,Cinel; Cameron Alexander,18,0,30,12
1658069655936,MATH 18,A03,083745,Cinel; Cameron Alexander,10,0,30,20
1658069655936,MATH 18,B01,083748,Rideout; David Porter,5,0,37,32
1658069655936,MATH 18,B02,083749,Rideout; David Porter,5,0,36,31
1658069655936,MATH 18,B03,083750,Rideout; David Porter,3,0,37,34
1658069655936,MATH 18,B04,083751,Rideout; David Porter,7,0,36,29
1658069655936,MATH 18,B05,093473,Rideout; David Porter,7,0,36,29
1658069655936,MATH 18,B06,093474,Rideout; David Porter,6,0,36,30
1658069661960,MATH 20A,A01,083754,Zheng; Zequn,14,0,40,26
1658069667985,MATH 20B,A01,083756,Briones; Jor-el Thomas Caparas,4,0,36,32
1658069667985,MATH 20B,A02,083757,Briones; Jor-el Thomas Caparas,1,0,36,35
1658069667985,MATH 20B,A03,093475,Briones; Jor-el Thomas Caparas,3,0,36,33
1658069674012,MATH 20C,A01,083760,Briones; Jor-el Thomas Caparas,1,0,35,34
1658069674012,MATH 20C,A02,083761,Briones; Jor-el Thomas Caparas,8,0,35,27
1658069674012,MATH 20C,A03,093476,Briones; Jor-el Thomas Caparas,0,1,36,36
1658069674012,MATH 20C,B01,083762,Bach; Quang Tran,1,0,30,29
1658069680045,MATH 20D,A01,083765,Tran; Brian Kha,5,0,30,25
1658069680045,MATH 20D,A02,083766,Tran; Brian Kha,5,0,30,25
1658069680045,MATH 20D,A03,083767,Tran; Brian Kha,6,0,30,24
1658069686069,MATH 20E,A01,083771,Ganguly; Soumya,12,0,32,20
1658069686069,MATH 20E,A02,083772,Ganguly; Soumya,7,0,32,25
1658069686069,MATH 20E,B01,083773,Ciotti; Benjamin,20,0,35,15
1658069686069,MATH 20E,B02,083774,Ciotti; Benjamin,18,0,35,17
1658069692096,MATH 103A,A01,083777,Greenfeld; Be'Eri,6,0,36,30
1658069692096,MATH 103A,A02,083778,Greenfeld; Be'Eri,5,0,36,31
1658069692096,MATH 103A,A03,093561,Greenfeld; Be'Eri,7,0,36,29
1658069692096,MATH 103A,B01,083779,Greenfeld; Be'Eri,8,0,36,28
1658069692096,MATH 103A,B02,083780,Greenfeld; Be'Eri,4,0,36,32
1658069692096,MATH 103A,B03,093562,Greenfeld; Be'Eri,3,0,36,33
1658069698124,MATH 105,A01,085443,Carter; Anne Toulson,15,0,35,20
1658069698124,MATH 105,A02,093477,Carter; Anne Toulson,20,0,35,15
1658069704154,MATH 109,A01,083213,Ganzberger; Geoffrey Michael,3,0,34,31
1658069704154,MATH 109,A02,083214,Ganzberger; Geoffrey Michael,4,0,34,30
1658069704154,MATH 109,A03,093478,Ganzberger; Geoffrey Michael,2,0,34,32
1658069704154,MATH 109,B01,083215,Ganzberger; Geoffrey Michael,3,0,32,29
1658069704154,MATH 109,B02,083216,Ganzberger; Geoffrey Michael,3,0,32,29
1658069704154,MATH 109,B03,093479,Ganzberger; Geoffrey Michael,8,0,32,24
1658069710184,MATH 142A,A01,083219,Chow; Bennett,7,0,32,25
1658069710184,MATH 142A,A02,083220,Chow; Bennett,10,0,32,22
1658069710184,MATH 142A,A03,093480,Chow; Bennett,9,0,32,23
1658069710184,MATH 142A,B03,093481,Chow; Bennett,8,0,32,24
1658069710184,MATH 142A,B04,093558,Chow; Bennett,14,0,32,18
1658069710184,MATH 142A,B05,093559,Chow; Bennett,7,0,32,25
1658069716208,MATH 193A,A01,083224,Rotar; Vladimir,9,0,34,25
1658069716208,MATH 193A,A02,083225,Rotar; Vladimir,11,0,34,23
1658069716208,MATH 193A,A03,083781,Rotar; Vladimir,5,0,34,29
1658069716208,MATH 193A,A04,083782,Rotar; Vladimir,12,0,34,22
1658069716208,MATH 193A,A05,093482,Rotar; Vladimir,11,0,34,23
1658069722237,MATH 197,001,091859,McAuley; Julian John,9999,0,9999,0
1658069722237,MATH 197,002,095566,Kedlaya; Kiran S.,9997,0,9999,2
1658069722237,MATH 197,003,095567,Xiao; Ming,9999,0,9999,0
1658069722237,MATH 197,004,095571,Perols; Johan Lars,9998,0,9999,1
1658069729298,COGS 9,A01,083615,Shannon; Kyle Michael,11,0,75,64
1658069735325,COGS 11,A01,083617,Boyle; Mary E. T.,23,0,48,25
1658069741435,COGS 13,A01,083071,Bastos; Amalia Pinkusfeld,12,0,71,59
1658069747459,COGS 14A,A01,092681,Semenuks; Arturs,5,1,100,95
1658069753482,COGS 14B,A01,083073,Cheng; Tzu-Han,7,0,63,56
1658069759511,COGS 17,A01,092677,Semenuks; Arturs,7,0,81,74
1658069765534,COGS 100,A01,083619,Allen; Michael Gordon,17,0,70,53
1658069771558,COGS 101A,A01,083621,Davis; Joshua Daniel,9,0,68,59
1658069777583,COGS 101B,A01,091572,Allen; Michael Gordon,14,0,65,51
1658069783608,COGS 101C,A01,083625,Delgado; Tania,17,0,35,18
1658069789632,COGS 107A,A01,083627,Boyle; Mary E. T.,14,0,60,46
1658069795660,COGS 118A,A01,083075,Gupta; Anjum,21,0,76,55
1658069801688,CSE 3,A50,083646,Miranda; Gregory Joseph,24,0,50,26
1658069807715,CSE 8A,A50,083650,Miranda; Gregory Joseph,17,1,56,39
1658069813743,CSE 11,A01,083080,Cao; Yingjun,7,15,40,33
1658069819777,CSE 12,A01,083652,Krause-Levy; Sophia Louisa,30,1,120,90
1658069825803,CSE 15L,A01,083654,Morris; Justin Loren,9,0,50,41
1658069825803,CSE 15L,A02,083655,Morris; Justin Loren,11,0,50,39
1658069831829,CSE 20,A01,083657,Tran; Khoa Dang,39,0,80,41
1658069837854,CSE 21,A01,095574,Bach; Quang Tran,23,0,48,25
1658069843882,CSE 30,A01,083084,Eldon; John,8,0,80,72
1658069843882,CSE 30,B01,095061,Bhaskar; Nishant,9,0,50,41
1658069849917,CSE 100,A01,083659,Cao; Yingjun,5,4,70,65
1658069855970,CSE 134B,A01,083661,Powell; Thomas Allan,25,0,100,75
1658069861999,CSE 140,A01,083663,Gungor; Onat,17,0,85,68
1658069868028,CSE 140L,A01,083088,Eldon; John,23,0,100,77
1658069874054,CSE 175,A01,083665,Kumar; Rakesh,3,0,25,22
1658069880079,CSE 190,A00,092507,Dubnov; Shlomo,8,0,20,12
1658069886104,ECE 45,A01,083139,Congero; Spencer William,7,0,75,68
1658069892129,ECE 65,A50,083695,Saad; Andrew S,12,0,30,18
1658069892129,ECE 65,A51,095125,Saad; Andrew S,24,0,26,2
1658069898154,ECE 109,A01,091882,Touri; Behrouz,21,0,70,49
1658069904178,ECE 180,A00,083140,Abi Samra; Nicholas Camill,1,0,30,29
1658069904178,ECE 180,B00,083141,Abi Samra; Nicholas Camill,0,0,30,30
1658069910208,MATH 10A,A01,083735,Patchell; Gregory David,2,0,30,28
1658069910208,MATH 10A,A02,083736,Patchell; Gregory David,20,0,30,10
1658069910208,MATH 10A,A03,083737,Patchell; Gregory David,16,0,30,14
1658069916233,MATH 10B,A01,083207,Lim; Seonhee,9,0,34,25
1658069916233,MATH 10B,A02,083208,Lim; Seonhee,10,0,35,25
1658069916233,MATH 10B,A03,093472,Lim; Seonhee,7,0,34,27
1658069916233,MATH 10B,B01,083739,Sinha; Shubham,14,0,30,16
1658069922266,MATH 18,A01,083743,Cinel; Cameron Alexander,9,0,30,21
1658069922266,MATH 18,A02,083744,Cinel; Cameron Alexander,18,0,30,12
1658069922266,MATH 18,A03,083745,Cinel; Cameron Alexander,10,0,30,20
1658069922266,MATH 18,B01,083748,Rideout; David Porter,5,0,37,32
1658069922266,MATH 18,B02,083749,Rideout; David Porter,5,0,36,31
1658069922266,MATH 18,B03,083750,Rideout; David Porter,3,0,37,34
1658069922266,MATH 18,B04,083751,Rideout; David Porter,7,0,36,29
1658069922266,MATH 18,B05,093473,Rideout; David Porter,7,0,36,29
1658069922266,MATH 18,B06,093474,Rideout; David Porter,6,0,36,30
1658069928291,MATH 20A,A01,083754,Zheng; Zequn,14,0,40,26
1658069934316,MATH 20B,A01,083756,Briones; Jor-el Thomas Caparas,4,0,36,32
1658069934316,MATH 20B,A02,083757,Briones; Jor-el Thomas Caparas,1,0,36,35
1658069934316,MATH 20B,A03,093475,Briones; Jor-el Thomas Caparas,3,0,36,33
1658069940350,MATH 20C,A01,083760,Briones; Jor-el Thomas Caparas,1,0,35,34
1658069940350,MATH 20C,A02,083761,Briones; Jor-el Thomas Caparas,8,0,35,27
1658069940350,MATH 20C,A03,093476,Briones; Jor-el Thomas Caparas,0,1,36,36
1658069940350,MATH 20C,B01,083762,Bach; Quang Tran,1,0,30,29
1658069946376,MATH 20D,A01,083765,Tran; Brian Kha,5,0,30,25
1658069946376,MATH 20D,A02,083766,Tran; Brian Kha,5,0,30,25
1658069946376,MATH 20D,A03,083767,Tran; Brian Kha,6,0,30,24
1658069952402,MATH 20E,A01,083771,Ganguly; Soumya,12,0,32,20
1658069952402,MATH 20E,A02,083772,Ganguly; Soumya,7,0,32,25
1658069952402,MATH 20E,B01,083773,Ciotti; Benjamin,20,0,35,15
1658069952402,MATH 20E,B02,083774,Ciotti; Benjamin,18,0,35,17
1658069958428,MATH 103A,A01,083777,Greenfeld; Be'Eri,6,0,36,30
1658069958428,MATH 103A,A02,083778,Greenfeld; Be'Eri,5,0,36,31
1658069958428,MATH 103A,A03,093561,Greenfeld; Be'Eri,7,0,36,29
1658069958428,MATH 103A,B01,083779,Greenfeld; Be'Eri,8,0,36,28
1658069958428,MATH 103A,B02,083780,Greenfeld; Be'Eri,4,0,36,32
1658069958428,MATH 103A,B03,093562,Greenfeld; Be'Eri,3,0,36,33
1658069964457,MATH 105,A01,085443,Carter; Anne Toulson,15,0,35,20
1658069964457,MATH 105,A02,093477,Carter; Anne Toulson,20,0,35,15
1658069970488,MATH 109,A01,083213,Ganzberger; Geoffrey Michael,3,0,34,31
1658069970488,MATH 109,A02,083214,Ganzberger; Geoffrey Michael,4,0,34,30
1658069970488,MATH 109,A03,093478,Ganzberger; Geoffrey Michael,2,0,34,32
1658069970488,MATH 109,B01,083215,Ganzberger; Geoffrey Michael,3,0,32,29
1658069970488,MATH 109,B02,083216,Ganzberger; Geoffrey Michael,3,0,32,29
1658069970488,MATH 109,B03,093479,Ganzberger; Geoffrey Michael,8,0,32,24
1658069976520,MATH 142A,A01,083219,Chow; Bennett,7,0,32,25
1658069976520,MATH 142A,A02,083220,Chow; Bennett,10,0,32,22
1658069976520,MATH 142A,A03,093480,Chow; Bennett,9,0,32,23
1658069976520,MATH 142A,B03,093481,Chow; Bennett,8,0,32,24
1658069976520,MATH 142A,B04,093558,Chow; Bennett,14,0,32,18
1658069976520,MATH 142A,B05,093559,Chow; Bennett,7,0,32,25
1658069982546,MATH 193A,A01,083224,Rotar; Vladimir,9,0,34,25
1658069982546,MATH 193A,A02,083225,Rotar; Vladimir,11,0,34,23
1658069982546,MATH 193A,A03,083781,Rotar; Vladimir,5,0,34,29
1658069982546,MATH 193A,A04,083782,Rotar; Vladimir,12,0,34,22
1658069982546,MATH 193A,A05,093482,Rotar; Vladimir,11,0,34,23
1658069988569,MATH 197,001,091859,McAuley; Julian John,9999,0,9999,0
1658069988569,MATH 197,002,095566,Kedlaya; Kiran S.,9997,0,9999,2
1658069988569,MATH 197,003,095567,Xiao; Ming,9999,0,9999,0
1658069988569,MATH 197,004,095571,Perols; Johan Lars,9998,0,9999,1
1658069995623,COGS 9,A01,083615,Shannon; Kyle Michael,11,0,75,64
1658070001650,COGS 11,A01,083617,Boyle; Mary E. T.,23,0,48,25
1658070007675,COGS 13,A01,083071,Bastos; Amalia Pinkusfeld,12,0,71,59
1658070013698,COGS 14A,A01,092681,Semenuks; Arturs,5,1,100,95
1658070019723,COGS 14B,A01,083073,Cheng; Tzu-Han,7,0,63,56
1658070025754,COGS 17,A01,092677,Semenuks; Arturs,7,0,81,74
1658070031777,COGS 100,A01,083619,Allen; Michael Gordon,17,0,70,53
1658070037806,COGS 101A,A01,083621,Davis; Joshua Daniel,9,0,68,59
1658070043835,COGS 101B,A01,091572,Allen; Michael Gordon,14,0,65,51
1658070049857,COGS 101C,A01,083625,Delgado; Tania,17,0,35,18
1658070055880,COGS 107A,A01,083627,Boyle; Mary E. T.,14,0,60,46
1658070061906,COGS 118A,A01,083075,Gupta; Anjum,21,0,76,55
1658070067936,CSE 3,A50,083646,Miranda; Gregory Joseph,24,0,50,26
1658070073958,CSE 8A,A50,083650,Miranda; Gregory Joseph,17,1,56,39
1658070079980,CSE 11,A01,083080,Cao; Yingjun,7,15,40,33
1658070086006,CSE 12,A01,083652,Krause-Levy; Sophia Louisa,30,1,120,90
1658070092030,CSE 15L,A01,083654,Morris; Justin Loren,9,0,50,41
1658070092030,CSE 15L,A02,083655,Morris; Justin Loren,11,0,50,39
1658070098056,CSE 20,A01,083657,Tran; Khoa Dang,39,0,80,41
1658070104078,CSE 21,A01,095574,Bach; Quang Tran,23,0,48,25
1658070110109,CSE 30,A01,083084,Eldon; John,8,0,80,72
1658070110109,CSE 30,B01,095061,Bhaskar; Nishant,9,0,50,41
1658070116132,CSE 100,A01,083659,Cao; Yingjun,5,4,70,65
1658070122165,CSE 134B,A01,083661,Powell; Thomas Allan,25,0,100,75
1658070128188,CSE 140,A01,083663,Gungor; Onat,17,0,85,68
1658070134213,CSE 140L,A01,083088,Eldon; John,23,0,100,77
1658070140236,CSE 175,A01,083665,Kumar; Rakesh,3,0,25,22
1658070146259,CSE 190,A00,092507,Dubnov; Shlomo,8,0,20,12
1658070152283,ECE 45,A01,083139,Congero; Spencer William,7,0,75,68
1658070158308,ECE 65,A50,083695,Saad; Andrew S,12,0,30,18
1658070158308,ECE 65,A51,095125,Saad; Andrew S,24,0,26,2
1658070164331,ECE 109,A01,091882,Touri; Behrouz,21,0,70,49
1658070170354,ECE 180,A00,083140,Abi Samra; Nicholas Camill,1,0,30,29
1658070170354,ECE 180,B00,083141,Abi Samra; Nicholas Camill,0,0,30,30
1658070176380,MATH 10A,A01,083735,Patchell; Gregory David,2,0,30,28
1658070176380,MATH 10A,A02,083736,Patchell; Gregory David,20,0,30,10
1658070176380,MATH 10A,A03,083737,Patchell; Gregory David,16,0,30,14
1658070182403,MATH 10B,A01,083207,Lim; Seonhee,9,0,34,25
1658070182403,MATH 10B,A02,083208,Lim; Seonhee,10,0,35,25
1658070182403,MATH 10B,A03,093472,Lim; Seonhee,7,0,34,27
1658070182403,MATH 10B,B01,083739,Sinha; Shubham,14,0,30,16
1658070188427,MATH 18,A01,083743,Cinel; Cameron Alexander,9,0,30,21
1658070188427,MATH 18,A02,083744,Cinel; Cameron Alexander,18,0,30,12
1658070188427,MATH 18,A03,083745,Cinel; Cameron Alexander,10,0,30,20
1658070188427,MATH 18,B01,083748,Rideout; David Porter,5,0,37,32
1658070188427,MATH 18,B02,083749,Rideout; David Porter,5,0,36,31
1658070188427,MATH 18,B03,083750,Rideout; David Porter,3,0,37,34
1658070188427,MATH 18,B04,083751,Rideout; David Porter,7,0,36,29
1658070188427,MATH 18,B05,093473,Rideout; David Porter,7,0,36,29
1658070188427,MATH 18,B06,093474,Rideout; David Porter,6,0,36,30
1658070194454,MATH 20A,A01,083754,Zheng; Zequn,14,0,40,26
1658070200477,MATH 20B,A01,083756,Briones; Jor-el Thomas Caparas,4,0,36,32
1658070200477,MATH 20B,A02,083757,Briones; Jor-el Thomas Caparas,1,0,36,35
1658070200477,MATH 20B,A03,093475,Briones; Jor-el Thomas Caparas,3,0,36,33
1658070206498,MATH 20C,A01,083760,Briones; Jor-el Thomas Caparas,1,0,35,34
1658070206498,MATH 20C,A02,083761,Briones; Jor-el Thomas Caparas,8,0,35,27
1658070206498,MATH 20C,A03,093476,Briones; Jor-el Thomas Caparas,0,1,36,36
1658070206498,MATH 20C,B01,083762,Bach; Quang Tran,1,0,30,29
1658070212522,MATH 20D,A01,083765,Tran; Brian Kha,5,0,30,25
1658070212522,MATH 20D,A02,083766,Tran; Brian Kha,5,0,30,25
1658070212522,MATH 20D,A03,083767,Tran; Brian Kha,6,0,30,24
1658070218545,MATH 20E,A01,083771,Ganguly; Soumya,12,0,32,20
1658070218545,MATH 20E,A02,083772,Ganguly; Soumya,7,0,32,25
1658070218545,MATH 20E,B01,083773,Ciotti; Benjamin,20,0,35,15
1658070218545,MATH 20E,B02,083774,Ciotti; Benjamin,18,0,35,17
1658070224567,MATH 103A,A01,083777,Greenfeld; Be'Eri,6,0,36,30
1658070224567,MATH 103A,A02,083778,Greenfeld; Be'Eri,5,0,36,31
1658070224567,MATH 103A,A03,093561,Greenfeld; Be'Eri,7,0,36,29
1658070224567,MATH 103A,B01,083779,Greenfeld; Be'Eri,8,0,36,28
1658070224567,MATH 103A,B02,083780,Greenfeld; Be'Eri,4,0,36,32
1658070224567,MATH 103A,B03,093562,Greenfeld; Be'Eri,3,0,36,33
1658070230591,MATH 105,A01,085443,Carter; Anne Toulson,15,0,35,20
1658070230591,MATH 105,A02,093477,Carter; Anne Toulson,20,0,35,15
1658070236613,MATH 109,A01,083213,Ganzberger; Geoffrey Michael,3,0,34,31
1658070236613,MATH 109,A02,083214,Ganzberger; Geoffrey Michael,4,0,34,30
1658070236613,MATH 109,A03,093478,Ganzberger; Geoffrey Michael,2,0,34,32
1658070236613,MATH 109,B01,083215,Ganzberger; Geoffrey Michael,3,0,32,29
1658070236613,MATH 109,B02,083216,Ganzberger; Geoffrey Michael,3,0,32,29
1658070236613,MATH 109,B03,093479,Ganzberger; Geoffrey Michael,8,0,32,24
1658070242636,MATH 142A,A01,083219,Chow; Bennett,7,0,32,25
1658070242636,MATH 142A,A02,083220,Chow; Bennett,10,0,32,22
1658070242636,MATH 142A,A03,093480,Chow; Bennett,9,0,32,23
1658070242636,MATH 142A,B03,093481,Chow; Bennett,8,0,32,24
1658070242636,MATH 142A,B04,093558,Chow; Bennett,14,0,32,18
1658070242636,MATH 142A,B05,093559,Chow; Bennett,7,0,32,25
1658070248660,MATH 193A,A01,083224,Rotar; Vladimir,9,0,34,25
1658070248660,MATH 193A,A02,083225,Rotar; Vladimir,11,0,34,23
1658070248660,MATH 193A,A03,083781,Rotar; Vladimir,5,0,34,29
1658070248660,MATH 193A,A04,083782,Rotar; Vladimir,12,0,34,22
1658070248660,MATH 193A,A05,093482,Rotar; Vladimir,11,0,34,23
1658070254692,MATH 197,001,091859,McAuley; Julian John,9999,0,9999,0
1658070254692,MATH 197,002,095566,Kedlaya; Kiran S.,9997,0,9999,2
1658070254692,MATH 197,003,095567,Xiao; Ming,9999,0,9999,0
1658070254692,MATH 197,004,095571,Perols; Johan Lars,9998,0,9999,1
1658070261749,COGS 9,A01,083615,Shannon; Kyle Michael,11,0,75,64
1658070267776,COGS 11,A01,083617,Boyle; Mary E. T.,23,0,48,25
1658070273803,COGS 13,A01,083071,Bastos; Amalia Pinkusfeld,12,0,71,59
1658070279828,COGS 14A,A01,092681,Semenuks; Arturs,5,1,100,95
1658070285850,COGS 14B,A01,083073,Cheng; Tzu-Han,7,0,63,56
1658070291876,COGS 17,A01,092677,Semenuks; Arturs,7,0,81,74
1658070297904,COGS 100,A01,083619,Allen; Michael Gordon,17,0,70,53
1658070303927,COGS 101A,A01,083621,Davis; Joshua Daniel,9,0,68,59
1658070309952,COGS 101B,A01,091572,Allen; Michael Gordon,14,0,65,51
1658070315980,COGS 101C,A01,083625,Delgado; Tania,17,0,35,18
1658070322003,COGS 107A,A01,083627,Boyle; Mary E. T.,14,0,60,46
1658070328031,COGS 118A,A01,083075,Gupta; Anjum,21,0,76,55
1658070334055,CSE 3,A50,083646,Miranda; Gregory Joseph,24,0,50,26
1658070340169,CSE 8A,A50,083650,Miranda; Gregory Joseph,17,1,56,39
1658070346196,CSE 11,A01,083080,Cao; Yingjun,7,15,40,33
1658070352218,CSE 12,A01,083652,Krause-Levy; Sophia Louisa,30,1,120,90
1658070358243,CSE 15L,A01,083654,Morris; Justin Loren,9,0,50,41
1658070358243,CSE 15L,A02,083655,Morris; Justin Loren,11,0,50,39
1658070364266,CSE 20,A01,083657,Tran; Khoa Dang,39,0,80,41
1658070370293,CSE 21,A01,095574,Bach; Quang Tran,23,0,48,25
1658070376331,CSE 30,A01,083084,Eldon; John,8,0,80,72
1658070376331,CSE 30,B01,095061,Bhaskar; Nishant,9,0,50,41
1658070382357,CSE 100,A01,083659,Cao; Yingjun,5,4,70,65
1658070388383,CSE 134B,A01,083661,Powell; Thomas Allan,25,0,100,75
1658070394407,CSE 140,A01,083663,Gungor; Onat,17,0,85,68
1658070400437,CSE 140L,A01,083088,Eldon; John,23,0,100,77
1658070406462,CSE 175,A01,083665,Kumar; Rakesh,3,0,25,22
1658070412484,CSE 190,A00,092507,Dubnov; Shlomo,8,0,20,12
1658070418510,ECE 45,A01,083139,Congero; Spencer William,7,0,75,68
1658070424539,ECE 65,A50,083695,Saad; Andrew S,12,0,30,18
1658070424539,ECE 65,A51,095125,Saad; Andrew S,24,0,26,2
1658070430565,ECE 109,A01,091882,Touri; Behrouz,21,0,70,49
1658070436590,ECE 180,A00,083140,Abi Samra; Nicholas Camill,1,0,30,29
1658070436590,ECE 180,B00,083141,Abi Samra; Nicholas Camill,0,0,30,30
1658070442613,MATH 10A,A01,083735,Patchell; Gregory David,2,0,30,28
1658070442613,MATH 10A,A02,083736,Patchell; Gregory David,20,0,30,10
1658070442613,MATH 10A,A03,083737,Patchell; Gregory David,16,0,30,14
1658070448638,MATH 10B,A01,083207,Lim; Seonhee,9,0,34,25
1658070448638,MATH 10B,A02,083208,Lim; Seonhee,10,0,35,25
1658070448638,MATH 10B,A03,093472,Lim; Seonhee,7,0,34,27
1658070448638,MATH 10B,B01,083739,Sinha; Shubham,14,0,30,16
1658070454664,MATH 18,A01,083743,Cinel; Cameron Alexander,9,0,30,21
1658070454664,MATH 18,A02,083744,Cinel; Cameron Alexander,18,0,30,12
1658070454664,MATH 18,A03,083745,Cinel; Cameron Alexander,10,0,30,20
1658070454664,MATH 18,B01,083748,Rideout; David Porter,5,0,37,32
1658070454664,MATH 18,B02,083749,Rideout; David Porter,5,0,36,31
1658070454664,MATH 18,B03,083750,Rideout; David Porter,3,0,37,34
1658070454664,MATH 18,B04,083751,Rideout; David Porter,7,0,36,29
1658070454664,MATH 18,B05,093473,Rideout; David Porter,7,0,36,29
1658070454664,MATH 18,B06,093474,Rideout; David Porter,6,0,36,30
1658070460686,MATH 20A,A01,083754,Zheng; Zequn,14,0,40,26
1658070466710,MATH 20B,A01,083756,Briones; Jor-el Thomas Caparas,4,0,36,32
1658070466710,MATH 20B,A02,083757,Briones; Jor-el Thomas Caparas,1,0,36,35
1658070466710,MATH 20B,A03,093475,Briones; Jor-el Thomas Caparas,3,0,36,33
1658070472735,MATH 20C,A01,083760,Briones; Jor-el Thomas Caparas,1,0,35,34
1658070472735,MATH 20C,A02,083761,Briones; Jor-el Thomas Caparas,8,0,35,27
1658070472735,MATH 20C,A03,093476,Briones; Jor-el Thomas Caparas,0,1,36,36
1658070472735,MATH 20C,B01,083762,Bach; Quang Tran,1,0,30,29
1658070478759,MATH 20D,A01,083765,Tran; Brian Kha,5,0,30,25
1658070478759,MATH 20D,A02,083766,Tran; Brian Kha,5,0,30,25
1658070478759,MATH 20D,A03,083767,Tran; Brian Kha,6,0,30,24
1658070484785,MATH 20E,A01,083771,Ganguly; Soumya,12,0,32,20
1658070484785,MATH 20E,A02,083772,Ganguly; Soumya,7,0,32,25
1658070484785,MATH 20E,B01,083773,Ciotti; Benjamin,20,0,35,15
1658070484785,MATH 20E,B02,083774,Ciotti; Benjamin,18,0,35,17
1658070490807,MATH 103A,A01,083777,Greenfeld; Be'Eri,6,0,36,30
1658070490807,MATH 103A,A02,083778,Greenfeld; Be'Eri,5,0,36,31
1658070490807,MATH 103A,A03,093561,Greenfeld; Be'Eri,7,0,36,29
1658070490807,MATH 103A,B01,083779,Greenfeld; Be'Eri,8,0,36,28
1658070490807,MATH 103A,B02,083780,Greenfeld; Be'Eri,4,0,36,32
1658070490807,MATH 103A,B03,093562,Greenfeld; Be'Eri,3,0,36,33
1658070496830,MATH 105,A01,085443,Carter; Anne Toulson,15,0,35,20
1658070496830,MATH 105,A02,093477,Carter; Anne Toulson,20,0,35,15
1658070502854,MATH 109,A01,083213,Ganzberger; Geoffrey Michael,3,0,34,31
1658070502854,MATH 109,A02,083214,Ganzberger; Geoffrey Michael,4,0,34,30
1658070502854,MATH 109,A03,093478,Ganzberger; Geoffrey Michael,2,0,34,32
1658070502854,MATH 109,B01,083215,Ganzberger; Geoffrey Michael,3,0,32,29
1658070502854,MATH 109,B02,083216,Ganzberger; Geoffrey Michael,3,0,32,29
1658070502854,MATH 109,B03,093479,Ganzberger; Geoffrey Michael,8,0,32,24
1658070508884,MATH 142A,A01,083219,Chow; Bennett,7,0,32,25
1658070508884,MATH 142A,A02,083220,Chow; Bennett,10,0,32,22
1658070508884,MATH 142A,A03,093480,Chow; Bennett,9,0,32,23
1658070508884,MATH 142A,B03,093481,Chow; Bennett,8,0,32,24
1658070508884,MATH 142A,B04,093558,Chow; Bennett,14,0,32,18
1658070508884,MATH 142A,B05,093559,Chow; Bennett,7,0,32,25
1658070514907,MATH 193A,A01,083224,Rotar; Vladimir,9,0,34,25
1658070514907,MATH 193A,A02,083225,Rotar; Vladimir,11,0,34,23
1658070514907,MATH 193A,A03,083781,Rotar; Vladimir,5,0,34,29
1658070514907,MATH 193A,A04,083782,Rotar; Vladimir,12,0,34,22
1658070514907,MATH 193A,A05,093482,Rotar; Vladimir,11,0,34,23
1658070520934,MATH 197,001,091859,McAuley; Julian John,9999,0,9999,0
1658070520934,MATH 197,002,095566,Kedlaya; Kiran S.,9997,0,9999,2
1658070520934,MATH 197,003,095567,Xiao; Ming,9999,0,9999,0
1658070520934,MATH 197,004,095571,Perols; Johan Lars,9998,0,9999,1
1658070527995,COGS 9,A01,083615,Shannon; Kyle Michael,11,0,75,64
1658070534019,COGS 11,A01,083617,Boyle; Mary E. T.,23,0,48,25
1658070540045,COGS 13,A01,083071,Bastos; Amalia Pinkusfeld,12,0,71,59
1658070546069,COGS 14A,A01,092681,Semenuks; Arturs,5,1,100,95
1658070552093,COGS 14B,A01,083073,Cheng; Tzu-Han,7,0,63,56
1658070558118,COGS 17,A01,092677,Semenuks; Arturs,7,0,81,74
1658070564145,COGS 100,A01,083619,Allen; Michael Gordon,17,0,70,53
1658070570173,COGS 101A,A01,083621,Davis; Joshua Daniel,9,0,68,59
1658070576200,COGS 101B,A01,091572,Allen; Michael Gordon,14,0,65,51
1658070582222,COGS 101C,A01,083625,Delgado; Tania,17,0,35,18
1658070588250,COGS 107A,A01,083627,Boyle; Mary E. T.,14,0,60,46
1658070594275,COGS 118A,A01,083075,Gupta; Anjum,21,0,76,55
1658070600300,CSE 3,A50,083646,Miranda; Gregory Joseph,24,0,50,26
1658070606325,CSE 8A,A50,083650,Miranda; Gregory Joseph,17,1,56,39
1658070612350,CSE 11,A01,083080,Cao; Yingjun,7,15,40,33
1658070618372,CSE 12,A01,083652,Krause-Levy; Sophia Louisa,30,1,120,90
1658070624397,CSE 15L,A01,083654,Morris; Justin Loren,9,0,50,41
1658070624397,CSE 15L,A02,083655,Morris; Justin Loren,11,0,50,39
1658070630424,CSE 20,A01,083657,Tran; Khoa Dang,39,0,80,41
1658070636451,CSE 21,A01,095574,Bach; Quang Tran,23,0,48,25
1658070642475,CSE 30,A01,083084,Eldon; John,8,0,80,72
1658070642475,CSE 30,B01,095061,Bhaskar; Nishant,9,0,50,41
1658070648497,CSE 100,A01,083659,Cao; Yingjun,5,4,70,65
1658070654526,CSE 134B,A01,083661,Powell; Thomas Allan,25,0,100,75
1658070660549,CSE 140,A01,083663,Gungor; Onat,17,0,85,68
1658070666575,CSE 140L,A01,083088,Eldon; John,23,0,100,77
1658070672598,CSE 175,A01,083665,Kumar; Rakesh,3,0,25,22
1658070678624,CSE 190,A00,092507,Dubnov; Shlomo,8,0,20,12
1658070684652,ECE 45,A01,083139,Congero; Spencer William,7,0,75,68
1658070690689,ECE 65,A50,083695,Saad; Andrew S,12,0,30,18
1658070690689,ECE 65,A51,095125,Saad; Andrew S,24,0,26,2
1658070696713,ECE 109,A01,091882,Touri; Behrouz,21,0,70,49
1658070702738,ECE 180,A00,083140,Abi Samra; Nicholas Camill,1,0,30,29
1658070702738,ECE 180,B00,083141,Abi Samra; Nicholas Camill,0,0,30,30
1658070708762,MATH 10A,A01,083735,Patchell; Gregory David,2,0,30,28
1658070708762,MATH 10A,A02,083736,Patchell; Gregory David,20,0,30,10
1658070708762,MATH 10A,A03,083737,Patchell; Gregory David,16,0,30,14
1658070714786,MATH 10B,A01,083207,Lim; Seonhee,9,0,34,25
1658070714786,MATH 10B,A02,083208,Lim; Seonhee,10,0,35,25
1658070714786,MATH 10B,A03,093472,Lim; Seonhee,7,0,34,27
1658070714786,MATH 10B,B01,083739,Sinha; Shubham,14,0,30,16
1658070720812,MATH 18,A01,083743,Cinel; Cameron Alexander,9,0,30,21
1658070720812,MATH 18,A02,083744,Cinel; Cameron Alexander,18,0,30,12
1658070720812,MATH 18,A03,083745,Cinel; Cameron Alexander,10,0,30,20
1658070720812,MATH 18,B01,083748,Rideout; David Porter,5,0,37,32
1658070720812,MATH 18,B02,083749,Rideout; David Porter,5,0,36,31
1658070720812,MATH 18,B03,083750,Rideout; David Porter,3,0,37,34
1658070720812,MATH 18,B04,083751,Rideout; David Porter,7,0,36,29
1658070720812,MATH 18,B05,093473,Rideout; David Porter,7,0,36,29
1658070720812,MATH 18,B06,093474,Rideout; David Porter,6,0,36,30
1658070726836,MATH 20A,A01,083754,Zheng; Zequn,14,0,40,26
1658070732860,MATH 20B,A01,083756,Briones; Jor-el Thomas Caparas,4,0,36,32
1658070732860,MATH 20B,A02,083757,Briones; Jor-el Thomas Caparas,1,0,36,35
1658070732860,MATH 20B,A03,093475,Briones; Jor-el Thomas Caparas,3,0,36,33
1658070738883,MATH 20C,A01,083760,Briones; Jor-el Thomas Caparas,1,0,35,34
1658070738883,MATH 20C,A02,083761,Briones; Jor-el Thomas Caparas,8,0,35,27
1658070738883,MATH 20C,A03,093476,Briones; Jor-el Thomas Caparas,0,1,36,36
1658070738883,MATH 20C,B01,083762,Bach; Quang Tran,1,0,30,29
1658070744908,MATH 20D,A01,083765,Tran; Brian Kha,5,0,30,25
1658070744908,MATH 20D,A02,083766,Tran; Brian Kha,5,0,30,25
1658070744908,MATH 20D,A03,083767,Tran; Brian Kha,6,0,30,24
1658070750931,MATH 20E,A01,083771,Ganguly; Soumya,12,0,32,20
1658070750931,MATH 20E,A02,083772,Ganguly; Soumya,7,0,32,25
1658070750931,MATH 20E,B01,083773,Ciotti; Benjamin,20,0,35,15
1658070750931,MATH 20E,B02,083774,Ciotti; Benjamin,18,0,35,17
1658070756957,MATH 103A,A01,083777,Greenfeld; Be'Eri,6,0,36,30
1658070756957,MATH 103A,A02,083778,Greenfeld; Be'Eri,5,0,36,31
1658070756957,MATH 103A,A03,093561,Greenfeld; Be'Eri,7,0,36,29
1658070756957,MATH 103A,B01,083779,Greenfeld; Be'Eri,8,0,36,28
1658070756957,MATH 103A,B02,083780,Greenfeld; Be'Eri,4,0,36,32
1658070756957,MATH 103A,B03,093562,Greenfeld; Be'Eri,3,0,36,33
1658070762982,MATH 105,A01,085443,Carter; Anne Toulson,15,0,35,20
1658070762982,MATH 105,A02,093477,Carter; Anne Toulson,20,0,35,15
1658070769007,MATH 109,A01,083213,Ganzberger; Geoffrey Michael,3,0,34,31
1658070769007,MATH 109,A02,083214,Ganzberger; Geoffrey Michael,4,0,34,30
1658070769007,MATH 109,A03,093478,Ganzberger; Geoffrey Michael,2,0,34,32
1658070769007,MATH 109,B01,083215,Ganzberger; Geoffrey Michael,3,0,32,29
1658070769007,MATH 109,B02,083216,Ganzberger; Geoffrey Michael,3,0,32,29
1658070769007,MATH 109,B03,093479,Ganzberger; Geoffrey Michael,8,0,32,24
1658070775037,MATH 142A,A01,083219,Chow; Bennett,7,0,32,25
1658070775037,MATH 142A,A02,083220,Chow; Bennett,10,0,32,22
1658070775037,MATH 142A,A03,093480,Chow; Bennett,9,0,32,23
1658070775037,MATH 142A,B03,093481,Chow; Bennett,8,0,32,24
1658070775037,MATH 142A,B04,093558,Chow; Bennett,14,0,32,18
1658070775037,MATH 142A,B05,093559,Chow; Bennett,7,0,32,25
1658070781062,MATH 193A,A01,083224,Rotar; Vladimir,9,0,34,25
1658070781062,MATH 193A,A02,083225,Rotar; Vladimir,11,0,34,23
1658070781062,MATH 193A,A03,083781,Rotar; Vladimir,5,0,34,29
1658070781062,MATH 193A,A04,083782,Rotar; Vladimir,12,0,34,22
1658070781062,MATH 193A,A05,093482,Rotar; Vladimir,11,0,34,23
1658070787087,MATH 197,001,091859,McAuley; Julian John,9999,0,9999,0
1658070787087,MATH 197,002,095566,Kedlaya; Kiran S.,9997,0,9999,2
1658070787087,MATH 197,003,095567,Xiao; Ming,9999,0,9999,0
1658070787087,MATH 197,004,095571,Perols; Johan Lars,9998,0,9999,1
1658070794144,COGS 9,A01,083615,Shannon; Kyle Michael,11,0,75,64
1658070800168,COGS 11,A01,083617,Boyle; Mary E. T.,23,0,48,25
1658070806192,COGS 13,A01,083071,Bastos; Amalia Pinkusfeld,12,0,71,59
1658070812219,COGS 14A,A01,092681,Semenuks; Arturs,5,1,100,95
1658070818245,COGS 14B,A01,083073,Cheng; Tzu-Han,7,0,63,56
1658070824271,COGS 17,A01,092677,Semenuks; Arturs,7,0,81,74
1658070830300,COGS 100,A01,083619,Allen; Michael Gordon,17,0,70,53
1658070836325,COGS 101A,A01,083621,Davis; Joshua Daniel,9,0,68,59
1658070842353,COGS 101B,A01,091572,Allen; Michael Gordon,14,0,65,51
1658070848382,COGS 101C,A01,083625,Delgado; Tania,17,0,35,18
1658070854406,COGS 107A,A01,083627,Boyle; Mary E. T.,14,0,60,46
1658070860430,COGS 118A,A01,083075,Gupta; Anjum,21,0,76,55
1658070866454,CSE 3,A50,083646,Miranda; Gregory Joseph,24,0,50,26
1658070872479,CSE 8A,A50,083650,Miranda; Gregory Joseph,17,1,56,39
1658070878505,CSE 11,A01,083080,Cao; Yingjun,7,15,40,33
1658070884532,CSE 12,A01,083652,Krause-Levy; Sophia Louisa,30,1,120,90
1658070890556,CSE 15L,A01,083654,Morris; Justin Loren,9,0,50,41
1658070890556,CSE 15L,A02,083655,Morris; Justin Loren,11,0,50,39
1658070896583,CSE 20,A01,083657,Tran; Khoa Dang,39,0,80,41
1658070902606,CSE 21,A01,095574,Bach; Quang Tran,23,0,48,25
1658070908635,CSE 30,A01,083084,Eldon; John,8,0,80,72
1658070908635,CSE 30,B01,095061,Bhaskar; Nishant,9,0,50,41
1658070914660,CSE 100,A01,083659,Cao; Yingjun,5,4,70,65
1658070920690,CSE 134B,A01,083661,Powell; Thomas Allan,25,0,100,75
1658070926716,CSE 140,A01,083663,Gungor; Onat,17,0,85,68
1658070932739,CSE 140L,A01,083088,Eldon; John,23,0,100,77
1658070938838,CSE 175,A01,083665,Kumar; Rakesh,3,0,25,22
1658070944862,CSE 190,A00,092507,Dubnov; Shlomo,8,0,20,12
1658070950885,ECE 45,A01,083139,Congero; Spencer William,7,0,75,68
1658070956913,ECE 65,A50,083695,Saad; Andrew S,12,0,30,18
1658070956913,ECE 65,A51,095125,Saad; Andrew S,24,0,26,2
1658070962936,ECE 109,A01,091882,Touri; Behrouz,21,0,70,49
1658070968963,ECE 180,A00,083140,Abi Samra; Nicholas Camill,1,0,30,29
1658070968963,ECE 180,B00,083141,Abi Samra; Nicholas Camill,0,0,30,30
1658070974994,MATH 10A,A01,083735,Patchell; Gregory David,2,0,30,28
1658070974994,MATH 10A,A02,083736,Patchell; Gregory David,20,0,30,10
1658070974994,MATH 10A,A03,083737,Patchell; Gregory David,16,0,30,14
1658070981023,MATH 10B,A01,083207,Lim; Seonhee,9,0,34,25
1658070981023,MATH 10B,A02,083208,Lim; Seonhee,10,0,35,25
1658070981023,MATH 10B,A03,093472,Lim; Seonhee,7,0,34,27
1658070981023,MATH 10B,B01,083739,Sinha; Shubham,14,0,30,16
1658070987049,MATH 18,A01,083743,Cinel; Cameron Alexander,9,0,30,21
1658070987049,MATH 18,A02,083744,Cinel; Cameron Alexander,18,0,30,12
1658070987049,MATH 18,A03,083745,Cinel; Cameron Alexander,10,0,30,20
1658070987049,MATH 18,B01,083748,Rideout; David Porter,5,0,37,32
1658070987049,MATH 18,B02,083749,Rideout; David Porter,5,0,36,31
1658070987049,MATH 18,B03,083750,Rideout; David Porter,3,0,37,34
1658070987049,MATH 18,B04,083751,Rideout; David Porter,7,0,36,29
1658070987049,MATH 18,B05,093473,Rideout; David Porter,7,0,36,29
1658070987049,MATH 18,B06,093474,Rideout; David Porter,6,0,36,30
1658070993072,MATH 20A,A01,083754,Zheng; Zequn,14,0,40,26
1658070999100,MATH 20B,A01,083756,Briones; Jor-el Thomas Caparas,4,0,36,32
1658070999100,MATH 20B,A02,083757,Briones; Jor-el Thomas Caparas,1,0,36,35
1658070999100,MATH 20B,A03,093475,Briones; Jor-el Thomas Caparas,3,0,36,33
1658071005127,MATH 20C,A01,083760,Briones; Jor-el Thomas Caparas,1,0,35,34
1658071005127,MATH 20C,A02,083761,Briones; Jor-el Thomas Caparas,8,0,35,27
1658071005127,MATH 20C,A03,093476,Briones; Jor-el Thomas Caparas,0,1,36,36
1658071005127,MATH 20C,B01,083762,Bach; Quang Tran,1,0,30,29
1658071011150,MATH 20D,A01,083765,Tran; Brian Kha,5,0,30,25
1658071011150,MATH 20D,A02,083766,Tran; Brian Kha,5,0,30,25
1658071011150,MATH 20D,A03,083767,Tran; Brian Kha,6,0,30,24
1658071017183,MATH 20E,A01,083771,Ganguly; Soumya,12,0,32,20
1658071017183,MATH 20E,A02,083772,Ganguly; Soumya,7,0,32,25
1658071017183,MATH 20E,B01,083773,Ciotti; Benjamin,20,0,35,15
1658071017183,MATH 20E,B02,083774,Ciotti; Benjamin,18,0,35,17
1658071023214,MATH 103A,A01,083777,Greenfeld; Be'Eri,6,0,36,30
1658071023214,MATH 103A,A02,083778,Greenfeld; Be'Eri,5,0,36,31
1658071023214,MATH 103A,A03,093561,Greenfeld; Be'Eri,7,0,36,29
1658071023214,MATH 103A,B01,083779,Greenfeld; Be'Eri,8,0,36,28
1658071023214,MATH 103A,B02,083780,Greenfeld; Be'Eri,4,0,36,32
1658071023214,MATH 103A,B03,093562,Greenfeld; Be'Eri,3,0,36,33
1658071029251,MATH 105,A01,085443,Carter; Anne Toulson,15,0,35,20
1658071029251,MATH 105,A02,093477,Carter; Anne Toulson,20,0,35,15
1658071035275,MATH 109,A01,083213,Ganzberger; Geoffrey Michael,3,0,34,31
1658071035275,MATH 109,A02,083214,Ganzberger; Geoffrey Michael,4,0,34,30
1658071035275,MATH 109,A03,093478,Ganzberger; Geoffrey Michael,2,0,34,32
1658071035275,MATH 109,B01,083215,Ganzberger; Geoffrey Michael,3,0,32,29
1658071035275,MATH 109,B02,083216,Ganzberger; Geoffrey Michael,3,0,32,29
1658071035275,MATH 109,B03,093479,Ganzberger; Geoffrey Michael,8,0,32,24
1658071041304,MATH 142A,A01,083219,Chow; Bennett,7,0,32,25
1658071041304,MATH 142A,A02,083220,Chow; Bennett,10,0,32,22
1658071041304,MATH 142A,A03,093480,Chow; Bennett,9,0,32,23
1658071041304,MATH 142A,B03,093481,Chow; Bennett,8,0,32,24
1658071041304,MATH 142A,B04,093558,Chow; Bennett,14,0,32,18
1658071041304,MATH 142A,B05,093559,Chow; Bennett,7,0,32,25
1658071047327,MATH 193A,A01,083224,Rotar; Vladimir,9,0,34,25
1658071047327,MATH 193A,A02,083225,Rotar; Vladimir,11,0,34,23
1658071047327,MATH 193A,A03,083781,Rotar; Vladimir,5,0,34,29
1658071047327,MATH 193A,A04,083782,Rotar; Vladimir,12,0,34,22
1658071047327,MATH 193A,A05,093482,Rotar; Vladimir,11,0,34,23
1658071053353,MATH 197,001,091859,McAuley; Julian John,9999,0,9999,0
1658071053353,MATH 197,002,095566,Kedlaya; Kiran S.,9997,0,9999,2
1658071053353,MATH 197,003,095567,Xiao; Ming,9999,0,9999,0
1658071053353,MATH 197,004,095571,Perols; Johan Lars,9998,0,9999,1
1658071060411,COGS 9,A01,083615,Shannon; Kyle Michael,11,0,75,64
1658071066435,COGS 11,A01,083617,Boyle; Mary E. T.,23,0,48,25
1658071072462,COGS 13,A01,083071,Bastos; Amalia Pinkusfeld,12,0,71,59
1658071078489,COGS 14A,A01,092681,Semenuks; Arturs,5,1,100,95
1658071084514,COGS 14B,A01,083073,Cheng; Tzu-Han,7,0,63,56
1658071090540,COGS 17,A01,092677,Semenuks; Arturs,7,0,81,74
1658071096568,COGS 100,A01,083619,Allen; Michael Gordon,17,0,70,53
1658071102594,COGS 101A,A01,083621,Davis; Joshua Daniel,9,0,68,59
1658071108621,COGS 101B,A01,091572,Allen; Michael Gordon,14,0,65,51
1658071114645,COGS 101C,A01,083625,Delgado; Tania,17,0,35,18
1658071120668,COGS 107A,A01,083627,Boyle; Mary E. T.,14,0,60,46
1658071126690,COGS 118A,A01,083075,Gupta; Anjum,21,0,76,55
1658071132717,CSE 3,A50,083646,Miranda; Gregory Joseph,24,0,50,26
1658071138743,CSE 8A,A50,083650,Miranda; Gregory Joseph,17,1,56,39
1658071144764,CSE 11,A01,083080,Cao; Yingjun,7,15,40,33
1658071150789,CSE 12,A01,083652,Krause-Levy; Sophia Louisa,30,1,120,90
1658071156812,CSE 15L,A01,083654,Morris; Justin Loren,9,0,50,41
1658071156812,CSE 15L,A02,083655,Morris; Justin Loren,11,0,50,39
1658071162835,CSE 20,A01,083657,Tran; Khoa Dang,39,0,80,41
1658071168861,CSE 21,A01,095574,Bach; Quang Tran,23,0,48,25
1658071174884,CSE 30,A01,083084,Eldon; John,8,0,80,72
1658071174884,CSE 30,B01,095061,Bhaskar; Nishant,9,0,50,41
1658071180906,CSE 100,A01,083659,Cao; Yingjun,5,4,70,65
1658071186929,CSE 134B,A01,083661,Powell; Thomas Allan,25,0,100,75
1658071192955,CSE 140,A01,083663,Gungor; Onat,17,0,85,68
1658071198977,CSE 140L,A01,083088,Eldon; John,23,0,100,77
1658071205003,CSE 175,A01,083665,Kumar; Rakesh,3,0,25,22
1658071211026,CSE 190,A00,092507,Dubnov; Shlomo,8,0,20,12
1658071217048,ECE 45,A01,083139,Congero; Spencer William,7,0,75,68
1658071223076,ECE 65,A50,083695,Saad; Andrew S,12,0,30,18
1658071223076,ECE 65,A51,095125,Saad; Andrew S,24,0,26,2
1658071229101,ECE 109,A01,091882,Touri; Behrouz,21,0,70,49
1658071235126,ECE 180,A00,083140,Abi Samra; Nicholas Camill,1,0,30,29
1658071235126,ECE 180,B00,083141,Abi Samra; Nicholas Camill,0,0,30,30
1658071241155,MATH 10A,A01,083735,Patchell; Gregory David,2,0,30,28
1658071241155,MATH 10A,A02,083736,Patchell; Gregory David,20,0,30,10
1658071241155,MATH 10A,A03,083737,Patchell; Gregory David,16,0,30,14
1658071247188,MATH 10B,A01,083207,Lim; Seonhee,9,0,34,25
1658071247188,MATH 10B,A02,083208,Lim; Seonhee,10,0,35,25
1658071247188,MATH 10B,A03,093472,Lim; Seonhee,7,0,34,27
1658071247188,MATH 10B,B01,083739,Sinha; Shubham,14,0,30,16
1658071253213,MATH 18,A01,083743,Cinel; Cameron Alexander,9,0,30,21
1658071253213,MATH 18,A02,083744,Cinel; Cameron Alexander,18,0,30,12
1658071253213,MATH 18,A03,083745,Cinel; Cameron Alexander,10,0,30,20
1658071253213,MATH 18,B01,083748,Rideout; David Porter,5,0,37,32
1658071253213,MATH 18,B02,083749,Rideout; David Porter,5,0,36,31
1658071253213,MATH 18,B03,083750,Rideout; David Porter,3,0,37,34
1658071253213,MATH 18,B04,083751,Rideout; David Porter,7,0,36,29
1658071253213,MATH 18,B05,093473,Rideout; David Porter,7,0,36,29
1658071253213,MATH 18,B06,093474,Rideout; David Porter,6,0,36,30
1658071259240,MATH 20A,A01,083754,Zheng; Zequn,14,0,40,26
1658071265264,MATH 20B,A01,083756,Briones; Jor-el Thomas Caparas,4,0,36,32
1658071265264,MATH 20B,A02,083757,Briones; Jor-el Thomas Caparas,1,0,36,35
1658071265264,MATH 20B,A03,093475,Briones; Jor-el Thomas Caparas,3,0,36,33
1658071271286,MATH 20C,A01,083760,Briones; Jor-el Thomas Caparas,1,0,35,34
1658071271286,MATH 20C,A02,083761,Briones; Jor-el Thomas Caparas,8,0,35,27
1658071271286,MATH 20C,A03,093476,Briones; Jor-el Thomas Caparas,0,1,36,36
1658071271286,MATH 20C,B01,083762,Bach; Quang Tran,1,0,30,29
1658071277312,MATH 20D,A01,083765,Tran; Brian Kha,5,0,30,25
1658071277312,MATH 20D,A02,083766,Tran; Brian Kha,5,0,30,25
1658071277312,MATH 20D,A03,083767,Tran; Brian Kha,6,0,30,24
1658071283336,MATH 20E,A01,083771,Ganguly; Soumya,12,0,32,20
1658071283336,MATH 20E,A02,083772,Ganguly; Soumya,7,0,32,25
1658071283336,MATH 20E,B01,083773,Ciotti; Benjamin,20,0,35,15
1658071283336,MATH 20E,B02,083774,Ciotti; Benjamin,18,0,35,17
1658071289365,MATH 103A,A01,083777,Greenfeld; Be'Eri,6,0,36,30
1658071289365,MATH 103A,A02,083778,Greenfeld; Be'Eri,5,0,36,31
1658071289365,MATH 103A,A03,093561,Greenfeld; Be'Eri,7,0,36,29
1658071289365,MATH 103A,B01,083779,Greenfeld; Be'Eri,8,0,36,28
1658071289365,MATH 103A,B02,083780,Greenfeld; Be'Eri,4,0,36,32
1658071289365,MATH 103A,B03,093562,Greenfeld; Be'Eri,3,0,36,33
1658071295392,MATH 105,A01,085443,Carter; Anne Toulson,15,0,35,20
1658071295392,MATH 105,A02,093477,Carter; Anne Toulson,20,0,35,15
1658071301420,MATH 109,A01,083213,Ganzberger; Geoffrey Michael,3,0,34,31
1658071301420,MATH 109,A02,083214,Ganzberger; Geoffrey Michael,4,0,34,30
1658071301420,MATH 109,A03,093478,Ganzberger; Geoffrey Michael,2,0,34,32
1658071301420,MATH 109,B01,083215,Ganzberger; Geoffrey Michael,3,0,32,29
1658071301420,MATH 109,B02,083216,Ganzberger; Geoffrey Michael,3,0,32,29
1658071301420,MATH 109,B03,093479,Ganzberger; Geoffrey Michael,8,0,32,24
1658071307446,MATH 142A,A01,083219,Chow; Bennett,7,0,32,25
1658071307446,MATH 142A,A02,083220,Chow; Bennett,10,0,32,22
1658071307446,MATH 142A,A03,093480,Chow; Bennett,9,0,32,23
1658071307446,MATH 142A,B03,093481,Chow; Bennett,8,0,32,24
1658071307446,MATH 142A,B04,093558,Chow; Bennett,14,0,32,18
1658071307446,MATH 142A,B05,093559,Chow; Bennett,7,0,32,25
1658071313468,MATH 193A,A01,083224,Rotar; Vladimir,9,0,34,25
1658071313468,MATH 193A,A02,083225,Rotar; Vladimir,11,0,34,23
1658071313468,MATH 193A,A03,083781,Rotar; Vladimir,5,0,34,29
1658071313468,MATH 193A,A04,083782,Rotar; Vladimir,12,0,34,22
1658071313468,MATH 193A,A05,093482,Rotar; Vladimir,11,0,34,23
1658071319495,MATH 197,001,091859,McAuley; Julian John,9999,0,9999,0
1658071319495,MATH 197,002,095566,Kedlaya; Kiran S.,9997,0,9999,2
1658071319495,MATH 197,003,095567,Xiao; Ming,9999,0,9999,0
1658071319495,MATH 197,004,095571,Perols; Johan Lars,9998,0,9999,1
1658071326572,COGS 9,A01,083615,Shannon; Kyle Michael,11,0,75,64
1658071332595,COGS 11,A01,083617,Boyle; Mary E. T.,23,0,48,25
1658071338623,COGS 13,A01,083071,Bastos; Amalia Pinkusfeld,12,0,71,59
1658071344655,COGS 14A,A01,092681,Semenuks; Arturs,5,1,100,95
1658071350679,COGS 14B,A01,083073,Cheng; Tzu-Han,7,0,63,56
1658071356719,COGS 17,A01,092677,Semenuks; Arturs,7,0,81,74
1658071362748,COGS 100,A01,083619,Allen; Michael Gordon,17,0,70,53
1658071368772,COGS 101A,A01,083621,Davis; Joshua Daniel,9,0,68,59
1658071374798,COGS 101B,A01,091572,Allen; Michael Gordon,14,0,65,51
1658071380826,COGS 101C,A01,083625,Delgado; Tania,17,0,35,18
1658071386855,COGS 107A,A01,083627,Boyle; Mary E. T.,14,0,60,46
1658071392880,COGS 118A,A01,083075,Gupta; Anjum,21,0,76,55
1658071398904,CSE 3,A50,083646,Miranda; Gregory Joseph,24,0,50,26
1658071404932,CSE 8A,A50,083650,Miranda; Gregory Joseph,17,1,56,39
1658071410955,CSE 11,A01,083080,Cao; Yingjun,7,15,40,33
1658071416978,CSE 12,A01,083652,Krause-Levy; Sophia Louisa,30,1,120,90
1658071423001,CSE 15L,A01,083654,Morris; Justin Loren,9,0,50,41
1658071423001,CSE 15L,A02,083655,Morris; Justin Loren,11,0,50,39
1658071429024,CSE 20,A01,083657,Tran; Khoa Dang,39,0,80,41
1658071435054,CSE 21,A01,095574,Bach; Quang Tran,23,0,48,25
1658071441081,CSE 30,A01,083084,Eldon; John,8,0,80,72
1658071441081,CSE 30,B01,095061,Bhaskar; Nishant,9,0,50,41
1658071447105,CSE 100,A01,083659,Cao; Yingjun,5,4,70,65
1658071453129,CSE 134B,A01,083661,Powell; Thomas Allan,25,0,100,75
1658071459154,CSE 140,A01,083663,Gungor; Onat,17,0,85,68
1658071465185,CSE 140L,A01,083088,Eldon; John,23,0,100,77
1658071471220,CSE 175,A01,083665,Kumar; Rakesh,3,0,25,22
1658071477253,CSE 190,A00,092507,Dubnov; Shlomo,8,0,20,12
1658071483279,ECE 45,A01,083139,Congero; Spencer William,7,0,75,68
1658071489310,ECE 65,A50,083695,Saad; Andrew S,12,0,30,18
1658071489310,ECE 65,A51,095125,Saad; Andrew S,24,0,26,2
1658071495337,ECE 109,A01,091882,Touri; Behrouz,21,0,70,49
1658071501370,ECE 180,A00,083140,Abi Samra; Nicholas Camill,1,0,30,29
1658071501370,ECE 180,B00,083141,Abi Samra; Nicholas Camill,0,0,30,30
1658071507399,MATH 10A,A01,083735,Patchell; Gregory David,2,0,30,28
1658071507399,MATH 10A,A02,083736,Patchell; Gregory David,20,0,30,10
1658071507399,MATH 10A,A03,083737,Patchell; Gregory David,16,0,30,14
1658071513426,MATH 10B,A01,083207,Lim; Seonhee,9,0,34,25
1658071513426,MATH 10B,A02,083208,Lim; Seonhee,10,0,35,25
1658071513426,MATH 10B,A03,093472,Lim; Seonhee,7,0,34,27
1658071513426,MATH 10B,B01,083739,Sinha; Shubham,14,0,30,16
1658071519454,MATH 18,A01,083743,Cinel; Cameron Alexander,9,0,30,21
1658071519454,MATH 18,A02,083744,Cinel; Cameron Alexander,18,0,30,12
1658071519454,MATH 18,A03,083745,Cinel; Cameron Alexander,10,0,30,20
1658071519454,MATH 18,B01,083748,Rideout; David Porter,5,0,37,32
1658071519454,MATH 18,B02,083749,Rideout; David Porter,5,0,36,31
1658071519454,MATH 18,B03,083750,Rideout; David Porter,3,0,37,34
1658071519454,MATH 18,B04,083751,Rideout; David Porter,7,0,36,29
1658071519454,MATH 18,B05,093473,Rideout; David Porter,7,0,36,29
1658071519454,MATH 18,B06,093474,Rideout; David Porter,6,0,36,30
1658071525479,MATH 20A,A01,083754,Zheng; Zequn,14,0,40,26
1658071531506,MATH 20B,A01,083756,Briones; Jor-el Thomas Caparas,4,0,36,32
1658071531506,MATH 20B,A02,083757,Briones; Jor-el Thomas Caparas,1,0,36,35
1658071531506,MATH 20B,A03,093475,Briones; Jor-el Thomas Caparas,3,0,36,33
1658071537604,MATH 20C,A01,083760,Briones; Jor-el Thomas Caparas,1,0,35,34
1658071537604,MATH 20C,A02,083761,Briones; Jor-el Thomas Caparas,8,0,35,27
1658071537604,MATH 20C,A03,093476,Briones; Jor-el Thomas Caparas,0,1,36,36
1658071537604,MATH 20C,B01,083762,Bach; Quang Tran,1,0,30,29
1658071543629,MATH 20D,A01,083765,Tran; Brian Kha,5,0,30,25
1658071543629,MATH 20D,A02,083766,Tran; Brian Kha,5,0,30,25
1658071543629,MATH 20D,A03,083767,Tran; Brian Kha,6,0,30,24
1658071549656,MATH 20E,A01,083771,Ganguly; Soumya,12,0,32,20
1658071549656,MATH 20E,A02,083772,Ganguly; Soumya,7,0,32,25
1658071549656,MATH 20E,B01,083773,Ciotti; Benjamin,20,0,35,15
1658071549656,MATH 20E,B02,083774,Ciotti; Benjamin,18,0,35,17
1658071555683,MATH 103A,A01,083777,Greenfeld; Be'Eri,6,0,36,30
1658071555683,MATH 103A,A02,083778,Greenfeld; Be'Eri,5,0,36,31
1658071555683,MATH 103A,A03,093561,Greenfeld; Be'Eri,7,0,36,29
1658071555683,MATH 103A,B01,083779,Greenfeld; Be'Eri,8,0,36,28
1658071555683,MATH 103A,B02,083780,Greenfeld; Be'Eri,4,0,36,32
1658071555683,MATH 103A,B03,093562,Greenfeld; Be'Eri,3,0,36,33
1658071561712,MATH 105,A01,085443,Carter; Anne Toulson,15,0,35,20
1658071561712,MATH 105,A02,093477,Carter; Anne Toulson,20,0,35,15
1658071567740,MATH 109,A01,083213,Ganzberger; Geoffrey Michael,3,0,34,31
1658071567740,MATH 109,A02,083214,Ganzberger; Geoffrey Michael,4,0,34,30
1658071567740,MATH 109,A03,093478,Ganzberger; Geoffrey Michael,2,0,34,32
1658071567740,MATH 109,B01,083215,Ganzberger; Geoffrey Michael,3,0,32,29
1658071567740,MATH 109,B02,083216,Ganzberger; Geoffrey Michael,3,0,32,29
1658071567740,MATH 109,B03,093479,Ganzberger; Geoffrey Michael,8,0,32,24
1658071573781,MATH 142A,A01,083219,Chow; Bennett,7,0,32,25
1658071573781,MATH 142A,A02,083220,Chow; Bennett,10,0,32,22
1658071573781,MATH 142A,A03,093480,Chow; Bennett,9,0,32,23
1658071573781,MATH 142A,B03,093481,Chow; Bennett,8,0,32,24
1658071573781,MATH 142A,B04,093558,Chow; Bennett,14,0,32,18
1658071573781,MATH 142A,B05,093559,Chow; Bennett,7,0,32,25
1658071579809,MATH 193A,A01,083224,Rotar; Vladimir,9,0,34,25
1658071579809,MATH 193A,A02,083225,Rotar; Vladimir,11,0,34,23
1658071579809,MATH 193A,A03,083781,Rotar; Vladimir,5,0,34,29
1658071579809,MATH 193A,A04,083782,Rotar; Vladimir,12,0,34,22
1658071579809,MATH 193A,A05,093482,Rotar; Vladimir,11,0,34,23
1658071585835,MATH 197,001,091859,McAuley; Julian John,9999,0,9999,0
1658071585835,MATH 197,002,095566,Kedlaya; Kiran S.,9997,0,9999,2
1658071585835,MATH 197,003,095567,Xiao; Ming,9999,0,9999,0
1658071585835,MATH 197,004,095571,Perols; Johan Lars,9998,0,9999,1
1658071592896,COGS 9,A01,083615,Shannon; Kyle Michael,11,0,75,64
1658071598921,COGS 11,A01,083617,Boyle; Mary E. T.,23,0,48,25
1658071604956,COGS 13,A01,083071,Bastos; Amalia Pinkusfeld,12,0,71,59
1658071610987,COGS 14A,A01,092681,Semenuks; Arturs,5,1,100,95
1658071617011,COGS 14B,A01,083073,Cheng; Tzu-Han,7,0,63,56
1658071623037,COGS 17,A01,092677,Semenuks; Arturs,7,0,81,74
1658071629065,COGS 100,A01,083619,Allen; Michael Gordon,17,0,70,53
1658071635090,COGS 101A,A01,083621,Davis; Joshua Daniel,9,0,68,59
1658071641116,COGS 101B,A01,091572,Allen; Michael Gordon,14,0,65,51
1658071647140,COGS 101C,A01,083625,Delgado; Tania,17,0,35,18
1658071653164,COGS 107A,A01,083627,Boyle; Mary E. T.,14,0,60,46
1658071659191,COGS 118A,A01,083075,Gupta; Anjum,21,0,76,55
1658071665218,CSE 3,A50,083646,Miranda; Gregory Joseph,24,0,50,26
1658071671246,CSE 8A,A50,083650,Miranda; Gregory Joseph,17,1,56,39
1658071677272,CSE 11,A01,083080,Cao; Yingjun,7,15,40,33
1658071683300,CSE 12,A01,083652,Krause-Levy; Sophia Louisa,30,1,120,90
1658071689327,CSE 15L,A01,083654,Morris; Justin Loren,9,0,50,41
1658071689327,CSE 15L,A02,083655,Morris; Justin Loren,11,0,50,39
1658071695353,CSE 20,A01,083657,Tran; Khoa Dang,39,0,80,41
1658071701376,CSE 21,A01,095574,Bach; Quang Tran,23,0,48,25
1658071707402,CSE 30,A01,083084,Eldon; John,8,0,80,72
1658071707402,CSE 30,B01,095061,Bhaskar; Nishant,9,0,50,41
1658071713425,CSE 100,A01,083659,Cao; Yingjun,5,4,70,65
1658071719449,CSE 134B,A01,083661,Powell; Thomas Allan,25,0,100,75
1658071725472,CSE 140,A01,083663,Gungor; Onat,17,0,85,68
1658071731497,CSE 140L,A01,083088,Eldon; John,23,0,100,77
1658071737520,CSE 175,A01,083665,Kumar; Rakesh,3,0,25,22
1658071743545,CSE 190,A00,092507,Dubnov; Shlomo,8,0,20,12
1658071749568,ECE 45,A01,083139,Congero; Spencer William,7,0,75,68
1658071755593,ECE 65,A50,083695,Saad; Andrew S,12,0,30,18
1658071755593,ECE 65,A51,095125,Saad; Andrew S,24,0,26,2
1658071761617,ECE 109,A01,091882,Touri; Behrouz,21,0,70,49
1658071767641,ECE 180,A00,083140,Abi Samra; Nicholas Camill,1,0,30,29
1658071767641,ECE 180,B00,083141,Abi Samra; Nicholas Camill,0,0,30,30
1658071773670,MATH 10A,A01,083735,Patchell; Gregory David,2,0,30,28
1658071773670,MATH 10A,A02,083736,Patchell; Gregory David,20,0,30,10
1658071773670,MATH 10A,A03,083737,Patchell; Gregory David,16,0,30,14
1658071779694,MATH 10B,A01,083207,Lim; Seonhee,9,0,34,25
1658071779694,MATH 10B,A02,083208,Lim; Seonhee,10,0,35,25
1658071779694,MATH 10B,A03,093472,Lim; Seonhee,7,0,34,27
1658071779694,MATH 10B,B01,083739,Sinha; Shubham,14,0,30,16
1658071785719,MATH 18,A01,083743,Cinel; Cameron Alexander,9,0,30,21
1658071785719,MATH 18,A02,083744,Cinel; Cameron Alexander,18,0,30,12
1658071785719,MATH 18,A03,083745,Cinel; Cameron Alexander,10,0,30,20
1658071785719,MATH 18,B01,083748,Rideout; David Porter,5,0,37,32
1658071785719,MATH 18,B02,083749,Rideout; David Porter,5,0,36,31
1658071785719,MATH 18,B03,083750,Rideout; David Porter,3,0,37,34
1658071785719,MATH 18,B04,083751,Rideout; David Porter,7,0,36,29
1658071785719,MATH 18,B05,093473,Rideout; David Porter,7,0,36,29
1658071785719,MATH 18,B06,093474,Rideout; David Porter,6,0,36,30
1658071791743,MATH 20A,A01,083754,Zheng; Zequn,14,0,40,26
1658071797773,MATH 20B,A01,083756,Briones; Jor-el Thomas Caparas,4,0,36,32
1658071797773,MATH 20B,A02,083757,Briones; Jor-el Thomas Caparas,1,0,36,35
1658071797773,MATH 20B,A03,093475,Briones; Jor-el Thomas Caparas,3,0,36,33
1658071803798,MATH 20C,A01,083760,Briones; Jor-el Thomas Caparas,1,0,35,34
1658071803798,MATH 20C,A02,083761,Briones; Jor-el Thomas Caparas,8,0,35,27
1658071803798,MATH 20C,A03,093476,Briones; Jor-el Thomas Caparas,0,1,36,36
1658071803798,MATH 20C,B01,083762,Bach; Quang Tran,1,0,30,29
1658071809826,MATH 20D,A01,083765,Tran; Brian Kha,5,0,30,25
1658071809826,MATH 20D,A02,083766,Tran; Brian Kha,5,0,30,25
1658071809826,MATH 20D,A03,083767,Tran; Brian Kha,6,0,30,24
1658071815848,MATH 20E,A01,083771,Ganguly; Soumya,12,0,32,20
1658071815848,MATH 20E,A02,083772,Ganguly; Soumya,7,0,32,25
1658071815848,MATH 20E,B01,083773,Ciotti; Benjamin,20,0,35,15
1658071815848,MATH 20E,B02,083774,Ciotti; Benjamin,18,0,35,17
1658071821873,MATH 103A,A01,083777,Greenfeld; Be'Eri,6,0,36,30
1658071821873,MATH 103A,A02,083778,Greenfeld; Be'Eri,5,0,36,31
1658071821873,MATH 103A,A03,093561,Greenfeld; Be'Eri,7,0,36,29
1658071821873,MATH 103A,B01,083779,Greenfeld; Be'Eri,8,0,36,28
1658071821873,MATH 103A,B02,083780,Greenfeld; Be'Eri,4,0,36,32
1658071821873,MATH 103A,B03,093562,Greenfeld; Be'Eri,3,0,36,33
1658071827898,MATH 105,A01,085443,Carter; Anne Toulson,15,0,35,20
1658071827898,MATH 105,A02,093477,Carter; Anne Toulson,20,0,35,15
1658071833925,MATH 109,A01,083213,Ganzberger; Geoffrey Michael,3,0,34,31
1658071833925,MATH 109,A02,083214,Ganzberger; Geoffrey Michael,4,0,34,30
1658071833925,MATH 109,A03,093478,Ganzberger; Geoffrey Michael,2,0,34,32
1658071833925,MATH 109,B01,083215,Ganzberger; Geoffrey Michael,3,0,32,29
1658071833925,MATH 109,B02,083216,Ganzberger; Geoffrey Michael,3,0,32,29
1658071833925,MATH 109,B03,093479,Ganzberger; Geoffrey Michael,8,0,32,24
1658071839950,MATH 142A,A01,083219,Chow; Bennett,7,0,32,25
1658071839950,MATH 142A,A02,083220,Chow; Bennett,10,0,32,22
1658071839950,MATH 142A,A03,093480,Chow; Bennett,9,0,32,23
1658071839950,MATH 142A,B03,093481,Chow; Bennett,8,0,32,24
1658071839950,MATH 142A,B04,093558,Chow; Bennett,14,0,32,18
1658071839950,MATH 142A,B05,093559,Chow; Bennett,7,0,32,25
1658071845979,MATH 193A,A01,083224,Rotar; Vladimir,9,0,34,25
1658071845979,MATH 193A,A02,083225,Rotar; Vladimir,11,0,34,23
1658071845979,MATH 193A,A03,083781,Rotar; Vladimir,5,0,34,29
1658071845979,MATH 193A,A04,083782,Rotar; Vladimir,12,0,34,22
1658071845979,MATH 193A,A05,093482,Rotar; Vladimir,11,0,34,23
1658071852004,MATH 197,001,091859,McAuley; Julian John,9999,0,9999,0
1658071852004,MATH 197,002,095566,Kedlaya; Kiran S.,9997,0,9999,2
1658071852004,MATH 197,003,095567,Xiao; Ming,9999,0,9999,0
1658071852004,MATH 197,004,095571,Perols; Johan Lars,9998,0,9999,1
1658071859060,COGS 9,A01,083615,Shannon; Kyle Michael,11,0,75,64
1658071865085,COGS 11,A01,083617,Boyle; Mary E. T.,23,0,48,25
1658071871109,COGS 13,A01,083071,Bastos; Amalia Pinkusfeld,12,0,71,59
1658071877138,COGS 14A,A01,092681,Semenuks; Arturs,5,1,100,95
1658071883168,COGS 14B,A01,083073,Cheng; Tzu-Han,7,0,63,56
1658071889191,COGS 17,A01,092677,Semenuks; Arturs,7,0,81,74
1658071895214,COGS 100,A01,083619,Allen; Michael Gordon,17,0,70,53
1658071901242,COGS 101A,A01,083621,Davis; Joshua Daniel,9,0,68,59
1658071907270,COGS 101B,A01,091572,Allen; Michael Gordon,14,0,65,51
1658071913297,COGS 101C,A01,083625,Delgado; Tania,17,0,35,18
1658071919322,COGS 107A,A01,083627,Boyle; Mary E. T.,14,0,60,46
1658071925350,COGS 118A,A01,083075,Gupta; Anjum,21,0,76,55
1658071931375,CSE 3,A50,083646,Miranda; Gregory Joseph,24,0,50,26
1658071937399,CSE 8A,A50,083650,Miranda; Gregory Joseph,17,1,56,39
1658071943421,CSE 11,A01,083080,Cao; Yingjun,7,15,40,33
1658071949448,CSE 12,A01,083652,Krause-Levy; Sophia Louisa,30,1,120,90
1658071955472,CSE 15L,A01,083654,Morris; Justin Loren,9,0,50,41
1658071955472,CSE 15L,A02,083655,Morris; Justin Loren,11,0,50,39
1658071961497,CSE 20,A01,083657,Tran; Khoa Dang,39,0,80,41
1658071967521,CSE 21,A01,095574,Bach; Quang Tran,23,0,48,25
1658071973557,CSE 30,A01,083084,Eldon; John,8,0,80,72
1658071973557,CSE 30,B01,095061,Bhaskar; Nishant,9,0,50,41
1658071979584,CSE 100,A01,083659,Cao; Yingjun,5,4,70,65
1658071985608,CSE 134B,A01,083661,Powell; Thomas Allan,25,0,100,75
1658071991634,CSE 140,A01,083663,Gungor; Onat,17,0,85,68
1658071997662,CSE 140L,A01,083088,Eldon; John,23,0,100,77
1658072003687,CSE 175,A01,083665,Kumar; Rakesh,3,0,25,22
1658072009713,CSE 190,A00,092507,Dubnov; Shlomo,8,0,20,12
1658072015741,ECE 45,A01,083139,Congero; Spencer William,7,0,75,68
1658072021764,ECE 65,A50,083695,Saad; Andrew S,12,0,30,18
1658072021764,ECE 65,A51,095125,Saad; Andrew S,24,0,26,2
1658072027789,ECE 109,A01,091882,Touri; Behrouz,21,0,70,49
1658072033813,ECE 180,A00,083140,Abi Samra; Nicholas Camill,1,0,30,29
1658072033813,ECE 180,B00,083141,Abi Samra; Nicholas Camill,0,0,30,30
1658072039840,MATH 10A,A01,083735,Patchell; Gregory David,2,0,30,28
1658072039840,MATH 10A,A02,083736,Patchell; Gregory David,20,0,30,10
1658072039840,MATH 10A,A03,083737,Patchell; Gregory David,16,0,30,14
1658072045869,MATH 10B,A01,083207,Lim; Seonhee,9,0,34,25
1658072045869,MATH 10B,A02,083208,Lim; Seonhee,10,0,35,25
1658072045869,MATH 10B,A03,093472,Lim; Seonhee,7,0,34,27
1658072045869,MATH 10B,B01,083739,Sinha; Shubham,14,0,30,16
1658072051904,MATH 18,A01,083743,Cinel; Cameron Alexander,9,0,30,21
1658072051904,MATH 18,A02,083744,Cinel; Cameron Alexander,18,0,30,12
1658072051904,MATH 18,A03,083745,Cinel; Cameron Alexander,10,0,30,20
1658072051904,MATH 18,B01,083748,Rideout; David Porter,5,0,37,32
1658072051904,MATH 18,B02,083749,Rideout; David Porter,5,0,36,31
1658072051904,MATH 18,B03,083750,Rideout; David Porter,3,0,37,34
1658072051904,MATH 18,B04,083751,Rideout; David Porter,7,0,36,29
1658072051904,MATH 18,B05,093473,Rideout; David Porter,7,0,36,29
1658072051904,MATH 18,B06,093474,Rideout; David Porter,6,0,36,30
1658072057929,MATH 20A,A01,083754,Zheng; Zequn,14,0,40,26
1658072063957,MATH 20B,A01,083756,Briones; Jor-el Thomas Caparas,4,0,36,32
1658072063957,MATH 20B,A02,083757,Briones; Jor-el Thomas Caparas,1,0,36,35
1658072063957,MATH 20B,A03,093475,Briones; Jor-el Thomas Caparas,3,0,36,33
1658072069984,MATH 20C,A01,083760,Briones; Jor-el Thomas Caparas,1,0,35,34
1658072069984,MATH 20C,A02,083761,Briones; Jor-el Thomas Caparas,8,0,35,27
1658072069984,MATH 20C,A03,093476,Briones; Jor-el Thomas Caparas,0,1,36,36
1658072069984,MATH 20C,B01,083762,Bach; Quang Tran,1,0,30,29
1658072076013,MATH 20D,A01,083765,Tran; Brian Kha,5,0,30,25
1658072076013,MATH 20D,A02,083766,Tran; Brian Kha,5,0,30,25
1658072076013,MATH 20D,A03,083767,Tran; Brian Kha,6,0,30,24
1658072082043,MATH 20E,A01,083771,Ganguly; Soumya,12,0,32,20
1658072082043,MATH 20E,A02,083772,Ganguly; Soumya,7,0,32,25
1658072082043,MATH 20E,B01,083773,Ciotti; Benjamin,20,0,35,15
1658072082043,MATH 20E,B02,083774,Ciotti; Benjamin,18,0,35,17
1658072088068,MATH 103A,A01,083777,Greenfeld; Be'Eri,6,0,36,30
1658072088068,MATH 103A,A02,083778,Greenfeld; Be'Eri,5,0,36,31
1658072088068,MATH 103A,A03,093561,Greenfeld; Be'Eri,7,0,36,29
1658072088068,MATH 103A,B01,083779,Greenfeld; Be'Eri,8,0,36,28
1658072088068,MATH 103A,B02,083780,Greenfeld; Be'Eri,4,0,36,32
1658072088068,MATH 103A,B03,093562,Greenfeld; Be'Eri,3,0,36,33
1658072094093,MATH 105,A01,085443,Carter; Anne Toulson,15,0,35,20
1658072094093,MATH 105,A02,093477,Carter; Anne Toulson,20,0,35,15
1658072100125,MATH 109,A01,083213,Ganzberger; Geoffrey Michael,3,0,34,31
1658072100125,MATH 109,A02,083214,Ganzberger; Geoffrey Michael,4,0,34,30
1658072100125,MATH 109,A03,093478,Ganzberger; Geoffrey Michael,2,0,34,32
1658072100125,MATH 109,B01,083215,Ganzberger; Geoffrey Michael,3,0,32,29
1658072100125,MATH 109,B02,083216,Ganzberger; Geoffrey Michael,3,0,32,29
1658072100125,MATH 109,B03,093479,Ganzberger; Geoffrey Michael,8,0,32,24
1658072106155,MATH 142A,A01,083219,Chow; Bennett,7,0,32,25
1658072106155,MATH 142A,A02,083220,Chow; Bennett,10,0,32,22
1658072106155,MATH 142A,A03,093480,Chow; Bennett,9,0,32,23
1658072106155,MATH 142A,B03,093481,Chow; Bennett,8,0,32,24
1658072106155,MATH 142A,B04,093558,Chow; Bennett,14,0,32,18
1658072106155,MATH 142A,B05,093559,Chow; Bennett,7,0,32,25
1658072112179,MATH 193A,A01,083224,Rotar; Vladimir,9,0,34,25
1658072112179,MATH 193A,A02,083225,Rotar; Vladimir,11,0,34,23
1658072112179,MATH 193A,A03,083781,Rotar; Vladimir,5,0,34,29
1658072112179,MATH 193A,A04,083782,Rotar; Vladimir,12,0,34,22
1658072112179,MATH 193A,A05,093482,Rotar; Vladimir,11,0,34,23
1658072118206,MATH 197,001,091859,McAuley; Julian John,9999,0,9999,0
1658072118206,MATH 197,002,095566,Kedlaya; Kiran S.,9997,0,9999,2
1658072118206,MATH 197,003,095567,Xiao; Ming,9999,0,9999,0
1658072118206,MATH 197,004,095571,Perols; Johan Lars,9998,0,9999,1
1658072125272,COGS 9,A01,083615,Shannon; Kyle Michael,11,0,75,64
1658072131368,COGS 11,A01,083617,Boyle; Mary E. T.,23,0,48,25
1658072137392,COGS 13,A01,083071,Bastos; Amalia Pinkusfeld,12,0,71,59
1658072143421,COGS 14A,A01,092681,Semenuks; Arturs,5,1,100,95
1658072149443,COGS 14B,A01,083073,Cheng; Tzu-Han,7,0,63,56
1658072155470,COGS 17,A01,092677,Semenuks; Arturs,7,0,81,74
1658072161497,COGS 100,A01,083619,Allen; Michael Gordon,17,0,70,53
1658072167523,COGS 101A,A01,083621,Davis; Joshua Daniel,9,0,68,59
1658072173548,COGS 101B,A01,091572,Allen; Michael Gordon,14,0,65,51
1658072179588,COGS 101C,A01,083625,Delgado; Tania,17,0,35,18
1658072185617,COGS 107A,A01,083627,Boyle; Mary E. T.,14,0,60,46
1658072191641,COGS 118A,A01,083075,Gupta; Anjum,21,0,76,55
1658072197671,CSE 3,A50,083646,Miranda; Gregory Joseph,24,0,50,26
1658072203695,CSE 8A,A50,083650,Miranda; Gregory Joseph,17,1,56,39
1658072209722,CSE 11,A01,083080,Cao; Yingjun,7,15,40,33
1658072215745,CSE 12,A01,083652,Krause-Levy; Sophia Louisa,30,1,120,90
1658072221767,CSE 15L,A01,083654,Morris; Justin Loren,9,0,50,41
1658072221767,CSE 15L,A02,083655,Morris; Justin Loren,11,0,50,39
1658072227796,CSE 20,A01,083657,Tran; Khoa Dang,39,0,80,41
1658072233820,CSE 21,A01,095574,Bach; Quang Tran,23,0,48,25
1658072239843,CSE 30,A01,083084,Eldon; John,8,0,80,72
1658072239843,CSE 30,B01,095061,Bhaskar; Nishant,9,0,50,41
1658072245866,CSE 100,A01,083659,Cao; Yingjun,5,4,70,65
1658072251893,CSE 134B,A01,083661,Powell; Thomas Allan,25,0,100,75
1658072257917,CSE 140,A01,083663,Gungor; Onat,17,0,85,68
1658072263943,CSE 140L,A01,083088,Eldon; John,23,0,100,77
1658072269970,CSE 175,A01,083665,Kumar; Rakesh,3,0,25,22
1658072275994,CSE 190,A00,092507,Dubnov; Shlomo,8,0,20,12
1658072282018,ECE 45,A01,083139,Congero; Spencer William,7,0,75,68
1658072288042,ECE 65,A50,083695,Saad; Andrew S,12,0,30,18
1658072288042,ECE 65,A51,095125,Saad; Andrew S,24,0,26,2
1658072294067,ECE 109,A01,091882,Touri; Behrouz,21,0,70,49
1658072300095,ECE 180,A00,083140,Abi Samra; Nicholas Camill,1,0,30,29
1658072300095,ECE 180,B00,083141,Abi Samra; Nicholas Camill,0,0,30,30
1658072306120,MATH 10A,A01,083735,Patchell; Gregory David,2,0,30,28
1658072306120,MATH 10A,A02,083736,Patchell; Gregory David,20,0,30,10
1658072306120,MATH 10A,A03,083737,Patchell; Gregory David,16,0,30,14
1658072312151,MATH 10B,A01,083207,Lim; Seonhee,9,0,34,25
1658072312151,MATH 10B,A02,083208,Lim; Seonhee,10,0,35,25
1658072312151,MATH 10B,A03,093472,Lim; Seonhee,7,0,34,27
1658072312151,MATH 10B,B01,083739,Sinha; Shubham,14,0,30,16
1658072318178,MATH 18,A01,083743,Cinel; Cameron Alexander,9,0,30,21
1658072318178,MATH 18,A02,083744,Cinel; Cameron Alexander,18,0,30,12
1658072318178,MATH 18,A03,083745,Cinel; Cameron Alexander,10,0,30,20
1658072318178,MATH 18,B01,083748,Rideout; David Porter,5,0,37,32
1658072318178,MATH 18,B02,083749,Rideout; David Porter,5,0,36,31
1658072318178,MATH 18,B03,083750,Rideout; David Porter,3,0,37,34
1658072318178,MATH 18,B04,083751,Rideout; David Porter,7,0,36,29
1658072318178,MATH 18,B05,093473,Rideout; David Porter,7,0,36,29
1658072318178,MATH 18,B06,093474,Rideout; David Porter,6,0,36,30
1658072324206,MATH 20A,A01,083754,Zheng; Zequn,14,0,40,26
1658072330231,MATH 20B,A01,083756,Briones; Jor-el Thomas Caparas,4,0,36,32
1658072330231,MATH 20B,A02,083757,Briones; Jor-el Thomas Caparas,1,0,36,35
1658072330231,MATH 20B,A03,093475,Briones; Jor-el Thomas Caparas,3,0,36,33
1658072336260,MATH 20C,A01,083760,Briones; Jor-el Thomas Caparas,1,0,35,34
1658072336260,MATH 20C,A02,083761,Briones; Jor-el Thomas Caparas,8,0,35,27
1658072336260,MATH 20C,A03,093476,Briones; Jor-el Thomas Caparas,0,1,36,36
1658072336260,MATH 20C,B01,083762,Bach; Quang Tran,1,0,30,29
1658072342284,MATH 20D,A01,083765,Tran; Brian Kha,5,0,30,25
1658072342284,MATH 20D,A02,083766,Tran; Brian Kha,5,0,30,25
1658072342284,MATH 20D,A03,083767,Tran; Brian Kha,6,0,30,24
1658072348310,MATH 20E,A01,083771,Ganguly; Soumya,12,0,32,20
1658072348310,MATH 20E,A02,083772,Ganguly; Soumya,7,0,32,25
1658072348310,MATH 20E,B01,083773,Ciotti; Benjamin,20,0,35,15
1658072348310,MATH 20E,B02,083774,Ciotti; Benjamin,18,0,35,17
1658072354340,MATH 103A,A01,083777,Greenfeld; Be'Eri,6,0,36,30
1658072354340,MATH 103A,A02,083778,Greenfeld; Be'Eri,5,0,36,31
1658072354340,MATH 103A,A03,093561,Greenfeld; Be'Eri,7,0,36,29
1658072354340,MATH 103A,B01,083779,Greenfeld; Be'Eri,8,0,36,28
1658072354340,MATH 103A,B02,083780,Greenfeld; Be'Eri,4,0,36,32
1658072354340,MATH 103A,B03,093562,Greenfeld; Be'Eri,3,0,36,33
1658072360364,MATH 105,A01,085443,Carter; Anne Toulson,15,0,35,20
1658072360364,MATH 105,A02,093477,Carter; Anne Toulson,20,0,35,15
1658072366389,MATH 109,A01,083213,Ganzberger; Geoffrey Michael,3,0,34,31
1658072366389,MATH 109,A02,083214,Ganzberger; Geoffrey Michael,4,0,34,30
1658072366389,MATH 109,A03,093478,Ganzberger; Geoffrey Michael,2,0,34,32
1658072366389,MATH 109,B01,083215,Ganzberger; Geoffrey Michael,3,0,32,29
1658072366389,MATH 109,B02,083216,Ganzberger; Geoffrey Michael,3,0,32,29
1658072366389,MATH 109,B03,093479,Ganzberger; Geoffrey Michael,8,0,32,24
1658072372416,MATH 142A,A01,083219,Chow; Bennett,7,0,32,25
1658072372416,MATH 142A,A02,083220,Chow; Bennett,10,0,32,22
1658072372416,MATH 142A,A03,093480,Chow; Bennett,9,0,32,23
1658072372416,MATH 142A,B03,093481,Chow; Bennett,8,0,32,24
1658072372416,MATH 142A,B04,093558,Chow; Bennett,14,0,32,18
1658072372416,MATH 142A,B05,093559,Chow; Bennett,7,0,32,25
1658072378440,MATH 193A,A01,083224,Rotar; Vladimir,9,0,34,25
1658072378440,MATH 193A,A02,083225,Rotar; Vladimir,11,0,34,23
1658072378440,MATH 193A,A03,083781,Rotar; Vladimir,5,0,34,29
1658072378440,MATH 193A,A04,083782,Rotar; Vladimir,12,0,34,22
1658072378440,MATH 193A,A05,093482,Rotar; Vladimir,11,0,34,23
1658072384471,MATH 197,001,091859,McAuley; Julian John,9999,0,9999,0
1658072384471,MATH 197,002,095566,Kedlaya; Kiran S.,9997,0,9999,2
1658072384471,MATH 197,003,095567,Xiao; Ming,9999,0,9999,0
1658072384471,MATH 197,004,095571,Perols; Johan Lars,9998,0,9999,1
1658072391525,COGS 9,A01,083615,Shannon; Kyle Michael,11,0,75,64
1658072397560,COGS 11,A01,083617,Boyle; Mary E. T.,23,0,48,25
1658072403588,COGS 13,A01,083071,Bastos; Amalia Pinkusfeld,12,0,71,59
1658072409613,COGS 14A,A01,092681,Semenuks; Arturs,5,1,100,95
1658072415638,COGS 14B,A01,083073,Cheng; Tzu-Han,7,0,63,56
1658072421662,COGS 17,A01,092677,Semenuks; Arturs,7,0,81,74
1658072427690,COGS 100,A01,083619,Allen; Michael Gordon,17,0,70,53
1658072433714,COGS 101A,A01,083621,Davis; Joshua Daniel,9,0,68,59
1658072439738,COGS 101B,A01,091572,Allen; Michael Gordon,14,0,65,51
1658072445762,COGS 101C,A01,083625,Delgado; Tania,17,0,35,18
1658072451789,COGS 107A,A01,083627,Boyle; Mary E. T.,14,0,60,46
1658072457813,COGS 118A,A01,083075,Gupta; Anjum,21,0,76,55
1658072463841,CSE 3,A50,083646,Miranda; Gregory Joseph,24,0,50,26
1658072469866,CSE 8A,A50,083650,Miranda; Gregory Joseph,17,1,56,39
1658072475890,CSE 11,A01,083080,Cao; Yingjun,7,15,40,33
1658072481916,CSE 12,A01,083652,Krause-Levy; Sophia Louisa,30,1,120,90
1658072487942,CSE 15L,A01,083654,Morris; Justin Loren,9,0,50,41
1658072487942,CSE 15L,A02,083655,Morris; Justin Loren,11,0,50,39
1658072493969,CSE 20,A01,083657,Tran; Khoa Dang,39,0,80,41
1658072499997,CSE 21,A01,095574,Bach; Quang Tran,23,0,48,25
1658072506025,CSE 30,A01,083084,Eldon; John,8,0,80,72
1658072506025,CSE 30,B01,095061,Bhaskar; Nishant,9,0,50,41
1658072512046,CSE 100,A01,083659,Cao; Yingjun,5,4,70,65
1658072518070,CSE 134B,A01,083661,Powell; Thomas Allan,25,0,100,75
1658072524093,CSE 140,A01,083663,Gungor; Onat,17,0,85,68
1658072530122,CSE 140L,A01,083088,Eldon; John,23,0,100,77
1658072536149,CSE 175,A01,083665,Kumar; Rakesh,3,0,25,22
1658072542178,CSE 190,A00,092507,Dubnov; Shlomo,8,0,20,12
1658072548202,ECE 45,A01,083139,Congero; Spencer William,7,0,75,68
1658072554226,ECE 65,A50,083695,Saad; Andrew S,12,0,30,18
1658072554226,ECE 65,A51,095125,Saad; Andrew S,24,0,26,2
1658072560256,ECE 109,A01,091882,Touri; Behrouz,21,0,70,49
1658072566280,ECE 180,A00,083140,Abi Samra; Nicholas Camill,1,0,30,29
1658072566280,ECE 180,B00,083141,Abi Samra; Nicholas Camill,0,0,30,30
1658072572308,MATH 10A,A01,083735,Patchell; Gregory David,2,0,30,28
1658072572308,MATH 10A,A02,083736,Patchell; Gregory David,20,0,30,10
1658072572308,MATH 10A,A03,083737,Patchell; Gregory David,16,0,30,14
1658072578338,MATH 10B,A01,083207,Lim; Seonhee,9,0,34,25
1658072578338,MATH 10B,A02,083208,Lim; Seonhee,10,0,35,25
1658072578338,MATH 10B,A03,093472,Lim; Seonhee,7,0,34,27
1658072578338,MATH 10B,B01,083739,Sinha; Shubham,14,0,30,16
1658072584364,MATH 18,A01,083743,Cinel; Cameron Alexander,9,0,30,21
1658072584364,MATH 18,A02,083744,Cinel; Cameron Alexander,18,0,30,12
1658072584364,MATH 18,A03,083745,Cinel; Cameron Alexander,10,0,30,20
1658072584364,MATH 18,B01,083748,Rideout; David Porter,5,0,37,32
1658072584364,MATH 18,B02,083749,Rideout; David Porter,5,0,36,31
1658072584364,MATH 18,B03,083750,Rideout; David Porter,3,0,37,34
1658072584364,MATH 18,B04,083751,Rideout; David Porter,7,0,36,29
1658072584364,MATH 18,B05,093473,Rideout; David Porter,7,0,36,29
1658072584364,MATH 18,B06,093474,Rideout; David Porter,6,0,36,30
1658072590388,MATH 20A,A01,083754,Zheng; Zequn,14,0,40,26
1658072596412,MATH 20B,A01,083756,Briones; Jor-el Thomas Caparas,4,0,36,32
1658072596412,MATH 20B,A02,083757,Briones; Jor-el Thomas Caparas,1,0,36,35
1658072596412,MATH 20B,A03,093475,Briones; Jor-el Thomas Caparas,3,0,36,33
1658072602437,MATH 20C,A01,083760,Briones; Jor-el Thomas Caparas,1,0,35,34
1658072602437,MATH 20C,A02,083761,Briones; Jor-el Thomas Caparas,8,0,35,27
1658072602437,MATH 20C,A03,093476,Briones; Jor-el Thomas Caparas,0,1,36,36
1658072602437,MATH 20C,B01,083762,Bach; Quang Tran,1,0,30,29
1658072608462,MATH 20D,A01,083765,Tran; Brian Kha,5,0,30,25
1658072608462,MATH 20D,A02,083766,Tran; Brian Kha,5,0,30,25
1658072608462,MATH 20D,A03,083767,Tran; Brian Kha,6,0,30,24
1658072614491,MATH 20E,A01,083771,Ganguly; Soumya,12,0,32,20
1658072614491,MATH 20E,A02,083772,Ganguly; Soumya,7,0,32,25
1658072614491,MATH 20E,B01,083773,Ciotti; Benjamin,20,0,35,15
1658072614491,MATH 20E,B02,083774,Ciotti; Benjamin,18,0,35,17
1658072620520,MATH 103A,A01,083777,Greenfeld; Be'Eri,6,0,36,30
1658072620520,MATH 103A,A02,083778,Greenfeld; Be'Eri,5,0,36,31
1658072620520,MATH 103A,A03,093561,Greenfeld; Be'Eri,7,0,36,29
1658072620520,MATH 103A,B01,083779,Greenfeld; Be'Eri,8,0,36,28
1658072620520,MATH 103A,B02,083780,Greenfeld; Be'Eri,4,0,36,32
1658072620520,MATH 103A,B03,093562,Greenfeld; Be'Eri,3,0,36,33
1658072626545,MATH 105,A01,085443,Carter; Anne Toulson,15,0,35,20
1658072626545,MATH 105,A02,093477,Carter; Anne Toulson,20,0,35,15
1658072632574,MATH 109,A01,083213,Ganzberger; Geoffrey Michael,3,0,34,31
1658072632574,MATH 109,A02,083214,Ganzberger; Geoffrey Michael,4,0,34,30
1658072632574,MATH 109,A03,093478,Ganzberger; Geoffrey Michael,2,0,34,32
1658072632574,MATH 109,B01,083215,Ganzberger; Geoffrey Michael,3,0,32,29
1658072632574,MATH 109,B02,083216,Ganzberger; Geoffrey Michael,3,0,32,29
1658072632574,MATH 109,B03,093479,Ganzberger; Geoffrey Michael,8,0,32,24
1658072638605,MATH 142A,A01,083219,Chow; Bennett,7,0,32,25
1658072638605,MATH 142A,A02,083220,Chow; Bennett,10,0,32,22
1658072638605,MATH 142A,A03,093480,Chow; Bennett,9,0,32,23
1658072638605,MATH 142A,B03,093481,Chow; Bennett,8,0,32,24
1658072638605,MATH 142A,B04,093558,Chow; Bennett,14,0,32,18
1658072638605,MATH 142A,B05,093559,Chow; Bennett,7,0,32,25
1658072644631,MATH 193A,A01,083224,Rotar; Vladimir,9,0,34,25
1658072644631,MATH 193A,A02,083225,Rotar; Vladimir,11,0,34,23
1658072644631,MATH 193A,A03,083781,Rotar; Vladimir,5,0,34,29
1658072644631,MATH 193A,A04,083782,Rotar; Vladimir,12,0,34,22
1658072644631,MATH 193A,A05,093482,Rotar; Vladimir,11,0,34,23
1658072650652,MATH 197,001,091859,McAuley; Julian John,9999,0,9999,0
1658072650652,MATH 197,002,095566,Kedlaya; Kiran S.,9997,0,9999,2
1658072650652,MATH 197,003,095567,Xiao; Ming,9999,0,9999,0
1658072650652,MATH 197,004,095571,Perols; Johan Lars,9998,0,9999,1
1658072657704,COGS 9,A01,083615,Shannon; Kyle Michael,11,0,75,64
1658072663733,COGS 11,A01,083617,Boyle; Mary E. T.,23,0,48,25
1658072669760,COGS 13,A01,083071,Bastos; Amalia Pinkusfeld,12,0,71,59
1658072675784,COGS 14A,A01,092681,Semenuks; Arturs,5,1,100,95
1658072681809,COGS 14B,A01,083073,Cheng; Tzu-Han,7,0,63,56
1658072687835,COGS 17,A01,092677,Semenuks; Arturs,7,0,81,74
1658072693860,COGS 100,A01,083619,Allen; Michael Gordon,17,0,70,53
1658072699886,COGS 101A,A01,083621,Davis; Joshua Daniel,9,0,68,59
1658072705917,COGS 101B,A01,091572,Allen; Michael Gordon,14,0,65,51
1658072711941,COGS 101C,A01,083625,Delgado; Tania,17,0,35,18
1658072717965,COGS 107A,A01,083627,Boyle; Mary E. T.,14,0,60,46
1658072723990,COGS 118A,A01,083075,Gupta; Anjum,21,0,76,55
1658072730091,CSE 3,A50,083646,Miranda; Gregory Joseph,24,0,50,26
1658072736118,CSE 8A,A50,083650,Miranda; Gregory Joseph,17,1,56,39
1658072742143,CSE 11,A01,083080,Cao; Yingjun,7,15,40,33
1658072748172,CSE 12,A01,083652,Krause-Levy; Sophia Louisa,30,1,120,90
1658072754195,CSE 15L,A01,083654,Morris; Justin Loren,9,0,50,41
1658072754195,CSE 15L,A02,083655,Morris; Justin Loren,11,0,50,39
1658072760219,CSE 20,A01,083657,Tran; Khoa Dang,39,0,80,41
1658072766245,CSE 21,A01,095574,Bach; Quang Tran,23,0,48,25
1658072772269,CSE 30,A01,083084,Eldon; John,8,0,80,72
1658072772269,CSE 30,B01,095061,Bhaskar; Nishant,9,0,50,41
1658072778297,CSE 100,A01,083659,Cao; Yingjun,5,4,70,65
1658072784324,CSE 134B,A01,083661,Powell; Thomas Allan,25,0,100,75
1658072790348,CSE 140,A01,083663,Gungor; Onat,17,0,85,68
1658072796372,CSE 140L,A01,083088,Eldon; John,23,0,100,77
1658072802399,CSE 175,A01,083665,Kumar; Rakesh,3,0,25,22
1658072808424,CSE 190,A00,092507,Dubnov; Shlomo,8,0,20,12
1658072814448,ECE 45,A01,083139,Congero; Spencer William,7,0,75,68
1658072820472,ECE 65,A50,083695,Saad; Andrew S,12,0,30,18
1658072820472,ECE 65,A51,095125,Saad; Andrew S,24,0,26,2
1658072826501,ECE 109,A01,091882,Touri; Behrouz,21,0,70,49
1658072832524,ECE 180,A00,083140,Abi Samra; Nicholas Camill,1,0,30,29
1658072832524,ECE 180,B00,083141,Abi Samra; Nicholas Camill,0,0,30,30
1658072838554,MATH 10A,A01,083735,Patchell; Gregory David,2,0,30,28
1658072838554,MATH 10A,A02,083736,Patchell; Gregory David,20,0,30,10
1658072838554,MATH 10A,A03,083737,Patchell; Gregory David,16,0,30,14
1658072844581,MATH 10B,A01,083207,Lim; Seonhee,9,0,34,25
1658072844581,MATH 10B,A02,083208,Lim; Seonhee,10,0,35,25
1658072844581,MATH 10B,A03,093472,Lim; Seonhee,7,0,34,27
1658072844581,MATH 10B,B01,083739,Sinha; Shubham,14,0,30,16
1658072850614,MATH 18,A01,083743,Cinel; Cameron Alexander,9,0,30,21
1658072850614,MATH 18,A02,083744,Cinel; Cameron Alexander,18,0,30,12
1658072850614,MATH 18,A03,083745,Cinel; Cameron Alexander,10,0,30,20
1658072850614,MATH 18,B01,083748,Rideout; David Porter,5,0,37,32
1658072850614,MATH 18,B02,083749,Rideout; David Porter,5,0,36,31
1658072850614,MATH 18,B03,083750,Rideout; David Porter,3,0,37,34
1658072850614,MATH 18,B04,083751,Rideout; David Porter,7,0,36,29
1658072850614,MATH 18,B05,093473,Rideout; David Porter,7,0,36,29
1658072850614,MATH 18,B06,093474,Rideout; David Porter,6,0,36,30
1658072856638,MATH 20A,A01,083754,Zheng; Zequn,14,0,40,26
1658072862667,MATH 20B,A01,083756,Briones; Jor-el Thomas Caparas,4,0,36,32
1658072862667,MATH 20B,A02,083757,Briones; Jor-el Thomas Caparas,1,0,36,35
1658072862667,MATH 20B,A03,093475,Briones; Jor-el Thomas Caparas,3,0,36,33
1658072868691,MATH 20C,A01,083760,Briones; Jor-el Thomas Caparas,1,0,35,34
1658072868691,MATH 20C,A02,083761,Briones; Jor-el Thomas Caparas,8,0,35,27
1658072868691,MATH 20C,A03,093476,Briones; Jor-el Thomas Caparas,0,1,36,36
1658072868691,MATH 20C,B01,083762,Bach; Quang Tran,1,0,30,29
1658072874716,MATH 20D,A01,083765,Tran; Brian Kha,5,0,30,25
1658072874716,MATH 20D,A02,083766,Tran; Brian Kha,5,0,30,25
1658072874716,MATH 20D,A03,083767,Tran; Brian Kha,6,0,30,24
1658072880745,MATH 20E,A01,083771,Ganguly; Soumya,12,0,32,20
1658072880745,MATH 20E,A02,083772,Ganguly; Soumya,7,0,32,25
1658072880745,MATH 20E,B01,083773,Ciotti; Benjamin,20,0,35,15
1658072880745,MATH 20E,B02,083774,Ciotti; Benjamin,18,0,35,17
1658072886776,MATH 103A,A01,083777,Greenfeld; Be'Eri,6,0,36,30
1658072886776,MATH 103A,A02,083778,Greenfeld; Be'Eri,5,0,36,31
1658072886776,MATH 103A,A03,093561,Greenfeld; Be'Eri,7,0,36,29
1658072886776,MATH 103A,B01,083779,Greenfeld; Be'Eri,8,0,36,28
1658072886776,MATH 103A,B02,083780,Greenfeld; Be'Eri,4,0,36,32
1658072886776,MATH 103A,B03,093562,Greenfeld; Be'Eri,3,0,36,33
1658072892804,MATH 105,A01,085443,Carter; Anne Toulson,15,0,35,20
1658072892804,MATH 105,A02,093477,Carter; Anne Toulson,20,0,35,15
1658072898829,MATH 109,A01,083213,Ganzberger; Geoffrey Michael,3,0,34,31
1658072898829,MATH 109,A02,083214,Ganzberger; Geoffrey Michael,4,0,34,30
1658072898829,MATH 109,A03,093478,Ganzberger; Geoffrey Michael,2,0,34,32
1658072898829,MATH 109,B01,083215,Ganzberger; Geoffrey Michael,3,0,32,29
1658072898829,MATH 109,B02,083216,Ganzberger; Geoffrey Michael,3,0,32,29
1658072898829,MATH 109,B03,093479,Ganzberger; Geoffrey Michael,8,0,32,24
1658072904854,MATH 142A,A01,083219,Chow; Bennett,7,0,32,25
1658072904854,MATH 142A,A02,083220,Chow; Bennett,10,0,32,22
1658072904854,MATH 142A,A03,093480,Chow; Bennett,9,0,32,23
1658072904854,MATH 142A,B03,093481,Chow; Bennett,8,0,32,24
1658072904854,MATH 142A,B04,093558,Chow; Bennett,14,0,32,18
1658072904854,MATH 142A,B05,093559,Chow; Bennett,7,0,32,25
1658072910879,MATH 193A,A01,083224,Rotar; Vladimir,9,0,34,25
1658072910879,MATH 193A,A02,083225,Rotar; Vladimir,11,0,34,23
1658072910879,MATH 193A,A03,083781,Rotar; Vladimir,5,0,34,29
1658072910879,MATH 193A,A04,083782,Rotar; Vladimir,12,0,34,22
1658072910879,MATH 193A,A05,093482,Rotar; Vladimir,11,0,34,23
1658072916907,MATH 197,001,091859,McAuley; Julian John,9999,0,9999,0
1658072916907,MATH 197,002,095566,Kedlaya; Kiran S.,9997,0,9999,2
1658072916907,MATH 197,003,095567,Xiao; Ming,9999,0,9999,0
1658072916907,MATH 197,004,095571,Perols; Johan Lars,9998,0,9999,1
1658072923966,COGS 9,A01,083615,Shannon; Kyle Michael,11,0,75,64
1658072929989,COGS 11,A01,083617,Boyle; Mary E. T.,23,0,48,25
1658072936014,COGS 13,A01,083071,Bastos; Amalia Pinkusfeld,12,0,71,59
1658072942040,COGS 14A,A01,092681,Semenuks; Arturs,5,1,100,95
1658072948066,COGS 14B,A01,083073,Cheng; Tzu-Han,7,0,63,56
1658072954093,COGS 17,A01,092677,Semenuks; Arturs,7,0,81,74
1658072960119,COGS 100,A01,083619,Allen; Michael Gordon,17,0,70,53
1658072966147,COGS 101A,A01,083621,Davis; Joshua Daniel,9,0,68,59
1658072972175,COGS 101B,A01,091572,Allen; Michael Gordon,14,0,65,51
1658072978199,COGS 101C,A01,083625,Delgado; Tania,17,0,35,18
1658072984224,COGS 107A,A01,083627,Boyle; Mary E. T.,14,0,60,46
1658072990254,COGS 118A,A01,083075,Gupta; Anjum,21,0,76,55
1658072996282,CSE 3,A50,083646,Miranda; Gregory Joseph,24,0,50,26
1658073002304,CSE 8A,A50,083650,Miranda; Gregory Joseph,17,1,56,39
1658073008329,CSE 11,A01,083080,Cao; Yingjun,7,15,40,33
1658073014357,CSE 12,A01,083652,Krause-Levy; Sophia Louisa,30,1,120,90
1658073020383,CSE 15L,A01,083654,Morris; Justin Loren,9,0,50,41
1658073020383,CSE 15L,A02,083655,Morris; Justin Loren,11,0,50,39
1658073026412,CSE 20,A01,083657,Tran; Khoa Dang,39,0,80,41
1658073032439,CSE 21,A01,095574,Bach; Quang Tran,23,0,48,25
1658073038461,CSE 30,A01,083084,Eldon; John,8,0,80,72
1658073038461,CSE 30,B01,095061,Bhaskar; Nishant,9,0,50,41
1658073044486,CSE 100,A01,083659,Cao; Yingjun,5,4,70,65
1658073050520,CSE 134B,A01,083661,Powell; Thomas Allan,25,0,100,75
1658073056544,CSE 140,A01,083663,Gungor; Onat,17,0,85,68
1658073062572,CSE 140L,A01,083088,Eldon; John,23,0,100,77
1658073068598,CSE 175,A01,083665,Kumar; Rakesh,3,0,25,22
1658073074622,CSE 190,A00,092507,Dubnov; Shlomo,8,0,20,12
1658073080649,ECE 45,A01,083139,Congero; Spencer William,7,0,75,68
1658073086673,ECE 65,A50,083695,Saad; Andrew S,12,0,30,18
1658073086673,ECE 65,A51,095125,Saad; Andrew S,24,0,26,2
1658073092702,ECE 109,A01,091882,Touri; Behrouz,21,0,70,49
1658073098725,ECE 180,A00,083140,Abi Samra; Nicholas Camill,1,0,30,29
1658073098725,ECE 180,B00,083141,Abi Samra; Nicholas Camill,0,0,30,30
1658073104754,MATH 10A,A01,083735,Patchell; Gregory David,2,0,30,28
1658073104754,MATH 10A,A02,083736,Patchell; Gregory David,20,0,30,10
1658073104754,MATH 10A,A03,083737,Patchell; Gregory David,16,0,30,14
1658073110784,MATH 10B,A01,083207,Lim; Seonhee,9,0,34,25
1658073110784,MATH 10B,A02,083208,Lim; Seonhee,10,0,35,25
1658073110784,MATH 10B,A03,093472,Lim; Seonhee,7,0,34,27
1658073110784,MATH 10B,B01,083739,Sinha; Shubham,14,0,30,16
1658073116810,MATH 18,A01,083743,Cinel; Cameron Alexander,9,0,30,21
1658073116810,MATH 18,A02,083744,Cinel; Cameron Alexander,18,0,30,12
1658073116810,MATH 18,A03,083745,Cinel; Cameron Alexander,10,0,30,20
1658073116810,MATH 18,B01,083748,Rideout; David Porter,5,0,37,32
1658073116810,MATH 18,B02,083749,Rideout; David Porter,5,0,36,31
1658073116810,MATH 18,B03,083750,Rideout; David Porter,3,0,37,34
1658073116810,MATH 18,B04,083751,Rideout; David Porter,7,0,36,29
1658073116810,MATH 18,B05,093473,Rideout; David Porter,7,0,36,29
1658073116810,MATH 18,B06,093474,Rideout; David Porter,6,0,36,30
1658073122837,MATH 20A,A01,083754,Zheng; Zequn,14,0,40,26
1658073128861,MATH 20B,A01,083756,Briones; Jor-el Thomas Caparas,4,0,36,32
1658073128861,MATH 20B,A02,083757,Briones; Jor-el Thomas Caparas,1,0,36,35
1658073128861,MATH 20B,A03,093475,Briones; Jor-el Thomas Caparas,3,0,36,33
1658073134885,MATH 20C,A01,083760,Briones; Jor-el Thomas Caparas,1,0,35,34
1658073134885,MATH 20C,A02,083761,Briones; Jor-el Thomas Caparas,8,0,35,27
1658073134885,MATH 20C,A03,093476,Briones; Jor-el Thomas Caparas,0,1,36,36
1658073134885,MATH 20C,B01,083762,Bach; Quang Tran,1,0,30,29
1658073140911,MATH 20D,A01,083765,Tran; Brian Kha,5,0,30,25
1658073140911,MATH 20D,A02,083766,Tran; Brian Kha,5,0,30,25
1658073140911,MATH 20D,A03,083767,Tran; Brian Kha,6,0,30,24
1658073146939,MATH 20E,A01,083771,Ganguly; Soumya,12,0,32,20
1658073146939,MATH 20E,A02,083772,Ganguly; Soumya,7,0,32,25
1658073146939,MATH 20E,B01,083773,Ciotti; Benjamin,20,0,35,15
1658073146939,MATH 20E,B02,083774,Ciotti; Benjamin,18,0,35,17
1658073152970,MATH 103A,A01,083777,Greenfeld; Be'Eri,6,0,36,30
1658073152970,MATH 103A,A02,083778,Greenfeld; Be'Eri,5,0,36,31
1658073152970,MATH 103A,A03,093561,Greenfeld; Be'Eri,7,0,36,29
1658073152970,MATH 103A,B01,083779,Greenfeld; Be'Eri,8,0,36,28
1658073152970,MATH 103A,B02,083780,Greenfeld; Be'Eri,4,0,36,32
1658073152970,MATH 103A,B03,093562,Greenfeld; Be'Eri,3,0,36,33
1658073158994,MATH 105,A01,085443,Carter; Anne Toulson,15,0,35,20
1658073158994,MATH 105,A02,093477,Carter; Anne Toulson,20,0,35,15
1658073165018,MATH 109,A01,083213,Ganzberger; Geoffrey Michael,3,0,34,31
1658073165018,MATH 109,A02,083214,Ganzberger; Geoffrey Michael,4,0,34,30
1658073165018,MATH 109,A03,093478,Ganzberger; Geoffrey Michael,2,0,34,32
1658073165018,MATH 109,B01,083215,Ganzberger; Geoffrey Michael,3,0,32,29
1658073165018,MATH 109,B02,083216,Ganzberger; Geoffrey Michael,3,0,32,29
1658073165018,MATH 109,B03,093479,Ganzberger; Geoffrey Michael,8,0,32,24
1658073171050,MATH 142A,A01,083219,Chow; Bennett,7,0,32,25
1658073171050,MATH 142A,A02,083220,Chow; Bennett,10,0,32,22
1658073171050,MATH 142A,A03,093480,Chow; Bennett,9,0,32,23
1658073171050,MATH 142A,B03,093481,Chow; Bennett,8,0,32,24
1658073171050,MATH 142A,B04,093558,Chow; Bennett,14,0,32,18
1658073171050,MATH 142A,B05,093559,Chow; Bennett,7,0,32,25
1658073177077,MATH 193A,A01,083224,Rotar; Vladimir,9,0,34,25
1658073177077,MATH 193A,A02,083225,Rotar; Vladimir,11,0,34,23
1658073177077,MATH 193A,A03,083781,Rotar; Vladimir,5,0,34,29
1658073177077,MATH 193A,A04,083782,Rotar; Vladimir,12,0,34,22
1658073177077,MATH 193A,A05,093482,Rotar; Vladimir,11,0,34,23
1658073183100,MATH 197,001,091859,McAuley; Julian John,9999,0,9999,0
1658073183100,MATH 197,002,095566,Kedlaya; Kiran S.,9997,0,9999,2
1658073183100,MATH 197,003,095567,Xiao; Ming,9999,0,9999,0
1658073183100,MATH 197,004,095571,Perols; Johan Lars,9998,0,9999,1
1658073190160,COGS 9,A01,083615,Shannon; Kyle Michael,11,0,75,64
1658073196185,COGS 11,A01,083617,Boyle; Mary E. T.,23,0,48,25
1658073202209,COGS 13,A01,083071,Bastos; Amalia Pinkusfeld,12,0,71,59
1658073208233,COGS 14A,A01,092681,Semenuks; Arturs,5,1,100,95
1658073214262,COGS 14B,A01,083073,Cheng; Tzu-Han,7,0,63,56
1658073220289,COGS 17,A01,092677,Semenuks; Arturs,7,0,81,74
1658073226317,COGS 100,A01,083619,Allen; Michael Gordon,17,0,70,53
1658073232344,COGS 101A,A01,083621,Davis; Joshua Daniel,9,0,68,59
1658073238372,COGS 101B,A01,091572,Allen; Michael Gordon,14,0,65,51
1658073244399,COGS 101C,A01,083625,Delgado; Tania,17,0,35,18
1658073250423,COGS 107A,A01,083627,Boyle; Mary E. T.,14,0,60,46
1658073256447,COGS 118A,A01,083075,Gupta; Anjum,21,0,76,55
1658073262476,CSE 3,A50,083646,Miranda; Gregory Joseph,24,0,50,26
1658073268500,CSE 8A,A50,083650,Miranda; Gregory Joseph,17,1,56,39
1658073274527,CSE 11,A01,083080,Cao; Yingjun,7,15,40,33
1658073280554,CSE 12,A01,083652,Krause-Levy; Sophia Louisa,30,1,120,90
1658073286578,CSE 15L,A01,083654,Morris; Justin Loren,9,0,50,41
1658073286578,CSE 15L,A02,083655,Morris; Justin Loren,11,0,50,39
1658073292601,CSE 20,A01,083657,Tran; Khoa Dang,39,0,80,41
1658073298628,CSE 21,A01,095574,Bach; Quang Tran,23,0,48,25
1658073304656,CSE 30,A01,083084,Eldon; John,8,0,80,72
1658073304656,CSE 30,B01,095061,Bhaskar; Nishant,9,0,50,41
1658073310684,CSE 100,A01,083659,Cao; Yingjun,5,4,70,65
1658073316706,CSE 134B,A01,083661,Powell; Thomas Allan,25,0,100,75
1658073322732,CSE 140,A01,083663,Gungor; Onat,17,0,85,68
1658073328829,CSE 140L,A01,083088,Eldon; John,23,0,100,77
1658073334853,CSE 175,A01,083665,Kumar; Rakesh,3,0,25,22
1658073340874,CSE 190,A00,092507,Dubnov; Shlomo,8,0,20,12
1658073346904,ECE 45,A01,083139,Congero; Spencer William,7,0,75,68
1658073352928,ECE 65,A50,083695,Saad; Andrew S,12,0,30,18
1658073352928,ECE 65,A51,095125,Saad; Andrew S,24,0,26,2
1658073358953,ECE 109,A01,091882,Touri; Behrouz,21,0,70,49
1658073364979,ECE 180,A00,083140,Abi Samra; Nicholas Camill,1,0,30,29
1658073364979,ECE 180,B00,083141,Abi Samra; Nicholas Camill,0,0,30,30
1658073371002,MATH 10A,A01,083735,Patchell; Gregory David,2,0,30,28
1658073371002,MATH 10A,A02,083736,Patchell; Gregory David,20,0,30,10
1658073371002,MATH 10A,A03,083737,Patchell; Gregory David,16,0,30,14
1658073377032,MATH 10B,A01,083207,Lim; Seonhee,9,0,34,25
1658073377032,MATH 10B,A02,083208,Lim; Seonhee,10,0,35,25
1658073377032,MATH 10B,A03,093472,Lim; Seonhee,7,0,34,27
1658073377032,MATH 10B,B01,083739,Sinha; Shubham,14,0,30,16
1658073383064,MATH 18,A01,083743,Cinel; Cameron Alexander,9,0,30,21
1658073383064,MATH 18,A02,083744,Cinel; Cameron Alexander,18,0,30,12
1658073383064,MATH 18,A03,083745,Cinel; Cameron Alexander,10,0,30,20
1658073383064,MATH 18,B01,083748,Rideout; David Porter,5,0,37,32
1658073383064,MATH 18,B02,083749,Rideout; David Porter,5,0,36,31
1658073383064,MATH 18,B03,083750,Rideout; David Porter,3,0,37,34
1658073383064,MATH 18,B04,083751,Rideout; David Porter,7,0,36,29
1658073383064,MATH 18,B05,093473,Rideout; David Porter,7,0,36,29
1658073383064,MATH 18,B06,093474,Rideout; David Porter,6,0,36,30
1658073389089,MATH 20A,A01,083754,Zheng; Zequn,14,0,40,26
1658073395116,MATH 20B,A01,083756,Briones; Jor-el Thomas Caparas,4,0,36,32
1658073395116,MATH 20B,A02,083757,Briones; Jor-el Thomas Caparas,1,0,36,35
1658073395116,MATH 20B,A03,093475,Briones; Jor-el Thomas Caparas,3,0,36,33
1658073401139,MATH 20C,A01,083760,Briones; Jor-el Thomas Caparas,1,0,35,34
1658073401139,MATH 20C,A02,083761,Briones; Jor-el Thomas Caparas,8,0,35,27
1658073401139,MATH 20C,A03,093476,Briones; Jor-el Thomas Caparas,0,1,36,36
1658073401139,MATH 20C,B01,083762,Bach; Quang Tran,1,0,30,29
1658073407164,MATH 20D,A01,083765,Tran; Brian Kha,5,0,30,25
1658073407164,MATH 20D,A02,083766,Tran; Brian Kha,5,0,30,25
1658073407164,MATH 20D,A03,083767,Tran; Brian Kha,6,0,30,24
1658073413192,MATH 20E,A01,083771,Ganguly; Soumya,12,0,32,20
1658073413192,MATH 20E,A02,083772,Ganguly; Soumya,7,0,32,25
1658073413192,MATH 20E,B01,083773,Ciotti; Benjamin,20,0,35,15
1658073413192,MATH 20E,B02,083774,Ciotti; Benjamin,18,0,35,17
1658073419223,MATH 103A,A01,083777,Greenfeld; Be'Eri,6,0,36,30
1658073419223,MATH 103A,A02,083778,Greenfeld; Be'Eri,5,0,36,31
1658073419223,MATH 103A,A03,093561,Greenfeld; Be'Eri,7,0,36,29
1658073419223,MATH 103A,B01,083779,Greenfeld; Be'Eri,8,0,36,28
1658073419223,MATH 103A,B02,083780,Greenfeld; Be'Eri,4,0,36,32
1658073419223,MATH 103A,B03,093562,Greenfeld; Be'Eri,3,0,36,33
1658073425255,MATH 105,A01,085443,Carter; Anne Toulson,15,0,35,20
1658073425255,MATH 105,A02,093477,Carter; Anne Toulson,20,0,35,15
1658073431280,MATH 109,A01,083213,Ganzberger; Geoffrey Michael,3,0,34,31
1658073431280,MATH 109,A02,083214,Ganzberger; Geoffrey Michael,4,0,34,30
1658073431280,MATH 109,A03,093478,Ganzberger; Geoffrey Michael,2,0,34,32
1658073431280,MATH 109,B01,083215,Ganzberger; Geoffrey Michael,3,0,32,29
1658073431280,MATH 109,B02,083216,Ganzberger; Geoffrey Michael,3,0,32,29
1658073431280,MATH 109,B03,093479,Ganzberger; Geoffrey Michael,8,0,32,24
1658073437304,MATH 142A,A01,083219,Chow; Bennett,7,0,32,25
1658073437304,MATH 142A,A02,083220,Chow; Bennett,10,0,32,22
1658073437304,MATH 142A,A03,093480,Chow; Bennett,9,0,32,23
1658073437304,MATH 142A,B03,093481,Chow; Bennett,8,0,32,24
1658073437304,MATH 142A,B04,093558,Chow; Bennett,14,0,32,18
1658073437304,MATH 142A,B05,093559,Chow; Bennett,7,0,32,25
1658073443329,MATH 193A,A01,083224,Rotar; Vladimir,9,0,34,25
1658073443329,MATH 193A,A02,083225,Rotar; Vladimir,11,0,34,23
1658073443329,MATH 193A,A03,083781,Rotar; Vladimir,5,0,34,29
1658073443329,MATH 193A,A04,083782,Rotar; Vladimir,12,0,34,22
1658073443329,MATH 193A,A05,093482,Rotar; Vladimir,11,0,34,23
1658073449353,MATH 197,001,091859,McAuley; Julian John,9999,0,9999,0
1658073449353,MATH 197,002,095566,Kedlaya; Kiran S.,9997,0,9999,2
1658073449353,MATH 197,003,095567,Xiao; Ming,9999,0,9999,0
1658073449353,MATH 197,004,095571,Perols; Johan Lars,9998,0,9999,1
1658073456422,COGS 9,A01,083615,Shannon; Kyle Michael,11,0,75,64
1658073462448,COGS 11,A01,083617,Boyle; Mary E. T.,23,0,48,25
1658073468471,COGS 13,A01,083071,Bastos; Amalia Pinkusfeld,12,0,71,59
1658073474496,COGS 14A,A01,092681,Semenuks; Arturs,5,1,100,95
1658073480522,COGS 14B,A01,083073,Cheng; Tzu-Han,7,0,63,56
1658073486547,COGS 17,A01,092677,Semenuks; Arturs,7,0,81,74
1658073492576,COGS 100,A01,083619,Allen; Michael Gordon,17,0,70,53
1658073498600,COGS 101A,A01,083621,Davis; Joshua Daniel,9,0,68,59
1658073504624,COGS 101B,A01,091572,Allen; Michael Gordon,14,0,65,51
1658073510651,COGS 101C,A01,083625,Delgado; Tania,17,0,35,18
1658073516674,COGS 107A,A01,083627,Boyle; Mary E. T.,14,0,60,46
1658073522703,COGS 118A,A01,083075,Gupta; Anjum,21,0,76,55
1658073528731,CSE 3,A50,083646,Miranda; Gregory Joseph,24,0,50,26
1658073534758,CSE 8A,A50,083650,Miranda; Gregory Joseph,17,1,56,39
1658073540783,CSE 11,A01,083080,Cao; Yingjun,7,15,40,33
1658073546807,CSE 12,A01,083652,Krause-Levy; Sophia Louisa,30,1,120,90
1658073552831,CSE 15L,A01,083654,Morris; Justin Loren,9,0,50,41
1658073552831,CSE 15L,A02,083655,Morris; Justin Loren,11,0,50,39
1658073558855,CSE 20,A01,083657,Tran; Khoa Dang,39,0,80,41
1658073564881,CSE 21,A01,095574,Bach; Quang Tran,23,0,48,25
1658073570906,CSE 30,A01,083084,Eldon; John,8,0,80,72
1658073570906,CSE 30,B01,095061,Bhaskar; Nishant,9,0,50,41
1658073576933,CSE 100,A01,083659,Cao; Yingjun,5,4,70,65
1658073582957,CSE 134B,A01,083661,Powell; Thomas Allan,25,0,100,75
1658073588981,CSE 140,A01,083663,Gungor; Onat,17,0,85,68
1658073595012,CSE 140L,A01,083088,Eldon; John,23,0,100,77
1658073601039,CSE 175,A01,083665,Kumar; Rakesh,3,0,25,22
1658073607065,CSE 190,A00,092507,Dubnov; Shlomo,8,0,20,12
1658073613093,ECE 45,A01,083139,Congero; Spencer William,7,0,75,68
1658073619117,ECE 65,A50,083695,Saad; Andrew S,12,0,30,18
1658073619117,ECE 65,A51,095125,Saad; Andrew S,24,0,26,2
1658073625140,ECE 109,A01,091882,Touri; Behrouz,21,0,70,49
1658073631168,ECE 180,A00,083140,Abi Samra; Nicholas Camill,1,0,30,29
1658073631168,ECE 180,B00,083141,Abi Samra; Nicholas Camill,0,0,30,30
1658073637192,MATH 10A,A01,083735,Patchell; Gregory David,2,0,30,28
1658073637192,MATH 10A,A02,083736,Patchell; Gregory David,20,0,30,10
1658073637192,MATH 10A,A03,083737,Patchell; Gregory David,16,0,30,14
1658073643216,MATH 10B,A01,083207,Lim; Seonhee,9,0,34,25
1658073643216,MATH 10B,A02,083208,Lim; Seonhee,10,0,35,25
1658073643216,MATH 10B,A03,093472,Lim; Seonhee,7,0,34,27
1658073643216,MATH 10B,B01,083739,Sinha; Shubham,14,0,30,16
1658073649248,MATH 18,A01,083743,Cinel; Cameron Alexander,9,0,30,21
1658073649248,MATH 18,A02,083744,Cinel; Cameron Alexander,18,0,30,12
1658073649248,MATH 18,A03,083745,Cinel; Cameron Alexander,10,0,30,20
1658073649248,MATH 18,B01,083748,Rideout; David Porter,5,0,37,32
1658073649248,MATH 18,B02,083749,Rideout; David Porter,5,0,36,31
1658073649248,MATH 18,B03,083750,Rideout; David Porter,3,0,37,34
1658073649248,MATH 18,B04,083751,Rideout; David Porter,7,0,36,29
1658073649248,MATH 18,B05,093473,Rideout; David Porter,7,0,36,29
1658073649248,MATH 18,B06,093474,Rideout; David Porter,6,0,36,30
1658073655272,MATH 20A,A01,083754,Zheng; Zequn,14,0,40,26
1658073661299,MATH 20B,A01,083756,Briones; Jor-el Thomas Caparas,4,0,36,32
1658073661299,MATH 20B,A02,083757,Briones; Jor-el Thomas Caparas,1,0,36,35
1658073661299,MATH 20B,A03,093475,Briones; Jor-el Thomas Caparas,3,0,36,33
1658073667324,MATH 20C,A01,083760,Briones; Jor-el Thomas Caparas,1,0,35,34
1658073667324,MATH 20C,A02,083761,Briones; Jor-el Thomas Caparas,8,0,35,27
1658073667324,MATH 20C,A03,093476,Briones; Jor-el Thomas Caparas,0,1,36,36
1658073667324,MATH 20C,B01,083762,Bach; Quang Tran,1,0,30,29
1658073673356,MATH 20D,A01,083765,Tran; Brian Kha,5,0,30,25
1658073673356,MATH 20D,A02,083766,Tran; Brian Kha,5,0,30,25
1658073673356,MATH 20D,A03,083767,Tran; Brian Kha,6,0,30,24
1658073679387,MATH 20E,A01,083771,Ganguly; Soumya,12,0,32,20
1658073679387,MATH 20E,A02,083772,Ganguly; Soumya,7,0,32,25
1658073679387,MATH 20E,B01,083773,Ciotti; Benjamin,20,0,35,15
1658073679387,MATH 20E,B02,083774,Ciotti; Benjamin,18,0,35,17
1658073685452,MATH 103A,A01,083777,Greenfeld; Be'Eri,6,0,36,30
1658073685452,MATH 103A,A02,083778,Greenfeld; Be'Eri,5,0,36,31
1658073685452,MATH 103A,A03,093561,Greenfeld; Be'Eri,7,0,36,29
1658073685452,MATH 103A,B01,083779,Greenfeld; Be'Eri,8,0,36,28
1658073685452,MATH 103A,B02,083780,Greenfeld; Be'Eri,4,0,36,32
1658073685452,MATH 103A,B03,093562,Greenfeld; Be'Eri,3,0,36,33
1658073691476,MATH 105,A01,085443,Carter; Anne Toulson,15,0,35,20
1658073691476,MATH 105,A02,093477,Carter; Anne Toulson,20,0,35,15
1658073697507,MATH 109,A01,083213,Ganzberger; Geoffrey Michael,3,0,34,31
1658073697507,MATH 109,A02,083214,Ganzberger; Geoffrey Michael,4,0,34,30
1658073697507,MATH 109,A03,093478,Ganzberger; Geoffrey Michael,2,0,34,32
1658073697507,MATH 109,B01,083215,Ganzberger; Geoffrey Michael,3,0,32,29
1658073697507,MATH 109,B02,083216,Ganzberger; Geoffrey Michael,3,0,32,29
1658073697507,MATH 109,B03,093479,Ganzberger; Geoffrey Michael,8,0,32,24
1658073703536,MATH 142A,A01,083219,Chow; Bennett,7,0,32,25
1658073703536,MATH 142A,A02,083220,Chow; Bennett,10,0,32,22
1658073703536,MATH 142A,A03,093480,Chow; Bennett,9,0,32,23
1658073703536,MATH 142A,B03,093481,Chow; Bennett,8,0,32,24
1658073703536,MATH 142A,B04,093558,Chow; Bennett,14,0,32,18
1658073703536,MATH 142A,B05,093559,Chow; Bennett,7,0,32,25
1658073709559,MATH 193A,A01,083224,Rotar; Vladimir,9,0,34,25
1658073709559,MATH 193A,A02,083225,Rotar; Vladimir,11,0,34,23
1658073709559,MATH 193A,A03,083781,Rotar; Vladimir,5,0,34,29
1658073709559,MATH 193A,A04,083782,Rotar; Vladimir,12,0,34,22
1658073709559,MATH 193A,A05,093482,Rotar; Vladimir,11,0,34,23
1658073715585,MATH 197,001,091859,McAuley; Julian John,9999,0,9999,0
1658073715585,MATH 197,002,095566,Kedlaya; Kiran S.,9997,0,9999,2
1658073715585,MATH 197,003,095567,Xiao; Ming,9999,0,9999,0
1658073715585,MATH 197,004,095571,Perols; Johan Lars,9998,0,9999,1
1658073722657,COGS 9,A01,083615,Shannon; Kyle Michael,11,0,75,64
1658073728683,COGS 11,A01,083617,Boyle; Mary E. T.,23,0,48,25
1658073734707,COGS 13,A01,083071,Bastos; Amalia Pinkusfeld,12,0,71,59
1658073740732,COGS 14A,A01,092681,Semenuks; Arturs,5,1,100,95
1658073746757,COGS 14B,A01,083073,Cheng; Tzu-Han,7,0,63,56
1658073752782,COGS 17,A01,092677,Semenuks; Arturs,7,0,81,74
1658073758813,COGS 100,A01,083619,Allen; Michael Gordon,17,0,70,53
1658073764839,COGS 101A,A01,083621,Davis; Joshua Daniel,9,0,68,59
1658073770866,COGS 101B,A01,091572,Allen; Michael Gordon,14,0,65,51
1658073776893,COGS 101C,A01,083625,Delgado; Tania,17,0,35,18
1658073782916,COGS 107A,A01,083627,Boyle; Mary E. T.,14,0,60,46
1658073788939,COGS 118A,A01,083075,Gupta; Anjum,21,0,76,55
1658073794966,CSE 3,A50,083646,Miranda; Gregory Joseph,24,0,50,26
1658073800991,CSE 8A,A50,083650,Miranda; Gregory Joseph,17,1,56,39
1658073807016,CSE 11,A01,083080,Cao; Yingjun,7,15,40,33
1658073813041,CSE 12,A01,083652,Krause-Levy; Sophia Louisa,30,1,120,90
1658073819065,CSE 15L,A01,083654,Morris; Justin Loren,9,0,50,41
1658073819065,CSE 15L,A02,083655,Morris; Justin Loren,11,0,50,39
1658073825088,CSE 20,A01,083657,Tran; Khoa Dang,39,0,80,41
1658073831116,CSE 21,A01,095574,Bach; Quang Tran,23,0,48,25
1658073837141,CSE 30,A01,083084,Eldon; John,8,0,80,72
1658073837141,CSE 30,B01,095061,Bhaskar; Nishant,9,0,50,41
1658073843166,CSE 100,A01,083659,Cao; Yingjun,5,4,70,65
1658073849196,CSE 134B,A01,083661,Powell; Thomas Allan,25,0,100,75
1658073855225,CSE 140,A01,083663,Gungor; Onat,17,0,85,68
1658073861259,CSE 140L,A01,083088,Eldon; John,23,0,100,77
1658073867283,CSE 175,A01,083665,Kumar; Rakesh,3,0,25,22
1658073873309,CSE 190,A00,092507,Dubnov; Shlomo,8,0,20,12
1658073879332,ECE 45,A01,083139,Congero; Spencer William,7,0,75,68
1658073885357,ECE 65,A50,083695,Saad; Andrew S,12,0,30,18
1658073885357,ECE 65,A51,095125,Saad; Andrew S,24,0,26,2
1658073891380,ECE 109,A01,091882,Touri; Behrouz,21,0,70,49
1658073897407,ECE 180,A00,083140,Abi Samra; Nicholas Camill,1,0,30,29
1658073897407,ECE 180,B00,083141,Abi Samra; Nicholas Camill,0,0,30,30
1658073903432,MATH 10A,A01,083735,Patchell; Gregory David,2,0,30,28
1658073903432,MATH 10A,A02,083736,Patchell; Gregory David,20,0,30,10
1658073903432,MATH 10A,A03,083737,Patchell; Gregory David,16,0,30,14
1658073909461,MATH 10B,A01,083207,Lim; Seonhee,9,0,34,25
1658073909461,MATH 10B,A02,083208,Lim; Seonhee,10,0,35,25
1658073909461,MATH 10B,A03,093472,Lim; Seonhee,7,0,34,27
1658073909461,MATH 10B,B01,083739,Sinha; Shubham,14,0,30,16
1658073915487,MATH 18,A01,083743,Cinel; Cameron Alexander,9,0,30,21
1658073915487,MATH 18,A02,083744,Cinel; Cameron Alexander,18,0,30,12
1658073915487,MATH 18,A03,083745,Cinel; Cameron Alexander,10,0,30,20
1658073915487,MATH 18,B01,083748,Rideout; David Porter,5,0,37,32
1658073915487,MATH 18,B02,083749,Rideout; David Porter,5,0,36,31
1658073915487,MATH 18,B03,083750,Rideout; David Porter,3,0,37,34
1658073915487,MATH 18,B04,083751,Rideout; David Porter,7,0,36,29
1658073915487,MATH 18,B05,093473,Rideout; David Porter,7,0,36,29
1658073915487,MATH 18,B06,093474,Rideout; David Porter,6,0,36,30
1658073921512,MATH 20A,A01,083754,Zheng; Zequn,14,0,40,26
1658073927613,MATH 20B,A01,083756,Briones; Jor-el Thomas Caparas,4,0,36,32
1658073927613,MATH 20B,A02,083757,Briones; Jor-el Thomas Caparas,1,0,36,35
1658073927613,MATH 20B,A03,093475,Briones; Jor-el Thomas Caparas,3,0,36,33
1658073933637,MATH 20C,A01,083760,Briones; Jor-el Thomas Caparas,1,0,35,34
1658073933637,MATH 20C,A02,083761,Briones; Jor-el Thomas Caparas,8,0,35,27
1658073933637,MATH 20C,A03,093476,Briones; Jor-el Thomas Caparas,0,1,36,36
1658073933637,MATH 20C,B01,083762,Bach; Quang Tran,1,0,30,29
1658073939661,MATH 20D,A01,083765,Tran; Brian Kha,5,0,30,25
1658073939661,MATH 20D,A02,083766,Tran; Brian Kha,5,0,30,25
1658073939661,MATH 20D,A03,083767,Tran; Brian Kha,6,0,30,24
1658073945685,MATH 20E,A01,083771,Ganguly; Soumya,12,0,32,20
1658073945685,MATH 20E,A02,083772,Ganguly; Soumya,7,0,32,25
1658073945685,MATH 20E,B01,083773,Ciotti; Benjamin,20,0,35,15
1658073945685,MATH 20E,B02,083774,Ciotti; Benjamin,18,0,35,17
1658073951721,MATH 103A,A01,083777,Greenfeld; Be'Eri,6,0,36,30
1658073951721,MATH 103A,A02,083778,Greenfeld; Be'Eri,5,0,36,31
1658073951721,MATH 103A,A03,093561,Greenfeld; Be'Eri,7,0,36,29
1658073951721,MATH 103A,B01,083779,Greenfeld; Be'Eri,8,0,36,28
1658073951721,MATH 103A,B02,083780,Greenfeld; Be'Eri,4,0,36,32
1658073951721,MATH 103A,B03,093562,Greenfeld; Be'Eri,3,0,36,33
1658073957746,MATH 105,A01,085443,Carter; Anne Toulson,15,0,35,20
1658073957746,MATH 105,A02,093477,Carter; Anne Toulson,20,0,35,15
1658073963772,MATH 109,A01,083213,Ganzberger; Geoffrey Michael,3,0,34,31
1658073963772,MATH 109,A02,083214,Ganzberger; Geoffrey Michael,4,0,34,30
1658073963772,MATH 109,A03,093478,Ganzberger; Geoffrey Michael,2,0,34,32
1658073963772,MATH 109,B01,083215,Ganzberger; Geoffrey Michael,3,0,32,29
1658073963772,MATH 109,B02,083216,Ganzberger; Geoffrey Michael,3,0,32,29
1658073963772,MATH 109,B03,093479,Ganzberger; Geoffrey Michael,8,0,32,24
1658073969802,MATH 142A,A01,083219,Chow; Bennett,7,0,32,25
1658073969802,MATH 142A,A02,083220,Chow; Bennett,10,0,32,22
1658073969802,MATH 142A,A03,093480,Chow; Bennett,9,0,32,23
1658073969802,MATH 142A,B03,093481,Chow; Bennett,8,0,32,24
1658073969802,MATH 142A,B04,093558,Chow; Bennett,14,0,32,18
1658073969802,MATH 142A,B05,093559,Chow; Bennett,7,0,32,25
1658073975831,MATH 193A,A01,083224,Rotar; Vladimir,9,0,34,25
1658073975831,MATH 193A,A02,083225,Rotar; Vladimir,11,0,34,23
1658073975831,MATH 193A,A03,083781,Rotar; Vladimir,5,0,34,29
1658073975831,MATH 193A,A04,083782,Rotar; Vladimir,12,0,34,22
1658073975831,MATH 193A,A05,093482,Rotar; Vladimir,11,0,34,23
1658073981855,MATH 197,001,091859,McAuley; Julian John,9999,0,9999,0
1658073981855,MATH 197,002,095566,Kedlaya; Kiran S.,9997,0,9999,2
1658073981855,MATH 197,003,095567,Xiao; Ming,9999,0,9999,0
1658073981855,MATH 197,004,095571,Perols; Johan Lars,9998,0,9999,1
1658073988922,COGS 9,A01,083615,Shannon; Kyle Michael,11,0,75,64
1658073994946,COGS 11,A01,083617,Boyle; Mary E. T.,23,0,48,25
1658074000969,COGS 13,A01,083071,Bastos; Amalia Pinkusfeld,12,0,71,59
1658074007009,COGS 14A,A01,092681,Semenuks; Arturs,5,1,100,95
1658074013038,COGS 14B,A01,083073,Cheng; Tzu-Han,7,0,63,56
1658074019065,COGS 17,A01,092677,Semenuks; Arturs,7,0,81,74
1658074025090,COGS 100,A01,083619,Allen; Michael Gordon,17,0,70,53
1658074031114,COGS 101A,A01,083621,Davis; Joshua Daniel,9,0,68,59
1658074037140,COGS 101B,A01,091572,Allen; Michael Gordon,14,0,65,51
1658074043167,COGS 101C,A01,083625,Delgado; Tania,17,0,35,18
1658074049195,COGS 107A,A01,083627,Boyle; Mary E. T.,14,0,60,46
1658074055220,COGS 118A,A01,083075,Gupta; Anjum,21,0,76,55
1658074061245,CSE 3,A50,083646,Miranda; Gregory Joseph,24,0,50,26
1658074067273,CSE 8A,A50,083650,Miranda; Gregory Joseph,17,1,56,39
1658074073299,CSE 11,A01,083080,Cao; Yingjun,7,15,40,33
1658074079323,CSE 12,A01,083652,Krause-Levy; Sophia Louisa,30,1,120,90
1658074085348,CSE 15L,A01,083654,Morris; Justin Loren,9,0,50,41
1658074085348,CSE 15L,A02,083655,Morris; Justin Loren,11,0,50,39
1658074091371,CSE 20,A01,083657,Tran; Khoa Dang,39,0,80,41
1658074097396,CSE 21,A01,095574,Bach; Quang Tran,23,0,48,25
1658074103420,CSE 30,A01,083084,Eldon; John,8,0,80,72
1658074103420,CSE 30,B01,095061,Bhaskar; Nishant,9,0,50,41
1658074109444,CSE 100,A01,083659,Cao; Yingjun,5,4,70,65
1658074115472,CSE 134B,A01,083661,Powell; Thomas Allan,25,0,100,75
1658074121501,CSE 140,A01,083663,Gungor; Onat,17,0,85,68
1658074127527,CSE 140L,A01,083088,Eldon; John,23,0,100,77
1658074133551,CSE 175,A01,083665,Kumar; Rakesh,3,0,25,22
1658074139575,CSE 190,A00,092507,Dubnov; Shlomo,8,0,20,12
1658074145605,ECE 45,A01,083139,Congero; Spencer William,7,0,75,68
1658074151629,ECE 65,A50,083695,Saad; Andrew S,12,0,30,18
1658074151629,ECE 65,A51,095125,Saad; Andrew S,24,0,26,2
1658074157655,ECE 109,A01,091882,Touri; Behrouz,21,0,70,49
1658074163689,ECE 180,A00,083140,Abi Samra; Nicholas Camill,1,0,30,29
1658074163689,ECE 180,B00,083141,Abi Samra; Nicholas Camill,0,0,30,30
1658074169714,MATH 10A,A01,083735,Patchell; Gregory David,2,0,30,28
1658074169714,MATH 10A,A02,083736,Patchell; Gregory David,20,0,30,10
1658074169714,MATH 10A,A03,083737,Patchell; Gregory David,16,0,30,14
1658074175740,MATH 10B,A01,083207,Lim; Seonhee,9,0,34,25
1658074175740,MATH 10B,A02,083208,Lim; Seonhee,10,0,35,25
1658074175740,MATH 10B,A03,093472,Lim; Seonhee,7,0,34,27
1658074175740,MATH 10B,B01,083739,Sinha; Shubham,14,0,30,16
1658074181765,MATH 18,A01,083743,Cinel; Cameron Alexander,9,0,30,21
1658074181765,MATH 18,A02,083744,Cinel; Cameron Alexander,18,0,30,12
1658074181765,MATH 18,A03,083745,Cinel; Cameron Alexander,10,0,30,20
1658074181765,MATH 18,B01,083748,Rideout; David Porter,5,0,37,32
1658074181765,MATH 18,B02,083749,Rideout; David Porter,5,0,36,31
1658074181765,MATH 18,B03,083750,Rideout; David Porter,3,0,37,34
1658074181765,MATH 18,B04,083751,Rideout; David Porter,7,0,36,29
1658074181765,MATH 18,B05,093473,Rideout; David Porter,7,0,36,29
1658074181765,MATH 18,B06,093474,Rideout; David Porter,6,0,36,30
1658074187789,MATH 20A,A01,083754,Zheng; Zequn,14,0,40,26
1658074193813,MATH 20B,A01,083756,Briones; Jor-el Thomas Caparas,4,0,36,32
1658074193813,MATH 20B,A02,083757,Briones; Jor-el Thomas Caparas,1,0,36,35
1658074193813,MATH 20B,A03,093475,Briones; Jor-el Thomas Caparas,3,0,36,33
1658074199845,MATH 20C,A01,083760,Briones; Jor-el Thomas Caparas,1,0,35,34
1658074199845,MATH 20C,A02,083761,Briones; Jor-el Thomas Caparas,8,0,35,27
1658074199845,MATH 20C,A03,093476,Briones; Jor-el Thomas Caparas,0,1,36,36
1658074199845,MATH 20C,B01,083762,Bach; Quang Tran,1,0,30,29
1658074205871,MATH 20D,A01,083765,Tran; Brian Kha,5,0,30,25
1658074205871,MATH 20D,A02,083766,Tran; Brian Kha,5,0,30,25
1658074205871,MATH 20D,A03,083767,Tran; Brian Kha,6,0,30,24
1658074211896,MATH 20E,A01,083771,Ganguly; Soumya,12,0,32,20
1658074211896,MATH 20E,A02,083772,Ganguly; Soumya,7,0,32,25
1658074211896,MATH 20E,B01,083773,Ciotti; Benjamin,20,0,35,15
1658074211896,MATH 20E,B02,083774,Ciotti; Benjamin,18,0,35,17
1658074217921,MATH 103A,A01,083777,Greenfeld; Be'Eri,6,0,36,30
1658074217921,MATH 103A,A02,083778,Greenfeld; Be'Eri,5,0,36,31
1658074217921,MATH 103A,A03,093561,Greenfeld; Be'Eri,7,0,36,29
1658074217921,MATH 103A,B01,083779,Greenfeld; Be'Eri,8,0,36,28
1658074217921,MATH 103A,B02,083780,Greenfeld; Be'Eri,4,0,36,32
1658074217921,MATH 103A,B03,093562,Greenfeld; Be'Eri,3,0,36,33
1658074223946,MATH 105,A01,085443,Carter; Anne Toulson,15,0,35,20
1658074223946,MATH 105,A02,093477,Carter; Anne Toulson,20,0,35,15
1658074229974,MATH 109,A01,083213,Ganzberger; Geoffrey Michael,3,0,34,31
1658074229974,MATH 109,A02,083214,Ganzberger; Geoffrey Michael,4,0,34,30
1658074229974,MATH 109,A03,093478,Ganzberger; Geoffrey Michael,2,0,34,32
1658074229974,MATH 109,B01,083215,Ganzberger; Geoffrey Michael,3,0,32,29
1658074229974,MATH 109,B02,083216,Ganzberger; Geoffrey Michael,3,0,32,29
1658074229974,MATH 109,B03,093479,Ganzberger; Geoffrey Michael,8,0,32,24
1658074236004,MATH 142A,A01,083219,Chow; Bennett,7,0,32,25
1658074236004,MATH 142A,A02,083220,Chow; Bennett,10,0,32,22
1658074236004,MATH 142A,A03,093480,Chow; Bennett,9,0,32,23
1658074236004,MATH 142A,B03,093481,Chow; Bennett,8,0,32,24
1658074236004,MATH 142A,B04,093558,Chow; Bennett,14,0,32,18
1658074236004,MATH 142A,B05,093559,Chow; Bennett,7,0,32,25
1658074242032,MATH 193A,A01,083224,Rotar; Vladimir,9,0,34,25
1658074242032,MATH 193A,A02,083225,Rotar; Vladimir,11,0,34,23
1658074242032,MATH 193A,A03,083781,Rotar; Vladimir,5,0,34,29
1658074242032,MATH 193A,A04,083782,Rotar; Vladimir,12,0,34,22
1658074242032,MATH 193A,A05,093482,Rotar; Vladimir,11,0,34,23
1658074248056,MATH 197,001,091859,McAuley; Julian John,9999,0,9999,0
1658074248056,MATH 197,002,095566,Kedlaya; Kiran S.,9997,0,9999,2
1658074248056,MATH 197,003,095567,Xiao; Ming,9999,0,9999,0
1658074248056,MATH 197,004,095571,Perols; Johan Lars,9998,0,9999,1
1658074255126,COGS 9,A01,083615,Shannon; Kyle Michael,11,0,75,64
1658074261151,COGS 11,A01,083617,Boyle; Mary E. T.,23,0,48,25
1658074267176,COGS 13,A01,083071,Bastos; Amalia Pinkusfeld,12,0,71,59
1658074273204,COGS 14A,A01,092681,Semenuks; Arturs,5,1,100,95
1658074279226,COGS 14B,A01,083073,Cheng; Tzu-Han,7,0,63,56
1658074285249,COGS 17,A01,092677,Semenuks; Arturs,7,0,81,74
1658074291274,COGS 100,A01,083619,Allen; Michael Gordon,17,0,70,53
1658074297298,COGS 101A,A01,083621,Davis; Joshua Daniel,9,0,68,59
1658074303328,COGS 101B,A01,091572,Allen; Michael Gordon,14,0,65,51
1658074309353,COGS 101C,A01,083625,Delgado; Tania,17,0,35,18
1658074315380,COGS 107A,A01,083627,Boyle; Mary E. T.,14,0,60,46
1658074321408,COGS 118A,A01,083075,Gupta; Anjum,21,0,76,55
1658074327433,CSE 3,A50,083646,Miranda; Gregory Joseph,24,0,50,26
1658074333458,CSE 8A,A50,083650,Miranda; Gregory Joseph,17,1,56,39
1658074339482,CSE 11,A01,083080,Cao; Yingjun,7,15,40,33
1658074345506,CSE 12,A01,083652,Krause-Levy; Sophia Louisa,30,1,120,90
1658074351529,CSE 15L,A01,083654,Morris; Justin Loren,9,0,50,41
1658074351529,CSE 15L,A02,083655,Morris; Justin Loren,11,0,50,39
1658074357556,CSE 20,A01,083657,Tran; Khoa Dang,39,0,80,41
1658074363580,CSE 21,A01,095574,Bach; Quang Tran,23,0,48,25
1658074369602,CSE 30,A01,083084,Eldon; John,8,0,80,72
1658074369602,CSE 30,B01,095061,Bhaskar; Nishant,9,0,50,41
1658074375627,CSE 100,A01,083659,Cao; Yingjun,5,4,70,65
1658074381649,CSE 134B,A01,083661,Powell; Thomas Allan,25,0,100,75
1658074387674,CSE 140,A01,083663,Gungor; Onat,17,0,85,68
1658074393699,CSE 140L,A01,083088,Eldon; John,23,0,100,77
1658074399727,CSE 175,A01,083665,Kumar; Rakesh,3,0,25,22
1658074405759,CSE 190,A00,092507,Dubnov; Shlomo,8,0,20,12
1658074411783,ECE 45,A01,083139,Congero; Spencer William,7,0,75,68
1658074417805,ECE 65,A50,083695,Saad; Andrew S,12,0,30,18
1658074417805,ECE 65,A51,095125,Saad; Andrew S,24,0,26,2
1658074423828,ECE 109,A01,091882,Touri; Behrouz,21,0,70,49
1658074429853,ECE 180,A00,083140,Abi Samra; Nicholas Camill,1,0,30,29
1658074429853,ECE 180,B00,083141,Abi Samra; Nicholas Camill,0,0,30,30
1658074435877,MATH 10A,A01,083735,Patchell; Gregory David,2,0,30,28
1658074435877,MATH 10A,A02,083736,Patchell; Gregory David,20,0,30,10
1658074435877,MATH 10A,A03,083737,Patchell; Gregory David,16,0,30,14
1658074441906,MATH 10B,A01,083207,Lim; Seonhee,9,0,34,25
1658074441906,MATH 10B,A02,083208,Lim; Seonhee,10,0,35,25
1658074441906,MATH 10B,A03,093472,Lim; Seonhee,7,0,34,27
1658074441906,MATH 10B,B01,083739,Sinha; Shubham,14,0,30,16
1658074447932,MATH 18,A01,083743,Cinel; Cameron Alexander,9,0,30,21
1658074447932,MATH 18,A02,083744,Cinel; Cameron Alexander,18,0,30,12
1658074447932,MATH 18,A03,083745,Cinel; Cameron Alexander,10,0,30,20
1658074447932,MATH 18,B01,083748,Rideout; David Porter,5,0,37,32
1658074447932,MATH 18,B02,083749,Rideout; David Porter,5,0,36,31
1658074447932,MATH 18,B03,083750,Rideout; David Porter,3,0,37,34
1658074447932,MATH 18,B04,083751,Rideout; David Porter,7,0,36,29
1658074447932,MATH 18,B05,093473,Rideout; David Porter,7,0,36,29
1658074447932,MATH 18,B06,093474,Rideout; David Porter,6,0,36,30
1658074453960,MATH 20A,A01,083754,Zheng; Zequn,14,0,40,26
1658074459983,MATH 20B,A01,083756,Briones; Jor-el Thomas Caparas,4,0,36,32
1658074459983,MATH 20B,A02,083757,Briones; Jor-el Thomas Caparas,1,0,36,35
1658074459983,MATH 20B,A03,093475,Briones; Jor-el Thomas Caparas,3,0,36,33
1658074466008,MATH 20C,A01,083760,Briones; Jor-el Thomas Caparas,1,0,35,34
1658074466008,MATH 20C,A02,083761,Briones; Jor-el Thomas Caparas,8,0,35,27
1658074466008,MATH 20C,A03,093476,Briones; Jor-el Thomas Caparas,0,1,36,36
1658074466008,MATH 20C,B01,083762,Bach; Quang Tran,1,0,30,29
1658074472031,MATH 20D,A01,083765,Tran; Brian Kha,5,0,30,25
1658074472031,MATH 20D,A02,083766,Tran; Brian Kha,5,0,30,25
1658074472031,MATH 20D,A03,083767,Tran; Brian Kha,6,0,30,24
1658074478061,MATH 20E,A01,083771,Ganguly; Soumya,12,0,32,20
1658074478061,MATH 20E,A02,083772,Ganguly; Soumya,7,0,32,25
1658074478061,MATH 20E,B01,083773,Ciotti; Benjamin,20,0,35,15
1658074478061,MATH 20E,B02,083774,Ciotti; Benjamin,18,0,35,17
1658074484091,MATH 103A,A01,083777,Greenfeld; Be'Eri,6,0,36,30
1658074484091,MATH 103A,A02,083778,Greenfeld; Be'Eri,5,0,36,31
1658074484091,MATH 103A,A03,093561,Greenfeld; Be'Eri,7,0,36,29
1658074484091,MATH 103A,B01,083779,Greenfeld; Be'Eri,8,0,36,28
1658074484091,MATH 103A,B02,083780,Greenfeld; Be'Eri,4,0,36,32
1658074484091,MATH 103A,B03,093562,Greenfeld; Be'Eri,3,0,36,33
1658074490115,MATH 105,A01,085443,Carter; Anne Toulson,15,0,35,20
1658074490115,MATH 105,A02,093477,Carter; Anne Toulson,20,0,35,15
1658074496145,MATH 109,A01,083213,Ganzberger; Geoffrey Michael,3,0,34,31
1658074496145,MATH 109,A02,083214,Ganzberger; Geoffrey Michael,4,0,34,30
1658074496145,MATH 109,A03,093478,Ganzberger; Geoffrey Michael,2,0,34,32
1658074496145,MATH 109,B01,083215,Ganzberger; Geoffrey Michael,3,0,32,29
1658074496145,MATH 109,B02,083216,Ganzberger; Geoffrey Michael,3,0,32,29
1658074496145,MATH 109,B03,093479,Ganzberger; Geoffrey Michael,8,0,32,24
1658074502174,MATH 142A,A01,083219,Chow; Bennett,7,0,32,25
1658074502174,MATH 142A,A02,083220,Chow; Bennett,10,0,32,22
1658074502174,MATH 142A,A03,093480,Chow; Bennett,9,0,32,23
1658074502174,MATH 142A,B03,093481,Chow; Bennett,8,0,32,24
1658074502174,MATH 142A,B04,093558,Chow; Bennett,14,0,32,18
1658074502174,MATH 142A,B05,093559,Chow; Bennett,7,0,32,25
1658074508197,MATH 193A,A01,083224,Rotar; Vladimir,9,0,34,25
1658074508197,MATH 193A,A02,083225,Rotar; Vladimir,11,0,34,23
1658074508197,MATH 193A,A03,083781,Rotar; Vladimir,5,0,34,29
1658074508197,MATH 193A,A04,083782,Rotar; Vladimir,12,0,34,22
1658074508197,MATH 193A,A05,093482,Rotar; Vladimir,11,0,34,23
1658074514222,MATH 197,001,091859,McAuley; Julian John,9999,0,9999,0
1658074514222,MATH 197,002,095566,Kedlaya; Kiran S.,9997,0,9999,2
1658074514222,MATH 197,003,095567,Xiao; Ming,9999,0,9999,0
1658074514222,MATH 197,004,095571,Perols; Johan Lars,9998,0,9999,1
1658074521372,COGS 9,A01,083615,Shannon; Kyle Michael,11,0,75,64
1658074527396,COGS 11,A01,083617,Boyle; Mary E. T.,23,0,48,25
1658074533418,COGS 13,A01,083071,Bastos; Amalia Pinkusfeld,12,0,71,59
1658074539445,COGS 14A,A01,092681,Semenuks; Arturs,5,1,100,95
1658074545469,COGS 14B,A01,083073,Cheng; Tzu-Han,7,0,63,56
1658074551494,COGS 17,A01,092677,Semenuks; Arturs,7,0,81,74
1658074557521,COGS 100,A01,083619,Allen; Michael Gordon,17,0,70,53
1658074563546,COGS 101A,A01,083621,Davis; Joshua Daniel,9,0,68,59
1658074569570,COGS 101B,A01,091572,Allen; Michael Gordon,14,0,65,51
1658074575596,COGS 101C,A01,083625,Delgado; Tania,17,0,35,18
1658074581620,COGS 107A,A01,083627,Boyle; Mary E. T.,14,0,60,46
1658074587645,COGS 118A,A01,083075,Gupta; Anjum,21,0,76,55
1658074593670,CSE 3,A50,083646,Miranda; Gregory Joseph,24,0,50,26
1658074599697,CSE 8A,A50,083650,Miranda; Gregory Joseph,17,1,56,39
1658074605727,CSE 11,A01,083080,Cao; Yingjun,7,15,40,33
1658074611754,CSE 12,A01,083652,Krause-Levy; Sophia Louisa,30,1,120,90
1658074617782,CSE 15L,A01,083654,Morris; Justin Loren,9,0,50,41
1658074617782,CSE 15L,A02,083655,Morris; Justin Loren,11,0,50,39
1658074623806,CSE 20,A01,083657,Tran; Khoa Dang,39,0,80,41
1658074629832,CSE 21,A01,095574,Bach; Quang Tran,23,0,48,25
1658074635857,CSE 30,A01,083084,Eldon; John,8,0,80,72
1658074635857,CSE 30,B01,095061,Bhaskar; Nishant,9,0,50,41
1658074641884,CSE 100,A01,083659,Cao; Yingjun,5,4,70,65
1658074647908,CSE 134B,A01,083661,Powell; Thomas Allan,25,0,100,75
1658074653932,CSE 140,A01,083663,Gungor; Onat,17,0,85,68
1658074659958,CSE 140L,A01,083088,Eldon; John,23,0,100,77
1658074665984,CSE 175,A01,083665,Kumar; Rakesh,3,0,25,22
1658074672048,CSE 190,A00,092507,Dubnov; Shlomo,8,0,20,12
1658074678077,ECE 45,A01,083139,Congero; Spencer William,7,0,75,68
1658074684101,ECE 65,A50,083695,Saad; Andrew S,12,0,30,18
1658074684101,ECE 65,A51,095125,Saad; Andrew S,24,0,26,2
1658074690126,ECE 109,A01,091882,Touri; Behrouz,21,0,70,49
1658074696152,ECE 180,A00,083140,Abi Samra; Nicholas Camill,1,0,30,29
1658074696152,ECE 180,B00,083141,Abi Samra; Nicholas Camill,0,0,30,30
1658074702176,MATH 10A,A01,083735,Patchell; Gregory David,2,0,30,28
1658074702176,MATH 10A,A02,083736,Patchell; Gregory David,20,0,30,10
1658074702176,MATH 10A,A03,083737,Patchell; Gregory David,16,0,30,14
1658074708200,MATH 10B,A01,083207,Lim; Seonhee,9,0,34,25
1658074708200,MATH 10B,A02,083208,Lim; Seonhee,10,0,35,25
1658074708200,MATH 10B,A03,093472,Lim; Seonhee,7,0,34,27
1658074708200,MATH 10B,B01,083739,Sinha; Shubham,14,0,30,16
1658074714226,MATH 18,A01,083743,Cinel; Cameron Alexander,9,0,30,21
1658074714226,MATH 18,A02,083744,Cinel; Cameron Alexander,18,0,30,12
1658074714226,MATH 18,A03,083745,Cinel; Cameron Alexander,10,0,30,20
1658074714226,MATH 18,B01,083748,Rideout; David Porter,5,0,37,32
1658074714226,MATH 18,B02,083749,Rideout; David Porter,5,0,36,31
1658074714226,MATH 18,B03,083750,Rideout; David Porter,3,0,37,34
1658074714226,MATH 18,B04,083751,Rideout; David Porter,7,0,36,29
1658074714226,MATH 18,B05,093473,Rideout; David Porter,7,0,36,29
1658074714226,MATH 18,B06,093474,Rideout; David Porter,6,0,36,30
1658074720253,MATH 20A,A01,083754,Zheng; Zequn,14,0,40,26
1658074726281,MATH 20B,A01,083756,Briones; Jor-el Thomas Caparas,4,0,36,32
1658074726281,MATH 20B,A02,083757,Briones; Jor-el Thomas Caparas,1,0,36,35
1658074726281,MATH 20B,A03,093475,Briones; Jor-el Thomas Caparas,3,0,36,33
1658074732306,MATH 20C,A01,083760,Briones; Jor-el Thomas Caparas,1,0,35,34
1658074732306,MATH 20C,A02,083761,Briones; Jor-el Thomas Caparas,8,0,35,27
1658074732306,MATH 20C,A03,093476,Briones; Jor-el Thomas Caparas,0,1,36,36
1658074732306,MATH 20C,B01,083762,Bach; Quang Tran,1,0,30,29
1658074738331,MATH 20D,A01,083765,Tran; Brian Kha,5,0,30,25
1658074738331,MATH 20D,A02,083766,Tran; Brian Kha,5,0,30,25
1658074738331,MATH 20D,A03,083767,Tran; Brian Kha,6,0,30,24
1658074744360,MATH 20E,A01,083771,Ganguly; Soumya,12,0,32,20
1658074744360,MATH 20E,A02,083772,Ganguly; Soumya,7,0,32,25
1658074744360,MATH 20E,B01,083773,Ciotti; Benjamin,20,0,35,15
1658074744360,MATH 20E,B02,083774,Ciotti; Benjamin,18,0,35,17
1658074750383,MATH 103A,A01,083777,Greenfeld; Be'Eri,6,0,36,30
1658074750383,MATH 103A,A02,083778,Greenfeld; Be'Eri,5,0,36,31
1658074750383,MATH 103A,A03,093561,Greenfeld; Be'Eri,7,0,36,29
1658074750383,MATH 103A,B01,083779,Greenfeld; Be'Eri,8,0,36,28
1658074750383,MATH 103A,B02,083780,Greenfeld; Be'Eri,4,0,36,32
1658074750383,MATH 103A,B03,093562,Greenfeld; Be'Eri,3,0,36,33
1658074756408,MATH 105,A01,085443,Carter; Anne Toulson,15,0,35,20
1658074756408,MATH 105,A02,093477,Carter; Anne Toulson,20,0,35,15
1658074762434,MATH 109,A01,083213,Ganzberger; Geoffrey Michael,3,0,34,31
1658074762434,MATH 109,A02,083214,Ganzberger; Geoffrey Michael,4,0,34,30
1658074762434,MATH 109,A03,093478,Ganzberger; Geoffrey Michael,2,0,34,32
1658074762434,MATH 109,B01,083215,Ganzberger; Geoffrey Michael,3,0,32,29
1658074762434,MATH 109,B02,083216,Ganzberger; Geoffrey Michael,3,0,32,29
1658074762434,MATH 109,B03,093479,Ganzberger; Geoffrey Michael,8,0,32,24
1658074768459,MATH 142A,A01,083219,Chow; Bennett,7,0,32,25
1658074768459,MATH 142A,A02,083220,Chow; Bennett,10,0,32,22
1658074768459,MATH 142A,A03,093480,Chow; Bennett,9,0,32,23
1658074768459,MATH 142A,B03,093481,Chow; Bennett,8,0,32,24
1658074768459,MATH 142A,B04,093558,Chow; Bennett,14,0,32,18
1658074768459,MATH 142A,B05,093559,Chow; Bennett,7,0,32,25
1658074774485,MATH 193A,A01,083224,Rotar; Vladimir,9,0,34,25
1658074774485,MATH 193A,A02,083225,Rotar; Vladimir,11,0,34,23
1658074774485,MATH 193A,A03,083781,Rotar; Vladimir,5,0,34,29
1658074774485,MATH 193A,A04,083782,Rotar; Vladimir,12,0,34,22
1658074774485,MATH 193A,A05,093482,Rotar; Vladimir,11,0,34,23
1658074780511,MATH 197,001,091859,McAuley; Julian John,9999,0,9999,0
1658074780511,MATH 197,002,095566,Kedlaya; Kiran S.,9997,0,9999,2
1658074780511,MATH 197,003,095567,Xiao; Ming,9999,0,9999,0
1658074780511,MATH 197,004,095571,Perols; Johan Lars,9998,0,9999,1
1658074787568,COGS 9,A01,083615,Shannon; Kyle Michael,11,0,75,64
1658074793593,COGS 11,A01,083617,Boyle; Mary E. T.,23,0,48,25
1658074799617,COGS 13,A01,083071,Bastos; Amalia Pinkusfeld,12,0,71,59
1658074805641,COGS 14A,A01,092681,Semenuks; Arturs,5,1,100,95
1658074811668,COGS 14B,A01,083073,Cheng; Tzu-Han,7,0,63,56
1658074817692,COGS 17,A01,092677,Semenuks; Arturs,7,0,81,74
1658074823715,COGS 100,A01,083619,Allen; Michael Gordon,17,0,70,53
1658074829740,COGS 101A,A01,083621,Davis; Joshua Daniel,9,0,68,59
1658074835766,COGS 101B,A01,091572,Allen; Michael Gordon,14,0,65,51
1658074841794,COGS 101C,A01,083625,Delgado; Tania,17,0,35,18
1658074847822,COGS 107A,A01,083627,Boyle; Mary E. T.,14,0,60,46
1658074853846,COGS 118A,A01,083075,Gupta; Anjum,21,0,76,55
1658074859868,CSE 3,A50,083646,Miranda; Gregory Joseph,24,0,50,26
1658074865897,CSE 8A,A50,083650,Miranda; Gregory Joseph,17,1,56,39
1658074871921,CSE 11,A01,083080,Cao; Yingjun,7,15,40,33
1658074877951,CSE 12,A01,083652,Krause-Levy; Sophia Louisa,30,1,120,90
1658074883975,CSE 15L,A01,083654,Morris; Justin Loren,9,0,50,41
1658074883975,CSE 15L,A02,083655,Morris; Justin Loren,11,0,50,39
1658074889999,CSE 20,A01,083657,Tran; Khoa Dang,39,0,80,41
1658074896023,CSE 21,A01,095574,Bach; Quang Tran,23,0,48,25
1658074902052,CSE 30,A01,083084,Eldon; John,8,0,80,72
1658074902052,CSE 30,B01,095061,Bhaskar; Nishant,9,0,50,41
1658074908090,CSE 100,A01,083659,Cao; Yingjun,5,4,70,65
1658074914118,CSE 134B,A01,083661,Powell; Thomas Allan,25,0,100,75
1658074920141,CSE 140,A01,083663,Gungor; Onat,17,0,85,68
1658074926176,CSE 140L,A01,083088,Eldon; John,23,0,100,77
1658074932205,CSE 175,A01,083665,Kumar; Rakesh,3,0,25,22
1658074938233,CSE 190,A00,092507,Dubnov; Shlomo,8,0,20,12
1658074944255,ECE 45,A01,083139,Congero; Spencer William,7,0,75,68
1658074950280,ECE 65,A50,083695,Saad; Andrew S,12,0,30,18
1658074950280,ECE 65,A51,095125,Saad; Andrew S,24,0,26,2
1658074956311,ECE 109,A01,091882,Touri; Behrouz,21,0,70,49
1658074962337,ECE 180,A00,083140,Abi Samra; Nicholas Camill,1,0,30,29
1658074962337,ECE 180,B00,083141,Abi Samra; Nicholas Camill,0,0,30,30
1658074968361,MATH 10A,A01,083735,Patchell; Gregory David,2,0,30,28
1658074968361,MATH 10A,A02,083736,Patchell; Gregory David,20,0,30,10
1658074968361,MATH 10A,A03,083737,Patchell; Gregory David,16,0,30,14
1658074974386,MATH 10B,A01,083207,Lim; Seonhee,9,0,34,25
1658074974386,MATH 10B,A02,083208,Lim; Seonhee,10,0,35,25
1658074974386,MATH 10B,A03,093472,Lim; Seonhee,7,0,34,27
1658074974386,MATH 10B,B01,083739,Sinha; Shubham,14,0,30,16
1658074980417,MATH 18,A01,083743,Cinel; Cameron Alexander,9,0,30,21
1658074980417,MATH 18,A02,083744,Cinel; Cameron Alexander,18,0,30,12
1658074980417,MATH 18,A03,083745,Cinel; Cameron Alexander,10,0,30,20
1658074980417,MATH 18,B01,083748,Rideout; David Porter,5,0,37,32
1658074980417,MATH 18,B02,083749,Rideout; David Porter,5,0,36,31
1658074980417,MATH 18,B03,083750,Rideout; David Porter,3,0,37,34
1658074980417,MATH 18,B04,083751,Rideout; David Porter,7,0,36,29
1658074980417,MATH 18,B05,093473,Rideout; David Porter,7,0,36,29
1658074980417,MATH 18,B06,093474,Rideout; David Porter,6,0,36,30
1658074986443,MATH 20A,A01,083754,Zheng; Zequn,14,0,40,26
1658074992484,MATH 20B,A01,083756,Briones; Jor-el Thomas Caparas,4,0,36,32
1658074992484,MATH 20B,A02,083757,Briones; Jor-el Thomas Caparas,1,0,36,35
1658074992484,MATH 20B,A03,093475,Briones; Jor-el Thomas Caparas,3,0,36,33
1658074998507,MATH 20C,A01,083760,Briones; Jor-el Thomas Caparas,1,0,35,34
1658074998507,MATH 20C,A02,083761,Briones; Jor-el Thomas Caparas,8,0,35,27
1658074998507,MATH 20C,A03,093476,Briones; Jor-el Thomas Caparas,0,1,36,36
1658074998507,MATH 20C,B01,083762,Bach; Quang Tran,1,0,30,29
1658075004538,MATH 20D,A01,083765,Tran; Brian Kha,5,0,30,25
1658075004538,MATH 20D,A02,083766,Tran; Brian Kha,5,0,30,25
1658075004538,MATH 20D,A03,083767,Tran; Brian Kha,6,0,30,24
1658075010568,MATH 20E,A01,083771,Ganguly; Soumya,12,0,32,20
1658075010568,MATH 20E,A02,083772,Ganguly; Soumya,7,0,32,25
1658075010568,MATH 20E,B01,083773,Ciotti; Benjamin,20,0,35,15
1658075010568,MATH 20E,B02,083774,Ciotti; Benjamin,18,0,35,17
1658075016592,MATH 103A,A01,083777,Greenfeld; Be'Eri,6,0,36,30
1658075016592,MATH 103A,A02,083778,Greenfeld; Be'Eri,5,0,36,31
1658075016592,MATH 103A,A03,093561,Greenfeld; Be'Eri,7,0,36,29
1658075016592,MATH 103A,B01,083779,Greenfeld; Be'Eri,8,0,36,28
1658075016592,MATH 103A,B02,083780,Greenfeld; Be'Eri,4,0,36,32
1658075016592,MATH 103A,B03,093562,Greenfeld; Be'Eri,3,0,36,33
1658075022621,MATH 105,A01,085443,Carter; Anne Toulson,15,0,35,20
1658075022621,MATH 105,A02,093477,Carter; Anne Toulson,20,0,35,15
1658075028651,MATH 109,A01,083213,Ganzberger; Geoffrey Michael,3,0,34,31
1658075028651,MATH 109,A02,083214,Ganzberger; Geoffrey Michael,4,0,34,30
1658075028651,MATH 109,A03,093478,Ganzberger; Geoffrey Michael,2,0,34,32
1658075028651,MATH 109,B01,083215,Ganzberger; Geoffrey Michael,3,0,32,29
1658075028651,MATH 109,B02,083216,Ganzberger; Geoffrey Michael,3,0,32,29
1658075028651,MATH 109,B03,093479,Ganzberger; Geoffrey Michael,8,0,32,24
1658075034681,MATH 142A,A01,083219,Chow; Bennett,7,0,32,25
1658075034681,MATH 142A,A02,083220,Chow; Bennett,10,0,32,22
1658075034681,MATH 142A,A03,093480,Chow; Bennett,9,0,32,23
1658075034681,MATH 142A,B03,093481,Chow; Bennett,8,0,32,24
1658075034681,MATH 142A,B04,093558,Chow; Bennett,14,0,32,18
1658075034681,MATH 142A,B05,093559,Chow; Bennett,7,0,32,25
1658075040705,MATH 193A,A01,083224,Rotar; Vladimir,9,0,34,25
1658075040705,MATH 193A,A02,083225,Rotar; Vladimir,11,0,34,23
1658075040705,MATH 193A,A03,083781,Rotar; Vladimir,5,0,34,29
1658075040705,MATH 193A,A04,083782,Rotar; Vladimir,12,0,34,22
1658075040705,MATH 193A,A05,093482,Rotar; Vladimir,11,0,34,23
1658075046729,MATH 197,001,091859,McAuley; Julian John,9999,0,9999,0
1658075046729,MATH 197,002,095566,Kedlaya; Kiran S.,9997,0,9999,2
1658075046729,MATH 197,003,095567,Xiao; Ming,9999,0,9999,0
1658075046729,MATH 197,004,095571,Perols; Johan Lars,9998,0,9999,1
1658075053785,COGS 9,A01,083615,Shannon; Kyle Michael,11,0,75,64
1658075059813,COGS 11,A01,083617,Boyle; Mary E. T.,23,0,48,25
1658075065837,COGS 13,A01,083071,Bastos; Amalia Pinkusfeld,12,0,71,59
1658075071862,COGS 14A,A01,092681,Semenuks; Arturs,5,1,100,95
1658075077885,COGS 14B,A01,083073,Cheng; Tzu-Han,7,0,63,56
1658075083908,COGS 17,A01,092677,Semenuks; Arturs,7,0,81,74
1658075089933,COGS 100,A01,083619,Allen; Michael Gordon,17,0,70,53
1658075095958,COGS 101A,A01,083621,Davis; Joshua Daniel,9,0,68,59
1658075102005,COGS 101B,A01,091572,Allen; Michael Gordon,14,0,65,51
1658075108027,COGS 101C,A01,083625,Delgado; Tania,17,0,35,18
1658075114054,COGS 107A,A01,083627,Boyle; Mary E. T.,14,0,60,46
1658075120153,COGS 118A,A01,083075,Gupta; Anjum,21,0,76,55
1658075126177,CSE 3,A50,083646,Miranda; Gregory Joseph,24,0,50,26
1658075132207,CSE 8A,A50,083650,Miranda; Gregory Joseph,17,1,56,39
1658075138232,CSE 11,A01,083080,Cao; Yingjun,7,15,40,33
1658075144253,CSE 12,A01,083652,Krause-Levy; Sophia Louisa,30,1,120,90
1658075150276,CSE 15L,A01,083654,Morris; Justin Loren,9,0,50,41
1658075150276,CSE 15L,A02,083655,Morris; Justin Loren,11,0,50,39
1658075156298,CSE 20,A01,083657,Tran; Khoa Dang,39,0,80,41
1658075162356,CSE 21,A01,095574,Bach; Quang Tran,23,0,48,25
1658075168382,CSE 30,A01,083084,Eldon; John,8,0,80,72
1658075168382,CSE 30,B01,095061,Bhaskar; Nishant,9,0,50,41
1658075174406,CSE 100,A01,083659,Cao; Yingjun,5,4,70,65
1658075180435,CSE 134B,A01,083661,Powell; Thomas Allan,25,0,100,75
1658075186458,CSE 140,A01,083663,Gungor; Onat,17,0,85,68
1658075192483,CSE 140L,A01,083088,Eldon; John,23,0,100,77
1658075198510,CSE 175,A01,083665,Kumar; Rakesh,3,0,25,22
1658075204535,CSE 190,A00,092507,Dubnov; Shlomo,8,0,20,12
1658075210560,ECE 45,A01,083139,Congero; Spencer William,7,0,75,68
1658075216584,ECE 65,A50,083695,Saad; Andrew S,12,0,30,18
1658075216584,ECE 65,A51,095125,Saad; Andrew S,24,0,26,2
1658075222612,ECE 109,A01,091882,Touri; Behrouz,21,0,70,49
1658075228637,ECE 180,A00,083140,Abi Samra; Nicholas Camill,1,0,30,29
1658075228637,ECE 180,B00,083141,Abi Samra; Nicholas Camill,0,0,30,30
1658075234663,MATH 10A,A01,083735,Patchell; Gregory David,2,0,30,28
1658075234663,MATH 10A,A02,083736,Patchell; Gregory David,20,0,30,10
1658075234663,MATH 10A,A03,083737,Patchell; Gregory David,16,0,30,14
1658075240688,MATH 10B,A01,083207,Lim; Seonhee,9,0,34,25
1658075240688,MATH 10B,A02,083208,Lim; Seonhee,10,0,35,25
1658075240688,MATH 10B,A03,093472,Lim; Seonhee,7,0,34,27
1658075240688,MATH 10B,B01,083739,Sinha; Shubham,14,0,30,16
1658075246713,MATH 18,A01,083743,Cinel; Cameron Alexander,9,0,30,21
1658075246713,MATH 18,A02,083744,Cinel; Cameron Alexander,18,0,30,12
1658075246713,MATH 18,A03,083745,Cinel; Cameron Alexander,10,0,30,20
1658075246713,MATH 18,B01,083748,Rideout; David Porter,5,0,37,32
1658075246713,MATH 18,B02,083749,Rideout; David Porter,5,0,36,31
1658075246713,MATH 18,B03,083750,Rideout; David Porter,3,0,37,34
1658075246713,MATH 18,B04,083751,Rideout; David Porter,7,0,36,29
1658075246713,MATH 18,B05,093473,Rideout; David Porter,7,0,36,29
1658075246713,MATH 18,B06,093474,Rideout; David Porter,6,0,36,30
1658075252736,MATH 20A,A01,083754,Zheng; Zequn,14,0,40,26
1658075258764,MATH 20B,A01,083756,Briones; Jor-el Thomas Caparas,4,0,36,32
1658075258764,MATH 20B,A02,083757,Briones; Jor-el Thomas Caparas,1,0,36,35
1658075258764,MATH 20B,A03,093475,Briones; Jor-el Thomas Caparas,3,0,36,33
1658075264793,MATH 20C,A01,083760,Briones; Jor-el Thomas Caparas,1,0,35,34
1658075264793,MATH 20C,A02,083761,Briones; Jor-el Thomas Caparas,8,0,35,27
1658075264793,MATH 20C,A03,093476,Briones; Jor-el Thomas Caparas,0,1,36,36
1658075264793,MATH 20C,B01,083762,Bach; Quang Tran,1,0,30,29
1658075270817,MATH 20D,A01,083765,Tran; Brian Kha,5,0,30,25
1658075270817,MATH 20D,A02,083766,Tran; Brian Kha,5,0,30,25
1658075270817,MATH 20D,A03,083767,Tran; Brian Kha,6,0,30,24
1658075276841,MATH 20E,A01,083771,Ganguly; Soumya,12,0,32,20
1658075276841,MATH 20E,A02,083772,Ganguly; Soumya,7,0,32,25
1658075276841,MATH 20E,B01,083773,Ciotti; Benjamin,20,0,35,15
1658075276841,MATH 20E,B02,083774,Ciotti; Benjamin,18,0,35,17
1658075282867,MATH 103A,A01,083777,Greenfeld; Be'Eri,6,0,36,30
1658075282867,MATH 103A,A02,083778,Greenfeld; Be'Eri,5,0,36,31
1658075282867,MATH 103A,A03,093561,Greenfeld; Be'Eri,7,0,36,29
1658075282867,MATH 103A,B01,083779,Greenfeld; Be'Eri,8,0,36,28
1658075282867,MATH 103A,B02,083780,Greenfeld; Be'Eri,4,0,36,32
1658075282867,MATH 103A,B03,093562,Greenfeld; Be'Eri,3,0,36,33
1658075288894,MATH 105,A01,085443,Carter; Anne Toulson,15,0,35,20
1658075288894,MATH 105,A02,093477,Carter; Anne Toulson,20,0,35,15
1658075294917,MATH 109,A01,083213,Ganzberger; Geoffrey Michael,3,0,34,31
1658075294917,MATH 109,A02,083214,Ganzberger; Geoffrey Michael,4,0,34,30
1658075294917,MATH 109,A03,093478,Ganzberger; Geoffrey Michael,2,0,34,32
1658075294917,MATH 109,B01,083215,Ganzberger; Geoffrey Michael,3,0,32,29
1658075294917,MATH 109,B02,083216,Ganzberger; Geoffrey Michael,3,0,32,29
1658075294917,MATH 109,B03,093479,Ganzberger; Geoffrey Michael,8,0,32,24
1658075300943,MATH 142A,A01,083219,Chow; Bennett,7,0,32,25
1658075300943,MATH 142A,A02,083220,Chow; Bennett,10,0,32,22
1658075300943,MATH 142A,A03,093480,Chow; Bennett,9,0,32,23
1658075300943,MATH 142A,B03,093481,Chow; Bennett,8,0,32,24
1658075300943,MATH 142A,B04,093558,Chow; Bennett,14,0,32,18
1658075300943,MATH 142A,B05,093559,Chow; Bennett,7,0,32,25
1658075306978,MATH 193A,A01,083224,Rotar; Vladimir,9,0,34,25
1658075306978,MATH 193A,A02,083225,Rotar; Vladimir,11,0,34,23
1658075306978,MATH 193A,A03,083781,Rotar; Vladimir,5,0,34,29
1658075306978,MATH 193A,A04,083782,Rotar; Vladimir,12,0,34,22
1658075306978,MATH 193A,A05,093482,Rotar; Vladimir,11,0,34,23
1658075313007,MATH 197,001,091859,McAuley; Julian John,9999,0,9999,0
1658075313007,MATH 197,002,095566,Kedlaya; Kiran S.,9997,0,9999,2
1658075313007,MATH 197,003,095567,Xiao; Ming,9999,0,9999,0
1658075313007,MATH 197,004,095571,Perols; Johan Lars,9998,0,9999,1
1658075320073,COGS 9,A01,083615,Shannon; Kyle Michael,11,0,75,64
1658075326098,COGS 11,A01,083617,Boyle; Mary E. T.,23,0,48,25
1658075332123,COGS 13,A01,083071,Bastos; Amalia Pinkusfeld,12,0,71,59
1658075338146,COGS 14A,A01,092681,Semenuks; Arturs,5,1,100,95
1658075344169,COGS 14B,A01,083073,Cheng; Tzu-Han,7,0,63,56
1658075350193,COGS 17,A01,092677,Semenuks; Arturs,7,0,81,74
1658075356222,COGS 100,A01,083619,Allen; Michael Gordon,17,0,70,53
1658075362246,COGS 101A,A01,083621,Davis; Joshua Daniel,9,0,68,59
1658075368273,COGS 101B,A01,091572,Allen; Michael Gordon,14,0,65,51
1658075374298,COGS 101C,A01,083625,Delgado; Tania,17,0,35,18
1658075380323,COGS 107A,A01,083627,Boyle; Mary E. T.,14,0,60,46
1658075386349,COGS 118A,A01,083075,Gupta; Anjum,21,0,76,55
1658075392375,CSE 3,A50,083646,Miranda; Gregory Joseph,24,0,50,26
1658075398399,CSE 8A,A50,083650,Miranda; Gregory Joseph,17,1,56,39
1658075404422,CSE 11,A01,083080,Cao; Yingjun,7,15,40,33
1658075410446,CSE 12,A01,083652,Krause-Levy; Sophia Louisa,30,1,120,90
1658075416476,CSE 15L,A01,083654,Morris; Justin Loren,9,0,50,41
1658075416476,CSE 15L,A02,083655,Morris; Justin Loren,11,0,50,39
1658075422503,CSE 20,A01,083657,Tran; Khoa Dang,39,0,80,41
1658075428526,CSE 21,A01,095574,Bach; Quang Tran,23,0,48,25
1658075434555,CSE 30,A01,083084,Eldon; John,8,0,80,72
1658075434555,CSE 30,B01,095061,Bhaskar; Nishant,9,0,50,41
1658075440579,CSE 100,A01,083659,Cao; Yingjun,5,4,70,65
1658075446606,CSE 134B,A01,083661,Powell; Thomas Allan,25,0,100,75
1658075452629,CSE 140,A01,083663,Gungor; Onat,17,0,85,68
1658075458653,CSE 140L,A01,083088,Eldon; John,23,0,100,77
1658075464678,CSE 175,A01,083665,Kumar; Rakesh,3,0,25,22
1658075470700,CSE 190,A00,092507,Dubnov; Shlomo,8,0,20,12
1658075476723,ECE 45,A01,083139,Congero; Spencer William,7,0,75,68
1658075482750,ECE 65,A50,083695,Saad; Andrew S,12,0,30,18
1658075482750,ECE 65,A51,095125,Saad; Andrew S,24,0,26,2
1658075488774,ECE 109,A01,091882,Touri; Behrouz,21,0,70,49
1658075494798,ECE 180,A00,083140,Abi Samra; Nicholas Camill,1,0,30,29
1658075494798,ECE 180,B00,083141,Abi Samra; Nicholas Camill,0,0,30,30
1658075500821,MATH 10A,A01,083735,Patchell; Gregory David,2,0,30,28
1658075500821,MATH 10A,A02,083736,Patchell; Gregory David,20,0,30,10
1658075500821,MATH 10A,A03,083737,Patchell; Gregory David,16,0,30,14
1658075506850,MATH 10B,A01,083207,Lim; Seonhee,9,0,34,25
1658075506850,MATH 10B,A02,083208,Lim; Seonhee,10,0,35,25
1658075506850,MATH 10B,A03,093472,Lim; Seonhee,7,0,34,27
1658075506850,MATH 10B,B01,083739,Sinha; Shubham,14,0,30,16
1658075512882,MATH 18,A01,083743,Cinel; Cameron Alexander,9,0,30,21
1658075512882,MATH 18,A02,083744,Cinel; Cameron Alexander,18,0,30,12
1658075512882,MATH 18,A03,083745,Cinel; Cameron Alexander,10,0,30,20
1658075512882,MATH 18,B01,083748,Rideout; David Porter,5,0,37,32
1658075512882,MATH 18,B02,083749,Rideout; David Porter,5,0,36,31
1658075512882,MATH 18,B03,083750,Rideout; David Porter,3,0,37,34
1658075512882,MATH 18,B04,083751,Rideout; David Porter,7,0,36,29
1658075512882,MATH 18,B05,093473,Rideout; David Porter,7,0,36,29
1658075512882,MATH 18,B06,093474,Rideout; David Porter,6,0,36,30
1658075518906,MATH 20A,A01,083754,Zheng; Zequn,14,0,40,26
1658075524930,MATH 20B,A01,083756,Briones; Jor-el Thomas Caparas,4,0,36,32
1658075524930,MATH 20B,A02,083757,Briones; Jor-el Thomas Caparas,1,0,36,35
1658075524930,MATH 20B,A03,093475,Briones; Jor-el Thomas Caparas,3,0,36,33
1658075530957,MATH 20C,A01,083760,Briones; Jor-el Thomas Caparas,1,0,35,34
1658075530957,MATH 20C,A02,083761,Briones; Jor-el Thomas Caparas,8,0,35,27
1658075530957,MATH 20C,A03,093476,Briones; Jor-el Thomas Caparas,0,1,36,36
1658075530957,MATH 20C,B01,083762,Bach; Quang Tran,1,0,30,29
1658075536980,MATH 20D,A01,083765,Tran; Brian Kha,5,0,30,25
1658075536980,MATH 20D,A02,083766,Tran; Brian Kha,5,0,30,25
1658075536980,MATH 20D,A03,083767,Tran; Brian Kha,6,0,30,24
1658075543004,MATH 20E,A01,083771,Ganguly; Soumya,12,0,32,20
1658075543004,MATH 20E,A02,083772,Ganguly; Soumya,7,0,32,25
1658075543004,MATH 20E,B01,083773,Ciotti; Benjamin,20,0,35,15
1658075543004,MATH 20E,B02,083774,Ciotti; Benjamin,18,0,35,17
1658075549034,MATH 103A,A01,083777,Greenfeld; Be'Eri,6,0,36,30
1658075549034,MATH 103A,A02,083778,Greenfeld; Be'Eri,5,0,36,31
1658075549034,MATH 103A,A03,093561,Greenfeld; Be'Eri,7,0,36,29
1658075549034,MATH 103A,B01,083779,Greenfeld; Be'Eri,8,0,36,28
1658075549034,MATH 103A,B02,083780,Greenfeld; Be'Eri,4,0,36,32
1658075549034,MATH 103A,B03,093562,Greenfeld; Be'Eri,3,0,36,33
1658075555060,MATH 105,A01,085443,Carter; Anne Toulson,15,0,35,20
1658075555060,MATH 105,A02,093477,Carter; Anne Toulson,20,0,35,15
1658075561085,MATH 109,A01,083213,Ganzberger; Geoffrey Michael,3,0,34,31
1658075561085,MATH 109,A02,083214,Ganzberger; Geoffrey Michael,4,0,34,30
1658075561085,MATH 109,A03,093478,Ganzberger; Geoffrey Michael,2,0,34,32
1658075561085,MATH 109,B01,083215,Ganzberger; Geoffrey Michael,3,0,32,29
1658075561085,MATH 109,B02,083216,Ganzberger; Geoffrey Michael,3,0,32,29
1658075561085,MATH 109,B03,093479,Ganzberger; Geoffrey Michael,8,0,32,24
1658075567115,MATH 142A,A01,083219,Chow; Bennett,7,0,32,25
1658075567115,MATH 142A,A02,083220,Chow; Bennett,10,0,32,22
1658075567115,MATH 142A,A03,093480,Chow; Bennett,9,0,32,23
1658075567115,MATH 142A,B03,093481,Chow; Bennett,8,0,32,24
1658075567115,MATH 142A,B04,093558,Chow; Bennett,14,0,32,18
1658075567115,MATH 142A,B05,093559,Chow; Bennett,7,0,32,25
1658075573152,MATH 193A,A01,083224,Rotar; Vladimir,9,0,34,25
1658075573152,MATH 193A,A02,083225,Rotar; Vladimir,11,0,34,23
1658075573152,MATH 193A,A03,083781,Rotar; Vladimir,5,0,34,29
1658075573152,MATH 193A,A04,083782,Rotar; Vladimir,12,0,34,22
1658075573152,MATH 193A,A05,093482,Rotar; Vladimir,11,0,34,23
1658075579180,MATH 197,001,091859,McAuley; Julian John,9999,0,9999,0
1658075579180,MATH 197,002,095566,Kedlaya; Kiran S.,9997,0,9999,2
1658075579180,MATH 197,003,095567,Xiao; Ming,9999,0,9999,0
1658075579180,MATH 197,004,095571,Perols; Johan Lars,9998,0,9999,1
1658075586251,COGS 9,A01,083615,Shannon; Kyle Michael,11,0,75,64
1658075592277,COGS 11,A01,083617,Boyle; Mary E. T.,23,0,48,25
1658075598300,COGS 13,A01,083071,Bastos; Amalia Pinkusfeld,12,0,71,59
1658075604324,COGS 14A,A01,092681,Semenuks; Arturs,5,1,100,95
1658075610347,COGS 14B,A01,083073,Cheng; Tzu-Han,7,0,63,56
1658075616370,COGS 17,A01,092677,Semenuks; Arturs,7,0,81,74
1658075622397,COGS 100,A01,083619,Allen; Michael Gordon,17,0,70,53
1658075628420,COGS 101A,A01,083621,Davis; Joshua Daniel,9,0,68,59
1658075634452,COGS 101B,A01,091572,Allen; Michael Gordon,14,0,65,51
1658075640480,COGS 101C,A01,083625,Delgado; Tania,17,0,35,18
1658075646508,COGS 107A,A01,083627,Boyle; Mary E. T.,14,0,60,46
1658075652530,COGS 118A,A01,083075,Gupta; Anjum,21,0,76,55
1658075658555,CSE 3,A50,083646,Miranda; Gregory Joseph,24,0,50,26
1658075664580,CSE 8A,A50,083650,Miranda; Gregory Joseph,17,1,56,39
1658075670604,CSE 11,A01,083080,Cao; Yingjun,7,15,40,33
1658075676628,CSE 12,A01,083652,Krause-Levy; Sophia Louisa,30,1,120,90
1658075682655,CSE 15L,A01,083654,Morris; Justin Loren,9,0,50,41
1658075682655,CSE 15L,A02,083655,Morris; Justin Loren,11,0,50,39
1658075688679,CSE 20,A01,083657,Tran; Khoa Dang,39,0,80,41
1658075694703,CSE 21,A01,095574,Bach; Quang Tran,23,0,48,25
1658075700728,CSE 30,A01,083084,Eldon; John,8,0,80,72
1658075700728,CSE 30,B01,095061,Bhaskar; Nishant,9,0,50,41
1658075706752,CSE 100,A01,083659,Cao; Yingjun,5,4,70,65
1658075712776,CSE 134B,A01,083661,Powell; Thomas Allan,25,0,100,75
1658075718877,CSE 140,A01,083663,Gungor; Onat,17,0,85,68
1658075724904,CSE 140L,A01,083088,Eldon; John,23,0,100,77
1658075730931,CSE 175,A01,083665,Kumar; Rakesh,3,0,25,22
1658075736954,CSE 190,A00,092507,Dubnov; Shlomo,8,0,20,12
1658075742979,ECE 45,A01,083139,Congero; Spencer William,7,0,75,68
1658075749004,ECE 65,A50,083695,Saad; Andrew S,12,0,30,18
1658075749004,ECE 65,A51,095125,Saad; Andrew S,24,0,26,2
1658075755030,ECE 109,A01,091882,Touri; Behrouz,21,0,70,49
1658075761054,ECE 180,A00,083140,Abi Samra; Nicholas Camill,1,0,30,29
1658075761054,ECE 180,B00,083141,Abi Samra; Nicholas Camill,0,0,30,30
1658075767081,MATH 10A,A01,083735,Patchell; Gregory David,2,0,30,28
1658075767081,MATH 10A,A02,083736,Patchell; Gregory David,20,0,30,10
1658075767081,MATH 10A,A03,083737,Patchell; Gregory David,16,0,30,14
1658075773112,MATH 10B,A01,083207,Lim; Seonhee,9,0,34,25
1658075773112,MATH 10B,A02,083208,Lim; Seonhee,10,0,35,25
1658075773112,MATH 10B,A03,093472,Lim; Seonhee,7,0,34,27
1658075773112,MATH 10B,B01,083739,Sinha; Shubham,14,0,30,16
1658075779149,MATH 18,A01,083743,Cinel; Cameron Alexander,9,0,30,21
1658075779149,MATH 18,A02,083744,Cinel; Cameron Alexander,18,0,30,12
1658075779149,MATH 18,A03,083745,Cinel; Cameron Alexander,10,0,30,20
1658075779149,MATH 18,B01,083748,Rideout; David Porter,5,0,37,32
1658075779149,MATH 18,B02,083749,Rideout; David Porter,5,0,36,31
1658075779149,MATH 18,B03,083750,Rideout; David Porter,3,0,37,34
1658075779149,MATH 18,B04,083751,Rideout; David Porter,7,0,36,29
1658075779149,MATH 18,B05,093473,Rideout; David Porter,7,0,36,29
1658075779149,MATH 18,B06,093474,Rideout; David Porter,6,0,36,30
1658075785187,MATH 20A,A01,083754,Zheng; Zequn,14,0,40,26
1658075791221,MATH 20B,A01,083756,Briones; Jor-el Thomas Caparas,4,0,36,32
1658075791221,MATH 20B,A02,083757,Briones; Jor-el Thomas Caparas,1,0,36,35
1658075791221,MATH 20B,A03,093475,Briones; Jor-el Thomas Caparas,3,0,36,33
1658075797251,MATH 20C,A01,083760,Briones; Jor-el Thomas Caparas,1,0,35,34
1658075797251,MATH 20C,A02,083761,Briones; Jor-el Thomas Caparas,8,0,35,27
1658075797251,MATH 20C,A03,093476,Briones; Jor-el Thomas Caparas,0,1,36,36
1658075797251,MATH 20C,B01,083762,Bach; Quang Tran,1,0,30,29
1658075803277,MATH 20D,A01,083765,Tran; Brian Kha,5,0,30,25
1658075803277,MATH 20D,A02,083766,Tran; Brian Kha,5,0,30,25
1658075803277,MATH 20D,A03,083767,Tran; Brian Kha,6,0,30,24
1658075809304,MATH 20E,A01,083771,Ganguly; Soumya,12,0,32,20
1658075809304,MATH 20E,A02,083772,Ganguly; Soumya,7,0,32,25
1658075809304,MATH 20E,B01,083773,Ciotti; Benjamin,20,0,35,15
1658075809304,MATH 20E,B02,083774,Ciotti; Benjamin,18,0,35,17
1658075815334,MATH 103A,A01,083777,Greenfeld; Be'Eri,6,0,36,30
1658075815334,MATH 103A,A02,083778,Greenfeld; Be'Eri,5,0,36,31
1658075815334,MATH 103A,A03,093561,Greenfeld; Be'Eri,7,0,36,29
1658075815334,MATH 103A,B01,083779,Greenfeld; Be'Eri,8,0,36,28
1658075815334,MATH 103A,B02,083780,Greenfeld; Be'Eri,4,0,36,32
1658075815334,MATH 103A,B03,093562,Greenfeld; Be'Eri,3,0,36,33
1658075821360,MATH 105,A01,085443,Carter; Anne Toulson,15,0,35,20
1658075821360,MATH 105,A02,093477,Carter; Anne Toulson,20,0,35,15
1658075827392,MATH 109,A01,083213,Ganzberger; Geoffrey Michael,3,0,34,31
1658075827392,MATH 109,A02,083214,Ganzberger; Geoffrey Michael,4,0,34,30
1658075827392,MATH 109,A03,093478,Ganzberger; Geoffrey Michael,2,0,34,32
1658075827392,MATH 109,B01,083215,Ganzberger; Geoffrey Michael,3,0,32,29
1658075827392,MATH 109,B02,083216,Ganzberger; Geoffrey Michael,3,0,32,29
1658075827392,MATH 109,B03,093479,Ganzberger; Geoffrey Michael,8,0,32,24
1658075833416,MATH 142A,A01,083219,Chow; Bennett,7,0,32,25
1658075833416,MATH 142A,A02,083220,Chow; Bennett,10,0,32,22
1658075833416,MATH 142A,A03,093480,Chow; Bennett,9,0,32,23
1658075833416,MATH 142A,B03,093481,Chow; Bennett,8,0,32,24
1658075833416,MATH 142A,B04,093558,Chow; Bennett,14,0,32,18
1658075833416,MATH 142A,B05,093559,Chow; Bennett,7,0,32,25
1658075839445,MATH 193A,A01,083224,Rotar; Vladimir,9,0,34,25
1658075839445,MATH 193A,A02,083225,Rotar; Vladimir,11,0,34,23
1658075839445,MATH 193A,A03,083781,Rotar; Vladimir,5,0,34,29
1658075839445,MATH 193A,A04,083782,Rotar; Vladimir,12,0,34,22
1658075839445,MATH 193A,A05,093482,Rotar; Vladimir,11,0,34,23
1658075845470,MATH 197,001,091859,McAuley; Julian John,9999,0,9999,0
1658075845470,MATH 197,002,095566,Kedlaya; Kiran S.,9997,0,9999,2
1658075845470,MATH 197,003,095567,Xiao; Ming,9999,0,9999,0
1658075845470,MATH 197,004,095571,Perols; Johan Lars,9998,0,9999,1
1658075852525,COGS 9,A01,083615,Shannon; Kyle Michael,11,0,75,64
1658075858558,COGS 11,A01,083617,Boyle; Mary E. T.,23,0,48,25
1658075864582,COGS 13,A01,083071,Bastos; Amalia Pinkusfeld,12,0,71,59
1658075870606,COGS 14A,A01,092681,Semenuks; Arturs,5,1,100,95
1658075876630,COGS 14B,A01,083073,Cheng; Tzu-Han,7,0,63,56
1658075882657,COGS 17,A01,092677,Semenuks; Arturs,7,0,81,74
1658075888680,COGS 100,A01,083619,Allen; Michael Gordon,17,0,70,53
1658075894709,COGS 101A,A01,083621,Davis; Joshua Daniel,9,0,68,59
1658075900732,COGS 101B,A01,091572,Allen; Michael Gordon,14,0,65,51
1658075906757,COGS 101C,A01,083625,Delgado; Tania,17,0,35,18
1658075912780,COGS 107A,A01,083627,Boyle; Mary E. T.,14,0,60,46
1658075918805,COGS 118A,A01,083075,Gupta; Anjum,21,0,76,55
1658075924829,CSE 3,A50,083646,Miranda; Gregory Joseph,24,0,50,26
1658075930853,CSE 8A,A50,083650,Miranda; Gregory Joseph,17,1,56,39
1658075936879,CSE 11,A01,083080,Cao; Yingjun,7,15,40,33
1658075942915,CSE 12,A01,083652,Krause-Levy; Sophia Louisa,30,1,120,90
1658075948938,CSE 15L,A01,083654,Morris; Justin Loren,9,0,50,41
1658075948938,CSE 15L,A02,083655,Morris; Justin Loren,11,0,50,39
1658075954961,CSE 20,A01,083657,Tran; Khoa Dang,39,0,80,41
1658075960989,CSE 21,A01,095574,Bach; Quang Tran,23,0,48,25
1658075967016,CSE 30,A01,083084,Eldon; John,8,0,80,72
1658075967016,CSE 30,B01,095061,Bhaskar; Nishant,9,0,50,41
1658075973041,CSE 100,A01,083659,Cao; Yingjun,5,4,70,65
1658075979075,CSE 134B,A01,083661,Powell; Thomas Allan,25,0,100,75
1658075985111,CSE 140,A01,083663,Gungor; Onat,17,0,85,68
1658075991135,CSE 140L,A01,083088,Eldon; John,23,0,100,77
1658075997159,CSE 175,A01,083665,Kumar; Rakesh,3,0,25,22
1658076003188,CSE 190,A00,092507,Dubnov; Shlomo,8,0,20,12
1658076009215,ECE 45,A01,083139,Congero; Spencer William,7,0,75,68
1658076015248,ECE 65,A50,083695,Saad; Andrew S,12,0,30,18
1658076015248,ECE 65,A51,095125,Saad; Andrew S,24,0,26,2
1658076021274,ECE 109,A01,091882,Touri; Behrouz,21,0,70,49
1658076027300,ECE 180,A00,083140,Abi Samra; Nicholas Camill,1,0,30,29
1658076027300,ECE 180,B00,083141,Abi Samra; Nicholas Camill,0,0,30,30
1658076033326,MATH 10A,A01,083735,Patchell; Gregory David,2,0,30,28
1658076033326,MATH 10A,A02,083736,Patchell; Gregory David,20,0,30,10
1658076033326,MATH 10A,A03,083737,Patchell; Gregory David,16,0,30,14
1658076039357,MATH 10B,A01,083207,Lim; Seonhee,9,0,34,25
1658076039357,MATH 10B,A02,083208,Lim; Seonhee,10,0,35,25
1658076039357,MATH 10B,A03,093472,Lim; Seonhee,7,0,34,27
1658076039357,MATH 10B,B01,083739,Sinha; Shubham,14,0,30,16
1658076045389,MATH 18,A01,083743,Cinel; Cameron Alexander,9,0,30,21
1658076045389,MATH 18,A02,083744,Cinel; Cameron Alexander,18,0,30,12
1658076045389,MATH 18,A03,083745,Cinel; Cameron Alexander,10,0,30,20
1658076045389,MATH 18,B01,083748,Rideout; David Porter,5,0,37,32
1658076045389,MATH 18,B02,083749,Rideout; David Porter,5,0,36,31
1658076045389,MATH 18,B03,083750,Rideout; David Porter,3,0,37,34
1658076045389,MATH 18,B04,083751,Rideout; David Porter,7,0,36,29
1658076045389,MATH 18,B05,093473,Rideout; David Porter,7,0,36,29
1658076045389,MATH 18,B06,093474,Rideout; David Porter,6,0,36,30
1658076051413,MATH 20A,A01,083754,Zheng; Zequn,14,0,40,26
1658076057438,MATH 20B,A01,083756,Briones; Jor-el Thomas Caparas,4,0,36,32
1658076057438,MATH 20B,A02,083757,Briones; Jor-el Thomas Caparas,1,0,36,35
1658076057438,MATH 20B,A03,093475,Briones; Jor-el Thomas Caparas,3,0,36,33
1658076063463,MATH 20C,A01,083760,Briones; Jor-el Thomas Caparas,1,0,35,34
1658076063463,MATH 20C,A02,083761,Briones; Jor-el Thomas Caparas,8,0,35,27
1658076063463,MATH 20C,A03,093476,Briones; Jor-el Thomas Caparas,0,1,36,36
1658076063463,MATH 20C,B01,083762,Bach; Quang Tran,1,0,30,29
1658076069491,MATH 20D,A01,083765,Tran; Brian Kha,5,0,30,25
1658076069491,MATH 20D,A02,083766,Tran; Brian Kha,5,0,30,25
1658076069491,MATH 20D,A03,083767,Tran; Brian Kha,6,0,30,24
1658076075515,MATH 20E,A01,083771,Ganguly; Soumya,12,0,32,20
1658076075515,MATH 20E,A02,083772,Ganguly; Soumya,7,0,32,25
1658076075515,MATH 20E,B01,083773,Ciotti; Benjamin,20,0,35,15
1658076075515,MATH 20E,B02,083774,Ciotti; Benjamin,18,0,35,17
1658076081544,MATH 103A,A01,083777,Greenfeld; Be'Eri,6,0,36,30
1658076081544,MATH 103A,A02,083778,Greenfeld; Be'Eri,5,0,36,31
1658076081544,MATH 103A,A03,093561,Greenfeld; Be'Eri,7,0,36,29
1658076081544,MATH 103A,B01,083779,Greenfeld; Be'Eri,8,0,36,28
1658076081544,MATH 103A,B02,083780,Greenfeld; Be'Eri,4,0,36,32
1658076081544,MATH 103A,B03,093562,Greenfeld; Be'Eri,3,0,36,33
1658076087571,MATH 105,A01,085443,Carter; Anne Toulson,15,0,35,20
1658076087571,MATH 105,A02,093477,Carter; Anne Toulson,20,0,35,15
1658076093595,MATH 109,A01,083213,Ganzberger; Geoffrey Michael,3,0,34,31
1658076093595,MATH 109,A02,083214,Ganzberger; Geoffrey Michael,4,0,34,30
1658076093595,MATH 109,A03,093478,Ganzberger; Geoffrey Michael,2,0,34,32
1658076093595,MATH 109,B01,083215,Ganzberger; Geoffrey Michael,3,0,32,29
1658076093595,MATH 109,B02,083216,Ganzberger; Geoffrey Michael,3,0,32,29
1658076093595,MATH 109,B03,093479,Ganzberger; Geoffrey Michael,8,0,32,24
1658076099621,MATH 142A,A01,083219,Chow; Bennett,7,0,32,25
1658076099621,MATH 142A,A02,083220,Chow; Bennett,10,0,32,22
1658076099621,MATH 142A,A03,093480,Chow; Bennett,9,0,32,23
1658076099621,MATH 142A,B03,093481,Chow; Bennett,8,0,32,24
1658076099621,MATH 142A,B04,093558,Chow; Bennett,14,0,32,18
1658076099621,MATH 142A,B05,093559,Chow; Bennett,7,0,32,25
1658076105646,MATH 193A,A01,083224,Rotar; Vladimir,9,0,34,25
1658076105646,MATH 193A,A02,083225,Rotar; Vladimir,11,0,34,23
1658076105646,MATH 193A,A03,083781,Rotar; Vladimir,5,0,34,29
1658076105646,MATH 193A,A04,083782,Rotar; Vladimir,12,0,34,22
1658076105646,MATH 193A,A05,093482,Rotar; Vladimir,11,0,34,23
1658076111677,MATH 197,001,091859,McAuley; Julian John,9999,0,9999,0
1658076111677,MATH 197,002,095566,Kedlaya; Kiran S.,9997,0,9999,2
1658076111677,MATH 197,003,095567,Xiao; Ming,9999,0,9999,0
1658076111677,MATH 197,004,095571,Perols; Johan Lars,9998,0,9999,1
1658076118737,COGS 9,A01,083615,Shannon; Kyle Michael,11,0,75,64
1658076124784,COGS 11,A01,083617,Boyle; Mary E. T.,23,0,48,25
1658076130806,COGS 13,A01,083071,Bastos; Amalia Pinkusfeld,12,0,71,59
1658076136828,COGS 14A,A01,092681,Semenuks; Arturs,5,1,100,95
1658076142856,COGS 14B,A01,083073,Cheng; Tzu-Han,7,0,63,56
1658076148885,COGS 17,A01,092677,Semenuks; Arturs,7,0,81,74
1658076154912,COGS 100,A01,083619,Allen; Michael Gordon,17,0,70,53
1658076160935,COGS 101A,A01,083621,Davis; Joshua Daniel,9,0,68,59
1658076166959,COGS 101B,A01,091572,Allen; Michael Gordon,14,0,65,51
1658076172990,COGS 101C,A01,083625,Delgado; Tania,17,0,35,18
1658076179017,COGS 107A,A01,083627,Boyle; Mary E. T.,14,0,60,46
1658076185042,COGS 118A,A01,083075,Gupta; Anjum,21,0,76,55
1658076191067,CSE 3,A50,083646,Miranda; Gregory Joseph,24,0,50,26
1658076197095,CSE 8A,A50,083650,Miranda; Gregory Joseph,17,1,56,39
1658076203122,CSE 11,A01,083080,Cao; Yingjun,7,15,40,33
1658076209146,CSE 12,A01,083652,Krause-Levy; Sophia Louisa,30,1,120,90
1658076215170,CSE 15L,A01,083654,Morris; Justin Loren,9,0,50,41
1658076215170,CSE 15L,A02,083655,Morris; Justin Loren,11,0,50,39
1658076221194,CSE 20,A01,083657,Tran; Khoa Dang,39,0,80,41
1658076227222,CSE 21,A01,095574,Bach; Quang Tran,23,0,48,25
1658076233246,CSE 30,A01,083084,Eldon; John,8,0,80,72
1658076233246,CSE 30,B01,095061,Bhaskar; Nishant,9,0,50,41
1658076239278,CSE 100,A01,083659,Cao; Yingjun,5,4,70,65
1658076245302,CSE 134B,A01,083661,Powell; Thomas Allan,25,0,100,75
1658076251329,CSE 140,A01,083663,Gungor; Onat,17,0,85,68
1658076257357,CSE 140L,A01,083088,Eldon; John,23,0,100,77
1658076263381,CSE 175,A01,083665,Kumar; Rakesh,3,0,25,22
1658076269403,CSE 190,A00,092507,Dubnov; Shlomo,8,0,20,12
1658076275428,ECE 45,A01,083139,Congero; Spencer William,7,0,75,68
1658076281457,ECE 65,A50,083695,Saad; Andrew S,12,0,30,18
1658076281457,ECE 65,A51,095125,Saad; Andrew S,24,0,26,2
1658076287484,ECE 109,A01,091882,Touri; Behrouz,21,0,70,49
1658076293512,ECE 180,A00,083140,Abi Samra; Nicholas Camill,1,0,30,29
1658076293512,ECE 180,B00,083141,Abi Samra; Nicholas Camill,0,0,30,30
1658076299537,MATH 10A,A01,083735,Patchell; Gregory David,2,0,30,28
1658076299537,MATH 10A,A02,083736,Patchell; Gregory David,20,0,30,10
1658076299537,MATH 10A,A03,083737,Patchell; Gregory David,16,0,30,14
1658076305563,MATH 10B,A01,083207,Lim; Seonhee,9,0,34,25
1658076305563,MATH 10B,A02,083208,Lim; Seonhee,10,0,35,25
1658076305563,MATH 10B,A03,093472,Lim; Seonhee,7,0,34,27
1658076305563,MATH 10B,B01,083739,Sinha; Shubham,14,0,30,16
1658076311595,MATH 18,A01,083743,Cinel; Cameron Alexander,9,0,30,21
1658076311595,MATH 18,A02,083744,Cinel; Cameron Alexander,18,0,30,12
1658076311595,MATH 18,A03,083745,Cinel; Cameron Alexander,10,0,30,20
1658076311595,MATH 18,B01,083748,Rideout; David Porter,5,0,37,32
1658076311595,MATH 18,B02,083749,Rideout; David Porter,5,0,36,31
1658076311595,MATH 18,B03,083750,Rideout; David Porter,3,0,37,34
1658076311595,MATH 18,B04,083751,Rideout; David Porter,7,0,36,29
1658076311595,MATH 18,B05,093473,Rideout; David Porter,7,0,36,29
1658076311595,MATH 18,B06,093474,Rideout; David Porter,6,0,36,30
1658076317695,MATH 20A,A01,083754,Zheng; Zequn,14,0,40,26
1658076323719,MATH 20B,A01,083756,Briones; Jor-el Thomas Caparas,4,0,36,32
1658076323719,MATH 20B,A02,083757,Briones; Jor-el Thomas Caparas,1,0,36,35
1658076323719,MATH 20B,A03,093475,Briones; Jor-el Thomas Caparas,3,0,36,33
1658076329749,MATH 20C,A01,083760,Briones; Jor-el Thomas Caparas,1,0,35,34
1658076329749,MATH 20C,A02,083761,Briones; Jor-el Thomas Caparas,8,0,35,27
1658076329749,MATH 20C,A03,093476,Briones; Jor-el Thomas Caparas,0,1,36,36
1658076329749,MATH 20C,B01,083762,Bach; Quang Tran,1,0,30,29
1658076335773,MATH 20D,A01,083765,Tran; Brian Kha,5,0,30,25
1658076335773,MATH 20D,A02,083766,Tran; Brian Kha,5,0,30,25
1658076335773,MATH 20D,A03,083767,Tran; Brian Kha,6,0,30,24
1658076341801,MATH 20E,A01,083771,Ganguly; Soumya,12,0,32,20
1658076341801,MATH 20E,A02,083772,Ganguly; Soumya,7,0,32,25
1658076341801,MATH 20E,B01,083773,Ciotti; Benjamin,20,0,35,15
1658076341801,MATH 20E,B02,083774,Ciotti; Benjamin,18,0,35,17
1658076347836,MATH 103A,A01,083777,Greenfeld; Be'Eri,6,0,36,30
1658076347836,MATH 103A,A02,083778,Greenfeld; Be'Eri,5,0,36,31
1658076347836,MATH 103A,A03,093561,Greenfeld; Be'Eri,7,0,36,29
1658076347836,MATH 103A,B01,083779,Greenfeld; Be'Eri,8,0,36,28
1658076347836,MATH 103A,B02,083780,Greenfeld; Be'Eri,4,0,36,32
1658076347836,MATH 103A,B03,093562,Greenfeld; Be'Eri,3,0,36,33
1658076353860,MATH 105,A01,085443,Carter; Anne Toulson,15,0,35,20
1658076353860,MATH 105,A02,093477,Carter; Anne Toulson,20,0,35,15
1658076359885,MATH 109,A01,083213,Ganzberger; Geoffrey Michael,3,0,34,31
1658076359885,MATH 109,A02,083214,Ganzberger; Geoffrey Michael,4,0,34,30
1658076359885,MATH 109,A03,093478,Ganzberger; Geoffrey Michael,2,0,34,32
1658076359885,MATH 109,B01,083215,Ganzberger; Geoffrey Michael,3,0,32,29
1658076359885,MATH 109,B02,083216,Ganzberger; Geoffrey Michael,3,0,32,29
1658076359885,MATH 109,B03,093479,Ganzberger; Geoffrey Michael,8,0,32,24
1658076365917,MATH 142A,A01,083219,Chow; Bennett,7,0,32,25
1658076365917,MATH 142A,A02,083220,Chow; Bennett,10,0,32,22
1658076365917,MATH 142A,A03,093480,Chow; Bennett,9,0,32,23
1658076365917,MATH 142A,B03,093481,Chow; Bennett,8,0,32,24
1658076365917,MATH 142A,B04,093558,Chow; Bennett,14,0,32,18
1658076365917,MATH 142A,B05,093559,Chow; Bennett,7,0,32,25
1658076371941,MATH 193A,A01,083224,Rotar; Vladimir,9,0,34,25
1658076371941,MATH 193A,A02,083225,Rotar; Vladimir,11,0,34,23
1658076371941,MATH 193A,A03,083781,Rotar; Vladimir,5,0,34,29
1658076371941,MATH 193A,A04,083782,Rotar; Vladimir,12,0,34,22
1658076371941,MATH 193A,A05,093482,Rotar; Vladimir,11,0,34,23
1658076377969,MATH 197,001,091859,McAuley; Julian John,9999,0,9999,0
1658076377969,MATH 197,002,095566,Kedlaya; Kiran S.,9997,0,9999,2
1658076377969,MATH 197,003,095567,Xiao; Ming,9999,0,9999,0
1658076377969,MATH 197,004,095571,Perols; Johan Lars,9998,0,9999,1
1658076385023,COGS 9,A01,083615,Shannon; Kyle Michael,11,0,75,64
1658076391050,COGS 11,A01,083617,Boyle; Mary E. T.,23,0,48,25
1658076397078,COGS 13,A01,083071,Bastos; Amalia Pinkusfeld,12,0,71,59
1658076403104,COGS 14A,A01,092681,Semenuks; Arturs,5,1,100,95
1658076409132,COGS 14B,A01,083073,Cheng; Tzu-Han,7,0,63,56
1658076415157,COGS 17,A01,092677,Semenuks; Arturs,7,0,81,74
1658076421181,COGS 100,A01,083619,Allen; Michael Gordon,17,0,70,53
1658076427217,COGS 101A,A01,083621,Davis; Joshua Daniel,9,0,68,59
1658076433246,COGS 101B,A01,091572,Allen; Michael Gordon,14,0,65,51
1658076439274,COGS 101C,A01,083625,Delgado; Tania,17,0,35,18
1658076445298,COGS 107A,A01,083627,Boyle; Mary E. T.,14,0,60,46
1658076451322,COGS 118A,A01,083075,Gupta; Anjum,21,0,76,55
1658076457351,CSE 3,A50,083646,Miranda; Gregory Joseph,24,0,50,26
1658076463376,CSE 8A,A50,083650,Miranda; Gregory Joseph,17,1,56,39
1658076469400,CSE 11,A01,083080,Cao; Yingjun,7,15,40,33
1658076475427,CSE 12,A01,083652,Krause-Levy; Sophia Louisa,30,1,120,90
1658076481454,CSE 15L,A01,083654,Morris; Justin Loren,9,0,50,41
1658076481454,CSE 15L,A02,083655,Morris; Justin Loren,11,0,50,39
1658076487479,CSE 20,A01,083657,Tran; Khoa Dang,39,0,80,41
1658076493501,CSE 21,A01,095574,Bach; Quang Tran,23,0,48,25
1658076499526,CSE 30,A01,083084,Eldon; John,8,0,80,72
1658076499526,CSE 30,B01,095061,Bhaskar; Nishant,9,0,50,41
1658076505550,CSE 100,A01,083659,Cao; Yingjun,5,4,70,65
1658076511577,CSE 134B,A01,083661,Powell; Thomas Allan,25,0,100,75
1658076517602,CSE 140,A01,083663,Gungor; Onat,17,0,85,68
1658076523630,CSE 140L,A01,083088,Eldon; John,23,0,100,77
1658076529653,CSE 175,A01,083665,Kumar; Rakesh,3,0,25,22
1658076535676,CSE 190,A00,092507,Dubnov; Shlomo,8,0,20,12
1658076541702,ECE 45,A01,083139,Congero; Spencer William,7,0,75,68
1658076547730,ECE 65,A50,083695,Saad; Andrew S,12,0,30,18
1658076547730,ECE 65,A51,095125,Saad; Andrew S,24,0,26,2
1658076553757,ECE 109,A01,091882,Touri; Behrouz,21,0,70,49
1658076559784,ECE 180,A00,083140,Abi Samra; Nicholas Camill,1,0,30,29
1658076559784,ECE 180,B00,083141,Abi Samra; Nicholas Camill,0,0,30,30
1658076565806,MATH 10A,A01,083735,Patchell; Gregory David,2,0,30,28
1658076565806,MATH 10A,A02,083736,Patchell; Gregory David,20,0,30,10
1658076565806,MATH 10A,A03,083737,Patchell; Gregory David,16,0,30,14
1658076571831,MATH 10B,A01,083207,Lim; Seonhee,9,0,34,25
1658076571831,MATH 10B,A02,083208,Lim; Seonhee,10,0,35,25
1658076571831,MATH 10B,A03,093472,Lim; Seonhee,7,0,34,27
1658076571831,MATH 10B,B01,083739,Sinha; Shubham,14,0,30,16
1658076577856,MATH 18,A01,083743,Cinel; Cameron Alexander,9,0,30,21
1658076577856,MATH 18,A02,083744,Cinel; Cameron Alexander,18,0,30,12
1658076577856,MATH 18,A03,083745,Cinel; Cameron Alexander,10,0,30,20
1658076577856,MATH 18,B01,083748,Rideout; David Porter,5,0,37,32
1658076577856,MATH 18,B02,083749,Rideout; David Porter,5,0,36,31
1658076577856,MATH 18,B03,083750,Rideout; David Porter,3,0,37,34
1658076577856,MATH 18,B04,083751,Rideout; David Porter,7,0,36,29
1658076577856,MATH 18,B05,093473,Rideout; David Porter,7,0,36,29
1658076577856,MATH 18,B06,093474,Rideout; David Porter,6,0,36,30
1658076583881,MATH 20A,A01,083754,Zheng; Zequn,14,0,40,26
1658076589905,MATH 20B,A01,083756,Briones; Jor-el Thomas Caparas,4,0,36,32
1658076589905,MATH 20B,A02,083757,Briones; Jor-el Thomas Caparas,1,0,36,35
1658076589905,MATH 20B,A03,093475,Briones; Jor-el Thomas Caparas,3,0,36,33
1658076595929,MATH 20C,A01,083760,Briones; Jor-el Thomas Caparas,1,0,35,34
1658076595929,MATH 20C,A02,083761,Briones; Jor-el Thomas Caparas,8,0,35,27
1658076595929,MATH 20C,A03,093476,Briones; Jor-el Thomas Caparas,0,1,36,36
1658076595929,MATH 20C,B01,083762,Bach; Quang Tran,1,0,30,29
1658076601955,MATH 20D,A01,083765,Tran; Brian Kha,5,0,30,25
1658076601955,MATH 20D,A02,083766,Tran; Brian Kha,5,0,30,25
1658076601955,MATH 20D,A03,083767,Tran; Brian Kha,6,0,30,24
1658076607989,MATH 20E,A01,083771,Ganguly; Soumya,12,0,32,20
1658076607989,MATH 20E,A02,083772,Ganguly; Soumya,7,0,32,25
1658076607989,MATH 20E,B01,083773,Ciotti; Benjamin,20,0,35,15
1658076607989,MATH 20E,B02,083774,Ciotti; Benjamin,18,0,35,17
1658076614012,MATH 103A,A01,083777,Greenfeld; Be'Eri,6,0,36,30
1658076614012,MATH 103A,A02,083778,Greenfeld; Be'Eri,5,0,36,31
1658076614012,MATH 103A,A03,093561,Greenfeld; Be'Eri,7,0,36,29
1658076614012,MATH 103A,B01,083779,Greenfeld; Be'Eri,8,0,36,28
1658076614012,MATH 103A,B02,083780,Greenfeld; Be'Eri,4,0,36,32
1658076614012,MATH 103A,B03,093562,Greenfeld; Be'Eri,3,0,36,33
1658076620040,MATH 105,A01,085443,Carter; Anne Toulson,15,0,35,20
1658076620040,MATH 105,A02,093477,Carter; Anne Toulson,20,0,35,15
1658076626065,MATH 109,A01,083213,Ganzberger; Geoffrey Michael,3,0,34,31
1658076626065,MATH 109,A02,083214,Ganzberger; Geoffrey Michael,4,0,34,30
1658076626065,MATH 109,A03,093478,Ganzberger; Geoffrey Michael,2,0,34,32
1658076626065,MATH 109,B01,083215,Ganzberger; Geoffrey Michael,3,0,32,29
1658076626065,MATH 109,B02,083216,Ganzberger; Geoffrey Michael,3,0,32,29
1658076626065,MATH 109,B03,093479,Ganzberger; Geoffrey Michael,8,0,32,24
1658076632090,MATH 142A,A01,083219,Chow; Bennett,7,0,32,25
1658076632090,MATH 142A,A02,083220,Chow; Bennett,10,0,32,22
1658076632090,MATH 142A,A03,093480,Chow; Bennett,9,0,32,23
1658076632090,MATH 142A,B03,093481,Chow; Bennett,8,0,32,24
1658076632090,MATH 142A,B04,093558,Chow; Bennett,14,0,32,18
1658076632090,MATH 142A,B05,093559,Chow; Bennett,7,0,32,25
1658076638121,MATH 193A,A01,083224,Rotar; Vladimir,9,0,34,25
1658076638121,MATH 193A,A02,083225,Rotar; Vladimir,11,0,34,23
1658076638121,MATH 193A,A03,083781,Rotar; Vladimir,5,0,34,29
1658076638121,MATH 193A,A04,083782,Rotar; Vladimir,12,0,34,22
1658076638121,MATH 193A,A05,093482,Rotar; Vladimir,11,0,34,23
1658076644147,MATH 197,001,091859,McAuley; Julian John,9999,0,9999,0
1658076644147,MATH 197,002,095566,Kedlaya; Kiran S.,9997,0,9999,2
1658076644147,MATH 197,003,095567,Xiao; Ming,9999,0,9999,0
1658076644147,MATH 197,004,095571,Perols; Johan Lars,9998,0,9999,1
1658076651217,COGS 9,A01,083615,Shannon; Kyle Michael,11,0,75,64
1658076657244,COGS 11,A01,083617,Boyle; Mary E. T.,23,0,48,25
1658076663271,COGS 13,A01,083071,Bastos; Amalia Pinkusfeld,12,0,71,59
1658076669295,COGS 14A,A01,092681,Semenuks; Arturs,5,1,100,95
1658076675318,COGS 14B,A01,083073,Cheng; Tzu-Han,7,0,63,56
1658076681343,COGS 17,A01,092677,Semenuks; Arturs,7,0,81,74
1658076687369,COGS 100,A01,083619,Allen; Michael Gordon,17,0,70,53
1658076693394,COGS 101A,A01,083621,Davis; Joshua Daniel,9,0,68,59
1658076699421,COGS 101B,A01,091572,Allen; Michael Gordon,14,0,65,51
1658076705445,COGS 101C,A01,083625,Delgado; Tania,17,0,35,18
1658076711470,COGS 107A,A01,083627,Boyle; Mary E. T.,14,0,60,46
1658076717494,COGS 118A,A01,083075,Gupta; Anjum,21,0,76,55
1658076723519,CSE 3,A50,083646,Miranda; Gregory Joseph,24,0,50,26
1658076729543,CSE 8A,A50,083650,Miranda; Gregory Joseph,17,1,56,39
1658076735570,CSE 11,A01,083080,Cao; Yingjun,7,15,40,33
1658076741596,CSE 12,A01,083652,Krause-Levy; Sophia Louisa,30,1,120,90
1658076747621,CSE 15L,A01,083654,Morris; Justin Loren,9,0,50,41
1658076747621,CSE 15L,A02,083655,Morris; Justin Loren,11,0,50,39
1658076753644,CSE 20,A01,083657,Tran; Khoa Dang,39,0,80,41
1658076759672,CSE 21,A01,095574,Bach; Quang Tran,23,0,48,25
1658076765700,CSE 30,A01,083084,Eldon; John,8,0,80,72
1658076765700,CSE 30,B01,095061,Bhaskar; Nishant,9,0,50,41
1658076771723,CSE 100,A01,083659,Cao; Yingjun,5,4,70,65
1658076777747,CSE 134B,A01,083661,Powell; Thomas Allan,25,0,100,75
1658076783770,CSE 140,A01,083663,Gungor; Onat,17,0,85,68
1658076789794,CSE 140L,A01,083088,Eldon; John,23,0,100,77
1658076795818,CSE 175,A01,083665,Kumar; Rakesh,3,0,25,22
1658076801841,CSE 190,A00,092507,Dubnov; Shlomo,8,0,20,12
1658076807865,ECE 45,A01,083139,Congero; Spencer William,7,0,75,68
1658076813893,ECE 65,A50,083695,Saad; Andrew S,12,0,30,18
1658076813893,ECE 65,A51,095125,Saad; Andrew S,24,0,26,2
1658076819920,ECE 109,A01,091882,Touri; Behrouz,21,0,70,49
1658076825945,ECE 180,A00,083140,Abi Samra; Nicholas Camill,1,0,30,29
1658076825945,ECE 180,B00,083141,Abi Samra; Nicholas Camill,0,0,30,30
1658076831973,MATH 10A,A01,083735,Patchell; Gregory David,2,0,30,28
1658076831973,MATH 10A,A02,083736,Patchell; Gregory David,20,0,30,10
1658076831973,MATH 10A,A03,083737,Patchell; Gregory David,16,0,30,14
1658076838002,MATH 10B,A01,083207,Lim; Seonhee,9,0,34,25
1658076838002,MATH 10B,A02,083208,Lim; Seonhee,10,0,35,25
1658076838002,MATH 10B,A03,093472,Lim; Seonhee,7,0,34,27
1658076838002,MATH 10B,B01,083739,Sinha; Shubham,14,0,30,16
1658076844028,MATH 18,A01,083743,Cinel; Cameron Alexander,9,0,30,21
1658076844028,MATH 18,A02,083744,Cinel; Cameron Alexander,18,0,30,12
1658076844028,MATH 18,A03,083745,Cinel; Cameron Alexander,10,0,30,20
1658076844028,MATH 18,B01,083748,Rideout; David Porter,5,0,37,32
1658076844028,MATH 18,B02,083749,Rideout; David Porter,5,0,36,31
1658076844028,MATH 18,B03,083750,Rideout; David Porter,3,0,37,34
1658076844028,MATH 18,B04,083751,Rideout; David Porter,7,0,36,29
1658076844028,MATH 18,B05,093473,Rideout; David Porter,7,0,36,29
1658076844028,MATH 18,B06,093474,Rideout; David Porter,6,0,36,30
1658076850055,MATH 20A,A01,083754,Zheng; Zequn,14,0,40,26
1658076856078,MATH 20B,A01,083756,Briones; Jor-el Thomas Caparas,4,0,36,32
1658076856078,MATH 20B,A02,083757,Briones; Jor-el Thomas Caparas,1,0,36,35
1658076856078,MATH 20B,A03,093475,Briones; Jor-el Thomas Caparas,3,0,36,33
1658076862107,MATH 20C,A01,083760,Briones; Jor-el Thomas Caparas,1,0,35,34
1658076862107,MATH 20C,A02,083761,Briones; Jor-el Thomas Caparas,8,0,35,27
1658076862107,MATH 20C,A03,093476,Briones; Jor-el Thomas Caparas,0,1,36,36
1658076862107,MATH 20C,B01,083762,Bach; Quang Tran,1,0,30,29
1658076868133,MATH 20D,A01,083765,Tran; Brian Kha,5,0,30,25
1658076868133,MATH 20D,A02,083766,Tran; Brian Kha,5,0,30,25
1658076868133,MATH 20D,A03,083767,Tran; Brian Kha,6,0,30,24
1658076874163,MATH 20E,A01,083771,Ganguly; Soumya,12,0,32,20
1658076874163,MATH 20E,A02,083772,Ganguly; Soumya,7,0,32,25
1658076874163,MATH 20E,B01,083773,Ciotti; Benjamin,20,0,35,15
1658076874163,MATH 20E,B02,083774,Ciotti; Benjamin,18,0,35,17
1658076880188,MATH 103A,A01,083777,Greenfeld; Be'Eri,6,0,36,30
1658076880188,MATH 103A,A02,083778,Greenfeld; Be'Eri,5,0,36,31
1658076880188,MATH 103A,A03,093561,Greenfeld; Be'Eri,7,0,36,29
1658076880188,MATH 103A,B01,083779,Greenfeld; Be'Eri,8,0,36,28
1658076880188,MATH 103A,B02,083780,Greenfeld; Be'Eri,4,0,36,32
1658076880188,MATH 103A,B03,093562,Greenfeld; Be'Eri,3,0,36,33
1658076886216,MATH 105,A01,085443,Carter; Anne Toulson,15,0,35,20
1658076886216,MATH 105,A02,093477,Carter; Anne Toulson,20,0,35,15
1658076892240,MATH 109,A01,083213,Ganzberger; Geoffrey Michael,3,0,34,31
1658076892240,MATH 109,A02,083214,Ganzberger; Geoffrey Michael,4,0,34,30
1658076892240,MATH 109,A03,093478,Ganzberger; Geoffrey Michael,2,0,34,32
1658076892240,MATH 109,B01,083215,Ganzberger; Geoffrey Michael,3,0,32,29
1658076892240,MATH 109,B02,083216,Ganzberger; Geoffrey Michael,3,0,32,29
1658076892240,MATH 109,B03,093479,Ganzberger; Geoffrey Michael,8,0,32,24
1658076898265,MATH 142A,A01,083219,Chow; Bennett,7,0,32,25
1658076898265,MATH 142A,A02,083220,Chow; Bennett,10,0,32,22
1658076898265,MATH 142A,A03,093480,Chow; Bennett,9,0,32,23
1658076898265,MATH 142A,B03,093481,Chow; Bennett,8,0,32,24
1658076898265,MATH 142A,B04,093558,Chow; Bennett,14,0,32,18
1658076898265,MATH 142A,B05,093559,Chow; Bennett,7,0,32,25
1658076904296,MATH 193A,A01,083224,Rotar; Vladimir,9,0,34,25
1658076904296,MATH 193A,A02,083225,Rotar; Vladimir,11,0,34,23
1658076904296,MATH 193A,A03,083781,Rotar; Vladimir,5,0,34,29
1658076904296,MATH 193A,A04,083782,Rotar; Vladimir,12,0,34,22
1658076904296,MATH 193A,A05,093482,Rotar; Vladimir,11,0,34,23
1658076910320,MATH 197,001,091859,McAuley; Julian John,9999,0,9999,0
1658076910320,MATH 197,002,095566,Kedlaya; Kiran S.,9997,0,9999,2
1658076910320,MATH 197,003,095567,Xiao; Ming,9999,0,9999,0
1658076910320,MATH 197,004,095571,Perols; Johan Lars,9998,0,9999,1
1658076917481,COGS 9,A01,083615,Shannon; Kyle Michael,11,0,75,64
1658076923505,COGS 11,A01,083617,Boyle; Mary E. T.,23,0,48,25
1658076929529,COGS 13,A01,083071,Bastos; Amalia Pinkusfeld,12,0,71,59
1658076935555,COGS 14A,A01,092681,Semenuks; Arturs,5,1,100,95
1658076941579,COGS 14B,A01,083073,Cheng; Tzu-Han,7,0,63,56
1658076947610,COGS 17,A01,092677,Semenuks; Arturs,7,0,81,74
1658076953644,COGS 100,A01,083619,Allen; Michael Gordon,17,0,70,53
1658076959670,COGS 101A,A01,083621,Davis; Joshua Daniel,9,0,68,59
1658076965699,COGS 101B,A01,091572,Allen; Michael Gordon,14,0,65,51
1658076971725,COGS 101C,A01,083625,Delgado; Tania,17,0,35,18
1658076977753,COGS 107A,A01,083627,Boyle; Mary E. T.,14,0,60,46
1658076983777,COGS 118A,A01,083075,Gupta; Anjum,21,0,76,55
1658076989805,CSE 3,A50,083646,Miranda; Gregory Joseph,24,0,50,26
1658076995833,CSE 8A,A50,083650,Miranda; Gregory Joseph,17,1,56,39
1658077001857,CSE 11,A01,083080,Cao; Yingjun,7,15,40,33
1658077007881,CSE 12,A01,083652,Krause-Levy; Sophia Louisa,30,1,120,90
1658077013906,CSE 15L,A01,083654,Morris; Justin Loren,9,0,50,41
1658077013906,CSE 15L,A02,083655,Morris; Justin Loren,11,0,50,39
1658077019931,CSE 20,A01,083657,Tran; Khoa Dang,39,0,80,41
1658077025955,CSE 21,A01,095574,Bach; Quang Tran,23,0,48,25
1658077031980,CSE 30,A01,083084,Eldon; John,8,0,80,72
1658077031980,CSE 30,B01,095061,Bhaskar; Nishant,9,0,50,41
1658077038005,CSE 100,A01,083659,Cao; Yingjun,5,4,70,65
1658077044029,CSE 134B,A01,083661,Powell; Thomas Allan,25,0,100,75
1658077050056,CSE 140,A01,083663,Gungor; Onat,17,0,85,68
1658077056082,CSE 140L,A01,083088,Eldon; John,23,0,100,77
1658077062110,CSE 175,A01,083665,Kumar; Rakesh,3,0,25,22
1658077068137,CSE 190,A00,092507,Dubnov; Shlomo,8,0,20,12
1658077074165,ECE 45,A01,083139,Congero; Spencer William,7,0,75,68
1658077080187,ECE 65,A50,083695,Saad; Andrew S,12,0,30,18
1658077080187,ECE 65,A51,095125,Saad; Andrew S,24,0,26,2
1658077086215,ECE 109,A01,091882,Touri; Behrouz,21,0,70,49
1658077092249,ECE 180,A00,083140,Abi Samra; Nicholas Camill,1,0,30,29
1658077092249,ECE 180,B00,083141,Abi Samra; Nicholas Camill,0,0,30,30
1658077098281,MATH 10A,A01,083735,Patchell; Gregory David,2,0,30,28
1658077098281,MATH 10A,A02,083736,Patchell; Gregory David,20,0,30,10
1658077098281,MATH 10A,A03,083737,Patchell; Gregory David,16,0,30,14
1658077104306,MATH 10B,A01,083207,Lim; Seonhee,9,0,34,25
1658077104306,MATH 10B,A02,083208,Lim; Seonhee,10,0,35,25
1658077104306,MATH 10B,A03,093472,Lim; Seonhee,7,0,34,27
1658077104306,MATH 10B,B01,083739,Sinha; Shubham,14,0,30,16
1658077110333,MATH 18,A01,083743,Cinel; Cameron Alexander,9,0,30,21
1658077110333,MATH 18,A02,083744,Cinel; Cameron Alexander,18,0,30,12
1658077110333,MATH 18,A03,083745,Cinel; Cameron Alexander,10,0,30,20
1658077110333,MATH 18,B01,083748,Rideout; David Porter,5,0,37,32
1658077110333,MATH 18,B02,083749,Rideout; David Porter,5,0,36,31
1658077110333,MATH 18,B03,083750,Rideout; David Porter,3,0,37,34
1658077110333,MATH 18,B04,083751,Rideout; David Porter,7,0,36,29
1658077110333,MATH 18,B05,093473,Rideout; David Porter,7,0,36,29
1658077110333,MATH 18,B06,093474,Rideout; David Porter,6,0,36,30
1658077116359,MATH 20A,A01,083754,Zheng; Zequn,14,0,40,26
1658077122389,MATH 20B,A01,083756,Briones; Jor-el Thomas Caparas,4,0,36,32
1658077122389,MATH 20B,A02,083757,Briones; Jor-el Thomas Caparas,1,0,36,35
1658077122389,MATH 20B,A03,093475,Briones; Jor-el Thomas Caparas,3,0,36,33
1658077128414,MATH 20C,A01,083760,Briones; Jor-el Thomas Caparas,1,0,35,34
1658077128414,MATH 20C,A02,083761,Briones; Jor-el Thomas Caparas,8,0,35,27
1658077128414,MATH 20C,A03,093476,Briones; Jor-el Thomas Caparas,0,1,36,36
1658077128414,MATH 20C,B01,083762,Bach; Quang Tran,1,0,30,29
1658077134438,MATH 20D,A01,083765,Tran; Brian Kha,5,0,30,25
1658077134438,MATH 20D,A02,083766,Tran; Brian Kha,5,0,30,25
1658077134438,MATH 20D,A03,083767,Tran; Brian Kha,6,0,30,24
1658077140466,MATH 20E,A01,083771,Ganguly; Soumya,12,0,32,20
1658077140466,MATH 20E,A02,083772,Ganguly; Soumya,7,0,32,25
1658077140466,MATH 20E,B01,083773,Ciotti; Benjamin,20,0,35,15
1658077140466,MATH 20E,B02,083774,Ciotti; Benjamin,18,0,35,17
1658077146492,MATH 103A,A01,083777,Greenfeld; Be'Eri,6,0,36,30
1658077146492,MATH 103A,A02,083778,Greenfeld; Be'Eri,5,0,36,31
1658077146492,MATH 103A,A03,093561,Greenfeld; Be'Eri,7,0,36,29
1658077146492,MATH 103A,B01,083779,Greenfeld; Be'Eri,8,0,36,28
1658077146492,MATH 103A,B02,083780,Greenfeld; Be'Eri,4,0,36,32
1658077146492,MATH 103A,B03,093562,Greenfeld; Be'Eri,3,0,36,33
1658077152516,MATH 105,A01,085443,Carter; Anne Toulson,15,0,35,20
1658077152516,MATH 105,A02,093477,Carter; Anne Toulson,20,0,35,15
1658077158541,MATH 109,A01,083213,Ganzberger; Geoffrey Michael,3,0,34,31
1658077158541,MATH 109,A02,083214,Ganzberger; Geoffrey Michael,4,0,34,30
1658077158541,MATH 109,A03,093478,Ganzberger; Geoffrey Michael,2,0,34,32
1658077158541,MATH 109,B01,083215,Ganzberger; Geoffrey Michael,3,0,32,29
1658077158541,MATH 109,B02,083216,Ganzberger; Geoffrey Michael,3,0,32,29
1658077158541,MATH 109,B03,093479,Ganzberger; Geoffrey Michael,8,0,32,24
1658077164573,MATH 142A,A01,083219,Chow; Bennett,7,0,32,25
1658077164573,MATH 142A,A02,083220,Chow; Bennett,10,0,32,22
1658077164573,MATH 142A,A03,093480,Chow; Bennett,9,0,32,23
1658077164573,MATH 142A,B03,093481,Chow; Bennett,8,0,32,24
1658077164573,MATH 142A,B04,093558,Chow; Bennett,14,0,32,18
1658077164573,MATH 142A,B05,093559,Chow; Bennett,7,0,32,25
1658077170597,MATH 193A,A01,083224,Rotar; Vladimir,9,0,34,25
1658077170597,MATH 193A,A02,083225,Rotar; Vladimir,11,0,34,23
1658077170597,MATH 193A,A03,083781,Rotar; Vladimir,5,0,34,29
1658077170597,MATH 193A,A04,083782,Rotar; Vladimir,12,0,34,22
1658077170597,MATH 193A,A05,093482,Rotar; Vladimir,11,0,34,23
1658077176624,MATH 197,001,091859,McAuley; Julian John,9999,0,9999,0
1658077176624,MATH 197,002,095566,Kedlaya; Kiran S.,9997,0,9999,2
1658077176624,MATH 197,003,095567,Xiao; Ming,9999,0,9999,0
1658077176624,MATH 197,004,095571,Perols; Johan Lars,9998,0,9999,1
1658077183688,COGS 9,A01,083615,Shannon; Kyle Michael,11,0,75,64
1658077189712,COGS 11,A01,083617,Boyle; Mary E. T.,23,0,48,25
1658077195736,COGS 13,A01,083071,Bastos; Amalia Pinkusfeld,12,0,71,59
1658077201764,COGS 14A,A01,092681,Semenuks; Arturs,5,1,100,95
1658077207790,COGS 14B,A01,083073,Cheng; Tzu-Han,7,0,63,56
1658077213813,COGS 17,A01,092677,Semenuks; Arturs,7,0,81,74
1658077219839,COGS 100,A01,083619,Allen; Michael Gordon,17,0,70,53
1658077225869,COGS 101A,A01,083621,Davis; Joshua Daniel,9,0,68,59
1658077231892,COGS 101B,A01,091572,Allen; Michael Gordon,14,0,65,51
1658077237915,COGS 101C,A01,083625,Delgado; Tania,17,0,35,18
1658077243939,COGS 107A,A01,083627,Boyle; Mary E. T.,14,0,60,46
1658077249961,COGS 118A,A01,083075,Gupta; Anjum,21,0,76,55
1658077255990,CSE 3,A50,083646,Miranda; Gregory Joseph,24,0,50,26
1658077262018,CSE 8A,A50,083650,Miranda; Gregory Joseph,17,1,56,39
1658077268048,CSE 11,A01,083080,Cao; Yingjun,7,15,40,33
1658077274076,CSE 12,A01,083652,Krause-Levy; Sophia Louisa,30,1,120,90
1658077280103,CSE 15L,A01,083654,Morris; Justin Loren,9,0,50,41
1658077280103,CSE 15L,A02,083655,Morris; Justin Loren,11,0,50,39
1658077286127,CSE 20,A01,083657,Tran; Khoa Dang,39,0,80,41
1658077292151,CSE 21,A01,095574,Bach; Quang Tran,23,0,48,25
1658077298179,CSE 30,A01,083084,Eldon; John,8,0,80,72
1658077298179,CSE 30,B01,095061,Bhaskar; Nishant,9,0,50,41
1658077304201,CSE 100,A01,083659,Cao; Yingjun,5,4,70,65
1658077310225,CSE 134B,A01,083661,Powell; Thomas Allan,25,0,100,75
1658077316253,CSE 140,A01,083663,Gungor; Onat,17,0,85,68
1658077322276,CSE 140L,A01,083088,Eldon; John,23,0,100,77
1658077328306,CSE 175,A01,083665,Kumar; Rakesh,3,0,25,22
1658077334329,CSE 190,A00,092507,Dubnov; Shlomo,8,0,20,12
1658077340357,ECE 45,A01,083139,Congero; Spencer William,7,0,75,68
1658077346383,ECE 65,A50,083695,Saad; Andrew S,12,0,30,18
1658077346383,ECE 65,A51,095125,Saad; Andrew S,24,0,26,2
1658077352410,ECE 109,A01,091882,Touri; Behrouz,21,0,70,49
1658077358434,ECE 180,A00,083140,Abi Samra; Nicholas Camill,1,0,30,29
1658077358434,ECE 180,B00,083141,Abi Samra; Nicholas Camill,0,0,30,30
1658077364465,MATH 10A,A01,083735,Patchell; Gregory David,2,0,30,28
1658077364465,MATH 10A,A02,083736,Patchell; Gregory David,20,0,30,10
1658077364465,MATH 10A,A03,083737,Patchell; Gregory David,16,0,30,14
1658077370512,MATH 10B,A01,083207,Lim; Seonhee,9,0,34,25
1658077370512,MATH 10B,A02,083208,Lim; Seonhee,10,0,35,25
1658077370512,MATH 10B,A03,093472,Lim; Seonhee,7,0,34,27
1658077370512,MATH 10B,B01,083739,Sinha; Shubham,14,0,30,16
1658077376538,MATH 18,A01,083743,Cinel; Cameron Alexander,9,0,30,21
1658077376538,MATH 18,A02,083744,Cinel; Cameron Alexander,18,0,30,12
1658077376538,MATH 18,A03,083745,Cinel; Cameron Alexander,10,0,30,20
1658077376538,MATH 18,B01,083748,Rideout; David Porter,5,0,37,32
1658077376538,MATH 18,B02,083749,Rideout; David Porter,5,0,36,31
1658077376538,MATH 18,B03,083750,Rideout; David Porter,3,0,37,34
1658077376538,MATH 18,B04,083751,Rideout; David Porter,7,0,36,29
1658077376538,MATH 18,B05,093473,Rideout; David Porter,7,0,36,29
1658077376538,MATH 18,B06,093474,Rideout; David Porter,6,0,36,30
1658077382566,MATH 20A,A01,083754,Zheng; Zequn,14,0,40,26
1658077388589,MATH 20B,A01,083756,Briones; Jor-el Thomas Caparas,4,0,36,32
1658077388589,MATH 20B,A02,083757,Briones; Jor-el Thomas Caparas,1,0,36,35
1658077388589,MATH 20B,A03,093475,Briones; Jor-el Thomas Caparas,3,0,36,33
1658077394618,MATH 20C,A01,083760,Briones; Jor-el Thomas Caparas,1,0,35,34
1658077394618,MATH 20C,A02,083761,Briones; Jor-el Thomas Caparas,8,0,35,27
1658077394618,MATH 20C,A03,093476,Briones; Jor-el Thomas Caparas,0,1,36,36
1658077394618,MATH 20C,B01,083762,Bach; Quang Tran,1,0,30,29
1658077400643,MATH 20D,A01,083765,Tran; Brian Kha,5,0,30,25
1658077400643,MATH 20D,A02,083766,Tran; Brian Kha,5,0,30,25
1658077400643,MATH 20D,A03,083767,Tran; Brian Kha,6,0,30,24
1658077406669,MATH 20E,A01,083771,Ganguly; Soumya,12,0,32,20
1658077406669,MATH 20E,A02,083772,Ganguly; Soumya,7,0,32,25
1658077406669,MATH 20E,B01,083773,Ciotti; Benjamin,20,0,35,15
1658077406669,MATH 20E,B02,083774,Ciotti; Benjamin,18,0,35,17
1658077412693,MATH 103A,A01,083777,Greenfeld; Be'Eri,6,0,36,30
1658077412693,MATH 103A,A02,083778,Greenfeld; Be'Eri,5,0,36,31
1658077412693,MATH 103A,A03,093561,Greenfeld; Be'Eri,7,0,36,29
1658077412693,MATH 103A,B01,083779,Greenfeld; Be'Eri,8,0,36,28
1658077412693,MATH 103A,B02,083780,Greenfeld; Be'Eri,4,0,36,32
1658077412693,MATH 103A,B03,093562,Greenfeld; Be'Eri,3,0,36,33
1658077418722,MATH 105,A01,085443,Carter; Anne Toulson,15,0,35,20
1658077418722,MATH 105,A02,093477,Carter; Anne Toulson,20,0,35,15
1658077424750,MATH 109,A01,083213,Ganzberger; Geoffrey Michael,3,0,34,31
1658077424750,MATH 109,A02,083214,Ganzberger; Geoffrey Michael,4,0,34,30
1658077424750,MATH 109,A03,093478,Ganzberger; Geoffrey Michael,2,0,34,32
1658077424750,MATH 109,B01,083215,Ganzberger; Geoffrey Michael,3,0,32,29
1658077424750,MATH 109,B02,083216,Ganzberger; Geoffrey Michael,3,0,32,29
1658077424750,MATH 109,B03,093479,Ganzberger; Geoffrey Michael,8,0,32,24
1658077430780,MATH 142A,A01,083219,Chow; Bennett,7,0,32,25
1658077430780,MATH 142A,A02,083220,Chow; Bennett,10,0,32,22
1658077430780,MATH 142A,A03,093480,Chow; Bennett,9,0,32,23
1658077430780,MATH 142A,B03,093481,Chow; Bennett,8,0,32,24
1658077430780,MATH 142A,B04,093558,Chow; Bennett,14,0,32,18
1658077430780,MATH 142A,B05,093559,Chow; Bennett,7,0,32,25
1658077436804,MATH 193A,A01,083224,Rotar; Vladimir,9,0,34,25
1658077436804,MATH 193A,A02,083225,Rotar; Vladimir,11,0,34,23
1658077436804,MATH 193A,A03,083781,Rotar; Vladimir,5,0,34,29
1658077436804,MATH 193A,A04,083782,Rotar; Vladimir,12,0,34,22
1658077436804,MATH 193A,A05,093482,Rotar; Vladimir,11,0,34,23
1658077442828,MATH 197,001,091859,McAuley; Julian John,9999,0,9999,0
1658077442828,MATH 197,002,095566,Kedlaya; Kiran S.,9997,0,9999,2
1658077442828,MATH 197,003,095567,Xiao; Ming,9999,0,9999,0
1658077442828,MATH 197,004,095571,Perols; Johan Lars,9998,0,9999,1
1658077449880,COGS 9,A01,083615,Shannon; Kyle Michael,11,0,75,64
1658077455905,COGS 11,A01,083617,Boyle; Mary E. T.,23,0,48,25
1658077461927,COGS 13,A01,083071,Bastos; Amalia Pinkusfeld,12,0,71,59
1658077467958,COGS 14A,A01,092681,Semenuks; Arturs,5,1,100,95
1658077473995,COGS 14B,A01,083073,Cheng; Tzu-Han,7,0,63,56
1658077480019,COGS 17,A01,092677,Semenuks; Arturs,7,0,81,74
1658077486043,COGS 100,A01,083619,Allen; Michael Gordon,17,0,70,53
1658077492071,COGS 101A,A01,083621,Davis; Joshua Daniel,9,0,68,59
1658077498098,COGS 101B,A01,091572,Allen; Michael Gordon,14,0,65,51
1658077504133,COGS 101C,A01,083625,Delgado; Tania,17,0,35,18
1658077510251,COGS 107A,A01,083627,Boyle; Mary E. T.,14,0,60,46
1658077516278,COGS 118A,A01,083075,Gupta; Anjum,21,0,76,55
1658077522307,CSE 3,A50,083646,Miranda; Gregory Joseph,24,0,50,26
1658077528344,CSE 8A,A50,083650,Miranda; Gregory Joseph,17,1,56,39
1658077534367,CSE 11,A01,083080,Cao; Yingjun,7,15,40,33
1658077540394,CSE 12,A01,083652,Krause-Levy; Sophia Louisa,30,1,120,90
1658077546422,CSE 15L,A01,083654,Morris; Justin Loren,9,0,50,41
1658077546422,CSE 15L,A02,083655,Morris; Justin Loren,11,0,50,39
1658077552450,CSE 20,A01,083657,Tran; Khoa Dang,39,0,80,41
1658077558473,CSE 21,A01,095574,Bach; Quang Tran,23,0,48,25
1658077564496,CSE 30,A01,083084,Eldon; John,8,0,80,72
1658077564496,CSE 30,B01,095061,Bhaskar; Nishant,9,0,50,41
1658077570519,CSE 100,A01,083659,Cao; Yingjun,5,4,70,65
1658077576547,CSE 134B,A01,083661,Powell; Thomas Allan,25,0,100,75
1658077582571,CSE 140,A01,083663,Gungor; Onat,17,0,85,68
1658077588594,CSE 140L,A01,083088,Eldon; John,23,0,100,77
1658077594624,CSE 175,A01,083665,Kumar; Rakesh,3,0,25,22
1658077600647,CSE 190,A00,092507,Dubnov; Shlomo,8,0,20,12
1658077606671,ECE 45,A01,083139,Congero; Spencer William,7,0,75,68
1658077612694,ECE 65,A50,083695,Saad; Andrew S,12,0,30,18
1658077612694,ECE 65,A51,095125,Saad; Andrew S,24,0,26,2
1658077618718,ECE 109,A01,091882,Touri; Behrouz,21,0,70,49
1658077624745,ECE 180,A00,083140,Abi Samra; Nicholas Camill,1,0,30,29
1658077624745,ECE 180,B00,083141,Abi Samra; Nicholas Camill,0,0,30,30
1658077630785,MATH 10A,A01,083735,Patchell; Gregory David,2,0,30,28
1658077630785,MATH 10A,A02,083736,Patchell; Gregory David,20,0,30,10
1658077630785,MATH 10A,A03,083737,Patchell; Gregory David,16,0,30,14
1658077636809,MATH 10B,A01,083207,Lim; Seonhee,9,0,34,25
1658077636809,MATH 10B,A02,083208,Lim; Seonhee,10,0,35,25
1658077636809,MATH 10B,A03,093472,Lim; Seonhee,7,0,34,27
1658077636809,MATH 10B,B01,083739,Sinha; Shubham,14,0,30,16
1658077642833,MATH 18,A01,083743,Cinel; Cameron Alexander,9,0,30,21
1658077642833,MATH 18,A02,083744,Cinel; Cameron Alexander,18,0,30,12
1658077642833,MATH 18,A03,083745,Cinel; Cameron Alexander,10,0,30,20
1658077642833,MATH 18,B01,083748,Rideout; David Porter,5,0,37,32
1658077642833,MATH 18,B02,083749,Rideout; David Porter,5,0,36,31
1658077642833,MATH 18,B03,083750,Rideout; David Porter,3,0,37,34
1658077642833,MATH 18,B04,083751,Rideout; David Porter,7,0,36,29
1658077642833,MATH 18,B05,093473,Rideout; David Porter,7,0,36,29
1658077642833,MATH 18,B06,093474,Rideout; David Porter,6,0,36,30
1658077648861,MATH 20A,A01,083754,Zheng; Zequn,14,0,40,26
1658077654885,MATH 20B,A01,083756,Briones; Jor-el Thomas Caparas,4,0,36,32
1658077654885,MATH 20B,A02,083757,Briones; Jor-el Thomas Caparas,1,0,36,35
1658077654885,MATH 20B,A03,093475,Briones; Jor-el Thomas Caparas,3,0,36,33
1658077660906,MATH 20C,A01,083760,Briones; Jor-el Thomas Caparas,1,0,35,34
1658077660906,MATH 20C,A02,083761,Briones; Jor-el Thomas Caparas,8,0,35,27
1658077660906,MATH 20C,A03,093476,Briones; Jor-el Thomas Caparas,0,1,36,36
1658077660906,MATH 20C,B01,083762,Bach; Quang Tran,1,0,30,29
1658077666929,MATH 20D,A01,083765,Tran; Brian Kha,5,0,30,25
1658077666929,MATH 20D,A02,083766,Tran; Brian Kha,5,0,30,25
1658077666929,MATH 20D,A03,083767,Tran; Brian Kha,6,0,30,24
1658077672955,MATH 20E,A01,083771,Ganguly; Soumya,12,0,32,20
1658077672955,MATH 20E,A02,083772,Ganguly; Soumya,7,0,32,25
1658077672955,MATH 20E,B01,083773,Ciotti; Benjamin,20,0,35,15
1658077672955,MATH 20E,B02,083774,Ciotti; Benjamin,18,0,35,17
1658077678979,MATH 103A,A01,083777,Greenfeld; Be'Eri,6,0,36,30
1658077678979,MATH 103A,A02,083778,Greenfeld; Be'Eri,5,0,36,31
1658077678979,MATH 103A,A03,093561,Greenfeld; Be'Eri,7,0,36,29
1658077678979,MATH 103A,B01,083779,Greenfeld; Be'Eri,8,0,36,28
1658077678979,MATH 103A,B02,083780,Greenfeld; Be'Eri,4,0,36,32
1658077678979,MATH 103A,B03,093562,Greenfeld; Be'Eri,3,0,36,33
1658077685002,MATH 105,A01,085443,Carter; Anne Toulson,15,0,35,20
1658077685002,MATH 105,A02,093477,Carter; Anne Toulson,20,0,35,15
1658077691024,MATH 109,A01,083213,Ganzberger; Geoffrey Michael,3,0,34,31
1658077691024,MATH 109,A02,083214,Ganzberger; Geoffrey Michael,4,0,34,30
1658077691024,MATH 109,A03,093478,Ganzberger; Geoffrey Michael,2,0,34,32
1658077691024,MATH 109,B01,083215,Ganzberger; Geoffrey Michael,3,0,32,29
1658077691024,MATH 109,B02,083216,Ganzberger; Geoffrey Michael,3,0,32,29
1658077691024,MATH 109,B03,093479,Ganzberger; Geoffrey Michael,8,0,32,24
1658077697050,MATH 142A,A01,083219,Chow; Bennett,7,0,32,25
1658077697050,MATH 142A,A02,083220,Chow; Bennett,10,0,32,22
1658077697050,MATH 142A,A03,093480,Chow; Bennett,9,0,32,23
1658077697050,MATH 142A,B03,093481,Chow; Bennett,8,0,32,24
1658077697050,MATH 142A,B04,093558,Chow; Bennett,14,0,32,18
1658077697050,MATH 142A,B05,093559,Chow; Bennett,7,0,32,25
1658077703080,MATH 193A,A01,083224,Rotar; Vladimir,9,0,34,25
1658077703080,MATH 193A,A02,083225,Rotar; Vladimir,11,0,34,23
1658077703080,MATH 193A,A03,083781,Rotar; Vladimir,5,0,34,29
1658077703080,MATH 193A,A04,083782,Rotar; Vladimir,12,0,34,22
1658077703080,MATH 193A,A05,093482,Rotar; Vladimir,11,0,34,23
1658077709103,MATH 197,001,091859,McAuley; Julian John,9999,0,9999,0
1658077709103,MATH 197,002,095566,Kedlaya; Kiran S.,9997,0,9999,2
1658077709103,MATH 197,003,095567,Xiao; Ming,9999,0,9999,0
1658077709103,MATH 197,004,095571,Perols; Johan Lars,9998,0,9999,1
1658077716163,COGS 9,A01,083615,Shannon; Kyle Michael,11,0,75,64
1658077722186,COGS 11,A01,083617,Boyle; Mary E. T.,23,0,48,25
1658077728209,COGS 13,A01,083071,Bastos; Amalia Pinkusfeld,12,0,71,59
1658077734232,COGS 14A,A01,092681,Semenuks; Arturs,5,1,100,95
1658077740259,COGS 14B,A01,083073,Cheng; Tzu-Han,7,0,63,56
1658077746286,COGS 17,A01,092677,Semenuks; Arturs,7,0,81,74
1658077752311,COGS 100,A01,083619,Allen; Michael Gordon,17,0,70,53
1658077758335,COGS 101A,A01,083621,Davis; Joshua Daniel,9,0,68,59
1658077764363,COGS 101B,A01,091572,Allen; Michael Gordon,14,0,65,51
1658077770391,COGS 101C,A01,083625,Delgado; Tania,17,0,35,18
1658077776418,COGS 107A,A01,083627,Boyle; Mary E. T.,14,0,60,46
1658077782441,COGS 118A,A01,083075,Gupta; Anjum,21,0,76,55
1658077788475,CSE 3,A50,083646,Miranda; Gregory Joseph,24,0,50,26
1658077794500,CSE 8A,A50,083650,Miranda; Gregory Joseph,17,1,56,39
1658077800523,CSE 11,A01,083080,Cao; Yingjun,7,15,40,33
1658077806551,CSE 12,A01,083652,Krause-Levy; Sophia Louisa,30,1,120,90
1658077812587,CSE 15L,A01,083654,Morris; Justin Loren,9,0,50,41
1658077812587,CSE 15L,A02,083655,Morris; Justin Loren,11,0,50,39
1658077818611,CSE 20,A01,083657,Tran; Khoa Dang,39,0,80,41
1658077824640,CSE 21,A01,095574,Bach; Quang Tran,23,0,48,25
1658077830664,CSE 30,A01,083084,Eldon; John,8,0,80,72
1658077830664,CSE 30,B01,095061,Bhaskar; Nishant,9,0,50,41
1658077836697,CSE 100,A01,083659,Cao; Yingjun,5,4,70,65
1658077842722,CSE 134B,A01,083661,Powell; Thomas Allan,25,0,100,75
1658077848745,CSE 140,A01,083663,Gungor; Onat,17,0,85,68
1658077854773,CSE 140L,A01,083088,Eldon; John,23,0,100,77
1658077860797,CSE 175,A01,083665,Kumar; Rakesh,3,0,25,22
1658077866825,CSE 190,A00,092507,Dubnov; Shlomo,8,0,20,12
1658077872854,ECE 45,A01,083139,Congero; Spencer William,7,0,75,68
1658077878881,ECE 65,A50,083695,Saad; Andrew S,12,0,30,18
1658077878881,ECE 65,A51,095125,Saad; Andrew S,24,0,26,2
1658077884904,ECE 109,A01,091882,Touri; Behrouz,21,0,70,49
1658077890931,ECE 180,A00,083140,Abi Samra; Nicholas Camill,1,0,30,29
1658077890931,ECE 180,B00,083141,Abi Samra; Nicholas Camill,0,0,30,30
1658077896955,MATH 10A,A01,083735,Patchell; Gregory David,2,0,30,28
1658077896955,MATH 10A,A02,083736,Patchell; Gregory David,20,0,30,10
1658077896955,MATH 10A,A03,083737,Patchell; Gregory David,16,0,30,14
1658077902980,MATH 10B,A01,083207,Lim; Seonhee,9,0,34,25
1658077902980,MATH 10B,A02,083208,Lim; Seonhee,10,0,35,25
1658077902980,MATH 10B,A03,093472,Lim; Seonhee,7,0,34,27
1658077902980,MATH 10B,B01,083739,Sinha; Shubham,14,0,30,16
1658077909006,MATH 18,A01,083743,Cinel; Cameron Alexander,9,0,30,21
1658077909006,MATH 18,A02,083744,Cinel; Cameron Alexander,18,0,30,12
1658077909006,MATH 18,A03,083745,Cinel; Cameron Alexander,10,0,30,20
1658077909006,MATH 18,B01,083748,Rideout; David Porter,5,0,37,32
1658077909006,MATH 18,B02,083749,Rideout; David Porter,5,0,36,31
1658077909006,MATH 18,B03,083750,Rideout; David Porter,3,0,37,34
1658077909006,MATH 18,B04,083751,Rideout; David Porter,7,0,36,29
1658077909006,MATH 18,B05,093473,Rideout; David Porter,7,0,36,29
1658077909006,MATH 18,B06,093474,Rideout; David Porter,6,0,36,30
1658077915033,MATH 20A,A01,083754,Zheng; Zequn,14,0,40,26
1658077921057,MATH 20B,A01,083756,Briones; Jor-el Thomas Caparas,4,0,36,32
1658077921057,MATH 20B,A02,083757,Briones; Jor-el Thomas Caparas,1,0,36,35
1658077921057,MATH 20B,A03,093475,Briones; Jor-el Thomas Caparas,3,0,36,33
1658077927082,MATH 20C,A01,083760,Briones; Jor-el Thomas Caparas,1,0,35,34
1658077927082,MATH 20C,A02,083761,Briones; Jor-el Thomas Caparas,8,0,35,27
1658077927082,MATH 20C,A03,093476,Briones; Jor-el Thomas Caparas,0,1,36,36
1658077927082,MATH 20C,B01,083762,Bach; Quang Tran,1,0,30,29
1658077933109,MATH 20D,A01,083765,Tran; Brian Kha,5,0,30,25
1658077933109,MATH 20D,A02,083766,Tran; Brian Kha,5,0,30,25
1658077933109,MATH 20D,A03,083767,Tran; Brian Kha,6,0,30,24
1658077939137,MATH 20E,A01,083771,Ganguly; Soumya,12,0,32,20
1658077939137,MATH 20E,A02,083772,Ganguly; Soumya,7,0,32,25
1658077939137,MATH 20E,B01,083773,Ciotti; Benjamin,20,0,35,15
1658077939137,MATH 20E,B02,083774,Ciotti; Benjamin,18,0,35,17
1658077945167,MATH 103A,A01,083777,Greenfeld; Be'Eri,6,0,36,30
1658077945167,MATH 103A,A02,083778,Greenfeld; Be'Eri,5,0,36,31
1658077945167,MATH 103A,A03,093561,Greenfeld; Be'Eri,7,0,36,29
1658077945167,MATH 103A,B01,083779,Greenfeld; Be'Eri,8,0,36,28
1658077945167,MATH 103A,B02,083780,Greenfeld; Be'Eri,4,0,36,32
1658077945167,MATH 103A,B03,093562,Greenfeld; Be'Eri,3,0,36,33
1658077951192,MATH 105,A01,085443,Carter; Anne Toulson,15,0,35,20
1658077951192,MATH 105,A02,093477,Carter; Anne Toulson,20,0,35,15
1658077957216,MATH 109,A01,083213,Ganzberger; Geoffrey Michael,3,0,34,31
1658077957216,MATH 109,A02,083214,Ganzberger; Geoffrey Michael,4,0,34,30
1658077957216,MATH 109,A03,093478,Ganzberger; Geoffrey Michael,2,0,34,32
1658077957216,MATH 109,B01,083215,Ganzberger; Geoffrey Michael,3,0,32,29
1658077957216,MATH 109,B02,083216,Ganzberger; Geoffrey Michael,3,0,32,29
1658077957216,MATH 109,B03,093479,Ganzberger; Geoffrey Michael,8,0,32,24
1658077963246,MATH 142A,A01,083219,Chow; Bennett,7,0,32,25
1658077963246,MATH 142A,A02,083220,Chow; Bennett,10,0,32,22
1658077963246,MATH 142A,A03,093480,Chow; Bennett,9,0,32,23
1658077963246,MATH 142A,B03,093481,Chow; Bennett,8,0,32,24
1658077963246,MATH 142A,B04,093558,Chow; Bennett,14,0,32,18
1658077963246,MATH 142A,B05,093559,Chow; Bennett,7,0,32,25
1658077969270,MATH 193A,A01,083224,Rotar; Vladimir,9,0,34,25
1658077969270,MATH 193A,A02,083225,Rotar; Vladimir,11,0,34,23
1658077969270,MATH 193A,A03,083781,Rotar; Vladimir,5,0,34,29
1658077969270,MATH 193A,A04,083782,Rotar; Vladimir,12,0,34,22
1658077969270,MATH 193A,A05,093482,Rotar; Vladimir,11,0,34,23
1658077975294,MATH 197,001,091859,McAuley; Julian John,9999,0,9999,0
1658077975294,MATH 197,002,095566,Kedlaya; Kiran S.,9997,0,9999,2
1658077975294,MATH 197,003,095567,Xiao; Ming,9999,0,9999,0
1658077975294,MATH 197,004,095571,Perols; Johan Lars,9998,0,9999,1
1658077982358,COGS 9,A01,083615,Shannon; Kyle Michael,11,0,75,64
1658077988380,COGS 11,A01,083617,Boyle; Mary E. T.,23,0,48,25
1658077994404,COGS 13,A01,083071,Bastos; Amalia Pinkusfeld,12,0,71,59
1658078000429,COGS 14A,A01,092681,Semenuks; Arturs,5,1,100,95
1658078006456,COGS 14B,A01,083073,Cheng; Tzu-Han,7,0,63,56
1658078012479,COGS 17,A01,092677,Semenuks; Arturs,7,0,81,74
1658078018516,COGS 100,A01,083619,Allen; Michael Gordon,17,0,70,53
1658078024541,COGS 101A,A01,083621,Davis; Joshua Daniel,9,0,68,59
1658078030564,COGS 101B,A01,091572,Allen; Michael Gordon,14,0,65,51
1658078036587,COGS 101C,A01,083625,Delgado; Tania,17,0,35,18
1658078042610,COGS 107A,A01,083627,Boyle; Mary E. T.,14,0,60,46
1658078048638,COGS 118A,A01,083075,Gupta; Anjum,21,0,76,55
1658078054666,CSE 3,A50,083646,Miranda; Gregory Joseph,24,0,50,26
1658078060693,CSE 8A,A50,083650,Miranda; Gregory Joseph,17,1,56,39
1658078066718,CSE 11,A01,083080,Cao; Yingjun,7,15,40,33
1658078072742,CSE 12,A01,083652,Krause-Levy; Sophia Louisa,30,1,120,90
1658078078770,CSE 15L,A01,083654,Morris; Justin Loren,9,0,50,41
1658078078770,CSE 15L,A02,083655,Morris; Justin Loren,11,0,50,39
1658078084794,CSE 20,A01,083657,Tran; Khoa Dang,39,0,80,41
1658078090818,CSE 21,A01,095574,Bach; Quang Tran,23,0,48,25
1658078096843,CSE 30,A01,083084,Eldon; John,8,0,80,72
1658078096843,CSE 30,B01,095061,Bhaskar; Nishant,9,0,50,41
1658078102876,CSE 100,A01,083659,Cao; Yingjun,5,4,70,65
1658078108993,CSE 134B,A01,083661,Powell; Thomas Allan,25,0,100,75
1658078115020,CSE 140,A01,083663,Gungor; Onat,17,0,85,68
1658078121046,CSE 140L,A01,083088,Eldon; John,23,0,100,77
1658078127070,CSE 175,A01,083665,Kumar; Rakesh,3,0,25,22
1658078133092,CSE 190,A00,092507,Dubnov; Shlomo,8,0,20,12
1658078139116,ECE 45,A01,083139,Congero; Spencer William,7,0,75,68
1658078145145,ECE 65,A50,083695,Saad; Andrew S,12,0,30,18
1658078145145,ECE 65,A51,095125,Saad; Andrew S,24,0,26,2
1658078151166,ECE 109,A01,091882,Touri; Behrouz,21,0,70,49
1658078157194,ECE 180,A00,083140,Abi Samra; Nicholas Camill,1,0,30,29
1658078157194,ECE 180,B00,083141,Abi Samra; Nicholas Camill,0,0,30,30
1658078163219,MATH 10A,A01,083735,Patchell; Gregory David,2,0,30,28
1658078163219,MATH 10A,A02,083736,Patchell; Gregory David,20,0,30,10
1658078163219,MATH 10A,A03,083737,Patchell; Gregory David,16,0,30,14
1658078169244,MATH 10B,A01,083207,Lim; Seonhee,9,0,34,25
1658078169244,MATH 10B,A02,083208,Lim; Seonhee,10,0,35,25
1658078169244,MATH 10B,A03,093472,Lim; Seonhee,7,0,34,27
1658078169244,MATH 10B,B01,083739,Sinha; Shubham,14,0,30,16
1658078175269,MATH 18,A01,083743,Cinel; Cameron Alexander,9,0,30,21
1658078175269,MATH 18,A02,083744,Cinel; Cameron Alexander,18,0,30,12
1658078175269,MATH 18,A03,083745,Cinel; Cameron Alexander,10,0,30,20
1658078175269,MATH 18,B01,083748,Rideout; David Porter,5,0,37,32
1658078175269,MATH 18,B02,083749,Rideout; David Porter,5,0,36,31
1658078175269,MATH 18,B03,083750,Rideout; David Porter,3,0,37,34
1658078175269,MATH 18,B04,083751,Rideout; David Porter,7,0,36,29
1658078175269,MATH 18,B05,093473,Rideout; David Porter,7,0,36,29
1658078175269,MATH 18,B06,093474,Rideout; David Porter,6,0,36,30
1658078181296,MATH 20A,A01,083754,Zheng; Zequn,14,0,40,26
1658078187335,MATH 20B,A01,083756,Briones; Jor-el Thomas Caparas,4,0,36,32
1658078187335,MATH 20B,A02,083757,Briones; Jor-el Thomas Caparas,1,0,36,35
1658078187335,MATH 20B,A03,093475,Briones; Jor-el Thomas Caparas,3,0,36,33
1658078193361,MATH 20C,A01,083760,Briones; Jor-el Thomas Caparas,1,0,35,34
1658078193361,MATH 20C,A02,083761,Briones; Jor-el Thomas Caparas,8,0,35,27
1658078193361,MATH 20C,A03,093476,Briones; Jor-el Thomas Caparas,0,1,36,36
1658078193361,MATH 20C,B01,083762,Bach; Quang Tran,1,0,30,29
1658078199384,MATH 20D,A01,083765,Tran; Brian Kha,5,0,30,25
1658078199384,MATH 20D,A02,083766,Tran; Brian Kha,5,0,30,25
1658078199384,MATH 20D,A03,083767,Tran; Brian Kha,6,0,30,24
1658078205408,MATH 20E,A01,083771,Ganguly; Soumya,12,0,32,20
1658078205408,MATH 20E,A02,083772,Ganguly; Soumya,7,0,32,25
1658078205408,MATH 20E,B01,083773,Ciotti; Benjamin,20,0,35,15
1658078205408,MATH 20E,B02,083774,Ciotti; Benjamin,18,0,35,17
1658078211438,MATH 103A,A01,083777,Greenfeld; Be'Eri,6,0,36,30
1658078211438,MATH 103A,A02,083778,Greenfeld; Be'Eri,5,0,36,31
1658078211438,MATH 103A,A03,093561,Greenfeld; Be'Eri,7,0,36,29
1658078211438,MATH 103A,B01,083779,Greenfeld; Be'Eri,8,0,36,28
1658078211438,MATH 103A,B02,083780,Greenfeld; Be'Eri,4,0,36,32
1658078211438,MATH 103A,B03,093562,Greenfeld; Be'Eri,3,0,36,33
1658078217463,MATH 105,A01,085443,Carter; Anne Toulson,15,0,35,20
1658078217463,MATH 105,A02,093477,Carter; Anne Toulson,20,0,35,15
1658078223492,MATH 109,A01,083213,Ganzberger; Geoffrey Michael,3,0,34,31
1658078223492,MATH 109,A02,083214,Ganzberger; Geoffrey Michael,4,0,34,30
1658078223492,MATH 109,A03,093478,Ganzberger; Geoffrey Michael,2,0,34,32
1658078223492,MATH 109,B01,083215,Ganzberger; Geoffrey Michael,3,0,32,29
1658078223492,MATH 109,B02,083216,Ganzberger; Geoffrey Michael,3,0,32,29
1658078223492,MATH 109,B03,093479,Ganzberger; Geoffrey Michael,8,0,32,24
1658078229523,MATH 142A,A01,083219,Chow; Bennett,7,0,32,25
1658078229523,MATH 142A,A02,083220,Chow; Bennett,10,0,32,22
1658078229523,MATH 142A,A03,093480,Chow; Bennett,9,0,32,23
1658078229523,MATH 142A,B03,093481,Chow; Bennett,8,0,32,24
1658078229523,MATH 142A,B04,093558,Chow; Bennett,14,0,32,18
1658078229523,MATH 142A,B05,093559,Chow; Bennett,7,0,32,25
1658078235548,MATH 193A,A01,083224,Rotar; Vladimir,9,0,34,25
1658078235548,MATH 193A,A02,083225,Rotar; Vladimir,11,0,34,23
1658078235548,MATH 193A,A03,083781,Rotar; Vladimir,5,0,34,29
1658078235548,MATH 193A,A04,083782,Rotar; Vladimir,12,0,34,22
1658078235548,MATH 193A,A05,093482,Rotar; Vladimir,11,0,34,23
1658078241575,MATH 197,001,091859,McAuley; Julian John,9999,0,9999,0
1658078241575,MATH 197,002,095566,Kedlaya; Kiran S.,9997,0,9999,2
1658078241575,MATH 197,003,095567,Xiao; Ming,9999,0,9999,0
1658078241575,MATH 197,004,095571,Perols; Johan Lars,9998,0,9999,1
1658078248653,COGS 9,A01,083615,Shannon; Kyle Michael,11,0,75,64
1658078254681,COGS 11,A01,083617,Boyle; Mary E. T.,23,0,48,25
1658078260705,COGS 13,A01,083071,Bastos; Amalia Pinkusfeld,12,0,71,59
1658078266729,COGS 14A,A01,092681,Semenuks; Arturs,5,1,100,95
1658078272755,COGS 14B,A01,083073,Cheng; Tzu-Han,7,0,63,56
1658078278777,COGS 17,A01,092677,Semenuks; Arturs,7,0,81,74
1658078284803,COGS 100,A01,083619,Allen; Michael Gordon,17,0,70,53
1658078290828,COGS 101A,A01,083621,Davis; Joshua Daniel,9,0,68,59
1658078296856,COGS 101B,A01,091572,Allen; Michael Gordon,14,0,65,51
1658078302888,COGS 101C,A01,083625,Delgado; Tania,17,0,35,18
1658078308915,COGS 107A,A01,083627,Boyle; Mary E. T.,14,0,60,46
1658078314942,COGS 118A,A01,083075,Gupta; Anjum,21,0,76,55
1658078320967,CSE 3,A50,083646,Miranda; Gregory Joseph,24,0,50,26
1658078326992,CSE 8A,A50,083650,Miranda; Gregory Joseph,17,1,56,39
1658078333014,CSE 11,A01,083080,Cao; Yingjun,7,15,40,33
1658078339043,CSE 12,A01,083652,Krause-Levy; Sophia Louisa,30,1,120,90
1658078345073,CSE 15L,A01,083654,Morris; Justin Loren,9,0,50,41
1658078345073,CSE 15L,A02,083655,Morris; Justin Loren,11,0,50,39
1658078351097,CSE 20,A01,083657,Tran; Khoa Dang,39,0,80,41
1658078357125,CSE 21,A01,095574,Bach; Quang Tran,23,0,48,25
1658078363149,CSE 30,A01,083084,Eldon; John,8,0,80,72
1658078363149,CSE 30,B01,095061,Bhaskar; Nishant,9,0,50,41
1658078369173,CSE 100,A01,083659,Cao; Yingjun,5,4,70,65
1658078375200,CSE 134B,A01,083661,Powell; Thomas Allan,25,0,100,75
1658078381225,CSE 140,A01,083663,Gungor; Onat,17,0,85,68
1658078387253,CSE 140L,A01,083088,Eldon; John,23,0,100,77
1658078393280,CSE 175,A01,083665,Kumar; Rakesh,3,0,25,22
1658078399316,CSE 190,A00,092507,Dubnov; Shlomo,8,0,20,12
1658078405354,ECE 45,A01,083139,Congero; Spencer William,7,0,75,68
1658078411378,ECE 65,A50,083695,Saad; Andrew S,12,0,30,18
1658078411378,ECE 65,A51,095125,Saad; Andrew S,24,0,26,2
1658078417403,ECE 109,A01,091882,Touri; Behrouz,21,0,70,49
1658078423425,ECE 180,A00,083140,Abi Samra; Nicholas Camill,1,0,30,29
1658078423425,ECE 180,B00,083141,Abi Samra; Nicholas Camill,0,0,30,30
1658078429454,MATH 10A,A01,083735,Patchell; Gregory David,2,0,30,28
1658078429454,MATH 10A,A02,083736,Patchell; Gregory David,20,0,30,10
1658078429454,MATH 10A,A03,083737,Patchell; Gregory David,16,0,30,14
1658078435482,MATH 10B,A01,083207,Lim; Seonhee,9,0,34,25
1658078435482,MATH 10B,A02,083208,Lim; Seonhee,10,0,35,25
1658078435482,MATH 10B,A03,093472,Lim; Seonhee,7,0,34,27
1658078435482,MATH 10B,B01,083739,Sinha; Shubham,14,0,30,16
1658078441508,MATH 18,A01,083743,Cinel; Cameron Alexander,9,0,30,21
1658078441508,MATH 18,A02,083744,Cinel; Cameron Alexander,18,0,30,12
1658078441508,MATH 18,A03,083745,Cinel; Cameron Alexander,10,0,30,20
1658078441508,MATH 18,B01,083748,Rideout; David Porter,5,0,37,32
1658078441508,MATH 18,B02,083749,Rideout; David Porter,5,0,36,31
1658078441508,MATH 18,B03,083750,Rideout; David Porter,3,0,37,34
1658078441508,MATH 18,B04,083751,Rideout; David Porter,7,0,36,29
1658078441508,MATH 18,B05,093473,Rideout; David Porter,7,0,36,29
1658078441508,MATH 18,B06,093474,Rideout; David Porter,6,0,36,30
1658078447545,MATH 20A,A01,083754,Zheng; Zequn,14,0,40,26
1658078453578,MATH 20B,A01,083756,Briones; Jor-el Thomas Caparas,4,0,36,32
1658078453578,MATH 20B,A02,083757,Briones; Jor-el Thomas Caparas,1,0,36,35
1658078453578,MATH 20B,A03,093475,Briones; Jor-el Thomas Caparas,3,0,36,33
1658078459602,MATH 20C,A01,083760,Briones; Jor-el Thomas Caparas,1,0,35,34
1658078459602,MATH 20C,A02,083761,Briones; Jor-el Thomas Caparas,8,0,35,27
1658078459602,MATH 20C,A03,093476,Briones; Jor-el Thomas Caparas,0,1,36,36
1658078459602,MATH 20C,B01,083762,Bach; Quang Tran,1,0,30,29
1658078465626,MATH 20D,A01,083765,Tran; Brian Kha,5,0,30,25
1658078465626,MATH 20D,A02,083766,Tran; Brian Kha,5,0,30,25
1658078465626,MATH 20D,A03,083767,Tran; Brian Kha,6,0,30,24
1658078471655,MATH 20E,A01,083771,Ganguly; Soumya,12,0,32,20
1658078471655,MATH 20E,A02,083772,Ganguly; Soumya,7,0,32,25
1658078471655,MATH 20E,B01,083773,Ciotti; Benjamin,20,0,35,15
1658078471655,MATH 20E,B02,083774,Ciotti; Benjamin,18,0,35,17
1658078477685,MATH 103A,A01,083777,Greenfeld; Be'Eri,6,0,36,30
1658078477685,MATH 103A,A02,083778,Greenfeld; Be'Eri,5,0,36,31
1658078477685,MATH 103A,A03,093561,Greenfeld; Be'Eri,7,0,36,29
1658078477685,MATH 103A,B01,083779,Greenfeld; Be'Eri,8,0,36,28
1658078477685,MATH 103A,B02,083780,Greenfeld; Be'Eri,4,0,36,32
1658078477685,MATH 103A,B03,093562,Greenfeld; Be'Eri,3,0,36,33
1658078483713,MATH 105,A01,085443,Carter; Anne Toulson,15,0,35,20
1658078483713,MATH 105,A02,093477,Carter; Anne Toulson,20,0,35,15
1658078489737,MATH 109,A01,083213,Ganzberger; Geoffrey Michael,3,0,34,31
1658078489737,MATH 109,A02,083214,Ganzberger; Geoffrey Michael,4,0,34,30
1658078489737,MATH 109,A03,093478,Ganzberger; Geoffrey Michael,2,0,34,32
1658078489737,MATH 109,B01,083215,Ganzberger; Geoffrey Michael,3,0,32,29
1658078489737,MATH 109,B02,083216,Ganzberger; Geoffrey Michael,3,0,32,29
1658078489737,MATH 109,B03,093479,Ganzberger; Geoffrey Michael,8,0,32,24
1658078495762,MATH 142A,A01,083219,Chow; Bennett,7,0,32,25
1658078495762,MATH 142A,A02,083220,Chow; Bennett,10,0,32,22
1658078495762,MATH 142A,A03,093480,Chow; Bennett,9,0,32,23
1658078495762,MATH 142A,B03,093481,Chow; Bennett,8,0,32,24
1658078495762,MATH 142A,B04,093558,Chow; Bennett,14,0,32,18
1658078495762,MATH 142A,B05,093559,Chow; Bennett,7,0,32,25
1658078501785,MATH 193A,A01,083224,Rotar; Vladimir,9,0,34,25
1658078501785,MATH 193A,A02,083225,Rotar; Vladimir,11,0,34,23
1658078501785,MATH 193A,A03,083781,Rotar; Vladimir,5,0,34,29
1658078501785,MATH 193A,A04,083782,Rotar; Vladimir,12,0,34,22
1658078501785,MATH 193A,A05,093482,Rotar; Vladimir,11,0,34,23
1658078507809,MATH 197,001,091859,McAuley; Julian John,9999,0,9999,0
1658078507809,MATH 197,002,095566,Kedlaya; Kiran S.,9997,0,9999,2
1658078507809,MATH 197,003,095567,Xiao; Ming,9999,0,9999,0
1658078507809,MATH 197,004,095571,Perols; Johan Lars,9998,0,9999,1
1658078514888,COGS 9,A01,083615,Shannon; Kyle Michael,11,0,75,64
1658078520911,COGS 11,A01,083617,Boyle; Mary E. T.,23,0,48,25
1658078526936,COGS 13,A01,083071,Bastos; Amalia Pinkusfeld,12,0,71,59
1658078532959,COGS 14A,A01,092681,Semenuks; Arturs,5,1,100,95
1658078538989,COGS 14B,A01,083073,Cheng; Tzu-Han,7,0,63,56
1658078545018,COGS 17,A01,092677,Semenuks; Arturs,7,0,81,74
1658078551045,COGS 100,A01,083619,Allen; Michael Gordon,17,0,70,53
1658078557075,COGS 101A,A01,083621,Davis; Joshua Daniel,9,0,68,59
1658078563104,COGS 101B,A01,091572,Allen; Michael Gordon,14,0,65,51
1658078569127,COGS 101C,A01,083625,Delgado; Tania,17,0,35,18
1658078575156,COGS 107A,A01,083627,Boyle; Mary E. T.,14,0,60,46
1658078581184,COGS 118A,A01,083075,Gupta; Anjum,21,0,76,55
1658078587213,CSE 3,A50,083646,Miranda; Gregory Joseph,24,0,50,26
1658078593247,CSE 8A,A50,083650,Miranda; Gregory Joseph,17,1,56,39
1658078599271,CSE 11,A01,083080,Cao; Yingjun,7,15,40,33
1658078605295,CSE 12,A01,083652,Krause-Levy; Sophia Louisa,30,1,120,90
1658078611323,CSE 15L,A01,083654,Morris; Justin Loren,9,0,50,41
1658078611323,CSE 15L,A02,083655,Morris; Justin Loren,11,0,50,39
1658078617352,CSE 20,A01,083657,Tran; Khoa Dang,39,0,80,41
1658078623384,CSE 21,A01,095574,Bach; Quang Tran,23,0,48,25
1658078629412,CSE 30,A01,083084,Eldon; John,8,0,80,72
1658078629412,CSE 30,B01,095061,Bhaskar; Nishant,9,0,50,41
1658078635436,CSE 100,A01,083659,Cao; Yingjun,5,4,70,65
1658078641473,CSE 134B,A01,083661,Powell; Thomas Allan,25,0,100,75
1658078647496,CSE 140,A01,083663,Gungor; Onat,17,0,85,68
1658078653521,CSE 140L,A01,083088,Eldon; John,23,0,100,77
1658078659545,CSE 175,A01,083665,Kumar; Rakesh,3,0,25,22
1658078665568,CSE 190,A00,092507,Dubnov; Shlomo,8,0,20,12
1658078671590,ECE 45,A01,083139,Congero; Spencer William,7,0,75,68
1658078677619,ECE 65,A50,083695,Saad; Andrew S,12,0,30,18
1658078677619,ECE 65,A51,095125,Saad; Andrew S,24,0,26,2
1658078683646,ECE 109,A01,091882,Touri; Behrouz,21,0,70,49
1658078689674,ECE 180,A00,083140,Abi Samra; Nicholas Camill,1,0,30,29
1658078689674,ECE 180,B00,083141,Abi Samra; Nicholas Camill,0,0,30,30
1658078695698,MATH 10A,A01,083735,Patchell; Gregory David,2,0,30,28
1658078695698,MATH 10A,A02,083736,Patchell; Gregory David,20,0,30,10
1658078695698,MATH 10A,A03,083737,Patchell; Gregory David,16,0,30,14
1658078701734,MATH 10B,A01,083207,Lim; Seonhee,9,0,34,25
1658078701734,MATH 10B,A02,083208,Lim; Seonhee,10,0,35,25
1658078701734,MATH 10B,A03,093472,Lim; Seonhee,7,0,34,27
1658078701734,MATH 10B,B01,083739,Sinha; Shubham,14,0,30,16
1658078707835,MATH 18,A01,083743,Cinel; Cameron Alexander,9,0,30,21
1658078707835,MATH 18,A02,083744,Cinel; Cameron Alexander,18,0,30,12
1658078707835,MATH 18,A03,083745,Cinel; Cameron Alexander,10,0,30,20
1658078707835,MATH 18,B01,083748,Rideout; David Porter,5,0,37,32
1658078707835,MATH 18,B02,083749,Rideout; David Porter,5,0,36,31
1658078707835,MATH 18,B03,083750,Rideout; David Porter,3,0,37,34
1658078707835,MATH 18,B04,083751,Rideout; David Porter,7,0,36,29
1658078707835,MATH 18,B05,093473,Rideout; David Porter,7,0,36,29
1658078707835,MATH 18,B06,093474,Rideout; David Porter,6,0,36,30
1658078713866,MATH 20A,A01,083754,Zheng; Zequn,14,0,40,26
1658078719894,MATH 20B,A01,083756,Briones; Jor-el Thomas Caparas,4,0,36,32
1658078719894,MATH 20B,A02,083757,Briones; Jor-el Thomas Caparas,1,0,36,35
1658078719894,MATH 20B,A03,093475,Briones; Jor-el Thomas Caparas,3,0,36,33
1658078725923,MATH 20C,A01,083760,Briones; Jor-el Thomas Caparas,1,0,35,34
1658078725923,MATH 20C,A02,083761,Briones; Jor-el Thomas Caparas,8,0,35,27
1658078725923,MATH 20C,A03,093476,Briones; Jor-el Thomas Caparas,0,1,36,36
1658078725923,MATH 20C,B01,083762,Bach; Quang Tran,1,0,30,29
1658078731945,MATH 20D,A01,083765,Tran; Brian Kha,5,0,30,25
1658078731945,MATH 20D,A02,083766,Tran; Brian Kha,5,0,30,25
1658078731945,MATH 20D,A03,083767,Tran; Brian Kha,6,0,30,24
1658078737970,MATH 20E,A01,083771,Ganguly; Soumya,12,0,32,20
1658078737970,MATH 20E,A02,083772,Ganguly; Soumya,7,0,32,25
1658078737970,MATH 20E,B01,083773,Ciotti; Benjamin,20,0,35,15
1658078737970,MATH 20E,B02,083774,Ciotti; Benjamin,18,0,35,17
1658078743994,MATH 103A,A01,083777,Greenfeld; Be'Eri,6,0,36,30
1658078743994,MATH 103A,A02,083778,Greenfeld; Be'Eri,5,0,36,31
1658078743994,MATH 103A,A03,093561,Greenfeld; Be'Eri,7,0,36,29
1658078743994,MATH 103A,B01,083779,Greenfeld; Be'Eri,8,0,36,28
1658078743994,MATH 103A,B02,083780,Greenfeld; Be'Eri,4,0,36,32
1658078743994,MATH 103A,B03,093562,Greenfeld; Be'Eri,3,0,36,33
1658078750032,MATH 105,A01,085443,Carter; Anne Toulson,15,0,35,20
1658078750032,MATH 105,A02,093477,Carter; Anne Toulson,20,0,35,15
1658078756061,MATH 109,A01,083213,Ganzberger; Geoffrey Michael,3,0,34,31
1658078756061,MATH 109,A02,083214,Ganzberger; Geoffrey Michael,4,0,34,30
1658078756061,MATH 109,A03,093478,Ganzberger; Geoffrey Michael,2,0,34,32
1658078756061,MATH 109,B01,083215,Ganzberger; Geoffrey Michael,3,0,32,29
1658078756061,MATH 109,B02,083216,Ganzberger; Geoffrey Michael,3,0,32,29
1658078756061,MATH 109,B03,093479,Ganzberger; Geoffrey Michael,8,0,32,24
1658078762091,MATH 142A,A01,083219,Chow; Bennett,7,0,32,25
1658078762091,MATH 142A,A02,083220,Chow; Bennett,10,0,32,22
1658078762091,MATH 142A,A03,093480,Chow; Bennett,9,0,32,23
1658078762091,MATH 142A,B03,093481,Chow; Bennett,8,0,32,24
1658078762091,MATH 142A,B04,093558,Chow; Bennett,14,0,32,18
1658078762091,MATH 142A,B05,093559,Chow; Bennett,7,0,32,25
1658078768116,MATH 193A,A01,083224,Rotar; Vladimir,9,0,34,25
1658078768116,MATH 193A,A02,083225,Rotar; Vladimir,11,0,34,23
1658078768116,MATH 193A,A03,083781,Rotar; Vladimir,5,0,34,29
1658078768116,MATH 193A,A04,083782,Rotar; Vladimir,12,0,34,22
1658078768116,MATH 193A,A05,093482,Rotar; Vladimir,11,0,34,23
1658078774139,MATH 197,001,091859,McAuley; Julian John,9999,0,9999,0
1658078774139,MATH 197,002,095566,Kedlaya; Kiran S.,9997,0,9999,2
1658078774139,MATH 197,003,095567,Xiao; Ming,9999,0,9999,0
1658078774139,MATH 197,004,095571,Perols; Johan Lars,9998,0,9999,1
1658078781212,COGS 9,A01,083615,Shannon; Kyle Michael,11,0,75,64
1658078787242,COGS 11,A01,083617,Boyle; Mary E. T.,23,0,48,25
1658078793269,COGS 13,A01,083071,Bastos; Amalia Pinkusfeld,12,0,71,59
1658078799302,COGS 14A,A01,092681,Semenuks; Arturs,5,1,100,95
1658078805337,COGS 14B,A01,083073,Cheng; Tzu-Han,7,0,63,56
1658078811361,COGS 17,A01,092677,Semenuks; Arturs,7,0,81,74
1658078817384,COGS 100,A01,083619,Allen; Michael Gordon,17,0,70,53
1658078823406,COGS 101A,A01,083621,Davis; Joshua Daniel,9,0,68,59
1658078829432,COGS 101B,A01,091572,Allen; Michael Gordon,14,0,65,51
1658078835455,COGS 101C,A01,083625,Delgado; Tania,17,0,35,18
1658078841482,COGS 107A,A01,083627,Boyle; Mary E. T.,14,0,60,46
1658078847510,COGS 118A,A01,083075,Gupta; Anjum,21,0,76,55
1658078853535,CSE 3,A50,083646,Miranda; Gregory Joseph,24,0,50,26
1658078859559,CSE 8A,A50,083650,Miranda; Gregory Joseph,17,1,56,39
1658078865589,CSE 11,A01,083080,Cao; Yingjun,7,15,40,33
1658078871617,CSE 12,A01,083652,Krause-Levy; Sophia Louisa,30,1,120,90
1658078877640,CSE 15L,A01,083654,Morris; Justin Loren,9,0,50,41
1658078877640,CSE 15L,A02,083655,Morris; Justin Loren,11,0,50,39
1658078883667,CSE 20,A01,083657,Tran; Khoa Dang,39,0,80,41
1658078889696,CSE 21,A01,095574,Bach; Quang Tran,23,0,48,25
1658078895724,CSE 30,A01,083084,Eldon; John,8,0,80,72
1658078895724,CSE 30,B01,095061,Bhaskar; Nishant,9,0,50,41
1658078901747,CSE 100,A01,083659,Cao; Yingjun,5,4,70,65
1658078907772,CSE 134B,A01,083661,Powell; Thomas Allan,25,0,100,75
1658078913795,CSE 140,A01,083663,Gungor; Onat,17,0,85,68
1658078919818,CSE 140L,A01,083088,Eldon; John,23,0,100,77
1658078925842,CSE 175,A01,083665,Kumar; Rakesh,3,0,25,22
1658078931865,CSE 190,A00,092507,Dubnov; Shlomo,8,0,20,12
1658078937891,ECE 45,A01,083139,Congero; Spencer William,7,0,75,68
1658078943916,ECE 65,A50,083695,Saad; Andrew S,12,0,30,18
1658078943916,ECE 65,A51,095125,Saad; Andrew S,24,0,26,2
1658078949939,ECE 109,A01,091882,Touri; Behrouz,21,0,70,49
1658078955967,ECE 180,A00,083140,Abi Samra; Nicholas Camill,1,0,30,29
1658078955967,ECE 180,B00,083141,Abi Samra; Nicholas Camill,0,0,30,30
1658078961991,MATH 10A,A01,083735,Patchell; Gregory David,2,0,30,28
1658078961991,MATH 10A,A02,083736,Patchell; Gregory David,20,0,30,10
1658078961991,MATH 10A,A03,083737,Patchell; Gregory David,16,0,30,14
1658078968020,MATH 10B,A01,083207,Lim; Seonhee,9,0,34,25
1658078968020,MATH 10B,A02,083208,Lim; Seonhee,10,0,35,25
1658078968020,MATH 10B,A03,093472,Lim; Seonhee,7,0,34,27
1658078968020,MATH 10B,B01,083739,Sinha; Shubham,14,0,30,16
1658078974044,MATH 18,A01,083743,Cinel; Cameron Alexander,9,0,30,21
1658078974044,MATH 18,A02,083744,Cinel; Cameron Alexander,18,0,30,12
1658078974044,MATH 18,A03,083745,Cinel; Cameron Alexander,10,0,30,20
1658078974044,MATH 18,B01,083748,Rideout; David Porter,5,0,37,32
1658078974044,MATH 18,B02,083749,Rideout; David Porter,5,0,36,31
1658078974044,MATH 18,B03,083750,Rideout; David Porter,3,0,37,34
1658078974044,MATH 18,B04,083751,Rideout; David Porter,7,0,36,29
1658078974044,MATH 18,B05,093473,Rideout; David Porter,7,0,36,29
1658078974044,MATH 18,B06,093474,Rideout; David Porter,6,0,36,30
1658078980069,MATH 20A,A01,083754,Zheng; Zequn,14,0,40,26
1658078986099,MATH 20B,A01,083756,Briones; Jor-el Thomas Caparas,4,0,36,32
1658078986099,MATH 20B,A02,083757,Briones; Jor-el Thomas Caparas,1,0,36,35
1658078986099,MATH 20B,A03,093475,Briones; Jor-el Thomas Caparas,3,0,36,33
1658078992124,MATH 20C,A01,083760,Briones; Jor-el Thomas Caparas,1,0,35,34
1658078992124,MATH 20C,A02,083761,Briones; Jor-el Thomas Caparas,8,0,35,27
1658078992124,MATH 20C,A03,093476,Briones; Jor-el Thomas Caparas,0,1,36,36
1658078992124,MATH 20C,B01,083762,Bach; Quang Tran,1,0,30,29
1658078998153,MATH 20D,A01,083765,Tran; Brian Kha,5,0,30,25
1658078998153,MATH 20D,A02,083766,Tran; Brian Kha,5,0,30,25
1658078998153,MATH 20D,A03,083767,Tran; Brian Kha,6,0,30,24
1658079004176,MATH 20E,A01,083771,Ganguly; Soumya,12,0,32,20
1658079004176,MATH 20E,A02,083772,Ganguly; Soumya,7,0,32,25
1658079004176,MATH 20E,B01,083773,Ciotti; Benjamin,20,0,35,15
1658079004176,MATH 20E,B02,083774,Ciotti; Benjamin,18,0,35,17
1658079010208,MATH 103A,A01,083777,Greenfeld; Be'Eri,6,0,36,30
1658079010208,MATH 103A,A02,083778,Greenfeld; Be'Eri,5,0,36,31
1658079010208,MATH 103A,A03,093561,Greenfeld; Be'Eri,7,0,36,29
1658079010208,MATH 103A,B01,083779,Greenfeld; Be'Eri,8,0,36,28
1658079010208,MATH 103A,B02,083780,Greenfeld; Be'Eri,4,0,36,32
1658079010208,MATH 103A,B03,093562,Greenfeld; Be'Eri,3,0,36,33
1658079016234,MATH 105,A01,085443,Carter; Anne Toulson,15,0,35,20
1658079016234,MATH 105,A02,093477,Carter; Anne Toulson,20,0,35,15
1658079022257,MATH 109,A01,083213,Ganzberger; Geoffrey Michael,3,0,34,31
1658079022257,MATH 109,A02,083214,Ganzberger; Geoffrey Michael,4,0,34,30
1658079022257,MATH 109,A03,093478,Ganzberger; Geoffrey Michael,2,0,34,32
1658079022257,MATH 109,B01,083215,Ganzberger; Geoffrey Michael,3,0,32,29
1658079022257,MATH 109,B02,083216,Ganzberger; Geoffrey Michael,3,0,32,29
1658079022257,MATH 109,B03,093479,Ganzberger; Geoffrey Michael,8,0,32,24
1658079028282,MATH 142A,A01,083219,Chow; Bennett,7,0,32,25
1658079028282,MATH 142A,A02,083220,Chow; Bennett,10,0,32,22
1658079028282,MATH 142A,A03,093480,Chow; Bennett,9,0,32,23
1658079028282,MATH 142A,B03,093481,Chow; Bennett,8,0,32,24
1658079028282,MATH 142A,B04,093558,Chow; Bennett,14,0,32,18
1658079028282,MATH 142A,B05,093559,Chow; Bennett,7,0,32,25
1658079034307,MATH 193A,A01,083224,Rotar; Vladimir,9,0,34,25
1658079034307,MATH 193A,A02,083225,Rotar; Vladimir,11,0,34,23
1658079034307,MATH 193A,A03,083781,Rotar; Vladimir,5,0,34,29
1658079034307,MATH 193A,A04,083782,Rotar; Vladimir,12,0,34,22
1658079034307,MATH 193A,A05,093482,Rotar; Vladimir,11,0,34,23
1658079040334,MATH 197,001,091859,McAuley; Julian John,9999,0,9999,0
1658079040334,MATH 197,002,095566,Kedlaya; Kiran S.,9997,0,9999,2
1658079040334,MATH 197,003,095567,Xiao; Ming,9999,0,9999,0
1658079040334,MATH 197,004,095571,Perols; Johan Lars,9998,0,9999,1
1658079047397,COGS 9,A01,083615,Shannon; Kyle Michael,11,0,75,64
1658079053421,COGS 11,A01,083617,Boyle; Mary E. T.,23,0,48,25
1658079059447,COGS 13,A01,083071,Bastos; Amalia Pinkusfeld,12,0,71,59
1658079065474,COGS 14A,A01,092681,Semenuks; Arturs,5,1,100,95
1658079071501,COGS 14B,A01,083073,Cheng; Tzu-Han,7,0,63,56
1658079077524,COGS 17,A01,092677,Semenuks; Arturs,7,0,81,74
1658079083547,COGS 100,A01,083619,Allen; Michael Gordon,17,0,70,53
1658079089575,COGS 101A,A01,083621,Davis; Joshua Daniel,9,0,68,59
1658079095601,COGS 101B,A01,091572,Allen; Michael Gordon,14,0,65,51
1658079101625,COGS 101C,A01,083625,Delgado; Tania,17,0,35,18
1658079107656,COGS 107A,A01,083627,Boyle; Mary E. T.,14,0,60,46
1658079113683,COGS 118A,A01,083075,Gupta; Anjum,21,0,76,55
1658079119722,CSE 3,A50,083646,Miranda; Gregory Joseph,24,0,50,26
1658079125754,CSE 8A,A50,083650,Miranda; Gregory Joseph,17,1,56,39
1658079131776,CSE 11,A01,083080,Cao; Yingjun,7,15,40,33
1658079137816,CSE 12,A01,083652,Krause-Levy; Sophia Louisa,30,1,120,90
1658079143844,CSE 15L,A01,083654,Morris; Justin Loren,9,0,50,41
1658079143844,CSE 15L,A02,083655,Morris; Justin Loren,11,0,50,39
1658079149889,CSE 20,A01,083657,Tran; Khoa Dang,39,0,80,41
1658079155913,CSE 21,A01,095574,Bach; Quang Tran,23,0,48,25
1658079161941,CSE 30,A01,083084,Eldon; John,8,0,80,72
1658079161941,CSE 30,B01,095061,Bhaskar; Nishant,9,0,50,41
1658079167965,CSE 100,A01,083659,Cao; Yingjun,5,4,70,65
1658079173989,CSE 134B,A01,083661,Powell; Thomas Allan,25,0,100,75
1658079180012,CSE 140,A01,083663,Gungor; Onat,17,0,85,68
1658079186036,CSE 140L,A01,083088,Eldon; John,23,0,100,77
1658079192059,CSE 175,A01,083665,Kumar; Rakesh,3,0,25,22
1658079198085,CSE 190,A00,092507,Dubnov; Shlomo,8,0,20,12
1658079204112,ECE 45,A01,083139,Congero; Spencer William,7,0,75,68
1658079210135,ECE 65,A50,083695,Saad; Andrew S,12,0,30,18
1658079210135,ECE 65,A51,095125,Saad; Andrew S,24,0,26,2
1658079216158,ECE 109,A01,091882,Touri; Behrouz,21,0,70,49
1658079222179,ECE 180,A00,083140,Abi Samra; Nicholas Camill,1,0,30,29
1658079222179,ECE 180,B00,083141,Abi Samra; Nicholas Camill,0,0,30,30
1658079228211,MATH 10A,A01,083735,Patchell; Gregory David,2,0,30,28
1658079228211,MATH 10A,A02,083736,Patchell; Gregory David,20,0,30,10
1658079228211,MATH 10A,A03,083737,Patchell; Gregory David,16,0,30,14
1658079234239,MATH 10B,A01,083207,Lim; Seonhee,9,0,34,25
1658079234239,MATH 10B,A02,083208,Lim; Seonhee,10,0,35,25
1658079234239,MATH 10B,A03,093472,Lim; Seonhee,7,0,34,27
1658079234239,MATH 10B,B01,083739,Sinha; Shubham,14,0,30,16
1658079240266,MATH 18,A01,083743,Cinel; Cameron Alexander,9,0,30,21
1658079240266,MATH 18,A02,083744,Cinel; Cameron Alexander,18,0,30,12
1658079240266,MATH 18,A03,083745,Cinel; Cameron Alexander,10,0,30,20
1658079240266,MATH 18,B01,083748,Rideout; David Porter,5,0,37,32
1658079240266,MATH 18,B02,083749,Rideout; David Porter,5,0,36,31
1658079240266,MATH 18,B03,083750,Rideout; David Porter,3,0,37,34
1658079240266,MATH 18,B04,083751,Rideout; David Porter,7,0,36,29
1658079240266,MATH 18,B05,093473,Rideout; David Porter,7,0,36,29
1658079240266,MATH 18,B06,093474,Rideout; David Porter,6,0,36,30
1658079246290,MATH 20A,A01,083754,Zheng; Zequn,14,0,40,26
1658079252317,MATH 20B,A01,083756,Briones; Jor-el Thomas Caparas,4,0,36,32
1658079252317,MATH 20B,A02,083757,Briones; Jor-el Thomas Caparas,1,0,36,35
1658079252317,MATH 20B,A03,093475,Briones; Jor-el Thomas Caparas,3,0,36,33
1658079258343,MATH 20C,A01,083760,Briones; Jor-el Thomas Caparas,1,0,35,34
1658079258343,MATH 20C,A02,083761,Briones; Jor-el Thomas Caparas,8,0,35,27
1658079258343,MATH 20C,A03,093476,Briones; Jor-el Thomas Caparas,0,1,36,36
1658079258343,MATH 20C,B01,083762,Bach; Quang Tran,1,0,30,29
1658079264378,MATH 20D,A01,083765,Tran; Brian Kha,5,0,30,25
1658079264378,MATH 20D,A02,083766,Tran; Brian Kha,5,0,30,25
1658079264378,MATH 20D,A03,083767,Tran; Brian Kha,6,0,30,24
1658079270402,MATH 20E,A01,083771,Ganguly; Soumya,12,0,32,20
1658079270402,MATH 20E,A02,083772,Ganguly; Soumya,7,0,32,25
1658079270402,MATH 20E,B01,083773,Ciotti; Benjamin,20,0,35,15
1658079270402,MATH 20E,B02,083774,Ciotti; Benjamin,18,0,35,17
1658079276434,MATH 103A,A01,083777,Greenfeld; Be'Eri,6,0,36,30
1658079276434,MATH 103A,A02,083778,Greenfeld; Be'Eri,5,0,36,31
1658079276434,MATH 103A,A03,093561,Greenfeld; Be'Eri,7,0,36,29
1658079276434,MATH 103A,B01,083779,Greenfeld; Be'Eri,8,0,36,28
1658079276434,MATH 103A,B02,083780,Greenfeld; Be'Eri,4,0,36,32
1658079276434,MATH 103A,B03,093562,Greenfeld; Be'Eri,3,0,36,33
1658079282457,MATH 105,A01,085443,Carter; Anne Toulson,15,0,35,20
1658079282457,MATH 105,A02,093477,Carter; Anne Toulson,20,0,35,15
1658079288482,MATH 109,A01,083213,Ganzberger; Geoffrey Michael,3,0,34,31
1658079288482,MATH 109,A02,083214,Ganzberger; Geoffrey Michael,4,0,34,30
1658079288482,MATH 109,A03,093478,Ganzberger; Geoffrey Michael,2,0,34,32
1658079288482,MATH 109,B01,083215,Ganzberger; Geoffrey Michael,3,0,32,29
1658079288482,MATH 109,B02,083216,Ganzberger; Geoffrey Michael,3,0,32,29
1658079288482,MATH 109,B03,093479,Ganzberger; Geoffrey Michael,8,0,32,24
1658079294512,MATH 142A,A01,083219,Chow; Bennett,7,0,32,25
1658079294512,MATH 142A,A02,083220,Chow; Bennett,10,0,32,22
1658079294512,MATH 142A,A03,093480,Chow; Bennett,9,0,32,23
1658079294512,MATH 142A,B03,093481,Chow; Bennett,8,0,32,24
1658079294512,MATH 142A,B04,093558,Chow; Bennett,14,0,32,18
1658079294512,MATH 142A,B05,093559,Chow; Bennett,7,0,32,25
1658079300551,MATH 193A,A01,083224,Rotar; Vladimir,9,0,34,25
1658079300551,MATH 193A,A02,083225,Rotar; Vladimir,11,0,34,23
1658079300551,MATH 193A,A03,083781,Rotar; Vladimir,5,0,34,29
1658079300551,MATH 193A,A04,083782,Rotar; Vladimir,12,0,34,22
1658079300551,MATH 193A,A05,093482,Rotar; Vladimir,11,0,34,23
1658079306645,MATH 197,001,091859,McAuley; Julian John,9999,0,9999,0
1658079306645,MATH 197,002,095566,Kedlaya; Kiran S.,9997,0,9999,2
1658079306645,MATH 197,003,095567,Xiao; Ming,9999,0,9999,0
1658079306645,MATH 197,004,095571,Perols; Johan Lars,9998,0,9999,1
1658079313714,COGS 9,A01,083615,Shannon; Kyle Michael,11,0,75,64
1658079319738,COGS 11,A01,083617,Boyle; Mary E. T.,23,0,48,25
1658079325766,COGS 13,A01,083071,Bastos; Amalia Pinkusfeld,12,0,71,59
1658079331793,COGS 14A,A01,092681,Semenuks; Arturs,5,1,100,95
1658079337822,COGS 14B,A01,083073,Cheng; Tzu-Han,7,0,63,56
1658079343844,COGS 17,A01,092677,Semenuks; Arturs,7,0,81,74
1658079349870,COGS 100,A01,083619,Allen; Michael Gordon,17,0,70,53
1658079355893,COGS 101A,A01,083621,Davis; Joshua Daniel,9,0,68,59
1658079361917,COGS 101B,A01,091572,Allen; Michael Gordon,14,0,65,51
1658079367939,COGS 101C,A01,083625,Delgado; Tania,17,0,35,18
1658079373964,COGS 107A,A01,083627,Boyle; Mary E. T.,14,0,60,46
1658079379985,COGS 118A,A01,083075,Gupta; Anjum,21,0,76,55
1658079386008,CSE 3,A50,083646,Miranda; Gregory Joseph,24,0,50,26
1658079392034,CSE 8A,A50,083650,Miranda; Gregory Joseph,17,1,56,39
1658079398059,CSE 11,A01,083080,Cao; Yingjun,7,15,40,33
1658079404085,CSE 12,A01,083652,Krause-Levy; Sophia Louisa,30,1,120,90
1658079410111,CSE 15L,A01,083654,Morris; Justin Loren,9,0,50,41
1658079410111,CSE 15L,A02,083655,Morris; Justin Loren,11,0,50,39
1658079416139,CSE 20,A01,083657,Tran; Khoa Dang,39,0,80,41
1658079422162,CSE 21,A01,095574,Bach; Quang Tran,23,0,48,25
1658079428187,CSE 30,A01,083084,Eldon; John,8,0,80,72
1658079428187,CSE 30,B01,095061,Bhaskar; Nishant,9,0,50,41
1658079434213,CSE 100,A01,083659,Cao; Yingjun,5,4,70,65
1658079440237,CSE 134B,A01,083661,Powell; Thomas Allan,25,0,100,75
1658079446266,CSE 140,A01,083663,Gungor; Onat,17,0,85,68
1658079452290,CSE 140L,A01,083088,Eldon; John,23,0,100,77
1658079458311,CSE 175,A01,083665,Kumar; Rakesh,3,0,25,22
1658079464334,CSE 190,A00,092507,Dubnov; Shlomo,8,0,20,12
1658079470355,ECE 45,A01,083139,Congero; Spencer William,7,0,75,68
1658079476381,ECE 65,A50,083695,Saad; Andrew S,12,0,30,18
1658079476381,ECE 65,A51,095125,Saad; Andrew S,24,0,26,2
1658079482404,ECE 109,A01,091882,Touri; Behrouz,21,0,70,49
1658079488427,ECE 180,A00,083140,Abi Samra; Nicholas Camill,1,0,30,29
1658079488427,ECE 180,B00,083141,Abi Samra; Nicholas Camill,0,0,30,30
1658079494450,MATH 10A,A01,083735,Patchell; Gregory David,2,0,30,28
1658079494450,MATH 10A,A02,083736,Patchell; Gregory David,20,0,30,10
1658079494450,MATH 10A,A03,083737,Patchell; Gregory David,16,0,30,14
1658079500479,MATH 10B,A01,083207,Lim; Seonhee,9,0,34,25
1658079500479,MATH 10B,A02,083208,Lim; Seonhee,10,0,35,25
1658079500479,MATH 10B,A03,093472,Lim; Seonhee,7,0,34,27
1658079500479,MATH 10B,B01,083739,Sinha; Shubham,14,0,30,16
1658079506505,MATH 18,A01,083743,Cinel; Cameron Alexander,9,0,30,21
1658079506505,MATH 18,A02,083744,Cinel; Cameron Alexander,18,0,30,12
1658079506505,MATH 18,A03,083745,Cinel; Cameron Alexander,10,0,30,20
1658079506505,MATH 18,B01,083748,Rideout; David Porter,5,0,37,32
1658079506505,MATH 18,B02,083749,Rideout; David Porter,5,0,36,31
1658079506505,MATH 18,B03,083750,Rideout; David Porter,3,0,37,34
1658079506505,MATH 18,B04,083751,Rideout; David Porter,7,0,36,29
1658079506505,MATH 18,B05,093473,Rideout; David Porter,7,0,36,29
1658079506505,MATH 18,B06,093474,Rideout; David Porter,6,0,36,30
1658079512536,MATH 20A,A01,083754,Zheng; Zequn,14,0,40,26
1658079518565,MATH 20B,A01,083756,Briones; Jor-el Thomas Caparas,4,0,36,32
1658079518565,MATH 20B,A02,083757,Briones; Jor-el Thomas Caparas,1,0,36,35
1658079518565,MATH 20B,A03,093475,Briones; Jor-el Thomas Caparas,3,0,36,33
1658079524589,MATH 20C,A01,083760,Briones; Jor-el Thomas Caparas,1,0,35,34
1658079524589,MATH 20C,A02,083761,Briones; Jor-el Thomas Caparas,8,0,35,27
1658079524589,MATH 20C,A03,093476,Briones; Jor-el Thomas Caparas,0,1,36,36
1658079524589,MATH 20C,B01,083762,Bach; Quang Tran,1,0,30,29
1658079530614,MATH 20D,A01,083765,Tran; Brian Kha,5,0,30,25
1658079530614,MATH 20D,A02,083766,Tran; Brian Kha,5,0,30,25
1658079530614,MATH 20D,A03,083767,Tran; Brian Kha,6,0,30,24
1658079536636,MATH 20E,A01,083771,Ganguly; Soumya,12,0,32,20
1658079536636,MATH 20E,A02,083772,Ganguly; Soumya,7,0,32,25
1658079536636,MATH 20E,B01,083773,Ciotti; Benjamin,20,0,35,15
1658079536636,MATH 20E,B02,083774,Ciotti; Benjamin,18,0,35,17
1658079542665,MATH 103A,A01,083777,Greenfeld; Be'Eri,6,0,36,30
1658079542665,MATH 103A,A02,083778,Greenfeld; Be'Eri,5,0,36,31
1658079542665,MATH 103A,A03,093561,Greenfeld; Be'Eri,7,0,36,29
1658079542665,MATH 103A,B01,083779,Greenfeld; Be'Eri,8,0,36,28
1658079542665,MATH 103A,B02,083780,Greenfeld; Be'Eri,4,0,36,32
1658079542665,MATH 103A,B03,093562,Greenfeld; Be'Eri,3,0,36,33
1658079548691,MATH 105,A01,085443,Carter; Anne Toulson,15,0,35,20
1658079548691,MATH 105,A02,093477,Carter; Anne Toulson,20,0,35,15
1658079554720,MATH 109,A01,083213,Ganzberger; Geoffrey Michael,3,0,34,31
1658079554720,MATH 109,A02,083214,Ganzberger; Geoffrey Michael,4,0,34,30
1658079554720,MATH 109,A03,093478,Ganzberger; Geoffrey Michael,2,0,34,32
1658079554720,MATH 109,B01,083215,Ganzberger; Geoffrey Michael,3,0,32,29
1658079554720,MATH 109,B02,083216,Ganzberger; Geoffrey Michael,3,0,32,29
1658079554720,MATH 109,B03,093479,Ganzberger; Geoffrey Michael,8,0,32,24
1658079560743,MATH 142A,A01,083219,Chow; Bennett,7,0,32,25
1658079560743,MATH 142A,A02,083220,Chow; Bennett,10,0,32,22
1658079560743,MATH 142A,A03,093480,Chow; Bennett,9,0,32,23
1658079560743,MATH 142A,B03,093481,Chow; Bennett,8,0,32,24
1658079560743,MATH 142A,B04,093558,Chow; Bennett,14,0,32,18
1658079560743,MATH 142A,B05,093559,Chow; Bennett,7,0,32,25
1658079566766,MATH 193A,A01,083224,Rotar; Vladimir,9,0,34,25
1658079566766,MATH 193A,A02,083225,Rotar; Vladimir,11,0,34,23
1658079566766,MATH 193A,A03,083781,Rotar; Vladimir,5,0,34,29
1658079566766,MATH 193A,A04,083782,Rotar; Vladimir,12,0,34,22
1658079566766,MATH 193A,A05,093482,Rotar; Vladimir,11,0,34,23
1658079572793,MATH 197,001,091859,McAuley; Julian John,9999,0,9999,0
1658079572793,MATH 197,002,095566,Kedlaya; Kiran S.,9997,0,9999,2
1658079572793,MATH 197,003,095567,Xiao; Ming,9999,0,9999,0
1658079572793,MATH 197,004,095571,Perols; Johan Lars,9998,0,9999,1
1658079579853,COGS 9,A01,083615,Shannon; Kyle Michael,11,0,75,64
1658079585877,COGS 11,A01,083617,Boyle; Mary E. T.,23,0,48,25
1658079591900,COGS 13,A01,083071,Bastos; Amalia Pinkusfeld,12,0,71,59
1658079597927,COGS 14A,A01,092681,Semenuks; Arturs,5,1,100,95
1658079603953,COGS 14B,A01,083073,Cheng; Tzu-Han,7,0,63,56
1658079609979,COGS 17,A01,092677,Semenuks; Arturs,7,0,81,74
1658079616002,COGS 100,A01,083619,Allen; Michael Gordon,17,0,70,53
1658079622030,COGS 101A,A01,083621,Davis; Joshua Daniel,9,0,68,59
1658079628054,COGS 101B,A01,091572,Allen; Michael Gordon,14,0,65,51
1658079634080,COGS 101C,A01,083625,Delgado; Tania,17,0,35,18
1658079640102,COGS 107A,A01,083627,Boyle; Mary E. T.,14,0,60,46
1658079646128,COGS 118A,A01,083075,Gupta; Anjum,21,0,76,55
1658079652156,CSE 3,A50,083646,Miranda; Gregory Joseph,24,0,50,26
1658079658180,CSE 8A,A50,083650,Miranda; Gregory Joseph,17,1,56,39
1658079664202,CSE 11,A01,083080,Cao; Yingjun,7,15,40,33
1658079670224,CSE 12,A01,083652,Krause-Levy; Sophia Louisa,30,1,120,90
1658079676247,CSE 15L,A01,083654,Morris; Justin Loren,9,0,50,41
1658079676247,CSE 15L,A02,083655,Morris; Justin Loren,11,0,50,39
1658079682272,CSE 20,A01,083657,Tran; Khoa Dang,39,0,80,41
1658079688298,CSE 21,A01,095574,Bach; Quang Tran,23,0,48,25
1658079694322,CSE 30,A01,083084,Eldon; John,8,0,80,72
1658079694322,CSE 30,B01,095061,Bhaskar; Nishant,9,0,50,41
1658079700344,CSE 100,A01,083659,Cao; Yingjun,5,4,70,65
1658079706371,CSE 134B,A01,083661,Powell; Thomas Allan,25,0,100,75
1658079712397,CSE 140,A01,083663,Gungor; Onat,17,0,85,68
1658079718424,CSE 140L,A01,083088,Eldon; John,23,0,100,77
1658079724445,CSE 175,A01,083665,Kumar; Rakesh,3,0,25,22
1658079730471,CSE 190,A00,092507,Dubnov; Shlomo,8,0,20,12
1658079736499,ECE 45,A01,083139,Congero; Spencer William,7,0,75,68
1658079742527,ECE 65,A50,083695,Saad; Andrew S,12,0,30,18
1658079742527,ECE 65,A51,095125,Saad; Andrew S,24,0,26,2
1658079748551,ECE 109,A01,091882,Touri; Behrouz,21,0,70,49
1658079754582,ECE 180,A00,083140,Abi Samra; Nicholas Camill,1,0,30,29
1658079754582,ECE 180,B00,083141,Abi Samra; Nicholas Camill,0,0,30,30
1658079760605,MATH 10A,A01,083735,Patchell; Gregory David,2,0,30,28
1658079760605,MATH 10A,A02,083736,Patchell; Gregory David,20,0,30,10
1658079760605,MATH 10A,A03,083737,Patchell; Gregory David,16,0,30,14
1658079766629,MATH 10B,A01,083207,Lim; Seonhee,9,0,34,25
1658079766629,MATH 10B,A02,083208,Lim; Seonhee,10,0,35,25
1658079766629,MATH 10B,A03,093472,Lim; Seonhee,7,0,34,27
1658079766629,MATH 10B,B01,083739,Sinha; Shubham,14,0,30,16
1658079772660,MATH 18,A01,083743,Cinel; Cameron Alexander,9,0,30,21
1658079772660,MATH 18,A02,083744,Cinel; Cameron Alexander,18,0,30,12
1658079772660,MATH 18,A03,083745,Cinel; Cameron Alexander,10,0,30,20
1658079772660,MATH 18,B01,083748,Rideout; David Porter,5,0,37,32
1658079772660,MATH 18,B02,083749,Rideout; David Porter,5,0,36,31
1658079772660,MATH 18,B03,083750,Rideout; David Porter,3,0,37,34
1658079772660,MATH 18,B04,083751,Rideout; David Porter,7,0,36,29
1658079772660,MATH 18,B05,093473,Rideout; David Porter,7,0,36,29
1658079772660,MATH 18,B06,093474,Rideout; David Porter,6,0,36,30
1658079778687,MATH 20A,A01,083754,Zheng; Zequn,14,0,40,26
1658079784715,MATH 20B,A01,083756,Briones; Jor-el Thomas Caparas,4,0,36,32
1658079784715,MATH 20B,A02,083757,Briones; Jor-el Thomas Caparas,1,0,36,35
1658079784715,MATH 20B,A03,093475,Briones; Jor-el Thomas Caparas,3,0,36,33
1658079790736,MATH 20C,A01,083760,Briones; Jor-el Thomas Caparas,1,0,35,34
1658079790736,MATH 20C,A02,083761,Briones; Jor-el Thomas Caparas,8,0,35,27
1658079790736,MATH 20C,A03,093476,Briones; Jor-el Thomas Caparas,0,1,36,36
1658079790736,MATH 20C,B01,083762,Bach; Quang Tran,1,0,30,29
1658079796760,MATH 20D,A01,083765,Tran; Brian Kha,5,0,30,25
1658079796760,MATH 20D,A02,083766,Tran; Brian Kha,5,0,30,25
1658079796760,MATH 20D,A03,083767,Tran; Brian Kha,6,0,30,24
1658079802789,MATH 20E,A01,083771,Ganguly; Soumya,12,0,32,20
1658079802789,MATH 20E,A02,083772,Ganguly; Soumya,7,0,32,25
1658079802789,MATH 20E,B01,083773,Ciotti; Benjamin,20,0,35,15
1658079802789,MATH 20E,B02,083774,Ciotti; Benjamin,18,0,35,17
1658079808817,MATH 103A,A01,083777,Greenfeld; Be'Eri,6,0,36,30
1658079808817,MATH 103A,A02,083778,Greenfeld; Be'Eri,5,0,36,31
1658079808817,MATH 103A,A03,093561,Greenfeld; Be'Eri,7,0,36,29
1658079808817,MATH 103A,B01,083779,Greenfeld; Be'Eri,8,0,36,28
1658079808817,MATH 103A,B02,083780,Greenfeld; Be'Eri,4,0,36,32
1658079808817,MATH 103A,B03,093562,Greenfeld; Be'Eri,3,0,36,33
1658079814851,MATH 105,A01,085443,Carter; Anne Toulson,15,0,35,20
1658079814851,MATH 105,A02,093477,Carter; Anne Toulson,20,0,35,15
1658079820879,MATH 109,A01,083213,Ganzberger; Geoffrey Michael,3,0,34,31
1658079820879,MATH 109,A02,083214,Ganzberger; Geoffrey Michael,4,0,34,30
1658079820879,MATH 109,A03,093478,Ganzberger; Geoffrey Michael,2,0,34,32
1658079820879,MATH 109,B01,083215,Ganzberger; Geoffrey Michael,3,0,32,29
1658079820879,MATH 109,B02,083216,Ganzberger; Geoffrey Michael,3,0,32,29
1658079820879,MATH 109,B03,093479,Ganzberger; Geoffrey Michael,8,0,32,24
1658079826908,MATH 142A,A01,083219,Chow; Bennett,7,0,32,25
1658079826908,MATH 142A,A02,083220,Chow; Bennett,10,0,32,22
1658079826908,MATH 142A,A03,093480,Chow; Bennett,9,0,32,23
1658079826908,MATH 142A,B03,093481,Chow; Bennett,8,0,32,24
1658079826908,MATH 142A,B04,093558,Chow; Bennett,14,0,32,18
1658079826908,MATH 142A,B05,093559,Chow; Bennett,7,0,32,25
1658079832932,MATH 193A,A01,083224,Rotar; Vladimir,9,0,34,25
1658079832932,MATH 193A,A02,083225,Rotar; Vladimir,11,0,34,23
1658079832932,MATH 193A,A03,083781,Rotar; Vladimir,5,0,34,29
1658079832932,MATH 193A,A04,083782,Rotar; Vladimir,12,0,34,22
1658079832932,MATH 193A,A05,093482,Rotar; Vladimir,11,0,34,23
1658079838955,MATH 197,001,091859,McAuley; Julian John,9999,0,9999,0
1658079838955,MATH 197,002,095566,Kedlaya; Kiran S.,9997,0,9999,2
1658079838955,MATH 197,003,095567,Xiao; Ming,9999,0,9999,0
1658079838955,MATH 197,004,095571,Perols; Johan Lars,9998,0,9999,1
1658079846027,COGS 9,A01,083615,Shannon; Kyle Michael,11,0,75,64
1658079852057,COGS 11,A01,083617,Boyle; Mary E. T.,23,0,48,25
1658079858081,COGS 13,A01,083071,Bastos; Amalia Pinkusfeld,12,0,71,59
1658079864107,COGS 14A,A01,092681,Semenuks; Arturs,5,1,100,95
1658079870131,COGS 14B,A01,083073,Cheng; Tzu-Han,7,0,63,56
1658079876154,COGS 17,A01,092677,Semenuks; Arturs,7,0,81,74
1658079882178,COGS 100,A01,083619,Allen; Michael Gordon,17,0,70,53
1658079888208,COGS 101A,A01,083621,Davis; Joshua Daniel,9,0,68,59
1658079894235,COGS 101B,A01,091572,Allen; Michael Gordon,14,0,65,51
1658079900333,COGS 101C,A01,083625,Delgado; Tania,17,0,35,18
1658079906356,COGS 107A,A01,083627,Boyle; Mary E. T.,14,0,60,46
1658079912380,COGS 118A,A01,083075,Gupta; Anjum,21,0,76,55
1658079918409,CSE 3,A50,083646,Miranda; Gregory Joseph,24,0,50,26
1658079924433,CSE 8A,A50,083650,Miranda; Gregory Joseph,17,1,56,39
1658079930457,CSE 11,A01,083080,Cao; Yingjun,7,15,40,33
1658079936480,CSE 12,A01,083652,Krause-Levy; Sophia Louisa,30,1,120,90
1658079942505,CSE 15L,A01,083654,Morris; Justin Loren,9,0,50,41
1658079942505,CSE 15L,A02,083655,Morris; Justin Loren,11,0,50,39
1658079948541,CSE 20,A01,083657,Tran; Khoa Dang,39,0,80,41
1658079954565,CSE 21,A01,095574,Bach; Quang Tran,23,0,48,25
1658079960596,CSE 30,A01,083084,Eldon; John,8,0,80,72
1658079960596,CSE 30,B01,095061,Bhaskar; Nishant,9,0,50,41
1658079966620,CSE 100,A01,083659,Cao; Yingjun,5,4,70,65
1658079972647,CSE 134B,A01,083661,Powell; Thomas Allan,25,0,100,75
1658079978679,CSE 140,A01,083663,Gungor; Onat,17,0,85,68
1658079984703,CSE 140L,A01,083088,Eldon; John,23,0,100,77
1658079990726,CSE 175,A01,083665,Kumar; Rakesh,3,0,25,22
1658079996751,CSE 190,A00,092507,Dubnov; Shlomo,8,0,20,12
1658080002775,ECE 45,A01,083139,Congero; Spencer William,7,0,75,68
1658080008801,ECE 65,A50,083695,Saad; Andrew S,12,0,30,18
1658080008801,ECE 65,A51,095125,Saad; Andrew S,24,0,26,2
1658080014826,ECE 109,A01,091882,Touri; Behrouz,21,0,70,49
1658080020850,ECE 180,A00,083140,Abi Samra; Nicholas Camill,1,0,30,29
1658080020850,ECE 180,B00,083141,Abi Samra; Nicholas Camill,0,0,30,30
1658080026873,MATH 10A,A01,083735,Patchell; Gregory David,2,0,30,28
1658080026873,MATH 10A,A02,083736,Patchell; Gregory David,20,0,30,10
1658080026873,MATH 10A,A03,083737,Patchell; Gregory David,16,0,30,14
1658080032899,MATH 10B,A01,083207,Lim; Seonhee,9,0,34,25
1658080032899,MATH 10B,A02,083208,Lim; Seonhee,10,0,35,25
1658080032899,MATH 10B,A03,093472,Lim; Seonhee,7,0,34,27
1658080032899,MATH 10B,B01,083739,Sinha; Shubham,14,0,30,16
1658080038931,MATH 18,A01,083743,Cinel; Cameron Alexander,9,0,30,21
1658080038931,MATH 18,A02,083744,Cinel; Cameron Alexander,18,0,30,12
1658080038931,MATH 18,A03,083745,Cinel; Cameron Alexander,10,0,30,20
1658080038931,MATH 18,B01,083748,Rideout; David Porter,5,0,37,32
1658080038931,MATH 18,B02,083749,Rideout; David Porter,5,0,36,31
1658080038931,MATH 18,B03,083750,Rideout; David Porter,3,0,37,34
1658080038931,MATH 18,B04,083751,Rideout; David Porter,7,0,36,29
1658080038931,MATH 18,B05,093473,Rideout; David Porter,7,0,36,29
1658080038931,MATH 18,B06,093474,Rideout; David Porter,6,0,36,30
1658080044954,MATH 20A,A01,083754,Zheng; Zequn,14,0,40,26
1658080050981,MATH 20B,A01,083756,Briones; Jor-el Thomas Caparas,4,0,36,32
1658080050981,MATH 20B,A02,083757,Briones; Jor-el Thomas Caparas,1,0,36,35
1658080050981,MATH 20B,A03,093475,Briones; Jor-el Thomas Caparas,3,0,36,33
1658080057010,MATH 20C,A01,083760,Briones; Jor-el Thomas Caparas,1,0,35,34
1658080057010,MATH 20C,A02,083761,Briones; Jor-el Thomas Caparas,8,0,35,27
1658080057010,MATH 20C,A03,093476,Briones; Jor-el Thomas Caparas,0,1,36,36
1658080057010,MATH 20C,B01,083762,Bach; Quang Tran,1,0,30,29
1658080063038,MATH 20D,A01,083765,Tran; Brian Kha,5,0,30,25
1658080063038,MATH 20D,A02,083766,Tran; Brian Kha,5,0,30,25
1658080063038,MATH 20D,A03,083767,Tran; Brian Kha,6,0,30,24
1658080069061,MATH 20E,A01,083771,Ganguly; Soumya,12,0,32,20
1658080069061,MATH 20E,A02,083772,Ganguly; Soumya,7,0,32,25
1658080069061,MATH 20E,B01,083773,Ciotti; Benjamin,20,0,35,15
1658080069061,MATH 20E,B02,083774,Ciotti; Benjamin,18,0,35,17
1658080075087,MATH 103A,A01,083777,Greenfeld; Be'Eri,6,0,36,30
1658080075087,MATH 103A,A02,083778,Greenfeld; Be'Eri,5,0,36,31
1658080075087,MATH 103A,A03,093561,Greenfeld; Be'Eri,7,0,36,29
1658080075087,MATH 103A,B01,083779,Greenfeld; Be'Eri,8,0,36,28
1658080075087,MATH 103A,B02,083780,Greenfeld; Be'Eri,4,0,36,32
1658080075087,MATH 103A,B03,093562,Greenfeld; Be'Eri,3,0,36,33
1658080081111,MATH 105,A01,085443,Carter; Anne Toulson,15,0,35,20
1658080081111,MATH 105,A02,093477,Carter; Anne Toulson,20,0,35,15
1658080087143,MATH 109,A01,083213,Ganzberger; Geoffrey Michael,3,0,34,31
1658080087143,MATH 109,A02,083214,Ganzberger; Geoffrey Michael,4,0,34,30
1658080087143,MATH 109,A03,093478,Ganzberger; Geoffrey Michael,2,0,34,32
1658080087143,MATH 109,B01,083215,Ganzberger; Geoffrey Michael,3,0,32,29
1658080087143,MATH 109,B02,083216,Ganzberger; Geoffrey Michael,3,0,32,29
1658080087143,MATH 109,B03,093479,Ganzberger; Geoffrey Michael,8,0,32,24
1658080093167,MATH 142A,A01,083219,Chow; Bennett,7,0,32,25
1658080093167,MATH 142A,A02,083220,Chow; Bennett,10,0,32,22
1658080093167,MATH 142A,A03,093480,Chow; Bennett,9,0,32,23
1658080093167,MATH 142A,B03,093481,Chow; Bennett,8,0,32,24
1658080093167,MATH 142A,B04,093558,Chow; Bennett,14,0,32,18
1658080093167,MATH 142A,B05,093559,Chow; Bennett,7,0,32,25
1658080099198,MATH 193A,A01,083224,Rotar; Vladimir,9,0,34,25
1658080099198,MATH 193A,A02,083225,Rotar; Vladimir,11,0,34,23
1658080099198,MATH 193A,A03,083781,Rotar; Vladimir,5,0,34,29
1658080099198,MATH 193A,A04,083782,Rotar; Vladimir,12,0,34,22
1658080099198,MATH 193A,A05,093482,Rotar; Vladimir,11,0,34,23
1658080105228,MATH 197,001,091859,McAuley; Julian John,9999,0,9999,0
1658080105228,MATH 197,002,095566,Kedlaya; Kiran S.,9997,0,9999,2
1658080105228,MATH 197,003,095567,Xiao; Ming,9999,0,9999,0
1658080105228,MATH 197,004,095571,Perols; Johan Lars,9998,0,9999,1
1658080112278,COGS 9,A01,083615,Shannon; Kyle Michael,11,0,75,64
1658080118300,COGS 11,A01,083617,Boyle; Mary E. T.,23,0,48,25
1658080124324,COGS 13,A01,083071,Bastos; Amalia Pinkusfeld,12,0,71,59
1658080130378,COGS 14A,A01,092681,Semenuks; Arturs,5,1,100,95
1658080136405,COGS 14B,A01,083073,Cheng; Tzu-Han,7,0,63,56
1658080142432,COGS 17,A01,092677,Semenuks; Arturs,7,0,81,74
1658080148455,COGS 100,A01,083619,Allen; Michael Gordon,17,0,70,53
1658080154482,COGS 101A,A01,083621,Davis; Joshua Daniel,9,0,68,59
1658080160509,COGS 101B,A01,091572,Allen; Michael Gordon,14,0,65,51
1658080166532,COGS 101C,A01,083625,Delgado; Tania,17,0,35,18
1658080172555,COGS 107A,A01,083627,Boyle; Mary E. T.,14,0,60,46
1658080178580,COGS 118A,A01,083075,Gupta; Anjum,21,0,76,55
1658080184608,CSE 3,A50,083646,Miranda; Gregory Joseph,24,0,50,26
1658080190632,CSE 8A,A50,083650,Miranda; Gregory Joseph,17,1,56,39
1658080196659,CSE 11,A01,083080,Cao; Yingjun,7,15,40,33
1658080202684,CSE 12,A01,083652,Krause-Levy; Sophia Louisa,30,1,120,90
1658080208709,CSE 15L,A01,083654,Morris; Justin Loren,9,0,50,41
1658080208709,CSE 15L,A02,083655,Morris; Justin Loren,11,0,50,39
1658080214732,CSE 20,A01,083657,Tran; Khoa Dang,39,0,80,41
1658080220756,CSE 21,A01,095574,Bach; Quang Tran,23,0,48,25
1658080226780,CSE 30,A01,083084,Eldon; John,8,0,80,72
1658080226780,CSE 30,B01,095061,Bhaskar; Nishant,9,0,50,41
1658080232805,CSE 100,A01,083659,Cao; Yingjun,5,4,70,65
1658080238833,CSE 134B,A01,083661,Powell; Thomas Allan,25,0,100,75
1658080244859,CSE 140,A01,083663,Gungor; Onat,17,0,85,68
1658080250883,CSE 140L,A01,083088,Eldon; John,23,0,100,77
1658080256910,CSE 175,A01,083665,Kumar; Rakesh,3,0,25,22
1658080262942,CSE 190,A00,092507,Dubnov; Shlomo,8,0,20,12
1658080268966,ECE 45,A01,083139,Congero; Spencer William,7,0,75,68
1658080274991,ECE 65,A50,083695,Saad; Andrew S,12,0,30,18
1658080274991,ECE 65,A51,095125,Saad; Andrew S,24,0,26,2
1658080281024,ECE 109,A01,091882,Touri; Behrouz,21,0,70,49
1658080287052,ECE 180,A00,083140,Abi Samra; Nicholas Camill,1,0,30,29
1658080287052,ECE 180,B00,083141,Abi Samra; Nicholas Camill,0,0,30,30
1658080293076,MATH 10A,A01,083735,Patchell; Gregory David,2,0,30,28
1658080293076,MATH 10A,A02,083736,Patchell; Gregory David,20,0,30,10
1658080293076,MATH 10A,A03,083737,Patchell; Gregory David,16,0,30,14
1658080299104,MATH 10B,A01,083207,Lim; Seonhee,9,0,34,25
1658080299104,MATH 10B,A02,083208,Lim; Seonhee,10,0,35,25
1658080299104,MATH 10B,A03,093472,Lim; Seonhee,7,0,34,27
1658080299104,MATH 10B,B01,083739,Sinha; Shubham,14,0,30,16
1658080305130,MATH 18,A01,083743,Cinel; Cameron Alexander,9,0,30,21
1658080305130,MATH 18,A02,083744,Cinel; Cameron Alexander,18,0,30,12
1658080305130,MATH 18,A03,083745,Cinel; Cameron Alexander,10,0,30,20
1658080305130,MATH 18,B01,083748,Rideout; David Porter,5,0,37,32
1658080305130,MATH 18,B02,083749,Rideout; David Porter,5,0,36,31
1658080305130,MATH 18,B03,083750,Rideout; David Porter,3,0,37,34
1658080305130,MATH 18,B04,083751,Rideout; David Porter,7,0,36,29
1658080305130,MATH 18,B05,093473,Rideout; David Porter,7,0,36,29
1658080305130,MATH 18,B06,093474,Rideout; David Porter,6,0,36,30
1658080311153,MATH 20A,A01,083754,Zheng; Zequn,14,0,40,26
1658080317177,MATH 20B,A01,083756,Briones; Jor-el Thomas Caparas,4,0,36,32
1658080317177,MATH 20B,A02,083757,Briones; Jor-el Thomas Caparas,1,0,36,35
1658080317177,MATH 20B,A03,093475,Briones; Jor-el Thomas Caparas,3,0,36,33
1658080323201,MATH 20C,A01,083760,Briones; Jor-el Thomas Caparas,1,0,35,34
1658080323201,MATH 20C,A02,083761,Briones; Jor-el Thomas Caparas,8,0,35,27
1658080323201,MATH 20C,A03,093476,Briones; Jor-el Thomas Caparas,0,1,36,36
1658080323201,MATH 20C,B01,083762,Bach; Quang Tran,1,0,30,29
1658080329231,MATH 20D,A01,083765,Tran; Brian Kha,5,0,30,25
1658080329231,MATH 20D,A02,083766,Tran; Brian Kha,5,0,30,25
1658080329231,MATH 20D,A03,083767,Tran; Brian Kha,6,0,30,24
1658080335268,MATH 20E,A01,083771,Ganguly; Soumya,12,0,32,20
1658080335268,MATH 20E,A02,083772,Ganguly; Soumya,7,0,32,25
1658080335268,MATH 20E,B01,083773,Ciotti; Benjamin,20,0,35,15
1658080335268,MATH 20E,B02,083774,Ciotti; Benjamin,18,0,35,17
1658080341303,MATH 103A,A01,083777,Greenfeld; Be'Eri,6,0,36,30
1658080341303,MATH 103A,A02,083778,Greenfeld; Be'Eri,5,0,36,31
1658080341303,MATH 103A,A03,093561,Greenfeld; Be'Eri,7,0,36,29
1658080341303,MATH 103A,B01,083779,Greenfeld; Be'Eri,8,0,36,28
1658080341303,MATH 103A,B02,083780,Greenfeld; Be'Eri,4,0,36,32
1658080341303,MATH 103A,B03,093562,Greenfeld; Be'Eri,3,0,36,33
1658080347328,MATH 105,A01,085443,Carter; Anne Toulson,15,0,35,20
1658080347328,MATH 105,A02,093477,Carter; Anne Toulson,20,0,35,15
1658080353359,MATH 109,A01,083213,Ganzberger; Geoffrey Michael,3,0,34,31
1658080353359,MATH 109,A02,083214,Ganzberger; Geoffrey Michael,4,0,34,30
1658080353359,MATH 109,A03,093478,Ganzberger; Geoffrey Michael,2,0,34,32
1658080353359,MATH 109,B01,083215,Ganzberger; Geoffrey Michael,3,0,32,29
1658080353359,MATH 109,B02,083216,Ganzberger; Geoffrey Michael,3,0,32,29
1658080353359,MATH 109,B03,093479,Ganzberger; Geoffrey Michael,8,0,32,24
1658080359385,MATH 142A,A01,083219,Chow; Bennett,7,0,32,25
1658080359385,MATH 142A,A02,083220,Chow; Bennett,10,0,32,22
1658080359385,MATH 142A,A03,093480,Chow; Bennett,9,0,32,23
1658080359385,MATH 142A,B03,093481,Chow; Bennett,8,0,32,24
1658080359385,MATH 142A,B04,093558,Chow; Bennett,14,0,32,18
1658080359385,MATH 142A,B05,093559,Chow; Bennett,7,0,32,25
1658080365420,MATH 193A,A01,083224,Rotar; Vladimir,9,0,34,25
1658080365420,MATH 193A,A02,083225,Rotar; Vladimir,11,0,34,23
1658080365420,MATH 193A,A03,083781,Rotar; Vladimir,5,0,34,29
1658080365420,MATH 193A,A04,083782,Rotar; Vladimir,12,0,34,22
1658080365420,MATH 193A,A05,093482,Rotar; Vladimir,11,0,34,23
1658080371447,MATH 197,001,091859,McAuley; Julian John,9999,0,9999,0
1658080371447,MATH 197,002,095566,Kedlaya; Kiran S.,9997,0,9999,2
1658080371447,MATH 197,003,095567,Xiao; Ming,9999,0,9999,0
1658080371447,MATH 197,004,095571,Perols; Johan Lars,9998,0,9999,1
1658080378499,COGS 9,A01,083615,Shannon; Kyle Michael,11,0,75,64
1658080384535,COGS 11,A01,083617,Boyle; Mary E. T.,23,0,48,25
1658080390560,COGS 13,A01,083071,Bastos; Amalia Pinkusfeld,12,0,71,59
1658080396587,COGS 14A,A01,092681,Semenuks; Arturs,5,1,100,95
1658080402612,COGS 14B,A01,083073,Cheng; Tzu-Han,7,0,63,56
1658080408636,COGS 17,A01,092677,Semenuks; Arturs,7,0,81,74
1658080414661,COGS 100,A01,083619,Allen; Michael Gordon,17,0,70,53
1658080420686,COGS 101A,A01,083621,Davis; Joshua Daniel,9,0,68,59
1658080426712,COGS 101B,A01,091572,Allen; Michael Gordon,14,0,65,51
1658080432735,COGS 101C,A01,083625,Delgado; Tania,17,0,35,18
1658080438759,COGS 107A,A01,083627,Boyle; Mary E. T.,14,0,60,46
1658080444782,COGS 118A,A01,083075,Gupta; Anjum,21,0,76,55
1658080450808,CSE 3,A50,083646,Miranda; Gregory Joseph,24,0,50,26
1658080456831,CSE 8A,A50,083650,Miranda; Gregory Joseph,17,1,56,39
1658080462854,CSE 11,A01,083080,Cao; Yingjun,7,15,40,33
1658080468881,CSE 12,A01,083652,Krause-Levy; Sophia Louisa,30,1,120,90
1658080474909,CSE 15L,A01,083654,Morris; Justin Loren,9,0,50,41
1658080474909,CSE 15L,A02,083655,Morris; Justin Loren,11,0,50,39
1658080480933,CSE 20,A01,083657,Tran; Khoa Dang,39,0,80,41
1658080486960,CSE 21,A01,095574,Bach; Quang Tran,23,0,48,25
1658080492983,CSE 30,A01,083084,Eldon; John,8,0,80,72
1658080492983,CSE 30,B01,095061,Bhaskar; Nishant,9,0,50,41
1658080499095,CSE 100,A01,083659,Cao; Yingjun,5,4,70,65
1658080505124,CSE 134B,A01,083661,Powell; Thomas Allan,25,0,100,75
1658080511148,CSE 140,A01,083663,Gungor; Onat,17,0,85,68
1658080517172,CSE 140L,A01,083088,Eldon; John,23,0,100,77
1658080523197,CSE 175,A01,083665,Kumar; Rakesh,3,0,25,22
1658080529220,CSE 190,A00,092507,Dubnov; Shlomo,8,0,20,12
1658080535248,ECE 45,A01,083139,Congero; Spencer William,7,0,75,68
1658080541282,ECE 65,A50,083695,Saad; Andrew S,12,0,30,18
1658080541282,ECE 65,A51,095125,Saad; Andrew S,24,0,26,2
1658080547306,ECE 109,A01,091882,Touri; Behrouz,21,0,70,49
1658080553333,ECE 180,A00,083140,Abi Samra; Nicholas Camill,1,0,30,29
1658080553333,ECE 180,B00,083141,Abi Samra; Nicholas Camill,0,0,30,30
1658080559357,MATH 10A,A01,083735,Patchell; Gregory David,2,0,30,28
1658080559357,MATH 10A,A02,083736,Patchell; Gregory David,20,0,30,10
1658080559357,MATH 10A,A03,083737,Patchell; Gregory David,16,0,30,14
1658080565381,MATH 10B,A01,083207,Lim; Seonhee,9,0,34,25
1658080565381,MATH 10B,A02,083208,Lim; Seonhee,10,0,35,25
1658080565381,MATH 10B,A03,093472,Lim; Seonhee,7,0,34,27
1658080565381,MATH 10B,B01,083739,Sinha; Shubham,14,0,30,16
1658080571406,MATH 18,A01,083743,Cinel; Cameron Alexander,9,0,30,21
1658080571406,MATH 18,A02,083744,Cinel; Cameron Alexander,18,0,30,12
1658080571406,MATH 18,A03,083745,Cinel; Cameron Alexander,10,0,30,20
1658080571406,MATH 18,B01,083748,Rideout; David Porter,5,0,37,32
1658080571406,MATH 18,B02,083749,Rideout; David Porter,5,0,36,31
1658080571406,MATH 18,B03,083750,Rideout; David Porter,3,0,37,34
1658080571406,MATH 18,B04,083751,Rideout; David Porter,7,0,36,29
1658080571406,MATH 18,B05,093473,Rideout; David Porter,7,0,36,29
1658080571406,MATH 18,B06,093474,Rideout; David Porter,6,0,36,30
1658080577430,MATH 20A,A01,083754,Zheng; Zequn,14,0,40,26
1658080583453,MATH 20B,A01,083756,Briones; Jor-el Thomas Caparas,4,0,36,32
1658080583453,MATH 20B,A02,083757,Briones; Jor-el Thomas Caparas,1,0,36,35
1658080583453,MATH 20B,A03,093475,Briones; Jor-el Thomas Caparas,3,0,36,33
1658080589476,MATH 20C,A01,083760,Briones; Jor-el Thomas Caparas,1,0,35,34
1658080589476,MATH 20C,A02,083761,Briones; Jor-el Thomas Caparas,8,0,35,27
1658080589476,MATH 20C,A03,093476,Briones; Jor-el Thomas Caparas,0,1,36,36
1658080589476,MATH 20C,B01,083762,Bach; Quang Tran,1,0,30,29
1658080595504,MATH 20D,A01,083765,Tran; Brian Kha,5,0,30,25
1658080595504,MATH 20D,A02,083766,Tran; Brian Kha,5,0,30,25
1658080595504,MATH 20D,A03,083767,Tran; Brian Kha,6,0,30,24
1658080601534,MATH 20E,A01,083771,Ganguly; Soumya,12,0,32,20
1658080601534,MATH 20E,A02,083772,Ganguly; Soumya,7,0,32,25
1658080601534,MATH 20E,B01,083773,Ciotti; Benjamin,20,0,35,15
1658080601534,MATH 20E,B02,083774,Ciotti; Benjamin,18,0,35,17
1658080607558,MATH 103A,A01,083777,Greenfeld; Be'Eri,6,0,36,30
1658080607558,MATH 103A,A02,083778,Greenfeld; Be'Eri,5,0,36,31
1658080607558,MATH 103A,A03,093561,Greenfeld; Be'Eri,7,0,36,29
1658080607558,MATH 103A,B01,083779,Greenfeld; Be'Eri,8,0,36,28
1658080607558,MATH 103A,B02,083780,Greenfeld; Be'Eri,4,0,36,32
1658080607558,MATH 103A,B03,093562,Greenfeld; Be'Eri,3,0,36,33
1658080613581,MATH 105,A01,085443,Carter; Anne Toulson,15,0,35,20
1658080613581,MATH 105,A02,093477,Carter; Anne Toulson,20,0,35,15
1658080619610,MATH 109,A01,083213,Ganzberger; Geoffrey Michael,3,0,34,31
1658080619610,MATH 109,A02,083214,Ganzberger; Geoffrey Michael,4,0,34,30
1658080619610,MATH 109,A03,093478,Ganzberger; Geoffrey Michael,2,0,34,32
1658080619610,MATH 109,B01,083215,Ganzberger; Geoffrey Michael,3,0,32,29
1658080619610,MATH 109,B02,083216,Ganzberger; Geoffrey Michael,3,0,32,29
1658080619610,MATH 109,B03,093479,Ganzberger; Geoffrey Michael,8,0,32,24
1658080625634,MATH 142A,A01,083219,Chow; Bennett,7,0,32,25
1658080625634,MATH 142A,A02,083220,Chow; Bennett,10,0,32,22
1658080625634,MATH 142A,A03,093480,Chow; Bennett,9,0,32,23
1658080625634,MATH 142A,B03,093481,Chow; Bennett,8,0,32,24
1658080625634,MATH 142A,B04,093558,Chow; Bennett,14,0,32,18
1658080625634,MATH 142A,B05,093559,Chow; Bennett,7,0,32,25
1658080631663,MATH 193A,A01,083224,Rotar; Vladimir,9,0,34,25
1658080631663,MATH 193A,A02,083225,Rotar; Vladimir,11,0,34,23
1658080631663,MATH 193A,A03,083781,Rotar; Vladimir,5,0,34,29
1658080631663,MATH 193A,A04,083782,Rotar; Vladimir,12,0,34,22
1658080631663,MATH 193A,A05,093482,Rotar; Vladimir,11,0,34,23
1658080637686,MATH 197,001,091859,McAuley; Julian John,9999,0,9999,0
1658080637686,MATH 197,002,095566,Kedlaya; Kiran S.,9997,0,9999,2
1658080637686,MATH 197,003,095567,Xiao; Ming,9999,0,9999,0
1658080637686,MATH 197,004,095571,Perols; Johan Lars,9998,0,9999,1
1658080644741,COGS 9,A01,083615,Shannon; Kyle Michael,11,0,75,64
1658080650770,COGS 11,A01,083617,Boyle; Mary E. T.,23,0,48,25
1658080656793,COGS 13,A01,083071,Bastos; Amalia Pinkusfeld,12,0,71,59
1658080662817,COGS 14A,A01,092681,Semenuks; Arturs,5,1,100,95
1658080668844,COGS 14B,A01,083073,Cheng; Tzu-Han,7,0,63,56
1658080674875,COGS 17,A01,092677,Semenuks; Arturs,7,0,81,74
1658080680899,COGS 100,A01,083619,Allen; Michael Gordon,17,0,70,53
1658080686926,COGS 101A,A01,083621,Davis; Joshua Daniel,9,0,68,59
1658080692953,COGS 101B,A01,091572,Allen; Michael Gordon,14,0,65,51
1658080698976,COGS 101C,A01,083625,Delgado; Tania,17,0,35,18
1658080705001,COGS 107A,A01,083627,Boyle; Mary E. T.,14,0,60,46
1658080711025,COGS 118A,A01,083075,Gupta; Anjum,21,0,76,55
1658080717053,CSE 3,A50,083646,Miranda; Gregory Joseph,24,0,50,26
1658080723081,CSE 8A,A50,083650,Miranda; Gregory Joseph,17,1,56,39
1658080729108,CSE 11,A01,083080,Cao; Yingjun,7,15,40,33
1658080735131,CSE 12,A01,083652,Krause-Levy; Sophia Louisa,30,1,120,90
1658080741153,CSE 15L,A01,083654,Morris; Justin Loren,9,0,50,41
1658080741153,CSE 15L,A02,083655,Morris; Justin Loren,11,0,50,39
1658080747175,CSE 20,A01,083657,Tran; Khoa Dang,39,0,80,41
1658080753203,CSE 21,A01,095574,Bach; Quang Tran,23,0,48,25
1658080759229,CSE 30,A01,083084,Eldon; John,8,0,80,72
1658080759229,CSE 30,B01,095061,Bhaskar; Nishant,9,0,50,41
1658080765255,CSE 100,A01,083659,Cao; Yingjun,5,4,70,65
1658080771277,CSE 134B,A01,083661,Powell; Thomas Allan,25,0,100,75
1658080777304,CSE 140,A01,083663,Gungor; Onat,17,0,85,68
1658080783328,CSE 140L,A01,083088,Eldon; John,23,0,100,77
1658080789350,CSE 175,A01,083665,Kumar; Rakesh,3,0,25,22
1658080795378,CSE 190,A00,092507,Dubnov; Shlomo,8,0,20,12
1658080801415,ECE 45,A01,083139,Congero; Spencer William,7,0,75,68
1658080807443,ECE 65,A50,083695,Saad; Andrew S,12,0,30,18
1658080807443,ECE 65,A51,095125,Saad; Andrew S,24,0,26,2
1658080813467,ECE 109,A01,091882,Touri; Behrouz,21,0,70,49
1658080819494,ECE 180,A00,083140,Abi Samra; Nicholas Camill,1,0,30,29
1658080819494,ECE 180,B00,083141,Abi Samra; Nicholas Camill,0,0,30,30
1658080825517,MATH 10A,A01,083735,Patchell; Gregory David,2,0,30,28
1658080825517,MATH 10A,A02,083736,Patchell; Gregory David,20,0,30,10
1658080825517,MATH 10A,A03,083737,Patchell; Gregory David,16,0,30,14
1658080831546,MATH 10B,A01,083207,Lim; Seonhee,9,0,34,25
1658080831546,MATH 10B,A02,083208,Lim; Seonhee,10,0,35,25
1658080831546,MATH 10B,A03,093472,Lim; Seonhee,7,0,34,27
1658080831546,MATH 10B,B01,083739,Sinha; Shubham,14,0,30,16
1658080837570,MATH 18,A01,083743,Cinel; Cameron Alexander,9,0,30,21
1658080837570,MATH 18,A02,083744,Cinel; Cameron Alexander,18,0,30,12
1658080837570,MATH 18,A03,083745,Cinel; Cameron Alexander,10,0,30,20
1658080837570,MATH 18,B01,083748,Rideout; David Porter,5,0,37,32
1658080837570,MATH 18,B02,083749,Rideout; David Porter,5,0,36,31
1658080837570,MATH 18,B03,083750,Rideout; David Porter,3,0,37,34
1658080837570,MATH 18,B04,083751,Rideout; David Porter,7,0,36,29
1658080837570,MATH 18,B05,093473,Rideout; David Porter,7,0,36,29
1658080837570,MATH 18,B06,093474,Rideout; David Porter,6,0,36,30
1658080843595,MATH 20A,A01,083754,Zheng; Zequn,14,0,40,26
1658080849624,MATH 20B,A01,083756,Briones; Jor-el Thomas Caparas,4,0,36,32
1658080849624,MATH 20B,A02,083757,Briones; Jor-el Thomas Caparas,1,0,36,35
1658080849624,MATH 20B,A03,093475,Briones; Jor-el Thomas Caparas,3,0,36,33
1658080855648,MATH 20C,A01,083760,Briones; Jor-el Thomas Caparas,1,0,35,34
1658080855648,MATH 20C,A02,083761,Briones; Jor-el Thomas Caparas,8,0,35,27
1658080855648,MATH 20C,A03,093476,Briones; Jor-el Thomas Caparas,0,1,36,36
1658080855648,MATH 20C,B01,083762,Bach; Quang Tran,1,0,30,29
1658080861678,MATH 20D,A01,083765,Tran; Brian Kha,5,0,30,25
1658080861678,MATH 20D,A02,083766,Tran; Brian Kha,5,0,30,25
1658080861678,MATH 20D,A03,083767,Tran; Brian Kha,6,0,30,24
1658080867713,MATH 20E,A01,083771,Ganguly; Soumya,12,0,32,20
1658080867713,MATH 20E,A02,083772,Ganguly; Soumya,7,0,32,25
1658080867713,MATH 20E,B01,083773,Ciotti; Benjamin,20,0,35,15
1658080867713,MATH 20E,B02,083774,Ciotti; Benjamin,18,0,35,17
1658080873743,MATH 103A,A01,083777,Greenfeld; Be'Eri,6,0,36,30
1658080873743,MATH 103A,A02,083778,Greenfeld; Be'Eri,5,0,36,31
1658080873743,MATH 103A,A03,093561,Greenfeld; Be'Eri,7,0,36,29
1658080873743,MATH 103A,B01,083779,Greenfeld; Be'Eri,8,0,36,28
1658080873743,MATH 103A,B02,083780,Greenfeld; Be'Eri,4,0,36,32
1658080873743,MATH 103A,B03,093562,Greenfeld; Be'Eri,3,0,36,33
1658080879765,MATH 105,A01,085443,Carter; Anne Toulson,15,0,35,20
1658080879765,MATH 105,A02,093477,Carter; Anne Toulson,20,0,35,15
1658080885788,MATH 109,A01,083213,Ganzberger; Geoffrey Michael,3,0,34,31
1658080885788,MATH 109,A02,083214,Ganzberger; Geoffrey Michael,4,0,34,30
1658080885788,MATH 109,A03,093478,Ganzberger; Geoffrey Michael,2,0,34,32
1658080885788,MATH 109,B01,083215,Ganzberger; Geoffrey Michael,3,0,32,29
1658080885788,MATH 109,B02,083216,Ganzberger; Geoffrey Michael,3,0,32,29
1658080885788,MATH 109,B03,093479,Ganzberger; Geoffrey Michael,8,0,32,24
1658080891812,MATH 142A,A01,083219,Chow; Bennett,7,0,32,25
1658080891812,MATH 142A,A02,083220,Chow; Bennett,10,0,32,22
1658080891812,MATH 142A,A03,093480,Chow; Bennett,9,0,32,23
1658080891812,MATH 142A,B03,093481,Chow; Bennett,8,0,32,24
1658080891812,MATH 142A,B04,093558,Chow; Bennett,14,0,32,18
1658080891812,MATH 142A,B05,093559,Chow; Bennett,7,0,32,25
1658080897840,MATH 193A,A01,083224,Rotar; Vladimir,9,0,34,25
1658080897840,MATH 193A,A02,083225,Rotar; Vladimir,11,0,34,23
1658080897840,MATH 193A,A03,083781,Rotar; Vladimir,5,0,34,29
1658080897840,MATH 193A,A04,083782,Rotar; Vladimir,12,0,34,22
1658080897840,MATH 193A,A05,093482,Rotar; Vladimir,11,0,34,23
1658080903864,MATH 197,001,091859,McAuley; Julian John,9999,0,9999,0
1658080903864,MATH 197,002,095566,Kedlaya; Kiran S.,9997,0,9999,2
1658080903864,MATH 197,003,095567,Xiao; Ming,9999,0,9999,0
1658080903864,MATH 197,004,095571,Perols; Johan Lars,9998,0,9999,1
1658080910928,COGS 9,A01,083615,Shannon; Kyle Michael,11,0,75,64
1658080916952,COGS 11,A01,083617,Boyle; Mary E. T.,23,0,48,25
1658080922975,COGS 13,A01,083071,Bastos; Amalia Pinkusfeld,12,0,71,59
1658080929003,COGS 14A,A01,092681,Semenuks; Arturs,5,1,100,95
1658080935029,COGS 14B,A01,083073,Cheng; Tzu-Han,7,0,63,56
1658080941053,COGS 17,A01,092677,Semenuks; Arturs,7,0,81,74
1658080947077,COGS 100,A01,083619,Allen; Michael Gordon,17,0,70,53
1658080953103,COGS 101A,A01,083621,Davis; Joshua Daniel,9,0,68,59
1658080959134,COGS 101B,A01,091572,Allen; Michael Gordon,14,0,65,51
1658080965161,COGS 101C,A01,083625,Delgado; Tania,17,0,35,18
1658080971188,COGS 107A,A01,083627,Boyle; Mary E. T.,14,0,60,46
1658080977215,COGS 118A,A01,083075,Gupta; Anjum,21,0,76,55
1658080983239,CSE 3,A50,083646,Miranda; Gregory Joseph,24,0,50,26
1658080989263,CSE 8A,A50,083650,Miranda; Gregory Joseph,17,1,56,39
1658080995292,CSE 11,A01,083080,Cao; Yingjun,7,15,40,33
1658081001322,CSE 12,A01,083652,Krause-Levy; Sophia Louisa,30,1,120,90
1658081007349,CSE 15L,A01,083654,Morris; Justin Loren,9,0,50,41
1658081007349,CSE 15L,A02,083655,Morris; Justin Loren,11,0,50,39
1658081013373,CSE 20,A01,083657,Tran; Khoa Dang,39,0,80,41
1658081019396,CSE 21,A01,095574,Bach; Quang Tran,23,0,48,25
1658081025419,CSE 30,A01,083084,Eldon; John,8,0,80,72
1658081025419,CSE 30,B01,095061,Bhaskar; Nishant,9,0,50,41
1658081031450,CSE 100,A01,083659,Cao; Yingjun,5,4,70,65
1658081037474,CSE 134B,A01,083661,Powell; Thomas Allan,25,0,100,75
1658081043500,CSE 140,A01,083663,Gungor; Onat,17,0,85,68
1658081049525,CSE 140L,A01,083088,Eldon; John,23,0,100,77
1658081055548,CSE 175,A01,083665,Kumar; Rakesh,3,0,25,22
1658081061571,CSE 190,A00,092507,Dubnov; Shlomo,8,0,20,12
1658081067599,ECE 45,A01,083139,Congero; Spencer William,7,0,75,68
1658081073624,ECE 65,A50,083695,Saad; Andrew S,12,0,30,18
1658081073624,ECE 65,A51,095125,Saad; Andrew S,24,0,26,2
1658081079656,ECE 109,A01,091882,Touri; Behrouz,21,0,70,49
1658081085679,ECE 180,A00,083140,Abi Samra; Nicholas Camill,1,0,30,29
1658081085679,ECE 180,B00,083141,Abi Samra; Nicholas Camill,0,0,30,30
1658081091704,MATH 10A,A01,083735,Patchell; Gregory David,2,0,30,28
1658081091704,MATH 10A,A02,083736,Patchell; Gregory David,20,0,30,10
1658081091704,MATH 10A,A03,083737,Patchell; Gregory David,16,0,30,14
1658081097822,MATH 10B,A01,083207,Lim; Seonhee,9,0,34,25
1658081097822,MATH 10B,A02,083208,Lim; Seonhee,10,0,35,25
1658081097822,MATH 10B,A03,093472,Lim; Seonhee,7,0,34,27
1658081097822,MATH 10B,B01,083739,Sinha; Shubham,14,0,30,16
1658081103846,MATH 18,A01,083743,Cinel; Cameron Alexander,9,0,30,21
1658081103846,MATH 18,A02,083744,Cinel; Cameron Alexander,18,0,30,12
1658081103846,MATH 18,A03,083745,Cinel; Cameron Alexander,10,0,30,20
1658081103846,MATH 18,B01,083748,Rideout; David Porter,5,0,37,32
1658081103846,MATH 18,B02,083749,Rideout; David Porter,5,0,36,31
1658081103846,MATH 18,B03,083750,Rideout; David Porter,3,0,37,34
1658081103846,MATH 18,B04,083751,Rideout; David Porter,7,0,36,29
1658081103846,MATH 18,B05,093473,Rideout; David Porter,7,0,36,29
1658081103846,MATH 18,B06,093474,Rideout; David Porter,6,0,36,30
1658081109872,MATH 20A,A01,083754,Zheng; Zequn,14,0,40,26
1658081115896,MATH 20B,A01,083756,Briones; Jor-el Thomas Caparas,4,0,36,32
1658081115896,MATH 20B,A02,083757,Briones; Jor-el Thomas Caparas,1,0,36,35
1658081115896,MATH 20B,A03,093475,Briones; Jor-el Thomas Caparas,3,0,36,33
1658081121920,MATH 20C,A01,083760,Briones; Jor-el Thomas Caparas,1,0,35,34
1658081121920,MATH 20C,A02,083761,Briones; Jor-el Thomas Caparas,8,0,35,27
1658081121920,MATH 20C,A03,093476,Briones; Jor-el Thomas Caparas,0,1,36,36
1658081121920,MATH 20C,B01,083762,Bach; Quang Tran,1,0,30,29
1658081127944,MATH 20D,A01,083765,Tran; Brian Kha,5,0,30,25
1658081127944,MATH 20D,A02,083766,Tran; Brian Kha,5,0,30,25
1658081127944,MATH 20D,A03,083767,Tran; Brian Kha,6,0,30,24
1658081133968,MATH 20E,A01,083771,Ganguly; Soumya,12,0,32,20
1658081133968,MATH 20E,A02,083772,Ganguly; Soumya,7,0,32,25
1658081133968,MATH 20E,B01,083773,Ciotti; Benjamin,20,0,35,15
1658081133968,MATH 20E,B02,083774,Ciotti; Benjamin,18,0,35,17
1658081139998,MATH 103A,A01,083777,Greenfeld; Be'Eri,6,0,36,30
1658081139998,MATH 103A,A02,083778,Greenfeld; Be'Eri,5,0,36,31
1658081139998,MATH 103A,A03,093561,Greenfeld; Be'Eri,7,0,36,29
1658081139998,MATH 103A,B01,083779,Greenfeld; Be'Eri,8,0,36,28
1658081139998,MATH 103A,B02,083780,Greenfeld; Be'Eri,4,0,36,32
1658081139998,MATH 103A,B03,093562,Greenfeld; Be'Eri,3,0,36,33
1658081146022,MATH 105,A01,085443,Carter; Anne Toulson,15,0,35,20
1658081146022,MATH 105,A02,093477,Carter; Anne Toulson,20,0,35,15
1658081152045,MATH 109,A01,083213,Ganzberger; Geoffrey Michael,3,0,34,31
1658081152045,MATH 109,A02,083214,Ganzberger; Geoffrey Michael,4,0,34,30
1658081152045,MATH 109,A03,093478,Ganzberger; Geoffrey Michael,2,0,34,32
1658081152045,MATH 109,B01,083215,Ganzberger; Geoffrey Michael,3,0,32,29
1658081152045,MATH 109,B02,083216,Ganzberger; Geoffrey Michael,3,0,32,29
1658081152045,MATH 109,B03,093479,Ganzberger; Geoffrey Michael,8,0,32,24
1658081158071,MATH 142A,A01,083219,Chow; Bennett,7,0,32,25
1658081158071,MATH 142A,A02,083220,Chow; Bennett,10,0,32,22
1658081158071,MATH 142A,A03,093480,Chow; Bennett,9,0,32,23
1658081158071,MATH 142A,B03,093481,Chow; Bennett,8,0,32,24
1658081158071,MATH 142A,B04,093558,Chow; Bennett,14,0,32,18
1658081158071,MATH 142A,B05,093559,Chow; Bennett,7,0,32,25
1658081164096,MATH 193A,A01,083224,Rotar; Vladimir,9,0,34,25
1658081164096,MATH 193A,A02,083225,Rotar; Vladimir,11,0,34,23
1658081164096,MATH 193A,A03,083781,Rotar; Vladimir,5,0,34,29
1658081164096,MATH 193A,A04,083782,Rotar; Vladimir,12,0,34,22
1658081164096,MATH 193A,A05,093482,Rotar; Vladimir,11,0,34,23
1658081170119,MATH 197,001,091859,McAuley; Julian John,9999,0,9999,0
1658081170119,MATH 197,002,095566,Kedlaya; Kiran S.,9997,0,9999,2
1658081170119,MATH 197,003,095567,Xiao; Ming,9999,0,9999,0
1658081170119,MATH 197,004,095571,Perols; Johan Lars,9998,0,9999,1
1658081177182,COGS 9,A01,083615,Shannon; Kyle Michael,11,0,75,64
1658081183208,COGS 11,A01,083617,Boyle; Mary E. T.,23,0,48,25
1658081189235,COGS 13,A01,083071,Bastos; Amalia Pinkusfeld,12,0,71,59
1658081195262,COGS 14A,A01,092681,Semenuks; Arturs,5,1,100,95
1658081201286,COGS 14B,A01,083073,Cheng; Tzu-Han,7,0,63,56
1658081207309,COGS 17,A01,092677,Semenuks; Arturs,7,0,81,74
1658081213332,COGS 100,A01,083619,Allen; Michael Gordon,17,0,70,53
1658081219357,COGS 101A,A01,083621,Davis; Joshua Daniel,9,0,68,59
1658081225384,COGS 101B,A01,091572,Allen; Michael Gordon,14,0,65,51
1658081231408,COGS 101C,A01,083625,Delgado; Tania,17,0,35,18
1658081237431,COGS 107A,A01,083627,Boyle; Mary E. T.,14,0,60,46
1658081243455,COGS 118A,A01,083075,Gupta; Anjum,21,0,76,55
1658081249485,CSE 3,A50,083646,Miranda; Gregory Joseph,24,0,50,26
1658081255509,CSE 8A,A50,083650,Miranda; Gregory Joseph,17,1,56,39
1658081261533,CSE 11,A01,083080,Cao; Yingjun,7,15,40,33
1658081267557,CSE 12,A01,083652,Krause-Levy; Sophia Louisa,30,1,120,90
1658081273581,CSE 15L,A01,083654,Morris; Justin Loren,9,0,50,41
1658081273581,CSE 15L,A02,083655,Morris; Justin Loren,11,0,50,39
1658081279604,CSE 20,A01,083657,Tran; Khoa Dang,39,0,80,41
1658081285633,CSE 21,A01,095574,Bach; Quang Tran,23,0,48,25
1658081291656,CSE 30,A01,083084,Eldon; John,8,0,80,72
1658081291656,CSE 30,B01,095061,Bhaskar; Nishant,9,0,50,41
1658081297679,CSE 100,A01,083659,Cao; Yingjun,5,4,70,65
1658081303703,CSE 134B,A01,083661,Powell; Thomas Allan,25,0,100,75
1658081309730,CSE 140,A01,083663,Gungor; Onat,17,0,85,68
1658081315753,CSE 140L,A01,083088,Eldon; John,23,0,100,77
1658081321775,CSE 175,A01,083665,Kumar; Rakesh,3,0,25,22
1658081327798,CSE 190,A00,092507,Dubnov; Shlomo,8,0,20,12
1658081333821,ECE 45,A01,083139,Congero; Spencer William,7,0,75,68
1658081339849,ECE 65,A50,083695,Saad; Andrew S,12,0,30,18
1658081339849,ECE 65,A51,095125,Saad; Andrew S,24,0,26,2
1658081345876,ECE 109,A01,091882,Touri; Behrouz,21,0,70,49
1658081351899,ECE 180,A00,083140,Abi Samra; Nicholas Camill,1,0,30,29
1658081351899,ECE 180,B00,083141,Abi Samra; Nicholas Camill,0,0,30,30
1658081357926,MATH 10A,A01,083735,Patchell; Gregory David,2,0,30,28
1658081357926,MATH 10A,A02,083736,Patchell; Gregory David,20,0,30,10
1658081357926,MATH 10A,A03,083737,Patchell; Gregory David,16,0,30,14
1658081363950,MATH 10B,A01,083207,Lim; Seonhee,9,0,34,25
1658081363950,MATH 10B,A02,083208,Lim; Seonhee,10,0,35,25
1658081363950,MATH 10B,A03,093472,Lim; Seonhee,7,0,34,27
1658081363950,MATH 10B,B01,083739,Sinha; Shubham,14,0,30,16
1658081369975,MATH 18,A01,083743,Cinel; Cameron Alexander,9,0,30,21
1658081369975,MATH 18,A02,083744,Cinel; Cameron Alexander,18,0,30,12
1658081369975,MATH 18,A03,083745,Cinel; Cameron Alexander,10,0,30,20
1658081369975,MATH 18,B01,083748,Rideout; David Porter,5,0,37,32
1658081369975,MATH 18,B02,083749,Rideout; David Porter,5,0,36,31
1658081369975,MATH 18,B03,083750,Rideout; David Porter,3,0,37,34
1658081369975,MATH 18,B04,083751,Rideout; David Porter,7,0,36,29
1658081369975,MATH 18,B05,093473,Rideout; David Porter,7,0,36,29
1658081369975,MATH 18,B06,093474,Rideout; David Porter,6,0,36,30
1658081375999,MATH 20A,A01,083754,Zheng; Zequn,14,0,40,26
1658081382028,MATH 20B,A01,083756,Briones; Jor-el Thomas Caparas,4,0,36,32
1658081382028,MATH 20B,A02,083757,Briones; Jor-el Thomas Caparas,1,0,36,35
1658081382028,MATH 20B,A03,093475,Briones; Jor-el Thomas Caparas,3,0,36,33
1658081388057,MATH 20C,A01,083760,Briones; Jor-el Thomas Caparas,1,0,35,34
1658081388057,MATH 20C,A02,083761,Briones; Jor-el Thomas Caparas,8,0,35,27
1658081388057,MATH 20C,A03,093476,Briones; Jor-el Thomas Caparas,0,1,36,36
1658081388057,MATH 20C,B01,083762,Bach; Quang Tran,1,0,30,29
1658081394080,MATH 20D,A01,083765,Tran; Brian Kha,5,0,30,25
1658081394080,MATH 20D,A02,083766,Tran; Brian Kha,5,0,30,25
1658081394080,MATH 20D,A03,083767,Tran; Brian Kha,6,0,30,24
1658081400109,MATH 20E,A01,083771,Ganguly; Soumya,12,0,32,20
1658081400109,MATH 20E,A02,083772,Ganguly; Soumya,7,0,32,25
1658081400109,MATH 20E,B01,083773,Ciotti; Benjamin,20,0,35,15
1658081400109,MATH 20E,B02,083774,Ciotti; Benjamin,18,0,35,17
1658081406141,MATH 103A,A01,083777,Greenfeld; Be'Eri,6,0,36,30
1658081406141,MATH 103A,A02,083778,Greenfeld; Be'Eri,5,0,36,31
1658081406141,MATH 103A,A03,093561,Greenfeld; Be'Eri,7,0,36,29
1658081406141,MATH 103A,B01,083779,Greenfeld; Be'Eri,8,0,36,28
1658081406141,MATH 103A,B02,083780,Greenfeld; Be'Eri,4,0,36,32
1658081406141,MATH 103A,B03,093562,Greenfeld; Be'Eri,3,0,36,33
1658081412168,MATH 105,A01,085443,Carter; Anne Toulson,15,0,35,20
1658081412168,MATH 105,A02,093477,Carter; Anne Toulson,20,0,35,15
1658081418194,MATH 109,A01,083213,Ganzberger; Geoffrey Michael,3,0,34,31
1658081418194,MATH 109,A02,083214,Ganzberger; Geoffrey Michael,4,0,34,30
1658081418194,MATH 109,A03,093478,Ganzberger; Geoffrey Michael,2,0,34,32
1658081418194,MATH 109,B01,083215,Ganzberger; Geoffrey Michael,3,0,32,29
1658081418194,MATH 109,B02,083216,Ganzberger; Geoffrey Michael,3,0,32,29
1658081418194,MATH 109,B03,093479,Ganzberger; Geoffrey Michael,8,0,32,24
1658081424218,MATH 142A,A01,083219,Chow; Bennett,7,0,32,25
1658081424218,MATH 142A,A02,083220,Chow; Bennett,10,0,32,22
1658081424218,MATH 142A,A03,093480,Chow; Bennett,9,0,32,23
1658081424218,MATH 142A,B03,093481,Chow; Bennett,8,0,32,24
1658081424218,MATH 142A,B04,093558,Chow; Bennett,14,0,32,18
1658081424218,MATH 142A,B05,093559,Chow; Bennett,7,0,32,25
1658081430244,MATH 193A,A01,083224,Rotar; Vladimir,9,0,34,25
1658081430244,MATH 193A,A02,083225,Rotar; Vladimir,11,0,34,23
1658081430244,MATH 193A,A03,083781,Rotar; Vladimir,5,0,34,29
1658081430244,MATH 193A,A04,083782,Rotar; Vladimir,12,0,34,22
1658081430244,MATH 193A,A05,093482,Rotar; Vladimir,11,0,34,23
1658081436271,MATH 197,001,091859,McAuley; Julian John,9999,0,9999,0
1658081436271,MATH 197,002,095566,Kedlaya; Kiran S.,9997,0,9999,2
1658081436271,MATH 197,003,095567,Xiao; Ming,9999,0,9999,0
1658081436271,MATH 197,004,095571,Perols; Johan Lars,9998,0,9999,1
1658081443328,COGS 9,A01,083615,Shannon; Kyle Michael,11,0,75,64
1658081449355,COGS 11,A01,083617,Boyle; Mary E. T.,23,0,48,25
1658081455379,COGS 13,A01,083071,Bastos; Amalia Pinkusfeld,12,0,71,59
1658081461403,COGS 14A,A01,092681,Semenuks; Arturs,5,1,100,95
1658081467425,COGS 14B,A01,083073,Cheng; Tzu-Han,7,0,63,56
1658081473451,COGS 17,A01,092677,Semenuks; Arturs,7,0,81,74
1658081479474,COGS 100,A01,083619,Allen; Michael Gordon,17,0,70,53
1658081485499,COGS 101A,A01,083621,Davis; Joshua Daniel,9,0,68,59
1658081491524,COGS 101B,A01,091572,Allen; Michael Gordon,14,0,65,51
1658081497550,COGS 101C,A01,083625,Delgado; Tania,17,0,35,18
1658081503576,COGS 107A,A01,083627,Boyle; Mary E. T.,14,0,60,46
1658081509601,COGS 118A,A01,083075,Gupta; Anjum,21,0,76,55
1658081515628,CSE 3,A50,083646,Miranda; Gregory Joseph,24,0,50,26
1658081521672,CSE 8A,A50,083650,Miranda; Gregory Joseph,17,1,56,39
1658081527693,CSE 11,A01,083080,Cao; Yingjun,7,15,40,33
1658081533729,CSE 12,A01,083652,Krause-Levy; Sophia Louisa,30,1,120,90
1658081539756,CSE 15L,A01,083654,Morris; Justin Loren,9,0,50,41
1658081539756,CSE 15L,A02,083655,Morris; Justin Loren,11,0,50,39
1658081545782,CSE 20,A01,083657,Tran; Khoa Dang,39,0,80,41
1658081551810,CSE 21,A01,095574,Bach; Quang Tran,23,0,48,25
1658081557839,CSE 30,A01,083084,Eldon; John,8,0,80,72
1658081557839,CSE 30,B01,095061,Bhaskar; Nishant,9,0,50,41
1658081563864,CSE 100,A01,083659,Cao; Yingjun,5,4,70,65
1658081569888,CSE 134B,A01,083661,Powell; Thomas Allan,25,0,100,75
1658081575911,CSE 140,A01,083663,Gungor; Onat,17,0,85,68
1658081581932,CSE 140L,A01,083088,Eldon; John,23,0,100,77
1658081587957,CSE 175,A01,083665,Kumar; Rakesh,3,0,25,22
1658081593981,CSE 190,A00,092507,Dubnov; Shlomo,8,0,20,12
1658081600004,ECE 45,A01,083139,Congero; Spencer William,7,0,75,68
1658081606027,ECE 65,A50,083695,Saad; Andrew S,12,0,30,18
1658081606027,ECE 65,A51,095125,Saad; Andrew S,24,0,26,2
1658081612055,ECE 109,A01,091882,Touri; Behrouz,21,0,70,49
1658081618078,ECE 180,A00,083140,Abi Samra; Nicholas Camill,1,0,30,29
1658081618078,ECE 180,B00,083141,Abi Samra; Nicholas Camill,0,0,30,30
1658081624105,MATH 10A,A01,083735,Patchell; Gregory David,2,0,30,28
1658081624105,MATH 10A,A02,083736,Patchell; Gregory David,20,0,30,10
1658081624105,MATH 10A,A03,083737,Patchell; Gregory David,16,0,30,14
1658081630129,MATH 10B,A01,083207,Lim; Seonhee,9,0,34,25
1658081630129,MATH 10B,A02,083208,Lim; Seonhee,10,0,35,25
1658081630129,MATH 10B,A03,093472,Lim; Seonhee,7,0,34,27
1658081630129,MATH 10B,B01,083739,Sinha; Shubham,14,0,30,16
1658081636161,MATH 18,A01,083743,Cinel; Cameron Alexander,9,0,30,21
1658081636161,MATH 18,A02,083744,Cinel; Cameron Alexander,18,0,30,12
1658081636161,MATH 18,A03,083745,Cinel; Cameron Alexander,10,0,30,20
1658081636161,MATH 18,B01,083748,Rideout; David Porter,5,0,37,32
1658081636161,MATH 18,B02,083749,Rideout; David Porter,5,0,36,31
1658081636161,MATH 18,B03,083750,Rideout; David Porter,3,0,37,34
1658081636161,MATH 18,B04,083751,Rideout; David Porter,7,0,36,29
1658081636161,MATH 18,B05,093473,Rideout; David Porter,7,0,36,29
1658081636161,MATH 18,B06,093474,Rideout; David Porter,6,0,36,30
1658081642184,MATH 20A,A01,083754,Zheng; Zequn,14,0,40,26
1658081648208,MATH 20B,A01,083756,Briones; Jor-el Thomas Caparas,4,0,36,32
1658081648208,MATH 20B,A02,083757,Briones; Jor-el Thomas Caparas,1,0,36,35
1658081648208,MATH 20B,A03,093475,Briones; Jor-el Thomas Caparas,3,0,36,33
1658081654232,MATH 20C,A01,083760,Briones; Jor-el Thomas Caparas,1,0,35,34
1658081654232,MATH 20C,A02,083761,Briones; Jor-el Thomas Caparas,8,0,35,27
1658081654232,MATH 20C,A03,093476,Briones; Jor-el Thomas Caparas,0,1,36,36
1658081654232,MATH 20C,B01,083762,Bach; Quang Tran,1,0,30,29
1658081660256,MATH 20D,A01,083765,Tran; Brian Kha,5,0,30,25
1658081660256,MATH 20D,A02,083766,Tran; Brian Kha,5,0,30,25
1658081660256,MATH 20D,A03,083767,Tran; Brian Kha,6,0,30,24
1658081666280,MATH 20E,A01,083771,Ganguly; Soumya,12,0,32,20
1658081666280,MATH 20E,A02,083772,Ganguly; Soumya,7,0,32,25
1658081666280,MATH 20E,B01,083773,Ciotti; Benjamin,20,0,35,15
1658081666280,MATH 20E,B02,083774,Ciotti; Benjamin,18,0,35,17
1658081672305,MATH 103A,A01,083777,Greenfeld; Be'Eri,6,0,36,30
1658081672305,MATH 103A,A02,083778,Greenfeld; Be'Eri,5,0,36,31
1658081672305,MATH 103A,A03,093561,Greenfeld; Be'Eri,7,0,36,29
1658081672305,MATH 103A,B01,083779,Greenfeld; Be'Eri,8,0,36,28
1658081672305,MATH 103A,B02,083780,Greenfeld; Be'Eri,4,0,36,32
1658081672305,MATH 103A,B03,093562,Greenfeld; Be'Eri,3,0,36,33
1658081678329,MATH 105,A01,085443,Carter; Anne Toulson,15,0,35,20
1658081678329,MATH 105,A02,093477,Carter; Anne Toulson,20,0,35,15
1658081684368,MATH 109,A01,083213,Ganzberger; Geoffrey Michael,3,0,34,31
1658081684368,MATH 109,A02,083214,Ganzberger; Geoffrey Michael,4,0,34,30
1658081684368,MATH 109,A03,093478,Ganzberger; Geoffrey Michael,2,0,34,32
1658081684368,MATH 109,B01,083215,Ganzberger; Geoffrey Michael,3,0,32,29
1658081684368,MATH 109,B02,083216,Ganzberger; Geoffrey Michael,3,0,32,29
1658081684368,MATH 109,B03,093479,Ganzberger; Geoffrey Michael,8,0,32,24
1658081690399,MATH 142A,A01,083219,Chow; Bennett,7,0,32,25
1658081690399,MATH 142A,A02,083220,Chow; Bennett,10,0,32,22
1658081690399,MATH 142A,A03,093480,Chow; Bennett,9,0,32,23
1658081690399,MATH 142A,B03,093481,Chow; Bennett,8,0,32,24
1658081690399,MATH 142A,B04,093558,Chow; Bennett,14,0,32,18
1658081690399,MATH 142A,B05,093559,Chow; Bennett,7,0,32,25
1658081696496,MATH 193A,A01,083224,Rotar; Vladimir,9,0,34,25
1658081696496,MATH 193A,A02,083225,Rotar; Vladimir,11,0,34,23
1658081696496,MATH 193A,A03,083781,Rotar; Vladimir,5,0,34,29
1658081696496,MATH 193A,A04,083782,Rotar; Vladimir,12,0,34,22
1658081696496,MATH 193A,A05,093482,Rotar; Vladimir,11,0,34,23
1658081702533,MATH 197,001,091859,McAuley; Julian John,9999,0,9999,0
1658081702533,MATH 197,002,095566,Kedlaya; Kiran S.,9997,0,9999,2
1658081702533,MATH 197,003,095567,Xiao; Ming,9999,0,9999,0
1658081702533,MATH 197,004,095571,Perols; Johan Lars,9998,0,9999,1
1658081709606,COGS 9,A01,083615,Shannon; Kyle Michael,11,0,75,64
1658081715634,COGS 11,A01,083617,Boyle; Mary E. T.,23,0,48,25
1658081721662,COGS 13,A01,083071,Bastos; Amalia Pinkusfeld,12,0,71,59
1658081727686,COGS 14A,A01,092681,Semenuks; Arturs,5,1,100,95
1658081733721,COGS 14B,A01,083073,Cheng; Tzu-Han,7,0,63,56
1658081739744,COGS 17,A01,092677,Semenuks; Arturs,7,0,81,74
1658081745767,COGS 100,A01,083619,Allen; Michael Gordon,17,0,70,53
1658081751822,COGS 101A,A01,083621,Davis; Joshua Daniel,9,0,68,59
1658081757845,COGS 101B,A01,091572,Allen; Michael Gordon,14,0,65,51
1658081763868,COGS 101C,A01,083625,Delgado; Tania,17,0,35,18
1658081769895,COGS 107A,A01,083627,Boyle; Mary E. T.,14,0,60,46
1658081775918,COGS 118A,A01,083075,Gupta; Anjum,21,0,76,55
1658081781942,CSE 3,A50,083646,Miranda; Gregory Joseph,24,0,50,26
1658081787974,CSE 8A,A50,083650,Miranda; Gregory Joseph,17,1,56,39
1658081794000,CSE 11,A01,083080,Cao; Yingjun,7,15,40,33
1658081800023,CSE 12,A01,083652,Krause-Levy; Sophia Louisa,30,1,120,90
1658081806046,CSE 15L,A01,083654,Morris; Justin Loren,9,0,50,41
1658081806046,CSE 15L,A02,083655,Morris; Justin Loren,11,0,50,39
1658081812073,CSE 20,A01,083657,Tran; Khoa Dang,39,0,80,41
1658081818100,CSE 21,A01,095574,Bach; Quang Tran,23,0,48,25
1658081824127,CSE 30,A01,083084,Eldon; John,8,0,80,72
1658081824127,CSE 30,B01,095061,Bhaskar; Nishant,9,0,50,41
1658081830151,CSE 100,A01,083659,Cao; Yingjun,5,4,70,65
1658081836175,CSE 134B,A01,083661,Powell; Thomas Allan,25,0,100,75
1658081842199,CSE 140,A01,083663,Gungor; Onat,17,0,85,68
1658081848223,CSE 140L,A01,083088,Eldon; John,23,0,100,77
1658081854247,CSE 175,A01,083665,Kumar; Rakesh,3,0,25,22
1658081860275,CSE 190,A00,092507,Dubnov; Shlomo,8,0,20,12
1658081866298,ECE 45,A01,083139,Congero; Spencer William,7,0,75,68
1658081872323,ECE 65,A50,083695,Saad; Andrew S,12,0,30,18
1658081872323,ECE 65,A51,095125,Saad; Andrew S,24,0,26,2
1658081878347,ECE 109,A01,091882,Touri; Behrouz,21,0,70,49
1658081884371,ECE 180,A00,083140,Abi Samra; Nicholas Camill,1,0,30,29
1658081884371,ECE 180,B00,083141,Abi Samra; Nicholas Camill,0,0,30,30
1658081890399,MATH 10A,A01,083735,Patchell; Gregory David,2,0,30,28
1658081890399,MATH 10A,A02,083736,Patchell; Gregory David,20,0,30,10
1658081890399,MATH 10A,A03,083737,Patchell; Gregory David,16,0,30,14
1658081896427,MATH 10B,A01,083207,Lim; Seonhee,9,0,34,25
1658081896427,MATH 10B,A02,083208,Lim; Seonhee,10,0,35,25
1658081896427,MATH 10B,A03,093472,Lim; Seonhee,7,0,34,27
1658081896427,MATH 10B,B01,083739,Sinha; Shubham,14,0,30,16
1658081902453,MATH 18,A01,083743,Cinel; Cameron Alexander,9,0,30,21
1658081902453,MATH 18,A02,083744,Cinel; Cameron Alexander,18,0,30,12
1658081902453,MATH 18,A03,083745,Cinel; Cameron Alexander,10,0,30,20
1658081902453,MATH 18,B01,083748,Rideout; David Porter,5,0,37,32
1658081902453,MATH 18,B02,083749,Rideout; David Porter,5,0,36,31
1658081902453,MATH 18,B03,083750,Rideout; David Porter,3,0,37,34
1658081902453,MATH 18,B04,083751,Rideout; David Porter,7,0,36,29
1658081902453,MATH 18,B05,093473,Rideout; David Porter,7,0,36,29
1658081902453,MATH 18,B06,093474,Rideout; David Porter,6,0,36,30
1658081908479,MATH 20A,A01,083754,Zheng; Zequn,14,0,40,26
1658081914506,MATH 20B,A01,083756,Briones; Jor-el Thomas Caparas,4,0,36,32
1658081914506,MATH 20B,A02,083757,Briones; Jor-el Thomas Caparas,1,0,36,35
1658081914506,MATH 20B,A03,093475,Briones; Jor-el Thomas Caparas,3,0,36,33
1658081920538,MATH 20C,A01,083760,Briones; Jor-el Thomas Caparas,1,0,35,34
1658081920538,MATH 20C,A02,083761,Briones; Jor-el Thomas Caparas,8,0,35,27
1658081920538,MATH 20C,A03,093476,Briones; Jor-el Thomas Caparas,0,1,36,36
1658081920538,MATH 20C,B01,083762,Bach; Quang Tran,1,0,30,29
1658081926563,MATH 20D,A01,083765,Tran; Brian Kha,5,0,30,25
1658081926563,MATH 20D,A02,083766,Tran; Brian Kha,5,0,30,25
1658081926563,MATH 20D,A03,083767,Tran; Brian Kha,6,0,30,24
1658081932630,MATH 20E,A01,083771,Ganguly; Soumya,12,0,32,20
1658081932630,MATH 20E,A02,083772,Ganguly; Soumya,7,0,32,25
1658081932630,MATH 20E,B01,083773,Ciotti; Benjamin,20,0,35,15
1658081932630,MATH 20E,B02,083774,Ciotti; Benjamin,18,0,35,17
1658081938661,MATH 103A,A01,083777,Greenfeld; Be'Eri,6,0,36,30
1658081938661,MATH 103A,A02,083778,Greenfeld; Be'Eri,5,0,36,31
1658081938661,MATH 103A,A03,093561,Greenfeld; Be'Eri,7,0,36,29
1658081938661,MATH 103A,B01,083779,Greenfeld; Be'Eri,8,0,36,28
1658081938661,MATH 103A,B02,083780,Greenfeld; Be'Eri,4,0,36,32
1658081938661,MATH 103A,B03,093562,Greenfeld; Be'Eri,3,0,36,33
1658081944689,MATH 105,A01,085443,Carter; Anne Toulson,15,0,35,20
1658081944689,MATH 105,A02,093477,Carter; Anne Toulson,20,0,35,15
1658081950711,MATH 109,A01,083213,Ganzberger; Geoffrey Michael,3,0,34,31
1658081950711,MATH 109,A02,083214,Ganzberger; Geoffrey Michael,4,0,34,30
1658081950711,MATH 109,A03,093478,Ganzberger; Geoffrey Michael,2,0,34,32
1658081950711,MATH 109,B01,083215,Ganzberger; Geoffrey Michael,3,0,32,29
1658081950711,MATH 109,B02,083216,Ganzberger; Geoffrey Michael,3,0,32,29
1658081950711,MATH 109,B03,093479,Ganzberger; Geoffrey Michael,8,0,32,24
1658081956741,MATH 142A,A01,083219,Chow; Bennett,7,0,32,25
1658081956741,MATH 142A,A02,083220,Chow; Bennett,10,0,32,22
1658081956741,MATH 142A,A03,093480,Chow; Bennett,9,0,32,23
1658081956741,MATH 142A,B03,093481,Chow; Bennett,8,0,32,24
1658081956741,MATH 142A,B04,093558,Chow; Bennett,14,0,32,18
1658081956741,MATH 142A,B05,093559,Chow; Bennett,7,0,32,25
1658081962770,MATH 193A,A01,083224,Rotar; Vladimir,9,0,34,25
1658081962770,MATH 193A,A02,083225,Rotar; Vladimir,11,0,34,23
1658081962770,MATH 193A,A03,083781,Rotar; Vladimir,5,0,34,29
1658081962770,MATH 193A,A04,083782,Rotar; Vladimir,12,0,34,22
1658081962770,MATH 193A,A05,093482,Rotar; Vladimir,11,0,34,23
1658081968794,MATH 197,001,091859,McAuley; Julian John,9999,0,9999,0
1658081968794,MATH 197,002,095566,Kedlaya; Kiran S.,9997,0,9999,2
1658081968794,MATH 197,003,095567,Xiao; Ming,9999,0,9999,0
1658081968794,MATH 197,004,095571,Perols; Johan Lars,9998,0,9999,1
1658081975846,COGS 9,A01,083615,Shannon; Kyle Michael,11,0,75,64
1658081981870,COGS 11,A01,083617,Boyle; Mary E. T.,23,0,48,25
1658081987898,COGS 13,A01,083071,Bastos; Amalia Pinkusfeld,12,0,71,59
1658081993923,COGS 14A,A01,092681,Semenuks; Arturs,5,1,100,95
1658081999952,COGS 14B,A01,083073,Cheng; Tzu-Han,7,0,63,56
1658082005979,COGS 17,A01,092677,Semenuks; Arturs,7,0,81,74
1658082012008,COGS 100,A01,083619,Allen; Michael Gordon,17,0,70,53
1658082018042,COGS 101A,A01,083621,Davis; Joshua Daniel,9,0,68,59
1658082024069,COGS 101B,A01,091572,Allen; Michael Gordon,14,0,65,51
1658082030097,COGS 101C,A01,083625,Delgado; Tania,17,0,35,18
1658082036131,COGS 107A,A01,083627,Boyle; Mary E. T.,14,0,60,46
1658082042154,COGS 118A,A01,083075,Gupta; Anjum,21,0,76,55
1658082048190,CSE 3,A50,083646,Miranda; Gregory Joseph,24,0,50,26
1658082054214,CSE 8A,A50,083650,Miranda; Gregory Joseph,17,1,56,39
1658082060240,CSE 11,A01,083080,Cao; Yingjun,7,15,40,33
1658082066277,CSE 12,A01,083652,Krause-Levy; Sophia Louisa,30,1,120,90
1658082072301,CSE 15L,A01,083654,Morris; Justin Loren,9,0,50,41
1658082072301,CSE 15L,A02,083655,Morris; Justin Loren,11,0,50,39
1658082078329,CSE 20,A01,083657,Tran; Khoa Dang,39,0,80,41
1658082084353,CSE 21,A01,095574,Bach; Quang Tran,23,0,48,25
1658082090381,CSE 30,A01,083084,Eldon; John,8,0,80,72
1658082090381,CSE 30,B01,095061,Bhaskar; Nishant,9,0,50,41
1658082096407,CSE 100,A01,083659,Cao; Yingjun,5,4,70,65
1658082102430,CSE 134B,A01,083661,Powell; Thomas Allan,25,0,100,75
1658082108474,CSE 140,A01,083663,Gungor; Onat,17,0,85,68
1658082114498,CSE 140L,A01,083088,Eldon; John,23,0,100,77
1658082120526,CSE 175,A01,083665,Kumar; Rakesh,3,0,25,22
1658082126554,CSE 190,A00,092507,Dubnov; Shlomo,8,0,20,12
1658082132581,ECE 45,A01,083139,Congero; Spencer William,7,0,75,68
1658082138608,ECE 65,A50,083695,Saad; Andrew S,12,0,30,18
1658082138608,ECE 65,A51,095125,Saad; Andrew S,24,0,26,2
1658082144635,ECE 109,A01,091882,Touri; Behrouz,21,0,70,49
1658082150676,ECE 180,A00,083140,Abi Samra; Nicholas Camill,1,0,30,29
1658082150676,ECE 180,B00,083141,Abi Samra; Nicholas Camill,0,0,30,30
1658082156707,MATH 10A,A01,083735,Patchell; Gregory David,2,0,30,28
1658082156707,MATH 10A,A02,083736,Patchell; Gregory David,20,0,30,10
1658082156707,MATH 10A,A03,083737,Patchell; Gregory David,16,0,30,14
1658082162741,MATH 10B,A01,083207,Lim; Seonhee,9,0,34,25
1658082162741,MATH 10B,A02,083208,Lim; Seonhee,10,0,35,25
1658082162741,MATH 10B,A03,093472,Lim; Seonhee,7,0,34,27
1658082162741,MATH 10B,B01,083739,Sinha; Shubham,14,0,30,16
1658082168769,MATH 18,A01,083743,Cinel; Cameron Alexander,9,0,30,21
1658082168769,MATH 18,A02,083744,Cinel; Cameron Alexander,18,0,30,12
1658082168769,MATH 18,A03,083745,Cinel; Cameron Alexander,10,0,30,20
1658082168769,MATH 18,B01,083748,Rideout; David Porter,5,0,37,32
1658082168769,MATH 18,B02,083749,Rideout; David Porter,5,0,36,31
1658082168769,MATH 18,B03,083750,Rideout; David Porter,3,0,37,34
1658082168769,MATH 18,B04,083751,Rideout; David Porter,7,0,36,29
1658082168769,MATH 18,B05,093473,Rideout; David Porter,7,0,36,29
1658082168769,MATH 18,B06,093474,Rideout; David Porter,6,0,36,30
1658082174793,MATH 20A,A01,083754,Zheng; Zequn,14,0,40,26
1658082180818,MATH 20B,A01,083756,Briones; Jor-el Thomas Caparas,4,0,36,32
1658082180818,MATH 20B,A02,083757,Briones; Jor-el Thomas Caparas,1,0,36,35
1658082180818,MATH 20B,A03,093475,Briones; Jor-el Thomas Caparas,3,0,36,33
1658082186841,MATH 20C,A01,083760,Briones; Jor-el Thomas Caparas,1,0,35,34
1658082186841,MATH 20C,A02,083761,Briones; Jor-el Thomas Caparas,8,0,35,27
1658082186841,MATH 20C,A03,093476,Briones; Jor-el Thomas Caparas,0,1,36,36
1658082186841,MATH 20C,B01,083762,Bach; Quang Tran,1,0,30,29
1658082192868,MATH 20D,A01,083765,Tran; Brian Kha,5,0,30,25
1658082192868,MATH 20D,A02,083766,Tran; Brian Kha,5,0,30,25
1658082192868,MATH 20D,A03,083767,Tran; Brian Kha,6,0,30,24
1658082198893,MATH 20E,A01,083771,Ganguly; Soumya,12,0,32,20
1658082198893,MATH 20E,A02,083772,Ganguly; Soumya,7,0,32,25
1658082198893,MATH 20E,B01,083773,Ciotti; Benjamin,20,0,35,15
1658082198893,MATH 20E,B02,083774,Ciotti; Benjamin,18,0,35,17
1658082204920,MATH 103A,A01,083777,Greenfeld; Be'Eri,6,0,36,30
1658082204920,MATH 103A,A02,083778,Greenfeld; Be'Eri,5,0,36,31
1658082204920,MATH 103A,A03,093561,Greenfeld; Be'Eri,7,0,36,29
1658082204920,MATH 103A,B01,083779,Greenfeld; Be'Eri,8,0,36,28
1658082204920,MATH 103A,B02,083780,Greenfeld; Be'Eri,4,0,36,32
1658082204920,MATH 103A,B03,093562,Greenfeld; Be'Eri,3,0,36,33
1658082210950,MATH 105,A01,085443,Carter; Anne Toulson,15,0,35,20
1658082210950,MATH 105,A02,093477,Carter; Anne Toulson,20,0,35,15
1658082216973,MATH 109,A01,083213,Ganzberger; Geoffrey Michael,3,0,34,31
1658082216973,MATH 109,A02,083214,Ganzberger; Geoffrey Michael,4,0,34,30
1658082216973,MATH 109,A03,093478,Ganzberger; Geoffrey Michael,2,0,34,32
1658082216973,MATH 109,B01,083215,Ganzberger; Geoffrey Michael,3,0,32,29
1658082216973,MATH 109,B02,083216,Ganzberger; Geoffrey Michael,3,0,32,29
1658082216973,MATH 109,B03,093479,Ganzberger; Geoffrey Michael,8,0,32,24
1658082223005,MATH 142A,A01,083219,Chow; Bennett,7,0,32,25
1658082223005,MATH 142A,A02,083220,Chow; Bennett,10,0,32,22
1658082223005,MATH 142A,A03,093480,Chow; Bennett,9,0,32,23
1658082223005,MATH 142A,B03,093481,Chow; Bennett,8,0,32,24
1658082223005,MATH 142A,B04,093558,Chow; Bennett,14,0,32,18
1658082223005,MATH 142A,B05,093559,Chow; Bennett,7,0,32,25
1658082229034,MATH 193A,A01,083224,Rotar; Vladimir,9,0,34,25
1658082229034,MATH 193A,A02,083225,Rotar; Vladimir,11,0,34,23
1658082229034,MATH 193A,A03,083781,Rotar; Vladimir,5,0,34,29
1658082229034,MATH 193A,A04,083782,Rotar; Vladimir,12,0,34,22
1658082229034,MATH 193A,A05,093482,Rotar; Vladimir,11,0,34,23
1658082235062,MATH 197,001,091859,McAuley; Julian John,9999,0,9999,0
1658082235062,MATH 197,002,095566,Kedlaya; Kiran S.,9997,0,9999,2
1658082235062,MATH 197,003,095567,Xiao; Ming,9999,0,9999,0
1658082235062,MATH 197,004,095571,Perols; Johan Lars,9998,0,9999,1
1658082242127,COGS 9,A01,083615,Shannon; Kyle Michael,11,0,75,64
1658082248154,COGS 11,A01,083617,Boyle; Mary E. T.,23,0,48,25
1658082254182,COGS 13,A01,083071,Bastos; Amalia Pinkusfeld,12,0,71,59
1658082260210,COGS 14A,A01,092681,Semenuks; Arturs,5,1,100,95
1658082266249,COGS 14B,A01,083073,Cheng; Tzu-Han,7,0,63,56
1658082272273,COGS 17,A01,092677,Semenuks; Arturs,7,0,81,74
1658082278300,COGS 100,A01,083619,Allen; Michael Gordon,17,0,70,53
1658082284323,COGS 101A,A01,083621,Davis; Joshua Daniel,9,0,68,59
1658082290416,COGS 101B,A01,091572,Allen; Michael Gordon,14,0,65,51
1658082296439,COGS 101C,A01,083625,Delgado; Tania,17,0,35,18
1658082302471,COGS 107A,A01,083627,Boyle; Mary E. T.,14,0,60,46
1658082308494,COGS 118A,A01,083075,Gupta; Anjum,21,0,76,55
1658082314518,CSE 3,A50,083646,Miranda; Gregory Joseph,24,0,50,26
1658082320542,CSE 8A,A50,083650,Miranda; Gregory Joseph,17,1,56,39
1658082326569,CSE 11,A01,083080,Cao; Yingjun,7,15,40,33
1658082332592,CSE 12,A01,083652,Krause-Levy; Sophia Louisa,30,1,120,90
1658082338619,CSE 15L,A01,083654,Morris; Justin Loren,9,0,50,41
1658082338619,CSE 15L,A02,083655,Morris; Justin Loren,11,0,50,39
1658082344645,CSE 20,A01,083657,Tran; Khoa Dang,39,0,80,41
1658082350668,CSE 21,A01,095574,Bach; Quang Tran,23,0,48,25
1658082356693,CSE 30,A01,083084,Eldon; John,8,0,80,72
1658082356693,CSE 30,B01,095061,Bhaskar; Nishant,9,0,50,41
1658082362717,CSE 100,A01,083659,Cao; Yingjun,5,4,70,65
1658082368740,CSE 134B,A01,083661,Powell; Thomas Allan,25,0,100,75
1658082374767,CSE 140,A01,083663,Gungor; Onat,17,0,85,68
1658082380790,CSE 140L,A01,083088,Eldon; John,23,0,100,77
1658082386813,CSE 175,A01,083665,Kumar; Rakesh,3,0,25,22
1658082392837,CSE 190,A00,092507,Dubnov; Shlomo,8,0,20,12
1658082398863,ECE 45,A01,083139,Congero; Spencer William,7,0,75,68
1658082404902,ECE 65,A50,083695,Saad; Andrew S,12,0,30,18
1658082404902,ECE 65,A51,095125,Saad; Andrew S,24,0,26,2
1658082410925,ECE 109,A01,091882,Touri; Behrouz,21,0,70,49
1658082416948,ECE 180,A00,083140,Abi Samra; Nicholas Camill,1,0,30,29
1658082416948,ECE 180,B00,083141,Abi Samra; Nicholas Camill,0,0,30,30
1658082422977,MATH 10A,A01,083735,Patchell; Gregory David,2,0,30,28
1658082422977,MATH 10A,A02,083736,Patchell; Gregory David,20,0,30,10
1658082422977,MATH 10A,A03,083737,Patchell; Gregory David,16,0,30,14
1658082429011,MATH 10B,A01,083207,Lim; Seonhee,9,0,34,25
1658082429011,MATH 10B,A02,083208,Lim; Seonhee,10,0,35,25
1658082429011,MATH 10B,A03,093472,Lim; Seonhee,7,0,34,27
1658082429011,MATH 10B,B01,083739,Sinha; Shubham,14,0,30,16
1658082435037,MATH 18,A01,083743,Cinel; Cameron Alexander,9,0,30,21
1658082435037,MATH 18,A02,083744,Cinel; Cameron Alexander,18,0,30,12
1658082435037,MATH 18,A03,083745,Cinel; Cameron Alexander,10,0,30,20
1658082435037,MATH 18,B01,083748,Rideout; David Porter,5,0,37,32
1658082435037,MATH 18,B02,083749,Rideout; David Porter,5,0,36,31
1658082435037,MATH 18,B03,083750,Rideout; David Porter,3,0,37,34
1658082435037,MATH 18,B04,083751,Rideout; David Porter,7,0,36,29
1658082435037,MATH 18,B05,093473,Rideout; David Porter,7,0,36,29
1658082435037,MATH 18,B06,093474,Rideout; David Porter,6,0,36,30
1658082441060,MATH 20A,A01,083754,Zheng; Zequn,14,0,40,26
1658082447086,MATH 20B,A01,083756,Briones; Jor-el Thomas Caparas,4,0,36,32
1658082447086,MATH 20B,A02,083757,Briones; Jor-el Thomas Caparas,1,0,36,35
1658082447086,MATH 20B,A03,093475,Briones; Jor-el Thomas Caparas,3,0,36,33
1658082453110,MATH 20C,A01,083760,Briones; Jor-el Thomas Caparas,1,0,35,34
1658082453110,MATH 20C,A02,083761,Briones; Jor-el Thomas Caparas,8,0,35,27
1658082453110,MATH 20C,A03,093476,Briones; Jor-el Thomas Caparas,0,1,36,36
1658082453110,MATH 20C,B01,083762,Bach; Quang Tran,1,0,30,29
1658082459134,MATH 20D,A01,083765,Tran; Brian Kha,5,0,30,25
1658082459134,MATH 20D,A02,083766,Tran; Brian Kha,5,0,30,25
1658082459134,MATH 20D,A03,083767,Tran; Brian Kha,6,0,30,24
1658082465158,MATH 20E,A01,083771,Ganguly; Soumya,12,0,32,20
1658082465158,MATH 20E,A02,083772,Ganguly; Soumya,7,0,32,25
1658082465158,MATH 20E,B01,083773,Ciotti; Benjamin,20,0,35,15
1658082465158,MATH 20E,B02,083774,Ciotti; Benjamin,18,0,35,17
1658082471184,MATH 103A,A01,083777,Greenfeld; Be'Eri,6,0,36,30
1658082471184,MATH 103A,A02,083778,Greenfeld; Be'Eri,5,0,36,31
1658082471184,MATH 103A,A03,093561,Greenfeld; Be'Eri,7,0,36,29
1658082471184,MATH 103A,B01,083779,Greenfeld; Be'Eri,8,0,36,28
1658082471184,MATH 103A,B02,083780,Greenfeld; Be'Eri,4,0,36,32
1658082471184,MATH 103A,B03,093562,Greenfeld; Be'Eri,3,0,36,33
1658082477212,MATH 105,A01,085443,Carter; Anne Toulson,15,0,35,20
1658082477212,MATH 105,A02,093477,Carter; Anne Toulson,20,0,35,15
1658082483240,MATH 109,A01,083213,Ganzberger; Geoffrey Michael,3,0,34,31
1658082483240,MATH 109,A02,083214,Ganzberger; Geoffrey Michael,4,0,34,30
1658082483240,MATH 109,A03,093478,Ganzberger; Geoffrey Michael,2,0,34,32
1658082483240,MATH 109,B01,083215,Ganzberger; Geoffrey Michael,3,0,32,29
1658082483240,MATH 109,B02,083216,Ganzberger; Geoffrey Michael,3,0,32,29
1658082483240,MATH 109,B03,093479,Ganzberger; Geoffrey Michael,8,0,32,24
1658082489270,MATH 142A,A01,083219,Chow; Bennett,7,0,32,25
1658082489270,MATH 142A,A02,083220,Chow; Bennett,10,0,32,22
1658082489270,MATH 142A,A03,093480,Chow; Bennett,9,0,32,23
1658082489270,MATH 142A,B03,093481,Chow; Bennett,8,0,32,24
1658082489270,MATH 142A,B04,093558,Chow; Bennett,14,0,32,18
1658082489270,MATH 142A,B05,093559,Chow; Bennett,7,0,32,25
1658082495297,MATH 193A,A01,083224,Rotar; Vladimir,9,0,34,25
1658082495297,MATH 193A,A02,083225,Rotar; Vladimir,11,0,34,23
1658082495297,MATH 193A,A03,083781,Rotar; Vladimir,5,0,34,29
1658082495297,MATH 193A,A04,083782,Rotar; Vladimir,12,0,34,22
1658082495297,MATH 193A,A05,093482,Rotar; Vladimir,11,0,34,23
1658082501324,MATH 197,001,091859,McAuley; Julian John,9999,0,9999,0
1658082501324,MATH 197,002,095566,Kedlaya; Kiran S.,9997,0,9999,2
1658082501324,MATH 197,003,095567,Xiao; Ming,9999,0,9999,0
1658082501324,MATH 197,004,095571,Perols; Johan Lars,9998,0,9999,1
1658082508380,COGS 9,A01,083615,Shannon; Kyle Michael,11,0,75,64
1658082514404,COGS 11,A01,083617,Boyle; Mary E. T.,23,0,48,25
1658082520428,COGS 13,A01,083071,Bastos; Amalia Pinkusfeld,12,0,71,59
1658082526456,COGS 14A,A01,092681,Semenuks; Arturs,5,1,100,95
1658082532479,COGS 14B,A01,083073,Cheng; Tzu-Han,7,0,63,56
1658082538514,COGS 17,A01,092677,Semenuks; Arturs,7,0,81,74
1658082544538,COGS 100,A01,083619,Allen; Michael Gordon,17,0,70,53
1658082550565,COGS 101A,A01,083621,Davis; Joshua Daniel,9,0,68,59
1658082556589,COGS 101B,A01,091572,Allen; Michael Gordon,14,0,65,51
1658082562612,COGS 101C,A01,083625,Delgado; Tania,17,0,35,18
1658082568635,COGS 107A,A01,083627,Boyle; Mary E. T.,14,0,60,46
1658082574662,COGS 118A,A01,083075,Gupta; Anjum,21,0,76,55
1658082580685,CSE 3,A50,083646,Miranda; Gregory Joseph,24,0,50,26
1658082586709,CSE 8A,A50,083650,Miranda; Gregory Joseph,17,1,56,39
1658082592734,CSE 11,A01,083080,Cao; Yingjun,7,15,40,33
1658082598759,CSE 12,A01,083652,Krause-Levy; Sophia Louisa,30,1,120,90
1658082604784,CSE 15L,A01,083654,Morris; Justin Loren,9,0,50,41
1658082604784,CSE 15L,A02,083655,Morris; Justin Loren,11,0,50,39
1658082610806,CSE 20,A01,083657,Tran; Khoa Dang,39,0,80,41
1658082616828,CSE 21,A01,095574,Bach; Quang Tran,23,0,48,25
1658082622850,CSE 30,A01,083084,Eldon; John,8,0,80,72
1658082622850,CSE 30,B01,095061,Bhaskar; Nishant,9,0,50,41
1658082628878,CSE 100,A01,083659,Cao; Yingjun,5,4,70,65
1658082634912,CSE 134B,A01,083661,Powell; Thomas Allan,25,0,100,75
1658082640934,CSE 140,A01,083663,Gungor; Onat,17,0,85,68
1658082646956,CSE 140L,A01,083088,Eldon; John,23,0,100,77
1658082652979,CSE 175,A01,083665,Kumar; Rakesh,3,0,25,22
1658082659002,CSE 190,A00,092507,Dubnov; Shlomo,8,0,20,12
1658082665026,ECE 45,A01,083139,Congero; Spencer William,7,0,75,68
1658082671055,ECE 65,A50,083695,Saad; Andrew S,12,0,30,18
1658082671055,ECE 65,A51,095125,Saad; Andrew S,24,0,26,2
1658082677082,ECE 109,A01,091882,Touri; Behrouz,21,0,70,49
1658082683105,ECE 180,A00,083140,Abi Samra; Nicholas Camill,1,0,30,29
1658082683105,ECE 180,B00,083141,Abi Samra; Nicholas Camill,0,0,30,30
1658082689129,MATH 10A,A01,083735,Patchell; Gregory David,2,0,30,28
1658082689129,MATH 10A,A02,083736,Patchell; Gregory David,20,0,30,10
1658082689129,MATH 10A,A03,083737,Patchell; Gregory David,16,0,30,14
1658082695158,MATH 10B,A01,083207,Lim; Seonhee,9,0,34,25
1658082695158,MATH 10B,A02,083208,Lim; Seonhee,10,0,35,25
1658082695158,MATH 10B,A03,093472,Lim; Seonhee,7,0,34,27
1658082695158,MATH 10B,B01,083739,Sinha; Shubham,14,0,30,16
1658082701190,MATH 18,A01,083743,Cinel; Cameron Alexander,9,0,30,21
1658082701190,MATH 18,A02,083744,Cinel; Cameron Alexander,18,0,30,12
1658082701190,MATH 18,A03,083745,Cinel; Cameron Alexander,10,0,30,20
1658082701190,MATH 18,B01,083748,Rideout; David Porter,5,0,37,32
1658082701190,MATH 18,B02,083749,Rideout; David Porter,5,0,36,31
1658082701190,MATH 18,B03,083750,Rideout; David Porter,3,0,37,34
1658082701190,MATH 18,B04,083751,Rideout; David Porter,7,0,36,29
1658082701190,MATH 18,B05,093473,Rideout; David Porter,7,0,36,29
1658082701190,MATH 18,B06,093474,Rideout; David Porter,6,0,36,30
1658082707223,MATH 20A,A01,083754,Zheng; Zequn,14,0,40,26
1658082713252,MATH 20B,A01,083756,Briones; Jor-el Thomas Caparas,4,0,36,32
1658082713252,MATH 20B,A02,083757,Briones; Jor-el Thomas Caparas,1,0,36,35
1658082713252,MATH 20B,A03,093475,Briones; Jor-el Thomas Caparas,3,0,36,33
1658082719278,MATH 20C,A01,083760,Briones; Jor-el Thomas Caparas,1,0,35,34
1658082719278,MATH 20C,A02,083761,Briones; Jor-el Thomas Caparas,8,0,35,27
1658082719278,MATH 20C,A03,093476,Briones; Jor-el Thomas Caparas,0,1,36,36
1658082719278,MATH 20C,B01,083762,Bach; Quang Tran,1,0,30,29
1658082725307,MATH 20D,A01,083765,Tran; Brian Kha,5,0,30,25
1658082725307,MATH 20D,A02,083766,Tran; Brian Kha,5,0,30,25
1658082725307,MATH 20D,A03,083767,Tran; Brian Kha,6,0,30,24
1658082731352,MATH 20E,A01,083771,Ganguly; Soumya,12,0,32,20
1658082731352,MATH 20E,A02,083772,Ganguly; Soumya,7,0,32,25
1658082731352,MATH 20E,B01,083773,Ciotti; Benjamin,20,0,35,15
1658082731352,MATH 20E,B02,083774,Ciotti; Benjamin,18,0,35,17
1658082737380,MATH 103A,A01,083777,Greenfeld; Be'Eri,6,0,36,30
1658082737380,MATH 103A,A02,083778,Greenfeld; Be'Eri,5,0,36,31
1658082737380,MATH 103A,A03,093561,Greenfeld; Be'Eri,7,0,36,29
1658082737380,MATH 103A,B01,083779,Greenfeld; Be'Eri,8,0,36,28
1658082737380,MATH 103A,B02,083780,Greenfeld; Be'Eri,4,0,36,32
1658082737380,MATH 103A,B03,093562,Greenfeld; Be'Eri,3,0,36,33
1658082743403,MATH 105,A01,085443,Carter; Anne Toulson,15,0,35,20
1658082743403,MATH 105,A02,093477,Carter; Anne Toulson,20,0,35,15
1658082749431,MATH 109,A01,083213,Ganzberger; Geoffrey Michael,3,0,34,31
1658082749431,MATH 109,A02,083214,Ganzberger; Geoffrey Michael,4,0,34,30
1658082749431,MATH 109,A03,093478,Ganzberger; Geoffrey Michael,2,0,34,32
1658082749431,MATH 109,B01,083215,Ganzberger; Geoffrey Michael,3,0,32,29
1658082749431,MATH 109,B02,083216,Ganzberger; Geoffrey Michael,3,0,32,29
1658082749431,MATH 109,B03,093479,Ganzberger; Geoffrey Michael,8,0,32,24
1658082755457,MATH 142A,A01,083219,Chow; Bennett,7,0,32,25
1658082755457,MATH 142A,A02,083220,Chow; Bennett,10,0,32,22
1658082755457,MATH 142A,A03,093480,Chow; Bennett,9,0,32,23
1658082755457,MATH 142A,B03,093481,Chow; Bennett,8,0,32,24
1658082755457,MATH 142A,B04,093558,Chow; Bennett,14,0,32,18
1658082755457,MATH 142A,B05,093559,Chow; Bennett,7,0,32,25
1658082761479,MATH 193A,A01,083224,Rotar; Vladimir,9,0,34,25
1658082761479,MATH 193A,A02,083225,Rotar; Vladimir,11,0,34,23
1658082761479,MATH 193A,A03,083781,Rotar; Vladimir,5,0,34,29
1658082761479,MATH 193A,A04,083782,Rotar; Vladimir,12,0,34,22
1658082761479,MATH 193A,A05,093482,Rotar; Vladimir,11,0,34,23
1658082767505,MATH 197,001,091859,McAuley; Julian John,9999,0,9999,0
1658082767505,MATH 197,002,095566,Kedlaya; Kiran S.,9997,0,9999,2
1658082767505,MATH 197,003,095567,Xiao; Ming,9999,0,9999,0
1658082767505,MATH 197,004,095571,Perols; Johan Lars,9998,0,9999,1
1658082774560,COGS 9,A01,083615,Shannon; Kyle Michael,11,0,75,64
1658082780586,COGS 11,A01,083617,Boyle; Mary E. T.,23,0,48,25
1658082786611,COGS 13,A01,083071,Bastos; Amalia Pinkusfeld,12,0,71,59
1658082792638,COGS 14A,A01,092681,Semenuks; Arturs,5,1,100,95
1658082798661,COGS 14B,A01,083073,Cheng; Tzu-Han,7,0,63,56
1658082804688,COGS 17,A01,092677,Semenuks; Arturs,7,0,81,74
1658082810719,COGS 100,A01,083619,Allen; Michael Gordon,17,0,70,53
1658082816756,COGS 101A,A01,083621,Davis; Joshua Daniel,9,0,68,59
1658082822785,COGS 101B,A01,091572,Allen; Michael Gordon,14,0,65,51
1658082828808,COGS 101C,A01,083625,Delgado; Tania,17,0,35,18
1658082834832,COGS 107A,A01,083627,Boyle; Mary E. T.,14,0,60,46
1658082840861,COGS 118A,A01,083075,Gupta; Anjum,21,0,76,55
1658082846889,CSE 3,A50,083646,Miranda; Gregory Joseph,24,0,50,26
1658082852913,CSE 8A,A50,083650,Miranda; Gregory Joseph,17,1,56,39
1658082858939,CSE 11,A01,083080,Cao; Yingjun,7,15,40,33
1658082864962,CSE 12,A01,083652,Krause-Levy; Sophia Louisa,30,1,120,90
1658082870986,CSE 15L,A01,083654,Morris; Justin Loren,9,0,50,41
1658082870986,CSE 15L,A02,083655,Morris; Justin Loren,11,0,50,39
1658082877010,CSE 20,A01,083657,Tran; Khoa Dang,39,0,80,41
1658082883034,CSE 21,A01,095574,Bach; Quang Tran,23,0,48,25
1658082889128,CSE 30,A01,083084,Eldon; John,8,0,80,72
1658082889128,CSE 30,B01,095061,Bhaskar; Nishant,9,0,50,41
1658082895155,CSE 100,A01,083659,Cao; Yingjun,5,4,70,65
1658082901181,CSE 134B,A01,083661,Powell; Thomas Allan,25,0,100,75
1658082907209,CSE 140,A01,083663,Gungor; Onat,17,0,85,68
1658082913233,CSE 140L,A01,083088,Eldon; John,23,0,100,77
1658082919255,CSE 175,A01,083665,Kumar; Rakesh,3,0,25,22
1658082925281,CSE 190,A00,092507,Dubnov; Shlomo,8,0,20,12
1658082931305,ECE 45,A01,083139,Congero; Spencer William,7,0,75,68
1658082937329,ECE 65,A50,083695,Saad; Andrew S,12,0,30,18
1658082937329,ECE 65,A51,095125,Saad; Andrew S,24,0,26,2
1658082943351,ECE 109,A01,091882,Touri; Behrouz,21,0,70,49
1658082949375,ECE 180,A00,083140,Abi Samra; Nicholas Camill,1,0,30,29
1658082949375,ECE 180,B00,083141,Abi Samra; Nicholas Camill,0,0,30,30
1658082955399,MATH 10A,A01,083735,Patchell; Gregory David,2,0,30,28
1658082955399,MATH 10A,A02,083736,Patchell; Gregory David,20,0,30,10
1658082955399,MATH 10A,A03,083737,Patchell; Gregory David,16,0,30,14
1658082961429,MATH 10B,A01,083207,Lim; Seonhee,9,0,34,25
1658082961429,MATH 10B,A02,083208,Lim; Seonhee,10,0,35,25
1658082961429,MATH 10B,A03,093472,Lim; Seonhee,7,0,34,27
1658082961429,MATH 10B,B01,083739,Sinha; Shubham,14,0,30,16
1658082967462,MATH 18,A01,083743,Cinel; Cameron Alexander,9,0,30,21
1658082967462,MATH 18,A02,083744,Cinel; Cameron Alexander,18,0,30,12
1658082967462,MATH 18,A03,083745,Cinel; Cameron Alexander,10,0,30,20
1658082967462,MATH 18,B01,083748,Rideout; David Porter,5,0,37,32
1658082967462,MATH 18,B02,083749,Rideout; David Porter,5,0,36,31
1658082967462,MATH 18,B03,083750,Rideout; David Porter,3,0,37,34
1658082967462,MATH 18,B04,083751,Rideout; David Porter,7,0,36,29
1658082967462,MATH 18,B05,093473,Rideout; David Porter,7,0,36,29
1658082967462,MATH 18,B06,093474,Rideout; David Porter,6,0,36,30
1658082973488,MATH 20A,A01,083754,Zheng; Zequn,14,0,40,26
1658082979522,MATH 20B,A01,083756,Briones; Jor-el Thomas Caparas,4,0,36,32
1658082979522,MATH 20B,A02,083757,Briones; Jor-el Thomas Caparas,1,0,36,35
1658082979522,MATH 20B,A03,093475,Briones; Jor-el Thomas Caparas,3,0,36,33
1658082985546,MATH 20C,A01,083760,Briones; Jor-el Thomas Caparas,1,0,35,34
1658082985546,MATH 20C,A02,083761,Briones; Jor-el Thomas Caparas,8,0,35,27
1658082985546,MATH 20C,A03,093476,Briones; Jor-el Thomas Caparas,0,1,36,36
1658082985546,MATH 20C,B01,083762,Bach; Quang Tran,1,0,30,29
1658082991569,MATH 20D,A01,083765,Tran; Brian Kha,5,0,30,25
1658082991569,MATH 20D,A02,083766,Tran; Brian Kha,5,0,30,25
1658082991569,MATH 20D,A03,083767,Tran; Brian Kha,6,0,30,24
1658082997598,MATH 20E,A01,083771,Ganguly; Soumya,12,0,32,20
1658082997598,MATH 20E,A02,083772,Ganguly; Soumya,7,0,32,25
1658082997598,MATH 20E,B01,083773,Ciotti; Benjamin,20,0,35,15
1658082997598,MATH 20E,B02,083774,Ciotti; Benjamin,18,0,35,17
1658083003622,MATH 103A,A01,083777,Greenfeld; Be'Eri,6,0,36,30
1658083003622,MATH 103A,A02,083778,Greenfeld; Be'Eri,5,0,36,31
1658083003622,MATH 103A,A03,093561,Greenfeld; Be'Eri,7,0,36,29
1658083003622,MATH 103A,B01,083779,Greenfeld; Be'Eri,8,0,36,28
1658083003622,MATH 103A,B02,083780,Greenfeld; Be'Eri,4,0,36,32
1658083003622,MATH 103A,B03,093562,Greenfeld; Be'Eri,3,0,36,33
1658083009645,MATH 105,A01,085443,Carter; Anne Toulson,15,0,35,20
1658083009645,MATH 105,A02,093477,Carter; Anne Toulson,20,0,35,15
1658083015673,MATH 109,A01,083213,Ganzberger; Geoffrey Michael,3,0,34,31
1658083015673,MATH 109,A02,083214,Ganzberger; Geoffrey Michael,4,0,34,30
1658083015673,MATH 109,A03,093478,Ganzberger; Geoffrey Michael,2,0,34,32
1658083015673,MATH 109,B01,083215,Ganzberger; Geoffrey Michael,3,0,32,29
1658083015673,MATH 109,B02,083216,Ganzberger; Geoffrey Michael,3,0,32,29
1658083015673,MATH 109,B03,093479,Ganzberger; Geoffrey Michael,8,0,32,24
1658083021695,MATH 142A,A01,083219,Chow; Bennett,7,0,32,25
1658083021695,MATH 142A,A02,083220,Chow; Bennett,10,0,32,22
1658083021695,MATH 142A,A03,093480,Chow; Bennett,9,0,32,23
1658083021695,MATH 142A,B03,093481,Chow; Bennett,8,0,32,24
1658083021695,MATH 142A,B04,093558,Chow; Bennett,14,0,32,18
1658083021695,MATH 142A,B05,093559,Chow; Bennett,7,0,32,25
1658083027719,MATH 193A,A01,083224,Rotar; Vladimir,9,0,34,25
1658083027719,MATH 193A,A02,083225,Rotar; Vladimir,11,0,34,23
1658083027719,MATH 193A,A03,083781,Rotar; Vladimir,5,0,34,29
1658083027719,MATH 193A,A04,083782,Rotar; Vladimir,12,0,34,22
1658083027719,MATH 193A,A05,093482,Rotar; Vladimir,11,0,34,23
1658083033740,MATH 197,001,091859,McAuley; Julian John,9999,0,9999,0
1658083033740,MATH 197,002,095566,Kedlaya; Kiran S.,9997,0,9999,2
1658083033740,MATH 197,003,095567,Xiao; Ming,9999,0,9999,0
1658083033740,MATH 197,004,095571,Perols; Johan Lars,9998,0,9999,1
1658083040804,COGS 9,A01,083615,Shannon; Kyle Michael,11,0,75,64
1658083046828,COGS 11,A01,083617,Boyle; Mary E. T.,23,0,48,25
1658083052856,COGS 13,A01,083071,Bastos; Amalia Pinkusfeld,12,0,71,59
1658083058879,COGS 14A,A01,092681,Semenuks; Arturs,5,1,100,95
1658083064906,COGS 14B,A01,083073,Cheng; Tzu-Han,7,0,63,56
1658083070930,COGS 17,A01,092677,Semenuks; Arturs,7,0,81,74
1658083076958,COGS 100,A01,083619,Allen; Michael Gordon,17,0,70,53
1658083082986,COGS 101A,A01,083621,Davis; Joshua Daniel,9,0,68,59
1658083089013,COGS 101B,A01,091572,Allen; Michael Gordon,14,0,65,51
1658083095041,COGS 101C,A01,083625,Delgado; Tania,17,0,35,18
1658083101066,COGS 107A,A01,083627,Boyle; Mary E. T.,14,0,60,46
1658083107091,COGS 118A,A01,083075,Gupta; Anjum,21,0,76,55
1658083113115,CSE 3,A50,083646,Miranda; Gregory Joseph,24,0,50,26
1658083119139,CSE 8A,A50,083650,Miranda; Gregory Joseph,17,1,56,39
1658083125162,CSE 11,A01,083080,Cao; Yingjun,7,15,40,33
1658083131190,CSE 12,A01,083652,Krause-Levy; Sophia Louisa,30,1,120,90
1658083137230,CSE 15L,A01,083654,Morris; Justin Loren,9,0,50,41
1658083137230,CSE 15L,A02,083655,Morris; Justin Loren,11,0,50,39
1658083143254,CSE 20,A01,083657,Tran; Khoa Dang,39,0,80,41
1658083149278,CSE 21,A01,095574,Bach; Quang Tran,23,0,48,25
1658083155306,CSE 30,A01,083084,Eldon; John,8,0,80,72
1658083155306,CSE 30,B01,095061,Bhaskar; Nishant,9,0,50,41
1658083161333,CSE 100,A01,083659,Cao; Yingjun,5,4,70,65
1658083167359,CSE 134B,A01,083661,Powell; Thomas Allan,25,0,100,75
1658083173383,CSE 140,A01,083663,Gungor; Onat,17,0,85,68
1658083179407,CSE 140L,A01,083088,Eldon; John,23,0,100,77
1658083185433,CSE 175,A01,083665,Kumar; Rakesh,3,0,25,22
1658083191459,CSE 190,A00,092507,Dubnov; Shlomo,8,0,20,12
1658083197483,ECE 45,A01,083139,Congero; Spencer William,7,0,75,68
1658083203508,ECE 65,A50,083695,Saad; Andrew S,12,0,30,18
1658083203508,ECE 65,A51,095125,Saad; Andrew S,24,0,26,2
1658083209532,ECE 109,A01,091882,Touri; Behrouz,21,0,70,49
1658083215555,ECE 180,A00,083140,Abi Samra; Nicholas Camill,1,0,30,29
1658083215555,ECE 180,B00,083141,Abi Samra; Nicholas Camill,0,0,30,30
1658083221580,MATH 10A,A01,083735,Patchell; Gregory David,2,0,30,28
1658083221580,MATH 10A,A02,083736,Patchell; Gregory David,20,0,30,10
1658083221580,MATH 10A,A03,083737,Patchell; Gregory David,16,0,30,14
1658083227604,MATH 10B,A01,083207,Lim; Seonhee,9,0,34,25
1658083227604,MATH 10B,A02,083208,Lim; Seonhee,10,0,35,25
1658083227604,MATH 10B,A03,093472,Lim; Seonhee,7,0,34,27
1658083227604,MATH 10B,B01,083739,Sinha; Shubham,14,0,30,16
1658083233634,MATH 18,A01,083743,Cinel; Cameron Alexander,9,0,30,21
1658083233634,MATH 18,A02,083744,Cinel; Cameron Alexander,18,0,30,12
1658083233634,MATH 18,A03,083745,Cinel; Cameron Alexander,10,0,30,20
1658083233634,MATH 18,B01,083748,Rideout; David Porter,5,0,37,32
1658083233634,MATH 18,B02,083749,Rideout; David Porter,5,0,36,31
1658083233634,MATH 18,B03,083750,Rideout; David Porter,3,0,37,34
1658083233634,MATH 18,B04,083751,Rideout; David Porter,7,0,36,29
1658083233634,MATH 18,B05,093473,Rideout; David Porter,7,0,36,29
1658083233634,MATH 18,B06,093474,Rideout; David Porter,6,0,36,30
1658083239658,MATH 20A,A01,083754,Zheng; Zequn,14,0,40,26
1658083245683,MATH 20B,A01,083756,Briones; Jor-el Thomas Caparas,4,0,36,32
1658083245683,MATH 20B,A02,083757,Briones; Jor-el Thomas Caparas,1,0,36,35
1658083245683,MATH 20B,A03,093475,Briones; Jor-el Thomas Caparas,3,0,36,33
1658083251707,MATH 20C,A01,083760,Briones; Jor-el Thomas Caparas,1,0,35,34
1658083251707,MATH 20C,A02,083761,Briones; Jor-el Thomas Caparas,8,0,35,27
1658083251707,MATH 20C,A03,093476,Briones; Jor-el Thomas Caparas,0,1,36,36
1658083251707,MATH 20C,B01,083762,Bach; Quang Tran,1,0,30,29
1658083257732,MATH 20D,A01,083765,Tran; Brian Kha,5,0,30,25
1658083257732,MATH 20D,A02,083766,Tran; Brian Kha,5,0,30,25
1658083257732,MATH 20D,A03,083767,Tran; Brian Kha,6,0,30,24
1658083263767,MATH 20E,A01,083771,Ganguly; Soumya,12,0,32,20
1658083263767,MATH 20E,A02,083772,Ganguly; Soumya,7,0,32,25
1658083263767,MATH 20E,B01,083773,Ciotti; Benjamin,20,0,35,15
1658083263767,MATH 20E,B02,083774,Ciotti; Benjamin,18,0,35,17
1658083269795,MATH 103A,A01,083777,Greenfeld; Be'Eri,6,0,36,30
1658083269795,MATH 103A,A02,083778,Greenfeld; Be'Eri,5,0,36,31
1658083269795,MATH 103A,A03,093561,Greenfeld; Be'Eri,7,0,36,29
1658083269795,MATH 103A,B01,083779,Greenfeld; Be'Eri,8,0,36,28
1658083269795,MATH 103A,B02,083780,Greenfeld; Be'Eri,4,0,36,32
1658083269795,MATH 103A,B03,093562,Greenfeld; Be'Eri,3,0,36,33
1658083275820,MATH 105,A01,085443,Carter; Anne Toulson,15,0,35,20
1658083275820,MATH 105,A02,093477,Carter; Anne Toulson,20,0,35,15
1658083281843,MATH 109,A01,083213,Ganzberger; Geoffrey Michael,3,0,34,31
1658083281843,MATH 109,A02,083214,Ganzberger; Geoffrey Michael,4,0,34,30
1658083281843,MATH 109,A03,093478,Ganzberger; Geoffrey Michael,2,0,34,32
1658083281843,MATH 109,B01,083215,Ganzberger; Geoffrey Michael,3,0,32,29
1658083281843,MATH 109,B02,083216,Ganzberger; Geoffrey Michael,3,0,32,29
1658083281843,MATH 109,B03,093479,Ganzberger; Geoffrey Michael,8,0,32,24
1658083287868,MATH 142A,A01,083219,Chow; Bennett,7,0,32,25
1658083287868,MATH 142A,A02,083220,Chow; Bennett,10,0,32,22
1658083287868,MATH 142A,A03,093480,Chow; Bennett,9,0,32,23
1658083287868,MATH 142A,B03,093481,Chow; Bennett,8,0,32,24
1658083287868,MATH 142A,B04,093558,Chow; Bennett,14,0,32,18
1658083287868,MATH 142A,B05,093559,Chow; Bennett,7,0,32,25
1658083293892,MATH 193A,A01,083224,Rotar; Vladimir,9,0,34,25
1658083293892,MATH 193A,A02,083225,Rotar; Vladimir,11,0,34,23
1658083293892,MATH 193A,A03,083781,Rotar; Vladimir,5,0,34,29
1658083293892,MATH 193A,A04,083782,Rotar; Vladimir,12,0,34,22
1658083293892,MATH 193A,A05,093482,Rotar; Vladimir,11,0,34,23
1658083299916,MATH 197,001,091859,McAuley; Julian John,9999,0,9999,0
1658083299916,MATH 197,002,095566,Kedlaya; Kiran S.,9997,0,9999,2
1658083299916,MATH 197,003,095567,Xiao; Ming,9999,0,9999,0
1658083299916,MATH 197,004,095571,Perols; Johan Lars,9998,0,9999,1
1658083306981,COGS 9,A01,083615,Shannon; Kyle Michael,11,0,75,64
1658083313003,COGS 11,A01,083617,Boyle; Mary E. T.,23,0,48,25
1658083319030,COGS 13,A01,083071,Bastos; Amalia Pinkusfeld,12,0,71,59
1658083325058,COGS 14A,A01,092681,Semenuks; Arturs,5,1,100,95
1658083331082,COGS 14B,A01,083073,Cheng; Tzu-Han,7,0,63,56
1658083337105,COGS 17,A01,092677,Semenuks; Arturs,7,0,81,74
1658083343128,COGS 100,A01,083619,Allen; Michael Gordon,17,0,70,53
1658083349151,COGS 101A,A01,083621,Davis; Joshua Daniel,9,0,68,59
1658083355180,COGS 101B,A01,091572,Allen; Michael Gordon,14,0,65,51
1658083361202,COGS 101C,A01,083625,Delgado; Tania,17,0,35,18
1658083367235,COGS 107A,A01,083627,Boyle; Mary E. T.,14,0,60,46
1658083373264,COGS 118A,A01,083075,Gupta; Anjum,21,0,76,55
1658083379292,CSE 3,A50,083646,Miranda; Gregory Joseph,24,0,50,26
1658083385320,CSE 8A,A50,083650,Miranda; Gregory Joseph,17,1,56,39
1658083391344,CSE 11,A01,083080,Cao; Yingjun,7,15,40,33
1658083397371,CSE 12,A01,083652,Krause-Levy; Sophia Louisa,30,1,120,90
1658083403396,CSE 15L,A01,083654,Morris; Justin Loren,9,0,50,41
1658083403396,CSE 15L,A02,083655,Morris; Justin Loren,11,0,50,39
1658083409421,CSE 20,A01,083657,Tran; Khoa Dang,39,0,80,41
1658083415444,CSE 21,A01,095574,Bach; Quang Tran,23,0,48,25
1658083421473,CSE 30,A01,083084,Eldon; John,8,0,80,72
1658083421473,CSE 30,B01,095061,Bhaskar; Nishant,9,0,50,41
1658083427497,CSE 100,A01,083659,Cao; Yingjun,5,4,70,65
1658083433520,CSE 134B,A01,083661,Powell; Thomas Allan,25,0,100,75
1658083439546,CSE 140,A01,083663,Gungor; Onat,17,0,85,68
1658083445572,CSE 140L,A01,083088,Eldon; John,23,0,100,77
1658083451596,CSE 175,A01,083665,Kumar; Rakesh,3,0,25,22
1658083457619,CSE 190,A00,092507,Dubnov; Shlomo,8,0,20,12
1658083463646,ECE 45,A01,083139,Congero; Spencer William,7,0,75,68
1658083469673,ECE 65,A50,083695,Saad; Andrew S,12,0,30,18
1658083469673,ECE 65,A51,095125,Saad; Andrew S,24,0,26,2
1658083475706,ECE 109,A01,091882,Touri; Behrouz,21,0,70,49
1658083481734,ECE 180,A00,083140,Abi Samra; Nicholas Camill,1,0,30,29
1658083481734,ECE 180,B00,083141,Abi Samra; Nicholas Camill,0,0,30,30
1658083487849,MATH 10A,A01,083735,Patchell; Gregory David,2,0,30,28
1658083487849,MATH 10A,A02,083736,Patchell; Gregory David,20,0,30,10
1658083487849,MATH 10A,A03,083737,Patchell; Gregory David,16,0,30,14
1658083493874,MATH 10B,A01,083207,Lim; Seonhee,9,0,34,25
1658083493874,MATH 10B,A02,083208,Lim; Seonhee,10,0,35,25
1658083493874,MATH 10B,A03,093472,Lim; Seonhee,7,0,34,27
1658083493874,MATH 10B,B01,083739,Sinha; Shubham,14,0,30,16
1658083499898,MATH 18,A01,083743,Cinel; Cameron Alexander,9,0,30,21
1658083499898,MATH 18,A02,083744,Cinel; Cameron Alexander,18,0,30,12
1658083499898,MATH 18,A03,083745,Cinel; Cameron Alexander,10,0,30,20
1658083499898,MATH 18,B01,083748,Rideout; David Porter,5,0,37,32
1658083499898,MATH 18,B02,083749,Rideout; David Porter,5,0,36,31
1658083499898,MATH 18,B03,083750,Rideout; David Porter,3,0,37,34
1658083499898,MATH 18,B04,083751,Rideout; David Porter,7,0,36,29
1658083499898,MATH 18,B05,093473,Rideout; David Porter,7,0,36,29
1658083499898,MATH 18,B06,093474,Rideout; David Porter,6,0,36,30
1658083505922,MATH 20A,A01,083754,Zheng; Zequn,14,0,40,26
1658083511946,MATH 20B,A01,083756,Briones; Jor-el Thomas Caparas,4,0,36,32
1658083511946,MATH 20B,A02,083757,Briones; Jor-el Thomas Caparas,1,0,36,35
1658083511946,MATH 20B,A03,093475,Briones; Jor-el Thomas Caparas,3,0,36,33
1658083517971,MATH 20C,A01,083760,Briones; Jor-el Thomas Caparas,1,0,35,34
1658083517971,MATH 20C,A02,083761,Briones; Jor-el Thomas Caparas,8,0,35,27
1658083517971,MATH 20C,A03,093476,Briones; Jor-el Thomas Caparas,0,1,36,36
1658083517971,MATH 20C,B01,083762,Bach; Quang Tran,1,0,30,29
1658083524001,MATH 20D,A01,083765,Tran; Brian Kha,5,0,30,25
1658083524001,MATH 20D,A02,083766,Tran; Brian Kha,5,0,30,25
1658083524001,MATH 20D,A03,083767,Tran; Brian Kha,6,0,30,24
1658083530037,MATH 20E,A01,083771,Ganguly; Soumya,12,0,32,20
1658083530037,MATH 20E,A02,083772,Ganguly; Soumya,7,0,32,25
1658083530037,MATH 20E,B01,083773,Ciotti; Benjamin,20,0,35,15
1658083530037,MATH 20E,B02,083774,Ciotti; Benjamin,18,0,35,17
1658083536069,MATH 103A,A01,083777,Greenfeld; Be'Eri,6,0,36,30
1658083536069,MATH 103A,A02,083778,Greenfeld; Be'Eri,5,0,36,31
1658083536069,MATH 103A,A03,093561,Greenfeld; Be'Eri,7,0,36,29
1658083536069,MATH 103A,B01,083779,Greenfeld; Be'Eri,8,0,36,28
1658083536069,MATH 103A,B02,083780,Greenfeld; Be'Eri,4,0,36,32
1658083536069,MATH 103A,B03,093562,Greenfeld; Be'Eri,3,0,36,33
1658083542097,MATH 105,A01,085443,Carter; Anne Toulson,15,0,35,20
1658083542097,MATH 105,A02,093477,Carter; Anne Toulson,20,0,35,15
1658083548126,MATH 109,A01,083213,Ganzberger; Geoffrey Michael,3,0,34,31
1658083548126,MATH 109,A02,083214,Ganzberger; Geoffrey Michael,4,0,34,30
1658083548126,MATH 109,A03,093478,Ganzberger; Geoffrey Michael,2,0,34,32
1658083548126,MATH 109,B01,083215,Ganzberger; Geoffrey Michael,3,0,32,29
1658083548126,MATH 109,B02,083216,Ganzberger; Geoffrey Michael,3,0,32,29
1658083548126,MATH 109,B03,093479,Ganzberger; Geoffrey Michael,8,0,32,24
1658083554157,MATH 142A,A01,083219,Chow; Bennett,7,0,32,25
1658083554157,MATH 142A,A02,083220,Chow; Bennett,10,0,32,22
1658083554157,MATH 142A,A03,093480,Chow; Bennett,9,0,32,23
1658083554157,MATH 142A,B03,093481,Chow; Bennett,8,0,32,24
1658083554157,MATH 142A,B04,093558,Chow; Bennett,14,0,32,18
1658083554157,MATH 142A,B05,093559,Chow; Bennett,7,0,32,25
1658083560186,MATH 193A,A01,083224,Rotar; Vladimir,9,0,34,25
1658083560186,MATH 193A,A02,083225,Rotar; Vladimir,11,0,34,23
1658083560186,MATH 193A,A03,083781,Rotar; Vladimir,5,0,34,29
1658083560186,MATH 193A,A04,083782,Rotar; Vladimir,12,0,34,22
1658083560186,MATH 193A,A05,093482,Rotar; Vladimir,11,0,34,23
1658083566210,MATH 197,001,091859,McAuley; Julian John,9999,0,9999,0
1658083566210,MATH 197,002,095566,Kedlaya; Kiran S.,9997,0,9999,2
1658083566210,MATH 197,003,095567,Xiao; Ming,9999,0,9999,0
1658083566210,MATH 197,004,095571,Perols; Johan Lars,9998,0,9999,1
1658083573268,COGS 9,A01,083615,Shannon; Kyle Michael,11,0,75,64
1658083579291,COGS 11,A01,083617,Boyle; Mary E. T.,23,0,48,25
1658083585318,COGS 13,A01,083071,Bastos; Amalia Pinkusfeld,12,0,71,59
1658083591341,COGS 14A,A01,092681,Semenuks; Arturs,5,1,100,95
1658083597369,COGS 14B,A01,083073,Cheng; Tzu-Han,7,0,63,56
1658083603404,COGS 17,A01,092677,Semenuks; Arturs,7,0,81,74
1658083609428,COGS 100,A01,083619,Allen; Michael Gordon,17,0,70,53
1658083615452,COGS 101A,A01,083621,Davis; Joshua Daniel,9,0,68,59
1658083621475,COGS 101B,A01,091572,Allen; Michael Gordon,14,0,65,51
1658083627502,COGS 101C,A01,083625,Delgado; Tania,17,0,35,18
1658083633526,COGS 107A,A01,083627,Boyle; Mary E. T.,14,0,60,46
1658083639553,COGS 118A,A01,083075,Gupta; Anjum,21,0,76,55
1658083645582,CSE 3,A50,083646,Miranda; Gregory Joseph,24,0,50,26
1658083651610,CSE 8A,A50,083650,Miranda; Gregory Joseph,17,1,56,39
1658083657643,CSE 11,A01,083080,Cao; Yingjun,7,15,40,33
1658083663671,CSE 12,A01,083652,Krause-Levy; Sophia Louisa,30,1,120,90
1658083669694,CSE 15L,A01,083654,Morris; Justin Loren,9,0,50,41
1658083669694,CSE 15L,A02,083655,Morris; Justin Loren,11,0,50,39
1658083675719,CSE 20,A01,083657,Tran; Khoa Dang,39,0,80,41
1658083681742,CSE 21,A01,095574,Bach; Quang Tran,23,0,48,25
1658083687764,CSE 30,A01,083084,Eldon; John,8,0,80,72
1658083687764,CSE 30,B01,095061,Bhaskar; Nishant,9,0,50,41
1658083693789,CSE 100,A01,083659,Cao; Yingjun,5,4,70,65
1658083699811,CSE 134B,A01,083661,Powell; Thomas Allan,25,0,100,75
1658083705834,CSE 140,A01,083663,Gungor; Onat,17,0,85,68
1658083711858,CSE 140L,A01,083088,Eldon; John,23,0,100,77
1658083717881,CSE 175,A01,083665,Kumar; Rakesh,3,0,25,22
1658083723907,CSE 190,A00,092507,Dubnov; Shlomo,8,0,20,12
1658083729932,ECE 45,A01,083139,Congero; Spencer William,7,0,75,68
1658083735970,ECE 65,A50,083695,Saad; Andrew S,12,0,30,18
1658083735970,ECE 65,A51,095125,Saad; Andrew S,24,0,26,2
1658083741997,ECE 109,A01,091882,Touri; Behrouz,21,0,70,49
1658083748020,ECE 180,A00,083140,Abi Samra; Nicholas Camill,1,0,30,29
1658083748020,ECE 180,B00,083141,Abi Samra; Nicholas Camill,0,0,30,30
1658083754047,MATH 10A,A01,083735,Patchell; Gregory David,2,0,30,28
1658083754047,MATH 10A,A02,083736,Patchell; Gregory David,20,0,30,10
1658083754047,MATH 10A,A03,083737,Patchell; Gregory David,16,0,30,14
1658083760070,MATH 10B,A01,083207,Lim; Seonhee,9,0,34,25
1658083760070,MATH 10B,A02,083208,Lim; Seonhee,10,0,35,25
1658083760070,MATH 10B,A03,093472,Lim; Seonhee,7,0,34,27
1658083760070,MATH 10B,B01,083739,Sinha; Shubham,14,0,30,16
1658083766098,MATH 18,A01,083743,Cinel; Cameron Alexander,9,0,30,21
1658083766098,MATH 18,A02,083744,Cinel; Cameron Alexander,18,0,30,12
1658083766098,MATH 18,A03,083745,Cinel; Cameron Alexander,10,0,30,20
1658083766098,MATH 18,B01,083748,Rideout; David Porter,5,0,37,32
1658083766098,MATH 18,B02,083749,Rideout; David Porter,5,0,36,31
1658083766098,MATH 18,B03,083750,Rideout; David Porter,3,0,37,34
1658083766098,MATH 18,B04,083751,Rideout; David Porter,7,0,36,29
1658083766098,MATH 18,B05,093473,Rideout; David Porter,7,0,36,29
1658083766098,MATH 18,B06,093474,Rideout; David Porter,6,0,36,30
1658083772125,MATH 20A,A01,083754,Zheng; Zequn,14,0,40,26
1658083778149,MATH 20B,A01,083756,Briones; Jor-el Thomas Caparas,4,0,36,32
1658083778149,MATH 20B,A02,083757,Briones; Jor-el Thomas Caparas,1,0,36,35
1658083778149,MATH 20B,A03,093475,Briones; Jor-el Thomas Caparas,3,0,36,33
1658083784173,MATH 20C,A01,083760,Briones; Jor-el Thomas Caparas,1,0,35,34
1658083784173,MATH 20C,A02,083761,Briones; Jor-el Thomas Caparas,8,0,35,27
1658083784173,MATH 20C,A03,093476,Briones; Jor-el Thomas Caparas,0,1,36,36
1658083784173,MATH 20C,B01,083762,Bach; Quang Tran,1,0,30,29
1658083790206,MATH 20D,A01,083765,Tran; Brian Kha,5,0,30,25
1658083790206,MATH 20D,A02,083766,Tran; Brian Kha,5,0,30,25
1658083790206,MATH 20D,A03,083767,Tran; Brian Kha,6,0,30,24
1658083796235,MATH 20E,A01,083771,Ganguly; Soumya,12,0,32,20
1658083796235,MATH 20E,A02,083772,Ganguly; Soumya,7,0,32,25
1658083796235,MATH 20E,B01,083773,Ciotti; Benjamin,20,0,35,15
1658083796235,MATH 20E,B02,083774,Ciotti; Benjamin,18,0,35,17
1658083802266,MATH 103A,A01,083777,Greenfeld; Be'Eri,6,0,36,30
1658083802266,MATH 103A,A02,083778,Greenfeld; Be'Eri,5,0,36,31
1658083802266,MATH 103A,A03,093561,Greenfeld; Be'Eri,7,0,36,29
1658083802266,MATH 103A,B01,083779,Greenfeld; Be'Eri,8,0,36,28
1658083802266,MATH 103A,B02,083780,Greenfeld; Be'Eri,4,0,36,32
1658083802266,MATH 103A,B03,093562,Greenfeld; Be'Eri,3,0,36,33
1658083808290,MATH 105,A01,085443,Carter; Anne Toulson,15,0,35,20
1658083808290,MATH 105,A02,093477,Carter; Anne Toulson,20,0,35,15
1658083814319,MATH 109,A01,083213,Ganzberger; Geoffrey Michael,3,0,34,31
1658083814319,MATH 109,A02,083214,Ganzberger; Geoffrey Michael,4,0,34,30
1658083814319,MATH 109,A03,093478,Ganzberger; Geoffrey Michael,2,0,34,32
1658083814319,MATH 109,B01,083215,Ganzberger; Geoffrey Michael,3,0,32,29
1658083814319,MATH 109,B02,083216,Ganzberger; Geoffrey Michael,3,0,32,29
1658083814319,MATH 109,B03,093479,Ganzberger; Geoffrey Michael,8,0,32,24
1658083820344,MATH 142A,A01,083219,Chow; Bennett,7,0,32,25
1658083820344,MATH 142A,A02,083220,Chow; Bennett,10,0,32,22
1658083820344,MATH 142A,A03,093480,Chow; Bennett,9,0,32,23
1658083820344,MATH 142A,B03,093481,Chow; Bennett,8,0,32,24
1658083820344,MATH 142A,B04,093558,Chow; Bennett,14,0,32,18
1658083820344,MATH 142A,B05,093559,Chow; Bennett,7,0,32,25
1658083826372,MATH 193A,A01,083224,Rotar; Vladimir,9,0,34,25
1658083826372,MATH 193A,A02,083225,Rotar; Vladimir,11,0,34,23
1658083826372,MATH 193A,A03,083781,Rotar; Vladimir,5,0,34,29
1658083826372,MATH 193A,A04,083782,Rotar; Vladimir,12,0,34,22
1658083826372,MATH 193A,A05,093482,Rotar; Vladimir,11,0,34,23
1658083832397,MATH 197,001,091859,McAuley; Julian John,9999,0,9999,0
1658083832397,MATH 197,002,095566,Kedlaya; Kiran S.,9997,0,9999,2
1658083832397,MATH 197,003,095567,Xiao; Ming,9999,0,9999,0
1658083832397,MATH 197,004,095571,Perols; Johan Lars,9998,0,9999,1
1658083839465,COGS 9,A01,083615,Shannon; Kyle Michael,11,0,75,64
1658083845491,COGS 11,A01,083617,Boyle; Mary E. T.,23,0,48,25
1658083851518,COGS 13,A01,083071,Bastos; Amalia Pinkusfeld,12,0,71,59
1658083857546,COGS 14A,A01,092681,Semenuks; Arturs,5,1,100,95
1658083863569,COGS 14B,A01,083073,Cheng; Tzu-Han,7,0,63,56
1658083869592,COGS 17,A01,092677,Semenuks; Arturs,7,0,81,74
1658083875619,COGS 100,A01,083619,Allen; Michael Gordon,17,0,70,53
1658083881640,COGS 101A,A01,083621,Davis; Joshua Daniel,9,0,68,59
1658083887669,COGS 101B,A01,091572,Allen; Michael Gordon,14,0,65,51
1658083893693,COGS 101C,A01,083625,Delgado; Tania,17,0,35,18
1658083899716,COGS 107A,A01,083627,Boyle; Mary E. T.,14,0,60,46
1658083905742,COGS 118A,A01,083075,Gupta; Anjum,21,0,76,55
1658083911770,CSE 3,A50,083646,Miranda; Gregory Joseph,24,0,50,26
1658083917796,CSE 8A,A50,083650,Miranda; Gregory Joseph,17,1,56,39
1658083923823,CSE 11,A01,083080,Cao; Yingjun,7,15,40,33
1658083929849,CSE 12,A01,083652,Krause-Levy; Sophia Louisa,30,1,120,90
1658083935871,CSE 15L,A01,083654,Morris; Justin Loren,9,0,50,41
1658083935871,CSE 15L,A02,083655,Morris; Justin Loren,11,0,50,39
1658083941895,CSE 20,A01,083657,Tran; Khoa Dang,39,0,80,41
1658083947920,CSE 21,A01,095574,Bach; Quang Tran,23,0,48,25
1658083953945,CSE 30,A01,083084,Eldon; John,8,0,80,72
1658083953945,CSE 30,B01,095061,Bhaskar; Nishant,9,0,50,41
1658083959971,CSE 100,A01,083659,Cao; Yingjun,5,4,70,65
1658083965995,CSE 134B,A01,083661,Powell; Thomas Allan,25,0,100,75
1658083972020,CSE 140,A01,083663,Gungor; Onat,17,0,85,68
1658083978044,CSE 140L,A01,083088,Eldon; John,23,0,100,77
1658083984070,CSE 175,A01,083665,Kumar; Rakesh,3,0,25,22
1658083990097,CSE 190,A00,092507,Dubnov; Shlomo,8,0,20,12
1658083996119,ECE 45,A01,083139,Congero; Spencer William,7,0,75,68
1658084002141,ECE 65,A50,083695,Saad; Andrew S,12,0,30,18
1658084002141,ECE 65,A51,095125,Saad; Andrew S,24,0,26,2
1658084008169,ECE 109,A01,091882,Touri; Behrouz,21,0,70,49
1658084014192,ECE 180,A00,083140,Abi Samra; Nicholas Camill,1,0,30,29
1658084014192,ECE 180,B00,083141,Abi Samra; Nicholas Camill,0,0,30,30
1658084020215,MATH 10A,A01,083735,Patchell; Gregory David,2,0,30,28
1658084020215,MATH 10A,A02,083736,Patchell; Gregory David,20,0,30,10
1658084020215,MATH 10A,A03,083737,Patchell; Gregory David,16,0,30,14
1658084026244,MATH 10B,A01,083207,Lim; Seonhee,9,0,34,25
1658084026244,MATH 10B,A02,083208,Lim; Seonhee,10,0,35,25
1658084026244,MATH 10B,A03,093472,Lim; Seonhee,7,0,34,27
1658084026244,MATH 10B,B01,083739,Sinha; Shubham,14,0,30,16
1658084032268,MATH 18,A01,083743,Cinel; Cameron Alexander,9,0,30,21
1658084032268,MATH 18,A02,083744,Cinel; Cameron Alexander,18,0,30,12
1658084032268,MATH 18,A03,083745,Cinel; Cameron Alexander,10,0,30,20
1658084032268,MATH 18,B01,083748,Rideout; David Porter,5,0,37,32
1658084032268,MATH 18,B02,083749,Rideout; David Porter,5,0,36,31
1658084032268,MATH 18,B03,083750,Rideout; David Porter,3,0,37,34
1658084032268,MATH 18,B04,083751,Rideout; David Porter,7,0,36,29
1658084032268,MATH 18,B05,093473,Rideout; David Porter,7,0,36,29
1658084032268,MATH 18,B06,093474,Rideout; David Porter,6,0,36,30
1658084038296,MATH 20A,A01,083754,Zheng; Zequn,14,0,40,26
1658084044320,MATH 20B,A01,083756,Briones; Jor-el Thomas Caparas,4,0,36,32
1658084044320,MATH 20B,A02,083757,Briones; Jor-el Thomas Caparas,1,0,36,35
1658084044320,MATH 20B,A03,093475,Briones; Jor-el Thomas Caparas,3,0,36,33
1658084050360,MATH 20C,A01,083760,Briones; Jor-el Thomas Caparas,1,0,35,34
1658084050360,MATH 20C,A02,083761,Briones; Jor-el Thomas Caparas,8,0,35,27
1658084050360,MATH 20C,A03,093476,Briones; Jor-el Thomas Caparas,0,1,36,36
1658084050360,MATH 20C,B01,083762,Bach; Quang Tran,1,0,30,29
1658084056383,MATH 20D,A01,083765,Tran; Brian Kha,5,0,30,25
1658084056383,MATH 20D,A02,083766,Tran; Brian Kha,5,0,30,25
1658084056383,MATH 20D,A03,083767,Tran; Brian Kha,6,0,30,24
1658084062406,MATH 20E,A01,083771,Ganguly; Soumya,12,0,32,20
1658084062406,MATH 20E,A02,083772,Ganguly; Soumya,7,0,32,25
1658084062406,MATH 20E,B01,083773,Ciotti; Benjamin,20,0,35,15
1658084062406,MATH 20E,B02,083774,Ciotti; Benjamin,18,0,35,17
1658084068431,MATH 103A,A01,083777,Greenfeld; Be'Eri,6,0,36,30
1658084068431,MATH 103A,A02,083778,Greenfeld; Be'Eri,5,0,36,31
1658084068431,MATH 103A,A03,093561,Greenfeld; Be'Eri,7,0,36,29
1658084068431,MATH 103A,B01,083779,Greenfeld; Be'Eri,8,0,36,28
1658084068431,MATH 103A,B02,083780,Greenfeld; Be'Eri,4,0,36,32
1658084068431,MATH 103A,B03,093562,Greenfeld; Be'Eri,3,0,36,33
1658084074454,MATH 105,A01,085443,Carter; Anne Toulson,15,0,35,20
1658084074454,MATH 105,A02,093477,Carter; Anne Toulson,20,0,35,15
1658084080479,MATH 109,A01,083213,Ganzberger; Geoffrey Michael,3,0,34,31
1658084080479,MATH 109,A02,083214,Ganzberger; Geoffrey Michael,4,0,34,30
1658084080479,MATH 109,A03,093478,Ganzberger; Geoffrey Michael,2,0,34,32
1658084080479,MATH 109,B01,083215,Ganzberger; Geoffrey Michael,3,0,32,29
1658084080479,MATH 109,B02,083216,Ganzberger; Geoffrey Michael,3,0,32,29
1658084080479,MATH 109,B03,093479,Ganzberger; Geoffrey Michael,8,0,32,24
1658084086587,MATH 142A,A01,083219,Chow; Bennett,7,0,32,25
1658084086587,MATH 142A,A02,083220,Chow; Bennett,10,0,32,22
1658084086587,MATH 142A,A03,093480,Chow; Bennett,9,0,32,23
1658084086587,MATH 142A,B03,093481,Chow; Bennett,8,0,32,24
1658084086587,MATH 142A,B04,093558,Chow; Bennett,14,0,32,18
1658084086587,MATH 142A,B05,093559,Chow; Bennett,7,0,32,25
1658084092610,MATH 193A,A01,083224,Rotar; Vladimir,9,0,34,25
1658084092610,MATH 193A,A02,083225,Rotar; Vladimir,11,0,34,23
1658084092610,MATH 193A,A03,083781,Rotar; Vladimir,5,0,34,29
1658084092610,MATH 193A,A04,083782,Rotar; Vladimir,12,0,34,22
1658084092610,MATH 193A,A05,093482,Rotar; Vladimir,11,0,34,23
1658084098638,MATH 197,001,091859,McAuley; Julian John,9999,0,9999,0
1658084098638,MATH 197,002,095566,Kedlaya; Kiran S.,9997,0,9999,2
1658084098638,MATH 197,003,095567,Xiao; Ming,9999,0,9999,0
1658084098638,MATH 197,004,095571,Perols; Johan Lars,9998,0,9999,1
1658084105697,COGS 9,A01,083615,Shannon; Kyle Michael,11,0,75,64
1658084111721,COGS 11,A01,083617,Boyle; Mary E. T.,23,0,48,25
1658084117745,COGS 13,A01,083071,Bastos; Amalia Pinkusfeld,12,0,71,59
1658084123772,COGS 14A,A01,092681,Semenuks; Arturs,5,1,100,95
1658084129798,COGS 14B,A01,083073,Cheng; Tzu-Han,7,0,63,56
1658084135821,COGS 17,A01,092677,Semenuks; Arturs,7,0,81,74
1658084141847,COGS 100,A01,083619,Allen; Michael Gordon,17,0,70,53
1658084147875,COGS 101A,A01,083621,Davis; Joshua Daniel,9,0,68,59
1658084153898,COGS 101B,A01,091572,Allen; Michael Gordon,14,0,65,51
1658084159922,COGS 101C,A01,083625,Delgado; Tania,17,0,35,18
1658084165950,COGS 107A,A01,083627,Boyle; Mary E. T.,14,0,60,46
1658084171972,COGS 118A,A01,083075,Gupta; Anjum,21,0,76,55
1658084177995,CSE 3,A50,083646,Miranda; Gregory Joseph,24,0,50,26
1658084184023,CSE 8A,A50,083650,Miranda; Gregory Joseph,17,1,56,39
1658084190052,CSE 11,A01,083080,Cao; Yingjun,7,15,40,33
1658084196080,CSE 12,A01,083652,Krause-Levy; Sophia Louisa,30,1,120,90
1658084202103,CSE 15L,A01,083654,Morris; Justin Loren,9,0,50,41
1658084202103,CSE 15L,A02,083655,Morris; Justin Loren,11,0,50,39
1658084208126,CSE 20,A01,083657,Tran; Khoa Dang,39,0,80,41
1658084214150,CSE 21,A01,095574,Bach; Quang Tran,23,0,48,25
1658084220184,CSE 30,A01,083084,Eldon; John,8,0,80,72
1658084220184,CSE 30,B01,095061,Bhaskar; Nishant,9,0,50,41
1658084226212,CSE 100,A01,083659,Cao; Yingjun,5,4,70,65
1658084232236,CSE 134B,A01,083661,Powell; Thomas Allan,25,0,100,75
1658084238269,CSE 140,A01,083663,Gungor; Onat,17,0,85,68
1658084244292,CSE 140L,A01,083088,Eldon; John,23,0,100,77
1658084250316,CSE 175,A01,083665,Kumar; Rakesh,3,0,25,22
1658084256341,CSE 190,A00,092507,Dubnov; Shlomo,8,0,20,12
1658084262364,ECE 45,A01,083139,Congero; Spencer William,7,0,75,68
1658084268393,ECE 65,A50,083695,Saad; Andrew S,12,0,30,18
1658084268393,ECE 65,A51,095125,Saad; Andrew S,24,0,26,2
1658084274417,ECE 109,A01,091882,Touri; Behrouz,21,0,70,49
1658084280439,ECE 180,A00,083140,Abi Samra; Nicholas Camill,1,0,30,29
1658084280439,ECE 180,B00,083141,Abi Samra; Nicholas Camill,0,0,30,30
1658084286464,MATH 10A,A01,083735,Patchell; Gregory David,2,0,30,28
1658084286464,MATH 10A,A02,083736,Patchell; Gregory David,20,0,30,10
1658084286464,MATH 10A,A03,083737,Patchell; Gregory David,16,0,30,14
1658084292488,MATH 10B,A01,083207,Lim; Seonhee,9,0,34,25
1658084292488,MATH 10B,A02,083208,Lim; Seonhee,10,0,35,25
1658084292488,MATH 10B,A03,093472,Lim; Seonhee,7,0,34,27
1658084292488,MATH 10B,B01,083739,Sinha; Shubham,14,0,30,16
1658084298514,MATH 18,A01,083743,Cinel; Cameron Alexander,9,0,30,21
1658084298514,MATH 18,A02,083744,Cinel; Cameron Alexander,18,0,30,12
1658084298514,MATH 18,A03,083745,Cinel; Cameron Alexander,10,0,30,20
1658084298514,MATH 18,B01,083748,Rideout; David Porter,5,0,37,32
1658084298514,MATH 18,B02,083749,Rideout; David Porter,5,0,36,31
1658084298514,MATH 18,B03,083750,Rideout; David Porter,3,0,37,34
1658084298514,MATH 18,B04,083751,Rideout; David Porter,7,0,36,29
1658084298514,MATH 18,B05,093473,Rideout; David Porter,7,0,36,29
1658084298514,MATH 18,B06,093474,Rideout; David Porter,6,0,36,30
1658084304537,MATH 20A,A01,083754,Zheng; Zequn,14,0,40,26
1658084310561,MATH 20B,A01,083756,Briones; Jor-el Thomas Caparas,4,0,36,32
1658084310561,MATH 20B,A02,083757,Briones; Jor-el Thomas Caparas,1,0,36,35
1658084310561,MATH 20B,A03,093475,Briones; Jor-el Thomas Caparas,3,0,36,33
1658084316586,MATH 20C,A01,083760,Briones; Jor-el Thomas Caparas,1,0,35,34
1658084316586,MATH 20C,A02,083761,Briones; Jor-el Thomas Caparas,8,0,35,27
1658084316586,MATH 20C,A03,093476,Briones; Jor-el Thomas Caparas,0,1,36,36
1658084316586,MATH 20C,B01,083762,Bach; Quang Tran,1,0,30,29
1658084322610,MATH 20D,A01,083765,Tran; Brian Kha,5,0,30,25
1658084322610,MATH 20D,A02,083766,Tran; Brian Kha,5,0,30,25
1658084322610,MATH 20D,A03,083767,Tran; Brian Kha,6,0,30,24
1658084328639,MATH 20E,A01,083771,Ganguly; Soumya,12,0,32,20
1658084328639,MATH 20E,A02,083772,Ganguly; Soumya,7,0,32,25
1658084328639,MATH 20E,B01,083773,Ciotti; Benjamin,20,0,35,15
1658084328639,MATH 20E,B02,083774,Ciotti; Benjamin,18,0,35,17
1658084334663,MATH 103A,A01,083777,Greenfeld; Be'Eri,6,0,36,30
1658084334663,MATH 103A,A02,083778,Greenfeld; Be'Eri,5,0,36,31
1658084334663,MATH 103A,A03,093561,Greenfeld; Be'Eri,7,0,36,29
1658084334663,MATH 103A,B01,083779,Greenfeld; Be'Eri,8,0,36,28
1658084334663,MATH 103A,B02,083780,Greenfeld; Be'Eri,4,0,36,32
1658084334663,MATH 103A,B03,093562,Greenfeld; Be'Eri,3,0,36,33
1658084340688,MATH 105,A01,085443,Carter; Anne Toulson,15,0,35,20
1658084340688,MATH 105,A02,093477,Carter; Anne Toulson,20,0,35,15
1658084346718,MATH 109,A01,083213,Ganzberger; Geoffrey Michael,3,0,34,31
1658084346718,MATH 109,A02,083214,Ganzberger; Geoffrey Michael,4,0,34,30
1658084346718,MATH 109,A03,093478,Ganzberger; Geoffrey Michael,2,0,34,32
1658084346718,MATH 109,B01,083215,Ganzberger; Geoffrey Michael,3,0,32,29
1658084346718,MATH 109,B02,083216,Ganzberger; Geoffrey Michael,3,0,32,29
1658084346718,MATH 109,B03,093479,Ganzberger; Geoffrey Michael,8,0,32,24
1658084352747,MATH 142A,A01,083219,Chow; Bennett,7,0,32,25
1658084352747,MATH 142A,A02,083220,Chow; Bennett,10,0,32,22
1658084352747,MATH 142A,A03,093480,Chow; Bennett,9,0,32,23
1658084352747,MATH 142A,B03,093481,Chow; Bennett,8,0,32,24
1658084352747,MATH 142A,B04,093558,Chow; Bennett,14,0,32,18
1658084352747,MATH 142A,B05,093559,Chow; Bennett,7,0,32,25
1658084358770,MATH 193A,A01,083224,Rotar; Vladimir,9,0,34,25
1658084358770,MATH 193A,A02,083225,Rotar; Vladimir,11,0,34,23
1658084358770,MATH 193A,A03,083781,Rotar; Vladimir,5,0,34,29
1658084358770,MATH 193A,A04,083782,Rotar; Vladimir,12,0,34,22
1658084358770,MATH 193A,A05,093482,Rotar; Vladimir,11,0,34,23
1658084364797,MATH 197,001,091859,McAuley; Julian John,9999,0,9999,0
1658084364797,MATH 197,002,095566,Kedlaya; Kiran S.,9997,0,9999,2
1658084364797,MATH 197,003,095567,Xiao; Ming,9999,0,9999,0
1658084364797,MATH 197,004,095571,Perols; Johan Lars,9998,0,9999,1
1658084371888,COGS 9,A01,083615,Shannon; Kyle Michael,11,0,75,64
1658084377912,COGS 11,A01,083617,Boyle; Mary E. T.,23,0,48,25
1658084383948,COGS 13,A01,083071,Bastos; Amalia Pinkusfeld,12,0,71,59
1658084389971,COGS 14A,A01,092681,Semenuks; Arturs,5,1,100,95
1658084395994,COGS 14B,A01,083073,Cheng; Tzu-Han,7,0,63,56
1658084402017,COGS 17,A01,092677,Semenuks; Arturs,7,0,81,74
1658084408041,COGS 100,A01,083619,Allen; Michael Gordon,17,0,70,53
1658084414068,COGS 101A,A01,083621,Davis; Joshua Daniel,9,0,68,59
1658084420093,COGS 101B,A01,091572,Allen; Michael Gordon,14,0,65,51
1658084426121,COGS 101C,A01,083625,Delgado; Tania,17,0,35,18
1658084432147,COGS 107A,A01,083627,Boyle; Mary E. T.,14,0,60,46
1658084438170,COGS 118A,A01,083075,Gupta; Anjum,21,0,76,55
1658084444194,CSE 3,A50,083646,Miranda; Gregory Joseph,24,0,50,26
1658084450221,CSE 8A,A50,083650,Miranda; Gregory Joseph,17,1,56,39
1658084456256,CSE 11,A01,083080,Cao; Yingjun,7,15,40,33
1658084462284,CSE 12,A01,083652,Krause-Levy; Sophia Louisa,30,1,120,90
1658084468312,CSE 15L,A01,083654,Morris; Justin Loren,9,0,50,41
1658084468312,CSE 15L,A02,083655,Morris; Justin Loren,11,0,50,39
1658084474335,CSE 20,A01,083657,Tran; Khoa Dang,39,0,80,41
1658084480359,CSE 21,A01,095574,Bach; Quang Tran,23,0,48,25
1658084486382,CSE 30,A01,083084,Eldon; John,8,0,80,72
1658084486382,CSE 30,B01,095061,Bhaskar; Nishant,9,0,50,41
1658084492403,CSE 100,A01,083659,Cao; Yingjun,5,4,70,65
1658084498426,CSE 134B,A01,083661,Powell; Thomas Allan,25,0,100,75
1658084504451,CSE 140,A01,083663,Gungor; Onat,17,0,85,68
1658084510478,CSE 140L,A01,083088,Eldon; John,23,0,100,77
1658084516505,CSE 175,A01,083665,Kumar; Rakesh,3,0,25,22
1658084522536,CSE 190,A00,092507,Dubnov; Shlomo,8,0,20,12
1658084528562,ECE 45,A01,083139,Congero; Spencer William,7,0,75,68
1658084534586,ECE 65,A50,083695,Saad; Andrew S,12,0,30,18
1658084534586,ECE 65,A51,095125,Saad; Andrew S,24,0,26,2
1658084540609,ECE 109,A01,091882,Touri; Behrouz,21,0,70,49
1658084546642,ECE 180,A00,083140,Abi Samra; Nicholas Camill,1,0,30,29
1658084546642,ECE 180,B00,083141,Abi Samra; Nicholas Camill,0,0,30,30
1658084552669,MATH 10A,A01,083735,Patchell; Gregory David,2,0,30,28
1658084552669,MATH 10A,A02,083736,Patchell; Gregory David,20,0,30,10
1658084552669,MATH 10A,A03,083737,Patchell; Gregory David,16,0,30,14
1658084558694,MATH 10B,A01,083207,Lim; Seonhee,9,0,34,25
1658084558694,MATH 10B,A02,083208,Lim; Seonhee,10,0,35,25
1658084558694,MATH 10B,A03,093472,Lim; Seonhee,7,0,34,27
1658084558694,MATH 10B,B01,083739,Sinha; Shubham,14,0,30,16
1658084564725,MATH 18,A01,083743,Cinel; Cameron Alexander,9,0,30,21
1658084564725,MATH 18,A02,083744,Cinel; Cameron Alexander,18,0,30,12
1658084564725,MATH 18,A03,083745,Cinel; Cameron Alexander,10,0,30,20
1658084564725,MATH 18,B01,083748,Rideout; David Porter,5,0,37,32
1658084564725,MATH 18,B02,083749,Rideout; David Porter,5,0,36,31
1658084564725,MATH 18,B03,083750,Rideout; David Porter,3,0,37,34
1658084564725,MATH 18,B04,083751,Rideout; David Porter,7,0,36,29
1658084564725,MATH 18,B05,093473,Rideout; David Porter,7,0,36,29
1658084564725,MATH 18,B06,093474,Rideout; David Porter,6,0,36,30
1658084570750,MATH 20A,A01,083754,Zheng; Zequn,14,0,40,26
1658084576779,MATH 20B,A01,083756,Briones; Jor-el Thomas Caparas,4,0,36,32
1658084576779,MATH 20B,A02,083757,Briones; Jor-el Thomas Caparas,1,0,36,35
1658084576779,MATH 20B,A03,093475,Briones; Jor-el Thomas Caparas,3,0,36,33
1658084582803,MATH 20C,A01,083760,Briones; Jor-el Thomas Caparas,1,0,35,34
1658084582803,MATH 20C,A02,083761,Briones; Jor-el Thomas Caparas,8,0,35,27
1658084582803,MATH 20C,A03,093476,Briones; Jor-el Thomas Caparas,0,1,36,36
1658084582803,MATH 20C,B01,083762,Bach; Quang Tran,1,0,30,29
1658084588827,MATH 20D,A01,083765,Tran; Brian Kha,5,0,30,25
1658084588827,MATH 20D,A02,083766,Tran; Brian Kha,5,0,30,25
1658084588827,MATH 20D,A03,083767,Tran; Brian Kha,6,0,30,24
1658084594857,MATH 20E,A01,083771,Ganguly; Soumya,12,0,32,20
1658084594857,MATH 20E,A02,083772,Ganguly; Soumya,7,0,32,25
1658084594857,MATH 20E,B01,083773,Ciotti; Benjamin,20,0,35,15
1658084594857,MATH 20E,B02,083774,Ciotti; Benjamin,18,0,35,17
1658084600888,MATH 103A,A01,083777,Greenfeld; Be'Eri,6,0,36,30
1658084600888,MATH 103A,A02,083778,Greenfeld; Be'Eri,5,0,36,31
1658084600888,MATH 103A,A03,093561,Greenfeld; Be'Eri,7,0,36,29
1658084600888,MATH 103A,B01,083779,Greenfeld; Be'Eri,8,0,36,28
1658084600888,MATH 103A,B02,083780,Greenfeld; Be'Eri,4,0,36,32
1658084600888,MATH 103A,B03,093562,Greenfeld; Be'Eri,3,0,36,33
1658084606912,MATH 105,A01,085443,Carter; Anne Toulson,15,0,35,20
1658084606912,MATH 105,A02,093477,Carter; Anne Toulson,20,0,35,15
1658084612936,MATH 109,A01,083213,Ganzberger; Geoffrey Michael,3,0,34,31
1658084612936,MATH 109,A02,083214,Ganzberger; Geoffrey Michael,4,0,34,30
1658084612936,MATH 109,A03,093478,Ganzberger; Geoffrey Michael,2,0,34,32
1658084612936,MATH 109,B01,083215,Ganzberger; Geoffrey Michael,3,0,32,29
1658084612936,MATH 109,B02,083216,Ganzberger; Geoffrey Michael,3,0,32,29
1658084612936,MATH 109,B03,093479,Ganzberger; Geoffrey Michael,8,0,32,24
1658084618960,MATH 142A,A01,083219,Chow; Bennett,7,0,32,25
1658084618960,MATH 142A,A02,083220,Chow; Bennett,10,0,32,22
1658084618960,MATH 142A,A03,093480,Chow; Bennett,9,0,32,23
1658084618960,MATH 142A,B03,093481,Chow; Bennett,8,0,32,24
1658084618960,MATH 142A,B04,093558,Chow; Bennett,14,0,32,18
1658084618960,MATH 142A,B05,093559,Chow; Bennett,7,0,32,25
1658084624988,MATH 193A,A01,083224,Rotar; Vladimir,9,0,34,25
1658084624988,MATH 193A,A02,083225,Rotar; Vladimir,11,0,34,23
1658084624988,MATH 193A,A03,083781,Rotar; Vladimir,5,0,34,29
1658084624988,MATH 193A,A04,083782,Rotar; Vladimir,12,0,34,22
1658084624988,MATH 193A,A05,093482,Rotar; Vladimir,11,0,34,23
1658084631012,MATH 197,001,091859,McAuley; Julian John,9999,0,9999,0
1658084631012,MATH 197,002,095566,Kedlaya; Kiran S.,9997,0,9999,2
1658084631012,MATH 197,003,095567,Xiao; Ming,9999,0,9999,0
1658084631012,MATH 197,004,095571,Perols; Johan Lars,9998,0,9999,1
1658084638080,COGS 9,A01,083615,Shannon; Kyle Michael,11,0,75,64
1658084644107,COGS 11,A01,083617,Boyle; Mary E. T.,23,0,48,25
1658084650130,COGS 13,A01,083071,Bastos; Amalia Pinkusfeld,12,0,71,59
1658084656159,COGS 14A,A01,092681,Semenuks; Arturs,5,1,100,95
1658084662187,COGS 14B,A01,083073,Cheng; Tzu-Han,7,0,63,56
1658084668213,COGS 17,A01,092677,Semenuks; Arturs,7,0,81,74
1658084674237,COGS 100,A01,083619,Allen; Michael Gordon,17,0,70,53
1658084680339,COGS 101A,A01,083621,Davis; Joshua Daniel,9,0,68,59
1658084686361,COGS 101B,A01,091572,Allen; Michael Gordon,14,0,65,51
1658084692387,COGS 101C,A01,083625,Delgado; Tania,17,0,35,18
1658084698410,COGS 107A,A01,083627,Boyle; Mary E. T.,14,0,60,46
1658084704432,COGS 118A,A01,083075,Gupta; Anjum,21,0,76,55
1658084710461,CSE 3,A50,083646,Miranda; Gregory Joseph,24,0,50,26
1658084716494,CSE 8A,A50,083650,Miranda; Gregory Joseph,17,1,56,39
1658084722519,CSE 11,A01,083080,Cao; Yingjun,7,15,40,33
1658084728552,CSE 12,A01,083652,Krause-Levy; Sophia Louisa,30,1,120,90
1658084734577,CSE 15L,A01,083654,Morris; Justin Loren,9,0,50,41
1658084734577,CSE 15L,A02,083655,Morris; Justin Loren,11,0,50,39
1658084740605,CSE 20,A01,083657,Tran; Khoa Dang,39,0,80,41
1658084746643,CSE 21,A01,095574,Bach; Quang Tran,23,0,48,25
1658084752665,CSE 30,A01,083084,Eldon; John,8,0,80,72
1658084752665,CSE 30,B01,095061,Bhaskar; Nishant,9,0,50,41
1658084758693,CSE 100,A01,083659,Cao; Yingjun,5,4,70,65
1658084764723,CSE 134B,A01,083661,Powell; Thomas Allan,25,0,100,75
1658084770748,CSE 140,A01,083663,Gungor; Onat,17,0,85,68
1658084776775,CSE 140L,A01,083088,Eldon; John,23,0,100,77
1658084782799,CSE 175,A01,083665,Kumar; Rakesh,3,0,25,22
1658084788825,CSE 190,A00,092507,Dubnov; Shlomo,8,0,20,12
1658084794846,ECE 45,A01,083139,Congero; Spencer William,7,0,75,68
1658084800873,ECE 65,A50,083695,Saad; Andrew S,12,0,30,18
1658084800873,ECE 65,A51,095125,Saad; Andrew S,24,0,26,2
1658084806898,ECE 109,A01,091882,Touri; Behrouz,21,0,70,49
1658084812926,ECE 180,A00,083140,Abi Samra; Nicholas Camill,1,0,30,29
1658084812926,ECE 180,B00,083141,Abi Samra; Nicholas Camill,0,0,30,30
1658084818949,MATH 10A,A01,083735,Patchell; Gregory David,2,0,30,28
1658084818949,MATH 10A,A02,083736,Patchell; Gregory David,20,0,30,10
1658084818949,MATH 10A,A03,083737,Patchell; Gregory David,16,0,30,14
1658084824977,MATH 10B,A01,083207,Lim; Seonhee,9,0,34,25
1658084824977,MATH 10B,A02,083208,Lim; Seonhee,10,0,35,25
1658084824977,MATH 10B,A03,093472,Lim; Seonhee,7,0,34,27
1658084824977,MATH 10B,B01,083739,Sinha; Shubham,14,0,30,16
1658084831009,MATH 18,A01,083743,Cinel; Cameron Alexander,9,0,30,21
1658084831009,MATH 18,A02,083744,Cinel; Cameron Alexander,18,0,30,12
1658084831009,MATH 18,A03,083745,Cinel; Cameron Alexander,10,0,30,20
1658084831009,MATH 18,B01,083748,Rideout; David Porter,5,0,37,32
1658084831009,MATH 18,B02,083749,Rideout; David Porter,5,0,36,31
1658084831009,MATH 18,B03,083750,Rideout; David Porter,3,0,37,34
1658084831009,MATH 18,B04,083751,Rideout; David Porter,7,0,36,29
1658084831009,MATH 18,B05,093473,Rideout; David Porter,7,0,36,29
1658084831009,MATH 18,B06,093474,Rideout; David Porter,6,0,36,30
1658084837035,MATH 20A,A01,083754,Zheng; Zequn,14,0,40,26
1658084843057,MATH 20B,A01,083756,Briones; Jor-el Thomas Caparas,4,0,36,32
1658084843057,MATH 20B,A02,083757,Briones; Jor-el Thomas Caparas,1,0,36,35
1658084843057,MATH 20B,A03,093475,Briones; Jor-el Thomas Caparas,3,0,36,33
1658084849092,MATH 20C,A01,083760,Briones; Jor-el Thomas Caparas,1,0,35,34
1658084849092,MATH 20C,A02,083761,Briones; Jor-el Thomas Caparas,8,0,35,27
1658084849092,MATH 20C,A03,093476,Briones; Jor-el Thomas Caparas,0,1,36,36
1658084849092,MATH 20C,B01,083762,Bach; Quang Tran,1,0,30,29
1658084855124,MATH 20D,A01,083765,Tran; Brian Kha,5,0,30,25
1658084855124,MATH 20D,A02,083766,Tran; Brian Kha,5,0,30,25
1658084855124,MATH 20D,A03,083767,Tran; Brian Kha,6,0,30,24
1658084861153,MATH 20E,A01,083771,Ganguly; Soumya,12,0,32,20
1658084861153,MATH 20E,A02,083772,Ganguly; Soumya,7,0,32,25
1658084861153,MATH 20E,B01,083773,Ciotti; Benjamin,20,0,35,15
1658084861153,MATH 20E,B02,083774,Ciotti; Benjamin,18,0,35,17
1658084867184,MATH 103A,A01,083777,Greenfeld; Be'Eri,6,0,36,30
1658084867184,MATH 103A,A02,083778,Greenfeld; Be'Eri,5,0,36,31
1658084867184,MATH 103A,A03,093561,Greenfeld; Be'Eri,7,0,36,29
1658084867184,MATH 103A,B01,083779,Greenfeld; Be'Eri,8,0,36,28
1658084867184,MATH 103A,B02,083780,Greenfeld; Be'Eri,4,0,36,32
1658084867184,MATH 103A,B03,093562,Greenfeld; Be'Eri,3,0,36,33
1658084873213,MATH 105,A01,085443,Carter; Anne Toulson,15,0,35,20
1658084873213,MATH 105,A02,093477,Carter; Anne Toulson,20,0,35,15
1658084879237,MATH 109,A01,083213,Ganzberger; Geoffrey Michael,3,0,34,31
1658084879237,MATH 109,A02,083214,Ganzberger; Geoffrey Michael,4,0,34,30
1658084879237,MATH 109,A03,093478,Ganzberger; Geoffrey Michael,2,0,34,32
1658084879237,MATH 109,B01,083215,Ganzberger; Geoffrey Michael,3,0,32,29
1658084879237,MATH 109,B02,083216,Ganzberger; Geoffrey Michael,3,0,32,29
1658084879237,MATH 109,B03,093479,Ganzberger; Geoffrey Michael,8,0,32,24
1658084885266,MATH 142A,A01,083219,Chow; Bennett,7,0,32,25
1658084885266,MATH 142A,A02,083220,Chow; Bennett,10,0,32,22
1658084885266,MATH 142A,A03,093480,Chow; Bennett,9,0,32,23
1658084885266,MATH 142A,B03,093481,Chow; Bennett,8,0,32,24
1658084885266,MATH 142A,B04,093558,Chow; Bennett,14,0,32,18
1658084885266,MATH 142A,B05,093559,Chow; Bennett,7,0,32,25
1658084891296,MATH 193A,A01,083224,Rotar; Vladimir,9,0,34,25
1658084891296,MATH 193A,A02,083225,Rotar; Vladimir,11,0,34,23
1658084891296,MATH 193A,A03,083781,Rotar; Vladimir,5,0,34,29
1658084891296,MATH 193A,A04,083782,Rotar; Vladimir,12,0,34,22
1658084891296,MATH 193A,A05,093482,Rotar; Vladimir,11,0,34,23
1658084897324,MATH 197,001,091859,McAuley; Julian John,9999,0,9999,0
1658084897324,MATH 197,002,095566,Kedlaya; Kiran S.,9997,0,9999,2
1658084897324,MATH 197,003,095567,Xiao; Ming,9999,0,9999,0
1658084897324,MATH 197,004,095571,Perols; Johan Lars,9998,0,9999,1
1658084904388,COGS 9,A01,083615,Shannon; Kyle Michael,11,0,75,64
1658084910412,COGS 11,A01,083617,Boyle; Mary E. T.,23,0,48,25
1658084916435,COGS 13,A01,083071,Bastos; Amalia Pinkusfeld,12,0,71,59
1658084922458,COGS 14A,A01,092681,Semenuks; Arturs,5,1,100,95
1658084928481,COGS 14B,A01,083073,Cheng; Tzu-Han,7,0,63,56
1658084934508,COGS 17,A01,092677,Semenuks; Arturs,7,0,81,74
1658084940532,COGS 100,A01,083619,Allen; Michael Gordon,17,0,70,53
1658084946560,COGS 101A,A01,083621,Davis; Joshua Daniel,9,0,68,59
1658084952583,COGS 101B,A01,091572,Allen; Michael Gordon,14,0,65,51
1658084958609,COGS 101C,A01,083625,Delgado; Tania,17,0,35,18
1658084964633,COGS 107A,A01,083627,Boyle; Mary E. T.,14,0,60,46
1658084970659,COGS 118A,A01,083075,Gupta; Anjum,21,0,76,55
1658084976683,CSE 3,A50,083646,Miranda; Gregory Joseph,24,0,50,26
1658084982712,CSE 8A,A50,083650,Miranda; Gregory Joseph,17,1,56,39
1658084988740,CSE 11,A01,083080,Cao; Yingjun,7,15,40,33
1658084994767,CSE 12,A01,083652,Krause-Levy; Sophia Louisa,30,1,120,90
1658085000790,CSE 15L,A01,083654,Morris; Justin Loren,9,0,50,41
1658085000790,CSE 15L,A02,083655,Morris; Justin Loren,11,0,50,39
1658085006817,CSE 20,A01,083657,Tran; Khoa Dang,39,0,80,41
1658085012845,CSE 21,A01,095574,Bach; Quang Tran,23,0,48,25
1658085018873,CSE 30,A01,083084,Eldon; John,8,0,80,72
1658085018873,CSE 30,B01,095061,Bhaskar; Nishant,9,0,50,41
1658085024898,CSE 100,A01,083659,Cao; Yingjun,5,4,70,65
1658085030924,CSE 134B,A01,083661,Powell; Thomas Allan,25,0,100,75
1658085036962,CSE 140,A01,083663,Gungor; Onat,17,0,85,68
1658085042989,CSE 140L,A01,083088,Eldon; John,23,0,100,77
1658085049015,CSE 175,A01,083665,Kumar; Rakesh,3,0,25,22
1658085055114,CSE 190,A00,092507,Dubnov; Shlomo,8,0,20,12
1658085061152,ECE 45,A01,083139,Congero; Spencer William,7,0,75,68
1658085067179,ECE 65,A50,083695,Saad; Andrew S,12,0,30,18
1658085067179,ECE 65,A51,095125,Saad; Andrew S,24,0,26,2
1658085073203,ECE 109,A01,091882,Touri; Behrouz,21,0,70,49
1658085079229,ECE 180,A00,083140,Abi Samra; Nicholas Camill,1,0,30,29
1658085079229,ECE 180,B00,083141,Abi Samra; Nicholas Camill,0,0,30,30
1658085085253,MATH 10A,A01,083735,Patchell; Gregory David,2,0,30,28
1658085085253,MATH 10A,A02,083736,Patchell; Gregory David,20,0,30,10
1658085085253,MATH 10A,A03,083737,Patchell; Gregory David,16,0,30,14
1658085091277,MATH 10B,A01,083207,Lim; Seonhee,9,0,34,25
1658085091277,MATH 10B,A02,083208,Lim; Seonhee,10,0,35,25
1658085091277,MATH 10B,A03,093472,Lim; Seonhee,7,0,34,27
1658085091277,MATH 10B,B01,083739,Sinha; Shubham,14,0,30,16
1658085097304,MATH 18,A01,083743,Cinel; Cameron Alexander,9,0,30,21
1658085097304,MATH 18,A02,083744,Cinel; Cameron Alexander,18,0,30,12
1658085097304,MATH 18,A03,083745,Cinel; Cameron Alexander,10,0,30,20
1658085097304,MATH 18,B01,083748,Rideout; David Porter,5,0,37,32
1658085097304,MATH 18,B02,083749,Rideout; David Porter,5,0,36,31
1658085097304,MATH 18,B03,083750,Rideout; David Porter,3,0,37,34
1658085097304,MATH 18,B04,083751,Rideout; David Porter,7,0,36,29
1658085097304,MATH 18,B05,093473,Rideout; David Porter,7,0,36,29
1658085097304,MATH 18,B06,093474,Rideout; David Porter,6,0,36,30
1658085103328,MATH 20A,A01,083754,Zheng; Zequn,14,0,40,26
1658085109355,MATH 20B,A01,083756,Briones; Jor-el Thomas Caparas,4,0,36,32
1658085109355,MATH 20B,A02,083757,Briones; Jor-el Thomas Caparas,1,0,36,35
1658085109355,MATH 20B,A03,093475,Briones; Jor-el Thomas Caparas,3,0,36,33
1658085115379,MATH 20C,A01,083760,Briones; Jor-el Thomas Caparas,1,0,35,34
1658085115379,MATH 20C,A02,083761,Briones; Jor-el Thomas Caparas,8,0,35,27
1658085115379,MATH 20C,A03,093476,Briones; Jor-el Thomas Caparas,0,1,36,36
1658085115379,MATH 20C,B01,083762,Bach; Quang Tran,1,0,30,29
1658085121410,MATH 20D,A01,083765,Tran; Brian Kha,5,0,30,25
1658085121410,MATH 20D,A02,083766,Tran; Brian Kha,5,0,30,25
1658085121410,MATH 20D,A03,083767,Tran; Brian Kha,6,0,30,24
1658085127434,MATH 20E,A01,083771,Ganguly; Soumya,12,0,32,20
1658085127434,MATH 20E,A02,083772,Ganguly; Soumya,7,0,32,25
1658085127434,MATH 20E,B01,083773,Ciotti; Benjamin,20,0,35,15
1658085127434,MATH 20E,B02,083774,Ciotti; Benjamin,18,0,35,17
1658085133465,MATH 103A,A01,083777,Greenfeld; Be'Eri,6,0,36,30
1658085133465,MATH 103A,A02,083778,Greenfeld; Be'Eri,5,0,36,31
1658085133465,MATH 103A,A03,093561,Greenfeld; Be'Eri,7,0,36,29
1658085133465,MATH 103A,B01,083779,Greenfeld; Be'Eri,8,0,36,28
1658085133465,MATH 103A,B02,083780,Greenfeld; Be'Eri,4,0,36,32
1658085133465,MATH 103A,B03,093562,Greenfeld; Be'Eri,3,0,36,33
1658085139488,MATH 105,A01,085443,Carter; Anne Toulson,15,0,35,20
1658085139488,MATH 105,A02,093477,Carter; Anne Toulson,20,0,35,15
1658085145519,MATH 109,A01,083213,Ganzberger; Geoffrey Michael,3,0,34,31
1658085145519,MATH 109,A02,083214,Ganzberger; Geoffrey Michael,4,0,34,30
1658085145519,MATH 109,A03,093478,Ganzberger; Geoffrey Michael,2,0,34,32
1658085145519,MATH 109,B01,083215,Ganzberger; Geoffrey Michael,3,0,32,29
1658085145519,MATH 109,B02,083216,Ganzberger; Geoffrey Michael,3,0,32,29
1658085145519,MATH 109,B03,093479,Ganzberger; Geoffrey Michael,8,0,32,24
1658085151541,MATH 142A,A01,083219,Chow; Bennett,7,0,32,25
1658085151541,MATH 142A,A02,083220,Chow; Bennett,10,0,32,22
1658085151541,MATH 142A,A03,093480,Chow; Bennett,9,0,32,23
1658085151541,MATH 142A,B03,093481,Chow; Bennett,8,0,32,24
1658085151541,MATH 142A,B04,093558,Chow; Bennett,14,0,32,18
1658085151541,MATH 142A,B05,093559,Chow; Bennett,7,0,32,25
1658085157566,MATH 193A,A01,083224,Rotar; Vladimir,9,0,34,25
1658085157566,MATH 193A,A02,083225,Rotar; Vladimir,11,0,34,23
1658085157566,MATH 193A,A03,083781,Rotar; Vladimir,5,0,34,29
1658085157566,MATH 193A,A04,083782,Rotar; Vladimir,12,0,34,22
1658085157566,MATH 193A,A05,093482,Rotar; Vladimir,11,0,34,23
1658085163589,MATH 197,001,091859,McAuley; Julian John,9999,0,9999,0
1658085163589,MATH 197,002,095566,Kedlaya; Kiran S.,9997,0,9999,2
1658085163589,MATH 197,003,095567,Xiao; Ming,9999,0,9999,0
1658085163589,MATH 197,004,095571,Perols; Johan Lars,9998,0,9999,1
1658085170642,COGS 9,A01,083615,Shannon; Kyle Michael,11,0,75,64
1658085176667,COGS 11,A01,083617,Boyle; Mary E. T.,23,0,48,25
1658085182693,COGS 13,A01,083071,Bastos; Amalia Pinkusfeld,12,0,71,59
1658085188719,COGS 14A,A01,092681,Semenuks; Arturs,5,1,100,95
1658085194743,COGS 14B,A01,083073,Cheng; Tzu-Han,7,0,63,56
1658085200765,COGS 17,A01,092677,Semenuks; Arturs,7,0,81,74
1658085206792,COGS 100,A01,083619,Allen; Michael Gordon,17,0,70,53
1658085212815,COGS 101A,A01,083621,Davis; Joshua Daniel,9,0,68,59
1658085218842,COGS 101B,A01,091572,Allen; Michael Gordon,14,0,65,51
1658085224868,COGS 101C,A01,083625,Delgado; Tania,17,0,35,18
1658085230892,COGS 107A,A01,083627,Boyle; Mary E. T.,14,0,60,46
1658085236916,COGS 118A,A01,083075,Gupta; Anjum,21,0,76,55
1658085242941,CSE 3,A50,083646,Miranda; Gregory Joseph,24,0,50,26
1658085248965,CSE 8A,A50,083650,Miranda; Gregory Joseph,17,1,56,39
1658085254988,CSE 11,A01,083080,Cao; Yingjun,7,15,40,33
1658085261014,CSE 12,A01,083652,Krause-Levy; Sophia Louisa,30,1,120,90
1658085267041,CSE 15L,A01,083654,Morris; Justin Loren,9,0,50,41
1658085267041,CSE 15L,A02,083655,Morris; Justin Loren,11,0,50,39
1658085273072,CSE 20,A01,083657,Tran; Khoa Dang,39,0,80,41
1658085279169,CSE 21,A01,095574,Bach; Quang Tran,23,0,48,25
1658085285197,CSE 30,A01,083084,Eldon; John,8,0,80,72
1658085285197,CSE 30,B01,095061,Bhaskar; Nishant,9,0,50,41
1658085291226,CSE 100,A01,083659,Cao; Yingjun,5,4,70,65
1658085297250,CSE 134B,A01,083661,Powell; Thomas Allan,25,0,100,75
1658085303281,CSE 140,A01,083663,Gungor; Onat,17,0,85,68
1658085309306,CSE 140L,A01,083088,Eldon; John,23,0,100,77
1658085315333,CSE 175,A01,083665,Kumar; Rakesh,3,0,25,22
1658085321356,CSE 190,A00,092507,Dubnov; Shlomo,8,0,20,12
1658085327383,ECE 45,A01,083139,Congero; Spencer William,7,0,75,68
1658085333410,ECE 65,A50,083695,Saad; Andrew S,12,0,30,18
1658085333410,ECE 65,A51,095125,Saad; Andrew S,24,0,26,2
1658085339437,ECE 109,A01,091882,Touri; Behrouz,21,0,70,49
1658085345460,ECE 180,A00,083140,Abi Samra; Nicholas Camill,1,0,30,29
1658085345460,ECE 180,B00,083141,Abi Samra; Nicholas Camill,0,0,30,30
1658085351488,MATH 10A,A01,083735,Patchell; Gregory David,2,0,30,28
1658085351488,MATH 10A,A02,083736,Patchell; Gregory David,20,0,30,10
1658085351488,MATH 10A,A03,083737,Patchell; Gregory David,16,0,30,14
1658085357546,MATH 10B,A01,083207,Lim; Seonhee,9,0,34,25
1658085357546,MATH 10B,A02,083208,Lim; Seonhee,10,0,35,25
1658085357546,MATH 10B,A03,093472,Lim; Seonhee,7,0,34,27
1658085357546,MATH 10B,B01,083739,Sinha; Shubham,14,0,30,16
1658085363584,MATH 18,A01,083743,Cinel; Cameron Alexander,9,0,30,21
1658085363584,MATH 18,A02,083744,Cinel; Cameron Alexander,18,0,30,12
1658085363584,MATH 18,A03,083745,Cinel; Cameron Alexander,10,0,30,20
1658085363584,MATH 18,B01,083748,Rideout; David Porter,5,0,37,32
1658085363584,MATH 18,B02,083749,Rideout; David Porter,5,0,36,31
1658085363584,MATH 18,B03,083750,Rideout; David Porter,3,0,37,34
1658085363584,MATH 18,B04,083751,Rideout; David Porter,7,0,36,29
1658085363584,MATH 18,B05,093473,Rideout; David Porter,7,0,36,29
1658085363584,MATH 18,B06,093474,Rideout; David Porter,6,0,36,30
1658085369607,MATH 20A,A01,083754,Zheng; Zequn,14,0,40,26
1658085375630,MATH 20B,A01,083756,Briones; Jor-el Thomas Caparas,4,0,36,32
1658085375630,MATH 20B,A02,083757,Briones; Jor-el Thomas Caparas,1,0,36,35
1658085375630,MATH 20B,A03,093475,Briones; Jor-el Thomas Caparas,3,0,36,33
1658085381658,MATH 20C,A01,083760,Briones; Jor-el Thomas Caparas,1,0,35,34
1658085381658,MATH 20C,A02,083761,Briones; Jor-el Thomas Caparas,8,0,35,27
1658085381658,MATH 20C,A03,093476,Briones; Jor-el Thomas Caparas,0,1,36,36
1658085381658,MATH 20C,B01,083762,Bach; Quang Tran,1,0,30,29
1658085387688,MATH 20D,A01,083765,Tran; Brian Kha,5,0,30,25
1658085387688,MATH 20D,A02,083766,Tran; Brian Kha,5,0,30,25
1658085387688,MATH 20D,A03,083767,Tran; Brian Kha,6,0,30,24
1658085393711,MATH 20E,A01,083771,Ganguly; Soumya,12,0,32,20
1658085393711,MATH 20E,A02,083772,Ganguly; Soumya,7,0,32,25
1658085393711,MATH 20E,B01,083773,Ciotti; Benjamin,20,0,35,15
1658085393711,MATH 20E,B02,083774,Ciotti; Benjamin,18,0,35,17
1658085399743,MATH 103A,A01,083777,Greenfeld; Be'Eri,6,0,36,30
1658085399743,MATH 103A,A02,083778,Greenfeld; Be'Eri,5,0,36,31
1658085399743,MATH 103A,A03,093561,Greenfeld; Be'Eri,7,0,36,29
1658085399743,MATH 103A,B01,083779,Greenfeld; Be'Eri,8,0,36,28
1658085399743,MATH 103A,B02,083780,Greenfeld; Be'Eri,4,0,36,32
1658085399743,MATH 103A,B03,093562,Greenfeld; Be'Eri,3,0,36,33
1658085405767,MATH 105,A01,085443,Carter; Anne Toulson,15,0,35,20
1658085405767,MATH 105,A02,093477,Carter; Anne Toulson,20,0,35,15
1658085411795,MATH 109,A01,083213,Ganzberger; Geoffrey Michael,3,0,34,31
1658085411795,MATH 109,A02,083214,Ganzberger; Geoffrey Michael,4,0,34,30
1658085411795,MATH 109,A03,093478,Ganzberger; Geoffrey Michael,2,0,34,32
1658085411795,MATH 109,B01,083215,Ganzberger; Geoffrey Michael,3,0,32,29
1658085411795,MATH 109,B02,083216,Ganzberger; Geoffrey Michael,3,0,32,29
1658085411795,MATH 109,B03,093479,Ganzberger; Geoffrey Michael,8,0,32,24
1658085417819,MATH 142A,A01,083219,Chow; Bennett,7,0,32,25
1658085417819,MATH 142A,A02,083220,Chow; Bennett,10,0,32,22
1658085417819,MATH 142A,A03,093480,Chow; Bennett,9,0,32,23
1658085417819,MATH 142A,B03,093481,Chow; Bennett,8,0,32,24
1658085417819,MATH 142A,B04,093558,Chow; Bennett,14,0,32,18
1658085417819,MATH 142A,B05,093559,Chow; Bennett,7,0,32,25
1658085423859,MATH 193A,A01,083224,Rotar; Vladimir,9,0,34,25
1658085423859,MATH 193A,A02,083225,Rotar; Vladimir,11,0,34,23
1658085423859,MATH 193A,A03,083781,Rotar; Vladimir,5,0,34,29
1658085423859,MATH 193A,A04,083782,Rotar; Vladimir,12,0,34,22
1658085423859,MATH 193A,A05,093482,Rotar; Vladimir,11,0,34,23
1658085429881,MATH 197,001,091859,McAuley; Julian John,9999,0,9999,0
1658085429881,MATH 197,002,095566,Kedlaya; Kiran S.,9997,0,9999,2
1658085429881,MATH 197,003,095567,Xiao; Ming,9999,0,9999,0
1658085429881,MATH 197,004,095571,Perols; Johan Lars,9998,0,9999,1
1658085436944,COGS 9,A01,083615,Shannon; Kyle Michael,11,0,75,64
1658085442967,COGS 11,A01,083617,Boyle; Mary E. T.,23,0,48,25
1658085448992,COGS 13,A01,083071,Bastos; Amalia Pinkusfeld,12,0,71,59
1658085455019,COGS 14A,A01,092681,Semenuks; Arturs,5,1,100,95
1658085461045,COGS 14B,A01,083073,Cheng; Tzu-Han,7,0,63,56
1658085467068,COGS 17,A01,092677,Semenuks; Arturs,7,0,81,74
1658085473102,COGS 100,A01,083619,Allen; Michael Gordon,17,0,70,53
1658085479125,COGS 101A,A01,083621,Davis; Joshua Daniel,9,0,68,59
1658085485151,COGS 101B,A01,091572,Allen; Michael Gordon,14,0,65,51
1658085491175,COGS 101C,A01,083625,Delgado; Tania,17,0,35,18
1658085497200,COGS 107A,A01,083627,Boyle; Mary E. T.,14,0,60,46
1658085503224,COGS 118A,A01,083075,Gupta; Anjum,21,0,76,55
1658085509251,CSE 3,A50,083646,Miranda; Gregory Joseph,24,0,50,26
1658085515274,CSE 8A,A50,083650,Miranda; Gregory Joseph,17,1,56,39
1658085521316,CSE 11,A01,083080,Cao; Yingjun,7,15,40,33
1658085527339,CSE 12,A01,083652,Krause-Levy; Sophia Louisa,30,1,120,90
1658085533364,CSE 15L,A01,083654,Morris; Justin Loren,9,0,50,41
1658085533364,CSE 15L,A02,083655,Morris; Justin Loren,11,0,50,39
1658085539387,CSE 20,A01,083657,Tran; Khoa Dang,39,0,80,41
1658085545411,CSE 21,A01,095574,Bach; Quang Tran,23,0,48,25
1658085551441,CSE 30,A01,083084,Eldon; John,8,0,80,72
1658085551441,CSE 30,B01,095061,Bhaskar; Nishant,9,0,50,41
1658085557465,CSE 100,A01,083659,Cao; Yingjun,5,4,70,65
1658085563493,CSE 134B,A01,083661,Powell; Thomas Allan,25,0,100,75
1658085569527,CSE 140,A01,083663,Gungor; Onat,17,0,85,68
1658085575551,CSE 140L,A01,083088,Eldon; John,23,0,100,77
1658085581574,CSE 175,A01,083665,Kumar; Rakesh,3,0,25,22
1658085587597,CSE 190,A00,092507,Dubnov; Shlomo,8,0,20,12
1658085593621,ECE 45,A01,083139,Congero; Spencer William,7,0,75,68
1658085599644,ECE 65,A50,083695,Saad; Andrew S,12,0,30,18
1658085599644,ECE 65,A51,095125,Saad; Andrew S,24,0,26,2
1658085605671,ECE 109,A01,091882,Touri; Behrouz,21,0,70,49
1658085611699,ECE 180,A00,083140,Abi Samra; Nicholas Camill,1,0,30,29
1658085611699,ECE 180,B00,083141,Abi Samra; Nicholas Camill,0,0,30,30
1658085617729,MATH 10A,A01,083735,Patchell; Gregory David,2,0,30,28
1658085617729,MATH 10A,A02,083736,Patchell; Gregory David,20,0,30,10
1658085617729,MATH 10A,A03,083737,Patchell; Gregory David,16,0,30,14
1658085623753,MATH 10B,A01,083207,Lim; Seonhee,9,0,34,25
1658085623753,MATH 10B,A02,083208,Lim; Seonhee,10,0,35,25
1658085623753,MATH 10B,A03,093472,Lim; Seonhee,7,0,34,27
1658085623753,MATH 10B,B01,083739,Sinha; Shubham,14,0,30,16
1658085629778,MATH 18,A01,083743,Cinel; Cameron Alexander,9,0,30,21
1658085629778,MATH 18,A02,083744,Cinel; Cameron Alexander,18,0,30,12
1658085629778,MATH 18,A03,083745,Cinel; Cameron Alexander,10,0,30,20
1658085629778,MATH 18,B01,083748,Rideout; David Porter,5,0,37,32
1658085629778,MATH 18,B02,083749,Rideout; David Porter,5,0,36,31
1658085629778,MATH 18,B03,083750,Rideout; David Porter,3,0,37,34
1658085629778,MATH 18,B04,083751,Rideout; David Porter,7,0,36,29
1658085629778,MATH 18,B05,093473,Rideout; David Porter,7,0,36,29
1658085629778,MATH 18,B06,093474,Rideout; David Porter,6,0,36,30
1658085635801,MATH 20A,A01,083754,Zheng; Zequn,14,0,40,26
1658085641823,MATH 20B,A01,083756,Briones; Jor-el Thomas Caparas,4,0,36,32
1658085641823,MATH 20B,A02,083757,Briones; Jor-el Thomas Caparas,1,0,36,35
1658085641823,MATH 20B,A03,093475,Briones; Jor-el Thomas Caparas,3,0,36,33
1658085647847,MATH 20C,A01,083760,Briones; Jor-el Thomas Caparas,1,0,35,34
1658085647847,MATH 20C,A02,083761,Briones; Jor-el Thomas Caparas,8,0,35,27
1658085647847,MATH 20C,A03,093476,Briones; Jor-el Thomas Caparas,0,1,36,36
1658085647847,MATH 20C,B01,083762,Bach; Quang Tran,1,0,30,29
1658085653870,MATH 20D,A01,083765,Tran; Brian Kha,5,0,30,25
1658085653870,MATH 20D,A02,083766,Tran; Brian Kha,5,0,30,25
1658085653870,MATH 20D,A03,083767,Tran; Brian Kha,6,0,30,24
1658085659894,MATH 20E,A01,083771,Ganguly; Soumya,12,0,32,20
1658085659894,MATH 20E,A02,083772,Ganguly; Soumya,7,0,32,25
1658085659894,MATH 20E,B01,083773,Ciotti; Benjamin,20,0,35,15
1658085659894,MATH 20E,B02,083774,Ciotti; Benjamin,18,0,35,17
1658085665915,MATH 103A,A01,083777,Greenfeld; Be'Eri,6,0,36,30
1658085665915,MATH 103A,A02,083778,Greenfeld; Be'Eri,5,0,36,31
1658085665915,MATH 103A,A03,093561,Greenfeld; Be'Eri,7,0,36,29
1658085665915,MATH 103A,B01,083779,Greenfeld; Be'Eri,8,0,36,28
1658085665915,MATH 103A,B02,083780,Greenfeld; Be'Eri,4,0,36,32
1658085665915,MATH 103A,B03,093562,Greenfeld; Be'Eri,3,0,36,33
1658085671939,MATH 105,A01,085443,Carter; Anne Toulson,15,0,35,20
1658085671939,MATH 105,A02,093477,Carter; Anne Toulson,20,0,35,15
1658085677968,MATH 109,A01,083213,Ganzberger; Geoffrey Michael,3,0,34,31
1658085677968,MATH 109,A02,083214,Ganzberger; Geoffrey Michael,4,0,34,30
1658085677968,MATH 109,A03,093478,Ganzberger; Geoffrey Michael,2,0,34,32
1658085677968,MATH 109,B01,083215,Ganzberger; Geoffrey Michael,3,0,32,29
1658085677968,MATH 109,B02,083216,Ganzberger; Geoffrey Michael,3,0,32,29
1658085677968,MATH 109,B03,093479,Ganzberger; Geoffrey Michael,8,0,32,24
1658085684000,MATH 142A,A01,083219,Chow; Bennett,7,0,32,25
1658085684000,MATH 142A,A02,083220,Chow; Bennett,10,0,32,22
1658085684000,MATH 142A,A03,093480,Chow; Bennett,9,0,32,23
1658085684000,MATH 142A,B03,093481,Chow; Bennett,8,0,32,24
1658085684000,MATH 142A,B04,093558,Chow; Bennett,14,0,32,18
1658085684000,MATH 142A,B05,093559,Chow; Bennett,7,0,32,25
1658085690024,MATH 193A,A01,083224,Rotar; Vladimir,9,0,34,25
1658085690024,MATH 193A,A02,083225,Rotar; Vladimir,11,0,34,23
1658085690024,MATH 193A,A03,083781,Rotar; Vladimir,5,0,34,29
1658085690024,MATH 193A,A04,083782,Rotar; Vladimir,12,0,34,22
1658085690024,MATH 193A,A05,093482,Rotar; Vladimir,11,0,34,23
1658085696048,MATH 197,001,091859,McAuley; Julian John,9999,0,9999,0
1658085696048,MATH 197,002,095566,Kedlaya; Kiran S.,9997,0,9999,2
1658085696048,MATH 197,003,095567,Xiao; Ming,9999,0,9999,0
1658085696048,MATH 197,004,095571,Perols; Johan Lars,9998,0,9999,1
1658085703103,COGS 9,A01,083615,Shannon; Kyle Michael,11,0,75,64
1658085709129,COGS 11,A01,083617,Boyle; Mary E. T.,23,0,48,25
1658085715161,COGS 13,A01,083071,Bastos; Amalia Pinkusfeld,12,0,71,59
1658085721189,COGS 14A,A01,092681,Semenuks; Arturs,5,1,100,95
1658085727216,COGS 14B,A01,083073,Cheng; Tzu-Han,7,0,63,56
1658085733249,COGS 17,A01,092677,Semenuks; Arturs,7,0,81,74
1658085739276,COGS 100,A01,083619,Allen; Michael Gordon,17,0,70,53
1658085745299,COGS 101A,A01,083621,Davis; Joshua Daniel,9,0,68,59
1658085751321,COGS 101B,A01,091572,Allen; Michael Gordon,14,0,65,51
1658085757344,COGS 101C,A01,083625,Delgado; Tania,17,0,35,18
1658085763372,COGS 107A,A01,083627,Boyle; Mary E. T.,14,0,60,46
1658085769396,COGS 118A,A01,083075,Gupta; Anjum,21,0,76,55
1658085775420,CSE 3,A50,083646,Miranda; Gregory Joseph,24,0,50,26
1658085781453,CSE 8A,A50,083650,Miranda; Gregory Joseph,17,1,56,39
1658085787486,CSE 11,A01,083080,Cao; Yingjun,7,15,40,33
1658085793509,CSE 12,A01,083652,Krause-Levy; Sophia Louisa,30,1,120,90
1658085799542,CSE 15L,A01,083654,Morris; Justin Loren,9,0,50,41
1658085799542,CSE 15L,A02,083655,Morris; Justin Loren,11,0,50,39
1658085805564,CSE 20,A01,083657,Tran; Khoa Dang,39,0,80,41
1658085811587,CSE 21,A01,095574,Bach; Quang Tran,23,0,48,25
1658085817616,CSE 30,A01,083084,Eldon; John,8,0,80,72
1658085817616,CSE 30,B01,095061,Bhaskar; Nishant,9,0,50,41
1658085823643,CSE 100,A01,083659,Cao; Yingjun,5,4,70,65
1658085829667,CSE 134B,A01,083661,Powell; Thomas Allan,25,0,100,75
1658085835694,CSE 140,A01,083663,Gungor; Onat,17,0,85,68
1658085841724,CSE 140L,A01,083088,Eldon; John,23,0,100,77
1658085847750,CSE 175,A01,083665,Kumar; Rakesh,3,0,25,22
1658085853773,CSE 190,A00,092507,Dubnov; Shlomo,8,0,20,12
1658085859794,ECE 45,A01,083139,Congero; Spencer William,7,0,75,68
1658085865823,ECE 65,A50,083695,Saad; Andrew S,12,0,30,18
1658085865823,ECE 65,A51,095125,Saad; Andrew S,24,0,26,2
1658085871845,ECE 109,A01,091882,Touri; Behrouz,21,0,70,49
1658085877944,ECE 180,A00,083140,Abi Samra; Nicholas Camill,1,0,30,29
1658085877944,ECE 180,B00,083141,Abi Samra; Nicholas Camill,0,0,30,30
1658085883968,MATH 10A,A01,083735,Patchell; Gregory David,2,0,30,28
1658085883968,MATH 10A,A02,083736,Patchell; Gregory David,20,0,30,10
1658085883968,MATH 10A,A03,083737,Patchell; Gregory David,16,0,30,14
1658085889997,MATH 10B,A01,083207,Lim; Seonhee,9,0,34,25
1658085889997,MATH 10B,A02,083208,Lim; Seonhee,10,0,35,25
1658085889997,MATH 10B,A03,093472,Lim; Seonhee,7,0,34,27
1658085889997,MATH 10B,B01,083739,Sinha; Shubham,14,0,30,16
1658085896024,MATH 18,A01,083743,Cinel; Cameron Alexander,9,0,30,21
1658085896024,MATH 18,A02,083744,Cinel; Cameron Alexander,18,0,30,12
1658085896024,MATH 18,A03,083745,Cinel; Cameron Alexander,10,0,30,20
1658085896024,MATH 18,B01,083748,Rideout; David Porter,5,0,37,32
1658085896024,MATH 18,B02,083749,Rideout; David Porter,5,0,36,31
1658085896024,MATH 18,B03,083750,Rideout; David Porter,3,0,37,34
1658085896024,MATH 18,B04,083751,Rideout; David Porter,7,0,36,29
1658085896024,MATH 18,B05,093473,Rideout; David Porter,7,0,36,29
1658085896024,MATH 18,B06,093474,Rideout; David Porter,6,0,36,30
1658085902051,MATH 20A,A01,083754,Zheng; Zequn,14,0,40,26
1658085908079,MATH 20B,A01,083756,Briones; Jor-el Thomas Caparas,4,0,36,32
1658085908079,MATH 20B,A02,083757,Briones; Jor-el Thomas Caparas,1,0,36,35
1658085908079,MATH 20B,A03,093475,Briones; Jor-el Thomas Caparas,3,0,36,33
1658085914111,MATH 20C,A01,083760,Briones; Jor-el Thomas Caparas,1,0,35,34
1658085914111,MATH 20C,A02,083761,Briones; Jor-el Thomas Caparas,8,0,35,27
1658085914111,MATH 20C,A03,093476,Briones; Jor-el Thomas Caparas,0,1,36,36
1658085914111,MATH 20C,B01,083762,Bach; Quang Tran,1,0,30,29
1658085920143,MATH 20D,A01,083765,Tran; Brian Kha,5,0,30,25
1658085920143,MATH 20D,A02,083766,Tran; Brian Kha,5,0,30,25
1658085920143,MATH 20D,A03,083767,Tran; Brian Kha,6,0,30,24
1658085926172,MATH 20E,A01,083771,Ganguly; Soumya,12,0,32,20
1658085926172,MATH 20E,A02,083772,Ganguly; Soumya,7,0,32,25
1658085926172,MATH 20E,B01,083773,Ciotti; Benjamin,20,0,35,15
1658085926172,MATH 20E,B02,083774,Ciotti; Benjamin,18,0,35,17
1658085932196,MATH 103A,A01,083777,Greenfeld; Be'Eri,6,0,36,30
1658085932196,MATH 103A,A02,083778,Greenfeld; Be'Eri,5,0,36,31
1658085932196,MATH 103A,A03,093561,Greenfeld; Be'Eri,7,0,36,29
1658085932196,MATH 103A,B01,083779,Greenfeld; Be'Eri,8,0,36,28
1658085932196,MATH 103A,B02,083780,Greenfeld; Be'Eri,4,0,36,32
1658085932196,MATH 103A,B03,093562,Greenfeld; Be'Eri,3,0,36,33
1658085938221,MATH 105,A01,085443,Carter; Anne Toulson,15,0,35,20
1658085938221,MATH 105,A02,093477,Carter; Anne Toulson,20,0,35,15
1658085944257,MATH 109,A01,083213,Ganzberger; Geoffrey Michael,3,0,34,31
1658085944257,MATH 109,A02,083214,Ganzberger; Geoffrey Michael,4,0,34,30
1658085944257,MATH 109,A03,093478,Ganzberger; Geoffrey Michael,2,0,34,32
1658085944257,MATH 109,B01,083215,Ganzberger; Geoffrey Michael,3,0,32,29
1658085944257,MATH 109,B02,083216,Ganzberger; Geoffrey Michael,3,0,32,29
1658085944257,MATH 109,B03,093479,Ganzberger; Geoffrey Michael,8,0,32,24
1658085950287,MATH 142A,A01,083219,Chow; Bennett,7,0,32,25
1658085950287,MATH 142A,A02,083220,Chow; Bennett,10,0,32,22
1658085950287,MATH 142A,A03,093480,Chow; Bennett,9,0,32,23
1658085950287,MATH 142A,B03,093481,Chow; Bennett,8,0,32,24
1658085950287,MATH 142A,B04,093558,Chow; Bennett,14,0,32,18
1658085950287,MATH 142A,B05,093559,Chow; Bennett,7,0,32,25
1658085956312,MATH 193A,A01,083224,Rotar; Vladimir,9,0,34,25
1658085956312,MATH 193A,A02,083225,Rotar; Vladimir,11,0,34,23
1658085956312,MATH 193A,A03,083781,Rotar; Vladimir,5,0,34,29
1658085956312,MATH 193A,A04,083782,Rotar; Vladimir,12,0,34,22
1658085956312,MATH 193A,A05,093482,Rotar; Vladimir,11,0,34,23
1658085962336,MATH 197,001,091859,McAuley; Julian John,9999,0,9999,0
1658085962336,MATH 197,002,095566,Kedlaya; Kiran S.,9997,0,9999,2
1658085962336,MATH 197,003,095567,Xiao; Ming,9999,0,9999,0
1658085962336,MATH 197,004,095571,Perols; Johan Lars,9998,0,9999,1
1658085969402,COGS 9,A01,083615,Shannon; Kyle Michael,11,0,75,64
1658085975428,COGS 11,A01,083617,Boyle; Mary E. T.,23,0,48,25
1658085981451,COGS 13,A01,083071,Bastos; Amalia Pinkusfeld,12,0,71,59
1658085987477,COGS 14A,A01,092681,Semenuks; Arturs,5,1,100,95
1658085993505,COGS 14B,A01,083073,Cheng; Tzu-Han,7,0,63,56
1658085999536,COGS 17,A01,092677,Semenuks; Arturs,7,0,81,74
1658086005559,COGS 100,A01,083619,Allen; Michael Gordon,17,0,70,53
1658086011582,COGS 101A,A01,083621,Davis; Joshua Daniel,9,0,68,59
1658086017606,COGS 101B,A01,091572,Allen; Michael Gordon,14,0,65,51
1658086023633,COGS 101C,A01,083625,Delgado; Tania,17,0,35,18
1658086029656,COGS 107A,A01,083627,Boyle; Mary E. T.,14,0,60,46
1658086035681,COGS 118A,A01,083075,Gupta; Anjum,21,0,76,55
1658086041709,CSE 3,A50,083646,Miranda; Gregory Joseph,24,0,50,26
1658086047734,CSE 8A,A50,083650,Miranda; Gregory Joseph,17,1,56,39
1658086053761,CSE 11,A01,083080,Cao; Yingjun,7,15,40,33
1658086059784,CSE 12,A01,083652,Krause-Levy; Sophia Louisa,30,1,120,90
1658086065811,CSE 15L,A01,083654,Morris; Justin Loren,9,0,50,41
1658086065811,CSE 15L,A02,083655,Morris; Justin Loren,11,0,50,39
1658086071838,CSE 20,A01,083657,Tran; Khoa Dang,39,0,80,41
1658086077862,CSE 21,A01,095574,Bach; Quang Tran,23,0,48,25
1658086083886,CSE 30,A01,083084,Eldon; John,8,0,80,72
1658086083886,CSE 30,B01,095061,Bhaskar; Nishant,9,0,50,41
1658086089909,CSE 100,A01,083659,Cao; Yingjun,5,4,70,65
1658086095933,CSE 134B,A01,083661,Powell; Thomas Allan,25,0,100,75
1658086101956,CSE 140,A01,083663,Gungor; Onat,17,0,85,68
1658086107980,CSE 140L,A01,083088,Eldon; John,23,0,100,77
1658086114004,CSE 175,A01,083665,Kumar; Rakesh,3,0,25,22
1658086120030,CSE 190,A00,092507,Dubnov; Shlomo,8,0,20,12
1658086126058,ECE 45,A01,083139,Congero; Spencer William,7,0,75,68
1658086132081,ECE 65,A50,083695,Saad; Andrew S,12,0,30,18
1658086132081,ECE 65,A51,095125,Saad; Andrew S,24,0,26,2
1658086138107,ECE 109,A01,091882,Touri; Behrouz,21,0,70,49
1658086144130,ECE 180,A00,083140,Abi Samra; Nicholas Camill,1,0,30,29
1658086144130,ECE 180,B00,083141,Abi Samra; Nicholas Camill,0,0,30,30
1658086150158,MATH 10A,A01,083735,Patchell; Gregory David,2,0,30,28
1658086150158,MATH 10A,A02,083736,Patchell; Gregory David,20,0,30,10
1658086150158,MATH 10A,A03,083737,Patchell; Gregory David,16,0,30,14
1658086156188,MATH 10B,A01,083207,Lim; Seonhee,9,0,34,25
1658086156188,MATH 10B,A02,083208,Lim; Seonhee,10,0,35,25
1658086156188,MATH 10B,A03,093472,Lim; Seonhee,7,0,34,27
1658086156188,MATH 10B,B01,083739,Sinha; Shubham,14,0,30,16
1658086162218,MATH 18,A01,083743,Cinel; Cameron Alexander,9,0,30,21
1658086162218,MATH 18,A02,083744,Cinel; Cameron Alexander,18,0,30,12
1658086162218,MATH 18,A03,083745,Cinel; Cameron Alexander,10,0,30,20
1658086162218,MATH 18,B01,083748,Rideout; David Porter,5,0,37,32
1658086162218,MATH 18,B02,083749,Rideout; David Porter,5,0,36,31
1658086162218,MATH 18,B03,083750,Rideout; David Porter,3,0,37,34
1658086162218,MATH 18,B04,083751,Rideout; David Porter,7,0,36,29
1658086162218,MATH 18,B05,093473,Rideout; David Porter,7,0,36,29
1658086162218,MATH 18,B06,093474,Rideout; David Porter,6,0,36,30
1658086168242,MATH 20A,A01,083754,Zheng; Zequn,14,0,40,26
1658086174269,MATH 20B,A01,083756,Briones; Jor-el Thomas Caparas,4,0,36,32
1658086174269,MATH 20B,A02,083757,Briones; Jor-el Thomas Caparas,1,0,36,35
1658086174269,MATH 20B,A03,093475,Briones; Jor-el Thomas Caparas,3,0,36,33
1658086180297,MATH 20C,A01,083760,Briones; Jor-el Thomas Caparas,1,0,35,34
1658086180297,MATH 20C,A02,083761,Briones; Jor-el Thomas Caparas,8,0,35,27
1658086180297,MATH 20C,A03,093476,Briones; Jor-el Thomas Caparas,0,1,36,36
1658086180297,MATH 20C,B01,083762,Bach; Quang Tran,1,0,30,29
1658086186324,MATH 20D,A01,083765,Tran; Brian Kha,5,0,30,25
1658086186324,MATH 20D,A02,083766,Tran; Brian Kha,5,0,30,25
1658086186324,MATH 20D,A03,083767,Tran; Brian Kha,6,0,30,24
1658086192348,MATH 20E,A01,083771,Ganguly; Soumya,12,0,32,20
1658086192348,MATH 20E,A02,083772,Ganguly; Soumya,7,0,32,25
1658086192348,MATH 20E,B01,083773,Ciotti; Benjamin,20,0,35,15
1658086192348,MATH 20E,B02,083774,Ciotti; Benjamin,18,0,35,17
1658086198377,MATH 103A,A01,083777,Greenfeld; Be'Eri,6,0,36,30
1658086198377,MATH 103A,A02,083778,Greenfeld; Be'Eri,5,0,36,31
1658086198377,MATH 103A,A03,093561,Greenfeld; Be'Eri,7,0,36,29
1658086198377,MATH 103A,B01,083779,Greenfeld; Be'Eri,8,0,36,28
1658086198377,MATH 103A,B02,083780,Greenfeld; Be'Eri,4,0,36,32
1658086198377,MATH 103A,B03,093562,Greenfeld; Be'Eri,3,0,36,33
1658086204406,MATH 105,A01,085443,Carter; Anne Toulson,15,0,35,20
1658086204406,MATH 105,A02,093477,Carter; Anne Toulson,20,0,35,15
1658086210433,MATH 109,A01,083213,Ganzberger; Geoffrey Michael,3,0,34,31
1658086210433,MATH 109,A02,083214,Ganzberger; Geoffrey Michael,4,0,34,30
1658086210433,MATH 109,A03,093478,Ganzberger; Geoffrey Michael,2,0,34,32
1658086210433,MATH 109,B01,083215,Ganzberger; Geoffrey Michael,3,0,32,29
1658086210433,MATH 109,B02,083216,Ganzberger; Geoffrey Michael,3,0,32,29
1658086210433,MATH 109,B03,093479,Ganzberger; Geoffrey Michael,8,0,32,24
1658086216464,MATH 142A,A01,083219,Chow; Bennett,7,0,32,25
1658086216464,MATH 142A,A02,083220,Chow; Bennett,10,0,32,22
1658086216464,MATH 142A,A03,093480,Chow; Bennett,9,0,32,23
1658086216464,MATH 142A,B03,093481,Chow; Bennett,8,0,32,24
1658086216464,MATH 142A,B04,093558,Chow; Bennett,14,0,32,18
1658086216464,MATH 142A,B05,093559,Chow; Bennett,7,0,32,25
1658086222488,MATH 193A,A01,083224,Rotar; Vladimir,9,0,34,25
1658086222488,MATH 193A,A02,083225,Rotar; Vladimir,11,0,34,23
1658086222488,MATH 193A,A03,083781,Rotar; Vladimir,5,0,34,29
1658086222488,MATH 193A,A04,083782,Rotar; Vladimir,12,0,34,22
1658086222488,MATH 193A,A05,093482,Rotar; Vladimir,11,0,34,23
1658086228512,MATH 197,001,091859,McAuley; Julian John,9999,0,9999,0
1658086228512,MATH 197,002,095566,Kedlaya; Kiran S.,9997,0,9999,2
1658086228512,MATH 197,003,095567,Xiao; Ming,9999,0,9999,0
1658086228512,MATH 197,004,095571,Perols; Johan Lars,9998,0,9999,1
1658086235562,COGS 9,A01,083615,Shannon; Kyle Michael,11,0,75,64
1658086241587,COGS 11,A01,083617,Boyle; Mary E. T.,23,0,48,25
1658086247610,COGS 13,A01,083071,Bastos; Amalia Pinkusfeld,12,0,71,59
1658086253633,COGS 14A,A01,092681,Semenuks; Arturs,5,1,100,95
1658086259660,COGS 14B,A01,083073,Cheng; Tzu-Han,7,0,63,56
1658086265683,COGS 17,A01,092677,Semenuks; Arturs,7,0,81,74
1658086278662,COGS 100,A01,083619,Allen; Michael Gordon,17,0,70,53
1658086284688,COGS 101A,A01,083621,Davis; Joshua Daniel,9,0,68,59
1658086290714,COGS 101B,A01,091572,Allen; Michael Gordon,14,0,65,51
1658086296742,COGS 101C,A01,083625,Delgado; Tania,17,0,35,18
1658086302765,COGS 107A,A01,083627,Boyle; Mary E. T.,14,0,60,46
1658086308789,COGS 118A,A01,083075,Gupta; Anjum,21,0,76,55
1658086314817,CSE 3,A50,083646,Miranda; Gregory Joseph,24,0,50,26
1658086320842,CSE 8A,A50,083650,Miranda; Gregory Joseph,17,1,56,39
1658086326870,CSE 11,A01,083080,Cao; Yingjun,7,15,40,33
1658086332895,CSE 12,A01,083652,Krause-Levy; Sophia Louisa,30,1,120,90
1658086338919,CSE 15L,A01,083654,Morris; Justin Loren,9,0,50,41
1658086338919,CSE 15L,A02,083655,Morris; Justin Loren,11,0,50,39
1658086344942,CSE 20,A01,083657,Tran; Khoa Dang,39,0,80,41
1658086350966,CSE 21,A01,095574,Bach; Quang Tran,23,0,48,25
1658086356991,CSE 30,A01,083084,Eldon; John,8,0,80,72
1658086356991,CSE 30,B01,095061,Bhaskar; Nishant,9,0,50,41
1658086363015,CSE 100,A01,083659,Cao; Yingjun,5,4,70,65
1658086369041,CSE 134B,A01,083661,Powell; Thomas Allan,25,0,100,75
1658086375064,CSE 140,A01,083663,Gungor; Onat,17,0,85,68
1658086381088,CSE 140L,A01,083088,Eldon; John,23,0,100,77
1658086387114,CSE 175,A01,083665,Kumar; Rakesh,3,0,25,22
1658086393144,CSE 190,A00,092507,Dubnov; Shlomo,8,0,20,12
1658086399168,ECE 45,A01,083139,Congero; Spencer William,7,0,75,68
1658086405192,ECE 65,A50,083695,Saad; Andrew S,12,0,30,18
1658086405192,ECE 65,A51,095125,Saad; Andrew S,24,0,26,2
1658086411216,ECE 109,A01,091882,Touri; Behrouz,21,0,70,49
1658086417243,ECE 180,A00,083140,Abi Samra; Nicholas Camill,1,0,30,29
1658086417243,ECE 180,B00,083141,Abi Samra; Nicholas Camill,0,0,30,30
1658086423272,MATH 10A,A01,083735,Patchell; Gregory David,2,0,30,28
1658086423272,MATH 10A,A02,083736,Patchell; Gregory David,20,0,30,10
1658086423272,MATH 10A,A03,083737,Patchell; Gregory David,16,0,30,14
1658086429300,MATH 10B,A01,083207,Lim; Seonhee,9,0,34,25
1658086429300,MATH 10B,A02,083208,Lim; Seonhee,10,0,35,25
1658086429300,MATH 10B,A03,093472,Lim; Seonhee,7,0,34,27
1658086429300,MATH 10B,B01,083739,Sinha; Shubham,14,0,30,16
1658086435325,MATH 18,A01,083743,Cinel; Cameron Alexander,9,0,30,21
1658086435325,MATH 18,A02,083744,Cinel; Cameron Alexander,18,0,30,12
1658086435325,MATH 18,A03,083745,Cinel; Cameron Alexander,10,0,30,20
1658086435325,MATH 18,B01,083748,Rideout; David Porter,5,0,37,32
1658086435325,MATH 18,B02,083749,Rideout; David Porter,5,0,36,31
1658086435325,MATH 18,B03,083750,Rideout; David Porter,3,0,37,34
1658086435325,MATH 18,B04,083751,Rideout; David Porter,7,0,36,29
1658086435325,MATH 18,B05,093473,Rideout; David Porter,7,0,36,29
1658086435325,MATH 18,B06,093474,Rideout; David Porter,6,0,36,30
1658086441357,MATH 20A,A01,083754,Zheng; Zequn,14,0,40,26
1658086447385,MATH 20B,A01,083756,Briones; Jor-el Thomas Caparas,4,0,36,32
1658086447385,MATH 20B,A02,083757,Briones; Jor-el Thomas Caparas,1,0,36,35
1658086447385,MATH 20B,A03,093475,Briones; Jor-el Thomas Caparas,3,0,36,33
1658086453409,MATH 20C,A01,083760,Briones; Jor-el Thomas Caparas,1,0,35,34
1658086453409,MATH 20C,A02,083761,Briones; Jor-el Thomas Caparas,8,0,35,27
1658086453409,MATH 20C,A03,093476,Briones; Jor-el Thomas Caparas,0,1,36,36
1658086453409,MATH 20C,B01,083762,Bach; Quang Tran,1,0,30,29
1658086459433,MATH 20D,A01,083765,Tran; Brian Kha,5,0,30,25
1658086459433,MATH 20D,A02,083766,Tran; Brian Kha,5,0,30,25
1658086459433,MATH 20D,A03,083767,Tran; Brian Kha,6,0,30,24
1658086465455,MATH 20E,A01,083771,Ganguly; Soumya,12,0,32,20
1658086465455,MATH 20E,A02,083772,Ganguly; Soumya,7,0,32,25
1658086465455,MATH 20E,B01,083773,Ciotti; Benjamin,20,0,35,15
1658086465455,MATH 20E,B02,083774,Ciotti; Benjamin,18,0,35,17
1658086471478,MATH 103A,A01,083777,Greenfeld; Be'Eri,6,0,36,30
1658086471478,MATH 103A,A02,083778,Greenfeld; Be'Eri,5,0,36,31
1658086471478,MATH 103A,A03,093561,Greenfeld; Be'Eri,7,0,36,29
1658086471478,MATH 103A,B01,083779,Greenfeld; Be'Eri,8,0,36,28
1658086471478,MATH 103A,B02,083780,Greenfeld; Be'Eri,4,0,36,32
1658086471478,MATH 103A,B03,093562,Greenfeld; Be'Eri,3,0,36,33
1658086477502,MATH 105,A01,085443,Carter; Anne Toulson,15,0,35,20
1658086477502,MATH 105,A02,093477,Carter; Anne Toulson,20,0,35,15
1658086483601,MATH 109,A01,083213,Ganzberger; Geoffrey Michael,3,0,34,31
1658086483601,MATH 109,A02,083214,Ganzberger; Geoffrey Michael,4,0,34,30
1658086483601,MATH 109,A03,093478,Ganzberger; Geoffrey Michael,2,0,34,32
1658086483601,MATH 109,B01,083215,Ganzberger; Geoffrey Michael,3,0,32,29
1658086483601,MATH 109,B02,083216,Ganzberger; Geoffrey Michael,3,0,32,29
1658086483601,MATH 109,B03,093479,Ganzberger; Geoffrey Michael,8,0,32,24
1658086489631,MATH 142A,A01,083219,Chow; Bennett,7,0,32,25
1658086489631,MATH 142A,A02,083220,Chow; Bennett,10,0,32,22
1658086489631,MATH 142A,A03,093480,Chow; Bennett,9,0,32,23
1658086489631,MATH 142A,B03,093481,Chow; Bennett,8,0,32,24
1658086489631,MATH 142A,B04,093558,Chow; Bennett,14,0,32,18
1658086489631,MATH 142A,B05,093559,Chow; Bennett,7,0,32,25
1658086495662,MATH 193A,A01,083224,Rotar; Vladimir,9,0,34,25
1658086495662,MATH 193A,A02,083225,Rotar; Vladimir,11,0,34,23
1658086495662,MATH 193A,A03,083781,Rotar; Vladimir,5,0,34,29
1658086495662,MATH 193A,A04,083782,Rotar; Vladimir,12,0,34,22
1658086495662,MATH 193A,A05,093482,Rotar; Vladimir,11,0,34,23
1658086501686,MATH 197,001,091859,McAuley; Julian John,9999,0,9999,0
1658086501686,MATH 197,002,095566,Kedlaya; Kiran S.,9997,0,9999,2
1658086501686,MATH 197,003,095567,Xiao; Ming,9999,0,9999,0
1658086501686,MATH 197,004,095571,Perols; Johan Lars,9998,0,9999,1
1658086508747,COGS 9,A01,083615,Shannon; Kyle Michael,11,0,75,64
1658086514783,COGS 11,A01,083617,Boyle; Mary E. T.,23,0,48,25
1658086520809,COGS 13,A01,083071,Bastos; Amalia Pinkusfeld,12,0,71,59
1658086526833,COGS 14A,A01,092681,Semenuks; Arturs,5,1,100,95
1658086532857,COGS 14B,A01,083073,Cheng; Tzu-Han,7,0,63,56
1658086538890,COGS 17,A01,092677,Semenuks; Arturs,7,0,81,74
1658086544914,COGS 100,A01,083619,Allen; Michael Gordon,17,0,70,53
1658086550941,COGS 101A,A01,083621,Davis; Joshua Daniel,9,0,68,59
1658086556967,COGS 101B,A01,091572,Allen; Michael Gordon,14,0,65,51
1658086562990,COGS 101C,A01,083625,Delgado; Tania,17,0,35,18
1658086569012,COGS 107A,A01,083627,Boyle; Mary E. T.,14,0,60,46
1658086575034,COGS 118A,A01,083075,Gupta; Anjum,21,0,76,55
1658086581064,CSE 3,A50,083646,Miranda; Gregory Joseph,24,0,50,26
1658086587091,CSE 8A,A50,083650,Miranda; Gregory Joseph,17,1,56,39
1658086593118,CSE 11,A01,083080,Cao; Yingjun,7,15,40,33
1658086599142,CSE 12,A01,083652,Krause-Levy; Sophia Louisa,30,1,120,90
1658086605169,CSE 15L,A01,083654,Morris; Justin Loren,9,0,50,41
1658086605169,CSE 15L,A02,083655,Morris; Justin Loren,11,0,50,39
1658086611195,CSE 20,A01,083657,Tran; Khoa Dang,39,0,80,41
1658086617222,CSE 21,A01,095574,Bach; Quang Tran,23,0,48,25
1658086623245,CSE 30,A01,083084,Eldon; John,8,0,80,72
1658086623245,CSE 30,B01,095061,Bhaskar; Nishant,9,0,50,41
1658086629269,CSE 100,A01,083659,Cao; Yingjun,5,4,70,65
1658086635297,CSE 134B,A01,083661,Powell; Thomas Allan,25,0,100,75
1658086641320,CSE 140,A01,083663,Gungor; Onat,17,0,85,68
1658086647344,CSE 140L,A01,083088,Eldon; John,23,0,100,77
1658086653366,CSE 175,A01,083665,Kumar; Rakesh,3,0,25,22
1658086659390,CSE 190,A00,092507,Dubnov; Shlomo,8,0,20,12
1658086665424,ECE 45,A01,083139,Congero; Spencer William,7,0,75,68
1658086671452,ECE 65,A50,083695,Saad; Andrew S,12,0,30,18
1658086671452,ECE 65,A51,095125,Saad; Andrew S,24,0,26,2
1658086677478,ECE 109,A01,091882,Touri; Behrouz,21,0,70,49
1658086683502,ECE 180,A00,083140,Abi Samra; Nicholas Camill,1,0,30,29
1658086683502,ECE 180,B00,083141,Abi Samra; Nicholas Camill,0,0,30,30
1658086689530,MATH 10A,A01,083735,Patchell; Gregory David,2,0,30,28
1658086689530,MATH 10A,A02,083736,Patchell; Gregory David,20,0,30,10
1658086689530,MATH 10A,A03,083737,Patchell; Gregory David,16,0,30,14
1658086695559,MATH 10B,A01,083207,Lim; Seonhee,9,0,34,25
1658086695559,MATH 10B,A02,083208,Lim; Seonhee,10,0,35,25
1658086695559,MATH 10B,A03,093472,Lim; Seonhee,7,0,34,27
1658086695559,MATH 10B,B01,083739,Sinha; Shubham,14,0,30,16
1658086701583,MATH 18,A01,083743,Cinel; Cameron Alexander,9,0,30,21
1658086701583,MATH 18,A02,083744,Cinel; Cameron Alexander,18,0,30,12
1658086701583,MATH 18,A03,083745,Cinel; Cameron Alexander,10,0,30,20
1658086701583,MATH 18,B01,083748,Rideout; David Porter,5,0,37,32
1658086701583,MATH 18,B02,083749,Rideout; David Porter,5,0,36,31
1658086701583,MATH 18,B03,083750,Rideout; David Porter,3,0,37,34
1658086701583,MATH 18,B04,083751,Rideout; David Porter,7,0,36,29
1658086701583,MATH 18,B05,093473,Rideout; David Porter,7,0,36,29
1658086701583,MATH 18,B06,093474,Rideout; David Porter,6,0,36,30
1658086707606,MATH 20A,A01,083754,Zheng; Zequn,14,0,40,26
1658086713635,MATH 20B,A01,083756,Briones; Jor-el Thomas Caparas,4,0,36,32
1658086713635,MATH 20B,A02,083757,Briones; Jor-el Thomas Caparas,1,0,36,35
1658086713635,MATH 20B,A03,093475,Briones; Jor-el Thomas Caparas,3,0,36,33
1658086719663,MATH 20C,A01,083760,Briones; Jor-el Thomas Caparas,1,0,35,34
1658086719663,MATH 20C,A02,083761,Briones; Jor-el Thomas Caparas,8,0,35,27
1658086719663,MATH 20C,A03,093476,Briones; Jor-el Thomas Caparas,0,1,36,36
1658086719663,MATH 20C,B01,083762,Bach; Quang Tran,1,0,30,29
1658086725701,MATH 20D,A01,083765,Tran; Brian Kha,5,0,30,25
1658086725701,MATH 20D,A02,083766,Tran; Brian Kha,5,0,30,25
1658086725701,MATH 20D,A03,083767,Tran; Brian Kha,6,0,30,24
1658086731725,MATH 20E,A01,083771,Ganguly; Soumya,12,0,32,20
1658086731725,MATH 20E,A02,083772,Ganguly; Soumya,7,0,32,25
1658086731725,MATH 20E,B01,083773,Ciotti; Benjamin,20,0,35,15
1658086731725,MATH 20E,B02,083774,Ciotti; Benjamin,18,0,35,17
1658086737749,MATH 103A,A01,083777,Greenfeld; Be'Eri,6,0,36,30
1658086737749,MATH 103A,A02,083778,Greenfeld; Be'Eri,5,0,36,31
1658086737749,MATH 103A,A03,093561,Greenfeld; Be'Eri,7,0,36,29
1658086737749,MATH 103A,B01,083779,Greenfeld; Be'Eri,8,0,36,28
1658086737749,MATH 103A,B02,083780,Greenfeld; Be'Eri,4,0,36,32
1658086737749,MATH 103A,B03,093562,Greenfeld; Be'Eri,3,0,36,33
1658086743776,MATH 105,A01,085443,Carter; Anne Toulson,15,0,35,20
1658086743776,MATH 105,A02,093477,Carter; Anne Toulson,20,0,35,15
1658086749804,MATH 109,A01,083213,Ganzberger; Geoffrey Michael,3,0,34,31
1658086749804,MATH 109,A02,083214,Ganzberger; Geoffrey Michael,4,0,34,30
1658086749804,MATH 109,A03,093478,Ganzberger; Geoffrey Michael,2,0,34,32
1658086749804,MATH 109,B01,083215,Ganzberger; Geoffrey Michael,3,0,32,29
1658086749804,MATH 109,B02,083216,Ganzberger; Geoffrey Michael,3,0,32,29
1658086749804,MATH 109,B03,093479,Ganzberger; Geoffrey Michael,8,0,32,24
1658086755836,MATH 142A,A01,083219,Chow; Bennett,7,0,32,25
1658086755836,MATH 142A,A02,083220,Chow; Bennett,10,0,32,22
1658086755836,MATH 142A,A03,093480,Chow; Bennett,9,0,32,23
1658086755836,MATH 142A,B03,093481,Chow; Bennett,8,0,32,24
1658086755836,MATH 142A,B04,093558,Chow; Bennett,14,0,32,18
1658086755836,MATH 142A,B05,093559,Chow; Bennett,7,0,32,25
1658086761864,MATH 193A,A01,083224,Rotar; Vladimir,9,0,34,25
1658086761864,MATH 193A,A02,083225,Rotar; Vladimir,11,0,34,23
1658086761864,MATH 193A,A03,083781,Rotar; Vladimir,5,0,34,29
1658086761864,MATH 193A,A04,083782,Rotar; Vladimir,12,0,34,22
1658086761864,MATH 193A,A05,093482,Rotar; Vladimir,11,0,34,23
1658086767890,MATH 197,001,091859,McAuley; Julian John,9999,0,9999,0
1658086767890,MATH 197,002,095566,Kedlaya; Kiran S.,9997,0,9999,2
1658086767890,MATH 197,003,095567,Xiao; Ming,9999,0,9999,0
1658086767890,MATH 197,004,095571,Perols; Johan Lars,9998,0,9999,1
1658086774948,COGS 9,A01,083615,Shannon; Kyle Michael,11,0,75,64
1658086780977,COGS 11,A01,083617,Boyle; Mary E. T.,23,0,48,25
1658086786998,COGS 13,A01,083071,Bastos; Amalia Pinkusfeld,12,0,71,59
1658086793020,COGS 14A,A01,092681,Semenuks; Arturs,5,1,100,95
1658086799043,COGS 14B,A01,083073,Cheng; Tzu-Han,7,0,63,56
1658086805075,COGS 17,A01,092677,Semenuks; Arturs,7,0,81,74
1658086811103,COGS 100,A01,083619,Allen; Michael Gordon,17,0,70,53
1658086817126,COGS 101A,A01,083621,Davis; Joshua Daniel,9,0,68,59
1658086823151,COGS 101B,A01,091572,Allen; Michael Gordon,14,0,65,51
1658086829174,COGS 101C,A01,083625,Delgado; Tania,17,0,35,18
1658086835197,COGS 107A,A01,083627,Boyle; Mary E. T.,14,0,60,46
1658086841221,COGS 118A,A01,083075,Gupta; Anjum,21,0,76,55
1658086847245,CSE 3,A50,083646,Miranda; Gregory Joseph,24,0,50,26
1658086853268,CSE 8A,A50,083650,Miranda; Gregory Joseph,17,1,56,39
1658086859294,CSE 11,A01,083080,Cao; Yingjun,7,15,40,33
1658086865321,CSE 12,A01,083652,Krause-Levy; Sophia Louisa,30,1,120,90
1658086871346,CSE 15L,A01,083654,Morris; Justin Loren,9,0,50,41
1658086871346,CSE 15L,A02,083655,Morris; Justin Loren,11,0,50,39
1658086877367,CSE 20,A01,083657,Tran; Khoa Dang,39,0,80,41
1658086883393,CSE 21,A01,095574,Bach; Quang Tran,23,0,48,25
1658086889417,CSE 30,A01,083084,Eldon; John,8,0,80,72
1658086889417,CSE 30,B01,095061,Bhaskar; Nishant,9,0,50,41
1658086895442,CSE 100,A01,083659,Cao; Yingjun,5,4,70,65
1658086901465,CSE 134B,A01,083661,Powell; Thomas Allan,25,0,100,75
1658086907495,CSE 140,A01,083663,Gungor; Onat,17,0,85,68
1658086913522,CSE 140L,A01,083088,Eldon; John,23,0,100,77
1658086919545,CSE 175,A01,083665,Kumar; Rakesh,3,0,25,22
1658086925578,CSE 190,A00,092507,Dubnov; Shlomo,8,0,20,12
1658086931600,ECE 45,A01,083139,Congero; Spencer William,7,0,75,68
1658086937625,ECE 65,A50,083695,Saad; Andrew S,12,0,30,18
1658086937625,ECE 65,A51,095125,Saad; Andrew S,24,0,26,2
1658086943648,ECE 109,A01,091882,Touri; Behrouz,21,0,70,49
1658086949674,ECE 180,A00,083140,Abi Samra; Nicholas Camill,1,0,30,29
1658086949674,ECE 180,B00,083141,Abi Samra; Nicholas Camill,0,0,30,30
1658086955697,MATH 10A,A01,083735,Patchell; Gregory David,2,0,30,28
1658086955697,MATH 10A,A02,083736,Patchell; Gregory David,20,0,30,10
1658086955697,MATH 10A,A03,083737,Patchell; Gregory David,16,0,30,14
1658086961726,MATH 10B,A01,083207,Lim; Seonhee,9,0,34,25
1658086961726,MATH 10B,A02,083208,Lim; Seonhee,10,0,35,25
1658086961726,MATH 10B,A03,093472,Lim; Seonhee,7,0,34,27
1658086961726,MATH 10B,B01,083739,Sinha; Shubham,14,0,30,16
1658086967757,MATH 18,A01,083743,Cinel; Cameron Alexander,9,0,30,21
1658086967757,MATH 18,A02,083744,Cinel; Cameron Alexander,18,0,30,12
1658086967757,MATH 18,A03,083745,Cinel; Cameron Alexander,10,0,30,20
1658086967757,MATH 18,B01,083748,Rideout; David Porter,5,0,37,32
1658086967757,MATH 18,B02,083749,Rideout; David Porter,5,0,36,31
1658086967757,MATH 18,B03,083750,Rideout; David Porter,3,0,37,34
1658086967757,MATH 18,B04,083751,Rideout; David Porter,7,0,36,29
1658086967757,MATH 18,B05,093473,Rideout; David Porter,7,0,36,29
1658086967757,MATH 18,B06,093474,Rideout; David Porter,6,0,36,30
1658086973779,MATH 20A,A01,083754,Zheng; Zequn,14,0,40,26
1658086979803,MATH 20B,A01,083756,Briones; Jor-el Thomas Caparas,4,0,36,32
1658086979803,MATH 20B,A02,083757,Briones; Jor-el Thomas Caparas,1,0,36,35
1658086979803,MATH 20B,A03,093475,Briones; Jor-el Thomas Caparas,3,0,36,33
1658086985829,MATH 20C,A01,083760,Briones; Jor-el Thomas Caparas,1,0,35,34
1658086985829,MATH 20C,A02,083761,Briones; Jor-el Thomas Caparas,8,0,35,27
1658086985829,MATH 20C,A03,093476,Briones; Jor-el Thomas Caparas,0,1,36,36
1658086985829,MATH 20C,B01,083762,Bach; Quang Tran,1,0,30,29
1658086991853,MATH 20D,A01,083765,Tran; Brian Kha,5,0,30,25
1658086991853,MATH 20D,A02,083766,Tran; Brian Kha,5,0,30,25
1658086991853,MATH 20D,A03,083767,Tran; Brian Kha,6,0,30,24
1658086997879,MATH 20E,A01,083771,Ganguly; Soumya,12,0,32,20
1658086997879,MATH 20E,A02,083772,Ganguly; Soumya,7,0,32,25
1658086997879,MATH 20E,B01,083773,Ciotti; Benjamin,20,0,35,15
1658086997879,MATH 20E,B02,083774,Ciotti; Benjamin,18,0,35,17
1658087003904,MATH 103A,A01,083777,Greenfeld; Be'Eri,6,0,36,30
1658087003904,MATH 103A,A02,083778,Greenfeld; Be'Eri,5,0,36,31
1658087003904,MATH 103A,A03,093561,Greenfeld; Be'Eri,7,0,36,29
1658087003904,MATH 103A,B01,083779,Greenfeld; Be'Eri,8,0,36,28
1658087003904,MATH 103A,B02,083780,Greenfeld; Be'Eri,4,0,36,32
1658087003904,MATH 103A,B03,093562,Greenfeld; Be'Eri,3,0,36,33
1658087009927,MATH 105,A01,085443,Carter; Anne Toulson,15,0,35,20
1658087009927,MATH 105,A02,093477,Carter; Anne Toulson,20,0,35,15
1658087015956,MATH 109,A01,083213,Ganzberger; Geoffrey Michael,3,0,34,31
1658087015956,MATH 109,A02,083214,Ganzberger; Geoffrey Michael,4,0,34,30
1658087015956,MATH 109,A03,093478,Ganzberger; Geoffrey Michael,2,0,34,32
1658087015956,MATH 109,B01,083215,Ganzberger; Geoffrey Michael,3,0,32,29
1658087015956,MATH 109,B02,083216,Ganzberger; Geoffrey Michael,3,0,32,29
1658087015956,MATH 109,B03,093479,Ganzberger; Geoffrey Michael,8,0,32,24
1658087021980,MATH 142A,A01,083219,Chow; Bennett,7,0,32,25
1658087021980,MATH 142A,A02,083220,Chow; Bennett,10,0,32,22
1658087021980,MATH 142A,A03,093480,Chow; Bennett,9,0,32,23
1658087021980,MATH 142A,B03,093481,Chow; Bennett,8,0,32,24
1658087021980,MATH 142A,B04,093558,Chow; Bennett,14,0,32,18
1658087021980,MATH 142A,B05,093559,Chow; Bennett,7,0,32,25
1658087028004,MATH 193A,A01,083224,Rotar; Vladimir,9,0,34,25
1658087028004,MATH 193A,A02,083225,Rotar; Vladimir,11,0,34,23
1658087028004,MATH 193A,A03,083781,Rotar; Vladimir,5,0,34,29
1658087028004,MATH 193A,A04,083782,Rotar; Vladimir,12,0,34,22
1658087028004,MATH 193A,A05,093482,Rotar; Vladimir,11,0,34,23
1658087034029,MATH 197,001,091859,McAuley; Julian John,9999,0,9999,0
1658087034029,MATH 197,002,095566,Kedlaya; Kiran S.,9997,0,9999,2
1658087034029,MATH 197,003,095567,Xiao; Ming,9999,0,9999,0
1658087034029,MATH 197,004,095571,Perols; Johan Lars,9998,0,9999,1
1658087041090,COGS 9,A01,083615,Shannon; Kyle Michael,11,0,75,64
1658087047117,COGS 11,A01,083617,Boyle; Mary E. T.,23,0,48,25
1658087053143,COGS 13,A01,083071,Bastos; Amalia Pinkusfeld,12,0,71,59
1658087059166,COGS 14A,A01,092681,Semenuks; Arturs,5,1,100,95
1658087065196,COGS 14B,A01,083073,Cheng; Tzu-Han,7,0,63,56
1658087071223,COGS 17,A01,092677,Semenuks; Arturs,7,0,81,74
1658087077317,COGS 100,A01,083619,Allen; Michael Gordon,17,0,70,53
1658087083343,COGS 101A,A01,083621,Davis; Joshua Daniel,9,0,68,59
1658087089366,COGS 101B,A01,091572,Allen; Michael Gordon,14,0,65,51
1658087095394,COGS 101C,A01,083625,Delgado; Tania,17,0,35,18
1658087101420,COGS 107A,A01,083627,Boyle; Mary E. T.,14,0,60,46
1658087107444,COGS 118A,A01,083075,Gupta; Anjum,21,0,76,55
1658087113473,CSE 3,A50,083646,Miranda; Gregory Joseph,24,0,50,26
1658087119500,CSE 8A,A50,083650,Miranda; Gregory Joseph,17,1,56,39
1658087125524,CSE 11,A01,083080,Cao; Yingjun,7,15,40,33
1658087131549,CSE 12,A01,083652,Krause-Levy; Sophia Louisa,30,1,120,90
1658087137575,CSE 15L,A01,083654,Morris; Justin Loren,9,0,50,41
1658087137575,CSE 15L,A02,083655,Morris; Justin Loren,11,0,50,39
1658087143604,CSE 20,A01,083657,Tran; Khoa Dang,39,0,80,41
1658087149633,CSE 21,A01,095574,Bach; Quang Tran,23,0,48,25
1658087155658,CSE 30,A01,083084,Eldon; John,8,0,80,72
1658087155658,CSE 30,B01,095061,Bhaskar; Nishant,9,0,50,41
1658087161680,CSE 100,A01,083659,Cao; Yingjun,5,4,70,65
1658087167701,CSE 134B,A01,083661,Powell; Thomas Allan,25,0,100,75
1658087173725,CSE 140,A01,083663,Gungor; Onat,17,0,85,68
1658087179749,CSE 140L,A01,083088,Eldon; John,23,0,100,77
1658087185773,CSE 175,A01,083665,Kumar; Rakesh,3,0,25,22
1658087191807,CSE 190,A00,092507,Dubnov; Shlomo,8,0,20,12
1658087197835,ECE 45,A01,083139,Congero; Spencer William,7,0,75,68
1658087203861,ECE 65,A50,083695,Saad; Andrew S,12,0,30,18
1658087203861,ECE 65,A51,095125,Saad; Andrew S,24,0,26,2
1658087209885,ECE 109,A01,091882,Touri; Behrouz,21,0,70,49
1658087215911,ECE 180,A00,083140,Abi Samra; Nicholas Camill,1,0,30,29
1658087215911,ECE 180,B00,083141,Abi Samra; Nicholas Camill,0,0,30,30
1658087221939,MATH 10A,A01,083735,Patchell; Gregory David,2,0,30,28
1658087221939,MATH 10A,A02,083736,Patchell; Gregory David,20,0,30,10
1658087221939,MATH 10A,A03,083737,Patchell; Gregory David,16,0,30,14
1658087227969,MATH 10B,A01,083207,Lim; Seonhee,9,0,34,25
1658087227969,MATH 10B,A02,083208,Lim; Seonhee,10,0,35,25
1658087227969,MATH 10B,A03,093472,Lim; Seonhee,7,0,34,27
1658087227969,MATH 10B,B01,083739,Sinha; Shubham,14,0,30,16
1658087233998,MATH 18,A01,083743,Cinel; Cameron Alexander,9,0,30,21
1658087233998,MATH 18,A02,083744,Cinel; Cameron Alexander,18,0,30,12
1658087233998,MATH 18,A03,083745,Cinel; Cameron Alexander,10,0,30,20
1658087233998,MATH 18,B01,083748,Rideout; David Porter,5,0,37,32
1658087233998,MATH 18,B02,083749,Rideout; David Porter,5,0,36,31
1658087233998,MATH 18,B03,083750,Rideout; David Porter,3,0,37,34
1658087233998,MATH 18,B04,083751,Rideout; David Porter,7,0,36,29
1658087233998,MATH 18,B05,093473,Rideout; David Porter,7,0,36,29
1658087233998,MATH 18,B06,093474,Rideout; David Porter,6,0,36,30
1658087240021,MATH 20A,A01,083754,Zheng; Zequn,14,0,40,26
1658087246044,MATH 20B,A01,083756,Briones; Jor-el Thomas Caparas,4,0,36,32
1658087246044,MATH 20B,A02,083757,Briones; Jor-el Thomas Caparas,1,0,36,35
1658087246044,MATH 20B,A03,093475,Briones; Jor-el Thomas Caparas,3,0,36,33
1658087252077,MATH 20C,A01,083760,Briones; Jor-el Thomas Caparas,1,0,35,34
1658087252077,MATH 20C,A02,083761,Briones; Jor-el Thomas Caparas,8,0,35,27
1658087252077,MATH 20C,A03,093476,Briones; Jor-el Thomas Caparas,0,1,36,36
1658087252077,MATH 20C,B01,083762,Bach; Quang Tran,1,0,30,29
1658087258103,MATH 20D,A01,083765,Tran; Brian Kha,5,0,30,25
1658087258103,MATH 20D,A02,083766,Tran; Brian Kha,5,0,30,25
1658087258103,MATH 20D,A03,083767,Tran; Brian Kha,6,0,30,24
1658087264133,MATH 20E,A01,083771,Ganguly; Soumya,12,0,32,20
1658087264133,MATH 20E,A02,083772,Ganguly; Soumya,7,0,32,25
1658087264133,MATH 20E,B01,083773,Ciotti; Benjamin,20,0,35,15
1658087264133,MATH 20E,B02,083774,Ciotti; Benjamin,18,0,35,17
1658087270161,MATH 103A,A01,083777,Greenfeld; Be'Eri,6,0,36,30
1658087270161,MATH 103A,A02,083778,Greenfeld; Be'Eri,5,0,36,31
1658087270161,MATH 103A,A03,093561,Greenfeld; Be'Eri,7,0,36,29
1658087270161,MATH 103A,B01,083779,Greenfeld; Be'Eri,8,0,36,28
1658087270161,MATH 103A,B02,083780,Greenfeld; Be'Eri,4,0,36,32
1658087270161,MATH 103A,B03,093562,Greenfeld; Be'Eri,3,0,36,33
1658087276186,MATH 105,A01,085443,Carter; Anne Toulson,15,0,35,20
1658087276186,MATH 105,A02,093477,Carter; Anne Toulson,20,0,35,15
1658087282210,MATH 109,A01,083213,Ganzberger; Geoffrey Michael,3,0,34,31
1658087282210,MATH 109,A02,083214,Ganzberger; Geoffrey Michael,4,0,34,30
1658087282210,MATH 109,A03,093478,Ganzberger; Geoffrey Michael,2,0,34,32
1658087282210,MATH 109,B01,083215,Ganzberger; Geoffrey Michael,3,0,32,29
1658087282210,MATH 109,B02,083216,Ganzberger; Geoffrey Michael,3,0,32,29
1658087282210,MATH 109,B03,093479,Ganzberger; Geoffrey Michael,8,0,32,24
1658087288241,MATH 142A,A01,083219,Chow; Bennett,7,0,32,25
1658087288241,MATH 142A,A02,083220,Chow; Bennett,10,0,32,22
1658087288241,MATH 142A,A03,093480,Chow; Bennett,9,0,32,23
1658087288241,MATH 142A,B03,093481,Chow; Bennett,8,0,32,24
1658087288241,MATH 142A,B04,093558,Chow; Bennett,14,0,32,18
1658087288241,MATH 142A,B05,093559,Chow; Bennett,7,0,32,25
1658087294264,MATH 193A,A01,083224,Rotar; Vladimir,9,0,34,25
1658087294264,MATH 193A,A02,083225,Rotar; Vladimir,11,0,34,23
1658087294264,MATH 193A,A03,083781,Rotar; Vladimir,5,0,34,29
1658087294264,MATH 193A,A04,083782,Rotar; Vladimir,12,0,34,22
1658087294264,MATH 193A,A05,093482,Rotar; Vladimir,11,0,34,23
1658087300288,MATH 197,001,091859,McAuley; Julian John,9999,0,9999,0
1658087300288,MATH 197,002,095566,Kedlaya; Kiran S.,9997,0,9999,2
1658087300288,MATH 197,003,095567,Xiao; Ming,9999,0,9999,0
1658087300288,MATH 197,004,095571,Perols; Johan Lars,9998,0,9999,1
1658087307351,COGS 9,A01,083615,Shannon; Kyle Michael,11,0,75,64
1658087313379,COGS 11,A01,083617,Boyle; Mary E. T.,23,0,48,25
1658087319404,COGS 13,A01,083071,Bastos; Amalia Pinkusfeld,12,0,71,59
1658087325435,COGS 14A,A01,092681,Semenuks; Arturs,5,1,100,95
1658087331462,COGS 14B,A01,083073,Cheng; Tzu-Han,7,0,63,56
1658087337489,COGS 17,A01,092677,Semenuks; Arturs,7,0,81,74
1658087343516,COGS 100,A01,083619,Allen; Michael Gordon,17,0,70,53
1658087349540,COGS 101A,A01,083621,Davis; Joshua Daniel,9,0,68,59
1658087355564,COGS 101B,A01,091572,Allen; Michael Gordon,14,0,65,51
1658087361588,COGS 101C,A01,083625,Delgado; Tania,17,0,35,18
1658087367619,COGS 107A,A01,083627,Boyle; Mary E. T.,14,0,60,46
1658087373646,COGS 118A,A01,083075,Gupta; Anjum,21,0,76,55
1658087379671,CSE 3,A50,083646,Miranda; Gregory Joseph,24,0,50,26
1658087385698,CSE 8A,A50,083650,Miranda; Gregory Joseph,17,1,56,39
1658087391722,CSE 11,A01,083080,Cao; Yingjun,7,15,40,33
1658087397747,CSE 12,A01,083652,Krause-Levy; Sophia Louisa,30,1,120,90
1658087403772,CSE 15L,A01,083654,Morris; Justin Loren,9,0,50,41
1658087403772,CSE 15L,A02,083655,Morris; Justin Loren,11,0,50,39
1658087409795,CSE 20,A01,083657,Tran; Khoa Dang,39,0,80,41
1658087415819,CSE 21,A01,095574,Bach; Quang Tran,23,0,48,25
1658087421847,CSE 30,A01,083084,Eldon; John,8,0,80,72
1658087421847,CSE 30,B01,095061,Bhaskar; Nishant,9,0,50,41
1658087427869,CSE 100,A01,083659,Cao; Yingjun,5,4,70,65
1658087433893,CSE 134B,A01,083661,Powell; Thomas Allan,25,0,100,75
1658087439917,CSE 140,A01,083663,Gungor; Onat,17,0,85,68
1658087445944,CSE 140L,A01,083088,Eldon; John,23,0,100,77
1658087451980,CSE 175,A01,083665,Kumar; Rakesh,3,0,25,22
1658087458008,CSE 190,A00,092507,Dubnov; Shlomo,8,0,20,12
1658087464038,ECE 45,A01,083139,Congero; Spencer William,7,0,75,68
1658087470066,ECE 65,A50,083695,Saad; Andrew S,12,0,30,18
1658087470066,ECE 65,A51,095125,Saad; Andrew S,24,0,26,2
1658087476090,ECE 109,A01,091882,Touri; Behrouz,21,0,70,49
1658087482114,ECE 180,A00,083140,Abi Samra; Nicholas Camill,1,0,30,29
1658087482114,ECE 180,B00,083141,Abi Samra; Nicholas Camill,0,0,30,30
1658087488138,MATH 10A,A01,083735,Patchell; Gregory David,2,0,30,28
1658087488138,MATH 10A,A02,083736,Patchell; Gregory David,20,0,30,10
1658087488138,MATH 10A,A03,083737,Patchell; Gregory David,16,0,30,14
1658087494168,MATH 10B,A01,083207,Lim; Seonhee,9,0,34,25
1658087494168,MATH 10B,A02,083208,Lim; Seonhee,10,0,35,25
1658087494168,MATH 10B,A03,093472,Lim; Seonhee,7,0,34,27
1658087494168,MATH 10B,B01,083739,Sinha; Shubham,14,0,30,16
1658087500194,MATH 18,A01,083743,Cinel; Cameron Alexander,9,0,30,21
1658087500194,MATH 18,A02,083744,Cinel; Cameron Alexander,18,0,30,12
1658087500194,MATH 18,A03,083745,Cinel; Cameron Alexander,10,0,30,20
1658087500194,MATH 18,B01,083748,Rideout; David Porter,5,0,37,32
1658087500194,MATH 18,B02,083749,Rideout; David Porter,5,0,36,31
1658087500194,MATH 18,B03,083750,Rideout; David Porter,3,0,37,34
1658087500194,MATH 18,B04,083751,Rideout; David Porter,7,0,36,29
1658087500194,MATH 18,B05,093473,Rideout; David Porter,7,0,36,29
1658087500194,MATH 18,B06,093474,Rideout; David Porter,6,0,36,30
1658087506218,MATH 20A,A01,083754,Zheng; Zequn,14,0,40,26
1658087512240,MATH 20B,A01,083756,Briones; Jor-el Thomas Caparas,4,0,36,32
1658087512240,MATH 20B,A02,083757,Briones; Jor-el Thomas Caparas,1,0,36,35
1658087512240,MATH 20B,A03,093475,Briones; Jor-el Thomas Caparas,3,0,36,33
1658087518269,MATH 20C,A01,083760,Briones; Jor-el Thomas Caparas,1,0,35,34
1658087518269,MATH 20C,A02,083761,Briones; Jor-el Thomas Caparas,8,0,35,27
1658087518269,MATH 20C,A03,093476,Briones; Jor-el Thomas Caparas,0,1,36,36
1658087518269,MATH 20C,B01,083762,Bach; Quang Tran,1,0,30,29
1658087524293,MATH 20D,A01,083765,Tran; Brian Kha,5,0,30,25
1658087524293,MATH 20D,A02,083766,Tran; Brian Kha,5,0,30,25
1658087524293,MATH 20D,A03,083767,Tran; Brian Kha,6,0,30,24
1658087530317,MATH 20E,A01,083771,Ganguly; Soumya,12,0,32,20
1658087530317,MATH 20E,A02,083772,Ganguly; Soumya,7,0,32,25
1658087530317,MATH 20E,B01,083773,Ciotti; Benjamin,20,0,35,15
1658087530317,MATH 20E,B02,083774,Ciotti; Benjamin,18,0,35,17
1658087536353,MATH 103A,A01,083777,Greenfeld; Be'Eri,6,0,36,30
1658087536353,MATH 103A,A02,083778,Greenfeld; Be'Eri,5,0,36,31
1658087536353,MATH 103A,A03,093561,Greenfeld; Be'Eri,7,0,36,29
1658087536353,MATH 103A,B01,083779,Greenfeld; Be'Eri,8,0,36,28
1658087536353,MATH 103A,B02,083780,Greenfeld; Be'Eri,4,0,36,32
1658087536353,MATH 103A,B03,093562,Greenfeld; Be'Eri,3,0,36,33
1658087542381,MATH 105,A01,085443,Carter; Anne Toulson,15,0,35,20
1658087542381,MATH 105,A02,093477,Carter; Anne Toulson,20,0,35,15
1658087548410,MATH 109,A01,083213,Ganzberger; Geoffrey Michael,3,0,34,31
1658087548410,MATH 109,A02,083214,Ganzberger; Geoffrey Michael,4,0,34,30
1658087548410,MATH 109,A03,093478,Ganzberger; Geoffrey Michael,2,0,34,32
1658087548410,MATH 109,B01,083215,Ganzberger; Geoffrey Michael,3,0,32,29
1658087548410,MATH 109,B02,083216,Ganzberger; Geoffrey Michael,3,0,32,29
1658087548410,MATH 109,B03,093479,Ganzberger; Geoffrey Michael,8,0,32,24
1658087554434,MATH 142A,A01,083219,Chow; Bennett,7,0,32,25
1658087554434,MATH 142A,A02,083220,Chow; Bennett,10,0,32,22
1658087554434,MATH 142A,A03,093480,Chow; Bennett,9,0,32,23
1658087554434,MATH 142A,B03,093481,Chow; Bennett,8,0,32,24
1658087554434,MATH 142A,B04,093558,Chow; Bennett,14,0,32,18
1658087554434,MATH 142A,B05,093559,Chow; Bennett,7,0,32,25
1658087560460,MATH 193A,A01,083224,Rotar; Vladimir,9,0,34,25
1658087560460,MATH 193A,A02,083225,Rotar; Vladimir,11,0,34,23
1658087560460,MATH 193A,A03,083781,Rotar; Vladimir,5,0,34,29
1658087560460,MATH 193A,A04,083782,Rotar; Vladimir,12,0,34,22
1658087560460,MATH 193A,A05,093482,Rotar; Vladimir,11,0,34,23
1658087566496,MATH 197,001,091859,McAuley; Julian John,9999,0,9999,0
1658087566496,MATH 197,002,095566,Kedlaya; Kiran S.,9997,0,9999,2
1658087566496,MATH 197,003,095567,Xiao; Ming,9999,0,9999,0
1658087566496,MATH 197,004,095571,Perols; Johan Lars,9998,0,9999,1
1658087573562,COGS 9,A01,083615,Shannon; Kyle Michael,11,0,75,64
1658087579588,COGS 11,A01,083617,Boyle; Mary E. T.,23,0,48,25
1658087585611,COGS 13,A01,083071,Bastos; Amalia Pinkusfeld,12,0,71,59
1658087591638,COGS 14A,A01,092681,Semenuks; Arturs,5,1,100,95
1658087597661,COGS 14B,A01,083073,Cheng; Tzu-Han,7,0,63,56
1658087603690,COGS 17,A01,092677,Semenuks; Arturs,7,0,81,74
1658087609715,COGS 100,A01,083619,Allen; Michael Gordon,17,0,70,53
1658087615743,COGS 101A,A01,083621,Davis; Joshua Daniel,9,0,68,59
1658087621767,COGS 101B,A01,091572,Allen; Michael Gordon,14,0,65,51
1658087627793,COGS 101C,A01,083625,Delgado; Tania,17,0,35,18
1658087633821,COGS 107A,A01,083627,Boyle; Mary E. T.,14,0,60,46
1658087639847,COGS 118A,A01,083075,Gupta; Anjum,21,0,76,55
1658087645872,CSE 3,A50,083646,Miranda; Gregory Joseph,24,0,50,26
1658087651899,CSE 8A,A50,083650,Miranda; Gregory Joseph,17,1,56,39
1658087657923,CSE 11,A01,083080,Cao; Yingjun,7,15,40,33
1658087663950,CSE 12,A01,083652,Krause-Levy; Sophia Louisa,30,1,120,90
1658087669974,CSE 15L,A01,083654,Morris; Justin Loren,9,0,50,41
1658087669974,CSE 15L,A02,083655,Morris; Justin Loren,11,0,50,39
1658087676079,CSE 20,A01,083657,Tran; Khoa Dang,39,0,80,41
1658087682106,CSE 21,A01,095574,Bach; Quang Tran,23,0,48,25
1658087688133,CSE 30,A01,083084,Eldon; John,8,0,80,72
1658087688133,CSE 30,B01,095061,Bhaskar; Nishant,9,0,50,41
1658087694159,CSE 100,A01,083659,Cao; Yingjun,5,4,70,65
1658087700185,CSE 134B,A01,083661,Powell; Thomas Allan,25,0,100,75
1658087706208,CSE 140,A01,083663,Gungor; Onat,17,0,85,68
1658087712234,CSE 140L,A01,083088,Eldon; John,23,0,100,77
1658087718262,CSE 175,A01,083665,Kumar; Rakesh,3,0,25,22
1658087724289,CSE 190,A00,092507,Dubnov; Shlomo,8,0,20,12
1658087730334,ECE 45,A01,083139,Congero; Spencer William,7,0,75,68
1658087736359,ECE 65,A50,083695,Saad; Andrew S,12,0,30,18
1658087736359,ECE 65,A51,095125,Saad; Andrew S,24,0,26,2
1658087742383,ECE 109,A01,091882,Touri; Behrouz,21,0,70,49
1658087748407,ECE 180,A00,083140,Abi Samra; Nicholas Camill,1,0,30,29
1658087748407,ECE 180,B00,083141,Abi Samra; Nicholas Camill,0,0,30,30
1658087754433,MATH 10A,A01,083735,Patchell; Gregory David,2,0,30,28
1658087754433,MATH 10A,A02,083736,Patchell; Gregory David,20,0,30,10
1658087754433,MATH 10A,A03,083737,Patchell; Gregory David,16,0,30,14
1658087760468,MATH 10B,A01,083207,Lim; Seonhee,9,0,34,25
1658087760468,MATH 10B,A02,083208,Lim; Seonhee,10,0,35,25
1658087760468,MATH 10B,A03,093472,Lim; Seonhee,7,0,34,27
1658087760468,MATH 10B,B01,083739,Sinha; Shubham,14,0,30,16
1658087766500,MATH 18,A01,083743,Cinel; Cameron Alexander,9,0,30,21
1658087766500,MATH 18,A02,083744,Cinel; Cameron Alexander,18,0,30,12
1658087766500,MATH 18,A03,083745,Cinel; Cameron Alexander,10,0,30,20
1658087766500,MATH 18,B01,083748,Rideout; David Porter,5,0,37,32
1658087766500,MATH 18,B02,083749,Rideout; David Porter,5,0,36,31
1658087766500,MATH 18,B03,083750,Rideout; David Porter,3,0,37,34
1658087766500,MATH 18,B04,083751,Rideout; David Porter,7,0,36,29
1658087766500,MATH 18,B05,093473,Rideout; David Porter,7,0,36,29
1658087766500,MATH 18,B06,093474,Rideout; David Porter,6,0,36,30
1658087772524,MATH 20A,A01,083754,Zheng; Zequn,14,0,40,26
1658087778548,MATH 20B,A01,083756,Briones; Jor-el Thomas Caparas,4,0,36,32
1658087778548,MATH 20B,A02,083757,Briones; Jor-el Thomas Caparas,1,0,36,35
1658087778548,MATH 20B,A03,093475,Briones; Jor-el Thomas Caparas,3,0,36,33
1658087784572,MATH 20C,A01,083760,Briones; Jor-el Thomas Caparas,1,0,35,34
1658087784572,MATH 20C,A02,083761,Briones; Jor-el Thomas Caparas,8,0,35,27
1658087784572,MATH 20C,A03,093476,Briones; Jor-el Thomas Caparas,0,1,36,36
1658087784572,MATH 20C,B01,083762,Bach; Quang Tran,1,0,30,29
1658087790596,MATH 20D,A01,083765,Tran; Brian Kha,5,0,30,25
1658087790596,MATH 20D,A02,083766,Tran; Brian Kha,5,0,30,25
1658087790596,MATH 20D,A03,083767,Tran; Brian Kha,6,0,30,24
1658087796628,MATH 20E,A01,083771,Ganguly; Soumya,12,0,32,20
1658087796628,MATH 20E,A02,083772,Ganguly; Soumya,7,0,32,25
1658087796628,MATH 20E,B01,083773,Ciotti; Benjamin,20,0,35,15
1658087796628,MATH 20E,B02,083774,Ciotti; Benjamin,18,0,35,17
1658087802653,MATH 103A,A01,083777,Greenfeld; Be'Eri,6,0,36,30
1658087802653,MATH 103A,A02,083778,Greenfeld; Be'Eri,5,0,36,31
1658087802653,MATH 103A,A03,093561,Greenfeld; Be'Eri,7,0,36,29
1658087802653,MATH 103A,B01,083779,Greenfeld; Be'Eri,8,0,36,28
1658087802653,MATH 103A,B02,083780,Greenfeld; Be'Eri,4,0,36,32
1658087802653,MATH 103A,B03,093562,Greenfeld; Be'Eri,3,0,36,33
1658087808680,MATH 105,A01,085443,Carter; Anne Toulson,15,0,35,20
1658087808680,MATH 105,A02,093477,Carter; Anne Toulson,20,0,35,15
1658087814709,MATH 109,A01,083213,Ganzberger; Geoffrey Michael,3,0,34,31
1658087814709,MATH 109,A02,083214,Ganzberger; Geoffrey Michael,4,0,34,30
1658087814709,MATH 109,A03,093478,Ganzberger; Geoffrey Michael,2,0,34,32
1658087814709,MATH 109,B01,083215,Ganzberger; Geoffrey Michael,3,0,32,29
1658087814709,MATH 109,B02,083216,Ganzberger; Geoffrey Michael,3,0,32,29
1658087814709,MATH 109,B03,093479,Ganzberger; Geoffrey Michael,8,0,32,24
1658087820738,MATH 142A,A01,083219,Chow; Bennett,7,0,32,25
1658087820738,MATH 142A,A02,083220,Chow; Bennett,10,0,32,22
1658087820738,MATH 142A,A03,093480,Chow; Bennett,9,0,32,23
1658087820738,MATH 142A,B03,093481,Chow; Bennett,8,0,32,24
1658087820738,MATH 142A,B04,093558,Chow; Bennett,14,0,32,18
1658087820738,MATH 142A,B05,093559,Chow; Bennett,7,0,32,25
1658087826761,MATH 193A,A01,083224,Rotar; Vladimir,9,0,34,25
1658087826761,MATH 193A,A02,083225,Rotar; Vladimir,11,0,34,23
1658087826761,MATH 193A,A03,083781,Rotar; Vladimir,5,0,34,29
1658087826761,MATH 193A,A04,083782,Rotar; Vladimir,12,0,34,22
1658087826761,MATH 193A,A05,093482,Rotar; Vladimir,11,0,34,23
1658087832787,MATH 197,001,091859,McAuley; Julian John,9999,0,9999,0
1658087832787,MATH 197,002,095566,Kedlaya; Kiran S.,9997,0,9999,2
1658087832787,MATH 197,003,095567,Xiao; Ming,9999,0,9999,0
1658087832787,MATH 197,004,095571,Perols; Johan Lars,9998,0,9999,1
1658087839840,COGS 9,A01,083615,Shannon; Kyle Michael,11,0,75,64
1658087845862,COGS 11,A01,083617,Boyle; Mary E. T.,23,0,48,25
1658087851886,COGS 13,A01,083071,Bastos; Amalia Pinkusfeld,12,0,71,59
1658087857912,COGS 14A,A01,092681,Semenuks; Arturs,5,1,100,95
1658087863939,COGS 14B,A01,083073,Cheng; Tzu-Han,7,0,63,56
1658087869966,COGS 17,A01,092677,Semenuks; Arturs,7,0,81,74
1658087875988,COGS 100,A01,083619,Allen; Michael Gordon,17,0,70,53
1658087882015,COGS 101A,A01,083621,Davis; Joshua Daniel,9,0,68,59
1658087888049,COGS 101B,A01,091572,Allen; Michael Gordon,14,0,65,51
1658087894073,COGS 101C,A01,083625,Delgado; Tania,17,0,35,18
1658087900096,COGS 107A,A01,083627,Boyle; Mary E. T.,14,0,60,46
1658087906133,COGS 118A,A01,083075,Gupta; Anjum,21,0,76,55
1658087912157,CSE 3,A50,083646,Miranda; Gregory Joseph,24,0,50,26
1658087918185,CSE 8A,A50,083650,Miranda; Gregory Joseph,17,1,56,39
1658087924208,CSE 11,A01,083080,Cao; Yingjun,7,15,40,33
1658087930232,CSE 12,A01,083652,Krause-Levy; Sophia Louisa,30,1,120,90
1658087936259,CSE 15L,A01,083654,Morris; Justin Loren,9,0,50,41
1658087936259,CSE 15L,A02,083655,Morris; Justin Loren,11,0,50,39
1658087942289,CSE 20,A01,083657,Tran; Khoa Dang,39,0,80,41
1658087948317,CSE 21,A01,095574,Bach; Quang Tran,23,0,48,25
1658087954344,CSE 30,A01,083084,Eldon; John,8,0,80,72
1658087954344,CSE 30,B01,095061,Bhaskar; Nishant,9,0,50,41
1658087960379,CSE 100,A01,083659,Cao; Yingjun,5,4,70,65
1658087966402,CSE 134B,A01,083661,Powell; Thomas Allan,25,0,100,75
1658087972428,CSE 140,A01,083663,Gungor; Onat,17,0,85,68
1658087978456,CSE 140L,A01,083088,Eldon; John,23,0,100,77
1658087984481,CSE 175,A01,083665,Kumar; Rakesh,3,0,25,22
1658087990505,CSE 190,A00,092507,Dubnov; Shlomo,8,0,20,12
1658087996529,ECE 45,A01,083139,Congero; Spencer William,7,0,75,68
1658088002552,ECE 65,A50,083695,Saad; Andrew S,12,0,30,18
1658088002552,ECE 65,A51,095125,Saad; Andrew S,24,0,26,2
1658088008578,ECE 109,A01,091882,Touri; Behrouz,21,0,70,49
1658088014603,ECE 180,A00,083140,Abi Samra; Nicholas Camill,1,0,30,29
1658088014603,ECE 180,B00,083141,Abi Samra; Nicholas Camill,0,0,30,30
1658088020626,MATH 10A,A01,083735,Patchell; Gregory David,2,0,30,28
1658088020626,MATH 10A,A02,083736,Patchell; Gregory David,20,0,30,10
1658088020626,MATH 10A,A03,083737,Patchell; Gregory David,16,0,30,14
1658088026651,MATH 10B,A01,083207,Lim; Seonhee,9,0,34,25
1658088026651,MATH 10B,A02,083208,Lim; Seonhee,10,0,35,25
1658088026651,MATH 10B,A03,093472,Lim; Seonhee,7,0,34,27
1658088026651,MATH 10B,B01,083739,Sinha; Shubham,14,0,30,16
1658088032676,MATH 18,A01,083743,Cinel; Cameron Alexander,9,0,30,21
1658088032676,MATH 18,A02,083744,Cinel; Cameron Alexander,18,0,30,12
1658088032676,MATH 18,A03,083745,Cinel; Cameron Alexander,10,0,30,20
1658088032676,MATH 18,B01,083748,Rideout; David Porter,5,0,37,32
1658088032676,MATH 18,B02,083749,Rideout; David Porter,5,0,36,31
1658088032676,MATH 18,B03,083750,Rideout; David Porter,3,0,37,34
1658088032676,MATH 18,B04,083751,Rideout; David Porter,7,0,36,29
1658088032676,MATH 18,B05,093473,Rideout; David Porter,7,0,36,29
1658088032676,MATH 18,B06,093474,Rideout; David Porter,6,0,36,30
1658088038706,MATH 20A,A01,083754,Zheng; Zequn,14,0,40,26
1658088044734,MATH 20B,A01,083756,Briones; Jor-el Thomas Caparas,4,0,36,32
1658088044734,MATH 20B,A02,083757,Briones; Jor-el Thomas Caparas,1,0,36,35
1658088044734,MATH 20B,A03,093475,Briones; Jor-el Thomas Caparas,3,0,36,33
1658088050756,MATH 20C,A01,083760,Briones; Jor-el Thomas Caparas,1,0,35,34
1658088050756,MATH 20C,A02,083761,Briones; Jor-el Thomas Caparas,8,0,35,27
1658088050756,MATH 20C,A03,093476,Briones; Jor-el Thomas Caparas,0,1,36,36
1658088050756,MATH 20C,B01,083762,Bach; Quang Tran,1,0,30,29
1658088056780,MATH 20D,A01,083765,Tran; Brian Kha,5,0,30,25
1658088056780,MATH 20D,A02,083766,Tran; Brian Kha,5,0,30,25
1658088056780,MATH 20D,A03,083767,Tran; Brian Kha,6,0,30,24
1658088062804,MATH 20E,A01,083771,Ganguly; Soumya,12,0,32,20
1658088062804,MATH 20E,A02,083772,Ganguly; Soumya,7,0,32,25
1658088062804,MATH 20E,B01,083773,Ciotti; Benjamin,20,0,35,15
1658088062804,MATH 20E,B02,083774,Ciotti; Benjamin,18,0,35,17
1658088068827,MATH 103A,A01,083777,Greenfeld; Be'Eri,6,0,36,30
1658088068827,MATH 103A,A02,083778,Greenfeld; Be'Eri,5,0,36,31
1658088068827,MATH 103A,A03,093561,Greenfeld; Be'Eri,7,0,36,29
1658088068827,MATH 103A,B01,083779,Greenfeld; Be'Eri,8,0,36,28
1658088068827,MATH 103A,B02,083780,Greenfeld; Be'Eri,4,0,36,32
1658088068827,MATH 103A,B03,093562,Greenfeld; Be'Eri,3,0,36,33
1658088074853,MATH 105,A01,085443,Carter; Anne Toulson,15,0,35,20
1658088074853,MATH 105,A02,093477,Carter; Anne Toulson,20,0,35,15
1658088080882,MATH 109,A01,083213,Ganzberger; Geoffrey Michael,3,0,34,31
1658088080882,MATH 109,A02,083214,Ganzberger; Geoffrey Michael,4,0,34,30
1658088080882,MATH 109,A03,093478,Ganzberger; Geoffrey Michael,2,0,34,32
1658088080882,MATH 109,B01,083215,Ganzberger; Geoffrey Michael,3,0,32,29
1658088080882,MATH 109,B02,083216,Ganzberger; Geoffrey Michael,3,0,32,29
1658088080882,MATH 109,B03,093479,Ganzberger; Geoffrey Michael,8,0,32,24
1658088086906,MATH 142A,A01,083219,Chow; Bennett,7,0,32,25
1658088086906,MATH 142A,A02,083220,Chow; Bennett,10,0,32,22
1658088086906,MATH 142A,A03,093480,Chow; Bennett,9,0,32,23
1658088086906,MATH 142A,B03,093481,Chow; Bennett,8,0,32,24
1658088086906,MATH 142A,B04,093558,Chow; Bennett,14,0,32,18
1658088086906,MATH 142A,B05,093559,Chow; Bennett,7,0,32,25
1658088092941,MATH 193A,A01,083224,Rotar; Vladimir,9,0,34,25
1658088092941,MATH 193A,A02,083225,Rotar; Vladimir,11,0,34,23
1658088092941,MATH 193A,A03,083781,Rotar; Vladimir,5,0,34,29
1658088092941,MATH 193A,A04,083782,Rotar; Vladimir,12,0,34,22
1658088092941,MATH 193A,A05,093482,Rotar; Vladimir,11,0,34,23
1658088098974,MATH 197,001,091859,McAuley; Julian John,9999,0,9999,0
1658088098974,MATH 197,002,095566,Kedlaya; Kiran S.,9997,0,9999,2
1658088098974,MATH 197,003,095567,Xiao; Ming,9999,0,9999,0
1658088098974,MATH 197,004,095571,Perols; Johan Lars,9998,0,9999,1
1658088106028,COGS 9,A01,083615,Shannon; Kyle Michael,11,0,75,64
1658088112052,COGS 11,A01,083617,Boyle; Mary E. T.,23,0,48,25
1658088118077,COGS 13,A01,083071,Bastos; Amalia Pinkusfeld,12,0,71,59
1658088124109,COGS 14A,A01,092681,Semenuks; Arturs,5,1,100,95
1658088130132,COGS 14B,A01,083073,Cheng; Tzu-Han,7,0,63,56
1658088136158,COGS 17,A01,092677,Semenuks; Arturs,7,0,81,74
1658088142186,COGS 100,A01,083619,Allen; Michael Gordon,17,0,70,53
1658088148212,COGS 101A,A01,083621,Davis; Joshua Daniel,9,0,68,59
1658088154235,COGS 101B,A01,091572,Allen; Michael Gordon,14,0,65,51
1658088160277,COGS 101C,A01,083625,Delgado; Tania,17,0,35,18
1658088166302,COGS 107A,A01,083627,Boyle; Mary E. T.,14,0,60,46
1658088172326,COGS 118A,A01,083075,Gupta; Anjum,21,0,76,55
1658088178348,CSE 3,A50,083646,Miranda; Gregory Joseph,24,0,50,26
1658088184371,CSE 8A,A50,083650,Miranda; Gregory Joseph,17,1,56,39
1658088190395,CSE 11,A01,083080,Cao; Yingjun,7,15,40,33
1658088196418,CSE 12,A01,083652,Krause-Levy; Sophia Louisa,30,1,120,90
1658088202442,CSE 15L,A01,083654,Morris; Justin Loren,9,0,50,41
1658088202442,CSE 15L,A02,083655,Morris; Justin Loren,11,0,50,39
1658088208473,CSE 20,A01,083657,Tran; Khoa Dang,39,0,80,41
1658088214506,CSE 21,A01,095574,Bach; Quang Tran,23,0,48,25
1658088220532,CSE 30,A01,083084,Eldon; John,8,0,80,72
1658088220532,CSE 30,B01,095061,Bhaskar; Nishant,9,0,50,41
1658088226559,CSE 100,A01,083659,Cao; Yingjun,5,4,70,65
1658088232583,CSE 134B,A01,083661,Powell; Thomas Allan,25,0,100,75
1658088238609,CSE 140,A01,083663,Gungor; Onat,17,0,85,68
1658088244631,CSE 140L,A01,083088,Eldon; John,23,0,100,77
1658088250652,CSE 175,A01,083665,Kumar; Rakesh,3,0,25,22
1658088256676,CSE 190,A00,092507,Dubnov; Shlomo,8,0,20,12
1658088262700,ECE 45,A01,083139,Congero; Spencer William,7,0,75,68
1658088268727,ECE 65,A50,083695,Saad; Andrew S,12,0,30,18
1658088268727,ECE 65,A51,095125,Saad; Andrew S,24,0,26,2
1658088274823,ECE 109,A01,091882,Touri; Behrouz,21,0,70,49
1658088280851,ECE 180,A00,083140,Abi Samra; Nicholas Camill,1,0,30,29
1658088280851,ECE 180,B00,083141,Abi Samra; Nicholas Camill,0,0,30,30
1658088286874,MATH 10A,A01,083735,Patchell; Gregory David,2,0,30,28
1658088286874,MATH 10A,A02,083736,Patchell; Gregory David,20,0,30,10
1658088286874,MATH 10A,A03,083737,Patchell; Gregory David,16,0,30,14
1658088292909,MATH 10B,A01,083207,Lim; Seonhee,9,0,34,25
1658088292909,MATH 10B,A02,083208,Lim; Seonhee,10,0,35,25
1658088292909,MATH 10B,A03,093472,Lim; Seonhee,7,0,34,27
1658088292909,MATH 10B,B01,083739,Sinha; Shubham,14,0,30,16
1658088298993,MATH 18,A01,083743,Cinel; Cameron Alexander,9,0,30,21
1658088298993,MATH 18,A02,083744,Cinel; Cameron Alexander,18,0,30,12
1658088298993,MATH 18,A03,083745,Cinel; Cameron Alexander,10,0,30,20
1658088298993,MATH 18,B01,083748,Rideout; David Porter,5,0,37,32
1658088298993,MATH 18,B02,083749,Rideout; David Porter,5,0,36,31
1658088298993,MATH 18,B03,083750,Rideout; David Porter,3,0,37,34
1658088298993,MATH 18,B04,083751,Rideout; David Porter,7,0,36,29
1658088298993,MATH 18,B05,093473,Rideout; David Porter,7,0,36,29
1658088298993,MATH 18,B06,093474,Rideout; David Porter,6,0,36,30
1658088305025,MATH 20A,A01,083754,Zheng; Zequn,14,0,40,26
1658088311048,MATH 20B,A01,083756,Briones; Jor-el Thomas Caparas,4,0,36,32
1658088311048,MATH 20B,A02,083757,Briones; Jor-el Thomas Caparas,1,0,36,35
1658088311048,MATH 20B,A03,093475,Briones; Jor-el Thomas Caparas,3,0,36,33
1658088317078,MATH 20C,A01,083760,Briones; Jor-el Thomas Caparas,1,0,35,34
1658088317078,MATH 20C,A02,083761,Briones; Jor-el Thomas Caparas,8,0,35,27
1658088317078,MATH 20C,A03,093476,Briones; Jor-el Thomas Caparas,0,1,36,36
1658088317078,MATH 20C,B01,083762,Bach; Quang Tran,1,0,30,29
1658088323102,MATH 20D,A01,083765,Tran; Brian Kha,5,0,30,25
1658088323102,MATH 20D,A02,083766,Tran; Brian Kha,5,0,30,25
1658088323102,MATH 20D,A03,083767,Tran; Brian Kha,6,0,30,24
1658088329130,MATH 20E,A01,083771,Ganguly; Soumya,12,0,32,20
1658088329130,MATH 20E,A02,083772,Ganguly; Soumya,7,0,32,25
1658088329130,MATH 20E,B01,083773,Ciotti; Benjamin,20,0,35,15
1658088329130,MATH 20E,B02,083774,Ciotti; Benjamin,18,0,35,17
1658088335154,MATH 103A,A01,083777,Greenfeld; Be'Eri,6,0,36,30
1658088335154,MATH 103A,A02,083778,Greenfeld; Be'Eri,5,0,36,31
1658088335154,MATH 103A,A03,093561,Greenfeld; Be'Eri,7,0,36,29
1658088335154,MATH 103A,B01,083779,Greenfeld; Be'Eri,8,0,36,28
1658088335154,MATH 103A,B02,083780,Greenfeld; Be'Eri,4,0,36,32
1658088335154,MATH 103A,B03,093562,Greenfeld; Be'Eri,3,0,36,33
1658088341189,MATH 105,A01,085443,Carter; Anne Toulson,15,0,35,20
1658088341189,MATH 105,A02,093477,Carter; Anne Toulson,20,0,35,15
1658088347212,MATH 109,A01,083213,Ganzberger; Geoffrey Michael,3,0,34,31
1658088347212,MATH 109,A02,083214,Ganzberger; Geoffrey Michael,4,0,34,30
1658088347212,MATH 109,A03,093478,Ganzberger; Geoffrey Michael,2,0,34,32
1658088347212,MATH 109,B01,083215,Ganzberger; Geoffrey Michael,3,0,32,29
1658088347212,MATH 109,B02,083216,Ganzberger; Geoffrey Michael,3,0,32,29
1658088347212,MATH 109,B03,093479,Ganzberger; Geoffrey Michael,8,0,32,24
1658088353235,MATH 142A,A01,083219,Chow; Bennett,7,0,32,25
1658088353235,MATH 142A,A02,083220,Chow; Bennett,10,0,32,22
1658088353235,MATH 142A,A03,093480,Chow; Bennett,9,0,32,23
1658088353235,MATH 142A,B03,093481,Chow; Bennett,8,0,32,24
1658088353235,MATH 142A,B04,093558,Chow; Bennett,14,0,32,18
1658088353235,MATH 142A,B05,093559,Chow; Bennett,7,0,32,25
1658088359264,MATH 193A,A01,083224,Rotar; Vladimir,9,0,34,25
1658088359264,MATH 193A,A02,083225,Rotar; Vladimir,11,0,34,23
1658088359264,MATH 193A,A03,083781,Rotar; Vladimir,5,0,34,29
1658088359264,MATH 193A,A04,083782,Rotar; Vladimir,12,0,34,22
1658088359264,MATH 193A,A05,093482,Rotar; Vladimir,11,0,34,23
1658088365290,MATH 197,001,091859,McAuley; Julian John,9999,0,9999,0
1658088365290,MATH 197,002,095566,Kedlaya; Kiran S.,9997,0,9999,2
1658088365290,MATH 197,003,095567,Xiao; Ming,9999,0,9999,0
1658088365290,MATH 197,004,095571,Perols; Johan Lars,9998,0,9999,1
1658088372345,COGS 9,A01,083615,Shannon; Kyle Michael,11,0,75,64
1658088378372,COGS 11,A01,083617,Boyle; Mary E. T.,23,0,48,25
1658088384403,COGS 13,A01,083071,Bastos; Amalia Pinkusfeld,12,0,71,59
1658088390432,COGS 14A,A01,092681,Semenuks; Arturs,5,1,100,95
1658088396460,COGS 14B,A01,083073,Cheng; Tzu-Han,7,0,63,56
1658088402483,COGS 17,A01,092677,Semenuks; Arturs,7,0,81,74
1658088408511,COGS 100,A01,083619,Allen; Michael Gordon,17,0,70,53
1658088414540,COGS 101A,A01,083621,Davis; Joshua Daniel,9,0,68,59
1658088420564,COGS 101B,A01,091572,Allen; Michael Gordon,14,0,65,51
1658088426589,COGS 101C,A01,083625,Delgado; Tania,17,0,35,18
1658088432612,COGS 107A,A01,083627,Boyle; Mary E. T.,14,0,60,46
1658088438639,COGS 118A,A01,083075,Gupta; Anjum,21,0,76,55
1658088444666,CSE 3,A50,083646,Miranda; Gregory Joseph,24,0,50,26
1658088450691,CSE 8A,A50,083650,Miranda; Gregory Joseph,17,1,56,39
1658088456717,CSE 11,A01,083080,Cao; Yingjun,7,15,40,33
1658088462744,CSE 12,A01,083652,Krause-Levy; Sophia Louisa,30,1,120,90
1658088468772,CSE 15L,A01,083654,Morris; Justin Loren,9,0,50,41
1658088468772,CSE 15L,A02,083655,Morris; Justin Loren,11,0,50,39
1658088474796,CSE 20,A01,083657,Tran; Khoa Dang,39,0,80,41
1658088480824,CSE 21,A01,095574,Bach; Quang Tran,23,0,48,25
1658088486849,CSE 30,A01,083084,Eldon; John,8,0,80,72
1658088486849,CSE 30,B01,095061,Bhaskar; Nishant,9,0,50,41
1658088492877,CSE 100,A01,083659,Cao; Yingjun,5,4,70,65
1658088498899,CSE 134B,A01,083661,Powell; Thomas Allan,25,0,100,75
1658088504923,CSE 140,A01,083663,Gungor; Onat,17,0,85,68
1658088510946,CSE 140L,A01,083088,Eldon; John,23,0,100,77
1658088516971,CSE 175,A01,083665,Kumar; Rakesh,3,0,25,22
1658088522995,CSE 190,A00,092507,Dubnov; Shlomo,8,0,20,12
1658088529020,ECE 45,A01,083139,Congero; Spencer William,7,0,75,68
1658088535043,ECE 65,A50,083695,Saad; Andrew S,12,0,30,18
1658088535043,ECE 65,A51,095125,Saad; Andrew S,24,0,26,2
1658088541068,ECE 109,A01,091882,Touri; Behrouz,21,0,70,49
1658088547096,ECE 180,A00,083140,Abi Samra; Nicholas Camill,1,0,30,29
1658088547096,ECE 180,B00,083141,Abi Samra; Nicholas Camill,0,0,30,30
1658088553119,MATH 10A,A01,083735,Patchell; Gregory David,2,0,30,28
1658088553119,MATH 10A,A02,083736,Patchell; Gregory David,20,0,30,10
1658088553119,MATH 10A,A03,083737,Patchell; Gregory David,16,0,30,14
1658088559149,MATH 10B,A01,083207,Lim; Seonhee,9,0,34,25
1658088559149,MATH 10B,A02,083208,Lim; Seonhee,10,0,35,25
1658088559149,MATH 10B,A03,093472,Lim; Seonhee,7,0,34,27
1658088559149,MATH 10B,B01,083739,Sinha; Shubham,14,0,30,16
1658088565180,MATH 18,A01,083743,Cinel; Cameron Alexander,9,0,30,21
1658088565180,MATH 18,A02,083744,Cinel; Cameron Alexander,18,0,30,12
1658088565180,MATH 18,A03,083745,Cinel; Cameron Alexander,10,0,30,20
1658088565180,MATH 18,B01,083748,Rideout; David Porter,5,0,37,32
1658088565180,MATH 18,B02,083749,Rideout; David Porter,5,0,36,31
1658088565180,MATH 18,B03,083750,Rideout; David Porter,3,0,37,34
1658088565180,MATH 18,B04,083751,Rideout; David Porter,7,0,36,29
1658088565180,MATH 18,B05,093473,Rideout; David Porter,7,0,36,29
1658088565180,MATH 18,B06,093474,Rideout; David Porter,6,0,36,30
1658088571205,MATH 20A,A01,083754,Zheng; Zequn,14,0,40,26
1658088577233,MATH 20B,A01,083756,Briones; Jor-el Thomas Caparas,4,0,36,32
1658088577233,MATH 20B,A02,083757,Briones; Jor-el Thomas Caparas,1,0,36,35
1658088577233,MATH 20B,A03,093475,Briones; Jor-el Thomas Caparas,3,0,36,33
1658088583257,MATH 20C,A01,083760,Briones; Jor-el Thomas Caparas,1,0,35,34
1658088583257,MATH 20C,A02,083761,Briones; Jor-el Thomas Caparas,8,0,35,27
1658088583257,MATH 20C,A03,093476,Briones; Jor-el Thomas Caparas,0,1,36,36
1658088583257,MATH 20C,B01,083762,Bach; Quang Tran,1,0,30,29
1658088589281,MATH 20D,A01,083765,Tran; Brian Kha,5,0,30,25
1658088589281,MATH 20D,A02,083766,Tran; Brian Kha,5,0,30,25
1658088589281,MATH 20D,A03,083767,Tran; Brian Kha,6,0,30,24
1658088595303,MATH 20E,A01,083771,Ganguly; Soumya,12,0,32,20
1658088595303,MATH 20E,A02,083772,Ganguly; Soumya,7,0,32,25
1658088595303,MATH 20E,B01,083773,Ciotti; Benjamin,20,0,35,15
1658088595303,MATH 20E,B02,083774,Ciotti; Benjamin,18,0,35,17
1658088601333,MATH 103A,A01,083777,Greenfeld; Be'Eri,6,0,36,30
1658088601333,MATH 103A,A02,083778,Greenfeld; Be'Eri,5,0,36,31
1658088601333,MATH 103A,A03,093561,Greenfeld; Be'Eri,7,0,36,29
1658088601333,MATH 103A,B01,083779,Greenfeld; Be'Eri,8,0,36,28
1658088601333,MATH 103A,B02,083780,Greenfeld; Be'Eri,4,0,36,32
1658088601333,MATH 103A,B03,093562,Greenfeld; Be'Eri,3,0,36,33
1658088607358,MATH 105,A01,085443,Carter; Anne Toulson,15,0,35,20
1658088607358,MATH 105,A02,093477,Carter; Anne Toulson,20,0,35,15
1658088613383,MATH 109,A01,083213,Ganzberger; Geoffrey Michael,3,0,34,31
1658088613383,MATH 109,A02,083214,Ganzberger; Geoffrey Michael,4,0,34,30
1658088613383,MATH 109,A03,093478,Ganzberger; Geoffrey Michael,2,0,34,32
1658088613383,MATH 109,B01,083215,Ganzberger; Geoffrey Michael,3,0,32,29
1658088613383,MATH 109,B02,083216,Ganzberger; Geoffrey Michael,3,0,32,29
1658088613383,MATH 109,B03,093479,Ganzberger; Geoffrey Michael,8,0,32,24
1658088619416,MATH 142A,A01,083219,Chow; Bennett,7,0,32,25
1658088619416,MATH 142A,A02,083220,Chow; Bennett,10,0,32,22
1658088619416,MATH 142A,A03,093480,Chow; Bennett,9,0,32,23
1658088619416,MATH 142A,B03,093481,Chow; Bennett,8,0,32,24
1658088619416,MATH 142A,B04,093558,Chow; Bennett,14,0,32,18
1658088619416,MATH 142A,B05,093559,Chow; Bennett,7,0,32,25
1658088625445,MATH 193A,A01,083224,Rotar; Vladimir,9,0,34,25
1658088625445,MATH 193A,A02,083225,Rotar; Vladimir,11,0,34,23
1658088625445,MATH 193A,A03,083781,Rotar; Vladimir,5,0,34,29
1658088625445,MATH 193A,A04,083782,Rotar; Vladimir,12,0,34,22
1658088625445,MATH 193A,A05,093482,Rotar; Vladimir,11,0,34,23
1658088631471,MATH 197,001,091859,McAuley; Julian John,9999,0,9999,0
1658088631471,MATH 197,002,095566,Kedlaya; Kiran S.,9997,0,9999,2
1658088631471,MATH 197,003,095567,Xiao; Ming,9999,0,9999,0
1658088631471,MATH 197,004,095571,Perols; Johan Lars,9998,0,9999,1
1658088638529,COGS 9,A01,083615,Shannon; Kyle Michael,11,0,75,64
1658088644558,COGS 11,A01,083617,Boyle; Mary E. T.,23,0,48,25
1658088650582,COGS 13,A01,083071,Bastos; Amalia Pinkusfeld,12,0,71,59
1658088656606,COGS 14A,A01,092681,Semenuks; Arturs,5,1,100,95
1658088662633,COGS 14B,A01,083073,Cheng; Tzu-Han,7,0,63,56
1658088668657,COGS 17,A01,092677,Semenuks; Arturs,7,0,81,74
1658088674681,COGS 100,A01,083619,Allen; Michael Gordon,17,0,70,53
1658088680708,COGS 101A,A01,083621,Davis; Joshua Daniel,9,0,68,59
1658088686734,COGS 101B,A01,091572,Allen; Michael Gordon,14,0,65,51
1658088692760,COGS 101C,A01,083625,Delgado; Tania,17,0,35,18
1658088698787,COGS 107A,A01,083627,Boyle; Mary E. T.,14,0,60,46
1658088704811,COGS 118A,A01,083075,Gupta; Anjum,21,0,76,55
1658088710837,CSE 3,A50,083646,Miranda; Gregory Joseph,24,0,50,26
1658088716868,CSE 8A,A50,083650,Miranda; Gregory Joseph,17,1,56,39
1658088722891,CSE 11,A01,083080,Cao; Yingjun,7,15,40,33
1658088728918,CSE 12,A01,083652,Krause-Levy; Sophia Louisa,30,1,120,90
1658088734943,CSE 15L,A01,083654,Morris; Justin Loren,9,0,50,41
1658088734943,CSE 15L,A02,083655,Morris; Justin Loren,11,0,50,39
1658088740967,CSE 20,A01,083657,Tran; Khoa Dang,39,0,80,41
1658088746994,CSE 21,A01,095574,Bach; Quang Tran,23,0,48,25
1658088753019,CSE 30,A01,083084,Eldon; John,8,0,80,72
1658088753019,CSE 30,B01,095061,Bhaskar; Nishant,9,0,50,41
1658088759042,CSE 100,A01,083659,Cao; Yingjun,5,4,70,65
1658088765065,CSE 134B,A01,083661,Powell; Thomas Allan,25,0,100,75
1658088771091,CSE 140,A01,083663,Gungor; Onat,17,0,85,68
1658088777114,CSE 140L,A01,083088,Eldon; John,23,0,100,77
1658088783141,CSE 175,A01,083665,Kumar; Rakesh,3,0,25,22
1658088789168,CSE 190,A00,092507,Dubnov; Shlomo,8,0,20,12
1658088795190,ECE 45,A01,083139,Congero; Spencer William,7,0,75,68
1658088801214,ECE 65,A50,083695,Saad; Andrew S,12,0,30,18
1658088801214,ECE 65,A51,095125,Saad; Andrew S,24,0,26,2
1658088807238,ECE 109,A01,091882,Touri; Behrouz,21,0,70,49
1658088813263,ECE 180,A00,083140,Abi Samra; Nicholas Camill,1,0,30,29
1658088813263,ECE 180,B00,083141,Abi Samra; Nicholas Camill,0,0,30,30
1658088819287,MATH 10A,A01,083735,Patchell; Gregory David,2,0,30,28
1658088819287,MATH 10A,A02,083736,Patchell; Gregory David,20,0,30,10
1658088819287,MATH 10A,A03,083737,Patchell; Gregory David,16,0,30,14
1658088825309,MATH 10B,A01,083207,Lim; Seonhee,9,0,34,25
1658088825309,MATH 10B,A02,083208,Lim; Seonhee,10,0,35,25
1658088825309,MATH 10B,A03,093472,Lim; Seonhee,7,0,34,27
1658088825309,MATH 10B,B01,083739,Sinha; Shubham,14,0,30,16
1658088831335,MATH 18,A01,083743,Cinel; Cameron Alexander,9,0,30,21
1658088831335,MATH 18,A02,083744,Cinel; Cameron Alexander,18,0,30,12
1658088831335,MATH 18,A03,083745,Cinel; Cameron Alexander,10,0,30,20
1658088831335,MATH 18,B01,083748,Rideout; David Porter,5,0,37,32
1658088831335,MATH 18,B02,083749,Rideout; David Porter,5,0,36,31
1658088831335,MATH 18,B03,083750,Rideout; David Porter,3,0,37,34
1658088831335,MATH 18,B04,083751,Rideout; David Porter,7,0,36,29
1658088831335,MATH 18,B05,093473,Rideout; David Porter,7,0,36,29
1658088831335,MATH 18,B06,093474,Rideout; David Porter,6,0,36,30
1658088837359,MATH 20A,A01,083754,Zheng; Zequn,14,0,40,26
1658088843383,MATH 20B,A01,083756,Briones; Jor-el Thomas Caparas,4,0,36,32
1658088843383,MATH 20B,A02,083757,Briones; Jor-el Thomas Caparas,1,0,36,35
1658088843383,MATH 20B,A03,093475,Briones; Jor-el Thomas Caparas,3,0,36,33
1658088849413,MATH 20C,A01,083760,Briones; Jor-el Thomas Caparas,1,0,35,34
1658088849413,MATH 20C,A02,083761,Briones; Jor-el Thomas Caparas,8,0,35,27
1658088849413,MATH 20C,A03,093476,Briones; Jor-el Thomas Caparas,0,1,36,36
1658088849413,MATH 20C,B01,083762,Bach; Quang Tran,1,0,30,29
1658088855448,MATH 20D,A01,083765,Tran; Brian Kha,5,0,30,25
1658088855448,MATH 20D,A02,083766,Tran; Brian Kha,5,0,30,25
1658088855448,MATH 20D,A03,083767,Tran; Brian Kha,6,0,30,24
1658088861476,MATH 20E,A01,083771,Ganguly; Soumya,12,0,32,20
1658088861476,MATH 20E,A02,083772,Ganguly; Soumya,7,0,32,25
1658088861476,MATH 20E,B01,083773,Ciotti; Benjamin,20,0,35,15
1658088861476,MATH 20E,B02,083774,Ciotti; Benjamin,18,0,35,17
1658088867505,MATH 103A,A01,083777,Greenfeld; Be'Eri,6,0,36,30
1658088867505,MATH 103A,A02,083778,Greenfeld; Be'Eri,5,0,36,31
1658088867505,MATH 103A,A03,093561,Greenfeld; Be'Eri,7,0,36,29
1658088867505,MATH 103A,B01,083779,Greenfeld; Be'Eri,8,0,36,28
1658088867505,MATH 103A,B02,083780,Greenfeld; Be'Eri,4,0,36,32
1658088867505,MATH 103A,B03,093562,Greenfeld; Be'Eri,3,0,36,33
1658088873603,MATH 105,A01,085443,Carter; Anne Toulson,15,0,35,20
1658088873603,MATH 105,A02,093477,Carter; Anne Toulson,20,0,35,15
1658088879631,MATH 109,A01,083213,Ganzberger; Geoffrey Michael,3,0,34,31
1658088879631,MATH 109,A02,083214,Ganzberger; Geoffrey Michael,4,0,34,30
1658088879631,MATH 109,A03,093478,Ganzberger; Geoffrey Michael,2,0,34,32
1658088879631,MATH 109,B01,083215,Ganzberger; Geoffrey Michael,3,0,32,29
1658088879631,MATH 109,B02,083216,Ganzberger; Geoffrey Michael,3,0,32,29
1658088879631,MATH 109,B03,093479,Ganzberger; Geoffrey Michael,8,0,32,24
1658088885657,MATH 142A,A01,083219,Chow; Bennett,7,0,32,25
1658088885657,MATH 142A,A02,083220,Chow; Bennett,10,0,32,22
1658088885657,MATH 142A,A03,093480,Chow; Bennett,9,0,32,23
1658088885657,MATH 142A,B03,093481,Chow; Bennett,8,0,32,24
1658088885657,MATH 142A,B04,093558,Chow; Bennett,14,0,32,18
1658088885657,MATH 142A,B05,093559,Chow; Bennett,7,0,32,25
1658088891686,MATH 193A,A01,083224,Rotar; Vladimir,9,0,34,25
1658088891686,MATH 193A,A02,083225,Rotar; Vladimir,11,0,34,23
1658088891686,MATH 193A,A03,083781,Rotar; Vladimir,5,0,34,29
1658088891686,MATH 193A,A04,083782,Rotar; Vladimir,12,0,34,22
1658088891686,MATH 193A,A05,093482,Rotar; Vladimir,11,0,34,23
1658088897713,MATH 197,001,091859,McAuley; Julian John,9999,0,9999,0
1658088897713,MATH 197,002,095566,Kedlaya; Kiran S.,9997,0,9999,2
1658088897713,MATH 197,003,095567,Xiao; Ming,9999,0,9999,0
1658088897713,MATH 197,004,095571,Perols; Johan Lars,9998,0,9999,1
1658088904790,COGS 9,A01,083615,Shannon; Kyle Michael,11,0,75,64
1658088910812,COGS 11,A01,083617,Boyle; Mary E. T.,23,0,48,25
1658088916835,COGS 13,A01,083071,Bastos; Amalia Pinkusfeld,12,0,71,59
1658088922863,COGS 14A,A01,092681,Semenuks; Arturs,5,1,100,95
1658088928888,COGS 14B,A01,083073,Cheng; Tzu-Han,7,0,63,56
1658088934914,COGS 17,A01,092677,Semenuks; Arturs,7,0,81,74
1658088940941,COGS 100,A01,083619,Allen; Michael Gordon,17,0,70,53
1658088946965,COGS 101A,A01,083621,Davis; Joshua Daniel,9,0,68,59
1658088952991,COGS 101B,A01,091572,Allen; Michael Gordon,14,0,65,51
1658088959015,COGS 101C,A01,083625,Delgado; Tania,17,0,35,18
1658088965042,COGS 107A,A01,083627,Boyle; Mary E. T.,14,0,60,46
1658088971066,COGS 118A,A01,083075,Gupta; Anjum,21,0,76,55
1658088977093,CSE 3,A50,083646,Miranda; Gregory Joseph,24,0,50,26
1658088983117,CSE 8A,A50,083650,Miranda; Gregory Joseph,17,1,56,39
1658088989140,CSE 11,A01,083080,Cao; Yingjun,7,15,40,33
1658088995167,CSE 12,A01,083652,Krause-Levy; Sophia Louisa,30,1,120,90
1658089001190,CSE 15L,A01,083654,Morris; Justin Loren,9,0,50,41
1658089001190,CSE 15L,A02,083655,Morris; Justin Loren,11,0,50,39
1658089007213,CSE 20,A01,083657,Tran; Khoa Dang,39,0,80,41
1658089013241,CSE 21,A01,095574,Bach; Quang Tran,23,0,48,25
1658089019266,CSE 30,A01,083084,Eldon; John,8,0,80,72
1658089019266,CSE 30,B01,095061,Bhaskar; Nishant,9,0,50,41
1658089025293,CSE 100,A01,083659,Cao; Yingjun,5,4,70,65
1658089031319,CSE 134B,A01,083661,Powell; Thomas Allan,25,0,100,75
1658089037348,CSE 140,A01,083663,Gungor; Onat,17,0,85,68
1658089043375,CSE 140L,A01,083088,Eldon; John,23,0,100,77
1658089049402,CSE 175,A01,083665,Kumar; Rakesh,3,0,25,22
1658089055428,CSE 190,A00,092507,Dubnov; Shlomo,8,0,20,12
1658089061453,ECE 45,A01,083139,Congero; Spencer William,7,0,75,68
1658089067480,ECE 65,A50,083695,Saad; Andrew S,12,0,30,18
1658089067480,ECE 65,A51,095125,Saad; Andrew S,24,0,26,2
1658089073507,ECE 109,A01,091882,Touri; Behrouz,21,0,70,49
1658089079531,ECE 180,A00,083140,Abi Samra; Nicholas Camill,1,0,30,29
1658089079531,ECE 180,B00,083141,Abi Samra; Nicholas Camill,0,0,30,30
1658089085558,MATH 10A,A01,083735,Patchell; Gregory David,2,0,30,28
1658089085558,MATH 10A,A02,083736,Patchell; Gregory David,20,0,30,10
1658089085558,MATH 10A,A03,083737,Patchell; Gregory David,16,0,30,14
1658089091582,MATH 10B,A01,083207,Lim; Seonhee,9,0,34,25
1658089091582,MATH 10B,A02,083208,Lim; Seonhee,10,0,35,25
1658089091582,MATH 10B,A03,093472,Lim; Seonhee,7,0,34,27
1658089091582,MATH 10B,B01,083739,Sinha; Shubham,14,0,30,16
1658089097613,MATH 18,A01,083743,Cinel; Cameron Alexander,9,0,30,21
1658089097613,MATH 18,A02,083744,Cinel; Cameron Alexander,18,0,30,12
1658089097613,MATH 18,A03,083745,Cinel; Cameron Alexander,10,0,30,20
1658089097613,MATH 18,B01,083748,Rideout; David Porter,5,0,37,32
1658089097613,MATH 18,B02,083749,Rideout; David Porter,5,0,36,31
1658089097613,MATH 18,B03,083750,Rideout; David Porter,3,0,37,34
1658089097613,MATH 18,B04,083751,Rideout; David Porter,7,0,36,29
1658089097613,MATH 18,B05,093473,Rideout; David Porter,7,0,36,29
1658089097613,MATH 18,B06,093474,Rideout; David Porter,6,0,36,30
1658089103637,MATH 20A,A01,083754,Zheng; Zequn,14,0,40,26
1658089109664,MATH 20B,A01,083756,Briones; Jor-el Thomas Caparas,4,0,36,32
1658089109664,MATH 20B,A02,083757,Briones; Jor-el Thomas Caparas,1,0,36,35
1658089109664,MATH 20B,A03,093475,Briones; Jor-el Thomas Caparas,3,0,36,33
1658089115688,MATH 20C,A01,083760,Briones; Jor-el Thomas Caparas,1,0,35,34
1658089115688,MATH 20C,A02,083761,Briones; Jor-el Thomas Caparas,8,0,35,27
1658089115688,MATH 20C,A03,093476,Briones; Jor-el Thomas Caparas,0,1,36,36
1658089115688,MATH 20C,B01,083762,Bach; Quang Tran,1,0,30,29
1658089121716,MATH 20D,A01,083765,Tran; Brian Kha,5,0,30,25
1658089121716,MATH 20D,A02,083766,Tran; Brian Kha,5,0,30,25
1658089121716,MATH 20D,A03,083767,Tran; Brian Kha,6,0,30,24
1658089127746,MATH 20E,A01,083771,Ganguly; Soumya,12,0,32,20
1658089127746,MATH 20E,A02,083772,Ganguly; Soumya,7,0,32,25
1658089127746,MATH 20E,B01,083773,Ciotti; Benjamin,20,0,35,15
1658089127746,MATH 20E,B02,083774,Ciotti; Benjamin,18,0,35,17
1658089133773,MATH 103A,A01,083777,Greenfeld; Be'Eri,6,0,36,30
1658089133773,MATH 103A,A02,083778,Greenfeld; Be'Eri,5,0,36,31
1658089133773,MATH 103A,A03,093561,Greenfeld; Be'Eri,7,0,36,29
1658089133773,MATH 103A,B01,083779,Greenfeld; Be'Eri,8,0,36,28
1658089133773,MATH 103A,B02,083780,Greenfeld; Be'Eri,4,0,36,32
1658089133773,MATH 103A,B03,093562,Greenfeld; Be'Eri,3,0,36,33
1658089139800,MATH 105,A01,085443,Carter; Anne Toulson,15,0,35,20
1658089139800,MATH 105,A02,093477,Carter; Anne Toulson,20,0,35,15
1658089145829,MATH 109,A01,083213,Ganzberger; Geoffrey Michael,3,0,34,31
1658089145829,MATH 109,A02,083214,Ganzberger; Geoffrey Michael,4,0,34,30
1658089145829,MATH 109,A03,093478,Ganzberger; Geoffrey Michael,2,0,34,32
1658089145829,MATH 109,B01,083215,Ganzberger; Geoffrey Michael,3,0,32,29
1658089145829,MATH 109,B02,083216,Ganzberger; Geoffrey Michael,3,0,32,29
1658089145829,MATH 109,B03,093479,Ganzberger; Geoffrey Michael,8,0,32,24
1658089151860,MATH 142A,A01,083219,Chow; Bennett,7,0,32,25
1658089151860,MATH 142A,A02,083220,Chow; Bennett,10,0,32,22
1658089151860,MATH 142A,A03,093480,Chow; Bennett,9,0,32,23
1658089151860,MATH 142A,B03,093481,Chow; Bennett,8,0,32,24
1658089151860,MATH 142A,B04,093558,Chow; Bennett,14,0,32,18
1658089151860,MATH 142A,B05,093559,Chow; Bennett,7,0,32,25
1658089157889,MATH 193A,A01,083224,Rotar; Vladimir,9,0,34,25
1658089157889,MATH 193A,A02,083225,Rotar; Vladimir,11,0,34,23
1658089157889,MATH 193A,A03,083781,Rotar; Vladimir,5,0,34,29
1658089157889,MATH 193A,A04,083782,Rotar; Vladimir,12,0,34,22
1658089157889,MATH 193A,A05,093482,Rotar; Vladimir,11,0,34,23
1658089163911,MATH 197,001,091859,McAuley; Julian John,9999,0,9999,0
1658089163911,MATH 197,002,095566,Kedlaya; Kiran S.,9997,0,9999,2
1658089163911,MATH 197,003,095567,Xiao; Ming,9999,0,9999,0
1658089163911,MATH 197,004,095571,Perols; Johan Lars,9998,0,9999,1
1658089170963,COGS 9,A01,083615,Shannon; Kyle Michael,11,0,75,64
1658089176986,COGS 11,A01,083617,Boyle; Mary E. T.,23,0,48,25
1658089183023,COGS 13,A01,083071,Bastos; Amalia Pinkusfeld,12,0,71,59
1658089189049,COGS 14A,A01,092681,Semenuks; Arturs,5,1,100,95
1658089195076,COGS 14B,A01,083073,Cheng; Tzu-Han,7,0,63,56
1658089201100,COGS 17,A01,092677,Semenuks; Arturs,7,0,81,74
1658089207127,COGS 100,A01,083619,Allen; Michael Gordon,17,0,70,53
1658089213150,COGS 101A,A01,083621,Davis; Joshua Daniel,9,0,68,59
1658089219173,COGS 101B,A01,091572,Allen; Michael Gordon,14,0,65,51
1658089225220,COGS 101C,A01,083625,Delgado; Tania,17,0,35,18
1658089231244,COGS 107A,A01,083627,Boyle; Mary E. T.,14,0,60,46
1658089237271,COGS 118A,A01,083075,Gupta; Anjum,21,0,76,55
1658089243306,CSE 3,A50,083646,Miranda; Gregory Joseph,24,0,50,26
1658089249331,CSE 8A,A50,083650,Miranda; Gregory Joseph,17,1,56,39
1658089255355,CSE 11,A01,083080,Cao; Yingjun,7,15,40,33
1658089261377,CSE 12,A01,083652,Krause-Levy; Sophia Louisa,30,1,120,90
1658089267405,CSE 15L,A01,083654,Morris; Justin Loren,9,0,50,41
1658089267405,CSE 15L,A02,083655,Morris; Justin Loren,11,0,50,39
1658089273432,CSE 20,A01,083657,Tran; Khoa Dang,39,0,80,41
1658089279456,CSE 21,A01,095574,Bach; Quang Tran,23,0,48,25
1658089285484,CSE 30,A01,083084,Eldon; John,8,0,80,72
1658089285484,CSE 30,B01,095061,Bhaskar; Nishant,9,0,50,41
1658089291509,CSE 100,A01,083659,Cao; Yingjun,5,4,70,65
1658089297532,CSE 134B,A01,083661,Powell; Thomas Allan,25,0,100,75
1658089303557,CSE 140,A01,083663,Gungor; Onat,17,0,85,68
1658089309581,CSE 140L,A01,083088,Eldon; John,23,0,100,77
1658089315604,CSE 175,A01,083665,Kumar; Rakesh,3,0,25,22
1658089321635,CSE 190,A00,092507,Dubnov; Shlomo,8,0,20,12
1658089327661,ECE 45,A01,083139,Congero; Spencer William,7,0,75,68
1658089333684,ECE 65,A50,083695,Saad; Andrew S,12,0,30,18
1658089333684,ECE 65,A51,095125,Saad; Andrew S,24,0,26,2
1658089339710,ECE 109,A01,091882,Touri; Behrouz,21,0,70,49
1658089345738,ECE 180,A00,083140,Abi Samra; Nicholas Camill,1,0,30,29
1658089345738,ECE 180,B00,083141,Abi Samra; Nicholas Camill,0,0,30,30
1658089351767,MATH 10A,A01,083735,Patchell; Gregory David,2,0,30,28
1658089351767,MATH 10A,A02,083736,Patchell; Gregory David,20,0,30,10
1658089351767,MATH 10A,A03,083737,Patchell; Gregory David,16,0,30,14
1658089357795,MATH 10B,A01,083207,Lim; Seonhee,9,0,34,25
1658089357795,MATH 10B,A02,083208,Lim; Seonhee,10,0,35,25
1658089357795,MATH 10B,A03,093472,Lim; Seonhee,7,0,34,27
1658089357795,MATH 10B,B01,083739,Sinha; Shubham,14,0,30,16
1658089363825,MATH 18,A01,083743,Cinel; Cameron Alexander,9,0,30,21
1658089363825,MATH 18,A02,083744,Cinel; Cameron Alexander,18,0,30,12
1658089363825,MATH 18,A03,083745,Cinel; Cameron Alexander,10,0,30,20
1658089363825,MATH 18,B01,083748,Rideout; David Porter,5,0,37,32
1658089363825,MATH 18,B02,083749,Rideout; David Porter,5,0,36,31
1658089363825,MATH 18,B03,083750,Rideout; David Porter,3,0,37,34
1658089363825,MATH 18,B04,083751,Rideout; David Porter,7,0,36,29
1658089363825,MATH 18,B05,093473,Rideout; David Porter,7,0,36,29
1658089363825,MATH 18,B06,093474,Rideout; David Porter,6,0,36,30
1658089369848,MATH 20A,A01,083754,Zheng; Zequn,14,0,40,26
1658089375873,MATH 20B,A01,083756,Briones; Jor-el Thomas Caparas,4,0,36,32
1658089375873,MATH 20B,A02,083757,Briones; Jor-el Thomas Caparas,1,0,36,35
1658089375873,MATH 20B,A03,093475,Briones; Jor-el Thomas Caparas,3,0,36,33
1658089381902,MATH 20C,A01,083760,Briones; Jor-el Thomas Caparas,1,0,35,34
1658089381902,MATH 20C,A02,083761,Briones; Jor-el Thomas Caparas,8,0,35,27
1658089381902,MATH 20C,A03,093476,Briones; Jor-el Thomas Caparas,0,1,36,36
1658089381902,MATH 20C,B01,083762,Bach; Quang Tran,1,0,30,29
1658089387949,MATH 20D,A01,083765,Tran; Brian Kha,5,0,30,25
1658089387949,MATH 20D,A02,083766,Tran; Brian Kha,5,0,30,25
1658089387949,MATH 20D,A03,083767,Tran; Brian Kha,6,0,30,24
1658089393971,MATH 20E,A01,083771,Ganguly; Soumya,12,0,32,20
1658089393971,MATH 20E,A02,083772,Ganguly; Soumya,7,0,32,25
1658089393971,MATH 20E,B01,083773,Ciotti; Benjamin,20,0,35,15
1658089393971,MATH 20E,B02,083774,Ciotti; Benjamin,18,0,35,17
1658089400000,MATH 103A,A01,083777,Greenfeld; Be'Eri,6,0,36,30
1658089400000,MATH 103A,A02,083778,Greenfeld; Be'Eri,5,0,36,31
1658089400000,MATH 103A,A03,093561,Greenfeld; Be'Eri,7,0,36,29
1658089400000,MATH 103A,B01,083779,Greenfeld; Be'Eri,8,0,36,28
1658089400000,MATH 103A,B02,083780,Greenfeld; Be'Eri,4,0,36,32
1658089400000,MATH 103A,B03,093562,Greenfeld; Be'Eri,3,0,36,33
1658089406025,MATH 105,A01,085443,Carter; Anne Toulson,15,0,35,20
1658089406025,MATH 105,A02,093477,Carter; Anne Toulson,20,0,35,15
1658089412053,MATH 109,A01,083213,Ganzberger; Geoffrey Michael,3,0,34,31
1658089412053,MATH 109,A02,083214,Ganzberger; Geoffrey Michael,4,0,34,30
1658089412053,MATH 109,A03,093478,Ganzberger; Geoffrey Michael,2,0,34,32
1658089412053,MATH 109,B01,083215,Ganzberger; Geoffrey Michael,3,0,32,29
1658089412053,MATH 109,B02,083216,Ganzberger; Geoffrey Michael,3,0,32,29
1658089412053,MATH 109,B03,093479,Ganzberger; Geoffrey Michael,8,0,32,24
1658089418083,MATH 142A,A01,083219,Chow; Bennett,7,0,32,25
1658089418083,MATH 142A,A02,083220,Chow; Bennett,10,0,32,22
1658089418083,MATH 142A,A03,093480,Chow; Bennett,9,0,32,23
1658089418083,MATH 142A,B03,093481,Chow; Bennett,8,0,32,24
1658089418083,MATH 142A,B04,093558,Chow; Bennett,14,0,32,18
1658089418083,MATH 142A,B05,093559,Chow; Bennett,7,0,32,25
1658089424108,MATH 193A,A01,083224,Rotar; Vladimir,9,0,34,25
1658089424108,MATH 193A,A02,083225,Rotar; Vladimir,11,0,34,23
1658089424108,MATH 193A,A03,083781,Rotar; Vladimir,5,0,34,29
1658089424108,MATH 193A,A04,083782,Rotar; Vladimir,12,0,34,22
1658089424108,MATH 193A,A05,093482,Rotar; Vladimir,11,0,34,23
1658089430135,MATH 197,001,091859,McAuley; Julian John,9999,0,9999,0
1658089430135,MATH 197,002,095566,Kedlaya; Kiran S.,9997,0,9999,2
1658089430135,MATH 197,003,095567,Xiao; Ming,9999,0,9999,0
1658089430135,MATH 197,004,095571,Perols; Johan Lars,9998,0,9999,1
1658089437191,COGS 9,A01,083615,Shannon; Kyle Michael,11,0,75,64
1658089443215,COGS 11,A01,083617,Boyle; Mary E. T.,23,0,48,25
1658089449241,COGS 13,A01,083071,Bastos; Amalia Pinkusfeld,12,0,71,59
1658089455268,COGS 14A,A01,092681,Semenuks; Arturs,5,1,100,95
1658089461292,COGS 14B,A01,083073,Cheng; Tzu-Han,7,0,63,56
1658089467404,COGS 17,A01,092677,Semenuks; Arturs,7,0,81,74
1658089473428,COGS 100,A01,083619,Allen; Michael Gordon,17,0,70,53
1658089479452,COGS 101A,A01,083621,Davis; Joshua Daniel,9,0,68,59
1658089485476,COGS 101B,A01,091572,Allen; Michael Gordon,14,0,65,51
1658089491498,COGS 101C,A01,083625,Delgado; Tania,17,0,35,18
1658089497522,COGS 107A,A01,083627,Boyle; Mary E. T.,14,0,60,46
1658089503549,COGS 118A,A01,083075,Gupta; Anjum,21,0,76,55
1658089509575,CSE 3,A50,083646,Miranda; Gregory Joseph,24,0,50,26
1658089515601,CSE 8A,A50,083650,Miranda; Gregory Joseph,17,1,56,39
1658089521629,CSE 11,A01,083080,Cao; Yingjun,7,15,40,33
1658089527657,CSE 12,A01,083652,Krause-Levy; Sophia Louisa,30,1,120,90
1658089533680,CSE 15L,A01,083654,Morris; Justin Loren,9,0,50,41
1658089533680,CSE 15L,A02,083655,Morris; Justin Loren,11,0,50,39
1658089539706,CSE 20,A01,083657,Tran; Khoa Dang,39,0,80,41
1658089545729,CSE 21,A01,095574,Bach; Quang Tran,23,0,48,25
1658089551754,CSE 30,A01,083084,Eldon; John,8,0,80,72
1658089551754,CSE 30,B01,095061,Bhaskar; Nishant,9,0,50,41
1658089557776,CSE 100,A01,083659,Cao; Yingjun,5,4,70,65
1658089563803,CSE 134B,A01,083661,Powell; Thomas Allan,25,0,100,75
1658089569828,CSE 140,A01,083663,Gungor; Onat,17,0,85,68
1658089575855,CSE 140L,A01,083088,Eldon; John,23,0,100,77
1658089581879,CSE 175,A01,083665,Kumar; Rakesh,3,0,25,22
1658089587902,CSE 190,A00,092507,Dubnov; Shlomo,8,0,20,12
1658089593928,ECE 45,A01,083139,Congero; Spencer William,7,0,75,68
1658089599956,ECE 65,A50,083695,Saad; Andrew S,12,0,30,18
1658089599956,ECE 65,A51,095125,Saad; Andrew S,24,0,26,2
1658089605989,ECE 109,A01,091882,Touri; Behrouz,21,0,70,49
1658089612012,ECE 180,A00,083140,Abi Samra; Nicholas Camill,1,0,30,29
1658089612012,ECE 180,B00,083141,Abi Samra; Nicholas Camill,0,0,30,30
1658089618042,MATH 10A,A01,083735,Patchell; Gregory David,2,0,30,28
1658089618042,MATH 10A,A02,083736,Patchell; Gregory David,20,0,30,10
1658089618042,MATH 10A,A03,083737,Patchell; Gregory David,16,0,30,14
1658089624064,MATH 10B,A01,083207,Lim; Seonhee,9,0,34,25
1658089624064,MATH 10B,A02,083208,Lim; Seonhee,10,0,35,25
1658089624064,MATH 10B,A03,093472,Lim; Seonhee,7,0,34,27
1658089624064,MATH 10B,B01,083739,Sinha; Shubham,14,0,30,16
1658089630102,MATH 18,A01,083743,Cinel; Cameron Alexander,9,0,30,21
1658089630102,MATH 18,A02,083744,Cinel; Cameron Alexander,18,0,30,12
1658089630102,MATH 18,A03,083745,Cinel; Cameron Alexander,10,0,30,20
1658089630102,MATH 18,B01,083748,Rideout; David Porter,5,0,37,32
1658089630102,MATH 18,B02,083749,Rideout; David Porter,5,0,36,31
1658089630102,MATH 18,B03,083750,Rideout; David Porter,3,0,37,34
1658089630102,MATH 18,B04,083751,Rideout; David Porter,7,0,36,29
1658089630102,MATH 18,B05,093473,Rideout; David Porter,7,0,36,29
1658089630102,MATH 18,B06,093474,Rideout; David Porter,6,0,36,30
1658089636126,MATH 20A,A01,083754,Zheng; Zequn,14,0,40,26
1658089642151,MATH 20B,A01,083756,Briones; Jor-el Thomas Caparas,4,0,36,32
1658089642151,MATH 20B,A02,083757,Briones; Jor-el Thomas Caparas,1,0,36,35
1658089642151,MATH 20B,A03,093475,Briones; Jor-el Thomas Caparas,3,0,36,33
1658089648177,MATH 20C,A01,083760,Briones; Jor-el Thomas Caparas,1,0,35,34
1658089648177,MATH 20C,A02,083761,Briones; Jor-el Thomas Caparas,8,0,35,27
1658089648177,MATH 20C,A03,093476,Briones; Jor-el Thomas Caparas,0,1,36,36
1658089648177,MATH 20C,B01,083762,Bach; Quang Tran,1,0,30,29
1658089654202,MATH 20D,A01,083765,Tran; Brian Kha,5,0,30,25
1658089654202,MATH 20D,A02,083766,Tran; Brian Kha,5,0,30,25
1658089654202,MATH 20D,A03,083767,Tran; Brian Kha,6,0,30,24
1658089660225,MATH 20E,A01,083771,Ganguly; Soumya,12,0,32,20
1658089660225,MATH 20E,A02,083772,Ganguly; Soumya,7,0,32,25
1658089660225,MATH 20E,B01,083773,Ciotti; Benjamin,20,0,35,15
1658089660225,MATH 20E,B02,083774,Ciotti; Benjamin,18,0,35,17
1658089666254,MATH 103A,A01,083777,Greenfeld; Be'Eri,6,0,36,30
1658089666254,MATH 103A,A02,083778,Greenfeld; Be'Eri,5,0,36,31
1658089666254,MATH 103A,A03,093561,Greenfeld; Be'Eri,7,0,36,29
1658089666254,MATH 103A,B01,083779,Greenfeld; Be'Eri,8,0,36,28
1658089666254,MATH 103A,B02,083780,Greenfeld; Be'Eri,4,0,36,32
1658089666254,MATH 103A,B03,093562,Greenfeld; Be'Eri,3,0,36,33
1658089672277,MATH 105,A01,085443,Carter; Anne Toulson,15,0,35,20
1658089672277,MATH 105,A02,093477,Carter; Anne Toulson,20,0,35,15
1658089678301,MATH 109,A01,083213,Ganzberger; Geoffrey Michael,3,0,34,31
1658089678301,MATH 109,A02,083214,Ganzberger; Geoffrey Michael,4,0,34,30
1658089678301,MATH 109,A03,093478,Ganzberger; Geoffrey Michael,2,0,34,32
1658089678301,MATH 109,B01,083215,Ganzberger; Geoffrey Michael,3,0,32,29
1658089678301,MATH 109,B02,083216,Ganzberger; Geoffrey Michael,3,0,32,29
1658089678301,MATH 109,B03,093479,Ganzberger; Geoffrey Michael,8,0,32,24
1658089684329,MATH 142A,A01,083219,Chow; Bennett,7,0,32,25
1658089684329,MATH 142A,A02,083220,Chow; Bennett,10,0,32,22
1658089684329,MATH 142A,A03,093480,Chow; Bennett,9,0,32,23
1658089684329,MATH 142A,B03,093481,Chow; Bennett,8,0,32,24
1658089684329,MATH 142A,B04,093558,Chow; Bennett,14,0,32,18
1658089684329,MATH 142A,B05,093559,Chow; Bennett,7,0,32,25
1658089690359,MATH 193A,A01,083224,Rotar; Vladimir,9,0,34,25
1658089690359,MATH 193A,A02,083225,Rotar; Vladimir,11,0,34,23
1658089690359,MATH 193A,A03,083781,Rotar; Vladimir,5,0,34,29
1658089690359,MATH 193A,A04,083782,Rotar; Vladimir,12,0,34,22
1658089690359,MATH 193A,A05,093482,Rotar; Vladimir,11,0,34,23
1658089696385,MATH 197,001,091859,McAuley; Julian John,9999,0,9999,0
1658089696385,MATH 197,002,095566,Kedlaya; Kiran S.,9997,0,9999,2
1658089696385,MATH 197,003,095567,Xiao; Ming,9999,0,9999,0
1658089696385,MATH 197,004,095571,Perols; Johan Lars,9998,0,9999,1
1658089703440,COGS 9,A01,083615,Shannon; Kyle Michael,11,0,75,64
1658089709463,COGS 11,A01,083617,Boyle; Mary E. T.,23,0,48,25
1658089715491,COGS 13,A01,083071,Bastos; Amalia Pinkusfeld,12,0,71,59
1658089721515,COGS 14A,A01,092681,Semenuks; Arturs,5,1,100,95
1658089727543,COGS 14B,A01,083073,Cheng; Tzu-Han,7,0,63,56
1658089733570,COGS 17,A01,092677,Semenuks; Arturs,7,0,81,74
1658089739596,COGS 100,A01,083619,Allen; Michael Gordon,17,0,70,53
1658089745624,COGS 101A,A01,083621,Davis; Joshua Daniel,9,0,68,59
1658089751652,COGS 101B,A01,091572,Allen; Michael Gordon,14,0,65,51
1658089757679,COGS 101C,A01,083625,Delgado; Tania,17,0,35,18
1658089763703,COGS 107A,A01,083627,Boyle; Mary E. T.,14,0,60,46
1658089769726,COGS 118A,A01,083075,Gupta; Anjum,21,0,76,55
1658089775753,CSE 3,A50,083646,Miranda; Gregory Joseph,24,0,50,26
1658089781777,CSE 8A,A50,083650,Miranda; Gregory Joseph,17,1,56,39
1658089787814,CSE 11,A01,083080,Cao; Yingjun,7,15,40,33
1658089793839,CSE 12,A01,083652,Krause-Levy; Sophia Louisa,30,1,120,90
1658089799863,CSE 15L,A01,083654,Morris; Justin Loren,9,0,50,41
1658089799863,CSE 15L,A02,083655,Morris; Justin Loren,11,0,50,39
1658089805887,CSE 20,A01,083657,Tran; Khoa Dang,39,0,80,41
1658089811910,CSE 21,A01,095574,Bach; Quang Tran,23,0,48,25
1658089817933,CSE 30,A01,083084,Eldon; John,8,0,80,72
1658089817933,CSE 30,B01,095061,Bhaskar; Nishant,9,0,50,41
1658089823956,CSE 100,A01,083659,Cao; Yingjun,5,4,70,65
1658089829982,CSE 134B,A01,083661,Powell; Thomas Allan,25,0,100,75
1658089836008,CSE 140,A01,083663,Gungor; Onat,17,0,85,68
1658089842033,CSE 140L,A01,083088,Eldon; John,23,0,100,77
1658089848057,CSE 175,A01,083665,Kumar; Rakesh,3,0,25,22
1658089854080,CSE 190,A00,092507,Dubnov; Shlomo,8,0,20,12
1658089860108,ECE 45,A01,083139,Congero; Spencer William,7,0,75,68
1658089866135,ECE 65,A50,083695,Saad; Andrew S,12,0,30,18
1658089866135,ECE 65,A51,095125,Saad; Andrew S,24,0,26,2
1658089872158,ECE 109,A01,091882,Touri; Behrouz,21,0,70,49
1658089878181,ECE 180,A00,083140,Abi Samra; Nicholas Camill,1,0,30,29
1658089878181,ECE 180,B00,083141,Abi Samra; Nicholas Camill,0,0,30,30
1658089884204,MATH 10A,A01,083735,Patchell; Gregory David,2,0,30,28
1658089884204,MATH 10A,A02,083736,Patchell; Gregory David,20,0,30,10
1658089884204,MATH 10A,A03,083737,Patchell; Gregory David,16,0,30,14
1658089890237,MATH 10B,A01,083207,Lim; Seonhee,9,0,34,25
1658089890237,MATH 10B,A02,083208,Lim; Seonhee,10,0,35,25
1658089890237,MATH 10B,A03,093472,Lim; Seonhee,7,0,34,27
1658089890237,MATH 10B,B01,083739,Sinha; Shubham,14,0,30,16
1658089896269,MATH 18,A01,083743,Cinel; Cameron Alexander,9,0,30,21
1658089896269,MATH 18,A02,083744,Cinel; Cameron Alexander,18,0,30,12
1658089896269,MATH 18,A03,083745,Cinel; Cameron Alexander,10,0,30,20
1658089896269,MATH 18,B01,083748,Rideout; David Porter,5,0,37,32
1658089896269,MATH 18,B02,083749,Rideout; David Porter,5,0,36,31
1658089896269,MATH 18,B03,083750,Rideout; David Porter,3,0,37,34
1658089896269,MATH 18,B04,083751,Rideout; David Porter,7,0,36,29
1658089896269,MATH 18,B05,093473,Rideout; David Porter,7,0,36,29
1658089896269,MATH 18,B06,093474,Rideout; David Porter,6,0,36,30
1658089902295,MATH 20A,A01,083754,Zheng; Zequn,14,0,40,26
1658089908322,MATH 20B,A01,083756,Briones; Jor-el Thomas Caparas,4,0,36,32
1658089908322,MATH 20B,A02,083757,Briones; Jor-el Thomas Caparas,1,0,36,35
1658089908322,MATH 20B,A03,093475,Briones; Jor-el Thomas Caparas,3,0,36,33
1658089914349,MATH 20C,A01,083760,Briones; Jor-el Thomas Caparas,1,0,35,34
1658089914349,MATH 20C,A02,083761,Briones; Jor-el Thomas Caparas,8,0,35,27
1658089914349,MATH 20C,A03,093476,Briones; Jor-el Thomas Caparas,0,1,36,36
1658089914349,MATH 20C,B01,083762,Bach; Quang Tran,1,0,30,29
1658089920378,MATH 20D,A01,083765,Tran; Brian Kha,5,0,30,25
1658089920378,MATH 20D,A02,083766,Tran; Brian Kha,5,0,30,25
1658089920378,MATH 20D,A03,083767,Tran; Brian Kha,6,0,30,24
1658089926402,MATH 20E,A01,083771,Ganguly; Soumya,12,0,32,20
1658089926402,MATH 20E,A02,083772,Ganguly; Soumya,7,0,32,25
1658089926402,MATH 20E,B01,083773,Ciotti; Benjamin,20,0,35,15
1658089926402,MATH 20E,B02,083774,Ciotti; Benjamin,18,0,35,17
1658089932432,MATH 103A,A01,083777,Greenfeld; Be'Eri,6,0,36,30
1658089932432,MATH 103A,A02,083778,Greenfeld; Be'Eri,5,0,36,31
1658089932432,MATH 103A,A03,093561,Greenfeld; Be'Eri,7,0,36,29
1658089932432,MATH 103A,B01,083779,Greenfeld; Be'Eri,8,0,36,28
1658089932432,MATH 103A,B02,083780,Greenfeld; Be'Eri,4,0,36,32
1658089932432,MATH 103A,B03,093562,Greenfeld; Be'Eri,3,0,36,33
1658089938459,MATH 105,A01,085443,Carter; Anne Toulson,15,0,35,20
1658089938459,MATH 105,A02,093477,Carter; Anne Toulson,20,0,35,15
1658089944482,MATH 109,A01,083213,Ganzberger; Geoffrey Michael,3,0,34,31
1658089944482,MATH 109,A02,083214,Ganzberger; Geoffrey Michael,4,0,34,30
1658089944482,MATH 109,A03,093478,Ganzberger; Geoffrey Michael,2,0,34,32
1658089944482,MATH 109,B01,083215,Ganzberger; Geoffrey Michael,3,0,32,29
1658089944482,MATH 109,B02,083216,Ganzberger; Geoffrey Michael,3,0,32,29
1658089944482,MATH 109,B03,093479,Ganzberger; Geoffrey Michael,8,0,32,24
1658089950507,MATH 142A,A01,083219,Chow; Bennett,7,0,32,25
1658089950507,MATH 142A,A02,083220,Chow; Bennett,10,0,32,22
1658089950507,MATH 142A,A03,093480,Chow; Bennett,9,0,32,23
1658089950507,MATH 142A,B03,093481,Chow; Bennett,8,0,32,24
1658089950507,MATH 142A,B04,093558,Chow; Bennett,14,0,32,18
1658089950507,MATH 142A,B05,093559,Chow; Bennett,7,0,32,25
1658089956533,MATH 193A,A01,083224,Rotar; Vladimir,9,0,34,25
1658089956533,MATH 193A,A02,083225,Rotar; Vladimir,11,0,34,23
1658089956533,MATH 193A,A03,083781,Rotar; Vladimir,5,0,34,29
1658089956533,MATH 193A,A04,083782,Rotar; Vladimir,12,0,34,22
1658089956533,MATH 193A,A05,093482,Rotar; Vladimir,11,0,34,23
1658089962558,MATH 197,001,091859,McAuley; Julian John,9999,0,9999,0
1658089962558,MATH 197,002,095566,Kedlaya; Kiran S.,9997,0,9999,2
1658089962558,MATH 197,003,095567,Xiao; Ming,9999,0,9999,0
1658089962558,MATH 197,004,095571,Perols; Johan Lars,9998,0,9999,1
1658089969622,COGS 9,A01,083615,Shannon; Kyle Michael,11,0,75,64
1658089975647,COGS 11,A01,083617,Boyle; Mary E. T.,23,0,48,25
1658089981670,COGS 13,A01,083071,Bastos; Amalia Pinkusfeld,12,0,71,59
1658089987691,COGS 14A,A01,092681,Semenuks; Arturs,5,1,100,95
1658089993716,COGS 14B,A01,083073,Cheng; Tzu-Han,7,0,63,56
1658089999739,COGS 17,A01,092677,Semenuks; Arturs,7,0,81,74
1658090005761,COGS 100,A01,083619,Allen; Michael Gordon,17,0,70,53
1658090011789,COGS 101A,A01,083621,Davis; Joshua Daniel,9,0,68,59
1658090017813,COGS 101B,A01,091572,Allen; Michael Gordon,14,0,65,51
1658090023843,COGS 101C,A01,083625,Delgado; Tania,17,0,35,18
1658090029868,COGS 107A,A01,083627,Boyle; Mary E. T.,14,0,60,46
1658090035892,COGS 118A,A01,083075,Gupta; Anjum,21,0,76,55
1658090041925,CSE 3,A50,083646,Miranda; Gregory Joseph,24,0,50,26
1658090047948,CSE 8A,A50,083650,Miranda; Gregory Joseph,17,1,56,39
1658090053975,CSE 11,A01,083080,Cao; Yingjun,7,15,40,33
1658090060003,CSE 12,A01,083652,Krause-Levy; Sophia Louisa,30,1,120,90
1658090066100,CSE 15L,A01,083654,Morris; Justin Loren,9,0,50,41
1658090066100,CSE 15L,A02,083655,Morris; Justin Loren,11,0,50,39
1658090072124,CSE 20,A01,083657,Tran; Khoa Dang,39,0,80,41
1658090078151,CSE 21,A01,095574,Bach; Quang Tran,23,0,48,25
1658090084182,CSE 30,A01,083084,Eldon; John,8,0,80,72
1658090084182,CSE 30,B01,095061,Bhaskar; Nishant,9,0,50,41
1658090090206,CSE 100,A01,083659,Cao; Yingjun,5,4,70,65
1658090096229,CSE 134B,A01,083661,Powell; Thomas Allan,25,0,100,75
1658090102256,CSE 140,A01,083663,Gungor; Onat,17,0,85,68
1658090108279,CSE 140L,A01,083088,Eldon; John,23,0,100,77
1658090114303,CSE 175,A01,083665,Kumar; Rakesh,3,0,25,22
1658090120329,CSE 190,A00,092507,Dubnov; Shlomo,8,0,20,12
1658090126356,ECE 45,A01,083139,Congero; Spencer William,7,0,75,68
1658090132381,ECE 65,A50,083695,Saad; Andrew S,12,0,30,18
1658090132381,ECE 65,A51,095125,Saad; Andrew S,24,0,26,2
1658090138404,ECE 109,A01,091882,Touri; Behrouz,21,0,70,49
1658090144428,ECE 180,A00,083140,Abi Samra; Nicholas Camill,1,0,30,29
1658090144428,ECE 180,B00,083141,Abi Samra; Nicholas Camill,0,0,30,30
1658090150455,MATH 10A,A01,083735,Patchell; Gregory David,2,0,30,28
1658090150455,MATH 10A,A02,083736,Patchell; Gregory David,20,0,30,10
1658090150455,MATH 10A,A03,083737,Patchell; Gregory David,16,0,30,14
1658090156485,MATH 10B,A01,083207,Lim; Seonhee,9,0,34,25
1658090156485,MATH 10B,A02,083208,Lim; Seonhee,10,0,35,25
1658090156485,MATH 10B,A03,093472,Lim; Seonhee,7,0,34,27
1658090156485,MATH 10B,B01,083739,Sinha; Shubham,14,0,30,16
1658090162516,MATH 18,A01,083743,Cinel; Cameron Alexander,9,0,30,21
1658090162516,MATH 18,A02,083744,Cinel; Cameron Alexander,18,0,30,12
1658090162516,MATH 18,A03,083745,Cinel; Cameron Alexander,10,0,30,20
1658090162516,MATH 18,B01,083748,Rideout; David Porter,5,0,37,32
1658090162516,MATH 18,B02,083749,Rideout; David Porter,5,0,36,31
1658090162516,MATH 18,B03,083750,Rideout; David Porter,3,0,37,34
1658090162516,MATH 18,B04,083751,Rideout; David Porter,7,0,36,29
1658090162516,MATH 18,B05,093473,Rideout; David Porter,7,0,36,29
1658090162516,MATH 18,B06,093474,Rideout; David Porter,6,0,36,30
1658090168541,MATH 20A,A01,083754,Zheng; Zequn,14,0,40,26
1658090174563,MATH 20B,A01,083756,Briones; Jor-el Thomas Caparas,4,0,36,32
1658090174563,MATH 20B,A02,083757,Briones; Jor-el Thomas Caparas,1,0,36,35
1658090174563,MATH 20B,A03,093475,Briones; Jor-el Thomas Caparas,3,0,36,33
1658090180586,MATH 20C,A01,083760,Briones; Jor-el Thomas Caparas,1,0,35,34
1658090180586,MATH 20C,A02,083761,Briones; Jor-el Thomas Caparas,8,0,35,27
1658090180586,MATH 20C,A03,093476,Briones; Jor-el Thomas Caparas,0,1,36,36
1658090180586,MATH 20C,B01,083762,Bach; Quang Tran,1,0,30,29
1658090186614,MATH 20D,A01,083765,Tran; Brian Kha,5,0,30,25
1658090186614,MATH 20D,A02,083766,Tran; Brian Kha,5,0,30,25
1658090186614,MATH 20D,A03,083767,Tran; Brian Kha,6,0,30,24
1658090192638,MATH 20E,A01,083771,Ganguly; Soumya,12,0,32,20
1658090192638,MATH 20E,A02,083772,Ganguly; Soumya,7,0,32,25
1658090192638,MATH 20E,B01,083773,Ciotti; Benjamin,20,0,35,15
1658090192638,MATH 20E,B02,083774,Ciotti; Benjamin,18,0,35,17
1658090198663,MATH 103A,A01,083777,Greenfeld; Be'Eri,6,0,36,30
1658090198663,MATH 103A,A02,083778,Greenfeld; Be'Eri,5,0,36,31
1658090198663,MATH 103A,A03,093561,Greenfeld; Be'Eri,7,0,36,29
1658090198663,MATH 103A,B01,083779,Greenfeld; Be'Eri,8,0,36,28
1658090198663,MATH 103A,B02,083780,Greenfeld; Be'Eri,4,0,36,32
1658090198663,MATH 103A,B03,093562,Greenfeld; Be'Eri,3,0,36,33
1658090204690,MATH 105,A01,085443,Carter; Anne Toulson,15,0,35,20
1658090204690,MATH 105,A02,093477,Carter; Anne Toulson,20,0,35,15
1658090210726,MATH 109,A01,083213,Ganzberger; Geoffrey Michael,3,0,34,31
1658090210726,MATH 109,A02,083214,Ganzberger; Geoffrey Michael,4,0,34,30
1658090210726,MATH 109,A03,093478,Ganzberger; Geoffrey Michael,2,0,34,32
1658090210726,MATH 109,B01,083215,Ganzberger; Geoffrey Michael,3,0,32,29
1658090210726,MATH 109,B02,083216,Ganzberger; Geoffrey Michael,3,0,32,29
1658090210726,MATH 109,B03,093479,Ganzberger; Geoffrey Michael,8,0,32,24
1658090216751,MATH 142A,A01,083219,Chow; Bennett,7,0,32,25
1658090216751,MATH 142A,A02,083220,Chow; Bennett,10,0,32,22
1658090216751,MATH 142A,A03,093480,Chow; Bennett,9,0,32,23
1658090216751,MATH 142A,B03,093481,Chow; Bennett,8,0,32,24
1658090216751,MATH 142A,B04,093558,Chow; Bennett,14,0,32,18
1658090216751,MATH 142A,B05,093559,Chow; Bennett,7,0,32,25
1658090222775,MATH 193A,A01,083224,Rotar; Vladimir,9,0,34,25
1658090222775,MATH 193A,A02,083225,Rotar; Vladimir,11,0,34,23
1658090222775,MATH 193A,A03,083781,Rotar; Vladimir,5,0,34,29
1658090222775,MATH 193A,A04,083782,Rotar; Vladimir,12,0,34,22
1658090222775,MATH 193A,A05,093482,Rotar; Vladimir,11,0,34,23
1658090228802,MATH 197,001,091859,McAuley; Julian John,9999,0,9999,0
1658090228802,MATH 197,002,095566,Kedlaya; Kiran S.,9997,0,9999,2
1658090228802,MATH 197,003,095567,Xiao; Ming,9999,0,9999,0
1658090228802,MATH 197,004,095571,Perols; Johan Lars,9998,0,9999,1
1658090235853,COGS 9,A01,083615,Shannon; Kyle Michael,11,0,75,64
1658090241879,COGS 11,A01,083617,Boyle; Mary E. T.,23,0,48,25
1658090247906,COGS 13,A01,083071,Bastos; Amalia Pinkusfeld,12,0,71,59
1658090253931,COGS 14A,A01,092681,Semenuks; Arturs,5,1,100,95
1658090259955,COGS 14B,A01,083073,Cheng; Tzu-Han,7,0,63,56
1658090265978,COGS 17,A01,092677,Semenuks; Arturs,7,0,81,74
1658090272001,COGS 100,A01,083619,Allen; Michael Gordon,17,0,70,53
1658090278030,COGS 101A,A01,083621,Davis; Joshua Daniel,9,0,68,59
1658090284052,COGS 101B,A01,091572,Allen; Michael Gordon,14,0,65,51
1658090290078,COGS 101C,A01,083625,Delgado; Tania,17,0,35,18
1658090296109,COGS 107A,A01,083627,Boyle; Mary E. T.,14,0,60,46
1658090302140,COGS 118A,A01,083075,Gupta; Anjum,21,0,76,55
1658090308163,CSE 3,A50,083646,Miranda; Gregory Joseph,24,0,50,26
1658090314185,CSE 8A,A50,083650,Miranda; Gregory Joseph,17,1,56,39
1658090320208,CSE 11,A01,083080,Cao; Yingjun,7,15,40,33
1658090326234,CSE 12,A01,083652,Krause-Levy; Sophia Louisa,30,1,120,90
1658090332260,CSE 15L,A01,083654,Morris; Justin Loren,9,0,50,41
1658090332260,CSE 15L,A02,083655,Morris; Justin Loren,11,0,50,39
1658090338283,CSE 20,A01,083657,Tran; Khoa Dang,39,0,80,41
1658090344310,CSE 21,A01,095574,Bach; Quang Tran,23,0,48,25
1658090350335,CSE 30,A01,083084,Eldon; John,8,0,80,72
1658090350335,CSE 30,B01,095061,Bhaskar; Nishant,9,0,50,41
1658090356358,CSE 100,A01,083659,Cao; Yingjun,5,4,70,65
1658090362381,CSE 134B,A01,083661,Powell; Thomas Allan,25,0,100,75
1658090368403,CSE 140,A01,083663,Gungor; Onat,17,0,85,68
1658090374432,CSE 140L,A01,083088,Eldon; John,23,0,100,77
1658090380463,CSE 175,A01,083665,Kumar; Rakesh,3,0,25,22
1658090386490,CSE 190,A00,092507,Dubnov; Shlomo,8,0,20,12
1658090392513,ECE 45,A01,083139,Congero; Spencer William,7,0,75,68
1658090398546,ECE 65,A50,083695,Saad; Andrew S,12,0,30,18
1658090398546,ECE 65,A51,095125,Saad; Andrew S,24,0,26,2
1658090404569,ECE 109,A01,091882,Touri; Behrouz,21,0,70,49
1658090410592,ECE 180,A00,083140,Abi Samra; Nicholas Camill,1,0,30,29
1658090410592,ECE 180,B00,083141,Abi Samra; Nicholas Camill,0,0,30,30
1658090416619,MATH 10A,A01,083735,Patchell; Gregory David,2,0,30,28
1658090416619,MATH 10A,A02,083736,Patchell; Gregory David,20,0,30,10
1658090416619,MATH 10A,A03,083737,Patchell; Gregory David,16,0,30,14
1658090422647,MATH 10B,A01,083207,Lim; Seonhee,9,0,34,25
1658090422647,MATH 10B,A02,083208,Lim; Seonhee,10,0,35,25
1658090422647,MATH 10B,A03,093472,Lim; Seonhee,7,0,34,27
1658090422647,MATH 10B,B01,083739,Sinha; Shubham,14,0,30,16
1658090428677,MATH 18,A01,083743,Cinel; Cameron Alexander,9,0,30,21
1658090428677,MATH 18,A02,083744,Cinel; Cameron Alexander,18,0,30,12
1658090428677,MATH 18,A03,083745,Cinel; Cameron Alexander,10,0,30,20
1658090428677,MATH 18,B01,083748,Rideout; David Porter,5,0,37,32
1658090428677,MATH 18,B02,083749,Rideout; David Porter,5,0,36,31
1658090428677,MATH 18,B03,083750,Rideout; David Porter,3,0,37,34
1658090428677,MATH 18,B04,083751,Rideout; David Porter,7,0,36,29
1658090428677,MATH 18,B05,093473,Rideout; David Porter,7,0,36,29
1658090428677,MATH 18,B06,093474,Rideout; David Porter,6,0,36,30
1658090434701,MATH 20A,A01,083754,Zheng; Zequn,14,0,40,26
1658090440729,MATH 20B,A01,083756,Briones; Jor-el Thomas Caparas,4,0,36,32
1658090440729,MATH 20B,A02,083757,Briones; Jor-el Thomas Caparas,1,0,36,35
1658090440729,MATH 20B,A03,093475,Briones; Jor-el Thomas Caparas,3,0,36,33
1658090446753,MATH 20C,A01,083760,Briones; Jor-el Thomas Caparas,1,0,35,34
1658090446753,MATH 20C,A02,083761,Briones; Jor-el Thomas Caparas,8,0,35,27
1658090446753,MATH 20C,A03,093476,Briones; Jor-el Thomas Caparas,0,1,36,36
1658090446753,MATH 20C,B01,083762,Bach; Quang Tran,1,0,30,29
1658090452780,MATH 20D,A01,083765,Tran; Brian Kha,5,0,30,25
1658090452780,MATH 20D,A02,083766,Tran; Brian Kha,5,0,30,25
1658090452780,MATH 20D,A03,083767,Tran; Brian Kha,6,0,30,24
1658090458803,MATH 20E,A01,083771,Ganguly; Soumya,12,0,32,20
1658090458803,MATH 20E,A02,083772,Ganguly; Soumya,7,0,32,25
1658090458803,MATH 20E,B01,083773,Ciotti; Benjamin,20,0,35,15
1658090458803,MATH 20E,B02,083774,Ciotti; Benjamin,18,0,35,17
1658090464826,MATH 103A,A01,083777,Greenfeld; Be'Eri,6,0,36,30
1658090464826,MATH 103A,A02,083778,Greenfeld; Be'Eri,5,0,36,31
1658090464826,MATH 103A,A03,093561,Greenfeld; Be'Eri,7,0,36,29
1658090464826,MATH 103A,B01,083779,Greenfeld; Be'Eri,8,0,36,28
1658090464826,MATH 103A,B02,083780,Greenfeld; Be'Eri,4,0,36,32
1658090464826,MATH 103A,B03,093562,Greenfeld; Be'Eri,3,0,36,33
1658090470847,MATH 105,A01,085443,Carter; Anne Toulson,15,0,35,20
1658090470847,MATH 105,A02,093477,Carter; Anne Toulson,20,0,35,15
1658090476871,MATH 109,A01,083213,Ganzberger; Geoffrey Michael,3,0,34,31
1658090476871,MATH 109,A02,083214,Ganzberger; Geoffrey Michael,4,0,34,30
1658090476871,MATH 109,A03,093478,Ganzberger; Geoffrey Michael,2,0,34,32
1658090476871,MATH 109,B01,083215,Ganzberger; Geoffrey Michael,3,0,32,29
1658090476871,MATH 109,B02,083216,Ganzberger; Geoffrey Michael,3,0,32,29
1658090476871,MATH 109,B03,093479,Ganzberger; Geoffrey Michael,8,0,32,24
1658090482894,MATH 142A,A01,083219,Chow; Bennett,7,0,32,25
1658090482894,MATH 142A,A02,083220,Chow; Bennett,10,0,32,22
1658090482894,MATH 142A,A03,093480,Chow; Bennett,9,0,32,23
1658090482894,MATH 142A,B03,093481,Chow; Bennett,8,0,32,24
1658090482894,MATH 142A,B04,093558,Chow; Bennett,14,0,32,18
1658090482894,MATH 142A,B05,093559,Chow; Bennett,7,0,32,25
1658090488923,MATH 193A,A01,083224,Rotar; Vladimir,9,0,34,25
1658090488923,MATH 193A,A02,083225,Rotar; Vladimir,11,0,34,23
1658090488923,MATH 193A,A03,083781,Rotar; Vladimir,5,0,34,29
1658090488923,MATH 193A,A04,083782,Rotar; Vladimir,12,0,34,22
1658090488923,MATH 193A,A05,093482,Rotar; Vladimir,11,0,34,23
1658090494946,MATH 197,001,091859,McAuley; Julian John,9999,0,9999,0
1658090494946,MATH 197,002,095566,Kedlaya; Kiran S.,9997,0,9999,2
1658090494946,MATH 197,003,095567,Xiao; Ming,9999,0,9999,0
1658090494946,MATH 197,004,095571,Perols; Johan Lars,9998,0,9999,1
1658090502006,COGS 9,A01,083615,Shannon; Kyle Michael,11,0,75,64
1658090508029,COGS 11,A01,083617,Boyle; Mary E. T.,23,0,48,25
1658090514056,COGS 13,A01,083071,Bastos; Amalia Pinkusfeld,12,0,71,59
1658090520085,COGS 14A,A01,092681,Semenuks; Arturs,5,1,100,95
1658090526112,COGS 14B,A01,083073,Cheng; Tzu-Han,7,0,63,56
1658090532136,COGS 17,A01,092677,Semenuks; Arturs,7,0,81,74
1658090538161,COGS 100,A01,083619,Allen; Michael Gordon,17,0,70,53
1658090544184,COGS 101A,A01,083621,Davis; Joshua Daniel,9,0,68,59
1658090550206,COGS 101B,A01,091572,Allen; Michael Gordon,14,0,65,51
1658090556232,COGS 101C,A01,083625,Delgado; Tania,17,0,35,18
1658090562258,COGS 107A,A01,083627,Boyle; Mary E. T.,14,0,60,46
1658090568283,COGS 118A,A01,083075,Gupta; Anjum,21,0,76,55
1658090574307,CSE 3,A50,083646,Miranda; Gregory Joseph,24,0,50,26
1658090580339,CSE 8A,A50,083650,Miranda; Gregory Joseph,17,1,56,39
1658090586362,CSE 11,A01,083080,Cao; Yingjun,7,15,40,33
1658090592385,CSE 12,A01,083652,Krause-Levy; Sophia Louisa,30,1,120,90
1658090598407,CSE 15L,A01,083654,Morris; Justin Loren,9,0,50,41
1658090598407,CSE 15L,A02,083655,Morris; Justin Loren,11,0,50,39
1658090604433,CSE 20,A01,083657,Tran; Khoa Dang,39,0,80,41
1658090610456,CSE 21,A01,095574,Bach; Quang Tran,23,0,48,25
1658090616479,CSE 30,A01,083084,Eldon; John,8,0,80,72
1658090616479,CSE 30,B01,095061,Bhaskar; Nishant,9,0,50,41
1658090622502,CSE 100,A01,083659,Cao; Yingjun,5,4,70,65
1658090628525,CSE 134B,A01,083661,Powell; Thomas Allan,25,0,100,75
1658090634550,CSE 140,A01,083663,Gungor; Onat,17,0,85,68
1658090640579,CSE 140L,A01,083088,Eldon; John,23,0,100,77
1658090646604,CSE 175,A01,083665,Kumar; Rakesh,3,0,25,22
1658090652626,CSE 190,A00,092507,Dubnov; Shlomo,8,0,20,12
1658090658650,ECE 45,A01,083139,Congero; Spencer William,7,0,75,68
1658090664745,ECE 65,A50,083695,Saad; Andrew S,12,0,30,18
1658090664745,ECE 65,A51,095125,Saad; Andrew S,24,0,26,2
1658090670772,ECE 109,A01,091882,Touri; Behrouz,21,0,70,49
1658090676794,ECE 180,A00,083140,Abi Samra; Nicholas Camill,1,0,30,29
1658090676794,ECE 180,B00,083141,Abi Samra; Nicholas Camill,0,0,30,30
1658090682823,MATH 10A,A01,083735,Patchell; Gregory David,2,0,30,28
1658090682823,MATH 10A,A02,083736,Patchell; Gregory David,20,0,30,10
1658090682823,MATH 10A,A03,083737,Patchell; Gregory David,16,0,30,14
1658090688850,MATH 10B,A01,083207,Lim; Seonhee,9,0,34,25
1658090688850,MATH 10B,A02,083208,Lim; Seonhee,10,0,35,25
1658090688850,MATH 10B,A03,093472,Lim; Seonhee,7,0,34,27
1658090688850,MATH 10B,B01,083739,Sinha; Shubham,14,0,30,16
1658090694875,MATH 18,A01,083743,Cinel; Cameron Alexander,9,0,30,21
1658090694875,MATH 18,A02,083744,Cinel; Cameron Alexander,18,0,30,12
1658090694875,MATH 18,A03,083745,Cinel; Cameron Alexander,10,0,30,20
1658090694875,MATH 18,B01,083748,Rideout; David Porter,5,0,37,32
1658090694875,MATH 18,B02,083749,Rideout; David Porter,5,0,36,31
1658090694875,MATH 18,B03,083750,Rideout; David Porter,3,0,37,34
1658090694875,MATH 18,B04,083751,Rideout; David Porter,7,0,36,29
1658090694875,MATH 18,B05,093473,Rideout; David Porter,7,0,36,29
1658090694875,MATH 18,B06,093474,Rideout; David Porter,6,0,36,30
1658090700899,MATH 20A,A01,083754,Zheng; Zequn,14,0,40,26
1658090706921,MATH 20B,A01,083756,Briones; Jor-el Thomas Caparas,4,0,36,32
1658090706921,MATH 20B,A02,083757,Briones; Jor-el Thomas Caparas,1,0,36,35
1658090706921,MATH 20B,A03,093475,Briones; Jor-el Thomas Caparas,3,0,36,33
1658090712947,MATH 20C,A01,083760,Briones; Jor-el Thomas Caparas,1,0,35,34
1658090712947,MATH 20C,A02,083761,Briones; Jor-el Thomas Caparas,8,0,35,27
1658090712947,MATH 20C,A03,093476,Briones; Jor-el Thomas Caparas,0,1,36,36
1658090712947,MATH 20C,B01,083762,Bach; Quang Tran,1,0,30,29
1658090718975,MATH 20D,A01,083765,Tran; Brian Kha,5,0,30,25
1658090718975,MATH 20D,A02,083766,Tran; Brian Kha,5,0,30,25
1658090718975,MATH 20D,A03,083767,Tran; Brian Kha,6,0,30,24
1658090725000,MATH 20E,A01,083771,Ganguly; Soumya,12,0,32,20
1658090725000,MATH 20E,A02,083772,Ganguly; Soumya,7,0,32,25
1658090725000,MATH 20E,B01,083773,Ciotti; Benjamin,20,0,35,15
1658090725000,MATH 20E,B02,083774,Ciotti; Benjamin,18,0,35,17
1658090731033,MATH 103A,A01,083777,Greenfeld; Be'Eri,6,0,36,30
1658090731033,MATH 103A,A02,083778,Greenfeld; Be'Eri,5,0,36,31
1658090731033,MATH 103A,A03,093561,Greenfeld; Be'Eri,7,0,36,29
1658090731033,MATH 103A,B01,083779,Greenfeld; Be'Eri,8,0,36,28
1658090731033,MATH 103A,B02,083780,Greenfeld; Be'Eri,4,0,36,32
1658090731033,MATH 103A,B03,093562,Greenfeld; Be'Eri,3,0,36,33
1658090737069,MATH 105,A01,085443,Carter; Anne Toulson,15,0,35,20
1658090737069,MATH 105,A02,093477,Carter; Anne Toulson,20,0,35,15
1658090743094,MATH 109,A01,083213,Ganzberger; Geoffrey Michael,3,0,34,31
1658090743094,MATH 109,A02,083214,Ganzberger; Geoffrey Michael,4,0,34,30
1658090743094,MATH 109,A03,093478,Ganzberger; Geoffrey Michael,2,0,34,32
1658090743094,MATH 109,B01,083215,Ganzberger; Geoffrey Michael,3,0,32,29
1658090743094,MATH 109,B02,083216,Ganzberger; Geoffrey Michael,3,0,32,29
1658090743094,MATH 109,B03,093479,Ganzberger; Geoffrey Michael,8,0,32,24
1658090749119,MATH 142A,A01,083219,Chow; Bennett,7,0,32,25
1658090749119,MATH 142A,A02,083220,Chow; Bennett,10,0,32,22
1658090749119,MATH 142A,A03,093480,Chow; Bennett,9,0,32,23
1658090749119,MATH 142A,B03,093481,Chow; Bennett,8,0,32,24
1658090749119,MATH 142A,B04,093558,Chow; Bennett,14,0,32,18
1658090749119,MATH 142A,B05,093559,Chow; Bennett,7,0,32,25
1658090755146,MATH 193A,A01,083224,Rotar; Vladimir,9,0,34,25
1658090755146,MATH 193A,A02,083225,Rotar; Vladimir,11,0,34,23
1658090755146,MATH 193A,A03,083781,Rotar; Vladimir,5,0,34,29
1658090755146,MATH 193A,A04,083782,Rotar; Vladimir,12,0,34,22
1658090755146,MATH 193A,A05,093482,Rotar; Vladimir,11,0,34,23
1658090761169,MATH 197,001,091859,McAuley; Julian John,9999,0,9999,0
1658090761169,MATH 197,002,095566,Kedlaya; Kiran S.,9997,0,9999,2
1658090761169,MATH 197,003,095567,Xiao; Ming,9999,0,9999,0
1658090761169,MATH 197,004,095571,Perols; Johan Lars,9998,0,9999,1
1658090768243,COGS 9,A01,083615,Shannon; Kyle Michael,11,0,75,64
1658090774266,COGS 11,A01,083617,Boyle; Mary E. T.,23,0,48,25
1658090780294,COGS 13,A01,083071,Bastos; Amalia Pinkusfeld,12,0,71,59
1658090786317,COGS 14A,A01,092681,Semenuks; Arturs,5,1,100,95
1658090792345,COGS 14B,A01,083073,Cheng; Tzu-Han,7,0,63,56
1658090798371,COGS 17,A01,092677,Semenuks; Arturs,7,0,81,74
1658090804399,COGS 100,A01,083619,Allen; Michael Gordon,17,0,70,53
1658090810423,COGS 101A,A01,083621,Davis; Joshua Daniel,9,0,68,59
1658090816446,COGS 101B,A01,091572,Allen; Michael Gordon,14,0,65,51
1658090822473,COGS 101C,A01,083625,Delgado; Tania,17,0,35,18
1658090828498,COGS 107A,A01,083627,Boyle; Mary E. T.,14,0,60,46
1658090834533,COGS 118A,A01,083075,Gupta; Anjum,21,0,76,55
1658090840561,CSE 3,A50,083646,Miranda; Gregory Joseph,24,0,50,26
1658090846585,CSE 8A,A50,083650,Miranda; Gregory Joseph,17,1,56,39
1658090852608,CSE 11,A01,083080,Cao; Yingjun,7,15,40,33
1658090858634,CSE 12,A01,083652,Krause-Levy; Sophia Louisa,30,1,120,90
1658090864662,CSE 15L,A01,083654,Morris; Justin Loren,9,0,50,41
1658090864662,CSE 15L,A02,083655,Morris; Justin Loren,11,0,50,39
1658090870687,CSE 20,A01,083657,Tran; Khoa Dang,39,0,80,41
1658090876715,CSE 21,A01,095574,Bach; Quang Tran,23,0,48,25
1658090882742,CSE 30,A01,083084,Eldon; John,8,0,80,72
1658090882742,CSE 30,B01,095061,Bhaskar; Nishant,9,0,50,41
1658090888769,CSE 100,A01,083659,Cao; Yingjun,5,4,70,65
1658090894795,CSE 134B,A01,083661,Powell; Thomas Allan,25,0,100,75
1658090900822,CSE 140,A01,083663,Gungor; Onat,17,0,85,68
1658090906849,CSE 140L,A01,083088,Eldon; John,23,0,100,77
1658090912874,CSE 175,A01,083665,Kumar; Rakesh,3,0,25,22
1658090918898,CSE 190,A00,092507,Dubnov; Shlomo,8,0,20,12
1658090924921,ECE 45,A01,083139,Congero; Spencer William,7,0,75,68
1658090930951,ECE 65,A50,083695,Saad; Andrew S,12,0,30,18
1658090930951,ECE 65,A51,095125,Saad; Andrew S,24,0,26,2
1658090936978,ECE 109,A01,091882,Touri; Behrouz,21,0,70,49
1658090943003,ECE 180,A00,083140,Abi Samra; Nicholas Camill,1,0,30,29
1658090943003,ECE 180,B00,083141,Abi Samra; Nicholas Camill,0,0,30,30
1658090949032,MATH 10A,A01,083735,Patchell; Gregory David,2,0,30,28
1658090949032,MATH 10A,A02,083736,Patchell; Gregory David,20,0,30,10
1658090949032,MATH 10A,A03,083737,Patchell; Gregory David,16,0,30,14
1658090955056,MATH 10B,A01,083207,Lim; Seonhee,9,0,34,25
1658090955056,MATH 10B,A02,083208,Lim; Seonhee,10,0,35,25
1658090955056,MATH 10B,A03,093472,Lim; Seonhee,7,0,34,27
1658090955056,MATH 10B,B01,083739,Sinha; Shubham,14,0,30,16
1658090961089,MATH 18,A01,083743,Cinel; Cameron Alexander,9,0,30,21
1658090961089,MATH 18,A02,083744,Cinel; Cameron Alexander,18,0,30,12
1658090961089,MATH 18,A03,083745,Cinel; Cameron Alexander,10,0,30,20
1658090961089,MATH 18,B01,083748,Rideout; David Porter,5,0,37,32
1658090961089,MATH 18,B02,083749,Rideout; David Porter,5,0,36,31
1658090961089,MATH 18,B03,083750,Rideout; David Porter,3,0,37,34
1658090961089,MATH 18,B04,083751,Rideout; David Porter,7,0,36,29
1658090961089,MATH 18,B05,093473,Rideout; David Porter,7,0,36,29
1658090961089,MATH 18,B06,093474,Rideout; David Porter,6,0,36,30
1658090967116,MATH 20A,A01,083754,Zheng; Zequn,14,0,40,26
1658090973141,MATH 20B,A01,083756,Briones; Jor-el Thomas Caparas,4,0,36,32
1658090973141,MATH 20B,A02,083757,Briones; Jor-el Thomas Caparas,1,0,36,35
1658090973141,MATH 20B,A03,093475,Briones; Jor-el Thomas Caparas,3,0,36,33
1658090979165,MATH 20C,A01,083760,Briones; Jor-el Thomas Caparas,1,0,35,34
1658090979165,MATH 20C,A02,083761,Briones; Jor-el Thomas Caparas,8,0,35,27
1658090979165,MATH 20C,A03,093476,Briones; Jor-el Thomas Caparas,0,1,36,36
1658090979165,MATH 20C,B01,083762,Bach; Quang Tran,1,0,30,29
1658090985193,MATH 20D,A01,083765,Tran; Brian Kha,5,0,30,25
1658090985193,MATH 20D,A02,083766,Tran; Brian Kha,5,0,30,25
1658090985193,MATH 20D,A03,083767,Tran; Brian Kha,6,0,30,24
1658090991221,MATH 20E,A01,083771,Ganguly; Soumya,12,0,32,20
1658090991221,MATH 20E,A02,083772,Ganguly; Soumya,7,0,32,25
1658090991221,MATH 20E,B01,083773,Ciotti; Benjamin,20,0,35,15
1658090991221,MATH 20E,B02,083774,Ciotti; Benjamin,18,0,35,17
1658090997249,MATH 103A,A01,083777,Greenfeld; Be'Eri,6,0,36,30
1658090997249,MATH 103A,A02,083778,Greenfeld; Be'Eri,5,0,36,31
1658090997249,MATH 103A,A03,093561,Greenfeld; Be'Eri,7,0,36,29
1658090997249,MATH 103A,B01,083779,Greenfeld; Be'Eri,8,0,36,28
1658090997249,MATH 103A,B02,083780,Greenfeld; Be'Eri,4,0,36,32
1658090997249,MATH 103A,B03,093562,Greenfeld; Be'Eri,3,0,36,33
1658091003284,MATH 105,A01,085443,Carter; Anne Toulson,15,0,35,20
1658091003284,MATH 105,A02,093477,Carter; Anne Toulson,20,0,35,15
1658091009318,MATH 109,A01,083213,Ganzberger; Geoffrey Michael,3,0,34,31
1658091009318,MATH 109,A02,083214,Ganzberger; Geoffrey Michael,4,0,34,30
1658091009318,MATH 109,A03,093478,Ganzberger; Geoffrey Michael,2,0,34,32
1658091009318,MATH 109,B01,083215,Ganzberger; Geoffrey Michael,3,0,32,29
1658091009318,MATH 109,B02,083216,Ganzberger; Geoffrey Michael,3,0,32,29
1658091009318,MATH 109,B03,093479,Ganzberger; Geoffrey Michael,8,0,32,24
1658091015342,MATH 142A,A01,083219,Chow; Bennett,7,0,32,25
1658091015342,MATH 142A,A02,083220,Chow; Bennett,10,0,32,22
1658091015342,MATH 142A,A03,093480,Chow; Bennett,9,0,32,23
1658091015342,MATH 142A,B03,093481,Chow; Bennett,8,0,32,24
1658091015342,MATH 142A,B04,093558,Chow; Bennett,14,0,32,18
1658091015342,MATH 142A,B05,093559,Chow; Bennett,7,0,32,25
1658091021365,MATH 193A,A01,083224,Rotar; Vladimir,9,0,34,25
1658091021365,MATH 193A,A02,083225,Rotar; Vladimir,11,0,34,23
1658091021365,MATH 193A,A03,083781,Rotar; Vladimir,5,0,34,29
1658091021365,MATH 193A,A04,083782,Rotar; Vladimir,12,0,34,22
1658091021365,MATH 193A,A05,093482,Rotar; Vladimir,11,0,34,23
1658091027389,MATH 197,001,091859,McAuley; Julian John,9999,0,9999,0
1658091027389,MATH 197,002,095566,Kedlaya; Kiran S.,9997,0,9999,2
1658091027389,MATH 197,003,095567,Xiao; Ming,9999,0,9999,0
1658091027389,MATH 197,004,095571,Perols; Johan Lars,9998,0,9999,1
1658091034442,COGS 9,A01,083615,Shannon; Kyle Michael,11,0,75,64
1658091040469,COGS 11,A01,083617,Boyle; Mary E. T.,23,0,48,25
1658091046494,COGS 13,A01,083071,Bastos; Amalia Pinkusfeld,12,0,71,59
1658091052518,COGS 14A,A01,092681,Semenuks; Arturs,5,1,100,95
1658091058540,COGS 14B,A01,083073,Cheng; Tzu-Han,7,0,63,56
1658091064567,COGS 17,A01,092677,Semenuks; Arturs,7,0,81,74
1658091070594,COGS 100,A01,083619,Allen; Michael Gordon,17,0,70,53
1658091076617,COGS 101A,A01,083621,Davis; Joshua Daniel,9,0,68,59
1658091082639,COGS 101B,A01,091572,Allen; Michael Gordon,14,0,65,51
1658091088665,COGS 101C,A01,083625,Delgado; Tania,17,0,35,18
1658091094689,COGS 107A,A01,083627,Boyle; Mary E. T.,14,0,60,46
1658091100715,COGS 118A,A01,083075,Gupta; Anjum,21,0,76,55
1658091106738,CSE 3,A50,083646,Miranda; Gregory Joseph,24,0,50,26
1658091112765,CSE 8A,A50,083650,Miranda; Gregory Joseph,17,1,56,39
1658091118788,CSE 11,A01,083080,Cao; Yingjun,7,15,40,33
1658091124812,CSE 12,A01,083652,Krause-Levy; Sophia Louisa,30,1,120,90
1658091130837,CSE 15L,A01,083654,Morris; Justin Loren,9,0,50,41
1658091130837,CSE 15L,A02,083655,Morris; Justin Loren,11,0,50,39
1658091136860,CSE 20,A01,083657,Tran; Khoa Dang,39,0,80,41
1658091142882,CSE 21,A01,095574,Bach; Quang Tran,23,0,48,25
1658091148904,CSE 30,A01,083084,Eldon; John,8,0,80,72
1658091148904,CSE 30,B01,095061,Bhaskar; Nishant,9,0,50,41
1658091154931,CSE 100,A01,083659,Cao; Yingjun,5,4,70,65
1658091160952,CSE 134B,A01,083661,Powell; Thomas Allan,25,0,100,75
1658091166975,CSE 140,A01,083663,Gungor; Onat,17,0,85,68
1658091173006,CSE 140L,A01,083088,Eldon; John,23,0,100,77
1658091179035,CSE 175,A01,083665,Kumar; Rakesh,3,0,25,22
1658091185062,CSE 190,A00,092507,Dubnov; Shlomo,8,0,20,12
1658091191086,ECE 45,A01,083139,Congero; Spencer William,7,0,75,68
1658091197109,ECE 65,A50,083695,Saad; Andrew S,12,0,30,18
1658091197109,ECE 65,A51,095125,Saad; Andrew S,24,0,26,2
1658091203134,ECE 109,A01,091882,Touri; Behrouz,21,0,70,49
1658091209157,ECE 180,A00,083140,Abi Samra; Nicholas Camill,1,0,30,29
1658091209157,ECE 180,B00,083141,Abi Samra; Nicholas Camill,0,0,30,30
1658091215184,MATH 10A,A01,083735,Patchell; Gregory David,2,0,30,28
1658091215184,MATH 10A,A02,083736,Patchell; Gregory David,20,0,30,10
1658091215184,MATH 10A,A03,083737,Patchell; Gregory David,16,0,30,14
1658091221212,MATH 10B,A01,083207,Lim; Seonhee,9,0,34,25
1658091221212,MATH 10B,A02,083208,Lim; Seonhee,10,0,35,25
1658091221212,MATH 10B,A03,093472,Lim; Seonhee,7,0,34,27
1658091221212,MATH 10B,B01,083739,Sinha; Shubham,14,0,30,16
1658091227250,MATH 18,A01,083743,Cinel; Cameron Alexander,9,0,30,21
1658091227250,MATH 18,A02,083744,Cinel; Cameron Alexander,18,0,30,12
1658091227250,MATH 18,A03,083745,Cinel; Cameron Alexander,10,0,30,20
1658091227250,MATH 18,B01,083748,Rideout; David Porter,5,0,37,32
1658091227250,MATH 18,B02,083749,Rideout; David Porter,5,0,36,31
1658091227250,MATH 18,B03,083750,Rideout; David Porter,3,0,37,34
1658091227250,MATH 18,B04,083751,Rideout; David Porter,7,0,36,29
1658091227250,MATH 18,B05,093473,Rideout; David Porter,7,0,36,29
1658091227250,MATH 18,B06,093474,Rideout; David Porter,6,0,36,30
1658091233276,MATH 20A,A01,083754,Zheng; Zequn,14,0,40,26
1658091239300,MATH 20B,A01,083756,Briones; Jor-el Thomas Caparas,4,0,36,32
1658091239300,MATH 20B,A02,083757,Briones; Jor-el Thomas Caparas,1,0,36,35
1658091239300,MATH 20B,A03,093475,Briones; Jor-el Thomas Caparas,3,0,36,33
1658091245330,MATH 20C,A01,083760,Briones; Jor-el Thomas Caparas,1,0,35,34
1658091245330,MATH 20C,A02,083761,Briones; Jor-el Thomas Caparas,8,0,35,27
1658091245330,MATH 20C,A03,093476,Briones; Jor-el Thomas Caparas,0,1,36,36
1658091245330,MATH 20C,B01,083762,Bach; Quang Tran,1,0,30,29
1658091251354,MATH 20D,A01,083765,Tran; Brian Kha,5,0,30,25
1658091251354,MATH 20D,A02,083766,Tran; Brian Kha,5,0,30,25
1658091251354,MATH 20D,A03,083767,Tran; Brian Kha,6,0,30,24
1658091257383,MATH 20E,A01,083771,Ganguly; Soumya,12,0,32,20
1658091257383,MATH 20E,A02,083772,Ganguly; Soumya,7,0,32,25
1658091257383,MATH 20E,B01,083773,Ciotti; Benjamin,20,0,35,15
1658091257383,MATH 20E,B02,083774,Ciotti; Benjamin,18,0,35,17
1658091263490,MATH 103A,A01,083777,Greenfeld; Be'Eri,6,0,36,30
1658091263490,MATH 103A,A02,083778,Greenfeld; Be'Eri,5,0,36,31
1658091263490,MATH 103A,A03,093561,Greenfeld; Be'Eri,7,0,36,29
1658091263490,MATH 103A,B01,083779,Greenfeld; Be'Eri,8,0,36,28
1658091263490,MATH 103A,B02,083780,Greenfeld; Be'Eri,4,0,36,32
1658091263490,MATH 103A,B03,093562,Greenfeld; Be'Eri,3,0,36,33
1658091269517,MATH 105,A01,085443,Carter; Anne Toulson,15,0,35,20
1658091269517,MATH 105,A02,093477,Carter; Anne Toulson,20,0,35,15
1658091275545,MATH 109,A01,083213,Ganzberger; Geoffrey Michael,3,0,34,31
1658091275545,MATH 109,A02,083214,Ganzberger; Geoffrey Michael,4,0,34,30
1658091275545,MATH 109,A03,093478,Ganzberger; Geoffrey Michael,2,0,34,32
1658091275545,MATH 109,B01,083215,Ganzberger; Geoffrey Michael,3,0,32,29
1658091275545,MATH 109,B02,083216,Ganzberger; Geoffrey Michael,3,0,32,29
1658091275545,MATH 109,B03,093479,Ganzberger; Geoffrey Michael,8,0,32,24
1658091281569,MATH 142A,A01,083219,Chow; Bennett,7,0,32,25
1658091281569,MATH 142A,A02,083220,Chow; Bennett,10,0,32,22
1658091281569,MATH 142A,A03,093480,Chow; Bennett,9,0,32,23
1658091281569,MATH 142A,B03,093481,Chow; Bennett,8,0,32,24
1658091281569,MATH 142A,B04,093558,Chow; Bennett,14,0,32,18
1658091281569,MATH 142A,B05,093559,Chow; Bennett,7,0,32,25
1658091287594,MATH 193A,A01,083224,Rotar; Vladimir,9,0,34,25
1658091287594,MATH 193A,A02,083225,Rotar; Vladimir,11,0,34,23
1658091287594,MATH 193A,A03,083781,Rotar; Vladimir,5,0,34,29
1658091287594,MATH 193A,A04,083782,Rotar; Vladimir,12,0,34,22
1658091287594,MATH 193A,A05,093482,Rotar; Vladimir,11,0,34,23
1658091293616,MATH 197,001,091859,McAuley; Julian John,9999,0,9999,0
1658091293616,MATH 197,002,095566,Kedlaya; Kiran S.,9997,0,9999,2
1658091293616,MATH 197,003,095567,Xiao; Ming,9999,0,9999,0
1658091293616,MATH 197,004,095571,Perols; Johan Lars,9998,0,9999,1
1658091300680,COGS 9,A01,083615,Shannon; Kyle Michael,11,0,75,64
1658091306702,COGS 11,A01,083617,Boyle; Mary E. T.,23,0,48,25
1658091312731,COGS 13,A01,083071,Bastos; Amalia Pinkusfeld,12,0,71,59
1658091318754,COGS 14A,A01,092681,Semenuks; Arturs,5,1,100,95
1658091324784,COGS 14B,A01,083073,Cheng; Tzu-Han,7,0,63,56
1658091330809,COGS 17,A01,092677,Semenuks; Arturs,7,0,81,74
1658091336833,COGS 100,A01,083619,Allen; Michael Gordon,17,0,70,53
1658091342856,COGS 101A,A01,083621,Davis; Joshua Daniel,9,0,68,59
1658091348880,COGS 101B,A01,091572,Allen; Michael Gordon,14,0,65,51
1658091354903,COGS 101C,A01,083625,Delgado; Tania,17,0,35,18
1658091360932,COGS 107A,A01,083627,Boyle; Mary E. T.,14,0,60,46
1658091366972,COGS 118A,A01,083075,Gupta; Anjum,21,0,76,55
1658091372996,CSE 3,A50,083646,Miranda; Gregory Joseph,24,0,50,26
1658091379022,CSE 8A,A50,083650,Miranda; Gregory Joseph,17,1,56,39
1658091385047,CSE 11,A01,083080,Cao; Yingjun,7,15,40,33
1658091391071,CSE 12,A01,083652,Krause-Levy; Sophia Louisa,30,1,120,90
1658091397095,CSE 15L,A01,083654,Morris; Justin Loren,9,0,50,41
1658091397095,CSE 15L,A02,083655,Morris; Justin Loren,11,0,50,39
1658091403117,CSE 20,A01,083657,Tran; Khoa Dang,39,0,80,41
1658091409145,CSE 21,A01,095574,Bach; Quang Tran,23,0,48,25
1658091415180,CSE 30,A01,083084,Eldon; John,8,0,80,72
1658091415180,CSE 30,B01,095061,Bhaskar; Nishant,9,0,50,41
1658091421202,CSE 100,A01,083659,Cao; Yingjun,5,4,70,65
1658091427226,CSE 134B,A01,083661,Powell; Thomas Allan,25,0,100,75
1658091433250,CSE 140,A01,083663,Gungor; Onat,17,0,85,68
1658091439276,CSE 140L,A01,083088,Eldon; John,23,0,100,77
1658091445303,CSE 175,A01,083665,Kumar; Rakesh,3,0,25,22
1658091451327,CSE 190,A00,092507,Dubnov; Shlomo,8,0,20,12
1658091457350,ECE 45,A01,083139,Congero; Spencer William,7,0,75,68
1658091463378,ECE 65,A50,083695,Saad; Andrew S,12,0,30,18
1658091463378,ECE 65,A51,095125,Saad; Andrew S,24,0,26,2
1658091469403,ECE 109,A01,091882,Touri; Behrouz,21,0,70,49
1658091475431,ECE 180,A00,083140,Abi Samra; Nicholas Camill,1,0,30,29
1658091475431,ECE 180,B00,083141,Abi Samra; Nicholas Camill,0,0,30,30
1658091481454,MATH 10A,A01,083735,Patchell; Gregory David,2,0,30,28
1658091481454,MATH 10A,A02,083736,Patchell; Gregory David,20,0,30,10
1658091481454,MATH 10A,A03,083737,Patchell; Gregory David,16,0,30,14
1658091487479,MATH 10B,A01,083207,Lim; Seonhee,9,0,34,25
1658091487479,MATH 10B,A02,083208,Lim; Seonhee,10,0,35,25
1658091487479,MATH 10B,A03,093472,Lim; Seonhee,7,0,34,27
1658091487479,MATH 10B,B01,083739,Sinha; Shubham,14,0,30,16
1658091493504,MATH 18,A01,083743,Cinel; Cameron Alexander,9,0,30,21
1658091493504,MATH 18,A02,083744,Cinel; Cameron Alexander,18,0,30,12
1658091493504,MATH 18,A03,083745,Cinel; Cameron Alexander,10,0,30,20
1658091493504,MATH 18,B01,083748,Rideout; David Porter,5,0,37,32
1658091493504,MATH 18,B02,083749,Rideout; David Porter,5,0,36,31
1658091493504,MATH 18,B03,083750,Rideout; David Porter,3,0,37,34
1658091493504,MATH 18,B04,083751,Rideout; David Porter,7,0,36,29
1658091493504,MATH 18,B05,093473,Rideout; David Porter,7,0,36,29
1658091493504,MATH 18,B06,093474,Rideout; David Porter,6,0,36,30
1658091499526,MATH 20A,A01,083754,Zheng; Zequn,14,0,40,26
1658091505550,MATH 20B,A01,083756,Briones; Jor-el Thomas Caparas,4,0,36,32
1658091505550,MATH 20B,A02,083757,Briones; Jor-el Thomas Caparas,1,0,36,35
1658091505550,MATH 20B,A03,093475,Briones; Jor-el Thomas Caparas,3,0,36,33
1658091511574,MATH 20C,A01,083760,Briones; Jor-el Thomas Caparas,1,0,35,34
1658091511574,MATH 20C,A02,083761,Briones; Jor-el Thomas Caparas,8,0,35,27
1658091511574,MATH 20C,A03,093476,Briones; Jor-el Thomas Caparas,0,1,36,36
1658091511574,MATH 20C,B01,083762,Bach; Quang Tran,1,0,30,29
1658091517613,MATH 20D,A01,083765,Tran; Brian Kha,5,0,30,25
1658091517613,MATH 20D,A02,083766,Tran; Brian Kha,5,0,30,25
1658091517613,MATH 20D,A03,083767,Tran; Brian Kha,6,0,30,24
1658091523638,MATH 20E,A01,083771,Ganguly; Soumya,12,0,32,20
1658091523638,MATH 20E,A02,083772,Ganguly; Soumya,7,0,32,25
1658091523638,MATH 20E,B01,083773,Ciotti; Benjamin,20,0,35,15
1658091523638,MATH 20E,B02,083774,Ciotti; Benjamin,18,0,35,17
1658091529660,MATH 103A,A01,083777,Greenfeld; Be'Eri,6,0,36,30
1658091529660,MATH 103A,A02,083778,Greenfeld; Be'Eri,5,0,36,31
1658091529660,MATH 103A,A03,093561,Greenfeld; Be'Eri,7,0,36,29
1658091529660,MATH 103A,B01,083779,Greenfeld; Be'Eri,8,0,36,28
1658091529660,MATH 103A,B02,083780,Greenfeld; Be'Eri,4,0,36,32
1658091529660,MATH 103A,B03,093562,Greenfeld; Be'Eri,3,0,36,33
1658091535684,MATH 105,A01,085443,Carter; Anne Toulson,15,0,35,20
1658091535684,MATH 105,A02,093477,Carter; Anne Toulson,20,0,35,15
1658091541708,MATH 109,A01,083213,Ganzberger; Geoffrey Michael,3,0,34,31
1658091541708,MATH 109,A02,083214,Ganzberger; Geoffrey Michael,4,0,34,30
1658091541708,MATH 109,A03,093478,Ganzberger; Geoffrey Michael,2,0,34,32
1658091541708,MATH 109,B01,083215,Ganzberger; Geoffrey Michael,3,0,32,29
1658091541708,MATH 109,B02,083216,Ganzberger; Geoffrey Michael,3,0,32,29
1658091541708,MATH 109,B03,093479,Ganzberger; Geoffrey Michael,8,0,32,24
1658091547739,MATH 142A,A01,083219,Chow; Bennett,7,0,32,25
1658091547739,MATH 142A,A02,083220,Chow; Bennett,10,0,32,22
1658091547739,MATH 142A,A03,093480,Chow; Bennett,9,0,32,23
1658091547739,MATH 142A,B03,093481,Chow; Bennett,8,0,32,24
1658091547739,MATH 142A,B04,093558,Chow; Bennett,14,0,32,18
1658091547739,MATH 142A,B05,093559,Chow; Bennett,7,0,32,25
1658091553762,MATH 193A,A01,083224,Rotar; Vladimir,9,0,34,25
1658091553762,MATH 193A,A02,083225,Rotar; Vladimir,11,0,34,23
1658091553762,MATH 193A,A03,083781,Rotar; Vladimir,5,0,34,29
1658091553762,MATH 193A,A04,083782,Rotar; Vladimir,12,0,34,22
1658091553762,MATH 193A,A05,093482,Rotar; Vladimir,11,0,34,23
1658091559785,MATH 197,001,091859,McAuley; Julian John,9999,0,9999,0
1658091559785,MATH 197,002,095566,Kedlaya; Kiran S.,9997,0,9999,2
1658091559785,MATH 197,003,095567,Xiao; Ming,9999,0,9999,0
1658091559785,MATH 197,004,095571,Perols; Johan Lars,9998,0,9999,1
1658091566864,COGS 9,A01,083615,Shannon; Kyle Michael,11,0,75,64
1658091572891,COGS 11,A01,083617,Boyle; Mary E. T.,23,0,48,25
1658091578915,COGS 13,A01,083071,Bastos; Amalia Pinkusfeld,12,0,71,59
1658091584939,COGS 14A,A01,092681,Semenuks; Arturs,5,1,100,95
1658091590966,COGS 14B,A01,083073,Cheng; Tzu-Han,7,0,63,56
1658091596992,COGS 17,A01,092677,Semenuks; Arturs,7,0,81,74
1658091603017,COGS 100,A01,083619,Allen; Michael Gordon,17,0,70,53
1658091609050,COGS 101A,A01,083621,Davis; Joshua Daniel,9,0,68,59
1658091615074,COGS 101B,A01,091572,Allen; Michael Gordon,14,0,65,51
1658091621104,COGS 101C,A01,083625,Delgado; Tania,17,0,35,18
1658091627131,COGS 107A,A01,083627,Boyle; Mary E. T.,14,0,60,46
1658091633154,COGS 118A,A01,083075,Gupta; Anjum,21,0,76,55
1658091639181,CSE 3,A50,083646,Miranda; Gregory Joseph,24,0,50,26
1658091645208,CSE 8A,A50,083650,Miranda; Gregory Joseph,17,1,56,39
1658091651231,CSE 11,A01,083080,Cao; Yingjun,7,15,40,33
1658091657254,CSE 12,A01,083652,Krause-Levy; Sophia Louisa,30,1,120,90
1658091663277,CSE 15L,A01,083654,Morris; Justin Loren,9,0,50,41
1658091663277,CSE 15L,A02,083655,Morris; Justin Loren,11,0,50,39
1658091669301,CSE 20,A01,083657,Tran; Khoa Dang,39,0,80,41
1658091675323,CSE 21,A01,095574,Bach; Quang Tran,23,0,48,25
1658091681350,CSE 30,A01,083084,Eldon; John,8,0,80,72
1658091681350,CSE 30,B01,095061,Bhaskar; Nishant,9,0,50,41
1658091687379,CSE 100,A01,083659,Cao; Yingjun,5,4,70,65
1658091693407,CSE 134B,A01,083661,Powell; Thomas Allan,25,0,100,75
1658091699431,CSE 140,A01,083663,Gungor; Onat,17,0,85,68
1658091705455,CSE 140L,A01,083088,Eldon; John,23,0,100,77
1658091711482,CSE 175,A01,083665,Kumar; Rakesh,3,0,25,22
1658091717508,CSE 190,A00,092507,Dubnov; Shlomo,8,0,20,12
1658091723530,ECE 45,A01,083139,Congero; Spencer William,7,0,75,68
1658091729558,ECE 65,A50,083695,Saad; Andrew S,12,0,30,18
1658091729558,ECE 65,A51,095125,Saad; Andrew S,24,0,26,2
1658091735585,ECE 109,A01,091882,Touri; Behrouz,21,0,70,49
1658091741611,ECE 180,A00,083140,Abi Samra; Nicholas Camill,1,0,30,29
1658091741611,ECE 180,B00,083141,Abi Samra; Nicholas Camill,0,0,30,30
1658091747637,MATH 10A,A01,083735,Patchell; Gregory David,2,0,30,28
1658091747637,MATH 10A,A02,083736,Patchell; Gregory David,20,0,30,10
1658091747637,MATH 10A,A03,083737,Patchell; Gregory David,16,0,30,14
1658091753662,MATH 10B,A01,083207,Lim; Seonhee,9,0,34,25
1658091753662,MATH 10B,A02,083208,Lim; Seonhee,10,0,35,25
1658091753662,MATH 10B,A03,093472,Lim; Seonhee,7,0,34,27
1658091753662,MATH 10B,B01,083739,Sinha; Shubham,14,0,30,16
1658091759688,MATH 18,A01,083743,Cinel; Cameron Alexander,9,0,30,21
1658091759688,MATH 18,A02,083744,Cinel; Cameron Alexander,18,0,30,12
1658091759688,MATH 18,A03,083745,Cinel; Cameron Alexander,10,0,30,20
1658091759688,MATH 18,B01,083748,Rideout; David Porter,5,0,37,32
1658091759688,MATH 18,B02,083749,Rideout; David Porter,5,0,36,31
1658091759688,MATH 18,B03,083750,Rideout; David Porter,3,0,37,34
1658091759688,MATH 18,B04,083751,Rideout; David Porter,7,0,36,29
1658091759688,MATH 18,B05,093473,Rideout; David Porter,7,0,36,29
1658091759688,MATH 18,B06,093474,Rideout; David Porter,6,0,36,30
1658091765712,MATH 20A,A01,083754,Zheng; Zequn,14,0,40,26
1658091771735,MATH 20B,A01,083756,Briones; Jor-el Thomas Caparas,4,0,36,32
1658091771735,MATH 20B,A02,083757,Briones; Jor-el Thomas Caparas,1,0,36,35
1658091771735,MATH 20B,A03,093475,Briones; Jor-el Thomas Caparas,3,0,36,33
1658091777760,MATH 20C,A01,083760,Briones; Jor-el Thomas Caparas,1,0,35,34
1658091777760,MATH 20C,A02,083761,Briones; Jor-el Thomas Caparas,8,0,35,27
1658091777760,MATH 20C,A03,093476,Briones; Jor-el Thomas Caparas,0,1,36,36
1658091777760,MATH 20C,B01,083762,Bach; Quang Tran,1,0,30,29
1658091783783,MATH 20D,A01,083765,Tran; Brian Kha,5,0,30,25
1658091783783,MATH 20D,A02,083766,Tran; Brian Kha,5,0,30,25
1658091783783,MATH 20D,A03,083767,Tran; Brian Kha,6,0,30,24
1658091789811,MATH 20E,A01,083771,Ganguly; Soumya,12,0,32,20
1658091789811,MATH 20E,A02,083772,Ganguly; Soumya,7,0,32,25
1658091789811,MATH 20E,B01,083773,Ciotti; Benjamin,20,0,35,15
1658091789811,MATH 20E,B02,083774,Ciotti; Benjamin,18,0,35,17
1658091795841,MATH 103A,A01,083777,Greenfeld; Be'Eri,6,0,36,30
1658091795841,MATH 103A,A02,083778,Greenfeld; Be'Eri,5,0,36,31
1658091795841,MATH 103A,A03,093561,Greenfeld; Be'Eri,7,0,36,29
1658091795841,MATH 103A,B01,083779,Greenfeld; Be'Eri,8,0,36,28
1658091795841,MATH 103A,B02,083780,Greenfeld; Be'Eri,4,0,36,32
1658091795841,MATH 103A,B03,093562,Greenfeld; Be'Eri,3,0,36,33
1658091801868,MATH 105,A01,085443,Carter; Anne Toulson,15,0,35,20
1658091801868,MATH 105,A02,093477,Carter; Anne Toulson,20,0,35,15
1658091807897,MATH 109,A01,083213,Ganzberger; Geoffrey Michael,3,0,34,31
1658091807897,MATH 109,A02,083214,Ganzberger; Geoffrey Michael,4,0,34,30
1658091807897,MATH 109,A03,093478,Ganzberger; Geoffrey Michael,2,0,34,32
1658091807897,MATH 109,B01,083215,Ganzberger; Geoffrey Michael,3,0,32,29
1658091807897,MATH 109,B02,083216,Ganzberger; Geoffrey Michael,3,0,32,29
1658091807897,MATH 109,B03,093479,Ganzberger; Geoffrey Michael,8,0,32,24
1658091813926,MATH 142A,A01,083219,Chow; Bennett,7,0,32,25
1658091813926,MATH 142A,A02,083220,Chow; Bennett,10,0,32,22
1658091813926,MATH 142A,A03,093480,Chow; Bennett,9,0,32,23
1658091813926,MATH 142A,B03,093481,Chow; Bennett,8,0,32,24
1658091813926,MATH 142A,B04,093558,Chow; Bennett,14,0,32,18
1658091813926,MATH 142A,B05,093559,Chow; Bennett,7,0,32,25
1658091819956,MATH 193A,A01,083224,Rotar; Vladimir,9,0,34,25
1658091819956,MATH 193A,A02,083225,Rotar; Vladimir,11,0,34,23
1658091819956,MATH 193A,A03,083781,Rotar; Vladimir,5,0,34,29
1658091819956,MATH 193A,A04,083782,Rotar; Vladimir,12,0,34,22
1658091819956,MATH 193A,A05,093482,Rotar; Vladimir,11,0,34,23
1658091825985,MATH 197,001,091859,McAuley; Julian John,9999,0,9999,0
1658091825985,MATH 197,002,095566,Kedlaya; Kiran S.,9997,0,9999,2
1658091825985,MATH 197,003,095567,Xiao; Ming,9999,0,9999,0
1658091825985,MATH 197,004,095571,Perols; Johan Lars,9998,0,9999,1
1658091833050,COGS 9,A01,083615,Shannon; Kyle Michael,11,0,75,64
1658091839076,COGS 11,A01,083617,Boyle; Mary E. T.,23,0,48,25
1658091845097,COGS 13,A01,083071,Bastos; Amalia Pinkusfeld,12,0,71,59
1658091851124,COGS 14A,A01,092681,Semenuks; Arturs,5,1,100,95
1658091857257,COGS 14B,A01,083073,Cheng; Tzu-Han,7,0,63,56
1658091863290,COGS 17,A01,092677,Semenuks; Arturs,7,0,81,74
1658091869313,COGS 100,A01,083619,Allen; Michael Gordon,17,0,70,53
1658091875336,COGS 101A,A01,083621,Davis; Joshua Daniel,9,0,68,59
1658091881363,COGS 101B,A01,091572,Allen; Michael Gordon,14,0,65,51
1658091887393,COGS 101C,A01,083625,Delgado; Tania,17,0,35,18
1658091893427,COGS 107A,A01,083627,Boyle; Mary E. T.,14,0,60,46
1658091899454,COGS 118A,A01,083075,Gupta; Anjum,21,0,76,55
1658091905487,CSE 3,A50,083646,Miranda; Gregory Joseph,24,0,50,26
1658091911515,CSE 8A,A50,083650,Miranda; Gregory Joseph,17,1,56,39
1658091917541,CSE 11,A01,083080,Cao; Yingjun,7,15,40,33
1658091923565,CSE 12,A01,083652,Krause-Levy; Sophia Louisa,30,1,120,90
1658091929590,CSE 15L,A01,083654,Morris; Justin Loren,9,0,50,41
1658091929590,CSE 15L,A02,083655,Morris; Justin Loren,11,0,50,39
1658091935617,CSE 20,A01,083657,Tran; Khoa Dang,39,0,80,41
1658091941644,CSE 21,A01,095574,Bach; Quang Tran,23,0,48,25
1658091947668,CSE 30,A01,083084,Eldon; John,8,0,80,72
1658091947668,CSE 30,B01,095061,Bhaskar; Nishant,9,0,50,41
1658091953691,CSE 100,A01,083659,Cao; Yingjun,5,4,70,65
1658091959718,CSE 134B,A01,083661,Powell; Thomas Allan,25,0,100,75
1658091965741,CSE 140,A01,083663,Gungor; Onat,17,0,85,68
1658091971765,CSE 140L,A01,083088,Eldon; John,23,0,100,77
1658091977789,CSE 175,A01,083665,Kumar; Rakesh,3,0,25,22
1658091983812,CSE 190,A00,092507,Dubnov; Shlomo,8,0,20,12
1658091989839,ECE 45,A01,083139,Congero; Spencer William,7,0,75,68
1658091995869,ECE 65,A50,083695,Saad; Andrew S,12,0,30,18
1658091995869,ECE 65,A51,095125,Saad; Andrew S,24,0,26,2
1658092001892,ECE 109,A01,091882,Touri; Behrouz,21,0,70,49
1658092007920,ECE 180,A00,083140,Abi Samra; Nicholas Camill,1,0,30,29
1658092007920,ECE 180,B00,083141,Abi Samra; Nicholas Camill,0,0,30,30
1658092013944,MATH 10A,A01,083735,Patchell; Gregory David,2,0,30,28
1658092013944,MATH 10A,A02,083736,Patchell; Gregory David,20,0,30,10
1658092013944,MATH 10A,A03,083737,Patchell; Gregory David,16,0,30,14
1658092019974,MATH 10B,A01,083207,Lim; Seonhee,9,0,34,25
1658092019974,MATH 10B,A02,083208,Lim; Seonhee,10,0,35,25
1658092019974,MATH 10B,A03,093472,Lim; Seonhee,7,0,34,27
1658092019974,MATH 10B,B01,083739,Sinha; Shubham,14,0,30,16
1658092026007,MATH 18,A01,083743,Cinel; Cameron Alexander,9,0,30,21
1658092026007,MATH 18,A02,083744,Cinel; Cameron Alexander,18,0,30,12
1658092026007,MATH 18,A03,083745,Cinel; Cameron Alexander,10,0,30,20
1658092026007,MATH 18,B01,083748,Rideout; David Porter,5,0,37,32
1658092026007,MATH 18,B02,083749,Rideout; David Porter,5,0,36,31
1658092026007,MATH 18,B03,083750,Rideout; David Porter,3,0,37,34
1658092026007,MATH 18,B04,083751,Rideout; David Porter,7,0,36,29
1658092026007,MATH 18,B05,093473,Rideout; David Porter,7,0,36,29
1658092026007,MATH 18,B06,093474,Rideout; David Porter,6,0,36,30
1658092032031,MATH 20A,A01,083754,Zheng; Zequn,14,0,40,26
1658092038059,MATH 20B,A01,083756,Briones; Jor-el Thomas Caparas,4,0,36,32
1658092038059,MATH 20B,A02,083757,Briones; Jor-el Thomas Caparas,1,0,36,35
1658092038059,MATH 20B,A03,093475,Briones; Jor-el Thomas Caparas,3,0,36,33
1658092044087,MATH 20C,A01,083760,Briones; Jor-el Thomas Caparas,1,0,35,34
1658092044087,MATH 20C,A02,083761,Briones; Jor-el Thomas Caparas,8,0,35,27
1658092044087,MATH 20C,A03,093476,Briones; Jor-el Thomas Caparas,0,1,36,36
1658092044087,MATH 20C,B01,083762,Bach; Quang Tran,1,0,30,29
1658092050115,MATH 20D,A01,083765,Tran; Brian Kha,5,0,30,25
1658092050115,MATH 20D,A02,083766,Tran; Brian Kha,5,0,30,25
1658092050115,MATH 20D,A03,083767,Tran; Brian Kha,6,0,30,24
1658092056138,MATH 20E,A01,083771,Ganguly; Soumya,12,0,32,20
1658092056138,MATH 20E,A02,083772,Ganguly; Soumya,7,0,32,25
1658092056138,MATH 20E,B01,083773,Ciotti; Benjamin,20,0,35,15
1658092056138,MATH 20E,B02,083774,Ciotti; Benjamin,18,0,35,17
1658092062163,MATH 103A,A01,083777,Greenfeld; Be'Eri,6,0,36,30
1658092062163,MATH 103A,A02,083778,Greenfeld; Be'Eri,5,0,36,31
1658092062163,MATH 103A,A03,093561,Greenfeld; Be'Eri,7,0,36,29
1658092062163,MATH 103A,B01,083779,Greenfeld; Be'Eri,8,0,36,28
1658092062163,MATH 103A,B02,083780,Greenfeld; Be'Eri,4,0,36,32
1658092062163,MATH 103A,B03,093562,Greenfeld; Be'Eri,3,0,36,33
1658092068187,MATH 105,A01,085443,Carter; Anne Toulson,15,0,35,20
1658092068187,MATH 105,A02,093477,Carter; Anne Toulson,20,0,35,15
1658092074216,MATH 109,A01,083213,Ganzberger; Geoffrey Michael,3,0,34,31
1658092074216,MATH 109,A02,083214,Ganzberger; Geoffrey Michael,4,0,34,30
1658092074216,MATH 109,A03,093478,Ganzberger; Geoffrey Michael,2,0,34,32
1658092074216,MATH 109,B01,083215,Ganzberger; Geoffrey Michael,3,0,32,29
1658092074216,MATH 109,B02,083216,Ganzberger; Geoffrey Michael,3,0,32,29
1658092074216,MATH 109,B03,093479,Ganzberger; Geoffrey Michael,8,0,32,24
1658092080253,MATH 142A,A01,083219,Chow; Bennett,7,0,32,25
1658092080253,MATH 142A,A02,083220,Chow; Bennett,10,0,32,22
1658092080253,MATH 142A,A03,093480,Chow; Bennett,9,0,32,23
1658092080253,MATH 142A,B03,093481,Chow; Bennett,8,0,32,24
1658092080253,MATH 142A,B04,093558,Chow; Bennett,14,0,32,18
1658092080253,MATH 142A,B05,093559,Chow; Bennett,7,0,32,25
1658092086281,MATH 193A,A01,083224,Rotar; Vladimir,9,0,34,25
1658092086281,MATH 193A,A02,083225,Rotar; Vladimir,11,0,34,23
1658092086281,MATH 193A,A03,083781,Rotar; Vladimir,5,0,34,29
1658092086281,MATH 193A,A04,083782,Rotar; Vladimir,12,0,34,22
1658092086281,MATH 193A,A05,093482,Rotar; Vladimir,11,0,34,23
1658092092304,MATH 197,001,091859,McAuley; Julian John,9999,0,9999,0
1658092092304,MATH 197,002,095566,Kedlaya; Kiran S.,9997,0,9999,2
1658092092304,MATH 197,003,095567,Xiao; Ming,9999,0,9999,0
1658092092304,MATH 197,004,095571,Perols; Johan Lars,9998,0,9999,1
1658092099360,COGS 9,A01,083615,Shannon; Kyle Michael,11,0,75,64
1658092105387,COGS 11,A01,083617,Boyle; Mary E. T.,23,0,48,25
1658092111410,COGS 13,A01,083071,Bastos; Amalia Pinkusfeld,12,0,71,59
1658092117437,COGS 14A,A01,092681,Semenuks; Arturs,5,1,100,95
1658092123459,COGS 14B,A01,083073,Cheng; Tzu-Han,7,0,63,56
1658092129487,COGS 17,A01,092677,Semenuks; Arturs,7,0,81,74
1658092135514,COGS 100,A01,083619,Allen; Michael Gordon,17,0,70,53
1658092141539,COGS 101A,A01,083621,Davis; Joshua Daniel,9,0,68,59
1658092147565,COGS 101B,A01,091572,Allen; Michael Gordon,14,0,65,51
1658092153589,COGS 101C,A01,083625,Delgado; Tania,17,0,35,18
1658092159615,COGS 107A,A01,083627,Boyle; Mary E. T.,14,0,60,46
1658092165639,COGS 118A,A01,083075,Gupta; Anjum,21,0,76,55
1658092171663,CSE 3,A50,083646,Miranda; Gregory Joseph,24,0,50,26
1658092177690,CSE 8A,A50,083650,Miranda; Gregory Joseph,17,1,56,39
1658092183717,CSE 11,A01,083080,Cao; Yingjun,7,15,40,33
1658092189741,CSE 12,A01,083652,Krause-Levy; Sophia Louisa,30,1,120,90
1658092195763,CSE 15L,A01,083654,Morris; Justin Loren,9,0,50,41
1658092195763,CSE 15L,A02,083655,Morris; Justin Loren,11,0,50,39
1658092201785,CSE 20,A01,083657,Tran; Khoa Dang,39,0,80,41
1658092207813,CSE 21,A01,095574,Bach; Quang Tran,23,0,48,25
1658092213846,CSE 30,A01,083084,Eldon; John,8,0,80,72
1658092213846,CSE 30,B01,095061,Bhaskar; Nishant,9,0,50,41
1658092219867,CSE 100,A01,083659,Cao; Yingjun,5,4,70,65
1658092225890,CSE 134B,A01,083661,Powell; Thomas Allan,25,0,100,75
1658092231912,CSE 140,A01,083663,Gungor; Onat,17,0,85,68
1658092237934,CSE 140L,A01,083088,Eldon; John,23,0,100,77
1658092243962,CSE 175,A01,083665,Kumar; Rakesh,3,0,25,22
1658092249990,CSE 190,A00,092507,Dubnov; Shlomo,8,0,20,12
1658092256013,ECE 45,A01,083139,Congero; Spencer William,7,0,75,68
1658092262040,ECE 65,A50,083695,Saad; Andrew S,12,0,30,18
1658092262040,ECE 65,A51,095125,Saad; Andrew S,24,0,26,2
1658092268064,ECE 109,A01,091882,Touri; Behrouz,21,0,70,49
1658092274087,ECE 180,A00,083140,Abi Samra; Nicholas Camill,1,0,30,29
1658092274087,ECE 180,B00,083141,Abi Samra; Nicholas Camill,0,0,30,30
1658092280110,MATH 10A,A01,083735,Patchell; Gregory David,2,0,30,28
1658092280110,MATH 10A,A02,083736,Patchell; Gregory David,20,0,30,10
1658092280110,MATH 10A,A03,083737,Patchell; Gregory David,16,0,30,14
1658092286138,MATH 10B,A01,083207,Lim; Seonhee,9,0,34,25
1658092286138,MATH 10B,A02,083208,Lim; Seonhee,10,0,35,25
1658092286138,MATH 10B,A03,093472,Lim; Seonhee,7,0,34,27
1658092286138,MATH 10B,B01,083739,Sinha; Shubham,14,0,30,16
1658092292168,MATH 18,A01,083743,Cinel; Cameron Alexander,9,0,30,21
1658092292168,MATH 18,A02,083744,Cinel; Cameron Alexander,18,0,30,12
1658092292168,MATH 18,A03,083745,Cinel; Cameron Alexander,10,0,30,20
1658092292168,MATH 18,B01,083748,Rideout; David Porter,5,0,37,32
1658092292168,MATH 18,B02,083749,Rideout; David Porter,5,0,36,31
1658092292168,MATH 18,B03,083750,Rideout; David Porter,3,0,37,34
1658092292168,MATH 18,B04,083751,Rideout; David Porter,7,0,36,29
1658092292168,MATH 18,B05,093473,Rideout; David Porter,7,0,36,29
1658092292168,MATH 18,B06,093474,Rideout; David Porter,6,0,36,30
1658092298194,MATH 20A,A01,083754,Zheng; Zequn,14,0,40,26
1658092304218,MATH 20B,A01,083756,Briones; Jor-el Thomas Caparas,4,0,36,32
1658092304218,MATH 20B,A02,083757,Briones; Jor-el Thomas Caparas,1,0,36,35
1658092304218,MATH 20B,A03,093475,Briones; Jor-el Thomas Caparas,3,0,36,33
1658092310248,MATH 20C,A01,083760,Briones; Jor-el Thomas Caparas,1,0,35,34
1658092310248,MATH 20C,A02,083761,Briones; Jor-el Thomas Caparas,8,0,35,27
1658092310248,MATH 20C,A03,093476,Briones; Jor-el Thomas Caparas,0,1,36,36
1658092310248,MATH 20C,B01,083762,Bach; Quang Tran,1,0,30,29
1658092316273,MATH 20D,A01,083765,Tran; Brian Kha,5,0,30,25
1658092316273,MATH 20D,A02,083766,Tran; Brian Kha,5,0,30,25
1658092316273,MATH 20D,A03,083767,Tran; Brian Kha,6,0,30,24
1658092322306,MATH 20E,A01,083771,Ganguly; Soumya,12,0,32,20
1658092322306,MATH 20E,A02,083772,Ganguly; Soumya,7,0,32,25
1658092322306,MATH 20E,B01,083773,Ciotti; Benjamin,20,0,35,15
1658092322306,MATH 20E,B02,083774,Ciotti; Benjamin,18,0,35,17
1658092328340,MATH 103A,A01,083777,Greenfeld; Be'Eri,6,0,36,30
1658092328340,MATH 103A,A02,083778,Greenfeld; Be'Eri,5,0,36,31
1658092328340,MATH 103A,A03,093561,Greenfeld; Be'Eri,7,0,36,29
1658092328340,MATH 103A,B01,083779,Greenfeld; Be'Eri,8,0,36,28
1658092328340,MATH 103A,B02,083780,Greenfeld; Be'Eri,4,0,36,32
1658092328340,MATH 103A,B03,093562,Greenfeld; Be'Eri,3,0,36,33
1658092334372,MATH 105,A01,085443,Carter; Anne Toulson,15,0,35,20
1658092334372,MATH 105,A02,093477,Carter; Anne Toulson,20,0,35,15
1658092340397,MATH 109,A01,083213,Ganzberger; Geoffrey Michael,3,0,34,31
1658092340397,MATH 109,A02,083214,Ganzberger; Geoffrey Michael,4,0,34,30
1658092340397,MATH 109,A03,093478,Ganzberger; Geoffrey Michael,2,0,34,32
1658092340397,MATH 109,B01,083215,Ganzberger; Geoffrey Michael,3,0,32,29
1658092340397,MATH 109,B02,083216,Ganzberger; Geoffrey Michael,3,0,32,29
1658092340397,MATH 109,B03,093479,Ganzberger; Geoffrey Michael,8,0,32,24
1658092346425,MATH 142A,A01,083219,Chow; Bennett,7,0,32,25
1658092346425,MATH 142A,A02,083220,Chow; Bennett,10,0,32,22
1658092346425,MATH 142A,A03,093480,Chow; Bennett,9,0,32,23
1658092346425,MATH 142A,B03,093481,Chow; Bennett,8,0,32,24
1658092346425,MATH 142A,B04,093558,Chow; Bennett,14,0,32,18
1658092346425,MATH 142A,B05,093559,Chow; Bennett,7,0,32,25
1658092352449,MATH 193A,A01,083224,Rotar; Vladimir,9,0,34,25
1658092352449,MATH 193A,A02,083225,Rotar; Vladimir,11,0,34,23
1658092352449,MATH 193A,A03,083781,Rotar; Vladimir,5,0,34,29
1658092352449,MATH 193A,A04,083782,Rotar; Vladimir,12,0,34,22
1658092352449,MATH 193A,A05,093482,Rotar; Vladimir,11,0,34,23
1658092358471,MATH 197,001,091859,McAuley; Julian John,9999,0,9999,0
1658092358471,MATH 197,002,095566,Kedlaya; Kiran S.,9997,0,9999,2
1658092358471,MATH 197,003,095567,Xiao; Ming,9999,0,9999,0
1658092358471,MATH 197,004,095571,Perols; Johan Lars,9998,0,9999,1
1658092365530,COGS 9,A01,083615,Shannon; Kyle Michael,11,0,75,64
1658092371558,COGS 11,A01,083617,Boyle; Mary E. T.,23,0,48,25
1658092377581,COGS 13,A01,083071,Bastos; Amalia Pinkusfeld,12,0,71,59
1658092383604,COGS 14A,A01,092681,Semenuks; Arturs,5,1,100,95
1658092389628,COGS 14B,A01,083073,Cheng; Tzu-Han,7,0,63,56
1658092395651,COGS 17,A01,092677,Semenuks; Arturs,7,0,81,74
1658092401672,COGS 100,A01,083619,Allen; Michael Gordon,17,0,70,53
1658092407700,COGS 101A,A01,083621,Davis; Joshua Daniel,9,0,68,59
1658092413728,COGS 101B,A01,091572,Allen; Michael Gordon,14,0,65,51
1658092419752,COGS 101C,A01,083625,Delgado; Tania,17,0,35,18
1658092425775,COGS 107A,A01,083627,Boyle; Mary E. T.,14,0,60,46
1658092431801,COGS 118A,A01,083075,Gupta; Anjum,21,0,76,55
1658092437829,CSE 3,A50,083646,Miranda; Gregory Joseph,24,0,50,26
1658092443855,CSE 8A,A50,083650,Miranda; Gregory Joseph,17,1,56,39
1658092449881,CSE 11,A01,083080,Cao; Yingjun,7,15,40,33
1658092456001,CSE 12,A01,083652,Krause-Levy; Sophia Louisa,30,1,120,90
1658092462024,CSE 15L,A01,083654,Morris; Justin Loren,9,0,50,41
1658092462024,CSE 15L,A02,083655,Morris; Justin Loren,11,0,50,39
1658092468052,CSE 20,A01,083657,Tran; Khoa Dang,39,0,80,41
1658092474075,CSE 21,A01,095574,Bach; Quang Tran,23,0,48,25
1658092480098,CSE 30,A01,083084,Eldon; John,8,0,80,72
1658092480098,CSE 30,B01,095061,Bhaskar; Nishant,9,0,50,41
1658092486122,CSE 100,A01,083659,Cao; Yingjun,5,4,70,65
1658092492145,CSE 134B,A01,083661,Powell; Thomas Allan,25,0,100,75
1658092498169,CSE 140,A01,083663,Gungor; Onat,17,0,85,68
1658092504193,CSE 140L,A01,083088,Eldon; John,23,0,100,77
1658092510217,CSE 175,A01,083665,Kumar; Rakesh,3,0,25,22
1658092516244,CSE 190,A00,092507,Dubnov; Shlomo,8,0,20,12
1658092522271,ECE 45,A01,083139,Congero; Spencer William,7,0,75,68
1658092528294,ECE 65,A50,083695,Saad; Andrew S,12,0,30,18
1658092528294,ECE 65,A51,095125,Saad; Andrew S,24,0,26,2
1658092534318,ECE 109,A01,091882,Touri; Behrouz,21,0,70,49
1658092540385,ECE 180,A00,083140,Abi Samra; Nicholas Camill,1,0,30,29
1658092540385,ECE 180,B00,083141,Abi Samra; Nicholas Camill,0,0,30,30
1658092546415,MATH 10A,A01,083735,Patchell; Gregory David,2,0,30,28
1658092546415,MATH 10A,A02,083736,Patchell; Gregory David,20,0,30,10
1658092546415,MATH 10A,A03,083737,Patchell; Gregory David,16,0,30,14
1658092552444,MATH 10B,A01,083207,Lim; Seonhee,9,0,34,25
1658092552444,MATH 10B,A02,083208,Lim; Seonhee,10,0,35,25
1658092552444,MATH 10B,A03,093472,Lim; Seonhee,7,0,34,27
1658092552444,MATH 10B,B01,083739,Sinha; Shubham,14,0,30,16
1658092558466,MATH 18,A01,083743,Cinel; Cameron Alexander,9,0,30,21
1658092558466,MATH 18,A02,083744,Cinel; Cameron Alexander,18,0,30,12
1658092558466,MATH 18,A03,083745,Cinel; Cameron Alexander,10,0,30,20
1658092558466,MATH 18,B01,083748,Rideout; David Porter,5,0,37,32
1658092558466,MATH 18,B02,083749,Rideout; David Porter,5,0,36,31
1658092558466,MATH 18,B03,083750,Rideout; David Porter,3,0,37,34
1658092558466,MATH 18,B04,083751,Rideout; David Porter,7,0,36,29
1658092558466,MATH 18,B05,093473,Rideout; David Porter,7,0,36,29
1658092558466,MATH 18,B06,093474,Rideout; David Porter,6,0,36,30
1658092564493,MATH 20A,A01,083754,Zheng; Zequn,14,0,40,26
1658092570540,MATH 20B,A01,083756,Briones; Jor-el Thomas Caparas,4,0,36,32
1658092570540,MATH 20B,A02,083757,Briones; Jor-el Thomas Caparas,1,0,36,35
1658092570540,MATH 20B,A03,093475,Briones; Jor-el Thomas Caparas,3,0,36,33
1658092576564,MATH 20C,A01,083760,Briones; Jor-el Thomas Caparas,1,0,35,34
1658092576564,MATH 20C,A02,083761,Briones; Jor-el Thomas Caparas,8,0,35,27
1658092576564,MATH 20C,A03,093476,Briones; Jor-el Thomas Caparas,0,1,36,36
1658092576564,MATH 20C,B01,083762,Bach; Quang Tran,1,0,30,29
1658092582588,MATH 20D,A01,083765,Tran; Brian Kha,5,0,30,25
1658092582588,MATH 20D,A02,083766,Tran; Brian Kha,5,0,30,25
1658092582588,MATH 20D,A03,083767,Tran; Brian Kha,6,0,30,24
1658092588612,MATH 20E,A01,083771,Ganguly; Soumya,12,0,32,20
1658092588612,MATH 20E,A02,083772,Ganguly; Soumya,7,0,32,25
1658092588612,MATH 20E,B01,083773,Ciotti; Benjamin,20,0,35,15
1658092588612,MATH 20E,B02,083774,Ciotti; Benjamin,18,0,35,17
1658092594647,MATH 103A,A01,083777,Greenfeld; Be'Eri,6,0,36,30
1658092594647,MATH 103A,A02,083778,Greenfeld; Be'Eri,5,0,36,31
1658092594647,MATH 103A,A03,093561,Greenfeld; Be'Eri,7,0,36,29
1658092594647,MATH 103A,B01,083779,Greenfeld; Be'Eri,8,0,36,28
1658092594647,MATH 103A,B02,083780,Greenfeld; Be'Eri,4,0,36,32
1658092594647,MATH 103A,B03,093562,Greenfeld; Be'Eri,3,0,36,33
1658092600673,MATH 105,A01,085443,Carter; Anne Toulson,15,0,35,20
1658092600673,MATH 105,A02,093477,Carter; Anne Toulson,20,0,35,15
1658092606695,MATH 109,A01,083213,Ganzberger; Geoffrey Michael,3,0,34,31
1658092606695,MATH 109,A02,083214,Ganzberger; Geoffrey Michael,4,0,34,30
1658092606695,MATH 109,A03,093478,Ganzberger; Geoffrey Michael,2,0,34,32
1658092606695,MATH 109,B01,083215,Ganzberger; Geoffrey Michael,3,0,32,29
1658092606695,MATH 109,B02,083216,Ganzberger; Geoffrey Michael,3,0,32,29
1658092606695,MATH 109,B03,093479,Ganzberger; Geoffrey Michael,8,0,32,24
1658092612719,MATH 142A,A01,083219,Chow; Bennett,7,0,32,25
1658092612719,MATH 142A,A02,083220,Chow; Bennett,10,0,32,22
1658092612719,MATH 142A,A03,093480,Chow; Bennett,9,0,32,23
1658092612719,MATH 142A,B03,093481,Chow; Bennett,8,0,32,24
1658092612719,MATH 142A,B04,093558,Chow; Bennett,14,0,32,18
1658092612719,MATH 142A,B05,093559,Chow; Bennett,7,0,32,25
1658092618742,MATH 193A,A01,083224,Rotar; Vladimir,9,0,34,25
1658092618742,MATH 193A,A02,083225,Rotar; Vladimir,11,0,34,23
1658092618742,MATH 193A,A03,083781,Rotar; Vladimir,5,0,34,29
1658092618742,MATH 193A,A04,083782,Rotar; Vladimir,12,0,34,22
1658092618742,MATH 193A,A05,093482,Rotar; Vladimir,11,0,34,23
1658092624766,MATH 197,001,091859,McAuley; Julian John,9999,0,9999,0
1658092624766,MATH 197,002,095566,Kedlaya; Kiran S.,9997,0,9999,2
1658092624766,MATH 197,003,095567,Xiao; Ming,9999,0,9999,0
1658092624766,MATH 197,004,095571,Perols; Johan Lars,9998,0,9999,1
1658092631823,COGS 9,A01,083615,Shannon; Kyle Michael,11,0,75,64
1658092637851,COGS 11,A01,083617,Boyle; Mary E. T.,23,0,48,25
1658092643878,COGS 13,A01,083071,Bastos; Amalia Pinkusfeld,12,0,71,59
1658092649901,COGS 14A,A01,092681,Semenuks; Arturs,5,1,100,95
1658092655928,COGS 14B,A01,083073,Cheng; Tzu-Han,7,0,63,56
1658092661950,COGS 17,A01,092677,Semenuks; Arturs,7,0,81,74
1658092667973,COGS 100,A01,083619,Allen; Michael Gordon,17,0,70,53
1658092673999,COGS 101A,A01,083621,Davis; Joshua Daniel,9,0,68,59
1658092680031,COGS 101B,A01,091572,Allen; Michael Gordon,14,0,65,51
1658092686054,COGS 101C,A01,083625,Delgado; Tania,17,0,35,18
1658092692079,COGS 107A,A01,083627,Boyle; Mary E. T.,14,0,60,46
1658092698103,COGS 118A,A01,083075,Gupta; Anjum,21,0,76,55
1658092704131,CSE 3,A50,083646,Miranda; Gregory Joseph,24,0,50,26
1658092710157,CSE 8A,A50,083650,Miranda; Gregory Joseph,17,1,56,39
1658092716179,CSE 11,A01,083080,Cao; Yingjun,7,15,40,33
1658092722202,CSE 12,A01,083652,Krause-Levy; Sophia Louisa,30,1,120,90
1658092728227,CSE 15L,A01,083654,Morris; Justin Loren,9,0,50,41
1658092728227,CSE 15L,A02,083655,Morris; Justin Loren,11,0,50,39
1658092734254,CSE 20,A01,083657,Tran; Khoa Dang,39,0,80,41
1658092740280,CSE 21,A01,095574,Bach; Quang Tran,23,0,48,25
1658092746306,CSE 30,A01,083084,Eldon; John,8,0,80,72
1658092746306,CSE 30,B01,095061,Bhaskar; Nishant,9,0,50,41
1658092752336,CSE 100,A01,083659,Cao; Yingjun,5,4,70,65
1658092758368,CSE 134B,A01,083661,Powell; Thomas Allan,25,0,100,75
1658092764389,CSE 140,A01,083663,Gungor; Onat,17,0,85,68
1658092770413,CSE 140L,A01,083088,Eldon; John,23,0,100,77
1658092776438,CSE 175,A01,083665,Kumar; Rakesh,3,0,25,22
1658092782461,CSE 190,A00,092507,Dubnov; Shlomo,8,0,20,12
1658092788485,ECE 45,A01,083139,Congero; Spencer William,7,0,75,68
1658092794520,ECE 65,A50,083695,Saad; Andrew S,12,0,30,18
1658092794520,ECE 65,A51,095125,Saad; Andrew S,24,0,26,2
1658092800547,ECE 109,A01,091882,Touri; Behrouz,21,0,70,49
1658092806570,ECE 180,A00,083140,Abi Samra; Nicholas Camill,1,0,30,29
1658092806570,ECE 180,B00,083141,Abi Samra; Nicholas Camill,0,0,30,30
1658092812597,MATH 10A,A01,083735,Patchell; Gregory David,2,0,30,28
1658092812597,MATH 10A,A02,083736,Patchell; Gregory David,20,0,30,10
1658092812597,MATH 10A,A03,083737,Patchell; Gregory David,16,0,30,14
1658092818627,MATH 10B,A01,083207,Lim; Seonhee,9,0,34,25
1658092818627,MATH 10B,A02,083208,Lim; Seonhee,10,0,35,25
1658092818627,MATH 10B,A03,093472,Lim; Seonhee,7,0,34,27
1658092818627,MATH 10B,B01,083739,Sinha; Shubham,14,0,30,16
1658092824658,MATH 18,A01,083743,Cinel; Cameron Alexander,9,0,30,21
1658092824658,MATH 18,A02,083744,Cinel; Cameron Alexander,18,0,30,12
1658092824658,MATH 18,A03,083745,Cinel; Cameron Alexander,10,0,30,20
1658092824658,MATH 18,B01,083748,Rideout; David Porter,5,0,37,32
1658092824658,MATH 18,B02,083749,Rideout; David Porter,5,0,36,31
1658092824658,MATH 18,B03,083750,Rideout; David Porter,3,0,37,34
1658092824658,MATH 18,B04,083751,Rideout; David Porter,7,0,36,29
1658092824658,MATH 18,B05,093473,Rideout; David Porter,7,0,36,29
1658092824658,MATH 18,B06,093474,Rideout; David Porter,6,0,36,30
1658092830681,MATH 20A,A01,083754,Zheng; Zequn,14,0,40,26
1658092836702,MATH 20B,A01,083756,Briones; Jor-el Thomas Caparas,4,0,36,32
1658092836702,MATH 20B,A02,083757,Briones; Jor-el Thomas Caparas,1,0,36,35
1658092836702,MATH 20B,A03,093475,Briones; Jor-el Thomas Caparas,3,0,36,33
1658092842732,MATH 20C,A01,083760,Briones; Jor-el Thomas Caparas,1,0,35,34
1658092842732,MATH 20C,A02,083761,Briones; Jor-el Thomas Caparas,8,0,35,27
1658092842732,MATH 20C,A03,093476,Briones; Jor-el Thomas Caparas,0,1,36,36
1658092842732,MATH 20C,B01,083762,Bach; Quang Tran,1,0,30,29
1658092848756,MATH 20D,A01,083765,Tran; Brian Kha,5,0,30,25
1658092848756,MATH 20D,A02,083766,Tran; Brian Kha,5,0,30,25
1658092848756,MATH 20D,A03,083767,Tran; Brian Kha,6,0,30,24
1658092854778,MATH 20E,A01,083771,Ganguly; Soumya,12,0,32,20
1658092854778,MATH 20E,A02,083772,Ganguly; Soumya,7,0,32,25
1658092854778,MATH 20E,B01,083773,Ciotti; Benjamin,20,0,35,15
1658092854778,MATH 20E,B02,083774,Ciotti; Benjamin,18,0,35,17
1658092860803,MATH 103A,A01,083777,Greenfeld; Be'Eri,6,0,36,30
1658092860803,MATH 103A,A02,083778,Greenfeld; Be'Eri,5,0,36,31
1658092860803,MATH 103A,A03,093561,Greenfeld; Be'Eri,7,0,36,29
1658092860803,MATH 103A,B01,083779,Greenfeld; Be'Eri,8,0,36,28
1658092860803,MATH 103A,B02,083780,Greenfeld; Be'Eri,4,0,36,32
1658092860803,MATH 103A,B03,093562,Greenfeld; Be'Eri,3,0,36,33
1658092866826,MATH 105,A01,085443,Carter; Anne Toulson,15,0,35,20
1658092866826,MATH 105,A02,093477,Carter; Anne Toulson,20,0,35,15
1658092872853,MATH 109,A01,083213,Ganzberger; Geoffrey Michael,3,0,34,31
1658092872853,MATH 109,A02,083214,Ganzberger; Geoffrey Michael,4,0,34,30
1658092872853,MATH 109,A03,093478,Ganzberger; Geoffrey Michael,2,0,34,32
1658092872853,MATH 109,B01,083215,Ganzberger; Geoffrey Michael,3,0,32,29
1658092872853,MATH 109,B02,083216,Ganzberger; Geoffrey Michael,3,0,32,29
1658092872853,MATH 109,B03,093479,Ganzberger; Geoffrey Michael,8,0,32,24
1658092878877,MATH 142A,A01,083219,Chow; Bennett,7,0,32,25
1658092878877,MATH 142A,A02,083220,Chow; Bennett,10,0,32,22
1658092878877,MATH 142A,A03,093480,Chow; Bennett,9,0,32,23
1658092878877,MATH 142A,B03,093481,Chow; Bennett,8,0,32,24
1658092878877,MATH 142A,B04,093558,Chow; Bennett,14,0,32,18
1658092878877,MATH 142A,B05,093559,Chow; Bennett,7,0,32,25
1658092884901,MATH 193A,A01,083224,Rotar; Vladimir,9,0,34,25
1658092884901,MATH 193A,A02,083225,Rotar; Vladimir,11,0,34,23
1658092884901,MATH 193A,A03,083781,Rotar; Vladimir,5,0,34,29
1658092884901,MATH 193A,A04,083782,Rotar; Vladimir,12,0,34,22
1658092884901,MATH 193A,A05,093482,Rotar; Vladimir,11,0,34,23
1658092890925,MATH 197,001,091859,McAuley; Julian John,9999,0,9999,0
1658092890925,MATH 197,002,095566,Kedlaya; Kiran S.,9997,0,9999,2
1658092890925,MATH 197,003,095567,Xiao; Ming,9999,0,9999,0
1658092890925,MATH 197,004,095571,Perols; Johan Lars,9998,0,9999,1
1658092897986,COGS 9,A01,083615,Shannon; Kyle Michael,11,0,75,64
1658092904013,COGS 11,A01,083617,Boyle; Mary E. T.,23,0,48,25
1658092910035,COGS 13,A01,083071,Bastos; Amalia Pinkusfeld,12,0,71,59
1658092916058,COGS 14A,A01,092681,Semenuks; Arturs,5,1,100,95
1658092922086,COGS 14B,A01,083073,Cheng; Tzu-Han,7,0,63,56
1658092928116,COGS 17,A01,092677,Semenuks; Arturs,7,0,81,74
1658092934143,COGS 100,A01,083619,Allen; Michael Gordon,17,0,70,53
1658092940167,COGS 101A,A01,083621,Davis; Joshua Daniel,9,0,68,59
1658092946190,COGS 101B,A01,091572,Allen; Michael Gordon,14,0,65,51
1658092952214,COGS 101C,A01,083625,Delgado; Tania,17,0,35,18
1658092958237,COGS 107A,A01,083627,Boyle; Mary E. T.,14,0,60,46
1658092964263,COGS 118A,A01,083075,Gupta; Anjum,21,0,76,55
1658092970290,CSE 3,A50,083646,Miranda; Gregory Joseph,24,0,50,26
1658092976315,CSE 8A,A50,083650,Miranda; Gregory Joseph,17,1,56,39
1658092982341,CSE 11,A01,083080,Cao; Yingjun,7,15,40,33
1658092988365,CSE 12,A01,083652,Krause-Levy; Sophia Louisa,30,1,120,90
1658092994387,CSE 15L,A01,083654,Morris; Justin Loren,9,0,50,41
1658092994387,CSE 15L,A02,083655,Morris; Justin Loren,11,0,50,39
1658093000413,CSE 20,A01,083657,Tran; Khoa Dang,39,0,80,41
1658093006436,CSE 21,A01,095574,Bach; Quang Tran,23,0,48,25
1658093012459,CSE 30,A01,083084,Eldon; John,8,0,80,72
1658093012459,CSE 30,B01,095061,Bhaskar; Nishant,9,0,50,41
1658093018485,CSE 100,A01,083659,Cao; Yingjun,5,4,70,65
1658093024509,CSE 134B,A01,083661,Powell; Thomas Allan,25,0,100,75
1658093030533,CSE 140,A01,083663,Gungor; Onat,17,0,85,68
1658093036563,CSE 140L,A01,083088,Eldon; John,23,0,100,77
1658093042587,CSE 175,A01,083665,Kumar; Rakesh,3,0,25,22
1658093048611,CSE 190,A00,092507,Dubnov; Shlomo,8,0,20,12
1658093054711,ECE 45,A01,083139,Congero; Spencer William,7,0,75,68
1658093060735,ECE 65,A50,083695,Saad; Andrew S,12,0,30,18
1658093060735,ECE 65,A51,095125,Saad; Andrew S,24,0,26,2
1658093066758,ECE 109,A01,091882,Touri; Behrouz,21,0,70,49
1658093072784,ECE 180,A00,083140,Abi Samra; Nicholas Camill,1,0,30,29
1658093072784,ECE 180,B00,083141,Abi Samra; Nicholas Camill,0,0,30,30
1658093078807,MATH 10A,A01,083735,Patchell; Gregory David,2,0,30,28
1658093078807,MATH 10A,A02,083736,Patchell; Gregory David,20,0,30,10
1658093078807,MATH 10A,A03,083737,Patchell; Gregory David,16,0,30,14
1658093084830,MATH 10B,A01,083207,Lim; Seonhee,9,0,34,25
1658093084830,MATH 10B,A02,083208,Lim; Seonhee,10,0,35,25
1658093084830,MATH 10B,A03,093472,Lim; Seonhee,7,0,34,27
1658093084830,MATH 10B,B01,083739,Sinha; Shubham,14,0,30,16
1658093090854,MATH 18,A01,083743,Cinel; Cameron Alexander,9,0,30,21
1658093090854,MATH 18,A02,083744,Cinel; Cameron Alexander,18,0,30,12
1658093090854,MATH 18,A03,083745,Cinel; Cameron Alexander,10,0,30,20
1658093090854,MATH 18,B01,083748,Rideout; David Porter,5,0,37,32
1658093090854,MATH 18,B02,083749,Rideout; David Porter,5,0,36,31
1658093090854,MATH 18,B03,083750,Rideout; David Porter,3,0,37,34
1658093090854,MATH 18,B04,083751,Rideout; David Porter,7,0,36,29
1658093090854,MATH 18,B05,093473,Rideout; David Porter,7,0,36,29
1658093090854,MATH 18,B06,093474,Rideout; David Porter,6,0,36,30
1658093096878,MATH 20A,A01,083754,Zheng; Zequn,14,0,40,26
1658093102902,MATH 20B,A01,083756,Briones; Jor-el Thomas Caparas,4,0,36,32
1658093102902,MATH 20B,A02,083757,Briones; Jor-el Thomas Caparas,1,0,36,35
1658093102902,MATH 20B,A03,093475,Briones; Jor-el Thomas Caparas,3,0,36,33
1658093108932,MATH 20C,A01,083760,Briones; Jor-el Thomas Caparas,1,0,35,34
1658093108932,MATH 20C,A02,083761,Briones; Jor-el Thomas Caparas,8,0,35,27
1658093108932,MATH 20C,A03,093476,Briones; Jor-el Thomas Caparas,0,1,36,36
1658093108932,MATH 20C,B01,083762,Bach; Quang Tran,1,0,30,29
1658093114957,MATH 20D,A01,083765,Tran; Brian Kha,5,0,30,25
1658093114957,MATH 20D,A02,083766,Tran; Brian Kha,5,0,30,25
1658093114957,MATH 20D,A03,083767,Tran; Brian Kha,6,0,30,24
1658093120986,MATH 20E,A01,083771,Ganguly; Soumya,12,0,32,20
1658093120986,MATH 20E,A02,083772,Ganguly; Soumya,7,0,32,25
1658093120986,MATH 20E,B01,083773,Ciotti; Benjamin,20,0,35,15
1658093120986,MATH 20E,B02,083774,Ciotti; Benjamin,18,0,35,17
1658093127011,MATH 103A,A01,083777,Greenfeld; Be'Eri,6,0,36,30
1658093127011,MATH 103A,A02,083778,Greenfeld; Be'Eri,5,0,36,31
1658093127011,MATH 103A,A03,093561,Greenfeld; Be'Eri,7,0,36,29
1658093127011,MATH 103A,B01,083779,Greenfeld; Be'Eri,8,0,36,28
1658093127011,MATH 103A,B02,083780,Greenfeld; Be'Eri,4,0,36,32
1658093127011,MATH 103A,B03,093562,Greenfeld; Be'Eri,3,0,36,33
1658093133036,MATH 105,A01,085443,Carter; Anne Toulson,15,0,35,20
1658093133036,MATH 105,A02,093477,Carter; Anne Toulson,20,0,35,15
1658093139061,MATH 109,A01,083213,Ganzberger; Geoffrey Michael,3,0,34,31
1658093139061,MATH 109,A02,083214,Ganzberger; Geoffrey Michael,4,0,34,30
1658093139061,MATH 109,A03,093478,Ganzberger; Geoffrey Michael,2,0,34,32
1658093139061,MATH 109,B01,083215,Ganzberger; Geoffrey Michael,3,0,32,29
1658093139061,MATH 109,B02,083216,Ganzberger; Geoffrey Michael,3,0,32,29
1658093139061,MATH 109,B03,093479,Ganzberger; Geoffrey Michael,8,0,32,24
1658093145087,MATH 142A,A01,083219,Chow; Bennett,7,0,32,25
1658093145087,MATH 142A,A02,083220,Chow; Bennett,10,0,32,22
1658093145087,MATH 142A,A03,093480,Chow; Bennett,9,0,32,23
1658093145087,MATH 142A,B03,093481,Chow; Bennett,8,0,32,24
1658093145087,MATH 142A,B04,093558,Chow; Bennett,14,0,32,18
1658093145087,MATH 142A,B05,093559,Chow; Bennett,7,0,32,25
1658093151118,MATH 193A,A01,083224,Rotar; Vladimir,9,0,34,25
1658093151118,MATH 193A,A02,083225,Rotar; Vladimir,11,0,34,23
1658093151118,MATH 193A,A03,083781,Rotar; Vladimir,5,0,34,29
1658093151118,MATH 193A,A04,083782,Rotar; Vladimir,12,0,34,22
1658093151118,MATH 193A,A05,093482,Rotar; Vladimir,11,0,34,23
1658093157144,MATH 197,001,091859,McAuley; Julian John,9999,0,9999,0
1658093157144,MATH 197,002,095566,Kedlaya; Kiran S.,9997,0,9999,2
1658093157144,MATH 197,003,095567,Xiao; Ming,9999,0,9999,0
1658093157144,MATH 197,004,095571,Perols; Johan Lars,9998,0,9999,1
1658093164194,COGS 9,A01,083615,Shannon; Kyle Michael,11,0,75,64
1658093170218,COGS 11,A01,083617,Boyle; Mary E. T.,23,0,48,25
1658093176254,COGS 13,A01,083071,Bastos; Amalia Pinkusfeld,12,0,71,59
1658093182277,COGS 14A,A01,092681,Semenuks; Arturs,5,1,100,95
1658093188304,COGS 14B,A01,083073,Cheng; Tzu-Han,7,0,63,56
1658093194328,COGS 17,A01,092677,Semenuks; Arturs,7,0,81,74
1658093200354,COGS 100,A01,083619,Allen; Michael Gordon,17,0,70,53
1658093206381,COGS 101A,A01,083621,Davis; Joshua Daniel,9,0,68,59
1658093212404,COGS 101B,A01,091572,Allen; Michael Gordon,14,0,65,51
1658093218432,COGS 101C,A01,083625,Delgado; Tania,17,0,35,18
1658093224458,COGS 107A,A01,083627,Boyle; Mary E. T.,14,0,60,46
1658093230492,COGS 118A,A01,083075,Gupta; Anjum,21,0,76,55
1658093236520,CSE 3,A50,083646,Miranda; Gregory Joseph,24,0,50,26
1658093242548,CSE 8A,A50,083650,Miranda; Gregory Joseph,17,1,56,39
1658093248571,CSE 11,A01,083080,Cao; Yingjun,7,15,40,33
1658093254594,CSE 12,A01,083652,Krause-Levy; Sophia Louisa,30,1,120,90
1658093260619,CSE 15L,A01,083654,Morris; Justin Loren,9,0,50,41
1658093260619,CSE 15L,A02,083655,Morris; Justin Loren,11,0,50,39
1658093266642,CSE 20,A01,083657,Tran; Khoa Dang,39,0,80,41
1658093272665,CSE 21,A01,095574,Bach; Quang Tran,23,0,48,25
1658093278688,CSE 30,A01,083084,Eldon; John,8,0,80,72
1658093278688,CSE 30,B01,095061,Bhaskar; Nishant,9,0,50,41
1658093284719,CSE 100,A01,083659,Cao; Yingjun,5,4,70,65
1658093290740,CSE 134B,A01,083661,Powell; Thomas Allan,25,0,100,75
1658093296764,CSE 140,A01,083663,Gungor; Onat,17,0,85,68
1658093302786,CSE 140L,A01,083088,Eldon; John,23,0,100,77
1658093308814,CSE 175,A01,083665,Kumar; Rakesh,3,0,25,22
1658093314836,CSE 190,A00,092507,Dubnov; Shlomo,8,0,20,12
1658093320862,ECE 45,A01,083139,Congero; Spencer William,7,0,75,68
1658093326885,ECE 65,A50,083695,Saad; Andrew S,12,0,30,18
1658093326885,ECE 65,A51,095125,Saad; Andrew S,24,0,26,2
1658093332907,ECE 109,A01,091882,Touri; Behrouz,21,0,70,49
1658093338932,ECE 180,A00,083140,Abi Samra; Nicholas Camill,1,0,30,29
1658093338932,ECE 180,B00,083141,Abi Samra; Nicholas Camill,0,0,30,30
1658093344955,MATH 10A,A01,083735,Patchell; Gregory David,2,0,30,28
1658093344955,MATH 10A,A02,083736,Patchell; Gregory David,20,0,30,10
1658093344955,MATH 10A,A03,083737,Patchell; Gregory David,16,0,30,14
1658093350980,MATH 10B,A01,083207,Lim; Seonhee,9,0,34,25
1658093350980,MATH 10B,A02,083208,Lim; Seonhee,10,0,35,25
1658093350980,MATH 10B,A03,093472,Lim; Seonhee,7,0,34,27
1658093350980,MATH 10B,B01,083739,Sinha; Shubham,14,0,30,16
1658093357004,MATH 18,A01,083743,Cinel; Cameron Alexander,9,0,30,21
1658093357004,MATH 18,A02,083744,Cinel; Cameron Alexander,18,0,30,12
1658093357004,MATH 18,A03,083745,Cinel; Cameron Alexander,10,0,30,20
1658093357004,MATH 18,B01,083748,Rideout; David Porter,5,0,37,32
1658093357004,MATH 18,B02,083749,Rideout; David Porter,5,0,36,31
1658093357004,MATH 18,B03,083750,Rideout; David Porter,3,0,37,34
1658093357004,MATH 18,B04,083751,Rideout; David Porter,7,0,36,29
1658093357004,MATH 18,B05,093473,Rideout; David Porter,7,0,36,29
1658093357004,MATH 18,B06,093474,Rideout; David Porter,6,0,36,30
1658093363025,MATH 20A,A01,083754,Zheng; Zequn,14,0,40,26
1658093369047,MATH 20B,A01,083756,Briones; Jor-el Thomas Caparas,4,0,36,32
1658093369047,MATH 20B,A02,083757,Briones; Jor-el Thomas Caparas,1,0,36,35
1658093369047,MATH 20B,A03,093475,Briones; Jor-el Thomas Caparas,3,0,36,33
1658093375073,MATH 20C,A01,083760,Briones; Jor-el Thomas Caparas,1,0,35,34
1658093375073,MATH 20C,A02,083761,Briones; Jor-el Thomas Caparas,8,0,35,27
1658093375073,MATH 20C,A03,093476,Briones; Jor-el Thomas Caparas,0,1,36,36
1658093375073,MATH 20C,B01,083762,Bach; Quang Tran,1,0,30,29
1658093381097,MATH 20D,A01,083765,Tran; Brian Kha,5,0,30,25
1658093381097,MATH 20D,A02,083766,Tran; Brian Kha,5,0,30,25
1658093381097,MATH 20D,A03,083767,Tran; Brian Kha,6,0,30,24
1658093387121,MATH 20E,A01,083771,Ganguly; Soumya,12,0,32,20
1658093387121,MATH 20E,A02,083772,Ganguly; Soumya,7,0,32,25
1658093387121,MATH 20E,B01,083773,Ciotti; Benjamin,20,0,35,15
1658093387121,MATH 20E,B02,083774,Ciotti; Benjamin,18,0,35,17
1658093393154,MATH 103A,A01,083777,Greenfeld; Be'Eri,6,0,36,30
1658093393154,MATH 103A,A02,083778,Greenfeld; Be'Eri,5,0,36,31
1658093393154,MATH 103A,A03,093561,Greenfeld; Be'Eri,7,0,36,29
1658093393154,MATH 103A,B01,083779,Greenfeld; Be'Eri,8,0,36,28
1658093393154,MATH 103A,B02,083780,Greenfeld; Be'Eri,4,0,36,32
1658093393154,MATH 103A,B03,093562,Greenfeld; Be'Eri,3,0,36,33
1658093399177,MATH 105,A01,085443,Carter; Anne Toulson,15,0,35,20
1658093399177,MATH 105,A02,093477,Carter; Anne Toulson,20,0,35,15
1658093405202,MATH 109,A01,083213,Ganzberger; Geoffrey Michael,3,0,34,31
1658093405202,MATH 109,A02,083214,Ganzberger; Geoffrey Michael,4,0,34,30
1658093405202,MATH 109,A03,093478,Ganzberger; Geoffrey Michael,2,0,34,32
1658093405202,MATH 109,B01,083215,Ganzberger; Geoffrey Michael,3,0,32,29
1658093405202,MATH 109,B02,083216,Ganzberger; Geoffrey Michael,3,0,32,29
1658093405202,MATH 109,B03,093479,Ganzberger; Geoffrey Michael,8,0,32,24
1658093411230,MATH 142A,A01,083219,Chow; Bennett,7,0,32,25
1658093411230,MATH 142A,A02,083220,Chow; Bennett,10,0,32,22
1658093411230,MATH 142A,A03,093480,Chow; Bennett,9,0,32,23
1658093411230,MATH 142A,B03,093481,Chow; Bennett,8,0,32,24
1658093411230,MATH 142A,B04,093558,Chow; Bennett,14,0,32,18
1658093411230,MATH 142A,B05,093559,Chow; Bennett,7,0,32,25
1658093417265,MATH 193A,A01,083224,Rotar; Vladimir,9,0,34,25
1658093417265,MATH 193A,A02,083225,Rotar; Vladimir,11,0,34,23
1658093417265,MATH 193A,A03,083781,Rotar; Vladimir,5,0,34,29
1658093417265,MATH 193A,A04,083782,Rotar; Vladimir,12,0,34,22
1658093417265,MATH 193A,A05,093482,Rotar; Vladimir,11,0,34,23
1658093423290,MATH 197,001,091859,McAuley; Julian John,9999,0,9999,0
1658093423290,MATH 197,002,095566,Kedlaya; Kiran S.,9997,0,9999,2
1658093423290,MATH 197,003,095567,Xiao; Ming,9999,0,9999,0
1658093423290,MATH 197,004,095571,Perols; Johan Lars,9998,0,9999,1
1658093430348,COGS 9,A01,083615,Shannon; Kyle Michael,11,0,75,64
1658093436374,COGS 11,A01,083617,Boyle; Mary E. T.,23,0,48,25
1658093442398,COGS 13,A01,083071,Bastos; Amalia Pinkusfeld,12,0,71,59
1658093448422,COGS 14A,A01,092681,Semenuks; Arturs,5,1,100,95
1658093454445,COGS 14B,A01,083073,Cheng; Tzu-Han,7,0,63,56
1658093460473,COGS 17,A01,092677,Semenuks; Arturs,7,0,81,74
1658093466497,COGS 100,A01,083619,Allen; Michael Gordon,17,0,70,53
1658093472524,COGS 101A,A01,083621,Davis; Joshua Daniel,9,0,68,59
1658093478547,COGS 101B,A01,091572,Allen; Michael Gordon,14,0,65,51
1658093484571,COGS 101C,A01,083625,Delgado; Tania,17,0,35,18
1658093490594,COGS 107A,A01,083627,Boyle; Mary E. T.,14,0,60,46
1658093496621,COGS 118A,A01,083075,Gupta; Anjum,21,0,76,55
1658093502648,CSE 3,A50,083646,Miranda; Gregory Joseph,24,0,50,26
1658093508671,CSE 8A,A50,083650,Miranda; Gregory Joseph,17,1,56,39
1658093514698,CSE 11,A01,083080,Cao; Yingjun,7,15,40,33
1658093520724,CSE 12,A01,083652,Krause-Levy; Sophia Louisa,30,1,120,90
1658093526748,CSE 15L,A01,083654,Morris; Justin Loren,9,0,50,41
1658093526748,CSE 15L,A02,083655,Morris; Justin Loren,11,0,50,39
1658093532775,CSE 20,A01,083657,Tran; Khoa Dang,39,0,80,41
1658093538798,CSE 21,A01,095574,Bach; Quang Tran,23,0,48,25
1658093544834,CSE 30,A01,083084,Eldon; John,8,0,80,72
1658093544834,CSE 30,B01,095061,Bhaskar; Nishant,9,0,50,41
1658093550861,CSE 100,A01,083659,Cao; Yingjun,5,4,70,65
1658093556885,CSE 134B,A01,083661,Powell; Thomas Allan,25,0,100,75
1658093562908,CSE 140,A01,083663,Gungor; Onat,17,0,85,68
1658093568934,CSE 140L,A01,083088,Eldon; John,23,0,100,77
1658093574964,CSE 175,A01,083665,Kumar; Rakesh,3,0,25,22
1658093580987,CSE 190,A00,092507,Dubnov; Shlomo,8,0,20,12
1658093587011,ECE 45,A01,083139,Congero; Spencer William,7,0,75,68
1658093593034,ECE 65,A50,083695,Saad; Andrew S,12,0,30,18
1658093593034,ECE 65,A51,095125,Saad; Andrew S,24,0,26,2
1658093599057,ECE 109,A01,091882,Touri; Behrouz,21,0,70,49
1658093605084,ECE 180,A00,083140,Abi Samra; Nicholas Camill,1,0,30,29
1658093605084,ECE 180,B00,083141,Abi Samra; Nicholas Camill,0,0,30,30
1658093611107,MATH 10A,A01,083735,Patchell; Gregory David,2,0,30,28
1658093611107,MATH 10A,A02,083736,Patchell; Gregory David,20,0,30,10
1658093611107,MATH 10A,A03,083737,Patchell; Gregory David,16,0,30,14
1658093617135,MATH 10B,A01,083207,Lim; Seonhee,9,0,34,25
1658093617135,MATH 10B,A02,083208,Lim; Seonhee,10,0,35,25
1658093617135,MATH 10B,A03,093472,Lim; Seonhee,7,0,34,27
1658093617135,MATH 10B,B01,083739,Sinha; Shubham,14,0,30,16
1658093623166,MATH 18,A01,083743,Cinel; Cameron Alexander,9,0,30,21
1658093623166,MATH 18,A02,083744,Cinel; Cameron Alexander,18,0,30,12
1658093623166,MATH 18,A03,083745,Cinel; Cameron Alexander,10,0,30,20
1658093623166,MATH 18,B01,083748,Rideout; David Porter,5,0,37,32
1658093623166,MATH 18,B02,083749,Rideout; David Porter,5,0,36,31
1658093623166,MATH 18,B03,083750,Rideout; David Porter,3,0,37,34
1658093623166,MATH 18,B04,083751,Rideout; David Porter,7,0,36,29
1658093623166,MATH 18,B05,093473,Rideout; David Porter,7,0,36,29
1658093623166,MATH 18,B06,093474,Rideout; David Porter,6,0,36,30
1658093629189,MATH 20A,A01,083754,Zheng; Zequn,14,0,40,26
1658093635214,MATH 20B,A01,083756,Briones; Jor-el Thomas Caparas,4,0,36,32
1658093635214,MATH 20B,A02,083757,Briones; Jor-el Thomas Caparas,1,0,36,35
1658093635214,MATH 20B,A03,093475,Briones; Jor-el Thomas Caparas,3,0,36,33
1658093641243,MATH 20C,A01,083760,Briones; Jor-el Thomas Caparas,1,0,35,34
1658093641243,MATH 20C,A02,083761,Briones; Jor-el Thomas Caparas,8,0,35,27
1658093641243,MATH 20C,A03,093476,Briones; Jor-el Thomas Caparas,0,1,36,36
1658093641243,MATH 20C,B01,083762,Bach; Quang Tran,1,0,30,29
1658093647267,MATH 20D,A01,083765,Tran; Brian Kha,5,0,30,25
1658093647267,MATH 20D,A02,083766,Tran; Brian Kha,5,0,30,25
1658093647267,MATH 20D,A03,083767,Tran; Brian Kha,6,0,30,24
1658093653367,MATH 20E,A01,083771,Ganguly; Soumya,12,0,32,20
1658093653367,MATH 20E,A02,083772,Ganguly; Soumya,7,0,32,25
1658093653367,MATH 20E,B01,083773,Ciotti; Benjamin,20,0,35,15
1658093653367,MATH 20E,B02,083774,Ciotti; Benjamin,18,0,35,17
1658093659396,MATH 103A,A01,083777,Greenfeld; Be'Eri,6,0,36,30
1658093659396,MATH 103A,A02,083778,Greenfeld; Be'Eri,5,0,36,31
1658093659396,MATH 103A,A03,093561,Greenfeld; Be'Eri,7,0,36,29
1658093659396,MATH 103A,B01,083779,Greenfeld; Be'Eri,8,0,36,28
1658093659396,MATH 103A,B02,083780,Greenfeld; Be'Eri,4,0,36,32
1658093659396,MATH 103A,B03,093562,Greenfeld; Be'Eri,3,0,36,33
1658093665421,MATH 105,A01,085443,Carter; Anne Toulson,15,0,35,20
1658093665421,MATH 105,A02,093477,Carter; Anne Toulson,20,0,35,15
1658093671452,MATH 109,A01,083213,Ganzberger; Geoffrey Michael,3,0,34,31
1658093671452,MATH 109,A02,083214,Ganzberger; Geoffrey Michael,4,0,34,30
1658093671452,MATH 109,A03,093478,Ganzberger; Geoffrey Michael,2,0,34,32
1658093671452,MATH 109,B01,083215,Ganzberger; Geoffrey Michael,3,0,32,29
1658093671452,MATH 109,B02,083216,Ganzberger; Geoffrey Michael,3,0,32,29
1658093671452,MATH 109,B03,093479,Ganzberger; Geoffrey Michael,8,0,32,24
1658093677477,MATH 142A,A01,083219,Chow; Bennett,7,0,32,25
1658093677477,MATH 142A,A02,083220,Chow; Bennett,10,0,32,22
1658093677477,MATH 142A,A03,093480,Chow; Bennett,9,0,32,23
1658093677477,MATH 142A,B03,093481,Chow; Bennett,8,0,32,24
1658093677477,MATH 142A,B04,093558,Chow; Bennett,14,0,32,18
1658093677477,MATH 142A,B05,093559,Chow; Bennett,7,0,32,25
1658093683505,MATH 193A,A01,083224,Rotar; Vladimir,9,0,34,25
1658093683505,MATH 193A,A02,083225,Rotar; Vladimir,11,0,34,23
1658093683505,MATH 193A,A03,083781,Rotar; Vladimir,5,0,34,29
1658093683505,MATH 193A,A04,083782,Rotar; Vladimir,12,0,34,22
1658093683505,MATH 193A,A05,093482,Rotar; Vladimir,11,0,34,23
1658093689542,MATH 197,001,091859,McAuley; Julian John,9999,0,9999,0
1658093689542,MATH 197,002,095566,Kedlaya; Kiran S.,9997,0,9999,2
1658093689542,MATH 197,003,095567,Xiao; Ming,9999,0,9999,0
1658093689542,MATH 197,004,095571,Perols; Johan Lars,9998,0,9999,1
1658093696610,COGS 9,A01,083615,Shannon; Kyle Michael,11,0,75,64
1658093702636,COGS 11,A01,083617,Boyle; Mary E. T.,23,0,48,25
1658093708660,COGS 13,A01,083071,Bastos; Amalia Pinkusfeld,12,0,71,59
1658093714686,COGS 14A,A01,092681,Semenuks; Arturs,5,1,100,95
1658093720710,COGS 14B,A01,083073,Cheng; Tzu-Han,7,0,63,56
1658093726736,COGS 17,A01,092677,Semenuks; Arturs,7,0,81,74
1658093732759,COGS 100,A01,083619,Allen; Michael Gordon,17,0,70,53
1658093738781,COGS 101A,A01,083621,Davis; Joshua Daniel,9,0,68,59
1658093744805,COGS 101B,A01,091572,Allen; Michael Gordon,14,0,65,51
1658093750832,COGS 101C,A01,083625,Delgado; Tania,17,0,35,18
1658093756855,COGS 107A,A01,083627,Boyle; Mary E. T.,14,0,60,46
1658093762878,COGS 118A,A01,083075,Gupta; Anjum,21,0,76,55
1658093768906,CSE 3,A50,083646,Miranda; Gregory Joseph,24,0,50,26
1658093774933,CSE 8A,A50,083650,Miranda; Gregory Joseph,17,1,56,39
1658093780961,CSE 11,A01,083080,Cao; Yingjun,7,15,40,33
1658093786984,CSE 12,A01,083652,Krause-Levy; Sophia Louisa,30,1,120,90
1658093793010,CSE 15L,A01,083654,Morris; Justin Loren,9,0,50,41
1658093793010,CSE 15L,A02,083655,Morris; Justin Loren,11,0,50,39
1658093799039,CSE 20,A01,083657,Tran; Khoa Dang,39,0,80,41
1658093805061,CSE 21,A01,095574,Bach; Quang Tran,23,0,48,25
1658093811087,CSE 30,A01,083084,Eldon; John,8,0,80,72
1658093811087,CSE 30,B01,095061,Bhaskar; Nishant,9,0,50,41
1658093817111,CSE 100,A01,083659,Cao; Yingjun,5,4,70,65
1658093823139,CSE 134B,A01,083661,Powell; Thomas Allan,25,0,100,75
1658093829163,CSE 140,A01,083663,Gungor; Onat,17,0,85,68
1658093835190,CSE 140L,A01,083088,Eldon; John,23,0,100,77
1658093841214,CSE 175,A01,083665,Kumar; Rakesh,3,0,25,22
1658093847240,CSE 190,A00,092507,Dubnov; Shlomo,8,0,20,12
1658093853263,ECE 45,A01,083139,Congero; Spencer William,7,0,75,68
1658093859289,ECE 65,A50,083695,Saad; Andrew S,12,0,30,18
1658093859289,ECE 65,A51,095125,Saad; Andrew S,24,0,26,2
1658093865312,ECE 109,A01,091882,Touri; Behrouz,21,0,70,49
1658093871336,ECE 180,A00,083140,Abi Samra; Nicholas Camill,1,0,30,29
1658093871336,ECE 180,B00,083141,Abi Samra; Nicholas Camill,0,0,30,30
1658093877360,MATH 10A,A01,083735,Patchell; Gregory David,2,0,30,28
1658093877360,MATH 10A,A02,083736,Patchell; Gregory David,20,0,30,10
1658093877360,MATH 10A,A03,083737,Patchell; Gregory David,16,0,30,14
1658093883386,MATH 10B,A01,083207,Lim; Seonhee,9,0,34,25
1658093883386,MATH 10B,A02,083208,Lim; Seonhee,10,0,35,25
1658093883386,MATH 10B,A03,093472,Lim; Seonhee,7,0,34,27
1658093883386,MATH 10B,B01,083739,Sinha; Shubham,14,0,30,16
1658093889424,MATH 18,A01,083743,Cinel; Cameron Alexander,9,0,30,21
1658093889424,MATH 18,A02,083744,Cinel; Cameron Alexander,18,0,30,12
1658093889424,MATH 18,A03,083745,Cinel; Cameron Alexander,10,0,30,20
1658093889424,MATH 18,B01,083748,Rideout; David Porter,5,0,37,32
1658093889424,MATH 18,B02,083749,Rideout; David Porter,5,0,36,31
1658093889424,MATH 18,B03,083750,Rideout; David Porter,3,0,37,34
1658093889424,MATH 18,B04,083751,Rideout; David Porter,7,0,36,29
1658093889424,MATH 18,B05,093473,Rideout; David Porter,7,0,36,29
1658093889424,MATH 18,B06,093474,Rideout; David Porter,6,0,36,30
1658093895447,MATH 20A,A01,083754,Zheng; Zequn,14,0,40,26
1658093901470,MATH 20B,A01,083756,Briones; Jor-el Thomas Caparas,4,0,36,32
1658093901470,MATH 20B,A02,083757,Briones; Jor-el Thomas Caparas,1,0,36,35
1658093901470,MATH 20B,A03,093475,Briones; Jor-el Thomas Caparas,3,0,36,33
1658093907495,MATH 20C,A01,083760,Briones; Jor-el Thomas Caparas,1,0,35,34
1658093907495,MATH 20C,A02,083761,Briones; Jor-el Thomas Caparas,8,0,35,27
1658093907495,MATH 20C,A03,093476,Briones; Jor-el Thomas Caparas,0,1,36,36
1658093907495,MATH 20C,B01,083762,Bach; Quang Tran,1,0,30,29
1658093913525,MATH 20D,A01,083765,Tran; Brian Kha,5,0,30,25
1658093913525,MATH 20D,A02,083766,Tran; Brian Kha,5,0,30,25
1658093913525,MATH 20D,A03,083767,Tran; Brian Kha,6,0,30,24
1658093919549,MATH 20E,A01,083771,Ganguly; Soumya,12,0,32,20
1658093919549,MATH 20E,A02,083772,Ganguly; Soumya,7,0,32,25
1658093919549,MATH 20E,B01,083773,Ciotti; Benjamin,20,0,35,15
1658093919549,MATH 20E,B02,083774,Ciotti; Benjamin,18,0,35,17
1658093925578,MATH 103A,A01,083777,Greenfeld; Be'Eri,6,0,36,30
1658093925578,MATH 103A,A02,083778,Greenfeld; Be'Eri,5,0,36,31
1658093925578,MATH 103A,A03,093561,Greenfeld; Be'Eri,7,0,36,29
1658093925578,MATH 103A,B01,083779,Greenfeld; Be'Eri,8,0,36,28
1658093925578,MATH 103A,B02,083780,Greenfeld; Be'Eri,4,0,36,32
1658093925578,MATH 103A,B03,093562,Greenfeld; Be'Eri,3,0,36,33
1658093931601,MATH 105,A01,085443,Carter; Anne Toulson,15,0,35,20
1658093931601,MATH 105,A02,093477,Carter; Anne Toulson,20,0,35,15
1658093937625,MATH 109,A01,083213,Ganzberger; Geoffrey Michael,3,0,34,31
1658093937625,MATH 109,A02,083214,Ganzberger; Geoffrey Michael,4,0,34,30
1658093937625,MATH 109,A03,093478,Ganzberger; Geoffrey Michael,2,0,34,32
1658093937625,MATH 109,B01,083215,Ganzberger; Geoffrey Michael,3,0,32,29
1658093937625,MATH 109,B02,083216,Ganzberger; Geoffrey Michael,3,0,32,29
1658093937625,MATH 109,B03,093479,Ganzberger; Geoffrey Michael,8,0,32,24
1658093943656,MATH 142A,A01,083219,Chow; Bennett,7,0,32,25
1658093943656,MATH 142A,A02,083220,Chow; Bennett,10,0,32,22
1658093943656,MATH 142A,A03,093480,Chow; Bennett,9,0,32,23
1658093943656,MATH 142A,B03,093481,Chow; Bennett,8,0,32,24
1658093943656,MATH 142A,B04,093558,Chow; Bennett,14,0,32,18
1658093943656,MATH 142A,B05,093559,Chow; Bennett,7,0,32,25
1658093949682,MATH 193A,A01,083224,Rotar; Vladimir,9,0,34,25
1658093949682,MATH 193A,A02,083225,Rotar; Vladimir,11,0,34,23
1658093949682,MATH 193A,A03,083781,Rotar; Vladimir,5,0,34,29
1658093949682,MATH 193A,A04,083782,Rotar; Vladimir,12,0,34,22
1658093949682,MATH 193A,A05,093482,Rotar; Vladimir,11,0,34,23
1658093955710,MATH 197,001,091859,McAuley; Julian John,9999,0,9999,0
1658093955710,MATH 197,002,095566,Kedlaya; Kiran S.,9997,0,9999,2
1658093955710,MATH 197,003,095567,Xiao; Ming,9999,0,9999,0
1658093955710,MATH 197,004,095571,Perols; Johan Lars,9998,0,9999,1
1658093962770,COGS 9,A01,083615,Shannon; Kyle Michael,11,0,75,64
1658093968797,COGS 11,A01,083617,Boyle; Mary E. T.,23,0,48,25
1658093974823,COGS 13,A01,083071,Bastos; Amalia Pinkusfeld,12,0,71,59
1658093980849,COGS 14A,A01,092681,Semenuks; Arturs,5,1,100,95
1658093986872,COGS 14B,A01,083073,Cheng; Tzu-Han,7,0,63,56
1658093992895,COGS 17,A01,092677,Semenuks; Arturs,7,0,81,74
1658093998920,COGS 100,A01,083619,Allen; Michael Gordon,17,0,70,53
1658094004947,COGS 101A,A01,083621,Davis; Joshua Daniel,9,0,68,59
1658094010968,COGS 101B,A01,091572,Allen; Michael Gordon,14,0,65,51
1658094016994,COGS 101C,A01,083625,Delgado; Tania,17,0,35,18
1658094023021,COGS 107A,A01,083627,Boyle; Mary E. T.,14,0,60,46
1658094029045,COGS 118A,A01,083075,Gupta; Anjum,21,0,76,55
1658094035069,CSE 3,A50,083646,Miranda; Gregory Joseph,24,0,50,26
1658094041091,CSE 8A,A50,083650,Miranda; Gregory Joseph,17,1,56,39
1658094047115,CSE 11,A01,083080,Cao; Yingjun,7,15,40,33
1658094053141,CSE 12,A01,083652,Krause-Levy; Sophia Louisa,30,1,120,90
1658094059165,CSE 15L,A01,083654,Morris; Justin Loren,9,0,50,41
1658094059165,CSE 15L,A02,083655,Morris; Justin Loren,11,0,50,39
1658094065190,CSE 20,A01,083657,Tran; Khoa Dang,39,0,80,41
1658094071220,CSE 21,A01,095574,Bach; Quang Tran,23,0,48,25
1658094077248,CSE 30,A01,083084,Eldon; John,8,0,80,72
1658094077248,CSE 30,B01,095061,Bhaskar; Nishant,9,0,50,41
1658094083271,CSE 100,A01,083659,Cao; Yingjun,5,4,70,65
1658094089294,CSE 134B,A01,083661,Powell; Thomas Allan,25,0,100,75
1658094095318,CSE 140,A01,083663,Gungor; Onat,17,0,85,68
1658094101340,CSE 140L,A01,083088,Eldon; John,23,0,100,77
1658094107365,CSE 175,A01,083665,Kumar; Rakesh,3,0,25,22
1658094113391,CSE 190,A00,092507,Dubnov; Shlomo,8,0,20,12
1658094119418,ECE 45,A01,083139,Congero; Spencer William,7,0,75,68
1658094125441,ECE 65,A50,083695,Saad; Andrew S,12,0,30,18
1658094125441,ECE 65,A51,095125,Saad; Andrew S,24,0,26,2
1658094131468,ECE 109,A01,091882,Touri; Behrouz,21,0,70,49
1658094137491,ECE 180,A00,083140,Abi Samra; Nicholas Camill,1,0,30,29
1658094137491,ECE 180,B00,083141,Abi Samra; Nicholas Camill,0,0,30,30
1658094143518,MATH 10A,A01,083735,Patchell; Gregory David,2,0,30,28
1658094143518,MATH 10A,A02,083736,Patchell; Gregory David,20,0,30,10
1658094143518,MATH 10A,A03,083737,Patchell; Gregory David,16,0,30,14
1658094149547,MATH 10B,A01,083207,Lim; Seonhee,9,0,34,25
1658094149547,MATH 10B,A02,083208,Lim; Seonhee,10,0,35,25
1658094149547,MATH 10B,A03,093472,Lim; Seonhee,7,0,34,27
1658094149547,MATH 10B,B01,083739,Sinha; Shubham,14,0,30,16
1658094155571,MATH 18,A01,083743,Cinel; Cameron Alexander,9,0,30,21
1658094155571,MATH 18,A02,083744,Cinel; Cameron Alexander,18,0,30,12
1658094155571,MATH 18,A03,083745,Cinel; Cameron Alexander,10,0,30,20
1658094155571,MATH 18,B01,083748,Rideout; David Porter,5,0,37,32
1658094155571,MATH 18,B02,083749,Rideout; David Porter,5,0,36,31
1658094155571,MATH 18,B03,083750,Rideout; David Porter,3,0,37,34
1658094155571,MATH 18,B04,083751,Rideout; David Porter,7,0,36,29
1658094155571,MATH 18,B05,093473,Rideout; David Porter,7,0,36,29
1658094155571,MATH 18,B06,093474,Rideout; David Porter,6,0,36,30
1658094161595,MATH 20A,A01,083754,Zheng; Zequn,14,0,40,26
1658094167621,MATH 20B,A01,083756,Briones; Jor-el Thomas Caparas,4,0,36,32
1658094167621,MATH 20B,A02,083757,Briones; Jor-el Thomas Caparas,1,0,36,35
1658094167621,MATH 20B,A03,093475,Briones; Jor-el Thomas Caparas,3,0,36,33
1658094173645,MATH 20C,A01,083760,Briones; Jor-el Thomas Caparas,1,0,35,34
1658094173645,MATH 20C,A02,083761,Briones; Jor-el Thomas Caparas,8,0,35,27
1658094173645,MATH 20C,A03,093476,Briones; Jor-el Thomas Caparas,0,1,36,36
1658094173645,MATH 20C,B01,083762,Bach; Quang Tran,1,0,30,29
1658094179669,MATH 20D,A01,083765,Tran; Brian Kha,5,0,30,25
1658094179669,MATH 20D,A02,083766,Tran; Brian Kha,5,0,30,25
1658094179669,MATH 20D,A03,083767,Tran; Brian Kha,6,0,30,24
1658094185697,MATH 20E,A01,083771,Ganguly; Soumya,12,0,32,20
1658094185697,MATH 20E,A02,083772,Ganguly; Soumya,7,0,32,25
1658094185697,MATH 20E,B01,083773,Ciotti; Benjamin,20,0,35,15
1658094185697,MATH 20E,B02,083774,Ciotti; Benjamin,18,0,35,17
1658094191728,MATH 103A,A01,083777,Greenfeld; Be'Eri,6,0,36,30
1658094191728,MATH 103A,A02,083778,Greenfeld; Be'Eri,5,0,36,31
1658094191728,MATH 103A,A03,093561,Greenfeld; Be'Eri,7,0,36,29
1658094191728,MATH 103A,B01,083779,Greenfeld; Be'Eri,8,0,36,28
1658094191728,MATH 103A,B02,083780,Greenfeld; Be'Eri,4,0,36,32
1658094191728,MATH 103A,B03,093562,Greenfeld; Be'Eri,3,0,36,33
1658094197755,MATH 105,A01,085443,Carter; Anne Toulson,15,0,35,20
1658094197755,MATH 105,A02,093477,Carter; Anne Toulson,20,0,35,15
1658094203784,MATH 109,A01,083213,Ganzberger; Geoffrey Michael,3,0,34,31
1658094203784,MATH 109,A02,083214,Ganzberger; Geoffrey Michael,4,0,34,30
1658094203784,MATH 109,A03,093478,Ganzberger; Geoffrey Michael,2,0,34,32
1658094203784,MATH 109,B01,083215,Ganzberger; Geoffrey Michael,3,0,32,29
1658094203784,MATH 109,B02,083216,Ganzberger; Geoffrey Michael,3,0,32,29
1658094203784,MATH 109,B03,093479,Ganzberger; Geoffrey Michael,8,0,32,24
1658094209814,MATH 142A,A01,083219,Chow; Bennett,7,0,32,25
1658094209814,MATH 142A,A02,083220,Chow; Bennett,10,0,32,22
1658094209814,MATH 142A,A03,093480,Chow; Bennett,9,0,32,23
1658094209814,MATH 142A,B03,093481,Chow; Bennett,8,0,32,24
1658094209814,MATH 142A,B04,093558,Chow; Bennett,14,0,32,18
1658094209814,MATH 142A,B05,093559,Chow; Bennett,7,0,32,25
1658094215837,MATH 193A,A01,083224,Rotar; Vladimir,9,0,34,25
1658094215837,MATH 193A,A02,083225,Rotar; Vladimir,11,0,34,23
1658094215837,MATH 193A,A03,083781,Rotar; Vladimir,5,0,34,29
1658094215837,MATH 193A,A04,083782,Rotar; Vladimir,12,0,34,22
1658094215837,MATH 193A,A05,093482,Rotar; Vladimir,11,0,34,23
1658094221869,MATH 197,001,091859,McAuley; Julian John,9999,0,9999,0
1658094221869,MATH 197,002,095566,Kedlaya; Kiran S.,9997,0,9999,2
1658094221869,MATH 197,003,095567,Xiao; Ming,9999,0,9999,0
1658094221869,MATH 197,004,095571,Perols; Johan Lars,9998,0,9999,1
1658094228942,COGS 9,A01,083615,Shannon; Kyle Michael,11,0,75,64
1658094234965,COGS 11,A01,083617,Boyle; Mary E. T.,23,0,48,25
1658094240996,COGS 13,A01,083071,Bastos; Amalia Pinkusfeld,12,0,71,59
1658094247093,COGS 14A,A01,092681,Semenuks; Arturs,5,1,100,95
1658094253116,COGS 14B,A01,083073,Cheng; Tzu-Han,7,0,63,56
1658094259143,COGS 17,A01,092677,Semenuks; Arturs,7,0,81,74
1658094265166,COGS 100,A01,083619,Allen; Michael Gordon,17,0,70,53
1658094271194,COGS 101A,A01,083621,Davis; Joshua Daniel,9,0,68,59
1658094277220,COGS 101B,A01,091572,Allen; Michael Gordon,14,0,65,51
1658094283244,COGS 101C,A01,083625,Delgado; Tania,17,0,35,18
1658094289267,COGS 107A,A01,083627,Boyle; Mary E. T.,14,0,60,46
1658094295291,COGS 118A,A01,083075,Gupta; Anjum,21,0,76,55
1658094301316,CSE 3,A50,083646,Miranda; Gregory Joseph,24,0,50,26
1658094307338,CSE 8A,A50,083650,Miranda; Gregory Joseph,17,1,56,39
1658094313364,CSE 11,A01,083080,Cao; Yingjun,7,15,40,33
1658094319390,CSE 12,A01,083652,Krause-Levy; Sophia Louisa,30,1,120,90
1658094325414,CSE 15L,A01,083654,Morris; Justin Loren,9,0,50,41
1658094325414,CSE 15L,A02,083655,Morris; Justin Loren,11,0,50,39
1658094331436,CSE 20,A01,083657,Tran; Khoa Dang,39,0,80,41
1658094337460,CSE 21,A01,095574,Bach; Quang Tran,23,0,48,25
1658094343483,CSE 30,A01,083084,Eldon; John,8,0,80,72
1658094343483,CSE 30,B01,095061,Bhaskar; Nishant,9,0,50,41
1658094349515,CSE 100,A01,083659,Cao; Yingjun,5,4,70,65
1658094355541,CSE 134B,A01,083661,Powell; Thomas Allan,25,0,100,75
1658094361563,CSE 140,A01,083663,Gungor; Onat,17,0,85,68
1658094367588,CSE 140L,A01,083088,Eldon; John,23,0,100,77
1658094373612,CSE 175,A01,083665,Kumar; Rakesh,3,0,25,22
1658094379638,CSE 190,A00,092507,Dubnov; Shlomo,8,0,20,12
1658094385674,ECE 45,A01,083139,Congero; Spencer William,7,0,75,68
1658094391706,ECE 65,A50,083695,Saad; Andrew S,12,0,30,18
1658094391706,ECE 65,A51,095125,Saad; Andrew S,24,0,26,2
1658094397735,ECE 109,A01,091882,Touri; Behrouz,21,0,70,49
1658094403758,ECE 180,A00,083140,Abi Samra; Nicholas Camill,1,0,30,29
1658094403758,ECE 180,B00,083141,Abi Samra; Nicholas Camill,0,0,30,30
1658094409781,MATH 10A,A01,083735,Patchell; Gregory David,2,0,30,28
1658094409781,MATH 10A,A02,083736,Patchell; Gregory David,20,0,30,10
1658094409781,MATH 10A,A03,083737,Patchell; Gregory David,16,0,30,14
1658094415809,MATH 10B,A01,083207,Lim; Seonhee,9,0,34,25
1658094415809,MATH 10B,A02,083208,Lim; Seonhee,10,0,35,25
1658094415809,MATH 10B,A03,093472,Lim; Seonhee,7,0,34,27
1658094415809,MATH 10B,B01,083739,Sinha; Shubham,14,0,30,16
1658094421833,MATH 18,A01,083743,Cinel; Cameron Alexander,9,0,30,21
1658094421833,MATH 18,A02,083744,Cinel; Cameron Alexander,18,0,30,12
1658094421833,MATH 18,A03,083745,Cinel; Cameron Alexander,10,0,30,20
1658094421833,MATH 18,B01,083748,Rideout; David Porter,5,0,37,32
1658094421833,MATH 18,B02,083749,Rideout; David Porter,5,0,36,31
1658094421833,MATH 18,B03,083750,Rideout; David Porter,3,0,37,34
1658094421833,MATH 18,B04,083751,Rideout; David Porter,7,0,36,29
1658094421833,MATH 18,B05,093473,Rideout; David Porter,7,0,36,29
1658094421833,MATH 18,B06,093474,Rideout; David Porter,6,0,36,30
1658094427855,MATH 20A,A01,083754,Zheng; Zequn,14,0,40,26
1658094433881,MATH 20B,A01,083756,Briones; Jor-el Thomas Caparas,4,0,36,32
1658094433881,MATH 20B,A02,083757,Briones; Jor-el Thomas Caparas,1,0,36,35
1658094433881,MATH 20B,A03,093475,Briones; Jor-el Thomas Caparas,3,0,36,33
1658094439910,MATH 20C,A01,083760,Briones; Jor-el Thomas Caparas,1,0,35,34
1658094439910,MATH 20C,A02,083761,Briones; Jor-el Thomas Caparas,8,0,35,27
1658094439910,MATH 20C,A03,093476,Briones; Jor-el Thomas Caparas,0,1,36,36
1658094439910,MATH 20C,B01,083762,Bach; Quang Tran,1,0,30,29
1658094445934,MATH 20D,A01,083765,Tran; Brian Kha,5,0,30,25
1658094445934,MATH 20D,A02,083766,Tran; Brian Kha,5,0,30,25
1658094445934,MATH 20D,A03,083767,Tran; Brian Kha,6,0,30,24
1658094451962,MATH 20E,A01,083771,Ganguly; Soumya,12,0,32,20
1658094451962,MATH 20E,A02,083772,Ganguly; Soumya,7,0,32,25
1658094451962,MATH 20E,B01,083773,Ciotti; Benjamin,20,0,35,15
1658094451962,MATH 20E,B02,083774,Ciotti; Benjamin,18,0,35,17
1658094457986,MATH 103A,A01,083777,Greenfeld; Be'Eri,6,0,36,30
1658094457986,MATH 103A,A02,083778,Greenfeld; Be'Eri,5,0,36,31
1658094457986,MATH 103A,A03,093561,Greenfeld; Be'Eri,7,0,36,29
1658094457986,MATH 103A,B01,083779,Greenfeld; Be'Eri,8,0,36,28
1658094457986,MATH 103A,B02,083780,Greenfeld; Be'Eri,4,0,36,32
1658094457986,MATH 103A,B03,093562,Greenfeld; Be'Eri,3,0,36,33
1658094464008,MATH 105,A01,085443,Carter; Anne Toulson,15,0,35,20
1658094464008,MATH 105,A02,093477,Carter; Anne Toulson,20,0,35,15
1658094470032,MATH 109,A01,083213,Ganzberger; Geoffrey Michael,3,0,34,31
1658094470032,MATH 109,A02,083214,Ganzberger; Geoffrey Michael,4,0,34,30
1658094470032,MATH 109,A03,093478,Ganzberger; Geoffrey Michael,2,0,34,32
1658094470032,MATH 109,B01,083215,Ganzberger; Geoffrey Michael,3,0,32,29
1658094470032,MATH 109,B02,083216,Ganzberger; Geoffrey Michael,3,0,32,29
1658094470032,MATH 109,B03,093479,Ganzberger; Geoffrey Michael,8,0,32,24
1658094476054,MATH 142A,A01,083219,Chow; Bennett,7,0,32,25
1658094476054,MATH 142A,A02,083220,Chow; Bennett,10,0,32,22
1658094476054,MATH 142A,A03,093480,Chow; Bennett,9,0,32,23
1658094476054,MATH 142A,B03,093481,Chow; Bennett,8,0,32,24
1658094476054,MATH 142A,B04,093558,Chow; Bennett,14,0,32,18
1658094476054,MATH 142A,B05,093559,Chow; Bennett,7,0,32,25
1658094482081,MATH 193A,A01,083224,Rotar; Vladimir,9,0,34,25
1658094482081,MATH 193A,A02,083225,Rotar; Vladimir,11,0,34,23
1658094482081,MATH 193A,A03,083781,Rotar; Vladimir,5,0,34,29
1658094482081,MATH 193A,A04,083782,Rotar; Vladimir,12,0,34,22
1658094482081,MATH 193A,A05,093482,Rotar; Vladimir,11,0,34,23
1658094488103,MATH 197,001,091859,McAuley; Julian John,9999,0,9999,0
1658094488103,MATH 197,002,095566,Kedlaya; Kiran S.,9997,0,9999,2
1658094488103,MATH 197,003,095567,Xiao; Ming,9999,0,9999,0
1658094488103,MATH 197,004,095571,Perols; Johan Lars,9998,0,9999,1
1658094495173,COGS 9,A01,083615,Shannon; Kyle Michael,11,0,75,64
1658094501198,COGS 11,A01,083617,Boyle; Mary E. T.,23,0,48,25
1658094507220,COGS 13,A01,083071,Bastos; Amalia Pinkusfeld,12,0,71,59
1658094513247,COGS 14A,A01,092681,Semenuks; Arturs,5,1,100,95
1658094519270,COGS 14B,A01,083073,Cheng; Tzu-Han,7,0,63,56
1658094525292,COGS 17,A01,092677,Semenuks; Arturs,7,0,81,74
1658094531320,COGS 100,A01,083619,Allen; Michael Gordon,17,0,70,53
1658094537344,COGS 101A,A01,083621,Davis; Joshua Daniel,9,0,68,59
1658094543367,COGS 101B,A01,091572,Allen; Michael Gordon,14,0,65,51
1658094549397,COGS 101C,A01,083625,Delgado; Tania,17,0,35,18
1658094555422,COGS 107A,A01,083627,Boyle; Mary E. T.,14,0,60,46
1658094561446,COGS 118A,A01,083075,Gupta; Anjum,21,0,76,55
1658094567469,CSE 3,A50,083646,Miranda; Gregory Joseph,24,0,50,26
1658094573495,CSE 8A,A50,083650,Miranda; Gregory Joseph,17,1,56,39
1658094579534,CSE 11,A01,083080,Cao; Yingjun,7,15,40,33
1658094585557,CSE 12,A01,083652,Krause-Levy; Sophia Louisa,30,1,120,90
1658094591581,CSE 15L,A01,083654,Morris; Justin Loren,9,0,50,41
1658094591581,CSE 15L,A02,083655,Morris; Justin Loren,11,0,50,39
1658094597604,CSE 20,A01,083657,Tran; Khoa Dang,39,0,80,41
1658094603629,CSE 21,A01,095574,Bach; Quang Tran,23,0,48,25
1658094609654,CSE 30,A01,083084,Eldon; John,8,0,80,72
1658094609654,CSE 30,B01,095061,Bhaskar; Nishant,9,0,50,41
1658094615681,CSE 100,A01,083659,Cao; Yingjun,5,4,70,65
1658094621705,CSE 134B,A01,083661,Powell; Thomas Allan,25,0,100,75
1658094627736,CSE 140,A01,083663,Gungor; Onat,17,0,85,68
1658094633763,CSE 140L,A01,083088,Eldon; John,23,0,100,77
1658094639791,CSE 175,A01,083665,Kumar; Rakesh,3,0,25,22
1658094645814,CSE 190,A00,092507,Dubnov; Shlomo,8,0,20,12
1658094651838,ECE 45,A01,083139,Congero; Spencer William,7,0,75,68
1658094657863,ECE 65,A50,083695,Saad; Andrew S,12,0,30,18
1658094657863,ECE 65,A51,095125,Saad; Andrew S,24,0,26,2
1658094663886,ECE 109,A01,091882,Touri; Behrouz,21,0,70,49
1658094669933,ECE 180,A00,083140,Abi Samra; Nicholas Camill,1,0,30,29
1658094669933,ECE 180,B00,083141,Abi Samra; Nicholas Camill,0,0,30,30
1658094675960,MATH 10A,A01,083735,Patchell; Gregory David,2,0,30,28
1658094675960,MATH 10A,A02,083736,Patchell; Gregory David,20,0,30,10
1658094675960,MATH 10A,A03,083737,Patchell; Gregory David,16,0,30,14
1658094681984,MATH 10B,A01,083207,Lim; Seonhee,9,0,34,25
1658094681984,MATH 10B,A02,083208,Lim; Seonhee,10,0,35,25
1658094681984,MATH 10B,A03,093472,Lim; Seonhee,7,0,34,27
1658094681984,MATH 10B,B01,083739,Sinha; Shubham,14,0,30,16
1658094688016,MATH 18,A01,083743,Cinel; Cameron Alexander,9,0,30,21
1658094688016,MATH 18,A02,083744,Cinel; Cameron Alexander,18,0,30,12
1658094688016,MATH 18,A03,083745,Cinel; Cameron Alexander,10,0,30,20
1658094688016,MATH 18,B01,083748,Rideout; David Porter,5,0,37,32
1658094688016,MATH 18,B02,083749,Rideout; David Porter,5,0,36,31
1658094688016,MATH 18,B03,083750,Rideout; David Porter,3,0,37,34
1658094688016,MATH 18,B04,083751,Rideout; David Porter,7,0,36,29
1658094688016,MATH 18,B05,093473,Rideout; David Porter,7,0,36,29
1658094688016,MATH 18,B06,093474,Rideout; David Porter,6,0,36,30
1658094694039,MATH 20A,A01,083754,Zheng; Zequn,14,0,40,26
1658094700063,MATH 20B,A01,083756,Briones; Jor-el Thomas Caparas,4,0,36,32
1658094700063,MATH 20B,A02,083757,Briones; Jor-el Thomas Caparas,1,0,36,35
1658094700063,MATH 20B,A03,093475,Briones; Jor-el Thomas Caparas,3,0,36,33
1658094706091,MATH 20C,A01,083760,Briones; Jor-el Thomas Caparas,1,0,35,34
1658094706091,MATH 20C,A02,083761,Briones; Jor-el Thomas Caparas,8,0,35,27
1658094706091,MATH 20C,A03,093476,Briones; Jor-el Thomas Caparas,0,1,36,36
1658094706091,MATH 20C,B01,083762,Bach; Quang Tran,1,0,30,29
1658094712115,MATH 20D,A01,083765,Tran; Brian Kha,5,0,30,25
1658094712115,MATH 20D,A02,083766,Tran; Brian Kha,5,0,30,25
1658094712115,MATH 20D,A03,083767,Tran; Brian Kha,6,0,30,24
1658094718139,MATH 20E,A01,083771,Ganguly; Soumya,12,0,32,20
1658094718139,MATH 20E,A02,083772,Ganguly; Soumya,7,0,32,25
1658094718139,MATH 20E,B01,083773,Ciotti; Benjamin,20,0,35,15
1658094718139,MATH 20E,B02,083774,Ciotti; Benjamin,18,0,35,17
1658094724164,MATH 103A,A01,083777,Greenfeld; Be'Eri,6,0,36,30
1658094724164,MATH 103A,A02,083778,Greenfeld; Be'Eri,5,0,36,31
1658094724164,MATH 103A,A03,093561,Greenfeld; Be'Eri,7,0,36,29
1658094724164,MATH 103A,B01,083779,Greenfeld; Be'Eri,8,0,36,28
1658094724164,MATH 103A,B02,083780,Greenfeld; Be'Eri,4,0,36,32
1658094724164,MATH 103A,B03,093562,Greenfeld; Be'Eri,3,0,36,33
1658094730187,MATH 105,A01,085443,Carter; Anne Toulson,15,0,35,20
1658094730187,MATH 105,A02,093477,Carter; Anne Toulson,20,0,35,15
1658094736215,MATH 109,A01,083213,Ganzberger; Geoffrey Michael,3,0,34,31
1658094736215,MATH 109,A02,083214,Ganzberger; Geoffrey Michael,4,0,34,30
1658094736215,MATH 109,A03,093478,Ganzberger; Geoffrey Michael,2,0,34,32
1658094736215,MATH 109,B01,083215,Ganzberger; Geoffrey Michael,3,0,32,29
1658094736215,MATH 109,B02,083216,Ganzberger; Geoffrey Michael,3,0,32,29
1658094736215,MATH 109,B03,093479,Ganzberger; Geoffrey Michael,8,0,32,24
1658094742240,MATH 142A,A01,083219,Chow; Bennett,7,0,32,25
1658094742240,MATH 142A,A02,083220,Chow; Bennett,10,0,32,22
1658094742240,MATH 142A,A03,093480,Chow; Bennett,9,0,32,23
1658094742240,MATH 142A,B03,093481,Chow; Bennett,8,0,32,24
1658094742240,MATH 142A,B04,093558,Chow; Bennett,14,0,32,18
1658094742240,MATH 142A,B05,093559,Chow; Bennett,7,0,32,25
1658094748264,MATH 193A,A01,083224,Rotar; Vladimir,9,0,34,25
1658094748264,MATH 193A,A02,083225,Rotar; Vladimir,11,0,34,23
1658094748264,MATH 193A,A03,083781,Rotar; Vladimir,5,0,34,29
1658094748264,MATH 193A,A04,083782,Rotar; Vladimir,12,0,34,22
1658094748264,MATH 193A,A05,093482,Rotar; Vladimir,11,0,34,23
1658094754292,MATH 197,001,091859,McAuley; Julian John,9999,0,9999,0
1658094754292,MATH 197,002,095566,Kedlaya; Kiran S.,9997,0,9999,2
1658094754292,MATH 197,003,095567,Xiao; Ming,9999,0,9999,0
1658094754292,MATH 197,004,095571,Perols; Johan Lars,9998,0,9999,1
1658094761359,COGS 9,A01,083615,Shannon; Kyle Michael,11,0,75,64
1658094767382,COGS 11,A01,083617,Boyle; Mary E. T.,23,0,48,25
1658094773407,COGS 13,A01,083071,Bastos; Amalia Pinkusfeld,12,0,71,59
1658094779430,COGS 14A,A01,092681,Semenuks; Arturs,5,1,100,95
1658094785456,COGS 14B,A01,083073,Cheng; Tzu-Han,7,0,63,56
1658094791479,COGS 17,A01,092677,Semenuks; Arturs,7,0,81,74
1658094797502,COGS 100,A01,083619,Allen; Michael Gordon,17,0,70,53
1658094803526,COGS 101A,A01,083621,Davis; Joshua Daniel,9,0,68,59
1658094809553,COGS 101B,A01,091572,Allen; Michael Gordon,14,0,65,51
1658094815578,COGS 101C,A01,083625,Delgado; Tania,17,0,35,18
1658094821601,COGS 107A,A01,083627,Boyle; Mary E. T.,14,0,60,46
1658094827624,COGS 118A,A01,083075,Gupta; Anjum,21,0,76,55
1658094833648,CSE 3,A50,083646,Miranda; Gregory Joseph,24,0,50,26
1658094839675,CSE 8A,A50,083650,Miranda; Gregory Joseph,17,1,56,39
1658094845792,CSE 11,A01,083080,Cao; Yingjun,7,15,40,33
1658094851818,CSE 12,A01,083652,Krause-Levy; Sophia Louisa,30,1,120,90
1658094857842,CSE 15L,A01,083654,Morris; Justin Loren,9,0,50,41
1658094857842,CSE 15L,A02,083655,Morris; Justin Loren,11,0,50,39
1658094863924,CSE 20,A01,083657,Tran; Khoa Dang,39,0,80,41
1658094869955,CSE 21,A01,095574,Bach; Quang Tran,23,0,48,25
1658094875978,CSE 30,A01,083084,Eldon; John,8,0,80,72
1658094875978,CSE 30,B01,095061,Bhaskar; Nishant,9,0,50,41
1658094882012,CSE 100,A01,083659,Cao; Yingjun,5,4,70,65
1658094888036,CSE 134B,A01,083661,Powell; Thomas Allan,25,0,100,75
1658094894060,CSE 140,A01,083663,Gungor; Onat,17,0,85,68
1658094900083,CSE 140L,A01,083088,Eldon; John,23,0,100,77
1658094906107,CSE 175,A01,083665,Kumar; Rakesh,3,0,25,22
1658094912131,CSE 190,A00,092507,Dubnov; Shlomo,8,0,20,12
1658094918155,ECE 45,A01,083139,Congero; Spencer William,7,0,75,68
1658094924188,ECE 65,A50,083695,Saad; Andrew S,12,0,30,18
1658094924188,ECE 65,A51,095125,Saad; Andrew S,24,0,26,2
1658094930215,ECE 109,A01,091882,Touri; Behrouz,21,0,70,49
1658094936246,ECE 180,A00,083140,Abi Samra; Nicholas Camill,1,0,30,29
1658094936246,ECE 180,B00,083141,Abi Samra; Nicholas Camill,0,0,30,30
1658094942275,MATH 10A,A01,083735,Patchell; Gregory David,2,0,30,28
1658094942275,MATH 10A,A02,083736,Patchell; Gregory David,20,0,30,10
1658094942275,MATH 10A,A03,083737,Patchell; Gregory David,16,0,30,14
1658094948300,MATH 10B,A01,083207,Lim; Seonhee,9,0,34,25
1658094948300,MATH 10B,A02,083208,Lim; Seonhee,10,0,35,25
1658094948300,MATH 10B,A03,093472,Lim; Seonhee,7,0,34,27
1658094948300,MATH 10B,B01,083739,Sinha; Shubham,14,0,30,16
1658094954333,MATH 18,A01,083743,Cinel; Cameron Alexander,9,0,30,21
1658094954333,MATH 18,A02,083744,Cinel; Cameron Alexander,18,0,30,12
1658094954333,MATH 18,A03,083745,Cinel; Cameron Alexander,10,0,30,20
1658094954333,MATH 18,B01,083748,Rideout; David Porter,5,0,37,32
1658094954333,MATH 18,B02,083749,Rideout; David Porter,5,0,36,31
1658094954333,MATH 18,B03,083750,Rideout; David Porter,3,0,37,34
1658094954333,MATH 18,B04,083751,Rideout; David Porter,7,0,36,29
1658094954333,MATH 18,B05,093473,Rideout; David Porter,7,0,36,29
1658094954333,MATH 18,B06,093474,Rideout; David Porter,6,0,36,30
1658094960361,MATH 20A,A01,083754,Zheng; Zequn,14,0,40,26
1658094966385,MATH 20B,A01,083756,Briones; Jor-el Thomas Caparas,4,0,36,32
1658094966385,MATH 20B,A02,083757,Briones; Jor-el Thomas Caparas,1,0,36,35
1658094966385,MATH 20B,A03,093475,Briones; Jor-el Thomas Caparas,3,0,36,33
1658094972409,MATH 20C,A01,083760,Briones; Jor-el Thomas Caparas,1,0,35,34
1658094972409,MATH 20C,A02,083761,Briones; Jor-el Thomas Caparas,8,0,35,27
1658094972409,MATH 20C,A03,093476,Briones; Jor-el Thomas Caparas,0,1,36,36
1658094972409,MATH 20C,B01,083762,Bach; Quang Tran,1,0,30,29
1658094978433,MATH 20D,A01,083765,Tran; Brian Kha,5,0,30,25
1658094978433,MATH 20D,A02,083766,Tran; Brian Kha,5,0,30,25
1658094978433,MATH 20D,A03,083767,Tran; Brian Kha,6,0,30,24
1658094984463,MATH 20E,A01,083771,Ganguly; Soumya,12,0,32,20
1658094984463,MATH 20E,A02,083772,Ganguly; Soumya,7,0,32,25
1658094984463,MATH 20E,B01,083773,Ciotti; Benjamin,20,0,35,15
1658094984463,MATH 20E,B02,083774,Ciotti; Benjamin,18,0,35,17
1658094990494,MATH 103A,A01,083777,Greenfeld; Be'Eri,6,0,36,30
1658094990494,MATH 103A,A02,083778,Greenfeld; Be'Eri,5,0,36,31
1658094990494,MATH 103A,A03,093561,Greenfeld; Be'Eri,7,0,36,29
1658094990494,MATH 103A,B01,083779,Greenfeld; Be'Eri,8,0,36,28
1658094990494,MATH 103A,B02,083780,Greenfeld; Be'Eri,4,0,36,32
1658094990494,MATH 103A,B03,093562,Greenfeld; Be'Eri,3,0,36,33
1658094996518,MATH 105,A01,085443,Carter; Anne Toulson,15,0,35,20
1658094996518,MATH 105,A02,093477,Carter; Anne Toulson,20,0,35,15
1658095002542,MATH 109,A01,083213,Ganzberger; Geoffrey Michael,3,0,34,31
1658095002542,MATH 109,A02,083214,Ganzberger; Geoffrey Michael,4,0,34,30
1658095002542,MATH 109,A03,093478,Ganzberger; Geoffrey Michael,2,0,34,32
1658095002542,MATH 109,B01,083215,Ganzberger; Geoffrey Michael,3,0,32,29
1658095002542,MATH 109,B02,083216,Ganzberger; Geoffrey Michael,3,0,32,29
1658095002542,MATH 109,B03,093479,Ganzberger; Geoffrey Michael,8,0,32,24
1658095008571,MATH 142A,A01,083219,Chow; Bennett,7,0,32,25
1658095008571,MATH 142A,A02,083220,Chow; Bennett,10,0,32,22
1658095008571,MATH 142A,A03,093480,Chow; Bennett,9,0,32,23
1658095008571,MATH 142A,B03,093481,Chow; Bennett,8,0,32,24
1658095008571,MATH 142A,B04,093558,Chow; Bennett,14,0,32,18
1658095008571,MATH 142A,B05,093559,Chow; Bennett,7,0,32,25
1658095014604,MATH 193A,A01,083224,Rotar; Vladimir,9,0,34,25
1658095014604,MATH 193A,A02,083225,Rotar; Vladimir,11,0,34,23
1658095014604,MATH 193A,A03,083781,Rotar; Vladimir,5,0,34,29
1658095014604,MATH 193A,A04,083782,Rotar; Vladimir,12,0,34,22
1658095014604,MATH 193A,A05,093482,Rotar; Vladimir,11,0,34,23
1658095020627,MATH 197,001,091859,McAuley; Julian John,9999,0,9999,0
1658095020627,MATH 197,002,095566,Kedlaya; Kiran S.,9997,0,9999,2
1658095020627,MATH 197,003,095567,Xiao; Ming,9999,0,9999,0
1658095020627,MATH 197,004,095571,Perols; Johan Lars,9998,0,9999,1
1658095027688,COGS 9,A01,083615,Shannon; Kyle Michael,11,0,75,64
1658095033713,COGS 11,A01,083617,Boyle; Mary E. T.,23,0,48,25
1658095039741,COGS 13,A01,083071,Bastos; Amalia Pinkusfeld,12,0,71,59
1658095045765,COGS 14A,A01,092681,Semenuks; Arturs,5,1,100,95
1658095051798,COGS 14B,A01,083073,Cheng; Tzu-Han,7,0,63,56
1658095057820,COGS 17,A01,092677,Semenuks; Arturs,7,0,81,74
1658095063842,COGS 100,A01,083619,Allen; Michael Gordon,17,0,70,53
1658095069868,COGS 101A,A01,083621,Davis; Joshua Daniel,9,0,68,59
1658095075891,COGS 101B,A01,091572,Allen; Michael Gordon,14,0,65,51
1658095081913,COGS 101C,A01,083625,Delgado; Tania,17,0,35,18
1658095087937,COGS 107A,A01,083627,Boyle; Mary E. T.,14,0,60,46
1658095093963,COGS 118A,A01,083075,Gupta; Anjum,21,0,76,55
1658095099990,CSE 3,A50,083646,Miranda; Gregory Joseph,24,0,50,26
1658095106018,CSE 8A,A50,083650,Miranda; Gregory Joseph,17,1,56,39
1658095112043,CSE 11,A01,083080,Cao; Yingjun,7,15,40,33
1658095118065,CSE 12,A01,083652,Krause-Levy; Sophia Louisa,30,1,120,90
1658095124088,CSE 15L,A01,083654,Morris; Justin Loren,9,0,50,41
1658095124088,CSE 15L,A02,083655,Morris; Justin Loren,11,0,50,39
1658095130115,CSE 20,A01,083657,Tran; Khoa Dang,39,0,80,41
1658095136138,CSE 21,A01,095574,Bach; Quang Tran,23,0,48,25
1658095142165,CSE 30,A01,083084,Eldon; John,8,0,80,72
1658095142165,CSE 30,B01,095061,Bhaskar; Nishant,9,0,50,41
1658095148192,CSE 100,A01,083659,Cao; Yingjun,5,4,70,65
1658095154223,CSE 134B,A01,083661,Powell; Thomas Allan,25,0,100,75
1658095160251,CSE 140,A01,083663,Gungor; Onat,17,0,85,68
1658095166278,CSE 140L,A01,083088,Eldon; John,23,0,100,77
1658095172302,CSE 175,A01,083665,Kumar; Rakesh,3,0,25,22
1658095178325,CSE 190,A00,092507,Dubnov; Shlomo,8,0,20,12
1658095184351,ECE 45,A01,083139,Congero; Spencer William,7,0,75,68
1658095190374,ECE 65,A50,083695,Saad; Andrew S,12,0,30,18
1658095190374,ECE 65,A51,095125,Saad; Andrew S,24,0,26,2
1658095196401,ECE 109,A01,091882,Touri; Behrouz,21,0,70,49
1658095202428,ECE 180,A00,083140,Abi Samra; Nicholas Camill,1,0,30,29
1658095202428,ECE 180,B00,083141,Abi Samra; Nicholas Camill,0,0,30,30
1658095208455,MATH 10A,A01,083735,Patchell; Gregory David,2,0,30,28
1658095208455,MATH 10A,A02,083736,Patchell; Gregory David,20,0,30,10
1658095208455,MATH 10A,A03,083737,Patchell; Gregory David,16,0,30,14
1658095214479,MATH 10B,A01,083207,Lim; Seonhee,9,0,34,25
1658095214479,MATH 10B,A02,083208,Lim; Seonhee,10,0,35,25
1658095214479,MATH 10B,A03,093472,Lim; Seonhee,7,0,34,27
1658095214479,MATH 10B,B01,083739,Sinha; Shubham,14,0,30,16
1658095220503,MATH 18,A01,083743,Cinel; Cameron Alexander,9,0,30,21
1658095220503,MATH 18,A02,083744,Cinel; Cameron Alexander,18,0,30,12
1658095220503,MATH 18,A03,083745,Cinel; Cameron Alexander,10,0,30,20
1658095220503,MATH 18,B01,083748,Rideout; David Porter,5,0,37,32
1658095220503,MATH 18,B02,083749,Rideout; David Porter,5,0,36,31
1658095220503,MATH 18,B03,083750,Rideout; David Porter,3,0,37,34
1658095220503,MATH 18,B04,083751,Rideout; David Porter,7,0,36,29
1658095220503,MATH 18,B05,093473,Rideout; David Porter,7,0,36,29
1658095220503,MATH 18,B06,093474,Rideout; David Porter,6,0,36,30
1658095226542,MATH 20A,A01,083754,Zheng; Zequn,14,0,40,26
1658095232566,MATH 20B,A01,083756,Briones; Jor-el Thomas Caparas,4,0,36,32
1658095232566,MATH 20B,A02,083757,Briones; Jor-el Thomas Caparas,1,0,36,35
1658095232566,MATH 20B,A03,093475,Briones; Jor-el Thomas Caparas,3,0,36,33
1658095238592,MATH 20C,A01,083760,Briones; Jor-el Thomas Caparas,1,0,35,34
1658095238592,MATH 20C,A02,083761,Briones; Jor-el Thomas Caparas,8,0,35,27
1658095238592,MATH 20C,A03,093476,Briones; Jor-el Thomas Caparas,0,1,36,36
1658095238592,MATH 20C,B01,083762,Bach; Quang Tran,1,0,30,29
1658095244613,MATH 20D,A01,083765,Tran; Brian Kha,5,0,30,25
1658095244613,MATH 20D,A02,083766,Tran; Brian Kha,5,0,30,25
1658095244613,MATH 20D,A03,083767,Tran; Brian Kha,6,0,30,24
1658095250637,MATH 20E,A01,083771,Ganguly; Soumya,12,0,32,20
1658095250637,MATH 20E,A02,083772,Ganguly; Soumya,7,0,32,25
1658095250637,MATH 20E,B01,083773,Ciotti; Benjamin,20,0,35,15
1658095250637,MATH 20E,B02,083774,Ciotti; Benjamin,18,0,35,17
1658095256659,MATH 103A,A01,083777,Greenfeld; Be'Eri,6,0,36,30
1658095256659,MATH 103A,A02,083778,Greenfeld; Be'Eri,5,0,36,31
1658095256659,MATH 103A,A03,093561,Greenfeld; Be'Eri,7,0,36,29
1658095256659,MATH 103A,B01,083779,Greenfeld; Be'Eri,8,0,36,28
1658095256659,MATH 103A,B02,083780,Greenfeld; Be'Eri,4,0,36,32
1658095256659,MATH 103A,B03,093562,Greenfeld; Be'Eri,3,0,36,33
1658095262691,MATH 105,A01,085443,Carter; Anne Toulson,15,0,35,20
1658095262691,MATH 105,A02,093477,Carter; Anne Toulson,20,0,35,15
1658095268714,MATH 109,A01,083213,Ganzberger; Geoffrey Michael,3,0,34,31
1658095268714,MATH 109,A02,083214,Ganzberger; Geoffrey Michael,4,0,34,30
1658095268714,MATH 109,A03,093478,Ganzberger; Geoffrey Michael,2,0,34,32
1658095268714,MATH 109,B01,083215,Ganzberger; Geoffrey Michael,3,0,32,29
1658095268714,MATH 109,B02,083216,Ganzberger; Geoffrey Michael,3,0,32,29
1658095268714,MATH 109,B03,093479,Ganzberger; Geoffrey Michael,8,0,32,24
1658095274737,MATH 142A,A01,083219,Chow; Bennett,7,0,32,25
1658095274737,MATH 142A,A02,083220,Chow; Bennett,10,0,32,22
1658095274737,MATH 142A,A03,093480,Chow; Bennett,9,0,32,23
1658095274737,MATH 142A,B03,093481,Chow; Bennett,8,0,32,24
1658095274737,MATH 142A,B04,093558,Chow; Bennett,14,0,32,18
1658095274737,MATH 142A,B05,093559,Chow; Bennett,7,0,32,25
1658095280760,MATH 193A,A01,083224,Rotar; Vladimir,9,0,34,25
1658095280760,MATH 193A,A02,083225,Rotar; Vladimir,11,0,34,23
1658095280760,MATH 193A,A03,083781,Rotar; Vladimir,5,0,34,29
1658095280760,MATH 193A,A04,083782,Rotar; Vladimir,12,0,34,22
1658095280760,MATH 193A,A05,093482,Rotar; Vladimir,11,0,34,23
1658095286782,MATH 197,001,091859,McAuley; Julian John,9999,0,9999,0
1658095286782,MATH 197,002,095566,Kedlaya; Kiran S.,9997,0,9999,2
1658095286782,MATH 197,003,095567,Xiao; Ming,9999,0,9999,0
1658095286782,MATH 197,004,095571,Perols; Johan Lars,9998,0,9999,1
1658095293832,COGS 9,A01,083615,Shannon; Kyle Michael,11,0,75,64
1658095299853,COGS 11,A01,083617,Boyle; Mary E. T.,23,0,48,25
1658095305876,COGS 13,A01,083071,Bastos; Amalia Pinkusfeld,12,0,71,59
1658095311899,COGS 14A,A01,092681,Semenuks; Arturs,5,1,100,95
1658095317920,COGS 14B,A01,083073,Cheng; Tzu-Han,7,0,63,56
1658095323948,COGS 17,A01,092677,Semenuks; Arturs,7,0,81,74
1658095329969,COGS 100,A01,083619,Allen; Michael Gordon,17,0,70,53
1658095335992,COGS 101A,A01,083621,Davis; Joshua Daniel,9,0,68,59
1658095342014,COGS 101B,A01,091572,Allen; Michael Gordon,14,0,65,51
1658095348041,COGS 101C,A01,083625,Delgado; Tania,17,0,35,18
1658095354065,COGS 107A,A01,083627,Boyle; Mary E. T.,14,0,60,46
1658095360093,COGS 118A,A01,083075,Gupta; Anjum,21,0,76,55
1658095366122,CSE 3,A50,083646,Miranda; Gregory Joseph,24,0,50,26
1658095372146,CSE 8A,A50,083650,Miranda; Gregory Joseph,17,1,56,39
1658095378169,CSE 11,A01,083080,Cao; Yingjun,7,15,40,33
1658095384196,CSE 12,A01,083652,Krause-Levy; Sophia Louisa,30,1,120,90
1658095390222,CSE 15L,A01,083654,Morris; Justin Loren,9,0,50,41
1658095390222,CSE 15L,A02,083655,Morris; Justin Loren,11,0,50,39
1658095396245,CSE 20,A01,083657,Tran; Khoa Dang,39,0,80,41
1658095402280,CSE 21,A01,095574,Bach; Quang Tran,23,0,48,25
1658095408311,CSE 30,A01,083084,Eldon; John,8,0,80,72
1658095408311,CSE 30,B01,095061,Bhaskar; Nishant,9,0,50,41
1658095414335,CSE 100,A01,083659,Cao; Yingjun,5,4,70,65
1658095420363,CSE 134B,A01,083661,Powell; Thomas Allan,25,0,100,75
1658095426390,CSE 140,A01,083663,Gungor; Onat,17,0,85,68
1658095432415,CSE 140L,A01,083088,Eldon; John,23,0,100,77
1658095438438,CSE 175,A01,083665,Kumar; Rakesh,3,0,25,22
1658095444554,CSE 190,A00,092507,Dubnov; Shlomo,8,0,20,12
1658095450579,ECE 45,A01,083139,Congero; Spencer William,7,0,75,68
1658095456603,ECE 65,A50,083695,Saad; Andrew S,12,0,30,18
1658095456603,ECE 65,A51,095125,Saad; Andrew S,24,0,26,2
1658095462625,ECE 109,A01,091882,Touri; Behrouz,21,0,70,49
1658095468650,ECE 180,A00,083140,Abi Samra; Nicholas Camill,1,0,30,29
1658095468650,ECE 180,B00,083141,Abi Samra; Nicholas Camill,0,0,30,30
1658095474675,MATH 10A,A01,083735,Patchell; Gregory David,2,0,30,28
1658095474675,MATH 10A,A02,083736,Patchell; Gregory David,20,0,30,10
1658095474675,MATH 10A,A03,083737,Patchell; Gregory David,16,0,30,14
1658095480697,MATH 10B,A01,083207,Lim; Seonhee,9,0,34,25
1658095480697,MATH 10B,A02,083208,Lim; Seonhee,10,0,35,25
1658095480697,MATH 10B,A03,093472,Lim; Seonhee,7,0,34,27
1658095480697,MATH 10B,B01,083739,Sinha; Shubham,14,0,30,16
1658095486725,MATH 18,A01,083743,Cinel; Cameron Alexander,9,0,30,21
1658095486725,MATH 18,A02,083744,Cinel; Cameron Alexander,18,0,30,12
1658095486725,MATH 18,A03,083745,Cinel; Cameron Alexander,10,0,30,20
1658095486725,MATH 18,B01,083748,Rideout; David Porter,5,0,37,32
1658095486725,MATH 18,B02,083749,Rideout; David Porter,5,0,36,31
1658095486725,MATH 18,B03,083750,Rideout; David Porter,3,0,37,34
1658095486725,MATH 18,B04,083751,Rideout; David Porter,7,0,36,29
1658095486725,MATH 18,B05,093473,Rideout; David Porter,7,0,36,29
1658095486725,MATH 18,B06,093474,Rideout; David Porter,6,0,36,30
1658095492756,MATH 20A,A01,083754,Zheng; Zequn,14,0,40,26
1658095498779,MATH 20B,A01,083756,Briones; Jor-el Thomas Caparas,4,0,36,32
1658095498779,MATH 20B,A02,083757,Briones; Jor-el Thomas Caparas,1,0,36,35
1658095498779,MATH 20B,A03,093475,Briones; Jor-el Thomas Caparas,3,0,36,33
1658095504803,MATH 20C,A01,083760,Briones; Jor-el Thomas Caparas,1,0,35,34
1658095504803,MATH 20C,A02,083761,Briones; Jor-el Thomas Caparas,8,0,35,27
1658095504803,MATH 20C,A03,093476,Briones; Jor-el Thomas Caparas,0,1,36,36
1658095504803,MATH 20C,B01,083762,Bach; Quang Tran,1,0,30,29
1658095510830,MATH 20D,A01,083765,Tran; Brian Kha,5,0,30,25
1658095510830,MATH 20D,A02,083766,Tran; Brian Kha,5,0,30,25
1658095510830,MATH 20D,A03,083767,Tran; Brian Kha,6,0,30,24
1658095516858,MATH 20E,A01,083771,Ganguly; Soumya,12,0,32,20
1658095516858,MATH 20E,A02,083772,Ganguly; Soumya,7,0,32,25
1658095516858,MATH 20E,B01,083773,Ciotti; Benjamin,20,0,35,15
1658095516858,MATH 20E,B02,083774,Ciotti; Benjamin,18,0,35,17
1658095522889,MATH 103A,A01,083777,Greenfeld; Be'Eri,6,0,36,30
1658095522889,MATH 103A,A02,083778,Greenfeld; Be'Eri,5,0,36,31
1658095522889,MATH 103A,A03,093561,Greenfeld; Be'Eri,7,0,36,29
1658095522889,MATH 103A,B01,083779,Greenfeld; Be'Eri,8,0,36,28
1658095522889,MATH 103A,B02,083780,Greenfeld; Be'Eri,4,0,36,32
1658095522889,MATH 103A,B03,093562,Greenfeld; Be'Eri,3,0,36,33
1658095528913,MATH 105,A01,085443,Carter; Anne Toulson,15,0,35,20
1658095528913,MATH 105,A02,093477,Carter; Anne Toulson,20,0,35,15
1658095534937,MATH 109,A01,083213,Ganzberger; Geoffrey Michael,3,0,34,31
1658095534937,MATH 109,A02,083214,Ganzberger; Geoffrey Michael,4,0,34,30
1658095534937,MATH 109,A03,093478,Ganzberger; Geoffrey Michael,2,0,34,32
1658095534937,MATH 109,B01,083215,Ganzberger; Geoffrey Michael,3,0,32,29
1658095534937,MATH 109,B02,083216,Ganzberger; Geoffrey Michael,3,0,32,29
1658095534937,MATH 109,B03,093479,Ganzberger; Geoffrey Michael,8,0,32,24
1658095540964,MATH 142A,A01,083219,Chow; Bennett,7,0,32,25
1658095540964,MATH 142A,A02,083220,Chow; Bennett,10,0,32,22
1658095540964,MATH 142A,A03,093480,Chow; Bennett,9,0,32,23
1658095540964,MATH 142A,B03,093481,Chow; Bennett,8,0,32,24
1658095540964,MATH 142A,B04,093558,Chow; Bennett,14,0,32,18
1658095540964,MATH 142A,B05,093559,Chow; Bennett,7,0,32,25
1658095546987,MATH 193A,A01,083224,Rotar; Vladimir,9,0,34,25
1658095546987,MATH 193A,A02,083225,Rotar; Vladimir,11,0,34,23
1658095546987,MATH 193A,A03,083781,Rotar; Vladimir,5,0,34,29
1658095546987,MATH 193A,A04,083782,Rotar; Vladimir,12,0,34,22
1658095546987,MATH 193A,A05,093482,Rotar; Vladimir,11,0,34,23
1658095553009,MATH 197,001,091859,McAuley; Julian John,9999,0,9999,0
1658095553009,MATH 197,002,095566,Kedlaya; Kiran S.,9997,0,9999,2
1658095553009,MATH 197,003,095567,Xiao; Ming,9999,0,9999,0
1658095553009,MATH 197,004,095571,Perols; Johan Lars,9998,0,9999,1
1658095560062,COGS 9,A01,083615,Shannon; Kyle Michael,11,0,75,64
1658095566084,COGS 11,A01,083617,Boyle; Mary E. T.,23,0,48,25
1658095572107,COGS 13,A01,083071,Bastos; Amalia Pinkusfeld,12,0,71,59
1658095578143,COGS 14A,A01,092681,Semenuks; Arturs,5,1,100,95
1658095584169,COGS 14B,A01,083073,Cheng; Tzu-Han,7,0,63,56
1658095590197,COGS 17,A01,092677,Semenuks; Arturs,7,0,81,74
1658095596223,COGS 100,A01,083619,Allen; Michael Gordon,17,0,70,53
1658095602249,COGS 101A,A01,083621,Davis; Joshua Daniel,9,0,68,59
1658095608271,COGS 101B,A01,091572,Allen; Michael Gordon,14,0,65,51
1658095614301,COGS 101C,A01,083625,Delgado; Tania,17,0,35,18
1658095620328,COGS 107A,A01,083627,Boyle; Mary E. T.,14,0,60,46
1658095626355,COGS 118A,A01,083075,Gupta; Anjum,21,0,76,55
1658095632379,CSE 3,A50,083646,Miranda; Gregory Joseph,24,0,50,26
1658095638409,CSE 8A,A50,083650,Miranda; Gregory Joseph,17,1,56,39
1658095644435,CSE 11,A01,083080,Cao; Yingjun,7,15,40,33
1658095650467,CSE 12,A01,083652,Krause-Levy; Sophia Louisa,30,1,120,90
1658095656490,CSE 15L,A01,083654,Morris; Justin Loren,9,0,50,41
1658095656490,CSE 15L,A02,083655,Morris; Justin Loren,11,0,50,39
1658095662516,CSE 20,A01,083657,Tran; Khoa Dang,39,0,80,41
1658095668542,CSE 21,A01,095574,Bach; Quang Tran,23,0,48,25
1658095674570,CSE 30,A01,083084,Eldon; John,8,0,80,72
1658095674570,CSE 30,B01,095061,Bhaskar; Nishant,9,0,50,41
1658095680595,CSE 100,A01,083659,Cao; Yingjun,5,4,70,65
1658095686622,CSE 134B,A01,083661,Powell; Thomas Allan,25,0,100,75
1658095692657,CSE 140,A01,083663,Gungor; Onat,17,0,85,68
1658095698680,CSE 140L,A01,083088,Eldon; John,23,0,100,77
1658095704703,CSE 175,A01,083665,Kumar; Rakesh,3,0,25,22
1658095710725,CSE 190,A00,092507,Dubnov; Shlomo,8,0,20,12
1658095716749,ECE 45,A01,083139,Congero; Spencer William,7,0,75,68
1658095722772,ECE 65,A50,083695,Saad; Andrew S,12,0,30,18
1658095722772,ECE 65,A51,095125,Saad; Andrew S,24,0,26,2
1658095728798,ECE 109,A01,091882,Touri; Behrouz,21,0,70,49
1658095734834,ECE 180,A00,083140,Abi Samra; Nicholas Camill,1,0,30,29
1658095734834,ECE 180,B00,083141,Abi Samra; Nicholas Camill,0,0,30,30
1658095740866,MATH 10A,A01,083735,Patchell; Gregory David,2,0,30,28
1658095740866,MATH 10A,A02,083736,Patchell; Gregory David,20,0,30,10
1658095740866,MATH 10A,A03,083737,Patchell; Gregory David,16,0,30,14
1658095746890,MATH 10B,A01,083207,Lim; Seonhee,9,0,34,25
1658095746890,MATH 10B,A02,083208,Lim; Seonhee,10,0,35,25
1658095746890,MATH 10B,A03,093472,Lim; Seonhee,7,0,34,27
1658095746890,MATH 10B,B01,083739,Sinha; Shubham,14,0,30,16
1658095752921,MATH 18,A01,083743,Cinel; Cameron Alexander,9,0,30,21
1658095752921,MATH 18,A02,083744,Cinel; Cameron Alexander,18,0,30,12
1658095752921,MATH 18,A03,083745,Cinel; Cameron Alexander,10,0,30,20
1658095752921,MATH 18,B01,083748,Rideout; David Porter,5,0,37,32
1658095752921,MATH 18,B02,083749,Rideout; David Porter,5,0,36,31
1658095752921,MATH 18,B03,083750,Rideout; David Porter,3,0,37,34
1658095752921,MATH 18,B04,083751,Rideout; David Porter,7,0,36,29
1658095752921,MATH 18,B05,093473,Rideout; David Porter,7,0,36,29
1658095752921,MATH 18,B06,093474,Rideout; David Porter,6,0,36,30
1658095758943,MATH 20A,A01,083754,Zheng; Zequn,14,0,40,26
1658095764967,MATH 20B,A01,083756,Briones; Jor-el Thomas Caparas,4,0,36,32
1658095764967,MATH 20B,A02,083757,Briones; Jor-el Thomas Caparas,1,0,36,35
1658095764967,MATH 20B,A03,093475,Briones; Jor-el Thomas Caparas,3,0,36,33
1658095770991,MATH 20C,A01,083760,Briones; Jor-el Thomas Caparas,1,0,35,34
1658095770991,MATH 20C,A02,083761,Briones; Jor-el Thomas Caparas,8,0,35,27
1658095770991,MATH 20C,A03,093476,Briones; Jor-el Thomas Caparas,0,1,36,36
1658095770991,MATH 20C,B01,083762,Bach; Quang Tran,1,0,30,29
1658095777015,MATH 20D,A01,083765,Tran; Brian Kha,5,0,30,25
1658095777015,MATH 20D,A02,083766,Tran; Brian Kha,5,0,30,25
1658095777015,MATH 20D,A03,083767,Tran; Brian Kha,6,0,30,24
1658095783039,MATH 20E,A01,083771,Ganguly; Soumya,12,0,32,20
1658095783039,MATH 20E,A02,083772,Ganguly; Soumya,7,0,32,25
1658095783039,MATH 20E,B01,083773,Ciotti; Benjamin,20,0,35,15
1658095783039,MATH 20E,B02,083774,Ciotti; Benjamin,18,0,35,17
1658095789075,MATH 103A,A01,083777,Greenfeld; Be'Eri,6,0,36,30
1658095789075,MATH 103A,A02,083778,Greenfeld; Be'Eri,5,0,36,31
1658095789075,MATH 103A,A03,093561,Greenfeld; Be'Eri,7,0,36,29
1658095789075,MATH 103A,B01,083779,Greenfeld; Be'Eri,8,0,36,28
1658095789075,MATH 103A,B02,083780,Greenfeld; Be'Eri,4,0,36,32
1658095789075,MATH 103A,B03,093562,Greenfeld; Be'Eri,3,0,36,33
1658095795098,MATH 105,A01,085443,Carter; Anne Toulson,15,0,35,20
1658095795098,MATH 105,A02,093477,Carter; Anne Toulson,20,0,35,15
1658095801122,MATH 109,A01,083213,Ganzberger; Geoffrey Michael,3,0,34,31
1658095801122,MATH 109,A02,083214,Ganzberger; Geoffrey Michael,4,0,34,30
1658095801122,MATH 109,A03,093478,Ganzberger; Geoffrey Michael,2,0,34,32
1658095801122,MATH 109,B01,083215,Ganzberger; Geoffrey Michael,3,0,32,29
1658095801122,MATH 109,B02,083216,Ganzberger; Geoffrey Michael,3,0,32,29
1658095801122,MATH 109,B03,093479,Ganzberger; Geoffrey Michael,8,0,32,24
1658095807158,MATH 142A,A01,083219,Chow; Bennett,7,0,32,25
1658095807158,MATH 142A,A02,083220,Chow; Bennett,10,0,32,22
1658095807158,MATH 142A,A03,093480,Chow; Bennett,9,0,32,23
1658095807158,MATH 142A,B03,093481,Chow; Bennett,8,0,32,24
1658095807158,MATH 142A,B04,093558,Chow; Bennett,14,0,32,18
1658095807158,MATH 142A,B05,093559,Chow; Bennett,7,0,32,25
1658095813181,MATH 193A,A01,083224,Rotar; Vladimir,9,0,34,25
1658095813181,MATH 193A,A02,083225,Rotar; Vladimir,11,0,34,23
1658095813181,MATH 193A,A03,083781,Rotar; Vladimir,5,0,34,29
1658095813181,MATH 193A,A04,083782,Rotar; Vladimir,12,0,34,22
1658095813181,MATH 193A,A05,093482,Rotar; Vladimir,11,0,34,23
1658095819208,MATH 197,001,091859,McAuley; Julian John,9999,0,9999,0
1658095819208,MATH 197,002,095566,Kedlaya; Kiran S.,9997,0,9999,2
1658095819208,MATH 197,003,095567,Xiao; Ming,9999,0,9999,0
1658095819208,MATH 197,004,095571,Perols; Johan Lars,9998,0,9999,1
1658095826274,COGS 9,A01,083615,Shannon; Kyle Michael,11,0,75,64
1658095832297,COGS 11,A01,083617,Boyle; Mary E. T.,23,0,48,25
1658095838322,COGS 13,A01,083071,Bastos; Amalia Pinkusfeld,12,0,71,59
1658095844346,COGS 14A,A01,092681,Semenuks; Arturs,5,1,100,95
1658095850378,COGS 14B,A01,083073,Cheng; Tzu-Han,7,0,63,56
1658095856404,COGS 17,A01,092677,Semenuks; Arturs,7,0,81,74
1658095862429,COGS 100,A01,083619,Allen; Michael Gordon,17,0,70,53
1658095868453,COGS 101A,A01,083621,Davis; Joshua Daniel,9,0,68,59
1658095874476,COGS 101B,A01,091572,Allen; Michael Gordon,14,0,65,51
1658095880500,COGS 101C,A01,083625,Delgado; Tania,17,0,35,18
1658095886524,COGS 107A,A01,083627,Boyle; Mary E. T.,14,0,60,46
1658095892551,COGS 118A,A01,083075,Gupta; Anjum,21,0,76,55
1658095898574,CSE 3,A50,083646,Miranda; Gregory Joseph,24,0,50,26
1658095904597,CSE 8A,A50,083650,Miranda; Gregory Joseph,17,1,56,39
1658095910624,CSE 11,A01,083080,Cao; Yingjun,7,15,40,33
1658095916650,CSE 12,A01,083652,Krause-Levy; Sophia Louisa,30,1,120,90
1658095922677,CSE 15L,A01,083654,Morris; Justin Loren,9,0,50,41
1658095922677,CSE 15L,A02,083655,Morris; Justin Loren,11,0,50,39
1658095928707,CSE 20,A01,083657,Tran; Khoa Dang,39,0,80,41
1658095934733,CSE 21,A01,095574,Bach; Quang Tran,23,0,48,25
1658095940758,CSE 30,A01,083084,Eldon; John,8,0,80,72
1658095940758,CSE 30,B01,095061,Bhaskar; Nishant,9,0,50,41
1658095946782,CSE 100,A01,083659,Cao; Yingjun,5,4,70,65
1658095952809,CSE 134B,A01,083661,Powell; Thomas Allan,25,0,100,75
1658095958835,CSE 140,A01,083663,Gungor; Onat,17,0,85,68
1658095964863,CSE 140L,A01,083088,Eldon; John,23,0,100,77
1658095970889,CSE 175,A01,083665,Kumar; Rakesh,3,0,25,22
1658095976912,CSE 190,A00,092507,Dubnov; Shlomo,8,0,20,12
1658095982938,ECE 45,A01,083139,Congero; Spencer William,7,0,75,68
1658095988964,ECE 65,A50,083695,Saad; Andrew S,12,0,30,18
1658095988964,ECE 65,A51,095125,Saad; Andrew S,24,0,26,2
1658095994991,ECE 109,A01,091882,Touri; Behrouz,21,0,70,49
1658096001017,ECE 180,A00,083140,Abi Samra; Nicholas Camill,1,0,30,29
1658096001017,ECE 180,B00,083141,Abi Samra; Nicholas Camill,0,0,30,30
1658096007042,MATH 10A,A01,083735,Patchell; Gregory David,2,0,30,28
1658096007042,MATH 10A,A02,083736,Patchell; Gregory David,20,0,30,10
1658096007042,MATH 10A,A03,083737,Patchell; Gregory David,16,0,30,14
1658096013066,MATH 10B,A01,083207,Lim; Seonhee,9,0,34,25
1658096013066,MATH 10B,A02,083208,Lim; Seonhee,10,0,35,25
1658096013066,MATH 10B,A03,093472,Lim; Seonhee,7,0,34,27
1658096013066,MATH 10B,B01,083739,Sinha; Shubham,14,0,30,16
1658096019094,MATH 18,A01,083743,Cinel; Cameron Alexander,9,0,30,21
1658096019094,MATH 18,A02,083744,Cinel; Cameron Alexander,18,0,30,12
1658096019094,MATH 18,A03,083745,Cinel; Cameron Alexander,10,0,30,20
1658096019094,MATH 18,B01,083748,Rideout; David Porter,5,0,37,32
1658096019094,MATH 18,B02,083749,Rideout; David Porter,5,0,36,31
1658096019094,MATH 18,B03,083750,Rideout; David Porter,3,0,37,34
1658096019094,MATH 18,B04,083751,Rideout; David Porter,7,0,36,29
1658096019094,MATH 18,B05,093473,Rideout; David Porter,7,0,36,29
1658096019094,MATH 18,B06,093474,Rideout; David Porter,6,0,36,30
1658096025118,MATH 20A,A01,083754,Zheng; Zequn,14,0,40,26
1658096031141,MATH 20B,A01,083756,Briones; Jor-el Thomas Caparas,4,0,36,32
1658096031141,MATH 20B,A02,083757,Briones; Jor-el Thomas Caparas,1,0,36,35
1658096031141,MATH 20B,A03,093475,Briones; Jor-el Thomas Caparas,3,0,36,33
1658096037169,MATH 20C,A01,083760,Briones; Jor-el Thomas Caparas,1,0,35,34
1658096037169,MATH 20C,A02,083761,Briones; Jor-el Thomas Caparas,8,0,35,27
1658096037169,MATH 20C,A03,093476,Briones; Jor-el Thomas Caparas,0,1,36,36
1658096037169,MATH 20C,B01,083762,Bach; Quang Tran,1,0,30,29
1658096043270,MATH 20D,A01,083765,Tran; Brian Kha,5,0,30,25
1658096043270,MATH 20D,A02,083766,Tran; Brian Kha,5,0,30,25
1658096043270,MATH 20D,A03,083767,Tran; Brian Kha,6,0,30,24
1658096049298,MATH 20E,A01,083771,Ganguly; Soumya,12,0,32,20
1658096049298,MATH 20E,A02,083772,Ganguly; Soumya,7,0,32,25
1658096049298,MATH 20E,B01,083773,Ciotti; Benjamin,20,0,35,15
1658096049298,MATH 20E,B02,083774,Ciotti; Benjamin,18,0,35,17
1658096055330,MATH 103A,A01,083777,Greenfeld; Be'Eri,6,0,36,30
1658096055330,MATH 103A,A02,083778,Greenfeld; Be'Eri,5,0,36,31
1658096055330,MATH 103A,A03,093561,Greenfeld; Be'Eri,7,0,36,29
1658096055330,MATH 103A,B01,083779,Greenfeld; Be'Eri,8,0,36,28
1658096055330,MATH 103A,B02,083780,Greenfeld; Be'Eri,4,0,36,32
1658096055330,MATH 103A,B03,093562,Greenfeld; Be'Eri,3,0,36,33
1658096061357,MATH 105,A01,085443,Carter; Anne Toulson,15,0,35,20
1658096061357,MATH 105,A02,093477,Carter; Anne Toulson,20,0,35,15
1658096067381,MATH 109,A01,083213,Ganzberger; Geoffrey Michael,3,0,34,31
1658096067381,MATH 109,A02,083214,Ganzberger; Geoffrey Michael,4,0,34,30
1658096067381,MATH 109,A03,093478,Ganzberger; Geoffrey Michael,2,0,34,32
1658096067381,MATH 109,B01,083215,Ganzberger; Geoffrey Michael,3,0,32,29
1658096067381,MATH 109,B02,083216,Ganzberger; Geoffrey Michael,3,0,32,29
1658096067381,MATH 109,B03,093479,Ganzberger; Geoffrey Michael,8,0,32,24
1658096073410,MATH 142A,A01,083219,Chow; Bennett,7,0,32,25
1658096073410,MATH 142A,A02,083220,Chow; Bennett,10,0,32,22
1658096073410,MATH 142A,A03,093480,Chow; Bennett,9,0,32,23
1658096073410,MATH 142A,B03,093481,Chow; Bennett,8,0,32,24
1658096073410,MATH 142A,B04,093558,Chow; Bennett,14,0,32,18
1658096073410,MATH 142A,B05,093559,Chow; Bennett,7,0,32,25
1658096079442,MATH 193A,A01,083224,Rotar; Vladimir,9,0,34,25
1658096079442,MATH 193A,A02,083225,Rotar; Vladimir,11,0,34,23
1658096079442,MATH 193A,A03,083781,Rotar; Vladimir,5,0,34,29
1658096079442,MATH 193A,A04,083782,Rotar; Vladimir,12,0,34,22
1658096079442,MATH 193A,A05,093482,Rotar; Vladimir,11,0,34,23
1658096085463,MATH 197,001,091859,McAuley; Julian John,9999,0,9999,0
1658096085463,MATH 197,002,095566,Kedlaya; Kiran S.,9997,0,9999,2
1658096085463,MATH 197,003,095567,Xiao; Ming,9999,0,9999,0
1658096085463,MATH 197,004,095571,Perols; Johan Lars,9998,0,9999,1
1658096092531,COGS 9,A01,083615,Shannon; Kyle Michael,11,0,75,64
1658096098555,COGS 11,A01,083617,Boyle; Mary E. T.,23,0,48,25
1658096104577,COGS 13,A01,083071,Bastos; Amalia Pinkusfeld,12,0,71,59
1658096110600,COGS 14A,A01,092681,Semenuks; Arturs,5,1,100,95
1658096116624,COGS 14B,A01,083073,Cheng; Tzu-Han,7,0,63,56
1658096122646,COGS 17,A01,092677,Semenuks; Arturs,7,0,81,74
1658096128667,COGS 100,A01,083619,Allen; Michael Gordon,17,0,70,53
1658096134692,COGS 101A,A01,083621,Davis; Joshua Daniel,9,0,68,59
1658096140714,COGS 101B,A01,091572,Allen; Michael Gordon,14,0,65,51
1658096146738,COGS 101C,A01,083625,Delgado; Tania,17,0,35,18
1658096152761,COGS 107A,A01,083627,Boyle; Mary E. T.,14,0,60,46
1658096158783,COGS 118A,A01,083075,Gupta; Anjum,21,0,76,55
1658096164805,CSE 3,A50,083646,Miranda; Gregory Joseph,24,0,50,26
1658096170830,CSE 8A,A50,083650,Miranda; Gregory Joseph,17,1,56,39
1658096176852,CSE 11,A01,083080,Cao; Yingjun,7,15,40,33
1658096182875,CSE 12,A01,083652,Krause-Levy; Sophia Louisa,30,1,120,90
1658096188897,CSE 15L,A01,083654,Morris; Justin Loren,9,0,50,41
1658096188897,CSE 15L,A02,083655,Morris; Justin Loren,11,0,50,39
1658096194953,CSE 20,A01,083657,Tran; Khoa Dang,39,0,80,41
1658096200975,CSE 21,A01,095574,Bach; Quang Tran,23,0,48,25
1658096206998,CSE 30,A01,083084,Eldon; John,8,0,80,72
1658096206998,CSE 30,B01,095061,Bhaskar; Nishant,9,0,50,41
1658096213024,CSE 100,A01,083659,Cao; Yingjun,5,4,70,65
1658096219046,CSE 134B,A01,083661,Powell; Thomas Allan,25,0,100,75
1658096225070,CSE 140,A01,083663,Gungor; Onat,17,0,85,68
1658096231104,CSE 140L,A01,083088,Eldon; John,23,0,100,77
1658096237128,CSE 175,A01,083665,Kumar; Rakesh,3,0,25,22
1658096243150,CSE 190,A00,092507,Dubnov; Shlomo,8,0,20,12
1658096249183,ECE 45,A01,083139,Congero; Spencer William,7,0,75,68
1658096255206,ECE 65,A50,083695,Saad; Andrew S,12,0,30,18
1658096255206,ECE 65,A51,095125,Saad; Andrew S,24,0,26,2
1658096261234,ECE 109,A01,091882,Touri; Behrouz,21,0,70,49
1658096267262,ECE 180,A00,083140,Abi Samra; Nicholas Camill,1,0,30,29
1658096267262,ECE 180,B00,083141,Abi Samra; Nicholas Camill,0,0,30,30
1658096273298,MATH 10A,A01,083735,Patchell; Gregory David,2,0,30,28
1658096273298,MATH 10A,A02,083736,Patchell; Gregory David,20,0,30,10
1658096273298,MATH 10A,A03,083737,Patchell; Gregory David,16,0,30,14
1658096279323,MATH 10B,A01,083207,Lim; Seonhee,9,0,34,25
1658096279323,MATH 10B,A02,083208,Lim; Seonhee,10,0,35,25
1658096279323,MATH 10B,A03,093472,Lim; Seonhee,7,0,34,27
1658096279323,MATH 10B,B01,083739,Sinha; Shubham,14,0,30,16
1658096285348,MATH 18,A01,083743,Cinel; Cameron Alexander,9,0,30,21
1658096285348,MATH 18,A02,083744,Cinel; Cameron Alexander,18,0,30,12
1658096285348,MATH 18,A03,083745,Cinel; Cameron Alexander,10,0,30,20
1658096285348,MATH 18,B01,083748,Rideout; David Porter,5,0,37,32
1658096285348,MATH 18,B02,083749,Rideout; David Porter,5,0,36,31
1658096285348,MATH 18,B03,083750,Rideout; David Porter,3,0,37,34
1658096285348,MATH 18,B04,083751,Rideout; David Porter,7,0,36,29
1658096285348,MATH 18,B05,093473,Rideout; David Porter,7,0,36,29
1658096285348,MATH 18,B06,093474,Rideout; David Porter,6,0,36,30
1658096291375,MATH 20A,A01,083754,Zheng; Zequn,14,0,40,26
1658096297401,MATH 20B,A01,083756,Briones; Jor-el Thomas Caparas,4,0,36,32
1658096297401,MATH 20B,A02,083757,Briones; Jor-el Thomas Caparas,1,0,36,35
1658096297401,MATH 20B,A03,093475,Briones; Jor-el Thomas Caparas,3,0,36,33
1658096303424,MATH 20C,A01,083760,Briones; Jor-el Thomas Caparas,1,0,35,34
1658096303424,MATH 20C,A02,083761,Briones; Jor-el Thomas Caparas,8,0,35,27
1658096303424,MATH 20C,A03,093476,Briones; Jor-el Thomas Caparas,0,1,36,36
1658096303424,MATH 20C,B01,083762,Bach; Quang Tran,1,0,30,29
1658096309459,MATH 20D,A01,083765,Tran; Brian Kha,5,0,30,25
1658096309459,MATH 20D,A02,083766,Tran; Brian Kha,5,0,30,25
1658096309459,MATH 20D,A03,083767,Tran; Brian Kha,6,0,30,24
1658096315487,MATH 20E,A01,083771,Ganguly; Soumya,12,0,32,20
1658096315487,MATH 20E,A02,083772,Ganguly; Soumya,7,0,32,25
1658096315487,MATH 20E,B01,083773,Ciotti; Benjamin,20,0,35,15
1658096315487,MATH 20E,B02,083774,Ciotti; Benjamin,18,0,35,17
1658096321517,MATH 103A,A01,083777,Greenfeld; Be'Eri,6,0,36,30
1658096321517,MATH 103A,A02,083778,Greenfeld; Be'Eri,5,0,36,31
1658096321517,MATH 103A,A03,093561,Greenfeld; Be'Eri,7,0,36,29
1658096321517,MATH 103A,B01,083779,Greenfeld; Be'Eri,8,0,36,28
1658096321517,MATH 103A,B02,083780,Greenfeld; Be'Eri,4,0,36,32
1658096321517,MATH 103A,B03,093562,Greenfeld; Be'Eri,3,0,36,33
1658096327544,MATH 105,A01,085443,Carter; Anne Toulson,15,0,35,20
1658096327544,MATH 105,A02,093477,Carter; Anne Toulson,20,0,35,15
1658096333572,MATH 109,A01,083213,Ganzberger; Geoffrey Michael,3,0,34,31
1658096333572,MATH 109,A02,083214,Ganzberger; Geoffrey Michael,4,0,34,30
1658096333572,MATH 109,A03,093478,Ganzberger; Geoffrey Michael,2,0,34,32
1658096333572,MATH 109,B01,083215,Ganzberger; Geoffrey Michael,3,0,32,29
1658096333572,MATH 109,B02,083216,Ganzberger; Geoffrey Michael,3,0,32,29
1658096333572,MATH 109,B03,093479,Ganzberger; Geoffrey Michael,8,0,32,24
1658096339596,MATH 142A,A01,083219,Chow; Bennett,7,0,32,25
1658096339596,MATH 142A,A02,083220,Chow; Bennett,10,0,32,22
1658096339596,MATH 142A,A03,093480,Chow; Bennett,9,0,32,23
1658096339596,MATH 142A,B03,093481,Chow; Bennett,8,0,32,24
1658096339596,MATH 142A,B04,093558,Chow; Bennett,14,0,32,18
1658096339596,MATH 142A,B05,093559,Chow; Bennett,7,0,32,25
1658096345618,MATH 193A,A01,083224,Rotar; Vladimir,9,0,34,25
1658096345618,MATH 193A,A02,083225,Rotar; Vladimir,11,0,34,23
1658096345618,MATH 193A,A03,083781,Rotar; Vladimir,5,0,34,29
1658096345618,MATH 193A,A04,083782,Rotar; Vladimir,12,0,34,22
1658096345618,MATH 193A,A05,093482,Rotar; Vladimir,11,0,34,23
1658096351646,MATH 197,001,091859,McAuley; Julian John,9999,0,9999,0
1658096351646,MATH 197,002,095566,Kedlaya; Kiran S.,9997,0,9999,2
1658096351646,MATH 197,003,095567,Xiao; Ming,9999,0,9999,0
1658096351646,MATH 197,004,095571,Perols; Johan Lars,9998,0,9999,1
1658096358702,COGS 9,A01,083615,Shannon; Kyle Michael,11,0,75,64
1658096364726,COGS 11,A01,083617,Boyle; Mary E. T.,23,0,48,25
1658096370748,COGS 13,A01,083071,Bastos; Amalia Pinkusfeld,12,0,71,59
1658096376775,COGS 14A,A01,092681,Semenuks; Arturs,5,1,100,95
1658096382798,COGS 14B,A01,083073,Cheng; Tzu-Han,7,0,63,56
1658096388823,COGS 17,A01,092677,Semenuks; Arturs,7,0,81,74
1658096394850,COGS 100,A01,083619,Allen; Michael Gordon,17,0,70,53
1658096400880,COGS 101A,A01,083621,Davis; Joshua Daniel,9,0,68,59
1658096406903,COGS 101B,A01,091572,Allen; Michael Gordon,14,0,65,51
1658096412929,COGS 101C,A01,083625,Delgado; Tania,17,0,35,18
1658096418953,COGS 107A,A01,083627,Boyle; Mary E. T.,14,0,60,46
1658096424980,COGS 118A,A01,083075,Gupta; Anjum,21,0,76,55
1658096431003,CSE 3,A50,083646,Miranda; Gregory Joseph,24,0,50,26
1658096437027,CSE 8A,A50,083650,Miranda; Gregory Joseph,17,1,56,39
1658096443050,CSE 11,A01,083080,Cao; Yingjun,7,15,40,33
1658096449073,CSE 12,A01,083652,Krause-Levy; Sophia Louisa,30,1,120,90
1658096455097,CSE 15L,A01,083654,Morris; Justin Loren,9,0,50,41
1658096455097,CSE 15L,A02,083655,Morris; Justin Loren,11,0,50,39
1658096461119,CSE 20,A01,083657,Tran; Khoa Dang,39,0,80,41
1658096467146,CSE 21,A01,095574,Bach; Quang Tran,23,0,48,25
1658096473170,CSE 30,A01,083084,Eldon; John,8,0,80,72
1658096473170,CSE 30,B01,095061,Bhaskar; Nishant,9,0,50,41
1658096479193,CSE 100,A01,083659,Cao; Yingjun,5,4,70,65
1658096485216,CSE 134B,A01,083661,Powell; Thomas Allan,25,0,100,75
1658096491243,CSE 140,A01,083663,Gungor; Onat,17,0,85,68
1658096497276,CSE 140L,A01,083088,Eldon; John,23,0,100,77
1658096503300,CSE 175,A01,083665,Kumar; Rakesh,3,0,25,22
1658096509322,CSE 190,A00,092507,Dubnov; Shlomo,8,0,20,12
1658096515346,ECE 45,A01,083139,Congero; Spencer William,7,0,75,68
1658096521368,ECE 65,A50,083695,Saad; Andrew S,12,0,30,18
1658096521368,ECE 65,A51,095125,Saad; Andrew S,24,0,26,2
1658096527391,ECE 109,A01,091882,Touri; Behrouz,21,0,70,49
1658096533418,ECE 180,A00,083140,Abi Samra; Nicholas Camill,1,0,30,29
1658096533418,ECE 180,B00,083141,Abi Samra; Nicholas Camill,0,0,30,30
1658096539441,MATH 10A,A01,083735,Patchell; Gregory David,2,0,30,28
1658096539441,MATH 10A,A02,083736,Patchell; Gregory David,20,0,30,10
1658096539441,MATH 10A,A03,083737,Patchell; Gregory David,16,0,30,14
1658096545474,MATH 10B,A01,083207,Lim; Seonhee,9,0,34,25
1658096545474,MATH 10B,A02,083208,Lim; Seonhee,10,0,35,25
1658096545474,MATH 10B,A03,093472,Lim; Seonhee,7,0,34,27
1658096545474,MATH 10B,B01,083739,Sinha; Shubham,14,0,30,16
1658096551500,MATH 18,A01,083743,Cinel; Cameron Alexander,9,0,30,21
1658096551500,MATH 18,A02,083744,Cinel; Cameron Alexander,18,0,30,12
1658096551500,MATH 18,A03,083745,Cinel; Cameron Alexander,10,0,30,20
1658096551500,MATH 18,B01,083748,Rideout; David Porter,5,0,37,32
1658096551500,MATH 18,B02,083749,Rideout; David Porter,5,0,36,31
1658096551500,MATH 18,B03,083750,Rideout; David Porter,3,0,37,34
1658096551500,MATH 18,B04,083751,Rideout; David Porter,7,0,36,29
1658096551500,MATH 18,B05,093473,Rideout; David Porter,7,0,36,29
1658096551500,MATH 18,B06,093474,Rideout; David Porter,6,0,36,30
1658096557527,MATH 20A,A01,083754,Zheng; Zequn,14,0,40,26
1658096563551,MATH 20B,A01,083756,Briones; Jor-el Thomas Caparas,4,0,36,32
1658096563551,MATH 20B,A02,083757,Briones; Jor-el Thomas Caparas,1,0,36,35
1658096563551,MATH 20B,A03,093475,Briones; Jor-el Thomas Caparas,3,0,36,33
1658096569574,MATH 20C,A01,083760,Briones; Jor-el Thomas Caparas,1,0,35,34
1658096569574,MATH 20C,A02,083761,Briones; Jor-el Thomas Caparas,8,0,35,27
1658096569574,MATH 20C,A03,093476,Briones; Jor-el Thomas Caparas,0,1,36,36
1658096569574,MATH 20C,B01,083762,Bach; Quang Tran,1,0,30,29
1658096575599,MATH 20D,A01,083765,Tran; Brian Kha,5,0,30,25
1658096575599,MATH 20D,A02,083766,Tran; Brian Kha,5,0,30,25
1658096575599,MATH 20D,A03,083767,Tran; Brian Kha,6,0,30,24
1658096581627,MATH 20E,A01,083771,Ganguly; Soumya,12,0,32,20
1658096581627,MATH 20E,A02,083772,Ganguly; Soumya,7,0,32,25
1658096581627,MATH 20E,B01,083773,Ciotti; Benjamin,20,0,35,15
1658096581627,MATH 20E,B02,083774,Ciotti; Benjamin,18,0,35,17
1658096587656,MATH 103A,A01,083777,Greenfeld; Be'Eri,6,0,36,30
1658096587656,MATH 103A,A02,083778,Greenfeld; Be'Eri,5,0,36,31
1658096587656,MATH 103A,A03,093561,Greenfeld; Be'Eri,7,0,36,29
1658096587656,MATH 103A,B01,083779,Greenfeld; Be'Eri,8,0,36,28
1658096587656,MATH 103A,B02,083780,Greenfeld; Be'Eri,4,0,36,32
1658096587656,MATH 103A,B03,093562,Greenfeld; Be'Eri,3,0,36,33
1658096593681,MATH 105,A01,085443,Carter; Anne Toulson,15,0,35,20
1658096593681,MATH 105,A02,093477,Carter; Anne Toulson,20,0,35,15
1658096599709,MATH 109,A01,083213,Ganzberger; Geoffrey Michael,3,0,34,31
1658096599709,MATH 109,A02,083214,Ganzberger; Geoffrey Michael,4,0,34,30
1658096599709,MATH 109,A03,093478,Ganzberger; Geoffrey Michael,2,0,34,32
1658096599709,MATH 109,B01,083215,Ganzberger; Geoffrey Michael,3,0,32,29
1658096599709,MATH 109,B02,083216,Ganzberger; Geoffrey Michael,3,0,32,29
1658096599709,MATH 109,B03,093479,Ganzberger; Geoffrey Michael,8,0,32,24
1658096605734,MATH 142A,A01,083219,Chow; Bennett,7,0,32,25
1658096605734,MATH 142A,A02,083220,Chow; Bennett,10,0,32,22
1658096605734,MATH 142A,A03,093480,Chow; Bennett,9,0,32,23
1658096605734,MATH 142A,B03,093481,Chow; Bennett,8,0,32,24
1658096605734,MATH 142A,B04,093558,Chow; Bennett,14,0,32,18
1658096605734,MATH 142A,B05,093559,Chow; Bennett,7,0,32,25
1658096611762,MATH 193A,A01,083224,Rotar; Vladimir,9,0,34,25
1658096611762,MATH 193A,A02,083225,Rotar; Vladimir,11,0,34,23
1658096611762,MATH 193A,A03,083781,Rotar; Vladimir,5,0,34,29
1658096611762,MATH 193A,A04,083782,Rotar; Vladimir,12,0,34,22
1658096611762,MATH 193A,A05,093482,Rotar; Vladimir,11,0,34,23
1658096617788,MATH 197,001,091859,McAuley; Julian John,9999,0,9999,0
1658096617788,MATH 197,002,095566,Kedlaya; Kiran S.,9997,0,9999,2
1658096617788,MATH 197,003,095567,Xiao; Ming,9999,0,9999,0
1658096617788,MATH 197,004,095571,Perols; Johan Lars,9998,0,9999,1
1658096624842,COGS 9,A01,083615,Shannon; Kyle Michael,11,0,75,64
1658096630865,COGS 11,A01,083617,Boyle; Mary E. T.,23,0,48,25
1658096636970,COGS 13,A01,083071,Bastos; Amalia Pinkusfeld,12,0,71,59
1658096642997,COGS 14A,A01,092681,Semenuks; Arturs,5,1,100,95
1658096649025,COGS 14B,A01,083073,Cheng; Tzu-Han,7,0,63,56
1658096655052,COGS 17,A01,092677,Semenuks; Arturs,7,0,81,74
1658096661082,COGS 100,A01,083619,Allen; Michael Gordon,17,0,70,53
1658096667110,COGS 101A,A01,083621,Davis; Joshua Daniel,9,0,68,59
1658096673136,COGS 101B,A01,091572,Allen; Michael Gordon,14,0,65,51
1658096679160,COGS 101C,A01,083625,Delgado; Tania,17,0,35,18
1658096685183,COGS 107A,A01,083627,Boyle; Mary E. T.,14,0,60,46
1658096691210,COGS 118A,A01,083075,Gupta; Anjum,21,0,76,55
1658096697233,CSE 3,A50,083646,Miranda; Gregory Joseph,24,0,50,26
1658096703262,CSE 8A,A50,083650,Miranda; Gregory Joseph,17,1,56,39
1658096709286,CSE 11,A01,083080,Cao; Yingjun,7,15,40,33
1658096715309,CSE 12,A01,083652,Krause-Levy; Sophia Louisa,30,1,120,90
1658096721334,CSE 15L,A01,083654,Morris; Justin Loren,9,0,50,41
1658096721334,CSE 15L,A02,083655,Morris; Justin Loren,11,0,50,39
1658096727360,CSE 20,A01,083657,Tran; Khoa Dang,39,0,80,41
1658096733390,CSE 21,A01,095574,Bach; Quang Tran,23,0,48,25
1658096739414,CSE 30,A01,083084,Eldon; John,8,0,80,72
1658096739414,CSE 30,B01,095061,Bhaskar; Nishant,9,0,50,41
1658096745440,CSE 100,A01,083659,Cao; Yingjun,5,4,70,65
1658096751462,CSE 134B,A01,083661,Powell; Thomas Allan,25,0,100,75
1658096757486,CSE 140,A01,083663,Gungor; Onat,17,0,85,68
1658096763512,CSE 140L,A01,083088,Eldon; John,23,0,100,77
1658096769537,CSE 175,A01,083665,Kumar; Rakesh,3,0,25,22
1658096775565,CSE 190,A00,092507,Dubnov; Shlomo,8,0,20,12
1658096781588,ECE 45,A01,083139,Congero; Spencer William,7,0,75,68
1658096787611,ECE 65,A50,083695,Saad; Andrew S,12,0,30,18
1658096787611,ECE 65,A51,095125,Saad; Andrew S,24,0,26,2
1658096793635,ECE 109,A01,091882,Touri; Behrouz,21,0,70,49
1658096799669,ECE 180,A00,083140,Abi Samra; Nicholas Camill,1,0,30,29
1658096799669,ECE 180,B00,083141,Abi Samra; Nicholas Camill,0,0,30,30
1658096805697,MATH 10A,A01,083735,Patchell; Gregory David,2,0,30,28
1658096805697,MATH 10A,A02,083736,Patchell; Gregory David,20,0,30,10
1658096805697,MATH 10A,A03,083737,Patchell; Gregory David,16,0,30,14
1658096811722,MATH 10B,A01,083207,Lim; Seonhee,9,0,34,25
1658096811722,MATH 10B,A02,083208,Lim; Seonhee,10,0,35,25
1658096811722,MATH 10B,A03,093472,Lim; Seonhee,7,0,34,27
1658096811722,MATH 10B,B01,083739,Sinha; Shubham,14,0,30,16
1658096817750,MATH 18,A01,083743,Cinel; Cameron Alexander,9,0,30,21
1658096817750,MATH 18,A02,083744,Cinel; Cameron Alexander,18,0,30,12
1658096817750,MATH 18,A03,083745,Cinel; Cameron Alexander,10,0,30,20
1658096817750,MATH 18,B01,083748,Rideout; David Porter,5,0,37,32
1658096817750,MATH 18,B02,083749,Rideout; David Porter,5,0,36,31
1658096817750,MATH 18,B03,083750,Rideout; David Porter,3,0,37,34
1658096817750,MATH 18,B04,083751,Rideout; David Porter,7,0,36,29
1658096817750,MATH 18,B05,093473,Rideout; David Porter,7,0,36,29
1658096817750,MATH 18,B06,093474,Rideout; David Porter,6,0,36,30
1658096823771,MATH 20A,A01,083754,Zheng; Zequn,14,0,40,26
1658096829799,MATH 20B,A01,083756,Briones; Jor-el Thomas Caparas,4,0,36,32
1658096829799,MATH 20B,A02,083757,Briones; Jor-el Thomas Caparas,1,0,36,35
1658096829799,MATH 20B,A03,093475,Briones; Jor-el Thomas Caparas,3,0,36,33
1658096835830,MATH 20C,A01,083760,Briones; Jor-el Thomas Caparas,1,0,35,34
1658096835830,MATH 20C,A02,083761,Briones; Jor-el Thomas Caparas,8,0,35,27
1658096835830,MATH 20C,A03,093476,Briones; Jor-el Thomas Caparas,0,1,36,36
1658096835830,MATH 20C,B01,083762,Bach; Quang Tran,1,0,30,29
1658096841855,MATH 20D,A01,083765,Tran; Brian Kha,5,0,30,25
1658096841855,MATH 20D,A02,083766,Tran; Brian Kha,5,0,30,25
1658096841855,MATH 20D,A03,083767,Tran; Brian Kha,6,0,30,24
1658096847878,MATH 20E,A01,083771,Ganguly; Soumya,12,0,32,20
1658096847878,MATH 20E,A02,083772,Ganguly; Soumya,7,0,32,25
1658096847878,MATH 20E,B01,083773,Ciotti; Benjamin,20,0,35,15
1658096847878,MATH 20E,B02,083774,Ciotti; Benjamin,18,0,35,17
1658096853908,MATH 103A,A01,083777,Greenfeld; Be'Eri,6,0,36,30
1658096853908,MATH 103A,A02,083778,Greenfeld; Be'Eri,5,0,36,31
1658096853908,MATH 103A,A03,093561,Greenfeld; Be'Eri,7,0,36,29
1658096853908,MATH 103A,B01,083779,Greenfeld; Be'Eri,8,0,36,28
1658096853908,MATH 103A,B02,083780,Greenfeld; Be'Eri,4,0,36,32
1658096853908,MATH 103A,B03,093562,Greenfeld; Be'Eri,3,0,36,33
1658096859931,MATH 105,A01,085443,Carter; Anne Toulson,15,0,35,20
1658096859931,MATH 105,A02,093477,Carter; Anne Toulson,20,0,35,15
1658096865955,MATH 109,A01,083213,Ganzberger; Geoffrey Michael,3,0,34,31
1658096865955,MATH 109,A02,083214,Ganzberger; Geoffrey Michael,4,0,34,30
1658096865955,MATH 109,A03,093478,Ganzberger; Geoffrey Michael,2,0,34,32
1658096865955,MATH 109,B01,083215,Ganzberger; Geoffrey Michael,3,0,32,29
1658096865955,MATH 109,B02,083216,Ganzberger; Geoffrey Michael,3,0,32,29
1658096865955,MATH 109,B03,093479,Ganzberger; Geoffrey Michael,8,0,32,24
1658096871984,MATH 142A,A01,083219,Chow; Bennett,7,0,32,25
1658096871984,MATH 142A,A02,083220,Chow; Bennett,10,0,32,22
1658096871984,MATH 142A,A03,093480,Chow; Bennett,9,0,32,23
1658096871984,MATH 142A,B03,093481,Chow; Bennett,8,0,32,24
1658096871984,MATH 142A,B04,093558,Chow; Bennett,14,0,32,18
1658096871984,MATH 142A,B05,093559,Chow; Bennett,7,0,32,25
1658096878012,MATH 193A,A01,083224,Rotar; Vladimir,9,0,34,25
1658096878012,MATH 193A,A02,083225,Rotar; Vladimir,11,0,34,23
1658096878012,MATH 193A,A03,083781,Rotar; Vladimir,5,0,34,29
1658096878012,MATH 193A,A04,083782,Rotar; Vladimir,12,0,34,22
1658096878012,MATH 193A,A05,093482,Rotar; Vladimir,11,0,34,23
1658096884035,MATH 197,001,091859,McAuley; Julian John,9999,0,9999,0
1658096884035,MATH 197,002,095566,Kedlaya; Kiran S.,9997,0,9999,2
1658096884035,MATH 197,003,095567,Xiao; Ming,9999,0,9999,0
1658096884035,MATH 197,004,095571,Perols; Johan Lars,9998,0,9999,1
1658096891085,COGS 9,A01,083615,Shannon; Kyle Michael,11,0,75,64
1658096897110,COGS 11,A01,083617,Boyle; Mary E. T.,23,0,48,25
1658096903136,COGS 13,A01,083071,Bastos; Amalia Pinkusfeld,12,0,71,59
1658096909160,COGS 14A,A01,092681,Semenuks; Arturs,5,1,100,95
1658096915186,COGS 14B,A01,083073,Cheng; Tzu-Han,7,0,63,56
1658096921209,COGS 17,A01,092677,Semenuks; Arturs,7,0,81,74
1658096927237,COGS 100,A01,083619,Allen; Michael Gordon,17,0,70,53
1658096933263,COGS 101A,A01,083621,Davis; Joshua Daniel,9,0,68,59
1658096939287,COGS 101B,A01,091572,Allen; Michael Gordon,14,0,65,51
1658096945315,COGS 101C,A01,083625,Delgado; Tania,17,0,35,18
1658096951338,COGS 107A,A01,083627,Boyle; Mary E. T.,14,0,60,46
1658096957365,COGS 118A,A01,083075,Gupta; Anjum,21,0,76,55
1658096963402,CSE 3,A50,083646,Miranda; Gregory Joseph,24,0,50,26
1658096969444,CSE 8A,A50,083650,Miranda; Gregory Joseph,17,1,56,39
1658096975470,CSE 11,A01,083080,Cao; Yingjun,7,15,40,33
1658096981496,CSE 12,A01,083652,Krause-Levy; Sophia Louisa,30,1,120,90
1658096987519,CSE 15L,A01,083654,Morris; Justin Loren,9,0,50,41
1658096987519,CSE 15L,A02,083655,Morris; Justin Loren,11,0,50,39
1658096993548,CSE 20,A01,083657,Tran; Khoa Dang,39,0,80,41
1658096999571,CSE 21,A01,095574,Bach; Quang Tran,23,0,48,25
1658097005597,CSE 30,A01,083084,Eldon; John,8,0,80,72
1658097005597,CSE 30,B01,095061,Bhaskar; Nishant,9,0,50,41
1658097011623,CSE 100,A01,083659,Cao; Yingjun,5,4,70,65
1658097017648,CSE 134B,A01,083661,Powell; Thomas Allan,25,0,100,75
1658097023670,CSE 140,A01,083663,Gungor; Onat,17,0,85,68
1658097029694,CSE 140L,A01,083088,Eldon; John,23,0,100,77
1658097035717,CSE 175,A01,083665,Kumar; Rakesh,3,0,25,22
1658097041746,CSE 190,A00,092507,Dubnov; Shlomo,8,0,20,12
1658097047772,ECE 45,A01,083139,Congero; Spencer William,7,0,75,68
1658097053798,ECE 65,A50,083695,Saad; Andrew S,12,0,30,18
1658097053798,ECE 65,A51,095125,Saad; Andrew S,24,0,26,2
1658097059847,ECE 109,A01,091882,Touri; Behrouz,21,0,70,49
1658097065874,ECE 180,A00,083140,Abi Samra; Nicholas Camill,1,0,30,29
1658097065874,ECE 180,B00,083141,Abi Samra; Nicholas Camill,0,0,30,30
1658097071899,MATH 10A,A01,083735,Patchell; Gregory David,2,0,30,28
1658097071899,MATH 10A,A02,083736,Patchell; Gregory David,20,0,30,10
1658097071899,MATH 10A,A03,083737,Patchell; Gregory David,16,0,30,14
1658097077927,MATH 10B,A01,083207,Lim; Seonhee,9,0,34,25
1658097077927,MATH 10B,A02,083208,Lim; Seonhee,10,0,35,25
1658097077927,MATH 10B,A03,093472,Lim; Seonhee,7,0,34,27
1658097077927,MATH 10B,B01,083739,Sinha; Shubham,14,0,30,16
1658097083952,MATH 18,A01,083743,Cinel; Cameron Alexander,9,0,30,21
1658097083952,MATH 18,A02,083744,Cinel; Cameron Alexander,18,0,30,12
1658097083952,MATH 18,A03,083745,Cinel; Cameron Alexander,10,0,30,20
1658097083952,MATH 18,B01,083748,Rideout; David Porter,5,0,37,32
1658097083952,MATH 18,B02,083749,Rideout; David Porter,5,0,36,31
1658097083952,MATH 18,B03,083750,Rideout; David Porter,3,0,37,34
1658097083952,MATH 18,B04,083751,Rideout; David Porter,7,0,36,29
1658097083952,MATH 18,B05,093473,Rideout; David Porter,7,0,36,29
1658097083952,MATH 18,B06,093474,Rideout; David Porter,6,0,36,30
1658097089976,MATH 20A,A01,083754,Zheng; Zequn,14,0,40,26
1658097096003,MATH 20B,A01,083756,Briones; Jor-el Thomas Caparas,4,0,36,32
1658097096003,MATH 20B,A02,083757,Briones; Jor-el Thomas Caparas,1,0,36,35
1658097096003,MATH 20B,A03,093475,Briones; Jor-el Thomas Caparas,3,0,36,33
1658097102027,MATH 20C,A01,083760,Briones; Jor-el Thomas Caparas,1,0,35,34
1658097102027,MATH 20C,A02,083761,Briones; Jor-el Thomas Caparas,8,0,35,27
1658097102027,MATH 20C,A03,093476,Briones; Jor-el Thomas Caparas,0,1,36,36
1658097102027,MATH 20C,B01,083762,Bach; Quang Tran,1,0,30,29
1658097108051,MATH 20D,A01,083765,Tran; Brian Kha,5,0,30,25
1658097108051,MATH 20D,A02,083766,Tran; Brian Kha,5,0,30,25
1658097108051,MATH 20D,A03,083767,Tran; Brian Kha,6,0,30,24
1658097114073,MATH 20E,A01,083771,Ganguly; Soumya,12,0,32,20
1658097114073,MATH 20E,A02,083772,Ganguly; Soumya,7,0,32,25
1658097114073,MATH 20E,B01,083773,Ciotti; Benjamin,20,0,35,15
1658097114073,MATH 20E,B02,083774,Ciotti; Benjamin,18,0,35,17
1658097120098,MATH 103A,A01,083777,Greenfeld; Be'Eri,6,0,36,30
1658097120098,MATH 103A,A02,083778,Greenfeld; Be'Eri,5,0,36,31
1658097120098,MATH 103A,A03,093561,Greenfeld; Be'Eri,7,0,36,29
1658097120098,MATH 103A,B01,083779,Greenfeld; Be'Eri,8,0,36,28
1658097120098,MATH 103A,B02,083780,Greenfeld; Be'Eri,4,0,36,32
1658097120098,MATH 103A,B03,093562,Greenfeld; Be'Eri,3,0,36,33
1658097126129,MATH 105,A01,085443,Carter; Anne Toulson,15,0,35,20
1658097126129,MATH 105,A02,093477,Carter; Anne Toulson,20,0,35,15
1658097132153,MATH 109,A01,083213,Ganzberger; Geoffrey Michael,3,0,34,31
1658097132153,MATH 109,A02,083214,Ganzberger; Geoffrey Michael,4,0,34,30
1658097132153,MATH 109,A03,093478,Ganzberger; Geoffrey Michael,2,0,34,32
1658097132153,MATH 109,B01,083215,Ganzberger; Geoffrey Michael,3,0,32,29
1658097132153,MATH 109,B02,083216,Ganzberger; Geoffrey Michael,3,0,32,29
1658097132153,MATH 109,B03,093479,Ganzberger; Geoffrey Michael,8,0,32,24
1658097138178,MATH 142A,A01,083219,Chow; Bennett,7,0,32,25
1658097138178,MATH 142A,A02,083220,Chow; Bennett,10,0,32,22
1658097138178,MATH 142A,A03,093480,Chow; Bennett,9,0,32,23
1658097138178,MATH 142A,B03,093481,Chow; Bennett,8,0,32,24
1658097138178,MATH 142A,B04,093558,Chow; Bennett,14,0,32,18
1658097138178,MATH 142A,B05,093559,Chow; Bennett,7,0,32,25
1658097144200,MATH 193A,A01,083224,Rotar; Vladimir,9,0,34,25
1658097144200,MATH 193A,A02,083225,Rotar; Vladimir,11,0,34,23
1658097144200,MATH 193A,A03,083781,Rotar; Vladimir,5,0,34,29
1658097144200,MATH 193A,A04,083782,Rotar; Vladimir,12,0,34,22
1658097144200,MATH 193A,A05,093482,Rotar; Vladimir,11,0,34,23
1658097150223,MATH 197,001,091859,McAuley; Julian John,9999,0,9999,0
1658097150223,MATH 197,002,095566,Kedlaya; Kiran S.,9997,0,9999,2
1658097150223,MATH 197,003,095567,Xiao; Ming,9999,0,9999,0
1658097150223,MATH 197,004,095571,Perols; Johan Lars,9998,0,9999,1
1658097157274,COGS 9,A01,083615,Shannon; Kyle Michael,11,0,75,64
1658097163301,COGS 11,A01,083617,Boyle; Mary E. T.,23,0,48,25
1658097169324,COGS 13,A01,083071,Bastos; Amalia Pinkusfeld,12,0,71,59
1658097175347,COGS 14A,A01,092681,Semenuks; Arturs,5,1,100,95
1658097181371,COGS 14B,A01,083073,Cheng; Tzu-Han,7,0,63,56
1658097187394,COGS 17,A01,092677,Semenuks; Arturs,7,0,81,74
1658097193421,COGS 100,A01,083619,Allen; Michael Gordon,17,0,70,53
1658097199448,COGS 101A,A01,083621,Davis; Joshua Daniel,9,0,68,59
1658097205473,COGS 101B,A01,091572,Allen; Michael Gordon,14,0,65,51
1658097211495,COGS 101C,A01,083625,Delgado; Tania,17,0,35,18
1658097217519,COGS 107A,A01,083627,Boyle; Mary E. T.,14,0,60,46
1658097223546,COGS 118A,A01,083075,Gupta; Anjum,21,0,76,55
1658097229573,CSE 3,A50,083646,Miranda; Gregory Joseph,24,0,50,26
1658097235668,CSE 8A,A50,083650,Miranda; Gregory Joseph,17,1,56,39
1658097241691,CSE 11,A01,083080,Cao; Yingjun,7,15,40,33
1658097247719,CSE 12,A01,083652,Krause-Levy; Sophia Louisa,30,1,120,90
1658097253741,CSE 15L,A01,083654,Morris; Justin Loren,9,0,50,41
1658097253741,CSE 15L,A02,083655,Morris; Justin Loren,11,0,50,39
1658097259765,CSE 20,A01,083657,Tran; Khoa Dang,39,0,80,41
1658097265790,CSE 21,A01,095574,Bach; Quang Tran,23,0,48,25
1658097271816,CSE 30,A01,083084,Eldon; John,8,0,80,72
1658097271816,CSE 30,B01,095061,Bhaskar; Nishant,9,0,50,41
1658097277838,CSE 100,A01,083659,Cao; Yingjun,5,4,70,65
1658097283860,CSE 134B,A01,083661,Powell; Thomas Allan,25,0,100,75
1658097289886,CSE 140,A01,083663,Gungor; Onat,17,0,85,68
1658097295912,CSE 140L,A01,083088,Eldon; John,23,0,100,77
1658097301937,CSE 175,A01,083665,Kumar; Rakesh,3,0,25,22
1658097307960,CSE 190,A00,092507,Dubnov; Shlomo,8,0,20,12
1658097313983,ECE 45,A01,083139,Congero; Spencer William,7,0,75,68
1658097320008,ECE 65,A50,083695,Saad; Andrew S,12,0,30,18
1658097320008,ECE 65,A51,095125,Saad; Andrew S,24,0,26,2
1658097326049,ECE 109,A01,091882,Touri; Behrouz,21,0,70,49
1658097332074,ECE 180,A00,083140,Abi Samra; Nicholas Camill,1,0,30,29
1658097332074,ECE 180,B00,083141,Abi Samra; Nicholas Camill,0,0,30,30
1658097338098,MATH 10A,A01,083735,Patchell; Gregory David,2,0,30,28
1658097338098,MATH 10A,A02,083736,Patchell; Gregory David,20,0,30,10
1658097338098,MATH 10A,A03,083737,Patchell; Gregory David,16,0,30,14
1658097344126,MATH 10B,A01,083207,Lim; Seonhee,9,0,34,25
1658097344126,MATH 10B,A02,083208,Lim; Seonhee,10,0,35,25
1658097344126,MATH 10B,A03,093472,Lim; Seonhee,7,0,34,27
1658097344126,MATH 10B,B01,083739,Sinha; Shubham,14,0,30,16
1658097350160,MATH 18,A01,083743,Cinel; Cameron Alexander,9,0,30,21
1658097350160,MATH 18,A02,083744,Cinel; Cameron Alexander,18,0,30,12
1658097350160,MATH 18,A03,083745,Cinel; Cameron Alexander,10,0,30,20
1658097350160,MATH 18,B01,083748,Rideout; David Porter,5,0,37,32
1658097350160,MATH 18,B02,083749,Rideout; David Porter,5,0,36,31
1658097350160,MATH 18,B03,083750,Rideout; David Porter,3,0,37,34
1658097350160,MATH 18,B04,083751,Rideout; David Porter,7,0,36,29
1658097350160,MATH 18,B05,093473,Rideout; David Porter,7,0,36,29
1658097350160,MATH 18,B06,093474,Rideout; David Porter,6,0,36,30
1658097356185,MATH 20A,A01,083754,Zheng; Zequn,14,0,40,26
1658097362208,MATH 20B,A01,083756,Briones; Jor-el Thomas Caparas,4,0,36,32
1658097362208,MATH 20B,A02,083757,Briones; Jor-el Thomas Caparas,1,0,36,35
1658097362208,MATH 20B,A03,093475,Briones; Jor-el Thomas Caparas,3,0,36,33
1658097368238,MATH 20C,A01,083760,Briones; Jor-el Thomas Caparas,1,0,35,34
1658097368238,MATH 20C,A02,083761,Briones; Jor-el Thomas Caparas,8,0,35,27
1658097368238,MATH 20C,A03,093476,Briones; Jor-el Thomas Caparas,0,1,36,36
1658097368238,MATH 20C,B01,083762,Bach; Quang Tran,1,0,30,29
1658097374265,MATH 20D,A01,083765,Tran; Brian Kha,5,0,30,25
1658097374265,MATH 20D,A02,083766,Tran; Brian Kha,5,0,30,25
1658097374265,MATH 20D,A03,083767,Tran; Brian Kha,6,0,30,24
1658097380293,MATH 20E,A01,083771,Ganguly; Soumya,12,0,32,20
1658097380293,MATH 20E,A02,083772,Ganguly; Soumya,7,0,32,25
1658097380293,MATH 20E,B01,083773,Ciotti; Benjamin,20,0,35,15
1658097380293,MATH 20E,B02,083774,Ciotti; Benjamin,18,0,35,17
1658097386317,MATH 103A,A01,083777,Greenfeld; Be'Eri,6,0,36,30
1658097386317,MATH 103A,A02,083778,Greenfeld; Be'Eri,5,0,36,31
1658097386317,MATH 103A,A03,093561,Greenfeld; Be'Eri,7,0,36,29
1658097386317,MATH 103A,B01,083779,Greenfeld; Be'Eri,8,0,36,28
1658097386317,MATH 103A,B02,083780,Greenfeld; Be'Eri,4,0,36,32
1658097386317,MATH 103A,B03,093562,Greenfeld; Be'Eri,3,0,36,33
1658097392340,MATH 105,A01,085443,Carter; Anne Toulson,15,0,35,20
1658097392340,MATH 105,A02,093477,Carter; Anne Toulson,20,0,35,15
1658097398364,MATH 109,A01,083213,Ganzberger; Geoffrey Michael,3,0,34,31
1658097398364,MATH 109,A02,083214,Ganzberger; Geoffrey Michael,4,0,34,30
1658097398364,MATH 109,A03,093478,Ganzberger; Geoffrey Michael,2,0,34,32
1658097398364,MATH 109,B01,083215,Ganzberger; Geoffrey Michael,3,0,32,29
1658097398364,MATH 109,B02,083216,Ganzberger; Geoffrey Michael,3,0,32,29
1658097398364,MATH 109,B03,093479,Ganzberger; Geoffrey Michael,8,0,32,24
1658097404394,MATH 142A,A01,083219,Chow; Bennett,7,0,32,25
1658097404394,MATH 142A,A02,083220,Chow; Bennett,10,0,32,22
1658097404394,MATH 142A,A03,093480,Chow; Bennett,9,0,32,23
1658097404394,MATH 142A,B03,093481,Chow; Bennett,8,0,32,24
1658097404394,MATH 142A,B04,093558,Chow; Bennett,14,0,32,18
1658097404394,MATH 142A,B05,093559,Chow; Bennett,7,0,32,25
1658097410418,MATH 193A,A01,083224,Rotar; Vladimir,9,0,34,25
1658097410418,MATH 193A,A02,083225,Rotar; Vladimir,11,0,34,23
1658097410418,MATH 193A,A03,083781,Rotar; Vladimir,5,0,34,29
1658097410418,MATH 193A,A04,083782,Rotar; Vladimir,12,0,34,22
1658097410418,MATH 193A,A05,093482,Rotar; Vladimir,11,0,34,23
1658097416446,MATH 197,001,091859,McAuley; Julian John,9999,0,9999,0
1658097416446,MATH 197,002,095566,Kedlaya; Kiran S.,9997,0,9999,2
1658097416446,MATH 197,003,095567,Xiao; Ming,9999,0,9999,0
1658097416446,MATH 197,004,095571,Perols; Johan Lars,9998,0,9999,1
1658097423500,COGS 9,A01,083615,Shannon; Kyle Michael,11,0,75,64
1658097429528,COGS 11,A01,083617,Boyle; Mary E. T.,23,0,48,25
1658097435563,COGS 13,A01,083071,Bastos; Amalia Pinkusfeld,12,0,71,59
1658097441586,COGS 14A,A01,092681,Semenuks; Arturs,5,1,100,95
1658097447609,COGS 14B,A01,083073,Cheng; Tzu-Han,7,0,63,56
1658097453633,COGS 17,A01,092677,Semenuks; Arturs,7,0,81,74
1658097459656,COGS 100,A01,083619,Allen; Michael Gordon,17,0,70,53
1658097465682,COGS 101A,A01,083621,Davis; Joshua Daniel,9,0,68,59
1658097471705,COGS 101B,A01,091572,Allen; Michael Gordon,14,0,65,51
1658097477728,COGS 101C,A01,083625,Delgado; Tania,17,0,35,18
1658097483753,COGS 107A,A01,083627,Boyle; Mary E. T.,14,0,60,46
1658097489788,COGS 118A,A01,083075,Gupta; Anjum,21,0,76,55
1658097495812,CSE 3,A50,083646,Miranda; Gregory Joseph,24,0,50,26
1658097501838,CSE 8A,A50,083650,Miranda; Gregory Joseph,17,1,56,39
1658097507863,CSE 11,A01,083080,Cao; Yingjun,7,15,40,33
1658097513887,CSE 12,A01,083652,Krause-Levy; Sophia Louisa,30,1,120,90
1658097519916,CSE 15L,A01,083654,Morris; Justin Loren,9,0,50,41
1658097519916,CSE 15L,A02,083655,Morris; Justin Loren,11,0,50,39
1658097525943,CSE 20,A01,083657,Tran; Khoa Dang,39,0,80,41
1658097531972,CSE 21,A01,095574,Bach; Quang Tran,23,0,48,25
1658097538000,CSE 30,A01,083084,Eldon; John,8,0,80,72
1658097538000,CSE 30,B01,095061,Bhaskar; Nishant,9,0,50,41
1658097544024,CSE 100,A01,083659,Cao; Yingjun,5,4,70,65
1658097550048,CSE 134B,A01,083661,Powell; Thomas Allan,25,0,100,75
1658097556072,CSE 140,A01,083663,Gungor; Onat,17,0,85,68
1658097562099,CSE 140L,A01,083088,Eldon; John,23,0,100,77
1658097568122,CSE 175,A01,083665,Kumar; Rakesh,3,0,25,22
1658097574145,CSE 190,A00,092507,Dubnov; Shlomo,8,0,20,12
1658097580168,ECE 45,A01,083139,Congero; Spencer William,7,0,75,68
1658097586192,ECE 65,A50,083695,Saad; Andrew S,12,0,30,18
1658097586192,ECE 65,A51,095125,Saad; Andrew S,24,0,26,2
1658097592218,ECE 109,A01,091882,Touri; Behrouz,21,0,70,49
1658097598241,ECE 180,A00,083140,Abi Samra; Nicholas Camill,1,0,30,29
1658097598241,ECE 180,B00,083141,Abi Samra; Nicholas Camill,0,0,30,30
1658097604269,MATH 10A,A01,083735,Patchell; Gregory David,2,0,30,28
1658097604269,MATH 10A,A02,083736,Patchell; Gregory David,20,0,30,10
1658097604269,MATH 10A,A03,083737,Patchell; Gregory David,16,0,30,14
1658097610294,MATH 10B,A01,083207,Lim; Seonhee,9,0,34,25
1658097610294,MATH 10B,A02,083208,Lim; Seonhee,10,0,35,25
1658097610294,MATH 10B,A03,093472,Lim; Seonhee,7,0,34,27
1658097610294,MATH 10B,B01,083739,Sinha; Shubham,14,0,30,16
1658097616320,MATH 18,A01,083743,Cinel; Cameron Alexander,9,0,30,21
1658097616320,MATH 18,A02,083744,Cinel; Cameron Alexander,18,0,30,12
1658097616320,MATH 18,A03,083745,Cinel; Cameron Alexander,10,0,30,20
1658097616320,MATH 18,B01,083748,Rideout; David Porter,5,0,37,32
1658097616320,MATH 18,B02,083749,Rideout; David Porter,5,0,36,31
1658097616320,MATH 18,B03,083750,Rideout; David Porter,3,0,37,34
1658097616320,MATH 18,B04,083751,Rideout; David Porter,7,0,36,29
1658097616320,MATH 18,B05,093473,Rideout; David Porter,7,0,36,29
1658097616320,MATH 18,B06,093474,Rideout; David Porter,6,0,36,30
1658097622342,MATH 20A,A01,083754,Zheng; Zequn,14,0,40,26
1658097628369,MATH 20B,A01,083756,Briones; Jor-el Thomas Caparas,4,0,36,32
1658097628369,MATH 20B,A02,083757,Briones; Jor-el Thomas Caparas,1,0,36,35
1658097628369,MATH 20B,A03,093475,Briones; Jor-el Thomas Caparas,3,0,36,33
1658097634394,MATH 20C,A01,083760,Briones; Jor-el Thomas Caparas,1,0,35,34
1658097634394,MATH 20C,A02,083761,Briones; Jor-el Thomas Caparas,8,0,35,27
1658097634394,MATH 20C,A03,093476,Briones; Jor-el Thomas Caparas,0,1,36,36
1658097634394,MATH 20C,B01,083762,Bach; Quang Tran,1,0,30,29
1658097640420,MATH 20D,A01,083765,Tran; Brian Kha,5,0,30,25
1658097640420,MATH 20D,A02,083766,Tran; Brian Kha,5,0,30,25
1658097640420,MATH 20D,A03,083767,Tran; Brian Kha,6,0,30,24
1658097646448,MATH 20E,A01,083771,Ganguly; Soumya,12,0,32,20
1658097646448,MATH 20E,A02,083772,Ganguly; Soumya,7,0,32,25
1658097646448,MATH 20E,B01,083773,Ciotti; Benjamin,20,0,35,15
1658097646448,MATH 20E,B02,083774,Ciotti; Benjamin,18,0,35,17
1658097652478,MATH 103A,A01,083777,Greenfeld; Be'Eri,6,0,36,30
1658097652478,MATH 103A,A02,083778,Greenfeld; Be'Eri,5,0,36,31
1658097652478,MATH 103A,A03,093561,Greenfeld; Be'Eri,7,0,36,29
1658097652478,MATH 103A,B01,083779,Greenfeld; Be'Eri,8,0,36,28
1658097652478,MATH 103A,B02,083780,Greenfeld; Be'Eri,4,0,36,32
1658097652478,MATH 103A,B03,093562,Greenfeld; Be'Eri,3,0,36,33
1658097658503,MATH 105,A01,085443,Carter; Anne Toulson,15,0,35,20
1658097658503,MATH 105,A02,093477,Carter; Anne Toulson,20,0,35,15
1658097664532,MATH 109,A01,083213,Ganzberger; Geoffrey Michael,3,0,34,31
1658097664532,MATH 109,A02,083214,Ganzberger; Geoffrey Michael,4,0,34,30
1658097664532,MATH 109,A03,093478,Ganzberger; Geoffrey Michael,2,0,34,32
1658097664532,MATH 109,B01,083215,Ganzberger; Geoffrey Michael,3,0,32,29
1658097664532,MATH 109,B02,083216,Ganzberger; Geoffrey Michael,3,0,32,29
1658097664532,MATH 109,B03,093479,Ganzberger; Geoffrey Michael,8,0,32,24
1658097670565,MATH 142A,A01,083219,Chow; Bennett,7,0,32,25
1658097670565,MATH 142A,A02,083220,Chow; Bennett,10,0,32,22
1658097670565,MATH 142A,A03,093480,Chow; Bennett,9,0,32,23
1658097670565,MATH 142A,B03,093481,Chow; Bennett,8,0,32,24
1658097670565,MATH 142A,B04,093558,Chow; Bennett,14,0,32,18
1658097670565,MATH 142A,B05,093559,Chow; Bennett,7,0,32,25
1658097676590,MATH 193A,A01,083224,Rotar; Vladimir,9,0,34,25
1658097676590,MATH 193A,A02,083225,Rotar; Vladimir,11,0,34,23
1658097676590,MATH 193A,A03,083781,Rotar; Vladimir,5,0,34,29
1658097676590,MATH 193A,A04,083782,Rotar; Vladimir,12,0,34,22
1658097676590,MATH 193A,A05,093482,Rotar; Vladimir,11,0,34,23
1658097682613,MATH 197,001,091859,McAuley; Julian John,9999,0,9999,0
1658097682613,MATH 197,002,095566,Kedlaya; Kiran S.,9997,0,9999,2
1658097682613,MATH 197,003,095567,Xiao; Ming,9999,0,9999,0
1658097682613,MATH 197,004,095571,Perols; Johan Lars,9998,0,9999,1
1658097689679,COGS 9,A01,083615,Shannon; Kyle Michael,11,0,75,64
1658097695702,COGS 11,A01,083617,Boyle; Mary E. T.,23,0,48,25
1658097701726,COGS 13,A01,083071,Bastos; Amalia Pinkusfeld,12,0,71,59
1658097707749,COGS 14A,A01,092681,Semenuks; Arturs,5,1,100,95
1658097713776,COGS 14B,A01,083073,Cheng; Tzu-Han,7,0,63,56
1658097719798,COGS 17,A01,092677,Semenuks; Arturs,7,0,81,74
1658097725822,COGS 100,A01,083619,Allen; Michael Gordon,17,0,70,53
1658097731850,COGS 101A,A01,083621,Davis; Joshua Daniel,9,0,68,59
1658097737877,COGS 101B,A01,091572,Allen; Michael Gordon,14,0,65,51
1658097743903,COGS 101C,A01,083625,Delgado; Tania,17,0,35,18
1658097749925,COGS 107A,A01,083627,Boyle; Mary E. T.,14,0,60,46
1658097755948,COGS 118A,A01,083075,Gupta; Anjum,21,0,76,55
1658097761975,CSE 3,A50,083646,Miranda; Gregory Joseph,24,0,50,26
1658097767998,CSE 8A,A50,083650,Miranda; Gregory Joseph,17,1,56,39
1658097774021,CSE 11,A01,083080,Cao; Yingjun,7,15,40,33
1658097780047,CSE 12,A01,083652,Krause-Levy; Sophia Louisa,30,1,120,90
1658097786074,CSE 15L,A01,083654,Morris; Justin Loren,9,0,50,41
1658097786074,CSE 15L,A02,083655,Morris; Justin Loren,11,0,50,39
1658097792102,CSE 20,A01,083657,Tran; Khoa Dang,39,0,80,41
1658097798133,CSE 21,A01,095574,Bach; Quang Tran,23,0,48,25
1658097804156,CSE 30,A01,083084,Eldon; John,8,0,80,72
1658097804156,CSE 30,B01,095061,Bhaskar; Nishant,9,0,50,41
1658097810183,CSE 100,A01,083659,Cao; Yingjun,5,4,70,65
1658097816208,CSE 134B,A01,083661,Powell; Thomas Allan,25,0,100,75
1658097822231,CSE 140,A01,083663,Gungor; Onat,17,0,85,68
1658097828264,CSE 140L,A01,083088,Eldon; John,23,0,100,77
1658097834378,CSE 175,A01,083665,Kumar; Rakesh,3,0,25,22
1658097840401,CSE 190,A00,092507,Dubnov; Shlomo,8,0,20,12
1658097846436,ECE 45,A01,083139,Congero; Spencer William,7,0,75,68
1658097852465,ECE 65,A50,083695,Saad; Andrew S,12,0,30,18
1658097852465,ECE 65,A51,095125,Saad; Andrew S,24,0,26,2
1658097858492,ECE 109,A01,091882,Touri; Behrouz,21,0,70,49
1658097864518,ECE 180,A00,083140,Abi Samra; Nicholas Camill,1,0,30,29
1658097864518,ECE 180,B00,083141,Abi Samra; Nicholas Camill,0,0,30,30
1658097870544,MATH 10A,A01,083735,Patchell; Gregory David,2,0,30,28
1658097870544,MATH 10A,A02,083736,Patchell; Gregory David,20,0,30,10
1658097870544,MATH 10A,A03,083737,Patchell; Gregory David,16,0,30,14
1658097876568,MATH 10B,A01,083207,Lim; Seonhee,9,0,34,25
1658097876568,MATH 10B,A02,083208,Lim; Seonhee,10,0,35,25
1658097876568,MATH 10B,A03,093472,Lim; Seonhee,7,0,34,27
1658097876568,MATH 10B,B01,083739,Sinha; Shubham,14,0,30,16
1658097882593,MATH 18,A01,083743,Cinel; Cameron Alexander,9,0,30,21
1658097882593,MATH 18,A02,083744,Cinel; Cameron Alexander,18,0,30,12
1658097882593,MATH 18,A03,083745,Cinel; Cameron Alexander,10,0,30,20
1658097882593,MATH 18,B01,083748,Rideout; David Porter,5,0,37,32
1658097882593,MATH 18,B02,083749,Rideout; David Porter,5,0,36,31
1658097882593,MATH 18,B03,083750,Rideout; David Porter,3,0,37,34
1658097882593,MATH 18,B04,083751,Rideout; David Porter,7,0,36,29
1658097882593,MATH 18,B05,093473,Rideout; David Porter,7,0,36,29
1658097882593,MATH 18,B06,093474,Rideout; David Porter,6,0,36,30
1658097888618,MATH 20A,A01,083754,Zheng; Zequn,14,0,40,26
1658097894642,MATH 20B,A01,083756,Briones; Jor-el Thomas Caparas,4,0,36,32
1658097894642,MATH 20B,A02,083757,Briones; Jor-el Thomas Caparas,1,0,36,35
1658097894642,MATH 20B,A03,093475,Briones; Jor-el Thomas Caparas,3,0,36,33
1658097900677,MATH 20C,A01,083760,Briones; Jor-el Thomas Caparas,1,0,35,34
1658097900677,MATH 20C,A02,083761,Briones; Jor-el Thomas Caparas,8,0,35,27
1658097900677,MATH 20C,A03,093476,Briones; Jor-el Thomas Caparas,0,1,36,36
1658097900677,MATH 20C,B01,083762,Bach; Quang Tran,1,0,30,29
1658097906700,MATH 20D,A01,083765,Tran; Brian Kha,5,0,30,25
1658097906700,MATH 20D,A02,083766,Tran; Brian Kha,5,0,30,25
1658097906700,MATH 20D,A03,083767,Tran; Brian Kha,6,0,30,24
1658097912729,MATH 20E,A01,083771,Ganguly; Soumya,12,0,32,20
1658097912729,MATH 20E,A02,083772,Ganguly; Soumya,7,0,32,25
1658097912729,MATH 20E,B01,083773,Ciotti; Benjamin,20,0,35,15
1658097912729,MATH 20E,B02,083774,Ciotti; Benjamin,18,0,35,17
1658097918753,MATH 103A,A01,083777,Greenfeld; Be'Eri,6,0,36,30
1658097918753,MATH 103A,A02,083778,Greenfeld; Be'Eri,5,0,36,31
1658097918753,MATH 103A,A03,093561,Greenfeld; Be'Eri,7,0,36,29
1658097918753,MATH 103A,B01,083779,Greenfeld; Be'Eri,8,0,36,28
1658097918753,MATH 103A,B02,083780,Greenfeld; Be'Eri,4,0,36,32
1658097918753,MATH 103A,B03,093562,Greenfeld; Be'Eri,3,0,36,33
1658097924778,MATH 105,A01,085443,Carter; Anne Toulson,15,0,35,20
1658097924778,MATH 105,A02,093477,Carter; Anne Toulson,20,0,35,15
1658097930804,MATH 109,A01,083213,Ganzberger; Geoffrey Michael,3,0,34,31
1658097930804,MATH 109,A02,083214,Ganzberger; Geoffrey Michael,4,0,34,30
1658097930804,MATH 109,A03,093478,Ganzberger; Geoffrey Michael,2,0,34,32
1658097930804,MATH 109,B01,083215,Ganzberger; Geoffrey Michael,3,0,32,29
1658097930804,MATH 109,B02,083216,Ganzberger; Geoffrey Michael,3,0,32,29
1658097930804,MATH 109,B03,093479,Ganzberger; Geoffrey Michael,8,0,32,24
1658097936828,MATH 142A,A01,083219,Chow; Bennett,7,0,32,25
1658097936828,MATH 142A,A02,083220,Chow; Bennett,10,0,32,22
1658097936828,MATH 142A,A03,093480,Chow; Bennett,9,0,32,23
1658097936828,MATH 142A,B03,093481,Chow; Bennett,8,0,32,24
1658097936828,MATH 142A,B04,093558,Chow; Bennett,14,0,32,18
1658097936828,MATH 142A,B05,093559,Chow; Bennett,7,0,32,25
1658097942851,MATH 193A,A01,083224,Rotar; Vladimir,9,0,34,25
1658097942851,MATH 193A,A02,083225,Rotar; Vladimir,11,0,34,23
1658097942851,MATH 193A,A03,083781,Rotar; Vladimir,5,0,34,29
1658097942851,MATH 193A,A04,083782,Rotar; Vladimir,12,0,34,22
1658097942851,MATH 193A,A05,093482,Rotar; Vladimir,11,0,34,23
1658097948876,MATH 197,001,091859,McAuley; Julian John,9999,0,9999,0
1658097948876,MATH 197,002,095566,Kedlaya; Kiran S.,9997,0,9999,2
1658097948876,MATH 197,003,095567,Xiao; Ming,9999,0,9999,0
1658097948876,MATH 197,004,095571,Perols; Johan Lars,9998,0,9999,1
1658097955939,COGS 9,A01,083615,Shannon; Kyle Michael,11,0,75,64
1658097961963,COGS 11,A01,083617,Boyle; Mary E. T.,23,0,48,25
1658097967989,COGS 13,A01,083071,Bastos; Amalia Pinkusfeld,12,0,71,59
1658097974015,COGS 14A,A01,092681,Semenuks; Arturs,5,1,100,95
1658097980039,COGS 14B,A01,083073,Cheng; Tzu-Han,7,0,63,56
1658097986066,COGS 17,A01,092677,Semenuks; Arturs,7,0,81,74
1658097992099,COGS 100,A01,083619,Allen; Michael Gordon,17,0,70,53
1658097998126,COGS 101A,A01,083621,Davis; Joshua Daniel,9,0,68,59
1658098004154,COGS 101B,A01,091572,Allen; Michael Gordon,14,0,65,51
1658098010176,COGS 101C,A01,083625,Delgado; Tania,17,0,35,18
1658098016203,COGS 107A,A01,083627,Boyle; Mary E. T.,14,0,60,46
1658098022225,COGS 118A,A01,083075,Gupta; Anjum,21,0,76,55
1658098028251,CSE 3,A50,083646,Miranda; Gregory Joseph,24,0,50,26
1658098034275,CSE 8A,A50,083650,Miranda; Gregory Joseph,17,1,56,39
1658098040299,CSE 11,A01,083080,Cao; Yingjun,7,15,40,33
1658098046324,CSE 12,A01,083652,Krause-Levy; Sophia Louisa,30,1,120,90
1658098052346,CSE 15L,A01,083654,Morris; Justin Loren,9,0,50,41
1658098052346,CSE 15L,A02,083655,Morris; Justin Loren,11,0,50,39
1658098058369,CSE 20,A01,083657,Tran; Khoa Dang,39,0,80,41
1658098064396,CSE 21,A01,095574,Bach; Quang Tran,23,0,48,25
1658098070421,CSE 30,A01,083084,Eldon; John,8,0,80,72
1658098070421,CSE 30,B01,095061,Bhaskar; Nishant,9,0,50,41
1658098076451,CSE 100,A01,083659,Cao; Yingjun,5,4,70,65
1658098082484,CSE 134B,A01,083661,Powell; Thomas Allan,25,0,100,75
1658098088510,CSE 140,A01,083663,Gungor; Onat,17,0,85,68
1658098094534,CSE 140L,A01,083088,Eldon; John,23,0,100,77
1658098100556,CSE 175,A01,083665,Kumar; Rakesh,3,0,25,22
1658098106581,CSE 190,A00,092507,Dubnov; Shlomo,8,0,20,12
1658098112605,ECE 45,A01,083139,Congero; Spencer William,7,0,75,68
1658098118629,ECE 65,A50,083695,Saad; Andrew S,12,0,30,18
1658098118629,ECE 65,A51,095125,Saad; Andrew S,24,0,26,2
1658098124652,ECE 109,A01,091882,Touri; Behrouz,21,0,70,49
1658098130678,ECE 180,A00,083140,Abi Samra; Nicholas Camill,1,0,30,29
1658098130678,ECE 180,B00,083141,Abi Samra; Nicholas Camill,0,0,30,30
1658098136707,MATH 10A,A01,083735,Patchell; Gregory David,2,0,30,28
1658098136707,MATH 10A,A02,083736,Patchell; Gregory David,20,0,30,10
1658098136707,MATH 10A,A03,083737,Patchell; Gregory David,16,0,30,14
1658098142731,MATH 10B,A01,083207,Lim; Seonhee,9,0,34,25
1658098142731,MATH 10B,A02,083208,Lim; Seonhee,10,0,35,25
1658098142731,MATH 10B,A03,093472,Lim; Seonhee,7,0,34,27
1658098142731,MATH 10B,B01,083739,Sinha; Shubham,14,0,30,16
1658098148757,MATH 18,A01,083743,Cinel; Cameron Alexander,9,0,30,21
1658098148757,MATH 18,A02,083744,Cinel; Cameron Alexander,18,0,30,12
1658098148757,MATH 18,A03,083745,Cinel; Cameron Alexander,10,0,30,20
1658098148757,MATH 18,B01,083748,Rideout; David Porter,5,0,37,32
1658098148757,MATH 18,B02,083749,Rideout; David Porter,5,0,36,31
1658098148757,MATH 18,B03,083750,Rideout; David Porter,3,0,37,34
1658098148757,MATH 18,B04,083751,Rideout; David Porter,7,0,36,29
1658098148757,MATH 18,B05,093473,Rideout; David Porter,7,0,36,29
1658098148757,MATH 18,B06,093474,Rideout; David Porter,6,0,36,30
1658098154780,MATH 20A,A01,083754,Zheng; Zequn,14,0,40,26
1658098160808,MATH 20B,A01,083756,Briones; Jor-el Thomas Caparas,4,0,36,32
1658098160808,MATH 20B,A02,083757,Briones; Jor-el Thomas Caparas,1,0,36,35
1658098160808,MATH 20B,A03,093475,Briones; Jor-el Thomas Caparas,3,0,36,33
1658098166831,MATH 20C,A01,083760,Briones; Jor-el Thomas Caparas,1,0,35,34
1658098166831,MATH 20C,A02,083761,Briones; Jor-el Thomas Caparas,8,0,35,27
1658098166831,MATH 20C,A03,093476,Briones; Jor-el Thomas Caparas,0,1,36,36
1658098166831,MATH 20C,B01,083762,Bach; Quang Tran,1,0,30,29
1658098172854,MATH 20D,A01,083765,Tran; Brian Kha,5,0,30,25
1658098172854,MATH 20D,A02,083766,Tran; Brian Kha,5,0,30,25
1658098172854,MATH 20D,A03,083767,Tran; Brian Kha,6,0,30,24
1658098178877,MATH 20E,A01,083771,Ganguly; Soumya,12,0,32,20
1658098178877,MATH 20E,A02,083772,Ganguly; Soumya,7,0,32,25
1658098178877,MATH 20E,B01,083773,Ciotti; Benjamin,20,0,35,15
1658098178877,MATH 20E,B02,083774,Ciotti; Benjamin,18,0,35,17
1658098184908,MATH 103A,A01,083777,Greenfeld; Be'Eri,6,0,36,30
1658098184908,MATH 103A,A02,083778,Greenfeld; Be'Eri,5,0,36,31
1658098184908,MATH 103A,A03,093561,Greenfeld; Be'Eri,7,0,36,29
1658098184908,MATH 103A,B01,083779,Greenfeld; Be'Eri,8,0,36,28
1658098184908,MATH 103A,B02,083780,Greenfeld; Be'Eri,4,0,36,32
1658098184908,MATH 103A,B03,093562,Greenfeld; Be'Eri,3,0,36,33
1658098190931,MATH 105,A01,085443,Carter; Anne Toulson,15,0,35,20
1658098190931,MATH 105,A02,093477,Carter; Anne Toulson,20,0,35,15
1658098196957,MATH 109,A01,083213,Ganzberger; Geoffrey Michael,3,0,34,31
1658098196957,MATH 109,A02,083214,Ganzberger; Geoffrey Michael,4,0,34,30
1658098196957,MATH 109,A03,093478,Ganzberger; Geoffrey Michael,2,0,34,32
1658098196957,MATH 109,B01,083215,Ganzberger; Geoffrey Michael,3,0,32,29
1658098196957,MATH 109,B02,083216,Ganzberger; Geoffrey Michael,3,0,32,29
1658098196957,MATH 109,B03,093479,Ganzberger; Geoffrey Michael,8,0,32,24
1658098202982,MATH 142A,A01,083219,Chow; Bennett,7,0,32,25
1658098202982,MATH 142A,A02,083220,Chow; Bennett,10,0,32,22
1658098202982,MATH 142A,A03,093480,Chow; Bennett,9,0,32,23
1658098202982,MATH 142A,B03,093481,Chow; Bennett,8,0,32,24
1658098202982,MATH 142A,B04,093558,Chow; Bennett,14,0,32,18
1658098202982,MATH 142A,B05,093559,Chow; Bennett,7,0,32,25
1658098209010,MATH 193A,A01,083224,Rotar; Vladimir,9,0,34,25
1658098209010,MATH 193A,A02,083225,Rotar; Vladimir,11,0,34,23
1658098209010,MATH 193A,A03,083781,Rotar; Vladimir,5,0,34,29
1658098209010,MATH 193A,A04,083782,Rotar; Vladimir,12,0,34,22
1658098209010,MATH 193A,A05,093482,Rotar; Vladimir,11,0,34,23
1658098215036,MATH 197,001,091859,McAuley; Julian John,9999,0,9999,0
1658098215036,MATH 197,002,095566,Kedlaya; Kiran S.,9997,0,9999,2
1658098215036,MATH 197,003,095567,Xiao; Ming,9999,0,9999,0
1658098215036,MATH 197,004,095571,Perols; Johan Lars,9998,0,9999,1
1658098222089,COGS 9,A01,083615,Shannon; Kyle Michael,11,0,75,64
1658098228112,COGS 11,A01,083617,Boyle; Mary E. T.,23,0,48,25
1658098234135,COGS 13,A01,083071,Bastos; Amalia Pinkusfeld,12,0,71,59
1658098240172,COGS 14A,A01,092681,Semenuks; Arturs,5,1,100,95
1658098246203,COGS 14B,A01,083073,Cheng; Tzu-Han,7,0,63,56
1658098252229,COGS 17,A01,092677,Semenuks; Arturs,7,0,81,74
1658098258253,COGS 100,A01,083619,Allen; Michael Gordon,17,0,70,53
1658098264282,COGS 101A,A01,083621,Davis; Joshua Daniel,9,0,68,59
1658098270305,COGS 101B,A01,091572,Allen; Michael Gordon,14,0,65,51
1658098276327,COGS 101C,A01,083625,Delgado; Tania,17,0,35,18
1658098282355,COGS 107A,A01,083627,Boyle; Mary E. T.,14,0,60,46
1658098288377,COGS 118A,A01,083075,Gupta; Anjum,21,0,76,55
1658098294399,CSE 3,A50,083646,Miranda; Gregory Joseph,24,0,50,26
1658098300426,CSE 8A,A50,083650,Miranda; Gregory Joseph,17,1,56,39
1658098306449,CSE 11,A01,083080,Cao; Yingjun,7,15,40,33
1658098312472,CSE 12,A01,083652,Krause-Levy; Sophia Louisa,30,1,120,90
1658098318496,CSE 15L,A01,083654,Morris; Justin Loren,9,0,50,41
1658098318496,CSE 15L,A02,083655,Morris; Justin Loren,11,0,50,39
1658098324527,CSE 20,A01,083657,Tran; Khoa Dang,39,0,80,41
1658098330553,CSE 21,A01,095574,Bach; Quang Tran,23,0,48,25
1658098336589,CSE 30,A01,083084,Eldon; John,8,0,80,72
1658098336589,CSE 30,B01,095061,Bhaskar; Nishant,9,0,50,41
1658098342613,CSE 100,A01,083659,Cao; Yingjun,5,4,70,65
1658098348645,CSE 134B,A01,083661,Powell; Thomas Allan,25,0,100,75
1658098354671,CSE 140,A01,083663,Gungor; Onat,17,0,85,68
1658098360696,CSE 140L,A01,083088,Eldon; John,23,0,100,77
1658098366722,CSE 175,A01,083665,Kumar; Rakesh,3,0,25,22
1658098372751,CSE 190,A00,092507,Dubnov; Shlomo,8,0,20,12
1658098378784,ECE 45,A01,083139,Congero; Spencer William,7,0,75,68
1658098384807,ECE 65,A50,083695,Saad; Andrew S,12,0,30,18
1658098384807,ECE 65,A51,095125,Saad; Andrew S,24,0,26,2
1658098390831,ECE 109,A01,091882,Touri; Behrouz,21,0,70,49
1658098396854,ECE 180,A00,083140,Abi Samra; Nicholas Camill,1,0,30,29
1658098396854,ECE 180,B00,083141,Abi Samra; Nicholas Camill,0,0,30,30
1658098402877,MATH 10A,A01,083735,Patchell; Gregory David,2,0,30,28
1658098402877,MATH 10A,A02,083736,Patchell; Gregory David,20,0,30,10
1658098402877,MATH 10A,A03,083737,Patchell; Gregory David,16,0,30,14
1658098408902,MATH 10B,A01,083207,Lim; Seonhee,9,0,34,25
1658098408902,MATH 10B,A02,083208,Lim; Seonhee,10,0,35,25
1658098408902,MATH 10B,A03,093472,Lim; Seonhee,7,0,34,27
1658098408902,MATH 10B,B01,083739,Sinha; Shubham,14,0,30,16
1658098414926,MATH 18,A01,083743,Cinel; Cameron Alexander,9,0,30,21
1658098414926,MATH 18,A02,083744,Cinel; Cameron Alexander,18,0,30,12
1658098414926,MATH 18,A03,083745,Cinel; Cameron Alexander,10,0,30,20
1658098414926,MATH 18,B01,083748,Rideout; David Porter,5,0,37,32
1658098414926,MATH 18,B02,083749,Rideout; David Porter,5,0,36,31
1658098414926,MATH 18,B03,083750,Rideout; David Porter,3,0,37,34
1658098414926,MATH 18,B04,083751,Rideout; David Porter,7,0,36,29
1658098414926,MATH 18,B05,093473,Rideout; David Porter,7,0,36,29
1658098414926,MATH 18,B06,093474,Rideout; David Porter,6,0,36,30
1658098420948,MATH 20A,A01,083754,Zheng; Zequn,14,0,40,26
1658098426972,MATH 20B,A01,083756,Briones; Jor-el Thomas Caparas,4,0,36,32
1658098426972,MATH 20B,A02,083757,Briones; Jor-el Thomas Caparas,1,0,36,35
1658098426972,MATH 20B,A03,093475,Briones; Jor-el Thomas Caparas,3,0,36,33
1658098433093,MATH 20C,A01,083760,Briones; Jor-el Thomas Caparas,1,0,35,34
1658098433093,MATH 20C,A02,083761,Briones; Jor-el Thomas Caparas,8,0,35,27
1658098433093,MATH 20C,A03,093476,Briones; Jor-el Thomas Caparas,0,1,36,36
1658098433093,MATH 20C,B01,083762,Bach; Quang Tran,1,0,30,29
1658098439123,MATH 20D,A01,083765,Tran; Brian Kha,5,0,30,25
1658098439123,MATH 20D,A02,083766,Tran; Brian Kha,5,0,30,25
1658098439123,MATH 20D,A03,083767,Tran; Brian Kha,6,0,30,24
1658098445153,MATH 20E,A01,083771,Ganguly; Soumya,12,0,32,20
1658098445153,MATH 20E,A02,083772,Ganguly; Soumya,7,0,32,25
1658098445153,MATH 20E,B01,083773,Ciotti; Benjamin,20,0,35,15
1658098445153,MATH 20E,B02,083774,Ciotti; Benjamin,18,0,35,17
1658098451177,MATH 103A,A01,083777,Greenfeld; Be'Eri,6,0,36,30
1658098451177,MATH 103A,A02,083778,Greenfeld; Be'Eri,5,0,36,31
1658098451177,MATH 103A,A03,093561,Greenfeld; Be'Eri,7,0,36,29
1658098451177,MATH 103A,B01,083779,Greenfeld; Be'Eri,8,0,36,28
1658098451177,MATH 103A,B02,083780,Greenfeld; Be'Eri,4,0,36,32
1658098451177,MATH 103A,B03,093562,Greenfeld; Be'Eri,3,0,36,33
1658098457200,MATH 105,A01,085443,Carter; Anne Toulson,15,0,35,20
1658098457200,MATH 105,A02,093477,Carter; Anne Toulson,20,0,35,15
1658098463224,MATH 109,A01,083213,Ganzberger; Geoffrey Michael,3,0,34,31
1658098463224,MATH 109,A02,083214,Ganzberger; Geoffrey Michael,4,0,34,30
1658098463224,MATH 109,A03,093478,Ganzberger; Geoffrey Michael,2,0,34,32
1658098463224,MATH 109,B01,083215,Ganzberger; Geoffrey Michael,3,0,32,29
1658098463224,MATH 109,B02,083216,Ganzberger; Geoffrey Michael,3,0,32,29
1658098463224,MATH 109,B03,093479,Ganzberger; Geoffrey Michael,8,0,32,24
1658098469248,MATH 142A,A01,083219,Chow; Bennett,7,0,32,25
1658098469248,MATH 142A,A02,083220,Chow; Bennett,10,0,32,22
1658098469248,MATH 142A,A03,093480,Chow; Bennett,9,0,32,23
1658098469248,MATH 142A,B03,093481,Chow; Bennett,8,0,32,24
1658098469248,MATH 142A,B04,093558,Chow; Bennett,14,0,32,18
1658098469248,MATH 142A,B05,093559,Chow; Bennett,7,0,32,25
1658098475274,MATH 193A,A01,083224,Rotar; Vladimir,9,0,34,25
1658098475274,MATH 193A,A02,083225,Rotar; Vladimir,11,0,34,23
1658098475274,MATH 193A,A03,083781,Rotar; Vladimir,5,0,34,29
1658098475274,MATH 193A,A04,083782,Rotar; Vladimir,12,0,34,22
1658098475274,MATH 193A,A05,093482,Rotar; Vladimir,11,0,34,23
1658098481298,MATH 197,001,091859,McAuley; Julian John,9999,0,9999,0
1658098481298,MATH 197,002,095566,Kedlaya; Kiran S.,9997,0,9999,2
1658098481298,MATH 197,003,095567,Xiao; Ming,9999,0,9999,0
1658098481298,MATH 197,004,095571,Perols; Johan Lars,9998,0,9999,1
1658098488355,COGS 9,A01,083615,Shannon; Kyle Michael,11,0,75,64
1658098494382,COGS 11,A01,083617,Boyle; Mary E. T.,23,0,48,25
1658098500404,COGS 13,A01,083071,Bastos; Amalia Pinkusfeld,12,0,71,59
1658098506428,COGS 14A,A01,092681,Semenuks; Arturs,5,1,100,95
1658098512450,COGS 14B,A01,083073,Cheng; Tzu-Han,7,0,63,56
1658098518477,COGS 17,A01,092677,Semenuks; Arturs,7,0,81,74
1658098524500,COGS 100,A01,083619,Allen; Michael Gordon,17,0,70,53
1658098530525,COGS 101A,A01,083621,Davis; Joshua Daniel,9,0,68,59
1658098536548,COGS 101B,A01,091572,Allen; Michael Gordon,14,0,65,51
1658098542599,COGS 101C,A01,083625,Delgado; Tania,17,0,35,18
1658098548625,COGS 107A,A01,083627,Boyle; Mary E. T.,14,0,60,46
1658098554647,COGS 118A,A01,083075,Gupta; Anjum,21,0,76,55
1658098560670,CSE 3,A50,083646,Miranda; Gregory Joseph,24,0,50,26
1658098566692,CSE 8A,A50,083650,Miranda; Gregory Joseph,17,1,56,39
1658098572716,CSE 11,A01,083080,Cao; Yingjun,7,15,40,33
1658098578741,CSE 12,A01,083652,Krause-Levy; Sophia Louisa,30,1,120,90
1658098584763,CSE 15L,A01,083654,Morris; Justin Loren,9,0,50,41
1658098584763,CSE 15L,A02,083655,Morris; Justin Loren,11,0,50,39
1658098590791,CSE 20,A01,083657,Tran; Khoa Dang,39,0,80,41
1658098596813,CSE 21,A01,095574,Bach; Quang Tran,23,0,48,25
1658098602837,CSE 30,A01,083084,Eldon; John,8,0,80,72
1658098602837,CSE 30,B01,095061,Bhaskar; Nishant,9,0,50,41
1658098608860,CSE 100,A01,083659,Cao; Yingjun,5,4,70,65
1658098614887,CSE 134B,A01,083661,Powell; Thomas Allan,25,0,100,75
1658098620910,CSE 140,A01,083663,Gungor; Onat,17,0,85,68
1658098626934,CSE 140L,A01,083088,Eldon; John,23,0,100,77
1658098632960,CSE 175,A01,083665,Kumar; Rakesh,3,0,25,22
1658098638984,CSE 190,A00,092507,Dubnov; Shlomo,8,0,20,12
1658098645011,ECE 45,A01,083139,Congero; Spencer William,7,0,75,68
1658098651034,ECE 65,A50,083695,Saad; Andrew S,12,0,30,18
1658098651034,ECE 65,A51,095125,Saad; Andrew S,24,0,26,2
1658098657058,ECE 109,A01,091882,Touri; Behrouz,21,0,70,49
1658098663081,ECE 180,A00,083140,Abi Samra; Nicholas Camill,1,0,30,29
1658098663081,ECE 180,B00,083141,Abi Samra; Nicholas Camill,0,0,30,30
1658098669108,MATH 10A,A01,083735,Patchell; Gregory David,2,0,30,28
1658098669108,MATH 10A,A02,083736,Patchell; Gregory David,20,0,30,10
1658098669108,MATH 10A,A03,083737,Patchell; Gregory David,16,0,30,14
1658098675134,MATH 10B,A01,083207,Lim; Seonhee,9,0,34,25
1658098675134,MATH 10B,A02,083208,Lim; Seonhee,10,0,35,25
1658098675134,MATH 10B,A03,093472,Lim; Seonhee,7,0,34,27
1658098675134,MATH 10B,B01,083739,Sinha; Shubham,14,0,30,16
1658098681167,MATH 18,A01,083743,Cinel; Cameron Alexander,9,0,30,21
1658098681167,MATH 18,A02,083744,Cinel; Cameron Alexander,18,0,30,12
1658098681167,MATH 18,A03,083745,Cinel; Cameron Alexander,10,0,30,20
1658098681167,MATH 18,B01,083748,Rideout; David Porter,5,0,37,32
1658098681167,MATH 18,B02,083749,Rideout; David Porter,5,0,36,31
1658098681167,MATH 18,B03,083750,Rideout; David Porter,3,0,37,34
1658098681167,MATH 18,B04,083751,Rideout; David Porter,7,0,36,29
1658098681167,MATH 18,B05,093473,Rideout; David Porter,7,0,36,29
1658098681167,MATH 18,B06,093474,Rideout; David Porter,6,0,36,30
1658098687190,MATH 20A,A01,083754,Zheng; Zequn,14,0,40,26
1658098693213,MATH 20B,A01,083756,Briones; Jor-el Thomas Caparas,4,0,36,32
1658098693213,MATH 20B,A02,083757,Briones; Jor-el Thomas Caparas,1,0,36,35
1658098693213,MATH 20B,A03,093475,Briones; Jor-el Thomas Caparas,3,0,36,33
1658098699238,MATH 20C,A01,083760,Briones; Jor-el Thomas Caparas,1,0,35,34
1658098699238,MATH 20C,A02,083761,Briones; Jor-el Thomas Caparas,8,0,35,27
1658098699238,MATH 20C,A03,093476,Briones; Jor-el Thomas Caparas,0,1,36,36
1658098699238,MATH 20C,B01,083762,Bach; Quang Tran,1,0,30,29
1658098705266,MATH 20D,A01,083765,Tran; Brian Kha,5,0,30,25
1658098705266,MATH 20D,A02,083766,Tran; Brian Kha,5,0,30,25
1658098705266,MATH 20D,A03,083767,Tran; Brian Kha,6,0,30,24
1658098711295,MATH 20E,A01,083771,Ganguly; Soumya,12,0,32,20
1658098711295,MATH 20E,A02,083772,Ganguly; Soumya,7,0,32,25
1658098711295,MATH 20E,B01,083773,Ciotti; Benjamin,20,0,35,15
1658098711295,MATH 20E,B02,083774,Ciotti; Benjamin,18,0,35,17
1658098717324,MATH 103A,A01,083777,Greenfeld; Be'Eri,6,0,36,30
1658098717324,MATH 103A,A02,083778,Greenfeld; Be'Eri,5,0,36,31
1658098717324,MATH 103A,A03,093561,Greenfeld; Be'Eri,7,0,36,29
1658098717324,MATH 103A,B01,083779,Greenfeld; Be'Eri,8,0,36,28
1658098717324,MATH 103A,B02,083780,Greenfeld; Be'Eri,4,0,36,32
1658098717324,MATH 103A,B03,093562,Greenfeld; Be'Eri,3,0,36,33
1658098723347,MATH 105,A01,085443,Carter; Anne Toulson,15,0,35,20
1658098723347,MATH 105,A02,093477,Carter; Anne Toulson,20,0,35,15
1658098729372,MATH 109,A01,083213,Ganzberger; Geoffrey Michael,3,0,34,31
1658098729372,MATH 109,A02,083214,Ganzberger; Geoffrey Michael,4,0,34,30
1658098729372,MATH 109,A03,093478,Ganzberger; Geoffrey Michael,2,0,34,32
1658098729372,MATH 109,B01,083215,Ganzberger; Geoffrey Michael,3,0,32,29
1658098729372,MATH 109,B02,083216,Ganzberger; Geoffrey Michael,3,0,32,29
1658098729372,MATH 109,B03,093479,Ganzberger; Geoffrey Michael,8,0,32,24
1658098735396,MATH 142A,A01,083219,Chow; Bennett,7,0,32,25
1658098735396,MATH 142A,A02,083220,Chow; Bennett,10,0,32,22
1658098735396,MATH 142A,A03,093480,Chow; Bennett,9,0,32,23
1658098735396,MATH 142A,B03,093481,Chow; Bennett,8,0,32,24
1658098735396,MATH 142A,B04,093558,Chow; Bennett,14,0,32,18
1658098735396,MATH 142A,B05,093559,Chow; Bennett,7,0,32,25
1658098741428,MATH 193A,A01,083224,Rotar; Vladimir,9,0,34,25
1658098741428,MATH 193A,A02,083225,Rotar; Vladimir,11,0,34,23
1658098741428,MATH 193A,A03,083781,Rotar; Vladimir,5,0,34,29
1658098741428,MATH 193A,A04,083782,Rotar; Vladimir,12,0,34,22
1658098741428,MATH 193A,A05,093482,Rotar; Vladimir,11,0,34,23
1658098747453,MATH 197,001,091859,McAuley; Julian John,9999,0,9999,0
1658098747453,MATH 197,002,095566,Kedlaya; Kiran S.,9997,0,9999,2
1658098747453,MATH 197,003,095567,Xiao; Ming,9999,0,9999,0
1658098747453,MATH 197,004,095571,Perols; Johan Lars,9998,0,9999,1
1658098754517,COGS 9,A01,083615,Shannon; Kyle Michael,11,0,75,64
1658098760540,COGS 11,A01,083617,Boyle; Mary E. T.,23,0,48,25
1658098766564,COGS 13,A01,083071,Bastos; Amalia Pinkusfeld,12,0,71,59
1658098772592,COGS 14A,A01,092681,Semenuks; Arturs,5,1,100,95
1658098778616,COGS 14B,A01,083073,Cheng; Tzu-Han,7,0,63,56
1658098784644,COGS 17,A01,092677,Semenuks; Arturs,7,0,81,74
1658098790670,COGS 100,A01,083619,Allen; Michael Gordon,17,0,70,53
1658098796693,COGS 101A,A01,083621,Davis; Joshua Daniel,9,0,68,59
1658098802719,COGS 101B,A01,091572,Allen; Michael Gordon,14,0,65,51
1658098808743,COGS 101C,A01,083625,Delgado; Tania,17,0,35,18
1658098814766,COGS 107A,A01,083627,Boyle; Mary E. T.,14,0,60,46
1658098820789,COGS 118A,A01,083075,Gupta; Anjum,21,0,76,55
1658098826817,CSE 3,A50,083646,Miranda; Gregory Joseph,24,0,50,26
1658098832839,CSE 8A,A50,083650,Miranda; Gregory Joseph,17,1,56,39
1658098838865,CSE 11,A01,083080,Cao; Yingjun,7,15,40,33
1658098844887,CSE 12,A01,083652,Krause-Levy; Sophia Louisa,30,1,120,90
1658098850911,CSE 15L,A01,083654,Morris; Justin Loren,9,0,50,41
1658098850911,CSE 15L,A02,083655,Morris; Justin Loren,11,0,50,39
1658098856938,CSE 20,A01,083657,Tran; Khoa Dang,39,0,80,41
1658098862961,CSE 21,A01,095574,Bach; Quang Tran,23,0,48,25
1658098868989,CSE 30,A01,083084,Eldon; John,8,0,80,72
1658098868989,CSE 30,B01,095061,Bhaskar; Nishant,9,0,50,41
1658098875016,CSE 100,A01,083659,Cao; Yingjun,5,4,70,65
1658098881040,CSE 134B,A01,083661,Powell; Thomas Allan,25,0,100,75
1658098887067,CSE 140,A01,083663,Gungor; Onat,17,0,85,68
1658098893090,CSE 140L,A01,083088,Eldon; John,23,0,100,77
1658098899116,CSE 175,A01,083665,Kumar; Rakesh,3,0,25,22
1658098905139,CSE 190,A00,092507,Dubnov; Shlomo,8,0,20,12
1658098911163,ECE 45,A01,083139,Congero; Spencer William,7,0,75,68
1658098917192,ECE 65,A50,083695,Saad; Andrew S,12,0,30,18
1658098917192,ECE 65,A51,095125,Saad; Andrew S,24,0,26,2
1658098923219,ECE 109,A01,091882,Touri; Behrouz,21,0,70,49
1658098929242,ECE 180,A00,083140,Abi Samra; Nicholas Camill,1,0,30,29
1658098929242,ECE 180,B00,083141,Abi Samra; Nicholas Camill,0,0,30,30
1658098935266,MATH 10A,A01,083735,Patchell; Gregory David,2,0,30,28
1658098935266,MATH 10A,A02,083736,Patchell; Gregory David,20,0,30,10
1658098935266,MATH 10A,A03,083737,Patchell; Gregory David,16,0,30,14
1658098941296,MATH 10B,A01,083207,Lim; Seonhee,9,0,34,25
1658098941296,MATH 10B,A02,083208,Lim; Seonhee,10,0,35,25
1658098941296,MATH 10B,A03,093472,Lim; Seonhee,7,0,34,27
1658098941296,MATH 10B,B01,083739,Sinha; Shubham,14,0,30,16
1658098947328,MATH 18,A01,083743,Cinel; Cameron Alexander,9,0,30,21
1658098947328,MATH 18,A02,083744,Cinel; Cameron Alexander,18,0,30,12
1658098947328,MATH 18,A03,083745,Cinel; Cameron Alexander,10,0,30,20
1658098947328,MATH 18,B01,083748,Rideout; David Porter,5,0,37,32
1658098947328,MATH 18,B02,083749,Rideout; David Porter,5,0,36,31
1658098947328,MATH 18,B03,083750,Rideout; David Porter,3,0,37,34
1658098947328,MATH 18,B04,083751,Rideout; David Porter,7,0,36,29
1658098947328,MATH 18,B05,093473,Rideout; David Porter,7,0,36,29
1658098947328,MATH 18,B06,093474,Rideout; David Porter,6,0,36,30
1658098953355,MATH 20A,A01,083754,Zheng; Zequn,14,0,40,26
1658098959389,MATH 20B,A01,083756,Briones; Jor-el Thomas Caparas,4,0,36,32
1658098959389,MATH 20B,A02,083757,Briones; Jor-el Thomas Caparas,1,0,36,35
1658098959389,MATH 20B,A03,093475,Briones; Jor-el Thomas Caparas,3,0,36,33
1658098965421,MATH 20C,A01,083760,Briones; Jor-el Thomas Caparas,1,0,35,34
1658098965421,MATH 20C,A02,083761,Briones; Jor-el Thomas Caparas,8,0,35,27
1658098965421,MATH 20C,A03,093476,Briones; Jor-el Thomas Caparas,0,1,36,36
1658098965421,MATH 20C,B01,083762,Bach; Quang Tran,1,0,30,29
1658098971445,MATH 20D,A01,083765,Tran; Brian Kha,5,0,30,25
1658098971445,MATH 20D,A02,083766,Tran; Brian Kha,5,0,30,25
1658098971445,MATH 20D,A03,083767,Tran; Brian Kha,6,0,30,24
1658098977475,MATH 20E,A01,083771,Ganguly; Soumya,12,0,32,20
1658098977475,MATH 20E,A02,083772,Ganguly; Soumya,7,0,32,25
1658098977475,MATH 20E,B01,083773,Ciotti; Benjamin,20,0,35,15
1658098977475,MATH 20E,B02,083774,Ciotti; Benjamin,18,0,35,17
1658098983500,MATH 103A,A01,083777,Greenfeld; Be'Eri,6,0,36,30
1658098983500,MATH 103A,A02,083778,Greenfeld; Be'Eri,5,0,36,31
1658098983500,MATH 103A,A03,093561,Greenfeld; Be'Eri,7,0,36,29
1658098983500,MATH 103A,B01,083779,Greenfeld; Be'Eri,8,0,36,28
1658098983500,MATH 103A,B02,083780,Greenfeld; Be'Eri,4,0,36,32
1658098983500,MATH 103A,B03,093562,Greenfeld; Be'Eri,3,0,36,33
1658098989525,MATH 105,A01,085443,Carter; Anne Toulson,15,0,35,20
1658098989525,MATH 105,A02,093477,Carter; Anne Toulson,20,0,35,15
1658098995553,MATH 109,A01,083213,Ganzberger; Geoffrey Michael,3,0,34,31
1658098995553,MATH 109,A02,083214,Ganzberger; Geoffrey Michael,4,0,34,30
1658098995553,MATH 109,A03,093478,Ganzberger; Geoffrey Michael,2,0,34,32
1658098995553,MATH 109,B01,083215,Ganzberger; Geoffrey Michael,3,0,32,29
1658098995553,MATH 109,B02,083216,Ganzberger; Geoffrey Michael,3,0,32,29
1658098995553,MATH 109,B03,093479,Ganzberger; Geoffrey Michael,8,0,32,24
1658099001577,MATH 142A,A01,083219,Chow; Bennett,7,0,32,25
1658099001577,MATH 142A,A02,083220,Chow; Bennett,10,0,32,22
1658099001577,MATH 142A,A03,093480,Chow; Bennett,9,0,32,23
1658099001577,MATH 142A,B03,093481,Chow; Bennett,8,0,32,24
1658099001577,MATH 142A,B04,093558,Chow; Bennett,14,0,32,18
1658099001577,MATH 142A,B05,093559,Chow; Bennett,7,0,32,25
1658099007601,MATH 193A,A01,083224,Rotar; Vladimir,9,0,34,25
1658099007601,MATH 193A,A02,083225,Rotar; Vladimir,11,0,34,23
1658099007601,MATH 193A,A03,083781,Rotar; Vladimir,5,0,34,29
1658099007601,MATH 193A,A04,083782,Rotar; Vladimir,12,0,34,22
1658099007601,MATH 193A,A05,093482,Rotar; Vladimir,11,0,34,23
1658099013627,MATH 197,001,091859,McAuley; Julian John,9999,0,9999,0
1658099013627,MATH 197,002,095566,Kedlaya; Kiran S.,9997,0,9999,2
1658099013627,MATH 197,003,095567,Xiao; Ming,9999,0,9999,0
1658099013627,MATH 197,004,095571,Perols; Johan Lars,9998,0,9999,1
1658099020716,COGS 9,A01,083615,Shannon; Kyle Michael,11,0,75,64
1658099026833,COGS 11,A01,083617,Boyle; Mary E. T.,23,0,48,25
1658099032859,COGS 13,A01,083071,Bastos; Amalia Pinkusfeld,12,0,71,59
1658099038881,COGS 14A,A01,092681,Semenuks; Arturs,5,1,100,95
1658099044937,COGS 14B,A01,083073,Cheng; Tzu-Han,7,0,63,56
1658099050959,COGS 17,A01,092677,Semenuks; Arturs,7,0,81,74
1658099056990,COGS 100,A01,083619,Allen; Michael Gordon,17,0,70,53
1658099063013,COGS 101A,A01,083621,Davis; Joshua Daniel,9,0,68,59
1658099069035,COGS 101B,A01,091572,Allen; Michael Gordon,14,0,65,51
1658099075066,COGS 101C,A01,083625,Delgado; Tania,17,0,35,18
1658099081091,COGS 107A,A01,083627,Boyle; Mary E. T.,14,0,60,46
1658099087117,COGS 118A,A01,083075,Gupta; Anjum,21,0,76,55
1658099093149,CSE 3,A50,083646,Miranda; Gregory Joseph,24,0,50,26
1658099099177,CSE 8A,A50,083650,Miranda; Gregory Joseph,17,1,56,39
1658099105200,CSE 11,A01,083080,Cao; Yingjun,7,15,40,33
1658099111227,CSE 12,A01,083652,Krause-Levy; Sophia Louisa,30,1,120,90
1658099117254,CSE 15L,A01,083654,Morris; Justin Loren,9,0,50,41
1658099117254,CSE 15L,A02,083655,Morris; Justin Loren,11,0,50,39
1658099123276,CSE 20,A01,083657,Tran; Khoa Dang,39,0,80,41
1658099129304,CSE 21,A01,095574,Bach; Quang Tran,23,0,48,25
1658099135327,CSE 30,A01,083084,Eldon; John,8,0,80,72
1658099135327,CSE 30,B01,095061,Bhaskar; Nishant,9,0,50,41
1658099141358,CSE 100,A01,083659,Cao; Yingjun,5,4,70,65
1658099147386,CSE 134B,A01,083661,Powell; Thomas Allan,25,0,100,75
1658099153411,CSE 140,A01,083663,Gungor; Onat,17,0,85,68
1658099159439,CSE 140L,A01,083088,Eldon; John,23,0,100,77
1658099165463,CSE 175,A01,083665,Kumar; Rakesh,3,0,25,22
1658099171488,CSE 190,A00,092507,Dubnov; Shlomo,8,0,20,12
1658099177511,ECE 45,A01,083139,Congero; Spencer William,7,0,75,68
1658099183536,ECE 65,A50,083695,Saad; Andrew S,12,0,30,18
1658099183536,ECE 65,A51,095125,Saad; Andrew S,24,0,26,2
1658099189571,ECE 109,A01,091882,Touri; Behrouz,21,0,70,49
1658099195597,ECE 180,A00,083140,Abi Samra; Nicholas Camill,1,0,30,29
1658099195597,ECE 180,B00,083141,Abi Samra; Nicholas Camill,0,0,30,30
1658099201624,MATH 10A,A01,083735,Patchell; Gregory David,2,0,30,28
1658099201624,MATH 10A,A02,083736,Patchell; Gregory David,20,0,30,10
1658099201624,MATH 10A,A03,083737,Patchell; Gregory David,16,0,30,14
1658099207648,MATH 10B,A01,083207,Lim; Seonhee,9,0,34,25
1658099207648,MATH 10B,A02,083208,Lim; Seonhee,10,0,35,25
1658099207648,MATH 10B,A03,093472,Lim; Seonhee,7,0,34,27
1658099207648,MATH 10B,B01,083739,Sinha; Shubham,14,0,30,16
1658099213674,MATH 18,A01,083743,Cinel; Cameron Alexander,9,0,30,21
1658099213674,MATH 18,A02,083744,Cinel; Cameron Alexander,18,0,30,12
1658099213674,MATH 18,A03,083745,Cinel; Cameron Alexander,10,0,30,20
1658099213674,MATH 18,B01,083748,Rideout; David Porter,5,0,37,32
1658099213674,MATH 18,B02,083749,Rideout; David Porter,5,0,36,31
1658099213674,MATH 18,B03,083750,Rideout; David Porter,3,0,37,34
1658099213674,MATH 18,B04,083751,Rideout; David Porter,7,0,36,29
1658099213674,MATH 18,B05,093473,Rideout; David Porter,7,0,36,29
1658099213674,MATH 18,B06,093474,Rideout; David Porter,6,0,36,30
1658099219698,MATH 20A,A01,083754,Zheng; Zequn,14,0,40,26
1658099225722,MATH 20B,A01,083756,Briones; Jor-el Thomas Caparas,4,0,36,32
1658099225722,MATH 20B,A02,083757,Briones; Jor-el Thomas Caparas,1,0,36,35
1658099225722,MATH 20B,A03,093475,Briones; Jor-el Thomas Caparas,3,0,36,33
1658099231752,MATH 20C,A01,083760,Briones; Jor-el Thomas Caparas,1,0,35,34
1658099231752,MATH 20C,A02,083761,Briones; Jor-el Thomas Caparas,8,0,35,27
1658099231752,MATH 20C,A03,093476,Briones; Jor-el Thomas Caparas,0,1,36,36
1658099231752,MATH 20C,B01,083762,Bach; Quang Tran,1,0,30,29
1658099237775,MATH 20D,A01,083765,Tran; Brian Kha,5,0,30,25
1658099237775,MATH 20D,A02,083766,Tran; Brian Kha,5,0,30,25
1658099237775,MATH 20D,A03,083767,Tran; Brian Kha,6,0,30,24
1658099243800,MATH 20E,A01,083771,Ganguly; Soumya,12,0,32,20
1658099243800,MATH 20E,A02,083772,Ganguly; Soumya,7,0,32,25
1658099243800,MATH 20E,B01,083773,Ciotti; Benjamin,20,0,35,15
1658099243800,MATH 20E,B02,083774,Ciotti; Benjamin,18,0,35,17
1658099249825,MATH 103A,A01,083777,Greenfeld; Be'Eri,6,0,36,30
1658099249825,MATH 103A,A02,083778,Greenfeld; Be'Eri,5,0,36,31
1658099249825,MATH 103A,A03,093561,Greenfeld; Be'Eri,7,0,36,29
1658099249825,MATH 103A,B01,083779,Greenfeld; Be'Eri,8,0,36,28
1658099249825,MATH 103A,B02,083780,Greenfeld; Be'Eri,4,0,36,32
1658099249825,MATH 103A,B03,093562,Greenfeld; Be'Eri,3,0,36,33
1658099255854,MATH 105,A01,085443,Carter; Anne Toulson,15,0,35,20
1658099255854,MATH 105,A02,093477,Carter; Anne Toulson,20,0,35,15
1658099261883,MATH 109,A01,083213,Ganzberger; Geoffrey Michael,3,0,34,31
1658099261883,MATH 109,A02,083214,Ganzberger; Geoffrey Michael,4,0,34,30
1658099261883,MATH 109,A03,093478,Ganzberger; Geoffrey Michael,2,0,34,32
1658099261883,MATH 109,B01,083215,Ganzberger; Geoffrey Michael,3,0,32,29
1658099261883,MATH 109,B02,083216,Ganzberger; Geoffrey Michael,3,0,32,29
1658099261883,MATH 109,B03,093479,Ganzberger; Geoffrey Michael,8,0,32,24
1658099267908,MATH 142A,A01,083219,Chow; Bennett,7,0,32,25
1658099267908,MATH 142A,A02,083220,Chow; Bennett,10,0,32,22
1658099267908,MATH 142A,A03,093480,Chow; Bennett,9,0,32,23
1658099267908,MATH 142A,B03,093481,Chow; Bennett,8,0,32,24
1658099267908,MATH 142A,B04,093558,Chow; Bennett,14,0,32,18
1658099267908,MATH 142A,B05,093559,Chow; Bennett,7,0,32,25
1658099273933,MATH 193A,A01,083224,Rotar; Vladimir,9,0,34,25
1658099273933,MATH 193A,A02,083225,Rotar; Vladimir,11,0,34,23
1658099273933,MATH 193A,A03,083781,Rotar; Vladimir,5,0,34,29
1658099273933,MATH 193A,A04,083782,Rotar; Vladimir,12,0,34,22
1658099273933,MATH 193A,A05,093482,Rotar; Vladimir,11,0,34,23
1658099279960,MATH 197,001,091859,McAuley; Julian John,9999,0,9999,0
1658099279960,MATH 197,002,095566,Kedlaya; Kiran S.,9997,0,9999,2
1658099279960,MATH 197,003,095567,Xiao; Ming,9999,0,9999,0
1658099279960,MATH 197,004,095571,Perols; Johan Lars,9998,0,9999,1
1658099287018,COGS 9,A01,083615,Shannon; Kyle Michael,11,0,75,64
1658099293041,COGS 11,A01,083617,Boyle; Mary E. T.,23,0,48,25
1658099299066,COGS 13,A01,083071,Bastos; Amalia Pinkusfeld,12,0,71,59
1658099305089,COGS 14A,A01,092681,Semenuks; Arturs,5,1,100,95
1658099311120,COGS 14B,A01,083073,Cheng; Tzu-Han,7,0,63,56
1658099317148,COGS 17,A01,092677,Semenuks; Arturs,7,0,81,74
1658099323174,COGS 100,A01,083619,Allen; Michael Gordon,17,0,70,53
1658099329201,COGS 101A,A01,083621,Davis; Joshua Daniel,9,0,68,59
1658099335227,COGS 101B,A01,091572,Allen; Michael Gordon,14,0,65,51
1658099341250,COGS 101C,A01,083625,Delgado; Tania,17,0,35,18
1658099347274,COGS 107A,A01,083627,Boyle; Mary E. T.,14,0,60,46
1658099353298,COGS 118A,A01,083075,Gupta; Anjum,21,0,76,55
1658099359327,CSE 3,A50,083646,Miranda; Gregory Joseph,24,0,50,26
1658099365353,CSE 8A,A50,083650,Miranda; Gregory Joseph,17,1,56,39
1658099371375,CSE 11,A01,083080,Cao; Yingjun,7,15,40,33
1658099377400,CSE 12,A01,083652,Krause-Levy; Sophia Louisa,30,1,120,90
1658099383424,CSE 15L,A01,083654,Morris; Justin Loren,9,0,50,41
1658099383424,CSE 15L,A02,083655,Morris; Justin Loren,11,0,50,39
1658099389447,CSE 20,A01,083657,Tran; Khoa Dang,39,0,80,41
1658099395470,CSE 21,A01,095574,Bach; Quang Tran,23,0,48,25
1658099401493,CSE 30,A01,083084,Eldon; John,8,0,80,72
1658099401493,CSE 30,B01,095061,Bhaskar; Nishant,9,0,50,41
1658099407517,CSE 100,A01,083659,Cao; Yingjun,5,4,70,65
1658099413541,CSE 134B,A01,083661,Powell; Thomas Allan,25,0,100,75
1658099419576,CSE 140,A01,083663,Gungor; Onat,17,0,85,68
1658099425600,CSE 140L,A01,083088,Eldon; John,23,0,100,77
1658099431627,CSE 175,A01,083665,Kumar; Rakesh,3,0,25,22
1658099437654,CSE 190,A00,092507,Dubnov; Shlomo,8,0,20,12
1658099443676,ECE 45,A01,083139,Congero; Spencer William,7,0,75,68
1658099449723,ECE 65,A50,083695,Saad; Andrew S,12,0,30,18
1658099449723,ECE 65,A51,095125,Saad; Andrew S,24,0,26,2
1658099455749,ECE 109,A01,091882,Touri; Behrouz,21,0,70,49
1658099461771,ECE 180,A00,083140,Abi Samra; Nicholas Camill,1,0,30,29
1658099461771,ECE 180,B00,083141,Abi Samra; Nicholas Camill,0,0,30,30
1658099467810,MATH 10A,A01,083735,Patchell; Gregory David,2,0,30,28
1658099467810,MATH 10A,A02,083736,Patchell; Gregory David,20,0,30,10
1658099467810,MATH 10A,A03,083737,Patchell; Gregory David,16,0,30,14
1658099473834,MATH 10B,A01,083207,Lim; Seonhee,9,0,34,25
1658099473834,MATH 10B,A02,083208,Lim; Seonhee,10,0,35,25
1658099473834,MATH 10B,A03,093472,Lim; Seonhee,7,0,34,27
1658099473834,MATH 10B,B01,083739,Sinha; Shubham,14,0,30,16
1658099479863,MATH 18,A01,083743,Cinel; Cameron Alexander,9,0,30,21
1658099479863,MATH 18,A02,083744,Cinel; Cameron Alexander,18,0,30,12
1658099479863,MATH 18,A03,083745,Cinel; Cameron Alexander,10,0,30,20
1658099479863,MATH 18,B01,083748,Rideout; David Porter,5,0,37,32
1658099479863,MATH 18,B02,083749,Rideout; David Porter,5,0,36,31
1658099479863,MATH 18,B03,083750,Rideout; David Porter,3,0,37,34
1658099479863,MATH 18,B04,083751,Rideout; David Porter,7,0,36,29
1658099479863,MATH 18,B05,093473,Rideout; David Porter,7,0,36,29
1658099479863,MATH 18,B06,093474,Rideout; David Porter,6,0,36,30
1658099485887,MATH 20A,A01,083754,Zheng; Zequn,14,0,40,26
1658099491914,MATH 20B,A01,083756,Briones; Jor-el Thomas Caparas,4,0,36,32
1658099491914,MATH 20B,A02,083757,Briones; Jor-el Thomas Caparas,1,0,36,35
1658099491914,MATH 20B,A03,093475,Briones; Jor-el Thomas Caparas,3,0,36,33
1658099497939,MATH 20C,A01,083760,Briones; Jor-el Thomas Caparas,1,0,35,34
1658099497939,MATH 20C,A02,083761,Briones; Jor-el Thomas Caparas,8,0,35,27
1658099497939,MATH 20C,A03,093476,Briones; Jor-el Thomas Caparas,0,1,36,36
1658099497939,MATH 20C,B01,083762,Bach; Quang Tran,1,0,30,29
1658099503962,MATH 20D,A01,083765,Tran; Brian Kha,5,0,30,25
1658099503962,MATH 20D,A02,083766,Tran; Brian Kha,5,0,30,25
1658099503962,MATH 20D,A03,083767,Tran; Brian Kha,6,0,30,24
1658099509990,MATH 20E,A01,083771,Ganguly; Soumya,12,0,32,20
1658099509990,MATH 20E,A02,083772,Ganguly; Soumya,7,0,32,25
1658099509990,MATH 20E,B01,083773,Ciotti; Benjamin,20,0,35,15
1658099509990,MATH 20E,B02,083774,Ciotti; Benjamin,18,0,35,17
1658099516013,MATH 103A,A01,083777,Greenfeld; Be'Eri,6,0,36,30
1658099516013,MATH 103A,A02,083778,Greenfeld; Be'Eri,5,0,36,31
1658099516013,MATH 103A,A03,093561,Greenfeld; Be'Eri,7,0,36,29
1658099516013,MATH 103A,B01,083779,Greenfeld; Be'Eri,8,0,36,28
1658099516013,MATH 103A,B02,083780,Greenfeld; Be'Eri,4,0,36,32
1658099516013,MATH 103A,B03,093562,Greenfeld; Be'Eri,3,0,36,33
1658099522039,MATH 105,A01,085443,Carter; Anne Toulson,15,0,35,20
1658099522039,MATH 105,A02,093477,Carter; Anne Toulson,20,0,35,15
1658099528064,MATH 109,A01,083213,Ganzberger; Geoffrey Michael,3,0,34,31
1658099528064,MATH 109,A02,083214,Ganzberger; Geoffrey Michael,4,0,34,30
1658099528064,MATH 109,A03,093478,Ganzberger; Geoffrey Michael,2,0,34,32
1658099528064,MATH 109,B01,083215,Ganzberger; Geoffrey Michael,3,0,32,29
1658099528064,MATH 109,B02,083216,Ganzberger; Geoffrey Michael,3,0,32,29
1658099528064,MATH 109,B03,093479,Ganzberger; Geoffrey Michael,8,0,32,24
1658099534091,MATH 142A,A01,083219,Chow; Bennett,7,0,32,25
1658099534091,MATH 142A,A02,083220,Chow; Bennett,10,0,32,22
1658099534091,MATH 142A,A03,093480,Chow; Bennett,9,0,32,23
1658099534091,MATH 142A,B03,093481,Chow; Bennett,8,0,32,24
1658099534091,MATH 142A,B04,093558,Chow; Bennett,14,0,32,18
1658099534091,MATH 142A,B05,093559,Chow; Bennett,7,0,32,25
1658099540116,MATH 193A,A01,083224,Rotar; Vladimir,9,0,34,25
1658099540116,MATH 193A,A02,083225,Rotar; Vladimir,11,0,34,23
1658099540116,MATH 193A,A03,083781,Rotar; Vladimir,5,0,34,29
1658099540116,MATH 193A,A04,083782,Rotar; Vladimir,12,0,34,22
1658099540116,MATH 193A,A05,093482,Rotar; Vladimir,11,0,34,23
1658099546145,MATH 197,001,091859,McAuley; Julian John,9999,0,9999,0
1658099546145,MATH 197,002,095566,Kedlaya; Kiran S.,9997,0,9999,2
1658099546145,MATH 197,003,095567,Xiao; Ming,9999,0,9999,0
1658099546145,MATH 197,004,095571,Perols; Johan Lars,9998,0,9999,1
1658099553199,COGS 9,A01,083615,Shannon; Kyle Michael,11,0,75,64
1658099559223,COGS 11,A01,083617,Boyle; Mary E. T.,23,0,48,25
1658099565254,COGS 13,A01,083071,Bastos; Amalia Pinkusfeld,12,0,71,59
1658099571278,COGS 14A,A01,092681,Semenuks; Arturs,5,1,100,95
1658099577300,COGS 14B,A01,083073,Cheng; Tzu-Han,7,0,63,56
1658099583327,COGS 17,A01,092677,Semenuks; Arturs,7,0,81,74
1658099589352,COGS 100,A01,083619,Allen; Michael Gordon,17,0,70,53
1658099595376,COGS 101A,A01,083621,Davis; Joshua Daniel,9,0,68,59
1658099601402,COGS 101B,A01,091572,Allen; Michael Gordon,14,0,65,51
1658099607425,COGS 101C,A01,083625,Delgado; Tania,17,0,35,18
1658099613447,COGS 107A,A01,083627,Boyle; Mary E. T.,14,0,60,46
1658099619474,COGS 118A,A01,083075,Gupta; Anjum,21,0,76,55
1658099625580,CSE 3,A50,083646,Miranda; Gregory Joseph,24,0,50,26
1658099631611,CSE 8A,A50,083650,Miranda; Gregory Joseph,17,1,56,39
1658099637640,CSE 11,A01,083080,Cao; Yingjun,7,15,40,33
1658099643668,CSE 12,A01,083652,Krause-Levy; Sophia Louisa,30,1,120,90
1658099649692,CSE 15L,A01,083654,Morris; Justin Loren,9,0,50,41
1658099649692,CSE 15L,A02,083655,Morris; Justin Loren,11,0,50,39
1658099655719,CSE 20,A01,083657,Tran; Khoa Dang,39,0,80,41
1658099661743,CSE 21,A01,095574,Bach; Quang Tran,23,0,48,25
1658099667768,CSE 30,A01,083084,Eldon; John,8,0,80,72
1658099667768,CSE 30,B01,095061,Bhaskar; Nishant,9,0,50,41
1658099673792,CSE 100,A01,083659,Cao; Yingjun,5,4,70,65
1658099679816,CSE 134B,A01,083661,Powell; Thomas Allan,25,0,100,75
1658099685847,CSE 140,A01,083663,Gungor; Onat,17,0,85,68
1658099691870,CSE 140L,A01,083088,Eldon; John,23,0,100,77
1658099697894,CSE 175,A01,083665,Kumar; Rakesh,3,0,25,22
1658099703917,CSE 190,A00,092507,Dubnov; Shlomo,8,0,20,12
1658099709959,ECE 45,A01,083139,Congero; Spencer William,7,0,75,68
1658099715988,ECE 65,A50,083695,Saad; Andrew S,12,0,30,18
1658099715988,ECE 65,A51,095125,Saad; Andrew S,24,0,26,2
1658099722009,ECE 109,A01,091882,Touri; Behrouz,21,0,70,49
1658099728037,ECE 180,A00,083140,Abi Samra; Nicholas Camill,1,0,30,29
1658099728037,ECE 180,B00,083141,Abi Samra; Nicholas Camill,0,0,30,30
1658099734061,MATH 10A,A01,083735,Patchell; Gregory David,2,0,30,28
1658099734061,MATH 10A,A02,083736,Patchell; Gregory David,20,0,30,10
1658099734061,MATH 10A,A03,083737,Patchell; Gregory David,16,0,30,14
1658099740092,MATH 10B,A01,083207,Lim; Seonhee,9,0,34,25
1658099740092,MATH 10B,A02,083208,Lim; Seonhee,10,0,35,25
1658099740092,MATH 10B,A03,093472,Lim; Seonhee,7,0,34,27
1658099740092,MATH 10B,B01,083739,Sinha; Shubham,14,0,30,16
1658099746117,MATH 18,A01,083743,Cinel; Cameron Alexander,9,0,30,21
1658099746117,MATH 18,A02,083744,Cinel; Cameron Alexander,18,0,30,12
1658099746117,MATH 18,A03,083745,Cinel; Cameron Alexander,10,0,30,20
1658099746117,MATH 18,B01,083748,Rideout; David Porter,5,0,37,32
1658099746117,MATH 18,B02,083749,Rideout; David Porter,5,0,36,31
1658099746117,MATH 18,B03,083750,Rideout; David Porter,3,0,37,34
1658099746117,MATH 18,B04,083751,Rideout; David Porter,7,0,36,29
1658099746117,MATH 18,B05,093473,Rideout; David Porter,7,0,36,29
1658099746117,MATH 18,B06,093474,Rideout; David Porter,6,0,36,30
1658099752140,MATH 20A,A01,083754,Zheng; Zequn,14,0,40,26
1658099758163,MATH 20B,A01,083756,Briones; Jor-el Thomas Caparas,4,0,36,32
1658099758163,MATH 20B,A02,083757,Briones; Jor-el Thomas Caparas,1,0,36,35
1658099758163,MATH 20B,A03,093475,Briones; Jor-el Thomas Caparas,3,0,36,33
1658099764187,MATH 20C,A01,083760,Briones; Jor-el Thomas Caparas,1,0,35,34
1658099764187,MATH 20C,A02,083761,Briones; Jor-el Thomas Caparas,8,0,35,27
1658099764187,MATH 20C,A03,093476,Briones; Jor-el Thomas Caparas,0,1,36,36
1658099764187,MATH 20C,B01,083762,Bach; Quang Tran,1,0,30,29
1658099770212,MATH 20D,A01,083765,Tran; Brian Kha,5,0,30,25
1658099770212,MATH 20D,A02,083766,Tran; Brian Kha,5,0,30,25
1658099770212,MATH 20D,A03,083767,Tran; Brian Kha,6,0,30,24
1658099776235,MATH 20E,A01,083771,Ganguly; Soumya,12,0,32,20
1658099776235,MATH 20E,A02,083772,Ganguly; Soumya,7,0,32,25
1658099776235,MATH 20E,B01,083773,Ciotti; Benjamin,20,0,35,15
1658099776235,MATH 20E,B02,083774,Ciotti; Benjamin,18,0,35,17
1658099782266,MATH 103A,A01,083777,Greenfeld; Be'Eri,6,0,36,30
1658099782266,MATH 103A,A02,083778,Greenfeld; Be'Eri,5,0,36,31
1658099782266,MATH 103A,A03,093561,Greenfeld; Be'Eri,7,0,36,29
1658099782266,MATH 103A,B01,083779,Greenfeld; Be'Eri,8,0,36,28
1658099782266,MATH 103A,B02,083780,Greenfeld; Be'Eri,4,0,36,32
1658099782266,MATH 103A,B03,093562,Greenfeld; Be'Eri,3,0,36,33
1658099788289,MATH 105,A01,085443,Carter; Anne Toulson,15,0,35,20
1658099788289,MATH 105,A02,093477,Carter; Anne Toulson,20,0,35,15
1658099794315,MATH 109,A01,083213,Ganzberger; Geoffrey Michael,3,0,34,31
1658099794315,MATH 109,A02,083214,Ganzberger; Geoffrey Michael,4,0,34,30
1658099794315,MATH 109,A03,093478,Ganzberger; Geoffrey Michael,2,0,34,32
1658099794315,MATH 109,B01,083215,Ganzberger; Geoffrey Michael,3,0,32,29
1658099794315,MATH 109,B02,083216,Ganzberger; Geoffrey Michael,3,0,32,29
1658099794315,MATH 109,B03,093479,Ganzberger; Geoffrey Michael,8,0,32,24
1658099800340,MATH 142A,A01,083219,Chow; Bennett,7,0,32,25
1658099800340,MATH 142A,A02,083220,Chow; Bennett,10,0,32,22
1658099800340,MATH 142A,A03,093480,Chow; Bennett,9,0,32,23
1658099800340,MATH 142A,B03,093481,Chow; Bennett,8,0,32,24
1658099800340,MATH 142A,B04,093558,Chow; Bennett,14,0,32,18
1658099800340,MATH 142A,B05,093559,Chow; Bennett,7,0,32,25
1658099806369,MATH 193A,A01,083224,Rotar; Vladimir,9,0,34,25
1658099806369,MATH 193A,A02,083225,Rotar; Vladimir,11,0,34,23
1658099806369,MATH 193A,A03,083781,Rotar; Vladimir,5,0,34,29
1658099806369,MATH 193A,A04,083782,Rotar; Vladimir,12,0,34,22
1658099806369,MATH 193A,A05,093482,Rotar; Vladimir,11,0,34,23
1658099812394,MATH 197,001,091859,McAuley; Julian John,9999,0,9999,0
1658099812394,MATH 197,002,095566,Kedlaya; Kiran S.,9997,0,9999,2
1658099812394,MATH 197,003,095567,Xiao; Ming,9999,0,9999,0
1658099812394,MATH 197,004,095571,Perols; Johan Lars,9998,0,9999,1
1658099819452,COGS 9,A01,083615,Shannon; Kyle Michael,11,0,75,64
1658099825480,COGS 11,A01,083617,Boyle; Mary E. T.,23,0,48,25
1658099831508,COGS 13,A01,083071,Bastos; Amalia Pinkusfeld,12,0,71,59
1658099837535,COGS 14A,A01,092681,Semenuks; Arturs,5,1,100,95
1658099843559,COGS 14B,A01,083073,Cheng; Tzu-Han,7,0,63,56
1658099849583,COGS 17,A01,092677,Semenuks; Arturs,7,0,81,74
1658099855610,COGS 100,A01,083619,Allen; Michael Gordon,17,0,70,53
1658099861634,COGS 101A,A01,083621,Davis; Joshua Daniel,9,0,68,59
1658099867658,COGS 101B,A01,091572,Allen; Michael Gordon,14,0,65,51
1658099873682,COGS 101C,A01,083625,Delgado; Tania,17,0,35,18
1658099879707,COGS 107A,A01,083627,Boyle; Mary E. T.,14,0,60,46
1658099885730,COGS 118A,A01,083075,Gupta; Anjum,21,0,76,55
1658099891753,CSE 3,A50,083646,Miranda; Gregory Joseph,24,0,50,26
1658099897784,CSE 8A,A50,083650,Miranda; Gregory Joseph,17,1,56,39
1658099903809,CSE 11,A01,083080,Cao; Yingjun,7,15,40,33
1658099909832,CSE 12,A01,083652,Krause-Levy; Sophia Louisa,30,1,120,90
1658099915873,CSE 15L,A01,083654,Morris; Justin Loren,9,0,50,41
1658099915873,CSE 15L,A02,083655,Morris; Justin Loren,11,0,50,39
1658099921900,CSE 20,A01,083657,Tran; Khoa Dang,39,0,80,41
1658099927928,CSE 21,A01,095574,Bach; Quang Tran,23,0,48,25
1658099933953,CSE 30,A01,083084,Eldon; John,8,0,80,72
1658099933953,CSE 30,B01,095061,Bhaskar; Nishant,9,0,50,41
1658099939975,CSE 100,A01,083659,Cao; Yingjun,5,4,70,65
1658099946001,CSE 134B,A01,083661,Powell; Thomas Allan,25,0,100,75
1658099952025,CSE 140,A01,083663,Gungor; Onat,17,0,85,68
1658099958049,CSE 140L,A01,083088,Eldon; John,23,0,100,77
1658099964072,CSE 175,A01,083665,Kumar; Rakesh,3,0,25,22
1658099970099,CSE 190,A00,092507,Dubnov; Shlomo,8,0,20,12
1658099976122,ECE 45,A01,083139,Congero; Spencer William,7,0,75,68
1658099982146,ECE 65,A50,083695,Saad; Andrew S,12,0,30,18
1658099982146,ECE 65,A51,095125,Saad; Andrew S,24,0,26,2
1658099988173,ECE 109,A01,091882,Touri; Behrouz,21,0,70,49
1658099994199,ECE 180,A00,083140,Abi Samra; Nicholas Camill,1,0,30,29
1658099994199,ECE 180,B00,083141,Abi Samra; Nicholas Camill,0,0,30,30
1658100000229,MATH 10A,A01,083735,Patchell; Gregory David,2,0,30,28
1658100000229,MATH 10A,A02,083736,Patchell; Gregory David,20,0,30,10
1658100000229,MATH 10A,A03,083737,Patchell; Gregory David,16,0,30,14
1658100006262,MATH 10B,A01,083207,Lim; Seonhee,9,0,34,25
1658100006262,MATH 10B,A02,083208,Lim; Seonhee,10,0,35,25
1658100006262,MATH 10B,A03,093472,Lim; Seonhee,7,0,34,27
1658100006262,MATH 10B,B01,083739,Sinha; Shubham,14,0,30,16
1658100012294,MATH 18,A01,083743,Cinel; Cameron Alexander,9,0,30,21
1658100012294,MATH 18,A02,083744,Cinel; Cameron Alexander,18,0,30,12
1658100012294,MATH 18,A03,083745,Cinel; Cameron Alexander,10,0,30,20
1658100012294,MATH 18,B01,083748,Rideout; David Porter,5,0,37,32
1658100012294,MATH 18,B02,083749,Rideout; David Porter,5,0,36,31
1658100012294,MATH 18,B03,083750,Rideout; David Porter,3,0,37,34
1658100012294,MATH 18,B04,083751,Rideout; David Porter,7,0,36,29
1658100012294,MATH 18,B05,093473,Rideout; David Porter,7,0,36,29
1658100012294,MATH 18,B06,093474,Rideout; David Porter,6,0,36,30
1658100018324,MATH 20A,A01,083754,Zheng; Zequn,14,0,40,26
1658100024356,MATH 20B,A01,083756,Briones; Jor-el Thomas Caparas,4,0,36,32
1658100024356,MATH 20B,A02,083757,Briones; Jor-el Thomas Caparas,1,0,36,35
1658100024356,MATH 20B,A03,093475,Briones; Jor-el Thomas Caparas,3,0,36,33
1658100030386,MATH 20C,A01,083760,Briones; Jor-el Thomas Caparas,1,0,35,34
1658100030386,MATH 20C,A02,083761,Briones; Jor-el Thomas Caparas,8,0,35,27
1658100030386,MATH 20C,A03,093476,Briones; Jor-el Thomas Caparas,0,1,36,36
1658100030386,MATH 20C,B01,083762,Bach; Quang Tran,1,0,30,29
1658100036418,MATH 20D,A01,083765,Tran; Brian Kha,5,0,30,25
1658100036418,MATH 20D,A02,083766,Tran; Brian Kha,5,0,30,25
1658100036418,MATH 20D,A03,083767,Tran; Brian Kha,6,0,30,24
1658100042445,MATH 20E,A01,083771,Ganguly; Soumya,12,0,32,20
1658100042445,MATH 20E,A02,083772,Ganguly; Soumya,7,0,32,25
1658100042445,MATH 20E,B01,083773,Ciotti; Benjamin,20,0,35,15
1658100042445,MATH 20E,B02,083774,Ciotti; Benjamin,18,0,35,17
1658100048471,MATH 103A,A01,083777,Greenfeld; Be'Eri,6,0,36,30
1658100048471,MATH 103A,A02,083778,Greenfeld; Be'Eri,5,0,36,31
1658100048471,MATH 103A,A03,093561,Greenfeld; Be'Eri,7,0,36,29
1658100048471,MATH 103A,B01,083779,Greenfeld; Be'Eri,8,0,36,28
1658100048471,MATH 103A,B02,083780,Greenfeld; Be'Eri,4,0,36,32
1658100048471,MATH 103A,B03,093562,Greenfeld; Be'Eri,3,0,36,33
1658100054494,MATH 105,A01,085443,Carter; Anne Toulson,15,0,35,20
1658100054494,MATH 105,A02,093477,Carter; Anne Toulson,20,0,35,15
1658100060517,MATH 109,A01,083213,Ganzberger; Geoffrey Michael,3,0,34,31
1658100060517,MATH 109,A02,083214,Ganzberger; Geoffrey Michael,4,0,34,30
1658100060517,MATH 109,A03,093478,Ganzberger; Geoffrey Michael,2,0,34,32
1658100060517,MATH 109,B01,083215,Ganzberger; Geoffrey Michael,3,0,32,29
1658100060517,MATH 109,B02,083216,Ganzberger; Geoffrey Michael,3,0,32,29
1658100060517,MATH 109,B03,093479,Ganzberger; Geoffrey Michael,8,0,32,24
1658100066548,MATH 142A,A01,083219,Chow; Bennett,7,0,32,25
1658100066548,MATH 142A,A02,083220,Chow; Bennett,10,0,32,22
1658100066548,MATH 142A,A03,093480,Chow; Bennett,9,0,32,23
1658100066548,MATH 142A,B03,093481,Chow; Bennett,8,0,32,24
1658100066548,MATH 142A,B04,093558,Chow; Bennett,14,0,32,18
1658100066548,MATH 142A,B05,093559,Chow; Bennett,7,0,32,25
1658100072584,MATH 193A,A01,083224,Rotar; Vladimir,9,0,34,25
1658100072584,MATH 193A,A02,083225,Rotar; Vladimir,11,0,34,23
1658100072584,MATH 193A,A03,083781,Rotar; Vladimir,5,0,34,29
1658100072584,MATH 193A,A04,083782,Rotar; Vladimir,12,0,34,22
1658100072584,MATH 193A,A05,093482,Rotar; Vladimir,11,0,34,23
1658100078611,MATH 197,001,091859,McAuley; Julian John,9999,0,9999,0
1658100078611,MATH 197,002,095566,Kedlaya; Kiran S.,9997,0,9999,2
1658100078611,MATH 197,003,095567,Xiao; Ming,9999,0,9999,0
1658100078611,MATH 197,004,095571,Perols; Johan Lars,9998,0,9999,1
1658100085663,COGS 9,A01,083615,Shannon; Kyle Michael,11,0,75,64
1658100091686,COGS 11,A01,083617,Boyle; Mary E. T.,23,0,48,25
1658100097717,COGS 13,A01,083071,Bastos; Amalia Pinkusfeld,12,0,71,59
1658100103740,COGS 14A,A01,092681,Semenuks; Arturs,5,1,100,95
1658100109770,COGS 14B,A01,083073,Cheng; Tzu-Han,7,0,63,56
1658100115792,COGS 17,A01,092677,Semenuks; Arturs,7,0,81,74
1658100121823,COGS 100,A01,083619,Allen; Michael Gordon,17,0,70,53
1658100127850,COGS 101A,A01,083621,Davis; Joshua Daniel,9,0,68,59
1658100133878,COGS 101B,A01,091572,Allen; Michael Gordon,14,0,65,51
1658100139901,COGS 101C,A01,083625,Delgado; Tania,17,0,35,18
1658100145929,COGS 107A,A01,083627,Boyle; Mary E. T.,14,0,60,46
1658100151965,COGS 118A,A01,083075,Gupta; Anjum,21,0,76,55
1658100157995,CSE 3,A50,083646,Miranda; Gregory Joseph,24,0,50,26
1658100164020,CSE 8A,A50,083650,Miranda; Gregory Joseph,17,1,56,39
1658100170043,CSE 11,A01,083080,Cao; Yingjun,7,15,40,33
1658100176067,CSE 12,A01,083652,Krause-Levy; Sophia Louisa,30,1,120,90
1658100182091,CSE 15L,A01,083654,Morris; Justin Loren,9,0,50,41
1658100182091,CSE 15L,A02,083655,Morris; Justin Loren,11,0,50,39
1658100188120,CSE 20,A01,083657,Tran; Khoa Dang,39,0,80,41
1658100194144,CSE 21,A01,095574,Bach; Quang Tran,23,0,48,25
1658100200173,CSE 30,A01,083084,Eldon; John,8,0,80,72
1658100200173,CSE 30,B01,095061,Bhaskar; Nishant,9,0,50,41
1658100206196,CSE 100,A01,083659,Cao; Yingjun,5,4,70,65
1658100212223,CSE 134B,A01,083661,Powell; Thomas Allan,25,0,100,75
1658100218250,CSE 140,A01,083663,Gungor; Onat,17,0,85,68
1658100224364,CSE 140L,A01,083088,Eldon; John,23,0,100,77
1658100230387,CSE 175,A01,083665,Kumar; Rakesh,3,0,25,22
1658100236411,CSE 190,A00,092507,Dubnov; Shlomo,8,0,20,12
1658100242437,ECE 45,A01,083139,Congero; Spencer William,7,0,75,68
1658100248462,ECE 65,A50,083695,Saad; Andrew S,12,0,30,18
1658100248462,ECE 65,A51,095125,Saad; Andrew S,24,0,26,2
1658100254485,ECE 109,A01,091882,Touri; Behrouz,21,0,70,49
1658100260519,ECE 180,A00,083140,Abi Samra; Nicholas Camill,1,0,30,29
1658100260519,ECE 180,B00,083141,Abi Samra; Nicholas Camill,0,0,30,30
1658100266543,MATH 10A,A01,083735,Patchell; Gregory David,2,0,30,28
1658100266543,MATH 10A,A02,083736,Patchell; Gregory David,20,0,30,10
1658100266543,MATH 10A,A03,083737,Patchell; Gregory David,16,0,30,14
1658100272567,MATH 10B,A01,083207,Lim; Seonhee,9,0,34,25
1658100272567,MATH 10B,A02,083208,Lim; Seonhee,10,0,35,25
1658100272567,MATH 10B,A03,093472,Lim; Seonhee,7,0,34,27
1658100272567,MATH 10B,B01,083739,Sinha; Shubham,14,0,30,16
1658100278592,MATH 18,A01,083743,Cinel; Cameron Alexander,9,0,30,21
1658100278592,MATH 18,A02,083744,Cinel; Cameron Alexander,18,0,30,12
1658100278592,MATH 18,A03,083745,Cinel; Cameron Alexander,10,0,30,20
1658100278592,MATH 18,B01,083748,Rideout; David Porter,5,0,37,32
1658100278592,MATH 18,B02,083749,Rideout; David Porter,5,0,36,31
1658100278592,MATH 18,B03,083750,Rideout; David Porter,3,0,37,34
1658100278592,MATH 18,B04,083751,Rideout; David Porter,7,0,36,29
1658100278592,MATH 18,B05,093473,Rideout; David Porter,7,0,36,29
1658100278592,MATH 18,B06,093474,Rideout; David Porter,6,0,36,30
1658100284619,MATH 20A,A01,083754,Zheng; Zequn,14,0,40,26
1658100290649,MATH 20B,A01,083756,Briones; Jor-el Thomas Caparas,4,0,36,32
1658100290649,MATH 20B,A02,083757,Briones; Jor-el Thomas Caparas,1,0,36,35
1658100290649,MATH 20B,A03,093475,Briones; Jor-el Thomas Caparas,3,0,36,33
1658100296678,MATH 20C,A01,083760,Briones; Jor-el Thomas Caparas,1,0,35,34
1658100296678,MATH 20C,A02,083761,Briones; Jor-el Thomas Caparas,8,0,35,27
1658100296678,MATH 20C,A03,093476,Briones; Jor-el Thomas Caparas,0,1,36,36
1658100296678,MATH 20C,B01,083762,Bach; Quang Tran,1,0,30,29
1658100302703,MATH 20D,A01,083765,Tran; Brian Kha,5,0,30,25
1658100302703,MATH 20D,A02,083766,Tran; Brian Kha,5,0,30,25
1658100302703,MATH 20D,A03,083767,Tran; Brian Kha,6,0,30,24
1658100308727,MATH 20E,A01,083771,Ganguly; Soumya,12,0,32,20
1658100308727,MATH 20E,A02,083772,Ganguly; Soumya,7,0,32,25
1658100308727,MATH 20E,B01,083773,Ciotti; Benjamin,20,0,35,15
1658100308727,MATH 20E,B02,083774,Ciotti; Benjamin,18,0,35,17
1658100314753,MATH 103A,A01,083777,Greenfeld; Be'Eri,6,0,36,30
1658100314753,MATH 103A,A02,083778,Greenfeld; Be'Eri,5,0,36,31
1658100314753,MATH 103A,A03,093561,Greenfeld; Be'Eri,7,0,36,29
1658100314753,MATH 103A,B01,083779,Greenfeld; Be'Eri,8,0,36,28
1658100314753,MATH 103A,B02,083780,Greenfeld; Be'Eri,4,0,36,32
1658100314753,MATH 103A,B03,093562,Greenfeld; Be'Eri,3,0,36,33
1658100320776,MATH 105,A01,085443,Carter; Anne Toulson,15,0,35,20
1658100320776,MATH 105,A02,093477,Carter; Anne Toulson,20,0,35,15
1658100326807,MATH 109,A01,083213,Ganzberger; Geoffrey Michael,3,0,34,31
1658100326807,MATH 109,A02,083214,Ganzberger; Geoffrey Michael,4,0,34,30
1658100326807,MATH 109,A03,093478,Ganzberger; Geoffrey Michael,2,0,34,32
1658100326807,MATH 109,B01,083215,Ganzberger; Geoffrey Michael,3,0,32,29
1658100326807,MATH 109,B02,083216,Ganzberger; Geoffrey Michael,3,0,32,29
1658100326807,MATH 109,B03,093479,Ganzberger; Geoffrey Michael,8,0,32,24
1658100332830,MATH 142A,A01,083219,Chow; Bennett,7,0,32,25
1658100332830,MATH 142A,A02,083220,Chow; Bennett,10,0,32,22
1658100332830,MATH 142A,A03,093480,Chow; Bennett,9,0,32,23
1658100332830,MATH 142A,B03,093481,Chow; Bennett,8,0,32,24
1658100332830,MATH 142A,B04,093558,Chow; Bennett,14,0,32,18
1658100332830,MATH 142A,B05,093559,Chow; Bennett,7,0,32,25
1658100338859,MATH 193A,A01,083224,Rotar; Vladimir,9,0,34,25
1658100338859,MATH 193A,A02,083225,Rotar; Vladimir,11,0,34,23
1658100338859,MATH 193A,A03,083781,Rotar; Vladimir,5,0,34,29
1658100338859,MATH 193A,A04,083782,Rotar; Vladimir,12,0,34,22
1658100338859,MATH 193A,A05,093482,Rotar; Vladimir,11,0,34,23
1658100344882,MATH 197,001,091859,McAuley; Julian John,9999,0,9999,0
1658100344882,MATH 197,002,095566,Kedlaya; Kiran S.,9997,0,9999,2
1658100344882,MATH 197,003,095567,Xiao; Ming,9999,0,9999,0
1658100344882,MATH 197,004,095571,Perols; Johan Lars,9998,0,9999,1
1658100351945,COGS 9,A01,083615,Shannon; Kyle Michael,11,0,75,64
1658100357986,COGS 11,A01,083617,Boyle; Mary E. T.,23,0,48,25
1658100364013,COGS 13,A01,083071,Bastos; Amalia Pinkusfeld,12,0,71,59
1658100370038,COGS 14A,A01,092681,Semenuks; Arturs,5,1,100,95
1658100376062,COGS 14B,A01,083073,Cheng; Tzu-Han,7,0,63,56
1658100382086,COGS 17,A01,092677,Semenuks; Arturs,7,0,81,74
1658100388109,COGS 100,A01,083619,Allen; Michael Gordon,17,0,70,53
1658100394132,COGS 101A,A01,083621,Davis; Joshua Daniel,9,0,68,59
1658100400155,COGS 101B,A01,091572,Allen; Michael Gordon,14,0,65,51
1658100406179,COGS 101C,A01,083625,Delgado; Tania,17,0,35,18
1658100412203,COGS 107A,A01,083627,Boyle; Mary E. T.,14,0,60,46
1658100418229,COGS 118A,A01,083075,Gupta; Anjum,21,0,76,55
1658100424258,CSE 3,A50,083646,Miranda; Gregory Joseph,24,0,50,26
1658100430291,CSE 8A,A50,083650,Miranda; Gregory Joseph,17,1,56,39
1658100436322,CSE 11,A01,083080,Cao; Yingjun,7,15,40,33
1658100442344,CSE 12,A01,083652,Krause-Levy; Sophia Louisa,30,1,120,90
1658100448371,CSE 15L,A01,083654,Morris; Justin Loren,9,0,50,41
1658100448371,CSE 15L,A02,083655,Morris; Justin Loren,11,0,50,39
1658100454395,CSE 20,A01,083657,Tran; Khoa Dang,39,0,80,41
1658100460420,CSE 21,A01,095574,Bach; Quang Tran,23,0,48,25
1658100466447,CSE 30,A01,083084,Eldon; John,8,0,80,72
1658100466447,CSE 30,B01,095061,Bhaskar; Nishant,9,0,50,41
1658100472474,CSE 100,A01,083659,Cao; Yingjun,5,4,70,65
1658100478497,CSE 134B,A01,083661,Powell; Thomas Allan,25,0,100,75
1658100484519,CSE 140,A01,083663,Gungor; Onat,17,0,85,68
1658100490542,CSE 140L,A01,083088,Eldon; John,23,0,100,77
1658100496571,CSE 175,A01,083665,Kumar; Rakesh,3,0,25,22
1658100502601,CSE 190,A00,092507,Dubnov; Shlomo,8,0,20,12
1658100508628,ECE 45,A01,083139,Congero; Spencer William,7,0,75,68
1658100514652,ECE 65,A50,083695,Saad; Andrew S,12,0,30,18
1658100514652,ECE 65,A51,095125,Saad; Andrew S,24,0,26,2
1658100520677,ECE 109,A01,091882,Touri; Behrouz,21,0,70,49
1658100526704,ECE 180,A00,083140,Abi Samra; Nicholas Camill,1,0,30,29
1658100526704,ECE 180,B00,083141,Abi Samra; Nicholas Camill,0,0,30,30
1658100532733,MATH 10A,A01,083735,Patchell; Gregory David,2,0,30,28
1658100532733,MATH 10A,A02,083736,Patchell; Gregory David,20,0,30,10
1658100532733,MATH 10A,A03,083737,Patchell; Gregory David,16,0,30,14
1658100538757,MATH 10B,A01,083207,Lim; Seonhee,9,0,34,25
1658100538757,MATH 10B,A02,083208,Lim; Seonhee,10,0,35,25
1658100538757,MATH 10B,A03,093472,Lim; Seonhee,7,0,34,27
1658100538757,MATH 10B,B01,083739,Sinha; Shubham,14,0,30,16
1658100544783,MATH 18,A01,083743,Cinel; Cameron Alexander,9,0,30,21
1658100544783,MATH 18,A02,083744,Cinel; Cameron Alexander,18,0,30,12
1658100544783,MATH 18,A03,083745,Cinel; Cameron Alexander,10,0,30,20
1658100544783,MATH 18,B01,083748,Rideout; David Porter,5,0,37,32
1658100544783,MATH 18,B02,083749,Rideout; David Porter,5,0,36,31
1658100544783,MATH 18,B03,083750,Rideout; David Porter,3,0,37,34
1658100544783,MATH 18,B04,083751,Rideout; David Porter,7,0,36,29
1658100544783,MATH 18,B05,093473,Rideout; David Porter,7,0,36,29
1658100544783,MATH 18,B06,093474,Rideout; David Porter,6,0,36,30
1658100550806,MATH 20A,A01,083754,Zheng; Zequn,14,0,40,26
1658100556833,MATH 20B,A01,083756,Briones; Jor-el Thomas Caparas,4,0,36,32
1658100556833,MATH 20B,A02,083757,Briones; Jor-el Thomas Caparas,1,0,36,35
1658100556833,MATH 20B,A03,093475,Briones; Jor-el Thomas Caparas,3,0,36,33
1658100562856,MATH 20C,A01,083760,Briones; Jor-el Thomas Caparas,1,0,35,34
1658100562856,MATH 20C,A02,083761,Briones; Jor-el Thomas Caparas,8,0,35,27
1658100562856,MATH 20C,A03,093476,Briones; Jor-el Thomas Caparas,0,1,36,36
1658100562856,MATH 20C,B01,083762,Bach; Quang Tran,1,0,30,29
1658100568879,MATH 20D,A01,083765,Tran; Brian Kha,5,0,30,25
1658100568879,MATH 20D,A02,083766,Tran; Brian Kha,5,0,30,25
1658100568879,MATH 20D,A03,083767,Tran; Brian Kha,6,0,30,24
1658100574903,MATH 20E,A01,083771,Ganguly; Soumya,12,0,32,20
1658100574903,MATH 20E,A02,083772,Ganguly; Soumya,7,0,32,25
1658100574903,MATH 20E,B01,083773,Ciotti; Benjamin,20,0,35,15
1658100574903,MATH 20E,B02,083774,Ciotti; Benjamin,18,0,35,17
1658100580925,MATH 103A,A01,083777,Greenfeld; Be'Eri,6,0,36,30
1658100580925,MATH 103A,A02,083778,Greenfeld; Be'Eri,5,0,36,31
1658100580925,MATH 103A,A03,093561,Greenfeld; Be'Eri,7,0,36,29
1658100580925,MATH 103A,B01,083779,Greenfeld; Be'Eri,8,0,36,28
1658100580925,MATH 103A,B02,083780,Greenfeld; Be'Eri,4,0,36,32
1658100580925,MATH 103A,B03,093562,Greenfeld; Be'Eri,3,0,36,33
1658100586952,MATH 105,A01,085443,Carter; Anne Toulson,15,0,35,20
1658100586952,MATH 105,A02,093477,Carter; Anne Toulson,20,0,35,15
1658100592976,MATH 109,A01,083213,Ganzberger; Geoffrey Michael,3,0,34,31
1658100592976,MATH 109,A02,083214,Ganzberger; Geoffrey Michael,4,0,34,30
1658100592976,MATH 109,A03,093478,Ganzberger; Geoffrey Michael,2,0,34,32
1658100592976,MATH 109,B01,083215,Ganzberger; Geoffrey Michael,3,0,32,29
1658100592976,MATH 109,B02,083216,Ganzberger; Geoffrey Michael,3,0,32,29
1658100592976,MATH 109,B03,093479,Ganzberger; Geoffrey Michael,8,0,32,24
1658100599005,MATH 142A,A01,083219,Chow; Bennett,7,0,32,25
1658100599005,MATH 142A,A02,083220,Chow; Bennett,10,0,32,22
1658100599005,MATH 142A,A03,093480,Chow; Bennett,9,0,32,23
1658100599005,MATH 142A,B03,093481,Chow; Bennett,8,0,32,24
1658100599005,MATH 142A,B04,093558,Chow; Bennett,14,0,32,18
1658100599005,MATH 142A,B05,093559,Chow; Bennett,7,0,32,25
1658100605027,MATH 193A,A01,083224,Rotar; Vladimir,9,0,34,25
1658100605027,MATH 193A,A02,083225,Rotar; Vladimir,11,0,34,23
1658100605027,MATH 193A,A03,083781,Rotar; Vladimir,5,0,34,29
1658100605027,MATH 193A,A04,083782,Rotar; Vladimir,12,0,34,22
1658100605027,MATH 193A,A05,093482,Rotar; Vladimir,11,0,34,23
1658100611051,MATH 197,001,091859,McAuley; Julian John,9999,0,9999,0
1658100611051,MATH 197,002,095566,Kedlaya; Kiran S.,9997,0,9999,2
1658100611051,MATH 197,003,095567,Xiao; Ming,9999,0,9999,0
1658100611051,MATH 197,004,095571,Perols; Johan Lars,9998,0,9999,1
1658100618105,COGS 9,A01,083615,Shannon; Kyle Michael,11,0,75,64
1658100624129,COGS 11,A01,083617,Boyle; Mary E. T.,23,0,48,25
1658100630158,COGS 13,A01,083071,Bastos; Amalia Pinkusfeld,12,0,71,59
1658100636182,COGS 14A,A01,092681,Semenuks; Arturs,5,1,100,95
1658100642207,COGS 14B,A01,083073,Cheng; Tzu-Han,7,0,63,56
1658100648230,COGS 17,A01,092677,Semenuks; Arturs,7,0,81,74
1658100654258,COGS 100,A01,083619,Allen; Michael Gordon,17,0,70,53
1658100660284,COGS 101A,A01,083621,Davis; Joshua Daniel,9,0,68,59
1658100666317,COGS 101B,A01,091572,Allen; Michael Gordon,14,0,65,51
1658100672343,COGS 101C,A01,083625,Delgado; Tania,17,0,35,18
1658100678366,COGS 107A,A01,083627,Boyle; Mary E. T.,14,0,60,46
1658100684393,COGS 118A,A01,083075,Gupta; Anjum,21,0,76,55
1658100690421,CSE 3,A50,083646,Miranda; Gregory Joseph,24,0,50,26
1658100696446,CSE 8A,A50,083650,Miranda; Gregory Joseph,17,1,56,39
1658100702473,CSE 11,A01,083080,Cao; Yingjun,7,15,40,33
1658100708506,CSE 12,A01,083652,Krause-Levy; Sophia Louisa,30,1,120,90
1658100714533,CSE 15L,A01,083654,Morris; Justin Loren,9,0,50,41
1658100714533,CSE 15L,A02,083655,Morris; Justin Loren,11,0,50,39
1658100720563,CSE 20,A01,083657,Tran; Khoa Dang,39,0,80,41
1658100726586,CSE 21,A01,095574,Bach; Quang Tran,23,0,48,25
1658100732615,CSE 30,A01,083084,Eldon; John,8,0,80,72
1658100732615,CSE 30,B01,095061,Bhaskar; Nishant,9,0,50,41
1658100738638,CSE 100,A01,083659,Cao; Yingjun,5,4,70,65
1658100744664,CSE 134B,A01,083661,Powell; Thomas Allan,25,0,100,75
1658100750691,CSE 140,A01,083663,Gungor; Onat,17,0,85,68
1658100756714,CSE 140L,A01,083088,Eldon; John,23,0,100,77
1658100762742,CSE 175,A01,083665,Kumar; Rakesh,3,0,25,22
1658100768764,CSE 190,A00,092507,Dubnov; Shlomo,8,0,20,12
1658100774788,ECE 45,A01,083139,Congero; Spencer William,7,0,75,68
1658100780813,ECE 65,A50,083695,Saad; Andrew S,12,0,30,18
1658100780813,ECE 65,A51,095125,Saad; Andrew S,24,0,26,2
1658100786836,ECE 109,A01,091882,Touri; Behrouz,21,0,70,49
1658100792864,ECE 180,A00,083140,Abi Samra; Nicholas Camill,1,0,30,29
1658100792864,ECE 180,B00,083141,Abi Samra; Nicholas Camill,0,0,30,30
1658100798886,MATH 10A,A01,083735,Patchell; Gregory David,2,0,30,28
1658100798886,MATH 10A,A02,083736,Patchell; Gregory David,20,0,30,10
1658100798886,MATH 10A,A03,083737,Patchell; Gregory David,16,0,30,14
1658100804911,MATH 10B,A01,083207,Lim; Seonhee,9,0,34,25
1658100804911,MATH 10B,A02,083208,Lim; Seonhee,10,0,35,25
1658100804911,MATH 10B,A03,093472,Lim; Seonhee,7,0,34,27
1658100804911,MATH 10B,B01,083739,Sinha; Shubham,14,0,30,16
1658100810941,MATH 18,A01,083743,Cinel; Cameron Alexander,9,0,30,21
1658100810941,MATH 18,A02,083744,Cinel; Cameron Alexander,18,0,30,12
1658100810941,MATH 18,A03,083745,Cinel; Cameron Alexander,10,0,30,20
1658100810941,MATH 18,B01,083748,Rideout; David Porter,5,0,37,32
1658100810941,MATH 18,B02,083749,Rideout; David Porter,5,0,36,31
1658100810941,MATH 18,B03,083750,Rideout; David Porter,3,0,37,34
1658100810941,MATH 18,B04,083751,Rideout; David Porter,7,0,36,29
1658100810941,MATH 18,B05,093473,Rideout; David Porter,7,0,36,29
1658100810941,MATH 18,B06,093474,Rideout; David Porter,6,0,36,30
1658100816964,MATH 20A,A01,083754,Zheng; Zequn,14,0,40,26
1658100823091,MATH 20B,A01,083756,Briones; Jor-el Thomas Caparas,4,0,36,32
1658100823091,MATH 20B,A02,083757,Briones; Jor-el Thomas Caparas,1,0,36,35
1658100823091,MATH 20B,A03,093475,Briones; Jor-el Thomas Caparas,3,0,36,33
1658100829116,MATH 20C,A01,083760,Briones; Jor-el Thomas Caparas,1,0,35,34
1658100829116,MATH 20C,A02,083761,Briones; Jor-el Thomas Caparas,8,0,35,27
1658100829116,MATH 20C,A03,093476,Briones; Jor-el Thomas Caparas,0,1,36,36
1658100829116,MATH 20C,B01,083762,Bach; Quang Tran,1,0,30,29
1658100835146,MATH 20D,A01,083765,Tran; Brian Kha,5,0,30,25
1658100835146,MATH 20D,A02,083766,Tran; Brian Kha,5,0,30,25
1658100835146,MATH 20D,A03,083767,Tran; Brian Kha,6,0,30,24
1658100841171,MATH 20E,A01,083771,Ganguly; Soumya,12,0,32,20
1658100841171,MATH 20E,A02,083772,Ganguly; Soumya,7,0,32,25
1658100841171,MATH 20E,B01,083773,Ciotti; Benjamin,20,0,35,15
1658100841171,MATH 20E,B02,083774,Ciotti; Benjamin,18,0,35,17
1658100847195,MATH 103A,A01,083777,Greenfeld; Be'Eri,6,0,36,30
1658100847195,MATH 103A,A02,083778,Greenfeld; Be'Eri,5,0,36,31
1658100847195,MATH 103A,A03,093561,Greenfeld; Be'Eri,7,0,36,29
1658100847195,MATH 103A,B01,083779,Greenfeld; Be'Eri,8,0,36,28
1658100847195,MATH 103A,B02,083780,Greenfeld; Be'Eri,4,0,36,32
1658100847195,MATH 103A,B03,093562,Greenfeld; Be'Eri,3,0,36,33
1658100853223,MATH 105,A01,085443,Carter; Anne Toulson,15,0,35,20
1658100853223,MATH 105,A02,093477,Carter; Anne Toulson,20,0,35,15
1658100859252,MATH 109,A01,083213,Ganzberger; Geoffrey Michael,3,0,34,31
1658100859252,MATH 109,A02,083214,Ganzberger; Geoffrey Michael,4,0,34,30
1658100859252,MATH 109,A03,093478,Ganzberger; Geoffrey Michael,2,0,34,32
1658100859252,MATH 109,B01,083215,Ganzberger; Geoffrey Michael,3,0,32,29
1658100859252,MATH 109,B02,083216,Ganzberger; Geoffrey Michael,3,0,32,29
1658100859252,MATH 109,B03,093479,Ganzberger; Geoffrey Michael,8,0,32,24
1658100865275,MATH 142A,A01,083219,Chow; Bennett,7,0,32,25
1658100865275,MATH 142A,A02,083220,Chow; Bennett,10,0,32,22
1658100865275,MATH 142A,A03,093480,Chow; Bennett,9,0,32,23
1658100865275,MATH 142A,B03,093481,Chow; Bennett,8,0,32,24
1658100865275,MATH 142A,B04,093558,Chow; Bennett,14,0,32,18
1658100865275,MATH 142A,B05,093559,Chow; Bennett,7,0,32,25
1658100871303,MATH 193A,A01,083224,Rotar; Vladimir,9,0,34,25
1658100871303,MATH 193A,A02,083225,Rotar; Vladimir,11,0,34,23
1658100871303,MATH 193A,A03,083781,Rotar; Vladimir,5,0,34,29
1658100871303,MATH 193A,A04,083782,Rotar; Vladimir,12,0,34,22
1658100871303,MATH 193A,A05,093482,Rotar; Vladimir,11,0,34,23
1658100877327,MATH 197,001,091859,McAuley; Julian John,9999,0,9999,0
1658100877327,MATH 197,002,095566,Kedlaya; Kiran S.,9997,0,9999,2
1658100877327,MATH 197,003,095567,Xiao; Ming,9999,0,9999,0
1658100877327,MATH 197,004,095571,Perols; Johan Lars,9998,0,9999,1
1658100884384,COGS 9,A01,083615,Shannon; Kyle Michael,11,0,75,64
1658100890408,COGS 11,A01,083617,Boyle; Mary E. T.,23,0,48,25
1658100896438,COGS 13,A01,083071,Bastos; Amalia Pinkusfeld,12,0,71,59
1658100902462,COGS 14A,A01,092681,Semenuks; Arturs,5,1,100,95
1658100908485,COGS 14B,A01,083073,Cheng; Tzu-Han,7,0,63,56
1658100914508,COGS 17,A01,092677,Semenuks; Arturs,7,0,81,74
1658100920531,COGS 100,A01,083619,Allen; Michael Gordon,17,0,70,53
1658100926559,COGS 101A,A01,083621,Davis; Joshua Daniel,9,0,68,59
1658100932582,COGS 101B,A01,091572,Allen; Michael Gordon,14,0,65,51
1658100938619,COGS 101C,A01,083625,Delgado; Tania,17,0,35,18
1658100944646,COGS 107A,A01,083627,Boyle; Mary E. T.,14,0,60,46
1658100950671,COGS 118A,A01,083075,Gupta; Anjum,21,0,76,55
1658100956698,CSE 3,A50,083646,Miranda; Gregory Joseph,24,0,50,26
1658100962720,CSE 8A,A50,083650,Miranda; Gregory Joseph,17,1,56,39
1658100968743,CSE 11,A01,083080,Cao; Yingjun,7,15,40,33
1658100974771,CSE 12,A01,083652,Krause-Levy; Sophia Louisa,30,1,120,90
1658100980794,CSE 15L,A01,083654,Morris; Justin Loren,9,0,50,41
1658100980794,CSE 15L,A02,083655,Morris; Justin Loren,11,0,50,39
1658100986821,CSE 20,A01,083657,Tran; Khoa Dang,39,0,80,41
1658100992844,CSE 21,A01,095574,Bach; Quang Tran,23,0,48,25
1658100998868,CSE 30,A01,083084,Eldon; John,8,0,80,72
1658100998868,CSE 30,B01,095061,Bhaskar; Nishant,9,0,50,41
1658101004891,CSE 100,A01,083659,Cao; Yingjun,5,4,70,65
1658101010919,CSE 134B,A01,083661,Powell; Thomas Allan,25,0,100,75
1658101016942,CSE 140,A01,083663,Gungor; Onat,17,0,85,68
1658101022965,CSE 140L,A01,083088,Eldon; John,23,0,100,77
1658101028987,CSE 175,A01,083665,Kumar; Rakesh,3,0,25,22
1658101035015,CSE 190,A00,092507,Dubnov; Shlomo,8,0,20,12
1658101041042,ECE 45,A01,083139,Congero; Spencer William,7,0,75,68
1658101047067,ECE 65,A50,083695,Saad; Andrew S,12,0,30,18
1658101047067,ECE 65,A51,095125,Saad; Andrew S,24,0,26,2
1658101053091,ECE 109,A01,091882,Touri; Behrouz,21,0,70,49
1658101059116,ECE 180,A00,083140,Abi Samra; Nicholas Camill,1,0,30,29
1658101059116,ECE 180,B00,083141,Abi Samra; Nicholas Camill,0,0,30,30
1658101065144,MATH 10A,A01,083735,Patchell; Gregory David,2,0,30,28
1658101065144,MATH 10A,A02,083736,Patchell; Gregory David,20,0,30,10
1658101065144,MATH 10A,A03,083737,Patchell; Gregory David,16,0,30,14
1658101071172,MATH 10B,A01,083207,Lim; Seonhee,9,0,34,25
1658101071172,MATH 10B,A02,083208,Lim; Seonhee,10,0,35,25
1658101071172,MATH 10B,A03,093472,Lim; Seonhee,7,0,34,27
1658101071172,MATH 10B,B01,083739,Sinha; Shubham,14,0,30,16
1658101077197,MATH 18,A01,083743,Cinel; Cameron Alexander,9,0,30,21
1658101077197,MATH 18,A02,083744,Cinel; Cameron Alexander,18,0,30,12
1658101077197,MATH 18,A03,083745,Cinel; Cameron Alexander,10,0,30,20
1658101077197,MATH 18,B01,083748,Rideout; David Porter,5,0,37,32
1658101077197,MATH 18,B02,083749,Rideout; David Porter,5,0,36,31
1658101077197,MATH 18,B03,083750,Rideout; David Porter,3,0,37,34
1658101077197,MATH 18,B04,083751,Rideout; David Porter,7,0,36,29
1658101077197,MATH 18,B05,093473,Rideout; David Porter,7,0,36,29
1658101077197,MATH 18,B06,093474,Rideout; David Porter,6,0,36,30
1658101083220,MATH 20A,A01,083754,Zheng; Zequn,14,0,40,26
1658101089244,MATH 20B,A01,083756,Briones; Jor-el Thomas Caparas,4,0,36,32
1658101089244,MATH 20B,A02,083757,Briones; Jor-el Thomas Caparas,1,0,36,35
1658101089244,MATH 20B,A03,093475,Briones; Jor-el Thomas Caparas,3,0,36,33
1658101095269,MATH 20C,A01,083760,Briones; Jor-el Thomas Caparas,1,0,35,34
1658101095269,MATH 20C,A02,083761,Briones; Jor-el Thomas Caparas,8,0,35,27
1658101095269,MATH 20C,A03,093476,Briones; Jor-el Thomas Caparas,0,1,36,36
1658101095269,MATH 20C,B01,083762,Bach; Quang Tran,1,0,30,29
1658101101298,MATH 20D,A01,083765,Tran; Brian Kha,5,0,30,25
1658101101298,MATH 20D,A02,083766,Tran; Brian Kha,5,0,30,25
1658101101298,MATH 20D,A03,083767,Tran; Brian Kha,6,0,30,24
1658101107324,MATH 20E,A01,083771,Ganguly; Soumya,12,0,32,20
1658101107324,MATH 20E,A02,083772,Ganguly; Soumya,7,0,32,25
1658101107324,MATH 20E,B01,083773,Ciotti; Benjamin,20,0,35,15
1658101107324,MATH 20E,B02,083774,Ciotti; Benjamin,18,0,35,17
1658101113355,MATH 103A,A01,083777,Greenfeld; Be'Eri,6,0,36,30
1658101113355,MATH 103A,A02,083778,Greenfeld; Be'Eri,5,0,36,31
1658101113355,MATH 103A,A03,093561,Greenfeld; Be'Eri,7,0,36,29
1658101113355,MATH 103A,B01,083779,Greenfeld; Be'Eri,8,0,36,28
1658101113355,MATH 103A,B02,083780,Greenfeld; Be'Eri,4,0,36,32
1658101113355,MATH 103A,B03,093562,Greenfeld; Be'Eri,3,0,36,33
1658101119379,MATH 105,A01,085443,Carter; Anne Toulson,15,0,35,20
1658101119379,MATH 105,A02,093477,Carter; Anne Toulson,20,0,35,15
1658101125408,MATH 109,A01,083213,Ganzberger; Geoffrey Michael,3,0,34,31
1658101125408,MATH 109,A02,083214,Ganzberger; Geoffrey Michael,4,0,34,30
1658101125408,MATH 109,A03,093478,Ganzberger; Geoffrey Michael,2,0,34,32
1658101125408,MATH 109,B01,083215,Ganzberger; Geoffrey Michael,3,0,32,29
1658101125408,MATH 109,B02,083216,Ganzberger; Geoffrey Michael,3,0,32,29
1658101125408,MATH 109,B03,093479,Ganzberger; Geoffrey Michael,8,0,32,24
1658101131437,MATH 142A,A01,083219,Chow; Bennett,7,0,32,25
1658101131437,MATH 142A,A02,083220,Chow; Bennett,10,0,32,22
1658101131437,MATH 142A,A03,093480,Chow; Bennett,9,0,32,23
1658101131437,MATH 142A,B03,093481,Chow; Bennett,8,0,32,24
1658101131437,MATH 142A,B04,093558,Chow; Bennett,14,0,32,18
1658101131437,MATH 142A,B05,093559,Chow; Bennett,7,0,32,25
1658101137466,MATH 193A,A01,083224,Rotar; Vladimir,9,0,34,25
1658101137466,MATH 193A,A02,083225,Rotar; Vladimir,11,0,34,23
1658101137466,MATH 193A,A03,083781,Rotar; Vladimir,5,0,34,29
1658101137466,MATH 193A,A04,083782,Rotar; Vladimir,12,0,34,22
1658101137466,MATH 193A,A05,093482,Rotar; Vladimir,11,0,34,23
1658101143491,MATH 197,001,091859,McAuley; Julian John,9999,0,9999,0
1658101143491,MATH 197,002,095566,Kedlaya; Kiran S.,9997,0,9999,2
1658101143491,MATH 197,003,095567,Xiao; Ming,9999,0,9999,0
1658101143491,MATH 197,004,095571,Perols; Johan Lars,9998,0,9999,1
1658101150549,COGS 9,A01,083615,Shannon; Kyle Michael,11,0,75,64
1658101156577,COGS 11,A01,083617,Boyle; Mary E. T.,23,0,48,25
1658101162600,COGS 13,A01,083071,Bastos; Amalia Pinkusfeld,12,0,71,59
1658101168626,COGS 14A,A01,092681,Semenuks; Arturs,5,1,100,95
1658101174648,COGS 14B,A01,083073,Cheng; Tzu-Han,7,0,63,56
1658101180674,COGS 17,A01,092677,Semenuks; Arturs,7,0,81,74
1658101186696,COGS 100,A01,083619,Allen; Michael Gordon,17,0,70,53
1658101192728,COGS 101A,A01,083621,Davis; Joshua Daniel,9,0,68,59
1658101198749,COGS 101B,A01,091572,Allen; Michael Gordon,14,0,65,51
1658101204771,COGS 101C,A01,083625,Delgado; Tania,17,0,35,18
1658101210796,COGS 107A,A01,083627,Boyle; Mary E. T.,14,0,60,46
1658101216822,COGS 118A,A01,083075,Gupta; Anjum,21,0,76,55
1658101222848,CSE 3,A50,083646,Miranda; Gregory Joseph,24,0,50,26
1658101228871,CSE 8A,A50,083650,Miranda; Gregory Joseph,17,1,56,39
1658101234895,CSE 11,A01,083080,Cao; Yingjun,7,15,40,33
1658101240916,CSE 12,A01,083652,Krause-Levy; Sophia Louisa,30,1,120,90
1658101246940,CSE 15L,A01,083654,Morris; Justin Loren,9,0,50,41
1658101246940,CSE 15L,A02,083655,Morris; Justin Loren,11,0,50,39
1658101252963,CSE 20,A01,083657,Tran; Khoa Dang,39,0,80,41
1658101258991,CSE 21,A01,095574,Bach; Quang Tran,23,0,48,25
1658101265017,CSE 30,A01,083084,Eldon; John,8,0,80,72
1658101265017,CSE 30,B01,095061,Bhaskar; Nishant,9,0,50,41
1658101271040,CSE 100,A01,083659,Cao; Yingjun,5,4,70,65
1658101277063,CSE 134B,A01,083661,Powell; Thomas Allan,25,0,100,75
1658101283087,CSE 140,A01,083663,Gungor; Onat,17,0,85,68
1658101289114,CSE 140L,A01,083088,Eldon; John,23,0,100,77
1658101295136,CSE 175,A01,083665,Kumar; Rakesh,3,0,25,22
1658101301160,CSE 190,A00,092507,Dubnov; Shlomo,8,0,20,12
1658101307183,ECE 45,A01,083139,Congero; Spencer William,7,0,75,68
1658101313209,ECE 65,A50,083695,Saad; Andrew S,12,0,30,18
1658101313209,ECE 65,A51,095125,Saad; Andrew S,24,0,26,2
1658101319233,ECE 109,A01,091882,Touri; Behrouz,21,0,70,49
1658101325268,ECE 180,A00,083140,Abi Samra; Nicholas Camill,1,0,30,29
1658101325268,ECE 180,B00,083141,Abi Samra; Nicholas Camill,0,0,30,30
1658101331291,MATH 10A,A01,083735,Patchell; Gregory David,2,0,30,28
1658101331291,MATH 10A,A02,083736,Patchell; Gregory David,20,0,30,10
1658101331291,MATH 10A,A03,083737,Patchell; Gregory David,16,0,30,14
1658101337320,MATH 10B,A01,083207,Lim; Seonhee,9,0,34,25
1658101337320,MATH 10B,A02,083208,Lim; Seonhee,10,0,35,25
1658101337320,MATH 10B,A03,093472,Lim; Seonhee,7,0,34,27
1658101337320,MATH 10B,B01,083739,Sinha; Shubham,14,0,30,16
1658101343342,MATH 18,A01,083743,Cinel; Cameron Alexander,9,0,30,21
1658101343342,MATH 18,A02,083744,Cinel; Cameron Alexander,18,0,30,12
1658101343342,MATH 18,A03,083745,Cinel; Cameron Alexander,10,0,30,20
1658101343342,MATH 18,B01,083748,Rideout; David Porter,5,0,37,32
1658101343342,MATH 18,B02,083749,Rideout; David Porter,5,0,36,31
1658101343342,MATH 18,B03,083750,Rideout; David Porter,3,0,37,34
1658101343342,MATH 18,B04,083751,Rideout; David Porter,7,0,36,29
1658101343342,MATH 18,B05,093473,Rideout; David Porter,7,0,36,29
1658101343342,MATH 18,B06,093474,Rideout; David Porter,6,0,36,30
1658101349367,MATH 20A,A01,083754,Zheng; Zequn,14,0,40,26
1658101355390,MATH 20B,A01,083756,Briones; Jor-el Thomas Caparas,4,0,36,32
1658101355390,MATH 20B,A02,083757,Briones; Jor-el Thomas Caparas,1,0,36,35
1658101355390,MATH 20B,A03,093475,Briones; Jor-el Thomas Caparas,3,0,36,33
1658101361418,MATH 20C,A01,083760,Briones; Jor-el Thomas Caparas,1,0,35,34
1658101361418,MATH 20C,A02,083761,Briones; Jor-el Thomas Caparas,8,0,35,27
1658101361418,MATH 20C,A03,093476,Briones; Jor-el Thomas Caparas,0,1,36,36
1658101361418,MATH 20C,B01,083762,Bach; Quang Tran,1,0,30,29
1658101367442,MATH 20D,A01,083765,Tran; Brian Kha,5,0,30,25
1658101367442,MATH 20D,A02,083766,Tran; Brian Kha,5,0,30,25
1658101367442,MATH 20D,A03,083767,Tran; Brian Kha,6,0,30,24
1658101373466,MATH 20E,A01,083771,Ganguly; Soumya,12,0,32,20
1658101373466,MATH 20E,A02,083772,Ganguly; Soumya,7,0,32,25
1658101373466,MATH 20E,B01,083773,Ciotti; Benjamin,20,0,35,15
1658101373466,MATH 20E,B02,083774,Ciotti; Benjamin,18,0,35,17
1658101379495,MATH 103A,A01,083777,Greenfeld; Be'Eri,6,0,36,30
1658101379495,MATH 103A,A02,083778,Greenfeld; Be'Eri,5,0,36,31
1658101379495,MATH 103A,A03,093561,Greenfeld; Be'Eri,7,0,36,29
1658101379495,MATH 103A,B01,083779,Greenfeld; Be'Eri,8,0,36,28
1658101379495,MATH 103A,B02,083780,Greenfeld; Be'Eri,4,0,36,32
1658101379495,MATH 103A,B03,093562,Greenfeld; Be'Eri,3,0,36,33
1658101385517,MATH 105,A01,085443,Carter; Anne Toulson,15,0,35,20
1658101385517,MATH 105,A02,093477,Carter; Anne Toulson,20,0,35,15
1658101391540,MATH 109,A01,083213,Ganzberger; Geoffrey Michael,3,0,34,31
1658101391540,MATH 109,A02,083214,Ganzberger; Geoffrey Michael,4,0,34,30
1658101391540,MATH 109,A03,093478,Ganzberger; Geoffrey Michael,2,0,34,32
1658101391540,MATH 109,B01,083215,Ganzberger; Geoffrey Michael,3,0,32,29
1658101391540,MATH 109,B02,083216,Ganzberger; Geoffrey Michael,3,0,32,29
1658101391540,MATH 109,B03,093479,Ganzberger; Geoffrey Michael,8,0,32,24
1658101397580,MATH 142A,A01,083219,Chow; Bennett,7,0,32,25
1658101397580,MATH 142A,A02,083220,Chow; Bennett,10,0,32,22
1658101397580,MATH 142A,A03,093480,Chow; Bennett,9,0,32,23
1658101397580,MATH 142A,B03,093481,Chow; Bennett,8,0,32,24
1658101397580,MATH 142A,B04,093558,Chow; Bennett,14,0,32,18
1658101397580,MATH 142A,B05,093559,Chow; Bennett,7,0,32,25
1658101403603,MATH 193A,A01,083224,Rotar; Vladimir,9,0,34,25
1658101403603,MATH 193A,A02,083225,Rotar; Vladimir,11,0,34,23
1658101403603,MATH 193A,A03,083781,Rotar; Vladimir,5,0,34,29
1658101403603,MATH 193A,A04,083782,Rotar; Vladimir,12,0,34,22
1658101403603,MATH 193A,A05,093482,Rotar; Vladimir,11,0,34,23
1658101409628,MATH 197,001,091859,McAuley; Julian John,9999,0,9999,0
1658101409628,MATH 197,002,095566,Kedlaya; Kiran S.,9997,0,9999,2
1658101409628,MATH 197,003,095567,Xiao; Ming,9999,0,9999,0
1658101409628,MATH 197,004,095571,Perols; Johan Lars,9998,0,9999,1
1658101416778,COGS 9,A01,083615,Shannon; Kyle Michael,11,0,75,64
1658101422805,COGS 11,A01,083617,Boyle; Mary E. T.,23,0,48,25
1658101428828,COGS 13,A01,083071,Bastos; Amalia Pinkusfeld,12,0,71,59
1658101434852,COGS 14A,A01,092681,Semenuks; Arturs,5,1,100,95
1658101440879,COGS 14B,A01,083073,Cheng; Tzu-Han,7,0,63,56
1658101446906,COGS 17,A01,092677,Semenuks; Arturs,7,0,81,74
1658101452930,COGS 100,A01,083619,Allen; Michael Gordon,17,0,70,53
1658101458955,COGS 101A,A01,083621,Davis; Joshua Daniel,9,0,68,59
1658101464978,COGS 101B,A01,091572,Allen; Michael Gordon,14,0,65,51
1658101471002,COGS 101C,A01,083625,Delgado; Tania,17,0,35,18
1658101477025,COGS 107A,A01,083627,Boyle; Mary E. T.,14,0,60,46
1658101483052,COGS 118A,A01,083075,Gupta; Anjum,21,0,76,55
1658101489076,CSE 3,A50,083646,Miranda; Gregory Joseph,24,0,50,26
1658101495100,CSE 8A,A50,083650,Miranda; Gregory Joseph,17,1,56,39
1658101501126,CSE 11,A01,083080,Cao; Yingjun,7,15,40,33
1658101507150,CSE 12,A01,083652,Krause-Levy; Sophia Louisa,30,1,120,90
1658101513173,CSE 15L,A01,083654,Morris; Justin Loren,9,0,50,41
1658101513173,CSE 15L,A02,083655,Morris; Justin Loren,11,0,50,39
1658101519198,CSE 20,A01,083657,Tran; Khoa Dang,39,0,80,41
1658101525221,CSE 21,A01,095574,Bach; Quang Tran,23,0,48,25
1658101531255,CSE 30,A01,083084,Eldon; John,8,0,80,72
1658101531255,CSE 30,B01,095061,Bhaskar; Nishant,9,0,50,41
1658101537283,CSE 100,A01,083659,Cao; Yingjun,5,4,70,65
1658101543309,CSE 134B,A01,083661,Powell; Thomas Allan,25,0,100,75
1658101549334,CSE 140,A01,083663,Gungor; Onat,17,0,85,68
1658101555358,CSE 140L,A01,083088,Eldon; John,23,0,100,77
1658101561381,CSE 175,A01,083665,Kumar; Rakesh,3,0,25,22
1658101567404,CSE 190,A00,092507,Dubnov; Shlomo,8,0,20,12
1658101573427,ECE 45,A01,083139,Congero; Spencer William,7,0,75,68
1658101579459,ECE 65,A50,083695,Saad; Andrew S,12,0,30,18
1658101579459,ECE 65,A51,095125,Saad; Andrew S,24,0,26,2
1658101585483,ECE 109,A01,091882,Touri; Behrouz,21,0,70,49
1658101591505,ECE 180,A00,083140,Abi Samra; Nicholas Camill,1,0,30,29
1658101591505,ECE 180,B00,083141,Abi Samra; Nicholas Camill,0,0,30,30
1658101597538,MATH 10A,A01,083735,Patchell; Gregory David,2,0,30,28
1658101597538,MATH 10A,A02,083736,Patchell; Gregory David,20,0,30,10
1658101597538,MATH 10A,A03,083737,Patchell; Gregory David,16,0,30,14
1658101603563,MATH 10B,A01,083207,Lim; Seonhee,9,0,34,25
1658101603563,MATH 10B,A02,083208,Lim; Seonhee,10,0,35,25
1658101603563,MATH 10B,A03,093472,Lim; Seonhee,7,0,34,27
1658101603563,MATH 10B,B01,083739,Sinha; Shubham,14,0,30,16
1658101609588,MATH 18,A01,083743,Cinel; Cameron Alexander,9,0,30,21
1658101609588,MATH 18,A02,083744,Cinel; Cameron Alexander,18,0,30,12
1658101609588,MATH 18,A03,083745,Cinel; Cameron Alexander,10,0,30,20
1658101609588,MATH 18,B01,083748,Rideout; David Porter,5,0,37,32
1658101609588,MATH 18,B02,083749,Rideout; David Porter,5,0,36,31
1658101609588,MATH 18,B03,083750,Rideout; David Porter,3,0,37,34
1658101609588,MATH 18,B04,083751,Rideout; David Porter,7,0,36,29
1658101609588,MATH 18,B05,093473,Rideout; David Porter,7,0,36,29
1658101609588,MATH 18,B06,093474,Rideout; David Porter,6,0,36,30
1658101615616,MATH 20A,A01,083754,Zheng; Zequn,14,0,40,26
1658101621639,MATH 20B,A01,083756,Briones; Jor-el Thomas Caparas,4,0,36,32
1658101621639,MATH 20B,A02,083757,Briones; Jor-el Thomas Caparas,1,0,36,35
1658101621639,MATH 20B,A03,093475,Briones; Jor-el Thomas Caparas,3,0,36,33
1658101627663,MATH 20C,A01,083760,Briones; Jor-el Thomas Caparas,1,0,35,34
1658101627663,MATH 20C,A02,083761,Briones; Jor-el Thomas Caparas,8,0,35,27
1658101627663,MATH 20C,A03,093476,Briones; Jor-el Thomas Caparas,0,1,36,36
1658101627663,MATH 20C,B01,083762,Bach; Quang Tran,1,0,30,29
1658101633698,MATH 20D,A01,083765,Tran; Brian Kha,5,0,30,25
1658101633698,MATH 20D,A02,083766,Tran; Brian Kha,5,0,30,25
1658101633698,MATH 20D,A03,083767,Tran; Brian Kha,6,0,30,24
1658101639726,MATH 20E,A01,083771,Ganguly; Soumya,12,0,32,20
1658101639726,MATH 20E,A02,083772,Ganguly; Soumya,7,0,32,25
1658101639726,MATH 20E,B01,083773,Ciotti; Benjamin,20,0,35,15
1658101639726,MATH 20E,B02,083774,Ciotti; Benjamin,18,0,35,17
1658101645756,MATH 103A,A01,083777,Greenfeld; Be'Eri,6,0,36,30
1658101645756,MATH 103A,A02,083778,Greenfeld; Be'Eri,5,0,36,31
1658101645756,MATH 103A,A03,093561,Greenfeld; Be'Eri,7,0,36,29
1658101645756,MATH 103A,B01,083779,Greenfeld; Be'Eri,8,0,36,28
1658101645756,MATH 103A,B02,083780,Greenfeld; Be'Eri,4,0,36,32
1658101645756,MATH 103A,B03,093562,Greenfeld; Be'Eri,3,0,36,33
1658101651784,MATH 105,A01,085443,Carter; Anne Toulson,15,0,35,20
1658101651784,MATH 105,A02,093477,Carter; Anne Toulson,20,0,35,15
1658101657811,MATH 109,A01,083213,Ganzberger; Geoffrey Michael,3,0,34,31
1658101657811,MATH 109,A02,083214,Ganzberger; Geoffrey Michael,4,0,34,30
1658101657811,MATH 109,A03,093478,Ganzberger; Geoffrey Michael,2,0,34,32
1658101657811,MATH 109,B01,083215,Ganzberger; Geoffrey Michael,3,0,32,29
1658101657811,MATH 109,B02,083216,Ganzberger; Geoffrey Michael,3,0,32,29
1658101657811,MATH 109,B03,093479,Ganzberger; Geoffrey Michael,8,0,32,24
1658101663835,MATH 142A,A01,083219,Chow; Bennett,7,0,32,25
1658101663835,MATH 142A,A02,083220,Chow; Bennett,10,0,32,22
1658101663835,MATH 142A,A03,093480,Chow; Bennett,9,0,32,23
1658101663835,MATH 142A,B03,093481,Chow; Bennett,8,0,32,24
1658101663835,MATH 142A,B04,093558,Chow; Bennett,14,0,32,18
1658101663835,MATH 142A,B05,093559,Chow; Bennett,7,0,32,25
1658101669858,MATH 193A,A01,083224,Rotar; Vladimir,9,0,34,25
1658101669858,MATH 193A,A02,083225,Rotar; Vladimir,11,0,34,23
1658101669858,MATH 193A,A03,083781,Rotar; Vladimir,5,0,34,29
1658101669858,MATH 193A,A04,083782,Rotar; Vladimir,12,0,34,22
1658101669858,MATH 193A,A05,093482,Rotar; Vladimir,11,0,34,23
1658101675880,MATH 197,001,091859,McAuley; Julian John,9999,0,9999,0
1658101675880,MATH 197,002,095566,Kedlaya; Kiran S.,9997,0,9999,2
1658101675880,MATH 197,003,095567,Xiao; Ming,9999,0,9999,0
1658101675880,MATH 197,004,095571,Perols; Johan Lars,9998,0,9999,1
1658101682935,COGS 9,A01,083615,Shannon; Kyle Michael,11,0,75,64
1658101688961,COGS 11,A01,083617,Boyle; Mary E. T.,23,0,48,25
1658101694985,COGS 13,A01,083071,Bastos; Amalia Pinkusfeld,12,0,71,59
1658101701008,COGS 14A,A01,092681,Semenuks; Arturs,5,1,100,95
1658101707031,COGS 14B,A01,083073,Cheng; Tzu-Han,7,0,63,56
1658101713059,COGS 17,A01,092677,Semenuks; Arturs,7,0,81,74
1658101719085,COGS 100,A01,083619,Allen; Michael Gordon,17,0,70,53
1658101725107,COGS 101A,A01,083621,Davis; Joshua Daniel,9,0,68,59
1658101731134,COGS 101B,A01,091572,Allen; Michael Gordon,14,0,65,51
1658101737160,COGS 101C,A01,083625,Delgado; Tania,17,0,35,18
1658101743188,COGS 107A,A01,083627,Boyle; Mary E. T.,14,0,60,46
1658101749216,COGS 118A,A01,083075,Gupta; Anjum,21,0,76,55
1658101755245,CSE 3,A50,083646,Miranda; Gregory Joseph,24,0,50,26
1658101761274,CSE 8A,A50,083650,Miranda; Gregory Joseph,17,1,56,39
1658101767295,CSE 11,A01,083080,Cao; Yingjun,7,15,40,33
1658101773326,CSE 12,A01,083652,Krause-Levy; Sophia Louisa,30,1,120,90
1658101779350,CSE 15L,A01,083654,Morris; Justin Loren,9,0,50,41
1658101779350,CSE 15L,A02,083655,Morris; Justin Loren,11,0,50,39
1658101785374,CSE 20,A01,083657,Tran; Khoa Dang,39,0,80,41
1658101791400,CSE 21,A01,095574,Bach; Quang Tran,23,0,48,25
1658101797429,CSE 30,A01,083084,Eldon; John,8,0,80,72
1658101797429,CSE 30,B01,095061,Bhaskar; Nishant,9,0,50,41
1658101803455,CSE 100,A01,083659,Cao; Yingjun,5,4,70,65
1658101809479,CSE 134B,A01,083661,Powell; Thomas Allan,25,0,100,75
1658101815502,CSE 140,A01,083663,Gungor; Onat,17,0,85,68
1658101821528,CSE 140L,A01,083088,Eldon; John,23,0,100,77
1658101827553,CSE 175,A01,083665,Kumar; Rakesh,3,0,25,22
1658101833576,CSE 190,A00,092507,Dubnov; Shlomo,8,0,20,12
1658101839600,ECE 45,A01,083139,Congero; Spencer William,7,0,75,68
1658101845621,ECE 65,A50,083695,Saad; Andrew S,12,0,30,18
1658101845621,ECE 65,A51,095125,Saad; Andrew S,24,0,26,2
1658101851645,ECE 109,A01,091882,Touri; Behrouz,21,0,70,49
1658101857668,ECE 180,A00,083140,Abi Samra; Nicholas Camill,1,0,30,29
1658101857668,ECE 180,B00,083141,Abi Samra; Nicholas Camill,0,0,30,30
1658101863692,MATH 10A,A01,083735,Patchell; Gregory David,2,0,30,28
1658101863692,MATH 10A,A02,083736,Patchell; Gregory David,20,0,30,10
1658101863692,MATH 10A,A03,083737,Patchell; Gregory David,16,0,30,14
1658101869714,MATH 10B,A01,083207,Lim; Seonhee,9,0,34,25
1658101869714,MATH 10B,A02,083208,Lim; Seonhee,10,0,35,25
1658101869714,MATH 10B,A03,093472,Lim; Seonhee,7,0,34,27
1658101869714,MATH 10B,B01,083739,Sinha; Shubham,14,0,30,16
1658101875738,MATH 18,A01,083743,Cinel; Cameron Alexander,9,0,30,21
1658101875738,MATH 18,A02,083744,Cinel; Cameron Alexander,18,0,30,12
1658101875738,MATH 18,A03,083745,Cinel; Cameron Alexander,10,0,30,20
1658101875738,MATH 18,B01,083748,Rideout; David Porter,5,0,37,32
1658101875738,MATH 18,B02,083749,Rideout; David Porter,5,0,36,31
1658101875738,MATH 18,B03,083750,Rideout; David Porter,3,0,37,34
1658101875738,MATH 18,B04,083751,Rideout; David Porter,7,0,36,29
1658101875738,MATH 18,B05,093473,Rideout; David Porter,7,0,36,29
1658101875738,MATH 18,B06,093474,Rideout; David Porter,6,0,36,30
1658101881762,MATH 20A,A01,083754,Zheng; Zequn,14,0,40,26
1658101887791,MATH 20B,A01,083756,Briones; Jor-el Thomas Caparas,4,0,36,32
1658101887791,MATH 20B,A02,083757,Briones; Jor-el Thomas Caparas,1,0,36,35
1658101887791,MATH 20B,A03,093475,Briones; Jor-el Thomas Caparas,3,0,36,33
1658101893815,MATH 20C,A01,083760,Briones; Jor-el Thomas Caparas,1,0,35,34
1658101893815,MATH 20C,A02,083761,Briones; Jor-el Thomas Caparas,8,0,35,27
1658101893815,MATH 20C,A03,093476,Briones; Jor-el Thomas Caparas,0,1,36,36
1658101893815,MATH 20C,B01,083762,Bach; Quang Tran,1,0,30,29
1658101899839,MATH 20D,A01,083765,Tran; Brian Kha,5,0,30,25
1658101899839,MATH 20D,A02,083766,Tran; Brian Kha,5,0,30,25
1658101899839,MATH 20D,A03,083767,Tran; Brian Kha,6,0,30,24
1658101905868,MATH 20E,A01,083771,Ganguly; Soumya,12,0,32,20
1658101905868,MATH 20E,A02,083772,Ganguly; Soumya,7,0,32,25
1658101905868,MATH 20E,B01,083773,Ciotti; Benjamin,20,0,35,15
1658101905868,MATH 20E,B02,083774,Ciotti; Benjamin,18,0,35,17
1658101911898,MATH 103A,A01,083777,Greenfeld; Be'Eri,6,0,36,30
1658101911898,MATH 103A,A02,083778,Greenfeld; Be'Eri,5,0,36,31
1658101911898,MATH 103A,A03,093561,Greenfeld; Be'Eri,7,0,36,29
1658101911898,MATH 103A,B01,083779,Greenfeld; Be'Eri,8,0,36,28
1658101911898,MATH 103A,B02,083780,Greenfeld; Be'Eri,4,0,36,32
1658101911898,MATH 103A,B03,093562,Greenfeld; Be'Eri,3,0,36,33
1658101917921,MATH 105,A01,085443,Carter; Anne Toulson,15,0,35,20
1658101917921,MATH 105,A02,093477,Carter; Anne Toulson,20,0,35,15
1658101923946,MATH 109,A01,083213,Ganzberger; Geoffrey Michael,3,0,34,31
1658101923946,MATH 109,A02,083214,Ganzberger; Geoffrey Michael,4,0,34,30
1658101923946,MATH 109,A03,093478,Ganzberger; Geoffrey Michael,2,0,34,32
1658101923946,MATH 109,B01,083215,Ganzberger; Geoffrey Michael,3,0,32,29
1658101923946,MATH 109,B02,083216,Ganzberger; Geoffrey Michael,3,0,32,29
1658101923946,MATH 109,B03,093479,Ganzberger; Geoffrey Michael,8,0,32,24
1658101929974,MATH 142A,A01,083219,Chow; Bennett,7,0,32,25
1658101929974,MATH 142A,A02,083220,Chow; Bennett,10,0,32,22
1658101929974,MATH 142A,A03,093480,Chow; Bennett,9,0,32,23
1658101929974,MATH 142A,B03,093481,Chow; Bennett,8,0,32,24
1658101929974,MATH 142A,B04,093558,Chow; Bennett,14,0,32,18
1658101929974,MATH 142A,B05,093559,Chow; Bennett,7,0,32,25
1658101935997,MATH 193A,A01,083224,Rotar; Vladimir,9,0,34,25
1658101935997,MATH 193A,A02,083225,Rotar; Vladimir,11,0,34,23
1658101935997,MATH 193A,A03,083781,Rotar; Vladimir,5,0,34,29
1658101935997,MATH 193A,A04,083782,Rotar; Vladimir,12,0,34,22
1658101935997,MATH 193A,A05,093482,Rotar; Vladimir,11,0,34,23
1658101942020,MATH 197,001,091859,McAuley; Julian John,9999,0,9999,0
1658101942020,MATH 197,002,095566,Kedlaya; Kiran S.,9997,0,9999,2
1658101942020,MATH 197,003,095567,Xiao; Ming,9999,0,9999,0
1658101942020,MATH 197,004,095571,Perols; Johan Lars,9998,0,9999,1
1658101949082,COGS 9,A01,083615,Shannon; Kyle Michael,11,0,75,64
1658101955106,COGS 11,A01,083617,Boyle; Mary E. T.,23,0,48,25
1658101961129,COGS 13,A01,083071,Bastos; Amalia Pinkusfeld,12,0,71,59
1658101967153,COGS 14A,A01,092681,Semenuks; Arturs,5,1,100,95
1658101973177,COGS 14B,A01,083073,Cheng; Tzu-Han,7,0,63,56
1658101979204,COGS 17,A01,092677,Semenuks; Arturs,7,0,81,74
1658101985231,COGS 100,A01,083619,Allen; Michael Gordon,17,0,70,53
1658101991258,COGS 101A,A01,083621,Davis; Joshua Daniel,9,0,68,59
1658101997281,COGS 101B,A01,091572,Allen; Michael Gordon,14,0,65,51
1658102003303,COGS 101C,A01,083625,Delgado; Tania,17,0,35,18
1658102009326,COGS 107A,A01,083627,Boyle; Mary E. T.,14,0,60,46
1658102015442,COGS 118A,A01,083075,Gupta; Anjum,21,0,76,55
1658102021465,CSE 3,A50,083646,Miranda; Gregory Joseph,24,0,50,26
1658102027492,CSE 8A,A50,083650,Miranda; Gregory Joseph,17,1,56,39
1658102033516,CSE 11,A01,083080,Cao; Yingjun,7,15,40,33
1658102039544,CSE 12,A01,083652,Krause-Levy; Sophia Louisa,30,1,120,90
1658102045567,CSE 15L,A01,083654,Morris; Justin Loren,9,0,50,41
1658102045567,CSE 15L,A02,083655,Morris; Justin Loren,11,0,50,39
1658102051595,CSE 20,A01,083657,Tran; Khoa Dang,39,0,80,41
1658102057631,CSE 21,A01,095574,Bach; Quang Tran,23,0,48,25
1658102063656,CSE 30,A01,083084,Eldon; John,8,0,80,72
1658102063656,CSE 30,B01,095061,Bhaskar; Nishant,9,0,50,41
1658102069679,CSE 100,A01,083659,Cao; Yingjun,5,4,70,65
1658102075702,CSE 134B,A01,083661,Powell; Thomas Allan,25,0,100,75
1658102081726,CSE 140,A01,083663,Gungor; Onat,17,0,85,68
1658102087752,CSE 140L,A01,083088,Eldon; John,23,0,100,77
1658102093776,CSE 175,A01,083665,Kumar; Rakesh,3,0,25,22
1658102099802,CSE 190,A00,092507,Dubnov; Shlomo,8,0,20,12
1658102105828,ECE 45,A01,083139,Congero; Spencer William,7,0,75,68
1658102111850,ECE 65,A50,083695,Saad; Andrew S,12,0,30,18
1658102111850,ECE 65,A51,095125,Saad; Andrew S,24,0,26,2
1658102117874,ECE 109,A01,091882,Touri; Behrouz,21,0,70,49
1658102123899,ECE 180,A00,083140,Abi Samra; Nicholas Camill,1,0,30,29
1658102123899,ECE 180,B00,083141,Abi Samra; Nicholas Camill,0,0,30,30
1658102129928,MATH 10A,A01,083735,Patchell; Gregory David,2,0,30,28
1658102129928,MATH 10A,A02,083736,Patchell; Gregory David,20,0,30,10
1658102129928,MATH 10A,A03,083737,Patchell; Gregory David,16,0,30,14
1658102135952,MATH 10B,A01,083207,Lim; Seonhee,9,0,34,25
1658102135952,MATH 10B,A02,083208,Lim; Seonhee,10,0,35,25
1658102135952,MATH 10B,A03,093472,Lim; Seonhee,7,0,34,27
1658102135952,MATH 10B,B01,083739,Sinha; Shubham,14,0,30,16
1658102141984,MATH 18,A01,083743,Cinel; Cameron Alexander,9,0,30,21
1658102141984,MATH 18,A02,083744,Cinel; Cameron Alexander,18,0,30,12
1658102141984,MATH 18,A03,083745,Cinel; Cameron Alexander,10,0,30,20
1658102141984,MATH 18,B01,083748,Rideout; David Porter,5,0,37,32
1658102141984,MATH 18,B02,083749,Rideout; David Porter,5,0,36,31
1658102141984,MATH 18,B03,083750,Rideout; David Porter,3,0,37,34
1658102141984,MATH 18,B04,083751,Rideout; David Porter,7,0,36,29
1658102141984,MATH 18,B05,093473,Rideout; David Porter,7,0,36,29
1658102141984,MATH 18,B06,093474,Rideout; David Porter,6,0,36,30
1658102148007,MATH 20A,A01,083754,Zheng; Zequn,14,0,40,26
1658102154029,MATH 20B,A01,083756,Briones; Jor-el Thomas Caparas,4,0,36,32
1658102154029,MATH 20B,A02,083757,Briones; Jor-el Thomas Caparas,1,0,36,35
1658102154029,MATH 20B,A03,093475,Briones; Jor-el Thomas Caparas,3,0,36,33
1658102160054,MATH 20C,A01,083760,Briones; Jor-el Thomas Caparas,1,0,35,34
1658102160054,MATH 20C,A02,083761,Briones; Jor-el Thomas Caparas,8,0,35,27
1658102160054,MATH 20C,A03,093476,Briones; Jor-el Thomas Caparas,0,1,36,36
1658102160054,MATH 20C,B01,083762,Bach; Quang Tran,1,0,30,29
1658102166080,MATH 20D,A01,083765,Tran; Brian Kha,5,0,30,25
1658102166080,MATH 20D,A02,083766,Tran; Brian Kha,5,0,30,25
1658102166080,MATH 20D,A03,083767,Tran; Brian Kha,6,0,30,24
1658102172104,MATH 20E,A01,083771,Ganguly; Soumya,12,0,32,20
1658102172104,MATH 20E,A02,083772,Ganguly; Soumya,7,0,32,25
1658102172104,MATH 20E,B01,083773,Ciotti; Benjamin,20,0,35,15
1658102172104,MATH 20E,B02,083774,Ciotti; Benjamin,18,0,35,17
1658102178127,MATH 103A,A01,083777,Greenfeld; Be'Eri,6,0,36,30
1658102178127,MATH 103A,A02,083778,Greenfeld; Be'Eri,5,0,36,31
1658102178127,MATH 103A,A03,093561,Greenfeld; Be'Eri,7,0,36,29
1658102178127,MATH 103A,B01,083779,Greenfeld; Be'Eri,8,0,36,28
1658102178127,MATH 103A,B02,083780,Greenfeld; Be'Eri,4,0,36,32
1658102178127,MATH 103A,B03,093562,Greenfeld; Be'Eri,3,0,36,33
1658102184165,MATH 105,A01,085443,Carter; Anne Toulson,15,0,35,20
1658102184165,MATH 105,A02,093477,Carter; Anne Toulson,20,0,35,15
1658102190190,MATH 109,A01,083213,Ganzberger; Geoffrey Michael,3,0,34,31
1658102190190,MATH 109,A02,083214,Ganzberger; Geoffrey Michael,4,0,34,30
1658102190190,MATH 109,A03,093478,Ganzberger; Geoffrey Michael,2,0,34,32
1658102190190,MATH 109,B01,083215,Ganzberger; Geoffrey Michael,3,0,32,29
1658102190190,MATH 109,B02,083216,Ganzberger; Geoffrey Michael,3,0,32,29
1658102190190,MATH 109,B03,093479,Ganzberger; Geoffrey Michael,8,0,32,24
1658102196220,MATH 142A,A01,083219,Chow; Bennett,7,0,32,25
1658102196220,MATH 142A,A02,083220,Chow; Bennett,10,0,32,22
1658102196220,MATH 142A,A03,093480,Chow; Bennett,9,0,32,23
1658102196220,MATH 142A,B03,093481,Chow; Bennett,8,0,32,24
1658102196220,MATH 142A,B04,093558,Chow; Bennett,14,0,32,18
1658102196220,MATH 142A,B05,093559,Chow; Bennett,7,0,32,25
1658102202245,MATH 193A,A01,083224,Rotar; Vladimir,9,0,34,25
1658102202245,MATH 193A,A02,083225,Rotar; Vladimir,11,0,34,23
1658102202245,MATH 193A,A03,083781,Rotar; Vladimir,5,0,34,29
1658102202245,MATH 193A,A04,083782,Rotar; Vladimir,12,0,34,22
1658102202245,MATH 193A,A05,093482,Rotar; Vladimir,11,0,34,23
1658102208268,MATH 197,001,091859,McAuley; Julian John,9999,0,9999,0
1658102208268,MATH 197,002,095566,Kedlaya; Kiran S.,9997,0,9999,2
1658102208268,MATH 197,003,095567,Xiao; Ming,9999,0,9999,0
1658102208268,MATH 197,004,095571,Perols; Johan Lars,9998,0,9999,1
1658102215321,COGS 9,A01,083615,Shannon; Kyle Michael,11,0,75,64
1658102221346,COGS 11,A01,083617,Boyle; Mary E. T.,23,0,48,25
1658102227373,COGS 13,A01,083071,Bastos; Amalia Pinkusfeld,12,0,71,59
1658102233396,COGS 14A,A01,092681,Semenuks; Arturs,5,1,100,95
1658102239425,COGS 14B,A01,083073,Cheng; Tzu-Han,7,0,63,56
1658102245449,COGS 17,A01,092677,Semenuks; Arturs,7,0,81,74
1658102251474,COGS 100,A01,083619,Allen; Michael Gordon,17,0,70,53
1658102257502,COGS 101A,A01,083621,Davis; Joshua Daniel,9,0,68,59
1658102263531,COGS 101B,A01,091572,Allen; Michael Gordon,14,0,65,51
1658102269557,COGS 101C,A01,083625,Delgado; Tania,17,0,35,18
1658102275579,COGS 107A,A01,083627,Boyle; Mary E. T.,14,0,60,46
1658102281607,COGS 118A,A01,083075,Gupta; Anjum,21,0,76,55
1658102287632,CSE 3,A50,083646,Miranda; Gregory Joseph,24,0,50,26
1658102293655,CSE 8A,A50,083650,Miranda; Gregory Joseph,17,1,56,39
1658102299676,CSE 11,A01,083080,Cao; Yingjun,7,15,40,33
1658102305703,CSE 12,A01,083652,Krause-Levy; Sophia Louisa,30,1,120,90
1658102311725,CSE 15L,A01,083654,Morris; Justin Loren,9,0,50,41
1658102311725,CSE 15L,A02,083655,Morris; Justin Loren,11,0,50,39
1658102317748,CSE 20,A01,083657,Tran; Khoa Dang,39,0,80,41
1658102323774,CSE 21,A01,095574,Bach; Quang Tran,23,0,48,25
1658102329796,CSE 30,A01,083084,Eldon; John,8,0,80,72
1658102329796,CSE 30,B01,095061,Bhaskar; Nishant,9,0,50,41
1658102335817,CSE 100,A01,083659,Cao; Yingjun,5,4,70,65
1658102341844,CSE 134B,A01,083661,Powell; Thomas Allan,25,0,100,75
1658102347867,CSE 140,A01,083663,Gungor; Onat,17,0,85,68
1658102353897,CSE 140L,A01,083088,Eldon; John,23,0,100,77
1658102359921,CSE 175,A01,083665,Kumar; Rakesh,3,0,25,22
1658102365945,CSE 190,A00,092507,Dubnov; Shlomo,8,0,20,12
1658102371970,ECE 45,A01,083139,Congero; Spencer William,7,0,75,68
1658102377996,ECE 65,A50,083695,Saad; Andrew S,12,0,30,18
1658102377996,ECE 65,A51,095125,Saad; Andrew S,24,0,26,2
1658102384019,ECE 109,A01,091882,Touri; Behrouz,21,0,70,49
1658102390043,ECE 180,A00,083140,Abi Samra; Nicholas Camill,1,0,30,29
1658102390043,ECE 180,B00,083141,Abi Samra; Nicholas Camill,0,0,30,30
1658102396067,MATH 10A,A01,083735,Patchell; Gregory David,2,0,30,28
1658102396067,MATH 10A,A02,083736,Patchell; Gregory David,20,0,30,10
1658102396067,MATH 10A,A03,083737,Patchell; Gregory David,16,0,30,14
1658102402098,MATH 10B,A01,083207,Lim; Seonhee,9,0,34,25
1658102402098,MATH 10B,A02,083208,Lim; Seonhee,10,0,35,25
1658102402098,MATH 10B,A03,093472,Lim; Seonhee,7,0,34,27
1658102402098,MATH 10B,B01,083739,Sinha; Shubham,14,0,30,16
1658102408123,MATH 18,A01,083743,Cinel; Cameron Alexander,9,0,30,21
1658102408123,MATH 18,A02,083744,Cinel; Cameron Alexander,18,0,30,12
1658102408123,MATH 18,A03,083745,Cinel; Cameron Alexander,10,0,30,20
1658102408123,MATH 18,B01,083748,Rideout; David Porter,5,0,37,32
1658102408123,MATH 18,B02,083749,Rideout; David Porter,5,0,36,31
1658102408123,MATH 18,B03,083750,Rideout; David Porter,3,0,37,34
1658102408123,MATH 18,B04,083751,Rideout; David Porter,7,0,36,29
1658102408123,MATH 18,B05,093473,Rideout; David Porter,7,0,36,29
1658102408123,MATH 18,B06,093474,Rideout; David Porter,6,0,36,30
1658102414148,MATH 20A,A01,083754,Zheng; Zequn,14,0,40,26
1658102420171,MATH 20B,A01,083756,Briones; Jor-el Thomas Caparas,4,0,36,32
1658102420171,MATH 20B,A02,083757,Briones; Jor-el Thomas Caparas,1,0,36,35
1658102420171,MATH 20B,A03,093475,Briones; Jor-el Thomas Caparas,3,0,36,33
1658102426199,MATH 20C,A01,083760,Briones; Jor-el Thomas Caparas,1,0,35,34
1658102426199,MATH 20C,A02,083761,Briones; Jor-el Thomas Caparas,8,0,35,27
1658102426199,MATH 20C,A03,093476,Briones; Jor-el Thomas Caparas,0,1,36,36
1658102426199,MATH 20C,B01,083762,Bach; Quang Tran,1,0,30,29
1658102432223,MATH 20D,A01,083765,Tran; Brian Kha,5,0,30,25
1658102432223,MATH 20D,A02,083766,Tran; Brian Kha,5,0,30,25
1658102432223,MATH 20D,A03,083767,Tran; Brian Kha,6,0,30,24
1658102438256,MATH 20E,A01,083771,Ganguly; Soumya,12,0,32,20
1658102438256,MATH 20E,A02,083772,Ganguly; Soumya,7,0,32,25
1658102438256,MATH 20E,B01,083773,Ciotti; Benjamin,20,0,35,15
1658102438256,MATH 20E,B02,083774,Ciotti; Benjamin,18,0,35,17
1658102444281,MATH 103A,A01,083777,Greenfeld; Be'Eri,6,0,36,30
1658102444281,MATH 103A,A02,083778,Greenfeld; Be'Eri,5,0,36,31
1658102444281,MATH 103A,A03,093561,Greenfeld; Be'Eri,7,0,36,29
1658102444281,MATH 103A,B01,083779,Greenfeld; Be'Eri,8,0,36,28
1658102444281,MATH 103A,B02,083780,Greenfeld; Be'Eri,4,0,36,32
1658102444281,MATH 103A,B03,093562,Greenfeld; Be'Eri,3,0,36,33
1658102450304,MATH 105,A01,085443,Carter; Anne Toulson,15,0,35,20
1658102450304,MATH 105,A02,093477,Carter; Anne Toulson,20,0,35,15
1658102456333,MATH 109,A01,083213,Ganzberger; Geoffrey Michael,3,0,34,31
1658102456333,MATH 109,A02,083214,Ganzberger; Geoffrey Michael,4,0,34,30
1658102456333,MATH 109,A03,093478,Ganzberger; Geoffrey Michael,2,0,34,32
1658102456333,MATH 109,B01,083215,Ganzberger; Geoffrey Michael,3,0,32,29
1658102456333,MATH 109,B02,083216,Ganzberger; Geoffrey Michael,3,0,32,29
1658102456333,MATH 109,B03,093479,Ganzberger; Geoffrey Michael,8,0,32,24
1658102462363,MATH 142A,A01,083219,Chow; Bennett,7,0,32,25
1658102462363,MATH 142A,A02,083220,Chow; Bennett,10,0,32,22
1658102462363,MATH 142A,A03,093480,Chow; Bennett,9,0,32,23
1658102462363,MATH 142A,B03,093481,Chow; Bennett,8,0,32,24
1658102462363,MATH 142A,B04,093558,Chow; Bennett,14,0,32,18
1658102462363,MATH 142A,B05,093559,Chow; Bennett,7,0,32,25
1658102468388,MATH 193A,A01,083224,Rotar; Vladimir,9,0,34,25
1658102468388,MATH 193A,A02,083225,Rotar; Vladimir,11,0,34,23
1658102468388,MATH 193A,A03,083781,Rotar; Vladimir,5,0,34,29
1658102468388,MATH 193A,A04,083782,Rotar; Vladimir,12,0,34,22
1658102468388,MATH 193A,A05,093482,Rotar; Vladimir,11,0,34,23
1658102474414,MATH 197,001,091859,McAuley; Julian John,9999,0,9999,0
1658102474414,MATH 197,002,095566,Kedlaya; Kiran S.,9997,0,9999,2
1658102474414,MATH 197,003,095567,Xiao; Ming,9999,0,9999,0
1658102474414,MATH 197,004,095571,Perols; Johan Lars,9998,0,9999,1
1658102481473,COGS 9,A01,083615,Shannon; Kyle Michael,11,0,75,64
1658102487497,COGS 11,A01,083617,Boyle; Mary E. T.,23,0,48,25
1658102493524,COGS 13,A01,083071,Bastos; Amalia Pinkusfeld,12,0,71,59
1658102499548,COGS 14A,A01,092681,Semenuks; Arturs,5,1,100,95
1658102505571,COGS 14B,A01,083073,Cheng; Tzu-Han,7,0,63,56
1658102511598,COGS 17,A01,092677,Semenuks; Arturs,7,0,81,74
1658102517624,COGS 100,A01,083619,Allen; Michael Gordon,17,0,70,53
1658102523647,COGS 101A,A01,083621,Davis; Joshua Daniel,9,0,68,59
1658102529672,COGS 101B,A01,091572,Allen; Michael Gordon,14,0,65,51
1658102535698,COGS 101C,A01,083625,Delgado; Tania,17,0,35,18
1658102541723,COGS 107A,A01,083627,Boyle; Mary E. T.,14,0,60,46
1658102547746,COGS 118A,A01,083075,Gupta; Anjum,21,0,76,55
1658102553773,CSE 3,A50,083646,Miranda; Gregory Joseph,24,0,50,26
1658102559797,CSE 8A,A50,083650,Miranda; Gregory Joseph,17,1,56,39
1658102565820,CSE 11,A01,083080,Cao; Yingjun,7,15,40,33
1658102571844,CSE 12,A01,083652,Krause-Levy; Sophia Louisa,30,1,120,90
1658102577867,CSE 15L,A01,083654,Morris; Justin Loren,9,0,50,41
1658102577867,CSE 15L,A02,083655,Morris; Justin Loren,11,0,50,39
1658102583894,CSE 20,A01,083657,Tran; Khoa Dang,39,0,80,41
1658102589918,CSE 21,A01,095574,Bach; Quang Tran,23,0,48,25
1658102595941,CSE 30,A01,083084,Eldon; John,8,0,80,72
1658102595941,CSE 30,B01,095061,Bhaskar; Nishant,9,0,50,41
1658102601967,CSE 100,A01,083659,Cao; Yingjun,5,4,70,65
1658102607993,CSE 134B,A01,083661,Powell; Thomas Allan,25,0,100,75
1658102614093,CSE 140,A01,083663,Gungor; Onat,17,0,85,68
1658102620119,CSE 140L,A01,083088,Eldon; John,23,0,100,77
1658102626143,CSE 175,A01,083665,Kumar; Rakesh,3,0,25,22
1658102632169,CSE 190,A00,092507,Dubnov; Shlomo,8,0,20,12
1658102638197,ECE 45,A01,083139,Congero; Spencer William,7,0,75,68
1658102644221,ECE 65,A50,083695,Saad; Andrew S,12,0,30,18
1658102644221,ECE 65,A51,095125,Saad; Andrew S,24,0,26,2
1658102650248,ECE 109,A01,091882,Touri; Behrouz,21,0,70,49
1658102656277,ECE 180,A00,083140,Abi Samra; Nicholas Camill,1,0,30,29
1658102656277,ECE 180,B00,083141,Abi Samra; Nicholas Camill,0,0,30,30
1658102662302,MATH 10A,A01,083735,Patchell; Gregory David,2,0,30,28
1658102662302,MATH 10A,A02,083736,Patchell; Gregory David,20,0,30,10
1658102662302,MATH 10A,A03,083737,Patchell; Gregory David,16,0,30,14
1658102668326,MATH 10B,A01,083207,Lim; Seonhee,9,0,34,25
1658102668326,MATH 10B,A02,083208,Lim; Seonhee,10,0,35,25
1658102668326,MATH 10B,A03,093472,Lim; Seonhee,7,0,34,27
1658102668326,MATH 10B,B01,083739,Sinha; Shubham,14,0,30,16
1658102674350,MATH 18,A01,083743,Cinel; Cameron Alexander,9,0,30,21
1658102674350,MATH 18,A02,083744,Cinel; Cameron Alexander,18,0,30,12
1658102674350,MATH 18,A03,083745,Cinel; Cameron Alexander,10,0,30,20
1658102674350,MATH 18,B01,083748,Rideout; David Porter,5,0,37,32
1658102674350,MATH 18,B02,083749,Rideout; David Porter,5,0,36,31
1658102674350,MATH 18,B03,083750,Rideout; David Porter,3,0,37,34
1658102674350,MATH 18,B04,083751,Rideout; David Porter,7,0,36,29
1658102674350,MATH 18,B05,093473,Rideout; David Porter,7,0,36,29
1658102674350,MATH 18,B06,093474,Rideout; David Porter,6,0,36,30
1658102680373,MATH 20A,A01,083754,Zheng; Zequn,14,0,40,26
1658102686397,MATH 20B,A01,083756,Briones; Jor-el Thomas Caparas,4,0,36,32
1658102686397,MATH 20B,A02,083757,Briones; Jor-el Thomas Caparas,1,0,36,35
1658102686397,MATH 20B,A03,093475,Briones; Jor-el Thomas Caparas,3,0,36,33
1658102692421,MATH 20C,A01,083760,Briones; Jor-el Thomas Caparas,1,0,35,34
1658102692421,MATH 20C,A02,083761,Briones; Jor-el Thomas Caparas,8,0,35,27
1658102692421,MATH 20C,A03,093476,Briones; Jor-el Thomas Caparas,0,1,36,36
1658102692421,MATH 20C,B01,083762,Bach; Quang Tran,1,0,30,29
1658102698449,MATH 20D,A01,083765,Tran; Brian Kha,5,0,30,25
1658102698449,MATH 20D,A02,083766,Tran; Brian Kha,5,0,30,25
1658102698449,MATH 20D,A03,083767,Tran; Brian Kha,6,0,30,24
1658102704478,MATH 20E,A01,083771,Ganguly; Soumya,12,0,32,20
1658102704478,MATH 20E,A02,083772,Ganguly; Soumya,7,0,32,25
1658102704478,MATH 20E,B01,083773,Ciotti; Benjamin,20,0,35,15
1658102704478,MATH 20E,B02,083774,Ciotti; Benjamin,18,0,35,17
1658102710506,MATH 103A,A01,083777,Greenfeld; Be'Eri,6,0,36,30
1658102710506,MATH 103A,A02,083778,Greenfeld; Be'Eri,5,0,36,31
1658102710506,MATH 103A,A03,093561,Greenfeld; Be'Eri,7,0,36,29
1658102710506,MATH 103A,B01,083779,Greenfeld; Be'Eri,8,0,36,28
1658102710506,MATH 103A,B02,083780,Greenfeld; Be'Eri,4,0,36,32
1658102710506,MATH 103A,B03,093562,Greenfeld; Be'Eri,3,0,36,33
1658102716533,MATH 105,A01,085443,Carter; Anne Toulson,15,0,35,20
1658102716533,MATH 105,A02,093477,Carter; Anne Toulson,20,0,35,15
1658102722557,MATH 109,A01,083213,Ganzberger; Geoffrey Michael,3,0,34,31
1658102722557,MATH 109,A02,083214,Ganzberger; Geoffrey Michael,4,0,34,30
1658102722557,MATH 109,A03,093478,Ganzberger; Geoffrey Michael,2,0,34,32
1658102722557,MATH 109,B01,083215,Ganzberger; Geoffrey Michael,3,0,32,29
1658102722557,MATH 109,B02,083216,Ganzberger; Geoffrey Michael,3,0,32,29
1658102722557,MATH 109,B03,093479,Ganzberger; Geoffrey Michael,8,0,32,24
1658102728588,MATH 142A,A01,083219,Chow; Bennett,7,0,32,25
1658102728588,MATH 142A,A02,083220,Chow; Bennett,10,0,32,22
1658102728588,MATH 142A,A03,093480,Chow; Bennett,9,0,32,23
1658102728588,MATH 142A,B03,093481,Chow; Bennett,8,0,32,24
1658102728588,MATH 142A,B04,093558,Chow; Bennett,14,0,32,18
1658102728588,MATH 142A,B05,093559,Chow; Bennett,7,0,32,25
1658102734618,MATH 193A,A01,083224,Rotar; Vladimir,9,0,34,25
1658102734618,MATH 193A,A02,083225,Rotar; Vladimir,11,0,34,23
1658102734618,MATH 193A,A03,083781,Rotar; Vladimir,5,0,34,29
1658102734618,MATH 193A,A04,083782,Rotar; Vladimir,12,0,34,22
1658102734618,MATH 193A,A05,093482,Rotar; Vladimir,11,0,34,23
1658102740641,MATH 197,001,091859,McAuley; Julian John,9999,0,9999,0
1658102740641,MATH 197,002,095566,Kedlaya; Kiran S.,9997,0,9999,2
1658102740641,MATH 197,003,095567,Xiao; Ming,9999,0,9999,0
1658102740641,MATH 197,004,095571,Perols; Johan Lars,9998,0,9999,1
1658102747699,COGS 9,A01,083615,Shannon; Kyle Michael,11,0,75,64
1658102753726,COGS 11,A01,083617,Boyle; Mary E. T.,23,0,48,25
1658102759750,COGS 13,A01,083071,Bastos; Amalia Pinkusfeld,12,0,71,59
1658102765776,COGS 14A,A01,092681,Semenuks; Arturs,5,1,100,95
1658102771805,COGS 14B,A01,083073,Cheng; Tzu-Han,7,0,63,56
1658102777828,COGS 17,A01,092677,Semenuks; Arturs,7,0,81,74
1658102783856,COGS 100,A01,083619,Allen; Michael Gordon,17,0,70,53
1658102789880,COGS 101A,A01,083621,Davis; Joshua Daniel,9,0,68,59
1658102795903,COGS 101B,A01,091572,Allen; Michael Gordon,14,0,65,51
1658102801931,COGS 101C,A01,083625,Delgado; Tania,17,0,35,18
1658102807959,COGS 107A,A01,083627,Boyle; Mary E. T.,14,0,60,46
1658102813983,COGS 118A,A01,083075,Gupta; Anjum,21,0,76,55
1658102820019,CSE 3,A50,083646,Miranda; Gregory Joseph,24,0,50,26
1658102826047,CSE 8A,A50,083650,Miranda; Gregory Joseph,17,1,56,39
1658102832076,CSE 11,A01,083080,Cao; Yingjun,7,15,40,33
1658102838099,CSE 12,A01,083652,Krause-Levy; Sophia Louisa,30,1,120,90
1658102844120,CSE 15L,A01,083654,Morris; Justin Loren,9,0,50,41
1658102844120,CSE 15L,A02,083655,Morris; Justin Loren,11,0,50,39
1658102850153,CSE 20,A01,083657,Tran; Khoa Dang,39,0,80,41
1658102856177,CSE 21,A01,095574,Bach; Quang Tran,23,0,48,25
1658102862201,CSE 30,A01,083084,Eldon; John,8,0,80,72
1658102862201,CSE 30,B01,095061,Bhaskar; Nishant,9,0,50,41
1658102868233,CSE 100,A01,083659,Cao; Yingjun,5,4,70,65
1658102874262,CSE 134B,A01,083661,Powell; Thomas Allan,25,0,100,75
1658102880291,CSE 140,A01,083663,Gungor; Onat,17,0,85,68
1658102886320,CSE 140L,A01,083088,Eldon; John,23,0,100,77
1658102892344,CSE 175,A01,083665,Kumar; Rakesh,3,0,25,22
1658102898367,CSE 190,A00,092507,Dubnov; Shlomo,8,0,20,12
1658102904391,ECE 45,A01,083139,Congero; Spencer William,7,0,75,68
1658102910423,ECE 65,A50,083695,Saad; Andrew S,12,0,30,18
1658102910423,ECE 65,A51,095125,Saad; Andrew S,24,0,26,2
1658102916455,ECE 109,A01,091882,Touri; Behrouz,21,0,70,49
1658102922479,ECE 180,A00,083140,Abi Samra; Nicholas Camill,1,0,30,29
1658102922479,ECE 180,B00,083141,Abi Samra; Nicholas Camill,0,0,30,30
1658102928507,MATH 10A,A01,083735,Patchell; Gregory David,2,0,30,28
1658102928507,MATH 10A,A02,083736,Patchell; Gregory David,20,0,30,10
1658102928507,MATH 10A,A03,083737,Patchell; Gregory David,16,0,30,14
1658102934536,MATH 10B,A01,083207,Lim; Seonhee,9,0,34,25
1658102934536,MATH 10B,A02,083208,Lim; Seonhee,10,0,35,25
1658102934536,MATH 10B,A03,093472,Lim; Seonhee,7,0,34,27
1658102934536,MATH 10B,B01,083739,Sinha; Shubham,14,0,30,16
1658102940561,MATH 18,A01,083743,Cinel; Cameron Alexander,9,0,30,21
1658102940561,MATH 18,A02,083744,Cinel; Cameron Alexander,18,0,30,12
1658102940561,MATH 18,A03,083745,Cinel; Cameron Alexander,10,0,30,20
1658102940561,MATH 18,B01,083748,Rideout; David Porter,5,0,37,32
1658102940561,MATH 18,B02,083749,Rideout; David Porter,5,0,36,31
1658102940561,MATH 18,B03,083750,Rideout; David Porter,3,0,37,34
1658102940561,MATH 18,B04,083751,Rideout; David Porter,7,0,36,29
1658102940561,MATH 18,B05,093473,Rideout; David Porter,7,0,36,29
1658102940561,MATH 18,B06,093474,Rideout; David Porter,6,0,36,30
1658102946586,MATH 20A,A01,083754,Zheng; Zequn,14,0,40,26
1658102952610,MATH 20B,A01,083756,Briones; Jor-el Thomas Caparas,4,0,36,32
1658102952610,MATH 20B,A02,083757,Briones; Jor-el Thomas Caparas,1,0,36,35
1658102952610,MATH 20B,A03,093475,Briones; Jor-el Thomas Caparas,3,0,36,33
1658102958634,MATH 20C,A01,083760,Briones; Jor-el Thomas Caparas,1,0,35,34
1658102958634,MATH 20C,A02,083761,Briones; Jor-el Thomas Caparas,8,0,35,27
1658102958634,MATH 20C,A03,093476,Briones; Jor-el Thomas Caparas,0,1,36,36
1658102958634,MATH 20C,B01,083762,Bach; Quang Tran,1,0,30,29
1658102964671,MATH 20D,A01,083765,Tran; Brian Kha,5,0,30,25
1658102964671,MATH 20D,A02,083766,Tran; Brian Kha,5,0,30,25
1658102964671,MATH 20D,A03,083767,Tran; Brian Kha,6,0,30,24
1658102970695,MATH 20E,A01,083771,Ganguly; Soumya,12,0,32,20
1658102970695,MATH 20E,A02,083772,Ganguly; Soumya,7,0,32,25
1658102970695,MATH 20E,B01,083773,Ciotti; Benjamin,20,0,35,15
1658102970695,MATH 20E,B02,083774,Ciotti; Benjamin,18,0,35,17
1658102976725,MATH 103A,A01,083777,Greenfeld; Be'Eri,6,0,36,30
1658102976725,MATH 103A,A02,083778,Greenfeld; Be'Eri,5,0,36,31
1658102976725,MATH 103A,A03,093561,Greenfeld; Be'Eri,7,0,36,29
1658102976725,MATH 103A,B01,083779,Greenfeld; Be'Eri,8,0,36,28
1658102976725,MATH 103A,B02,083780,Greenfeld; Be'Eri,4,0,36,32
1658102976725,MATH 103A,B03,093562,Greenfeld; Be'Eri,3,0,36,33
1658102982754,MATH 105,A01,085443,Carter; Anne Toulson,15,0,35,20
1658102982754,MATH 105,A02,093477,Carter; Anne Toulson,20,0,35,15
1658102988783,MATH 109,A01,083213,Ganzberger; Geoffrey Michael,3,0,34,31
1658102988783,MATH 109,A02,083214,Ganzberger; Geoffrey Michael,4,0,34,30
1658102988783,MATH 109,A03,093478,Ganzberger; Geoffrey Michael,2,0,34,32
1658102988783,MATH 109,B01,083215,Ganzberger; Geoffrey Michael,3,0,32,29
1658102988783,MATH 109,B02,083216,Ganzberger; Geoffrey Michael,3,0,32,29
1658102988783,MATH 109,B03,093479,Ganzberger; Geoffrey Michael,8,0,32,24
1658102994808,MATH 142A,A01,083219,Chow; Bennett,7,0,32,25
1658102994808,MATH 142A,A02,083220,Chow; Bennett,10,0,32,22
1658102994808,MATH 142A,A03,093480,Chow; Bennett,9,0,32,23
1658102994808,MATH 142A,B03,093481,Chow; Bennett,8,0,32,24
1658102994808,MATH 142A,B04,093558,Chow; Bennett,14,0,32,18
1658102994808,MATH 142A,B05,093559,Chow; Bennett,7,0,32,25
1658103000834,MATH 193A,A01,083224,Rotar; Vladimir,9,0,34,25
1658103000834,MATH 193A,A02,083225,Rotar; Vladimir,11,0,34,23
1658103000834,MATH 193A,A03,083781,Rotar; Vladimir,5,0,34,29
1658103000834,MATH 193A,A04,083782,Rotar; Vladimir,12,0,34,22
1658103000834,MATH 193A,A05,093482,Rotar; Vladimir,11,0,34,23
1658103006857,MATH 197,001,091859,McAuley; Julian John,9999,0,9999,0
1658103006857,MATH 197,002,095566,Kedlaya; Kiran S.,9997,0,9999,2
1658103006857,MATH 197,003,095567,Xiao; Ming,9999,0,9999,0
1658103006857,MATH 197,004,095571,Perols; Johan Lars,9998,0,9999,1
1658103013923,COGS 9,A01,083615,Shannon; Kyle Michael,11,0,75,64
1658103019946,COGS 11,A01,083617,Boyle; Mary E. T.,23,0,48,25
1658103025973,COGS 13,A01,083071,Bastos; Amalia Pinkusfeld,12,0,71,59
1658103031999,COGS 14A,A01,092681,Semenuks; Arturs,5,1,100,95
1658103038022,COGS 14B,A01,083073,Cheng; Tzu-Han,7,0,63,56
1658103044049,COGS 17,A01,092677,Semenuks; Arturs,7,0,81,74
1658103050072,COGS 100,A01,083619,Allen; Michael Gordon,17,0,70,53
1658103056099,COGS 101A,A01,083621,Davis; Joshua Daniel,9,0,68,59
1658103062123,COGS 101B,A01,091572,Allen; Michael Gordon,14,0,65,51
1658103068146,COGS 101C,A01,083625,Delgado; Tania,17,0,35,18
1658103074172,COGS 107A,A01,083627,Boyle; Mary E. T.,14,0,60,46
1658103080196,COGS 118A,A01,083075,Gupta; Anjum,21,0,76,55
1658103091587,CSE 3,A50,083646,Miranda; Gregory Joseph,24,0,50,26
1658103097611,CSE 8A,A50,083650,Miranda; Gregory Joseph,17,1,56,39
1658103103639,CSE 11,A01,083080,Cao; Yingjun,7,15,40,33
1658103109664,CSE 12,A01,083652,Krause-Levy; Sophia Louisa,30,1,120,90
1658103115691,CSE 15L,A01,083654,Morris; Justin Loren,9,0,50,41
1658103115691,CSE 15L,A02,083655,Morris; Justin Loren,11,0,50,39
1658103121716,CSE 20,A01,083657,Tran; Khoa Dang,39,0,80,41
1658103127743,CSE 21,A01,095574,Bach; Quang Tran,23,0,48,25
1658103133766,CSE 30,A01,083084,Eldon; John,8,0,80,72
1658103133766,CSE 30,B01,095061,Bhaskar; Nishant,9,0,50,41
1658103139789,CSE 100,A01,083659,Cao; Yingjun,5,4,70,65
1658103145820,CSE 134B,A01,083661,Powell; Thomas Allan,25,0,100,75
1658103151849,CSE 140,A01,083663,Gungor; Onat,17,0,85,68
1658103157874,CSE 140L,A01,083088,Eldon; John,23,0,100,77
1658103163897,CSE 175,A01,083665,Kumar; Rakesh,3,0,25,22
1658103169921,CSE 190,A00,092507,Dubnov; Shlomo,8,0,20,12
1658103175961,ECE 45,A01,083139,Congero; Spencer William,7,0,75,68
1658103181993,ECE 65,A50,083695,Saad; Andrew S,12,0,30,18
1658103181993,ECE 65,A51,095125,Saad; Andrew S,24,0,26,2
1658103188017,ECE 109,A01,091882,Touri; Behrouz,21,0,70,49
1658103194040,ECE 180,A00,083140,Abi Samra; Nicholas Camill,1,0,30,29
1658103194040,ECE 180,B00,083141,Abi Samra; Nicholas Camill,0,0,30,30
1658103200068,MATH 10A,A01,083735,Patchell; Gregory David,2,0,30,28
1658103200068,MATH 10A,A02,083736,Patchell; Gregory David,20,0,30,10
1658103200068,MATH 10A,A03,083737,Patchell; Gregory David,16,0,30,14
1658103206099,MATH 10B,A01,083207,Lim; Seonhee,9,0,34,25
1658103206099,MATH 10B,A02,083208,Lim; Seonhee,10,0,35,25
1658103206099,MATH 10B,A03,093472,Lim; Seonhee,7,0,34,27
1658103206099,MATH 10B,B01,083739,Sinha; Shubham,14,0,30,16
1658103212124,MATH 18,A01,083743,Cinel; Cameron Alexander,9,0,30,21
1658103212124,MATH 18,A02,083744,Cinel; Cameron Alexander,18,0,30,12
1658103212124,MATH 18,A03,083745,Cinel; Cameron Alexander,10,0,30,20
1658103212124,MATH 18,B01,083748,Rideout; David Porter,5,0,37,32
1658103212124,MATH 18,B02,083749,Rideout; David Porter,5,0,36,31
1658103212124,MATH 18,B03,083750,Rideout; David Porter,3,0,37,34
1658103212124,MATH 18,B04,083751,Rideout; David Porter,7,0,36,29
1658103212124,MATH 18,B05,093473,Rideout; David Porter,7,0,36,29
1658103212124,MATH 18,B06,093474,Rideout; David Porter,6,0,36,30
1658103218240,MATH 20A,A01,083754,Zheng; Zequn,14,0,40,26
1658103224263,MATH 20B,A01,083756,Briones; Jor-el Thomas Caparas,4,0,36,32
1658103224263,MATH 20B,A02,083757,Briones; Jor-el Thomas Caparas,1,0,36,35
1658103224263,MATH 20B,A03,093475,Briones; Jor-el Thomas Caparas,3,0,36,33
1658103230288,MATH 20C,A01,083760,Briones; Jor-el Thomas Caparas,1,0,35,34
1658103230288,MATH 20C,A02,083761,Briones; Jor-el Thomas Caparas,8,0,35,27
1658103230288,MATH 20C,A03,093476,Briones; Jor-el Thomas Caparas,0,1,36,36
1658103230288,MATH 20C,B01,083762,Bach; Quang Tran,1,0,30,29
1658103236316,MATH 20D,A01,083765,Tran; Brian Kha,5,0,30,25
1658103236316,MATH 20D,A02,083766,Tran; Brian Kha,5,0,30,25
1658103236316,MATH 20D,A03,083767,Tran; Brian Kha,6,0,30,24
1658103242341,MATH 20E,A01,083771,Ganguly; Soumya,12,0,32,20
1658103242341,MATH 20E,A02,083772,Ganguly; Soumya,7,0,32,25
1658103242341,MATH 20E,B01,083773,Ciotti; Benjamin,20,0,35,15
1658103242341,MATH 20E,B02,083774,Ciotti; Benjamin,18,0,35,17
1658103248370,MATH 103A,A01,083777,Greenfeld; Be'Eri,6,0,36,30
1658103248370,MATH 103A,A02,083778,Greenfeld; Be'Eri,5,0,36,31
1658103248370,MATH 103A,A03,093561,Greenfeld; Be'Eri,7,0,36,29
1658103248370,MATH 103A,B01,083779,Greenfeld; Be'Eri,8,0,36,28
1658103248370,MATH 103A,B02,083780,Greenfeld; Be'Eri,4,0,36,32
1658103248370,MATH 103A,B03,093562,Greenfeld; Be'Eri,3,0,36,33
1658103254393,MATH 105,A01,085443,Carter; Anne Toulson,15,0,35,20
1658103254393,MATH 105,A02,093477,Carter; Anne Toulson,20,0,35,15
1658103260417,MATH 109,A01,083213,Ganzberger; Geoffrey Michael,3,0,34,31
1658103260417,MATH 109,A02,083214,Ganzberger; Geoffrey Michael,4,0,34,30
1658103260417,MATH 109,A03,093478,Ganzberger; Geoffrey Michael,2,0,34,32
1658103260417,MATH 109,B01,083215,Ganzberger; Geoffrey Michael,3,0,32,29
1658103260417,MATH 109,B02,083216,Ganzberger; Geoffrey Michael,3,0,32,29
1658103260417,MATH 109,B03,093479,Ganzberger; Geoffrey Michael,8,0,32,24
1658103266442,MATH 142A,A01,083219,Chow; Bennett,7,0,32,25
1658103266442,MATH 142A,A02,083220,Chow; Bennett,10,0,32,22
1658103266442,MATH 142A,A03,093480,Chow; Bennett,9,0,32,23
1658103266442,MATH 142A,B03,093481,Chow; Bennett,8,0,32,24
1658103266442,MATH 142A,B04,093558,Chow; Bennett,14,0,32,18
1658103266442,MATH 142A,B05,093559,Chow; Bennett,7,0,32,25
1658103272465,MATH 193A,A01,083224,Rotar; Vladimir,9,0,34,25
1658103272465,MATH 193A,A02,083225,Rotar; Vladimir,11,0,34,23
1658103272465,MATH 193A,A03,083781,Rotar; Vladimir,5,0,34,29
1658103272465,MATH 193A,A04,083782,Rotar; Vladimir,12,0,34,22
1658103272465,MATH 193A,A05,093482,Rotar; Vladimir,11,0,34,23
1658103278488,MATH 197,001,091859,McAuley; Julian John,9999,0,9999,0
1658103278488,MATH 197,002,095566,Kedlaya; Kiran S.,9997,0,9999,2
1658103278488,MATH 197,003,095567,Xiao; Ming,9999,0,9999,0
1658103278488,MATH 197,004,095571,Perols; Johan Lars,9998,0,9999,1
1658103285538,COGS 9,A01,083615,Shannon; Kyle Michael,11,0,75,64
1658103291570,COGS 11,A01,083617,Boyle; Mary E. T.,23,0,48,25
1658103297593,COGS 13,A01,083071,Bastos; Amalia Pinkusfeld,12,0,71,59
1658103303615,COGS 14A,A01,092681,Semenuks; Arturs,5,1,100,95
1658103309638,COGS 14B,A01,083073,Cheng; Tzu-Han,7,0,63,56
1658103315661,COGS 17,A01,092677,Semenuks; Arturs,7,0,81,74
1658103321684,COGS 100,A01,083619,Allen; Michael Gordon,17,0,70,53
1658103327711,COGS 101A,A01,083621,Davis; Joshua Daniel,9,0,68,59
1658103333738,COGS 101B,A01,091572,Allen; Michael Gordon,14,0,65,51
1658103339763,COGS 101C,A01,083625,Delgado; Tania,17,0,35,18
1658103345787,COGS 107A,A01,083627,Boyle; Mary E. T.,14,0,60,46
1658103351810,COGS 118A,A01,083075,Gupta; Anjum,21,0,76,55
1658103357836,CSE 3,A50,083646,Miranda; Gregory Joseph,24,0,50,26
1658103363863,CSE 8A,A50,083650,Miranda; Gregory Joseph,17,1,56,39
1658103369889,CSE 11,A01,083080,Cao; Yingjun,7,15,40,33
1658103375916,CSE 12,A01,083652,Krause-Levy; Sophia Louisa,30,1,120,90
1658103381940,CSE 15L,A01,083654,Morris; Justin Loren,9,0,50,41
1658103381940,CSE 15L,A02,083655,Morris; Justin Loren,11,0,50,39
1658103387962,CSE 20,A01,083657,Tran; Khoa Dang,39,0,80,41
1658103393988,CSE 21,A01,095574,Bach; Quang Tran,23,0,48,25
1658103400014,CSE 30,A01,083084,Eldon; John,8,0,80,72
1658103400014,CSE 30,B01,095061,Bhaskar; Nishant,9,0,50,41
1658103406036,CSE 100,A01,083659,Cao; Yingjun,5,4,70,65
1658103412059,CSE 134B,A01,083661,Powell; Thomas Allan,25,0,100,75
1658103418083,CSE 140,A01,083663,Gungor; Onat,17,0,85,68
1658103424106,CSE 140L,A01,083088,Eldon; John,23,0,100,77
1658103430138,CSE 175,A01,083665,Kumar; Rakesh,3,0,25,22
1658103436163,CSE 190,A00,092507,Dubnov; Shlomo,8,0,20,12
1658103442198,ECE 45,A01,083139,Congero; Spencer William,7,0,75,68
1658103448221,ECE 65,A50,083695,Saad; Andrew S,12,0,30,18
1658103448221,ECE 65,A51,095125,Saad; Andrew S,24,0,26,2
1658103454245,ECE 109,A01,091882,Touri; Behrouz,21,0,70,49
1658103460270,ECE 180,A00,083140,Abi Samra; Nicholas Camill,1,0,30,29
1658103460270,ECE 180,B00,083141,Abi Samra; Nicholas Camill,0,0,30,30
1658103466293,MATH 10A,A01,083735,Patchell; Gregory David,2,0,30,28
1658103466293,MATH 10A,A02,083736,Patchell; Gregory David,20,0,30,10
1658103466293,MATH 10A,A03,083737,Patchell; Gregory David,16,0,30,14
1658103472315,MATH 10B,A01,083207,Lim; Seonhee,9,0,34,25
1658103472315,MATH 10B,A02,083208,Lim; Seonhee,10,0,35,25
1658103472315,MATH 10B,A03,093472,Lim; Seonhee,7,0,34,27
1658103472315,MATH 10B,B01,083739,Sinha; Shubham,14,0,30,16
1658103478339,MATH 18,A01,083743,Cinel; Cameron Alexander,9,0,30,21
1658103478339,MATH 18,A02,083744,Cinel; Cameron Alexander,18,0,30,12
1658103478339,MATH 18,A03,083745,Cinel; Cameron Alexander,10,0,30,20
1658103478339,MATH 18,B01,083748,Rideout; David Porter,5,0,37,32
1658103478339,MATH 18,B02,083749,Rideout; David Porter,5,0,36,31
1658103478339,MATH 18,B03,083750,Rideout; David Porter,3,0,37,34
1658103478339,MATH 18,B04,083751,Rideout; David Porter,7,0,36,29
1658103478339,MATH 18,B05,093473,Rideout; David Porter,7,0,36,29
1658103478339,MATH 18,B06,093474,Rideout; David Porter,6,0,36,30
1658103484371,MATH 20A,A01,083754,Zheng; Zequn,14,0,40,26
1658103490395,MATH 20B,A01,083756,Briones; Jor-el Thomas Caparas,4,0,36,32
1658103490395,MATH 20B,A02,083757,Briones; Jor-el Thomas Caparas,1,0,36,35
1658103490395,MATH 20B,A03,093475,Briones; Jor-el Thomas Caparas,3,0,36,33
1658103496423,MATH 20C,A01,083760,Briones; Jor-el Thomas Caparas,1,0,35,34
1658103496423,MATH 20C,A02,083761,Briones; Jor-el Thomas Caparas,8,0,35,27
1658103496423,MATH 20C,A03,093476,Briones; Jor-el Thomas Caparas,0,1,36,36
1658103496423,MATH 20C,B01,083762,Bach; Quang Tran,1,0,30,29
1658103502451,MATH 20D,A01,083765,Tran; Brian Kha,5,0,30,25
1658103502451,MATH 20D,A02,083766,Tran; Brian Kha,5,0,30,25
1658103502451,MATH 20D,A03,083767,Tran; Brian Kha,6,0,30,24
1658103508475,MATH 20E,A01,083771,Ganguly; Soumya,12,0,32,20
1658103508475,MATH 20E,A02,083772,Ganguly; Soumya,7,0,32,25
1658103508475,MATH 20E,B01,083773,Ciotti; Benjamin,20,0,35,15
1658103508475,MATH 20E,B02,083774,Ciotti; Benjamin,18,0,35,17
1658103514505,MATH 103A,A01,083777,Greenfeld; Be'Eri,6,0,36,30
1658103514505,MATH 103A,A02,083778,Greenfeld; Be'Eri,5,0,36,31
1658103514505,MATH 103A,A03,093561,Greenfeld; Be'Eri,7,0,36,29
1658103514505,MATH 103A,B01,083779,Greenfeld; Be'Eri,8,0,36,28
1658103514505,MATH 103A,B02,083780,Greenfeld; Be'Eri,4,0,36,32
1658103514505,MATH 103A,B03,093562,Greenfeld; Be'Eri,3,0,36,33
1658103520528,MATH 105,A01,085443,Carter; Anne Toulson,15,0,35,20
1658103520528,MATH 105,A02,093477,Carter; Anne Toulson,20,0,35,15
1658103526563,MATH 109,A01,083213,Ganzberger; Geoffrey Michael,3,0,34,31
1658103526563,MATH 109,A02,083214,Ganzberger; Geoffrey Michael,4,0,34,30
1658103526563,MATH 109,A03,093478,Ganzberger; Geoffrey Michael,2,0,34,32
1658103526563,MATH 109,B01,083215,Ganzberger; Geoffrey Michael,3,0,32,29
1658103526563,MATH 109,B02,083216,Ganzberger; Geoffrey Michael,3,0,32,29
1658103526563,MATH 109,B03,093479,Ganzberger; Geoffrey Michael,8,0,32,24
1658103532593,MATH 142A,A01,083219,Chow; Bennett,7,0,32,25
1658103532593,MATH 142A,A02,083220,Chow; Bennett,10,0,32,22
1658103532593,MATH 142A,A03,093480,Chow; Bennett,9,0,32,23
1658103532593,MATH 142A,B03,093481,Chow; Bennett,8,0,32,24
1658103532593,MATH 142A,B04,093558,Chow; Bennett,14,0,32,18
1658103532593,MATH 142A,B05,093559,Chow; Bennett,7,0,32,25
1658103538616,MATH 193A,A01,083224,Rotar; Vladimir,9,0,34,25
1658103538616,MATH 193A,A02,083225,Rotar; Vladimir,11,0,34,23
1658103538616,MATH 193A,A03,083781,Rotar; Vladimir,5,0,34,29
1658103538616,MATH 193A,A04,083782,Rotar; Vladimir,12,0,34,22
1658103538616,MATH 193A,A05,093482,Rotar; Vladimir,11,0,34,23
1658103544652,MATH 197,001,091859,McAuley; Julian John,9999,0,9999,0
1658103544652,MATH 197,002,095566,Kedlaya; Kiran S.,9997,0,9999,2
1658103544652,MATH 197,003,095567,Xiao; Ming,9999,0,9999,0
1658103544652,MATH 197,004,095571,Perols; Johan Lars,9998,0,9999,1
1658103551714,COGS 9,A01,083615,Shannon; Kyle Michael,11,0,75,64
1658103557737,COGS 11,A01,083617,Boyle; Mary E. T.,23,0,48,25
1658103563760,COGS 13,A01,083071,Bastos; Amalia Pinkusfeld,12,0,71,59
1658103569787,COGS 14A,A01,092681,Semenuks; Arturs,5,1,100,95
1658103575810,COGS 14B,A01,083073,Cheng; Tzu-Han,7,0,63,56
1658103581834,COGS 17,A01,092677,Semenuks; Arturs,7,0,81,74
1658103587857,COGS 100,A01,083619,Allen; Michael Gordon,17,0,70,53
1658103593881,COGS 101A,A01,083621,Davis; Joshua Daniel,9,0,68,59
1658103599905,COGS 101B,A01,091572,Allen; Michael Gordon,14,0,65,51
1658103605929,COGS 101C,A01,083625,Delgado; Tania,17,0,35,18
1658103611952,COGS 107A,A01,083627,Boyle; Mary E. T.,14,0,60,46
1658103617978,COGS 118A,A01,083075,Gupta; Anjum,21,0,76,55
1658103624008,CSE 3,A50,083646,Miranda; Gregory Joseph,24,0,50,26
1658103630032,CSE 8A,A50,083650,Miranda; Gregory Joseph,17,1,56,39
1658103636056,CSE 11,A01,083080,Cao; Yingjun,7,15,40,33
1658103642082,CSE 12,A01,083652,Krause-Levy; Sophia Louisa,30,1,120,90
1658103648109,CSE 15L,A01,083654,Morris; Justin Loren,9,0,50,41
1658103648109,CSE 15L,A02,083655,Morris; Justin Loren,11,0,50,39
1658103654141,CSE 20,A01,083657,Tran; Khoa Dang,39,0,80,41
1658103660164,CSE 21,A01,095574,Bach; Quang Tran,23,0,48,25
1658103666187,CSE 30,A01,083084,Eldon; John,8,0,80,72
1658103666187,CSE 30,B01,095061,Bhaskar; Nishant,9,0,50,41
1658103672211,CSE 100,A01,083659,Cao; Yingjun,5,4,70,65
1658103678237,CSE 134B,A01,083661,Powell; Thomas Allan,25,0,100,75
1658103684261,CSE 140,A01,083663,Gungor; Onat,17,0,85,68
1658103690285,CSE 140L,A01,083088,Eldon; John,23,0,100,77
1658103696312,CSE 175,A01,083665,Kumar; Rakesh,3,0,25,22
1658103702334,CSE 190,A00,092507,Dubnov; Shlomo,8,0,20,12
1658103708360,ECE 45,A01,083139,Congero; Spencer William,7,0,75,68
1658103714392,ECE 65,A50,083695,Saad; Andrew S,12,0,30,18
1658103714392,ECE 65,A51,095125,Saad; Andrew S,24,0,26,2
1658103720417,ECE 109,A01,091882,Touri; Behrouz,21,0,70,49
1658103726442,ECE 180,A00,083140,Abi Samra; Nicholas Camill,1,0,30,29
1658103726442,ECE 180,B00,083141,Abi Samra; Nicholas Camill,0,0,30,30
1658103732465,MATH 10A,A01,083735,Patchell; Gregory David,2,0,30,28
1658103732465,MATH 10A,A02,083736,Patchell; Gregory David,20,0,30,10
1658103732465,MATH 10A,A03,083737,Patchell; Gregory David,16,0,30,14
1658103738489,MATH 10B,A01,083207,Lim; Seonhee,9,0,34,25
1658103738489,MATH 10B,A02,083208,Lim; Seonhee,10,0,35,25
1658103738489,MATH 10B,A03,093472,Lim; Seonhee,7,0,34,27
1658103738489,MATH 10B,B01,083739,Sinha; Shubham,14,0,30,16
1658103744521,MATH 18,A01,083743,Cinel; Cameron Alexander,9,0,30,21
1658103744521,MATH 18,A02,083744,Cinel; Cameron Alexander,18,0,30,12
1658103744521,MATH 18,A03,083745,Cinel; Cameron Alexander,10,0,30,20
1658103744521,MATH 18,B01,083748,Rideout; David Porter,5,0,37,32
1658103744521,MATH 18,B02,083749,Rideout; David Porter,5,0,36,31
1658103744521,MATH 18,B03,083750,Rideout; David Porter,3,0,37,34
1658103744521,MATH 18,B04,083751,Rideout; David Porter,7,0,36,29
1658103744521,MATH 18,B05,093473,Rideout; David Porter,7,0,36,29
1658103744521,MATH 18,B06,093474,Rideout; David Porter,6,0,36,30
1658103750547,MATH 20A,A01,083754,Zheng; Zequn,14,0,40,26
1658103756570,MATH 20B,A01,083756,Briones; Jor-el Thomas Caparas,4,0,36,32
1658103756570,MATH 20B,A02,083757,Briones; Jor-el Thomas Caparas,1,0,36,35
1658103756570,MATH 20B,A03,093475,Briones; Jor-el Thomas Caparas,3,0,36,33
1658103762610,MATH 20C,A01,083760,Briones; Jor-el Thomas Caparas,1,0,35,34
1658103762610,MATH 20C,A02,083761,Briones; Jor-el Thomas Caparas,8,0,35,27
1658103762610,MATH 20C,A03,093476,Briones; Jor-el Thomas Caparas,0,1,36,36
1658103762610,MATH 20C,B01,083762,Bach; Quang Tran,1,0,30,29
1658103768633,MATH 20D,A01,083765,Tran; Brian Kha,5,0,30,25
1658103768633,MATH 20D,A02,083766,Tran; Brian Kha,5,0,30,25
1658103768633,MATH 20D,A03,083767,Tran; Brian Kha,6,0,30,24
1658103774661,MATH 20E,A01,083771,Ganguly; Soumya,12,0,32,20
1658103774661,MATH 20E,A02,083772,Ganguly; Soumya,7,0,32,25
1658103774661,MATH 20E,B01,083773,Ciotti; Benjamin,20,0,35,15
1658103774661,MATH 20E,B02,083774,Ciotti; Benjamin,18,0,35,17
1658103780689,MATH 103A,A01,083777,Greenfeld; Be'Eri,6,0,36,30
1658103780689,MATH 103A,A02,083778,Greenfeld; Be'Eri,5,0,36,31
1658103780689,MATH 103A,A03,093561,Greenfeld; Be'Eri,7,0,36,29
1658103780689,MATH 103A,B01,083779,Greenfeld; Be'Eri,8,0,36,28
1658103780689,MATH 103A,B02,083780,Greenfeld; Be'Eri,4,0,36,32
1658103780689,MATH 103A,B03,093562,Greenfeld; Be'Eri,3,0,36,33
1658103786711,MATH 105,A01,085443,Carter; Anne Toulson,15,0,35,20
1658103786711,MATH 105,A02,093477,Carter; Anne Toulson,20,0,35,15
1658103792736,MATH 109,A01,083213,Ganzberger; Geoffrey Michael,3,0,34,31
1658103792736,MATH 109,A02,083214,Ganzberger; Geoffrey Michael,4,0,34,30
1658103792736,MATH 109,A03,093478,Ganzberger; Geoffrey Michael,2,0,34,32
1658103792736,MATH 109,B01,083215,Ganzberger; Geoffrey Michael,3,0,32,29
1658103792736,MATH 109,B02,083216,Ganzberger; Geoffrey Michael,3,0,32,29
1658103792736,MATH 109,B03,093479,Ganzberger; Geoffrey Michael,8,0,32,24
1658103798765,MATH 142A,A01,083219,Chow; Bennett,7,0,32,25
1658103798765,MATH 142A,A02,083220,Chow; Bennett,10,0,32,22
1658103798765,MATH 142A,A03,093480,Chow; Bennett,9,0,32,23
1658103798765,MATH 142A,B03,093481,Chow; Bennett,8,0,32,24
1658103798765,MATH 142A,B04,093558,Chow; Bennett,14,0,32,18
1658103798765,MATH 142A,B05,093559,Chow; Bennett,7,0,32,25
1658103804792,MATH 193A,A01,083224,Rotar; Vladimir,9,0,34,25
1658103804792,MATH 193A,A02,083225,Rotar; Vladimir,11,0,34,23
1658103804792,MATH 193A,A03,083781,Rotar; Vladimir,5,0,34,29
1658103804792,MATH 193A,A04,083782,Rotar; Vladimir,12,0,34,22
1658103804792,MATH 193A,A05,093482,Rotar; Vladimir,11,0,34,23
1658103810826,MATH 197,001,091859,McAuley; Julian John,9999,0,9999,0
1658103810826,MATH 197,002,095566,Kedlaya; Kiran S.,9997,0,9999,2
1658103810826,MATH 197,003,095567,Xiao; Ming,9999,0,9999,0
1658103810826,MATH 197,004,095571,Perols; Johan Lars,9998,0,9999,1
1658103817968,COGS 9,A01,083615,Shannon; Kyle Michael,11,0,75,64
1658103823998,COGS 11,A01,083617,Boyle; Mary E. T.,23,0,48,25
1658103830020,COGS 13,A01,083071,Bastos; Amalia Pinkusfeld,12,0,71,59
1658103836042,COGS 14A,A01,092681,Semenuks; Arturs,5,1,100,95
1658103842071,COGS 14B,A01,083073,Cheng; Tzu-Han,7,0,63,56
1658103848093,COGS 17,A01,092677,Semenuks; Arturs,7,0,81,74
1658103854117,COGS 100,A01,083619,Allen; Michael Gordon,17,0,70,53
1658103860147,COGS 101A,A01,083621,Davis; Joshua Daniel,9,0,68,59
1658103866171,COGS 101B,A01,091572,Allen; Michael Gordon,14,0,65,51
1658103872199,COGS 101C,A01,083625,Delgado; Tania,17,0,35,18
1658103878225,COGS 107A,A01,083627,Boyle; Mary E. T.,14,0,60,46
1658103884252,COGS 118A,A01,083075,Gupta; Anjum,21,0,76,55
1658103890276,CSE 3,A50,083646,Miranda; Gregory Joseph,24,0,50,26
1658103896304,CSE 8A,A50,083650,Miranda; Gregory Joseph,17,1,56,39
1658103902332,CSE 11,A01,083080,Cao; Yingjun,7,15,40,33
1658103908371,CSE 12,A01,083652,Krause-Levy; Sophia Louisa,30,1,120,90
1658103914401,CSE 15L,A01,083654,Morris; Justin Loren,9,0,50,41
1658103914401,CSE 15L,A02,083655,Morris; Justin Loren,11,0,50,39
1658103920424,CSE 20,A01,083657,Tran; Khoa Dang,39,0,80,41
1658103926458,CSE 21,A01,095574,Bach; Quang Tran,23,0,48,25
1658103932485,CSE 30,A01,083084,Eldon; John,8,0,80,72
1658103932485,CSE 30,B01,095061,Bhaskar; Nishant,9,0,50,41
1658103938508,CSE 100,A01,083659,Cao; Yingjun,5,4,70,65
1658103944530,CSE 134B,A01,083661,Powell; Thomas Allan,25,0,100,75
1658103950565,CSE 140,A01,083663,Gungor; Onat,17,0,85,68
1658103956588,CSE 140L,A01,083088,Eldon; John,23,0,100,77
1658103962614,CSE 175,A01,083665,Kumar; Rakesh,3,0,25,22
1658103968652,CSE 190,A00,092507,Dubnov; Shlomo,8,0,20,12
1658103974674,ECE 45,A01,083139,Congero; Spencer William,7,0,75,68
1658103980701,ECE 65,A50,083695,Saad; Andrew S,12,0,30,18
1658103980701,ECE 65,A51,095125,Saad; Andrew S,24,0,26,2
1658103986724,ECE 109,A01,091882,Touri; Behrouz,21,0,70,49
1658103992747,ECE 180,A00,083140,Abi Samra; Nicholas Camill,1,0,30,29
1658103992747,ECE 180,B00,083141,Abi Samra; Nicholas Camill,0,0,30,30
1658103998781,MATH 10A,A01,083735,Patchell; Gregory David,2,0,30,28
1658103998781,MATH 10A,A02,083736,Patchell; Gregory David,20,0,30,10
1658103998781,MATH 10A,A03,083737,Patchell; Gregory David,16,0,30,14
1658104004803,MATH 10B,A01,083207,Lim; Seonhee,9,0,34,25
1658104004803,MATH 10B,A02,083208,Lim; Seonhee,10,0,35,25
1658104004803,MATH 10B,A03,093472,Lim; Seonhee,7,0,34,27
1658104004803,MATH 10B,B01,083739,Sinha; Shubham,14,0,30,16
1658104010828,MATH 18,A01,083743,Cinel; Cameron Alexander,9,0,30,21
1658104010828,MATH 18,A02,083744,Cinel; Cameron Alexander,18,0,30,12
1658104010828,MATH 18,A03,083745,Cinel; Cameron Alexander,10,0,30,20
1658104010828,MATH 18,B01,083748,Rideout; David Porter,5,0,37,32
1658104010828,MATH 18,B02,083749,Rideout; David Porter,5,0,36,31
1658104010828,MATH 18,B03,083750,Rideout; David Porter,3,0,37,34
1658104010828,MATH 18,B04,083751,Rideout; David Porter,7,0,36,29
1658104010828,MATH 18,B05,093473,Rideout; David Porter,7,0,36,29
1658104010828,MATH 18,B06,093474,Rideout; David Porter,6,0,36,30
1658104016855,MATH 20A,A01,083754,Zheng; Zequn,14,0,40,26
1658104022883,MATH 20B,A01,083756,Briones; Jor-el Thomas Caparas,4,0,36,32
1658104022883,MATH 20B,A02,083757,Briones; Jor-el Thomas Caparas,1,0,36,35
1658104022883,MATH 20B,A03,093475,Briones; Jor-el Thomas Caparas,3,0,36,33
1658104028911,MATH 20C,A01,083760,Briones; Jor-el Thomas Caparas,1,0,35,34
1658104028911,MATH 20C,A02,083761,Briones; Jor-el Thomas Caparas,8,0,35,27
1658104028911,MATH 20C,A03,093476,Briones; Jor-el Thomas Caparas,0,1,36,36
1658104028911,MATH 20C,B01,083762,Bach; Quang Tran,1,0,30,29
1658104034933,MATH 20D,A01,083765,Tran; Brian Kha,5,0,30,25
1658104034933,MATH 20D,A02,083766,Tran; Brian Kha,5,0,30,25
1658104034933,MATH 20D,A03,083767,Tran; Brian Kha,6,0,30,24
1658104040958,MATH 20E,A01,083771,Ganguly; Soumya,12,0,32,20
1658104040958,MATH 20E,A02,083772,Ganguly; Soumya,7,0,32,25
1658104040958,MATH 20E,B01,083773,Ciotti; Benjamin,20,0,35,15
1658104040958,MATH 20E,B02,083774,Ciotti; Benjamin,18,0,35,17
1658104046997,MATH 103A,A01,083777,Greenfeld; Be'Eri,6,0,36,30
1658104046997,MATH 103A,A02,083778,Greenfeld; Be'Eri,5,0,36,31
1658104046997,MATH 103A,A03,093561,Greenfeld; Be'Eri,7,0,36,29
1658104046997,MATH 103A,B01,083779,Greenfeld; Be'Eri,8,0,36,28
1658104046997,MATH 103A,B02,083780,Greenfeld; Be'Eri,4,0,36,32
1658104046997,MATH 103A,B03,093562,Greenfeld; Be'Eri,3,0,36,33
1658104053021,MATH 105,A01,085443,Carter; Anne Toulson,15,0,35,20
1658104053021,MATH 105,A02,093477,Carter; Anne Toulson,20,0,35,15
1658104059044,MATH 109,A01,083213,Ganzberger; Geoffrey Michael,3,0,34,31
1658104059044,MATH 109,A02,083214,Ganzberger; Geoffrey Michael,4,0,34,30
1658104059044,MATH 109,A03,093478,Ganzberger; Geoffrey Michael,2,0,34,32
1658104059044,MATH 109,B01,083215,Ganzberger; Geoffrey Michael,3,0,32,29
1658104059044,MATH 109,B02,083216,Ganzberger; Geoffrey Michael,3,0,32,29
1658104059044,MATH 109,B03,093479,Ganzberger; Geoffrey Michael,8,0,32,24
1658104065075,MATH 142A,A01,083219,Chow; Bennett,7,0,32,25
1658104065075,MATH 142A,A02,083220,Chow; Bennett,10,0,32,22
1658104065075,MATH 142A,A03,093480,Chow; Bennett,9,0,32,23
1658104065075,MATH 142A,B03,093481,Chow; Bennett,8,0,32,24
1658104065075,MATH 142A,B04,093558,Chow; Bennett,14,0,32,18
1658104065075,MATH 142A,B05,093559,Chow; Bennett,7,0,32,25
1658104071105,MATH 193A,A01,083224,Rotar; Vladimir,9,0,34,25
1658104071105,MATH 193A,A02,083225,Rotar; Vladimir,11,0,34,23
1658104071105,MATH 193A,A03,083781,Rotar; Vladimir,5,0,34,29
1658104071105,MATH 193A,A04,083782,Rotar; Vladimir,12,0,34,22
1658104071105,MATH 193A,A05,093482,Rotar; Vladimir,11,0,34,23
1658104077132,MATH 197,001,091859,McAuley; Julian John,9999,0,9999,0
1658104077132,MATH 197,002,095566,Kedlaya; Kiran S.,9997,0,9999,2
1658104077132,MATH 197,003,095567,Xiao; Ming,9999,0,9999,0
1658104077132,MATH 197,004,095571,Perols; Johan Lars,9998,0,9999,1
1658104084188,COGS 9,A01,083615,Shannon; Kyle Michael,11,0,75,64
1658104090210,COGS 11,A01,083617,Boyle; Mary E. T.,23,0,48,25
1658104096234,COGS 13,A01,083071,Bastos; Amalia Pinkusfeld,12,0,71,59
1658104102260,COGS 14A,A01,092681,Semenuks; Arturs,5,1,100,95
1658104108283,COGS 14B,A01,083073,Cheng; Tzu-Han,7,0,63,56
1658104114310,COGS 17,A01,092677,Semenuks; Arturs,7,0,81,74
1658104120336,COGS 100,A01,083619,Allen; Michael Gordon,17,0,70,53
1658104126359,COGS 101A,A01,083621,Davis; Joshua Daniel,9,0,68,59
1658104132381,COGS 101B,A01,091572,Allen; Michael Gordon,14,0,65,51
1658104138404,COGS 101C,A01,083625,Delgado; Tania,17,0,35,18
1658104144428,COGS 107A,A01,083627,Boyle; Mary E. T.,14,0,60,46
1658104150453,COGS 118A,A01,083075,Gupta; Anjum,21,0,76,55
1658104156483,CSE 3,A50,083646,Miranda; Gregory Joseph,24,0,50,26
1658104162507,CSE 8A,A50,083650,Miranda; Gregory Joseph,17,1,56,39
1658104168533,CSE 11,A01,083080,Cao; Yingjun,7,15,40,33
1658104174558,CSE 12,A01,083652,Krause-Levy; Sophia Louisa,30,1,120,90
1658104180586,CSE 15L,A01,083654,Morris; Justin Loren,9,0,50,41
1658104180586,CSE 15L,A02,083655,Morris; Justin Loren,11,0,50,39
1658104186614,CSE 20,A01,083657,Tran; Khoa Dang,39,0,80,41
1658104192642,CSE 21,A01,095574,Bach; Quang Tran,23,0,48,25
1658104198666,CSE 30,A01,083084,Eldon; John,8,0,80,72
1658104198666,CSE 30,B01,095061,Bhaskar; Nishant,9,0,50,41
1658104204692,CSE 100,A01,083659,Cao; Yingjun,5,4,70,65
1658104210714,CSE 134B,A01,083661,Powell; Thomas Allan,25,0,100,75
1658104216739,CSE 140,A01,083663,Gungor; Onat,17,0,85,68
1658104222762,CSE 140L,A01,083088,Eldon; John,23,0,100,77
1658104228784,CSE 175,A01,083665,Kumar; Rakesh,3,0,25,22
1658104234808,CSE 190,A00,092507,Dubnov; Shlomo,8,0,20,12
1658104240830,ECE 45,A01,083139,Congero; Spencer William,7,0,75,68
1658104246858,ECE 65,A50,083695,Saad; Andrew S,12,0,30,18
1658104246858,ECE 65,A51,095125,Saad; Andrew S,24,0,26,2
1658104252881,ECE 109,A01,091882,Touri; Behrouz,21,0,70,49
1658104258906,ECE 180,A00,083140,Abi Samra; Nicholas Camill,1,0,30,29
1658104258906,ECE 180,B00,083141,Abi Samra; Nicholas Camill,0,0,30,30
1658104264934,MATH 10A,A01,083735,Patchell; Gregory David,2,0,30,28
1658104264934,MATH 10A,A02,083736,Patchell; Gregory David,20,0,30,10
1658104264934,MATH 10A,A03,083737,Patchell; Gregory David,16,0,30,14
1658104270961,MATH 10B,A01,083207,Lim; Seonhee,9,0,34,25
1658104270961,MATH 10B,A02,083208,Lim; Seonhee,10,0,35,25
1658104270961,MATH 10B,A03,093472,Lim; Seonhee,7,0,34,27
1658104270961,MATH 10B,B01,083739,Sinha; Shubham,14,0,30,16
1658104276993,MATH 18,A01,083743,Cinel; Cameron Alexander,9,0,30,21
1658104276993,MATH 18,A02,083744,Cinel; Cameron Alexander,18,0,30,12
1658104276993,MATH 18,A03,083745,Cinel; Cameron Alexander,10,0,30,20
1658104276993,MATH 18,B01,083748,Rideout; David Porter,5,0,37,32
1658104276993,MATH 18,B02,083749,Rideout; David Porter,5,0,36,31
1658104276993,MATH 18,B03,083750,Rideout; David Porter,3,0,37,34
1658104276993,MATH 18,B04,083751,Rideout; David Porter,7,0,36,29
1658104276993,MATH 18,B05,093473,Rideout; David Porter,7,0,36,29
1658104276993,MATH 18,B06,093474,Rideout; David Porter,6,0,36,30
1658104283018,MATH 20A,A01,083754,Zheng; Zequn,14,0,40,26
1658104289044,MATH 20B,A01,083756,Briones; Jor-el Thomas Caparas,4,0,36,32
1658104289044,MATH 20B,A02,083757,Briones; Jor-el Thomas Caparas,1,0,36,35
1658104289044,MATH 20B,A03,093475,Briones; Jor-el Thomas Caparas,3,0,36,33
1658104295072,MATH 20C,A01,083760,Briones; Jor-el Thomas Caparas,1,0,35,34
1658104295072,MATH 20C,A02,083761,Briones; Jor-el Thomas Caparas,8,0,35,27
1658104295072,MATH 20C,A03,093476,Briones; Jor-el Thomas Caparas,0,1,36,36
1658104295072,MATH 20C,B01,083762,Bach; Quang Tran,1,0,30,29
1658104301097,MATH 20D,A01,083765,Tran; Brian Kha,5,0,30,25
1658104301097,MATH 20D,A02,083766,Tran; Brian Kha,5,0,30,25
1658104301097,MATH 20D,A03,083767,Tran; Brian Kha,6,0,30,24
1658104307126,MATH 20E,A01,083771,Ganguly; Soumya,12,0,32,20
1658104307126,MATH 20E,A02,083772,Ganguly; Soumya,7,0,32,25
1658104307126,MATH 20E,B01,083773,Ciotti; Benjamin,20,0,35,15
1658104307126,MATH 20E,B02,083774,Ciotti; Benjamin,18,0,35,17
1658104313155,MATH 103A,A01,083777,Greenfeld; Be'Eri,6,0,36,30
1658104313155,MATH 103A,A02,083778,Greenfeld; Be'Eri,5,0,36,31
1658104313155,MATH 103A,A03,093561,Greenfeld; Be'Eri,7,0,36,29
1658104313155,MATH 103A,B01,083779,Greenfeld; Be'Eri,8,0,36,28
1658104313155,MATH 103A,B02,083780,Greenfeld; Be'Eri,4,0,36,32
1658104313155,MATH 103A,B03,093562,Greenfeld; Be'Eri,3,0,36,33
1658104319180,MATH 105,A01,085443,Carter; Anne Toulson,15,0,35,20
1658104319180,MATH 105,A02,093477,Carter; Anne Toulson,20,0,35,15
1658104325205,MATH 109,A01,083213,Ganzberger; Geoffrey Michael,3,0,34,31
1658104325205,MATH 109,A02,083214,Ganzberger; Geoffrey Michael,4,0,34,30
1658104325205,MATH 109,A03,093478,Ganzberger; Geoffrey Michael,2,0,34,32
1658104325205,MATH 109,B01,083215,Ganzberger; Geoffrey Michael,3,0,32,29
1658104325205,MATH 109,B02,083216,Ganzberger; Geoffrey Michael,3,0,32,29
1658104325205,MATH 109,B03,093479,Ganzberger; Geoffrey Michael,8,0,32,24
1658104331229,MATH 142A,A01,083219,Chow; Bennett,7,0,32,25
1658104331229,MATH 142A,A02,083220,Chow; Bennett,10,0,32,22
1658104331229,MATH 142A,A03,093480,Chow; Bennett,9,0,32,23
1658104331229,MATH 142A,B03,093481,Chow; Bennett,8,0,32,24
1658104331229,MATH 142A,B04,093558,Chow; Bennett,14,0,32,18
1658104331229,MATH 142A,B05,093559,Chow; Bennett,7,0,32,25
1658104337254,MATH 193A,A01,083224,Rotar; Vladimir,9,0,34,25
1658104337254,MATH 193A,A02,083225,Rotar; Vladimir,11,0,34,23
1658104337254,MATH 193A,A03,083781,Rotar; Vladimir,5,0,34,29
1658104337254,MATH 193A,A04,083782,Rotar; Vladimir,12,0,34,22
1658104337254,MATH 193A,A05,093482,Rotar; Vladimir,11,0,34,23
1658104343282,MATH 197,001,091859,McAuley; Julian John,9999,0,9999,0
1658104343282,MATH 197,002,095566,Kedlaya; Kiran S.,9997,0,9999,2
1658104343282,MATH 197,003,095567,Xiao; Ming,9999,0,9999,0
1658104343282,MATH 197,004,095571,Perols; Johan Lars,9998,0,9999,1
1658104350345,COGS 9,A01,083615,Shannon; Kyle Michael,11,0,75,64
1658104356368,COGS 11,A01,083617,Boyle; Mary E. T.,23,0,48,25
1658104362391,COGS 13,A01,083071,Bastos; Amalia Pinkusfeld,12,0,71,59
1658104368414,COGS 14A,A01,092681,Semenuks; Arturs,5,1,100,95
1658104374442,COGS 14B,A01,083073,Cheng; Tzu-Han,7,0,63,56
1658104380471,COGS 17,A01,092677,Semenuks; Arturs,7,0,81,74
1658104386500,COGS 100,A01,083619,Allen; Michael Gordon,17,0,70,53
1658104392523,COGS 101A,A01,083621,Davis; Joshua Daniel,9,0,68,59
1658104398546,COGS 101B,A01,091572,Allen; Michael Gordon,14,0,65,51
1658104404570,COGS 101C,A01,083625,Delgado; Tania,17,0,35,18
1658104410668,COGS 107A,A01,083627,Boyle; Mary E. T.,14,0,60,46
1658104416691,COGS 118A,A01,083075,Gupta; Anjum,21,0,76,55
1658104422715,CSE 3,A50,083646,Miranda; Gregory Joseph,24,0,50,26
1658104428739,CSE 8A,A50,083650,Miranda; Gregory Joseph,17,1,56,39
1658104434762,CSE 11,A01,083080,Cao; Yingjun,7,15,40,33
1658104440790,CSE 12,A01,083652,Krause-Levy; Sophia Louisa,30,1,120,90
1658104446813,CSE 15L,A01,083654,Morris; Justin Loren,9,0,50,41
1658104446813,CSE 15L,A02,083655,Morris; Justin Loren,11,0,50,39
1658104452840,CSE 20,A01,083657,Tran; Khoa Dang,39,0,80,41
1658104458881,CSE 21,A01,095574,Bach; Quang Tran,23,0,48,25
1658104464906,CSE 30,A01,083084,Eldon; John,8,0,80,72
1658104464906,CSE 30,B01,095061,Bhaskar; Nishant,9,0,50,41
1658104470929,CSE 100,A01,083659,Cao; Yingjun,5,4,70,65
1658104476953,CSE 134B,A01,083661,Powell; Thomas Allan,25,0,100,75
1658104482979,CSE 140,A01,083663,Gungor; Onat,17,0,85,68
1658104489006,CSE 140L,A01,083088,Eldon; John,23,0,100,77
1658104495029,CSE 175,A01,083665,Kumar; Rakesh,3,0,25,22
1658104501052,CSE 190,A00,092507,Dubnov; Shlomo,8,0,20,12
1658104507074,ECE 45,A01,083139,Congero; Spencer William,7,0,75,68
1658104513097,ECE 65,A50,083695,Saad; Andrew S,12,0,30,18
1658104513097,ECE 65,A51,095125,Saad; Andrew S,24,0,26,2
1658104519126,ECE 109,A01,091882,Touri; Behrouz,21,0,70,49
1658104525149,ECE 180,A00,083140,Abi Samra; Nicholas Camill,1,0,30,29
1658104525149,ECE 180,B00,083141,Abi Samra; Nicholas Camill,0,0,30,30
1658104531176,MATH 10A,A01,083735,Patchell; Gregory David,2,0,30,28
1658104531176,MATH 10A,A02,083736,Patchell; Gregory David,20,0,30,10
1658104531176,MATH 10A,A03,083737,Patchell; Gregory David,16,0,30,14
1658104537216,MATH 10B,A01,083207,Lim; Seonhee,9,0,34,25
1658104537216,MATH 10B,A02,083208,Lim; Seonhee,10,0,35,25
1658104537216,MATH 10B,A03,093472,Lim; Seonhee,7,0,34,27
1658104537216,MATH 10B,B01,083739,Sinha; Shubham,14,0,30,16
1658104543247,MATH 18,A01,083743,Cinel; Cameron Alexander,9,0,30,21
1658104543247,MATH 18,A02,083744,Cinel; Cameron Alexander,18,0,30,12
1658104543247,MATH 18,A03,083745,Cinel; Cameron Alexander,10,0,30,20
1658104543247,MATH 18,B01,083748,Rideout; David Porter,5,0,37,32
1658104543247,MATH 18,B02,083749,Rideout; David Porter,5,0,36,31
1658104543247,MATH 18,B03,083750,Rideout; David Porter,3,0,37,34
1658104543247,MATH 18,B04,083751,Rideout; David Porter,7,0,36,29
1658104543247,MATH 18,B05,093473,Rideout; David Porter,7,0,36,29
1658104543247,MATH 18,B06,093474,Rideout; David Porter,6,0,36,30
1658104549268,MATH 20A,A01,083754,Zheng; Zequn,14,0,40,26
1658104555291,MATH 20B,A01,083756,Briones; Jor-el Thomas Caparas,4,0,36,32
1658104555291,MATH 20B,A02,083757,Briones; Jor-el Thomas Caparas,1,0,36,35
1658104555291,MATH 20B,A03,093475,Briones; Jor-el Thomas Caparas,3,0,36,33
1658104561327,MATH 20C,A01,083760,Briones; Jor-el Thomas Caparas,1,0,35,34
1658104561327,MATH 20C,A02,083761,Briones; Jor-el Thomas Caparas,8,0,35,27
1658104561327,MATH 20C,A03,093476,Briones; Jor-el Thomas Caparas,0,1,36,36
1658104561327,MATH 20C,B01,083762,Bach; Quang Tran,1,0,30,29
1658104567357,MATH 20D,A01,083765,Tran; Brian Kha,5,0,30,25
1658104567357,MATH 20D,A02,083766,Tran; Brian Kha,5,0,30,25
1658104567357,MATH 20D,A03,083767,Tran; Brian Kha,6,0,30,24
1658104573381,MATH 20E,A01,083771,Ganguly; Soumya,12,0,32,20
1658104573381,MATH 20E,A02,083772,Ganguly; Soumya,7,0,32,25
1658104573381,MATH 20E,B01,083773,Ciotti; Benjamin,20,0,35,15
1658104573381,MATH 20E,B02,083774,Ciotti; Benjamin,18,0,35,17
1658104579406,MATH 103A,A01,083777,Greenfeld; Be'Eri,6,0,36,30
1658104579406,MATH 103A,A02,083778,Greenfeld; Be'Eri,5,0,36,31
1658104579406,MATH 103A,A03,093561,Greenfeld; Be'Eri,7,0,36,29
1658104579406,MATH 103A,B01,083779,Greenfeld; Be'Eri,8,0,36,28
1658104579406,MATH 103A,B02,083780,Greenfeld; Be'Eri,4,0,36,32
1658104579406,MATH 103A,B03,093562,Greenfeld; Be'Eri,3,0,36,33
1658104585430,MATH 105,A01,085443,Carter; Anne Toulson,15,0,35,20
1658104585430,MATH 105,A02,093477,Carter; Anne Toulson,20,0,35,15
1658104591454,MATH 109,A01,083213,Ganzberger; Geoffrey Michael,3,0,34,31
1658104591454,MATH 109,A02,083214,Ganzberger; Geoffrey Michael,4,0,34,30
1658104591454,MATH 109,A03,093478,Ganzberger; Geoffrey Michael,2,0,34,32
1658104591454,MATH 109,B01,083215,Ganzberger; Geoffrey Michael,3,0,32,29
1658104591454,MATH 109,B02,083216,Ganzberger; Geoffrey Michael,3,0,32,29
1658104591454,MATH 109,B03,093479,Ganzberger; Geoffrey Michael,8,0,32,24
1658104597482,MATH 142A,A01,083219,Chow; Bennett,7,0,32,25
1658104597482,MATH 142A,A02,083220,Chow; Bennett,10,0,32,22
1658104597482,MATH 142A,A03,093480,Chow; Bennett,9,0,32,23
1658104597482,MATH 142A,B03,093481,Chow; Bennett,8,0,32,24
1658104597482,MATH 142A,B04,093558,Chow; Bennett,14,0,32,18
1658104597482,MATH 142A,B05,093559,Chow; Bennett,7,0,32,25
1658104603510,MATH 193A,A01,083224,Rotar; Vladimir,9,0,34,25
1658104603510,MATH 193A,A02,083225,Rotar; Vladimir,11,0,34,23
1658104603510,MATH 193A,A03,083781,Rotar; Vladimir,5,0,34,29
1658104603510,MATH 193A,A04,083782,Rotar; Vladimir,12,0,34,22
1658104603510,MATH 193A,A05,093482,Rotar; Vladimir,11,0,34,23
1658104609537,MATH 197,001,091859,McAuley; Julian John,9999,0,9999,0
1658104609537,MATH 197,002,095566,Kedlaya; Kiran S.,9997,0,9999,2
1658104609537,MATH 197,003,095567,Xiao; Ming,9999,0,9999,0
1658104609537,MATH 197,004,095571,Perols; Johan Lars,9998,0,9999,1
1658104616597,COGS 9,A01,083615,Shannon; Kyle Michael,11,0,75,64
1658104622622,COGS 11,A01,083617,Boyle; Mary E. T.,23,0,48,25
1658104628645,COGS 13,A01,083071,Bastos; Amalia Pinkusfeld,12,0,71,59
1658104634673,COGS 14A,A01,092681,Semenuks; Arturs,5,1,100,95
1658104640697,COGS 14B,A01,083073,Cheng; Tzu-Han,7,0,63,56
1658104646721,COGS 17,A01,092677,Semenuks; Arturs,7,0,81,74
1658104652743,COGS 100,A01,083619,Allen; Michael Gordon,17,0,70,53
1658104658766,COGS 101A,A01,083621,Davis; Joshua Daniel,9,0,68,59
1658104664789,COGS 101B,A01,091572,Allen; Michael Gordon,14,0,65,51
1658104670813,COGS 101C,A01,083625,Delgado; Tania,17,0,35,18
1658104676836,COGS 107A,A01,083627,Boyle; Mary E. T.,14,0,60,46
1658104682858,COGS 118A,A01,083075,Gupta; Anjum,21,0,76,55
1658104688886,CSE 3,A50,083646,Miranda; Gregory Joseph,24,0,50,26
1658104694909,CSE 8A,A50,083650,Miranda; Gregory Joseph,17,1,56,39
1658104700932,CSE 11,A01,083080,Cao; Yingjun,7,15,40,33
1658104706958,CSE 12,A01,083652,Krause-Levy; Sophia Louisa,30,1,120,90
1658104712983,CSE 15L,A01,083654,Morris; Justin Loren,9,0,50,41
1658104712983,CSE 15L,A02,083655,Morris; Justin Loren,11,0,50,39
1658104719006,CSE 20,A01,083657,Tran; Khoa Dang,39,0,80,41
1658104725034,CSE 21,A01,095574,Bach; Quang Tran,23,0,48,25
1658104731056,CSE 30,A01,083084,Eldon; John,8,0,80,72
1658104731056,CSE 30,B01,095061,Bhaskar; Nishant,9,0,50,41
1658104737081,CSE 100,A01,083659,Cao; Yingjun,5,4,70,65
1658104743107,CSE 134B,A01,083661,Powell; Thomas Allan,25,0,100,75
1658104749131,CSE 140,A01,083663,Gungor; Onat,17,0,85,68
1658104755158,CSE 140L,A01,083088,Eldon; John,23,0,100,77
1658104761180,CSE 175,A01,083665,Kumar; Rakesh,3,0,25,22
1658104767204,CSE 190,A00,092507,Dubnov; Shlomo,8,0,20,12
1658104773227,ECE 45,A01,083139,Congero; Spencer William,7,0,75,68
1658104779266,ECE 65,A50,083695,Saad; Andrew S,12,0,30,18
1658104779266,ECE 65,A51,095125,Saad; Andrew S,24,0,26,2
1658104785306,ECE 109,A01,091882,Touri; Behrouz,21,0,70,49
1658104791334,ECE 180,A00,083140,Abi Samra; Nicholas Camill,1,0,30,29
1658104791334,ECE 180,B00,083141,Abi Samra; Nicholas Camill,0,0,30,30
1658104797358,MATH 10A,A01,083735,Patchell; Gregory David,2,0,30,28
1658104797358,MATH 10A,A02,083736,Patchell; Gregory David,20,0,30,10
1658104797358,MATH 10A,A03,083737,Patchell; Gregory David,16,0,30,14
1658104803382,MATH 10B,A01,083207,Lim; Seonhee,9,0,34,25
1658104803382,MATH 10B,A02,083208,Lim; Seonhee,10,0,35,25
1658104803382,MATH 10B,A03,093472,Lim; Seonhee,7,0,34,27
1658104803382,MATH 10B,B01,083739,Sinha; Shubham,14,0,30,16
1658104809413,MATH 18,A01,083743,Cinel; Cameron Alexander,9,0,30,21
1658104809413,MATH 18,A02,083744,Cinel; Cameron Alexander,18,0,30,12
1658104809413,MATH 18,A03,083745,Cinel; Cameron Alexander,10,0,30,20
1658104809413,MATH 18,B01,083748,Rideout; David Porter,5,0,37,32
1658104809413,MATH 18,B02,083749,Rideout; David Porter,5,0,36,31
1658104809413,MATH 18,B03,083750,Rideout; David Porter,3,0,37,34
1658104809413,MATH 18,B04,083751,Rideout; David Porter,7,0,36,29
1658104809413,MATH 18,B05,093473,Rideout; David Porter,7,0,36,29
1658104809413,MATH 18,B06,093474,Rideout; David Porter,6,0,36,30
1658104815435,MATH 20A,A01,083754,Zheng; Zequn,14,0,40,26
1658104821458,MATH 20B,A01,083756,Briones; Jor-el Thomas Caparas,4,0,36,32
1658104821458,MATH 20B,A02,083757,Briones; Jor-el Thomas Caparas,1,0,36,35
1658104821458,MATH 20B,A03,093475,Briones; Jor-el Thomas Caparas,3,0,36,33
1658104827485,MATH 20C,A01,083760,Briones; Jor-el Thomas Caparas,1,0,35,34
1658104827485,MATH 20C,A02,083761,Briones; Jor-el Thomas Caparas,8,0,35,27
1658104827485,MATH 20C,A03,093476,Briones; Jor-el Thomas Caparas,0,1,36,36
1658104827485,MATH 20C,B01,083762,Bach; Quang Tran,1,0,30,29
1658104833514,MATH 20D,A01,083765,Tran; Brian Kha,5,0,30,25
1658104833514,MATH 20D,A02,083766,Tran; Brian Kha,5,0,30,25
1658104833514,MATH 20D,A03,083767,Tran; Brian Kha,6,0,30,24
1658104839538,MATH 20E,A01,083771,Ganguly; Soumya,12,0,32,20
1658104839538,MATH 20E,A02,083772,Ganguly; Soumya,7,0,32,25
1658104839538,MATH 20E,B01,083773,Ciotti; Benjamin,20,0,35,15
1658104839538,MATH 20E,B02,083774,Ciotti; Benjamin,18,0,35,17
1658104845563,MATH 103A,A01,083777,Greenfeld; Be'Eri,6,0,36,30
1658104845563,MATH 103A,A02,083778,Greenfeld; Be'Eri,5,0,36,31
1658104845563,MATH 103A,A03,093561,Greenfeld; Be'Eri,7,0,36,29
1658104845563,MATH 103A,B01,083779,Greenfeld; Be'Eri,8,0,36,28
1658104845563,MATH 103A,B02,083780,Greenfeld; Be'Eri,4,0,36,32
1658104845563,MATH 103A,B03,093562,Greenfeld; Be'Eri,3,0,36,33
1658104851586,MATH 105,A01,085443,Carter; Anne Toulson,15,0,35,20
1658104851586,MATH 105,A02,093477,Carter; Anne Toulson,20,0,35,15
1658104857614,MATH 109,A01,083213,Ganzberger; Geoffrey Michael,3,0,34,31
1658104857614,MATH 109,A02,083214,Ganzberger; Geoffrey Michael,4,0,34,30
1658104857614,MATH 109,A03,093478,Ganzberger; Geoffrey Michael,2,0,34,32
1658104857614,MATH 109,B01,083215,Ganzberger; Geoffrey Michael,3,0,32,29
1658104857614,MATH 109,B02,083216,Ganzberger; Geoffrey Michael,3,0,32,29
1658104857614,MATH 109,B03,093479,Ganzberger; Geoffrey Michael,8,0,32,24
1658104863638,MATH 142A,A01,083219,Chow; Bennett,7,0,32,25
1658104863638,MATH 142A,A02,083220,Chow; Bennett,10,0,32,22
1658104863638,MATH 142A,A03,093480,Chow; Bennett,9,0,32,23
1658104863638,MATH 142A,B03,093481,Chow; Bennett,8,0,32,24
1658104863638,MATH 142A,B04,093558,Chow; Bennett,14,0,32,18
1658104863638,MATH 142A,B05,093559,Chow; Bennett,7,0,32,25
1658104869666,MATH 193A,A01,083224,Rotar; Vladimir,9,0,34,25
1658104869666,MATH 193A,A02,083225,Rotar; Vladimir,11,0,34,23
1658104869666,MATH 193A,A03,083781,Rotar; Vladimir,5,0,34,29
1658104869666,MATH 193A,A04,083782,Rotar; Vladimir,12,0,34,22
1658104869666,MATH 193A,A05,093482,Rotar; Vladimir,11,0,34,23
1658104875689,MATH 197,001,091859,McAuley; Julian John,9999,0,9999,0
1658104875689,MATH 197,002,095566,Kedlaya; Kiran S.,9997,0,9999,2
1658104875689,MATH 197,003,095567,Xiao; Ming,9999,0,9999,0
1658104875689,MATH 197,004,095571,Perols; Johan Lars,9998,0,9999,1
1658104882751,COGS 9,A01,083615,Shannon; Kyle Michael,11,0,75,64
1658104888776,COGS 11,A01,083617,Boyle; Mary E. T.,23,0,48,25
1658104894798,COGS 13,A01,083071,Bastos; Amalia Pinkusfeld,12,0,71,59
1658104900833,COGS 14A,A01,092681,Semenuks; Arturs,5,1,100,95
1658104906858,COGS 14B,A01,083073,Cheng; Tzu-Han,7,0,63,56
1658104912880,COGS 17,A01,092677,Semenuks; Arturs,7,0,81,74
1658104918903,COGS 100,A01,083619,Allen; Michael Gordon,17,0,70,53
1658104924929,COGS 101A,A01,083621,Davis; Joshua Daniel,9,0,68,59
1658104930955,COGS 101B,A01,091572,Allen; Michael Gordon,14,0,65,51
1658104936980,COGS 101C,A01,083625,Delgado; Tania,17,0,35,18
1658104943002,COGS 107A,A01,083627,Boyle; Mary E. T.,14,0,60,46
1658104949024,COGS 118A,A01,083075,Gupta; Anjum,21,0,76,55
1658104955050,CSE 3,A50,083646,Miranda; Gregory Joseph,24,0,50,26
1658104961076,CSE 8A,A50,083650,Miranda; Gregory Joseph,17,1,56,39
1658104967099,CSE 11,A01,083080,Cao; Yingjun,7,15,40,33
1658104973122,CSE 12,A01,083652,Krause-Levy; Sophia Louisa,30,1,120,90
1658104979145,CSE 15L,A01,083654,Morris; Justin Loren,9,0,50,41
1658104979145,CSE 15L,A02,083655,Morris; Justin Loren,11,0,50,39
1658104985172,CSE 20,A01,083657,Tran; Khoa Dang,39,0,80,41
1658104991196,CSE 21,A01,095574,Bach; Quang Tran,23,0,48,25
1658104997222,CSE 30,A01,083084,Eldon; John,8,0,80,72
1658104997222,CSE 30,B01,095061,Bhaskar; Nishant,9,0,50,41
1658105003244,CSE 100,A01,083659,Cao; Yingjun,5,4,70,65
1658105009345,CSE 134B,A01,083661,Powell; Thomas Allan,25,0,100,75
1658105015369,CSE 140,A01,083663,Gungor; Onat,17,0,85,68
1658105021394,CSE 140L,A01,083088,Eldon; John,23,0,100,77
1658105027420,CSE 175,A01,083665,Kumar; Rakesh,3,0,25,22
1658105033457,CSE 190,A00,092507,Dubnov; Shlomo,8,0,20,12
1658105039487,ECE 45,A01,083139,Congero; Spencer William,7,0,75,68
1658105045514,ECE 65,A50,083695,Saad; Andrew S,12,0,30,18
1658105045514,ECE 65,A51,095125,Saad; Andrew S,24,0,26,2
1658105051537,ECE 109,A01,091882,Touri; Behrouz,21,0,70,49
1658105057561,ECE 180,A00,083140,Abi Samra; Nicholas Camill,1,0,30,29
1658105057561,ECE 180,B00,083141,Abi Samra; Nicholas Camill,0,0,30,30
1658105063588,MATH 10A,A01,083735,Patchell; Gregory David,2,0,30,28
1658105063588,MATH 10A,A02,083736,Patchell; Gregory David,20,0,30,10
1658105063588,MATH 10A,A03,083737,Patchell; Gregory David,16,0,30,14
1658105069611,MATH 10B,A01,083207,Lim; Seonhee,9,0,34,25
1658105069611,MATH 10B,A02,083208,Lim; Seonhee,10,0,35,25
1658105069611,MATH 10B,A03,093472,Lim; Seonhee,7,0,34,27
1658105069611,MATH 10B,B01,083739,Sinha; Shubham,14,0,30,16
1658105075637,MATH 18,A01,083743,Cinel; Cameron Alexander,9,0,30,21
1658105075637,MATH 18,A02,083744,Cinel; Cameron Alexander,18,0,30,12
1658105075637,MATH 18,A03,083745,Cinel; Cameron Alexander,10,0,30,20
1658105075637,MATH 18,B01,083748,Rideout; David Porter,5,0,37,32
1658105075637,MATH 18,B02,083749,Rideout; David Porter,5,0,36,31
1658105075637,MATH 18,B03,083750,Rideout; David Porter,3,0,37,34
1658105075637,MATH 18,B04,083751,Rideout; David Porter,7,0,36,29
1658105075637,MATH 18,B05,093473,Rideout; David Porter,7,0,36,29
1658105075637,MATH 18,B06,093474,Rideout; David Porter,6,0,36,30
1658105081663,MATH 20A,A01,083754,Zheng; Zequn,14,0,40,26
1658105087689,MATH 20B,A01,083756,Briones; Jor-el Thomas Caparas,4,0,36,32
1658105087689,MATH 20B,A02,083757,Briones; Jor-el Thomas Caparas,1,0,36,35
1658105087689,MATH 20B,A03,093475,Briones; Jor-el Thomas Caparas,3,0,36,33
1658105093713,MATH 20C,A01,083760,Briones; Jor-el Thomas Caparas,1,0,35,34
1658105093713,MATH 20C,A02,083761,Briones; Jor-el Thomas Caparas,8,0,35,27
1658105093713,MATH 20C,A03,093476,Briones; Jor-el Thomas Caparas,0,1,36,36
1658105093713,MATH 20C,B01,083762,Bach; Quang Tran,1,0,30,29
1658105099741,MATH 20D,A01,083765,Tran; Brian Kha,5,0,30,25
1658105099741,MATH 20D,A02,083766,Tran; Brian Kha,5,0,30,25
1658105099741,MATH 20D,A03,083767,Tran; Brian Kha,6,0,30,24
1658105105770,MATH 20E,A01,083771,Ganguly; Soumya,12,0,32,20
1658105105770,MATH 20E,A02,083772,Ganguly; Soumya,7,0,32,25
1658105105770,MATH 20E,B01,083773,Ciotti; Benjamin,20,0,35,15
1658105105770,MATH 20E,B02,083774,Ciotti; Benjamin,18,0,35,17
1658105111794,MATH 103A,A01,083777,Greenfeld; Be'Eri,6,0,36,30
1658105111794,MATH 103A,A02,083778,Greenfeld; Be'Eri,5,0,36,31
1658105111794,MATH 103A,A03,093561,Greenfeld; Be'Eri,7,0,36,29
1658105111794,MATH 103A,B01,083779,Greenfeld; Be'Eri,8,0,36,28
1658105111794,MATH 103A,B02,083780,Greenfeld; Be'Eri,4,0,36,32
1658105111794,MATH 103A,B03,093562,Greenfeld; Be'Eri,3,0,36,33
1658105117819,MATH 105,A01,085443,Carter; Anne Toulson,15,0,35,20
1658105117819,MATH 105,A02,093477,Carter; Anne Toulson,20,0,35,15
1658105123849,MATH 109,A01,083213,Ganzberger; Geoffrey Michael,3,0,34,31
1658105123849,MATH 109,A02,083214,Ganzberger; Geoffrey Michael,4,0,34,30
1658105123849,MATH 109,A03,093478,Ganzberger; Geoffrey Michael,2,0,34,32
1658105123849,MATH 109,B01,083215,Ganzberger; Geoffrey Michael,3,0,32,29
1658105123849,MATH 109,B02,083216,Ganzberger; Geoffrey Michael,3,0,32,29
1658105123849,MATH 109,B03,093479,Ganzberger; Geoffrey Michael,8,0,32,24
1658105129874,MATH 142A,A01,083219,Chow; Bennett,7,0,32,25
1658105129874,MATH 142A,A02,083220,Chow; Bennett,10,0,32,22
1658105129874,MATH 142A,A03,093480,Chow; Bennett,9,0,32,23
1658105129874,MATH 142A,B03,093481,Chow; Bennett,8,0,32,24
1658105129874,MATH 142A,B04,093558,Chow; Bennett,14,0,32,18
1658105129874,MATH 142A,B05,093559,Chow; Bennett,7,0,32,25
1658105135902,MATH 193A,A01,083224,Rotar; Vladimir,9,0,34,25
1658105135902,MATH 193A,A02,083225,Rotar; Vladimir,11,0,34,23
1658105135902,MATH 193A,A03,083781,Rotar; Vladimir,5,0,34,29
1658105135902,MATH 193A,A04,083782,Rotar; Vladimir,12,0,34,22
1658105135902,MATH 193A,A05,093482,Rotar; Vladimir,11,0,34,23
1658105141925,MATH 197,001,091859,McAuley; Julian John,9999,0,9999,0
1658105141925,MATH 197,002,095566,Kedlaya; Kiran S.,9997,0,9999,2
1658105141925,MATH 197,003,095567,Xiao; Ming,9999,0,9999,0
1658105141925,MATH 197,004,095571,Perols; Johan Lars,9998,0,9999,1
1658105148990,COGS 9,A01,083615,Shannon; Kyle Michael,11,0,75,64
1658105155021,COGS 11,A01,083617,Boyle; Mary E. T.,23,0,48,25
1658105161045,COGS 13,A01,083071,Bastos; Amalia Pinkusfeld,12,0,71,59
1658105167074,COGS 14A,A01,092681,Semenuks; Arturs,5,1,100,95
1658105173098,COGS 14B,A01,083073,Cheng; Tzu-Han,7,0,63,56
1658105179121,COGS 17,A01,092677,Semenuks; Arturs,7,0,81,74
1658105185147,COGS 100,A01,083619,Allen; Michael Gordon,17,0,70,53
1658105191178,COGS 101A,A01,083621,Davis; Joshua Daniel,9,0,68,59
1658105197202,COGS 101B,A01,091572,Allen; Michael Gordon,14,0,65,51
1658105203226,COGS 101C,A01,083625,Delgado; Tania,17,0,35,18
1658105209248,COGS 107A,A01,083627,Boyle; Mary E. T.,14,0,60,46
1658105215273,COGS 118A,A01,083075,Gupta; Anjum,21,0,76,55
1658105221296,CSE 3,A50,083646,Miranda; Gregory Joseph,24,0,50,26
1658105227321,CSE 8A,A50,083650,Miranda; Gregory Joseph,17,1,56,39
1658105233348,CSE 11,A01,083080,Cao; Yingjun,7,15,40,33
1658105239371,CSE 12,A01,083652,Krause-Levy; Sophia Louisa,30,1,120,90
1658105245404,CSE 15L,A01,083654,Morris; Justin Loren,9,0,50,41
1658105245404,CSE 15L,A02,083655,Morris; Justin Loren,11,0,50,39
1658105251427,CSE 20,A01,083657,Tran; Khoa Dang,39,0,80,41
1658105257453,CSE 21,A01,095574,Bach; Quang Tran,23,0,48,25
1658105263476,CSE 30,A01,083084,Eldon; John,8,0,80,72
1658105263476,CSE 30,B01,095061,Bhaskar; Nishant,9,0,50,41
1658105269502,CSE 100,A01,083659,Cao; Yingjun,5,4,70,65
1658105275529,CSE 134B,A01,083661,Powell; Thomas Allan,25,0,100,75
1658105281555,CSE 140,A01,083663,Gungor; Onat,17,0,85,68
1658105287578,CSE 140L,A01,083088,Eldon; John,23,0,100,77
1658105293606,CSE 175,A01,083665,Kumar; Rakesh,3,0,25,22
1658105299628,CSE 190,A00,092507,Dubnov; Shlomo,8,0,20,12
1658105305652,ECE 45,A01,083139,Congero; Spencer William,7,0,75,68
1658105311678,ECE 65,A50,083695,Saad; Andrew S,12,0,30,18
1658105311678,ECE 65,A51,095125,Saad; Andrew S,24,0,26,2
1658105317700,ECE 109,A01,091882,Touri; Behrouz,21,0,70,49
1658105323723,ECE 180,A00,083140,Abi Samra; Nicholas Camill,1,0,30,29
1658105323723,ECE 180,B00,083141,Abi Samra; Nicholas Camill,0,0,30,30
1658105329749,MATH 10A,A01,083735,Patchell; Gregory David,2,0,30,28
1658105329749,MATH 10A,A02,083736,Patchell; Gregory David,20,0,30,10
1658105329749,MATH 10A,A03,083737,Patchell; Gregory David,16,0,30,14
1658105335770,MATH 10B,A01,083207,Lim; Seonhee,9,0,34,25
1658105335770,MATH 10B,A02,083208,Lim; Seonhee,10,0,35,25
1658105335770,MATH 10B,A03,093472,Lim; Seonhee,7,0,34,27
1658105335770,MATH 10B,B01,083739,Sinha; Shubham,14,0,30,16
1658105341802,MATH 18,A01,083743,Cinel; Cameron Alexander,9,0,30,21
1658105341802,MATH 18,A02,083744,Cinel; Cameron Alexander,18,0,30,12
1658105341802,MATH 18,A03,083745,Cinel; Cameron Alexander,10,0,30,20
1658105341802,MATH 18,B01,083748,Rideout; David Porter,5,0,37,32
1658105341802,MATH 18,B02,083749,Rideout; David Porter,5,0,36,31
1658105341802,MATH 18,B03,083750,Rideout; David Porter,3,0,37,34
1658105341802,MATH 18,B04,083751,Rideout; David Porter,7,0,36,29
1658105341802,MATH 18,B05,093473,Rideout; David Porter,7,0,36,29
1658105341802,MATH 18,B06,093474,Rideout; David Porter,6,0,36,30
1658105347825,MATH 20A,A01,083754,Zheng; Zequn,14,0,40,26
1658105353849,MATH 20B,A01,083756,Briones; Jor-el Thomas Caparas,4,0,36,32
1658105353849,MATH 20B,A02,083757,Briones; Jor-el Thomas Caparas,1,0,36,35
1658105353849,MATH 20B,A03,093475,Briones; Jor-el Thomas Caparas,3,0,36,33
1658105359872,MATH 20C,A01,083760,Briones; Jor-el Thomas Caparas,1,0,35,34
1658105359872,MATH 20C,A02,083761,Briones; Jor-el Thomas Caparas,8,0,35,27
1658105359872,MATH 20C,A03,093476,Briones; Jor-el Thomas Caparas,0,1,36,36
1658105359872,MATH 20C,B01,083762,Bach; Quang Tran,1,0,30,29
1658105365895,MATH 20D,A01,083765,Tran; Brian Kha,5,0,30,25
1658105365895,MATH 20D,A02,083766,Tran; Brian Kha,5,0,30,25
1658105365895,MATH 20D,A03,083767,Tran; Brian Kha,6,0,30,24
1658105371918,MATH 20E,A01,083771,Ganguly; Soumya,12,0,32,20
1658105371918,MATH 20E,A02,083772,Ganguly; Soumya,7,0,32,25
1658105371918,MATH 20E,B01,083773,Ciotti; Benjamin,20,0,35,15
1658105371918,MATH 20E,B02,083774,Ciotti; Benjamin,18,0,35,17
1658105377943,MATH 103A,A01,083777,Greenfeld; Be'Eri,6,0,36,30
1658105377943,MATH 103A,A02,083778,Greenfeld; Be'Eri,5,0,36,31
1658105377943,MATH 103A,A03,093561,Greenfeld; Be'Eri,7,0,36,29
1658105377943,MATH 103A,B01,083779,Greenfeld; Be'Eri,8,0,36,28
1658105377943,MATH 103A,B02,083780,Greenfeld; Be'Eri,4,0,36,32
1658105377943,MATH 103A,B03,093562,Greenfeld; Be'Eri,3,0,36,33
1658105383970,MATH 105,A01,085443,Carter; Anne Toulson,15,0,35,20
1658105383970,MATH 105,A02,093477,Carter; Anne Toulson,20,0,35,15
1658105389994,MATH 109,A01,083213,Ganzberger; Geoffrey Michael,3,0,34,31
1658105389994,MATH 109,A02,083214,Ganzberger; Geoffrey Michael,4,0,34,30
1658105389994,MATH 109,A03,093478,Ganzberger; Geoffrey Michael,2,0,34,32
1658105389994,MATH 109,B01,083215,Ganzberger; Geoffrey Michael,3,0,32,29
1658105389994,MATH 109,B02,083216,Ganzberger; Geoffrey Michael,3,0,32,29
1658105389994,MATH 109,B03,093479,Ganzberger; Geoffrey Michael,8,0,32,24
1658105396018,MATH 142A,A01,083219,Chow; Bennett,7,0,32,25
1658105396018,MATH 142A,A02,083220,Chow; Bennett,10,0,32,22
1658105396018,MATH 142A,A03,093480,Chow; Bennett,9,0,32,23
1658105396018,MATH 142A,B03,093481,Chow; Bennett,8,0,32,24
1658105396018,MATH 142A,B04,093558,Chow; Bennett,14,0,32,18
1658105396018,MATH 142A,B05,093559,Chow; Bennett,7,0,32,25
1658105402047,MATH 193A,A01,083224,Rotar; Vladimir,9,0,34,25
1658105402047,MATH 193A,A02,083225,Rotar; Vladimir,11,0,34,23
1658105402047,MATH 193A,A03,083781,Rotar; Vladimir,5,0,34,29
1658105402047,MATH 193A,A04,083782,Rotar; Vladimir,12,0,34,22
1658105402047,MATH 193A,A05,093482,Rotar; Vladimir,11,0,34,23
1658105408084,MATH 197,001,091859,McAuley; Julian John,9999,0,9999,0
1658105408084,MATH 197,002,095566,Kedlaya; Kiran S.,9997,0,9999,2
1658105408084,MATH 197,003,095567,Xiao; Ming,9999,0,9999,0
1658105408084,MATH 197,004,095571,Perols; Johan Lars,9998,0,9999,1
1658105415172,COGS 9,A01,083615,Shannon; Kyle Michael,11,0,75,64
1658105421198,COGS 11,A01,083617,Boyle; Mary E. T.,23,0,48,25
1658105427233,COGS 13,A01,083071,Bastos; Amalia Pinkusfeld,12,0,71,59
1658105433255,COGS 14A,A01,092681,Semenuks; Arturs,5,1,100,95
1658105439278,COGS 14B,A01,083073,Cheng; Tzu-Han,7,0,63,56
1658105445309,COGS 17,A01,092677,Semenuks; Arturs,7,0,81,74
1658105451331,COGS 100,A01,083619,Allen; Michael Gordon,17,0,70,53
1658105457355,COGS 101A,A01,083621,Davis; Joshua Daniel,9,0,68,59
1658105463377,COGS 101B,A01,091572,Allen; Michael Gordon,14,0,65,51
1658105469410,COGS 101C,A01,083625,Delgado; Tania,17,0,35,18
1658105475434,COGS 107A,A01,083627,Boyle; Mary E. T.,14,0,60,46
1658105481459,COGS 118A,A01,083075,Gupta; Anjum,21,0,76,55
1658105487484,CSE 3,A50,083646,Miranda; Gregory Joseph,24,0,50,26
1658105493507,CSE 8A,A50,083650,Miranda; Gregory Joseph,17,1,56,39
1658105499533,CSE 11,A01,083080,Cao; Yingjun,7,15,40,33
1658105505559,CSE 12,A01,083652,Krause-Levy; Sophia Louisa,30,1,120,90
1658105511588,CSE 15L,A01,083654,Morris; Justin Loren,9,0,50,41
1658105511588,CSE 15L,A02,083655,Morris; Justin Loren,11,0,50,39
1658105517611,CSE 20,A01,083657,Tran; Khoa Dang,39,0,80,41
1658105523635,CSE 21,A01,095574,Bach; Quang Tran,23,0,48,25
1658105529663,CSE 30,A01,083084,Eldon; John,8,0,80,72
1658105529663,CSE 30,B01,095061,Bhaskar; Nishant,9,0,50,41
1658105535684,CSE 100,A01,083659,Cao; Yingjun,5,4,70,65
1658105541712,CSE 134B,A01,083661,Powell; Thomas Allan,25,0,100,75
1658105547735,CSE 140,A01,083663,Gungor; Onat,17,0,85,68
1658105553758,CSE 140L,A01,083088,Eldon; John,23,0,100,77
1658105559784,CSE 175,A01,083665,Kumar; Rakesh,3,0,25,22
1658105565809,CSE 190,A00,092507,Dubnov; Shlomo,8,0,20,12
1658105571833,ECE 45,A01,083139,Congero; Spencer William,7,0,75,68
1658105577860,ECE 65,A50,083695,Saad; Andrew S,12,0,30,18
1658105577860,ECE 65,A51,095125,Saad; Andrew S,24,0,26,2
1658105583884,ECE 109,A01,091882,Touri; Behrouz,21,0,70,49
1658105589915,ECE 180,A00,083140,Abi Samra; Nicholas Camill,1,0,30,29
1658105589915,ECE 180,B00,083141,Abi Samra; Nicholas Camill,0,0,30,30
1658105595942,MATH 10A,A01,083735,Patchell; Gregory David,2,0,30,28
1658105595942,MATH 10A,A02,083736,Patchell; Gregory David,20,0,30,10
1658105595942,MATH 10A,A03,083737,Patchell; Gregory David,16,0,30,14
1658105601966,MATH 10B,A01,083207,Lim; Seonhee,9,0,34,25
1658105601966,MATH 10B,A02,083208,Lim; Seonhee,10,0,35,25
1658105601966,MATH 10B,A03,093472,Lim; Seonhee,7,0,34,27
1658105601966,MATH 10B,B01,083739,Sinha; Shubham,14,0,30,16
1658105608063,MATH 18,A01,083743,Cinel; Cameron Alexander,9,0,30,21
1658105608063,MATH 18,A02,083744,Cinel; Cameron Alexander,18,0,30,12
1658105608063,MATH 18,A03,083745,Cinel; Cameron Alexander,10,0,30,20
1658105608063,MATH 18,B01,083748,Rideout; David Porter,5,0,37,32
1658105608063,MATH 18,B02,083749,Rideout; David Porter,5,0,36,31
1658105608063,MATH 18,B03,083750,Rideout; David Porter,3,0,37,34
1658105608063,MATH 18,B04,083751,Rideout; David Porter,7,0,36,29
1658105608063,MATH 18,B05,093473,Rideout; David Porter,7,0,36,29
1658105608063,MATH 18,B06,093474,Rideout; David Porter,6,0,36,30
1658105614086,MATH 20A,A01,083754,Zheng; Zequn,14,0,40,26
1658105620110,MATH 20B,A01,083756,Briones; Jor-el Thomas Caparas,4,0,36,32
1658105620110,MATH 20B,A02,083757,Briones; Jor-el Thomas Caparas,1,0,36,35
1658105620110,MATH 20B,A03,093475,Briones; Jor-el Thomas Caparas,3,0,36,33
1658105626135,MATH 20C,A01,083760,Briones; Jor-el Thomas Caparas,1,0,35,34
1658105626135,MATH 20C,A02,083761,Briones; Jor-el Thomas Caparas,8,0,35,27
1658105626135,MATH 20C,A03,093476,Briones; Jor-el Thomas Caparas,0,1,36,36
1658105626135,MATH 20C,B01,083762,Bach; Quang Tran,1,0,30,29
1658105632158,MATH 20D,A01,083765,Tran; Brian Kha,5,0,30,25
1658105632158,MATH 20D,A02,083766,Tran; Brian Kha,5,0,30,25
1658105632158,MATH 20D,A03,083767,Tran; Brian Kha,6,0,30,24
1658105638187,MATH 20E,A01,083771,Ganguly; Soumya,12,0,32,20
1658105638187,MATH 20E,A02,083772,Ganguly; Soumya,7,0,32,25
1658105638187,MATH 20E,B01,083773,Ciotti; Benjamin,20,0,35,15
1658105638187,MATH 20E,B02,083774,Ciotti; Benjamin,18,0,35,17
1658105644211,MATH 103A,A01,083777,Greenfeld; Be'Eri,6,0,36,30
1658105644211,MATH 103A,A02,083778,Greenfeld; Be'Eri,5,0,36,31
1658105644211,MATH 103A,A03,093561,Greenfeld; Be'Eri,7,0,36,29
1658105644211,MATH 103A,B01,083779,Greenfeld; Be'Eri,8,0,36,28
1658105644211,MATH 103A,B02,083780,Greenfeld; Be'Eri,4,0,36,32
1658105644211,MATH 103A,B03,093562,Greenfeld; Be'Eri,3,0,36,33
1658105650234,MATH 105,A01,085443,Carter; Anne Toulson,15,0,35,20
1658105650234,MATH 105,A02,093477,Carter; Anne Toulson,20,0,35,15
1658105656262,MATH 109,A01,083213,Ganzberger; Geoffrey Michael,3,0,34,31
1658105656262,MATH 109,A02,083214,Ganzberger; Geoffrey Michael,4,0,34,30
1658105656262,MATH 109,A03,093478,Ganzberger; Geoffrey Michael,2,0,34,32
1658105656262,MATH 109,B01,083215,Ganzberger; Geoffrey Michael,3,0,32,29
1658105656262,MATH 109,B02,083216,Ganzberger; Geoffrey Michael,3,0,32,29
1658105656262,MATH 109,B03,093479,Ganzberger; Geoffrey Michael,8,0,32,24
1658105662292,MATH 142A,A01,083219,Chow; Bennett,7,0,32,25
1658105662292,MATH 142A,A02,083220,Chow; Bennett,10,0,32,22
1658105662292,MATH 142A,A03,093480,Chow; Bennett,9,0,32,23
1658105662292,MATH 142A,B03,093481,Chow; Bennett,8,0,32,24
1658105662292,MATH 142A,B04,093558,Chow; Bennett,14,0,32,18
1658105662292,MATH 142A,B05,093559,Chow; Bennett,7,0,32,25
1658105668320,MATH 193A,A01,083224,Rotar; Vladimir,9,0,34,25
1658105668320,MATH 193A,A02,083225,Rotar; Vladimir,11,0,34,23
1658105668320,MATH 193A,A03,083781,Rotar; Vladimir,5,0,34,29
1658105668320,MATH 193A,A04,083782,Rotar; Vladimir,12,0,34,22
1658105668320,MATH 193A,A05,093482,Rotar; Vladimir,11,0,34,23
1658105674343,MATH 197,001,091859,McAuley; Julian John,9999,0,9999,0
1658105674343,MATH 197,002,095566,Kedlaya; Kiran S.,9997,0,9999,2
1658105674343,MATH 197,003,095567,Xiao; Ming,9999,0,9999,0
1658105674343,MATH 197,004,095571,Perols; Johan Lars,9998,0,9999,1
1658105681395,COGS 9,A01,083615,Shannon; Kyle Michael,11,0,75,64
1658105687423,COGS 11,A01,083617,Boyle; Mary E. T.,23,0,48,25
1658105693446,COGS 13,A01,083071,Bastos; Amalia Pinkusfeld,12,0,71,59
1658105699473,COGS 14A,A01,092681,Semenuks; Arturs,5,1,100,95
1658105705498,COGS 14B,A01,083073,Cheng; Tzu-Han,7,0,63,56
1658105711524,COGS 17,A01,092677,Semenuks; Arturs,7,0,81,74
1658105717547,COGS 100,A01,083619,Allen; Michael Gordon,17,0,70,53
1658105723578,COGS 101A,A01,083621,Davis; Joshua Daniel,9,0,68,59
1658105729605,COGS 101B,A01,091572,Allen; Michael Gordon,14,0,65,51
1658105735627,COGS 101C,A01,083625,Delgado; Tania,17,0,35,18
1658105741650,COGS 107A,A01,083627,Boyle; Mary E. T.,14,0,60,46
1658105747675,COGS 118A,A01,083075,Gupta; Anjum,21,0,76,55
1658105753700,CSE 3,A50,083646,Miranda; Gregory Joseph,24,0,50,26
1658105759723,CSE 8A,A50,083650,Miranda; Gregory Joseph,17,1,56,39
1658105765747,CSE 11,A01,083080,Cao; Yingjun,7,15,40,33
1658105771770,CSE 12,A01,083652,Krause-Levy; Sophia Louisa,30,1,120,90
1658105777794,CSE 15L,A01,083654,Morris; Justin Loren,9,0,50,41
1658105777794,CSE 15L,A02,083655,Morris; Justin Loren,11,0,50,39
1658105783816,CSE 20,A01,083657,Tran; Khoa Dang,39,0,80,41
1658105789843,CSE 21,A01,095574,Bach; Quang Tran,23,0,48,25
1658105795864,CSE 30,A01,083084,Eldon; John,8,0,80,72
1658105795864,CSE 30,B01,095061,Bhaskar; Nishant,9,0,50,41
1658105801892,CSE 100,A01,083659,Cao; Yingjun,5,4,70,65
1658105807921,CSE 134B,A01,083661,Powell; Thomas Allan,25,0,100,75
1658105813952,CSE 140,A01,083663,Gungor; Onat,17,0,85,68
1658105819979,CSE 140L,A01,083088,Eldon; John,23,0,100,77
1658105826001,CSE 175,A01,083665,Kumar; Rakesh,3,0,25,22
1658105832027,CSE 190,A00,092507,Dubnov; Shlomo,8,0,20,12
1658105838053,ECE 45,A01,083139,Congero; Spencer William,7,0,75,68
1658105844076,ECE 65,A50,083695,Saad; Andrew S,12,0,30,18
1658105844076,ECE 65,A51,095125,Saad; Andrew S,24,0,26,2
1658105850102,ECE 109,A01,091882,Touri; Behrouz,21,0,70,49
1658105856129,ECE 180,A00,083140,Abi Samra; Nicholas Camill,1,0,30,29
1658105856129,ECE 180,B00,083141,Abi Samra; Nicholas Camill,0,0,30,30
1658105862150,MATH 10A,A01,083735,Patchell; Gregory David,2,0,30,28
1658105862150,MATH 10A,A02,083736,Patchell; Gregory David,20,0,30,10
1658105862150,MATH 10A,A03,083737,Patchell; Gregory David,16,0,30,14
1658105868179,MATH 10B,A01,083207,Lim; Seonhee,9,0,34,25
1658105868179,MATH 10B,A02,083208,Lim; Seonhee,10,0,35,25
1658105868179,MATH 10B,A03,093472,Lim; Seonhee,7,0,34,27
1658105868179,MATH 10B,B01,083739,Sinha; Shubham,14,0,30,16
1658105874204,MATH 18,A01,083743,Cinel; Cameron Alexander,9,0,30,21
1658105874204,MATH 18,A02,083744,Cinel; Cameron Alexander,18,0,30,12
1658105874204,MATH 18,A03,083745,Cinel; Cameron Alexander,10,0,30,20
1658105874204,MATH 18,B01,083748,Rideout; David Porter,5,0,37,32
1658105874204,MATH 18,B02,083749,Rideout; David Porter,5,0,36,31
1658105874204,MATH 18,B03,083750,Rideout; David Porter,3,0,37,34
1658105874204,MATH 18,B04,083751,Rideout; David Porter,7,0,36,29
1658105874204,MATH 18,B05,093473,Rideout; David Porter,7,0,36,29
1658105874204,MATH 18,B06,093474,Rideout; David Porter,6,0,36,30
1658105880227,MATH 20A,A01,083754,Zheng; Zequn,14,0,40,26
1658105886255,MATH 20B,A01,083756,Briones; Jor-el Thomas Caparas,4,0,36,32
1658105886255,MATH 20B,A02,083757,Briones; Jor-el Thomas Caparas,1,0,36,35
1658105886255,MATH 20B,A03,093475,Briones; Jor-el Thomas Caparas,3,0,36,33
1658105892278,MATH 20C,A01,083760,Briones; Jor-el Thomas Caparas,1,0,35,34
1658105892278,MATH 20C,A02,083761,Briones; Jor-el Thomas Caparas,8,0,35,27
1658105892278,MATH 20C,A03,093476,Briones; Jor-el Thomas Caparas,0,1,36,36
1658105892278,MATH 20C,B01,083762,Bach; Quang Tran,1,0,30,29
1658105898307,MATH 20D,A01,083765,Tran; Brian Kha,5,0,30,25
1658105898307,MATH 20D,A02,083766,Tran; Brian Kha,5,0,30,25
1658105898307,MATH 20D,A03,083767,Tran; Brian Kha,6,0,30,24
1658105904330,MATH 20E,A01,083771,Ganguly; Soumya,12,0,32,20
1658105904330,MATH 20E,A02,083772,Ganguly; Soumya,7,0,32,25
1658105904330,MATH 20E,B01,083773,Ciotti; Benjamin,20,0,35,15
1658105904330,MATH 20E,B02,083774,Ciotti; Benjamin,18,0,35,17
1658105910359,MATH 103A,A01,083777,Greenfeld; Be'Eri,6,0,36,30
1658105910359,MATH 103A,A02,083778,Greenfeld; Be'Eri,5,0,36,31
1658105910359,MATH 103A,A03,093561,Greenfeld; Be'Eri,7,0,36,29
1658105910359,MATH 103A,B01,083779,Greenfeld; Be'Eri,8,0,36,28
1658105910359,MATH 103A,B02,083780,Greenfeld; Be'Eri,4,0,36,32
1658105910359,MATH 103A,B03,093562,Greenfeld; Be'Eri,3,0,36,33
1658105916382,MATH 105,A01,085443,Carter; Anne Toulson,15,0,35,20
1658105916382,MATH 105,A02,093477,Carter; Anne Toulson,20,0,35,15
1658105922406,MATH 109,A01,083213,Ganzberger; Geoffrey Michael,3,0,34,31
1658105922406,MATH 109,A02,083214,Ganzberger; Geoffrey Michael,4,0,34,30
1658105922406,MATH 109,A03,093478,Ganzberger; Geoffrey Michael,2,0,34,32
1658105922406,MATH 109,B01,083215,Ganzberger; Geoffrey Michael,3,0,32,29
1658105922406,MATH 109,B02,083216,Ganzberger; Geoffrey Michael,3,0,32,29
1658105922406,MATH 109,B03,093479,Ganzberger; Geoffrey Michael,8,0,32,24
1658105928430,MATH 142A,A01,083219,Chow; Bennett,7,0,32,25
1658105928430,MATH 142A,A02,083220,Chow; Bennett,10,0,32,22
1658105928430,MATH 142A,A03,093480,Chow; Bennett,9,0,32,23
1658105928430,MATH 142A,B03,093481,Chow; Bennett,8,0,32,24
1658105928430,MATH 142A,B04,093558,Chow; Bennett,14,0,32,18
1658105928430,MATH 142A,B05,093559,Chow; Bennett,7,0,32,25
1658105934455,MATH 193A,A01,083224,Rotar; Vladimir,9,0,34,25
1658105934455,MATH 193A,A02,083225,Rotar; Vladimir,11,0,34,23
1658105934455,MATH 193A,A03,083781,Rotar; Vladimir,5,0,34,29
1658105934455,MATH 193A,A04,083782,Rotar; Vladimir,12,0,34,22
1658105934455,MATH 193A,A05,093482,Rotar; Vladimir,11,0,34,23
1658105940481,MATH 197,001,091859,McAuley; Julian John,9999,0,9999,0
1658105940481,MATH 197,002,095566,Kedlaya; Kiran S.,9997,0,9999,2
1658105940481,MATH 197,003,095567,Xiao; Ming,9999,0,9999,0
1658105940481,MATH 197,004,095571,Perols; Johan Lars,9998,0,9999,1
1658105947542,COGS 9,A01,083615,Shannon; Kyle Michael,11,0,75,64
1658105953567,COGS 11,A01,083617,Boyle; Mary E. T.,23,0,48,25
1658105959594,COGS 13,A01,083071,Bastos; Amalia Pinkusfeld,12,0,71,59
1658105965617,COGS 14A,A01,092681,Semenuks; Arturs,5,1,100,95
1658105971641,COGS 14B,A01,083073,Cheng; Tzu-Han,7,0,63,56
1658105977663,COGS 17,A01,092677,Semenuks; Arturs,7,0,81,74
1658105983689,COGS 100,A01,083619,Allen; Michael Gordon,17,0,70,53
1658105989719,COGS 101A,A01,083621,Davis; Joshua Daniel,9,0,68,59
1658105995742,COGS 101B,A01,091572,Allen; Michael Gordon,14,0,65,51
1658106001766,COGS 101C,A01,083625,Delgado; Tania,17,0,35,18
1658106007791,COGS 107A,A01,083627,Boyle; Mary E. T.,14,0,60,46
1658106013818,COGS 118A,A01,083075,Gupta; Anjum,21,0,76,55
1658106019840,CSE 3,A50,083646,Miranda; Gregory Joseph,24,0,50,26
1658106025861,CSE 8A,A50,083650,Miranda; Gregory Joseph,17,1,56,39
1658106031888,CSE 11,A01,083080,Cao; Yingjun,7,15,40,33
1658106037910,CSE 12,A01,083652,Krause-Levy; Sophia Louisa,30,1,120,90
1658106043932,CSE 15L,A01,083654,Morris; Justin Loren,9,0,50,41
1658106043932,CSE 15L,A02,083655,Morris; Justin Loren,11,0,50,39
1658106049954,CSE 20,A01,083657,Tran; Khoa Dang,39,0,80,41
1658106055980,CSE 21,A01,095574,Bach; Quang Tran,23,0,48,25
1658106062016,CSE 30,A01,083084,Eldon; John,8,0,80,72
1658106062016,CSE 30,B01,095061,Bhaskar; Nishant,9,0,50,41
1658106068043,CSE 100,A01,083659,Cao; Yingjun,5,4,70,65
1658106074071,CSE 134B,A01,083661,Powell; Thomas Allan,25,0,100,75
1658106080096,CSE 140,A01,083663,Gungor; Onat,17,0,85,68
1658106086124,CSE 140L,A01,083088,Eldon; John,23,0,100,77
1658106092152,CSE 175,A01,083665,Kumar; Rakesh,3,0,25,22
1658106098177,CSE 190,A00,092507,Dubnov; Shlomo,8,0,20,12
1658106104199,ECE 45,A01,083139,Congero; Spencer William,7,0,75,68
1658106110223,ECE 65,A50,083695,Saad; Andrew S,12,0,30,18
1658106110223,ECE 65,A51,095125,Saad; Andrew S,24,0,26,2
1658106116251,ECE 109,A01,091882,Touri; Behrouz,21,0,70,49
1658106122278,ECE 180,A00,083140,Abi Samra; Nicholas Camill,1,0,30,29
1658106122278,ECE 180,B00,083141,Abi Samra; Nicholas Camill,0,0,30,30
1658106128306,MATH 10A,A01,083735,Patchell; Gregory David,2,0,30,28
1658106128306,MATH 10A,A02,083736,Patchell; Gregory David,20,0,30,10
1658106128306,MATH 10A,A03,083737,Patchell; Gregory David,16,0,30,14
1658106134330,MATH 10B,A01,083207,Lim; Seonhee,9,0,34,25
1658106134330,MATH 10B,A02,083208,Lim; Seonhee,10,0,35,25
1658106134330,MATH 10B,A03,093472,Lim; Seonhee,7,0,34,27
1658106134330,MATH 10B,B01,083739,Sinha; Shubham,14,0,30,16
1658106140355,MATH 18,A01,083743,Cinel; Cameron Alexander,9,0,30,21
1658106140355,MATH 18,A02,083744,Cinel; Cameron Alexander,18,0,30,12
1658106140355,MATH 18,A03,083745,Cinel; Cameron Alexander,10,0,30,20
1658106140355,MATH 18,B01,083748,Rideout; David Porter,5,0,37,32
1658106140355,MATH 18,B02,083749,Rideout; David Porter,5,0,36,31
1658106140355,MATH 18,B03,083750,Rideout; David Porter,3,0,37,34
1658106140355,MATH 18,B04,083751,Rideout; David Porter,7,0,36,29
1658106140355,MATH 18,B05,093473,Rideout; David Porter,7,0,36,29
1658106140355,MATH 18,B06,093474,Rideout; David Porter,6,0,36,30
1658106146382,MATH 20A,A01,083754,Zheng; Zequn,14,0,40,26
1658106152410,MATH 20B,A01,083756,Briones; Jor-el Thomas Caparas,4,0,36,32
1658106152410,MATH 20B,A02,083757,Briones; Jor-el Thomas Caparas,1,0,36,35
1658106152410,MATH 20B,A03,093475,Briones; Jor-el Thomas Caparas,3,0,36,33
1658106158446,MATH 20C,A01,083760,Briones; Jor-el Thomas Caparas,1,0,35,34
1658106158446,MATH 20C,A02,083761,Briones; Jor-el Thomas Caparas,8,0,35,27
1658106158446,MATH 20C,A03,093476,Briones; Jor-el Thomas Caparas,0,1,36,36
1658106158446,MATH 20C,B01,083762,Bach; Quang Tran,1,0,30,29
1658106164474,MATH 20D,A01,083765,Tran; Brian Kha,5,0,30,25
1658106164474,MATH 20D,A02,083766,Tran; Brian Kha,5,0,30,25
1658106164474,MATH 20D,A03,083767,Tran; Brian Kha,6,0,30,24
1658106170519,MATH 20E,A01,083771,Ganguly; Soumya,12,0,32,20
1658106170519,MATH 20E,A02,083772,Ganguly; Soumya,7,0,32,25
1658106170519,MATH 20E,B01,083773,Ciotti; Benjamin,20,0,35,15
1658106170519,MATH 20E,B02,083774,Ciotti; Benjamin,18,0,35,17
1658106176543,MATH 103A,A01,083777,Greenfeld; Be'Eri,6,0,36,30
1658106176543,MATH 103A,A02,083778,Greenfeld; Be'Eri,5,0,36,31
1658106176543,MATH 103A,A03,093561,Greenfeld; Be'Eri,7,0,36,29
1658106176543,MATH 103A,B01,083779,Greenfeld; Be'Eri,8,0,36,28
1658106176543,MATH 103A,B02,083780,Greenfeld; Be'Eri,4,0,36,32
1658106176543,MATH 103A,B03,093562,Greenfeld; Be'Eri,3,0,36,33
1658106182567,MATH 105,A01,085443,Carter; Anne Toulson,15,0,35,20
1658106182567,MATH 105,A02,093477,Carter; Anne Toulson,20,0,35,15
1658106188596,MATH 109,A01,083213,Ganzberger; Geoffrey Michael,3,0,34,31
1658106188596,MATH 109,A02,083214,Ganzberger; Geoffrey Michael,4,0,34,30
1658106188596,MATH 109,A03,093478,Ganzberger; Geoffrey Michael,2,0,34,32
1658106188596,MATH 109,B01,083215,Ganzberger; Geoffrey Michael,3,0,32,29
1658106188596,MATH 109,B02,083216,Ganzberger; Geoffrey Michael,3,0,32,29
1658106188596,MATH 109,B03,093479,Ganzberger; Geoffrey Michael,8,0,32,24
1658106194621,MATH 142A,A01,083219,Chow; Bennett,7,0,32,25
1658106194621,MATH 142A,A02,083220,Chow; Bennett,10,0,32,22
1658106194621,MATH 142A,A03,093480,Chow; Bennett,9,0,32,23
1658106194621,MATH 142A,B03,093481,Chow; Bennett,8,0,32,24
1658106194621,MATH 142A,B04,093558,Chow; Bennett,14,0,32,18
1658106194621,MATH 142A,B05,093559,Chow; Bennett,7,0,32,25
1658106200649,MATH 193A,A01,083224,Rotar; Vladimir,9,0,34,25
1658106200649,MATH 193A,A02,083225,Rotar; Vladimir,11,0,34,23
1658106200649,MATH 193A,A03,083781,Rotar; Vladimir,5,0,34,29
1658106200649,MATH 193A,A04,083782,Rotar; Vladimir,12,0,34,22
1658106200649,MATH 193A,A05,093482,Rotar; Vladimir,11,0,34,23
1658106206766,MATH 197,001,091859,McAuley; Julian John,9999,0,9999,0
1658106206766,MATH 197,002,095566,Kedlaya; Kiran S.,9997,0,9999,2
1658106206766,MATH 197,003,095567,Xiao; Ming,9999,0,9999,0
1658106206766,MATH 197,004,095571,Perols; Johan Lars,9998,0,9999,1
1658106213829,COGS 9,A01,083615,Shannon; Kyle Michael,11,0,75,64
1658106219853,COGS 11,A01,083617,Boyle; Mary E. T.,23,0,48,25
1658106225879,COGS 13,A01,083071,Bastos; Amalia Pinkusfeld,12,0,71,59
1658106231906,COGS 14A,A01,092681,Semenuks; Arturs,5,1,100,95
1658106237932,COGS 14B,A01,083073,Cheng; Tzu-Han,7,0,63,56
1658106243956,COGS 17,A01,092677,Semenuks; Arturs,7,0,81,74
1658106249983,COGS 100,A01,083619,Allen; Michael Gordon,17,0,70,53
1658106256012,COGS 101A,A01,083621,Davis; Joshua Daniel,9,0,68,59
1658106262038,COGS 101B,A01,091572,Allen; Michael Gordon,14,0,65,51
1658106268063,COGS 101C,A01,083625,Delgado; Tania,17,0,35,18
1658106274090,COGS 107A,A01,083627,Boyle; Mary E. T.,14,0,60,46
1658106280114,COGS 118A,A01,083075,Gupta; Anjum,21,0,76,55
1658106286142,CSE 3,A50,083646,Miranda; Gregory Joseph,24,0,50,26
1658106292169,CSE 8A,A50,083650,Miranda; Gregory Joseph,17,1,56,39
1658106298193,CSE 11,A01,083080,Cao; Yingjun,7,15,40,33
1658106304219,CSE 12,A01,083652,Krause-Levy; Sophia Louisa,30,1,120,90
1658106310243,CSE 15L,A01,083654,Morris; Justin Loren,9,0,50,41
1658106310243,CSE 15L,A02,083655,Morris; Justin Loren,11,0,50,39
1658106316270,CSE 20,A01,083657,Tran; Khoa Dang,39,0,80,41
1658106322293,CSE 21,A01,095574,Bach; Quang Tran,23,0,48,25
1658106328319,CSE 30,A01,083084,Eldon; John,8,0,80,72
1658106328319,CSE 30,B01,095061,Bhaskar; Nishant,9,0,50,41
1658106334343,CSE 100,A01,083659,Cao; Yingjun,5,4,70,65
1658106340365,CSE 134B,A01,083661,Powell; Thomas Allan,25,0,100,75
1658106346388,CSE 140,A01,083663,Gungor; Onat,17,0,85,68
1658106352412,CSE 140L,A01,083088,Eldon; John,23,0,100,77
1658106358434,CSE 175,A01,083665,Kumar; Rakesh,3,0,25,22
1658106364459,CSE 190,A00,092507,Dubnov; Shlomo,8,0,20,12
1658106370486,ECE 45,A01,083139,Congero; Spencer William,7,0,75,68
1658106376512,ECE 65,A50,083695,Saad; Andrew S,12,0,30,18
1658106376512,ECE 65,A51,095125,Saad; Andrew S,24,0,26,2
1658106382535,ECE 109,A01,091882,Touri; Behrouz,21,0,70,49
1658106388561,ECE 180,A00,083140,Abi Samra; Nicholas Camill,1,0,30,29
1658106388561,ECE 180,B00,083141,Abi Samra; Nicholas Camill,0,0,30,30
1658106394590,MATH 10A,A01,083735,Patchell; Gregory David,2,0,30,28
1658106394590,MATH 10A,A02,083736,Patchell; Gregory David,20,0,30,10
1658106394590,MATH 10A,A03,083737,Patchell; Gregory David,16,0,30,14
1658106400615,MATH 10B,A01,083207,Lim; Seonhee,9,0,34,25
1658106400615,MATH 10B,A02,083208,Lim; Seonhee,10,0,35,25
1658106400615,MATH 10B,A03,093472,Lim; Seonhee,7,0,34,27
1658106400615,MATH 10B,B01,083739,Sinha; Shubham,14,0,30,16
1658106406638,MATH 18,A01,083743,Cinel; Cameron Alexander,9,0,30,21
1658106406638,MATH 18,A02,083744,Cinel; Cameron Alexander,18,0,30,12
1658106406638,MATH 18,A03,083745,Cinel; Cameron Alexander,10,0,30,20
1658106406638,MATH 18,B01,083748,Rideout; David Porter,5,0,37,32
1658106406638,MATH 18,B02,083749,Rideout; David Porter,5,0,36,31
1658106406638,MATH 18,B03,083750,Rideout; David Porter,3,0,37,34
1658106406638,MATH 18,B04,083751,Rideout; David Porter,7,0,36,29
1658106406638,MATH 18,B05,093473,Rideout; David Porter,7,0,36,29
1658106406638,MATH 18,B06,093474,Rideout; David Porter,6,0,36,30
1658106412662,MATH 20A,A01,083754,Zheng; Zequn,14,0,40,26
1658106418685,MATH 20B,A01,083756,Briones; Jor-el Thomas Caparas,4,0,36,32
1658106418685,MATH 20B,A02,083757,Briones; Jor-el Thomas Caparas,1,0,36,35
1658106418685,MATH 20B,A03,093475,Briones; Jor-el Thomas Caparas,3,0,36,33
1658106424714,MATH 20C,A01,083760,Briones; Jor-el Thomas Caparas,1,0,35,34
1658106424714,MATH 20C,A02,083761,Briones; Jor-el Thomas Caparas,8,0,35,27
1658106424714,MATH 20C,A03,093476,Briones; Jor-el Thomas Caparas,0,1,36,36
1658106424714,MATH 20C,B01,083762,Bach; Quang Tran,1,0,30,29
1658106430735,MATH 20D,A01,083765,Tran; Brian Kha,5,0,30,25
1658106430735,MATH 20D,A02,083766,Tran; Brian Kha,5,0,30,25
1658106430735,MATH 20D,A03,083767,Tran; Brian Kha,6,0,30,24
1658106436760,MATH 20E,A01,083771,Ganguly; Soumya,12,0,32,20
1658106436760,MATH 20E,A02,083772,Ganguly; Soumya,7,0,32,25
1658106436760,MATH 20E,B01,083773,Ciotti; Benjamin,20,0,35,15
1658106436760,MATH 20E,B02,083774,Ciotti; Benjamin,18,0,35,17
1658106442788,MATH 103A,A01,083777,Greenfeld; Be'Eri,6,0,36,30
1658106442788,MATH 103A,A02,083778,Greenfeld; Be'Eri,5,0,36,31
1658106442788,MATH 103A,A03,093561,Greenfeld; Be'Eri,7,0,36,29
1658106442788,MATH 103A,B01,083779,Greenfeld; Be'Eri,8,0,36,28
1658106442788,MATH 103A,B02,083780,Greenfeld; Be'Eri,4,0,36,32
1658106442788,MATH 103A,B03,093562,Greenfeld; Be'Eri,3,0,36,33
1658106448819,MATH 105,A01,085443,Carter; Anne Toulson,15,0,35,20
1658106448819,MATH 105,A02,093477,Carter; Anne Toulson,20,0,35,15
1658106454841,MATH 109,A01,083213,Ganzberger; Geoffrey Michael,3,0,34,31
1658106454841,MATH 109,A02,083214,Ganzberger; Geoffrey Michael,4,0,34,30
1658106454841,MATH 109,A03,093478,Ganzberger; Geoffrey Michael,2,0,34,32
1658106454841,MATH 109,B01,083215,Ganzberger; Geoffrey Michael,3,0,32,29
1658106454841,MATH 109,B02,083216,Ganzberger; Geoffrey Michael,3,0,32,29
1658106454841,MATH 109,B03,093479,Ganzberger; Geoffrey Michael,8,0,32,24
1658106460869,MATH 142A,A01,083219,Chow; Bennett,7,0,32,25
1658106460869,MATH 142A,A02,083220,Chow; Bennett,10,0,32,22
1658106460869,MATH 142A,A03,093480,Chow; Bennett,9,0,32,23
1658106460869,MATH 142A,B03,093481,Chow; Bennett,8,0,32,24
1658106460869,MATH 142A,B04,093558,Chow; Bennett,14,0,32,18
1658106460869,MATH 142A,B05,093559,Chow; Bennett,7,0,32,25
1658106466893,MATH 193A,A01,083224,Rotar; Vladimir,9,0,34,25
1658106466893,MATH 193A,A02,083225,Rotar; Vladimir,11,0,34,23
1658106466893,MATH 193A,A03,083781,Rotar; Vladimir,5,0,34,29
1658106466893,MATH 193A,A04,083782,Rotar; Vladimir,12,0,34,22
1658106466893,MATH 193A,A05,093482,Rotar; Vladimir,11,0,34,23
1658106472920,MATH 197,001,091859,McAuley; Julian John,9999,0,9999,0
1658106472920,MATH 197,002,095566,Kedlaya; Kiran S.,9997,0,9999,2
1658106472920,MATH 197,003,095567,Xiao; Ming,9999,0,9999,0
1658106472920,MATH 197,004,095571,Perols; Johan Lars,9998,0,9999,1
1658106479979,COGS 9,A01,083615,Shannon; Kyle Michael,11,0,75,64
1658106486005,COGS 11,A01,083617,Boyle; Mary E. T.,23,0,48,25
1658106492036,COGS 13,A01,083071,Bastos; Amalia Pinkusfeld,12,0,71,59
1658106498063,COGS 14A,A01,092681,Semenuks; Arturs,5,1,100,95
1658106504087,COGS 14B,A01,083073,Cheng; Tzu-Han,7,0,63,56
1658106510110,COGS 17,A01,092677,Semenuks; Arturs,7,0,81,74
1658106516137,COGS 100,A01,083619,Allen; Michael Gordon,17,0,70,53
1658106522163,COGS 101A,A01,083621,Davis; Joshua Daniel,9,0,68,59
1658106528208,COGS 101B,A01,091572,Allen; Michael Gordon,14,0,65,51
1658106534232,COGS 101C,A01,083625,Delgado; Tania,17,0,35,18
1658106540265,COGS 107A,A01,083627,Boyle; Mary E. T.,14,0,60,46
1658106546293,COGS 118A,A01,083075,Gupta; Anjum,21,0,76,55
1658106552321,CSE 3,A50,083646,Miranda; Gregory Joseph,24,0,50,26
1658106558344,CSE 8A,A50,083650,Miranda; Gregory Joseph,17,1,56,39
1658106564368,CSE 11,A01,083080,Cao; Yingjun,7,15,40,33
1658106570394,CSE 12,A01,083652,Krause-Levy; Sophia Louisa,30,1,120,90
1658106576417,CSE 15L,A01,083654,Morris; Justin Loren,9,0,50,41
1658106576417,CSE 15L,A02,083655,Morris; Justin Loren,11,0,50,39
1658106582440,CSE 20,A01,083657,Tran; Khoa Dang,39,0,80,41
1658106588464,CSE 21,A01,095574,Bach; Quang Tran,23,0,48,25
1658106594487,CSE 30,A01,083084,Eldon; John,8,0,80,72
1658106594487,CSE 30,B01,095061,Bhaskar; Nishant,9,0,50,41
1658106600511,CSE 100,A01,083659,Cao; Yingjun,5,4,70,65
1658106606535,CSE 134B,A01,083661,Powell; Thomas Allan,25,0,100,75
1658106612575,CSE 140,A01,083663,Gungor; Onat,17,0,85,68
1658106618603,CSE 140L,A01,083088,Eldon; John,23,0,100,77
1658106624626,CSE 175,A01,083665,Kumar; Rakesh,3,0,25,22
1658106630647,CSE 190,A00,092507,Dubnov; Shlomo,8,0,20,12
1658106636671,ECE 45,A01,083139,Congero; Spencer William,7,0,75,68
1658106642699,ECE 65,A50,083695,Saad; Andrew S,12,0,30,18
1658106642699,ECE 65,A51,095125,Saad; Andrew S,24,0,26,2
1658106648722,ECE 109,A01,091882,Touri; Behrouz,21,0,70,49
1658106654746,ECE 180,A00,083140,Abi Samra; Nicholas Camill,1,0,30,29
1658106654746,ECE 180,B00,083141,Abi Samra; Nicholas Camill,0,0,30,30
1658106660773,MATH 10A,A01,083735,Patchell; Gregory David,2,0,30,28
1658106660773,MATH 10A,A02,083736,Patchell; Gregory David,20,0,30,10
1658106660773,MATH 10A,A03,083737,Patchell; Gregory David,16,0,30,14
1658106666797,MATH 10B,A01,083207,Lim; Seonhee,9,0,34,25
1658106666797,MATH 10B,A02,083208,Lim; Seonhee,10,0,35,25
1658106666797,MATH 10B,A03,093472,Lim; Seonhee,7,0,34,27
1658106666797,MATH 10B,B01,083739,Sinha; Shubham,14,0,30,16
1658106672829,MATH 18,A01,083743,Cinel; Cameron Alexander,9,0,30,21
1658106672829,MATH 18,A02,083744,Cinel; Cameron Alexander,18,0,30,12
1658106672829,MATH 18,A03,083745,Cinel; Cameron Alexander,10,0,30,20
1658106672829,MATH 18,B01,083748,Rideout; David Porter,5,0,37,32
1658106672829,MATH 18,B02,083749,Rideout; David Porter,5,0,36,31
1658106672829,MATH 18,B03,083750,Rideout; David Porter,3,0,37,34
1658106672829,MATH 18,B04,083751,Rideout; David Porter,7,0,36,29
1658106672829,MATH 18,B05,093473,Rideout; David Porter,7,0,36,29
1658106672829,MATH 18,B06,093474,Rideout; David Porter,6,0,36,30
1658106678855,MATH 20A,A01,083754,Zheng; Zequn,14,0,40,26
1658106684881,MATH 20B,A01,083756,Briones; Jor-el Thomas Caparas,4,0,36,32
1658106684881,MATH 20B,A02,083757,Briones; Jor-el Thomas Caparas,1,0,36,35
1658106684881,MATH 20B,A03,093475,Briones; Jor-el Thomas Caparas,3,0,36,33
1658106690904,MATH 20C,A01,083760,Briones; Jor-el Thomas Caparas,1,0,35,34
1658106690904,MATH 20C,A02,083761,Briones; Jor-el Thomas Caparas,8,0,35,27
1658106690904,MATH 20C,A03,093476,Briones; Jor-el Thomas Caparas,0,1,36,36
1658106690904,MATH 20C,B01,083762,Bach; Quang Tran,1,0,30,29
1658106696933,MATH 20D,A01,083765,Tran; Brian Kha,5,0,30,25
1658106696933,MATH 20D,A02,083766,Tran; Brian Kha,5,0,30,25
1658106696933,MATH 20D,A03,083767,Tran; Brian Kha,6,0,30,24
1658106702961,MATH 20E,A01,083771,Ganguly; Soumya,12,0,32,20
1658106702961,MATH 20E,A02,083772,Ganguly; Soumya,7,0,32,25
1658106702961,MATH 20E,B01,083773,Ciotti; Benjamin,20,0,35,15
1658106702961,MATH 20E,B02,083774,Ciotti; Benjamin,18,0,35,17
1658106708986,MATH 103A,A01,083777,Greenfeld; Be'Eri,6,0,36,30
1658106708986,MATH 103A,A02,083778,Greenfeld; Be'Eri,5,0,36,31
1658106708986,MATH 103A,A03,093561,Greenfeld; Be'Eri,7,0,36,29
1658106708986,MATH 103A,B01,083779,Greenfeld; Be'Eri,8,0,36,28
1658106708986,MATH 103A,B02,083780,Greenfeld; Be'Eri,4,0,36,32
1658106708986,MATH 103A,B03,093562,Greenfeld; Be'Eri,3,0,36,33
1658106715009,MATH 105,A01,085443,Carter; Anne Toulson,15,0,35,20
1658106715009,MATH 105,A02,093477,Carter; Anne Toulson,20,0,35,15
1658106721039,MATH 109,A01,083213,Ganzberger; Geoffrey Michael,3,0,34,31
1658106721039,MATH 109,A02,083214,Ganzberger; Geoffrey Michael,4,0,34,30
1658106721039,MATH 109,A03,093478,Ganzberger; Geoffrey Michael,2,0,34,32
1658106721039,MATH 109,B01,083215,Ganzberger; Geoffrey Michael,3,0,32,29
1658106721039,MATH 109,B02,083216,Ganzberger; Geoffrey Michael,3,0,32,29
1658106721039,MATH 109,B03,093479,Ganzberger; Geoffrey Michael,8,0,32,24
1658106727069,MATH 142A,A01,083219,Chow; Bennett,7,0,32,25
1658106727069,MATH 142A,A02,083220,Chow; Bennett,10,0,32,22
1658106727069,MATH 142A,A03,093480,Chow; Bennett,9,0,32,23
1658106727069,MATH 142A,B03,093481,Chow; Bennett,8,0,32,24
1658106727069,MATH 142A,B04,093558,Chow; Bennett,14,0,32,18
1658106727069,MATH 142A,B05,093559,Chow; Bennett,7,0,32,25
1658106733099,MATH 193A,A01,083224,Rotar; Vladimir,9,0,34,25
1658106733099,MATH 193A,A02,083225,Rotar; Vladimir,11,0,34,23
1658106733099,MATH 193A,A03,083781,Rotar; Vladimir,5,0,34,29
1658106733099,MATH 193A,A04,083782,Rotar; Vladimir,12,0,34,22
1658106733099,MATH 193A,A05,093482,Rotar; Vladimir,11,0,34,23
1658106739133,MATH 197,001,091859,McAuley; Julian John,9999,0,9999,0
1658106739133,MATH 197,002,095566,Kedlaya; Kiran S.,9997,0,9999,2
1658106739133,MATH 197,003,095567,Xiao; Ming,9999,0,9999,0
1658106739133,MATH 197,004,095571,Perols; Johan Lars,9998,0,9999,1
1658106746204,COGS 9,A01,083615,Shannon; Kyle Michael,11,0,75,64
1658106752227,COGS 11,A01,083617,Boyle; Mary E. T.,23,0,48,25
1658106758254,COGS 13,A01,083071,Bastos; Amalia Pinkusfeld,12,0,71,59
1658106764281,COGS 14A,A01,092681,Semenuks; Arturs,5,1,100,95
1658106770307,COGS 14B,A01,083073,Cheng; Tzu-Han,7,0,63,56
1658106776330,COGS 17,A01,092677,Semenuks; Arturs,7,0,81,74
1658106782353,COGS 100,A01,083619,Allen; Michael Gordon,17,0,70,53
1658106788381,COGS 101A,A01,083621,Davis; Joshua Daniel,9,0,68,59
1658106794405,COGS 101B,A01,091572,Allen; Michael Gordon,14,0,65,51
1658106800517,COGS 101C,A01,083625,Delgado; Tania,17,0,35,18
1658106806540,COGS 107A,A01,083627,Boyle; Mary E. T.,14,0,60,46
1658106812563,COGS 118A,A01,083075,Gupta; Anjum,21,0,76,55
1658106818586,CSE 3,A50,083646,Miranda; Gregory Joseph,24,0,50,26
1658106824610,CSE 8A,A50,083650,Miranda; Gregory Joseph,17,1,56,39
1658106830633,CSE 11,A01,083080,Cao; Yingjun,7,15,40,33
1658106836657,CSE 12,A01,083652,Krause-Levy; Sophia Louisa,30,1,120,90
1658106842683,CSE 15L,A01,083654,Morris; Justin Loren,9,0,50,41
1658106842683,CSE 15L,A02,083655,Morris; Justin Loren,11,0,50,39
1658106848706,CSE 20,A01,083657,Tran; Khoa Dang,39,0,80,41
1658106854729,CSE 21,A01,095574,Bach; Quang Tran,23,0,48,25
1658106860752,CSE 30,A01,083084,Eldon; John,8,0,80,72
1658106860752,CSE 30,B01,095061,Bhaskar; Nishant,9,0,50,41
1658106866778,CSE 100,A01,083659,Cao; Yingjun,5,4,70,65
1658106872805,CSE 134B,A01,083661,Powell; Thomas Allan,25,0,100,75
1658106878829,CSE 140,A01,083663,Gungor; Onat,17,0,85,68
1658106884853,CSE 140L,A01,083088,Eldon; John,23,0,100,77
1658106890876,CSE 175,A01,083665,Kumar; Rakesh,3,0,25,22
1658106896899,CSE 190,A00,092507,Dubnov; Shlomo,8,0,20,12
1658106902930,ECE 45,A01,083139,Congero; Spencer William,7,0,75,68
1658106908954,ECE 65,A50,083695,Saad; Andrew S,12,0,30,18
1658106908954,ECE 65,A51,095125,Saad; Andrew S,24,0,26,2
1658106914977,ECE 109,A01,091882,Touri; Behrouz,21,0,70,49
1658106921002,ECE 180,A00,083140,Abi Samra; Nicholas Camill,1,0,30,29
1658106921002,ECE 180,B00,083141,Abi Samra; Nicholas Camill,0,0,30,30
1658106927034,MATH 10A,A01,083735,Patchell; Gregory David,2,0,30,28
1658106927034,MATH 10A,A02,083736,Patchell; Gregory David,20,0,30,10
1658106927034,MATH 10A,A03,083737,Patchell; Gregory David,16,0,30,14
1658106933074,MATH 10B,A01,083207,Lim; Seonhee,9,0,34,25
1658106933074,MATH 10B,A02,083208,Lim; Seonhee,10,0,35,25
1658106933074,MATH 10B,A03,093472,Lim; Seonhee,7,0,34,27
1658106933074,MATH 10B,B01,083739,Sinha; Shubham,14,0,30,16
1658106939098,MATH 18,A01,083743,Cinel; Cameron Alexander,9,0,30,21
1658106939098,MATH 18,A02,083744,Cinel; Cameron Alexander,18,0,30,12
1658106939098,MATH 18,A03,083745,Cinel; Cameron Alexander,10,0,30,20
1658106939098,MATH 18,B01,083748,Rideout; David Porter,5,0,37,32
1658106939098,MATH 18,B02,083749,Rideout; David Porter,5,0,36,31
1658106939098,MATH 18,B03,083750,Rideout; David Porter,3,0,37,34
1658106939098,MATH 18,B04,083751,Rideout; David Porter,7,0,36,29
1658106939098,MATH 18,B05,093473,Rideout; David Porter,7,0,36,29
1658106939098,MATH 18,B06,093474,Rideout; David Porter,6,0,36,30
1658106945135,MATH 20A,A01,083754,Zheng; Zequn,14,0,40,26
1658106951162,MATH 20B,A01,083756,Briones; Jor-el Thomas Caparas,4,0,36,32
1658106951162,MATH 20B,A02,083757,Briones; Jor-el Thomas Caparas,1,0,36,35
1658106951162,MATH 20B,A03,093475,Briones; Jor-el Thomas Caparas,3,0,36,33
1658106957187,MATH 20C,A01,083760,Briones; Jor-el Thomas Caparas,1,0,35,34
1658106957187,MATH 20C,A02,083761,Briones; Jor-el Thomas Caparas,8,0,35,27
1658106957187,MATH 20C,A03,093476,Briones; Jor-el Thomas Caparas,0,1,36,36
1658106957187,MATH 20C,B01,083762,Bach; Quang Tran,1,0,30,29
1658106963210,MATH 20D,A01,083765,Tran; Brian Kha,5,0,30,25
1658106963210,MATH 20D,A02,083766,Tran; Brian Kha,5,0,30,25
1658106963210,MATH 20D,A03,083767,Tran; Brian Kha,6,0,30,24
1658106969241,MATH 20E,A01,083771,Ganguly; Soumya,12,0,32,20
1658106969241,MATH 20E,A02,083772,Ganguly; Soumya,7,0,32,25
1658106969241,MATH 20E,B01,083773,Ciotti; Benjamin,20,0,35,15
1658106969241,MATH 20E,B02,083774,Ciotti; Benjamin,18,0,35,17
1658106975275,MATH 103A,A01,083777,Greenfeld; Be'Eri,6,0,36,30
1658106975275,MATH 103A,A02,083778,Greenfeld; Be'Eri,5,0,36,31
1658106975275,MATH 103A,A03,093561,Greenfeld; Be'Eri,7,0,36,29
1658106975275,MATH 103A,B01,083779,Greenfeld; Be'Eri,8,0,36,28
1658106975275,MATH 103A,B02,083780,Greenfeld; Be'Eri,4,0,36,32
1658106975275,MATH 103A,B03,093562,Greenfeld; Be'Eri,3,0,36,33
1658106981299,MATH 105,A01,085443,Carter; Anne Toulson,15,0,35,20
1658106981299,MATH 105,A02,093477,Carter; Anne Toulson,20,0,35,15
1658106987335,MATH 109,A01,083213,Ganzberger; Geoffrey Michael,3,0,34,31
1658106987335,MATH 109,A02,083214,Ganzberger; Geoffrey Michael,4,0,34,30
1658106987335,MATH 109,A03,093478,Ganzberger; Geoffrey Michael,2,0,34,32
1658106987335,MATH 109,B01,083215,Ganzberger; Geoffrey Michael,3,0,32,29
1658106987335,MATH 109,B02,083216,Ganzberger; Geoffrey Michael,3,0,32,29
1658106987335,MATH 109,B03,093479,Ganzberger; Geoffrey Michael,8,0,32,24
1658106993365,MATH 142A,A01,083219,Chow; Bennett,7,0,32,25
1658106993365,MATH 142A,A02,083220,Chow; Bennett,10,0,32,22
1658106993365,MATH 142A,A03,093480,Chow; Bennett,9,0,32,23
1658106993365,MATH 142A,B03,093481,Chow; Bennett,8,0,32,24
1658106993365,MATH 142A,B04,093558,Chow; Bennett,14,0,32,18
1658106993365,MATH 142A,B05,093559,Chow; Bennett,7,0,32,25
1658106999395,MATH 193A,A01,083224,Rotar; Vladimir,9,0,34,25
1658106999395,MATH 193A,A02,083225,Rotar; Vladimir,11,0,34,23
1658106999395,MATH 193A,A03,083781,Rotar; Vladimir,5,0,34,29
1658106999395,MATH 193A,A04,083782,Rotar; Vladimir,12,0,34,22
1658106999395,MATH 193A,A05,093482,Rotar; Vladimir,11,0,34,23
1658107005420,MATH 197,001,091859,McAuley; Julian John,9999,0,9999,0
1658107005420,MATH 197,002,095566,Kedlaya; Kiran S.,9997,0,9999,2
1658107005420,MATH 197,003,095567,Xiao; Ming,9999,0,9999,0
1658107005420,MATH 197,004,095571,Perols; Johan Lars,9998,0,9999,1
1658107012472,COGS 9,A01,083615,Shannon; Kyle Michael,11,0,75,64
1658107018495,COGS 11,A01,083617,Boyle; Mary E. T.,23,0,48,25
1658107024518,COGS 13,A01,083071,Bastos; Amalia Pinkusfeld,12,0,71,59
1658107030543,COGS 14A,A01,092681,Semenuks; Arturs,5,1,100,95
1658107036566,COGS 14B,A01,083073,Cheng; Tzu-Han,7,0,63,56
1658107042593,COGS 17,A01,092677,Semenuks; Arturs,7,0,81,74
1658107048620,COGS 100,A01,083619,Allen; Michael Gordon,17,0,70,53
1658107054643,COGS 101A,A01,083621,Davis; Joshua Daniel,9,0,68,59
1658107060666,COGS 101B,A01,091572,Allen; Michael Gordon,14,0,65,51
1658107066689,COGS 101C,A01,083625,Delgado; Tania,17,0,35,18
1658107072723,COGS 107A,A01,083627,Boyle; Mary E. T.,14,0,60,46
1658107078750,COGS 118A,A01,083075,Gupta; Anjum,21,0,76,55
1658107084771,CSE 3,A50,083646,Miranda; Gregory Joseph,24,0,50,26
1658107090808,CSE 8A,A50,083650,Miranda; Gregory Joseph,17,1,56,39
1658107096831,CSE 11,A01,083080,Cao; Yingjun,7,15,40,33
1658107102857,CSE 12,A01,083652,Krause-Levy; Sophia Louisa,30,1,120,90
1658107108880,CSE 15L,A01,083654,Morris; Justin Loren,9,0,50,41
1658107108880,CSE 15L,A02,083655,Morris; Justin Loren,11,0,50,39
1658107114906,CSE 20,A01,083657,Tran; Khoa Dang,39,0,80,41
1658107120931,CSE 21,A01,095574,Bach; Quang Tran,23,0,48,25
1658107126954,CSE 30,A01,083084,Eldon; John,8,0,80,72
1658107126954,CSE 30,B01,095061,Bhaskar; Nishant,9,0,50,41
1658107132977,CSE 100,A01,083659,Cao; Yingjun,5,4,70,65
1658107139003,CSE 134B,A01,083661,Powell; Thomas Allan,25,0,100,75
1658107145031,CSE 140,A01,083663,Gungor; Onat,17,0,85,68
1658107151053,CSE 140L,A01,083088,Eldon; John,23,0,100,77
1658107157078,CSE 175,A01,083665,Kumar; Rakesh,3,0,25,22
1658107163102,CSE 190,A00,092507,Dubnov; Shlomo,8,0,20,12
1658107169124,ECE 45,A01,083139,Congero; Spencer William,7,0,75,68
1658107175148,ECE 65,A50,083695,Saad; Andrew S,12,0,30,18
1658107175148,ECE 65,A51,095125,Saad; Andrew S,24,0,26,2
1658107181171,ECE 109,A01,091882,Touri; Behrouz,21,0,70,49
1658107187194,ECE 180,A00,083140,Abi Samra; Nicholas Camill,1,0,30,29
1658107187194,ECE 180,B00,083141,Abi Samra; Nicholas Camill,0,0,30,30
1658107193218,MATH 10A,A01,083735,Patchell; Gregory David,2,0,30,28
1658107193218,MATH 10A,A02,083736,Patchell; Gregory David,20,0,30,10
1658107193218,MATH 10A,A03,083737,Patchell; Gregory David,16,0,30,14
1658107199241,MATH 10B,A01,083207,Lim; Seonhee,9,0,34,25
1658107199241,MATH 10B,A02,083208,Lim; Seonhee,10,0,35,25
1658107199241,MATH 10B,A03,093472,Lim; Seonhee,7,0,34,27
1658107199241,MATH 10B,B01,083739,Sinha; Shubham,14,0,30,16
1658107205275,MATH 18,A01,083743,Cinel; Cameron Alexander,9,0,30,21
1658107205275,MATH 18,A02,083744,Cinel; Cameron Alexander,18,0,30,12
1658107205275,MATH 18,A03,083745,Cinel; Cameron Alexander,10,0,30,20
1658107205275,MATH 18,B01,083748,Rideout; David Porter,5,0,37,32
1658107205275,MATH 18,B02,083749,Rideout; David Porter,5,0,36,31
1658107205275,MATH 18,B03,083750,Rideout; David Porter,3,0,37,34
1658107205275,MATH 18,B04,083751,Rideout; David Porter,7,0,36,29
1658107205275,MATH 18,B05,093473,Rideout; David Porter,7,0,36,29
1658107205275,MATH 18,B06,093474,Rideout; David Porter,6,0,36,30
1658107211301,MATH 20A,A01,083754,Zheng; Zequn,14,0,40,26
1658107217325,MATH 20B,A01,083756,Briones; Jor-el Thomas Caparas,4,0,36,32
1658107217325,MATH 20B,A02,083757,Briones; Jor-el Thomas Caparas,1,0,36,35
1658107217325,MATH 20B,A03,093475,Briones; Jor-el Thomas Caparas,3,0,36,33
1658107223349,MATH 20C,A01,083760,Briones; Jor-el Thomas Caparas,1,0,35,34
1658107223349,MATH 20C,A02,083761,Briones; Jor-el Thomas Caparas,8,0,35,27
1658107223349,MATH 20C,A03,093476,Briones; Jor-el Thomas Caparas,0,1,36,36
1658107223349,MATH 20C,B01,083762,Bach; Quang Tran,1,0,30,29
1658107229377,MATH 20D,A01,083765,Tran; Brian Kha,5,0,30,25
1658107229377,MATH 20D,A02,083766,Tran; Brian Kha,5,0,30,25
1658107229377,MATH 20D,A03,083767,Tran; Brian Kha,6,0,30,24
1658107235400,MATH 20E,A01,083771,Ganguly; Soumya,12,0,32,20
1658107235400,MATH 20E,A02,083772,Ganguly; Soumya,7,0,32,25
1658107235400,MATH 20E,B01,083773,Ciotti; Benjamin,20,0,35,15
1658107235400,MATH 20E,B02,083774,Ciotti; Benjamin,18,0,35,17
1658107241426,MATH 103A,A01,083777,Greenfeld; Be'Eri,6,0,36,30
1658107241426,MATH 103A,A02,083778,Greenfeld; Be'Eri,5,0,36,31
1658107241426,MATH 103A,A03,093561,Greenfeld; Be'Eri,7,0,36,29
1658107241426,MATH 103A,B01,083779,Greenfeld; Be'Eri,8,0,36,28
1658107241426,MATH 103A,B02,083780,Greenfeld; Be'Eri,4,0,36,32
1658107241426,MATH 103A,B03,093562,Greenfeld; Be'Eri,3,0,36,33
1658107247448,MATH 105,A01,085443,Carter; Anne Toulson,15,0,35,20
1658107247448,MATH 105,A02,093477,Carter; Anne Toulson,20,0,35,15
1658107253471,MATH 109,A01,083213,Ganzberger; Geoffrey Michael,3,0,34,31
1658107253471,MATH 109,A02,083214,Ganzberger; Geoffrey Michael,4,0,34,30
1658107253471,MATH 109,A03,093478,Ganzberger; Geoffrey Michael,2,0,34,32
1658107253471,MATH 109,B01,083215,Ganzberger; Geoffrey Michael,3,0,32,29
1658107253471,MATH 109,B02,083216,Ganzberger; Geoffrey Michael,3,0,32,29
1658107253471,MATH 109,B03,093479,Ganzberger; Geoffrey Michael,8,0,32,24
1658107259501,MATH 142A,A01,083219,Chow; Bennett,7,0,32,25
1658107259501,MATH 142A,A02,083220,Chow; Bennett,10,0,32,22
1658107259501,MATH 142A,A03,093480,Chow; Bennett,9,0,32,23
1658107259501,MATH 142A,B03,093481,Chow; Bennett,8,0,32,24
1658107259501,MATH 142A,B04,093558,Chow; Bennett,14,0,32,18
1658107259501,MATH 142A,B05,093559,Chow; Bennett,7,0,32,25
1658107265525,MATH 193A,A01,083224,Rotar; Vladimir,9,0,34,25
1658107265525,MATH 193A,A02,083225,Rotar; Vladimir,11,0,34,23
1658107265525,MATH 193A,A03,083781,Rotar; Vladimir,5,0,34,29
1658107265525,MATH 193A,A04,083782,Rotar; Vladimir,12,0,34,22
1658107265525,MATH 193A,A05,093482,Rotar; Vladimir,11,0,34,23
1658107271546,MATH 197,001,091859,McAuley; Julian John,9999,0,9999,0
1658107271546,MATH 197,002,095566,Kedlaya; Kiran S.,9997,0,9999,2
1658107271546,MATH 197,003,095567,Xiao; Ming,9999,0,9999,0
1658107271546,MATH 197,004,095571,Perols; Johan Lars,9998,0,9999,1
1658107278602,COGS 9,A01,083615,Shannon; Kyle Michael,11,0,75,64
1658107284628,COGS 11,A01,083617,Boyle; Mary E. T.,23,0,48,25
1658107290652,COGS 13,A01,083071,Bastos; Amalia Pinkusfeld,12,0,71,59
1658107296692,COGS 14A,A01,092681,Semenuks; Arturs,5,1,100,95
1658107302717,COGS 14B,A01,083073,Cheng; Tzu-Han,7,0,63,56
1658107308740,COGS 17,A01,092677,Semenuks; Arturs,7,0,81,74
1658107314764,COGS 100,A01,083619,Allen; Michael Gordon,17,0,70,53
1658107320790,COGS 101A,A01,083621,Davis; Joshua Daniel,9,0,68,59
1658107326813,COGS 101B,A01,091572,Allen; Michael Gordon,14,0,65,51
1658107332841,COGS 101C,A01,083625,Delgado; Tania,17,0,35,18
1658107338864,COGS 107A,A01,083627,Boyle; Mary E. T.,14,0,60,46
1658107344887,COGS 118A,A01,083075,Gupta; Anjum,21,0,76,55
1658107350910,CSE 3,A50,083646,Miranda; Gregory Joseph,24,0,50,26
1658107356938,CSE 8A,A50,083650,Miranda; Gregory Joseph,17,1,56,39
1658107362960,CSE 11,A01,083080,Cao; Yingjun,7,15,40,33
1658107368984,CSE 12,A01,083652,Krause-Levy; Sophia Louisa,30,1,120,90
1658107375011,CSE 15L,A01,083654,Morris; Justin Loren,9,0,50,41
1658107375011,CSE 15L,A02,083655,Morris; Justin Loren,11,0,50,39
1658107381038,CSE 20,A01,083657,Tran; Khoa Dang,39,0,80,41
1658107387061,CSE 21,A01,095574,Bach; Quang Tran,23,0,48,25
1658107393089,CSE 30,A01,083084,Eldon; John,8,0,80,72
1658107393089,CSE 30,B01,095061,Bhaskar; Nishant,9,0,50,41
1658107399203,CSE 100,A01,083659,Cao; Yingjun,5,4,70,65
1658107405225,CSE 134B,A01,083661,Powell; Thomas Allan,25,0,100,75
1658107411255,CSE 140,A01,083663,Gungor; Onat,17,0,85,68
1658107417282,CSE 140L,A01,083088,Eldon; John,23,0,100,77
1658107423317,CSE 175,A01,083665,Kumar; Rakesh,3,0,25,22
1658107429342,CSE 190,A00,092507,Dubnov; Shlomo,8,0,20,12
1658107435366,ECE 45,A01,083139,Congero; Spencer William,7,0,75,68
1658107441390,ECE 65,A50,083695,Saad; Andrew S,12,0,30,18
1658107441390,ECE 65,A51,095125,Saad; Andrew S,24,0,26,2
1658107447413,ECE 109,A01,091882,Touri; Behrouz,21,0,70,49
1658107453442,ECE 180,A00,083140,Abi Samra; Nicholas Camill,1,0,30,29
1658107453442,ECE 180,B00,083141,Abi Samra; Nicholas Camill,0,0,30,30
1658107459470,MATH 10A,A01,083735,Patchell; Gregory David,2,0,30,28
1658107459470,MATH 10A,A02,083736,Patchell; Gregory David,20,0,30,10
1658107459470,MATH 10A,A03,083737,Patchell; Gregory David,16,0,30,14
1658107465494,MATH 10B,A01,083207,Lim; Seonhee,9,0,34,25
1658107465494,MATH 10B,A02,083208,Lim; Seonhee,10,0,35,25
1658107465494,MATH 10B,A03,093472,Lim; Seonhee,7,0,34,27
1658107465494,MATH 10B,B01,083739,Sinha; Shubham,14,0,30,16
1658107471525,MATH 18,A01,083743,Cinel; Cameron Alexander,9,0,30,21
1658107471525,MATH 18,A02,083744,Cinel; Cameron Alexander,18,0,30,12
1658107471525,MATH 18,A03,083745,Cinel; Cameron Alexander,10,0,30,20
1658107471525,MATH 18,B01,083748,Rideout; David Porter,5,0,37,32
1658107471525,MATH 18,B02,083749,Rideout; David Porter,5,0,36,31
1658107471525,MATH 18,B03,083750,Rideout; David Porter,3,0,37,34
1658107471525,MATH 18,B04,083751,Rideout; David Porter,7,0,36,29
1658107471525,MATH 18,B05,093473,Rideout; David Porter,7,0,36,29
1658107471525,MATH 18,B06,093474,Rideout; David Porter,6,0,36,30
1658107477558,MATH 20A,A01,083754,Zheng; Zequn,14,0,40,26
1658107483580,MATH 20B,A01,083756,Briones; Jor-el Thomas Caparas,4,0,36,32
1658107483580,MATH 20B,A02,083757,Briones; Jor-el Thomas Caparas,1,0,36,35
1658107483580,MATH 20B,A03,093475,Briones; Jor-el Thomas Caparas,3,0,36,33
1658107489610,MATH 20C,A01,083760,Briones; Jor-el Thomas Caparas,1,0,35,34
1658107489610,MATH 20C,A02,083761,Briones; Jor-el Thomas Caparas,8,0,35,27
1658107489610,MATH 20C,A03,093476,Briones; Jor-el Thomas Caparas,0,1,36,36
1658107489610,MATH 20C,B01,083762,Bach; Quang Tran,1,0,30,29
1658107495635,MATH 20D,A01,083765,Tran; Brian Kha,5,0,30,25
1658107495635,MATH 20D,A02,083766,Tran; Brian Kha,5,0,30,25
1658107495635,MATH 20D,A03,083767,Tran; Brian Kha,6,0,30,24
1658107501660,MATH 20E,A01,083771,Ganguly; Soumya,12,0,32,20
1658107501660,MATH 20E,A02,083772,Ganguly; Soumya,7,0,32,25
1658107501660,MATH 20E,B01,083773,Ciotti; Benjamin,20,0,35,15
1658107501660,MATH 20E,B02,083774,Ciotti; Benjamin,18,0,35,17
1658107507685,MATH 103A,A01,083777,Greenfeld; Be'Eri,6,0,36,30
1658107507685,MATH 103A,A02,083778,Greenfeld; Be'Eri,5,0,36,31
1658107507685,MATH 103A,A03,093561,Greenfeld; Be'Eri,7,0,36,29
1658107507685,MATH 103A,B01,083779,Greenfeld; Be'Eri,8,0,36,28
1658107507685,MATH 103A,B02,083780,Greenfeld; Be'Eri,4,0,36,32
1658107507685,MATH 103A,B03,093562,Greenfeld; Be'Eri,3,0,36,33
1658107513708,MATH 105,A01,085443,Carter; Anne Toulson,15,0,35,20
1658107513708,MATH 105,A02,093477,Carter; Anne Toulson,20,0,35,15
1658107519740,MATH 109,A01,083213,Ganzberger; Geoffrey Michael,3,0,34,31
1658107519740,MATH 109,A02,083214,Ganzberger; Geoffrey Michael,4,0,34,30
1658107519740,MATH 109,A03,093478,Ganzberger; Geoffrey Michael,2,0,34,32
1658107519740,MATH 109,B01,083215,Ganzberger; Geoffrey Michael,3,0,32,29
1658107519740,MATH 109,B02,083216,Ganzberger; Geoffrey Michael,3,0,32,29
1658107519740,MATH 109,B03,093479,Ganzberger; Geoffrey Michael,8,0,32,24
1658107525769,MATH 142A,A01,083219,Chow; Bennett,7,0,32,25
1658107525769,MATH 142A,A02,083220,Chow; Bennett,10,0,32,22
1658107525769,MATH 142A,A03,093480,Chow; Bennett,9,0,32,23
1658107525769,MATH 142A,B03,093481,Chow; Bennett,8,0,32,24
1658107525769,MATH 142A,B04,093558,Chow; Bennett,14,0,32,18
1658107525769,MATH 142A,B05,093559,Chow; Bennett,7,0,32,25
1658107531800,MATH 193A,A01,083224,Rotar; Vladimir,9,0,34,25
1658107531800,MATH 193A,A02,083225,Rotar; Vladimir,11,0,34,23
1658107531800,MATH 193A,A03,083781,Rotar; Vladimir,5,0,34,29
1658107531800,MATH 193A,A04,083782,Rotar; Vladimir,12,0,34,22
1658107531800,MATH 193A,A05,093482,Rotar; Vladimir,11,0,34,23
1658107537823,MATH 197,001,091859,McAuley; Julian John,9999,0,9999,0
1658107537823,MATH 197,002,095566,Kedlaya; Kiran S.,9997,0,9999,2
1658107537823,MATH 197,003,095567,Xiao; Ming,9999,0,9999,0
1658107537823,MATH 197,004,095571,Perols; Johan Lars,9998,0,9999,1
1658107544882,COGS 9,A01,083615,Shannon; Kyle Michael,11,0,75,64
1658107550904,COGS 11,A01,083617,Boyle; Mary E. T.,23,0,48,25
1658107556929,COGS 13,A01,083071,Bastos; Amalia Pinkusfeld,12,0,71,59
1658107562956,COGS 14A,A01,092681,Semenuks; Arturs,5,1,100,95
1658107568979,COGS 14B,A01,083073,Cheng; Tzu-Han,7,0,63,56
1658107575005,COGS 17,A01,092677,Semenuks; Arturs,7,0,81,74
1658107581032,COGS 100,A01,083619,Allen; Michael Gordon,17,0,70,53
1658107587059,COGS 101A,A01,083621,Davis; Joshua Daniel,9,0,68,59
1658107593086,COGS 101B,A01,091572,Allen; Michael Gordon,14,0,65,51
1658107599117,COGS 101C,A01,083625,Delgado; Tania,17,0,35,18
1658107605140,COGS 107A,A01,083627,Boyle; Mary E. T.,14,0,60,46
1658107611164,COGS 118A,A01,083075,Gupta; Anjum,21,0,76,55
1658107617192,CSE 3,A50,083646,Miranda; Gregory Joseph,24,0,50,26
1658107623217,CSE 8A,A50,083650,Miranda; Gregory Joseph,17,1,56,39
1658107629241,CSE 11,A01,083080,Cao; Yingjun,7,15,40,33
1658107635272,CSE 12,A01,083652,Krause-Levy; Sophia Louisa,30,1,120,90
1658107641299,CSE 15L,A01,083654,Morris; Justin Loren,9,0,50,41
1658107641299,CSE 15L,A02,083655,Morris; Justin Loren,11,0,50,39
1658107647330,CSE 20,A01,083657,Tran; Khoa Dang,39,0,80,41
1658107653358,CSE 21,A01,095574,Bach; Quang Tran,23,0,48,25
1658107659382,CSE 30,A01,083084,Eldon; John,8,0,80,72
1658107659382,CSE 30,B01,095061,Bhaskar; Nishant,9,0,50,41
1658107665409,CSE 100,A01,083659,Cao; Yingjun,5,4,70,65
1658107671433,CSE 134B,A01,083661,Powell; Thomas Allan,25,0,100,75
1658107677459,CSE 140,A01,083663,Gungor; Onat,17,0,85,68
1658107683486,CSE 140L,A01,083088,Eldon; John,23,0,100,77
1658107689507,CSE 175,A01,083665,Kumar; Rakesh,3,0,25,22
1658107695531,CSE 190,A00,092507,Dubnov; Shlomo,8,0,20,12
1658107701559,ECE 45,A01,083139,Congero; Spencer William,7,0,75,68
1658107707586,ECE 65,A50,083695,Saad; Andrew S,12,0,30,18
1658107707586,ECE 65,A51,095125,Saad; Andrew S,24,0,26,2
1658107713608,ECE 109,A01,091882,Touri; Behrouz,21,0,70,49
1658107719632,ECE 180,A00,083140,Abi Samra; Nicholas Camill,1,0,30,29
1658107719632,ECE 180,B00,083141,Abi Samra; Nicholas Camill,0,0,30,30
1658107725667,MATH 10A,A01,083735,Patchell; Gregory David,2,0,30,28
1658107725667,MATH 10A,A02,083736,Patchell; Gregory David,20,0,30,10
1658107725667,MATH 10A,A03,083737,Patchell; Gregory David,16,0,30,14
1658107731695,MATH 10B,A01,083207,Lim; Seonhee,9,0,34,25
1658107731695,MATH 10B,A02,083208,Lim; Seonhee,10,0,35,25
1658107731695,MATH 10B,A03,093472,Lim; Seonhee,7,0,34,27
1658107731695,MATH 10B,B01,083739,Sinha; Shubham,14,0,30,16
1658107737726,MATH 18,A01,083743,Cinel; Cameron Alexander,9,0,30,21
1658107737726,MATH 18,A02,083744,Cinel; Cameron Alexander,18,0,30,12
1658107737726,MATH 18,A03,083745,Cinel; Cameron Alexander,10,0,30,20
1658107737726,MATH 18,B01,083748,Rideout; David Porter,5,0,37,32
1658107737726,MATH 18,B02,083749,Rideout; David Porter,5,0,36,31
1658107737726,MATH 18,B03,083750,Rideout; David Porter,3,0,37,34
1658107737726,MATH 18,B04,083751,Rideout; David Porter,7,0,36,29
1658107737726,MATH 18,B05,093473,Rideout; David Porter,7,0,36,29
1658107737726,MATH 18,B06,093474,Rideout; David Porter,6,0,36,30
1658107743749,MATH 20A,A01,083754,Zheng; Zequn,14,0,40,26
1658107749772,MATH 20B,A01,083756,Briones; Jor-el Thomas Caparas,4,0,36,32
1658107749772,MATH 20B,A02,083757,Briones; Jor-el Thomas Caparas,1,0,36,35
1658107749772,MATH 20B,A03,093475,Briones; Jor-el Thomas Caparas,3,0,36,33
1658107755801,MATH 20C,A01,083760,Briones; Jor-el Thomas Caparas,1,0,35,34
1658107755801,MATH 20C,A02,083761,Briones; Jor-el Thomas Caparas,8,0,35,27
1658107755801,MATH 20C,A03,093476,Briones; Jor-el Thomas Caparas,0,1,36,36
1658107755801,MATH 20C,B01,083762,Bach; Quang Tran,1,0,30,29
1658107761828,MATH 20D,A01,083765,Tran; Brian Kha,5,0,30,25
1658107761828,MATH 20D,A02,083766,Tran; Brian Kha,5,0,30,25
1658107761828,MATH 20D,A03,083767,Tran; Brian Kha,6,0,30,24
1658107767853,MATH 20E,A01,083771,Ganguly; Soumya,12,0,32,20
1658107767853,MATH 20E,A02,083772,Ganguly; Soumya,7,0,32,25
1658107767853,MATH 20E,B01,083773,Ciotti; Benjamin,20,0,35,15
1658107767853,MATH 20E,B02,083774,Ciotti; Benjamin,18,0,35,17
1658107773885,MATH 103A,A01,083777,Greenfeld; Be'Eri,6,0,36,30
1658107773885,MATH 103A,A02,083778,Greenfeld; Be'Eri,5,0,36,31
1658107773885,MATH 103A,A03,093561,Greenfeld; Be'Eri,7,0,36,29
1658107773885,MATH 103A,B01,083779,Greenfeld; Be'Eri,8,0,36,28
1658107773885,MATH 103A,B02,083780,Greenfeld; Be'Eri,4,0,36,32
1658107773885,MATH 103A,B03,093562,Greenfeld; Be'Eri,3,0,36,33
1658107779907,MATH 105,A01,085443,Carter; Anne Toulson,15,0,35,20
1658107779907,MATH 105,A02,093477,Carter; Anne Toulson,20,0,35,15
1658107785936,MATH 109,A01,083213,Ganzberger; Geoffrey Michael,3,0,34,31
1658107785936,MATH 109,A02,083214,Ganzberger; Geoffrey Michael,4,0,34,30
1658107785936,MATH 109,A03,093478,Ganzberger; Geoffrey Michael,2,0,34,32
1658107785936,MATH 109,B01,083215,Ganzberger; Geoffrey Michael,3,0,32,29
1658107785936,MATH 109,B02,083216,Ganzberger; Geoffrey Michael,3,0,32,29
1658107785936,MATH 109,B03,093479,Ganzberger; Geoffrey Michael,8,0,32,24
1658107791960,MATH 142A,A01,083219,Chow; Bennett,7,0,32,25
1658107791960,MATH 142A,A02,083220,Chow; Bennett,10,0,32,22
1658107791960,MATH 142A,A03,093480,Chow; Bennett,9,0,32,23
1658107791960,MATH 142A,B03,093481,Chow; Bennett,8,0,32,24
1658107791960,MATH 142A,B04,093558,Chow; Bennett,14,0,32,18
1658107791960,MATH 142A,B05,093559,Chow; Bennett,7,0,32,25
1658107797996,MATH 193A,A01,083224,Rotar; Vladimir,9,0,34,25
1658107797996,MATH 193A,A02,083225,Rotar; Vladimir,11,0,34,23
1658107797996,MATH 193A,A03,083781,Rotar; Vladimir,5,0,34,29
1658107797996,MATH 193A,A04,083782,Rotar; Vladimir,12,0,34,22
1658107797996,MATH 193A,A05,093482,Rotar; Vladimir,11,0,34,23
1658107804021,MATH 197,001,091859,McAuley; Julian John,9999,0,9999,0
1658107804021,MATH 197,002,095566,Kedlaya; Kiran S.,9997,0,9999,2
1658107804021,MATH 197,003,095567,Xiao; Ming,9999,0,9999,0
1658107804021,MATH 197,004,095571,Perols; Johan Lars,9998,0,9999,1
1658107811083,COGS 9,A01,083615,Shannon; Kyle Michael,11,0,75,64
1658107817107,COGS 11,A01,083617,Boyle; Mary E. T.,23,0,48,25
1658107823130,COGS 13,A01,083071,Bastos; Amalia Pinkusfeld,12,0,71,59
1658107829156,COGS 14A,A01,092681,Semenuks; Arturs,5,1,100,95
1658107835184,COGS 14B,A01,083073,Cheng; Tzu-Han,7,0,63,56
1658107841210,COGS 17,A01,092677,Semenuks; Arturs,7,0,81,74
1658107847233,COGS 100,A01,083619,Allen; Michael Gordon,17,0,70,53
1658107853255,COGS 101A,A01,083621,Davis; Joshua Daniel,9,0,68,59
1658107859279,COGS 101B,A01,091572,Allen; Michael Gordon,14,0,65,51
1658107865302,COGS 101C,A01,083625,Delgado; Tania,17,0,35,18
1658107871328,COGS 107A,A01,083627,Boyle; Mary E. T.,14,0,60,46
1658107877355,COGS 118A,A01,083075,Gupta; Anjum,21,0,76,55
1658107883378,CSE 3,A50,083646,Miranda; Gregory Joseph,24,0,50,26
1658107889401,CSE 8A,A50,083650,Miranda; Gregory Joseph,17,1,56,39
1658107895429,CSE 11,A01,083080,Cao; Yingjun,7,15,40,33
1658107901457,CSE 12,A01,083652,Krause-Levy; Sophia Louisa,30,1,120,90
1658107907480,CSE 15L,A01,083654,Morris; Justin Loren,9,0,50,41
1658107907480,CSE 15L,A02,083655,Morris; Justin Loren,11,0,50,39
1658107913507,CSE 20,A01,083657,Tran; Khoa Dang,39,0,80,41
1658107919529,CSE 21,A01,095574,Bach; Quang Tran,23,0,48,25
1658107925562,CSE 30,A01,083084,Eldon; John,8,0,80,72
1658107925562,CSE 30,B01,095061,Bhaskar; Nishant,9,0,50,41
1658107931586,CSE 100,A01,083659,Cao; Yingjun,5,4,70,65
1658107937613,CSE 134B,A01,083661,Powell; Thomas Allan,25,0,100,75
1658107943635,CSE 140,A01,083663,Gungor; Onat,17,0,85,68
1658107949662,CSE 140L,A01,083088,Eldon; John,23,0,100,77
1658107955684,CSE 175,A01,083665,Kumar; Rakesh,3,0,25,22
1658107961711,CSE 190,A00,092507,Dubnov; Shlomo,8,0,20,12
1658107967734,ECE 45,A01,083139,Congero; Spencer William,7,0,75,68
1658107973762,ECE 65,A50,083695,Saad; Andrew S,12,0,30,18
1658107973762,ECE 65,A51,095125,Saad; Andrew S,24,0,26,2
1658107979785,ECE 109,A01,091882,Touri; Behrouz,21,0,70,49
1658107985809,ECE 180,A00,083140,Abi Samra; Nicholas Camill,1,0,30,29
1658107985809,ECE 180,B00,083141,Abi Samra; Nicholas Camill,0,0,30,30
1658107991835,MATH 10A,A01,083735,Patchell; Gregory David,2,0,30,28
1658107991835,MATH 10A,A02,083736,Patchell; Gregory David,20,0,30,10
1658107991835,MATH 10A,A03,083737,Patchell; Gregory David,16,0,30,14
1658107997940,MATH 10B,A01,083207,Lim; Seonhee,9,0,34,25
1658107997940,MATH 10B,A02,083208,Lim; Seonhee,10,0,35,25
1658107997940,MATH 10B,A03,093472,Lim; Seonhee,7,0,34,27
1658107997940,MATH 10B,B01,083739,Sinha; Shubham,14,0,30,16
1658108003977,MATH 18,A01,083743,Cinel; Cameron Alexander,9,0,30,21
1658108003977,MATH 18,A02,083744,Cinel; Cameron Alexander,18,0,30,12
1658108003977,MATH 18,A03,083745,Cinel; Cameron Alexander,10,0,30,20
1658108003977,MATH 18,B01,083748,Rideout; David Porter,5,0,37,32
1658108003977,MATH 18,B02,083749,Rideout; David Porter,5,0,36,31
1658108003977,MATH 18,B03,083750,Rideout; David Porter,3,0,37,34
1658108003977,MATH 18,B04,083751,Rideout; David Porter,7,0,36,29
1658108003977,MATH 18,B05,093473,Rideout; David Porter,7,0,36,29
1658108003977,MATH 18,B06,093474,Rideout; David Porter,6,0,36,30
1658108010003,MATH 20A,A01,083754,Zheng; Zequn,14,0,40,26
1658108016027,MATH 20B,A01,083756,Briones; Jor-el Thomas Caparas,4,0,36,32
1658108016027,MATH 20B,A02,083757,Briones; Jor-el Thomas Caparas,1,0,36,35
1658108016027,MATH 20B,A03,093475,Briones; Jor-el Thomas Caparas,3,0,36,33
1658108022054,MATH 20C,A01,083760,Briones; Jor-el Thomas Caparas,1,0,35,34
1658108022054,MATH 20C,A02,083761,Briones; Jor-el Thomas Caparas,8,0,35,27
1658108022054,MATH 20C,A03,093476,Briones; Jor-el Thomas Caparas,0,1,36,36
1658108022054,MATH 20C,B01,083762,Bach; Quang Tran,1,0,30,29
1658108028082,MATH 20D,A01,083765,Tran; Brian Kha,5,0,30,25
1658108028082,MATH 20D,A02,083766,Tran; Brian Kha,5,0,30,25
1658108028082,MATH 20D,A03,083767,Tran; Brian Kha,6,0,30,24
1658108034108,MATH 20E,A01,083771,Ganguly; Soumya,12,0,32,20
1658108034108,MATH 20E,A02,083772,Ganguly; Soumya,7,0,32,25
1658108034108,MATH 20E,B01,083773,Ciotti; Benjamin,20,0,35,15
1658108034108,MATH 20E,B02,083774,Ciotti; Benjamin,18,0,35,17
1658108040133,MATH 103A,A01,083777,Greenfeld; Be'Eri,6,0,36,30
1658108040133,MATH 103A,A02,083778,Greenfeld; Be'Eri,5,0,36,31
1658108040133,MATH 103A,A03,093561,Greenfeld; Be'Eri,7,0,36,29
1658108040133,MATH 103A,B01,083779,Greenfeld; Be'Eri,8,0,36,28
1658108040133,MATH 103A,B02,083780,Greenfeld; Be'Eri,4,0,36,32
1658108040133,MATH 103A,B03,093562,Greenfeld; Be'Eri,3,0,36,33
1658108046157,MATH 105,A01,085443,Carter; Anne Toulson,15,0,35,20
1658108046157,MATH 105,A02,093477,Carter; Anne Toulson,20,0,35,15
1658108052186,MATH 109,A01,083213,Ganzberger; Geoffrey Michael,3,0,34,31
1658108052186,MATH 109,A02,083214,Ganzberger; Geoffrey Michael,4,0,34,30
1658108052186,MATH 109,A03,093478,Ganzberger; Geoffrey Michael,2,0,34,32
1658108052186,MATH 109,B01,083215,Ganzberger; Geoffrey Michael,3,0,32,29
1658108052186,MATH 109,B02,083216,Ganzberger; Geoffrey Michael,3,0,32,29
1658108052186,MATH 109,B03,093479,Ganzberger; Geoffrey Michael,8,0,32,24
1658108058216,MATH 142A,A01,083219,Chow; Bennett,7,0,32,25
1658108058216,MATH 142A,A02,083220,Chow; Bennett,10,0,32,22
1658108058216,MATH 142A,A03,093480,Chow; Bennett,9,0,32,23
1658108058216,MATH 142A,B03,093481,Chow; Bennett,8,0,32,24
1658108058216,MATH 142A,B04,093558,Chow; Bennett,14,0,32,18
1658108058216,MATH 142A,B05,093559,Chow; Bennett,7,0,32,25
1658108064246,MATH 193A,A01,083224,Rotar; Vladimir,9,0,34,25
1658108064246,MATH 193A,A02,083225,Rotar; Vladimir,11,0,34,23
1658108064246,MATH 193A,A03,083781,Rotar; Vladimir,5,0,34,29
1658108064246,MATH 193A,A04,083782,Rotar; Vladimir,12,0,34,22
1658108064246,MATH 193A,A05,093482,Rotar; Vladimir,11,0,34,23
1658108070270,MATH 197,001,091859,McAuley; Julian John,9999,0,9999,0
1658108070270,MATH 197,002,095566,Kedlaya; Kiran S.,9997,0,9999,2
1658108070270,MATH 197,003,095567,Xiao; Ming,9999,0,9999,0
1658108070270,MATH 197,004,095571,Perols; Johan Lars,9998,0,9999,1
1658108077326,COGS 9,A01,083615,Shannon; Kyle Michael,11,0,75,64
1658108083353,COGS 11,A01,083617,Boyle; Mary E. T.,23,0,48,25
1658108089376,COGS 13,A01,083071,Bastos; Amalia Pinkusfeld,12,0,71,59
1658108095398,COGS 14A,A01,092681,Semenuks; Arturs,5,1,100,95
1658108101422,COGS 14B,A01,083073,Cheng; Tzu-Han,7,0,63,56
1658108107447,COGS 17,A01,092677,Semenuks; Arturs,7,0,81,74
1658108113470,COGS 100,A01,083619,Allen; Michael Gordon,17,0,70,53
1658108119495,COGS 101A,A01,083621,Davis; Joshua Daniel,9,0,68,59
1658108125518,COGS 101B,A01,091572,Allen; Michael Gordon,14,0,65,51
1658108131546,COGS 101C,A01,083625,Delgado; Tania,17,0,35,18
1658108137572,COGS 107A,A01,083627,Boyle; Mary E. T.,14,0,60,46
1658108143596,COGS 118A,A01,083075,Gupta; Anjum,21,0,76,55
1658108149623,CSE 3,A50,083646,Miranda; Gregory Joseph,24,0,50,26
1658108155650,CSE 8A,A50,083650,Miranda; Gregory Joseph,17,1,56,39
1658108161680,CSE 11,A01,083080,Cao; Yingjun,7,15,40,33
1658108167704,CSE 12,A01,083652,Krause-Levy; Sophia Louisa,30,1,120,90
1658108173729,CSE 15L,A01,083654,Morris; Justin Loren,9,0,50,41
1658108173729,CSE 15L,A02,083655,Morris; Justin Loren,11,0,50,39
1658108179756,CSE 20,A01,083657,Tran; Khoa Dang,39,0,80,41
1658108185778,CSE 21,A01,095574,Bach; Quang Tran,23,0,48,25
1658108191805,CSE 30,A01,083084,Eldon; John,8,0,80,72
1658108191805,CSE 30,B01,095061,Bhaskar; Nishant,9,0,50,41
1658108197828,CSE 100,A01,083659,Cao; Yingjun,5,4,70,65
1658108203849,CSE 134B,A01,083661,Powell; Thomas Allan,25,0,100,75
1658108209873,CSE 140,A01,083663,Gungor; Onat,17,0,85,68
1658108215896,CSE 140L,A01,083088,Eldon; John,23,0,100,77
1658108221922,CSE 175,A01,083665,Kumar; Rakesh,3,0,25,22
1658108227949,CSE 190,A00,092507,Dubnov; Shlomo,8,0,20,12
1658108233976,ECE 45,A01,083139,Congero; Spencer William,7,0,75,68
1658108240004,ECE 65,A50,083695,Saad; Andrew S,12,0,30,18
1658108240004,ECE 65,A51,095125,Saad; Andrew S,24,0,26,2
1658108246027,ECE 109,A01,091882,Touri; Behrouz,21,0,70,49
1658108252049,ECE 180,A00,083140,Abi Samra; Nicholas Camill,1,0,30,29
1658108252049,ECE 180,B00,083141,Abi Samra; Nicholas Camill,0,0,30,30
1658108258076,MATH 10A,A01,083735,Patchell; Gregory David,2,0,30,28
1658108258076,MATH 10A,A02,083736,Patchell; Gregory David,20,0,30,10
1658108258076,MATH 10A,A03,083737,Patchell; Gregory David,16,0,30,14
1658108264098,MATH 10B,A01,083207,Lim; Seonhee,9,0,34,25
1658108264098,MATH 10B,A02,083208,Lim; Seonhee,10,0,35,25
1658108264098,MATH 10B,A03,093472,Lim; Seonhee,7,0,34,27
1658108264098,MATH 10B,B01,083739,Sinha; Shubham,14,0,30,16
1658108270123,MATH 18,A01,083743,Cinel; Cameron Alexander,9,0,30,21
1658108270123,MATH 18,A02,083744,Cinel; Cameron Alexander,18,0,30,12
1658108270123,MATH 18,A03,083745,Cinel; Cameron Alexander,10,0,30,20
1658108270123,MATH 18,B01,083748,Rideout; David Porter,5,0,37,32
1658108270123,MATH 18,B02,083749,Rideout; David Porter,5,0,36,31
1658108270123,MATH 18,B03,083750,Rideout; David Porter,3,0,37,34
1658108270123,MATH 18,B04,083751,Rideout; David Porter,7,0,36,29
1658108270123,MATH 18,B05,093473,Rideout; David Porter,7,0,36,29
1658108270123,MATH 18,B06,093474,Rideout; David Porter,6,0,36,30
1658108276149,MATH 20A,A01,083754,Zheng; Zequn,14,0,40,26
1658108282172,MATH 20B,A01,083756,Briones; Jor-el Thomas Caparas,4,0,36,32
1658108282172,MATH 20B,A02,083757,Briones; Jor-el Thomas Caparas,1,0,36,35
1658108282172,MATH 20B,A03,093475,Briones; Jor-el Thomas Caparas,3,0,36,33
1658108288201,MATH 20C,A01,083760,Briones; Jor-el Thomas Caparas,1,0,35,34
1658108288201,MATH 20C,A02,083761,Briones; Jor-el Thomas Caparas,8,0,35,27
1658108288201,MATH 20C,A03,093476,Briones; Jor-el Thomas Caparas,0,1,36,36
1658108288201,MATH 20C,B01,083762,Bach; Quang Tran,1,0,30,29
1658108294223,MATH 20D,A01,083765,Tran; Brian Kha,5,0,30,25
1658108294223,MATH 20D,A02,083766,Tran; Brian Kha,5,0,30,25
1658108294223,MATH 20D,A03,083767,Tran; Brian Kha,6,0,30,24
1658108300252,MATH 20E,A01,083771,Ganguly; Soumya,12,0,32,20
1658108300252,MATH 20E,A02,083772,Ganguly; Soumya,7,0,32,25
1658108300252,MATH 20E,B01,083773,Ciotti; Benjamin,20,0,35,15
1658108300252,MATH 20E,B02,083774,Ciotti; Benjamin,18,0,35,17
1658108306281,MATH 103A,A01,083777,Greenfeld; Be'Eri,6,0,36,30
1658108306281,MATH 103A,A02,083778,Greenfeld; Be'Eri,5,0,36,31
1658108306281,MATH 103A,A03,093561,Greenfeld; Be'Eri,7,0,36,29
1658108306281,MATH 103A,B01,083779,Greenfeld; Be'Eri,8,0,36,28
1658108306281,MATH 103A,B02,083780,Greenfeld; Be'Eri,4,0,36,32
1658108306281,MATH 103A,B03,093562,Greenfeld; Be'Eri,3,0,36,33
1658108312324,MATH 105,A01,085443,Carter; Anne Toulson,15,0,35,20
1658108312324,MATH 105,A02,093477,Carter; Anne Toulson,20,0,35,15
1658108318346,MATH 109,A01,083213,Ganzberger; Geoffrey Michael,3,0,34,31
1658108318346,MATH 109,A02,083214,Ganzberger; Geoffrey Michael,4,0,34,30
1658108318346,MATH 109,A03,093478,Ganzberger; Geoffrey Michael,2,0,34,32
1658108318346,MATH 109,B01,083215,Ganzberger; Geoffrey Michael,3,0,32,29
1658108318346,MATH 109,B02,083216,Ganzberger; Geoffrey Michael,3,0,32,29
1658108318346,MATH 109,B03,093479,Ganzberger; Geoffrey Michael,8,0,32,24
1658108324375,MATH 142A,A01,083219,Chow; Bennett,7,0,32,25
1658108324375,MATH 142A,A02,083220,Chow; Bennett,10,0,32,22
1658108324375,MATH 142A,A03,093480,Chow; Bennett,9,0,32,23
1658108324375,MATH 142A,B03,093481,Chow; Bennett,8,0,32,24
1658108324375,MATH 142A,B04,093558,Chow; Bennett,14,0,32,18
1658108324375,MATH 142A,B05,093559,Chow; Bennett,7,0,32,25
1658108330404,MATH 193A,A01,083224,Rotar; Vladimir,9,0,34,25
1658108330404,MATH 193A,A02,083225,Rotar; Vladimir,11,0,34,23
1658108330404,MATH 193A,A03,083781,Rotar; Vladimir,5,0,34,29
1658108330404,MATH 193A,A04,083782,Rotar; Vladimir,12,0,34,22
1658108330404,MATH 193A,A05,093482,Rotar; Vladimir,11,0,34,23
1658108336427,MATH 197,001,091859,McAuley; Julian John,9999,0,9999,0
1658108336427,MATH 197,002,095566,Kedlaya; Kiran S.,9997,0,9999,2
1658108336427,MATH 197,003,095567,Xiao; Ming,9999,0,9999,0
1658108336427,MATH 197,004,095571,Perols; Johan Lars,9998,0,9999,1
1658108343494,COGS 9,A01,083615,Shannon; Kyle Michael,11,0,75,64
1658108349520,COGS 11,A01,083617,Boyle; Mary E. T.,23,0,48,25
1658108355548,COGS 13,A01,083071,Bastos; Amalia Pinkusfeld,12,0,71,59
1658108361573,COGS 14A,A01,092681,Semenuks; Arturs,5,1,100,95
1658108367601,COGS 14B,A01,083073,Cheng; Tzu-Han,7,0,63,56
1658108373635,COGS 17,A01,092677,Semenuks; Arturs,7,0,81,74
1658108379663,COGS 100,A01,083619,Allen; Michael Gordon,17,0,70,53
1658108385689,COGS 101A,A01,083621,Davis; Joshua Daniel,9,0,68,59
1658108391723,COGS 101B,A01,091572,Allen; Michael Gordon,14,0,65,51
1658108397746,COGS 101C,A01,083625,Delgado; Tania,17,0,35,18
1658108403775,COGS 107A,A01,083627,Boyle; Mary E. T.,14,0,60,46
1658108409804,COGS 118A,A01,083075,Gupta; Anjum,21,0,76,55
1658108415826,CSE 3,A50,083646,Miranda; Gregory Joseph,24,0,50,26
1658108421850,CSE 8A,A50,083650,Miranda; Gregory Joseph,17,1,56,39
1658108427881,CSE 11,A01,083080,Cao; Yingjun,7,15,40,33
1658108433914,CSE 12,A01,083652,Krause-Levy; Sophia Louisa,30,1,120,90
1658108439949,CSE 15L,A01,083654,Morris; Justin Loren,9,0,50,41
1658108439949,CSE 15L,A02,083655,Morris; Justin Loren,11,0,50,39
1658108445971,CSE 20,A01,083657,Tran; Khoa Dang,39,0,80,41
1658108451998,CSE 21,A01,095574,Bach; Quang Tran,23,0,48,25
1658108458026,CSE 30,A01,083084,Eldon; John,8,0,80,72
1658108458026,CSE 30,B01,095061,Bhaskar; Nishant,9,0,50,41
1658108464058,CSE 100,A01,083659,Cao; Yingjun,5,4,70,65
1658108470085,CSE 134B,A01,083661,Powell; Thomas Allan,25,0,100,75
1658108476109,CSE 140,A01,083663,Gungor; Onat,17,0,85,68
1658108482132,CSE 140L,A01,083088,Eldon; John,23,0,100,77
1658108488158,CSE 175,A01,083665,Kumar; Rakesh,3,0,25,22
1658108494183,CSE 190,A00,092507,Dubnov; Shlomo,8,0,20,12
1658108500206,ECE 45,A01,083139,Congero; Spencer William,7,0,75,68
1658108506229,ECE 65,A50,083695,Saad; Andrew S,12,0,30,18
1658108506229,ECE 65,A51,095125,Saad; Andrew S,24,0,26,2
1658108512257,ECE 109,A01,091882,Touri; Behrouz,21,0,70,49
1658108518280,ECE 180,A00,083140,Abi Samra; Nicholas Camill,1,0,30,29
1658108518280,ECE 180,B00,083141,Abi Samra; Nicholas Camill,0,0,30,30
1658108524303,MATH 10A,A01,083735,Patchell; Gregory David,2,0,30,28
1658108524303,MATH 10A,A02,083736,Patchell; Gregory David,20,0,30,10
1658108524303,MATH 10A,A03,083737,Patchell; Gregory David,16,0,30,14
1658108530347,MATH 10B,A01,083207,Lim; Seonhee,9,0,34,25
1658108530347,MATH 10B,A02,083208,Lim; Seonhee,10,0,35,25
1658108530347,MATH 10B,A03,093472,Lim; Seonhee,7,0,34,27
1658108530347,MATH 10B,B01,083739,Sinha; Shubham,14,0,30,16
1658108536379,MATH 18,A01,083743,Cinel; Cameron Alexander,9,0,30,21
1658108536379,MATH 18,A02,083744,Cinel; Cameron Alexander,18,0,30,12
1658108536379,MATH 18,A03,083745,Cinel; Cameron Alexander,10,0,30,20
1658108536379,MATH 18,B01,083748,Rideout; David Porter,5,0,37,32
1658108536379,MATH 18,B02,083749,Rideout; David Porter,5,0,36,31
1658108536379,MATH 18,B03,083750,Rideout; David Porter,3,0,37,34
1658108536379,MATH 18,B04,083751,Rideout; David Porter,7,0,36,29
1658108536379,MATH 18,B05,093473,Rideout; David Porter,7,0,36,29
1658108536379,MATH 18,B06,093474,Rideout; David Porter,6,0,36,30
1658108542403,MATH 20A,A01,083754,Zheng; Zequn,14,0,40,26
1658108548431,MATH 20B,A01,083756,Briones; Jor-el Thomas Caparas,4,0,36,32
1658108548431,MATH 20B,A02,083757,Briones; Jor-el Thomas Caparas,1,0,36,35
1658108548431,MATH 20B,A03,093475,Briones; Jor-el Thomas Caparas,3,0,36,33
1658108554461,MATH 20C,A01,083760,Briones; Jor-el Thomas Caparas,1,0,35,34
1658108554461,MATH 20C,A02,083761,Briones; Jor-el Thomas Caparas,8,0,35,27
1658108554461,MATH 20C,A03,093476,Briones; Jor-el Thomas Caparas,0,1,36,36
1658108554461,MATH 20C,B01,083762,Bach; Quang Tran,1,0,30,29
1658108560489,MATH 20D,A01,083765,Tran; Brian Kha,5,0,30,25
1658108560489,MATH 20D,A02,083766,Tran; Brian Kha,5,0,30,25
1658108560489,MATH 20D,A03,083767,Tran; Brian Kha,6,0,30,24
1658108566516,MATH 20E,A01,083771,Ganguly; Soumya,12,0,32,20
1658108566516,MATH 20E,A02,083772,Ganguly; Soumya,7,0,32,25
1658108566516,MATH 20E,B01,083773,Ciotti; Benjamin,20,0,35,15
1658108566516,MATH 20E,B02,083774,Ciotti; Benjamin,18,0,35,17
1658108572550,MATH 103A,A01,083777,Greenfeld; Be'Eri,6,0,36,30
1658108572550,MATH 103A,A02,083778,Greenfeld; Be'Eri,5,0,36,31
1658108572550,MATH 103A,A03,093561,Greenfeld; Be'Eri,7,0,36,29
1658108572550,MATH 103A,B01,083779,Greenfeld; Be'Eri,8,0,36,28
1658108572550,MATH 103A,B02,083780,Greenfeld; Be'Eri,4,0,36,32
1658108572550,MATH 103A,B03,093562,Greenfeld; Be'Eri,3,0,36,33
1658108578576,MATH 105,A01,085443,Carter; Anne Toulson,15,0,35,20
1658108578576,MATH 105,A02,093477,Carter; Anne Toulson,20,0,35,15
1658108584600,MATH 109,A01,083213,Ganzberger; Geoffrey Michael,3,0,34,31
1658108584600,MATH 109,A02,083214,Ganzberger; Geoffrey Michael,4,0,34,30
1658108584600,MATH 109,A03,093478,Ganzberger; Geoffrey Michael,2,0,34,32
1658108584600,MATH 109,B01,083215,Ganzberger; Geoffrey Michael,3,0,32,29
1658108584600,MATH 109,B02,083216,Ganzberger; Geoffrey Michael,3,0,32,29
1658108584600,MATH 109,B03,093479,Ganzberger; Geoffrey Michael,8,0,32,24
1658108590629,MATH 142A,A01,083219,Chow; Bennett,7,0,32,25
1658108590629,MATH 142A,A02,083220,Chow; Bennett,10,0,32,22
1658108590629,MATH 142A,A03,093480,Chow; Bennett,9,0,32,23
1658108590629,MATH 142A,B03,093481,Chow; Bennett,8,0,32,24
1658108590629,MATH 142A,B04,093558,Chow; Bennett,14,0,32,18
1658108590629,MATH 142A,B05,093559,Chow; Bennett,7,0,32,25
1658108596737,MATH 193A,A01,083224,Rotar; Vladimir,9,0,34,25
1658108596737,MATH 193A,A02,083225,Rotar; Vladimir,11,0,34,23
1658108596737,MATH 193A,A03,083781,Rotar; Vladimir,5,0,34,29
1658108596737,MATH 193A,A04,083782,Rotar; Vladimir,12,0,34,22
1658108596737,MATH 193A,A05,093482,Rotar; Vladimir,11,0,34,23
1658108602762,MATH 197,001,091859,McAuley; Julian John,9999,0,9999,0
1658108602762,MATH 197,002,095566,Kedlaya; Kiran S.,9997,0,9999,2
1658108602762,MATH 197,003,095567,Xiao; Ming,9999,0,9999,0
1658108602762,MATH 197,004,095571,Perols; Johan Lars,9998,0,9999,1
1658108609824,COGS 9,A01,083615,Shannon; Kyle Michael,11,0,75,64
1658108615847,COGS 11,A01,083617,Boyle; Mary E. T.,23,0,48,25
1658108621874,COGS 13,A01,083071,Bastos; Amalia Pinkusfeld,12,0,71,59
1658108627900,COGS 14A,A01,092681,Semenuks; Arturs,5,1,100,95
1658108633924,COGS 14B,A01,083073,Cheng; Tzu-Han,7,0,63,56
1658108639948,COGS 17,A01,092677,Semenuks; Arturs,7,0,81,74
1658108645974,COGS 100,A01,083619,Allen; Michael Gordon,17,0,70,53
1658108651999,COGS 101A,A01,083621,Davis; Joshua Daniel,9,0,68,59
1658108658022,COGS 101B,A01,091572,Allen; Michael Gordon,14,0,65,51
1658108664046,COGS 101C,A01,083625,Delgado; Tania,17,0,35,18
1658108670069,COGS 107A,A01,083627,Boyle; Mary E. T.,14,0,60,46
1658108676095,COGS 118A,A01,083075,Gupta; Anjum,21,0,76,55
1658108682119,CSE 3,A50,083646,Miranda; Gregory Joseph,24,0,50,26
1658108688143,CSE 8A,A50,083650,Miranda; Gregory Joseph,17,1,56,39
1658108694166,CSE 11,A01,083080,Cao; Yingjun,7,15,40,33
1658108700191,CSE 12,A01,083652,Krause-Levy; Sophia Louisa,30,1,120,90
1658108706215,CSE 15L,A01,083654,Morris; Justin Loren,9,0,50,41
1658108706215,CSE 15L,A02,083655,Morris; Justin Loren,11,0,50,39
1658108712252,CSE 20,A01,083657,Tran; Khoa Dang,39,0,80,41
1658108718277,CSE 21,A01,095574,Bach; Quang Tran,23,0,48,25
1658108724303,CSE 30,A01,083084,Eldon; John,8,0,80,72
1658108724303,CSE 30,B01,095061,Bhaskar; Nishant,9,0,50,41
1658108730326,CSE 100,A01,083659,Cao; Yingjun,5,4,70,65
1658108736350,CSE 134B,A01,083661,Powell; Thomas Allan,25,0,100,75
1658108742377,CSE 140,A01,083663,Gungor; Onat,17,0,85,68
1658108748401,CSE 140L,A01,083088,Eldon; John,23,0,100,77
1658108754425,CSE 175,A01,083665,Kumar; Rakesh,3,0,25,22
1658108760448,CSE 190,A00,092507,Dubnov; Shlomo,8,0,20,12
1658108766476,ECE 45,A01,083139,Congero; Spencer William,7,0,75,68
1658108772499,ECE 65,A50,083695,Saad; Andrew S,12,0,30,18
1658108772499,ECE 65,A51,095125,Saad; Andrew S,24,0,26,2
1658108778527,ECE 109,A01,091882,Touri; Behrouz,21,0,70,49
1658108784554,ECE 180,A00,083140,Abi Samra; Nicholas Camill,1,0,30,29
1658108784554,ECE 180,B00,083141,Abi Samra; Nicholas Camill,0,0,30,30
1658108790577,MATH 10A,A01,083735,Patchell; Gregory David,2,0,30,28
1658108790577,MATH 10A,A02,083736,Patchell; Gregory David,20,0,30,10
1658108790577,MATH 10A,A03,083737,Patchell; Gregory David,16,0,30,14
1658108796603,MATH 10B,A01,083207,Lim; Seonhee,9,0,34,25
1658108796603,MATH 10B,A02,083208,Lim; Seonhee,10,0,35,25
1658108796603,MATH 10B,A03,093472,Lim; Seonhee,7,0,34,27
1658108796603,MATH 10B,B01,083739,Sinha; Shubham,14,0,30,16
1658108802628,MATH 18,A01,083743,Cinel; Cameron Alexander,9,0,30,21
1658108802628,MATH 18,A02,083744,Cinel; Cameron Alexander,18,0,30,12
1658108802628,MATH 18,A03,083745,Cinel; Cameron Alexander,10,0,30,20
1658108802628,MATH 18,B01,083748,Rideout; David Porter,5,0,37,32
1658108802628,MATH 18,B02,083749,Rideout; David Porter,5,0,36,31
1658108802628,MATH 18,B03,083750,Rideout; David Porter,3,0,37,34
1658108802628,MATH 18,B04,083751,Rideout; David Porter,7,0,36,29
1658108802628,MATH 18,B05,093473,Rideout; David Porter,7,0,36,29
1658108802628,MATH 18,B06,093474,Rideout; David Porter,6,0,36,30
1658108808650,MATH 20A,A01,083754,Zheng; Zequn,14,0,40,26
1658108814673,MATH 20B,A01,083756,Briones; Jor-el Thomas Caparas,4,0,36,32
1658108814673,MATH 20B,A02,083757,Briones; Jor-el Thomas Caparas,1,0,36,35
1658108814673,MATH 20B,A03,093475,Briones; Jor-el Thomas Caparas,3,0,36,33
1658108820700,MATH 20C,A01,083760,Briones; Jor-el Thomas Caparas,1,0,35,34
1658108820700,MATH 20C,A02,083761,Briones; Jor-el Thomas Caparas,8,0,35,27
1658108820700,MATH 20C,A03,093476,Briones; Jor-el Thomas Caparas,0,1,36,36
1658108820700,MATH 20C,B01,083762,Bach; Quang Tran,1,0,30,29
1658108826724,MATH 20D,A01,083765,Tran; Brian Kha,5,0,30,25
1658108826724,MATH 20D,A02,083766,Tran; Brian Kha,5,0,30,25
1658108826724,MATH 20D,A03,083767,Tran; Brian Kha,6,0,30,24
1658108832750,MATH 20E,A01,083771,Ganguly; Soumya,12,0,32,20
1658108832750,MATH 20E,A02,083772,Ganguly; Soumya,7,0,32,25
1658108832750,MATH 20E,B01,083773,Ciotti; Benjamin,20,0,35,15
1658108832750,MATH 20E,B02,083774,Ciotti; Benjamin,18,0,35,17
1658108838776,MATH 103A,A01,083777,Greenfeld; Be'Eri,6,0,36,30
1658108838776,MATH 103A,A02,083778,Greenfeld; Be'Eri,5,0,36,31
1658108838776,MATH 103A,A03,093561,Greenfeld; Be'Eri,7,0,36,29
1658108838776,MATH 103A,B01,083779,Greenfeld; Be'Eri,8,0,36,28
1658108838776,MATH 103A,B02,083780,Greenfeld; Be'Eri,4,0,36,32
1658108838776,MATH 103A,B03,093562,Greenfeld; Be'Eri,3,0,36,33
1658108844803,MATH 105,A01,085443,Carter; Anne Toulson,15,0,35,20
1658108844803,MATH 105,A02,093477,Carter; Anne Toulson,20,0,35,15
1658108850833,MATH 109,A01,083213,Ganzberger; Geoffrey Michael,3,0,34,31
1658108850833,MATH 109,A02,083214,Ganzberger; Geoffrey Michael,4,0,34,30
1658108850833,MATH 109,A03,093478,Ganzberger; Geoffrey Michael,2,0,34,32
1658108850833,MATH 109,B01,083215,Ganzberger; Geoffrey Michael,3,0,32,29
1658108850833,MATH 109,B02,083216,Ganzberger; Geoffrey Michael,3,0,32,29
1658108850833,MATH 109,B03,093479,Ganzberger; Geoffrey Michael,8,0,32,24
1658108856867,MATH 142A,A01,083219,Chow; Bennett,7,0,32,25
1658108856867,MATH 142A,A02,083220,Chow; Bennett,10,0,32,22
1658108856867,MATH 142A,A03,093480,Chow; Bennett,9,0,32,23
1658108856867,MATH 142A,B03,093481,Chow; Bennett,8,0,32,24
1658108856867,MATH 142A,B04,093558,Chow; Bennett,14,0,32,18
1658108856867,MATH 142A,B05,093559,Chow; Bennett,7,0,32,25
1658108862890,MATH 193A,A01,083224,Rotar; Vladimir,9,0,34,25
1658108862890,MATH 193A,A02,083225,Rotar; Vladimir,11,0,34,23
1658108862890,MATH 193A,A03,083781,Rotar; Vladimir,5,0,34,29
1658108862890,MATH 193A,A04,083782,Rotar; Vladimir,12,0,34,22
1658108862890,MATH 193A,A05,093482,Rotar; Vladimir,11,0,34,23
1658108868914,MATH 197,001,091859,McAuley; Julian John,9999,0,9999,0
1658108868914,MATH 197,002,095566,Kedlaya; Kiran S.,9997,0,9999,2
1658108868914,MATH 197,003,095567,Xiao; Ming,9999,0,9999,0
1658108868914,MATH 197,004,095571,Perols; Johan Lars,9998,0,9999,1
1658108875975,COGS 9,A01,083615,Shannon; Kyle Michael,11,0,75,64
1658108882004,COGS 11,A01,083617,Boyle; Mary E. T.,23,0,48,25
1658108888031,COGS 13,A01,083071,Bastos; Amalia Pinkusfeld,12,0,71,59
1658108894060,COGS 14A,A01,092681,Semenuks; Arturs,5,1,100,95
1658108900087,COGS 14B,A01,083073,Cheng; Tzu-Han,7,0,63,56
1658108906111,COGS 17,A01,092677,Semenuks; Arturs,7,0,81,74
1658108912139,COGS 100,A01,083619,Allen; Michael Gordon,17,0,70,53
1658108918166,COGS 101A,A01,083621,Davis; Joshua Daniel,9,0,68,59
1658108924190,COGS 101B,A01,091572,Allen; Michael Gordon,14,0,65,51
1658108930216,COGS 101C,A01,083625,Delgado; Tania,17,0,35,18
1658108936240,COGS 107A,A01,083627,Boyle; Mary E. T.,14,0,60,46
1658108942263,COGS 118A,A01,083075,Gupta; Anjum,21,0,76,55
1658108948291,CSE 3,A50,083646,Miranda; Gregory Joseph,24,0,50,26
1658108954314,CSE 8A,A50,083650,Miranda; Gregory Joseph,17,1,56,39
1658108960338,CSE 11,A01,083080,Cao; Yingjun,7,15,40,33
1658108966362,CSE 12,A01,083652,Krause-Levy; Sophia Louisa,30,1,120,90
1658108972387,CSE 15L,A01,083654,Morris; Justin Loren,9,0,50,41
1658108972387,CSE 15L,A02,083655,Morris; Justin Loren,11,0,50,39
1658108978410,CSE 20,A01,083657,Tran; Khoa Dang,39,0,80,41
1658108984438,CSE 21,A01,095574,Bach; Quang Tran,23,0,48,25
1658108990463,CSE 30,A01,083084,Eldon; John,8,0,80,72
1658108990463,CSE 30,B01,095061,Bhaskar; Nishant,9,0,50,41
1658108996490,CSE 100,A01,083659,Cao; Yingjun,5,4,70,65
1658109002520,CSE 134B,A01,083661,Powell; Thomas Allan,25,0,100,75
1658109008543,CSE 140,A01,083663,Gungor; Onat,17,0,85,68
1658109014565,CSE 140L,A01,083088,Eldon; John,23,0,100,77
1658109020588,CSE 175,A01,083665,Kumar; Rakesh,3,0,25,22
1658109026614,CSE 190,A00,092507,Dubnov; Shlomo,8,0,20,12
1658109032639,ECE 45,A01,083139,Congero; Spencer William,7,0,75,68
1658109038666,ECE 65,A50,083695,Saad; Andrew S,12,0,30,18
1658109038666,ECE 65,A51,095125,Saad; Andrew S,24,0,26,2
1658109044692,ECE 109,A01,091882,Touri; Behrouz,21,0,70,49
1658109050719,ECE 180,A00,083140,Abi Samra; Nicholas Camill,1,0,30,29
1658109050719,ECE 180,B00,083141,Abi Samra; Nicholas Camill,0,0,30,30
1658109056746,MATH 10A,A01,083735,Patchell; Gregory David,2,0,30,28
1658109056746,MATH 10A,A02,083736,Patchell; Gregory David,20,0,30,10
1658109056746,MATH 10A,A03,083737,Patchell; Gregory David,16,0,30,14
1658109062771,MATH 10B,A01,083207,Lim; Seonhee,9,0,34,25
1658109062771,MATH 10B,A02,083208,Lim; Seonhee,10,0,35,25
1658109062771,MATH 10B,A03,093472,Lim; Seonhee,7,0,34,27
1658109062771,MATH 10B,B01,083739,Sinha; Shubham,14,0,30,16
1658109068796,MATH 18,A01,083743,Cinel; Cameron Alexander,9,0,30,21
1658109068796,MATH 18,A02,083744,Cinel; Cameron Alexander,18,0,30,12
1658109068796,MATH 18,A03,083745,Cinel; Cameron Alexander,10,0,30,20
1658109068796,MATH 18,B01,083748,Rideout; David Porter,5,0,37,32
1658109068796,MATH 18,B02,083749,Rideout; David Porter,5,0,36,31
1658109068796,MATH 18,B03,083750,Rideout; David Porter,3,0,37,34
1658109068796,MATH 18,B04,083751,Rideout; David Porter,7,0,36,29
1658109068796,MATH 18,B05,093473,Rideout; David Porter,7,0,36,29
1658109068796,MATH 18,B06,093474,Rideout; David Porter,6,0,36,30
1658109074818,MATH 20A,A01,083754,Zheng; Zequn,14,0,40,26
1658109080847,MATH 20B,A01,083756,Briones; Jor-el Thomas Caparas,4,0,36,32
1658109080847,MATH 20B,A02,083757,Briones; Jor-el Thomas Caparas,1,0,36,35
1658109080847,MATH 20B,A03,093475,Briones; Jor-el Thomas Caparas,3,0,36,33
1658109086872,MATH 20C,A01,083760,Briones; Jor-el Thomas Caparas,1,0,35,34
1658109086872,MATH 20C,A02,083761,Briones; Jor-el Thomas Caparas,8,0,35,27
1658109086872,MATH 20C,A03,093476,Briones; Jor-el Thomas Caparas,0,1,36,36
1658109086872,MATH 20C,B01,083762,Bach; Quang Tran,1,0,30,29
1658109092899,MATH 20D,A01,083765,Tran; Brian Kha,5,0,30,25
1658109092899,MATH 20D,A02,083766,Tran; Brian Kha,5,0,30,25
1658109092899,MATH 20D,A03,083767,Tran; Brian Kha,6,0,30,24
1658109098936,MATH 20E,A01,083771,Ganguly; Soumya,12,0,32,20
1658109098936,MATH 20E,A02,083772,Ganguly; Soumya,7,0,32,25
1658109098936,MATH 20E,B01,083773,Ciotti; Benjamin,20,0,35,15
1658109098936,MATH 20E,B02,083774,Ciotti; Benjamin,18,0,35,17
1658109104961,MATH 103A,A01,083777,Greenfeld; Be'Eri,6,0,36,30
1658109104961,MATH 103A,A02,083778,Greenfeld; Be'Eri,5,0,36,31
1658109104961,MATH 103A,A03,093561,Greenfeld; Be'Eri,7,0,36,29
1658109104961,MATH 103A,B01,083779,Greenfeld; Be'Eri,8,0,36,28
1658109104961,MATH 103A,B02,083780,Greenfeld; Be'Eri,4,0,36,32
1658109104961,MATH 103A,B03,093562,Greenfeld; Be'Eri,3,0,36,33
1658109110985,MATH 105,A01,085443,Carter; Anne Toulson,15,0,35,20
1658109110985,MATH 105,A02,093477,Carter; Anne Toulson,20,0,35,15
1658109117014,MATH 109,A01,083213,Ganzberger; Geoffrey Michael,3,0,34,31
1658109117014,MATH 109,A02,083214,Ganzberger; Geoffrey Michael,4,0,34,30
1658109117014,MATH 109,A03,093478,Ganzberger; Geoffrey Michael,2,0,34,32
1658109117014,MATH 109,B01,083215,Ganzberger; Geoffrey Michael,3,0,32,29
1658109117014,MATH 109,B02,083216,Ganzberger; Geoffrey Michael,3,0,32,29
1658109117014,MATH 109,B03,093479,Ganzberger; Geoffrey Michael,8,0,32,24
1658109123045,MATH 142A,A01,083219,Chow; Bennett,7,0,32,25
1658109123045,MATH 142A,A02,083220,Chow; Bennett,10,0,32,22
1658109123045,MATH 142A,A03,093480,Chow; Bennett,9,0,32,23
1658109123045,MATH 142A,B03,093481,Chow; Bennett,8,0,32,24
1658109123045,MATH 142A,B04,093558,Chow; Bennett,14,0,32,18
1658109123045,MATH 142A,B05,093559,Chow; Bennett,7,0,32,25
1658109129080,MATH 193A,A01,083224,Rotar; Vladimir,9,0,34,25
1658109129080,MATH 193A,A02,083225,Rotar; Vladimir,11,0,34,23
1658109129080,MATH 193A,A03,083781,Rotar; Vladimir,5,0,34,29
1658109129080,MATH 193A,A04,083782,Rotar; Vladimir,12,0,34,22
1658109129080,MATH 193A,A05,093482,Rotar; Vladimir,11,0,34,23
1658109135104,MATH 197,001,091859,McAuley; Julian John,9999,0,9999,0
1658109135104,MATH 197,002,095566,Kedlaya; Kiran S.,9997,0,9999,2
1658109135104,MATH 197,003,095567,Xiao; Ming,9999,0,9999,0
1658109135104,MATH 197,004,095571,Perols; Johan Lars,9998,0,9999,1
1658109142171,COGS 9,A01,083615,Shannon; Kyle Michael,11,0,75,64
1658109148194,COGS 11,A01,083617,Boyle; Mary E. T.,23,0,48,25
1658109154217,COGS 13,A01,083071,Bastos; Amalia Pinkusfeld,12,0,71,59
1658109160245,COGS 14A,A01,092681,Semenuks; Arturs,5,1,100,95
1658109166268,COGS 14B,A01,083073,Cheng; Tzu-Han,7,0,63,56
1658109172291,COGS 17,A01,092677,Semenuks; Arturs,7,0,81,74
1658109178314,COGS 100,A01,083619,Allen; Michael Gordon,17,0,70,53
1658109184340,COGS 101A,A01,083621,Davis; Joshua Daniel,9,0,68,59
1658109190456,COGS 101B,A01,091572,Allen; Michael Gordon,14,0,65,51
1658109196480,COGS 101C,A01,083625,Delgado; Tania,17,0,35,18
1658109202509,COGS 107A,A01,083627,Boyle; Mary E. T.,14,0,60,46
1658109208535,COGS 118A,A01,083075,Gupta; Anjum,21,0,76,55
1658109214563,CSE 3,A50,083646,Miranda; Gregory Joseph,24,0,50,26
1658109220586,CSE 8A,A50,083650,Miranda; Gregory Joseph,17,1,56,39
1658109226614,CSE 11,A01,083080,Cao; Yingjun,7,15,40,33
1658109232647,CSE 12,A01,083652,Krause-Levy; Sophia Louisa,30,1,120,90
1658109238671,CSE 15L,A01,083654,Morris; Justin Loren,9,0,50,41
1658109238671,CSE 15L,A02,083655,Morris; Justin Loren,11,0,50,39
1658109244699,CSE 20,A01,083657,Tran; Khoa Dang,39,0,80,41
1658109250720,CSE 21,A01,095574,Bach; Quang Tran,23,0,48,25
1658109256744,CSE 30,A01,083084,Eldon; John,8,0,80,72
1658109256744,CSE 30,B01,095061,Bhaskar; Nishant,9,0,50,41
1658109262769,CSE 100,A01,083659,Cao; Yingjun,5,4,70,65
1658109268791,CSE 134B,A01,083661,Powell; Thomas Allan,25,0,100,75
1658109274817,CSE 140,A01,083663,Gungor; Onat,17,0,85,68
1658109280841,CSE 140L,A01,083088,Eldon; John,23,0,100,77
1658109286866,CSE 175,A01,083665,Kumar; Rakesh,3,0,25,22
1658109292892,CSE 190,A00,092507,Dubnov; Shlomo,8,0,20,12
1658109298915,ECE 45,A01,083139,Congero; Spencer William,7,0,75,68
1658109304938,ECE 65,A50,083695,Saad; Andrew S,12,0,30,18
1658109304938,ECE 65,A51,095125,Saad; Andrew S,24,0,26,2
1658109310961,ECE 109,A01,091882,Touri; Behrouz,21,0,70,49
1658109316984,ECE 180,A00,083140,Abi Samra; Nicholas Camill,1,0,30,29
1658109316984,ECE 180,B00,083141,Abi Samra; Nicholas Camill,0,0,30,30
1658109323006,MATH 10A,A01,083735,Patchell; Gregory David,2,0,30,28
1658109323006,MATH 10A,A02,083736,Patchell; Gregory David,20,0,30,10
1658109323006,MATH 10A,A03,083737,Patchell; Gregory David,16,0,30,14
1658109329033,MATH 10B,A01,083207,Lim; Seonhee,9,0,34,25
1658109329033,MATH 10B,A02,083208,Lim; Seonhee,10,0,35,25
1658109329033,MATH 10B,A03,093472,Lim; Seonhee,7,0,34,27
1658109329033,MATH 10B,B01,083739,Sinha; Shubham,14,0,30,16
1658109335065,MATH 18,A01,083743,Cinel; Cameron Alexander,9,0,30,21
1658109335065,MATH 18,A02,083744,Cinel; Cameron Alexander,18,0,30,12
1658109335065,MATH 18,A03,083745,Cinel; Cameron Alexander,10,0,30,20
1658109335065,MATH 18,B01,083748,Rideout; David Porter,5,0,37,32
1658109335065,MATH 18,B02,083749,Rideout; David Porter,5,0,36,31
1658109335065,MATH 18,B03,083750,Rideout; David Porter,3,0,37,34
1658109335065,MATH 18,B04,083751,Rideout; David Porter,7,0,36,29
1658109335065,MATH 18,B05,093473,Rideout; David Porter,7,0,36,29
1658109335065,MATH 18,B06,093474,Rideout; David Porter,6,0,36,30
1658109341091,MATH 20A,A01,083754,Zheng; Zequn,14,0,40,26
1658109347114,MATH 20B,A01,083756,Briones; Jor-el Thomas Caparas,4,0,36,32
1658109347114,MATH 20B,A02,083757,Briones; Jor-el Thomas Caparas,1,0,36,35
1658109347114,MATH 20B,A03,093475,Briones; Jor-el Thomas Caparas,3,0,36,33
1658109353140,MATH 20C,A01,083760,Briones; Jor-el Thomas Caparas,1,0,35,34
1658109353140,MATH 20C,A02,083761,Briones; Jor-el Thomas Caparas,8,0,35,27
1658109353140,MATH 20C,A03,093476,Briones; Jor-el Thomas Caparas,0,1,36,36
1658109353140,MATH 20C,B01,083762,Bach; Quang Tran,1,0,30,29
1658109359169,MATH 20D,A01,083765,Tran; Brian Kha,5,0,30,25
1658109359169,MATH 20D,A02,083766,Tran; Brian Kha,5,0,30,25
1658109359169,MATH 20D,A03,083767,Tran; Brian Kha,6,0,30,24
1658109365192,MATH 20E,A01,083771,Ganguly; Soumya,12,0,32,20
1658109365192,MATH 20E,A02,083772,Ganguly; Soumya,7,0,32,25
1658109365192,MATH 20E,B01,083773,Ciotti; Benjamin,20,0,35,15
1658109365192,MATH 20E,B02,083774,Ciotti; Benjamin,18,0,35,17
1658109371223,MATH 103A,A01,083777,Greenfeld; Be'Eri,6,0,36,30
1658109371223,MATH 103A,A02,083778,Greenfeld; Be'Eri,5,0,36,31
1658109371223,MATH 103A,A03,093561,Greenfeld; Be'Eri,7,0,36,29
1658109371223,MATH 103A,B01,083779,Greenfeld; Be'Eri,8,0,36,28
1658109371223,MATH 103A,B02,083780,Greenfeld; Be'Eri,4,0,36,32
1658109371223,MATH 103A,B03,093562,Greenfeld; Be'Eri,3,0,36,33
1658109377250,MATH 105,A01,085443,Carter; Anne Toulson,15,0,35,20
1658109377250,MATH 105,A02,093477,Carter; Anne Toulson,20,0,35,15
1658109383280,MATH 109,A01,083213,Ganzberger; Geoffrey Michael,3,0,34,31
1658109383280,MATH 109,A02,083214,Ganzberger; Geoffrey Michael,4,0,34,30
1658109383280,MATH 109,A03,093478,Ganzberger; Geoffrey Michael,2,0,34,32
1658109383280,MATH 109,B01,083215,Ganzberger; Geoffrey Michael,3,0,32,29
1658109383280,MATH 109,B02,083216,Ganzberger; Geoffrey Michael,3,0,32,29
1658109383280,MATH 109,B03,093479,Ganzberger; Geoffrey Michael,8,0,32,24
1658109389304,MATH 142A,A01,083219,Chow; Bennett,7,0,32,25
1658109389304,MATH 142A,A02,083220,Chow; Bennett,10,0,32,22
1658109389304,MATH 142A,A03,093480,Chow; Bennett,9,0,32,23
1658109389304,MATH 142A,B03,093481,Chow; Bennett,8,0,32,24
1658109389304,MATH 142A,B04,093558,Chow; Bennett,14,0,32,18
1658109389304,MATH 142A,B05,093559,Chow; Bennett,7,0,32,25
1658109395329,MATH 193A,A01,083224,Rotar; Vladimir,9,0,34,25
1658109395329,MATH 193A,A02,083225,Rotar; Vladimir,11,0,34,23
1658109395329,MATH 193A,A03,083781,Rotar; Vladimir,5,0,34,29
1658109395329,MATH 193A,A04,083782,Rotar; Vladimir,12,0,34,22
1658109395329,MATH 193A,A05,093482,Rotar; Vladimir,11,0,34,23
1658109401352,MATH 197,001,091859,McAuley; Julian John,9999,0,9999,0
1658109401352,MATH 197,002,095566,Kedlaya; Kiran S.,9997,0,9999,2
1658109401352,MATH 197,003,095567,Xiao; Ming,9999,0,9999,0
1658109401352,MATH 197,004,095571,Perols; Johan Lars,9998,0,9999,1
1658109408421,COGS 9,A01,083615,Shannon; Kyle Michael,11,0,75,64
1658109414445,COGS 11,A01,083617,Boyle; Mary E. T.,23,0,48,25
1658109420467,COGS 13,A01,083071,Bastos; Amalia Pinkusfeld,12,0,71,59
1658109426497,COGS 14A,A01,092681,Semenuks; Arturs,5,1,100,95
1658109432525,COGS 14B,A01,083073,Cheng; Tzu-Han,7,0,63,56
1658109438556,COGS 17,A01,092677,Semenuks; Arturs,7,0,81,74
1658109444583,COGS 100,A01,083619,Allen; Michael Gordon,17,0,70,53
1658109450607,COGS 101A,A01,083621,Davis; Joshua Daniel,9,0,68,59
1658109456630,COGS 101B,A01,091572,Allen; Michael Gordon,14,0,65,51
1658109462655,COGS 101C,A01,083625,Delgado; Tania,17,0,35,18
1658109468691,COGS 107A,A01,083627,Boyle; Mary E. T.,14,0,60,46
1658109474715,COGS 118A,A01,083075,Gupta; Anjum,21,0,76,55
1658109480741,CSE 3,A50,083646,Miranda; Gregory Joseph,24,0,50,26
1658109486765,CSE 8A,A50,083650,Miranda; Gregory Joseph,17,1,56,39
1658109492787,CSE 11,A01,083080,Cao; Yingjun,7,15,40,33
1658109498809,CSE 12,A01,083652,Krause-Levy; Sophia Louisa,30,1,120,90
1658109504836,CSE 15L,A01,083654,Morris; Justin Loren,9,0,50,41
1658109504836,CSE 15L,A02,083655,Morris; Justin Loren,11,0,50,39
1658109510861,CSE 20,A01,083657,Tran; Khoa Dang,39,0,80,41
1658109516885,CSE 21,A01,095574,Bach; Quang Tran,23,0,48,25
1658109522913,CSE 30,A01,083084,Eldon; John,8,0,80,72
1658109522913,CSE 30,B01,095061,Bhaskar; Nishant,9,0,50,41
1658109528936,CSE 100,A01,083659,Cao; Yingjun,5,4,70,65
1658109534962,CSE 134B,A01,083661,Powell; Thomas Allan,25,0,100,75
1658109540988,CSE 140,A01,083663,Gungor; Onat,17,0,85,68
1658109547012,CSE 140L,A01,083088,Eldon; John,23,0,100,77
1658109553039,CSE 175,A01,083665,Kumar; Rakesh,3,0,25,22
1658109559065,CSE 190,A00,092507,Dubnov; Shlomo,8,0,20,12
1658109565089,ECE 45,A01,083139,Congero; Spencer William,7,0,75,68
1658109571113,ECE 65,A50,083695,Saad; Andrew S,12,0,30,18
1658109571113,ECE 65,A51,095125,Saad; Andrew S,24,0,26,2
1658109577137,ECE 109,A01,091882,Touri; Behrouz,21,0,70,49
1658109583165,ECE 180,A00,083140,Abi Samra; Nicholas Camill,1,0,30,29
1658109583165,ECE 180,B00,083141,Abi Samra; Nicholas Camill,0,0,30,30
1658109589192,MATH 10A,A01,083735,Patchell; Gregory David,2,0,30,28
1658109589192,MATH 10A,A02,083736,Patchell; Gregory David,20,0,30,10
1658109589192,MATH 10A,A03,083737,Patchell; Gregory David,16,0,30,14
1658109595216,MATH 10B,A01,083207,Lim; Seonhee,9,0,34,25
1658109595216,MATH 10B,A02,083208,Lim; Seonhee,10,0,35,25
1658109595216,MATH 10B,A03,093472,Lim; Seonhee,7,0,34,27
1658109595216,MATH 10B,B01,083739,Sinha; Shubham,14,0,30,16
1658109601245,MATH 18,A01,083743,Cinel; Cameron Alexander,9,0,30,21
1658109601245,MATH 18,A02,083744,Cinel; Cameron Alexander,18,0,30,12
1658109601245,MATH 18,A03,083745,Cinel; Cameron Alexander,10,0,30,20
1658109601245,MATH 18,B01,083748,Rideout; David Porter,5,0,37,32
1658109601245,MATH 18,B02,083749,Rideout; David Porter,5,0,36,31
1658109601245,MATH 18,B03,083750,Rideout; David Porter,3,0,37,34
1658109601245,MATH 18,B04,083751,Rideout; David Porter,7,0,36,29
1658109601245,MATH 18,B05,093473,Rideout; David Porter,7,0,36,29
1658109601245,MATH 18,B06,093474,Rideout; David Porter,6,0,36,30
1658109607268,MATH 20A,A01,083754,Zheng; Zequn,14,0,40,26
1658109613292,MATH 20B,A01,083756,Briones; Jor-el Thomas Caparas,4,0,36,32
1658109613292,MATH 20B,A02,083757,Briones; Jor-el Thomas Caparas,1,0,36,35
1658109613292,MATH 20B,A03,093475,Briones; Jor-el Thomas Caparas,3,0,36,33
1658109619318,MATH 20C,A01,083760,Briones; Jor-el Thomas Caparas,1,0,35,34
1658109619318,MATH 20C,A02,083761,Briones; Jor-el Thomas Caparas,8,0,35,27
1658109619318,MATH 20C,A03,093476,Briones; Jor-el Thomas Caparas,0,1,36,36
1658109619318,MATH 20C,B01,083762,Bach; Quang Tran,1,0,30,29
1658109625340,MATH 20D,A01,083765,Tran; Brian Kha,5,0,30,25
1658109625340,MATH 20D,A02,083766,Tran; Brian Kha,5,0,30,25
1658109625340,MATH 20D,A03,083767,Tran; Brian Kha,6,0,30,24
1658109631369,MATH 20E,A01,083771,Ganguly; Soumya,12,0,32,20
1658109631369,MATH 20E,A02,083772,Ganguly; Soumya,7,0,32,25
1658109631369,MATH 20E,B01,083773,Ciotti; Benjamin,20,0,35,15
1658109631369,MATH 20E,B02,083774,Ciotti; Benjamin,18,0,35,17
1658109637395,MATH 103A,A01,083777,Greenfeld; Be'Eri,6,0,36,30
1658109637395,MATH 103A,A02,083778,Greenfeld; Be'Eri,5,0,36,31
1658109637395,MATH 103A,A03,093561,Greenfeld; Be'Eri,7,0,36,29
1658109637395,MATH 103A,B01,083779,Greenfeld; Be'Eri,8,0,36,28
1658109637395,MATH 103A,B02,083780,Greenfeld; Be'Eri,4,0,36,32
1658109637395,MATH 103A,B03,093562,Greenfeld; Be'Eri,3,0,36,33
1658109643417,MATH 105,A01,085443,Carter; Anne Toulson,15,0,35,20
1658109643417,MATH 105,A02,093477,Carter; Anne Toulson,20,0,35,15
1658109649449,MATH 109,A01,083213,Ganzberger; Geoffrey Michael,3,0,34,31
1658109649449,MATH 109,A02,083214,Ganzberger; Geoffrey Michael,4,0,34,30
1658109649449,MATH 109,A03,093478,Ganzberger; Geoffrey Michael,2,0,34,32
1658109649449,MATH 109,B01,083215,Ganzberger; Geoffrey Michael,3,0,32,29
1658109649449,MATH 109,B02,083216,Ganzberger; Geoffrey Michael,3,0,32,29
1658109649449,MATH 109,B03,093479,Ganzberger; Geoffrey Michael,8,0,32,24
1658109655479,MATH 142A,A01,083219,Chow; Bennett,7,0,32,25
1658109655479,MATH 142A,A02,083220,Chow; Bennett,10,0,32,22
1658109655479,MATH 142A,A03,093480,Chow; Bennett,9,0,32,23
1658109655479,MATH 142A,B03,093481,Chow; Bennett,8,0,32,24
1658109655479,MATH 142A,B04,093558,Chow; Bennett,14,0,32,18
1658109655479,MATH 142A,B05,093559,Chow; Bennett,7,0,32,25
1658109661503,MATH 193A,A01,083224,Rotar; Vladimir,9,0,34,25
1658109661503,MATH 193A,A02,083225,Rotar; Vladimir,11,0,34,23
1658109661503,MATH 193A,A03,083781,Rotar; Vladimir,5,0,34,29
1658109661503,MATH 193A,A04,083782,Rotar; Vladimir,12,0,34,22
1658109661503,MATH 193A,A05,093482,Rotar; Vladimir,11,0,34,23
1658109667527,MATH 197,001,091859,McAuley; Julian John,9999,0,9999,0
1658109667527,MATH 197,002,095566,Kedlaya; Kiran S.,9997,0,9999,2
1658109667527,MATH 197,003,095567,Xiao; Ming,9999,0,9999,0
1658109667527,MATH 197,004,095571,Perols; Johan Lars,9998,0,9999,1
1658109674671,COGS 9,A01,083615,Shannon; Kyle Michael,11,0,75,64
1658109680696,COGS 11,A01,083617,Boyle; Mary E. T.,23,0,48,25
1658109686727,COGS 13,A01,083071,Bastos; Amalia Pinkusfeld,12,0,71,59
1658109692751,COGS 14A,A01,092681,Semenuks; Arturs,5,1,100,95
1658109698796,COGS 14B,A01,083073,Cheng; Tzu-Han,7,0,63,56
1658109704823,COGS 17,A01,092677,Semenuks; Arturs,7,0,81,74
1658109710863,COGS 100,A01,083619,Allen; Michael Gordon,17,0,70,53
1658109716885,COGS 101A,A01,083621,Davis; Joshua Daniel,9,0,68,59
1658109722908,COGS 101B,A01,091572,Allen; Michael Gordon,14,0,65,51
1658109728933,COGS 101C,A01,083625,Delgado; Tania,17,0,35,18
1658109734957,COGS 107A,A01,083627,Boyle; Mary E. T.,14,0,60,46
1658109740980,COGS 118A,A01,083075,Gupta; Anjum,21,0,76,55
1658109747011,CSE 3,A50,083646,Miranda; Gregory Joseph,24,0,50,26
1658109753034,CSE 8A,A50,083650,Miranda; Gregory Joseph,17,1,56,39
1658109759057,CSE 11,A01,083080,Cao; Yingjun,7,15,40,33
1658109765081,CSE 12,A01,083652,Krause-Levy; Sophia Louisa,30,1,120,90
1658109771104,CSE 15L,A01,083654,Morris; Justin Loren,9,0,50,41
1658109771104,CSE 15L,A02,083655,Morris; Justin Loren,11,0,50,39
1658109777129,CSE 20,A01,083657,Tran; Khoa Dang,39,0,80,41
1658109783153,CSE 21,A01,095574,Bach; Quang Tran,23,0,48,25
1658109789248,CSE 30,A01,083084,Eldon; John,8,0,80,72
1658109789248,CSE 30,B01,095061,Bhaskar; Nishant,9,0,50,41
1658109795282,CSE 100,A01,083659,Cao; Yingjun,5,4,70,65
1658109801306,CSE 134B,A01,083661,Powell; Thomas Allan,25,0,100,75
1658109807370,CSE 140,A01,083663,Gungor; Onat,17,0,85,68
1658109813395,CSE 140L,A01,083088,Eldon; John,23,0,100,77
1658109819417,CSE 175,A01,083665,Kumar; Rakesh,3,0,25,22
1658109825440,CSE 190,A00,092507,Dubnov; Shlomo,8,0,20,12
1658109831471,ECE 45,A01,083139,Congero; Spencer William,7,0,75,68
1658109837510,ECE 65,A50,083695,Saad; Andrew S,12,0,30,18
1658109837510,ECE 65,A51,095125,Saad; Andrew S,24,0,26,2
1658109843532,ECE 109,A01,091882,Touri; Behrouz,21,0,70,49
1658109849555,ECE 180,A00,083140,Abi Samra; Nicholas Camill,1,0,30,29
1658109849555,ECE 180,B00,083141,Abi Samra; Nicholas Camill,0,0,30,30
1658109855586,MATH 10A,A01,083735,Patchell; Gregory David,2,0,30,28
1658109855586,MATH 10A,A02,083736,Patchell; Gregory David,20,0,30,10
1658109855586,MATH 10A,A03,083737,Patchell; Gregory David,16,0,30,14
1658109861621,MATH 10B,A01,083207,Lim; Seonhee,9,0,34,25
1658109861621,MATH 10B,A02,083208,Lim; Seonhee,10,0,35,25
1658109861621,MATH 10B,A03,093472,Lim; Seonhee,7,0,34,27
1658109861621,MATH 10B,B01,083739,Sinha; Shubham,14,0,30,16
1658109867662,MATH 18,A01,083743,Cinel; Cameron Alexander,9,0,30,21
1658109867662,MATH 18,A02,083744,Cinel; Cameron Alexander,18,0,30,12
1658109867662,MATH 18,A03,083745,Cinel; Cameron Alexander,10,0,30,20
1658109867662,MATH 18,B01,083748,Rideout; David Porter,5,0,37,32
1658109867662,MATH 18,B02,083749,Rideout; David Porter,5,0,36,31
1658109867662,MATH 18,B03,083750,Rideout; David Porter,3,0,37,34
1658109867662,MATH 18,B04,083751,Rideout; David Porter,7,0,36,29
1658109867662,MATH 18,B05,093473,Rideout; David Porter,7,0,36,29
1658109867662,MATH 18,B06,093474,Rideout; David Porter,6,0,36,30
1658109873691,MATH 20A,A01,083754,Zheng; Zequn,14,0,40,26
1658109879719,MATH 20B,A01,083756,Briones; Jor-el Thomas Caparas,4,0,36,32
1658109879719,MATH 20B,A02,083757,Briones; Jor-el Thomas Caparas,1,0,36,35
1658109879719,MATH 20B,A03,093475,Briones; Jor-el Thomas Caparas,3,0,36,33
1658109885742,MATH 20C,A01,083760,Briones; Jor-el Thomas Caparas,1,0,35,34
1658109885742,MATH 20C,A02,083761,Briones; Jor-el Thomas Caparas,8,0,35,27
1658109885742,MATH 20C,A03,093476,Briones; Jor-el Thomas Caparas,0,1,36,36
1658109885742,MATH 20C,B01,083762,Bach; Quang Tran,1,0,30,29
1658109891779,MATH 20D,A01,083765,Tran; Brian Kha,5,0,30,25
1658109891779,MATH 20D,A02,083766,Tran; Brian Kha,5,0,30,25
1658109891779,MATH 20D,A03,083767,Tran; Brian Kha,6,0,30,24
1658109897809,MATH 20E,A01,083771,Ganguly; Soumya,12,0,32,20
1658109897809,MATH 20E,A02,083772,Ganguly; Soumya,7,0,32,25
1658109897809,MATH 20E,B01,083773,Ciotti; Benjamin,20,0,35,15
1658109897809,MATH 20E,B02,083774,Ciotti; Benjamin,18,0,35,17
1658109903832,MATH 103A,A01,083777,Greenfeld; Be'Eri,6,0,36,30
1658109903832,MATH 103A,A02,083778,Greenfeld; Be'Eri,5,0,36,31
1658109903832,MATH 103A,A03,093561,Greenfeld; Be'Eri,7,0,36,29
1658109903832,MATH 103A,B01,083779,Greenfeld; Be'Eri,8,0,36,28
1658109903832,MATH 103A,B02,083780,Greenfeld; Be'Eri,4,0,36,32
1658109903832,MATH 103A,B03,093562,Greenfeld; Be'Eri,3,0,36,33
1658109909855,MATH 105,A01,085443,Carter; Anne Toulson,15,0,35,20
1658109909855,MATH 105,A02,093477,Carter; Anne Toulson,20,0,35,15
1658109915879,MATH 109,A01,083213,Ganzberger; Geoffrey Michael,3,0,34,31
1658109915879,MATH 109,A02,083214,Ganzberger; Geoffrey Michael,4,0,34,30
1658109915879,MATH 109,A03,093478,Ganzberger; Geoffrey Michael,2,0,34,32
1658109915879,MATH 109,B01,083215,Ganzberger; Geoffrey Michael,3,0,32,29
1658109915879,MATH 109,B02,083216,Ganzberger; Geoffrey Michael,3,0,32,29
1658109915879,MATH 109,B03,093479,Ganzberger; Geoffrey Michael,8,0,32,24
1658109921903,MATH 142A,A01,083219,Chow; Bennett,7,0,32,25
1658109921903,MATH 142A,A02,083220,Chow; Bennett,10,0,32,22
1658109921903,MATH 142A,A03,093480,Chow; Bennett,9,0,32,23
1658109921903,MATH 142A,B03,093481,Chow; Bennett,8,0,32,24
1658109921903,MATH 142A,B04,093558,Chow; Bennett,14,0,32,18
1658109921903,MATH 142A,B05,093559,Chow; Bennett,7,0,32,25
1658109927932,MATH 193A,A01,083224,Rotar; Vladimir,9,0,34,25
1658109927932,MATH 193A,A02,083225,Rotar; Vladimir,11,0,34,23
1658109927932,MATH 193A,A03,083781,Rotar; Vladimir,5,0,34,29
1658109927932,MATH 193A,A04,083782,Rotar; Vladimir,12,0,34,22
1658109927932,MATH 193A,A05,093482,Rotar; Vladimir,11,0,34,23
1658109933953,MATH 197,001,091859,McAuley; Julian John,9999,0,9999,0
1658109933953,MATH 197,002,095566,Kedlaya; Kiran S.,9997,0,9999,2
1658109933953,MATH 197,003,095567,Xiao; Ming,9999,0,9999,0
1658109933953,MATH 197,004,095571,Perols; Johan Lars,9998,0,9999,1
1658109941023,COGS 9,A01,083615,Shannon; Kyle Michael,11,0,75,64
1658109947047,COGS 11,A01,083617,Boyle; Mary E. T.,23,0,48,25
1658109953071,COGS 13,A01,083071,Bastos; Amalia Pinkusfeld,12,0,71,59
1658109959094,COGS 14A,A01,092681,Semenuks; Arturs,5,1,100,95
1658109965118,COGS 14B,A01,083073,Cheng; Tzu-Han,7,0,63,56
1658109971144,COGS 17,A01,092677,Semenuks; Arturs,7,0,81,74
1658109977168,COGS 100,A01,083619,Allen; Michael Gordon,17,0,70,53
1658109983195,COGS 101A,A01,083621,Davis; Joshua Daniel,9,0,68,59
1658109989217,COGS 101B,A01,091572,Allen; Michael Gordon,14,0,65,51
1658109995240,COGS 101C,A01,083625,Delgado; Tania,17,0,35,18
1658110001263,COGS 107A,A01,083627,Boyle; Mary E. T.,14,0,60,46
1658110007286,COGS 118A,A01,083075,Gupta; Anjum,21,0,76,55
1658110013323,CSE 3,A50,083646,Miranda; Gregory Joseph,24,0,50,26
1658110019351,CSE 8A,A50,083650,Miranda; Gregory Joseph,17,1,56,39
1658110025378,CSE 11,A01,083080,Cao; Yingjun,7,15,40,33
1658110031403,CSE 12,A01,083652,Krause-Levy; Sophia Louisa,30,1,120,90
1658110037427,CSE 15L,A01,083654,Morris; Justin Loren,9,0,50,41
1658110037427,CSE 15L,A02,083655,Morris; Justin Loren,11,0,50,39
1658110043463,CSE 20,A01,083657,Tran; Khoa Dang,39,0,80,41
1658110049493,CSE 21,A01,095574,Bach; Quang Tran,23,0,48,25
1658110055518,CSE 30,A01,083084,Eldon; John,8,0,80,72
1658110055518,CSE 30,B01,095061,Bhaskar; Nishant,9,0,50,41
1658110061541,CSE 100,A01,083659,Cao; Yingjun,5,4,70,65
1658110067563,CSE 134B,A01,083661,Powell; Thomas Allan,25,0,100,75
1658110073587,CSE 140,A01,083663,Gungor; Onat,17,0,85,68
1658110079610,CSE 140L,A01,083088,Eldon; John,23,0,100,77
1658110085636,CSE 175,A01,083665,Kumar; Rakesh,3,0,25,22
1658110091663,CSE 190,A00,092507,Dubnov; Shlomo,8,0,20,12
1658110097689,ECE 45,A01,083139,Congero; Spencer William,7,0,75,68
1658110103712,ECE 65,A50,083695,Saad; Andrew S,12,0,30,18
1658110103712,ECE 65,A51,095125,Saad; Andrew S,24,0,26,2
1658110109735,ECE 109,A01,091882,Touri; Behrouz,21,0,70,49
1658110115762,ECE 180,A00,083140,Abi Samra; Nicholas Camill,1,0,30,29
1658110115762,ECE 180,B00,083141,Abi Samra; Nicholas Camill,0,0,30,30
1658110121790,MATH 10A,A01,083735,Patchell; Gregory David,2,0,30,28
1658110121790,MATH 10A,A02,083736,Patchell; Gregory David,20,0,30,10
1658110121790,MATH 10A,A03,083737,Patchell; Gregory David,16,0,30,14
1658110127815,MATH 10B,A01,083207,Lim; Seonhee,9,0,34,25
1658110127815,MATH 10B,A02,083208,Lim; Seonhee,10,0,35,25
1658110127815,MATH 10B,A03,093472,Lim; Seonhee,7,0,34,27
1658110127815,MATH 10B,B01,083739,Sinha; Shubham,14,0,30,16
1658110133840,MATH 18,A01,083743,Cinel; Cameron Alexander,9,0,30,21
1658110133840,MATH 18,A02,083744,Cinel; Cameron Alexander,18,0,30,12
1658110133840,MATH 18,A03,083745,Cinel; Cameron Alexander,10,0,30,20
1658110133840,MATH 18,B01,083748,Rideout; David Porter,5,0,37,32
1658110133840,MATH 18,B02,083749,Rideout; David Porter,5,0,36,31
1658110133840,MATH 18,B03,083750,Rideout; David Porter,3,0,37,34
1658110133840,MATH 18,B04,083751,Rideout; David Porter,7,0,36,29
1658110133840,MATH 18,B05,093473,Rideout; David Porter,7,0,36,29
1658110133840,MATH 18,B06,093474,Rideout; David Porter,6,0,36,30
1658110139864,MATH 20A,A01,083754,Zheng; Zequn,14,0,40,26
1658110145905,MATH 20B,A01,083756,Briones; Jor-el Thomas Caparas,4,0,36,32
1658110145905,MATH 20B,A02,083757,Briones; Jor-el Thomas Caparas,1,0,36,35
1658110145905,MATH 20B,A03,093475,Briones; Jor-el Thomas Caparas,3,0,36,33
1658110151933,MATH 20C,A01,083760,Briones; Jor-el Thomas Caparas,1,0,35,34
1658110151933,MATH 20C,A02,083761,Briones; Jor-el Thomas Caparas,8,0,35,27
1658110151933,MATH 20C,A03,093476,Briones; Jor-el Thomas Caparas,0,1,36,36
1658110151933,MATH 20C,B01,083762,Bach; Quang Tran,1,0,30,29
1658110157956,MATH 20D,A01,083765,Tran; Brian Kha,5,0,30,25
1658110157956,MATH 20D,A02,083766,Tran; Brian Kha,5,0,30,25
1658110157956,MATH 20D,A03,083767,Tran; Brian Kha,6,0,30,24
1658110163981,MATH 20E,A01,083771,Ganguly; Soumya,12,0,32,20
1658110163981,MATH 20E,A02,083772,Ganguly; Soumya,7,0,32,25
1658110163981,MATH 20E,B01,083773,Ciotti; Benjamin,20,0,35,15
1658110163981,MATH 20E,B02,083774,Ciotti; Benjamin,18,0,35,17
1658110170011,MATH 103A,A01,083777,Greenfeld; Be'Eri,6,0,36,30
1658110170011,MATH 103A,A02,083778,Greenfeld; Be'Eri,5,0,36,31
1658110170011,MATH 103A,A03,093561,Greenfeld; Be'Eri,7,0,36,29
1658110170011,MATH 103A,B01,083779,Greenfeld; Be'Eri,8,0,36,28
1658110170011,MATH 103A,B02,083780,Greenfeld; Be'Eri,4,0,36,32
1658110170011,MATH 103A,B03,093562,Greenfeld; Be'Eri,3,0,36,33
1658110176038,MATH 105,A01,085443,Carter; Anne Toulson,15,0,35,20
1658110176038,MATH 105,A02,093477,Carter; Anne Toulson,20,0,35,15
1658110182064,MATH 109,A01,083213,Ganzberger; Geoffrey Michael,3,0,34,31
1658110182064,MATH 109,A02,083214,Ganzberger; Geoffrey Michael,4,0,34,30
1658110182064,MATH 109,A03,093478,Ganzberger; Geoffrey Michael,2,0,34,32
1658110182064,MATH 109,B01,083215,Ganzberger; Geoffrey Michael,3,0,32,29
1658110182064,MATH 109,B02,083216,Ganzberger; Geoffrey Michael,3,0,32,29
1658110182064,MATH 109,B03,093479,Ganzberger; Geoffrey Michael,8,0,32,24
1658110188089,MATH 142A,A01,083219,Chow; Bennett,7,0,32,25
1658110188089,MATH 142A,A02,083220,Chow; Bennett,10,0,32,22
1658110188089,MATH 142A,A03,093480,Chow; Bennett,9,0,32,23
1658110188089,MATH 142A,B03,093481,Chow; Bennett,8,0,32,24
1658110188089,MATH 142A,B04,093558,Chow; Bennett,14,0,32,18
1658110188089,MATH 142A,B05,093559,Chow; Bennett,7,0,32,25
1658110194113,MATH 193A,A01,083224,Rotar; Vladimir,9,0,34,25
1658110194113,MATH 193A,A02,083225,Rotar; Vladimir,11,0,34,23
1658110194113,MATH 193A,A03,083781,Rotar; Vladimir,5,0,34,29
1658110194113,MATH 193A,A04,083782,Rotar; Vladimir,12,0,34,22
1658110194113,MATH 193A,A05,093482,Rotar; Vladimir,11,0,34,23
1658110200136,MATH 197,001,091859,McAuley; Julian John,9999,0,9999,0
1658110200136,MATH 197,002,095566,Kedlaya; Kiran S.,9997,0,9999,2
1658110200136,MATH 197,003,095567,Xiao; Ming,9999,0,9999,0
1658110200136,MATH 197,004,095571,Perols; Johan Lars,9998,0,9999,1
1658110207201,COGS 9,A01,083615,Shannon; Kyle Michael,11,0,75,64
1658110213228,COGS 11,A01,083617,Boyle; Mary E. T.,23,0,48,25
1658110219257,COGS 13,A01,083071,Bastos; Amalia Pinkusfeld,12,0,71,59
1658110225282,COGS 14A,A01,092681,Semenuks; Arturs,5,1,100,95
1658110231307,COGS 14B,A01,083073,Cheng; Tzu-Han,7,0,63,56
1658110237332,COGS 17,A01,092677,Semenuks; Arturs,7,0,81,74
1658110243362,COGS 100,A01,083619,Allen; Michael Gordon,17,0,70,53
1658110249399,COGS 101A,A01,083621,Davis; Joshua Daniel,9,0,68,59
1658110255427,COGS 101B,A01,091572,Allen; Michael Gordon,14,0,65,51
1658110261450,COGS 101C,A01,083625,Delgado; Tania,17,0,35,18
1658110267479,COGS 107A,A01,083627,Boyle; Mary E. T.,14,0,60,46
1658110273503,COGS 118A,A01,083075,Gupta; Anjum,21,0,76,55
1658110279536,CSE 3,A50,083646,Miranda; Gregory Joseph,24,0,50,26
1658110285561,CSE 8A,A50,083650,Miranda; Gregory Joseph,17,1,56,39
1658110291589,CSE 11,A01,083080,Cao; Yingjun,7,15,40,33
1658110297613,CSE 12,A01,083652,Krause-Levy; Sophia Louisa,30,1,120,90
1658110303637,CSE 15L,A01,083654,Morris; Justin Loren,9,0,50,41
1658110303637,CSE 15L,A02,083655,Morris; Justin Loren,11,0,50,39
1658110309666,CSE 20,A01,083657,Tran; Khoa Dang,39,0,80,41
1658110315690,CSE 21,A01,095574,Bach; Quang Tran,23,0,48,25
1658110321714,CSE 30,A01,083084,Eldon; John,8,0,80,72
1658110321714,CSE 30,B01,095061,Bhaskar; Nishant,9,0,50,41
1658110327738,CSE 100,A01,083659,Cao; Yingjun,5,4,70,65
1658110333760,CSE 134B,A01,083661,Powell; Thomas Allan,25,0,100,75
1658110339783,CSE 140,A01,083663,Gungor; Onat,17,0,85,68
1658110345806,CSE 140L,A01,083088,Eldon; John,23,0,100,77
1658110351832,CSE 175,A01,083665,Kumar; Rakesh,3,0,25,22
1658110357857,CSE 190,A00,092507,Dubnov; Shlomo,8,0,20,12
1658110363880,ECE 45,A01,083139,Congero; Spencer William,7,0,75,68
1658110369907,ECE 65,A50,083695,Saad; Andrew S,12,0,30,18
1658110369907,ECE 65,A51,095125,Saad; Andrew S,24,0,26,2
1658110375929,ECE 109,A01,091882,Touri; Behrouz,21,0,70,49
1658110381962,ECE 180,A00,083140,Abi Samra; Nicholas Camill,1,0,30,29
1658110381962,ECE 180,B00,083141,Abi Samra; Nicholas Camill,0,0,30,30
1658110388078,MATH 10A,A01,083735,Patchell; Gregory David,2,0,30,28
1658110388078,MATH 10A,A02,083736,Patchell; Gregory David,20,0,30,10
1658110388078,MATH 10A,A03,083737,Patchell; Gregory David,16,0,30,14
1658110394101,MATH 10B,A01,083207,Lim; Seonhee,9,0,34,25
1658110394101,MATH 10B,A02,083208,Lim; Seonhee,10,0,35,25
1658110394101,MATH 10B,A03,093472,Lim; Seonhee,7,0,34,27
1658110394101,MATH 10B,B01,083739,Sinha; Shubham,14,0,30,16
1658110400132,MATH 18,A01,083743,Cinel; Cameron Alexander,9,0,30,21
1658110400132,MATH 18,A02,083744,Cinel; Cameron Alexander,18,0,30,12
1658110400132,MATH 18,A03,083745,Cinel; Cameron Alexander,10,0,30,20
1658110400132,MATH 18,B01,083748,Rideout; David Porter,5,0,37,32
1658110400132,MATH 18,B02,083749,Rideout; David Porter,5,0,36,31
1658110400132,MATH 18,B03,083750,Rideout; David Porter,3,0,37,34
1658110400132,MATH 18,B04,083751,Rideout; David Porter,7,0,36,29
1658110400132,MATH 18,B05,093473,Rideout; David Porter,7,0,36,29
1658110400132,MATH 18,B06,093474,Rideout; David Porter,6,0,36,30
1658110406158,MATH 20A,A01,083754,Zheng; Zequn,14,0,40,26
1658110412185,MATH 20B,A01,083756,Briones; Jor-el Thomas Caparas,4,0,36,32
1658110412185,MATH 20B,A02,083757,Briones; Jor-el Thomas Caparas,1,0,36,35
1658110412185,MATH 20B,A03,093475,Briones; Jor-el Thomas Caparas,3,0,36,33
1658110418209,MATH 20C,A01,083760,Briones; Jor-el Thomas Caparas,1,0,35,34
1658110418209,MATH 20C,A02,083761,Briones; Jor-el Thomas Caparas,8,0,35,27
1658110418209,MATH 20C,A03,093476,Briones; Jor-el Thomas Caparas,0,1,36,36
1658110418209,MATH 20C,B01,083762,Bach; Quang Tran,1,0,30,29
1658110424237,MATH 20D,A01,083765,Tran; Brian Kha,5,0,30,25
1658110424237,MATH 20D,A02,083766,Tran; Brian Kha,5,0,30,25
1658110424237,MATH 20D,A03,083767,Tran; Brian Kha,6,0,30,24
1658110430260,MATH 20E,A01,083771,Ganguly; Soumya,12,0,32,20
1658110430260,MATH 20E,A02,083772,Ganguly; Soumya,7,0,32,25
1658110430260,MATH 20E,B01,083773,Ciotti; Benjamin,20,0,35,15
1658110430260,MATH 20E,B02,083774,Ciotti; Benjamin,18,0,35,17
1658110436289,MATH 103A,A01,083777,Greenfeld; Be'Eri,6,0,36,30
1658110436289,MATH 103A,A02,083778,Greenfeld; Be'Eri,5,0,36,31
1658110436289,MATH 103A,A03,093561,Greenfeld; Be'Eri,7,0,36,29
1658110436289,MATH 103A,B01,083779,Greenfeld; Be'Eri,8,0,36,28
1658110436289,MATH 103A,B02,083780,Greenfeld; Be'Eri,4,0,36,32
1658110436289,MATH 103A,B03,093562,Greenfeld; Be'Eri,3,0,36,33
1658110442317,MATH 105,A01,085443,Carter; Anne Toulson,15,0,35,20
1658110442317,MATH 105,A02,093477,Carter; Anne Toulson,20,0,35,15
1658110448341,MATH 109,A01,083213,Ganzberger; Geoffrey Michael,3,0,34,31
1658110448341,MATH 109,A02,083214,Ganzberger; Geoffrey Michael,4,0,34,30
1658110448341,MATH 109,A03,093478,Ganzberger; Geoffrey Michael,2,0,34,32
1658110448341,MATH 109,B01,083215,Ganzberger; Geoffrey Michael,3,0,32,29
1658110448341,MATH 109,B02,083216,Ganzberger; Geoffrey Michael,3,0,32,29
1658110448341,MATH 109,B03,093479,Ganzberger; Geoffrey Michael,8,0,32,24
1658110454370,MATH 142A,A01,083219,Chow; Bennett,7,0,32,25
1658110454370,MATH 142A,A02,083220,Chow; Bennett,10,0,32,22
1658110454370,MATH 142A,A03,093480,Chow; Bennett,9,0,32,23
1658110454370,MATH 142A,B03,093481,Chow; Bennett,8,0,32,24
1658110454370,MATH 142A,B04,093558,Chow; Bennett,14,0,32,18
1658110454370,MATH 142A,B05,093559,Chow; Bennett,7,0,32,25
1658110460398,MATH 193A,A01,083224,Rotar; Vladimir,9,0,34,25
1658110460398,MATH 193A,A02,083225,Rotar; Vladimir,11,0,34,23
1658110460398,MATH 193A,A03,083781,Rotar; Vladimir,5,0,34,29
1658110460398,MATH 193A,A04,083782,Rotar; Vladimir,12,0,34,22
1658110460398,MATH 193A,A05,093482,Rotar; Vladimir,11,0,34,23
1658110466424,MATH 197,001,091859,McAuley; Julian John,9999,0,9999,0
1658110466424,MATH 197,002,095566,Kedlaya; Kiran S.,9997,0,9999,2
1658110466424,MATH 197,003,095567,Xiao; Ming,9999,0,9999,0
1658110466424,MATH 197,004,095571,Perols; Johan Lars,9998,0,9999,1
1658110473489,COGS 9,A01,083615,Shannon; Kyle Michael,11,0,75,64
1658110479518,COGS 11,A01,083617,Boyle; Mary E. T.,23,0,48,25
1658110485544,COGS 13,A01,083071,Bastos; Amalia Pinkusfeld,12,0,71,59
1658110491566,COGS 14A,A01,092681,Semenuks; Arturs,5,1,100,95
1658110497593,COGS 14B,A01,083073,Cheng; Tzu-Han,7,0,63,56
1658110503624,COGS 17,A01,092677,Semenuks; Arturs,7,0,81,74
1658110509649,COGS 100,A01,083619,Allen; Michael Gordon,17,0,70,53
1658110515675,COGS 101A,A01,083621,Davis; Joshua Daniel,9,0,68,59
1658110521699,COGS 101B,A01,091572,Allen; Michael Gordon,14,0,65,51
1658110527727,COGS 101C,A01,083625,Delgado; Tania,17,0,35,18
1658110533751,COGS 107A,A01,083627,Boyle; Mary E. T.,14,0,60,46
1658110539778,COGS 118A,A01,083075,Gupta; Anjum,21,0,76,55
1658110545801,CSE 3,A50,083646,Miranda; Gregory Joseph,24,0,50,26
1658110551825,CSE 8A,A50,083650,Miranda; Gregory Joseph,17,1,56,39
1658110557847,CSE 11,A01,083080,Cao; Yingjun,7,15,40,33
1658110563875,CSE 12,A01,083652,Krause-Levy; Sophia Louisa,30,1,120,90
1658110569901,CSE 15L,A01,083654,Morris; Justin Loren,9,0,50,41
1658110569901,CSE 15L,A02,083655,Morris; Justin Loren,11,0,50,39
1658110575931,CSE 20,A01,083657,Tran; Khoa Dang,39,0,80,41
1658110581958,CSE 21,A01,095574,Bach; Quang Tran,23,0,48,25
1658110587982,CSE 30,A01,083084,Eldon; John,8,0,80,72
1658110587982,CSE 30,B01,095061,Bhaskar; Nishant,9,0,50,41
1658110594005,CSE 100,A01,083659,Cao; Yingjun,5,4,70,65
1658110600041,CSE 134B,A01,083661,Powell; Thomas Allan,25,0,100,75
1658110606064,CSE 140,A01,083663,Gungor; Onat,17,0,85,68
1658110612087,CSE 140L,A01,083088,Eldon; John,23,0,100,77
1658110618122,CSE 175,A01,083665,Kumar; Rakesh,3,0,25,22
1658110624146,CSE 190,A00,092507,Dubnov; Shlomo,8,0,20,12
1658110630169,ECE 45,A01,083139,Congero; Spencer William,7,0,75,68
1658110636194,ECE 65,A50,083695,Saad; Andrew S,12,0,30,18
1658110636194,ECE 65,A51,095125,Saad; Andrew S,24,0,26,2
1658110642220,ECE 109,A01,091882,Touri; Behrouz,21,0,70,49
1658110648244,ECE 180,A00,083140,Abi Samra; Nicholas Camill,1,0,30,29
1658110648244,ECE 180,B00,083141,Abi Samra; Nicholas Camill,0,0,30,30
1658110654266,MATH 10A,A01,083735,Patchell; Gregory David,2,0,30,28
1658110654266,MATH 10A,A02,083736,Patchell; Gregory David,20,0,30,10
1658110654266,MATH 10A,A03,083737,Patchell; Gregory David,16,0,30,14
1658110660296,MATH 10B,A01,083207,Lim; Seonhee,9,0,34,25
1658110660296,MATH 10B,A02,083208,Lim; Seonhee,10,0,35,25
1658110660296,MATH 10B,A03,093472,Lim; Seonhee,7,0,34,27
1658110660296,MATH 10B,B01,083739,Sinha; Shubham,14,0,30,16
1658110666322,MATH 18,A01,083743,Cinel; Cameron Alexander,9,0,30,21
1658110666322,MATH 18,A02,083744,Cinel; Cameron Alexander,18,0,30,12
1658110666322,MATH 18,A03,083745,Cinel; Cameron Alexander,10,0,30,20
1658110666322,MATH 18,B01,083748,Rideout; David Porter,5,0,37,32
1658110666322,MATH 18,B02,083749,Rideout; David Porter,5,0,36,31
1658110666322,MATH 18,B03,083750,Rideout; David Porter,3,0,37,34
1658110666322,MATH 18,B04,083751,Rideout; David Porter,7,0,36,29
1658110666322,MATH 18,B05,093473,Rideout; David Porter,7,0,36,29
1658110666322,MATH 18,B06,093474,Rideout; David Porter,6,0,36,30
1658110672343,MATH 20A,A01,083754,Zheng; Zequn,14,0,40,26
1658110678366,MATH 20B,A01,083756,Briones; Jor-el Thomas Caparas,4,0,36,32
1658110678366,MATH 20B,A02,083757,Briones; Jor-el Thomas Caparas,1,0,36,35
1658110678366,MATH 20B,A03,093475,Briones; Jor-el Thomas Caparas,3,0,36,33
1658110684389,MATH 20C,A01,083760,Briones; Jor-el Thomas Caparas,1,0,35,34
1658110684389,MATH 20C,A02,083761,Briones; Jor-el Thomas Caparas,8,0,35,27
1658110684389,MATH 20C,A03,093476,Briones; Jor-el Thomas Caparas,0,1,36,36
1658110684389,MATH 20C,B01,083762,Bach; Quang Tran,1,0,30,29
1658110690417,MATH 20D,A01,083765,Tran; Brian Kha,5,0,30,25
1658110690417,MATH 20D,A02,083766,Tran; Brian Kha,5,0,30,25
1658110690417,MATH 20D,A03,083767,Tran; Brian Kha,6,0,30,24
1658110696440,MATH 20E,A01,083771,Ganguly; Soumya,12,0,32,20
1658110696440,MATH 20E,A02,083772,Ganguly; Soumya,7,0,32,25
1658110696440,MATH 20E,B01,083773,Ciotti; Benjamin,20,0,35,15
1658110696440,MATH 20E,B02,083774,Ciotti; Benjamin,18,0,35,17
1658110702464,MATH 103A,A01,083777,Greenfeld; Be'Eri,6,0,36,30
1658110702464,MATH 103A,A02,083778,Greenfeld; Be'Eri,5,0,36,31
1658110702464,MATH 103A,A03,093561,Greenfeld; Be'Eri,7,0,36,29
1658110702464,MATH 103A,B01,083779,Greenfeld; Be'Eri,8,0,36,28
1658110702464,MATH 103A,B02,083780,Greenfeld; Be'Eri,4,0,36,32
1658110702464,MATH 103A,B03,093562,Greenfeld; Be'Eri,3,0,36,33
1658110708490,MATH 105,A01,085443,Carter; Anne Toulson,15,0,35,20
1658110708490,MATH 105,A02,093477,Carter; Anne Toulson,20,0,35,15
1658110714520,MATH 109,A01,083213,Ganzberger; Geoffrey Michael,3,0,34,31
1658110714520,MATH 109,A02,083214,Ganzberger; Geoffrey Michael,4,0,34,30
1658110714520,MATH 109,A03,093478,Ganzberger; Geoffrey Michael,2,0,34,32
1658110714520,MATH 109,B01,083215,Ganzberger; Geoffrey Michael,3,0,32,29
1658110714520,MATH 109,B02,083216,Ganzberger; Geoffrey Michael,3,0,32,29
1658110714520,MATH 109,B03,093479,Ganzberger; Geoffrey Michael,8,0,32,24
1658110720549,MATH 142A,A01,083219,Chow; Bennett,7,0,32,25
1658110720549,MATH 142A,A02,083220,Chow; Bennett,10,0,32,22
1658110720549,MATH 142A,A03,093480,Chow; Bennett,9,0,32,23
1658110720549,MATH 142A,B03,093481,Chow; Bennett,8,0,32,24
1658110720549,MATH 142A,B04,093558,Chow; Bennett,14,0,32,18
1658110720549,MATH 142A,B05,093559,Chow; Bennett,7,0,32,25
1658110726586,MATH 193A,A01,083224,Rotar; Vladimir,9,0,34,25
1658110726586,MATH 193A,A02,083225,Rotar; Vladimir,11,0,34,23
1658110726586,MATH 193A,A03,083781,Rotar; Vladimir,5,0,34,29
1658110726586,MATH 193A,A04,083782,Rotar; Vladimir,12,0,34,22
1658110726586,MATH 193A,A05,093482,Rotar; Vladimir,11,0,34,23
1658110732609,MATH 197,001,091859,McAuley; Julian John,9999,0,9999,0
1658110732609,MATH 197,002,095566,Kedlaya; Kiran S.,9997,0,9999,2
1658110732609,MATH 197,003,095567,Xiao; Ming,9999,0,9999,0
1658110732609,MATH 197,004,095571,Perols; Johan Lars,9998,0,9999,1
1658110739662,COGS 9,A01,083615,Shannon; Kyle Michael,11,0,75,64
1658110745690,COGS 11,A01,083617,Boyle; Mary E. T.,23,0,48,25
1658110751718,COGS 13,A01,083071,Bastos; Amalia Pinkusfeld,12,0,71,59
1658110757741,COGS 14A,A01,092681,Semenuks; Arturs,5,1,100,95
1658110763775,COGS 14B,A01,083073,Cheng; Tzu-Han,7,0,63,56
1658110769800,COGS 17,A01,092677,Semenuks; Arturs,7,0,81,74
1658110775823,COGS 100,A01,083619,Allen; Michael Gordon,17,0,70,53
1658110781849,COGS 101A,A01,083621,Davis; Joshua Daniel,9,0,68,59
1658110787876,COGS 101B,A01,091572,Allen; Michael Gordon,14,0,65,51
1658110793900,COGS 101C,A01,083625,Delgado; Tania,17,0,35,18
1658110799928,COGS 107A,A01,083627,Boyle; Mary E. T.,14,0,60,46
1658110805956,COGS 118A,A01,083075,Gupta; Anjum,21,0,76,55
1658110811982,CSE 3,A50,083646,Miranda; Gregory Joseph,24,0,50,26
1658110818007,CSE 8A,A50,083650,Miranda; Gregory Joseph,17,1,56,39
1658110824034,CSE 11,A01,083080,Cao; Yingjun,7,15,40,33
1658110830058,CSE 12,A01,083652,Krause-Levy; Sophia Louisa,30,1,120,90
1658110836082,CSE 15L,A01,083654,Morris; Justin Loren,9,0,50,41
1658110836082,CSE 15L,A02,083655,Morris; Justin Loren,11,0,50,39
1658110842106,CSE 20,A01,083657,Tran; Khoa Dang,39,0,80,41
1658110848130,CSE 21,A01,095574,Bach; Quang Tran,23,0,48,25
1658110854154,CSE 30,A01,083084,Eldon; John,8,0,80,72
1658110854154,CSE 30,B01,095061,Bhaskar; Nishant,9,0,50,41
1658110860189,CSE 100,A01,083659,Cao; Yingjun,5,4,70,65
1658110866212,CSE 134B,A01,083661,Powell; Thomas Allan,25,0,100,75
1658110872235,CSE 140,A01,083663,Gungor; Onat,17,0,85,68
1658110878270,CSE 140L,A01,083088,Eldon; John,23,0,100,77
1658110884296,CSE 175,A01,083665,Kumar; Rakesh,3,0,25,22
1658110890319,CSE 190,A00,092507,Dubnov; Shlomo,8,0,20,12
1658110896343,ECE 45,A01,083139,Congero; Spencer William,7,0,75,68
1658110902366,ECE 65,A50,083695,Saad; Andrew S,12,0,30,18
1658110902366,ECE 65,A51,095125,Saad; Andrew S,24,0,26,2
1658110908392,ECE 109,A01,091882,Touri; Behrouz,21,0,70,49
1658110914418,ECE 180,A00,083140,Abi Samra; Nicholas Camill,1,0,30,29
1658110914418,ECE 180,B00,083141,Abi Samra; Nicholas Camill,0,0,30,30
1658110920443,MATH 10A,A01,083735,Patchell; Gregory David,2,0,30,28
1658110920443,MATH 10A,A02,083736,Patchell; Gregory David,20,0,30,10
1658110920443,MATH 10A,A03,083737,Patchell; Gregory David,16,0,30,14
1658110926468,MATH 10B,A01,083207,Lim; Seonhee,9,0,34,25
1658110926468,MATH 10B,A02,083208,Lim; Seonhee,10,0,35,25
1658110926468,MATH 10B,A03,093472,Lim; Seonhee,7,0,34,27
1658110926468,MATH 10B,B01,083739,Sinha; Shubham,14,0,30,16
1658110932503,MATH 18,A01,083743,Cinel; Cameron Alexander,9,0,30,21
1658110932503,MATH 18,A02,083744,Cinel; Cameron Alexander,18,0,30,12
1658110932503,MATH 18,A03,083745,Cinel; Cameron Alexander,10,0,30,20
1658110932503,MATH 18,B01,083748,Rideout; David Porter,5,0,37,32
1658110932503,MATH 18,B02,083749,Rideout; David Porter,5,0,36,31
1658110932503,MATH 18,B03,083750,Rideout; David Porter,3,0,37,34
1658110932503,MATH 18,B04,083751,Rideout; David Porter,7,0,36,29
1658110932503,MATH 18,B05,093473,Rideout; David Porter,7,0,36,29
1658110932503,MATH 18,B06,093474,Rideout; David Porter,6,0,36,30
1658110938526,MATH 20A,A01,083754,Zheng; Zequn,14,0,40,26
1658110944554,MATH 20B,A01,083756,Briones; Jor-el Thomas Caparas,4,0,36,32
1658110944554,MATH 20B,A02,083757,Briones; Jor-el Thomas Caparas,1,0,36,35
1658110944554,MATH 20B,A03,093475,Briones; Jor-el Thomas Caparas,3,0,36,33
1658110950583,MATH 20C,A01,083760,Briones; Jor-el Thomas Caparas,1,0,35,34
1658110950583,MATH 20C,A02,083761,Briones; Jor-el Thomas Caparas,8,0,35,27
1658110950583,MATH 20C,A03,093476,Briones; Jor-el Thomas Caparas,0,1,36,36
1658110950583,MATH 20C,B01,083762,Bach; Quang Tran,1,0,30,29
1658110956606,MATH 20D,A01,083765,Tran; Brian Kha,5,0,30,25
1658110956606,MATH 20D,A02,083766,Tran; Brian Kha,5,0,30,25
1658110956606,MATH 20D,A03,083767,Tran; Brian Kha,6,0,30,24
1658110962634,MATH 20E,A01,083771,Ganguly; Soumya,12,0,32,20
1658110962634,MATH 20E,A02,083772,Ganguly; Soumya,7,0,32,25
1658110962634,MATH 20E,B01,083773,Ciotti; Benjamin,20,0,35,15
1658110962634,MATH 20E,B02,083774,Ciotti; Benjamin,18,0,35,17
1658110968661,MATH 103A,A01,083777,Greenfeld; Be'Eri,6,0,36,30
1658110968661,MATH 103A,A02,083778,Greenfeld; Be'Eri,5,0,36,31
1658110968661,MATH 103A,A03,093561,Greenfeld; Be'Eri,7,0,36,29
1658110968661,MATH 103A,B01,083779,Greenfeld; Be'Eri,8,0,36,28
1658110968661,MATH 103A,B02,083780,Greenfeld; Be'Eri,4,0,36,32
1658110968661,MATH 103A,B03,093562,Greenfeld; Be'Eri,3,0,36,33
1658110974688,MATH 105,A01,085443,Carter; Anne Toulson,15,0,35,20
1658110974688,MATH 105,A02,093477,Carter; Anne Toulson,20,0,35,15
1658110980712,MATH 109,A01,083213,Ganzberger; Geoffrey Michael,3,0,34,31
1658110980712,MATH 109,A02,083214,Ganzberger; Geoffrey Michael,4,0,34,30
1658110980712,MATH 109,A03,093478,Ganzberger; Geoffrey Michael,2,0,34,32
1658110980712,MATH 109,B01,083215,Ganzberger; Geoffrey Michael,3,0,32,29
1658110980712,MATH 109,B02,083216,Ganzberger; Geoffrey Michael,3,0,32,29
1658110980712,MATH 109,B03,093479,Ganzberger; Geoffrey Michael,8,0,32,24
1658110986814,MATH 142A,A01,083219,Chow; Bennett,7,0,32,25
1658110986814,MATH 142A,A02,083220,Chow; Bennett,10,0,32,22
1658110986814,MATH 142A,A03,093480,Chow; Bennett,9,0,32,23
1658110986814,MATH 142A,B03,093481,Chow; Bennett,8,0,32,24
1658110986814,MATH 142A,B04,093558,Chow; Bennett,14,0,32,18
1658110986814,MATH 142A,B05,093559,Chow; Bennett,7,0,32,25
1658110992854,MATH 193A,A01,083224,Rotar; Vladimir,9,0,34,25
1658110992854,MATH 193A,A02,083225,Rotar; Vladimir,11,0,34,23
1658110992854,MATH 193A,A03,083781,Rotar; Vladimir,5,0,34,29
1658110992854,MATH 193A,A04,083782,Rotar; Vladimir,12,0,34,22
1658110992854,MATH 193A,A05,093482,Rotar; Vladimir,11,0,34,23
1658110998878,MATH 197,001,091859,McAuley; Julian John,9999,0,9999,0
1658110998878,MATH 197,002,095566,Kedlaya; Kiran S.,9997,0,9999,2
1658110998878,MATH 197,003,095567,Xiao; Ming,9999,0,9999,0
1658110998878,MATH 197,004,095571,Perols; Johan Lars,9998,0,9999,1
1658111005950,COGS 9,A01,083615,Shannon; Kyle Michael,11,0,75,64
1658111011973,COGS 11,A01,083617,Boyle; Mary E. T.,23,0,48,25
1658111018010,COGS 13,A01,083071,Bastos; Amalia Pinkusfeld,12,0,71,59
1658111024036,COGS 14A,A01,092681,Semenuks; Arturs,5,1,100,95
1658111030061,COGS 14B,A01,083073,Cheng; Tzu-Han,7,0,63,56
1658111036085,COGS 17,A01,092677,Semenuks; Arturs,7,0,81,74
1658111042111,COGS 100,A01,083619,Allen; Michael Gordon,17,0,70,53
1658111048139,COGS 101A,A01,083621,Davis; Joshua Daniel,9,0,68,59
1658111054163,COGS 101B,A01,091572,Allen; Michael Gordon,14,0,65,51
1658111060187,COGS 101C,A01,083625,Delgado; Tania,17,0,35,18
1658111066210,COGS 107A,A01,083627,Boyle; Mary E. T.,14,0,60,46
1658111072247,COGS 118A,A01,083075,Gupta; Anjum,21,0,76,55
1658111078271,CSE 3,A50,083646,Miranda; Gregory Joseph,24,0,50,26
1658111084301,CSE 8A,A50,083650,Miranda; Gregory Joseph,17,1,56,39
1658111090337,CSE 11,A01,083080,Cao; Yingjun,7,15,40,33
1658111096362,CSE 12,A01,083652,Krause-Levy; Sophia Louisa,30,1,120,90
1658111102391,CSE 15L,A01,083654,Morris; Justin Loren,9,0,50,41
1658111102391,CSE 15L,A02,083655,Morris; Justin Loren,11,0,50,39
1658111108413,CSE 20,A01,083657,Tran; Khoa Dang,39,0,80,41
1658111114439,CSE 21,A01,095574,Bach; Quang Tran,23,0,48,25
1658111120466,CSE 30,A01,083084,Eldon; John,8,0,80,72
1658111120466,CSE 30,B01,095061,Bhaskar; Nishant,9,0,50,41
1658111126492,CSE 100,A01,083659,Cao; Yingjun,5,4,70,65
1658111132519,CSE 134B,A01,083661,Powell; Thomas Allan,25,0,100,75
1658111138553,CSE 140,A01,083663,Gungor; Onat,17,0,85,68
1658111144576,CSE 140L,A01,083088,Eldon; John,23,0,100,77
1658111150600,CSE 175,A01,083665,Kumar; Rakesh,3,0,25,22
1658111156622,CSE 190,A00,092507,Dubnov; Shlomo,8,0,20,12
1658111162645,ECE 45,A01,083139,Congero; Spencer William,7,0,75,68
1658111168672,ECE 65,A50,083695,Saad; Andrew S,12,0,30,18
1658111168672,ECE 65,A51,095125,Saad; Andrew S,24,0,26,2
1658111174695,ECE 109,A01,091882,Touri; Behrouz,21,0,70,49
1658111180718,ECE 180,A00,083140,Abi Samra; Nicholas Camill,1,0,30,29
1658111180718,ECE 180,B00,083141,Abi Samra; Nicholas Camill,0,0,30,30
1658111186741,MATH 10A,A01,083735,Patchell; Gregory David,2,0,30,28
1658111186741,MATH 10A,A02,083736,Patchell; Gregory David,20,0,30,10
1658111186741,MATH 10A,A03,083737,Patchell; Gregory David,16,0,30,14
1658111192766,MATH 10B,A01,083207,Lim; Seonhee,9,0,34,25
1658111192766,MATH 10B,A02,083208,Lim; Seonhee,10,0,35,25
1658111192766,MATH 10B,A03,093472,Lim; Seonhee,7,0,34,27
1658111192766,MATH 10B,B01,083739,Sinha; Shubham,14,0,30,16
1658111198814,MATH 18,A01,083743,Cinel; Cameron Alexander,9,0,30,21
1658111198814,MATH 18,A02,083744,Cinel; Cameron Alexander,18,0,30,12
1658111198814,MATH 18,A03,083745,Cinel; Cameron Alexander,10,0,30,20
1658111198814,MATH 18,B01,083748,Rideout; David Porter,5,0,37,32
1658111198814,MATH 18,B02,083749,Rideout; David Porter,5,0,36,31
1658111198814,MATH 18,B03,083750,Rideout; David Porter,3,0,37,34
1658111198814,MATH 18,B04,083751,Rideout; David Porter,7,0,36,29
1658111198814,MATH 18,B05,093473,Rideout; David Porter,7,0,36,29
1658111198814,MATH 18,B06,093474,Rideout; David Porter,6,0,36,30
1658111204837,MATH 20A,A01,083754,Zheng; Zequn,14,0,40,26
1658111210864,MATH 20B,A01,083756,Briones; Jor-el Thomas Caparas,4,0,36,32
1658111210864,MATH 20B,A02,083757,Briones; Jor-el Thomas Caparas,1,0,36,35
1658111210864,MATH 20B,A03,093475,Briones; Jor-el Thomas Caparas,3,0,36,33
1658111216888,MATH 20C,A01,083760,Briones; Jor-el Thomas Caparas,1,0,35,34
1658111216888,MATH 20C,A02,083761,Briones; Jor-el Thomas Caparas,8,0,35,27
1658111216888,MATH 20C,A03,093476,Briones; Jor-el Thomas Caparas,0,1,36,36
1658111216888,MATH 20C,B01,083762,Bach; Quang Tran,1,0,30,29
1658111222912,MATH 20D,A01,083765,Tran; Brian Kha,5,0,30,25
1658111222912,MATH 20D,A02,083766,Tran; Brian Kha,5,0,30,25
1658111222912,MATH 20D,A03,083767,Tran; Brian Kha,6,0,30,24
1658111228936,MATH 20E,A01,083771,Ganguly; Soumya,12,0,32,20
1658111228936,MATH 20E,A02,083772,Ganguly; Soumya,7,0,32,25
1658111228936,MATH 20E,B01,083773,Ciotti; Benjamin,20,0,35,15
1658111228936,MATH 20E,B02,083774,Ciotti; Benjamin,18,0,35,17
1658111234962,MATH 103A,A01,083777,Greenfeld; Be'Eri,6,0,36,30
1658111234962,MATH 103A,A02,083778,Greenfeld; Be'Eri,5,0,36,31
1658111234962,MATH 103A,A03,093561,Greenfeld; Be'Eri,7,0,36,29
1658111234962,MATH 103A,B01,083779,Greenfeld; Be'Eri,8,0,36,28
1658111234962,MATH 103A,B02,083780,Greenfeld; Be'Eri,4,0,36,32
1658111234962,MATH 103A,B03,093562,Greenfeld; Be'Eri,3,0,36,33
1658111240985,MATH 105,A01,085443,Carter; Anne Toulson,15,0,35,20
1658111240985,MATH 105,A02,093477,Carter; Anne Toulson,20,0,35,15
1658111247010,MATH 109,A01,083213,Ganzberger; Geoffrey Michael,3,0,34,31
1658111247010,MATH 109,A02,083214,Ganzberger; Geoffrey Michael,4,0,34,30
1658111247010,MATH 109,A03,093478,Ganzberger; Geoffrey Michael,2,0,34,32
1658111247010,MATH 109,B01,083215,Ganzberger; Geoffrey Michael,3,0,32,29
1658111247010,MATH 109,B02,083216,Ganzberger; Geoffrey Michael,3,0,32,29
1658111247010,MATH 109,B03,093479,Ganzberger; Geoffrey Michael,8,0,32,24
1658111253036,MATH 142A,A01,083219,Chow; Bennett,7,0,32,25
1658111253036,MATH 142A,A02,083220,Chow; Bennett,10,0,32,22
1658111253036,MATH 142A,A03,093480,Chow; Bennett,9,0,32,23
1658111253036,MATH 142A,B03,093481,Chow; Bennett,8,0,32,24
1658111253036,MATH 142A,B04,093558,Chow; Bennett,14,0,32,18
1658111253036,MATH 142A,B05,093559,Chow; Bennett,7,0,32,25
1658111259076,MATH 193A,A01,083224,Rotar; Vladimir,9,0,34,25
1658111259076,MATH 193A,A02,083225,Rotar; Vladimir,11,0,34,23
1658111259076,MATH 193A,A03,083781,Rotar; Vladimir,5,0,34,29
1658111259076,MATH 193A,A04,083782,Rotar; Vladimir,12,0,34,22
1658111259076,MATH 193A,A05,093482,Rotar; Vladimir,11,0,34,23
1658111265100,MATH 197,001,091859,McAuley; Julian John,9999,0,9999,0
1658111265100,MATH 197,002,095566,Kedlaya; Kiran S.,9997,0,9999,2
1658111265100,MATH 197,003,095567,Xiao; Ming,9999,0,9999,0
1658111265100,MATH 197,004,095571,Perols; Johan Lars,9998,0,9999,1
1658111272157,COGS 9,A01,083615,Shannon; Kyle Michael,11,0,75,64
1658111278183,COGS 11,A01,083617,Boyle; Mary E. T.,23,0,48,25
1658111284209,COGS 13,A01,083071,Bastos; Amalia Pinkusfeld,12,0,71,59
1658111290238,COGS 14A,A01,092681,Semenuks; Arturs,5,1,100,95
1658111296266,COGS 14B,A01,083073,Cheng; Tzu-Han,7,0,63,56
1658111302294,COGS 17,A01,092677,Semenuks; Arturs,7,0,81,74
1658111308316,COGS 100,A01,083619,Allen; Michael Gordon,17,0,70,53
1658111314344,COGS 101A,A01,083621,Davis; Joshua Daniel,9,0,68,59
1658111320368,COGS 101B,A01,091572,Allen; Michael Gordon,14,0,65,51
1658111326394,COGS 101C,A01,083625,Delgado; Tania,17,0,35,18
1658111332417,COGS 107A,A01,083627,Boyle; Mary E. T.,14,0,60,46
1658111338444,COGS 118A,A01,083075,Gupta; Anjum,21,0,76,55
1658111344471,CSE 3,A50,083646,Miranda; Gregory Joseph,24,0,50,26
1658111350495,CSE 8A,A50,083650,Miranda; Gregory Joseph,17,1,56,39
1658111356517,CSE 11,A01,083080,Cao; Yingjun,7,15,40,33
1658111362542,CSE 12,A01,083652,Krause-Levy; Sophia Louisa,30,1,120,90
1658111368563,CSE 15L,A01,083654,Morris; Justin Loren,9,0,50,41
1658111368563,CSE 15L,A02,083655,Morris; Justin Loren,11,0,50,39
1658111374591,CSE 20,A01,083657,Tran; Khoa Dang,39,0,80,41
1658111380613,CSE 21,A01,095574,Bach; Quang Tran,23,0,48,25
1658111386638,CSE 30,A01,083084,Eldon; John,8,0,80,72
1658111386638,CSE 30,B01,095061,Bhaskar; Nishant,9,0,50,41
1658111392663,CSE 100,A01,083659,Cao; Yingjun,5,4,70,65
1658111398700,CSE 134B,A01,083661,Powell; Thomas Allan,25,0,100,75
1658111404727,CSE 140,A01,083663,Gungor; Onat,17,0,85,68
1658111410750,CSE 140L,A01,083088,Eldon; John,23,0,100,77
1658111416776,CSE 175,A01,083665,Kumar; Rakesh,3,0,25,22
1658111422798,CSE 190,A00,092507,Dubnov; Shlomo,8,0,20,12
1658111428831,ECE 45,A01,083139,Congero; Spencer William,7,0,75,68
1658111434864,ECE 65,A50,083695,Saad; Andrew S,12,0,30,18
1658111434864,ECE 65,A51,095125,Saad; Andrew S,24,0,26,2
1658111440887,ECE 109,A01,091882,Touri; Behrouz,21,0,70,49
1658111446913,ECE 180,A00,083140,Abi Samra; Nicholas Camill,1,0,30,29
1658111446913,ECE 180,B00,083141,Abi Samra; Nicholas Camill,0,0,30,30
1658111452936,MATH 10A,A01,083735,Patchell; Gregory David,2,0,30,28
1658111452936,MATH 10A,A02,083736,Patchell; Gregory David,20,0,30,10
1658111452936,MATH 10A,A03,083737,Patchell; Gregory David,16,0,30,14
1658111458960,MATH 10B,A01,083207,Lim; Seonhee,9,0,34,25
1658111458960,MATH 10B,A02,083208,Lim; Seonhee,10,0,35,25
1658111458960,MATH 10B,A03,093472,Lim; Seonhee,7,0,34,27
1658111458960,MATH 10B,B01,083739,Sinha; Shubham,14,0,30,16
1658111464982,MATH 18,A01,083743,Cinel; Cameron Alexander,9,0,30,21
1658111464982,MATH 18,A02,083744,Cinel; Cameron Alexander,18,0,30,12
1658111464982,MATH 18,A03,083745,Cinel; Cameron Alexander,10,0,30,20
1658111464982,MATH 18,B01,083748,Rideout; David Porter,5,0,37,32
1658111464982,MATH 18,B02,083749,Rideout; David Porter,5,0,36,31
1658111464982,MATH 18,B03,083750,Rideout; David Porter,3,0,37,34
1658111464982,MATH 18,B04,083751,Rideout; David Porter,7,0,36,29
1658111464982,MATH 18,B05,093473,Rideout; David Porter,7,0,36,29
1658111464982,MATH 18,B06,093474,Rideout; David Porter,6,0,36,30
1658111471006,MATH 20A,A01,083754,Zheng; Zequn,14,0,40,26
1658111477034,MATH 20B,A01,083756,Briones; Jor-el Thomas Caparas,4,0,36,32
1658111477034,MATH 20B,A02,083757,Briones; Jor-el Thomas Caparas,1,0,36,35
1658111477034,MATH 20B,A03,093475,Briones; Jor-el Thomas Caparas,3,0,36,33
1658111483062,MATH 20C,A01,083760,Briones; Jor-el Thomas Caparas,1,0,35,34
1658111483062,MATH 20C,A02,083761,Briones; Jor-el Thomas Caparas,8,0,35,27
1658111483062,MATH 20C,A03,093476,Briones; Jor-el Thomas Caparas,0,1,36,36
1658111483062,MATH 20C,B01,083762,Bach; Quang Tran,1,0,30,29
1658111489087,MATH 20D,A01,083765,Tran; Brian Kha,5,0,30,25
1658111489087,MATH 20D,A02,083766,Tran; Brian Kha,5,0,30,25
1658111489087,MATH 20D,A03,083767,Tran; Brian Kha,6,0,30,24
1658111495115,MATH 20E,A01,083771,Ganguly; Soumya,12,0,32,20
1658111495115,MATH 20E,A02,083772,Ganguly; Soumya,7,0,32,25
1658111495115,MATH 20E,B01,083773,Ciotti; Benjamin,20,0,35,15
1658111495115,MATH 20E,B02,083774,Ciotti; Benjamin,18,0,35,17
1658111501139,MATH 103A,A01,083777,Greenfeld; Be'Eri,6,0,36,30
1658111501139,MATH 103A,A02,083778,Greenfeld; Be'Eri,5,0,36,31
1658111501139,MATH 103A,A03,093561,Greenfeld; Be'Eri,7,0,36,29
1658111501139,MATH 103A,B01,083779,Greenfeld; Be'Eri,8,0,36,28
1658111501139,MATH 103A,B02,083780,Greenfeld; Be'Eri,4,0,36,32
1658111501139,MATH 103A,B03,093562,Greenfeld; Be'Eri,3,0,36,33
1658111507163,MATH 105,A01,085443,Carter; Anne Toulson,15,0,35,20
1658111507163,MATH 105,A02,093477,Carter; Anne Toulson,20,0,35,15
1658111513190,MATH 109,A01,083213,Ganzberger; Geoffrey Michael,3,0,34,31
1658111513190,MATH 109,A02,083214,Ganzberger; Geoffrey Michael,4,0,34,30
1658111513190,MATH 109,A03,093478,Ganzberger; Geoffrey Michael,2,0,34,32
1658111513190,MATH 109,B01,083215,Ganzberger; Geoffrey Michael,3,0,32,29
1658111513190,MATH 109,B02,083216,Ganzberger; Geoffrey Michael,3,0,32,29
1658111513190,MATH 109,B03,093479,Ganzberger; Geoffrey Michael,8,0,32,24
1658111519214,MATH 142A,A01,083219,Chow; Bennett,7,0,32,25
1658111519214,MATH 142A,A02,083220,Chow; Bennett,10,0,32,22
1658111519214,MATH 142A,A03,093480,Chow; Bennett,9,0,32,23
1658111519214,MATH 142A,B03,093481,Chow; Bennett,8,0,32,24
1658111519214,MATH 142A,B04,093558,Chow; Bennett,14,0,32,18
1658111519214,MATH 142A,B05,093559,Chow; Bennett,7,0,32,25
1658111525248,MATH 193A,A01,083224,Rotar; Vladimir,9,0,34,25
1658111525248,MATH 193A,A02,083225,Rotar; Vladimir,11,0,34,23
1658111525248,MATH 193A,A03,083781,Rotar; Vladimir,5,0,34,29
1658111525248,MATH 193A,A04,083782,Rotar; Vladimir,12,0,34,22
1658111525248,MATH 193A,A05,093482,Rotar; Vladimir,11,0,34,23
1658111531271,MATH 197,001,091859,McAuley; Julian John,9999,0,9999,0
1658111531271,MATH 197,002,095566,Kedlaya; Kiran S.,9997,0,9999,2
1658111531271,MATH 197,003,095567,Xiao; Ming,9999,0,9999,0
1658111531271,MATH 197,004,095571,Perols; Johan Lars,9998,0,9999,1
1658111538323,COGS 9,A01,083615,Shannon; Kyle Michael,11,0,75,64
1658111544349,COGS 11,A01,083617,Boyle; Mary E. T.,23,0,48,25
1658111550370,COGS 13,A01,083071,Bastos; Amalia Pinkusfeld,12,0,71,59
1658111556397,COGS 14A,A01,092681,Semenuks; Arturs,5,1,100,95
1658111562418,COGS 14B,A01,083073,Cheng; Tzu-Han,7,0,63,56
1658111568442,COGS 17,A01,092677,Semenuks; Arturs,7,0,81,74
1658111574466,COGS 100,A01,083619,Allen; Michael Gordon,17,0,70,53
1658111580570,COGS 101A,A01,083621,Davis; Joshua Daniel,9,0,68,59
1658111586595,COGS 101B,A01,091572,Allen; Michael Gordon,14,0,65,51
1658111592616,COGS 101C,A01,083625,Delgado; Tania,17,0,35,18
1658111598638,COGS 107A,A01,083627,Boyle; Mary E. T.,14,0,60,46
1658111604671,COGS 118A,A01,083075,Gupta; Anjum,21,0,76,55
1658111610695,CSE 3,A50,083646,Miranda; Gregory Joseph,24,0,50,26
1658111616736,CSE 8A,A50,083650,Miranda; Gregory Joseph,17,1,56,39
1658111622760,CSE 11,A01,083080,Cao; Yingjun,7,15,40,33
1658111628787,CSE 12,A01,083652,Krause-Levy; Sophia Louisa,30,1,120,90
1658111634810,CSE 15L,A01,083654,Morris; Justin Loren,9,0,50,41
1658111634810,CSE 15L,A02,083655,Morris; Justin Loren,11,0,50,39
1658111640833,CSE 20,A01,083657,Tran; Khoa Dang,39,0,80,41
1658111646859,CSE 21,A01,095574,Bach; Quang Tran,23,0,48,25
1658111652883,CSE 30,A01,083084,Eldon; John,8,0,80,72
1658111652883,CSE 30,B01,095061,Bhaskar; Nishant,9,0,50,41
1658111658911,CSE 100,A01,083659,Cao; Yingjun,5,4,70,65
1658111664933,CSE 134B,A01,083661,Powell; Thomas Allan,25,0,100,75
1658111670959,CSE 140,A01,083663,Gungor; Onat,17,0,85,68
1658111676985,CSE 140L,A01,083088,Eldon; John,23,0,100,77
1658111683008,CSE 175,A01,083665,Kumar; Rakesh,3,0,25,22
1658111689031,CSE 190,A00,092507,Dubnov; Shlomo,8,0,20,12
1658111695057,ECE 45,A01,083139,Congero; Spencer William,7,0,75,68
1658111701081,ECE 65,A50,083695,Saad; Andrew S,12,0,30,18
1658111701081,ECE 65,A51,095125,Saad; Andrew S,24,0,26,2
1658111707104,ECE 109,A01,091882,Touri; Behrouz,21,0,70,49
1658111713133,ECE 180,A00,083140,Abi Samra; Nicholas Camill,1,0,30,29
1658111713133,ECE 180,B00,083141,Abi Samra; Nicholas Camill,0,0,30,30
1658111719155,MATH 10A,A01,083735,Patchell; Gregory David,2,0,30,28
1658111719155,MATH 10A,A02,083736,Patchell; Gregory David,20,0,30,10
1658111719155,MATH 10A,A03,083737,Patchell; Gregory David,16,0,30,14
1658111725177,MATH 10B,A01,083207,Lim; Seonhee,9,0,34,25
1658111725177,MATH 10B,A02,083208,Lim; Seonhee,10,0,35,25
1658111725177,MATH 10B,A03,093472,Lim; Seonhee,7,0,34,27
1658111725177,MATH 10B,B01,083739,Sinha; Shubham,14,0,30,16
1658111731202,MATH 18,A01,083743,Cinel; Cameron Alexander,9,0,30,21
1658111731202,MATH 18,A02,083744,Cinel; Cameron Alexander,18,0,30,12
1658111731202,MATH 18,A03,083745,Cinel; Cameron Alexander,10,0,30,20
1658111731202,MATH 18,B01,083748,Rideout; David Porter,5,0,37,32
1658111731202,MATH 18,B02,083749,Rideout; David Porter,5,0,36,31
1658111731202,MATH 18,B03,083750,Rideout; David Porter,3,0,37,34
1658111731202,MATH 18,B04,083751,Rideout; David Porter,7,0,36,29
1658111731202,MATH 18,B05,093473,Rideout; David Porter,7,0,36,29
1658111731202,MATH 18,B06,093474,Rideout; David Porter,6,0,36,30
1658111737225,MATH 20A,A01,083754,Zheng; Zequn,14,0,40,26
1658111743248,MATH 20B,A01,083756,Briones; Jor-el Thomas Caparas,4,0,36,32
1658111743248,MATH 20B,A02,083757,Briones; Jor-el Thomas Caparas,1,0,36,35
1658111743248,MATH 20B,A03,093475,Briones; Jor-el Thomas Caparas,3,0,36,33
1658111749272,MATH 20C,A01,083760,Briones; Jor-el Thomas Caparas,1,0,35,34
1658111749272,MATH 20C,A02,083761,Briones; Jor-el Thomas Caparas,8,0,35,27
1658111749272,MATH 20C,A03,093476,Briones; Jor-el Thomas Caparas,0,1,36,36
1658111749272,MATH 20C,B01,083762,Bach; Quang Tran,1,0,30,29
1658111755301,MATH 20D,A01,083765,Tran; Brian Kha,5,0,30,25
1658111755301,MATH 20D,A02,083766,Tran; Brian Kha,5,0,30,25
1658111755301,MATH 20D,A03,083767,Tran; Brian Kha,6,0,30,24
1658111761330,MATH 20E,A01,083771,Ganguly; Soumya,12,0,32,20
1658111761330,MATH 20E,A02,083772,Ganguly; Soumya,7,0,32,25
1658111761330,MATH 20E,B01,083773,Ciotti; Benjamin,20,0,35,15
1658111761330,MATH 20E,B02,083774,Ciotti; Benjamin,18,0,35,17
1658111767367,MATH 103A,A01,083777,Greenfeld; Be'Eri,6,0,36,30
1658111767367,MATH 103A,A02,083778,Greenfeld; Be'Eri,5,0,36,31
1658111767367,MATH 103A,A03,093561,Greenfeld; Be'Eri,7,0,36,29
1658111767367,MATH 103A,B01,083779,Greenfeld; Be'Eri,8,0,36,28
1658111767367,MATH 103A,B02,083780,Greenfeld; Be'Eri,4,0,36,32
1658111767367,MATH 103A,B03,093562,Greenfeld; Be'Eri,3,0,36,33
1658111773390,MATH 105,A01,085443,Carter; Anne Toulson,15,0,35,20
1658111773390,MATH 105,A02,093477,Carter; Anne Toulson,20,0,35,15
1658111779419,MATH 109,A01,083213,Ganzberger; Geoffrey Michael,3,0,34,31
1658111779419,MATH 109,A02,083214,Ganzberger; Geoffrey Michael,4,0,34,30
1658111779419,MATH 109,A03,093478,Ganzberger; Geoffrey Michael,2,0,34,32
1658111779419,MATH 109,B01,083215,Ganzberger; Geoffrey Michael,3,0,32,29
1658111779419,MATH 109,B02,083216,Ganzberger; Geoffrey Michael,3,0,32,29
1658111779419,MATH 109,B03,093479,Ganzberger; Geoffrey Michael,8,0,32,24
1658111785443,MATH 142A,A01,083219,Chow; Bennett,7,0,32,25
1658111785443,MATH 142A,A02,083220,Chow; Bennett,10,0,32,22
1658111785443,MATH 142A,A03,093480,Chow; Bennett,9,0,32,23
1658111785443,MATH 142A,B03,093481,Chow; Bennett,8,0,32,24
1658111785443,MATH 142A,B04,093558,Chow; Bennett,14,0,32,18
1658111785443,MATH 142A,B05,093559,Chow; Bennett,7,0,32,25
1658111791470,MATH 193A,A01,083224,Rotar; Vladimir,9,0,34,25
1658111791470,MATH 193A,A02,083225,Rotar; Vladimir,11,0,34,23
1658111791470,MATH 193A,A03,083781,Rotar; Vladimir,5,0,34,29
1658111791470,MATH 193A,A04,083782,Rotar; Vladimir,12,0,34,22
1658111791470,MATH 193A,A05,093482,Rotar; Vladimir,11,0,34,23
1658111797493,MATH 197,001,091859,McAuley; Julian John,9999,0,9999,0
1658111797493,MATH 197,002,095566,Kedlaya; Kiran S.,9997,0,9999,2
1658111797493,MATH 197,003,095567,Xiao; Ming,9999,0,9999,0
1658111797493,MATH 197,004,095571,Perols; Johan Lars,9998,0,9999,1
1658111804564,COGS 9,A01,083615,Shannon; Kyle Michael,11,0,75,64
1658111810588,COGS 11,A01,083617,Boyle; Mary E. T.,23,0,48,25
1658111816615,COGS 13,A01,083071,Bastos; Amalia Pinkusfeld,12,0,71,59
1658111822646,COGS 14A,A01,092681,Semenuks; Arturs,5,1,100,95
1658111828670,COGS 14B,A01,083073,Cheng; Tzu-Han,7,0,63,56
1658111834698,COGS 17,A01,092677,Semenuks; Arturs,7,0,81,74
1658111840721,COGS 100,A01,083619,Allen; Michael Gordon,17,0,70,53
1658111846745,COGS 101A,A01,083621,Davis; Joshua Daniel,9,0,68,59
1658111852768,COGS 101B,A01,091572,Allen; Michael Gordon,14,0,65,51
1658111858805,COGS 101C,A01,083625,Delgado; Tania,17,0,35,18
1658111864829,COGS 107A,A01,083627,Boyle; Mary E. T.,14,0,60,46
1658111870856,COGS 118A,A01,083075,Gupta; Anjum,21,0,76,55
1658111876881,CSE 3,A50,083646,Miranda; Gregory Joseph,24,0,50,26
1658111882926,CSE 8A,A50,083650,Miranda; Gregory Joseph,17,1,56,39
1658111888961,CSE 11,A01,083080,Cao; Yingjun,7,15,40,33
1658111894984,CSE 12,A01,083652,Krause-Levy; Sophia Louisa,30,1,120,90
1658111901007,CSE 15L,A01,083654,Morris; Justin Loren,9,0,50,41
1658111901007,CSE 15L,A02,083655,Morris; Justin Loren,11,0,50,39
1658111907058,CSE 20,A01,083657,Tran; Khoa Dang,39,0,80,41
1658111913092,CSE 21,A01,095574,Bach; Quang Tran,23,0,48,25
1658111919117,CSE 30,A01,083084,Eldon; John,8,0,80,72
1658111919117,CSE 30,B01,095061,Bhaskar; Nishant,9,0,50,41
1658111925140,CSE 100,A01,083659,Cao; Yingjun,5,4,70,65
1658111931162,CSE 134B,A01,083661,Powell; Thomas Allan,25,0,100,75
1658111937189,CSE 140,A01,083663,Gungor; Onat,17,0,85,68
1658111943216,CSE 140L,A01,083088,Eldon; John,23,0,100,77
1658111949243,CSE 175,A01,083665,Kumar; Rakesh,3,0,25,22
1658111955285,CSE 190,A00,092507,Dubnov; Shlomo,8,0,20,12
1658111961321,ECE 45,A01,083139,Congero; Spencer William,7,0,75,68
1658111967365,ECE 65,A50,083695,Saad; Andrew S,12,0,30,18
1658111967365,ECE 65,A51,095125,Saad; Andrew S,24,0,26,2
1658111973391,ECE 109,A01,091882,Touri; Behrouz,21,0,70,49
1658111979417,ECE 180,A00,083140,Abi Samra; Nicholas Camill,1,0,30,29
1658111979417,ECE 180,B00,083141,Abi Samra; Nicholas Camill,0,0,30,30
1658111985442,MATH 10A,A01,083735,Patchell; Gregory David,2,0,30,28
1658111985442,MATH 10A,A02,083736,Patchell; Gregory David,20,0,30,10
1658111985442,MATH 10A,A03,083737,Patchell; Gregory David,16,0,30,14
1658111991479,MATH 10B,A01,083207,Lim; Seonhee,9,0,34,25
1658111991479,MATH 10B,A02,083208,Lim; Seonhee,10,0,35,25
1658111991479,MATH 10B,A03,093472,Lim; Seonhee,7,0,34,27
1658111991479,MATH 10B,B01,083739,Sinha; Shubham,14,0,30,16
1658111997513,MATH 18,A01,083743,Cinel; Cameron Alexander,9,0,30,21
1658111997513,MATH 18,A02,083744,Cinel; Cameron Alexander,18,0,30,12
1658111997513,MATH 18,A03,083745,Cinel; Cameron Alexander,10,0,30,20
1658111997513,MATH 18,B01,083748,Rideout; David Porter,5,0,37,32
1658111997513,MATH 18,B02,083749,Rideout; David Porter,5,0,36,31
1658111997513,MATH 18,B03,083750,Rideout; David Porter,3,0,37,34
1658111997513,MATH 18,B04,083751,Rideout; David Porter,7,0,36,29
1658111997513,MATH 18,B05,093473,Rideout; David Porter,7,0,36,29
1658111997513,MATH 18,B06,093474,Rideout; David Porter,6,0,36,30
1658112003543,MATH 20A,A01,083754,Zheng; Zequn,14,0,40,26
1658112009573,MATH 20B,A01,083756,Briones; Jor-el Thomas Caparas,4,0,36,32
1658112009573,MATH 20B,A02,083757,Briones; Jor-el Thomas Caparas,1,0,36,35
1658112009573,MATH 20B,A03,093475,Briones; Jor-el Thomas Caparas,3,0,36,33
1658112015619,MATH 20C,A01,083760,Briones; Jor-el Thomas Caparas,1,0,35,34
1658112015619,MATH 20C,A02,083761,Briones; Jor-el Thomas Caparas,8,0,35,27
1658112015619,MATH 20C,A03,093476,Briones; Jor-el Thomas Caparas,0,1,36,36
1658112015619,MATH 20C,B01,083762,Bach; Quang Tran,1,0,30,29
1658112021640,MATH 20D,A01,083765,Tran; Brian Kha,5,0,30,25
1658112021640,MATH 20D,A02,083766,Tran; Brian Kha,5,0,30,25
1658112021640,MATH 20D,A03,083767,Tran; Brian Kha,6,0,30,24
1658112027668,MATH 20E,A01,083771,Ganguly; Soumya,12,0,32,20
1658112027668,MATH 20E,A02,083772,Ganguly; Soumya,7,0,32,25
1658112027668,MATH 20E,B01,083773,Ciotti; Benjamin,20,0,35,15
1658112027668,MATH 20E,B02,083774,Ciotti; Benjamin,18,0,35,17
1658112033699,MATH 103A,A01,083777,Greenfeld; Be'Eri,6,0,36,30
1658112033699,MATH 103A,A02,083778,Greenfeld; Be'Eri,5,0,36,31
1658112033699,MATH 103A,A03,093561,Greenfeld; Be'Eri,7,0,36,29
1658112033699,MATH 103A,B01,083779,Greenfeld; Be'Eri,8,0,36,28
1658112033699,MATH 103A,B02,083780,Greenfeld; Be'Eri,4,0,36,32
1658112033699,MATH 103A,B03,093562,Greenfeld; Be'Eri,3,0,36,33
1658112039730,MATH 105,A01,085443,Carter; Anne Toulson,15,0,35,20
1658112039730,MATH 105,A02,093477,Carter; Anne Toulson,20,0,35,15
1658112045759,MATH 109,A01,083213,Ganzberger; Geoffrey Michael,3,0,34,31
1658112045759,MATH 109,A02,083214,Ganzberger; Geoffrey Michael,4,0,34,30
1658112045759,MATH 109,A03,093478,Ganzberger; Geoffrey Michael,2,0,34,32
1658112045759,MATH 109,B01,083215,Ganzberger; Geoffrey Michael,3,0,32,29
1658112045759,MATH 109,B02,083216,Ganzberger; Geoffrey Michael,3,0,32,29
1658112045759,MATH 109,B03,093479,Ganzberger; Geoffrey Michael,8,0,32,24
1658112051798,MATH 142A,A01,083219,Chow; Bennett,7,0,32,25
1658112051798,MATH 142A,A02,083220,Chow; Bennett,10,0,32,22
1658112051798,MATH 142A,A03,093480,Chow; Bennett,9,0,32,23
1658112051798,MATH 142A,B03,093481,Chow; Bennett,8,0,32,24
1658112051798,MATH 142A,B04,093558,Chow; Bennett,14,0,32,18
1658112051798,MATH 142A,B05,093559,Chow; Bennett,7,0,32,25
1658112057822,MATH 193A,A01,083224,Rotar; Vladimir,9,0,34,25
1658112057822,MATH 193A,A02,083225,Rotar; Vladimir,11,0,34,23
1658112057822,MATH 193A,A03,083781,Rotar; Vladimir,5,0,34,29
1658112057822,MATH 193A,A04,083782,Rotar; Vladimir,12,0,34,22
1658112057822,MATH 193A,A05,093482,Rotar; Vladimir,11,0,34,23
1658112063854,MATH 197,001,091859,McAuley; Julian John,9999,0,9999,0
1658112063854,MATH 197,002,095566,Kedlaya; Kiran S.,9997,0,9999,2
1658112063854,MATH 197,003,095567,Xiao; Ming,9999,0,9999,0
1658112063854,MATH 197,004,095571,Perols; Johan Lars,9998,0,9999,1
1658112070916,COGS 9,A01,083615,Shannon; Kyle Michael,11,0,75,64
1658112076942,COGS 11,A01,083617,Boyle; Mary E. T.,23,0,48,25
1658112082966,COGS 13,A01,083071,Bastos; Amalia Pinkusfeld,12,0,71,59
1658112089000,COGS 14A,A01,092681,Semenuks; Arturs,5,1,100,95
1658112095028,COGS 14B,A01,083073,Cheng; Tzu-Han,7,0,63,56
1658112101081,COGS 17,A01,092677,Semenuks; Arturs,7,0,81,74
1658112107108,COGS 100,A01,083619,Allen; Michael Gordon,17,0,70,53
1658112113131,COGS 101A,A01,083621,Davis; Joshua Daniel,9,0,68,59
1658112119154,COGS 101B,A01,091572,Allen; Michael Gordon,14,0,65,51
1658112125176,COGS 101C,A01,083625,Delgado; Tania,17,0,35,18
1658112131200,COGS 107A,A01,083627,Boyle; Mary E. T.,14,0,60,46
1658112137223,COGS 118A,A01,083075,Gupta; Anjum,21,0,76,55
1658112143253,CSE 3,A50,083646,Miranda; Gregory Joseph,24,0,50,26
1658112149280,CSE 8A,A50,083650,Miranda; Gregory Joseph,17,1,56,39
1658112155321,CSE 11,A01,083080,Cao; Yingjun,7,15,40,33
1658112161344,CSE 12,A01,083652,Krause-Levy; Sophia Louisa,30,1,120,90
1658112167368,CSE 15L,A01,083654,Morris; Justin Loren,9,0,50,41
1658112167368,CSE 15L,A02,083655,Morris; Justin Loren,11,0,50,39
1658112173395,CSE 20,A01,083657,Tran; Khoa Dang,39,0,80,41
1658112179513,CSE 21,A01,095574,Bach; Quang Tran,23,0,48,25
1658112185544,CSE 30,A01,083084,Eldon; John,8,0,80,72
1658112185544,CSE 30,B01,095061,Bhaskar; Nishant,9,0,50,41
1658112191567,CSE 100,A01,083659,Cao; Yingjun,5,4,70,65
1658112197590,CSE 134B,A01,083661,Powell; Thomas Allan,25,0,100,75
1658112203617,CSE 140,A01,083663,Gungor; Onat,17,0,85,68
1658112209639,CSE 140L,A01,083088,Eldon; John,23,0,100,77
1658112215663,CSE 175,A01,083665,Kumar; Rakesh,3,0,25,22
1658112221692,CSE 190,A00,092507,Dubnov; Shlomo,8,0,20,12
1658112227739,ECE 45,A01,083139,Congero; Spencer William,7,0,75,68
1658112233766,ECE 65,A50,083695,Saad; Andrew S,12,0,30,18
1658112233766,ECE 65,A51,095125,Saad; Andrew S,24,0,26,2
1658112239805,ECE 109,A01,091882,Touri; Behrouz,21,0,70,49
1658112245830,ECE 180,A00,083140,Abi Samra; Nicholas Camill,1,0,30,29
1658112245830,ECE 180,B00,083141,Abi Samra; Nicholas Camill,0,0,30,30
1658112251857,MATH 10A,A01,083735,Patchell; Gregory David,2,0,30,28
1658112251857,MATH 10A,A02,083736,Patchell; Gregory David,20,0,30,10
1658112251857,MATH 10A,A03,083737,Patchell; Gregory David,16,0,30,14
1658112257887,MATH 10B,A01,083207,Lim; Seonhee,9,0,34,25
1658112257887,MATH 10B,A02,083208,Lim; Seonhee,10,0,35,25
1658112257887,MATH 10B,A03,093472,Lim; Seonhee,7,0,34,27
1658112257887,MATH 10B,B01,083739,Sinha; Shubham,14,0,30,16
1658112263914,MATH 18,A01,083743,Cinel; Cameron Alexander,9,0,30,21
1658112263914,MATH 18,A02,083744,Cinel; Cameron Alexander,18,0,30,12
1658112263914,MATH 18,A03,083745,Cinel; Cameron Alexander,10,0,30,20
1658112263914,MATH 18,B01,083748,Rideout; David Porter,5,0,37,32
1658112263914,MATH 18,B02,083749,Rideout; David Porter,5,0,36,31
1658112263914,MATH 18,B03,083750,Rideout; David Porter,3,0,37,34
1658112263914,MATH 18,B04,083751,Rideout; David Porter,7,0,36,29
1658112263914,MATH 18,B05,093473,Rideout; David Porter,7,0,36,29
1658112263914,MATH 18,B06,093474,Rideout; David Porter,6,0,36,30
1658112269948,MATH 20A,A01,083754,Zheng; Zequn,14,0,40,26
1658112275971,MATH 20B,A01,083756,Briones; Jor-el Thomas Caparas,4,0,36,32
1658112275971,MATH 20B,A02,083757,Briones; Jor-el Thomas Caparas,1,0,36,35
1658112275971,MATH 20B,A03,093475,Briones; Jor-el Thomas Caparas,3,0,36,33
1658112281996,MATH 20C,A01,083760,Briones; Jor-el Thomas Caparas,1,0,35,34
1658112281996,MATH 20C,A02,083761,Briones; Jor-el Thomas Caparas,8,0,35,27
1658112281996,MATH 20C,A03,093476,Briones; Jor-el Thomas Caparas,0,1,36,36
1658112281996,MATH 20C,B01,083762,Bach; Quang Tran,1,0,30,29
1658112288027,MATH 20D,A01,083765,Tran; Brian Kha,5,0,30,25
1658112288027,MATH 20D,A02,083766,Tran; Brian Kha,5,0,30,25
1658112288027,MATH 20D,A03,083767,Tran; Brian Kha,6,0,30,24
1658112294051,MATH 20E,A01,083771,Ganguly; Soumya,12,0,32,20
1658112294051,MATH 20E,A02,083772,Ganguly; Soumya,7,0,32,25
1658112294051,MATH 20E,B01,083773,Ciotti; Benjamin,20,0,35,15
1658112294051,MATH 20E,B02,083774,Ciotti; Benjamin,18,0,35,17
1658112300087,MATH 103A,A01,083777,Greenfeld; Be'Eri,6,0,36,30
1658112300087,MATH 103A,A02,083778,Greenfeld; Be'Eri,5,0,36,31
1658112300087,MATH 103A,A03,093561,Greenfeld; Be'Eri,7,0,36,29
1658112300087,MATH 103A,B01,083779,Greenfeld; Be'Eri,8,0,36,28
1658112300087,MATH 103A,B02,083780,Greenfeld; Be'Eri,4,0,36,32
1658112300087,MATH 103A,B03,093562,Greenfeld; Be'Eri,3,0,36,33
1658112306119,MATH 105,A01,085443,Carter; Anne Toulson,15,0,35,20
1658112306119,MATH 105,A02,093477,Carter; Anne Toulson,20,0,35,15
1658112312143,MATH 109,A01,083213,Ganzberger; Geoffrey Michael,3,0,34,31
1658112312143,MATH 109,A02,083214,Ganzberger; Geoffrey Michael,4,0,34,30
1658112312143,MATH 109,A03,093478,Ganzberger; Geoffrey Michael,2,0,34,32
1658112312143,MATH 109,B01,083215,Ganzberger; Geoffrey Michael,3,0,32,29
1658112312143,MATH 109,B02,083216,Ganzberger; Geoffrey Michael,3,0,32,29
1658112312143,MATH 109,B03,093479,Ganzberger; Geoffrey Michael,8,0,32,24
1658112318173,MATH 142A,A01,083219,Chow; Bennett,7,0,32,25
1658112318173,MATH 142A,A02,083220,Chow; Bennett,10,0,32,22
1658112318173,MATH 142A,A03,093480,Chow; Bennett,9,0,32,23
1658112318173,MATH 142A,B03,093481,Chow; Bennett,8,0,32,24
1658112318173,MATH 142A,B04,093558,Chow; Bennett,14,0,32,18
1658112318173,MATH 142A,B05,093559,Chow; Bennett,7,0,32,25
1658112324203,MATH 193A,A01,083224,Rotar; Vladimir,9,0,34,25
1658112324203,MATH 193A,A02,083225,Rotar; Vladimir,11,0,34,23
1658112324203,MATH 193A,A03,083781,Rotar; Vladimir,5,0,34,29
1658112324203,MATH 193A,A04,083782,Rotar; Vladimir,12,0,34,22
1658112324203,MATH 193A,A05,093482,Rotar; Vladimir,11,0,34,23
1658112330229,MATH 197,001,091859,McAuley; Julian John,9999,0,9999,0
1658112330229,MATH 197,002,095566,Kedlaya; Kiran S.,9997,0,9999,2
1658112330229,MATH 197,003,095567,Xiao; Ming,9999,0,9999,0
1658112330229,MATH 197,004,095571,Perols; Johan Lars,9998,0,9999,1
1658112337285,COGS 9,A01,083615,Shannon; Kyle Michael,11,0,75,64
1658112343311,COGS 11,A01,083617,Boyle; Mary E. T.,23,0,48,25
1658112349335,COGS 13,A01,083071,Bastos; Amalia Pinkusfeld,12,0,71,59
1658112355359,COGS 14A,A01,092681,Semenuks; Arturs,5,1,100,95
1658112361383,COGS 14B,A01,083073,Cheng; Tzu-Han,7,0,63,56
1658112367406,COGS 17,A01,092677,Semenuks; Arturs,7,0,81,74
1658112373430,COGS 100,A01,083619,Allen; Michael Gordon,17,0,70,53
1658112379456,COGS 101A,A01,083621,Davis; Joshua Daniel,9,0,68,59
1658112385498,COGS 101B,A01,091572,Allen; Michael Gordon,14,0,65,51
1658112391528,COGS 101C,A01,083625,Delgado; Tania,17,0,35,18
1658112397553,COGS 107A,A01,083627,Boyle; Mary E. T.,14,0,60,46
1658112403579,COGS 118A,A01,083075,Gupta; Anjum,21,0,76,55
1658112409606,CSE 3,A50,083646,Miranda; Gregory Joseph,24,0,50,26
1658112415634,CSE 8A,A50,083650,Miranda; Gregory Joseph,17,1,56,39
1658112421663,CSE 11,A01,083080,Cao; Yingjun,7,15,40,33
1658112427686,CSE 12,A01,083652,Krause-Levy; Sophia Louisa,30,1,120,90
1658112433709,CSE 15L,A01,083654,Morris; Justin Loren,9,0,50,41
1658112433709,CSE 15L,A02,083655,Morris; Justin Loren,11,0,50,39
1658112439733,CSE 20,A01,083657,Tran; Khoa Dang,39,0,80,41
1658112445757,CSE 21,A01,095574,Bach; Quang Tran,23,0,48,25
1658112451782,CSE 30,A01,083084,Eldon; John,8,0,80,72
1658112451782,CSE 30,B01,095061,Bhaskar; Nishant,9,0,50,41
1658112457804,CSE 100,A01,083659,Cao; Yingjun,5,4,70,65
1658112463827,CSE 134B,A01,083661,Powell; Thomas Allan,25,0,100,75
1658112469854,CSE 140,A01,083663,Gungor; Onat,17,0,85,68
1658112475885,CSE 140L,A01,083088,Eldon; John,23,0,100,77
1658112481916,CSE 175,A01,083665,Kumar; Rakesh,3,0,25,22
1658112487949,CSE 190,A00,092507,Dubnov; Shlomo,8,0,20,12
1658112493978,ECE 45,A01,083139,Congero; Spencer William,7,0,75,68
1658112500010,ECE 65,A50,083695,Saad; Andrew S,12,0,30,18
1658112500010,ECE 65,A51,095125,Saad; Andrew S,24,0,26,2
1658112506036,ECE 109,A01,091882,Touri; Behrouz,21,0,70,49
1658112512060,ECE 180,A00,083140,Abi Samra; Nicholas Camill,1,0,30,29
1658112512060,ECE 180,B00,083141,Abi Samra; Nicholas Camill,0,0,30,30
1658112518088,MATH 10A,A01,083735,Patchell; Gregory David,2,0,30,28
1658112518088,MATH 10A,A02,083736,Patchell; Gregory David,20,0,30,10
1658112518088,MATH 10A,A03,083737,Patchell; Gregory David,16,0,30,14
1658112524114,MATH 10B,A01,083207,Lim; Seonhee,9,0,34,25
1658112524114,MATH 10B,A02,083208,Lim; Seonhee,10,0,35,25
1658112524114,MATH 10B,A03,093472,Lim; Seonhee,7,0,34,27
1658112524114,MATH 10B,B01,083739,Sinha; Shubham,14,0,30,16
1658112530152,MATH 18,A01,083743,Cinel; Cameron Alexander,9,0,30,21
1658112530152,MATH 18,A02,083744,Cinel; Cameron Alexander,18,0,30,12
1658112530152,MATH 18,A03,083745,Cinel; Cameron Alexander,10,0,30,20
1658112530152,MATH 18,B01,083748,Rideout; David Porter,5,0,37,32
1658112530152,MATH 18,B02,083749,Rideout; David Porter,5,0,36,31
1658112530152,MATH 18,B03,083750,Rideout; David Porter,3,0,37,34
1658112530152,MATH 18,B04,083751,Rideout; David Porter,7,0,36,29
1658112530152,MATH 18,B05,093473,Rideout; David Porter,7,0,36,29
1658112530152,MATH 18,B06,093474,Rideout; David Porter,6,0,36,30
1658112536174,MATH 20A,A01,083754,Zheng; Zequn,14,0,40,26
1658112542199,MATH 20B,A01,083756,Briones; Jor-el Thomas Caparas,4,0,36,32
1658112542199,MATH 20B,A02,083757,Briones; Jor-el Thomas Caparas,1,0,36,35
1658112542199,MATH 20B,A03,093475,Briones; Jor-el Thomas Caparas,3,0,36,33
1658112548229,MATH 20C,A01,083760,Briones; Jor-el Thomas Caparas,1,0,35,34
1658112548229,MATH 20C,A02,083761,Briones; Jor-el Thomas Caparas,8,0,35,27
1658112548229,MATH 20C,A03,093476,Briones; Jor-el Thomas Caparas,0,1,36,36
1658112548229,MATH 20C,B01,083762,Bach; Quang Tran,1,0,30,29
1658112554252,MATH 20D,A01,083765,Tran; Brian Kha,5,0,30,25
1658112554252,MATH 20D,A02,083766,Tran; Brian Kha,5,0,30,25
1658112554252,MATH 20D,A03,083767,Tran; Brian Kha,6,0,30,24
1658112560280,MATH 20E,A01,083771,Ganguly; Soumya,12,0,32,20
1658112560280,MATH 20E,A02,083772,Ganguly; Soumya,7,0,32,25
1658112560280,MATH 20E,B01,083773,Ciotti; Benjamin,20,0,35,15
1658112560280,MATH 20E,B02,083774,Ciotti; Benjamin,18,0,35,17
1658112566311,MATH 103A,A01,083777,Greenfeld; Be'Eri,6,0,36,30
1658112566311,MATH 103A,A02,083778,Greenfeld; Be'Eri,5,0,36,31
1658112566311,MATH 103A,A03,093561,Greenfeld; Be'Eri,7,0,36,29
1658112566311,MATH 103A,B01,083779,Greenfeld; Be'Eri,8,0,36,28
1658112566311,MATH 103A,B02,083780,Greenfeld; Be'Eri,4,0,36,32
1658112566311,MATH 103A,B03,093562,Greenfeld; Be'Eri,3,0,36,33
1658112572335,MATH 105,A01,085443,Carter; Anne Toulson,15,0,35,20
1658112572335,MATH 105,A02,093477,Carter; Anne Toulson,20,0,35,15
1658112578359,MATH 109,A01,083213,Ganzberger; Geoffrey Michael,3,0,34,31
1658112578359,MATH 109,A02,083214,Ganzberger; Geoffrey Michael,4,0,34,30
1658112578359,MATH 109,A03,093478,Ganzberger; Geoffrey Michael,2,0,34,32
1658112578359,MATH 109,B01,083215,Ganzberger; Geoffrey Michael,3,0,32,29
1658112578359,MATH 109,B02,083216,Ganzberger; Geoffrey Michael,3,0,32,29
1658112578359,MATH 109,B03,093479,Ganzberger; Geoffrey Michael,8,0,32,24
1658112584413,MATH 142A,A01,083219,Chow; Bennett,7,0,32,25
1658112584413,MATH 142A,A02,083220,Chow; Bennett,10,0,32,22
1658112584413,MATH 142A,A03,093480,Chow; Bennett,9,0,32,23
1658112584413,MATH 142A,B03,093481,Chow; Bennett,8,0,32,24
1658112584413,MATH 142A,B04,093558,Chow; Bennett,14,0,32,18
1658112584413,MATH 142A,B05,093559,Chow; Bennett,7,0,32,25
1658112590441,MATH 193A,A01,083224,Rotar; Vladimir,9,0,34,25
1658112590441,MATH 193A,A02,083225,Rotar; Vladimir,11,0,34,23
1658112590441,MATH 193A,A03,083781,Rotar; Vladimir,5,0,34,29
1658112590441,MATH 193A,A04,083782,Rotar; Vladimir,12,0,34,22
1658112590441,MATH 193A,A05,093482,Rotar; Vladimir,11,0,34,23
1658112596486,MATH 197,001,091859,McAuley; Julian John,9999,0,9999,0
1658112596486,MATH 197,002,095566,Kedlaya; Kiran S.,9997,0,9999,2
1658112596486,MATH 197,003,095567,Xiao; Ming,9999,0,9999,0
1658112596486,MATH 197,004,095571,Perols; Johan Lars,9998,0,9999,1
1658112603548,COGS 9,A01,083615,Shannon; Kyle Michael,11,0,75,64
1658112609577,COGS 11,A01,083617,Boyle; Mary E. T.,23,0,48,25
1658112615604,COGS 13,A01,083071,Bastos; Amalia Pinkusfeld,12,0,71,59
1658112621627,COGS 14A,A01,092681,Semenuks; Arturs,5,1,100,95
1658112627651,COGS 14B,A01,083073,Cheng; Tzu-Han,7,0,63,56
1658112633679,COGS 17,A01,092677,Semenuks; Arturs,7,0,81,74
1658112639706,COGS 100,A01,083619,Allen; Michael Gordon,17,0,70,53
1658112645730,COGS 101A,A01,083621,Davis; Joshua Daniel,9,0,68,59
1658112651753,COGS 101B,A01,091572,Allen; Michael Gordon,14,0,65,51
1658112657777,COGS 101C,A01,083625,Delgado; Tania,17,0,35,18
1658112663800,COGS 107A,A01,083627,Boyle; Mary E. T.,14,0,60,46
1658112669830,COGS 118A,A01,083075,Gupta; Anjum,21,0,76,55
1658112675858,CSE 3,A50,083646,Miranda; Gregory Joseph,24,0,50,26
1658112681881,CSE 8A,A50,083650,Miranda; Gregory Joseph,17,1,56,39
1658112687905,CSE 11,A01,083080,Cao; Yingjun,7,15,40,33
1658112693941,CSE 12,A01,083652,Krause-Levy; Sophia Louisa,30,1,120,90
1658112699973,CSE 15L,A01,083654,Morris; Justin Loren,9,0,50,41
1658112699973,CSE 15L,A02,083655,Morris; Justin Loren,11,0,50,39
1658112705996,CSE 20,A01,083657,Tran; Khoa Dang,39,0,80,41
1658112712023,CSE 21,A01,095574,Bach; Quang Tran,23,0,48,25
1658112718051,CSE 30,A01,083084,Eldon; John,8,0,80,72
1658112718051,CSE 30,B01,095061,Bhaskar; Nishant,9,0,50,41
1658112724074,CSE 100,A01,083659,Cao; Yingjun,5,4,70,65
1658112730097,CSE 134B,A01,083661,Powell; Thomas Allan,25,0,100,75
1658112736120,CSE 140,A01,083663,Gungor; Onat,17,0,85,68
1658112742143,CSE 140L,A01,083088,Eldon; John,23,0,100,77
1658112748166,CSE 175,A01,083665,Kumar; Rakesh,3,0,25,22
1658112754189,CSE 190,A00,092507,Dubnov; Shlomo,8,0,20,12
1658112760212,ECE 45,A01,083139,Congero; Spencer William,7,0,75,68
1658112766236,ECE 65,A50,083695,Saad; Andrew S,12,0,30,18
1658112766236,ECE 65,A51,095125,Saad; Andrew S,24,0,26,2
1658112772262,ECE 109,A01,091882,Touri; Behrouz,21,0,70,49
1658112778378,ECE 180,A00,083140,Abi Samra; Nicholas Camill,1,0,30,29
1658112778378,ECE 180,B00,083141,Abi Samra; Nicholas Camill,0,0,30,30
1658112784406,MATH 10A,A01,083735,Patchell; Gregory David,2,0,30,28
1658112784406,MATH 10A,A02,083736,Patchell; Gregory David,20,0,30,10
1658112784406,MATH 10A,A03,083737,Patchell; Gregory David,16,0,30,14
1658112790440,MATH 10B,A01,083207,Lim; Seonhee,9,0,34,25
1658112790440,MATH 10B,A02,083208,Lim; Seonhee,10,0,35,25
1658112790440,MATH 10B,A03,093472,Lim; Seonhee,7,0,34,27
1658112790440,MATH 10B,B01,083739,Sinha; Shubham,14,0,30,16
1658112796466,MATH 18,A01,083743,Cinel; Cameron Alexander,9,0,30,21
1658112796466,MATH 18,A02,083744,Cinel; Cameron Alexander,18,0,30,12
1658112796466,MATH 18,A03,083745,Cinel; Cameron Alexander,10,0,30,20
1658112796466,MATH 18,B01,083748,Rideout; David Porter,5,0,37,32
1658112796466,MATH 18,B02,083749,Rideout; David Porter,5,0,36,31
1658112796466,MATH 18,B03,083750,Rideout; David Porter,3,0,37,34
1658112796466,MATH 18,B04,083751,Rideout; David Porter,7,0,36,29
1658112796466,MATH 18,B05,093473,Rideout; David Porter,7,0,36,29
1658112796466,MATH 18,B06,093474,Rideout; David Porter,6,0,36,30
1658112802490,MATH 20A,A01,083754,Zheng; Zequn,14,0,40,26
1658112808524,MATH 20B,A01,083756,Briones; Jor-el Thomas Caparas,4,0,36,32
1658112808524,MATH 20B,A02,083757,Briones; Jor-el Thomas Caparas,1,0,36,35
1658112808524,MATH 20B,A03,093475,Briones; Jor-el Thomas Caparas,3,0,36,33
1658112814552,MATH 20C,A01,083760,Briones; Jor-el Thomas Caparas,1,0,35,34
1658112814552,MATH 20C,A02,083761,Briones; Jor-el Thomas Caparas,8,0,35,27
1658112814552,MATH 20C,A03,093476,Briones; Jor-el Thomas Caparas,0,1,36,36
1658112814552,MATH 20C,B01,083762,Bach; Quang Tran,1,0,30,29
1658112820581,MATH 20D,A01,083765,Tran; Brian Kha,5,0,30,25
1658112820581,MATH 20D,A02,083766,Tran; Brian Kha,5,0,30,25
1658112820581,MATH 20D,A03,083767,Tran; Brian Kha,6,0,30,24
1658112826609,MATH 20E,A01,083771,Ganguly; Soumya,12,0,32,20
1658112826609,MATH 20E,A02,083772,Ganguly; Soumya,7,0,32,25
1658112826609,MATH 20E,B01,083773,Ciotti; Benjamin,20,0,35,15
1658112826609,MATH 20E,B02,083774,Ciotti; Benjamin,18,0,35,17
1658112832634,MATH 103A,A01,083777,Greenfeld; Be'Eri,6,0,36,30
1658112832634,MATH 103A,A02,083778,Greenfeld; Be'Eri,5,0,36,31
1658112832634,MATH 103A,A03,093561,Greenfeld; Be'Eri,7,0,36,29
1658112832634,MATH 103A,B01,083779,Greenfeld; Be'Eri,8,0,36,28
1658112832634,MATH 103A,B02,083780,Greenfeld; Be'Eri,4,0,36,32
1658112832634,MATH 103A,B03,093562,Greenfeld; Be'Eri,3,0,36,33
1658112838658,MATH 105,A01,085443,Carter; Anne Toulson,15,0,35,20
1658112838658,MATH 105,A02,093477,Carter; Anne Toulson,20,0,35,15
1658112844681,MATH 109,A01,083213,Ganzberger; Geoffrey Michael,3,0,34,31
1658112844681,MATH 109,A02,083214,Ganzberger; Geoffrey Michael,4,0,34,30
1658112844681,MATH 109,A03,093478,Ganzberger; Geoffrey Michael,2,0,34,32
1658112844681,MATH 109,B01,083215,Ganzberger; Geoffrey Michael,3,0,32,29
1658112844681,MATH 109,B02,083216,Ganzberger; Geoffrey Michael,3,0,32,29
1658112844681,MATH 109,B03,093479,Ganzberger; Geoffrey Michael,8,0,32,24
1658112850708,MATH 142A,A01,083219,Chow; Bennett,7,0,32,25
1658112850708,MATH 142A,A02,083220,Chow; Bennett,10,0,32,22
1658112850708,MATH 142A,A03,093480,Chow; Bennett,9,0,32,23
1658112850708,MATH 142A,B03,093481,Chow; Bennett,8,0,32,24
1658112850708,MATH 142A,B04,093558,Chow; Bennett,14,0,32,18
1658112850708,MATH 142A,B05,093559,Chow; Bennett,7,0,32,25
1658112856753,MATH 193A,A01,083224,Rotar; Vladimir,9,0,34,25
1658112856753,MATH 193A,A02,083225,Rotar; Vladimir,11,0,34,23
1658112856753,MATH 193A,A03,083781,Rotar; Vladimir,5,0,34,29
1658112856753,MATH 193A,A04,083782,Rotar; Vladimir,12,0,34,22
1658112856753,MATH 193A,A05,093482,Rotar; Vladimir,11,0,34,23
1658112862776,MATH 197,001,091859,McAuley; Julian John,9999,0,9999,0
1658112862776,MATH 197,002,095566,Kedlaya; Kiran S.,9997,0,9999,2
1658112862776,MATH 197,003,095567,Xiao; Ming,9999,0,9999,0
1658112862776,MATH 197,004,095571,Perols; Johan Lars,9998,0,9999,1
1658112869859,COGS 9,A01,083615,Shannon; Kyle Michael,11,0,75,64
1658112875885,COGS 11,A01,083617,Boyle; Mary E. T.,23,0,48,25
1658112881909,COGS 13,A01,083071,Bastos; Amalia Pinkusfeld,12,0,71,59
1658112887934,COGS 14A,A01,092681,Semenuks; Arturs,5,1,100,95
1658112893958,COGS 14B,A01,083073,Cheng; Tzu-Han,7,0,63,56
1658112899985,COGS 17,A01,092677,Semenuks; Arturs,7,0,81,74
1658112906009,COGS 100,A01,083619,Allen; Michael Gordon,17,0,70,53
1658112912032,COGS 101A,A01,083621,Davis; Joshua Daniel,9,0,68,59
1658112918056,COGS 101B,A01,091572,Allen; Michael Gordon,14,0,65,51
1658112924082,COGS 101C,A01,083625,Delgado; Tania,17,0,35,18
1658112930108,COGS 107A,A01,083627,Boyle; Mary E. T.,14,0,60,46
1658112936135,COGS 118A,A01,083075,Gupta; Anjum,21,0,76,55
1658112942165,CSE 3,A50,083646,Miranda; Gregory Joseph,24,0,50,26
1658112948188,CSE 8A,A50,083650,Miranda; Gregory Joseph,17,1,56,39
1658112954223,CSE 11,A01,083080,Cao; Yingjun,7,15,40,33
1658112960249,CSE 12,A01,083652,Krause-Levy; Sophia Louisa,30,1,120,90
1658112966288,CSE 15L,A01,083654,Morris; Justin Loren,9,0,50,41
1658112966288,CSE 15L,A02,083655,Morris; Justin Loren,11,0,50,39
1658112972312,CSE 20,A01,083657,Tran; Khoa Dang,39,0,80,41
1658112978336,CSE 21,A01,095574,Bach; Quang Tran,23,0,48,25
1658112984364,CSE 30,A01,083084,Eldon; John,8,0,80,72
1658112984364,CSE 30,B01,095061,Bhaskar; Nishant,9,0,50,41
1658112990387,CSE 100,A01,083659,Cao; Yingjun,5,4,70,65
1658112996411,CSE 134B,A01,083661,Powell; Thomas Allan,25,0,100,75
1658113002434,CSE 140,A01,083663,Gungor; Onat,17,0,85,68
1658113008458,CSE 140L,A01,083088,Eldon; John,23,0,100,77
1658113014480,CSE 175,A01,083665,Kumar; Rakesh,3,0,25,22
1658113020508,CSE 190,A00,092507,Dubnov; Shlomo,8,0,20,12
1658113026532,ECE 45,A01,083139,Congero; Spencer William,7,0,75,68
1658113032558,ECE 65,A50,083695,Saad; Andrew S,12,0,30,18
1658113032558,ECE 65,A51,095125,Saad; Andrew S,24,0,26,2
1658113038603,ECE 109,A01,091882,Touri; Behrouz,21,0,70,49
1658113044626,ECE 180,A00,083140,Abi Samra; Nicholas Camill,1,0,30,29
1658113044626,ECE 180,B00,083141,Abi Samra; Nicholas Camill,0,0,30,30
1658113050655,MATH 10A,A01,083735,Patchell; Gregory David,2,0,30,28
1658113050655,MATH 10A,A02,083736,Patchell; Gregory David,20,0,30,10
1658113050655,MATH 10A,A03,083737,Patchell; Gregory David,16,0,30,14
1658113056684,MATH 10B,A01,083207,Lim; Seonhee,9,0,34,25
1658113056684,MATH 10B,A02,083208,Lim; Seonhee,10,0,35,25
1658113056684,MATH 10B,A03,093472,Lim; Seonhee,7,0,34,27
1658113056684,MATH 10B,B01,083739,Sinha; Shubham,14,0,30,16
1658113062709,MATH 18,A01,083743,Cinel; Cameron Alexander,9,0,30,21
1658113062709,MATH 18,A02,083744,Cinel; Cameron Alexander,18,0,30,12
1658113062709,MATH 18,A03,083745,Cinel; Cameron Alexander,10,0,30,20
1658113062709,MATH 18,B01,083748,Rideout; David Porter,5,0,37,32
1658113062709,MATH 18,B02,083749,Rideout; David Porter,5,0,36,31
1658113062709,MATH 18,B03,083750,Rideout; David Porter,3,0,37,34
1658113062709,MATH 18,B04,083751,Rideout; David Porter,7,0,36,29
1658113062709,MATH 18,B05,093473,Rideout; David Porter,7,0,36,29
1658113062709,MATH 18,B06,093474,Rideout; David Porter,6,0,36,30
1658113068732,MATH 20A,A01,083754,Zheng; Zequn,14,0,40,26
1658113074760,MATH 20B,A01,083756,Briones; Jor-el Thomas Caparas,4,0,36,32
1658113074760,MATH 20B,A02,083757,Briones; Jor-el Thomas Caparas,1,0,36,35
1658113074760,MATH 20B,A03,093475,Briones; Jor-el Thomas Caparas,3,0,36,33
1658113080784,MATH 20C,A01,083760,Briones; Jor-el Thomas Caparas,1,0,35,34
1658113080784,MATH 20C,A02,083761,Briones; Jor-el Thomas Caparas,8,0,35,27
1658113080784,MATH 20C,A03,093476,Briones; Jor-el Thomas Caparas,0,1,36,36
1658113080784,MATH 20C,B01,083762,Bach; Quang Tran,1,0,30,29
1658113086813,MATH 20D,A01,083765,Tran; Brian Kha,5,0,30,25
1658113086813,MATH 20D,A02,083766,Tran; Brian Kha,5,0,30,25
1658113086813,MATH 20D,A03,083767,Tran; Brian Kha,6,0,30,24
1658113092836,MATH 20E,A01,083771,Ganguly; Soumya,12,0,32,20
1658113092836,MATH 20E,A02,083772,Ganguly; Soumya,7,0,32,25
1658113092836,MATH 20E,B01,083773,Ciotti; Benjamin,20,0,35,15
1658113092836,MATH 20E,B02,083774,Ciotti; Benjamin,18,0,35,17
1658113098864,MATH 103A,A01,083777,Greenfeld; Be'Eri,6,0,36,30
1658113098864,MATH 103A,A02,083778,Greenfeld; Be'Eri,5,0,36,31
1658113098864,MATH 103A,A03,093561,Greenfeld; Be'Eri,7,0,36,29
1658113098864,MATH 103A,B01,083779,Greenfeld; Be'Eri,8,0,36,28
1658113098864,MATH 103A,B02,083780,Greenfeld; Be'Eri,4,0,36,32
1658113098864,MATH 103A,B03,093562,Greenfeld; Be'Eri,3,0,36,33
1658113104896,MATH 105,A01,085443,Carter; Anne Toulson,15,0,35,20
1658113104896,MATH 105,A02,093477,Carter; Anne Toulson,20,0,35,15
1658113110940,MATH 109,A01,083213,Ganzberger; Geoffrey Michael,3,0,34,31
1658113110940,MATH 109,A02,083214,Ganzberger; Geoffrey Michael,4,0,34,30
1658113110940,MATH 109,A03,093478,Ganzberger; Geoffrey Michael,2,0,34,32
1658113110940,MATH 109,B01,083215,Ganzberger; Geoffrey Michael,3,0,32,29
1658113110940,MATH 109,B02,083216,Ganzberger; Geoffrey Michael,3,0,32,29
1658113110940,MATH 109,B03,093479,Ganzberger; Geoffrey Michael,8,0,32,24
1658113116977,MATH 142A,A01,083219,Chow; Bennett,7,0,32,25
1658113116977,MATH 142A,A02,083220,Chow; Bennett,10,0,32,22
1658113116977,MATH 142A,A03,093480,Chow; Bennett,9,0,32,23
1658113116977,MATH 142A,B03,093481,Chow; Bennett,8,0,32,24
1658113116977,MATH 142A,B04,093558,Chow; Bennett,14,0,32,18
1658113116977,MATH 142A,B05,093559,Chow; Bennett,7,0,32,25
1658113123001,MATH 193A,A01,083224,Rotar; Vladimir,9,0,34,25
1658113123001,MATH 193A,A02,083225,Rotar; Vladimir,11,0,34,23
1658113123001,MATH 193A,A03,083781,Rotar; Vladimir,5,0,34,29
1658113123001,MATH 193A,A04,083782,Rotar; Vladimir,12,0,34,22
1658113123001,MATH 193A,A05,093482,Rotar; Vladimir,11,0,34,23
1658113129030,MATH 197,001,091859,McAuley; Julian John,9999,0,9999,0
1658113129030,MATH 197,002,095566,Kedlaya; Kiran S.,9997,0,9999,2
1658113129030,MATH 197,003,095567,Xiao; Ming,9999,0,9999,0
1658113129030,MATH 197,004,095571,Perols; Johan Lars,9998,0,9999,1
1658113136087,COGS 9,A01,083615,Shannon; Kyle Michael,11,0,75,64
1658113142111,COGS 11,A01,083617,Boyle; Mary E. T.,23,0,48,25
1658113148135,COGS 13,A01,083071,Bastos; Amalia Pinkusfeld,12,0,71,59
1658113154161,COGS 14A,A01,092681,Semenuks; Arturs,5,1,100,95
1658113160186,COGS 14B,A01,083073,Cheng; Tzu-Han,7,0,63,56
1658113166216,COGS 17,A01,092677,Semenuks; Arturs,7,0,81,74
1658113172249,COGS 100,A01,083619,Allen; Michael Gordon,17,0,70,53
1658113178272,COGS 101A,A01,083621,Davis; Joshua Daniel,9,0,68,59
1658113184296,COGS 101B,A01,091572,Allen; Michael Gordon,14,0,65,51
1658113190341,COGS 101C,A01,083625,Delgado; Tania,17,0,35,18
1658113196373,COGS 107A,A01,083627,Boyle; Mary E. T.,14,0,60,46
1658113202398,COGS 118A,A01,083075,Gupta; Anjum,21,0,76,55
1658113208436,CSE 3,A50,083646,Miranda; Gregory Joseph,24,0,50,26
1658113214461,CSE 8A,A50,083650,Miranda; Gregory Joseph,17,1,56,39
1658113220487,CSE 11,A01,083080,Cao; Yingjun,7,15,40,33
1658113226511,CSE 12,A01,083652,Krause-Levy; Sophia Louisa,30,1,120,90
1658113232538,CSE 15L,A01,083654,Morris; Justin Loren,9,0,50,41
1658113232538,CSE 15L,A02,083655,Morris; Justin Loren,11,0,50,39
1658113238563,CSE 20,A01,083657,Tran; Khoa Dang,39,0,80,41
1658113244591,CSE 21,A01,095574,Bach; Quang Tran,23,0,48,25
1658113250614,CSE 30,A01,083084,Eldon; John,8,0,80,72
1658113250614,CSE 30,B01,095061,Bhaskar; Nishant,9,0,50,41
1658113256658,CSE 100,A01,083659,Cao; Yingjun,5,4,70,65
1658113262705,CSE 134B,A01,083661,Powell; Thomas Allan,25,0,100,75
1658113268729,CSE 140,A01,083663,Gungor; Onat,17,0,85,68
1658113274755,CSE 140L,A01,083088,Eldon; John,23,0,100,77
1658113280780,CSE 175,A01,083665,Kumar; Rakesh,3,0,25,22
1658113286827,CSE 190,A00,092507,Dubnov; Shlomo,8,0,20,12
1658113292851,ECE 45,A01,083139,Congero; Spencer William,7,0,75,68
1658113298885,ECE 65,A50,083695,Saad; Andrew S,12,0,30,18
1658113298885,ECE 65,A51,095125,Saad; Andrew S,24,0,26,2
1658113304912,ECE 109,A01,091882,Touri; Behrouz,21,0,70,49
1658113310936,ECE 180,A00,083140,Abi Samra; Nicholas Camill,1,0,30,29
1658113310936,ECE 180,B00,083141,Abi Samra; Nicholas Camill,0,0,30,30
1658113316960,MATH 10A,A01,083735,Patchell; Gregory David,2,0,30,28
1658113316960,MATH 10A,A02,083736,Patchell; Gregory David,20,0,30,10
1658113316960,MATH 10A,A03,083737,Patchell; Gregory David,16,0,30,14
1658113322990,MATH 10B,A01,083207,Lim; Seonhee,9,0,34,25
1658113322990,MATH 10B,A02,083208,Lim; Seonhee,10,0,35,25
1658113322990,MATH 10B,A03,093472,Lim; Seonhee,7,0,34,27
1658113322990,MATH 10B,B01,083739,Sinha; Shubham,14,0,30,16
1658113329017,MATH 18,A01,083743,Cinel; Cameron Alexander,9,0,30,21
1658113329017,MATH 18,A02,083744,Cinel; Cameron Alexander,18,0,30,12
1658113329017,MATH 18,A03,083745,Cinel; Cameron Alexander,10,0,30,20
1658113329017,MATH 18,B01,083748,Rideout; David Porter,5,0,37,32
1658113329017,MATH 18,B02,083749,Rideout; David Porter,5,0,36,31
1658113329017,MATH 18,B03,083750,Rideout; David Porter,3,0,37,34
1658113329017,MATH 18,B04,083751,Rideout; David Porter,7,0,36,29
1658113329017,MATH 18,B05,093473,Rideout; David Porter,7,0,36,29
1658113329017,MATH 18,B06,093474,Rideout; David Porter,6,0,36,30
1658113335044,MATH 20A,A01,083754,Zheng; Zequn,14,0,40,26
1658113341068,MATH 20B,A01,083756,Briones; Jor-el Thomas Caparas,4,0,36,32
1658113341068,MATH 20B,A02,083757,Briones; Jor-el Thomas Caparas,1,0,36,35
1658113341068,MATH 20B,A03,093475,Briones; Jor-el Thomas Caparas,3,0,36,33
1658113347109,MATH 20C,A01,083760,Briones; Jor-el Thomas Caparas,1,0,35,34
1658113347109,MATH 20C,A02,083761,Briones; Jor-el Thomas Caparas,8,0,35,27
1658113347109,MATH 20C,A03,093476,Briones; Jor-el Thomas Caparas,0,1,36,36
1658113347109,MATH 20C,B01,083762,Bach; Quang Tran,1,0,30,29
1658113353133,MATH 20D,A01,083765,Tran; Brian Kha,5,0,30,25
1658113353133,MATH 20D,A02,083766,Tran; Brian Kha,5,0,30,25
1658113353133,MATH 20D,A03,083767,Tran; Brian Kha,6,0,30,24
1658113359157,MATH 20E,A01,083771,Ganguly; Soumya,12,0,32,20
1658113359157,MATH 20E,A02,083772,Ganguly; Soumya,7,0,32,25
1658113359157,MATH 20E,B01,083773,Ciotti; Benjamin,20,0,35,15
1658113359157,MATH 20E,B02,083774,Ciotti; Benjamin,18,0,35,17
1658113365211,MATH 103A,A01,083777,Greenfeld; Be'Eri,6,0,36,30
1658113365211,MATH 103A,A02,083778,Greenfeld; Be'Eri,5,0,36,31
1658113365211,MATH 103A,A03,093561,Greenfeld; Be'Eri,7,0,36,29
1658113365211,MATH 103A,B01,083779,Greenfeld; Be'Eri,8,0,36,28
1658113365211,MATH 103A,B02,083780,Greenfeld; Be'Eri,4,0,36,32
1658113365211,MATH 103A,B03,093562,Greenfeld; Be'Eri,3,0,36,33
1658113371237,MATH 105,A01,085443,Carter; Anne Toulson,15,0,35,20
1658113371237,MATH 105,A02,093477,Carter; Anne Toulson,20,0,35,15
1658113377366,MATH 109,A01,083213,Ganzberger; Geoffrey Michael,3,0,34,31
1658113377366,MATH 109,A02,083214,Ganzberger; Geoffrey Michael,4,0,34,30
1658113377366,MATH 109,A03,093478,Ganzberger; Geoffrey Michael,2,0,34,32
1658113377366,MATH 109,B01,083215,Ganzberger; Geoffrey Michael,3,0,32,29
1658113377366,MATH 109,B02,083216,Ganzberger; Geoffrey Michael,3,0,32,29
1658113377366,MATH 109,B03,093479,Ganzberger; Geoffrey Michael,8,0,32,24
1658113383401,MATH 142A,A01,083219,Chow; Bennett,7,0,32,25
1658113383401,MATH 142A,A02,083220,Chow; Bennett,10,0,32,22
1658113383401,MATH 142A,A03,093480,Chow; Bennett,9,0,32,23
1658113383401,MATH 142A,B03,093481,Chow; Bennett,8,0,32,24
1658113383401,MATH 142A,B04,093558,Chow; Bennett,14,0,32,18
1658113383401,MATH 142A,B05,093559,Chow; Bennett,7,0,32,25
1658113389447,MATH 193A,A01,083224,Rotar; Vladimir,9,0,34,25
1658113389447,MATH 193A,A02,083225,Rotar; Vladimir,11,0,34,23
1658113389447,MATH 193A,A03,083781,Rotar; Vladimir,5,0,34,29
1658113389447,MATH 193A,A04,083782,Rotar; Vladimir,12,0,34,22
1658113389447,MATH 193A,A05,093482,Rotar; Vladimir,11,0,34,23
1658113395478,MATH 197,001,091859,McAuley; Julian John,9999,0,9999,0
1658113395478,MATH 197,002,095566,Kedlaya; Kiran S.,9997,0,9999,2
1658113395478,MATH 197,003,095567,Xiao; Ming,9999,0,9999,0
1658113395478,MATH 197,004,095571,Perols; Johan Lars,9998,0,9999,1
1658113402533,COGS 9,A01,083615,Shannon; Kyle Michael,11,0,75,64
1658113408559,COGS 11,A01,083617,Boyle; Mary E. T.,23,0,48,25
1658113414611,COGS 13,A01,083071,Bastos; Amalia Pinkusfeld,12,0,71,59
1658113420655,COGS 14A,A01,092681,Semenuks; Arturs,5,1,100,95
1658113426683,COGS 14B,A01,083073,Cheng; Tzu-Han,7,0,63,56
1658113432709,COGS 17,A01,092677,Semenuks; Arturs,7,0,81,74
1658113438735,COGS 100,A01,083619,Allen; Michael Gordon,17,0,70,53
1658113444764,COGS 101A,A01,083621,Davis; Joshua Daniel,9,0,68,59
1658113450808,COGS 101B,A01,091572,Allen; Michael Gordon,14,0,65,51
1658113456832,COGS 101C,A01,083625,Delgado; Tania,17,0,35,18
1658113462857,COGS 107A,A01,083627,Boyle; Mary E. T.,14,0,60,46
1658113468885,COGS 118A,A01,083075,Gupta; Anjum,21,0,76,55
1658113474909,CSE 3,A50,083646,Miranda; Gregory Joseph,24,0,50,26
1658113480930,CSE 8A,A50,083650,Miranda; Gregory Joseph,17,1,56,39
1658113486956,CSE 11,A01,083080,Cao; Yingjun,7,15,40,33
1658113492999,CSE 12,A01,083652,Krause-Levy; Sophia Louisa,30,1,120,90
1658113499020,CSE 15L,A01,083654,Morris; Justin Loren,9,0,50,41
1658113499020,CSE 15L,A02,083655,Morris; Justin Loren,11,0,50,39
1658113505047,CSE 20,A01,083657,Tran; Khoa Dang,39,0,80,41
1658113511074,CSE 21,A01,095574,Bach; Quang Tran,23,0,48,25
1658113517110,CSE 30,A01,083084,Eldon; John,8,0,80,72
1658113517110,CSE 30,B01,095061,Bhaskar; Nishant,9,0,50,41
1658113523133,CSE 100,A01,083659,Cao; Yingjun,5,4,70,65
1658113529156,CSE 134B,A01,083661,Powell; Thomas Allan,25,0,100,75
1658113535201,CSE 140,A01,083663,Gungor; Onat,17,0,85,68
1658113541236,CSE 140L,A01,083088,Eldon; John,23,0,100,77
1658113547260,CSE 175,A01,083665,Kumar; Rakesh,3,0,25,22
1658113553286,CSE 190,A00,092507,Dubnov; Shlomo,8,0,20,12
1658113559312,ECE 45,A01,083139,Congero; Spencer William,7,0,75,68
1658113565358,ECE 65,A50,083695,Saad; Andrew S,12,0,30,18
1658113565358,ECE 65,A51,095125,Saad; Andrew S,24,0,26,2
1658113571391,ECE 109,A01,091882,Touri; Behrouz,21,0,70,49
1658113577432,ECE 180,A00,083140,Abi Samra; Nicholas Camill,1,0,30,29
1658113577432,ECE 180,B00,083141,Abi Samra; Nicholas Camill,0,0,30,30
1658113583482,MATH 10A,A01,083735,Patchell; Gregory David,2,0,30,28
1658113583482,MATH 10A,A02,083736,Patchell; Gregory David,20,0,30,10
1658113583482,MATH 10A,A03,083737,Patchell; Gregory David,16,0,30,14
1658113589504,MATH 10B,A01,083207,Lim; Seonhee,9,0,34,25
1658113589504,MATH 10B,A02,083208,Lim; Seonhee,10,0,35,25
1658113589504,MATH 10B,A03,093472,Lim; Seonhee,7,0,34,27
1658113589504,MATH 10B,B01,083739,Sinha; Shubham,14,0,30,16
1658113595542,MATH 18,A01,083743,Cinel; Cameron Alexander,9,0,30,21
1658113595542,MATH 18,A02,083744,Cinel; Cameron Alexander,18,0,30,12
1658113595542,MATH 18,A03,083745,Cinel; Cameron Alexander,10,0,30,20
1658113595542,MATH 18,B01,083748,Rideout; David Porter,5,0,37,32
1658113595542,MATH 18,B02,083749,Rideout; David Porter,5,0,36,31
1658113595542,MATH 18,B03,083750,Rideout; David Porter,3,0,37,34
1658113595542,MATH 18,B04,083751,Rideout; David Porter,7,0,36,29
1658113595542,MATH 18,B05,093473,Rideout; David Porter,7,0,36,29
1658113595542,MATH 18,B06,093474,Rideout; David Porter,6,0,36,30
1658113601565,MATH 20A,A01,083754,Zheng; Zequn,14,0,40,26
1658113607608,MATH 20B,A01,083756,Briones; Jor-el Thomas Caparas,4,0,36,32
1658113607608,MATH 20B,A02,083757,Briones; Jor-el Thomas Caparas,1,0,36,35
1658113607608,MATH 20B,A03,093475,Briones; Jor-el Thomas Caparas,3,0,36,33
1658113613642,MATH 20C,A01,083760,Briones; Jor-el Thomas Caparas,1,0,35,34
1658113613642,MATH 20C,A02,083761,Briones; Jor-el Thomas Caparas,8,0,35,27
1658113613642,MATH 20C,A03,093476,Briones; Jor-el Thomas Caparas,0,1,36,36
1658113613642,MATH 20C,B01,083762,Bach; Quang Tran,1,0,30,29
1658113619665,MATH 20D,A01,083765,Tran; Brian Kha,5,0,30,25
1658113619665,MATH 20D,A02,083766,Tran; Brian Kha,5,0,30,25
1658113619665,MATH 20D,A03,083767,Tran; Brian Kha,6,0,30,24
1658113625702,MATH 20E,A01,083771,Ganguly; Soumya,12,0,32,20
1658113625702,MATH 20E,A02,083772,Ganguly; Soumya,7,0,32,25
1658113625702,MATH 20E,B01,083773,Ciotti; Benjamin,20,0,35,15
1658113625702,MATH 20E,B02,083774,Ciotti; Benjamin,18,0,35,17
1658113631732,MATH 103A,A01,083777,Greenfeld; Be'Eri,6,0,36,30
1658113631732,MATH 103A,A02,083778,Greenfeld; Be'Eri,5,0,36,31
1658113631732,MATH 103A,A03,093561,Greenfeld; Be'Eri,7,0,36,29
1658113631732,MATH 103A,B01,083779,Greenfeld; Be'Eri,8,0,36,28
1658113631732,MATH 103A,B02,083780,Greenfeld; Be'Eri,4,0,36,32
1658113631732,MATH 103A,B03,093562,Greenfeld; Be'Eri,3,0,36,33
1658113637757,MATH 105,A01,085443,Carter; Anne Toulson,15,0,35,20
1658113637757,MATH 105,A02,093477,Carter; Anne Toulson,20,0,35,15
1658113643787,MATH 109,A01,083213,Ganzberger; Geoffrey Michael,3,0,34,31
1658113643787,MATH 109,A02,083214,Ganzberger; Geoffrey Michael,4,0,34,30
1658113643787,MATH 109,A03,093478,Ganzberger; Geoffrey Michael,2,0,34,32
1658113643787,MATH 109,B01,083215,Ganzberger; Geoffrey Michael,3,0,32,29
1658113643787,MATH 109,B02,083216,Ganzberger; Geoffrey Michael,3,0,32,29
1658113643787,MATH 109,B03,093479,Ganzberger; Geoffrey Michael,8,0,32,24
1658113649817,MATH 142A,A01,083219,Chow; Bennett,7,0,32,25
1658113649817,MATH 142A,A02,083220,Chow; Bennett,10,0,32,22
1658113649817,MATH 142A,A03,093480,Chow; Bennett,9,0,32,23
1658113649817,MATH 142A,B03,093481,Chow; Bennett,8,0,32,24
1658113649817,MATH 142A,B04,093558,Chow; Bennett,14,0,32,18
1658113649817,MATH 142A,B05,093559,Chow; Bennett,7,0,32,25
1658113655841,MATH 193A,A01,083224,Rotar; Vladimir,9,0,34,25
1658113655841,MATH 193A,A02,083225,Rotar; Vladimir,11,0,34,23
1658113655841,MATH 193A,A03,083781,Rotar; Vladimir,5,0,34,29
1658113655841,MATH 193A,A04,083782,Rotar; Vladimir,12,0,34,22
1658113655841,MATH 193A,A05,093482,Rotar; Vladimir,11,0,34,23
1658113661890,MATH 197,001,091859,McAuley; Julian John,9999,0,9999,0
1658113661890,MATH 197,002,095566,Kedlaya; Kiran S.,9997,0,9999,2
1658113661890,MATH 197,003,095567,Xiao; Ming,9999,0,9999,0
1658113661890,MATH 197,004,095571,Perols; Johan Lars,9998,0,9999,1
1658113668972,COGS 9,A01,083615,Shannon; Kyle Michael,11,0,75,64
1658113674998,COGS 11,A01,083617,Boyle; Mary E. T.,23,0,48,25
1658113681031,COGS 13,A01,083071,Bastos; Amalia Pinkusfeld,12,0,71,59
1658113687060,COGS 14A,A01,092681,Semenuks; Arturs,5,1,100,95
1658113693100,COGS 14B,A01,083073,Cheng; Tzu-Han,7,0,63,56
1658113699126,COGS 17,A01,092677,Semenuks; Arturs,7,0,81,74
1658113705181,COGS 100,A01,083619,Allen; Michael Gordon,17,0,70,53
1658113711230,COGS 101A,A01,083621,Davis; Joshua Daniel,9,0,68,59
1658113717266,COGS 101B,A01,091572,Allen; Michael Gordon,14,0,65,51
1658113723297,COGS 101C,A01,083625,Delgado; Tania,17,0,35,18
1658113729321,COGS 107A,A01,083627,Boyle; Mary E. T.,14,0,60,46
1658113735349,COGS 118A,A01,083075,Gupta; Anjum,21,0,76,55
1658113741377,CSE 3,A50,083646,Miranda; Gregory Joseph,24,0,50,26
1658113747405,CSE 8A,A50,083650,Miranda; Gregory Joseph,17,1,56,39
1658113753428,CSE 11,A01,083080,Cao; Yingjun,7,15,40,33
1658113759453,CSE 12,A01,083652,Krause-Levy; Sophia Louisa,30,1,120,90
1658113765485,CSE 15L,A01,083654,Morris; Justin Loren,9,0,50,41
1658113765485,CSE 15L,A02,083655,Morris; Justin Loren,11,0,50,39
1658113771520,CSE 20,A01,083657,Tran; Khoa Dang,39,0,80,41
1658113777561,CSE 21,A01,095574,Bach; Quang Tran,23,0,48,25
1658113783588,CSE 30,A01,083084,Eldon; John,8,0,80,72
1658113783588,CSE 30,B01,095061,Bhaskar; Nishant,9,0,50,41
1658113789611,CSE 100,A01,083659,Cao; Yingjun,5,4,70,65
1658113795634,CSE 134B,A01,083661,Powell; Thomas Allan,25,0,100,75
1658113801658,CSE 140,A01,083663,Gungor; Onat,17,0,85,68
1658113807691,CSE 140L,A01,083088,Eldon; John,23,0,100,77
1658113813714,CSE 175,A01,083665,Kumar; Rakesh,3,0,25,22
1658113819740,CSE 190,A00,092507,Dubnov; Shlomo,8,0,20,12
1658113825768,ECE 45,A01,083139,Congero; Spencer William,7,0,75,68
1658113831793,ECE 65,A50,083695,Saad; Andrew S,12,0,30,18
1658113831793,ECE 65,A51,095125,Saad; Andrew S,24,0,26,2
1658113837832,ECE 109,A01,091882,Touri; Behrouz,21,0,70,49
1658113843858,ECE 180,A00,083140,Abi Samra; Nicholas Camill,1,0,30,29
1658113843858,ECE 180,B00,083141,Abi Samra; Nicholas Camill,0,0,30,30
1658113849896,MATH 10A,A01,083735,Patchell; Gregory David,2,0,30,28
1658113849896,MATH 10A,A02,083736,Patchell; Gregory David,20,0,30,10
1658113849896,MATH 10A,A03,083737,Patchell; Gregory David,16,0,30,14
1658113855934,MATH 10B,A01,083207,Lim; Seonhee,9,0,34,25
1658113855934,MATH 10B,A02,083208,Lim; Seonhee,10,0,35,25
1658113855934,MATH 10B,A03,093472,Lim; Seonhee,7,0,34,27
1658113855934,MATH 10B,B01,083739,Sinha; Shubham,14,0,30,16
1658113861965,MATH 18,A01,083743,Cinel; Cameron Alexander,9,0,30,21
1658113861965,MATH 18,A02,083744,Cinel; Cameron Alexander,18,0,30,12
1658113861965,MATH 18,A03,083745,Cinel; Cameron Alexander,10,0,30,20
1658113861965,MATH 18,B01,083748,Rideout; David Porter,5,0,37,32
1658113861965,MATH 18,B02,083749,Rideout; David Porter,5,0,36,31
1658113861965,MATH 18,B03,083750,Rideout; David Porter,3,0,37,34
1658113861965,MATH 18,B04,083751,Rideout; David Porter,7,0,36,29
1658113861965,MATH 18,B05,093473,Rideout; David Porter,7,0,36,29
1658113861965,MATH 18,B06,093474,Rideout; David Porter,6,0,36,30
1658113867991,MATH 20A,A01,083754,Zheng; Zequn,14,0,40,26
1658113874014,MATH 20B,A01,083756,Briones; Jor-el Thomas Caparas,4,0,36,32
1658113874014,MATH 20B,A02,083757,Briones; Jor-el Thomas Caparas,1,0,36,35
1658113874014,MATH 20B,A03,093475,Briones; Jor-el Thomas Caparas,3,0,36,33
1658113880061,MATH 20C,A01,083760,Briones; Jor-el Thomas Caparas,1,0,35,34
1658113880061,MATH 20C,A02,083761,Briones; Jor-el Thomas Caparas,8,0,35,27
1658113880061,MATH 20C,A03,093476,Briones; Jor-el Thomas Caparas,0,1,36,36
1658113880061,MATH 20C,B01,083762,Bach; Quang Tran,1,0,30,29
1658113886088,MATH 20D,A01,083765,Tran; Brian Kha,5,0,30,25
1658113886088,MATH 20D,A02,083766,Tran; Brian Kha,5,0,30,25
1658113886088,MATH 20D,A03,083767,Tran; Brian Kha,6,0,30,24
1658113892113,MATH 20E,A01,083771,Ganguly; Soumya,12,0,32,20
1658113892113,MATH 20E,A02,083772,Ganguly; Soumya,7,0,32,25
1658113892113,MATH 20E,B01,083773,Ciotti; Benjamin,20,0,35,15
1658113892113,MATH 20E,B02,083774,Ciotti; Benjamin,18,0,35,17
1658113898152,MATH 103A,A01,083777,Greenfeld; Be'Eri,6,0,36,30
1658113898152,MATH 103A,A02,083778,Greenfeld; Be'Eri,5,0,36,31
1658113898152,MATH 103A,A03,093561,Greenfeld; Be'Eri,7,0,36,29
1658113898152,MATH 103A,B01,083779,Greenfeld; Be'Eri,8,0,36,28
1658113898152,MATH 103A,B02,083780,Greenfeld; Be'Eri,4,0,36,32
1658113898152,MATH 103A,B03,093562,Greenfeld; Be'Eri,3,0,36,33
1658113904176,MATH 105,A01,085443,Carter; Anne Toulson,15,0,35,20
1658113904176,MATH 105,A02,093477,Carter; Anne Toulson,20,0,35,15
1658113910223,MATH 109,A01,083213,Ganzberger; Geoffrey Michael,3,0,34,31
1658113910223,MATH 109,A02,083214,Ganzberger; Geoffrey Michael,4,0,34,30
1658113910223,MATH 109,A03,093478,Ganzberger; Geoffrey Michael,2,0,34,32
1658113910223,MATH 109,B01,083215,Ganzberger; Geoffrey Michael,3,0,32,29
1658113910223,MATH 109,B02,083216,Ganzberger; Geoffrey Michael,3,0,32,29
1658113910223,MATH 109,B03,093479,Ganzberger; Geoffrey Michael,8,0,32,24
1658113916247,MATH 142A,A01,083219,Chow; Bennett,7,0,32,25
1658113916247,MATH 142A,A02,083220,Chow; Bennett,10,0,32,22
1658113916247,MATH 142A,A03,093480,Chow; Bennett,9,0,32,23
1658113916247,MATH 142A,B03,093481,Chow; Bennett,8,0,32,24
1658113916247,MATH 142A,B04,093558,Chow; Bennett,14,0,32,18
1658113916247,MATH 142A,B05,093559,Chow; Bennett,7,0,32,25
1658113922289,MATH 193A,A01,083224,Rotar; Vladimir,9,0,34,25
1658113922289,MATH 193A,A02,083225,Rotar; Vladimir,11,0,34,23
1658113922289,MATH 193A,A03,083781,Rotar; Vladimir,5,0,34,29
1658113922289,MATH 193A,A04,083782,Rotar; Vladimir,12,0,34,22
1658113922289,MATH 193A,A05,093482,Rotar; Vladimir,11,0,34,23
1658113928315,MATH 197,001,091859,McAuley; Julian John,9999,0,9999,0
1658113928315,MATH 197,002,095566,Kedlaya; Kiran S.,9997,0,9999,2
1658113928315,MATH 197,003,095567,Xiao; Ming,9999,0,9999,0
1658113928315,MATH 197,004,095571,Perols; Johan Lars,9998,0,9999,1
1658113935381,COGS 9,A01,083615,Shannon; Kyle Michael,11,0,75,64
1658113941408,COGS 11,A01,083617,Boyle; Mary E. T.,23,0,48,25
1658113947456,COGS 13,A01,083071,Bastos; Amalia Pinkusfeld,12,0,71,59
1658113953495,COGS 14A,A01,092681,Semenuks; Arturs,5,1,100,95
1658113959522,COGS 14B,A01,083073,Cheng; Tzu-Han,7,0,63,56
1658113965569,COGS 17,A01,092677,Semenuks; Arturs,7,0,81,74
1658113971681,COGS 100,A01,083619,Allen; Michael Gordon,17,0,70,53
1658113977715,COGS 101A,A01,083621,Davis; Joshua Daniel,9,0,68,59
1658113983741,COGS 101B,A01,091572,Allen; Michael Gordon,14,0,65,51
1658113989768,COGS 101C,A01,083625,Delgado; Tania,17,0,35,18
1658113995796,COGS 107A,A01,083627,Boyle; Mary E. T.,14,0,60,46
1658114001833,COGS 118A,A01,083075,Gupta; Anjum,21,0,76,55
1658114007858,CSE 3,A50,083646,Miranda; Gregory Joseph,24,0,50,26
1658114013885,CSE 8A,A50,083650,Miranda; Gregory Joseph,17,1,56,39
1658114019928,CSE 11,A01,083080,Cao; Yingjun,7,15,40,33
1658114025952,CSE 12,A01,083652,Krause-Levy; Sophia Louisa,30,1,120,90
1658114031976,CSE 15L,A01,083654,Morris; Justin Loren,9,0,50,41
1658114031976,CSE 15L,A02,083655,Morris; Justin Loren,11,0,50,39
1658114038003,CSE 20,A01,083657,Tran; Khoa Dang,39,0,80,41
1658114044026,CSE 21,A01,095574,Bach; Quang Tran,23,0,48,25
1658114050054,CSE 30,A01,083084,Eldon; John,8,0,80,72
1658114050054,CSE 30,B01,095061,Bhaskar; Nishant,9,0,50,41
1658114056078,CSE 100,A01,083659,Cao; Yingjun,5,4,70,65
1658114062107,CSE 134B,A01,083661,Powell; Thomas Allan,25,0,100,75
1658114068133,CSE 140,A01,083663,Gungor; Onat,17,0,85,68
1658114074157,CSE 140L,A01,083088,Eldon; John,23,0,100,77
1658114080183,CSE 175,A01,083665,Kumar; Rakesh,3,0,25,22
1658114086206,CSE 190,A00,092507,Dubnov; Shlomo,8,0,20,12
1658114092253,ECE 45,A01,083139,Congero; Spencer William,7,0,75,68
1658114098285,ECE 65,A50,083695,Saad; Andrew S,12,0,30,18
1658114098285,ECE 65,A51,095125,Saad; Andrew S,24,0,26,2
1658114104312,ECE 109,A01,091882,Touri; Behrouz,21,0,70,49
1658114110336,ECE 180,A00,083140,Abi Samra; Nicholas Camill,1,0,30,29
1658114110336,ECE 180,B00,083141,Abi Samra; Nicholas Camill,0,0,30,30
1658114116361,MATH 10A,A01,083735,Patchell; Gregory David,2,0,30,28
1658114116361,MATH 10A,A02,083736,Patchell; Gregory David,20,0,30,10
1658114116361,MATH 10A,A03,083737,Patchell; Gregory David,16,0,30,14
1658114122385,MATH 10B,A01,083207,Lim; Seonhee,9,0,34,25
1658114122385,MATH 10B,A02,083208,Lim; Seonhee,10,0,35,25
1658114122385,MATH 10B,A03,093472,Lim; Seonhee,7,0,34,27
1658114122385,MATH 10B,B01,083739,Sinha; Shubham,14,0,30,16
1658114128410,MATH 18,A01,083743,Cinel; Cameron Alexander,9,0,30,21
1658114128410,MATH 18,A02,083744,Cinel; Cameron Alexander,18,0,30,12
1658114128410,MATH 18,A03,083745,Cinel; Cameron Alexander,10,0,30,20
1658114128410,MATH 18,B01,083748,Rideout; David Porter,5,0,37,32
1658114128410,MATH 18,B02,083749,Rideout; David Porter,5,0,36,31
1658114128410,MATH 18,B03,083750,Rideout; David Porter,3,0,37,34
1658114128410,MATH 18,B04,083751,Rideout; David Porter,7,0,36,29
1658114128410,MATH 18,B05,093473,Rideout; David Porter,7,0,36,29
1658114128410,MATH 18,B06,093474,Rideout; David Porter,6,0,36,30
1658114134464,MATH 20A,A01,083754,Zheng; Zequn,14,0,40,26
1658114140511,MATH 20B,A01,083756,Briones; Jor-el Thomas Caparas,4,0,36,32
1658114140511,MATH 20B,A02,083757,Briones; Jor-el Thomas Caparas,1,0,36,35
1658114140511,MATH 20B,A03,093475,Briones; Jor-el Thomas Caparas,3,0,36,33
1658114146535,MATH 20C,A01,083760,Briones; Jor-el Thomas Caparas,1,0,35,34
1658114146535,MATH 20C,A02,083761,Briones; Jor-el Thomas Caparas,8,0,35,27
1658114146535,MATH 20C,A03,093476,Briones; Jor-el Thomas Caparas,0,1,36,36
1658114146535,MATH 20C,B01,083762,Bach; Quang Tran,1,0,30,29
1658114152560,MATH 20D,A01,083765,Tran; Brian Kha,5,0,30,25
1658114152560,MATH 20D,A02,083766,Tran; Brian Kha,5,0,30,25
1658114152560,MATH 20D,A03,083767,Tran; Brian Kha,6,0,30,24
1658114158585,MATH 20E,A01,083771,Ganguly; Soumya,12,0,32,20
1658114158585,MATH 20E,A02,083772,Ganguly; Soumya,7,0,32,25
1658114158585,MATH 20E,B01,083773,Ciotti; Benjamin,20,0,35,15
1658114158585,MATH 20E,B02,083774,Ciotti; Benjamin,18,0,35,17
1658114164615,MATH 103A,A01,083777,Greenfeld; Be'Eri,6,0,36,30
1658114164615,MATH 103A,A02,083778,Greenfeld; Be'Eri,5,0,36,31
1658114164615,MATH 103A,A03,093561,Greenfeld; Be'Eri,7,0,36,29
1658114164615,MATH 103A,B01,083779,Greenfeld; Be'Eri,8,0,36,28
1658114164615,MATH 103A,B02,083780,Greenfeld; Be'Eri,4,0,36,32
1658114164615,MATH 103A,B03,093562,Greenfeld; Be'Eri,3,0,36,33
1658114170638,MATH 105,A01,085443,Carter; Anne Toulson,15,0,35,20
1658114170638,MATH 105,A02,093477,Carter; Anne Toulson,20,0,35,15
1658114176662,MATH 109,A01,083213,Ganzberger; Geoffrey Michael,3,0,34,31
1658114176662,MATH 109,A02,083214,Ganzberger; Geoffrey Michael,4,0,34,30
1658114176662,MATH 109,A03,093478,Ganzberger; Geoffrey Michael,2,0,34,32
1658114176662,MATH 109,B01,083215,Ganzberger; Geoffrey Michael,3,0,32,29
1658114176662,MATH 109,B02,083216,Ganzberger; Geoffrey Michael,3,0,32,29
1658114176662,MATH 109,B03,093479,Ganzberger; Geoffrey Michael,8,0,32,24
1658114182702,MATH 142A,A01,083219,Chow; Bennett,7,0,32,25
1658114182702,MATH 142A,A02,083220,Chow; Bennett,10,0,32,22
1658114182702,MATH 142A,A03,093480,Chow; Bennett,9,0,32,23
1658114182702,MATH 142A,B03,093481,Chow; Bennett,8,0,32,24
1658114182702,MATH 142A,B04,093558,Chow; Bennett,14,0,32,18
1658114182702,MATH 142A,B05,093559,Chow; Bennett,7,0,32,25
1658114188728,MATH 193A,A01,083224,Rotar; Vladimir,9,0,34,25
1658114188728,MATH 193A,A02,083225,Rotar; Vladimir,11,0,34,23
1658114188728,MATH 193A,A03,083781,Rotar; Vladimir,5,0,34,29
1658114188728,MATH 193A,A04,083782,Rotar; Vladimir,12,0,34,22
1658114188728,MATH 193A,A05,093482,Rotar; Vladimir,11,0,34,23
1658114194753,MATH 197,001,091859,McAuley; Julian John,9999,0,9999,0
1658114194753,MATH 197,002,095566,Kedlaya; Kiran S.,9997,0,9999,2
1658114194753,MATH 197,003,095567,Xiao; Ming,9999,0,9999,0
1658114194753,MATH 197,004,095571,Perols; Johan Lars,9998,0,9999,1
1658114201806,COGS 9,A01,083615,Shannon; Kyle Michael,11,0,75,64
1658114207833,COGS 11,A01,083617,Boyle; Mary E. T.,23,0,48,25
1658114213859,COGS 13,A01,083071,Bastos; Amalia Pinkusfeld,12,0,71,59
1658114219887,COGS 14A,A01,092681,Semenuks; Arturs,5,1,100,95
1658114225911,COGS 14B,A01,083073,Cheng; Tzu-Han,7,0,63,56
1658114231934,COGS 17,A01,092677,Semenuks; Arturs,7,0,81,74
1658114237972,COGS 100,A01,083619,Allen; Michael Gordon,17,0,70,53
1658114243995,COGS 101A,A01,083621,Davis; Joshua Daniel,9,0,68,59
1658114250019,COGS 101B,A01,091572,Allen; Michael Gordon,14,0,65,51
1658114256048,COGS 101C,A01,083625,Delgado; Tania,17,0,35,18
1658114262089,COGS 107A,A01,083627,Boyle; Mary E. T.,14,0,60,46
1658114268112,COGS 118A,A01,083075,Gupta; Anjum,21,0,76,55
1658114274141,CSE 3,A50,083646,Miranda; Gregory Joseph,24,0,50,26
1658114280172,CSE 8A,A50,083650,Miranda; Gregory Joseph,17,1,56,39
1658114286197,CSE 11,A01,083080,Cao; Yingjun,7,15,40,33
1658114292220,CSE 12,A01,083652,Krause-Levy; Sophia Louisa,30,1,120,90
1658114298247,CSE 15L,A01,083654,Morris; Justin Loren,9,0,50,41
1658114298247,CSE 15L,A02,083655,Morris; Justin Loren,11,0,50,39
1658114304270,CSE 20,A01,083657,Tran; Khoa Dang,39,0,80,41
1658114310297,CSE 21,A01,095574,Bach; Quang Tran,23,0,48,25
1658114316322,CSE 30,A01,083084,Eldon; John,8,0,80,72
1658114316322,CSE 30,B01,095061,Bhaskar; Nishant,9,0,50,41
1658114322344,CSE 100,A01,083659,Cao; Yingjun,5,4,70,65
1658114328370,CSE 134B,A01,083661,Powell; Thomas Allan,25,0,100,75
1658114334396,CSE 140,A01,083663,Gungor; Onat,17,0,85,68
1658114340420,CSE 140L,A01,083088,Eldon; John,23,0,100,77
1658114346443,CSE 175,A01,083665,Kumar; Rakesh,3,0,25,22
1658114352476,CSE 190,A00,092507,Dubnov; Shlomo,8,0,20,12
1658114358502,ECE 45,A01,083139,Congero; Spencer William,7,0,75,68
1658114364526,ECE 65,A50,083695,Saad; Andrew S,12,0,30,18
1658114364526,ECE 65,A51,095125,Saad; Andrew S,24,0,26,2
1658114370550,ECE 109,A01,091882,Touri; Behrouz,21,0,70,49
1658114376573,ECE 180,A00,083140,Abi Samra; Nicholas Camill,1,0,30,29
1658114376573,ECE 180,B00,083141,Abi Samra; Nicholas Camill,0,0,30,30
1658114382598,MATH 10A,A01,083735,Patchell; Gregory David,2,0,30,28
1658114382598,MATH 10A,A02,083736,Patchell; Gregory David,20,0,30,10
1658114382598,MATH 10A,A03,083737,Patchell; Gregory David,16,0,30,14
1658114388625,MATH 10B,A01,083207,Lim; Seonhee,9,0,34,25
1658114388625,MATH 10B,A02,083208,Lim; Seonhee,10,0,35,25
1658114388625,MATH 10B,A03,093472,Lim; Seonhee,7,0,34,27
1658114388625,MATH 10B,B01,083739,Sinha; Shubham,14,0,30,16
1658114394649,MATH 18,A01,083743,Cinel; Cameron Alexander,9,0,30,21
1658114394649,MATH 18,A02,083744,Cinel; Cameron Alexander,18,0,30,12
1658114394649,MATH 18,A03,083745,Cinel; Cameron Alexander,10,0,30,20
1658114394649,MATH 18,B01,083748,Rideout; David Porter,5,0,37,32
1658114394649,MATH 18,B02,083749,Rideout; David Porter,5,0,36,31
1658114394649,MATH 18,B03,083750,Rideout; David Porter,3,0,37,34
1658114394649,MATH 18,B04,083751,Rideout; David Porter,7,0,36,29
1658114394649,MATH 18,B05,093473,Rideout; David Porter,7,0,36,29
1658114394649,MATH 18,B06,093474,Rideout; David Porter,6,0,36,30
1658114400683,MATH 20A,A01,083754,Zheng; Zequn,14,0,40,26
1658114406707,MATH 20B,A01,083756,Briones; Jor-el Thomas Caparas,4,0,36,32
1658114406707,MATH 20B,A02,083757,Briones; Jor-el Thomas Caparas,1,0,36,35
1658114406707,MATH 20B,A03,093475,Briones; Jor-el Thomas Caparas,3,0,36,33
1658114412732,MATH 20C,A01,083760,Briones; Jor-el Thomas Caparas,1,0,35,34
1658114412732,MATH 20C,A02,083761,Briones; Jor-el Thomas Caparas,8,0,35,27
1658114412732,MATH 20C,A03,093476,Briones; Jor-el Thomas Caparas,0,1,36,36
1658114412732,MATH 20C,B01,083762,Bach; Quang Tran,1,0,30,29
1658114418761,MATH 20D,A01,083765,Tran; Brian Kha,5,0,30,25
1658114418761,MATH 20D,A02,083766,Tran; Brian Kha,5,0,30,25
1658114418761,MATH 20D,A03,083767,Tran; Brian Kha,6,0,30,24
1658114424789,MATH 20E,A01,083771,Ganguly; Soumya,12,0,32,20
1658114424789,MATH 20E,A02,083772,Ganguly; Soumya,7,0,32,25
1658114424789,MATH 20E,B01,083773,Ciotti; Benjamin,20,0,35,15
1658114424789,MATH 20E,B02,083774,Ciotti; Benjamin,18,0,35,17
1658114430814,MATH 103A,A01,083777,Greenfeld; Be'Eri,6,0,36,30
1658114430814,MATH 103A,A02,083778,Greenfeld; Be'Eri,5,0,36,31
1658114430814,MATH 103A,A03,093561,Greenfeld; Be'Eri,7,0,36,29
1658114430814,MATH 103A,B01,083779,Greenfeld; Be'Eri,8,0,36,28
1658114430814,MATH 103A,B02,083780,Greenfeld; Be'Eri,4,0,36,32
1658114430814,MATH 103A,B03,093562,Greenfeld; Be'Eri,3,0,36,33
1658114436837,MATH 105,A01,085443,Carter; Anne Toulson,15,0,35,20
1658114436837,MATH 105,A02,093477,Carter; Anne Toulson,20,0,35,15
1658114442862,MATH 109,A01,083213,Ganzberger; Geoffrey Michael,3,0,34,31
1658114442862,MATH 109,A02,083214,Ganzberger; Geoffrey Michael,4,0,34,30
1658114442862,MATH 109,A03,093478,Ganzberger; Geoffrey Michael,2,0,34,32
1658114442862,MATH 109,B01,083215,Ganzberger; Geoffrey Michael,3,0,32,29
1658114442862,MATH 109,B02,083216,Ganzberger; Geoffrey Michael,3,0,32,29
1658114442862,MATH 109,B03,093479,Ganzberger; Geoffrey Michael,8,0,32,24
1658114448887,MATH 142A,A01,083219,Chow; Bennett,7,0,32,25
1658114448887,MATH 142A,A02,083220,Chow; Bennett,10,0,32,22
1658114448887,MATH 142A,A03,093480,Chow; Bennett,9,0,32,23
1658114448887,MATH 142A,B03,093481,Chow; Bennett,8,0,32,24
1658114448887,MATH 142A,B04,093558,Chow; Bennett,14,0,32,18
1658114448887,MATH 142A,B05,093559,Chow; Bennett,7,0,32,25
1658114454911,MATH 193A,A01,083224,Rotar; Vladimir,9,0,34,25
1658114454911,MATH 193A,A02,083225,Rotar; Vladimir,11,0,34,23
1658114454911,MATH 193A,A03,083781,Rotar; Vladimir,5,0,34,29
1658114454911,MATH 193A,A04,083782,Rotar; Vladimir,12,0,34,22
1658114454911,MATH 193A,A05,093482,Rotar; Vladimir,11,0,34,23
1658114460945,MATH 197,001,091859,McAuley; Julian John,9999,0,9999,0
1658114460945,MATH 197,002,095566,Kedlaya; Kiran S.,9997,0,9999,2
1658114460945,MATH 197,003,095567,Xiao; Ming,9999,0,9999,0
1658114460945,MATH 197,004,095571,Perols; Johan Lars,9998,0,9999,1
1658114468006,COGS 9,A01,083615,Shannon; Kyle Michael,11,0,75,64
1658114474029,COGS 11,A01,083617,Boyle; Mary E. T.,23,0,48,25
1658114480058,COGS 13,A01,083071,Bastos; Amalia Pinkusfeld,12,0,71,59
1658114486085,COGS 14A,A01,092681,Semenuks; Arturs,5,1,100,95
1658114492113,COGS 14B,A01,083073,Cheng; Tzu-Han,7,0,63,56
1658114498138,COGS 17,A01,092677,Semenuks; Arturs,7,0,81,74
1658114504166,COGS 100,A01,083619,Allen; Michael Gordon,17,0,70,53
1658114510194,COGS 101A,A01,083621,Davis; Joshua Daniel,9,0,68,59
1658114516221,COGS 101B,A01,091572,Allen; Michael Gordon,14,0,65,51
1658114522251,COGS 101C,A01,083625,Delgado; Tania,17,0,35,18
1658114528282,COGS 107A,A01,083627,Boyle; Mary E. T.,14,0,60,46
1658114534306,COGS 118A,A01,083075,Gupta; Anjum,21,0,76,55
1658114540334,CSE 3,A50,083646,Miranda; Gregory Joseph,24,0,50,26
1658114546356,CSE 8A,A50,083650,Miranda; Gregory Joseph,17,1,56,39
1658114552383,CSE 11,A01,083080,Cao; Yingjun,7,15,40,33
1658114558410,CSE 12,A01,083652,Krause-Levy; Sophia Louisa,30,1,120,90
1658114564433,CSE 15L,A01,083654,Morris; Justin Loren,9,0,50,41
1658114564433,CSE 15L,A02,083655,Morris; Justin Loren,11,0,50,39
1658114570552,CSE 20,A01,083657,Tran; Khoa Dang,39,0,80,41
1658114576586,CSE 21,A01,095574,Bach; Quang Tran,23,0,48,25
1658114582611,CSE 30,A01,083084,Eldon; John,8,0,80,72
1658114582611,CSE 30,B01,095061,Bhaskar; Nishant,9,0,50,41
1658114588635,CSE 100,A01,083659,Cao; Yingjun,5,4,70,65
1658114594661,CSE 134B,A01,083661,Powell; Thomas Allan,25,0,100,75
1658114600684,CSE 140,A01,083663,Gungor; Onat,17,0,85,68
1658114606707,CSE 140L,A01,083088,Eldon; John,23,0,100,77
1658114612731,CSE 175,A01,083665,Kumar; Rakesh,3,0,25,22
1658114618753,CSE 190,A00,092507,Dubnov; Shlomo,8,0,20,12
1658114624780,ECE 45,A01,083139,Congero; Spencer William,7,0,75,68
1658114630804,ECE 65,A50,083695,Saad; Andrew S,12,0,30,18
1658114630804,ECE 65,A51,095125,Saad; Andrew S,24,0,26,2
1658114636828,ECE 109,A01,091882,Touri; Behrouz,21,0,70,49
1658114642858,ECE 180,A00,083140,Abi Samra; Nicholas Camill,1,0,30,29
1658114642858,ECE 180,B00,083141,Abi Samra; Nicholas Camill,0,0,30,30
1658114648881,MATH 10A,A01,083735,Patchell; Gregory David,2,0,30,28
1658114648881,MATH 10A,A02,083736,Patchell; Gregory David,20,0,30,10
1658114648881,MATH 10A,A03,083737,Patchell; Gregory David,16,0,30,14
1658114654911,MATH 10B,A01,083207,Lim; Seonhee,9,0,34,25
1658114654911,MATH 10B,A02,083208,Lim; Seonhee,10,0,35,25
1658114654911,MATH 10B,A03,093472,Lim; Seonhee,7,0,34,27
1658114654911,MATH 10B,B01,083739,Sinha; Shubham,14,0,30,16
1658114660936,MATH 18,A01,083743,Cinel; Cameron Alexander,9,0,30,21
1658114660936,MATH 18,A02,083744,Cinel; Cameron Alexander,18,0,30,12
1658114660936,MATH 18,A03,083745,Cinel; Cameron Alexander,10,0,30,20
1658114660936,MATH 18,B01,083748,Rideout; David Porter,5,0,37,32
1658114660936,MATH 18,B02,083749,Rideout; David Porter,5,0,36,31
1658114660936,MATH 18,B03,083750,Rideout; David Porter,3,0,37,34
1658114660936,MATH 18,B04,083751,Rideout; David Porter,7,0,36,29
1658114660936,MATH 18,B05,093473,Rideout; David Porter,7,0,36,29
1658114660936,MATH 18,B06,093474,Rideout; David Porter,6,0,36,30
1658114666959,MATH 20A,A01,083754,Zheng; Zequn,14,0,40,26
1658114672988,MATH 20B,A01,083756,Briones; Jor-el Thomas Caparas,4,0,36,32
1658114672988,MATH 20B,A02,083757,Briones; Jor-el Thomas Caparas,1,0,36,35
1658114672988,MATH 20B,A03,093475,Briones; Jor-el Thomas Caparas,3,0,36,33
1658114679013,MATH 20C,A01,083760,Briones; Jor-el Thomas Caparas,1,0,35,34
1658114679013,MATH 20C,A02,083761,Briones; Jor-el Thomas Caparas,8,0,35,27
1658114679013,MATH 20C,A03,093476,Briones; Jor-el Thomas Caparas,0,1,36,36
1658114679013,MATH 20C,B01,083762,Bach; Quang Tran,1,0,30,29
1658114685040,MATH 20D,A01,083765,Tran; Brian Kha,5,0,30,25
1658114685040,MATH 20D,A02,083766,Tran; Brian Kha,5,0,30,25
1658114685040,MATH 20D,A03,083767,Tran; Brian Kha,6,0,30,24
1658114691073,MATH 20E,A01,083771,Ganguly; Soumya,12,0,32,20
1658114691073,MATH 20E,A02,083772,Ganguly; Soumya,7,0,32,25
1658114691073,MATH 20E,B01,083773,Ciotti; Benjamin,20,0,35,15
1658114691073,MATH 20E,B02,083774,Ciotti; Benjamin,18,0,35,17
1658114697099,MATH 103A,A01,083777,Greenfeld; Be'Eri,6,0,36,30
1658114697099,MATH 103A,A02,083778,Greenfeld; Be'Eri,5,0,36,31
1658114697099,MATH 103A,A03,093561,Greenfeld; Be'Eri,7,0,36,29
1658114697099,MATH 103A,B01,083779,Greenfeld; Be'Eri,8,0,36,28
1658114697099,MATH 103A,B02,083780,Greenfeld; Be'Eri,4,0,36,32
1658114697099,MATH 103A,B03,093562,Greenfeld; Be'Eri,3,0,36,33
1658114703132,MATH 105,A01,085443,Carter; Anne Toulson,15,0,35,20
1658114703132,MATH 105,A02,093477,Carter; Anne Toulson,20,0,35,15
1658114709162,MATH 109,A01,083213,Ganzberger; Geoffrey Michael,3,0,34,31
1658114709162,MATH 109,A02,083214,Ganzberger; Geoffrey Michael,4,0,34,30
1658114709162,MATH 109,A03,093478,Ganzberger; Geoffrey Michael,2,0,34,32
1658114709162,MATH 109,B01,083215,Ganzberger; Geoffrey Michael,3,0,32,29
1658114709162,MATH 109,B02,083216,Ganzberger; Geoffrey Michael,3,0,32,29
1658114709162,MATH 109,B03,093479,Ganzberger; Geoffrey Michael,8,0,32,24
1658114715185,MATH 142A,A01,083219,Chow; Bennett,7,0,32,25
1658114715185,MATH 142A,A02,083220,Chow; Bennett,10,0,32,22
1658114715185,MATH 142A,A03,093480,Chow; Bennett,9,0,32,23
1658114715185,MATH 142A,B03,093481,Chow; Bennett,8,0,32,24
1658114715185,MATH 142A,B04,093558,Chow; Bennett,14,0,32,18
1658114715185,MATH 142A,B05,093559,Chow; Bennett,7,0,32,25
1658114721213,MATH 193A,A01,083224,Rotar; Vladimir,9,0,34,25
1658114721213,MATH 193A,A02,083225,Rotar; Vladimir,11,0,34,23
1658114721213,MATH 193A,A03,083781,Rotar; Vladimir,5,0,34,29
1658114721213,MATH 193A,A04,083782,Rotar; Vladimir,12,0,34,22
1658114721213,MATH 193A,A05,093482,Rotar; Vladimir,11,0,34,23
1658114727244,MATH 197,001,091859,McAuley; Julian John,9999,0,9999,0
1658114727244,MATH 197,002,095566,Kedlaya; Kiran S.,9997,0,9999,2
1658114727244,MATH 197,003,095567,Xiao; Ming,9999,0,9999,0
1658114727244,MATH 197,004,095571,Perols; Johan Lars,9998,0,9999,1
1658114734298,COGS 9,A01,083615,Shannon; Kyle Michael,11,0,75,64
1658114740339,COGS 11,A01,083617,Boyle; Mary E. T.,23,0,48,25
1658114746365,COGS 13,A01,083071,Bastos; Amalia Pinkusfeld,12,0,71,59
1658114752388,COGS 14A,A01,092681,Semenuks; Arturs,5,1,100,95
1658114758411,COGS 14B,A01,083073,Cheng; Tzu-Han,7,0,63,56
1658114764434,COGS 17,A01,092677,Semenuks; Arturs,7,0,81,74
1658114770457,COGS 100,A01,083619,Allen; Michael Gordon,17,0,70,53
1658114776485,COGS 101A,A01,083621,Davis; Joshua Daniel,9,0,68,59
1658114782509,COGS 101B,A01,091572,Allen; Michael Gordon,14,0,65,51
1658114788531,COGS 101C,A01,083625,Delgado; Tania,17,0,35,18
1658114794562,COGS 107A,A01,083627,Boyle; Mary E. T.,14,0,60,46
1658114800589,COGS 118A,A01,083075,Gupta; Anjum,21,0,76,55
1658114806613,CSE 3,A50,083646,Miranda; Gregory Joseph,24,0,50,26
1658114812638,CSE 8A,A50,083650,Miranda; Gregory Joseph,17,1,56,39
1658114818660,CSE 11,A01,083080,Cao; Yingjun,7,15,40,33
1658114824682,CSE 12,A01,083652,Krause-Levy; Sophia Louisa,30,1,120,90
1658114830704,CSE 15L,A01,083654,Morris; Justin Loren,9,0,50,41
1658114830704,CSE 15L,A02,083655,Morris; Justin Loren,11,0,50,39
1658114836732,CSE 20,A01,083657,Tran; Khoa Dang,39,0,80,41
1658114842760,CSE 21,A01,095574,Bach; Quang Tran,23,0,48,25
1658114848785,CSE 30,A01,083084,Eldon; John,8,0,80,72
1658114848785,CSE 30,B01,095061,Bhaskar; Nishant,9,0,50,41
1658114854812,CSE 100,A01,083659,Cao; Yingjun,5,4,70,65
1658114860834,CSE 134B,A01,083661,Powell; Thomas Allan,25,0,100,75
1658114866856,CSE 140,A01,083663,Gungor; Onat,17,0,85,68
1658114872880,CSE 140L,A01,083088,Eldon; John,23,0,100,77
1658114878903,CSE 175,A01,083665,Kumar; Rakesh,3,0,25,22
1658114884934,CSE 190,A00,092507,Dubnov; Shlomo,8,0,20,12
1658114890965,ECE 45,A01,083139,Congero; Spencer William,7,0,75,68
1658114896991,ECE 65,A50,083695,Saad; Andrew S,12,0,30,18
1658114896991,ECE 65,A51,095125,Saad; Andrew S,24,0,26,2
1658114903013,ECE 109,A01,091882,Touri; Behrouz,21,0,70,49
1658114909039,ECE 180,A00,083140,Abi Samra; Nicholas Camill,1,0,30,29
1658114909039,ECE 180,B00,083141,Abi Samra; Nicholas Camill,0,0,30,30
1658114915062,MATH 10A,A01,083735,Patchell; Gregory David,2,0,30,28
1658114915062,MATH 10A,A02,083736,Patchell; Gregory David,20,0,30,10
1658114915062,MATH 10A,A03,083737,Patchell; Gregory David,16,0,30,14
1658114921090,MATH 10B,A01,083207,Lim; Seonhee,9,0,34,25
1658114921090,MATH 10B,A02,083208,Lim; Seonhee,10,0,35,25
1658114921090,MATH 10B,A03,093472,Lim; Seonhee,7,0,34,27
1658114921090,MATH 10B,B01,083739,Sinha; Shubham,14,0,30,16
1658114927115,MATH 18,A01,083743,Cinel; Cameron Alexander,9,0,30,21
1658114927115,MATH 18,A02,083744,Cinel; Cameron Alexander,18,0,30,12
1658114927115,MATH 18,A03,083745,Cinel; Cameron Alexander,10,0,30,20
1658114927115,MATH 18,B01,083748,Rideout; David Porter,5,0,37,32
1658114927115,MATH 18,B02,083749,Rideout; David Porter,5,0,36,31
1658114927115,MATH 18,B03,083750,Rideout; David Porter,3,0,37,34
1658114927115,MATH 18,B04,083751,Rideout; David Porter,7,0,36,29
1658114927115,MATH 18,B05,093473,Rideout; David Porter,7,0,36,29
1658114927115,MATH 18,B06,093474,Rideout; David Porter,6,0,36,30
1658114933144,MATH 20A,A01,083754,Zheng; Zequn,14,0,40,26
1658114939179,MATH 20B,A01,083756,Briones; Jor-el Thomas Caparas,4,0,36,32
1658114939179,MATH 20B,A02,083757,Briones; Jor-el Thomas Caparas,1,0,36,35
1658114939179,MATH 20B,A03,093475,Briones; Jor-el Thomas Caparas,3,0,36,33
1658114945211,MATH 20C,A01,083760,Briones; Jor-el Thomas Caparas,1,0,35,34
1658114945211,MATH 20C,A02,083761,Briones; Jor-el Thomas Caparas,8,0,35,27
1658114945211,MATH 20C,A03,093476,Briones; Jor-el Thomas Caparas,0,1,36,36
1658114945211,MATH 20C,B01,083762,Bach; Quang Tran,1,0,30,29
1658114951236,MATH 20D,A01,083765,Tran; Brian Kha,5,0,30,25
1658114951236,MATH 20D,A02,083766,Tran; Brian Kha,5,0,30,25
1658114951236,MATH 20D,A03,083767,Tran; Brian Kha,6,0,30,24
1658114957265,MATH 20E,A01,083771,Ganguly; Soumya,12,0,32,20
1658114957265,MATH 20E,A02,083772,Ganguly; Soumya,7,0,32,25
1658114957265,MATH 20E,B01,083773,Ciotti; Benjamin,20,0,35,15
1658114957265,MATH 20E,B02,083774,Ciotti; Benjamin,18,0,35,17
1658114963290,MATH 103A,A01,083777,Greenfeld; Be'Eri,6,0,36,30
1658114963290,MATH 103A,A02,083778,Greenfeld; Be'Eri,5,0,36,31
1658114963290,MATH 103A,A03,093561,Greenfeld; Be'Eri,7,0,36,29
1658114963290,MATH 103A,B01,083779,Greenfeld; Be'Eri,8,0,36,28
1658114963290,MATH 103A,B02,083780,Greenfeld; Be'Eri,4,0,36,32
1658114963290,MATH 103A,B03,093562,Greenfeld; Be'Eri,3,0,36,33
1658114969312,MATH 105,A01,085443,Carter; Anne Toulson,15,0,35,20
1658114969312,MATH 105,A02,093477,Carter; Anne Toulson,20,0,35,15
1658114975340,MATH 109,A01,083213,Ganzberger; Geoffrey Michael,3,0,34,31
1658114975340,MATH 109,A02,083214,Ganzberger; Geoffrey Michael,4,0,34,30
1658114975340,MATH 109,A03,093478,Ganzberger; Geoffrey Michael,2,0,34,32
1658114975340,MATH 109,B01,083215,Ganzberger; Geoffrey Michael,3,0,32,29
1658114975340,MATH 109,B02,083216,Ganzberger; Geoffrey Michael,3,0,32,29
1658114975340,MATH 109,B03,093479,Ganzberger; Geoffrey Michael,8,0,32,24
1658114981365,MATH 142A,A01,083219,Chow; Bennett,7,0,32,25
1658114981365,MATH 142A,A02,083220,Chow; Bennett,10,0,32,22
1658114981365,MATH 142A,A03,093480,Chow; Bennett,9,0,32,23
1658114981365,MATH 142A,B03,093481,Chow; Bennett,8,0,32,24
1658114981365,MATH 142A,B04,093558,Chow; Bennett,14,0,32,18
1658114981365,MATH 142A,B05,093559,Chow; Bennett,7,0,32,25
1658114987389,MATH 193A,A01,083224,Rotar; Vladimir,9,0,34,25
1658114987389,MATH 193A,A02,083225,Rotar; Vladimir,11,0,34,23
1658114987389,MATH 193A,A03,083781,Rotar; Vladimir,5,0,34,29
1658114987389,MATH 193A,A04,083782,Rotar; Vladimir,12,0,34,22
1658114987389,MATH 193A,A05,093482,Rotar; Vladimir,11,0,34,23
1658114993412,MATH 197,001,091859,McAuley; Julian John,9999,0,9999,0
1658114993412,MATH 197,002,095566,Kedlaya; Kiran S.,9997,0,9999,2
1658114993412,MATH 197,003,095567,Xiao; Ming,9999,0,9999,0
1658114993412,MATH 197,004,095571,Perols; Johan Lars,9998,0,9999,1
1658115000475,COGS 9,A01,083615,Shannon; Kyle Michael,11,0,75,64
1658115006499,COGS 11,A01,083617,Boyle; Mary E. T.,23,0,48,25
1658115012525,COGS 13,A01,083071,Bastos; Amalia Pinkusfeld,12,0,71,59
1658115018562,COGS 14A,A01,092681,Semenuks; Arturs,5,1,100,95
1658115024590,COGS 14B,A01,083073,Cheng; Tzu-Han,7,0,63,56
1658115030613,COGS 17,A01,092677,Semenuks; Arturs,7,0,81,74
1658115036636,COGS 100,A01,083619,Allen; Michael Gordon,17,0,70,53
1658115042662,COGS 101A,A01,083621,Davis; Joshua Daniel,9,0,68,59
1658115048689,COGS 101B,A01,091572,Allen; Michael Gordon,14,0,65,51
1658115054713,COGS 101C,A01,083625,Delgado; Tania,17,0,35,18
1658115060736,COGS 107A,A01,083627,Boyle; Mary E. T.,14,0,60,46
1658115066762,COGS 118A,A01,083075,Gupta; Anjum,21,0,76,55
1658115072790,CSE 3,A50,083646,Miranda; Gregory Joseph,24,0,50,26
1658115078816,CSE 8A,A50,083650,Miranda; Gregory Joseph,17,1,56,39
1658115084844,CSE 11,A01,083080,Cao; Yingjun,7,15,40,33
1658115090870,CSE 12,A01,083652,Krause-Levy; Sophia Louisa,30,1,120,90
1658115096895,CSE 15L,A01,083654,Morris; Justin Loren,9,0,50,41
1658115096895,CSE 15L,A02,083655,Morris; Justin Loren,11,0,50,39
1658115102921,CSE 20,A01,083657,Tran; Khoa Dang,39,0,80,41
1658115108945,CSE 21,A01,095574,Bach; Quang Tran,23,0,48,25
1658115114976,CSE 30,A01,083084,Eldon; John,8,0,80,72
1658115114976,CSE 30,B01,095061,Bhaskar; Nishant,9,0,50,41
1658115121003,CSE 100,A01,083659,Cao; Yingjun,5,4,70,65
1658115127029,CSE 134B,A01,083661,Powell; Thomas Allan,25,0,100,75
1658115133057,CSE 140,A01,083663,Gungor; Onat,17,0,85,68
1658115139080,CSE 140L,A01,083088,Eldon; John,23,0,100,77
1658115145107,CSE 175,A01,083665,Kumar; Rakesh,3,0,25,22
1658115151133,CSE 190,A00,092507,Dubnov; Shlomo,8,0,20,12
1658115157160,ECE 45,A01,083139,Congero; Spencer William,7,0,75,68
1658115163193,ECE 65,A50,083695,Saad; Andrew S,12,0,30,18
1658115163193,ECE 65,A51,095125,Saad; Andrew S,24,0,26,2
1658115169290,ECE 109,A01,091882,Touri; Behrouz,21,0,70,49
1658115175314,ECE 180,A00,083140,Abi Samra; Nicholas Camill,1,0,30,29
1658115175314,ECE 180,B00,083141,Abi Samra; Nicholas Camill,0,0,30,30
1658115181341,MATH 10A,A01,083735,Patchell; Gregory David,2,0,30,28
1658115181341,MATH 10A,A02,083736,Patchell; Gregory David,20,0,30,10
1658115181341,MATH 10A,A03,083737,Patchell; Gregory David,16,0,30,14
1658115187364,MATH 10B,A01,083207,Lim; Seonhee,9,0,34,25
1658115187364,MATH 10B,A02,083208,Lim; Seonhee,10,0,35,25
1658115187364,MATH 10B,A03,093472,Lim; Seonhee,7,0,34,27
1658115187364,MATH 10B,B01,083739,Sinha; Shubham,14,0,30,16
1658115193390,MATH 18,A01,083743,Cinel; Cameron Alexander,9,0,30,21
1658115193390,MATH 18,A02,083744,Cinel; Cameron Alexander,18,0,30,12
1658115193390,MATH 18,A03,083745,Cinel; Cameron Alexander,10,0,30,20
1658115193390,MATH 18,B01,083748,Rideout; David Porter,5,0,37,32
1658115193390,MATH 18,B02,083749,Rideout; David Porter,5,0,36,31
1658115193390,MATH 18,B03,083750,Rideout; David Porter,3,0,37,34
1658115193390,MATH 18,B04,083751,Rideout; David Porter,7,0,36,29
1658115193390,MATH 18,B05,093473,Rideout; David Porter,7,0,36,29
1658115193390,MATH 18,B06,093474,Rideout; David Porter,6,0,36,30
1658115199415,MATH 20A,A01,083754,Zheng; Zequn,14,0,40,26
1658115205438,MATH 20B,A01,083756,Briones; Jor-el Thomas Caparas,4,0,36,32
1658115205438,MATH 20B,A02,083757,Briones; Jor-el Thomas Caparas,1,0,36,35
1658115205438,MATH 20B,A03,093475,Briones; Jor-el Thomas Caparas,3,0,36,33
1658115211460,MATH 20C,A01,083760,Briones; Jor-el Thomas Caparas,1,0,35,34
1658115211460,MATH 20C,A02,083761,Briones; Jor-el Thomas Caparas,8,0,35,27
1658115211460,MATH 20C,A03,093476,Briones; Jor-el Thomas Caparas,0,1,36,36
1658115211460,MATH 20C,B01,083762,Bach; Quang Tran,1,0,30,29
1658115217501,MATH 20D,A01,083765,Tran; Brian Kha,5,0,30,25
1658115217501,MATH 20D,A02,083766,Tran; Brian Kha,5,0,30,25
1658115217501,MATH 20D,A03,083767,Tran; Brian Kha,6,0,30,24
1658115223524,MATH 20E,A01,083771,Ganguly; Soumya,12,0,32,20
1658115223524,MATH 20E,A02,083772,Ganguly; Soumya,7,0,32,25
1658115223524,MATH 20E,B01,083773,Ciotti; Benjamin,20,0,35,15
1658115223524,MATH 20E,B02,083774,Ciotti; Benjamin,18,0,35,17
1658115229548,MATH 103A,A01,083777,Greenfeld; Be'Eri,6,0,36,30
1658115229548,MATH 103A,A02,083778,Greenfeld; Be'Eri,5,0,36,31
1658115229548,MATH 103A,A03,093561,Greenfeld; Be'Eri,7,0,36,29
1658115229548,MATH 103A,B01,083779,Greenfeld; Be'Eri,8,0,36,28
1658115229548,MATH 103A,B02,083780,Greenfeld; Be'Eri,4,0,36,32
1658115229548,MATH 103A,B03,093562,Greenfeld; Be'Eri,3,0,36,33
1658115235571,MATH 105,A01,085443,Carter; Anne Toulson,15,0,35,20
1658115235571,MATH 105,A02,093477,Carter; Anne Toulson,20,0,35,15
1658115241595,MATH 109,A01,083213,Ganzberger; Geoffrey Michael,3,0,34,31
1658115241595,MATH 109,A02,083214,Ganzberger; Geoffrey Michael,4,0,34,30
1658115241595,MATH 109,A03,093478,Ganzberger; Geoffrey Michael,2,0,34,32
1658115241595,MATH 109,B01,083215,Ganzberger; Geoffrey Michael,3,0,32,29
1658115241595,MATH 109,B02,083216,Ganzberger; Geoffrey Michael,3,0,32,29
1658115241595,MATH 109,B03,093479,Ganzberger; Geoffrey Michael,8,0,32,24
1658115247624,MATH 142A,A01,083219,Chow; Bennett,7,0,32,25
1658115247624,MATH 142A,A02,083220,Chow; Bennett,10,0,32,22
1658115247624,MATH 142A,A03,093480,Chow; Bennett,9,0,32,23
1658115247624,MATH 142A,B03,093481,Chow; Bennett,8,0,32,24
1658115247624,MATH 142A,B04,093558,Chow; Bennett,14,0,32,18
1658115247624,MATH 142A,B05,093559,Chow; Bennett,7,0,32,25
1658115253654,MATH 193A,A01,083224,Rotar; Vladimir,9,0,34,25
1658115253654,MATH 193A,A02,083225,Rotar; Vladimir,11,0,34,23
1658115253654,MATH 193A,A03,083781,Rotar; Vladimir,5,0,34,29
1658115253654,MATH 193A,A04,083782,Rotar; Vladimir,12,0,34,22
1658115253654,MATH 193A,A05,093482,Rotar; Vladimir,11,0,34,23
1658115259678,MATH 197,001,091859,McAuley; Julian John,9999,0,9999,0
1658115259678,MATH 197,002,095566,Kedlaya; Kiran S.,9997,0,9999,2
1658115259678,MATH 197,003,095567,Xiao; Ming,9999,0,9999,0
1658115259678,MATH 197,004,095571,Perols; Johan Lars,9998,0,9999,1
1658115266733,COGS 9,A01,083615,Shannon; Kyle Michael,11,0,75,64
1658115272884,COGS 11,A01,083617,Boyle; Mary E. T.,23,0,48,25
1658115278910,COGS 13,A01,083071,Bastos; Amalia Pinkusfeld,12,0,71,59
1658115284938,COGS 14A,A01,092681,Semenuks; Arturs,5,1,100,95
1658115290966,COGS 14B,A01,083073,Cheng; Tzu-Han,7,0,63,56
1658115296990,COGS 17,A01,092677,Semenuks; Arturs,7,0,81,74
1658115303018,COGS 100,A01,083619,Allen; Michael Gordon,17,0,70,53
1658115309044,COGS 101A,A01,083621,Davis; Joshua Daniel,9,0,68,59
1658115315067,COGS 101B,A01,091572,Allen; Michael Gordon,14,0,65,51
1658115321091,COGS 101C,A01,083625,Delgado; Tania,17,0,35,18
1658115327134,COGS 107A,A01,083627,Boyle; Mary E. T.,14,0,60,46
1658115333160,COGS 118A,A01,083075,Gupta; Anjum,21,0,76,55
1658115339188,CSE 3,A50,083646,Miranda; Gregory Joseph,24,0,50,26
1658115345212,CSE 8A,A50,083650,Miranda; Gregory Joseph,17,1,56,39
1658115351239,CSE 11,A01,083080,Cao; Yingjun,7,15,40,33
1658115357261,CSE 12,A01,083652,Krause-Levy; Sophia Louisa,30,1,120,90
1658115363285,CSE 15L,A01,083654,Morris; Justin Loren,9,0,50,41
1658115363285,CSE 15L,A02,083655,Morris; Justin Loren,11,0,50,39
1658115369307,CSE 20,A01,083657,Tran; Khoa Dang,39,0,80,41
1658115375333,CSE 21,A01,095574,Bach; Quang Tran,23,0,48,25
1658115381355,CSE 30,A01,083084,Eldon; John,8,0,80,72
1658115381355,CSE 30,B01,095061,Bhaskar; Nishant,9,0,50,41
1658115387381,CSE 100,A01,083659,Cao; Yingjun,5,4,70,65
1658115393407,CSE 134B,A01,083661,Powell; Thomas Allan,25,0,100,75
1658115399434,CSE 140,A01,083663,Gungor; Onat,17,0,85,68
1658115405457,CSE 140L,A01,083088,Eldon; John,23,0,100,77
1658115411483,CSE 175,A01,083665,Kumar; Rakesh,3,0,25,22
1658115417506,CSE 190,A00,092507,Dubnov; Shlomo,8,0,20,12
1658115423530,ECE 45,A01,083139,Congero; Spencer William,7,0,75,68
1658115429552,ECE 65,A50,083695,Saad; Andrew S,12,0,30,18
1658115429552,ECE 65,A51,095125,Saad; Andrew S,24,0,26,2
1658115435578,ECE 109,A01,091882,Touri; Behrouz,21,0,70,49
1658115441601,ECE 180,A00,083140,Abi Samra; Nicholas Camill,1,0,30,29
1658115441601,ECE 180,B00,083141,Abi Samra; Nicholas Camill,0,0,30,30
1658115447641,MATH 10A,A01,083735,Patchell; Gregory David,2,0,30,28
1658115447641,MATH 10A,A02,083736,Patchell; Gregory David,20,0,30,10
1658115447641,MATH 10A,A03,083737,Patchell; Gregory David,16,0,30,14
1658115453667,MATH 10B,A01,083207,Lim; Seonhee,9,0,34,25
1658115453667,MATH 10B,A02,083208,Lim; Seonhee,10,0,35,25
1658115453667,MATH 10B,A03,093472,Lim; Seonhee,7,0,34,27
1658115453667,MATH 10B,B01,083739,Sinha; Shubham,14,0,30,16
1658115459692,MATH 18,A01,083743,Cinel; Cameron Alexander,9,0,30,21
1658115459692,MATH 18,A02,083744,Cinel; Cameron Alexander,18,0,30,12
1658115459692,MATH 18,A03,083745,Cinel; Cameron Alexander,10,0,30,20
1658115459692,MATH 18,B01,083748,Rideout; David Porter,5,0,37,32
1658115459692,MATH 18,B02,083749,Rideout; David Porter,5,0,36,31
1658115459692,MATH 18,B03,083750,Rideout; David Porter,3,0,37,34
1658115459692,MATH 18,B04,083751,Rideout; David Porter,7,0,36,29
1658115459692,MATH 18,B05,093473,Rideout; David Porter,7,0,36,29
1658115459692,MATH 18,B06,093474,Rideout; David Porter,6,0,36,30
1658115465715,MATH 20A,A01,083754,Zheng; Zequn,14,0,40,26
1658115471737,MATH 20B,A01,083756,Briones; Jor-el Thomas Caparas,4,0,36,32
1658115471737,MATH 20B,A02,083757,Briones; Jor-el Thomas Caparas,1,0,36,35
1658115471737,MATH 20B,A03,093475,Briones; Jor-el Thomas Caparas,3,0,36,33
1658115477766,MATH 20C,A01,083760,Briones; Jor-el Thomas Caparas,1,0,35,34
1658115477766,MATH 20C,A02,083761,Briones; Jor-el Thomas Caparas,8,0,35,27
1658115477766,MATH 20C,A03,093476,Briones; Jor-el Thomas Caparas,0,1,36,36
1658115477766,MATH 20C,B01,083762,Bach; Quang Tran,1,0,30,29
1658115483795,MATH 20D,A01,083765,Tran; Brian Kha,5,0,30,25
1658115483795,MATH 20D,A02,083766,Tran; Brian Kha,5,0,30,25
1658115483795,MATH 20D,A03,083767,Tran; Brian Kha,6,0,30,24
1658115489819,MATH 20E,A01,083771,Ganguly; Soumya,12,0,32,20
1658115489819,MATH 20E,A02,083772,Ganguly; Soumya,7,0,32,25
1658115489819,MATH 20E,B01,083773,Ciotti; Benjamin,20,0,35,15
1658115489819,MATH 20E,B02,083774,Ciotti; Benjamin,18,0,35,17
1658115495842,MATH 103A,A01,083777,Greenfeld; Be'Eri,6,0,36,30
1658115495842,MATH 103A,A02,083778,Greenfeld; Be'Eri,5,0,36,31
1658115495842,MATH 103A,A03,093561,Greenfeld; Be'Eri,7,0,36,29
1658115495842,MATH 103A,B01,083779,Greenfeld; Be'Eri,8,0,36,28
1658115495842,MATH 103A,B02,083780,Greenfeld; Be'Eri,4,0,36,32
1658115495842,MATH 103A,B03,093562,Greenfeld; Be'Eri,3,0,36,33
1658115501869,MATH 105,A01,085443,Carter; Anne Toulson,15,0,35,20
1658115501869,MATH 105,A02,093477,Carter; Anne Toulson,20,0,35,15
1658115507897,MATH 109,A01,083213,Ganzberger; Geoffrey Michael,3,0,34,31
1658115507897,MATH 109,A02,083214,Ganzberger; Geoffrey Michael,4,0,34,30
1658115507897,MATH 109,A03,093478,Ganzberger; Geoffrey Michael,2,0,34,32
1658115507897,MATH 109,B01,083215,Ganzberger; Geoffrey Michael,3,0,32,29
1658115507897,MATH 109,B02,083216,Ganzberger; Geoffrey Michael,3,0,32,29
1658115507897,MATH 109,B03,093479,Ganzberger; Geoffrey Michael,8,0,32,24
1658115513921,MATH 142A,A01,083219,Chow; Bennett,7,0,32,25
1658115513921,MATH 142A,A02,083220,Chow; Bennett,10,0,32,22
1658115513921,MATH 142A,A03,093480,Chow; Bennett,9,0,32,23
1658115513921,MATH 142A,B03,093481,Chow; Bennett,8,0,32,24
1658115513921,MATH 142A,B04,093558,Chow; Bennett,14,0,32,18
1658115513921,MATH 142A,B05,093559,Chow; Bennett,7,0,32,25
1658115519944,MATH 193A,A01,083224,Rotar; Vladimir,9,0,34,25
1658115519944,MATH 193A,A02,083225,Rotar; Vladimir,11,0,34,23
1658115519944,MATH 193A,A03,083781,Rotar; Vladimir,5,0,34,29
1658115519944,MATH 193A,A04,083782,Rotar; Vladimir,12,0,34,22
1658115519944,MATH 193A,A05,093482,Rotar; Vladimir,11,0,34,23
1658115525967,MATH 197,001,091859,McAuley; Julian John,9999,0,9999,0
1658115525967,MATH 197,002,095566,Kedlaya; Kiran S.,9997,0,9999,2
1658115525967,MATH 197,003,095567,Xiao; Ming,9999,0,9999,0
1658115525967,MATH 197,004,095571,Perols; Johan Lars,9998,0,9999,1
1658115533032,COGS 9,A01,083615,Shannon; Kyle Michael,11,0,75,64
1658115539058,COGS 11,A01,083617,Boyle; Mary E. T.,23,0,48,25
1658115545083,COGS 13,A01,083071,Bastos; Amalia Pinkusfeld,12,0,71,59
1658115551108,COGS 14A,A01,092681,Semenuks; Arturs,5,1,100,95
1658115557132,COGS 14B,A01,083073,Cheng; Tzu-Han,7,0,63,56
1658115563154,COGS 17,A01,092677,Semenuks; Arturs,7,0,81,74
1658115569179,COGS 100,A01,083619,Allen; Michael Gordon,17,0,70,53
1658115575203,COGS 101A,A01,083621,Davis; Joshua Daniel,9,0,68,59
1658115581229,COGS 101B,A01,091572,Allen; Michael Gordon,14,0,65,51
1658115587252,COGS 101C,A01,083625,Delgado; Tania,17,0,35,18
1658115593280,COGS 107A,A01,083627,Boyle; Mary E. T.,14,0,60,46
1658115599307,COGS 118A,A01,083075,Gupta; Anjum,21,0,76,55
1658115605331,CSE 3,A50,083646,Miranda; Gregory Joseph,24,0,50,26
1658115611355,CSE 8A,A50,083650,Miranda; Gregory Joseph,17,1,56,39
1658115617389,CSE 11,A01,083080,Cao; Yingjun,7,15,40,33
1658115623413,CSE 12,A01,083652,Krause-Levy; Sophia Louisa,30,1,120,90
1658115629437,CSE 15L,A01,083654,Morris; Justin Loren,9,0,50,41
1658115629437,CSE 15L,A02,083655,Morris; Justin Loren,11,0,50,39
1658115635464,CSE 20,A01,083657,Tran; Khoa Dang,39,0,80,41
1658115641487,CSE 21,A01,095574,Bach; Quang Tran,23,0,48,25
1658115647515,CSE 30,A01,083084,Eldon; John,8,0,80,72
1658115647515,CSE 30,B01,095061,Bhaskar; Nishant,9,0,50,41
1658115653542,CSE 100,A01,083659,Cao; Yingjun,5,4,70,65
1658115659568,CSE 134B,A01,083661,Powell; Thomas Allan,25,0,100,75
1658115665594,CSE 140,A01,083663,Gungor; Onat,17,0,85,68
1658115671616,CSE 140L,A01,083088,Eldon; John,23,0,100,77
1658115677640,CSE 175,A01,083665,Kumar; Rakesh,3,0,25,22
1658115683666,CSE 190,A00,092507,Dubnov; Shlomo,8,0,20,12
1658115689693,ECE 45,A01,083139,Congero; Spencer William,7,0,75,68
1658115695716,ECE 65,A50,083695,Saad; Andrew S,12,0,30,18
1658115695716,ECE 65,A51,095125,Saad; Andrew S,24,0,26,2
1658115701739,ECE 109,A01,091882,Touri; Behrouz,21,0,70,49
1658115707766,ECE 180,A00,083140,Abi Samra; Nicholas Camill,1,0,30,29
1658115707766,ECE 180,B00,083141,Abi Samra; Nicholas Camill,0,0,30,30
1658115713790,MATH 10A,A01,083735,Patchell; Gregory David,2,0,30,28
1658115713790,MATH 10A,A02,083736,Patchell; Gregory David,20,0,30,10
1658115713790,MATH 10A,A03,083737,Patchell; Gregory David,16,0,30,14
1658115719814,MATH 10B,A01,083207,Lim; Seonhee,9,0,34,25
1658115719814,MATH 10B,A02,083208,Lim; Seonhee,10,0,35,25
1658115719814,MATH 10B,A03,093472,Lim; Seonhee,7,0,34,27
1658115719814,MATH 10B,B01,083739,Sinha; Shubham,14,0,30,16
1658115725846,MATH 18,A01,083743,Cinel; Cameron Alexander,9,0,30,21
1658115725846,MATH 18,A02,083744,Cinel; Cameron Alexander,18,0,30,12
1658115725846,MATH 18,A03,083745,Cinel; Cameron Alexander,10,0,30,20
1658115725846,MATH 18,B01,083748,Rideout; David Porter,5,0,37,32
1658115725846,MATH 18,B02,083749,Rideout; David Porter,5,0,36,31
1658115725846,MATH 18,B03,083750,Rideout; David Porter,3,0,37,34
1658115725846,MATH 18,B04,083751,Rideout; David Porter,7,0,36,29
1658115725846,MATH 18,B05,093473,Rideout; David Porter,7,0,36,29
1658115725846,MATH 18,B06,093474,Rideout; David Porter,6,0,36,30
1658115731869,MATH 20A,A01,083754,Zheng; Zequn,14,0,40,26
1658115737906,MATH 20B,A01,083756,Briones; Jor-el Thomas Caparas,4,0,36,32
1658115737906,MATH 20B,A02,083757,Briones; Jor-el Thomas Caparas,1,0,36,35
1658115737906,MATH 20B,A03,093475,Briones; Jor-el Thomas Caparas,3,0,36,33
1658115743931,MATH 20C,A01,083760,Briones; Jor-el Thomas Caparas,1,0,35,34
1658115743931,MATH 20C,A02,083761,Briones; Jor-el Thomas Caparas,8,0,35,27
1658115743931,MATH 20C,A03,093476,Briones; Jor-el Thomas Caparas,0,1,36,36
1658115743931,MATH 20C,B01,083762,Bach; Quang Tran,1,0,30,29
1658115749954,MATH 20D,A01,083765,Tran; Brian Kha,5,0,30,25
1658115749954,MATH 20D,A02,083766,Tran; Brian Kha,5,0,30,25
1658115749954,MATH 20D,A03,083767,Tran; Brian Kha,6,0,30,24
1658115755979,MATH 20E,A01,083771,Ganguly; Soumya,12,0,32,20
1658115755979,MATH 20E,A02,083772,Ganguly; Soumya,7,0,32,25
1658115755979,MATH 20E,B01,083773,Ciotti; Benjamin,20,0,35,15
1658115755979,MATH 20E,B02,083774,Ciotti; Benjamin,18,0,35,17
1658115762009,MATH 103A,A01,083777,Greenfeld; Be'Eri,6,0,36,30
1658115762009,MATH 103A,A02,083778,Greenfeld; Be'Eri,5,0,36,31
1658115762009,MATH 103A,A03,093561,Greenfeld; Be'Eri,7,0,36,29
1658115762009,MATH 103A,B01,083779,Greenfeld; Be'Eri,8,0,36,28
1658115762009,MATH 103A,B02,083780,Greenfeld; Be'Eri,4,0,36,32
1658115762009,MATH 103A,B03,093562,Greenfeld; Be'Eri,3,0,36,33
1658115768104,MATH 105,A01,085443,Carter; Anne Toulson,15,0,35,20
1658115768104,MATH 105,A02,093477,Carter; Anne Toulson,20,0,35,15
1658115774133,MATH 109,A01,083213,Ganzberger; Geoffrey Michael,3,0,34,31
1658115774133,MATH 109,A02,083214,Ganzberger; Geoffrey Michael,4,0,34,30
1658115774133,MATH 109,A03,093478,Ganzberger; Geoffrey Michael,2,0,34,32
1658115774133,MATH 109,B01,083215,Ganzberger; Geoffrey Michael,3,0,32,29
1658115774133,MATH 109,B02,083216,Ganzberger; Geoffrey Michael,3,0,32,29
1658115774133,MATH 109,B03,093479,Ganzberger; Geoffrey Michael,8,0,32,24
1658115780161,MATH 142A,A01,083219,Chow; Bennett,7,0,32,25
1658115780161,MATH 142A,A02,083220,Chow; Bennett,10,0,32,22
1658115780161,MATH 142A,A03,093480,Chow; Bennett,9,0,32,23
1658115780161,MATH 142A,B03,093481,Chow; Bennett,8,0,32,24
1658115780161,MATH 142A,B04,093558,Chow; Bennett,14,0,32,18
1658115780161,MATH 142A,B05,093559,Chow; Bennett,7,0,32,25
1658115786189,MATH 193A,A01,083224,Rotar; Vladimir,9,0,34,25
1658115786189,MATH 193A,A02,083225,Rotar; Vladimir,11,0,34,23
1658115786189,MATH 193A,A03,083781,Rotar; Vladimir,5,0,34,29
1658115786189,MATH 193A,A04,083782,Rotar; Vladimir,12,0,34,22
1658115786189,MATH 193A,A05,093482,Rotar; Vladimir,11,0,34,23
1658115792212,MATH 197,001,091859,McAuley; Julian John,9999,0,9999,0
1658115792212,MATH 197,002,095566,Kedlaya; Kiran S.,9997,0,9999,2
1658115792212,MATH 197,003,095567,Xiao; Ming,9999,0,9999,0
1658115792212,MATH 197,004,095571,Perols; Johan Lars,9998,0,9999,1
1658115799278,COGS 9,A01,083615,Shannon; Kyle Michael,11,0,75,64
1658115805302,COGS 11,A01,083617,Boyle; Mary E. T.,23,0,48,25
1658115811328,COGS 13,A01,083071,Bastos; Amalia Pinkusfeld,12,0,71,59
1658115817351,COGS 14A,A01,092681,Semenuks; Arturs,5,1,100,95
1658115823377,COGS 14B,A01,083073,Cheng; Tzu-Han,7,0,63,56
1658115829404,COGS 17,A01,092677,Semenuks; Arturs,7,0,81,74
1658115835427,COGS 100,A01,083619,Allen; Michael Gordon,17,0,70,53
1658115841452,COGS 101A,A01,083621,Davis; Joshua Daniel,9,0,68,59
1658115847476,COGS 101B,A01,091572,Allen; Michael Gordon,14,0,65,51
1658115853500,COGS 101C,A01,083625,Delgado; Tania,17,0,35,18
1658115859526,COGS 107A,A01,083627,Boyle; Mary E. T.,14,0,60,46
1658115865553,COGS 118A,A01,083075,Gupta; Anjum,21,0,76,55
1658115871579,CSE 3,A50,083646,Miranda; Gregory Joseph,24,0,50,26
1658115877603,CSE 8A,A50,083650,Miranda; Gregory Joseph,17,1,56,39
1658115883629,CSE 11,A01,083080,Cao; Yingjun,7,15,40,33
1658115889659,CSE 12,A01,083652,Krause-Levy; Sophia Louisa,30,1,120,90
1658115895687,CSE 15L,A01,083654,Morris; Justin Loren,9,0,50,41
1658115895687,CSE 15L,A02,083655,Morris; Justin Loren,11,0,50,39
1658115901715,CSE 20,A01,083657,Tran; Khoa Dang,39,0,80,41
1658115907741,CSE 21,A01,095574,Bach; Quang Tran,23,0,48,25
1658115913763,CSE 30,A01,083084,Eldon; John,8,0,80,72
1658115913763,CSE 30,B01,095061,Bhaskar; Nishant,9,0,50,41
1658115919785,CSE 100,A01,083659,Cao; Yingjun,5,4,70,65
1658115925808,CSE 134B,A01,083661,Powell; Thomas Allan,25,0,100,75
1658115931835,CSE 140,A01,083663,Gungor; Onat,17,0,85,68
1658115937859,CSE 140L,A01,083088,Eldon; John,23,0,100,77
1658115943882,CSE 175,A01,083665,Kumar; Rakesh,3,0,25,22
1658115949908,CSE 190,A00,092507,Dubnov; Shlomo,8,0,20,12
1658115955932,ECE 45,A01,083139,Congero; Spencer William,7,0,75,68
1658115961959,ECE 65,A50,083695,Saad; Andrew S,12,0,30,18
1658115961959,ECE 65,A51,095125,Saad; Andrew S,24,0,26,2
1658115967980,ECE 109,A01,091882,Touri; Behrouz,21,0,70,49
1658115974009,ECE 180,A00,083140,Abi Samra; Nicholas Camill,1,0,30,29
1658115974009,ECE 180,B00,083141,Abi Samra; Nicholas Camill,0,0,30,30
1658115980034,MATH 10A,A01,083735,Patchell; Gregory David,2,0,30,28
1658115980034,MATH 10A,A02,083736,Patchell; Gregory David,20,0,30,10
1658115980034,MATH 10A,A03,083737,Patchell; Gregory David,16,0,30,14
1658115986059,MATH 10B,A01,083207,Lim; Seonhee,9,0,34,25
1658115986059,MATH 10B,A02,083208,Lim; Seonhee,10,0,35,25
1658115986059,MATH 10B,A03,093472,Lim; Seonhee,7,0,34,27
1658115986059,MATH 10B,B01,083739,Sinha; Shubham,14,0,30,16
1658115992089,MATH 18,A01,083743,Cinel; Cameron Alexander,9,0,30,21
1658115992089,MATH 18,A02,083744,Cinel; Cameron Alexander,18,0,30,12
1658115992089,MATH 18,A03,083745,Cinel; Cameron Alexander,10,0,30,20
1658115992089,MATH 18,B01,083748,Rideout; David Porter,5,0,37,32
1658115992089,MATH 18,B02,083749,Rideout; David Porter,5,0,36,31
1658115992089,MATH 18,B03,083750,Rideout; David Porter,3,0,37,34
1658115992089,MATH 18,B04,083751,Rideout; David Porter,7,0,36,29
1658115992089,MATH 18,B05,093473,Rideout; David Porter,7,0,36,29
1658115992089,MATH 18,B06,093474,Rideout; David Porter,6,0,36,30
1658115998117,MATH 20A,A01,083754,Zheng; Zequn,14,0,40,26
1658116004140,MATH 20B,A01,083756,Briones; Jor-el Thomas Caparas,4,0,36,32
1658116004140,MATH 20B,A02,083757,Briones; Jor-el Thomas Caparas,1,0,36,35
1658116004140,MATH 20B,A03,093475,Briones; Jor-el Thomas Caparas,3,0,36,33
1658116010169,MATH 20C,A01,083760,Briones; Jor-el Thomas Caparas,1,0,35,34
1658116010169,MATH 20C,A02,083761,Briones; Jor-el Thomas Caparas,8,0,35,27
1658116010169,MATH 20C,A03,093476,Briones; Jor-el Thomas Caparas,0,1,36,36
1658116010169,MATH 20C,B01,083762,Bach; Quang Tran,1,0,30,29
1658116016193,MATH 20D,A01,083765,Tran; Brian Kha,5,0,30,25
1658116016193,MATH 20D,A02,083766,Tran; Brian Kha,5,0,30,25
1658116016193,MATH 20D,A03,083767,Tran; Brian Kha,6,0,30,24
1658116022217,MATH 20E,A01,083771,Ganguly; Soumya,12,0,32,20
1658116022217,MATH 20E,A02,083772,Ganguly; Soumya,7,0,32,25
1658116022217,MATH 20E,B01,083773,Ciotti; Benjamin,20,0,35,15
1658116022217,MATH 20E,B02,083774,Ciotti; Benjamin,18,0,35,17
1658116028247,MATH 103A,A01,083777,Greenfeld; Be'Eri,6,0,36,30
1658116028247,MATH 103A,A02,083778,Greenfeld; Be'Eri,5,0,36,31
1658116028247,MATH 103A,A03,093561,Greenfeld; Be'Eri,7,0,36,29
1658116028247,MATH 103A,B01,083779,Greenfeld; Be'Eri,8,0,36,28
1658116028247,MATH 103A,B02,083780,Greenfeld; Be'Eri,4,0,36,32
1658116028247,MATH 103A,B03,093562,Greenfeld; Be'Eri,3,0,36,33
1658116034275,MATH 105,A01,085443,Carter; Anne Toulson,15,0,35,20
1658116034275,MATH 105,A02,093477,Carter; Anne Toulson,20,0,35,15
1658116040303,MATH 109,A01,083213,Ganzberger; Geoffrey Michael,3,0,34,31
1658116040303,MATH 109,A02,083214,Ganzberger; Geoffrey Michael,4,0,34,30
1658116040303,MATH 109,A03,093478,Ganzberger; Geoffrey Michael,2,0,34,32
1658116040303,MATH 109,B01,083215,Ganzberger; Geoffrey Michael,3,0,32,29
1658116040303,MATH 109,B02,083216,Ganzberger; Geoffrey Michael,3,0,32,29
1658116040303,MATH 109,B03,093479,Ganzberger; Geoffrey Michael,8,0,32,24
1658116046334,MATH 142A,A01,083219,Chow; Bennett,7,0,32,25
1658116046334,MATH 142A,A02,083220,Chow; Bennett,10,0,32,22
1658116046334,MATH 142A,A03,093480,Chow; Bennett,9,0,32,23
1658116046334,MATH 142A,B03,093481,Chow; Bennett,8,0,32,24
1658116046334,MATH 142A,B04,093558,Chow; Bennett,14,0,32,18
1658116046334,MATH 142A,B05,093559,Chow; Bennett,7,0,32,25
1658116052359,MATH 193A,A01,083224,Rotar; Vladimir,9,0,34,25
1658116052359,MATH 193A,A02,083225,Rotar; Vladimir,11,0,34,23
1658116052359,MATH 193A,A03,083781,Rotar; Vladimir,5,0,34,29
1658116052359,MATH 193A,A04,083782,Rotar; Vladimir,12,0,34,22
1658116052359,MATH 193A,A05,093482,Rotar; Vladimir,11,0,34,23
1658116058382,MATH 197,001,091859,McAuley; Julian John,9999,0,9999,0
1658116058382,MATH 197,002,095566,Kedlaya; Kiran S.,9997,0,9999,2
1658116058382,MATH 197,003,095567,Xiao; Ming,9999,0,9999,0
1658116058382,MATH 197,004,095571,Perols; Johan Lars,9998,0,9999,1
1658116065436,COGS 9,A01,083615,Shannon; Kyle Michael,11,0,75,64
1658116071459,COGS 11,A01,083617,Boyle; Mary E. T.,23,0,48,25
1658116077493,COGS 13,A01,083071,Bastos; Amalia Pinkusfeld,12,0,71,59
1658116083522,COGS 14A,A01,092681,Semenuks; Arturs,5,1,100,95
1658116089555,COGS 14B,A01,083073,Cheng; Tzu-Han,7,0,63,56
1658116095662,COGS 17,A01,092677,Semenuks; Arturs,7,0,81,74
1658116101684,COGS 100,A01,083619,Allen; Michael Gordon,17,0,70,53
1658116107708,COGS 101A,A01,083621,Davis; Joshua Daniel,9,0,68,59
1658116113745,COGS 101B,A01,091572,Allen; Michael Gordon,14,0,65,51
1658116119772,COGS 101C,A01,083625,Delgado; Tania,17,0,35,18
1658116125804,COGS 107A,A01,083627,Boyle; Mary E. T.,14,0,60,46
1658116131830,COGS 118A,A01,083075,Gupta; Anjum,21,0,76,55
1658116137856,CSE 3,A50,083646,Miranda; Gregory Joseph,24,0,50,26
1658116143885,CSE 8A,A50,083650,Miranda; Gregory Joseph,17,1,56,39
1658116149909,CSE 11,A01,083080,Cao; Yingjun,7,15,40,33
1658116155936,CSE 12,A01,083652,Krause-Levy; Sophia Louisa,30,1,120,90
1658116161959,CSE 15L,A01,083654,Morris; Justin Loren,9,0,50,41
1658116161959,CSE 15L,A02,083655,Morris; Justin Loren,11,0,50,39
1658116167993,CSE 20,A01,083657,Tran; Khoa Dang,39,0,80,41
1658116174016,CSE 21,A01,095574,Bach; Quang Tran,23,0,48,25
1658116180051,CSE 30,A01,083084,Eldon; John,8,0,80,72
1658116180051,CSE 30,B01,095061,Bhaskar; Nishant,9,0,50,41
1658116186072,CSE 100,A01,083659,Cao; Yingjun,5,4,70,65
1658116192110,CSE 134B,A01,083661,Powell; Thomas Allan,25,0,100,75
1658116198136,CSE 140,A01,083663,Gungor; Onat,17,0,85,68
1658116204162,CSE 140L,A01,083088,Eldon; John,23,0,100,77
1658116210197,CSE 175,A01,083665,Kumar; Rakesh,3,0,25,22
1658116216230,CSE 190,A00,092507,Dubnov; Shlomo,8,0,20,12
1658116222259,ECE 45,A01,083139,Congero; Spencer William,7,0,75,68
1658116228283,ECE 65,A50,083695,Saad; Andrew S,12,0,30,18
1658116228283,ECE 65,A51,095125,Saad; Andrew S,24,0,26,2
1658116234325,ECE 109,A01,091882,Touri; Behrouz,21,0,70,49
1658116240347,ECE 180,A00,083140,Abi Samra; Nicholas Camill,1,0,30,29
1658116240347,ECE 180,B00,083141,Abi Samra; Nicholas Camill,0,0,30,30
1658116246387,MATH 10A,A01,083735,Patchell; Gregory David,2,0,30,28
1658116246387,MATH 10A,A02,083736,Patchell; Gregory David,20,0,30,10
1658116246387,MATH 10A,A03,083737,Patchell; Gregory David,16,0,30,14
1658116252410,MATH 10B,A01,083207,Lim; Seonhee,9,0,34,25
1658116252410,MATH 10B,A02,083208,Lim; Seonhee,10,0,35,25
1658116252410,MATH 10B,A03,093472,Lim; Seonhee,7,0,34,27
1658116252410,MATH 10B,B01,083739,Sinha; Shubham,14,0,30,16
1658116258435,MATH 18,A01,083743,Cinel; Cameron Alexander,9,0,30,21
1658116258435,MATH 18,A02,083744,Cinel; Cameron Alexander,18,0,30,12
1658116258435,MATH 18,A03,083745,Cinel; Cameron Alexander,10,0,30,20
1658116258435,MATH 18,B01,083748,Rideout; David Porter,5,0,37,32
1658116258435,MATH 18,B02,083749,Rideout; David Porter,5,0,36,31
1658116258435,MATH 18,B03,083750,Rideout; David Porter,3,0,37,34
1658116258435,MATH 18,B04,083751,Rideout; David Porter,7,0,36,29
1658116258435,MATH 18,B05,093473,Rideout; David Porter,7,0,36,29
1658116258435,MATH 18,B06,093474,Rideout; David Porter,6,0,36,30
1658116264458,MATH 20A,A01,083754,Zheng; Zequn,14,0,40,26
1658116270487,MATH 20B,A01,083756,Briones; Jor-el Thomas Caparas,4,0,36,32
1658116270487,MATH 20B,A02,083757,Briones; Jor-el Thomas Caparas,1,0,36,35
1658116270487,MATH 20B,A03,093475,Briones; Jor-el Thomas Caparas,3,0,36,33
1658116276519,MATH 20C,A01,083760,Briones; Jor-el Thomas Caparas,1,0,35,34
1658116276519,MATH 20C,A02,083761,Briones; Jor-el Thomas Caparas,8,0,35,27
1658116276519,MATH 20C,A03,093476,Briones; Jor-el Thomas Caparas,0,1,36,36
1658116276519,MATH 20C,B01,083762,Bach; Quang Tran,1,0,30,29
1658116282544,MATH 20D,A01,083765,Tran; Brian Kha,5,0,30,25
1658116282544,MATH 20D,A02,083766,Tran; Brian Kha,5,0,30,25
1658116282544,MATH 20D,A03,083767,Tran; Brian Kha,6,0,30,24
1658116288569,MATH 20E,A01,083771,Ganguly; Soumya,12,0,32,20
1658116288569,MATH 20E,A02,083772,Ganguly; Soumya,7,0,32,25
1658116288569,MATH 20E,B01,083773,Ciotti; Benjamin,20,0,35,15
1658116288569,MATH 20E,B02,083774,Ciotti; Benjamin,18,0,35,17
1658116294594,MATH 103A,A01,083777,Greenfeld; Be'Eri,6,0,36,30
1658116294594,MATH 103A,A02,083778,Greenfeld; Be'Eri,5,0,36,31
1658116294594,MATH 103A,A03,093561,Greenfeld; Be'Eri,7,0,36,29
1658116294594,MATH 103A,B01,083779,Greenfeld; Be'Eri,8,0,36,28
1658116294594,MATH 103A,B02,083780,Greenfeld; Be'Eri,4,0,36,32
1658116294594,MATH 103A,B03,093562,Greenfeld; Be'Eri,3,0,36,33
1658116300622,MATH 105,A01,085443,Carter; Anne Toulson,15,0,35,20
1658116300622,MATH 105,A02,093477,Carter; Anne Toulson,20,0,35,15
1658116306652,MATH 109,A01,083213,Ganzberger; Geoffrey Michael,3,0,34,31
1658116306652,MATH 109,A02,083214,Ganzberger; Geoffrey Michael,4,0,34,30
1658116306652,MATH 109,A03,093478,Ganzberger; Geoffrey Michael,2,0,34,32
1658116306652,MATH 109,B01,083215,Ganzberger; Geoffrey Michael,3,0,32,29
1658116306652,MATH 109,B02,083216,Ganzberger; Geoffrey Michael,3,0,32,29
1658116306652,MATH 109,B03,093479,Ganzberger; Geoffrey Michael,8,0,32,24
1658116312691,MATH 142A,A01,083219,Chow; Bennett,7,0,32,25
1658116312691,MATH 142A,A02,083220,Chow; Bennett,10,0,32,22
1658116312691,MATH 142A,A03,093480,Chow; Bennett,9,0,32,23
1658116312691,MATH 142A,B03,093481,Chow; Bennett,8,0,32,24
1658116312691,MATH 142A,B04,093558,Chow; Bennett,14,0,32,18
1658116312691,MATH 142A,B05,093559,Chow; Bennett,7,0,32,25
1658116318719,MATH 193A,A01,083224,Rotar; Vladimir,9,0,34,25
1658116318719,MATH 193A,A02,083225,Rotar; Vladimir,11,0,34,23
1658116318719,MATH 193A,A03,083781,Rotar; Vladimir,5,0,34,29
1658116318719,MATH 193A,A04,083782,Rotar; Vladimir,12,0,34,22
1658116318719,MATH 193A,A05,093482,Rotar; Vladimir,11,0,34,23
1658116324750,MATH 197,001,091859,McAuley; Julian John,9999,0,9999,0
1658116324750,MATH 197,002,095566,Kedlaya; Kiran S.,9997,0,9999,2
1658116324750,MATH 197,003,095567,Xiao; Ming,9999,0,9999,0
1658116324750,MATH 197,004,095571,Perols; Johan Lars,9998,0,9999,1
1658116331819,COGS 9,A01,083615,Shannon; Kyle Michael,11,0,75,64
1658116337846,COGS 11,A01,083617,Boyle; Mary E. T.,23,0,48,25
1658116343869,COGS 13,A01,083071,Bastos; Amalia Pinkusfeld,12,0,71,59
1658116349896,COGS 14A,A01,092681,Semenuks; Arturs,5,1,100,95
1658116355920,COGS 14B,A01,083073,Cheng; Tzu-Han,7,0,63,56
1658116362024,COGS 17,A01,092677,Semenuks; Arturs,7,0,81,74
1658116368053,COGS 100,A01,083619,Allen; Michael Gordon,17,0,70,53
1658116374076,COGS 101A,A01,083621,Davis; Joshua Daniel,9,0,68,59
1658116380115,COGS 101B,A01,091572,Allen; Michael Gordon,14,0,65,51
1658116386144,COGS 101C,A01,083625,Delgado; Tania,17,0,35,18
1658116392172,COGS 107A,A01,083627,Boyle; Mary E. T.,14,0,60,46
1658116398199,COGS 118A,A01,083075,Gupta; Anjum,21,0,76,55
1658116404237,CSE 3,A50,083646,Miranda; Gregory Joseph,24,0,50,26
1658116410267,CSE 8A,A50,083650,Miranda; Gregory Joseph,17,1,56,39
1658116416296,CSE 11,A01,083080,Cao; Yingjun,7,15,40,33
1658116422321,CSE 12,A01,083652,Krause-Levy; Sophia Louisa,30,1,120,90
1658116428350,CSE 15L,A01,083654,Morris; Justin Loren,9,0,50,41
1658116428350,CSE 15L,A02,083655,Morris; Justin Loren,11,0,50,39
1658116434372,CSE 20,A01,083657,Tran; Khoa Dang,39,0,80,41
1658116440401,CSE 21,A01,095574,Bach; Quang Tran,23,0,48,25
1658116446440,CSE 30,A01,083084,Eldon; John,8,0,80,72
1658116446440,CSE 30,B01,095061,Bhaskar; Nishant,9,0,50,41
1658116452466,CSE 100,A01,083659,Cao; Yingjun,5,4,70,65
1658116458493,CSE 134B,A01,083661,Powell; Thomas Allan,25,0,100,75
1658116464519,CSE 140,A01,083663,Gungor; Onat,17,0,85,68
1658116470542,CSE 140L,A01,083088,Eldon; John,23,0,100,77
1658116476568,CSE 175,A01,083665,Kumar; Rakesh,3,0,25,22
1658116482595,CSE 190,A00,092507,Dubnov; Shlomo,8,0,20,12
1658116488618,ECE 45,A01,083139,Congero; Spencer William,7,0,75,68
1658116494640,ECE 65,A50,083695,Saad; Andrew S,12,0,30,18
1658116494640,ECE 65,A51,095125,Saad; Andrew S,24,0,26,2
1658116500667,ECE 109,A01,091882,Touri; Behrouz,21,0,70,49
1658116506701,ECE 180,A00,083140,Abi Samra; Nicholas Camill,1,0,30,29
1658116506701,ECE 180,B00,083141,Abi Samra; Nicholas Camill,0,0,30,30
1658116512725,MATH 10A,A01,083735,Patchell; Gregory David,2,0,30,28
1658116512725,MATH 10A,A02,083736,Patchell; Gregory David,20,0,30,10
1658116512725,MATH 10A,A03,083737,Patchell; Gregory David,16,0,30,14
1658116518749,MATH 10B,A01,083207,Lim; Seonhee,9,0,34,25
1658116518749,MATH 10B,A02,083208,Lim; Seonhee,10,0,35,25
1658116518749,MATH 10B,A03,093472,Lim; Seonhee,7,0,34,27
1658116518749,MATH 10B,B01,083739,Sinha; Shubham,14,0,30,16
1658116524780,MATH 18,A01,083743,Cinel; Cameron Alexander,9,0,30,21
1658116524780,MATH 18,A02,083744,Cinel; Cameron Alexander,18,0,30,12
1658116524780,MATH 18,A03,083745,Cinel; Cameron Alexander,10,0,30,20
1658116524780,MATH 18,B01,083748,Rideout; David Porter,5,0,37,32
1658116524780,MATH 18,B02,083749,Rideout; David Porter,5,0,36,31
1658116524780,MATH 18,B03,083750,Rideout; David Porter,3,0,37,34
1658116524780,MATH 18,B04,083751,Rideout; David Porter,7,0,36,29
1658116524780,MATH 18,B05,093473,Rideout; David Porter,7,0,36,29
1658116524780,MATH 18,B06,093474,Rideout; David Porter,6,0,36,30
1658116530805,MATH 20A,A01,083754,Zheng; Zequn,14,0,40,26
1658116536841,MATH 20B,A01,083756,Briones; Jor-el Thomas Caparas,4,0,36,32
1658116536841,MATH 20B,A02,083757,Briones; Jor-el Thomas Caparas,1,0,36,35
1658116536841,MATH 20B,A03,093475,Briones; Jor-el Thomas Caparas,3,0,36,33
1658116542869,MATH 20C,A01,083760,Briones; Jor-el Thomas Caparas,1,0,35,34
1658116542869,MATH 20C,A02,083761,Briones; Jor-el Thomas Caparas,8,0,35,27
1658116542869,MATH 20C,A03,093476,Briones; Jor-el Thomas Caparas,0,1,36,36
1658116542869,MATH 20C,B01,083762,Bach; Quang Tran,1,0,30,29
1658116548892,MATH 20D,A01,083765,Tran; Brian Kha,5,0,30,25
1658116548892,MATH 20D,A02,083766,Tran; Brian Kha,5,0,30,25
1658116548892,MATH 20D,A03,083767,Tran; Brian Kha,6,0,30,24
1658116554921,MATH 20E,A01,083771,Ganguly; Soumya,12,0,32,20
1658116554921,MATH 20E,A02,083772,Ganguly; Soumya,7,0,32,25
1658116554921,MATH 20E,B01,083773,Ciotti; Benjamin,20,0,35,15
1658116554921,MATH 20E,B02,083774,Ciotti; Benjamin,18,0,35,17
1658116560947,MATH 103A,A01,083777,Greenfeld; Be'Eri,6,0,36,30
1658116560947,MATH 103A,A02,083778,Greenfeld; Be'Eri,5,0,36,31
1658116560947,MATH 103A,A03,093561,Greenfeld; Be'Eri,7,0,36,29
1658116560947,MATH 103A,B01,083779,Greenfeld; Be'Eri,8,0,36,28
1658116560947,MATH 103A,B02,083780,Greenfeld; Be'Eri,4,0,36,32
1658116560947,MATH 103A,B03,093562,Greenfeld; Be'Eri,3,0,36,33
1658116566971,MATH 105,A01,085443,Carter; Anne Toulson,15,0,35,20
1658116566971,MATH 105,A02,093477,Carter; Anne Toulson,20,0,35,15
1658116572998,MATH 109,A01,083213,Ganzberger; Geoffrey Michael,3,0,34,31
1658116572998,MATH 109,A02,083214,Ganzberger; Geoffrey Michael,4,0,34,30
1658116572998,MATH 109,A03,093478,Ganzberger; Geoffrey Michael,2,0,34,32
1658116572998,MATH 109,B01,083215,Ganzberger; Geoffrey Michael,3,0,32,29
1658116572998,MATH 109,B02,083216,Ganzberger; Geoffrey Michael,3,0,32,29
1658116572998,MATH 109,B03,093479,Ganzberger; Geoffrey Michael,8,0,32,24
1658116579022,MATH 142A,A01,083219,Chow; Bennett,7,0,32,25
1658116579022,MATH 142A,A02,083220,Chow; Bennett,10,0,32,22
1658116579022,MATH 142A,A03,093480,Chow; Bennett,9,0,32,23
1658116579022,MATH 142A,B03,093481,Chow; Bennett,8,0,32,24
1658116579022,MATH 142A,B04,093558,Chow; Bennett,14,0,32,18
1658116579022,MATH 142A,B05,093559,Chow; Bennett,7,0,32,25
1658116585046,MATH 193A,A01,083224,Rotar; Vladimir,9,0,34,25
1658116585046,MATH 193A,A02,083225,Rotar; Vladimir,11,0,34,23
1658116585046,MATH 193A,A03,083781,Rotar; Vladimir,5,0,34,29
1658116585046,MATH 193A,A04,083782,Rotar; Vladimir,12,0,34,22
1658116585046,MATH 193A,A05,093482,Rotar; Vladimir,11,0,34,23
1658116591080,MATH 197,001,091859,McAuley; Julian John,9999,0,9999,0
1658116591080,MATH 197,002,095566,Kedlaya; Kiran S.,9997,0,9999,2
1658116591080,MATH 197,003,095567,Xiao; Ming,9999,0,9999,0
1658116591080,MATH 197,004,095571,Perols; Johan Lars,9998,0,9999,1
1658116598151,COGS 9,A01,083615,Shannon; Kyle Michael,11,0,75,64
1658116604178,COGS 11,A01,083617,Boyle; Mary E. T.,23,0,48,25
1658116610204,COGS 13,A01,083071,Bastos; Amalia Pinkusfeld,12,0,71,59
1658116616227,COGS 14A,A01,092681,Semenuks; Arturs,5,1,100,95
1658116622252,COGS 14B,A01,083073,Cheng; Tzu-Han,7,0,63,56
1658116628279,COGS 17,A01,092677,Semenuks; Arturs,7,0,81,74
1658116634303,COGS 100,A01,083619,Allen; Michael Gordon,17,0,70,53
1658116640333,COGS 101A,A01,083621,Davis; Joshua Daniel,9,0,68,59
1658116646358,COGS 101B,A01,091572,Allen; Michael Gordon,14,0,65,51
1658116652381,COGS 101C,A01,083625,Delgado; Tania,17,0,35,18
1658116658404,COGS 107A,A01,083627,Boyle; Mary E. T.,14,0,60,46
1658116664435,COGS 118A,A01,083075,Gupta; Anjum,21,0,76,55
1658116670459,CSE 3,A50,083646,Miranda; Gregory Joseph,24,0,50,26
1658116676483,CSE 8A,A50,083650,Miranda; Gregory Joseph,17,1,56,39
1658116682506,CSE 11,A01,083080,Cao; Yingjun,7,15,40,33
1658116688529,CSE 12,A01,083652,Krause-Levy; Sophia Louisa,30,1,120,90
1658116694559,CSE 15L,A01,083654,Morris; Justin Loren,9,0,50,41
1658116694559,CSE 15L,A02,083655,Morris; Justin Loren,11,0,50,39
1658116700585,CSE 20,A01,083657,Tran; Khoa Dang,39,0,80,41
1658116706612,CSE 21,A01,095574,Bach; Quang Tran,23,0,48,25
1658116712652,CSE 30,A01,083084,Eldon; John,8,0,80,72
1658116712652,CSE 30,B01,095061,Bhaskar; Nishant,9,0,50,41
1658116718681,CSE 100,A01,083659,Cao; Yingjun,5,4,70,65
1658116724711,CSE 134B,A01,083661,Powell; Thomas Allan,25,0,100,75
1658116730734,CSE 140,A01,083663,Gungor; Onat,17,0,85,68
1658116736768,CSE 140L,A01,083088,Eldon; John,23,0,100,77
1658116742791,CSE 175,A01,083665,Kumar; Rakesh,3,0,25,22
1658116748822,CSE 190,A00,092507,Dubnov; Shlomo,8,0,20,12
1658116754848,ECE 45,A01,083139,Congero; Spencer William,7,0,75,68
1658116760875,ECE 65,A50,083695,Saad; Andrew S,12,0,30,18
1658116760875,ECE 65,A51,095125,Saad; Andrew S,24,0,26,2
1658116766901,ECE 109,A01,091882,Touri; Behrouz,21,0,70,49
1658116772924,ECE 180,A00,083140,Abi Samra; Nicholas Camill,1,0,30,29
1658116772924,ECE 180,B00,083141,Abi Samra; Nicholas Camill,0,0,30,30
1658116778951,MATH 10A,A01,083735,Patchell; Gregory David,2,0,30,28
1658116778951,MATH 10A,A02,083736,Patchell; Gregory David,20,0,30,10
1658116778951,MATH 10A,A03,083737,Patchell; Gregory David,16,0,30,14
1658116784977,MATH 10B,A01,083207,Lim; Seonhee,9,0,34,25
1658116784977,MATH 10B,A02,083208,Lim; Seonhee,10,0,35,25
1658116784977,MATH 10B,A03,093472,Lim; Seonhee,7,0,34,27
1658116784977,MATH 10B,B01,083739,Sinha; Shubham,14,0,30,16
1658116791009,MATH 18,A01,083743,Cinel; Cameron Alexander,9,0,30,21
1658116791009,MATH 18,A02,083744,Cinel; Cameron Alexander,18,0,30,12
1658116791009,MATH 18,A03,083745,Cinel; Cameron Alexander,10,0,30,20
1658116791009,MATH 18,B01,083748,Rideout; David Porter,5,0,37,32
1658116791009,MATH 18,B02,083749,Rideout; David Porter,5,0,36,31
1658116791009,MATH 18,B03,083750,Rideout; David Porter,3,0,37,34
1658116791009,MATH 18,B04,083751,Rideout; David Porter,7,0,36,29
1658116791009,MATH 18,B05,093473,Rideout; David Porter,7,0,36,29
1658116791009,MATH 18,B06,093474,Rideout; David Porter,6,0,36,30
1658116797035,MATH 20A,A01,083754,Zheng; Zequn,14,0,40,26
1658116803059,MATH 20B,A01,083756,Briones; Jor-el Thomas Caparas,4,0,36,32
1658116803059,MATH 20B,A02,083757,Briones; Jor-el Thomas Caparas,1,0,36,35
1658116803059,MATH 20B,A03,093475,Briones; Jor-el Thomas Caparas,3,0,36,33
1658116809095,MATH 20C,A01,083760,Briones; Jor-el Thomas Caparas,1,0,35,34
1658116809095,MATH 20C,A02,083761,Briones; Jor-el Thomas Caparas,8,0,35,27
1658116809095,MATH 20C,A03,093476,Briones; Jor-el Thomas Caparas,0,1,36,36
1658116809095,MATH 20C,B01,083762,Bach; Quang Tran,1,0,30,29
1658116815118,MATH 20D,A01,083765,Tran; Brian Kha,5,0,30,25
1658116815118,MATH 20D,A02,083766,Tran; Brian Kha,5,0,30,25
1658116815118,MATH 20D,A03,083767,Tran; Brian Kha,6,0,30,24
1658116821147,MATH 20E,A01,083771,Ganguly; Soumya,12,0,32,20
1658116821147,MATH 20E,A02,083772,Ganguly; Soumya,7,0,32,25
1658116821147,MATH 20E,B01,083773,Ciotti; Benjamin,20,0,35,15
1658116821147,MATH 20E,B02,083774,Ciotti; Benjamin,18,0,35,17
1658116827179,MATH 103A,A01,083777,Greenfeld; Be'Eri,6,0,36,30
1658116827179,MATH 103A,A02,083778,Greenfeld; Be'Eri,5,0,36,31
1658116827179,MATH 103A,A03,093561,Greenfeld; Be'Eri,7,0,36,29
1658116827179,MATH 103A,B01,083779,Greenfeld; Be'Eri,8,0,36,28
1658116827179,MATH 103A,B02,083780,Greenfeld; Be'Eri,4,0,36,32
1658116827179,MATH 103A,B03,093562,Greenfeld; Be'Eri,3,0,36,33
1658116833202,MATH 105,A01,085443,Carter; Anne Toulson,15,0,35,20
1658116833202,MATH 105,A02,093477,Carter; Anne Toulson,20,0,35,15
1658116839226,MATH 109,A01,083213,Ganzberger; Geoffrey Michael,3,0,34,31
1658116839226,MATH 109,A02,083214,Ganzberger; Geoffrey Michael,4,0,34,30
1658116839226,MATH 109,A03,093478,Ganzberger; Geoffrey Michael,2,0,34,32
1658116839226,MATH 109,B01,083215,Ganzberger; Geoffrey Michael,3,0,32,29
1658116839226,MATH 109,B02,083216,Ganzberger; Geoffrey Michael,3,0,32,29
1658116839226,MATH 109,B03,093479,Ganzberger; Geoffrey Michael,8,0,32,24
1658116845256,MATH 142A,A01,083219,Chow; Bennett,7,0,32,25
1658116845256,MATH 142A,A02,083220,Chow; Bennett,10,0,32,22
1658116845256,MATH 142A,A03,093480,Chow; Bennett,9,0,32,23
1658116845256,MATH 142A,B03,093481,Chow; Bennett,8,0,32,24
1658116845256,MATH 142A,B04,093558,Chow; Bennett,14,0,32,18
1658116845256,MATH 142A,B05,093559,Chow; Bennett,7,0,32,25
1658116851286,MATH 193A,A01,083224,Rotar; Vladimir,9,0,34,25
1658116851286,MATH 193A,A02,083225,Rotar; Vladimir,11,0,34,23
1658116851286,MATH 193A,A03,083781,Rotar; Vladimir,5,0,34,29
1658116851286,MATH 193A,A04,083782,Rotar; Vladimir,12,0,34,22
1658116851286,MATH 193A,A05,093482,Rotar; Vladimir,11,0,34,23
1658116857309,MATH 197,001,091859,McAuley; Julian John,9999,0,9999,0
1658116857309,MATH 197,002,095566,Kedlaya; Kiran S.,9997,0,9999,2
1658116857309,MATH 197,003,095567,Xiao; Ming,9999,0,9999,0
1658116857309,MATH 197,004,095571,Perols; Johan Lars,9998,0,9999,1
1658116864384,COGS 9,A01,083615,Shannon; Kyle Michael,11,0,75,64
1658116870424,COGS 11,A01,083617,Boyle; Mary E. T.,23,0,48,25
1658116876448,COGS 13,A01,083071,Bastos; Amalia Pinkusfeld,12,0,71,59
1658116882470,COGS 14A,A01,092681,Semenuks; Arturs,5,1,100,95
1658116888496,COGS 14B,A01,083073,Cheng; Tzu-Han,7,0,63,56
1658116903996,COGS 17,A01,092677,Semenuks; Arturs,7,0,81,74
1658116910018,COGS 100,A01,083619,Allen; Michael Gordon,17,0,70,53
1658116916042,COGS 101A,A01,083621,Davis; Joshua Daniel,9,0,68,59
1658116922068,COGS 101B,A01,091572,Allen; Michael Gordon,14,0,65,51
1658116928096,COGS 101C,A01,083625,Delgado; Tania,17,0,35,18
1658116934124,COGS 107A,A01,083627,Boyle; Mary E. T.,14,0,60,46
1658116940148,COGS 118A,A01,083075,Gupta; Anjum,21,0,76,55
1658116946172,CSE 3,A50,083646,Miranda; Gregory Joseph,24,0,50,26
1658116952196,CSE 8A,A50,083650,Miranda; Gregory Joseph,17,1,56,39
1658116958229,CSE 11,A01,083080,Cao; Yingjun,7,15,40,33
1658116964255,CSE 12,A01,083652,Krause-Levy; Sophia Louisa,30,1,120,90
1658116970367,CSE 15L,A01,083654,Morris; Justin Loren,9,0,50,41
1658116970367,CSE 15L,A02,083655,Morris; Justin Loren,11,0,50,39
1658116976393,CSE 20,A01,083657,Tran; Khoa Dang,39,0,80,41
1658116982420,CSE 21,A01,095574,Bach; Quang Tran,23,0,48,25
1658116988448,CSE 30,A01,083084,Eldon; John,8,0,80,72
1658116988448,CSE 30,B01,095061,Bhaskar; Nishant,9,0,50,41
1658116994471,CSE 100,A01,083659,Cao; Yingjun,5,4,70,65
1658117000494,CSE 134B,A01,083661,Powell; Thomas Allan,25,0,100,75
1658117006517,CSE 140,A01,083663,Gungor; Onat,17,0,85,68
1658117012542,CSE 140L,A01,083088,Eldon; John,23,0,100,77
1658117018564,CSE 175,A01,083665,Kumar; Rakesh,3,0,25,22
1658117024588,CSE 190,A00,092507,Dubnov; Shlomo,8,0,20,12
1658117030627,ECE 45,A01,083139,Congero; Spencer William,7,0,75,68
1658117036650,ECE 65,A50,083695,Saad; Andrew S,12,0,30,18
1658117036650,ECE 65,A51,095125,Saad; Andrew S,24,0,26,2
1658117042673,ECE 109,A01,091882,Touri; Behrouz,21,0,70,49
1658117048699,ECE 180,A00,083140,Abi Samra; Nicholas Camill,1,0,30,29
1658117048699,ECE 180,B00,083141,Abi Samra; Nicholas Camill,0,0,30,30
1658117054722,MATH 10A,A01,083735,Patchell; Gregory David,2,0,30,28
1658117054722,MATH 10A,A02,083736,Patchell; Gregory David,20,0,30,10
1658117054722,MATH 10A,A03,083737,Patchell; Gregory David,16,0,30,14
1658117060750,MATH 10B,A01,083207,Lim; Seonhee,9,0,34,25
1658117060750,MATH 10B,A02,083208,Lim; Seonhee,10,0,35,25
1658117060750,MATH 10B,A03,093472,Lim; Seonhee,7,0,34,27
1658117060750,MATH 10B,B01,083739,Sinha; Shubham,14,0,30,16
1658117066774,MATH 18,A01,083743,Cinel; Cameron Alexander,9,0,30,21
1658117066774,MATH 18,A02,083744,Cinel; Cameron Alexander,18,0,30,12
1658117066774,MATH 18,A03,083745,Cinel; Cameron Alexander,10,0,30,20
1658117066774,MATH 18,B01,083748,Rideout; David Porter,5,0,37,32
1658117066774,MATH 18,B02,083749,Rideout; David Porter,5,0,36,31
1658117066774,MATH 18,B03,083750,Rideout; David Porter,3,0,37,34
1658117066774,MATH 18,B04,083751,Rideout; David Porter,7,0,36,29
1658117066774,MATH 18,B05,093473,Rideout; David Porter,7,0,36,29
1658117066774,MATH 18,B06,093474,Rideout; David Porter,6,0,36,30
1658117072801,MATH 20A,A01,083754,Zheng; Zequn,14,0,40,26
1658117078825,MATH 20B,A01,083756,Briones; Jor-el Thomas Caparas,4,0,36,32
1658117078825,MATH 20B,A02,083757,Briones; Jor-el Thomas Caparas,1,0,36,35
1658117078825,MATH 20B,A03,093475,Briones; Jor-el Thomas Caparas,3,0,36,33
1658117084865,MATH 20C,A01,083760,Briones; Jor-el Thomas Caparas,1,0,35,34
1658117084865,MATH 20C,A02,083761,Briones; Jor-el Thomas Caparas,8,0,35,27
1658117084865,MATH 20C,A03,093476,Briones; Jor-el Thomas Caparas,0,1,36,36
1658117084865,MATH 20C,B01,083762,Bach; Quang Tran,1,0,30,29
1658117090890,MATH 20D,A01,083765,Tran; Brian Kha,5,0,30,25
1658117090890,MATH 20D,A02,083766,Tran; Brian Kha,5,0,30,25
1658117090890,MATH 20D,A03,083767,Tran; Brian Kha,6,0,30,24
1658117096913,MATH 20E,A01,083771,Ganguly; Soumya,12,0,32,20
1658117096913,MATH 20E,A02,083772,Ganguly; Soumya,7,0,32,25
1658117096913,MATH 20E,B01,083773,Ciotti; Benjamin,20,0,35,15
1658117096913,MATH 20E,B02,083774,Ciotti; Benjamin,18,0,35,17
1658117102937,MATH 103A,A01,083777,Greenfeld; Be'Eri,6,0,36,30
1658117102937,MATH 103A,A02,083778,Greenfeld; Be'Eri,5,0,36,31
1658117102937,MATH 103A,A03,093561,Greenfeld; Be'Eri,7,0,36,29
1658117102937,MATH 103A,B01,083779,Greenfeld; Be'Eri,8,0,36,28
1658117102937,MATH 103A,B02,083780,Greenfeld; Be'Eri,4,0,36,32
1658117102937,MATH 103A,B03,093562,Greenfeld; Be'Eri,3,0,36,33
1658117108972,MATH 105,A01,085443,Carter; Anne Toulson,15,0,35,20
1658117108972,MATH 105,A02,093477,Carter; Anne Toulson,20,0,35,15
1658117115004,MATH 109,A01,083213,Ganzberger; Geoffrey Michael,3,0,34,31
1658117115004,MATH 109,A02,083214,Ganzberger; Geoffrey Michael,4,0,34,30
1658117115004,MATH 109,A03,093478,Ganzberger; Geoffrey Michael,2,0,34,32
1658117115004,MATH 109,B01,083215,Ganzberger; Geoffrey Michael,3,0,32,29
1658117115004,MATH 109,B02,083216,Ganzberger; Geoffrey Michael,3,0,32,29
1658117115004,MATH 109,B03,093479,Ganzberger; Geoffrey Michael,8,0,32,24
1658117121034,MATH 142A,A01,083219,Chow; Bennett,7,0,32,25
1658117121034,MATH 142A,A02,083220,Chow; Bennett,10,0,32,22
1658117121034,MATH 142A,A03,093480,Chow; Bennett,9,0,32,23
1658117121034,MATH 142A,B03,093481,Chow; Bennett,8,0,32,24
1658117121034,MATH 142A,B04,093558,Chow; Bennett,14,0,32,18
1658117121034,MATH 142A,B05,093559,Chow; Bennett,7,0,32,25
1658117127058,MATH 193A,A01,083224,Rotar; Vladimir,9,0,34,25
1658117127058,MATH 193A,A02,083225,Rotar; Vladimir,11,0,34,23
1658117127058,MATH 193A,A03,083781,Rotar; Vladimir,5,0,34,29
1658117127058,MATH 193A,A04,083782,Rotar; Vladimir,12,0,34,22
1658117127058,MATH 193A,A05,093482,Rotar; Vladimir,11,0,34,23
1658117133081,MATH 197,001,091859,McAuley; Julian John,9999,0,9999,0
1658117133081,MATH 197,002,095566,Kedlaya; Kiran S.,9997,0,9999,2
1658117133081,MATH 197,003,095567,Xiao; Ming,9999,0,9999,0
1658117133081,MATH 197,004,095571,Perols; Johan Lars,9998,0,9999,1
1658117140134,COGS 9,A01,083615,Shannon; Kyle Michael,11,0,75,64
1658117146161,COGS 11,A01,083617,Boyle; Mary E. T.,23,0,48,25
1658117152183,COGS 13,A01,083071,Bastos; Amalia Pinkusfeld,12,0,71,59
1658117158217,COGS 14A,A01,092681,Semenuks; Arturs,5,1,100,95
1658117164240,COGS 14B,A01,083073,Cheng; Tzu-Han,7,0,63,56
1658117170264,COGS 17,A01,092677,Semenuks; Arturs,7,0,81,74
1658117176288,COGS 100,A01,083619,Allen; Michael Gordon,17,0,70,53
1658117182311,COGS 101A,A01,083621,Davis; Joshua Daniel,9,0,68,59
1658117188340,COGS 101B,A01,091572,Allen; Michael Gordon,14,0,65,51
1658117194367,COGS 101C,A01,083625,Delgado; Tania,17,0,35,18
1658117200395,COGS 107A,A01,083627,Boyle; Mary E. T.,14,0,60,46
1658117206428,COGS 118A,A01,083075,Gupta; Anjum,21,0,76,55
1658117212453,CSE 3,A50,083646,Miranda; Gregory Joseph,24,0,50,26
1658117218476,CSE 8A,A50,083650,Miranda; Gregory Joseph,17,1,56,39
1658117224500,CSE 11,A01,083080,Cao; Yingjun,7,15,40,33
1658117230534,CSE 12,A01,083652,Krause-Levy; Sophia Louisa,30,1,120,90
1658117236558,CSE 15L,A01,083654,Morris; Justin Loren,9,0,50,41
1658117236558,CSE 15L,A02,083655,Morris; Justin Loren,11,0,50,39
1658117242582,CSE 20,A01,083657,Tran; Khoa Dang,39,0,80,41
1658117248605,CSE 21,A01,095574,Bach; Quang Tran,23,0,48,25
1658117254629,CSE 30,A01,083084,Eldon; John,8,0,80,72
1658117254629,CSE 30,B01,095061,Bhaskar; Nishant,9,0,50,41
1658117260651,CSE 100,A01,083659,Cao; Yingjun,5,4,70,65
1658117266674,CSE 134B,A01,083661,Powell; Thomas Allan,25,0,100,75
1658117272698,CSE 140,A01,083663,Gungor; Onat,17,0,85,68
1658117278721,CSE 140L,A01,083088,Eldon; John,23,0,100,77
1658117284745,CSE 175,A01,083665,Kumar; Rakesh,3,0,25,22
1658117290771,CSE 190,A00,092507,Dubnov; Shlomo,8,0,20,12
1658117296794,ECE 45,A01,083139,Congero; Spencer William,7,0,75,68
1658117302820,ECE 65,A50,083695,Saad; Andrew S,12,0,30,18
1658117302820,ECE 65,A51,095125,Saad; Andrew S,24,0,26,2
1658117308842,ECE 109,A01,091882,Touri; Behrouz,21,0,70,49
1658117314866,ECE 180,A00,083140,Abi Samra; Nicholas Camill,1,0,30,29
1658117314866,ECE 180,B00,083141,Abi Samra; Nicholas Camill,0,0,30,30
1658117320887,MATH 10A,A01,083735,Patchell; Gregory David,2,0,30,28
1658117320887,MATH 10A,A02,083736,Patchell; Gregory David,20,0,30,10
1658117320887,MATH 10A,A03,083737,Patchell; Gregory David,16,0,30,14
1658117326912,MATH 10B,A01,083207,Lim; Seonhee,9,0,34,25
1658117326912,MATH 10B,A02,083208,Lim; Seonhee,10,0,35,25
1658117326912,MATH 10B,A03,093472,Lim; Seonhee,7,0,34,27
1658117326912,MATH 10B,B01,083739,Sinha; Shubham,14,0,30,16
1658117332944,MATH 18,A01,083743,Cinel; Cameron Alexander,9,0,30,21
1658117332944,MATH 18,A02,083744,Cinel; Cameron Alexander,18,0,30,12
1658117332944,MATH 18,A03,083745,Cinel; Cameron Alexander,10,0,30,20
1658117332944,MATH 18,B01,083748,Rideout; David Porter,5,0,37,32
1658117332944,MATH 18,B02,083749,Rideout; David Porter,5,0,36,31
1658117332944,MATH 18,B03,083750,Rideout; David Porter,3,0,37,34
1658117332944,MATH 18,B04,083751,Rideout; David Porter,7,0,36,29
1658117332944,MATH 18,B05,093473,Rideout; David Porter,7,0,36,29
1658117332944,MATH 18,B06,093474,Rideout; David Porter,6,0,36,30
1658117338969,MATH 20A,A01,083754,Zheng; Zequn,14,0,40,26
1658117344992,MATH 20B,A01,083756,Briones; Jor-el Thomas Caparas,4,0,36,32
1658117344992,MATH 20B,A02,083757,Briones; Jor-el Thomas Caparas,1,0,36,35
1658117344992,MATH 20B,A03,093475,Briones; Jor-el Thomas Caparas,3,0,36,33
1658117351022,MATH 20C,A01,083760,Briones; Jor-el Thomas Caparas,1,0,35,34
1658117351022,MATH 20C,A02,083761,Briones; Jor-el Thomas Caparas,8,0,35,27
1658117351022,MATH 20C,A03,093476,Briones; Jor-el Thomas Caparas,0,1,36,36
1658117351022,MATH 20C,B01,083762,Bach; Quang Tran,1,0,30,29
1658117357046,MATH 20D,A01,083765,Tran; Brian Kha,5,0,30,25
1658117357046,MATH 20D,A02,083766,Tran; Brian Kha,5,0,30,25
1658117357046,MATH 20D,A03,083767,Tran; Brian Kha,6,0,30,24
1658117363082,MATH 20E,A01,083771,Ganguly; Soumya,12,0,32,20
1658117363082,MATH 20E,A02,083772,Ganguly; Soumya,7,0,32,25
1658117363082,MATH 20E,B01,083773,Ciotti; Benjamin,20,0,35,15
1658117363082,MATH 20E,B02,083774,Ciotti; Benjamin,18,0,35,17
1658117369108,MATH 103A,A01,083777,Greenfeld; Be'Eri,6,0,36,30
1658117369108,MATH 103A,A02,083778,Greenfeld; Be'Eri,5,0,36,31
1658117369108,MATH 103A,A03,093561,Greenfeld; Be'Eri,7,0,36,29
1658117369108,MATH 103A,B01,083779,Greenfeld; Be'Eri,8,0,36,28
1658117369108,MATH 103A,B02,083780,Greenfeld; Be'Eri,4,0,36,32
1658117369108,MATH 103A,B03,093562,Greenfeld; Be'Eri,3,0,36,33
1658117375132,MATH 105,A01,085443,Carter; Anne Toulson,15,0,35,20
1658117375132,MATH 105,A02,093477,Carter; Anne Toulson,20,0,35,15
1658117381162,MATH 109,A01,083213,Ganzberger; Geoffrey Michael,3,0,34,31
1658117381162,MATH 109,A02,083214,Ganzberger; Geoffrey Michael,4,0,34,30
1658117381162,MATH 109,A03,093478,Ganzberger; Geoffrey Michael,2,0,34,32
1658117381162,MATH 109,B01,083215,Ganzberger; Geoffrey Michael,3,0,32,29
1658117381162,MATH 109,B02,083216,Ganzberger; Geoffrey Michael,3,0,32,29
1658117381162,MATH 109,B03,093479,Ganzberger; Geoffrey Michael,8,0,32,24
1658117387202,MATH 142A,A01,083219,Chow; Bennett,7,0,32,25
1658117387202,MATH 142A,A02,083220,Chow; Bennett,10,0,32,22
1658117387202,MATH 142A,A03,093480,Chow; Bennett,9,0,32,23
1658117387202,MATH 142A,B03,093481,Chow; Bennett,8,0,32,24
1658117387202,MATH 142A,B04,093558,Chow; Bennett,14,0,32,18
1658117387202,MATH 142A,B05,093559,Chow; Bennett,7,0,32,25
1658117393228,MATH 193A,A01,083224,Rotar; Vladimir,9,0,34,25
1658117393228,MATH 193A,A02,083225,Rotar; Vladimir,11,0,34,23
1658117393228,MATH 193A,A03,083781,Rotar; Vladimir,5,0,34,29
1658117393228,MATH 193A,A04,083782,Rotar; Vladimir,12,0,34,22
1658117393228,MATH 193A,A05,093482,Rotar; Vladimir,11,0,34,23
1658117399251,MATH 197,001,091859,McAuley; Julian John,9999,0,9999,0
1658117399251,MATH 197,002,095566,Kedlaya; Kiran S.,9997,0,9999,2
1658117399251,MATH 197,003,095567,Xiao; Ming,9999,0,9999,0
1658117399251,MATH 197,004,095571,Perols; Johan Lars,9998,0,9999,1
1658117406308,COGS 9,A01,083615,Shannon; Kyle Michael,11,0,75,64
1658117412334,COGS 11,A01,083617,Boyle; Mary E. T.,23,0,48,25
1658117418357,COGS 13,A01,083071,Bastos; Amalia Pinkusfeld,12,0,71,59
1658117424384,COGS 14A,A01,092681,Semenuks; Arturs,5,1,100,95
1658117430411,COGS 14B,A01,083073,Cheng; Tzu-Han,7,0,63,56
1658117436440,COGS 17,A01,092677,Semenuks; Arturs,7,0,81,74
1658117442463,COGS 100,A01,083619,Allen; Michael Gordon,17,0,70,53
1658117448488,COGS 101A,A01,083621,Davis; Joshua Daniel,9,0,68,59
1658117454512,COGS 101B,A01,091572,Allen; Michael Gordon,14,0,65,51
1658117460539,COGS 101C,A01,083625,Delgado; Tania,17,0,35,18
1658117466563,COGS 107A,A01,083627,Boyle; Mary E. T.,14,0,60,46
1658117472591,COGS 118A,A01,083075,Gupta; Anjum,21,0,76,55
1658117478618,CSE 3,A50,083646,Miranda; Gregory Joseph,24,0,50,26
1658117484645,CSE 8A,A50,083650,Miranda; Gregory Joseph,17,1,56,39
1658117490667,CSE 11,A01,083080,Cao; Yingjun,7,15,40,33
1658117496693,CSE 12,A01,083652,Krause-Levy; Sophia Louisa,30,1,120,90
1658117502716,CSE 15L,A01,083654,Morris; Justin Loren,9,0,50,41
1658117502716,CSE 15L,A02,083655,Morris; Justin Loren,11,0,50,39
1658117508738,CSE 20,A01,083657,Tran; Khoa Dang,39,0,80,41
1658117514767,CSE 21,A01,095574,Bach; Quang Tran,23,0,48,25
1658117520790,CSE 30,A01,083084,Eldon; John,8,0,80,72
1658117520790,CSE 30,B01,095061,Bhaskar; Nishant,9,0,50,41
1658117526813,CSE 100,A01,083659,Cao; Yingjun,5,4,70,65
1658117532835,CSE 134B,A01,083661,Powell; Thomas Allan,25,0,100,75
1658117538861,CSE 140,A01,083663,Gungor; Onat,17,0,85,68
1658117544888,CSE 140L,A01,083088,Eldon; John,23,0,100,77
1658117550913,CSE 175,A01,083665,Kumar; Rakesh,3,0,25,22
1658117556939,CSE 190,A00,092507,Dubnov; Shlomo,8,0,20,12
1658117562967,ECE 45,A01,083139,Congero; Spencer William,7,0,75,68
1658117569064,ECE 65,A50,083695,Saad; Andrew S,12,0,30,18
1658117569064,ECE 65,A51,095125,Saad; Andrew S,24,0,26,2
1658117575088,ECE 109,A01,091882,Touri; Behrouz,21,0,70,49
1658117581113,ECE 180,A00,083140,Abi Samra; Nicholas Camill,1,0,30,29
1658117581113,ECE 180,B00,083141,Abi Samra; Nicholas Camill,0,0,30,30
1658117587136,MATH 10A,A01,083735,Patchell; Gregory David,2,0,30,28
1658117587136,MATH 10A,A02,083736,Patchell; Gregory David,20,0,30,10
1658117587136,MATH 10A,A03,083737,Patchell; Gregory David,16,0,30,14
1658117593159,MATH 10B,A01,083207,Lim; Seonhee,9,0,34,25
1658117593159,MATH 10B,A02,083208,Lim; Seonhee,10,0,35,25
1658117593159,MATH 10B,A03,093472,Lim; Seonhee,7,0,34,27
1658117593159,MATH 10B,B01,083739,Sinha; Shubham,14,0,30,16
1658117599191,MATH 18,A01,083743,Cinel; Cameron Alexander,9,0,30,21
1658117599191,MATH 18,A02,083744,Cinel; Cameron Alexander,18,0,30,12
1658117599191,MATH 18,A03,083745,Cinel; Cameron Alexander,10,0,30,20
1658117599191,MATH 18,B01,083748,Rideout; David Porter,5,0,37,32
1658117599191,MATH 18,B02,083749,Rideout; David Porter,5,0,36,31
1658117599191,MATH 18,B03,083750,Rideout; David Porter,3,0,37,34
1658117599191,MATH 18,B04,083751,Rideout; David Porter,7,0,36,29
1658117599191,MATH 18,B05,093473,Rideout; David Porter,7,0,36,29
1658117599191,MATH 18,B06,093474,Rideout; David Porter,6,0,36,30
1658117605221,MATH 20A,A01,083754,Zheng; Zequn,14,0,40,26
1658117611248,MATH 20B,A01,083756,Briones; Jor-el Thomas Caparas,4,0,36,32
1658117611248,MATH 20B,A02,083757,Briones; Jor-el Thomas Caparas,1,0,36,35
1658117611248,MATH 20B,A03,093475,Briones; Jor-el Thomas Caparas,3,0,36,33
1658117617276,MATH 20C,A01,083760,Briones; Jor-el Thomas Caparas,1,0,35,34
1658117617276,MATH 20C,A02,083761,Briones; Jor-el Thomas Caparas,8,0,35,27
1658117617276,MATH 20C,A03,093476,Briones; Jor-el Thomas Caparas,0,1,36,36
1658117617276,MATH 20C,B01,083762,Bach; Quang Tran,1,0,30,29
1658117623304,MATH 20D,A01,083765,Tran; Brian Kha,5,0,30,25
1658117623304,MATH 20D,A02,083766,Tran; Brian Kha,5,0,30,25
1658117623304,MATH 20D,A03,083767,Tran; Brian Kha,6,0,30,24
1658117629327,MATH 20E,A01,083771,Ganguly; Soumya,12,0,32,20
1658117629327,MATH 20E,A02,083772,Ganguly; Soumya,7,0,32,25
1658117629327,MATH 20E,B01,083773,Ciotti; Benjamin,20,0,35,15
1658117629327,MATH 20E,B02,083774,Ciotti; Benjamin,18,0,35,17
1658117635357,MATH 103A,A01,083777,Greenfeld; Be'Eri,6,0,36,30
1658117635357,MATH 103A,A02,083778,Greenfeld; Be'Eri,5,0,36,31
1658117635357,MATH 103A,A03,093561,Greenfeld; Be'Eri,7,0,36,29
1658117635357,MATH 103A,B01,083779,Greenfeld; Be'Eri,8,0,36,28
1658117635357,MATH 103A,B02,083780,Greenfeld; Be'Eri,4,0,36,32
1658117635357,MATH 103A,B03,093562,Greenfeld; Be'Eri,3,0,36,33
1658117641381,MATH 105,A01,085443,Carter; Anne Toulson,15,0,35,20
1658117641381,MATH 105,A02,093477,Carter; Anne Toulson,20,0,35,15
1658117647404,MATH 109,A01,083213,Ganzberger; Geoffrey Michael,3,0,34,31
1658117647404,MATH 109,A02,083214,Ganzberger; Geoffrey Michael,4,0,34,30
1658117647404,MATH 109,A03,093478,Ganzberger; Geoffrey Michael,2,0,34,32
1658117647404,MATH 109,B01,083215,Ganzberger; Geoffrey Michael,3,0,32,29
1658117647404,MATH 109,B02,083216,Ganzberger; Geoffrey Michael,3,0,32,29
1658117647404,MATH 109,B03,093479,Ganzberger; Geoffrey Michael,8,0,32,24
1658117653429,MATH 142A,A01,083219,Chow; Bennett,7,0,32,25
1658117653429,MATH 142A,A02,083220,Chow; Bennett,10,0,32,22
1658117653429,MATH 142A,A03,093480,Chow; Bennett,9,0,32,23
1658117653429,MATH 142A,B03,093481,Chow; Bennett,8,0,32,24
1658117653429,MATH 142A,B04,093558,Chow; Bennett,14,0,32,18
1658117653429,MATH 142A,B05,093559,Chow; Bennett,7,0,32,25
1658117659454,MATH 193A,A01,083224,Rotar; Vladimir,9,0,34,25
1658117659454,MATH 193A,A02,083225,Rotar; Vladimir,11,0,34,23
1658117659454,MATH 193A,A03,083781,Rotar; Vladimir,5,0,34,29
1658117659454,MATH 193A,A04,083782,Rotar; Vladimir,12,0,34,22
1658117659454,MATH 193A,A05,093482,Rotar; Vladimir,11,0,34,23
1658117665475,MATH 197,001,091859,McAuley; Julian John,9999,0,9999,0
1658117665475,MATH 197,002,095566,Kedlaya; Kiran S.,9997,0,9999,2
1658117665475,MATH 197,003,095567,Xiao; Ming,9999,0,9999,0
1658117665475,MATH 197,004,095571,Perols; Johan Lars,9998,0,9999,1
1658117672539,COGS 9,A01,083615,Shannon; Kyle Michael,11,0,75,64
1658117678565,COGS 11,A01,083617,Boyle; Mary E. T.,23,0,48,25
1658117684592,COGS 13,A01,083071,Bastos; Amalia Pinkusfeld,12,0,71,59
1658117690619,COGS 14A,A01,092681,Semenuks; Arturs,5,1,100,95
1658117696645,COGS 14B,A01,083073,Cheng; Tzu-Han,7,0,63,56
1658117702672,COGS 17,A01,092677,Semenuks; Arturs,7,0,81,74
1658117708699,COGS 100,A01,083619,Allen; Michael Gordon,17,0,70,53
1658117714723,COGS 101A,A01,083621,Davis; Joshua Daniel,9,0,68,59
1658117720747,COGS 101B,A01,091572,Allen; Michael Gordon,14,0,65,51
1658117726771,COGS 101C,A01,083625,Delgado; Tania,17,0,35,18
1658117732793,COGS 107A,A01,083627,Boyle; Mary E. T.,14,0,60,46
1658117738821,COGS 118A,A01,083075,Gupta; Anjum,21,0,76,55
1658117744846,CSE 3,A50,083646,Miranda; Gregory Joseph,24,0,50,26
1658117750868,CSE 8A,A50,083650,Miranda; Gregory Joseph,17,1,56,39
1658117756895,CSE 11,A01,083080,Cao; Yingjun,7,15,40,33
1658117762922,CSE 12,A01,083652,Krause-Levy; Sophia Louisa,30,1,120,90
1658117768948,CSE 15L,A01,083654,Morris; Justin Loren,9,0,50,41
1658117768948,CSE 15L,A02,083655,Morris; Justin Loren,11,0,50,39
1658117774973,CSE 20,A01,083657,Tran; Khoa Dang,39,0,80,41
1658117781001,CSE 21,A01,095574,Bach; Quang Tran,23,0,48,25
1658117787029,CSE 30,A01,083084,Eldon; John,8,0,80,72
1658117787029,CSE 30,B01,095061,Bhaskar; Nishant,9,0,50,41
1658117793056,CSE 100,A01,083659,Cao; Yingjun,5,4,70,65
1658117799078,CSE 134B,A01,083661,Powell; Thomas Allan,25,0,100,75
1658117805102,CSE 140,A01,083663,Gungor; Onat,17,0,85,68
1658117811129,CSE 140L,A01,083088,Eldon; John,23,0,100,77
1658117817156,CSE 175,A01,083665,Kumar; Rakesh,3,0,25,22
1658117823179,CSE 190,A00,092507,Dubnov; Shlomo,8,0,20,12
1658117829208,ECE 45,A01,083139,Congero; Spencer William,7,0,75,68
1658117835232,ECE 65,A50,083695,Saad; Andrew S,12,0,30,18
1658117835232,ECE 65,A51,095125,Saad; Andrew S,24,0,26,2
1658117841265,ECE 109,A01,091882,Touri; Behrouz,21,0,70,49
1658117847288,ECE 180,A00,083140,Abi Samra; Nicholas Camill,1,0,30,29
1658117847288,ECE 180,B00,083141,Abi Samra; Nicholas Camill,0,0,30,30
1658117853314,MATH 10A,A01,083735,Patchell; Gregory David,2,0,30,28
1658117853314,MATH 10A,A02,083736,Patchell; Gregory David,20,0,30,10
1658117853314,MATH 10A,A03,083737,Patchell; Gregory David,16,0,30,14
1658117859345,MATH 10B,A01,083207,Lim; Seonhee,9,0,34,25
1658117859345,MATH 10B,A02,083208,Lim; Seonhee,10,0,35,25
1658117859345,MATH 10B,A03,093472,Lim; Seonhee,7,0,34,27
1658117859345,MATH 10B,B01,083739,Sinha; Shubham,14,0,30,16
1658117865371,MATH 18,A01,083743,Cinel; Cameron Alexander,9,0,30,21
1658117865371,MATH 18,A02,083744,Cinel; Cameron Alexander,18,0,30,12
1658117865371,MATH 18,A03,083745,Cinel; Cameron Alexander,10,0,30,20
1658117865371,MATH 18,B01,083748,Rideout; David Porter,5,0,37,32
1658117865371,MATH 18,B02,083749,Rideout; David Porter,5,0,36,31
1658117865371,MATH 18,B03,083750,Rideout; David Porter,3,0,37,34
1658117865371,MATH 18,B04,083751,Rideout; David Porter,7,0,36,29
1658117865371,MATH 18,B05,093473,Rideout; David Porter,7,0,36,29
1658117865371,MATH 18,B06,093474,Rideout; David Porter,6,0,36,30
1658117871397,MATH 20A,A01,083754,Zheng; Zequn,14,0,40,26
1658117877425,MATH 20B,A01,083756,Briones; Jor-el Thomas Caparas,4,0,36,32
1658117877425,MATH 20B,A02,083757,Briones; Jor-el Thomas Caparas,1,0,36,35
1658117877425,MATH 20B,A03,093475,Briones; Jor-el Thomas Caparas,3,0,36,33
1658117883454,MATH 20C,A01,083760,Briones; Jor-el Thomas Caparas,1,0,35,34
1658117883454,MATH 20C,A02,083761,Briones; Jor-el Thomas Caparas,8,0,35,27
1658117883454,MATH 20C,A03,093476,Briones; Jor-el Thomas Caparas,0,1,36,36
1658117883454,MATH 20C,B01,083762,Bach; Quang Tran,1,0,30,29
1658117889484,MATH 20D,A01,083765,Tran; Brian Kha,5,0,30,25
1658117889484,MATH 20D,A02,083766,Tran; Brian Kha,5,0,30,25
1658117889484,MATH 20D,A03,083767,Tran; Brian Kha,6,0,30,24
1658117895520,MATH 20E,A01,083771,Ganguly; Soumya,12,0,32,20
1658117895520,MATH 20E,A02,083772,Ganguly; Soumya,7,0,32,25
1658117895520,MATH 20E,B01,083773,Ciotti; Benjamin,20,0,35,15
1658117895520,MATH 20E,B02,083774,Ciotti; Benjamin,18,0,35,17
1658117901552,MATH 103A,A01,083777,Greenfeld; Be'Eri,6,0,36,30
1658117901552,MATH 103A,A02,083778,Greenfeld; Be'Eri,5,0,36,31
1658117901552,MATH 103A,A03,093561,Greenfeld; Be'Eri,7,0,36,29
1658117901552,MATH 103A,B01,083779,Greenfeld; Be'Eri,8,0,36,28
1658117901552,MATH 103A,B02,083780,Greenfeld; Be'Eri,4,0,36,32
1658117901552,MATH 103A,B03,093562,Greenfeld; Be'Eri,3,0,36,33
1658117907577,MATH 105,A01,085443,Carter; Anne Toulson,15,0,35,20
1658117907577,MATH 105,A02,093477,Carter; Anne Toulson,20,0,35,15
1658117913600,MATH 109,A01,083213,Ganzberger; Geoffrey Michael,3,0,34,31
1658117913600,MATH 109,A02,083214,Ganzberger; Geoffrey Michael,4,0,34,30
1658117913600,MATH 109,A03,093478,Ganzberger; Geoffrey Michael,2,0,34,32
1658117913600,MATH 109,B01,083215,Ganzberger; Geoffrey Michael,3,0,32,29
1658117913600,MATH 109,B02,083216,Ganzberger; Geoffrey Michael,3,0,32,29
1658117913600,MATH 109,B03,093479,Ganzberger; Geoffrey Michael,8,0,32,24
1658117919623,MATH 142A,A01,083219,Chow; Bennett,7,0,32,25
1658117919623,MATH 142A,A02,083220,Chow; Bennett,10,0,32,22
1658117919623,MATH 142A,A03,093480,Chow; Bennett,9,0,32,23
1658117919623,MATH 142A,B03,093481,Chow; Bennett,8,0,32,24
1658117919623,MATH 142A,B04,093558,Chow; Bennett,14,0,32,18
1658117919623,MATH 142A,B05,093559,Chow; Bennett,7,0,32,25
1658117925648,MATH 193A,A01,083224,Rotar; Vladimir,9,0,34,25
1658117925648,MATH 193A,A02,083225,Rotar; Vladimir,11,0,34,23
1658117925648,MATH 193A,A03,083781,Rotar; Vladimir,5,0,34,29
1658117925648,MATH 193A,A04,083782,Rotar; Vladimir,12,0,34,22
1658117925648,MATH 193A,A05,093482,Rotar; Vladimir,11,0,34,23
1658117931675,MATH 197,001,091859,McAuley; Julian John,9999,0,9999,0
1658117931675,MATH 197,002,095566,Kedlaya; Kiran S.,9997,0,9999,2
1658117931675,MATH 197,003,095567,Xiao; Ming,9999,0,9999,0
1658117931675,MATH 197,004,095571,Perols; Johan Lars,9998,0,9999,1
1658117938742,COGS 9,A01,083615,Shannon; Kyle Michael,11,0,75,64
1658117944767,COGS 11,A01,083617,Boyle; Mary E. T.,23,0,48,25
1658117950789,COGS 13,A01,083071,Bastos; Amalia Pinkusfeld,12,0,71,59
1658117956815,COGS 14A,A01,092681,Semenuks; Arturs,5,1,100,95
1658117962841,COGS 14B,A01,083073,Cheng; Tzu-Han,7,0,63,56
1658117968870,COGS 17,A01,092677,Semenuks; Arturs,7,0,81,74
1658117974895,COGS 100,A01,083619,Allen; Michael Gordon,17,0,70,53
1658117980917,COGS 101A,A01,083621,Davis; Joshua Daniel,9,0,68,59
1658117986943,COGS 101B,A01,091572,Allen; Michael Gordon,14,0,65,51
1658117992970,COGS 101C,A01,083625,Delgado; Tania,17,0,35,18
1658117998997,COGS 107A,A01,083627,Boyle; Mary E. T.,14,0,60,46
1658118005027,COGS 118A,A01,083075,Gupta; Anjum,21,0,76,55
1658118011055,CSE 3,A50,083646,Miranda; Gregory Joseph,24,0,50,26
1658118017083,CSE 8A,A50,083650,Miranda; Gregory Joseph,17,1,56,39
1658118023107,CSE 11,A01,083080,Cao; Yingjun,7,15,40,33
1658118029133,CSE 12,A01,083652,Krause-Levy; Sophia Louisa,30,1,120,90
1658118035157,CSE 15L,A01,083654,Morris; Justin Loren,9,0,50,41
1658118035157,CSE 15L,A02,083655,Morris; Justin Loren,11,0,50,39
1658118041184,CSE 20,A01,083657,Tran; Khoa Dang,39,0,80,41
1658118047208,CSE 21,A01,095574,Bach; Quang Tran,23,0,48,25
1658118053233,CSE 30,A01,083084,Eldon; John,8,0,80,72
1658118053233,CSE 30,B01,095061,Bhaskar; Nishant,9,0,50,41
1658118059256,CSE 100,A01,083659,Cao; Yingjun,5,4,70,65
1658118065279,CSE 134B,A01,083661,Powell; Thomas Allan,25,0,100,75
1658118071313,CSE 140,A01,083663,Gungor; Onat,17,0,85,68
1658118077336,CSE 140L,A01,083088,Eldon; John,23,0,100,77
1658118083358,CSE 175,A01,083665,Kumar; Rakesh,3,0,25,22
1658118089381,CSE 190,A00,092507,Dubnov; Shlomo,8,0,20,12
1658118095405,ECE 45,A01,083139,Congero; Spencer William,7,0,75,68
1658118101429,ECE 65,A50,083695,Saad; Andrew S,12,0,30,18
1658118101429,ECE 65,A51,095125,Saad; Andrew S,24,0,26,2
1658118107452,ECE 109,A01,091882,Touri; Behrouz,21,0,70,49
1658118113477,ECE 180,A00,083140,Abi Samra; Nicholas Camill,1,0,30,29
1658118113477,ECE 180,B00,083141,Abi Samra; Nicholas Camill,0,0,30,30
1658118119507,MATH 10A,A01,083735,Patchell; Gregory David,2,0,30,28
1658118119507,MATH 10A,A02,083736,Patchell; Gregory David,20,0,30,10
1658118119507,MATH 10A,A03,083737,Patchell; Gregory David,16,0,30,14
1658118125531,MATH 10B,A01,083207,Lim; Seonhee,9,0,34,25
1658118125531,MATH 10B,A02,083208,Lim; Seonhee,10,0,35,25
1658118125531,MATH 10B,A03,093472,Lim; Seonhee,7,0,34,27
1658118125531,MATH 10B,B01,083739,Sinha; Shubham,14,0,30,16
1658118131556,MATH 18,A01,083743,Cinel; Cameron Alexander,9,0,30,21
1658118131556,MATH 18,A02,083744,Cinel; Cameron Alexander,18,0,30,12
1658118131556,MATH 18,A03,083745,Cinel; Cameron Alexander,10,0,30,20
1658118131556,MATH 18,B01,083748,Rideout; David Porter,5,0,37,32
1658118131556,MATH 18,B02,083749,Rideout; David Porter,5,0,36,31
1658118131556,MATH 18,B03,083750,Rideout; David Porter,3,0,37,34
1658118131556,MATH 18,B04,083751,Rideout; David Porter,7,0,36,29
1658118131556,MATH 18,B05,093473,Rideout; David Porter,7,0,36,29
1658118131556,MATH 18,B06,093474,Rideout; David Porter,6,0,36,30
1658118137582,MATH 20A,A01,083754,Zheng; Zequn,14,0,40,26
1658118143606,MATH 20B,A01,083756,Briones; Jor-el Thomas Caparas,4,0,36,32
1658118143606,MATH 20B,A02,083757,Briones; Jor-el Thomas Caparas,1,0,36,35
1658118143606,MATH 20B,A03,093475,Briones; Jor-el Thomas Caparas,3,0,36,33
1658118149636,MATH 20C,A01,083760,Briones; Jor-el Thomas Caparas,1,0,35,34
1658118149636,MATH 20C,A02,083761,Briones; Jor-el Thomas Caparas,8,0,35,27
1658118149636,MATH 20C,A03,093476,Briones; Jor-el Thomas Caparas,0,1,36,36
1658118149636,MATH 20C,B01,083762,Bach; Quang Tran,1,0,30,29
1658118155659,MATH 20D,A01,083765,Tran; Brian Kha,5,0,30,25
1658118155659,MATH 20D,A02,083766,Tran; Brian Kha,5,0,30,25
1658118155659,MATH 20D,A03,083767,Tran; Brian Kha,6,0,30,24
1658118161684,MATH 20E,A01,083771,Ganguly; Soumya,12,0,32,20
1658118161684,MATH 20E,A02,083772,Ganguly; Soumya,7,0,32,25
1658118161684,MATH 20E,B01,083773,Ciotti; Benjamin,20,0,35,15
1658118161684,MATH 20E,B02,083774,Ciotti; Benjamin,18,0,35,17
1658118167779,MATH 103A,A01,083777,Greenfeld; Be'Eri,6,0,36,30
1658118167779,MATH 103A,A02,083778,Greenfeld; Be'Eri,5,0,36,31
1658118167779,MATH 103A,A03,093561,Greenfeld; Be'Eri,7,0,36,29
1658118167779,MATH 103A,B01,083779,Greenfeld; Be'Eri,8,0,36,28
1658118167779,MATH 103A,B02,083780,Greenfeld; Be'Eri,4,0,36,32
1658118167779,MATH 103A,B03,093562,Greenfeld; Be'Eri,3,0,36,33
1658118173802,MATH 105,A01,085443,Carter; Anne Toulson,15,0,35,20
1658118173802,MATH 105,A02,093477,Carter; Anne Toulson,20,0,35,15
1658118179827,MATH 109,A01,083213,Ganzberger; Geoffrey Michael,3,0,34,31
1658118179827,MATH 109,A02,083214,Ganzberger; Geoffrey Michael,4,0,34,30
1658118179827,MATH 109,A03,093478,Ganzberger; Geoffrey Michael,2,0,34,32
1658118179827,MATH 109,B01,083215,Ganzberger; Geoffrey Michael,3,0,32,29
1658118179827,MATH 109,B02,083216,Ganzberger; Geoffrey Michael,3,0,32,29
1658118179827,MATH 109,B03,093479,Ganzberger; Geoffrey Michael,8,0,32,24
1658118185856,MATH 142A,A01,083219,Chow; Bennett,7,0,32,25
1658118185856,MATH 142A,A02,083220,Chow; Bennett,10,0,32,22
1658118185856,MATH 142A,A03,093480,Chow; Bennett,9,0,32,23
1658118185856,MATH 142A,B03,093481,Chow; Bennett,8,0,32,24
1658118185856,MATH 142A,B04,093558,Chow; Bennett,14,0,32,18
1658118185856,MATH 142A,B05,093559,Chow; Bennett,7,0,32,25
1658118191885,MATH 193A,A01,083224,Rotar; Vladimir,9,0,34,25
1658118191885,MATH 193A,A02,083225,Rotar; Vladimir,11,0,34,23
1658118191885,MATH 193A,A03,083781,Rotar; Vladimir,5,0,34,29
1658118191885,MATH 193A,A04,083782,Rotar; Vladimir,12,0,34,22
1658118191885,MATH 193A,A05,093482,Rotar; Vladimir,11,0,34,23
1658118197910,MATH 197,001,091859,McAuley; Julian John,9999,0,9999,0
1658118197910,MATH 197,002,095566,Kedlaya; Kiran S.,9997,0,9999,2
1658118197910,MATH 197,003,095567,Xiao; Ming,9999,0,9999,0
1658118197910,MATH 197,004,095571,Perols; Johan Lars,9998,0,9999,1
1658118204975,COGS 9,A01,083615,Shannon; Kyle Michael,11,0,75,64
1658118211003,COGS 11,A01,083617,Boyle; Mary E. T.,23,0,48,25
1658118217026,COGS 13,A01,083071,Bastos; Amalia Pinkusfeld,12,0,71,59
1658118223053,COGS 14A,A01,092681,Semenuks; Arturs,5,1,100,95
1658118229081,COGS 14B,A01,083073,Cheng; Tzu-Han,7,0,63,56
1658118235104,COGS 17,A01,092677,Semenuks; Arturs,7,0,81,74
1658118241125,COGS 100,A01,083619,Allen; Michael Gordon,17,0,70,53
1658118247147,COGS 101A,A01,083621,Davis; Joshua Daniel,9,0,68,59
1658118253171,COGS 101B,A01,091572,Allen; Michael Gordon,14,0,65,51
1658118259195,COGS 101C,A01,083625,Delgado; Tania,17,0,35,18
1658118265219,COGS 107A,A01,083627,Boyle; Mary E. T.,14,0,60,46
1658118271246,COGS 118A,A01,083075,Gupta; Anjum,21,0,76,55
1658118277271,CSE 3,A50,083646,Miranda; Gregory Joseph,24,0,50,26
1658118283293,CSE 8A,A50,083650,Miranda; Gregory Joseph,17,1,56,39
1658118289320,CSE 11,A01,083080,Cao; Yingjun,7,15,40,33
1658118295348,CSE 12,A01,083652,Krause-Levy; Sophia Louisa,30,1,120,90
1658118301376,CSE 15L,A01,083654,Morris; Justin Loren,9,0,50,41
1658118301376,CSE 15L,A02,083655,Morris; Justin Loren,11,0,50,39
1658118307400,CSE 20,A01,083657,Tran; Khoa Dang,39,0,80,41
1658118313428,CSE 21,A01,095574,Bach; Quang Tran,23,0,48,25
1658118319449,CSE 30,A01,083084,Eldon; John,8,0,80,72
1658118319449,CSE 30,B01,095061,Bhaskar; Nishant,9,0,50,41
1658118325475,CSE 100,A01,083659,Cao; Yingjun,5,4,70,65
1658118331504,CSE 134B,A01,083661,Powell; Thomas Allan,25,0,100,75
1658118337530,CSE 140,A01,083663,Gungor; Onat,17,0,85,68
1658118343552,CSE 140L,A01,083088,Eldon; John,23,0,100,77
1658118349579,CSE 175,A01,083665,Kumar; Rakesh,3,0,25,22
1658118355603,CSE 190,A00,092507,Dubnov; Shlomo,8,0,20,12
1658118361626,ECE 45,A01,083139,Congero; Spencer William,7,0,75,68
1658118367649,ECE 65,A50,083695,Saad; Andrew S,12,0,30,18
1658118367649,ECE 65,A51,095125,Saad; Andrew S,24,0,26,2
1658118373674,ECE 109,A01,091882,Touri; Behrouz,21,0,70,49
1658118379702,ECE 180,A00,083140,Abi Samra; Nicholas Camill,1,0,30,29
1658118379702,ECE 180,B00,083141,Abi Samra; Nicholas Camill,0,0,30,30
1658118385727,MATH 10A,A01,083735,Patchell; Gregory David,2,0,30,28
1658118385727,MATH 10A,A02,083736,Patchell; Gregory David,20,0,30,10
1658118385727,MATH 10A,A03,083737,Patchell; Gregory David,16,0,30,14
1658118391754,MATH 10B,A01,083207,Lim; Seonhee,9,0,34,25
1658118391754,MATH 10B,A02,083208,Lim; Seonhee,10,0,35,25
1658118391754,MATH 10B,A03,093472,Lim; Seonhee,7,0,34,27
1658118391754,MATH 10B,B01,083739,Sinha; Shubham,14,0,30,16
1658118397777,MATH 18,A01,083743,Cinel; Cameron Alexander,9,0,30,21
1658118397777,MATH 18,A02,083744,Cinel; Cameron Alexander,18,0,30,12
1658118397777,MATH 18,A03,083745,Cinel; Cameron Alexander,10,0,30,20
1658118397777,MATH 18,B01,083748,Rideout; David Porter,5,0,37,32
1658118397777,MATH 18,B02,083749,Rideout; David Porter,5,0,36,31
1658118397777,MATH 18,B03,083750,Rideout; David Porter,3,0,37,34
1658118397777,MATH 18,B04,083751,Rideout; David Porter,7,0,36,29
1658118397777,MATH 18,B05,093473,Rideout; David Porter,7,0,36,29
1658118397777,MATH 18,B06,093474,Rideout; David Porter,6,0,36,30
1658118403804,MATH 20A,A01,083754,Zheng; Zequn,14,0,40,26
1658118409827,MATH 20B,A01,083756,Briones; Jor-el Thomas Caparas,4,0,36,32
1658118409827,MATH 20B,A02,083757,Briones; Jor-el Thomas Caparas,1,0,36,35
1658118409827,MATH 20B,A03,093475,Briones; Jor-el Thomas Caparas,3,0,36,33
1658118415851,MATH 20C,A01,083760,Briones; Jor-el Thomas Caparas,1,0,35,34
1658118415851,MATH 20C,A02,083761,Briones; Jor-el Thomas Caparas,8,0,35,27
1658118415851,MATH 20C,A03,093476,Briones; Jor-el Thomas Caparas,0,1,36,36
1658118415851,MATH 20C,B01,083762,Bach; Quang Tran,1,0,30,29
1658118421873,MATH 20D,A01,083765,Tran; Brian Kha,5,0,30,25
1658118421873,MATH 20D,A02,083766,Tran; Brian Kha,5,0,30,25
1658118421873,MATH 20D,A03,083767,Tran; Brian Kha,6,0,30,24
1658118427899,MATH 20E,A01,083771,Ganguly; Soumya,12,0,32,20
1658118427899,MATH 20E,A02,083772,Ganguly; Soumya,7,0,32,25
1658118427899,MATH 20E,B01,083773,Ciotti; Benjamin,20,0,35,15
1658118427899,MATH 20E,B02,083774,Ciotti; Benjamin,18,0,35,17
1658118433923,MATH 103A,A01,083777,Greenfeld; Be'Eri,6,0,36,30
1658118433923,MATH 103A,A02,083778,Greenfeld; Be'Eri,5,0,36,31
1658118433923,MATH 103A,A03,093561,Greenfeld; Be'Eri,7,0,36,29
1658118433923,MATH 103A,B01,083779,Greenfeld; Be'Eri,8,0,36,28
1658118433923,MATH 103A,B02,083780,Greenfeld; Be'Eri,4,0,36,32
1658118433923,MATH 103A,B03,093562,Greenfeld; Be'Eri,3,0,36,33
1658118439950,MATH 105,A01,085443,Carter; Anne Toulson,15,0,35,20
1658118439950,MATH 105,A02,093477,Carter; Anne Toulson,20,0,35,15
1658118445977,MATH 109,A01,083213,Ganzberger; Geoffrey Michael,3,0,34,31
1658118445977,MATH 109,A02,083214,Ganzberger; Geoffrey Michael,4,0,34,30
1658118445977,MATH 109,A03,093478,Ganzberger; Geoffrey Michael,2,0,34,32
1658118445977,MATH 109,B01,083215,Ganzberger; Geoffrey Michael,3,0,32,29
1658118445977,MATH 109,B02,083216,Ganzberger; Geoffrey Michael,3,0,32,29
1658118445977,MATH 109,B03,093479,Ganzberger; Geoffrey Michael,8,0,32,24
1658118452005,MATH 142A,A01,083219,Chow; Bennett,7,0,32,25
1658118452005,MATH 142A,A02,083220,Chow; Bennett,10,0,32,22
1658118452005,MATH 142A,A03,093480,Chow; Bennett,9,0,32,23
1658118452005,MATH 142A,B03,093481,Chow; Bennett,8,0,32,24
1658118452005,MATH 142A,B04,093558,Chow; Bennett,14,0,32,18
1658118452005,MATH 142A,B05,093559,Chow; Bennett,7,0,32,25
1658118458033,MATH 193A,A01,083224,Rotar; Vladimir,9,0,34,25
1658118458033,MATH 193A,A02,083225,Rotar; Vladimir,11,0,34,23
1658118458033,MATH 193A,A03,083781,Rotar; Vladimir,5,0,34,29
1658118458033,MATH 193A,A04,083782,Rotar; Vladimir,12,0,34,22
1658118458033,MATH 193A,A05,093482,Rotar; Vladimir,11,0,34,23
1658118464060,MATH 197,001,091859,McAuley; Julian John,9999,0,9999,0
1658118464060,MATH 197,002,095566,Kedlaya; Kiran S.,9997,0,9999,2
1658118464060,MATH 197,003,095567,Xiao; Ming,9999,0,9999,0
1658118464060,MATH 197,004,095571,Perols; Johan Lars,9998,0,9999,1
1658118471137,COGS 9,A01,083615,Shannon; Kyle Michael,11,0,75,64
1658118477160,COGS 11,A01,083617,Boyle; Mary E. T.,23,0,48,25
1658118483188,COGS 13,A01,083071,Bastos; Amalia Pinkusfeld,12,0,71,59
1658118489212,COGS 14A,A01,092681,Semenuks; Arturs,5,1,100,95
1658118495235,COGS 14B,A01,083073,Cheng; Tzu-Han,7,0,63,56
1658118501257,COGS 17,A01,092677,Semenuks; Arturs,7,0,81,74
1658118507280,COGS 100,A01,083619,Allen; Michael Gordon,17,0,70,53
1658118513312,COGS 101A,A01,083621,Davis; Joshua Daniel,9,0,68,59
1658118519334,COGS 101B,A01,091572,Allen; Michael Gordon,14,0,65,51
1658118525360,COGS 101C,A01,083625,Delgado; Tania,17,0,35,18
1658118531383,COGS 107A,A01,083627,Boyle; Mary E. T.,14,0,60,46
1658118537411,COGS 118A,A01,083075,Gupta; Anjum,21,0,76,55
1658118543439,CSE 3,A50,083646,Miranda; Gregory Joseph,24,0,50,26
1658118549471,CSE 8A,A50,083650,Miranda; Gregory Joseph,17,1,56,39
1658118555502,CSE 11,A01,083080,Cao; Yingjun,7,15,40,33
1658118561525,CSE 12,A01,083652,Krause-Levy; Sophia Louisa,30,1,120,90
1658118567550,CSE 15L,A01,083654,Morris; Justin Loren,9,0,50,41
1658118567550,CSE 15L,A02,083655,Morris; Justin Loren,11,0,50,39
1658118573573,CSE 20,A01,083657,Tran; Khoa Dang,39,0,80,41
1658118579601,CSE 21,A01,095574,Bach; Quang Tran,23,0,48,25
1658118585624,CSE 30,A01,083084,Eldon; John,8,0,80,72
1658118585624,CSE 30,B01,095061,Bhaskar; Nishant,9,0,50,41
1658118591654,CSE 100,A01,083659,Cao; Yingjun,5,4,70,65
1658118597676,CSE 134B,A01,083661,Powell; Thomas Allan,25,0,100,75
1658118603699,CSE 140,A01,083663,Gungor; Onat,17,0,85,68
1658118609727,CSE 140L,A01,083088,Eldon; John,23,0,100,77
1658118615753,CSE 175,A01,083665,Kumar; Rakesh,3,0,25,22
1658118621780,CSE 190,A00,092507,Dubnov; Shlomo,8,0,20,12
1658118627803,ECE 45,A01,083139,Congero; Spencer William,7,0,75,68
1658118633826,ECE 65,A50,083695,Saad; Andrew S,12,0,30,18
1658118633826,ECE 65,A51,095125,Saad; Andrew S,24,0,26,2
1658118639850,ECE 109,A01,091882,Touri; Behrouz,21,0,70,49
1658118645885,ECE 180,A00,083140,Abi Samra; Nicholas Camill,1,0,30,29
1658118645885,ECE 180,B00,083141,Abi Samra; Nicholas Camill,0,0,30,30
1658118651909,MATH 10A,A01,083735,Patchell; Gregory David,2,0,30,28
1658118651909,MATH 10A,A02,083736,Patchell; Gregory David,20,0,30,10
1658118651909,MATH 10A,A03,083737,Patchell; Gregory David,16,0,30,14
1658118657937,MATH 10B,A01,083207,Lim; Seonhee,9,0,34,25
1658118657937,MATH 10B,A02,083208,Lim; Seonhee,10,0,35,25
1658118657937,MATH 10B,A03,093472,Lim; Seonhee,7,0,34,27
1658118657937,MATH 10B,B01,083739,Sinha; Shubham,14,0,30,16
1658118663970,MATH 18,A01,083743,Cinel; Cameron Alexander,9,0,30,21
1658118663970,MATH 18,A02,083744,Cinel; Cameron Alexander,18,0,30,12
1658118663970,MATH 18,A03,083745,Cinel; Cameron Alexander,10,0,30,20
1658118663970,MATH 18,B01,083748,Rideout; David Porter,5,0,37,32
1658118663970,MATH 18,B02,083749,Rideout; David Porter,5,0,36,31
1658118663970,MATH 18,B03,083750,Rideout; David Porter,3,0,37,34
1658118663970,MATH 18,B04,083751,Rideout; David Porter,7,0,36,29
1658118663970,MATH 18,B05,093473,Rideout; David Porter,7,0,36,29
1658118663970,MATH 18,B06,093474,Rideout; David Porter,6,0,36,30
1658118669998,MATH 20A,A01,083754,Zheng; Zequn,14,0,40,26
1658118676023,MATH 20B,A01,083756,Briones; Jor-el Thomas Caparas,4,0,36,32
1658118676023,MATH 20B,A02,083757,Briones; Jor-el Thomas Caparas,1,0,36,35
1658118676023,MATH 20B,A03,093475,Briones; Jor-el Thomas Caparas,3,0,36,33
1658118682048,MATH 20C,A01,083760,Briones; Jor-el Thomas Caparas,1,0,35,34
1658118682048,MATH 20C,A02,083761,Briones; Jor-el Thomas Caparas,8,0,35,27
1658118682048,MATH 20C,A03,093476,Briones; Jor-el Thomas Caparas,0,1,36,36
1658118682048,MATH 20C,B01,083762,Bach; Quang Tran,1,0,30,29
1658118688080,MATH 20D,A01,083765,Tran; Brian Kha,5,0,30,25
1658118688080,MATH 20D,A02,083766,Tran; Brian Kha,5,0,30,25
1658118688080,MATH 20D,A03,083767,Tran; Brian Kha,6,0,30,24
1658118694104,MATH 20E,A01,083771,Ganguly; Soumya,12,0,32,20
1658118694104,MATH 20E,A02,083772,Ganguly; Soumya,7,0,32,25
1658118694104,MATH 20E,B01,083773,Ciotti; Benjamin,20,0,35,15
1658118694104,MATH 20E,B02,083774,Ciotti; Benjamin,18,0,35,17
1658118700128,MATH 103A,A01,083777,Greenfeld; Be'Eri,6,0,36,30
1658118700128,MATH 103A,A02,083778,Greenfeld; Be'Eri,5,0,36,31
1658118700128,MATH 103A,A03,093561,Greenfeld; Be'Eri,7,0,36,29
1658118700128,MATH 103A,B01,083779,Greenfeld; Be'Eri,8,0,36,28
1658118700128,MATH 103A,B02,083780,Greenfeld; Be'Eri,4,0,36,32
1658118700128,MATH 103A,B03,093562,Greenfeld; Be'Eri,3,0,36,33
1658118706154,MATH 105,A01,085443,Carter; Anne Toulson,15,0,35,20
1658118706154,MATH 105,A02,093477,Carter; Anne Toulson,20,0,35,15
1658118712183,MATH 109,A01,083213,Ganzberger; Geoffrey Michael,3,0,34,31
1658118712183,MATH 109,A02,083214,Ganzberger; Geoffrey Michael,4,0,34,30
1658118712183,MATH 109,A03,093478,Ganzberger; Geoffrey Michael,2,0,34,32
1658118712183,MATH 109,B01,083215,Ganzberger; Geoffrey Michael,3,0,32,29
1658118712183,MATH 109,B02,083216,Ganzberger; Geoffrey Michael,3,0,32,29
1658118712183,MATH 109,B03,093479,Ganzberger; Geoffrey Michael,8,0,32,24
1658118718207,MATH 142A,A01,083219,Chow; Bennett,7,0,32,25
1658118718207,MATH 142A,A02,083220,Chow; Bennett,10,0,32,22
1658118718207,MATH 142A,A03,093480,Chow; Bennett,9,0,32,23
1658118718207,MATH 142A,B03,093481,Chow; Bennett,8,0,32,24
1658118718207,MATH 142A,B04,093558,Chow; Bennett,14,0,32,18
1658118718207,MATH 142A,B05,093559,Chow; Bennett,7,0,32,25
1658118724236,MATH 193A,A01,083224,Rotar; Vladimir,9,0,34,25
1658118724236,MATH 193A,A02,083225,Rotar; Vladimir,11,0,34,23
1658118724236,MATH 193A,A03,083781,Rotar; Vladimir,5,0,34,29
1658118724236,MATH 193A,A04,083782,Rotar; Vladimir,12,0,34,22
1658118724236,MATH 193A,A05,093482,Rotar; Vladimir,11,0,34,23
1658118730262,MATH 197,001,091859,McAuley; Julian John,9999,0,9999,0
1658118730262,MATH 197,002,095566,Kedlaya; Kiran S.,9997,0,9999,2
1658118730262,MATH 197,003,095567,Xiao; Ming,9999,0,9999,0
1658118730262,MATH 197,004,095571,Perols; Johan Lars,9998,0,9999,1
1658118737322,COGS 9,A01,083615,Shannon; Kyle Michael,11,0,75,64
1658118743349,COGS 11,A01,083617,Boyle; Mary E. T.,23,0,48,25
1658118749386,COGS 13,A01,083071,Bastos; Amalia Pinkusfeld,12,0,71,59
1658118755410,COGS 14A,A01,092681,Semenuks; Arturs,5,1,100,95
1658118761504,COGS 14B,A01,083073,Cheng; Tzu-Han,7,0,63,56
1658118767527,COGS 17,A01,092677,Semenuks; Arturs,7,0,81,74
1658118773555,COGS 100,A01,083619,Allen; Michael Gordon,17,0,70,53
1658118779582,COGS 101A,A01,083621,Davis; Joshua Daniel,9,0,68,59
1658118785608,COGS 101B,A01,091572,Allen; Michael Gordon,14,0,65,51
1658118791635,COGS 101C,A01,083625,Delgado; Tania,17,0,35,18
1658118797667,COGS 107A,A01,083627,Boyle; Mary E. T.,14,0,60,46
1658118803690,COGS 118A,A01,083075,Gupta; Anjum,21,0,76,55
1658118809713,CSE 3,A50,083646,Miranda; Gregory Joseph,24,0,50,26
1658118815737,CSE 8A,A50,083650,Miranda; Gregory Joseph,17,1,56,39
1658118821763,CSE 11,A01,083080,Cao; Yingjun,7,15,40,33
1658118827788,CSE 12,A01,083652,Krause-Levy; Sophia Louisa,30,1,120,90
1658118833810,CSE 15L,A01,083654,Morris; Justin Loren,9,0,50,41
1658118833810,CSE 15L,A02,083655,Morris; Justin Loren,11,0,50,39
1658118839834,CSE 20,A01,083657,Tran; Khoa Dang,39,0,80,41
1658118845857,CSE 21,A01,095574,Bach; Quang Tran,23,0,48,25
1658118851884,CSE 30,A01,083084,Eldon; John,8,0,80,72
1658118851884,CSE 30,B01,095061,Bhaskar; Nishant,9,0,50,41
1658118857910,CSE 100,A01,083659,Cao; Yingjun,5,4,70,65
1658118863942,CSE 134B,A01,083661,Powell; Thomas Allan,25,0,100,75
1658118869970,CSE 140,A01,083663,Gungor; Onat,17,0,85,68
1658118875999,CSE 140L,A01,083088,Eldon; John,23,0,100,77
1658118882030,CSE 175,A01,083665,Kumar; Rakesh,3,0,25,22
1658118888057,CSE 190,A00,092507,Dubnov; Shlomo,8,0,20,12
1658118894088,ECE 45,A01,083139,Congero; Spencer William,7,0,75,68
1658118900111,ECE 65,A50,083695,Saad; Andrew S,12,0,30,18
1658118900111,ECE 65,A51,095125,Saad; Andrew S,24,0,26,2
1658118906134,ECE 109,A01,091882,Touri; Behrouz,21,0,70,49
1658118912157,ECE 180,A00,083140,Abi Samra; Nicholas Camill,1,0,30,29
1658118912157,ECE 180,B00,083141,Abi Samra; Nicholas Camill,0,0,30,30
1658118918185,MATH 10A,A01,083735,Patchell; Gregory David,2,0,30,28
1658118918185,MATH 10A,A02,083736,Patchell; Gregory David,20,0,30,10
1658118918185,MATH 10A,A03,083737,Patchell; Gregory David,16,0,30,14
1658118924209,MATH 10B,A01,083207,Lim; Seonhee,9,0,34,25
1658118924209,MATH 10B,A02,083208,Lim; Seonhee,10,0,35,25
1658118924209,MATH 10B,A03,093472,Lim; Seonhee,7,0,34,27
1658118924209,MATH 10B,B01,083739,Sinha; Shubham,14,0,30,16
1658118930238,MATH 18,A01,083743,Cinel; Cameron Alexander,9,0,30,21
1658118930238,MATH 18,A02,083744,Cinel; Cameron Alexander,18,0,30,12
1658118930238,MATH 18,A03,083745,Cinel; Cameron Alexander,10,0,30,20
1658118930238,MATH 18,B01,083748,Rideout; David Porter,5,0,37,32
1658118930238,MATH 18,B02,083749,Rideout; David Porter,5,0,36,31
1658118930238,MATH 18,B03,083750,Rideout; David Porter,3,0,37,34
1658118930238,MATH 18,B04,083751,Rideout; David Porter,7,0,36,29
1658118930238,MATH 18,B05,093473,Rideout; David Porter,7,0,36,29
1658118930238,MATH 18,B06,093474,Rideout; David Porter,6,0,36,30
1658118936265,MATH 20A,A01,083754,Zheng; Zequn,14,0,40,26
1658118942289,MATH 20B,A01,083756,Briones; Jor-el Thomas Caparas,4,0,36,32
1658118942289,MATH 20B,A02,083757,Briones; Jor-el Thomas Caparas,1,0,36,35
1658118942289,MATH 20B,A03,093475,Briones; Jor-el Thomas Caparas,3,0,36,33
1658118948313,MATH 20C,A01,083760,Briones; Jor-el Thomas Caparas,1,0,35,34
1658118948313,MATH 20C,A02,083761,Briones; Jor-el Thomas Caparas,8,0,35,27
1658118948313,MATH 20C,A03,093476,Briones; Jor-el Thomas Caparas,0,1,36,36
1658118948313,MATH 20C,B01,083762,Bach; Quang Tran,1,0,30,29
1658118954341,MATH 20D,A01,083765,Tran; Brian Kha,5,0,30,25
1658118954341,MATH 20D,A02,083766,Tran; Brian Kha,5,0,30,25
1658118954341,MATH 20D,A03,083767,Tran; Brian Kha,6,0,30,24
1658118960368,MATH 20E,A01,083771,Ganguly; Soumya,12,0,32,20
1658118960368,MATH 20E,A02,083772,Ganguly; Soumya,7,0,32,25
1658118960368,MATH 20E,B01,083773,Ciotti; Benjamin,20,0,35,15
1658118960368,MATH 20E,B02,083774,Ciotti; Benjamin,18,0,35,17
1658118966392,MATH 103A,A01,083777,Greenfeld; Be'Eri,6,0,36,30
1658118966392,MATH 103A,A02,083778,Greenfeld; Be'Eri,5,0,36,31
1658118966392,MATH 103A,A03,093561,Greenfeld; Be'Eri,7,0,36,29
1658118966392,MATH 103A,B01,083779,Greenfeld; Be'Eri,8,0,36,28
1658118966392,MATH 103A,B02,083780,Greenfeld; Be'Eri,4,0,36,32
1658118966392,MATH 103A,B03,093562,Greenfeld; Be'Eri,3,0,36,33
1658118972423,MATH 105,A01,085443,Carter; Anne Toulson,15,0,35,20
1658118972423,MATH 105,A02,093477,Carter; Anne Toulson,20,0,35,15
1658118978452,MATH 109,A01,083213,Ganzberger; Geoffrey Michael,3,0,34,31
1658118978452,MATH 109,A02,083214,Ganzberger; Geoffrey Michael,4,0,34,30
1658118978452,MATH 109,A03,093478,Ganzberger; Geoffrey Michael,2,0,34,32
1658118978452,MATH 109,B01,083215,Ganzberger; Geoffrey Michael,3,0,32,29
1658118978452,MATH 109,B02,083216,Ganzberger; Geoffrey Michael,3,0,32,29
1658118978452,MATH 109,B03,093479,Ganzberger; Geoffrey Michael,8,0,32,24
1658118984474,MATH 142A,A01,083219,Chow; Bennett,7,0,32,25
1658118984474,MATH 142A,A02,083220,Chow; Bennett,10,0,32,22
1658118984474,MATH 142A,A03,093480,Chow; Bennett,9,0,32,23
1658118984474,MATH 142A,B03,093481,Chow; Bennett,8,0,32,24
1658118984474,MATH 142A,B04,093558,Chow; Bennett,14,0,32,18
1658118984474,MATH 142A,B05,093559,Chow; Bennett,7,0,32,25
1658118990499,MATH 193A,A01,083224,Rotar; Vladimir,9,0,34,25
1658118990499,MATH 193A,A02,083225,Rotar; Vladimir,11,0,34,23
1658118990499,MATH 193A,A03,083781,Rotar; Vladimir,5,0,34,29
1658118990499,MATH 193A,A04,083782,Rotar; Vladimir,12,0,34,22
1658118990499,MATH 193A,A05,093482,Rotar; Vladimir,11,0,34,23
1658118996528,MATH 197,001,091859,McAuley; Julian John,9999,0,9999,0
1658118996528,MATH 197,002,095566,Kedlaya; Kiran S.,9997,0,9999,2
1658118996528,MATH 197,003,095567,Xiao; Ming,9999,0,9999,0
1658118996528,MATH 197,004,095571,Perols; Johan Lars,9998,0,9999,1
1658119003584,COGS 9,A01,083615,Shannon; Kyle Michael,11,0,75,64
1658119009611,COGS 11,A01,083617,Boyle; Mary E. T.,23,0,48,25
1658119015639,COGS 13,A01,083071,Bastos; Amalia Pinkusfeld,12,0,71,59
1658119021675,COGS 14A,A01,092681,Semenuks; Arturs,5,1,100,95
1658119027698,COGS 14B,A01,083073,Cheng; Tzu-Han,7,0,63,56
1658119033723,COGS 17,A01,092677,Semenuks; Arturs,7,0,81,74
1658119039755,COGS 100,A01,083619,Allen; Michael Gordon,17,0,70,53
1658119045782,COGS 101A,A01,083621,Davis; Joshua Daniel,9,0,68,59
1658119051806,COGS 101B,A01,091572,Allen; Michael Gordon,14,0,65,51
1658119057832,COGS 101C,A01,083625,Delgado; Tania,17,0,35,18
1658119063857,COGS 107A,A01,083627,Boyle; Mary E. T.,14,0,60,46
1658119069878,COGS 118A,A01,083075,Gupta; Anjum,21,0,76,55
1658119075901,CSE 3,A50,083646,Miranda; Gregory Joseph,24,0,50,26
1658119081923,CSE 8A,A50,083650,Miranda; Gregory Joseph,17,1,56,39
1658119087948,CSE 11,A01,083080,Cao; Yingjun,7,15,40,33
1658119093970,CSE 12,A01,083652,Krause-Levy; Sophia Louisa,30,1,120,90
1658119099997,CSE 15L,A01,083654,Morris; Justin Loren,9,0,50,41
1658119099997,CSE 15L,A02,083655,Morris; Justin Loren,11,0,50,39
1658119106023,CSE 20,A01,083657,Tran; Khoa Dang,39,0,80,41
1658119112049,CSE 21,A01,095574,Bach; Quang Tran,23,0,48,25
1658119118070,CSE 30,A01,083084,Eldon; John,8,0,80,72
1658119118070,CSE 30,B01,095061,Bhaskar; Nishant,9,0,50,41
1658119124093,CSE 100,A01,083659,Cao; Yingjun,5,4,70,65
1658119130116,CSE 134B,A01,083661,Powell; Thomas Allan,25,0,100,75
1658119136141,CSE 140,A01,083663,Gungor; Onat,17,0,85,68
1658119142163,CSE 140L,A01,083088,Eldon; John,23,0,100,77
1658119148186,CSE 175,A01,083665,Kumar; Rakesh,3,0,25,22
1658119154209,CSE 190,A00,092507,Dubnov; Shlomo,8,0,20,12
1658119160232,ECE 45,A01,083139,Congero; Spencer William,7,0,75,68
1658119166255,ECE 65,A50,083695,Saad; Andrew S,12,0,30,18
1658119166255,ECE 65,A51,095125,Saad; Andrew S,24,0,26,2
1658119172277,ECE 109,A01,091882,Touri; Behrouz,21,0,70,49
1658119178312,ECE 180,A00,083140,Abi Samra; Nicholas Camill,1,0,30,29
1658119178312,ECE 180,B00,083141,Abi Samra; Nicholas Camill,0,0,30,30
1658119184344,MATH 10A,A01,083735,Patchell; Gregory David,2,0,30,28
1658119184344,MATH 10A,A02,083736,Patchell; Gregory David,20,0,30,10
1658119184344,MATH 10A,A03,083737,Patchell; Gregory David,16,0,30,14
1658119190368,MATH 10B,A01,083207,Lim; Seonhee,9,0,34,25
1658119190368,MATH 10B,A02,083208,Lim; Seonhee,10,0,35,25
1658119190368,MATH 10B,A03,093472,Lim; Seonhee,7,0,34,27
1658119190368,MATH 10B,B01,083739,Sinha; Shubham,14,0,30,16
1658119196393,MATH 18,A01,083743,Cinel; Cameron Alexander,9,0,30,21
1658119196393,MATH 18,A02,083744,Cinel; Cameron Alexander,18,0,30,12
1658119196393,MATH 18,A03,083745,Cinel; Cameron Alexander,10,0,30,20
1658119196393,MATH 18,B01,083748,Rideout; David Porter,5,0,37,32
1658119196393,MATH 18,B02,083749,Rideout; David Porter,5,0,36,31
1658119196393,MATH 18,B03,083750,Rideout; David Porter,3,0,37,34
1658119196393,MATH 18,B04,083751,Rideout; David Porter,7,0,36,29
1658119196393,MATH 18,B05,093473,Rideout; David Porter,7,0,36,29
1658119196393,MATH 18,B06,093474,Rideout; David Porter,6,0,36,30
1658119202419,MATH 20A,A01,083754,Zheng; Zequn,14,0,40,26
1658119208451,MATH 20B,A01,083756,Briones; Jor-el Thomas Caparas,4,0,36,32
1658119208451,MATH 20B,A02,083757,Briones; Jor-el Thomas Caparas,1,0,36,35
1658119208451,MATH 20B,A03,093475,Briones; Jor-el Thomas Caparas,3,0,36,33
1658119214475,MATH 20C,A01,083760,Briones; Jor-el Thomas Caparas,1,0,35,34
1658119214475,MATH 20C,A02,083761,Briones; Jor-el Thomas Caparas,8,0,35,27
1658119214475,MATH 20C,A03,093476,Briones; Jor-el Thomas Caparas,0,1,36,36
1658119214475,MATH 20C,B01,083762,Bach; Quang Tran,1,0,30,29
1658119220502,MATH 20D,A01,083765,Tran; Brian Kha,5,0,30,25
1658119220502,MATH 20D,A02,083766,Tran; Brian Kha,5,0,30,25
1658119220502,MATH 20D,A03,083767,Tran; Brian Kha,6,0,30,24
1658119226524,MATH 20E,A01,083771,Ganguly; Soumya,12,0,32,20
1658119226524,MATH 20E,A02,083772,Ganguly; Soumya,7,0,32,25
1658119226524,MATH 20E,B01,083773,Ciotti; Benjamin,20,0,35,15
1658119226524,MATH 20E,B02,083774,Ciotti; Benjamin,18,0,35,17
1658119232547,MATH 103A,A01,083777,Greenfeld; Be'Eri,6,0,36,30
1658119232547,MATH 103A,A02,083778,Greenfeld; Be'Eri,5,0,36,31
1658119232547,MATH 103A,A03,093561,Greenfeld; Be'Eri,7,0,36,29
1658119232547,MATH 103A,B01,083779,Greenfeld; Be'Eri,8,0,36,28
1658119232547,MATH 103A,B02,083780,Greenfeld; Be'Eri,4,0,36,32
1658119232547,MATH 103A,B03,093562,Greenfeld; Be'Eri,3,0,36,33
1658119238571,MATH 105,A01,085443,Carter; Anne Toulson,15,0,35,20
1658119238571,MATH 105,A02,093477,Carter; Anne Toulson,20,0,35,15
1658119244595,MATH 109,A01,083213,Ganzberger; Geoffrey Michael,3,0,34,31
1658119244595,MATH 109,A02,083214,Ganzberger; Geoffrey Michael,4,0,34,30
1658119244595,MATH 109,A03,093478,Ganzberger; Geoffrey Michael,2,0,34,32
1658119244595,MATH 109,B01,083215,Ganzberger; Geoffrey Michael,3,0,32,29
1658119244595,MATH 109,B02,083216,Ganzberger; Geoffrey Michael,3,0,32,29
1658119244595,MATH 109,B03,093479,Ganzberger; Geoffrey Michael,8,0,32,24
1658119250619,MATH 142A,A01,083219,Chow; Bennett,7,0,32,25
1658119250619,MATH 142A,A02,083220,Chow; Bennett,10,0,32,22
1658119250619,MATH 142A,A03,093480,Chow; Bennett,9,0,32,23
1658119250619,MATH 142A,B03,093481,Chow; Bennett,8,0,32,24
1658119250619,MATH 142A,B04,093558,Chow; Bennett,14,0,32,18
1658119250619,MATH 142A,B05,093559,Chow; Bennett,7,0,32,25
1658119256640,MATH 193A,A01,083224,Rotar; Vladimir,9,0,34,25
1658119256640,MATH 193A,A02,083225,Rotar; Vladimir,11,0,34,23
1658119256640,MATH 193A,A03,083781,Rotar; Vladimir,5,0,34,29
1658119256640,MATH 193A,A04,083782,Rotar; Vladimir,12,0,34,22
1658119256640,MATH 193A,A05,093482,Rotar; Vladimir,11,0,34,23
1658119262662,MATH 197,001,091859,McAuley; Julian John,9999,0,9999,0
1658119262662,MATH 197,002,095566,Kedlaya; Kiran S.,9997,0,9999,2
1658119262662,MATH 197,003,095567,Xiao; Ming,9999,0,9999,0
1658119262662,MATH 197,004,095571,Perols; Johan Lars,9998,0,9999,1
1658119269713,COGS 9,A01,083615,Shannon; Kyle Michael,11,0,75,64
1658119275739,COGS 11,A01,083617,Boyle; Mary E. T.,23,0,48,25
1658119281762,COGS 13,A01,083071,Bastos; Amalia Pinkusfeld,12,0,71,59
1658119287788,COGS 14A,A01,092681,Semenuks; Arturs,5,1,100,95
1658119293818,COGS 14B,A01,083073,Cheng; Tzu-Han,7,0,63,56
1658119299840,COGS 17,A01,092677,Semenuks; Arturs,7,0,81,74
1658119305863,COGS 100,A01,083619,Allen; Michael Gordon,17,0,70,53
1658119311897,COGS 101A,A01,083621,Davis; Joshua Daniel,9,0,68,59
1658119317919,COGS 101B,A01,091572,Allen; Michael Gordon,14,0,65,51
1658119323942,COGS 101C,A01,083625,Delgado; Tania,17,0,35,18
1658119329970,COGS 107A,A01,083627,Boyle; Mary E. T.,14,0,60,46
1658119335992,COGS 118A,A01,083075,Gupta; Anjum,21,0,76,55
1658119342018,CSE 3,A50,083646,Miranda; Gregory Joseph,24,0,50,26
1658119348045,CSE 8A,A50,083650,Miranda; Gregory Joseph,17,1,56,39
1658119354068,CSE 11,A01,083080,Cao; Yingjun,7,15,40,33
1658119360189,CSE 12,A01,083652,Krause-Levy; Sophia Louisa,30,1,120,90
1658119366211,CSE 15L,A01,083654,Morris; Justin Loren,9,0,50,41
1658119366211,CSE 15L,A02,083655,Morris; Justin Loren,11,0,50,39
1658119372235,CSE 20,A01,083657,Tran; Khoa Dang,39,0,80,41
1658119378261,CSE 21,A01,095574,Bach; Quang Tran,23,0,48,25
1658119384283,CSE 30,A01,083084,Eldon; John,8,0,80,72
1658119384283,CSE 30,B01,095061,Bhaskar; Nishant,9,0,50,41
1658119390310,CSE 100,A01,083659,Cao; Yingjun,5,4,70,65
1658119396338,CSE 134B,A01,083661,Powell; Thomas Allan,25,0,100,75
1658119402363,CSE 140,A01,083663,Gungor; Onat,17,0,85,68
1658119408391,CSE 140L,A01,083088,Eldon; John,23,0,100,77
1658119414414,CSE 175,A01,083665,Kumar; Rakesh,3,0,25,22
1658119420440,CSE 190,A00,092507,Dubnov; Shlomo,8,0,20,12
1658119426464,ECE 45,A01,083139,Congero; Spencer William,7,0,75,68
1658119432487,ECE 65,A50,083695,Saad; Andrew S,12,0,30,18
1658119432487,ECE 65,A51,095125,Saad; Andrew S,24,0,26,2
1658119438509,ECE 109,A01,091882,Touri; Behrouz,21,0,70,49
1658119444532,ECE 180,A00,083140,Abi Samra; Nicholas Camill,1,0,30,29
1658119444532,ECE 180,B00,083141,Abi Samra; Nicholas Camill,0,0,30,30
1658119450571,MATH 10A,A01,083735,Patchell; Gregory David,2,0,30,28
1658119450571,MATH 10A,A02,083736,Patchell; Gregory David,20,0,30,10
1658119450571,MATH 10A,A03,083737,Patchell; Gregory David,16,0,30,14
1658119456599,MATH 10B,A01,083207,Lim; Seonhee,9,0,34,25
1658119456599,MATH 10B,A02,083208,Lim; Seonhee,10,0,35,25
1658119456599,MATH 10B,A03,093472,Lim; Seonhee,7,0,34,27
1658119456599,MATH 10B,B01,083739,Sinha; Shubham,14,0,30,16
1658119462624,MATH 18,A01,083743,Cinel; Cameron Alexander,9,0,30,21
1658119462624,MATH 18,A02,083744,Cinel; Cameron Alexander,18,0,30,12
1658119462624,MATH 18,A03,083745,Cinel; Cameron Alexander,10,0,30,20
1658119462624,MATH 18,B01,083748,Rideout; David Porter,5,0,37,32
1658119462624,MATH 18,B02,083749,Rideout; David Porter,5,0,36,31
1658119462624,MATH 18,B03,083750,Rideout; David Porter,3,0,37,34
1658119462624,MATH 18,B04,083751,Rideout; David Porter,7,0,36,29
1658119462624,MATH 18,B05,093473,Rideout; David Porter,7,0,36,29
1658119462624,MATH 18,B06,093474,Rideout; David Porter,6,0,36,30
1658119468651,MATH 20A,A01,083754,Zheng; Zequn,14,0,40,26
1658119474674,MATH 20B,A01,083756,Briones; Jor-el Thomas Caparas,4,0,36,32
1658119474674,MATH 20B,A02,083757,Briones; Jor-el Thomas Caparas,1,0,36,35
1658119474674,MATH 20B,A03,093475,Briones; Jor-el Thomas Caparas,3,0,36,33
1658119480704,MATH 20C,A01,083760,Briones; Jor-el Thomas Caparas,1,0,35,34
1658119480704,MATH 20C,A02,083761,Briones; Jor-el Thomas Caparas,8,0,35,27
1658119480704,MATH 20C,A03,093476,Briones; Jor-el Thomas Caparas,0,1,36,36
1658119480704,MATH 20C,B01,083762,Bach; Quang Tran,1,0,30,29
1658119486729,MATH 20D,A01,083765,Tran; Brian Kha,5,0,30,25
1658119486729,MATH 20D,A02,083766,Tran; Brian Kha,5,0,30,25
1658119486729,MATH 20D,A03,083767,Tran; Brian Kha,6,0,30,24
1658119492752,MATH 20E,A01,083771,Ganguly; Soumya,12,0,32,20
1658119492752,MATH 20E,A02,083772,Ganguly; Soumya,7,0,32,25
1658119492752,MATH 20E,B01,083773,Ciotti; Benjamin,20,0,35,15
1658119492752,MATH 20E,B02,083774,Ciotti; Benjamin,18,0,35,17
1658119498781,MATH 103A,A01,083777,Greenfeld; Be'Eri,6,0,36,30
1658119498781,MATH 103A,A02,083778,Greenfeld; Be'Eri,5,0,36,31
1658119498781,MATH 103A,A03,093561,Greenfeld; Be'Eri,7,0,36,29
1658119498781,MATH 103A,B01,083779,Greenfeld; Be'Eri,8,0,36,28
1658119498781,MATH 103A,B02,083780,Greenfeld; Be'Eri,4,0,36,32
1658119498781,MATH 103A,B03,093562,Greenfeld; Be'Eri,3,0,36,33
1658119504807,MATH 105,A01,085443,Carter; Anne Toulson,15,0,35,20
1658119504807,MATH 105,A02,093477,Carter; Anne Toulson,20,0,35,15
1658119510834,MATH 109,A01,083213,Ganzberger; Geoffrey Michael,3,0,34,31
1658119510834,MATH 109,A02,083214,Ganzberger; Geoffrey Michael,4,0,34,30
1658119510834,MATH 109,A03,093478,Ganzberger; Geoffrey Michael,2,0,34,32
1658119510834,MATH 109,B01,083215,Ganzberger; Geoffrey Michael,3,0,32,29
1658119510834,MATH 109,B02,083216,Ganzberger; Geoffrey Michael,3,0,32,29
1658119510834,MATH 109,B03,093479,Ganzberger; Geoffrey Michael,8,0,32,24
1658119516858,MATH 142A,A01,083219,Chow; Bennett,7,0,32,25
1658119516858,MATH 142A,A02,083220,Chow; Bennett,10,0,32,22
1658119516858,MATH 142A,A03,093480,Chow; Bennett,9,0,32,23
1658119516858,MATH 142A,B03,093481,Chow; Bennett,8,0,32,24
1658119516858,MATH 142A,B04,093558,Chow; Bennett,14,0,32,18
1658119516858,MATH 142A,B05,093559,Chow; Bennett,7,0,32,25
1658119522882,MATH 193A,A01,083224,Rotar; Vladimir,9,0,34,25
1658119522882,MATH 193A,A02,083225,Rotar; Vladimir,11,0,34,23
1658119522882,MATH 193A,A03,083781,Rotar; Vladimir,5,0,34,29
1658119522882,MATH 193A,A04,083782,Rotar; Vladimir,12,0,34,22
1658119522882,MATH 193A,A05,093482,Rotar; Vladimir,11,0,34,23
1658119528906,MATH 197,001,091859,McAuley; Julian John,9999,0,9999,0
1658119528906,MATH 197,002,095566,Kedlaya; Kiran S.,9997,0,9999,2
1658119528906,MATH 197,003,095567,Xiao; Ming,9999,0,9999,0
1658119528906,MATH 197,004,095571,Perols; Johan Lars,9998,0,9999,1
1658119535970,COGS 9,A01,083615,Shannon; Kyle Michael,11,0,75,64
1658119541995,COGS 11,A01,083617,Boyle; Mary E. T.,23,0,48,25
1658119548022,COGS 13,A01,083071,Bastos; Amalia Pinkusfeld,12,0,71,59
1658119554044,COGS 14A,A01,092681,Semenuks; Arturs,5,1,100,95
1658119560070,COGS 14B,A01,083073,Cheng; Tzu-Han,7,0,63,56
1658119566098,COGS 17,A01,092677,Semenuks; Arturs,7,0,81,74
1658119572122,COGS 100,A01,083619,Allen; Michael Gordon,17,0,70,53
1658119578149,COGS 101A,A01,083621,Davis; Joshua Daniel,9,0,68,59
1658119584181,COGS 101B,A01,091572,Allen; Michael Gordon,14,0,65,51
1658119590209,COGS 101C,A01,083625,Delgado; Tania,17,0,35,18
1658119596234,COGS 107A,A01,083627,Boyle; Mary E. T.,14,0,60,46
1658119602259,COGS 118A,A01,083075,Gupta; Anjum,21,0,76,55
1658119608288,CSE 3,A50,083646,Miranda; Gregory Joseph,24,0,50,26
1658119614311,CSE 8A,A50,083650,Miranda; Gregory Joseph,17,1,56,39
1658119620336,CSE 11,A01,083080,Cao; Yingjun,7,15,40,33
1658119626360,CSE 12,A01,083652,Krause-Levy; Sophia Louisa,30,1,120,90
1658119632383,CSE 15L,A01,083654,Morris; Justin Loren,9,0,50,41
1658119632383,CSE 15L,A02,083655,Morris; Justin Loren,11,0,50,39
1658119638407,CSE 20,A01,083657,Tran; Khoa Dang,39,0,80,41
1658119644436,CSE 21,A01,095574,Bach; Quang Tran,23,0,48,25
1658119650459,CSE 30,A01,083084,Eldon; John,8,0,80,72
1658119650459,CSE 30,B01,095061,Bhaskar; Nishant,9,0,50,41
1658119656483,CSE 100,A01,083659,Cao; Yingjun,5,4,70,65
1658119662509,CSE 134B,A01,083661,Powell; Thomas Allan,25,0,100,75
1658119668533,CSE 140,A01,083663,Gungor; Onat,17,0,85,68
1658119674562,CSE 140L,A01,083088,Eldon; John,23,0,100,77
1658119680585,CSE 175,A01,083665,Kumar; Rakesh,3,0,25,22
1658119686607,CSE 190,A00,092507,Dubnov; Shlomo,8,0,20,12
1658119692650,ECE 45,A01,083139,Congero; Spencer William,7,0,75,68
1658119698677,ECE 65,A50,083695,Saad; Andrew S,12,0,30,18
1658119698677,ECE 65,A51,095125,Saad; Andrew S,24,0,26,2
1658119704713,ECE 109,A01,091882,Touri; Behrouz,21,0,70,49
1658119710739,ECE 180,A00,083140,Abi Samra; Nicholas Camill,1,0,30,29
1658119710739,ECE 180,B00,083141,Abi Samra; Nicholas Camill,0,0,30,30
1658119716766,MATH 10A,A01,083735,Patchell; Gregory David,2,0,30,28
1658119716766,MATH 10A,A02,083736,Patchell; Gregory David,20,0,30,10
1658119716766,MATH 10A,A03,083737,Patchell; Gregory David,16,0,30,14
1658119722790,MATH 10B,A01,083207,Lim; Seonhee,9,0,34,25
1658119722790,MATH 10B,A02,083208,Lim; Seonhee,10,0,35,25
1658119722790,MATH 10B,A03,093472,Lim; Seonhee,7,0,34,27
1658119722790,MATH 10B,B01,083739,Sinha; Shubham,14,0,30,16
1658119728815,MATH 18,A01,083743,Cinel; Cameron Alexander,9,0,30,21
1658119728815,MATH 18,A02,083744,Cinel; Cameron Alexander,18,0,30,12
1658119728815,MATH 18,A03,083745,Cinel; Cameron Alexander,10,0,30,20
1658119728815,MATH 18,B01,083748,Rideout; David Porter,5,0,37,32
1658119728815,MATH 18,B02,083749,Rideout; David Porter,5,0,36,31
1658119728815,MATH 18,B03,083750,Rideout; David Porter,3,0,37,34
1658119728815,MATH 18,B04,083751,Rideout; David Porter,7,0,36,29
1658119728815,MATH 18,B05,093473,Rideout; David Porter,7,0,36,29
1658119728815,MATH 18,B06,093474,Rideout; David Porter,6,0,36,30
1658119734842,MATH 20A,A01,083754,Zheng; Zequn,14,0,40,26
1658119740870,MATH 20B,A01,083756,Briones; Jor-el Thomas Caparas,4,0,36,32
1658119740870,MATH 20B,A02,083757,Briones; Jor-el Thomas Caparas,1,0,36,35
1658119740870,MATH 20B,A03,093475,Briones; Jor-el Thomas Caparas,3,0,36,33
1658119746895,MATH 20C,A01,083760,Briones; Jor-el Thomas Caparas,1,0,35,34
1658119746895,MATH 20C,A02,083761,Briones; Jor-el Thomas Caparas,8,0,35,27
1658119746895,MATH 20C,A03,093476,Briones; Jor-el Thomas Caparas,0,1,36,36
1658119746895,MATH 20C,B01,083762,Bach; Quang Tran,1,0,30,29
1658119752919,MATH 20D,A01,083765,Tran; Brian Kha,5,0,30,25
1658119752919,MATH 20D,A02,083766,Tran; Brian Kha,5,0,30,25
1658119752919,MATH 20D,A03,083767,Tran; Brian Kha,6,0,30,24
1658119758950,MATH 20E,A01,083771,Ganguly; Soumya,12,0,32,20
1658119758950,MATH 20E,A02,083772,Ganguly; Soumya,7,0,32,25
1658119758950,MATH 20E,B01,083773,Ciotti; Benjamin,20,0,35,15
1658119758950,MATH 20E,B02,083774,Ciotti; Benjamin,18,0,35,17
1658119764976,MATH 103A,A01,083777,Greenfeld; Be'Eri,6,0,36,30
1658119764976,MATH 103A,A02,083778,Greenfeld; Be'Eri,5,0,36,31
1658119764976,MATH 103A,A03,093561,Greenfeld; Be'Eri,7,0,36,29
1658119764976,MATH 103A,B01,083779,Greenfeld; Be'Eri,8,0,36,28
1658119764976,MATH 103A,B02,083780,Greenfeld; Be'Eri,4,0,36,32
1658119764976,MATH 103A,B03,093562,Greenfeld; Be'Eri,3,0,36,33
1658119771000,MATH 105,A01,085443,Carter; Anne Toulson,15,0,35,20
1658119771000,MATH 105,A02,093477,Carter; Anne Toulson,20,0,35,15
1658119777026,MATH 109,A01,083213,Ganzberger; Geoffrey Michael,3,0,34,31
1658119777026,MATH 109,A02,083214,Ganzberger; Geoffrey Michael,4,0,34,30
1658119777026,MATH 109,A03,093478,Ganzberger; Geoffrey Michael,2,0,34,32
1658119777026,MATH 109,B01,083215,Ganzberger; Geoffrey Michael,3,0,32,29
1658119777026,MATH 109,B02,083216,Ganzberger; Geoffrey Michael,3,0,32,29
1658119777026,MATH 109,B03,093479,Ganzberger; Geoffrey Michael,8,0,32,24
1658119783063,MATH 142A,A01,083219,Chow; Bennett,7,0,32,25
1658119783063,MATH 142A,A02,083220,Chow; Bennett,10,0,32,22
1658119783063,MATH 142A,A03,093480,Chow; Bennett,9,0,32,23
1658119783063,MATH 142A,B03,093481,Chow; Bennett,8,0,32,24
1658119783063,MATH 142A,B04,093558,Chow; Bennett,14,0,32,18
1658119783063,MATH 142A,B05,093559,Chow; Bennett,7,0,32,25
1658119789087,MATH 193A,A01,083224,Rotar; Vladimir,9,0,34,25
1658119789087,MATH 193A,A02,083225,Rotar; Vladimir,11,0,34,23
1658119789087,MATH 193A,A03,083781,Rotar; Vladimir,5,0,34,29
1658119789087,MATH 193A,A04,083782,Rotar; Vladimir,12,0,34,22
1658119789087,MATH 193A,A05,093482,Rotar; Vladimir,11,0,34,23
1658119795118,MATH 197,001,091859,McAuley; Julian John,9999,0,9999,0
1658119795118,MATH 197,002,095566,Kedlaya; Kiran S.,9997,0,9999,2
1658119795118,MATH 197,003,095567,Xiao; Ming,9999,0,9999,0
1658119795118,MATH 197,004,095571,Perols; Johan Lars,9998,0,9999,1
1658119802173,COGS 9,A01,083615,Shannon; Kyle Michael,11,0,75,64
1658119808199,COGS 11,A01,083617,Boyle; Mary E. T.,23,0,48,25
1658119814223,COGS 13,A01,083071,Bastos; Amalia Pinkusfeld,12,0,71,59
1658119820254,COGS 14A,A01,092681,Semenuks; Arturs,5,1,100,95
1658119826280,COGS 14B,A01,083073,Cheng; Tzu-Han,7,0,63,56
1658119832303,COGS 17,A01,092677,Semenuks; Arturs,7,0,81,74
1658119838330,COGS 100,A01,083619,Allen; Michael Gordon,17,0,70,53
1658119844358,COGS 101A,A01,083621,Davis; Joshua Daniel,9,0,68,59
1658119850385,COGS 101B,A01,091572,Allen; Michael Gordon,14,0,65,51
1658119856410,COGS 101C,A01,083625,Delgado; Tania,17,0,35,18
1658119862439,COGS 107A,A01,083627,Boyle; Mary E. T.,14,0,60,46
1658119868462,COGS 118A,A01,083075,Gupta; Anjum,21,0,76,55
1658119874487,CSE 3,A50,083646,Miranda; Gregory Joseph,24,0,50,26
1658119880510,CSE 8A,A50,083650,Miranda; Gregory Joseph,17,1,56,39
1658119886533,CSE 11,A01,083080,Cao; Yingjun,7,15,40,33
1658119892561,CSE 12,A01,083652,Krause-Levy; Sophia Louisa,30,1,120,90
1658119898585,CSE 15L,A01,083654,Morris; Justin Loren,9,0,50,41
1658119898585,CSE 15L,A02,083655,Morris; Justin Loren,11,0,50,39
1658119904610,CSE 20,A01,083657,Tran; Khoa Dang,39,0,80,41
1658119910635,CSE 21,A01,095574,Bach; Quang Tran,23,0,48,25
1658119916662,CSE 30,A01,083084,Eldon; John,8,0,80,72
1658119916662,CSE 30,B01,095061,Bhaskar; Nishant,9,0,50,41
1658119922688,CSE 100,A01,083659,Cao; Yingjun,5,4,70,65
1658119928712,CSE 134B,A01,083661,Powell; Thomas Allan,25,0,100,75
1658119934740,CSE 140,A01,083663,Gungor; Onat,17,0,85,68
1658119940763,CSE 140L,A01,083088,Eldon; John,23,0,100,77
1658119946789,CSE 175,A01,083665,Kumar; Rakesh,3,0,25,22
1658119952812,CSE 190,A00,092507,Dubnov; Shlomo,8,0,20,12
1658119958929,ECE 45,A01,083139,Congero; Spencer William,7,0,75,68
1658119964952,ECE 65,A50,083695,Saad; Andrew S,12,0,30,18
1658119964952,ECE 65,A51,095125,Saad; Andrew S,24,0,26,2
1658119970975,ECE 109,A01,091882,Touri; Behrouz,21,0,70,49
1658119976998,ECE 180,A00,083140,Abi Samra; Nicholas Camill,1,0,30,29
1658119976998,ECE 180,B00,083141,Abi Samra; Nicholas Camill,0,0,30,30
1658119983026,MATH 10A,A01,083735,Patchell; Gregory David,2,0,30,28
1658119983026,MATH 10A,A02,083736,Patchell; Gregory David,20,0,30,10
1658119983026,MATH 10A,A03,083737,Patchell; Gregory David,16,0,30,14
1658119989050,MATH 10B,A01,083207,Lim; Seonhee,9,0,34,25
1658119989050,MATH 10B,A02,083208,Lim; Seonhee,10,0,35,25
1658119989050,MATH 10B,A03,093472,Lim; Seonhee,7,0,34,27
1658119989050,MATH 10B,B01,083739,Sinha; Shubham,14,0,30,16
1658119995074,MATH 18,A01,083743,Cinel; Cameron Alexander,9,0,30,21
1658119995074,MATH 18,A02,083744,Cinel; Cameron Alexander,18,0,30,12
1658119995074,MATH 18,A03,083745,Cinel; Cameron Alexander,10,0,30,20
1658119995074,MATH 18,B01,083748,Rideout; David Porter,5,0,37,32
1658119995074,MATH 18,B02,083749,Rideout; David Porter,5,0,36,31
1658119995074,MATH 18,B03,083750,Rideout; David Porter,3,0,37,34
1658119995074,MATH 18,B04,083751,Rideout; David Porter,7,0,36,29
1658119995074,MATH 18,B05,093473,Rideout; David Porter,7,0,36,29
1658119995074,MATH 18,B06,093474,Rideout; David Porter,6,0,36,30
1658120001097,MATH 20A,A01,083754,Zheng; Zequn,14,0,40,26
1658120007120,MATH 20B,A01,083756,Briones; Jor-el Thomas Caparas,4,0,36,32
1658120007120,MATH 20B,A02,083757,Briones; Jor-el Thomas Caparas,1,0,36,35
1658120007120,MATH 20B,A03,093475,Briones; Jor-el Thomas Caparas,3,0,36,33
1658120013148,MATH 20C,A01,083760,Briones; Jor-el Thomas Caparas,1,0,35,34
1658120013148,MATH 20C,A02,083761,Briones; Jor-el Thomas Caparas,8,0,35,27
1658120013148,MATH 20C,A03,093476,Briones; Jor-el Thomas Caparas,0,1,36,36
1658120013148,MATH 20C,B01,083762,Bach; Quang Tran,1,0,30,29
1658120019173,MATH 20D,A01,083765,Tran; Brian Kha,5,0,30,25
1658120019173,MATH 20D,A02,083766,Tran; Brian Kha,5,0,30,25
1658120019173,MATH 20D,A03,083767,Tran; Brian Kha,6,0,30,24
1658120025203,MATH 20E,A01,083771,Ganguly; Soumya,12,0,32,20
1658120025203,MATH 20E,A02,083772,Ganguly; Soumya,7,0,32,25
1658120025203,MATH 20E,B01,083773,Ciotti; Benjamin,20,0,35,15
1658120025203,MATH 20E,B02,083774,Ciotti; Benjamin,18,0,35,17
1658120031227,MATH 103A,A01,083777,Greenfeld; Be'Eri,6,0,36,30
1658120031227,MATH 103A,A02,083778,Greenfeld; Be'Eri,5,0,36,31
1658120031227,MATH 103A,A03,093561,Greenfeld; Be'Eri,7,0,36,29
1658120031227,MATH 103A,B01,083779,Greenfeld; Be'Eri,8,0,36,28
1658120031227,MATH 103A,B02,083780,Greenfeld; Be'Eri,4,0,36,32
1658120031227,MATH 103A,B03,093562,Greenfeld; Be'Eri,3,0,36,33
1658120037255,MATH 105,A01,085443,Carter; Anne Toulson,15,0,35,20
1658120037255,MATH 105,A02,093477,Carter; Anne Toulson,20,0,35,15
1658120043284,MATH 109,A01,083213,Ganzberger; Geoffrey Michael,3,0,34,31
1658120043284,MATH 109,A02,083214,Ganzberger; Geoffrey Michael,4,0,34,30
1658120043284,MATH 109,A03,093478,Ganzberger; Geoffrey Michael,2,0,34,32
1658120043284,MATH 109,B01,083215,Ganzberger; Geoffrey Michael,3,0,32,29
1658120043284,MATH 109,B02,083216,Ganzberger; Geoffrey Michael,3,0,32,29
1658120043284,MATH 109,B03,093479,Ganzberger; Geoffrey Michael,8,0,32,24
1658120049308,MATH 142A,A01,083219,Chow; Bennett,7,0,32,25
1658120049308,MATH 142A,A02,083220,Chow; Bennett,10,0,32,22
1658120049308,MATH 142A,A03,093480,Chow; Bennett,9,0,32,23
1658120049308,MATH 142A,B03,093481,Chow; Bennett,8,0,32,24
1658120049308,MATH 142A,B04,093558,Chow; Bennett,14,0,32,18
1658120049308,MATH 142A,B05,093559,Chow; Bennett,7,0,32,25
1658120055338,MATH 193A,A01,083224,Rotar; Vladimir,9,0,34,25
1658120055338,MATH 193A,A02,083225,Rotar; Vladimir,11,0,34,23
1658120055338,MATH 193A,A03,083781,Rotar; Vladimir,5,0,34,29
1658120055338,MATH 193A,A04,083782,Rotar; Vladimir,12,0,34,22
1658120055338,MATH 193A,A05,093482,Rotar; Vladimir,11,0,34,23
1658120061362,MATH 197,001,091859,McAuley; Julian John,9999,0,9999,0
1658120061362,MATH 197,002,095566,Kedlaya; Kiran S.,9997,0,9999,2
1658120061362,MATH 197,003,095567,Xiao; Ming,9999,0,9999,0
1658120061362,MATH 197,004,095571,Perols; Johan Lars,9998,0,9999,1
1658120068420,COGS 9,A01,083615,Shannon; Kyle Michael,11,0,75,64
1658120074448,COGS 11,A01,083617,Boyle; Mary E. T.,23,0,48,25
1658120080476,COGS 13,A01,083071,Bastos; Amalia Pinkusfeld,12,0,71,59
1658120086503,COGS 14A,A01,092681,Semenuks; Arturs,5,1,100,95
1658120092525,COGS 14B,A01,083073,Cheng; Tzu-Han,7,0,63,56
1658120098548,COGS 17,A01,092677,Semenuks; Arturs,7,0,81,74
1658120104574,COGS 100,A01,083619,Allen; Michael Gordon,17,0,70,53
1658120110597,COGS 101A,A01,083621,Davis; Joshua Daniel,9,0,68,59
1658120116624,COGS 101B,A01,091572,Allen; Michael Gordon,14,0,65,51
1658120122657,COGS 101C,A01,083625,Delgado; Tania,17,0,35,18
1658120128681,COGS 107A,A01,083627,Boyle; Mary E. T.,14,0,60,46
1658120134704,COGS 118A,A01,083075,Gupta; Anjum,21,0,76,55
1658120140727,CSE 3,A50,083646,Miranda; Gregory Joseph,24,0,50,26
1658120146750,CSE 8A,A50,083650,Miranda; Gregory Joseph,17,1,56,39
1658120152776,CSE 11,A01,083080,Cao; Yingjun,7,15,40,33
1658120158804,CSE 12,A01,083652,Krause-Levy; Sophia Louisa,30,1,120,90
1658120164829,CSE 15L,A01,083654,Morris; Justin Loren,9,0,50,41
1658120164829,CSE 15L,A02,083655,Morris; Justin Loren,11,0,50,39
1658120170852,CSE 20,A01,083657,Tran; Khoa Dang,39,0,80,41
1658120176881,CSE 21,A01,095574,Bach; Quang Tran,23,0,48,25
1658120182902,CSE 30,A01,083084,Eldon; John,8,0,80,72
1658120182902,CSE 30,B01,095061,Bhaskar; Nishant,9,0,50,41
1658120188926,CSE 100,A01,083659,Cao; Yingjun,5,4,70,65
1658120194949,CSE 134B,A01,083661,Powell; Thomas Allan,25,0,100,75
1658120200982,CSE 140,A01,083663,Gungor; Onat,17,0,85,68
1658120207009,CSE 140L,A01,083088,Eldon; John,23,0,100,77
1658120213034,CSE 175,A01,083665,Kumar; Rakesh,3,0,25,22
1658120219057,CSE 190,A00,092507,Dubnov; Shlomo,8,0,20,12
1658120225085,ECE 45,A01,083139,Congero; Spencer William,7,0,75,68
1658120231114,ECE 65,A50,083695,Saad; Andrew S,12,0,30,18
1658120231114,ECE 65,A51,095125,Saad; Andrew S,24,0,26,2
1658120237142,ECE 109,A01,091882,Touri; Behrouz,21,0,70,49
1658120243168,ECE 180,A00,083140,Abi Samra; Nicholas Camill,1,0,30,29
1658120243168,ECE 180,B00,083141,Abi Samra; Nicholas Camill,0,0,30,30
1658120249197,MATH 10A,A01,083735,Patchell; Gregory David,2,0,30,28
1658120249197,MATH 10A,A02,083736,Patchell; Gregory David,20,0,30,10
1658120249197,MATH 10A,A03,083737,Patchell; Gregory David,16,0,30,14
1658120255235,MATH 10B,A01,083207,Lim; Seonhee,9,0,34,25
1658120255235,MATH 10B,A02,083208,Lim; Seonhee,10,0,35,25
1658120255235,MATH 10B,A03,093472,Lim; Seonhee,7,0,34,27
1658120255235,MATH 10B,B01,083739,Sinha; Shubham,14,0,30,16
1658120261266,MATH 18,A01,083743,Cinel; Cameron Alexander,9,0,30,21
1658120261266,MATH 18,A02,083744,Cinel; Cameron Alexander,18,0,30,12
1658120261266,MATH 18,A03,083745,Cinel; Cameron Alexander,10,0,30,20
1658120261266,MATH 18,B01,083748,Rideout; David Porter,5,0,37,32
1658120261266,MATH 18,B02,083749,Rideout; David Porter,5,0,36,31
1658120261266,MATH 18,B03,083750,Rideout; David Porter,3,0,37,34
1658120261266,MATH 18,B04,083751,Rideout; David Porter,7,0,36,29
1658120261266,MATH 18,B05,093473,Rideout; David Porter,7,0,36,29
1658120261266,MATH 18,B06,093474,Rideout; David Porter,6,0,36,30
1658120267297,MATH 20A,A01,083754,Zheng; Zequn,14,0,40,26
1658120273325,MATH 20B,A01,083756,Briones; Jor-el Thomas Caparas,4,0,36,32
1658120273325,MATH 20B,A02,083757,Briones; Jor-el Thomas Caparas,1,0,36,35
1658120273325,MATH 20B,A03,093475,Briones; Jor-el Thomas Caparas,3,0,36,33
1658120279348,MATH 20C,A01,083760,Briones; Jor-el Thomas Caparas,1,0,35,34
1658120279348,MATH 20C,A02,083761,Briones; Jor-el Thomas Caparas,8,0,35,27
1658120279348,MATH 20C,A03,093476,Briones; Jor-el Thomas Caparas,0,1,36,36
1658120279348,MATH 20C,B01,083762,Bach; Quang Tran,1,0,30,29
1658120285374,MATH 20D,A01,083765,Tran; Brian Kha,5,0,30,25
1658120285374,MATH 20D,A02,083766,Tran; Brian Kha,5,0,30,25
1658120285374,MATH 20D,A03,083767,Tran; Brian Kha,6,0,30,24
1658120291398,MATH 20E,A01,083771,Ganguly; Soumya,12,0,32,20
1658120291398,MATH 20E,A02,083772,Ganguly; Soumya,7,0,32,25
1658120291398,MATH 20E,B01,083773,Ciotti; Benjamin,20,0,35,15
1658120291398,MATH 20E,B02,083774,Ciotti; Benjamin,18,0,35,17
1658120297424,MATH 103A,A01,083777,Greenfeld; Be'Eri,6,0,36,30
1658120297424,MATH 103A,A02,083778,Greenfeld; Be'Eri,5,0,36,31
1658120297424,MATH 103A,A03,093561,Greenfeld; Be'Eri,7,0,36,29
1658120297424,MATH 103A,B01,083779,Greenfeld; Be'Eri,8,0,36,28
1658120297424,MATH 103A,B02,083780,Greenfeld; Be'Eri,4,0,36,32
1658120297424,MATH 103A,B03,093562,Greenfeld; Be'Eri,3,0,36,33
1658120303453,MATH 105,A01,085443,Carter; Anne Toulson,15,0,35,20
1658120303453,MATH 105,A02,093477,Carter; Anne Toulson,20,0,35,15
1658120309477,MATH 109,A01,083213,Ganzberger; Geoffrey Michael,3,0,34,31
1658120309477,MATH 109,A02,083214,Ganzberger; Geoffrey Michael,4,0,34,30
1658120309477,MATH 109,A03,093478,Ganzberger; Geoffrey Michael,2,0,34,32
1658120309477,MATH 109,B01,083215,Ganzberger; Geoffrey Michael,3,0,32,29
1658120309477,MATH 109,B02,083216,Ganzberger; Geoffrey Michael,3,0,32,29
1658120309477,MATH 109,B03,093479,Ganzberger; Geoffrey Michael,8,0,32,24
1658120315501,MATH 142A,A01,083219,Chow; Bennett,7,0,32,25
1658120315501,MATH 142A,A02,083220,Chow; Bennett,10,0,32,22
1658120315501,MATH 142A,A03,093480,Chow; Bennett,9,0,32,23
1658120315501,MATH 142A,B03,093481,Chow; Bennett,8,0,32,24
1658120315501,MATH 142A,B04,093558,Chow; Bennett,14,0,32,18
1658120315501,MATH 142A,B05,093559,Chow; Bennett,7,0,32,25
1658120321525,MATH 193A,A01,083224,Rotar; Vladimir,9,0,34,25
1658120321525,MATH 193A,A02,083225,Rotar; Vladimir,11,0,34,23
1658120321525,MATH 193A,A03,083781,Rotar; Vladimir,5,0,34,29
1658120321525,MATH 193A,A04,083782,Rotar; Vladimir,12,0,34,22
1658120321525,MATH 193A,A05,093482,Rotar; Vladimir,11,0,34,23
1658120327564,MATH 197,001,091859,McAuley; Julian John,9999,0,9999,0
1658120327564,MATH 197,002,095566,Kedlaya; Kiran S.,9997,0,9999,2
1658120327564,MATH 197,003,095567,Xiao; Ming,9999,0,9999,0
1658120327564,MATH 197,004,095571,Perols; Johan Lars,9998,0,9999,1
1658120334643,COGS 9,A01,083615,Shannon; Kyle Michael,11,0,75,64
1658120340670,COGS 11,A01,083617,Boyle; Mary E. T.,23,0,48,25
1658120346694,COGS 13,A01,083071,Bastos; Amalia Pinkusfeld,12,0,71,59
1658120352717,COGS 14A,A01,092681,Semenuks; Arturs,5,1,100,95
1658120358740,COGS 14B,A01,083073,Cheng; Tzu-Han,7,0,63,56
1658120364767,COGS 17,A01,092677,Semenuks; Arturs,7,0,81,74
1658120370794,COGS 100,A01,083619,Allen; Michael Gordon,17,0,70,53
1658120376817,COGS 101A,A01,083621,Davis; Joshua Daniel,9,0,68,59
1658120382844,COGS 101B,A01,091572,Allen; Michael Gordon,14,0,65,51
1658120388868,COGS 101C,A01,083625,Delgado; Tania,17,0,35,18
1658120394892,COGS 107A,A01,083627,Boyle; Mary E. T.,14,0,60,46
1658120400915,COGS 118A,A01,083075,Gupta; Anjum,21,0,76,55
1658120406937,CSE 3,A50,083646,Miranda; Gregory Joseph,24,0,50,26
1658120412966,CSE 8A,A50,083650,Miranda; Gregory Joseph,17,1,56,39
1658120418991,CSE 11,A01,083080,Cao; Yingjun,7,15,40,33
1658120425015,CSE 12,A01,083652,Krause-Levy; Sophia Louisa,30,1,120,90
1658120431042,CSE 15L,A01,083654,Morris; Justin Loren,9,0,50,41
1658120431042,CSE 15L,A02,083655,Morris; Justin Loren,11,0,50,39
1658120437068,CSE 20,A01,083657,Tran; Khoa Dang,39,0,80,41
1658120443091,CSE 21,A01,095574,Bach; Quang Tran,23,0,48,25
1658120449118,CSE 30,A01,083084,Eldon; John,8,0,80,72
1658120449118,CSE 30,B01,095061,Bhaskar; Nishant,9,0,50,41
1658120455152,CSE 100,A01,083659,Cao; Yingjun,5,4,70,65
1658120461179,CSE 134B,A01,083661,Powell; Thomas Allan,25,0,100,75
1658120467202,CSE 140,A01,083663,Gungor; Onat,17,0,85,68
1658120473226,CSE 140L,A01,083088,Eldon; John,23,0,100,77
1658120479249,CSE 175,A01,083665,Kumar; Rakesh,3,0,25,22
1658120485271,CSE 190,A00,092507,Dubnov; Shlomo,8,0,20,12
1658120491300,ECE 45,A01,083139,Congero; Spencer William,7,0,75,68
1658120497323,ECE 65,A50,083695,Saad; Andrew S,12,0,30,18
1658120497323,ECE 65,A51,095125,Saad; Andrew S,24,0,26,2
1658120503349,ECE 109,A01,091882,Touri; Behrouz,21,0,70,49
1658120509376,ECE 180,A00,083140,Abi Samra; Nicholas Camill,1,0,30,29
1658120509376,ECE 180,B00,083141,Abi Samra; Nicholas Camill,0,0,30,30
1658120515399,MATH 10A,A01,083735,Patchell; Gregory David,2,0,30,28
1658120515399,MATH 10A,A02,083736,Patchell; Gregory David,20,0,30,10
1658120515399,MATH 10A,A03,083737,Patchell; Gregory David,16,0,30,14
1658120521431,MATH 10B,A01,083207,Lim; Seonhee,9,0,34,25
1658120521431,MATH 10B,A02,083208,Lim; Seonhee,10,0,35,25
1658120521431,MATH 10B,A03,093472,Lim; Seonhee,7,0,34,27
1658120521431,MATH 10B,B01,083739,Sinha; Shubham,14,0,30,16
1658120527461,MATH 18,A01,083743,Cinel; Cameron Alexander,9,0,30,21
1658120527461,MATH 18,A02,083744,Cinel; Cameron Alexander,18,0,30,12
1658120527461,MATH 18,A03,083745,Cinel; Cameron Alexander,10,0,30,20
1658120527461,MATH 18,B01,083748,Rideout; David Porter,5,0,37,32
1658120527461,MATH 18,B02,083749,Rideout; David Porter,5,0,36,31
1658120527461,MATH 18,B03,083750,Rideout; David Porter,3,0,37,34
1658120527461,MATH 18,B04,083751,Rideout; David Porter,7,0,36,29
1658120527461,MATH 18,B05,093473,Rideout; David Porter,7,0,36,29
1658120527461,MATH 18,B06,093474,Rideout; David Porter,6,0,36,30
1658120533484,MATH 20A,A01,083754,Zheng; Zequn,14,0,40,26
1658120539512,MATH 20B,A01,083756,Briones; Jor-el Thomas Caparas,4,0,36,32
1658120539512,MATH 20B,A02,083757,Briones; Jor-el Thomas Caparas,1,0,36,35
1658120539512,MATH 20B,A03,093475,Briones; Jor-el Thomas Caparas,3,0,36,33
1658120545539,MATH 20C,A01,083760,Briones; Jor-el Thomas Caparas,1,0,35,34
1658120545539,MATH 20C,A02,083761,Briones; Jor-el Thomas Caparas,8,0,35,27
1658120545539,MATH 20C,A03,093476,Briones; Jor-el Thomas Caparas,0,1,36,36
1658120545539,MATH 20C,B01,083762,Bach; Quang Tran,1,0,30,29
1658120551567,MATH 20D,A01,083765,Tran; Brian Kha,5,0,30,25
1658120551567,MATH 20D,A02,083766,Tran; Brian Kha,5,0,30,25
1658120551567,MATH 20D,A03,083767,Tran; Brian Kha,6,0,30,24
1658120557662,MATH 20E,A01,083771,Ganguly; Soumya,12,0,32,20
1658120557662,MATH 20E,A02,083772,Ganguly; Soumya,7,0,32,25
1658120557662,MATH 20E,B01,083773,Ciotti; Benjamin,20,0,35,15
1658120557662,MATH 20E,B02,083774,Ciotti; Benjamin,18,0,35,17
1658120563687,MATH 103A,A01,083777,Greenfeld; Be'Eri,6,0,36,30
1658120563687,MATH 103A,A02,083778,Greenfeld; Be'Eri,5,0,36,31
1658120563687,MATH 103A,A03,093561,Greenfeld; Be'Eri,7,0,36,29
1658120563687,MATH 103A,B01,083779,Greenfeld; Be'Eri,8,0,36,28
1658120563687,MATH 103A,B02,083780,Greenfeld; Be'Eri,4,0,36,32
1658120563687,MATH 103A,B03,093562,Greenfeld; Be'Eri,3,0,36,33
1658120569711,MATH 105,A01,085443,Carter; Anne Toulson,15,0,35,20
1658120569711,MATH 105,A02,093477,Carter; Anne Toulson,20,0,35,15
1658120575739,MATH 109,A01,083213,Ganzberger; Geoffrey Michael,3,0,34,31
1658120575739,MATH 109,A02,083214,Ganzberger; Geoffrey Michael,4,0,34,30
1658120575739,MATH 109,A03,093478,Ganzberger; Geoffrey Michael,2,0,34,32
1658120575739,MATH 109,B01,083215,Ganzberger; Geoffrey Michael,3,0,32,29
1658120575739,MATH 109,B02,083216,Ganzberger; Geoffrey Michael,3,0,32,29
1658120575739,MATH 109,B03,093479,Ganzberger; Geoffrey Michael,8,0,32,24
1658120581775,MATH 142A,A01,083219,Chow; Bennett,7,0,32,25
1658120581775,MATH 142A,A02,083220,Chow; Bennett,10,0,32,22
1658120581775,MATH 142A,A03,093480,Chow; Bennett,9,0,32,23
1658120581775,MATH 142A,B03,093481,Chow; Bennett,8,0,32,24
1658120581775,MATH 142A,B04,093558,Chow; Bennett,14,0,32,18
1658120581775,MATH 142A,B05,093559,Chow; Bennett,7,0,32,25
1658120587799,MATH 193A,A01,083224,Rotar; Vladimir,9,0,34,25
1658120587799,MATH 193A,A02,083225,Rotar; Vladimir,11,0,34,23
1658120587799,MATH 193A,A03,083781,Rotar; Vladimir,5,0,34,29
1658120587799,MATH 193A,A04,083782,Rotar; Vladimir,12,0,34,22
1658120587799,MATH 193A,A05,093482,Rotar; Vladimir,11,0,34,23
1658120593824,MATH 197,001,091859,McAuley; Julian John,9999,0,9999,0
1658120593824,MATH 197,002,095566,Kedlaya; Kiran S.,9997,0,9999,2
1658120593824,MATH 197,003,095567,Xiao; Ming,9999,0,9999,0
1658120593824,MATH 197,004,095571,Perols; Johan Lars,9998,0,9999,1
1658120600876,COGS 9,A01,083615,Shannon; Kyle Michael,11,0,75,64
1658120606911,COGS 11,A01,083617,Boyle; Mary E. T.,23,0,48,25
1658120612938,COGS 13,A01,083071,Bastos; Amalia Pinkusfeld,12,0,71,59
1658120618960,COGS 14A,A01,092681,Semenuks; Arturs,5,1,100,95
1658120624990,COGS 14B,A01,083073,Cheng; Tzu-Han,7,0,63,56
1658120631019,COGS 17,A01,092677,Semenuks; Arturs,7,0,81,74
1658120637042,COGS 100,A01,083619,Allen; Michael Gordon,17,0,70,53
1658120643067,COGS 101A,A01,083621,Davis; Joshua Daniel,9,0,68,59
1658120649092,COGS 101B,A01,091572,Allen; Michael Gordon,14,0,65,51
1658120655115,COGS 101C,A01,083625,Delgado; Tania,17,0,35,18
1658120661143,COGS 107A,A01,083627,Boyle; Mary E. T.,14,0,60,46
1658120667165,COGS 118A,A01,083075,Gupta; Anjum,21,0,76,55
1658120673196,CSE 3,A50,083646,Miranda; Gregory Joseph,24,0,50,26
1658120679220,CSE 8A,A50,083650,Miranda; Gregory Joseph,17,1,56,39
1658120685247,CSE 11,A01,083080,Cao; Yingjun,7,15,40,33
1658120691271,CSE 12,A01,083652,Krause-Levy; Sophia Louisa,30,1,120,90
1658120697294,CSE 15L,A01,083654,Morris; Justin Loren,9,0,50,41
1658120697294,CSE 15L,A02,083655,Morris; Justin Loren,11,0,50,39
1658120703327,CSE 20,A01,083657,Tran; Khoa Dang,39,0,80,41
1658120709350,CSE 21,A01,095574,Bach; Quang Tran,23,0,48,25
1658120715375,CSE 30,A01,083084,Eldon; John,8,0,80,72
1658120715375,CSE 30,B01,095061,Bhaskar; Nishant,9,0,50,41
1658120721397,CSE 100,A01,083659,Cao; Yingjun,5,4,70,65
1658120727420,CSE 134B,A01,083661,Powell; Thomas Allan,25,0,100,75
1658120733442,CSE 140,A01,083663,Gungor; Onat,17,0,85,68
1658120739465,CSE 140L,A01,083088,Eldon; John,23,0,100,77
1658120745487,CSE 175,A01,083665,Kumar; Rakesh,3,0,25,22
1658120751512,CSE 190,A00,092507,Dubnov; Shlomo,8,0,20,12
1658120757534,ECE 45,A01,083139,Congero; Spencer William,7,0,75,68
1658120763561,ECE 65,A50,083695,Saad; Andrew S,12,0,30,18
1658120763561,ECE 65,A51,095125,Saad; Andrew S,24,0,26,2
1658120769586,ECE 109,A01,091882,Touri; Behrouz,21,0,70,49
1658120775613,ECE 180,A00,083140,Abi Samra; Nicholas Camill,1,0,30,29
1658120775613,ECE 180,B00,083141,Abi Samra; Nicholas Camill,0,0,30,30
1658120781644,MATH 10A,A01,083735,Patchell; Gregory David,2,0,30,28
1658120781644,MATH 10A,A02,083736,Patchell; Gregory David,20,0,30,10
1658120781644,MATH 10A,A03,083737,Patchell; Gregory David,16,0,30,14
1658120787674,MATH 10B,A01,083207,Lim; Seonhee,9,0,34,25
1658120787674,MATH 10B,A02,083208,Lim; Seonhee,10,0,35,25
1658120787674,MATH 10B,A03,093472,Lim; Seonhee,7,0,34,27
1658120787674,MATH 10B,B01,083739,Sinha; Shubham,14,0,30,16
1658120793705,MATH 18,A01,083743,Cinel; Cameron Alexander,9,0,30,21
1658120793705,MATH 18,A02,083744,Cinel; Cameron Alexander,18,0,30,12
1658120793705,MATH 18,A03,083745,Cinel; Cameron Alexander,10,0,30,20
1658120793705,MATH 18,B01,083748,Rideout; David Porter,5,0,37,32
1658120793705,MATH 18,B02,083749,Rideout; David Porter,5,0,36,31
1658120793705,MATH 18,B03,083750,Rideout; David Porter,3,0,37,34
1658120793705,MATH 18,B04,083751,Rideout; David Porter,7,0,36,29
1658120793705,MATH 18,B05,093473,Rideout; David Porter,7,0,36,29
1658120793705,MATH 18,B06,093474,Rideout; David Porter,6,0,36,30
1658120799728,MATH 20A,A01,083754,Zheng; Zequn,14,0,40,26
1658120805755,MATH 20B,A01,083756,Briones; Jor-el Thomas Caparas,4,0,36,32
1658120805755,MATH 20B,A02,083757,Briones; Jor-el Thomas Caparas,1,0,36,35
1658120805755,MATH 20B,A03,093475,Briones; Jor-el Thomas Caparas,3,0,36,33
1658120811785,MATH 20C,A01,083760,Briones; Jor-el Thomas Caparas,1,0,35,34
1658120811785,MATH 20C,A02,083761,Briones; Jor-el Thomas Caparas,8,0,35,27
1658120811785,MATH 20C,A03,093476,Briones; Jor-el Thomas Caparas,0,1,36,36
1658120811785,MATH 20C,B01,083762,Bach; Quang Tran,1,0,30,29
1658120817809,MATH 20D,A01,083765,Tran; Brian Kha,5,0,30,25
1658120817809,MATH 20D,A02,083766,Tran; Brian Kha,5,0,30,25
1658120817809,MATH 20D,A03,083767,Tran; Brian Kha,6,0,30,24
1658120823837,MATH 20E,A01,083771,Ganguly; Soumya,12,0,32,20
1658120823837,MATH 20E,A02,083772,Ganguly; Soumya,7,0,32,25
1658120823837,MATH 20E,B01,083773,Ciotti; Benjamin,20,0,35,15
1658120823837,MATH 20E,B02,083774,Ciotti; Benjamin,18,0,35,17
1658120829862,MATH 103A,A01,083777,Greenfeld; Be'Eri,6,0,36,30
1658120829862,MATH 103A,A02,083778,Greenfeld; Be'Eri,5,0,36,31
1658120829862,MATH 103A,A03,093561,Greenfeld; Be'Eri,7,0,36,29
1658120829862,MATH 103A,B01,083779,Greenfeld; Be'Eri,8,0,36,28
1658120829862,MATH 103A,B02,083780,Greenfeld; Be'Eri,4,0,36,32
1658120829862,MATH 103A,B03,093562,Greenfeld; Be'Eri,3,0,36,33
1658120835889,MATH 105,A01,085443,Carter; Anne Toulson,15,0,35,20
1658120835889,MATH 105,A02,093477,Carter; Anne Toulson,20,0,35,15
1658120841919,MATH 109,A01,083213,Ganzberger; Geoffrey Michael,3,0,34,31
1658120841919,MATH 109,A02,083214,Ganzberger; Geoffrey Michael,4,0,34,30
1658120841919,MATH 109,A03,093478,Ganzberger; Geoffrey Michael,2,0,34,32
1658120841919,MATH 109,B01,083215,Ganzberger; Geoffrey Michael,3,0,32,29
1658120841919,MATH 109,B02,083216,Ganzberger; Geoffrey Michael,3,0,32,29
1658120841919,MATH 109,B03,093479,Ganzberger; Geoffrey Michael,8,0,32,24
1658120847949,MATH 142A,A01,083219,Chow; Bennett,7,0,32,25
1658120847949,MATH 142A,A02,083220,Chow; Bennett,10,0,32,22
1658120847949,MATH 142A,A03,093480,Chow; Bennett,9,0,32,23
1658120847949,MATH 142A,B03,093481,Chow; Bennett,8,0,32,24
1658120847949,MATH 142A,B04,093558,Chow; Bennett,14,0,32,18
1658120847949,MATH 142A,B05,093559,Chow; Bennett,7,0,32,25
1658120853976,MATH 193A,A01,083224,Rotar; Vladimir,9,0,34,25
1658120853976,MATH 193A,A02,083225,Rotar; Vladimir,11,0,34,23
1658120853976,MATH 193A,A03,083781,Rotar; Vladimir,5,0,34,29
1658120853976,MATH 193A,A04,083782,Rotar; Vladimir,12,0,34,22
1658120853976,MATH 193A,A05,093482,Rotar; Vladimir,11,0,34,23
1658120860000,MATH 197,001,091859,McAuley; Julian John,9999,0,9999,0
1658120860000,MATH 197,002,095566,Kedlaya; Kiran S.,9997,0,9999,2
1658120860000,MATH 197,003,095567,Xiao; Ming,9999,0,9999,0
1658120860000,MATH 197,004,095571,Perols; Johan Lars,9998,0,9999,1
1658120867054,COGS 9,A01,083615,Shannon; Kyle Michael,11,0,75,64
1658120873077,COGS 11,A01,083617,Boyle; Mary E. T.,23,0,48,25
1658120879103,COGS 13,A01,083071,Bastos; Amalia Pinkusfeld,12,0,71,59
1658120885130,COGS 14A,A01,092681,Semenuks; Arturs,5,1,100,95
1658120891154,COGS 14B,A01,083073,Cheng; Tzu-Han,7,0,63,56
1658120897181,COGS 17,A01,092677,Semenuks; Arturs,7,0,81,74
1658120903203,COGS 100,A01,083619,Allen; Michael Gordon,17,0,70,53
1658120909229,COGS 101A,A01,083621,Davis; Joshua Daniel,9,0,68,59
1658120915253,COGS 101B,A01,091572,Allen; Michael Gordon,14,0,65,51
1658120921279,COGS 101C,A01,083625,Delgado; Tania,17,0,35,18
1658120927304,COGS 107A,A01,083627,Boyle; Mary E. T.,14,0,60,46
1658120933328,COGS 118A,A01,083075,Gupta; Anjum,21,0,76,55
1658120939354,CSE 3,A50,083646,Miranda; Gregory Joseph,24,0,50,26
1658120945381,CSE 8A,A50,083650,Miranda; Gregory Joseph,17,1,56,39
1658120951412,CSE 11,A01,083080,Cao; Yingjun,7,15,40,33
1658120957436,CSE 12,A01,083652,Krause-Levy; Sophia Louisa,30,1,120,90
1658120963460,CSE 15L,A01,083654,Morris; Justin Loren,9,0,50,41
1658120963460,CSE 15L,A02,083655,Morris; Justin Loren,11,0,50,39
1658120969484,CSE 20,A01,083657,Tran; Khoa Dang,39,0,80,41
1658120975509,CSE 21,A01,095574,Bach; Quang Tran,23,0,48,25
1658120981532,CSE 30,A01,083084,Eldon; John,8,0,80,72
1658120981532,CSE 30,B01,095061,Bhaskar; Nishant,9,0,50,41
1658120987555,CSE 100,A01,083659,Cao; Yingjun,5,4,70,65
1658120993578,CSE 134B,A01,083661,Powell; Thomas Allan,25,0,100,75
1658120999602,CSE 140,A01,083663,Gungor; Onat,17,0,85,68
1658121005635,CSE 140L,A01,083088,Eldon; John,23,0,100,77
1658121011658,CSE 175,A01,083665,Kumar; Rakesh,3,0,25,22
1658121017681,CSE 190,A00,092507,Dubnov; Shlomo,8,0,20,12
1658121023708,ECE 45,A01,083139,Congero; Spencer William,7,0,75,68
1658121029736,ECE 65,A50,083695,Saad; Andrew S,12,0,30,18
1658121029736,ECE 65,A51,095125,Saad; Andrew S,24,0,26,2
1658121035759,ECE 109,A01,091882,Touri; Behrouz,21,0,70,49
1658121041782,ECE 180,A00,083140,Abi Samra; Nicholas Camill,1,0,30,29
1658121041782,ECE 180,B00,083141,Abi Samra; Nicholas Camill,0,0,30,30
1658121047815,MATH 10A,A01,083735,Patchell; Gregory David,2,0,30,28
1658121047815,MATH 10A,A02,083736,Patchell; Gregory David,20,0,30,10
1658121047815,MATH 10A,A03,083737,Patchell; Gregory David,16,0,30,14
1658121053843,MATH 10B,A01,083207,Lim; Seonhee,9,0,34,25
1658121053843,MATH 10B,A02,083208,Lim; Seonhee,10,0,35,25
1658121053843,MATH 10B,A03,093472,Lim; Seonhee,7,0,34,27
1658121053843,MATH 10B,B01,083739,Sinha; Shubham,14,0,30,16
1658121059868,MATH 18,A01,083743,Cinel; Cameron Alexander,9,0,30,21
1658121059868,MATH 18,A02,083744,Cinel; Cameron Alexander,18,0,30,12
1658121059868,MATH 18,A03,083745,Cinel; Cameron Alexander,10,0,30,20
1658121059868,MATH 18,B01,083748,Rideout; David Porter,5,0,37,32
1658121059868,MATH 18,B02,083749,Rideout; David Porter,5,0,36,31
1658121059868,MATH 18,B03,083750,Rideout; David Porter,3,0,37,34
1658121059868,MATH 18,B04,083751,Rideout; David Porter,7,0,36,29
1658121059868,MATH 18,B05,093473,Rideout; David Porter,7,0,36,29
1658121059868,MATH 18,B06,093474,Rideout; David Porter,6,0,36,30
1658121065895,MATH 20A,A01,083754,Zheng; Zequn,14,0,40,26
1658121071925,MATH 20B,A01,083756,Briones; Jor-el Thomas Caparas,4,0,36,32
1658121071925,MATH 20B,A02,083757,Briones; Jor-el Thomas Caparas,1,0,36,35
1658121071925,MATH 20B,A03,093475,Briones; Jor-el Thomas Caparas,3,0,36,33
1658121077952,MATH 20C,A01,083760,Briones; Jor-el Thomas Caparas,1,0,35,34
1658121077952,MATH 20C,A02,083761,Briones; Jor-el Thomas Caparas,8,0,35,27
1658121077952,MATH 20C,A03,093476,Briones; Jor-el Thomas Caparas,0,1,36,36
1658121077952,MATH 20C,B01,083762,Bach; Quang Tran,1,0,30,29
1658121083976,MATH 20D,A01,083765,Tran; Brian Kha,5,0,30,25
1658121083976,MATH 20D,A02,083766,Tran; Brian Kha,5,0,30,25
1658121083976,MATH 20D,A03,083767,Tran; Brian Kha,6,0,30,24
1658121090005,MATH 20E,A01,083771,Ganguly; Soumya,12,0,32,20
1658121090005,MATH 20E,A02,083772,Ganguly; Soumya,7,0,32,25
1658121090005,MATH 20E,B01,083773,Ciotti; Benjamin,20,0,35,15
1658121090005,MATH 20E,B02,083774,Ciotti; Benjamin,18,0,35,17
1658121096034,MATH 103A,A01,083777,Greenfeld; Be'Eri,6,0,36,30
1658121096034,MATH 103A,A02,083778,Greenfeld; Be'Eri,5,0,36,31
1658121096034,MATH 103A,A03,093561,Greenfeld; Be'Eri,7,0,36,29
1658121096034,MATH 103A,B01,083779,Greenfeld; Be'Eri,8,0,36,28
1658121096034,MATH 103A,B02,083780,Greenfeld; Be'Eri,4,0,36,32
1658121096034,MATH 103A,B03,093562,Greenfeld; Be'Eri,3,0,36,33
1658121102058,MATH 105,A01,085443,Carter; Anne Toulson,15,0,35,20
1658121102058,MATH 105,A02,093477,Carter; Anne Toulson,20,0,35,15
1658121108094,MATH 109,A01,083213,Ganzberger; Geoffrey Michael,3,0,34,31
1658121108094,MATH 109,A02,083214,Ganzberger; Geoffrey Michael,4,0,34,30
1658121108094,MATH 109,A03,093478,Ganzberger; Geoffrey Michael,2,0,34,32
1658121108094,MATH 109,B01,083215,Ganzberger; Geoffrey Michael,3,0,32,29
1658121108094,MATH 109,B02,083216,Ganzberger; Geoffrey Michael,3,0,32,29
1658121108094,MATH 109,B03,093479,Ganzberger; Geoffrey Michael,8,0,32,24
1658121114122,MATH 142A,A01,083219,Chow; Bennett,7,0,32,25
1658121114122,MATH 142A,A02,083220,Chow; Bennett,10,0,32,22
1658121114122,MATH 142A,A03,093480,Chow; Bennett,9,0,32,23
1658121114122,MATH 142A,B03,093481,Chow; Bennett,8,0,32,24
1658121114122,MATH 142A,B04,093558,Chow; Bennett,14,0,32,18
1658121114122,MATH 142A,B05,093559,Chow; Bennett,7,0,32,25
1658121120151,MATH 193A,A01,083224,Rotar; Vladimir,9,0,34,25
1658121120151,MATH 193A,A02,083225,Rotar; Vladimir,11,0,34,23
1658121120151,MATH 193A,A03,083781,Rotar; Vladimir,5,0,34,29
1658121120151,MATH 193A,A04,083782,Rotar; Vladimir,12,0,34,22
1658121120151,MATH 193A,A05,093482,Rotar; Vladimir,11,0,34,23
1658121126175,MATH 197,001,091859,McAuley; Julian John,9999,0,9999,0
1658121126175,MATH 197,002,095566,Kedlaya; Kiran S.,9997,0,9999,2
1658121126175,MATH 197,003,095567,Xiao; Ming,9999,0,9999,0
1658121126175,MATH 197,004,095571,Perols; Johan Lars,9998,0,9999,1
1658121133228,COGS 9,A01,083615,Shannon; Kyle Michael,11,0,75,64
1658121139254,COGS 11,A01,083617,Boyle; Mary E. T.,23,0,48,25
1658121145279,COGS 13,A01,083071,Bastos; Amalia Pinkusfeld,12,0,71,59
1658121151375,COGS 14A,A01,092681,Semenuks; Arturs,5,1,100,95
1658121157399,COGS 14B,A01,083073,Cheng; Tzu-Han,7,0,63,56
1658121163424,COGS 17,A01,092677,Semenuks; Arturs,7,0,81,74
1658121169451,COGS 100,A01,083619,Allen; Michael Gordon,17,0,70,53
1658121175476,COGS 101A,A01,083621,Davis; Joshua Daniel,9,0,68,59
1658121181500,COGS 101B,A01,091572,Allen; Michael Gordon,14,0,65,51
1658121187524,COGS 101C,A01,083625,Delgado; Tania,17,0,35,18
1658121193546,COGS 107A,A01,083627,Boyle; Mary E. T.,14,0,60,46
1658121199575,COGS 118A,A01,083075,Gupta; Anjum,21,0,76,55
1658121205607,CSE 3,A50,083646,Miranda; Gregory Joseph,24,0,50,26
1658121211634,CSE 8A,A50,083650,Miranda; Gregory Joseph,17,1,56,39
1658121217667,CSE 11,A01,083080,Cao; Yingjun,7,15,40,33
1658121223693,CSE 12,A01,083652,Krause-Levy; Sophia Louisa,30,1,120,90
1658121229720,CSE 15L,A01,083654,Morris; Justin Loren,9,0,50,41
1658121229720,CSE 15L,A02,083655,Morris; Justin Loren,11,0,50,39
1658121235746,CSE 20,A01,083657,Tran; Khoa Dang,39,0,80,41
1658121241767,CSE 21,A01,095574,Bach; Quang Tran,23,0,48,25
1658121247794,CSE 30,A01,083084,Eldon; John,8,0,80,72
1658121247794,CSE 30,B01,095061,Bhaskar; Nishant,9,0,50,41
1658121253821,CSE 100,A01,083659,Cao; Yingjun,5,4,70,65
1658121259843,CSE 134B,A01,083661,Powell; Thomas Allan,25,0,100,75
1658121265866,CSE 140,A01,083663,Gungor; Onat,17,0,85,68
1658121271894,CSE 140L,A01,083088,Eldon; John,23,0,100,77
1658121277918,CSE 175,A01,083665,Kumar; Rakesh,3,0,25,22
1658121283940,CSE 190,A00,092507,Dubnov; Shlomo,8,0,20,12
1658121289963,ECE 45,A01,083139,Congero; Spencer William,7,0,75,68
1658121295985,ECE 65,A50,083695,Saad; Andrew S,12,0,30,18
1658121295985,ECE 65,A51,095125,Saad; Andrew S,24,0,26,2
1658121302010,ECE 109,A01,091882,Touri; Behrouz,21,0,70,49
1658121308046,ECE 180,A00,083140,Abi Samra; Nicholas Camill,1,0,30,29
1658121308046,ECE 180,B00,083141,Abi Samra; Nicholas Camill,0,0,30,30
1658121314074,MATH 10A,A01,083735,Patchell; Gregory David,2,0,30,28
1658121314074,MATH 10A,A02,083736,Patchell; Gregory David,20,0,30,10
1658121314074,MATH 10A,A03,083737,Patchell; Gregory David,16,0,30,14
1658121320106,MATH 10B,A01,083207,Lim; Seonhee,9,0,34,25
1658121320106,MATH 10B,A02,083208,Lim; Seonhee,10,0,35,25
1658121320106,MATH 10B,A03,093472,Lim; Seonhee,7,0,34,27
1658121320106,MATH 10B,B01,083739,Sinha; Shubham,14,0,30,16
1658121326130,MATH 18,A01,083743,Cinel; Cameron Alexander,9,0,30,21
1658121326130,MATH 18,A02,083744,Cinel; Cameron Alexander,18,0,30,12
1658121326130,MATH 18,A03,083745,Cinel; Cameron Alexander,10,0,30,20
1658121326130,MATH 18,B01,083748,Rideout; David Porter,5,0,37,32
1658121326130,MATH 18,B02,083749,Rideout; David Porter,5,0,36,31
1658121326130,MATH 18,B03,083750,Rideout; David Porter,3,0,37,34
1658121326130,MATH 18,B04,083751,Rideout; David Porter,7,0,36,29
1658121326130,MATH 18,B05,093473,Rideout; David Porter,7,0,36,29
1658121326130,MATH 18,B06,093474,Rideout; David Porter,6,0,36,30
1658121332155,MATH 20A,A01,083754,Zheng; Zequn,14,0,40,26
1658121338183,MATH 20B,A01,083756,Briones; Jor-el Thomas Caparas,4,0,36,32
1658121338183,MATH 20B,A02,083757,Briones; Jor-el Thomas Caparas,1,0,36,35
1658121338183,MATH 20B,A03,093475,Briones; Jor-el Thomas Caparas,3,0,36,33
1658121344207,MATH 20C,A01,083760,Briones; Jor-el Thomas Caparas,1,0,35,34
1658121344207,MATH 20C,A02,083761,Briones; Jor-el Thomas Caparas,8,0,35,27
1658121344207,MATH 20C,A03,093476,Briones; Jor-el Thomas Caparas,0,1,36,36
1658121344207,MATH 20C,B01,083762,Bach; Quang Tran,1,0,30,29
1658121350236,MATH 20D,A01,083765,Tran; Brian Kha,5,0,30,25
1658121350236,MATH 20D,A02,083766,Tran; Brian Kha,5,0,30,25
1658121350236,MATH 20D,A03,083767,Tran; Brian Kha,6,0,30,24
1658121356259,MATH 20E,A01,083771,Ganguly; Soumya,12,0,32,20
1658121356259,MATH 20E,A02,083772,Ganguly; Soumya,7,0,32,25
1658121356259,MATH 20E,B01,083773,Ciotti; Benjamin,20,0,35,15
1658121356259,MATH 20E,B02,083774,Ciotti; Benjamin,18,0,35,17
1658121362282,MATH 103A,A01,083777,Greenfeld; Be'Eri,6,0,36,30
1658121362282,MATH 103A,A02,083778,Greenfeld; Be'Eri,5,0,36,31
1658121362282,MATH 103A,A03,093561,Greenfeld; Be'Eri,7,0,36,29
1658121362282,MATH 103A,B01,083779,Greenfeld; Be'Eri,8,0,36,28
1658121362282,MATH 103A,B02,083780,Greenfeld; Be'Eri,4,0,36,32
1658121362282,MATH 103A,B03,093562,Greenfeld; Be'Eri,3,0,36,33
1658121368304,MATH 105,A01,085443,Carter; Anne Toulson,15,0,35,20
1658121368304,MATH 105,A02,093477,Carter; Anne Toulson,20,0,35,15
1658121374327,MATH 109,A01,083213,Ganzberger; Geoffrey Michael,3,0,34,31
1658121374327,MATH 109,A02,083214,Ganzberger; Geoffrey Michael,4,0,34,30
1658121374327,MATH 109,A03,093478,Ganzberger; Geoffrey Michael,2,0,34,32
1658121374327,MATH 109,B01,083215,Ganzberger; Geoffrey Michael,3,0,32,29
1658121374327,MATH 109,B02,083216,Ganzberger; Geoffrey Michael,3,0,32,29
1658121374327,MATH 109,B03,093479,Ganzberger; Geoffrey Michael,8,0,32,24
1658121380356,MATH 142A,A01,083219,Chow; Bennett,7,0,32,25
1658121380356,MATH 142A,A02,083220,Chow; Bennett,10,0,32,22
1658121380356,MATH 142A,A03,093480,Chow; Bennett,9,0,32,23
1658121380356,MATH 142A,B03,093481,Chow; Bennett,8,0,32,24
1658121380356,MATH 142A,B04,093558,Chow; Bennett,14,0,32,18
1658121380356,MATH 142A,B05,093559,Chow; Bennett,7,0,32,25
1658121386384,MATH 193A,A01,083224,Rotar; Vladimir,9,0,34,25
1658121386384,MATH 193A,A02,083225,Rotar; Vladimir,11,0,34,23
1658121386384,MATH 193A,A03,083781,Rotar; Vladimir,5,0,34,29
1658121386384,MATH 193A,A04,083782,Rotar; Vladimir,12,0,34,22
1658121386384,MATH 193A,A05,093482,Rotar; Vladimir,11,0,34,23
1658121392408,MATH 197,001,091859,McAuley; Julian John,9999,0,9999,0
1658121392408,MATH 197,002,095566,Kedlaya; Kiran S.,9997,0,9999,2
1658121392408,MATH 197,003,095567,Xiao; Ming,9999,0,9999,0
1658121392408,MATH 197,004,095571,Perols; Johan Lars,9998,0,9999,1
1658121399462,COGS 9,A01,083615,Shannon; Kyle Michael,11,0,75,64
1658121405485,COGS 11,A01,083617,Boyle; Mary E. T.,23,0,48,25
1658121411510,COGS 13,A01,083071,Bastos; Amalia Pinkusfeld,12,0,71,59
1658121417537,COGS 14A,A01,092681,Semenuks; Arturs,5,1,100,95
1658121423564,COGS 14B,A01,083073,Cheng; Tzu-Han,7,0,63,56
1658121429590,COGS 17,A01,092677,Semenuks; Arturs,7,0,81,74
1658121435614,COGS 100,A01,083619,Allen; Michael Gordon,17,0,70,53
1658121441637,COGS 101A,A01,083621,Davis; Joshua Daniel,9,0,68,59
1658121447661,COGS 101B,A01,091572,Allen; Michael Gordon,14,0,65,51
1658121453689,COGS 101C,A01,083625,Delgado; Tania,17,0,35,18
1658121459717,COGS 107A,A01,083627,Boyle; Mary E. T.,14,0,60,46
1658121465744,COGS 118A,A01,083075,Gupta; Anjum,21,0,76,55
1658121471769,CSE 3,A50,083646,Miranda; Gregory Joseph,24,0,50,26
1658121477797,CSE 8A,A50,083650,Miranda; Gregory Joseph,17,1,56,39
1658121483823,CSE 11,A01,083080,Cao; Yingjun,7,15,40,33
1658121489850,CSE 12,A01,083652,Krause-Levy; Sophia Louisa,30,1,120,90
1658121495872,CSE 15L,A01,083654,Morris; Justin Loren,9,0,50,41
1658121495872,CSE 15L,A02,083655,Morris; Justin Loren,11,0,50,39
1658121501897,CSE 20,A01,083657,Tran; Khoa Dang,39,0,80,41
1658121507923,CSE 21,A01,095574,Bach; Quang Tran,23,0,48,25
1658121513951,CSE 30,A01,083084,Eldon; John,8,0,80,72
1658121513951,CSE 30,B01,095061,Bhaskar; Nishant,9,0,50,41
1658121519976,CSE 100,A01,083659,Cao; Yingjun,5,4,70,65
1658121526000,CSE 134B,A01,083661,Powell; Thomas Allan,25,0,100,75
1658121532026,CSE 140,A01,083663,Gungor; Onat,17,0,85,68
1658121538050,CSE 140L,A01,083088,Eldon; John,23,0,100,77
1658121544078,CSE 175,A01,083665,Kumar; Rakesh,3,0,25,22
1658121550104,CSE 190,A00,092507,Dubnov; Shlomo,8,0,20,12
1658121556127,ECE 45,A01,083139,Congero; Spencer William,7,0,75,68
1658121562152,ECE 65,A50,083695,Saad; Andrew S,12,0,30,18
1658121562152,ECE 65,A51,095125,Saad; Andrew S,24,0,26,2
1658121568179,ECE 109,A01,091882,Touri; Behrouz,21,0,70,49
1658121574203,ECE 180,A00,083140,Abi Samra; Nicholas Camill,1,0,30,29
1658121574203,ECE 180,B00,083141,Abi Samra; Nicholas Camill,0,0,30,30
1658121580227,MATH 10A,A01,083735,Patchell; Gregory David,2,0,30,28
1658121580227,MATH 10A,A02,083736,Patchell; Gregory David,20,0,30,10
1658121580227,MATH 10A,A03,083737,Patchell; Gregory David,16,0,30,14
1658121586250,MATH 10B,A01,083207,Lim; Seonhee,9,0,34,25
1658121586250,MATH 10B,A02,083208,Lim; Seonhee,10,0,35,25
1658121586250,MATH 10B,A03,093472,Lim; Seonhee,7,0,34,27
1658121586250,MATH 10B,B01,083739,Sinha; Shubham,14,0,30,16
1658121592275,MATH 18,A01,083743,Cinel; Cameron Alexander,9,0,30,21
1658121592275,MATH 18,A02,083744,Cinel; Cameron Alexander,18,0,30,12
1658121592275,MATH 18,A03,083745,Cinel; Cameron Alexander,10,0,30,20
1658121592275,MATH 18,B01,083748,Rideout; David Porter,5,0,37,32
1658121592275,MATH 18,B02,083749,Rideout; David Porter,5,0,36,31
1658121592275,MATH 18,B03,083750,Rideout; David Porter,3,0,37,34
1658121592275,MATH 18,B04,083751,Rideout; David Porter,7,0,36,29
1658121592275,MATH 18,B05,093473,Rideout; David Porter,7,0,36,29
1658121592275,MATH 18,B06,093474,Rideout; David Porter,6,0,36,30
1658121598300,MATH 20A,A01,083754,Zheng; Zequn,14,0,40,26
1658121604324,MATH 20B,A01,083756,Briones; Jor-el Thomas Caparas,4,0,36,32
1658121604324,MATH 20B,A02,083757,Briones; Jor-el Thomas Caparas,1,0,36,35
1658121604324,MATH 20B,A03,093475,Briones; Jor-el Thomas Caparas,3,0,36,33
1658121610349,MATH 20C,A01,083760,Briones; Jor-el Thomas Caparas,1,0,35,34
1658121610349,MATH 20C,A02,083761,Briones; Jor-el Thomas Caparas,8,0,35,27
1658121610349,MATH 20C,A03,093476,Briones; Jor-el Thomas Caparas,0,1,36,36
1658121610349,MATH 20C,B01,083762,Bach; Quang Tran,1,0,30,29
1658121616372,MATH 20D,A01,083765,Tran; Brian Kha,5,0,30,25
1658121616372,MATH 20D,A02,083766,Tran; Brian Kha,5,0,30,25
1658121616372,MATH 20D,A03,083767,Tran; Brian Kha,6,0,30,24
1658121622396,MATH 20E,A01,083771,Ganguly; Soumya,12,0,32,20
1658121622396,MATH 20E,A02,083772,Ganguly; Soumya,7,0,32,25
1658121622396,MATH 20E,B01,083773,Ciotti; Benjamin,20,0,35,15
1658121622396,MATH 20E,B02,083774,Ciotti; Benjamin,18,0,35,17
1658121628424,MATH 103A,A01,083777,Greenfeld; Be'Eri,6,0,36,30
1658121628424,MATH 103A,A02,083778,Greenfeld; Be'Eri,5,0,36,31
1658121628424,MATH 103A,A03,093561,Greenfeld; Be'Eri,7,0,36,29
1658121628424,MATH 103A,B01,083779,Greenfeld; Be'Eri,8,0,36,28
1658121628424,MATH 103A,B02,083780,Greenfeld; Be'Eri,4,0,36,32
1658121628424,MATH 103A,B03,093562,Greenfeld; Be'Eri,3,0,36,33
1658121634451,MATH 105,A01,085443,Carter; Anne Toulson,15,0,35,20
1658121634451,MATH 105,A02,093477,Carter; Anne Toulson,20,0,35,15
1658121640475,MATH 109,A01,083213,Ganzberger; Geoffrey Michael,3,0,34,31
1658121640475,MATH 109,A02,083214,Ganzberger; Geoffrey Michael,4,0,34,30
1658121640475,MATH 109,A03,093478,Ganzberger; Geoffrey Michael,2,0,34,32
1658121640475,MATH 109,B01,083215,Ganzberger; Geoffrey Michael,3,0,32,29
1658121640475,MATH 109,B02,083216,Ganzberger; Geoffrey Michael,3,0,32,29
1658121640475,MATH 109,B03,093479,Ganzberger; Geoffrey Michael,8,0,32,24
1658121646505,MATH 142A,A01,083219,Chow; Bennett,7,0,32,25
1658121646505,MATH 142A,A02,083220,Chow; Bennett,10,0,32,22
1658121646505,MATH 142A,A03,093480,Chow; Bennett,9,0,32,23
1658121646505,MATH 142A,B03,093481,Chow; Bennett,8,0,32,24
1658121646505,MATH 142A,B04,093558,Chow; Bennett,14,0,32,18
1658121646505,MATH 142A,B05,093559,Chow; Bennett,7,0,32,25
1658121652535,MATH 193A,A01,083224,Rotar; Vladimir,9,0,34,25
1658121652535,MATH 193A,A02,083225,Rotar; Vladimir,11,0,34,23
1658121652535,MATH 193A,A03,083781,Rotar; Vladimir,5,0,34,29
1658121652535,MATH 193A,A04,083782,Rotar; Vladimir,12,0,34,22
1658121652535,MATH 193A,A05,093482,Rotar; Vladimir,11,0,34,23
1658121658562,MATH 197,001,091859,McAuley; Julian John,9999,0,9999,0
1658121658562,MATH 197,002,095566,Kedlaya; Kiran S.,9997,0,9999,2
1658121658562,MATH 197,003,095567,Xiao; Ming,9999,0,9999,0
1658121658562,MATH 197,004,095571,Perols; Johan Lars,9998,0,9999,1
1658121665618,COGS 9,A01,083615,Shannon; Kyle Michael,11,0,75,64
1658121671647,COGS 11,A01,083617,Boyle; Mary E. T.,23,0,48,25
1658121677671,COGS 13,A01,083071,Bastos; Amalia Pinkusfeld,12,0,71,59
1658121683703,COGS 14A,A01,092681,Semenuks; Arturs,5,1,100,95
1658121689725,COGS 14B,A01,083073,Cheng; Tzu-Han,7,0,63,56
1658121695752,COGS 17,A01,092677,Semenuks; Arturs,7,0,81,74
1658121701775,COGS 100,A01,083619,Allen; Michael Gordon,17,0,70,53
1658121707801,COGS 101A,A01,083621,Davis; Joshua Daniel,9,0,68,59
1658121713824,COGS 101B,A01,091572,Allen; Michael Gordon,14,0,65,51
1658121719849,COGS 101C,A01,083625,Delgado; Tania,17,0,35,18
1658121725874,COGS 107A,A01,083627,Boyle; Mary E. T.,14,0,60,46
1658121731898,COGS 118A,A01,083075,Gupta; Anjum,21,0,76,55
1658121737928,CSE 3,A50,083646,Miranda; Gregory Joseph,24,0,50,26
1658121743951,CSE 8A,A50,083650,Miranda; Gregory Joseph,17,1,56,39
1658121750049,CSE 11,A01,083080,Cao; Yingjun,7,15,40,33
1658121756073,CSE 12,A01,083652,Krause-Levy; Sophia Louisa,30,1,120,90
1658121762100,CSE 15L,A01,083654,Morris; Justin Loren,9,0,50,41
1658121762100,CSE 15L,A02,083655,Morris; Justin Loren,11,0,50,39
1658121768123,CSE 20,A01,083657,Tran; Khoa Dang,39,0,80,41
1658121774146,CSE 21,A01,095574,Bach; Quang Tran,23,0,48,25
1658121780171,CSE 30,A01,083084,Eldon; John,8,0,80,72
1658121780171,CSE 30,B01,095061,Bhaskar; Nishant,9,0,50,41
1658121786194,CSE 100,A01,083659,Cao; Yingjun,5,4,70,65
1658121792219,CSE 134B,A01,083661,Powell; Thomas Allan,25,0,100,75
1658121798241,CSE 140,A01,083663,Gungor; Onat,17,0,85,68
1658121804276,CSE 140L,A01,083088,Eldon; John,23,0,100,77
1658121810301,CSE 175,A01,083665,Kumar; Rakesh,3,0,25,22
1658121816325,CSE 190,A00,092507,Dubnov; Shlomo,8,0,20,12
1658121822348,ECE 45,A01,083139,Congero; Spencer William,7,0,75,68
1658121828371,ECE 65,A50,083695,Saad; Andrew S,12,0,30,18
1658121828371,ECE 65,A51,095125,Saad; Andrew S,24,0,26,2
1658121834394,ECE 109,A01,091882,Touri; Behrouz,21,0,70,49
1658121840416,ECE 180,A00,083140,Abi Samra; Nicholas Camill,1,0,30,29
1658121840416,ECE 180,B00,083141,Abi Samra; Nicholas Camill,0,0,30,30
1658121846439,MATH 10A,A01,083735,Patchell; Gregory David,2,0,30,28
1658121846439,MATH 10A,A02,083736,Patchell; Gregory David,20,0,30,10
1658121846439,MATH 10A,A03,083737,Patchell; Gregory David,16,0,30,14
1658121852473,MATH 10B,A01,083207,Lim; Seonhee,9,0,34,25
1658121852473,MATH 10B,A02,083208,Lim; Seonhee,10,0,35,25
1658121852473,MATH 10B,A03,093472,Lim; Seonhee,7,0,34,27
1658121852473,MATH 10B,B01,083739,Sinha; Shubham,14,0,30,16
1658121858498,MATH 18,A01,083743,Cinel; Cameron Alexander,9,0,30,21
1658121858498,MATH 18,A02,083744,Cinel; Cameron Alexander,18,0,30,12
1658121858498,MATH 18,A03,083745,Cinel; Cameron Alexander,10,0,30,20
1658121858498,MATH 18,B01,083748,Rideout; David Porter,5,0,37,32
1658121858498,MATH 18,B02,083749,Rideout; David Porter,5,0,36,31
1658121858498,MATH 18,B03,083750,Rideout; David Porter,3,0,37,34
1658121858498,MATH 18,B04,083751,Rideout; David Porter,7,0,36,29
1658121858498,MATH 18,B05,093473,Rideout; David Porter,7,0,36,29
1658121858498,MATH 18,B06,093474,Rideout; David Porter,6,0,36,30
1658121864524,MATH 20A,A01,083754,Zheng; Zequn,14,0,40,26
1658121870547,MATH 20B,A01,083756,Briones; Jor-el Thomas Caparas,4,0,36,32
1658121870547,MATH 20B,A02,083757,Briones; Jor-el Thomas Caparas,1,0,36,35
1658121870547,MATH 20B,A03,093475,Briones; Jor-el Thomas Caparas,3,0,36,33
1658121876576,MATH 20C,A01,083760,Briones; Jor-el Thomas Caparas,1,0,35,34
1658121876576,MATH 20C,A02,083761,Briones; Jor-el Thomas Caparas,8,0,35,27
1658121876576,MATH 20C,A03,093476,Briones; Jor-el Thomas Caparas,0,1,36,36
1658121876576,MATH 20C,B01,083762,Bach; Quang Tran,1,0,30,29
1658121882601,MATH 20D,A01,083765,Tran; Brian Kha,5,0,30,25
1658121882601,MATH 20D,A02,083766,Tran; Brian Kha,5,0,30,25
1658121882601,MATH 20D,A03,083767,Tran; Brian Kha,6,0,30,24
1658121888637,MATH 20E,A01,083771,Ganguly; Soumya,12,0,32,20
1658121888637,MATH 20E,A02,083772,Ganguly; Soumya,7,0,32,25
1658121888637,MATH 20E,B01,083773,Ciotti; Benjamin,20,0,35,15
1658121888637,MATH 20E,B02,083774,Ciotti; Benjamin,18,0,35,17
1658121894662,MATH 103A,A01,083777,Greenfeld; Be'Eri,6,0,36,30
1658121894662,MATH 103A,A02,083778,Greenfeld; Be'Eri,5,0,36,31
1658121894662,MATH 103A,A03,093561,Greenfeld; Be'Eri,7,0,36,29
1658121894662,MATH 103A,B01,083779,Greenfeld; Be'Eri,8,0,36,28
1658121894662,MATH 103A,B02,083780,Greenfeld; Be'Eri,4,0,36,32
1658121894662,MATH 103A,B03,093562,Greenfeld; Be'Eri,3,0,36,33
1658121900684,MATH 105,A01,085443,Carter; Anne Toulson,15,0,35,20
1658121900684,MATH 105,A02,093477,Carter; Anne Toulson,20,0,35,15
1658121906709,MATH 109,A01,083213,Ganzberger; Geoffrey Michael,3,0,34,31
1658121906709,MATH 109,A02,083214,Ganzberger; Geoffrey Michael,4,0,34,30
1658121906709,MATH 109,A03,093478,Ganzberger; Geoffrey Michael,2,0,34,32
1658121906709,MATH 109,B01,083215,Ganzberger; Geoffrey Michael,3,0,32,29
1658121906709,MATH 109,B02,083216,Ganzberger; Geoffrey Michael,3,0,32,29
1658121906709,MATH 109,B03,093479,Ganzberger; Geoffrey Michael,8,0,32,24
1658121912732,MATH 142A,A01,083219,Chow; Bennett,7,0,32,25
1658121912732,MATH 142A,A02,083220,Chow; Bennett,10,0,32,22
1658121912732,MATH 142A,A03,093480,Chow; Bennett,9,0,32,23
1658121912732,MATH 142A,B03,093481,Chow; Bennett,8,0,32,24
1658121912732,MATH 142A,B04,093558,Chow; Bennett,14,0,32,18
1658121912732,MATH 142A,B05,093559,Chow; Bennett,7,0,32,25
1658121918754,MATH 193A,A01,083224,Rotar; Vladimir,9,0,34,25
1658121918754,MATH 193A,A02,083225,Rotar; Vladimir,11,0,34,23
1658121918754,MATH 193A,A03,083781,Rotar; Vladimir,5,0,34,29
1658121918754,MATH 193A,A04,083782,Rotar; Vladimir,12,0,34,22
1658121918754,MATH 193A,A05,093482,Rotar; Vladimir,11,0,34,23
1658121924776,MATH 197,001,091859,McAuley; Julian John,9999,0,9999,0
1658121924776,MATH 197,002,095566,Kedlaya; Kiran S.,9997,0,9999,2
1658121924776,MATH 197,003,095567,Xiao; Ming,9999,0,9999,0
1658121924776,MATH 197,004,095571,Perols; Johan Lars,9998,0,9999,1
1658121931826,COGS 9,A01,083615,Shannon; Kyle Michael,11,0,75,64
1658121937852,COGS 11,A01,083617,Boyle; Mary E. T.,23,0,48,25
1658121943887,COGS 13,A01,083071,Bastos; Amalia Pinkusfeld,12,0,71,59
1658121949909,COGS 14A,A01,092681,Semenuks; Arturs,5,1,100,95
1658121955932,COGS 14B,A01,083073,Cheng; Tzu-Han,7,0,63,56
1658121961958,COGS 17,A01,092677,Semenuks; Arturs,7,0,81,74
1658121967981,COGS 100,A01,083619,Allen; Michael Gordon,17,0,70,53
1658121974006,COGS 101A,A01,083621,Davis; Joshua Daniel,9,0,68,59
1658121980029,COGS 101B,A01,091572,Allen; Michael Gordon,14,0,65,51
1658121986057,COGS 101C,A01,083625,Delgado; Tania,17,0,35,18
1658121992084,COGS 107A,A01,083627,Boyle; Mary E. T.,14,0,60,46
1658121998111,COGS 118A,A01,083075,Gupta; Anjum,21,0,76,55
1658122004142,CSE 3,A50,083646,Miranda; Gregory Joseph,24,0,50,26
1658122010177,CSE 8A,A50,083650,Miranda; Gregory Joseph,17,1,56,39
1658122016204,CSE 11,A01,083080,Cao; Yingjun,7,15,40,33
1658122022229,CSE 12,A01,083652,Krause-Levy; Sophia Louisa,30,1,120,90
1658122028260,CSE 15L,A01,083654,Morris; Justin Loren,9,0,50,41
1658122028260,CSE 15L,A02,083655,Morris; Justin Loren,11,0,50,39
1658122034287,CSE 20,A01,083657,Tran; Khoa Dang,39,0,80,41
1658122040319,CSE 21,A01,095574,Bach; Quang Tran,23,0,48,25
1658122046353,CSE 30,A01,083084,Eldon; John,8,0,80,72
1658122046353,CSE 30,B01,095061,Bhaskar; Nishant,9,0,50,41
1658122052395,CSE 100,A01,083659,Cao; Yingjun,5,4,70,65
1658122058418,CSE 134B,A01,083661,Powell; Thomas Allan,25,0,100,75
1658122064443,CSE 140,A01,083663,Gungor; Onat,17,0,85,68
1658122070467,CSE 140L,A01,083088,Eldon; John,23,0,100,77
1658122076497,CSE 175,A01,083665,Kumar; Rakesh,3,0,25,22
1658122082520,CSE 190,A00,092507,Dubnov; Shlomo,8,0,20,12
1658122088544,ECE 45,A01,083139,Congero; Spencer William,7,0,75,68
1658122094573,ECE 65,A50,083695,Saad; Andrew S,12,0,30,18
1658122094573,ECE 65,A51,095125,Saad; Andrew S,24,0,26,2
1658122100597,ECE 109,A01,091882,Touri; Behrouz,21,0,70,49
1658122106621,ECE 180,A00,083140,Abi Samra; Nicholas Camill,1,0,30,29
1658122106621,ECE 180,B00,083141,Abi Samra; Nicholas Camill,0,0,30,30
1658122112644,MATH 10A,A01,083735,Patchell; Gregory David,2,0,30,28
1658122112644,MATH 10A,A02,083736,Patchell; Gregory David,20,0,30,10
1658122112644,MATH 10A,A03,083737,Patchell; Gregory David,16,0,30,14
1658122118669,MATH 10B,A01,083207,Lim; Seonhee,9,0,34,25
1658122118669,MATH 10B,A02,083208,Lim; Seonhee,10,0,35,25
1658122118669,MATH 10B,A03,093472,Lim; Seonhee,7,0,34,27
1658122118669,MATH 10B,B01,083739,Sinha; Shubham,14,0,30,16
1658122124694,MATH 18,A01,083743,Cinel; Cameron Alexander,9,0,30,21
1658122124694,MATH 18,A02,083744,Cinel; Cameron Alexander,18,0,30,12
1658122124694,MATH 18,A03,083745,Cinel; Cameron Alexander,10,0,30,20
1658122124694,MATH 18,B01,083748,Rideout; David Porter,5,0,37,32
1658122124694,MATH 18,B02,083749,Rideout; David Porter,5,0,36,31
1658122124694,MATH 18,B03,083750,Rideout; David Porter,3,0,37,34
1658122124694,MATH 18,B04,083751,Rideout; David Porter,7,0,36,29
1658122124694,MATH 18,B05,093473,Rideout; David Porter,7,0,36,29
1658122124694,MATH 18,B06,093474,Rideout; David Porter,6,0,36,30
1658122130718,MATH 20A,A01,083754,Zheng; Zequn,14,0,40,26
1658122136747,MATH 20B,A01,083756,Briones; Jor-el Thomas Caparas,4,0,36,32
1658122136747,MATH 20B,A02,083757,Briones; Jor-el Thomas Caparas,1,0,36,35
1658122136747,MATH 20B,A03,093475,Briones; Jor-el Thomas Caparas,3,0,36,33
1658122142770,MATH 20C,A01,083760,Briones; Jor-el Thomas Caparas,1,0,35,34
1658122142770,MATH 20C,A02,083761,Briones; Jor-el Thomas Caparas,8,0,35,27
1658122142770,MATH 20C,A03,093476,Briones; Jor-el Thomas Caparas,0,1,36,36
1658122142770,MATH 20C,B01,083762,Bach; Quang Tran,1,0,30,29
1658122148807,MATH 20D,A01,083765,Tran; Brian Kha,5,0,30,25
1658122148807,MATH 20D,A02,083766,Tran; Brian Kha,5,0,30,25
1658122148807,MATH 20D,A03,083767,Tran; Brian Kha,6,0,30,24
1658122154835,MATH 20E,A01,083771,Ganguly; Soumya,12,0,32,20
1658122154835,MATH 20E,A02,083772,Ganguly; Soumya,7,0,32,25
1658122154835,MATH 20E,B01,083773,Ciotti; Benjamin,20,0,35,15
1658122154835,MATH 20E,B02,083774,Ciotti; Benjamin,18,0,35,17
1658122160859,MATH 103A,A01,083777,Greenfeld; Be'Eri,6,0,36,30
1658122160859,MATH 103A,A02,083778,Greenfeld; Be'Eri,5,0,36,31
1658122160859,MATH 103A,A03,093561,Greenfeld; Be'Eri,7,0,36,29
1658122160859,MATH 103A,B01,083779,Greenfeld; Be'Eri,8,0,36,28
1658122160859,MATH 103A,B02,083780,Greenfeld; Be'Eri,4,0,36,32
1658122160859,MATH 103A,B03,093562,Greenfeld; Be'Eri,3,0,36,33
1658122166886,MATH 105,A01,085443,Carter; Anne Toulson,15,0,35,20
1658122166886,MATH 105,A02,093477,Carter; Anne Toulson,20,0,35,15
1658122172911,MATH 109,A01,083213,Ganzberger; Geoffrey Michael,3,0,34,31
1658122172911,MATH 109,A02,083214,Ganzberger; Geoffrey Michael,4,0,34,30
1658122172911,MATH 109,A03,093478,Ganzberger; Geoffrey Michael,2,0,34,32
1658122172911,MATH 109,B01,083215,Ganzberger; Geoffrey Michael,3,0,32,29
1658122172911,MATH 109,B02,083216,Ganzberger; Geoffrey Michael,3,0,32,29
1658122172911,MATH 109,B03,093479,Ganzberger; Geoffrey Michael,8,0,32,24
1658122178934,MATH 142A,A01,083219,Chow; Bennett,7,0,32,25
1658122178934,MATH 142A,A02,083220,Chow; Bennett,10,0,32,22
1658122178934,MATH 142A,A03,093480,Chow; Bennett,9,0,32,23
1658122178934,MATH 142A,B03,093481,Chow; Bennett,8,0,32,24
1658122178934,MATH 142A,B04,093558,Chow; Bennett,14,0,32,18
1658122178934,MATH 142A,B05,093559,Chow; Bennett,7,0,32,25
1658122184958,MATH 193A,A01,083224,Rotar; Vladimir,9,0,34,25
1658122184958,MATH 193A,A02,083225,Rotar; Vladimir,11,0,34,23
1658122184958,MATH 193A,A03,083781,Rotar; Vladimir,5,0,34,29
1658122184958,MATH 193A,A04,083782,Rotar; Vladimir,12,0,34,22
1658122184958,MATH 193A,A05,093482,Rotar; Vladimir,11,0,34,23
1658122190985,MATH 197,001,091859,McAuley; Julian John,9999,0,9999,0
1658122190985,MATH 197,002,095566,Kedlaya; Kiran S.,9997,0,9999,2
1658122190985,MATH 197,003,095567,Xiao; Ming,9999,0,9999,0
1658122190985,MATH 197,004,095571,Perols; Johan Lars,9998,0,9999,1
1658122198046,COGS 9,A01,083615,Shannon; Kyle Michael,11,0,75,64
1658122204072,COGS 11,A01,083617,Boyle; Mary E. T.,23,0,48,25
1658122210105,COGS 13,A01,083071,Bastos; Amalia Pinkusfeld,12,0,71,59
1658122216132,COGS 14A,A01,092681,Semenuks; Arturs,5,1,100,95
1658122222157,COGS 14B,A01,083073,Cheng; Tzu-Han,7,0,63,56
1658122228181,COGS 17,A01,092677,Semenuks; Arturs,7,0,81,74
1658122234206,COGS 100,A01,083619,Allen; Michael Gordon,17,0,70,53
1658122240234,COGS 101A,A01,083621,Davis; Joshua Daniel,9,0,68,59
1658122246261,COGS 101B,A01,091572,Allen; Michael Gordon,14,0,65,51
1658122252297,COGS 101C,A01,083625,Delgado; Tania,17,0,35,18
1658122258319,COGS 107A,A01,083627,Boyle; Mary E. T.,14,0,60,46
1658122264344,COGS 118A,A01,083075,Gupta; Anjum,21,0,76,55
1658122270376,CSE 3,A50,083646,Miranda; Gregory Joseph,24,0,50,26
1658122276399,CSE 8A,A50,083650,Miranda; Gregory Joseph,17,1,56,39
1658122282424,CSE 11,A01,083080,Cao; Yingjun,7,15,40,33
1658122288447,CSE 12,A01,083652,Krause-Levy; Sophia Louisa,30,1,120,90
1658122294471,CSE 15L,A01,083654,Morris; Justin Loren,9,0,50,41
1658122294471,CSE 15L,A02,083655,Morris; Justin Loren,11,0,50,39
1658122300494,CSE 20,A01,083657,Tran; Khoa Dang,39,0,80,41
1658122306520,CSE 21,A01,095574,Bach; Quang Tran,23,0,48,25
1658122312543,CSE 30,A01,083084,Eldon; John,8,0,80,72
1658122312543,CSE 30,B01,095061,Bhaskar; Nishant,9,0,50,41
1658122318568,CSE 100,A01,083659,Cao; Yingjun,5,4,70,65
1658122324595,CSE 134B,A01,083661,Powell; Thomas Allan,25,0,100,75
1658122330618,CSE 140,A01,083663,Gungor; Onat,17,0,85,68
1658122336646,CSE 140L,A01,083088,Eldon; John,23,0,100,77
1658122342677,CSE 175,A01,083665,Kumar; Rakesh,3,0,25,22
1658122348773,CSE 190,A00,092507,Dubnov; Shlomo,8,0,20,12
1658122354795,ECE 45,A01,083139,Congero; Spencer William,7,0,75,68
1658122360823,ECE 65,A50,083695,Saad; Andrew S,12,0,30,18
1658122360823,ECE 65,A51,095125,Saad; Andrew S,24,0,26,2
1658122366846,ECE 109,A01,091882,Touri; Behrouz,21,0,70,49
1658122372872,ECE 180,A00,083140,Abi Samra; Nicholas Camill,1,0,30,29
1658122372872,ECE 180,B00,083141,Abi Samra; Nicholas Camill,0,0,30,30
1658122378899,MATH 10A,A01,083735,Patchell; Gregory David,2,0,30,28
1658122378899,MATH 10A,A02,083736,Patchell; Gregory David,20,0,30,10
1658122378899,MATH 10A,A03,083737,Patchell; Gregory David,16,0,30,14
1658122384923,MATH 10B,A01,083207,Lim; Seonhee,9,0,34,25
1658122384923,MATH 10B,A02,083208,Lim; Seonhee,10,0,35,25
1658122384923,MATH 10B,A03,093472,Lim; Seonhee,7,0,34,27
1658122384923,MATH 10B,B01,083739,Sinha; Shubham,14,0,30,16
1658122390946,MATH 18,A01,083743,Cinel; Cameron Alexander,9,0,30,21
1658122390946,MATH 18,A02,083744,Cinel; Cameron Alexander,18,0,30,12
1658122390946,MATH 18,A03,083745,Cinel; Cameron Alexander,10,0,30,20
1658122390946,MATH 18,B01,083748,Rideout; David Porter,5,0,37,32
1658122390946,MATH 18,B02,083749,Rideout; David Porter,5,0,36,31
1658122390946,MATH 18,B03,083750,Rideout; David Porter,3,0,37,34
1658122390946,MATH 18,B04,083751,Rideout; David Porter,7,0,36,29
1658122390946,MATH 18,B05,093473,Rideout; David Porter,7,0,36,29
1658122390946,MATH 18,B06,093474,Rideout; David Porter,6,0,36,30
1658122396978,MATH 20A,A01,083754,Zheng; Zequn,14,0,40,26
1658122403000,MATH 20B,A01,083756,Briones; Jor-el Thomas Caparas,4,0,36,32
1658122403000,MATH 20B,A02,083757,Briones; Jor-el Thomas Caparas,1,0,36,35
1658122403000,MATH 20B,A03,093475,Briones; Jor-el Thomas Caparas,3,0,36,33
1658122409024,MATH 20C,A01,083760,Briones; Jor-el Thomas Caparas,1,0,35,34
1658122409024,MATH 20C,A02,083761,Briones; Jor-el Thomas Caparas,8,0,35,27
1658122409024,MATH 20C,A03,093476,Briones; Jor-el Thomas Caparas,0,1,36,36
1658122409024,MATH 20C,B01,083762,Bach; Quang Tran,1,0,30,29
1658122415048,MATH 20D,A01,083765,Tran; Brian Kha,5,0,30,25
1658122415048,MATH 20D,A02,083766,Tran; Brian Kha,5,0,30,25
1658122415048,MATH 20D,A03,083767,Tran; Brian Kha,6,0,30,24
1658122421074,MATH 20E,A01,083771,Ganguly; Soumya,12,0,32,20
1658122421074,MATH 20E,A02,083772,Ganguly; Soumya,7,0,32,25
1658122421074,MATH 20E,B01,083773,Ciotti; Benjamin,20,0,35,15
1658122421074,MATH 20E,B02,083774,Ciotti; Benjamin,18,0,35,17
1658122427099,MATH 103A,A01,083777,Greenfeld; Be'Eri,6,0,36,30
1658122427099,MATH 103A,A02,083778,Greenfeld; Be'Eri,5,0,36,31
1658122427099,MATH 103A,A03,093561,Greenfeld; Be'Eri,7,0,36,29
1658122427099,MATH 103A,B01,083779,Greenfeld; Be'Eri,8,0,36,28
1658122427099,MATH 103A,B02,083780,Greenfeld; Be'Eri,4,0,36,32
1658122427099,MATH 103A,B03,093562,Greenfeld; Be'Eri,3,0,36,33
1658122433135,MATH 105,A01,085443,Carter; Anne Toulson,15,0,35,20
1658122433135,MATH 105,A02,093477,Carter; Anne Toulson,20,0,35,15
1658122439164,MATH 109,A01,083213,Ganzberger; Geoffrey Michael,3,0,34,31
1658122439164,MATH 109,A02,083214,Ganzberger; Geoffrey Michael,4,0,34,30
1658122439164,MATH 109,A03,093478,Ganzberger; Geoffrey Michael,2,0,34,32
1658122439164,MATH 109,B01,083215,Ganzberger; Geoffrey Michael,3,0,32,29
1658122439164,MATH 109,B02,083216,Ganzberger; Geoffrey Michael,3,0,32,29
1658122439164,MATH 109,B03,093479,Ganzberger; Geoffrey Michael,8,0,32,24
1658122445196,MATH 142A,A01,083219,Chow; Bennett,7,0,32,25
1658122445196,MATH 142A,A02,083220,Chow; Bennett,10,0,32,22
1658122445196,MATH 142A,A03,093480,Chow; Bennett,9,0,32,23
1658122445196,MATH 142A,B03,093481,Chow; Bennett,8,0,32,24
1658122445196,MATH 142A,B04,093558,Chow; Bennett,14,0,32,18
1658122445196,MATH 142A,B05,093559,Chow; Bennett,7,0,32,25
1658122451225,MATH 193A,A01,083224,Rotar; Vladimir,9,0,34,25
1658122451225,MATH 193A,A02,083225,Rotar; Vladimir,11,0,34,23
1658122451225,MATH 193A,A03,083781,Rotar; Vladimir,5,0,34,29
1658122451225,MATH 193A,A04,083782,Rotar; Vladimir,12,0,34,22
1658122451225,MATH 193A,A05,093482,Rotar; Vladimir,11,0,34,23
1658122457251,MATH 197,001,091859,McAuley; Julian John,9999,0,9999,0
1658122457251,MATH 197,002,095566,Kedlaya; Kiran S.,9997,0,9999,2
1658122457251,MATH 197,003,095567,Xiao; Ming,9999,0,9999,0
1658122457251,MATH 197,004,095571,Perols; Johan Lars,9998,0,9999,1
1658122464309,COGS 9,A01,083615,Shannon; Kyle Michael,11,0,75,64
1658122470332,COGS 11,A01,083617,Boyle; Mary E. T.,23,0,48,25
1658122476356,COGS 13,A01,083071,Bastos; Amalia Pinkusfeld,12,0,71,59
1658122482384,COGS 14A,A01,092681,Semenuks; Arturs,5,1,100,95
1658122488406,COGS 14B,A01,083073,Cheng; Tzu-Han,7,0,63,56
1658122494432,COGS 17,A01,092677,Semenuks; Arturs,7,0,81,74
1658122500472,COGS 100,A01,083619,Allen; Michael Gordon,17,0,70,53
1658122506500,COGS 101A,A01,083621,Davis; Joshua Daniel,9,0,68,59
1658122512524,COGS 101B,A01,091572,Allen; Michael Gordon,14,0,65,51
1658122518547,COGS 101C,A01,083625,Delgado; Tania,17,0,35,18
1658122524579,COGS 107A,A01,083627,Boyle; Mary E. T.,14,0,60,46
1658122530605,COGS 118A,A01,083075,Gupta; Anjum,21,0,76,55
1658122536630,CSE 3,A50,083646,Miranda; Gregory Joseph,24,0,50,26
1658122542654,CSE 8A,A50,083650,Miranda; Gregory Joseph,17,1,56,39
1658122548677,CSE 11,A01,083080,Cao; Yingjun,7,15,40,33
1658122554701,CSE 12,A01,083652,Krause-Levy; Sophia Louisa,30,1,120,90
1658122560724,CSE 15L,A01,083654,Morris; Justin Loren,9,0,50,41
1658122560724,CSE 15L,A02,083655,Morris; Justin Loren,11,0,50,39
1658122566750,CSE 20,A01,083657,Tran; Khoa Dang,39,0,80,41
1658122572777,CSE 21,A01,095574,Bach; Quang Tran,23,0,48,25
1658122578815,CSE 30,A01,083084,Eldon; John,8,0,80,72
1658122578815,CSE 30,B01,095061,Bhaskar; Nishant,9,0,50,41
1658122584839,CSE 100,A01,083659,Cao; Yingjun,5,4,70,65
1658122590864,CSE 134B,A01,083661,Powell; Thomas Allan,25,0,100,75
1658122596888,CSE 140,A01,083663,Gungor; Onat,17,0,85,68
1658122602911,CSE 140L,A01,083088,Eldon; John,23,0,100,77
1658122608937,CSE 175,A01,083665,Kumar; Rakesh,3,0,25,22
1658122614969,CSE 190,A00,092507,Dubnov; Shlomo,8,0,20,12
1658122620993,ECE 45,A01,083139,Congero; Spencer William,7,0,75,68
1658122627019,ECE 65,A50,083695,Saad; Andrew S,12,0,30,18
1658122627019,ECE 65,A51,095125,Saad; Andrew S,24,0,26,2
1658122633043,ECE 109,A01,091882,Touri; Behrouz,21,0,70,49
1658122639067,ECE 180,A00,083140,Abi Samra; Nicholas Camill,1,0,30,29
1658122639067,ECE 180,B00,083141,Abi Samra; Nicholas Camill,0,0,30,30
1658122645091,MATH 10A,A01,083735,Patchell; Gregory David,2,0,30,28
1658122645091,MATH 10A,A02,083736,Patchell; Gregory David,20,0,30,10
1658122645091,MATH 10A,A03,083737,Patchell; Gregory David,16,0,30,14
1658122651120,MATH 10B,A01,083207,Lim; Seonhee,9,0,34,25
1658122651120,MATH 10B,A02,083208,Lim; Seonhee,10,0,35,25
1658122651120,MATH 10B,A03,093472,Lim; Seonhee,7,0,34,27
1658122651120,MATH 10B,B01,083739,Sinha; Shubham,14,0,30,16
1658122657146,MATH 18,A01,083743,Cinel; Cameron Alexander,9,0,30,21
1658122657146,MATH 18,A02,083744,Cinel; Cameron Alexander,18,0,30,12
1658122657146,MATH 18,A03,083745,Cinel; Cameron Alexander,10,0,30,20
1658122657146,MATH 18,B01,083748,Rideout; David Porter,5,0,37,32
1658122657146,MATH 18,B02,083749,Rideout; David Porter,5,0,36,31
1658122657146,MATH 18,B03,083750,Rideout; David Porter,3,0,37,34
1658122657146,MATH 18,B04,083751,Rideout; David Porter,7,0,36,29
1658122657146,MATH 18,B05,093473,Rideout; David Porter,7,0,36,29
1658122657146,MATH 18,B06,093474,Rideout; David Porter,6,0,36,30
1658122663169,MATH 20A,A01,083754,Zheng; Zequn,14,0,40,26
1658122669193,MATH 20B,A01,083756,Briones; Jor-el Thomas Caparas,4,0,36,32
1658122669193,MATH 20B,A02,083757,Briones; Jor-el Thomas Caparas,1,0,36,35
1658122669193,MATH 20B,A03,093475,Briones; Jor-el Thomas Caparas,3,0,36,33
1658122675217,MATH 20C,A01,083760,Briones; Jor-el Thomas Caparas,1,0,35,34
1658122675217,MATH 20C,A02,083761,Briones; Jor-el Thomas Caparas,8,0,35,27
1658122675217,MATH 20C,A03,093476,Briones; Jor-el Thomas Caparas,0,1,36,36
1658122675217,MATH 20C,B01,083762,Bach; Quang Tran,1,0,30,29
1658122681240,MATH 20D,A01,083765,Tran; Brian Kha,5,0,30,25
1658122681240,MATH 20D,A02,083766,Tran; Brian Kha,5,0,30,25
1658122681240,MATH 20D,A03,083767,Tran; Brian Kha,6,0,30,24
1658122687277,MATH 20E,A01,083771,Ganguly; Soumya,12,0,32,20
1658122687277,MATH 20E,A02,083772,Ganguly; Soumya,7,0,32,25
1658122687277,MATH 20E,B01,083773,Ciotti; Benjamin,20,0,35,15
1658122687277,MATH 20E,B02,083774,Ciotti; Benjamin,18,0,35,17
1658122693302,MATH 103A,A01,083777,Greenfeld; Be'Eri,6,0,36,30
1658122693302,MATH 103A,A02,083778,Greenfeld; Be'Eri,5,0,36,31
1658122693302,MATH 103A,A03,093561,Greenfeld; Be'Eri,7,0,36,29
1658122693302,MATH 103A,B01,083779,Greenfeld; Be'Eri,8,0,36,28
1658122693302,MATH 103A,B02,083780,Greenfeld; Be'Eri,4,0,36,32
1658122693302,MATH 103A,B03,093562,Greenfeld; Be'Eri,3,0,36,33
1658122699330,MATH 105,A01,085443,Carter; Anne Toulson,15,0,35,20
1658122699330,MATH 105,A02,093477,Carter; Anne Toulson,20,0,35,15
1658122705354,MATH 109,A01,083213,Ganzberger; Geoffrey Michael,3,0,34,31
1658122705354,MATH 109,A02,083214,Ganzberger; Geoffrey Michael,4,0,34,30
1658122705354,MATH 109,A03,093478,Ganzberger; Geoffrey Michael,2,0,34,32
1658122705354,MATH 109,B01,083215,Ganzberger; Geoffrey Michael,3,0,32,29
1658122705354,MATH 109,B02,083216,Ganzberger; Geoffrey Michael,3,0,32,29
1658122705354,MATH 109,B03,093479,Ganzberger; Geoffrey Michael,8,0,32,24
1658122711378,MATH 142A,A01,083219,Chow; Bennett,7,0,32,25
1658122711378,MATH 142A,A02,083220,Chow; Bennett,10,0,32,22
1658122711378,MATH 142A,A03,093480,Chow; Bennett,9,0,32,23
1658122711378,MATH 142A,B03,093481,Chow; Bennett,8,0,32,24
1658122711378,MATH 142A,B04,093558,Chow; Bennett,14,0,32,18
1658122711378,MATH 142A,B05,093559,Chow; Bennett,7,0,32,25
1658122717401,MATH 193A,A01,083224,Rotar; Vladimir,9,0,34,25
1658122717401,MATH 193A,A02,083225,Rotar; Vladimir,11,0,34,23
1658122717401,MATH 193A,A03,083781,Rotar; Vladimir,5,0,34,29
1658122717401,MATH 193A,A04,083782,Rotar; Vladimir,12,0,34,22
1658122717401,MATH 193A,A05,093482,Rotar; Vladimir,11,0,34,23
1658122723428,MATH 197,001,091859,McAuley; Julian John,9999,0,9999,0
1658122723428,MATH 197,002,095566,Kedlaya; Kiran S.,9997,0,9999,2
1658122723428,MATH 197,003,095567,Xiao; Ming,9999,0,9999,0
1658122723428,MATH 197,004,095571,Perols; Johan Lars,9998,0,9999,1
1658122730493,COGS 9,A01,083615,Shannon; Kyle Michael,11,0,75,64
1658122736516,COGS 11,A01,083617,Boyle; Mary E. T.,23,0,48,25
1658122742540,COGS 13,A01,083071,Bastos; Amalia Pinkusfeld,12,0,71,59
1658122748567,COGS 14A,A01,092681,Semenuks; Arturs,5,1,100,95
1658122754590,COGS 14B,A01,083073,Cheng; Tzu-Han,7,0,63,56
1658122760613,COGS 17,A01,092677,Semenuks; Arturs,7,0,81,74
1658122766640,COGS 100,A01,083619,Allen; Michael Gordon,17,0,70,53
1658122772666,COGS 101A,A01,083621,Davis; Joshua Daniel,9,0,68,59
1658122778689,COGS 101B,A01,091572,Allen; Michael Gordon,14,0,65,51
1658122784713,COGS 101C,A01,083625,Delgado; Tania,17,0,35,18
1658122790736,COGS 107A,A01,083627,Boyle; Mary E. T.,14,0,60,46
1658122796762,COGS 118A,A01,083075,Gupta; Anjum,21,0,76,55
1658122802789,CSE 3,A50,083646,Miranda; Gregory Joseph,24,0,50,26
1658122808819,CSE 8A,A50,083650,Miranda; Gregory Joseph,17,1,56,39
1658122814846,CSE 11,A01,083080,Cao; Yingjun,7,15,40,33
1658122820873,CSE 12,A01,083652,Krause-Levy; Sophia Louisa,30,1,120,90
1658122826900,CSE 15L,A01,083654,Morris; Justin Loren,9,0,50,41
1658122826900,CSE 15L,A02,083655,Morris; Justin Loren,11,0,50,39
1658122832927,CSE 20,A01,083657,Tran; Khoa Dang,39,0,80,41
1658122838963,CSE 21,A01,095574,Bach; Quang Tran,23,0,48,25
1658122844986,CSE 30,A01,083084,Eldon; John,8,0,80,72
1658122844986,CSE 30,B01,095061,Bhaskar; Nishant,9,0,50,41
1658122851014,CSE 100,A01,083659,Cao; Yingjun,5,4,70,65
1658122857037,CSE 134B,A01,083661,Powell; Thomas Allan,25,0,100,75
1658122863060,CSE 140,A01,083663,Gungor; Onat,17,0,85,68
1658122869083,CSE 140L,A01,083088,Eldon; John,23,0,100,77
1658122875108,CSE 175,A01,083665,Kumar; Rakesh,3,0,25,22
1658122881131,CSE 190,A00,092507,Dubnov; Shlomo,8,0,20,12
1658122887160,ECE 45,A01,083139,Congero; Spencer William,7,0,75,68
1658122893183,ECE 65,A50,083695,Saad; Andrew S,12,0,30,18
1658122893183,ECE 65,A51,095125,Saad; Andrew S,24,0,26,2
1658122899206,ECE 109,A01,091882,Touri; Behrouz,21,0,70,49
1658122905231,ECE 180,A00,083140,Abi Samra; Nicholas Camill,1,0,30,29
1658122905231,ECE 180,B00,083141,Abi Samra; Nicholas Camill,0,0,30,30
1658122911267,MATH 10A,A01,083735,Patchell; Gregory David,2,0,30,28
1658122911267,MATH 10A,A02,083736,Patchell; Gregory David,20,0,30,10
1658122911267,MATH 10A,A03,083737,Patchell; Gregory David,16,0,30,14
1658122917297,MATH 10B,A01,083207,Lim; Seonhee,9,0,34,25
1658122917297,MATH 10B,A02,083208,Lim; Seonhee,10,0,35,25
1658122917297,MATH 10B,A03,093472,Lim; Seonhee,7,0,34,27
1658122917297,MATH 10B,B01,083739,Sinha; Shubham,14,0,30,16
1658122923323,MATH 18,A01,083743,Cinel; Cameron Alexander,9,0,30,21
1658122923323,MATH 18,A02,083744,Cinel; Cameron Alexander,18,0,30,12
1658122923323,MATH 18,A03,083745,Cinel; Cameron Alexander,10,0,30,20
1658122923323,MATH 18,B01,083748,Rideout; David Porter,5,0,37,32
1658122923323,MATH 18,B02,083749,Rideout; David Porter,5,0,36,31
1658122923323,MATH 18,B03,083750,Rideout; David Porter,3,0,37,34
1658122923323,MATH 18,B04,083751,Rideout; David Porter,7,0,36,29
1658122923323,MATH 18,B05,093473,Rideout; David Porter,7,0,36,29
1658122923323,MATH 18,B06,093474,Rideout; David Porter,6,0,36,30
1658122929358,MATH 20A,A01,083754,Zheng; Zequn,14,0,40,26
1658122935385,MATH 20B,A01,083756,Briones; Jor-el Thomas Caparas,4,0,36,32
1658122935385,MATH 20B,A02,083757,Briones; Jor-el Thomas Caparas,1,0,36,35
1658122935385,MATH 20B,A03,093475,Briones; Jor-el Thomas Caparas,3,0,36,33
1658122941410,MATH 20C,A01,083760,Briones; Jor-el Thomas Caparas,1,0,35,34
1658122941410,MATH 20C,A02,083761,Briones; Jor-el Thomas Caparas,8,0,35,27
1658122941410,MATH 20C,A03,093476,Briones; Jor-el Thomas Caparas,0,1,36,36
1658122941410,MATH 20C,B01,083762,Bach; Quang Tran,1,0,30,29
1658122947526,MATH 20D,A01,083765,Tran; Brian Kha,5,0,30,25
1658122947526,MATH 20D,A02,083766,Tran; Brian Kha,5,0,30,25
1658122947526,MATH 20D,A03,083767,Tran; Brian Kha,6,0,30,24
1658122953551,MATH 20E,A01,083771,Ganguly; Soumya,12,0,32,20
1658122953551,MATH 20E,A02,083772,Ganguly; Soumya,7,0,32,25
1658122953551,MATH 20E,B01,083773,Ciotti; Benjamin,20,0,35,15
1658122953551,MATH 20E,B02,083774,Ciotti; Benjamin,18,0,35,17
1658122959580,MATH 103A,A01,083777,Greenfeld; Be'Eri,6,0,36,30
1658122959580,MATH 103A,A02,083778,Greenfeld; Be'Eri,5,0,36,31
1658122959580,MATH 103A,A03,093561,Greenfeld; Be'Eri,7,0,36,29
1658122959580,MATH 103A,B01,083779,Greenfeld; Be'Eri,8,0,36,28
1658122959580,MATH 103A,B02,083780,Greenfeld; Be'Eri,4,0,36,32
1658122959580,MATH 103A,B03,093562,Greenfeld; Be'Eri,3,0,36,33
1658122965609,MATH 105,A01,085443,Carter; Anne Toulson,15,0,35,20
1658122965609,MATH 105,A02,093477,Carter; Anne Toulson,20,0,35,15
1658122971639,MATH 109,A01,083213,Ganzberger; Geoffrey Michael,3,0,34,31
1658122971639,MATH 109,A02,083214,Ganzberger; Geoffrey Michael,4,0,34,30
1658122971639,MATH 109,A03,093478,Ganzberger; Geoffrey Michael,2,0,34,32
1658122971639,MATH 109,B01,083215,Ganzberger; Geoffrey Michael,3,0,32,29
1658122971639,MATH 109,B02,083216,Ganzberger; Geoffrey Michael,3,0,32,29
1658122971639,MATH 109,B03,093479,Ganzberger; Geoffrey Michael,8,0,32,24
1658122977666,MATH 142A,A01,083219,Chow; Bennett,7,0,32,25
1658122977666,MATH 142A,A02,083220,Chow; Bennett,10,0,32,22
1658122977666,MATH 142A,A03,093480,Chow; Bennett,9,0,32,23
1658122977666,MATH 142A,B03,093481,Chow; Bennett,8,0,32,24
1658122977666,MATH 142A,B04,093558,Chow; Bennett,14,0,32,18
1658122977666,MATH 142A,B05,093559,Chow; Bennett,7,0,32,25
1658122983692,MATH 193A,A01,083224,Rotar; Vladimir,9,0,34,25
1658122983692,MATH 193A,A02,083225,Rotar; Vladimir,11,0,34,23
1658122983692,MATH 193A,A03,083781,Rotar; Vladimir,5,0,34,29
1658122983692,MATH 193A,A04,083782,Rotar; Vladimir,12,0,34,22
1658122983692,MATH 193A,A05,093482,Rotar; Vladimir,11,0,34,23
1658122989718,MATH 197,001,091859,McAuley; Julian John,9999,0,9999,0
1658122989718,MATH 197,002,095566,Kedlaya; Kiran S.,9997,0,9999,2
1658122989718,MATH 197,003,095567,Xiao; Ming,9999,0,9999,0
1658122989718,MATH 197,004,095571,Perols; Johan Lars,9998,0,9999,1
1658122996770,COGS 9,A01,083615,Shannon; Kyle Michael,11,0,75,64
1658123002794,COGS 11,A01,083617,Boyle; Mary E. T.,23,0,48,25
1658123008816,COGS 13,A01,083071,Bastos; Amalia Pinkusfeld,12,0,71,59
1658123014843,COGS 14A,A01,092681,Semenuks; Arturs,5,1,100,95
1658123020865,COGS 14B,A01,083073,Cheng; Tzu-Han,7,0,63,56
1658123026891,COGS 17,A01,092677,Semenuks; Arturs,7,0,81,74
1658123032920,COGS 100,A01,083619,Allen; Michael Gordon,17,0,70,53
1658123038942,COGS 101A,A01,083621,Davis; Joshua Daniel,9,0,68,59
1658123044968,COGS 101B,A01,091572,Allen; Michael Gordon,14,0,65,51
1658123050994,COGS 101C,A01,083625,Delgado; Tania,17,0,35,18
1658123057024,COGS 107A,A01,083627,Boyle; Mary E. T.,14,0,60,46
1658123063045,COGS 118A,A01,083075,Gupta; Anjum,21,0,76,55
1658123069070,CSE 3,A50,083646,Miranda; Gregory Joseph,24,0,50,26
1658123075094,CSE 8A,A50,083650,Miranda; Gregory Joseph,17,1,56,39
1658123081119,CSE 11,A01,083080,Cao; Yingjun,7,15,40,33
1658123087147,CSE 12,A01,083652,Krause-Levy; Sophia Louisa,30,1,120,90
1658123093180,CSE 15L,A01,083654,Morris; Justin Loren,9,0,50,41
1658123093180,CSE 15L,A02,083655,Morris; Justin Loren,11,0,50,39
1658123099205,CSE 20,A01,083657,Tran; Khoa Dang,39,0,80,41
1658123105228,CSE 21,A01,095574,Bach; Quang Tran,23,0,48,25
1658123111255,CSE 30,A01,083084,Eldon; John,8,0,80,72
1658123111255,CSE 30,B01,095061,Bhaskar; Nishant,9,0,50,41
1658123117281,CSE 100,A01,083659,Cao; Yingjun,5,4,70,65
1658123123307,CSE 134B,A01,083661,Powell; Thomas Allan,25,0,100,75
1658123129329,CSE 140,A01,083663,Gungor; Onat,17,0,85,68
1658123135356,CSE 140L,A01,083088,Eldon; John,23,0,100,77
1658123141378,CSE 175,A01,083665,Kumar; Rakesh,3,0,25,22
1658123147402,CSE 190,A00,092507,Dubnov; Shlomo,8,0,20,12
1658123153426,ECE 45,A01,083139,Congero; Spencer William,7,0,75,68
1658123159452,ECE 65,A50,083695,Saad; Andrew S,12,0,30,18
1658123159452,ECE 65,A51,095125,Saad; Andrew S,24,0,26,2
1658123165475,ECE 109,A01,091882,Touri; Behrouz,21,0,70,49
1658123171502,ECE 180,A00,083140,Abi Samra; Nicholas Camill,1,0,30,29
1658123171502,ECE 180,B00,083141,Abi Samra; Nicholas Camill,0,0,30,30
1658123177529,MATH 10A,A01,083735,Patchell; Gregory David,2,0,30,28
1658123177529,MATH 10A,A02,083736,Patchell; Gregory David,20,0,30,10
1658123177529,MATH 10A,A03,083737,Patchell; Gregory David,16,0,30,14
1658123183554,MATH 10B,A01,083207,Lim; Seonhee,9,0,34,25
1658123183554,MATH 10B,A02,083208,Lim; Seonhee,10,0,35,25
1658123183554,MATH 10B,A03,093472,Lim; Seonhee,7,0,34,27
1658123183554,MATH 10B,B01,083739,Sinha; Shubham,14,0,30,16
1658123189579,MATH 18,A01,083743,Cinel; Cameron Alexander,9,0,30,21
1658123189579,MATH 18,A02,083744,Cinel; Cameron Alexander,18,0,30,12
1658123189579,MATH 18,A03,083745,Cinel; Cameron Alexander,10,0,30,20
1658123189579,MATH 18,B01,083748,Rideout; David Porter,5,0,37,32
1658123189579,MATH 18,B02,083749,Rideout; David Porter,5,0,36,31
1658123189579,MATH 18,B03,083750,Rideout; David Porter,3,0,37,34
1658123189579,MATH 18,B04,083751,Rideout; David Porter,7,0,36,29
1658123189579,MATH 18,B05,093473,Rideout; David Porter,7,0,36,29
1658123189579,MATH 18,B06,093474,Rideout; David Porter,6,0,36,30
1658123195605,MATH 20A,A01,083754,Zheng; Zequn,14,0,40,26
1658123201631,MATH 20B,A01,083756,Briones; Jor-el Thomas Caparas,4,0,36,32
1658123201631,MATH 20B,A02,083757,Briones; Jor-el Thomas Caparas,1,0,36,35
1658123201631,MATH 20B,A03,093475,Briones; Jor-el Thomas Caparas,3,0,36,33
1658123207659,MATH 20C,A01,083760,Briones; Jor-el Thomas Caparas,1,0,35,34
1658123207659,MATH 20C,A02,083761,Briones; Jor-el Thomas Caparas,8,0,35,27
1658123207659,MATH 20C,A03,093476,Briones; Jor-el Thomas Caparas,0,1,36,36
1658123207659,MATH 20C,B01,083762,Bach; Quang Tran,1,0,30,29
1658123213685,MATH 20D,A01,083765,Tran; Brian Kha,5,0,30,25
1658123213685,MATH 20D,A02,083766,Tran; Brian Kha,5,0,30,25
1658123213685,MATH 20D,A03,083767,Tran; Brian Kha,6,0,30,24
1658123219708,MATH 20E,A01,083771,Ganguly; Soumya,12,0,32,20
1658123219708,MATH 20E,A02,083772,Ganguly; Soumya,7,0,32,25
1658123219708,MATH 20E,B01,083773,Ciotti; Benjamin,20,0,35,15
1658123219708,MATH 20E,B02,083774,Ciotti; Benjamin,18,0,35,17
1658123225736,MATH 103A,A01,083777,Greenfeld; Be'Eri,6,0,36,30
1658123225736,MATH 103A,A02,083778,Greenfeld; Be'Eri,5,0,36,31
1658123225736,MATH 103A,A03,093561,Greenfeld; Be'Eri,7,0,36,29
1658123225736,MATH 103A,B01,083779,Greenfeld; Be'Eri,8,0,36,28
1658123225736,MATH 103A,B02,083780,Greenfeld; Be'Eri,4,0,36,32
1658123225736,MATH 103A,B03,093562,Greenfeld; Be'Eri,3,0,36,33
1658123231760,MATH 105,A01,085443,Carter; Anne Toulson,15,0,35,20
1658123231760,MATH 105,A02,093477,Carter; Anne Toulson,20,0,35,15
1658123237783,MATH 109,A01,083213,Ganzberger; Geoffrey Michael,3,0,34,31
1658123237783,MATH 109,A02,083214,Ganzberger; Geoffrey Michael,4,0,34,30
1658123237783,MATH 109,A03,093478,Ganzberger; Geoffrey Michael,2,0,34,32
1658123237783,MATH 109,B01,083215,Ganzberger; Geoffrey Michael,3,0,32,29
1658123237783,MATH 109,B02,083216,Ganzberger; Geoffrey Michael,3,0,32,29
1658123237783,MATH 109,B03,093479,Ganzberger; Geoffrey Michael,8,0,32,24
1658123243813,MATH 142A,A01,083219,Chow; Bennett,7,0,32,25
1658123243813,MATH 142A,A02,083220,Chow; Bennett,10,0,32,22
1658123243813,MATH 142A,A03,093480,Chow; Bennett,9,0,32,23
1658123243813,MATH 142A,B03,093481,Chow; Bennett,8,0,32,24
1658123243813,MATH 142A,B04,093558,Chow; Bennett,14,0,32,18
1658123243813,MATH 142A,B05,093559,Chow; Bennett,7,0,32,25
1658123249836,MATH 193A,A01,083224,Rotar; Vladimir,9,0,34,25
1658123249836,MATH 193A,A02,083225,Rotar; Vladimir,11,0,34,23
1658123249836,MATH 193A,A03,083781,Rotar; Vladimir,5,0,34,29
1658123249836,MATH 193A,A04,083782,Rotar; Vladimir,12,0,34,22
1658123249836,MATH 193A,A05,093482,Rotar; Vladimir,11,0,34,23
1658123255866,MATH 197,001,091859,McAuley; Julian John,9999,0,9999,0
1658123255866,MATH 197,002,095566,Kedlaya; Kiran S.,9997,0,9999,2
1658123255866,MATH 197,003,095567,Xiao; Ming,9999,0,9999,0
1658123255866,MATH 197,004,095571,Perols; Johan Lars,9998,0,9999,1
1658123262923,COGS 9,A01,083615,Shannon; Kyle Michael,11,0,75,64
1658123268954,COGS 11,A01,083617,Boyle; Mary E. T.,23,0,48,25
1658123274978,COGS 13,A01,083071,Bastos; Amalia Pinkusfeld,12,0,71,59
1658123281005,COGS 14A,A01,092681,Semenuks; Arturs,5,1,100,95
1658123287029,COGS 14B,A01,083073,Cheng; Tzu-Han,7,0,63,56
1658123293053,COGS 17,A01,092677,Semenuks; Arturs,7,0,81,74
1658123299079,COGS 100,A01,083619,Allen; Michael Gordon,17,0,70,53
1658123305102,COGS 101A,A01,083621,Davis; Joshua Daniel,9,0,68,59
1658123311125,COGS 101B,A01,091572,Allen; Michael Gordon,14,0,65,51
1658123317152,COGS 101C,A01,083625,Delgado; Tania,17,0,35,18
1658123323175,COGS 107A,A01,083627,Boyle; Mary E. T.,14,0,60,46
1658123329201,COGS 118A,A01,083075,Gupta; Anjum,21,0,76,55
1658123335224,CSE 3,A50,083646,Miranda; Gregory Joseph,24,0,50,26
1658123341249,CSE 8A,A50,083650,Miranda; Gregory Joseph,17,1,56,39
1658123347272,CSE 11,A01,083080,Cao; Yingjun,7,15,40,33
1658123353297,CSE 12,A01,083652,Krause-Levy; Sophia Louisa,30,1,120,90
1658123359320,CSE 15L,A01,083654,Morris; Justin Loren,9,0,50,41
1658123359320,CSE 15L,A02,083655,Morris; Justin Loren,11,0,50,39
1658123365348,CSE 20,A01,083657,Tran; Khoa Dang,39,0,80,41
1658123371377,CSE 21,A01,095574,Bach; Quang Tran,23,0,48,25
1658123377409,CSE 30,A01,083084,Eldon; John,8,0,80,72
1658123377409,CSE 30,B01,095061,Bhaskar; Nishant,9,0,50,41
1658123383433,CSE 100,A01,083659,Cao; Yingjun,5,4,70,65
1658123389459,CSE 134B,A01,083661,Powell; Thomas Allan,25,0,100,75
1658123395482,CSE 140,A01,083663,Gungor; Onat,17,0,85,68
1658123401508,CSE 140L,A01,083088,Eldon; John,23,0,100,77
1658123407531,CSE 175,A01,083665,Kumar; Rakesh,3,0,25,22
1658123413557,CSE 190,A00,092507,Dubnov; Shlomo,8,0,20,12
1658123419580,ECE 45,A01,083139,Congero; Spencer William,7,0,75,68
1658123425602,ECE 65,A50,083695,Saad; Andrew S,12,0,30,18
1658123425602,ECE 65,A51,095125,Saad; Andrew S,24,0,26,2
1658123431625,ECE 109,A01,091882,Touri; Behrouz,21,0,70,49
1658123437652,ECE 180,A00,083140,Abi Samra; Nicholas Camill,1,0,30,29
1658123437652,ECE 180,B00,083141,Abi Samra; Nicholas Camill,0,0,30,30
1658123443679,MATH 10A,A01,083735,Patchell; Gregory David,2,0,30,28
1658123443679,MATH 10A,A02,083736,Patchell; Gregory David,20,0,30,10
1658123443679,MATH 10A,A03,083737,Patchell; Gregory David,16,0,30,14
1658123449704,MATH 10B,A01,083207,Lim; Seonhee,9,0,34,25
1658123449704,MATH 10B,A02,083208,Lim; Seonhee,10,0,35,25
1658123449704,MATH 10B,A03,093472,Lim; Seonhee,7,0,34,27
1658123449704,MATH 10B,B01,083739,Sinha; Shubham,14,0,30,16
1658123455729,MATH 18,A01,083743,Cinel; Cameron Alexander,9,0,30,21
1658123455729,MATH 18,A02,083744,Cinel; Cameron Alexander,18,0,30,12
1658123455729,MATH 18,A03,083745,Cinel; Cameron Alexander,10,0,30,20
1658123455729,MATH 18,B01,083748,Rideout; David Porter,5,0,37,32
1658123455729,MATH 18,B02,083749,Rideout; David Porter,5,0,36,31
1658123455729,MATH 18,B03,083750,Rideout; David Porter,3,0,37,34
1658123455729,MATH 18,B04,083751,Rideout; David Porter,7,0,36,29
1658123455729,MATH 18,B05,093473,Rideout; David Porter,7,0,36,29
1658123455729,MATH 18,B06,093474,Rideout; David Porter,6,0,36,30
1658123461761,MATH 20A,A01,083754,Zheng; Zequn,14,0,40,26
1658123467783,MATH 20B,A01,083756,Briones; Jor-el Thomas Caparas,4,0,36,32
1658123467783,MATH 20B,A02,083757,Briones; Jor-el Thomas Caparas,1,0,36,35
1658123467783,MATH 20B,A03,093475,Briones; Jor-el Thomas Caparas,3,0,36,33
1658123473822,MATH 20C,A01,083760,Briones; Jor-el Thomas Caparas,1,0,35,34
1658123473822,MATH 20C,A02,083761,Briones; Jor-el Thomas Caparas,8,0,35,27
1658123473822,MATH 20C,A03,093476,Briones; Jor-el Thomas Caparas,0,1,36,36
1658123473822,MATH 20C,B01,083762,Bach; Quang Tran,1,0,30,29
1658123479845,MATH 20D,A01,083765,Tran; Brian Kha,5,0,30,25
1658123479845,MATH 20D,A02,083766,Tran; Brian Kha,5,0,30,25
1658123479845,MATH 20D,A03,083767,Tran; Brian Kha,6,0,30,24
1658123485874,MATH 20E,A01,083771,Ganguly; Soumya,12,0,32,20
1658123485874,MATH 20E,A02,083772,Ganguly; Soumya,7,0,32,25
1658123485874,MATH 20E,B01,083773,Ciotti; Benjamin,20,0,35,15
1658123485874,MATH 20E,B02,083774,Ciotti; Benjamin,18,0,35,17
1658123491896,MATH 103A,A01,083777,Greenfeld; Be'Eri,6,0,36,30
1658123491896,MATH 103A,A02,083778,Greenfeld; Be'Eri,5,0,36,31
1658123491896,MATH 103A,A03,093561,Greenfeld; Be'Eri,7,0,36,29
1658123491896,MATH 103A,B01,083779,Greenfeld; Be'Eri,8,0,36,28
1658123491896,MATH 103A,B02,083780,Greenfeld; Be'Eri,4,0,36,32
1658123491896,MATH 103A,B03,093562,Greenfeld; Be'Eri,3,0,36,33
1658123497922,MATH 105,A01,085443,Carter; Anne Toulson,15,0,35,20
1658123497922,MATH 105,A02,093477,Carter; Anne Toulson,20,0,35,15
1658123503953,MATH 109,A01,083213,Ganzberger; Geoffrey Michael,3,0,34,31
1658123503953,MATH 109,A02,083214,Ganzberger; Geoffrey Michael,4,0,34,30
1658123503953,MATH 109,A03,093478,Ganzberger; Geoffrey Michael,2,0,34,32
1658123503953,MATH 109,B01,083215,Ganzberger; Geoffrey Michael,3,0,32,29
1658123503953,MATH 109,B02,083216,Ganzberger; Geoffrey Michael,3,0,32,29
1658123503953,MATH 109,B03,093479,Ganzberger; Geoffrey Michael,8,0,32,24
1658123509978,MATH 142A,A01,083219,Chow; Bennett,7,0,32,25
1658123509978,MATH 142A,A02,083220,Chow; Bennett,10,0,32,22
1658123509978,MATH 142A,A03,093480,Chow; Bennett,9,0,32,23
1658123509978,MATH 142A,B03,093481,Chow; Bennett,8,0,32,24
1658123509978,MATH 142A,B04,093558,Chow; Bennett,14,0,32,18
1658123509978,MATH 142A,B05,093559,Chow; Bennett,7,0,32,25
1658123516006,MATH 193A,A01,083224,Rotar; Vladimir,9,0,34,25
1658123516006,MATH 193A,A02,083225,Rotar; Vladimir,11,0,34,23
1658123516006,MATH 193A,A03,083781,Rotar; Vladimir,5,0,34,29
1658123516006,MATH 193A,A04,083782,Rotar; Vladimir,12,0,34,22
1658123516006,MATH 193A,A05,093482,Rotar; Vladimir,11,0,34,23
1658123522029,MATH 197,001,091859,McAuley; Julian John,9999,0,9999,0
1658123522029,MATH 197,002,095566,Kedlaya; Kiran S.,9997,0,9999,2
1658123522029,MATH 197,003,095567,Xiao; Ming,9999,0,9999,0
1658123522029,MATH 197,004,095571,Perols; Johan Lars,9998,0,9999,1
1658123529092,COGS 9,A01,083615,Shannon; Kyle Michael,11,0,75,64
1658123535115,COGS 11,A01,083617,Boyle; Mary E. T.,23,0,48,25
1658123541220,COGS 13,A01,083071,Bastos; Amalia Pinkusfeld,12,0,71,59
1658123547243,COGS 14A,A01,092681,Semenuks; Arturs,5,1,100,95
1658123553274,COGS 14B,A01,083073,Cheng; Tzu-Han,7,0,63,56
1658123559297,COGS 17,A01,092677,Semenuks; Arturs,7,0,81,74
1658123565321,COGS 100,A01,083619,Allen; Michael Gordon,17,0,70,53
1658123571350,COGS 101A,A01,083621,Davis; Joshua Daniel,9,0,68,59
1658123577371,COGS 101B,A01,091572,Allen; Michael Gordon,14,0,65,51
1658123583394,COGS 101C,A01,083625,Delgado; Tania,17,0,35,18
1658123589424,COGS 107A,A01,083627,Boyle; Mary E. T.,14,0,60,46
1658123595447,COGS 118A,A01,083075,Gupta; Anjum,21,0,76,55
1658123601479,CSE 3,A50,083646,Miranda; Gregory Joseph,24,0,50,26
1658123607512,CSE 8A,A50,083650,Miranda; Gregory Joseph,17,1,56,39
1658123613538,CSE 11,A01,083080,Cao; Yingjun,7,15,40,33
1658123619565,CSE 12,A01,083652,Krause-Levy; Sophia Louisa,30,1,120,90
1658123625592,CSE 15L,A01,083654,Morris; Justin Loren,9,0,50,41
1658123625592,CSE 15L,A02,083655,Morris; Justin Loren,11,0,50,39
1658123631620,CSE 20,A01,083657,Tran; Khoa Dang,39,0,80,41
1658123637646,CSE 21,A01,095574,Bach; Quang Tran,23,0,48,25
1658123643675,CSE 30,A01,083084,Eldon; John,8,0,80,72
1658123643675,CSE 30,B01,095061,Bhaskar; Nishant,9,0,50,41
1658123649700,CSE 100,A01,083659,Cao; Yingjun,5,4,70,65
1658123655725,CSE 134B,A01,083661,Powell; Thomas Allan,25,0,100,75
1658123661747,CSE 140,A01,083663,Gungor; Onat,17,0,85,68
1658123667771,CSE 140L,A01,083088,Eldon; John,23,0,100,77
1658123673794,CSE 175,A01,083665,Kumar; Rakesh,3,0,25,22
1658123679817,CSE 190,A00,092507,Dubnov; Shlomo,8,0,20,12
1658123685846,ECE 45,A01,083139,Congero; Spencer William,7,0,75,68
1658123691869,ECE 65,A50,083695,Saad; Andrew S,12,0,30,18
1658123691869,ECE 65,A51,095125,Saad; Andrew S,24,0,26,2
1658123697893,ECE 109,A01,091882,Touri; Behrouz,21,0,70,49
1658123703925,ECE 180,A00,083140,Abi Samra; Nicholas Camill,1,0,30,29
1658123703925,ECE 180,B00,083141,Abi Samra; Nicholas Camill,0,0,30,30
1658123709952,MATH 10A,A01,083735,Patchell; Gregory David,2,0,30,28
1658123709952,MATH 10A,A02,083736,Patchell; Gregory David,20,0,30,10
1658123709952,MATH 10A,A03,083737,Patchell; Gregory David,16,0,30,14
1658123715981,MATH 10B,A01,083207,Lim; Seonhee,9,0,34,25
1658123715981,MATH 10B,A02,083208,Lim; Seonhee,10,0,35,25
1658123715981,MATH 10B,A03,093472,Lim; Seonhee,7,0,34,27
1658123715981,MATH 10B,B01,083739,Sinha; Shubham,14,0,30,16
1658123722012,MATH 18,A01,083743,Cinel; Cameron Alexander,9,0,30,21
1658123722012,MATH 18,A02,083744,Cinel; Cameron Alexander,18,0,30,12
1658123722012,MATH 18,A03,083745,Cinel; Cameron Alexander,10,0,30,20
1658123722012,MATH 18,B01,083748,Rideout; David Porter,5,0,37,32
1658123722012,MATH 18,B02,083749,Rideout; David Porter,5,0,36,31
1658123722012,MATH 18,B03,083750,Rideout; David Porter,3,0,37,34
1658123722012,MATH 18,B04,083751,Rideout; David Porter,7,0,36,29
1658123722012,MATH 18,B05,093473,Rideout; David Porter,7,0,36,29
1658123722012,MATH 18,B06,093474,Rideout; David Porter,6,0,36,30
1658123728035,MATH 20A,A01,083754,Zheng; Zequn,14,0,40,26
1658123734058,MATH 20B,A01,083756,Briones; Jor-el Thomas Caparas,4,0,36,32
1658123734058,MATH 20B,A02,083757,Briones; Jor-el Thomas Caparas,1,0,36,35
1658123734058,MATH 20B,A03,093475,Briones; Jor-el Thomas Caparas,3,0,36,33
1658123740082,MATH 20C,A01,083760,Briones; Jor-el Thomas Caparas,1,0,35,34
1658123740082,MATH 20C,A02,083761,Briones; Jor-el Thomas Caparas,8,0,35,27
1658123740082,MATH 20C,A03,093476,Briones; Jor-el Thomas Caparas,0,1,36,36
1658123740082,MATH 20C,B01,083762,Bach; Quang Tran,1,0,30,29
1658123746106,MATH 20D,A01,083765,Tran; Brian Kha,5,0,30,25
1658123746106,MATH 20D,A02,083766,Tran; Brian Kha,5,0,30,25
1658123746106,MATH 20D,A03,083767,Tran; Brian Kha,6,0,30,24
1658123752134,MATH 20E,A01,083771,Ganguly; Soumya,12,0,32,20
1658123752134,MATH 20E,A02,083772,Ganguly; Soumya,7,0,32,25
1658123752134,MATH 20E,B01,083773,Ciotti; Benjamin,20,0,35,15
1658123752134,MATH 20E,B02,083774,Ciotti; Benjamin,18,0,35,17
1658123758162,MATH 103A,A01,083777,Greenfeld; Be'Eri,6,0,36,30
1658123758162,MATH 103A,A02,083778,Greenfeld; Be'Eri,5,0,36,31
1658123758162,MATH 103A,A03,093561,Greenfeld; Be'Eri,7,0,36,29
1658123758162,MATH 103A,B01,083779,Greenfeld; Be'Eri,8,0,36,28
1658123758162,MATH 103A,B02,083780,Greenfeld; Be'Eri,4,0,36,32
1658123758162,MATH 103A,B03,093562,Greenfeld; Be'Eri,3,0,36,33
1658123764190,MATH 105,A01,085443,Carter; Anne Toulson,15,0,35,20
1658123764190,MATH 105,A02,093477,Carter; Anne Toulson,20,0,35,15
1658123770214,MATH 109,A01,083213,Ganzberger; Geoffrey Michael,3,0,34,31
1658123770214,MATH 109,A02,083214,Ganzberger; Geoffrey Michael,4,0,34,30
1658123770214,MATH 109,A03,093478,Ganzberger; Geoffrey Michael,2,0,34,32
1658123770214,MATH 109,B01,083215,Ganzberger; Geoffrey Michael,3,0,32,29
1658123770214,MATH 109,B02,083216,Ganzberger; Geoffrey Michael,3,0,32,29
1658123770214,MATH 109,B03,093479,Ganzberger; Geoffrey Michael,8,0,32,24
1658123776237,MATH 142A,A01,083219,Chow; Bennett,7,0,32,25
1658123776237,MATH 142A,A02,083220,Chow; Bennett,10,0,32,22
1658123776237,MATH 142A,A03,093480,Chow; Bennett,9,0,32,23
1658123776237,MATH 142A,B03,093481,Chow; Bennett,8,0,32,24
1658123776237,MATH 142A,B04,093558,Chow; Bennett,14,0,32,18
1658123776237,MATH 142A,B05,093559,Chow; Bennett,7,0,32,25
1658123782264,MATH 193A,A01,083224,Rotar; Vladimir,9,0,34,25
1658123782264,MATH 193A,A02,083225,Rotar; Vladimir,11,0,34,23
1658123782264,MATH 193A,A03,083781,Rotar; Vladimir,5,0,34,29
1658123782264,MATH 193A,A04,083782,Rotar; Vladimir,12,0,34,22
1658123782264,MATH 193A,A05,093482,Rotar; Vladimir,11,0,34,23
1658123788291,MATH 197,001,091859,McAuley; Julian John,9999,0,9999,0
1658123788291,MATH 197,002,095566,Kedlaya; Kiran S.,9997,0,9999,2
1658123788291,MATH 197,003,095567,Xiao; Ming,9999,0,9999,0
1658123788291,MATH 197,004,095571,Perols; Johan Lars,9998,0,9999,1
1658123795362,COGS 9,A01,083615,Shannon; Kyle Michael,11,0,75,64
1658123801385,COGS 11,A01,083617,Boyle; Mary E. T.,23,0,48,25
1658123807411,COGS 13,A01,083071,Bastos; Amalia Pinkusfeld,12,0,71,59
1658123813437,COGS 14A,A01,092681,Semenuks; Arturs,5,1,100,95
1658123819460,COGS 14B,A01,083073,Cheng; Tzu-Han,7,0,63,56
1658123825485,COGS 17,A01,092677,Semenuks; Arturs,7,0,81,74
1658123831510,COGS 100,A01,083619,Allen; Michael Gordon,17,0,70,53
1658123837533,COGS 101A,A01,083621,Davis; Joshua Daniel,9,0,68,59
1658123843555,COGS 101B,A01,091572,Allen; Michael Gordon,14,0,65,51
1658123849577,COGS 101C,A01,083625,Delgado; Tania,17,0,35,18
1658123855615,COGS 107A,A01,083627,Boyle; Mary E. T.,14,0,60,46
1658123861639,COGS 118A,A01,083075,Gupta; Anjum,21,0,76,55
1658123867666,CSE 3,A50,083646,Miranda; Gregory Joseph,24,0,50,26
1658123873693,CSE 8A,A50,083650,Miranda; Gregory Joseph,17,1,56,39
1658123879715,CSE 11,A01,083080,Cao; Yingjun,7,15,40,33
1658123885742,CSE 12,A01,083652,Krause-Levy; Sophia Louisa,30,1,120,90
1658123891766,CSE 15L,A01,083654,Morris; Justin Loren,9,0,50,41
1658123891766,CSE 15L,A02,083655,Morris; Justin Loren,11,0,50,39
1658123897800,CSE 20,A01,083657,Tran; Khoa Dang,39,0,80,41
1658123903826,CSE 21,A01,095574,Bach; Quang Tran,23,0,48,25
1658123909849,CSE 30,A01,083084,Eldon; John,8,0,80,72
1658123909849,CSE 30,B01,095061,Bhaskar; Nishant,9,0,50,41
1658123915871,CSE 100,A01,083659,Cao; Yingjun,5,4,70,65
1658123921895,CSE 134B,A01,083661,Powell; Thomas Allan,25,0,100,75
1658123927921,CSE 140,A01,083663,Gungor; Onat,17,0,85,68
1658123933948,CSE 140L,A01,083088,Eldon; John,23,0,100,77
1658123939970,CSE 175,A01,083665,Kumar; Rakesh,3,0,25,22
1658123945991,CSE 190,A00,092507,Dubnov; Shlomo,8,0,20,12
1658123952014,ECE 45,A01,083139,Congero; Spencer William,7,0,75,68
1658123958037,ECE 65,A50,083695,Saad; Andrew S,12,0,30,18
1658123958037,ECE 65,A51,095125,Saad; Andrew S,24,0,26,2
1658123964059,ECE 109,A01,091882,Touri; Behrouz,21,0,70,49
1658123970081,ECE 180,A00,083140,Abi Samra; Nicholas Camill,1,0,30,29
1658123970081,ECE 180,B00,083141,Abi Samra; Nicholas Camill,0,0,30,30
1658123976108,MATH 10A,A01,083735,Patchell; Gregory David,2,0,30,28
1658123976108,MATH 10A,A02,083736,Patchell; Gregory David,20,0,30,10
1658123976108,MATH 10A,A03,083737,Patchell; Gregory David,16,0,30,14
1658123982136,MATH 10B,A01,083207,Lim; Seonhee,9,0,34,25
1658123982136,MATH 10B,A02,083208,Lim; Seonhee,10,0,35,25
1658123982136,MATH 10B,A03,093472,Lim; Seonhee,7,0,34,27
1658123982136,MATH 10B,B01,083739,Sinha; Shubham,14,0,30,16
1658123988161,MATH 18,A01,083743,Cinel; Cameron Alexander,9,0,30,21
1658123988161,MATH 18,A02,083744,Cinel; Cameron Alexander,18,0,30,12
1658123988161,MATH 18,A03,083745,Cinel; Cameron Alexander,10,0,30,20
1658123988161,MATH 18,B01,083748,Rideout; David Porter,5,0,37,32
1658123988161,MATH 18,B02,083749,Rideout; David Porter,5,0,36,31
1658123988161,MATH 18,B03,083750,Rideout; David Porter,3,0,37,34
1658123988161,MATH 18,B04,083751,Rideout; David Porter,7,0,36,29
1658123988161,MATH 18,B05,093473,Rideout; David Porter,7,0,36,29
1658123988161,MATH 18,B06,093474,Rideout; David Porter,6,0,36,30
1658123994185,MATH 20A,A01,083754,Zheng; Zequn,14,0,40,26
1658124000213,MATH 20B,A01,083756,Briones; Jor-el Thomas Caparas,4,0,36,32
1658124000213,MATH 20B,A02,083757,Briones; Jor-el Thomas Caparas,1,0,36,35
1658124000213,MATH 20B,A03,093475,Briones; Jor-el Thomas Caparas,3,0,36,33
1658124006238,MATH 20C,A01,083760,Briones; Jor-el Thomas Caparas,1,0,35,34
1658124006238,MATH 20C,A02,083761,Briones; Jor-el Thomas Caparas,8,0,35,27
1658124006238,MATH 20C,A03,093476,Briones; Jor-el Thomas Caparas,0,1,36,36
1658124006238,MATH 20C,B01,083762,Bach; Quang Tran,1,0,30,29
1658124012261,MATH 20D,A01,083765,Tran; Brian Kha,5,0,30,25
1658124012261,MATH 20D,A02,083766,Tran; Brian Kha,5,0,30,25
1658124012261,MATH 20D,A03,083767,Tran; Brian Kha,6,0,30,24
1658124018290,MATH 20E,A01,083771,Ganguly; Soumya,12,0,32,20
1658124018290,MATH 20E,A02,083772,Ganguly; Soumya,7,0,32,25
1658124018290,MATH 20E,B01,083773,Ciotti; Benjamin,20,0,35,15
1658124018290,MATH 20E,B02,083774,Ciotti; Benjamin,18,0,35,17
1658124024314,MATH 103A,A01,083777,Greenfeld; Be'Eri,6,0,36,30
1658124024314,MATH 103A,A02,083778,Greenfeld; Be'Eri,5,0,36,31
1658124024314,MATH 103A,A03,093561,Greenfeld; Be'Eri,7,0,36,29
1658124024314,MATH 103A,B01,083779,Greenfeld; Be'Eri,8,0,36,28
1658124024314,MATH 103A,B02,083780,Greenfeld; Be'Eri,4,0,36,32
1658124024314,MATH 103A,B03,093562,Greenfeld; Be'Eri,3,0,36,33
1658124030342,MATH 105,A01,085443,Carter; Anne Toulson,15,0,35,20
1658124030342,MATH 105,A02,093477,Carter; Anne Toulson,20,0,35,15
1658124036366,MATH 109,A01,083213,Ganzberger; Geoffrey Michael,3,0,34,31
1658124036366,MATH 109,A02,083214,Ganzberger; Geoffrey Michael,4,0,34,30
1658124036366,MATH 109,A03,093478,Ganzberger; Geoffrey Michael,2,0,34,32
1658124036366,MATH 109,B01,083215,Ganzberger; Geoffrey Michael,3,0,32,29
1658124036366,MATH 109,B02,083216,Ganzberger; Geoffrey Michael,3,0,32,29
1658124036366,MATH 109,B03,093479,Ganzberger; Geoffrey Michael,8,0,32,24
1658124042395,MATH 142A,A01,083219,Chow; Bennett,7,0,32,25
1658124042395,MATH 142A,A02,083220,Chow; Bennett,10,0,32,22
1658124042395,MATH 142A,A03,093480,Chow; Bennett,9,0,32,23
1658124042395,MATH 142A,B03,093481,Chow; Bennett,8,0,32,24
1658124042395,MATH 142A,B04,093558,Chow; Bennett,14,0,32,18
1658124042395,MATH 142A,B05,093559,Chow; Bennett,7,0,32,25
1658124048419,MATH 193A,A01,083224,Rotar; Vladimir,9,0,34,25
1658124048419,MATH 193A,A02,083225,Rotar; Vladimir,11,0,34,23
1658124048419,MATH 193A,A03,083781,Rotar; Vladimir,5,0,34,29
1658124048419,MATH 193A,A04,083782,Rotar; Vladimir,12,0,34,22
1658124048419,MATH 193A,A05,093482,Rotar; Vladimir,11,0,34,23
1658124054443,MATH 197,001,091859,McAuley; Julian John,9999,0,9999,0
1658124054443,MATH 197,002,095566,Kedlaya; Kiran S.,9997,0,9999,2
1658124054443,MATH 197,003,095567,Xiao; Ming,9999,0,9999,0
1658124054443,MATH 197,004,095571,Perols; Johan Lars,9998,0,9999,1
1658124061510,COGS 9,A01,083615,Shannon; Kyle Michael,11,0,75,64
1658124067533,COGS 11,A01,083617,Boyle; Mary E. T.,23,0,48,25
1658124073563,COGS 13,A01,083071,Bastos; Amalia Pinkusfeld,12,0,71,59
1658124079587,COGS 14A,A01,092681,Semenuks; Arturs,5,1,100,95
1658124085615,COGS 14B,A01,083073,Cheng; Tzu-Han,7,0,63,56
1658124091640,COGS 17,A01,092677,Semenuks; Arturs,7,0,81,74
1658124097665,COGS 100,A01,083619,Allen; Michael Gordon,17,0,70,53
1658124103691,COGS 101A,A01,083621,Davis; Joshua Daniel,9,0,68,59
1658124109719,COGS 101B,A01,091572,Allen; Michael Gordon,14,0,65,51
1658124115742,COGS 101C,A01,083625,Delgado; Tania,17,0,35,18
1658124121776,COGS 107A,A01,083627,Boyle; Mary E. T.,14,0,60,46
1658124127803,COGS 118A,A01,083075,Gupta; Anjum,21,0,76,55
1658124133828,CSE 3,A50,083646,Miranda; Gregory Joseph,24,0,50,26
1658124139924,CSE 8A,A50,083650,Miranda; Gregory Joseph,17,1,56,39
1658124145949,CSE 11,A01,083080,Cao; Yingjun,7,15,40,33
1658124151976,CSE 12,A01,083652,Krause-Levy; Sophia Louisa,30,1,120,90
1658124157999,CSE 15L,A01,083654,Morris; Justin Loren,9,0,50,41
1658124157999,CSE 15L,A02,083655,Morris; Justin Loren,11,0,50,39
1658124164023,CSE 20,A01,083657,Tran; Khoa Dang,39,0,80,41
1658124170049,CSE 21,A01,095574,Bach; Quang Tran,23,0,48,25
1658124176073,CSE 30,A01,083084,Eldon; John,8,0,80,72
1658124176073,CSE 30,B01,095061,Bhaskar; Nishant,9,0,50,41
1658124182103,CSE 100,A01,083659,Cao; Yingjun,5,4,70,65
1658124188129,CSE 134B,A01,083661,Powell; Thomas Allan,25,0,100,75
1658124194156,CSE 140,A01,083663,Gungor; Onat,17,0,85,68
1658124200187,CSE 140L,A01,083088,Eldon; John,23,0,100,77
1658124206211,CSE 175,A01,083665,Kumar; Rakesh,3,0,25,22
1658124212235,CSE 190,A00,092507,Dubnov; Shlomo,8,0,20,12
1658124218258,ECE 45,A01,083139,Congero; Spencer William,7,0,75,68
1658124224284,ECE 65,A50,083695,Saad; Andrew S,12,0,30,18
1658124224284,ECE 65,A51,095125,Saad; Andrew S,24,0,26,2
1658124230309,ECE 109,A01,091882,Touri; Behrouz,21,0,70,49
1658124236339,ECE 180,A00,083140,Abi Samra; Nicholas Camill,1,0,30,29
1658124236339,ECE 180,B00,083141,Abi Samra; Nicholas Camill,0,0,30,30
1658124242363,MATH 10A,A01,083735,Patchell; Gregory David,2,0,30,28
1658124242363,MATH 10A,A02,083736,Patchell; Gregory David,20,0,30,10
1658124242363,MATH 10A,A03,083737,Patchell; Gregory David,16,0,30,14
1658124248389,MATH 10B,A01,083207,Lim; Seonhee,9,0,34,25
1658124248389,MATH 10B,A02,083208,Lim; Seonhee,10,0,35,25
1658124248389,MATH 10B,A03,093472,Lim; Seonhee,7,0,34,27
1658124248389,MATH 10B,B01,083739,Sinha; Shubham,14,0,30,16
1658124254415,MATH 18,A01,083743,Cinel; Cameron Alexander,9,0,30,21
1658124254415,MATH 18,A02,083744,Cinel; Cameron Alexander,18,0,30,12
1658124254415,MATH 18,A03,083745,Cinel; Cameron Alexander,10,0,30,20
1658124254415,MATH 18,B01,083748,Rideout; David Porter,5,0,37,32
1658124254415,MATH 18,B02,083749,Rideout; David Porter,5,0,36,31
1658124254415,MATH 18,B03,083750,Rideout; David Porter,3,0,37,34
1658124254415,MATH 18,B04,083751,Rideout; David Porter,7,0,36,29
1658124254415,MATH 18,B05,093473,Rideout; David Porter,7,0,36,29
1658124254415,MATH 18,B06,093474,Rideout; David Porter,6,0,36,30
1658124260438,MATH 20A,A01,083754,Zheng; Zequn,14,0,40,26
1658124266464,MATH 20B,A01,083756,Briones; Jor-el Thomas Caparas,4,0,36,32
1658124266464,MATH 20B,A02,083757,Briones; Jor-el Thomas Caparas,1,0,36,35
1658124266464,MATH 20B,A03,093475,Briones; Jor-el Thomas Caparas,3,0,36,33
1658124272493,MATH 20C,A01,083760,Briones; Jor-el Thomas Caparas,1,0,35,34
1658124272493,MATH 20C,A02,083761,Briones; Jor-el Thomas Caparas,8,0,35,27
1658124272493,MATH 20C,A03,093476,Briones; Jor-el Thomas Caparas,0,1,36,36
1658124272493,MATH 20C,B01,083762,Bach; Quang Tran,1,0,30,29
1658124278528,MATH 20D,A01,083765,Tran; Brian Kha,5,0,30,25
1658124278528,MATH 20D,A02,083766,Tran; Brian Kha,5,0,30,25
1658124278528,MATH 20D,A03,083767,Tran; Brian Kha,6,0,30,24
1658124284560,MATH 20E,A01,083771,Ganguly; Soumya,12,0,32,20
1658124284560,MATH 20E,A02,083772,Ganguly; Soumya,7,0,32,25
1658124284560,MATH 20E,B01,083773,Ciotti; Benjamin,20,0,35,15
1658124284560,MATH 20E,B02,083774,Ciotti; Benjamin,18,0,35,17
1658124290593,MATH 103A,A01,083777,Greenfeld; Be'Eri,6,0,36,30
1658124290593,MATH 103A,A02,083778,Greenfeld; Be'Eri,5,0,36,31
1658124290593,MATH 103A,A03,093561,Greenfeld; Be'Eri,7,0,36,29
1658124290593,MATH 103A,B01,083779,Greenfeld; Be'Eri,8,0,36,28
1658124290593,MATH 103A,B02,083780,Greenfeld; Be'Eri,4,0,36,32
1658124290593,MATH 103A,B03,093562,Greenfeld; Be'Eri,3,0,36,33
1658124296619,MATH 105,A01,085443,Carter; Anne Toulson,15,0,35,20
1658124296619,MATH 105,A02,093477,Carter; Anne Toulson,20,0,35,15
1658124302650,MATH 109,A01,083213,Ganzberger; Geoffrey Michael,3,0,34,31
1658124302650,MATH 109,A02,083214,Ganzberger; Geoffrey Michael,4,0,34,30
1658124302650,MATH 109,A03,093478,Ganzberger; Geoffrey Michael,2,0,34,32
1658124302650,MATH 109,B01,083215,Ganzberger; Geoffrey Michael,3,0,32,29
1658124302650,MATH 109,B02,083216,Ganzberger; Geoffrey Michael,3,0,32,29
1658124302650,MATH 109,B03,093479,Ganzberger; Geoffrey Michael,8,0,32,24
1658124308676,MATH 142A,A01,083219,Chow; Bennett,7,0,32,25
1658124308676,MATH 142A,A02,083220,Chow; Bennett,10,0,32,22
1658124308676,MATH 142A,A03,093480,Chow; Bennett,9,0,32,23
1658124308676,MATH 142A,B03,093481,Chow; Bennett,8,0,32,24
1658124308676,MATH 142A,B04,093558,Chow; Bennett,14,0,32,18
1658124308676,MATH 142A,B05,093559,Chow; Bennett,7,0,32,25
1658124314705,MATH 193A,A01,083224,Rotar; Vladimir,9,0,34,25
1658124314705,MATH 193A,A02,083225,Rotar; Vladimir,11,0,34,23
1658124314705,MATH 193A,A03,083781,Rotar; Vladimir,5,0,34,29
1658124314705,MATH 193A,A04,083782,Rotar; Vladimir,12,0,34,22
1658124314705,MATH 193A,A05,093482,Rotar; Vladimir,11,0,34,23
1658124320731,MATH 197,001,091859,McAuley; Julian John,9999,0,9999,0
1658124320731,MATH 197,002,095566,Kedlaya; Kiran S.,9997,0,9999,2
1658124320731,MATH 197,003,095567,Xiao; Ming,9999,0,9999,0
1658124320731,MATH 197,004,095571,Perols; Johan Lars,9998,0,9999,1
1658124327803,COGS 9,A01,083615,Shannon; Kyle Michael,11,0,75,64
1658124333830,COGS 11,A01,083617,Boyle; Mary E. T.,23,0,48,25
1658124339858,COGS 13,A01,083071,Bastos; Amalia Pinkusfeld,12,0,71,59
1658124345882,COGS 14A,A01,092681,Semenuks; Arturs,5,1,100,95
1658124351914,COGS 14B,A01,083073,Cheng; Tzu-Han,7,0,63,56
1658124357941,COGS 17,A01,092677,Semenuks; Arturs,7,0,81,74
1658124363964,COGS 100,A01,083619,Allen; Michael Gordon,17,0,70,53
1658124369993,COGS 101A,A01,083621,Davis; Joshua Daniel,9,0,68,59
1658124376015,COGS 101B,A01,091572,Allen; Michael Gordon,14,0,65,51
1658124382042,COGS 101C,A01,083625,Delgado; Tania,17,0,35,18
1658124388076,COGS 107A,A01,083627,Boyle; Mary E. T.,14,0,60,46
1658124394104,COGS 118A,A01,083075,Gupta; Anjum,21,0,76,55
1658124400130,CSE 3,A50,083646,Miranda; Gregory Joseph,24,0,50,26
1658124406154,CSE 8A,A50,083650,Miranda; Gregory Joseph,17,1,56,39
1658124412181,CSE 11,A01,083080,Cao; Yingjun,7,15,40,33
1658124418208,CSE 12,A01,083652,Krause-Levy; Sophia Louisa,30,1,120,90
1658124424236,CSE 15L,A01,083654,Morris; Justin Loren,9,0,50,41
1658124424236,CSE 15L,A02,083655,Morris; Justin Loren,11,0,50,39
1658124430262,CSE 20,A01,083657,Tran; Khoa Dang,39,0,80,41
1658124436289,CSE 21,A01,095574,Bach; Quang Tran,23,0,48,25
1658124442315,CSE 30,A01,083084,Eldon; John,8,0,80,72
1658124442315,CSE 30,B01,095061,Bhaskar; Nishant,9,0,50,41
1658124448339,CSE 100,A01,083659,Cao; Yingjun,5,4,70,65
1658124454362,CSE 134B,A01,083661,Powell; Thomas Allan,25,0,100,75
1658124460393,CSE 140,A01,083663,Gungor; Onat,17,0,85,68
1658124466416,CSE 140L,A01,083088,Eldon; John,23,0,100,77
1658124472448,CSE 175,A01,083665,Kumar; Rakesh,3,0,25,22
1658124478476,CSE 190,A00,092507,Dubnov; Shlomo,8,0,20,12
1658124484507,ECE 45,A01,083139,Congero; Spencer William,7,0,75,68
1658124490531,ECE 65,A50,083695,Saad; Andrew S,12,0,30,18
1658124490531,ECE 65,A51,095125,Saad; Andrew S,24,0,26,2
1658124496558,ECE 109,A01,091882,Touri; Behrouz,21,0,70,49
1658124502584,ECE 180,A00,083140,Abi Samra; Nicholas Camill,1,0,30,29
1658124502584,ECE 180,B00,083141,Abi Samra; Nicholas Camill,0,0,30,30
1658124508608,MATH 10A,A01,083735,Patchell; Gregory David,2,0,30,28
1658124508608,MATH 10A,A02,083736,Patchell; Gregory David,20,0,30,10
1658124508608,MATH 10A,A03,083737,Patchell; Gregory David,16,0,30,14
1658124514638,MATH 10B,A01,083207,Lim; Seonhee,9,0,34,25
1658124514638,MATH 10B,A02,083208,Lim; Seonhee,10,0,35,25
1658124514638,MATH 10B,A03,093472,Lim; Seonhee,7,0,34,27
1658124514638,MATH 10B,B01,083739,Sinha; Shubham,14,0,30,16
1658124520669,MATH 18,A01,083743,Cinel; Cameron Alexander,9,0,30,21
1658124520669,MATH 18,A02,083744,Cinel; Cameron Alexander,18,0,30,12
1658124520669,MATH 18,A03,083745,Cinel; Cameron Alexander,10,0,30,20
1658124520669,MATH 18,B01,083748,Rideout; David Porter,5,0,37,32
1658124520669,MATH 18,B02,083749,Rideout; David Porter,5,0,36,31
1658124520669,MATH 18,B03,083750,Rideout; David Porter,3,0,37,34
1658124520669,MATH 18,B04,083751,Rideout; David Porter,7,0,36,29
1658124520669,MATH 18,B05,093473,Rideout; David Porter,7,0,36,29
1658124520669,MATH 18,B06,093474,Rideout; David Porter,6,0,36,30
1658124526704,MATH 20A,A01,083754,Zheng; Zequn,14,0,40,26
1658124532732,MATH 20B,A01,083756,Briones; Jor-el Thomas Caparas,4,0,36,32
1658124532732,MATH 20B,A02,083757,Briones; Jor-el Thomas Caparas,1,0,36,35
1658124532732,MATH 20B,A03,093475,Briones; Jor-el Thomas Caparas,3,0,36,33
1658124538756,MATH 20C,A01,083760,Briones; Jor-el Thomas Caparas,1,0,35,34
1658124538756,MATH 20C,A02,083761,Briones; Jor-el Thomas Caparas,8,0,35,27
1658124538756,MATH 20C,A03,093476,Briones; Jor-el Thomas Caparas,0,1,36,36
1658124538756,MATH 20C,B01,083762,Bach; Quang Tran,1,0,30,29
1658124544780,MATH 20D,A01,083765,Tran; Brian Kha,5,0,30,25
1658124544780,MATH 20D,A02,083766,Tran; Brian Kha,5,0,30,25
1658124544780,MATH 20D,A03,083767,Tran; Brian Kha,6,0,30,24
1658124550808,MATH 20E,A01,083771,Ganguly; Soumya,12,0,32,20
1658124550808,MATH 20E,A02,083772,Ganguly; Soumya,7,0,32,25
1658124550808,MATH 20E,B01,083773,Ciotti; Benjamin,20,0,35,15
1658124550808,MATH 20E,B02,083774,Ciotti; Benjamin,18,0,35,17
1658124556836,MATH 103A,A01,083777,Greenfeld; Be'Eri,6,0,36,30
1658124556836,MATH 103A,A02,083778,Greenfeld; Be'Eri,5,0,36,31
1658124556836,MATH 103A,A03,093561,Greenfeld; Be'Eri,7,0,36,29
1658124556836,MATH 103A,B01,083779,Greenfeld; Be'Eri,8,0,36,28
1658124556836,MATH 103A,B02,083780,Greenfeld; Be'Eri,4,0,36,32
1658124556836,MATH 103A,B03,093562,Greenfeld; Be'Eri,3,0,36,33
1658124562858,MATH 105,A01,085443,Carter; Anne Toulson,15,0,35,20
1658124562858,MATH 105,A02,093477,Carter; Anne Toulson,20,0,35,15
1658124568881,MATH 109,A01,083213,Ganzberger; Geoffrey Michael,3,0,34,31
1658124568881,MATH 109,A02,083214,Ganzberger; Geoffrey Michael,4,0,34,30
1658124568881,MATH 109,A03,093478,Ganzberger; Geoffrey Michael,2,0,34,32
1658124568881,MATH 109,B01,083215,Ganzberger; Geoffrey Michael,3,0,32,29
1658124568881,MATH 109,B02,083216,Ganzberger; Geoffrey Michael,3,0,32,29
1658124568881,MATH 109,B03,093479,Ganzberger; Geoffrey Michael,8,0,32,24
1658124574912,MATH 142A,A01,083219,Chow; Bennett,7,0,32,25
1658124574912,MATH 142A,A02,083220,Chow; Bennett,10,0,32,22
1658124574912,MATH 142A,A03,093480,Chow; Bennett,9,0,32,23
1658124574912,MATH 142A,B03,093481,Chow; Bennett,8,0,32,24
1658124574912,MATH 142A,B04,093558,Chow; Bennett,14,0,32,18
1658124574912,MATH 142A,B05,093559,Chow; Bennett,7,0,32,25
1658124580939,MATH 193A,A01,083224,Rotar; Vladimir,9,0,34,25
1658124580939,MATH 193A,A02,083225,Rotar; Vladimir,11,0,34,23
1658124580939,MATH 193A,A03,083781,Rotar; Vladimir,5,0,34,29
1658124580939,MATH 193A,A04,083782,Rotar; Vladimir,12,0,34,22
1658124580939,MATH 193A,A05,093482,Rotar; Vladimir,11,0,34,23
1658124586964,MATH 197,001,091859,McAuley; Julian John,9999,0,9999,0
1658124586964,MATH 197,002,095566,Kedlaya; Kiran S.,9997,0,9999,2
1658124586964,MATH 197,003,095567,Xiao; Ming,9999,0,9999,0
1658124586964,MATH 197,004,095571,Perols; Johan Lars,9998,0,9999,1
1658124594015,COGS 9,A01,083615,Shannon; Kyle Michael,11,0,75,64
1658124600040,COGS 11,A01,083617,Boyle; Mary E. T.,23,0,48,25
1658124606066,COGS 13,A01,083071,Bastos; Amalia Pinkusfeld,12,0,71,59
1658124612089,COGS 14A,A01,092681,Semenuks; Arturs,5,1,100,95
1658124618114,COGS 14B,A01,083073,Cheng; Tzu-Han,7,0,63,56
1658124624140,COGS 17,A01,092677,Semenuks; Arturs,7,0,81,74
1658124630172,COGS 100,A01,083619,Allen; Michael Gordon,17,0,70,53
1658124636195,COGS 101A,A01,083621,Davis; Joshua Daniel,9,0,68,59
1658124642223,COGS 101B,A01,091572,Allen; Michael Gordon,14,0,65,51
1658124648247,COGS 101C,A01,083625,Delgado; Tania,17,0,35,18
1658124654270,COGS 107A,A01,083627,Boyle; Mary E. T.,14,0,60,46
1658124660293,COGS 118A,A01,083075,Gupta; Anjum,21,0,76,55
1658124666316,CSE 3,A50,083646,Miranda; Gregory Joseph,24,0,50,26
1658124672345,CSE 8A,A50,083650,Miranda; Gregory Joseph,17,1,56,39
1658124678377,CSE 11,A01,083080,Cao; Yingjun,7,15,40,33
1658124684407,CSE 12,A01,083652,Krause-Levy; Sophia Louisa,30,1,120,90
1658124690438,CSE 15L,A01,083654,Morris; Justin Loren,9,0,50,41
1658124690438,CSE 15L,A02,083655,Morris; Justin Loren,11,0,50,39
1658124696465,CSE 20,A01,083657,Tran; Khoa Dang,39,0,80,41
1658124702487,CSE 21,A01,095574,Bach; Quang Tran,23,0,48,25
1658124708514,CSE 30,A01,083084,Eldon; John,8,0,80,72
1658124708514,CSE 30,B01,095061,Bhaskar; Nishant,9,0,50,41
1658124714542,CSE 100,A01,083659,Cao; Yingjun,5,4,70,65
1658124720569,CSE 134B,A01,083661,Powell; Thomas Allan,25,0,100,75
1658124726592,CSE 140,A01,083663,Gungor; Onat,17,0,85,68
1658124732618,CSE 140L,A01,083088,Eldon; John,23,0,100,77
1658124738731,CSE 175,A01,083665,Kumar; Rakesh,3,0,25,22
1658124744756,CSE 190,A00,092507,Dubnov; Shlomo,8,0,20,12
1658124750783,ECE 45,A01,083139,Congero; Spencer William,7,0,75,68
1658124756811,ECE 65,A50,083695,Saad; Andrew S,12,0,30,18
1658124756811,ECE 65,A51,095125,Saad; Andrew S,24,0,26,2
1658124762834,ECE 109,A01,091882,Touri; Behrouz,21,0,70,49
1658124768860,ECE 180,A00,083140,Abi Samra; Nicholas Camill,1,0,30,29
1658124768860,ECE 180,B00,083141,Abi Samra; Nicholas Camill,0,0,30,30
1658124774887,MATH 10A,A01,083735,Patchell; Gregory David,2,0,30,28
1658124774887,MATH 10A,A02,083736,Patchell; Gregory David,20,0,30,10
1658124774887,MATH 10A,A03,083737,Patchell; Gregory David,16,0,30,14
1658124780910,MATH 10B,A01,083207,Lim; Seonhee,9,0,34,25
1658124780910,MATH 10B,A02,083208,Lim; Seonhee,10,0,35,25
1658124780910,MATH 10B,A03,093472,Lim; Seonhee,7,0,34,27
1658124780910,MATH 10B,B01,083739,Sinha; Shubham,14,0,30,16
1658124786934,MATH 18,A01,083743,Cinel; Cameron Alexander,9,0,30,21
1658124786934,MATH 18,A02,083744,Cinel; Cameron Alexander,18,0,30,12
1658124786934,MATH 18,A03,083745,Cinel; Cameron Alexander,10,0,30,20
1658124786934,MATH 18,B01,083748,Rideout; David Porter,5,0,37,32
1658124786934,MATH 18,B02,083749,Rideout; David Porter,5,0,36,31
1658124786934,MATH 18,B03,083750,Rideout; David Porter,3,0,37,34
1658124786934,MATH 18,B04,083751,Rideout; David Porter,7,0,36,29
1658124786934,MATH 18,B05,093473,Rideout; David Porter,7,0,36,29
1658124786934,MATH 18,B06,093474,Rideout; David Porter,6,0,36,30
1658124792957,MATH 20A,A01,083754,Zheng; Zequn,14,0,40,26
1658124798981,MATH 20B,A01,083756,Briones; Jor-el Thomas Caparas,4,0,36,32
1658124798981,MATH 20B,A02,083757,Briones; Jor-el Thomas Caparas,1,0,36,35
1658124798981,MATH 20B,A03,093475,Briones; Jor-el Thomas Caparas,3,0,36,33
1658124805005,MATH 20C,A01,083760,Briones; Jor-el Thomas Caparas,1,0,35,34
1658124805005,MATH 20C,A02,083761,Briones; Jor-el Thomas Caparas,8,0,35,27
1658124805005,MATH 20C,A03,093476,Briones; Jor-el Thomas Caparas,0,1,36,36
1658124805005,MATH 20C,B01,083762,Bach; Quang Tran,1,0,30,29
1658124811028,MATH 20D,A01,083765,Tran; Brian Kha,5,0,30,25
1658124811028,MATH 20D,A02,083766,Tran; Brian Kha,5,0,30,25
1658124811028,MATH 20D,A03,083767,Tran; Brian Kha,6,0,30,24
1658124817053,MATH 20E,A01,083771,Ganguly; Soumya,12,0,32,20
1658124817053,MATH 20E,A02,083772,Ganguly; Soumya,7,0,32,25
1658124817053,MATH 20E,B01,083773,Ciotti; Benjamin,20,0,35,15
1658124817053,MATH 20E,B02,083774,Ciotti; Benjamin,18,0,35,17
1658124823076,MATH 103A,A01,083777,Greenfeld; Be'Eri,6,0,36,30
1658124823076,MATH 103A,A02,083778,Greenfeld; Be'Eri,5,0,36,31
1658124823076,MATH 103A,A03,093561,Greenfeld; Be'Eri,7,0,36,29
1658124823076,MATH 103A,B01,083779,Greenfeld; Be'Eri,8,0,36,28
1658124823076,MATH 103A,B02,083780,Greenfeld; Be'Eri,4,0,36,32
1658124823076,MATH 103A,B03,093562,Greenfeld; Be'Eri,3,0,36,33
1658124829105,MATH 105,A01,085443,Carter; Anne Toulson,15,0,35,20
1658124829105,MATH 105,A02,093477,Carter; Anne Toulson,20,0,35,15
1658124835133,MATH 109,A01,083213,Ganzberger; Geoffrey Michael,3,0,34,31
1658124835133,MATH 109,A02,083214,Ganzberger; Geoffrey Michael,4,0,34,30
1658124835133,MATH 109,A03,093478,Ganzberger; Geoffrey Michael,2,0,34,32
1658124835133,MATH 109,B01,083215,Ganzberger; Geoffrey Michael,3,0,32,29
1658124835133,MATH 109,B02,083216,Ganzberger; Geoffrey Michael,3,0,32,29
1658124835133,MATH 109,B03,093479,Ganzberger; Geoffrey Michael,8,0,32,24
1658124841163,MATH 142A,A01,083219,Chow; Bennett,7,0,32,25
1658124841163,MATH 142A,A02,083220,Chow; Bennett,10,0,32,22
1658124841163,MATH 142A,A03,093480,Chow; Bennett,9,0,32,23
1658124841163,MATH 142A,B03,093481,Chow; Bennett,8,0,32,24
1658124841163,MATH 142A,B04,093558,Chow; Bennett,14,0,32,18
1658124841163,MATH 142A,B05,093559,Chow; Bennett,7,0,32,25
1658124847194,MATH 193A,A01,083224,Rotar; Vladimir,9,0,34,25
1658124847194,MATH 193A,A02,083225,Rotar; Vladimir,11,0,34,23
1658124847194,MATH 193A,A03,083781,Rotar; Vladimir,5,0,34,29
1658124847194,MATH 193A,A04,083782,Rotar; Vladimir,12,0,34,22
1658124847194,MATH 193A,A05,093482,Rotar; Vladimir,11,0,34,23
1658124853220,MATH 197,001,091859,McAuley; Julian John,9999,0,9999,0
1658124853220,MATH 197,002,095566,Kedlaya; Kiran S.,9997,0,9999,2
1658124853220,MATH 197,003,095567,Xiao; Ming,9999,0,9999,0
1658124853220,MATH 197,004,095571,Perols; Johan Lars,9998,0,9999,1
1658124860277,COGS 9,A01,083615,Shannon; Kyle Michael,11,0,75,64
1658124866301,COGS 11,A01,083617,Boyle; Mary E. T.,23,0,48,25
1658124872329,COGS 13,A01,083071,Bastos; Amalia Pinkusfeld,12,0,71,59
1658124878356,COGS 14A,A01,092681,Semenuks; Arturs,5,1,100,95
1658124884384,COGS 14B,A01,083073,Cheng; Tzu-Han,7,0,63,56
1658124890408,COGS 17,A01,092677,Semenuks; Arturs,7,0,81,74
1658124896431,COGS 100,A01,083619,Allen; Michael Gordon,17,0,70,53
1658124902456,COGS 101A,A01,083621,Davis; Joshua Daniel,9,0,68,59
1658124908479,COGS 101B,A01,091572,Allen; Michael Gordon,14,0,65,51
1658124914502,COGS 101C,A01,083625,Delgado; Tania,17,0,35,18
1658124920534,COGS 107A,A01,083627,Boyle; Mary E. T.,14,0,60,46
1658124926557,COGS 118A,A01,083075,Gupta; Anjum,21,0,76,55
1658124932585,CSE 3,A50,083646,Miranda; Gregory Joseph,24,0,50,26
1658124938617,CSE 8A,A50,083650,Miranda; Gregory Joseph,17,1,56,39
1658124944641,CSE 11,A01,083080,Cao; Yingjun,7,15,40,33
1658124950681,CSE 12,A01,083652,Krause-Levy; Sophia Louisa,30,1,120,90
1658124956705,CSE 15L,A01,083654,Morris; Justin Loren,9,0,50,41
1658124956705,CSE 15L,A02,083655,Morris; Justin Loren,11,0,50,39
1658124962739,CSE 20,A01,083657,Tran; Khoa Dang,39,0,80,41
1658124968760,CSE 21,A01,095574,Bach; Quang Tran,23,0,48,25
1658124974784,CSE 30,A01,083084,Eldon; John,8,0,80,72
1658124974784,CSE 30,B01,095061,Bhaskar; Nishant,9,0,50,41
1658124980807,CSE 100,A01,083659,Cao; Yingjun,5,4,70,65
1658124986830,CSE 134B,A01,083661,Powell; Thomas Allan,25,0,100,75
1658124992860,CSE 140,A01,083663,Gungor; Onat,17,0,85,68
1658124998886,CSE 140L,A01,083088,Eldon; John,23,0,100,77
1658125004913,CSE 175,A01,083665,Kumar; Rakesh,3,0,25,22
1658125010936,CSE 190,A00,092507,Dubnov; Shlomo,8,0,20,12
1658125016960,ECE 45,A01,083139,Congero; Spencer William,7,0,75,68
1658125022988,ECE 65,A50,083695,Saad; Andrew S,12,0,30,18
1658125022988,ECE 65,A51,095125,Saad; Andrew S,24,0,26,2
1658125029013,ECE 109,A01,091882,Touri; Behrouz,21,0,70,49
1658125035042,ECE 180,A00,083140,Abi Samra; Nicholas Camill,1,0,30,29
1658125035042,ECE 180,B00,083141,Abi Samra; Nicholas Camill,0,0,30,30
1658125041066,MATH 10A,A01,083735,Patchell; Gregory David,2,0,30,28
1658125041066,MATH 10A,A02,083736,Patchell; Gregory David,20,0,30,10
1658125041066,MATH 10A,A03,083737,Patchell; Gregory David,16,0,30,14
1658125047097,MATH 10B,A01,083207,Lim; Seonhee,9,0,34,25
1658125047097,MATH 10B,A02,083208,Lim; Seonhee,10,0,35,25
1658125047097,MATH 10B,A03,093472,Lim; Seonhee,7,0,34,27
1658125047097,MATH 10B,B01,083739,Sinha; Shubham,14,0,30,16
1658125053124,MATH 18,A01,083743,Cinel; Cameron Alexander,9,0,30,21
1658125053124,MATH 18,A02,083744,Cinel; Cameron Alexander,18,0,30,12
1658125053124,MATH 18,A03,083745,Cinel; Cameron Alexander,10,0,30,20
1658125053124,MATH 18,B01,083748,Rideout; David Porter,5,0,37,32
1658125053124,MATH 18,B02,083749,Rideout; David Porter,5,0,36,31
1658125053124,MATH 18,B03,083750,Rideout; David Porter,3,0,37,34
1658125053124,MATH 18,B04,083751,Rideout; David Porter,7,0,36,29
1658125053124,MATH 18,B05,093473,Rideout; David Porter,7,0,36,29
1658125053124,MATH 18,B06,093474,Rideout; David Porter,6,0,36,30
1658125059151,MATH 20A,A01,083754,Zheng; Zequn,14,0,40,26
1658125065179,MATH 20B,A01,083756,Briones; Jor-el Thomas Caparas,4,0,36,32
1658125065179,MATH 20B,A02,083757,Briones; Jor-el Thomas Caparas,1,0,36,35
1658125065179,MATH 20B,A03,093475,Briones; Jor-el Thomas Caparas,3,0,36,33
1658125071210,MATH 20C,A01,083760,Briones; Jor-el Thomas Caparas,1,0,35,34
1658125071210,MATH 20C,A02,083761,Briones; Jor-el Thomas Caparas,8,0,35,27
1658125071210,MATH 20C,A03,093476,Briones; Jor-el Thomas Caparas,0,1,36,36
1658125071210,MATH 20C,B01,083762,Bach; Quang Tran,1,0,30,29
1658125077234,MATH 20D,A01,083765,Tran; Brian Kha,5,0,30,25
1658125077234,MATH 20D,A02,083766,Tran; Brian Kha,5,0,30,25
1658125077234,MATH 20D,A03,083767,Tran; Brian Kha,6,0,30,24
1658125083259,MATH 20E,A01,083771,Ganguly; Soumya,12,0,32,20
1658125083259,MATH 20E,A02,083772,Ganguly; Soumya,7,0,32,25
1658125083259,MATH 20E,B01,083773,Ciotti; Benjamin,20,0,35,15
1658125083259,MATH 20E,B02,083774,Ciotti; Benjamin,18,0,35,17
1658125089285,MATH 103A,A01,083777,Greenfeld; Be'Eri,6,0,36,30
1658125089285,MATH 103A,A02,083778,Greenfeld; Be'Eri,5,0,36,31
1658125089285,MATH 103A,A03,093561,Greenfeld; Be'Eri,7,0,36,29
1658125089285,MATH 103A,B01,083779,Greenfeld; Be'Eri,8,0,36,28
1658125089285,MATH 103A,B02,083780,Greenfeld; Be'Eri,4,0,36,32
1658125089285,MATH 103A,B03,093562,Greenfeld; Be'Eri,3,0,36,33
1658125095313,MATH 105,A01,085443,Carter; Anne Toulson,15,0,35,20
1658125095313,MATH 105,A02,093477,Carter; Anne Toulson,20,0,35,15
1658125101341,MATH 109,A01,083213,Ganzberger; Geoffrey Michael,3,0,34,31
1658125101341,MATH 109,A02,083214,Ganzberger; Geoffrey Michael,4,0,34,30
1658125101341,MATH 109,A03,093478,Ganzberger; Geoffrey Michael,2,0,34,32
1658125101341,MATH 109,B01,083215,Ganzberger; Geoffrey Michael,3,0,32,29
1658125101341,MATH 109,B02,083216,Ganzberger; Geoffrey Michael,3,0,32,29
1658125101341,MATH 109,B03,093479,Ganzberger; Geoffrey Michael,8,0,32,24
1658125107371,MATH 142A,A01,083219,Chow; Bennett,7,0,32,25
1658125107371,MATH 142A,A02,083220,Chow; Bennett,10,0,32,22
1658125107371,MATH 142A,A03,093480,Chow; Bennett,9,0,32,23
1658125107371,MATH 142A,B03,093481,Chow; Bennett,8,0,32,24
1658125107371,MATH 142A,B04,093558,Chow; Bennett,14,0,32,18
1658125107371,MATH 142A,B05,093559,Chow; Bennett,7,0,32,25
1658125113404,MATH 193A,A01,083224,Rotar; Vladimir,9,0,34,25
1658125113404,MATH 193A,A02,083225,Rotar; Vladimir,11,0,34,23
1658125113404,MATH 193A,A03,083781,Rotar; Vladimir,5,0,34,29
1658125113404,MATH 193A,A04,083782,Rotar; Vladimir,12,0,34,22
1658125113404,MATH 193A,A05,093482,Rotar; Vladimir,11,0,34,23
1658125119430,MATH 197,001,091859,McAuley; Julian John,9999,0,9999,0
1658125119430,MATH 197,002,095566,Kedlaya; Kiran S.,9997,0,9999,2
1658125119430,MATH 197,003,095567,Xiao; Ming,9999,0,9999,0
1658125119430,MATH 197,004,095571,Perols; Johan Lars,9998,0,9999,1
1658125126494,COGS 9,A01,083615,Shannon; Kyle Michael,11,0,75,64
1658125132522,COGS 11,A01,083617,Boyle; Mary E. T.,23,0,48,25
1658125138554,COGS 13,A01,083071,Bastos; Amalia Pinkusfeld,12,0,71,59
1658125144581,COGS 14A,A01,092681,Semenuks; Arturs,5,1,100,95
1658125150608,COGS 14B,A01,083073,Cheng; Tzu-Han,7,0,63,56
1658125156635,COGS 17,A01,092677,Semenuks; Arturs,7,0,81,74
1658125162662,COGS 100,A01,083619,Allen; Michael Gordon,17,0,70,53
1658125168686,COGS 101A,A01,083621,Davis; Joshua Daniel,9,0,68,59
1658125174713,COGS 101B,A01,091572,Allen; Michael Gordon,14,0,65,51
1658125180750,COGS 101C,A01,083625,Delgado; Tania,17,0,35,18
1658125186771,COGS 107A,A01,083627,Boyle; Mary E. T.,14,0,60,46
1658125192802,COGS 118A,A01,083075,Gupta; Anjum,21,0,76,55
1658125198829,CSE 3,A50,083646,Miranda; Gregory Joseph,24,0,50,26
1658125204853,CSE 8A,A50,083650,Miranda; Gregory Joseph,17,1,56,39
1658125210886,CSE 11,A01,083080,Cao; Yingjun,7,15,40,33
1658125216909,CSE 12,A01,083652,Krause-Levy; Sophia Louisa,30,1,120,90
1658125222934,CSE 15L,A01,083654,Morris; Justin Loren,9,0,50,41
1658125222934,CSE 15L,A02,083655,Morris; Justin Loren,11,0,50,39
1658125228961,CSE 20,A01,083657,Tran; Khoa Dang,39,0,80,41
1658125234987,CSE 21,A01,095574,Bach; Quang Tran,23,0,48,25
1658125241010,CSE 30,A01,083084,Eldon; John,8,0,80,72
1658125241010,CSE 30,B01,095061,Bhaskar; Nishant,9,0,50,41
1658125247039,CSE 100,A01,083659,Cao; Yingjun,5,4,70,65
1658125253061,CSE 134B,A01,083661,Powell; Thomas Allan,25,0,100,75
1658125259089,CSE 140,A01,083663,Gungor; Onat,17,0,85,68
1658125265122,CSE 140L,A01,083088,Eldon; John,23,0,100,77
1658125271145,CSE 175,A01,083665,Kumar; Rakesh,3,0,25,22
1658125277173,CSE 190,A00,092507,Dubnov; Shlomo,8,0,20,12
1658125283204,ECE 45,A01,083139,Congero; Spencer William,7,0,75,68
1658125289228,ECE 65,A50,083695,Saad; Andrew S,12,0,30,18
1658125289228,ECE 65,A51,095125,Saad; Andrew S,24,0,26,2
1658125295250,ECE 109,A01,091882,Touri; Behrouz,21,0,70,49
1658125301272,ECE 180,A00,083140,Abi Samra; Nicholas Camill,1,0,30,29
1658125301272,ECE 180,B00,083141,Abi Samra; Nicholas Camill,0,0,30,30
1658125307295,MATH 10A,A01,083735,Patchell; Gregory David,2,0,30,28
1658125307295,MATH 10A,A02,083736,Patchell; Gregory David,20,0,30,10
1658125307295,MATH 10A,A03,083737,Patchell; Gregory David,16,0,30,14
1658125313318,MATH 10B,A01,083207,Lim; Seonhee,9,0,34,25
1658125313318,MATH 10B,A02,083208,Lim; Seonhee,10,0,35,25
1658125313318,MATH 10B,A03,093472,Lim; Seonhee,7,0,34,27
1658125313318,MATH 10B,B01,083739,Sinha; Shubham,14,0,30,16
1658125319349,MATH 18,A01,083743,Cinel; Cameron Alexander,9,0,30,21
1658125319349,MATH 18,A02,083744,Cinel; Cameron Alexander,18,0,30,12
1658125319349,MATH 18,A03,083745,Cinel; Cameron Alexander,10,0,30,20
1658125319349,MATH 18,B01,083748,Rideout; David Porter,5,0,37,32
1658125319349,MATH 18,B02,083749,Rideout; David Porter,5,0,36,31
1658125319349,MATH 18,B03,083750,Rideout; David Porter,3,0,37,34
1658125319349,MATH 18,B04,083751,Rideout; David Porter,7,0,36,29
1658125319349,MATH 18,B05,093473,Rideout; David Porter,7,0,36,29
1658125319349,MATH 18,B06,093474,Rideout; David Porter,6,0,36,30
1658125325386,MATH 20A,A01,083754,Zheng; Zequn,14,0,40,26
1658125331410,MATH 20B,A01,083756,Briones; Jor-el Thomas Caparas,4,0,36,32
1658125331410,MATH 20B,A02,083757,Briones; Jor-el Thomas Caparas,1,0,36,35
1658125331410,MATH 20B,A03,093475,Briones; Jor-el Thomas Caparas,3,0,36,33
1658125337526,MATH 20C,A01,083760,Briones; Jor-el Thomas Caparas,1,0,35,34
1658125337526,MATH 20C,A02,083761,Briones; Jor-el Thomas Caparas,8,0,35,27
1658125337526,MATH 20C,A03,093476,Briones; Jor-el Thomas Caparas,0,1,36,36
1658125337526,MATH 20C,B01,083762,Bach; Quang Tran,1,0,30,29
1658125343549,MATH 20D,A01,083765,Tran; Brian Kha,5,0,30,25
1658125343549,MATH 20D,A02,083766,Tran; Brian Kha,5,0,30,25
1658125343549,MATH 20D,A03,083767,Tran; Brian Kha,6,0,30,24
1658125349573,MATH 20E,A01,083771,Ganguly; Soumya,12,0,32,20
1658125349573,MATH 20E,A02,083772,Ganguly; Soumya,7,0,32,25
1658125349573,MATH 20E,B01,083773,Ciotti; Benjamin,20,0,35,15
1658125349573,MATH 20E,B02,083774,Ciotti; Benjamin,18,0,35,17
1658125355597,MATH 103A,A01,083777,Greenfeld; Be'Eri,6,0,36,30
1658125355597,MATH 103A,A02,083778,Greenfeld; Be'Eri,5,0,36,31
1658125355597,MATH 103A,A03,093561,Greenfeld; Be'Eri,7,0,36,29
1658125355597,MATH 103A,B01,083779,Greenfeld; Be'Eri,8,0,36,28
1658125355597,MATH 103A,B02,083780,Greenfeld; Be'Eri,4,0,36,32
1658125355597,MATH 103A,B03,093562,Greenfeld; Be'Eri,3,0,36,33
1658125361620,MATH 105,A01,085443,Carter; Anne Toulson,15,0,35,20
1658125361620,MATH 105,A02,093477,Carter; Anne Toulson,20,0,35,15
1658125367649,MATH 109,A01,083213,Ganzberger; Geoffrey Michael,3,0,34,31
1658125367649,MATH 109,A02,083214,Ganzberger; Geoffrey Michael,4,0,34,30
1658125367649,MATH 109,A03,093478,Ganzberger; Geoffrey Michael,2,0,34,32
1658125367649,MATH 109,B01,083215,Ganzberger; Geoffrey Michael,3,0,32,29
1658125367649,MATH 109,B02,083216,Ganzberger; Geoffrey Michael,3,0,32,29
1658125367649,MATH 109,B03,093479,Ganzberger; Geoffrey Michael,8,0,32,24
1658125373679,MATH 142A,A01,083219,Chow; Bennett,7,0,32,25
1658125373679,MATH 142A,A02,083220,Chow; Bennett,10,0,32,22
1658125373679,MATH 142A,A03,093480,Chow; Bennett,9,0,32,23
1658125373679,MATH 142A,B03,093481,Chow; Bennett,8,0,32,24
1658125373679,MATH 142A,B04,093558,Chow; Bennett,14,0,32,18
1658125373679,MATH 142A,B05,093559,Chow; Bennett,7,0,32,25
1658125379703,MATH 193A,A01,083224,Rotar; Vladimir,9,0,34,25
1658125379703,MATH 193A,A02,083225,Rotar; Vladimir,11,0,34,23
1658125379703,MATH 193A,A03,083781,Rotar; Vladimir,5,0,34,29
1658125379703,MATH 193A,A04,083782,Rotar; Vladimir,12,0,34,22
1658125379703,MATH 193A,A05,093482,Rotar; Vladimir,11,0,34,23
1658125385729,MATH 197,001,091859,McAuley; Julian John,9999,0,9999,0
1658125385729,MATH 197,002,095566,Kedlaya; Kiran S.,9997,0,9999,2
1658125385729,MATH 197,003,095567,Xiao; Ming,9999,0,9999,0
1658125385729,MATH 197,004,095571,Perols; Johan Lars,9998,0,9999,1
1658125392814,COGS 9,A01,083615,Shannon; Kyle Michael,11,0,75,64
1658125398841,COGS 11,A01,083617,Boyle; Mary E. T.,23,0,48,25
1658125404864,COGS 13,A01,083071,Bastos; Amalia Pinkusfeld,12,0,71,59
1658125410890,COGS 14A,A01,092681,Semenuks; Arturs,5,1,100,95
1658125416917,COGS 14B,A01,083073,Cheng; Tzu-Han,7,0,63,56
1658125422941,COGS 17,A01,092677,Semenuks; Arturs,7,0,81,74
1658125428965,COGS 100,A01,083619,Allen; Michael Gordon,17,0,70,53
1658125434990,COGS 101A,A01,083621,Davis; Joshua Daniel,9,0,68,59
1658125441013,COGS 101B,A01,091572,Allen; Michael Gordon,14,0,65,51
1658125447039,COGS 101C,A01,083625,Delgado; Tania,17,0,35,18
1658125453062,COGS 107A,A01,083627,Boyle; Mary E. T.,14,0,60,46
1658125459089,COGS 118A,A01,083075,Gupta; Anjum,21,0,76,55
1658125465113,CSE 3,A50,083646,Miranda; Gregory Joseph,24,0,50,26
1658125471141,CSE 8A,A50,083650,Miranda; Gregory Joseph,17,1,56,39
1658125477164,CSE 11,A01,083080,Cao; Yingjun,7,15,40,33
1658125483187,CSE 12,A01,083652,Krause-Levy; Sophia Louisa,30,1,120,90
1658125489219,CSE 15L,A01,083654,Morris; Justin Loren,9,0,50,41
1658125489219,CSE 15L,A02,083655,Morris; Justin Loren,11,0,50,39
1658125495246,CSE 20,A01,083657,Tran; Khoa Dang,39,0,80,41
1658125501272,CSE 21,A01,095574,Bach; Quang Tran,23,0,48,25
1658125507297,CSE 30,A01,083084,Eldon; John,8,0,80,72
1658125507297,CSE 30,B01,095061,Bhaskar; Nishant,9,0,50,41
1658125513328,CSE 100,A01,083659,Cao; Yingjun,5,4,70,65
1658125519356,CSE 134B,A01,083661,Powell; Thomas Allan,25,0,100,75
1658125525379,CSE 140,A01,083663,Gungor; Onat,17,0,85,68
1658125531411,CSE 140L,A01,083088,Eldon; John,23,0,100,77
1658125537436,CSE 175,A01,083665,Kumar; Rakesh,3,0,25,22
1658125543463,CSE 190,A00,092507,Dubnov; Shlomo,8,0,20,12
1658125549501,ECE 45,A01,083139,Congero; Spencer William,7,0,75,68
1658125555543,ECE 65,A50,083695,Saad; Andrew S,12,0,30,18
1658125555543,ECE 65,A51,095125,Saad; Andrew S,24,0,26,2
1658125561573,ECE 109,A01,091882,Touri; Behrouz,21,0,70,49
1658125567609,ECE 180,A00,083140,Abi Samra; Nicholas Camill,1,0,30,29
1658125567609,ECE 180,B00,083141,Abi Samra; Nicholas Camill,0,0,30,30
1658125573636,MATH 10A,A01,083735,Patchell; Gregory David,2,0,30,28
1658125573636,MATH 10A,A02,083736,Patchell; Gregory David,20,0,30,10
1658125573636,MATH 10A,A03,083737,Patchell; Gregory David,16,0,30,14
1658125579660,MATH 10B,A01,083207,Lim; Seonhee,9,0,34,25
1658125579660,MATH 10B,A02,083208,Lim; Seonhee,10,0,35,25
1658125579660,MATH 10B,A03,093472,Lim; Seonhee,7,0,34,27
1658125579660,MATH 10B,B01,083739,Sinha; Shubham,14,0,30,16
1658125585692,MATH 18,A01,083743,Cinel; Cameron Alexander,9,0,30,21
1658125585692,MATH 18,A02,083744,Cinel; Cameron Alexander,18,0,30,12
1658125585692,MATH 18,A03,083745,Cinel; Cameron Alexander,10,0,30,20
1658125585692,MATH 18,B01,083748,Rideout; David Porter,5,0,37,32
1658125585692,MATH 18,B02,083749,Rideout; David Porter,5,0,36,31
1658125585692,MATH 18,B03,083750,Rideout; David Porter,3,0,37,34
1658125585692,MATH 18,B04,083751,Rideout; David Porter,7,0,36,29
1658125585692,MATH 18,B05,093473,Rideout; David Porter,7,0,36,29
1658125585692,MATH 18,B06,093474,Rideout; David Porter,6,0,36,30
1658125591721,MATH 20A,A01,083754,Zheng; Zequn,14,0,40,26
1658125597744,MATH 20B,A01,083756,Briones; Jor-el Thomas Caparas,4,0,36,32
1658125597744,MATH 20B,A02,083757,Briones; Jor-el Thomas Caparas,1,0,36,35
1658125597744,MATH 20B,A03,093475,Briones; Jor-el Thomas Caparas,3,0,36,33
1658125603769,MATH 20C,A01,083760,Briones; Jor-el Thomas Caparas,1,0,35,34
1658125603769,MATH 20C,A02,083761,Briones; Jor-el Thomas Caparas,8,0,35,27
1658125603769,MATH 20C,A03,093476,Briones; Jor-el Thomas Caparas,0,1,36,36
1658125603769,MATH 20C,B01,083762,Bach; Quang Tran,1,0,30,29
1658125609794,MATH 20D,A01,083765,Tran; Brian Kha,5,0,30,25
1658125609794,MATH 20D,A02,083766,Tran; Brian Kha,5,0,30,25
1658125609794,MATH 20D,A03,083767,Tran; Brian Kha,6,0,30,24
1658125615818,MATH 20E,A01,083771,Ganguly; Soumya,12,0,32,20
1658125615818,MATH 20E,A02,083772,Ganguly; Soumya,7,0,32,25
1658125615818,MATH 20E,B01,083773,Ciotti; Benjamin,20,0,35,15
1658125615818,MATH 20E,B02,083774,Ciotti; Benjamin,18,0,35,17
1658125621850,MATH 103A,A01,083777,Greenfeld; Be'Eri,6,0,36,30
1658125621850,MATH 103A,A02,083778,Greenfeld; Be'Eri,5,0,36,31
1658125621850,MATH 103A,A03,093561,Greenfeld; Be'Eri,7,0,36,29
1658125621850,MATH 103A,B01,083779,Greenfeld; Be'Eri,8,0,36,28
1658125621850,MATH 103A,B02,083780,Greenfeld; Be'Eri,4,0,36,32
1658125621850,MATH 103A,B03,093562,Greenfeld; Be'Eri,3,0,36,33
1658125627881,MATH 105,A01,085443,Carter; Anne Toulson,15,0,35,20
1658125627881,MATH 105,A02,093477,Carter; Anne Toulson,20,0,35,15
1658125633904,MATH 109,A01,083213,Ganzberger; Geoffrey Michael,3,0,34,31
1658125633904,MATH 109,A02,083214,Ganzberger; Geoffrey Michael,4,0,34,30
1658125633904,MATH 109,A03,093478,Ganzberger; Geoffrey Michael,2,0,34,32
1658125633904,MATH 109,B01,083215,Ganzberger; Geoffrey Michael,3,0,32,29
1658125633904,MATH 109,B02,083216,Ganzberger; Geoffrey Michael,3,0,32,29
1658125633904,MATH 109,B03,093479,Ganzberger; Geoffrey Michael,8,0,32,24
1658125639935,MATH 142A,A01,083219,Chow; Bennett,7,0,32,25
1658125639935,MATH 142A,A02,083220,Chow; Bennett,10,0,32,22
1658125639935,MATH 142A,A03,093480,Chow; Bennett,9,0,32,23
1658125639935,MATH 142A,B03,093481,Chow; Bennett,8,0,32,24
1658125639935,MATH 142A,B04,093558,Chow; Bennett,14,0,32,18
1658125639935,MATH 142A,B05,093559,Chow; Bennett,7,0,32,25
1658125645959,MATH 193A,A01,083224,Rotar; Vladimir,9,0,34,25
1658125645959,MATH 193A,A02,083225,Rotar; Vladimir,11,0,34,23
1658125645959,MATH 193A,A03,083781,Rotar; Vladimir,5,0,34,29
1658125645959,MATH 193A,A04,083782,Rotar; Vladimir,12,0,34,22
1658125645959,MATH 193A,A05,093482,Rotar; Vladimir,11,0,34,23
1658125651989,MATH 197,001,091859,McAuley; Julian John,9999,0,9999,0
1658125651989,MATH 197,002,095566,Kedlaya; Kiran S.,9997,0,9999,2
1658125651989,MATH 197,003,095567,Xiao; Ming,9999,0,9999,0
1658125651989,MATH 197,004,095571,Perols; Johan Lars,9998,0,9999,1
1658125659045,COGS 9,A01,083615,Shannon; Kyle Michael,11,0,75,64
1658125665068,COGS 11,A01,083617,Boyle; Mary E. T.,23,0,48,25
1658125671094,COGS 13,A01,083071,Bastos; Amalia Pinkusfeld,12,0,71,59
1658125677118,COGS 14A,A01,092681,Semenuks; Arturs,5,1,100,95
1658125683145,COGS 14B,A01,083073,Cheng; Tzu-Han,7,0,63,56
1658125689169,COGS 17,A01,092677,Semenuks; Arturs,7,0,81,74
1658125695192,COGS 100,A01,083619,Allen; Michael Gordon,17,0,70,53
1658125701215,COGS 101A,A01,083621,Davis; Joshua Daniel,9,0,68,59
1658125707241,COGS 101B,A01,091572,Allen; Michael Gordon,14,0,65,51
1658125713264,COGS 101C,A01,083625,Delgado; Tania,17,0,35,18
1658125719287,COGS 107A,A01,083627,Boyle; Mary E. T.,14,0,60,46
1658125725310,COGS 118A,A01,083075,Gupta; Anjum,21,0,76,55
1658125731335,CSE 3,A50,083646,Miranda; Gregory Joseph,24,0,50,26
1658125737359,CSE 8A,A50,083650,Miranda; Gregory Joseph,17,1,56,39
1658125743386,CSE 11,A01,083080,Cao; Yingjun,7,15,40,33
1658125749412,CSE 12,A01,083652,Krause-Levy; Sophia Louisa,30,1,120,90
1658125755435,CSE 15L,A01,083654,Morris; Justin Loren,9,0,50,41
1658125755435,CSE 15L,A02,083655,Morris; Justin Loren,11,0,50,39
1658125761463,CSE 20,A01,083657,Tran; Khoa Dang,39,0,80,41
1658125767487,CSE 21,A01,095574,Bach; Quang Tran,23,0,48,25
1658125773512,CSE 30,A01,083084,Eldon; John,8,0,80,72
1658125773512,CSE 30,B01,095061,Bhaskar; Nishant,9,0,50,41
1658125779536,CSE 100,A01,083659,Cao; Yingjun,5,4,70,65
1658125785571,CSE 134B,A01,083661,Powell; Thomas Allan,25,0,100,75
1658125791599,CSE 140,A01,083663,Gungor; Onat,17,0,85,68
1658125797622,CSE 140L,A01,083088,Eldon; John,23,0,100,77
1658125803665,CSE 175,A01,083665,Kumar; Rakesh,3,0,25,22
1658125809689,CSE 190,A00,092507,Dubnov; Shlomo,8,0,20,12
1658125815711,ECE 45,A01,083139,Congero; Spencer William,7,0,75,68
1658125821740,ECE 65,A50,083695,Saad; Andrew S,12,0,30,18
1658125821740,ECE 65,A51,095125,Saad; Andrew S,24,0,26,2
1658125827766,ECE 109,A01,091882,Touri; Behrouz,21,0,70,49
1658125833789,ECE 180,A00,083140,Abi Samra; Nicholas Camill,1,0,30,29
1658125833789,ECE 180,B00,083141,Abi Samra; Nicholas Camill,0,0,30,30
1658125839827,MATH 10A,A01,083735,Patchell; Gregory David,2,0,30,28
1658125839827,MATH 10A,A02,083736,Patchell; Gregory David,20,0,30,10
1658125839827,MATH 10A,A03,083737,Patchell; Gregory David,16,0,30,14
1658125845852,MATH 10B,A01,083207,Lim; Seonhee,9,0,34,25
1658125845852,MATH 10B,A02,083208,Lim; Seonhee,10,0,35,25
1658125845852,MATH 10B,A03,093472,Lim; Seonhee,7,0,34,27
1658125845852,MATH 10B,B01,083739,Sinha; Shubham,14,0,30,16
1658125851884,MATH 18,A01,083743,Cinel; Cameron Alexander,9,0,30,21
1658125851884,MATH 18,A02,083744,Cinel; Cameron Alexander,18,0,30,12
1658125851884,MATH 18,A03,083745,Cinel; Cameron Alexander,10,0,30,20
1658125851884,MATH 18,B01,083748,Rideout; David Porter,5,0,37,32
1658125851884,MATH 18,B02,083749,Rideout; David Porter,5,0,36,31
1658125851884,MATH 18,B03,083750,Rideout; David Porter,3,0,37,34
1658125851884,MATH 18,B04,083751,Rideout; David Porter,7,0,36,29
1658125851884,MATH 18,B05,093473,Rideout; David Porter,7,0,36,29
1658125851884,MATH 18,B06,093474,Rideout; David Porter,6,0,36,30
1658125857910,MATH 20A,A01,083754,Zheng; Zequn,14,0,40,26
1658125863934,MATH 20B,A01,083756,Briones; Jor-el Thomas Caparas,4,0,36,32
1658125863934,MATH 20B,A02,083757,Briones; Jor-el Thomas Caparas,1,0,36,35
1658125863934,MATH 20B,A03,093475,Briones; Jor-el Thomas Caparas,3,0,36,33
1658125869960,MATH 20C,A01,083760,Briones; Jor-el Thomas Caparas,1,0,35,34
1658125869960,MATH 20C,A02,083761,Briones; Jor-el Thomas Caparas,8,0,35,27
1658125869960,MATH 20C,A03,093476,Briones; Jor-el Thomas Caparas,0,1,36,36
1658125869960,MATH 20C,B01,083762,Bach; Quang Tran,1,0,30,29
1658125875983,MATH 20D,A01,083765,Tran; Brian Kha,5,0,30,25
1658125875983,MATH 20D,A02,083766,Tran; Brian Kha,5,0,30,25
1658125875983,MATH 20D,A03,083767,Tran; Brian Kha,6,0,30,24
1658125882009,MATH 20E,A01,083771,Ganguly; Soumya,12,0,32,20
1658125882009,MATH 20E,A02,083772,Ganguly; Soumya,7,0,32,25
1658125882009,MATH 20E,B01,083773,Ciotti; Benjamin,20,0,35,15
1658125882009,MATH 20E,B02,083774,Ciotti; Benjamin,18,0,35,17
1658125888034,MATH 103A,A01,083777,Greenfeld; Be'Eri,6,0,36,30
1658125888034,MATH 103A,A02,083778,Greenfeld; Be'Eri,5,0,36,31
1658125888034,MATH 103A,A03,093561,Greenfeld; Be'Eri,7,0,36,29
1658125888034,MATH 103A,B01,083779,Greenfeld; Be'Eri,8,0,36,28
1658125888034,MATH 103A,B02,083780,Greenfeld; Be'Eri,4,0,36,32
1658125888034,MATH 103A,B03,093562,Greenfeld; Be'Eri,3,0,36,33
1658125894061,MATH 105,A01,085443,Carter; Anne Toulson,15,0,35,20
1658125894061,MATH 105,A02,093477,Carter; Anne Toulson,20,0,35,15
1658125900090,MATH 109,A01,083213,Ganzberger; Geoffrey Michael,3,0,34,31
1658125900090,MATH 109,A02,083214,Ganzberger; Geoffrey Michael,4,0,34,30
1658125900090,MATH 109,A03,093478,Ganzberger; Geoffrey Michael,2,0,34,32
1658125900090,MATH 109,B01,083215,Ganzberger; Geoffrey Michael,3,0,32,29
1658125900090,MATH 109,B02,083216,Ganzberger; Geoffrey Michael,3,0,32,29
1658125900090,MATH 109,B03,093479,Ganzberger; Geoffrey Michael,8,0,32,24
1658125906114,MATH 142A,A01,083219,Chow; Bennett,7,0,32,25
1658125906114,MATH 142A,A02,083220,Chow; Bennett,10,0,32,22
1658125906114,MATH 142A,A03,093480,Chow; Bennett,9,0,32,23
1658125906114,MATH 142A,B03,093481,Chow; Bennett,8,0,32,24
1658125906114,MATH 142A,B04,093558,Chow; Bennett,14,0,32,18
1658125906114,MATH 142A,B05,093559,Chow; Bennett,7,0,32,25
1658125912142,MATH 193A,A01,083224,Rotar; Vladimir,9,0,34,25
1658125912142,MATH 193A,A02,083225,Rotar; Vladimir,11,0,34,23
1658125912142,MATH 193A,A03,083781,Rotar; Vladimir,5,0,34,29
1658125912142,MATH 193A,A04,083782,Rotar; Vladimir,12,0,34,22
1658125912142,MATH 193A,A05,093482,Rotar; Vladimir,11,0,34,23
1658125918165,MATH 197,001,091859,McAuley; Julian John,9999,0,9999,0
1658125918165,MATH 197,002,095566,Kedlaya; Kiran S.,9997,0,9999,2
1658125918165,MATH 197,003,095567,Xiao; Ming,9999,0,9999,0
1658125918165,MATH 197,004,095571,Perols; Johan Lars,9998,0,9999,1
1658125925224,COGS 9,A01,083615,Shannon; Kyle Michael,11,0,75,64
1658125931343,COGS 11,A01,083617,Boyle; Mary E. T.,23,0,48,25
1658125937366,COGS 13,A01,083071,Bastos; Amalia Pinkusfeld,12,0,71,59
1658125943390,COGS 14A,A01,092681,Semenuks; Arturs,5,1,100,95
1658125949413,COGS 14B,A01,083073,Cheng; Tzu-Han,7,0,63,56
1658125955436,COGS 17,A01,092677,Semenuks; Arturs,7,0,81,74
1658125961463,COGS 100,A01,083619,Allen; Michael Gordon,17,0,70,53
1658125967490,COGS 101A,A01,083621,Davis; Joshua Daniel,9,0,68,59
1658125973513,COGS 101B,A01,091572,Allen; Michael Gordon,14,0,65,51
1658125979539,COGS 101C,A01,083625,Delgado; Tania,17,0,35,18
1658125985566,COGS 107A,A01,083627,Boyle; Mary E. T.,14,0,60,46
1658125991589,COGS 118A,A01,083075,Gupta; Anjum,21,0,76,55
1658125997612,CSE 3,A50,083646,Miranda; Gregory Joseph,24,0,50,26
1658126003640,CSE 8A,A50,083650,Miranda; Gregory Joseph,17,1,56,39
1658126009666,CSE 11,A01,083080,Cao; Yingjun,7,15,40,33
1658126015692,CSE 12,A01,083652,Krause-Levy; Sophia Louisa,30,1,120,90
1658126021715,CSE 15L,A01,083654,Morris; Justin Loren,9,0,50,41
1658126021715,CSE 15L,A02,083655,Morris; Justin Loren,11,0,50,39
1658126027741,CSE 20,A01,083657,Tran; Khoa Dang,39,0,80,41
1658126033768,CSE 21,A01,095574,Bach; Quang Tran,23,0,48,25
1658126039792,CSE 30,A01,083084,Eldon; John,8,0,80,72
1658126039792,CSE 30,B01,095061,Bhaskar; Nishant,9,0,50,41
1658126045816,CSE 100,A01,083659,Cao; Yingjun,5,4,70,65
1658126051849,CSE 134B,A01,083661,Powell; Thomas Allan,25,0,100,75
1658126057877,CSE 140,A01,083663,Gungor; Onat,17,0,85,68
1658126063902,CSE 140L,A01,083088,Eldon; John,23,0,100,77
1658126069931,CSE 175,A01,083665,Kumar; Rakesh,3,0,25,22
1658126075954,CSE 190,A00,092507,Dubnov; Shlomo,8,0,20,12
1658126081977,ECE 45,A01,083139,Congero; Spencer William,7,0,75,68
1658126088004,ECE 65,A50,083695,Saad; Andrew S,12,0,30,18
1658126088004,ECE 65,A51,095125,Saad; Andrew S,24,0,26,2
1658126094028,ECE 109,A01,091882,Touri; Behrouz,21,0,70,49
1658126100050,ECE 180,A00,083140,Abi Samra; Nicholas Camill,1,0,30,29
1658126100050,ECE 180,B00,083141,Abi Samra; Nicholas Camill,0,0,30,30
1658126106078,MATH 10A,A01,083735,Patchell; Gregory David,2,0,30,28
1658126106078,MATH 10A,A02,083736,Patchell; Gregory David,20,0,30,10
1658126106078,MATH 10A,A03,083737,Patchell; Gregory David,16,0,30,14
1658126112104,MATH 10B,A01,083207,Lim; Seonhee,9,0,34,25
1658126112104,MATH 10B,A02,083208,Lim; Seonhee,10,0,35,25
1658126112104,MATH 10B,A03,093472,Lim; Seonhee,7,0,34,27
1658126112104,MATH 10B,B01,083739,Sinha; Shubham,14,0,30,16
1658126118134,MATH 18,A01,083743,Cinel; Cameron Alexander,9,0,30,21
1658126118134,MATH 18,A02,083744,Cinel; Cameron Alexander,18,0,30,12
1658126118134,MATH 18,A03,083745,Cinel; Cameron Alexander,10,0,30,20
1658126118134,MATH 18,B01,083748,Rideout; David Porter,5,0,37,32
1658126118134,MATH 18,B02,083749,Rideout; David Porter,5,0,36,31
1658126118134,MATH 18,B03,083750,Rideout; David Porter,3,0,37,34
1658126118134,MATH 18,B04,083751,Rideout; David Porter,7,0,36,29
1658126118134,MATH 18,B05,093473,Rideout; David Porter,7,0,36,29
1658126118134,MATH 18,B06,093474,Rideout; David Porter,6,0,36,30
1658126124157,MATH 20A,A01,083754,Zheng; Zequn,14,0,40,26
1658126130183,MATH 20B,A01,083756,Briones; Jor-el Thomas Caparas,4,0,36,32
1658126130183,MATH 20B,A02,083757,Briones; Jor-el Thomas Caparas,1,0,36,35
1658126130183,MATH 20B,A03,093475,Briones; Jor-el Thomas Caparas,3,0,36,33
1658126136213,MATH 20C,A01,083760,Briones; Jor-el Thomas Caparas,1,0,35,34
1658126136213,MATH 20C,A02,083761,Briones; Jor-el Thomas Caparas,8,0,35,27
1658126136213,MATH 20C,A03,093476,Briones; Jor-el Thomas Caparas,0,1,36,36
1658126136213,MATH 20C,B01,083762,Bach; Quang Tran,1,0,30,29
1658126142241,MATH 20D,A01,083765,Tran; Brian Kha,5,0,30,25
1658126142241,MATH 20D,A02,083766,Tran; Brian Kha,5,0,30,25
1658126142241,MATH 20D,A03,083767,Tran; Brian Kha,6,0,30,24
1658126148266,MATH 20E,A01,083771,Ganguly; Soumya,12,0,32,20
1658126148266,MATH 20E,A02,083772,Ganguly; Soumya,7,0,32,25
1658126148266,MATH 20E,B01,083773,Ciotti; Benjamin,20,0,35,15
1658126148266,MATH 20E,B02,083774,Ciotti; Benjamin,18,0,35,17
1658126154290,MATH 103A,A01,083777,Greenfeld; Be'Eri,6,0,36,30
1658126154290,MATH 103A,A02,083778,Greenfeld; Be'Eri,5,0,36,31
1658126154290,MATH 103A,A03,093561,Greenfeld; Be'Eri,7,0,36,29
1658126154290,MATH 103A,B01,083779,Greenfeld; Be'Eri,8,0,36,28
1658126154290,MATH 103A,B02,083780,Greenfeld; Be'Eri,4,0,36,32
1658126154290,MATH 103A,B03,093562,Greenfeld; Be'Eri,3,0,36,33
1658126160317,MATH 105,A01,085443,Carter; Anne Toulson,15,0,35,20
1658126160317,MATH 105,A02,093477,Carter; Anne Toulson,20,0,35,15
1658126166348,MATH 109,A01,083213,Ganzberger; Geoffrey Michael,3,0,34,31
1658126166348,MATH 109,A02,083214,Ganzberger; Geoffrey Michael,4,0,34,30
1658126166348,MATH 109,A03,093478,Ganzberger; Geoffrey Michael,2,0,34,32
1658126166348,MATH 109,B01,083215,Ganzberger; Geoffrey Michael,3,0,32,29
1658126166348,MATH 109,B02,083216,Ganzberger; Geoffrey Michael,3,0,32,29
1658126166348,MATH 109,B03,093479,Ganzberger; Geoffrey Michael,8,0,32,24
1658126172372,MATH 142A,A01,083219,Chow; Bennett,7,0,32,25
1658126172372,MATH 142A,A02,083220,Chow; Bennett,10,0,32,22
1658126172372,MATH 142A,A03,093480,Chow; Bennett,9,0,32,23
1658126172372,MATH 142A,B03,093481,Chow; Bennett,8,0,32,24
1658126172372,MATH 142A,B04,093558,Chow; Bennett,14,0,32,18
1658126172372,MATH 142A,B05,093559,Chow; Bennett,7,0,32,25
1658126178401,MATH 193A,A01,083224,Rotar; Vladimir,9,0,34,25
1658126178401,MATH 193A,A02,083225,Rotar; Vladimir,11,0,34,23
1658126178401,MATH 193A,A03,083781,Rotar; Vladimir,5,0,34,29
1658126178401,MATH 193A,A04,083782,Rotar; Vladimir,12,0,34,22
1658126178401,MATH 193A,A05,093482,Rotar; Vladimir,11,0,34,23
1658126184428,MATH 197,001,091859,McAuley; Julian John,9999,0,9999,0
1658126184428,MATH 197,002,095566,Kedlaya; Kiran S.,9997,0,9999,2
1658126184428,MATH 197,003,095567,Xiao; Ming,9999,0,9999,0
1658126184428,MATH 197,004,095571,Perols; Johan Lars,9998,0,9999,1
1658126191492,COGS 9,A01,083615,Shannon; Kyle Michael,11,0,75,64
1658126197516,COGS 11,A01,083617,Boyle; Mary E. T.,23,0,48,25
1658126203539,COGS 13,A01,083071,Bastos; Amalia Pinkusfeld,12,0,71,59
1658126209562,COGS 14A,A01,092681,Semenuks; Arturs,5,1,100,95
1658126215590,COGS 14B,A01,083073,Cheng; Tzu-Han,7,0,63,56
1658126221612,COGS 17,A01,092677,Semenuks; Arturs,7,0,81,74
1658126227640,COGS 100,A01,083619,Allen; Michael Gordon,17,0,70,53
1658126233667,COGS 101A,A01,083621,Davis; Joshua Daniel,9,0,68,59
1658126239693,COGS 101B,A01,091572,Allen; Michael Gordon,14,0,65,51
1658126245724,COGS 101C,A01,083625,Delgado; Tania,17,0,35,18
1658126251751,COGS 107A,A01,083627,Boyle; Mary E. T.,14,0,60,46
1658126257773,COGS 118A,A01,083075,Gupta; Anjum,21,0,76,55
1658126263797,CSE 3,A50,083646,Miranda; Gregory Joseph,24,0,50,26
1658126269820,CSE 8A,A50,083650,Miranda; Gregory Joseph,17,1,56,39
1658126275842,CSE 11,A01,083080,Cao; Yingjun,7,15,40,33
1658126281869,CSE 12,A01,083652,Krause-Levy; Sophia Louisa,30,1,120,90
1658126287892,CSE 15L,A01,083654,Morris; Justin Loren,9,0,50,41
1658126287892,CSE 15L,A02,083655,Morris; Justin Loren,11,0,50,39
1658126293917,CSE 20,A01,083657,Tran; Khoa Dang,39,0,80,41
1658126299944,CSE 21,A01,095574,Bach; Quang Tran,23,0,48,25
1658126305971,CSE 30,A01,083084,Eldon; John,8,0,80,72
1658126305971,CSE 30,B01,095061,Bhaskar; Nishant,9,0,50,41
1658126311992,CSE 100,A01,083659,Cao; Yingjun,5,4,70,65
1658126318017,CSE 134B,A01,083661,Powell; Thomas Allan,25,0,100,75
1658126324042,CSE 140,A01,083663,Gungor; Onat,17,0,85,68
1658126330065,CSE 140L,A01,083088,Eldon; John,23,0,100,77
1658126336087,CSE 175,A01,083665,Kumar; Rakesh,3,0,25,22
1658126342115,CSE 190,A00,092507,Dubnov; Shlomo,8,0,20,12
1658126348138,ECE 45,A01,083139,Congero; Spencer William,7,0,75,68
1658126354161,ECE 65,A50,083695,Saad; Andrew S,12,0,30,18
1658126354161,ECE 65,A51,095125,Saad; Andrew S,24,0,26,2
1658126360187,ECE 109,A01,091882,Touri; Behrouz,21,0,70,49
1658126366214,ECE 180,A00,083140,Abi Samra; Nicholas Camill,1,0,30,29
1658126366214,ECE 180,B00,083141,Abi Samra; Nicholas Camill,0,0,30,30
1658126372255,MATH 10A,A01,083735,Patchell; Gregory David,2,0,30,28
1658126372255,MATH 10A,A02,083736,Patchell; Gregory David,20,0,30,10
1658126372255,MATH 10A,A03,083737,Patchell; Gregory David,16,0,30,14
1658126378280,MATH 10B,A01,083207,Lim; Seonhee,9,0,34,25
1658126378280,MATH 10B,A02,083208,Lim; Seonhee,10,0,35,25
1658126378280,MATH 10B,A03,093472,Lim; Seonhee,7,0,34,27
1658126378280,MATH 10B,B01,083739,Sinha; Shubham,14,0,30,16
1658126384306,MATH 18,A01,083743,Cinel; Cameron Alexander,9,0,30,21
1658126384306,MATH 18,A02,083744,Cinel; Cameron Alexander,18,0,30,12
1658126384306,MATH 18,A03,083745,Cinel; Cameron Alexander,10,0,30,20
1658126384306,MATH 18,B01,083748,Rideout; David Porter,5,0,37,32
1658126384306,MATH 18,B02,083749,Rideout; David Porter,5,0,36,31
1658126384306,MATH 18,B03,083750,Rideout; David Porter,3,0,37,34
1658126384306,MATH 18,B04,083751,Rideout; David Porter,7,0,36,29
1658126384306,MATH 18,B05,093473,Rideout; David Porter,7,0,36,29
1658126384306,MATH 18,B06,093474,Rideout; David Porter,6,0,36,30
1658126390337,MATH 20A,A01,083754,Zheng; Zequn,14,0,40,26
1658126396360,MATH 20B,A01,083756,Briones; Jor-el Thomas Caparas,4,0,36,32
1658126396360,MATH 20B,A02,083757,Briones; Jor-el Thomas Caparas,1,0,36,35
1658126396360,MATH 20B,A03,093475,Briones; Jor-el Thomas Caparas,3,0,36,33
1658126402392,MATH 20C,A01,083760,Briones; Jor-el Thomas Caparas,1,0,35,34
1658126402392,MATH 20C,A02,083761,Briones; Jor-el Thomas Caparas,8,0,35,27
1658126402392,MATH 20C,A03,093476,Briones; Jor-el Thomas Caparas,0,1,36,36
1658126402392,MATH 20C,B01,083762,Bach; Quang Tran,1,0,30,29
1658126408414,MATH 20D,A01,083765,Tran; Brian Kha,5,0,30,25
1658126408414,MATH 20D,A02,083766,Tran; Brian Kha,5,0,30,25
1658126408414,MATH 20D,A03,083767,Tran; Brian Kha,6,0,30,24
1658126414437,MATH 20E,A01,083771,Ganguly; Soumya,12,0,32,20
1658126414437,MATH 20E,A02,083772,Ganguly; Soumya,7,0,32,25
1658126414437,MATH 20E,B01,083773,Ciotti; Benjamin,20,0,35,15
1658126414437,MATH 20E,B02,083774,Ciotti; Benjamin,18,0,35,17
1658126420466,MATH 103A,A01,083777,Greenfeld; Be'Eri,6,0,36,30
1658126420466,MATH 103A,A02,083778,Greenfeld; Be'Eri,5,0,36,31
1658126420466,MATH 103A,A03,093561,Greenfeld; Be'Eri,7,0,36,29
1658126420466,MATH 103A,B01,083779,Greenfeld; Be'Eri,8,0,36,28
1658126420466,MATH 103A,B02,083780,Greenfeld; Be'Eri,4,0,36,32
1658126420466,MATH 103A,B03,093562,Greenfeld; Be'Eri,3,0,36,33
1658126426489,MATH 105,A01,085443,Carter; Anne Toulson,15,0,35,20
1658126426489,MATH 105,A02,093477,Carter; Anne Toulson,20,0,35,15
1658126432515,MATH 109,A01,083213,Ganzberger; Geoffrey Michael,3,0,34,31
1658126432515,MATH 109,A02,083214,Ganzberger; Geoffrey Michael,4,0,34,30
1658126432515,MATH 109,A03,093478,Ganzberger; Geoffrey Michael,2,0,34,32
1658126432515,MATH 109,B01,083215,Ganzberger; Geoffrey Michael,3,0,32,29
1658126432515,MATH 109,B02,083216,Ganzberger; Geoffrey Michael,3,0,32,29
1658126432515,MATH 109,B03,093479,Ganzberger; Geoffrey Michael,8,0,32,24
1658126438536,MATH 142A,A01,083219,Chow; Bennett,7,0,32,25
1658126438536,MATH 142A,A02,083220,Chow; Bennett,10,0,32,22
1658126438536,MATH 142A,A03,093480,Chow; Bennett,9,0,32,23
1658126438536,MATH 142A,B03,093481,Chow; Bennett,8,0,32,24
1658126438536,MATH 142A,B04,093558,Chow; Bennett,14,0,32,18
1658126438536,MATH 142A,B05,093559,Chow; Bennett,7,0,32,25
1658126444560,MATH 193A,A01,083224,Rotar; Vladimir,9,0,34,25
1658126444560,MATH 193A,A02,083225,Rotar; Vladimir,11,0,34,23
1658126444560,MATH 193A,A03,083781,Rotar; Vladimir,5,0,34,29
1658126444560,MATH 193A,A04,083782,Rotar; Vladimir,12,0,34,22
1658126444560,MATH 193A,A05,093482,Rotar; Vladimir,11,0,34,23
1658126450582,MATH 197,001,091859,McAuley; Julian John,9999,0,9999,0
1658126450582,MATH 197,002,095566,Kedlaya; Kiran S.,9997,0,9999,2
1658126450582,MATH 197,003,095567,Xiao; Ming,9999,0,9999,0
1658126450582,MATH 197,004,095571,Perols; Johan Lars,9998,0,9999,1
1658126457636,COGS 9,A01,083615,Shannon; Kyle Michael,11,0,75,64
1658126463668,COGS 11,A01,083617,Boyle; Mary E. T.,23,0,48,25
1658126469691,COGS 13,A01,083071,Bastos; Amalia Pinkusfeld,12,0,71,59
1658126475727,COGS 14A,A01,092681,Semenuks; Arturs,5,1,100,95
1658126481753,COGS 14B,A01,083073,Cheng; Tzu-Han,7,0,63,56
1658126487777,COGS 17,A01,092677,Semenuks; Arturs,7,0,81,74
1658126493804,COGS 100,A01,083619,Allen; Michael Gordon,17,0,70,53
1658126499832,COGS 101A,A01,083621,Davis; Joshua Daniel,9,0,68,59
1658126505857,COGS 101B,A01,091572,Allen; Michael Gordon,14,0,65,51
1658126511884,COGS 101C,A01,083625,Delgado; Tania,17,0,35,18
1658126517910,COGS 107A,A01,083627,Boyle; Mary E. T.,14,0,60,46
1658126523933,COGS 118A,A01,083075,Gupta; Anjum,21,0,76,55
1658126530026,CSE 3,A50,083646,Miranda; Gregory Joseph,24,0,50,26
1658126536049,CSE 8A,A50,083650,Miranda; Gregory Joseph,17,1,56,39
1658126542072,CSE 11,A01,083080,Cao; Yingjun,7,15,40,33
1658126548097,CSE 12,A01,083652,Krause-Levy; Sophia Louisa,30,1,120,90
1658126554118,CSE 15L,A01,083654,Morris; Justin Loren,9,0,50,41
1658126554118,CSE 15L,A02,083655,Morris; Justin Loren,11,0,50,39
1658126560141,CSE 20,A01,083657,Tran; Khoa Dang,39,0,80,41
1658126566162,CSE 21,A01,095574,Bach; Quang Tran,23,0,48,25
1658126572184,CSE 30,A01,083084,Eldon; John,8,0,80,72
1658126572184,CSE 30,B01,095061,Bhaskar; Nishant,9,0,50,41
1658126578206,CSE 100,A01,083659,Cao; Yingjun,5,4,70,65
1658126584228,CSE 134B,A01,083661,Powell; Thomas Allan,25,0,100,75
1658126590252,CSE 140,A01,083663,Gungor; Onat,17,0,85,68
1658126596278,CSE 140L,A01,083088,Eldon; John,23,0,100,77
1658126602305,CSE 175,A01,083665,Kumar; Rakesh,3,0,25,22
1658126608334,CSE 190,A00,092507,Dubnov; Shlomo,8,0,20,12
1658126614360,ECE 45,A01,083139,Congero; Spencer William,7,0,75,68
1658126620383,ECE 65,A50,083695,Saad; Andrew S,12,0,30,18
1658126620383,ECE 65,A51,095125,Saad; Andrew S,24,0,26,2
1658126626410,ECE 109,A01,091882,Touri; Behrouz,21,0,70,49
1658126632435,ECE 180,A00,083140,Abi Samra; Nicholas Camill,1,0,30,29
1658126632435,ECE 180,B00,083141,Abi Samra; Nicholas Camill,0,0,30,30
1658126638462,MATH 10A,A01,083735,Patchell; Gregory David,2,0,30,28
1658126638462,MATH 10A,A02,083736,Patchell; Gregory David,20,0,30,10
1658126638462,MATH 10A,A03,083737,Patchell; Gregory David,16,0,30,14
1658126644487,MATH 10B,A01,083207,Lim; Seonhee,9,0,34,25
1658126644487,MATH 10B,A02,083208,Lim; Seonhee,10,0,35,25
1658126644487,MATH 10B,A03,093472,Lim; Seonhee,7,0,34,27
1658126644487,MATH 10B,B01,083739,Sinha; Shubham,14,0,30,16
1658126650519,MATH 18,A01,083743,Cinel; Cameron Alexander,9,0,30,21
1658126650519,MATH 18,A02,083744,Cinel; Cameron Alexander,18,0,30,12
1658126650519,MATH 18,A03,083745,Cinel; Cameron Alexander,10,0,30,20
1658126650519,MATH 18,B01,083748,Rideout; David Porter,5,0,37,32
1658126650519,MATH 18,B02,083749,Rideout; David Porter,5,0,36,31
1658126650519,MATH 18,B03,083750,Rideout; David Porter,3,0,37,34
1658126650519,MATH 18,B04,083751,Rideout; David Porter,7,0,36,29
1658126650519,MATH 18,B05,093473,Rideout; David Porter,7,0,36,29
1658126650519,MATH 18,B06,093474,Rideout; David Porter,6,0,36,30
1658126656546,MATH 20A,A01,083754,Zheng; Zequn,14,0,40,26
1658126662569,MATH 20B,A01,083756,Briones; Jor-el Thomas Caparas,4,0,36,32
1658126662569,MATH 20B,A02,083757,Briones; Jor-el Thomas Caparas,1,0,36,35
1658126662569,MATH 20B,A03,093475,Briones; Jor-el Thomas Caparas,3,0,36,33
1658126668597,MATH 20C,A01,083760,Briones; Jor-el Thomas Caparas,1,0,35,34
1658126668597,MATH 20C,A02,083761,Briones; Jor-el Thomas Caparas,8,0,35,27
1658126668597,MATH 20C,A03,093476,Briones; Jor-el Thomas Caparas,0,1,36,36
1658126668597,MATH 20C,B01,083762,Bach; Quang Tran,1,0,30,29
1658126674625,MATH 20D,A01,083765,Tran; Brian Kha,5,0,30,25
1658126674625,MATH 20D,A02,083766,Tran; Brian Kha,5,0,30,25
1658126674625,MATH 20D,A03,083767,Tran; Brian Kha,6,0,30,24
1658126680649,MATH 20E,A01,083771,Ganguly; Soumya,12,0,32,20
1658126680649,MATH 20E,A02,083772,Ganguly; Soumya,7,0,32,25
1658126680649,MATH 20E,B01,083773,Ciotti; Benjamin,20,0,35,15
1658126680649,MATH 20E,B02,083774,Ciotti; Benjamin,18,0,35,17
1658126686679,MATH 103A,A01,083777,Greenfeld; Be'Eri,6,0,36,30
1658126686679,MATH 103A,A02,083778,Greenfeld; Be'Eri,5,0,36,31
1658126686679,MATH 103A,A03,093561,Greenfeld; Be'Eri,7,0,36,29
1658126686679,MATH 103A,B01,083779,Greenfeld; Be'Eri,8,0,36,28
1658126686679,MATH 103A,B02,083780,Greenfeld; Be'Eri,4,0,36,32
1658126686679,MATH 103A,B03,093562,Greenfeld; Be'Eri,3,0,36,33
1658126692705,MATH 105,A01,085443,Carter; Anne Toulson,15,0,35,20
1658126692705,MATH 105,A02,093477,Carter; Anne Toulson,20,0,35,15
1658126698735,MATH 109,A01,083213,Ganzberger; Geoffrey Michael,3,0,34,31
1658126698735,MATH 109,A02,083214,Ganzberger; Geoffrey Michael,4,0,34,30
1658126698735,MATH 109,A03,093478,Ganzberger; Geoffrey Michael,2,0,34,32
1658126698735,MATH 109,B01,083215,Ganzberger; Geoffrey Michael,3,0,32,29
1658126698735,MATH 109,B02,083216,Ganzberger; Geoffrey Michael,3,0,32,29
1658126698735,MATH 109,B03,093479,Ganzberger; Geoffrey Michael,8,0,32,24
1658126704765,MATH 142A,A01,083219,Chow; Bennett,7,0,32,25
1658126704765,MATH 142A,A02,083220,Chow; Bennett,10,0,32,22
1658126704765,MATH 142A,A03,093480,Chow; Bennett,9,0,32,23
1658126704765,MATH 142A,B03,093481,Chow; Bennett,8,0,32,24
1658126704765,MATH 142A,B04,093558,Chow; Bennett,14,0,32,18
1658126704765,MATH 142A,B05,093559,Chow; Bennett,7,0,32,25
1658126710787,MATH 193A,A01,083224,Rotar; Vladimir,9,0,34,25
1658126710787,MATH 193A,A02,083225,Rotar; Vladimir,11,0,34,23
1658126710787,MATH 193A,A03,083781,Rotar; Vladimir,5,0,34,29
1658126710787,MATH 193A,A04,083782,Rotar; Vladimir,12,0,34,22
1658126710787,MATH 193A,A05,093482,Rotar; Vladimir,11,0,34,23
1658126716810,MATH 197,001,091859,McAuley; Julian John,9999,0,9999,0
1658126716810,MATH 197,002,095566,Kedlaya; Kiran S.,9997,0,9999,2
1658126716810,MATH 197,003,095567,Xiao; Ming,9999,0,9999,0
1658126716810,MATH 197,004,095571,Perols; Johan Lars,9998,0,9999,1
1658126723870,COGS 9,A01,083615,Shannon; Kyle Michael,11,0,75,64
1658126729897,COGS 11,A01,083617,Boyle; Mary E. T.,23,0,48,25
1658126735931,COGS 13,A01,083071,Bastos; Amalia Pinkusfeld,12,0,71,59
1658126741954,COGS 14A,A01,092681,Semenuks; Arturs,5,1,100,95
1658126747978,COGS 14B,A01,083073,Cheng; Tzu-Han,7,0,63,56
1658126754001,COGS 17,A01,092677,Semenuks; Arturs,7,0,81,74
1658126760028,COGS 100,A01,083619,Allen; Michael Gordon,17,0,70,53
1658126766053,COGS 101A,A01,083621,Davis; Joshua Daniel,9,0,68,59
1658126772077,COGS 101B,A01,091572,Allen; Michael Gordon,14,0,65,51
1658126778100,COGS 101C,A01,083625,Delgado; Tania,17,0,35,18
1658126784128,COGS 107A,A01,083627,Boyle; Mary E. T.,14,0,60,46
1658126790153,COGS 118A,A01,083075,Gupta; Anjum,21,0,76,55
1658126796178,CSE 3,A50,083646,Miranda; Gregory Joseph,24,0,50,26
1658126802206,CSE 8A,A50,083650,Miranda; Gregory Joseph,17,1,56,39
1658126808232,CSE 11,A01,083080,Cao; Yingjun,7,15,40,33
1658126814259,CSE 12,A01,083652,Krause-Levy; Sophia Louisa,30,1,120,90
1658126820284,CSE 15L,A01,083654,Morris; Justin Loren,9,0,50,41
1658126820284,CSE 15L,A02,083655,Morris; Justin Loren,11,0,50,39
1658126826311,CSE 20,A01,083657,Tran; Khoa Dang,39,0,80,41
1658126832335,CSE 21,A01,095574,Bach; Quang Tran,23,0,48,25
1658126838364,CSE 30,A01,083084,Eldon; John,8,0,80,72
1658126838364,CSE 30,B01,095061,Bhaskar; Nishant,9,0,50,41
1658126844387,CSE 100,A01,083659,Cao; Yingjun,5,4,70,65
1658126850410,CSE 134B,A01,083661,Powell; Thomas Allan,25,0,100,75
1658126856433,CSE 140,A01,083663,Gungor; Onat,17,0,85,68
1658126862456,CSE 140L,A01,083088,Eldon; John,23,0,100,77
1658126868479,CSE 175,A01,083665,Kumar; Rakesh,3,0,25,22
1658126874502,CSE 190,A00,092507,Dubnov; Shlomo,8,0,20,12
1658126880526,ECE 45,A01,083139,Congero; Spencer William,7,0,75,68
1658126886552,ECE 65,A50,083695,Saad; Andrew S,12,0,30,18
1658126886552,ECE 65,A51,095125,Saad; Andrew S,24,0,26,2
1658126892575,ECE 109,A01,091882,Touri; Behrouz,21,0,70,49
1658126898610,ECE 180,A00,083140,Abi Samra; Nicholas Camill,1,0,30,29
1658126898610,ECE 180,B00,083141,Abi Samra; Nicholas Camill,0,0,30,30
1658126904634,MATH 10A,A01,083735,Patchell; Gregory David,2,0,30,28
1658126904634,MATH 10A,A02,083736,Patchell; Gregory David,20,0,30,10
1658126904634,MATH 10A,A03,083737,Patchell; Gregory David,16,0,30,14
1658126910662,MATH 10B,A01,083207,Lim; Seonhee,9,0,34,25
1658126910662,MATH 10B,A02,083208,Lim; Seonhee,10,0,35,25
1658126910662,MATH 10B,A03,093472,Lim; Seonhee,7,0,34,27
1658126910662,MATH 10B,B01,083739,Sinha; Shubham,14,0,30,16
1658126916693,MATH 18,A01,083743,Cinel; Cameron Alexander,9,0,30,21
1658126916693,MATH 18,A02,083744,Cinel; Cameron Alexander,18,0,30,12
1658126916693,MATH 18,A03,083745,Cinel; Cameron Alexander,10,0,30,20
1658126916693,MATH 18,B01,083748,Rideout; David Porter,5,0,37,32
1658126916693,MATH 18,B02,083749,Rideout; David Porter,5,0,36,31
1658126916693,MATH 18,B03,083750,Rideout; David Porter,3,0,37,34
1658126916693,MATH 18,B04,083751,Rideout; David Porter,7,0,36,29
1658126916693,MATH 18,B05,093473,Rideout; David Porter,7,0,36,29
1658126916693,MATH 18,B06,093474,Rideout; David Porter,6,0,36,30
1658126922723,MATH 20A,A01,083754,Zheng; Zequn,14,0,40,26
1658126928748,MATH 20B,A01,083756,Briones; Jor-el Thomas Caparas,4,0,36,32
1658126928748,MATH 20B,A02,083757,Briones; Jor-el Thomas Caparas,1,0,36,35
1658126928748,MATH 20B,A03,093475,Briones; Jor-el Thomas Caparas,3,0,36,33
1658126934773,MATH 20C,A01,083760,Briones; Jor-el Thomas Caparas,1,0,35,34
1658126934773,MATH 20C,A02,083761,Briones; Jor-el Thomas Caparas,8,0,35,27
1658126934773,MATH 20C,A03,093476,Briones; Jor-el Thomas Caparas,0,1,36,36
1658126934773,MATH 20C,B01,083762,Bach; Quang Tran,1,0,30,29
1658126940796,MATH 20D,A01,083765,Tran; Brian Kha,5,0,30,25
1658126940796,MATH 20D,A02,083766,Tran; Brian Kha,5,0,30,25
1658126940796,MATH 20D,A03,083767,Tran; Brian Kha,6,0,30,24
1658126946828,MATH 20E,A01,083771,Ganguly; Soumya,12,0,32,20
1658126946828,MATH 20E,A02,083772,Ganguly; Soumya,7,0,32,25
1658126946828,MATH 20E,B01,083773,Ciotti; Benjamin,20,0,35,15
1658126946828,MATH 20E,B02,083774,Ciotti; Benjamin,18,0,35,17
1658126952858,MATH 103A,A01,083777,Greenfeld; Be'Eri,6,0,36,30
1658126952858,MATH 103A,A02,083778,Greenfeld; Be'Eri,5,0,36,31
1658126952858,MATH 103A,A03,093561,Greenfeld; Be'Eri,7,0,36,29
1658126952858,MATH 103A,B01,083779,Greenfeld; Be'Eri,8,0,36,28
1658126952858,MATH 103A,B02,083780,Greenfeld; Be'Eri,4,0,36,32
1658126952858,MATH 103A,B03,093562,Greenfeld; Be'Eri,3,0,36,33
1658126958882,MATH 105,A01,085443,Carter; Anne Toulson,15,0,35,20
1658126958882,MATH 105,A02,093477,Carter; Anne Toulson,20,0,35,15
1658126964909,MATH 109,A01,083213,Ganzberger; Geoffrey Michael,3,0,34,31
1658126964909,MATH 109,A02,083214,Ganzberger; Geoffrey Michael,4,0,34,30
1658126964909,MATH 109,A03,093478,Ganzberger; Geoffrey Michael,2,0,34,32
1658126964909,MATH 109,B01,083215,Ganzberger; Geoffrey Michael,3,0,32,29
1658126964909,MATH 109,B02,083216,Ganzberger; Geoffrey Michael,3,0,32,29
1658126964909,MATH 109,B03,093479,Ganzberger; Geoffrey Michael,8,0,32,24
1658126970933,MATH 142A,A01,083219,Chow; Bennett,7,0,32,25
1658126970933,MATH 142A,A02,083220,Chow; Bennett,10,0,32,22
1658126970933,MATH 142A,A03,093480,Chow; Bennett,9,0,32,23
1658126970933,MATH 142A,B03,093481,Chow; Bennett,8,0,32,24
1658126970933,MATH 142A,B04,093558,Chow; Bennett,14,0,32,18
1658126970933,MATH 142A,B05,093559,Chow; Bennett,7,0,32,25
1658126976961,MATH 193A,A01,083224,Rotar; Vladimir,9,0,34,25
1658126976961,MATH 193A,A02,083225,Rotar; Vladimir,11,0,34,23
1658126976961,MATH 193A,A03,083781,Rotar; Vladimir,5,0,34,29
1658126976961,MATH 193A,A04,083782,Rotar; Vladimir,12,0,34,22
1658126976961,MATH 193A,A05,093482,Rotar; Vladimir,11,0,34,23
1658126982986,MATH 197,001,091859,McAuley; Julian John,9999,0,9999,0
1658126982986,MATH 197,002,095566,Kedlaya; Kiran S.,9997,0,9999,2
1658126982986,MATH 197,003,095567,Xiao; Ming,9999,0,9999,0
1658126982986,MATH 197,004,095571,Perols; Johan Lars,9998,0,9999,1
1658126990049,COGS 9,A01,083615,Shannon; Kyle Michael,11,0,75,64
1658126996073,COGS 11,A01,083617,Boyle; Mary E. T.,23,0,48,25
1658127002102,COGS 13,A01,083071,Bastos; Amalia Pinkusfeld,12,0,71,59
1658127008125,COGS 14A,A01,092681,Semenuks; Arturs,5,1,100,95
1658127014148,COGS 14B,A01,083073,Cheng; Tzu-Han,7,0,63,56
1658127020172,COGS 17,A01,092677,Semenuks; Arturs,7,0,81,74
1658127026198,COGS 100,A01,083619,Allen; Michael Gordon,17,0,70,53
1658127032227,COGS 101A,A01,083621,Davis; Joshua Daniel,9,0,68,59
1658127038254,COGS 101B,A01,091572,Allen; Michael Gordon,14,0,65,51
1658127044277,COGS 101C,A01,083625,Delgado; Tania,17,0,35,18
1658127050305,COGS 107A,A01,083627,Boyle; Mary E. T.,14,0,60,46
1658127056328,COGS 118A,A01,083075,Gupta; Anjum,21,0,76,55
1658127062356,CSE 3,A50,083646,Miranda; Gregory Joseph,24,0,50,26
1658127068384,CSE 8A,A50,083650,Miranda; Gregory Joseph,17,1,56,39
1658127074412,CSE 11,A01,083080,Cao; Yingjun,7,15,40,33
1658127080437,CSE 12,A01,083652,Krause-Levy; Sophia Louisa,30,1,120,90
1658127086460,CSE 15L,A01,083654,Morris; Justin Loren,9,0,50,41
1658127086460,CSE 15L,A02,083655,Morris; Justin Loren,11,0,50,39
1658127092485,CSE 20,A01,083657,Tran; Khoa Dang,39,0,80,41
1658127098508,CSE 21,A01,095574,Bach; Quang Tran,23,0,48,25
1658127104531,CSE 30,A01,083084,Eldon; John,8,0,80,72
1658127104531,CSE 30,B01,095061,Bhaskar; Nishant,9,0,50,41
1658127110554,CSE 100,A01,083659,Cao; Yingjun,5,4,70,65
1658127116582,CSE 134B,A01,083661,Powell; Thomas Allan,25,0,100,75
1658127122606,CSE 140,A01,083663,Gungor; Onat,17,0,85,68
1658127128709,CSE 140L,A01,083088,Eldon; John,23,0,100,77
1658127134733,CSE 175,A01,083665,Kumar; Rakesh,3,0,25,22
1658127140760,CSE 190,A00,092507,Dubnov; Shlomo,8,0,20,12
1658127146782,ECE 45,A01,083139,Congero; Spencer William,7,0,75,68
1658127152806,ECE 65,A50,083695,Saad; Andrew S,12,0,30,18
1658127152806,ECE 65,A51,095125,Saad; Andrew S,24,0,26,2
1658127158835,ECE 109,A01,091882,Touri; Behrouz,21,0,70,49
1658127164862,ECE 180,A00,083140,Abi Samra; Nicholas Camill,1,0,30,29
1658127164862,ECE 180,B00,083141,Abi Samra; Nicholas Camill,0,0,30,30
1658127170885,MATH 10A,A01,083735,Patchell; Gregory David,2,0,30,28
1658127170885,MATH 10A,A02,083736,Patchell; Gregory David,20,0,30,10
1658127170885,MATH 10A,A03,083737,Patchell; Gregory David,16,0,30,14
1658127176910,MATH 10B,A01,083207,Lim; Seonhee,9,0,34,25
1658127176910,MATH 10B,A02,083208,Lim; Seonhee,10,0,35,25
1658127176910,MATH 10B,A03,093472,Lim; Seonhee,7,0,34,27
1658127176910,MATH 10B,B01,083739,Sinha; Shubham,14,0,30,16
1658127182935,MATH 18,A01,083743,Cinel; Cameron Alexander,9,0,30,21
1658127182935,MATH 18,A02,083744,Cinel; Cameron Alexander,18,0,30,12
1658127182935,MATH 18,A03,083745,Cinel; Cameron Alexander,10,0,30,20
1658127182935,MATH 18,B01,083748,Rideout; David Porter,5,0,37,32
1658127182935,MATH 18,B02,083749,Rideout; David Porter,5,0,36,31
1658127182935,MATH 18,B03,083750,Rideout; David Porter,3,0,37,34
1658127182935,MATH 18,B04,083751,Rideout; David Porter,7,0,36,29
1658127182935,MATH 18,B05,093473,Rideout; David Porter,7,0,36,29
1658127182935,MATH 18,B06,093474,Rideout; David Porter,6,0,36,30
1658127188959,MATH 20A,A01,083754,Zheng; Zequn,14,0,40,26
1658127194982,MATH 20B,A01,083756,Briones; Jor-el Thomas Caparas,4,0,36,32
1658127194982,MATH 20B,A02,083757,Briones; Jor-el Thomas Caparas,1,0,36,35
1658127194982,MATH 20B,A03,093475,Briones; Jor-el Thomas Caparas,3,0,36,33
1658127201011,MATH 20C,A01,083760,Briones; Jor-el Thomas Caparas,1,0,35,34
1658127201011,MATH 20C,A02,083761,Briones; Jor-el Thomas Caparas,8,0,35,27
1658127201011,MATH 20C,A03,093476,Briones; Jor-el Thomas Caparas,0,1,36,36
1658127201011,MATH 20C,B01,083762,Bach; Quang Tran,1,0,30,29
1658127207035,MATH 20D,A01,083765,Tran; Brian Kha,5,0,30,25
1658127207035,MATH 20D,A02,083766,Tran; Brian Kha,5,0,30,25
1658127207035,MATH 20D,A03,083767,Tran; Brian Kha,6,0,30,24
1658127213084,MATH 20E,A01,083771,Ganguly; Soumya,12,0,32,20
1658127213084,MATH 20E,A02,083772,Ganguly; Soumya,7,0,32,25
1658127213084,MATH 20E,B01,083773,Ciotti; Benjamin,20,0,35,15
1658127213084,MATH 20E,B02,083774,Ciotti; Benjamin,18,0,35,17
1658127219109,MATH 103A,A01,083777,Greenfeld; Be'Eri,6,0,36,30
1658127219109,MATH 103A,A02,083778,Greenfeld; Be'Eri,5,0,36,31
1658127219109,MATH 103A,A03,093561,Greenfeld; Be'Eri,7,0,36,29
1658127219109,MATH 103A,B01,083779,Greenfeld; Be'Eri,8,0,36,28
1658127219109,MATH 103A,B02,083780,Greenfeld; Be'Eri,4,0,36,32
1658127219109,MATH 103A,B03,093562,Greenfeld; Be'Eri,3,0,36,33
1658127225133,MATH 105,A01,085443,Carter; Anne Toulson,15,0,35,20
1658127225133,MATH 105,A02,093477,Carter; Anne Toulson,20,0,35,15
1658127231158,MATH 109,A01,083213,Ganzberger; Geoffrey Michael,3,0,34,31
1658127231158,MATH 109,A02,083214,Ganzberger; Geoffrey Michael,4,0,34,30
1658127231158,MATH 109,A03,093478,Ganzberger; Geoffrey Michael,2,0,34,32
1658127231158,MATH 109,B01,083215,Ganzberger; Geoffrey Michael,3,0,32,29
1658127231158,MATH 109,B02,083216,Ganzberger; Geoffrey Michael,3,0,32,29
1658127231158,MATH 109,B03,093479,Ganzberger; Geoffrey Michael,8,0,32,24
1658127237182,MATH 142A,A01,083219,Chow; Bennett,7,0,32,25
1658127237182,MATH 142A,A02,083220,Chow; Bennett,10,0,32,22
1658127237182,MATH 142A,A03,093480,Chow; Bennett,9,0,32,23
1658127237182,MATH 142A,B03,093481,Chow; Bennett,8,0,32,24
1658127237182,MATH 142A,B04,093558,Chow; Bennett,14,0,32,18
1658127237182,MATH 142A,B05,093559,Chow; Bennett,7,0,32,25
1658127243211,MATH 193A,A01,083224,Rotar; Vladimir,9,0,34,25
1658127243211,MATH 193A,A02,083225,Rotar; Vladimir,11,0,34,23
1658127243211,MATH 193A,A03,083781,Rotar; Vladimir,5,0,34,29
1658127243211,MATH 193A,A04,083782,Rotar; Vladimir,12,0,34,22
1658127243211,MATH 193A,A05,093482,Rotar; Vladimir,11,0,34,23
1658127249235,MATH 197,001,091859,McAuley; Julian John,9999,0,9999,0
1658127249235,MATH 197,002,095566,Kedlaya; Kiran S.,9997,0,9999,2
1658127249235,MATH 197,003,095567,Xiao; Ming,9999,0,9999,0
1658127249235,MATH 197,004,095571,Perols; Johan Lars,9998,0,9999,1
1658127256291,COGS 9,A01,083615,Shannon; Kyle Michael,11,0,75,64
1658127262315,COGS 11,A01,083617,Boyle; Mary E. T.,23,0,48,25
1658127268340,COGS 13,A01,083071,Bastos; Amalia Pinkusfeld,12,0,71,59
1658127274367,COGS 14A,A01,092681,Semenuks; Arturs,5,1,100,95
1658127280391,COGS 14B,A01,083073,Cheng; Tzu-Han,7,0,63,56
1658127286420,COGS 17,A01,092677,Semenuks; Arturs,7,0,81,74
1658127292443,COGS 100,A01,083619,Allen; Michael Gordon,17,0,70,53
1658127298466,COGS 101A,A01,083621,Davis; Joshua Daniel,9,0,68,59
1658127304499,COGS 101B,A01,091572,Allen; Michael Gordon,14,0,65,51
1658127310521,COGS 101C,A01,083625,Delgado; Tania,17,0,35,18
1658127316543,COGS 107A,A01,083627,Boyle; Mary E. T.,14,0,60,46
1658127322570,COGS 118A,A01,083075,Gupta; Anjum,21,0,76,55
1658127328593,CSE 3,A50,083646,Miranda; Gregory Joseph,24,0,50,26
1658127334618,CSE 8A,A50,083650,Miranda; Gregory Joseph,17,1,56,39
1658127340641,CSE 11,A01,083080,Cao; Yingjun,7,15,40,33
1658127346668,CSE 12,A01,083652,Krause-Levy; Sophia Louisa,30,1,120,90
1658127352691,CSE 15L,A01,083654,Morris; Justin Loren,9,0,50,41
1658127352691,CSE 15L,A02,083655,Morris; Justin Loren,11,0,50,39
1658127358715,CSE 20,A01,083657,Tran; Khoa Dang,39,0,80,41
1658127364742,CSE 21,A01,095574,Bach; Quang Tran,23,0,48,25
1658127370766,CSE 30,A01,083084,Eldon; John,8,0,80,72
1658127370766,CSE 30,B01,095061,Bhaskar; Nishant,9,0,50,41
1658127376789,CSE 100,A01,083659,Cao; Yingjun,5,4,70,65
1658127382812,CSE 134B,A01,083661,Powell; Thomas Allan,25,0,100,75
1658127388837,CSE 140,A01,083663,Gungor; Onat,17,0,85,68
1658127394861,CSE 140L,A01,083088,Eldon; John,23,0,100,77
1658127400882,CSE 175,A01,083665,Kumar; Rakesh,3,0,25,22
1658127406908,CSE 190,A00,092507,Dubnov; Shlomo,8,0,20,12
1658127412933,ECE 45,A01,083139,Congero; Spencer William,7,0,75,68
1658127418960,ECE 65,A50,083695,Saad; Andrew S,12,0,30,18
1658127418960,ECE 65,A51,095125,Saad; Andrew S,24,0,26,2
1658127424985,ECE 109,A01,091882,Touri; Behrouz,21,0,70,49
1658127431011,ECE 180,A00,083140,Abi Samra; Nicholas Camill,1,0,30,29
1658127431011,ECE 180,B00,083141,Abi Samra; Nicholas Camill,0,0,30,30
1658127437036,MATH 10A,A01,083735,Patchell; Gregory David,2,0,30,28
1658127437036,MATH 10A,A02,083736,Patchell; Gregory David,20,0,30,10
1658127437036,MATH 10A,A03,083737,Patchell; Gregory David,16,0,30,14
1658127443062,MATH 10B,A01,083207,Lim; Seonhee,9,0,34,25
1658127443062,MATH 10B,A02,083208,Lim; Seonhee,10,0,35,25
1658127443062,MATH 10B,A03,093472,Lim; Seonhee,7,0,34,27
1658127443062,MATH 10B,B01,083739,Sinha; Shubham,14,0,30,16
1658127449100,MATH 18,A01,083743,Cinel; Cameron Alexander,9,0,30,21
1658127449100,MATH 18,A02,083744,Cinel; Cameron Alexander,18,0,30,12
1658127449100,MATH 18,A03,083745,Cinel; Cameron Alexander,10,0,30,20
1658127449100,MATH 18,B01,083748,Rideout; David Porter,5,0,37,32
1658127449100,MATH 18,B02,083749,Rideout; David Porter,5,0,36,31
1658127449100,MATH 18,B03,083750,Rideout; David Porter,3,0,37,34
1658127449100,MATH 18,B04,083751,Rideout; David Porter,7,0,36,29
1658127449100,MATH 18,B05,093473,Rideout; David Porter,7,0,36,29
1658127449100,MATH 18,B06,093474,Rideout; David Porter,6,0,36,30
1658127455128,MATH 20A,A01,083754,Zheng; Zequn,14,0,40,26
1658127461157,MATH 20B,A01,083756,Briones; Jor-el Thomas Caparas,4,0,36,32
1658127461157,MATH 20B,A02,083757,Briones; Jor-el Thomas Caparas,1,0,36,35
1658127461157,MATH 20B,A03,093475,Briones; Jor-el Thomas Caparas,3,0,36,33
1658127467181,MATH 20C,A01,083760,Briones; Jor-el Thomas Caparas,1,0,35,34
1658127467181,MATH 20C,A02,083761,Briones; Jor-el Thomas Caparas,8,0,35,27
1658127467181,MATH 20C,A03,093476,Briones; Jor-el Thomas Caparas,0,1,36,36
1658127467181,MATH 20C,B01,083762,Bach; Quang Tran,1,0,30,29
1658127473209,MATH 20D,A01,083765,Tran; Brian Kha,5,0,30,25
1658127473209,MATH 20D,A02,083766,Tran; Brian Kha,5,0,30,25
1658127473209,MATH 20D,A03,083767,Tran; Brian Kha,6,0,30,24
1658127479234,MATH 20E,A01,083771,Ganguly; Soumya,12,0,32,20
1658127479234,MATH 20E,A02,083772,Ganguly; Soumya,7,0,32,25
1658127479234,MATH 20E,B01,083773,Ciotti; Benjamin,20,0,35,15
1658127479234,MATH 20E,B02,083774,Ciotti; Benjamin,18,0,35,17
1658127485273,MATH 103A,A01,083777,Greenfeld; Be'Eri,6,0,36,30
1658127485273,MATH 103A,A02,083778,Greenfeld; Be'Eri,5,0,36,31
1658127485273,MATH 103A,A03,093561,Greenfeld; Be'Eri,7,0,36,29
1658127485273,MATH 103A,B01,083779,Greenfeld; Be'Eri,8,0,36,28
1658127485273,MATH 103A,B02,083780,Greenfeld; Be'Eri,4,0,36,32
1658127485273,MATH 103A,B03,093562,Greenfeld; Be'Eri,3,0,36,33
1658127491297,MATH 105,A01,085443,Carter; Anne Toulson,15,0,35,20
1658127491297,MATH 105,A02,093477,Carter; Anne Toulson,20,0,35,15
1658127497326,MATH 109,A01,083213,Ganzberger; Geoffrey Michael,3,0,34,31
1658127497326,MATH 109,A02,083214,Ganzberger; Geoffrey Michael,4,0,34,30
1658127497326,MATH 109,A03,093478,Ganzberger; Geoffrey Michael,2,0,34,32
1658127497326,MATH 109,B01,083215,Ganzberger; Geoffrey Michael,3,0,32,29
1658127497326,MATH 109,B02,083216,Ganzberger; Geoffrey Michael,3,0,32,29
1658127497326,MATH 109,B03,093479,Ganzberger; Geoffrey Michael,8,0,32,24
1658127503359,MATH 142A,A01,083219,Chow; Bennett,7,0,32,25
1658127503359,MATH 142A,A02,083220,Chow; Bennett,10,0,32,22
1658127503359,MATH 142A,A03,093480,Chow; Bennett,9,0,32,23
1658127503359,MATH 142A,B03,093481,Chow; Bennett,8,0,32,24
1658127503359,MATH 142A,B04,093558,Chow; Bennett,14,0,32,18
1658127503359,MATH 142A,B05,093559,Chow; Bennett,7,0,32,25
1658127509394,MATH 193A,A01,083224,Rotar; Vladimir,9,0,34,25
1658127509394,MATH 193A,A02,083225,Rotar; Vladimir,11,0,34,23
1658127509394,MATH 193A,A03,083781,Rotar; Vladimir,5,0,34,29
1658127509394,MATH 193A,A04,083782,Rotar; Vladimir,12,0,34,22
1658127509394,MATH 193A,A05,093482,Rotar; Vladimir,11,0,34,23
1658127515425,MATH 197,001,091859,McAuley; Julian John,9999,0,9999,0
1658127515425,MATH 197,002,095566,Kedlaya; Kiran S.,9997,0,9999,2
1658127515425,MATH 197,003,095567,Xiao; Ming,9999,0,9999,0
1658127515425,MATH 197,004,095571,Perols; Johan Lars,9998,0,9999,1
1658127522497,COGS 9,A01,083615,Shannon; Kyle Michael,11,0,75,64
1658127528525,COGS 11,A01,083617,Boyle; Mary E. T.,23,0,48,25
1658127534548,COGS 13,A01,083071,Bastos; Amalia Pinkusfeld,12,0,71,59
1658127540575,COGS 14A,A01,092681,Semenuks; Arturs,5,1,100,95
1658127546605,COGS 14B,A01,083073,Cheng; Tzu-Han,7,0,63,56
1658127552627,COGS 17,A01,092677,Semenuks; Arturs,7,0,81,74
1658127558654,COGS 100,A01,083619,Allen; Michael Gordon,17,0,70,53
1658127564676,COGS 101A,A01,083621,Davis; Joshua Daniel,9,0,68,59
1658127570702,COGS 101B,A01,091572,Allen; Michael Gordon,14,0,65,51
1658127576727,COGS 101C,A01,083625,Delgado; Tania,17,0,35,18
1658127582751,COGS 107A,A01,083627,Boyle; Mary E. T.,14,0,60,46
1658127588777,COGS 118A,A01,083075,Gupta; Anjum,21,0,76,55
1658127594805,CSE 3,A50,083646,Miranda; Gregory Joseph,24,0,50,26
1658127600833,CSE 8A,A50,083650,Miranda; Gregory Joseph,17,1,56,39
1658127606858,CSE 11,A01,083080,Cao; Yingjun,7,15,40,33
1658127612884,CSE 12,A01,083652,Krause-Levy; Sophia Louisa,30,1,120,90
1658127618914,CSE 15L,A01,083654,Morris; Justin Loren,9,0,50,41
1658127618914,CSE 15L,A02,083655,Morris; Justin Loren,11,0,50,39
1658127624938,CSE 20,A01,083657,Tran; Khoa Dang,39,0,80,41
1658127630965,CSE 21,A01,095574,Bach; Quang Tran,23,0,48,25
1658127636988,CSE 30,A01,083084,Eldon; John,8,0,80,72
1658127636988,CSE 30,B01,095061,Bhaskar; Nishant,9,0,50,41
1658127643025,CSE 100,A01,083659,Cao; Yingjun,5,4,70,65
1658127649058,CSE 134B,A01,083661,Powell; Thomas Allan,25,0,100,75
1658127655086,CSE 140,A01,083663,Gungor; Onat,17,0,85,68
1658127661112,CSE 140L,A01,083088,Eldon; John,23,0,100,77
1658127667137,CSE 175,A01,083665,Kumar; Rakesh,3,0,25,22
1658127673166,CSE 190,A00,092507,Dubnov; Shlomo,8,0,20,12
1658127679190,ECE 45,A01,083139,Congero; Spencer William,7,0,75,68
1658127685220,ECE 65,A50,083695,Saad; Andrew S,12,0,30,18
1658127685220,ECE 65,A51,095125,Saad; Andrew S,24,0,26,2
1658127691256,ECE 109,A01,091882,Touri; Behrouz,21,0,70,49
1658127697284,ECE 180,A00,083140,Abi Samra; Nicholas Camill,1,0,30,29
1658127697284,ECE 180,B00,083141,Abi Samra; Nicholas Camill,0,0,30,30
1658127703309,MATH 10A,A01,083735,Patchell; Gregory David,2,0,30,28
1658127703309,MATH 10A,A02,083736,Patchell; Gregory David,20,0,30,10
1658127703309,MATH 10A,A03,083737,Patchell; Gregory David,16,0,30,14
1658127709343,MATH 10B,A01,083207,Lim; Seonhee,9,0,34,25
1658127709343,MATH 10B,A02,083208,Lim; Seonhee,10,0,35,25
1658127709343,MATH 10B,A03,093472,Lim; Seonhee,7,0,34,27
1658127709343,MATH 10B,B01,083739,Sinha; Shubham,14,0,30,16
1658127715382,MATH 18,A01,083743,Cinel; Cameron Alexander,9,0,30,21
1658127715382,MATH 18,A02,083744,Cinel; Cameron Alexander,18,0,30,12
1658127715382,MATH 18,A03,083745,Cinel; Cameron Alexander,10,0,30,20
1658127715382,MATH 18,B01,083748,Rideout; David Porter,5,0,37,32
1658127715382,MATH 18,B02,083749,Rideout; David Porter,5,0,36,31
1658127715382,MATH 18,B03,083750,Rideout; David Porter,3,0,37,34
1658127715382,MATH 18,B04,083751,Rideout; David Porter,7,0,36,29
1658127715382,MATH 18,B05,093473,Rideout; David Porter,7,0,36,29
1658127715382,MATH 18,B06,093474,Rideout; David Porter,6,0,36,30
1658127721407,MATH 20A,A01,083754,Zheng; Zequn,14,0,40,26
1658127727525,MATH 20B,A01,083756,Briones; Jor-el Thomas Caparas,4,0,36,32
1658127727525,MATH 20B,A02,083757,Briones; Jor-el Thomas Caparas,1,0,36,35
1658127727525,MATH 20B,A03,093475,Briones; Jor-el Thomas Caparas,3,0,36,33
1658127733550,MATH 20C,A01,083760,Briones; Jor-el Thomas Caparas,1,0,35,34
1658127733550,MATH 20C,A02,083761,Briones; Jor-el Thomas Caparas,8,0,35,27
1658127733550,MATH 20C,A03,093476,Briones; Jor-el Thomas Caparas,0,1,36,36
1658127733550,MATH 20C,B01,083762,Bach; Quang Tran,1,0,30,29
1658127739575,MATH 20D,A01,083765,Tran; Brian Kha,5,0,30,25
1658127739575,MATH 20D,A02,083766,Tran; Brian Kha,5,0,30,25
1658127739575,MATH 20D,A03,083767,Tran; Brian Kha,6,0,30,24
1658127745600,MATH 20E,A01,083771,Ganguly; Soumya,12,0,32,20
1658127745600,MATH 20E,A02,083772,Ganguly; Soumya,7,0,32,25
1658127745600,MATH 20E,B01,083773,Ciotti; Benjamin,20,0,35,15
1658127745600,MATH 20E,B02,083774,Ciotti; Benjamin,18,0,35,17
1658127751633,MATH 103A,A01,083777,Greenfeld; Be'Eri,6,0,36,30
1658127751633,MATH 103A,A02,083778,Greenfeld; Be'Eri,5,0,36,31
1658127751633,MATH 103A,A03,093561,Greenfeld; Be'Eri,7,0,36,29
1658127751633,MATH 103A,B01,083779,Greenfeld; Be'Eri,8,0,36,28
1658127751633,MATH 103A,B02,083780,Greenfeld; Be'Eri,4,0,36,32
1658127751633,MATH 103A,B03,093562,Greenfeld; Be'Eri,3,0,36,33
1658127757657,MATH 105,A01,085443,Carter; Anne Toulson,15,0,35,20
1658127757657,MATH 105,A02,093477,Carter; Anne Toulson,20,0,35,15
1658127763684,MATH 109,A01,083213,Ganzberger; Geoffrey Michael,3,0,34,31
1658127763684,MATH 109,A02,083214,Ganzberger; Geoffrey Michael,4,0,34,30
1658127763684,MATH 109,A03,093478,Ganzberger; Geoffrey Michael,2,0,34,32
1658127763684,MATH 109,B01,083215,Ganzberger; Geoffrey Michael,3,0,32,29
1658127763684,MATH 109,B02,083216,Ganzberger; Geoffrey Michael,3,0,32,29
1658127763684,MATH 109,B03,093479,Ganzberger; Geoffrey Michael,8,0,32,24
1658127769720,MATH 142A,A01,083219,Chow; Bennett,7,0,32,25
1658127769720,MATH 142A,A02,083220,Chow; Bennett,10,0,32,22
1658127769720,MATH 142A,A03,093480,Chow; Bennett,9,0,32,23
1658127769720,MATH 142A,B03,093481,Chow; Bennett,8,0,32,24
1658127769720,MATH 142A,B04,093558,Chow; Bennett,14,0,32,18
1658127769720,MATH 142A,B05,093559,Chow; Bennett,7,0,32,25
1658127775744,MATH 193A,A01,083224,Rotar; Vladimir,9,0,34,25
1658127775744,MATH 193A,A02,083225,Rotar; Vladimir,11,0,34,23
1658127775744,MATH 193A,A03,083781,Rotar; Vladimir,5,0,34,29
1658127775744,MATH 193A,A04,083782,Rotar; Vladimir,12,0,34,22
1658127775744,MATH 193A,A05,093482,Rotar; Vladimir,11,0,34,23
1658127781768,MATH 197,001,091859,McAuley; Julian John,9999,0,9999,0
1658127781768,MATH 197,002,095566,Kedlaya; Kiran S.,9997,0,9999,2
1658127781768,MATH 197,003,095567,Xiao; Ming,9999,0,9999,0
1658127781768,MATH 197,004,095571,Perols; Johan Lars,9998,0,9999,1
1658127788839,COGS 9,A01,083615,Shannon; Kyle Michael,11,0,75,64
1658127794869,COGS 11,A01,083617,Boyle; Mary E. T.,23,0,48,25
1658127800892,COGS 13,A01,083071,Bastos; Amalia Pinkusfeld,12,0,71,59
1658127806917,COGS 14A,A01,092681,Semenuks; Arturs,5,1,100,95
1658127812961,COGS 14B,A01,083073,Cheng; Tzu-Han,7,0,63,56
1658127818986,COGS 17,A01,092677,Semenuks; Arturs,7,0,81,74
1658127825016,COGS 100,A01,083619,Allen; Michael Gordon,17,0,70,53
1658127831042,COGS 101A,A01,083621,Davis; Joshua Daniel,9,0,68,59
1658127837075,COGS 101B,A01,091572,Allen; Michael Gordon,14,0,65,51
1658127843099,COGS 101C,A01,083625,Delgado; Tania,17,0,35,18
1658127849136,COGS 107A,A01,083627,Boyle; Mary E. T.,14,0,60,46
1658127855164,COGS 118A,A01,083075,Gupta; Anjum,21,0,76,55
1658127861196,CSE 3,A50,083646,Miranda; Gregory Joseph,24,0,50,26
1658127867226,CSE 8A,A50,083650,Miranda; Gregory Joseph,17,1,56,39
1658127873250,CSE 11,A01,083080,Cao; Yingjun,7,15,40,33
1658127879273,CSE 12,A01,083652,Krause-Levy; Sophia Louisa,30,1,120,90
1658127885302,CSE 15L,A01,083654,Morris; Justin Loren,9,0,50,41
1658127885302,CSE 15L,A02,083655,Morris; Justin Loren,11,0,50,39
1658127891326,CSE 20,A01,083657,Tran; Khoa Dang,39,0,80,41
1658127897350,CSE 21,A01,095574,Bach; Quang Tran,23,0,48,25
1658127903379,CSE 30,A01,083084,Eldon; John,8,0,80,72
1658127903379,CSE 30,B01,095061,Bhaskar; Nishant,9,0,50,41
1658127909403,CSE 100,A01,083659,Cao; Yingjun,5,4,70,65
1658127915428,CSE 134B,A01,083661,Powell; Thomas Allan,25,0,100,75
1658127921459,CSE 140,A01,083663,Gungor; Onat,17,0,85,68
1658127927491,CSE 140L,A01,083088,Eldon; John,23,0,100,77
1658127933519,CSE 175,A01,083665,Kumar; Rakesh,3,0,25,22
1658127939544,CSE 190,A00,092507,Dubnov; Shlomo,8,0,20,12
1658127945568,ECE 45,A01,083139,Congero; Spencer William,7,0,75,68
1658127951592,ECE 65,A50,083695,Saad; Andrew S,12,0,30,18
1658127951592,ECE 65,A51,095125,Saad; Andrew S,24,0,26,2
1658127957615,ECE 109,A01,091882,Touri; Behrouz,21,0,70,49
1658127963662,ECE 180,A00,083140,Abi Samra; Nicholas Camill,1,0,30,29
1658127963662,ECE 180,B00,083141,Abi Samra; Nicholas Camill,0,0,30,30
1658127969691,MATH 10A,A01,083735,Patchell; Gregory David,2,0,30,28
1658127969691,MATH 10A,A02,083736,Patchell; Gregory David,20,0,30,10
1658127969691,MATH 10A,A03,083737,Patchell; Gregory David,16,0,30,14
1658127975718,MATH 10B,A01,083207,Lim; Seonhee,9,0,34,25
1658127975718,MATH 10B,A02,083208,Lim; Seonhee,10,0,35,25
1658127975718,MATH 10B,A03,093472,Lim; Seonhee,7,0,34,27
1658127975718,MATH 10B,B01,083739,Sinha; Shubham,14,0,30,16
1658127981753,MATH 18,A01,083743,Cinel; Cameron Alexander,9,0,30,21
1658127981753,MATH 18,A02,083744,Cinel; Cameron Alexander,18,0,30,12
1658127981753,MATH 18,A03,083745,Cinel; Cameron Alexander,10,0,30,20
1658127981753,MATH 18,B01,083748,Rideout; David Porter,5,0,37,32
1658127981753,MATH 18,B02,083749,Rideout; David Porter,5,0,36,31
1658127981753,MATH 18,B03,083750,Rideout; David Porter,3,0,37,34
1658127981753,MATH 18,B04,083751,Rideout; David Porter,7,0,36,29
1658127981753,MATH 18,B05,093473,Rideout; David Porter,7,0,36,29
1658127981753,MATH 18,B06,093474,Rideout; David Porter,6,0,36,30
1658127987777,MATH 20A,A01,083754,Zheng; Zequn,14,0,40,26
1658127993801,MATH 20B,A01,083756,Briones; Jor-el Thomas Caparas,4,0,36,32
1658127993801,MATH 20B,A02,083757,Briones; Jor-el Thomas Caparas,1,0,36,35
1658127993801,MATH 20B,A03,093475,Briones; Jor-el Thomas Caparas,3,0,36,33
1658127999836,MATH 20C,A01,083760,Briones; Jor-el Thomas Caparas,1,0,35,34
1658127999836,MATH 20C,A02,083761,Briones; Jor-el Thomas Caparas,8,0,35,27
1658127999836,MATH 20C,A03,093476,Briones; Jor-el Thomas Caparas,0,1,36,36
1658127999836,MATH 20C,B01,083762,Bach; Quang Tran,1,0,30,29
1658128005864,MATH 20D,A01,083765,Tran; Brian Kha,5,0,30,25
1658128005864,MATH 20D,A02,083766,Tran; Brian Kha,5,0,30,25
1658128005864,MATH 20D,A03,083767,Tran; Brian Kha,6,0,30,24
1658128011888,MATH 20E,A01,083771,Ganguly; Soumya,12,0,32,20
1658128011888,MATH 20E,A02,083772,Ganguly; Soumya,7,0,32,25
1658128011888,MATH 20E,B01,083773,Ciotti; Benjamin,20,0,35,15
1658128011888,MATH 20E,B02,083774,Ciotti; Benjamin,18,0,35,17
1658128017913,MATH 103A,A01,083777,Greenfeld; Be'Eri,6,0,36,30
1658128017913,MATH 103A,A02,083778,Greenfeld; Be'Eri,5,0,36,31
1658128017913,MATH 103A,A03,093561,Greenfeld; Be'Eri,7,0,36,29
1658128017913,MATH 103A,B01,083779,Greenfeld; Be'Eri,8,0,36,28
1658128017913,MATH 103A,B02,083780,Greenfeld; Be'Eri,4,0,36,32
1658128017913,MATH 103A,B03,093562,Greenfeld; Be'Eri,3,0,36,33
1658128023945,MATH 105,A01,085443,Carter; Anne Toulson,15,0,35,20
1658128023945,MATH 105,A02,093477,Carter; Anne Toulson,20,0,35,15
1658128029977,MATH 109,A01,083213,Ganzberger; Geoffrey Michael,3,0,34,31
1658128029977,MATH 109,A02,083214,Ganzberger; Geoffrey Michael,4,0,34,30
1658128029977,MATH 109,A03,093478,Ganzberger; Geoffrey Michael,2,0,34,32
1658128029977,MATH 109,B01,083215,Ganzberger; Geoffrey Michael,3,0,32,29
1658128029977,MATH 109,B02,083216,Ganzberger; Geoffrey Michael,3,0,32,29
1658128029977,MATH 109,B03,093479,Ganzberger; Geoffrey Michael,8,0,32,24
1658128036002,MATH 142A,A01,083219,Chow; Bennett,7,0,32,25
1658128036002,MATH 142A,A02,083220,Chow; Bennett,10,0,32,22
1658128036002,MATH 142A,A03,093480,Chow; Bennett,9,0,32,23
1658128036002,MATH 142A,B03,093481,Chow; Bennett,8,0,32,24
1658128036002,MATH 142A,B04,093558,Chow; Bennett,14,0,32,18
1658128036002,MATH 142A,B05,093559,Chow; Bennett,7,0,32,25
1658128042033,MATH 193A,A01,083224,Rotar; Vladimir,9,0,34,25
1658128042033,MATH 193A,A02,083225,Rotar; Vladimir,11,0,34,23
1658128042033,MATH 193A,A03,083781,Rotar; Vladimir,5,0,34,29
1658128042033,MATH 193A,A04,083782,Rotar; Vladimir,12,0,34,22
1658128042033,MATH 193A,A05,093482,Rotar; Vladimir,11,0,34,23
1658128048056,MATH 197,001,091859,McAuley; Julian John,9999,0,9999,0
1658128048056,MATH 197,002,095566,Kedlaya; Kiran S.,9997,0,9999,2
1658128048056,MATH 197,003,095567,Xiao; Ming,9999,0,9999,0
1658128048056,MATH 197,004,095571,Perols; Johan Lars,9998,0,9999,1
1658128055120,COGS 9,A01,083615,Shannon; Kyle Michael,11,0,75,64
1658128061144,COGS 11,A01,083617,Boyle; Mary E. T.,23,0,48,25
1658128067169,COGS 13,A01,083071,Bastos; Amalia Pinkusfeld,12,0,71,59
1658128073196,COGS 14A,A01,092681,Semenuks; Arturs,5,1,100,95
1658128079225,COGS 14B,A01,083073,Cheng; Tzu-Han,7,0,63,56
1658128085249,COGS 17,A01,092677,Semenuks; Arturs,7,0,81,74
1658128091285,COGS 100,A01,083619,Allen; Michael Gordon,17,0,70,53
1658128097315,COGS 101A,A01,083621,Davis; Joshua Daniel,9,0,68,59
1658128103340,COGS 101B,A01,091572,Allen; Michael Gordon,14,0,65,51
1658128109364,COGS 101C,A01,083625,Delgado; Tania,17,0,35,18
1658128115388,COGS 107A,A01,083627,Boyle; Mary E. T.,14,0,60,46
1658128121414,COGS 118A,A01,083075,Gupta; Anjum,21,0,76,55
1658128127440,CSE 3,A50,083646,Miranda; Gregory Joseph,24,0,50,26
1658128133464,CSE 8A,A50,083650,Miranda; Gregory Joseph,17,1,56,39
1658128139499,CSE 11,A01,083080,Cao; Yingjun,7,15,40,33
1658128145524,CSE 12,A01,083652,Krause-Levy; Sophia Louisa,30,1,120,90
1658128151563,CSE 15L,A01,083654,Morris; Justin Loren,9,0,50,41
1658128151563,CSE 15L,A02,083655,Morris; Justin Loren,11,0,50,39
1658128157586,CSE 20,A01,083657,Tran; Khoa Dang,39,0,80,41
1658128163613,CSE 21,A01,095574,Bach; Quang Tran,23,0,48,25
1658128169644,CSE 30,A01,083084,Eldon; John,8,0,80,72
1658128169644,CSE 30,B01,095061,Bhaskar; Nishant,9,0,50,41
1658128175672,CSE 100,A01,083659,Cao; Yingjun,5,4,70,65
1658128181696,CSE 134B,A01,083661,Powell; Thomas Allan,25,0,100,75
1658128187719,CSE 140,A01,083663,Gungor; Onat,17,0,85,68
1658128193744,CSE 140L,A01,083088,Eldon; John,23,0,100,77
1658128199769,CSE 175,A01,083665,Kumar; Rakesh,3,0,25,22
1658128205794,CSE 190,A00,092507,Dubnov; Shlomo,8,0,20,12
1658128211819,ECE 45,A01,083139,Congero; Spencer William,7,0,75,68
1658128217843,ECE 65,A50,083695,Saad; Andrew S,12,0,30,18
1658128217843,ECE 65,A51,095125,Saad; Andrew S,24,0,26,2
1658128223871,ECE 109,A01,091882,Touri; Behrouz,21,0,70,49
1658128229897,ECE 180,A00,083140,Abi Samra; Nicholas Camill,1,0,30,29
1658128229897,ECE 180,B00,083141,Abi Samra; Nicholas Camill,0,0,30,30
1658128235927,MATH 10A,A01,083735,Patchell; Gregory David,2,0,30,28
1658128235927,MATH 10A,A02,083736,Patchell; Gregory David,20,0,30,10
1658128235927,MATH 10A,A03,083737,Patchell; Gregory David,16,0,30,14
1658128241957,MATH 10B,A01,083207,Lim; Seonhee,9,0,34,25
1658128241957,MATH 10B,A02,083208,Lim; Seonhee,10,0,35,25
1658128241957,MATH 10B,A03,093472,Lim; Seonhee,7,0,34,27
1658128241957,MATH 10B,B01,083739,Sinha; Shubham,14,0,30,16
1658128247986,MATH 18,A01,083743,Cinel; Cameron Alexander,9,0,30,21
1658128247986,MATH 18,A02,083744,Cinel; Cameron Alexander,18,0,30,12
1658128247986,MATH 18,A03,083745,Cinel; Cameron Alexander,10,0,30,20
1658128247986,MATH 18,B01,083748,Rideout; David Porter,5,0,37,32
1658128247986,MATH 18,B02,083749,Rideout; David Porter,5,0,36,31
1658128247986,MATH 18,B03,083750,Rideout; David Porter,3,0,37,34
1658128247986,MATH 18,B04,083751,Rideout; David Porter,7,0,36,29
1658128247986,MATH 18,B05,093473,Rideout; David Porter,7,0,36,29
1658128247986,MATH 18,B06,093474,Rideout; David Porter,6,0,36,30
1658128254010,MATH 20A,A01,083754,Zheng; Zequn,14,0,40,26
1658128260035,MATH 20B,A01,083756,Briones; Jor-el Thomas Caparas,4,0,36,32
1658128260035,MATH 20B,A02,083757,Briones; Jor-el Thomas Caparas,1,0,36,35
1658128260035,MATH 20B,A03,093475,Briones; Jor-el Thomas Caparas,3,0,36,33
1658128266065,MATH 20C,A01,083760,Briones; Jor-el Thomas Caparas,1,0,35,34
1658128266065,MATH 20C,A02,083761,Briones; Jor-el Thomas Caparas,8,0,35,27
1658128266065,MATH 20C,A03,093476,Briones; Jor-el Thomas Caparas,0,1,36,36
1658128266065,MATH 20C,B01,083762,Bach; Quang Tran,1,0,30,29
1658128272127,MATH 20D,A01,083765,Tran; Brian Kha,5,0,30,25
1658128272127,MATH 20D,A02,083766,Tran; Brian Kha,5,0,30,25
1658128272127,MATH 20D,A03,083767,Tran; Brian Kha,6,0,30,24
1658128278152,MATH 20E,A01,083771,Ganguly; Soumya,12,0,32,20
1658128278152,MATH 20E,A02,083772,Ganguly; Soumya,7,0,32,25
1658128278152,MATH 20E,B01,083773,Ciotti; Benjamin,20,0,35,15
1658128278152,MATH 20E,B02,083774,Ciotti; Benjamin,18,0,35,17
1658128284189,MATH 103A,A01,083777,Greenfeld; Be'Eri,6,0,36,30
1658128284189,MATH 103A,A02,083778,Greenfeld; Be'Eri,5,0,36,31
1658128284189,MATH 103A,A03,093561,Greenfeld; Be'Eri,7,0,36,29
1658128284189,MATH 103A,B01,083779,Greenfeld; Be'Eri,8,0,36,28
1658128284189,MATH 103A,B02,083780,Greenfeld; Be'Eri,4,0,36,32
1658128284189,MATH 103A,B03,093562,Greenfeld; Be'Eri,3,0,36,33
1658128290228,MATH 105,A01,085443,Carter; Anne Toulson,15,0,35,20
1658128290228,MATH 105,A02,093477,Carter; Anne Toulson,20,0,35,15
1658128296291,MATH 109,A01,083213,Ganzberger; Geoffrey Michael,3,0,34,31
1658128296291,MATH 109,A02,083214,Ganzberger; Geoffrey Michael,4,0,34,30
1658128296291,MATH 109,A03,093478,Ganzberger; Geoffrey Michael,2,0,34,32
1658128296291,MATH 109,B01,083215,Ganzberger; Geoffrey Michael,3,0,32,29
1658128296291,MATH 109,B02,083216,Ganzberger; Geoffrey Michael,3,0,32,29
1658128296291,MATH 109,B03,093479,Ganzberger; Geoffrey Michael,8,0,32,24
1658128302329,MATH 142A,A01,083219,Chow; Bennett,7,0,32,25
1658128302329,MATH 142A,A02,083220,Chow; Bennett,10,0,32,22
1658128302329,MATH 142A,A03,093480,Chow; Bennett,9,0,32,23
1658128302329,MATH 142A,B03,093481,Chow; Bennett,8,0,32,24
1658128302329,MATH 142A,B04,093558,Chow; Bennett,14,0,32,18
1658128302329,MATH 142A,B05,093559,Chow; Bennett,7,0,32,25
1658128308370,MATH 193A,A01,083224,Rotar; Vladimir,9,0,34,25
1658128308370,MATH 193A,A02,083225,Rotar; Vladimir,11,0,34,23
1658128308370,MATH 193A,A03,083781,Rotar; Vladimir,5,0,34,29
1658128308370,MATH 193A,A04,083782,Rotar; Vladimir,12,0,34,22
1658128308370,MATH 193A,A05,093482,Rotar; Vladimir,11,0,34,23
1658128314394,MATH 197,001,091859,McAuley; Julian John,9999,0,9999,0
1658128314394,MATH 197,002,095566,Kedlaya; Kiran S.,9997,0,9999,2
1658128314394,MATH 197,003,095567,Xiao; Ming,9999,0,9999,0
1658128314394,MATH 197,004,095571,Perols; Johan Lars,9998,0,9999,1
1658128321567,COGS 9,A01,083615,Shannon; Kyle Michael,11,0,75,64
1658128327592,COGS 11,A01,083617,Boyle; Mary E. T.,23,0,48,25
1658128333619,COGS 13,A01,083071,Bastos; Amalia Pinkusfeld,12,0,71,59
1658128339649,COGS 14A,A01,092681,Semenuks; Arturs,5,1,100,95
1658128345673,COGS 14B,A01,083073,Cheng; Tzu-Han,7,0,63,56
1658128351696,COGS 17,A01,092677,Semenuks; Arturs,7,0,81,74
1658128357723,COGS 100,A01,083619,Allen; Michael Gordon,17,0,70,53
1658128363752,COGS 101A,A01,083621,Davis; Joshua Daniel,9,0,68,59
1658128369776,COGS 101B,A01,091572,Allen; Michael Gordon,14,0,65,51
1658128375800,COGS 101C,A01,083625,Delgado; Tania,17,0,35,18
1658128381832,COGS 107A,A01,083627,Boyle; Mary E. T.,14,0,60,46
1658128387854,COGS 118A,A01,083075,Gupta; Anjum,21,0,76,55
1658128393882,CSE 3,A50,083646,Miranda; Gregory Joseph,24,0,50,26
1658128399905,CSE 8A,A50,083650,Miranda; Gregory Joseph,17,1,56,39
1658128405930,CSE 11,A01,083080,Cao; Yingjun,7,15,40,33
1658128411959,CSE 12,A01,083652,Krause-Levy; Sophia Louisa,30,1,120,90
1658128417987,CSE 15L,A01,083654,Morris; Justin Loren,9,0,50,41
1658128417987,CSE 15L,A02,083655,Morris; Justin Loren,11,0,50,39
1658128424012,CSE 20,A01,083657,Tran; Khoa Dang,39,0,80,41
1658128430039,CSE 21,A01,095574,Bach; Quang Tran,23,0,48,25
1658128436067,CSE 30,A01,083084,Eldon; John,8,0,80,72
1658128436067,CSE 30,B01,095061,Bhaskar; Nishant,9,0,50,41
1658128442098,CSE 100,A01,083659,Cao; Yingjun,5,4,70,65
1658128448128,CSE 134B,A01,083661,Powell; Thomas Allan,25,0,100,75
1658128454158,CSE 140,A01,083663,Gungor; Onat,17,0,85,68
1658128460189,CSE 140L,A01,083088,Eldon; John,23,0,100,77
1658128466217,CSE 175,A01,083665,Kumar; Rakesh,3,0,25,22
1658128472245,CSE 190,A00,092507,Dubnov; Shlomo,8,0,20,12
1658128478274,ECE 45,A01,083139,Congero; Spencer William,7,0,75,68
1658128484304,ECE 65,A50,083695,Saad; Andrew S,12,0,30,18
1658128484304,ECE 65,A51,095125,Saad; Andrew S,24,0,26,2
1658128495685,ECE 109,A01,091882,Touri; Behrouz,21,0,70,49
1658128501709,ECE 180,A00,083140,Abi Samra; Nicholas Camill,1,0,30,29
1658128501709,ECE 180,B00,083141,Abi Samra; Nicholas Camill,0,0,30,30
1658128507732,MATH 10A,A01,083735,Patchell; Gregory David,2,0,30,28
1658128507732,MATH 10A,A02,083736,Patchell; Gregory David,20,0,30,10
1658128507732,MATH 10A,A03,083737,Patchell; Gregory David,16,0,30,14
1658128513763,MATH 10B,A01,083207,Lim; Seonhee,9,0,34,25
1658128513763,MATH 10B,A02,083208,Lim; Seonhee,10,0,35,25
1658128513763,MATH 10B,A03,093472,Lim; Seonhee,7,0,34,27
1658128513763,MATH 10B,B01,083739,Sinha; Shubham,14,0,30,16
1658128519804,MATH 18,A01,083743,Cinel; Cameron Alexander,9,0,30,21
1658128519804,MATH 18,A02,083744,Cinel; Cameron Alexander,18,0,30,12
1658128519804,MATH 18,A03,083745,Cinel; Cameron Alexander,10,0,30,20
1658128519804,MATH 18,B01,083748,Rideout; David Porter,5,0,37,32
1658128519804,MATH 18,B02,083749,Rideout; David Porter,5,0,36,31
1658128519804,MATH 18,B03,083750,Rideout; David Porter,3,0,37,34
1658128519804,MATH 18,B04,083751,Rideout; David Porter,7,0,36,29
1658128519804,MATH 18,B05,093473,Rideout; David Porter,7,0,36,29
1658128519804,MATH 18,B06,093474,Rideout; David Porter,6,0,36,30
1658128525827,MATH 20A,A01,083754,Zheng; Zequn,14,0,40,26
1658128531855,MATH 20B,A01,083756,Briones; Jor-el Thomas Caparas,4,0,36,32
1658128531855,MATH 20B,A02,083757,Briones; Jor-el Thomas Caparas,1,0,36,35
1658128531855,MATH 20B,A03,093475,Briones; Jor-el Thomas Caparas,3,0,36,33
1658128537884,MATH 20C,A01,083760,Briones; Jor-el Thomas Caparas,1,0,35,34
1658128537884,MATH 20C,A02,083761,Briones; Jor-el Thomas Caparas,8,0,35,27
1658128537884,MATH 20C,A03,093476,Briones; Jor-el Thomas Caparas,0,1,36,36
1658128537884,MATH 20C,B01,083762,Bach; Quang Tran,1,0,30,29
1658128543915,MATH 20D,A01,083765,Tran; Brian Kha,5,0,30,25
1658128543915,MATH 20D,A02,083766,Tran; Brian Kha,5,0,30,25
1658128543915,MATH 20D,A03,083767,Tran; Brian Kha,6,0,30,24
1658128549946,MATH 20E,A01,083771,Ganguly; Soumya,12,0,32,20
1658128549946,MATH 20E,A02,083772,Ganguly; Soumya,7,0,32,25
1658128549946,MATH 20E,B01,083773,Ciotti; Benjamin,20,0,35,15
1658128549946,MATH 20E,B02,083774,Ciotti; Benjamin,18,0,35,17
1658128555976,MATH 103A,A01,083777,Greenfeld; Be'Eri,6,0,36,30
1658128555976,MATH 103A,A02,083778,Greenfeld; Be'Eri,5,0,36,31
1658128555976,MATH 103A,A03,093561,Greenfeld; Be'Eri,7,0,36,29
1658128555976,MATH 103A,B01,083779,Greenfeld; Be'Eri,8,0,36,28
1658128555976,MATH 103A,B02,083780,Greenfeld; Be'Eri,4,0,36,32
1658128555976,MATH 103A,B03,093562,Greenfeld; Be'Eri,3,0,36,33
1658128562007,MATH 105,A01,085443,Carter; Anne Toulson,15,0,35,20
1658128562007,MATH 105,A02,093477,Carter; Anne Toulson,20,0,35,15
1658128568030,MATH 109,A01,083213,Ganzberger; Geoffrey Michael,3,0,34,31
1658128568030,MATH 109,A02,083214,Ganzberger; Geoffrey Michael,4,0,34,30
1658128568030,MATH 109,A03,093478,Ganzberger; Geoffrey Michael,2,0,34,32
1658128568030,MATH 109,B01,083215,Ganzberger; Geoffrey Michael,3,0,32,29
1658128568030,MATH 109,B02,083216,Ganzberger; Geoffrey Michael,3,0,32,29
1658128568030,MATH 109,B03,093479,Ganzberger; Geoffrey Michael,8,0,32,24
1658128574061,MATH 142A,A01,083219,Chow; Bennett,7,0,32,25
1658128574061,MATH 142A,A02,083220,Chow; Bennett,10,0,32,22
1658128574061,MATH 142A,A03,093480,Chow; Bennett,9,0,32,23
1658128574061,MATH 142A,B03,093481,Chow; Bennett,8,0,32,24
1658128574061,MATH 142A,B04,093558,Chow; Bennett,14,0,32,18
1658128574061,MATH 142A,B05,093559,Chow; Bennett,7,0,32,25
1658128580093,MATH 193A,A01,083224,Rotar; Vladimir,9,0,34,25
1658128580093,MATH 193A,A02,083225,Rotar; Vladimir,11,0,34,23
1658128580093,MATH 193A,A03,083781,Rotar; Vladimir,5,0,34,29
1658128580093,MATH 193A,A04,083782,Rotar; Vladimir,12,0,34,22
1658128580093,MATH 193A,A05,093482,Rotar; Vladimir,11,0,34,23
1658128586117,MATH 197,001,091859,McAuley; Julian John,9999,0,9999,0
1658128586117,MATH 197,002,095566,Kedlaya; Kiran S.,9997,0,9999,2
1658128586117,MATH 197,003,095567,Xiao; Ming,9999,0,9999,0
1658128586117,MATH 197,004,095571,Perols; Johan Lars,9998,0,9999,1
1658128593179,COGS 9,A01,083615,Shannon; Kyle Michael,11,0,75,64
1658128599207,COGS 11,A01,083617,Boyle; Mary E. T.,23,0,48,25
1658128605230,COGS 13,A01,083071,Bastos; Amalia Pinkusfeld,12,0,71,59
1658128611270,COGS 14A,A01,092681,Semenuks; Arturs,5,1,100,95
1658128617301,COGS 14B,A01,083073,Cheng; Tzu-Han,7,0,63,56
1658128623326,COGS 17,A01,092677,Semenuks; Arturs,7,0,81,74
1658128629350,COGS 100,A01,083619,Allen; Michael Gordon,17,0,70,53
1658128635380,COGS 101A,A01,083621,Davis; Joshua Daniel,9,0,68,59
1658128641404,COGS 101B,A01,091572,Allen; Michael Gordon,14,0,65,51
1658128647429,COGS 101C,A01,083625,Delgado; Tania,17,0,35,18
1658128653452,COGS 107A,A01,083627,Boyle; Mary E. T.,14,0,60,46
1658128659483,COGS 118A,A01,083075,Gupta; Anjum,21,0,76,55
1658128665511,CSE 3,A50,083646,Miranda; Gregory Joseph,24,0,50,26
1658128671539,CSE 8A,A50,083650,Miranda; Gregory Joseph,17,1,56,39
1658128677563,CSE 11,A01,083080,Cao; Yingjun,7,15,40,33
1658128683589,CSE 12,A01,083652,Krause-Levy; Sophia Louisa,30,1,120,90
1658128689618,CSE 15L,A01,083654,Morris; Justin Loren,9,0,50,41
1658128689618,CSE 15L,A02,083655,Morris; Justin Loren,11,0,50,39
1658128695645,CSE 20,A01,083657,Tran; Khoa Dang,39,0,80,41
1658128701667,CSE 21,A01,095574,Bach; Quang Tran,23,0,48,25
1658128707694,CSE 30,A01,083084,Eldon; John,8,0,80,72
1658128707694,CSE 30,B01,095061,Bhaskar; Nishant,9,0,50,41
1658128713718,CSE 100,A01,083659,Cao; Yingjun,5,4,70,65
1658128719742,CSE 134B,A01,083661,Powell; Thomas Allan,25,0,100,75
1658128725766,CSE 140,A01,083663,Gungor; Onat,17,0,85,68
1658128731794,CSE 140L,A01,083088,Eldon; John,23,0,100,77
1658128737822,CSE 175,A01,083665,Kumar; Rakesh,3,0,25,22
1658128743844,CSE 190,A00,092507,Dubnov; Shlomo,8,0,20,12
1658128749874,ECE 45,A01,083139,Congero; Spencer William,7,0,75,68
1658128755900,ECE 65,A50,083695,Saad; Andrew S,12,0,30,18
1658128755900,ECE 65,A51,095125,Saad; Andrew S,24,0,26,2
1658128761928,ECE 109,A01,091882,Touri; Behrouz,21,0,70,49
1658128767951,ECE 180,A00,083140,Abi Samra; Nicholas Camill,1,0,30,29
1658128767951,ECE 180,B00,083141,Abi Samra; Nicholas Camill,0,0,30,30
1658128773974,MATH 10A,A01,083735,Patchell; Gregory David,2,0,30,28
1658128773974,MATH 10A,A02,083736,Patchell; Gregory David,20,0,30,10
1658128773974,MATH 10A,A03,083737,Patchell; Gregory David,16,0,30,14
1658128780005,MATH 10B,A01,083207,Lim; Seonhee,9,0,34,25
1658128780005,MATH 10B,A02,083208,Lim; Seonhee,10,0,35,25
1658128780005,MATH 10B,A03,093472,Lim; Seonhee,7,0,34,27
1658128780005,MATH 10B,B01,083739,Sinha; Shubham,14,0,30,16
1658128786030,MATH 18,A01,083743,Cinel; Cameron Alexander,9,0,30,21
1658128786030,MATH 18,A02,083744,Cinel; Cameron Alexander,18,0,30,12
1658128786030,MATH 18,A03,083745,Cinel; Cameron Alexander,10,0,30,20
1658128786030,MATH 18,B01,083748,Rideout; David Porter,5,0,37,32
1658128786030,MATH 18,B02,083749,Rideout; David Porter,5,0,36,31
1658128786030,MATH 18,B03,083750,Rideout; David Porter,3,0,37,34
1658128786030,MATH 18,B04,083751,Rideout; David Porter,7,0,36,29
1658128786030,MATH 18,B05,093473,Rideout; David Porter,7,0,36,29
1658128786030,MATH 18,B06,093474,Rideout; David Porter,6,0,36,30
1658128792055,MATH 20A,A01,083754,Zheng; Zequn,14,0,40,26
1658128798079,MATH 20B,A01,083756,Briones; Jor-el Thomas Caparas,4,0,36,32
1658128798079,MATH 20B,A02,083757,Briones; Jor-el Thomas Caparas,1,0,36,35
1658128798079,MATH 20B,A03,093475,Briones; Jor-el Thomas Caparas,3,0,36,33
1658128804108,MATH 20C,A01,083760,Briones; Jor-el Thomas Caparas,1,0,35,34
1658128804108,MATH 20C,A02,083761,Briones; Jor-el Thomas Caparas,8,0,35,27
1658128804108,MATH 20C,A03,093476,Briones; Jor-el Thomas Caparas,0,1,36,36
1658128804108,MATH 20C,B01,083762,Bach; Quang Tran,1,0,30,29
1658128810134,MATH 20D,A01,083765,Tran; Brian Kha,5,0,30,25
1658128810134,MATH 20D,A02,083766,Tran; Brian Kha,5,0,30,25
1658128810134,MATH 20D,A03,083767,Tran; Brian Kha,6,0,30,24
1658128816157,MATH 20E,A01,083771,Ganguly; Soumya,12,0,32,20
1658128816157,MATH 20E,A02,083772,Ganguly; Soumya,7,0,32,25
1658128816157,MATH 20E,B01,083773,Ciotti; Benjamin,20,0,35,15
1658128816157,MATH 20E,B02,083774,Ciotti; Benjamin,18,0,35,17
1658128822183,MATH 103A,A01,083777,Greenfeld; Be'Eri,6,0,36,30
1658128822183,MATH 103A,A02,083778,Greenfeld; Be'Eri,5,0,36,31
1658128822183,MATH 103A,A03,093561,Greenfeld; Be'Eri,7,0,36,29
1658128822183,MATH 103A,B01,083779,Greenfeld; Be'Eri,8,0,36,28
1658128822183,MATH 103A,B02,083780,Greenfeld; Be'Eri,4,0,36,32
1658128822183,MATH 103A,B03,093562,Greenfeld; Be'Eri,3,0,36,33
1658128828223,MATH 105,A01,085443,Carter; Anne Toulson,15,0,35,20
1658128828223,MATH 105,A02,093477,Carter; Anne Toulson,20,0,35,15
1658128834247,MATH 109,A01,083213,Ganzberger; Geoffrey Michael,3,0,34,31
1658128834247,MATH 109,A02,083214,Ganzberger; Geoffrey Michael,4,0,34,30
1658128834247,MATH 109,A03,093478,Ganzberger; Geoffrey Michael,2,0,34,32
1658128834247,MATH 109,B01,083215,Ganzberger; Geoffrey Michael,3,0,32,29
1658128834247,MATH 109,B02,083216,Ganzberger; Geoffrey Michael,3,0,32,29
1658128834247,MATH 109,B03,093479,Ganzberger; Geoffrey Michael,8,0,32,24
1658128840280,MATH 142A,A01,083219,Chow; Bennett,7,0,32,25
1658128840280,MATH 142A,A02,083220,Chow; Bennett,10,0,32,22
1658128840280,MATH 142A,A03,093480,Chow; Bennett,9,0,32,23
1658128840280,MATH 142A,B03,093481,Chow; Bennett,8,0,32,24
1658128840280,MATH 142A,B04,093558,Chow; Bennett,14,0,32,18
1658128840280,MATH 142A,B05,093559,Chow; Bennett,7,0,32,25
1658128846312,MATH 193A,A01,083224,Rotar; Vladimir,9,0,34,25
1658128846312,MATH 193A,A02,083225,Rotar; Vladimir,11,0,34,23
1658128846312,MATH 193A,A03,083781,Rotar; Vladimir,5,0,34,29
1658128846312,MATH 193A,A04,083782,Rotar; Vladimir,12,0,34,22
1658128846312,MATH 193A,A05,093482,Rotar; Vladimir,11,0,34,23
1658128852339,MATH 197,001,091859,McAuley; Julian John,9999,0,9999,0
1658128852339,MATH 197,002,095566,Kedlaya; Kiran S.,9997,0,9999,2
1658128852339,MATH 197,003,095567,Xiao; Ming,9999,0,9999,0
1658128852339,MATH 197,004,095571,Perols; Johan Lars,9998,0,9999,1
1658128859421,COGS 9,A01,083615,Shannon; Kyle Michael,11,0,75,64
1658128865448,COGS 11,A01,083617,Boyle; Mary E. T.,23,0,48,25
1658128871476,COGS 13,A01,083071,Bastos; Amalia Pinkusfeld,12,0,71,59
1658128877502,COGS 14A,A01,092681,Semenuks; Arturs,5,1,100,95
1658128883534,COGS 14B,A01,083073,Cheng; Tzu-Han,7,0,63,56
1658128889557,COGS 17,A01,092677,Semenuks; Arturs,7,0,81,74
1658128895582,COGS 100,A01,083619,Allen; Michael Gordon,17,0,70,53
1658128901610,COGS 101A,A01,083621,Davis; Joshua Daniel,9,0,68,59
1658128907637,COGS 101B,A01,091572,Allen; Michael Gordon,14,0,65,51
1658128913661,COGS 101C,A01,083625,Delgado; Tania,17,0,35,18
1658128919685,COGS 107A,A01,083627,Boyle; Mary E. T.,14,0,60,46
1658128925795,COGS 118A,A01,083075,Gupta; Anjum,21,0,76,55
1658128931823,CSE 3,A50,083646,Miranda; Gregory Joseph,24,0,50,26
1658128937847,CSE 8A,A50,083650,Miranda; Gregory Joseph,17,1,56,39
1658128943874,CSE 11,A01,083080,Cao; Yingjun,7,15,40,33
1658128949909,CSE 12,A01,083652,Krause-Levy; Sophia Louisa,30,1,120,90
1658128955933,CSE 15L,A01,083654,Morris; Justin Loren,9,0,50,41
1658128955933,CSE 15L,A02,083655,Morris; Justin Loren,11,0,50,39
1658128961956,CSE 20,A01,083657,Tran; Khoa Dang,39,0,80,41
1658128967996,CSE 21,A01,095574,Bach; Quang Tran,23,0,48,25
1658128974042,CSE 30,A01,083084,Eldon; John,8,0,80,72
1658128974042,CSE 30,B01,095061,Bhaskar; Nishant,9,0,50,41
1658128980071,CSE 100,A01,083659,Cao; Yingjun,5,4,70,65
1658128986098,CSE 134B,A01,083661,Powell; Thomas Allan,25,0,100,75
1658128992121,CSE 140,A01,083663,Gungor; Onat,17,0,85,68
1658128998144,CSE 140L,A01,083088,Eldon; John,23,0,100,77
1658129004167,CSE 175,A01,083665,Kumar; Rakesh,3,0,25,22
1658129010217,CSE 190,A00,092507,Dubnov; Shlomo,8,0,20,12
1658129016241,ECE 45,A01,083139,Congero; Spencer William,7,0,75,68
1658129022265,ECE 65,A50,083695,Saad; Andrew S,12,0,30,18
1658129022265,ECE 65,A51,095125,Saad; Andrew S,24,0,26,2
1658129028293,ECE 109,A01,091882,Touri; Behrouz,21,0,70,49
1658129034318,ECE 180,A00,083140,Abi Samra; Nicholas Camill,1,0,30,29
1658129034318,ECE 180,B00,083141,Abi Samra; Nicholas Camill,0,0,30,30
1658129040343,MATH 10A,A01,083735,Patchell; Gregory David,2,0,30,28
1658129040343,MATH 10A,A02,083736,Patchell; Gregory David,20,0,30,10
1658129040343,MATH 10A,A03,083737,Patchell; Gregory David,16,0,30,14
1658129046375,MATH 10B,A01,083207,Lim; Seonhee,9,0,34,25
1658129046375,MATH 10B,A02,083208,Lim; Seonhee,10,0,35,25
1658129046375,MATH 10B,A03,093472,Lim; Seonhee,7,0,34,27
1658129046375,MATH 10B,B01,083739,Sinha; Shubham,14,0,30,16
1658129052405,MATH 18,A01,083743,Cinel; Cameron Alexander,9,0,30,21
1658129052405,MATH 18,A02,083744,Cinel; Cameron Alexander,18,0,30,12
1658129052405,MATH 18,A03,083745,Cinel; Cameron Alexander,10,0,30,20
1658129052405,MATH 18,B01,083748,Rideout; David Porter,5,0,37,32
1658129052405,MATH 18,B02,083749,Rideout; David Porter,5,0,36,31
1658129052405,MATH 18,B03,083750,Rideout; David Porter,3,0,37,34
1658129052405,MATH 18,B04,083751,Rideout; David Porter,7,0,36,29
1658129052405,MATH 18,B05,093473,Rideout; David Porter,7,0,36,29
1658129052405,MATH 18,B06,093474,Rideout; David Porter,6,0,36,30
1658129058428,MATH 20A,A01,083754,Zheng; Zequn,14,0,40,26
1658129064456,MATH 20B,A01,083756,Briones; Jor-el Thomas Caparas,4,0,36,32
1658129064456,MATH 20B,A02,083757,Briones; Jor-el Thomas Caparas,1,0,36,35
1658129064456,MATH 20B,A03,093475,Briones; Jor-el Thomas Caparas,3,0,36,33
1658129070484,MATH 20C,A01,083760,Briones; Jor-el Thomas Caparas,1,0,35,34
1658129070484,MATH 20C,A02,083761,Briones; Jor-el Thomas Caparas,8,0,35,27
1658129070484,MATH 20C,A03,093476,Briones; Jor-el Thomas Caparas,0,1,36,36
1658129070484,MATH 20C,B01,083762,Bach; Quang Tran,1,0,30,29
1658129076508,MATH 20D,A01,083765,Tran; Brian Kha,5,0,30,25
1658129076508,MATH 20D,A02,083766,Tran; Brian Kha,5,0,30,25
1658129076508,MATH 20D,A03,083767,Tran; Brian Kha,6,0,30,24
1658129082532,MATH 20E,A01,083771,Ganguly; Soumya,12,0,32,20
1658129082532,MATH 20E,A02,083772,Ganguly; Soumya,7,0,32,25
1658129082532,MATH 20E,B01,083773,Ciotti; Benjamin,20,0,35,15
1658129082532,MATH 20E,B02,083774,Ciotti; Benjamin,18,0,35,17
1658129088557,MATH 103A,A01,083777,Greenfeld; Be'Eri,6,0,36,30
1658129088557,MATH 103A,A02,083778,Greenfeld; Be'Eri,5,0,36,31
1658129088557,MATH 103A,A03,093561,Greenfeld; Be'Eri,7,0,36,29
1658129088557,MATH 103A,B01,083779,Greenfeld; Be'Eri,8,0,36,28
1658129088557,MATH 103A,B02,083780,Greenfeld; Be'Eri,4,0,36,32
1658129088557,MATH 103A,B03,093562,Greenfeld; Be'Eri,3,0,36,33
1658129094586,MATH 105,A01,085443,Carter; Anne Toulson,15,0,35,20
1658129094586,MATH 105,A02,093477,Carter; Anne Toulson,20,0,35,15
1658129100616,MATH 109,A01,083213,Ganzberger; Geoffrey Michael,3,0,34,31
1658129100616,MATH 109,A02,083214,Ganzberger; Geoffrey Michael,4,0,34,30
1658129100616,MATH 109,A03,093478,Ganzberger; Geoffrey Michael,2,0,34,32
1658129100616,MATH 109,B01,083215,Ganzberger; Geoffrey Michael,3,0,32,29
1658129100616,MATH 109,B02,083216,Ganzberger; Geoffrey Michael,3,0,32,29
1658129100616,MATH 109,B03,093479,Ganzberger; Geoffrey Michael,8,0,32,24
1658129106640,MATH 142A,A01,083219,Chow; Bennett,7,0,32,25
1658129106640,MATH 142A,A02,083220,Chow; Bennett,10,0,32,22
1658129106640,MATH 142A,A03,093480,Chow; Bennett,9,0,32,23
1658129106640,MATH 142A,B03,093481,Chow; Bennett,8,0,32,24
1658129106640,MATH 142A,B04,093558,Chow; Bennett,14,0,32,18
1658129106640,MATH 142A,B05,093559,Chow; Bennett,7,0,32,25
1658129112670,MATH 193A,A01,083224,Rotar; Vladimir,9,0,34,25
1658129112670,MATH 193A,A02,083225,Rotar; Vladimir,11,0,34,23
1658129112670,MATH 193A,A03,083781,Rotar; Vladimir,5,0,34,29
1658129112670,MATH 193A,A04,083782,Rotar; Vladimir,12,0,34,22
1658129112670,MATH 193A,A05,093482,Rotar; Vladimir,11,0,34,23
1658129118694,MATH 197,001,091859,McAuley; Julian John,9999,0,9999,0
1658129118694,MATH 197,002,095566,Kedlaya; Kiran S.,9997,0,9999,2
1658129118694,MATH 197,003,095567,Xiao; Ming,9999,0,9999,0
1658129118694,MATH 197,004,095571,Perols; Johan Lars,9998,0,9999,1
1658129125761,COGS 9,A01,083615,Shannon; Kyle Michael,11,0,75,64
1658129131787,COGS 11,A01,083617,Boyle; Mary E. T.,23,0,48,25
1658129137808,COGS 13,A01,083071,Bastos; Amalia Pinkusfeld,12,0,71,59
1658129143831,COGS 14A,A01,092681,Semenuks; Arturs,5,1,100,95
1658129149854,COGS 14B,A01,083073,Cheng; Tzu-Han,7,0,63,56
1658129155882,COGS 17,A01,092677,Semenuks; Arturs,7,0,81,74
1658129161907,COGS 100,A01,083619,Allen; Michael Gordon,17,0,70,53
1658129167932,COGS 101A,A01,083621,Davis; Joshua Daniel,9,0,68,59
1658129173955,COGS 101B,A01,091572,Allen; Michael Gordon,14,0,65,51
1658129179980,COGS 101C,A01,083625,Delgado; Tania,17,0,35,18
1658129186004,COGS 107A,A01,083627,Boyle; Mary E. T.,14,0,60,46
1658129192026,COGS 118A,A01,083075,Gupta; Anjum,21,0,76,55
1658129198051,CSE 3,A50,083646,Miranda; Gregory Joseph,24,0,50,26
1658129204079,CSE 8A,A50,083650,Miranda; Gregory Joseph,17,1,56,39
1658129210102,CSE 11,A01,083080,Cao; Yingjun,7,15,40,33
1658129216136,CSE 12,A01,083652,Krause-Levy; Sophia Louisa,30,1,120,90
1658129222164,CSE 15L,A01,083654,Morris; Justin Loren,9,0,50,41
1658129222164,CSE 15L,A02,083655,Morris; Justin Loren,11,0,50,39
1658129228194,CSE 20,A01,083657,Tran; Khoa Dang,39,0,80,41
1658129234219,CSE 21,A01,095574,Bach; Quang Tran,23,0,48,25
1658129240254,CSE 30,A01,083084,Eldon; John,8,0,80,72
1658129240254,CSE 30,B01,095061,Bhaskar; Nishant,9,0,50,41
1658129246282,CSE 100,A01,083659,Cao; Yingjun,5,4,70,65
1658129252305,CSE 134B,A01,083661,Powell; Thomas Allan,25,0,100,75
1658129258340,CSE 140,A01,083663,Gungor; Onat,17,0,85,68
1658129264365,CSE 140L,A01,083088,Eldon; John,23,0,100,77
1658129270391,CSE 175,A01,083665,Kumar; Rakesh,3,0,25,22
1658129276415,CSE 190,A00,092507,Dubnov; Shlomo,8,0,20,12
1658129282439,ECE 45,A01,083139,Congero; Spencer William,7,0,75,68
1658129288463,ECE 65,A50,083695,Saad; Andrew S,12,0,30,18
1658129288463,ECE 65,A51,095125,Saad; Andrew S,24,0,26,2
1658129294487,ECE 109,A01,091882,Touri; Behrouz,21,0,70,49
1658129300513,ECE 180,A00,083140,Abi Samra; Nicholas Camill,1,0,30,29
1658129300513,ECE 180,B00,083141,Abi Samra; Nicholas Camill,0,0,30,30
1658129306542,MATH 10A,A01,083735,Patchell; Gregory David,2,0,30,28
1658129306542,MATH 10A,A02,083736,Patchell; Gregory David,20,0,30,10
1658129306542,MATH 10A,A03,083737,Patchell; Gregory David,16,0,30,14
1658129312565,MATH 10B,A01,083207,Lim; Seonhee,9,0,34,25
1658129312565,MATH 10B,A02,083208,Lim; Seonhee,10,0,35,25
1658129312565,MATH 10B,A03,093472,Lim; Seonhee,7,0,34,27
1658129312565,MATH 10B,B01,083739,Sinha; Shubham,14,0,30,16
1658129318590,MATH 18,A01,083743,Cinel; Cameron Alexander,9,0,30,21
1658129318590,MATH 18,A02,083744,Cinel; Cameron Alexander,18,0,30,12
1658129318590,MATH 18,A03,083745,Cinel; Cameron Alexander,10,0,30,20
1658129318590,MATH 18,B01,083748,Rideout; David Porter,5,0,37,32
1658129318590,MATH 18,B02,083749,Rideout; David Porter,5,0,36,31
1658129318590,MATH 18,B03,083750,Rideout; David Porter,3,0,37,34
1658129318590,MATH 18,B04,083751,Rideout; David Porter,7,0,36,29
1658129318590,MATH 18,B05,093473,Rideout; David Porter,7,0,36,29
1658129318590,MATH 18,B06,093474,Rideout; David Porter,6,0,36,30
1658129324619,MATH 20A,A01,083754,Zheng; Zequn,14,0,40,26
1658129330648,MATH 20B,A01,083756,Briones; Jor-el Thomas Caparas,4,0,36,32
1658129330648,MATH 20B,A02,083757,Briones; Jor-el Thomas Caparas,1,0,36,35
1658129330648,MATH 20B,A03,093475,Briones; Jor-el Thomas Caparas,3,0,36,33
1658129336671,MATH 20C,A01,083760,Briones; Jor-el Thomas Caparas,1,0,35,34
1658129336671,MATH 20C,A02,083761,Briones; Jor-el Thomas Caparas,8,0,35,27
1658129336671,MATH 20C,A03,093476,Briones; Jor-el Thomas Caparas,0,1,36,36
1658129336671,MATH 20C,B01,083762,Bach; Quang Tran,1,0,30,29
1658129342711,MATH 20D,A01,083765,Tran; Brian Kha,5,0,30,25
1658129342711,MATH 20D,A02,083766,Tran; Brian Kha,5,0,30,25
1658129342711,MATH 20D,A03,083767,Tran; Brian Kha,6,0,30,24
1658129348735,MATH 20E,A01,083771,Ganguly; Soumya,12,0,32,20
1658129348735,MATH 20E,A02,083772,Ganguly; Soumya,7,0,32,25
1658129348735,MATH 20E,B01,083773,Ciotti; Benjamin,20,0,35,15
1658129348735,MATH 20E,B02,083774,Ciotti; Benjamin,18,0,35,17
1658129354759,MATH 103A,A01,083777,Greenfeld; Be'Eri,6,0,36,30
1658129354759,MATH 103A,A02,083778,Greenfeld; Be'Eri,5,0,36,31
1658129354759,MATH 103A,A03,093561,Greenfeld; Be'Eri,7,0,36,29
1658129354759,MATH 103A,B01,083779,Greenfeld; Be'Eri,8,0,36,28
1658129354759,MATH 103A,B02,083780,Greenfeld; Be'Eri,4,0,36,32
1658129354759,MATH 103A,B03,093562,Greenfeld; Be'Eri,3,0,36,33
1658129360786,MATH 105,A01,085443,Carter; Anne Toulson,15,0,35,20
1658129360786,MATH 105,A02,093477,Carter; Anne Toulson,20,0,35,15
1658129366810,MATH 109,A01,083213,Ganzberger; Geoffrey Michael,3,0,34,31
1658129366810,MATH 109,A02,083214,Ganzberger; Geoffrey Michael,4,0,34,30
1658129366810,MATH 109,A03,093478,Ganzberger; Geoffrey Michael,2,0,34,32
1658129366810,MATH 109,B01,083215,Ganzberger; Geoffrey Michael,3,0,32,29
1658129366810,MATH 109,B02,083216,Ganzberger; Geoffrey Michael,3,0,32,29
1658129366810,MATH 109,B03,093479,Ganzberger; Geoffrey Michael,8,0,32,24
1658129372840,MATH 142A,A01,083219,Chow; Bennett,7,0,32,25
1658129372840,MATH 142A,A02,083220,Chow; Bennett,10,0,32,22
1658129372840,MATH 142A,A03,093480,Chow; Bennett,9,0,32,23
1658129372840,MATH 142A,B03,093481,Chow; Bennett,8,0,32,24
1658129372840,MATH 142A,B04,093558,Chow; Bennett,14,0,32,18
1658129372840,MATH 142A,B05,093559,Chow; Bennett,7,0,32,25
1658129378863,MATH 193A,A01,083224,Rotar; Vladimir,9,0,34,25
1658129378863,MATH 193A,A02,083225,Rotar; Vladimir,11,0,34,23
1658129378863,MATH 193A,A03,083781,Rotar; Vladimir,5,0,34,29
1658129378863,MATH 193A,A04,083782,Rotar; Vladimir,12,0,34,22
1658129378863,MATH 193A,A05,093482,Rotar; Vladimir,11,0,34,23
1658129384889,MATH 197,001,091859,McAuley; Julian John,9999,0,9999,0
1658129384889,MATH 197,002,095566,Kedlaya; Kiran S.,9997,0,9999,2
1658129384889,MATH 197,003,095567,Xiao; Ming,9999,0,9999,0
1658129384889,MATH 197,004,095571,Perols; Johan Lars,9998,0,9999,1
1658129391951,COGS 9,A01,083615,Shannon; Kyle Michael,11,0,75,64
1658129397978,COGS 11,A01,083617,Boyle; Mary E. T.,23,0,48,25
1658129404000,COGS 13,A01,083071,Bastos; Amalia Pinkusfeld,12,0,71,59
1658129410023,COGS 14A,A01,092681,Semenuks; Arturs,5,1,100,95
1658129416046,COGS 14B,A01,083073,Cheng; Tzu-Han,7,0,63,56
1658129422075,COGS 17,A01,092677,Semenuks; Arturs,7,0,81,74
1658129428099,COGS 100,A01,083619,Allen; Michael Gordon,17,0,70,53
1658129434123,COGS 101A,A01,083621,Davis; Joshua Daniel,9,0,68,59
1658129440150,COGS 101B,A01,091572,Allen; Michael Gordon,14,0,65,51
1658129446173,COGS 101C,A01,083625,Delgado; Tania,17,0,35,18
1658129452196,COGS 107A,A01,083627,Boyle; Mary E. T.,14,0,60,46
1658129458220,COGS 118A,A01,083075,Gupta; Anjum,21,0,76,55
1658129464252,CSE 3,A50,083646,Miranda; Gregory Joseph,24,0,50,26
1658129470279,CSE 8A,A50,083650,Miranda; Gregory Joseph,17,1,56,39
1658129476307,CSE 11,A01,083080,Cao; Yingjun,7,15,40,33
1658129482331,CSE 12,A01,083652,Krause-Levy; Sophia Louisa,30,1,120,90
1658129488359,CSE 15L,A01,083654,Morris; Justin Loren,9,0,50,41
1658129488359,CSE 15L,A02,083655,Morris; Justin Loren,11,0,50,39
1658129494387,CSE 20,A01,083657,Tran; Khoa Dang,39,0,80,41
1658129500410,CSE 21,A01,095574,Bach; Quang Tran,23,0,48,25
1658129506432,CSE 30,A01,083084,Eldon; John,8,0,80,72
1658129506432,CSE 30,B01,095061,Bhaskar; Nishant,9,0,50,41
1658129512455,CSE 100,A01,083659,Cao; Yingjun,5,4,70,65
1658129518480,CSE 134B,A01,083661,Powell; Thomas Allan,25,0,100,75
1658129524599,CSE 140,A01,083663,Gungor; Onat,17,0,85,68
1658129530622,CSE 140L,A01,083088,Eldon; John,23,0,100,77
1658129536646,CSE 175,A01,083665,Kumar; Rakesh,3,0,25,22
1658129542669,CSE 190,A00,092507,Dubnov; Shlomo,8,0,20,12
1658129548697,ECE 45,A01,083139,Congero; Spencer William,7,0,75,68
1658129554835,ECE 65,A50,083695,Saad; Andrew S,12,0,30,18
1658129554835,ECE 65,A51,095125,Saad; Andrew S,24,0,26,2
1658129560857,ECE 109,A01,091882,Touri; Behrouz,21,0,70,49
1658129566884,ECE 180,A00,083140,Abi Samra; Nicholas Camill,1,0,30,29
1658129566884,ECE 180,B00,083141,Abi Samra; Nicholas Camill,0,0,30,30
1658129572913,MATH 10A,A01,083735,Patchell; Gregory David,2,0,30,28
1658129572913,MATH 10A,A02,083736,Patchell; Gregory David,20,0,30,10
1658129572913,MATH 10A,A03,083737,Patchell; Gregory David,16,0,30,14
1658129578937,MATH 10B,A01,083207,Lim; Seonhee,9,0,34,25
1658129578937,MATH 10B,A02,083208,Lim; Seonhee,10,0,35,25
1658129578937,MATH 10B,A03,093472,Lim; Seonhee,7,0,34,27
1658129578937,MATH 10B,B01,083739,Sinha; Shubham,14,0,30,16
1658129584965,MATH 18,A01,083743,Cinel; Cameron Alexander,9,0,30,21
1658129584965,MATH 18,A02,083744,Cinel; Cameron Alexander,18,0,30,12
1658129584965,MATH 18,A03,083745,Cinel; Cameron Alexander,10,0,30,20
1658129584965,MATH 18,B01,083748,Rideout; David Porter,5,0,37,32
1658129584965,MATH 18,B02,083749,Rideout; David Porter,5,0,36,31
1658129584965,MATH 18,B03,083750,Rideout; David Porter,3,0,37,34
1658129584965,MATH 18,B04,083751,Rideout; David Porter,7,0,36,29
1658129584965,MATH 18,B05,093473,Rideout; David Porter,7,0,36,29
1658129584965,MATH 18,B06,093474,Rideout; David Porter,6,0,36,30
1658129590987,MATH 20A,A01,083754,Zheng; Zequn,14,0,40,26
1658129597009,MATH 20B,A01,083756,Briones; Jor-el Thomas Caparas,4,0,36,32
1658129597009,MATH 20B,A02,083757,Briones; Jor-el Thomas Caparas,1,0,36,35
1658129597009,MATH 20B,A03,093475,Briones; Jor-el Thomas Caparas,3,0,36,33
1658129603035,MATH 20C,A01,083760,Briones; Jor-el Thomas Caparas,1,0,35,34
1658129603035,MATH 20C,A02,083761,Briones; Jor-el Thomas Caparas,8,0,35,27
1658129603035,MATH 20C,A03,093476,Briones; Jor-el Thomas Caparas,0,1,36,36
1658129603035,MATH 20C,B01,083762,Bach; Quang Tran,1,0,30,29
1658129609059,MATH 20D,A01,083765,Tran; Brian Kha,5,0,30,25
1658129609059,MATH 20D,A02,083766,Tran; Brian Kha,5,0,30,25
1658129609059,MATH 20D,A03,083767,Tran; Brian Kha,6,0,30,24
1658129615083,MATH 20E,A01,083771,Ganguly; Soumya,12,0,32,20
1658129615083,MATH 20E,A02,083772,Ganguly; Soumya,7,0,32,25
1658129615083,MATH 20E,B01,083773,Ciotti; Benjamin,20,0,35,15
1658129615083,MATH 20E,B02,083774,Ciotti; Benjamin,18,0,35,17
1658129621107,MATH 103A,A01,083777,Greenfeld; Be'Eri,6,0,36,30
1658129621107,MATH 103A,A02,083778,Greenfeld; Be'Eri,5,0,36,31
1658129621107,MATH 103A,A03,093561,Greenfeld; Be'Eri,7,0,36,29
1658129621107,MATH 103A,B01,083779,Greenfeld; Be'Eri,8,0,36,28
1658129621107,MATH 103A,B02,083780,Greenfeld; Be'Eri,4,0,36,32
1658129621107,MATH 103A,B03,093562,Greenfeld; Be'Eri,3,0,36,33
1658129627134,MATH 105,A01,085443,Carter; Anne Toulson,15,0,35,20
1658129627134,MATH 105,A02,093477,Carter; Anne Toulson,20,0,35,15
1658129633159,MATH 109,A01,083213,Ganzberger; Geoffrey Michael,3,0,34,31
1658129633159,MATH 109,A02,083214,Ganzberger; Geoffrey Michael,4,0,34,30
1658129633159,MATH 109,A03,093478,Ganzberger; Geoffrey Michael,2,0,34,32
1658129633159,MATH 109,B01,083215,Ganzberger; Geoffrey Michael,3,0,32,29
1658129633159,MATH 109,B02,083216,Ganzberger; Geoffrey Michael,3,0,32,29
1658129633159,MATH 109,B03,093479,Ganzberger; Geoffrey Michael,8,0,32,24
1658129639188,MATH 142A,A01,083219,Chow; Bennett,7,0,32,25
1658129639188,MATH 142A,A02,083220,Chow; Bennett,10,0,32,22
1658129639188,MATH 142A,A03,093480,Chow; Bennett,9,0,32,23
1658129639188,MATH 142A,B03,093481,Chow; Bennett,8,0,32,24
1658129639188,MATH 142A,B04,093558,Chow; Bennett,14,0,32,18
1658129639188,MATH 142A,B05,093559,Chow; Bennett,7,0,32,25
1658129645216,MATH 193A,A01,083224,Rotar; Vladimir,9,0,34,25
1658129645216,MATH 193A,A02,083225,Rotar; Vladimir,11,0,34,23
1658129645216,MATH 193A,A03,083781,Rotar; Vladimir,5,0,34,29
1658129645216,MATH 193A,A04,083782,Rotar; Vladimir,12,0,34,22
1658129645216,MATH 193A,A05,093482,Rotar; Vladimir,11,0,34,23
1658129651241,MATH 197,001,091859,McAuley; Julian John,9999,0,9999,0
1658129651241,MATH 197,002,095566,Kedlaya; Kiran S.,9997,0,9999,2
1658129651241,MATH 197,003,095567,Xiao; Ming,9999,0,9999,0
1658129651241,MATH 197,004,095571,Perols; Johan Lars,9998,0,9999,1
1658129658322,COGS 9,A01,083615,Shannon; Kyle Michael,11,0,75,64
1658129664350,COGS 11,A01,083617,Boyle; Mary E. T.,23,0,48,25
1658129670379,COGS 13,A01,083071,Bastos; Amalia Pinkusfeld,12,0,71,59
1658129676402,COGS 14A,A01,092681,Semenuks; Arturs,5,1,100,95
1658129682434,COGS 14B,A01,083073,Cheng; Tzu-Han,7,0,63,56
1658129688458,COGS 17,A01,092677,Semenuks; Arturs,7,0,81,74
1658129694491,COGS 100,A01,083619,Allen; Michael Gordon,17,0,70,53
1658129700518,COGS 101A,A01,083621,Davis; Joshua Daniel,9,0,68,59
1658129706545,COGS 101B,A01,091572,Allen; Michael Gordon,14,0,65,51
1658129712576,COGS 101C,A01,083625,Delgado; Tania,17,0,35,18
1658129718610,COGS 107A,A01,083627,Boyle; Mary E. T.,14,0,60,46
1658129724642,COGS 118A,A01,083075,Gupta; Anjum,21,0,76,55
1658129730670,CSE 3,A50,083646,Miranda; Gregory Joseph,24,0,50,26
1658129736706,CSE 8A,A50,083650,Miranda; Gregory Joseph,17,1,56,39
1658129742729,CSE 11,A01,083080,Cao; Yingjun,7,15,40,33
1658129748753,CSE 12,A01,083652,Krause-Levy; Sophia Louisa,30,1,120,90
1658129754782,CSE 15L,A01,083654,Morris; Justin Loren,9,0,50,41
1658129754782,CSE 15L,A02,083655,Morris; Justin Loren,11,0,50,39
1658129760810,CSE 20,A01,083657,Tran; Khoa Dang,39,0,80,41
1658129766832,CSE 21,A01,095574,Bach; Quang Tran,23,0,48,25
1658129772859,CSE 30,A01,083084,Eldon; John,8,0,80,72
1658129772859,CSE 30,B01,095061,Bhaskar; Nishant,9,0,50,41
1658129778887,CSE 100,A01,083659,Cao; Yingjun,5,4,70,65
1658129784914,CSE 134B,A01,083661,Powell; Thomas Allan,25,0,100,75
1658129790942,CSE 140,A01,083663,Gungor; Onat,17,0,85,68
1658129796968,CSE 140L,A01,083088,Eldon; John,23,0,100,77
1658129802999,CSE 175,A01,083665,Kumar; Rakesh,3,0,25,22
1658129809023,CSE 190,A00,092507,Dubnov; Shlomo,8,0,20,12
1658129815050,ECE 45,A01,083139,Congero; Spencer William,7,0,75,68
1658129821077,ECE 65,A50,083695,Saad; Andrew S,12,0,30,18
1658129821077,ECE 65,A51,095125,Saad; Andrew S,24,0,26,2
1658129827100,ECE 109,A01,091882,Touri; Behrouz,21,0,70,49
1658129833129,ECE 180,A00,083140,Abi Samra; Nicholas Camill,1,0,30,29
1658129833129,ECE 180,B00,083141,Abi Samra; Nicholas Camill,0,0,30,30
1658129839152,MATH 10A,A01,083735,Patchell; Gregory David,2,0,30,28
1658129839152,MATH 10A,A02,083736,Patchell; Gregory David,20,0,30,10
1658129839152,MATH 10A,A03,083737,Patchell; Gregory David,16,0,30,14
1658129845198,MATH 10B,A01,083207,Lim; Seonhee,9,0,34,25
1658129845198,MATH 10B,A02,083208,Lim; Seonhee,10,0,35,25
1658129845198,MATH 10B,A03,093472,Lim; Seonhee,7,0,34,27
1658129845198,MATH 10B,B01,083739,Sinha; Shubham,14,0,30,16
1658129851223,MATH 18,A01,083743,Cinel; Cameron Alexander,9,0,30,21
1658129851223,MATH 18,A02,083744,Cinel; Cameron Alexander,18,0,30,12
1658129851223,MATH 18,A03,083745,Cinel; Cameron Alexander,10,0,30,20
1658129851223,MATH 18,B01,083748,Rideout; David Porter,5,0,37,32
1658129851223,MATH 18,B02,083749,Rideout; David Porter,5,0,36,31
1658129851223,MATH 18,B03,083750,Rideout; David Porter,3,0,37,34
1658129851223,MATH 18,B04,083751,Rideout; David Porter,7,0,36,29
1658129851223,MATH 18,B05,093473,Rideout; David Porter,7,0,36,29
1658129851223,MATH 18,B06,093474,Rideout; David Porter,6,0,36,30
1658129857247,MATH 20A,A01,083754,Zheng; Zequn,14,0,40,26
1658129863276,MATH 20B,A01,083756,Briones; Jor-el Thomas Caparas,4,0,36,32
1658129863276,MATH 20B,A02,083757,Briones; Jor-el Thomas Caparas,1,0,36,35
1658129863276,MATH 20B,A03,093475,Briones; Jor-el Thomas Caparas,3,0,36,33
1658129869302,MATH 20C,A01,083760,Briones; Jor-el Thomas Caparas,1,0,35,34
1658129869302,MATH 20C,A02,083761,Briones; Jor-el Thomas Caparas,8,0,35,27
1658129869302,MATH 20C,A03,093476,Briones; Jor-el Thomas Caparas,0,1,36,36
1658129869302,MATH 20C,B01,083762,Bach; Quang Tran,1,0,30,29
1658129875329,MATH 20D,A01,083765,Tran; Brian Kha,5,0,30,25
1658129875329,MATH 20D,A02,083766,Tran; Brian Kha,5,0,30,25
1658129875329,MATH 20D,A03,083767,Tran; Brian Kha,6,0,30,24
1658129881359,MATH 20E,A01,083771,Ganguly; Soumya,12,0,32,20
1658129881359,MATH 20E,A02,083772,Ganguly; Soumya,7,0,32,25
1658129881359,MATH 20E,B01,083773,Ciotti; Benjamin,20,0,35,15
1658129881359,MATH 20E,B02,083774,Ciotti; Benjamin,18,0,35,17
1658129887387,MATH 103A,A01,083777,Greenfeld; Be'Eri,6,0,36,30
1658129887387,MATH 103A,A02,083778,Greenfeld; Be'Eri,5,0,36,31
1658129887387,MATH 103A,A03,093561,Greenfeld; Be'Eri,7,0,36,29
1658129887387,MATH 103A,B01,083779,Greenfeld; Be'Eri,8,0,36,28
1658129887387,MATH 103A,B02,083780,Greenfeld; Be'Eri,4,0,36,32
1658129887387,MATH 103A,B03,093562,Greenfeld; Be'Eri,3,0,36,33
1658129893414,MATH 105,A01,085443,Carter; Anne Toulson,15,0,35,20
1658129893414,MATH 105,A02,093477,Carter; Anne Toulson,20,0,35,15
1658129899445,MATH 109,A01,083213,Ganzberger; Geoffrey Michael,3,0,34,31
1658129899445,MATH 109,A02,083214,Ganzberger; Geoffrey Michael,4,0,34,30
1658129899445,MATH 109,A03,093478,Ganzberger; Geoffrey Michael,2,0,34,32
1658129899445,MATH 109,B01,083215,Ganzberger; Geoffrey Michael,3,0,32,29
1658129899445,MATH 109,B02,083216,Ganzberger; Geoffrey Michael,3,0,32,29
1658129899445,MATH 109,B03,093479,Ganzberger; Geoffrey Michael,8,0,32,24
1658129905477,MATH 142A,A01,083219,Chow; Bennett,7,0,32,25
1658129905477,MATH 142A,A02,083220,Chow; Bennett,10,0,32,22
1658129905477,MATH 142A,A03,093480,Chow; Bennett,9,0,32,23
1658129905477,MATH 142A,B03,093481,Chow; Bennett,8,0,32,24
1658129905477,MATH 142A,B04,093558,Chow; Bennett,14,0,32,18
1658129905477,MATH 142A,B05,093559,Chow; Bennett,7,0,32,25
1658129911506,MATH 193A,A01,083224,Rotar; Vladimir,9,0,34,25
1658129911506,MATH 193A,A02,083225,Rotar; Vladimir,11,0,34,23
1658129911506,MATH 193A,A03,083781,Rotar; Vladimir,5,0,34,29
1658129911506,MATH 193A,A04,083782,Rotar; Vladimir,12,0,34,22
1658129911506,MATH 193A,A05,093482,Rotar; Vladimir,11,0,34,23
1658129917535,MATH 197,001,091859,McAuley; Julian John,9999,0,9999,0
1658129917535,MATH 197,002,095566,Kedlaya; Kiran S.,9997,0,9999,2
1658129917535,MATH 197,003,095567,Xiao; Ming,9999,0,9999,0
1658129917535,MATH 197,004,095571,Perols; Johan Lars,9998,0,9999,1
1658129924610,COGS 9,A01,083615,Shannon; Kyle Michael,11,0,75,64
1658129930634,COGS 11,A01,083617,Boyle; Mary E. T.,23,0,48,25
1658129936662,COGS 13,A01,083071,Bastos; Amalia Pinkusfeld,12,0,71,59
1658129942690,COGS 14A,A01,092681,Semenuks; Arturs,5,1,100,95
1658129948718,COGS 14B,A01,083073,Cheng; Tzu-Han,7,0,63,56
1658129954745,COGS 17,A01,092677,Semenuks; Arturs,7,0,81,74
1658129960770,COGS 100,A01,083619,Allen; Michael Gordon,17,0,70,53
1658129966793,COGS 101A,A01,083621,Davis; Joshua Daniel,9,0,68,59
1658129972819,COGS 101B,A01,091572,Allen; Michael Gordon,14,0,65,51
1658129978856,COGS 101C,A01,083625,Delgado; Tania,17,0,35,18
1658129984883,COGS 107A,A01,083627,Boyle; Mary E. T.,14,0,60,46
1658129990919,COGS 118A,A01,083075,Gupta; Anjum,21,0,76,55
1658129996960,CSE 3,A50,083646,Miranda; Gregory Joseph,24,0,50,26
1658130002983,CSE 8A,A50,083650,Miranda; Gregory Joseph,17,1,56,39
1658130009007,CSE 11,A01,083080,Cao; Yingjun,7,15,40,33
1658130015033,CSE 12,A01,083652,Krause-Levy; Sophia Louisa,30,1,120,90
1658130021061,CSE 15L,A01,083654,Morris; Justin Loren,9,0,50,41
1658130021061,CSE 15L,A02,083655,Morris; Justin Loren,11,0,50,39
1658130027087,CSE 20,A01,083657,Tran; Khoa Dang,39,0,80,41
1658130033112,CSE 21,A01,095574,Bach; Quang Tran,23,0,48,25
1658130039139,CSE 30,A01,083084,Eldon; John,8,0,80,72
1658130039139,CSE 30,B01,095061,Bhaskar; Nishant,9,0,50,41
1658130045170,CSE 100,A01,083659,Cao; Yingjun,5,4,70,65
1658130051197,CSE 134B,A01,083661,Powell; Thomas Allan,25,0,100,75
1658130057219,CSE 140,A01,083663,Gungor; Onat,17,0,85,68
1658130063242,CSE 140L,A01,083088,Eldon; John,23,0,100,77
1658130069284,CSE 175,A01,083665,Kumar; Rakesh,3,0,25,22
1658130075315,CSE 190,A00,092507,Dubnov; Shlomo,8,0,20,12
1658130081343,ECE 45,A01,083139,Congero; Spencer William,7,0,75,68
1658130087372,ECE 65,A50,083695,Saad; Andrew S,12,0,30,18
1658130087372,ECE 65,A51,095125,Saad; Andrew S,24,0,26,2
1658130093402,ECE 109,A01,091882,Touri; Behrouz,21,0,70,49
1658130099425,ECE 180,A00,083140,Abi Samra; Nicholas Camill,1,0,30,29
1658130099425,ECE 180,B00,083141,Abi Samra; Nicholas Camill,0,0,30,30
1658130105468,MATH 10A,A01,083735,Patchell; Gregory David,2,0,30,28
1658130105468,MATH 10A,A02,083736,Patchell; Gregory David,20,0,30,10
1658130105468,MATH 10A,A03,083737,Patchell; Gregory David,16,0,30,14
1658130111523,MATH 10B,A01,083207,Lim; Seonhee,9,0,34,25
1658130111523,MATH 10B,A02,083208,Lim; Seonhee,10,0,35,25
1658130111523,MATH 10B,A03,093472,Lim; Seonhee,7,0,34,27
1658130111523,MATH 10B,B01,083739,Sinha; Shubham,14,0,30,16
1658130117554,MATH 18,A01,083743,Cinel; Cameron Alexander,9,0,30,21
1658130117554,MATH 18,A02,083744,Cinel; Cameron Alexander,18,0,30,12
1658130117554,MATH 18,A03,083745,Cinel; Cameron Alexander,10,0,30,20
1658130117554,MATH 18,B01,083748,Rideout; David Porter,5,0,37,32
1658130117554,MATH 18,B02,083749,Rideout; David Porter,5,0,36,31
1658130117554,MATH 18,B03,083750,Rideout; David Porter,3,0,37,34
1658130117554,MATH 18,B04,083751,Rideout; David Porter,7,0,36,29
1658130117554,MATH 18,B05,093473,Rideout; David Porter,7,0,36,29
1658130117554,MATH 18,B06,093474,Rideout; David Porter,6,0,36,30
1658130123651,MATH 20A,A01,083754,Zheng; Zequn,14,0,40,26
1658130129675,MATH 20B,A01,083756,Briones; Jor-el Thomas Caparas,4,0,36,32
1658130129675,MATH 20B,A02,083757,Briones; Jor-el Thomas Caparas,1,0,36,35
1658130129675,MATH 20B,A03,093475,Briones; Jor-el Thomas Caparas,3,0,36,33
1658130135699,MATH 20C,A01,083760,Briones; Jor-el Thomas Caparas,1,0,35,34
1658130135699,MATH 20C,A02,083761,Briones; Jor-el Thomas Caparas,8,0,35,27
1658130135699,MATH 20C,A03,093476,Briones; Jor-el Thomas Caparas,0,1,36,36
1658130135699,MATH 20C,B01,083762,Bach; Quang Tran,1,0,30,29
1658130141724,MATH 20D,A01,083765,Tran; Brian Kha,5,0,30,25
1658130141724,MATH 20D,A02,083766,Tran; Brian Kha,5,0,30,25
1658130141724,MATH 20D,A03,083767,Tran; Brian Kha,6,0,30,24
1658130147747,MATH 20E,A01,083771,Ganguly; Soumya,12,0,32,20
1658130147747,MATH 20E,A02,083772,Ganguly; Soumya,7,0,32,25
1658130147747,MATH 20E,B01,083773,Ciotti; Benjamin,20,0,35,15
1658130147747,MATH 20E,B02,083774,Ciotti; Benjamin,18,0,35,17
1658130153776,MATH 103A,A01,083777,Greenfeld; Be'Eri,6,0,36,30
1658130153776,MATH 103A,A02,083778,Greenfeld; Be'Eri,5,0,36,31
1658130153776,MATH 103A,A03,093561,Greenfeld; Be'Eri,7,0,36,29
1658130153776,MATH 103A,B01,083779,Greenfeld; Be'Eri,8,0,36,28
1658130153776,MATH 103A,B02,083780,Greenfeld; Be'Eri,4,0,36,32
1658130153776,MATH 103A,B03,093562,Greenfeld; Be'Eri,3,0,36,33
1658130159799,MATH 105,A01,085443,Carter; Anne Toulson,15,0,35,20
1658130159799,MATH 105,A02,093477,Carter; Anne Toulson,20,0,35,15
1658130165838,MATH 109,A01,083213,Ganzberger; Geoffrey Michael,3,0,34,31
1658130165838,MATH 109,A02,083214,Ganzberger; Geoffrey Michael,4,0,34,30
1658130165838,MATH 109,A03,093478,Ganzberger; Geoffrey Michael,2,0,34,32
1658130165838,MATH 109,B01,083215,Ganzberger; Geoffrey Michael,3,0,32,29
1658130165838,MATH 109,B02,083216,Ganzberger; Geoffrey Michael,3,0,32,29
1658130165838,MATH 109,B03,093479,Ganzberger; Geoffrey Michael,8,0,32,24
1658130171867,MATH 142A,A01,083219,Chow; Bennett,7,0,32,25
1658130171867,MATH 142A,A02,083220,Chow; Bennett,10,0,32,22
1658130171867,MATH 142A,A03,093480,Chow; Bennett,9,0,32,23
1658130171867,MATH 142A,B03,093481,Chow; Bennett,8,0,32,24
1658130171867,MATH 142A,B04,093558,Chow; Bennett,14,0,32,18
1658130171867,MATH 142A,B05,093559,Chow; Bennett,7,0,32,25
1658130177890,MATH 193A,A01,083224,Rotar; Vladimir,9,0,34,25
1658130177890,MATH 193A,A02,083225,Rotar; Vladimir,11,0,34,23
1658130177890,MATH 193A,A03,083781,Rotar; Vladimir,5,0,34,29
1658130177890,MATH 193A,A04,083782,Rotar; Vladimir,12,0,34,22
1658130177890,MATH 193A,A05,093482,Rotar; Vladimir,11,0,34,23
1658130183915,MATH 197,001,091859,McAuley; Julian John,9999,0,9999,0
1658130183915,MATH 197,002,095566,Kedlaya; Kiran S.,9997,0,9999,2
1658130183915,MATH 197,003,095567,Xiao; Ming,9999,0,9999,0
1658130183915,MATH 197,004,095571,Perols; Johan Lars,9998,0,9999,1
1658130190968,COGS 9,A01,083615,Shannon; Kyle Michael,11,0,75,64
1658130196990,COGS 11,A01,083617,Boyle; Mary E. T.,23,0,48,25
1658130203018,COGS 13,A01,083071,Bastos; Amalia Pinkusfeld,12,0,71,59
1658130209041,COGS 14A,A01,092681,Semenuks; Arturs,5,1,100,95
1658130215068,COGS 14B,A01,083073,Cheng; Tzu-Han,7,0,63,56
1658130221091,COGS 17,A01,092677,Semenuks; Arturs,7,0,81,74
1658130227118,COGS 100,A01,083619,Allen; Michael Gordon,17,0,70,53
1658130233142,COGS 101A,A01,083621,Davis; Joshua Daniel,9,0,68,59
1658130239168,COGS 101B,A01,091572,Allen; Michael Gordon,14,0,65,51
1658130245193,COGS 101C,A01,083625,Delgado; Tania,17,0,35,18
1658130251220,COGS 107A,A01,083627,Boyle; Mary E. T.,14,0,60,46
1658130257244,COGS 118A,A01,083075,Gupta; Anjum,21,0,76,55
1658130263279,CSE 3,A50,083646,Miranda; Gregory Joseph,24,0,50,26
1658130269309,CSE 8A,A50,083650,Miranda; Gregory Joseph,17,1,56,39
1658130275337,CSE 11,A01,083080,Cao; Yingjun,7,15,40,33
1658130281361,CSE 12,A01,083652,Krause-Levy; Sophia Louisa,30,1,120,90
1658130287387,CSE 15L,A01,083654,Morris; Justin Loren,9,0,50,41
1658130287387,CSE 15L,A02,083655,Morris; Justin Loren,11,0,50,39
1658130293410,CSE 20,A01,083657,Tran; Khoa Dang,39,0,80,41
1658130299450,CSE 21,A01,095574,Bach; Quang Tran,23,0,48,25
1658130305475,CSE 30,A01,083084,Eldon; John,8,0,80,72
1658130305475,CSE 30,B01,095061,Bhaskar; Nishant,9,0,50,41
1658130311498,CSE 100,A01,083659,Cao; Yingjun,5,4,70,65
1658130317528,CSE 134B,A01,083661,Powell; Thomas Allan,25,0,100,75
1658130323552,CSE 140,A01,083663,Gungor; Onat,17,0,85,68
1658130329578,CSE 140L,A01,083088,Eldon; John,23,0,100,77
1658130335601,CSE 175,A01,083665,Kumar; Rakesh,3,0,25,22
1658130341625,CSE 190,A00,092507,Dubnov; Shlomo,8,0,20,12
1658130347651,ECE 45,A01,083139,Congero; Spencer William,7,0,75,68
1658130353680,ECE 65,A50,083695,Saad; Andrew S,12,0,30,18
1658130353680,ECE 65,A51,095125,Saad; Andrew S,24,0,26,2
1658130359707,ECE 109,A01,091882,Touri; Behrouz,21,0,70,49
1658130365731,ECE 180,A00,083140,Abi Samra; Nicholas Camill,1,0,30,29
1658130365731,ECE 180,B00,083141,Abi Samra; Nicholas Camill,0,0,30,30
1658130371754,MATH 10A,A01,083735,Patchell; Gregory David,2,0,30,28
1658130371754,MATH 10A,A02,083736,Patchell; Gregory David,20,0,30,10
1658130371754,MATH 10A,A03,083737,Patchell; Gregory David,16,0,30,14
1658130377786,MATH 10B,A01,083207,Lim; Seonhee,9,0,34,25
1658130377786,MATH 10B,A02,083208,Lim; Seonhee,10,0,35,25
1658130377786,MATH 10B,A03,093472,Lim; Seonhee,7,0,34,27
1658130377786,MATH 10B,B01,083739,Sinha; Shubham,14,0,30,16
1658130383811,MATH 18,A01,083743,Cinel; Cameron Alexander,9,0,30,21
1658130383811,MATH 18,A02,083744,Cinel; Cameron Alexander,18,0,30,12
1658130383811,MATH 18,A03,083745,Cinel; Cameron Alexander,10,0,30,20
1658130383811,MATH 18,B01,083748,Rideout; David Porter,5,0,37,32
1658130383811,MATH 18,B02,083749,Rideout; David Porter,5,0,36,31
1658130383811,MATH 18,B03,083750,Rideout; David Porter,3,0,37,34
1658130383811,MATH 18,B04,083751,Rideout; David Porter,7,0,36,29
1658130383811,MATH 18,B05,093473,Rideout; David Porter,7,0,36,29
1658130383811,MATH 18,B06,093474,Rideout; David Porter,6,0,36,30
1658130389834,MATH 20A,A01,083754,Zheng; Zequn,14,0,40,26
1658130395862,MATH 20B,A01,083756,Briones; Jor-el Thomas Caparas,4,0,36,32
1658130395862,MATH 20B,A02,083757,Briones; Jor-el Thomas Caparas,1,0,36,35
1658130395862,MATH 20B,A03,093475,Briones; Jor-el Thomas Caparas,3,0,36,33
1658130401886,MATH 20C,A01,083760,Briones; Jor-el Thomas Caparas,1,0,35,34
1658130401886,MATH 20C,A02,083761,Briones; Jor-el Thomas Caparas,8,0,35,27
1658130401886,MATH 20C,A03,093476,Briones; Jor-el Thomas Caparas,0,1,36,36
1658130401886,MATH 20C,B01,083762,Bach; Quang Tran,1,0,30,29
1658130407910,MATH 20D,A01,083765,Tran; Brian Kha,5,0,30,25
1658130407910,MATH 20D,A02,083766,Tran; Brian Kha,5,0,30,25
1658130407910,MATH 20D,A03,083767,Tran; Brian Kha,6,0,30,24
1658130413940,MATH 20E,A01,083771,Ganguly; Soumya,12,0,32,20
1658130413940,MATH 20E,A02,083772,Ganguly; Soumya,7,0,32,25
1658130413940,MATH 20E,B01,083773,Ciotti; Benjamin,20,0,35,15
1658130413940,MATH 20E,B02,083774,Ciotti; Benjamin,18,0,35,17
1658130419977,MATH 103A,A01,083777,Greenfeld; Be'Eri,6,0,36,30
1658130419977,MATH 103A,A02,083778,Greenfeld; Be'Eri,5,0,36,31
1658130419977,MATH 103A,A03,093561,Greenfeld; Be'Eri,7,0,36,29
1658130419977,MATH 103A,B01,083779,Greenfeld; Be'Eri,8,0,36,28
1658130419977,MATH 103A,B02,083780,Greenfeld; Be'Eri,4,0,36,32
1658130419977,MATH 103A,B03,093562,Greenfeld; Be'Eri,3,0,36,33
1658130426003,MATH 105,A01,085443,Carter; Anne Toulson,15,0,35,20
1658130426003,MATH 105,A02,093477,Carter; Anne Toulson,20,0,35,15
1658130432033,MATH 109,A01,083213,Ganzberger; Geoffrey Michael,3,0,34,31
1658130432033,MATH 109,A02,083214,Ganzberger; Geoffrey Michael,4,0,34,30
1658130432033,MATH 109,A03,093478,Ganzberger; Geoffrey Michael,2,0,34,32
1658130432033,MATH 109,B01,083215,Ganzberger; Geoffrey Michael,3,0,32,29
1658130432033,MATH 109,B02,083216,Ganzberger; Geoffrey Michael,3,0,32,29
1658130432033,MATH 109,B03,093479,Ganzberger; Geoffrey Michael,8,0,32,24
1658130438057,MATH 142A,A01,083219,Chow; Bennett,7,0,32,25
1658130438057,MATH 142A,A02,083220,Chow; Bennett,10,0,32,22
1658130438057,MATH 142A,A03,093480,Chow; Bennett,9,0,32,23
1658130438057,MATH 142A,B03,093481,Chow; Bennett,8,0,32,24
1658130438057,MATH 142A,B04,093558,Chow; Bennett,14,0,32,18
1658130438057,MATH 142A,B05,093559,Chow; Bennett,7,0,32,25
1658130444081,MATH 193A,A01,083224,Rotar; Vladimir,9,0,34,25
1658130444081,MATH 193A,A02,083225,Rotar; Vladimir,11,0,34,23
1658130444081,MATH 193A,A03,083781,Rotar; Vladimir,5,0,34,29
1658130444081,MATH 193A,A04,083782,Rotar; Vladimir,12,0,34,22
1658130444081,MATH 193A,A05,093482,Rotar; Vladimir,11,0,34,23
1658130450105,MATH 197,001,091859,McAuley; Julian John,9999,0,9999,0
1658130450105,MATH 197,002,095566,Kedlaya; Kiran S.,9997,0,9999,2
1658130450105,MATH 197,003,095567,Xiao; Ming,9999,0,9999,0
1658130450105,MATH 197,004,095571,Perols; Johan Lars,9998,0,9999,1
1658130457160,COGS 9,A01,083615,Shannon; Kyle Michael,11,0,75,64
1658130463184,COGS 11,A01,083617,Boyle; Mary E. T.,23,0,48,25
1658130469212,COGS 13,A01,083071,Bastos; Amalia Pinkusfeld,12,0,71,59
1658130475238,COGS 14A,A01,092681,Semenuks; Arturs,5,1,100,95
1658130481263,COGS 14B,A01,083073,Cheng; Tzu-Han,7,0,63,56
1658130487291,COGS 17,A01,092677,Semenuks; Arturs,7,0,81,74
1658130493321,COGS 100,A01,083619,Allen; Michael Gordon,17,0,70,53
1658130499346,COGS 101A,A01,083621,Davis; Joshua Daniel,9,0,68,59
1658130505374,COGS 101B,A01,091572,Allen; Michael Gordon,14,0,65,51
1658130511400,COGS 101C,A01,083625,Delgado; Tania,17,0,35,18
1658130517425,COGS 107A,A01,083627,Boyle; Mary E. T.,14,0,60,46
1658130523454,COGS 118A,A01,083075,Gupta; Anjum,21,0,76,55
1658130529477,CSE 3,A50,083646,Miranda; Gregory Joseph,24,0,50,26
1658130535501,CSE 8A,A50,083650,Miranda; Gregory Joseph,17,1,56,39
1658130541542,CSE 11,A01,083080,Cao; Yingjun,7,15,40,33
1658130547567,CSE 12,A01,083652,Krause-Levy; Sophia Louisa,30,1,120,90
1658130553595,CSE 15L,A01,083654,Morris; Justin Loren,9,0,50,41
1658130553595,CSE 15L,A02,083655,Morris; Justin Loren,11,0,50,39
1658130559622,CSE 20,A01,083657,Tran; Khoa Dang,39,0,80,41
1658130565651,CSE 21,A01,095574,Bach; Quang Tran,23,0,48,25
1658130571687,CSE 30,A01,083084,Eldon; John,8,0,80,72
1658130571687,CSE 30,B01,095061,Bhaskar; Nishant,9,0,50,41
1658130577719,CSE 100,A01,083659,Cao; Yingjun,5,4,70,65
1658130583742,CSE 134B,A01,083661,Powell; Thomas Allan,25,0,100,75
1658130589768,CSE 140,A01,083663,Gungor; Onat,17,0,85,68
1658130595795,CSE 140L,A01,083088,Eldon; John,23,0,100,77
1658130601817,CSE 175,A01,083665,Kumar; Rakesh,3,0,25,22
1658130607841,CSE 190,A00,092507,Dubnov; Shlomo,8,0,20,12
1658130613869,ECE 45,A01,083139,Congero; Spencer William,7,0,75,68
1658130619896,ECE 65,A50,083695,Saad; Andrew S,12,0,30,18
1658130619896,ECE 65,A51,095125,Saad; Andrew S,24,0,26,2
1658130625920,ECE 109,A01,091882,Touri; Behrouz,21,0,70,49
1658130631946,ECE 180,A00,083140,Abi Samra; Nicholas Camill,1,0,30,29
1658130631946,ECE 180,B00,083141,Abi Samra; Nicholas Camill,0,0,30,30
1658130637972,MATH 10A,A01,083735,Patchell; Gregory David,2,0,30,28
1658130637972,MATH 10A,A02,083736,Patchell; Gregory David,20,0,30,10
1658130637972,MATH 10A,A03,083737,Patchell; Gregory David,16,0,30,14
1658130644003,MATH 10B,A01,083207,Lim; Seonhee,9,0,34,25
1658130644003,MATH 10B,A02,083208,Lim; Seonhee,10,0,35,25
1658130644003,MATH 10B,A03,093472,Lim; Seonhee,7,0,34,27
1658130644003,MATH 10B,B01,083739,Sinha; Shubham,14,0,30,16
1658130650034,MATH 18,A01,083743,Cinel; Cameron Alexander,9,0,30,21
1658130650034,MATH 18,A02,083744,Cinel; Cameron Alexander,18,0,30,12
1658130650034,MATH 18,A03,083745,Cinel; Cameron Alexander,10,0,30,20
1658130650034,MATH 18,B01,083748,Rideout; David Porter,5,0,37,32
1658130650034,MATH 18,B02,083749,Rideout; David Porter,5,0,36,31
1658130650034,MATH 18,B03,083750,Rideout; David Porter,3,0,37,34
1658130650034,MATH 18,B04,083751,Rideout; David Porter,7,0,36,29
1658130650034,MATH 18,B05,093473,Rideout; David Porter,7,0,36,29
1658130650034,MATH 18,B06,093474,Rideout; David Porter,6,0,36,30
1658130656062,MATH 20A,A01,083754,Zheng; Zequn,14,0,40,26
1658130662096,MATH 20B,A01,083756,Briones; Jor-el Thomas Caparas,4,0,36,32
1658130662096,MATH 20B,A02,083757,Briones; Jor-el Thomas Caparas,1,0,36,35
1658130662096,MATH 20B,A03,093475,Briones; Jor-el Thomas Caparas,3,0,36,33
1658130668119,MATH 20C,A01,083760,Briones; Jor-el Thomas Caparas,1,0,35,34
1658130668119,MATH 20C,A02,083761,Briones; Jor-el Thomas Caparas,8,0,35,27
1658130668119,MATH 20C,A03,093476,Briones; Jor-el Thomas Caparas,0,1,36,36
1658130668119,MATH 20C,B01,083762,Bach; Quang Tran,1,0,30,29
1658130674149,MATH 20D,A01,083765,Tran; Brian Kha,5,0,30,25
1658130674149,MATH 20D,A02,083766,Tran; Brian Kha,5,0,30,25
1658130674149,MATH 20D,A03,083767,Tran; Brian Kha,6,0,30,24
1658130680177,MATH 20E,A01,083771,Ganguly; Soumya,12,0,32,20
1658130680177,MATH 20E,A02,083772,Ganguly; Soumya,7,0,32,25
1658130680177,MATH 20E,B01,083773,Ciotti; Benjamin,20,0,35,15
1658130680177,MATH 20E,B02,083774,Ciotti; Benjamin,18,0,35,17
1658130686209,MATH 103A,A01,083777,Greenfeld; Be'Eri,6,0,36,30
1658130686209,MATH 103A,A02,083778,Greenfeld; Be'Eri,5,0,36,31
1658130686209,MATH 103A,A03,093561,Greenfeld; Be'Eri,7,0,36,29
1658130686209,MATH 103A,B01,083779,Greenfeld; Be'Eri,8,0,36,28
1658130686209,MATH 103A,B02,083780,Greenfeld; Be'Eri,4,0,36,32
1658130686209,MATH 103A,B03,093562,Greenfeld; Be'Eri,3,0,36,33
1658130692237,MATH 105,A01,085443,Carter; Anne Toulson,15,0,35,20
1658130692237,MATH 105,A02,093477,Carter; Anne Toulson,20,0,35,15
1658130698265,MATH 109,A01,083213,Ganzberger; Geoffrey Michael,3,0,34,31
1658130698265,MATH 109,A02,083214,Ganzberger; Geoffrey Michael,4,0,34,30
1658130698265,MATH 109,A03,093478,Ganzberger; Geoffrey Michael,2,0,34,32
1658130698265,MATH 109,B01,083215,Ganzberger; Geoffrey Michael,3,0,32,29
1658130698265,MATH 109,B02,083216,Ganzberger; Geoffrey Michael,3,0,32,29
1658130698265,MATH 109,B03,093479,Ganzberger; Geoffrey Michael,8,0,32,24
1658130704294,MATH 142A,A01,083219,Chow; Bennett,7,0,32,25
1658130704294,MATH 142A,A02,083220,Chow; Bennett,10,0,32,22
1658130704294,MATH 142A,A03,093480,Chow; Bennett,9,0,32,23
1658130704294,MATH 142A,B03,093481,Chow; Bennett,8,0,32,24
1658130704294,MATH 142A,B04,093558,Chow; Bennett,14,0,32,18
1658130704294,MATH 142A,B05,093559,Chow; Bennett,7,0,32,25
1658130710333,MATH 193A,A01,083224,Rotar; Vladimir,9,0,34,25
1658130710333,MATH 193A,A02,083225,Rotar; Vladimir,11,0,34,23
1658130710333,MATH 193A,A03,083781,Rotar; Vladimir,5,0,34,29
1658130710333,MATH 193A,A04,083782,Rotar; Vladimir,12,0,34,22
1658130710333,MATH 193A,A05,093482,Rotar; Vladimir,11,0,34,23
1658130716362,MATH 197,001,091859,McAuley; Julian John,9999,0,9999,0
1658130716362,MATH 197,002,095566,Kedlaya; Kiran S.,9997,0,9999,2
1658130716362,MATH 197,003,095567,Xiao; Ming,9999,0,9999,0
1658130716362,MATH 197,004,095571,Perols; Johan Lars,9998,0,9999,1
1658130723516,COGS 9,A01,083615,Shannon; Kyle Michael,11,0,75,64
1658130729548,COGS 11,A01,083617,Boyle; Mary E. T.,23,0,48,25
1658130735575,COGS 13,A01,083071,Bastos; Amalia Pinkusfeld,12,0,71,59
1658130741605,COGS 14A,A01,092681,Semenuks; Arturs,5,1,100,95
1658130747643,COGS 14B,A01,083073,Cheng; Tzu-Han,7,0,63,56
1658130753673,COGS 17,A01,092677,Semenuks; Arturs,7,0,81,74
1658130759707,COGS 100,A01,083619,Allen; Michael Gordon,17,0,70,53
1658130765735,COGS 101A,A01,083621,Davis; Joshua Daniel,9,0,68,59
1658130771758,COGS 101B,A01,091572,Allen; Michael Gordon,14,0,65,51
1658130777784,COGS 101C,A01,083625,Delgado; Tania,17,0,35,18
1658130783818,COGS 107A,A01,083627,Boyle; Mary E. T.,14,0,60,46
1658130789842,COGS 118A,A01,083075,Gupta; Anjum,21,0,76,55
1658130795869,CSE 3,A50,083646,Miranda; Gregory Joseph,24,0,50,26
1658130801897,CSE 8A,A50,083650,Miranda; Gregory Joseph,17,1,56,39
1658130807920,CSE 11,A01,083080,Cao; Yingjun,7,15,40,33
1658130813947,CSE 12,A01,083652,Krause-Levy; Sophia Louisa,30,1,120,90
1658130819979,CSE 15L,A01,083654,Morris; Justin Loren,9,0,50,41
1658130819979,CSE 15L,A02,083655,Morris; Justin Loren,11,0,50,39
1658130826006,CSE 20,A01,083657,Tran; Khoa Dang,39,0,80,41
1658130832030,CSE 21,A01,095574,Bach; Quang Tran,23,0,48,25
1658130838052,CSE 30,A01,083084,Eldon; John,8,0,80,72
1658130838052,CSE 30,B01,095061,Bhaskar; Nishant,9,0,50,41
1658130844080,CSE 100,A01,083659,Cao; Yingjun,5,4,70,65
1658130850108,CSE 134B,A01,083661,Powell; Thomas Allan,25,0,100,75
1658130856137,CSE 140,A01,083663,Gungor; Onat,17,0,85,68
1658130862164,CSE 140L,A01,083088,Eldon; John,23,0,100,77
1658130868190,CSE 175,A01,083665,Kumar; Rakesh,3,0,25,22
1658130874223,CSE 190,A00,092507,Dubnov; Shlomo,8,0,20,12
1658130880253,ECE 45,A01,083139,Congero; Spencer William,7,0,75,68
1658130886278,ECE 65,A50,083695,Saad; Andrew S,12,0,30,18
1658130886278,ECE 65,A51,095125,Saad; Andrew S,24,0,26,2
1658130892306,ECE 109,A01,091882,Touri; Behrouz,21,0,70,49
1658130898329,ECE 180,A00,083140,Abi Samra; Nicholas Camill,1,0,30,29
1658130898329,ECE 180,B00,083141,Abi Samra; Nicholas Camill,0,0,30,30
1658130904354,MATH 10A,A01,083735,Patchell; Gregory David,2,0,30,28
1658130904354,MATH 10A,A02,083736,Patchell; Gregory David,20,0,30,10
1658130904354,MATH 10A,A03,083737,Patchell; Gregory David,16,0,30,14
1658130910378,MATH 10B,A01,083207,Lim; Seonhee,9,0,34,25
1658130910378,MATH 10B,A02,083208,Lim; Seonhee,10,0,35,25
1658130910378,MATH 10B,A03,093472,Lim; Seonhee,7,0,34,27
1658130910378,MATH 10B,B01,083739,Sinha; Shubham,14,0,30,16
1658130916418,MATH 18,A01,083743,Cinel; Cameron Alexander,9,0,30,21
1658130916418,MATH 18,A02,083744,Cinel; Cameron Alexander,18,0,30,12
1658130916418,MATH 18,A03,083745,Cinel; Cameron Alexander,10,0,30,20
1658130916418,MATH 18,B01,083748,Rideout; David Porter,5,0,37,32
1658130916418,MATH 18,B02,083749,Rideout; David Porter,5,0,36,31
1658130916418,MATH 18,B03,083750,Rideout; David Porter,3,0,37,34
1658130916418,MATH 18,B04,083751,Rideout; David Porter,7,0,36,29
1658130916418,MATH 18,B05,093473,Rideout; David Porter,7,0,36,29
1658130916418,MATH 18,B06,093474,Rideout; David Porter,6,0,36,30
1658130922441,MATH 20A,A01,083754,Zheng; Zequn,14,0,40,26
1658130928467,MATH 20B,A01,083756,Briones; Jor-el Thomas Caparas,4,0,36,32
1658130928467,MATH 20B,A02,083757,Briones; Jor-el Thomas Caparas,1,0,36,35
1658130928467,MATH 20B,A03,093475,Briones; Jor-el Thomas Caparas,3,0,36,33
1658130934491,MATH 20C,A01,083760,Briones; Jor-el Thomas Caparas,1,0,35,34
1658130934491,MATH 20C,A02,083761,Briones; Jor-el Thomas Caparas,8,0,35,27
1658130934491,MATH 20C,A03,093476,Briones; Jor-el Thomas Caparas,0,1,36,36
1658130934491,MATH 20C,B01,083762,Bach; Quang Tran,1,0,30,29
1658130940519,MATH 20D,A01,083765,Tran; Brian Kha,5,0,30,25
1658130940519,MATH 20D,A02,083766,Tran; Brian Kha,5,0,30,25
1658130940519,MATH 20D,A03,083767,Tran; Brian Kha,6,0,30,24
1658130946545,MATH 20E,A01,083771,Ganguly; Soumya,12,0,32,20
1658130946545,MATH 20E,A02,083772,Ganguly; Soumya,7,0,32,25
1658130946545,MATH 20E,B01,083773,Ciotti; Benjamin,20,0,35,15
1658130946545,MATH 20E,B02,083774,Ciotti; Benjamin,18,0,35,17
1658130952581,MATH 103A,A01,083777,Greenfeld; Be'Eri,6,0,36,30
1658130952581,MATH 103A,A02,083778,Greenfeld; Be'Eri,5,0,36,31
1658130952581,MATH 103A,A03,093561,Greenfeld; Be'Eri,7,0,36,29
1658130952581,MATH 103A,B01,083779,Greenfeld; Be'Eri,8,0,36,28
1658130952581,MATH 103A,B02,083780,Greenfeld; Be'Eri,4,0,36,32
1658130952581,MATH 103A,B03,093562,Greenfeld; Be'Eri,3,0,36,33
1658130958608,MATH 105,A01,085443,Carter; Anne Toulson,15,0,35,20
1658130958608,MATH 105,A02,093477,Carter; Anne Toulson,20,0,35,15
1658130964641,MATH 109,A01,083213,Ganzberger; Geoffrey Michael,3,0,34,31
1658130964641,MATH 109,A02,083214,Ganzberger; Geoffrey Michael,4,0,34,30
1658130964641,MATH 109,A03,093478,Ganzberger; Geoffrey Michael,2,0,34,32
1658130964641,MATH 109,B01,083215,Ganzberger; Geoffrey Michael,3,0,32,29
1658130964641,MATH 109,B02,083216,Ganzberger; Geoffrey Michael,3,0,32,29
1658130964641,MATH 109,B03,093479,Ganzberger; Geoffrey Michael,8,0,32,24
1658130970671,MATH 142A,A01,083219,Chow; Bennett,7,0,32,25
1658130970671,MATH 142A,A02,083220,Chow; Bennett,10,0,32,22
1658130970671,MATH 142A,A03,093480,Chow; Bennett,9,0,32,23
1658130970671,MATH 142A,B03,093481,Chow; Bennett,8,0,32,24
1658130970671,MATH 142A,B04,093558,Chow; Bennett,14,0,32,18
1658130970671,MATH 142A,B05,093559,Chow; Bennett,7,0,32,25
1658130976697,MATH 193A,A01,083224,Rotar; Vladimir,9,0,34,25
1658130976697,MATH 193A,A02,083225,Rotar; Vladimir,11,0,34,23
1658130976697,MATH 193A,A03,083781,Rotar; Vladimir,5,0,34,29
1658130976697,MATH 193A,A04,083782,Rotar; Vladimir,12,0,34,22
1658130976697,MATH 193A,A05,093482,Rotar; Vladimir,11,0,34,23
1658130982721,MATH 197,001,091859,McAuley; Julian John,9999,0,9999,0
1658130982721,MATH 197,002,095566,Kedlaya; Kiran S.,9997,0,9999,2
1658130982721,MATH 197,003,095567,Xiao; Ming,9999,0,9999,0
1658130982721,MATH 197,004,095571,Perols; Johan Lars,9998,0,9999,1
1658130989775,COGS 9,A01,083615,Shannon; Kyle Michael,11,0,75,64
1658130995799,COGS 11,A01,083617,Boyle; Mary E. T.,23,0,48,25
1658131001823,COGS 13,A01,083071,Bastos; Amalia Pinkusfeld,12,0,71,59
1658131007846,COGS 14A,A01,092681,Semenuks; Arturs,5,1,100,95
1658131013870,COGS 14B,A01,083073,Cheng; Tzu-Han,7,0,63,56
1658131019897,COGS 17,A01,092677,Semenuks; Arturs,7,0,81,74
1658131025924,COGS 100,A01,083619,Allen; Michael Gordon,17,0,70,53
1658131031951,COGS 101A,A01,083621,Davis; Joshua Daniel,9,0,68,59
1658131037978,COGS 101B,A01,091572,Allen; Michael Gordon,14,0,65,51
1658131044003,COGS 101C,A01,083625,Delgado; Tania,17,0,35,18
1658131050029,COGS 107A,A01,083627,Boyle; Mary E. T.,14,0,60,46
1658131056055,COGS 118A,A01,083075,Gupta; Anjum,21,0,76,55
1658131062085,CSE 3,A50,083646,Miranda; Gregory Joseph,24,0,50,26
1658131068113,CSE 8A,A50,083650,Miranda; Gregory Joseph,17,1,56,39
1658131074139,CSE 11,A01,083080,Cao; Yingjun,7,15,40,33
1658131080173,CSE 12,A01,083652,Krause-Levy; Sophia Louisa,30,1,120,90
1658131086199,CSE 15L,A01,083654,Morris; Justin Loren,9,0,50,41
1658131086199,CSE 15L,A02,083655,Morris; Justin Loren,11,0,50,39
1658131092223,CSE 20,A01,083657,Tran; Khoa Dang,39,0,80,41
1658131098246,CSE 21,A01,095574,Bach; Quang Tran,23,0,48,25
1658131104273,CSE 30,A01,083084,Eldon; John,8,0,80,72
1658131104273,CSE 30,B01,095061,Bhaskar; Nishant,9,0,50,41
1658131110297,CSE 100,A01,083659,Cao; Yingjun,5,4,70,65
1658131116320,CSE 134B,A01,083661,Powell; Thomas Allan,25,0,100,75
1658131122350,CSE 140,A01,083663,Gungor; Onat,17,0,85,68
1658131128373,CSE 140L,A01,083088,Eldon; John,23,0,100,77
1658131134397,CSE 175,A01,083665,Kumar; Rakesh,3,0,25,22
1658131140420,CSE 190,A00,092507,Dubnov; Shlomo,8,0,20,12
1658131146452,ECE 45,A01,083139,Congero; Spencer William,7,0,75,68
1658131152489,ECE 65,A50,083695,Saad; Andrew S,12,0,30,18
1658131152489,ECE 65,A51,095125,Saad; Andrew S,24,0,26,2
1658131158526,ECE 109,A01,091882,Touri; Behrouz,21,0,70,49
1658131164550,ECE 180,A00,083140,Abi Samra; Nicholas Camill,1,0,30,29
1658131164550,ECE 180,B00,083141,Abi Samra; Nicholas Camill,0,0,30,30
1658131170575,MATH 10A,A01,083735,Patchell; Gregory David,2,0,30,28
1658131170575,MATH 10A,A02,083736,Patchell; Gregory David,20,0,30,10
1658131170575,MATH 10A,A03,083737,Patchell; Gregory David,16,0,30,14
1658131176600,MATH 10B,A01,083207,Lim; Seonhee,9,0,34,25
1658131176600,MATH 10B,A02,083208,Lim; Seonhee,10,0,35,25
1658131176600,MATH 10B,A03,093472,Lim; Seonhee,7,0,34,27
1658131176600,MATH 10B,B01,083739,Sinha; Shubham,14,0,30,16
1658131182625,MATH 18,A01,083743,Cinel; Cameron Alexander,9,0,30,21
1658131182625,MATH 18,A02,083744,Cinel; Cameron Alexander,18,0,30,12
1658131182625,MATH 18,A03,083745,Cinel; Cameron Alexander,10,0,30,20
1658131182625,MATH 18,B01,083748,Rideout; David Porter,5,0,37,32
1658131182625,MATH 18,B02,083749,Rideout; David Porter,5,0,36,31
1658131182625,MATH 18,B03,083750,Rideout; David Porter,3,0,37,34
1658131182625,MATH 18,B04,083751,Rideout; David Porter,7,0,36,29
1658131182625,MATH 18,B05,093473,Rideout; David Porter,7,0,36,29
1658131182625,MATH 18,B06,093474,Rideout; David Porter,6,0,36,30
1658131188651,MATH 20A,A01,083754,Zheng; Zequn,14,0,40,26
1658131194676,MATH 20B,A01,083756,Briones; Jor-el Thomas Caparas,4,0,36,32
1658131194676,MATH 20B,A02,083757,Briones; Jor-el Thomas Caparas,1,0,36,35
1658131194676,MATH 20B,A03,093475,Briones; Jor-el Thomas Caparas,3,0,36,33
1658131200703,MATH 20C,A01,083760,Briones; Jor-el Thomas Caparas,1,0,35,34
1658131200703,MATH 20C,A02,083761,Briones; Jor-el Thomas Caparas,8,0,35,27
1658131200703,MATH 20C,A03,093476,Briones; Jor-el Thomas Caparas,0,1,36,36
1658131200703,MATH 20C,B01,083762,Bach; Quang Tran,1,0,30,29
1658131206729,MATH 20D,A01,083765,Tran; Brian Kha,5,0,30,25
1658131206729,MATH 20D,A02,083766,Tran; Brian Kha,5,0,30,25
1658131206729,MATH 20D,A03,083767,Tran; Brian Kha,6,0,30,24
1658131212757,MATH 20E,A01,083771,Ganguly; Soumya,12,0,32,20
1658131212757,MATH 20E,A02,083772,Ganguly; Soumya,7,0,32,25
1658131212757,MATH 20E,B01,083773,Ciotti; Benjamin,20,0,35,15
1658131212757,MATH 20E,B02,083774,Ciotti; Benjamin,18,0,35,17
1658131218780,MATH 103A,A01,083777,Greenfeld; Be'Eri,6,0,36,30
1658131218780,MATH 103A,A02,083778,Greenfeld; Be'Eri,5,0,36,31
1658131218780,MATH 103A,A03,093561,Greenfeld; Be'Eri,7,0,36,29
1658131218780,MATH 103A,B01,083779,Greenfeld; Be'Eri,8,0,36,28
1658131218780,MATH 103A,B02,083780,Greenfeld; Be'Eri,4,0,36,32
1658131218780,MATH 103A,B03,093562,Greenfeld; Be'Eri,3,0,36,33
1658131224804,MATH 105,A01,085443,Carter; Anne Toulson,15,0,35,20
1658131224804,MATH 105,A02,093477,Carter; Anne Toulson,20,0,35,15
1658131230829,MATH 109,A01,083213,Ganzberger; Geoffrey Michael,3,0,34,31
1658131230829,MATH 109,A02,083214,Ganzberger; Geoffrey Michael,4,0,34,30
1658131230829,MATH 109,A03,093478,Ganzberger; Geoffrey Michael,2,0,34,32
1658131230829,MATH 109,B01,083215,Ganzberger; Geoffrey Michael,3,0,32,29
1658131230829,MATH 109,B02,083216,Ganzberger; Geoffrey Michael,3,0,32,29
1658131230829,MATH 109,B03,093479,Ganzberger; Geoffrey Michael,8,0,32,24
1658131236860,MATH 142A,A01,083219,Chow; Bennett,7,0,32,25
1658131236860,MATH 142A,A02,083220,Chow; Bennett,10,0,32,22
1658131236860,MATH 142A,A03,093480,Chow; Bennett,9,0,32,23
1658131236860,MATH 142A,B03,093481,Chow; Bennett,8,0,32,24
1658131236860,MATH 142A,B04,093558,Chow; Bennett,14,0,32,18
1658131236860,MATH 142A,B05,093559,Chow; Bennett,7,0,32,25
1658131242883,MATH 193A,A01,083224,Rotar; Vladimir,9,0,34,25
1658131242883,MATH 193A,A02,083225,Rotar; Vladimir,11,0,34,23
1658131242883,MATH 193A,A03,083781,Rotar; Vladimir,5,0,34,29
1658131242883,MATH 193A,A04,083782,Rotar; Vladimir,12,0,34,22
1658131242883,MATH 193A,A05,093482,Rotar; Vladimir,11,0,34,23
1658131248907,MATH 197,001,091859,McAuley; Julian John,9999,0,9999,0
1658131248907,MATH 197,002,095566,Kedlaya; Kiran S.,9997,0,9999,2
1658131248907,MATH 197,003,095567,Xiao; Ming,9999,0,9999,0
1658131248907,MATH 197,004,095571,Perols; Johan Lars,9998,0,9999,1
1658131255967,COGS 9,A01,083615,Shannon; Kyle Michael,11,0,75,64
1658131261990,COGS 11,A01,083617,Boyle; Mary E. T.,23,0,48,25
1658131268017,COGS 13,A01,083071,Bastos; Amalia Pinkusfeld,12,0,71,59
1658131274044,COGS 14A,A01,092681,Semenuks; Arturs,5,1,100,95
1658131280068,COGS 14B,A01,083073,Cheng; Tzu-Han,7,0,63,56
1658131286091,COGS 17,A01,092677,Semenuks; Arturs,7,0,81,74
1658131292117,COGS 100,A01,083619,Allen; Michael Gordon,17,0,70,53
1658131298152,COGS 101A,A01,083621,Davis; Joshua Daniel,9,0,68,59
1658131304179,COGS 101B,A01,091572,Allen; Michael Gordon,14,0,65,51
1658131310202,COGS 101C,A01,083625,Delgado; Tania,17,0,35,18
1658131316302,COGS 107A,A01,083627,Boyle; Mary E. T.,14,0,60,46
1658131322330,COGS 118A,A01,083075,Gupta; Anjum,21,0,76,55
1658131328355,CSE 3,A50,083646,Miranda; Gregory Joseph,24,0,50,26
1658131334380,CSE 8A,A50,083650,Miranda; Gregory Joseph,17,1,56,39
1658131340404,CSE 11,A01,083080,Cao; Yingjun,7,15,40,33
1658131346427,CSE 12,A01,083652,Krause-Levy; Sophia Louisa,30,1,120,90
1658131352451,CSE 15L,A01,083654,Morris; Justin Loren,9,0,50,41
1658131352451,CSE 15L,A02,083655,Morris; Justin Loren,11,0,50,39
1658131358480,CSE 20,A01,083657,Tran; Khoa Dang,39,0,80,41
1658131364507,CSE 21,A01,095574,Bach; Quang Tran,23,0,48,25
1658131370530,CSE 30,A01,083084,Eldon; John,8,0,80,72
1658131370530,CSE 30,B01,095061,Bhaskar; Nishant,9,0,50,41
1658131376554,CSE 100,A01,083659,Cao; Yingjun,5,4,70,65
1658131382581,CSE 134B,A01,083661,Powell; Thomas Allan,25,0,100,75
1658131388613,CSE 140,A01,083663,Gungor; Onat,17,0,85,68
1658131394636,CSE 140L,A01,083088,Eldon; John,23,0,100,77
1658131400662,CSE 175,A01,083665,Kumar; Rakesh,3,0,25,22
1658131406695,CSE 190,A00,092507,Dubnov; Shlomo,8,0,20,12
1658131412728,ECE 45,A01,083139,Congero; Spencer William,7,0,75,68
1658131418767,ECE 65,A50,083695,Saad; Andrew S,12,0,30,18
1658131418767,ECE 65,A51,095125,Saad; Andrew S,24,0,26,2
1658131424796,ECE 109,A01,091882,Touri; Behrouz,21,0,70,49
1658131430828,ECE 180,A00,083140,Abi Samra; Nicholas Camill,1,0,30,29
1658131430828,ECE 180,B00,083141,Abi Samra; Nicholas Camill,0,0,30,30
1658131436857,MATH 10A,A01,083735,Patchell; Gregory David,2,0,30,28
1658131436857,MATH 10A,A02,083736,Patchell; Gregory David,20,0,30,10
1658131436857,MATH 10A,A03,083737,Patchell; Gregory David,16,0,30,14
1658131442884,MATH 10B,A01,083207,Lim; Seonhee,9,0,34,25
1658131442884,MATH 10B,A02,083208,Lim; Seonhee,10,0,35,25
1658131442884,MATH 10B,A03,093472,Lim; Seonhee,7,0,34,27
1658131442884,MATH 10B,B01,083739,Sinha; Shubham,14,0,30,16
1658131448913,MATH 18,A01,083743,Cinel; Cameron Alexander,9,0,30,21
1658131448913,MATH 18,A02,083744,Cinel; Cameron Alexander,18,0,30,12
1658131448913,MATH 18,A03,083745,Cinel; Cameron Alexander,10,0,30,20
1658131448913,MATH 18,B01,083748,Rideout; David Porter,5,0,37,32
1658131448913,MATH 18,B02,083749,Rideout; David Porter,5,0,36,31
1658131448913,MATH 18,B03,083750,Rideout; David Porter,3,0,37,34
1658131448913,MATH 18,B04,083751,Rideout; David Porter,7,0,36,29
1658131448913,MATH 18,B05,093473,Rideout; David Porter,7,0,36,29
1658131448913,MATH 18,B06,093474,Rideout; David Porter,6,0,36,30
1658131454944,MATH 20A,A01,083754,Zheng; Zequn,14,0,40,26
1658131460980,MATH 20B,A01,083756,Briones; Jor-el Thomas Caparas,4,0,36,32
1658131460980,MATH 20B,A02,083757,Briones; Jor-el Thomas Caparas,1,0,36,35
1658131460980,MATH 20B,A03,093475,Briones; Jor-el Thomas Caparas,3,0,36,33
1658131467014,MATH 20C,A01,083760,Briones; Jor-el Thomas Caparas,1,0,35,34
1658131467014,MATH 20C,A02,083761,Briones; Jor-el Thomas Caparas,8,0,35,27
1658131467014,MATH 20C,A03,093476,Briones; Jor-el Thomas Caparas,0,1,36,36
1658131467014,MATH 20C,B01,083762,Bach; Quang Tran,1,0,30,29
1658131473043,MATH 20D,A01,083765,Tran; Brian Kha,5,0,30,25
1658131473043,MATH 20D,A02,083766,Tran; Brian Kha,5,0,30,25
1658131473043,MATH 20D,A03,083767,Tran; Brian Kha,6,0,30,24
1658131479076,MATH 20E,A01,083771,Ganguly; Soumya,12,0,32,20
1658131479076,MATH 20E,A02,083772,Ganguly; Soumya,7,0,32,25
1658131479076,MATH 20E,B01,083773,Ciotti; Benjamin,20,0,35,15
1658131479076,MATH 20E,B02,083774,Ciotti; Benjamin,18,0,35,17
1658131485102,MATH 103A,A01,083777,Greenfeld; Be'Eri,6,0,36,30
1658131485102,MATH 103A,A02,083778,Greenfeld; Be'Eri,5,0,36,31
1658131485102,MATH 103A,A03,093561,Greenfeld; Be'Eri,7,0,36,29
1658131485102,MATH 103A,B01,083779,Greenfeld; Be'Eri,8,0,36,28
1658131485102,MATH 103A,B02,083780,Greenfeld; Be'Eri,4,0,36,32
1658131485102,MATH 103A,B03,093562,Greenfeld; Be'Eri,3,0,36,33
1658131491134,MATH 105,A01,085443,Carter; Anne Toulson,15,0,35,20
1658131491134,MATH 105,A02,093477,Carter; Anne Toulson,20,0,35,15
1658131497160,MATH 109,A01,083213,Ganzberger; Geoffrey Michael,3,0,34,31
1658131497160,MATH 109,A02,083214,Ganzberger; Geoffrey Michael,4,0,34,30
1658131497160,MATH 109,A03,093478,Ganzberger; Geoffrey Michael,2,0,34,32
1658131497160,MATH 109,B01,083215,Ganzberger; Geoffrey Michael,3,0,32,29
1658131497160,MATH 109,B02,083216,Ganzberger; Geoffrey Michael,3,0,32,29
1658131497160,MATH 109,B03,093479,Ganzberger; Geoffrey Michael,8,0,32,24
1658131503204,MATH 142A,A01,083219,Chow; Bennett,7,0,32,25
1658131503204,MATH 142A,A02,083220,Chow; Bennett,10,0,32,22
1658131503204,MATH 142A,A03,093480,Chow; Bennett,9,0,32,23
1658131503204,MATH 142A,B03,093481,Chow; Bennett,8,0,32,24
1658131503204,MATH 142A,B04,093558,Chow; Bennett,14,0,32,18
1658131503204,MATH 142A,B05,093559,Chow; Bennett,7,0,32,25
1658131509232,MATH 193A,A01,083224,Rotar; Vladimir,9,0,34,25
1658131509232,MATH 193A,A02,083225,Rotar; Vladimir,11,0,34,23
1658131509232,MATH 193A,A03,083781,Rotar; Vladimir,5,0,34,29
1658131509232,MATH 193A,A04,083782,Rotar; Vladimir,12,0,34,22
1658131509232,MATH 193A,A05,093482,Rotar; Vladimir,11,0,34,23
1658131515263,MATH 197,001,091859,McAuley; Julian John,9999,0,9999,0
1658131515263,MATH 197,002,095566,Kedlaya; Kiran S.,9997,0,9999,2
1658131515263,MATH 197,003,095567,Xiao; Ming,9999,0,9999,0
1658131515263,MATH 197,004,095571,Perols; Johan Lars,9998,0,9999,1
1658131522326,COGS 9,A01,083615,Shannon; Kyle Michael,11,0,75,64
1658131528356,COGS 11,A01,083617,Boyle; Mary E. T.,23,0,48,25
1658131534798,COGS 13,A01,083071,Bastos; Amalia Pinkusfeld,12,0,71,59
1658131540821,COGS 14A,A01,092681,Semenuks; Arturs,5,1,100,95
1658131546847,COGS 14B,A01,083073,Cheng; Tzu-Han,7,0,63,56
1658131552870,COGS 17,A01,092677,Semenuks; Arturs,7,0,81,74
1658131558895,COGS 100,A01,083619,Allen; Michael Gordon,17,0,70,53
1658131564934,COGS 101A,A01,083621,Davis; Joshua Daniel,9,0,68,59
1658131570959,COGS 101B,A01,091572,Allen; Michael Gordon,14,0,65,51
1658131576984,COGS 101C,A01,083625,Delgado; Tania,17,0,35,18
1658131583016,COGS 107A,A01,083627,Boyle; Mary E. T.,14,0,60,46
1658131589044,COGS 118A,A01,083075,Gupta; Anjum,21,0,76,55
1658131595072,CSE 3,A50,083646,Miranda; Gregory Joseph,24,0,50,26
1658131601096,CSE 8A,A50,083650,Miranda; Gregory Joseph,17,1,56,39
1658131607121,CSE 11,A01,083080,Cao; Yingjun,7,15,40,33
1658131613147,CSE 12,A01,083652,Krause-Levy; Sophia Louisa,30,1,120,90
1658131619172,CSE 15L,A01,083654,Morris; Justin Loren,9,0,50,41
1658131619172,CSE 15L,A02,083655,Morris; Justin Loren,11,0,50,39
1658131625273,CSE 20,A01,083657,Tran; Khoa Dang,39,0,80,41
1658131631309,CSE 21,A01,095574,Bach; Quang Tran,23,0,48,25
1658131637336,CSE 30,A01,083084,Eldon; John,8,0,80,72
1658131637336,CSE 30,B01,095061,Bhaskar; Nishant,9,0,50,41
1658131643696,CSE 100,A01,083659,Cao; Yingjun,5,4,70,65
1658131649723,CSE 134B,A01,083661,Powell; Thomas Allan,25,0,100,75
1658131655753,CSE 140,A01,083663,Gungor; Onat,17,0,85,68
1658131661775,CSE 140L,A01,083088,Eldon; John,23,0,100,77
1658131667819,CSE 175,A01,083665,Kumar; Rakesh,3,0,25,22
1658131673910,CSE 190,A00,092507,Dubnov; Shlomo,8,0,20,12
1658131679940,ECE 45,A01,083139,Congero; Spencer William,7,0,75,68
1658131685974,ECE 65,A50,083695,Saad; Andrew S,12,0,30,18
1658131685974,ECE 65,A51,095125,Saad; Andrew S,24,0,26,2
1658131691999,ECE 109,A01,091882,Touri; Behrouz,21,0,70,49
1658131698024,ECE 180,A00,083140,Abi Samra; Nicholas Camill,1,0,30,29
1658131698024,ECE 180,B00,083141,Abi Samra; Nicholas Camill,0,0,30,30
1658131704049,MATH 10A,A01,083735,Patchell; Gregory David,2,0,30,28
1658131704049,MATH 10A,A02,083736,Patchell; Gregory David,20,0,30,10
1658131704049,MATH 10A,A03,083737,Patchell; Gregory David,16,0,30,14
1658131710082,MATH 10B,A01,083207,Lim; Seonhee,9,0,34,25
1658131710082,MATH 10B,A02,083208,Lim; Seonhee,10,0,35,25
1658131710082,MATH 10B,A03,093472,Lim; Seonhee,7,0,34,27
1658131710082,MATH 10B,B01,083739,Sinha; Shubham,14,0,30,16
1658131716120,MATH 18,A01,083743,Cinel; Cameron Alexander,9,0,30,21
1658131716120,MATH 18,A02,083744,Cinel; Cameron Alexander,18,0,30,12
1658131716120,MATH 18,A03,083745,Cinel; Cameron Alexander,10,0,30,20
1658131716120,MATH 18,B01,083748,Rideout; David Porter,5,0,37,32
1658131716120,MATH 18,B02,083749,Rideout; David Porter,5,0,36,31
1658131716120,MATH 18,B03,083750,Rideout; David Porter,3,0,37,34
1658131716120,MATH 18,B04,083751,Rideout; David Porter,7,0,36,29
1658131716120,MATH 18,B05,093473,Rideout; David Porter,7,0,36,29
1658131716120,MATH 18,B06,093474,Rideout; David Porter,6,0,36,30
1658131722145,MATH 20A,A01,083754,Zheng; Zequn,14,0,40,26
1658131728194,MATH 20B,A01,083756,Briones; Jor-el Thomas Caparas,4,0,36,32
1658131728194,MATH 20B,A02,083757,Briones; Jor-el Thomas Caparas,1,0,36,35
1658131728194,MATH 20B,A03,093475,Briones; Jor-el Thomas Caparas,3,0,36,33
1658131734221,MATH 20C,A01,083760,Briones; Jor-el Thomas Caparas,1,0,35,34
1658131734221,MATH 20C,A02,083761,Briones; Jor-el Thomas Caparas,8,0,35,27
1658131734221,MATH 20C,A03,093476,Briones; Jor-el Thomas Caparas,0,1,36,36
1658131734221,MATH 20C,B01,083762,Bach; Quang Tran,1,0,30,29
1658131740296,MATH 20D,A01,083765,Tran; Brian Kha,5,0,30,25
1658131740296,MATH 20D,A02,083766,Tran; Brian Kha,5,0,30,25
1658131740296,MATH 20D,A03,083767,Tran; Brian Kha,6,0,30,24
1658131746323,MATH 20E,A01,083771,Ganguly; Soumya,12,0,32,20
1658131746323,MATH 20E,A02,083772,Ganguly; Soumya,7,0,32,25
1658131746323,MATH 20E,B01,083773,Ciotti; Benjamin,20,0,35,15
1658131746323,MATH 20E,B02,083774,Ciotti; Benjamin,18,0,35,17
1658131752362,MATH 103A,A01,083777,Greenfeld; Be'Eri,6,0,36,30
1658131752362,MATH 103A,A02,083778,Greenfeld; Be'Eri,5,0,36,31
1658131752362,MATH 103A,A03,093561,Greenfeld; Be'Eri,7,0,36,29
1658131752362,MATH 103A,B01,083779,Greenfeld; Be'Eri,8,0,36,28
1658131752362,MATH 103A,B02,083780,Greenfeld; Be'Eri,4,0,36,32
1658131752362,MATH 103A,B03,093562,Greenfeld; Be'Eri,3,0,36,33
1658131758388,MATH 105,A01,085443,Carter; Anne Toulson,15,0,35,20
1658131758388,MATH 105,A02,093477,Carter; Anne Toulson,20,0,35,15
1658131764421,MATH 109,A01,083213,Ganzberger; Geoffrey Michael,3,0,34,31
1658131764421,MATH 109,A02,083214,Ganzberger; Geoffrey Michael,4,0,34,30
1658131764421,MATH 109,A03,093478,Ganzberger; Geoffrey Michael,2,0,34,32
1658131764421,MATH 109,B01,083215,Ganzberger; Geoffrey Michael,3,0,32,29
1658131764421,MATH 109,B02,083216,Ganzberger; Geoffrey Michael,3,0,32,29
1658131764421,MATH 109,B03,093479,Ganzberger; Geoffrey Michael,8,0,32,24
1658131770457,MATH 142A,A01,083219,Chow; Bennett,7,0,32,25
1658131770457,MATH 142A,A02,083220,Chow; Bennett,10,0,32,22
1658131770457,MATH 142A,A03,093480,Chow; Bennett,9,0,32,23
1658131770457,MATH 142A,B03,093481,Chow; Bennett,8,0,32,24
1658131770457,MATH 142A,B04,093558,Chow; Bennett,14,0,32,18
1658131770457,MATH 142A,B05,093559,Chow; Bennett,7,0,32,25
1658131776493,MATH 193A,A01,083224,Rotar; Vladimir,9,0,34,25
1658131776493,MATH 193A,A02,083225,Rotar; Vladimir,11,0,34,23
1658131776493,MATH 193A,A03,083781,Rotar; Vladimir,5,0,34,29
1658131776493,MATH 193A,A04,083782,Rotar; Vladimir,12,0,34,22
1658131776493,MATH 193A,A05,093482,Rotar; Vladimir,11,0,34,23
1658131782519,MATH 197,001,091859,McAuley; Julian John,9999,0,9999,0
1658131782519,MATH 197,002,095566,Kedlaya; Kiran S.,9997,0,9999,2
1658131782519,MATH 197,003,095567,Xiao; Ming,9999,0,9999,0
1658131782519,MATH 197,004,095571,Perols; Johan Lars,9998,0,9999,1
1658131789667,COGS 9,A01,083615,Shannon; Kyle Michael,11,0,75,64
1658131795693,COGS 11,A01,083617,Boyle; Mary E. T.,23,0,48,25
1658131801718,COGS 13,A01,083071,Bastos; Amalia Pinkusfeld,12,0,71,59
1658131807756,COGS 14A,A01,092681,Semenuks; Arturs,5,1,100,95
1658131813807,COGS 14B,A01,083073,Cheng; Tzu-Han,7,0,63,56
1658131819836,COGS 17,A01,092677,Semenuks; Arturs,7,0,81,74
1658131825881,COGS 100,A01,083619,Allen; Michael Gordon,17,0,70,53
1658131831917,COGS 101A,A01,083621,Davis; Joshua Daniel,9,0,68,59
1658131837941,COGS 101B,A01,091572,Allen; Michael Gordon,14,0,65,51
1658131843979,COGS 101C,A01,083625,Delgado; Tania,17,0,35,18
1658131850003,COGS 107A,A01,083627,Boyle; Mary E. T.,14,0,60,46
1658131856028,COGS 118A,A01,083075,Gupta; Anjum,21,0,76,55
1658131862056,CSE 3,A50,083646,Miranda; Gregory Joseph,24,0,50,26
1658131868088,CSE 8A,A50,083650,Miranda; Gregory Joseph,17,1,56,39
1658131874126,CSE 11,A01,083080,Cao; Yingjun,7,15,40,33
1658131880161,CSE 12,A01,083652,Krause-Levy; Sophia Louisa,30,1,120,90
1658131886192,CSE 15L,A01,083654,Morris; Justin Loren,9,0,50,41
1658131886192,CSE 15L,A02,083655,Morris; Justin Loren,11,0,50,39
1658131892219,CSE 20,A01,083657,Tran; Khoa Dang,39,0,80,41
1658131898244,CSE 21,A01,095574,Bach; Quang Tran,23,0,48,25
1658131904269,CSE 30,A01,083084,Eldon; John,8,0,80,72
1658131904269,CSE 30,B01,095061,Bhaskar; Nishant,9,0,50,41
1658131910293,CSE 100,A01,083659,Cao; Yingjun,5,4,70,65
1658131916405,CSE 134B,A01,083661,Powell; Thomas Allan,25,0,100,75
1658131922433,CSE 140,A01,083663,Gungor; Onat,17,0,85,68
1658131928463,CSE 140L,A01,083088,Eldon; John,23,0,100,77
1658131934494,CSE 175,A01,083665,Kumar; Rakesh,3,0,25,22
1658131940524,CSE 190,A00,092507,Dubnov; Shlomo,8,0,20,12
1658131946552,ECE 45,A01,083139,Congero; Spencer William,7,0,75,68
1658131952587,ECE 65,A50,083695,Saad; Andrew S,12,0,30,18
1658131952587,ECE 65,A51,095125,Saad; Andrew S,24,0,26,2
1658131958612,ECE 109,A01,091882,Touri; Behrouz,21,0,70,49
1658131964643,ECE 180,A00,083140,Abi Samra; Nicholas Camill,1,0,30,29
1658131964643,ECE 180,B00,083141,Abi Samra; Nicholas Camill,0,0,30,30
1658131970678,MATH 10A,A01,083735,Patchell; Gregory David,2,0,30,28
1658131970678,MATH 10A,A02,083736,Patchell; Gregory David,20,0,30,10
1658131970678,MATH 10A,A03,083737,Patchell; Gregory David,16,0,30,14
1658131976707,MATH 10B,A01,083207,Lim; Seonhee,9,0,34,25
1658131976707,MATH 10B,A02,083208,Lim; Seonhee,10,0,35,25
1658131976707,MATH 10B,A03,093472,Lim; Seonhee,7,0,34,27
1658131976707,MATH 10B,B01,083739,Sinha; Shubham,14,0,30,16
1658131982736,MATH 18,A01,083743,Cinel; Cameron Alexander,9,0,30,21
1658131982736,MATH 18,A02,083744,Cinel; Cameron Alexander,18,0,30,12
1658131982736,MATH 18,A03,083745,Cinel; Cameron Alexander,10,0,30,20
1658131982736,MATH 18,B01,083748,Rideout; David Porter,5,0,37,32
1658131982736,MATH 18,B02,083749,Rideout; David Porter,5,0,36,31
1658131982736,MATH 18,B03,083750,Rideout; David Porter,3,0,37,34
1658131982736,MATH 18,B04,083751,Rideout; David Porter,7,0,36,29
1658131982736,MATH 18,B05,093473,Rideout; David Porter,7,0,36,29
1658131982736,MATH 18,B06,093474,Rideout; David Porter,6,0,36,30
1658131988760,MATH 20A,A01,083754,Zheng; Zequn,14,0,40,26
1658131994787,MATH 20B,A01,083756,Briones; Jor-el Thomas Caparas,4,0,36,32
1658131994787,MATH 20B,A02,083757,Briones; Jor-el Thomas Caparas,1,0,36,35
1658131994787,MATH 20B,A03,093475,Briones; Jor-el Thomas Caparas,3,0,36,33
1658132000814,MATH 20C,A01,083760,Briones; Jor-el Thomas Caparas,1,0,35,34
1658132000814,MATH 20C,A02,083761,Briones; Jor-el Thomas Caparas,8,0,35,27
1658132000814,MATH 20C,A03,093476,Briones; Jor-el Thomas Caparas,0,1,36,36
1658132000814,MATH 20C,B01,083762,Bach; Quang Tran,1,0,30,29
1658132006839,MATH 20D,A01,083765,Tran; Brian Kha,5,0,30,25
1658132006839,MATH 20D,A02,083766,Tran; Brian Kha,5,0,30,25
1658132006839,MATH 20D,A03,083767,Tran; Brian Kha,6,0,30,24
1658132012873,MATH 20E,A01,083771,Ganguly; Soumya,12,0,32,20
1658132012873,MATH 20E,A02,083772,Ganguly; Soumya,7,0,32,25
1658132012873,MATH 20E,B01,083773,Ciotti; Benjamin,20,0,35,15
1658132012873,MATH 20E,B02,083774,Ciotti; Benjamin,18,0,35,17
1658132018900,MATH 103A,A01,083777,Greenfeld; Be'Eri,6,0,36,30
1658132018900,MATH 103A,A02,083778,Greenfeld; Be'Eri,5,0,36,31
1658132018900,MATH 103A,A03,093561,Greenfeld; Be'Eri,7,0,36,29
1658132018900,MATH 103A,B01,083779,Greenfeld; Be'Eri,8,0,36,28
1658132018900,MATH 103A,B02,083780,Greenfeld; Be'Eri,4,0,36,32
1658132018900,MATH 103A,B03,093562,Greenfeld; Be'Eri,3,0,36,33
1658132024930,MATH 105,A01,085443,Carter; Anne Toulson,15,0,35,20
1658132024930,MATH 105,A02,093477,Carter; Anne Toulson,20,0,35,15
1658132030960,MATH 109,A01,083213,Ganzberger; Geoffrey Michael,3,0,34,31
1658132030960,MATH 109,A02,083214,Ganzberger; Geoffrey Michael,4,0,34,30
1658132030960,MATH 109,A03,093478,Ganzberger; Geoffrey Michael,2,0,34,32
1658132030960,MATH 109,B01,083215,Ganzberger; Geoffrey Michael,3,0,32,29
1658132030960,MATH 109,B02,083216,Ganzberger; Geoffrey Michael,3,0,32,29
1658132030960,MATH 109,B03,093479,Ganzberger; Geoffrey Michael,8,0,32,24
1658132036987,MATH 142A,A01,083219,Chow; Bennett,7,0,32,25
1658132036987,MATH 142A,A02,083220,Chow; Bennett,10,0,32,22
1658132036987,MATH 142A,A03,093480,Chow; Bennett,9,0,32,23
1658132036987,MATH 142A,B03,093481,Chow; Bennett,8,0,32,24
1658132036987,MATH 142A,B04,093558,Chow; Bennett,14,0,32,18
1658132036987,MATH 142A,B05,093559,Chow; Bennett,7,0,32,25
1658132043014,MATH 193A,A01,083224,Rotar; Vladimir,9,0,34,25
1658132043014,MATH 193A,A02,083225,Rotar; Vladimir,11,0,34,23
1658132043014,MATH 193A,A03,083781,Rotar; Vladimir,5,0,34,29
1658132043014,MATH 193A,A04,083782,Rotar; Vladimir,12,0,34,22
1658132043014,MATH 193A,A05,093482,Rotar; Vladimir,11,0,34,23
1658132049043,MATH 197,001,091859,McAuley; Julian John,9999,0,9999,0
1658132049043,MATH 197,002,095566,Kedlaya; Kiran S.,9997,0,9999,2
1658132049043,MATH 197,003,095567,Xiao; Ming,9999,0,9999,0
1658132049043,MATH 197,004,095571,Perols; Johan Lars,9998,0,9999,1
1658132056139,COGS 9,A01,083615,Shannon; Kyle Michael,11,0,75,64
1658132062164,COGS 11,A01,083617,Boyle; Mary E. T.,23,0,48,25
1658132068193,COGS 13,A01,083071,Bastos; Amalia Pinkusfeld,12,0,71,59
1658132074218,COGS 14A,A01,092681,Semenuks; Arturs,5,1,100,95
1658132080242,COGS 14B,A01,083073,Cheng; Tzu-Han,7,0,63,56
1658132086275,COGS 17,A01,092677,Semenuks; Arturs,7,0,81,74
1658132092300,COGS 100,A01,083619,Allen; Michael Gordon,17,0,70,53
1658132098324,COGS 101A,A01,083621,Davis; Joshua Daniel,9,0,68,59
1658132104357,COGS 101B,A01,091572,Allen; Michael Gordon,14,0,65,51
1658132110381,COGS 101C,A01,083625,Delgado; Tania,17,0,35,18
1658132116415,COGS 107A,A01,083627,Boyle; Mary E. T.,14,0,60,46
1658132122445,COGS 118A,A01,083075,Gupta; Anjum,21,0,76,55
1658132128480,CSE 3,A50,083646,Miranda; Gregory Joseph,24,0,50,26
1658132134505,CSE 8A,A50,083650,Miranda; Gregory Joseph,17,1,56,39
1658132140529,CSE 11,A01,083080,Cao; Yingjun,7,15,40,33
1658132146554,CSE 12,A01,083652,Krause-Levy; Sophia Louisa,30,1,120,90
1658132152581,CSE 15L,A01,083654,Morris; Justin Loren,9,0,50,41
1658132152581,CSE 15L,A02,083655,Morris; Justin Loren,11,0,50,39
1658132158608,CSE 20,A01,083657,Tran; Khoa Dang,39,0,80,41
1658132164640,CSE 21,A01,095574,Bach; Quang Tran,23,0,48,25
1658132170665,CSE 30,A01,083084,Eldon; John,8,0,80,72
1658132170665,CSE 30,B01,095061,Bhaskar; Nishant,9,0,50,41
1658132176692,CSE 100,A01,083659,Cao; Yingjun,5,4,70,65
1658132182720,CSE 134B,A01,083661,Powell; Thomas Allan,25,0,100,75
1658132188753,CSE 140,A01,083663,Gungor; Onat,17,0,85,68
1658132194776,CSE 140L,A01,083088,Eldon; John,23,0,100,77
1658132200799,CSE 175,A01,083665,Kumar; Rakesh,3,0,25,22
1658132206827,CSE 190,A00,092507,Dubnov; Shlomo,8,0,20,12
1658132212857,ECE 45,A01,083139,Congero; Spencer William,7,0,75,68
1658132218885,ECE 65,A50,083695,Saad; Andrew S,12,0,30,18
1658132218885,ECE 65,A51,095125,Saad; Andrew S,24,0,26,2
1658132224909,ECE 109,A01,091882,Touri; Behrouz,21,0,70,49
1658132230934,ECE 180,A00,083140,Abi Samra; Nicholas Camill,1,0,30,29
1658132230934,ECE 180,B00,083141,Abi Samra; Nicholas Camill,0,0,30,30
1658132236966,MATH 10A,A01,083735,Patchell; Gregory David,2,0,30,28
1658132236966,MATH 10A,A02,083736,Patchell; Gregory David,20,0,30,10
1658132236966,MATH 10A,A03,083737,Patchell; Gregory David,16,0,30,14
1658132243003,MATH 10B,A01,083207,Lim; Seonhee,9,0,34,25
1658132243003,MATH 10B,A02,083208,Lim; Seonhee,10,0,35,25
1658132243003,MATH 10B,A03,093472,Lim; Seonhee,7,0,34,27
1658132243003,MATH 10B,B01,083739,Sinha; Shubham,14,0,30,16
1658132249033,MATH 18,A01,083743,Cinel; Cameron Alexander,9,0,30,21
1658132249033,MATH 18,A02,083744,Cinel; Cameron Alexander,18,0,30,12
1658132249033,MATH 18,A03,083745,Cinel; Cameron Alexander,10,0,30,20
1658132249033,MATH 18,B01,083748,Rideout; David Porter,5,0,37,32
1658132249033,MATH 18,B02,083749,Rideout; David Porter,5,0,36,31
1658132249033,MATH 18,B03,083750,Rideout; David Porter,3,0,37,34
1658132249033,MATH 18,B04,083751,Rideout; David Porter,7,0,36,29
1658132249033,MATH 18,B05,093473,Rideout; David Porter,7,0,36,29
1658132249033,MATH 18,B06,093474,Rideout; David Porter,6,0,36,30
1658132255060,MATH 20A,A01,083754,Zheng; Zequn,14,0,40,26
1658132261087,MATH 20B,A01,083756,Briones; Jor-el Thomas Caparas,4,0,36,32
1658132261087,MATH 20B,A02,083757,Briones; Jor-el Thomas Caparas,1,0,36,35
1658132261087,MATH 20B,A03,093475,Briones; Jor-el Thomas Caparas,3,0,36,33
1658132267120,MATH 20C,A01,083760,Briones; Jor-el Thomas Caparas,1,0,35,34
1658132267120,MATH 20C,A02,083761,Briones; Jor-el Thomas Caparas,8,0,35,27
1658132267120,MATH 20C,A03,093476,Briones; Jor-el Thomas Caparas,0,1,36,36
1658132267120,MATH 20C,B01,083762,Bach; Quang Tran,1,0,30,29
1658132273150,MATH 20D,A01,083765,Tran; Brian Kha,5,0,30,25
1658132273150,MATH 20D,A02,083766,Tran; Brian Kha,5,0,30,25
1658132273150,MATH 20D,A03,083767,Tran; Brian Kha,6,0,30,24
1658132279185,MATH 20E,A01,083771,Ganguly; Soumya,12,0,32,20
1658132279185,MATH 20E,A02,083772,Ganguly; Soumya,7,0,32,25
1658132279185,MATH 20E,B01,083773,Ciotti; Benjamin,20,0,35,15
1658132279185,MATH 20E,B02,083774,Ciotti; Benjamin,18,0,35,17
1658132285215,MATH 103A,A01,083777,Greenfeld; Be'Eri,6,0,36,30
1658132285215,MATH 103A,A02,083778,Greenfeld; Be'Eri,5,0,36,31
1658132285215,MATH 103A,A03,093561,Greenfeld; Be'Eri,7,0,36,29
1658132285215,MATH 103A,B01,083779,Greenfeld; Be'Eri,8,0,36,28
1658132285215,MATH 103A,B02,083780,Greenfeld; Be'Eri,4,0,36,32
1658132285215,MATH 103A,B03,093562,Greenfeld; Be'Eri,3,0,36,33
1658132291247,MATH 105,A01,085443,Carter; Anne Toulson,15,0,35,20
1658132291247,MATH 105,A02,093477,Carter; Anne Toulson,20,0,35,15
1658132297273,MATH 109,A01,083213,Ganzberger; Geoffrey Michael,3,0,34,31
1658132297273,MATH 109,A02,083214,Ganzberger; Geoffrey Michael,4,0,34,30
1658132297273,MATH 109,A03,093478,Ganzberger; Geoffrey Michael,2,0,34,32
1658132297273,MATH 109,B01,083215,Ganzberger; Geoffrey Michael,3,0,32,29
1658132297273,MATH 109,B02,083216,Ganzberger; Geoffrey Michael,3,0,32,29
1658132297273,MATH 109,B03,093479,Ganzberger; Geoffrey Michael,8,0,32,24
1658132303301,MATH 142A,A01,083219,Chow; Bennett,7,0,32,25
1658132303301,MATH 142A,A02,083220,Chow; Bennett,10,0,32,22
1658132303301,MATH 142A,A03,093480,Chow; Bennett,9,0,32,23
1658132303301,MATH 142A,B03,093481,Chow; Bennett,8,0,32,24
1658132303301,MATH 142A,B04,093558,Chow; Bennett,14,0,32,18
1658132303301,MATH 142A,B05,093559,Chow; Bennett,7,0,32,25
1658132309329,MATH 193A,A01,083224,Rotar; Vladimir,9,0,34,25
1658132309329,MATH 193A,A02,083225,Rotar; Vladimir,11,0,34,23
1658132309329,MATH 193A,A03,083781,Rotar; Vladimir,5,0,34,29
1658132309329,MATH 193A,A04,083782,Rotar; Vladimir,12,0,34,22
1658132309329,MATH 193A,A05,093482,Rotar; Vladimir,11,0,34,23
1658132315362,MATH 197,001,091859,McAuley; Julian John,9999,0,9999,0
1658132315362,MATH 197,002,095566,Kedlaya; Kiran S.,9997,0,9999,2
1658132315362,MATH 197,003,095567,Xiao; Ming,9999,0,9999,0
1658132315362,MATH 197,004,095571,Perols; Johan Lars,9998,0,9999,1
1658132322437,COGS 9,A01,083615,Shannon; Kyle Michael,11,0,75,64
1658132328466,COGS 11,A01,083617,Boyle; Mary E. T.,23,0,48,25
1658132334490,COGS 13,A01,083071,Bastos; Amalia Pinkusfeld,12,0,71,59
1658132340527,COGS 14A,A01,092681,Semenuks; Arturs,5,1,100,95
1658132346555,COGS 14B,A01,083073,Cheng; Tzu-Han,7,0,63,56
1658132352585,COGS 17,A01,092677,Semenuks; Arturs,7,0,81,74
1658132358625,COGS 100,A01,083619,Allen; Michael Gordon,17,0,70,53
1658132364654,COGS 101A,A01,083621,Davis; Joshua Daniel,9,0,68,59
1658132370681,COGS 101B,A01,091572,Allen; Michael Gordon,14,0,65,51
1658132376719,COGS 101C,A01,083625,Delgado; Tania,17,0,35,18
1658132382748,COGS 107A,A01,083627,Boyle; Mary E. T.,14,0,60,46
1658132388778,COGS 118A,A01,083075,Gupta; Anjum,21,0,76,55
1658132394811,CSE 3,A50,083646,Miranda; Gregory Joseph,24,0,50,26
1658132400841,CSE 8A,A50,083650,Miranda; Gregory Joseph,17,1,56,39
1658132406867,CSE 11,A01,083080,Cao; Yingjun,7,15,40,33
1658132412893,CSE 12,A01,083652,Krause-Levy; Sophia Louisa,30,1,120,90
1658132418919,CSE 15L,A01,083654,Morris; Justin Loren,9,0,50,41
1658132418919,CSE 15L,A02,083655,Morris; Justin Loren,11,0,50,39
1658132424944,CSE 20,A01,083657,Tran; Khoa Dang,39,0,80,41
1658132430968,CSE 21,A01,095574,Bach; Quang Tran,23,0,48,25
1658132437001,CSE 30,A01,083084,Eldon; John,8,0,80,72
1658132437001,CSE 30,B01,095061,Bhaskar; Nishant,9,0,50,41
1658132443026,CSE 100,A01,083659,Cao; Yingjun,5,4,70,65
1658132449050,CSE 134B,A01,083661,Powell; Thomas Allan,25,0,100,75
1658132455077,CSE 140,A01,083663,Gungor; Onat,17,0,85,68
1658132461101,CSE 140L,A01,083088,Eldon; John,23,0,100,77
1658132467127,CSE 175,A01,083665,Kumar; Rakesh,3,0,25,22
1658132473152,CSE 190,A00,092507,Dubnov; Shlomo,8,0,20,12
1658132479179,ECE 45,A01,083139,Congero; Spencer William,7,0,75,68
1658132485214,ECE 65,A50,083695,Saad; Andrew S,12,0,30,18
1658132485214,ECE 65,A51,095125,Saad; Andrew S,24,0,26,2
1658132491251,ECE 109,A01,091882,Touri; Behrouz,21,0,70,49
1658132497276,ECE 180,A00,083140,Abi Samra; Nicholas Camill,1,0,30,29
1658132497276,ECE 180,B00,083141,Abi Samra; Nicholas Camill,0,0,30,30
1658132503313,MATH 10A,A01,083735,Patchell; Gregory David,2,0,30,28
1658132503313,MATH 10A,A02,083736,Patchell; Gregory David,20,0,30,10
1658132503313,MATH 10A,A03,083737,Patchell; Gregory David,16,0,30,14
1658132509349,MATH 10B,A01,083207,Lim; Seonhee,9,0,34,25
1658132509349,MATH 10B,A02,083208,Lim; Seonhee,10,0,35,25
1658132509349,MATH 10B,A03,093472,Lim; Seonhee,7,0,34,27
1658132509349,MATH 10B,B01,083739,Sinha; Shubham,14,0,30,16
1658132515469,MATH 18,A01,083743,Cinel; Cameron Alexander,9,0,30,21
1658132515469,MATH 18,A02,083744,Cinel; Cameron Alexander,18,0,30,12
1658132515469,MATH 18,A03,083745,Cinel; Cameron Alexander,10,0,30,20
1658132515469,MATH 18,B01,083748,Rideout; David Porter,5,0,37,32
1658132515469,MATH 18,B02,083749,Rideout; David Porter,5,0,36,31
1658132515469,MATH 18,B03,083750,Rideout; David Porter,3,0,37,34
1658132515469,MATH 18,B04,083751,Rideout; David Porter,7,0,36,29
1658132515469,MATH 18,B05,093473,Rideout; David Porter,7,0,36,29
1658132515469,MATH 18,B06,093474,Rideout; David Porter,6,0,36,30
1658132521511,MATH 20A,A01,083754,Zheng; Zequn,14,0,40,26
1658132527557,MATH 20B,A01,083756,Briones; Jor-el Thomas Caparas,4,0,36,32
1658132527557,MATH 20B,A02,083757,Briones; Jor-el Thomas Caparas,1,0,36,35
1658132527557,MATH 20B,A03,093475,Briones; Jor-el Thomas Caparas,3,0,36,33
1658132533583,MATH 20C,A01,083760,Briones; Jor-el Thomas Caparas,1,0,35,34
1658132533583,MATH 20C,A02,083761,Briones; Jor-el Thomas Caparas,8,0,35,27
1658132533583,MATH 20C,A03,093476,Briones; Jor-el Thomas Caparas,0,1,36,36
1658132533583,MATH 20C,B01,083762,Bach; Quang Tran,1,0,30,29
1658132539616,MATH 20D,A01,083765,Tran; Brian Kha,5,0,30,25
1658132539616,MATH 20D,A02,083766,Tran; Brian Kha,5,0,30,25
1658132539616,MATH 20D,A03,083767,Tran; Brian Kha,6,0,30,24
1658132545641,MATH 20E,A01,083771,Ganguly; Soumya,12,0,32,20
1658132545641,MATH 20E,A02,083772,Ganguly; Soumya,7,0,32,25
1658132545641,MATH 20E,B01,083773,Ciotti; Benjamin,20,0,35,15
1658132545641,MATH 20E,B02,083774,Ciotti; Benjamin,18,0,35,17
1658132551687,MATH 103A,A01,083777,Greenfeld; Be'Eri,6,0,36,30
1658132551687,MATH 103A,A02,083778,Greenfeld; Be'Eri,5,0,36,31
1658132551687,MATH 103A,A03,093561,Greenfeld; Be'Eri,7,0,36,29
1658132551687,MATH 103A,B01,083779,Greenfeld; Be'Eri,8,0,36,28
1658132551687,MATH 103A,B02,083780,Greenfeld; Be'Eri,4,0,36,32
1658132551687,MATH 103A,B03,093562,Greenfeld; Be'Eri,3,0,36,33
1658132557714,MATH 105,A01,085443,Carter; Anne Toulson,15,0,35,20
1658132557714,MATH 105,A02,093477,Carter; Anne Toulson,20,0,35,15
1658132563746,MATH 109,A01,083213,Ganzberger; Geoffrey Michael,3,0,34,31
1658132563746,MATH 109,A02,083214,Ganzberger; Geoffrey Michael,4,0,34,30
1658132563746,MATH 109,A03,093478,Ganzberger; Geoffrey Michael,2,0,34,32
1658132563746,MATH 109,B01,083215,Ganzberger; Geoffrey Michael,3,0,32,29
1658132563746,MATH 109,B02,083216,Ganzberger; Geoffrey Michael,3,0,32,29
1658132563746,MATH 109,B03,093479,Ganzberger; Geoffrey Michael,8,0,32,24
1658132569773,MATH 142A,A01,083219,Chow; Bennett,7,0,32,25
1658132569773,MATH 142A,A02,083220,Chow; Bennett,10,0,32,22
1658132569773,MATH 142A,A03,093480,Chow; Bennett,9,0,32,23
1658132569773,MATH 142A,B03,093481,Chow; Bennett,8,0,32,24
1658132569773,MATH 142A,B04,093558,Chow; Bennett,14,0,32,18
1658132569773,MATH 142A,B05,093559,Chow; Bennett,7,0,32,25
1658132575801,MATH 193A,A01,083224,Rotar; Vladimir,9,0,34,25
1658132575801,MATH 193A,A02,083225,Rotar; Vladimir,11,0,34,23
1658132575801,MATH 193A,A03,083781,Rotar; Vladimir,5,0,34,29
1658132575801,MATH 193A,A04,083782,Rotar; Vladimir,12,0,34,22
1658132575801,MATH 193A,A05,093482,Rotar; Vladimir,11,0,34,23
1658132581825,MATH 197,001,091859,McAuley; Julian John,9999,0,9999,0
1658132581825,MATH 197,002,095566,Kedlaya; Kiran S.,9997,0,9999,2
1658132581825,MATH 197,003,095567,Xiao; Ming,9999,0,9999,0
1658132581825,MATH 197,004,095571,Perols; Johan Lars,9998,0,9999,1
1658132588900,COGS 9,A01,083615,Shannon; Kyle Michael,11,0,75,64
1658132594937,COGS 11,A01,083617,Boyle; Mary E. T.,23,0,48,25
1658132600964,COGS 13,A01,083071,Bastos; Amalia Pinkusfeld,12,0,71,59
1658132606990,COGS 14A,A01,092681,Semenuks; Arturs,5,1,100,95
1658132613030,COGS 14B,A01,083073,Cheng; Tzu-Han,7,0,63,56
1658132619079,COGS 17,A01,092677,Semenuks; Arturs,7,0,81,74
1658132625105,COGS 100,A01,083619,Allen; Michael Gordon,17,0,70,53
1658132631132,COGS 101A,A01,083621,Davis; Joshua Daniel,9,0,68,59
1658132637156,COGS 101B,A01,091572,Allen; Michael Gordon,14,0,65,51
1658132643184,COGS 101C,A01,083625,Delgado; Tania,17,0,35,18
1658132649209,COGS 107A,A01,083627,Boyle; Mary E. T.,14,0,60,46
1658132655236,COGS 118A,A01,083075,Gupta; Anjum,21,0,76,55
1658132661277,CSE 3,A50,083646,Miranda; Gregory Joseph,24,0,50,26
1658132667307,CSE 8A,A50,083650,Miranda; Gregory Joseph,17,1,56,39
1658132673337,CSE 11,A01,083080,Cao; Yingjun,7,15,40,33
1658132679364,CSE 12,A01,083652,Krause-Levy; Sophia Louisa,30,1,120,90
1658132685390,CSE 15L,A01,083654,Morris; Justin Loren,9,0,50,41
1658132685390,CSE 15L,A02,083655,Morris; Justin Loren,11,0,50,39
1658132691420,CSE 20,A01,083657,Tran; Khoa Dang,39,0,80,41
1658132697451,CSE 21,A01,095574,Bach; Quang Tran,23,0,48,25
1658132703480,CSE 30,A01,083084,Eldon; John,8,0,80,72
1658132703480,CSE 30,B01,095061,Bhaskar; Nishant,9,0,50,41
1658132709505,CSE 100,A01,083659,Cao; Yingjun,5,4,70,65
1658132715535,CSE 134B,A01,083661,Powell; Thomas Allan,25,0,100,75
1658132721583,CSE 140,A01,083663,Gungor; Onat,17,0,85,68
1658132727607,CSE 140L,A01,083088,Eldon; John,23,0,100,77
1658132733635,CSE 175,A01,083665,Kumar; Rakesh,3,0,25,22
1658132739669,CSE 190,A00,092507,Dubnov; Shlomo,8,0,20,12
1658132745702,ECE 45,A01,083139,Congero; Spencer William,7,0,75,68
1658132751728,ECE 65,A50,083695,Saad; Andrew S,12,0,30,18
1658132751728,ECE 65,A51,095125,Saad; Andrew S,24,0,26,2
1658132757755,ECE 109,A01,091882,Touri; Behrouz,21,0,70,49
1658132763780,ECE 180,A00,083140,Abi Samra; Nicholas Camill,1,0,30,29
1658132763780,ECE 180,B00,083141,Abi Samra; Nicholas Camill,0,0,30,30
1658132769819,MATH 10A,A01,083735,Patchell; Gregory David,2,0,30,28
1658132769819,MATH 10A,A02,083736,Patchell; Gregory David,20,0,30,10
1658132769819,MATH 10A,A03,083737,Patchell; Gregory David,16,0,30,14
1658132775852,MATH 10B,A01,083207,Lim; Seonhee,9,0,34,25
1658132775852,MATH 10B,A02,083208,Lim; Seonhee,10,0,35,25
1658132775852,MATH 10B,A03,093472,Lim; Seonhee,7,0,34,27
1658132775852,MATH 10B,B01,083739,Sinha; Shubham,14,0,30,16
1658132781883,MATH 18,A01,083743,Cinel; Cameron Alexander,9,0,30,21
1658132781883,MATH 18,A02,083744,Cinel; Cameron Alexander,18,0,30,12
1658132781883,MATH 18,A03,083745,Cinel; Cameron Alexander,10,0,30,20
1658132781883,MATH 18,B01,083748,Rideout; David Porter,5,0,37,32
1658132781883,MATH 18,B02,083749,Rideout; David Porter,5,0,36,31
1658132781883,MATH 18,B03,083750,Rideout; David Porter,3,0,37,34
1658132781883,MATH 18,B04,083751,Rideout; David Porter,7,0,36,29
1658132781883,MATH 18,B05,093473,Rideout; David Porter,7,0,36,29
1658132781883,MATH 18,B06,093474,Rideout; David Porter,6,0,36,30
1658132787910,MATH 20A,A01,083754,Zheng; Zequn,14,0,40,26
1658132793937,MATH 20B,A01,083756,Briones; Jor-el Thomas Caparas,4,0,36,32
1658132793937,MATH 20B,A02,083757,Briones; Jor-el Thomas Caparas,1,0,36,35
1658132793937,MATH 20B,A03,093475,Briones; Jor-el Thomas Caparas,3,0,36,33
1658132799967,MATH 20C,A01,083760,Briones; Jor-el Thomas Caparas,1,0,35,34
1658132799967,MATH 20C,A02,083761,Briones; Jor-el Thomas Caparas,8,0,35,27
1658132799967,MATH 20C,A03,093476,Briones; Jor-el Thomas Caparas,0,1,36,36
1658132799967,MATH 20C,B01,083762,Bach; Quang Tran,1,0,30,29
1658132806004,MATH 20D,A01,083765,Tran; Brian Kha,5,0,30,25
1658132806004,MATH 20D,A02,083766,Tran; Brian Kha,5,0,30,25
1658132806004,MATH 20D,A03,083767,Tran; Brian Kha,6,0,30,24
1658132812038,MATH 20E,A01,083771,Ganguly; Soumya,12,0,32,20
1658132812038,MATH 20E,A02,083772,Ganguly; Soumya,7,0,32,25
1658132812038,MATH 20E,B01,083773,Ciotti; Benjamin,20,0,35,15
1658132812038,MATH 20E,B02,083774,Ciotti; Benjamin,18,0,35,17
1658132818076,MATH 103A,A01,083777,Greenfeld; Be'Eri,6,0,36,30
1658132818076,MATH 103A,A02,083778,Greenfeld; Be'Eri,5,0,36,31
1658132818076,MATH 103A,A03,093561,Greenfeld; Be'Eri,7,0,36,29
1658132818076,MATH 103A,B01,083779,Greenfeld; Be'Eri,8,0,36,28
1658132818076,MATH 103A,B02,083780,Greenfeld; Be'Eri,4,0,36,32
1658132818076,MATH 103A,B03,093562,Greenfeld; Be'Eri,3,0,36,33
1658132824108,MATH 105,A01,085443,Carter; Anne Toulson,15,0,35,20
1658132824108,MATH 105,A02,093477,Carter; Anne Toulson,20,0,35,15
1658132830136,MATH 109,A01,083213,Ganzberger; Geoffrey Michael,3,0,34,31
1658132830136,MATH 109,A02,083214,Ganzberger; Geoffrey Michael,4,0,34,30
1658132830136,MATH 109,A03,093478,Ganzberger; Geoffrey Michael,2,0,34,32
1658132830136,MATH 109,B01,083215,Ganzberger; Geoffrey Michael,3,0,32,29
1658132830136,MATH 109,B02,083216,Ganzberger; Geoffrey Michael,3,0,32,29
1658132830136,MATH 109,B03,093479,Ganzberger; Geoffrey Michael,8,0,32,24
1658132836164,MATH 142A,A01,083219,Chow; Bennett,7,0,32,25
1658132836164,MATH 142A,A02,083220,Chow; Bennett,10,0,32,22
1658132836164,MATH 142A,A03,093480,Chow; Bennett,9,0,32,23
1658132836164,MATH 142A,B03,093481,Chow; Bennett,8,0,32,24
1658132836164,MATH 142A,B04,093558,Chow; Bennett,14,0,32,18
1658132836164,MATH 142A,B05,093559,Chow; Bennett,7,0,32,25
1658132842189,MATH 193A,A01,083224,Rotar; Vladimir,9,0,34,25
1658132842189,MATH 193A,A02,083225,Rotar; Vladimir,11,0,34,23
1658132842189,MATH 193A,A03,083781,Rotar; Vladimir,5,0,34,29
1658132842189,MATH 193A,A04,083782,Rotar; Vladimir,12,0,34,22
1658132842189,MATH 193A,A05,093482,Rotar; Vladimir,11,0,34,23
1658132848217,MATH 197,001,091859,McAuley; Julian John,9999,0,9999,0
1658132848217,MATH 197,002,095566,Kedlaya; Kiran S.,9997,0,9999,2
1658132848217,MATH 197,003,095567,Xiao; Ming,9999,0,9999,0
1658132848217,MATH 197,004,095571,Perols; Johan Lars,9998,0,9999,1
1658132855299,COGS 9,A01,083615,Shannon; Kyle Michael,11,0,75,64
1658132861324,COGS 11,A01,083617,Boyle; Mary E. T.,23,0,48,25
1658132867360,COGS 13,A01,083071,Bastos; Amalia Pinkusfeld,12,0,71,59
1658132873393,COGS 14A,A01,092681,Semenuks; Arturs,5,1,100,95
1658132879418,COGS 14B,A01,083073,Cheng; Tzu-Han,7,0,63,56
1658132885441,COGS 17,A01,092677,Semenuks; Arturs,7,0,81,74
1658132891472,COGS 100,A01,083619,Allen; Michael Gordon,17,0,70,53
1658132897502,COGS 101A,A01,083621,Davis; Joshua Daniel,9,0,68,59
1658132903532,COGS 101B,A01,091572,Allen; Michael Gordon,14,0,65,51
1658132909559,COGS 101C,A01,083625,Delgado; Tania,17,0,35,18
1658132915585,COGS 107A,A01,083627,Boyle; Mary E. T.,14,0,60,46
1658132921614,COGS 118A,A01,083075,Gupta; Anjum,21,0,76,55
1658132927640,CSE 3,A50,083646,Miranda; Gregory Joseph,24,0,50,26
1658132933671,CSE 8A,A50,083650,Miranda; Gregory Joseph,17,1,56,39
1658132939694,CSE 11,A01,083080,Cao; Yingjun,7,15,40,33
1658132945726,CSE 12,A01,083652,Krause-Levy; Sophia Louisa,30,1,120,90
1658132951751,CSE 15L,A01,083654,Morris; Justin Loren,9,0,50,41
1658132951751,CSE 15L,A02,083655,Morris; Justin Loren,11,0,50,39
1658132957776,CSE 20,A01,083657,Tran; Khoa Dang,39,0,80,41
1658132963805,CSE 21,A01,095574,Bach; Quang Tran,23,0,48,25
1658132969831,CSE 30,A01,083084,Eldon; John,8,0,80,72
1658132969831,CSE 30,B01,095061,Bhaskar; Nishant,9,0,50,41
1658132975858,CSE 100,A01,083659,Cao; Yingjun,5,4,70,65
1658132981884,CSE 134B,A01,083661,Powell; Thomas Allan,25,0,100,75
1658132987913,CSE 140,A01,083663,Gungor; Onat,17,0,85,68
1658132993938,CSE 140L,A01,083088,Eldon; John,23,0,100,77
1658132999962,CSE 175,A01,083665,Kumar; Rakesh,3,0,25,22
1658133005989,CSE 190,A00,092507,Dubnov; Shlomo,8,0,20,12
1658133012023,ECE 45,A01,083139,Congero; Spencer William,7,0,75,68
1658133018054,ECE 65,A50,083695,Saad; Andrew S,12,0,30,18
1658133018054,ECE 65,A51,095125,Saad; Andrew S,24,0,26,2
1658133024084,ECE 109,A01,091882,Touri; Behrouz,21,0,70,49
1658133030109,ECE 180,A00,083140,Abi Samra; Nicholas Camill,1,0,30,29
1658133030109,ECE 180,B00,083141,Abi Samra; Nicholas Camill,0,0,30,30
1658133036145,MATH 10A,A01,083735,Patchell; Gregory David,2,0,30,28
1658133036145,MATH 10A,A02,083736,Patchell; Gregory David,20,0,30,10
1658133036145,MATH 10A,A03,083737,Patchell; Gregory David,16,0,30,14
1658133042182,MATH 10B,A01,083207,Lim; Seonhee,9,0,34,25
1658133042182,MATH 10B,A02,083208,Lim; Seonhee,10,0,35,25
1658133042182,MATH 10B,A03,093472,Lim; Seonhee,7,0,34,27
1658133042182,MATH 10B,B01,083739,Sinha; Shubham,14,0,30,16
1658133048213,MATH 18,A01,083743,Cinel; Cameron Alexander,9,0,30,21
1658133048213,MATH 18,A02,083744,Cinel; Cameron Alexander,18,0,30,12
1658133048213,MATH 18,A03,083745,Cinel; Cameron Alexander,10,0,30,20
1658133048213,MATH 18,B01,083748,Rideout; David Porter,5,0,37,32
1658133048213,MATH 18,B02,083749,Rideout; David Porter,5,0,36,31
1658133048213,MATH 18,B03,083750,Rideout; David Porter,3,0,37,34
1658133048213,MATH 18,B04,083751,Rideout; David Porter,7,0,36,29
1658133048213,MATH 18,B05,093473,Rideout; David Porter,7,0,36,29
1658133048213,MATH 18,B06,093474,Rideout; David Porter,6,0,36,30
1658133054237,MATH 20A,A01,083754,Zheng; Zequn,14,0,40,26
1658133060264,MATH 20B,A01,083756,Briones; Jor-el Thomas Caparas,4,0,36,32
1658133060264,MATH 20B,A02,083757,Briones; Jor-el Thomas Caparas,1,0,36,35
1658133060264,MATH 20B,A03,093475,Briones; Jor-el Thomas Caparas,3,0,36,33
1658133066359,MATH 20C,A01,083760,Briones; Jor-el Thomas Caparas,1,0,35,34
1658133066359,MATH 20C,A02,083761,Briones; Jor-el Thomas Caparas,8,0,35,27
1658133066359,MATH 20C,A03,093476,Briones; Jor-el Thomas Caparas,0,1,36,36
1658133066359,MATH 20C,B01,083762,Bach; Quang Tran,1,0,30,29
1658133072390,MATH 20D,A01,083765,Tran; Brian Kha,5,0,30,25
1658133072390,MATH 20D,A02,083766,Tran; Brian Kha,5,0,30,25
1658133072390,MATH 20D,A03,083767,Tran; Brian Kha,6,0,30,24
1658133078417,MATH 20E,A01,083771,Ganguly; Soumya,12,0,32,20
1658133078417,MATH 20E,A02,083772,Ganguly; Soumya,7,0,32,25
1658133078417,MATH 20E,B01,083773,Ciotti; Benjamin,20,0,35,15
1658133078417,MATH 20E,B02,083774,Ciotti; Benjamin,18,0,35,17
1658133084449,MATH 103A,A01,083777,Greenfeld; Be'Eri,6,0,36,30
1658133084449,MATH 103A,A02,083778,Greenfeld; Be'Eri,5,0,36,31
1658133084449,MATH 103A,A03,093561,Greenfeld; Be'Eri,7,0,36,29
1658133084449,MATH 103A,B01,083779,Greenfeld; Be'Eri,8,0,36,28
1658133084449,MATH 103A,B02,083780,Greenfeld; Be'Eri,4,0,36,32
1658133084449,MATH 103A,B03,093562,Greenfeld; Be'Eri,3,0,36,33
1658133090475,MATH 105,A01,085443,Carter; Anne Toulson,15,0,35,20
1658133090475,MATH 105,A02,093477,Carter; Anne Toulson,20,0,35,15
1658133096501,MATH 109,A01,083213,Ganzberger; Geoffrey Michael,3,0,34,31
1658133096501,MATH 109,A02,083214,Ganzberger; Geoffrey Michael,4,0,34,30
1658133096501,MATH 109,A03,093478,Ganzberger; Geoffrey Michael,2,0,34,32
1658133096501,MATH 109,B01,083215,Ganzberger; Geoffrey Michael,3,0,32,29
1658133096501,MATH 109,B02,083216,Ganzberger; Geoffrey Michael,3,0,32,29
1658133096501,MATH 109,B03,093479,Ganzberger; Geoffrey Michael,8,0,32,24
1658133102527,MATH 142A,A01,083219,Chow; Bennett,7,0,32,25
1658133102527,MATH 142A,A02,083220,Chow; Bennett,10,0,32,22
1658133102527,MATH 142A,A03,093480,Chow; Bennett,9,0,32,23
1658133102527,MATH 142A,B03,093481,Chow; Bennett,8,0,32,24
1658133102527,MATH 142A,B04,093558,Chow; Bennett,14,0,32,18
1658133102527,MATH 142A,B05,093559,Chow; Bennett,7,0,32,25
1658133108561,MATH 193A,A01,083224,Rotar; Vladimir,9,0,34,25
1658133108561,MATH 193A,A02,083225,Rotar; Vladimir,11,0,34,23
1658133108561,MATH 193A,A03,083781,Rotar; Vladimir,5,0,34,29
1658133108561,MATH 193A,A04,083782,Rotar; Vladimir,12,0,34,22
1658133108561,MATH 193A,A05,093482,Rotar; Vladimir,11,0,34,23
1658133114663,MATH 197,001,091859,McAuley; Julian John,9999,0,9999,0
1658133114663,MATH 197,002,095566,Kedlaya; Kiran S.,9997,0,9999,2
1658133114663,MATH 197,003,095567,Xiao; Ming,9999,0,9999,0
1658133114663,MATH 197,004,095571,Perols; Johan Lars,9998,0,9999,1
1658133121728,COGS 9,A01,083615,Shannon; Kyle Michael,11,0,75,64
1658133127756,COGS 11,A01,083617,Boyle; Mary E. T.,23,0,48,25
1658133133785,COGS 13,A01,083071,Bastos; Amalia Pinkusfeld,12,0,71,59
1658133139810,COGS 14A,A01,092681,Semenuks; Arturs,5,1,100,95
1658133145833,COGS 14B,A01,083073,Cheng; Tzu-Han,7,0,63,56
1658133151858,COGS 17,A01,092677,Semenuks; Arturs,7,0,81,74
1658133157883,COGS 100,A01,083619,Allen; Michael Gordon,17,0,70,53
1658133163909,COGS 101A,A01,083621,Davis; Joshua Daniel,9,0,68,59
1658133169934,COGS 101B,A01,091572,Allen; Michael Gordon,14,0,65,51
1658133175970,COGS 101C,A01,083625,Delgado; Tania,17,0,35,18
1658133181994,COGS 107A,A01,083627,Boyle; Mary E. T.,14,0,60,46
1658133188024,COGS 118A,A01,083075,Gupta; Anjum,21,0,76,55
1658133194061,CSE 3,A50,083646,Miranda; Gregory Joseph,24,0,50,26
1658133200085,CSE 8A,A50,083650,Miranda; Gregory Joseph,17,1,56,39
1658133206110,CSE 11,A01,083080,Cao; Yingjun,7,15,40,33
1658133212135,CSE 12,A01,083652,Krause-Levy; Sophia Louisa,30,1,120,90
1658133218164,CSE 15L,A01,083654,Morris; Justin Loren,9,0,50,41
1658133218164,CSE 15L,A02,083655,Morris; Justin Loren,11,0,50,39
1658133224189,CSE 20,A01,083657,Tran; Khoa Dang,39,0,80,41
1658133230219,CSE 21,A01,095574,Bach; Quang Tran,23,0,48,25
1658133236252,CSE 30,A01,083084,Eldon; John,8,0,80,72
1658133236252,CSE 30,B01,095061,Bhaskar; Nishant,9,0,50,41
1658133242285,CSE 100,A01,083659,Cao; Yingjun,5,4,70,65
1658133248325,CSE 134B,A01,083661,Powell; Thomas Allan,25,0,100,75
1658133254354,CSE 140,A01,083663,Gungor; Onat,17,0,85,68
1658133260382,CSE 140L,A01,083088,Eldon; John,23,0,100,77
1658133266408,CSE 175,A01,083665,Kumar; Rakesh,3,0,25,22
1658133272440,CSE 190,A00,092507,Dubnov; Shlomo,8,0,20,12
1658133278467,ECE 45,A01,083139,Congero; Spencer William,7,0,75,68
1658133284511,ECE 65,A50,083695,Saad; Andrew S,12,0,30,18
1658133284511,ECE 65,A51,095125,Saad; Andrew S,24,0,26,2
1658133290541,ECE 109,A01,091882,Touri; Behrouz,21,0,70,49
1658133296566,ECE 180,A00,083140,Abi Samra; Nicholas Camill,1,0,30,29
1658133296566,ECE 180,B00,083141,Abi Samra; Nicholas Camill,0,0,30,30
1658133302598,MATH 10A,A01,083735,Patchell; Gregory David,2,0,30,28
1658133302598,MATH 10A,A02,083736,Patchell; Gregory David,20,0,30,10
1658133302598,MATH 10A,A03,083737,Patchell; Gregory David,16,0,30,14
1658133308632,MATH 10B,A01,083207,Lim; Seonhee,9,0,34,25
1658133308632,MATH 10B,A02,083208,Lim; Seonhee,10,0,35,25
1658133308632,MATH 10B,A03,093472,Lim; Seonhee,7,0,34,27
1658133308632,MATH 10B,B01,083739,Sinha; Shubham,14,0,30,16
1658133314673,MATH 18,A01,083743,Cinel; Cameron Alexander,9,0,30,21
1658133314673,MATH 18,A02,083744,Cinel; Cameron Alexander,18,0,30,12
1658133314673,MATH 18,A03,083745,Cinel; Cameron Alexander,10,0,30,20
1658133314673,MATH 18,B01,083748,Rideout; David Porter,5,0,37,32
1658133314673,MATH 18,B02,083749,Rideout; David Porter,5,0,36,31
1658133314673,MATH 18,B03,083750,Rideout; David Porter,3,0,37,34
1658133314673,MATH 18,B04,083751,Rideout; David Porter,7,0,36,29
1658133314673,MATH 18,B05,093473,Rideout; David Porter,7,0,36,29
1658133314673,MATH 18,B06,093474,Rideout; David Porter,6,0,36,30
1658133320703,MATH 20A,A01,083754,Zheng; Zequn,14,0,40,26
1658133326729,MATH 20B,A01,083756,Briones; Jor-el Thomas Caparas,4,0,36,32
1658133326729,MATH 20B,A02,083757,Briones; Jor-el Thomas Caparas,1,0,36,35
1658133326729,MATH 20B,A03,093475,Briones; Jor-el Thomas Caparas,3,0,36,33
1658133332758,MATH 20C,A01,083760,Briones; Jor-el Thomas Caparas,1,0,35,34
1658133332758,MATH 20C,A02,083761,Briones; Jor-el Thomas Caparas,8,0,35,27
1658133332758,MATH 20C,A03,093476,Briones; Jor-el Thomas Caparas,0,1,36,36
1658133332758,MATH 20C,B01,083762,Bach; Quang Tran,1,0,30,29
1658133338792,MATH 20D,A01,083765,Tran; Brian Kha,5,0,30,25
1658133338792,MATH 20D,A02,083766,Tran; Brian Kha,5,0,30,25
1658133338792,MATH 20D,A03,083767,Tran; Brian Kha,6,0,30,24
1658133344818,MATH 20E,A01,083771,Ganguly; Soumya,12,0,32,20
1658133344818,MATH 20E,A02,083772,Ganguly; Soumya,7,0,32,25
1658133344818,MATH 20E,B01,083773,Ciotti; Benjamin,20,0,35,15
1658133344818,MATH 20E,B02,083774,Ciotti; Benjamin,18,0,35,17
1658133350852,MATH 103A,A01,083777,Greenfeld; Be'Eri,6,0,36,30
1658133350852,MATH 103A,A02,083778,Greenfeld; Be'Eri,5,0,36,31
1658133350852,MATH 103A,A03,093561,Greenfeld; Be'Eri,7,0,36,29
1658133350852,MATH 103A,B01,083779,Greenfeld; Be'Eri,8,0,36,28
1658133350852,MATH 103A,B02,083780,Greenfeld; Be'Eri,4,0,36,32
1658133350852,MATH 103A,B03,093562,Greenfeld; Be'Eri,3,0,36,33
1658133356883,MATH 105,A01,085443,Carter; Anne Toulson,15,0,35,20
1658133356883,MATH 105,A02,093477,Carter; Anne Toulson,20,0,35,15
1658133362909,MATH 109,A01,083213,Ganzberger; Geoffrey Michael,3,0,34,31
1658133362909,MATH 109,A02,083214,Ganzberger; Geoffrey Michael,4,0,34,30
1658133362909,MATH 109,A03,093478,Ganzberger; Geoffrey Michael,2,0,34,32
1658133362909,MATH 109,B01,083215,Ganzberger; Geoffrey Michael,3,0,32,29
1658133362909,MATH 109,B02,083216,Ganzberger; Geoffrey Michael,3,0,32,29
1658133362909,MATH 109,B03,093479,Ganzberger; Geoffrey Michael,8,0,32,24
1658133368935,MATH 142A,A01,083219,Chow; Bennett,7,0,32,25
1658133368935,MATH 142A,A02,083220,Chow; Bennett,10,0,32,22
1658133368935,MATH 142A,A03,093480,Chow; Bennett,9,0,32,23
1658133368935,MATH 142A,B03,093481,Chow; Bennett,8,0,32,24
1658133368935,MATH 142A,B04,093558,Chow; Bennett,14,0,32,18
1658133368935,MATH 142A,B05,093559,Chow; Bennett,7,0,32,25
1658133374960,MATH 193A,A01,083224,Rotar; Vladimir,9,0,34,25
1658133374960,MATH 193A,A02,083225,Rotar; Vladimir,11,0,34,23
1658133374960,MATH 193A,A03,083781,Rotar; Vladimir,5,0,34,29
1658133374960,MATH 193A,A04,083782,Rotar; Vladimir,12,0,34,22
1658133374960,MATH 193A,A05,093482,Rotar; Vladimir,11,0,34,23
1658133380991,MATH 197,001,091859,McAuley; Julian John,9999,0,9999,0
1658133380991,MATH 197,002,095566,Kedlaya; Kiran S.,9997,0,9999,2
1658133380991,MATH 197,003,095567,Xiao; Ming,9999,0,9999,0
1658133380991,MATH 197,004,095571,Perols; Johan Lars,9998,0,9999,1
1658133388069,COGS 9,A01,083615,Shannon; Kyle Michael,11,0,75,64
1658133394094,COGS 11,A01,083617,Boyle; Mary E. T.,23,0,48,25
1658133400125,COGS 13,A01,083071,Bastos; Amalia Pinkusfeld,12,0,71,59
1658133406149,COGS 14A,A01,092681,Semenuks; Arturs,5,1,100,95
1658133412180,COGS 14B,A01,083073,Cheng; Tzu-Han,7,0,63,56
1658133418204,COGS 17,A01,092677,Semenuks; Arturs,7,0,81,74
1658133424227,COGS 100,A01,083619,Allen; Michael Gordon,17,0,70,53
1658133430253,COGS 101A,A01,083621,Davis; Joshua Daniel,9,0,68,59
1658133436281,COGS 101B,A01,091572,Allen; Michael Gordon,14,0,65,51
1658133442304,COGS 101C,A01,083625,Delgado; Tania,17,0,35,18
1658133448329,COGS 107A,A01,083627,Boyle; Mary E. T.,14,0,60,46
1658133454357,COGS 118A,A01,083075,Gupta; Anjum,21,0,76,55
1658133460382,CSE 3,A50,083646,Miranda; Gregory Joseph,24,0,50,26
1658133466410,CSE 8A,A50,083650,Miranda; Gregory Joseph,17,1,56,39
1658133472438,CSE 11,A01,083080,Cao; Yingjun,7,15,40,33
1658133478470,CSE 12,A01,083652,Krause-Levy; Sophia Louisa,30,1,120,90
1658133484499,CSE 15L,A01,083654,Morris; Justin Loren,9,0,50,41
1658133484499,CSE 15L,A02,083655,Morris; Justin Loren,11,0,50,39
1658133490523,CSE 20,A01,083657,Tran; Khoa Dang,39,0,80,41
1658133496547,CSE 21,A01,095574,Bach; Quang Tran,23,0,48,25
1658133502572,CSE 30,A01,083084,Eldon; John,8,0,80,72
1658133502572,CSE 30,B01,095061,Bhaskar; Nishant,9,0,50,41
1658133508596,CSE 100,A01,083659,Cao; Yingjun,5,4,70,65
1658133514624,CSE 134B,A01,083661,Powell; Thomas Allan,25,0,100,75
1658133520648,CSE 140,A01,083663,Gungor; Onat,17,0,85,68
1658133526674,CSE 140L,A01,083088,Eldon; John,23,0,100,77
1658133532700,CSE 175,A01,083665,Kumar; Rakesh,3,0,25,22
1658133538723,CSE 190,A00,092507,Dubnov; Shlomo,8,0,20,12
1658133544749,ECE 45,A01,083139,Congero; Spencer William,7,0,75,68
1658133550776,ECE 65,A50,083695,Saad; Andrew S,12,0,30,18
1658133550776,ECE 65,A51,095125,Saad; Andrew S,24,0,26,2
1658133556801,ECE 109,A01,091882,Touri; Behrouz,21,0,70,49
1658133562827,ECE 180,A00,083140,Abi Samra; Nicholas Camill,1,0,30,29
1658133562827,ECE 180,B00,083141,Abi Samra; Nicholas Camill,0,0,30,30
1658133568856,MATH 10A,A01,083735,Patchell; Gregory David,2,0,30,28
1658133568856,MATH 10A,A02,083736,Patchell; Gregory David,20,0,30,10
1658133568856,MATH 10A,A03,083737,Patchell; Gregory David,16,0,30,14
1658133574881,MATH 10B,A01,083207,Lim; Seonhee,9,0,34,25
1658133574881,MATH 10B,A02,083208,Lim; Seonhee,10,0,35,25
1658133574881,MATH 10B,A03,093472,Lim; Seonhee,7,0,34,27
1658133574881,MATH 10B,B01,083739,Sinha; Shubham,14,0,30,16
1658133580924,MATH 18,A01,083743,Cinel; Cameron Alexander,9,0,30,21
1658133580924,MATH 18,A02,083744,Cinel; Cameron Alexander,18,0,30,12
1658133580924,MATH 18,A03,083745,Cinel; Cameron Alexander,10,0,30,20
1658133580924,MATH 18,B01,083748,Rideout; David Porter,5,0,37,32
1658133580924,MATH 18,B02,083749,Rideout; David Porter,5,0,36,31
1658133580924,MATH 18,B03,083750,Rideout; David Porter,3,0,37,34
1658133580924,MATH 18,B04,083751,Rideout; David Porter,7,0,36,29
1658133580924,MATH 18,B05,093473,Rideout; David Porter,7,0,36,29
1658133580924,MATH 18,B06,093474,Rideout; David Porter,6,0,36,30
1658133586949,MATH 20A,A01,083754,Zheng; Zequn,14,0,40,26
1658133592972,MATH 20B,A01,083756,Briones; Jor-el Thomas Caparas,4,0,36,32
1658133592972,MATH 20B,A02,083757,Briones; Jor-el Thomas Caparas,1,0,36,35
1658133592972,MATH 20B,A03,093475,Briones; Jor-el Thomas Caparas,3,0,36,33
1658133599000,MATH 20C,A01,083760,Briones; Jor-el Thomas Caparas,1,0,35,34
1658133599000,MATH 20C,A02,083761,Briones; Jor-el Thomas Caparas,8,0,35,27
1658133599000,MATH 20C,A03,093476,Briones; Jor-el Thomas Caparas,0,1,36,36
1658133599000,MATH 20C,B01,083762,Bach; Quang Tran,1,0,30,29
1658133605024,MATH 20D,A01,083765,Tran; Brian Kha,5,0,30,25
1658133605024,MATH 20D,A02,083766,Tran; Brian Kha,5,0,30,25
1658133605024,MATH 20D,A03,083767,Tran; Brian Kha,6,0,30,24
1658133611047,MATH 20E,A01,083771,Ganguly; Soumya,12,0,32,20
1658133611047,MATH 20E,A02,083772,Ganguly; Soumya,7,0,32,25
1658133611047,MATH 20E,B01,083773,Ciotti; Benjamin,20,0,35,15
1658133611047,MATH 20E,B02,083774,Ciotti; Benjamin,18,0,35,17
1658133617078,MATH 103A,A01,083777,Greenfeld; Be'Eri,6,0,36,30
1658133617078,MATH 103A,A02,083778,Greenfeld; Be'Eri,5,0,36,31
1658133617078,MATH 103A,A03,093561,Greenfeld; Be'Eri,7,0,36,29
1658133617078,MATH 103A,B01,083779,Greenfeld; Be'Eri,8,0,36,28
1658133617078,MATH 103A,B02,083780,Greenfeld; Be'Eri,4,0,36,32
1658133617078,MATH 103A,B03,093562,Greenfeld; Be'Eri,3,0,36,33
1658133623101,MATH 105,A01,085443,Carter; Anne Toulson,15,0,35,20
1658133623101,MATH 105,A02,093477,Carter; Anne Toulson,20,0,35,15
1658133629137,MATH 109,A01,083213,Ganzberger; Geoffrey Michael,3,0,34,31
1658133629137,MATH 109,A02,083214,Ganzberger; Geoffrey Michael,4,0,34,30
1658133629137,MATH 109,A03,093478,Ganzberger; Geoffrey Michael,2,0,34,32
1658133629137,MATH 109,B01,083215,Ganzberger; Geoffrey Michael,3,0,32,29
1658133629137,MATH 109,B02,083216,Ganzberger; Geoffrey Michael,3,0,32,29
1658133629137,MATH 109,B03,093479,Ganzberger; Geoffrey Michael,8,0,32,24
1658133635161,MATH 142A,A01,083219,Chow; Bennett,7,0,32,25
1658133635161,MATH 142A,A02,083220,Chow; Bennett,10,0,32,22
1658133635161,MATH 142A,A03,093480,Chow; Bennett,9,0,32,23
1658133635161,MATH 142A,B03,093481,Chow; Bennett,8,0,32,24
1658133635161,MATH 142A,B04,093558,Chow; Bennett,14,0,32,18
1658133635161,MATH 142A,B05,093559,Chow; Bennett,7,0,32,25
1658133641191,MATH 193A,A01,083224,Rotar; Vladimir,9,0,34,25
1658133641191,MATH 193A,A02,083225,Rotar; Vladimir,11,0,34,23
1658133641191,MATH 193A,A03,083781,Rotar; Vladimir,5,0,34,29
1658133641191,MATH 193A,A04,083782,Rotar; Vladimir,12,0,34,22
1658133641191,MATH 193A,A05,093482,Rotar; Vladimir,11,0,34,23
1658133647215,MATH 197,001,091859,McAuley; Julian John,9999,0,9999,0
1658133647215,MATH 197,002,095566,Kedlaya; Kiran S.,9997,0,9999,2
1658133647215,MATH 197,003,095567,Xiao; Ming,9999,0,9999,0
1658133647215,MATH 197,004,095571,Perols; Johan Lars,9998,0,9999,1
1658133654277,COGS 9,A01,083615,Shannon; Kyle Michael,11,0,75,64
1658133660315,COGS 11,A01,083617,Boyle; Mary E. T.,23,0,48,25
1658133666343,COGS 13,A01,083071,Bastos; Amalia Pinkusfeld,12,0,71,59
1658133672367,COGS 14A,A01,092681,Semenuks; Arturs,5,1,100,95
1658133678391,COGS 14B,A01,083073,Cheng; Tzu-Han,7,0,63,56
1658133684417,COGS 17,A01,092677,Semenuks; Arturs,7,0,81,74
1658133690445,COGS 100,A01,083619,Allen; Michael Gordon,17,0,70,53
1658133696468,COGS 101A,A01,083621,Davis; Joshua Daniel,9,0,68,59
1658133702497,COGS 101B,A01,091572,Allen; Michael Gordon,14,0,65,51
1658133708619,COGS 101C,A01,083625,Delgado; Tania,17,0,35,18
1658133714643,COGS 107A,A01,083627,Boyle; Mary E. T.,14,0,60,46
1658133720666,COGS 118A,A01,083075,Gupta; Anjum,21,0,76,55
1658133726696,CSE 3,A50,083646,Miranda; Gregory Joseph,24,0,50,26
1658133732720,CSE 8A,A50,083650,Miranda; Gregory Joseph,17,1,56,39
1658133738746,CSE 11,A01,083080,Cao; Yingjun,7,15,40,33
1658133744770,CSE 12,A01,083652,Krause-Levy; Sophia Louisa,30,1,120,90
1658133750798,CSE 15L,A01,083654,Morris; Justin Loren,9,0,50,41
1658133750798,CSE 15L,A02,083655,Morris; Justin Loren,11,0,50,39
1658133756823,CSE 20,A01,083657,Tran; Khoa Dang,39,0,80,41
1658133762852,CSE 21,A01,095574,Bach; Quang Tran,23,0,48,25
1658133768880,CSE 30,A01,083084,Eldon; John,8,0,80,72
1658133768880,CSE 30,B01,095061,Bhaskar; Nishant,9,0,50,41
1658133774905,CSE 100,A01,083659,Cao; Yingjun,5,4,70,65
1658133780934,CSE 134B,A01,083661,Powell; Thomas Allan,25,0,100,75
1658133786957,CSE 140,A01,083663,Gungor; Onat,17,0,85,68
1658133792983,CSE 140L,A01,083088,Eldon; John,23,0,100,77
1658133799007,CSE 175,A01,083665,Kumar; Rakesh,3,0,25,22
1658133805034,CSE 190,A00,092507,Dubnov; Shlomo,8,0,20,12
1658133811061,ECE 45,A01,083139,Congero; Spencer William,7,0,75,68
1658133817089,ECE 65,A50,083695,Saad; Andrew S,12,0,30,18
1658133817089,ECE 65,A51,095125,Saad; Andrew S,24,0,26,2
1658133823116,ECE 109,A01,091882,Touri; Behrouz,21,0,70,49
1658133829146,ECE 180,A00,083140,Abi Samra; Nicholas Camill,1,0,30,29
1658133829146,ECE 180,B00,083141,Abi Samra; Nicholas Camill,0,0,30,30
1658133835176,MATH 10A,A01,083735,Patchell; Gregory David,2,0,30,28
1658133835176,MATH 10A,A02,083736,Patchell; Gregory David,20,0,30,10
1658133835176,MATH 10A,A03,083737,Patchell; Gregory David,16,0,30,14
1658133841204,MATH 10B,A01,083207,Lim; Seonhee,9,0,34,25
1658133841204,MATH 10B,A02,083208,Lim; Seonhee,10,0,35,25
1658133841204,MATH 10B,A03,093472,Lim; Seonhee,7,0,34,27
1658133841204,MATH 10B,B01,083739,Sinha; Shubham,14,0,30,16
1658133847232,MATH 18,A01,083743,Cinel; Cameron Alexander,9,0,30,21
1658133847232,MATH 18,A02,083744,Cinel; Cameron Alexander,18,0,30,12
1658133847232,MATH 18,A03,083745,Cinel; Cameron Alexander,10,0,30,20
1658133847232,MATH 18,B01,083748,Rideout; David Porter,5,0,37,32
1658133847232,MATH 18,B02,083749,Rideout; David Porter,5,0,36,31
1658133847232,MATH 18,B03,083750,Rideout; David Porter,3,0,37,34
1658133847232,MATH 18,B04,083751,Rideout; David Porter,7,0,36,29
1658133847232,MATH 18,B05,093473,Rideout; David Porter,7,0,36,29
1658133847232,MATH 18,B06,093474,Rideout; David Porter,6,0,36,30
1658133853257,MATH 20A,A01,083754,Zheng; Zequn,14,0,40,26
1658133859291,MATH 20B,A01,083756,Briones; Jor-el Thomas Caparas,4,0,36,32
1658133859291,MATH 20B,A02,083757,Briones; Jor-el Thomas Caparas,1,0,36,35
1658133859291,MATH 20B,A03,093475,Briones; Jor-el Thomas Caparas,3,0,36,33
1658133865319,MATH 20C,A01,083760,Briones; Jor-el Thomas Caparas,1,0,35,34
1658133865319,MATH 20C,A02,083761,Briones; Jor-el Thomas Caparas,8,0,35,27
1658133865319,MATH 20C,A03,093476,Briones; Jor-el Thomas Caparas,0,1,36,36
1658133865319,MATH 20C,B01,083762,Bach; Quang Tran,1,0,30,29
1658133871344,MATH 20D,A01,083765,Tran; Brian Kha,5,0,30,25
1658133871344,MATH 20D,A02,083766,Tran; Brian Kha,5,0,30,25
1658133871344,MATH 20D,A03,083767,Tran; Brian Kha,6,0,30,24
1658133877371,MATH 20E,A01,083771,Ganguly; Soumya,12,0,32,20
1658133877371,MATH 20E,A02,083772,Ganguly; Soumya,7,0,32,25
1658133877371,MATH 20E,B01,083773,Ciotti; Benjamin,20,0,35,15
1658133877371,MATH 20E,B02,083774,Ciotti; Benjamin,18,0,35,17
1658133883396,MATH 103A,A01,083777,Greenfeld; Be'Eri,6,0,36,30
1658133883396,MATH 103A,A02,083778,Greenfeld; Be'Eri,5,0,36,31
1658133883396,MATH 103A,A03,093561,Greenfeld; Be'Eri,7,0,36,29
1658133883396,MATH 103A,B01,083779,Greenfeld; Be'Eri,8,0,36,28
1658133883396,MATH 103A,B02,083780,Greenfeld; Be'Eri,4,0,36,32
1658133883396,MATH 103A,B03,093562,Greenfeld; Be'Eri,3,0,36,33
1658133889423,MATH 105,A01,085443,Carter; Anne Toulson,15,0,35,20
1658133889423,MATH 105,A02,093477,Carter; Anne Toulson,20,0,35,15
1658133895448,MATH 109,A01,083213,Ganzberger; Geoffrey Michael,3,0,34,31
1658133895448,MATH 109,A02,083214,Ganzberger; Geoffrey Michael,4,0,34,30
1658133895448,MATH 109,A03,093478,Ganzberger; Geoffrey Michael,2,0,34,32
1658133895448,MATH 109,B01,083215,Ganzberger; Geoffrey Michael,3,0,32,29
1658133895448,MATH 109,B02,083216,Ganzberger; Geoffrey Michael,3,0,32,29
1658133895448,MATH 109,B03,093479,Ganzberger; Geoffrey Michael,8,0,32,24
1658133901472,MATH 142A,A01,083219,Chow; Bennett,7,0,32,25
1658133901472,MATH 142A,A02,083220,Chow; Bennett,10,0,32,22
1658133901472,MATH 142A,A03,093480,Chow; Bennett,9,0,32,23
1658133901472,MATH 142A,B03,093481,Chow; Bennett,8,0,32,24
1658133901472,MATH 142A,B04,093558,Chow; Bennett,14,0,32,18
1658133901472,MATH 142A,B05,093559,Chow; Bennett,7,0,32,25
1658133907502,MATH 193A,A01,083224,Rotar; Vladimir,9,0,34,25
1658133907502,MATH 193A,A02,083225,Rotar; Vladimir,11,0,34,23
1658133907502,MATH 193A,A03,083781,Rotar; Vladimir,5,0,34,29
1658133907502,MATH 193A,A04,083782,Rotar; Vladimir,12,0,34,22
1658133907502,MATH 193A,A05,093482,Rotar; Vladimir,11,0,34,23
1658133913526,MATH 197,001,091859,McAuley; Julian John,9999,0,9999,0
1658133913526,MATH 197,002,095566,Kedlaya; Kiran S.,9997,0,9999,2
1658133913526,MATH 197,003,095567,Xiao; Ming,9999,0,9999,0
1658133913526,MATH 197,004,095571,Perols; Johan Lars,9998,0,9999,1
1658133920599,COGS 9,A01,083615,Shannon; Kyle Michael,11,0,75,64
1658133926624,COGS 11,A01,083617,Boyle; Mary E. T.,23,0,48,25
1658133932650,COGS 13,A01,083071,Bastos; Amalia Pinkusfeld,12,0,71,59
1658133938680,COGS 14A,A01,092681,Semenuks; Arturs,5,1,100,95
1658133944706,COGS 14B,A01,083073,Cheng; Tzu-Han,7,0,63,56
1658133950729,COGS 17,A01,092677,Semenuks; Arturs,7,0,81,74
1658133956758,COGS 100,A01,083619,Allen; Michael Gordon,17,0,70,53
1658133962783,COGS 101A,A01,083621,Davis; Joshua Daniel,9,0,68,59
1658133968806,COGS 101B,A01,091572,Allen; Michael Gordon,14,0,65,51
1658133974832,COGS 101C,A01,083625,Delgado; Tania,17,0,35,18
1658133980856,COGS 107A,A01,083627,Boyle; Mary E. T.,14,0,60,46
1658133986887,COGS 118A,A01,083075,Gupta; Anjum,21,0,76,55
1658133992919,CSE 3,A50,083646,Miranda; Gregory Joseph,24,0,50,26
1658133998943,CSE 8A,A50,083650,Miranda; Gregory Joseph,17,1,56,39
1658134004966,CSE 11,A01,083080,Cao; Yingjun,7,15,40,33
1658134010996,CSE 12,A01,083652,Krause-Levy; Sophia Louisa,30,1,120,90
1658134017026,CSE 15L,A01,083654,Morris; Justin Loren,9,0,50,41
1658134017026,CSE 15L,A02,083655,Morris; Justin Loren,11,0,50,39
1658134023052,CSE 20,A01,083657,Tran; Khoa Dang,39,0,80,41
1658134029076,CSE 21,A01,095574,Bach; Quang Tran,23,0,48,25
1658134035102,CSE 30,A01,083084,Eldon; John,8,0,80,72
1658134035102,CSE 30,B01,095061,Bhaskar; Nishant,9,0,50,41
1658134041126,CSE 100,A01,083659,Cao; Yingjun,5,4,70,65
1658134047152,CSE 134B,A01,083661,Powell; Thomas Allan,25,0,100,75
1658134053176,CSE 140,A01,083663,Gungor; Onat,17,0,85,68
1658134059200,CSE 140L,A01,083088,Eldon; John,23,0,100,77
1658134065234,CSE 175,A01,083665,Kumar; Rakesh,3,0,25,22
1658134071263,CSE 190,A00,092507,Dubnov; Shlomo,8,0,20,12
1658134077288,ECE 45,A01,083139,Congero; Spencer William,7,0,75,68
1658134083315,ECE 65,A50,083695,Saad; Andrew S,12,0,30,18
1658134083315,ECE 65,A51,095125,Saad; Andrew S,24,0,26,2
1658134089346,ECE 109,A01,091882,Touri; Behrouz,21,0,70,49
1658134095370,ECE 180,A00,083140,Abi Samra; Nicholas Camill,1,0,30,29
1658134095370,ECE 180,B00,083141,Abi Samra; Nicholas Camill,0,0,30,30
1658134101403,MATH 10A,A01,083735,Patchell; Gregory David,2,0,30,28
1658134101403,MATH 10A,A02,083736,Patchell; Gregory David,20,0,30,10
1658134101403,MATH 10A,A03,083737,Patchell; Gregory David,16,0,30,14
1658134107437,MATH 10B,A01,083207,Lim; Seonhee,9,0,34,25
1658134107437,MATH 10B,A02,083208,Lim; Seonhee,10,0,35,25
1658134107437,MATH 10B,A03,093472,Lim; Seonhee,7,0,34,27
1658134107437,MATH 10B,B01,083739,Sinha; Shubham,14,0,30,16
1658134113465,MATH 18,A01,083743,Cinel; Cameron Alexander,9,0,30,21
1658134113465,MATH 18,A02,083744,Cinel; Cameron Alexander,18,0,30,12
1658134113465,MATH 18,A03,083745,Cinel; Cameron Alexander,10,0,30,20
1658134113465,MATH 18,B01,083748,Rideout; David Porter,5,0,37,32
1658134113465,MATH 18,B02,083749,Rideout; David Porter,5,0,36,31
1658134113465,MATH 18,B03,083750,Rideout; David Porter,3,0,37,34
1658134113465,MATH 18,B04,083751,Rideout; David Porter,7,0,36,29
1658134113465,MATH 18,B05,093473,Rideout; David Porter,7,0,36,29
1658134113465,MATH 18,B06,093474,Rideout; David Porter,6,0,36,30
1658134119512,MATH 20A,A01,083754,Zheng; Zequn,14,0,40,26
1658134125544,MATH 20B,A01,083756,Briones; Jor-el Thomas Caparas,4,0,36,32
1658134125544,MATH 20B,A02,083757,Briones; Jor-el Thomas Caparas,1,0,36,35
1658134125544,MATH 20B,A03,093475,Briones; Jor-el Thomas Caparas,3,0,36,33
1658134131573,MATH 20C,A01,083760,Briones; Jor-el Thomas Caparas,1,0,35,34
1658134131573,MATH 20C,A02,083761,Briones; Jor-el Thomas Caparas,8,0,35,27
1658134131573,MATH 20C,A03,093476,Briones; Jor-el Thomas Caparas,0,1,36,36
1658134131573,MATH 20C,B01,083762,Bach; Quang Tran,1,0,30,29
1658134137604,MATH 20D,A01,083765,Tran; Brian Kha,5,0,30,25
1658134137604,MATH 20D,A02,083766,Tran; Brian Kha,5,0,30,25
1658134137604,MATH 20D,A03,083767,Tran; Brian Kha,6,0,30,24
1658134143640,MATH 20E,A01,083771,Ganguly; Soumya,12,0,32,20
1658134143640,MATH 20E,A02,083772,Ganguly; Soumya,7,0,32,25
1658134143640,MATH 20E,B01,083773,Ciotti; Benjamin,20,0,35,15
1658134143640,MATH 20E,B02,083774,Ciotti; Benjamin,18,0,35,17
1658134149667,MATH 103A,A01,083777,Greenfeld; Be'Eri,6,0,36,30
1658134149667,MATH 103A,A02,083778,Greenfeld; Be'Eri,5,0,36,31
1658134149667,MATH 103A,A03,093561,Greenfeld; Be'Eri,7,0,36,29
1658134149667,MATH 103A,B01,083779,Greenfeld; Be'Eri,8,0,36,28
1658134149667,MATH 103A,B02,083780,Greenfeld; Be'Eri,4,0,36,32
1658134149667,MATH 103A,B03,093562,Greenfeld; Be'Eri,3,0,36,33
1658134155700,MATH 105,A01,085443,Carter; Anne Toulson,15,0,35,20
1658134155700,MATH 105,A02,093477,Carter; Anne Toulson,20,0,35,15
1658134161727,MATH 109,A01,083213,Ganzberger; Geoffrey Michael,3,0,34,31
1658134161727,MATH 109,A02,083214,Ganzberger; Geoffrey Michael,4,0,34,30
1658134161727,MATH 109,A03,093478,Ganzberger; Geoffrey Michael,2,0,34,32
1658134161727,MATH 109,B01,083215,Ganzberger; Geoffrey Michael,3,0,32,29
1658134161727,MATH 109,B02,083216,Ganzberger; Geoffrey Michael,3,0,32,29
1658134161727,MATH 109,B03,093479,Ganzberger; Geoffrey Michael,8,0,32,24
1658134167753,MATH 142A,A01,083219,Chow; Bennett,7,0,32,25
1658134167753,MATH 142A,A02,083220,Chow; Bennett,10,0,32,22
1658134167753,MATH 142A,A03,093480,Chow; Bennett,9,0,32,23
1658134167753,MATH 142A,B03,093481,Chow; Bennett,8,0,32,24
1658134167753,MATH 142A,B04,093558,Chow; Bennett,14,0,32,18
1658134167753,MATH 142A,B05,093559,Chow; Bennett,7,0,32,25
1658134173782,MATH 193A,A01,083224,Rotar; Vladimir,9,0,34,25
1658134173782,MATH 193A,A02,083225,Rotar; Vladimir,11,0,34,23
1658134173782,MATH 193A,A03,083781,Rotar; Vladimir,5,0,34,29
1658134173782,MATH 193A,A04,083782,Rotar; Vladimir,12,0,34,22
1658134173782,MATH 193A,A05,093482,Rotar; Vladimir,11,0,34,23
1658134179809,MATH 197,001,091859,McAuley; Julian John,9999,0,9999,0
1658134179809,MATH 197,002,095566,Kedlaya; Kiran S.,9997,0,9999,2
1658134179809,MATH 197,003,095567,Xiao; Ming,9999,0,9999,0
1658134179809,MATH 197,004,095571,Perols; Johan Lars,9998,0,9999,1
1658134186909,COGS 9,A01,083615,Shannon; Kyle Michael,11,0,75,64
1658134192933,COGS 11,A01,083617,Boyle; Mary E. T.,23,0,48,25
1658134198958,COGS 13,A01,083071,Bastos; Amalia Pinkusfeld,12,0,71,59
1658134204988,COGS 14A,A01,092681,Semenuks; Arturs,5,1,100,95
1658134211010,COGS 14B,A01,083073,Cheng; Tzu-Han,7,0,63,56
1658134217034,COGS 17,A01,092677,Semenuks; Arturs,7,0,81,74
1658134223059,COGS 100,A01,083619,Allen; Michael Gordon,17,0,70,53
1658134229088,COGS 101A,A01,083621,Davis; Joshua Daniel,9,0,68,59
1658134235111,COGS 101B,A01,091572,Allen; Michael Gordon,14,0,65,51
1658134241136,COGS 101C,A01,083625,Delgado; Tania,17,0,35,18
1658134247161,COGS 107A,A01,083627,Boyle; Mary E. T.,14,0,60,46
1658134253195,COGS 118A,A01,083075,Gupta; Anjum,21,0,76,55
1658134259222,CSE 3,A50,083646,Miranda; Gregory Joseph,24,0,50,26
1658134265245,CSE 8A,A50,083650,Miranda; Gregory Joseph,17,1,56,39
1658134271269,CSE 11,A01,083080,Cao; Yingjun,7,15,40,33
1658134277295,CSE 12,A01,083652,Krause-Levy; Sophia Louisa,30,1,120,90
1658134283321,CSE 15L,A01,083654,Morris; Justin Loren,9,0,50,41
1658134283321,CSE 15L,A02,083655,Morris; Justin Loren,11,0,50,39
1658134289350,CSE 20,A01,083657,Tran; Khoa Dang,39,0,80,41
1658134295379,CSE 21,A01,095574,Bach; Quang Tran,23,0,48,25
1658134301415,CSE 30,A01,083084,Eldon; John,8,0,80,72
1658134301415,CSE 30,B01,095061,Bhaskar; Nishant,9,0,50,41
1658134307514,CSE 100,A01,083659,Cao; Yingjun,5,4,70,65
1658134313545,CSE 134B,A01,083661,Powell; Thomas Allan,25,0,100,75
1658134319572,CSE 140,A01,083663,Gungor; Onat,17,0,85,68
1658134325601,CSE 140L,A01,083088,Eldon; John,23,0,100,77
1658134331626,CSE 175,A01,083665,Kumar; Rakesh,3,0,25,22
1658134337664,CSE 190,A00,092507,Dubnov; Shlomo,8,0,20,12
1658134343691,ECE 45,A01,083139,Congero; Spencer William,7,0,75,68
1658134349725,ECE 65,A50,083695,Saad; Andrew S,12,0,30,18
1658134349725,ECE 65,A51,095125,Saad; Andrew S,24,0,26,2
1658134355755,ECE 109,A01,091882,Touri; Behrouz,21,0,70,49
1658134361780,ECE 180,A00,083140,Abi Samra; Nicholas Camill,1,0,30,29
1658134361780,ECE 180,B00,083141,Abi Samra; Nicholas Camill,0,0,30,30
1658134367806,MATH 10A,A01,083735,Patchell; Gregory David,2,0,30,28
1658134367806,MATH 10A,A02,083736,Patchell; Gregory David,20,0,30,10
1658134367806,MATH 10A,A03,083737,Patchell; Gregory David,16,0,30,14
1658134373840,MATH 10B,A01,083207,Lim; Seonhee,9,0,34,25
1658134373840,MATH 10B,A02,083208,Lim; Seonhee,10,0,35,25
1658134373840,MATH 10B,A03,093472,Lim; Seonhee,7,0,34,27
1658134373840,MATH 10B,B01,083739,Sinha; Shubham,14,0,30,16
1658134379867,MATH 18,A01,083743,Cinel; Cameron Alexander,9,0,30,21
1658134379867,MATH 18,A02,083744,Cinel; Cameron Alexander,18,0,30,12
1658134379867,MATH 18,A03,083745,Cinel; Cameron Alexander,10,0,30,20
1658134379867,MATH 18,B01,083748,Rideout; David Porter,5,0,37,32
1658134379867,MATH 18,B02,083749,Rideout; David Porter,5,0,36,31
1658134379867,MATH 18,B03,083750,Rideout; David Porter,3,0,37,34
1658134379867,MATH 18,B04,083751,Rideout; David Porter,7,0,36,29
1658134379867,MATH 18,B05,093473,Rideout; David Porter,7,0,36,29
1658134379867,MATH 18,B06,093474,Rideout; David Porter,6,0,36,30
1658134385891,MATH 20A,A01,083754,Zheng; Zequn,14,0,40,26
1658134391915,MATH 20B,A01,083756,Briones; Jor-el Thomas Caparas,4,0,36,32
1658134391915,MATH 20B,A02,083757,Briones; Jor-el Thomas Caparas,1,0,36,35
1658134391915,MATH 20B,A03,093475,Briones; Jor-el Thomas Caparas,3,0,36,33
1658134397944,MATH 20C,A01,083760,Briones; Jor-el Thomas Caparas,1,0,35,34
1658134397944,MATH 20C,A02,083761,Briones; Jor-el Thomas Caparas,8,0,35,27
1658134397944,MATH 20C,A03,093476,Briones; Jor-el Thomas Caparas,0,1,36,36
1658134397944,MATH 20C,B01,083762,Bach; Quang Tran,1,0,30,29
1658134403974,MATH 20D,A01,083765,Tran; Brian Kha,5,0,30,25
1658134403974,MATH 20D,A02,083766,Tran; Brian Kha,5,0,30,25
1658134403974,MATH 20D,A03,083767,Tran; Brian Kha,6,0,30,24
1658134409999,MATH 20E,A01,083771,Ganguly; Soumya,12,0,32,20
1658134409999,MATH 20E,A02,083772,Ganguly; Soumya,7,0,32,25
1658134409999,MATH 20E,B01,083773,Ciotti; Benjamin,20,0,35,15
1658134409999,MATH 20E,B02,083774,Ciotti; Benjamin,18,0,35,17
1658134416024,MATH 103A,A01,083777,Greenfeld; Be'Eri,6,0,36,30
1658134416024,MATH 103A,A02,083778,Greenfeld; Be'Eri,5,0,36,31
1658134416024,MATH 103A,A03,093561,Greenfeld; Be'Eri,7,0,36,29
1658134416024,MATH 103A,B01,083779,Greenfeld; Be'Eri,8,0,36,28
1658134416024,MATH 103A,B02,083780,Greenfeld; Be'Eri,4,0,36,32
1658134416024,MATH 103A,B03,093562,Greenfeld; Be'Eri,3,0,36,33
1658134422054,MATH 105,A01,085443,Carter; Anne Toulson,15,0,35,20
1658134422054,MATH 105,A02,093477,Carter; Anne Toulson,20,0,35,15
1658134428083,MATH 109,A01,083213,Ganzberger; Geoffrey Michael,3,0,34,31
1658134428083,MATH 109,A02,083214,Ganzberger; Geoffrey Michael,4,0,34,30
1658134428083,MATH 109,A03,093478,Ganzberger; Geoffrey Michael,2,0,34,32
1658134428083,MATH 109,B01,083215,Ganzberger; Geoffrey Michael,3,0,32,29
1658134428083,MATH 109,B02,083216,Ganzberger; Geoffrey Michael,3,0,32,29
1658134428083,MATH 109,B03,093479,Ganzberger; Geoffrey Michael,8,0,32,24
1658134434115,MATH 142A,A01,083219,Chow; Bennett,7,0,32,25
1658134434115,MATH 142A,A02,083220,Chow; Bennett,10,0,32,22
1658134434115,MATH 142A,A03,093480,Chow; Bennett,9,0,32,23
1658134434115,MATH 142A,B03,093481,Chow; Bennett,8,0,32,24
1658134434115,MATH 142A,B04,093558,Chow; Bennett,14,0,32,18
1658134434115,MATH 142A,B05,093559,Chow; Bennett,7,0,32,25
1658134440149,MATH 193A,A01,083224,Rotar; Vladimir,9,0,34,25
1658134440149,MATH 193A,A02,083225,Rotar; Vladimir,11,0,34,23
1658134440149,MATH 193A,A03,083781,Rotar; Vladimir,5,0,34,29
1658134440149,MATH 193A,A04,083782,Rotar; Vladimir,12,0,34,22
1658134440149,MATH 193A,A05,093482,Rotar; Vladimir,11,0,34,23
1658134446179,MATH 197,001,091859,McAuley; Julian John,9999,0,9999,0
1658134446179,MATH 197,002,095566,Kedlaya; Kiran S.,9997,0,9999,2
1658134446179,MATH 197,003,095567,Xiao; Ming,9999,0,9999,0
1658134446179,MATH 197,004,095571,Perols; Johan Lars,9998,0,9999,1
1658134453272,COGS 9,A01,083615,Shannon; Kyle Michael,11,0,75,64
1658134459297,COGS 11,A01,083617,Boyle; Mary E. T.,23,0,48,25
1658134465329,COGS 13,A01,083071,Bastos; Amalia Pinkusfeld,12,0,71,59
1658134471367,COGS 14A,A01,092681,Semenuks; Arturs,5,1,100,95
1658134477394,COGS 14B,A01,083073,Cheng; Tzu-Han,7,0,63,56
1658134483423,COGS 17,A01,092677,Semenuks; Arturs,7,0,81,74
1658134489456,COGS 100,A01,083619,Allen; Michael Gordon,17,0,70,53
1658134495484,COGS 101A,A01,083621,Davis; Joshua Daniel,9,0,68,59
1658134501517,COGS 101B,A01,091572,Allen; Michael Gordon,14,0,65,51
1658134507545,COGS 101C,A01,083625,Delgado; Tania,17,0,35,18
1658134513572,COGS 107A,A01,083627,Boyle; Mary E. T.,14,0,60,46
1658134519604,COGS 118A,A01,083075,Gupta; Anjum,21,0,76,55
1658134525632,CSE 3,A50,083646,Miranda; Gregory Joseph,24,0,50,26
1658134531664,CSE 8A,A50,083650,Miranda; Gregory Joseph,17,1,56,39
1658134537702,CSE 11,A01,083080,Cao; Yingjun,7,15,40,33
1658134543725,CSE 12,A01,083652,Krause-Levy; Sophia Louisa,30,1,120,90
1658134549749,CSE 15L,A01,083654,Morris; Justin Loren,9,0,50,41
1658134549749,CSE 15L,A02,083655,Morris; Justin Loren,11,0,50,39
1658134555774,CSE 20,A01,083657,Tran; Khoa Dang,39,0,80,41
1658134561814,CSE 21,A01,095574,Bach; Quang Tran,23,0,48,25
1658134567839,CSE 30,A01,083084,Eldon; John,8,0,80,72
1658134567839,CSE 30,B01,095061,Bhaskar; Nishant,9,0,50,41
1658134573863,CSE 100,A01,083659,Cao; Yingjun,5,4,70,65
1658134579891,CSE 134B,A01,083661,Powell; Thomas Allan,25,0,100,75
1658134585915,CSE 140,A01,083663,Gungor; Onat,17,0,85,68
1658134591949,CSE 140L,A01,083088,Eldon; John,23,0,100,77
1658134597980,CSE 175,A01,083665,Kumar; Rakesh,3,0,25,22
1658134604006,CSE 190,A00,092507,Dubnov; Shlomo,8,0,20,12
1658134610039,ECE 45,A01,083139,Congero; Spencer William,7,0,75,68
1658134616067,ECE 65,A50,083695,Saad; Andrew S,12,0,30,18
1658134616067,ECE 65,A51,095125,Saad; Andrew S,24,0,26,2
1658134622093,ECE 109,A01,091882,Touri; Behrouz,21,0,70,49
1658134628118,ECE 180,A00,083140,Abi Samra; Nicholas Camill,1,0,30,29
1658134628118,ECE 180,B00,083141,Abi Samra; Nicholas Camill,0,0,30,30
1658134634147,MATH 10A,A01,083735,Patchell; Gregory David,2,0,30,28
1658134634147,MATH 10A,A02,083736,Patchell; Gregory David,20,0,30,10
1658134634147,MATH 10A,A03,083737,Patchell; Gregory David,16,0,30,14
1658134640174,MATH 10B,A01,083207,Lim; Seonhee,9,0,34,25
1658134640174,MATH 10B,A02,083208,Lim; Seonhee,10,0,35,25
1658134640174,MATH 10B,A03,093472,Lim; Seonhee,7,0,34,27
1658134640174,MATH 10B,B01,083739,Sinha; Shubham,14,0,30,16
1658134646204,MATH 18,A01,083743,Cinel; Cameron Alexander,9,0,30,21
1658134646204,MATH 18,A02,083744,Cinel; Cameron Alexander,18,0,30,12
1658134646204,MATH 18,A03,083745,Cinel; Cameron Alexander,10,0,30,20
1658134646204,MATH 18,B01,083748,Rideout; David Porter,5,0,37,32
1658134646204,MATH 18,B02,083749,Rideout; David Porter,5,0,36,31
1658134646204,MATH 18,B03,083750,Rideout; David Porter,3,0,37,34
1658134646204,MATH 18,B04,083751,Rideout; David Porter,7,0,36,29
1658134646204,MATH 18,B05,093473,Rideout; David Porter,7,0,36,29
1658134646204,MATH 18,B06,093474,Rideout; David Porter,6,0,36,30
1658134652235,MATH 20A,A01,083754,Zheng; Zequn,14,0,40,26
1658134658267,MATH 20B,A01,083756,Briones; Jor-el Thomas Caparas,4,0,36,32
1658134658267,MATH 20B,A02,083757,Briones; Jor-el Thomas Caparas,1,0,36,35
1658134658267,MATH 20B,A03,093475,Briones; Jor-el Thomas Caparas,3,0,36,33
1658134664301,MATH 20C,A01,083760,Briones; Jor-el Thomas Caparas,1,0,35,34
1658134664301,MATH 20C,A02,083761,Briones; Jor-el Thomas Caparas,8,0,35,27
1658134664301,MATH 20C,A03,093476,Briones; Jor-el Thomas Caparas,0,1,36,36
1658134664301,MATH 20C,B01,083762,Bach; Quang Tran,1,0,30,29
1658134670326,MATH 20D,A01,083765,Tran; Brian Kha,5,0,30,25
1658134670326,MATH 20D,A02,083766,Tran; Brian Kha,5,0,30,25
1658134670326,MATH 20D,A03,083767,Tran; Brian Kha,6,0,30,24
1658134676353,MATH 20E,A01,083771,Ganguly; Soumya,12,0,32,20
1658134676353,MATH 20E,A02,083772,Ganguly; Soumya,7,0,32,25
1658134676353,MATH 20E,B01,083773,Ciotti; Benjamin,20,0,35,15
1658134676353,MATH 20E,B02,083774,Ciotti; Benjamin,18,0,35,17
1658134682388,MATH 103A,A01,083777,Greenfeld; Be'Eri,6,0,36,30
1658134682388,MATH 103A,A02,083778,Greenfeld; Be'Eri,5,0,36,31
1658134682388,MATH 103A,A03,093561,Greenfeld; Be'Eri,7,0,36,29
1658134682388,MATH 103A,B01,083779,Greenfeld; Be'Eri,8,0,36,28
1658134682388,MATH 103A,B02,083780,Greenfeld; Be'Eri,4,0,36,32
1658134682388,MATH 103A,B03,093562,Greenfeld; Be'Eri,3,0,36,33
1658134688419,MATH 105,A01,085443,Carter; Anne Toulson,15,0,35,20
1658134688419,MATH 105,A02,093477,Carter; Anne Toulson,20,0,35,15
1658134694445,MATH 109,A01,083213,Ganzberger; Geoffrey Michael,3,0,34,31
1658134694445,MATH 109,A02,083214,Ganzberger; Geoffrey Michael,4,0,34,30
1658134694445,MATH 109,A03,093478,Ganzberger; Geoffrey Michael,2,0,34,32
1658134694445,MATH 109,B01,083215,Ganzberger; Geoffrey Michael,3,0,32,29
1658134694445,MATH 109,B02,083216,Ganzberger; Geoffrey Michael,3,0,32,29
1658134694445,MATH 109,B03,093479,Ganzberger; Geoffrey Michael,8,0,32,24
1658134700472,MATH 142A,A01,083219,Chow; Bennett,7,0,32,25
1658134700472,MATH 142A,A02,083220,Chow; Bennett,10,0,32,22
1658134700472,MATH 142A,A03,093480,Chow; Bennett,9,0,32,23
1658134700472,MATH 142A,B03,093481,Chow; Bennett,8,0,32,24
1658134700472,MATH 142A,B04,093558,Chow; Bennett,14,0,32,18
1658134700472,MATH 142A,B05,093559,Chow; Bennett,7,0,32,25
1658134706503,MATH 193A,A01,083224,Rotar; Vladimir,9,0,34,25
1658134706503,MATH 193A,A02,083225,Rotar; Vladimir,11,0,34,23
1658134706503,MATH 193A,A03,083781,Rotar; Vladimir,5,0,34,29
1658134706503,MATH 193A,A04,083782,Rotar; Vladimir,12,0,34,22
1658134706503,MATH 193A,A05,093482,Rotar; Vladimir,11,0,34,23
1658134712532,MATH 197,001,091859,McAuley; Julian John,9999,0,9999,0
1658134712532,MATH 197,002,095566,Kedlaya; Kiran S.,9997,0,9999,2
1658134712532,MATH 197,003,095567,Xiao; Ming,9999,0,9999,0
1658134712532,MATH 197,004,095571,Perols; Johan Lars,9998,0,9999,1
1658134719604,COGS 9,A01,083615,Shannon; Kyle Michael,11,0,75,64
1658134725629,COGS 11,A01,083617,Boyle; Mary E. T.,23,0,48,25
1658134731653,COGS 13,A01,083071,Bastos; Amalia Pinkusfeld,12,0,71,59
1658134737686,COGS 14A,A01,092681,Semenuks; Arturs,5,1,100,95
1658134743711,COGS 14B,A01,083073,Cheng; Tzu-Han,7,0,63,56
1658134749744,COGS 17,A01,092677,Semenuks; Arturs,7,0,81,74
1658134755770,COGS 100,A01,083619,Allen; Michael Gordon,17,0,70,53
1658134761800,COGS 101A,A01,083621,Davis; Joshua Daniel,9,0,68,59
1658134767826,COGS 101B,A01,091572,Allen; Michael Gordon,14,0,65,51
1658134773855,COGS 101C,A01,083625,Delgado; Tania,17,0,35,18
1658134779879,COGS 107A,A01,083627,Boyle; Mary E. T.,14,0,60,46
1658134785911,COGS 118A,A01,083075,Gupta; Anjum,21,0,76,55
1658134791938,CSE 3,A50,083646,Miranda; Gregory Joseph,24,0,50,26
1658134797967,CSE 8A,A50,083650,Miranda; Gregory Joseph,17,1,56,39
1658134803991,CSE 11,A01,083080,Cao; Yingjun,7,15,40,33
1658134810017,CSE 12,A01,083652,Krause-Levy; Sophia Louisa,30,1,120,90
1658134816047,CSE 15L,A01,083654,Morris; Justin Loren,9,0,50,41
1658134816047,CSE 15L,A02,083655,Morris; Justin Loren,11,0,50,39
1658134822073,CSE 20,A01,083657,Tran; Khoa Dang,39,0,80,41
1658134828104,CSE 21,A01,095574,Bach; Quang Tran,23,0,48,25
1658134834139,CSE 30,A01,083084,Eldon; John,8,0,80,72
1658134834139,CSE 30,B01,095061,Bhaskar; Nishant,9,0,50,41
1658134840165,CSE 100,A01,083659,Cao; Yingjun,5,4,70,65
1658134846197,CSE 134B,A01,083661,Powell; Thomas Allan,25,0,100,75
1658134852221,CSE 140,A01,083663,Gungor; Onat,17,0,85,68
1658134858245,CSE 140L,A01,083088,Eldon; John,23,0,100,77
1658134864280,CSE 175,A01,083665,Kumar; Rakesh,3,0,25,22
1658134870304,CSE 190,A00,092507,Dubnov; Shlomo,8,0,20,12
1658134876329,ECE 45,A01,083139,Congero; Spencer William,7,0,75,68
1658134882362,ECE 65,A50,083695,Saad; Andrew S,12,0,30,18
1658134882362,ECE 65,A51,095125,Saad; Andrew S,24,0,26,2
1658134888386,ECE 109,A01,091882,Touri; Behrouz,21,0,70,49
1658134894415,ECE 180,A00,083140,Abi Samra; Nicholas Camill,1,0,30,29
1658134894415,ECE 180,B00,083141,Abi Samra; Nicholas Camill,0,0,30,30
1658134900446,MATH 10A,A01,083735,Patchell; Gregory David,2,0,30,28
1658134900446,MATH 10A,A02,083736,Patchell; Gregory David,20,0,30,10
1658134900446,MATH 10A,A03,083737,Patchell; Gregory David,16,0,30,14
1658134906544,MATH 10B,A01,083207,Lim; Seonhee,9,0,34,25
1658134906544,MATH 10B,A02,083208,Lim; Seonhee,10,0,35,25
1658134906544,MATH 10B,A03,093472,Lim; Seonhee,7,0,34,27
1658134906544,MATH 10B,B01,083739,Sinha; Shubham,14,0,30,16
1658134912571,MATH 18,A01,083743,Cinel; Cameron Alexander,9,0,30,21
1658134912571,MATH 18,A02,083744,Cinel; Cameron Alexander,18,0,30,12
1658134912571,MATH 18,A03,083745,Cinel; Cameron Alexander,10,0,30,20
1658134912571,MATH 18,B01,083748,Rideout; David Porter,5,0,37,32
1658134912571,MATH 18,B02,083749,Rideout; David Porter,5,0,36,31
1658134912571,MATH 18,B03,083750,Rideout; David Porter,3,0,37,34
1658134912571,MATH 18,B04,083751,Rideout; David Porter,7,0,36,29
1658134912571,MATH 18,B05,093473,Rideout; David Porter,7,0,36,29
1658134912571,MATH 18,B06,093474,Rideout; David Porter,6,0,36,30
1658134918595,MATH 20A,A01,083754,Zheng; Zequn,14,0,40,26
1658134924627,MATH 20B,A01,083756,Briones; Jor-el Thomas Caparas,4,0,36,32
1658134924627,MATH 20B,A02,083757,Briones; Jor-el Thomas Caparas,1,0,36,35
1658134924627,MATH 20B,A03,093475,Briones; Jor-el Thomas Caparas,3,0,36,33
1658134930659,MATH 20C,A01,083760,Briones; Jor-el Thomas Caparas,1,0,35,34
1658134930659,MATH 20C,A02,083761,Briones; Jor-el Thomas Caparas,8,0,35,27
1658134930659,MATH 20C,A03,093476,Briones; Jor-el Thomas Caparas,0,1,36,36
1658134930659,MATH 20C,B01,083762,Bach; Quang Tran,1,0,30,29
1658134936691,MATH 20D,A01,083765,Tran; Brian Kha,5,0,30,25
1658134936691,MATH 20D,A02,083766,Tran; Brian Kha,5,0,30,25
1658134936691,MATH 20D,A03,083767,Tran; Brian Kha,6,0,30,24
1658134942724,MATH 20E,A01,083771,Ganguly; Soumya,12,0,32,20
1658134942724,MATH 20E,A02,083772,Ganguly; Soumya,7,0,32,25
1658134942724,MATH 20E,B01,083773,Ciotti; Benjamin,20,0,35,15
1658134942724,MATH 20E,B02,083774,Ciotti; Benjamin,18,0,35,17
1658134948749,MATH 103A,A01,083777,Greenfeld; Be'Eri,6,0,36,30
1658134948749,MATH 103A,A02,083778,Greenfeld; Be'Eri,5,0,36,31
1658134948749,MATH 103A,A03,093561,Greenfeld; Be'Eri,7,0,36,29
1658134948749,MATH 103A,B01,083779,Greenfeld; Be'Eri,8,0,36,28
1658134948749,MATH 103A,B02,083780,Greenfeld; Be'Eri,4,0,36,32
1658134948749,MATH 103A,B03,093562,Greenfeld; Be'Eri,3,0,36,33
1658134954780,MATH 105,A01,085443,Carter; Anne Toulson,15,0,35,20
1658134954780,MATH 105,A02,093477,Carter; Anne Toulson,20,0,35,15
1658134960810,MATH 109,A01,083213,Ganzberger; Geoffrey Michael,3,0,34,31
1658134960810,MATH 109,A02,083214,Ganzberger; Geoffrey Michael,4,0,34,30
1658134960810,MATH 109,A03,093478,Ganzberger; Geoffrey Michael,2,0,34,32
1658134960810,MATH 109,B01,083215,Ganzberger; Geoffrey Michael,3,0,32,29
1658134960810,MATH 109,B02,083216,Ganzberger; Geoffrey Michael,3,0,32,29
1658134960810,MATH 109,B03,093479,Ganzberger; Geoffrey Michael,8,0,32,24
1658134966835,MATH 142A,A01,083219,Chow; Bennett,7,0,32,25
1658134966835,MATH 142A,A02,083220,Chow; Bennett,10,0,32,22
1658134966835,MATH 142A,A03,093480,Chow; Bennett,9,0,32,23
1658134966835,MATH 142A,B03,093481,Chow; Bennett,8,0,32,24
1658134966835,MATH 142A,B04,093558,Chow; Bennett,14,0,32,18
1658134966835,MATH 142A,B05,093559,Chow; Bennett,7,0,32,25
1658134972880,MATH 193A,A01,083224,Rotar; Vladimir,9,0,34,25
1658134972880,MATH 193A,A02,083225,Rotar; Vladimir,11,0,34,23
1658134972880,MATH 193A,A03,083781,Rotar; Vladimir,5,0,34,29
1658134972880,MATH 193A,A04,083782,Rotar; Vladimir,12,0,34,22
1658134972880,MATH 193A,A05,093482,Rotar; Vladimir,11,0,34,23
1658134978934,MATH 197,001,091859,McAuley; Julian John,9999,0,9999,0
1658134978934,MATH 197,002,095566,Kedlaya; Kiran S.,9997,0,9999,2
1658134978934,MATH 197,003,095567,Xiao; Ming,9999,0,9999,0
1658134978934,MATH 197,004,095571,Perols; Johan Lars,9998,0,9999,1
1658134986015,COGS 9,A01,083615,Shannon; Kyle Michael,11,0,75,64
1658135001704,COGS 11,A01,083617,Boyle; Mary E. T.,23,0,48,25
1658135007729,COGS 13,A01,083071,Bastos; Amalia Pinkusfeld,12,0,71,59
1658135013756,COGS 14A,A01,092681,Semenuks; Arturs,5,1,100,95
1658135019781,COGS 14B,A01,083073,Cheng; Tzu-Han,7,0,63,56
1658135025806,COGS 17,A01,092677,Semenuks; Arturs,7,0,81,74
1658135031831,COGS 100,A01,083619,Allen; Michael Gordon,17,0,70,53
1658135037860,COGS 101A,A01,083621,Davis; Joshua Daniel,9,0,68,59
1658135043894,COGS 101B,A01,091572,Allen; Michael Gordon,14,0,65,51
1658135049922,COGS 101C,A01,083625,Delgado; Tania,17,0,35,18
1658135055947,COGS 107A,A01,083627,Boyle; Mary E. T.,14,0,60,46
1658135061975,COGS 118A,A01,083075,Gupta; Anjum,21,0,76,55
1658135068001,CSE 3,A50,083646,Miranda; Gregory Joseph,24,0,50,26
1658135074030,CSE 8A,A50,083650,Miranda; Gregory Joseph,17,1,56,39
1658135080059,CSE 11,A01,083080,Cao; Yingjun,7,15,40,33
1658135086084,CSE 12,A01,083652,Krause-Levy; Sophia Louisa,30,1,120,90
1658135092112,CSE 15L,A01,083654,Morris; Justin Loren,9,0,50,41
1658135092112,CSE 15L,A02,083655,Morris; Justin Loren,11,0,50,39
1658135098143,CSE 20,A01,083657,Tran; Khoa Dang,39,0,80,41
1658135104166,CSE 21,A01,095574,Bach; Quang Tran,23,0,48,25
1658135110192,CSE 30,A01,083084,Eldon; John,8,0,80,72
1658135110192,CSE 30,B01,095061,Bhaskar; Nishant,9,0,50,41
1658135116221,CSE 100,A01,083659,Cao; Yingjun,5,4,70,65
1658135122246,CSE 134B,A01,083661,Powell; Thomas Allan,25,0,100,75
1658135128270,CSE 140,A01,083663,Gungor; Onat,17,0,85,68
1658135134294,CSE 140L,A01,083088,Eldon; John,23,0,100,77
1658135140325,CSE 175,A01,083665,Kumar; Rakesh,3,0,25,22
1658135146349,CSE 190,A00,092507,Dubnov; Shlomo,8,0,20,12
1658135152375,ECE 45,A01,083139,Congero; Spencer William,7,0,75,68
1658135158401,ECE 65,A50,083695,Saad; Andrew S,12,0,30,18
1658135158401,ECE 65,A51,095125,Saad; Andrew S,24,0,26,2
1658135164427,ECE 109,A01,091882,Touri; Behrouz,21,0,70,49
1658135170456,ECE 180,A00,083140,Abi Samra; Nicholas Camill,1,0,30,29
1658135170456,ECE 180,B00,083141,Abi Samra; Nicholas Camill,0,0,30,30
1658135176490,MATH 10A,A01,083735,Patchell; Gregory David,2,0,30,28
1658135176490,MATH 10A,A02,083736,Patchell; Gregory David,20,0,30,10
1658135176490,MATH 10A,A03,083737,Patchell; Gregory David,16,0,30,14
1658135182540,MATH 10B,A01,083207,Lim; Seonhee,9,0,34,25
1658135182540,MATH 10B,A02,083208,Lim; Seonhee,10,0,35,25
1658135182540,MATH 10B,A03,093472,Lim; Seonhee,7,0,34,27
1658135182540,MATH 10B,B01,083739,Sinha; Shubham,14,0,30,16
1658135188595,MATH 18,A01,083743,Cinel; Cameron Alexander,9,0,30,21
1658135188595,MATH 18,A02,083744,Cinel; Cameron Alexander,18,0,30,12
1658135188595,MATH 18,A03,083745,Cinel; Cameron Alexander,10,0,30,20
1658135188595,MATH 18,B01,083748,Rideout; David Porter,5,0,37,32
1658135188595,MATH 18,B02,083749,Rideout; David Porter,5,0,36,31
1658135188595,MATH 18,B03,083750,Rideout; David Porter,3,0,37,34
1658135188595,MATH 18,B04,083751,Rideout; David Porter,7,0,36,29
1658135188595,MATH 18,B05,093473,Rideout; David Porter,7,0,36,29
1658135188595,MATH 18,B06,093474,Rideout; David Porter,6,0,36,30
1658135194625,MATH 20A,A01,083754,Zheng; Zequn,14,0,40,26
1658135200660,MATH 20B,A01,083756,Briones; Jor-el Thomas Caparas,4,0,36,32
1658135200660,MATH 20B,A02,083757,Briones; Jor-el Thomas Caparas,1,0,36,35
1658135200660,MATH 20B,A03,093475,Briones; Jor-el Thomas Caparas,3,0,36,33
1658135206687,MATH 20C,A01,083760,Briones; Jor-el Thomas Caparas,1,0,35,34
1658135206687,MATH 20C,A02,083761,Briones; Jor-el Thomas Caparas,8,0,35,27
1658135206687,MATH 20C,A03,093476,Briones; Jor-el Thomas Caparas,0,1,36,36
1658135206687,MATH 20C,B01,083762,Bach; Quang Tran,1,0,30,29
1658135212711,MATH 20D,A01,083765,Tran; Brian Kha,5,0,30,25
1658135212711,MATH 20D,A02,083766,Tran; Brian Kha,5,0,30,25
1658135212711,MATH 20D,A03,083767,Tran; Brian Kha,6,0,30,24
1658135218747,MATH 20E,A01,083771,Ganguly; Soumya,12,0,32,20
1658135218747,MATH 20E,A02,083772,Ganguly; Soumya,7,0,32,25
1658135218747,MATH 20E,B01,083773,Ciotti; Benjamin,20,0,35,15
1658135218747,MATH 20E,B02,083774,Ciotti; Benjamin,18,0,35,17
1658135224772,MATH 103A,A01,083777,Greenfeld; Be'Eri,6,0,36,30
1658135224772,MATH 103A,A02,083778,Greenfeld; Be'Eri,5,0,36,31
1658135224772,MATH 103A,A03,093561,Greenfeld; Be'Eri,7,0,36,29
1658135224772,MATH 103A,B01,083779,Greenfeld; Be'Eri,8,0,36,28
1658135224772,MATH 103A,B02,083780,Greenfeld; Be'Eri,4,0,36,32
1658135224772,MATH 103A,B03,093562,Greenfeld; Be'Eri,3,0,36,33
1658135230804,MATH 105,A01,085443,Carter; Anne Toulson,15,0,35,20
1658135230804,MATH 105,A02,093477,Carter; Anne Toulson,20,0,35,15
1658135236829,MATH 109,A01,083213,Ganzberger; Geoffrey Michael,3,0,34,31
1658135236829,MATH 109,A02,083214,Ganzberger; Geoffrey Michael,4,0,34,30
1658135236829,MATH 109,A03,093478,Ganzberger; Geoffrey Michael,2,0,34,32
1658135236829,MATH 109,B01,083215,Ganzberger; Geoffrey Michael,3,0,32,29
1658135236829,MATH 109,B02,083216,Ganzberger; Geoffrey Michael,3,0,32,29
1658135236829,MATH 109,B03,093479,Ganzberger; Geoffrey Michael,8,0,32,24
1658135242856,MATH 142A,A01,083219,Chow; Bennett,7,0,32,25
1658135242856,MATH 142A,A02,083220,Chow; Bennett,10,0,32,22
1658135242856,MATH 142A,A03,093480,Chow; Bennett,9,0,32,23
1658135242856,MATH 142A,B03,093481,Chow; Bennett,8,0,32,24
1658135242856,MATH 142A,B04,093558,Chow; Bennett,14,0,32,18
1658135242856,MATH 142A,B05,093559,Chow; Bennett,7,0,32,25
1658135248882,MATH 193A,A01,083224,Rotar; Vladimir,9,0,34,25
1658135248882,MATH 193A,A02,083225,Rotar; Vladimir,11,0,34,23
1658135248882,MATH 193A,A03,083781,Rotar; Vladimir,5,0,34,29
1658135248882,MATH 193A,A04,083782,Rotar; Vladimir,12,0,34,22
1658135248882,MATH 193A,A05,093482,Rotar; Vladimir,11,0,34,23
1658135254908,MATH 197,001,091859,McAuley; Julian John,9999,0,9999,0
1658135254908,MATH 197,002,095566,Kedlaya; Kiran S.,9997,0,9999,2
1658135254908,MATH 197,003,095567,Xiao; Ming,9999,0,9999,0
1658135254908,MATH 197,004,095571,Perols; Johan Lars,9998,0,9999,1
1658135261989,COGS 9,A01,083615,Shannon; Kyle Michael,11,0,75,64
1658135268019,COGS 11,A01,083617,Boyle; Mary E. T.,23,0,48,25
1658135274052,COGS 13,A01,083071,Bastos; Amalia Pinkusfeld,12,0,71,59
1658135280083,COGS 14A,A01,092681,Semenuks; Arturs,5,1,100,95
1658135286112,COGS 14B,A01,083073,Cheng; Tzu-Han,7,0,63,56
1658135292135,COGS 17,A01,092677,Semenuks; Arturs,7,0,81,74
1658135298160,COGS 100,A01,083619,Allen; Michael Gordon,17,0,70,53
1658135304184,COGS 101A,A01,083621,Davis; Joshua Daniel,9,0,68,59
1658135310215,COGS 101B,A01,091572,Allen; Michael Gordon,14,0,65,51
1658135316242,COGS 101C,A01,083625,Delgado; Tania,17,0,35,18
1658135322270,COGS 107A,A01,083627,Boyle; Mary E. T.,14,0,60,46
1658135328299,COGS 118A,A01,083075,Gupta; Anjum,21,0,76,55
1658135334325,CSE 3,A50,083646,Miranda; Gregory Joseph,24,0,50,26
1658135340357,CSE 8A,A50,083650,Miranda; Gregory Joseph,17,1,56,39
1658135346382,CSE 11,A01,083080,Cao; Yingjun,7,15,40,33
1658135352413,CSE 12,A01,083652,Krause-Levy; Sophia Louisa,30,1,120,90
1658135358438,CSE 15L,A01,083654,Morris; Justin Loren,9,0,50,41
1658135358438,CSE 15L,A02,083655,Morris; Justin Loren,11,0,50,39
1658135364470,CSE 20,A01,083657,Tran; Khoa Dang,39,0,80,41
1658135370497,CSE 21,A01,095574,Bach; Quang Tran,23,0,48,25
1658135376544,CSE 30,A01,083084,Eldon; John,8,0,80,72
1658135376544,CSE 30,B01,095061,Bhaskar; Nishant,9,0,50,41
1658135382569,CSE 100,A01,083659,Cao; Yingjun,5,4,70,65
1658135388599,CSE 134B,A01,083661,Powell; Thomas Allan,25,0,100,75
1658135394630,CSE 140,A01,083663,Gungor; Onat,17,0,85,68
1658135400661,CSE 140L,A01,083088,Eldon; John,23,0,100,77
1658135406686,CSE 175,A01,083665,Kumar; Rakesh,3,0,25,22
1658135412710,CSE 190,A00,092507,Dubnov; Shlomo,8,0,20,12
1658135418735,ECE 45,A01,083139,Congero; Spencer William,7,0,75,68
1658135424771,ECE 65,A50,083695,Saad; Andrew S,12,0,30,18
1658135424771,ECE 65,A51,095125,Saad; Andrew S,24,0,26,2
1658135430802,ECE 109,A01,091882,Touri; Behrouz,21,0,70,49
1658135436834,ECE 180,A00,083140,Abi Samra; Nicholas Camill,1,0,30,29
1658135436834,ECE 180,B00,083141,Abi Samra; Nicholas Camill,0,0,30,30
1658135442869,MATH 10A,A01,083735,Patchell; Gregory David,2,0,30,28
1658135442869,MATH 10A,A02,083736,Patchell; Gregory David,20,0,30,10
1658135442869,MATH 10A,A03,083737,Patchell; Gregory David,16,0,30,14
1658135448900,MATH 10B,A01,083207,Lim; Seonhee,9,0,34,25
1658135448900,MATH 10B,A02,083208,Lim; Seonhee,10,0,35,25
1658135448900,MATH 10B,A03,093472,Lim; Seonhee,7,0,34,27
1658135448900,MATH 10B,B01,083739,Sinha; Shubham,14,0,30,16
1658135454930,MATH 18,A01,083743,Cinel; Cameron Alexander,9,0,30,21
1658135454930,MATH 18,A02,083744,Cinel; Cameron Alexander,18,0,30,12
1658135454930,MATH 18,A03,083745,Cinel; Cameron Alexander,10,0,30,20
1658135454930,MATH 18,B01,083748,Rideout; David Porter,5,0,37,32
1658135454930,MATH 18,B02,083749,Rideout; David Porter,5,0,36,31
1658135454930,MATH 18,B03,083750,Rideout; David Porter,3,0,37,34
1658135454930,MATH 18,B04,083751,Rideout; David Porter,7,0,36,29
1658135454930,MATH 18,B05,093473,Rideout; David Porter,7,0,36,29
1658135454930,MATH 18,B06,093474,Rideout; David Porter,6,0,36,30
1658135460955,MATH 20A,A01,083754,Zheng; Zequn,14,0,40,26
1658135466981,MATH 20B,A01,083756,Briones; Jor-el Thomas Caparas,4,0,36,32
1658135466981,MATH 20B,A02,083757,Briones; Jor-el Thomas Caparas,1,0,36,35
1658135466981,MATH 20B,A03,093475,Briones; Jor-el Thomas Caparas,3,0,36,33
1658135473020,MATH 20C,A01,083760,Briones; Jor-el Thomas Caparas,1,0,35,34
1658135473020,MATH 20C,A02,083761,Briones; Jor-el Thomas Caparas,8,0,35,27
1658135473020,MATH 20C,A03,093476,Briones; Jor-el Thomas Caparas,0,1,36,36
1658135473020,MATH 20C,B01,083762,Bach; Quang Tran,1,0,30,29
1658135479057,MATH 20D,A01,083765,Tran; Brian Kha,5,0,30,25
1658135479057,MATH 20D,A02,083766,Tran; Brian Kha,5,0,30,25
1658135479057,MATH 20D,A03,083767,Tran; Brian Kha,6,0,30,24
1658135485084,MATH 20E,A01,083771,Ganguly; Soumya,12,0,32,20
1658135485084,MATH 20E,A02,083772,Ganguly; Soumya,7,0,32,25
1658135485084,MATH 20E,B01,083773,Ciotti; Benjamin,20,0,35,15
1658135485084,MATH 20E,B02,083774,Ciotti; Benjamin,18,0,35,17
1658135491118,MATH 103A,A01,083777,Greenfeld; Be'Eri,6,0,36,30
1658135491118,MATH 103A,A02,083778,Greenfeld; Be'Eri,5,0,36,31
1658135491118,MATH 103A,A03,093561,Greenfeld; Be'Eri,7,0,36,29
1658135491118,MATH 103A,B01,083779,Greenfeld; Be'Eri,8,0,36,28
1658135491118,MATH 103A,B02,083780,Greenfeld; Be'Eri,4,0,36,32
1658135491118,MATH 103A,B03,093562,Greenfeld; Be'Eri,3,0,36,33
1658135497148,MATH 105,A01,085443,Carter; Anne Toulson,15,0,35,20
1658135497148,MATH 105,A02,093477,Carter; Anne Toulson,20,0,35,15
1658135503182,MATH 109,A01,083213,Ganzberger; Geoffrey Michael,3,0,34,31
1658135503182,MATH 109,A02,083214,Ganzberger; Geoffrey Michael,4,0,34,30
1658135503182,MATH 109,A03,093478,Ganzberger; Geoffrey Michael,2,0,34,32
1658135503182,MATH 109,B01,083215,Ganzberger; Geoffrey Michael,3,0,32,29
1658135503182,MATH 109,B02,083216,Ganzberger; Geoffrey Michael,3,0,32,29
1658135503182,MATH 109,B03,093479,Ganzberger; Geoffrey Michael,8,0,32,24
1658135509218,MATH 142A,A01,083219,Chow; Bennett,7,0,32,25
1658135509218,MATH 142A,A02,083220,Chow; Bennett,10,0,32,22
1658135509218,MATH 142A,A03,093480,Chow; Bennett,9,0,32,23
1658135509218,MATH 142A,B03,093481,Chow; Bennett,8,0,32,24
1658135509218,MATH 142A,B04,093558,Chow; Bennett,14,0,32,18
1658135509218,MATH 142A,B05,093559,Chow; Bennett,7,0,32,25
1658135515334,MATH 193A,A01,083224,Rotar; Vladimir,9,0,34,25
1658135515334,MATH 193A,A02,083225,Rotar; Vladimir,11,0,34,23
1658135515334,MATH 193A,A03,083781,Rotar; Vladimir,5,0,34,29
1658135515334,MATH 193A,A04,083782,Rotar; Vladimir,12,0,34,22
1658135515334,MATH 193A,A05,093482,Rotar; Vladimir,11,0,34,23
1658135521359,MATH 197,001,091859,McAuley; Julian John,9999,0,9999,0
1658135521359,MATH 197,002,095566,Kedlaya; Kiran S.,9997,0,9999,2
1658135521359,MATH 197,003,095567,Xiao; Ming,9999,0,9999,0
1658135521359,MATH 197,004,095571,Perols; Johan Lars,9998,0,9999,1
1658135528436,COGS 9,A01,083615,Shannon; Kyle Michael,11,0,75,64
1658135534460,COGS 11,A01,083617,Boyle; Mary E. T.,23,0,48,25
1658135540492,COGS 13,A01,083071,Bastos; Amalia Pinkusfeld,12,0,71,59
1658135546517,COGS 14A,A01,092681,Semenuks; Arturs,5,1,100,95
1658135552544,COGS 14B,A01,083073,Cheng; Tzu-Han,7,0,63,56
1658135558572,COGS 17,A01,092677,Semenuks; Arturs,7,0,81,74
1658135564595,COGS 100,A01,083619,Allen; Michael Gordon,17,0,70,53
1658135570622,COGS 101A,A01,083621,Davis; Joshua Daniel,9,0,68,59
1658135576646,COGS 101B,A01,091572,Allen; Michael Gordon,14,0,65,51
1658135582677,COGS 101C,A01,083625,Delgado; Tania,17,0,35,18
1658135588701,COGS 107A,A01,083627,Boyle; Mary E. T.,14,0,60,46
1658135594730,COGS 118A,A01,083075,Gupta; Anjum,21,0,76,55
1658135600755,CSE 3,A50,083646,Miranda; Gregory Joseph,24,0,50,26
1658135606785,CSE 8A,A50,083650,Miranda; Gregory Joseph,17,1,56,39
1658135612809,CSE 11,A01,083080,Cao; Yingjun,7,15,40,33
1658135618834,CSE 12,A01,083652,Krause-Levy; Sophia Louisa,30,1,120,90
1658135624866,CSE 15L,A01,083654,Morris; Justin Loren,9,0,50,41
1658135624866,CSE 15L,A02,083655,Morris; Justin Loren,11,0,50,39
1658135630895,CSE 20,A01,083657,Tran; Khoa Dang,39,0,80,41
1658135636924,CSE 21,A01,095574,Bach; Quang Tran,23,0,48,25
1658135642955,CSE 30,A01,083084,Eldon; John,8,0,80,72
1658135642955,CSE 30,B01,095061,Bhaskar; Nishant,9,0,50,41
1658135648980,CSE 100,A01,083659,Cao; Yingjun,5,4,70,65
1658135655006,CSE 134B,A01,083661,Powell; Thomas Allan,25,0,100,75
1658135661032,CSE 140,A01,083663,Gungor; Onat,17,0,85,68
1658135667059,CSE 140L,A01,083088,Eldon; John,23,0,100,77
1658135673087,CSE 175,A01,083665,Kumar; Rakesh,3,0,25,22
1658135679110,CSE 190,A00,092507,Dubnov; Shlomo,8,0,20,12
1658135685137,ECE 45,A01,083139,Congero; Spencer William,7,0,75,68
1658135691161,ECE 65,A50,083695,Saad; Andrew S,12,0,30,18
1658135691161,ECE 65,A51,095125,Saad; Andrew S,24,0,26,2
1658135697190,ECE 109,A01,091882,Touri; Behrouz,21,0,70,49
1658135703223,ECE 180,A00,083140,Abi Samra; Nicholas Camill,1,0,30,29
1658135703223,ECE 180,B00,083141,Abi Samra; Nicholas Camill,0,0,30,30
1658135709256,MATH 10A,A01,083735,Patchell; Gregory David,2,0,30,28
1658135709256,MATH 10A,A02,083736,Patchell; Gregory David,20,0,30,10
1658135709256,MATH 10A,A03,083737,Patchell; Gregory David,16,0,30,14
1658135715286,MATH 10B,A01,083207,Lim; Seonhee,9,0,34,25
1658135715286,MATH 10B,A02,083208,Lim; Seonhee,10,0,35,25
1658135715286,MATH 10B,A03,093472,Lim; Seonhee,7,0,34,27
1658135715286,MATH 10B,B01,083739,Sinha; Shubham,14,0,30,16
1658135721314,MATH 18,A01,083743,Cinel; Cameron Alexander,9,0,30,21
1658135721314,MATH 18,A02,083744,Cinel; Cameron Alexander,18,0,30,12
1658135721314,MATH 18,A03,083745,Cinel; Cameron Alexander,10,0,30,20
1658135721314,MATH 18,B01,083748,Rideout; David Porter,5,0,37,32
1658135721314,MATH 18,B02,083749,Rideout; David Porter,5,0,36,31
1658135721314,MATH 18,B03,083750,Rideout; David Porter,3,0,37,34
1658135721314,MATH 18,B04,083751,Rideout; David Porter,7,0,36,29
1658135721314,MATH 18,B05,093473,Rideout; David Porter,7,0,36,29
1658135721314,MATH 18,B06,093474,Rideout; David Porter,6,0,36,30
1658135727339,MATH 20A,A01,083754,Zheng; Zequn,14,0,40,26
1658135733361,MATH 20B,A01,083756,Briones; Jor-el Thomas Caparas,4,0,36,32
1658135733361,MATH 20B,A02,083757,Briones; Jor-el Thomas Caparas,1,0,36,35
1658135733361,MATH 20B,A03,093475,Briones; Jor-el Thomas Caparas,3,0,36,33
1658135739385,MATH 20C,A01,083760,Briones; Jor-el Thomas Caparas,1,0,35,34
1658135739385,MATH 20C,A02,083761,Briones; Jor-el Thomas Caparas,8,0,35,27
1658135739385,MATH 20C,A03,093476,Briones; Jor-el Thomas Caparas,0,1,36,36
1658135739385,MATH 20C,B01,083762,Bach; Quang Tran,1,0,30,29
1658135745410,MATH 20D,A01,083765,Tran; Brian Kha,5,0,30,25
1658135745410,MATH 20D,A02,083766,Tran; Brian Kha,5,0,30,25
1658135745410,MATH 20D,A03,083767,Tran; Brian Kha,6,0,30,24
1658135751438,MATH 20E,A01,083771,Ganguly; Soumya,12,0,32,20
1658135751438,MATH 20E,A02,083772,Ganguly; Soumya,7,0,32,25
1658135751438,MATH 20E,B01,083773,Ciotti; Benjamin,20,0,35,15
1658135751438,MATH 20E,B02,083774,Ciotti; Benjamin,18,0,35,17
1658135757469,MATH 103A,A01,083777,Greenfeld; Be'Eri,6,0,36,30
1658135757469,MATH 103A,A02,083778,Greenfeld; Be'Eri,5,0,36,31
1658135757469,MATH 103A,A03,093561,Greenfeld; Be'Eri,7,0,36,29
1658135757469,MATH 103A,B01,083779,Greenfeld; Be'Eri,8,0,36,28
1658135757469,MATH 103A,B02,083780,Greenfeld; Be'Eri,4,0,36,32
1658135757469,MATH 103A,B03,093562,Greenfeld; Be'Eri,3,0,36,33
1658135763495,MATH 105,A01,085443,Carter; Anne Toulson,15,0,35,20
1658135763495,MATH 105,A02,093477,Carter; Anne Toulson,20,0,35,15
1658135769524,MATH 109,A01,083213,Ganzberger; Geoffrey Michael,3,0,34,31
1658135769524,MATH 109,A02,083214,Ganzberger; Geoffrey Michael,4,0,34,30
1658135769524,MATH 109,A03,093478,Ganzberger; Geoffrey Michael,2,0,34,32
1658135769524,MATH 109,B01,083215,Ganzberger; Geoffrey Michael,3,0,32,29
1658135769524,MATH 109,B02,083216,Ganzberger; Geoffrey Michael,3,0,32,29
1658135769524,MATH 109,B03,093479,Ganzberger; Geoffrey Michael,8,0,32,24
1658135775556,MATH 142A,A01,083219,Chow; Bennett,7,0,32,25
1658135775556,MATH 142A,A02,083220,Chow; Bennett,10,0,32,22
1658135775556,MATH 142A,A03,093480,Chow; Bennett,9,0,32,23
1658135775556,MATH 142A,B03,093481,Chow; Bennett,8,0,32,24
1658135775556,MATH 142A,B04,093558,Chow; Bennett,14,0,32,18
1658135775556,MATH 142A,B05,093559,Chow; Bennett,7,0,32,25
1658135781581,MATH 193A,A01,083224,Rotar; Vladimir,9,0,34,25
1658135781581,MATH 193A,A02,083225,Rotar; Vladimir,11,0,34,23
1658135781581,MATH 193A,A03,083781,Rotar; Vladimir,5,0,34,29
1658135781581,MATH 193A,A04,083782,Rotar; Vladimir,12,0,34,22
1658135781581,MATH 193A,A05,093482,Rotar; Vladimir,11,0,34,23
1658135787619,MATH 197,001,091859,McAuley; Julian John,9999,0,9999,0
1658135787619,MATH 197,002,095566,Kedlaya; Kiran S.,9997,0,9999,2
1658135787619,MATH 197,003,095567,Xiao; Ming,9999,0,9999,0
1658135787619,MATH 197,004,095571,Perols; Johan Lars,9998,0,9999,1
1658135794697,COGS 9,A01,083615,Shannon; Kyle Michael,11,0,75,64
1658135800719,COGS 11,A01,083617,Boyle; Mary E. T.,23,0,48,25
1658135806744,COGS 13,A01,083071,Bastos; Amalia Pinkusfeld,12,0,71,59
1658135812768,COGS 14A,A01,092681,Semenuks; Arturs,5,1,100,95
1658135818792,COGS 14B,A01,083073,Cheng; Tzu-Han,7,0,63,56
1658135824818,COGS 17,A01,092677,Semenuks; Arturs,7,0,81,74
1658135830841,COGS 100,A01,083619,Allen; Michael Gordon,17,0,70,53
1658135836864,COGS 101A,A01,083621,Davis; Joshua Daniel,9,0,68,59
1658135842894,COGS 101B,A01,091572,Allen; Michael Gordon,14,0,65,51
1658135848919,COGS 101C,A01,083625,Delgado; Tania,17,0,35,18
1658135854942,COGS 107A,A01,083627,Boyle; Mary E. T.,14,0,60,46
1658135860966,COGS 118A,A01,083075,Gupta; Anjum,21,0,76,55
1658135866991,CSE 3,A50,083646,Miranda; Gregory Joseph,24,0,50,26
1658135873014,CSE 8A,A50,083650,Miranda; Gregory Joseph,17,1,56,39
1658135879038,CSE 11,A01,083080,Cao; Yingjun,7,15,40,33
1658135885065,CSE 12,A01,083652,Krause-Levy; Sophia Louisa,30,1,120,90
1658135891091,CSE 15L,A01,083654,Morris; Justin Loren,9,0,50,41
1658135891091,CSE 15L,A02,083655,Morris; Justin Loren,11,0,50,39
1658135897114,CSE 20,A01,083657,Tran; Khoa Dang,39,0,80,41
1658135903147,CSE 21,A01,095574,Bach; Quang Tran,23,0,48,25
1658135909173,CSE 30,A01,083084,Eldon; John,8,0,80,72
1658135909173,CSE 30,B01,095061,Bhaskar; Nishant,9,0,50,41
1658135915199,CSE 100,A01,083659,Cao; Yingjun,5,4,70,65
1658135921229,CSE 134B,A01,083661,Powell; Thomas Allan,25,0,100,75
1658135927252,CSE 140,A01,083663,Gungor; Onat,17,0,85,68
1658135933277,CSE 140L,A01,083088,Eldon; John,23,0,100,77
1658135939312,CSE 175,A01,083665,Kumar; Rakesh,3,0,25,22
1658135945346,CSE 190,A00,092507,Dubnov; Shlomo,8,0,20,12
1658135951371,ECE 45,A01,083139,Congero; Spencer William,7,0,75,68
1658135957395,ECE 65,A50,083695,Saad; Andrew S,12,0,30,18
1658135957395,ECE 65,A51,095125,Saad; Andrew S,24,0,26,2
1658135963417,ECE 109,A01,091882,Touri; Behrouz,21,0,70,49
1658135969446,ECE 180,A00,083140,Abi Samra; Nicholas Camill,1,0,30,29
1658135969446,ECE 180,B00,083141,Abi Samra; Nicholas Camill,0,0,30,30
1658135975472,MATH 10A,A01,083735,Patchell; Gregory David,2,0,30,28
1658135975472,MATH 10A,A02,083736,Patchell; Gregory David,20,0,30,10
1658135975472,MATH 10A,A03,083737,Patchell; Gregory David,16,0,30,14
1658135981507,MATH 10B,A01,083207,Lim; Seonhee,9,0,34,25
1658135981507,MATH 10B,A02,083208,Lim; Seonhee,10,0,35,25
1658135981507,MATH 10B,A03,093472,Lim; Seonhee,7,0,34,27
1658135981507,MATH 10B,B01,083739,Sinha; Shubham,14,0,30,16
1658135987542,MATH 18,A01,083743,Cinel; Cameron Alexander,9,0,30,21
1658135987542,MATH 18,A02,083744,Cinel; Cameron Alexander,18,0,30,12
1658135987542,MATH 18,A03,083745,Cinel; Cameron Alexander,10,0,30,20
1658135987542,MATH 18,B01,083748,Rideout; David Porter,5,0,37,32
1658135987542,MATH 18,B02,083749,Rideout; David Porter,5,0,36,31
1658135987542,MATH 18,B03,083750,Rideout; David Porter,3,0,37,34
1658135987542,MATH 18,B04,083751,Rideout; David Porter,7,0,36,29
1658135987542,MATH 18,B05,093473,Rideout; David Porter,7,0,36,29
1658135987542,MATH 18,B06,093474,Rideout; David Porter,6,0,36,30
1658135993567,MATH 20A,A01,083754,Zheng; Zequn,14,0,40,26
1658135999598,MATH 20B,A01,083756,Briones; Jor-el Thomas Caparas,4,0,36,32
1658135999598,MATH 20B,A02,083757,Briones; Jor-el Thomas Caparas,1,0,36,35
1658135999598,MATH 20B,A03,093475,Briones; Jor-el Thomas Caparas,3,0,36,33
1658136005628,MATH 20C,A01,083760,Briones; Jor-el Thomas Caparas,1,0,35,34
1658136005628,MATH 20C,A02,083761,Briones; Jor-el Thomas Caparas,8,0,35,27
1658136005628,MATH 20C,A03,093476,Briones; Jor-el Thomas Caparas,0,1,36,36
1658136005628,MATH 20C,B01,083762,Bach; Quang Tran,1,0,30,29
1658136011652,MATH 20D,A01,083765,Tran; Brian Kha,5,0,30,25
1658136011652,MATH 20D,A02,083766,Tran; Brian Kha,5,0,30,25
1658136011652,MATH 20D,A03,083767,Tran; Brian Kha,6,0,30,24
1658136017687,MATH 20E,A01,083771,Ganguly; Soumya,12,0,32,20
1658136017687,MATH 20E,A02,083772,Ganguly; Soumya,7,0,32,25
1658136017687,MATH 20E,B01,083773,Ciotti; Benjamin,20,0,35,15
1658136017687,MATH 20E,B02,083774,Ciotti; Benjamin,18,0,35,17
1658136023715,MATH 103A,A01,083777,Greenfeld; Be'Eri,6,0,36,30
1658136023715,MATH 103A,A02,083778,Greenfeld; Be'Eri,5,0,36,31
1658136023715,MATH 103A,A03,093561,Greenfeld; Be'Eri,7,0,36,29
1658136023715,MATH 103A,B01,083779,Greenfeld; Be'Eri,8,0,36,28
1658136023715,MATH 103A,B02,083780,Greenfeld; Be'Eri,4,0,36,32
1658136023715,MATH 103A,B03,093562,Greenfeld; Be'Eri,3,0,36,33
1658136029740,MATH 105,A01,085443,Carter; Anne Toulson,15,0,35,20
1658136029740,MATH 105,A02,093477,Carter; Anne Toulson,20,0,35,15
1658136035769,MATH 109,A01,083213,Ganzberger; Geoffrey Michael,3,0,34,31
1658136035769,MATH 109,A02,083214,Ganzberger; Geoffrey Michael,4,0,34,30
1658136035769,MATH 109,A03,093478,Ganzberger; Geoffrey Michael,2,0,34,32
1658136035769,MATH 109,B01,083215,Ganzberger; Geoffrey Michael,3,0,32,29
1658136035769,MATH 109,B02,083216,Ganzberger; Geoffrey Michael,3,0,32,29
1658136035769,MATH 109,B03,093479,Ganzberger; Geoffrey Michael,8,0,32,24
1658136041800,MATH 142A,A01,083219,Chow; Bennett,7,0,32,25
1658136041800,MATH 142A,A02,083220,Chow; Bennett,10,0,32,22
1658136041800,MATH 142A,A03,093480,Chow; Bennett,9,0,32,23
1658136041800,MATH 142A,B03,093481,Chow; Bennett,8,0,32,24
1658136041800,MATH 142A,B04,093558,Chow; Bennett,14,0,32,18
1658136041800,MATH 142A,B05,093559,Chow; Bennett,7,0,32,25
1658136047831,MATH 193A,A01,083224,Rotar; Vladimir,9,0,34,25
1658136047831,MATH 193A,A02,083225,Rotar; Vladimir,11,0,34,23
1658136047831,MATH 193A,A03,083781,Rotar; Vladimir,5,0,34,29
1658136047831,MATH 193A,A04,083782,Rotar; Vladimir,12,0,34,22
1658136047831,MATH 193A,A05,093482,Rotar; Vladimir,11,0,34,23
1658136053860,MATH 197,001,091859,McAuley; Julian John,9999,0,9999,0
1658136053860,MATH 197,002,095566,Kedlaya; Kiran S.,9997,0,9999,2
1658136053860,MATH 197,003,095567,Xiao; Ming,9999,0,9999,0
1658136053860,MATH 197,004,095571,Perols; Johan Lars,9998,0,9999,1
1658136060931,COGS 9,A01,083615,Shannon; Kyle Michael,11,0,75,64
1658136066958,COGS 11,A01,083617,Boyle; Mary E. T.,23,0,48,25
1658136072986,COGS 13,A01,083071,Bastos; Amalia Pinkusfeld,12,0,71,59
1658136079009,COGS 14A,A01,092681,Semenuks; Arturs,5,1,100,95
1658136085034,COGS 14B,A01,083073,Cheng; Tzu-Han,7,0,63,56
1658136091060,COGS 17,A01,092677,Semenuks; Arturs,7,0,81,74
1658136097088,COGS 100,A01,083619,Allen; Michael Gordon,17,0,70,53
1658136103118,COGS 101A,A01,083621,Davis; Joshua Daniel,9,0,68,59
1658136109221,COGS 101B,A01,091572,Allen; Michael Gordon,14,0,65,51
1658136115249,COGS 101C,A01,083625,Delgado; Tania,17,0,35,18
1658136121273,COGS 107A,A01,083627,Boyle; Mary E. T.,14,0,60,46
1658136127296,COGS 118A,A01,083075,Gupta; Anjum,21,0,76,55
1658136133322,CSE 3,A50,083646,Miranda; Gregory Joseph,24,0,50,26
1658136139350,CSE 8A,A50,083650,Miranda; Gregory Joseph,17,1,56,39
1658136145373,CSE 11,A01,083080,Cao; Yingjun,7,15,40,33
1658136151397,CSE 12,A01,083652,Krause-Levy; Sophia Louisa,30,1,120,90
1658136157421,CSE 15L,A01,083654,Morris; Justin Loren,9,0,50,41
1658136157421,CSE 15L,A02,083655,Morris; Justin Loren,11,0,50,39
1658136163451,CSE 20,A01,083657,Tran; Khoa Dang,39,0,80,41
1658136169478,CSE 21,A01,095574,Bach; Quang Tran,23,0,48,25
1658136175502,CSE 30,A01,083084,Eldon; John,8,0,80,72
1658136175502,CSE 30,B01,095061,Bhaskar; Nishant,9,0,50,41
1658136181526,CSE 100,A01,083659,Cao; Yingjun,5,4,70,65
1658136187555,CSE 134B,A01,083661,Powell; Thomas Allan,25,0,100,75
1658136193583,CSE 140,A01,083663,Gungor; Onat,17,0,85,68
1658136199609,CSE 140L,A01,083088,Eldon; John,23,0,100,77
1658136205636,CSE 175,A01,083665,Kumar; Rakesh,3,0,25,22
1658136211661,CSE 190,A00,092507,Dubnov; Shlomo,8,0,20,12
1658136217691,ECE 45,A01,083139,Congero; Spencer William,7,0,75,68
1658136223720,ECE 65,A50,083695,Saad; Andrew S,12,0,30,18
1658136223720,ECE 65,A51,095125,Saad; Andrew S,24,0,26,2
1658136229743,ECE 109,A01,091882,Touri; Behrouz,21,0,70,49
1658136235766,ECE 180,A00,083140,Abi Samra; Nicholas Camill,1,0,30,29
1658136235766,ECE 180,B00,083141,Abi Samra; Nicholas Camill,0,0,30,30
1658136241790,MATH 10A,A01,083735,Patchell; Gregory David,2,0,30,28
1658136241790,MATH 10A,A02,083736,Patchell; Gregory David,20,0,30,10
1658136241790,MATH 10A,A03,083737,Patchell; Gregory David,16,0,30,14
1658136247822,MATH 10B,A01,083207,Lim; Seonhee,9,0,34,25
1658136247822,MATH 10B,A02,083208,Lim; Seonhee,10,0,35,25
1658136247822,MATH 10B,A03,093472,Lim; Seonhee,7,0,34,27
1658136247822,MATH 10B,B01,083739,Sinha; Shubham,14,0,30,16
1658136253855,MATH 18,A01,083743,Cinel; Cameron Alexander,9,0,30,21
1658136253855,MATH 18,A02,083744,Cinel; Cameron Alexander,18,0,30,12
1658136253855,MATH 18,A03,083745,Cinel; Cameron Alexander,10,0,30,20
1658136253855,MATH 18,B01,083748,Rideout; David Porter,5,0,37,32
1658136253855,MATH 18,B02,083749,Rideout; David Porter,5,0,36,31
1658136253855,MATH 18,B03,083750,Rideout; David Porter,3,0,37,34
1658136253855,MATH 18,B04,083751,Rideout; David Porter,7,0,36,29
1658136253855,MATH 18,B05,093473,Rideout; David Porter,7,0,36,29
1658136253855,MATH 18,B06,093474,Rideout; David Porter,6,0,36,30
1658136259880,MATH 20A,A01,083754,Zheng; Zequn,14,0,40,26
1658136265903,MATH 20B,A01,083756,Briones; Jor-el Thomas Caparas,4,0,36,32
1658136265903,MATH 20B,A02,083757,Briones; Jor-el Thomas Caparas,1,0,36,35
1658136265903,MATH 20B,A03,093475,Briones; Jor-el Thomas Caparas,3,0,36,33
1658136271930,MATH 20C,A01,083760,Briones; Jor-el Thomas Caparas,1,0,35,34
1658136271930,MATH 20C,A02,083761,Briones; Jor-el Thomas Caparas,8,0,35,27
1658136271930,MATH 20C,A03,093476,Briones; Jor-el Thomas Caparas,0,1,36,36
1658136271930,MATH 20C,B01,083762,Bach; Quang Tran,1,0,30,29
1658136277954,MATH 20D,A01,083765,Tran; Brian Kha,5,0,30,25
1658136277954,MATH 20D,A02,083766,Tran; Brian Kha,5,0,30,25
1658136277954,MATH 20D,A03,083767,Tran; Brian Kha,6,0,30,24
1658136283980,MATH 20E,A01,083771,Ganguly; Soumya,12,0,32,20
1658136283980,MATH 20E,A02,083772,Ganguly; Soumya,7,0,32,25
1658136283980,MATH 20E,B01,083773,Ciotti; Benjamin,20,0,35,15
1658136283980,MATH 20E,B02,083774,Ciotti; Benjamin,18,0,35,17
1658136290014,MATH 103A,A01,083777,Greenfeld; Be'Eri,6,0,36,30
1658136290014,MATH 103A,A02,083778,Greenfeld; Be'Eri,5,0,36,31
1658136290014,MATH 103A,A03,093561,Greenfeld; Be'Eri,7,0,36,29
1658136290014,MATH 103A,B01,083779,Greenfeld; Be'Eri,8,0,36,28
1658136290014,MATH 103A,B02,083780,Greenfeld; Be'Eri,4,0,36,32
1658136290014,MATH 103A,B03,093562,Greenfeld; Be'Eri,3,0,36,33
1658136296037,MATH 105,A01,085443,Carter; Anne Toulson,15,0,35,20
1658136296037,MATH 105,A02,093477,Carter; Anne Toulson,20,0,35,15
1658136302063,MATH 109,A01,083213,Ganzberger; Geoffrey Michael,3,0,34,31
1658136302063,MATH 109,A02,083214,Ganzberger; Geoffrey Michael,4,0,34,30
1658136302063,MATH 109,A03,093478,Ganzberger; Geoffrey Michael,2,0,34,32
1658136302063,MATH 109,B01,083215,Ganzberger; Geoffrey Michael,3,0,32,29
1658136302063,MATH 109,B02,083216,Ganzberger; Geoffrey Michael,3,0,32,29
1658136302063,MATH 109,B03,093479,Ganzberger; Geoffrey Michael,8,0,32,24
1658136308093,MATH 142A,A01,083219,Chow; Bennett,7,0,32,25
1658136308093,MATH 142A,A02,083220,Chow; Bennett,10,0,32,22
1658136308093,MATH 142A,A03,093480,Chow; Bennett,9,0,32,23
1658136308093,MATH 142A,B03,093481,Chow; Bennett,8,0,32,24
1658136308093,MATH 142A,B04,093558,Chow; Bennett,14,0,32,18
1658136308093,MATH 142A,B05,093559,Chow; Bennett,7,0,32,25
1658136314128,MATH 193A,A01,083224,Rotar; Vladimir,9,0,34,25
1658136314128,MATH 193A,A02,083225,Rotar; Vladimir,11,0,34,23
1658136314128,MATH 193A,A03,083781,Rotar; Vladimir,5,0,34,29
1658136314128,MATH 193A,A04,083782,Rotar; Vladimir,12,0,34,22
1658136314128,MATH 193A,A05,093482,Rotar; Vladimir,11,0,34,23
1658136320156,MATH 197,001,091859,McAuley; Julian John,9999,0,9999,0
1658136320156,MATH 197,002,095566,Kedlaya; Kiran S.,9997,0,9999,2
1658136320156,MATH 197,003,095567,Xiao; Ming,9999,0,9999,0
1658136320156,MATH 197,004,095571,Perols; Johan Lars,9998,0,9999,1
1658136327227,COGS 9,A01,083615,Shannon; Kyle Michael,11,0,75,64
1658136333252,COGS 11,A01,083617,Boyle; Mary E. T.,23,0,48,25
1658136339277,COGS 13,A01,083071,Bastos; Amalia Pinkusfeld,12,0,71,59
1658136345301,COGS 14A,A01,092681,Semenuks; Arturs,5,1,100,95
1658136351326,COGS 14B,A01,083073,Cheng; Tzu-Han,7,0,63,56
1658136357349,COGS 17,A01,092677,Semenuks; Arturs,7,0,81,74
1658136363372,COGS 100,A01,083619,Allen; Michael Gordon,17,0,70,53
1658136369398,COGS 101A,A01,083621,Davis; Joshua Daniel,9,0,68,59
1658136375422,COGS 101B,A01,091572,Allen; Michael Gordon,14,0,65,51
1658136381448,COGS 101C,A01,083625,Delgado; Tania,17,0,35,18
1658136387481,COGS 107A,A01,083627,Boyle; Mary E. T.,14,0,60,46
1658136393505,COGS 118A,A01,083075,Gupta; Anjum,21,0,76,55
1658136399529,CSE 3,A50,083646,Miranda; Gregory Joseph,24,0,50,26
1658136405552,CSE 8A,A50,083650,Miranda; Gregory Joseph,17,1,56,39
1658136411580,CSE 11,A01,083080,Cao; Yingjun,7,15,40,33
1658136417604,CSE 12,A01,083652,Krause-Levy; Sophia Louisa,30,1,120,90
1658136423628,CSE 15L,A01,083654,Morris; Justin Loren,9,0,50,41
1658136423628,CSE 15L,A02,083655,Morris; Justin Loren,11,0,50,39
1658136429651,CSE 20,A01,083657,Tran; Khoa Dang,39,0,80,41
1658136435684,CSE 21,A01,095574,Bach; Quang Tran,23,0,48,25
1658136441708,CSE 30,A01,083084,Eldon; John,8,0,80,72
1658136441708,CSE 30,B01,095061,Bhaskar; Nishant,9,0,50,41
1658136447736,CSE 100,A01,083659,Cao; Yingjun,5,4,70,65
1658136453765,CSE 134B,A01,083661,Powell; Thomas Allan,25,0,100,75
1658136459792,CSE 140,A01,083663,Gungor; Onat,17,0,85,68
1658136465816,CSE 140L,A01,083088,Eldon; John,23,0,100,77
1658136471845,CSE 175,A01,083665,Kumar; Rakesh,3,0,25,22
1658136477873,CSE 190,A00,092507,Dubnov; Shlomo,8,0,20,12
1658136483896,ECE 45,A01,083139,Congero; Spencer William,7,0,75,68
1658136489926,ECE 65,A50,083695,Saad; Andrew S,12,0,30,18
1658136489926,ECE 65,A51,095125,Saad; Andrew S,24,0,26,2
1658136495957,ECE 109,A01,091882,Touri; Behrouz,21,0,70,49
1658136501981,ECE 180,A00,083140,Abi Samra; Nicholas Camill,1,0,30,29
1658136501981,ECE 180,B00,083141,Abi Samra; Nicholas Camill,0,0,30,30
1658136508006,MATH 10A,A01,083735,Patchell; Gregory David,2,0,30,28
1658136508006,MATH 10A,A02,083736,Patchell; Gregory David,20,0,30,10
1658136508006,MATH 10A,A03,083737,Patchell; Gregory David,16,0,30,14
1658136514031,MATH 10B,A01,083207,Lim; Seonhee,9,0,34,25
1658136514031,MATH 10B,A02,083208,Lim; Seonhee,10,0,35,25
1658136514031,MATH 10B,A03,093472,Lim; Seonhee,7,0,34,27
1658136514031,MATH 10B,B01,083739,Sinha; Shubham,14,0,30,16
1658136520068,MATH 18,A01,083743,Cinel; Cameron Alexander,9,0,30,21
1658136520068,MATH 18,A02,083744,Cinel; Cameron Alexander,18,0,30,12
1658136520068,MATH 18,A03,083745,Cinel; Cameron Alexander,10,0,30,20
1658136520068,MATH 18,B01,083748,Rideout; David Porter,5,0,37,32
1658136520068,MATH 18,B02,083749,Rideout; David Porter,5,0,36,31
1658136520068,MATH 18,B03,083750,Rideout; David Porter,3,0,37,34
1658136520068,MATH 18,B04,083751,Rideout; David Porter,7,0,36,29
1658136520068,MATH 18,B05,093473,Rideout; David Porter,7,0,36,29
1658136520068,MATH 18,B06,093474,Rideout; David Porter,6,0,36,30
1658136526093,MATH 20A,A01,083754,Zheng; Zequn,14,0,40,26
1658136532117,MATH 20B,A01,083756,Briones; Jor-el Thomas Caparas,4,0,36,32
1658136532117,MATH 20B,A02,083757,Briones; Jor-el Thomas Caparas,1,0,36,35
1658136532117,MATH 20B,A03,093475,Briones; Jor-el Thomas Caparas,3,0,36,33
1658136538146,MATH 20C,A01,083760,Briones; Jor-el Thomas Caparas,1,0,35,34
1658136538146,MATH 20C,A02,083761,Briones; Jor-el Thomas Caparas,8,0,35,27
1658136538146,MATH 20C,A03,093476,Briones; Jor-el Thomas Caparas,0,1,36,36
1658136538146,MATH 20C,B01,083762,Bach; Quang Tran,1,0,30,29
1658136544170,MATH 20D,A01,083765,Tran; Brian Kha,5,0,30,25
1658136544170,MATH 20D,A02,083766,Tran; Brian Kha,5,0,30,25
1658136544170,MATH 20D,A03,083767,Tran; Brian Kha,6,0,30,24
1658136550201,MATH 20E,A01,083771,Ganguly; Soumya,12,0,32,20
1658136550201,MATH 20E,A02,083772,Ganguly; Soumya,7,0,32,25
1658136550201,MATH 20E,B01,083773,Ciotti; Benjamin,20,0,35,15
1658136550201,MATH 20E,B02,083774,Ciotti; Benjamin,18,0,35,17
1658136556231,MATH 103A,A01,083777,Greenfeld; Be'Eri,6,0,36,30
1658136556231,MATH 103A,A02,083778,Greenfeld; Be'Eri,5,0,36,31
1658136556231,MATH 103A,A03,093561,Greenfeld; Be'Eri,7,0,36,29
1658136556231,MATH 103A,B01,083779,Greenfeld; Be'Eri,8,0,36,28
1658136556231,MATH 103A,B02,083780,Greenfeld; Be'Eri,4,0,36,32
1658136556231,MATH 103A,B03,093562,Greenfeld; Be'Eri,3,0,36,33
1658136562259,MATH 105,A01,085443,Carter; Anne Toulson,15,0,35,20
1658136562259,MATH 105,A02,093477,Carter; Anne Toulson,20,0,35,15
1658136568281,MATH 109,A01,083213,Ganzberger; Geoffrey Michael,3,0,34,31
1658136568281,MATH 109,A02,083214,Ganzberger; Geoffrey Michael,4,0,34,30
1658136568281,MATH 109,A03,093478,Ganzberger; Geoffrey Michael,2,0,34,32
1658136568281,MATH 109,B01,083215,Ganzberger; Geoffrey Michael,3,0,32,29
1658136568281,MATH 109,B02,083216,Ganzberger; Geoffrey Michael,3,0,32,29
1658136568281,MATH 109,B03,093479,Ganzberger; Geoffrey Michael,8,0,32,24
1658136574309,MATH 142A,A01,083219,Chow; Bennett,7,0,32,25
1658136574309,MATH 142A,A02,083220,Chow; Bennett,10,0,32,22
1658136574309,MATH 142A,A03,093480,Chow; Bennett,9,0,32,23
1658136574309,MATH 142A,B03,093481,Chow; Bennett,8,0,32,24
1658136574309,MATH 142A,B04,093558,Chow; Bennett,14,0,32,18
1658136574309,MATH 142A,B05,093559,Chow; Bennett,7,0,32,25
1658136580338,MATH 193A,A01,083224,Rotar; Vladimir,9,0,34,25
1658136580338,MATH 193A,A02,083225,Rotar; Vladimir,11,0,34,23
1658136580338,MATH 193A,A03,083781,Rotar; Vladimir,5,0,34,29
1658136580338,MATH 193A,A04,083782,Rotar; Vladimir,12,0,34,22
1658136580338,MATH 193A,A05,093482,Rotar; Vladimir,11,0,34,23
1658136586361,MATH 197,001,091859,McAuley; Julian John,9999,0,9999,0
1658136586361,MATH 197,002,095566,Kedlaya; Kiran S.,9997,0,9999,2
1658136586361,MATH 197,003,095567,Xiao; Ming,9999,0,9999,0
1658136586361,MATH 197,004,095571,Perols; Johan Lars,9998,0,9999,1
1658136593415,COGS 9,A01,083615,Shannon; Kyle Michael,11,0,75,64
1658136599439,COGS 11,A01,083617,Boyle; Mary E. T.,23,0,48,25
1658136605465,COGS 13,A01,083071,Bastos; Amalia Pinkusfeld,12,0,71,59
1658136611489,COGS 14A,A01,092681,Semenuks; Arturs,5,1,100,95
1658136617513,COGS 14B,A01,083073,Cheng; Tzu-Han,7,0,63,56
1658136623535,COGS 17,A01,092677,Semenuks; Arturs,7,0,81,74
1658136629564,COGS 100,A01,083619,Allen; Michael Gordon,17,0,70,53
1658136635589,COGS 101A,A01,083621,Davis; Joshua Daniel,9,0,68,59
1658136642334,COGS 101B,A01,091572,Allen; Michael Gordon,14,0,65,51
1658136648359,COGS 101C,A01,083625,Delgado; Tania,17,0,35,18
1658136654391,COGS 107A,A01,083627,Boyle; Mary E. T.,14,0,60,46
1658136660421,COGS 118A,A01,083075,Gupta; Anjum,21,0,76,55
1658136666452,CSE 3,A50,083646,Miranda; Gregory Joseph,24,0,50,26
1658136672482,CSE 8A,A50,083650,Miranda; Gregory Joseph,17,1,56,39
1658136678514,CSE 11,A01,083080,Cao; Yingjun,7,15,40,33
1658136684539,CSE 12,A01,083652,Krause-Levy; Sophia Louisa,30,1,120,90
1658136690568,CSE 15L,A01,083654,Morris; Justin Loren,9,0,50,41
1658136690568,CSE 15L,A02,083655,Morris; Justin Loren,11,0,50,39
1658136696590,CSE 20,A01,083657,Tran; Khoa Dang,39,0,80,41
1658136702613,CSE 21,A01,095574,Bach; Quang Tran,23,0,48,25
1658136708714,CSE 30,A01,083084,Eldon; John,8,0,80,72
1658136708714,CSE 30,B01,095061,Bhaskar; Nishant,9,0,50,41
1658136714736,CSE 100,A01,083659,Cao; Yingjun,5,4,70,65
1658136720764,CSE 134B,A01,083661,Powell; Thomas Allan,25,0,100,75
1658136726790,CSE 140,A01,083663,Gungor; Onat,17,0,85,68
1658136732814,CSE 140L,A01,083088,Eldon; John,23,0,100,77
1658136738843,CSE 175,A01,083665,Kumar; Rakesh,3,0,25,22
1658136744865,CSE 190,A00,092507,Dubnov; Shlomo,8,0,20,12
1658136750890,ECE 45,A01,083139,Congero; Spencer William,7,0,75,68
1658136756914,ECE 65,A50,083695,Saad; Andrew S,12,0,30,18
1658136756914,ECE 65,A51,095125,Saad; Andrew S,24,0,26,2
1658136762938,ECE 109,A01,091882,Touri; Behrouz,21,0,70,49
1658136768989,ECE 180,A00,083140,Abi Samra; Nicholas Camill,1,0,30,29
1658136768989,ECE 180,B00,083141,Abi Samra; Nicholas Camill,0,0,30,30
1658136775020,MATH 10A,A01,083735,Patchell; Gregory David,2,0,30,28
1658136775020,MATH 10A,A02,083736,Patchell; Gregory David,20,0,30,10
1658136775020,MATH 10A,A03,083737,Patchell; Gregory David,16,0,30,14
1658136781047,MATH 10B,A01,083207,Lim; Seonhee,9,0,34,25
1658136781047,MATH 10B,A02,083208,Lim; Seonhee,10,0,35,25
1658136781047,MATH 10B,A03,093472,Lim; Seonhee,7,0,34,27
1658136781047,MATH 10B,B01,083739,Sinha; Shubham,14,0,30,16
1658136787072,MATH 18,A01,083743,Cinel; Cameron Alexander,9,0,30,21
1658136787072,MATH 18,A02,083744,Cinel; Cameron Alexander,18,0,30,12
1658136787072,MATH 18,A03,083745,Cinel; Cameron Alexander,10,0,30,20
1658136787072,MATH 18,B01,083748,Rideout; David Porter,5,0,37,32
1658136787072,MATH 18,B02,083749,Rideout; David Porter,5,0,36,31
1658136787072,MATH 18,B03,083750,Rideout; David Porter,3,0,37,34
1658136787072,MATH 18,B04,083751,Rideout; David Porter,7,0,36,29
1658136787072,MATH 18,B05,093473,Rideout; David Porter,7,0,36,29
1658136787072,MATH 18,B06,093474,Rideout; David Porter,6,0,36,30
1658136793099,MATH 20A,A01,083754,Zheng; Zequn,14,0,40,26
1658136799128,MATH 20B,A01,083756,Briones; Jor-el Thomas Caparas,4,0,36,32
1658136799128,MATH 20B,A02,083757,Briones; Jor-el Thomas Caparas,1,0,36,35
1658136799128,MATH 20B,A03,093475,Briones; Jor-el Thomas Caparas,3,0,36,33
1658136805150,MATH 20C,A01,083760,Briones; Jor-el Thomas Caparas,1,0,35,34
1658136805150,MATH 20C,A02,083761,Briones; Jor-el Thomas Caparas,8,0,35,27
1658136805150,MATH 20C,A03,093476,Briones; Jor-el Thomas Caparas,0,1,36,36
1658136805150,MATH 20C,B01,083762,Bach; Quang Tran,1,0,30,29
1658136811175,MATH 20D,A01,083765,Tran; Brian Kha,5,0,30,25
1658136811175,MATH 20D,A02,083766,Tran; Brian Kha,5,0,30,25
1658136811175,MATH 20D,A03,083767,Tran; Brian Kha,6,0,30,24
1658136817210,MATH 20E,A01,083771,Ganguly; Soumya,12,0,32,20
1658136817210,MATH 20E,A02,083772,Ganguly; Soumya,7,0,32,25
1658136817210,MATH 20E,B01,083773,Ciotti; Benjamin,20,0,35,15
1658136817210,MATH 20E,B02,083774,Ciotti; Benjamin,18,0,35,17
1658136823235,MATH 103A,A01,083777,Greenfeld; Be'Eri,6,0,36,30
1658136823235,MATH 103A,A02,083778,Greenfeld; Be'Eri,5,0,36,31
1658136823235,MATH 103A,A03,093561,Greenfeld; Be'Eri,7,0,36,29
1658136823235,MATH 103A,B01,083779,Greenfeld; Be'Eri,8,0,36,28
1658136823235,MATH 103A,B02,083780,Greenfeld; Be'Eri,4,0,36,32
1658136823235,MATH 103A,B03,093562,Greenfeld; Be'Eri,3,0,36,33
1658136829259,MATH 105,A01,085443,Carter; Anne Toulson,15,0,35,20
1658136829259,MATH 105,A02,093477,Carter; Anne Toulson,20,0,35,15
1658136835294,MATH 109,A01,083213,Ganzberger; Geoffrey Michael,3,0,34,31
1658136835294,MATH 109,A02,083214,Ganzberger; Geoffrey Michael,4,0,34,30
1658136835294,MATH 109,A03,093478,Ganzberger; Geoffrey Michael,2,0,34,32
1658136835294,MATH 109,B01,083215,Ganzberger; Geoffrey Michael,3,0,32,29
1658136835294,MATH 109,B02,083216,Ganzberger; Geoffrey Michael,3,0,32,29
1658136835294,MATH 109,B03,093479,Ganzberger; Geoffrey Michael,8,0,32,24
1658136841320,MATH 142A,A01,083219,Chow; Bennett,7,0,32,25
1658136841320,MATH 142A,A02,083220,Chow; Bennett,10,0,32,22
1658136841320,MATH 142A,A03,093480,Chow; Bennett,9,0,32,23
1658136841320,MATH 142A,B03,093481,Chow; Bennett,8,0,32,24
1658136841320,MATH 142A,B04,093558,Chow; Bennett,14,0,32,18
1658136841320,MATH 142A,B05,093559,Chow; Bennett,7,0,32,25
1658136847343,MATH 193A,A01,083224,Rotar; Vladimir,9,0,34,25
1658136847343,MATH 193A,A02,083225,Rotar; Vladimir,11,0,34,23
1658136847343,MATH 193A,A03,083781,Rotar; Vladimir,5,0,34,29
1658136847343,MATH 193A,A04,083782,Rotar; Vladimir,12,0,34,22
1658136847343,MATH 193A,A05,093482,Rotar; Vladimir,11,0,34,23
1658136853369,MATH 197,001,091859,McAuley; Julian John,9999,0,9999,0
1658136853369,MATH 197,002,095566,Kedlaya; Kiran S.,9997,0,9999,2
1658136853369,MATH 197,003,095567,Xiao; Ming,9999,0,9999,0
1658136853369,MATH 197,004,095571,Perols; Johan Lars,9998,0,9999,1
1658136860434,COGS 9,A01,083615,Shannon; Kyle Michael,11,0,75,64
1658136866462,COGS 11,A01,083617,Boyle; Mary E. T.,23,0,48,25
1658136872488,COGS 13,A01,083071,Bastos; Amalia Pinkusfeld,12,0,71,59
1658136878517,COGS 14A,A01,092681,Semenuks; Arturs,5,1,100,95
1658136884541,COGS 14B,A01,083073,Cheng; Tzu-Han,7,0,63,56
1658136890572,COGS 17,A01,092677,Semenuks; Arturs,7,0,81,74
1658136896597,COGS 100,A01,083619,Allen; Michael Gordon,17,0,70,53
1658136902623,COGS 101A,A01,083621,Davis; Joshua Daniel,9,0,68,59
1658136908652,COGS 101B,A01,091572,Allen; Michael Gordon,14,0,65,51
1658136914675,COGS 101C,A01,083625,Delgado; Tania,17,0,35,18
1658136920698,COGS 107A,A01,083627,Boyle; Mary E. T.,14,0,60,46
1658136926721,COGS 118A,A01,083075,Gupta; Anjum,21,0,76,55
1658136932776,CSE 3,A50,083646,Miranda; Gregory Joseph,24,0,50,26
1658136938800,CSE 8A,A50,083650,Miranda; Gregory Joseph,17,1,56,39
1658136944823,CSE 11,A01,083080,Cao; Yingjun,7,15,40,33
1658136950853,CSE 12,A01,083652,Krause-Levy; Sophia Louisa,30,1,120,90
1658136956877,CSE 15L,A01,083654,Morris; Justin Loren,9,0,50,41
1658136956877,CSE 15L,A02,083655,Morris; Justin Loren,11,0,50,39
1658136962906,CSE 20,A01,083657,Tran; Khoa Dang,39,0,80,41
1658136968933,CSE 21,A01,095574,Bach; Quang Tran,23,0,48,25
1658136974957,CSE 30,A01,083084,Eldon; John,8,0,80,72
1658136974957,CSE 30,B01,095061,Bhaskar; Nishant,9,0,50,41
1658136980983,CSE 100,A01,083659,Cao; Yingjun,5,4,70,65
1658136987013,CSE 134B,A01,083661,Powell; Thomas Allan,25,0,100,75
1658136993036,CSE 140,A01,083663,Gungor; Onat,17,0,85,68
1658136999061,CSE 140L,A01,083088,Eldon; John,23,0,100,77
1658137005085,CSE 175,A01,083665,Kumar; Rakesh,3,0,25,22
1658137011110,CSE 190,A00,092507,Dubnov; Shlomo,8,0,20,12
1658137017134,ECE 45,A01,083139,Congero; Spencer William,7,0,75,68
1658137023167,ECE 65,A50,083695,Saad; Andrew S,12,0,30,18
1658137023167,ECE 65,A51,095125,Saad; Andrew S,24,0,26,2
1658137029197,ECE 109,A01,091882,Touri; Behrouz,21,0,70,49
1658137035221,ECE 180,A00,083140,Abi Samra; Nicholas Camill,1,0,30,29
1658137035221,ECE 180,B00,083141,Abi Samra; Nicholas Camill,0,0,30,30
1658137041246,MATH 10A,A01,083735,Patchell; Gregory David,2,0,30,28
1658137041246,MATH 10A,A02,083736,Patchell; Gregory David,20,0,30,10
1658137041246,MATH 10A,A03,083737,Patchell; Gregory David,16,0,30,14
1658137047274,MATH 10B,A01,083207,Lim; Seonhee,9,0,34,25
1658137047274,MATH 10B,A02,083208,Lim; Seonhee,10,0,35,25
1658137047274,MATH 10B,A03,093472,Lim; Seonhee,7,0,34,27
1658137047274,MATH 10B,B01,083739,Sinha; Shubham,14,0,30,16
1658137053305,MATH 18,A01,083743,Cinel; Cameron Alexander,9,0,30,21
1658137053305,MATH 18,A02,083744,Cinel; Cameron Alexander,18,0,30,12
1658137053305,MATH 18,A03,083745,Cinel; Cameron Alexander,10,0,30,20
1658137053305,MATH 18,B01,083748,Rideout; David Porter,5,0,37,32
1658137053305,MATH 18,B02,083749,Rideout; David Porter,5,0,36,31
1658137053305,MATH 18,B03,083750,Rideout; David Porter,3,0,37,34
1658137053305,MATH 18,B04,083751,Rideout; David Porter,7,0,36,29
1658137053305,MATH 18,B05,093473,Rideout; David Porter,7,0,36,29
1658137053305,MATH 18,B06,093474,Rideout; David Porter,6,0,36,30
1658137059329,MATH 20A,A01,083754,Zheng; Zequn,14,0,40,26
1658137065352,MATH 20B,A01,083756,Briones; Jor-el Thomas Caparas,4,0,36,32
1658137065352,MATH 20B,A02,083757,Briones; Jor-el Thomas Caparas,1,0,36,35
1658137065352,MATH 20B,A03,093475,Briones; Jor-el Thomas Caparas,3,0,36,33
1658137071377,MATH 20C,A01,083760,Briones; Jor-el Thomas Caparas,1,0,35,34
1658137071377,MATH 20C,A02,083761,Briones; Jor-el Thomas Caparas,8,0,35,27
1658137071377,MATH 20C,A03,093476,Briones; Jor-el Thomas Caparas,0,1,36,36
1658137071377,MATH 20C,B01,083762,Bach; Quang Tran,1,0,30,29
1658137077401,MATH 20D,A01,083765,Tran; Brian Kha,5,0,30,25
1658137077401,MATH 20D,A02,083766,Tran; Brian Kha,5,0,30,25
1658137077401,MATH 20D,A03,083767,Tran; Brian Kha,6,0,30,24
1658137083431,MATH 20E,A01,083771,Ganguly; Soumya,12,0,32,20
1658137083431,MATH 20E,A02,083772,Ganguly; Soumya,7,0,32,25
1658137083431,MATH 20E,B01,083773,Ciotti; Benjamin,20,0,35,15
1658137083431,MATH 20E,B02,083774,Ciotti; Benjamin,18,0,35,17
1658137089462,MATH 103A,A01,083777,Greenfeld; Be'Eri,6,0,36,30
1658137089462,MATH 103A,A02,083778,Greenfeld; Be'Eri,5,0,36,31
1658137089462,MATH 103A,A03,093561,Greenfeld; Be'Eri,7,0,36,29
1658137089462,MATH 103A,B01,083779,Greenfeld; Be'Eri,8,0,36,28
1658137089462,MATH 103A,B02,083780,Greenfeld; Be'Eri,4,0,36,32
1658137089462,MATH 103A,B03,093562,Greenfeld; Be'Eri,3,0,36,33
1658137095491,MATH 105,A01,085443,Carter; Anne Toulson,15,0,35,20
1658137095491,MATH 105,A02,093477,Carter; Anne Toulson,20,0,35,15
1658137101516,MATH 109,A01,083213,Ganzberger; Geoffrey Michael,3,0,34,31
1658137101516,MATH 109,A02,083214,Ganzberger; Geoffrey Michael,4,0,34,30
1658137101516,MATH 109,A03,093478,Ganzberger; Geoffrey Michael,2,0,34,32
1658137101516,MATH 109,B01,083215,Ganzberger; Geoffrey Michael,3,0,32,29
1658137101516,MATH 109,B02,083216,Ganzberger; Geoffrey Michael,3,0,32,29
1658137101516,MATH 109,B03,093479,Ganzberger; Geoffrey Michael,8,0,32,24
1658137107540,MATH 142A,A01,083219,Chow; Bennett,7,0,32,25
1658137107540,MATH 142A,A02,083220,Chow; Bennett,10,0,32,22
1658137107540,MATH 142A,A03,093480,Chow; Bennett,9,0,32,23
1658137107540,MATH 142A,B03,093481,Chow; Bennett,8,0,32,24
1658137107540,MATH 142A,B04,093558,Chow; Bennett,14,0,32,18
1658137107540,MATH 142A,B05,093559,Chow; Bennett,7,0,32,25
1658137113565,MATH 193A,A01,083224,Rotar; Vladimir,9,0,34,25
1658137113565,MATH 193A,A02,083225,Rotar; Vladimir,11,0,34,23
1658137113565,MATH 193A,A03,083781,Rotar; Vladimir,5,0,34,29
1658137113565,MATH 193A,A04,083782,Rotar; Vladimir,12,0,34,22
1658137113565,MATH 193A,A05,093482,Rotar; Vladimir,11,0,34,23
1658137119589,MATH 197,001,091859,McAuley; Julian John,9999,0,9999,0
1658137119589,MATH 197,002,095566,Kedlaya; Kiran S.,9997,0,9999,2
1658137119589,MATH 197,003,095567,Xiao; Ming,9999,0,9999,0
1658137119589,MATH 197,004,095571,Perols; Johan Lars,9998,0,9999,1
1658137126673,COGS 9,A01,083615,Shannon; Kyle Michael,11,0,75,64
1658137132703,COGS 11,A01,083617,Boyle; Mary E. T.,23,0,48,25
1658137138730,COGS 13,A01,083071,Bastos; Amalia Pinkusfeld,12,0,71,59
1658137144754,COGS 14A,A01,092681,Semenuks; Arturs,5,1,100,95
1658137150781,COGS 14B,A01,083073,Cheng; Tzu-Han,7,0,63,56
1658137156808,COGS 17,A01,092677,Semenuks; Arturs,7,0,81,74
1658137162831,COGS 100,A01,083619,Allen; Michael Gordon,17,0,70,53
1658137168859,COGS 101A,A01,083621,Davis; Joshua Daniel,9,0,68,59
1658137174886,COGS 101B,A01,091572,Allen; Michael Gordon,14,0,65,51
1658137180908,COGS 101C,A01,083625,Delgado; Tania,17,0,35,18
1658137186929,COGS 107A,A01,083627,Boyle; Mary E. T.,14,0,60,46
1658137192953,COGS 118A,A01,083075,Gupta; Anjum,21,0,76,55
1658137198978,CSE 3,A50,083646,Miranda; Gregory Joseph,24,0,50,26
1658137205004,CSE 8A,A50,083650,Miranda; Gregory Joseph,17,1,56,39
1658137211027,CSE 11,A01,083080,Cao; Yingjun,7,15,40,33
1658137217055,CSE 12,A01,083652,Krause-Levy; Sophia Louisa,30,1,120,90
1658137223079,CSE 15L,A01,083654,Morris; Justin Loren,9,0,50,41
1658137223079,CSE 15L,A02,083655,Morris; Justin Loren,11,0,50,39
1658137229110,CSE 20,A01,083657,Tran; Khoa Dang,39,0,80,41
1658137235138,CSE 21,A01,095574,Bach; Quang Tran,23,0,48,25
1658137241168,CSE 30,A01,083084,Eldon; John,8,0,80,72
1658137241168,CSE 30,B01,095061,Bhaskar; Nishant,9,0,50,41
1658137247198,CSE 100,A01,083659,Cao; Yingjun,5,4,70,65
1658137253225,CSE 134B,A01,083661,Powell; Thomas Allan,25,0,100,75
1658137259253,CSE 140,A01,083663,Gungor; Onat,17,0,85,68
1658137265281,CSE 140L,A01,083088,Eldon; John,23,0,100,77
1658137271305,CSE 175,A01,083665,Kumar; Rakesh,3,0,25,22
1658137277330,CSE 190,A00,092507,Dubnov; Shlomo,8,0,20,12
1658137283359,ECE 45,A01,083139,Congero; Spencer William,7,0,75,68
1658137289401,ECE 65,A50,083695,Saad; Andrew S,12,0,30,18
1658137289401,ECE 65,A51,095125,Saad; Andrew S,24,0,26,2
1658137295426,ECE 109,A01,091882,Touri; Behrouz,21,0,70,49
1658137301451,ECE 180,A00,083140,Abi Samra; Nicholas Camill,1,0,30,29
1658137301451,ECE 180,B00,083141,Abi Samra; Nicholas Camill,0,0,30,30
1658137307557,MATH 10A,A01,083735,Patchell; Gregory David,2,0,30,28
1658137307557,MATH 10A,A02,083736,Patchell; Gregory David,20,0,30,10
1658137307557,MATH 10A,A03,083737,Patchell; Gregory David,16,0,30,14
1658137313583,MATH 10B,A01,083207,Lim; Seonhee,9,0,34,25
1658137313583,MATH 10B,A02,083208,Lim; Seonhee,10,0,35,25
1658137313583,MATH 10B,A03,093472,Lim; Seonhee,7,0,34,27
1658137313583,MATH 10B,B01,083739,Sinha; Shubham,14,0,30,16
1658137319617,MATH 18,A01,083743,Cinel; Cameron Alexander,9,0,30,21
1658137319617,MATH 18,A02,083744,Cinel; Cameron Alexander,18,0,30,12
1658137319617,MATH 18,A03,083745,Cinel; Cameron Alexander,10,0,30,20
1658137319617,MATH 18,B01,083748,Rideout; David Porter,5,0,37,32
1658137319617,MATH 18,B02,083749,Rideout; David Porter,5,0,36,31
1658137319617,MATH 18,B03,083750,Rideout; David Porter,3,0,37,34
1658137319617,MATH 18,B04,083751,Rideout; David Porter,7,0,36,29
1658137319617,MATH 18,B05,093473,Rideout; David Porter,7,0,36,29
1658137319617,MATH 18,B06,093474,Rideout; David Porter,6,0,36,30
1658137325640,MATH 20A,A01,083754,Zheng; Zequn,14,0,40,26
1658137331665,MATH 20B,A01,083756,Briones; Jor-el Thomas Caparas,4,0,36,32
1658137331665,MATH 20B,A02,083757,Briones; Jor-el Thomas Caparas,1,0,36,35
1658137331665,MATH 20B,A03,093475,Briones; Jor-el Thomas Caparas,3,0,36,33
1658137337689,MATH 20C,A01,083760,Briones; Jor-el Thomas Caparas,1,0,35,34
1658137337689,MATH 20C,A02,083761,Briones; Jor-el Thomas Caparas,8,0,35,27
1658137337689,MATH 20C,A03,093476,Briones; Jor-el Thomas Caparas,0,1,36,36
1658137337689,MATH 20C,B01,083762,Bach; Quang Tran,1,0,30,29
1658137343721,MATH 20D,A01,083765,Tran; Brian Kha,5,0,30,25
1658137343721,MATH 20D,A02,083766,Tran; Brian Kha,5,0,30,25
1658137343721,MATH 20D,A03,083767,Tran; Brian Kha,6,0,30,24
1658137349759,MATH 20E,A01,083771,Ganguly; Soumya,12,0,32,20
1658137349759,MATH 20E,A02,083772,Ganguly; Soumya,7,0,32,25
1658137349759,MATH 20E,B01,083773,Ciotti; Benjamin,20,0,35,15
1658137349759,MATH 20E,B02,083774,Ciotti; Benjamin,18,0,35,17
1658137355785,MATH 103A,A01,083777,Greenfeld; Be'Eri,6,0,36,30
1658137355785,MATH 103A,A02,083778,Greenfeld; Be'Eri,5,0,36,31
1658137355785,MATH 103A,A03,093561,Greenfeld; Be'Eri,7,0,36,29
1658137355785,MATH 103A,B01,083779,Greenfeld; Be'Eri,8,0,36,28
1658137355785,MATH 103A,B02,083780,Greenfeld; Be'Eri,4,0,36,32
1658137355785,MATH 103A,B03,093562,Greenfeld; Be'Eri,3,0,36,33
1658137361814,MATH 105,A01,085443,Carter; Anne Toulson,15,0,35,20
1658137361814,MATH 105,A02,093477,Carter; Anne Toulson,20,0,35,15
1658137367838,MATH 109,A01,083213,Ganzberger; Geoffrey Michael,3,0,34,31
1658137367838,MATH 109,A02,083214,Ganzberger; Geoffrey Michael,4,0,34,30
1658137367838,MATH 109,A03,093478,Ganzberger; Geoffrey Michael,2,0,34,32
1658137367838,MATH 109,B01,083215,Ganzberger; Geoffrey Michael,3,0,32,29
1658137367838,MATH 109,B02,083216,Ganzberger; Geoffrey Michael,3,0,32,29
1658137367838,MATH 109,B03,093479,Ganzberger; Geoffrey Michael,8,0,32,24
1658137373868,MATH 142A,A01,083219,Chow; Bennett,7,0,32,25
1658137373868,MATH 142A,A02,083220,Chow; Bennett,10,0,32,22
1658137373868,MATH 142A,A03,093480,Chow; Bennett,9,0,32,23
1658137373868,MATH 142A,B03,093481,Chow; Bennett,8,0,32,24
1658137373868,MATH 142A,B04,093558,Chow; Bennett,14,0,32,18
1658137373868,MATH 142A,B05,093559,Chow; Bennett,7,0,32,25
1658137379893,MATH 193A,A01,083224,Rotar; Vladimir,9,0,34,25
1658137379893,MATH 193A,A02,083225,Rotar; Vladimir,11,0,34,23
1658137379893,MATH 193A,A03,083781,Rotar; Vladimir,5,0,34,29
1658137379893,MATH 193A,A04,083782,Rotar; Vladimir,12,0,34,22
1658137379893,MATH 193A,A05,093482,Rotar; Vladimir,11,0,34,23
1658137385927,MATH 197,001,091859,McAuley; Julian John,9999,0,9999,0
1658137385927,MATH 197,002,095566,Kedlaya; Kiran S.,9997,0,9999,2
1658137385927,MATH 197,003,095567,Xiao; Ming,9999,0,9999,0
1658137385927,MATH 197,004,095571,Perols; Johan Lars,9998,0,9999,1
1658137392987,COGS 9,A01,083615,Shannon; Kyle Michael,11,0,75,64
1658137399011,COGS 11,A01,083617,Boyle; Mary E. T.,23,0,48,25
1658137405038,COGS 13,A01,083071,Bastos; Amalia Pinkusfeld,12,0,71,59
1658137411063,COGS 14A,A01,092681,Semenuks; Arturs,5,1,100,95
1658137417087,COGS 14B,A01,083073,Cheng; Tzu-Han,7,0,63,56
1658137423124,COGS 17,A01,092677,Semenuks; Arturs,7,0,81,74
1658137429151,COGS 100,A01,083619,Allen; Michael Gordon,17,0,70,53
1658137435175,COGS 101A,A01,083621,Davis; Joshua Daniel,9,0,68,59
1658137441205,COGS 101B,A01,091572,Allen; Michael Gordon,14,0,65,51
1658137447229,COGS 101C,A01,083625,Delgado; Tania,17,0,35,18
1658137453264,COGS 107A,A01,083627,Boyle; Mary E. T.,14,0,60,46
1658137459296,COGS 118A,A01,083075,Gupta; Anjum,21,0,76,55
1658137465328,CSE 3,A50,083646,Miranda; Gregory Joseph,24,0,50,26
1658137471355,CSE 8A,A50,083650,Miranda; Gregory Joseph,17,1,56,39
1658137477382,CSE 11,A01,083080,Cao; Yingjun,7,15,40,33
1658137483411,CSE 12,A01,083652,Krause-Levy; Sophia Louisa,30,1,120,90
1658137489439,CSE 15L,A01,083654,Morris; Justin Loren,9,0,50,41
1658137489439,CSE 15L,A02,083655,Morris; Justin Loren,11,0,50,39
1658137495462,CSE 20,A01,083657,Tran; Khoa Dang,39,0,80,41
1658137501493,CSE 21,A01,095574,Bach; Quang Tran,23,0,48,25
1658137507523,CSE 30,A01,083084,Eldon; John,8,0,80,72
1658137507523,CSE 30,B01,095061,Bhaskar; Nishant,9,0,50,41
1658137513547,CSE 100,A01,083659,Cao; Yingjun,5,4,70,65
1658137519574,CSE 134B,A01,083661,Powell; Thomas Allan,25,0,100,75
1658137525602,CSE 140,A01,083663,Gungor; Onat,17,0,85,68
1658137531625,CSE 140L,A01,083088,Eldon; John,23,0,100,77
1658137537649,CSE 175,A01,083665,Kumar; Rakesh,3,0,25,22
1658137543683,CSE 190,A00,092507,Dubnov; Shlomo,8,0,20,12
1658137549705,ECE 45,A01,083139,Congero; Spencer William,7,0,75,68
1658137555727,ECE 65,A50,083695,Saad; Andrew S,12,0,30,18
1658137555727,ECE 65,A51,095125,Saad; Andrew S,24,0,26,2
1658137561760,ECE 109,A01,091882,Touri; Behrouz,21,0,70,49
1658137567784,ECE 180,A00,083140,Abi Samra; Nicholas Camill,1,0,30,29
1658137567784,ECE 180,B00,083141,Abi Samra; Nicholas Camill,0,0,30,30
1658137573823,MATH 10A,A01,083735,Patchell; Gregory David,2,0,30,28
1658137573823,MATH 10A,A02,083736,Patchell; Gregory David,20,0,30,10
1658137573823,MATH 10A,A03,083737,Patchell; Gregory David,16,0,30,14
1658137579846,MATH 10B,A01,083207,Lim; Seonhee,9,0,34,25
1658137579846,MATH 10B,A02,083208,Lim; Seonhee,10,0,35,25
1658137579846,MATH 10B,A03,093472,Lim; Seonhee,7,0,34,27
1658137579846,MATH 10B,B01,083739,Sinha; Shubham,14,0,30,16
1658137585894,MATH 18,A01,083743,Cinel; Cameron Alexander,9,0,30,21
1658137585894,MATH 18,A02,083744,Cinel; Cameron Alexander,18,0,30,12
1658137585894,MATH 18,A03,083745,Cinel; Cameron Alexander,10,0,30,20
1658137585894,MATH 18,B01,083748,Rideout; David Porter,5,0,37,32
1658137585894,MATH 18,B02,083749,Rideout; David Porter,5,0,36,31
1658137585894,MATH 18,B03,083750,Rideout; David Porter,3,0,37,34
1658137585894,MATH 18,B04,083751,Rideout; David Porter,7,0,36,29
1658137585894,MATH 18,B05,093473,Rideout; David Porter,7,0,36,29
1658137585894,MATH 18,B06,093474,Rideout; David Porter,6,0,36,30
1658137591920,MATH 20A,A01,083754,Zheng; Zequn,14,0,40,26
1658137597945,MATH 20B,A01,083756,Briones; Jor-el Thomas Caparas,4,0,36,32
1658137597945,MATH 20B,A02,083757,Briones; Jor-el Thomas Caparas,1,0,36,35
1658137597945,MATH 20B,A03,093475,Briones; Jor-el Thomas Caparas,3,0,36,33
1658137604008,MATH 20C,A01,083760,Briones; Jor-el Thomas Caparas,1,0,35,34
1658137604008,MATH 20C,A02,083761,Briones; Jor-el Thomas Caparas,8,0,35,27
1658137604008,MATH 20C,A03,093476,Briones; Jor-el Thomas Caparas,0,1,36,36
1658137604008,MATH 20C,B01,083762,Bach; Quang Tran,1,0,30,29
1658137610042,MATH 20D,A01,083765,Tran; Brian Kha,5,0,30,25
1658137610042,MATH 20D,A02,083766,Tran; Brian Kha,5,0,30,25
1658137610042,MATH 20D,A03,083767,Tran; Brian Kha,6,0,30,24
1658137616071,MATH 20E,A01,083771,Ganguly; Soumya,12,0,32,20
1658137616071,MATH 20E,A02,083772,Ganguly; Soumya,7,0,32,25
1658137616071,MATH 20E,B01,083773,Ciotti; Benjamin,20,0,35,15
1658137616071,MATH 20E,B02,083774,Ciotti; Benjamin,18,0,35,17
1658137622121,MATH 103A,A01,083777,Greenfeld; Be'Eri,6,0,36,30
1658137622121,MATH 103A,A02,083778,Greenfeld; Be'Eri,5,0,36,31
1658137622121,MATH 103A,A03,093561,Greenfeld; Be'Eri,7,0,36,29
1658137622121,MATH 103A,B01,083779,Greenfeld; Be'Eri,8,0,36,28
1658137622121,MATH 103A,B02,083780,Greenfeld; Be'Eri,4,0,36,32
1658137622121,MATH 103A,B03,093562,Greenfeld; Be'Eri,3,0,36,33
1658137628149,MATH 105,A01,085443,Carter; Anne Toulson,15,0,35,20
1658137628149,MATH 105,A02,093477,Carter; Anne Toulson,20,0,35,15
1658137634176,MATH 109,A01,083213,Ganzberger; Geoffrey Michael,3,0,34,31
1658137634176,MATH 109,A02,083214,Ganzberger; Geoffrey Michael,4,0,34,30
1658137634176,MATH 109,A03,093478,Ganzberger; Geoffrey Michael,2,0,34,32
1658137634176,MATH 109,B01,083215,Ganzberger; Geoffrey Michael,3,0,32,29
1658137634176,MATH 109,B02,083216,Ganzberger; Geoffrey Michael,3,0,32,29
1658137634176,MATH 109,B03,093479,Ganzberger; Geoffrey Michael,8,0,32,24
1658137640220,MATH 142A,A01,083219,Chow; Bennett,7,0,32,25
1658137640220,MATH 142A,A02,083220,Chow; Bennett,10,0,32,22
1658137640220,MATH 142A,A03,093480,Chow; Bennett,9,0,32,23
1658137640220,MATH 142A,B03,093481,Chow; Bennett,8,0,32,24
1658137640220,MATH 142A,B04,093558,Chow; Bennett,14,0,32,18
1658137640220,MATH 142A,B05,093559,Chow; Bennett,7,0,32,25
1658137646245,MATH 193A,A01,083224,Rotar; Vladimir,9,0,34,25
1658137646245,MATH 193A,A02,083225,Rotar; Vladimir,11,0,34,23
1658137646245,MATH 193A,A03,083781,Rotar; Vladimir,5,0,34,29
1658137646245,MATH 193A,A04,083782,Rotar; Vladimir,12,0,34,22
1658137646245,MATH 193A,A05,093482,Rotar; Vladimir,11,0,34,23
1658137652273,MATH 197,001,091859,McAuley; Julian John,9999,0,9999,0
1658137652273,MATH 197,002,095566,Kedlaya; Kiran S.,9997,0,9999,2
1658137652273,MATH 197,003,095567,Xiao; Ming,9999,0,9999,0
1658137652273,MATH 197,004,095571,Perols; Johan Lars,9998,0,9999,1
1658137659335,COGS 9,A01,083615,Shannon; Kyle Michael,11,0,75,64
1658137665359,COGS 11,A01,083617,Boyle; Mary E. T.,23,0,48,25
1658137671386,COGS 13,A01,083071,Bastos; Amalia Pinkusfeld,12,0,71,59
1658137677414,COGS 14A,A01,092681,Semenuks; Arturs,5,1,100,95
1658137683451,COGS 14B,A01,083073,Cheng; Tzu-Han,7,0,63,56
1658137689474,COGS 17,A01,092677,Semenuks; Arturs,7,0,81,74
1658137695499,COGS 100,A01,083619,Allen; Michael Gordon,17,0,70,53
1658137701522,COGS 101A,A01,083621,Davis; Joshua Daniel,9,0,68,59
1658137707546,COGS 101B,A01,091572,Allen; Michael Gordon,14,0,65,51
1658137713574,COGS 101C,A01,083625,Delgado; Tania,17,0,35,18
1658137719597,COGS 107A,A01,083627,Boyle; Mary E. T.,14,0,60,46
1658137725622,COGS 118A,A01,083075,Gupta; Anjum,21,0,76,55
1658137731651,CSE 3,A50,083646,Miranda; Gregory Joseph,24,0,50,26
1658137737674,CSE 8A,A50,083650,Miranda; Gregory Joseph,17,1,56,39
1658137743698,CSE 11,A01,083080,Cao; Yingjun,7,15,40,33
1658137749722,CSE 12,A01,083652,Krause-Levy; Sophia Louisa,30,1,120,90
1658137755755,CSE 15L,A01,083654,Morris; Justin Loren,9,0,50,41
1658137755755,CSE 15L,A02,083655,Morris; Justin Loren,11,0,50,39
1658137761778,CSE 20,A01,083657,Tran; Khoa Dang,39,0,80,41
1658137767805,CSE 21,A01,095574,Bach; Quang Tran,23,0,48,25
1658137773833,CSE 30,A01,083084,Eldon; John,8,0,80,72
1658137773833,CSE 30,B01,095061,Bhaskar; Nishant,9,0,50,41
1658137779859,CSE 100,A01,083659,Cao; Yingjun,5,4,70,65
1658137785885,CSE 134B,A01,083661,Powell; Thomas Allan,25,0,100,75
1658137791908,CSE 140,A01,083663,Gungor; Onat,17,0,85,68
1658137797936,CSE 140L,A01,083088,Eldon; John,23,0,100,77
1658137803962,CSE 175,A01,083665,Kumar; Rakesh,3,0,25,22
1658137809985,CSE 190,A00,092507,Dubnov; Shlomo,8,0,20,12
1658137816009,ECE 45,A01,083139,Congero; Spencer William,7,0,75,68
1658137822044,ECE 65,A50,083695,Saad; Andrew S,12,0,30,18
1658137822044,ECE 65,A51,095125,Saad; Andrew S,24,0,26,2
1658137828069,ECE 109,A01,091882,Touri; Behrouz,21,0,70,49
1658137834094,ECE 180,A00,083140,Abi Samra; Nicholas Camill,1,0,30,29
1658137834094,ECE 180,B00,083141,Abi Samra; Nicholas Camill,0,0,30,30
1658137840122,MATH 10A,A01,083735,Patchell; Gregory David,2,0,30,28
1658137840122,MATH 10A,A02,083736,Patchell; Gregory David,20,0,30,10
1658137840122,MATH 10A,A03,083737,Patchell; Gregory David,16,0,30,14
1658137846147,MATH 10B,A01,083207,Lim; Seonhee,9,0,34,25
1658137846147,MATH 10B,A02,083208,Lim; Seonhee,10,0,35,25
1658137846147,MATH 10B,A03,093472,Lim; Seonhee,7,0,34,27
1658137846147,MATH 10B,B01,083739,Sinha; Shubham,14,0,30,16
1658137852187,MATH 18,A01,083743,Cinel; Cameron Alexander,9,0,30,21
1658137852187,MATH 18,A02,083744,Cinel; Cameron Alexander,18,0,30,12
1658137852187,MATH 18,A03,083745,Cinel; Cameron Alexander,10,0,30,20
1658137852187,MATH 18,B01,083748,Rideout; David Porter,5,0,37,32
1658137852187,MATH 18,B02,083749,Rideout; David Porter,5,0,36,31
1658137852187,MATH 18,B03,083750,Rideout; David Porter,3,0,37,34
1658137852187,MATH 18,B04,083751,Rideout; David Porter,7,0,36,29
1658137852187,MATH 18,B05,093473,Rideout; David Porter,7,0,36,29
1658137852187,MATH 18,B06,093474,Rideout; David Porter,6,0,36,30
1658137858215,MATH 20A,A01,083754,Zheng; Zequn,14,0,40,26
1658137864239,MATH 20B,A01,083756,Briones; Jor-el Thomas Caparas,4,0,36,32
1658137864239,MATH 20B,A02,083757,Briones; Jor-el Thomas Caparas,1,0,36,35
1658137864239,MATH 20B,A03,093475,Briones; Jor-el Thomas Caparas,3,0,36,33
1658137870273,MATH 20C,A01,083760,Briones; Jor-el Thomas Caparas,1,0,35,34
1658137870273,MATH 20C,A02,083761,Briones; Jor-el Thomas Caparas,8,0,35,27
1658137870273,MATH 20C,A03,093476,Briones; Jor-el Thomas Caparas,0,1,36,36
1658137870273,MATH 20C,B01,083762,Bach; Quang Tran,1,0,30,29
1658137876299,MATH 20D,A01,083765,Tran; Brian Kha,5,0,30,25
1658137876299,MATH 20D,A02,083766,Tran; Brian Kha,5,0,30,25
1658137876299,MATH 20D,A03,083767,Tran; Brian Kha,6,0,30,24
1658137882323,MATH 20E,A01,083771,Ganguly; Soumya,12,0,32,20
1658137882323,MATH 20E,A02,083772,Ganguly; Soumya,7,0,32,25
1658137882323,MATH 20E,B01,083773,Ciotti; Benjamin,20,0,35,15
1658137882323,MATH 20E,B02,083774,Ciotti; Benjamin,18,0,35,17
1658137888348,MATH 103A,A01,083777,Greenfeld; Be'Eri,6,0,36,30
1658137888348,MATH 103A,A02,083778,Greenfeld; Be'Eri,5,0,36,31
1658137888348,MATH 103A,A03,093561,Greenfeld; Be'Eri,7,0,36,29
1658137888348,MATH 103A,B01,083779,Greenfeld; Be'Eri,8,0,36,28
1658137888348,MATH 103A,B02,083780,Greenfeld; Be'Eri,4,0,36,32
1658137888348,MATH 103A,B03,093562,Greenfeld; Be'Eri,3,0,36,33
1658137894372,MATH 105,A01,085443,Carter; Anne Toulson,15,0,35,20
1658137894372,MATH 105,A02,093477,Carter; Anne Toulson,20,0,35,15
1658137900402,MATH 109,A01,083213,Ganzberger; Geoffrey Michael,3,0,34,31
1658137900402,MATH 109,A02,083214,Ganzberger; Geoffrey Michael,4,0,34,30
1658137900402,MATH 109,A03,093478,Ganzberger; Geoffrey Michael,2,0,34,32
1658137900402,MATH 109,B01,083215,Ganzberger; Geoffrey Michael,3,0,32,29
1658137900402,MATH 109,B02,083216,Ganzberger; Geoffrey Michael,3,0,32,29
1658137900402,MATH 109,B03,093479,Ganzberger; Geoffrey Michael,8,0,32,24
1658137906498,MATH 142A,A01,083219,Chow; Bennett,7,0,32,25
1658137906498,MATH 142A,A02,083220,Chow; Bennett,10,0,32,22
1658137906498,MATH 142A,A03,093480,Chow; Bennett,9,0,32,23
1658137906498,MATH 142A,B03,093481,Chow; Bennett,8,0,32,24
1658137906498,MATH 142A,B04,093558,Chow; Bennett,14,0,32,18
1658137906498,MATH 142A,B05,093559,Chow; Bennett,7,0,32,25
1658137912522,MATH 193A,A01,083224,Rotar; Vladimir,9,0,34,25
1658137912522,MATH 193A,A02,083225,Rotar; Vladimir,11,0,34,23
1658137912522,MATH 193A,A03,083781,Rotar; Vladimir,5,0,34,29
1658137912522,MATH 193A,A04,083782,Rotar; Vladimir,12,0,34,22
1658137912522,MATH 193A,A05,093482,Rotar; Vladimir,11,0,34,23
1658137918550,MATH 197,001,091859,McAuley; Julian John,9999,0,9999,0
1658137918550,MATH 197,002,095566,Kedlaya; Kiran S.,9997,0,9999,2
1658137918550,MATH 197,003,095567,Xiao; Ming,9999,0,9999,0
1658137918550,MATH 197,004,095571,Perols; Johan Lars,9998,0,9999,1
1658137925620,COGS 9,A01,083615,Shannon; Kyle Michael,11,0,75,64
1658137931647,COGS 11,A01,083617,Boyle; Mary E. T.,23,0,48,25
1658137937675,COGS 13,A01,083071,Bastos; Amalia Pinkusfeld,12,0,71,59
1658137943698,COGS 14A,A01,092681,Semenuks; Arturs,5,1,100,95
1658137949725,COGS 14B,A01,083073,Cheng; Tzu-Han,7,0,63,56
1658137955750,COGS 17,A01,092677,Semenuks; Arturs,7,0,81,74
1658137961773,COGS 100,A01,083619,Allen; Michael Gordon,17,0,70,53
1658137967806,COGS 101A,A01,083621,Davis; Joshua Daniel,9,0,68,59
1658137973830,COGS 101B,A01,091572,Allen; Michael Gordon,14,0,65,51
1658137979856,COGS 101C,A01,083625,Delgado; Tania,17,0,35,18
1658137985879,COGS 107A,A01,083627,Boyle; Mary E. T.,14,0,60,46
1658137991907,COGS 118A,A01,083075,Gupta; Anjum,21,0,76,55
1658137997930,CSE 3,A50,083646,Miranda; Gregory Joseph,24,0,50,26
1658138003959,CSE 8A,A50,083650,Miranda; Gregory Joseph,17,1,56,39
1658138009985,CSE 11,A01,083080,Cao; Yingjun,7,15,40,33
1658138016013,CSE 12,A01,083652,Krause-Levy; Sophia Louisa,30,1,120,90
1658138022038,CSE 15L,A01,083654,Morris; Justin Loren,9,0,50,41
1658138022038,CSE 15L,A02,083655,Morris; Justin Loren,11,0,50,39
1658138028060,CSE 20,A01,083657,Tran; Khoa Dang,39,0,80,41
1658138034083,CSE 21,A01,095574,Bach; Quang Tran,23,0,48,25
1658138040108,CSE 30,A01,083084,Eldon; John,8,0,80,72
1658138040108,CSE 30,B01,095061,Bhaskar; Nishant,9,0,50,41
1658138046132,CSE 100,A01,083659,Cao; Yingjun,5,4,70,65
1658138052161,CSE 134B,A01,083661,Powell; Thomas Allan,25,0,100,75
1658138058184,CSE 140,A01,083663,Gungor; Onat,17,0,85,68
1658138064212,CSE 140L,A01,083088,Eldon; John,23,0,100,77
1658138070236,CSE 175,A01,083665,Kumar; Rakesh,3,0,25,22
1658138076263,CSE 190,A00,092507,Dubnov; Shlomo,8,0,20,12
1658138082287,ECE 45,A01,083139,Congero; Spencer William,7,0,75,68
1658138088315,ECE 65,A50,083695,Saad; Andrew S,12,0,30,18
1658138088315,ECE 65,A51,095125,Saad; Andrew S,24,0,26,2
1658138094338,ECE 109,A01,091882,Touri; Behrouz,21,0,70,49
1658138100361,ECE 180,A00,083140,Abi Samra; Nicholas Camill,1,0,30,29
1658138100361,ECE 180,B00,083141,Abi Samra; Nicholas Camill,0,0,30,30
1658138106386,MATH 10A,A01,083735,Patchell; Gregory David,2,0,30,28
1658138106386,MATH 10A,A02,083736,Patchell; Gregory David,20,0,30,10
1658138106386,MATH 10A,A03,083737,Patchell; Gregory David,16,0,30,14
1658138112415,MATH 10B,A01,083207,Lim; Seonhee,9,0,34,25
1658138112415,MATH 10B,A02,083208,Lim; Seonhee,10,0,35,25
1658138112415,MATH 10B,A03,093472,Lim; Seonhee,7,0,34,27
1658138112415,MATH 10B,B01,083739,Sinha; Shubham,14,0,30,16
1658138118451,MATH 18,A01,083743,Cinel; Cameron Alexander,9,0,30,21
1658138118451,MATH 18,A02,083744,Cinel; Cameron Alexander,18,0,30,12
1658138118451,MATH 18,A03,083745,Cinel; Cameron Alexander,10,0,30,20
1658138118451,MATH 18,B01,083748,Rideout; David Porter,5,0,37,32
1658138118451,MATH 18,B02,083749,Rideout; David Porter,5,0,36,31
1658138118451,MATH 18,B03,083750,Rideout; David Porter,3,0,37,34
1658138118451,MATH 18,B04,083751,Rideout; David Porter,7,0,36,29
1658138118451,MATH 18,B05,093473,Rideout; David Porter,7,0,36,29
1658138118451,MATH 18,B06,093474,Rideout; David Porter,6,0,36,30
1658138124480,MATH 20A,A01,083754,Zheng; Zequn,14,0,40,26
1658138130504,MATH 20B,A01,083756,Briones; Jor-el Thomas Caparas,4,0,36,32
1658138130504,MATH 20B,A02,083757,Briones; Jor-el Thomas Caparas,1,0,36,35
1658138130504,MATH 20B,A03,093475,Briones; Jor-el Thomas Caparas,3,0,36,33
1658138136530,MATH 20C,A01,083760,Briones; Jor-el Thomas Caparas,1,0,35,34
1658138136530,MATH 20C,A02,083761,Briones; Jor-el Thomas Caparas,8,0,35,27
1658138136530,MATH 20C,A03,093476,Briones; Jor-el Thomas Caparas,0,1,36,36
1658138136530,MATH 20C,B01,083762,Bach; Quang Tran,1,0,30,29
1658138142554,MATH 20D,A01,083765,Tran; Brian Kha,5,0,30,25
1658138142554,MATH 20D,A02,083766,Tran; Brian Kha,5,0,30,25
1658138142554,MATH 20D,A03,083767,Tran; Brian Kha,6,0,30,24
1658138148578,MATH 20E,A01,083771,Ganguly; Soumya,12,0,32,20
1658138148578,MATH 20E,A02,083772,Ganguly; Soumya,7,0,32,25
1658138148578,MATH 20E,B01,083773,Ciotti; Benjamin,20,0,35,15
1658138148578,MATH 20E,B02,083774,Ciotti; Benjamin,18,0,35,17
1658138154604,MATH 103A,A01,083777,Greenfeld; Be'Eri,6,0,36,30
1658138154604,MATH 103A,A02,083778,Greenfeld; Be'Eri,5,0,36,31
1658138154604,MATH 103A,A03,093561,Greenfeld; Be'Eri,7,0,36,29
1658138154604,MATH 103A,B01,083779,Greenfeld; Be'Eri,8,0,36,28
1658138154604,MATH 103A,B02,083780,Greenfeld; Be'Eri,4,0,36,32
1658138154604,MATH 103A,B03,093562,Greenfeld; Be'Eri,3,0,36,33
1658138160640,MATH 105,A01,085443,Carter; Anne Toulson,15,0,35,20
1658138160640,MATH 105,A02,093477,Carter; Anne Toulson,20,0,35,15
1658138166666,MATH 109,A01,083213,Ganzberger; Geoffrey Michael,3,0,34,31
1658138166666,MATH 109,A02,083214,Ganzberger; Geoffrey Michael,4,0,34,30
1658138166666,MATH 109,A03,093478,Ganzberger; Geoffrey Michael,2,0,34,32
1658138166666,MATH 109,B01,083215,Ganzberger; Geoffrey Michael,3,0,32,29
1658138166666,MATH 109,B02,083216,Ganzberger; Geoffrey Michael,3,0,32,29
1658138166666,MATH 109,B03,093479,Ganzberger; Geoffrey Michael,8,0,32,24
1658138172705,MATH 142A,A01,083219,Chow; Bennett,7,0,32,25
1658138172705,MATH 142A,A02,083220,Chow; Bennett,10,0,32,22
1658138172705,MATH 142A,A03,093480,Chow; Bennett,9,0,32,23
1658138172705,MATH 142A,B03,093481,Chow; Bennett,8,0,32,24
1658138172705,MATH 142A,B04,093558,Chow; Bennett,14,0,32,18
1658138172705,MATH 142A,B05,093559,Chow; Bennett,7,0,32,25
1658138178728,MATH 193A,A01,083224,Rotar; Vladimir,9,0,34,25
1658138178728,MATH 193A,A02,083225,Rotar; Vladimir,11,0,34,23
1658138178728,MATH 193A,A03,083781,Rotar; Vladimir,5,0,34,29
1658138178728,MATH 193A,A04,083782,Rotar; Vladimir,12,0,34,22
1658138178728,MATH 193A,A05,093482,Rotar; Vladimir,11,0,34,23
1658138184756,MATH 197,001,091859,McAuley; Julian John,9999,0,9999,0
1658138184756,MATH 197,002,095566,Kedlaya; Kiran S.,9997,0,9999,2
1658138184756,MATH 197,003,095567,Xiao; Ming,9999,0,9999,0
1658138184756,MATH 197,004,095571,Perols; Johan Lars,9998,0,9999,1
1658138191820,COGS 9,A01,083615,Shannon; Kyle Michael,11,0,75,64
1658138197846,COGS 11,A01,083617,Boyle; Mary E. T.,23,0,48,25
1658138203869,COGS 13,A01,083071,Bastos; Amalia Pinkusfeld,12,0,71,59
1658138209893,COGS 14A,A01,092681,Semenuks; Arturs,5,1,100,95
1658138215937,COGS 14B,A01,083073,Cheng; Tzu-Han,7,0,63,56
1658138221964,COGS 17,A01,092677,Semenuks; Arturs,7,0,81,74
1658138227995,COGS 100,A01,083619,Allen; Michael Gordon,17,0,70,53
1658138234022,COGS 101A,A01,083621,Davis; Joshua Daniel,9,0,68,59
1658138240045,COGS 101B,A01,091572,Allen; Michael Gordon,14,0,65,51
1658138246069,COGS 101C,A01,083625,Delgado; Tania,17,0,35,18
1658138252097,COGS 107A,A01,083627,Boyle; Mary E. T.,14,0,60,46
1658138258120,COGS 118A,A01,083075,Gupta; Anjum,21,0,76,55
1658138264149,CSE 3,A50,083646,Miranda; Gregory Joseph,24,0,50,26
1658138270178,CSE 8A,A50,083650,Miranda; Gregory Joseph,17,1,56,39
1658138276205,CSE 11,A01,083080,Cao; Yingjun,7,15,40,33
1658138282231,CSE 12,A01,083652,Krause-Levy; Sophia Louisa,30,1,120,90
1658138288254,CSE 15L,A01,083654,Morris; Justin Loren,9,0,50,41
1658138288254,CSE 15L,A02,083655,Morris; Justin Loren,11,0,50,39
1658138294277,CSE 20,A01,083657,Tran; Khoa Dang,39,0,80,41
1658138300301,CSE 21,A01,095574,Bach; Quang Tran,23,0,48,25
1658138306329,CSE 30,A01,083084,Eldon; John,8,0,80,72
1658138306329,CSE 30,B01,095061,Bhaskar; Nishant,9,0,50,41
1658138312352,CSE 100,A01,083659,Cao; Yingjun,5,4,70,65
1658138318384,CSE 134B,A01,083661,Powell; Thomas Allan,25,0,100,75
1658138324411,CSE 140,A01,083663,Gungor; Onat,17,0,85,68
1658138330435,CSE 140L,A01,083088,Eldon; John,23,0,100,77
1658138336475,CSE 175,A01,083665,Kumar; Rakesh,3,0,25,22
1658138342499,CSE 190,A00,092507,Dubnov; Shlomo,8,0,20,12
1658138348523,ECE 45,A01,083139,Congero; Spencer William,7,0,75,68
1658138354551,ECE 65,A50,083695,Saad; Andrew S,12,0,30,18
1658138354551,ECE 65,A51,095125,Saad; Andrew S,24,0,26,2
1658138360577,ECE 109,A01,091882,Touri; Behrouz,21,0,70,49
1658138366601,ECE 180,A00,083140,Abi Samra; Nicholas Camill,1,0,30,29
1658138366601,ECE 180,B00,083141,Abi Samra; Nicholas Camill,0,0,30,30
1658138372629,MATH 10A,A01,083735,Patchell; Gregory David,2,0,30,28
1658138372629,MATH 10A,A02,083736,Patchell; Gregory David,20,0,30,10
1658138372629,MATH 10A,A03,083737,Patchell; Gregory David,16,0,30,14
1658138378658,MATH 10B,A01,083207,Lim; Seonhee,9,0,34,25
1658138378658,MATH 10B,A02,083208,Lim; Seonhee,10,0,35,25
1658138378658,MATH 10B,A03,093472,Lim; Seonhee,7,0,34,27
1658138378658,MATH 10B,B01,083739,Sinha; Shubham,14,0,30,16
1658138384683,MATH 18,A01,083743,Cinel; Cameron Alexander,9,0,30,21
1658138384683,MATH 18,A02,083744,Cinel; Cameron Alexander,18,0,30,12
1658138384683,MATH 18,A03,083745,Cinel; Cameron Alexander,10,0,30,20
1658138384683,MATH 18,B01,083748,Rideout; David Porter,5,0,37,32
1658138384683,MATH 18,B02,083749,Rideout; David Porter,5,0,36,31
1658138384683,MATH 18,B03,083750,Rideout; David Porter,3,0,37,34
1658138384683,MATH 18,B04,083751,Rideout; David Porter,7,0,36,29
1658138384683,MATH 18,B05,093473,Rideout; David Porter,7,0,36,29
1658138384683,MATH 18,B06,093474,Rideout; David Porter,6,0,36,30
1658138390714,MATH 20A,A01,083754,Zheng; Zequn,14,0,40,26
1658138396740,MATH 20B,A01,083756,Briones; Jor-el Thomas Caparas,4,0,36,32
1658138396740,MATH 20B,A02,083757,Briones; Jor-el Thomas Caparas,1,0,36,35
1658138396740,MATH 20B,A03,093475,Briones; Jor-el Thomas Caparas,3,0,36,33
1658138402766,MATH 20C,A01,083760,Briones; Jor-el Thomas Caparas,1,0,35,34
1658138402766,MATH 20C,A02,083761,Briones; Jor-el Thomas Caparas,8,0,35,27
1658138402766,MATH 20C,A03,093476,Briones; Jor-el Thomas Caparas,0,1,36,36
1658138402766,MATH 20C,B01,083762,Bach; Quang Tran,1,0,30,29
1658138408793,MATH 20D,A01,083765,Tran; Brian Kha,5,0,30,25
1658138408793,MATH 20D,A02,083766,Tran; Brian Kha,5,0,30,25
1658138408793,MATH 20D,A03,083767,Tran; Brian Kha,6,0,30,24
1658138414819,MATH 20E,A01,083771,Ganguly; Soumya,12,0,32,20
1658138414819,MATH 20E,A02,083772,Ganguly; Soumya,7,0,32,25
1658138414819,MATH 20E,B01,083773,Ciotti; Benjamin,20,0,35,15
1658138414819,MATH 20E,B02,083774,Ciotti; Benjamin,18,0,35,17
1658138420842,MATH 103A,A01,083777,Greenfeld; Be'Eri,6,0,36,30
1658138420842,MATH 103A,A02,083778,Greenfeld; Be'Eri,5,0,36,31
1658138420842,MATH 103A,A03,093561,Greenfeld; Be'Eri,7,0,36,29
1658138420842,MATH 103A,B01,083779,Greenfeld; Be'Eri,8,0,36,28
1658138420842,MATH 103A,B02,083780,Greenfeld; Be'Eri,4,0,36,32
1658138420842,MATH 103A,B03,093562,Greenfeld; Be'Eri,3,0,36,33
1658138426867,MATH 105,A01,085443,Carter; Anne Toulson,15,0,35,20
1658138426867,MATH 105,A02,093477,Carter; Anne Toulson,20,0,35,15
1658138432896,MATH 109,A01,083213,Ganzberger; Geoffrey Michael,3,0,34,31
1658138432896,MATH 109,A02,083214,Ganzberger; Geoffrey Michael,4,0,34,30
1658138432896,MATH 109,A03,093478,Ganzberger; Geoffrey Michael,2,0,34,32
1658138432896,MATH 109,B01,083215,Ganzberger; Geoffrey Michael,3,0,32,29
1658138432896,MATH 109,B02,083216,Ganzberger; Geoffrey Michael,3,0,32,29
1658138432896,MATH 109,B03,093479,Ganzberger; Geoffrey Michael,8,0,32,24
1658138438922,MATH 142A,A01,083219,Chow; Bennett,7,0,32,25
1658138438922,MATH 142A,A02,083220,Chow; Bennett,10,0,32,22
1658138438922,MATH 142A,A03,093480,Chow; Bennett,9,0,32,23
1658138438922,MATH 142A,B03,093481,Chow; Bennett,8,0,32,24
1658138438922,MATH 142A,B04,093558,Chow; Bennett,14,0,32,18
1658138438922,MATH 142A,B05,093559,Chow; Bennett,7,0,32,25
1658138444946,MATH 193A,A01,083224,Rotar; Vladimir,9,0,34,25
1658138444946,MATH 193A,A02,083225,Rotar; Vladimir,11,0,34,23
1658138444946,MATH 193A,A03,083781,Rotar; Vladimir,5,0,34,29
1658138444946,MATH 193A,A04,083782,Rotar; Vladimir,12,0,34,22
1658138444946,MATH 193A,A05,093482,Rotar; Vladimir,11,0,34,23
1658138450974,MATH 197,001,091859,McAuley; Julian John,9999,0,9999,0
1658138450974,MATH 197,002,095566,Kedlaya; Kiran S.,9997,0,9999,2
1658138450974,MATH 197,003,095567,Xiao; Ming,9999,0,9999,0
1658138450974,MATH 197,004,095571,Perols; Johan Lars,9998,0,9999,1
1658138458029,COGS 9,A01,083615,Shannon; Kyle Michael,11,0,75,64
1658138464058,COGS 11,A01,083617,Boyle; Mary E. T.,23,0,48,25
1658138470089,COGS 13,A01,083071,Bastos; Amalia Pinkusfeld,12,0,71,59
1658138476114,COGS 14A,A01,092681,Semenuks; Arturs,5,1,100,95
1658138482141,COGS 14B,A01,083073,Cheng; Tzu-Han,7,0,63,56
1658138488169,COGS 17,A01,092677,Semenuks; Arturs,7,0,81,74
1658138494202,COGS 100,A01,083619,Allen; Michael Gordon,17,0,70,53
1658138500297,COGS 101A,A01,083621,Davis; Joshua Daniel,9,0,68,59
1658138506324,COGS 101B,A01,091572,Allen; Michael Gordon,14,0,65,51
1658138512348,COGS 101C,A01,083625,Delgado; Tania,17,0,35,18
1658138518375,COGS 107A,A01,083627,Boyle; Mary E. T.,14,0,60,46
1658138524401,COGS 118A,A01,083075,Gupta; Anjum,21,0,76,55
1658138530430,CSE 3,A50,083646,Miranda; Gregory Joseph,24,0,50,26
1658138536454,CSE 8A,A50,083650,Miranda; Gregory Joseph,17,1,56,39
1658138542480,CSE 11,A01,083080,Cao; Yingjun,7,15,40,33
1658138548506,CSE 12,A01,083652,Krause-Levy; Sophia Louisa,30,1,120,90
1658138554533,CSE 15L,A01,083654,Morris; Justin Loren,9,0,50,41
1658138554533,CSE 15L,A02,083655,Morris; Justin Loren,11,0,50,39
1658138560563,CSE 20,A01,083657,Tran; Khoa Dang,39,0,80,41
1658138566588,CSE 21,A01,095574,Bach; Quang Tran,23,0,48,25
1658138572613,CSE 30,A01,083084,Eldon; John,8,0,80,72
1658138572613,CSE 30,B01,095061,Bhaskar; Nishant,9,0,50,41
1658138578636,CSE 100,A01,083659,Cao; Yingjun,5,4,70,65
1658138584658,CSE 134B,A01,083661,Powell; Thomas Allan,25,0,100,75
1658138590681,CSE 140,A01,083663,Gungor; Onat,17,0,85,68
1658138596702,CSE 140L,A01,083088,Eldon; John,23,0,100,77
1658138602727,CSE 175,A01,083665,Kumar; Rakesh,3,0,25,22
1658138608751,CSE 190,A00,092507,Dubnov; Shlomo,8,0,20,12
1658138614780,ECE 45,A01,083139,Congero; Spencer William,7,0,75,68
1658138620819,ECE 65,A50,083695,Saad; Andrew S,12,0,30,18
1658138620819,ECE 65,A51,095125,Saad; Andrew S,24,0,26,2
1658138626840,ECE 109,A01,091882,Touri; Behrouz,21,0,70,49
1658138632864,ECE 180,A00,083140,Abi Samra; Nicholas Camill,1,0,30,29
1658138632864,ECE 180,B00,083141,Abi Samra; Nicholas Camill,0,0,30,30
1658138638892,MATH 10A,A01,083735,Patchell; Gregory David,2,0,30,28
1658138638892,MATH 10A,A02,083736,Patchell; Gregory David,20,0,30,10
1658138638892,MATH 10A,A03,083737,Patchell; Gregory David,16,0,30,14
1658138644930,MATH 10B,A01,083207,Lim; Seonhee,9,0,34,25
1658138644930,MATH 10B,A02,083208,Lim; Seonhee,10,0,35,25
1658138644930,MATH 10B,A03,093472,Lim; Seonhee,7,0,34,27
1658138644930,MATH 10B,B01,083739,Sinha; Shubham,14,0,30,16
1658138650955,MATH 18,A01,083743,Cinel; Cameron Alexander,9,0,30,21
1658138650955,MATH 18,A02,083744,Cinel; Cameron Alexander,18,0,30,12
1658138650955,MATH 18,A03,083745,Cinel; Cameron Alexander,10,0,30,20
1658138650955,MATH 18,B01,083748,Rideout; David Porter,5,0,37,32
1658138650955,MATH 18,B02,083749,Rideout; David Porter,5,0,36,31
1658138650955,MATH 18,B03,083750,Rideout; David Porter,3,0,37,34
1658138650955,MATH 18,B04,083751,Rideout; David Porter,7,0,36,29
1658138650955,MATH 18,B05,093473,Rideout; David Porter,7,0,36,29
1658138650955,MATH 18,B06,093474,Rideout; David Porter,6,0,36,30
1658138656978,MATH 20A,A01,083754,Zheng; Zequn,14,0,40,26
1658138663005,MATH 20B,A01,083756,Briones; Jor-el Thomas Caparas,4,0,36,32
1658138663005,MATH 20B,A02,083757,Briones; Jor-el Thomas Caparas,1,0,36,35
1658138663005,MATH 20B,A03,093475,Briones; Jor-el Thomas Caparas,3,0,36,33
1658138669033,MATH 20C,A01,083760,Briones; Jor-el Thomas Caparas,1,0,35,34
1658138669033,MATH 20C,A02,083761,Briones; Jor-el Thomas Caparas,8,0,35,27
1658138669033,MATH 20C,A03,093476,Briones; Jor-el Thomas Caparas,0,1,36,36
1658138669033,MATH 20C,B01,083762,Bach; Quang Tran,1,0,30,29
1658138675063,MATH 20D,A01,083765,Tran; Brian Kha,5,0,30,25
1658138675063,MATH 20D,A02,083766,Tran; Brian Kha,5,0,30,25
1658138675063,MATH 20D,A03,083767,Tran; Brian Kha,6,0,30,24
1658138681094,MATH 20E,A01,083771,Ganguly; Soumya,12,0,32,20
1658138681094,MATH 20E,A02,083772,Ganguly; Soumya,7,0,32,25
1658138681094,MATH 20E,B01,083773,Ciotti; Benjamin,20,0,35,15
1658138681094,MATH 20E,B02,083774,Ciotti; Benjamin,18,0,35,17
1658138687118,MATH 103A,A01,083777,Greenfeld; Be'Eri,6,0,36,30
1658138687118,MATH 103A,A02,083778,Greenfeld; Be'Eri,5,0,36,31
1658138687118,MATH 103A,A03,093561,Greenfeld; Be'Eri,7,0,36,29
1658138687118,MATH 103A,B01,083779,Greenfeld; Be'Eri,8,0,36,28
1658138687118,MATH 103A,B02,083780,Greenfeld; Be'Eri,4,0,36,32
1658138687118,MATH 103A,B03,093562,Greenfeld; Be'Eri,3,0,36,33
1658138693154,MATH 105,A01,085443,Carter; Anne Toulson,15,0,35,20
1658138693154,MATH 105,A02,093477,Carter; Anne Toulson,20,0,35,15
1658138699190,MATH 109,A01,083213,Ganzberger; Geoffrey Michael,3,0,34,31
1658138699190,MATH 109,A02,083214,Ganzberger; Geoffrey Michael,4,0,34,30
1658138699190,MATH 109,A03,093478,Ganzberger; Geoffrey Michael,2,0,34,32
1658138699190,MATH 109,B01,083215,Ganzberger; Geoffrey Michael,3,0,32,29
1658138699190,MATH 109,B02,083216,Ganzberger; Geoffrey Michael,3,0,32,29
1658138699190,MATH 109,B03,093479,Ganzberger; Geoffrey Michael,8,0,32,24
1658138705215,MATH 142A,A01,083219,Chow; Bennett,7,0,32,25
1658138705215,MATH 142A,A02,083220,Chow; Bennett,10,0,32,22
1658138705215,MATH 142A,A03,093480,Chow; Bennett,9,0,32,23
1658138705215,MATH 142A,B03,093481,Chow; Bennett,8,0,32,24
1658138705215,MATH 142A,B04,093558,Chow; Bennett,14,0,32,18
1658138705215,MATH 142A,B05,093559,Chow; Bennett,7,0,32,25
1658138711243,MATH 193A,A01,083224,Rotar; Vladimir,9,0,34,25
1658138711243,MATH 193A,A02,083225,Rotar; Vladimir,11,0,34,23
1658138711243,MATH 193A,A03,083781,Rotar; Vladimir,5,0,34,29
1658138711243,MATH 193A,A04,083782,Rotar; Vladimir,12,0,34,22
1658138711243,MATH 193A,A05,093482,Rotar; Vladimir,11,0,34,23
1658138717265,MATH 197,001,091859,McAuley; Julian John,9999,0,9999,0
1658138717265,MATH 197,002,095566,Kedlaya; Kiran S.,9997,0,9999,2
1658138717265,MATH 197,003,095567,Xiao; Ming,9999,0,9999,0
1658138717265,MATH 197,004,095571,Perols; Johan Lars,9998,0,9999,1
1658138724321,COGS 9,A01,083615,Shannon; Kyle Michael,11,0,75,64
1658138730343,COGS 11,A01,083617,Boyle; Mary E. T.,23,0,48,25
1658138736367,COGS 13,A01,083071,Bastos; Amalia Pinkusfeld,12,0,71,59
1658138742389,COGS 14A,A01,092681,Semenuks; Arturs,5,1,100,95
1658138748412,COGS 14B,A01,083073,Cheng; Tzu-Han,7,0,63,56
1658138754436,COGS 17,A01,092677,Semenuks; Arturs,7,0,81,74
1658138760462,COGS 100,A01,083619,Allen; Michael Gordon,17,0,70,53
1658138766489,COGS 101A,A01,083621,Davis; Joshua Daniel,9,0,68,59
1658138772518,COGS 101B,A01,091572,Allen; Michael Gordon,14,0,65,51
1658138778543,COGS 101C,A01,083625,Delgado; Tania,17,0,35,18
1658138784566,COGS 107A,A01,083627,Boyle; Mary E. T.,14,0,60,46
1658138790592,COGS 118A,A01,083075,Gupta; Anjum,21,0,76,55
1658138796616,CSE 3,A50,083646,Miranda; Gregory Joseph,24,0,50,26
1658138802639,CSE 8A,A50,083650,Miranda; Gregory Joseph,17,1,56,39
1658138808663,CSE 11,A01,083080,Cao; Yingjun,7,15,40,33
1658138814686,CSE 12,A01,083652,Krause-Levy; Sophia Louisa,30,1,120,90
1658138820716,CSE 15L,A01,083654,Morris; Justin Loren,9,0,50,41
1658138820716,CSE 15L,A02,083655,Morris; Justin Loren,11,0,50,39
1658138826740,CSE 20,A01,083657,Tran; Khoa Dang,39,0,80,41
1658138832767,CSE 21,A01,095574,Bach; Quang Tran,23,0,48,25
1658138838791,CSE 30,A01,083084,Eldon; John,8,0,80,72
1658138838791,CSE 30,B01,095061,Bhaskar; Nishant,9,0,50,41
1658138844819,CSE 100,A01,083659,Cao; Yingjun,5,4,70,65
1658138850846,CSE 134B,A01,083661,Powell; Thomas Allan,25,0,100,75
1658138856872,CSE 140,A01,083663,Gungor; Onat,17,0,85,68
1658138862896,CSE 140L,A01,083088,Eldon; John,23,0,100,77
1658138868921,CSE 175,A01,083665,Kumar; Rakesh,3,0,25,22
1658138874946,CSE 190,A00,092507,Dubnov; Shlomo,8,0,20,12
1658138880975,ECE 45,A01,083139,Congero; Spencer William,7,0,75,68
1658138887002,ECE 65,A50,083695,Saad; Andrew S,12,0,30,18
1658138887002,ECE 65,A51,095125,Saad; Andrew S,24,0,26,2
1658138893028,ECE 109,A01,091882,Touri; Behrouz,21,0,70,49
1658138899055,ECE 180,A00,083140,Abi Samra; Nicholas Camill,1,0,30,29
1658138899055,ECE 180,B00,083141,Abi Samra; Nicholas Camill,0,0,30,30
1658138905078,MATH 10A,A01,083735,Patchell; Gregory David,2,0,30,28
1658138905078,MATH 10A,A02,083736,Patchell; Gregory David,20,0,30,10
1658138905078,MATH 10A,A03,083737,Patchell; Gregory David,16,0,30,14
1658138911103,MATH 10B,A01,083207,Lim; Seonhee,9,0,34,25
1658138911103,MATH 10B,A02,083208,Lim; Seonhee,10,0,35,25
1658138911103,MATH 10B,A03,093472,Lim; Seonhee,7,0,34,27
1658138911103,MATH 10B,B01,083739,Sinha; Shubham,14,0,30,16
1658138917132,MATH 18,A01,083743,Cinel; Cameron Alexander,9,0,30,21
1658138917132,MATH 18,A02,083744,Cinel; Cameron Alexander,18,0,30,12
1658138917132,MATH 18,A03,083745,Cinel; Cameron Alexander,10,0,30,20
1658138917132,MATH 18,B01,083748,Rideout; David Porter,5,0,37,32
1658138917132,MATH 18,B02,083749,Rideout; David Porter,5,0,36,31
1658138917132,MATH 18,B03,083750,Rideout; David Porter,3,0,37,34
1658138917132,MATH 18,B04,083751,Rideout; David Porter,7,0,36,29
1658138917132,MATH 18,B05,093473,Rideout; David Porter,7,0,36,29
1658138917132,MATH 18,B06,093474,Rideout; David Porter,6,0,36,30
1658138923160,MATH 20A,A01,083754,Zheng; Zequn,14,0,40,26
1658138929184,MATH 20B,A01,083756,Briones; Jor-el Thomas Caparas,4,0,36,32
1658138929184,MATH 20B,A02,083757,Briones; Jor-el Thomas Caparas,1,0,36,35
1658138929184,MATH 20B,A03,093475,Briones; Jor-el Thomas Caparas,3,0,36,33
1658138935209,MATH 20C,A01,083760,Briones; Jor-el Thomas Caparas,1,0,35,34
1658138935209,MATH 20C,A02,083761,Briones; Jor-el Thomas Caparas,8,0,35,27
1658138935209,MATH 20C,A03,093476,Briones; Jor-el Thomas Caparas,0,1,36,36
1658138935209,MATH 20C,B01,083762,Bach; Quang Tran,1,0,30,29
1658138941235,MATH 20D,A01,083765,Tran; Brian Kha,5,0,30,25
1658138941235,MATH 20D,A02,083766,Tran; Brian Kha,5,0,30,25
1658138941235,MATH 20D,A03,083767,Tran; Brian Kha,6,0,30,24
1658138947259,MATH 20E,A01,083771,Ganguly; Soumya,12,0,32,20
1658138947259,MATH 20E,A02,083772,Ganguly; Soumya,7,0,32,25
1658138947259,MATH 20E,B01,083773,Ciotti; Benjamin,20,0,35,15
1658138947259,MATH 20E,B02,083774,Ciotti; Benjamin,18,0,35,17
1658138953284,MATH 103A,A01,083777,Greenfeld; Be'Eri,6,0,36,30
1658138953284,MATH 103A,A02,083778,Greenfeld; Be'Eri,5,0,36,31
1658138953284,MATH 103A,A03,093561,Greenfeld; Be'Eri,7,0,36,29
1658138953284,MATH 103A,B01,083779,Greenfeld; Be'Eri,8,0,36,28
1658138953284,MATH 103A,B02,083780,Greenfeld; Be'Eri,4,0,36,32
1658138953284,MATH 103A,B03,093562,Greenfeld; Be'Eri,3,0,36,33
1658138959311,MATH 105,A01,085443,Carter; Anne Toulson,15,0,35,20
1658138959311,MATH 105,A02,093477,Carter; Anne Toulson,20,0,35,15
1658138965335,MATH 109,A01,083213,Ganzberger; Geoffrey Michael,3,0,34,31
1658138965335,MATH 109,A02,083214,Ganzberger; Geoffrey Michael,4,0,34,30
1658138965335,MATH 109,A03,093478,Ganzberger; Geoffrey Michael,2,0,34,32
1658138965335,MATH 109,B01,083215,Ganzberger; Geoffrey Michael,3,0,32,29
1658138965335,MATH 109,B02,083216,Ganzberger; Geoffrey Michael,3,0,32,29
1658138965335,MATH 109,B03,093479,Ganzberger; Geoffrey Michael,8,0,32,24
1658138971365,MATH 142A,A01,083219,Chow; Bennett,7,0,32,25
1658138971365,MATH 142A,A02,083220,Chow; Bennett,10,0,32,22
1658138971365,MATH 142A,A03,093480,Chow; Bennett,9,0,32,23
1658138971365,MATH 142A,B03,093481,Chow; Bennett,8,0,32,24
1658138971365,MATH 142A,B04,093558,Chow; Bennett,14,0,32,18
1658138971365,MATH 142A,B05,093559,Chow; Bennett,7,0,32,25
1658138977389,MATH 193A,A01,083224,Rotar; Vladimir,9,0,34,25
1658138977389,MATH 193A,A02,083225,Rotar; Vladimir,11,0,34,23
1658138977389,MATH 193A,A03,083781,Rotar; Vladimir,5,0,34,29
1658138977389,MATH 193A,A04,083782,Rotar; Vladimir,12,0,34,22
1658138977389,MATH 193A,A05,093482,Rotar; Vladimir,11,0,34,23
1658138983412,MATH 197,001,091859,McAuley; Julian John,9999,0,9999,0
1658138983412,MATH 197,002,095566,Kedlaya; Kiran S.,9997,0,9999,2
1658138983412,MATH 197,003,095567,Xiao; Ming,9999,0,9999,0
1658138983412,MATH 197,004,095571,Perols; Johan Lars,9998,0,9999,1
1658138990480,COGS 9,A01,083615,Shannon; Kyle Michael,11,0,75,64
1658138996505,COGS 11,A01,083617,Boyle; Mary E. T.,23,0,48,25
1658139002528,COGS 13,A01,083071,Bastos; Amalia Pinkusfeld,12,0,71,59
1658139008557,COGS 14A,A01,092681,Semenuks; Arturs,5,1,100,95
1658139014580,COGS 14B,A01,083073,Cheng; Tzu-Han,7,0,63,56
1658139020602,COGS 17,A01,092677,Semenuks; Arturs,7,0,81,74
1658139026631,COGS 100,A01,083619,Allen; Michael Gordon,17,0,70,53
1658139032658,COGS 101A,A01,083621,Davis; Joshua Daniel,9,0,68,59
1658139038683,COGS 101B,A01,091572,Allen; Michael Gordon,14,0,65,51
1658139044707,COGS 101C,A01,083625,Delgado; Tania,17,0,35,18
1658139050729,COGS 107A,A01,083627,Boyle; Mary E. T.,14,0,60,46
1658139056760,COGS 118A,A01,083075,Gupta; Anjum,21,0,76,55
1658139062789,CSE 3,A50,083646,Miranda; Gregory Joseph,24,0,50,26
1658139068818,CSE 8A,A50,083650,Miranda; Gregory Joseph,17,1,56,39
1658139074842,CSE 11,A01,083080,Cao; Yingjun,7,15,40,33
1658139080866,CSE 12,A01,083652,Krause-Levy; Sophia Louisa,30,1,120,90
1658139086891,CSE 15L,A01,083654,Morris; Justin Loren,9,0,50,41
1658139086891,CSE 15L,A02,083655,Morris; Justin Loren,11,0,50,39
1658139092917,CSE 20,A01,083657,Tran; Khoa Dang,39,0,80,41
1658139099038,CSE 21,A01,095574,Bach; Quang Tran,23,0,48,25
1658139105063,CSE 30,A01,083084,Eldon; John,8,0,80,72
1658139105063,CSE 30,B01,095061,Bhaskar; Nishant,9,0,50,41
1658139111087,CSE 100,A01,083659,Cao; Yingjun,5,4,70,65
1658139117111,CSE 134B,A01,083661,Powell; Thomas Allan,25,0,100,75
1658139123139,CSE 140,A01,083663,Gungor; Onat,17,0,85,68
1658139129162,CSE 140L,A01,083088,Eldon; John,23,0,100,77
1658139135185,CSE 175,A01,083665,Kumar; Rakesh,3,0,25,22
1658139141209,CSE 190,A00,092507,Dubnov; Shlomo,8,0,20,12
1658139147236,ECE 45,A01,083139,Congero; Spencer William,7,0,75,68
1658139153264,ECE 65,A50,083695,Saad; Andrew S,12,0,30,18
1658139153264,ECE 65,A51,095125,Saad; Andrew S,24,0,26,2
1658139159290,ECE 109,A01,091882,Touri; Behrouz,21,0,70,49
1658139165319,ECE 180,A00,083140,Abi Samra; Nicholas Camill,1,0,30,29
1658139165319,ECE 180,B00,083141,Abi Samra; Nicholas Camill,0,0,30,30
1658139171347,MATH 10A,A01,083735,Patchell; Gregory David,2,0,30,28
1658139171347,MATH 10A,A02,083736,Patchell; Gregory David,20,0,30,10
1658139171347,MATH 10A,A03,083737,Patchell; Gregory David,16,0,30,14
1658139177371,MATH 10B,A01,083207,Lim; Seonhee,9,0,34,25
1658139177371,MATH 10B,A02,083208,Lim; Seonhee,10,0,35,25
1658139177371,MATH 10B,A03,093472,Lim; Seonhee,7,0,34,27
1658139177371,MATH 10B,B01,083739,Sinha; Shubham,14,0,30,16
1658139183397,MATH 18,A01,083743,Cinel; Cameron Alexander,9,0,30,21
1658139183397,MATH 18,A02,083744,Cinel; Cameron Alexander,18,0,30,12
1658139183397,MATH 18,A03,083745,Cinel; Cameron Alexander,10,0,30,20
1658139183397,MATH 18,B01,083748,Rideout; David Porter,5,0,37,32
1658139183397,MATH 18,B02,083749,Rideout; David Porter,5,0,36,31
1658139183397,MATH 18,B03,083750,Rideout; David Porter,3,0,37,34
1658139183397,MATH 18,B04,083751,Rideout; David Porter,7,0,36,29
1658139183397,MATH 18,B05,093473,Rideout; David Porter,7,0,36,29
1658139183397,MATH 18,B06,093474,Rideout; David Porter,6,0,36,30
1658139189425,MATH 20A,A01,083754,Zheng; Zequn,14,0,40,26
1658139195451,MATH 20B,A01,083756,Briones; Jor-el Thomas Caparas,4,0,36,32
1658139195451,MATH 20B,A02,083757,Briones; Jor-el Thomas Caparas,1,0,36,35
1658139195451,MATH 20B,A03,093475,Briones; Jor-el Thomas Caparas,3,0,36,33
1658139201474,MATH 20C,A01,083760,Briones; Jor-el Thomas Caparas,1,0,35,34
1658139201474,MATH 20C,A02,083761,Briones; Jor-el Thomas Caparas,8,0,35,27
1658139201474,MATH 20C,A03,093476,Briones; Jor-el Thomas Caparas,0,1,36,36
1658139201474,MATH 20C,B01,083762,Bach; Quang Tran,1,0,30,29
1658139207496,MATH 20D,A01,083765,Tran; Brian Kha,5,0,30,25
1658139207496,MATH 20D,A02,083766,Tran; Brian Kha,5,0,30,25
1658139207496,MATH 20D,A03,083767,Tran; Brian Kha,6,0,30,24
1658139213521,MATH 20E,A01,083771,Ganguly; Soumya,12,0,32,20
1658139213521,MATH 20E,A02,083772,Ganguly; Soumya,7,0,32,25
1658139213521,MATH 20E,B01,083773,Ciotti; Benjamin,20,0,35,15
1658139213521,MATH 20E,B02,083774,Ciotti; Benjamin,18,0,35,17
1658139219545,MATH 103A,A01,083777,Greenfeld; Be'Eri,6,0,36,30
1658139219545,MATH 103A,A02,083778,Greenfeld; Be'Eri,5,0,36,31
1658139219545,MATH 103A,A03,093561,Greenfeld; Be'Eri,7,0,36,29
1658139219545,MATH 103A,B01,083779,Greenfeld; Be'Eri,8,0,36,28
1658139219545,MATH 103A,B02,083780,Greenfeld; Be'Eri,4,0,36,32
1658139219545,MATH 103A,B03,093562,Greenfeld; Be'Eri,3,0,36,33
1658139225569,MATH 105,A01,085443,Carter; Anne Toulson,15,0,35,20
1658139225569,MATH 105,A02,093477,Carter; Anne Toulson,20,0,35,15
1658139231599,MATH 109,A01,083213,Ganzberger; Geoffrey Michael,3,0,34,31
1658139231599,MATH 109,A02,083214,Ganzberger; Geoffrey Michael,4,0,34,30
1658139231599,MATH 109,A03,093478,Ganzberger; Geoffrey Michael,2,0,34,32
1658139231599,MATH 109,B01,083215,Ganzberger; Geoffrey Michael,3,0,32,29
1658139231599,MATH 109,B02,083216,Ganzberger; Geoffrey Michael,3,0,32,29
1658139231599,MATH 109,B03,093479,Ganzberger; Geoffrey Michael,8,0,32,24
1658139237629,MATH 142A,A01,083219,Chow; Bennett,7,0,32,25
1658139237629,MATH 142A,A02,083220,Chow; Bennett,10,0,32,22
1658139237629,MATH 142A,A03,093480,Chow; Bennett,9,0,32,23
1658139237629,MATH 142A,B03,093481,Chow; Bennett,8,0,32,24
1658139237629,MATH 142A,B04,093558,Chow; Bennett,14,0,32,18
1658139237629,MATH 142A,B05,093559,Chow; Bennett,7,0,32,25
1658139243653,MATH 193A,A01,083224,Rotar; Vladimir,9,0,34,25
1658139243653,MATH 193A,A02,083225,Rotar; Vladimir,11,0,34,23
1658139243653,MATH 193A,A03,083781,Rotar; Vladimir,5,0,34,29
1658139243653,MATH 193A,A04,083782,Rotar; Vladimir,12,0,34,22
1658139243653,MATH 193A,A05,093482,Rotar; Vladimir,11,0,34,23
1658139249680,MATH 197,001,091859,McAuley; Julian John,9999,0,9999,0
1658139249680,MATH 197,002,095566,Kedlaya; Kiran S.,9997,0,9999,2
1658139249680,MATH 197,003,095567,Xiao; Ming,9999,0,9999,0
1658139249680,MATH 197,004,095571,Perols; Johan Lars,9998,0,9999,1
1658139256737,COGS 9,A01,083615,Shannon; Kyle Michael,11,0,75,64
1658139262759,COGS 11,A01,083617,Boyle; Mary E. T.,23,0,48,25
1658139268782,COGS 13,A01,083071,Bastos; Amalia Pinkusfeld,12,0,71,59
1658139274806,COGS 14A,A01,092681,Semenuks; Arturs,5,1,100,95
1658139280831,COGS 14B,A01,083073,Cheng; Tzu-Han,7,0,63,56
1658139286857,COGS 17,A01,092677,Semenuks; Arturs,7,0,81,74
1658139292879,COGS 100,A01,083619,Allen; Michael Gordon,17,0,70,53
1658139298903,COGS 101A,A01,083621,Davis; Joshua Daniel,9,0,68,59
1658139304926,COGS 101B,A01,091572,Allen; Michael Gordon,14,0,65,51
1658139310949,COGS 101C,A01,083625,Delgado; Tania,17,0,35,18
1658139316970,COGS 107A,A01,083627,Boyle; Mary E. T.,14,0,60,46
1658139322994,COGS 118A,A01,083075,Gupta; Anjum,21,0,76,55
1658139329017,CSE 3,A50,083646,Miranda; Gregory Joseph,24,0,50,26
1658139335043,CSE 8A,A50,083650,Miranda; Gregory Joseph,17,1,56,39
1658139341068,CSE 11,A01,083080,Cao; Yingjun,7,15,40,33
1658139347094,CSE 12,A01,083652,Krause-Levy; Sophia Louisa,30,1,120,90
1658139353122,CSE 15L,A01,083654,Morris; Justin Loren,9,0,50,41
1658139353122,CSE 15L,A02,083655,Morris; Justin Loren,11,0,50,39
1658139359146,CSE 20,A01,083657,Tran; Khoa Dang,39,0,80,41
1658139365170,CSE 21,A01,095574,Bach; Quang Tran,23,0,48,25
1658139371193,CSE 30,A01,083084,Eldon; John,8,0,80,72
1658139371193,CSE 30,B01,095061,Bhaskar; Nishant,9,0,50,41
1658139377221,CSE 100,A01,083659,Cao; Yingjun,5,4,70,65
1658139383244,CSE 134B,A01,083661,Powell; Thomas Allan,25,0,100,75
1658139389267,CSE 140,A01,083663,Gungor; Onat,17,0,85,68
1658139395302,CSE 140L,A01,083088,Eldon; John,23,0,100,77
1658139401331,CSE 175,A01,083665,Kumar; Rakesh,3,0,25,22
1658139407353,CSE 190,A00,092507,Dubnov; Shlomo,8,0,20,12
1658139413384,ECE 45,A01,083139,Congero; Spencer William,7,0,75,68
1658139419407,ECE 65,A50,083695,Saad; Andrew S,12,0,30,18
1658139419407,ECE 65,A51,095125,Saad; Andrew S,24,0,26,2
1658139425436,ECE 109,A01,091882,Touri; Behrouz,21,0,70,49
1658139431459,ECE 180,A00,083140,Abi Samra; Nicholas Camill,1,0,30,29
1658139431459,ECE 180,B00,083141,Abi Samra; Nicholas Camill,0,0,30,30
1658139437487,MATH 10A,A01,083735,Patchell; Gregory David,2,0,30,28
1658139437487,MATH 10A,A02,083736,Patchell; Gregory David,20,0,30,10
1658139437487,MATH 10A,A03,083737,Patchell; Gregory David,16,0,30,14
1658139443518,MATH 10B,A01,083207,Lim; Seonhee,9,0,34,25
1658139443518,MATH 10B,A02,083208,Lim; Seonhee,10,0,35,25
1658139443518,MATH 10B,A03,093472,Lim; Seonhee,7,0,34,27
1658139443518,MATH 10B,B01,083739,Sinha; Shubham,14,0,30,16
1658139449544,MATH 18,A01,083743,Cinel; Cameron Alexander,9,0,30,21
1658139449544,MATH 18,A02,083744,Cinel; Cameron Alexander,18,0,30,12
1658139449544,MATH 18,A03,083745,Cinel; Cameron Alexander,10,0,30,20
1658139449544,MATH 18,B01,083748,Rideout; David Porter,5,0,37,32
1658139449544,MATH 18,B02,083749,Rideout; David Porter,5,0,36,31
1658139449544,MATH 18,B03,083750,Rideout; David Porter,3,0,37,34
1658139449544,MATH 18,B04,083751,Rideout; David Porter,7,0,36,29
1658139449544,MATH 18,B05,093473,Rideout; David Porter,7,0,36,29
1658139449544,MATH 18,B06,093474,Rideout; David Porter,6,0,36,30
1658139455571,MATH 20A,A01,083754,Zheng; Zequn,14,0,40,26
1658139461600,MATH 20B,A01,083756,Briones; Jor-el Thomas Caparas,4,0,36,32
1658139461600,MATH 20B,A02,083757,Briones; Jor-el Thomas Caparas,1,0,36,35
1658139461600,MATH 20B,A03,093475,Briones; Jor-el Thomas Caparas,3,0,36,33
1658139467624,MATH 20C,A01,083760,Briones; Jor-el Thomas Caparas,1,0,35,34
1658139467624,MATH 20C,A02,083761,Briones; Jor-el Thomas Caparas,8,0,35,27
1658139467624,MATH 20C,A03,093476,Briones; Jor-el Thomas Caparas,0,1,36,36
1658139467624,MATH 20C,B01,083762,Bach; Quang Tran,1,0,30,29
1658139473652,MATH 20D,A01,083765,Tran; Brian Kha,5,0,30,25
1658139473652,MATH 20D,A02,083766,Tran; Brian Kha,5,0,30,25
1658139473652,MATH 20D,A03,083767,Tran; Brian Kha,6,0,30,24
1658139479676,MATH 20E,A01,083771,Ganguly; Soumya,12,0,32,20
1658139479676,MATH 20E,A02,083772,Ganguly; Soumya,7,0,32,25
1658139479676,MATH 20E,B01,083773,Ciotti; Benjamin,20,0,35,15
1658139479676,MATH 20E,B02,083774,Ciotti; Benjamin,18,0,35,17
1658139485701,MATH 103A,A01,083777,Greenfeld; Be'Eri,6,0,36,30
1658139485701,MATH 103A,A02,083778,Greenfeld; Be'Eri,5,0,36,31
1658139485701,MATH 103A,A03,093561,Greenfeld; Be'Eri,7,0,36,29
1658139485701,MATH 103A,B01,083779,Greenfeld; Be'Eri,8,0,36,28
1658139485701,MATH 103A,B02,083780,Greenfeld; Be'Eri,4,0,36,32
1658139485701,MATH 103A,B03,093562,Greenfeld; Be'Eri,3,0,36,33
1658139491728,MATH 105,A01,085443,Carter; Anne Toulson,15,0,35,20
1658139491728,MATH 105,A02,093477,Carter; Anne Toulson,20,0,35,15
1658139497753,MATH 109,A01,083213,Ganzberger; Geoffrey Michael,3,0,34,31
1658139497753,MATH 109,A02,083214,Ganzberger; Geoffrey Michael,4,0,34,30
1658139497753,MATH 109,A03,093478,Ganzberger; Geoffrey Michael,2,0,34,32
1658139497753,MATH 109,B01,083215,Ganzberger; Geoffrey Michael,3,0,32,29
1658139497753,MATH 109,B02,083216,Ganzberger; Geoffrey Michael,3,0,32,29
1658139497753,MATH 109,B03,093479,Ganzberger; Geoffrey Michael,8,0,32,24
1658139503783,MATH 142A,A01,083219,Chow; Bennett,7,0,32,25
1658139503783,MATH 142A,A02,083220,Chow; Bennett,10,0,32,22
1658139503783,MATH 142A,A03,093480,Chow; Bennett,9,0,32,23
1658139503783,MATH 142A,B03,093481,Chow; Bennett,8,0,32,24
1658139503783,MATH 142A,B04,093558,Chow; Bennett,14,0,32,18
1658139503783,MATH 142A,B05,093559,Chow; Bennett,7,0,32,25
1658139509809,MATH 193A,A01,083224,Rotar; Vladimir,9,0,34,25
1658139509809,MATH 193A,A02,083225,Rotar; Vladimir,11,0,34,23
1658139509809,MATH 193A,A03,083781,Rotar; Vladimir,5,0,34,29
1658139509809,MATH 193A,A04,083782,Rotar; Vladimir,12,0,34,22
1658139509809,MATH 193A,A05,093482,Rotar; Vladimir,11,0,34,23
1658139515835,MATH 197,001,091859,McAuley; Julian John,9999,0,9999,0
1658139515835,MATH 197,002,095566,Kedlaya; Kiran S.,9997,0,9999,2
1658139515835,MATH 197,003,095567,Xiao; Ming,9999,0,9999,0
1658139515835,MATH 197,004,095571,Perols; Johan Lars,9998,0,9999,1
1658139522891,COGS 9,A01,083615,Shannon; Kyle Michael,11,0,75,64
1658139528914,COGS 11,A01,083617,Boyle; Mary E. T.,23,0,48,25
1658139534941,COGS 13,A01,083071,Bastos; Amalia Pinkusfeld,12,0,71,59
1658139540964,COGS 14A,A01,092681,Semenuks; Arturs,5,1,100,95
1658139546991,COGS 14B,A01,083073,Cheng; Tzu-Han,7,0,63,56
1658139553014,COGS 17,A01,092677,Semenuks; Arturs,7,0,81,74
1658139559040,COGS 100,A01,083619,Allen; Michael Gordon,17,0,70,53
1658139565068,COGS 101A,A01,083621,Davis; Joshua Daniel,9,0,68,59
1658139571095,COGS 101B,A01,091572,Allen; Michael Gordon,14,0,65,51
1658139577119,COGS 101C,A01,083625,Delgado; Tania,17,0,35,18
1658139583146,COGS 107A,A01,083627,Boyle; Mary E. T.,14,0,60,46
1658139589170,COGS 118A,A01,083075,Gupta; Anjum,21,0,76,55
1658139595194,CSE 3,A50,083646,Miranda; Gregory Joseph,24,0,50,26
1658139601224,CSE 8A,A50,083650,Miranda; Gregory Joseph,17,1,56,39
1658139607251,CSE 11,A01,083080,Cao; Yingjun,7,15,40,33
1658139613280,CSE 12,A01,083652,Krause-Levy; Sophia Louisa,30,1,120,90
1658139619305,CSE 15L,A01,083654,Morris; Justin Loren,9,0,50,41
1658139619305,CSE 15L,A02,083655,Morris; Justin Loren,11,0,50,39
1658139625331,CSE 20,A01,083657,Tran; Khoa Dang,39,0,80,41
1658139631358,CSE 21,A01,095574,Bach; Quang Tran,23,0,48,25
1658139637385,CSE 30,A01,083084,Eldon; John,8,0,80,72
1658139637385,CSE 30,B01,095061,Bhaskar; Nishant,9,0,50,41
1658139643412,CSE 100,A01,083659,Cao; Yingjun,5,4,70,65
1658139649434,CSE 134B,A01,083661,Powell; Thomas Allan,25,0,100,75
1658139655458,CSE 140,A01,083663,Gungor; Onat,17,0,85,68
1658139661482,CSE 140L,A01,083088,Eldon; John,23,0,100,77
1658139667508,CSE 175,A01,083665,Kumar; Rakesh,3,0,25,22
1658139673536,CSE 190,A00,092507,Dubnov; Shlomo,8,0,20,12
1658139679560,ECE 45,A01,083139,Congero; Spencer William,7,0,75,68
1658139685584,ECE 65,A50,083695,Saad; Andrew S,12,0,30,18
1658139685584,ECE 65,A51,095125,Saad; Andrew S,24,0,26,2
1658139691612,ECE 109,A01,091882,Touri; Behrouz,21,0,70,49
1658139697716,ECE 180,A00,083140,Abi Samra; Nicholas Camill,1,0,30,29
1658139697716,ECE 180,B00,083141,Abi Samra; Nicholas Camill,0,0,30,30
1658139703740,MATH 10A,A01,083735,Patchell; Gregory David,2,0,30,28
1658139703740,MATH 10A,A02,083736,Patchell; Gregory David,20,0,30,10
1658139703740,MATH 10A,A03,083737,Patchell; Gregory David,16,0,30,14
1658139709773,MATH 10B,A01,083207,Lim; Seonhee,9,0,34,25
1658139709773,MATH 10B,A02,083208,Lim; Seonhee,10,0,35,25
1658139709773,MATH 10B,A03,093472,Lim; Seonhee,7,0,34,27
1658139709773,MATH 10B,B01,083739,Sinha; Shubham,14,0,30,16
1658139715804,MATH 18,A01,083743,Cinel; Cameron Alexander,9,0,30,21
1658139715804,MATH 18,A02,083744,Cinel; Cameron Alexander,18,0,30,12
1658139715804,MATH 18,A03,083745,Cinel; Cameron Alexander,10,0,30,20
1658139715804,MATH 18,B01,083748,Rideout; David Porter,5,0,37,32
1658139715804,MATH 18,B02,083749,Rideout; David Porter,5,0,36,31
1658139715804,MATH 18,B03,083750,Rideout; David Porter,3,0,37,34
1658139715804,MATH 18,B04,083751,Rideout; David Porter,7,0,36,29
1658139715804,MATH 18,B05,093473,Rideout; David Porter,7,0,36,29
1658139715804,MATH 18,B06,093474,Rideout; David Porter,6,0,36,30
1658139721831,MATH 20A,A01,083754,Zheng; Zequn,14,0,40,26
1658139727857,MATH 20B,A01,083756,Briones; Jor-el Thomas Caparas,4,0,36,32
1658139727857,MATH 20B,A02,083757,Briones; Jor-el Thomas Caparas,1,0,36,35
1658139727857,MATH 20B,A03,093475,Briones; Jor-el Thomas Caparas,3,0,36,33
1658139733879,MATH 20C,A01,083760,Briones; Jor-el Thomas Caparas,1,0,35,34
1658139733879,MATH 20C,A02,083761,Briones; Jor-el Thomas Caparas,8,0,35,27
1658139733879,MATH 20C,A03,093476,Briones; Jor-el Thomas Caparas,0,1,36,36
1658139733879,MATH 20C,B01,083762,Bach; Quang Tran,1,0,30,29
1658139739903,MATH 20D,A01,083765,Tran; Brian Kha,5,0,30,25
1658139739903,MATH 20D,A02,083766,Tran; Brian Kha,5,0,30,25
1658139739903,MATH 20D,A03,083767,Tran; Brian Kha,6,0,30,24
1658139745928,MATH 20E,A01,083771,Ganguly; Soumya,12,0,32,20
1658139745928,MATH 20E,A02,083772,Ganguly; Soumya,7,0,32,25
1658139745928,MATH 20E,B01,083773,Ciotti; Benjamin,20,0,35,15
1658139745928,MATH 20E,B02,083774,Ciotti; Benjamin,18,0,35,17
1658139751953,MATH 103A,A01,083777,Greenfeld; Be'Eri,6,0,36,30
1658139751953,MATH 103A,A02,083778,Greenfeld; Be'Eri,5,0,36,31
1658139751953,MATH 103A,A03,093561,Greenfeld; Be'Eri,7,0,36,29
1658139751953,MATH 103A,B01,083779,Greenfeld; Be'Eri,8,0,36,28
1658139751953,MATH 103A,B02,083780,Greenfeld; Be'Eri,4,0,36,32
1658139751953,MATH 103A,B03,093562,Greenfeld; Be'Eri,3,0,36,33
1658139757985,MATH 105,A01,085443,Carter; Anne Toulson,15,0,35,20
1658139757985,MATH 105,A02,093477,Carter; Anne Toulson,20,0,35,15
1658139764012,MATH 109,A01,083213,Ganzberger; Geoffrey Michael,3,0,34,31
1658139764012,MATH 109,A02,083214,Ganzberger; Geoffrey Michael,4,0,34,30
1658139764012,MATH 109,A03,093478,Ganzberger; Geoffrey Michael,2,0,34,32
1658139764012,MATH 109,B01,083215,Ganzberger; Geoffrey Michael,3,0,32,29
1658139764012,MATH 109,B02,083216,Ganzberger; Geoffrey Michael,3,0,32,29
1658139764012,MATH 109,B03,093479,Ganzberger; Geoffrey Michael,8,0,32,24
1658139770040,MATH 142A,A01,083219,Chow; Bennett,7,0,32,25
1658139770040,MATH 142A,A02,083220,Chow; Bennett,10,0,32,22
1658139770040,MATH 142A,A03,093480,Chow; Bennett,9,0,32,23
1658139770040,MATH 142A,B03,093481,Chow; Bennett,8,0,32,24
1658139770040,MATH 142A,B04,093558,Chow; Bennett,14,0,32,18
1658139770040,MATH 142A,B05,093559,Chow; Bennett,7,0,32,25
1658139776069,MATH 193A,A01,083224,Rotar; Vladimir,9,0,34,25
1658139776069,MATH 193A,A02,083225,Rotar; Vladimir,11,0,34,23
1658139776069,MATH 193A,A03,083781,Rotar; Vladimir,5,0,34,29
1658139776069,MATH 193A,A04,083782,Rotar; Vladimir,12,0,34,22
1658139776069,MATH 193A,A05,093482,Rotar; Vladimir,11,0,34,23
1658139782098,MATH 197,001,091859,McAuley; Julian John,9999,0,9999,0
1658139782098,MATH 197,002,095566,Kedlaya; Kiran S.,9997,0,9999,2
1658139782098,MATH 197,003,095567,Xiao; Ming,9999,0,9999,0
1658139782098,MATH 197,004,095571,Perols; Johan Lars,9998,0,9999,1
1658139789149,COGS 9,A01,083615,Shannon; Kyle Michael,11,0,75,64
1658139795186,COGS 11,A01,083617,Boyle; Mary E. T.,23,0,48,25
1658139801210,COGS 13,A01,083071,Bastos; Amalia Pinkusfeld,12,0,71,59
1658139807234,COGS 14A,A01,092681,Semenuks; Arturs,5,1,100,95
1658139813260,COGS 14B,A01,083073,Cheng; Tzu-Han,7,0,63,56
1658139819283,COGS 17,A01,092677,Semenuks; Arturs,7,0,81,74
1658139825308,COGS 100,A01,083619,Allen; Michael Gordon,17,0,70,53
1658139831336,COGS 101A,A01,083621,Davis; Joshua Daniel,9,0,68,59
1658139837360,COGS 101B,A01,091572,Allen; Michael Gordon,14,0,65,51
1658139843383,COGS 101C,A01,083625,Delgado; Tania,17,0,35,18
1658139849410,COGS 107A,A01,083627,Boyle; Mary E. T.,14,0,60,46
1658139855437,COGS 118A,A01,083075,Gupta; Anjum,21,0,76,55
1658139861460,CSE 3,A50,083646,Miranda; Gregory Joseph,24,0,50,26
1658139867488,CSE 8A,A50,083650,Miranda; Gregory Joseph,17,1,56,39
1658139873511,CSE 11,A01,083080,Cao; Yingjun,7,15,40,33
1658139879539,CSE 12,A01,083652,Krause-Levy; Sophia Louisa,30,1,120,90
1658139885562,CSE 15L,A01,083654,Morris; Justin Loren,9,0,50,41
1658139885562,CSE 15L,A02,083655,Morris; Justin Loren,11,0,50,39
1658139891585,CSE 20,A01,083657,Tran; Khoa Dang,39,0,80,41
1658139897610,CSE 21,A01,095574,Bach; Quang Tran,23,0,48,25
1658139903634,CSE 30,A01,083084,Eldon; John,8,0,80,72
1658139903634,CSE 30,B01,095061,Bhaskar; Nishant,9,0,50,41
1658139909658,CSE 100,A01,083659,Cao; Yingjun,5,4,70,65
1658139915680,CSE 134B,A01,083661,Powell; Thomas Allan,25,0,100,75
1658139921706,CSE 140,A01,083663,Gungor; Onat,17,0,85,68
1658139927730,CSE 140L,A01,083088,Eldon; John,23,0,100,77
1658139933752,CSE 175,A01,083665,Kumar; Rakesh,3,0,25,22
1658139939780,CSE 190,A00,092507,Dubnov; Shlomo,8,0,20,12
1658139945808,ECE 45,A01,083139,Congero; Spencer William,7,0,75,68
1658139951843,ECE 65,A50,083695,Saad; Andrew S,12,0,30,18
1658139951843,ECE 65,A51,095125,Saad; Andrew S,24,0,26,2
1658139957875,ECE 109,A01,091882,Touri; Behrouz,21,0,70,49
1658139963900,ECE 180,A00,083140,Abi Samra; Nicholas Camill,1,0,30,29
1658139963900,ECE 180,B00,083141,Abi Samra; Nicholas Camill,0,0,30,30
1658139969924,MATH 10A,A01,083735,Patchell; Gregory David,2,0,30,28
1658139969924,MATH 10A,A02,083736,Patchell; Gregory David,20,0,30,10
1658139969924,MATH 10A,A03,083737,Patchell; Gregory David,16,0,30,14
1658139975960,MATH 10B,A01,083207,Lim; Seonhee,9,0,34,25
1658139975960,MATH 10B,A02,083208,Lim; Seonhee,10,0,35,25
1658139975960,MATH 10B,A03,093472,Lim; Seonhee,7,0,34,27
1658139975960,MATH 10B,B01,083739,Sinha; Shubham,14,0,30,16
1658139981985,MATH 18,A01,083743,Cinel; Cameron Alexander,9,0,30,21
1658139981985,MATH 18,A02,083744,Cinel; Cameron Alexander,18,0,30,12
1658139981985,MATH 18,A03,083745,Cinel; Cameron Alexander,10,0,30,20
1658139981985,MATH 18,B01,083748,Rideout; David Porter,5,0,37,32
1658139981985,MATH 18,B02,083749,Rideout; David Porter,5,0,36,31
1658139981985,MATH 18,B03,083750,Rideout; David Porter,3,0,37,34
1658139981985,MATH 18,B04,083751,Rideout; David Porter,7,0,36,29
1658139981985,MATH 18,B05,093473,Rideout; David Porter,7,0,36,29
1658139981985,MATH 18,B06,093474,Rideout; David Porter,6,0,36,30
1658139988011,MATH 20A,A01,083754,Zheng; Zequn,14,0,40,26
1658139994040,MATH 20B,A01,083756,Briones; Jor-el Thomas Caparas,4,0,36,32
1658139994040,MATH 20B,A02,083757,Briones; Jor-el Thomas Caparas,1,0,36,35
1658139994040,MATH 20B,A03,093475,Briones; Jor-el Thomas Caparas,3,0,36,33
1658140000071,MATH 20C,A01,083760,Briones; Jor-el Thomas Caparas,1,0,35,34
1658140000071,MATH 20C,A02,083761,Briones; Jor-el Thomas Caparas,8,0,35,27
1658140000071,MATH 20C,A03,093476,Briones; Jor-el Thomas Caparas,0,1,36,36
1658140000071,MATH 20C,B01,083762,Bach; Quang Tran,1,0,30,29
1658140006095,MATH 20D,A01,083765,Tran; Brian Kha,5,0,30,25
1658140006095,MATH 20D,A02,083766,Tran; Brian Kha,5,0,30,25
1658140006095,MATH 20D,A03,083767,Tran; Brian Kha,6,0,30,24
1658140012119,MATH 20E,A01,083771,Ganguly; Soumya,12,0,32,20
1658140012119,MATH 20E,A02,083772,Ganguly; Soumya,7,0,32,25
1658140012119,MATH 20E,B01,083773,Ciotti; Benjamin,20,0,35,15
1658140012119,MATH 20E,B02,083774,Ciotti; Benjamin,18,0,35,17
1658140018144,MATH 103A,A01,083777,Greenfeld; Be'Eri,6,0,36,30
1658140018144,MATH 103A,A02,083778,Greenfeld; Be'Eri,5,0,36,31
1658140018144,MATH 103A,A03,093561,Greenfeld; Be'Eri,7,0,36,29
1658140018144,MATH 103A,B01,083779,Greenfeld; Be'Eri,8,0,36,28
1658140018144,MATH 103A,B02,083780,Greenfeld; Be'Eri,4,0,36,32
1658140018144,MATH 103A,B03,093562,Greenfeld; Be'Eri,3,0,36,33
1658140024172,MATH 105,A01,085443,Carter; Anne Toulson,15,0,35,20
1658140024172,MATH 105,A02,093477,Carter; Anne Toulson,20,0,35,15
1658140030196,MATH 109,A01,083213,Ganzberger; Geoffrey Michael,3,0,34,31
1658140030196,MATH 109,A02,083214,Ganzberger; Geoffrey Michael,4,0,34,30
1658140030196,MATH 109,A03,093478,Ganzberger; Geoffrey Michael,2,0,34,32
1658140030196,MATH 109,B01,083215,Ganzberger; Geoffrey Michael,3,0,32,29
1658140030196,MATH 109,B02,083216,Ganzberger; Geoffrey Michael,3,0,32,29
1658140030196,MATH 109,B03,093479,Ganzberger; Geoffrey Michael,8,0,32,24
1658140036220,MATH 142A,A01,083219,Chow; Bennett,7,0,32,25
1658140036220,MATH 142A,A02,083220,Chow; Bennett,10,0,32,22
1658140036220,MATH 142A,A03,093480,Chow; Bennett,9,0,32,23
1658140036220,MATH 142A,B03,093481,Chow; Bennett,8,0,32,24
1658140036220,MATH 142A,B04,093558,Chow; Bennett,14,0,32,18
1658140036220,MATH 142A,B05,093559,Chow; Bennett,7,0,32,25
1658140042245,MATH 193A,A01,083224,Rotar; Vladimir,9,0,34,25
1658140042245,MATH 193A,A02,083225,Rotar; Vladimir,11,0,34,23
1658140042245,MATH 193A,A03,083781,Rotar; Vladimir,5,0,34,29
1658140042245,MATH 193A,A04,083782,Rotar; Vladimir,12,0,34,22
1658140042245,MATH 193A,A05,093482,Rotar; Vladimir,11,0,34,23
1658140048269,MATH 197,001,091859,McAuley; Julian John,9999,0,9999,0
1658140048269,MATH 197,002,095566,Kedlaya; Kiran S.,9997,0,9999,2
1658140048269,MATH 197,003,095567,Xiao; Ming,9999,0,9999,0
1658140048269,MATH 197,004,095571,Perols; Johan Lars,9998,0,9999,1
1658140055333,COGS 9,A01,083615,Shannon; Kyle Michael,11,0,75,64
1658140061356,COGS 11,A01,083617,Boyle; Mary E. T.,23,0,48,25
1658140067379,COGS 13,A01,083071,Bastos; Amalia Pinkusfeld,12,0,71,59
1658140073403,COGS 14A,A01,092681,Semenuks; Arturs,5,1,100,95
1658140079427,COGS 14B,A01,083073,Cheng; Tzu-Han,7,0,63,56
1658140085450,COGS 17,A01,092677,Semenuks; Arturs,7,0,81,74
1658140091479,COGS 100,A01,083619,Allen; Michael Gordon,17,0,70,53
1658140097503,COGS 101A,A01,083621,Davis; Joshua Daniel,9,0,68,59
1658140103530,COGS 101B,A01,091572,Allen; Michael Gordon,14,0,65,51
1658140109557,COGS 101C,A01,083625,Delgado; Tania,17,0,35,18
1658140115582,COGS 107A,A01,083627,Boyle; Mary E. T.,14,0,60,46
1658140121609,COGS 118A,A01,083075,Gupta; Anjum,21,0,76,55
1658140127632,CSE 3,A50,083646,Miranda; Gregory Joseph,24,0,50,26
1658140133654,CSE 8A,A50,083650,Miranda; Gregory Joseph,17,1,56,39
1658140139692,CSE 11,A01,083080,Cao; Yingjun,7,15,40,33
1658140145719,CSE 12,A01,083652,Krause-Levy; Sophia Louisa,30,1,120,90
1658140151742,CSE 15L,A01,083654,Morris; Justin Loren,9,0,50,41
1658140151742,CSE 15L,A02,083655,Morris; Justin Loren,11,0,50,39
1658140157764,CSE 20,A01,083657,Tran; Khoa Dang,39,0,80,41
1658140163792,CSE 21,A01,095574,Bach; Quang Tran,23,0,48,25
1658140169815,CSE 30,A01,083084,Eldon; John,8,0,80,72
1658140169815,CSE 30,B01,095061,Bhaskar; Nishant,9,0,50,41
1658140175838,CSE 100,A01,083659,Cao; Yingjun,5,4,70,65
1658140181878,CSE 134B,A01,083661,Powell; Thomas Allan,25,0,100,75
1658140187904,CSE 140,A01,083663,Gungor; Onat,17,0,85,68
1658140193931,CSE 140L,A01,083088,Eldon; John,23,0,100,77
1658140199954,CSE 175,A01,083665,Kumar; Rakesh,3,0,25,22
1658140205979,CSE 190,A00,092507,Dubnov; Shlomo,8,0,20,12
1658140212012,ECE 45,A01,083139,Congero; Spencer William,7,0,75,68
1658140218039,ECE 65,A50,083695,Saad; Andrew S,12,0,30,18
1658140218039,ECE 65,A51,095125,Saad; Andrew S,24,0,26,2
1658140224066,ECE 109,A01,091882,Touri; Behrouz,21,0,70,49
1658140230093,ECE 180,A00,083140,Abi Samra; Nicholas Camill,1,0,30,29
1658140230093,ECE 180,B00,083141,Abi Samra; Nicholas Camill,0,0,30,30
1658140236116,MATH 10A,A01,083735,Patchell; Gregory David,2,0,30,28
1658140236116,MATH 10A,A02,083736,Patchell; Gregory David,20,0,30,10
1658140236116,MATH 10A,A03,083737,Patchell; Gregory David,16,0,30,14
1658140242144,MATH 10B,A01,083207,Lim; Seonhee,9,0,34,25
1658140242144,MATH 10B,A02,083208,Lim; Seonhee,10,0,35,25
1658140242144,MATH 10B,A03,093472,Lim; Seonhee,7,0,34,27
1658140242144,MATH 10B,B01,083739,Sinha; Shubham,14,0,30,16
1658140248191,MATH 18,A01,083743,Cinel; Cameron Alexander,9,0,30,21
1658140248191,MATH 18,A02,083744,Cinel; Cameron Alexander,18,0,30,12
1658140248191,MATH 18,A03,083745,Cinel; Cameron Alexander,10,0,30,20
1658140248191,MATH 18,B01,083748,Rideout; David Porter,5,0,37,32
1658140248191,MATH 18,B02,083749,Rideout; David Porter,5,0,36,31
1658140248191,MATH 18,B03,083750,Rideout; David Porter,3,0,37,34
1658140248191,MATH 18,B04,083751,Rideout; David Porter,7,0,36,29
1658140248191,MATH 18,B05,093473,Rideout; David Porter,7,0,36,29
1658140248191,MATH 18,B06,093474,Rideout; David Porter,6,0,36,30
1658140254218,MATH 20A,A01,083754,Zheng; Zequn,14,0,40,26
1658140260241,MATH 20B,A01,083756,Briones; Jor-el Thomas Caparas,4,0,36,32
1658140260241,MATH 20B,A02,083757,Briones; Jor-el Thomas Caparas,1,0,36,35
1658140260241,MATH 20B,A03,093475,Briones; Jor-el Thomas Caparas,3,0,36,33
1658140266277,MATH 20C,A01,083760,Briones; Jor-el Thomas Caparas,1,0,35,34
1658140266277,MATH 20C,A02,083761,Briones; Jor-el Thomas Caparas,8,0,35,27
1658140266277,MATH 20C,A03,093476,Briones; Jor-el Thomas Caparas,0,1,36,36
1658140266277,MATH 20C,B01,083762,Bach; Quang Tran,1,0,30,29
1658140272300,MATH 20D,A01,083765,Tran; Brian Kha,5,0,30,25
1658140272300,MATH 20D,A02,083766,Tran; Brian Kha,5,0,30,25
1658140272300,MATH 20D,A03,083767,Tran; Brian Kha,6,0,30,24
1658140278329,MATH 20E,A01,083771,Ganguly; Soumya,12,0,32,20
1658140278329,MATH 20E,A02,083772,Ganguly; Soumya,7,0,32,25
1658140278329,MATH 20E,B01,083773,Ciotti; Benjamin,20,0,35,15
1658140278329,MATH 20E,B02,083774,Ciotti; Benjamin,18,0,35,17
1658140284359,MATH 103A,A01,083777,Greenfeld; Be'Eri,6,0,36,30
1658140284359,MATH 103A,A02,083778,Greenfeld; Be'Eri,5,0,36,31
1658140284359,MATH 103A,A03,093561,Greenfeld; Be'Eri,7,0,36,29
1658140284359,MATH 103A,B01,083779,Greenfeld; Be'Eri,8,0,36,28
1658140284359,MATH 103A,B02,083780,Greenfeld; Be'Eri,4,0,36,32
1658140284359,MATH 103A,B03,093562,Greenfeld; Be'Eri,3,0,36,33
1658140290387,MATH 105,A01,085443,Carter; Anne Toulson,15,0,35,20
1658140290387,MATH 105,A02,093477,Carter; Anne Toulson,20,0,35,15
1658140296484,MATH 109,A01,083213,Ganzberger; Geoffrey Michael,3,0,34,31
1658140296484,MATH 109,A02,083214,Ganzberger; Geoffrey Michael,4,0,34,30
1658140296484,MATH 109,A03,093478,Ganzberger; Geoffrey Michael,2,0,34,32
1658140296484,MATH 109,B01,083215,Ganzberger; Geoffrey Michael,3,0,32,29
1658140296484,MATH 109,B02,083216,Ganzberger; Geoffrey Michael,3,0,32,29
1658140296484,MATH 109,B03,093479,Ganzberger; Geoffrey Michael,8,0,32,24
1658140302508,MATH 142A,A01,083219,Chow; Bennett,7,0,32,25
1658140302508,MATH 142A,A02,083220,Chow; Bennett,10,0,32,22
1658140302508,MATH 142A,A03,093480,Chow; Bennett,9,0,32,23
1658140302508,MATH 142A,B03,093481,Chow; Bennett,8,0,32,24
1658140302508,MATH 142A,B04,093558,Chow; Bennett,14,0,32,18
1658140302508,MATH 142A,B05,093559,Chow; Bennett,7,0,32,25
1658140308533,MATH 193A,A01,083224,Rotar; Vladimir,9,0,34,25
1658140308533,MATH 193A,A02,083225,Rotar; Vladimir,11,0,34,23
1658140308533,MATH 193A,A03,083781,Rotar; Vladimir,5,0,34,29
1658140308533,MATH 193A,A04,083782,Rotar; Vladimir,12,0,34,22
1658140308533,MATH 193A,A05,093482,Rotar; Vladimir,11,0,34,23
1658140314556,MATH 197,001,091859,McAuley; Julian John,9999,0,9999,0
1658140314556,MATH 197,002,095566,Kedlaya; Kiran S.,9997,0,9999,2
1658140314556,MATH 197,003,095567,Xiao; Ming,9999,0,9999,0
1658140314556,MATH 197,004,095571,Perols; Johan Lars,9998,0,9999,1
1658140321622,COGS 9,A01,083615,Shannon; Kyle Michael,11,0,75,64
1658140327645,COGS 11,A01,083617,Boyle; Mary E. T.,23,0,48,25
1658140333672,COGS 13,A01,083071,Bastos; Amalia Pinkusfeld,12,0,71,59
1658140339696,COGS 14A,A01,092681,Semenuks; Arturs,5,1,100,95
1658140345724,COGS 14B,A01,083073,Cheng; Tzu-Han,7,0,63,56
1658140351764,COGS 17,A01,092677,Semenuks; Arturs,7,0,81,74
1658140357786,COGS 100,A01,083619,Allen; Michael Gordon,17,0,70,53
1658140363818,COGS 101A,A01,083621,Davis; Joshua Daniel,9,0,68,59
1658140369844,COGS 101B,A01,091572,Allen; Michael Gordon,14,0,65,51
1658140375866,COGS 101C,A01,083625,Delgado; Tania,17,0,35,18
1658140381894,COGS 107A,A01,083627,Boyle; Mary E. T.,14,0,60,46
1658140387917,COGS 118A,A01,083075,Gupta; Anjum,21,0,76,55
1658140393950,CSE 3,A50,083646,Miranda; Gregory Joseph,24,0,50,26
1658140399988,CSE 8A,A50,083650,Miranda; Gregory Joseph,17,1,56,39
1658140406011,CSE 11,A01,083080,Cao; Yingjun,7,15,40,33
1658140412034,CSE 12,A01,083652,Krause-Levy; Sophia Louisa,30,1,120,90
1658140418063,CSE 15L,A01,083654,Morris; Justin Loren,9,0,50,41
1658140418063,CSE 15L,A02,083655,Morris; Justin Loren,11,0,50,39
1658140424087,CSE 20,A01,083657,Tran; Khoa Dang,39,0,80,41
1658140430114,CSE 21,A01,095574,Bach; Quang Tran,23,0,48,25
1658140436138,CSE 30,A01,083084,Eldon; John,8,0,80,72
1658140436138,CSE 30,B01,095061,Bhaskar; Nishant,9,0,50,41
1658140442164,CSE 100,A01,083659,Cao; Yingjun,5,4,70,65
1658140448202,CSE 134B,A01,083661,Powell; Thomas Allan,25,0,100,75
1658140454229,CSE 140,A01,083663,Gungor; Onat,17,0,85,68
1658140460252,CSE 140L,A01,083088,Eldon; John,23,0,100,77
1658140466277,CSE 175,A01,083665,Kumar; Rakesh,3,0,25,22
1658140472304,CSE 190,A00,092507,Dubnov; Shlomo,8,0,20,12
1658140478328,ECE 45,A01,083139,Congero; Spencer William,7,0,75,68
1658140484352,ECE 65,A50,083695,Saad; Andrew S,12,0,30,18
1658140484352,ECE 65,A51,095125,Saad; Andrew S,24,0,26,2
1658140490378,ECE 109,A01,091882,Touri; Behrouz,21,0,70,49
1658140496400,ECE 180,A00,083140,Abi Samra; Nicholas Camill,1,0,30,29
1658140496400,ECE 180,B00,083141,Abi Samra; Nicholas Camill,0,0,30,30
1658140502425,MATH 10A,A01,083735,Patchell; Gregory David,2,0,30,28
1658140502425,MATH 10A,A02,083736,Patchell; Gregory David,20,0,30,10
1658140502425,MATH 10A,A03,083737,Patchell; Gregory David,16,0,30,14
1658140508455,MATH 10B,A01,083207,Lim; Seonhee,9,0,34,25
1658140508455,MATH 10B,A02,083208,Lim; Seonhee,10,0,35,25
1658140508455,MATH 10B,A03,093472,Lim; Seonhee,7,0,34,27
1658140508455,MATH 10B,B01,083739,Sinha; Shubham,14,0,30,16
1658140514480,MATH 18,A01,083743,Cinel; Cameron Alexander,9,0,30,21
1658140514480,MATH 18,A02,083744,Cinel; Cameron Alexander,18,0,30,12
1658140514480,MATH 18,A03,083745,Cinel; Cameron Alexander,10,0,30,20
1658140514480,MATH 18,B01,083748,Rideout; David Porter,5,0,37,32
1658140514480,MATH 18,B02,083749,Rideout; David Porter,5,0,36,31
1658140514480,MATH 18,B03,083750,Rideout; David Porter,3,0,37,34
1658140514480,MATH 18,B04,083751,Rideout; David Porter,7,0,36,29
1658140514480,MATH 18,B05,093473,Rideout; David Porter,7,0,36,29
1658140514480,MATH 18,B06,093474,Rideout; David Porter,6,0,36,30
1658140520504,MATH 20A,A01,083754,Zheng; Zequn,14,0,40,26
1658140526532,MATH 20B,A01,083756,Briones; Jor-el Thomas Caparas,4,0,36,32
1658140526532,MATH 20B,A02,083757,Briones; Jor-el Thomas Caparas,1,0,36,35
1658140526532,MATH 20B,A03,093475,Briones; Jor-el Thomas Caparas,3,0,36,33
1658140532561,MATH 20C,A01,083760,Briones; Jor-el Thomas Caparas,1,0,35,34
1658140532561,MATH 20C,A02,083761,Briones; Jor-el Thomas Caparas,8,0,35,27
1658140532561,MATH 20C,A03,093476,Briones; Jor-el Thomas Caparas,0,1,36,36
1658140532561,MATH 20C,B01,083762,Bach; Quang Tran,1,0,30,29
1658140538589,MATH 20D,A01,083765,Tran; Brian Kha,5,0,30,25
1658140538589,MATH 20D,A02,083766,Tran; Brian Kha,5,0,30,25
1658140538589,MATH 20D,A03,083767,Tran; Brian Kha,6,0,30,24
1658140544619,MATH 20E,A01,083771,Ganguly; Soumya,12,0,32,20
1658140544619,MATH 20E,A02,083772,Ganguly; Soumya,7,0,32,25
1658140544619,MATH 20E,B01,083773,Ciotti; Benjamin,20,0,35,15
1658140544619,MATH 20E,B02,083774,Ciotti; Benjamin,18,0,35,17
1658140550644,MATH 103A,A01,083777,Greenfeld; Be'Eri,6,0,36,30
1658140550644,MATH 103A,A02,083778,Greenfeld; Be'Eri,5,0,36,31
1658140550644,MATH 103A,A03,093561,Greenfeld; Be'Eri,7,0,36,29
1658140550644,MATH 103A,B01,083779,Greenfeld; Be'Eri,8,0,36,28
1658140550644,MATH 103A,B02,083780,Greenfeld; Be'Eri,4,0,36,32
1658140550644,MATH 103A,B03,093562,Greenfeld; Be'Eri,3,0,36,33
1658140556674,MATH 105,A01,085443,Carter; Anne Toulson,15,0,35,20
1658140556674,MATH 105,A02,093477,Carter; Anne Toulson,20,0,35,15
1658140562714,MATH 109,A01,083213,Ganzberger; Geoffrey Michael,3,0,34,31
1658140562714,MATH 109,A02,083214,Ganzberger; Geoffrey Michael,4,0,34,30
1658140562714,MATH 109,A03,093478,Ganzberger; Geoffrey Michael,2,0,34,32
1658140562714,MATH 109,B01,083215,Ganzberger; Geoffrey Michael,3,0,32,29
1658140562714,MATH 109,B02,083216,Ganzberger; Geoffrey Michael,3,0,32,29
1658140562714,MATH 109,B03,093479,Ganzberger; Geoffrey Michael,8,0,32,24
1658140568743,MATH 142A,A01,083219,Chow; Bennett,7,0,32,25
1658140568743,MATH 142A,A02,083220,Chow; Bennett,10,0,32,22
1658140568743,MATH 142A,A03,093480,Chow; Bennett,9,0,32,23
1658140568743,MATH 142A,B03,093481,Chow; Bennett,8,0,32,24
1658140568743,MATH 142A,B04,093558,Chow; Bennett,14,0,32,18
1658140568743,MATH 142A,B05,093559,Chow; Bennett,7,0,32,25
1658140574780,MATH 193A,A01,083224,Rotar; Vladimir,9,0,34,25
1658140574780,MATH 193A,A02,083225,Rotar; Vladimir,11,0,34,23
1658140574780,MATH 193A,A03,083781,Rotar; Vladimir,5,0,34,29
1658140574780,MATH 193A,A04,083782,Rotar; Vladimir,12,0,34,22
1658140574780,MATH 193A,A05,093482,Rotar; Vladimir,11,0,34,23
1658140580803,MATH 197,001,091859,McAuley; Julian John,9999,0,9999,0
1658140580803,MATH 197,002,095566,Kedlaya; Kiran S.,9997,0,9999,2
1658140580803,MATH 197,003,095567,Xiao; Ming,9999,0,9999,0
1658140580803,MATH 197,004,095571,Perols; Johan Lars,9998,0,9999,1
1658140587886,COGS 9,A01,083615,Shannon; Kyle Michael,11,0,75,64
1658140593921,COGS 11,A01,083617,Boyle; Mary E. T.,23,0,48,25
1658140599952,COGS 13,A01,083071,Bastos; Amalia Pinkusfeld,12,0,71,59
1658140605980,COGS 14A,A01,092681,Semenuks; Arturs,5,1,100,95
1658140612005,COGS 14B,A01,083073,Cheng; Tzu-Han,7,0,63,56
1658140618028,COGS 17,A01,092677,Semenuks; Arturs,7,0,81,74
1658140624057,COGS 100,A01,083619,Allen; Michael Gordon,17,0,70,53
1658140630082,COGS 101A,A01,083621,Davis; Joshua Daniel,9,0,68,59
1658140636107,COGS 101B,A01,091572,Allen; Michael Gordon,14,0,65,51
1658140642131,COGS 101C,A01,083625,Delgado; Tania,17,0,35,18
1658140648155,COGS 107A,A01,083627,Boyle; Mary E. T.,14,0,60,46
1658140654179,COGS 118A,A01,083075,Gupta; Anjum,21,0,76,55
1658140660205,CSE 3,A50,083646,Miranda; Gregory Joseph,24,0,50,26
1658140666235,CSE 8A,A50,083650,Miranda; Gregory Joseph,17,1,56,39
1658140672259,CSE 11,A01,083080,Cao; Yingjun,7,15,40,33
1658140678284,CSE 12,A01,083652,Krause-Levy; Sophia Louisa,30,1,120,90
1658140684312,CSE 15L,A01,083654,Morris; Justin Loren,9,0,50,41
1658140684312,CSE 15L,A02,083655,Morris; Justin Loren,11,0,50,39
1658140690367,CSE 20,A01,083657,Tran; Khoa Dang,39,0,80,41
1658140696395,CSE 21,A01,095574,Bach; Quang Tran,23,0,48,25
1658140702420,CSE 30,A01,083084,Eldon; John,8,0,80,72
1658140702420,CSE 30,B01,095061,Bhaskar; Nishant,9,0,50,41
1658140708445,CSE 100,A01,083659,Cao; Yingjun,5,4,70,65
1658140714470,CSE 134B,A01,083661,Powell; Thomas Allan,25,0,100,75
1658140720492,CSE 140,A01,083663,Gungor; Onat,17,0,85,68
1658140726515,CSE 140L,A01,083088,Eldon; John,23,0,100,77
1658140732540,CSE 175,A01,083665,Kumar; Rakesh,3,0,25,22
1658140738566,CSE 190,A00,092507,Dubnov; Shlomo,8,0,20,12
1658140744593,ECE 45,A01,083139,Congero; Spencer William,7,0,75,68
1658140750620,ECE 65,A50,083695,Saad; Andrew S,12,0,30,18
1658140750620,ECE 65,A51,095125,Saad; Andrew S,24,0,26,2
1658140756649,ECE 109,A01,091882,Touri; Behrouz,21,0,70,49
1658140762677,ECE 180,A00,083140,Abi Samra; Nicholas Camill,1,0,30,29
1658140762677,ECE 180,B00,083141,Abi Samra; Nicholas Camill,0,0,30,30
1658140768709,MATH 10A,A01,083735,Patchell; Gregory David,2,0,30,28
1658140768709,MATH 10A,A02,083736,Patchell; Gregory David,20,0,30,10
1658140768709,MATH 10A,A03,083737,Patchell; Gregory David,16,0,30,14
1658140774749,MATH 10B,A01,083207,Lim; Seonhee,9,0,34,25
1658140774749,MATH 10B,A02,083208,Lim; Seonhee,10,0,35,25
1658140774749,MATH 10B,A03,093472,Lim; Seonhee,7,0,34,27
1658140774749,MATH 10B,B01,083739,Sinha; Shubham,14,0,30,16
1658140780787,MATH 18,A01,083743,Cinel; Cameron Alexander,9,0,30,21
1658140780787,MATH 18,A02,083744,Cinel; Cameron Alexander,18,0,30,12
1658140780787,MATH 18,A03,083745,Cinel; Cameron Alexander,10,0,30,20
1658140780787,MATH 18,B01,083748,Rideout; David Porter,5,0,37,32
1658140780787,MATH 18,B02,083749,Rideout; David Porter,5,0,36,31
1658140780787,MATH 18,B03,083750,Rideout; David Porter,3,0,37,34
1658140780787,MATH 18,B04,083751,Rideout; David Porter,7,0,36,29
1658140780787,MATH 18,B05,093473,Rideout; David Porter,7,0,36,29
1658140780787,MATH 18,B06,093474,Rideout; David Porter,6,0,36,30
1658140786810,MATH 20A,A01,083754,Zheng; Zequn,14,0,40,26
1658140792835,MATH 20B,A01,083756,Briones; Jor-el Thomas Caparas,4,0,36,32
1658140792835,MATH 20B,A02,083757,Briones; Jor-el Thomas Caparas,1,0,36,35
1658140792835,MATH 20B,A03,093475,Briones; Jor-el Thomas Caparas,3,0,36,33
1658140798867,MATH 20C,A01,083760,Briones; Jor-el Thomas Caparas,1,0,35,34
1658140798867,MATH 20C,A02,083761,Briones; Jor-el Thomas Caparas,8,0,35,27
1658140798867,MATH 20C,A03,093476,Briones; Jor-el Thomas Caparas,0,1,36,36
1658140798867,MATH 20C,B01,083762,Bach; Quang Tran,1,0,30,29
1658140804897,MATH 20D,A01,083765,Tran; Brian Kha,5,0,30,25
1658140804897,MATH 20D,A02,083766,Tran; Brian Kha,5,0,30,25
1658140804897,MATH 20D,A03,083767,Tran; Brian Kha,6,0,30,24
1658140810931,MATH 20E,A01,083771,Ganguly; Soumya,12,0,32,20
1658140810931,MATH 20E,A02,083772,Ganguly; Soumya,7,0,32,25
1658140810931,MATH 20E,B01,083773,Ciotti; Benjamin,20,0,35,15
1658140810931,MATH 20E,B02,083774,Ciotti; Benjamin,18,0,35,17
1658140816967,MATH 103A,A01,083777,Greenfeld; Be'Eri,6,0,36,30
1658140816967,MATH 103A,A02,083778,Greenfeld; Be'Eri,5,0,36,31
1658140816967,MATH 103A,A03,093561,Greenfeld; Be'Eri,7,0,36,29
1658140816967,MATH 103A,B01,083779,Greenfeld; Be'Eri,8,0,36,28
1658140816967,MATH 103A,B02,083780,Greenfeld; Be'Eri,4,0,36,32
1658140816967,MATH 103A,B03,093562,Greenfeld; Be'Eri,3,0,36,33
1658140823002,MATH 105,A01,085443,Carter; Anne Toulson,15,0,35,20
1658140823002,MATH 105,A02,093477,Carter; Anne Toulson,20,0,35,15
1658140829027,MATH 109,A01,083213,Ganzberger; Geoffrey Michael,3,0,34,31
1658140829027,MATH 109,A02,083214,Ganzberger; Geoffrey Michael,4,0,34,30
1658140829027,MATH 109,A03,093478,Ganzberger; Geoffrey Michael,2,0,34,32
1658140829027,MATH 109,B01,083215,Ganzberger; Geoffrey Michael,3,0,32,29
1658140829027,MATH 109,B02,083216,Ganzberger; Geoffrey Michael,3,0,32,29
1658140829027,MATH 109,B03,093479,Ganzberger; Geoffrey Michael,8,0,32,24
1658140835070,MATH 142A,A01,083219,Chow; Bennett,7,0,32,25
1658140835070,MATH 142A,A02,083220,Chow; Bennett,10,0,32,22
1658140835070,MATH 142A,A03,093480,Chow; Bennett,9,0,32,23
1658140835070,MATH 142A,B03,093481,Chow; Bennett,8,0,32,24
1658140835070,MATH 142A,B04,093558,Chow; Bennett,14,0,32,18
1658140835070,MATH 142A,B05,093559,Chow; Bennett,7,0,32,25
1658140841095,MATH 193A,A01,083224,Rotar; Vladimir,9,0,34,25
1658140841095,MATH 193A,A02,083225,Rotar; Vladimir,11,0,34,23
1658140841095,MATH 193A,A03,083781,Rotar; Vladimir,5,0,34,29
1658140841095,MATH 193A,A04,083782,Rotar; Vladimir,12,0,34,22
1658140841095,MATH 193A,A05,093482,Rotar; Vladimir,11,0,34,23
1658140847120,MATH 197,001,091859,McAuley; Julian John,9999,0,9999,0
1658140847120,MATH 197,002,095566,Kedlaya; Kiran S.,9997,0,9999,2
1658140847120,MATH 197,003,095567,Xiao; Ming,9999,0,9999,0
1658140847120,MATH 197,004,095571,Perols; Johan Lars,9998,0,9999,1
1658140854199,COGS 9,A01,083615,Shannon; Kyle Michael,11,0,75,64
1658140860229,COGS 11,A01,083617,Boyle; Mary E. T.,23,0,48,25
1658140866260,COGS 13,A01,083071,Bastos; Amalia Pinkusfeld,12,0,71,59
1658140872285,COGS 14A,A01,092681,Semenuks; Arturs,5,1,100,95
1658140878311,COGS 14B,A01,083073,Cheng; Tzu-Han,7,0,63,56
1658140884341,COGS 17,A01,092677,Semenuks; Arturs,7,0,81,74
1658140890440,COGS 100,A01,083619,Allen; Michael Gordon,17,0,70,53
1658140896472,COGS 101A,A01,083621,Davis; Joshua Daniel,9,0,68,59
1658140902497,COGS 101B,A01,091572,Allen; Michael Gordon,14,0,65,51
1658140908527,COGS 101C,A01,083625,Delgado; Tania,17,0,35,18
1658140914552,COGS 107A,A01,083627,Boyle; Mary E. T.,14,0,60,46
1658140920584,COGS 118A,A01,083075,Gupta; Anjum,21,0,76,55
1658140926611,CSE 3,A50,083646,Miranda; Gregory Joseph,24,0,50,26
1658140932640,CSE 8A,A50,083650,Miranda; Gregory Joseph,17,1,56,39
1658140938666,CSE 11,A01,083080,Cao; Yingjun,7,15,40,33
1658140944697,CSE 12,A01,083652,Krause-Levy; Sophia Louisa,30,1,120,90
1658140950727,CSE 15L,A01,083654,Morris; Justin Loren,9,0,50,41
1658140950727,CSE 15L,A02,083655,Morris; Justin Loren,11,0,50,39
1658140956751,CSE 20,A01,083657,Tran; Khoa Dang,39,0,80,41
1658140962775,CSE 21,A01,095574,Bach; Quang Tran,23,0,48,25
1658140968800,CSE 30,A01,083084,Eldon; John,8,0,80,72
1658140968800,CSE 30,B01,095061,Bhaskar; Nishant,9,0,50,41
1658140974826,CSE 100,A01,083659,Cao; Yingjun,5,4,70,65
1658140980855,CSE 134B,A01,083661,Powell; Thomas Allan,25,0,100,75
1658140986884,CSE 140,A01,083663,Gungor; Onat,17,0,85,68
1658140992908,CSE 140L,A01,083088,Eldon; John,23,0,100,77
1658140998933,CSE 175,A01,083665,Kumar; Rakesh,3,0,25,22
1658141004959,CSE 190,A00,092507,Dubnov; Shlomo,8,0,20,12
1658141010985,ECE 45,A01,083139,Congero; Spencer William,7,0,75,68
1658141017012,ECE 65,A50,083695,Saad; Andrew S,12,0,30,18
1658141017012,ECE 65,A51,095125,Saad; Andrew S,24,0,26,2
1658141023040,ECE 109,A01,091882,Touri; Behrouz,21,0,70,49
1658141029076,ECE 180,A00,083140,Abi Samra; Nicholas Camill,1,0,30,29
1658141029076,ECE 180,B00,083141,Abi Samra; Nicholas Camill,0,0,30,30
1658141035102,MATH 10A,A01,083735,Patchell; Gregory David,2,0,30,28
1658141035102,MATH 10A,A02,083736,Patchell; Gregory David,20,0,30,10
1658141035102,MATH 10A,A03,083737,Patchell; Gregory David,16,0,30,14
1658141041138,MATH 10B,A01,083207,Lim; Seonhee,9,0,34,25
1658141041138,MATH 10B,A02,083208,Lim; Seonhee,10,0,35,25
1658141041138,MATH 10B,A03,093472,Lim; Seonhee,7,0,34,27
1658141041138,MATH 10B,B01,083739,Sinha; Shubham,14,0,30,16
1658141047178,MATH 18,A01,083743,Cinel; Cameron Alexander,9,0,30,21
1658141047178,MATH 18,A02,083744,Cinel; Cameron Alexander,18,0,30,12
1658141047178,MATH 18,A03,083745,Cinel; Cameron Alexander,10,0,30,20
1658141047178,MATH 18,B01,083748,Rideout; David Porter,5,0,37,32
1658141047178,MATH 18,B02,083749,Rideout; David Porter,5,0,36,31
1658141047178,MATH 18,B03,083750,Rideout; David Porter,3,0,37,34
1658141047178,MATH 18,B04,083751,Rideout; David Porter,7,0,36,29
1658141047178,MATH 18,B05,093473,Rideout; David Porter,7,0,36,29
1658141047178,MATH 18,B06,093474,Rideout; David Porter,6,0,36,30
1658141053210,MATH 20A,A01,083754,Zheng; Zequn,14,0,40,26
1658141059245,MATH 20B,A01,083756,Briones; Jor-el Thomas Caparas,4,0,36,32
1658141059245,MATH 20B,A02,083757,Briones; Jor-el Thomas Caparas,1,0,36,35
1658141059245,MATH 20B,A03,093475,Briones; Jor-el Thomas Caparas,3,0,36,33
1658141065278,MATH 20C,A01,083760,Briones; Jor-el Thomas Caparas,1,0,35,34
1658141065278,MATH 20C,A02,083761,Briones; Jor-el Thomas Caparas,8,0,35,27
1658141065278,MATH 20C,A03,093476,Briones; Jor-el Thomas Caparas,0,1,36,36
1658141065278,MATH 20C,B01,083762,Bach; Quang Tran,1,0,30,29
1658141071310,MATH 20D,A01,083765,Tran; Brian Kha,5,0,30,25
1658141071310,MATH 20D,A02,083766,Tran; Brian Kha,5,0,30,25
1658141071310,MATH 20D,A03,083767,Tran; Brian Kha,6,0,30,24
1658141077337,MATH 20E,A01,083771,Ganguly; Soumya,12,0,32,20
1658141077337,MATH 20E,A02,083772,Ganguly; Soumya,7,0,32,25
1658141077337,MATH 20E,B01,083773,Ciotti; Benjamin,20,0,35,15
1658141077337,MATH 20E,B02,083774,Ciotti; Benjamin,18,0,35,17
1658141083373,MATH 103A,A01,083777,Greenfeld; Be'Eri,6,0,36,30
1658141083373,MATH 103A,A02,083778,Greenfeld; Be'Eri,5,0,36,31
1658141083373,MATH 103A,A03,093561,Greenfeld; Be'Eri,7,0,36,29
1658141083373,MATH 103A,B01,083779,Greenfeld; Be'Eri,8,0,36,28
1658141083373,MATH 103A,B02,083780,Greenfeld; Be'Eri,4,0,36,32
1658141083373,MATH 103A,B03,093562,Greenfeld; Be'Eri,3,0,36,33
1658141089398,MATH 105,A01,085443,Carter; Anne Toulson,15,0,35,20
1658141089398,MATH 105,A02,093477,Carter; Anne Toulson,20,0,35,15
1658141095427,MATH 109,A01,083213,Ganzberger; Geoffrey Michael,3,0,34,31
1658141095427,MATH 109,A02,083214,Ganzberger; Geoffrey Michael,4,0,34,30
1658141095427,MATH 109,A03,093478,Ganzberger; Geoffrey Michael,2,0,34,32
1658141095427,MATH 109,B01,083215,Ganzberger; Geoffrey Michael,3,0,32,29
1658141095427,MATH 109,B02,083216,Ganzberger; Geoffrey Michael,3,0,32,29
1658141095427,MATH 109,B03,093479,Ganzberger; Geoffrey Michael,8,0,32,24
1658141101464,MATH 142A,A01,083219,Chow; Bennett,7,0,32,25
1658141101464,MATH 142A,A02,083220,Chow; Bennett,10,0,32,22
1658141101464,MATH 142A,A03,093480,Chow; Bennett,9,0,32,23
1658141101464,MATH 142A,B03,093481,Chow; Bennett,8,0,32,24
1658141101464,MATH 142A,B04,093558,Chow; Bennett,14,0,32,18
1658141101464,MATH 142A,B05,093559,Chow; Bennett,7,0,32,25
1658141107488,MATH 193A,A01,083224,Rotar; Vladimir,9,0,34,25
1658141107488,MATH 193A,A02,083225,Rotar; Vladimir,11,0,34,23
1658141107488,MATH 193A,A03,083781,Rotar; Vladimir,5,0,34,29
1658141107488,MATH 193A,A04,083782,Rotar; Vladimir,12,0,34,22
1658141107488,MATH 193A,A05,093482,Rotar; Vladimir,11,0,34,23
1658141113513,MATH 197,001,091859,McAuley; Julian John,9999,0,9999,0
1658141113513,MATH 197,002,095566,Kedlaya; Kiran S.,9997,0,9999,2
1658141113513,MATH 197,003,095567,Xiao; Ming,9999,0,9999,0
1658141113513,MATH 197,004,095571,Perols; Johan Lars,9998,0,9999,1
1658141120593,COGS 9,A01,083615,Shannon; Kyle Michael,11,0,75,64
1658141126617,COGS 11,A01,083617,Boyle; Mary E. T.,23,0,48,25
1658141132643,COGS 13,A01,083071,Bastos; Amalia Pinkusfeld,12,0,71,59
1658141138669,COGS 14A,A01,092681,Semenuks; Arturs,5,1,100,95
1658141144698,COGS 14B,A01,083073,Cheng; Tzu-Han,7,0,63,56
1658141150728,COGS 17,A01,092677,Semenuks; Arturs,7,0,81,74
1658141156756,COGS 100,A01,083619,Allen; Michael Gordon,17,0,70,53
1658141162781,COGS 101A,A01,083621,Davis; Joshua Daniel,9,0,68,59
1658141168805,COGS 101B,A01,091572,Allen; Michael Gordon,14,0,65,51
1658141174834,COGS 101C,A01,083625,Delgado; Tania,17,0,35,18
1658141180864,COGS 107A,A01,083627,Boyle; Mary E. T.,14,0,60,46
1658141186892,COGS 118A,A01,083075,Gupta; Anjum,21,0,76,55
1658141192924,CSE 3,A50,083646,Miranda; Gregory Joseph,24,0,50,26
1658141198948,CSE 8A,A50,083650,Miranda; Gregory Joseph,17,1,56,39
1658141204975,CSE 11,A01,083080,Cao; Yingjun,7,15,40,33
1658141211007,CSE 12,A01,083652,Krause-Levy; Sophia Louisa,30,1,120,90
1658141217031,CSE 15L,A01,083654,Morris; Justin Loren,9,0,50,41
1658141217031,CSE 15L,A02,083655,Morris; Justin Loren,11,0,50,39
1658141223057,CSE 20,A01,083657,Tran; Khoa Dang,39,0,80,41
1658141229081,CSE 21,A01,095574,Bach; Quang Tran,23,0,48,25
1658141235113,CSE 30,A01,083084,Eldon; John,8,0,80,72
1658141235113,CSE 30,B01,095061,Bhaskar; Nishant,9,0,50,41
1658141241142,CSE 100,A01,083659,Cao; Yingjun,5,4,70,65
1658141247166,CSE 134B,A01,083661,Powell; Thomas Allan,25,0,100,75
1658141253190,CSE 140,A01,083663,Gungor; Onat,17,0,85,68
1658141259213,CSE 140L,A01,083088,Eldon; John,23,0,100,77
1658141265236,CSE 175,A01,083665,Kumar; Rakesh,3,0,25,22
1658141271261,CSE 190,A00,092507,Dubnov; Shlomo,8,0,20,12
1658141277294,ECE 45,A01,083139,Congero; Spencer William,7,0,75,68
1658141283319,ECE 65,A50,083695,Saad; Andrew S,12,0,30,18
1658141283319,ECE 65,A51,095125,Saad; Andrew S,24,0,26,2
1658141289350,ECE 109,A01,091882,Touri; Behrouz,21,0,70,49
1658141295377,ECE 180,A00,083140,Abi Samra; Nicholas Camill,1,0,30,29
1658141295377,ECE 180,B00,083141,Abi Samra; Nicholas Camill,0,0,30,30
1658141301404,MATH 10A,A01,083735,Patchell; Gregory David,2,0,30,28
1658141301404,MATH 10A,A02,083736,Patchell; Gregory David,20,0,30,10
1658141301404,MATH 10A,A03,083737,Patchell; Gregory David,16,0,30,14
1658141307430,MATH 10B,A01,083207,Lim; Seonhee,9,0,34,25
1658141307430,MATH 10B,A02,083208,Lim; Seonhee,10,0,35,25
1658141307430,MATH 10B,A03,093472,Lim; Seonhee,7,0,34,27
1658141307430,MATH 10B,B01,083739,Sinha; Shubham,14,0,30,16
1658141313462,MATH 18,A01,083743,Cinel; Cameron Alexander,9,0,30,21
1658141313462,MATH 18,A02,083744,Cinel; Cameron Alexander,18,0,30,12
1658141313462,MATH 18,A03,083745,Cinel; Cameron Alexander,10,0,30,20
1658141313462,MATH 18,B01,083748,Rideout; David Porter,5,0,37,32
1658141313462,MATH 18,B02,083749,Rideout; David Porter,5,0,36,31
1658141313462,MATH 18,B03,083750,Rideout; David Porter,3,0,37,34
1658141313462,MATH 18,B04,083751,Rideout; David Porter,7,0,36,29
1658141313462,MATH 18,B05,093473,Rideout; David Porter,7,0,36,29
1658141313462,MATH 18,B06,093474,Rideout; David Porter,6,0,36,30
1658141319488,MATH 20A,A01,083754,Zheng; Zequn,14,0,40,26
1658141325513,MATH 20B,A01,083756,Briones; Jor-el Thomas Caparas,4,0,36,32
1658141325513,MATH 20B,A02,083757,Briones; Jor-el Thomas Caparas,1,0,36,35
1658141325513,MATH 20B,A03,093475,Briones; Jor-el Thomas Caparas,3,0,36,33
1658141331543,MATH 20C,A01,083760,Briones; Jor-el Thomas Caparas,1,0,35,34
1658141331543,MATH 20C,A02,083761,Briones; Jor-el Thomas Caparas,8,0,35,27
1658141331543,MATH 20C,A03,093476,Briones; Jor-el Thomas Caparas,0,1,36,36
1658141331543,MATH 20C,B01,083762,Bach; Quang Tran,1,0,30,29
1658141337569,MATH 20D,A01,083765,Tran; Brian Kha,5,0,30,25
1658141337569,MATH 20D,A02,083766,Tran; Brian Kha,5,0,30,25
1658141337569,MATH 20D,A03,083767,Tran; Brian Kha,6,0,30,24
1658141343604,MATH 20E,A01,083771,Ganguly; Soumya,12,0,32,20
1658141343604,MATH 20E,A02,083772,Ganguly; Soumya,7,0,32,25
1658141343604,MATH 20E,B01,083773,Ciotti; Benjamin,20,0,35,15
1658141343604,MATH 20E,B02,083774,Ciotti; Benjamin,18,0,35,17
1658141349629,MATH 103A,A01,083777,Greenfeld; Be'Eri,6,0,36,30
1658141349629,MATH 103A,A02,083778,Greenfeld; Be'Eri,5,0,36,31
1658141349629,MATH 103A,A03,093561,Greenfeld; Be'Eri,7,0,36,29
1658141349629,MATH 103A,B01,083779,Greenfeld; Be'Eri,8,0,36,28
1658141349629,MATH 103A,B02,083780,Greenfeld; Be'Eri,4,0,36,32
1658141349629,MATH 103A,B03,093562,Greenfeld; Be'Eri,3,0,36,33
1658141355654,MATH 105,A01,085443,Carter; Anne Toulson,15,0,35,20
1658141355654,MATH 105,A02,093477,Carter; Anne Toulson,20,0,35,15
1658141361683,MATH 109,A01,083213,Ganzberger; Geoffrey Michael,3,0,34,31
1658141361683,MATH 109,A02,083214,Ganzberger; Geoffrey Michael,4,0,34,30
1658141361683,MATH 109,A03,093478,Ganzberger; Geoffrey Michael,2,0,34,32
1658141361683,MATH 109,B01,083215,Ganzberger; Geoffrey Michael,3,0,32,29
1658141361683,MATH 109,B02,083216,Ganzberger; Geoffrey Michael,3,0,32,29
1658141361683,MATH 109,B03,093479,Ganzberger; Geoffrey Michael,8,0,32,24
1658141367715,MATH 142A,A01,083219,Chow; Bennett,7,0,32,25
1658141367715,MATH 142A,A02,083220,Chow; Bennett,10,0,32,22
1658141367715,MATH 142A,A03,093480,Chow; Bennett,9,0,32,23
1658141367715,MATH 142A,B03,093481,Chow; Bennett,8,0,32,24
1658141367715,MATH 142A,B04,093558,Chow; Bennett,14,0,32,18
1658141367715,MATH 142A,B05,093559,Chow; Bennett,7,0,32,25
1658141373744,MATH 193A,A01,083224,Rotar; Vladimir,9,0,34,25
1658141373744,MATH 193A,A02,083225,Rotar; Vladimir,11,0,34,23
1658141373744,MATH 193A,A03,083781,Rotar; Vladimir,5,0,34,29
1658141373744,MATH 193A,A04,083782,Rotar; Vladimir,12,0,34,22
1658141373744,MATH 193A,A05,093482,Rotar; Vladimir,11,0,34,23
1658141379782,MATH 197,001,091859,McAuley; Julian John,9999,0,9999,0
1658141379782,MATH 197,002,095566,Kedlaya; Kiran S.,9997,0,9999,2
1658141379782,MATH 197,003,095567,Xiao; Ming,9999,0,9999,0
1658141379782,MATH 197,004,095571,Perols; Johan Lars,9998,0,9999,1
1658141386846,COGS 9,A01,083615,Shannon; Kyle Michael,11,0,75,64
1658141392877,COGS 11,A01,083617,Boyle; Mary E. T.,23,0,48,25
1658141398919,COGS 13,A01,083071,Bastos; Amalia Pinkusfeld,12,0,71,59
1658141404946,COGS 14A,A01,092681,Semenuks; Arturs,5,1,100,95
1658141410974,COGS 14B,A01,083073,Cheng; Tzu-Han,7,0,63,56
1658141417006,COGS 17,A01,092677,Semenuks; Arturs,7,0,81,74
1658141423028,COGS 100,A01,083619,Allen; Michael Gordon,17,0,70,53
1658141429054,COGS 101A,A01,083621,Davis; Joshua Daniel,9,0,68,59
1658141435082,COGS 101B,A01,091572,Allen; Michael Gordon,14,0,65,51
1658141441119,COGS 101C,A01,083625,Delgado; Tania,17,0,35,18
1658141447145,COGS 107A,A01,083627,Boyle; Mary E. T.,14,0,60,46
1658141453183,COGS 118A,A01,083075,Gupta; Anjum,21,0,76,55
1658141459226,CSE 3,A50,083646,Miranda; Gregory Joseph,24,0,50,26
1658141479012,CSE 8A,A50,083650,Miranda; Gregory Joseph,17,1,56,39
1658141485040,CSE 11,A01,083080,Cao; Yingjun,7,15,40,33
1658141503904,CSE 12,A01,083652,Krause-Levy; Sophia Louisa,30,1,120,90
1658141509932,CSE 15L,A01,083654,Morris; Justin Loren,9,0,50,41
1658141509932,CSE 15L,A02,083655,Morris; Justin Loren,11,0,50,39
1658141529171,CSE 20,A01,083657,Tran; Khoa Dang,39,0,80,41
1658141535200,CSE 21,A01,095574,Bach; Quang Tran,23,0,48,25
1658141553950,CSE 30,A01,083084,Eldon; John,8,0,80,72
1658141553950,CSE 30,B01,095061,Bhaskar; Nishant,9,0,50,41
1658141559988,CSE 100,A01,083659,Cao; Yingjun,5,4,70,65
1658141578832,CSE 134B,A01,083661,Powell; Thomas Allan,25,0,100,75
1658141584863,CSE 140,A01,083663,Gungor; Onat,17,0,85,68
1658141603631,CSE 140L,A01,083088,Eldon; John,23,0,100,77
1658141609663,CSE 175,A01,083665,Kumar; Rakesh,3,0,25,22
1658141628282,CSE 190,A00,092507,Dubnov; Shlomo,8,0,20,12
1658141634317,ECE 45,A01,083139,Congero; Spencer William,7,0,75,68
1658141653148,ECE 65,A50,083695,Saad; Andrew S,12,0,30,18
1658141653148,ECE 65,A51,095125,Saad; Andrew S,24,0,26,2
1658141659181,ECE 109,A01,091882,Touri; Behrouz,21,0,70,49
1658141677428,ECE 180,A00,083140,Abi Samra; Nicholas Camill,1,0,30,29
1658141677428,ECE 180,B00,083141,Abi Samra; Nicholas Camill,0,0,30,30
1658141683464,MATH 10A,A01,083735,Patchell; Gregory David,2,0,30,28
1658141683464,MATH 10A,A02,083736,Patchell; Gregory David,20,0,30,10
1658141683464,MATH 10A,A03,083737,Patchell; Gregory David,16,0,30,14
1658141690124,MATH 10B,A01,083207,Lim; Seonhee,9,0,34,25
1658141690124,MATH 10B,A02,083208,Lim; Seonhee,10,0,35,25
1658141690124,MATH 10B,A03,093472,Lim; Seonhee,7,0,34,27
1658141690124,MATH 10B,B01,083739,Sinha; Shubham,14,0,30,16
1658141696154,MATH 18,A01,083743,Cinel; Cameron Alexander,9,0,30,21
1658141696154,MATH 18,A02,083744,Cinel; Cameron Alexander,18,0,30,12
1658141696154,MATH 18,A03,083745,Cinel; Cameron Alexander,10,0,30,20
1658141696154,MATH 18,B01,083748,Rideout; David Porter,5,0,37,32
1658141696154,MATH 18,B02,083749,Rideout; David Porter,5,0,36,31
1658141696154,MATH 18,B03,083750,Rideout; David Porter,3,0,37,34
1658141696154,MATH 18,B04,083751,Rideout; David Porter,7,0,36,29
1658141696154,MATH 18,B05,093473,Rideout; David Porter,7,0,36,29
1658141696154,MATH 18,B06,093474,Rideout; David Porter,6,0,36,30
1658141702197,MATH 20A,A01,083754,Zheng; Zequn,14,0,40,26
1658141708225,MATH 20B,A01,083756,Briones; Jor-el Thomas Caparas,4,0,36,32
1658141708225,MATH 20B,A02,083757,Briones; Jor-el Thomas Caparas,1,0,36,35
1658141708225,MATH 20B,A03,093475,Briones; Jor-el Thomas Caparas,3,0,36,33
1658141714252,MATH 20C,A01,083760,Briones; Jor-el Thomas Caparas,1,0,35,34
1658141714252,MATH 20C,A02,083761,Briones; Jor-el Thomas Caparas,8,0,35,27
1658141714252,MATH 20C,A03,093476,Briones; Jor-el Thomas Caparas,0,1,36,36
1658141714252,MATH 20C,B01,083762,Bach; Quang Tran,1,0,30,29
1658141720286,MATH 20D,A01,083765,Tran; Brian Kha,5,0,30,25
1658141720286,MATH 20D,A02,083766,Tran; Brian Kha,5,0,30,25
1658141720286,MATH 20D,A03,083767,Tran; Brian Kha,6,0,30,24
1658141726323,MATH 20E,A01,083771,Ganguly; Soumya,12,0,32,20
1658141726323,MATH 20E,A02,083772,Ganguly; Soumya,7,0,32,25
1658141726323,MATH 20E,B01,083773,Ciotti; Benjamin,20,0,35,15
1658141726323,MATH 20E,B02,083774,Ciotti; Benjamin,18,0,35,17
1658141732352,MATH 103A,A01,083777,Greenfeld; Be'Eri,6,0,36,30
1658141732352,MATH 103A,A02,083778,Greenfeld; Be'Eri,5,0,36,31
1658141732352,MATH 103A,A03,093561,Greenfeld; Be'Eri,7,0,36,29
1658141732352,MATH 103A,B01,083779,Greenfeld; Be'Eri,8,0,36,28
1658141732352,MATH 103A,B02,083780,Greenfeld; Be'Eri,4,0,36,32
1658141732352,MATH 103A,B03,093562,Greenfeld; Be'Eri,3,0,36,33
1658141738377,MATH 105,A01,085443,Carter; Anne Toulson,15,0,35,20
1658141738377,MATH 105,A02,093477,Carter; Anne Toulson,20,0,35,15
1658141744404,MATH 109,A01,083213,Ganzberger; Geoffrey Michael,3,0,34,31
1658141744404,MATH 109,A02,083214,Ganzberger; Geoffrey Michael,4,0,34,30
1658141744404,MATH 109,A03,093478,Ganzberger; Geoffrey Michael,2,0,34,32
1658141744404,MATH 109,B01,083215,Ganzberger; Geoffrey Michael,3,0,32,29
1658141744404,MATH 109,B02,083216,Ganzberger; Geoffrey Michael,3,0,32,29
1658141744404,MATH 109,B03,093479,Ganzberger; Geoffrey Michael,8,0,32,24
1658141750431,MATH 142A,A01,083219,Chow; Bennett,7,0,32,25
1658141750431,MATH 142A,A02,083220,Chow; Bennett,10,0,32,22
1658141750431,MATH 142A,A03,093480,Chow; Bennett,9,0,32,23
1658141750431,MATH 142A,B03,093481,Chow; Bennett,8,0,32,24
1658141750431,MATH 142A,B04,093558,Chow; Bennett,14,0,32,18
1658141750431,MATH 142A,B05,093559,Chow; Bennett,7,0,32,25
1658141756458,MATH 193A,A01,083224,Rotar; Vladimir,9,0,34,25
1658141756458,MATH 193A,A02,083225,Rotar; Vladimir,11,0,34,23
1658141756458,MATH 193A,A03,083781,Rotar; Vladimir,5,0,34,29
1658141756458,MATH 193A,A04,083782,Rotar; Vladimir,12,0,34,22
1658141756458,MATH 193A,A05,093482,Rotar; Vladimir,11,0,34,23
1658141762486,MATH 197,001,091859,McAuley; Julian John,9999,0,9999,0
1658141762486,MATH 197,002,095566,Kedlaya; Kiran S.,9997,0,9999,2
1658141762486,MATH 197,003,095567,Xiao; Ming,9999,0,9999,0
1658141762486,MATH 197,004,095571,Perols; Johan Lars,9998,0,9999,1
1658141769578,COGS 9,A01,083615,Shannon; Kyle Michael,11,0,75,64
1658141775604,COGS 11,A01,083617,Boyle; Mary E. T.,23,0,48,25
1658141781631,COGS 13,A01,083071,Bastos; Amalia Pinkusfeld,12,0,71,59
1658141787666,COGS 14A,A01,092681,Semenuks; Arturs,5,1,100,95
1658141793691,COGS 14B,A01,083073,Cheng; Tzu-Han,7,0,63,56
1658141799717,COGS 17,A01,092677,Semenuks; Arturs,7,0,81,74
1658141805747,COGS 100,A01,083619,Allen; Michael Gordon,17,0,70,53
1658141811778,COGS 101A,A01,083621,Davis; Joshua Daniel,9,0,68,59
1658141817803,COGS 101B,A01,091572,Allen; Michael Gordon,14,0,65,51
1658141823834,COGS 101C,A01,083625,Delgado; Tania,17,0,35,18
1658141829869,COGS 107A,A01,083627,Boyle; Mary E. T.,14,0,60,46
1658141835894,COGS 118A,A01,083075,Gupta; Anjum,21,0,76,55
1658141841929,CSE 3,A50,083646,Miranda; Gregory Joseph,24,0,50,26
1658141847961,CSE 8A,A50,083650,Miranda; Gregory Joseph,17,1,56,39
1658141853988,CSE 11,A01,083080,Cao; Yingjun,7,15,40,33
1658141860014,CSE 12,A01,083652,Krause-Levy; Sophia Louisa,30,1,120,90
1658141866040,CSE 15L,A01,083654,Morris; Justin Loren,9,0,50,41
1658141866040,CSE 15L,A02,083655,Morris; Justin Loren,11,0,50,39
1658141872073,CSE 20,A01,083657,Tran; Khoa Dang,39,0,80,41
1658141878102,CSE 21,A01,095574,Bach; Quang Tran,23,0,48,25
1658141893831,CSE 30,A01,083084,Eldon; John,8,0,80,72
1658141893831,CSE 30,B01,095061,Bhaskar; Nishant,9,0,50,41
1658141899861,CSE 100,A01,083659,Cao; Yingjun,5,4,70,65
1658141905911,CSE 134B,A01,083661,Powell; Thomas Allan,25,0,100,75
1658141911935,CSE 140,A01,083663,Gungor; Onat,17,0,85,68
1658141917961,CSE 140L,A01,083088,Eldon; John,23,0,100,77
1658141923988,CSE 175,A01,083665,Kumar; Rakesh,3,0,25,22
1658141930016,CSE 190,A00,092507,Dubnov; Shlomo,8,0,20,12
1658141936048,ECE 45,A01,083139,Congero; Spencer William,7,0,75,68
1658141942076,ECE 65,A50,083695,Saad; Andrew S,12,0,30,18
1658141942076,ECE 65,A51,095125,Saad; Andrew S,24,0,26,2
1658141948108,ECE 109,A01,091882,Touri; Behrouz,21,0,70,49
1658141954138,ECE 180,A00,083140,Abi Samra; Nicholas Camill,1,0,30,29
1658141954138,ECE 180,B00,083141,Abi Samra; Nicholas Camill,0,0,30,30
1658141960171,MATH 10A,A01,083735,Patchell; Gregory David,2,0,30,28
1658141960171,MATH 10A,A02,083736,Patchell; Gregory David,20,0,30,10
1658141960171,MATH 10A,A03,083737,Patchell; Gregory David,16,0,30,14
1658141966199,MATH 10B,A01,083207,Lim; Seonhee,9,0,34,25
1658141966199,MATH 10B,A02,083208,Lim; Seonhee,10,0,35,25
1658141966199,MATH 10B,A03,093472,Lim; Seonhee,7,0,34,27
1658141966199,MATH 10B,B01,083739,Sinha; Shubham,14,0,30,16
1658141972229,MATH 18,A01,083743,Cinel; Cameron Alexander,9,0,30,21
1658141972229,MATH 18,A02,083744,Cinel; Cameron Alexander,18,0,30,12
1658141972229,MATH 18,A03,083745,Cinel; Cameron Alexander,10,0,30,20
1658141972229,MATH 18,B01,083748,Rideout; David Porter,5,0,37,32
1658141972229,MATH 18,B02,083749,Rideout; David Porter,5,0,36,31
1658141972229,MATH 18,B03,083750,Rideout; David Porter,3,0,37,34
1658141972229,MATH 18,B04,083751,Rideout; David Porter,7,0,36,29
1658141972229,MATH 18,B05,093473,Rideout; David Porter,7,0,36,29
1658141972229,MATH 18,B06,093474,Rideout; David Porter,6,0,36,30
1658141978261,MATH 20A,A01,083754,Zheng; Zequn,14,0,40,26
1658141984297,MATH 20B,A01,083756,Briones; Jor-el Thomas Caparas,4,0,36,32
1658141984297,MATH 20B,A02,083757,Briones; Jor-el Thomas Caparas,1,0,36,35
1658141984297,MATH 20B,A03,093475,Briones; Jor-el Thomas Caparas,3,0,36,33
1658141990323,MATH 20C,A01,083760,Briones; Jor-el Thomas Caparas,1,0,35,34
1658141990323,MATH 20C,A02,083761,Briones; Jor-el Thomas Caparas,8,0,35,27
1658141990323,MATH 20C,A03,093476,Briones; Jor-el Thomas Caparas,0,1,36,36
1658141990323,MATH 20C,B01,083762,Bach; Quang Tran,1,0,30,29
1658141996357,MATH 20D,A01,083765,Tran; Brian Kha,5,0,30,25
1658141996357,MATH 20D,A02,083766,Tran; Brian Kha,5,0,30,25
1658141996357,MATH 20D,A03,083767,Tran; Brian Kha,6,0,30,24
1658142002386,MATH 20E,A01,083771,Ganguly; Soumya,12,0,32,20
1658142002386,MATH 20E,A02,083772,Ganguly; Soumya,7,0,32,25
1658142002386,MATH 20E,B01,083773,Ciotti; Benjamin,20,0,35,15
1658142002386,MATH 20E,B02,083774,Ciotti; Benjamin,18,0,35,17
1658142008425,MATH 103A,A01,083777,Greenfeld; Be'Eri,6,0,36,30
1658142008425,MATH 103A,A02,083778,Greenfeld; Be'Eri,5,0,36,31
1658142008425,MATH 103A,A03,093561,Greenfeld; Be'Eri,7,0,36,29
1658142008425,MATH 103A,B01,083779,Greenfeld; Be'Eri,8,0,36,28
1658142008425,MATH 103A,B02,083780,Greenfeld; Be'Eri,4,0,36,32
1658142008425,MATH 103A,B03,093562,Greenfeld; Be'Eri,3,0,36,33
1658142014451,MATH 105,A01,085443,Carter; Anne Toulson,15,0,35,20
1658142014451,MATH 105,A02,093477,Carter; Anne Toulson,20,0,35,15
1658142020486,MATH 109,A01,083213,Ganzberger; Geoffrey Michael,3,0,34,31
1658142020486,MATH 109,A02,083214,Ganzberger; Geoffrey Michael,4,0,34,30
1658142020486,MATH 109,A03,093478,Ganzberger; Geoffrey Michael,2,0,34,32
1658142020486,MATH 109,B01,083215,Ganzberger; Geoffrey Michael,3,0,32,29
1658142020486,MATH 109,B02,083216,Ganzberger; Geoffrey Michael,3,0,32,29
1658142020486,MATH 109,B03,093479,Ganzberger; Geoffrey Michael,8,0,32,24
1658142026520,MATH 142A,A01,083219,Chow; Bennett,7,0,32,25
1658142026520,MATH 142A,A02,083220,Chow; Bennett,10,0,32,22
1658142026520,MATH 142A,A03,093480,Chow; Bennett,9,0,32,23
1658142026520,MATH 142A,B03,093481,Chow; Bennett,8,0,32,24
1658142026520,MATH 142A,B04,093558,Chow; Bennett,14,0,32,18
1658142026520,MATH 142A,B05,093559,Chow; Bennett,7,0,32,25
1658142032545,MATH 193A,A01,083224,Rotar; Vladimir,9,0,34,25
1658142032545,MATH 193A,A02,083225,Rotar; Vladimir,11,0,34,23
1658142032545,MATH 193A,A03,083781,Rotar; Vladimir,5,0,34,29
1658142032545,MATH 193A,A04,083782,Rotar; Vladimir,12,0,34,22
1658142032545,MATH 193A,A05,093482,Rotar; Vladimir,11,0,34,23
1658142038577,MATH 197,001,091859,McAuley; Julian John,9999,0,9999,0
1658142038577,MATH 197,002,095566,Kedlaya; Kiran S.,9997,0,9999,2
1658142038577,MATH 197,003,095567,Xiao; Ming,9999,0,9999,0
1658142038577,MATH 197,004,095571,Perols; Johan Lars,9998,0,9999,1
1658142045666,COGS 9,A01,083615,Shannon; Kyle Michael,11,0,75,64
1658142051691,COGS 11,A01,083617,Boyle; Mary E. T.,23,0,48,25
1658142057716,COGS 13,A01,083071,Bastos; Amalia Pinkusfeld,12,0,71,59
1658142063746,COGS 14A,A01,092681,Semenuks; Arturs,5,1,100,95
1658142069775,COGS 14B,A01,083073,Cheng; Tzu-Han,7,0,63,56
1658142075800,COGS 17,A01,092677,Semenuks; Arturs,7,0,81,74
1658142081825,COGS 100,A01,083619,Allen; Michael Gordon,17,0,70,53
1658142087849,COGS 101A,A01,083621,Davis; Joshua Daniel,9,0,68,59
1658142093873,COGS 101B,A01,091572,Allen; Michael Gordon,14,0,65,51
1658142099897,COGS 101C,A01,083625,Delgado; Tania,17,0,35,18
1658142105922,COGS 107A,A01,083627,Boyle; Mary E. T.,14,0,60,46
1658142111949,COGS 118A,A01,083075,Gupta; Anjum,21,0,76,55
1658142117982,CSE 3,A50,083646,Miranda; Gregory Joseph,24,0,50,26
1658142124005,CSE 8A,A50,083650,Miranda; Gregory Joseph,17,1,56,39
1658142130034,CSE 11,A01,083080,Cao; Yingjun,7,15,40,33
1658142136066,CSE 12,A01,083652,Krause-Levy; Sophia Louisa,30,1,120,90
1658142142096,CSE 15L,A01,083654,Morris; Justin Loren,9,0,50,41
1658142142096,CSE 15L,A02,083655,Morris; Justin Loren,11,0,50,39
1658142148121,CSE 20,A01,083657,Tran; Khoa Dang,39,0,80,41
1658142154145,CSE 21,A01,095574,Bach; Quang Tran,23,0,48,25
1658142160170,CSE 30,A01,083084,Eldon; John,8,0,80,72
1658142160170,CSE 30,B01,095061,Bhaskar; Nishant,9,0,50,41
1658142179068,CSE 134B,A01,083661,Powell; Thomas Allan,25,0,100,75
1658142185099,CSE 140,A01,083663,Gungor; Onat,17,0,85,68
1658142191127,CSE 140L,A01,083088,Eldon; John,23,0,100,77
1658142197162,CSE 175,A01,083665,Kumar; Rakesh,3,0,25,22
1658142203189,CSE 190,A00,092507,Dubnov; Shlomo,8,0,20,12
1658142209217,ECE 45,A01,083139,Congero; Spencer William,7,0,75,68
1658142215248,ECE 65,A50,083695,Saad; Andrew S,12,0,30,18
1658142215248,ECE 65,A51,095125,Saad; Andrew S,24,0,26,2
1658142221274,ECE 109,A01,091882,Touri; Behrouz,21,0,70,49
1658142227298,ECE 180,A00,083140,Abi Samra; Nicholas Camill,1,0,30,29
1658142227298,ECE 180,B00,083141,Abi Samra; Nicholas Camill,0,0,30,30
1658142233325,MATH 10A,A01,083735,Patchell; Gregory David,2,0,30,28
1658142233325,MATH 10A,A02,083736,Patchell; Gregory David,20,0,30,10
1658142233325,MATH 10A,A03,083737,Patchell; Gregory David,16,0,30,14
1658142239355,MATH 10B,A01,083207,Lim; Seonhee,9,0,34,25
1658142239355,MATH 10B,A02,083208,Lim; Seonhee,10,0,35,25
1658142239355,MATH 10B,A03,093472,Lim; Seonhee,7,0,34,27
1658142239355,MATH 10B,B01,083739,Sinha; Shubham,14,0,30,16
1658142245385,MATH 18,A01,083743,Cinel; Cameron Alexander,9,0,30,21
1658142245385,MATH 18,A02,083744,Cinel; Cameron Alexander,18,0,30,12
1658142245385,MATH 18,A03,083745,Cinel; Cameron Alexander,10,0,30,20
1658142245385,MATH 18,B01,083748,Rideout; David Porter,5,0,37,32
1658142245385,MATH 18,B02,083749,Rideout; David Porter,5,0,36,31
1658142245385,MATH 18,B03,083750,Rideout; David Porter,3,0,37,34
1658142245385,MATH 18,B04,083751,Rideout; David Porter,7,0,36,29
1658142245385,MATH 18,B05,093473,Rideout; David Porter,7,0,36,29
1658142245385,MATH 18,B06,093474,Rideout; David Porter,6,0,36,30
1658142251408,MATH 20A,A01,083754,Zheng; Zequn,14,0,40,26
1658142257442,MATH 20B,A01,083756,Briones; Jor-el Thomas Caparas,4,0,36,32
1658142257442,MATH 20B,A02,083757,Briones; Jor-el Thomas Caparas,1,0,36,35
1658142257442,MATH 20B,A03,093475,Briones; Jor-el Thomas Caparas,3,0,36,33
1658142263476,MATH 20C,A01,083760,Briones; Jor-el Thomas Caparas,1,0,35,34
1658142263476,MATH 20C,A02,083761,Briones; Jor-el Thomas Caparas,8,0,35,27
1658142263476,MATH 20C,A03,093476,Briones; Jor-el Thomas Caparas,0,1,36,36
1658142263476,MATH 20C,B01,083762,Bach; Quang Tran,1,0,30,29
1658142269507,MATH 20D,A01,083765,Tran; Brian Kha,5,0,30,25
1658142269507,MATH 20D,A02,083766,Tran; Brian Kha,5,0,30,25
1658142269507,MATH 20D,A03,083767,Tran; Brian Kha,6,0,30,24
1658142275536,MATH 20E,A01,083771,Ganguly; Soumya,12,0,32,20
1658142275536,MATH 20E,A02,083772,Ganguly; Soumya,7,0,32,25
1658142275536,MATH 20E,B01,083773,Ciotti; Benjamin,20,0,35,15
1658142275536,MATH 20E,B02,083774,Ciotti; Benjamin,18,0,35,17
1658142281574,MATH 103A,A01,083777,Greenfeld; Be'Eri,6,0,36,30
1658142281574,MATH 103A,A02,083778,Greenfeld; Be'Eri,5,0,36,31
1658142281574,MATH 103A,A03,093561,Greenfeld; Be'Eri,7,0,36,29
1658142281574,MATH 103A,B01,083779,Greenfeld; Be'Eri,8,0,36,28
1658142281574,MATH 103A,B02,083780,Greenfeld; Be'Eri,4,0,36,32
1658142281574,MATH 103A,B03,093562,Greenfeld; Be'Eri,3,0,36,33
1658142287607,MATH 105,A01,085443,Carter; Anne Toulson,15,0,35,20
1658142287607,MATH 105,A02,093477,Carter; Anne Toulson,20,0,35,15
1658142293639,MATH 109,A01,083213,Ganzberger; Geoffrey Michael,3,0,34,31
1658142293639,MATH 109,A02,083214,Ganzberger; Geoffrey Michael,4,0,34,30
1658142293639,MATH 109,A03,093478,Ganzberger; Geoffrey Michael,2,0,34,32
1658142293639,MATH 109,B01,083215,Ganzberger; Geoffrey Michael,3,0,32,29
1658142293639,MATH 109,B02,083216,Ganzberger; Geoffrey Michael,3,0,32,29
1658142293639,MATH 109,B03,093479,Ganzberger; Geoffrey Michael,8,0,32,24
1658142299665,MATH 142A,A01,083219,Chow; Bennett,7,0,32,25
1658142299665,MATH 142A,A02,083220,Chow; Bennett,10,0,32,22
1658142299665,MATH 142A,A03,093480,Chow; Bennett,9,0,32,23
1658142299665,MATH 142A,B03,093481,Chow; Bennett,8,0,32,24
1658142299665,MATH 142A,B04,093558,Chow; Bennett,14,0,32,18
1658142299665,MATH 142A,B05,093559,Chow; Bennett,7,0,32,25
1658142305692,MATH 193A,A01,083224,Rotar; Vladimir,9,0,34,25
1658142305692,MATH 193A,A02,083225,Rotar; Vladimir,11,0,34,23
1658142305692,MATH 193A,A03,083781,Rotar; Vladimir,5,0,34,29
1658142305692,MATH 193A,A04,083782,Rotar; Vladimir,12,0,34,22
1658142305692,MATH 193A,A05,093482,Rotar; Vladimir,11,0,34,23
1658142311723,MATH 197,001,091859,McAuley; Julian John,9999,0,9999,0
1658142311723,MATH 197,002,095566,Kedlaya; Kiran S.,9997,0,9999,2
1658142311723,MATH 197,003,095567,Xiao; Ming,9999,0,9999,0
1658142311723,MATH 197,004,095571,Perols; Johan Lars,9998,0,9999,1
1658142318788,COGS 9,A01,083615,Shannon; Kyle Michael,11,0,75,64
1658142324813,COGS 11,A01,083617,Boyle; Mary E. T.,23,0,48,25
1658142330840,COGS 13,A01,083071,Bastos; Amalia Pinkusfeld,12,0,71,59
1658142336870,COGS 14A,A01,092681,Semenuks; Arturs,5,1,100,95
1658142342899,COGS 14B,A01,083073,Cheng; Tzu-Han,7,0,63,56
1658142348923,COGS 17,A01,092677,Semenuks; Arturs,7,0,81,74
1658142354954,COGS 100,A01,083619,Allen; Michael Gordon,17,0,70,53
1658142360984,COGS 101A,A01,083621,Davis; Joshua Daniel,9,0,68,59
1658142367010,COGS 101B,A01,091572,Allen; Michael Gordon,14,0,65,51
1658142373044,COGS 101C,A01,083625,Delgado; Tania,17,0,35,18
1658142379069,COGS 107A,A01,083627,Boyle; Mary E. T.,14,0,60,46
1658142385098,COGS 118A,A01,083075,Gupta; Anjum,21,0,76,55
1658142391132,CSE 3,A50,083646,Miranda; Gregory Joseph,24,0,50,26
1658142397161,CSE 8A,A50,083650,Miranda; Gregory Joseph,17,1,56,39
1658142403200,CSE 11,A01,083080,Cao; Yingjun,7,15,40,33
1658142409224,CSE 12,A01,083652,Krause-Levy; Sophia Louisa,30,1,120,90
1658142415256,CSE 15L,A01,083654,Morris; Justin Loren,9,0,50,41
1658142415256,CSE 15L,A02,083655,Morris; Justin Loren,11,0,50,39
1658142421286,CSE 20,A01,083657,Tran; Khoa Dang,39,0,80,41
1658142427316,CSE 21,A01,095574,Bach; Quang Tran,23,0,48,25
1658142433343,CSE 30,A01,083084,Eldon; John,8,0,80,72
1658142433343,CSE 30,B01,095061,Bhaskar; Nishant,9,0,50,41
1658142439368,CSE 100,A01,083659,Cao; Yingjun,5,4,70,65
1658142445394,CSE 134B,A01,083661,Powell; Thomas Allan,25,0,100,75
1658142451421,CSE 140,A01,083663,Gungor; Onat,17,0,85,68
1658142457446,CSE 140L,A01,083088,Eldon; John,23,0,100,77
1658142463473,CSE 175,A01,083665,Kumar; Rakesh,3,0,25,22
1658142469501,CSE 190,A00,092507,Dubnov; Shlomo,8,0,20,12
1658142475534,ECE 45,A01,083139,Congero; Spencer William,7,0,75,68
1658142481562,ECE 65,A50,083695,Saad; Andrew S,12,0,30,18
1658142481562,ECE 65,A51,095125,Saad; Andrew S,24,0,26,2
1658142487585,ECE 109,A01,091882,Touri; Behrouz,21,0,70,49
1658142493610,ECE 180,A00,083140,Abi Samra; Nicholas Camill,1,0,30,29
1658142493610,ECE 180,B00,083141,Abi Samra; Nicholas Camill,0,0,30,30
1658142499637,MATH 10A,A01,083735,Patchell; Gregory David,2,0,30,28
1658142499637,MATH 10A,A02,083736,Patchell; Gregory David,20,0,30,10
1658142499637,MATH 10A,A03,083737,Patchell; Gregory David,16,0,30,14
1658142505666,MATH 10B,A01,083207,Lim; Seonhee,9,0,34,25
1658142505666,MATH 10B,A02,083208,Lim; Seonhee,10,0,35,25
1658142505666,MATH 10B,A03,093472,Lim; Seonhee,7,0,34,27
1658142505666,MATH 10B,B01,083739,Sinha; Shubham,14,0,30,16
1658142511697,MATH 18,A01,083743,Cinel; Cameron Alexander,9,0,30,21
1658142511697,MATH 18,A02,083744,Cinel; Cameron Alexander,18,0,30,12
1658142511697,MATH 18,A03,083745,Cinel; Cameron Alexander,10,0,30,20
1658142511697,MATH 18,B01,083748,Rideout; David Porter,5,0,37,32
1658142511697,MATH 18,B02,083749,Rideout; David Porter,5,0,36,31
1658142511697,MATH 18,B03,083750,Rideout; David Porter,3,0,37,34
1658142511697,MATH 18,B04,083751,Rideout; David Porter,7,0,36,29
1658142511697,MATH 18,B05,093473,Rideout; David Porter,7,0,36,29
1658142511697,MATH 18,B06,093474,Rideout; David Porter,6,0,36,30
1658142517723,MATH 20A,A01,083754,Zheng; Zequn,14,0,40,26
1658142523757,MATH 20B,A01,083756,Briones; Jor-el Thomas Caparas,4,0,36,32
1658142523757,MATH 20B,A02,083757,Briones; Jor-el Thomas Caparas,1,0,36,35
1658142523757,MATH 20B,A03,093475,Briones; Jor-el Thomas Caparas,3,0,36,33
1658142529789,MATH 20C,A01,083760,Briones; Jor-el Thomas Caparas,1,0,35,34
1658142529789,MATH 20C,A02,083761,Briones; Jor-el Thomas Caparas,8,0,35,27
1658142529789,MATH 20C,A03,093476,Briones; Jor-el Thomas Caparas,0,1,36,36
1658142529789,MATH 20C,B01,083762,Bach; Quang Tran,1,0,30,29
1658142535821,MATH 20D,A01,083765,Tran; Brian Kha,5,0,30,25
1658142535821,MATH 20D,A02,083766,Tran; Brian Kha,5,0,30,25
1658142535821,MATH 20D,A03,083767,Tran; Brian Kha,6,0,30,24
1658142541847,MATH 20E,A01,083771,Ganguly; Soumya,12,0,32,20
1658142541847,MATH 20E,A02,083772,Ganguly; Soumya,7,0,32,25
1658142541847,MATH 20E,B01,083773,Ciotti; Benjamin,20,0,35,15
1658142541847,MATH 20E,B02,083774,Ciotti; Benjamin,18,0,35,17
1658142547883,MATH 103A,A01,083777,Greenfeld; Be'Eri,6,0,36,30
1658142547883,MATH 103A,A02,083778,Greenfeld; Be'Eri,5,0,36,31
1658142547883,MATH 103A,A03,093561,Greenfeld; Be'Eri,7,0,36,29
1658142547883,MATH 103A,B01,083779,Greenfeld; Be'Eri,8,0,36,28
1658142547883,MATH 103A,B02,083780,Greenfeld; Be'Eri,4,0,36,32
1658142547883,MATH 103A,B03,093562,Greenfeld; Be'Eri,3,0,36,33
1658142553910,MATH 105,A01,085443,Carter; Anne Toulson,15,0,35,20
1658142553910,MATH 105,A02,093477,Carter; Anne Toulson,20,0,35,15
1658142559935,MATH 109,A01,083213,Ganzberger; Geoffrey Michael,3,0,34,31
1658142559935,MATH 109,A02,083214,Ganzberger; Geoffrey Michael,4,0,34,30
1658142559935,MATH 109,A03,093478,Ganzberger; Geoffrey Michael,2,0,34,32
1658142559935,MATH 109,B01,083215,Ganzberger; Geoffrey Michael,3,0,32,29
1658142559935,MATH 109,B02,083216,Ganzberger; Geoffrey Michael,3,0,32,29
1658142559935,MATH 109,B03,093479,Ganzberger; Geoffrey Michael,8,0,32,24
1658142565963,MATH 142A,A01,083219,Chow; Bennett,7,0,32,25
1658142565963,MATH 142A,A02,083220,Chow; Bennett,10,0,32,22
1658142565963,MATH 142A,A03,093480,Chow; Bennett,9,0,32,23
1658142565963,MATH 142A,B03,093481,Chow; Bennett,8,0,32,24
1658142565963,MATH 142A,B04,093558,Chow; Bennett,14,0,32,18
1658142565963,MATH 142A,B05,093559,Chow; Bennett,7,0,32,25
1658142571988,MATH 193A,A01,083224,Rotar; Vladimir,9,0,34,25
1658142571988,MATH 193A,A02,083225,Rotar; Vladimir,11,0,34,23
1658142571988,MATH 193A,A03,083781,Rotar; Vladimir,5,0,34,29
1658142571988,MATH 193A,A04,083782,Rotar; Vladimir,12,0,34,22
1658142571988,MATH 193A,A05,093482,Rotar; Vladimir,11,0,34,23
1658142578014,MATH 197,001,091859,McAuley; Julian John,9999,0,9999,0
1658142578014,MATH 197,002,095566,Kedlaya; Kiran S.,9997,0,9999,2
1658142578014,MATH 197,003,095567,Xiao; Ming,9999,0,9999,0
1658142578014,MATH 197,004,095571,Perols; Johan Lars,9998,0,9999,1
1658142585099,COGS 9,A01,083615,Shannon; Kyle Michael,11,0,75,64
1658142591125,COGS 11,A01,083617,Boyle; Mary E. T.,23,0,48,25
1658142597156,COGS 13,A01,083071,Bastos; Amalia Pinkusfeld,12,0,71,59
1658142603185,COGS 14A,A01,092681,Semenuks; Arturs,5,1,100,95
1658142609211,COGS 14B,A01,083073,Cheng; Tzu-Han,7,0,63,56
1658142615237,COGS 17,A01,092677,Semenuks; Arturs,7,0,81,74
1658142621262,COGS 100,A01,083619,Allen; Michael Gordon,17,0,70,53
1658142627292,COGS 101A,A01,083621,Davis; Joshua Daniel,9,0,68,59
1658142633318,COGS 101B,A01,091572,Allen; Michael Gordon,14,0,65,51
1658142639345,COGS 101C,A01,083625,Delgado; Tania,17,0,35,18
1658142645378,COGS 107A,A01,083627,Boyle; Mary E. T.,14,0,60,46
1658142651404,COGS 118A,A01,083075,Gupta; Anjum,21,0,76,55
1658142657437,CSE 3,A50,083646,Miranda; Gregory Joseph,24,0,50,26
1658142663467,CSE 8A,A50,083650,Miranda; Gregory Joseph,17,1,56,39
1658142669492,CSE 11,A01,083080,Cao; Yingjun,7,15,40,33
1658142675518,CSE 12,A01,083652,Krause-Levy; Sophia Louisa,30,1,120,90
1658142681548,CSE 15L,A01,083654,Morris; Justin Loren,9,0,50,41
1658142681548,CSE 15L,A02,083655,Morris; Justin Loren,11,0,50,39
1658142687577,CSE 20,A01,083657,Tran; Khoa Dang,39,0,80,41
1658142693626,CSE 21,A01,095574,Bach; Quang Tran,23,0,48,25
1658142699653,CSE 30,A01,083084,Eldon; John,8,0,80,72
1658142699653,CSE 30,B01,095061,Bhaskar; Nishant,9,0,50,41
1658142705683,CSE 100,A01,083659,Cao; Yingjun,5,4,70,65
1658142711708,CSE 134B,A01,083661,Powell; Thomas Allan,25,0,100,75
1658142717731,CSE 140,A01,083663,Gungor; Onat,17,0,85,68
1658142723759,CSE 140L,A01,083088,Eldon; John,23,0,100,77
1658142729797,CSE 175,A01,083665,Kumar; Rakesh,3,0,25,22
1658142735823,CSE 190,A00,092507,Dubnov; Shlomo,8,0,20,12
1658142741850,ECE 45,A01,083139,Congero; Spencer William,7,0,75,68
1658142747878,ECE 65,A50,083695,Saad; Andrew S,12,0,30,18
1658142747878,ECE 65,A51,095125,Saad; Andrew S,24,0,26,2
1658142753902,ECE 109,A01,091882,Touri; Behrouz,21,0,70,49
1658142759931,ECE 180,A00,083140,Abi Samra; Nicholas Camill,1,0,30,29
1658142759931,ECE 180,B00,083141,Abi Samra; Nicholas Camill,0,0,30,30
1658142765956,MATH 10A,A01,083735,Patchell; Gregory David,2,0,30,28
1658142765956,MATH 10A,A02,083736,Patchell; Gregory David,20,0,30,10
1658142765956,MATH 10A,A03,083737,Patchell; Gregory David,16,0,30,14
1658142771990,MATH 10B,A01,083207,Lim; Seonhee,9,0,34,25
1658142771990,MATH 10B,A02,083208,Lim; Seonhee,10,0,35,25
1658142771990,MATH 10B,A03,093472,Lim; Seonhee,7,0,34,27
1658142771990,MATH 10B,B01,083739,Sinha; Shubham,14,0,30,16
1658142778108,MATH 18,A01,083743,Cinel; Cameron Alexander,9,0,30,21
1658142778108,MATH 18,A02,083744,Cinel; Cameron Alexander,18,0,30,12
1658142778108,MATH 18,A03,083745,Cinel; Cameron Alexander,10,0,30,20
1658142778108,MATH 18,B01,083748,Rideout; David Porter,5,0,37,32
1658142778108,MATH 18,B02,083749,Rideout; David Porter,5,0,36,31
1658142778108,MATH 18,B03,083750,Rideout; David Porter,3,0,37,34
1658142778108,MATH 18,B04,083751,Rideout; David Porter,7,0,36,29
1658142778108,MATH 18,B05,093473,Rideout; David Porter,7,0,36,29
1658142778108,MATH 18,B06,093474,Rideout; David Porter,6,0,36,30
1658142784143,MATH 20A,A01,083754,Zheng; Zequn,14,0,40,26
1658142790171,MATH 20B,A01,083756,Briones; Jor-el Thomas Caparas,4,0,36,32
1658142790171,MATH 20B,A02,083757,Briones; Jor-el Thomas Caparas,1,0,36,35
1658142790171,MATH 20B,A03,093475,Briones; Jor-el Thomas Caparas,3,0,36,33
1658142796198,MATH 20C,A01,083760,Briones; Jor-el Thomas Caparas,1,0,35,34
1658142796198,MATH 20C,A02,083761,Briones; Jor-el Thomas Caparas,8,0,35,27
1658142796198,MATH 20C,A03,093476,Briones; Jor-el Thomas Caparas,0,1,36,36
1658142796198,MATH 20C,B01,083762,Bach; Quang Tran,1,0,30,29
