time,subj_course_id,sec_code,sec_id,prof,available,waitlist,total,enrolled_ct
1656933699410,COGS 9,A01,083615,Shannon; Kyle Michael,7,0,75,68
1656933705442,COGS 11,A01,083617,Boyle; Mary E. T.,19,0,48,29
1656933711478,COGS 13,A01,083071,Bastos; Amalia Pinkusfeld,9,0,71,62
1656933717512,COGS 14A,A01,092681,Semenuks; Arturs,0,1,100,100
1656933723544,COGS 14B,A01,083073,Cheng; Tzu-Han,5,0,63,58
1656933729579,COGS 17,A01,092677,Semenuks; Arturs,4,0,81,77
1656933735609,COGS 100,A01,083619,Allen; Michael Gordon,15,0,70,55
1656933741638,COGS 101A,A01,083621,Davis; Joshua Daniel,9,0,68,59
1656933747674,COGS 101B,A01,091572,Allen; Michael Gordon,8,0,65,57
1656933753705,COGS 101C,A01,083625,Delgado; Tania,17,0,35,18
1656933759740,COGS 107A,A01,083627,Boyle; Mary E. T.,13,0,60,47
1656933765774,COGS 118A,A01,083075,Gupta; Anjum,15,0,76,61
1656933771823,CSE 3,A50,083646,Miranda; Gregory Joseph,22,0,50,28
1656933777856,CSE 8A,A50,083650,Miranda; Gregory Joseph,17,1,56,39
1656933783890,CSE 11,A01,083080,Cao; Yingjun,4,15,40,36
1656933789919,CSE 12,A01,083652,Krause-Levy; Sophia Louisa,20,1,120,100
1656933795949,CSE 15L,A01,083654,Morris; Justin Loren,8,0,50,42
1656933795949,CSE 15L,A02,083655,Morris; Justin Loren,8,0,50,42
1656933801979,CSE 20,A01,083657,Tran; Khoa Dang,37,0,80,43
1656933808009,CSE 21,A01,095574,Bach; Quang Tran,21,0,48,27
1656933814055,CSE 30,A01,083084,Eldon; John,4,0,80,76
1656933814055,CSE 30,B01,095061,Bhaskar; Nishant,6,0,50,44
1656933820090,CSE 100,A01,083659,Cao; Yingjun,3,4,70,67
1656933826118,CSE 134B,A01,083661,Powell; Thomas Allan,19,0,100,81
1656933832153,CSE 140,A01,083663,Gungor; Onat,14,0,85,71
1656933838183,CSE 140L,A01,083088,Eldon; John,16,0,100,84
1656933844220,CSE 175,A01,083665,Kumar; Rakesh,3,0,25,22
1656933856051,CSE 190,A00,092507,Dubnov; Shlomo,7,0,20,13
1656933862204,ECE 45,A01,083139,Congero; Spencer William,5,0,75,70
1656933876143,ECE 65,A50,083695,Saad; Andrew S,12,0,30,18
1656933876143,ECE 65,A51,095125,Saad; Andrew S,25,0,26,1
1656933882179,ECE 109,A01,091882,Touri; Behrouz,16,0,70,54
1656933895865,ECE 180,A00,083140,Abi Samra; Nicholas Camill,0,0,30,30
1656933895865,ECE 180,B00,083141,Abi Samra; Nicholas Camill,0,0,30,30
1656933901898,MATH 10A,A01,083735,Patchell; Gregory David,1,0,30,29
1656933901898,MATH 10A,A02,083736,Patchell; Gregory David,20,0,30,10
1656933901898,MATH 10A,A03,083737,Patchell; Gregory David,15,0,30,15
1656933915966,MATH 10B,A01,083207,Lim; Seonhee,7,0,34,27
1656933915966,MATH 10B,A02,083208,Lim; Seonhee,9,0,35,26
1656933915966,MATH 10B,A03,093472,Lim; Seonhee,4,0,34,30
1656933915966,MATH 10B,B01,083739,Sinha; Shubham,9,0,30,21
1656933922013,MATH 18,A01,083743,Cinel; Cameron Alexander,6,0,30,24
1656933922013,MATH 18,A02,083744,Cinel; Cameron Alexander,15,0,30,15
1656933922013,MATH 18,A03,083745,Cinel; Cameron Alexander,8,0,30,22
1656933922013,MATH 18,B01,083748,Rideout; David Porter,4,0,37,33
1656933922013,MATH 18,B02,083749,Rideout; David Porter,3,0,36,33
1656933922013,MATH 18,B03,083750,Rideout; David Porter,2,0,37,35
1656933922013,MATH 18,B04,083751,Rideout; David Porter,5,0,36,31
1656933922013,MATH 18,B05,093473,Rideout; David Porter,4,0,36,32
1656933922013,MATH 18,B06,093474,Rideout; David Porter,5,0,36,31
1656933936060,MATH 20A,A01,083754,Zheng; Zequn,12,0,40,28
1656933942099,MATH 20B,A01,083756,Briones; Jor-el Thomas Caparas,1,0,36,35
1656933942099,MATH 20B,A02,083757,Briones; Jor-el Thomas Caparas,1,0,36,35
1656933942099,MATH 20B,A03,093475,Briones; Jor-el Thomas Caparas,0,0,36,36
1656933956081,MATH 20C,A01,083760,Briones; Jor-el Thomas Caparas,1,0,35,34
1656933956081,MATH 20C,A02,083761,Briones; Jor-el Thomas Caparas,8,0,35,27
1656933956081,MATH 20C,A03,093476,Briones; Jor-el Thomas Caparas,0,1,36,36
1656933956081,MATH 20C,B01,083762,Bach; Quang Tran,0,0,30,30
1656933962122,MATH 20D,A01,083765,Tran; Brian Kha,4,0,30,26
1656933962122,MATH 20D,A02,083766,Tran; Brian Kha,4,0,30,26
1656933962122,MATH 20D,A03,083767,Tran; Brian Kha,3,0,30,27
1656933969458,MATH 20E,A01,083771,Ganguly; Soumya,5,0,32,27
1656933969458,MATH 20E,A02,083772,Ganguly; Soumya,6,0,32,26
1656933969458,MATH 20E,B01,083773,Ciotti; Benjamin,18,0,35,17
1656933969458,MATH 20E,B02,083774,Ciotti; Benjamin,17,0,35,18
1656933975493,MATH 103A,A01,083777,Greenfeld; Be'Eri,2,0,36,34
1656933975493,MATH 103A,A02,083778,Greenfeld; Be'Eri,5,0,36,31
1656933975493,MATH 103A,A03,093561,Greenfeld; Be'Eri,4,0,36,32
1656933975493,MATH 103A,B01,083779,Greenfeld; Be'Eri,6,0,36,30
1656933975493,MATH 103A,B02,083780,Greenfeld; Be'Eri,2,0,36,34
1656933975493,MATH 103A,B03,093562,Greenfeld; Be'Eri,2,0,36,34
1656933981524,MATH 105,A01,085443,Carter; Anne Toulson,13,0,35,22
1656933981524,MATH 105,A02,093477,Carter; Anne Toulson,20,0,35,15
1656933987567,MATH 109,A01,083213,Ganzberger; Geoffrey Michael,2,0,34,32
1656933987567,MATH 109,A02,083214,Ganzberger; Geoffrey Michael,2,0,34,32
1656933987567,MATH 109,A03,093478,Ganzberger; Geoffrey Michael,1,0,34,33
1656933987567,MATH 109,B01,083215,Ganzberger; Geoffrey Michael,1,0,32,31
1656933987567,MATH 109,B02,083216,Ganzberger; Geoffrey Michael,1,0,32,31
1656933987567,MATH 109,B03,093479,Ganzberger; Geoffrey Michael,6,0,32,26
1656933993598,MATH 142A,A01,083219,Chow; Bennett,6,0,32,26
1656933993598,MATH 142A,A02,083220,Chow; Bennett,10,0,32,22
1656933993598,MATH 142A,A03,093480,Chow; Bennett,7,0,32,25
1656933993598,MATH 142A,B03,093481,Chow; Bennett,7,0,32,25
1656933993598,MATH 142A,B04,093558,Chow; Bennett,11,0,32,21
1656933993598,MATH 142A,B05,093559,Chow; Bennett,6,0,32,26
1656933999639,MATH 193A,A01,083224,Rotar; Vladimir,7,0,34,27
1656933999639,MATH 193A,A02,083225,Rotar; Vladimir,3,0,34,31
1656933999639,MATH 193A,A03,083781,Rotar; Vladimir,1,0,34,33
1656933999639,MATH 193A,A04,083782,Rotar; Vladimir,6,0,34,28
1656933999639,MATH 193A,A05,093482,Rotar; Vladimir,6,0,34,28
1656934005672,MATH 197,001,091859,McAuley; Julian John,9999,0,9999,0
1656934005672,MATH 197,002,095566,Kedlaya; Kiran S.,9997,0,9999,2
1656934005672,MATH 197,003,095567,Xiao; Ming,9999,0,9999,0
1656934005672,MATH 197,004,095571,Perols; Johan Lars,9998,0,9999,1
1656934012753,COGS 9,A01,083615,Shannon; Kyle Michael,7,0,75,68
1656934018785,COGS 11,A01,083617,Boyle; Mary E. T.,19,0,48,29
1656934024811,COGS 13,A01,083071,Bastos; Amalia Pinkusfeld,9,0,71,62
1656934030844,COGS 14A,A01,092681,Semenuks; Arturs,0,1,100,100
1656934036875,COGS 14B,A01,083073,Cheng; Tzu-Han,5,0,63,58
1656934042907,COGS 17,A01,092677,Semenuks; Arturs,4,0,81,77
1656934048938,COGS 100,A01,083619,Allen; Michael Gordon,15,0,70,55
1656934054969,COGS 101A,A01,083621,Davis; Joshua Daniel,9,0,68,59
1656934060997,COGS 101B,A01,091572,Allen; Michael Gordon,8,0,65,57
1656934067026,COGS 101C,A01,083625,Delgado; Tania,17,0,35,18
1656934073060,COGS 107A,A01,083627,Boyle; Mary E. T.,13,0,60,47
1656934079088,COGS 118A,A01,083075,Gupta; Anjum,15,0,76,61
1656934085137,CSE 3,A50,083646,Miranda; Gregory Joseph,22,0,50,28
1656934091175,CSE 8A,A50,083650,Miranda; Gregory Joseph,17,1,56,39
1656934097208,CSE 11,A01,083080,Cao; Yingjun,4,15,40,36
1656934103304,CSE 12,A01,083652,Krause-Levy; Sophia Louisa,20,1,120,100
1656934109330,CSE 15L,A01,083654,Morris; Justin Loren,8,0,50,42
1656934109330,CSE 15L,A02,083655,Morris; Justin Loren,8,0,50,42
1656934115357,CSE 20,A01,083657,Tran; Khoa Dang,37,0,80,43
1656934121390,CSE 21,A01,095574,Bach; Quang Tran,21,0,48,27
1656934127429,CSE 30,A01,083084,Eldon; John,4,0,80,76
1656934127429,CSE 30,B01,095061,Bhaskar; Nishant,6,0,50,44
1656934133461,CSE 100,A01,083659,Cao; Yingjun,3,4,70,67
1656934139496,CSE 134B,A01,083661,Powell; Thomas Allan,19,0,100,81
1656934145528,CSE 140,A01,083663,Gungor; Onat,14,0,85,71
1656934151553,CSE 140L,A01,083088,Eldon; John,16,0,100,84
1656934157588,CSE 175,A01,083665,Kumar; Rakesh,3,0,25,22
1656934163619,CSE 190,A00,092507,Dubnov; Shlomo,7,0,20,13
1656934169650,ECE 45,A01,083139,Congero; Spencer William,5,0,75,70
1656934175681,ECE 65,A50,083695,Saad; Andrew S,12,0,30,18
1656934175681,ECE 65,A51,095125,Saad; Andrew S,25,0,26,1
1656934181711,ECE 109,A01,091882,Touri; Behrouz,16,0,70,54
1656934187738,ECE 180,A00,083140,Abi Samra; Nicholas Camill,0,0,30,30
1656934187738,ECE 180,B00,083141,Abi Samra; Nicholas Camill,0,0,30,30
1656934193772,MATH 10A,A01,083735,Patchell; Gregory David,1,0,30,29
1656934193772,MATH 10A,A02,083736,Patchell; Gregory David,20,0,30,10
1656934193772,MATH 10A,A03,083737,Patchell; Gregory David,15,0,30,15
1656934199802,MATH 10B,A01,083207,Lim; Seonhee,7,0,34,27
1656934199802,MATH 10B,A02,083208,Lim; Seonhee,9,0,35,26
1656934199802,MATH 10B,A03,093472,Lim; Seonhee,4,0,34,30
1656934199802,MATH 10B,B01,083739,Sinha; Shubham,9,0,30,21
1656934205852,MATH 18,A01,083743,Cinel; Cameron Alexander,6,0,30,24
1656934205852,MATH 18,A02,083744,Cinel; Cameron Alexander,15,0,30,15
1656934205852,MATH 18,A03,083745,Cinel; Cameron Alexander,8,0,30,22
1656934205852,MATH 18,B01,083748,Rideout; David Porter,4,0,37,33
1656934205852,MATH 18,B02,083749,Rideout; David Porter,3,0,36,33
1656934205852,MATH 18,B03,083750,Rideout; David Porter,2,0,37,35
1656934205852,MATH 18,B04,083751,Rideout; David Porter,5,0,36,31
1656934205852,MATH 18,B05,093473,Rideout; David Porter,4,0,36,32
1656934205852,MATH 18,B06,093474,Rideout; David Porter,5,0,36,31
1656934211891,MATH 20A,A01,083754,Zheng; Zequn,12,0,40,28
1656934217922,MATH 20B,A01,083756,Briones; Jor-el Thomas Caparas,1,0,36,35
1656934217922,MATH 20B,A02,083757,Briones; Jor-el Thomas Caparas,1,0,36,35
1656934217922,MATH 20B,A03,093475,Briones; Jor-el Thomas Caparas,0,0,36,36
1656934223955,MATH 20C,A01,083760,Briones; Jor-el Thomas Caparas,1,0,35,34
1656934223955,MATH 20C,A02,083761,Briones; Jor-el Thomas Caparas,8,0,35,27
1656934223955,MATH 20C,A03,093476,Briones; Jor-el Thomas Caparas,0,1,36,36
1656934223955,MATH 20C,B01,083762,Bach; Quang Tran,0,0,30,30
1656934229992,MATH 20D,A01,083765,Tran; Brian Kha,4,0,30,26
1656934229992,MATH 20D,A02,083766,Tran; Brian Kha,4,0,30,26
1656934229992,MATH 20D,A03,083767,Tran; Brian Kha,3,0,30,27
1656934236033,MATH 20E,A01,083771,Ganguly; Soumya,5,0,32,27
1656934236033,MATH 20E,A02,083772,Ganguly; Soumya,6,0,32,26
1656934236033,MATH 20E,B01,083773,Ciotti; Benjamin,18,0,35,17
1656934236033,MATH 20E,B02,083774,Ciotti; Benjamin,17,0,35,18
1656934242063,MATH 103A,A01,083777,Greenfeld; Be'Eri,2,0,36,34
1656934242063,MATH 103A,A02,083778,Greenfeld; Be'Eri,5,0,36,31
1656934242063,MATH 103A,A03,093561,Greenfeld; Be'Eri,4,0,36,32
1656934242063,MATH 103A,B01,083779,Greenfeld; Be'Eri,6,0,36,30
1656934242063,MATH 103A,B02,083780,Greenfeld; Be'Eri,2,0,36,34
1656934242063,MATH 103A,B03,093562,Greenfeld; Be'Eri,2,0,36,34
1656934248099,MATH 105,A01,085443,Carter; Anne Toulson,13,0,35,22
1656934248099,MATH 105,A02,093477,Carter; Anne Toulson,20,0,35,15
1656934254128,MATH 109,A01,083213,Ganzberger; Geoffrey Michael,2,0,34,32
1656934254128,MATH 109,A02,083214,Ganzberger; Geoffrey Michael,2,0,34,32
1656934254128,MATH 109,A03,093478,Ganzberger; Geoffrey Michael,1,0,34,33
1656934254128,MATH 109,B01,083215,Ganzberger; Geoffrey Michael,1,0,32,31
1656934254128,MATH 109,B02,083216,Ganzberger; Geoffrey Michael,1,0,32,31
1656934254128,MATH 109,B03,093479,Ganzberger; Geoffrey Michael,6,0,32,26
1656934260167,MATH 142A,A01,083219,Chow; Bennett,6,0,32,26
1656934260167,MATH 142A,A02,083220,Chow; Bennett,10,0,32,22
1656934260167,MATH 142A,A03,093480,Chow; Bennett,7,0,32,25
1656934260167,MATH 142A,B03,093481,Chow; Bennett,7,0,32,25
1656934260167,MATH 142A,B04,093558,Chow; Bennett,11,0,32,21
1656934260167,MATH 142A,B05,093559,Chow; Bennett,6,0,32,26
1656934266205,MATH 193A,A01,083224,Rotar; Vladimir,7,0,34,27
1656934266205,MATH 193A,A02,083225,Rotar; Vladimir,3,0,34,31
1656934266205,MATH 193A,A03,083781,Rotar; Vladimir,1,0,34,33
1656934266205,MATH 193A,A04,083782,Rotar; Vladimir,6,0,34,28
1656934266205,MATH 193A,A05,093482,Rotar; Vladimir,6,0,34,28
1656934272232,MATH 197,001,091859,McAuley; Julian John,9999,0,9999,0
1656934272232,MATH 197,002,095566,Kedlaya; Kiran S.,9997,0,9999,2
1656934272232,MATH 197,003,095567,Xiao; Ming,9999,0,9999,0
1656934272232,MATH 197,004,095571,Perols; Johan Lars,9998,0,9999,1
1656934279319,COGS 9,A01,083615,Shannon; Kyle Michael,7,0,75,68
1656934285347,COGS 11,A01,083617,Boyle; Mary E. T.,19,0,48,29
1656934291375,COGS 13,A01,083071,Bastos; Amalia Pinkusfeld,9,0,71,62
1656934297424,COGS 14A,A01,092681,Semenuks; Arturs,0,1,100,100
1656934303450,COGS 14B,A01,083073,Cheng; Tzu-Han,5,0,63,58
1656934309485,COGS 17,A01,092677,Semenuks; Arturs,4,0,81,77
1656934315517,COGS 100,A01,083619,Allen; Michael Gordon,15,0,70,55
1656934321622,COGS 101A,A01,083621,Davis; Joshua Daniel,9,0,68,59
1656934327654,COGS 101B,A01,091572,Allen; Michael Gordon,8,0,65,57
1656934333682,COGS 101C,A01,083625,Delgado; Tania,17,0,35,18
1656934345937,COGS 107A,A01,083627,Boyle; Mary E. T.,13,0,60,47
1656934351963,COGS 118A,A01,083075,Gupta; Anjum,15,0,76,61
1656934360247,CSE 3,A50,083646,Miranda; Gregory Joseph,22,0,50,28
1656934366277,CSE 8A,A50,083650,Miranda; Gregory Joseph,17,1,56,39
1656934372321,CSE 11,A01,083080,Cao; Yingjun,4,15,40,36
1656934378351,CSE 12,A01,083652,Krause-Levy; Sophia Louisa,20,1,120,100
1656934384379,CSE 15L,A01,083654,Morris; Justin Loren,8,0,50,42
1656934384379,CSE 15L,A02,083655,Morris; Justin Loren,8,0,50,42
1656934390409,CSE 20,A01,083657,Tran; Khoa Dang,37,0,80,43
1656934396436,CSE 21,A01,095574,Bach; Quang Tran,21,0,48,27
1656934402464,CSE 30,A01,083084,Eldon; John,4,0,80,76
1656934402464,CSE 30,B01,095061,Bhaskar; Nishant,6,0,50,44
1656934408498,CSE 100,A01,083659,Cao; Yingjun,3,4,70,67
1656934414524,CSE 134B,A01,083661,Powell; Thomas Allan,19,0,100,81
1656934420553,CSE 140,A01,083663,Gungor; Onat,14,0,85,71
1656934426580,CSE 140L,A01,083088,Eldon; John,16,0,100,84
1656934432610,CSE 175,A01,083665,Kumar; Rakesh,3,0,25,22
1656934438638,CSE 190,A00,092507,Dubnov; Shlomo,7,0,20,13
1656934444666,ECE 45,A01,083139,Congero; Spencer William,5,0,75,70
1656934450693,ECE 65,A50,083695,Saad; Andrew S,12,0,30,18
1656934450693,ECE 65,A51,095125,Saad; Andrew S,25,0,26,1
1656934456722,ECE 109,A01,091882,Touri; Behrouz,16,0,70,54
1656934462750,ECE 180,A00,083140,Abi Samra; Nicholas Camill,0,0,30,30
1656934462750,ECE 180,B00,083141,Abi Samra; Nicholas Camill,0,0,30,30
1656934468779,MATH 10A,A01,083735,Patchell; Gregory David,1,0,30,29
1656934468779,MATH 10A,A02,083736,Patchell; Gregory David,20,0,30,10
1656934468779,MATH 10A,A03,083737,Patchell; Gregory David,15,0,30,15
1656934474810,MATH 10B,A01,083207,Lim; Seonhee,7,0,34,27
1656934474810,MATH 10B,A02,083208,Lim; Seonhee,9,0,35,26
1656934474810,MATH 10B,A03,093472,Lim; Seonhee,4,0,34,30
1656934474810,MATH 10B,B01,083739,Sinha; Shubham,9,0,30,21
1656934480847,MATH 18,A01,083743,Cinel; Cameron Alexander,6,0,30,24
1656934480847,MATH 18,A02,083744,Cinel; Cameron Alexander,15,0,30,15
1656934480847,MATH 18,A03,083745,Cinel; Cameron Alexander,8,0,30,22
1656934480847,MATH 18,B01,083748,Rideout; David Porter,4,0,37,33
1656934480847,MATH 18,B02,083749,Rideout; David Porter,3,0,36,33
1656934480847,MATH 18,B03,083750,Rideout; David Porter,2,0,37,35
1656934480847,MATH 18,B04,083751,Rideout; David Porter,5,0,36,31
1656934480847,MATH 18,B05,093473,Rideout; David Porter,4,0,36,32
1656934480847,MATH 18,B06,093474,Rideout; David Porter,5,0,36,31
1656934486874,MATH 20A,A01,083754,Zheng; Zequn,12,0,40,28
1656934492903,MATH 20B,A01,083756,Briones; Jor-el Thomas Caparas,1,0,36,35
1656934492903,MATH 20B,A02,083757,Briones; Jor-el Thomas Caparas,1,0,36,35
1656934492903,MATH 20B,A03,093475,Briones; Jor-el Thomas Caparas,0,0,36,36
1656934498933,MATH 20C,A01,083760,Briones; Jor-el Thomas Caparas,1,0,35,34
1656934498933,MATH 20C,A02,083761,Briones; Jor-el Thomas Caparas,8,0,35,27
1656934498933,MATH 20C,A03,093476,Briones; Jor-el Thomas Caparas,0,1,36,36
1656934498933,MATH 20C,B01,083762,Bach; Quang Tran,0,0,30,30
1656934504968,MATH 20D,A01,083765,Tran; Brian Kha,4,0,30,26
1656934504968,MATH 20D,A02,083766,Tran; Brian Kha,4,0,30,26
1656934504968,MATH 20D,A03,083767,Tran; Brian Kha,3,0,30,27
1656934511003,MATH 20E,A01,083771,Ganguly; Soumya,5,0,32,27
1656934511003,MATH 20E,A02,083772,Ganguly; Soumya,6,0,32,26
1656934511003,MATH 20E,B01,083773,Ciotti; Benjamin,18,0,35,17
1656934511003,MATH 20E,B02,083774,Ciotti; Benjamin,17,0,35,18
1656934517031,MATH 103A,A01,083777,Greenfeld; Be'Eri,2,0,36,34
1656934517031,MATH 103A,A02,083778,Greenfeld; Be'Eri,5,0,36,31
1656934517031,MATH 103A,A03,093561,Greenfeld; Be'Eri,4,0,36,32
1656934517031,MATH 103A,B01,083779,Greenfeld; Be'Eri,6,0,36,30
1656934517031,MATH 103A,B02,083780,Greenfeld; Be'Eri,2,0,36,34
1656934517031,MATH 103A,B03,093562,Greenfeld; Be'Eri,2,0,36,34
1656934523066,MATH 105,A01,085443,Carter; Anne Toulson,13,0,35,22
1656934523066,MATH 105,A02,093477,Carter; Anne Toulson,20,0,35,15
1656934529101,MATH 109,A01,083213,Ganzberger; Geoffrey Michael,2,0,34,32
1656934529101,MATH 109,A02,083214,Ganzberger; Geoffrey Michael,2,0,34,32
1656934529101,MATH 109,A03,093478,Ganzberger; Geoffrey Michael,1,0,34,33
1656934529101,MATH 109,B01,083215,Ganzberger; Geoffrey Michael,1,0,32,31
1656934529101,MATH 109,B02,083216,Ganzberger; Geoffrey Michael,1,0,32,31
1656934529101,MATH 109,B03,093479,Ganzberger; Geoffrey Michael,6,0,32,26
1656934535133,MATH 142A,A01,083219,Chow; Bennett,6,0,32,26
1656934535133,MATH 142A,A02,083220,Chow; Bennett,10,0,32,22
1656934535133,MATH 142A,A03,093480,Chow; Bennett,7,0,32,25
1656934535133,MATH 142A,B03,093481,Chow; Bennett,7,0,32,25
1656934535133,MATH 142A,B04,093558,Chow; Bennett,11,0,32,21
1656934535133,MATH 142A,B05,093559,Chow; Bennett,6,0,32,26
1656934541161,MATH 193A,A01,083224,Rotar; Vladimir,7,0,34,27
1656934541161,MATH 193A,A02,083225,Rotar; Vladimir,3,0,34,31
1656934541161,MATH 193A,A03,083781,Rotar; Vladimir,1,0,34,33
1656934541161,MATH 193A,A04,083782,Rotar; Vladimir,6,0,34,28
1656934541161,MATH 193A,A05,093482,Rotar; Vladimir,6,0,34,28
1656934547192,MATH 197,001,091859,McAuley; Julian John,9999,0,9999,0
1656934547192,MATH 197,002,095566,Kedlaya; Kiran S.,9997,0,9999,2
1656934547192,MATH 197,003,095567,Xiao; Ming,9999,0,9999,0
1656934547192,MATH 197,004,095571,Perols; Johan Lars,9998,0,9999,1
1656934554288,COGS 9,A01,083615,Shannon; Kyle Michael,7,0,75,68
1656934560317,COGS 11,A01,083617,Boyle; Mary E. T.,19,0,48,29
1656934566343,COGS 13,A01,083071,Bastos; Amalia Pinkusfeld,9,0,71,62
1656934572372,COGS 14A,A01,092681,Semenuks; Arturs,0,1,100,100
1656934578401,COGS 14B,A01,083073,Cheng; Tzu-Han,5,0,63,58
1656934584431,COGS 17,A01,092677,Semenuks; Arturs,4,0,81,77
1656934590460,COGS 100,A01,083619,Allen; Michael Gordon,15,0,70,55
1656934596488,COGS 101A,A01,083621,Davis; Joshua Daniel,9,0,68,59
1656934602518,COGS 101B,A01,091572,Allen; Michael Gordon,8,0,65,57
1656934608551,COGS 101C,A01,083625,Delgado; Tania,17,0,35,18
1656934614577,COGS 107A,A01,083627,Boyle; Mary E. T.,13,0,60,47
1656934620607,COGS 118A,A01,083075,Gupta; Anjum,15,0,76,61
1656934626646,CSE 3,A50,083646,Miranda; Gregory Joseph,22,0,50,28
1656934632675,CSE 8A,A50,083650,Miranda; Gregory Joseph,17,1,56,39
1656934638704,CSE 11,A01,083080,Cao; Yingjun,4,15,40,36
1656934644736,CSE 12,A01,083652,Krause-Levy; Sophia Louisa,20,1,120,100
1656934650768,CSE 15L,A01,083654,Morris; Justin Loren,8,0,50,42
1656934650768,CSE 15L,A02,083655,Morris; Justin Loren,8,0,50,42
1656934656799,CSE 20,A01,083657,Tran; Khoa Dang,37,0,80,43
1656934662826,CSE 21,A01,095574,Bach; Quang Tran,21,0,48,27
1656934668856,CSE 30,A01,083084,Eldon; John,4,0,80,76
1656934668856,CSE 30,B01,095061,Bhaskar; Nishant,6,0,50,44
1656934674889,CSE 100,A01,083659,Cao; Yingjun,3,4,70,67
1656934680921,CSE 134B,A01,083661,Powell; Thomas Allan,19,0,100,81
1656934686950,CSE 140,A01,083663,Gungor; Onat,14,0,85,71
1656934692979,CSE 140L,A01,083088,Eldon; John,16,0,100,84
1656934699016,CSE 175,A01,083665,Kumar; Rakesh,3,0,25,22
1656934705047,CSE 190,A00,092507,Dubnov; Shlomo,7,0,20,13
1656934711076,ECE 45,A01,083139,Congero; Spencer William,5,0,75,70
1656934717107,ECE 65,A50,083695,Saad; Andrew S,12,0,30,18
1656934717107,ECE 65,A51,095125,Saad; Andrew S,25,0,26,1
1656934723134,ECE 109,A01,091882,Touri; Behrouz,16,0,70,54
1656934729169,ECE 180,A00,083140,Abi Samra; Nicholas Camill,0,0,30,30
1656934729169,ECE 180,B00,083141,Abi Samra; Nicholas Camill,0,0,30,30
1656934735204,MATH 10A,A01,083735,Patchell; Gregory David,1,0,30,29
1656934735204,MATH 10A,A02,083736,Patchell; Gregory David,20,0,30,10
1656934735204,MATH 10A,A03,083737,Patchell; Gregory David,15,0,30,15
1656934741245,MATH 10B,A01,083207,Lim; Seonhee,7,0,34,27
1656934741245,MATH 10B,A02,083208,Lim; Seonhee,9,0,35,26
1656934741245,MATH 10B,A03,093472,Lim; Seonhee,4,0,34,30
1656934741245,MATH 10B,B01,083739,Sinha; Shubham,9,0,30,21
1656934747291,MATH 18,A01,083743,Cinel; Cameron Alexander,6,0,30,24
1656934747291,MATH 18,A02,083744,Cinel; Cameron Alexander,15,0,30,15
1656934747291,MATH 18,A03,083745,Cinel; Cameron Alexander,8,0,30,22
1656934747291,MATH 18,B01,083748,Rideout; David Porter,4,0,37,33
1656934747291,MATH 18,B02,083749,Rideout; David Porter,3,0,36,33
1656934747291,MATH 18,B03,083750,Rideout; David Porter,2,0,37,35
1656934747291,MATH 18,B04,083751,Rideout; David Porter,5,0,36,31
1656934747291,MATH 18,B05,093473,Rideout; David Porter,4,0,36,32
1656934747291,MATH 18,B06,093474,Rideout; David Porter,5,0,36,31
1656934753319,MATH 20A,A01,083754,Zheng; Zequn,12,0,40,28
1656934759350,MATH 20B,A01,083756,Briones; Jor-el Thomas Caparas,1,0,36,35
1656934759350,MATH 20B,A02,083757,Briones; Jor-el Thomas Caparas,1,0,36,35
1656934759350,MATH 20B,A03,093475,Briones; Jor-el Thomas Caparas,0,0,36,36
1656934765379,MATH 20C,A01,083760,Briones; Jor-el Thomas Caparas,1,0,35,34
1656934765379,MATH 20C,A02,083761,Briones; Jor-el Thomas Caparas,8,0,35,27
1656934765379,MATH 20C,A03,093476,Briones; Jor-el Thomas Caparas,0,1,36,36
1656934765379,MATH 20C,B01,083762,Bach; Quang Tran,0,0,30,30
1656934771407,MATH 20D,A01,083765,Tran; Brian Kha,4,0,30,26
1656934771407,MATH 20D,A02,083766,Tran; Brian Kha,4,0,30,26
1656934771407,MATH 20D,A03,083767,Tran; Brian Kha,3,0,30,27
1656934777438,MATH 20E,A01,083771,Ganguly; Soumya,5,0,32,27
1656934777438,MATH 20E,A02,083772,Ganguly; Soumya,6,0,32,26
1656934777438,MATH 20E,B01,083773,Ciotti; Benjamin,18,0,35,17
1656934777438,MATH 20E,B02,083774,Ciotti; Benjamin,17,0,35,18
1656934783469,MATH 103A,A01,083777,Greenfeld; Be'Eri,2,0,36,34
1656934783469,MATH 103A,A02,083778,Greenfeld; Be'Eri,5,0,36,31
1656934783469,MATH 103A,A03,093561,Greenfeld; Be'Eri,4,0,36,32
1656934783469,MATH 103A,B01,083779,Greenfeld; Be'Eri,6,0,36,30
1656934783469,MATH 103A,B02,083780,Greenfeld; Be'Eri,2,0,36,34
1656934783469,MATH 103A,B03,093562,Greenfeld; Be'Eri,2,0,36,34
1656934789500,MATH 105,A01,085443,Carter; Anne Toulson,13,0,35,22
1656934789500,MATH 105,A02,093477,Carter; Anne Toulson,20,0,35,15
1656934795528,MATH 109,A01,083213,Ganzberger; Geoffrey Michael,2,0,34,32
1656934795528,MATH 109,A02,083214,Ganzberger; Geoffrey Michael,2,0,34,32
1656934795528,MATH 109,A03,093478,Ganzberger; Geoffrey Michael,1,0,34,33
1656934795528,MATH 109,B01,083215,Ganzberger; Geoffrey Michael,1,0,32,31
1656934795528,MATH 109,B02,083216,Ganzberger; Geoffrey Michael,1,0,32,31
1656934795528,MATH 109,B03,093479,Ganzberger; Geoffrey Michael,6,0,32,26
1656934801557,MATH 142A,A01,083219,Chow; Bennett,6,0,32,26
1656934801557,MATH 142A,A02,083220,Chow; Bennett,10,0,32,22
1656934801557,MATH 142A,A03,093480,Chow; Bennett,7,0,32,25
1656934801557,MATH 142A,B03,093481,Chow; Bennett,7,0,32,25
1656934801557,MATH 142A,B04,093558,Chow; Bennett,11,0,32,21
1656934801557,MATH 142A,B05,093559,Chow; Bennett,6,0,32,26
1656934807590,MATH 193A,A01,083224,Rotar; Vladimir,7,0,34,27
1656934807590,MATH 193A,A02,083225,Rotar; Vladimir,3,0,34,31
1656934807590,MATH 193A,A03,083781,Rotar; Vladimir,1,0,34,33
1656934807590,MATH 193A,A04,083782,Rotar; Vladimir,6,0,34,28
1656934807590,MATH 193A,A05,093482,Rotar; Vladimir,6,0,34,28
1656934813621,MATH 197,001,091859,McAuley; Julian John,9999,0,9999,0
1656934813621,MATH 197,002,095566,Kedlaya; Kiran S.,9997,0,9999,2
1656934813621,MATH 197,003,095567,Xiao; Ming,9999,0,9999,0
1656934813621,MATH 197,004,095571,Perols; Johan Lars,9998,0,9999,1
1656934820686,COGS 9,A01,083615,Shannon; Kyle Michael,7,0,75,68
1656934826717,COGS 11,A01,083617,Boyle; Mary E. T.,19,0,48,29
1656934832752,COGS 13,A01,083071,Bastos; Amalia Pinkusfeld,9,0,71,62
1656934838783,COGS 14A,A01,092681,Semenuks; Arturs,0,1,100,100
1656934844811,COGS 14B,A01,083073,Cheng; Tzu-Han,5,0,63,58
1656934850836,COGS 17,A01,092677,Semenuks; Arturs,4,0,81,77
1656934856868,COGS 100,A01,083619,Allen; Michael Gordon,15,0,70,55
1656934862897,COGS 101A,A01,083621,Davis; Joshua Daniel,9,0,68,59
1656934868924,COGS 101B,A01,091572,Allen; Michael Gordon,8,0,65,57
1656934874954,COGS 101C,A01,083625,Delgado; Tania,17,0,35,18
1656934880987,COGS 107A,A01,083627,Boyle; Mary E. T.,13,0,60,47
1656934887016,COGS 118A,A01,083075,Gupta; Anjum,15,0,76,61
1656934893049,CSE 3,A50,083646,Miranda; Gregory Joseph,22,0,50,28
1656934899076,CSE 8A,A50,083650,Miranda; Gregory Joseph,17,1,56,39
1656934905106,CSE 11,A01,083080,Cao; Yingjun,4,15,40,36
1656934911138,CSE 12,A01,083652,Krause-Levy; Sophia Louisa,20,1,120,100
1656934917171,CSE 15L,A01,083654,Morris; Justin Loren,8,0,50,42
1656934917171,CSE 15L,A02,083655,Morris; Justin Loren,8,0,50,42
1656934923203,CSE 20,A01,083657,Tran; Khoa Dang,37,0,80,43
1656934929320,CSE 21,A01,095574,Bach; Quang Tran,21,0,48,27
1656934935359,CSE 30,A01,083084,Eldon; John,4,0,80,76
1656934935359,CSE 30,B01,095061,Bhaskar; Nishant,6,0,50,44
1656934941393,CSE 100,A01,083659,Cao; Yingjun,3,4,70,67
1656934947423,CSE 134B,A01,083661,Powell; Thomas Allan,19,0,100,81
1656934953468,CSE 140,A01,083663,Gungor; Onat,14,0,85,71
1656934959512,CSE 140L,A01,083088,Eldon; John,16,0,100,84
1656934965539,CSE 175,A01,083665,Kumar; Rakesh,3,0,25,22
1656934971566,CSE 190,A00,092507,Dubnov; Shlomo,7,0,20,13
1656934977601,ECE 45,A01,083139,Congero; Spencer William,5,0,75,70
1656934983636,ECE 65,A50,083695,Saad; Andrew S,12,0,30,18
1656934983636,ECE 65,A51,095125,Saad; Andrew S,25,0,26,1
1656934989664,ECE 109,A01,091882,Touri; Behrouz,16,0,70,54
1656934995698,ECE 180,A00,083140,Abi Samra; Nicholas Camill,0,0,30,30
1656934995698,ECE 180,B00,083141,Abi Samra; Nicholas Camill,0,0,30,30
1656935001725,MATH 10A,A01,083735,Patchell; Gregory David,1,0,30,29
1656935001725,MATH 10A,A02,083736,Patchell; Gregory David,20,0,30,10
1656935001725,MATH 10A,A03,083737,Patchell; Gregory David,15,0,30,15
1656935007755,MATH 10B,A01,083207,Lim; Seonhee,7,0,34,27
1656935007755,MATH 10B,A02,083208,Lim; Seonhee,9,0,35,26
1656935007755,MATH 10B,A03,093472,Lim; Seonhee,4,0,34,30
1656935007755,MATH 10B,B01,083739,Sinha; Shubham,9,0,30,21
1656935013787,MATH 18,A01,083743,Cinel; Cameron Alexander,6,0,30,24
1656935013787,MATH 18,A02,083744,Cinel; Cameron Alexander,15,0,30,15
1656935013787,MATH 18,A03,083745,Cinel; Cameron Alexander,8,0,30,22
1656935013787,MATH 18,B01,083748,Rideout; David Porter,4,0,37,33
1656935013787,MATH 18,B02,083749,Rideout; David Porter,3,0,36,33
1656935013787,MATH 18,B03,083750,Rideout; David Porter,2,0,37,35
1656935013787,MATH 18,B04,083751,Rideout; David Porter,5,0,36,31
1656935013787,MATH 18,B05,093473,Rideout; David Porter,4,0,36,32
1656935013787,MATH 18,B06,093474,Rideout; David Porter,5,0,36,31
1656935019827,MATH 20A,A01,083754,Zheng; Zequn,12,0,40,28
1656935025861,MATH 20B,A01,083756,Briones; Jor-el Thomas Caparas,1,0,36,35
1656935025861,MATH 20B,A02,083757,Briones; Jor-el Thomas Caparas,1,0,36,35
1656935025861,MATH 20B,A03,093475,Briones; Jor-el Thomas Caparas,0,0,36,36
1656935031904,MATH 20C,A01,083760,Briones; Jor-el Thomas Caparas,1,0,35,34
1656935031904,MATH 20C,A02,083761,Briones; Jor-el Thomas Caparas,8,0,35,27
1656935031904,MATH 20C,A03,093476,Briones; Jor-el Thomas Caparas,0,1,36,36
1656935031904,MATH 20C,B01,083762,Bach; Quang Tran,0,0,30,30
1656935037934,MATH 20D,A01,083765,Tran; Brian Kha,4,0,30,26
1656935037934,MATH 20D,A02,083766,Tran; Brian Kha,4,0,30,26
1656935037934,MATH 20D,A03,083767,Tran; Brian Kha,3,0,30,27
1656935043988,MATH 20E,A01,083771,Ganguly; Soumya,5,0,32,27
1656935043988,MATH 20E,A02,083772,Ganguly; Soumya,6,0,32,26
1656935043988,MATH 20E,B01,083773,Ciotti; Benjamin,18,0,35,17
1656935043988,MATH 20E,B02,083774,Ciotti; Benjamin,17,0,35,18
1656935050020,MATH 103A,A01,083777,Greenfeld; Be'Eri,2,0,36,34
1656935050020,MATH 103A,A02,083778,Greenfeld; Be'Eri,5,0,36,31
1656935050020,MATH 103A,A03,093561,Greenfeld; Be'Eri,4,0,36,32
1656935050020,MATH 103A,B01,083779,Greenfeld; Be'Eri,6,0,36,30
1656935050020,MATH 103A,B02,083780,Greenfeld; Be'Eri,2,0,36,34
1656935050020,MATH 103A,B03,093562,Greenfeld; Be'Eri,2,0,36,34
1656935056055,MATH 105,A01,085443,Carter; Anne Toulson,13,0,35,22
1656935056055,MATH 105,A02,093477,Carter; Anne Toulson,20,0,35,15
1656935062091,MATH 109,A01,083213,Ganzberger; Geoffrey Michael,2,0,34,32
1656935062091,MATH 109,A02,083214,Ganzberger; Geoffrey Michael,2,0,34,32
1656935062091,MATH 109,A03,093478,Ganzberger; Geoffrey Michael,1,0,34,33
1656935062091,MATH 109,B01,083215,Ganzberger; Geoffrey Michael,1,0,32,31
1656935062091,MATH 109,B02,083216,Ganzberger; Geoffrey Michael,1,0,32,31
1656935062091,MATH 109,B03,093479,Ganzberger; Geoffrey Michael,6,0,32,26
1656935068121,MATH 142A,A01,083219,Chow; Bennett,6,0,32,26
1656935068121,MATH 142A,A02,083220,Chow; Bennett,10,0,32,22
1656935068121,MATH 142A,A03,093480,Chow; Bennett,7,0,32,25
1656935068121,MATH 142A,B03,093481,Chow; Bennett,7,0,32,25
1656935068121,MATH 142A,B04,093558,Chow; Bennett,11,0,32,21
1656935068121,MATH 142A,B05,093559,Chow; Bennett,6,0,32,26
1656935074154,MATH 193A,A01,083224,Rotar; Vladimir,7,0,34,27
1656935074154,MATH 193A,A02,083225,Rotar; Vladimir,3,0,34,31
1656935074154,MATH 193A,A03,083781,Rotar; Vladimir,1,0,34,33
1656935074154,MATH 193A,A04,083782,Rotar; Vladimir,6,0,34,28
1656935074154,MATH 193A,A05,093482,Rotar; Vladimir,6,0,34,28
1656935080184,MATH 197,001,091859,McAuley; Julian John,9999,0,9999,0
1656935080184,MATH 197,002,095566,Kedlaya; Kiran S.,9997,0,9999,2
1656935080184,MATH 197,003,095567,Xiao; Ming,9999,0,9999,0
1656935080184,MATH 197,004,095571,Perols; Johan Lars,9998,0,9999,1
1656935087271,COGS 9,A01,083615,Shannon; Kyle Michael,7,0,75,68
1656935093304,COGS 11,A01,083617,Boyle; Mary E. T.,19,0,48,29
1656935099332,COGS 13,A01,083071,Bastos; Amalia Pinkusfeld,9,0,71,62
1656935105362,COGS 14A,A01,092681,Semenuks; Arturs,0,1,100,100
1656935111394,COGS 14B,A01,083073,Cheng; Tzu-Han,5,0,63,58
1656935117427,COGS 17,A01,092677,Semenuks; Arturs,4,0,81,77
1656935123456,COGS 100,A01,083619,Allen; Michael Gordon,15,0,70,55
1656935129488,COGS 101A,A01,083621,Davis; Joshua Daniel,9,0,68,59
1656935135520,COGS 101B,A01,091572,Allen; Michael Gordon,8,0,65,57
1656935141557,COGS 101C,A01,083625,Delgado; Tania,17,0,35,18
1656935147590,COGS 107A,A01,083627,Boyle; Mary E. T.,13,0,60,47
1656935153621,COGS 118A,A01,083075,Gupta; Anjum,15,0,76,61
1656935159652,CSE 3,A50,083646,Miranda; Gregory Joseph,22,0,50,28
1656935165679,CSE 8A,A50,083650,Miranda; Gregory Joseph,17,1,56,39
1656935171706,CSE 11,A01,083080,Cao; Yingjun,4,15,40,36
1656935177740,CSE 12,A01,083652,Krause-Levy; Sophia Louisa,20,1,120,100
1656935183772,CSE 15L,A01,083654,Morris; Justin Loren,8,0,50,42
1656935183772,CSE 15L,A02,083655,Morris; Justin Loren,8,0,50,42
1656935189801,CSE 20,A01,083657,Tran; Khoa Dang,37,0,80,43
1656935195834,CSE 21,A01,095574,Bach; Quang Tran,21,0,48,27
1656935201864,CSE 30,A01,083084,Eldon; John,4,0,80,76
1656935201864,CSE 30,B01,095061,Bhaskar; Nishant,6,0,50,44
1656935207895,CSE 100,A01,083659,Cao; Yingjun,3,4,70,67
1656935213928,CSE 134B,A01,083661,Powell; Thomas Allan,19,0,100,81
1656935219956,CSE 140,A01,083663,Gungor; Onat,14,0,85,71
1656935225986,CSE 140L,A01,083088,Eldon; John,16,0,100,84
1656935232022,CSE 175,A01,083665,Kumar; Rakesh,3,0,25,22
1656935238053,CSE 190,A00,092507,Dubnov; Shlomo,7,0,20,13
1656935244083,ECE 45,A01,083139,Congero; Spencer William,5,0,75,70
1656935250111,ECE 65,A50,083695,Saad; Andrew S,12,0,30,18
1656935250111,ECE 65,A51,095125,Saad; Andrew S,25,0,26,1
1656935256138,ECE 109,A01,091882,Touri; Behrouz,16,0,70,54
1656935262173,ECE 180,A00,083140,Abi Samra; Nicholas Camill,0,0,30,30
1656935262173,ECE 180,B00,083141,Abi Samra; Nicholas Camill,0,0,30,30
1656935268754,MATH 10A,A01,083735,Patchell; Gregory David,1,0,30,29
1656935268754,MATH 10A,A02,083736,Patchell; Gregory David,20,0,30,10
1656935268754,MATH 10A,A03,083737,Patchell; Gregory David,15,0,30,15
1656935274786,MATH 10B,A01,083207,Lim; Seonhee,7,0,34,27
1656935274786,MATH 10B,A02,083208,Lim; Seonhee,9,0,35,26
1656935274786,MATH 10B,A03,093472,Lim; Seonhee,4,0,34,30
1656935274786,MATH 10B,B01,083739,Sinha; Shubham,9,0,30,21
1656935280815,MATH 18,A01,083743,Cinel; Cameron Alexander,6,0,30,24
1656935280815,MATH 18,A02,083744,Cinel; Cameron Alexander,15,0,30,15
1656935280815,MATH 18,A03,083745,Cinel; Cameron Alexander,8,0,30,22
1656935280815,MATH 18,B01,083748,Rideout; David Porter,4,0,37,33
1656935280815,MATH 18,B02,083749,Rideout; David Porter,3,0,36,33
1656935280815,MATH 18,B03,083750,Rideout; David Porter,2,0,37,35
1656935280815,MATH 18,B04,083751,Rideout; David Porter,5,0,36,31
1656935280815,MATH 18,B05,093473,Rideout; David Porter,4,0,36,32
1656935280815,MATH 18,B06,093474,Rideout; David Porter,5,0,36,31
1656935286844,MATH 20A,A01,083754,Zheng; Zequn,12,0,40,28
1656935292872,MATH 20B,A01,083756,Briones; Jor-el Thomas Caparas,1,0,36,35
1656935292872,MATH 20B,A02,083757,Briones; Jor-el Thomas Caparas,1,0,36,35
1656935292872,MATH 20B,A03,093475,Briones; Jor-el Thomas Caparas,0,0,36,36
1656935298905,MATH 20C,A01,083760,Briones; Jor-el Thomas Caparas,1,0,35,34
1656935298905,MATH 20C,A02,083761,Briones; Jor-el Thomas Caparas,8,0,35,27
1656935298905,MATH 20C,A03,093476,Briones; Jor-el Thomas Caparas,0,1,36,36
1656935298905,MATH 20C,B01,083762,Bach; Quang Tran,0,0,30,30
1656935304938,MATH 20D,A01,083765,Tran; Brian Kha,4,0,30,26
1656935304938,MATH 20D,A02,083766,Tran; Brian Kha,4,0,30,26
1656935304938,MATH 20D,A03,083767,Tran; Brian Kha,3,0,30,27
1656935310983,MATH 20E,A01,083771,Ganguly; Soumya,5,0,32,27
1656935310983,MATH 20E,A02,083772,Ganguly; Soumya,6,0,32,26
1656935310983,MATH 20E,B01,083773,Ciotti; Benjamin,18,0,35,17
1656935310983,MATH 20E,B02,083774,Ciotti; Benjamin,17,0,35,18
1656935317022,MATH 103A,A01,083777,Greenfeld; Be'Eri,2,0,36,34
1656935317022,MATH 103A,A02,083778,Greenfeld; Be'Eri,5,0,36,31
1656935317022,MATH 103A,A03,093561,Greenfeld; Be'Eri,4,0,36,32
1656935317022,MATH 103A,B01,083779,Greenfeld; Be'Eri,6,0,36,30
1656935317022,MATH 103A,B02,083780,Greenfeld; Be'Eri,2,0,36,34
1656935317022,MATH 103A,B03,093562,Greenfeld; Be'Eri,2,0,36,34
1656935323054,MATH 105,A01,085443,Carter; Anne Toulson,13,0,35,22
1656935323054,MATH 105,A02,093477,Carter; Anne Toulson,20,0,35,15
1656935329081,MATH 109,A01,083213,Ganzberger; Geoffrey Michael,2,0,34,32
1656935329081,MATH 109,A02,083214,Ganzberger; Geoffrey Michael,2,0,34,32
1656935329081,MATH 109,A03,093478,Ganzberger; Geoffrey Michael,1,0,34,33
1656935329081,MATH 109,B01,083215,Ganzberger; Geoffrey Michael,1,0,32,31
1656935329081,MATH 109,B02,083216,Ganzberger; Geoffrey Michael,1,0,32,31
1656935329081,MATH 109,B03,093479,Ganzberger; Geoffrey Michael,6,0,32,26
1656935335114,MATH 142A,A01,083219,Chow; Bennett,6,0,32,26
1656935335114,MATH 142A,A02,083220,Chow; Bennett,10,0,32,22
1656935335114,MATH 142A,A03,093480,Chow; Bennett,7,0,32,25
1656935335114,MATH 142A,B03,093481,Chow; Bennett,7,0,32,25
1656935335114,MATH 142A,B04,093558,Chow; Bennett,11,0,32,21
1656935335114,MATH 142A,B05,093559,Chow; Bennett,6,0,32,26
1656935341144,MATH 193A,A01,083224,Rotar; Vladimir,7,0,34,27
1656935341144,MATH 193A,A02,083225,Rotar; Vladimir,3,0,34,31
1656935341144,MATH 193A,A03,083781,Rotar; Vladimir,1,0,34,33
1656935341144,MATH 193A,A04,083782,Rotar; Vladimir,6,0,34,28
1656935341144,MATH 193A,A05,093482,Rotar; Vladimir,6,0,34,28
1656935347172,MATH 197,001,091859,McAuley; Julian John,9999,0,9999,0
1656935347172,MATH 197,002,095566,Kedlaya; Kiran S.,9997,0,9999,2
1656935347172,MATH 197,003,095567,Xiao; Ming,9999,0,9999,0
1656935347172,MATH 197,004,095571,Perols; Johan Lars,9998,0,9999,1
1656935354259,COGS 9,A01,083615,Shannon; Kyle Michael,7,0,75,68
1656935360288,COGS 11,A01,083617,Boyle; Mary E. T.,19,0,48,29
1656935366315,COGS 13,A01,083071,Bastos; Amalia Pinkusfeld,9,0,71,62
1656935372343,COGS 14A,A01,092681,Semenuks; Arturs,0,1,100,100
1656935378377,COGS 14B,A01,083073,Cheng; Tzu-Han,5,0,63,58
1656935384408,COGS 17,A01,092677,Semenuks; Arturs,4,0,81,77
1656935390436,COGS 100,A01,083619,Allen; Michael Gordon,15,0,70,55
1656935396462,COGS 101A,A01,083621,Davis; Joshua Daniel,9,0,68,59
1656935402488,COGS 101B,A01,091572,Allen; Michael Gordon,8,0,65,57
1656935408524,COGS 101C,A01,083625,Delgado; Tania,17,0,35,18
1656935414552,COGS 107A,A01,083627,Boyle; Mary E. T.,13,0,60,47
1656935420580,COGS 118A,A01,083075,Gupta; Anjum,15,0,76,61
1656935426608,CSE 3,A50,083646,Miranda; Gregory Joseph,22,0,50,28
1656935432642,CSE 8A,A50,083650,Miranda; Gregory Joseph,17,1,56,39
1656935438672,CSE 11,A01,083080,Cao; Yingjun,4,15,40,36
1656935444699,CSE 12,A01,083652,Krause-Levy; Sophia Louisa,20,1,120,100
1656935450732,CSE 15L,A01,083654,Morris; Justin Loren,8,0,50,42
1656935450732,CSE 15L,A02,083655,Morris; Justin Loren,8,0,50,42
1656935456764,CSE 20,A01,083657,Tran; Khoa Dang,37,0,80,43
1656935462792,CSE 21,A01,095574,Bach; Quang Tran,21,0,48,27
1656935468820,CSE 30,A01,083084,Eldon; John,4,0,80,76
1656935468820,CSE 30,B01,095061,Bhaskar; Nishant,6,0,50,44
1656935474849,CSE 100,A01,083659,Cao; Yingjun,3,4,70,67
1656935480879,CSE 134B,A01,083661,Powell; Thomas Allan,19,0,100,81
1656935486905,CSE 140,A01,083663,Gungor; Onat,14,0,85,71
1656935492933,CSE 140L,A01,083088,Eldon; John,16,0,100,84
1656935498965,CSE 175,A01,083665,Kumar; Rakesh,3,0,25,22
1656935504996,CSE 190,A00,092507,Dubnov; Shlomo,7,0,20,13
1656935511025,ECE 45,A01,083139,Congero; Spencer William,5,0,75,70
1656935517053,ECE 65,A50,083695,Saad; Andrew S,12,0,30,18
1656935517053,ECE 65,A51,095125,Saad; Andrew S,25,0,26,1
1656935523080,ECE 109,A01,091882,Touri; Behrouz,16,0,70,54
1656935529202,ECE 180,A00,083140,Abi Samra; Nicholas Camill,0,0,30,30
1656935529202,ECE 180,B00,083141,Abi Samra; Nicholas Camill,0,0,30,30
1656935535236,MATH 10A,A01,083735,Patchell; Gregory David,1,0,30,29
1656935535236,MATH 10A,A02,083736,Patchell; Gregory David,20,0,30,10
1656935535236,MATH 10A,A03,083737,Patchell; Gregory David,15,0,30,15
1656935541271,MATH 10B,A01,083207,Lim; Seonhee,7,0,34,27
1656935541271,MATH 10B,A02,083208,Lim; Seonhee,9,0,35,26
1656935541271,MATH 10B,A03,093472,Lim; Seonhee,4,0,34,30
1656935541271,MATH 10B,B01,083739,Sinha; Shubham,9,0,30,21
1656935547300,MATH 18,A01,083743,Cinel; Cameron Alexander,6,0,30,24
1656935547300,MATH 18,A02,083744,Cinel; Cameron Alexander,15,0,30,15
1656935547300,MATH 18,A03,083745,Cinel; Cameron Alexander,8,0,30,22
1656935547300,MATH 18,B01,083748,Rideout; David Porter,4,0,37,33
1656935547300,MATH 18,B02,083749,Rideout; David Porter,3,0,36,33
1656935547300,MATH 18,B03,083750,Rideout; David Porter,2,0,37,35
1656935547300,MATH 18,B04,083751,Rideout; David Porter,5,0,36,31
1656935547300,MATH 18,B05,093473,Rideout; David Porter,4,0,36,32
1656935547300,MATH 18,B06,093474,Rideout; David Porter,5,0,36,31
1656935553331,MATH 20A,A01,083754,Zheng; Zequn,12,0,40,28
1656935559365,MATH 20B,A01,083756,Briones; Jor-el Thomas Caparas,1,0,36,35
1656935559365,MATH 20B,A02,083757,Briones; Jor-el Thomas Caparas,1,0,36,35
1656935559365,MATH 20B,A03,093475,Briones; Jor-el Thomas Caparas,0,0,36,36
1656935565392,MATH 20C,A01,083760,Briones; Jor-el Thomas Caparas,1,0,35,34
1656935565392,MATH 20C,A02,083761,Briones; Jor-el Thomas Caparas,8,0,35,27
1656935565392,MATH 20C,A03,093476,Briones; Jor-el Thomas Caparas,0,1,36,36
1656935565392,MATH 20C,B01,083762,Bach; Quang Tran,0,0,30,30
1656935571420,MATH 20D,A01,083765,Tran; Brian Kha,4,0,30,26
1656935571420,MATH 20D,A02,083766,Tran; Brian Kha,4,0,30,26
1656935571420,MATH 20D,A03,083767,Tran; Brian Kha,3,0,30,27
1656935577450,MATH 20E,A01,083771,Ganguly; Soumya,5,0,32,27
1656935577450,MATH 20E,A02,083772,Ganguly; Soumya,6,0,32,26
1656935577450,MATH 20E,B01,083773,Ciotti; Benjamin,18,0,35,17
1656935577450,MATH 20E,B02,083774,Ciotti; Benjamin,17,0,35,18
1656935583480,MATH 103A,A01,083777,Greenfeld; Be'Eri,2,0,36,34
1656935583480,MATH 103A,A02,083778,Greenfeld; Be'Eri,5,0,36,31
1656935583480,MATH 103A,A03,093561,Greenfeld; Be'Eri,4,0,36,32
1656935583480,MATH 103A,B01,083779,Greenfeld; Be'Eri,6,0,36,30
1656935583480,MATH 103A,B02,083780,Greenfeld; Be'Eri,2,0,36,34
1656935583480,MATH 103A,B03,093562,Greenfeld; Be'Eri,2,0,36,34
1656935589507,MATH 105,A01,085443,Carter; Anne Toulson,13,0,35,22
1656935589507,MATH 105,A02,093477,Carter; Anne Toulson,20,0,35,15
1656935595537,MATH 109,A01,083213,Ganzberger; Geoffrey Michael,2,0,34,32
1656935595537,MATH 109,A02,083214,Ganzberger; Geoffrey Michael,2,0,34,32
1656935595537,MATH 109,A03,093478,Ganzberger; Geoffrey Michael,1,0,34,33
1656935595537,MATH 109,B01,083215,Ganzberger; Geoffrey Michael,1,0,32,31
1656935595537,MATH 109,B02,083216,Ganzberger; Geoffrey Michael,1,0,32,31
1656935595537,MATH 109,B03,093479,Ganzberger; Geoffrey Michael,6,0,32,26
1656935601566,MATH 142A,A01,083219,Chow; Bennett,6,0,32,26
1656935601566,MATH 142A,A02,083220,Chow; Bennett,10,0,32,22
1656935601566,MATH 142A,A03,093480,Chow; Bennett,7,0,32,25
1656935601566,MATH 142A,B03,093481,Chow; Bennett,7,0,32,25
1656935601566,MATH 142A,B04,093558,Chow; Bennett,11,0,32,21
1656935601566,MATH 142A,B05,093559,Chow; Bennett,6,0,32,26
1656935607604,MATH 193A,A01,083224,Rotar; Vladimir,7,0,34,27
1656935607604,MATH 193A,A02,083225,Rotar; Vladimir,3,0,34,31
1656935607604,MATH 193A,A03,083781,Rotar; Vladimir,1,0,34,33
1656935607604,MATH 193A,A04,083782,Rotar; Vladimir,6,0,34,28
1656935607604,MATH 193A,A05,093482,Rotar; Vladimir,6,0,34,28
1656935613639,MATH 197,001,091859,McAuley; Julian John,9999,0,9999,0
1656935613639,MATH 197,002,095566,Kedlaya; Kiran S.,9997,0,9999,2
1656935613639,MATH 197,003,095567,Xiao; Ming,9999,0,9999,0
1656935613639,MATH 197,004,095571,Perols; Johan Lars,9998,0,9999,1
1656935620704,COGS 9,A01,083615,Shannon; Kyle Michael,7,0,75,68
1656935626731,COGS 11,A01,083617,Boyle; Mary E. T.,19,0,48,29
1656935632757,COGS 13,A01,083071,Bastos; Amalia Pinkusfeld,9,0,71,62
1656935638782,COGS 14A,A01,092681,Semenuks; Arturs,0,1,100,100
1656935644811,COGS 14B,A01,083073,Cheng; Tzu-Han,5,0,63,58
1656935650843,COGS 17,A01,092677,Semenuks; Arturs,4,0,81,77
1656935656876,COGS 100,A01,083619,Allen; Michael Gordon,15,0,70,55
1656935662912,COGS 101A,A01,083621,Davis; Joshua Daniel,9,0,68,59
1656935668937,COGS 101B,A01,091572,Allen; Michael Gordon,8,0,65,57
1656935674969,COGS 101C,A01,083625,Delgado; Tania,17,0,35,18
1656935680996,COGS 107A,A01,083627,Boyle; Mary E. T.,13,0,60,47
1656935687025,COGS 118A,A01,083075,Gupta; Anjum,15,0,76,61
1656935693061,CSE 3,A50,083646,Miranda; Gregory Joseph,22,0,50,28
1656935699097,CSE 8A,A50,083650,Miranda; Gregory Joseph,17,1,56,39
1656935705122,CSE 11,A01,083080,Cao; Yingjun,4,15,40,36
1656935711149,CSE 12,A01,083652,Krause-Levy; Sophia Louisa,20,1,120,100
1656935717174,CSE 15L,A01,083654,Morris; Justin Loren,8,0,50,42
1656935717174,CSE 15L,A02,083655,Morris; Justin Loren,8,0,50,42
1656935723215,CSE 20,A01,083657,Tran; Khoa Dang,37,0,80,43
1656935729243,CSE 21,A01,095574,Bach; Quang Tran,21,0,48,27
1656935735268,CSE 30,A01,083084,Eldon; John,4,0,80,76
1656935735268,CSE 30,B01,095061,Bhaskar; Nishant,6,0,50,44
1656935741294,CSE 100,A01,083659,Cao; Yingjun,3,4,70,67
1656935747321,CSE 134B,A01,083661,Powell; Thomas Allan,19,0,100,81
1656935753347,CSE 140,A01,083663,Gungor; Onat,14,0,85,71
1656935759381,CSE 140L,A01,083088,Eldon; John,16,0,100,84
1656935765407,CSE 175,A01,083665,Kumar; Rakesh,3,0,25,22
1656935771432,CSE 190,A00,092507,Dubnov; Shlomo,7,0,20,13
1656935777469,ECE 45,A01,083139,Congero; Spencer William,5,0,75,70
1656935783501,ECE 65,A50,083695,Saad; Andrew S,12,0,30,18
1656935783501,ECE 65,A51,095125,Saad; Andrew S,25,0,26,1
1656935789529,ECE 109,A01,091882,Touri; Behrouz,16,0,70,54
1656935795561,ECE 180,A00,083140,Abi Samra; Nicholas Camill,0,0,30,30
1656935795561,ECE 180,B00,083141,Abi Samra; Nicholas Camill,0,0,30,30
1656935801596,MATH 10A,A01,083735,Patchell; Gregory David,1,0,30,29
1656935801596,MATH 10A,A02,083736,Patchell; Gregory David,20,0,30,10
1656935801596,MATH 10A,A03,083737,Patchell; Gregory David,15,0,30,15
1656935807638,MATH 10B,A01,083207,Lim; Seonhee,7,0,34,27
1656935807638,MATH 10B,A02,083208,Lim; Seonhee,9,0,35,26
1656935807638,MATH 10B,A03,093472,Lim; Seonhee,4,0,34,30
1656935807638,MATH 10B,B01,083739,Sinha; Shubham,9,0,30,21
1656935813672,MATH 18,A01,083743,Cinel; Cameron Alexander,6,0,30,24
1656935813672,MATH 18,A02,083744,Cinel; Cameron Alexander,15,0,30,15
1656935813672,MATH 18,A03,083745,Cinel; Cameron Alexander,8,0,30,22
1656935813672,MATH 18,B01,083748,Rideout; David Porter,4,0,37,33
1656935813672,MATH 18,B02,083749,Rideout; David Porter,3,0,36,33
1656935813672,MATH 18,B03,083750,Rideout; David Porter,2,0,37,35
1656935813672,MATH 18,B04,083751,Rideout; David Porter,5,0,36,31
1656935813672,MATH 18,B05,093473,Rideout; David Porter,4,0,36,32
1656935813672,MATH 18,B06,093474,Rideout; David Porter,5,0,36,31
1656935819698,MATH 20A,A01,083754,Zheng; Zequn,12,0,40,28
1656935825733,MATH 20B,A01,083756,Briones; Jor-el Thomas Caparas,1,0,36,35
1656935825733,MATH 20B,A02,083757,Briones; Jor-el Thomas Caparas,1,0,36,35
1656935825733,MATH 20B,A03,093475,Briones; Jor-el Thomas Caparas,0,0,36,36
1656935831763,MATH 20C,A01,083760,Briones; Jor-el Thomas Caparas,1,0,35,34
1656935831763,MATH 20C,A02,083761,Briones; Jor-el Thomas Caparas,8,0,35,27
1656935831763,MATH 20C,A03,093476,Briones; Jor-el Thomas Caparas,0,1,36,36
1656935831763,MATH 20C,B01,083762,Bach; Quang Tran,0,0,30,30
1656935837799,MATH 20D,A01,083765,Tran; Brian Kha,4,0,30,26
1656935837799,MATH 20D,A02,083766,Tran; Brian Kha,4,0,30,26
1656935837799,MATH 20D,A03,083767,Tran; Brian Kha,3,0,30,27
1656935843827,MATH 20E,A01,083771,Ganguly; Soumya,5,0,32,27
1656935843827,MATH 20E,A02,083772,Ganguly; Soumya,6,0,32,26
1656935843827,MATH 20E,B01,083773,Ciotti; Benjamin,18,0,35,17
1656935843827,MATH 20E,B02,083774,Ciotti; Benjamin,17,0,35,18
1656935849858,MATH 103A,A01,083777,Greenfeld; Be'Eri,2,0,36,34
1656935849858,MATH 103A,A02,083778,Greenfeld; Be'Eri,5,0,36,31
1656935849858,MATH 103A,A03,093561,Greenfeld; Be'Eri,4,0,36,32
1656935849858,MATH 103A,B01,083779,Greenfeld; Be'Eri,6,0,36,30
1656935849858,MATH 103A,B02,083780,Greenfeld; Be'Eri,2,0,36,34
1656935849858,MATH 103A,B03,093562,Greenfeld; Be'Eri,2,0,36,34
1656935855884,MATH 105,A01,085443,Carter; Anne Toulson,13,0,35,22
1656935855884,MATH 105,A02,093477,Carter; Anne Toulson,20,0,35,15
1656935861914,MATH 109,A01,083213,Ganzberger; Geoffrey Michael,2,0,34,32
1656935861914,MATH 109,A02,083214,Ganzberger; Geoffrey Michael,2,0,34,32
1656935861914,MATH 109,A03,093478,Ganzberger; Geoffrey Michael,1,0,34,33
1656935861914,MATH 109,B01,083215,Ganzberger; Geoffrey Michael,1,0,32,31
1656935861914,MATH 109,B02,083216,Ganzberger; Geoffrey Michael,1,0,32,31
1656935861914,MATH 109,B03,093479,Ganzberger; Geoffrey Michael,6,0,32,26
1656935867944,MATH 142A,A01,083219,Chow; Bennett,6,0,32,26
1656935867944,MATH 142A,A02,083220,Chow; Bennett,10,0,32,22
1656935867944,MATH 142A,A03,093480,Chow; Bennett,7,0,32,25
1656935867944,MATH 142A,B03,093481,Chow; Bennett,7,0,32,25
1656935867944,MATH 142A,B04,093558,Chow; Bennett,11,0,32,21
1656935867944,MATH 142A,B05,093559,Chow; Bennett,6,0,32,26
1656935873982,MATH 193A,A01,083224,Rotar; Vladimir,7,0,34,27
1656935873982,MATH 193A,A02,083225,Rotar; Vladimir,3,0,34,31
1656935873982,MATH 193A,A03,083781,Rotar; Vladimir,1,0,34,33
1656935873982,MATH 193A,A04,083782,Rotar; Vladimir,6,0,34,28
1656935873982,MATH 193A,A05,093482,Rotar; Vladimir,6,0,34,28
1656935880013,MATH 197,001,091859,McAuley; Julian John,9999,0,9999,0
1656935880013,MATH 197,002,095566,Kedlaya; Kiran S.,9997,0,9999,2
1656935880013,MATH 197,003,095567,Xiao; Ming,9999,0,9999,0
1656935880013,MATH 197,004,095571,Perols; Johan Lars,9998,0,9999,1
1656935887115,COGS 9,A01,083615,Shannon; Kyle Michael,7,0,75,68
1656935893144,COGS 11,A01,083617,Boyle; Mary E. T.,19,0,48,29
1656935899188,COGS 13,A01,083071,Bastos; Amalia Pinkusfeld,9,0,71,62
1656935905214,COGS 14A,A01,092681,Semenuks; Arturs,0,1,100,100
1656935911242,COGS 14B,A01,083073,Cheng; Tzu-Han,5,0,63,58
1656935917272,COGS 17,A01,092677,Semenuks; Arturs,4,0,81,77
1656935923308,COGS 100,A01,083619,Allen; Michael Gordon,15,0,70,55
1656935929333,COGS 101A,A01,083621,Davis; Joshua Daniel,9,0,68,59
1656935935365,COGS 101B,A01,091572,Allen; Michael Gordon,8,0,65,57
1656935941392,COGS 101C,A01,083625,Delgado; Tania,17,0,35,18
1656935947420,COGS 107A,A01,083627,Boyle; Mary E. T.,13,0,60,47
1656935953449,COGS 118A,A01,083075,Gupta; Anjum,15,0,76,61
1656935959486,CSE 3,A50,083646,Miranda; Gregory Joseph,22,0,50,28
1656935965516,CSE 8A,A50,083650,Miranda; Gregory Joseph,17,1,56,39
1656935971542,CSE 11,A01,083080,Cao; Yingjun,4,15,40,36
1656935977569,CSE 12,A01,083652,Krause-Levy; Sophia Louisa,20,1,120,100
1656935983599,CSE 15L,A01,083654,Morris; Justin Loren,8,0,50,42
1656935983599,CSE 15L,A02,083655,Morris; Justin Loren,8,0,50,42
1656935989624,CSE 20,A01,083657,Tran; Khoa Dang,37,0,80,43
1656935995651,CSE 21,A01,095574,Bach; Quang Tran,21,0,48,27
1656936001688,CSE 30,A01,083084,Eldon; John,4,0,80,76
1656936001688,CSE 30,B01,095061,Bhaskar; Nishant,6,0,50,44
1656936007713,CSE 100,A01,083659,Cao; Yingjun,3,4,70,67
1656936013738,CSE 134B,A01,083661,Powell; Thomas Allan,19,0,100,81
1656936019767,CSE 140,A01,083663,Gungor; Onat,14,0,85,71
1656936025791,CSE 140L,A01,083088,Eldon; John,16,0,100,84
1656936031819,CSE 175,A01,083665,Kumar; Rakesh,3,0,25,22
1656936037843,CSE 190,A00,092507,Dubnov; Shlomo,7,0,20,13
1656936043868,ECE 45,A01,083139,Congero; Spencer William,5,0,75,70
1656936049899,ECE 65,A50,083695,Saad; Andrew S,12,0,30,18
1656936049899,ECE 65,A51,095125,Saad; Andrew S,25,0,26,1
1656936055927,ECE 109,A01,091882,Touri; Behrouz,16,0,70,54
1656936061958,ECE 180,A00,083140,Abi Samra; Nicholas Camill,0,0,30,30
1656936061958,ECE 180,B00,083141,Abi Samra; Nicholas Camill,0,0,30,30
1656936067999,MATH 10A,A01,083735,Patchell; Gregory David,1,0,30,29
1656936067999,MATH 10A,A02,083736,Patchell; Gregory David,20,0,30,10
1656936067999,MATH 10A,A03,083737,Patchell; Gregory David,15,0,30,15
1656936074030,MATH 10B,A01,083207,Lim; Seonhee,7,0,34,27
1656936074030,MATH 10B,A02,083208,Lim; Seonhee,9,0,35,26
1656936074030,MATH 10B,A03,093472,Lim; Seonhee,4,0,34,30
1656936074030,MATH 10B,B01,083739,Sinha; Shubham,9,0,30,21
1656936080057,MATH 18,A01,083743,Cinel; Cameron Alexander,6,0,30,24
1656936080057,MATH 18,A02,083744,Cinel; Cameron Alexander,15,0,30,15
1656936080057,MATH 18,A03,083745,Cinel; Cameron Alexander,8,0,30,22
1656936080057,MATH 18,B01,083748,Rideout; David Porter,4,0,37,33
1656936080057,MATH 18,B02,083749,Rideout; David Porter,3,0,36,33
1656936080057,MATH 18,B03,083750,Rideout; David Porter,2,0,37,35
1656936080057,MATH 18,B04,083751,Rideout; David Porter,5,0,36,31
1656936080057,MATH 18,B05,093473,Rideout; David Porter,4,0,36,32
1656936080057,MATH 18,B06,093474,Rideout; David Porter,5,0,36,31
1656936086084,MATH 20A,A01,083754,Zheng; Zequn,12,0,40,28
1656936092113,MATH 20B,A01,083756,Briones; Jor-el Thomas Caparas,1,0,36,35
1656936092113,MATH 20B,A02,083757,Briones; Jor-el Thomas Caparas,1,0,36,35
1656936092113,MATH 20B,A03,093475,Briones; Jor-el Thomas Caparas,0,0,36,36
1656936098146,MATH 20C,A01,083760,Briones; Jor-el Thomas Caparas,1,0,35,34
1656936098146,MATH 20C,A02,083761,Briones; Jor-el Thomas Caparas,8,0,35,27
1656936098146,MATH 20C,A03,093476,Briones; Jor-el Thomas Caparas,0,1,36,36
1656936098146,MATH 20C,B01,083762,Bach; Quang Tran,0,0,30,30
1656936104174,MATH 20D,A01,083765,Tran; Brian Kha,4,0,30,26
1656936104174,MATH 20D,A02,083766,Tran; Brian Kha,4,0,30,26
1656936104174,MATH 20D,A03,083767,Tran; Brian Kha,3,0,30,27
1656936110207,MATH 20E,A01,083771,Ganguly; Soumya,5,0,32,27
1656936110207,MATH 20E,A02,083772,Ganguly; Soumya,6,0,32,26
1656936110207,MATH 20E,B01,083773,Ciotti; Benjamin,18,0,35,17
1656936110207,MATH 20E,B02,083774,Ciotti; Benjamin,17,0,35,18
1656936116243,MATH 103A,A01,083777,Greenfeld; Be'Eri,2,0,36,34
1656936116243,MATH 103A,A02,083778,Greenfeld; Be'Eri,5,0,36,31
1656936116243,MATH 103A,A03,093561,Greenfeld; Be'Eri,4,0,36,32
1656936116243,MATH 103A,B01,083779,Greenfeld; Be'Eri,6,0,36,30
1656936116243,MATH 103A,B02,083780,Greenfeld; Be'Eri,2,0,36,34
1656936116243,MATH 103A,B03,093562,Greenfeld; Be'Eri,2,0,36,34
1656936122272,MATH 105,A01,085443,Carter; Anne Toulson,13,0,35,22
1656936122272,MATH 105,A02,093477,Carter; Anne Toulson,20,0,35,15
1656936128394,MATH 109,A01,083213,Ganzberger; Geoffrey Michael,2,0,34,32
1656936128394,MATH 109,A02,083214,Ganzberger; Geoffrey Michael,2,0,34,32
1656936128394,MATH 109,A03,093478,Ganzberger; Geoffrey Michael,1,0,34,33
1656936128394,MATH 109,B01,083215,Ganzberger; Geoffrey Michael,1,0,32,31
1656936128394,MATH 109,B02,083216,Ganzberger; Geoffrey Michael,1,0,32,31
1656936128394,MATH 109,B03,093479,Ganzberger; Geoffrey Michael,6,0,32,26
1656936134421,MATH 142A,A01,083219,Chow; Bennett,6,0,32,26
1656936134421,MATH 142A,A02,083220,Chow; Bennett,10,0,32,22
1656936134421,MATH 142A,A03,093480,Chow; Bennett,7,0,32,25
1656936134421,MATH 142A,B03,093481,Chow; Bennett,7,0,32,25
1656936134421,MATH 142A,B04,093558,Chow; Bennett,11,0,32,21
1656936134421,MATH 142A,B05,093559,Chow; Bennett,6,0,32,26
1656936140449,MATH 193A,A01,083224,Rotar; Vladimir,7,0,34,27
1656936140449,MATH 193A,A02,083225,Rotar; Vladimir,3,0,34,31
1656936140449,MATH 193A,A03,083781,Rotar; Vladimir,1,0,34,33
1656936140449,MATH 193A,A04,083782,Rotar; Vladimir,6,0,34,28
1656936140449,MATH 193A,A05,093482,Rotar; Vladimir,6,0,34,28
1656936146475,MATH 197,001,091859,McAuley; Julian John,9999,0,9999,0
1656936146475,MATH 197,002,095566,Kedlaya; Kiran S.,9997,0,9999,2
1656936146475,MATH 197,003,095567,Xiao; Ming,9999,0,9999,0
1656936146475,MATH 197,004,095571,Perols; Johan Lars,9998,0,9999,1
1656936153547,COGS 9,A01,083615,Shannon; Kyle Michael,7,0,75,68
1656936159572,COGS 11,A01,083617,Boyle; Mary E. T.,19,0,48,29
1656936165602,COGS 13,A01,083071,Bastos; Amalia Pinkusfeld,9,0,71,62
1656936171632,COGS 14A,A01,092681,Semenuks; Arturs,0,1,100,100
1656936177670,COGS 14B,A01,083073,Cheng; Tzu-Han,5,0,63,58
1656936183697,COGS 17,A01,092677,Semenuks; Arturs,4,0,81,77
1656936189726,COGS 100,A01,083619,Allen; Michael Gordon,15,0,70,55
1656936195759,COGS 101A,A01,083621,Davis; Joshua Daniel,9,0,68,59
1656936201786,COGS 101B,A01,091572,Allen; Michael Gordon,8,0,65,57
1656936207819,COGS 101C,A01,083625,Delgado; Tania,17,0,35,18
1656936213852,COGS 107A,A01,083627,Boyle; Mary E. T.,13,0,60,47
1656936219880,COGS 118A,A01,083075,Gupta; Anjum,15,0,76,61
1656936225989,CSE 3,A50,083646,Miranda; Gregory Joseph,22,0,50,28
1656936232018,CSE 8A,A50,083650,Miranda; Gregory Joseph,17,1,56,39
1656936238048,CSE 11,A01,083080,Cao; Yingjun,4,15,40,36
1656936244120,CSE 12,A01,083652,Krause-Levy; Sophia Louisa,20,1,120,100
1656936250154,CSE 15L,A01,083654,Morris; Justin Loren,8,0,50,42
1656936250154,CSE 15L,A02,083655,Morris; Justin Loren,8,0,50,42
1656936256195,CSE 20,A01,083657,Tran; Khoa Dang,37,0,80,43
1656936262223,CSE 21,A01,095574,Bach; Quang Tran,21,0,48,27
1656936268252,CSE 30,A01,083084,Eldon; John,4,0,80,76
1656936268252,CSE 30,B01,095061,Bhaskar; Nishant,6,0,50,44
1656936274280,CSE 100,A01,083659,Cao; Yingjun,3,4,70,67
1656936280307,CSE 134B,A01,083661,Powell; Thomas Allan,19,0,100,81
1656936286332,CSE 140,A01,083663,Gungor; Onat,14,0,85,71
1656936292358,CSE 140L,A01,083088,Eldon; John,16,0,100,84
1656936298385,CSE 175,A01,083665,Kumar; Rakesh,3,0,25,22
1656936304415,CSE 190,A00,092507,Dubnov; Shlomo,7,0,20,13
1656936310446,ECE 45,A01,083139,Congero; Spencer William,5,0,75,70
1656936316582,ECE 65,A50,083695,Saad; Andrew S,12,0,30,18
1656936316582,ECE 65,A51,095125,Saad; Andrew S,25,0,26,1
1656936322668,ECE 109,A01,091882,Touri; Behrouz,16,0,70,54
1656936328731,ECE 180,A00,083140,Abi Samra; Nicholas Camill,0,0,30,30
1656936328731,ECE 180,B00,083141,Abi Samra; Nicholas Camill,0,0,30,30
1656936334790,MATH 10A,A01,083735,Patchell; Gregory David,1,0,30,29
1656936334790,MATH 10A,A02,083736,Patchell; Gregory David,20,0,30,10
1656936334790,MATH 10A,A03,083737,Patchell; Gregory David,15,0,30,15
1656936340819,MATH 10B,A01,083207,Lim; Seonhee,7,0,34,27
1656936340819,MATH 10B,A02,083208,Lim; Seonhee,9,0,35,26
1656936340819,MATH 10B,A03,093472,Lim; Seonhee,4,0,34,30
1656936340819,MATH 10B,B01,083739,Sinha; Shubham,9,0,30,21
1656936346850,MATH 18,A01,083743,Cinel; Cameron Alexander,6,0,30,24
1656936346850,MATH 18,A02,083744,Cinel; Cameron Alexander,15,0,30,15
1656936346850,MATH 18,A03,083745,Cinel; Cameron Alexander,8,0,30,22
1656936346850,MATH 18,B01,083748,Rideout; David Porter,4,0,37,33
1656936346850,MATH 18,B02,083749,Rideout; David Porter,3,0,36,33
1656936346850,MATH 18,B03,083750,Rideout; David Porter,2,0,37,35
1656936346850,MATH 18,B04,083751,Rideout; David Porter,5,0,36,31
1656936346850,MATH 18,B05,093473,Rideout; David Porter,4,0,36,32
1656936346850,MATH 18,B06,093474,Rideout; David Porter,5,0,36,31
1656936352878,MATH 20A,A01,083754,Zheng; Zequn,12,0,40,28
1656936358906,MATH 20B,A01,083756,Briones; Jor-el Thomas Caparas,1,0,36,35
1656936358906,MATH 20B,A02,083757,Briones; Jor-el Thomas Caparas,1,0,36,35
1656936358906,MATH 20B,A03,093475,Briones; Jor-el Thomas Caparas,0,0,36,36
1656936364934,MATH 20C,A01,083760,Briones; Jor-el Thomas Caparas,1,0,35,34
1656936364934,MATH 20C,A02,083761,Briones; Jor-el Thomas Caparas,8,0,35,27
1656936364934,MATH 20C,A03,093476,Briones; Jor-el Thomas Caparas,0,1,36,36
1656936364934,MATH 20C,B01,083762,Bach; Quang Tran,0,0,30,30
1656936370992,MATH 20D,A01,083765,Tran; Brian Kha,4,0,30,26
1656936370992,MATH 20D,A02,083766,Tran; Brian Kha,4,0,30,26
1656936370992,MATH 20D,A03,083767,Tran; Brian Kha,3,0,30,27
1656936377023,MATH 20E,A01,083771,Ganguly; Soumya,5,0,32,27
1656936377023,MATH 20E,A02,083772,Ganguly; Soumya,6,0,32,26
1656936377023,MATH 20E,B01,083773,Ciotti; Benjamin,18,0,35,17
1656936377023,MATH 20E,B02,083774,Ciotti; Benjamin,17,0,35,18
1656936383062,MATH 103A,A01,083777,Greenfeld; Be'Eri,2,0,36,34
1656936383062,MATH 103A,A02,083778,Greenfeld; Be'Eri,5,0,36,31
1656936383062,MATH 103A,A03,093561,Greenfeld; Be'Eri,4,0,36,32
1656936383062,MATH 103A,B01,083779,Greenfeld; Be'Eri,6,0,36,30
1656936383062,MATH 103A,B02,083780,Greenfeld; Be'Eri,2,0,36,34
1656936383062,MATH 103A,B03,093562,Greenfeld; Be'Eri,2,0,36,34
1656936389087,MATH 105,A01,085443,Carter; Anne Toulson,13,0,35,22
1656936389087,MATH 105,A02,093477,Carter; Anne Toulson,20,0,35,15
1656936395116,MATH 109,A01,083213,Ganzberger; Geoffrey Michael,2,0,34,32
1656936395116,MATH 109,A02,083214,Ganzberger; Geoffrey Michael,2,0,34,32
1656936395116,MATH 109,A03,093478,Ganzberger; Geoffrey Michael,1,0,34,33
1656936395116,MATH 109,B01,083215,Ganzberger; Geoffrey Michael,1,0,32,31
1656936395116,MATH 109,B02,083216,Ganzberger; Geoffrey Michael,1,0,32,31
1656936395116,MATH 109,B03,093479,Ganzberger; Geoffrey Michael,6,0,32,26
1656936401163,MATH 142A,A01,083219,Chow; Bennett,6,0,32,26
1656936401163,MATH 142A,A02,083220,Chow; Bennett,10,0,32,22
1656936401163,MATH 142A,A03,093480,Chow; Bennett,7,0,32,25
1656936401163,MATH 142A,B03,093481,Chow; Bennett,7,0,32,25
1656936401163,MATH 142A,B04,093558,Chow; Bennett,11,0,32,21
1656936401163,MATH 142A,B05,093559,Chow; Bennett,6,0,32,26
1656936407200,MATH 193A,A01,083224,Rotar; Vladimir,7,0,34,27
1656936407200,MATH 193A,A02,083225,Rotar; Vladimir,3,0,34,31
1656936407200,MATH 193A,A03,083781,Rotar; Vladimir,1,0,34,33
1656936407200,MATH 193A,A04,083782,Rotar; Vladimir,6,0,34,28
1656936407200,MATH 193A,A05,093482,Rotar; Vladimir,6,0,34,28
1656936413233,MATH 197,001,091859,McAuley; Julian John,9999,0,9999,0
1656936413233,MATH 197,002,095566,Kedlaya; Kiran S.,9997,0,9999,2
1656936413233,MATH 197,003,095567,Xiao; Ming,9999,0,9999,0
1656936413233,MATH 197,004,095571,Perols; Johan Lars,9998,0,9999,1
1656936420317,COGS 9,A01,083615,Shannon; Kyle Michael,7,0,75,68
1656936426351,COGS 11,A01,083617,Boyle; Mary E. T.,19,0,48,29
1656936432379,COGS 13,A01,083071,Bastos; Amalia Pinkusfeld,9,0,71,62
1656936438405,COGS 14A,A01,092681,Semenuks; Arturs,0,1,100,100
1656936444440,COGS 14B,A01,083073,Cheng; Tzu-Han,5,0,63,58
1656936450476,COGS 17,A01,092677,Semenuks; Arturs,4,0,81,77
1656936456518,COGS 100,A01,083619,Allen; Michael Gordon,15,0,70,55
1656936462558,COGS 101A,A01,083621,Davis; Joshua Daniel,9,0,68,59
1656936468585,COGS 101B,A01,091572,Allen; Michael Gordon,8,0,65,57
1656936474615,COGS 101C,A01,083625,Delgado; Tania,17,0,35,18
1656936480640,COGS 107A,A01,083627,Boyle; Mary E. T.,13,0,60,47
1656936486677,COGS 118A,A01,083075,Gupta; Anjum,15,0,76,61
1656936492703,CSE 3,A50,083646,Miranda; Gregory Joseph,22,0,50,28
1656936498729,CSE 8A,A50,083650,Miranda; Gregory Joseph,17,1,56,39
1656936504753,CSE 11,A01,083080,Cao; Yingjun,4,15,40,36
1656936510783,CSE 12,A01,083652,Krause-Levy; Sophia Louisa,20,1,120,100
1656936516814,CSE 15L,A01,083654,Morris; Justin Loren,8,0,50,42
1656936516814,CSE 15L,A02,083655,Morris; Justin Loren,8,0,50,42
1656936522843,CSE 20,A01,083657,Tran; Khoa Dang,37,0,80,43
1656936528871,CSE 21,A01,095574,Bach; Quang Tran,21,0,48,27
1656936534898,CSE 30,A01,083084,Eldon; John,4,0,80,76
1656936534898,CSE 30,B01,095061,Bhaskar; Nishant,6,0,50,44
1656936540928,CSE 100,A01,083659,Cao; Yingjun,3,4,70,67
1656936546959,CSE 134B,A01,083661,Powell; Thomas Allan,19,0,100,81
1656936552986,CSE 140,A01,083663,Gungor; Onat,14,0,85,71
1656936559018,CSE 140L,A01,083088,Eldon; John,16,0,100,84
1656936565051,CSE 175,A01,083665,Kumar; Rakesh,3,0,25,22
1656936571076,CSE 190,A00,092507,Dubnov; Shlomo,7,0,20,13
1656936577102,ECE 45,A01,083139,Congero; Spencer William,5,0,75,70
1656936583134,ECE 65,A50,083695,Saad; Andrew S,12,0,30,18
1656936583134,ECE 65,A51,095125,Saad; Andrew S,25,0,26,1
1656936589168,ECE 109,A01,091882,Touri; Behrouz,16,0,70,54
1656936595203,ECE 180,A00,083140,Abi Samra; Nicholas Camill,0,0,30,30
1656936595203,ECE 180,B00,083141,Abi Samra; Nicholas Camill,0,0,30,30
1656936601238,MATH 10A,A01,083735,Patchell; Gregory David,1,0,30,29
1656936601238,MATH 10A,A02,083736,Patchell; Gregory David,20,0,30,10
1656936601238,MATH 10A,A03,083737,Patchell; Gregory David,15,0,30,15
1656936607277,MATH 10B,A01,083207,Lim; Seonhee,7,0,34,27
1656936607277,MATH 10B,A02,083208,Lim; Seonhee,9,0,35,26
1656936607277,MATH 10B,A03,093472,Lim; Seonhee,4,0,34,30
1656936607277,MATH 10B,B01,083739,Sinha; Shubham,9,0,30,21
1656936613308,MATH 18,A01,083743,Cinel; Cameron Alexander,6,0,30,24
1656936613308,MATH 18,A02,083744,Cinel; Cameron Alexander,15,0,30,15
1656936613308,MATH 18,A03,083745,Cinel; Cameron Alexander,8,0,30,22
1656936613308,MATH 18,B01,083748,Rideout; David Porter,4,0,37,33
1656936613308,MATH 18,B02,083749,Rideout; David Porter,3,0,36,33
1656936613308,MATH 18,B03,083750,Rideout; David Porter,2,0,37,35
1656936613308,MATH 18,B04,083751,Rideout; David Porter,5,0,36,31
1656936613308,MATH 18,B05,093473,Rideout; David Porter,4,0,36,32
1656936613308,MATH 18,B06,093474,Rideout; David Porter,5,0,36,31
1656936619340,MATH 20A,A01,083754,Zheng; Zequn,12,0,40,28
1656936625369,MATH 20B,A01,083756,Briones; Jor-el Thomas Caparas,1,0,36,35
1656936625369,MATH 20B,A02,083757,Briones; Jor-el Thomas Caparas,1,0,36,35
1656936625369,MATH 20B,A03,093475,Briones; Jor-el Thomas Caparas,0,0,36,36
1656936631407,MATH 20C,A01,083760,Briones; Jor-el Thomas Caparas,1,0,35,34
1656936631407,MATH 20C,A02,083761,Briones; Jor-el Thomas Caparas,8,0,35,27
1656936631407,MATH 20C,A03,093476,Briones; Jor-el Thomas Caparas,0,1,36,36
1656936631407,MATH 20C,B01,083762,Bach; Quang Tran,0,0,30,30
1656936637439,MATH 20D,A01,083765,Tran; Brian Kha,4,0,30,26
1656936637439,MATH 20D,A02,083766,Tran; Brian Kha,4,0,30,26
1656936637439,MATH 20D,A03,083767,Tran; Brian Kha,3,0,30,27
1656936643474,MATH 20E,A01,083771,Ganguly; Soumya,5,0,32,27
1656936643474,MATH 20E,A02,083772,Ganguly; Soumya,6,0,32,26
1656936643474,MATH 20E,B01,083773,Ciotti; Benjamin,18,0,35,17
1656936643474,MATH 20E,B02,083774,Ciotti; Benjamin,17,0,35,18
1656936649513,MATH 103A,A01,083777,Greenfeld; Be'Eri,2,0,36,34
1656936649513,MATH 103A,A02,083778,Greenfeld; Be'Eri,5,0,36,31
1656936649513,MATH 103A,A03,093561,Greenfeld; Be'Eri,4,0,36,32
1656936649513,MATH 103A,B01,083779,Greenfeld; Be'Eri,6,0,36,30
1656936649513,MATH 103A,B02,083780,Greenfeld; Be'Eri,2,0,36,34
1656936649513,MATH 103A,B03,093562,Greenfeld; Be'Eri,2,0,36,34
1656936655542,MATH 105,A01,085443,Carter; Anne Toulson,13,0,35,22
1656936655542,MATH 105,A02,093477,Carter; Anne Toulson,20,0,35,15
1656936661573,MATH 109,A01,083213,Ganzberger; Geoffrey Michael,2,0,34,32
1656936661573,MATH 109,A02,083214,Ganzberger; Geoffrey Michael,2,0,34,32
1656936661573,MATH 109,A03,093478,Ganzberger; Geoffrey Michael,1,0,34,33
1656936661573,MATH 109,B01,083215,Ganzberger; Geoffrey Michael,1,0,32,31
1656936661573,MATH 109,B02,083216,Ganzberger; Geoffrey Michael,1,0,32,31
1656936661573,MATH 109,B03,093479,Ganzberger; Geoffrey Michael,6,0,32,26
1656936667609,MATH 142A,A01,083219,Chow; Bennett,6,0,32,26
1656936667609,MATH 142A,A02,083220,Chow; Bennett,10,0,32,22
1656936667609,MATH 142A,A03,093480,Chow; Bennett,7,0,32,25
1656936667609,MATH 142A,B03,093481,Chow; Bennett,7,0,32,25
1656936667609,MATH 142A,B04,093558,Chow; Bennett,11,0,32,21
1656936667609,MATH 142A,B05,093559,Chow; Bennett,6,0,32,26
1656936673638,MATH 193A,A01,083224,Rotar; Vladimir,7,0,34,27
1656936673638,MATH 193A,A02,083225,Rotar; Vladimir,3,0,34,31
1656936673638,MATH 193A,A03,083781,Rotar; Vladimir,1,0,34,33
1656936673638,MATH 193A,A04,083782,Rotar; Vladimir,6,0,34,28
1656936673638,MATH 193A,A05,093482,Rotar; Vladimir,6,0,34,28
1656936679668,MATH 197,001,091859,McAuley; Julian John,9999,0,9999,0
1656936679668,MATH 197,002,095566,Kedlaya; Kiran S.,9997,0,9999,2
1656936679668,MATH 197,003,095567,Xiao; Ming,9999,0,9999,0
1656936679668,MATH 197,004,095571,Perols; Johan Lars,9998,0,9999,1
1656936686750,COGS 9,A01,083615,Shannon; Kyle Michael,7,0,75,68
1656936692779,COGS 11,A01,083617,Boyle; Mary E. T.,19,0,48,29
1656936698810,COGS 13,A01,083071,Bastos; Amalia Pinkusfeld,9,0,71,62
1656936704838,COGS 14A,A01,092681,Semenuks; Arturs,0,1,100,100
1656936710866,COGS 14B,A01,083073,Cheng; Tzu-Han,5,0,63,58
1656936716900,COGS 17,A01,092677,Semenuks; Arturs,4,0,81,77
1656936723006,COGS 100,A01,083619,Allen; Michael Gordon,15,0,70,55
1656936729033,COGS 101A,A01,083621,Davis; Joshua Daniel,9,0,68,59
1656936735059,COGS 101B,A01,091572,Allen; Michael Gordon,8,0,65,57
1656936741083,COGS 101C,A01,083625,Delgado; Tania,17,0,35,18
1656936747112,COGS 107A,A01,083627,Boyle; Mary E. T.,13,0,60,47
1656936753139,COGS 118A,A01,083075,Gupta; Anjum,15,0,76,61
1656936759174,CSE 3,A50,083646,Miranda; Gregory Joseph,22,0,50,28
1656936765201,CSE 8A,A50,083650,Miranda; Gregory Joseph,17,1,56,39
1656936771233,CSE 11,A01,083080,Cao; Yingjun,4,15,40,36
1656936777267,CSE 12,A01,083652,Krause-Levy; Sophia Louisa,20,1,120,100
1656936783303,CSE 15L,A01,083654,Morris; Justin Loren,8,0,50,42
1656936783303,CSE 15L,A02,083655,Morris; Justin Loren,8,0,50,42
1656936789334,CSE 20,A01,083657,Tran; Khoa Dang,37,0,80,43
1656936795368,CSE 21,A01,095574,Bach; Quang Tran,21,0,48,27
1656936801401,CSE 30,A01,083084,Eldon; John,4,0,80,76
1656936801401,CSE 30,B01,095061,Bhaskar; Nishant,6,0,50,44
1656936807433,CSE 100,A01,083659,Cao; Yingjun,3,4,70,67
1656936813460,CSE 134B,A01,083661,Powell; Thomas Allan,19,0,100,81
1656936819491,CSE 140,A01,083663,Gungor; Onat,14,0,85,71
1656936825516,CSE 140L,A01,083088,Eldon; John,16,0,100,84
1656936831546,CSE 175,A01,083665,Kumar; Rakesh,3,0,25,22
1656936837574,CSE 190,A00,092507,Dubnov; Shlomo,7,0,20,13
1656936843603,ECE 45,A01,083139,Congero; Spencer William,5,0,75,70
1656936849642,ECE 65,A50,083695,Saad; Andrew S,12,0,30,18
1656936849642,ECE 65,A51,095125,Saad; Andrew S,25,0,26,1
1656936855669,ECE 109,A01,091882,Touri; Behrouz,16,0,70,54
1656936861696,ECE 180,A00,083140,Abi Samra; Nicholas Camill,0,0,30,30
1656936861696,ECE 180,B00,083141,Abi Samra; Nicholas Camill,0,0,30,30
1656936867732,MATH 10A,A01,083735,Patchell; Gregory David,1,0,30,29
1656936867732,MATH 10A,A02,083736,Patchell; Gregory David,20,0,30,10
1656936867732,MATH 10A,A03,083737,Patchell; Gregory David,15,0,30,15
1656936873770,MATH 10B,A01,083207,Lim; Seonhee,7,0,34,27
1656936873770,MATH 10B,A02,083208,Lim; Seonhee,9,0,35,26
1656936873770,MATH 10B,A03,093472,Lim; Seonhee,4,0,34,30
1656936873770,MATH 10B,B01,083739,Sinha; Shubham,9,0,30,21
1656936879801,MATH 18,A01,083743,Cinel; Cameron Alexander,6,0,30,24
1656936879801,MATH 18,A02,083744,Cinel; Cameron Alexander,15,0,30,15
1656936879801,MATH 18,A03,083745,Cinel; Cameron Alexander,8,0,30,22
1656936879801,MATH 18,B01,083748,Rideout; David Porter,4,0,37,33
1656936879801,MATH 18,B02,083749,Rideout; David Porter,3,0,36,33
1656936879801,MATH 18,B03,083750,Rideout; David Porter,2,0,37,35
1656936879801,MATH 18,B04,083751,Rideout; David Porter,5,0,36,31
1656936879801,MATH 18,B05,093473,Rideout; David Porter,4,0,36,32
1656936879801,MATH 18,B06,093474,Rideout; David Porter,5,0,36,31
1656936885843,MATH 20A,A01,083754,Zheng; Zequn,12,0,40,28
1656936891870,MATH 20B,A01,083756,Briones; Jor-el Thomas Caparas,1,0,36,35
1656936891870,MATH 20B,A02,083757,Briones; Jor-el Thomas Caparas,1,0,36,35
1656936891870,MATH 20B,A03,093475,Briones; Jor-el Thomas Caparas,0,0,36,36
1656936897899,MATH 20C,A01,083760,Briones; Jor-el Thomas Caparas,1,0,35,34
1656936897899,MATH 20C,A02,083761,Briones; Jor-el Thomas Caparas,8,0,35,27
1656936897899,MATH 20C,A03,093476,Briones; Jor-el Thomas Caparas,0,1,36,36
1656936897899,MATH 20C,B01,083762,Bach; Quang Tran,0,0,30,30
1656936903930,MATH 20D,A01,083765,Tran; Brian Kha,4,0,30,26
1656936903930,MATH 20D,A02,083766,Tran; Brian Kha,4,0,30,26
1656936903930,MATH 20D,A03,083767,Tran; Brian Kha,3,0,30,27
1656936909961,MATH 20E,A01,083771,Ganguly; Soumya,5,0,32,27
1656936909961,MATH 20E,A02,083772,Ganguly; Soumya,6,0,32,26
1656936909961,MATH 20E,B01,083773,Ciotti; Benjamin,18,0,35,17
1656936909961,MATH 20E,B02,083774,Ciotti; Benjamin,17,0,35,18
1656936915993,MATH 103A,A01,083777,Greenfeld; Be'Eri,2,0,36,34
1656936915993,MATH 103A,A02,083778,Greenfeld; Be'Eri,5,0,36,31
1656936915993,MATH 103A,A03,093561,Greenfeld; Be'Eri,4,0,36,32
1656936915993,MATH 103A,B01,083779,Greenfeld; Be'Eri,6,0,36,30
1656936915993,MATH 103A,B02,083780,Greenfeld; Be'Eri,2,0,36,34
1656936915993,MATH 103A,B03,093562,Greenfeld; Be'Eri,2,0,36,34
1656936922019,MATH 105,A01,085443,Carter; Anne Toulson,13,0,35,22
1656936922019,MATH 105,A02,093477,Carter; Anne Toulson,20,0,35,15
1656936928051,MATH 109,A01,083213,Ganzberger; Geoffrey Michael,2,0,34,32
1656936928051,MATH 109,A02,083214,Ganzberger; Geoffrey Michael,2,0,34,32
1656936928051,MATH 109,A03,093478,Ganzberger; Geoffrey Michael,1,0,34,33
1656936928051,MATH 109,B01,083215,Ganzberger; Geoffrey Michael,1,0,32,31
1656936928051,MATH 109,B02,083216,Ganzberger; Geoffrey Michael,1,0,32,31
1656936928051,MATH 109,B03,093479,Ganzberger; Geoffrey Michael,6,0,32,26
1656936934091,MATH 142A,A01,083219,Chow; Bennett,6,0,32,26
1656936934091,MATH 142A,A02,083220,Chow; Bennett,10,0,32,22
1656936934091,MATH 142A,A03,093480,Chow; Bennett,7,0,32,25
1656936934091,MATH 142A,B03,093481,Chow; Bennett,7,0,32,25
1656936934091,MATH 142A,B04,093558,Chow; Bennett,11,0,32,21
1656936934091,MATH 142A,B05,093559,Chow; Bennett,6,0,32,26
1656936940117,MATH 193A,A01,083224,Rotar; Vladimir,7,0,34,27
1656936940117,MATH 193A,A02,083225,Rotar; Vladimir,3,0,34,31
1656936940117,MATH 193A,A03,083781,Rotar; Vladimir,1,0,34,33
1656936940117,MATH 193A,A04,083782,Rotar; Vladimir,6,0,34,28
1656936940117,MATH 193A,A05,093482,Rotar; Vladimir,6,0,34,28
1656936946148,MATH 197,001,091859,McAuley; Julian John,9999,0,9999,0
1656936946148,MATH 197,002,095566,Kedlaya; Kiran S.,9997,0,9999,2
1656936946148,MATH 197,003,095567,Xiao; Ming,9999,0,9999,0
1656936946148,MATH 197,004,095571,Perols; Johan Lars,9998,0,9999,1
1656936953232,COGS 9,A01,083615,Shannon; Kyle Michael,7,0,75,68
1656936959264,COGS 11,A01,083617,Boyle; Mary E. T.,19,0,48,29
1656936965289,COGS 13,A01,083071,Bastos; Amalia Pinkusfeld,9,0,71,62
1656936971325,COGS 14A,A01,092681,Semenuks; Arturs,0,1,100,100
1656936977352,COGS 14B,A01,083073,Cheng; Tzu-Han,5,0,63,58
1656936983382,COGS 17,A01,092677,Semenuks; Arturs,4,0,81,77
1656936989413,COGS 100,A01,083619,Allen; Michael Gordon,15,0,70,55
1656936995444,COGS 101A,A01,083621,Davis; Joshua Daniel,9,0,68,59
1656937001491,COGS 101B,A01,091572,Allen; Michael Gordon,8,0,65,57
1656937007518,COGS 101C,A01,083625,Delgado; Tania,17,0,35,18
1656937013548,COGS 107A,A01,083627,Boyle; Mary E. T.,13,0,60,47
1656937019580,COGS 118A,A01,083075,Gupta; Anjum,15,0,76,61
1656937025615,CSE 3,A50,083646,Miranda; Gregory Joseph,22,0,50,28
1656937031643,CSE 8A,A50,083650,Miranda; Gregory Joseph,17,1,56,39
1656937037674,CSE 11,A01,083080,Cao; Yingjun,4,15,40,36
1656937043709,CSE 12,A01,083652,Krause-Levy; Sophia Louisa,20,1,120,100
1656937049737,CSE 15L,A01,083654,Morris; Justin Loren,8,0,50,42
1656937049737,CSE 15L,A02,083655,Morris; Justin Loren,8,0,50,42
1656937055764,CSE 20,A01,083657,Tran; Khoa Dang,37,0,80,43
1656937061794,CSE 21,A01,095574,Bach; Quang Tran,21,0,48,27
1656937067823,CSE 30,A01,083084,Eldon; John,4,0,80,76
1656937067823,CSE 30,B01,095061,Bhaskar; Nishant,6,0,50,44
1656937073858,CSE 100,A01,083659,Cao; Yingjun,3,4,70,67
1656937079891,CSE 134B,A01,083661,Powell; Thomas Allan,19,0,100,81
1656937085919,CSE 140,A01,083663,Gungor; Onat,14,0,85,71
1656937091947,CSE 140L,A01,083088,Eldon; John,16,0,100,84
1656937097975,CSE 175,A01,083665,Kumar; Rakesh,3,0,25,22
1656937104004,CSE 190,A00,092507,Dubnov; Shlomo,7,0,20,13
1656937110039,ECE 45,A01,083139,Congero; Spencer William,5,0,75,70
1656937116077,ECE 65,A50,083695,Saad; Andrew S,12,0,30,18
1656937116077,ECE 65,A51,095125,Saad; Andrew S,25,0,26,1
1656937122113,ECE 109,A01,091882,Touri; Behrouz,16,0,70,54
1656937128137,ECE 180,A00,083140,Abi Samra; Nicholas Camill,0,0,30,30
1656937128137,ECE 180,B00,083141,Abi Samra; Nicholas Camill,0,0,30,30
1656937134189,MATH 10A,A01,083735,Patchell; Gregory David,1,0,30,29
1656937134189,MATH 10A,A02,083736,Patchell; Gregory David,20,0,30,10
1656937134189,MATH 10A,A03,083737,Patchell; Gregory David,15,0,30,15
1656937140220,MATH 10B,A01,083207,Lim; Seonhee,7,0,34,27
1656937140220,MATH 10B,A02,083208,Lim; Seonhee,9,0,35,26
1656937140220,MATH 10B,A03,093472,Lim; Seonhee,4,0,34,30
1656937140220,MATH 10B,B01,083739,Sinha; Shubham,9,0,30,21
1656937146271,MATH 18,A01,083743,Cinel; Cameron Alexander,6,0,30,24
1656937146271,MATH 18,A02,083744,Cinel; Cameron Alexander,15,0,30,15
1656937146271,MATH 18,A03,083745,Cinel; Cameron Alexander,8,0,30,22
1656937146271,MATH 18,B01,083748,Rideout; David Porter,4,0,37,33
1656937146271,MATH 18,B02,083749,Rideout; David Porter,3,0,36,33
1656937146271,MATH 18,B03,083750,Rideout; David Porter,2,0,37,35
1656937146271,MATH 18,B04,083751,Rideout; David Porter,5,0,36,31
1656937146271,MATH 18,B05,093473,Rideout; David Porter,4,0,36,32
1656937146271,MATH 18,B06,093474,Rideout; David Porter,5,0,36,31
1656937152300,MATH 20A,A01,083754,Zheng; Zequn,12,0,40,28
1656937158333,MATH 20B,A01,083756,Briones; Jor-el Thomas Caparas,1,0,36,35
1656937158333,MATH 20B,A02,083757,Briones; Jor-el Thomas Caparas,1,0,36,35
1656937158333,MATH 20B,A03,093475,Briones; Jor-el Thomas Caparas,0,0,36,36
1656937164373,MATH 20C,A01,083760,Briones; Jor-el Thomas Caparas,1,0,35,34
1656937164373,MATH 20C,A02,083761,Briones; Jor-el Thomas Caparas,8,0,35,27
1656937164373,MATH 20C,A03,093476,Briones; Jor-el Thomas Caparas,0,1,36,36
1656937164373,MATH 20C,B01,083762,Bach; Quang Tran,0,0,30,30
1656937170408,MATH 20D,A01,083765,Tran; Brian Kha,4,0,30,26
1656937170408,MATH 20D,A02,083766,Tran; Brian Kha,4,0,30,26
1656937170408,MATH 20D,A03,083767,Tran; Brian Kha,3,0,30,27
1656937176438,MATH 20E,A01,083771,Ganguly; Soumya,5,0,32,27
1656937176438,MATH 20E,A02,083772,Ganguly; Soumya,6,0,32,26
1656937176438,MATH 20E,B01,083773,Ciotti; Benjamin,18,0,35,17
1656937176438,MATH 20E,B02,083774,Ciotti; Benjamin,17,0,35,18
1656937182478,MATH 103A,A01,083777,Greenfeld; Be'Eri,2,0,36,34
1656937182478,MATH 103A,A02,083778,Greenfeld; Be'Eri,5,0,36,31
1656937182478,MATH 103A,A03,093561,Greenfeld; Be'Eri,4,0,36,32
1656937182478,MATH 103A,B01,083779,Greenfeld; Be'Eri,6,0,36,30
1656937182478,MATH 103A,B02,083780,Greenfeld; Be'Eri,2,0,36,34
1656937182478,MATH 103A,B03,093562,Greenfeld; Be'Eri,2,0,36,34
1656937188505,MATH 105,A01,085443,Carter; Anne Toulson,13,0,35,22
1656937188505,MATH 105,A02,093477,Carter; Anne Toulson,20,0,35,15
1656937194547,MATH 109,A01,083213,Ganzberger; Geoffrey Michael,2,0,34,32
1656937194547,MATH 109,A02,083214,Ganzberger; Geoffrey Michael,2,0,34,32
1656937194547,MATH 109,A03,093478,Ganzberger; Geoffrey Michael,1,0,34,33
1656937194547,MATH 109,B01,083215,Ganzberger; Geoffrey Michael,1,0,32,31
1656937194547,MATH 109,B02,083216,Ganzberger; Geoffrey Michael,1,0,32,31
1656937194547,MATH 109,B03,093479,Ganzberger; Geoffrey Michael,6,0,32,26
1656937200576,MATH 142A,A01,083219,Chow; Bennett,6,0,32,26
1656937200576,MATH 142A,A02,083220,Chow; Bennett,10,0,32,22
1656937200576,MATH 142A,A03,093480,Chow; Bennett,7,0,32,25
1656937200576,MATH 142A,B03,093481,Chow; Bennett,7,0,32,25
1656937200576,MATH 142A,B04,093558,Chow; Bennett,11,0,32,21
1656937200576,MATH 142A,B05,093559,Chow; Bennett,6,0,32,26
1656937206613,MATH 193A,A01,083224,Rotar; Vladimir,7,0,34,27
1656937206613,MATH 193A,A02,083225,Rotar; Vladimir,3,0,34,31
1656937206613,MATH 193A,A03,083781,Rotar; Vladimir,1,0,34,33
1656937206613,MATH 193A,A04,083782,Rotar; Vladimir,6,0,34,28
1656937206613,MATH 193A,A05,093482,Rotar; Vladimir,6,0,34,28
1656937212646,MATH 197,001,091859,McAuley; Julian John,9999,0,9999,0
1656937212646,MATH 197,002,095566,Kedlaya; Kiran S.,9997,0,9999,2
1656937212646,MATH 197,003,095567,Xiao; Ming,9999,0,9999,0
1656937212646,MATH 197,004,095571,Perols; Johan Lars,9998,0,9999,1
1656937219732,COGS 9,A01,083615,Shannon; Kyle Michael,7,0,75,68
1656937225769,COGS 11,A01,083617,Boyle; Mary E. T.,19,0,48,29
1656937231803,COGS 13,A01,083071,Bastos; Amalia Pinkusfeld,9,0,71,62
1656937237827,COGS 14A,A01,092681,Semenuks; Arturs,0,1,100,100
1656937243854,COGS 14B,A01,083073,Cheng; Tzu-Han,5,0,63,58
1656937249889,COGS 17,A01,092677,Semenuks; Arturs,4,0,81,77
1656937255916,COGS 100,A01,083619,Allen; Michael Gordon,15,0,70,55
1656937261948,COGS 101A,A01,083621,Davis; Joshua Daniel,9,0,68,59
1656937267979,COGS 101B,A01,091572,Allen; Michael Gordon,8,0,65,57
1656937274013,COGS 101C,A01,083625,Delgado; Tania,17,0,35,18
1656937280040,COGS 107A,A01,083627,Boyle; Mary E. T.,13,0,60,47
1656937286066,COGS 118A,A01,083075,Gupta; Anjum,15,0,76,61
1656937292106,CSE 3,A50,083646,Miranda; Gregory Joseph,22,0,50,28
1656937298133,CSE 8A,A50,083650,Miranda; Gregory Joseph,17,1,56,39
1656937304159,CSE 11,A01,083080,Cao; Yingjun,4,15,40,36
1656937310190,CSE 12,A01,083652,Krause-Levy; Sophia Louisa,20,1,120,100
1656937316234,CSE 15L,A01,083654,Morris; Justin Loren,8,0,50,42
1656937316234,CSE 15L,A02,083655,Morris; Justin Loren,8,0,50,42
1656937322361,CSE 20,A01,083657,Tran; Khoa Dang,37,0,80,43
1656937328389,CSE 21,A01,095574,Bach; Quang Tran,21,0,48,27
1656937334427,CSE 30,A01,083084,Eldon; John,4,0,80,76
1656937334427,CSE 30,B01,095061,Bhaskar; Nishant,6,0,50,44
1656937340459,CSE 100,A01,083659,Cao; Yingjun,3,4,70,67
1656937346486,CSE 134B,A01,083661,Powell; Thomas Allan,19,0,100,81
1656937352512,CSE 140,A01,083663,Gungor; Onat,14,0,85,71
1656937358542,CSE 140L,A01,083088,Eldon; John,16,0,100,84
1656937364571,CSE 175,A01,083665,Kumar; Rakesh,3,0,25,22
1656937370596,CSE 190,A00,092507,Dubnov; Shlomo,7,0,20,13
1656937376631,ECE 45,A01,083139,Congero; Spencer William,5,0,75,70
1656937382660,ECE 65,A50,083695,Saad; Andrew S,12,0,30,18
1656937382660,ECE 65,A51,095125,Saad; Andrew S,25,0,26,1
1656937388688,ECE 109,A01,091882,Touri; Behrouz,16,0,70,54
1656937394720,ECE 180,A00,083140,Abi Samra; Nicholas Camill,0,0,30,30
1656937394720,ECE 180,B00,083141,Abi Samra; Nicholas Camill,0,0,30,30
1656937400749,MATH 10A,A01,083735,Patchell; Gregory David,1,0,30,29
1656937400749,MATH 10A,A02,083736,Patchell; Gregory David,20,0,30,10
1656937400749,MATH 10A,A03,083737,Patchell; Gregory David,15,0,30,15
1656937406791,MATH 10B,A01,083207,Lim; Seonhee,7,0,34,27
1656937406791,MATH 10B,A02,083208,Lim; Seonhee,9,0,35,26
1656937406791,MATH 10B,A03,093472,Lim; Seonhee,4,0,34,30
1656937406791,MATH 10B,B01,083739,Sinha; Shubham,9,0,30,21
1656937412822,MATH 18,A01,083743,Cinel; Cameron Alexander,6,0,30,24
1656937412822,MATH 18,A02,083744,Cinel; Cameron Alexander,15,0,30,15
1656937412822,MATH 18,A03,083745,Cinel; Cameron Alexander,8,0,30,22
1656937412822,MATH 18,B01,083748,Rideout; David Porter,4,0,37,33
1656937412822,MATH 18,B02,083749,Rideout; David Porter,3,0,36,33
1656937412822,MATH 18,B03,083750,Rideout; David Porter,2,0,37,35
1656937412822,MATH 18,B04,083751,Rideout; David Porter,5,0,36,31
1656937412822,MATH 18,B05,093473,Rideout; David Porter,4,0,36,32
1656937412822,MATH 18,B06,093474,Rideout; David Porter,5,0,36,31
1656937418849,MATH 20A,A01,083754,Zheng; Zequn,12,0,40,28
1656937424888,MATH 20B,A01,083756,Briones; Jor-el Thomas Caparas,1,0,36,35
1656937424888,MATH 20B,A02,083757,Briones; Jor-el Thomas Caparas,1,0,36,35
1656937424888,MATH 20B,A03,093475,Briones; Jor-el Thomas Caparas,0,0,36,36
1656937430924,MATH 20C,A01,083760,Briones; Jor-el Thomas Caparas,1,0,35,34
1656937430924,MATH 20C,A02,083761,Briones; Jor-el Thomas Caparas,8,0,35,27
1656937430924,MATH 20C,A03,093476,Briones; Jor-el Thomas Caparas,0,1,36,36
1656937430924,MATH 20C,B01,083762,Bach; Quang Tran,0,0,30,30
1656937436957,MATH 20D,A01,083765,Tran; Brian Kha,4,0,30,26
1656937436957,MATH 20D,A02,083766,Tran; Brian Kha,4,0,30,26
1656937436957,MATH 20D,A03,083767,Tran; Brian Kha,3,0,30,27
1656937442987,MATH 20E,A01,083771,Ganguly; Soumya,5,0,32,27
1656937442987,MATH 20E,A02,083772,Ganguly; Soumya,6,0,32,26
1656937442987,MATH 20E,B01,083773,Ciotti; Benjamin,18,0,35,17
1656937442987,MATH 20E,B02,083774,Ciotti; Benjamin,17,0,35,18
1656937449017,MATH 103A,A01,083777,Greenfeld; Be'Eri,2,0,36,34
1656937449017,MATH 103A,A02,083778,Greenfeld; Be'Eri,5,0,36,31
1656937449017,MATH 103A,A03,093561,Greenfeld; Be'Eri,4,0,36,32
1656937449017,MATH 103A,B01,083779,Greenfeld; Be'Eri,6,0,36,30
1656937449017,MATH 103A,B02,083780,Greenfeld; Be'Eri,2,0,36,34
1656937449017,MATH 103A,B03,093562,Greenfeld; Be'Eri,2,0,36,34
1656937455042,MATH 105,A01,085443,Carter; Anne Toulson,13,0,35,22
1656937455042,MATH 105,A02,093477,Carter; Anne Toulson,20,0,35,15
1656937461075,MATH 109,A01,083213,Ganzberger; Geoffrey Michael,2,0,34,32
1656937461075,MATH 109,A02,083214,Ganzberger; Geoffrey Michael,2,0,34,32
1656937461075,MATH 109,A03,093478,Ganzberger; Geoffrey Michael,1,0,34,33
1656937461075,MATH 109,B01,083215,Ganzberger; Geoffrey Michael,1,0,32,31
1656937461075,MATH 109,B02,083216,Ganzberger; Geoffrey Michael,1,0,32,31
1656937461075,MATH 109,B03,093479,Ganzberger; Geoffrey Michael,6,0,32,26
1656937467105,MATH 142A,A01,083219,Chow; Bennett,6,0,32,26
1656937467105,MATH 142A,A02,083220,Chow; Bennett,10,0,32,22
1656937467105,MATH 142A,A03,093480,Chow; Bennett,7,0,32,25
1656937467105,MATH 142A,B03,093481,Chow; Bennett,7,0,32,25
1656937467105,MATH 142A,B04,093558,Chow; Bennett,11,0,32,21
1656937467105,MATH 142A,B05,093559,Chow; Bennett,6,0,32,26
1656937473132,MATH 193A,A01,083224,Rotar; Vladimir,7,0,34,27
1656937473132,MATH 193A,A02,083225,Rotar; Vladimir,3,0,34,31
1656937473132,MATH 193A,A03,083781,Rotar; Vladimir,1,0,34,33
1656937473132,MATH 193A,A04,083782,Rotar; Vladimir,6,0,34,28
1656937473132,MATH 193A,A05,093482,Rotar; Vladimir,6,0,34,28
1656937479157,MATH 197,001,091859,McAuley; Julian John,9999,0,9999,0
1656937479157,MATH 197,002,095566,Kedlaya; Kiran S.,9997,0,9999,2
1656937479157,MATH 197,003,095567,Xiao; Ming,9999,0,9999,0
1656937479157,MATH 197,004,095571,Perols; Johan Lars,9998,0,9999,1
1656937486244,COGS 9,A01,083615,Shannon; Kyle Michael,7,0,75,68
1656937492268,COGS 11,A01,083617,Boyle; Mary E. T.,19,0,48,29
1656937498294,COGS 13,A01,083071,Bastos; Amalia Pinkusfeld,9,0,71,62
1656937504320,COGS 14A,A01,092681,Semenuks; Arturs,0,1,100,100
1656937510346,COGS 14B,A01,083073,Cheng; Tzu-Han,5,0,63,58
1656937516373,COGS 17,A01,092677,Semenuks; Arturs,4,0,81,77
1656937522403,COGS 100,A01,083619,Allen; Michael Gordon,15,0,70,55
1656937528431,COGS 101A,A01,083621,Davis; Joshua Daniel,9,0,68,59
1656937534469,COGS 101B,A01,091572,Allen; Michael Gordon,8,0,65,57
1656937540499,COGS 101C,A01,083625,Delgado; Tania,17,0,35,18
1656937546529,COGS 107A,A01,083627,Boyle; Mary E. T.,13,0,60,47
1656937552555,COGS 118A,A01,083075,Gupta; Anjum,15,0,76,61
1656937558588,CSE 3,A50,083646,Miranda; Gregory Joseph,22,0,50,28
1656937564617,CSE 8A,A50,083650,Miranda; Gregory Joseph,17,1,56,39
1656937570641,CSE 11,A01,083080,Cao; Yingjun,4,15,40,36
1656937576669,CSE 12,A01,083652,Krause-Levy; Sophia Louisa,20,1,120,100
1656937582693,CSE 15L,A01,083654,Morris; Justin Loren,8,0,50,42
1656937582693,CSE 15L,A02,083655,Morris; Justin Loren,8,0,50,42
1656937588722,CSE 20,A01,083657,Tran; Khoa Dang,37,0,80,43
1656937594755,CSE 21,A01,095574,Bach; Quang Tran,21,0,48,27
1656937600780,CSE 30,A01,083084,Eldon; John,4,0,80,76
1656937600780,CSE 30,B01,095061,Bhaskar; Nishant,6,0,50,44
1656937606807,CSE 100,A01,083659,Cao; Yingjun,3,4,70,67
1656937612840,CSE 134B,A01,083661,Powell; Thomas Allan,19,0,100,81
1656937618867,CSE 140,A01,083663,Gungor; Onat,14,0,85,71
1656937624912,CSE 140L,A01,083088,Eldon; John,16,0,100,84
1656937630947,CSE 175,A01,083665,Kumar; Rakesh,3,0,25,22
1656937636975,CSE 190,A00,092507,Dubnov; Shlomo,7,0,20,13
1656937643005,ECE 45,A01,083139,Congero; Spencer William,5,0,75,70
1656937649058,ECE 65,A50,083695,Saad; Andrew S,12,0,30,18
1656937649058,ECE 65,A51,095125,Saad; Andrew S,25,0,26,1
1656937655102,ECE 109,A01,091882,Touri; Behrouz,16,0,70,54
1656937661127,ECE 180,A00,083140,Abi Samra; Nicholas Camill,0,0,30,30
1656937661127,ECE 180,B00,083141,Abi Samra; Nicholas Camill,0,0,30,30
1656937667165,MATH 10A,A01,083735,Patchell; Gregory David,1,0,30,29
1656937667165,MATH 10A,A02,083736,Patchell; Gregory David,20,0,30,10
1656937667165,MATH 10A,A03,083737,Patchell; Gregory David,15,0,30,15
1656937673193,MATH 10B,A01,083207,Lim; Seonhee,7,0,34,27
1656937673193,MATH 10B,A02,083208,Lim; Seonhee,9,0,35,26
1656937673193,MATH 10B,A03,093472,Lim; Seonhee,4,0,34,30
1656937673193,MATH 10B,B01,083739,Sinha; Shubham,9,0,30,21
1656937679224,MATH 18,A01,083743,Cinel; Cameron Alexander,6,0,30,24
1656937679224,MATH 18,A02,083744,Cinel; Cameron Alexander,15,0,30,15
1656937679224,MATH 18,A03,083745,Cinel; Cameron Alexander,8,0,30,22
1656937679224,MATH 18,B01,083748,Rideout; David Porter,4,0,37,33
1656937679224,MATH 18,B02,083749,Rideout; David Porter,3,0,36,33
1656937679224,MATH 18,B03,083750,Rideout; David Porter,2,0,37,35
1656937679224,MATH 18,B04,083751,Rideout; David Porter,5,0,36,31
1656937679224,MATH 18,B05,093473,Rideout; David Porter,4,0,36,32
1656937679224,MATH 18,B06,093474,Rideout; David Porter,5,0,36,31
1656937685251,MATH 20A,A01,083754,Zheng; Zequn,12,0,40,28
1656937691285,MATH 20B,A01,083756,Briones; Jor-el Thomas Caparas,1,0,36,35
1656937691285,MATH 20B,A02,083757,Briones; Jor-el Thomas Caparas,1,0,36,35
1656937691285,MATH 20B,A03,093475,Briones; Jor-el Thomas Caparas,0,0,36,36
1656937697314,MATH 20C,A01,083760,Briones; Jor-el Thomas Caparas,1,0,35,34
1656937697314,MATH 20C,A02,083761,Briones; Jor-el Thomas Caparas,8,0,35,27
1656937697314,MATH 20C,A03,093476,Briones; Jor-el Thomas Caparas,0,1,36,36
1656937697314,MATH 20C,B01,083762,Bach; Quang Tran,0,0,30,30
1656937703344,MATH 20D,A01,083765,Tran; Brian Kha,4,0,30,26
1656937703344,MATH 20D,A02,083766,Tran; Brian Kha,4,0,30,26
1656937703344,MATH 20D,A03,083767,Tran; Brian Kha,3,0,30,27
1656937709372,MATH 20E,A01,083771,Ganguly; Soumya,5,0,32,27
1656937709372,MATH 20E,A02,083772,Ganguly; Soumya,6,0,32,26
1656937709372,MATH 20E,B01,083773,Ciotti; Benjamin,18,0,35,17
1656937709372,MATH 20E,B02,083774,Ciotti; Benjamin,17,0,35,18
1656937715403,MATH 103A,A01,083777,Greenfeld; Be'Eri,2,0,36,34
1656937715403,MATH 103A,A02,083778,Greenfeld; Be'Eri,5,0,36,31
1656937715403,MATH 103A,A03,093561,Greenfeld; Be'Eri,4,0,36,32
1656937715403,MATH 103A,B01,083779,Greenfeld; Be'Eri,6,0,36,30
1656937715403,MATH 103A,B02,083780,Greenfeld; Be'Eri,2,0,36,34
1656937715403,MATH 103A,B03,093562,Greenfeld; Be'Eri,2,0,36,34
1656937721436,MATH 105,A01,085443,Carter; Anne Toulson,13,0,35,22
1656937721436,MATH 105,A02,093477,Carter; Anne Toulson,20,0,35,15
1656937727465,MATH 109,A01,083213,Ganzberger; Geoffrey Michael,2,0,34,32
1656937727465,MATH 109,A02,083214,Ganzberger; Geoffrey Michael,2,0,34,32
1656937727465,MATH 109,A03,093478,Ganzberger; Geoffrey Michael,1,0,34,33
1656937727465,MATH 109,B01,083215,Ganzberger; Geoffrey Michael,1,0,32,31
1656937727465,MATH 109,B02,083216,Ganzberger; Geoffrey Michael,1,0,32,31
1656937727465,MATH 109,B03,093479,Ganzberger; Geoffrey Michael,6,0,32,26
1656937733494,MATH 142A,A01,083219,Chow; Bennett,6,0,32,26
1656937733494,MATH 142A,A02,083220,Chow; Bennett,10,0,32,22
1656937733494,MATH 142A,A03,093480,Chow; Bennett,7,0,32,25
1656937733494,MATH 142A,B03,093481,Chow; Bennett,7,0,32,25
1656937733494,MATH 142A,B04,093558,Chow; Bennett,11,0,32,21
1656937733494,MATH 142A,B05,093559,Chow; Bennett,6,0,32,26
1656937739527,MATH 193A,A01,083224,Rotar; Vladimir,7,0,34,27
1656937739527,MATH 193A,A02,083225,Rotar; Vladimir,3,0,34,31
1656937739527,MATH 193A,A03,083781,Rotar; Vladimir,1,0,34,33
1656937739527,MATH 193A,A04,083782,Rotar; Vladimir,6,0,34,28
1656937739527,MATH 193A,A05,093482,Rotar; Vladimir,6,0,34,28
1656937745560,MATH 197,001,091859,McAuley; Julian John,9999,0,9999,0
1656937745560,MATH 197,002,095566,Kedlaya; Kiran S.,9997,0,9999,2
1656937745560,MATH 197,003,095567,Xiao; Ming,9999,0,9999,0
1656937745560,MATH 197,004,095571,Perols; Johan Lars,9998,0,9999,1
1656937752640,COGS 9,A01,083615,Shannon; Kyle Michael,7,0,75,68
1656937758667,COGS 11,A01,083617,Boyle; Mary E. T.,19,0,48,29
1656937764692,COGS 13,A01,083071,Bastos; Amalia Pinkusfeld,9,0,71,62
1656937770724,COGS 14A,A01,092681,Semenuks; Arturs,0,1,100,100
1656937776747,COGS 14B,A01,083073,Cheng; Tzu-Han,5,0,63,58
1656937782772,COGS 17,A01,092677,Semenuks; Arturs,4,0,81,77
1656937788800,COGS 100,A01,083619,Allen; Michael Gordon,15,0,70,55
1656937794830,COGS 101A,A01,083621,Davis; Joshua Daniel,9,0,68,59
1656937800856,COGS 101B,A01,091572,Allen; Michael Gordon,8,0,65,57
1656937806955,COGS 101C,A01,083625,Delgado; Tania,17,0,35,18
1656937812984,COGS 107A,A01,083627,Boyle; Mary E. T.,13,0,60,47
1656937819011,COGS 118A,A01,083075,Gupta; Anjum,15,0,76,61
1656937825041,CSE 3,A50,083646,Miranda; Gregory Joseph,22,0,50,28
1656937831064,CSE 8A,A50,083650,Miranda; Gregory Joseph,17,1,56,39
1656937837095,CSE 11,A01,083080,Cao; Yingjun,4,15,40,36
1656937843121,CSE 12,A01,083652,Krause-Levy; Sophia Louisa,20,1,120,100
1656937849147,CSE 15L,A01,083654,Morris; Justin Loren,8,0,50,42
1656937849147,CSE 15L,A02,083655,Morris; Justin Loren,8,0,50,42
1656937855186,CSE 20,A01,083657,Tran; Khoa Dang,37,0,80,43
1656937861212,CSE 21,A01,095574,Bach; Quang Tran,21,0,48,27
1656937867241,CSE 30,A01,083084,Eldon; John,4,0,80,76
1656937867241,CSE 30,B01,095061,Bhaskar; Nishant,6,0,50,44
1656937873267,CSE 100,A01,083659,Cao; Yingjun,3,4,70,67
1656937879297,CSE 134B,A01,083661,Powell; Thomas Allan,19,0,100,81
1656937885327,CSE 140,A01,083663,Gungor; Onat,14,0,85,71
1656937891357,CSE 140L,A01,083088,Eldon; John,16,0,100,84
1656937897381,CSE 175,A01,083665,Kumar; Rakesh,3,0,25,22
1656937903406,CSE 190,A00,092507,Dubnov; Shlomo,7,0,20,13
1656937909433,ECE 45,A01,083139,Congero; Spencer William,5,0,75,70
1656937915461,ECE 65,A50,083695,Saad; Andrew S,12,0,30,18
1656937915461,ECE 65,A51,095125,Saad; Andrew S,25,0,26,1
1656937921563,ECE 109,A01,091882,Touri; Behrouz,16,0,70,54
1656937927604,ECE 180,A00,083140,Abi Samra; Nicholas Camill,0,0,30,30
1656937927604,ECE 180,B00,083141,Abi Samra; Nicholas Camill,0,0,30,30
1656937933631,MATH 10A,A01,083735,Patchell; Gregory David,1,0,30,29
1656937933631,MATH 10A,A02,083736,Patchell; Gregory David,20,0,30,10
1656937933631,MATH 10A,A03,083737,Patchell; Gregory David,15,0,30,15
1656937939663,MATH 10B,A01,083207,Lim; Seonhee,7,0,34,27
1656937939663,MATH 10B,A02,083208,Lim; Seonhee,9,0,35,26
1656937939663,MATH 10B,A03,093472,Lim; Seonhee,4,0,34,30
1656937939663,MATH 10B,B01,083739,Sinha; Shubham,9,0,30,21
1656937945707,MATH 18,A01,083743,Cinel; Cameron Alexander,6,0,30,24
1656937945707,MATH 18,A02,083744,Cinel; Cameron Alexander,15,0,30,15
1656937945707,MATH 18,A03,083745,Cinel; Cameron Alexander,8,0,30,22
1656937945707,MATH 18,B01,083748,Rideout; David Porter,4,0,37,33
1656937945707,MATH 18,B02,083749,Rideout; David Porter,3,0,36,33
1656937945707,MATH 18,B03,083750,Rideout; David Porter,2,0,37,35
1656937945707,MATH 18,B04,083751,Rideout; David Porter,5,0,36,31
1656937945707,MATH 18,B05,093473,Rideout; David Porter,4,0,36,32
1656937945707,MATH 18,B06,093474,Rideout; David Porter,5,0,36,31
1656937951736,MATH 20A,A01,083754,Zheng; Zequn,12,0,40,28
1656937957764,MATH 20B,A01,083756,Briones; Jor-el Thomas Caparas,1,0,36,35
1656937957764,MATH 20B,A02,083757,Briones; Jor-el Thomas Caparas,1,0,36,35
1656937957764,MATH 20B,A03,093475,Briones; Jor-el Thomas Caparas,0,0,36,36
1656937963793,MATH 20C,A01,083760,Briones; Jor-el Thomas Caparas,1,0,35,34
1656937963793,MATH 20C,A02,083761,Briones; Jor-el Thomas Caparas,8,0,35,27
1656937963793,MATH 20C,A03,093476,Briones; Jor-el Thomas Caparas,0,1,36,36
1656937963793,MATH 20C,B01,083762,Bach; Quang Tran,0,0,30,30
1656937969817,MATH 20D,A01,083765,Tran; Brian Kha,4,0,30,26
1656937969817,MATH 20D,A02,083766,Tran; Brian Kha,4,0,30,26
1656937969817,MATH 20D,A03,083767,Tran; Brian Kha,3,0,30,27
1656937975848,MATH 20E,A01,083771,Ganguly; Soumya,5,0,32,27
1656937975848,MATH 20E,A02,083772,Ganguly; Soumya,6,0,32,26
1656937975848,MATH 20E,B01,083773,Ciotti; Benjamin,18,0,35,17
1656937975848,MATH 20E,B02,083774,Ciotti; Benjamin,17,0,35,18
1656937981874,MATH 103A,A01,083777,Greenfeld; Be'Eri,2,0,36,34
1656937981874,MATH 103A,A02,083778,Greenfeld; Be'Eri,5,0,36,31
1656937981874,MATH 103A,A03,093561,Greenfeld; Be'Eri,4,0,36,32
1656937981874,MATH 103A,B01,083779,Greenfeld; Be'Eri,6,0,36,30
1656937981874,MATH 103A,B02,083780,Greenfeld; Be'Eri,2,0,36,34
1656937981874,MATH 103A,B03,093562,Greenfeld; Be'Eri,2,0,36,34
1656937987904,MATH 105,A01,085443,Carter; Anne Toulson,13,0,35,22
1656937987904,MATH 105,A02,093477,Carter; Anne Toulson,20,0,35,15
1656937993945,MATH 109,A01,083213,Ganzberger; Geoffrey Michael,2,0,34,32
1656937993945,MATH 109,A02,083214,Ganzberger; Geoffrey Michael,2,0,34,32
1656937993945,MATH 109,A03,093478,Ganzberger; Geoffrey Michael,1,0,34,33
1656937993945,MATH 109,B01,083215,Ganzberger; Geoffrey Michael,1,0,32,31
1656937993945,MATH 109,B02,083216,Ganzberger; Geoffrey Michael,1,0,32,31
1656937993945,MATH 109,B03,093479,Ganzberger; Geoffrey Michael,6,0,32,26
1656937999972,MATH 142A,A01,083219,Chow; Bennett,6,0,32,26
1656937999972,MATH 142A,A02,083220,Chow; Bennett,10,0,32,22
1656937999972,MATH 142A,A03,093480,Chow; Bennett,7,0,32,25
1656937999972,MATH 142A,B03,093481,Chow; Bennett,7,0,32,25
1656937999972,MATH 142A,B04,093558,Chow; Bennett,11,0,32,21
1656937999972,MATH 142A,B05,093559,Chow; Bennett,6,0,32,26
1656938005996,MATH 193A,A01,083224,Rotar; Vladimir,7,0,34,27
1656938005996,MATH 193A,A02,083225,Rotar; Vladimir,3,0,34,31
1656938005996,MATH 193A,A03,083781,Rotar; Vladimir,1,0,34,33
1656938005996,MATH 193A,A04,083782,Rotar; Vladimir,6,0,34,28
1656938005996,MATH 193A,A05,093482,Rotar; Vladimir,6,0,34,28
1656938012026,MATH 197,001,091859,McAuley; Julian John,9999,0,9999,0
1656938012026,MATH 197,002,095566,Kedlaya; Kiran S.,9997,0,9999,2
1656938012026,MATH 197,003,095567,Xiao; Ming,9999,0,9999,0
1656938012026,MATH 197,004,095571,Perols; Johan Lars,9998,0,9999,1
1656938019107,COGS 9,A01,083615,Shannon; Kyle Michael,7,0,75,68
1656938025139,COGS 11,A01,083617,Boyle; Mary E. T.,19,0,48,29
1656938031172,COGS 13,A01,083071,Bastos; Amalia Pinkusfeld,9,0,71,62
1656938037205,COGS 14A,A01,092681,Semenuks; Arturs,0,1,100,100
1656938043233,COGS 14B,A01,083073,Cheng; Tzu-Han,5,0,63,58
1656938049262,COGS 17,A01,092677,Semenuks; Arturs,4,0,81,77
1656938055289,COGS 100,A01,083619,Allen; Michael Gordon,15,0,70,55
1656938061314,COGS 101A,A01,083621,Davis; Joshua Daniel,9,0,68,59
1656938067339,COGS 101B,A01,091572,Allen; Michael Gordon,8,0,65,57
1656938073368,COGS 101C,A01,083625,Delgado; Tania,17,0,35,18
1656938079399,COGS 107A,A01,083627,Boyle; Mary E. T.,13,0,60,47
1656938085429,COGS 118A,A01,083075,Gupta; Anjum,15,0,76,61
1656938091456,CSE 3,A50,083646,Miranda; Gregory Joseph,22,0,50,28
1656938097484,CSE 8A,A50,083650,Miranda; Gregory Joseph,17,1,56,39
1656938103508,CSE 11,A01,083080,Cao; Yingjun,4,15,40,36
1656938109532,CSE 12,A01,083652,Krause-Levy; Sophia Louisa,20,1,120,100
1656938115561,CSE 15L,A01,083654,Morris; Justin Loren,8,0,50,42
1656938115561,CSE 15L,A02,083655,Morris; Justin Loren,8,0,50,42
1656938121583,CSE 20,A01,083657,Tran; Khoa Dang,37,0,80,43
1656938127608,CSE 21,A01,095574,Bach; Quang Tran,21,0,48,27
1656938133639,CSE 30,A01,083084,Eldon; John,4,0,80,76
1656938133639,CSE 30,B01,095061,Bhaskar; Nishant,6,0,50,44
1656938139665,CSE 100,A01,083659,Cao; Yingjun,3,4,70,67
1656938145693,CSE 134B,A01,083661,Powell; Thomas Allan,19,0,100,81
1656938151717,CSE 140,A01,083663,Gungor; Onat,14,0,85,71
1656938157744,CSE 140L,A01,083088,Eldon; John,16,0,100,84
1656938163772,CSE 175,A01,083665,Kumar; Rakesh,3,0,25,22
1656938169797,CSE 190,A00,092507,Dubnov; Shlomo,7,0,20,13
1656938175825,ECE 45,A01,083139,Congero; Spencer William,5,0,75,70
1656938181848,ECE 65,A50,083695,Saad; Andrew S,12,0,30,18
1656938181848,ECE 65,A51,095125,Saad; Andrew S,25,0,26,1
1656938187876,ECE 109,A01,091882,Touri; Behrouz,16,0,70,54
1656938193905,ECE 180,A00,083140,Abi Samra; Nicholas Camill,0,0,30,30
1656938193905,ECE 180,B00,083141,Abi Samra; Nicholas Camill,0,0,30,30
1656938199935,MATH 10A,A01,083735,Patchell; Gregory David,1,0,30,29
1656938199935,MATH 10A,A02,083736,Patchell; Gregory David,20,0,30,10
1656938199935,MATH 10A,A03,083737,Patchell; Gregory David,15,0,30,15
1656938205965,MATH 10B,A01,083207,Lim; Seonhee,7,0,34,27
1656938205965,MATH 10B,A02,083208,Lim; Seonhee,9,0,35,26
1656938205965,MATH 10B,A03,093472,Lim; Seonhee,4,0,34,30
1656938205965,MATH 10B,B01,083739,Sinha; Shubham,9,0,30,21
1656938211993,MATH 18,A01,083743,Cinel; Cameron Alexander,6,0,30,24
1656938211993,MATH 18,A02,083744,Cinel; Cameron Alexander,15,0,30,15
1656938211993,MATH 18,A03,083745,Cinel; Cameron Alexander,8,0,30,22
1656938211993,MATH 18,B01,083748,Rideout; David Porter,4,0,37,33
1656938211993,MATH 18,B02,083749,Rideout; David Porter,3,0,36,33
1656938211993,MATH 18,B03,083750,Rideout; David Porter,2,0,37,35
1656938211993,MATH 18,B04,083751,Rideout; David Porter,5,0,36,31
1656938211993,MATH 18,B05,093473,Rideout; David Porter,4,0,36,32
1656938211993,MATH 18,B06,093474,Rideout; David Porter,5,0,36,31
1656938218016,MATH 20A,A01,083754,Zheng; Zequn,12,0,40,28
1656938224039,MATH 20B,A01,083756,Briones; Jor-el Thomas Caparas,1,0,36,35
1656938224039,MATH 20B,A02,083757,Briones; Jor-el Thomas Caparas,1,0,36,35
1656938224039,MATH 20B,A03,093475,Briones; Jor-el Thomas Caparas,0,0,36,36
1656938230065,MATH 20C,A01,083760,Briones; Jor-el Thomas Caparas,1,0,35,34
1656938230065,MATH 20C,A02,083761,Briones; Jor-el Thomas Caparas,8,0,35,27
1656938230065,MATH 20C,A03,093476,Briones; Jor-el Thomas Caparas,0,1,36,36
1656938230065,MATH 20C,B01,083762,Bach; Quang Tran,0,0,30,30
1656938236089,MATH 20D,A01,083765,Tran; Brian Kha,4,0,30,26
1656938236089,MATH 20D,A02,083766,Tran; Brian Kha,4,0,30,26
1656938236089,MATH 20D,A03,083767,Tran; Brian Kha,3,0,30,27
1656938242116,MATH 20E,A01,083771,Ganguly; Soumya,5,0,32,27
1656938242116,MATH 20E,A02,083772,Ganguly; Soumya,6,0,32,26
1656938242116,MATH 20E,B01,083773,Ciotti; Benjamin,18,0,35,17
1656938242116,MATH 20E,B02,083774,Ciotti; Benjamin,17,0,35,18
1656938248141,MATH 103A,A01,083777,Greenfeld; Be'Eri,2,0,36,34
1656938248141,MATH 103A,A02,083778,Greenfeld; Be'Eri,5,0,36,31
1656938248141,MATH 103A,A03,093561,Greenfeld; Be'Eri,4,0,36,32
1656938248141,MATH 103A,B01,083779,Greenfeld; Be'Eri,6,0,36,30
1656938248141,MATH 103A,B02,083780,Greenfeld; Be'Eri,2,0,36,34
1656938248141,MATH 103A,B03,093562,Greenfeld; Be'Eri,2,0,36,34
1656938254167,MATH 105,A01,085443,Carter; Anne Toulson,13,0,35,22
1656938254167,MATH 105,A02,093477,Carter; Anne Toulson,20,0,35,15
1656938260192,MATH 109,A01,083213,Ganzberger; Geoffrey Michael,2,0,34,32
1656938260192,MATH 109,A02,083214,Ganzberger; Geoffrey Michael,2,0,34,32
1656938260192,MATH 109,A03,093478,Ganzberger; Geoffrey Michael,1,0,34,33
1656938260192,MATH 109,B01,083215,Ganzberger; Geoffrey Michael,1,0,32,31
1656938260192,MATH 109,B02,083216,Ganzberger; Geoffrey Michael,1,0,32,31
1656938260192,MATH 109,B03,093479,Ganzberger; Geoffrey Michael,6,0,32,26
1656938266217,MATH 142A,A01,083219,Chow; Bennett,6,0,32,26
1656938266217,MATH 142A,A02,083220,Chow; Bennett,10,0,32,22
1656938266217,MATH 142A,A03,093480,Chow; Bennett,7,0,32,25
1656938266217,MATH 142A,B03,093481,Chow; Bennett,7,0,32,25
1656938266217,MATH 142A,B04,093558,Chow; Bennett,11,0,32,21
1656938266217,MATH 142A,B05,093559,Chow; Bennett,6,0,32,26
1656938272248,MATH 193A,A01,083224,Rotar; Vladimir,7,0,34,27
1656938272248,MATH 193A,A02,083225,Rotar; Vladimir,3,0,34,31
1656938272248,MATH 193A,A03,083781,Rotar; Vladimir,1,0,34,33
1656938272248,MATH 193A,A04,083782,Rotar; Vladimir,6,0,34,28
1656938272248,MATH 193A,A05,093482,Rotar; Vladimir,6,0,34,28
1656938278274,MATH 197,001,091859,McAuley; Julian John,9999,0,9999,0
1656938278274,MATH 197,002,095566,Kedlaya; Kiran S.,9997,0,9999,2
1656938278274,MATH 197,003,095567,Xiao; Ming,9999,0,9999,0
1656938278274,MATH 197,004,095571,Perols; Johan Lars,9998,0,9999,1
1656938285353,COGS 9,A01,083615,Shannon; Kyle Michael,7,0,75,68
1656938291378,COGS 11,A01,083617,Boyle; Mary E. T.,19,0,48,29
1656938297405,COGS 13,A01,083071,Bastos; Amalia Pinkusfeld,9,0,71,62
1656938303439,COGS 14A,A01,092681,Semenuks; Arturs,0,1,100,100
1656938309468,COGS 14B,A01,083073,Cheng; Tzu-Han,5,0,63,58
1656938315494,COGS 17,A01,092677,Semenuks; Arturs,4,0,81,77
1656938321529,COGS 100,A01,083619,Allen; Michael Gordon,15,0,70,55
1656938327556,COGS 101A,A01,083621,Davis; Joshua Daniel,9,0,68,59
1656938333584,COGS 101B,A01,091572,Allen; Michael Gordon,8,0,65,57
1656938339607,COGS 101C,A01,083625,Delgado; Tania,17,0,35,18
1656938345631,COGS 107A,A01,083627,Boyle; Mary E. T.,13,0,60,47
1656938351659,COGS 118A,A01,083075,Gupta; Anjum,15,0,76,61
1656938357684,CSE 3,A50,083646,Miranda; Gregory Joseph,22,0,50,28
1656938363713,CSE 8A,A50,083650,Miranda; Gregory Joseph,17,1,56,39
1656938369737,CSE 11,A01,083080,Cao; Yingjun,4,15,40,36
1656938375765,CSE 12,A01,083652,Krause-Levy; Sophia Louisa,20,1,120,100
1656938381793,CSE 15L,A01,083654,Morris; Justin Loren,8,0,50,42
1656938381793,CSE 15L,A02,083655,Morris; Justin Loren,8,0,50,42
1656938387819,CSE 20,A01,083657,Tran; Khoa Dang,37,0,80,43
1656938393844,CSE 21,A01,095574,Bach; Quang Tran,21,0,48,27
1656938399873,CSE 30,A01,083084,Eldon; John,4,0,80,76
1656938399873,CSE 30,B01,095061,Bhaskar; Nishant,6,0,50,44
1656938405901,CSE 100,A01,083659,Cao; Yingjun,3,4,70,67
1656938411930,CSE 134B,A01,083661,Powell; Thomas Allan,19,0,100,81
1656938417961,CSE 140,A01,083663,Gungor; Onat,14,0,85,71
1656938423987,CSE 140L,A01,083088,Eldon; John,16,0,100,84
1656938430028,CSE 175,A01,083665,Kumar; Rakesh,3,0,25,22
1656938436055,CSE 190,A00,092507,Dubnov; Shlomo,7,0,20,13
1656938442083,ECE 45,A01,083139,Congero; Spencer William,5,0,75,70
1656938448118,ECE 65,A50,083695,Saad; Andrew S,12,0,30,18
1656938448118,ECE 65,A51,095125,Saad; Andrew S,25,0,26,1
1656938454154,ECE 109,A01,091882,Touri; Behrouz,16,0,70,54
1656938460180,ECE 180,A00,083140,Abi Samra; Nicholas Camill,0,0,30,30
1656938460180,ECE 180,B00,083141,Abi Samra; Nicholas Camill,0,0,30,30
1656938466206,MATH 10A,A01,083735,Patchell; Gregory David,1,0,30,29
1656938466206,MATH 10A,A02,083736,Patchell; Gregory David,20,0,30,10
1656938466206,MATH 10A,A03,083737,Patchell; Gregory David,15,0,30,15
1656938472234,MATH 10B,A01,083207,Lim; Seonhee,7,0,34,27
1656938472234,MATH 10B,A02,083208,Lim; Seonhee,9,0,35,26
1656938472234,MATH 10B,A03,093472,Lim; Seonhee,4,0,34,30
1656938472234,MATH 10B,B01,083739,Sinha; Shubham,9,0,30,21
1656938478273,MATH 18,A01,083743,Cinel; Cameron Alexander,6,0,30,24
1656938478273,MATH 18,A02,083744,Cinel; Cameron Alexander,15,0,30,15
1656938478273,MATH 18,A03,083745,Cinel; Cameron Alexander,8,0,30,22
1656938478273,MATH 18,B01,083748,Rideout; David Porter,4,0,37,33
1656938478273,MATH 18,B02,083749,Rideout; David Porter,3,0,36,33
1656938478273,MATH 18,B03,083750,Rideout; David Porter,2,0,37,35
1656938478273,MATH 18,B04,083751,Rideout; David Porter,5,0,36,31
1656938478273,MATH 18,B05,093473,Rideout; David Porter,4,0,36,32
1656938478273,MATH 18,B06,093474,Rideout; David Porter,5,0,36,31
1656938484302,MATH 20A,A01,083754,Zheng; Zequn,12,0,40,28
1656938490328,MATH 20B,A01,083756,Briones; Jor-el Thomas Caparas,1,0,36,35
1656938490328,MATH 20B,A02,083757,Briones; Jor-el Thomas Caparas,1,0,36,35
1656938490328,MATH 20B,A03,093475,Briones; Jor-el Thomas Caparas,0,0,36,36
1656938496359,MATH 20C,A01,083760,Briones; Jor-el Thomas Caparas,1,0,35,34
1656938496359,MATH 20C,A02,083761,Briones; Jor-el Thomas Caparas,8,0,35,27
1656938496359,MATH 20C,A03,093476,Briones; Jor-el Thomas Caparas,0,1,36,36
1656938496359,MATH 20C,B01,083762,Bach; Quang Tran,0,0,30,30
1656938502387,MATH 20D,A01,083765,Tran; Brian Kha,4,0,30,26
1656938502387,MATH 20D,A02,083766,Tran; Brian Kha,4,0,30,26
1656938502387,MATH 20D,A03,083767,Tran; Brian Kha,3,0,30,27
1656938508413,MATH 20E,A01,083771,Ganguly; Soumya,5,0,32,27
1656938508413,MATH 20E,A02,083772,Ganguly; Soumya,6,0,32,26
1656938508413,MATH 20E,B01,083773,Ciotti; Benjamin,18,0,35,17
1656938508413,MATH 20E,B02,083774,Ciotti; Benjamin,17,0,35,18
1656938514445,MATH 103A,A01,083777,Greenfeld; Be'Eri,2,0,36,34
1656938514445,MATH 103A,A02,083778,Greenfeld; Be'Eri,5,0,36,31
1656938514445,MATH 103A,A03,093561,Greenfeld; Be'Eri,4,0,36,32
1656938514445,MATH 103A,B01,083779,Greenfeld; Be'Eri,6,0,36,30
1656938514445,MATH 103A,B02,083780,Greenfeld; Be'Eri,2,0,36,34
1656938514445,MATH 103A,B03,093562,Greenfeld; Be'Eri,2,0,36,34
1656938520544,MATH 105,A01,085443,Carter; Anne Toulson,13,0,35,22
1656938520544,MATH 105,A02,093477,Carter; Anne Toulson,20,0,35,15
1656938526568,MATH 109,A01,083213,Ganzberger; Geoffrey Michael,2,0,34,32
1656938526568,MATH 109,A02,083214,Ganzberger; Geoffrey Michael,2,0,34,32
1656938526568,MATH 109,A03,093478,Ganzberger; Geoffrey Michael,1,0,34,33
1656938526568,MATH 109,B01,083215,Ganzberger; Geoffrey Michael,1,0,32,31
1656938526568,MATH 109,B02,083216,Ganzberger; Geoffrey Michael,1,0,32,31
1656938526568,MATH 109,B03,093479,Ganzberger; Geoffrey Michael,6,0,32,26
1656938532602,MATH 142A,A01,083219,Chow; Bennett,6,0,32,26
1656938532602,MATH 142A,A02,083220,Chow; Bennett,10,0,32,22
1656938532602,MATH 142A,A03,093480,Chow; Bennett,7,0,32,25
1656938532602,MATH 142A,B03,093481,Chow; Bennett,7,0,32,25
1656938532602,MATH 142A,B04,093558,Chow; Bennett,11,0,32,21
1656938532602,MATH 142A,B05,093559,Chow; Bennett,6,0,32,26
1656938538633,MATH 193A,A01,083224,Rotar; Vladimir,7,0,34,27
1656938538633,MATH 193A,A02,083225,Rotar; Vladimir,3,0,34,31
1656938538633,MATH 193A,A03,083781,Rotar; Vladimir,1,0,34,33
1656938538633,MATH 193A,A04,083782,Rotar; Vladimir,6,0,34,28
1656938538633,MATH 193A,A05,093482,Rotar; Vladimir,6,0,34,28
1656938544663,MATH 197,001,091859,McAuley; Julian John,9999,0,9999,0
1656938544663,MATH 197,002,095566,Kedlaya; Kiran S.,9997,0,9999,2
1656938544663,MATH 197,003,095567,Xiao; Ming,9999,0,9999,0
1656938544663,MATH 197,004,095571,Perols; Johan Lars,9998,0,9999,1
1656938551735,COGS 9,A01,083615,Shannon; Kyle Michael,7,0,75,68
1656938557757,COGS 11,A01,083617,Boyle; Mary E. T.,19,0,48,29
1656938563781,COGS 13,A01,083071,Bastos; Amalia Pinkusfeld,9,0,71,62
1656938569804,COGS 14A,A01,092681,Semenuks; Arturs,0,1,100,100
1656938575829,COGS 14B,A01,083073,Cheng; Tzu-Han,5,0,63,58
1656938581854,COGS 17,A01,092677,Semenuks; Arturs,4,0,81,77
1656938587876,COGS 100,A01,083619,Allen; Michael Gordon,15,0,70,55
1656938593901,COGS 101A,A01,083621,Davis; Joshua Daniel,9,0,68,59
1656938599928,COGS 101B,A01,091572,Allen; Michael Gordon,8,0,65,57
1656938605957,COGS 101C,A01,083625,Delgado; Tania,17,0,35,18
1656938611985,COGS 107A,A01,083627,Boyle; Mary E. T.,13,0,60,47
1656938618015,COGS 118A,A01,083075,Gupta; Anjum,15,0,76,61
1656938624039,CSE 3,A50,083646,Miranda; Gregory Joseph,22,0,50,28
1656938630066,CSE 8A,A50,083650,Miranda; Gregory Joseph,17,1,56,39
1656938636092,CSE 11,A01,083080,Cao; Yingjun,4,15,40,36
1656938642116,CSE 12,A01,083652,Krause-Levy; Sophia Louisa,20,1,120,100
1656938648142,CSE 15L,A01,083654,Morris; Justin Loren,8,0,50,42
1656938648142,CSE 15L,A02,083655,Morris; Justin Loren,8,0,50,42
1656938654171,CSE 20,A01,083657,Tran; Khoa Dang,37,0,80,43
1656938660211,CSE 21,A01,095574,Bach; Quang Tran,21,0,48,27
1656938666263,CSE 30,A01,083084,Eldon; John,4,0,80,76
1656938666263,CSE 30,B01,095061,Bhaskar; Nishant,6,0,50,44
1656938672286,CSE 100,A01,083659,Cao; Yingjun,3,4,70,67
1656938678312,CSE 134B,A01,083661,Powell; Thomas Allan,19,0,100,81
1656938684336,CSE 140,A01,083663,Gungor; Onat,14,0,85,71
1656938690361,CSE 140L,A01,083088,Eldon; John,16,0,100,84
1656938696387,CSE 175,A01,083665,Kumar; Rakesh,3,0,25,22
1656938702414,CSE 190,A00,092507,Dubnov; Shlomo,7,0,20,13
1656938708439,ECE 45,A01,083139,Congero; Spencer William,5,0,75,70
1656938714469,ECE 65,A50,083695,Saad; Andrew S,12,0,30,18
1656938714469,ECE 65,A51,095125,Saad; Andrew S,25,0,26,1
1656938720494,ECE 109,A01,091882,Touri; Behrouz,16,0,70,54
1656938726521,ECE 180,A00,083140,Abi Samra; Nicholas Camill,0,0,30,30
1656938726521,ECE 180,B00,083141,Abi Samra; Nicholas Camill,0,0,30,30
1656938732545,MATH 10A,A01,083735,Patchell; Gregory David,1,0,30,29
1656938732545,MATH 10A,A02,083736,Patchell; Gregory David,20,0,30,10
1656938732545,MATH 10A,A03,083737,Patchell; Gregory David,15,0,30,15
1656938738576,MATH 10B,A01,083207,Lim; Seonhee,7,0,34,27
1656938738576,MATH 10B,A02,083208,Lim; Seonhee,9,0,35,26
1656938738576,MATH 10B,A03,093472,Lim; Seonhee,4,0,34,30
1656938738576,MATH 10B,B01,083739,Sinha; Shubham,9,0,30,21
1656938744609,MATH 18,A01,083743,Cinel; Cameron Alexander,6,0,30,24
1656938744609,MATH 18,A02,083744,Cinel; Cameron Alexander,15,0,30,15
1656938744609,MATH 18,A03,083745,Cinel; Cameron Alexander,8,0,30,22
1656938744609,MATH 18,B01,083748,Rideout; David Porter,4,0,37,33
1656938744609,MATH 18,B02,083749,Rideout; David Porter,3,0,36,33
1656938744609,MATH 18,B03,083750,Rideout; David Porter,2,0,37,35
1656938744609,MATH 18,B04,083751,Rideout; David Porter,5,0,36,31
1656938744609,MATH 18,B05,093473,Rideout; David Porter,4,0,36,32
1656938744609,MATH 18,B06,093474,Rideout; David Porter,5,0,36,31
1656938750633,MATH 20A,A01,083754,Zheng; Zequn,12,0,40,28
1656938756657,MATH 20B,A01,083756,Briones; Jor-el Thomas Caparas,1,0,36,35
1656938756657,MATH 20B,A02,083757,Briones; Jor-el Thomas Caparas,1,0,36,35
1656938756657,MATH 20B,A03,093475,Briones; Jor-el Thomas Caparas,0,0,36,36
1656938762683,MATH 20C,A01,083760,Briones; Jor-el Thomas Caparas,1,0,35,34
1656938762683,MATH 20C,A02,083761,Briones; Jor-el Thomas Caparas,8,0,35,27
1656938762683,MATH 20C,A03,093476,Briones; Jor-el Thomas Caparas,0,1,36,36
1656938762683,MATH 20C,B01,083762,Bach; Quang Tran,0,0,30,30
1656938768709,MATH 20D,A01,083765,Tran; Brian Kha,4,0,30,26
1656938768709,MATH 20D,A02,083766,Tran; Brian Kha,4,0,30,26
1656938768709,MATH 20D,A03,083767,Tran; Brian Kha,3,0,30,27
1656938774739,MATH 20E,A01,083771,Ganguly; Soumya,5,0,32,27
1656938774739,MATH 20E,A02,083772,Ganguly; Soumya,6,0,32,26
1656938774739,MATH 20E,B01,083773,Ciotti; Benjamin,18,0,35,17
1656938774739,MATH 20E,B02,083774,Ciotti; Benjamin,17,0,35,18
1656938780765,MATH 103A,A01,083777,Greenfeld; Be'Eri,2,0,36,34
1656938780765,MATH 103A,A02,083778,Greenfeld; Be'Eri,5,0,36,31
1656938780765,MATH 103A,A03,093561,Greenfeld; Be'Eri,4,0,36,32
1656938780765,MATH 103A,B01,083779,Greenfeld; Be'Eri,6,0,36,30
1656938780765,MATH 103A,B02,083780,Greenfeld; Be'Eri,2,0,36,34
1656938780765,MATH 103A,B03,093562,Greenfeld; Be'Eri,2,0,36,34
1656938786789,MATH 105,A01,085443,Carter; Anne Toulson,13,0,35,22
1656938786789,MATH 105,A02,093477,Carter; Anne Toulson,20,0,35,15
1656938792822,MATH 109,A01,083213,Ganzberger; Geoffrey Michael,2,0,34,32
1656938792822,MATH 109,A02,083214,Ganzberger; Geoffrey Michael,2,0,34,32
1656938792822,MATH 109,A03,093478,Ganzberger; Geoffrey Michael,1,0,34,33
1656938792822,MATH 109,B01,083215,Ganzberger; Geoffrey Michael,1,0,32,31
1656938792822,MATH 109,B02,083216,Ganzberger; Geoffrey Michael,1,0,32,31
1656938792822,MATH 109,B03,093479,Ganzberger; Geoffrey Michael,6,0,32,26
1656938798855,MATH 142A,A01,083219,Chow; Bennett,6,0,32,26
1656938798855,MATH 142A,A02,083220,Chow; Bennett,10,0,32,22
1656938798855,MATH 142A,A03,093480,Chow; Bennett,7,0,32,25
1656938798855,MATH 142A,B03,093481,Chow; Bennett,7,0,32,25
1656938798855,MATH 142A,B04,093558,Chow; Bennett,11,0,32,21
1656938798855,MATH 142A,B05,093559,Chow; Bennett,6,0,32,26
1656938804881,MATH 193A,A01,083224,Rotar; Vladimir,7,0,34,27
1656938804881,MATH 193A,A02,083225,Rotar; Vladimir,3,0,34,31
1656938804881,MATH 193A,A03,083781,Rotar; Vladimir,1,0,34,33
1656938804881,MATH 193A,A04,083782,Rotar; Vladimir,6,0,34,28
1656938804881,MATH 193A,A05,093482,Rotar; Vladimir,6,0,34,28
1656938810910,MATH 197,001,091859,McAuley; Julian John,9999,0,9999,0
1656938810910,MATH 197,002,095566,Kedlaya; Kiran S.,9997,0,9999,2
1656938810910,MATH 197,003,095567,Xiao; Ming,9999,0,9999,0
1656938810910,MATH 197,004,095571,Perols; Johan Lars,9998,0,9999,1
1656938817991,COGS 9,A01,083615,Shannon; Kyle Michael,7,0,75,68
1656938824015,COGS 11,A01,083617,Boyle; Mary E. T.,19,0,48,29
1656938830042,COGS 13,A01,083071,Bastos; Amalia Pinkusfeld,9,0,71,62
1656938836066,COGS 14A,A01,092681,Semenuks; Arturs,0,1,100,100
1656938842093,COGS 14B,A01,083073,Cheng; Tzu-Han,5,0,63,58
1656938848122,COGS 17,A01,092677,Semenuks; Arturs,4,0,81,77
1656938854149,COGS 100,A01,083619,Allen; Michael Gordon,15,0,70,55
1656938860175,COGS 101A,A01,083621,Davis; Joshua Daniel,9,0,68,59
1656938866199,COGS 101B,A01,091572,Allen; Michael Gordon,8,0,65,57
1656938872226,COGS 101C,A01,083625,Delgado; Tania,17,0,35,18
1656938878253,COGS 107A,A01,083627,Boyle; Mary E. T.,13,0,60,47
1656938884284,COGS 118A,A01,083075,Gupta; Anjum,15,0,76,61
1656938890312,CSE 3,A50,083646,Miranda; Gregory Joseph,22,0,50,28
1656938896341,CSE 8A,A50,083650,Miranda; Gregory Joseph,17,1,56,39
1656938902364,CSE 11,A01,083080,Cao; Yingjun,4,15,40,36
1656938908393,CSE 12,A01,083652,Krause-Levy; Sophia Louisa,20,1,120,100
1656938914417,CSE 15L,A01,083654,Morris; Justin Loren,8,0,50,42
1656938914417,CSE 15L,A02,083655,Morris; Justin Loren,8,0,50,42
1656938920443,CSE 20,A01,083657,Tran; Khoa Dang,37,0,80,43
1656938926469,CSE 21,A01,095574,Bach; Quang Tran,21,0,48,27
1656938932497,CSE 30,A01,083084,Eldon; John,4,0,80,76
1656938932497,CSE 30,B01,095061,Bhaskar; Nishant,6,0,50,44
1656938938525,CSE 100,A01,083659,Cao; Yingjun,3,4,70,67
1656938944550,CSE 134B,A01,083661,Powell; Thomas Allan,19,0,100,81
1656938950580,CSE 140,A01,083663,Gungor; Onat,14,0,85,71
1656938956604,CSE 140L,A01,083088,Eldon; John,16,0,100,84
1656938962627,CSE 175,A01,083665,Kumar; Rakesh,3,0,25,22
1656938968654,CSE 190,A00,092507,Dubnov; Shlomo,7,0,20,13
1656938974677,ECE 45,A01,083139,Congero; Spencer William,5,0,75,70
1656938980702,ECE 65,A50,083695,Saad; Andrew S,12,0,30,18
1656938980702,ECE 65,A51,095125,Saad; Andrew S,25,0,26,1
1656938986727,ECE 109,A01,091882,Touri; Behrouz,16,0,70,54
1656938992750,ECE 180,A00,083140,Abi Samra; Nicholas Camill,0,0,30,30
1656938992750,ECE 180,B00,083141,Abi Samra; Nicholas Camill,0,0,30,30
1656938998778,MATH 10A,A01,083735,Patchell; Gregory David,1,0,30,29
1656938998778,MATH 10A,A02,083736,Patchell; Gregory David,20,0,30,10
1656938998778,MATH 10A,A03,083737,Patchell; Gregory David,15,0,30,15
1656939004803,MATH 10B,A01,083207,Lim; Seonhee,7,0,34,27
1656939004803,MATH 10B,A02,083208,Lim; Seonhee,9,0,35,26
1656939004803,MATH 10B,A03,093472,Lim; Seonhee,4,0,34,30
1656939004803,MATH 10B,B01,083739,Sinha; Shubham,9,0,30,21
1656939010831,MATH 18,A01,083743,Cinel; Cameron Alexander,6,0,30,24
1656939010831,MATH 18,A02,083744,Cinel; Cameron Alexander,15,0,30,15
1656939010831,MATH 18,A03,083745,Cinel; Cameron Alexander,8,0,30,22
1656939010831,MATH 18,B01,083748,Rideout; David Porter,4,0,37,33
1656939010831,MATH 18,B02,083749,Rideout; David Porter,3,0,36,33
1656939010831,MATH 18,B03,083750,Rideout; David Porter,2,0,37,35
1656939010831,MATH 18,B04,083751,Rideout; David Porter,5,0,36,31
1656939010831,MATH 18,B05,093473,Rideout; David Porter,4,0,36,32
1656939010831,MATH 18,B06,093474,Rideout; David Porter,5,0,36,31
1656939016859,MATH 20A,A01,083754,Zheng; Zequn,12,0,40,28
1656939022888,MATH 20B,A01,083756,Briones; Jor-el Thomas Caparas,1,0,36,35
1656939022888,MATH 20B,A02,083757,Briones; Jor-el Thomas Caparas,1,0,36,35
1656939022888,MATH 20B,A03,093475,Briones; Jor-el Thomas Caparas,0,0,36,36
1656939028912,MATH 20C,A01,083760,Briones; Jor-el Thomas Caparas,1,0,35,34
1656939028912,MATH 20C,A02,083761,Briones; Jor-el Thomas Caparas,8,0,35,27
1656939028912,MATH 20C,A03,093476,Briones; Jor-el Thomas Caparas,0,1,36,36
1656939028912,MATH 20C,B01,083762,Bach; Quang Tran,0,0,30,30
1656939034944,MATH 20D,A01,083765,Tran; Brian Kha,4,0,30,26
1656939034944,MATH 20D,A02,083766,Tran; Brian Kha,4,0,30,26
1656939034944,MATH 20D,A03,083767,Tran; Brian Kha,3,0,30,27
1656939040975,MATH 20E,A01,083771,Ganguly; Soumya,5,0,32,27
1656939040975,MATH 20E,A02,083772,Ganguly; Soumya,6,0,32,26
1656939040975,MATH 20E,B01,083773,Ciotti; Benjamin,18,0,35,17
1656939040975,MATH 20E,B02,083774,Ciotti; Benjamin,17,0,35,18
1656939047010,MATH 103A,A01,083777,Greenfeld; Be'Eri,2,0,36,34
1656939047010,MATH 103A,A02,083778,Greenfeld; Be'Eri,5,0,36,31
1656939047010,MATH 103A,A03,093561,Greenfeld; Be'Eri,4,0,36,32
1656939047010,MATH 103A,B01,083779,Greenfeld; Be'Eri,6,0,36,30
1656939047010,MATH 103A,B02,083780,Greenfeld; Be'Eri,2,0,36,34
1656939047010,MATH 103A,B03,093562,Greenfeld; Be'Eri,2,0,36,34
1656939053040,MATH 105,A01,085443,Carter; Anne Toulson,13,0,35,22
1656939053040,MATH 105,A02,093477,Carter; Anne Toulson,20,0,35,15
1656939059065,MATH 109,A01,083213,Ganzberger; Geoffrey Michael,2,0,34,32
1656939059065,MATH 109,A02,083214,Ganzberger; Geoffrey Michael,2,0,34,32
1656939059065,MATH 109,A03,093478,Ganzberger; Geoffrey Michael,1,0,34,33
1656939059065,MATH 109,B01,083215,Ganzberger; Geoffrey Michael,1,0,32,31
1656939059065,MATH 109,B02,083216,Ganzberger; Geoffrey Michael,1,0,32,31
1656939059065,MATH 109,B03,093479,Ganzberger; Geoffrey Michael,6,0,32,26
1656939065089,MATH 142A,A01,083219,Chow; Bennett,6,0,32,26
1656939065089,MATH 142A,A02,083220,Chow; Bennett,10,0,32,22
1656939065089,MATH 142A,A03,093480,Chow; Bennett,7,0,32,25
1656939065089,MATH 142A,B03,093481,Chow; Bennett,7,0,32,25
1656939065089,MATH 142A,B04,093558,Chow; Bennett,11,0,32,21
1656939065089,MATH 142A,B05,093559,Chow; Bennett,6,0,32,26
1656939071121,MATH 193A,A01,083224,Rotar; Vladimir,7,0,34,27
1656939071121,MATH 193A,A02,083225,Rotar; Vladimir,3,0,34,31
1656939071121,MATH 193A,A03,083781,Rotar; Vladimir,1,0,34,33
1656939071121,MATH 193A,A04,083782,Rotar; Vladimir,6,0,34,28
1656939071121,MATH 193A,A05,093482,Rotar; Vladimir,6,0,34,28
1656939077151,MATH 197,001,091859,McAuley; Julian John,9999,0,9999,0
1656939077151,MATH 197,002,095566,Kedlaya; Kiran S.,9997,0,9999,2
1656939077151,MATH 197,003,095567,Xiao; Ming,9999,0,9999,0
1656939077151,MATH 197,004,095571,Perols; Johan Lars,9998,0,9999,1
1656939084239,COGS 9,A01,083615,Shannon; Kyle Michael,7,0,75,68
1656939090264,COGS 11,A01,083617,Boyle; Mary E. T.,19,0,48,29
1656939096291,COGS 13,A01,083071,Bastos; Amalia Pinkusfeld,9,0,71,62
1656939102322,COGS 14A,A01,092681,Semenuks; Arturs,0,1,100,100
1656939108347,COGS 14B,A01,083073,Cheng; Tzu-Han,5,0,63,58
1656939114444,COGS 17,A01,092677,Semenuks; Arturs,4,0,81,77
1656939120473,COGS 100,A01,083619,Allen; Michael Gordon,15,0,70,55
1656939126503,COGS 101A,A01,083621,Davis; Joshua Daniel,9,0,68,59
1656939132527,COGS 101B,A01,091572,Allen; Michael Gordon,8,0,65,57
1656939138559,COGS 101C,A01,083625,Delgado; Tania,17,0,35,18
1656939144586,COGS 107A,A01,083627,Boyle; Mary E. T.,13,0,60,47
1656939150612,COGS 118A,A01,083075,Gupta; Anjum,15,0,76,61
1656939156638,CSE 3,A50,083646,Miranda; Gregory Joseph,22,0,50,28
1656939162660,CSE 8A,A50,083650,Miranda; Gregory Joseph,17,1,56,39
1656939168688,CSE 11,A01,083080,Cao; Yingjun,4,15,40,36
1656939174712,CSE 12,A01,083652,Krause-Levy; Sophia Louisa,20,1,120,100
1656939180740,CSE 15L,A01,083654,Morris; Justin Loren,8,0,50,42
1656939180740,CSE 15L,A02,083655,Morris; Justin Loren,8,0,50,42
1656939186770,CSE 20,A01,083657,Tran; Khoa Dang,37,0,80,43
1656939192794,CSE 21,A01,095574,Bach; Quang Tran,21,0,48,27
1656939198817,CSE 30,A01,083084,Eldon; John,4,0,80,76
1656939198817,CSE 30,B01,095061,Bhaskar; Nishant,6,0,50,44
1656939204844,CSE 100,A01,083659,Cao; Yingjun,3,4,70,67
1656939210868,CSE 134B,A01,083661,Powell; Thomas Allan,19,0,100,81
1656939216893,CSE 140,A01,083663,Gungor; Onat,14,0,85,71
1656939222922,CSE 140L,A01,083088,Eldon; John,16,0,100,84
1656939228950,CSE 175,A01,083665,Kumar; Rakesh,3,0,25,22
1656939234975,CSE 190,A00,092507,Dubnov; Shlomo,7,0,20,13
1656939241001,ECE 45,A01,083139,Congero; Spencer William,5,0,75,70
1656939247028,ECE 65,A50,083695,Saad; Andrew S,12,0,30,18
1656939247028,ECE 65,A51,095125,Saad; Andrew S,25,0,26,1
1656939253056,ECE 109,A01,091882,Touri; Behrouz,16,0,70,54
1656939259081,ECE 180,A00,083140,Abi Samra; Nicholas Camill,0,0,30,30
1656939259081,ECE 180,B00,083141,Abi Samra; Nicholas Camill,0,0,30,30
1656939265112,MATH 10A,A01,083735,Patchell; Gregory David,1,0,30,29
1656939265112,MATH 10A,A02,083736,Patchell; Gregory David,20,0,30,10
1656939265112,MATH 10A,A03,083737,Patchell; Gregory David,15,0,30,15
1656939271139,MATH 10B,A01,083207,Lim; Seonhee,7,0,34,27
1656939271139,MATH 10B,A02,083208,Lim; Seonhee,9,0,35,26
1656939271139,MATH 10B,A03,093472,Lim; Seonhee,4,0,34,30
1656939271139,MATH 10B,B01,083739,Sinha; Shubham,9,0,30,21
1656939277180,MATH 18,A01,083743,Cinel; Cameron Alexander,6,0,30,24
1656939277180,MATH 18,A02,083744,Cinel; Cameron Alexander,15,0,30,15
1656939277180,MATH 18,A03,083745,Cinel; Cameron Alexander,8,0,30,22
1656939277180,MATH 18,B01,083748,Rideout; David Porter,4,0,37,33
1656939277180,MATH 18,B02,083749,Rideout; David Porter,3,0,36,33
1656939277180,MATH 18,B03,083750,Rideout; David Porter,2,0,37,35
1656939277180,MATH 18,B04,083751,Rideout; David Porter,5,0,36,31
1656939277180,MATH 18,B05,093473,Rideout; David Porter,4,0,36,32
1656939277180,MATH 18,B06,093474,Rideout; David Porter,5,0,36,31
1656939283210,MATH 20A,A01,083754,Zheng; Zequn,12,0,40,28
1656939289236,MATH 20B,A01,083756,Briones; Jor-el Thomas Caparas,1,0,36,35
1656939289236,MATH 20B,A02,083757,Briones; Jor-el Thomas Caparas,1,0,36,35
1656939289236,MATH 20B,A03,093475,Briones; Jor-el Thomas Caparas,0,0,36,36
1656939295263,MATH 20C,A01,083760,Briones; Jor-el Thomas Caparas,1,0,35,34
1656939295263,MATH 20C,A02,083761,Briones; Jor-el Thomas Caparas,8,0,35,27
1656939295263,MATH 20C,A03,093476,Briones; Jor-el Thomas Caparas,0,1,36,36
1656939295263,MATH 20C,B01,083762,Bach; Quang Tran,0,0,30,30
1656939301288,MATH 20D,A01,083765,Tran; Brian Kha,4,0,30,26
1656939301288,MATH 20D,A02,083766,Tran; Brian Kha,4,0,30,26
1656939301288,MATH 20D,A03,083767,Tran; Brian Kha,3,0,30,27
1656939307313,MATH 20E,A01,083771,Ganguly; Soumya,5,0,32,27
1656939307313,MATH 20E,A02,083772,Ganguly; Soumya,6,0,32,26
1656939307313,MATH 20E,B01,083773,Ciotti; Benjamin,18,0,35,17
1656939307313,MATH 20E,B02,083774,Ciotti; Benjamin,17,0,35,18
1656939313340,MATH 103A,A01,083777,Greenfeld; Be'Eri,2,0,36,34
1656939313340,MATH 103A,A02,083778,Greenfeld; Be'Eri,5,0,36,31
1656939313340,MATH 103A,A03,093561,Greenfeld; Be'Eri,4,0,36,32
1656939313340,MATH 103A,B01,083779,Greenfeld; Be'Eri,6,0,36,30
1656939313340,MATH 103A,B02,083780,Greenfeld; Be'Eri,2,0,36,34
1656939313340,MATH 103A,B03,093562,Greenfeld; Be'Eri,2,0,36,34
1656939319366,MATH 105,A01,085443,Carter; Anne Toulson,13,0,35,22
1656939319366,MATH 105,A02,093477,Carter; Anne Toulson,20,0,35,15
1656939325392,MATH 109,A01,083213,Ganzberger; Geoffrey Michael,2,0,34,32
1656939325392,MATH 109,A02,083214,Ganzberger; Geoffrey Michael,2,0,34,32
1656939325392,MATH 109,A03,093478,Ganzberger; Geoffrey Michael,1,0,34,33
1656939325392,MATH 109,B01,083215,Ganzberger; Geoffrey Michael,1,0,32,31
1656939325392,MATH 109,B02,083216,Ganzberger; Geoffrey Michael,1,0,32,31
1656939325392,MATH 109,B03,093479,Ganzberger; Geoffrey Michael,6,0,32,26
1656939331418,MATH 142A,A01,083219,Chow; Bennett,6,0,32,26
1656939331418,MATH 142A,A02,083220,Chow; Bennett,10,0,32,22
1656939331418,MATH 142A,A03,093480,Chow; Bennett,7,0,32,25
1656939331418,MATH 142A,B03,093481,Chow; Bennett,7,0,32,25
1656939331418,MATH 142A,B04,093558,Chow; Bennett,11,0,32,21
1656939331418,MATH 142A,B05,093559,Chow; Bennett,6,0,32,26
1656939337445,MATH 193A,A01,083224,Rotar; Vladimir,7,0,34,27
1656939337445,MATH 193A,A02,083225,Rotar; Vladimir,3,0,34,31
1656939337445,MATH 193A,A03,083781,Rotar; Vladimir,1,0,34,33
1656939337445,MATH 193A,A04,083782,Rotar; Vladimir,6,0,34,28
1656939337445,MATH 193A,A05,093482,Rotar; Vladimir,6,0,34,28
1656939343475,MATH 197,001,091859,McAuley; Julian John,9999,0,9999,0
1656939343475,MATH 197,002,095566,Kedlaya; Kiran S.,9997,0,9999,2
1656939343475,MATH 197,003,095567,Xiao; Ming,9999,0,9999,0
1656939343475,MATH 197,004,095571,Perols; Johan Lars,9998,0,9999,1
1656939350526,COGS 9,A01,083615,Shannon; Kyle Michael,7,0,75,68
1656939356554,COGS 11,A01,083617,Boyle; Mary E. T.,19,0,48,29
1656939362583,COGS 13,A01,083071,Bastos; Amalia Pinkusfeld,9,0,71,62
1656939368609,COGS 14A,A01,092681,Semenuks; Arturs,0,1,100,100
1656939374634,COGS 14B,A01,083073,Cheng; Tzu-Han,5,0,63,58
1656939380672,COGS 17,A01,092677,Semenuks; Arturs,4,0,81,77
1656939386695,COGS 100,A01,083619,Allen; Michael Gordon,15,0,70,55
1656939392720,COGS 101A,A01,083621,Davis; Joshua Daniel,9,0,68,59
1656939398747,COGS 101B,A01,091572,Allen; Michael Gordon,8,0,65,57
1656939404773,COGS 101C,A01,083625,Delgado; Tania,17,0,35,18
1656939410798,COGS 107A,A01,083627,Boyle; Mary E. T.,13,0,60,47
1656939416823,COGS 118A,A01,083075,Gupta; Anjum,15,0,76,61
1656939422850,CSE 3,A50,083646,Miranda; Gregory Joseph,22,0,50,28
1656939428875,CSE 8A,A50,083650,Miranda; Gregory Joseph,17,1,56,39
1656939434900,CSE 11,A01,083080,Cao; Yingjun,4,15,40,36
1656939440926,CSE 12,A01,083652,Krause-Levy; Sophia Louisa,20,1,120,100
1656939446955,CSE 15L,A01,083654,Morris; Justin Loren,8,0,50,42
1656939446955,CSE 15L,A02,083655,Morris; Justin Loren,8,0,50,42
1656939452980,CSE 20,A01,083657,Tran; Khoa Dang,37,0,80,43
1656939459007,CSE 21,A01,095574,Bach; Quang Tran,21,0,48,27
1656939465030,CSE 30,A01,083084,Eldon; John,4,0,80,76
1656939465030,CSE 30,B01,095061,Bhaskar; Nishant,6,0,50,44
1656939471056,CSE 100,A01,083659,Cao; Yingjun,3,4,70,67
1656939477082,CSE 134B,A01,083661,Powell; Thomas Allan,19,0,100,81
1656939483113,CSE 140,A01,083663,Gungor; Onat,14,0,85,71
1656939489142,CSE 140L,A01,083088,Eldon; John,16,0,100,84
1656939495167,CSE 175,A01,083665,Kumar; Rakesh,3,0,25,22
1656939501193,CSE 190,A00,092507,Dubnov; Shlomo,7,0,20,13
1656939507221,ECE 45,A01,083139,Congero; Spencer William,5,0,75,70
1656939513248,ECE 65,A50,083695,Saad; Andrew S,12,0,30,18
1656939513248,ECE 65,A51,095125,Saad; Andrew S,25,0,26,1
1656939519271,ECE 109,A01,091882,Touri; Behrouz,16,0,70,54
1656939525296,ECE 180,A00,083140,Abi Samra; Nicholas Camill,0,0,30,30
1656939525296,ECE 180,B00,083141,Abi Samra; Nicholas Camill,0,0,30,30
1656939531327,MATH 10A,A01,083735,Patchell; Gregory David,1,0,30,29
1656939531327,MATH 10A,A02,083736,Patchell; Gregory David,20,0,30,10
1656939531327,MATH 10A,A03,083737,Patchell; Gregory David,15,0,30,15
1656939537355,MATH 10B,A01,083207,Lim; Seonhee,7,0,34,27
1656939537355,MATH 10B,A02,083208,Lim; Seonhee,9,0,35,26
1656939537355,MATH 10B,A03,093472,Lim; Seonhee,4,0,34,30
1656939537355,MATH 10B,B01,083739,Sinha; Shubham,9,0,30,21
1656939543391,MATH 18,A01,083743,Cinel; Cameron Alexander,6,0,30,24
1656939543391,MATH 18,A02,083744,Cinel; Cameron Alexander,15,0,30,15
1656939543391,MATH 18,A03,083745,Cinel; Cameron Alexander,8,0,30,22
1656939543391,MATH 18,B01,083748,Rideout; David Porter,4,0,37,33
1656939543391,MATH 18,B02,083749,Rideout; David Porter,3,0,36,33
1656939543391,MATH 18,B03,083750,Rideout; David Porter,2,0,37,35
1656939543391,MATH 18,B04,083751,Rideout; David Porter,5,0,36,31
1656939543391,MATH 18,B05,093473,Rideout; David Porter,4,0,36,32
1656939543391,MATH 18,B06,093474,Rideout; David Porter,5,0,36,31
1656939549419,MATH 20A,A01,083754,Zheng; Zequn,12,0,40,28
1656939555443,MATH 20B,A01,083756,Briones; Jor-el Thomas Caparas,1,0,36,35
1656939555443,MATH 20B,A02,083757,Briones; Jor-el Thomas Caparas,1,0,36,35
1656939555443,MATH 20B,A03,093475,Briones; Jor-el Thomas Caparas,0,0,36,36
1656939561468,MATH 20C,A01,083760,Briones; Jor-el Thomas Caparas,1,0,35,34
1656939561468,MATH 20C,A02,083761,Briones; Jor-el Thomas Caparas,8,0,35,27
1656939561468,MATH 20C,A03,093476,Briones; Jor-el Thomas Caparas,0,1,36,36
1656939561468,MATH 20C,B01,083762,Bach; Quang Tran,0,0,30,30
1656939567492,MATH 20D,A01,083765,Tran; Brian Kha,4,0,30,26
1656939567492,MATH 20D,A02,083766,Tran; Brian Kha,4,0,30,26
1656939567492,MATH 20D,A03,083767,Tran; Brian Kha,3,0,30,27
1656939573523,MATH 20E,A01,083771,Ganguly; Soumya,5,0,32,27
1656939573523,MATH 20E,A02,083772,Ganguly; Soumya,6,0,32,26
1656939573523,MATH 20E,B01,083773,Ciotti; Benjamin,18,0,35,17
1656939573523,MATH 20E,B02,083774,Ciotti; Benjamin,17,0,35,18
1656939579549,MATH 103A,A01,083777,Greenfeld; Be'Eri,2,0,36,34
1656939579549,MATH 103A,A02,083778,Greenfeld; Be'Eri,5,0,36,31
1656939579549,MATH 103A,A03,093561,Greenfeld; Be'Eri,4,0,36,32
1656939579549,MATH 103A,B01,083779,Greenfeld; Be'Eri,6,0,36,30
1656939579549,MATH 103A,B02,083780,Greenfeld; Be'Eri,2,0,36,34
1656939579549,MATH 103A,B03,093562,Greenfeld; Be'Eri,2,0,36,34
1656939585576,MATH 105,A01,085443,Carter; Anne Toulson,13,0,35,22
1656939585576,MATH 105,A02,093477,Carter; Anne Toulson,20,0,35,15
1656939591601,MATH 109,A01,083213,Ganzberger; Geoffrey Michael,2,0,34,32
1656939591601,MATH 109,A02,083214,Ganzberger; Geoffrey Michael,2,0,34,32
1656939591601,MATH 109,A03,093478,Ganzberger; Geoffrey Michael,1,0,34,33
1656939591601,MATH 109,B01,083215,Ganzberger; Geoffrey Michael,1,0,32,31
1656939591601,MATH 109,B02,083216,Ganzberger; Geoffrey Michael,1,0,32,31
1656939591601,MATH 109,B03,093479,Ganzberger; Geoffrey Michael,6,0,32,26
1656939597634,MATH 142A,A01,083219,Chow; Bennett,6,0,32,26
1656939597634,MATH 142A,A02,083220,Chow; Bennett,10,0,32,22
1656939597634,MATH 142A,A03,093480,Chow; Bennett,7,0,32,25
1656939597634,MATH 142A,B03,093481,Chow; Bennett,7,0,32,25
1656939597634,MATH 142A,B04,093558,Chow; Bennett,11,0,32,21
1656939597634,MATH 142A,B05,093559,Chow; Bennett,6,0,32,26
1656939603661,MATH 193A,A01,083224,Rotar; Vladimir,7,0,34,27
1656939603661,MATH 193A,A02,083225,Rotar; Vladimir,3,0,34,31
1656939603661,MATH 193A,A03,083781,Rotar; Vladimir,1,0,34,33
1656939603661,MATH 193A,A04,083782,Rotar; Vladimir,6,0,34,28
1656939603661,MATH 193A,A05,093482,Rotar; Vladimir,6,0,34,28
1656939609685,MATH 197,001,091859,McAuley; Julian John,9999,0,9999,0
1656939609685,MATH 197,002,095566,Kedlaya; Kiran S.,9997,0,9999,2
1656939609685,MATH 197,003,095567,Xiao; Ming,9999,0,9999,0
1656939609685,MATH 197,004,095571,Perols; Johan Lars,9998,0,9999,1
1656939616753,COGS 9,A01,083615,Shannon; Kyle Michael,7,0,75,68
1656939622777,COGS 11,A01,083617,Boyle; Mary E. T.,19,0,48,29
1656939628801,COGS 13,A01,083071,Bastos; Amalia Pinkusfeld,9,0,71,62
1656939634825,COGS 14A,A01,092681,Semenuks; Arturs,0,1,100,100
1656939640848,COGS 14B,A01,083073,Cheng; Tzu-Han,5,0,63,58
1656939646878,COGS 17,A01,092677,Semenuks; Arturs,4,0,81,77
1656939652913,COGS 100,A01,083619,Allen; Michael Gordon,15,0,70,55
1656939658939,COGS 101A,A01,083621,Davis; Joshua Daniel,9,0,68,59
1656939664963,COGS 101B,A01,091572,Allen; Michael Gordon,8,0,65,57
1656939670988,COGS 101C,A01,083625,Delgado; Tania,17,0,35,18
1656939677011,COGS 107A,A01,083627,Boyle; Mary E. T.,13,0,60,47
1656939683034,COGS 118A,A01,083075,Gupta; Anjum,15,0,76,61
1656939689061,CSE 3,A50,083646,Miranda; Gregory Joseph,22,0,50,28
1656939695089,CSE 8A,A50,083650,Miranda; Gregory Joseph,17,1,56,39
1656939701114,CSE 11,A01,083080,Cao; Yingjun,4,15,40,36
1656939707145,CSE 12,A01,083652,Krause-Levy; Sophia Louisa,20,1,120,100
1656939713245,CSE 15L,A01,083654,Morris; Justin Loren,8,0,50,42
1656939713245,CSE 15L,A02,083655,Morris; Justin Loren,8,0,50,42
1656939719273,CSE 20,A01,083657,Tran; Khoa Dang,37,0,80,43
1656939725306,CSE 21,A01,095574,Bach; Quang Tran,21,0,48,27
1656939731338,CSE 30,A01,083084,Eldon; John,4,0,80,76
1656939731338,CSE 30,B01,095061,Bhaskar; Nishant,6,0,50,44
1656939737364,CSE 100,A01,083659,Cao; Yingjun,3,4,70,67
1656939743390,CSE 134B,A01,083661,Powell; Thomas Allan,19,0,100,81
1656939749420,CSE 140,A01,083663,Gungor; Onat,14,0,85,71
1656939755446,CSE 140L,A01,083088,Eldon; John,16,0,100,84
1656939761471,CSE 175,A01,083665,Kumar; Rakesh,3,0,25,22
1656939767496,CSE 190,A00,092507,Dubnov; Shlomo,7,0,20,13
1656939773521,ECE 45,A01,083139,Congero; Spencer William,5,0,75,70
1656939779546,ECE 65,A50,083695,Saad; Andrew S,12,0,30,18
1656939779546,ECE 65,A51,095125,Saad; Andrew S,25,0,26,1
1656939785575,ECE 109,A01,091882,Touri; Behrouz,16,0,70,54
1656939791603,ECE 180,A00,083140,Abi Samra; Nicholas Camill,0,0,30,30
1656939791603,ECE 180,B00,083141,Abi Samra; Nicholas Camill,0,0,30,30
1656939797631,MATH 10A,A01,083735,Patchell; Gregory David,1,0,30,29
1656939797631,MATH 10A,A02,083736,Patchell; Gregory David,20,0,30,10
1656939797631,MATH 10A,A03,083737,Patchell; Gregory David,15,0,30,15
1656939803661,MATH 10B,A01,083207,Lim; Seonhee,7,0,34,27
1656939803661,MATH 10B,A02,083208,Lim; Seonhee,9,0,35,26
1656939803661,MATH 10B,A03,093472,Lim; Seonhee,4,0,34,30
1656939803661,MATH 10B,B01,083739,Sinha; Shubham,9,0,30,21
1656939809690,MATH 18,A01,083743,Cinel; Cameron Alexander,6,0,30,24
1656939809690,MATH 18,A02,083744,Cinel; Cameron Alexander,15,0,30,15
1656939809690,MATH 18,A03,083745,Cinel; Cameron Alexander,8,0,30,22
1656939809690,MATH 18,B01,083748,Rideout; David Porter,4,0,37,33
1656939809690,MATH 18,B02,083749,Rideout; David Porter,3,0,36,33
1656939809690,MATH 18,B03,083750,Rideout; David Porter,2,0,37,35
1656939809690,MATH 18,B04,083751,Rideout; David Porter,5,0,36,31
1656939809690,MATH 18,B05,093473,Rideout; David Porter,4,0,36,32
1656939809690,MATH 18,B06,093474,Rideout; David Porter,5,0,36,31
1656939815717,MATH 20A,A01,083754,Zheng; Zequn,12,0,40,28
1656939821742,MATH 20B,A01,083756,Briones; Jor-el Thomas Caparas,1,0,36,35
1656939821742,MATH 20B,A02,083757,Briones; Jor-el Thomas Caparas,1,0,36,35
1656939821742,MATH 20B,A03,093475,Briones; Jor-el Thomas Caparas,0,0,36,36
1656939827767,MATH 20C,A01,083760,Briones; Jor-el Thomas Caparas,1,0,35,34
1656939827767,MATH 20C,A02,083761,Briones; Jor-el Thomas Caparas,8,0,35,27
1656939827767,MATH 20C,A03,093476,Briones; Jor-el Thomas Caparas,0,1,36,36
1656939827767,MATH 20C,B01,083762,Bach; Quang Tran,0,0,30,30
1656939833793,MATH 20D,A01,083765,Tran; Brian Kha,4,0,30,26
1656939833793,MATH 20D,A02,083766,Tran; Brian Kha,4,0,30,26
1656939833793,MATH 20D,A03,083767,Tran; Brian Kha,3,0,30,27
1656939839826,MATH 20E,A01,083771,Ganguly; Soumya,5,0,32,27
1656939839826,MATH 20E,A02,083772,Ganguly; Soumya,6,0,32,26
1656939839826,MATH 20E,B01,083773,Ciotti; Benjamin,18,0,35,17
1656939839826,MATH 20E,B02,083774,Ciotti; Benjamin,17,0,35,18
1656939845860,MATH 103A,A01,083777,Greenfeld; Be'Eri,2,0,36,34
1656939845860,MATH 103A,A02,083778,Greenfeld; Be'Eri,5,0,36,31
1656939845860,MATH 103A,A03,093561,Greenfeld; Be'Eri,4,0,36,32
1656939845860,MATH 103A,B01,083779,Greenfeld; Be'Eri,6,0,36,30
1656939845860,MATH 103A,B02,083780,Greenfeld; Be'Eri,2,0,36,34
1656939845860,MATH 103A,B03,093562,Greenfeld; Be'Eri,2,0,36,34
1656939851885,MATH 105,A01,085443,Carter; Anne Toulson,13,0,35,22
1656939851885,MATH 105,A02,093477,Carter; Anne Toulson,20,0,35,15
1656939857909,MATH 109,A01,083213,Ganzberger; Geoffrey Michael,2,0,34,32
1656939857909,MATH 109,A02,083214,Ganzberger; Geoffrey Michael,2,0,34,32
1656939857909,MATH 109,A03,093478,Ganzberger; Geoffrey Michael,1,0,34,33
1656939857909,MATH 109,B01,083215,Ganzberger; Geoffrey Michael,1,0,32,31
1656939857909,MATH 109,B02,083216,Ganzberger; Geoffrey Michael,1,0,32,31
1656939857909,MATH 109,B03,093479,Ganzberger; Geoffrey Michael,6,0,32,26
1656939863944,MATH 142A,A01,083219,Chow; Bennett,6,0,32,26
1656939863944,MATH 142A,A02,083220,Chow; Bennett,10,0,32,22
1656939863944,MATH 142A,A03,093480,Chow; Bennett,7,0,32,25
1656939863944,MATH 142A,B03,093481,Chow; Bennett,7,0,32,25
1656939863944,MATH 142A,B04,093558,Chow; Bennett,11,0,32,21
1656939863944,MATH 142A,B05,093559,Chow; Bennett,6,0,32,26
1656939869968,MATH 193A,A01,083224,Rotar; Vladimir,7,0,34,27
1656939869968,MATH 193A,A02,083225,Rotar; Vladimir,3,0,34,31
1656939869968,MATH 193A,A03,083781,Rotar; Vladimir,1,0,34,33
1656939869968,MATH 193A,A04,083782,Rotar; Vladimir,6,0,34,28
1656939869968,MATH 193A,A05,093482,Rotar; Vladimir,6,0,34,28
1656939876002,MATH 197,001,091859,McAuley; Julian John,9999,0,9999,0
1656939876002,MATH 197,002,095566,Kedlaya; Kiran S.,9997,0,9999,2
1656939876002,MATH 197,003,095567,Xiao; Ming,9999,0,9999,0
1656939876002,MATH 197,004,095571,Perols; Johan Lars,9998,0,9999,1
1656939883089,COGS 9,A01,083615,Shannon; Kyle Michael,7,0,75,68
1656939889119,COGS 11,A01,083617,Boyle; Mary E. T.,19,0,48,29
1656939895149,COGS 13,A01,083071,Bastos; Amalia Pinkusfeld,9,0,71,62
1656939901174,COGS 14A,A01,092681,Semenuks; Arturs,0,1,100,100
1656939907197,COGS 14B,A01,083073,Cheng; Tzu-Han,5,0,63,58
1656939913225,COGS 17,A01,092677,Semenuks; Arturs,4,0,81,77
1656939919249,COGS 100,A01,083619,Allen; Michael Gordon,15,0,70,55
1656939925273,COGS 101A,A01,083621,Davis; Joshua Daniel,9,0,68,59
1656939931302,COGS 101B,A01,091572,Allen; Michael Gordon,8,0,65,57
1656939937325,COGS 101C,A01,083625,Delgado; Tania,17,0,35,18
1656939943350,COGS 107A,A01,083627,Boyle; Mary E. T.,13,0,60,47
1656939949379,COGS 118A,A01,083075,Gupta; Anjum,15,0,76,61
1656939955410,CSE 3,A50,083646,Miranda; Gregory Joseph,22,0,50,28
1656939961438,CSE 8A,A50,083650,Miranda; Gregory Joseph,17,1,56,39
1656939967463,CSE 11,A01,083080,Cao; Yingjun,4,15,40,36
1656939973488,CSE 12,A01,083652,Krause-Levy; Sophia Louisa,20,1,120,100
1656939979511,CSE 15L,A01,083654,Morris; Justin Loren,8,0,50,42
1656939979511,CSE 15L,A02,083655,Morris; Justin Loren,8,0,50,42
1656939985543,CSE 20,A01,083657,Tran; Khoa Dang,37,0,80,43
1656939991571,CSE 21,A01,095574,Bach; Quang Tran,21,0,48,27
1656939997597,CSE 30,A01,083084,Eldon; John,4,0,80,76
1656939997597,CSE 30,B01,095061,Bhaskar; Nishant,6,0,50,44
1656940003624,CSE 100,A01,083659,Cao; Yingjun,3,4,70,67
1656940009648,CSE 134B,A01,083661,Powell; Thomas Allan,19,0,100,81
1656940015677,CSE 140,A01,083663,Gungor; Onat,14,0,85,71
1656940021705,CSE 140L,A01,083088,Eldon; John,16,0,100,84
1656940027729,CSE 175,A01,083665,Kumar; Rakesh,3,0,25,22
1656940033752,CSE 190,A00,092507,Dubnov; Shlomo,7,0,20,13
1656940039779,ECE 45,A01,083139,Congero; Spencer William,5,0,75,70
1656940045807,ECE 65,A50,083695,Saad; Andrew S,12,0,30,18
1656940045807,ECE 65,A51,095125,Saad; Andrew S,25,0,26,1
1656940051834,ECE 109,A01,091882,Touri; Behrouz,16,0,70,54
1656940057856,ECE 180,A00,083140,Abi Samra; Nicholas Camill,0,0,30,30
1656940057856,ECE 180,B00,083141,Abi Samra; Nicholas Camill,0,0,30,30
1656940063881,MATH 10A,A01,083735,Patchell; Gregory David,1,0,30,29
1656940063881,MATH 10A,A02,083736,Patchell; Gregory David,20,0,30,10
1656940063881,MATH 10A,A03,083737,Patchell; Gregory David,15,0,30,15
1656940069908,MATH 10B,A01,083207,Lim; Seonhee,7,0,34,27
1656940069908,MATH 10B,A02,083208,Lim; Seonhee,9,0,35,26
1656940069908,MATH 10B,A03,093472,Lim; Seonhee,4,0,34,30
1656940069908,MATH 10B,B01,083739,Sinha; Shubham,9,0,30,21
1656940075942,MATH 18,A01,083743,Cinel; Cameron Alexander,6,0,30,24
1656940075942,MATH 18,A02,083744,Cinel; Cameron Alexander,15,0,30,15
1656940075942,MATH 18,A03,083745,Cinel; Cameron Alexander,8,0,30,22
1656940075942,MATH 18,B01,083748,Rideout; David Porter,4,0,37,33
1656940075942,MATH 18,B02,083749,Rideout; David Porter,3,0,36,33
1656940075942,MATH 18,B03,083750,Rideout; David Porter,2,0,37,35
1656940075942,MATH 18,B04,083751,Rideout; David Porter,5,0,36,31
1656940075942,MATH 18,B05,093473,Rideout; David Porter,4,0,36,32
1656940075942,MATH 18,B06,093474,Rideout; David Porter,5,0,36,31
1656940081972,MATH 20A,A01,083754,Zheng; Zequn,12,0,40,28
1656940087998,MATH 20B,A01,083756,Briones; Jor-el Thomas Caparas,1,0,36,35
1656940087998,MATH 20B,A02,083757,Briones; Jor-el Thomas Caparas,1,0,36,35
1656940087998,MATH 20B,A03,093475,Briones; Jor-el Thomas Caparas,0,0,36,36
1656940094023,MATH 20C,A01,083760,Briones; Jor-el Thomas Caparas,1,0,35,34
1656940094023,MATH 20C,A02,083761,Briones; Jor-el Thomas Caparas,8,0,35,27
1656940094023,MATH 20C,A03,093476,Briones; Jor-el Thomas Caparas,0,1,36,36
1656940094023,MATH 20C,B01,083762,Bach; Quang Tran,0,0,30,30
1656940100053,MATH 20D,A01,083765,Tran; Brian Kha,4,0,30,26
1656940100053,MATH 20D,A02,083766,Tran; Brian Kha,4,0,30,26
1656940100053,MATH 20D,A03,083767,Tran; Brian Kha,3,0,30,27
1656940106079,MATH 20E,A01,083771,Ganguly; Soumya,5,0,32,27
1656940106079,MATH 20E,A02,083772,Ganguly; Soumya,6,0,32,26
1656940106079,MATH 20E,B01,083773,Ciotti; Benjamin,18,0,35,17
1656940106079,MATH 20E,B02,083774,Ciotti; Benjamin,17,0,35,18
1656940112105,MATH 103A,A01,083777,Greenfeld; Be'Eri,2,0,36,34
1656940112105,MATH 103A,A02,083778,Greenfeld; Be'Eri,5,0,36,31
1656940112105,MATH 103A,A03,093561,Greenfeld; Be'Eri,4,0,36,32
1656940112105,MATH 103A,B01,083779,Greenfeld; Be'Eri,6,0,36,30
1656940112105,MATH 103A,B02,083780,Greenfeld; Be'Eri,2,0,36,34
1656940112105,MATH 103A,B03,093562,Greenfeld; Be'Eri,2,0,36,34
1656940118130,MATH 105,A01,085443,Carter; Anne Toulson,13,0,35,22
1656940118130,MATH 105,A02,093477,Carter; Anne Toulson,20,0,35,15
1656940124156,MATH 109,A01,083213,Ganzberger; Geoffrey Michael,2,0,34,32
1656940124156,MATH 109,A02,083214,Ganzberger; Geoffrey Michael,2,0,34,32
1656940124156,MATH 109,A03,093478,Ganzberger; Geoffrey Michael,1,0,34,33
1656940124156,MATH 109,B01,083215,Ganzberger; Geoffrey Michael,1,0,32,31
1656940124156,MATH 109,B02,083216,Ganzberger; Geoffrey Michael,1,0,32,31
1656940124156,MATH 109,B03,093479,Ganzberger; Geoffrey Michael,6,0,32,26
1656940130187,MATH 142A,A01,083219,Chow; Bennett,6,0,32,26
1656940130187,MATH 142A,A02,083220,Chow; Bennett,10,0,32,22
1656940130187,MATH 142A,A03,093480,Chow; Bennett,7,0,32,25
1656940130187,MATH 142A,B03,093481,Chow; Bennett,7,0,32,25
1656940130187,MATH 142A,B04,093558,Chow; Bennett,11,0,32,21
1656940130187,MATH 142A,B05,093559,Chow; Bennett,6,0,32,26
1656940136211,MATH 193A,A01,083224,Rotar; Vladimir,7,0,34,27
1656940136211,MATH 193A,A02,083225,Rotar; Vladimir,3,0,34,31
1656940136211,MATH 193A,A03,083781,Rotar; Vladimir,1,0,34,33
1656940136211,MATH 193A,A04,083782,Rotar; Vladimir,6,0,34,28
1656940136211,MATH 193A,A05,093482,Rotar; Vladimir,6,0,34,28
1656940142241,MATH 197,001,091859,McAuley; Julian John,9999,0,9999,0
1656940142241,MATH 197,002,095566,Kedlaya; Kiran S.,9997,0,9999,2
1656940142241,MATH 197,003,095567,Xiao; Ming,9999,0,9999,0
1656940142241,MATH 197,004,095571,Perols; Johan Lars,9998,0,9999,1
1656940149312,COGS 9,A01,083615,Shannon; Kyle Michael,7,0,75,68
1656940155336,COGS 11,A01,083617,Boyle; Mary E. T.,19,0,48,29
1656940161370,COGS 13,A01,083071,Bastos; Amalia Pinkusfeld,9,0,71,62
1656940167394,COGS 14A,A01,092681,Semenuks; Arturs,0,1,100,100
1656940173417,COGS 14B,A01,083073,Cheng; Tzu-Han,5,0,63,58
1656940179440,COGS 17,A01,092677,Semenuks; Arturs,4,0,81,77
1656940185469,COGS 100,A01,083619,Allen; Michael Gordon,15,0,70,55
1656940191494,COGS 101A,A01,083621,Davis; Joshua Daniel,9,0,68,59
1656940197526,COGS 101B,A01,091572,Allen; Michael Gordon,8,0,65,57
1656940203550,COGS 101C,A01,083625,Delgado; Tania,17,0,35,18
1656940209580,COGS 107A,A01,083627,Boyle; Mary E. T.,13,0,60,47
1656940215603,COGS 118A,A01,083075,Gupta; Anjum,15,0,76,61
1656940221631,CSE 3,A50,083646,Miranda; Gregory Joseph,22,0,50,28
1656940227656,CSE 8A,A50,083650,Miranda; Gregory Joseph,17,1,56,39
1656940233680,CSE 11,A01,083080,Cao; Yingjun,4,15,40,36
1656940239705,CSE 12,A01,083652,Krause-Levy; Sophia Louisa,20,1,120,100
1656940245732,CSE 15L,A01,083654,Morris; Justin Loren,8,0,50,42
1656940245732,CSE 15L,A02,083655,Morris; Justin Loren,8,0,50,42
1656940251761,CSE 20,A01,083657,Tran; Khoa Dang,37,0,80,43
1656940257789,CSE 21,A01,095574,Bach; Quang Tran,21,0,48,27
1656940263818,CSE 30,A01,083084,Eldon; John,4,0,80,76
1656940263818,CSE 30,B01,095061,Bhaskar; Nishant,6,0,50,44
1656940269842,CSE 100,A01,083659,Cao; Yingjun,3,4,70,67
1656940275871,CSE 134B,A01,083661,Powell; Thomas Allan,19,0,100,81
1656940281895,CSE 140,A01,083663,Gungor; Onat,14,0,85,71
1656940287924,CSE 140L,A01,083088,Eldon; John,16,0,100,84
1656940293965,CSE 175,A01,083665,Kumar; Rakesh,3,0,25,22
1656940299992,CSE 190,A00,092507,Dubnov; Shlomo,7,0,20,13
1656940306024,ECE 45,A01,083139,Congero; Spencer William,5,0,75,70
1656940312125,ECE 65,A50,083695,Saad; Andrew S,12,0,30,18
1656940312125,ECE 65,A51,095125,Saad; Andrew S,25,0,26,1
1656940318153,ECE 109,A01,091882,Touri; Behrouz,16,0,70,54
1656940324183,ECE 180,A00,083140,Abi Samra; Nicholas Camill,0,0,30,30
1656940324183,ECE 180,B00,083141,Abi Samra; Nicholas Camill,0,0,30,30
1656940330210,MATH 10A,A01,083735,Patchell; Gregory David,1,0,30,29
1656940330210,MATH 10A,A02,083736,Patchell; Gregory David,20,0,30,10
1656940330210,MATH 10A,A03,083737,Patchell; Gregory David,15,0,30,15
1656940336246,MATH 10B,A01,083207,Lim; Seonhee,7,0,34,27
1656940336246,MATH 10B,A02,083208,Lim; Seonhee,9,0,35,26
1656940336246,MATH 10B,A03,093472,Lim; Seonhee,4,0,34,30
1656940336246,MATH 10B,B01,083739,Sinha; Shubham,9,0,30,21
1656940342299,MATH 18,A01,083743,Cinel; Cameron Alexander,6,0,30,24
1656940342299,MATH 18,A02,083744,Cinel; Cameron Alexander,15,0,30,15
1656940342299,MATH 18,A03,083745,Cinel; Cameron Alexander,8,0,30,22
1656940342299,MATH 18,B01,083748,Rideout; David Porter,4,0,37,33
1656940342299,MATH 18,B02,083749,Rideout; David Porter,3,0,36,33
1656940342299,MATH 18,B03,083750,Rideout; David Porter,2,0,37,35
1656940342299,MATH 18,B04,083751,Rideout; David Porter,5,0,36,31
1656940342299,MATH 18,B05,093473,Rideout; David Porter,4,0,36,32
1656940342299,MATH 18,B06,093474,Rideout; David Porter,5,0,36,31
1656940348325,MATH 20A,A01,083754,Zheng; Zequn,12,0,40,28
1656940354361,MATH 20B,A01,083756,Briones; Jor-el Thomas Caparas,1,0,36,35
1656940354361,MATH 20B,A02,083757,Briones; Jor-el Thomas Caparas,1,0,36,35
1656940354361,MATH 20B,A03,093475,Briones; Jor-el Thomas Caparas,0,0,36,36
1656940360392,MATH 20C,A01,083760,Briones; Jor-el Thomas Caparas,1,0,35,34
1656940360392,MATH 20C,A02,083761,Briones; Jor-el Thomas Caparas,8,0,35,27
1656940360392,MATH 20C,A03,093476,Briones; Jor-el Thomas Caparas,0,1,36,36
1656940360392,MATH 20C,B01,083762,Bach; Quang Tran,0,0,30,30
1656940366418,MATH 20D,A01,083765,Tran; Brian Kha,4,0,30,26
1656940366418,MATH 20D,A02,083766,Tran; Brian Kha,4,0,30,26
1656940366418,MATH 20D,A03,083767,Tran; Brian Kha,3,0,30,27
1656940372446,MATH 20E,A01,083771,Ganguly; Soumya,5,0,32,27
1656940372446,MATH 20E,A02,083772,Ganguly; Soumya,6,0,32,26
1656940372446,MATH 20E,B01,083773,Ciotti; Benjamin,18,0,35,17
1656940372446,MATH 20E,B02,083774,Ciotti; Benjamin,17,0,35,18
1656940378472,MATH 103A,A01,083777,Greenfeld; Be'Eri,2,0,36,34
1656940378472,MATH 103A,A02,083778,Greenfeld; Be'Eri,5,0,36,31
1656940378472,MATH 103A,A03,093561,Greenfeld; Be'Eri,4,0,36,32
1656940378472,MATH 103A,B01,083779,Greenfeld; Be'Eri,6,0,36,30
1656940378472,MATH 103A,B02,083780,Greenfeld; Be'Eri,2,0,36,34
1656940378472,MATH 103A,B03,093562,Greenfeld; Be'Eri,2,0,36,34
1656940384498,MATH 105,A01,085443,Carter; Anne Toulson,13,0,35,22
1656940384498,MATH 105,A02,093477,Carter; Anne Toulson,20,0,35,15
1656940390522,MATH 109,A01,083213,Ganzberger; Geoffrey Michael,2,0,34,32
1656940390522,MATH 109,A02,083214,Ganzberger; Geoffrey Michael,2,0,34,32
1656940390522,MATH 109,A03,093478,Ganzberger; Geoffrey Michael,1,0,34,33
1656940390522,MATH 109,B01,083215,Ganzberger; Geoffrey Michael,1,0,32,31
1656940390522,MATH 109,B02,083216,Ganzberger; Geoffrey Michael,1,0,32,31
1656940390522,MATH 109,B03,093479,Ganzberger; Geoffrey Michael,6,0,32,26
1656940396552,MATH 142A,A01,083219,Chow; Bennett,6,0,32,26
1656940396552,MATH 142A,A02,083220,Chow; Bennett,10,0,32,22
1656940396552,MATH 142A,A03,093480,Chow; Bennett,7,0,32,25
1656940396552,MATH 142A,B03,093481,Chow; Bennett,7,0,32,25
1656940396552,MATH 142A,B04,093558,Chow; Bennett,11,0,32,21
1656940396552,MATH 142A,B05,093559,Chow; Bennett,6,0,32,26
1656940402577,MATH 193A,A01,083224,Rotar; Vladimir,7,0,34,27
1656940402577,MATH 193A,A02,083225,Rotar; Vladimir,3,0,34,31
1656940402577,MATH 193A,A03,083781,Rotar; Vladimir,1,0,34,33
1656940402577,MATH 193A,A04,083782,Rotar; Vladimir,6,0,34,28
1656940402577,MATH 193A,A05,093482,Rotar; Vladimir,6,0,34,28
1656940408605,MATH 197,001,091859,McAuley; Julian John,9999,0,9999,0
1656940408605,MATH 197,002,095566,Kedlaya; Kiran S.,9997,0,9999,2
1656940408605,MATH 197,003,095567,Xiao; Ming,9999,0,9999,0
1656940408605,MATH 197,004,095571,Perols; Johan Lars,9998,0,9999,1
1656940415679,COGS 9,A01,083615,Shannon; Kyle Michael,7,0,75,68
1656940421714,COGS 11,A01,083617,Boyle; Mary E. T.,19,0,48,29
1656940427739,COGS 13,A01,083071,Bastos; Amalia Pinkusfeld,9,0,71,62
1656940433765,COGS 14A,A01,092681,Semenuks; Arturs,0,1,100,100
1656940439790,COGS 14B,A01,083073,Cheng; Tzu-Han,5,0,63,58
1656940445817,COGS 17,A01,092677,Semenuks; Arturs,4,0,81,77
1656940451844,COGS 100,A01,083619,Allen; Michael Gordon,15,0,70,55
1656940457869,COGS 101A,A01,083621,Davis; Joshua Daniel,9,0,68,59
1656940463895,COGS 101B,A01,091572,Allen; Michael Gordon,8,0,65,57
1656940469921,COGS 101C,A01,083625,Delgado; Tania,17,0,35,18
1656940475947,COGS 107A,A01,083627,Boyle; Mary E. T.,13,0,60,47
1656940481972,COGS 118A,A01,083075,Gupta; Anjum,15,0,76,61
1656940487999,CSE 3,A50,083646,Miranda; Gregory Joseph,22,0,50,28
1656940494028,CSE 8A,A50,083650,Miranda; Gregory Joseph,17,1,56,39
1656940500051,CSE 11,A01,083080,Cao; Yingjun,4,15,40,36
1656940506081,CSE 12,A01,083652,Krause-Levy; Sophia Louisa,20,1,120,100
1656940512116,CSE 15L,A01,083654,Morris; Justin Loren,8,0,50,42
1656940512116,CSE 15L,A02,083655,Morris; Justin Loren,8,0,50,42
1656940518144,CSE 20,A01,083657,Tran; Khoa Dang,37,0,80,43
1656940524171,CSE 21,A01,095574,Bach; Quang Tran,21,0,48,27
1656940530203,CSE 30,A01,083084,Eldon; John,4,0,80,76
1656940530203,CSE 30,B01,095061,Bhaskar; Nishant,6,0,50,44
1656940536229,CSE 100,A01,083659,Cao; Yingjun,3,4,70,67
1656940542253,CSE 134B,A01,083661,Powell; Thomas Allan,19,0,100,81
1656940548279,CSE 140,A01,083663,Gungor; Onat,14,0,85,71
1656940554308,CSE 140L,A01,083088,Eldon; John,16,0,100,84
1656940560337,CSE 175,A01,083665,Kumar; Rakesh,3,0,25,22
1656940566363,CSE 190,A00,092507,Dubnov; Shlomo,7,0,20,13
1656940572388,ECE 45,A01,083139,Congero; Spencer William,5,0,75,70
1656940578418,ECE 65,A50,083695,Saad; Andrew S,12,0,30,18
1656940578418,ECE 65,A51,095125,Saad; Andrew S,25,0,26,1
1656940584447,ECE 109,A01,091882,Touri; Behrouz,16,0,70,54
1656940590472,ECE 180,A00,083140,Abi Samra; Nicholas Camill,0,0,30,30
1656940590472,ECE 180,B00,083141,Abi Samra; Nicholas Camill,0,0,30,30
1656940596496,MATH 10A,A01,083735,Patchell; Gregory David,1,0,30,29
1656940596496,MATH 10A,A02,083736,Patchell; Gregory David,20,0,30,10
1656940596496,MATH 10A,A03,083737,Patchell; Gregory David,15,0,30,15
1656940602527,MATH 10B,A01,083207,Lim; Seonhee,7,0,34,27
1656940602527,MATH 10B,A02,083208,Lim; Seonhee,9,0,35,26
1656940602527,MATH 10B,A03,093472,Lim; Seonhee,4,0,34,30
1656940602527,MATH 10B,B01,083739,Sinha; Shubham,9,0,30,21
1656940608562,MATH 18,A01,083743,Cinel; Cameron Alexander,6,0,30,24
1656940608562,MATH 18,A02,083744,Cinel; Cameron Alexander,15,0,30,15
1656940608562,MATH 18,A03,083745,Cinel; Cameron Alexander,8,0,30,22
1656940608562,MATH 18,B01,083748,Rideout; David Porter,4,0,37,33
1656940608562,MATH 18,B02,083749,Rideout; David Porter,3,0,36,33
1656940608562,MATH 18,B03,083750,Rideout; David Porter,2,0,37,35
1656940608562,MATH 18,B04,083751,Rideout; David Porter,5,0,36,31
1656940608562,MATH 18,B05,093473,Rideout; David Porter,4,0,36,32
1656940608562,MATH 18,B06,093474,Rideout; David Porter,5,0,36,31
1656940614591,MATH 20A,A01,083754,Zheng; Zequn,12,0,40,28
1656940620616,MATH 20B,A01,083756,Briones; Jor-el Thomas Caparas,1,0,36,35
1656940620616,MATH 20B,A02,083757,Briones; Jor-el Thomas Caparas,1,0,36,35
1656940620616,MATH 20B,A03,093475,Briones; Jor-el Thomas Caparas,0,0,36,36
1656940626647,MATH 20C,A01,083760,Briones; Jor-el Thomas Caparas,1,0,35,34
1656940626647,MATH 20C,A02,083761,Briones; Jor-el Thomas Caparas,8,0,35,27
1656940626647,MATH 20C,A03,093476,Briones; Jor-el Thomas Caparas,0,1,36,36
1656940626647,MATH 20C,B01,083762,Bach; Quang Tran,0,0,30,30
1656940632671,MATH 20D,A01,083765,Tran; Brian Kha,4,0,30,26
1656940632671,MATH 20D,A02,083766,Tran; Brian Kha,4,0,30,26
1656940632671,MATH 20D,A03,083767,Tran; Brian Kha,3,0,30,27
1656940638704,MATH 20E,A01,083771,Ganguly; Soumya,5,0,32,27
1656940638704,MATH 20E,A02,083772,Ganguly; Soumya,6,0,32,26
1656940638704,MATH 20E,B01,083773,Ciotti; Benjamin,18,0,35,17
1656940638704,MATH 20E,B02,083774,Ciotti; Benjamin,17,0,35,18
1656940644731,MATH 103A,A01,083777,Greenfeld; Be'Eri,2,0,36,34
1656940644731,MATH 103A,A02,083778,Greenfeld; Be'Eri,5,0,36,31
1656940644731,MATH 103A,A03,093561,Greenfeld; Be'Eri,4,0,36,32
1656940644731,MATH 103A,B01,083779,Greenfeld; Be'Eri,6,0,36,30
1656940644731,MATH 103A,B02,083780,Greenfeld; Be'Eri,2,0,36,34
1656940644731,MATH 103A,B03,093562,Greenfeld; Be'Eri,2,0,36,34
1656940650762,MATH 105,A01,085443,Carter; Anne Toulson,13,0,35,22
1656940650762,MATH 105,A02,093477,Carter; Anne Toulson,20,0,35,15
1656940656789,MATH 109,A01,083213,Ganzberger; Geoffrey Michael,2,0,34,32
1656940656789,MATH 109,A02,083214,Ganzberger; Geoffrey Michael,2,0,34,32
1656940656789,MATH 109,A03,093478,Ganzberger; Geoffrey Michael,1,0,34,33
1656940656789,MATH 109,B01,083215,Ganzberger; Geoffrey Michael,1,0,32,31
1656940656789,MATH 109,B02,083216,Ganzberger; Geoffrey Michael,1,0,32,31
1656940656789,MATH 109,B03,093479,Ganzberger; Geoffrey Michael,6,0,32,26
1656940662831,MATH 142A,A01,083219,Chow; Bennett,6,0,32,26
1656940662831,MATH 142A,A02,083220,Chow; Bennett,10,0,32,22
1656940662831,MATH 142A,A03,093480,Chow; Bennett,7,0,32,25
1656940662831,MATH 142A,B03,093481,Chow; Bennett,7,0,32,25
1656940662831,MATH 142A,B04,093558,Chow; Bennett,11,0,32,21
1656940662831,MATH 142A,B05,093559,Chow; Bennett,6,0,32,26
1656940668859,MATH 193A,A01,083224,Rotar; Vladimir,7,0,34,27
1656940668859,MATH 193A,A02,083225,Rotar; Vladimir,3,0,34,31
1656940668859,MATH 193A,A03,083781,Rotar; Vladimir,1,0,34,33
1656940668859,MATH 193A,A04,083782,Rotar; Vladimir,6,0,34,28
1656940668859,MATH 193A,A05,093482,Rotar; Vladimir,6,0,34,28
1656940674892,MATH 197,001,091859,McAuley; Julian John,9999,0,9999,0
1656940674892,MATH 197,002,095566,Kedlaya; Kiran S.,9997,0,9999,2
1656940674892,MATH 197,003,095567,Xiao; Ming,9999,0,9999,0
1656940674892,MATH 197,004,095571,Perols; Johan Lars,9998,0,9999,1
1656940681965,COGS 9,A01,083615,Shannon; Kyle Michael,7,0,75,68
1656940687989,COGS 11,A01,083617,Boyle; Mary E. T.,19,0,48,29
1656940694021,COGS 13,A01,083071,Bastos; Amalia Pinkusfeld,9,0,71,62
1656940700043,COGS 14A,A01,092681,Semenuks; Arturs,0,1,100,100
1656940706071,COGS 14B,A01,083073,Cheng; Tzu-Han,5,0,63,58
1656940712099,COGS 17,A01,092677,Semenuks; Arturs,4,0,81,77
1656940718125,COGS 100,A01,083619,Allen; Michael Gordon,15,0,70,55
1656940724150,COGS 101A,A01,083621,Davis; Joshua Daniel,9,0,68,59
1656940730176,COGS 101B,A01,091572,Allen; Michael Gordon,8,0,65,57
1656940736204,COGS 101C,A01,083625,Delgado; Tania,17,0,35,18
1656940742228,COGS 107A,A01,083627,Boyle; Mary E. T.,13,0,60,47
1656940748255,COGS 118A,A01,083075,Gupta; Anjum,15,0,76,61
1656940754287,CSE 3,A50,083646,Miranda; Gregory Joseph,22,0,50,28
1656940760315,CSE 8A,A50,083650,Miranda; Gregory Joseph,17,1,56,39
1656940766343,CSE 11,A01,083080,Cao; Yingjun,4,15,40,36
1656940772369,CSE 12,A01,083652,Krause-Levy; Sophia Louisa,20,1,120,100
1656940778404,CSE 15L,A01,083654,Morris; Justin Loren,8,0,50,42
1656940778404,CSE 15L,A02,083655,Morris; Justin Loren,8,0,50,42
1656940784427,CSE 20,A01,083657,Tran; Khoa Dang,37,0,80,43
1656940790455,CSE 21,A01,095574,Bach; Quang Tran,21,0,48,27
1656940796487,CSE 30,A01,083084,Eldon; John,4,0,80,76
1656940796487,CSE 30,B01,095061,Bhaskar; Nishant,6,0,50,44
1656940802513,CSE 100,A01,083659,Cao; Yingjun,3,4,70,67
1656940808538,CSE 134B,A01,083661,Powell; Thomas Allan,19,0,100,81
1656940814566,CSE 140,A01,083663,Gungor; Onat,14,0,85,71
1656940820593,CSE 140L,A01,083088,Eldon; John,16,0,100,84
1656940826617,CSE 175,A01,083665,Kumar; Rakesh,3,0,25,22
1656940832644,CSE 190,A00,092507,Dubnov; Shlomo,7,0,20,13
1656940838673,ECE 45,A01,083139,Congero; Spencer William,5,0,75,70
1656940844707,ECE 65,A50,083695,Saad; Andrew S,12,0,30,18
1656940844707,ECE 65,A51,095125,Saad; Andrew S,25,0,26,1
1656940850732,ECE 109,A01,091882,Touri; Behrouz,16,0,70,54
1656940856761,ECE 180,A00,083140,Abi Samra; Nicholas Camill,0,0,30,30
1656940856761,ECE 180,B00,083141,Abi Samra; Nicholas Camill,0,0,30,30
1656940862794,MATH 10A,A01,083735,Patchell; Gregory David,1,0,30,29
1656940862794,MATH 10A,A02,083736,Patchell; Gregory David,20,0,30,10
1656940862794,MATH 10A,A03,083737,Patchell; Gregory David,15,0,30,15
1656940868826,MATH 10B,A01,083207,Lim; Seonhee,7,0,34,27
1656940868826,MATH 10B,A02,083208,Lim; Seonhee,9,0,35,26
1656940868826,MATH 10B,A03,093472,Lim; Seonhee,4,0,34,30
1656940868826,MATH 10B,B01,083739,Sinha; Shubham,9,0,30,21
1656940874854,MATH 18,A01,083743,Cinel; Cameron Alexander,6,0,30,24
1656940874854,MATH 18,A02,083744,Cinel; Cameron Alexander,15,0,30,15
1656940874854,MATH 18,A03,083745,Cinel; Cameron Alexander,8,0,30,22
1656940874854,MATH 18,B01,083748,Rideout; David Porter,4,0,37,33
1656940874854,MATH 18,B02,083749,Rideout; David Porter,3,0,36,33
1656940874854,MATH 18,B03,083750,Rideout; David Porter,2,0,37,35
1656940874854,MATH 18,B04,083751,Rideout; David Porter,5,0,36,31
1656940874854,MATH 18,B05,093473,Rideout; David Porter,4,0,36,32
1656940874854,MATH 18,B06,093474,Rideout; David Porter,5,0,36,31
1656940880885,MATH 20A,A01,083754,Zheng; Zequn,12,0,40,28
1656940886907,MATH 20B,A01,083756,Briones; Jor-el Thomas Caparas,1,0,36,35
1656940886907,MATH 20B,A02,083757,Briones; Jor-el Thomas Caparas,1,0,36,35
1656940886907,MATH 20B,A03,093475,Briones; Jor-el Thomas Caparas,0,0,36,36
1656940892933,MATH 20C,A01,083760,Briones; Jor-el Thomas Caparas,1,0,35,34
1656940892933,MATH 20C,A02,083761,Briones; Jor-el Thomas Caparas,8,0,35,27
1656940892933,MATH 20C,A03,093476,Briones; Jor-el Thomas Caparas,0,1,36,36
1656940892933,MATH 20C,B01,083762,Bach; Quang Tran,0,0,30,30
1656940898959,MATH 20D,A01,083765,Tran; Brian Kha,4,0,30,26
1656940898959,MATH 20D,A02,083766,Tran; Brian Kha,4,0,30,26
1656940898959,MATH 20D,A03,083767,Tran; Brian Kha,3,0,30,27
1656940904991,MATH 20E,A01,083771,Ganguly; Soumya,5,0,32,27
1656940904991,MATH 20E,A02,083772,Ganguly; Soumya,6,0,32,26
1656940904991,MATH 20E,B01,083773,Ciotti; Benjamin,18,0,35,17
1656940904991,MATH 20E,B02,083774,Ciotti; Benjamin,17,0,35,18
1656940911105,MATH 103A,A01,083777,Greenfeld; Be'Eri,2,0,36,34
1656940911105,MATH 103A,A02,083778,Greenfeld; Be'Eri,5,0,36,31
1656940911105,MATH 103A,A03,093561,Greenfeld; Be'Eri,4,0,36,32
1656940911105,MATH 103A,B01,083779,Greenfeld; Be'Eri,6,0,36,30
1656940911105,MATH 103A,B02,083780,Greenfeld; Be'Eri,2,0,36,34
1656940911105,MATH 103A,B03,093562,Greenfeld; Be'Eri,2,0,36,34
1656940917135,MATH 105,A01,085443,Carter; Anne Toulson,13,0,35,22
1656940917135,MATH 105,A02,093477,Carter; Anne Toulson,20,0,35,15
1656940923161,MATH 109,A01,083213,Ganzberger; Geoffrey Michael,2,0,34,32
1656940923161,MATH 109,A02,083214,Ganzberger; Geoffrey Michael,2,0,34,32
1656940923161,MATH 109,A03,093478,Ganzberger; Geoffrey Michael,1,0,34,33
1656940923161,MATH 109,B01,083215,Ganzberger; Geoffrey Michael,1,0,32,31
1656940923161,MATH 109,B02,083216,Ganzberger; Geoffrey Michael,1,0,32,31
1656940923161,MATH 109,B03,093479,Ganzberger; Geoffrey Michael,6,0,32,26
1656940929186,MATH 142A,A01,083219,Chow; Bennett,6,0,32,26
1656940929186,MATH 142A,A02,083220,Chow; Bennett,10,0,32,22
1656940929186,MATH 142A,A03,093480,Chow; Bennett,7,0,32,25
1656940929186,MATH 142A,B03,093481,Chow; Bennett,7,0,32,25
1656940929186,MATH 142A,B04,093558,Chow; Bennett,11,0,32,21
1656940929186,MATH 142A,B05,093559,Chow; Bennett,6,0,32,26
1656940935217,MATH 193A,A01,083224,Rotar; Vladimir,7,0,34,27
1656940935217,MATH 193A,A02,083225,Rotar; Vladimir,3,0,34,31
1656940935217,MATH 193A,A03,083781,Rotar; Vladimir,1,0,34,33
1656940935217,MATH 193A,A04,083782,Rotar; Vladimir,6,0,34,28
1656940935217,MATH 193A,A05,093482,Rotar; Vladimir,6,0,34,28
1656940941243,MATH 197,001,091859,McAuley; Julian John,9999,0,9999,0
1656940941243,MATH 197,002,095566,Kedlaya; Kiran S.,9997,0,9999,2
1656940941243,MATH 197,003,095567,Xiao; Ming,9999,0,9999,0
1656940941243,MATH 197,004,095571,Perols; Johan Lars,9998,0,9999,1
1656940948305,COGS 9,A01,083615,Shannon; Kyle Michael,7,0,75,68
1656940954332,COGS 11,A01,083617,Boyle; Mary E. T.,19,0,48,29
1656940960354,COGS 13,A01,083071,Bastos; Amalia Pinkusfeld,9,0,71,62
1656940966382,COGS 14A,A01,092681,Semenuks; Arturs,0,1,100,100
1656940972418,COGS 14B,A01,083073,Cheng; Tzu-Han,5,0,63,58
1656940978444,COGS 17,A01,092677,Semenuks; Arturs,4,0,81,77
1656940984474,COGS 100,A01,083619,Allen; Michael Gordon,15,0,70,55
1656940990499,COGS 101A,A01,083621,Davis; Joshua Daniel,9,0,68,59
1656940996528,COGS 101B,A01,091572,Allen; Michael Gordon,8,0,65,57
1656941002558,COGS 101C,A01,083625,Delgado; Tania,17,0,35,18
1656941008584,COGS 107A,A01,083627,Boyle; Mary E. T.,13,0,60,47
1656941014613,COGS 118A,A01,083075,Gupta; Anjum,15,0,76,61
1656941020642,CSE 3,A50,083646,Miranda; Gregory Joseph,22,0,50,28
1656941026666,CSE 8A,A50,083650,Miranda; Gregory Joseph,17,1,56,39
1656941032697,CSE 11,A01,083080,Cao; Yingjun,4,15,40,36
1656941038721,CSE 12,A01,083652,Krause-Levy; Sophia Louisa,20,1,120,100
1656941044744,CSE 15L,A01,083654,Morris; Justin Loren,8,0,50,42
1656941044744,CSE 15L,A02,083655,Morris; Justin Loren,8,0,50,42
1656941050769,CSE 20,A01,083657,Tran; Khoa Dang,37,0,80,43
1656941056801,CSE 21,A01,095574,Bach; Quang Tran,21,0,48,27
1656941062826,CSE 30,A01,083084,Eldon; John,4,0,80,76
1656941062826,CSE 30,B01,095061,Bhaskar; Nishant,6,0,50,44
1656941068853,CSE 100,A01,083659,Cao; Yingjun,3,4,70,67
1656941074887,CSE 134B,A01,083661,Powell; Thomas Allan,19,0,100,81
1656941080912,CSE 140,A01,083663,Gungor; Onat,14,0,85,71
1656941086937,CSE 140L,A01,083088,Eldon; John,16,0,100,84
1656941092960,CSE 175,A01,083665,Kumar; Rakesh,3,0,25,22
1656941098986,CSE 190,A00,092507,Dubnov; Shlomo,7,0,20,13
1656941105012,ECE 45,A01,083139,Congero; Spencer William,5,0,75,70
1656941111043,ECE 65,A50,083695,Saad; Andrew S,12,0,30,18
1656941111043,ECE 65,A51,095125,Saad; Andrew S,25,0,26,1
1656941117068,ECE 109,A01,091882,Touri; Behrouz,16,0,70,54
1656941123095,ECE 180,A00,083140,Abi Samra; Nicholas Camill,0,0,30,30
1656941123095,ECE 180,B00,083141,Abi Samra; Nicholas Camill,0,0,30,30
1656941129121,MATH 10A,A01,083735,Patchell; Gregory David,1,0,30,29
1656941129121,MATH 10A,A02,083736,Patchell; Gregory David,20,0,30,10
1656941129121,MATH 10A,A03,083737,Patchell; Gregory David,15,0,30,15
1656941135147,MATH 10B,A01,083207,Lim; Seonhee,7,0,34,27
1656941135147,MATH 10B,A02,083208,Lim; Seonhee,9,0,35,26
1656941135147,MATH 10B,A03,093472,Lim; Seonhee,4,0,34,30
1656941135147,MATH 10B,B01,083739,Sinha; Shubham,9,0,30,21
1656941141182,MATH 18,A01,083743,Cinel; Cameron Alexander,6,0,30,24
1656941141182,MATH 18,A02,083744,Cinel; Cameron Alexander,15,0,30,15
1656941141182,MATH 18,A03,083745,Cinel; Cameron Alexander,8,0,30,22
1656941141182,MATH 18,B01,083748,Rideout; David Porter,4,0,37,33
1656941141182,MATH 18,B02,083749,Rideout; David Porter,3,0,36,33
1656941141182,MATH 18,B03,083750,Rideout; David Porter,2,0,37,35
1656941141182,MATH 18,B04,083751,Rideout; David Porter,5,0,36,31
1656941141182,MATH 18,B05,093473,Rideout; David Porter,4,0,36,32
1656941141182,MATH 18,B06,093474,Rideout; David Porter,5,0,36,31
1656941147208,MATH 20A,A01,083754,Zheng; Zequn,12,0,40,28
1656941153235,MATH 20B,A01,083756,Briones; Jor-el Thomas Caparas,1,0,36,35
1656941153235,MATH 20B,A02,083757,Briones; Jor-el Thomas Caparas,1,0,36,35
1656941153235,MATH 20B,A03,093475,Briones; Jor-el Thomas Caparas,0,0,36,36
1656941159267,MATH 20C,A01,083760,Briones; Jor-el Thomas Caparas,1,0,35,34
1656941159267,MATH 20C,A02,083761,Briones; Jor-el Thomas Caparas,8,0,35,27
1656941159267,MATH 20C,A03,093476,Briones; Jor-el Thomas Caparas,0,1,36,36
1656941159267,MATH 20C,B01,083762,Bach; Quang Tran,0,0,30,30
1656941165291,MATH 20D,A01,083765,Tran; Brian Kha,4,0,30,26
1656941165291,MATH 20D,A02,083766,Tran; Brian Kha,4,0,30,26
1656941165291,MATH 20D,A03,083767,Tran; Brian Kha,3,0,30,27
1656941171323,MATH 20E,A01,083771,Ganguly; Soumya,5,0,32,27
1656941171323,MATH 20E,A02,083772,Ganguly; Soumya,6,0,32,26
1656941171323,MATH 20E,B01,083773,Ciotti; Benjamin,18,0,35,17
1656941171323,MATH 20E,B02,083774,Ciotti; Benjamin,17,0,35,18
1656941177348,MATH 103A,A01,083777,Greenfeld; Be'Eri,2,0,36,34
1656941177348,MATH 103A,A02,083778,Greenfeld; Be'Eri,5,0,36,31
1656941177348,MATH 103A,A03,093561,Greenfeld; Be'Eri,4,0,36,32
1656941177348,MATH 103A,B01,083779,Greenfeld; Be'Eri,6,0,36,30
1656941177348,MATH 103A,B02,083780,Greenfeld; Be'Eri,2,0,36,34
1656941177348,MATH 103A,B03,093562,Greenfeld; Be'Eri,2,0,36,34
1656941183378,MATH 105,A01,085443,Carter; Anne Toulson,13,0,35,22
1656941183378,MATH 105,A02,093477,Carter; Anne Toulson,20,0,35,15
1656941189418,MATH 109,A01,083213,Ganzberger; Geoffrey Michael,2,0,34,32
1656941189418,MATH 109,A02,083214,Ganzberger; Geoffrey Michael,2,0,34,32
1656941189418,MATH 109,A03,093478,Ganzberger; Geoffrey Michael,1,0,34,33
1656941189418,MATH 109,B01,083215,Ganzberger; Geoffrey Michael,1,0,32,31
1656941189418,MATH 109,B02,083216,Ganzberger; Geoffrey Michael,1,0,32,31
1656941189418,MATH 109,B03,093479,Ganzberger; Geoffrey Michael,6,0,32,26
1656941195444,MATH 142A,A01,083219,Chow; Bennett,6,0,32,26
1656941195444,MATH 142A,A02,083220,Chow; Bennett,10,0,32,22
1656941195444,MATH 142A,A03,093480,Chow; Bennett,7,0,32,25
1656941195444,MATH 142A,B03,093481,Chow; Bennett,7,0,32,25
1656941195444,MATH 142A,B04,093558,Chow; Bennett,11,0,32,21
1656941195444,MATH 142A,B05,093559,Chow; Bennett,6,0,32,26
1656941201483,MATH 193A,A01,083224,Rotar; Vladimir,7,0,34,27
1656941201483,MATH 193A,A02,083225,Rotar; Vladimir,3,0,34,31
1656941201483,MATH 193A,A03,083781,Rotar; Vladimir,1,0,34,33
1656941201483,MATH 193A,A04,083782,Rotar; Vladimir,6,0,34,28
1656941201483,MATH 193A,A05,093482,Rotar; Vladimir,6,0,34,28
1656941207510,MATH 197,001,091859,McAuley; Julian John,9999,0,9999,0
1656941207510,MATH 197,002,095566,Kedlaya; Kiran S.,9997,0,9999,2
1656941207510,MATH 197,003,095567,Xiao; Ming,9999,0,9999,0
1656941207510,MATH 197,004,095571,Perols; Johan Lars,9998,0,9999,1
1656941214584,COGS 9,A01,083615,Shannon; Kyle Michael,7,0,75,68
1656941220614,COGS 11,A01,083617,Boyle; Mary E. T.,19,0,48,29
1656941226643,COGS 13,A01,083071,Bastos; Amalia Pinkusfeld,9,0,71,62
1656941232673,COGS 14A,A01,092681,Semenuks; Arturs,0,1,100,100
1656941238698,COGS 14B,A01,083073,Cheng; Tzu-Han,5,0,63,58
1656941244726,COGS 17,A01,092677,Semenuks; Arturs,4,0,81,77
1656941250757,COGS 100,A01,083619,Allen; Michael Gordon,15,0,70,55
1656941256782,COGS 101A,A01,083621,Davis; Joshua Daniel,9,0,68,59
1656941262808,COGS 101B,A01,091572,Allen; Michael Gordon,8,0,65,57
1656941268836,COGS 101C,A01,083625,Delgado; Tania,17,0,35,18
1656941274860,COGS 107A,A01,083627,Boyle; Mary E. T.,13,0,60,47
1656941280892,COGS 118A,A01,083075,Gupta; Anjum,15,0,76,61
1656941286926,CSE 3,A50,083646,Miranda; Gregory Joseph,22,0,50,28
1656941292956,CSE 8A,A50,083650,Miranda; Gregory Joseph,17,1,56,39
1656941298985,CSE 11,A01,083080,Cao; Yingjun,4,15,40,36
1656941305015,CSE 12,A01,083652,Krause-Levy; Sophia Louisa,20,1,120,100
1656941311040,CSE 15L,A01,083654,Morris; Justin Loren,8,0,50,42
1656941311040,CSE 15L,A02,083655,Morris; Justin Loren,8,0,50,42
1656941317064,CSE 20,A01,083657,Tran; Khoa Dang,37,0,80,43
1656941323090,CSE 21,A01,095574,Bach; Quang Tran,21,0,48,27
1656941329115,CSE 30,A01,083084,Eldon; John,4,0,80,76
1656941329115,CSE 30,B01,095061,Bhaskar; Nishant,6,0,50,44
1656941335142,CSE 100,A01,083659,Cao; Yingjun,3,4,70,67
1656941341176,CSE 134B,A01,083661,Powell; Thomas Allan,19,0,100,81
1656941347205,CSE 140,A01,083663,Gungor; Onat,14,0,85,71
1656941353235,CSE 140L,A01,083088,Eldon; John,16,0,100,84
1656941359258,CSE 175,A01,083665,Kumar; Rakesh,3,0,25,22
1656941365280,CSE 190,A00,092507,Dubnov; Shlomo,7,0,20,13
1656941371305,ECE 45,A01,083139,Congero; Spencer William,5,0,75,70
1656941377334,ECE 65,A50,083695,Saad; Andrew S,12,0,30,18
1656941377334,ECE 65,A51,095125,Saad; Andrew S,25,0,26,1
1656941383393,ECE 109,A01,091882,Touri; Behrouz,16,0,70,54
1656941389418,ECE 180,A00,083140,Abi Samra; Nicholas Camill,0,0,30,30
1656941389418,ECE 180,B00,083141,Abi Samra; Nicholas Camill,0,0,30,30
1656941395455,MATH 10A,A01,083735,Patchell; Gregory David,1,0,30,29
1656941395455,MATH 10A,A02,083736,Patchell; Gregory David,20,0,30,10
1656941395455,MATH 10A,A03,083737,Patchell; Gregory David,15,0,30,15
1656941401493,MATH 10B,A01,083207,Lim; Seonhee,7,0,34,27
1656941401493,MATH 10B,A02,083208,Lim; Seonhee,9,0,35,26
1656941401493,MATH 10B,A03,093472,Lim; Seonhee,4,0,34,30
1656941401493,MATH 10B,B01,083739,Sinha; Shubham,9,0,30,21
1656941407525,MATH 18,A01,083743,Cinel; Cameron Alexander,6,0,30,24
1656941407525,MATH 18,A02,083744,Cinel; Cameron Alexander,15,0,30,15
1656941407525,MATH 18,A03,083745,Cinel; Cameron Alexander,8,0,30,22
1656941407525,MATH 18,B01,083748,Rideout; David Porter,4,0,37,33
1656941407525,MATH 18,B02,083749,Rideout; David Porter,3,0,36,33
1656941407525,MATH 18,B03,083750,Rideout; David Porter,2,0,37,35
1656941407525,MATH 18,B04,083751,Rideout; David Porter,5,0,36,31
1656941407525,MATH 18,B05,093473,Rideout; David Porter,4,0,36,32
1656941407525,MATH 18,B06,093474,Rideout; David Porter,5,0,36,31
1656941413551,MATH 20A,A01,083754,Zheng; Zequn,12,0,40,28
1656941419581,MATH 20B,A01,083756,Briones; Jor-el Thomas Caparas,1,0,36,35
1656941419581,MATH 20B,A02,083757,Briones; Jor-el Thomas Caparas,1,0,36,35
1656941419581,MATH 20B,A03,093475,Briones; Jor-el Thomas Caparas,0,0,36,36
1656941425609,MATH 20C,A01,083760,Briones; Jor-el Thomas Caparas,1,0,35,34
1656941425609,MATH 20C,A02,083761,Briones; Jor-el Thomas Caparas,8,0,35,27
1656941425609,MATH 20C,A03,093476,Briones; Jor-el Thomas Caparas,0,1,36,36
1656941425609,MATH 20C,B01,083762,Bach; Quang Tran,0,0,30,30
1656941431634,MATH 20D,A01,083765,Tran; Brian Kha,4,0,30,26
1656941431634,MATH 20D,A02,083766,Tran; Brian Kha,4,0,30,26
1656941431634,MATH 20D,A03,083767,Tran; Brian Kha,3,0,30,27
1656941437658,MATH 20E,A01,083771,Ganguly; Soumya,5,0,32,27
1656941437658,MATH 20E,A02,083772,Ganguly; Soumya,6,0,32,26
1656941437658,MATH 20E,B01,083773,Ciotti; Benjamin,18,0,35,17
1656941437658,MATH 20E,B02,083774,Ciotti; Benjamin,17,0,35,18
1656941443691,MATH 103A,A01,083777,Greenfeld; Be'Eri,2,0,36,34
1656941443691,MATH 103A,A02,083778,Greenfeld; Be'Eri,5,0,36,31
1656941443691,MATH 103A,A03,093561,Greenfeld; Be'Eri,4,0,36,32
1656941443691,MATH 103A,B01,083779,Greenfeld; Be'Eri,6,0,36,30
1656941443691,MATH 103A,B02,083780,Greenfeld; Be'Eri,2,0,36,34
1656941443691,MATH 103A,B03,093562,Greenfeld; Be'Eri,2,0,36,34
1656941449720,MATH 105,A01,085443,Carter; Anne Toulson,13,0,35,22
1656941449720,MATH 105,A02,093477,Carter; Anne Toulson,20,0,35,15
1656941455749,MATH 109,A01,083213,Ganzberger; Geoffrey Michael,2,0,34,32
1656941455749,MATH 109,A02,083214,Ganzberger; Geoffrey Michael,2,0,34,32
1656941455749,MATH 109,A03,093478,Ganzberger; Geoffrey Michael,1,0,34,33
1656941455749,MATH 109,B01,083215,Ganzberger; Geoffrey Michael,1,0,32,31
1656941455749,MATH 109,B02,083216,Ganzberger; Geoffrey Michael,1,0,32,31
1656941455749,MATH 109,B03,093479,Ganzberger; Geoffrey Michael,6,0,32,26
1656941461773,MATH 142A,A01,083219,Chow; Bennett,6,0,32,26
1656941461773,MATH 142A,A02,083220,Chow; Bennett,10,0,32,22
1656941461773,MATH 142A,A03,093480,Chow; Bennett,7,0,32,25
1656941461773,MATH 142A,B03,093481,Chow; Bennett,7,0,32,25
1656941461773,MATH 142A,B04,093558,Chow; Bennett,11,0,32,21
1656941461773,MATH 142A,B05,093559,Chow; Bennett,6,0,32,26
1656941467797,MATH 193A,A01,083224,Rotar; Vladimir,7,0,34,27
1656941467797,MATH 193A,A02,083225,Rotar; Vladimir,3,0,34,31
1656941467797,MATH 193A,A03,083781,Rotar; Vladimir,1,0,34,33
1656941467797,MATH 193A,A04,083782,Rotar; Vladimir,6,0,34,28
1656941467797,MATH 193A,A05,093482,Rotar; Vladimir,6,0,34,28
1656941473827,MATH 197,001,091859,McAuley; Julian John,9999,0,9999,0
1656941473827,MATH 197,002,095566,Kedlaya; Kiran S.,9997,0,9999,2
1656941473827,MATH 197,003,095567,Xiao; Ming,9999,0,9999,0
1656941473827,MATH 197,004,095571,Perols; Johan Lars,9998,0,9999,1
1656941483201,COGS 9,A01,083615,Shannon; Kyle Michael,7,0,75,68
1656941489248,COGS 11,A01,083617,Boyle; Mary E. T.,19,0,48,29
1656941495272,COGS 13,A01,083071,Bastos; Amalia Pinkusfeld,9,0,71,62
1656941501301,COGS 14A,A01,092681,Semenuks; Arturs,0,1,100,100
1656941507398,COGS 14B,A01,083073,Cheng; Tzu-Han,5,0,63,58
1656941513430,COGS 17,A01,092677,Semenuks; Arturs,4,0,81,77
1656941519453,COGS 100,A01,083619,Allen; Michael Gordon,15,0,70,55
1656941525478,COGS 101A,A01,083621,Davis; Joshua Daniel,9,0,68,59
1656941531503,COGS 101B,A01,091572,Allen; Michael Gordon,8,0,65,57
1656941537528,COGS 101C,A01,083625,Delgado; Tania,17,0,35,18
1656941543553,COGS 107A,A01,083627,Boyle; Mary E. T.,13,0,60,47
1656941549578,COGS 118A,A01,083075,Gupta; Anjum,15,0,76,61
1656941555608,CSE 3,A50,083646,Miranda; Gregory Joseph,22,0,50,28
1656941561648,CSE 8A,A50,083650,Miranda; Gregory Joseph,17,1,56,39
1656941567672,CSE 11,A01,083080,Cao; Yingjun,4,15,40,36
1656941573696,CSE 12,A01,083652,Krause-Levy; Sophia Louisa,20,1,120,100
1656941579723,CSE 15L,A01,083654,Morris; Justin Loren,8,0,50,42
1656941579723,CSE 15L,A02,083655,Morris; Justin Loren,8,0,50,42
1656941585751,CSE 20,A01,083657,Tran; Khoa Dang,37,0,80,43
1656941591774,CSE 21,A01,095574,Bach; Quang Tran,21,0,48,27
1656941597803,CSE 30,A01,083084,Eldon; John,4,0,80,76
1656941597803,CSE 30,B01,095061,Bhaskar; Nishant,6,0,50,44
1656941603842,CSE 100,A01,083659,Cao; Yingjun,3,4,70,67
1656941609866,CSE 134B,A01,083661,Powell; Thomas Allan,19,0,100,81
1656941615893,CSE 140,A01,083663,Gungor; Onat,14,0,85,71
1656941621918,CSE 140L,A01,083088,Eldon; John,16,0,100,84
1656941627943,CSE 175,A01,083665,Kumar; Rakesh,3,0,25,22
1656941633970,CSE 190,A00,092507,Dubnov; Shlomo,7,0,20,13
1656941639993,ECE 45,A01,083139,Congero; Spencer William,5,0,75,70
1656941646019,ECE 65,A50,083695,Saad; Andrew S,12,0,30,18
1656941646019,ECE 65,A51,095125,Saad; Andrew S,25,0,26,1
1656941652044,ECE 109,A01,091882,Touri; Behrouz,16,0,70,54
1656941658073,ECE 180,A00,083140,Abi Samra; Nicholas Camill,0,0,30,30
1656941658073,ECE 180,B00,083141,Abi Samra; Nicholas Camill,0,0,30,30
1656941664101,MATH 10A,A01,083735,Patchell; Gregory David,1,0,30,29
1656941664101,MATH 10A,A02,083736,Patchell; Gregory David,20,0,30,10
1656941664101,MATH 10A,A03,083737,Patchell; Gregory David,15,0,30,15
1656941670126,MATH 10B,A01,083207,Lim; Seonhee,7,0,34,27
1656941670126,MATH 10B,A02,083208,Lim; Seonhee,9,0,35,26
1656941670126,MATH 10B,A03,093472,Lim; Seonhee,4,0,34,30
1656941670126,MATH 10B,B01,083739,Sinha; Shubham,9,0,30,21
1656941676154,MATH 18,A01,083743,Cinel; Cameron Alexander,6,0,30,24
1656941676154,MATH 18,A02,083744,Cinel; Cameron Alexander,15,0,30,15
1656941676154,MATH 18,A03,083745,Cinel; Cameron Alexander,8,0,30,22
1656941676154,MATH 18,B01,083748,Rideout; David Porter,4,0,37,33
1656941676154,MATH 18,B02,083749,Rideout; David Porter,3,0,36,33
1656941676154,MATH 18,B03,083750,Rideout; David Porter,2,0,37,35
1656941676154,MATH 18,B04,083751,Rideout; David Porter,5,0,36,31
1656941676154,MATH 18,B05,093473,Rideout; David Porter,4,0,36,32
1656941676154,MATH 18,B06,093474,Rideout; David Porter,5,0,36,31
1656941682177,MATH 20A,A01,083754,Zheng; Zequn,12,0,40,28
1656941688204,MATH 20B,A01,083756,Briones; Jor-el Thomas Caparas,1,0,36,35
1656941688204,MATH 20B,A02,083757,Briones; Jor-el Thomas Caparas,1,0,36,35
1656941688204,MATH 20B,A03,093475,Briones; Jor-el Thomas Caparas,0,0,36,36
1656941694228,MATH 20C,A01,083760,Briones; Jor-el Thomas Caparas,1,0,35,34
1656941694228,MATH 20C,A02,083761,Briones; Jor-el Thomas Caparas,8,0,35,27
1656941694228,MATH 20C,A03,093476,Briones; Jor-el Thomas Caparas,0,1,36,36
1656941694228,MATH 20C,B01,083762,Bach; Quang Tran,0,0,30,30
1656941700252,MATH 20D,A01,083765,Tran; Brian Kha,4,0,30,26
1656941700252,MATH 20D,A02,083766,Tran; Brian Kha,4,0,30,26
1656941700252,MATH 20D,A03,083767,Tran; Brian Kha,3,0,30,27
1656941706279,MATH 20E,A01,083771,Ganguly; Soumya,5,0,32,27
1656941706279,MATH 20E,A02,083772,Ganguly; Soumya,6,0,32,26
1656941706279,MATH 20E,B01,083773,Ciotti; Benjamin,18,0,35,17
1656941706279,MATH 20E,B02,083774,Ciotti; Benjamin,17,0,35,18
1656941712305,MATH 103A,A01,083777,Greenfeld; Be'Eri,2,0,36,34
1656941712305,MATH 103A,A02,083778,Greenfeld; Be'Eri,5,0,36,31
1656941712305,MATH 103A,A03,093561,Greenfeld; Be'Eri,4,0,36,32
1656941712305,MATH 103A,B01,083779,Greenfeld; Be'Eri,6,0,36,30
1656941712305,MATH 103A,B02,083780,Greenfeld; Be'Eri,2,0,36,34
1656941712305,MATH 103A,B03,093562,Greenfeld; Be'Eri,2,0,36,34
1656941718334,MATH 105,A01,085443,Carter; Anne Toulson,13,0,35,22
1656941718334,MATH 105,A02,093477,Carter; Anne Toulson,20,0,35,15
1656941724358,MATH 109,A01,083213,Ganzberger; Geoffrey Michael,2,0,34,32
1656941724358,MATH 109,A02,083214,Ganzberger; Geoffrey Michael,2,0,34,32
1656941724358,MATH 109,A03,093478,Ganzberger; Geoffrey Michael,1,0,34,33
1656941724358,MATH 109,B01,083215,Ganzberger; Geoffrey Michael,1,0,32,31
1656941724358,MATH 109,B02,083216,Ganzberger; Geoffrey Michael,1,0,32,31
1656941724358,MATH 109,B03,093479,Ganzberger; Geoffrey Michael,6,0,32,26
1656941730387,MATH 142A,A01,083219,Chow; Bennett,6,0,32,26
1656941730387,MATH 142A,A02,083220,Chow; Bennett,10,0,32,22
1656941730387,MATH 142A,A03,093480,Chow; Bennett,7,0,32,25
1656941730387,MATH 142A,B03,093481,Chow; Bennett,7,0,32,25
1656941730387,MATH 142A,B04,093558,Chow; Bennett,11,0,32,21
1656941730387,MATH 142A,B05,093559,Chow; Bennett,6,0,32,26
1656941736415,MATH 193A,A01,083224,Rotar; Vladimir,7,0,34,27
1656941736415,MATH 193A,A02,083225,Rotar; Vladimir,3,0,34,31
1656941736415,MATH 193A,A03,083781,Rotar; Vladimir,1,0,34,33
1656941736415,MATH 193A,A04,083782,Rotar; Vladimir,6,0,34,28
1656941736415,MATH 193A,A05,093482,Rotar; Vladimir,6,0,34,28
1656941742442,MATH 197,001,091859,McAuley; Julian John,9999,0,9999,0
1656941742442,MATH 197,002,095566,Kedlaya; Kiran S.,9997,0,9999,2
1656941742442,MATH 197,003,095567,Xiao; Ming,9999,0,9999,0
1656941742442,MATH 197,004,095571,Perols; Johan Lars,9998,0,9999,1
1656941749498,COGS 9,A01,083615,Shannon; Kyle Michael,7,0,75,68
1656941755521,COGS 11,A01,083617,Boyle; Mary E. T.,19,0,48,29
1656941761549,COGS 13,A01,083071,Bastos; Amalia Pinkusfeld,9,0,71,62
1656941767575,COGS 14A,A01,092681,Semenuks; Arturs,0,1,100,100
1656941773602,COGS 14B,A01,083073,Cheng; Tzu-Han,5,0,63,58
1656941779627,COGS 17,A01,092677,Semenuks; Arturs,4,0,81,77
1656941785654,COGS 100,A01,083619,Allen; Michael Gordon,15,0,70,55
1656941791685,COGS 101A,A01,083621,Davis; Joshua Daniel,9,0,68,59
1656941797707,COGS 101B,A01,091572,Allen; Michael Gordon,8,0,65,57
1656941803731,COGS 101C,A01,083625,Delgado; Tania,17,0,35,18
1656941809754,COGS 107A,A01,083627,Boyle; Mary E. T.,13,0,60,47
1656941815781,COGS 118A,A01,083075,Gupta; Anjum,15,0,76,61
1656941821804,CSE 3,A50,083646,Miranda; Gregory Joseph,22,0,50,28
1656941827826,CSE 8A,A50,083650,Miranda; Gregory Joseph,17,1,56,39
1656941833849,CSE 11,A01,083080,Cao; Yingjun,4,15,40,36
1656941839877,CSE 12,A01,083652,Krause-Levy; Sophia Louisa,20,1,120,100
1656941845899,CSE 15L,A01,083654,Morris; Justin Loren,8,0,50,42
1656941845899,CSE 15L,A02,083655,Morris; Justin Loren,8,0,50,42
1656941851926,CSE 20,A01,083657,Tran; Khoa Dang,37,0,80,43
1656941857950,CSE 21,A01,095574,Bach; Quang Tran,21,0,48,27
1656941863975,CSE 30,A01,083084,Eldon; John,4,0,80,76
1656941863975,CSE 30,B01,095061,Bhaskar; Nishant,6,0,50,44
1656941869998,CSE 100,A01,083659,Cao; Yingjun,3,4,70,67
1656941876039,CSE 134B,A01,083661,Powell; Thomas Allan,19,0,100,81
1656941882102,CSE 140,A01,083663,Gungor; Onat,14,0,85,71
1656941888130,CSE 140L,A01,083088,Eldon; John,16,0,100,84
1656941894158,CSE 175,A01,083665,Kumar; Rakesh,3,0,25,22
1656941900183,CSE 190,A00,092507,Dubnov; Shlomo,7,0,20,13
1656941906207,ECE 45,A01,083139,Congero; Spencer William,5,0,75,70
1656941912237,ECE 65,A50,083695,Saad; Andrew S,12,0,30,18
1656941912237,ECE 65,A51,095125,Saad; Andrew S,25,0,26,1
1656941918260,ECE 109,A01,091882,Touri; Behrouz,16,0,70,54
1656941924285,ECE 180,A00,083140,Abi Samra; Nicholas Camill,0,0,30,30
1656941924285,ECE 180,B00,083141,Abi Samra; Nicholas Camill,0,0,30,30
1656941930312,MATH 10A,A01,083735,Patchell; Gregory David,1,0,30,29
1656941930312,MATH 10A,A02,083736,Patchell; Gregory David,20,0,30,10
1656941930312,MATH 10A,A03,083737,Patchell; Gregory David,15,0,30,15
1656941936343,MATH 10B,A01,083207,Lim; Seonhee,7,0,34,27
1656941936343,MATH 10B,A02,083208,Lim; Seonhee,9,0,35,26
1656941936343,MATH 10B,A03,093472,Lim; Seonhee,4,0,34,30
1656941936343,MATH 10B,B01,083739,Sinha; Shubham,9,0,30,21
1656941942368,MATH 18,A01,083743,Cinel; Cameron Alexander,6,0,30,24
1656941942368,MATH 18,A02,083744,Cinel; Cameron Alexander,15,0,30,15
1656941942368,MATH 18,A03,083745,Cinel; Cameron Alexander,8,0,30,22
1656941942368,MATH 18,B01,083748,Rideout; David Porter,4,0,37,33
1656941942368,MATH 18,B02,083749,Rideout; David Porter,3,0,36,33
1656941942368,MATH 18,B03,083750,Rideout; David Porter,2,0,37,35
1656941942368,MATH 18,B04,083751,Rideout; David Porter,5,0,36,31
1656941942368,MATH 18,B05,093473,Rideout; David Porter,4,0,36,32
1656941942368,MATH 18,B06,093474,Rideout; David Porter,5,0,36,31
1656941948393,MATH 20A,A01,083754,Zheng; Zequn,12,0,40,28
1656941954421,MATH 20B,A01,083756,Briones; Jor-el Thomas Caparas,1,0,36,35
1656941954421,MATH 20B,A02,083757,Briones; Jor-el Thomas Caparas,1,0,36,35
1656941954421,MATH 20B,A03,093475,Briones; Jor-el Thomas Caparas,0,0,36,36
1656941960446,MATH 20C,A01,083760,Briones; Jor-el Thomas Caparas,1,0,35,34
1656941960446,MATH 20C,A02,083761,Briones; Jor-el Thomas Caparas,8,0,35,27
1656941960446,MATH 20C,A03,093476,Briones; Jor-el Thomas Caparas,0,1,36,36
1656941960446,MATH 20C,B01,083762,Bach; Quang Tran,0,0,30,30
1656941966476,MATH 20D,A01,083765,Tran; Brian Kha,4,0,30,26
1656941966476,MATH 20D,A02,083766,Tran; Brian Kha,4,0,30,26
1656941966476,MATH 20D,A03,083767,Tran; Brian Kha,3,0,30,27
1656941972505,MATH 20E,A01,083771,Ganguly; Soumya,5,0,32,27
1656941972505,MATH 20E,A02,083772,Ganguly; Soumya,6,0,32,26
1656941972505,MATH 20E,B01,083773,Ciotti; Benjamin,18,0,35,17
1656941972505,MATH 20E,B02,083774,Ciotti; Benjamin,17,0,35,18
1656941978532,MATH 103A,A01,083777,Greenfeld; Be'Eri,2,0,36,34
1656941978532,MATH 103A,A02,083778,Greenfeld; Be'Eri,5,0,36,31
1656941978532,MATH 103A,A03,093561,Greenfeld; Be'Eri,4,0,36,32
1656941978532,MATH 103A,B01,083779,Greenfeld; Be'Eri,6,0,36,30
1656941978532,MATH 103A,B02,083780,Greenfeld; Be'Eri,2,0,36,34
1656941978532,MATH 103A,B03,093562,Greenfeld; Be'Eri,2,0,36,34
1656941984580,MATH 105,A01,085443,Carter; Anne Toulson,13,0,35,22
1656941984580,MATH 105,A02,093477,Carter; Anne Toulson,20,0,35,15
1656941990611,MATH 109,A01,083213,Ganzberger; Geoffrey Michael,2,0,34,32
1656941990611,MATH 109,A02,083214,Ganzberger; Geoffrey Michael,2,0,34,32
1656941990611,MATH 109,A03,093478,Ganzberger; Geoffrey Michael,1,0,34,33
1656941990611,MATH 109,B01,083215,Ganzberger; Geoffrey Michael,1,0,32,31
1656941990611,MATH 109,B02,083216,Ganzberger; Geoffrey Michael,1,0,32,31
1656941990611,MATH 109,B03,093479,Ganzberger; Geoffrey Michael,6,0,32,26
1656941996637,MATH 142A,A01,083219,Chow; Bennett,6,0,32,26
1656941996637,MATH 142A,A02,083220,Chow; Bennett,10,0,32,22
1656941996637,MATH 142A,A03,093480,Chow; Bennett,7,0,32,25
1656941996637,MATH 142A,B03,093481,Chow; Bennett,7,0,32,25
1656941996637,MATH 142A,B04,093558,Chow; Bennett,11,0,32,21
1656941996637,MATH 142A,B05,093559,Chow; Bennett,6,0,32,26
1656942002667,MATH 193A,A01,083224,Rotar; Vladimir,7,0,34,27
1656942002667,MATH 193A,A02,083225,Rotar; Vladimir,3,0,34,31
1656942002667,MATH 193A,A03,083781,Rotar; Vladimir,1,0,34,33
1656942002667,MATH 193A,A04,083782,Rotar; Vladimir,6,0,34,28
1656942002667,MATH 193A,A05,093482,Rotar; Vladimir,6,0,34,28
1656942008694,MATH 197,001,091859,McAuley; Julian John,9999,0,9999,0
1656942008694,MATH 197,002,095566,Kedlaya; Kiran S.,9997,0,9999,2
1656942008694,MATH 197,003,095567,Xiao; Ming,9999,0,9999,0
1656942008694,MATH 197,004,095571,Perols; Johan Lars,9998,0,9999,1
1656942015757,COGS 9,A01,083615,Shannon; Kyle Michael,7,0,75,68
1656942021781,COGS 11,A01,083617,Boyle; Mary E. T.,19,0,48,29
1656942027803,COGS 13,A01,083071,Bastos; Amalia Pinkusfeld,9,0,71,62
1656942033830,COGS 14A,A01,092681,Semenuks; Arturs,0,1,100,100
1656942039853,COGS 14B,A01,083073,Cheng; Tzu-Han,5,0,63,58
1656942045881,COGS 17,A01,092677,Semenuks; Arturs,4,0,81,77
1656942051906,COGS 100,A01,083619,Allen; Michael Gordon,15,0,70,55
1656942057938,COGS 101A,A01,083621,Davis; Joshua Daniel,9,0,68,59
1656942063964,COGS 101B,A01,091572,Allen; Michael Gordon,8,0,65,57
1656942069991,COGS 101C,A01,083625,Delgado; Tania,17,0,35,18
1656942076021,COGS 107A,A01,083627,Boyle; Mary E. T.,13,0,60,47
1656942082045,COGS 118A,A01,083075,Gupta; Anjum,15,0,76,61
1656942088071,CSE 3,A50,083646,Miranda; Gregory Joseph,22,0,50,28
1656942094101,CSE 8A,A50,083650,Miranda; Gregory Joseph,17,1,56,39
1656942100128,CSE 11,A01,083080,Cao; Yingjun,4,15,40,36
1656942106248,CSE 12,A01,083652,Krause-Levy; Sophia Louisa,20,1,120,100
1656942112273,CSE 15L,A01,083654,Morris; Justin Loren,8,0,50,42
1656942112273,CSE 15L,A02,083655,Morris; Justin Loren,8,0,50,42
1656942118296,CSE 20,A01,083657,Tran; Khoa Dang,37,0,80,43
1656942124320,CSE 21,A01,095574,Bach; Quang Tran,21,0,48,27
1656942130346,CSE 30,A01,083084,Eldon; John,4,0,80,76
1656942130346,CSE 30,B01,095061,Bhaskar; Nishant,6,0,50,44
1656942136370,CSE 100,A01,083659,Cao; Yingjun,3,4,70,67
1656942142394,CSE 134B,A01,083661,Powell; Thomas Allan,19,0,100,81
1656942148417,CSE 140,A01,083663,Gungor; Onat,14,0,85,71
1656942154445,CSE 140L,A01,083088,Eldon; John,16,0,100,84
1656942160474,CSE 175,A01,083665,Kumar; Rakesh,3,0,25,22
1656942166498,CSE 190,A00,092507,Dubnov; Shlomo,7,0,20,13
1656942172521,ECE 45,A01,083139,Congero; Spencer William,5,0,75,70
1656942178549,ECE 65,A50,083695,Saad; Andrew S,12,0,30,18
1656942178549,ECE 65,A51,095125,Saad; Andrew S,25,0,26,1
1656942184574,ECE 109,A01,091882,Touri; Behrouz,16,0,70,54
1656942190608,ECE 180,A00,083140,Abi Samra; Nicholas Camill,0,0,30,30
1656942190608,ECE 180,B00,083141,Abi Samra; Nicholas Camill,0,0,30,30
1656942196637,MATH 10A,A01,083735,Patchell; Gregory David,1,0,30,29
1656942196637,MATH 10A,A02,083736,Patchell; Gregory David,20,0,30,10
1656942196637,MATH 10A,A03,083737,Patchell; Gregory David,15,0,30,15
1656942202661,MATH 10B,A01,083207,Lim; Seonhee,7,0,34,27
1656942202661,MATH 10B,A02,083208,Lim; Seonhee,9,0,35,26
1656942202661,MATH 10B,A03,093472,Lim; Seonhee,4,0,34,30
1656942202661,MATH 10B,B01,083739,Sinha; Shubham,9,0,30,21
1656942208686,MATH 18,A01,083743,Cinel; Cameron Alexander,6,0,30,24
1656942208686,MATH 18,A02,083744,Cinel; Cameron Alexander,15,0,30,15
1656942208686,MATH 18,A03,083745,Cinel; Cameron Alexander,8,0,30,22
1656942208686,MATH 18,B01,083748,Rideout; David Porter,4,0,37,33
1656942208686,MATH 18,B02,083749,Rideout; David Porter,3,0,36,33
1656942208686,MATH 18,B03,083750,Rideout; David Porter,2,0,37,35
1656942208686,MATH 18,B04,083751,Rideout; David Porter,5,0,36,31
1656942208686,MATH 18,B05,093473,Rideout; David Porter,4,0,36,32
1656942208686,MATH 18,B06,093474,Rideout; David Porter,5,0,36,31
1656942214711,MATH 20A,A01,083754,Zheng; Zequn,12,0,40,28
1656942220738,MATH 20B,A01,083756,Briones; Jor-el Thomas Caparas,1,0,36,35
1656942220738,MATH 20B,A02,083757,Briones; Jor-el Thomas Caparas,1,0,36,35
1656942220738,MATH 20B,A03,093475,Briones; Jor-el Thomas Caparas,0,0,36,36
1656942226762,MATH 20C,A01,083760,Briones; Jor-el Thomas Caparas,1,0,35,34
1656942226762,MATH 20C,A02,083761,Briones; Jor-el Thomas Caparas,8,0,35,27
1656942226762,MATH 20C,A03,093476,Briones; Jor-el Thomas Caparas,0,1,36,36
1656942226762,MATH 20C,B01,083762,Bach; Quang Tran,0,0,30,30
1656942232787,MATH 20D,A01,083765,Tran; Brian Kha,4,0,30,26
1656942232787,MATH 20D,A02,083766,Tran; Brian Kha,4,0,30,26
1656942232787,MATH 20D,A03,083767,Tran; Brian Kha,3,0,30,27
1656942238816,MATH 20E,A01,083771,Ganguly; Soumya,5,0,32,27
1656942238816,MATH 20E,A02,083772,Ganguly; Soumya,6,0,32,26
1656942238816,MATH 20E,B01,083773,Ciotti; Benjamin,18,0,35,17
1656942238816,MATH 20E,B02,083774,Ciotti; Benjamin,17,0,35,18
1656942244839,MATH 103A,A01,083777,Greenfeld; Be'Eri,2,0,36,34
1656942244839,MATH 103A,A02,083778,Greenfeld; Be'Eri,5,0,36,31
1656942244839,MATH 103A,A03,093561,Greenfeld; Be'Eri,4,0,36,32
1656942244839,MATH 103A,B01,083779,Greenfeld; Be'Eri,6,0,36,30
1656942244839,MATH 103A,B02,083780,Greenfeld; Be'Eri,2,0,36,34
1656942244839,MATH 103A,B03,093562,Greenfeld; Be'Eri,2,0,36,34
1656942250864,MATH 105,A01,085443,Carter; Anne Toulson,13,0,35,22
1656942250864,MATH 105,A02,093477,Carter; Anne Toulson,20,0,35,15
1656942256888,MATH 109,A01,083213,Ganzberger; Geoffrey Michael,2,0,34,32
1656942256888,MATH 109,A02,083214,Ganzberger; Geoffrey Michael,2,0,34,32
1656942256888,MATH 109,A03,093478,Ganzberger; Geoffrey Michael,1,0,34,33
1656942256888,MATH 109,B01,083215,Ganzberger; Geoffrey Michael,1,0,32,31
1656942256888,MATH 109,B02,083216,Ganzberger; Geoffrey Michael,1,0,32,31
1656942256888,MATH 109,B03,093479,Ganzberger; Geoffrey Michael,6,0,32,26
1656942262912,MATH 142A,A01,083219,Chow; Bennett,6,0,32,26
1656942262912,MATH 142A,A02,083220,Chow; Bennett,10,0,32,22
1656942262912,MATH 142A,A03,093480,Chow; Bennett,7,0,32,25
1656942262912,MATH 142A,B03,093481,Chow; Bennett,7,0,32,25
1656942262912,MATH 142A,B04,093558,Chow; Bennett,11,0,32,21
1656942262912,MATH 142A,B05,093559,Chow; Bennett,6,0,32,26
1656942268937,MATH 193A,A01,083224,Rotar; Vladimir,7,0,34,27
1656942268937,MATH 193A,A02,083225,Rotar; Vladimir,3,0,34,31
1656942268937,MATH 193A,A03,083781,Rotar; Vladimir,1,0,34,33
1656942268937,MATH 193A,A04,083782,Rotar; Vladimir,6,0,34,28
1656942268937,MATH 193A,A05,093482,Rotar; Vladimir,6,0,34,28
1656942274960,MATH 197,001,091859,McAuley; Julian John,9999,0,9999,0
1656942274960,MATH 197,002,095566,Kedlaya; Kiran S.,9997,0,9999,2
1656942274960,MATH 197,003,095567,Xiao; Ming,9999,0,9999,0
1656942274960,MATH 197,004,095571,Perols; Johan Lars,9998,0,9999,1
1656942282016,COGS 9,A01,083615,Shannon; Kyle Michael,7,0,75,68
1656942288039,COGS 11,A01,083617,Boyle; Mary E. T.,19,0,48,29
1656942294062,COGS 13,A01,083071,Bastos; Amalia Pinkusfeld,9,0,71,62
1656942300089,COGS 14A,A01,092681,Semenuks; Arturs,0,1,100,100
1656942306112,COGS 14B,A01,083073,Cheng; Tzu-Han,5,0,63,58
1656942312136,COGS 17,A01,092677,Semenuks; Arturs,4,0,81,77
1656942318164,COGS 100,A01,083619,Allen; Michael Gordon,15,0,70,55
1656942324188,COGS 101A,A01,083621,Davis; Joshua Daniel,9,0,68,59
1656942330215,COGS 101B,A01,091572,Allen; Michael Gordon,8,0,65,57
1656942336240,COGS 101C,A01,083625,Delgado; Tania,17,0,35,18
1656942342264,COGS 107A,A01,083627,Boyle; Mary E. T.,13,0,60,47
1656942348288,COGS 118A,A01,083075,Gupta; Anjum,15,0,76,61
1656942354316,CSE 3,A50,083646,Miranda; Gregory Joseph,22,0,50,28
1656942360340,CSE 8A,A50,083650,Miranda; Gregory Joseph,17,1,56,39
1656942366365,CSE 11,A01,083080,Cao; Yingjun,4,15,40,36
1656942372393,CSE 12,A01,083652,Krause-Levy; Sophia Louisa,20,1,120,100
1656942378415,CSE 15L,A01,083654,Morris; Justin Loren,8,0,50,42
1656942378415,CSE 15L,A02,083655,Morris; Justin Loren,8,0,50,42
1656942384445,CSE 20,A01,083657,Tran; Khoa Dang,37,0,80,43
1656942390473,CSE 21,A01,095574,Bach; Quang Tran,21,0,48,27
1656942396510,CSE 30,A01,083084,Eldon; John,4,0,80,76
1656942396510,CSE 30,B01,095061,Bhaskar; Nishant,6,0,50,44
1656942402539,CSE 100,A01,083659,Cao; Yingjun,3,4,70,67
1656942408564,CSE 134B,A01,083661,Powell; Thomas Allan,19,0,100,81
1656942414588,CSE 140,A01,083663,Gungor; Onat,14,0,85,71
1656942420615,CSE 140L,A01,083088,Eldon; John,16,0,100,84
1656942426638,CSE 175,A01,083665,Kumar; Rakesh,3,0,25,22
1656942432665,CSE 190,A00,092507,Dubnov; Shlomo,7,0,20,13
1656942438693,ECE 45,A01,083139,Congero; Spencer William,5,0,75,70
1656942444728,ECE 65,A50,083695,Saad; Andrew S,12,0,30,18
1656942444728,ECE 65,A51,095125,Saad; Andrew S,25,0,26,1
1656942450757,ECE 109,A01,091882,Touri; Behrouz,16,0,70,54
1656942456782,ECE 180,A00,083140,Abi Samra; Nicholas Camill,0,0,30,30
1656942456782,ECE 180,B00,083141,Abi Samra; Nicholas Camill,0,0,30,30
1656942462811,MATH 10A,A01,083735,Patchell; Gregory David,1,0,30,29
1656942462811,MATH 10A,A02,083736,Patchell; Gregory David,20,0,30,10
1656942462811,MATH 10A,A03,083737,Patchell; Gregory David,15,0,30,15
1656942468839,MATH 10B,A01,083207,Lim; Seonhee,7,0,34,27
1656942468839,MATH 10B,A02,083208,Lim; Seonhee,9,0,35,26
1656942468839,MATH 10B,A03,093472,Lim; Seonhee,4,0,34,30
1656942468839,MATH 10B,B01,083739,Sinha; Shubham,9,0,30,21
1656942474863,MATH 18,A01,083743,Cinel; Cameron Alexander,6,0,30,24
1656942474863,MATH 18,A02,083744,Cinel; Cameron Alexander,15,0,30,15
1656942474863,MATH 18,A03,083745,Cinel; Cameron Alexander,8,0,30,22
1656942474863,MATH 18,B01,083748,Rideout; David Porter,4,0,37,33
1656942474863,MATH 18,B02,083749,Rideout; David Porter,3,0,36,33
1656942474863,MATH 18,B03,083750,Rideout; David Porter,2,0,37,35
1656942474863,MATH 18,B04,083751,Rideout; David Porter,5,0,36,31
1656942474863,MATH 18,B05,093473,Rideout; David Porter,4,0,36,32
1656942474863,MATH 18,B06,093474,Rideout; David Porter,5,0,36,31
1656942480888,MATH 20A,A01,083754,Zheng; Zequn,12,0,40,28
1656942486916,MATH 20B,A01,083756,Briones; Jor-el Thomas Caparas,1,0,36,35
1656942486916,MATH 20B,A02,083757,Briones; Jor-el Thomas Caparas,1,0,36,35
1656942486916,MATH 20B,A03,093475,Briones; Jor-el Thomas Caparas,0,0,36,36
1656942492942,MATH 20C,A01,083760,Briones; Jor-el Thomas Caparas,1,0,35,34
1656942492942,MATH 20C,A02,083761,Briones; Jor-el Thomas Caparas,8,0,35,27
1656942492942,MATH 20C,A03,093476,Briones; Jor-el Thomas Caparas,0,1,36,36
1656942492942,MATH 20C,B01,083762,Bach; Quang Tran,0,0,30,30
1656942498969,MATH 20D,A01,083765,Tran; Brian Kha,4,0,30,26
1656942498969,MATH 20D,A02,083766,Tran; Brian Kha,4,0,30,26
1656942498969,MATH 20D,A03,083767,Tran; Brian Kha,3,0,30,27
1656942504994,MATH 20E,A01,083771,Ganguly; Soumya,5,0,32,27
1656942504994,MATH 20E,A02,083772,Ganguly; Soumya,6,0,32,26
1656942504994,MATH 20E,B01,083773,Ciotti; Benjamin,18,0,35,17
1656942504994,MATH 20E,B02,083774,Ciotti; Benjamin,17,0,35,18
1656942511020,MATH 103A,A01,083777,Greenfeld; Be'Eri,2,0,36,34
1656942511020,MATH 103A,A02,083778,Greenfeld; Be'Eri,5,0,36,31
1656942511020,MATH 103A,A03,093561,Greenfeld; Be'Eri,4,0,36,32
1656942511020,MATH 103A,B01,083779,Greenfeld; Be'Eri,6,0,36,30
1656942511020,MATH 103A,B02,083780,Greenfeld; Be'Eri,2,0,36,34
1656942511020,MATH 103A,B03,093562,Greenfeld; Be'Eri,2,0,36,34
1656942517047,MATH 105,A01,085443,Carter; Anne Toulson,13,0,35,22
1656942517047,MATH 105,A02,093477,Carter; Anne Toulson,20,0,35,15
1656942523076,MATH 109,A01,083213,Ganzberger; Geoffrey Michael,2,0,34,32
1656942523076,MATH 109,A02,083214,Ganzberger; Geoffrey Michael,2,0,34,32
1656942523076,MATH 109,A03,093478,Ganzberger; Geoffrey Michael,1,0,34,33
1656942523076,MATH 109,B01,083215,Ganzberger; Geoffrey Michael,1,0,32,31
1656942523076,MATH 109,B02,083216,Ganzberger; Geoffrey Michael,1,0,32,31
1656942523076,MATH 109,B03,093479,Ganzberger; Geoffrey Michael,6,0,32,26
1656942529107,MATH 142A,A01,083219,Chow; Bennett,6,0,32,26
1656942529107,MATH 142A,A02,083220,Chow; Bennett,10,0,32,22
1656942529107,MATH 142A,A03,093480,Chow; Bennett,7,0,32,25
1656942529107,MATH 142A,B03,093481,Chow; Bennett,7,0,32,25
1656942529107,MATH 142A,B04,093558,Chow; Bennett,11,0,32,21
1656942529107,MATH 142A,B05,093559,Chow; Bennett,6,0,32,26
1656942535132,MATH 193A,A01,083224,Rotar; Vladimir,7,0,34,27
1656942535132,MATH 193A,A02,083225,Rotar; Vladimir,3,0,34,31
1656942535132,MATH 193A,A03,083781,Rotar; Vladimir,1,0,34,33
1656942535132,MATH 193A,A04,083782,Rotar; Vladimir,6,0,34,28
1656942535132,MATH 193A,A05,093482,Rotar; Vladimir,6,0,34,28
1656942541155,MATH 197,001,091859,McAuley; Julian John,9999,0,9999,0
1656942541155,MATH 197,002,095566,Kedlaya; Kiran S.,9997,0,9999,2
1656942541155,MATH 197,003,095567,Xiao; Ming,9999,0,9999,0
1656942541155,MATH 197,004,095571,Perols; Johan Lars,9998,0,9999,1
1656942548227,COGS 9,A01,083615,Shannon; Kyle Michael,7,0,75,68
1656942554257,COGS 11,A01,083617,Boyle; Mary E. T.,19,0,48,29
1656942560281,COGS 13,A01,083071,Bastos; Amalia Pinkusfeld,9,0,71,62
1656942566305,COGS 14A,A01,092681,Semenuks; Arturs,0,1,100,100
1656942572330,COGS 14B,A01,083073,Cheng; Tzu-Han,5,0,63,58
1656942578355,COGS 17,A01,092677,Semenuks; Arturs,4,0,81,77
1656942584379,COGS 100,A01,083619,Allen; Michael Gordon,15,0,70,55
1656942590403,COGS 101A,A01,083621,Davis; Joshua Daniel,9,0,68,59
1656942596434,COGS 101B,A01,091572,Allen; Michael Gordon,8,0,65,57
1656942602463,COGS 101C,A01,083625,Delgado; Tania,17,0,35,18
1656942608491,COGS 107A,A01,083627,Boyle; Mary E. T.,13,0,60,47
1656942614516,COGS 118A,A01,083075,Gupta; Anjum,15,0,76,61
1656942620539,CSE 3,A50,083646,Miranda; Gregory Joseph,22,0,50,28
1656942626562,CSE 8A,A50,083650,Miranda; Gregory Joseph,17,1,56,39
1656942632588,CSE 11,A01,083080,Cao; Yingjun,4,15,40,36
1656942638613,CSE 12,A01,083652,Krause-Levy; Sophia Louisa,20,1,120,100
1656942644637,CSE 15L,A01,083654,Morris; Justin Loren,8,0,50,42
1656942644637,CSE 15L,A02,083655,Morris; Justin Loren,8,0,50,42
1656942650665,CSE 20,A01,083657,Tran; Khoa Dang,37,0,80,43
1656942656689,CSE 21,A01,095574,Bach; Quang Tran,21,0,48,27
1656942662719,CSE 30,A01,083084,Eldon; John,4,0,80,76
1656942662719,CSE 30,B01,095061,Bhaskar; Nishant,6,0,50,44
1656942668741,CSE 100,A01,083659,Cao; Yingjun,3,4,70,67
1656942674768,CSE 134B,A01,083661,Powell; Thomas Allan,19,0,100,81
1656942680794,CSE 140,A01,083663,Gungor; Onat,14,0,85,71
1656942686821,CSE 140L,A01,083088,Eldon; John,16,0,100,84
1656942692846,CSE 175,A01,083665,Kumar; Rakesh,3,0,25,22
1656942698872,CSE 190,A00,092507,Dubnov; Shlomo,7,0,20,13
1656942704977,ECE 45,A01,083139,Congero; Spencer William,5,0,75,70
1656942711002,ECE 65,A50,083695,Saad; Andrew S,12,0,30,18
1656942711002,ECE 65,A51,095125,Saad; Andrew S,25,0,26,1
1656942717026,ECE 109,A01,091882,Touri; Behrouz,16,0,70,54
1656942723053,ECE 180,A00,083140,Abi Samra; Nicholas Camill,0,0,30,30
1656942723053,ECE 180,B00,083141,Abi Samra; Nicholas Camill,0,0,30,30
1656942729077,MATH 10A,A01,083735,Patchell; Gregory David,1,0,30,29
1656942729077,MATH 10A,A02,083736,Patchell; Gregory David,20,0,30,10
1656942729077,MATH 10A,A03,083737,Patchell; Gregory David,15,0,30,15
1656942735106,MATH 10B,A01,083207,Lim; Seonhee,7,0,34,27
1656942735106,MATH 10B,A02,083208,Lim; Seonhee,9,0,35,26
1656942735106,MATH 10B,A03,093472,Lim; Seonhee,4,0,34,30
1656942735106,MATH 10B,B01,083739,Sinha; Shubham,9,0,30,21
1656942741138,MATH 18,A01,083743,Cinel; Cameron Alexander,6,0,30,24
1656942741138,MATH 18,A02,083744,Cinel; Cameron Alexander,15,0,30,15
1656942741138,MATH 18,A03,083745,Cinel; Cameron Alexander,8,0,30,22
1656942741138,MATH 18,B01,083748,Rideout; David Porter,4,0,37,33
1656942741138,MATH 18,B02,083749,Rideout; David Porter,3,0,36,33
1656942741138,MATH 18,B03,083750,Rideout; David Porter,2,0,37,35
1656942741138,MATH 18,B04,083751,Rideout; David Porter,5,0,36,31
1656942741138,MATH 18,B05,093473,Rideout; David Porter,4,0,36,32
1656942741138,MATH 18,B06,093474,Rideout; David Porter,5,0,36,31
1656942747165,MATH 20A,A01,083754,Zheng; Zequn,12,0,40,28
1656942753193,MATH 20B,A01,083756,Briones; Jor-el Thomas Caparas,1,0,36,35
1656942753193,MATH 20B,A02,083757,Briones; Jor-el Thomas Caparas,1,0,36,35
1656942753193,MATH 20B,A03,093475,Briones; Jor-el Thomas Caparas,0,0,36,36
1656942759224,MATH 20C,A01,083760,Briones; Jor-el Thomas Caparas,1,0,35,34
1656942759224,MATH 20C,A02,083761,Briones; Jor-el Thomas Caparas,8,0,35,27
1656942759224,MATH 20C,A03,093476,Briones; Jor-el Thomas Caparas,0,1,36,36
1656942759224,MATH 20C,B01,083762,Bach; Quang Tran,0,0,30,30
1656942765253,MATH 20D,A01,083765,Tran; Brian Kha,4,0,30,26
1656942765253,MATH 20D,A02,083766,Tran; Brian Kha,4,0,30,26
1656942765253,MATH 20D,A03,083767,Tran; Brian Kha,3,0,30,27
1656942771276,MATH 20E,A01,083771,Ganguly; Soumya,5,0,32,27
1656942771276,MATH 20E,A02,083772,Ganguly; Soumya,6,0,32,26
1656942771276,MATH 20E,B01,083773,Ciotti; Benjamin,18,0,35,17
1656942771276,MATH 20E,B02,083774,Ciotti; Benjamin,17,0,35,18
1656942777302,MATH 103A,A01,083777,Greenfeld; Be'Eri,2,0,36,34
1656942777302,MATH 103A,A02,083778,Greenfeld; Be'Eri,5,0,36,31
1656942777302,MATH 103A,A03,093561,Greenfeld; Be'Eri,4,0,36,32
1656942777302,MATH 103A,B01,083779,Greenfeld; Be'Eri,6,0,36,30
1656942777302,MATH 103A,B02,083780,Greenfeld; Be'Eri,2,0,36,34
1656942777302,MATH 103A,B03,093562,Greenfeld; Be'Eri,2,0,36,34
1656942783331,MATH 105,A01,085443,Carter; Anne Toulson,13,0,35,22
1656942783331,MATH 105,A02,093477,Carter; Anne Toulson,20,0,35,15
1656942789355,MATH 109,A01,083213,Ganzberger; Geoffrey Michael,2,0,34,32
1656942789355,MATH 109,A02,083214,Ganzberger; Geoffrey Michael,2,0,34,32
1656942789355,MATH 109,A03,093478,Ganzberger; Geoffrey Michael,1,0,34,33
1656942789355,MATH 109,B01,083215,Ganzberger; Geoffrey Michael,1,0,32,31
1656942789355,MATH 109,B02,083216,Ganzberger; Geoffrey Michael,1,0,32,31
1656942789355,MATH 109,B03,093479,Ganzberger; Geoffrey Michael,6,0,32,26
1656942795380,MATH 142A,A01,083219,Chow; Bennett,6,0,32,26
1656942795380,MATH 142A,A02,083220,Chow; Bennett,10,0,32,22
1656942795380,MATH 142A,A03,093480,Chow; Bennett,7,0,32,25
1656942795380,MATH 142A,B03,093481,Chow; Bennett,7,0,32,25
1656942795380,MATH 142A,B04,093558,Chow; Bennett,11,0,32,21
1656942795380,MATH 142A,B05,093559,Chow; Bennett,6,0,32,26
1656942801403,MATH 193A,A01,083224,Rotar; Vladimir,7,0,34,27
1656942801403,MATH 193A,A02,083225,Rotar; Vladimir,3,0,34,31
1656942801403,MATH 193A,A03,083781,Rotar; Vladimir,1,0,34,33
1656942801403,MATH 193A,A04,083782,Rotar; Vladimir,6,0,34,28
1656942801403,MATH 193A,A05,093482,Rotar; Vladimir,6,0,34,28
1656942807427,MATH 197,001,091859,McAuley; Julian John,9999,0,9999,0
1656942807427,MATH 197,002,095566,Kedlaya; Kiran S.,9997,0,9999,2
1656942807427,MATH 197,003,095567,Xiao; Ming,9999,0,9999,0
1656942807427,MATH 197,004,095571,Perols; Johan Lars,9998,0,9999,1
1656942814483,COGS 9,A01,083615,Shannon; Kyle Michael,7,0,75,68
1656942820510,COGS 11,A01,083617,Boyle; Mary E. T.,19,0,48,29
1656942826537,COGS 13,A01,083071,Bastos; Amalia Pinkusfeld,9,0,71,62
1656942832565,COGS 14A,A01,092681,Semenuks; Arturs,0,1,100,100
1656942838588,COGS 14B,A01,083073,Cheng; Tzu-Han,5,0,63,58
1656942844616,COGS 17,A01,092677,Semenuks; Arturs,4,0,81,77
1656942850640,COGS 100,A01,083619,Allen; Michael Gordon,15,0,70,55
1656942856675,COGS 101A,A01,083621,Davis; Joshua Daniel,9,0,68,59
1656942862697,COGS 101B,A01,091572,Allen; Michael Gordon,8,0,65,57
1656942868719,COGS 101C,A01,083625,Delgado; Tania,17,0,35,18
1656942874742,COGS 107A,A01,083627,Boyle; Mary E. T.,13,0,60,47
1656942880764,COGS 118A,A01,083075,Gupta; Anjum,15,0,76,61
1656942886791,CSE 3,A50,083646,Miranda; Gregory Joseph,22,0,50,28
1656942892819,CSE 8A,A50,083650,Miranda; Gregory Joseph,17,1,56,39
1656942898842,CSE 11,A01,083080,Cao; Yingjun,4,15,40,36
1656942904875,CSE 12,A01,083652,Krause-Levy; Sophia Louisa,20,1,120,100
1656942910899,CSE 15L,A01,083654,Morris; Justin Loren,8,0,50,42
1656942910899,CSE 15L,A02,083655,Morris; Justin Loren,8,0,50,42
1656942916927,CSE 20,A01,083657,Tran; Khoa Dang,37,0,80,43
1656942922951,CSE 21,A01,095574,Bach; Quang Tran,21,0,48,27
1656942928974,CSE 30,A01,083084,Eldon; John,4,0,80,76
1656942928974,CSE 30,B01,095061,Bhaskar; Nishant,6,0,50,44
1656942935002,CSE 100,A01,083659,Cao; Yingjun,3,4,70,67
1656942941029,CSE 134B,A01,083661,Powell; Thomas Allan,19,0,100,81
1656942947052,CSE 140,A01,083663,Gungor; Onat,14,0,85,71
1656942953075,CSE 140L,A01,083088,Eldon; John,16,0,100,84
1656942959102,CSE 175,A01,083665,Kumar; Rakesh,3,0,25,22
1656942965130,CSE 190,A00,092507,Dubnov; Shlomo,7,0,20,13
1656942971152,ECE 45,A01,083139,Congero; Spencer William,5,0,75,70
1656942977176,ECE 65,A50,083695,Saad; Andrew S,12,0,30,18
1656942977176,ECE 65,A51,095125,Saad; Andrew S,25,0,26,1
1656942983203,ECE 109,A01,091882,Touri; Behrouz,16,0,70,54
1656942989226,ECE 180,A00,083140,Abi Samra; Nicholas Camill,0,0,30,30
1656942989226,ECE 180,B00,083141,Abi Samra; Nicholas Camill,0,0,30,30
1656942995251,MATH 10A,A01,083735,Patchell; Gregory David,1,0,30,29
1656942995251,MATH 10A,A02,083736,Patchell; Gregory David,20,0,30,10
1656942995251,MATH 10A,A03,083737,Patchell; Gregory David,15,0,30,15
1656943001276,MATH 10B,A01,083207,Lim; Seonhee,7,0,34,27
1656943001276,MATH 10B,A02,083208,Lim; Seonhee,9,0,35,26
1656943001276,MATH 10B,A03,093472,Lim; Seonhee,4,0,34,30
1656943001276,MATH 10B,B01,083739,Sinha; Shubham,9,0,30,21
1656943007309,MATH 18,A01,083743,Cinel; Cameron Alexander,6,0,30,24
1656943007309,MATH 18,A02,083744,Cinel; Cameron Alexander,15,0,30,15
1656943007309,MATH 18,A03,083745,Cinel; Cameron Alexander,8,0,30,22
1656943007309,MATH 18,B01,083748,Rideout; David Porter,4,0,37,33
1656943007309,MATH 18,B02,083749,Rideout; David Porter,3,0,36,33
1656943007309,MATH 18,B03,083750,Rideout; David Porter,2,0,37,35
1656943007309,MATH 18,B04,083751,Rideout; David Porter,5,0,36,31
1656943007309,MATH 18,B05,093473,Rideout; David Porter,4,0,36,32
1656943007309,MATH 18,B06,093474,Rideout; David Porter,5,0,36,31
1656943013333,MATH 20A,A01,083754,Zheng; Zequn,12,0,40,28
1656943019359,MATH 20B,A01,083756,Briones; Jor-el Thomas Caparas,1,0,36,35
1656943019359,MATH 20B,A02,083757,Briones; Jor-el Thomas Caparas,1,0,36,35
1656943019359,MATH 20B,A03,093475,Briones; Jor-el Thomas Caparas,0,0,36,36
1656943025385,MATH 20C,A01,083760,Briones; Jor-el Thomas Caparas,1,0,35,34
1656943025385,MATH 20C,A02,083761,Briones; Jor-el Thomas Caparas,8,0,35,27
1656943025385,MATH 20C,A03,093476,Briones; Jor-el Thomas Caparas,0,1,36,36
1656943025385,MATH 20C,B01,083762,Bach; Quang Tran,0,0,30,30
1656943031409,MATH 20D,A01,083765,Tran; Brian Kha,4,0,30,26
1656943031409,MATH 20D,A02,083766,Tran; Brian Kha,4,0,30,26
1656943031409,MATH 20D,A03,083767,Tran; Brian Kha,3,0,30,27
1656943037434,MATH 20E,A01,083771,Ganguly; Soumya,5,0,32,27
1656943037434,MATH 20E,A02,083772,Ganguly; Soumya,6,0,32,26
1656943037434,MATH 20E,B01,083773,Ciotti; Benjamin,18,0,35,17
1656943037434,MATH 20E,B02,083774,Ciotti; Benjamin,17,0,35,18
1656943043460,MATH 103A,A01,083777,Greenfeld; Be'Eri,2,0,36,34
1656943043460,MATH 103A,A02,083778,Greenfeld; Be'Eri,5,0,36,31
1656943043460,MATH 103A,A03,093561,Greenfeld; Be'Eri,4,0,36,32
1656943043460,MATH 103A,B01,083779,Greenfeld; Be'Eri,6,0,36,30
1656943043460,MATH 103A,B02,083780,Greenfeld; Be'Eri,2,0,36,34
1656943043460,MATH 103A,B03,093562,Greenfeld; Be'Eri,2,0,36,34
1656943049486,MATH 105,A01,085443,Carter; Anne Toulson,13,0,35,22
1656943049486,MATH 105,A02,093477,Carter; Anne Toulson,20,0,35,15
1656943055546,MATH 109,A01,083213,Ganzberger; Geoffrey Michael,2,0,34,32
1656943055546,MATH 109,A02,083214,Ganzberger; Geoffrey Michael,2,0,34,32
1656943055546,MATH 109,A03,093478,Ganzberger; Geoffrey Michael,1,0,34,33
1656943055546,MATH 109,B01,083215,Ganzberger; Geoffrey Michael,1,0,32,31
1656943055546,MATH 109,B02,083216,Ganzberger; Geoffrey Michael,1,0,32,31
1656943055546,MATH 109,B03,093479,Ganzberger; Geoffrey Michael,6,0,32,26
1656943061577,MATH 142A,A01,083219,Chow; Bennett,6,0,32,26
1656943061577,MATH 142A,A02,083220,Chow; Bennett,10,0,32,22
1656943061577,MATH 142A,A03,093480,Chow; Bennett,7,0,32,25
1656943061577,MATH 142A,B03,093481,Chow; Bennett,7,0,32,25
1656943061577,MATH 142A,B04,093558,Chow; Bennett,11,0,32,21
1656943061577,MATH 142A,B05,093559,Chow; Bennett,6,0,32,26
1656943067602,MATH 193A,A01,083224,Rotar; Vladimir,7,0,34,27
1656943067602,MATH 193A,A02,083225,Rotar; Vladimir,3,0,34,31
1656943067602,MATH 193A,A03,083781,Rotar; Vladimir,1,0,34,33
1656943067602,MATH 193A,A04,083782,Rotar; Vladimir,6,0,34,28
1656943067602,MATH 193A,A05,093482,Rotar; Vladimir,6,0,34,28
1656943073625,MATH 197,001,091859,McAuley; Julian John,9999,0,9999,0
1656943073625,MATH 197,002,095566,Kedlaya; Kiran S.,9997,0,9999,2
1656943073625,MATH 197,003,095567,Xiao; Ming,9999,0,9999,0
1656943073625,MATH 197,004,095571,Perols; Johan Lars,9998,0,9999,1
1656943080684,COGS 9,A01,083615,Shannon; Kyle Michael,7,0,75,68
1656943086707,COGS 11,A01,083617,Boyle; Mary E. T.,19,0,48,29
1656943092731,COGS 13,A01,083071,Bastos; Amalia Pinkusfeld,9,0,71,62
1656943098756,COGS 14A,A01,092681,Semenuks; Arturs,0,1,100,100
1656943104779,COGS 14B,A01,083073,Cheng; Tzu-Han,5,0,63,58
1656943110805,COGS 17,A01,092677,Semenuks; Arturs,4,0,81,77
1656943116832,COGS 100,A01,083619,Allen; Michael Gordon,15,0,70,55
1656943122858,COGS 101A,A01,083621,Davis; Joshua Daniel,9,0,68,59
1656943128882,COGS 101B,A01,091572,Allen; Michael Gordon,8,0,65,57
1656943134909,COGS 101C,A01,083625,Delgado; Tania,17,0,35,18
1656943140935,COGS 107A,A01,083627,Boyle; Mary E. T.,13,0,60,47
1656943146958,COGS 118A,A01,083075,Gupta; Anjum,15,0,76,61
1656943152982,CSE 3,A50,083646,Miranda; Gregory Joseph,22,0,50,28
1656943159017,CSE 8A,A50,083650,Miranda; Gregory Joseph,17,1,56,39
1656943165044,CSE 11,A01,083080,Cao; Yingjun,4,15,40,36
1656943171077,CSE 12,A01,083652,Krause-Levy; Sophia Louisa,20,1,120,100
1656943177101,CSE 15L,A01,083654,Morris; Justin Loren,8,0,50,42
1656943177101,CSE 15L,A02,083655,Morris; Justin Loren,8,0,50,42
1656943183128,CSE 20,A01,083657,Tran; Khoa Dang,37,0,80,43
1656943189152,CSE 21,A01,095574,Bach; Quang Tran,21,0,48,27
1656943195181,CSE 30,A01,083084,Eldon; John,4,0,80,76
1656943195181,CSE 30,B01,095061,Bhaskar; Nishant,6,0,50,44
1656943201213,CSE 100,A01,083659,Cao; Yingjun,3,4,70,67
1656943207239,CSE 134B,A01,083661,Powell; Thomas Allan,19,0,100,81
1656943213262,CSE 140,A01,083663,Gungor; Onat,14,0,85,71
1656943219290,CSE 140L,A01,083088,Eldon; John,16,0,100,84
1656943225316,CSE 175,A01,083665,Kumar; Rakesh,3,0,25,22
1656943231342,CSE 190,A00,092507,Dubnov; Shlomo,7,0,20,13
1656943237366,ECE 45,A01,083139,Congero; Spencer William,5,0,75,70
1656943243397,ECE 65,A50,083695,Saad; Andrew S,12,0,30,18
1656943243397,ECE 65,A51,095125,Saad; Andrew S,25,0,26,1
1656943249422,ECE 109,A01,091882,Touri; Behrouz,16,0,70,54
1656943255450,ECE 180,A00,083140,Abi Samra; Nicholas Camill,0,0,30,30
1656943255450,ECE 180,B00,083141,Abi Samra; Nicholas Camill,0,0,30,30
1656943261474,MATH 10A,A01,083735,Patchell; Gregory David,1,0,30,29
1656943261474,MATH 10A,A02,083736,Patchell; Gregory David,20,0,30,10
1656943261474,MATH 10A,A03,083737,Patchell; Gregory David,15,0,30,15
1656943267507,MATH 10B,A01,083207,Lim; Seonhee,7,0,34,27
1656943267507,MATH 10B,A02,083208,Lim; Seonhee,9,0,35,26
1656943267507,MATH 10B,A03,093472,Lim; Seonhee,4,0,34,30
1656943267507,MATH 10B,B01,083739,Sinha; Shubham,9,0,30,21
1656943273549,MATH 18,A01,083743,Cinel; Cameron Alexander,6,0,30,24
1656943273549,MATH 18,A02,083744,Cinel; Cameron Alexander,15,0,30,15
1656943273549,MATH 18,A03,083745,Cinel; Cameron Alexander,8,0,30,22
1656943273549,MATH 18,B01,083748,Rideout; David Porter,4,0,37,33
1656943273549,MATH 18,B02,083749,Rideout; David Porter,3,0,36,33
1656943273549,MATH 18,B03,083750,Rideout; David Porter,2,0,37,35
1656943273549,MATH 18,B04,083751,Rideout; David Porter,5,0,36,31
1656943273549,MATH 18,B05,093473,Rideout; David Porter,4,0,36,32
1656943273549,MATH 18,B06,093474,Rideout; David Porter,5,0,36,31
1656943279574,MATH 20A,A01,083754,Zheng; Zequn,12,0,40,28
1656943285599,MATH 20B,A01,083756,Briones; Jor-el Thomas Caparas,1,0,36,35
1656943285599,MATH 20B,A02,083757,Briones; Jor-el Thomas Caparas,1,0,36,35
1656943285599,MATH 20B,A03,093475,Briones; Jor-el Thomas Caparas,0,0,36,36
1656943291633,MATH 20C,A01,083760,Briones; Jor-el Thomas Caparas,1,0,35,34
1656943291633,MATH 20C,A02,083761,Briones; Jor-el Thomas Caparas,8,0,35,27
1656943291633,MATH 20C,A03,093476,Briones; Jor-el Thomas Caparas,0,1,36,36
1656943291633,MATH 20C,B01,083762,Bach; Quang Tran,0,0,30,30
1656943297661,MATH 20D,A01,083765,Tran; Brian Kha,4,0,30,26
1656943297661,MATH 20D,A02,083766,Tran; Brian Kha,4,0,30,26
1656943297661,MATH 20D,A03,083767,Tran; Brian Kha,3,0,30,27
1656943303779,MATH 20E,A01,083771,Ganguly; Soumya,5,0,32,27
1656943303779,MATH 20E,A02,083772,Ganguly; Soumya,6,0,32,26
1656943303779,MATH 20E,B01,083773,Ciotti; Benjamin,18,0,35,17
1656943303779,MATH 20E,B02,083774,Ciotti; Benjamin,17,0,35,18
1656943309816,MATH 103A,A01,083777,Greenfeld; Be'Eri,2,0,36,34
1656943309816,MATH 103A,A02,083778,Greenfeld; Be'Eri,5,0,36,31
1656943309816,MATH 103A,A03,093561,Greenfeld; Be'Eri,4,0,36,32
1656943309816,MATH 103A,B01,083779,Greenfeld; Be'Eri,6,0,36,30
1656943309816,MATH 103A,B02,083780,Greenfeld; Be'Eri,2,0,36,34
1656943309816,MATH 103A,B03,093562,Greenfeld; Be'Eri,2,0,36,34
1656943315846,MATH 105,A01,085443,Carter; Anne Toulson,13,0,35,22
1656943315846,MATH 105,A02,093477,Carter; Anne Toulson,20,0,35,15
1656943321878,MATH 109,A01,083213,Ganzberger; Geoffrey Michael,2,0,34,32
1656943321878,MATH 109,A02,083214,Ganzberger; Geoffrey Michael,2,0,34,32
1656943321878,MATH 109,A03,093478,Ganzberger; Geoffrey Michael,1,0,34,33
1656943321878,MATH 109,B01,083215,Ganzberger; Geoffrey Michael,1,0,32,31
1656943321878,MATH 109,B02,083216,Ganzberger; Geoffrey Michael,1,0,32,31
1656943321878,MATH 109,B03,093479,Ganzberger; Geoffrey Michael,6,0,32,26
1656943327904,MATH 142A,A01,083219,Chow; Bennett,6,0,32,26
1656943327904,MATH 142A,A02,083220,Chow; Bennett,10,0,32,22
1656943327904,MATH 142A,A03,093480,Chow; Bennett,7,0,32,25
1656943327904,MATH 142A,B03,093481,Chow; Bennett,7,0,32,25
1656943327904,MATH 142A,B04,093558,Chow; Bennett,11,0,32,21
1656943327904,MATH 142A,B05,093559,Chow; Bennett,6,0,32,26
1656943333930,MATH 193A,A01,083224,Rotar; Vladimir,7,0,34,27
1656943333930,MATH 193A,A02,083225,Rotar; Vladimir,3,0,34,31
1656943333930,MATH 193A,A03,083781,Rotar; Vladimir,1,0,34,33
1656943333930,MATH 193A,A04,083782,Rotar; Vladimir,6,0,34,28
1656943333930,MATH 193A,A05,093482,Rotar; Vladimir,6,0,34,28
1656943339954,MATH 197,001,091859,McAuley; Julian John,9999,0,9999,0
1656943339954,MATH 197,002,095566,Kedlaya; Kiran S.,9997,0,9999,2
1656943339954,MATH 197,003,095567,Xiao; Ming,9999,0,9999,0
1656943339954,MATH 197,004,095571,Perols; Johan Lars,9998,0,9999,1
1656943347014,COGS 9,A01,083615,Shannon; Kyle Michael,7,0,75,68
1656943353054,COGS 11,A01,083617,Boyle; Mary E. T.,19,0,48,29
1656943359082,COGS 13,A01,083071,Bastos; Amalia Pinkusfeld,9,0,71,62
1656943365110,COGS 14A,A01,092681,Semenuks; Arturs,0,1,100,100
1656943371138,COGS 14B,A01,083073,Cheng; Tzu-Han,5,0,63,58
1656943377164,COGS 17,A01,092677,Semenuks; Arturs,4,0,81,77
1656943383189,COGS 100,A01,083619,Allen; Michael Gordon,15,0,70,55
1656943389213,COGS 101A,A01,083621,Davis; Joshua Daniel,9,0,68,59
1656943395240,COGS 101B,A01,091572,Allen; Michael Gordon,8,0,65,57
1656943401268,COGS 101C,A01,083625,Delgado; Tania,17,0,35,18
1656943407291,COGS 107A,A01,083627,Boyle; Mary E. T.,13,0,60,47
1656943413319,COGS 118A,A01,083075,Gupta; Anjum,15,0,76,61
1656943419344,CSE 3,A50,083646,Miranda; Gregory Joseph,22,0,50,28
1656943425373,CSE 8A,A50,083650,Miranda; Gregory Joseph,17,1,56,39
1656943431396,CSE 11,A01,083080,Cao; Yingjun,4,15,40,36
1656943437420,CSE 12,A01,083652,Krause-Levy; Sophia Louisa,20,1,120,100
1656943443448,CSE 15L,A01,083654,Morris; Justin Loren,8,0,50,42
1656943443448,CSE 15L,A02,083655,Morris; Justin Loren,8,0,50,42
1656943449474,CSE 20,A01,083657,Tran; Khoa Dang,37,0,80,43
1656943455502,CSE 21,A01,095574,Bach; Quang Tran,21,0,48,27
1656943461526,CSE 30,A01,083084,Eldon; John,4,0,80,76
1656943461526,CSE 30,B01,095061,Bhaskar; Nishant,6,0,50,44
1656943467553,CSE 100,A01,083659,Cao; Yingjun,3,4,70,67
1656943473580,CSE 134B,A01,083661,Powell; Thomas Allan,19,0,100,81
1656943479605,CSE 140,A01,083663,Gungor; Onat,14,0,85,71
1656943485630,CSE 140L,A01,083088,Eldon; John,16,0,100,84
1656943491655,CSE 175,A01,083665,Kumar; Rakesh,3,0,25,22
1656943497681,CSE 190,A00,092507,Dubnov; Shlomo,7,0,20,13
1656943503708,ECE 45,A01,083139,Congero; Spencer William,5,0,75,70
1656943509738,ECE 65,A50,083695,Saad; Andrew S,12,0,30,18
1656943509738,ECE 65,A51,095125,Saad; Andrew S,25,0,26,1
1656943515766,ECE 109,A01,091882,Touri; Behrouz,16,0,70,54
1656943521790,ECE 180,A00,083140,Abi Samra; Nicholas Camill,0,0,30,30
1656943521790,ECE 180,B00,083141,Abi Samra; Nicholas Camill,0,0,30,30
1656943527813,MATH 10A,A01,083735,Patchell; Gregory David,1,0,30,29
1656943527813,MATH 10A,A02,083736,Patchell; Gregory David,20,0,30,10
1656943527813,MATH 10A,A03,083737,Patchell; Gregory David,15,0,30,15
1656943533844,MATH 10B,A01,083207,Lim; Seonhee,7,0,34,27
1656943533844,MATH 10B,A02,083208,Lim; Seonhee,9,0,35,26
1656943533844,MATH 10B,A03,093472,Lim; Seonhee,4,0,34,30
1656943533844,MATH 10B,B01,083739,Sinha; Shubham,9,0,30,21
1656943539870,MATH 18,A01,083743,Cinel; Cameron Alexander,6,0,30,24
1656943539870,MATH 18,A02,083744,Cinel; Cameron Alexander,15,0,30,15
1656943539870,MATH 18,A03,083745,Cinel; Cameron Alexander,8,0,30,22
1656943539870,MATH 18,B01,083748,Rideout; David Porter,4,0,37,33
1656943539870,MATH 18,B02,083749,Rideout; David Porter,3,0,36,33
1656943539870,MATH 18,B03,083750,Rideout; David Porter,2,0,37,35
1656943539870,MATH 18,B04,083751,Rideout; David Porter,5,0,36,31
1656943539870,MATH 18,B05,093473,Rideout; David Porter,4,0,36,32
1656943539870,MATH 18,B06,093474,Rideout; David Porter,5,0,36,31
1656943545899,MATH 20A,A01,083754,Zheng; Zequn,12,0,40,28
1656943551923,MATH 20B,A01,083756,Briones; Jor-el Thomas Caparas,1,0,36,35
1656943551923,MATH 20B,A02,083757,Briones; Jor-el Thomas Caparas,1,0,36,35
1656943551923,MATH 20B,A03,093475,Briones; Jor-el Thomas Caparas,0,0,36,36
1656943557948,MATH 20C,A01,083760,Briones; Jor-el Thomas Caparas,1,0,35,34
1656943557948,MATH 20C,A02,083761,Briones; Jor-el Thomas Caparas,8,0,35,27
1656943557948,MATH 20C,A03,093476,Briones; Jor-el Thomas Caparas,0,1,36,36
1656943557948,MATH 20C,B01,083762,Bach; Quang Tran,0,0,30,30
1656943563983,MATH 20D,A01,083765,Tran; Brian Kha,4,0,30,26
1656943563983,MATH 20D,A02,083766,Tran; Brian Kha,4,0,30,26
1656943563983,MATH 20D,A03,083767,Tran; Brian Kha,3,0,30,27
1656943570010,MATH 20E,A01,083771,Ganguly; Soumya,5,0,32,27
1656943570010,MATH 20E,A02,083772,Ganguly; Soumya,6,0,32,26
1656943570010,MATH 20E,B01,083773,Ciotti; Benjamin,18,0,35,17
1656943570010,MATH 20E,B02,083774,Ciotti; Benjamin,17,0,35,18
1656943576035,MATH 103A,A01,083777,Greenfeld; Be'Eri,2,0,36,34
1656943576035,MATH 103A,A02,083778,Greenfeld; Be'Eri,5,0,36,31
1656943576035,MATH 103A,A03,093561,Greenfeld; Be'Eri,4,0,36,32
1656943576035,MATH 103A,B01,083779,Greenfeld; Be'Eri,6,0,36,30
1656943576035,MATH 103A,B02,083780,Greenfeld; Be'Eri,2,0,36,34
1656943576035,MATH 103A,B03,093562,Greenfeld; Be'Eri,2,0,36,34
1656943582057,MATH 105,A01,085443,Carter; Anne Toulson,13,0,35,22
1656943582057,MATH 105,A02,093477,Carter; Anne Toulson,20,0,35,15
1656943588083,MATH 109,A01,083213,Ganzberger; Geoffrey Michael,2,0,34,32
1656943588083,MATH 109,A02,083214,Ganzberger; Geoffrey Michael,2,0,34,32
1656943588083,MATH 109,A03,093478,Ganzberger; Geoffrey Michael,1,0,34,33
1656943588083,MATH 109,B01,083215,Ganzberger; Geoffrey Michael,1,0,32,31
1656943588083,MATH 109,B02,083216,Ganzberger; Geoffrey Michael,1,0,32,31
1656943588083,MATH 109,B03,093479,Ganzberger; Geoffrey Michael,6,0,32,26
1656943594112,MATH 142A,A01,083219,Chow; Bennett,6,0,32,26
1656943594112,MATH 142A,A02,083220,Chow; Bennett,10,0,32,22
1656943594112,MATH 142A,A03,093480,Chow; Bennett,7,0,32,25
1656943594112,MATH 142A,B03,093481,Chow; Bennett,7,0,32,25
1656943594112,MATH 142A,B04,093558,Chow; Bennett,11,0,32,21
1656943594112,MATH 142A,B05,093559,Chow; Bennett,6,0,32,26
1656943600142,MATH 193A,A01,083224,Rotar; Vladimir,7,0,34,27
1656943600142,MATH 193A,A02,083225,Rotar; Vladimir,3,0,34,31
1656943600142,MATH 193A,A03,083781,Rotar; Vladimir,1,0,34,33
1656943600142,MATH 193A,A04,083782,Rotar; Vladimir,6,0,34,28
1656943600142,MATH 193A,A05,093482,Rotar; Vladimir,6,0,34,28
1656943606170,MATH 197,001,091859,McAuley; Julian John,9999,0,9999,0
1656943606170,MATH 197,002,095566,Kedlaya; Kiran S.,9997,0,9999,2
1656943606170,MATH 197,003,095567,Xiao; Ming,9999,0,9999,0
1656943606170,MATH 197,004,095571,Perols; Johan Lars,9998,0,9999,1
1656943613238,COGS 9,A01,083615,Shannon; Kyle Michael,7,0,75,68
1656943619262,COGS 11,A01,083617,Boyle; Mary E. T.,19,0,48,29
1656943625289,COGS 13,A01,083071,Bastos; Amalia Pinkusfeld,9,0,71,62
1656943631317,COGS 14A,A01,092681,Semenuks; Arturs,0,1,100,100
1656943637344,COGS 14B,A01,083073,Cheng; Tzu-Han,5,0,63,58
1656943643370,COGS 17,A01,092677,Semenuks; Arturs,4,0,81,77
1656943649405,COGS 100,A01,083619,Allen; Michael Gordon,15,0,70,55
1656943655429,COGS 101A,A01,083621,Davis; Joshua Daniel,9,0,68,59
1656943661452,COGS 101B,A01,091572,Allen; Michael Gordon,8,0,65,57
1656943667484,COGS 101C,A01,083625,Delgado; Tania,17,0,35,18
1656943673509,COGS 107A,A01,083627,Boyle; Mary E. T.,13,0,60,47
1656943679541,COGS 118A,A01,083075,Gupta; Anjum,15,0,76,61
1656943685563,CSE 3,A50,083646,Miranda; Gregory Joseph,22,0,50,28
1656943691587,CSE 8A,A50,083650,Miranda; Gregory Joseph,17,1,56,39
1656943697613,CSE 11,A01,083080,Cao; Yingjun,4,15,40,36
1656943703637,CSE 12,A01,083652,Krause-Levy; Sophia Louisa,20,1,120,100
1656943709663,CSE 15L,A01,083654,Morris; Justin Loren,8,0,50,42
1656943709663,CSE 15L,A02,083655,Morris; Justin Loren,8,0,50,42
1656943715688,CSE 20,A01,083657,Tran; Khoa Dang,37,0,80,43
1656943721717,CSE 21,A01,095574,Bach; Quang Tran,21,0,48,27
1656943727741,CSE 30,A01,083084,Eldon; John,4,0,80,76
1656943727741,CSE 30,B01,095061,Bhaskar; Nishant,6,0,50,44
1656943733765,CSE 100,A01,083659,Cao; Yingjun,3,4,70,67
1656943739789,CSE 134B,A01,083661,Powell; Thomas Allan,19,0,100,81
1656943745814,CSE 140,A01,083663,Gungor; Onat,14,0,85,71
1656943751836,CSE 140L,A01,083088,Eldon; John,16,0,100,84
1656943757862,CSE 175,A01,083665,Kumar; Rakesh,3,0,25,22
1656943763889,CSE 190,A00,092507,Dubnov; Shlomo,7,0,20,13
1656943769918,ECE 45,A01,083139,Congero; Spencer William,5,0,75,70
1656943775941,ECE 65,A50,083695,Saad; Andrew S,12,0,30,18
1656943775941,ECE 65,A51,095125,Saad; Andrew S,25,0,26,1
1656943781964,ECE 109,A01,091882,Touri; Behrouz,16,0,70,54
1656943787991,ECE 180,A00,083140,Abi Samra; Nicholas Camill,0,0,30,30
1656943787991,ECE 180,B00,083141,Abi Samra; Nicholas Camill,0,0,30,30
1656943794018,MATH 10A,A01,083735,Patchell; Gregory David,1,0,30,29
1656943794018,MATH 10A,A02,083736,Patchell; Gregory David,20,0,30,10
1656943794018,MATH 10A,A03,083737,Patchell; Gregory David,15,0,30,15
1656943800042,MATH 10B,A01,083207,Lim; Seonhee,7,0,34,27
1656943800042,MATH 10B,A02,083208,Lim; Seonhee,9,0,35,26
1656943800042,MATH 10B,A03,093472,Lim; Seonhee,4,0,34,30
1656943800042,MATH 10B,B01,083739,Sinha; Shubham,9,0,30,21
1656943806068,MATH 18,A01,083743,Cinel; Cameron Alexander,6,0,30,24
1656943806068,MATH 18,A02,083744,Cinel; Cameron Alexander,15,0,30,15
1656943806068,MATH 18,A03,083745,Cinel; Cameron Alexander,8,0,30,22
1656943806068,MATH 18,B01,083748,Rideout; David Porter,4,0,37,33
1656943806068,MATH 18,B02,083749,Rideout; David Porter,3,0,36,33
1656943806068,MATH 18,B03,083750,Rideout; David Porter,2,0,37,35
1656943806068,MATH 18,B04,083751,Rideout; David Porter,5,0,36,31
1656943806068,MATH 18,B05,093473,Rideout; David Porter,4,0,36,32
1656943806068,MATH 18,B06,093474,Rideout; David Porter,5,0,36,31
1656943812090,MATH 20A,A01,083754,Zheng; Zequn,12,0,40,28
1656943818118,MATH 20B,A01,083756,Briones; Jor-el Thomas Caparas,1,0,36,35
1656943818118,MATH 20B,A02,083757,Briones; Jor-el Thomas Caparas,1,0,36,35
1656943818118,MATH 20B,A03,093475,Briones; Jor-el Thomas Caparas,0,0,36,36
1656943824148,MATH 20C,A01,083760,Briones; Jor-el Thomas Caparas,1,0,35,34
1656943824148,MATH 20C,A02,083761,Briones; Jor-el Thomas Caparas,8,0,35,27
1656943824148,MATH 20C,A03,093476,Briones; Jor-el Thomas Caparas,0,1,36,36
1656943824148,MATH 20C,B01,083762,Bach; Quang Tran,0,0,30,30
1656943830187,MATH 20D,A01,083765,Tran; Brian Kha,4,0,30,26
1656943830187,MATH 20D,A02,083766,Tran; Brian Kha,4,0,30,26
1656943830187,MATH 20D,A03,083767,Tran; Brian Kha,3,0,30,27
1656943836216,MATH 20E,A01,083771,Ganguly; Soumya,5,0,32,27
1656943836216,MATH 20E,A02,083772,Ganguly; Soumya,6,0,32,26
1656943836216,MATH 20E,B01,083773,Ciotti; Benjamin,18,0,35,17
1656943836216,MATH 20E,B02,083774,Ciotti; Benjamin,17,0,35,18
1656943842247,MATH 103A,A01,083777,Greenfeld; Be'Eri,2,0,36,34
1656943842247,MATH 103A,A02,083778,Greenfeld; Be'Eri,5,0,36,31
1656943842247,MATH 103A,A03,093561,Greenfeld; Be'Eri,4,0,36,32
1656943842247,MATH 103A,B01,083779,Greenfeld; Be'Eri,6,0,36,30
1656943842247,MATH 103A,B02,083780,Greenfeld; Be'Eri,2,0,36,34
1656943842247,MATH 103A,B03,093562,Greenfeld; Be'Eri,2,0,36,34
1656943848277,MATH 105,A01,085443,Carter; Anne Toulson,13,0,35,22
1656943848277,MATH 105,A02,093477,Carter; Anne Toulson,20,0,35,15
1656943854307,MATH 109,A01,083213,Ganzberger; Geoffrey Michael,2,0,34,32
1656943854307,MATH 109,A02,083214,Ganzberger; Geoffrey Michael,2,0,34,32
1656943854307,MATH 109,A03,093478,Ganzberger; Geoffrey Michael,1,0,34,33
1656943854307,MATH 109,B01,083215,Ganzberger; Geoffrey Michael,1,0,32,31
1656943854307,MATH 109,B02,083216,Ganzberger; Geoffrey Michael,1,0,32,31
1656943854307,MATH 109,B03,093479,Ganzberger; Geoffrey Michael,6,0,32,26
1656943860336,MATH 142A,A01,083219,Chow; Bennett,6,0,32,26
1656943860336,MATH 142A,A02,083220,Chow; Bennett,10,0,32,22
1656943860336,MATH 142A,A03,093480,Chow; Bennett,7,0,32,25
1656943860336,MATH 142A,B03,093481,Chow; Bennett,7,0,32,25
1656943860336,MATH 142A,B04,093558,Chow; Bennett,11,0,32,21
1656943860336,MATH 142A,B05,093559,Chow; Bennett,6,0,32,26
1656943866363,MATH 193A,A01,083224,Rotar; Vladimir,7,0,34,27
1656943866363,MATH 193A,A02,083225,Rotar; Vladimir,3,0,34,31
1656943866363,MATH 193A,A03,083781,Rotar; Vladimir,1,0,34,33
1656943866363,MATH 193A,A04,083782,Rotar; Vladimir,6,0,34,28
1656943866363,MATH 193A,A05,093482,Rotar; Vladimir,6,0,34,28
1656943872388,MATH 197,001,091859,McAuley; Julian John,9999,0,9999,0
1656943872388,MATH 197,002,095566,Kedlaya; Kiran S.,9997,0,9999,2
1656943872388,MATH 197,003,095567,Xiao; Ming,9999,0,9999,0
1656943872388,MATH 197,004,095571,Perols; Johan Lars,9998,0,9999,1
1656943879453,COGS 9,A01,083615,Shannon; Kyle Michael,7,0,75,68
1656943885478,COGS 11,A01,083617,Boyle; Mary E. T.,19,0,48,29
1656943891506,COGS 13,A01,083071,Bastos; Amalia Pinkusfeld,9,0,71,62
1656943897605,COGS 14A,A01,092681,Semenuks; Arturs,0,1,100,100
1656943903632,COGS 14B,A01,083073,Cheng; Tzu-Han,5,0,63,58
1656943909661,COGS 17,A01,092677,Semenuks; Arturs,4,0,81,77
1656943915684,COGS 100,A01,083619,Allen; Michael Gordon,15,0,70,55
1656943921722,COGS 101A,A01,083621,Davis; Joshua Daniel,9,0,68,59
1656943927744,COGS 101B,A01,091572,Allen; Michael Gordon,8,0,65,57
1656943933767,COGS 101C,A01,083625,Delgado; Tania,17,0,35,18
1656943939793,COGS 107A,A01,083627,Boyle; Mary E. T.,13,0,60,47
1656943945816,COGS 118A,A01,083075,Gupta; Anjum,15,0,76,61
1656943951842,CSE 3,A50,083646,Miranda; Gregory Joseph,22,0,50,28
1656943957864,CSE 8A,A50,083650,Miranda; Gregory Joseph,17,1,56,39
1656943963891,CSE 11,A01,083080,Cao; Yingjun,4,15,40,36
1656943969920,CSE 12,A01,083652,Krause-Levy; Sophia Louisa,20,1,120,100
1656943975947,CSE 15L,A01,083654,Morris; Justin Loren,8,0,50,42
1656943975947,CSE 15L,A02,083655,Morris; Justin Loren,8,0,50,42
1656943981972,CSE 20,A01,083657,Tran; Khoa Dang,37,0,80,43
1656943987994,CSE 21,A01,095574,Bach; Quang Tran,21,0,48,27
1656943994020,CSE 30,A01,083084,Eldon; John,4,0,80,76
1656943994020,CSE 30,B01,095061,Bhaskar; Nishant,6,0,50,44
1656944000043,CSE 100,A01,083659,Cao; Yingjun,3,4,70,67
1656944006070,CSE 134B,A01,083661,Powell; Thomas Allan,19,0,100,81
1656944012099,CSE 140,A01,083663,Gungor; Onat,14,0,85,71
1656944018122,CSE 140L,A01,083088,Eldon; John,16,0,100,84
1656944024148,CSE 175,A01,083665,Kumar; Rakesh,3,0,25,22
1656944030179,CSE 190,A00,092507,Dubnov; Shlomo,7,0,20,13
1656944036216,ECE 45,A01,083139,Congero; Spencer William,5,0,75,70
1656944042245,ECE 65,A50,083695,Saad; Andrew S,12,0,30,18
1656944042245,ECE 65,A51,095125,Saad; Andrew S,25,0,26,1
1656944048267,ECE 109,A01,091882,Touri; Behrouz,16,0,70,54
1656944054291,ECE 180,A00,083140,Abi Samra; Nicholas Camill,0,0,30,30
1656944054291,ECE 180,B00,083141,Abi Samra; Nicholas Camill,0,0,30,30
1656944060315,MATH 10A,A01,083735,Patchell; Gregory David,1,0,30,29
1656944060315,MATH 10A,A02,083736,Patchell; Gregory David,20,0,30,10
1656944060315,MATH 10A,A03,083737,Patchell; Gregory David,15,0,30,15
1656944066340,MATH 10B,A01,083207,Lim; Seonhee,7,0,34,27
1656944066340,MATH 10B,A02,083208,Lim; Seonhee,9,0,35,26
1656944066340,MATH 10B,A03,093472,Lim; Seonhee,4,0,34,30
1656944066340,MATH 10B,B01,083739,Sinha; Shubham,9,0,30,21
1656944072381,MATH 18,A01,083743,Cinel; Cameron Alexander,6,0,30,24
1656944072381,MATH 18,A02,083744,Cinel; Cameron Alexander,15,0,30,15
1656944072381,MATH 18,A03,083745,Cinel; Cameron Alexander,8,0,30,22
1656944072381,MATH 18,B01,083748,Rideout; David Porter,4,0,37,33
1656944072381,MATH 18,B02,083749,Rideout; David Porter,3,0,36,33
1656944072381,MATH 18,B03,083750,Rideout; David Porter,2,0,37,35
1656944072381,MATH 18,B04,083751,Rideout; David Porter,5,0,36,31
1656944072381,MATH 18,B05,093473,Rideout; David Porter,4,0,36,32
1656944072381,MATH 18,B06,093474,Rideout; David Porter,5,0,36,31
1656944078406,MATH 20A,A01,083754,Zheng; Zequn,12,0,40,28
1656944084433,MATH 20B,A01,083756,Briones; Jor-el Thomas Caparas,1,0,36,35
1656944084433,MATH 20B,A02,083757,Briones; Jor-el Thomas Caparas,1,0,36,35
1656944084433,MATH 20B,A03,093475,Briones; Jor-el Thomas Caparas,0,0,36,36
1656944090466,MATH 20C,A01,083760,Briones; Jor-el Thomas Caparas,1,0,35,34
1656944090466,MATH 20C,A02,083761,Briones; Jor-el Thomas Caparas,8,0,35,27
1656944090466,MATH 20C,A03,093476,Briones; Jor-el Thomas Caparas,0,1,36,36
1656944090466,MATH 20C,B01,083762,Bach; Quang Tran,0,0,30,30
1656944096491,MATH 20D,A01,083765,Tran; Brian Kha,4,0,30,26
1656944096491,MATH 20D,A02,083766,Tran; Brian Kha,4,0,30,26
1656944096491,MATH 20D,A03,083767,Tran; Brian Kha,3,0,30,27
1656944102521,MATH 20E,A01,083771,Ganguly; Soumya,5,0,32,27
1656944102521,MATH 20E,A02,083772,Ganguly; Soumya,6,0,32,26
1656944102521,MATH 20E,B01,083773,Ciotti; Benjamin,18,0,35,17
1656944102521,MATH 20E,B02,083774,Ciotti; Benjamin,17,0,35,18
1656944108554,MATH 103A,A01,083777,Greenfeld; Be'Eri,2,0,36,34
1656944108554,MATH 103A,A02,083778,Greenfeld; Be'Eri,5,0,36,31
1656944108554,MATH 103A,A03,093561,Greenfeld; Be'Eri,4,0,36,32
1656944108554,MATH 103A,B01,083779,Greenfeld; Be'Eri,6,0,36,30
1656944108554,MATH 103A,B02,083780,Greenfeld; Be'Eri,2,0,36,34
1656944108554,MATH 103A,B03,093562,Greenfeld; Be'Eri,2,0,36,34
1656944114582,MATH 105,A01,085443,Carter; Anne Toulson,13,0,35,22
1656944114582,MATH 105,A02,093477,Carter; Anne Toulson,20,0,35,15
1656944120607,MATH 109,A01,083213,Ganzberger; Geoffrey Michael,2,0,34,32
1656944120607,MATH 109,A02,083214,Ganzberger; Geoffrey Michael,2,0,34,32
1656944120607,MATH 109,A03,093478,Ganzberger; Geoffrey Michael,1,0,34,33
1656944120607,MATH 109,B01,083215,Ganzberger; Geoffrey Michael,1,0,32,31
1656944120607,MATH 109,B02,083216,Ganzberger; Geoffrey Michael,1,0,32,31
1656944120607,MATH 109,B03,093479,Ganzberger; Geoffrey Michael,6,0,32,26
1656944126631,MATH 142A,A01,083219,Chow; Bennett,6,0,32,26
1656944126631,MATH 142A,A02,083220,Chow; Bennett,10,0,32,22
1656944126631,MATH 142A,A03,093480,Chow; Bennett,7,0,32,25
1656944126631,MATH 142A,B03,093481,Chow; Bennett,7,0,32,25
1656944126631,MATH 142A,B04,093558,Chow; Bennett,11,0,32,21
1656944126631,MATH 142A,B05,093559,Chow; Bennett,6,0,32,26
1656944132659,MATH 193A,A01,083224,Rotar; Vladimir,7,0,34,27
1656944132659,MATH 193A,A02,083225,Rotar; Vladimir,3,0,34,31
1656944132659,MATH 193A,A03,083781,Rotar; Vladimir,1,0,34,33
1656944132659,MATH 193A,A04,083782,Rotar; Vladimir,6,0,34,28
1656944132659,MATH 193A,A05,093482,Rotar; Vladimir,6,0,34,28
1656944138681,MATH 197,001,091859,McAuley; Julian John,9999,0,9999,0
1656944138681,MATH 197,002,095566,Kedlaya; Kiran S.,9997,0,9999,2
1656944138681,MATH 197,003,095567,Xiao; Ming,9999,0,9999,0
1656944138681,MATH 197,004,095571,Perols; Johan Lars,9998,0,9999,1
1656944145736,COGS 9,A01,083615,Shannon; Kyle Michael,7,0,75,68
1656944151760,COGS 11,A01,083617,Boyle; Mary E. T.,19,0,48,29
1656944157784,COGS 13,A01,083071,Bastos; Amalia Pinkusfeld,9,0,71,62
1656944163806,COGS 14A,A01,092681,Semenuks; Arturs,0,1,100,100
1656944169834,COGS 14B,A01,083073,Cheng; Tzu-Han,5,0,63,58
1656944175861,COGS 17,A01,092677,Semenuks; Arturs,4,0,81,77
1656944181890,COGS 100,A01,083619,Allen; Michael Gordon,15,0,70,55
1656944187913,COGS 101A,A01,083621,Davis; Joshua Daniel,9,0,68,59
1656944193936,COGS 101B,A01,091572,Allen; Michael Gordon,8,0,65,57
1656944199959,COGS 101C,A01,083625,Delgado; Tania,17,0,35,18
1656944205983,COGS 107A,A01,083627,Boyle; Mary E. T.,13,0,60,47
1656944212014,COGS 118A,A01,083075,Gupta; Anjum,15,0,76,61
1656944218039,CSE 3,A50,083646,Miranda; Gregory Joseph,22,0,50,28
1656944224064,CSE 8A,A50,083650,Miranda; Gregory Joseph,17,1,56,39
1656944230096,CSE 11,A01,083080,Cao; Yingjun,4,15,40,36
1656944236123,CSE 12,A01,083652,Krause-Levy; Sophia Louisa,20,1,120,100
1656944242153,CSE 15L,A01,083654,Morris; Justin Loren,8,0,50,42
1656944242153,CSE 15L,A02,083655,Morris; Justin Loren,8,0,50,42
1656944248178,CSE 20,A01,083657,Tran; Khoa Dang,37,0,80,43
1656944254207,CSE 21,A01,095574,Bach; Quang Tran,21,0,48,27
1656944260236,CSE 30,A01,083084,Eldon; John,4,0,80,76
1656944260236,CSE 30,B01,095061,Bhaskar; Nishant,6,0,50,44
1656944266264,CSE 100,A01,083659,Cao; Yingjun,3,4,70,67
1656944272292,CSE 134B,A01,083661,Powell; Thomas Allan,19,0,100,81
1656944278321,CSE 140,A01,083663,Gungor; Onat,14,0,85,71
1656944284348,CSE 140L,A01,083088,Eldon; John,16,0,100,84
1656944290374,CSE 175,A01,083665,Kumar; Rakesh,3,0,25,22
1656944296400,CSE 190,A00,092507,Dubnov; Shlomo,7,0,20,13
1656944302438,ECE 45,A01,083139,Congero; Spencer William,5,0,75,70
1656944308462,ECE 65,A50,083695,Saad; Andrew S,12,0,30,18
1656944308462,ECE 65,A51,095125,Saad; Andrew S,25,0,26,1
1656944314487,ECE 109,A01,091882,Touri; Behrouz,16,0,70,54
1656944320516,ECE 180,A00,083140,Abi Samra; Nicholas Camill,0,0,30,30
1656944320516,ECE 180,B00,083141,Abi Samra; Nicholas Camill,0,0,30,30
1656944326540,MATH 10A,A01,083735,Patchell; Gregory David,1,0,30,29
1656944326540,MATH 10A,A02,083736,Patchell; Gregory David,20,0,30,10
1656944326540,MATH 10A,A03,083737,Patchell; Gregory David,15,0,30,15
1656944332565,MATH 10B,A01,083207,Lim; Seonhee,7,0,34,27
1656944332565,MATH 10B,A02,083208,Lim; Seonhee,9,0,35,26
1656944332565,MATH 10B,A03,093472,Lim; Seonhee,4,0,34,30
1656944332565,MATH 10B,B01,083739,Sinha; Shubham,9,0,30,21
1656944338588,MATH 18,A01,083743,Cinel; Cameron Alexander,6,0,30,24
1656944338588,MATH 18,A02,083744,Cinel; Cameron Alexander,15,0,30,15
1656944338588,MATH 18,A03,083745,Cinel; Cameron Alexander,8,0,30,22
1656944338588,MATH 18,B01,083748,Rideout; David Porter,4,0,37,33
1656944338588,MATH 18,B02,083749,Rideout; David Porter,3,0,36,33
1656944338588,MATH 18,B03,083750,Rideout; David Porter,2,0,37,35
1656944338588,MATH 18,B04,083751,Rideout; David Porter,5,0,36,31
1656944338588,MATH 18,B05,093473,Rideout; David Porter,4,0,36,32
1656944338588,MATH 18,B06,093474,Rideout; David Porter,5,0,36,31
1656944344616,MATH 20A,A01,083754,Zheng; Zequn,12,0,40,28
1656944350645,MATH 20B,A01,083756,Briones; Jor-el Thomas Caparas,1,0,36,35
1656944350645,MATH 20B,A02,083757,Briones; Jor-el Thomas Caparas,1,0,36,35
1656944350645,MATH 20B,A03,093475,Briones; Jor-el Thomas Caparas,0,0,36,36
1656944356675,MATH 20C,A01,083760,Briones; Jor-el Thomas Caparas,1,0,35,34
1656944356675,MATH 20C,A02,083761,Briones; Jor-el Thomas Caparas,8,0,35,27
1656944356675,MATH 20C,A03,093476,Briones; Jor-el Thomas Caparas,0,1,36,36
1656944356675,MATH 20C,B01,083762,Bach; Quang Tran,0,0,30,30
1656944362705,MATH 20D,A01,083765,Tran; Brian Kha,4,0,30,26
1656944362705,MATH 20D,A02,083766,Tran; Brian Kha,4,0,30,26
1656944362705,MATH 20D,A03,083767,Tran; Brian Kha,3,0,30,27
1656944368728,MATH 20E,A01,083771,Ganguly; Soumya,5,0,32,27
1656944368728,MATH 20E,A02,083772,Ganguly; Soumya,6,0,32,26
1656944368728,MATH 20E,B01,083773,Ciotti; Benjamin,18,0,35,17
1656944368728,MATH 20E,B02,083774,Ciotti; Benjamin,17,0,35,18
1656944374751,MATH 103A,A01,083777,Greenfeld; Be'Eri,2,0,36,34
1656944374751,MATH 103A,A02,083778,Greenfeld; Be'Eri,5,0,36,31
1656944374751,MATH 103A,A03,093561,Greenfeld; Be'Eri,4,0,36,32
1656944374751,MATH 103A,B01,083779,Greenfeld; Be'Eri,6,0,36,30
1656944374751,MATH 103A,B02,083780,Greenfeld; Be'Eri,2,0,36,34
1656944374751,MATH 103A,B03,093562,Greenfeld; Be'Eri,2,0,36,34
1656944380778,MATH 105,A01,085443,Carter; Anne Toulson,13,0,35,22
1656944380778,MATH 105,A02,093477,Carter; Anne Toulson,20,0,35,15
1656944386806,MATH 109,A01,083213,Ganzberger; Geoffrey Michael,2,0,34,32
1656944386806,MATH 109,A02,083214,Ganzberger; Geoffrey Michael,2,0,34,32
1656944386806,MATH 109,A03,093478,Ganzberger; Geoffrey Michael,1,0,34,33
1656944386806,MATH 109,B01,083215,Ganzberger; Geoffrey Michael,1,0,32,31
1656944386806,MATH 109,B02,083216,Ganzberger; Geoffrey Michael,1,0,32,31
1656944386806,MATH 109,B03,093479,Ganzberger; Geoffrey Michael,6,0,32,26
1656944392830,MATH 142A,A01,083219,Chow; Bennett,6,0,32,26
1656944392830,MATH 142A,A02,083220,Chow; Bennett,10,0,32,22
1656944392830,MATH 142A,A03,093480,Chow; Bennett,7,0,32,25
1656944392830,MATH 142A,B03,093481,Chow; Bennett,7,0,32,25
1656944392830,MATH 142A,B04,093558,Chow; Bennett,11,0,32,21
1656944392830,MATH 142A,B05,093559,Chow; Bennett,6,0,32,26
1656944398854,MATH 193A,A01,083224,Rotar; Vladimir,7,0,34,27
1656944398854,MATH 193A,A02,083225,Rotar; Vladimir,3,0,34,31
1656944398854,MATH 193A,A03,083781,Rotar; Vladimir,1,0,34,33
1656944398854,MATH 193A,A04,083782,Rotar; Vladimir,6,0,34,28
1656944398854,MATH 193A,A05,093482,Rotar; Vladimir,6,0,34,28
1656944404879,MATH 197,001,091859,McAuley; Julian John,9999,0,9999,0
1656944404879,MATH 197,002,095566,Kedlaya; Kiran S.,9997,0,9999,2
1656944404879,MATH 197,003,095567,Xiao; Ming,9999,0,9999,0
1656944404879,MATH 197,004,095571,Perols; Johan Lars,9998,0,9999,1
1656944411937,COGS 9,A01,083615,Shannon; Kyle Michael,7,0,75,68
1656944417960,COGS 11,A01,083617,Boyle; Mary E. T.,19,0,48,29
1656944423985,COGS 13,A01,083071,Bastos; Amalia Pinkusfeld,9,0,71,62
1656944430011,COGS 14A,A01,092681,Semenuks; Arturs,0,1,100,100
1656944436036,COGS 14B,A01,083073,Cheng; Tzu-Han,5,0,63,58
1656944442059,COGS 17,A01,092677,Semenuks; Arturs,4,0,81,77
1656944448086,COGS 100,A01,083619,Allen; Michael Gordon,15,0,70,55
1656944454112,COGS 101A,A01,083621,Davis; Joshua Daniel,9,0,68,59
1656944460136,COGS 101B,A01,091572,Allen; Michael Gordon,8,0,65,57
1656944466165,COGS 101C,A01,083625,Delgado; Tania,17,0,35,18
1656944472192,COGS 107A,A01,083627,Boyle; Mary E. T.,13,0,60,47
1656944478220,COGS 118A,A01,083075,Gupta; Anjum,15,0,76,61
1656944484248,CSE 3,A50,083646,Miranda; Gregory Joseph,22,0,50,28
1656944490273,CSE 8A,A50,083650,Miranda; Gregory Joseph,17,1,56,39
1656944496371,CSE 11,A01,083080,Cao; Yingjun,4,15,40,36
1656944502394,CSE 12,A01,083652,Krause-Levy; Sophia Louisa,20,1,120,100
1656944508422,CSE 15L,A01,083654,Morris; Justin Loren,8,0,50,42
1656944508422,CSE 15L,A02,083655,Morris; Justin Loren,8,0,50,42
1656944514450,CSE 20,A01,083657,Tran; Khoa Dang,37,0,80,43
1656944520478,CSE 21,A01,095574,Bach; Quang Tran,21,0,48,27
1656944526507,CSE 30,A01,083084,Eldon; John,4,0,80,76
1656944526507,CSE 30,B01,095061,Bhaskar; Nishant,6,0,50,44
1656944532530,CSE 100,A01,083659,Cao; Yingjun,3,4,70,67
1656944538554,CSE 134B,A01,083661,Powell; Thomas Allan,19,0,100,81
1656944544585,CSE 140,A01,083663,Gungor; Onat,14,0,85,71
1656944550611,CSE 140L,A01,083088,Eldon; John,16,0,100,84
1656944556643,CSE 175,A01,083665,Kumar; Rakesh,3,0,25,22
1656944562671,CSE 190,A00,092507,Dubnov; Shlomo,7,0,20,13
1656944568703,ECE 45,A01,083139,Congero; Spencer William,5,0,75,70
1656944574729,ECE 65,A50,083695,Saad; Andrew S,12,0,30,18
1656944574729,ECE 65,A51,095125,Saad; Andrew S,25,0,26,1
1656944580753,ECE 109,A01,091882,Touri; Behrouz,16,0,70,54
1656944586791,ECE 180,A00,083140,Abi Samra; Nicholas Camill,0,0,30,30
1656944586791,ECE 180,B00,083141,Abi Samra; Nicholas Camill,0,0,30,30
1656944592814,MATH 10A,A01,083735,Patchell; Gregory David,1,0,30,29
1656944592814,MATH 10A,A02,083736,Patchell; Gregory David,20,0,30,10
1656944592814,MATH 10A,A03,083737,Patchell; Gregory David,15,0,30,15
1656944598838,MATH 10B,A01,083207,Lim; Seonhee,7,0,34,27
1656944598838,MATH 10B,A02,083208,Lim; Seonhee,9,0,35,26
1656944598838,MATH 10B,A03,093472,Lim; Seonhee,4,0,34,30
1656944598838,MATH 10B,B01,083739,Sinha; Shubham,9,0,30,21
1656944604863,MATH 18,A01,083743,Cinel; Cameron Alexander,6,0,30,24
1656944604863,MATH 18,A02,083744,Cinel; Cameron Alexander,15,0,30,15
1656944604863,MATH 18,A03,083745,Cinel; Cameron Alexander,8,0,30,22
1656944604863,MATH 18,B01,083748,Rideout; David Porter,4,0,37,33
1656944604863,MATH 18,B02,083749,Rideout; David Porter,3,0,36,33
1656944604863,MATH 18,B03,083750,Rideout; David Porter,2,0,37,35
1656944604863,MATH 18,B04,083751,Rideout; David Porter,5,0,36,31
1656944604863,MATH 18,B05,093473,Rideout; David Porter,4,0,36,32
1656944604863,MATH 18,B06,093474,Rideout; David Porter,5,0,36,31
1656944610890,MATH 20A,A01,083754,Zheng; Zequn,12,0,40,28
1656944616915,MATH 20B,A01,083756,Briones; Jor-el Thomas Caparas,1,0,36,35
1656944616915,MATH 20B,A02,083757,Briones; Jor-el Thomas Caparas,1,0,36,35
1656944616915,MATH 20B,A03,093475,Briones; Jor-el Thomas Caparas,0,0,36,36
1656944622940,MATH 20C,A01,083760,Briones; Jor-el Thomas Caparas,1,0,35,34
1656944622940,MATH 20C,A02,083761,Briones; Jor-el Thomas Caparas,8,0,35,27
1656944622940,MATH 20C,A03,093476,Briones; Jor-el Thomas Caparas,0,1,36,36
1656944622940,MATH 20C,B01,083762,Bach; Quang Tran,0,0,30,30
1656944628968,MATH 20D,A01,083765,Tran; Brian Kha,4,0,30,26
1656944628968,MATH 20D,A02,083766,Tran; Brian Kha,4,0,30,26
1656944628968,MATH 20D,A03,083767,Tran; Brian Kha,3,0,30,27
1656944634999,MATH 20E,A01,083771,Ganguly; Soumya,5,0,32,27
1656944634999,MATH 20E,A02,083772,Ganguly; Soumya,6,0,32,26
1656944634999,MATH 20E,B01,083773,Ciotti; Benjamin,18,0,35,17
1656944634999,MATH 20E,B02,083774,Ciotti; Benjamin,17,0,35,18
1656944641023,MATH 103A,A01,083777,Greenfeld; Be'Eri,2,0,36,34
1656944641023,MATH 103A,A02,083778,Greenfeld; Be'Eri,5,0,36,31
1656944641023,MATH 103A,A03,093561,Greenfeld; Be'Eri,4,0,36,32
1656944641023,MATH 103A,B01,083779,Greenfeld; Be'Eri,6,0,36,30
1656944641023,MATH 103A,B02,083780,Greenfeld; Be'Eri,2,0,36,34
1656944641023,MATH 103A,B03,093562,Greenfeld; Be'Eri,2,0,36,34
1656944647051,MATH 105,A01,085443,Carter; Anne Toulson,13,0,35,22
1656944647051,MATH 105,A02,093477,Carter; Anne Toulson,20,0,35,15
1656944653078,MATH 109,A01,083213,Ganzberger; Geoffrey Michael,2,0,34,32
1656944653078,MATH 109,A02,083214,Ganzberger; Geoffrey Michael,2,0,34,32
1656944653078,MATH 109,A03,093478,Ganzberger; Geoffrey Michael,1,0,34,33
1656944653078,MATH 109,B01,083215,Ganzberger; Geoffrey Michael,1,0,32,31
1656944653078,MATH 109,B02,083216,Ganzberger; Geoffrey Michael,1,0,32,31
1656944653078,MATH 109,B03,093479,Ganzberger; Geoffrey Michael,6,0,32,26
1656944659109,MATH 142A,A01,083219,Chow; Bennett,6,0,32,26
1656944659109,MATH 142A,A02,083220,Chow; Bennett,10,0,32,22
1656944659109,MATH 142A,A03,093480,Chow; Bennett,7,0,32,25
1656944659109,MATH 142A,B03,093481,Chow; Bennett,7,0,32,25
1656944659109,MATH 142A,B04,093558,Chow; Bennett,11,0,32,21
1656944659109,MATH 142A,B05,093559,Chow; Bennett,6,0,32,26
1656944665137,MATH 193A,A01,083224,Rotar; Vladimir,7,0,34,27
1656944665137,MATH 193A,A02,083225,Rotar; Vladimir,3,0,34,31
1656944665137,MATH 193A,A03,083781,Rotar; Vladimir,1,0,34,33
1656944665137,MATH 193A,A04,083782,Rotar; Vladimir,6,0,34,28
1656944665137,MATH 193A,A05,093482,Rotar; Vladimir,6,0,34,28
1656944671164,MATH 197,001,091859,McAuley; Julian John,9999,0,9999,0
1656944671164,MATH 197,002,095566,Kedlaya; Kiran S.,9997,0,9999,2
1656944671164,MATH 197,003,095567,Xiao; Ming,9999,0,9999,0
1656944671164,MATH 197,004,095571,Perols; Johan Lars,9998,0,9999,1
1656944678234,COGS 9,A01,083615,Shannon; Kyle Michael,7,0,75,68
1656944684258,COGS 11,A01,083617,Boyle; Mary E. T.,19,0,48,29
1656944690283,COGS 13,A01,083071,Bastos; Amalia Pinkusfeld,9,0,71,62
1656944696306,COGS 14A,A01,092681,Semenuks; Arturs,0,1,100,100
1656944702331,COGS 14B,A01,083073,Cheng; Tzu-Han,5,0,63,58
1656944708353,COGS 17,A01,092677,Semenuks; Arturs,4,0,81,77
1656944714378,COGS 100,A01,083619,Allen; Michael Gordon,15,0,70,55
1656944720404,COGS 101A,A01,083621,Davis; Joshua Daniel,9,0,68,59
1656944726435,COGS 101B,A01,091572,Allen; Michael Gordon,8,0,65,57
1656944732459,COGS 101C,A01,083625,Delgado; Tania,17,0,35,18
1656944738484,COGS 107A,A01,083627,Boyle; Mary E. T.,13,0,60,47
1656944744509,COGS 118A,A01,083075,Gupta; Anjum,15,0,76,61
1656944750538,CSE 3,A50,083646,Miranda; Gregory Joseph,22,0,50,28
1656944756564,CSE 8A,A50,083650,Miranda; Gregory Joseph,17,1,56,39
1656944762590,CSE 11,A01,083080,Cao; Yingjun,4,15,40,36
1656944768617,CSE 12,A01,083652,Krause-Levy; Sophia Louisa,20,1,120,100
1656944774642,CSE 15L,A01,083654,Morris; Justin Loren,8,0,50,42
1656944774642,CSE 15L,A02,083655,Morris; Justin Loren,8,0,50,42
1656944780666,CSE 20,A01,083657,Tran; Khoa Dang,37,0,80,43
1656944786697,CSE 21,A01,095574,Bach; Quang Tran,21,0,48,27
1656944792724,CSE 30,A01,083084,Eldon; John,4,0,80,76
1656944792724,CSE 30,B01,095061,Bhaskar; Nishant,6,0,50,44
1656944798748,CSE 100,A01,083659,Cao; Yingjun,3,4,70,67
1656944804771,CSE 134B,A01,083661,Powell; Thomas Allan,19,0,100,81
1656944810794,CSE 140,A01,083663,Gungor; Onat,14,0,85,71
1656944816825,CSE 140L,A01,083088,Eldon; John,16,0,100,84
1656944822847,CSE 175,A01,083665,Kumar; Rakesh,3,0,25,22
1656944828878,CSE 190,A00,092507,Dubnov; Shlomo,7,0,20,13
1656944834903,ECE 45,A01,083139,Congero; Spencer William,5,0,75,70
1656944840928,ECE 65,A50,083695,Saad; Andrew S,12,0,30,18
1656944840928,ECE 65,A51,095125,Saad; Andrew S,25,0,26,1
1656944846951,ECE 109,A01,091882,Touri; Behrouz,16,0,70,54
1656944852979,ECE 180,A00,083140,Abi Samra; Nicholas Camill,0,0,30,30
1656944852979,ECE 180,B00,083141,Abi Samra; Nicholas Camill,0,0,30,30
1656944859004,MATH 10A,A01,083735,Patchell; Gregory David,1,0,30,29
1656944859004,MATH 10A,A02,083736,Patchell; Gregory David,20,0,30,10
1656944859004,MATH 10A,A03,083737,Patchell; Gregory David,15,0,30,15
1656944865029,MATH 10B,A01,083207,Lim; Seonhee,7,0,34,27
1656944865029,MATH 10B,A02,083208,Lim; Seonhee,9,0,35,26
1656944865029,MATH 10B,A03,093472,Lim; Seonhee,4,0,34,30
1656944865029,MATH 10B,B01,083739,Sinha; Shubham,9,0,30,21
1656944871062,MATH 18,A01,083743,Cinel; Cameron Alexander,6,0,30,24
1656944871062,MATH 18,A02,083744,Cinel; Cameron Alexander,15,0,30,15
1656944871062,MATH 18,A03,083745,Cinel; Cameron Alexander,8,0,30,22
1656944871062,MATH 18,B01,083748,Rideout; David Porter,4,0,37,33
1656944871062,MATH 18,B02,083749,Rideout; David Porter,3,0,36,33
1656944871062,MATH 18,B03,083750,Rideout; David Porter,2,0,37,35
1656944871062,MATH 18,B04,083751,Rideout; David Porter,5,0,36,31
1656944871062,MATH 18,B05,093473,Rideout; David Porter,4,0,36,32
1656944871062,MATH 18,B06,093474,Rideout; David Porter,5,0,36,31
1656944877087,MATH 20A,A01,083754,Zheng; Zequn,12,0,40,28
1656944883112,MATH 20B,A01,083756,Briones; Jor-el Thomas Caparas,1,0,36,35
1656944883112,MATH 20B,A02,083757,Briones; Jor-el Thomas Caparas,1,0,36,35
1656944883112,MATH 20B,A03,093475,Briones; Jor-el Thomas Caparas,0,0,36,36
1656944889142,MATH 20C,A01,083760,Briones; Jor-el Thomas Caparas,1,0,35,34
1656944889142,MATH 20C,A02,083761,Briones; Jor-el Thomas Caparas,8,0,35,27
1656944889142,MATH 20C,A03,093476,Briones; Jor-el Thomas Caparas,0,1,36,36
1656944889142,MATH 20C,B01,083762,Bach; Quang Tran,0,0,30,30
1656944895168,MATH 20D,A01,083765,Tran; Brian Kha,4,0,30,26
1656944895168,MATH 20D,A02,083766,Tran; Brian Kha,4,0,30,26
1656944895168,MATH 20D,A03,083767,Tran; Brian Kha,3,0,30,27
1656944901192,MATH 20E,A01,083771,Ganguly; Soumya,5,0,32,27
1656944901192,MATH 20E,A02,083772,Ganguly; Soumya,6,0,32,26
1656944901192,MATH 20E,B01,083773,Ciotti; Benjamin,18,0,35,17
1656944901192,MATH 20E,B02,083774,Ciotti; Benjamin,17,0,35,18
1656944907223,MATH 103A,A01,083777,Greenfeld; Be'Eri,2,0,36,34
1656944907223,MATH 103A,A02,083778,Greenfeld; Be'Eri,5,0,36,31
1656944907223,MATH 103A,A03,093561,Greenfeld; Be'Eri,4,0,36,32
1656944907223,MATH 103A,B01,083779,Greenfeld; Be'Eri,6,0,36,30
1656944907223,MATH 103A,B02,083780,Greenfeld; Be'Eri,2,0,36,34
1656944907223,MATH 103A,B03,093562,Greenfeld; Be'Eri,2,0,36,34
1656944913246,MATH 105,A01,085443,Carter; Anne Toulson,13,0,35,22
1656944913246,MATH 105,A02,093477,Carter; Anne Toulson,20,0,35,15
1656944919271,MATH 109,A01,083213,Ganzberger; Geoffrey Michael,2,0,34,32
1656944919271,MATH 109,A02,083214,Ganzberger; Geoffrey Michael,2,0,34,32
1656944919271,MATH 109,A03,093478,Ganzberger; Geoffrey Michael,1,0,34,33
1656944919271,MATH 109,B01,083215,Ganzberger; Geoffrey Michael,1,0,32,31
1656944919271,MATH 109,B02,083216,Ganzberger; Geoffrey Michael,1,0,32,31
1656944919271,MATH 109,B03,093479,Ganzberger; Geoffrey Michael,6,0,32,26
1656944925297,MATH 142A,A01,083219,Chow; Bennett,6,0,32,26
1656944925297,MATH 142A,A02,083220,Chow; Bennett,10,0,32,22
1656944925297,MATH 142A,A03,093480,Chow; Bennett,7,0,32,25
1656944925297,MATH 142A,B03,093481,Chow; Bennett,7,0,32,25
1656944925297,MATH 142A,B04,093558,Chow; Bennett,11,0,32,21
1656944925297,MATH 142A,B05,093559,Chow; Bennett,6,0,32,26
1656944931325,MATH 193A,A01,083224,Rotar; Vladimir,7,0,34,27
1656944931325,MATH 193A,A02,083225,Rotar; Vladimir,3,0,34,31
1656944931325,MATH 193A,A03,083781,Rotar; Vladimir,1,0,34,33
1656944931325,MATH 193A,A04,083782,Rotar; Vladimir,6,0,34,28
1656944931325,MATH 193A,A05,093482,Rotar; Vladimir,6,0,34,28
1656944937347,MATH 197,001,091859,McAuley; Julian John,9999,0,9999,0
1656944937347,MATH 197,002,095566,Kedlaya; Kiran S.,9997,0,9999,2
1656944937347,MATH 197,003,095567,Xiao; Ming,9999,0,9999,0
1656944937347,MATH 197,004,095571,Perols; Johan Lars,9998,0,9999,1
1656944944401,COGS 9,A01,083615,Shannon; Kyle Michael,7,0,75,68
1656944950426,COGS 11,A01,083617,Boyle; Mary E. T.,19,0,48,29
1656944956447,COGS 13,A01,083071,Bastos; Amalia Pinkusfeld,9,0,71,62
1656944962471,COGS 14A,A01,092681,Semenuks; Arturs,0,1,100,100
1656944968501,COGS 14B,A01,083073,Cheng; Tzu-Han,5,0,63,58
1656944974527,COGS 17,A01,092677,Semenuks; Arturs,4,0,81,77
1656944980552,COGS 100,A01,083619,Allen; Michael Gordon,15,0,70,55
1656944986580,COGS 101A,A01,083621,Davis; Joshua Daniel,9,0,68,59
1656944992605,COGS 101B,A01,091572,Allen; Michael Gordon,8,0,65,57
1656944998631,COGS 101C,A01,083625,Delgado; Tania,17,0,35,18
1656945004663,COGS 107A,A01,083627,Boyle; Mary E. T.,13,0,60,47
1656945010690,COGS 118A,A01,083075,Gupta; Anjum,15,0,76,61
1656945016720,CSE 3,A50,083646,Miranda; Gregory Joseph,22,0,50,28
1656945022746,CSE 8A,A50,083650,Miranda; Gregory Joseph,17,1,56,39
1656945028769,CSE 11,A01,083080,Cao; Yingjun,4,15,40,36
1656945034794,CSE 12,A01,083652,Krause-Levy; Sophia Louisa,20,1,120,100
1656945040818,CSE 15L,A01,083654,Morris; Justin Loren,8,0,50,42
1656945040818,CSE 15L,A02,083655,Morris; Justin Loren,8,0,50,42
1656945046842,CSE 20,A01,083657,Tran; Khoa Dang,37,0,80,43
1656945052867,CSE 21,A01,095574,Bach; Quang Tran,21,0,48,27
1656945058892,CSE 30,A01,083084,Eldon; John,4,0,80,76
1656945058892,CSE 30,B01,095061,Bhaskar; Nishant,6,0,50,44
1656945064918,CSE 100,A01,083659,Cao; Yingjun,3,4,70,67
1656945070940,CSE 134B,A01,083661,Powell; Thomas Allan,19,0,100,81
1656945076964,CSE 140,A01,083663,Gungor; Onat,14,0,85,71
1656945082988,CSE 140L,A01,083088,Eldon; John,16,0,100,84
1656945089015,CSE 175,A01,083665,Kumar; Rakesh,3,0,25,22
1656945095124,CSE 190,A00,092507,Dubnov; Shlomo,7,0,20,13
1656945101151,ECE 45,A01,083139,Congero; Spencer William,5,0,75,70
1656945107185,ECE 65,A50,083695,Saad; Andrew S,12,0,30,18
1656945107185,ECE 65,A51,095125,Saad; Andrew S,25,0,26,1
1656945113217,ECE 109,A01,091882,Touri; Behrouz,16,0,70,54
1656945119242,ECE 180,A00,083140,Abi Samra; Nicholas Camill,0,0,30,30
1656945119242,ECE 180,B00,083141,Abi Samra; Nicholas Camill,0,0,30,30
1656945125275,MATH 10A,A01,083735,Patchell; Gregory David,1,0,30,29
1656945125275,MATH 10A,A02,083736,Patchell; Gregory David,20,0,30,10
1656945125275,MATH 10A,A03,083737,Patchell; Gregory David,15,0,30,15
1656945131299,MATH 10B,A01,083207,Lim; Seonhee,7,0,34,27
1656945131299,MATH 10B,A02,083208,Lim; Seonhee,9,0,35,26
1656945131299,MATH 10B,A03,093472,Lim; Seonhee,4,0,34,30
1656945131299,MATH 10B,B01,083739,Sinha; Shubham,9,0,30,21
1656945137329,MATH 18,A01,083743,Cinel; Cameron Alexander,6,0,30,24
1656945137329,MATH 18,A02,083744,Cinel; Cameron Alexander,15,0,30,15
1656945137329,MATH 18,A03,083745,Cinel; Cameron Alexander,8,0,30,22
1656945137329,MATH 18,B01,083748,Rideout; David Porter,4,0,37,33
1656945137329,MATH 18,B02,083749,Rideout; David Porter,3,0,36,33
1656945137329,MATH 18,B03,083750,Rideout; David Porter,2,0,37,35
1656945137329,MATH 18,B04,083751,Rideout; David Porter,5,0,36,31
1656945137329,MATH 18,B05,093473,Rideout; David Porter,4,0,36,32
1656945137329,MATH 18,B06,093474,Rideout; David Porter,5,0,36,31
1656945143359,MATH 20A,A01,083754,Zheng; Zequn,12,0,40,28
1656945149387,MATH 20B,A01,083756,Briones; Jor-el Thomas Caparas,1,0,36,35
1656945149387,MATH 20B,A02,083757,Briones; Jor-el Thomas Caparas,1,0,36,35
1656945149387,MATH 20B,A03,093475,Briones; Jor-el Thomas Caparas,0,0,36,36
1656945155411,MATH 20C,A01,083760,Briones; Jor-el Thomas Caparas,1,0,35,34
1656945155411,MATH 20C,A02,083761,Briones; Jor-el Thomas Caparas,8,0,35,27
1656945155411,MATH 20C,A03,093476,Briones; Jor-el Thomas Caparas,0,1,36,36
1656945155411,MATH 20C,B01,083762,Bach; Quang Tran,0,0,30,30
1656945161437,MATH 20D,A01,083765,Tran; Brian Kha,4,0,30,26
1656945161437,MATH 20D,A02,083766,Tran; Brian Kha,4,0,30,26
1656945161437,MATH 20D,A03,083767,Tran; Brian Kha,3,0,30,27
1656945167470,MATH 20E,A01,083771,Ganguly; Soumya,5,0,32,27
1656945167470,MATH 20E,A02,083772,Ganguly; Soumya,6,0,32,26
1656945167470,MATH 20E,B01,083773,Ciotti; Benjamin,18,0,35,17
1656945167470,MATH 20E,B02,083774,Ciotti; Benjamin,17,0,35,18
1656945173500,MATH 103A,A01,083777,Greenfeld; Be'Eri,2,0,36,34
1656945173500,MATH 103A,A02,083778,Greenfeld; Be'Eri,5,0,36,31
1656945173500,MATH 103A,A03,093561,Greenfeld; Be'Eri,4,0,36,32
1656945173500,MATH 103A,B01,083779,Greenfeld; Be'Eri,6,0,36,30
1656945173500,MATH 103A,B02,083780,Greenfeld; Be'Eri,2,0,36,34
1656945173500,MATH 103A,B03,093562,Greenfeld; Be'Eri,2,0,36,34
1656945179525,MATH 105,A01,085443,Carter; Anne Toulson,13,0,35,22
1656945179525,MATH 105,A02,093477,Carter; Anne Toulson,20,0,35,15
1656945185568,MATH 109,A01,083213,Ganzberger; Geoffrey Michael,2,0,34,32
1656945185568,MATH 109,A02,083214,Ganzberger; Geoffrey Michael,2,0,34,32
1656945185568,MATH 109,A03,093478,Ganzberger; Geoffrey Michael,1,0,34,33
1656945185568,MATH 109,B01,083215,Ganzberger; Geoffrey Michael,1,0,32,31
1656945185568,MATH 109,B02,083216,Ganzberger; Geoffrey Michael,1,0,32,31
1656945185568,MATH 109,B03,093479,Ganzberger; Geoffrey Michael,6,0,32,26
1656945191592,MATH 142A,A01,083219,Chow; Bennett,6,0,32,26
1656945191592,MATH 142A,A02,083220,Chow; Bennett,10,0,32,22
1656945191592,MATH 142A,A03,093480,Chow; Bennett,7,0,32,25
1656945191592,MATH 142A,B03,093481,Chow; Bennett,7,0,32,25
1656945191592,MATH 142A,B04,093558,Chow; Bennett,11,0,32,21
1656945191592,MATH 142A,B05,093559,Chow; Bennett,6,0,32,26
1656945197617,MATH 193A,A01,083224,Rotar; Vladimir,7,0,34,27
1656945197617,MATH 193A,A02,083225,Rotar; Vladimir,3,0,34,31
1656945197617,MATH 193A,A03,083781,Rotar; Vladimir,1,0,34,33
1656945197617,MATH 193A,A04,083782,Rotar; Vladimir,6,0,34,28
1656945197617,MATH 193A,A05,093482,Rotar; Vladimir,6,0,34,28
1656945203640,MATH 197,001,091859,McAuley; Julian John,9999,0,9999,0
1656945203640,MATH 197,002,095566,Kedlaya; Kiran S.,9997,0,9999,2
1656945203640,MATH 197,003,095567,Xiao; Ming,9999,0,9999,0
1656945203640,MATH 197,004,095571,Perols; Johan Lars,9998,0,9999,1
1656945210707,COGS 9,A01,083615,Shannon; Kyle Michael,7,0,75,68
1656945216734,COGS 11,A01,083617,Boyle; Mary E. T.,19,0,48,29
1656945222762,COGS 13,A01,083071,Bastos; Amalia Pinkusfeld,9,0,71,62
1656945228785,COGS 14A,A01,092681,Semenuks; Arturs,0,1,100,100
1656945234813,COGS 14B,A01,083073,Cheng; Tzu-Han,5,0,63,58
1656945240837,COGS 17,A01,092677,Semenuks; Arturs,4,0,81,77
1656945246861,COGS 100,A01,083619,Allen; Michael Gordon,15,0,70,55
1656945252884,COGS 101A,A01,083621,Davis; Joshua Daniel,9,0,68,59
1656945258908,COGS 101B,A01,091572,Allen; Michael Gordon,8,0,65,57
1656945264934,COGS 101C,A01,083625,Delgado; Tania,17,0,35,18
1656945270958,COGS 107A,A01,083627,Boyle; Mary E. T.,13,0,60,47
1656945276983,COGS 118A,A01,083075,Gupta; Anjum,15,0,76,61
1656945283009,CSE 3,A50,083646,Miranda; Gregory Joseph,22,0,50,28
1656945289038,CSE 8A,A50,083650,Miranda; Gregory Joseph,17,1,56,39
1656945295064,CSE 11,A01,083080,Cao; Yingjun,4,15,40,36
1656945301088,CSE 12,A01,083652,Krause-Levy; Sophia Louisa,20,1,120,100
1656945307114,CSE 15L,A01,083654,Morris; Justin Loren,8,0,50,42
1656945307114,CSE 15L,A02,083655,Morris; Justin Loren,8,0,50,42
1656945313137,CSE 20,A01,083657,Tran; Khoa Dang,37,0,80,43
1656945319162,CSE 21,A01,095574,Bach; Quang Tran,21,0,48,27
1656945325194,CSE 30,A01,083084,Eldon; John,4,0,80,76
1656945325194,CSE 30,B01,095061,Bhaskar; Nishant,6,0,50,44
1656945331217,CSE 100,A01,083659,Cao; Yingjun,3,4,70,67
1656945337248,CSE 134B,A01,083661,Powell; Thomas Allan,19,0,100,81
1656945343272,CSE 140,A01,083663,Gungor; Onat,14,0,85,71
1656945349296,CSE 140L,A01,083088,Eldon; John,16,0,100,84
1656945355321,CSE 175,A01,083665,Kumar; Rakesh,3,0,25,22
1656945361344,CSE 190,A00,092507,Dubnov; Shlomo,7,0,20,13
1656945367369,ECE 45,A01,083139,Congero; Spencer William,5,0,75,70
1656945373393,ECE 65,A50,083695,Saad; Andrew S,12,0,30,18
1656945373393,ECE 65,A51,095125,Saad; Andrew S,25,0,26,1
1656945379422,ECE 109,A01,091882,Touri; Behrouz,16,0,70,54
1656945385450,ECE 180,A00,083140,Abi Samra; Nicholas Camill,0,0,30,30
1656945385450,ECE 180,B00,083141,Abi Samra; Nicholas Camill,0,0,30,30
1656945391476,MATH 10A,A01,083735,Patchell; Gregory David,1,0,30,29
1656945391476,MATH 10A,A02,083736,Patchell; Gregory David,20,0,30,10
1656945391476,MATH 10A,A03,083737,Patchell; Gregory David,15,0,30,15
1656945397504,MATH 10B,A01,083207,Lim; Seonhee,7,0,34,27
1656945397504,MATH 10B,A02,083208,Lim; Seonhee,9,0,35,26
1656945397504,MATH 10B,A03,093472,Lim; Seonhee,4,0,34,30
1656945397504,MATH 10B,B01,083739,Sinha; Shubham,9,0,30,21
1656945403528,MATH 18,A01,083743,Cinel; Cameron Alexander,6,0,30,24
1656945403528,MATH 18,A02,083744,Cinel; Cameron Alexander,15,0,30,15
1656945403528,MATH 18,A03,083745,Cinel; Cameron Alexander,8,0,30,22
1656945403528,MATH 18,B01,083748,Rideout; David Porter,4,0,37,33
1656945403528,MATH 18,B02,083749,Rideout; David Porter,3,0,36,33
1656945403528,MATH 18,B03,083750,Rideout; David Porter,2,0,37,35
1656945403528,MATH 18,B04,083751,Rideout; David Porter,5,0,36,31
1656945403528,MATH 18,B05,093473,Rideout; David Porter,4,0,36,32
1656945403528,MATH 18,B06,093474,Rideout; David Porter,5,0,36,31
1656945409551,MATH 20A,A01,083754,Zheng; Zequn,12,0,40,28
1656945415575,MATH 20B,A01,083756,Briones; Jor-el Thomas Caparas,1,0,36,35
1656945415575,MATH 20B,A02,083757,Briones; Jor-el Thomas Caparas,1,0,36,35
1656945415575,MATH 20B,A03,093475,Briones; Jor-el Thomas Caparas,0,0,36,36
1656945421604,MATH 20C,A01,083760,Briones; Jor-el Thomas Caparas,1,0,35,34
1656945421604,MATH 20C,A02,083761,Briones; Jor-el Thomas Caparas,8,0,35,27
1656945421604,MATH 20C,A03,093476,Briones; Jor-el Thomas Caparas,0,1,36,36
1656945421604,MATH 20C,B01,083762,Bach; Quang Tran,0,0,30,30
1656945427641,MATH 20D,A01,083765,Tran; Brian Kha,4,0,30,26
1656945427641,MATH 20D,A02,083766,Tran; Brian Kha,4,0,30,26
1656945427641,MATH 20D,A03,083767,Tran; Brian Kha,3,0,30,27
1656945433667,MATH 20E,A01,083771,Ganguly; Soumya,5,0,32,27
1656945433667,MATH 20E,A02,083772,Ganguly; Soumya,6,0,32,26
1656945433667,MATH 20E,B01,083773,Ciotti; Benjamin,18,0,35,17
1656945433667,MATH 20E,B02,083774,Ciotti; Benjamin,17,0,35,18
1656945439695,MATH 103A,A01,083777,Greenfeld; Be'Eri,2,0,36,34
1656945439695,MATH 103A,A02,083778,Greenfeld; Be'Eri,5,0,36,31
1656945439695,MATH 103A,A03,093561,Greenfeld; Be'Eri,4,0,36,32
1656945439695,MATH 103A,B01,083779,Greenfeld; Be'Eri,6,0,36,30
1656945439695,MATH 103A,B02,083780,Greenfeld; Be'Eri,2,0,36,34
1656945439695,MATH 103A,B03,093562,Greenfeld; Be'Eri,2,0,36,34
1656945445728,MATH 105,A01,085443,Carter; Anne Toulson,13,0,35,22
1656945445728,MATH 105,A02,093477,Carter; Anne Toulson,20,0,35,15
1656945451760,MATH 109,A01,083213,Ganzberger; Geoffrey Michael,2,0,34,32
1656945451760,MATH 109,A02,083214,Ganzberger; Geoffrey Michael,2,0,34,32
1656945451760,MATH 109,A03,093478,Ganzberger; Geoffrey Michael,1,0,34,33
1656945451760,MATH 109,B01,083215,Ganzberger; Geoffrey Michael,1,0,32,31
1656945451760,MATH 109,B02,083216,Ganzberger; Geoffrey Michael,1,0,32,31
1656945451760,MATH 109,B03,093479,Ganzberger; Geoffrey Michael,6,0,32,26
1656945457788,MATH 142A,A01,083219,Chow; Bennett,6,0,32,26
1656945457788,MATH 142A,A02,083220,Chow; Bennett,10,0,32,22
1656945457788,MATH 142A,A03,093480,Chow; Bennett,7,0,32,25
1656945457788,MATH 142A,B03,093481,Chow; Bennett,7,0,32,25
1656945457788,MATH 142A,B04,093558,Chow; Bennett,11,0,32,21
1656945457788,MATH 142A,B05,093559,Chow; Bennett,6,0,32,26
1656945463817,MATH 193A,A01,083224,Rotar; Vladimir,7,0,34,27
1656945463817,MATH 193A,A02,083225,Rotar; Vladimir,3,0,34,31
1656945463817,MATH 193A,A03,083781,Rotar; Vladimir,1,0,34,33
1656945463817,MATH 193A,A04,083782,Rotar; Vladimir,6,0,34,28
1656945463817,MATH 193A,A05,093482,Rotar; Vladimir,6,0,34,28
1656945469843,MATH 197,001,091859,McAuley; Julian John,9999,0,9999,0
1656945469843,MATH 197,002,095566,Kedlaya; Kiran S.,9997,0,9999,2
1656945469843,MATH 197,003,095567,Xiao; Ming,9999,0,9999,0
1656945469843,MATH 197,004,095571,Perols; Johan Lars,9998,0,9999,1
1656945476907,COGS 9,A01,083615,Shannon; Kyle Michael,7,0,75,68
1656945482929,COGS 11,A01,083617,Boyle; Mary E. T.,19,0,48,29
1656945488953,COGS 13,A01,083071,Bastos; Amalia Pinkusfeld,9,0,71,62
1656945494976,COGS 14A,A01,092681,Semenuks; Arturs,0,1,100,100
1656945501004,COGS 14B,A01,083073,Cheng; Tzu-Han,5,0,63,58
1656945507030,COGS 17,A01,092677,Semenuks; Arturs,4,0,81,77
1656945513058,COGS 100,A01,083619,Allen; Michael Gordon,15,0,70,55
1656945519083,COGS 101A,A01,083621,Davis; Joshua Daniel,9,0,68,59
1656945525112,COGS 101B,A01,091572,Allen; Michael Gordon,8,0,65,57
1656945531138,COGS 101C,A01,083625,Delgado; Tania,17,0,35,18
1656945537166,COGS 107A,A01,083627,Boyle; Mary E. T.,13,0,60,47
1656945543189,COGS 118A,A01,083075,Gupta; Anjum,15,0,76,61
1656945549213,CSE 3,A50,083646,Miranda; Gregory Joseph,22,0,50,28
1656945555237,CSE 8A,A50,083650,Miranda; Gregory Joseph,17,1,56,39
1656945561263,CSE 11,A01,083080,Cao; Yingjun,4,15,40,36
1656945567288,CSE 12,A01,083652,Krause-Levy; Sophia Louisa,20,1,120,100
1656945573319,CSE 15L,A01,083654,Morris; Justin Loren,8,0,50,42
1656945573319,CSE 15L,A02,083655,Morris; Justin Loren,8,0,50,42
1656945579344,CSE 20,A01,083657,Tran; Khoa Dang,37,0,80,43
1656945585374,CSE 21,A01,095574,Bach; Quang Tran,21,0,48,27
1656945591400,CSE 30,A01,083084,Eldon; John,4,0,80,76
1656945591400,CSE 30,B01,095061,Bhaskar; Nishant,6,0,50,44
1656945597424,CSE 100,A01,083659,Cao; Yingjun,3,4,70,67
1656945603457,CSE 134B,A01,083661,Powell; Thomas Allan,19,0,100,81
1656945609480,CSE 140,A01,083663,Gungor; Onat,14,0,85,71
1656945615504,CSE 140L,A01,083088,Eldon; John,16,0,100,84
1656945621530,CSE 175,A01,083665,Kumar; Rakesh,3,0,25,22
1656945627566,CSE 190,A00,092507,Dubnov; Shlomo,7,0,20,13
1656945633594,ECE 45,A01,083139,Congero; Spencer William,5,0,75,70
1656945639619,ECE 65,A50,083695,Saad; Andrew S,12,0,30,18
1656945639619,ECE 65,A51,095125,Saad; Andrew S,25,0,26,1
1656945645647,ECE 109,A01,091882,Touri; Behrouz,16,0,70,54
1656945651671,ECE 180,A00,083140,Abi Samra; Nicholas Camill,0,0,30,30
1656945651671,ECE 180,B00,083141,Abi Samra; Nicholas Camill,0,0,30,30
1656945657697,MATH 10A,A01,083735,Patchell; Gregory David,1,0,30,29
1656945657697,MATH 10A,A02,083736,Patchell; Gregory David,20,0,30,10
1656945657697,MATH 10A,A03,083737,Patchell; Gregory David,15,0,30,15
1656945663725,MATH 10B,A01,083207,Lim; Seonhee,7,0,34,27
1656945663725,MATH 10B,A02,083208,Lim; Seonhee,9,0,35,26
1656945663725,MATH 10B,A03,093472,Lim; Seonhee,4,0,34,30
1656945663725,MATH 10B,B01,083739,Sinha; Shubham,9,0,30,21
1656945669750,MATH 18,A01,083743,Cinel; Cameron Alexander,6,0,30,24
1656945669750,MATH 18,A02,083744,Cinel; Cameron Alexander,15,0,30,15
1656945669750,MATH 18,A03,083745,Cinel; Cameron Alexander,8,0,30,22
1656945669750,MATH 18,B01,083748,Rideout; David Porter,4,0,37,33
1656945669750,MATH 18,B02,083749,Rideout; David Porter,3,0,36,33
1656945669750,MATH 18,B03,083750,Rideout; David Porter,2,0,37,35
1656945669750,MATH 18,B04,083751,Rideout; David Porter,5,0,36,31
1656945669750,MATH 18,B05,093473,Rideout; David Porter,4,0,36,32
1656945669750,MATH 18,B06,093474,Rideout; David Porter,5,0,36,31
1656945675774,MATH 20A,A01,083754,Zheng; Zequn,12,0,40,28
1656945681799,MATH 20B,A01,083756,Briones; Jor-el Thomas Caparas,1,0,36,35
1656945681799,MATH 20B,A02,083757,Briones; Jor-el Thomas Caparas,1,0,36,35
1656945681799,MATH 20B,A03,093475,Briones; Jor-el Thomas Caparas,0,0,36,36
1656945687825,MATH 20C,A01,083760,Briones; Jor-el Thomas Caparas,1,0,35,34
1656945687825,MATH 20C,A02,083761,Briones; Jor-el Thomas Caparas,8,0,35,27
1656945687825,MATH 20C,A03,093476,Briones; Jor-el Thomas Caparas,0,1,36,36
1656945687825,MATH 20C,B01,083762,Bach; Quang Tran,0,0,30,30
1656945693930,MATH 20D,A01,083765,Tran; Brian Kha,4,0,30,26
1656945693930,MATH 20D,A02,083766,Tran; Brian Kha,4,0,30,26
1656945693930,MATH 20D,A03,083767,Tran; Brian Kha,3,0,30,27
1656945699956,MATH 20E,A01,083771,Ganguly; Soumya,5,0,32,27
1656945699956,MATH 20E,A02,083772,Ganguly; Soumya,6,0,32,26
1656945699956,MATH 20E,B01,083773,Ciotti; Benjamin,18,0,35,17
1656945699956,MATH 20E,B02,083774,Ciotti; Benjamin,17,0,35,18
1656945705981,MATH 103A,A01,083777,Greenfeld; Be'Eri,2,0,36,34
1656945705981,MATH 103A,A02,083778,Greenfeld; Be'Eri,5,0,36,31
1656945705981,MATH 103A,A03,093561,Greenfeld; Be'Eri,4,0,36,32
1656945705981,MATH 103A,B01,083779,Greenfeld; Be'Eri,6,0,36,30
1656945705981,MATH 103A,B02,083780,Greenfeld; Be'Eri,2,0,36,34
1656945705981,MATH 103A,B03,093562,Greenfeld; Be'Eri,2,0,36,34
1656945712005,MATH 105,A01,085443,Carter; Anne Toulson,13,0,35,22
1656945712005,MATH 105,A02,093477,Carter; Anne Toulson,20,0,35,15
1656945718034,MATH 109,A01,083213,Ganzberger; Geoffrey Michael,2,0,34,32
1656945718034,MATH 109,A02,083214,Ganzberger; Geoffrey Michael,2,0,34,32
1656945718034,MATH 109,A03,093478,Ganzberger; Geoffrey Michael,1,0,34,33
1656945718034,MATH 109,B01,083215,Ganzberger; Geoffrey Michael,1,0,32,31
1656945718034,MATH 109,B02,083216,Ganzberger; Geoffrey Michael,1,0,32,31
1656945718034,MATH 109,B03,093479,Ganzberger; Geoffrey Michael,6,0,32,26
1656945724057,MATH 142A,A01,083219,Chow; Bennett,6,0,32,26
1656945724057,MATH 142A,A02,083220,Chow; Bennett,10,0,32,22
1656945724057,MATH 142A,A03,093480,Chow; Bennett,7,0,32,25
1656945724057,MATH 142A,B03,093481,Chow; Bennett,7,0,32,25
1656945724057,MATH 142A,B04,093558,Chow; Bennett,11,0,32,21
1656945724057,MATH 142A,B05,093559,Chow; Bennett,6,0,32,26
1656945730084,MATH 193A,A01,083224,Rotar; Vladimir,7,0,34,27
1656945730084,MATH 193A,A02,083225,Rotar; Vladimir,3,0,34,31
1656945730084,MATH 193A,A03,083781,Rotar; Vladimir,1,0,34,33
1656945730084,MATH 193A,A04,083782,Rotar; Vladimir,6,0,34,28
1656945730084,MATH 193A,A05,093482,Rotar; Vladimir,6,0,34,28
1656945736109,MATH 197,001,091859,McAuley; Julian John,9999,0,9999,0
1656945736109,MATH 197,002,095566,Kedlaya; Kiran S.,9997,0,9999,2
1656945736109,MATH 197,003,095567,Xiao; Ming,9999,0,9999,0
1656945736109,MATH 197,004,095571,Perols; Johan Lars,9998,0,9999,1
1656945743181,COGS 9,A01,083615,Shannon; Kyle Michael,7,0,75,68
1656945749209,COGS 11,A01,083617,Boyle; Mary E. T.,19,0,48,29
1656945755232,COGS 13,A01,083071,Bastos; Amalia Pinkusfeld,9,0,71,62
1656945761259,COGS 14A,A01,092681,Semenuks; Arturs,0,1,100,100
1656945767287,COGS 14B,A01,083073,Cheng; Tzu-Han,5,0,63,58
1656945773312,COGS 17,A01,092677,Semenuks; Arturs,4,0,81,77
1656945779336,COGS 100,A01,083619,Allen; Michael Gordon,15,0,70,55
1656945785360,COGS 101A,A01,083621,Davis; Joshua Daniel,9,0,68,59
1656945791387,COGS 101B,A01,091572,Allen; Michael Gordon,8,0,65,57
1656945797409,COGS 101C,A01,083625,Delgado; Tania,17,0,35,18
1656945803435,COGS 107A,A01,083627,Boyle; Mary E. T.,13,0,60,47
1656945809457,COGS 118A,A01,083075,Gupta; Anjum,15,0,76,61
1656945815480,CSE 3,A50,083646,Miranda; Gregory Joseph,22,0,50,28
1656945821508,CSE 8A,A50,083650,Miranda; Gregory Joseph,17,1,56,39
1656945827534,CSE 11,A01,083080,Cao; Yingjun,4,15,40,36
1656945833558,CSE 12,A01,083652,Krause-Levy; Sophia Louisa,20,1,120,100
1656945839583,CSE 15L,A01,083654,Morris; Justin Loren,8,0,50,42
1656945839583,CSE 15L,A02,083655,Morris; Justin Loren,8,0,50,42
1656945845612,CSE 20,A01,083657,Tran; Khoa Dang,37,0,80,43
1656945851635,CSE 21,A01,095574,Bach; Quang Tran,21,0,48,27
1656945857664,CSE 30,A01,083084,Eldon; John,4,0,80,76
1656945857664,CSE 30,B01,095061,Bhaskar; Nishant,6,0,50,44
1656945863693,CSE 100,A01,083659,Cao; Yingjun,3,4,70,67
1656945869716,CSE 134B,A01,083661,Powell; Thomas Allan,19,0,100,81
1656945875744,CSE 140,A01,083663,Gungor; Onat,14,0,85,71
1656945881770,CSE 140L,A01,083088,Eldon; John,16,0,100,84
1656945887797,CSE 175,A01,083665,Kumar; Rakesh,3,0,25,22
1656945893822,CSE 190,A00,092507,Dubnov; Shlomo,7,0,20,13
1656945899847,ECE 45,A01,083139,Congero; Spencer William,5,0,75,70
1656945905871,ECE 65,A50,083695,Saad; Andrew S,12,0,30,18
1656945905871,ECE 65,A51,095125,Saad; Andrew S,25,0,26,1
1656945911894,ECE 109,A01,091882,Touri; Behrouz,16,0,70,54
1656945917918,ECE 180,A00,083140,Abi Samra; Nicholas Camill,0,0,30,30
1656945917918,ECE 180,B00,083141,Abi Samra; Nicholas Camill,0,0,30,30
1656945923948,MATH 10A,A01,083735,Patchell; Gregory David,1,0,30,29
1656945923948,MATH 10A,A02,083736,Patchell; Gregory David,20,0,30,10
1656945923948,MATH 10A,A03,083737,Patchell; Gregory David,15,0,30,15
1656945929978,MATH 10B,A01,083207,Lim; Seonhee,7,0,34,27
1656945929978,MATH 10B,A02,083208,Lim; Seonhee,9,0,35,26
1656945929978,MATH 10B,A03,093472,Lim; Seonhee,4,0,34,30
1656945929978,MATH 10B,B01,083739,Sinha; Shubham,9,0,30,21
1656945936006,MATH 18,A01,083743,Cinel; Cameron Alexander,6,0,30,24
1656945936006,MATH 18,A02,083744,Cinel; Cameron Alexander,15,0,30,15
1656945936006,MATH 18,A03,083745,Cinel; Cameron Alexander,8,0,30,22
1656945936006,MATH 18,B01,083748,Rideout; David Porter,4,0,37,33
1656945936006,MATH 18,B02,083749,Rideout; David Porter,3,0,36,33
1656945936006,MATH 18,B03,083750,Rideout; David Porter,2,0,37,35
1656945936006,MATH 18,B04,083751,Rideout; David Porter,5,0,36,31
1656945936006,MATH 18,B05,093473,Rideout; David Porter,4,0,36,32
1656945936006,MATH 18,B06,093474,Rideout; David Porter,5,0,36,31
1656945942029,MATH 20A,A01,083754,Zheng; Zequn,12,0,40,28
1656945948057,MATH 20B,A01,083756,Briones; Jor-el Thomas Caparas,1,0,36,35
1656945948057,MATH 20B,A02,083757,Briones; Jor-el Thomas Caparas,1,0,36,35
1656945948057,MATH 20B,A03,093475,Briones; Jor-el Thomas Caparas,0,0,36,36
1656945954082,MATH 20C,A01,083760,Briones; Jor-el Thomas Caparas,1,0,35,34
1656945954082,MATH 20C,A02,083761,Briones; Jor-el Thomas Caparas,8,0,35,27
1656945954082,MATH 20C,A03,093476,Briones; Jor-el Thomas Caparas,0,1,36,36
1656945954082,MATH 20C,B01,083762,Bach; Quang Tran,0,0,30,30
1656945960108,MATH 20D,A01,083765,Tran; Brian Kha,4,0,30,26
1656945960108,MATH 20D,A02,083766,Tran; Brian Kha,4,0,30,26
1656945960108,MATH 20D,A03,083767,Tran; Brian Kha,3,0,30,27
1656945966133,MATH 20E,A01,083771,Ganguly; Soumya,5,0,32,27
1656945966133,MATH 20E,A02,083772,Ganguly; Soumya,6,0,32,26
1656945966133,MATH 20E,B01,083773,Ciotti; Benjamin,18,0,35,17
1656945966133,MATH 20E,B02,083774,Ciotti; Benjamin,17,0,35,18
1656945972162,MATH 103A,A01,083777,Greenfeld; Be'Eri,2,0,36,34
1656945972162,MATH 103A,A02,083778,Greenfeld; Be'Eri,5,0,36,31
1656945972162,MATH 103A,A03,093561,Greenfeld; Be'Eri,4,0,36,32
1656945972162,MATH 103A,B01,083779,Greenfeld; Be'Eri,6,0,36,30
1656945972162,MATH 103A,B02,083780,Greenfeld; Be'Eri,2,0,36,34
1656945972162,MATH 103A,B03,093562,Greenfeld; Be'Eri,2,0,36,34
1656945978187,MATH 105,A01,085443,Carter; Anne Toulson,13,0,35,22
1656945978187,MATH 105,A02,093477,Carter; Anne Toulson,20,0,35,15
1656945984211,MATH 109,A01,083213,Ganzberger; Geoffrey Michael,2,0,34,32
1656945984211,MATH 109,A02,083214,Ganzberger; Geoffrey Michael,2,0,34,32
1656945984211,MATH 109,A03,093478,Ganzberger; Geoffrey Michael,1,0,34,33
1656945984211,MATH 109,B01,083215,Ganzberger; Geoffrey Michael,1,0,32,31
1656945984211,MATH 109,B02,083216,Ganzberger; Geoffrey Michael,1,0,32,31
1656945984211,MATH 109,B03,093479,Ganzberger; Geoffrey Michael,6,0,32,26
1656945990235,MATH 142A,A01,083219,Chow; Bennett,6,0,32,26
1656945990235,MATH 142A,A02,083220,Chow; Bennett,10,0,32,22
1656945990235,MATH 142A,A03,093480,Chow; Bennett,7,0,32,25
1656945990235,MATH 142A,B03,093481,Chow; Bennett,7,0,32,25
1656945990235,MATH 142A,B04,093558,Chow; Bennett,11,0,32,21
1656945990235,MATH 142A,B05,093559,Chow; Bennett,6,0,32,26
1656945996264,MATH 193A,A01,083224,Rotar; Vladimir,7,0,34,27
1656945996264,MATH 193A,A02,083225,Rotar; Vladimir,3,0,34,31
1656945996264,MATH 193A,A03,083781,Rotar; Vladimir,1,0,34,33
1656945996264,MATH 193A,A04,083782,Rotar; Vladimir,6,0,34,28
1656945996264,MATH 193A,A05,093482,Rotar; Vladimir,6,0,34,28
1656946002288,MATH 197,001,091859,McAuley; Julian John,9999,0,9999,0
1656946002288,MATH 197,002,095566,Kedlaya; Kiran S.,9997,0,9999,2
1656946002288,MATH 197,003,095567,Xiao; Ming,9999,0,9999,0
1656946002288,MATH 197,004,095571,Perols; Johan Lars,9998,0,9999,1
1656946009358,COGS 9,A01,083615,Shannon; Kyle Michael,7,0,75,68
1656946015385,COGS 11,A01,083617,Boyle; Mary E. T.,19,0,48,29
1656946021410,COGS 13,A01,083071,Bastos; Amalia Pinkusfeld,9,0,71,62
1656946027434,COGS 14A,A01,092681,Semenuks; Arturs,0,1,100,100
1656946033459,COGS 14B,A01,083073,Cheng; Tzu-Han,5,0,63,58
1656946039483,COGS 17,A01,092677,Semenuks; Arturs,4,0,81,77
1656946045507,COGS 100,A01,083619,Allen; Michael Gordon,15,0,70,55
1656946051531,COGS 101A,A01,083621,Davis; Joshua Daniel,9,0,68,59
1656946057554,COGS 101B,A01,091572,Allen; Michael Gordon,8,0,65,57
1656946063581,COGS 101C,A01,083625,Delgado; Tania,17,0,35,18
1656946069607,COGS 107A,A01,083627,Boyle; Mary E. T.,13,0,60,47
1656946075631,COGS 118A,A01,083075,Gupta; Anjum,15,0,76,61
1656946081654,CSE 3,A50,083646,Miranda; Gregory Joseph,22,0,50,28
1656946087677,CSE 8A,A50,083650,Miranda; Gregory Joseph,17,1,56,39
1656946093699,CSE 11,A01,083080,Cao; Yingjun,4,15,40,36
1656946099722,CSE 12,A01,083652,Krause-Levy; Sophia Louisa,20,1,120,100
1656946105745,CSE 15L,A01,083654,Morris; Justin Loren,8,0,50,42
1656946105745,CSE 15L,A02,083655,Morris; Justin Loren,8,0,50,42
1656946111768,CSE 20,A01,083657,Tran; Khoa Dang,37,0,80,43
1656946117794,CSE 21,A01,095574,Bach; Quang Tran,21,0,48,27
1656946123821,CSE 30,A01,083084,Eldon; John,4,0,80,76
1656946123821,CSE 30,B01,095061,Bhaskar; Nishant,6,0,50,44
1656946129845,CSE 100,A01,083659,Cao; Yingjun,3,4,70,67
1656946135869,CSE 134B,A01,083661,Powell; Thomas Allan,19,0,100,81
1656946141893,CSE 140,A01,083663,Gungor; Onat,14,0,85,71
1656946147920,CSE 140L,A01,083088,Eldon; John,16,0,100,84
1656946153947,CSE 175,A01,083665,Kumar; Rakesh,3,0,25,22
1656946159969,CSE 190,A00,092507,Dubnov; Shlomo,7,0,20,13
1656946165994,ECE 45,A01,083139,Congero; Spencer William,5,0,75,70
1656946172020,ECE 65,A50,083695,Saad; Andrew S,12,0,30,18
1656946172020,ECE 65,A51,095125,Saad; Andrew S,25,0,26,1
1656946178047,ECE 109,A01,091882,Touri; Behrouz,16,0,70,54
1656946184074,ECE 180,A00,083140,Abi Samra; Nicholas Camill,0,0,30,30
1656946184074,ECE 180,B00,083141,Abi Samra; Nicholas Camill,0,0,30,30
1656946190107,MATH 10A,A01,083735,Patchell; Gregory David,1,0,30,29
1656946190107,MATH 10A,A02,083736,Patchell; Gregory David,20,0,30,10
1656946190107,MATH 10A,A03,083737,Patchell; Gregory David,15,0,30,15
1656946196138,MATH 10B,A01,083207,Lim; Seonhee,7,0,34,27
1656946196138,MATH 10B,A02,083208,Lim; Seonhee,9,0,35,26
1656946196138,MATH 10B,A03,093472,Lim; Seonhee,4,0,34,30
1656946196138,MATH 10B,B01,083739,Sinha; Shubham,9,0,30,21
1656946202173,MATH 18,A01,083743,Cinel; Cameron Alexander,6,0,30,24
1656946202173,MATH 18,A02,083744,Cinel; Cameron Alexander,15,0,30,15
1656946202173,MATH 18,A03,083745,Cinel; Cameron Alexander,8,0,30,22
1656946202173,MATH 18,B01,083748,Rideout; David Porter,4,0,37,33
1656946202173,MATH 18,B02,083749,Rideout; David Porter,3,0,36,33
1656946202173,MATH 18,B03,083750,Rideout; David Porter,2,0,37,35
1656946202173,MATH 18,B04,083751,Rideout; David Porter,5,0,36,31
1656946202173,MATH 18,B05,093473,Rideout; David Porter,4,0,36,32
1656946202173,MATH 18,B06,093474,Rideout; David Porter,5,0,36,31
1656946208199,MATH 20A,A01,083754,Zheng; Zequn,12,0,40,28
1656946214228,MATH 20B,A01,083756,Briones; Jor-el Thomas Caparas,1,0,36,35
1656946214228,MATH 20B,A02,083757,Briones; Jor-el Thomas Caparas,1,0,36,35
1656946214228,MATH 20B,A03,093475,Briones; Jor-el Thomas Caparas,0,0,36,36
1656946220256,MATH 20C,A01,083760,Briones; Jor-el Thomas Caparas,1,0,35,34
1656946220256,MATH 20C,A02,083761,Briones; Jor-el Thomas Caparas,8,0,35,27
1656946220256,MATH 20C,A03,093476,Briones; Jor-el Thomas Caparas,0,1,36,36
1656946220256,MATH 20C,B01,083762,Bach; Quang Tran,0,0,30,30
1656946226281,MATH 20D,A01,083765,Tran; Brian Kha,4,0,30,26
1656946226281,MATH 20D,A02,083766,Tran; Brian Kha,4,0,30,26
1656946226281,MATH 20D,A03,083767,Tran; Brian Kha,3,0,30,27
1656946232306,MATH 20E,A01,083771,Ganguly; Soumya,5,0,32,27
1656946232306,MATH 20E,A02,083772,Ganguly; Soumya,6,0,32,26
1656946232306,MATH 20E,B01,083773,Ciotti; Benjamin,18,0,35,17
1656946232306,MATH 20E,B02,083774,Ciotti; Benjamin,17,0,35,18
1656946238332,MATH 103A,A01,083777,Greenfeld; Be'Eri,2,0,36,34
1656946238332,MATH 103A,A02,083778,Greenfeld; Be'Eri,5,0,36,31
1656946238332,MATH 103A,A03,093561,Greenfeld; Be'Eri,4,0,36,32
1656946238332,MATH 103A,B01,083779,Greenfeld; Be'Eri,6,0,36,30
1656946238332,MATH 103A,B02,083780,Greenfeld; Be'Eri,2,0,36,34
1656946238332,MATH 103A,B03,093562,Greenfeld; Be'Eri,2,0,36,34
1656946244361,MATH 105,A01,085443,Carter; Anne Toulson,13,0,35,22
1656946244361,MATH 105,A02,093477,Carter; Anne Toulson,20,0,35,15
1656946250386,MATH 109,A01,083213,Ganzberger; Geoffrey Michael,2,0,34,32
1656946250386,MATH 109,A02,083214,Ganzberger; Geoffrey Michael,2,0,34,32
1656946250386,MATH 109,A03,093478,Ganzberger; Geoffrey Michael,1,0,34,33
1656946250386,MATH 109,B01,083215,Ganzberger; Geoffrey Michael,1,0,32,31
1656946250386,MATH 109,B02,083216,Ganzberger; Geoffrey Michael,1,0,32,31
1656946250386,MATH 109,B03,093479,Ganzberger; Geoffrey Michael,6,0,32,26
1656946256417,MATH 142A,A01,083219,Chow; Bennett,6,0,32,26
1656946256417,MATH 142A,A02,083220,Chow; Bennett,10,0,32,22
1656946256417,MATH 142A,A03,093480,Chow; Bennett,7,0,32,25
1656946256417,MATH 142A,B03,093481,Chow; Bennett,7,0,32,25
1656946256417,MATH 142A,B04,093558,Chow; Bennett,11,0,32,21
1656946256417,MATH 142A,B05,093559,Chow; Bennett,6,0,32,26
1656946262441,MATH 193A,A01,083224,Rotar; Vladimir,7,0,34,27
1656946262441,MATH 193A,A02,083225,Rotar; Vladimir,3,0,34,31
1656946262441,MATH 193A,A03,083781,Rotar; Vladimir,1,0,34,33
1656946262441,MATH 193A,A04,083782,Rotar; Vladimir,6,0,34,28
1656946262441,MATH 193A,A05,093482,Rotar; Vladimir,6,0,34,28
1656946268469,MATH 197,001,091859,McAuley; Julian John,9999,0,9999,0
1656946268469,MATH 197,002,095566,Kedlaya; Kiran S.,9997,0,9999,2
1656946268469,MATH 197,003,095567,Xiao; Ming,9999,0,9999,0
1656946268469,MATH 197,004,095571,Perols; Johan Lars,9998,0,9999,1
1656946275533,COGS 9,A01,083615,Shannon; Kyle Michael,7,0,75,68
1656946281561,COGS 11,A01,083617,Boyle; Mary E. T.,19,0,48,29
1656946287661,COGS 13,A01,083071,Bastos; Amalia Pinkusfeld,9,0,71,62
1656946293686,COGS 14A,A01,092681,Semenuks; Arturs,0,1,100,100
1656946299710,COGS 14B,A01,083073,Cheng; Tzu-Han,5,0,63,58
1656946305737,COGS 17,A01,092677,Semenuks; Arturs,4,0,81,77
1656946311765,COGS 100,A01,083619,Allen; Michael Gordon,15,0,70,55
1656946317791,COGS 101A,A01,083621,Davis; Joshua Daniel,9,0,68,59
1656946323818,COGS 101B,A01,091572,Allen; Michael Gordon,8,0,65,57
1656946329841,COGS 101C,A01,083625,Delgado; Tania,17,0,35,18
1656946335865,COGS 107A,A01,083627,Boyle; Mary E. T.,13,0,60,47
1656946341893,COGS 118A,A01,083075,Gupta; Anjum,15,0,76,61
1656946347917,CSE 3,A50,083646,Miranda; Gregory Joseph,22,0,50,28
1656946353939,CSE 8A,A50,083650,Miranda; Gregory Joseph,17,1,56,39
1656946359964,CSE 11,A01,083080,Cao; Yingjun,4,15,40,36
1656946365987,CSE 12,A01,083652,Krause-Levy; Sophia Louisa,20,1,120,100
1656946372017,CSE 15L,A01,083654,Morris; Justin Loren,8,0,50,42
1656946372017,CSE 15L,A02,083655,Morris; Justin Loren,8,0,50,42
1656946378041,CSE 20,A01,083657,Tran; Khoa Dang,37,0,80,43
1656946384070,CSE 21,A01,095574,Bach; Quang Tran,21,0,48,27
1656946390092,CSE 30,A01,083084,Eldon; John,4,0,80,76
1656946390092,CSE 30,B01,095061,Bhaskar; Nishant,6,0,50,44
1656946396114,CSE 100,A01,083659,Cao; Yingjun,3,4,70,67
1656946402135,CSE 134B,A01,083661,Powell; Thomas Allan,19,0,100,81
1656946408162,CSE 140,A01,083663,Gungor; Onat,14,0,85,71
1656946414185,CSE 140L,A01,083088,Eldon; John,16,0,100,84
1656946420209,CSE 175,A01,083665,Kumar; Rakesh,3,0,25,22
1656946426232,CSE 190,A00,092507,Dubnov; Shlomo,7,0,20,13
1656946432266,ECE 45,A01,083139,Congero; Spencer William,5,0,75,70
1656946438292,ECE 65,A50,083695,Saad; Andrew S,12,0,30,18
1656946438292,ECE 65,A51,095125,Saad; Andrew S,25,0,26,1
1656946444314,ECE 109,A01,091882,Touri; Behrouz,16,0,70,54
1656946450341,ECE 180,A00,083140,Abi Samra; Nicholas Camill,0,0,30,30
1656946450341,ECE 180,B00,083141,Abi Samra; Nicholas Camill,0,0,30,30
1656946456371,MATH 10A,A01,083735,Patchell; Gregory David,1,0,30,29
1656946456371,MATH 10A,A02,083736,Patchell; Gregory David,20,0,30,10
1656946456371,MATH 10A,A03,083737,Patchell; Gregory David,15,0,30,15
1656946462400,MATH 10B,A01,083207,Lim; Seonhee,7,0,34,27
1656946462400,MATH 10B,A02,083208,Lim; Seonhee,9,0,35,26
1656946462400,MATH 10B,A03,093472,Lim; Seonhee,4,0,34,30
1656946462400,MATH 10B,B01,083739,Sinha; Shubham,9,0,30,21
1656946468424,MATH 18,A01,083743,Cinel; Cameron Alexander,6,0,30,24
1656946468424,MATH 18,A02,083744,Cinel; Cameron Alexander,15,0,30,15
1656946468424,MATH 18,A03,083745,Cinel; Cameron Alexander,8,0,30,22
1656946468424,MATH 18,B01,083748,Rideout; David Porter,4,0,37,33
1656946468424,MATH 18,B02,083749,Rideout; David Porter,3,0,36,33
1656946468424,MATH 18,B03,083750,Rideout; David Porter,2,0,37,35
1656946468424,MATH 18,B04,083751,Rideout; David Porter,5,0,36,31
1656946468424,MATH 18,B05,093473,Rideout; David Porter,4,0,36,32
1656946468424,MATH 18,B06,093474,Rideout; David Porter,5,0,36,31
1656946474458,MATH 20A,A01,083754,Zheng; Zequn,12,0,40,28
1656946480483,MATH 20B,A01,083756,Briones; Jor-el Thomas Caparas,1,0,36,35
1656946480483,MATH 20B,A02,083757,Briones; Jor-el Thomas Caparas,1,0,36,35
1656946480483,MATH 20B,A03,093475,Briones; Jor-el Thomas Caparas,0,0,36,36
1656946486510,MATH 20C,A01,083760,Briones; Jor-el Thomas Caparas,1,0,35,34
1656946486510,MATH 20C,A02,083761,Briones; Jor-el Thomas Caparas,8,0,35,27
1656946486510,MATH 20C,A03,093476,Briones; Jor-el Thomas Caparas,0,1,36,36
1656946486510,MATH 20C,B01,083762,Bach; Quang Tran,0,0,30,30
1656946492539,MATH 20D,A01,083765,Tran; Brian Kha,4,0,30,26
1656946492539,MATH 20D,A02,083766,Tran; Brian Kha,4,0,30,26
1656946492539,MATH 20D,A03,083767,Tran; Brian Kha,3,0,30,27
1656946498563,MATH 20E,A01,083771,Ganguly; Soumya,5,0,32,27
1656946498563,MATH 20E,A02,083772,Ganguly; Soumya,6,0,32,26
1656946498563,MATH 20E,B01,083773,Ciotti; Benjamin,18,0,35,17
1656946498563,MATH 20E,B02,083774,Ciotti; Benjamin,17,0,35,18
1656946504588,MATH 103A,A01,083777,Greenfeld; Be'Eri,2,0,36,34
1656946504588,MATH 103A,A02,083778,Greenfeld; Be'Eri,5,0,36,31
1656946504588,MATH 103A,A03,093561,Greenfeld; Be'Eri,4,0,36,32
1656946504588,MATH 103A,B01,083779,Greenfeld; Be'Eri,6,0,36,30
1656946504588,MATH 103A,B02,083780,Greenfeld; Be'Eri,2,0,36,34
1656946504588,MATH 103A,B03,093562,Greenfeld; Be'Eri,2,0,36,34
1656946510610,MATH 105,A01,085443,Carter; Anne Toulson,13,0,35,22
1656946510610,MATH 105,A02,093477,Carter; Anne Toulson,20,0,35,15
1656946516639,MATH 109,A01,083213,Ganzberger; Geoffrey Michael,2,0,34,32
1656946516639,MATH 109,A02,083214,Ganzberger; Geoffrey Michael,2,0,34,32
1656946516639,MATH 109,A03,093478,Ganzberger; Geoffrey Michael,1,0,34,33
1656946516639,MATH 109,B01,083215,Ganzberger; Geoffrey Michael,1,0,32,31
1656946516639,MATH 109,B02,083216,Ganzberger; Geoffrey Michael,1,0,32,31
1656946516639,MATH 109,B03,093479,Ganzberger; Geoffrey Michael,6,0,32,26
1656946522665,MATH 142A,A01,083219,Chow; Bennett,6,0,32,26
1656946522665,MATH 142A,A02,083220,Chow; Bennett,10,0,32,22
1656946522665,MATH 142A,A03,093480,Chow; Bennett,7,0,32,25
1656946522665,MATH 142A,B03,093481,Chow; Bennett,7,0,32,25
1656946522665,MATH 142A,B04,093558,Chow; Bennett,11,0,32,21
1656946522665,MATH 142A,B05,093559,Chow; Bennett,6,0,32,26
1656946528686,MATH 193A,A01,083224,Rotar; Vladimir,7,0,34,27
1656946528686,MATH 193A,A02,083225,Rotar; Vladimir,3,0,34,31
1656946528686,MATH 193A,A03,083781,Rotar; Vladimir,1,0,34,33
1656946528686,MATH 193A,A04,083782,Rotar; Vladimir,6,0,34,28
1656946528686,MATH 193A,A05,093482,Rotar; Vladimir,6,0,34,28
1656946534712,MATH 197,001,091859,McAuley; Julian John,9999,0,9999,0
1656946534712,MATH 197,002,095566,Kedlaya; Kiran S.,9997,0,9999,2
1656946534712,MATH 197,003,095567,Xiao; Ming,9999,0,9999,0
1656946534712,MATH 197,004,095571,Perols; Johan Lars,9998,0,9999,1
1656946541767,COGS 9,A01,083615,Shannon; Kyle Michael,7,0,75,68
1656946547794,COGS 11,A01,083617,Boyle; Mary E. T.,19,0,48,29
1656946553821,COGS 13,A01,083071,Bastos; Amalia Pinkusfeld,9,0,71,62
1656946559848,COGS 14A,A01,092681,Semenuks; Arturs,0,1,100,100
1656946565878,COGS 14B,A01,083073,Cheng; Tzu-Han,5,0,63,58
1656946571903,COGS 17,A01,092677,Semenuks; Arturs,4,0,81,77
1656946577927,COGS 100,A01,083619,Allen; Michael Gordon,15,0,70,55
1656946583951,COGS 101A,A01,083621,Davis; Joshua Daniel,9,0,68,59
1656946589978,COGS 101B,A01,091572,Allen; Michael Gordon,8,0,65,57
1656946596005,COGS 101C,A01,083625,Delgado; Tania,17,0,35,18
1656946602033,COGS 107A,A01,083627,Boyle; Mary E. T.,13,0,60,47
1656946608055,COGS 118A,A01,083075,Gupta; Anjum,15,0,76,61
1656946614080,CSE 3,A50,083646,Miranda; Gregory Joseph,22,0,50,28
1656946620106,CSE 8A,A50,083650,Miranda; Gregory Joseph,17,1,56,39
1656946626134,CSE 11,A01,083080,Cao; Yingjun,4,15,40,36
1656946632158,CSE 12,A01,083652,Krause-Levy; Sophia Louisa,20,1,120,100
1656946638185,CSE 15L,A01,083654,Morris; Justin Loren,8,0,50,42
1656946638185,CSE 15L,A02,083655,Morris; Justin Loren,8,0,50,42
1656946644213,CSE 20,A01,083657,Tran; Khoa Dang,37,0,80,43
1656946650239,CSE 21,A01,095574,Bach; Quang Tran,21,0,48,27
1656946656264,CSE 30,A01,083084,Eldon; John,4,0,80,76
1656946656264,CSE 30,B01,095061,Bhaskar; Nishant,6,0,50,44
1656946662288,CSE 100,A01,083659,Cao; Yingjun,3,4,70,67
1656946668315,CSE 134B,A01,083661,Powell; Thomas Allan,19,0,100,81
1656946674340,CSE 140,A01,083663,Gungor; Onat,14,0,85,71
1656946680363,CSE 140L,A01,083088,Eldon; John,16,0,100,84
1656946686391,CSE 175,A01,083665,Kumar; Rakesh,3,0,25,22
1656946692417,CSE 190,A00,092507,Dubnov; Shlomo,7,0,20,13
1656946698444,ECE 45,A01,083139,Congero; Spencer William,5,0,75,70
1656946704482,ECE 65,A50,083695,Saad; Andrew S,12,0,30,18
1656946704482,ECE 65,A51,095125,Saad; Andrew S,25,0,26,1
1656946710505,ECE 109,A01,091882,Touri; Behrouz,16,0,70,54
1656946716532,ECE 180,A00,083140,Abi Samra; Nicholas Camill,0,0,30,30
1656946716532,ECE 180,B00,083141,Abi Samra; Nicholas Camill,0,0,30,30
1656946722555,MATH 10A,A01,083735,Patchell; Gregory David,1,0,30,29
1656946722555,MATH 10A,A02,083736,Patchell; Gregory David,20,0,30,10
1656946722555,MATH 10A,A03,083737,Patchell; Gregory David,15,0,30,15
1656946728584,MATH 10B,A01,083207,Lim; Seonhee,7,0,34,27
1656946728584,MATH 10B,A02,083208,Lim; Seonhee,9,0,35,26
1656946728584,MATH 10B,A03,093472,Lim; Seonhee,4,0,34,30
1656946728584,MATH 10B,B01,083739,Sinha; Shubham,9,0,30,21
1656946734608,MATH 18,A01,083743,Cinel; Cameron Alexander,6,0,30,24
1656946734608,MATH 18,A02,083744,Cinel; Cameron Alexander,15,0,30,15
1656946734608,MATH 18,A03,083745,Cinel; Cameron Alexander,8,0,30,22
1656946734608,MATH 18,B01,083748,Rideout; David Porter,4,0,37,33
1656946734608,MATH 18,B02,083749,Rideout; David Porter,3,0,36,33
1656946734608,MATH 18,B03,083750,Rideout; David Porter,2,0,37,35
1656946734608,MATH 18,B04,083751,Rideout; David Porter,5,0,36,31
1656946734608,MATH 18,B05,093473,Rideout; David Porter,4,0,36,32
1656946734608,MATH 18,B06,093474,Rideout; David Porter,5,0,36,31
1656946740634,MATH 20A,A01,083754,Zheng; Zequn,12,0,40,28
1656946746670,MATH 20B,A01,083756,Briones; Jor-el Thomas Caparas,1,0,36,35
1656946746670,MATH 20B,A02,083757,Briones; Jor-el Thomas Caparas,1,0,36,35
1656946746670,MATH 20B,A03,093475,Briones; Jor-el Thomas Caparas,0,0,36,36
1656946752698,MATH 20C,A01,083760,Briones; Jor-el Thomas Caparas,1,0,35,34
1656946752698,MATH 20C,A02,083761,Briones; Jor-el Thomas Caparas,8,0,35,27
1656946752698,MATH 20C,A03,093476,Briones; Jor-el Thomas Caparas,0,1,36,36
1656946752698,MATH 20C,B01,083762,Bach; Quang Tran,0,0,30,30
1656946758723,MATH 20D,A01,083765,Tran; Brian Kha,4,0,30,26
1656946758723,MATH 20D,A02,083766,Tran; Brian Kha,4,0,30,26
1656946758723,MATH 20D,A03,083767,Tran; Brian Kha,3,0,30,27
1656946764761,MATH 20E,A01,083771,Ganguly; Soumya,5,0,32,27
1656946764761,MATH 20E,A02,083772,Ganguly; Soumya,6,0,32,26
1656946764761,MATH 20E,B01,083773,Ciotti; Benjamin,18,0,35,17
1656946764761,MATH 20E,B02,083774,Ciotti; Benjamin,17,0,35,18
1656946770797,MATH 103A,A01,083777,Greenfeld; Be'Eri,2,0,36,34
1656946770797,MATH 103A,A02,083778,Greenfeld; Be'Eri,5,0,36,31
1656946770797,MATH 103A,A03,093561,Greenfeld; Be'Eri,4,0,36,32
1656946770797,MATH 103A,B01,083779,Greenfeld; Be'Eri,6,0,36,30
1656946770797,MATH 103A,B02,083780,Greenfeld; Be'Eri,2,0,36,34
1656946770797,MATH 103A,B03,093562,Greenfeld; Be'Eri,2,0,36,34
1656946776824,MATH 105,A01,085443,Carter; Anne Toulson,13,0,35,22
1656946776824,MATH 105,A02,093477,Carter; Anne Toulson,20,0,35,15
1656946782857,MATH 109,A01,083213,Ganzberger; Geoffrey Michael,2,0,34,32
1656946782857,MATH 109,A02,083214,Ganzberger; Geoffrey Michael,2,0,34,32
1656946782857,MATH 109,A03,093478,Ganzberger; Geoffrey Michael,1,0,34,33
1656946782857,MATH 109,B01,083215,Ganzberger; Geoffrey Michael,1,0,32,31
1656946782857,MATH 109,B02,083216,Ganzberger; Geoffrey Michael,1,0,32,31
1656946782857,MATH 109,B03,093479,Ganzberger; Geoffrey Michael,6,0,32,26
1656946788885,MATH 142A,A01,083219,Chow; Bennett,6,0,32,26
1656946788885,MATH 142A,A02,083220,Chow; Bennett,10,0,32,22
1656946788885,MATH 142A,A03,093480,Chow; Bennett,7,0,32,25
1656946788885,MATH 142A,B03,093481,Chow; Bennett,7,0,32,25
1656946788885,MATH 142A,B04,093558,Chow; Bennett,11,0,32,21
1656946788885,MATH 142A,B05,093559,Chow; Bennett,6,0,32,26
1656946794917,MATH 193A,A01,083224,Rotar; Vladimir,7,0,34,27
1656946794917,MATH 193A,A02,083225,Rotar; Vladimir,3,0,34,31
1656946794917,MATH 193A,A03,083781,Rotar; Vladimir,1,0,34,33
1656946794917,MATH 193A,A04,083782,Rotar; Vladimir,6,0,34,28
1656946794917,MATH 193A,A05,093482,Rotar; Vladimir,6,0,34,28
1656946800944,MATH 197,001,091859,McAuley; Julian John,9999,0,9999,0
1656946800944,MATH 197,002,095566,Kedlaya; Kiran S.,9997,0,9999,2
1656946800944,MATH 197,003,095567,Xiao; Ming,9999,0,9999,0
1656946800944,MATH 197,004,095571,Perols; Johan Lars,9998,0,9999,1
1656946808013,COGS 9,A01,083615,Shannon; Kyle Michael,7,0,75,68
1656946814036,COGS 11,A01,083617,Boyle; Mary E. T.,19,0,48,29
1656946820061,COGS 13,A01,083071,Bastos; Amalia Pinkusfeld,9,0,71,62
1656946826084,COGS 14A,A01,092681,Semenuks; Arturs,0,1,100,100
1656946832107,COGS 14B,A01,083073,Cheng; Tzu-Han,5,0,63,58
1656946838132,COGS 17,A01,092677,Semenuks; Arturs,4,0,81,77
1656946844161,COGS 100,A01,083619,Allen; Michael Gordon,15,0,70,55
1656946850188,COGS 101A,A01,083621,Davis; Joshua Daniel,9,0,68,59
1656946856211,COGS 101B,A01,091572,Allen; Michael Gordon,8,0,65,57
1656946862237,COGS 101C,A01,083625,Delgado; Tania,17,0,35,18
1656946868262,COGS 107A,A01,083627,Boyle; Mary E. T.,13,0,60,47
1656946874290,COGS 118A,A01,083075,Gupta; Anjum,15,0,76,61
1656946880313,CSE 3,A50,083646,Miranda; Gregory Joseph,22,0,50,28
1656946886427,CSE 8A,A50,083650,Miranda; Gregory Joseph,17,1,56,39
1656946892449,CSE 11,A01,083080,Cao; Yingjun,4,15,40,36
1656946898472,CSE 12,A01,083652,Krause-Levy; Sophia Louisa,20,1,120,100
1656946904494,CSE 15L,A01,083654,Morris; Justin Loren,8,0,50,42
1656946904494,CSE 15L,A02,083655,Morris; Justin Loren,8,0,50,42
1656946910522,CSE 20,A01,083657,Tran; Khoa Dang,37,0,80,43
1656946916544,CSE 21,A01,095574,Bach; Quang Tran,21,0,48,27
1656946922567,CSE 30,A01,083084,Eldon; John,4,0,80,76
1656946922567,CSE 30,B01,095061,Bhaskar; Nishant,6,0,50,44
1656946928594,CSE 100,A01,083659,Cao; Yingjun,3,4,70,67
1656946934617,CSE 134B,A01,083661,Powell; Thomas Allan,19,0,100,81
1656946940641,CSE 140,A01,083663,Gungor; Onat,14,0,85,71
1656946946665,CSE 140L,A01,083088,Eldon; John,16,0,100,84
1656946952687,CSE 175,A01,083665,Kumar; Rakesh,3,0,25,22
1656946958709,CSE 190,A00,092507,Dubnov; Shlomo,7,0,20,13
1656946964732,ECE 45,A01,083139,Congero; Spencer William,5,0,75,70
1656946970759,ECE 65,A50,083695,Saad; Andrew S,12,0,30,18
1656946970759,ECE 65,A51,095125,Saad; Andrew S,25,0,26,1
1656946976785,ECE 109,A01,091882,Touri; Behrouz,16,0,70,54
1656946982812,ECE 180,A00,083140,Abi Samra; Nicholas Camill,0,0,30,30
1656946982812,ECE 180,B00,083141,Abi Samra; Nicholas Camill,0,0,30,30
1656946988834,MATH 10A,A01,083735,Patchell; Gregory David,1,0,30,29
1656946988834,MATH 10A,A02,083736,Patchell; Gregory David,20,0,30,10
1656946988834,MATH 10A,A03,083737,Patchell; Gregory David,15,0,30,15
1656946994858,MATH 10B,A01,083207,Lim; Seonhee,7,0,34,27
1656946994858,MATH 10B,A02,083208,Lim; Seonhee,9,0,35,26
1656946994858,MATH 10B,A03,093472,Lim; Seonhee,4,0,34,30
1656946994858,MATH 10B,B01,083739,Sinha; Shubham,9,0,30,21
1656947000881,MATH 18,A01,083743,Cinel; Cameron Alexander,6,0,30,24
1656947000881,MATH 18,A02,083744,Cinel; Cameron Alexander,15,0,30,15
1656947000881,MATH 18,A03,083745,Cinel; Cameron Alexander,8,0,30,22
1656947000881,MATH 18,B01,083748,Rideout; David Porter,4,0,37,33
1656947000881,MATH 18,B02,083749,Rideout; David Porter,3,0,36,33
1656947000881,MATH 18,B03,083750,Rideout; David Porter,2,0,37,35
1656947000881,MATH 18,B04,083751,Rideout; David Porter,5,0,36,31
1656947000881,MATH 18,B05,093473,Rideout; David Porter,4,0,36,32
1656947000881,MATH 18,B06,093474,Rideout; David Porter,5,0,36,31
1656947006907,MATH 20A,A01,083754,Zheng; Zequn,12,0,40,28
1656947012931,MATH 20B,A01,083756,Briones; Jor-el Thomas Caparas,1,0,36,35
1656947012931,MATH 20B,A02,083757,Briones; Jor-el Thomas Caparas,1,0,36,35
1656947012931,MATH 20B,A03,093475,Briones; Jor-el Thomas Caparas,0,0,36,36
1656947018953,MATH 20C,A01,083760,Briones; Jor-el Thomas Caparas,1,0,35,34
1656947018953,MATH 20C,A02,083761,Briones; Jor-el Thomas Caparas,8,0,35,27
1656947018953,MATH 20C,A03,093476,Briones; Jor-el Thomas Caparas,0,1,36,36
1656947018953,MATH 20C,B01,083762,Bach; Quang Tran,0,0,30,30
1656947024981,MATH 20D,A01,083765,Tran; Brian Kha,4,0,30,26
1656947024981,MATH 20D,A02,083766,Tran; Brian Kha,4,0,30,26
1656947024981,MATH 20D,A03,083767,Tran; Brian Kha,3,0,30,27
1656947031004,MATH 20E,A01,083771,Ganguly; Soumya,5,0,32,27
1656947031004,MATH 20E,A02,083772,Ganguly; Soumya,6,0,32,26
1656947031004,MATH 20E,B01,083773,Ciotti; Benjamin,18,0,35,17
1656947031004,MATH 20E,B02,083774,Ciotti; Benjamin,17,0,35,18
1656947037032,MATH 103A,A01,083777,Greenfeld; Be'Eri,2,0,36,34
1656947037032,MATH 103A,A02,083778,Greenfeld; Be'Eri,5,0,36,31
1656947037032,MATH 103A,A03,093561,Greenfeld; Be'Eri,4,0,36,32
1656947037032,MATH 103A,B01,083779,Greenfeld; Be'Eri,6,0,36,30
1656947037032,MATH 103A,B02,083780,Greenfeld; Be'Eri,2,0,36,34
1656947037032,MATH 103A,B03,093562,Greenfeld; Be'Eri,2,0,36,34
1656947043062,MATH 105,A01,085443,Carter; Anne Toulson,13,0,35,22
1656947043062,MATH 105,A02,093477,Carter; Anne Toulson,20,0,35,15
1656947049091,MATH 109,A01,083213,Ganzberger; Geoffrey Michael,2,0,34,32
1656947049091,MATH 109,A02,083214,Ganzberger; Geoffrey Michael,2,0,34,32
1656947049091,MATH 109,A03,093478,Ganzberger; Geoffrey Michael,1,0,34,33
1656947049091,MATH 109,B01,083215,Ganzberger; Geoffrey Michael,1,0,32,31
1656947049091,MATH 109,B02,083216,Ganzberger; Geoffrey Michael,1,0,32,31
1656947049091,MATH 109,B03,093479,Ganzberger; Geoffrey Michael,6,0,32,26
1656947055117,MATH 142A,A01,083219,Chow; Bennett,6,0,32,26
1656947055117,MATH 142A,A02,083220,Chow; Bennett,10,0,32,22
1656947055117,MATH 142A,A03,093480,Chow; Bennett,7,0,32,25
1656947055117,MATH 142A,B03,093481,Chow; Bennett,7,0,32,25
1656947055117,MATH 142A,B04,093558,Chow; Bennett,11,0,32,21
1656947055117,MATH 142A,B05,093559,Chow; Bennett,6,0,32,26
1656947061141,MATH 193A,A01,083224,Rotar; Vladimir,7,0,34,27
1656947061141,MATH 193A,A02,083225,Rotar; Vladimir,3,0,34,31
1656947061141,MATH 193A,A03,083781,Rotar; Vladimir,1,0,34,33
1656947061141,MATH 193A,A04,083782,Rotar; Vladimir,6,0,34,28
1656947061141,MATH 193A,A05,093482,Rotar; Vladimir,6,0,34,28
1656947067165,MATH 197,001,091859,McAuley; Julian John,9999,0,9999,0
1656947067165,MATH 197,002,095566,Kedlaya; Kiran S.,9997,0,9999,2
1656947067165,MATH 197,003,095567,Xiao; Ming,9999,0,9999,0
1656947067165,MATH 197,004,095571,Perols; Johan Lars,9998,0,9999,1
1656947074231,COGS 9,A01,083615,Shannon; Kyle Michael,7,0,75,68
1656947080260,COGS 11,A01,083617,Boyle; Mary E. T.,19,0,48,29
1656947086282,COGS 13,A01,083071,Bastos; Amalia Pinkusfeld,9,0,71,62
1656947092303,COGS 14A,A01,092681,Semenuks; Arturs,0,1,100,100
1656947098327,COGS 14B,A01,083073,Cheng; Tzu-Han,5,0,63,58
1656947104358,COGS 17,A01,092677,Semenuks; Arturs,4,0,81,77
1656947110383,COGS 100,A01,083619,Allen; Michael Gordon,15,0,70,55
1656947116410,COGS 101A,A01,083621,Davis; Joshua Daniel,9,0,68,59
1656947122432,COGS 101B,A01,091572,Allen; Michael Gordon,8,0,65,57
1656947128459,COGS 101C,A01,083625,Delgado; Tania,17,0,35,18
1656947134482,COGS 107A,A01,083627,Boyle; Mary E. T.,13,0,60,47
1656947140518,COGS 118A,A01,083075,Gupta; Anjum,15,0,76,61
1656947146541,CSE 3,A50,083646,Miranda; Gregory Joseph,22,0,50,28
1656947152569,CSE 8A,A50,083650,Miranda; Gregory Joseph,17,1,56,39
1656947158593,CSE 11,A01,083080,Cao; Yingjun,4,15,40,36
1656947164619,CSE 12,A01,083652,Krause-Levy; Sophia Louisa,20,1,120,100
1656947170645,CSE 15L,A01,083654,Morris; Justin Loren,8,0,50,42
1656947170645,CSE 15L,A02,083655,Morris; Justin Loren,8,0,50,42
1656947176667,CSE 20,A01,083657,Tran; Khoa Dang,37,0,80,43
1656947182690,CSE 21,A01,095574,Bach; Quang Tran,21,0,48,27
1656947188714,CSE 30,A01,083084,Eldon; John,4,0,80,76
1656947188714,CSE 30,B01,095061,Bhaskar; Nishant,6,0,50,44
1656947194739,CSE 100,A01,083659,Cao; Yingjun,3,4,70,67
1656947200762,CSE 134B,A01,083661,Powell; Thomas Allan,19,0,100,81
1656947206788,CSE 140,A01,083663,Gungor; Onat,14,0,85,71
1656947212811,CSE 140L,A01,083088,Eldon; John,16,0,100,84
1656947218835,CSE 175,A01,083665,Kumar; Rakesh,3,0,25,22
1656947224862,CSE 190,A00,092507,Dubnov; Shlomo,7,0,20,13
1656947230889,ECE 45,A01,083139,Congero; Spencer William,5,0,75,70
1656947236912,ECE 65,A50,083695,Saad; Andrew S,12,0,30,18
1656947236912,ECE 65,A51,095125,Saad; Andrew S,25,0,26,1
1656947242936,ECE 109,A01,091882,Touri; Behrouz,16,0,70,54
1656947248957,ECE 180,A00,083140,Abi Samra; Nicholas Camill,0,0,30,30
1656947248957,ECE 180,B00,083141,Abi Samra; Nicholas Camill,0,0,30,30
1656947254981,MATH 10A,A01,083735,Patchell; Gregory David,1,0,30,29
1656947254981,MATH 10A,A02,083736,Patchell; Gregory David,20,0,30,10
1656947254981,MATH 10A,A03,083737,Patchell; Gregory David,15,0,30,15
1656947261007,MATH 10B,A01,083207,Lim; Seonhee,7,0,34,27
1656947261007,MATH 10B,A02,083208,Lim; Seonhee,9,0,35,26
1656947261007,MATH 10B,A03,093472,Lim; Seonhee,4,0,34,30
1656947261007,MATH 10B,B01,083739,Sinha; Shubham,9,0,30,21
1656947267041,MATH 18,A01,083743,Cinel; Cameron Alexander,6,0,30,24
1656947267041,MATH 18,A02,083744,Cinel; Cameron Alexander,15,0,30,15
1656947267041,MATH 18,A03,083745,Cinel; Cameron Alexander,8,0,30,22
1656947267041,MATH 18,B01,083748,Rideout; David Porter,4,0,37,33
1656947267041,MATH 18,B02,083749,Rideout; David Porter,3,0,36,33
1656947267041,MATH 18,B03,083750,Rideout; David Porter,2,0,37,35
1656947267041,MATH 18,B04,083751,Rideout; David Porter,5,0,36,31
1656947267041,MATH 18,B05,093473,Rideout; David Porter,4,0,36,32
1656947267041,MATH 18,B06,093474,Rideout; David Porter,5,0,36,31
1656947273065,MATH 20A,A01,083754,Zheng; Zequn,12,0,40,28
1656947279091,MATH 20B,A01,083756,Briones; Jor-el Thomas Caparas,1,0,36,35
1656947279091,MATH 20B,A02,083757,Briones; Jor-el Thomas Caparas,1,0,36,35
1656947279091,MATH 20B,A03,093475,Briones; Jor-el Thomas Caparas,0,0,36,36
1656947285125,MATH 20C,A01,083760,Briones; Jor-el Thomas Caparas,1,0,35,34
1656947285125,MATH 20C,A02,083761,Briones; Jor-el Thomas Caparas,8,0,35,27
1656947285125,MATH 20C,A03,093476,Briones; Jor-el Thomas Caparas,0,1,36,36
1656947285125,MATH 20C,B01,083762,Bach; Quang Tran,0,0,30,30
1656947291149,MATH 20D,A01,083765,Tran; Brian Kha,4,0,30,26
1656947291149,MATH 20D,A02,083766,Tran; Brian Kha,4,0,30,26
1656947291149,MATH 20D,A03,083767,Tran; Brian Kha,3,0,30,27
1656947297177,MATH 20E,A01,083771,Ganguly; Soumya,5,0,32,27
1656947297177,MATH 20E,A02,083772,Ganguly; Soumya,6,0,32,26
1656947297177,MATH 20E,B01,083773,Ciotti; Benjamin,18,0,35,17
1656947297177,MATH 20E,B02,083774,Ciotti; Benjamin,17,0,35,18
1656947303200,MATH 103A,A01,083777,Greenfeld; Be'Eri,2,0,36,34
1656947303200,MATH 103A,A02,083778,Greenfeld; Be'Eri,5,0,36,31
1656947303200,MATH 103A,A03,093561,Greenfeld; Be'Eri,4,0,36,32
1656947303200,MATH 103A,B01,083779,Greenfeld; Be'Eri,6,0,36,30
1656947303200,MATH 103A,B02,083780,Greenfeld; Be'Eri,2,0,36,34
1656947303200,MATH 103A,B03,093562,Greenfeld; Be'Eri,2,0,36,34
1656947309224,MATH 105,A01,085443,Carter; Anne Toulson,13,0,35,22
1656947309224,MATH 105,A02,093477,Carter; Anne Toulson,20,0,35,15
1656947315250,MATH 109,A01,083213,Ganzberger; Geoffrey Michael,2,0,34,32
1656947315250,MATH 109,A02,083214,Ganzberger; Geoffrey Michael,2,0,34,32
1656947315250,MATH 109,A03,093478,Ganzberger; Geoffrey Michael,1,0,34,33
1656947315250,MATH 109,B01,083215,Ganzberger; Geoffrey Michael,1,0,32,31
1656947315250,MATH 109,B02,083216,Ganzberger; Geoffrey Michael,1,0,32,31
1656947315250,MATH 109,B03,093479,Ganzberger; Geoffrey Michael,6,0,32,26
1656947321275,MATH 142A,A01,083219,Chow; Bennett,6,0,32,26
1656947321275,MATH 142A,A02,083220,Chow; Bennett,10,0,32,22
1656947321275,MATH 142A,A03,093480,Chow; Bennett,7,0,32,25
1656947321275,MATH 142A,B03,093481,Chow; Bennett,7,0,32,25
1656947321275,MATH 142A,B04,093558,Chow; Bennett,11,0,32,21
1656947321275,MATH 142A,B05,093559,Chow; Bennett,6,0,32,26
1656947327305,MATH 193A,A01,083224,Rotar; Vladimir,7,0,34,27
1656947327305,MATH 193A,A02,083225,Rotar; Vladimir,3,0,34,31
1656947327305,MATH 193A,A03,083781,Rotar; Vladimir,1,0,34,33
1656947327305,MATH 193A,A04,083782,Rotar; Vladimir,6,0,34,28
1656947327305,MATH 193A,A05,093482,Rotar; Vladimir,6,0,34,28
1656947333329,MATH 197,001,091859,McAuley; Julian John,9999,0,9999,0
1656947333329,MATH 197,002,095566,Kedlaya; Kiran S.,9997,0,9999,2
1656947333329,MATH 197,003,095567,Xiao; Ming,9999,0,9999,0
1656947333329,MATH 197,004,095571,Perols; Johan Lars,9998,0,9999,1
1656947340382,COGS 9,A01,083615,Shannon; Kyle Michael,7,0,75,68
1656947346416,COGS 11,A01,083617,Boyle; Mary E. T.,19,0,48,29
1656947352438,COGS 13,A01,083071,Bastos; Amalia Pinkusfeld,9,0,71,62
1656947358460,COGS 14A,A01,092681,Semenuks; Arturs,0,1,100,100
1656947364481,COGS 14B,A01,083073,Cheng; Tzu-Han,5,0,63,58
1656947370508,COGS 17,A01,092677,Semenuks; Arturs,4,0,81,77
1656947376543,COGS 100,A01,083619,Allen; Michael Gordon,15,0,70,55
1656947382570,COGS 101A,A01,083621,Davis; Joshua Daniel,9,0,68,59
1656947388605,COGS 101B,A01,091572,Allen; Michael Gordon,8,0,65,57
1656947394630,COGS 101C,A01,083625,Delgado; Tania,17,0,35,18
1656947400656,COGS 107A,A01,083627,Boyle; Mary E. T.,13,0,60,47
1656947406679,COGS 118A,A01,083075,Gupta; Anjum,15,0,76,61
1656947412708,CSE 3,A50,083646,Miranda; Gregory Joseph,22,0,50,28
1656947418731,CSE 8A,A50,083650,Miranda; Gregory Joseph,17,1,56,39
1656947424760,CSE 11,A01,083080,Cao; Yingjun,4,15,40,36
1656947430784,CSE 12,A01,083652,Krause-Levy; Sophia Louisa,20,1,120,100
1656947436809,CSE 15L,A01,083654,Morris; Justin Loren,8,0,50,42
1656947436809,CSE 15L,A02,083655,Morris; Justin Loren,8,0,50,42
1656947442850,CSE 20,A01,083657,Tran; Khoa Dang,37,0,80,43
1656947448878,CSE 21,A01,095574,Bach; Quang Tran,21,0,48,27
1656947454908,CSE 30,A01,083084,Eldon; John,4,0,80,76
1656947454908,CSE 30,B01,095061,Bhaskar; Nishant,6,0,50,44
1656947460938,CSE 100,A01,083659,Cao; Yingjun,3,4,70,67
1656947466963,CSE 134B,A01,083661,Powell; Thomas Allan,19,0,100,81
1656947472987,CSE 140,A01,083663,Gungor; Onat,14,0,85,71
1656947479016,CSE 140L,A01,083088,Eldon; John,16,0,100,84
1656947485113,CSE 175,A01,083665,Kumar; Rakesh,3,0,25,22
1656947491150,CSE 190,A00,092507,Dubnov; Shlomo,7,0,20,13
1656947497175,ECE 45,A01,083139,Congero; Spencer William,5,0,75,70
1656947503199,ECE 65,A50,083695,Saad; Andrew S,12,0,30,18
1656947503199,ECE 65,A51,095125,Saad; Andrew S,25,0,26,1
1656947509226,ECE 109,A01,091882,Touri; Behrouz,16,0,70,54
1656947515254,ECE 180,A00,083140,Abi Samra; Nicholas Camill,0,0,30,30
1656947515254,ECE 180,B00,083141,Abi Samra; Nicholas Camill,0,0,30,30
1656947521279,MATH 10A,A01,083735,Patchell; Gregory David,1,0,30,29
1656947521279,MATH 10A,A02,083736,Patchell; Gregory David,20,0,30,10
1656947521279,MATH 10A,A03,083737,Patchell; Gregory David,15,0,30,15
1656947527304,MATH 10B,A01,083207,Lim; Seonhee,7,0,34,27
1656947527304,MATH 10B,A02,083208,Lim; Seonhee,9,0,35,26
1656947527304,MATH 10B,A03,093472,Lim; Seonhee,4,0,34,30
1656947527304,MATH 10B,B01,083739,Sinha; Shubham,9,0,30,21
1656947533332,MATH 18,A01,083743,Cinel; Cameron Alexander,6,0,30,24
1656947533332,MATH 18,A02,083744,Cinel; Cameron Alexander,15,0,30,15
1656947533332,MATH 18,A03,083745,Cinel; Cameron Alexander,8,0,30,22
1656947533332,MATH 18,B01,083748,Rideout; David Porter,4,0,37,33
1656947533332,MATH 18,B02,083749,Rideout; David Porter,3,0,36,33
1656947533332,MATH 18,B03,083750,Rideout; David Porter,2,0,37,35
1656947533332,MATH 18,B04,083751,Rideout; David Porter,5,0,36,31
1656947533332,MATH 18,B05,093473,Rideout; David Porter,4,0,36,32
1656947533332,MATH 18,B06,093474,Rideout; David Porter,5,0,36,31
1656947539355,MATH 20A,A01,083754,Zheng; Zequn,12,0,40,28
1656947545380,MATH 20B,A01,083756,Briones; Jor-el Thomas Caparas,1,0,36,35
1656947545380,MATH 20B,A02,083757,Briones; Jor-el Thomas Caparas,1,0,36,35
1656947545380,MATH 20B,A03,093475,Briones; Jor-el Thomas Caparas,0,0,36,36
1656947551403,MATH 20C,A01,083760,Briones; Jor-el Thomas Caparas,1,0,35,34
1656947551403,MATH 20C,A02,083761,Briones; Jor-el Thomas Caparas,8,0,35,27
1656947551403,MATH 20C,A03,093476,Briones; Jor-el Thomas Caparas,0,1,36,36
1656947551403,MATH 20C,B01,083762,Bach; Quang Tran,0,0,30,30
1656947557432,MATH 20D,A01,083765,Tran; Brian Kha,4,0,30,26
1656947557432,MATH 20D,A02,083766,Tran; Brian Kha,4,0,30,26
1656947557432,MATH 20D,A03,083767,Tran; Brian Kha,3,0,30,27
1656947563457,MATH 20E,A01,083771,Ganguly; Soumya,5,0,32,27
1656947563457,MATH 20E,A02,083772,Ganguly; Soumya,6,0,32,26
1656947563457,MATH 20E,B01,083773,Ciotti; Benjamin,18,0,35,17
1656947563457,MATH 20E,B02,083774,Ciotti; Benjamin,17,0,35,18
1656947569481,MATH 103A,A01,083777,Greenfeld; Be'Eri,2,0,36,34
1656947569481,MATH 103A,A02,083778,Greenfeld; Be'Eri,5,0,36,31
1656947569481,MATH 103A,A03,093561,Greenfeld; Be'Eri,4,0,36,32
1656947569481,MATH 103A,B01,083779,Greenfeld; Be'Eri,6,0,36,30
1656947569481,MATH 103A,B02,083780,Greenfeld; Be'Eri,2,0,36,34
1656947569481,MATH 103A,B03,093562,Greenfeld; Be'Eri,2,0,36,34
1656947575506,MATH 105,A01,085443,Carter; Anne Toulson,13,0,35,22
1656947575506,MATH 105,A02,093477,Carter; Anne Toulson,20,0,35,15
1656947581530,MATH 109,A01,083213,Ganzberger; Geoffrey Michael,2,0,34,32
1656947581530,MATH 109,A02,083214,Ganzberger; Geoffrey Michael,2,0,34,32
1656947581530,MATH 109,A03,093478,Ganzberger; Geoffrey Michael,1,0,34,33
1656947581530,MATH 109,B01,083215,Ganzberger; Geoffrey Michael,1,0,32,31
1656947581530,MATH 109,B02,083216,Ganzberger; Geoffrey Michael,1,0,32,31
1656947581530,MATH 109,B03,093479,Ganzberger; Geoffrey Michael,6,0,32,26
1656947587555,MATH 142A,A01,083219,Chow; Bennett,6,0,32,26
1656947587555,MATH 142A,A02,083220,Chow; Bennett,10,0,32,22
1656947587555,MATH 142A,A03,093480,Chow; Bennett,7,0,32,25
1656947587555,MATH 142A,B03,093481,Chow; Bennett,7,0,32,25
1656947587555,MATH 142A,B04,093558,Chow; Bennett,11,0,32,21
1656947587555,MATH 142A,B05,093559,Chow; Bennett,6,0,32,26
1656947593581,MATH 193A,A01,083224,Rotar; Vladimir,7,0,34,27
1656947593581,MATH 193A,A02,083225,Rotar; Vladimir,3,0,34,31
1656947593581,MATH 193A,A03,083781,Rotar; Vladimir,1,0,34,33
1656947593581,MATH 193A,A04,083782,Rotar; Vladimir,6,0,34,28
1656947593581,MATH 193A,A05,093482,Rotar; Vladimir,6,0,34,28
1656947599604,MATH 197,001,091859,McAuley; Julian John,9999,0,9999,0
1656947599604,MATH 197,002,095566,Kedlaya; Kiran S.,9997,0,9999,2
1656947599604,MATH 197,003,095567,Xiao; Ming,9999,0,9999,0
1656947599604,MATH 197,004,095571,Perols; Johan Lars,9998,0,9999,1
1656947606666,COGS 9,A01,083615,Shannon; Kyle Michael,7,0,75,68
1656947612693,COGS 11,A01,083617,Boyle; Mary E. T.,19,0,48,29
1656947618717,COGS 13,A01,083071,Bastos; Amalia Pinkusfeld,9,0,71,62
1656947624747,COGS 14A,A01,092681,Semenuks; Arturs,0,1,100,100
1656947630770,COGS 14B,A01,083073,Cheng; Tzu-Han,5,0,63,58
1656947636794,COGS 17,A01,092677,Semenuks; Arturs,4,0,81,77
1656947642818,COGS 100,A01,083619,Allen; Michael Gordon,15,0,70,55
1656947648847,COGS 101A,A01,083621,Davis; Joshua Daniel,9,0,68,59
1656947654871,COGS 101B,A01,091572,Allen; Michael Gordon,8,0,65,57
1656947660893,COGS 101C,A01,083625,Delgado; Tania,17,0,35,18
1656947666916,COGS 107A,A01,083627,Boyle; Mary E. T.,13,0,60,47
1656947672940,COGS 118A,A01,083075,Gupta; Anjum,15,0,76,61
1656947678969,CSE 3,A50,083646,Miranda; Gregory Joseph,22,0,50,28
1656947684997,CSE 8A,A50,083650,Miranda; Gregory Joseph,17,1,56,39
1656947691023,CSE 11,A01,083080,Cao; Yingjun,4,15,40,36
1656947697049,CSE 12,A01,083652,Krause-Levy; Sophia Louisa,20,1,120,100
1656947703071,CSE 15L,A01,083654,Morris; Justin Loren,8,0,50,42
1656947703071,CSE 15L,A02,083655,Morris; Justin Loren,8,0,50,42
1656947709095,CSE 20,A01,083657,Tran; Khoa Dang,37,0,80,43
1656947715123,CSE 21,A01,095574,Bach; Quang Tran,21,0,48,27
1656947721151,CSE 30,A01,083084,Eldon; John,4,0,80,76
1656947721151,CSE 30,B01,095061,Bhaskar; Nishant,6,0,50,44
1656947727173,CSE 100,A01,083659,Cao; Yingjun,3,4,70,67
1656947733201,CSE 134B,A01,083661,Powell; Thomas Allan,19,0,100,81
1656947739225,CSE 140,A01,083663,Gungor; Onat,14,0,85,71
1656947745248,CSE 140L,A01,083088,Eldon; John,16,0,100,84
1656947751274,CSE 175,A01,083665,Kumar; Rakesh,3,0,25,22
1656947757300,CSE 190,A00,092507,Dubnov; Shlomo,7,0,20,13
1656947763328,ECE 45,A01,083139,Congero; Spencer William,5,0,75,70
1656947769356,ECE 65,A50,083695,Saad; Andrew S,12,0,30,18
1656947769356,ECE 65,A51,095125,Saad; Andrew S,25,0,26,1
1656947775379,ECE 109,A01,091882,Touri; Behrouz,16,0,70,54
1656947781403,ECE 180,A00,083140,Abi Samra; Nicholas Camill,0,0,30,30
1656947781403,ECE 180,B00,083141,Abi Samra; Nicholas Camill,0,0,30,30
1656947787431,MATH 10A,A01,083735,Patchell; Gregory David,1,0,30,29
1656947787431,MATH 10A,A02,083736,Patchell; Gregory David,20,0,30,10
1656947787431,MATH 10A,A03,083737,Patchell; Gregory David,15,0,30,15
1656947793459,MATH 10B,A01,083207,Lim; Seonhee,7,0,34,27
1656947793459,MATH 10B,A02,083208,Lim; Seonhee,9,0,35,26
1656947793459,MATH 10B,A03,093472,Lim; Seonhee,4,0,34,30
1656947793459,MATH 10B,B01,083739,Sinha; Shubham,9,0,30,21
1656947799486,MATH 18,A01,083743,Cinel; Cameron Alexander,6,0,30,24
1656947799486,MATH 18,A02,083744,Cinel; Cameron Alexander,15,0,30,15
1656947799486,MATH 18,A03,083745,Cinel; Cameron Alexander,8,0,30,22
1656947799486,MATH 18,B01,083748,Rideout; David Porter,4,0,37,33
1656947799486,MATH 18,B02,083749,Rideout; David Porter,3,0,36,33
1656947799486,MATH 18,B03,083750,Rideout; David Porter,2,0,37,35
1656947799486,MATH 18,B04,083751,Rideout; David Porter,5,0,36,31
1656947799486,MATH 18,B05,093473,Rideout; David Porter,4,0,36,32
1656947799486,MATH 18,B06,093474,Rideout; David Porter,5,0,36,31
1656947805509,MATH 20A,A01,083754,Zheng; Zequn,12,0,40,28
1656947811535,MATH 20B,A01,083756,Briones; Jor-el Thomas Caparas,1,0,36,35
1656947811535,MATH 20B,A02,083757,Briones; Jor-el Thomas Caparas,1,0,36,35
1656947811535,MATH 20B,A03,093475,Briones; Jor-el Thomas Caparas,0,0,36,36
1656947817562,MATH 20C,A01,083760,Briones; Jor-el Thomas Caparas,1,0,35,34
1656947817562,MATH 20C,A02,083761,Briones; Jor-el Thomas Caparas,8,0,35,27
1656947817562,MATH 20C,A03,093476,Briones; Jor-el Thomas Caparas,0,1,36,36
1656947817562,MATH 20C,B01,083762,Bach; Quang Tran,0,0,30,30
1656947823589,MATH 20D,A01,083765,Tran; Brian Kha,4,0,30,26
1656947823589,MATH 20D,A02,083766,Tran; Brian Kha,4,0,30,26
1656947823589,MATH 20D,A03,083767,Tran; Brian Kha,3,0,30,27
1656947829617,MATH 20E,A01,083771,Ganguly; Soumya,5,0,32,27
1656947829617,MATH 20E,A02,083772,Ganguly; Soumya,6,0,32,26
1656947829617,MATH 20E,B01,083773,Ciotti; Benjamin,18,0,35,17
1656947829617,MATH 20E,B02,083774,Ciotti; Benjamin,17,0,35,18
1656947835641,MATH 103A,A01,083777,Greenfeld; Be'Eri,2,0,36,34
1656947835641,MATH 103A,A02,083778,Greenfeld; Be'Eri,5,0,36,31
1656947835641,MATH 103A,A03,093561,Greenfeld; Be'Eri,4,0,36,32
1656947835641,MATH 103A,B01,083779,Greenfeld; Be'Eri,6,0,36,30
1656947835641,MATH 103A,B02,083780,Greenfeld; Be'Eri,2,0,36,34
1656947835641,MATH 103A,B03,093562,Greenfeld; Be'Eri,2,0,36,34
1656947841663,MATH 105,A01,085443,Carter; Anne Toulson,13,0,35,22
1656947841663,MATH 105,A02,093477,Carter; Anne Toulson,20,0,35,15
1656947847687,MATH 109,A01,083213,Ganzberger; Geoffrey Michael,2,0,34,32
1656947847687,MATH 109,A02,083214,Ganzberger; Geoffrey Michael,2,0,34,32
1656947847687,MATH 109,A03,093478,Ganzberger; Geoffrey Michael,1,0,34,33
1656947847687,MATH 109,B01,083215,Ganzberger; Geoffrey Michael,1,0,32,31
1656947847687,MATH 109,B02,083216,Ganzberger; Geoffrey Michael,1,0,32,31
1656947847687,MATH 109,B03,093479,Ganzberger; Geoffrey Michael,6,0,32,26
1656947853712,MATH 142A,A01,083219,Chow; Bennett,6,0,32,26
1656947853712,MATH 142A,A02,083220,Chow; Bennett,10,0,32,22
1656947853712,MATH 142A,A03,093480,Chow; Bennett,7,0,32,25
1656947853712,MATH 142A,B03,093481,Chow; Bennett,7,0,32,25
1656947853712,MATH 142A,B04,093558,Chow; Bennett,11,0,32,21
1656947853712,MATH 142A,B05,093559,Chow; Bennett,6,0,32,26
1656947859736,MATH 193A,A01,083224,Rotar; Vladimir,7,0,34,27
1656947859736,MATH 193A,A02,083225,Rotar; Vladimir,3,0,34,31
1656947859736,MATH 193A,A03,083781,Rotar; Vladimir,1,0,34,33
1656947859736,MATH 193A,A04,083782,Rotar; Vladimir,6,0,34,28
1656947859736,MATH 193A,A05,093482,Rotar; Vladimir,6,0,34,28
1656947865762,MATH 197,001,091859,McAuley; Julian John,9999,0,9999,0
1656947865762,MATH 197,002,095566,Kedlaya; Kiran S.,9997,0,9999,2
1656947865762,MATH 197,003,095567,Xiao; Ming,9999,0,9999,0
1656947865762,MATH 197,004,095571,Perols; Johan Lars,9998,0,9999,1
1656947872814,COGS 9,A01,083615,Shannon; Kyle Michael,7,0,75,68
1656947878838,COGS 11,A01,083617,Boyle; Mary E. T.,19,0,48,29
1656947884864,COGS 13,A01,083071,Bastos; Amalia Pinkusfeld,9,0,71,62
1656947890887,COGS 14A,A01,092681,Semenuks; Arturs,0,1,100,100
1656947896911,COGS 14B,A01,083073,Cheng; Tzu-Han,5,0,63,58
1656947902936,COGS 17,A01,092677,Semenuks; Arturs,4,0,81,77
1656947908960,COGS 100,A01,083619,Allen; Michael Gordon,15,0,70,55
1656947914987,COGS 101A,A01,083621,Davis; Joshua Daniel,9,0,68,59
1656947921011,COGS 101B,A01,091572,Allen; Michael Gordon,8,0,65,57
1656947927034,COGS 101C,A01,083625,Delgado; Tania,17,0,35,18
1656947933061,COGS 107A,A01,083627,Boyle; Mary E. T.,13,0,60,47
1656947939087,COGS 118A,A01,083075,Gupta; Anjum,15,0,76,61
1656947945111,CSE 3,A50,083646,Miranda; Gregory Joseph,22,0,50,28
1656947951134,CSE 8A,A50,083650,Miranda; Gregory Joseph,17,1,56,39
1656947957161,CSE 11,A01,083080,Cao; Yingjun,4,15,40,36
1656947963185,CSE 12,A01,083652,Krause-Levy; Sophia Louisa,20,1,120,100
1656947969215,CSE 15L,A01,083654,Morris; Justin Loren,8,0,50,42
1656947969215,CSE 15L,A02,083655,Morris; Justin Loren,8,0,50,42
1656947975243,CSE 20,A01,083657,Tran; Khoa Dang,37,0,80,43
1656947981272,CSE 21,A01,095574,Bach; Quang Tran,21,0,48,27
1656947987299,CSE 30,A01,083084,Eldon; John,4,0,80,76
1656947987299,CSE 30,B01,095061,Bhaskar; Nishant,6,0,50,44
1656947993326,CSE 100,A01,083659,Cao; Yingjun,3,4,70,67
1656947999368,CSE 134B,A01,083661,Powell; Thomas Allan,19,0,100,81
1656948005395,CSE 140,A01,083663,Gungor; Onat,14,0,85,71
1656948011417,CSE 140L,A01,083088,Eldon; John,16,0,100,84
1656948017461,CSE 175,A01,083665,Kumar; Rakesh,3,0,25,22
1656948023485,CSE 190,A00,092507,Dubnov; Shlomo,7,0,20,13
1656948029509,ECE 45,A01,083139,Congero; Spencer William,5,0,75,70
1656948035531,ECE 65,A50,083695,Saad; Andrew S,12,0,30,18
1656948035531,ECE 65,A51,095125,Saad; Andrew S,25,0,26,1
1656948041554,ECE 109,A01,091882,Touri; Behrouz,16,0,70,54
1656948047579,ECE 180,A00,083140,Abi Samra; Nicholas Camill,0,0,30,30
1656948047579,ECE 180,B00,083141,Abi Samra; Nicholas Camill,0,0,30,30
1656948053602,MATH 10A,A01,083735,Patchell; Gregory David,1,0,30,29
1656948053602,MATH 10A,A02,083736,Patchell; Gregory David,20,0,30,10
1656948053602,MATH 10A,A03,083737,Patchell; Gregory David,15,0,30,15
1656948059626,MATH 10B,A01,083207,Lim; Seonhee,7,0,34,27
1656948059626,MATH 10B,A02,083208,Lim; Seonhee,9,0,35,26
1656948059626,MATH 10B,A03,093472,Lim; Seonhee,4,0,34,30
1656948059626,MATH 10B,B01,083739,Sinha; Shubham,9,0,30,21
1656948065652,MATH 18,A01,083743,Cinel; Cameron Alexander,6,0,30,24
1656948065652,MATH 18,A02,083744,Cinel; Cameron Alexander,15,0,30,15
1656948065652,MATH 18,A03,083745,Cinel; Cameron Alexander,8,0,30,22
1656948065652,MATH 18,B01,083748,Rideout; David Porter,4,0,37,33
1656948065652,MATH 18,B02,083749,Rideout; David Porter,3,0,36,33
1656948065652,MATH 18,B03,083750,Rideout; David Porter,2,0,37,35
1656948065652,MATH 18,B04,083751,Rideout; David Porter,5,0,36,31
1656948065652,MATH 18,B05,093473,Rideout; David Porter,4,0,36,32
1656948065652,MATH 18,B06,093474,Rideout; David Porter,5,0,36,31
1656948071675,MATH 20A,A01,083754,Zheng; Zequn,12,0,40,28
1656948077700,MATH 20B,A01,083756,Briones; Jor-el Thomas Caparas,1,0,36,35
1656948077700,MATH 20B,A02,083757,Briones; Jor-el Thomas Caparas,1,0,36,35
1656948077700,MATH 20B,A03,093475,Briones; Jor-el Thomas Caparas,0,0,36,36
1656948083797,MATH 20C,A01,083760,Briones; Jor-el Thomas Caparas,1,0,35,34
1656948083797,MATH 20C,A02,083761,Briones; Jor-el Thomas Caparas,8,0,35,27
1656948083797,MATH 20C,A03,093476,Briones; Jor-el Thomas Caparas,0,1,36,36
1656948083797,MATH 20C,B01,083762,Bach; Quang Tran,0,0,30,30
1656948089821,MATH 20D,A01,083765,Tran; Brian Kha,4,0,30,26
1656948089821,MATH 20D,A02,083766,Tran; Brian Kha,4,0,30,26
1656948089821,MATH 20D,A03,083767,Tran; Brian Kha,3,0,30,27
1656948095847,MATH 20E,A01,083771,Ganguly; Soumya,5,0,32,27
1656948095847,MATH 20E,A02,083772,Ganguly; Soumya,6,0,32,26
1656948095847,MATH 20E,B01,083773,Ciotti; Benjamin,18,0,35,17
1656948095847,MATH 20E,B02,083774,Ciotti; Benjamin,17,0,35,18
1656948101871,MATH 103A,A01,083777,Greenfeld; Be'Eri,2,0,36,34
1656948101871,MATH 103A,A02,083778,Greenfeld; Be'Eri,5,0,36,31
1656948101871,MATH 103A,A03,093561,Greenfeld; Be'Eri,4,0,36,32
1656948101871,MATH 103A,B01,083779,Greenfeld; Be'Eri,6,0,36,30
1656948101871,MATH 103A,B02,083780,Greenfeld; Be'Eri,2,0,36,34
1656948101871,MATH 103A,B03,093562,Greenfeld; Be'Eri,2,0,36,34
1656948107894,MATH 105,A01,085443,Carter; Anne Toulson,13,0,35,22
1656948107894,MATH 105,A02,093477,Carter; Anne Toulson,20,0,35,15
1656948113923,MATH 109,A01,083213,Ganzberger; Geoffrey Michael,2,0,34,32
1656948113923,MATH 109,A02,083214,Ganzberger; Geoffrey Michael,2,0,34,32
1656948113923,MATH 109,A03,093478,Ganzberger; Geoffrey Michael,1,0,34,33
1656948113923,MATH 109,B01,083215,Ganzberger; Geoffrey Michael,1,0,32,31
1656948113923,MATH 109,B02,083216,Ganzberger; Geoffrey Michael,1,0,32,31
1656948113923,MATH 109,B03,093479,Ganzberger; Geoffrey Michael,6,0,32,26
1656948119947,MATH 142A,A01,083219,Chow; Bennett,6,0,32,26
1656948119947,MATH 142A,A02,083220,Chow; Bennett,10,0,32,22
1656948119947,MATH 142A,A03,093480,Chow; Bennett,7,0,32,25
1656948119947,MATH 142A,B03,093481,Chow; Bennett,7,0,32,25
1656948119947,MATH 142A,B04,093558,Chow; Bennett,11,0,32,21
1656948119947,MATH 142A,B05,093559,Chow; Bennett,6,0,32,26
1656948125972,MATH 193A,A01,083224,Rotar; Vladimir,7,0,34,27
1656948125972,MATH 193A,A02,083225,Rotar; Vladimir,3,0,34,31
1656948125972,MATH 193A,A03,083781,Rotar; Vladimir,1,0,34,33
1656948125972,MATH 193A,A04,083782,Rotar; Vladimir,6,0,34,28
1656948125972,MATH 193A,A05,093482,Rotar; Vladimir,6,0,34,28
1656948132000,MATH 197,001,091859,McAuley; Julian John,9999,0,9999,0
1656948132000,MATH 197,002,095566,Kedlaya; Kiran S.,9997,0,9999,2
1656948132000,MATH 197,003,095567,Xiao; Ming,9999,0,9999,0
1656948132000,MATH 197,004,095571,Perols; Johan Lars,9998,0,9999,1
1656948139057,COGS 9,A01,083615,Shannon; Kyle Michael,7,0,75,68
1656948145082,COGS 11,A01,083617,Boyle; Mary E. T.,19,0,48,29
1656948151109,COGS 13,A01,083071,Bastos; Amalia Pinkusfeld,9,0,71,62
1656948157154,COGS 14A,A01,092681,Semenuks; Arturs,0,1,100,100
1656948163179,COGS 14B,A01,083073,Cheng; Tzu-Han,5,0,63,58
1656948169204,COGS 17,A01,092677,Semenuks; Arturs,4,0,81,77
1656948175229,COGS 100,A01,083619,Allen; Michael Gordon,15,0,70,55
1656948181254,COGS 101A,A01,083621,Davis; Joshua Daniel,9,0,68,59
1656948187277,COGS 101B,A01,091572,Allen; Michael Gordon,8,0,65,57
1656948193304,COGS 101C,A01,083625,Delgado; Tania,17,0,35,18
1656948199328,COGS 107A,A01,083627,Boyle; Mary E. T.,13,0,60,47
1656948205357,COGS 118A,A01,083075,Gupta; Anjum,15,0,76,61
1656948211385,CSE 3,A50,083646,Miranda; Gregory Joseph,22,0,50,28
1656948217414,CSE 8A,A50,083650,Miranda; Gregory Joseph,17,1,56,39
1656948223444,CSE 11,A01,083080,Cao; Yingjun,4,15,40,36
1656948229469,CSE 12,A01,083652,Krause-Levy; Sophia Louisa,20,1,120,100
1656948235493,CSE 15L,A01,083654,Morris; Justin Loren,8,0,50,42
1656948235493,CSE 15L,A02,083655,Morris; Justin Loren,8,0,50,42
1656948241516,CSE 20,A01,083657,Tran; Khoa Dang,37,0,80,43
1656948247545,CSE 21,A01,095574,Bach; Quang Tran,21,0,48,27
1656948253575,CSE 30,A01,083084,Eldon; John,4,0,80,76
1656948253575,CSE 30,B01,095061,Bhaskar; Nishant,6,0,50,44
1656948259604,CSE 100,A01,083659,Cao; Yingjun,3,4,70,67
1656948265630,CSE 134B,A01,083661,Powell; Thomas Allan,19,0,100,81
1656948271652,CSE 140,A01,083663,Gungor; Onat,14,0,85,71
1656948277678,CSE 140L,A01,083088,Eldon; John,16,0,100,84
1656948283703,CSE 175,A01,083665,Kumar; Rakesh,3,0,25,22
1656948289729,CSE 190,A00,092507,Dubnov; Shlomo,7,0,20,13
1656948295757,ECE 45,A01,083139,Congero; Spencer William,5,0,75,70
1656948301786,ECE 65,A50,083695,Saad; Andrew S,12,0,30,18
1656948301786,ECE 65,A51,095125,Saad; Andrew S,25,0,26,1
1656948307811,ECE 109,A01,091882,Touri; Behrouz,16,0,70,54
1656948313834,ECE 180,A00,083140,Abi Samra; Nicholas Camill,0,0,30,30
1656948313834,ECE 180,B00,083141,Abi Samra; Nicholas Camill,0,0,30,30
1656948319859,MATH 10A,A01,083735,Patchell; Gregory David,1,0,30,29
1656948319859,MATH 10A,A02,083736,Patchell; Gregory David,20,0,30,10
1656948319859,MATH 10A,A03,083737,Patchell; Gregory David,15,0,30,15
1656948325886,MATH 10B,A01,083207,Lim; Seonhee,7,0,34,27
1656948325886,MATH 10B,A02,083208,Lim; Seonhee,9,0,35,26
1656948325886,MATH 10B,A03,093472,Lim; Seonhee,4,0,34,30
1656948325886,MATH 10B,B01,083739,Sinha; Shubham,9,0,30,21
1656948331919,MATH 18,A01,083743,Cinel; Cameron Alexander,6,0,30,24
1656948331919,MATH 18,A02,083744,Cinel; Cameron Alexander,15,0,30,15
1656948331919,MATH 18,A03,083745,Cinel; Cameron Alexander,8,0,30,22
1656948331919,MATH 18,B01,083748,Rideout; David Porter,4,0,37,33
1656948331919,MATH 18,B02,083749,Rideout; David Porter,3,0,36,33
1656948331919,MATH 18,B03,083750,Rideout; David Porter,2,0,37,35
1656948331919,MATH 18,B04,083751,Rideout; David Porter,5,0,36,31
1656948331919,MATH 18,B05,093473,Rideout; David Porter,4,0,36,32
1656948331919,MATH 18,B06,093474,Rideout; David Porter,5,0,36,31
1656948337942,MATH 20A,A01,083754,Zheng; Zequn,12,0,40,28
1656948343971,MATH 20B,A01,083756,Briones; Jor-el Thomas Caparas,1,0,36,35
1656948343971,MATH 20B,A02,083757,Briones; Jor-el Thomas Caparas,1,0,36,35
1656948343971,MATH 20B,A03,093475,Briones; Jor-el Thomas Caparas,0,0,36,36
1656948350001,MATH 20C,A01,083760,Briones; Jor-el Thomas Caparas,1,0,35,34
1656948350001,MATH 20C,A02,083761,Briones; Jor-el Thomas Caparas,8,0,35,27
1656948350001,MATH 20C,A03,093476,Briones; Jor-el Thomas Caparas,0,1,36,36
1656948350001,MATH 20C,B01,083762,Bach; Quang Tran,0,0,30,30
1656948356025,MATH 20D,A01,083765,Tran; Brian Kha,4,0,30,26
1656948356025,MATH 20D,A02,083766,Tran; Brian Kha,4,0,30,26
1656948356025,MATH 20D,A03,083767,Tran; Brian Kha,3,0,30,27
1656948362049,MATH 20E,A01,083771,Ganguly; Soumya,5,0,32,27
1656948362049,MATH 20E,A02,083772,Ganguly; Soumya,6,0,32,26
1656948362049,MATH 20E,B01,083773,Ciotti; Benjamin,18,0,35,17
1656948362049,MATH 20E,B02,083774,Ciotti; Benjamin,17,0,35,18
1656948368073,MATH 103A,A01,083777,Greenfeld; Be'Eri,2,0,36,34
1656948368073,MATH 103A,A02,083778,Greenfeld; Be'Eri,5,0,36,31
1656948368073,MATH 103A,A03,093561,Greenfeld; Be'Eri,4,0,36,32
1656948368073,MATH 103A,B01,083779,Greenfeld; Be'Eri,6,0,36,30
1656948368073,MATH 103A,B02,083780,Greenfeld; Be'Eri,2,0,36,34
1656948368073,MATH 103A,B03,093562,Greenfeld; Be'Eri,2,0,36,34
1656948374117,MATH 105,A01,085443,Carter; Anne Toulson,13,0,35,22
1656948374117,MATH 105,A02,093477,Carter; Anne Toulson,20,0,35,15
1656948380145,MATH 109,A01,083213,Ganzberger; Geoffrey Michael,2,0,34,32
1656948380145,MATH 109,A02,083214,Ganzberger; Geoffrey Michael,2,0,34,32
1656948380145,MATH 109,A03,093478,Ganzberger; Geoffrey Michael,1,0,34,33
1656948380145,MATH 109,B01,083215,Ganzberger; Geoffrey Michael,1,0,32,31
1656948380145,MATH 109,B02,083216,Ganzberger; Geoffrey Michael,1,0,32,31
1656948380145,MATH 109,B03,093479,Ganzberger; Geoffrey Michael,6,0,32,26
1656948386169,MATH 142A,A01,083219,Chow; Bennett,6,0,32,26
1656948386169,MATH 142A,A02,083220,Chow; Bennett,10,0,32,22
1656948386169,MATH 142A,A03,093480,Chow; Bennett,7,0,32,25
1656948386169,MATH 142A,B03,093481,Chow; Bennett,7,0,32,25
1656948386169,MATH 142A,B04,093558,Chow; Bennett,11,0,32,21
1656948386169,MATH 142A,B05,093559,Chow; Bennett,6,0,32,26
1656948392191,MATH 193A,A01,083224,Rotar; Vladimir,7,0,34,27
1656948392191,MATH 193A,A02,083225,Rotar; Vladimir,3,0,34,31
1656948392191,MATH 193A,A03,083781,Rotar; Vladimir,1,0,34,33
1656948392191,MATH 193A,A04,083782,Rotar; Vladimir,6,0,34,28
1656948392191,MATH 193A,A05,093482,Rotar; Vladimir,6,0,34,28
1656948398215,MATH 197,001,091859,McAuley; Julian John,9999,0,9999,0
1656948398215,MATH 197,002,095566,Kedlaya; Kiran S.,9997,0,9999,2
1656948398215,MATH 197,003,095567,Xiao; Ming,9999,0,9999,0
1656948398215,MATH 197,004,095571,Perols; Johan Lars,9998,0,9999,1
1656948405278,COGS 9,A01,083615,Shannon; Kyle Michael,7,0,75,68
1656948411305,COGS 11,A01,083617,Boyle; Mary E. T.,19,0,48,29
1656948417326,COGS 13,A01,083071,Bastos; Amalia Pinkusfeld,9,0,71,62
1656948423354,COGS 14A,A01,092681,Semenuks; Arturs,0,1,100,100
1656948429380,COGS 14B,A01,083073,Cheng; Tzu-Han,5,0,63,58
1656948435403,COGS 17,A01,092677,Semenuks; Arturs,4,0,81,77
1656948441430,COGS 100,A01,083619,Allen; Michael Gordon,15,0,70,55
1656948447453,COGS 101A,A01,083621,Davis; Joshua Daniel,9,0,68,59
1656948453476,COGS 101B,A01,091572,Allen; Michael Gordon,8,0,65,57
1656948459500,COGS 101C,A01,083625,Delgado; Tania,17,0,35,18
1656948465527,COGS 107A,A01,083627,Boyle; Mary E. T.,13,0,60,47
1656948471551,COGS 118A,A01,083075,Gupta; Anjum,15,0,76,61
1656948477578,CSE 3,A50,083646,Miranda; Gregory Joseph,22,0,50,28
1656948483601,CSE 8A,A50,083650,Miranda; Gregory Joseph,17,1,56,39
1656948489625,CSE 11,A01,083080,Cao; Yingjun,4,15,40,36
1656948495652,CSE 12,A01,083652,Krause-Levy; Sophia Louisa,20,1,120,100
1656948501674,CSE 15L,A01,083654,Morris; Justin Loren,8,0,50,42
1656948501674,CSE 15L,A02,083655,Morris; Justin Loren,8,0,50,42
1656948507698,CSE 20,A01,083657,Tran; Khoa Dang,37,0,80,43
1656948513722,CSE 21,A01,095574,Bach; Quang Tran,21,0,48,27
1656948519755,CSE 30,A01,083084,Eldon; John,4,0,80,76
1656948519755,CSE 30,B01,095061,Bhaskar; Nishant,6,0,50,44
1656948525782,CSE 100,A01,083659,Cao; Yingjun,3,4,70,67
1656948531805,CSE 134B,A01,083661,Powell; Thomas Allan,19,0,100,81
1656948537830,CSE 140,A01,083663,Gungor; Onat,14,0,85,71
1656948543856,CSE 140L,A01,083088,Eldon; John,16,0,100,84
1656948549880,CSE 175,A01,083665,Kumar; Rakesh,3,0,25,22
1656948555909,CSE 190,A00,092507,Dubnov; Shlomo,7,0,20,13
1656948561930,ECE 45,A01,083139,Congero; Spencer William,5,0,75,70
1656948567957,ECE 65,A50,083695,Saad; Andrew S,12,0,30,18
1656948567957,ECE 65,A51,095125,Saad; Andrew S,25,0,26,1
1656948573981,ECE 109,A01,091882,Touri; Behrouz,16,0,70,54
1656948580009,ECE 180,A00,083140,Abi Samra; Nicholas Camill,0,0,30,30
1656948580009,ECE 180,B00,083141,Abi Samra; Nicholas Camill,0,0,30,30
1656948586043,MATH 10A,A01,083735,Patchell; Gregory David,1,0,30,29
1656948586043,MATH 10A,A02,083736,Patchell; Gregory David,20,0,30,10
1656948586043,MATH 10A,A03,083737,Patchell; Gregory David,15,0,30,15
1656948592076,MATH 10B,A01,083207,Lim; Seonhee,7,0,34,27
1656948592076,MATH 10B,A02,083208,Lim; Seonhee,9,0,35,26
1656948592076,MATH 10B,A03,093472,Lim; Seonhee,4,0,34,30
1656948592076,MATH 10B,B01,083739,Sinha; Shubham,9,0,30,21
1656948598102,MATH 18,A01,083743,Cinel; Cameron Alexander,6,0,30,24
1656948598102,MATH 18,A02,083744,Cinel; Cameron Alexander,15,0,30,15
1656948598102,MATH 18,A03,083745,Cinel; Cameron Alexander,8,0,30,22
1656948598102,MATH 18,B01,083748,Rideout; David Porter,4,0,37,33
1656948598102,MATH 18,B02,083749,Rideout; David Porter,3,0,36,33
1656948598102,MATH 18,B03,083750,Rideout; David Porter,2,0,37,35
1656948598102,MATH 18,B04,083751,Rideout; David Porter,5,0,36,31
1656948598102,MATH 18,B05,093473,Rideout; David Porter,4,0,36,32
1656948598102,MATH 18,B06,093474,Rideout; David Porter,5,0,36,31
1656948604126,MATH 20A,A01,083754,Zheng; Zequn,12,0,40,28
1656948610160,MATH 20B,A01,083756,Briones; Jor-el Thomas Caparas,1,0,36,35
1656948610160,MATH 20B,A02,083757,Briones; Jor-el Thomas Caparas,1,0,36,35
1656948610160,MATH 20B,A03,093475,Briones; Jor-el Thomas Caparas,0,0,36,36
1656948616191,MATH 20C,A01,083760,Briones; Jor-el Thomas Caparas,1,0,35,34
1656948616191,MATH 20C,A02,083761,Briones; Jor-el Thomas Caparas,8,0,35,27
1656948616191,MATH 20C,A03,093476,Briones; Jor-el Thomas Caparas,0,1,36,36
1656948616191,MATH 20C,B01,083762,Bach; Quang Tran,0,0,30,30
1656948622220,MATH 20D,A01,083765,Tran; Brian Kha,4,0,30,26
1656948622220,MATH 20D,A02,083766,Tran; Brian Kha,4,0,30,26
1656948622220,MATH 20D,A03,083767,Tran; Brian Kha,3,0,30,27
1656948628249,MATH 20E,A01,083771,Ganguly; Soumya,5,0,32,27
1656948628249,MATH 20E,A02,083772,Ganguly; Soumya,6,0,32,26
1656948628249,MATH 20E,B01,083773,Ciotti; Benjamin,18,0,35,17
1656948628249,MATH 20E,B02,083774,Ciotti; Benjamin,17,0,35,18
1656948634282,MATH 103A,A01,083777,Greenfeld; Be'Eri,2,0,36,34
1656948634282,MATH 103A,A02,083778,Greenfeld; Be'Eri,5,0,36,31
1656948634282,MATH 103A,A03,093561,Greenfeld; Be'Eri,4,0,36,32
1656948634282,MATH 103A,B01,083779,Greenfeld; Be'Eri,6,0,36,30
1656948634282,MATH 103A,B02,083780,Greenfeld; Be'Eri,2,0,36,34
1656948634282,MATH 103A,B03,093562,Greenfeld; Be'Eri,2,0,36,34
1656948640307,MATH 105,A01,085443,Carter; Anne Toulson,13,0,35,22
1656948640307,MATH 105,A02,093477,Carter; Anne Toulson,20,0,35,15
1656948646332,MATH 109,A01,083213,Ganzberger; Geoffrey Michael,2,0,34,32
1656948646332,MATH 109,A02,083214,Ganzberger; Geoffrey Michael,2,0,34,32
1656948646332,MATH 109,A03,093478,Ganzberger; Geoffrey Michael,1,0,34,33
1656948646332,MATH 109,B01,083215,Ganzberger; Geoffrey Michael,1,0,32,31
1656948646332,MATH 109,B02,083216,Ganzberger; Geoffrey Michael,1,0,32,31
1656948646332,MATH 109,B03,093479,Ganzberger; Geoffrey Michael,6,0,32,26
1656948652357,MATH 142A,A01,083219,Chow; Bennett,6,0,32,26
1656948652357,MATH 142A,A02,083220,Chow; Bennett,10,0,32,22
1656948652357,MATH 142A,A03,093480,Chow; Bennett,7,0,32,25
1656948652357,MATH 142A,B03,093481,Chow; Bennett,7,0,32,25
1656948652357,MATH 142A,B04,093558,Chow; Bennett,11,0,32,21
1656948652357,MATH 142A,B05,093559,Chow; Bennett,6,0,32,26
1656948658386,MATH 193A,A01,083224,Rotar; Vladimir,7,0,34,27
1656948658386,MATH 193A,A02,083225,Rotar; Vladimir,3,0,34,31
1656948658386,MATH 193A,A03,083781,Rotar; Vladimir,1,0,34,33
1656948658386,MATH 193A,A04,083782,Rotar; Vladimir,6,0,34,28
1656948658386,MATH 193A,A05,093482,Rotar; Vladimir,6,0,34,28
1656948664410,MATH 197,001,091859,McAuley; Julian John,9999,0,9999,0
1656948664410,MATH 197,002,095566,Kedlaya; Kiran S.,9997,0,9999,2
1656948664410,MATH 197,003,095567,Xiao; Ming,9999,0,9999,0
1656948664410,MATH 197,004,095571,Perols; Johan Lars,9998,0,9999,1
1656948671479,COGS 9,A01,083615,Shannon; Kyle Michael,7,0,75,68
1656948677594,COGS 11,A01,083617,Boyle; Mary E. T.,19,0,48,29
1656948683628,COGS 13,A01,083071,Bastos; Amalia Pinkusfeld,9,0,71,62
1656948689657,COGS 14A,A01,092681,Semenuks; Arturs,0,1,100,100
1656948695682,COGS 14B,A01,083073,Cheng; Tzu-Han,5,0,63,58
1656948701706,COGS 17,A01,092677,Semenuks; Arturs,4,0,81,77
1656948707730,COGS 100,A01,083619,Allen; Michael Gordon,15,0,70,55
1656948713753,COGS 101A,A01,083621,Davis; Joshua Daniel,9,0,68,59
1656948719776,COGS 101B,A01,091572,Allen; Michael Gordon,8,0,65,57
1656948725799,COGS 101C,A01,083625,Delgado; Tania,17,0,35,18
1656948731832,COGS 107A,A01,083627,Boyle; Mary E. T.,13,0,60,47
1656948737856,COGS 118A,A01,083075,Gupta; Anjum,15,0,76,61
1656948743885,CSE 3,A50,083646,Miranda; Gregory Joseph,22,0,50,28
1656948749908,CSE 8A,A50,083650,Miranda; Gregory Joseph,17,1,56,39
1656948755934,CSE 11,A01,083080,Cao; Yingjun,4,15,40,36
1656948761963,CSE 12,A01,083652,Krause-Levy; Sophia Louisa,20,1,120,100
1656948767986,CSE 15L,A01,083654,Morris; Justin Loren,8,0,50,42
1656948767986,CSE 15L,A02,083655,Morris; Justin Loren,8,0,50,42
1656948774009,CSE 20,A01,083657,Tran; Khoa Dang,37,0,80,43
1656948780039,CSE 21,A01,095574,Bach; Quang Tran,21,0,48,27
1656948786062,CSE 30,A01,083084,Eldon; John,4,0,80,76
1656948786062,CSE 30,B01,095061,Bhaskar; Nishant,6,0,50,44
1656948792085,CSE 100,A01,083659,Cao; Yingjun,3,4,70,67
1656948798112,CSE 134B,A01,083661,Powell; Thomas Allan,19,0,100,81
1656948804135,CSE 140,A01,083663,Gungor; Onat,14,0,85,71
1656948810157,CSE 140L,A01,083088,Eldon; John,16,0,100,84
1656948816182,CSE 175,A01,083665,Kumar; Rakesh,3,0,25,22
1656948822205,CSE 190,A00,092507,Dubnov; Shlomo,7,0,20,13
1656948828231,ECE 45,A01,083139,Congero; Spencer William,5,0,75,70
1656948834255,ECE 65,A50,083695,Saad; Andrew S,12,0,30,18
1656948834255,ECE 65,A51,095125,Saad; Andrew S,25,0,26,1
1656948840280,ECE 109,A01,091882,Touri; Behrouz,16,0,70,54
1656948846305,ECE 180,A00,083140,Abi Samra; Nicholas Camill,0,0,30,30
1656948846305,ECE 180,B00,083141,Abi Samra; Nicholas Camill,0,0,30,30
1656948852328,MATH 10A,A01,083735,Patchell; Gregory David,1,0,30,29
1656948852328,MATH 10A,A02,083736,Patchell; Gregory David,20,0,30,10
1656948852328,MATH 10A,A03,083737,Patchell; Gregory David,15,0,30,15
1656948858357,MATH 10B,A01,083207,Lim; Seonhee,7,0,34,27
1656948858357,MATH 10B,A02,083208,Lim; Seonhee,9,0,35,26
1656948858357,MATH 10B,A03,093472,Lim; Seonhee,4,0,34,30
1656948858357,MATH 10B,B01,083739,Sinha; Shubham,9,0,30,21
1656948864382,MATH 18,A01,083743,Cinel; Cameron Alexander,6,0,30,24
1656948864382,MATH 18,A02,083744,Cinel; Cameron Alexander,15,0,30,15
1656948864382,MATH 18,A03,083745,Cinel; Cameron Alexander,8,0,30,22
1656948864382,MATH 18,B01,083748,Rideout; David Porter,4,0,37,33
1656948864382,MATH 18,B02,083749,Rideout; David Porter,3,0,36,33
1656948864382,MATH 18,B03,083750,Rideout; David Porter,2,0,37,35
1656948864382,MATH 18,B04,083751,Rideout; David Porter,5,0,36,31
1656948864382,MATH 18,B05,093473,Rideout; David Porter,4,0,36,32
1656948864382,MATH 18,B06,093474,Rideout; David Porter,5,0,36,31
1656948870410,MATH 20A,A01,083754,Zheng; Zequn,12,0,40,28
1656948876443,MATH 20B,A01,083756,Briones; Jor-el Thomas Caparas,1,0,36,35
1656948876443,MATH 20B,A02,083757,Briones; Jor-el Thomas Caparas,1,0,36,35
1656948876443,MATH 20B,A03,093475,Briones; Jor-el Thomas Caparas,0,0,36,36
1656948882468,MATH 20C,A01,083760,Briones; Jor-el Thomas Caparas,1,0,35,34
1656948882468,MATH 20C,A02,083761,Briones; Jor-el Thomas Caparas,8,0,35,27
1656948882468,MATH 20C,A03,093476,Briones; Jor-el Thomas Caparas,0,1,36,36
1656948882468,MATH 20C,B01,083762,Bach; Quang Tran,0,0,30,30
1656948888496,MATH 20D,A01,083765,Tran; Brian Kha,4,0,30,26
1656948888496,MATH 20D,A02,083766,Tran; Brian Kha,4,0,30,26
1656948888496,MATH 20D,A03,083767,Tran; Brian Kha,3,0,30,27
1656948894521,MATH 20E,A01,083771,Ganguly; Soumya,5,0,32,27
1656948894521,MATH 20E,A02,083772,Ganguly; Soumya,6,0,32,26
1656948894521,MATH 20E,B01,083773,Ciotti; Benjamin,18,0,35,17
1656948894521,MATH 20E,B02,083774,Ciotti; Benjamin,17,0,35,18
1656948900546,MATH 103A,A01,083777,Greenfeld; Be'Eri,2,0,36,34
1656948900546,MATH 103A,A02,083778,Greenfeld; Be'Eri,5,0,36,31
1656948900546,MATH 103A,A03,093561,Greenfeld; Be'Eri,4,0,36,32
1656948900546,MATH 103A,B01,083779,Greenfeld; Be'Eri,6,0,36,30
1656948900546,MATH 103A,B02,083780,Greenfeld; Be'Eri,2,0,36,34
1656948900546,MATH 103A,B03,093562,Greenfeld; Be'Eri,2,0,36,34
1656948906572,MATH 105,A01,085443,Carter; Anne Toulson,13,0,35,22
1656948906572,MATH 105,A02,093477,Carter; Anne Toulson,20,0,35,15
1656948912597,MATH 109,A01,083213,Ganzberger; Geoffrey Michael,2,0,34,32
1656948912597,MATH 109,A02,083214,Ganzberger; Geoffrey Michael,2,0,34,32
1656948912597,MATH 109,A03,093478,Ganzberger; Geoffrey Michael,1,0,34,33
1656948912597,MATH 109,B01,083215,Ganzberger; Geoffrey Michael,1,0,32,31
1656948912597,MATH 109,B02,083216,Ganzberger; Geoffrey Michael,1,0,32,31
1656948912597,MATH 109,B03,093479,Ganzberger; Geoffrey Michael,6,0,32,26
1656948918628,MATH 142A,A01,083219,Chow; Bennett,6,0,32,26
1656948918628,MATH 142A,A02,083220,Chow; Bennett,10,0,32,22
1656948918628,MATH 142A,A03,093480,Chow; Bennett,7,0,32,25
1656948918628,MATH 142A,B03,093481,Chow; Bennett,7,0,32,25
1656948918628,MATH 142A,B04,093558,Chow; Bennett,11,0,32,21
1656948918628,MATH 142A,B05,093559,Chow; Bennett,6,0,32,26
1656948924661,MATH 193A,A01,083224,Rotar; Vladimir,7,0,34,27
1656948924661,MATH 193A,A02,083225,Rotar; Vladimir,3,0,34,31
1656948924661,MATH 193A,A03,083781,Rotar; Vladimir,1,0,34,33
1656948924661,MATH 193A,A04,083782,Rotar; Vladimir,6,0,34,28
1656948924661,MATH 193A,A05,093482,Rotar; Vladimir,6,0,34,28
1656948930687,MATH 197,001,091859,McAuley; Julian John,9999,0,9999,0
1656948930687,MATH 197,002,095566,Kedlaya; Kiran S.,9997,0,9999,2
1656948930687,MATH 197,003,095567,Xiao; Ming,9999,0,9999,0
1656948930687,MATH 197,004,095571,Perols; Johan Lars,9998,0,9999,1
1656948937754,COGS 9,A01,083615,Shannon; Kyle Michael,7,0,75,68
1656948943778,COGS 11,A01,083617,Boyle; Mary E. T.,19,0,48,29
1656948949812,COGS 13,A01,083071,Bastos; Amalia Pinkusfeld,9,0,71,62
1656948955836,COGS 14A,A01,092681,Semenuks; Arturs,0,1,100,100
1656948961863,COGS 14B,A01,083073,Cheng; Tzu-Han,5,0,63,58
1656948967887,COGS 17,A01,092677,Semenuks; Arturs,4,0,81,77
1656948973913,COGS 100,A01,083619,Allen; Michael Gordon,15,0,70,55
1656948979941,COGS 101A,A01,083621,Davis; Joshua Daniel,9,0,68,59
1656948985969,COGS 101B,A01,091572,Allen; Michael Gordon,8,0,65,57
1656948991997,COGS 101C,A01,083625,Delgado; Tania,17,0,35,18
1656948998023,COGS 107A,A01,083627,Boyle; Mary E. T.,13,0,60,47
1656949004048,COGS 118A,A01,083075,Gupta; Anjum,15,0,76,61
1656949010074,CSE 3,A50,083646,Miranda; Gregory Joseph,22,0,50,28
1656949016109,CSE 8A,A50,083650,Miranda; Gregory Joseph,17,1,56,39
1656949022134,CSE 11,A01,083080,Cao; Yingjun,4,15,40,36
1656949028156,CSE 12,A01,083652,Krause-Levy; Sophia Louisa,20,1,120,100
1656949034179,CSE 15L,A01,083654,Morris; Justin Loren,8,0,50,42
1656949034179,CSE 15L,A02,083655,Morris; Justin Loren,8,0,50,42
1656949040204,CSE 20,A01,083657,Tran; Khoa Dang,37,0,80,43
1656949046227,CSE 21,A01,095574,Bach; Quang Tran,21,0,48,27
1656949052251,CSE 30,A01,083084,Eldon; John,4,0,80,76
1656949052251,CSE 30,B01,095061,Bhaskar; Nishant,6,0,50,44
1656949058275,CSE 100,A01,083659,Cao; Yingjun,3,4,70,67
1656949064302,CSE 134B,A01,083661,Powell; Thomas Allan,19,0,100,81
1656949070329,CSE 140,A01,083663,Gungor; Onat,14,0,85,71
1656949076354,CSE 140L,A01,083088,Eldon; John,16,0,100,84
1656949082379,CSE 175,A01,083665,Kumar; Rakesh,3,0,25,22
1656949088406,CSE 190,A00,092507,Dubnov; Shlomo,7,0,20,13
1656949094428,ECE 45,A01,083139,Congero; Spencer William,5,0,75,70
1656949100451,ECE 65,A50,083695,Saad; Andrew S,12,0,30,18
1656949100451,ECE 65,A51,095125,Saad; Andrew S,25,0,26,1
1656949106478,ECE 109,A01,091882,Touri; Behrouz,16,0,70,54
1656949112500,ECE 180,A00,083140,Abi Samra; Nicholas Camill,0,0,30,30
1656949112500,ECE 180,B00,083141,Abi Samra; Nicholas Camill,0,0,30,30
1656949118524,MATH 10A,A01,083735,Patchell; Gregory David,1,0,30,29
1656949118524,MATH 10A,A02,083736,Patchell; Gregory David,20,0,30,10
1656949118524,MATH 10A,A03,083737,Patchell; Gregory David,15,0,30,15
1656949124548,MATH 10B,A01,083207,Lim; Seonhee,7,0,34,27
1656949124548,MATH 10B,A02,083208,Lim; Seonhee,9,0,35,26
1656949124548,MATH 10B,A03,093472,Lim; Seonhee,4,0,34,30
1656949124548,MATH 10B,B01,083739,Sinha; Shubham,9,0,30,21
1656949130579,MATH 18,A01,083743,Cinel; Cameron Alexander,6,0,30,24
1656949130579,MATH 18,A02,083744,Cinel; Cameron Alexander,15,0,30,15
1656949130579,MATH 18,A03,083745,Cinel; Cameron Alexander,8,0,30,22
1656949130579,MATH 18,B01,083748,Rideout; David Porter,4,0,37,33
1656949130579,MATH 18,B02,083749,Rideout; David Porter,3,0,36,33
1656949130579,MATH 18,B03,083750,Rideout; David Porter,2,0,37,35
1656949130579,MATH 18,B04,083751,Rideout; David Porter,5,0,36,31
1656949130579,MATH 18,B05,093473,Rideout; David Porter,4,0,36,32
1656949130579,MATH 18,B06,093474,Rideout; David Porter,5,0,36,31
1656949136604,MATH 20A,A01,083754,Zheng; Zequn,12,0,40,28
1656949142633,MATH 20B,A01,083756,Briones; Jor-el Thomas Caparas,1,0,36,35
1656949142633,MATH 20B,A02,083757,Briones; Jor-el Thomas Caparas,1,0,36,35
1656949142633,MATH 20B,A03,093475,Briones; Jor-el Thomas Caparas,0,0,36,36
1656949148658,MATH 20C,A01,083760,Briones; Jor-el Thomas Caparas,1,0,35,34
1656949148658,MATH 20C,A02,083761,Briones; Jor-el Thomas Caparas,8,0,35,27
1656949148658,MATH 20C,A03,093476,Briones; Jor-el Thomas Caparas,0,1,36,36
1656949148658,MATH 20C,B01,083762,Bach; Quang Tran,0,0,30,30
1656949154686,MATH 20D,A01,083765,Tran; Brian Kha,4,0,30,26
1656949154686,MATH 20D,A02,083766,Tran; Brian Kha,4,0,30,26
1656949154686,MATH 20D,A03,083767,Tran; Brian Kha,3,0,30,27
1656949160712,MATH 20E,A01,083771,Ganguly; Soumya,5,0,32,27
1656949160712,MATH 20E,A02,083772,Ganguly; Soumya,6,0,32,26
1656949160712,MATH 20E,B01,083773,Ciotti; Benjamin,18,0,35,17
1656949160712,MATH 20E,B02,083774,Ciotti; Benjamin,17,0,35,18
1656949166735,MATH 103A,A01,083777,Greenfeld; Be'Eri,2,0,36,34
1656949166735,MATH 103A,A02,083778,Greenfeld; Be'Eri,5,0,36,31
1656949166735,MATH 103A,A03,093561,Greenfeld; Be'Eri,4,0,36,32
1656949166735,MATH 103A,B01,083779,Greenfeld; Be'Eri,6,0,36,30
1656949166735,MATH 103A,B02,083780,Greenfeld; Be'Eri,2,0,36,34
1656949166735,MATH 103A,B03,093562,Greenfeld; Be'Eri,2,0,36,34
1656949172762,MATH 105,A01,085443,Carter; Anne Toulson,13,0,35,22
1656949172762,MATH 105,A02,093477,Carter; Anne Toulson,20,0,35,15
1656949178786,MATH 109,A01,083213,Ganzberger; Geoffrey Michael,2,0,34,32
1656949178786,MATH 109,A02,083214,Ganzberger; Geoffrey Michael,2,0,34,32
1656949178786,MATH 109,A03,093478,Ganzberger; Geoffrey Michael,1,0,34,33
1656949178786,MATH 109,B01,083215,Ganzberger; Geoffrey Michael,1,0,32,31
1656949178786,MATH 109,B02,083216,Ganzberger; Geoffrey Michael,1,0,32,31
1656949178786,MATH 109,B03,093479,Ganzberger; Geoffrey Michael,6,0,32,26
1656949184811,MATH 142A,A01,083219,Chow; Bennett,6,0,32,26
1656949184811,MATH 142A,A02,083220,Chow; Bennett,10,0,32,22
1656949184811,MATH 142A,A03,093480,Chow; Bennett,7,0,32,25
1656949184811,MATH 142A,B03,093481,Chow; Bennett,7,0,32,25
1656949184811,MATH 142A,B04,093558,Chow; Bennett,11,0,32,21
1656949184811,MATH 142A,B05,093559,Chow; Bennett,6,0,32,26
1656949190843,MATH 193A,A01,083224,Rotar; Vladimir,7,0,34,27
1656949190843,MATH 193A,A02,083225,Rotar; Vladimir,4,0,34,30
1656949190843,MATH 193A,A03,083781,Rotar; Vladimir,1,0,34,33
1656949190843,MATH 193A,A04,083782,Rotar; Vladimir,6,0,34,28
1656949190843,MATH 193A,A05,093482,Rotar; Vladimir,6,0,34,28
1656949196873,MATH 197,001,091859,McAuley; Julian John,9999,0,9999,0
1656949196873,MATH 197,002,095566,Kedlaya; Kiran S.,9997,0,9999,2
1656949196873,MATH 197,003,095567,Xiao; Ming,9999,0,9999,0
1656949196873,MATH 197,004,095571,Perols; Johan Lars,9998,0,9999,1
1656949203947,COGS 9,A01,083615,Shannon; Kyle Michael,7,0,75,68
1656949209974,COGS 11,A01,083617,Boyle; Mary E. T.,19,0,48,29
1656949216001,COGS 13,A01,083071,Bastos; Amalia Pinkusfeld,9,0,71,62
1656949222027,COGS 14A,A01,092681,Semenuks; Arturs,0,1,100,100
1656949228055,COGS 14B,A01,083073,Cheng; Tzu-Han,5,0,63,58
1656949234085,COGS 17,A01,092677,Semenuks; Arturs,4,0,81,77
1656949240108,COGS 100,A01,083619,Allen; Michael Gordon,15,0,70,55
1656949246134,COGS 101A,A01,083621,Davis; Joshua Daniel,9,0,68,59
1656949252158,COGS 101B,A01,091572,Allen; Michael Gordon,8,0,65,57
1656949258182,COGS 101C,A01,083625,Delgado; Tania,17,0,35,18
1656949264209,COGS 107A,A01,083627,Boyle; Mary E. T.,13,0,60,47
1656949270232,COGS 118A,A01,083075,Gupta; Anjum,15,0,76,61
1656949276343,CSE 3,A50,083646,Miranda; Gregory Joseph,22,0,50,28
1656949282366,CSE 8A,A50,083650,Miranda; Gregory Joseph,17,1,56,39
1656949288390,CSE 11,A01,083080,Cao; Yingjun,4,15,40,36
1656949294418,CSE 12,A01,083652,Krause-Levy; Sophia Louisa,20,1,120,100
1656949300442,CSE 15L,A01,083654,Morris; Justin Loren,8,0,50,42
1656949300442,CSE 15L,A02,083655,Morris; Justin Loren,8,0,50,42
1656949306477,CSE 20,A01,083657,Tran; Khoa Dang,37,0,80,43
1656949312500,CSE 21,A01,095574,Bach; Quang Tran,21,0,48,27
1656949318524,CSE 30,A01,083084,Eldon; John,4,0,80,76
1656949318524,CSE 30,B01,095061,Bhaskar; Nishant,6,0,50,44
1656949324550,CSE 100,A01,083659,Cao; Yingjun,3,4,70,67
1656949330576,CSE 134B,A01,083661,Powell; Thomas Allan,19,0,100,81
1656949336600,CSE 140,A01,083663,Gungor; Onat,14,0,85,71
1656949342624,CSE 140L,A01,083088,Eldon; John,16,0,100,84
1656949348650,CSE 175,A01,083665,Kumar; Rakesh,3,0,25,22
1656949354674,CSE 190,A00,092507,Dubnov; Shlomo,7,0,20,13
1656949360698,ECE 45,A01,083139,Congero; Spencer William,5,0,75,70
1656949366721,ECE 65,A50,083695,Saad; Andrew S,12,0,30,18
1656949366721,ECE 65,A51,095125,Saad; Andrew S,25,0,26,1
1656949372744,ECE 109,A01,091882,Touri; Behrouz,16,0,70,54
1656949378766,ECE 180,A00,083140,Abi Samra; Nicholas Camill,0,0,30,30
1656949378766,ECE 180,B00,083141,Abi Samra; Nicholas Camill,0,0,30,30
1656949384790,MATH 10A,A01,083735,Patchell; Gregory David,1,0,30,29
1656949384790,MATH 10A,A02,083736,Patchell; Gregory David,20,0,30,10
1656949384790,MATH 10A,A03,083737,Patchell; Gregory David,15,0,30,15
1656949390814,MATH 10B,A01,083207,Lim; Seonhee,7,0,34,27
1656949390814,MATH 10B,A02,083208,Lim; Seonhee,9,0,35,26
1656949390814,MATH 10B,A03,093472,Lim; Seonhee,4,0,34,30
1656949390814,MATH 10B,B01,083739,Sinha; Shubham,9,0,30,21
1656949396838,MATH 18,A01,083743,Cinel; Cameron Alexander,6,0,30,24
1656949396838,MATH 18,A02,083744,Cinel; Cameron Alexander,15,0,30,15
1656949396838,MATH 18,A03,083745,Cinel; Cameron Alexander,8,0,30,22
1656949396838,MATH 18,B01,083748,Rideout; David Porter,4,0,37,33
1656949396838,MATH 18,B02,083749,Rideout; David Porter,3,0,36,33
1656949396838,MATH 18,B03,083750,Rideout; David Porter,2,0,37,35
1656949396838,MATH 18,B04,083751,Rideout; David Porter,5,0,36,31
1656949396838,MATH 18,B05,093473,Rideout; David Porter,4,0,36,32
1656949396838,MATH 18,B06,093474,Rideout; David Porter,5,0,36,31
1656949402862,MATH 20A,A01,083754,Zheng; Zequn,12,0,40,28
1656949408885,MATH 20B,A01,083756,Briones; Jor-el Thomas Caparas,1,0,36,35
1656949408885,MATH 20B,A02,083757,Briones; Jor-el Thomas Caparas,1,0,36,35
1656949408885,MATH 20B,A03,093475,Briones; Jor-el Thomas Caparas,0,0,36,36
1656949414918,MATH 20C,A01,083760,Briones; Jor-el Thomas Caparas,1,0,35,34
1656949414918,MATH 20C,A02,083761,Briones; Jor-el Thomas Caparas,8,0,35,27
1656949414918,MATH 20C,A03,093476,Briones; Jor-el Thomas Caparas,0,1,36,36
1656949414918,MATH 20C,B01,083762,Bach; Quang Tran,0,0,30,30
1656949420941,MATH 20D,A01,083765,Tran; Brian Kha,4,0,30,26
1656949420941,MATH 20D,A02,083766,Tran; Brian Kha,4,0,30,26
1656949420941,MATH 20D,A03,083767,Tran; Brian Kha,3,0,30,27
1656949426970,MATH 20E,A01,083771,Ganguly; Soumya,5,0,32,27
1656949426970,MATH 20E,A02,083772,Ganguly; Soumya,6,0,32,26
1656949426970,MATH 20E,B01,083773,Ciotti; Benjamin,18,0,35,17
1656949426970,MATH 20E,B02,083774,Ciotti; Benjamin,17,0,35,18
1656949433004,MATH 103A,A01,083777,Greenfeld; Be'Eri,2,0,36,34
1656949433004,MATH 103A,A02,083778,Greenfeld; Be'Eri,5,0,36,31
1656949433004,MATH 103A,A03,093561,Greenfeld; Be'Eri,4,0,36,32
1656949433004,MATH 103A,B01,083779,Greenfeld; Be'Eri,6,0,36,30
1656949433004,MATH 103A,B02,083780,Greenfeld; Be'Eri,2,0,36,34
1656949433004,MATH 103A,B03,093562,Greenfeld; Be'Eri,2,0,36,34
1656949439029,MATH 105,A01,085443,Carter; Anne Toulson,13,0,35,22
1656949439029,MATH 105,A02,093477,Carter; Anne Toulson,20,0,35,15
1656949445053,MATH 109,A01,083213,Ganzberger; Geoffrey Michael,2,0,34,32
1656949445053,MATH 109,A02,083214,Ganzberger; Geoffrey Michael,2,0,34,32
1656949445053,MATH 109,A03,093478,Ganzberger; Geoffrey Michael,1,0,34,33
1656949445053,MATH 109,B01,083215,Ganzberger; Geoffrey Michael,1,0,32,31
1656949445053,MATH 109,B02,083216,Ganzberger; Geoffrey Michael,1,0,32,31
1656949445053,MATH 109,B03,093479,Ganzberger; Geoffrey Michael,6,0,32,26
1656949451083,MATH 142A,A01,083219,Chow; Bennett,6,0,32,26
1656949451083,MATH 142A,A02,083220,Chow; Bennett,10,0,32,22
1656949451083,MATH 142A,A03,093480,Chow; Bennett,7,0,32,25
1656949451083,MATH 142A,B03,093481,Chow; Bennett,7,0,32,25
1656949451083,MATH 142A,B04,093558,Chow; Bennett,11,0,32,21
1656949451083,MATH 142A,B05,093559,Chow; Bennett,6,0,32,26
1656949457113,MATH 193A,A01,083224,Rotar; Vladimir,7,0,34,27
1656949457113,MATH 193A,A02,083225,Rotar; Vladimir,4,0,34,30
1656949457113,MATH 193A,A03,083781,Rotar; Vladimir,1,0,34,33
1656949457113,MATH 193A,A04,083782,Rotar; Vladimir,6,0,34,28
1656949457113,MATH 193A,A05,093482,Rotar; Vladimir,6,0,34,28
1656949463136,MATH 197,001,091859,McAuley; Julian John,9999,0,9999,0
1656949463136,MATH 197,002,095566,Kedlaya; Kiran S.,9997,0,9999,2
1656949463136,MATH 197,003,095567,Xiao; Ming,9999,0,9999,0
1656949463136,MATH 197,004,095571,Perols; Johan Lars,9998,0,9999,1
1656949470206,COGS 9,A01,083615,Shannon; Kyle Michael,7,0,75,68
1656949476227,COGS 11,A01,083617,Boyle; Mary E. T.,19,0,48,29
1656949482251,COGS 13,A01,083071,Bastos; Amalia Pinkusfeld,9,0,71,62
1656949488278,COGS 14A,A01,092681,Semenuks; Arturs,0,1,100,100
1656949494313,COGS 14B,A01,083073,Cheng; Tzu-Han,5,0,63,58
1656949500339,COGS 17,A01,092677,Semenuks; Arturs,4,0,81,77
1656949506364,COGS 100,A01,083619,Allen; Michael Gordon,15,0,70,55
1656949512387,COGS 101A,A01,083621,Davis; Joshua Daniel,9,0,68,59
1656949518417,COGS 101B,A01,091572,Allen; Michael Gordon,8,0,65,57
1656949524441,COGS 101C,A01,083625,Delgado; Tania,17,0,35,18
1656949530469,COGS 107A,A01,083627,Boyle; Mary E. T.,13,0,60,47
1656949536503,COGS 118A,A01,083075,Gupta; Anjum,15,0,76,61
1656949542528,CSE 3,A50,083646,Miranda; Gregory Joseph,22,0,50,28
1656949548552,CSE 8A,A50,083650,Miranda; Gregory Joseph,17,1,56,39
1656949554575,CSE 11,A01,083080,Cao; Yingjun,4,15,40,36
1656949560601,CSE 12,A01,083652,Krause-Levy; Sophia Louisa,20,1,120,100
1656949566625,CSE 15L,A01,083654,Morris; Justin Loren,8,0,50,42
1656949566625,CSE 15L,A02,083655,Morris; Justin Loren,8,0,50,42
1656949572651,CSE 20,A01,083657,Tran; Khoa Dang,37,0,80,43
1656949578678,CSE 21,A01,095574,Bach; Quang Tran,21,0,48,27
1656949584705,CSE 30,A01,083084,Eldon; John,4,0,80,76
1656949584705,CSE 30,B01,095061,Bhaskar; Nishant,6,0,50,44
1656949590727,CSE 100,A01,083659,Cao; Yingjun,3,4,70,67
1656949596751,CSE 134B,A01,083661,Powell; Thomas Allan,19,0,100,81
1656949602779,CSE 140,A01,083663,Gungor; Onat,14,0,85,71
1656949608802,CSE 140L,A01,083088,Eldon; John,16,0,100,84
1656949614826,CSE 175,A01,083665,Kumar; Rakesh,3,0,25,22
1656949620849,CSE 190,A00,092507,Dubnov; Shlomo,7,0,20,13
1656949626875,ECE 45,A01,083139,Congero; Spencer William,5,0,75,70
1656949632900,ECE 65,A50,083695,Saad; Andrew S,12,0,30,18
1656949632900,ECE 65,A51,095125,Saad; Andrew S,25,0,26,1
1656949638928,ECE 109,A01,091882,Touri; Behrouz,16,0,70,54
1656949644966,ECE 180,A00,083140,Abi Samra; Nicholas Camill,0,0,30,30
1656949644966,ECE 180,B00,083141,Abi Samra; Nicholas Camill,0,0,30,30
1656949650989,MATH 10A,A01,083735,Patchell; Gregory David,1,0,30,29
1656949650989,MATH 10A,A02,083736,Patchell; Gregory David,20,0,30,10
1656949650989,MATH 10A,A03,083737,Patchell; Gregory David,15,0,30,15
1656949657018,MATH 10B,A01,083207,Lim; Seonhee,7,0,34,27
1656949657018,MATH 10B,A02,083208,Lim; Seonhee,9,0,35,26
1656949657018,MATH 10B,A03,093472,Lim; Seonhee,4,0,34,30
1656949657018,MATH 10B,B01,083739,Sinha; Shubham,9,0,30,21
1656949663044,MATH 18,A01,083743,Cinel; Cameron Alexander,6,0,30,24
1656949663044,MATH 18,A02,083744,Cinel; Cameron Alexander,15,0,30,15
1656949663044,MATH 18,A03,083745,Cinel; Cameron Alexander,8,0,30,22
1656949663044,MATH 18,B01,083748,Rideout; David Porter,4,0,37,33
1656949663044,MATH 18,B02,083749,Rideout; David Porter,3,0,36,33
1656949663044,MATH 18,B03,083750,Rideout; David Porter,2,0,37,35
1656949663044,MATH 18,B04,083751,Rideout; David Porter,5,0,36,31
1656949663044,MATH 18,B05,093473,Rideout; David Porter,4,0,36,32
1656949663044,MATH 18,B06,093474,Rideout; David Porter,5,0,36,31
1656949669068,MATH 20A,A01,083754,Zheng; Zequn,12,0,40,28
1656949675096,MATH 20B,A01,083756,Briones; Jor-el Thomas Caparas,1,0,36,35
1656949675096,MATH 20B,A02,083757,Briones; Jor-el Thomas Caparas,1,0,36,35
1656949675096,MATH 20B,A03,093475,Briones; Jor-el Thomas Caparas,0,0,36,36
1656949681120,MATH 20C,A01,083760,Briones; Jor-el Thomas Caparas,1,0,35,34
1656949681120,MATH 20C,A02,083761,Briones; Jor-el Thomas Caparas,8,0,35,27
1656949681120,MATH 20C,A03,093476,Briones; Jor-el Thomas Caparas,0,1,36,36
1656949681120,MATH 20C,B01,083762,Bach; Quang Tran,0,0,30,30
1656949687151,MATH 20D,A01,083765,Tran; Brian Kha,4,0,30,26
1656949687151,MATH 20D,A02,083766,Tran; Brian Kha,4,0,30,26
1656949687151,MATH 20D,A03,083767,Tran; Brian Kha,3,0,30,27
1656949693178,MATH 20E,A01,083771,Ganguly; Soumya,5,0,32,27
1656949693178,MATH 20E,A02,083772,Ganguly; Soumya,6,0,32,26
1656949693178,MATH 20E,B01,083773,Ciotti; Benjamin,18,0,35,17
1656949693178,MATH 20E,B02,083774,Ciotti; Benjamin,17,0,35,18
1656949699201,MATH 103A,A01,083777,Greenfeld; Be'Eri,2,0,36,34
1656949699201,MATH 103A,A02,083778,Greenfeld; Be'Eri,5,0,36,31
1656949699201,MATH 103A,A03,093561,Greenfeld; Be'Eri,4,0,36,32
1656949699201,MATH 103A,B01,083779,Greenfeld; Be'Eri,6,0,36,30
1656949699201,MATH 103A,B02,083780,Greenfeld; Be'Eri,2,0,36,34
1656949699201,MATH 103A,B03,093562,Greenfeld; Be'Eri,2,0,36,34
1656949705236,MATH 105,A01,085443,Carter; Anne Toulson,13,0,35,22
1656949705236,MATH 105,A02,093477,Carter; Anne Toulson,20,0,35,15
1656949711265,MATH 109,A01,083213,Ganzberger; Geoffrey Michael,2,0,34,32
1656949711265,MATH 109,A02,083214,Ganzberger; Geoffrey Michael,2,0,34,32
1656949711265,MATH 109,A03,093478,Ganzberger; Geoffrey Michael,1,0,34,33
1656949711265,MATH 109,B01,083215,Ganzberger; Geoffrey Michael,1,0,32,31
1656949711265,MATH 109,B02,083216,Ganzberger; Geoffrey Michael,1,0,32,31
1656949711265,MATH 109,B03,093479,Ganzberger; Geoffrey Michael,6,0,32,26
1656949717296,MATH 142A,A01,083219,Chow; Bennett,6,0,32,26
1656949717296,MATH 142A,A02,083220,Chow; Bennett,10,0,32,22
1656949717296,MATH 142A,A03,093480,Chow; Bennett,7,0,32,25
1656949717296,MATH 142A,B03,093481,Chow; Bennett,7,0,32,25
1656949717296,MATH 142A,B04,093558,Chow; Bennett,11,0,32,21
1656949717296,MATH 142A,B05,093559,Chow; Bennett,6,0,32,26
1656949723325,MATH 193A,A01,083224,Rotar; Vladimir,7,0,34,27
1656949723325,MATH 193A,A02,083225,Rotar; Vladimir,4,0,34,30
1656949723325,MATH 193A,A03,083781,Rotar; Vladimir,1,0,34,33
1656949723325,MATH 193A,A04,083782,Rotar; Vladimir,6,0,34,28
1656949723325,MATH 193A,A05,093482,Rotar; Vladimir,6,0,34,28
1656949729350,MATH 197,001,091859,McAuley; Julian John,9999,0,9999,0
1656949729350,MATH 197,002,095566,Kedlaya; Kiran S.,9997,0,9999,2
1656949729350,MATH 197,003,095567,Xiao; Ming,9999,0,9999,0
1656949729350,MATH 197,004,095571,Perols; Johan Lars,9998,0,9999,1
1656949736414,COGS 9,A01,083615,Shannon; Kyle Michael,7,0,75,68
1656949742439,COGS 11,A01,083617,Boyle; Mary E. T.,19,0,48,29
1656949748462,COGS 13,A01,083071,Bastos; Amalia Pinkusfeld,9,0,71,62
1656949754489,COGS 14A,A01,092681,Semenuks; Arturs,0,1,100,100
1656949760513,COGS 14B,A01,083073,Cheng; Tzu-Han,5,0,63,58
1656949766537,COGS 17,A01,092677,Semenuks; Arturs,4,0,81,77
1656949772562,COGS 100,A01,083619,Allen; Michael Gordon,15,0,70,55
1656949778586,COGS 101A,A01,083621,Davis; Joshua Daniel,9,0,68,59
1656949784608,COGS 101B,A01,091572,Allen; Michael Gordon,8,0,65,57
1656949790635,COGS 101C,A01,083625,Delgado; Tania,17,0,35,18
1656949796671,COGS 107A,A01,083627,Boyle; Mary E. T.,13,0,60,47
1656949802698,COGS 118A,A01,083075,Gupta; Anjum,15,0,76,61
1656949808722,CSE 3,A50,083646,Miranda; Gregory Joseph,22,0,50,28
1656949814753,CSE 8A,A50,083650,Miranda; Gregory Joseph,17,1,56,39
1656949820781,CSE 11,A01,083080,Cao; Yingjun,4,15,40,36
1656949826803,CSE 12,A01,083652,Krause-Levy; Sophia Louisa,20,1,120,100
1656949832831,CSE 15L,A01,083654,Morris; Justin Loren,8,0,50,42
1656949832831,CSE 15L,A02,083655,Morris; Justin Loren,8,0,50,42
1656949838860,CSE 20,A01,083657,Tran; Khoa Dang,37,0,80,43
1656949844894,CSE 21,A01,095574,Bach; Quang Tran,21,0,48,27
1656949850926,CSE 30,A01,083084,Eldon; John,4,0,80,76
1656949850926,CSE 30,B01,095061,Bhaskar; Nishant,6,0,50,44
1656949856954,CSE 100,A01,083659,Cao; Yingjun,3,4,70,67
1656949862979,CSE 134B,A01,083661,Powell; Thomas Allan,19,0,100,81
1656949869002,CSE 140,A01,083663,Gungor; Onat,14,0,85,71
1656949875098,CSE 140L,A01,083088,Eldon; John,16,0,100,84
1656949881123,CSE 175,A01,083665,Kumar; Rakesh,3,0,25,22
1656949887149,CSE 190,A00,092507,Dubnov; Shlomo,7,0,20,13
1656949893186,ECE 45,A01,083139,Congero; Spencer William,5,0,75,70
1656949899211,ECE 65,A50,083695,Saad; Andrew S,12,0,30,18
1656949899211,ECE 65,A51,095125,Saad; Andrew S,25,0,26,1
1656949905235,ECE 109,A01,091882,Touri; Behrouz,16,0,70,54
1656949911259,ECE 180,A00,083140,Abi Samra; Nicholas Camill,0,0,30,30
1656949911259,ECE 180,B00,083141,Abi Samra; Nicholas Camill,0,0,30,30
1656949917289,MATH 10A,A01,083735,Patchell; Gregory David,1,0,30,29
1656949917289,MATH 10A,A02,083736,Patchell; Gregory David,20,0,30,10
1656949917289,MATH 10A,A03,083737,Patchell; Gregory David,15,0,30,15
1656949923314,MATH 10B,A01,083207,Lim; Seonhee,7,0,34,27
1656949923314,MATH 10B,A02,083208,Lim; Seonhee,9,0,35,26
1656949923314,MATH 10B,A03,093472,Lim; Seonhee,4,0,34,30
1656949923314,MATH 10B,B01,083739,Sinha; Shubham,9,0,30,21
1656949929338,MATH 18,A01,083743,Cinel; Cameron Alexander,6,0,30,24
1656949929338,MATH 18,A02,083744,Cinel; Cameron Alexander,15,0,30,15
1656949929338,MATH 18,A03,083745,Cinel; Cameron Alexander,8,0,30,22
1656949929338,MATH 18,B01,083748,Rideout; David Porter,4,0,37,33
1656949929338,MATH 18,B02,083749,Rideout; David Porter,3,0,36,33
1656949929338,MATH 18,B03,083750,Rideout; David Porter,2,0,37,35
1656949929338,MATH 18,B04,083751,Rideout; David Porter,5,0,36,31
1656949929338,MATH 18,B05,093473,Rideout; David Porter,4,0,36,32
1656949929338,MATH 18,B06,093474,Rideout; David Porter,5,0,36,31
1656949935366,MATH 20A,A01,083754,Zheng; Zequn,12,0,40,28
1656949941390,MATH 20B,A01,083756,Briones; Jor-el Thomas Caparas,1,0,36,35
1656949941390,MATH 20B,A02,083757,Briones; Jor-el Thomas Caparas,1,0,36,35
1656949941390,MATH 20B,A03,093475,Briones; Jor-el Thomas Caparas,0,0,36,36
1656949947425,MATH 20C,A01,083760,Briones; Jor-el Thomas Caparas,1,0,35,34
1656949947425,MATH 20C,A02,083761,Briones; Jor-el Thomas Caparas,8,0,35,27
1656949947425,MATH 20C,A03,093476,Briones; Jor-el Thomas Caparas,0,1,36,36
1656949947425,MATH 20C,B01,083762,Bach; Quang Tran,0,0,30,30
1656949953454,MATH 20D,A01,083765,Tran; Brian Kha,4,0,30,26
1656949953454,MATH 20D,A02,083766,Tran; Brian Kha,4,0,30,26
1656949953454,MATH 20D,A03,083767,Tran; Brian Kha,3,0,30,27
1656949959483,MATH 20E,A01,083771,Ganguly; Soumya,5,0,32,27
1656949959483,MATH 20E,A02,083772,Ganguly; Soumya,6,0,32,26
1656949959483,MATH 20E,B01,083773,Ciotti; Benjamin,18,0,35,17
1656949959483,MATH 20E,B02,083774,Ciotti; Benjamin,17,0,35,18
1656949965506,MATH 103A,A01,083777,Greenfeld; Be'Eri,2,0,36,34
1656949965506,MATH 103A,A02,083778,Greenfeld; Be'Eri,5,0,36,31
1656949965506,MATH 103A,A03,093561,Greenfeld; Be'Eri,4,0,36,32
1656949965506,MATH 103A,B01,083779,Greenfeld; Be'Eri,6,0,36,30
1656949965506,MATH 103A,B02,083780,Greenfeld; Be'Eri,2,0,36,34
1656949965506,MATH 103A,B03,093562,Greenfeld; Be'Eri,2,0,36,34
1656949971528,MATH 105,A01,085443,Carter; Anne Toulson,13,0,35,22
1656949971528,MATH 105,A02,093477,Carter; Anne Toulson,20,0,35,15
1656949977552,MATH 109,A01,083213,Ganzberger; Geoffrey Michael,2,0,34,32
1656949977552,MATH 109,A02,083214,Ganzberger; Geoffrey Michael,2,0,34,32
1656949977552,MATH 109,A03,093478,Ganzberger; Geoffrey Michael,1,0,34,33
1656949977552,MATH 109,B01,083215,Ganzberger; Geoffrey Michael,1,0,32,31
1656949977552,MATH 109,B02,083216,Ganzberger; Geoffrey Michael,1,0,32,31
1656949977552,MATH 109,B03,093479,Ganzberger; Geoffrey Michael,6,0,32,26
1656949983577,MATH 142A,A01,083219,Chow; Bennett,6,0,32,26
1656949983577,MATH 142A,A02,083220,Chow; Bennett,10,0,32,22
1656949983577,MATH 142A,A03,093480,Chow; Bennett,7,0,32,25
1656949983577,MATH 142A,B03,093481,Chow; Bennett,7,0,32,25
1656949983577,MATH 142A,B04,093558,Chow; Bennett,11,0,32,21
1656949983577,MATH 142A,B05,093559,Chow; Bennett,6,0,32,26
1656949989603,MATH 193A,A01,083224,Rotar; Vladimir,7,0,34,27
1656949989603,MATH 193A,A02,083225,Rotar; Vladimir,4,0,34,30
1656949989603,MATH 193A,A03,083781,Rotar; Vladimir,1,0,34,33
1656949989603,MATH 193A,A04,083782,Rotar; Vladimir,6,0,34,28
1656949989603,MATH 193A,A05,093482,Rotar; Vladimir,6,0,34,28
1656949995630,MATH 197,001,091859,McAuley; Julian John,9999,0,9999,0
1656949995630,MATH 197,002,095566,Kedlaya; Kiran S.,9997,0,9999,2
1656949995630,MATH 197,003,095567,Xiao; Ming,9999,0,9999,0
1656949995630,MATH 197,004,095571,Perols; Johan Lars,9998,0,9999,1
1656950002694,COGS 9,A01,083615,Shannon; Kyle Michael,7,0,75,68
1656950008719,COGS 11,A01,083617,Boyle; Mary E. T.,19,0,48,29
1656950014743,COGS 13,A01,083071,Bastos; Amalia Pinkusfeld,9,0,71,62
1656950020766,COGS 14A,A01,092681,Semenuks; Arturs,0,1,100,100
1656950026797,COGS 14B,A01,083073,Cheng; Tzu-Han,5,0,63,58
1656950032821,COGS 17,A01,092677,Semenuks; Arturs,4,0,81,77
1656950038848,COGS 100,A01,083619,Allen; Michael Gordon,15,0,70,55
1656950044872,COGS 101A,A01,083621,Davis; Joshua Daniel,9,0,68,59
1656950050899,COGS 101B,A01,091572,Allen; Michael Gordon,8,0,65,57
1656950056924,COGS 101C,A01,083625,Delgado; Tania,17,0,35,18
1656950062949,COGS 107A,A01,083627,Boyle; Mary E. T.,13,0,60,47
1656950068974,COGS 118A,A01,083075,Gupta; Anjum,15,0,76,61
1656950075002,CSE 3,A50,083646,Miranda; Gregory Joseph,22,0,50,28
1656950081029,CSE 8A,A50,083650,Miranda; Gregory Joseph,17,1,56,39
1656950087052,CSE 11,A01,083080,Cao; Yingjun,4,15,40,36
1656950093074,CSE 12,A01,083652,Krause-Levy; Sophia Louisa,20,1,120,100
1656950099100,CSE 15L,A01,083654,Morris; Justin Loren,8,0,50,42
1656950099100,CSE 15L,A02,083655,Morris; Justin Loren,8,0,50,42
1656950105124,CSE 20,A01,083657,Tran; Khoa Dang,37,0,80,43
1656950111158,CSE 21,A01,095574,Bach; Quang Tran,21,0,48,27
1656950117181,CSE 30,A01,083084,Eldon; John,4,0,80,76
1656950117181,CSE 30,B01,095061,Bhaskar; Nishant,6,0,50,44
1656950123206,CSE 100,A01,083659,Cao; Yingjun,3,4,70,67
1656950129233,CSE 134B,A01,083661,Powell; Thomas Allan,19,0,100,81
1656950135256,CSE 140,A01,083663,Gungor; Onat,14,0,85,71
1656950141278,CSE 140L,A01,083088,Eldon; John,16,0,100,84
1656950147305,CSE 175,A01,083665,Kumar; Rakesh,3,0,25,22
1656950153344,CSE 190,A00,092507,Dubnov; Shlomo,7,0,20,13
1656950159372,ECE 45,A01,083139,Congero; Spencer William,5,0,75,70
1656950165401,ECE 65,A50,083695,Saad; Andrew S,12,0,30,18
1656950165401,ECE 65,A51,095125,Saad; Andrew S,25,0,26,1
1656950171424,ECE 109,A01,091882,Touri; Behrouz,16,0,70,54
1656950177458,ECE 180,A00,083140,Abi Samra; Nicholas Camill,0,0,30,30
1656950177458,ECE 180,B00,083141,Abi Samra; Nicholas Camill,0,0,30,30
1656950183481,MATH 10A,A01,083735,Patchell; Gregory David,1,0,30,29
1656950183481,MATH 10A,A02,083736,Patchell; Gregory David,20,0,30,10
1656950183481,MATH 10A,A03,083737,Patchell; Gregory David,15,0,30,15
1656950189511,MATH 10B,A01,083207,Lim; Seonhee,7,0,34,27
1656950189511,MATH 10B,A02,083208,Lim; Seonhee,9,0,35,26
1656950189511,MATH 10B,A03,093472,Lim; Seonhee,4,0,34,30
1656950189511,MATH 10B,B01,083739,Sinha; Shubham,9,0,30,21
1656950195561,MATH 18,A01,083743,Cinel; Cameron Alexander,6,0,30,24
1656950195561,MATH 18,A02,083744,Cinel; Cameron Alexander,15,0,30,15
1656950195561,MATH 18,A03,083745,Cinel; Cameron Alexander,8,0,30,22
1656950195561,MATH 18,B01,083748,Rideout; David Porter,4,0,37,33
1656950195561,MATH 18,B02,083749,Rideout; David Porter,3,0,36,33
1656950195561,MATH 18,B03,083750,Rideout; David Porter,2,0,37,35
1656950195561,MATH 18,B04,083751,Rideout; David Porter,5,0,36,31
1656950195561,MATH 18,B05,093473,Rideout; David Porter,4,0,36,32
1656950195561,MATH 18,B06,093474,Rideout; David Porter,5,0,36,31
1656950201585,MATH 20A,A01,083754,Zheng; Zequn,12,0,40,28
1656950207613,MATH 20B,A01,083756,Briones; Jor-el Thomas Caparas,1,0,36,35
1656950207613,MATH 20B,A02,083757,Briones; Jor-el Thomas Caparas,1,0,36,35
1656950207613,MATH 20B,A03,093475,Briones; Jor-el Thomas Caparas,0,0,36,36
1656950213637,MATH 20C,A01,083760,Briones; Jor-el Thomas Caparas,1,0,35,34
1656950213637,MATH 20C,A02,083761,Briones; Jor-el Thomas Caparas,8,0,35,27
1656950213637,MATH 20C,A03,093476,Briones; Jor-el Thomas Caparas,0,1,36,36
1656950213637,MATH 20C,B01,083762,Bach; Quang Tran,0,0,30,30
1656950219665,MATH 20D,A01,083765,Tran; Brian Kha,4,0,30,26
1656950219665,MATH 20D,A02,083766,Tran; Brian Kha,4,0,30,26
1656950219665,MATH 20D,A03,083767,Tran; Brian Kha,3,0,30,27
1656950225693,MATH 20E,A01,083771,Ganguly; Soumya,5,0,32,27
1656950225693,MATH 20E,A02,083772,Ganguly; Soumya,6,0,32,26
1656950225693,MATH 20E,B01,083773,Ciotti; Benjamin,18,0,35,17
1656950225693,MATH 20E,B02,083774,Ciotti; Benjamin,17,0,35,18
1656950231722,MATH 103A,A01,083777,Greenfeld; Be'Eri,2,0,36,34
1656950231722,MATH 103A,A02,083778,Greenfeld; Be'Eri,5,0,36,31
1656950231722,MATH 103A,A03,093561,Greenfeld; Be'Eri,4,0,36,32
1656950231722,MATH 103A,B01,083779,Greenfeld; Be'Eri,6,0,36,30
1656950231722,MATH 103A,B02,083780,Greenfeld; Be'Eri,2,0,36,34
1656950231722,MATH 103A,B03,093562,Greenfeld; Be'Eri,2,0,36,34
1656950237747,MATH 105,A01,085443,Carter; Anne Toulson,13,0,35,22
1656950237747,MATH 105,A02,093477,Carter; Anne Toulson,20,0,35,15
1656950243771,MATH 109,A01,083213,Ganzberger; Geoffrey Michael,2,0,34,32
1656950243771,MATH 109,A02,083214,Ganzberger; Geoffrey Michael,2,0,34,32
1656950243771,MATH 109,A03,093478,Ganzberger; Geoffrey Michael,1,0,34,33
1656950243771,MATH 109,B01,083215,Ganzberger; Geoffrey Michael,1,0,32,31
1656950243771,MATH 109,B02,083216,Ganzberger; Geoffrey Michael,1,0,32,31
1656950243771,MATH 109,B03,093479,Ganzberger; Geoffrey Michael,6,0,32,26
1656950249797,MATH 142A,A01,083219,Chow; Bennett,6,0,32,26
1656950249797,MATH 142A,A02,083220,Chow; Bennett,10,0,32,22
1656950249797,MATH 142A,A03,093480,Chow; Bennett,7,0,32,25
1656950249797,MATH 142A,B03,093481,Chow; Bennett,7,0,32,25
1656950249797,MATH 142A,B04,093558,Chow; Bennett,11,0,32,21
1656950249797,MATH 142A,B05,093559,Chow; Bennett,6,0,32,26
1656950255827,MATH 193A,A01,083224,Rotar; Vladimir,7,0,34,27
1656950255827,MATH 193A,A02,083225,Rotar; Vladimir,4,0,34,30
1656950255827,MATH 193A,A03,083781,Rotar; Vladimir,1,0,34,33
1656950255827,MATH 193A,A04,083782,Rotar; Vladimir,6,0,34,28
1656950255827,MATH 193A,A05,093482,Rotar; Vladimir,6,0,34,28
1656950261853,MATH 197,001,091859,McAuley; Julian John,9999,0,9999,0
1656950261853,MATH 197,002,095566,Kedlaya; Kiran S.,9997,0,9999,2
1656950261853,MATH 197,003,095567,Xiao; Ming,9999,0,9999,0
1656950261853,MATH 197,004,095571,Perols; Johan Lars,9998,0,9999,1
1656950268914,COGS 9,A01,083615,Shannon; Kyle Michael,7,0,75,68
1656950274939,COGS 11,A01,083617,Boyle; Mary E. T.,19,0,48,29
1656950280965,COGS 13,A01,083071,Bastos; Amalia Pinkusfeld,9,0,71,62
1656950286992,COGS 14A,A01,092681,Semenuks; Arturs,0,1,100,100
1656950293018,COGS 14B,A01,083073,Cheng; Tzu-Han,5,0,63,58
1656950299040,COGS 17,A01,092677,Semenuks; Arturs,4,0,81,77
1656950305063,COGS 100,A01,083619,Allen; Michael Gordon,15,0,70,55
1656950311087,COGS 101A,A01,083621,Davis; Joshua Daniel,9,0,68,59
1656950317109,COGS 101B,A01,091572,Allen; Michael Gordon,8,0,65,57
1656950323134,COGS 101C,A01,083625,Delgado; Tania,17,0,35,18
1656950329157,COGS 107A,A01,083627,Boyle; Mary E. T.,13,0,60,47
1656950335185,COGS 118A,A01,083075,Gupta; Anjum,15,0,76,61
1656950341210,CSE 3,A50,083646,Miranda; Gregory Joseph,22,0,50,28
1656950347235,CSE 8A,A50,083650,Miranda; Gregory Joseph,17,1,56,39
1656950353257,CSE 11,A01,083080,Cao; Yingjun,4,15,40,36
1656950359296,CSE 12,A01,083652,Krause-Levy; Sophia Louisa,20,1,120,100
1656950365320,CSE 15L,A01,083654,Morris; Justin Loren,8,0,50,42
1656950365320,CSE 15L,A02,083655,Morris; Justin Loren,8,0,50,42
1656950371347,CSE 20,A01,083657,Tran; Khoa Dang,37,0,80,43
1656950377376,CSE 21,A01,095574,Bach; Quang Tran,21,0,48,27
1656950383399,CSE 30,A01,083084,Eldon; John,4,0,80,76
1656950383399,CSE 30,B01,095061,Bhaskar; Nishant,6,0,50,44
1656950389423,CSE 100,A01,083659,Cao; Yingjun,3,4,70,67
1656950395449,CSE 134B,A01,083661,Powell; Thomas Allan,19,0,100,81
1656950401477,CSE 140,A01,083663,Gungor; Onat,14,0,85,71
1656950407500,CSE 140L,A01,083088,Eldon; John,16,0,100,84
1656950413530,CSE 175,A01,083665,Kumar; Rakesh,3,0,25,22
1656950419560,CSE 190,A00,092507,Dubnov; Shlomo,7,0,20,13
1656950425587,ECE 45,A01,083139,Congero; Spencer William,5,0,75,70
1656950431610,ECE 65,A50,083695,Saad; Andrew S,12,0,30,18
1656950431610,ECE 65,A51,095125,Saad; Andrew S,25,0,26,1
1656950437636,ECE 109,A01,091882,Touri; Behrouz,16,0,70,54
1656950443661,ECE 180,A00,083140,Abi Samra; Nicholas Camill,0,0,30,30
1656950443661,ECE 180,B00,083141,Abi Samra; Nicholas Camill,0,0,30,30
1656950449696,MATH 10A,A01,083735,Patchell; Gregory David,1,0,30,29
1656950449696,MATH 10A,A02,083736,Patchell; Gregory David,20,0,30,10
1656950449696,MATH 10A,A03,083737,Patchell; Gregory David,15,0,30,15
1656950455741,MATH 10B,A01,083207,Lim; Seonhee,7,0,34,27
1656950455741,MATH 10B,A02,083208,Lim; Seonhee,9,0,35,26
1656950455741,MATH 10B,A03,093472,Lim; Seonhee,4,0,34,30
1656950455741,MATH 10B,B01,083739,Sinha; Shubham,9,0,30,21
1656950461772,MATH 18,A01,083743,Cinel; Cameron Alexander,6,0,30,24
1656950461772,MATH 18,A02,083744,Cinel; Cameron Alexander,15,0,30,15
1656950461772,MATH 18,A03,083745,Cinel; Cameron Alexander,8,0,30,22
1656950461772,MATH 18,B01,083748,Rideout; David Porter,4,0,37,33
1656950461772,MATH 18,B02,083749,Rideout; David Porter,3,0,36,33
1656950461772,MATH 18,B03,083750,Rideout; David Porter,2,0,37,35
1656950461772,MATH 18,B04,083751,Rideout; David Porter,5,0,36,31
1656950461772,MATH 18,B05,093473,Rideout; David Porter,4,0,36,32
1656950461772,MATH 18,B06,093474,Rideout; David Porter,5,0,36,31
1656950467794,MATH 20A,A01,083754,Zheng; Zequn,12,0,40,28
1656950473911,MATH 20B,A01,083756,Briones; Jor-el Thomas Caparas,1,0,36,35
1656950473911,MATH 20B,A02,083757,Briones; Jor-el Thomas Caparas,1,0,36,35
1656950473911,MATH 20B,A03,093475,Briones; Jor-el Thomas Caparas,0,0,36,36
1656950479935,MATH 20C,A01,083760,Briones; Jor-el Thomas Caparas,1,0,35,34
1656950479935,MATH 20C,A02,083761,Briones; Jor-el Thomas Caparas,8,0,35,27
1656950479935,MATH 20C,A03,093476,Briones; Jor-el Thomas Caparas,0,1,36,36
1656950479935,MATH 20C,B01,083762,Bach; Quang Tran,0,0,30,30
1656950485964,MATH 20D,A01,083765,Tran; Brian Kha,4,0,30,26
1656950485964,MATH 20D,A02,083766,Tran; Brian Kha,4,0,30,26
1656950485964,MATH 20D,A03,083767,Tran; Brian Kha,3,0,30,27
1656950491987,MATH 20E,A01,083771,Ganguly; Soumya,5,0,32,27
1656950491987,MATH 20E,A02,083772,Ganguly; Soumya,6,0,32,26
1656950491987,MATH 20E,B01,083773,Ciotti; Benjamin,18,0,35,17
1656950491987,MATH 20E,B02,083774,Ciotti; Benjamin,17,0,35,18
1656950498019,MATH 103A,A01,083777,Greenfeld; Be'Eri,2,0,36,34
1656950498019,MATH 103A,A02,083778,Greenfeld; Be'Eri,5,0,36,31
1656950498019,MATH 103A,A03,093561,Greenfeld; Be'Eri,4,0,36,32
1656950498019,MATH 103A,B01,083779,Greenfeld; Be'Eri,6,0,36,30
1656950498019,MATH 103A,B02,083780,Greenfeld; Be'Eri,2,0,36,34
1656950498019,MATH 103A,B03,093562,Greenfeld; Be'Eri,2,0,36,34
1656950504045,MATH 105,A01,085443,Carter; Anne Toulson,13,0,35,22
1656950504045,MATH 105,A02,093477,Carter; Anne Toulson,20,0,35,15
1656950510069,MATH 109,A01,083213,Ganzberger; Geoffrey Michael,2,0,34,32
1656950510069,MATH 109,A02,083214,Ganzberger; Geoffrey Michael,2,0,34,32
1656950510069,MATH 109,A03,093478,Ganzberger; Geoffrey Michael,1,0,34,33
1656950510069,MATH 109,B01,083215,Ganzberger; Geoffrey Michael,1,0,32,31
1656950510069,MATH 109,B02,083216,Ganzberger; Geoffrey Michael,1,0,32,31
1656950510069,MATH 109,B03,093479,Ganzberger; Geoffrey Michael,6,0,32,26
1656950516092,MATH 142A,A01,083219,Chow; Bennett,6,0,32,26
1656950516092,MATH 142A,A02,083220,Chow; Bennett,10,0,32,22
1656950516092,MATH 142A,A03,093480,Chow; Bennett,7,0,32,25
1656950516092,MATH 142A,B03,093481,Chow; Bennett,7,0,32,25
1656950516092,MATH 142A,B04,093558,Chow; Bennett,11,0,32,21
1656950516092,MATH 142A,B05,093559,Chow; Bennett,6,0,32,26
1656950522123,MATH 193A,A01,083224,Rotar; Vladimir,7,0,34,27
1656950522123,MATH 193A,A02,083225,Rotar; Vladimir,4,0,34,30
1656950522123,MATH 193A,A03,083781,Rotar; Vladimir,1,0,34,33
1656950522123,MATH 193A,A04,083782,Rotar; Vladimir,6,0,34,28
1656950522123,MATH 193A,A05,093482,Rotar; Vladimir,6,0,34,28
1656950528149,MATH 197,001,091859,McAuley; Julian John,9999,0,9999,0
1656950528149,MATH 197,002,095566,Kedlaya; Kiran S.,9997,0,9999,2
1656950528149,MATH 197,003,095567,Xiao; Ming,9999,0,9999,0
1656950528149,MATH 197,004,095571,Perols; Johan Lars,9998,0,9999,1
1656950535203,COGS 9,A01,083615,Shannon; Kyle Michael,7,0,75,68
1656950541240,COGS 11,A01,083617,Boyle; Mary E. T.,19,0,48,29
1656950547265,COGS 13,A01,083071,Bastos; Amalia Pinkusfeld,9,0,71,62
1656950553291,COGS 14A,A01,092681,Semenuks; Arturs,0,1,100,100
1656950559319,COGS 14B,A01,083073,Cheng; Tzu-Han,5,0,63,58
1656950565342,COGS 17,A01,092677,Semenuks; Arturs,4,0,81,77
1656950571368,COGS 100,A01,083619,Allen; Michael Gordon,15,0,70,55
1656950577393,COGS 101A,A01,083621,Davis; Joshua Daniel,9,0,68,59
1656950583417,COGS 101B,A01,091572,Allen; Michael Gordon,8,0,65,57
1656950589469,COGS 101C,A01,083625,Delgado; Tania,17,0,35,18
1656950595497,COGS 107A,A01,083627,Boyle; Mary E. T.,13,0,60,47
1656950601522,COGS 118A,A01,083075,Gupta; Anjum,15,0,76,61
1656950607550,CSE 3,A50,083646,Miranda; Gregory Joseph,22,0,50,28
1656950613574,CSE 8A,A50,083650,Miranda; Gregory Joseph,17,1,56,39
1656950619598,CSE 11,A01,083080,Cao; Yingjun,4,15,40,36
1656950625623,CSE 12,A01,083652,Krause-Levy; Sophia Louisa,20,1,120,100
1656950631650,CSE 15L,A01,083654,Morris; Justin Loren,8,0,50,42
1656950631650,CSE 15L,A02,083655,Morris; Justin Loren,8,0,50,42
1656950637675,CSE 20,A01,083657,Tran; Khoa Dang,37,0,80,43
1656950643704,CSE 21,A01,095574,Bach; Quang Tran,21,0,48,27
1656950649731,CSE 30,A01,083084,Eldon; John,4,0,80,76
1656950649731,CSE 30,B01,095061,Bhaskar; Nishant,6,0,50,44
1656950655757,CSE 100,A01,083659,Cao; Yingjun,3,4,70,67
1656950661781,CSE 134B,A01,083661,Powell; Thomas Allan,19,0,100,81
1656950667806,CSE 140,A01,083663,Gungor; Onat,14,0,85,71
1656950673829,CSE 140L,A01,083088,Eldon; John,16,0,100,84
1656950679850,CSE 175,A01,083665,Kumar; Rakesh,3,0,25,22
1656950685873,CSE 190,A00,092507,Dubnov; Shlomo,7,0,20,13
1656950691900,ECE 45,A01,083139,Congero; Spencer William,5,0,75,70
1656950697930,ECE 65,A50,083695,Saad; Andrew S,12,0,30,18
1656950697930,ECE 65,A51,095125,Saad; Andrew S,25,0,26,1
1656950703955,ECE 109,A01,091882,Touri; Behrouz,16,0,70,54
1656950709982,ECE 180,A00,083140,Abi Samra; Nicholas Camill,0,0,30,30
1656950709982,ECE 180,B00,083141,Abi Samra; Nicholas Camill,0,0,30,30
1656950716007,MATH 10A,A01,083735,Patchell; Gregory David,1,0,30,29
1656950716007,MATH 10A,A02,083736,Patchell; Gregory David,20,0,30,10
1656950716007,MATH 10A,A03,083737,Patchell; Gregory David,15,0,30,15
1656950722036,MATH 10B,A01,083207,Lim; Seonhee,7,0,34,27
1656950722036,MATH 10B,A02,083208,Lim; Seonhee,9,0,35,26
1656950722036,MATH 10B,A03,093472,Lim; Seonhee,4,0,34,30
1656950722036,MATH 10B,B01,083739,Sinha; Shubham,9,0,30,21
1656950728068,MATH 18,A01,083743,Cinel; Cameron Alexander,6,0,30,24
1656950728068,MATH 18,A02,083744,Cinel; Cameron Alexander,15,0,30,15
1656950728068,MATH 18,A03,083745,Cinel; Cameron Alexander,8,0,30,22
1656950728068,MATH 18,B01,083748,Rideout; David Porter,4,0,37,33
1656950728068,MATH 18,B02,083749,Rideout; David Porter,3,0,36,33
1656950728068,MATH 18,B03,083750,Rideout; David Porter,2,0,37,35
1656950728068,MATH 18,B04,083751,Rideout; David Porter,5,0,36,31
1656950728068,MATH 18,B05,093473,Rideout; David Porter,4,0,36,32
1656950728068,MATH 18,B06,093474,Rideout; David Porter,5,0,36,31
1656950734097,MATH 20A,A01,083754,Zheng; Zequn,12,0,40,28
1656950740121,MATH 20B,A01,083756,Briones; Jor-el Thomas Caparas,1,0,36,35
1656950740121,MATH 20B,A02,083757,Briones; Jor-el Thomas Caparas,1,0,36,35
1656950740121,MATH 20B,A03,093475,Briones; Jor-el Thomas Caparas,0,0,36,36
1656950746150,MATH 20C,A01,083760,Briones; Jor-el Thomas Caparas,1,0,35,34
1656950746150,MATH 20C,A02,083761,Briones; Jor-el Thomas Caparas,8,0,35,27
1656950746150,MATH 20C,A03,093476,Briones; Jor-el Thomas Caparas,0,1,36,36
1656950746150,MATH 20C,B01,083762,Bach; Quang Tran,0,0,30,30
1656950752172,MATH 20D,A01,083765,Tran; Brian Kha,4,0,30,26
1656950752172,MATH 20D,A02,083766,Tran; Brian Kha,4,0,30,26
1656950752172,MATH 20D,A03,083767,Tran; Brian Kha,3,0,30,27
1656950758195,MATH 20E,A01,083771,Ganguly; Soumya,5,0,32,27
1656950758195,MATH 20E,A02,083772,Ganguly; Soumya,6,0,32,26
1656950758195,MATH 20E,B01,083773,Ciotti; Benjamin,18,0,35,17
1656950758195,MATH 20E,B02,083774,Ciotti; Benjamin,17,0,35,18
1656950764221,MATH 103A,A01,083777,Greenfeld; Be'Eri,2,0,36,34
1656950764221,MATH 103A,A02,083778,Greenfeld; Be'Eri,5,0,36,31
1656950764221,MATH 103A,A03,093561,Greenfeld; Be'Eri,4,0,36,32
1656950764221,MATH 103A,B01,083779,Greenfeld; Be'Eri,6,0,36,30
1656950764221,MATH 103A,B02,083780,Greenfeld; Be'Eri,2,0,36,34
1656950764221,MATH 103A,B03,093562,Greenfeld; Be'Eri,2,0,36,34
1656950770244,MATH 105,A01,085443,Carter; Anne Toulson,13,0,35,22
1656950770244,MATH 105,A02,093477,Carter; Anne Toulson,20,0,35,15
1656950776269,MATH 109,A01,083213,Ganzberger; Geoffrey Michael,2,0,34,32
1656950776269,MATH 109,A02,083214,Ganzberger; Geoffrey Michael,2,0,34,32
1656950776269,MATH 109,A03,093478,Ganzberger; Geoffrey Michael,1,0,34,33
1656950776269,MATH 109,B01,083215,Ganzberger; Geoffrey Michael,1,0,32,31
1656950776269,MATH 109,B02,083216,Ganzberger; Geoffrey Michael,1,0,32,31
1656950776269,MATH 109,B03,093479,Ganzberger; Geoffrey Michael,6,0,32,26
1656950782293,MATH 142A,A01,083219,Chow; Bennett,6,0,32,26
1656950782293,MATH 142A,A02,083220,Chow; Bennett,10,0,32,22
1656950782293,MATH 142A,A03,093480,Chow; Bennett,7,0,32,25
1656950782293,MATH 142A,B03,093481,Chow; Bennett,7,0,32,25
1656950782293,MATH 142A,B04,093558,Chow; Bennett,11,0,32,21
1656950782293,MATH 142A,B05,093559,Chow; Bennett,6,0,32,26
1656950788321,MATH 193A,A01,083224,Rotar; Vladimir,7,0,34,27
1656950788321,MATH 193A,A02,083225,Rotar; Vladimir,4,0,34,30
1656950788321,MATH 193A,A03,083781,Rotar; Vladimir,1,0,34,33
1656950788321,MATH 193A,A04,083782,Rotar; Vladimir,6,0,34,28
1656950788321,MATH 193A,A05,093482,Rotar; Vladimir,6,0,34,28
1656950794349,MATH 197,001,091859,McAuley; Julian John,9999,0,9999,0
1656950794349,MATH 197,002,095566,Kedlaya; Kiran S.,9997,0,9999,2
1656950794349,MATH 197,003,095567,Xiao; Ming,9999,0,9999,0
1656950794349,MATH 197,004,095571,Perols; Johan Lars,9998,0,9999,1
1656950801426,COGS 9,A01,083615,Shannon; Kyle Michael,7,0,75,68
1656950807451,COGS 11,A01,083617,Boyle; Mary E. T.,19,0,48,29
1656950813474,COGS 13,A01,083071,Bastos; Amalia Pinkusfeld,9,0,71,62
1656950819500,COGS 14A,A01,092681,Semenuks; Arturs,0,1,100,100
1656950825524,COGS 14B,A01,083073,Cheng; Tzu-Han,5,0,63,58
1656950831548,COGS 17,A01,092677,Semenuks; Arturs,4,0,81,77
1656950837571,COGS 100,A01,083619,Allen; Michael Gordon,15,0,70,55
1656950843599,COGS 101A,A01,083621,Davis; Joshua Daniel,9,0,68,59
1656950849633,COGS 101B,A01,091572,Allen; Michael Gordon,8,0,65,57
1656950855665,COGS 101C,A01,083625,Delgado; Tania,17,0,35,18
1656950861689,COGS 107A,A01,083627,Boyle; Mary E. T.,13,0,60,47
1656950867715,COGS 118A,A01,083075,Gupta; Anjum,15,0,76,61
1656950873743,CSE 3,A50,083646,Miranda; Gregory Joseph,22,0,50,28
1656950879770,CSE 8A,A50,083650,Miranda; Gregory Joseph,17,1,56,39
1656950885797,CSE 11,A01,083080,Cao; Yingjun,4,15,40,36
1656950891825,CSE 12,A01,083652,Krause-Levy; Sophia Louisa,20,1,120,100
1656950897848,CSE 15L,A01,083654,Morris; Justin Loren,8,0,50,42
1656950897848,CSE 15L,A02,083655,Morris; Justin Loren,8,0,50,42
1656950903870,CSE 20,A01,083657,Tran; Khoa Dang,37,0,80,43
1656950909893,CSE 21,A01,095574,Bach; Quang Tran,21,0,48,27
1656950915915,CSE 30,A01,083084,Eldon; John,4,0,80,76
1656950915915,CSE 30,B01,095061,Bhaskar; Nishant,6,0,50,44
1656950921937,CSE 100,A01,083659,Cao; Yingjun,3,4,70,67
1656950927971,CSE 134B,A01,083661,Powell; Thomas Allan,19,0,100,81
1656950933996,CSE 140,A01,083663,Gungor; Onat,14,0,85,71
1656950940021,CSE 140L,A01,083088,Eldon; John,16,0,100,84
1656950946045,CSE 175,A01,083665,Kumar; Rakesh,3,0,25,22
1656950952070,CSE 190,A00,092507,Dubnov; Shlomo,7,0,20,13
1656950958092,ECE 45,A01,083139,Congero; Spencer William,5,0,75,70
1656950964116,ECE 65,A50,083695,Saad; Andrew S,12,0,30,18
1656950964116,ECE 65,A51,095125,Saad; Andrew S,25,0,26,1
1656950970143,ECE 109,A01,091882,Touri; Behrouz,16,0,70,54
1656950976177,ECE 180,A00,083140,Abi Samra; Nicholas Camill,0,0,30,30
1656950976177,ECE 180,B00,083141,Abi Samra; Nicholas Camill,0,0,30,30
1656950982202,MATH 10A,A01,083735,Patchell; Gregory David,1,0,30,29
1656950982202,MATH 10A,A02,083736,Patchell; Gregory David,20,0,30,10
1656950982202,MATH 10A,A03,083737,Patchell; Gregory David,15,0,30,15
1656950988232,MATH 10B,A01,083207,Lim; Seonhee,7,0,34,27
1656950988232,MATH 10B,A02,083208,Lim; Seonhee,9,0,35,26
1656950988232,MATH 10B,A03,093472,Lim; Seonhee,4,0,34,30
1656950988232,MATH 10B,B01,083739,Sinha; Shubham,9,0,30,21
1656950994260,MATH 18,A01,083743,Cinel; Cameron Alexander,6,0,30,24
1656950994260,MATH 18,A02,083744,Cinel; Cameron Alexander,15,0,30,15
1656950994260,MATH 18,A03,083745,Cinel; Cameron Alexander,8,0,30,22
1656950994260,MATH 18,B01,083748,Rideout; David Porter,4,0,37,33
1656950994260,MATH 18,B02,083749,Rideout; David Porter,3,0,36,33
1656950994260,MATH 18,B03,083750,Rideout; David Porter,2,0,37,35
1656950994260,MATH 18,B04,083751,Rideout; David Porter,5,0,36,31
1656950994260,MATH 18,B05,093473,Rideout; David Porter,4,0,36,32
1656950994260,MATH 18,B06,093474,Rideout; David Porter,5,0,36,31
1656951000292,MATH 20A,A01,083754,Zheng; Zequn,12,0,40,28
1656951006319,MATH 20B,A01,083756,Briones; Jor-el Thomas Caparas,1,0,36,35
1656951006319,MATH 20B,A02,083757,Briones; Jor-el Thomas Caparas,1,0,36,35
1656951006319,MATH 20B,A03,093475,Briones; Jor-el Thomas Caparas,0,0,36,36
1656951012348,MATH 20C,A01,083760,Briones; Jor-el Thomas Caparas,1,0,35,34
1656951012348,MATH 20C,A02,083761,Briones; Jor-el Thomas Caparas,8,0,35,27
1656951012348,MATH 20C,A03,093476,Briones; Jor-el Thomas Caparas,0,1,36,36
1656951012348,MATH 20C,B01,083762,Bach; Quang Tran,0,0,30,30
1656951018373,MATH 20D,A01,083765,Tran; Brian Kha,4,0,30,26
1656951018373,MATH 20D,A02,083766,Tran; Brian Kha,4,0,30,26
1656951018373,MATH 20D,A03,083767,Tran; Brian Kha,3,0,30,27
1656951024410,MATH 20E,A01,083771,Ganguly; Soumya,5,0,32,27
1656951024410,MATH 20E,A02,083772,Ganguly; Soumya,6,0,32,26
1656951024410,MATH 20E,B01,083773,Ciotti; Benjamin,18,0,35,17
1656951024410,MATH 20E,B02,083774,Ciotti; Benjamin,17,0,35,18
1656951030440,MATH 103A,A01,083777,Greenfeld; Be'Eri,2,0,36,34
1656951030440,MATH 103A,A02,083778,Greenfeld; Be'Eri,5,0,36,31
1656951030440,MATH 103A,A03,093561,Greenfeld; Be'Eri,4,0,36,32
1656951030440,MATH 103A,B01,083779,Greenfeld; Be'Eri,6,0,36,30
1656951030440,MATH 103A,B02,083780,Greenfeld; Be'Eri,2,0,36,34
1656951030440,MATH 103A,B03,093562,Greenfeld; Be'Eri,2,0,36,34
1656951036467,MATH 105,A01,085443,Carter; Anne Toulson,13,0,35,22
1656951036467,MATH 105,A02,093477,Carter; Anne Toulson,20,0,35,15
1656951042496,MATH 109,A01,083213,Ganzberger; Geoffrey Michael,2,0,34,32
1656951042496,MATH 109,A02,083214,Ganzberger; Geoffrey Michael,2,0,34,32
1656951042496,MATH 109,A03,093478,Ganzberger; Geoffrey Michael,1,0,34,33
1656951042496,MATH 109,B01,083215,Ganzberger; Geoffrey Michael,1,0,32,31
1656951042496,MATH 109,B02,083216,Ganzberger; Geoffrey Michael,1,0,32,31
1656951042496,MATH 109,B03,093479,Ganzberger; Geoffrey Michael,6,0,32,26
1656951048525,MATH 142A,A01,083219,Chow; Bennett,6,0,32,26
1656951048525,MATH 142A,A02,083220,Chow; Bennett,10,0,32,22
1656951048525,MATH 142A,A03,093480,Chow; Bennett,7,0,32,25
1656951048525,MATH 142A,B03,093481,Chow; Bennett,7,0,32,25
1656951048525,MATH 142A,B04,093558,Chow; Bennett,11,0,32,21
1656951048525,MATH 142A,B05,093559,Chow; Bennett,6,0,32,26
1656951054549,MATH 193A,A01,083224,Rotar; Vladimir,7,0,34,27
1656951054549,MATH 193A,A02,083225,Rotar; Vladimir,4,0,34,30
1656951054549,MATH 193A,A03,083781,Rotar; Vladimir,1,0,34,33
1656951054549,MATH 193A,A04,083782,Rotar; Vladimir,6,0,34,28
1656951054549,MATH 193A,A05,093482,Rotar; Vladimir,6,0,34,28
1656951060575,MATH 197,001,091859,McAuley; Julian John,9999,0,9999,0
1656951060575,MATH 197,002,095566,Kedlaya; Kiran S.,9997,0,9999,2
1656951060575,MATH 197,003,095567,Xiao; Ming,9999,0,9999,0
1656951060575,MATH 197,004,095571,Perols; Johan Lars,9998,0,9999,1
1656951067797,COGS 9,A01,083615,Shannon; Kyle Michael,7,0,75,68
1656951073821,COGS 11,A01,083617,Boyle; Mary E. T.,19,0,48,29
1656951079844,COGS 13,A01,083071,Bastos; Amalia Pinkusfeld,9,0,71,62
1656951085871,COGS 14A,A01,092681,Semenuks; Arturs,0,1,100,100
1656951091902,COGS 14B,A01,083073,Cheng; Tzu-Han,5,0,63,58
1656951097928,COGS 17,A01,092677,Semenuks; Arturs,4,0,81,77
1656951103950,COGS 100,A01,083619,Allen; Michael Gordon,15,0,70,55
1656951109973,COGS 101A,A01,083621,Davis; Joshua Daniel,9,0,68,59
1656951115998,COGS 101B,A01,091572,Allen; Michael Gordon,8,0,65,57
1656951122030,COGS 101C,A01,083625,Delgado; Tania,17,0,35,18
1656951128051,COGS 107A,A01,083627,Boyle; Mary E. T.,13,0,60,47
1656951134083,COGS 118A,A01,083075,Gupta; Anjum,15,0,76,61
1656951140111,CSE 3,A50,083646,Miranda; Gregory Joseph,22,0,50,28
1656951146139,CSE 8A,A50,083650,Miranda; Gregory Joseph,17,1,56,39
1656951152162,CSE 11,A01,083080,Cao; Yingjun,4,15,40,36
1656951158187,CSE 12,A01,083652,Krause-Levy; Sophia Louisa,20,1,120,100
1656951164215,CSE 15L,A01,083654,Morris; Justin Loren,8,0,50,42
1656951164215,CSE 15L,A02,083655,Morris; Justin Loren,8,0,50,42
1656951170240,CSE 20,A01,083657,Tran; Khoa Dang,37,0,80,43
1656951176262,CSE 21,A01,095574,Bach; Quang Tran,21,0,48,27
1656951182290,CSE 30,A01,083084,Eldon; John,4,0,80,76
1656951182290,CSE 30,B01,095061,Bhaskar; Nishant,6,0,50,44
1656951188318,CSE 100,A01,083659,Cao; Yingjun,3,4,70,67
1656951194345,CSE 134B,A01,083661,Powell; Thomas Allan,19,0,100,81
1656951200369,CSE 140,A01,083663,Gungor; Onat,14,0,85,71
1656951206392,CSE 140L,A01,083088,Eldon; John,16,0,100,84
1656951212416,CSE 175,A01,083665,Kumar; Rakesh,3,0,25,22
1656951218443,CSE 190,A00,092507,Dubnov; Shlomo,7,0,20,13
1656951224467,ECE 45,A01,083139,Congero; Spencer William,5,0,75,70
1656951230491,ECE 65,A50,083695,Saad; Andrew S,12,0,30,18
1656951230491,ECE 65,A51,095125,Saad; Andrew S,25,0,26,1
1656951236519,ECE 109,A01,091882,Touri; Behrouz,16,0,70,54
1656951242547,ECE 180,A00,083140,Abi Samra; Nicholas Camill,0,0,30,30
1656951242547,ECE 180,B00,083141,Abi Samra; Nicholas Camill,0,0,30,30
1656951248573,MATH 10A,A01,083735,Patchell; Gregory David,1,0,30,29
1656951248573,MATH 10A,A02,083736,Patchell; Gregory David,20,0,30,10
1656951248573,MATH 10A,A03,083737,Patchell; Gregory David,15,0,30,15
1656951254599,MATH 10B,A01,083207,Lim; Seonhee,7,0,34,27
1656951254599,MATH 10B,A02,083208,Lim; Seonhee,9,0,35,26
1656951254599,MATH 10B,A03,093472,Lim; Seonhee,4,0,34,30
1656951254599,MATH 10B,B01,083739,Sinha; Shubham,9,0,30,21
1656951260624,MATH 18,A01,083743,Cinel; Cameron Alexander,6,0,30,24
1656951260624,MATH 18,A02,083744,Cinel; Cameron Alexander,15,0,30,15
1656951260624,MATH 18,A03,083745,Cinel; Cameron Alexander,8,0,30,22
1656951260624,MATH 18,B01,083748,Rideout; David Porter,4,0,37,33
1656951260624,MATH 18,B02,083749,Rideout; David Porter,3,0,36,33
1656951260624,MATH 18,B03,083750,Rideout; David Porter,2,0,37,35
1656951260624,MATH 18,B04,083751,Rideout; David Porter,5,0,36,31
1656951260624,MATH 18,B05,093473,Rideout; David Porter,4,0,36,32
1656951260624,MATH 18,B06,093474,Rideout; David Porter,5,0,36,31
1656951266647,MATH 20A,A01,083754,Zheng; Zequn,12,0,40,28
1656951272671,MATH 20B,A01,083756,Briones; Jor-el Thomas Caparas,1,0,36,35
1656951272671,MATH 20B,A02,083757,Briones; Jor-el Thomas Caparas,1,0,36,35
1656951272671,MATH 20B,A03,093475,Briones; Jor-el Thomas Caparas,0,0,36,36
1656951278701,MATH 20C,A01,083760,Briones; Jor-el Thomas Caparas,1,0,35,34
1656951278701,MATH 20C,A02,083761,Briones; Jor-el Thomas Caparas,8,0,35,27
1656951278701,MATH 20C,A03,093476,Briones; Jor-el Thomas Caparas,0,1,36,36
1656951278701,MATH 20C,B01,083762,Bach; Quang Tran,0,0,30,30
1656951284724,MATH 20D,A01,083765,Tran; Brian Kha,4,0,30,26
1656951284724,MATH 20D,A02,083766,Tran; Brian Kha,4,0,30,26
1656951284724,MATH 20D,A03,083767,Tran; Brian Kha,3,0,30,27
1656951290748,MATH 20E,A01,083771,Ganguly; Soumya,5,0,32,27
1656951290748,MATH 20E,A02,083772,Ganguly; Soumya,6,0,32,26
1656951290748,MATH 20E,B01,083773,Ciotti; Benjamin,18,0,35,17
1656951290748,MATH 20E,B02,083774,Ciotti; Benjamin,17,0,35,18
1656951296772,MATH 103A,A01,083777,Greenfeld; Be'Eri,2,0,36,34
1656951296772,MATH 103A,A02,083778,Greenfeld; Be'Eri,5,0,36,31
1656951296772,MATH 103A,A03,093561,Greenfeld; Be'Eri,4,0,36,32
1656951296772,MATH 103A,B01,083779,Greenfeld; Be'Eri,6,0,36,30
1656951296772,MATH 103A,B02,083780,Greenfeld; Be'Eri,2,0,36,34
1656951296772,MATH 103A,B03,093562,Greenfeld; Be'Eri,2,0,36,34
1656951302798,MATH 105,A01,085443,Carter; Anne Toulson,13,0,35,22
1656951302798,MATH 105,A02,093477,Carter; Anne Toulson,20,0,35,15
1656951308822,MATH 109,A01,083213,Ganzberger; Geoffrey Michael,2,0,34,32
1656951308822,MATH 109,A02,083214,Ganzberger; Geoffrey Michael,2,0,34,32
1656951308822,MATH 109,A03,093478,Ganzberger; Geoffrey Michael,1,0,34,33
1656951308822,MATH 109,B01,083215,Ganzberger; Geoffrey Michael,1,0,32,31
1656951308822,MATH 109,B02,083216,Ganzberger; Geoffrey Michael,1,0,32,31
1656951308822,MATH 109,B03,093479,Ganzberger; Geoffrey Michael,6,0,32,26
1656951314851,MATH 142A,A01,083219,Chow; Bennett,6,0,32,26
1656951314851,MATH 142A,A02,083220,Chow; Bennett,10,0,32,22
1656951314851,MATH 142A,A03,093480,Chow; Bennett,7,0,32,25
1656951314851,MATH 142A,B03,093481,Chow; Bennett,7,0,32,25
1656951314851,MATH 142A,B04,093558,Chow; Bennett,11,0,32,21
1656951314851,MATH 142A,B05,093559,Chow; Bennett,6,0,32,26
1656951320881,MATH 193A,A01,083224,Rotar; Vladimir,7,0,34,27
1656951320881,MATH 193A,A02,083225,Rotar; Vladimir,4,0,34,30
1656951320881,MATH 193A,A03,083781,Rotar; Vladimir,1,0,34,33
1656951320881,MATH 193A,A04,083782,Rotar; Vladimir,6,0,34,28
1656951320881,MATH 193A,A05,093482,Rotar; Vladimir,6,0,34,28
1656951326904,MATH 197,001,091859,McAuley; Julian John,9999,0,9999,0
1656951326904,MATH 197,002,095566,Kedlaya; Kiran S.,9997,0,9999,2
1656951326904,MATH 197,003,095567,Xiao; Ming,9999,0,9999,0
1656951326904,MATH 197,004,095571,Perols; Johan Lars,9998,0,9999,1
1656951333968,COGS 9,A01,083615,Shannon; Kyle Michael,7,0,75,68
1656951339992,COGS 11,A01,083617,Boyle; Mary E. T.,19,0,48,29
1656951346016,COGS 13,A01,083071,Bastos; Amalia Pinkusfeld,9,0,71,62
1656951352041,COGS 14A,A01,092681,Semenuks; Arturs,0,1,100,100
1656951358064,COGS 14B,A01,083073,Cheng; Tzu-Han,5,0,63,58
1656951364091,COGS 17,A01,092677,Semenuks; Arturs,4,0,81,77
1656951370116,COGS 100,A01,083619,Allen; Michael Gordon,15,0,70,55
1656951376141,COGS 101A,A01,083621,Davis; Joshua Daniel,9,0,68,59
1656951382164,COGS 101B,A01,091572,Allen; Michael Gordon,8,0,65,57
1656951388195,COGS 101C,A01,083625,Delgado; Tania,17,0,35,18
1656951394224,COGS 107A,A01,083627,Boyle; Mary E. T.,13,0,60,47
1656951400251,COGS 118A,A01,083075,Gupta; Anjum,15,0,76,61
1656951406279,CSE 3,A50,083646,Miranda; Gregory Joseph,22,0,50,28
1656951412303,CSE 8A,A50,083650,Miranda; Gregory Joseph,17,1,56,39
1656951418329,CSE 11,A01,083080,Cao; Yingjun,4,15,40,36
1656951424358,CSE 12,A01,083652,Krause-Levy; Sophia Louisa,20,1,120,100
1656951430386,CSE 15L,A01,083654,Morris; Justin Loren,8,0,50,42
1656951430386,CSE 15L,A02,083655,Morris; Justin Loren,8,0,50,42
1656951436414,CSE 20,A01,083657,Tran; Khoa Dang,37,0,80,43
1656951442436,CSE 21,A01,095574,Bach; Quang Tran,21,0,48,27
1656951448461,CSE 30,A01,083084,Eldon; John,4,0,80,76
1656951448461,CSE 30,B01,095061,Bhaskar; Nishant,6,0,50,44
1656951454485,CSE 100,A01,083659,Cao; Yingjun,3,4,70,67
1656951460512,CSE 134B,A01,083661,Powell; Thomas Allan,19,0,100,81
1656951466541,CSE 140,A01,083663,Gungor; Onat,14,0,85,71
1656951472565,CSE 140L,A01,083088,Eldon; John,16,0,100,84
1656951478592,CSE 175,A01,083665,Kumar; Rakesh,3,0,25,22
1656951484616,CSE 190,A00,092507,Dubnov; Shlomo,7,0,20,13
1656951490641,ECE 45,A01,083139,Congero; Spencer William,5,0,75,70
1656951496668,ECE 65,A50,083695,Saad; Andrew S,12,0,30,18
1656951496668,ECE 65,A51,095125,Saad; Andrew S,25,0,26,1
1656951502692,ECE 109,A01,091882,Touri; Behrouz,16,0,70,54
1656951508714,ECE 180,A00,083140,Abi Samra; Nicholas Camill,0,0,30,30
1656951508714,ECE 180,B00,083141,Abi Samra; Nicholas Camill,0,0,30,30
1656951514737,MATH 10A,A01,083735,Patchell; Gregory David,1,0,30,29
1656951514737,MATH 10A,A02,083736,Patchell; Gregory David,20,0,30,10
1656951514737,MATH 10A,A03,083737,Patchell; Gregory David,15,0,30,15
1656951520765,MATH 10B,A01,083207,Lim; Seonhee,7,0,34,27
1656951520765,MATH 10B,A02,083208,Lim; Seonhee,9,0,35,26
1656951520765,MATH 10B,A03,093472,Lim; Seonhee,4,0,34,30
1656951520765,MATH 10B,B01,083739,Sinha; Shubham,9,0,30,21
1656951526802,MATH 18,A01,083743,Cinel; Cameron Alexander,6,0,30,24
1656951526802,MATH 18,A02,083744,Cinel; Cameron Alexander,15,0,30,15
1656951526802,MATH 18,A03,083745,Cinel; Cameron Alexander,8,0,30,22
1656951526802,MATH 18,B01,083748,Rideout; David Porter,4,0,37,33
1656951526802,MATH 18,B02,083749,Rideout; David Porter,3,0,36,33
1656951526802,MATH 18,B03,083750,Rideout; David Porter,2,0,37,35
1656951526802,MATH 18,B04,083751,Rideout; David Porter,5,0,36,31
1656951526802,MATH 18,B05,093473,Rideout; David Porter,4,0,36,32
1656951526802,MATH 18,B06,093474,Rideout; David Porter,5,0,36,31
1656951532828,MATH 20A,A01,083754,Zheng; Zequn,12,0,40,28
1656951538856,MATH 20B,A01,083756,Briones; Jor-el Thomas Caparas,1,0,36,35
1656951538856,MATH 20B,A02,083757,Briones; Jor-el Thomas Caparas,1,0,36,35
1656951538856,MATH 20B,A03,093475,Briones; Jor-el Thomas Caparas,0,0,36,36
1656951544882,MATH 20C,A01,083760,Briones; Jor-el Thomas Caparas,1,0,35,34
1656951544882,MATH 20C,A02,083761,Briones; Jor-el Thomas Caparas,8,0,35,27
1656951544882,MATH 20C,A03,093476,Briones; Jor-el Thomas Caparas,0,1,36,36
1656951544882,MATH 20C,B01,083762,Bach; Quang Tran,0,0,30,30
1656951550908,MATH 20D,A01,083765,Tran; Brian Kha,4,0,30,26
1656951550908,MATH 20D,A02,083766,Tran; Brian Kha,4,0,30,26
1656951550908,MATH 20D,A03,083767,Tran; Brian Kha,3,0,30,27
1656951556936,MATH 20E,A01,083771,Ganguly; Soumya,5,0,32,27
1656951556936,MATH 20E,A02,083772,Ganguly; Soumya,6,0,32,26
1656951556936,MATH 20E,B01,083773,Ciotti; Benjamin,18,0,35,17
1656951556936,MATH 20E,B02,083774,Ciotti; Benjamin,17,0,35,18
1656951562964,MATH 103A,A01,083777,Greenfeld; Be'Eri,2,0,36,34
1656951562964,MATH 103A,A02,083778,Greenfeld; Be'Eri,5,0,36,31
1656951562964,MATH 103A,A03,093561,Greenfeld; Be'Eri,4,0,36,32
1656951562964,MATH 103A,B01,083779,Greenfeld; Be'Eri,6,0,36,30
1656951562964,MATH 103A,B02,083780,Greenfeld; Be'Eri,2,0,36,34
1656951562964,MATH 103A,B03,093562,Greenfeld; Be'Eri,2,0,36,34
1656951568987,MATH 105,A01,085443,Carter; Anne Toulson,13,0,35,22
1656951568987,MATH 105,A02,093477,Carter; Anne Toulson,20,0,35,15
1656951575014,MATH 109,A01,083213,Ganzberger; Geoffrey Michael,2,0,34,32
1656951575014,MATH 109,A02,083214,Ganzberger; Geoffrey Michael,2,0,34,32
1656951575014,MATH 109,A03,093478,Ganzberger; Geoffrey Michael,1,0,34,33
1656951575014,MATH 109,B01,083215,Ganzberger; Geoffrey Michael,1,0,32,31
1656951575014,MATH 109,B02,083216,Ganzberger; Geoffrey Michael,1,0,32,31
1656951575014,MATH 109,B03,093479,Ganzberger; Geoffrey Michael,6,0,32,26
1656951581043,MATH 142A,A01,083219,Chow; Bennett,6,0,32,26
1656951581043,MATH 142A,A02,083220,Chow; Bennett,10,0,32,22
1656951581043,MATH 142A,A03,093480,Chow; Bennett,7,0,32,25
1656951581043,MATH 142A,B03,093481,Chow; Bennett,7,0,32,25
1656951581043,MATH 142A,B04,093558,Chow; Bennett,11,0,32,21
1656951581043,MATH 142A,B05,093559,Chow; Bennett,6,0,32,26
1656951587067,MATH 193A,A01,083224,Rotar; Vladimir,7,0,34,27
1656951587067,MATH 193A,A02,083225,Rotar; Vladimir,4,0,34,30
1656951587067,MATH 193A,A03,083781,Rotar; Vladimir,1,0,34,33
1656951587067,MATH 193A,A04,083782,Rotar; Vladimir,6,0,34,28
1656951587067,MATH 193A,A05,093482,Rotar; Vladimir,6,0,34,28
1656951593090,MATH 197,001,091859,McAuley; Julian John,9999,0,9999,0
1656951593090,MATH 197,002,095566,Kedlaya; Kiran S.,9997,0,9999,2
1656951593090,MATH 197,003,095567,Xiao; Ming,9999,0,9999,0
1656951593090,MATH 197,004,095571,Perols; Johan Lars,9998,0,9999,1
1656951600157,COGS 9,A01,083615,Shannon; Kyle Michael,7,0,75,68
1656951606181,COGS 11,A01,083617,Boyle; Mary E. T.,19,0,48,29
1656951612207,COGS 13,A01,083071,Bastos; Amalia Pinkusfeld,9,0,71,62
1656951618232,COGS 14A,A01,092681,Semenuks; Arturs,0,1,100,100
1656951624259,COGS 14B,A01,083073,Cheng; Tzu-Han,5,0,63,58
1656951630284,COGS 17,A01,092677,Semenuks; Arturs,4,0,81,77
1656951636312,COGS 100,A01,083619,Allen; Michael Gordon,15,0,70,55
1656951642336,COGS 101A,A01,083621,Davis; Joshua Daniel,9,0,68,59
1656951648360,COGS 101B,A01,091572,Allen; Michael Gordon,8,0,65,57
1656951654384,COGS 101C,A01,083625,Delgado; Tania,17,0,35,18
1656951660409,COGS 107A,A01,083627,Boyle; Mary E. T.,13,0,60,47
1656951666504,COGS 118A,A01,083075,Gupta; Anjum,15,0,76,61
1656951672534,CSE 3,A50,083646,Miranda; Gregory Joseph,22,0,50,28
1656951678558,CSE 8A,A50,083650,Miranda; Gregory Joseph,17,1,56,39
1656951684587,CSE 11,A01,083080,Cao; Yingjun,4,15,40,36
1656951690610,CSE 12,A01,083652,Krause-Levy; Sophia Louisa,20,1,120,100
1656951696634,CSE 15L,A01,083654,Morris; Justin Loren,8,0,50,42
1656951696634,CSE 15L,A02,083655,Morris; Justin Loren,8,0,50,42
1656951702661,CSE 20,A01,083657,Tran; Khoa Dang,37,0,80,43
1656951708685,CSE 21,A01,095574,Bach; Quang Tran,21,0,48,27
1656951714713,CSE 30,A01,083084,Eldon; John,4,0,80,76
1656951714713,CSE 30,B01,095061,Bhaskar; Nishant,6,0,50,44
1656951720738,CSE 100,A01,083659,Cao; Yingjun,3,4,70,67
1656951726767,CSE 134B,A01,083661,Powell; Thomas Allan,19,0,100,81
1656951732794,CSE 140,A01,083663,Gungor; Onat,14,0,85,71
1656951738828,CSE 140L,A01,083088,Eldon; John,16,0,100,84
1656951744863,CSE 175,A01,083665,Kumar; Rakesh,3,0,25,22
1656951750891,CSE 190,A00,092507,Dubnov; Shlomo,7,0,20,13
1656951756921,ECE 45,A01,083139,Congero; Spencer William,5,0,75,70
1656951762947,ECE 65,A50,083695,Saad; Andrew S,12,0,30,18
1656951762947,ECE 65,A51,095125,Saad; Andrew S,25,0,26,1
1656951768971,ECE 109,A01,091882,Touri; Behrouz,16,0,70,54
1656951774994,ECE 180,A00,083140,Abi Samra; Nicholas Camill,0,0,30,30
1656951774994,ECE 180,B00,083141,Abi Samra; Nicholas Camill,0,0,30,30
1656951781016,MATH 10A,A01,083735,Patchell; Gregory David,1,0,30,29
1656951781016,MATH 10A,A02,083736,Patchell; Gregory David,20,0,30,10
1656951781016,MATH 10A,A03,083737,Patchell; Gregory David,15,0,30,15
1656951787044,MATH 10B,A01,083207,Lim; Seonhee,7,0,34,27
1656951787044,MATH 10B,A02,083208,Lim; Seonhee,9,0,35,26
1656951787044,MATH 10B,A03,093472,Lim; Seonhee,4,0,34,30
1656951787044,MATH 10B,B01,083739,Sinha; Shubham,9,0,30,21
1656951793069,MATH 18,A01,083743,Cinel; Cameron Alexander,6,0,30,24
1656951793069,MATH 18,A02,083744,Cinel; Cameron Alexander,15,0,30,15
1656951793069,MATH 18,A03,083745,Cinel; Cameron Alexander,8,0,30,22
1656951793069,MATH 18,B01,083748,Rideout; David Porter,4,0,37,33
1656951793069,MATH 18,B02,083749,Rideout; David Porter,3,0,36,33
1656951793069,MATH 18,B03,083750,Rideout; David Porter,2,0,37,35
1656951793069,MATH 18,B04,083751,Rideout; David Porter,5,0,36,31
1656951793069,MATH 18,B05,093473,Rideout; David Porter,4,0,36,32
1656951793069,MATH 18,B06,093474,Rideout; David Porter,5,0,36,31
1656951799096,MATH 20A,A01,083754,Zheng; Zequn,12,0,40,28
1656951805125,MATH 20B,A01,083756,Briones; Jor-el Thomas Caparas,1,0,36,35
1656951805125,MATH 20B,A02,083757,Briones; Jor-el Thomas Caparas,1,0,36,35
1656951805125,MATH 20B,A03,093475,Briones; Jor-el Thomas Caparas,0,0,36,36
1656951811150,MATH 20C,A01,083760,Briones; Jor-el Thomas Caparas,1,0,35,34
1656951811150,MATH 20C,A02,083761,Briones; Jor-el Thomas Caparas,8,0,35,27
1656951811150,MATH 20C,A03,093476,Briones; Jor-el Thomas Caparas,0,1,36,36
1656951811150,MATH 20C,B01,083762,Bach; Quang Tran,0,0,30,30
1656951817175,MATH 20D,A01,083765,Tran; Brian Kha,4,0,30,26
1656951817175,MATH 20D,A02,083766,Tran; Brian Kha,4,0,30,26
1656951817175,MATH 20D,A03,083767,Tran; Brian Kha,3,0,30,27
1656951823199,MATH 20E,A01,083771,Ganguly; Soumya,5,0,32,27
1656951823199,MATH 20E,A02,083772,Ganguly; Soumya,6,0,32,26
1656951823199,MATH 20E,B01,083773,Ciotti; Benjamin,18,0,35,17
1656951823199,MATH 20E,B02,083774,Ciotti; Benjamin,17,0,35,18
1656951829224,MATH 103A,A01,083777,Greenfeld; Be'Eri,2,0,36,34
1656951829224,MATH 103A,A02,083778,Greenfeld; Be'Eri,5,0,36,31
1656951829224,MATH 103A,A03,093561,Greenfeld; Be'Eri,4,0,36,32
1656951829224,MATH 103A,B01,083779,Greenfeld; Be'Eri,6,0,36,30
1656951829224,MATH 103A,B02,083780,Greenfeld; Be'Eri,2,0,36,34
1656951829224,MATH 103A,B03,093562,Greenfeld; Be'Eri,2,0,36,34
1656951835253,MATH 105,A01,085443,Carter; Anne Toulson,13,0,35,22
1656951835253,MATH 105,A02,093477,Carter; Anne Toulson,20,0,35,15
1656951841275,MATH 109,A01,083213,Ganzberger; Geoffrey Michael,2,0,34,32
1656951841275,MATH 109,A02,083214,Ganzberger; Geoffrey Michael,2,0,34,32
1656951841275,MATH 109,A03,093478,Ganzberger; Geoffrey Michael,1,0,34,33
1656951841275,MATH 109,B01,083215,Ganzberger; Geoffrey Michael,1,0,32,31
1656951841275,MATH 109,B02,083216,Ganzberger; Geoffrey Michael,1,0,32,31
1656951841275,MATH 109,B03,093479,Ganzberger; Geoffrey Michael,6,0,32,26
1656951847306,MATH 142A,A01,083219,Chow; Bennett,6,0,32,26
1656951847306,MATH 142A,A02,083220,Chow; Bennett,10,0,32,22
1656951847306,MATH 142A,A03,093480,Chow; Bennett,7,0,32,25
1656951847306,MATH 142A,B03,093481,Chow; Bennett,7,0,32,25
1656951847306,MATH 142A,B04,093558,Chow; Bennett,11,0,32,21
1656951847306,MATH 142A,B05,093559,Chow; Bennett,6,0,32,26
1656951853335,MATH 193A,A01,083224,Rotar; Vladimir,7,0,34,27
1656951853335,MATH 193A,A02,083225,Rotar; Vladimir,4,0,34,30
1656951853335,MATH 193A,A03,083781,Rotar; Vladimir,1,0,34,33
1656951853335,MATH 193A,A04,083782,Rotar; Vladimir,6,0,34,28
1656951853335,MATH 193A,A05,093482,Rotar; Vladimir,6,0,34,28
1656951859359,MATH 197,001,091859,McAuley; Julian John,9999,0,9999,0
1656951859359,MATH 197,002,095566,Kedlaya; Kiran S.,9997,0,9999,2
1656951859359,MATH 197,003,095567,Xiao; Ming,9999,0,9999,0
1656951859359,MATH 197,004,095571,Perols; Johan Lars,9998,0,9999,1
1656951866415,COGS 9,A01,083615,Shannon; Kyle Michael,7,0,75,68
1656951872438,COGS 11,A01,083617,Boyle; Mary E. T.,19,0,48,29
1656951878463,COGS 13,A01,083071,Bastos; Amalia Pinkusfeld,9,0,71,62
1656951884487,COGS 14A,A01,092681,Semenuks; Arturs,0,1,100,100
1656951890511,COGS 14B,A01,083073,Cheng; Tzu-Han,5,0,63,58
1656951896533,COGS 17,A01,092677,Semenuks; Arturs,4,0,81,77
1656951902559,COGS 100,A01,083619,Allen; Michael Gordon,15,0,70,55
1656951908585,COGS 101A,A01,083621,Davis; Joshua Daniel,9,0,68,59
1656951914609,COGS 101B,A01,091572,Allen; Michael Gordon,8,0,65,57
1656951920632,COGS 101C,A01,083625,Delgado; Tania,17,0,35,18
1656951926655,COGS 107A,A01,083627,Boyle; Mary E. T.,13,0,60,47
1656951932684,COGS 118A,A01,083075,Gupta; Anjum,15,0,76,61
1656951938712,CSE 3,A50,083646,Miranda; Gregory Joseph,22,0,50,28
1656951944736,CSE 8A,A50,083650,Miranda; Gregory Joseph,17,1,56,39
1656951950759,CSE 11,A01,083080,Cao; Yingjun,4,15,40,36
1656951956783,CSE 12,A01,083652,Krause-Levy; Sophia Louisa,20,1,120,100
1656951962810,CSE 15L,A01,083654,Morris; Justin Loren,8,0,50,42
1656951962810,CSE 15L,A02,083655,Morris; Justin Loren,8,0,50,42
1656951968832,CSE 20,A01,083657,Tran; Khoa Dang,37,0,80,43
1656951974860,CSE 21,A01,095574,Bach; Quang Tran,21,0,48,27
1656951980885,CSE 30,A01,083084,Eldon; John,4,0,80,76
1656951980885,CSE 30,B01,095061,Bhaskar; Nishant,6,0,50,44
1656951986908,CSE 100,A01,083659,Cao; Yingjun,3,4,70,67
1656951992936,CSE 134B,A01,083661,Powell; Thomas Allan,19,0,100,81
1656951998958,CSE 140,A01,083663,Gungor; Onat,14,0,85,71
1656952004982,CSE 140L,A01,083088,Eldon; John,16,0,100,84
1656952011005,CSE 175,A01,083665,Kumar; Rakesh,3,0,25,22
1656952017030,CSE 190,A00,092507,Dubnov; Shlomo,7,0,20,13
1656952023051,ECE 45,A01,083139,Congero; Spencer William,5,0,75,70
1656952029074,ECE 65,A50,083695,Saad; Andrew S,12,0,30,18
1656952029074,ECE 65,A51,095125,Saad; Andrew S,25,0,26,1
1656952035103,ECE 109,A01,091882,Touri; Behrouz,16,0,70,54
1656952041132,ECE 180,A00,083140,Abi Samra; Nicholas Camill,0,0,30,30
1656952041132,ECE 180,B00,083141,Abi Samra; Nicholas Camill,0,0,30,30
1656952047157,MATH 10A,A01,083735,Patchell; Gregory David,1,0,30,29
1656952047157,MATH 10A,A02,083736,Patchell; Gregory David,20,0,30,10
1656952047157,MATH 10A,A03,083737,Patchell; Gregory David,15,0,30,15
1656952053188,MATH 10B,A01,083207,Lim; Seonhee,7,0,34,27
1656952053188,MATH 10B,A02,083208,Lim; Seonhee,9,0,35,26
1656952053188,MATH 10B,A03,093472,Lim; Seonhee,4,0,34,30
1656952053188,MATH 10B,B01,083739,Sinha; Shubham,9,0,30,21
1656952059213,MATH 18,A01,083743,Cinel; Cameron Alexander,6,0,30,24
1656952059213,MATH 18,A02,083744,Cinel; Cameron Alexander,15,0,30,15
1656952059213,MATH 18,A03,083745,Cinel; Cameron Alexander,8,0,30,22
1656952059213,MATH 18,B01,083748,Rideout; David Porter,4,0,37,33
1656952059213,MATH 18,B02,083749,Rideout; David Porter,3,0,36,33
1656952059213,MATH 18,B03,083750,Rideout; David Porter,2,0,37,35
1656952059213,MATH 18,B04,083751,Rideout; David Porter,5,0,36,31
1656952059213,MATH 18,B05,093473,Rideout; David Porter,4,0,36,32
1656952059213,MATH 18,B06,093474,Rideout; David Porter,5,0,36,31
1656952065248,MATH 20A,A01,083754,Zheng; Zequn,12,0,40,28
1656952071275,MATH 20B,A01,083756,Briones; Jor-el Thomas Caparas,1,0,36,35
1656952071275,MATH 20B,A02,083757,Briones; Jor-el Thomas Caparas,1,0,36,35
1656952071275,MATH 20B,A03,093475,Briones; Jor-el Thomas Caparas,0,0,36,36
1656952077301,MATH 20C,A01,083760,Briones; Jor-el Thomas Caparas,1,0,35,34
1656952077301,MATH 20C,A02,083761,Briones; Jor-el Thomas Caparas,8,0,35,27
1656952077301,MATH 20C,A03,093476,Briones; Jor-el Thomas Caparas,0,1,36,36
1656952077301,MATH 20C,B01,083762,Bach; Quang Tran,0,0,30,30
1656952083326,MATH 20D,A01,083765,Tran; Brian Kha,4,0,30,26
1656952083326,MATH 20D,A02,083766,Tran; Brian Kha,4,0,30,26
1656952083326,MATH 20D,A03,083767,Tran; Brian Kha,3,0,30,27
1656952089356,MATH 20E,A01,083771,Ganguly; Soumya,5,0,32,27
1656952089356,MATH 20E,A02,083772,Ganguly; Soumya,6,0,32,26
1656952089356,MATH 20E,B01,083773,Ciotti; Benjamin,18,0,35,17
1656952089356,MATH 20E,B02,083774,Ciotti; Benjamin,17,0,35,18
1656952095378,MATH 103A,A01,083777,Greenfeld; Be'Eri,2,0,36,34
1656952095378,MATH 103A,A02,083778,Greenfeld; Be'Eri,5,0,36,31
1656952095378,MATH 103A,A03,093561,Greenfeld; Be'Eri,4,0,36,32
1656952095378,MATH 103A,B01,083779,Greenfeld; Be'Eri,6,0,36,30
1656952095378,MATH 103A,B02,083780,Greenfeld; Be'Eri,2,0,36,34
1656952095378,MATH 103A,B03,093562,Greenfeld; Be'Eri,2,0,36,34
1656952101405,MATH 105,A01,085443,Carter; Anne Toulson,13,0,35,22
1656952101405,MATH 105,A02,093477,Carter; Anne Toulson,20,0,35,15
1656952107430,MATH 109,A01,083213,Ganzberger; Geoffrey Michael,2,0,34,32
1656952107430,MATH 109,A02,083214,Ganzberger; Geoffrey Michael,2,0,34,32
1656952107430,MATH 109,A03,093478,Ganzberger; Geoffrey Michael,1,0,34,33
1656952107430,MATH 109,B01,083215,Ganzberger; Geoffrey Michael,1,0,32,31
1656952107430,MATH 109,B02,083216,Ganzberger; Geoffrey Michael,1,0,32,31
1656952107430,MATH 109,B03,093479,Ganzberger; Geoffrey Michael,6,0,32,26
1656952113458,MATH 142A,A01,083219,Chow; Bennett,6,0,32,26
1656952113458,MATH 142A,A02,083220,Chow; Bennett,10,0,32,22
1656952113458,MATH 142A,A03,093480,Chow; Bennett,7,0,32,25
1656952113458,MATH 142A,B03,093481,Chow; Bennett,7,0,32,25
1656952113458,MATH 142A,B04,093558,Chow; Bennett,11,0,32,21
1656952113458,MATH 142A,B05,093559,Chow; Bennett,6,0,32,26
1656952119482,MATH 193A,A01,083224,Rotar; Vladimir,7,0,34,27
1656952119482,MATH 193A,A02,083225,Rotar; Vladimir,4,0,34,30
1656952119482,MATH 193A,A03,083781,Rotar; Vladimir,1,0,34,33
1656952119482,MATH 193A,A04,083782,Rotar; Vladimir,6,0,34,28
1656952119482,MATH 193A,A05,093482,Rotar; Vladimir,6,0,34,28
1656952125507,MATH 197,001,091859,McAuley; Julian John,9999,0,9999,0
1656952125507,MATH 197,002,095566,Kedlaya; Kiran S.,9997,0,9999,2
1656952125507,MATH 197,003,095567,Xiao; Ming,9999,0,9999,0
1656952125507,MATH 197,004,095571,Perols; Johan Lars,9998,0,9999,1
1656952132558,COGS 9,A01,083615,Shannon; Kyle Michael,7,0,75,68
1656952138586,COGS 11,A01,083617,Boyle; Mary E. T.,19,0,48,29
1656952144608,COGS 13,A01,083071,Bastos; Amalia Pinkusfeld,9,0,71,62
1656952150631,COGS 14A,A01,092681,Semenuks; Arturs,0,1,100,100
1656952156658,COGS 14B,A01,083073,Cheng; Tzu-Han,5,0,63,58
1656952162683,COGS 17,A01,092677,Semenuks; Arturs,4,0,81,77
1656952168708,COGS 100,A01,083619,Allen; Michael Gordon,15,0,70,55
1656952174731,COGS 101A,A01,083621,Davis; Joshua Daniel,9,0,68,59
1656952180752,COGS 101B,A01,091572,Allen; Michael Gordon,8,0,65,57
1656952186778,COGS 101C,A01,083625,Delgado; Tania,17,0,35,18
1656952192809,COGS 107A,A01,083627,Boyle; Mary E. T.,13,0,60,47
1656952198831,COGS 118A,A01,083075,Gupta; Anjum,15,0,76,61
1656952204854,CSE 3,A50,083646,Miranda; Gregory Joseph,22,0,50,28
1656952210882,CSE 8A,A50,083650,Miranda; Gregory Joseph,17,1,56,39
1656952216903,CSE 11,A01,083080,Cao; Yingjun,4,15,40,36
1656952222927,CSE 12,A01,083652,Krause-Levy; Sophia Louisa,20,1,120,100
1656952228963,CSE 15L,A01,083654,Morris; Justin Loren,8,0,50,42
1656952228963,CSE 15L,A02,083655,Morris; Justin Loren,8,0,50,42
1656952234990,CSE 20,A01,083657,Tran; Khoa Dang,37,0,80,43
1656952241017,CSE 21,A01,095574,Bach; Quang Tran,21,0,48,27
1656952247045,CSE 30,A01,083084,Eldon; John,4,0,80,76
1656952247045,CSE 30,B01,095061,Bhaskar; Nishant,6,0,50,44
1656952253068,CSE 100,A01,083659,Cao; Yingjun,3,4,70,67
1656952259095,CSE 134B,A01,083661,Powell; Thomas Allan,19,0,100,81
1656952265214,CSE 140,A01,083663,Gungor; Onat,14,0,85,71
1656952271236,CSE 140L,A01,083088,Eldon; John,16,0,100,84
1656952277261,CSE 175,A01,083665,Kumar; Rakesh,3,0,25,22
1656952283286,CSE 190,A00,092507,Dubnov; Shlomo,7,0,20,13
1656952289312,ECE 45,A01,083139,Congero; Spencer William,5,0,75,70
1656952295347,ECE 65,A50,083695,Saad; Andrew S,12,0,30,18
1656952295347,ECE 65,A51,095125,Saad; Andrew S,25,0,26,1
1656952301370,ECE 109,A01,091882,Touri; Behrouz,16,0,70,54
1656952307397,ECE 180,A00,083140,Abi Samra; Nicholas Camill,0,0,30,30
1656952307397,ECE 180,B00,083141,Abi Samra; Nicholas Camill,0,0,30,30
1656952313424,MATH 10A,A01,083735,Patchell; Gregory David,1,0,30,29
1656952313424,MATH 10A,A02,083736,Patchell; Gregory David,20,0,30,10
1656952313424,MATH 10A,A03,083737,Patchell; Gregory David,15,0,30,15
1656952319447,MATH 10B,A01,083207,Lim; Seonhee,7,0,34,27
1656952319447,MATH 10B,A02,083208,Lim; Seonhee,9,0,35,26
1656952319447,MATH 10B,A03,093472,Lim; Seonhee,4,0,34,30
1656952319447,MATH 10B,B01,083739,Sinha; Shubham,9,0,30,21
1656952325471,MATH 18,A01,083743,Cinel; Cameron Alexander,6,0,30,24
1656952325471,MATH 18,A02,083744,Cinel; Cameron Alexander,15,0,30,15
1656952325471,MATH 18,A03,083745,Cinel; Cameron Alexander,8,0,30,22
1656952325471,MATH 18,B01,083748,Rideout; David Porter,4,0,37,33
1656952325471,MATH 18,B02,083749,Rideout; David Porter,3,0,36,33
1656952325471,MATH 18,B03,083750,Rideout; David Porter,2,0,37,35
1656952325471,MATH 18,B04,083751,Rideout; David Porter,5,0,36,31
1656952325471,MATH 18,B05,093473,Rideout; David Porter,4,0,36,32
1656952325471,MATH 18,B06,093474,Rideout; David Porter,5,0,36,31
1656952331503,MATH 20A,A01,083754,Zheng; Zequn,12,0,40,28
1656952337527,MATH 20B,A01,083756,Briones; Jor-el Thomas Caparas,1,0,36,35
1656952337527,MATH 20B,A02,083757,Briones; Jor-el Thomas Caparas,1,0,36,35
1656952337527,MATH 20B,A03,093475,Briones; Jor-el Thomas Caparas,0,0,36,36
1656952343551,MATH 20C,A01,083760,Briones; Jor-el Thomas Caparas,1,0,35,34
1656952343551,MATH 20C,A02,083761,Briones; Jor-el Thomas Caparas,8,0,35,27
1656952343551,MATH 20C,A03,093476,Briones; Jor-el Thomas Caparas,0,1,36,36
1656952343551,MATH 20C,B01,083762,Bach; Quang Tran,0,0,30,30
1656952349581,MATH 20D,A01,083765,Tran; Brian Kha,4,0,30,26
1656952349581,MATH 20D,A02,083766,Tran; Brian Kha,4,0,30,26
1656952349581,MATH 20D,A03,083767,Tran; Brian Kha,3,0,30,27
1656952355608,MATH 20E,A01,083771,Ganguly; Soumya,5,0,32,27
1656952355608,MATH 20E,A02,083772,Ganguly; Soumya,6,0,32,26
1656952355608,MATH 20E,B01,083773,Ciotti; Benjamin,18,0,35,17
1656952355608,MATH 20E,B02,083774,Ciotti; Benjamin,17,0,35,18
1656952361637,MATH 103A,A01,083777,Greenfeld; Be'Eri,2,0,36,34
1656952361637,MATH 103A,A02,083778,Greenfeld; Be'Eri,5,0,36,31
1656952361637,MATH 103A,A03,093561,Greenfeld; Be'Eri,4,0,36,32
1656952361637,MATH 103A,B01,083779,Greenfeld; Be'Eri,6,0,36,30
1656952361637,MATH 103A,B02,083780,Greenfeld; Be'Eri,2,0,36,34
1656952361637,MATH 103A,B03,093562,Greenfeld; Be'Eri,2,0,36,34
1656952367662,MATH 105,A01,085443,Carter; Anne Toulson,13,0,35,22
1656952367662,MATH 105,A02,093477,Carter; Anne Toulson,20,0,35,15
1656952373686,MATH 109,A01,083213,Ganzberger; Geoffrey Michael,2,0,34,32
1656952373686,MATH 109,A02,083214,Ganzberger; Geoffrey Michael,2,0,34,32
1656952373686,MATH 109,A03,093478,Ganzberger; Geoffrey Michael,1,0,34,33
1656952373686,MATH 109,B01,083215,Ganzberger; Geoffrey Michael,1,0,32,31
1656952373686,MATH 109,B02,083216,Ganzberger; Geoffrey Michael,1,0,32,31
1656952373686,MATH 109,B03,093479,Ganzberger; Geoffrey Michael,6,0,32,26
1656952379716,MATH 142A,A01,083219,Chow; Bennett,6,0,32,26
1656952379716,MATH 142A,A02,083220,Chow; Bennett,10,0,32,22
1656952379716,MATH 142A,A03,093480,Chow; Bennett,7,0,32,25
1656952379716,MATH 142A,B03,093481,Chow; Bennett,7,0,32,25
1656952379716,MATH 142A,B04,093558,Chow; Bennett,11,0,32,21
1656952379716,MATH 142A,B05,093559,Chow; Bennett,6,0,32,26
1656952385744,MATH 193A,A01,083224,Rotar; Vladimir,7,0,34,27
1656952385744,MATH 193A,A02,083225,Rotar; Vladimir,4,0,34,30
1656952385744,MATH 193A,A03,083781,Rotar; Vladimir,1,0,34,33
1656952385744,MATH 193A,A04,083782,Rotar; Vladimir,6,0,34,28
1656952385744,MATH 193A,A05,093482,Rotar; Vladimir,6,0,34,28
1656952391767,MATH 197,001,091859,McAuley; Julian John,9999,0,9999,0
1656952391767,MATH 197,002,095566,Kedlaya; Kiran S.,9997,0,9999,2
1656952391767,MATH 197,003,095567,Xiao; Ming,9999,0,9999,0
1656952391767,MATH 197,004,095571,Perols; Johan Lars,9998,0,9999,1
1656952398844,COGS 9,A01,083615,Shannon; Kyle Michael,7,0,75,68
1656952404870,COGS 11,A01,083617,Boyle; Mary E. T.,19,0,48,29
1656952410898,COGS 13,A01,083071,Bastos; Amalia Pinkusfeld,9,0,71,62
1656952416921,COGS 14A,A01,092681,Semenuks; Arturs,0,1,100,100
1656952422946,COGS 14B,A01,083073,Cheng; Tzu-Han,5,0,63,58
1656952428969,COGS 17,A01,092677,Semenuks; Arturs,4,0,81,77
1656952434997,COGS 100,A01,083619,Allen; Michael Gordon,15,0,70,55
1656952441021,COGS 101A,A01,083621,Davis; Joshua Daniel,9,0,68,59
1656952447046,COGS 101B,A01,091572,Allen; Michael Gordon,8,0,65,57
1656952453086,COGS 101C,A01,083625,Delgado; Tania,17,0,35,18
1656952459112,COGS 107A,A01,083627,Boyle; Mary E. T.,13,0,60,47
1656952465136,COGS 118A,A01,083075,Gupta; Anjum,15,0,76,61
1656952471161,CSE 3,A50,083646,Miranda; Gregory Joseph,22,0,50,28
1656952477189,CSE 8A,A50,083650,Miranda; Gregory Joseph,17,1,56,39
1656952483213,CSE 11,A01,083080,Cao; Yingjun,4,15,40,36
1656952489241,CSE 12,A01,083652,Krause-Levy; Sophia Louisa,20,1,120,100
1656952495276,CSE 15L,A01,083654,Morris; Justin Loren,8,0,50,42
1656952495276,CSE 15L,A02,083655,Morris; Justin Loren,8,0,50,42
1656952501304,CSE 20,A01,083657,Tran; Khoa Dang,37,0,80,43
1656952507330,CSE 21,A01,095574,Bach; Quang Tran,21,0,48,27
1656952513358,CSE 30,A01,083084,Eldon; John,4,0,80,76
1656952513358,CSE 30,B01,095061,Bhaskar; Nishant,6,0,50,44
1656952519385,CSE 100,A01,083659,Cao; Yingjun,3,4,70,67
1656952525407,CSE 134B,A01,083661,Powell; Thomas Allan,19,0,100,81
1656952531430,CSE 140,A01,083663,Gungor; Onat,14,0,85,71
1656952537457,CSE 140L,A01,083088,Eldon; John,16,0,100,84
1656952543484,CSE 175,A01,083665,Kumar; Rakesh,3,0,25,22
1656952549514,CSE 190,A00,092507,Dubnov; Shlomo,7,0,20,13
1656952555536,ECE 45,A01,083139,Congero; Spencer William,5,0,75,70
1656952561563,ECE 65,A50,083695,Saad; Andrew S,12,0,30,18
1656952561563,ECE 65,A51,095125,Saad; Andrew S,25,0,26,1
1656952567587,ECE 109,A01,091882,Touri; Behrouz,16,0,70,54
1656952573611,ECE 180,A00,083140,Abi Samra; Nicholas Camill,0,0,30,30
1656952573611,ECE 180,B00,083141,Abi Samra; Nicholas Camill,0,0,30,30
1656952579639,MATH 10A,A01,083735,Patchell; Gregory David,1,0,30,29
1656952579639,MATH 10A,A02,083736,Patchell; Gregory David,20,0,30,10
1656952579639,MATH 10A,A03,083737,Patchell; Gregory David,15,0,30,15
1656952585668,MATH 10B,A01,083207,Lim; Seonhee,7,0,34,27
1656952585668,MATH 10B,A02,083208,Lim; Seonhee,9,0,35,26
1656952585668,MATH 10B,A03,093472,Lim; Seonhee,4,0,34,30
1656952585668,MATH 10B,B01,083739,Sinha; Shubham,9,0,30,21
1656952591693,MATH 18,A01,083743,Cinel; Cameron Alexander,6,0,30,24
1656952591693,MATH 18,A02,083744,Cinel; Cameron Alexander,15,0,30,15
1656952591693,MATH 18,A03,083745,Cinel; Cameron Alexander,8,0,30,22
1656952591693,MATH 18,B01,083748,Rideout; David Porter,4,0,37,33
1656952591693,MATH 18,B02,083749,Rideout; David Porter,3,0,36,33
1656952591693,MATH 18,B03,083750,Rideout; David Porter,2,0,37,35
1656952591693,MATH 18,B04,083751,Rideout; David Porter,5,0,36,31
1656952591693,MATH 18,B05,093473,Rideout; David Porter,4,0,36,32
1656952591693,MATH 18,B06,093474,Rideout; David Porter,5,0,36,31
1656952597715,MATH 20A,A01,083754,Zheng; Zequn,12,0,40,28
1656952603740,MATH 20B,A01,083756,Briones; Jor-el Thomas Caparas,1,0,36,35
1656952603740,MATH 20B,A02,083757,Briones; Jor-el Thomas Caparas,1,0,36,35
1656952603740,MATH 20B,A03,093475,Briones; Jor-el Thomas Caparas,0,0,36,36
1656952609768,MATH 20C,A01,083760,Briones; Jor-el Thomas Caparas,1,0,35,34
1656952609768,MATH 20C,A02,083761,Briones; Jor-el Thomas Caparas,8,0,35,27
1656952609768,MATH 20C,A03,093476,Briones; Jor-el Thomas Caparas,0,1,36,36
1656952609768,MATH 20C,B01,083762,Bach; Quang Tran,0,0,30,30
1656952615795,MATH 20D,A01,083765,Tran; Brian Kha,4,0,30,26
1656952615795,MATH 20D,A02,083766,Tran; Brian Kha,4,0,30,26
1656952615795,MATH 20D,A03,083767,Tran; Brian Kha,3,0,30,27
1656952621819,MATH 20E,A01,083771,Ganguly; Soumya,5,0,32,27
1656952621819,MATH 20E,A02,083772,Ganguly; Soumya,6,0,32,26
1656952621819,MATH 20E,B01,083773,Ciotti; Benjamin,18,0,35,17
1656952621819,MATH 20E,B02,083774,Ciotti; Benjamin,17,0,35,18
1656952627840,MATH 103A,A01,083777,Greenfeld; Be'Eri,2,0,36,34
1656952627840,MATH 103A,A02,083778,Greenfeld; Be'Eri,5,0,36,31
1656952627840,MATH 103A,A03,093561,Greenfeld; Be'Eri,4,0,36,32
1656952627840,MATH 103A,B01,083779,Greenfeld; Be'Eri,6,0,36,30
1656952627840,MATH 103A,B02,083780,Greenfeld; Be'Eri,2,0,36,34
1656952627840,MATH 103A,B03,093562,Greenfeld; Be'Eri,2,0,36,34
1656952633867,MATH 105,A01,085443,Carter; Anne Toulson,13,0,35,22
1656952633867,MATH 105,A02,093477,Carter; Anne Toulson,20,0,35,15
1656952639895,MATH 109,A01,083213,Ganzberger; Geoffrey Michael,2,0,34,32
1656952639895,MATH 109,A02,083214,Ganzberger; Geoffrey Michael,2,0,34,32
1656952639895,MATH 109,A03,093478,Ganzberger; Geoffrey Michael,1,0,34,33
1656952639895,MATH 109,B01,083215,Ganzberger; Geoffrey Michael,1,0,32,31
1656952639895,MATH 109,B02,083216,Ganzberger; Geoffrey Michael,1,0,32,31
1656952639895,MATH 109,B03,093479,Ganzberger; Geoffrey Michael,6,0,32,26
1656952645924,MATH 142A,A01,083219,Chow; Bennett,6,0,32,26
1656952645924,MATH 142A,A02,083220,Chow; Bennett,10,0,32,22
1656952645924,MATH 142A,A03,093480,Chow; Bennett,7,0,32,25
1656952645924,MATH 142A,B03,093481,Chow; Bennett,7,0,32,25
1656952645924,MATH 142A,B04,093558,Chow; Bennett,11,0,32,21
1656952645924,MATH 142A,B05,093559,Chow; Bennett,6,0,32,26
1656952651949,MATH 193A,A01,083224,Rotar; Vladimir,7,0,34,27
1656952651949,MATH 193A,A02,083225,Rotar; Vladimir,4,0,34,30
1656952651949,MATH 193A,A03,083781,Rotar; Vladimir,1,0,34,33
1656952651949,MATH 193A,A04,083782,Rotar; Vladimir,6,0,34,28
1656952651949,MATH 193A,A05,093482,Rotar; Vladimir,6,0,34,28
1656952657972,MATH 197,001,091859,McAuley; Julian John,9999,0,9999,0
1656952657972,MATH 197,002,095566,Kedlaya; Kiran S.,9997,0,9999,2
1656952657972,MATH 197,003,095567,Xiao; Ming,9999,0,9999,0
1656952657972,MATH 197,004,095571,Perols; Johan Lars,9998,0,9999,1
1656952665030,COGS 9,A01,083615,Shannon; Kyle Michael,7,0,75,68
1656952671055,COGS 11,A01,083617,Boyle; Mary E. T.,19,0,48,29
1656952677080,COGS 13,A01,083071,Bastos; Amalia Pinkusfeld,9,0,71,62
1656952683102,COGS 14A,A01,092681,Semenuks; Arturs,0,1,100,100
1656952689125,COGS 14B,A01,083073,Cheng; Tzu-Han,5,0,63,58
1656952695151,COGS 17,A01,092677,Semenuks; Arturs,4,0,81,77
1656952701177,COGS 100,A01,083619,Allen; Michael Gordon,15,0,70,55
1656952707200,COGS 101A,A01,083621,Davis; Joshua Daniel,9,0,68,59
1656952713225,COGS 101B,A01,091572,Allen; Michael Gordon,8,0,65,57
1656952719247,COGS 101C,A01,083625,Delgado; Tania,17,0,35,18
1656952725275,COGS 107A,A01,083627,Boyle; Mary E. T.,13,0,60,47
1656952731304,COGS 118A,A01,083075,Gupta; Anjum,15,0,76,61
1656952737330,CSE 3,A50,083646,Miranda; Gregory Joseph,22,0,50,28
1656952743362,CSE 8A,A50,083650,Miranda; Gregory Joseph,17,1,56,39
1656952749385,CSE 11,A01,083080,Cao; Yingjun,4,15,40,36
1656952755408,CSE 12,A01,083652,Krause-Levy; Sophia Louisa,20,1,120,100
1656952761435,CSE 15L,A01,083654,Morris; Justin Loren,8,0,50,42
1656952761435,CSE 15L,A02,083655,Morris; Justin Loren,8,0,50,42
1656952767462,CSE 20,A01,083657,Tran; Khoa Dang,37,0,80,43
1656952773503,CSE 21,A01,095574,Bach; Quang Tran,21,0,48,27
1656952779528,CSE 30,A01,083084,Eldon; John,4,0,80,76
1656952779528,CSE 30,B01,095061,Bhaskar; Nishant,6,0,50,44
1656952785552,CSE 100,A01,083659,Cao; Yingjun,3,4,70,67
1656952791579,CSE 134B,A01,083661,Powell; Thomas Allan,19,0,100,81
1656952797606,CSE 140,A01,083663,Gungor; Onat,14,0,85,71
1656952803631,CSE 140L,A01,083088,Eldon; John,16,0,100,84
1656952809655,CSE 175,A01,083665,Kumar; Rakesh,3,0,25,22
1656952815679,CSE 190,A00,092507,Dubnov; Shlomo,7,0,20,13
1656952821704,ECE 45,A01,083139,Congero; Spencer William,5,0,75,70
1656952827727,ECE 65,A50,083695,Saad; Andrew S,12,0,30,18
1656952827727,ECE 65,A51,095125,Saad; Andrew S,25,0,26,1
1656952833751,ECE 109,A01,091882,Touri; Behrouz,16,0,70,54
1656952839779,ECE 180,A00,083140,Abi Samra; Nicholas Camill,0,0,30,30
1656952839779,ECE 180,B00,083141,Abi Samra; Nicholas Camill,0,0,30,30
1656952845802,MATH 10A,A01,083735,Patchell; Gregory David,1,0,30,29
1656952845802,MATH 10A,A02,083736,Patchell; Gregory David,20,0,30,10
1656952845802,MATH 10A,A03,083737,Patchell; Gregory David,15,0,30,15
1656952851825,MATH 10B,A01,083207,Lim; Seonhee,7,0,34,27
1656952851825,MATH 10B,A02,083208,Lim; Seonhee,9,0,35,26
1656952851825,MATH 10B,A03,093472,Lim; Seonhee,4,0,34,30
1656952851825,MATH 10B,B01,083739,Sinha; Shubham,9,0,30,21
1656952857851,MATH 18,A01,083743,Cinel; Cameron Alexander,6,0,30,24
1656952857851,MATH 18,A02,083744,Cinel; Cameron Alexander,15,0,30,15
1656952857851,MATH 18,A03,083745,Cinel; Cameron Alexander,8,0,30,22
1656952857851,MATH 18,B01,083748,Rideout; David Porter,4,0,37,33
1656952857851,MATH 18,B02,083749,Rideout; David Porter,3,0,36,33
1656952857851,MATH 18,B03,083750,Rideout; David Porter,2,0,37,35
1656952857851,MATH 18,B04,083751,Rideout; David Porter,5,0,36,31
1656952857851,MATH 18,B05,093473,Rideout; David Porter,4,0,36,32
1656952857851,MATH 18,B06,093474,Rideout; David Porter,5,0,36,31
1656952863964,MATH 20A,A01,083754,Zheng; Zequn,12,0,40,28
1656952869986,MATH 20B,A01,083756,Briones; Jor-el Thomas Caparas,1,0,36,35
1656952869986,MATH 20B,A02,083757,Briones; Jor-el Thomas Caparas,1,0,36,35
1656952869986,MATH 20B,A03,093475,Briones; Jor-el Thomas Caparas,0,0,36,36
1656952876011,MATH 20C,A01,083760,Briones; Jor-el Thomas Caparas,1,0,35,34
1656952876011,MATH 20C,A02,083761,Briones; Jor-el Thomas Caparas,8,0,35,27
1656952876011,MATH 20C,A03,093476,Briones; Jor-el Thomas Caparas,0,1,36,36
1656952876011,MATH 20C,B01,083762,Bach; Quang Tran,0,0,30,30
1656952882039,MATH 20D,A01,083765,Tran; Brian Kha,4,0,30,26
1656952882039,MATH 20D,A02,083766,Tran; Brian Kha,4,0,30,26
1656952882039,MATH 20D,A03,083767,Tran; Brian Kha,3,0,30,27
1656952888063,MATH 20E,A01,083771,Ganguly; Soumya,5,0,32,27
1656952888063,MATH 20E,A02,083772,Ganguly; Soumya,6,0,32,26
1656952888063,MATH 20E,B01,083773,Ciotti; Benjamin,18,0,35,17
1656952888063,MATH 20E,B02,083774,Ciotti; Benjamin,17,0,35,18
1656952894088,MATH 103A,A01,083777,Greenfeld; Be'Eri,2,0,36,34
1656952894088,MATH 103A,A02,083778,Greenfeld; Be'Eri,5,0,36,31
1656952894088,MATH 103A,A03,093561,Greenfeld; Be'Eri,4,0,36,32
1656952894088,MATH 103A,B01,083779,Greenfeld; Be'Eri,6,0,36,30
1656952894088,MATH 103A,B02,083780,Greenfeld; Be'Eri,2,0,36,34
1656952894088,MATH 103A,B03,093562,Greenfeld; Be'Eri,2,0,36,34
1656952900110,MATH 105,A01,085443,Carter; Anne Toulson,13,0,35,22
1656952900110,MATH 105,A02,093477,Carter; Anne Toulson,20,0,35,15
1656952906140,MATH 109,A01,083213,Ganzberger; Geoffrey Michael,2,0,34,32
1656952906140,MATH 109,A02,083214,Ganzberger; Geoffrey Michael,2,0,34,32
1656952906140,MATH 109,A03,093478,Ganzberger; Geoffrey Michael,1,0,34,33
1656952906140,MATH 109,B01,083215,Ganzberger; Geoffrey Michael,1,0,32,31
1656952906140,MATH 109,B02,083216,Ganzberger; Geoffrey Michael,1,0,32,31
1656952906140,MATH 109,B03,093479,Ganzberger; Geoffrey Michael,6,0,32,26
1656952912170,MATH 142A,A01,083219,Chow; Bennett,6,0,32,26
1656952912170,MATH 142A,A02,083220,Chow; Bennett,10,0,32,22
1656952912170,MATH 142A,A03,093480,Chow; Bennett,7,0,32,25
1656952912170,MATH 142A,B03,093481,Chow; Bennett,7,0,32,25
1656952912170,MATH 142A,B04,093558,Chow; Bennett,11,0,32,21
1656952912170,MATH 142A,B05,093559,Chow; Bennett,6,0,32,26
1656952918194,MATH 193A,A01,083224,Rotar; Vladimir,7,0,34,27
1656952918194,MATH 193A,A02,083225,Rotar; Vladimir,4,0,34,30
1656952918194,MATH 193A,A03,083781,Rotar; Vladimir,1,0,34,33
1656952918194,MATH 193A,A04,083782,Rotar; Vladimir,6,0,34,28
1656952918194,MATH 193A,A05,093482,Rotar; Vladimir,6,0,34,28
1656952924218,MATH 197,001,091859,McAuley; Julian John,9999,0,9999,0
1656952924218,MATH 197,002,095566,Kedlaya; Kiran S.,9997,0,9999,2
1656952924218,MATH 197,003,095567,Xiao; Ming,9999,0,9999,0
1656952924218,MATH 197,004,095571,Perols; Johan Lars,9998,0,9999,1
1656952931274,COGS 9,A01,083615,Shannon; Kyle Michael,7,0,75,68
1656952937300,COGS 11,A01,083617,Boyle; Mary E. T.,19,0,48,29
1656952943323,COGS 13,A01,083071,Bastos; Amalia Pinkusfeld,9,0,71,62
1656952949346,COGS 14A,A01,092681,Semenuks; Arturs,0,1,100,100
1656952955370,COGS 14B,A01,083073,Cheng; Tzu-Han,5,0,63,58
1656952961393,COGS 17,A01,092677,Semenuks; Arturs,4,0,81,77
1656952967420,COGS 100,A01,083619,Allen; Michael Gordon,15,0,70,55
1656952973445,COGS 101A,A01,083621,Davis; Joshua Daniel,9,0,68,59
1656952979469,COGS 101B,A01,091572,Allen; Michael Gordon,8,0,65,57
1656952985491,COGS 101C,A01,083625,Delgado; Tania,17,0,35,18
1656952991519,COGS 107A,A01,083627,Boyle; Mary E. T.,13,0,60,47
1656952997542,COGS 118A,A01,083075,Gupta; Anjum,15,0,76,61
1656953003566,CSE 3,A50,083646,Miranda; Gregory Joseph,22,0,50,28
1656953009593,CSE 8A,A50,083650,Miranda; Gregory Joseph,17,1,56,39
1656953015621,CSE 11,A01,083080,Cao; Yingjun,4,15,40,36
1656953021648,CSE 12,A01,083652,Krause-Levy; Sophia Louisa,20,1,120,100
1656953027676,CSE 15L,A01,083654,Morris; Justin Loren,8,0,50,42
1656953027676,CSE 15L,A02,083655,Morris; Justin Loren,8,0,50,42
1656953033703,CSE 20,A01,083657,Tran; Khoa Dang,37,0,80,43
1656953039748,CSE 21,A01,095574,Bach; Quang Tran,21,0,48,27
1656953045772,CSE 30,A01,083084,Eldon; John,4,0,80,76
1656953045772,CSE 30,B01,095061,Bhaskar; Nishant,6,0,50,44
1656953051802,CSE 100,A01,083659,Cao; Yingjun,3,4,70,67
1656953057825,CSE 134B,A01,083661,Powell; Thomas Allan,19,0,100,81
1656953063858,CSE 140,A01,083663,Gungor; Onat,14,0,85,71
1656953069899,CSE 140L,A01,083088,Eldon; John,16,0,100,84
1656953075923,CSE 175,A01,083665,Kumar; Rakesh,3,0,25,22
1656953081946,CSE 190,A00,092507,Dubnov; Shlomo,7,0,20,13
1656953087975,ECE 45,A01,083139,Congero; Spencer William,5,0,75,70
1656953094001,ECE 65,A50,083695,Saad; Andrew S,12,0,30,18
1656953094001,ECE 65,A51,095125,Saad; Andrew S,25,0,26,1
1656953100024,ECE 109,A01,091882,Touri; Behrouz,16,0,70,54
1656953106047,ECE 180,A00,083140,Abi Samra; Nicholas Camill,0,0,30,30
1656953106047,ECE 180,B00,083141,Abi Samra; Nicholas Camill,0,0,30,30
1656953112072,MATH 10A,A01,083735,Patchell; Gregory David,1,0,30,29
1656953112072,MATH 10A,A02,083736,Patchell; Gregory David,20,0,30,10
1656953112072,MATH 10A,A03,083737,Patchell; Gregory David,15,0,30,15
1656953118095,MATH 10B,A01,083207,Lim; Seonhee,7,0,34,27
1656953118095,MATH 10B,A02,083208,Lim; Seonhee,9,0,35,26
1656953118095,MATH 10B,A03,093472,Lim; Seonhee,4,0,34,30
1656953118095,MATH 10B,B01,083739,Sinha; Shubham,9,0,30,21
1656953124128,MATH 18,A01,083743,Cinel; Cameron Alexander,6,0,30,24
1656953124128,MATH 18,A02,083744,Cinel; Cameron Alexander,15,0,30,15
1656953124128,MATH 18,A03,083745,Cinel; Cameron Alexander,8,0,30,22
1656953124128,MATH 18,B01,083748,Rideout; David Porter,4,0,37,33
1656953124128,MATH 18,B02,083749,Rideout; David Porter,3,0,36,33
1656953124128,MATH 18,B03,083750,Rideout; David Porter,2,0,37,35
1656953124128,MATH 18,B04,083751,Rideout; David Porter,5,0,36,31
1656953124128,MATH 18,B05,093473,Rideout; David Porter,4,0,36,32
1656953124128,MATH 18,B06,093474,Rideout; David Porter,5,0,36,31
1656953130153,MATH 20A,A01,083754,Zheng; Zequn,12,0,40,28
1656953136176,MATH 20B,A01,083756,Briones; Jor-el Thomas Caparas,1,0,36,35
1656953136176,MATH 20B,A02,083757,Briones; Jor-el Thomas Caparas,1,0,36,35
1656953136176,MATH 20B,A03,093475,Briones; Jor-el Thomas Caparas,0,0,36,36
1656953142201,MATH 20C,A01,083760,Briones; Jor-el Thomas Caparas,1,0,35,34
1656953142201,MATH 20C,A02,083761,Briones; Jor-el Thomas Caparas,8,0,35,27
1656953142201,MATH 20C,A03,093476,Briones; Jor-el Thomas Caparas,0,1,36,36
1656953142201,MATH 20C,B01,083762,Bach; Quang Tran,0,0,30,30
1656953148225,MATH 20D,A01,083765,Tran; Brian Kha,4,0,30,26
1656953148225,MATH 20D,A02,083766,Tran; Brian Kha,4,0,30,26
1656953148225,MATH 20D,A03,083767,Tran; Brian Kha,3,0,30,27
1656953154246,MATH 20E,A01,083771,Ganguly; Soumya,5,0,32,27
1656953154246,MATH 20E,A02,083772,Ganguly; Soumya,6,0,32,26
1656953154246,MATH 20E,B01,083773,Ciotti; Benjamin,18,0,35,17
1656953154246,MATH 20E,B02,083774,Ciotti; Benjamin,17,0,35,18
1656953160276,MATH 103A,A01,083777,Greenfeld; Be'Eri,2,0,36,34
1656953160276,MATH 103A,A02,083778,Greenfeld; Be'Eri,5,0,36,31
1656953160276,MATH 103A,A03,093561,Greenfeld; Be'Eri,4,0,36,32
1656953160276,MATH 103A,B01,083779,Greenfeld; Be'Eri,6,0,36,30
1656953160276,MATH 103A,B02,083780,Greenfeld; Be'Eri,2,0,36,34
1656953160276,MATH 103A,B03,093562,Greenfeld; Be'Eri,2,0,36,34
1656953166298,MATH 105,A01,085443,Carter; Anne Toulson,13,0,35,22
1656953166298,MATH 105,A02,093477,Carter; Anne Toulson,20,0,35,15
1656953172323,MATH 109,A01,083213,Ganzberger; Geoffrey Michael,2,0,34,32
1656953172323,MATH 109,A02,083214,Ganzberger; Geoffrey Michael,2,0,34,32
1656953172323,MATH 109,A03,093478,Ganzberger; Geoffrey Michael,1,0,34,33
1656953172323,MATH 109,B01,083215,Ganzberger; Geoffrey Michael,1,0,32,31
1656953172323,MATH 109,B02,083216,Ganzberger; Geoffrey Michael,1,0,32,31
1656953172323,MATH 109,B03,093479,Ganzberger; Geoffrey Michael,6,0,32,26
1656953178347,MATH 142A,A01,083219,Chow; Bennett,6,0,32,26
1656953178347,MATH 142A,A02,083220,Chow; Bennett,10,0,32,22
1656953178347,MATH 142A,A03,093480,Chow; Bennett,7,0,32,25
1656953178347,MATH 142A,B03,093481,Chow; Bennett,7,0,32,25
1656953178347,MATH 142A,B04,093558,Chow; Bennett,11,0,32,21
1656953178347,MATH 142A,B05,093559,Chow; Bennett,6,0,32,26
1656953184372,MATH 193A,A01,083224,Rotar; Vladimir,7,0,34,27
1656953184372,MATH 193A,A02,083225,Rotar; Vladimir,4,0,34,30
1656953184372,MATH 193A,A03,083781,Rotar; Vladimir,1,0,34,33
1656953184372,MATH 193A,A04,083782,Rotar; Vladimir,6,0,34,28
1656953184372,MATH 193A,A05,093482,Rotar; Vladimir,6,0,34,28
1656953190399,MATH 197,001,091859,McAuley; Julian John,9999,0,9999,0
1656953190399,MATH 197,002,095566,Kedlaya; Kiran S.,9997,0,9999,2
1656953190399,MATH 197,003,095567,Xiao; Ming,9999,0,9999,0
1656953190399,MATH 197,004,095571,Perols; Johan Lars,9998,0,9999,1
1656953197450,COGS 9,A01,083615,Shannon; Kyle Michael,7,0,75,68
1656953203478,COGS 11,A01,083617,Boyle; Mary E. T.,19,0,48,29
1656953209502,COGS 13,A01,083071,Bastos; Amalia Pinkusfeld,9,0,71,62
1656953215526,COGS 14A,A01,092681,Semenuks; Arturs,0,1,100,100
1656953221550,COGS 14B,A01,083073,Cheng; Tzu-Han,5,0,63,58
1656953227577,COGS 17,A01,092677,Semenuks; Arturs,4,0,81,77
1656953233604,COGS 100,A01,083619,Allen; Michael Gordon,15,0,70,55
1656953239627,COGS 101A,A01,083621,Davis; Joshua Daniel,9,0,68,59
1656953245655,COGS 101B,A01,091572,Allen; Michael Gordon,8,0,65,57
1656953251682,COGS 101C,A01,083625,Delgado; Tania,17,0,35,18
1656953257709,COGS 107A,A01,083627,Boyle; Mary E. T.,13,0,60,47
1656953263731,COGS 118A,A01,083075,Gupta; Anjum,15,0,76,61
1656953269753,CSE 3,A50,083646,Miranda; Gregory Joseph,22,0,50,28
1656953275788,CSE 8A,A50,083650,Miranda; Gregory Joseph,17,1,56,39
1656953281812,CSE 11,A01,083080,Cao; Yingjun,4,15,40,36
1656953287845,CSE 12,A01,083652,Krause-Levy; Sophia Louisa,20,1,120,100
1656953293869,CSE 15L,A01,083654,Morris; Justin Loren,8,0,50,42
1656953293869,CSE 15L,A02,083655,Morris; Justin Loren,8,0,50,42
1656953299895,CSE 20,A01,083657,Tran; Khoa Dang,37,0,80,43
1656953305919,CSE 21,A01,095574,Bach; Quang Tran,21,0,48,27
1656953311946,CSE 30,A01,083084,Eldon; John,4,0,80,76
1656953311946,CSE 30,B01,095061,Bhaskar; Nishant,6,0,50,44
1656953317969,CSE 100,A01,083659,Cao; Yingjun,3,4,70,67
1656953323992,CSE 134B,A01,083661,Powell; Thomas Allan,19,0,100,81
1656953330018,CSE 140,A01,083663,Gungor; Onat,14,0,85,71
1656953336041,CSE 140L,A01,083088,Eldon; John,16,0,100,84
1656953342067,CSE 175,A01,083665,Kumar; Rakesh,3,0,25,22
1656953348093,CSE 190,A00,092507,Dubnov; Shlomo,7,0,20,13
1656953354120,ECE 45,A01,083139,Congero; Spencer William,5,0,75,70
1656953360143,ECE 65,A50,083695,Saad; Andrew S,12,0,30,18
1656953360143,ECE 65,A51,095125,Saad; Andrew S,25,0,26,1
1656953366170,ECE 109,A01,091882,Touri; Behrouz,16,0,70,54
1656953372196,ECE 180,A00,083140,Abi Samra; Nicholas Camill,0,0,30,30
1656953372196,ECE 180,B00,083141,Abi Samra; Nicholas Camill,0,0,30,30
1656953378219,MATH 10A,A01,083735,Patchell; Gregory David,1,0,30,29
1656953378219,MATH 10A,A02,083736,Patchell; Gregory David,20,0,30,10
1656953378219,MATH 10A,A03,083737,Patchell; Gregory David,15,0,30,15
1656953384243,MATH 10B,A01,083207,Lim; Seonhee,7,0,34,27
1656953384243,MATH 10B,A02,083208,Lim; Seonhee,9,0,35,26
1656953384243,MATH 10B,A03,093472,Lim; Seonhee,4,0,34,30
1656953384243,MATH 10B,B01,083739,Sinha; Shubham,9,0,30,21
1656953390268,MATH 18,A01,083743,Cinel; Cameron Alexander,6,0,30,24
1656953390268,MATH 18,A02,083744,Cinel; Cameron Alexander,15,0,30,15
1656953390268,MATH 18,A03,083745,Cinel; Cameron Alexander,8,0,30,22
1656953390268,MATH 18,B01,083748,Rideout; David Porter,4,0,37,33
1656953390268,MATH 18,B02,083749,Rideout; David Porter,3,0,36,33
1656953390268,MATH 18,B03,083750,Rideout; David Porter,2,0,37,35
1656953390268,MATH 18,B04,083751,Rideout; David Porter,5,0,36,31
1656953390268,MATH 18,B05,093473,Rideout; David Porter,4,0,36,32
1656953390268,MATH 18,B06,093474,Rideout; David Porter,5,0,36,31
1656953396291,MATH 20A,A01,083754,Zheng; Zequn,12,0,40,28
1656953402318,MATH 20B,A01,083756,Briones; Jor-el Thomas Caparas,1,0,36,35
1656953402318,MATH 20B,A02,083757,Briones; Jor-el Thomas Caparas,1,0,36,35
1656953402318,MATH 20B,A03,093475,Briones; Jor-el Thomas Caparas,0,0,36,36
1656953408340,MATH 20C,A01,083760,Briones; Jor-el Thomas Caparas,1,0,35,34
1656953408340,MATH 20C,A02,083761,Briones; Jor-el Thomas Caparas,8,0,35,27
1656953408340,MATH 20C,A03,093476,Briones; Jor-el Thomas Caparas,0,1,36,36
1656953408340,MATH 20C,B01,083762,Bach; Quang Tran,0,0,30,30
1656953414372,MATH 20D,A01,083765,Tran; Brian Kha,4,0,30,26
1656953414372,MATH 20D,A02,083766,Tran; Brian Kha,4,0,30,26
1656953414372,MATH 20D,A03,083767,Tran; Brian Kha,3,0,30,27
1656953420400,MATH 20E,A01,083771,Ganguly; Soumya,5,0,32,27
1656953420400,MATH 20E,A02,083772,Ganguly; Soumya,6,0,32,26
1656953420400,MATH 20E,B01,083773,Ciotti; Benjamin,18,0,35,17
1656953420400,MATH 20E,B02,083774,Ciotti; Benjamin,17,0,35,18
1656953426423,MATH 103A,A01,083777,Greenfeld; Be'Eri,2,0,36,34
1656953426423,MATH 103A,A02,083778,Greenfeld; Be'Eri,5,0,36,31
1656953426423,MATH 103A,A03,093561,Greenfeld; Be'Eri,4,0,36,32
1656953426423,MATH 103A,B01,083779,Greenfeld; Be'Eri,6,0,36,30
1656953426423,MATH 103A,B02,083780,Greenfeld; Be'Eri,2,0,36,34
1656953426423,MATH 103A,B03,093562,Greenfeld; Be'Eri,2,0,36,34
1656953432448,MATH 105,A01,085443,Carter; Anne Toulson,14,0,35,21
1656953432448,MATH 105,A02,093477,Carter; Anne Toulson,20,0,35,15
1656953438477,MATH 109,A01,083213,Ganzberger; Geoffrey Michael,2,0,34,32
1656953438477,MATH 109,A02,083214,Ganzberger; Geoffrey Michael,2,0,34,32
1656953438477,MATH 109,A03,093478,Ganzberger; Geoffrey Michael,1,0,34,33
1656953438477,MATH 109,B01,083215,Ganzberger; Geoffrey Michael,1,0,32,31
1656953438477,MATH 109,B02,083216,Ganzberger; Geoffrey Michael,1,0,32,31
1656953438477,MATH 109,B03,093479,Ganzberger; Geoffrey Michael,6,0,32,26
1656953444513,MATH 142A,A01,083219,Chow; Bennett,6,0,32,26
1656953444513,MATH 142A,A02,083220,Chow; Bennett,10,0,32,22
1656953444513,MATH 142A,A03,093480,Chow; Bennett,7,0,32,25
1656953444513,MATH 142A,B03,093481,Chow; Bennett,7,0,32,25
1656953444513,MATH 142A,B04,093558,Chow; Bennett,11,0,32,21
1656953444513,MATH 142A,B05,093559,Chow; Bennett,6,0,32,26
1656953450543,MATH 193A,A01,083224,Rotar; Vladimir,7,0,34,27
1656953450543,MATH 193A,A02,083225,Rotar; Vladimir,4,0,34,30
1656953450543,MATH 193A,A03,083781,Rotar; Vladimir,1,0,34,33
1656953450543,MATH 193A,A04,083782,Rotar; Vladimir,6,0,34,28
1656953450543,MATH 193A,A05,093482,Rotar; Vladimir,6,0,34,28
1656953456570,MATH 197,001,091859,McAuley; Julian John,9999,0,9999,0
1656953456570,MATH 197,002,095566,Kedlaya; Kiran S.,9997,0,9999,2
1656953456570,MATH 197,003,095567,Xiao; Ming,9999,0,9999,0
1656953456570,MATH 197,004,095571,Perols; Johan Lars,9998,0,9999,1
1656953463712,COGS 9,A01,083615,Shannon; Kyle Michael,7,0,75,68
1656953469735,COGS 11,A01,083617,Boyle; Mary E. T.,19,0,48,29
1656953475759,COGS 13,A01,083071,Bastos; Amalia Pinkusfeld,9,0,71,62
1656953481783,COGS 14A,A01,092681,Semenuks; Arturs,0,1,100,100
1656953487806,COGS 14B,A01,083073,Cheng; Tzu-Han,5,0,63,58
1656953493829,COGS 17,A01,092677,Semenuks; Arturs,4,0,81,77
1656953499853,COGS 100,A01,083619,Allen; Michael Gordon,15,0,70,55
1656953505881,COGS 101A,A01,083621,Davis; Joshua Daniel,9,0,68,59
1656953511918,COGS 101B,A01,091572,Allen; Michael Gordon,8,0,65,57
1656953517941,COGS 101C,A01,083625,Delgado; Tania,17,0,35,18
1656953523969,COGS 107A,A01,083627,Boyle; Mary E. T.,13,0,60,47
1656953529997,COGS 118A,A01,083075,Gupta; Anjum,15,0,76,61
1656953536031,CSE 3,A50,083646,Miranda; Gregory Joseph,22,0,50,28
1656953542059,CSE 8A,A50,083650,Miranda; Gregory Joseph,17,1,56,39
1656953548084,CSE 11,A01,083080,Cao; Yingjun,4,15,40,36
1656953554107,CSE 12,A01,083652,Krause-Levy; Sophia Louisa,20,1,120,100
1656953560131,CSE 15L,A01,083654,Morris; Justin Loren,8,0,50,42
1656953560131,CSE 15L,A02,083655,Morris; Justin Loren,8,0,50,42
1656953566155,CSE 20,A01,083657,Tran; Khoa Dang,37,0,80,43
1656953572180,CSE 21,A01,095574,Bach; Quang Tran,21,0,48,27
1656953578204,CSE 30,A01,083084,Eldon; John,4,0,80,76
1656953578204,CSE 30,B01,095061,Bhaskar; Nishant,6,0,50,44
1656953584228,CSE 100,A01,083659,Cao; Yingjun,3,4,70,67
1656953590255,CSE 134B,A01,083661,Powell; Thomas Allan,19,0,100,81
1656953596276,CSE 140,A01,083663,Gungor; Onat,14,0,85,71
1656953602299,CSE 140L,A01,083088,Eldon; John,16,0,100,84
1656953608330,CSE 175,A01,083665,Kumar; Rakesh,3,0,25,22
1656953614353,CSE 190,A00,092507,Dubnov; Shlomo,7,0,20,13
1656953620377,ECE 45,A01,083139,Congero; Spencer William,5,0,75,70
1656953626407,ECE 65,A50,083695,Saad; Andrew S,12,0,30,18
1656953626407,ECE 65,A51,095125,Saad; Andrew S,25,0,26,1
1656953632437,ECE 109,A01,091882,Touri; Behrouz,16,0,70,54
1656953638462,ECE 180,A00,083140,Abi Samra; Nicholas Camill,0,0,30,30
1656953638462,ECE 180,B00,083141,Abi Samra; Nicholas Camill,0,0,30,30
1656953644487,MATH 10A,A01,083735,Patchell; Gregory David,1,0,30,29
1656953644487,MATH 10A,A02,083736,Patchell; Gregory David,20,0,30,10
1656953644487,MATH 10A,A03,083737,Patchell; Gregory David,15,0,30,15
1656953650516,MATH 10B,A01,083207,Lim; Seonhee,7,0,34,27
1656953650516,MATH 10B,A02,083208,Lim; Seonhee,9,0,35,26
1656953650516,MATH 10B,A03,093472,Lim; Seonhee,4,0,34,30
1656953650516,MATH 10B,B01,083739,Sinha; Shubham,9,0,30,21
1656953656541,MATH 18,A01,083743,Cinel; Cameron Alexander,6,0,30,24
1656953656541,MATH 18,A02,083744,Cinel; Cameron Alexander,15,0,30,15
1656953656541,MATH 18,A03,083745,Cinel; Cameron Alexander,8,0,30,22
1656953656541,MATH 18,B01,083748,Rideout; David Porter,4,0,37,33
1656953656541,MATH 18,B02,083749,Rideout; David Porter,3,0,36,33
1656953656541,MATH 18,B03,083750,Rideout; David Porter,2,0,37,35
1656953656541,MATH 18,B04,083751,Rideout; David Porter,5,0,36,31
1656953656541,MATH 18,B05,093473,Rideout; David Porter,4,0,36,32
1656953656541,MATH 18,B06,093474,Rideout; David Porter,5,0,36,31
1656953662569,MATH 20A,A01,083754,Zheng; Zequn,12,0,40,28
1656953668592,MATH 20B,A01,083756,Briones; Jor-el Thomas Caparas,1,0,36,35
1656953668592,MATH 20B,A02,083757,Briones; Jor-el Thomas Caparas,1,0,36,35
1656953668592,MATH 20B,A03,093475,Briones; Jor-el Thomas Caparas,0,0,36,36
1656953674621,MATH 20C,A01,083760,Briones; Jor-el Thomas Caparas,1,0,35,34
1656953674621,MATH 20C,A02,083761,Briones; Jor-el Thomas Caparas,8,0,35,27
1656953674621,MATH 20C,A03,093476,Briones; Jor-el Thomas Caparas,0,1,36,36
1656953674621,MATH 20C,B01,083762,Bach; Quang Tran,0,0,30,30
1656953680643,MATH 20D,A01,083765,Tran; Brian Kha,4,0,30,26
1656953680643,MATH 20D,A02,083766,Tran; Brian Kha,4,0,30,26
1656953680643,MATH 20D,A03,083767,Tran; Brian Kha,3,0,30,27
1656953686669,MATH 20E,A01,083771,Ganguly; Soumya,5,0,32,27
1656953686669,MATH 20E,A02,083772,Ganguly; Soumya,6,0,32,26
1656953686669,MATH 20E,B01,083773,Ciotti; Benjamin,18,0,35,17
1656953686669,MATH 20E,B02,083774,Ciotti; Benjamin,17,0,35,18
1656953692692,MATH 103A,A01,083777,Greenfeld; Be'Eri,2,0,36,34
1656953692692,MATH 103A,A02,083778,Greenfeld; Be'Eri,5,0,36,31
1656953692692,MATH 103A,A03,093561,Greenfeld; Be'Eri,4,0,36,32
1656953692692,MATH 103A,B01,083779,Greenfeld; Be'Eri,6,0,36,30
1656953692692,MATH 103A,B02,083780,Greenfeld; Be'Eri,2,0,36,34
1656953692692,MATH 103A,B03,093562,Greenfeld; Be'Eri,2,0,36,34
1656953698717,MATH 105,A01,085443,Carter; Anne Toulson,14,0,35,21
1656953698717,MATH 105,A02,093477,Carter; Anne Toulson,20,0,35,15
1656953704741,MATH 109,A01,083213,Ganzberger; Geoffrey Michael,2,0,34,32
1656953704741,MATH 109,A02,083214,Ganzberger; Geoffrey Michael,2,0,34,32
1656953704741,MATH 109,A03,093478,Ganzberger; Geoffrey Michael,1,0,34,33
1656953704741,MATH 109,B01,083215,Ganzberger; Geoffrey Michael,1,0,32,31
1656953704741,MATH 109,B02,083216,Ganzberger; Geoffrey Michael,1,0,32,31
1656953704741,MATH 109,B03,093479,Ganzberger; Geoffrey Michael,6,0,32,26
1656953710770,MATH 142A,A01,083219,Chow; Bennett,6,0,32,26
1656953710770,MATH 142A,A02,083220,Chow; Bennett,10,0,32,22
1656953710770,MATH 142A,A03,093480,Chow; Bennett,7,0,32,25
1656953710770,MATH 142A,B03,093481,Chow; Bennett,7,0,32,25
1656953710770,MATH 142A,B04,093558,Chow; Bennett,11,0,32,21
1656953710770,MATH 142A,B05,093559,Chow; Bennett,6,0,32,26
1656953716794,MATH 193A,A01,083224,Rotar; Vladimir,7,0,34,27
1656953716794,MATH 193A,A02,083225,Rotar; Vladimir,4,0,34,30
1656953716794,MATH 193A,A03,083781,Rotar; Vladimir,1,0,34,33
1656953716794,MATH 193A,A04,083782,Rotar; Vladimir,6,0,34,28
1656953716794,MATH 193A,A05,093482,Rotar; Vladimir,6,0,34,28
1656953722817,MATH 197,001,091859,McAuley; Julian John,9999,0,9999,0
1656953722817,MATH 197,002,095566,Kedlaya; Kiran S.,9997,0,9999,2
1656953722817,MATH 197,003,095567,Xiao; Ming,9999,0,9999,0
1656953722817,MATH 197,004,095571,Perols; Johan Lars,9998,0,9999,1
1656953729882,COGS 9,A01,083615,Shannon; Kyle Michael,7,0,75,68
1656953735905,COGS 11,A01,083617,Boyle; Mary E. T.,19,0,48,29
1656953741933,COGS 13,A01,083071,Bastos; Amalia Pinkusfeld,9,0,71,62
1656953747956,COGS 14A,A01,092681,Semenuks; Arturs,0,1,100,100
1656953753979,COGS 14B,A01,083073,Cheng; Tzu-Han,5,0,63,58
1656953760007,COGS 17,A01,092677,Semenuks; Arturs,4,0,81,77
1656953766029,COGS 100,A01,083619,Allen; Michael Gordon,15,0,70,55
1656953772051,COGS 101A,A01,083621,Davis; Joshua Daniel,9,0,68,59
1656953778073,COGS 101B,A01,091572,Allen; Michael Gordon,8,0,65,57
1656953784100,COGS 101C,A01,083625,Delgado; Tania,17,0,35,18
1656953790123,COGS 107A,A01,083627,Boyle; Mary E. T.,13,0,60,47
1656953796148,COGS 118A,A01,083075,Gupta; Anjum,15,0,76,61
1656953802176,CSE 3,A50,083646,Miranda; Gregory Joseph,22,0,50,28
1656953808204,CSE 8A,A50,083650,Miranda; Gregory Joseph,17,1,56,39
1656953814231,CSE 11,A01,083080,Cao; Yingjun,4,15,40,36
1656953820258,CSE 12,A01,083652,Krause-Levy; Sophia Louisa,20,1,120,100
1656953826285,CSE 15L,A01,083654,Morris; Justin Loren,8,0,50,42
1656953826285,CSE 15L,A02,083655,Morris; Justin Loren,8,0,50,42
1656953832312,CSE 20,A01,083657,Tran; Khoa Dang,37,0,80,43
1656953838341,CSE 21,A01,095574,Bach; Quang Tran,21,0,48,27
1656953844370,CSE 30,A01,083084,Eldon; John,4,0,80,76
1656953844370,CSE 30,B01,095061,Bhaskar; Nishant,6,0,50,44
1656953850398,CSE 100,A01,083659,Cao; Yingjun,3,4,70,67
1656953856421,CSE 134B,A01,083661,Powell; Thomas Allan,19,0,100,81
1656953862444,CSE 140,A01,083663,Gungor; Onat,14,0,85,71
1656953868471,CSE 140L,A01,083088,Eldon; John,16,0,100,84
1656953874495,CSE 175,A01,083665,Kumar; Rakesh,3,0,25,22
1656953880520,CSE 190,A00,092507,Dubnov; Shlomo,7,0,20,13
1656953886542,ECE 45,A01,083139,Congero; Spencer William,5,0,75,70
1656953892572,ECE 65,A50,083695,Saad; Andrew S,12,0,30,18
1656953892572,ECE 65,A51,095125,Saad; Andrew S,25,0,26,1
1656953898603,ECE 109,A01,091882,Touri; Behrouz,16,0,70,54
1656953904631,ECE 180,A00,083140,Abi Samra; Nicholas Camill,0,0,30,30
1656953904631,ECE 180,B00,083141,Abi Samra; Nicholas Camill,0,0,30,30
1656953910656,MATH 10A,A01,083735,Patchell; Gregory David,1,0,30,29
1656953910656,MATH 10A,A02,083736,Patchell; Gregory David,20,0,30,10
1656953910656,MATH 10A,A03,083737,Patchell; Gregory David,15,0,30,15
1656953916680,MATH 10B,A01,083207,Lim; Seonhee,7,0,34,27
1656953916680,MATH 10B,A02,083208,Lim; Seonhee,9,0,35,26
1656953916680,MATH 10B,A03,093472,Lim; Seonhee,4,0,34,30
1656953916680,MATH 10B,B01,083739,Sinha; Shubham,9,0,30,21
1656953922706,MATH 18,A01,083743,Cinel; Cameron Alexander,6,0,30,24
1656953922706,MATH 18,A02,083744,Cinel; Cameron Alexander,15,0,30,15
1656953922706,MATH 18,A03,083745,Cinel; Cameron Alexander,8,0,30,22
1656953922706,MATH 18,B01,083748,Rideout; David Porter,4,0,37,33
1656953922706,MATH 18,B02,083749,Rideout; David Porter,3,0,36,33
1656953922706,MATH 18,B03,083750,Rideout; David Porter,2,0,37,35
1656953922706,MATH 18,B04,083751,Rideout; David Porter,5,0,36,31
1656953922706,MATH 18,B05,093473,Rideout; David Porter,4,0,36,32
1656953922706,MATH 18,B06,093474,Rideout; David Porter,5,0,36,31
1656953928733,MATH 20A,A01,083754,Zheng; Zequn,12,0,40,28
1656953934757,MATH 20B,A01,083756,Briones; Jor-el Thomas Caparas,1,0,36,35
1656953934757,MATH 20B,A02,083757,Briones; Jor-el Thomas Caparas,1,0,36,35
1656953934757,MATH 20B,A03,093475,Briones; Jor-el Thomas Caparas,0,0,36,36
1656953940785,MATH 20C,A01,083760,Briones; Jor-el Thomas Caparas,1,0,35,34
1656953940785,MATH 20C,A02,083761,Briones; Jor-el Thomas Caparas,8,0,35,27
1656953940785,MATH 20C,A03,093476,Briones; Jor-el Thomas Caparas,0,1,36,36
1656953940785,MATH 20C,B01,083762,Bach; Quang Tran,0,0,30,30
1656953946816,MATH 20D,A01,083765,Tran; Brian Kha,4,0,30,26
1656953946816,MATH 20D,A02,083766,Tran; Brian Kha,4,0,30,26
1656953946816,MATH 20D,A03,083767,Tran; Brian Kha,3,0,30,27
1656953952840,MATH 20E,A01,083771,Ganguly; Soumya,5,0,32,27
1656953952840,MATH 20E,A02,083772,Ganguly; Soumya,6,0,32,26
1656953952840,MATH 20E,B01,083773,Ciotti; Benjamin,18,0,35,17
1656953952840,MATH 20E,B02,083774,Ciotti; Benjamin,17,0,35,18
1656953958865,MATH 103A,A01,083777,Greenfeld; Be'Eri,2,0,36,34
1656953958865,MATH 103A,A02,083778,Greenfeld; Be'Eri,5,0,36,31
1656953958865,MATH 103A,A03,093561,Greenfeld; Be'Eri,4,0,36,32
1656953958865,MATH 103A,B01,083779,Greenfeld; Be'Eri,6,0,36,30
1656953958865,MATH 103A,B02,083780,Greenfeld; Be'Eri,2,0,36,34
1656953958865,MATH 103A,B03,093562,Greenfeld; Be'Eri,2,0,36,34
1656953964889,MATH 105,A01,085443,Carter; Anne Toulson,14,0,35,21
1656953964889,MATH 105,A02,093477,Carter; Anne Toulson,20,0,35,15
1656953970914,MATH 109,A01,083213,Ganzberger; Geoffrey Michael,2,0,34,32
1656953970914,MATH 109,A02,083214,Ganzberger; Geoffrey Michael,2,0,34,32
1656953970914,MATH 109,A03,093478,Ganzberger; Geoffrey Michael,1,0,34,33
1656953970914,MATH 109,B01,083215,Ganzberger; Geoffrey Michael,1,0,32,31
1656953970914,MATH 109,B02,083216,Ganzberger; Geoffrey Michael,1,0,32,31
1656953970914,MATH 109,B03,093479,Ganzberger; Geoffrey Michael,6,0,32,26
1656953976950,MATH 142A,A01,083219,Chow; Bennett,6,0,32,26
1656953976950,MATH 142A,A02,083220,Chow; Bennett,10,0,32,22
1656953976950,MATH 142A,A03,093480,Chow; Bennett,7,0,32,25
1656953976950,MATH 142A,B03,093481,Chow; Bennett,7,0,32,25
1656953976950,MATH 142A,B04,093558,Chow; Bennett,11,0,32,21
1656953976950,MATH 142A,B05,093559,Chow; Bennett,6,0,32,26
1656953982974,MATH 193A,A01,083224,Rotar; Vladimir,7,0,34,27
1656953982974,MATH 193A,A02,083225,Rotar; Vladimir,4,0,34,30
1656953982974,MATH 193A,A03,083781,Rotar; Vladimir,1,0,34,33
1656953982974,MATH 193A,A04,083782,Rotar; Vladimir,6,0,34,28
1656953982974,MATH 193A,A05,093482,Rotar; Vladimir,6,0,34,28
1656953988997,MATH 197,001,091859,McAuley; Julian John,9999,0,9999,0
1656953988997,MATH 197,002,095566,Kedlaya; Kiran S.,9997,0,9999,2
1656953988997,MATH 197,003,095567,Xiao; Ming,9999,0,9999,0
1656953988997,MATH 197,004,095571,Perols; Johan Lars,9998,0,9999,1
1656953996058,COGS 9,A01,083615,Shannon; Kyle Michael,7,0,75,68
1656954002083,COGS 11,A01,083617,Boyle; Mary E. T.,19,0,48,29
1656954008110,COGS 13,A01,083071,Bastos; Amalia Pinkusfeld,9,0,71,62
1656954014137,COGS 14A,A01,092681,Semenuks; Arturs,0,1,100,100
1656954020161,COGS 14B,A01,083073,Cheng; Tzu-Han,5,0,63,58
1656954026185,COGS 17,A01,092677,Semenuks; Arturs,4,0,81,77
1656954032212,COGS 100,A01,083619,Allen; Michael Gordon,15,0,70,55
1656954038239,COGS 101A,A01,083621,Davis; Joshua Daniel,9,0,68,59
1656954044266,COGS 101B,A01,091572,Allen; Michael Gordon,8,0,65,57
1656954050292,COGS 101C,A01,083625,Delgado; Tania,17,0,35,18
1656954056391,COGS 107A,A01,083627,Boyle; Mary E. T.,13,0,60,47
1656954062419,COGS 118A,A01,083075,Gupta; Anjum,15,0,76,61
1656954068447,CSE 3,A50,083646,Miranda; Gregory Joseph,22,0,50,28
1656954074476,CSE 8A,A50,083650,Miranda; Gregory Joseph,17,1,56,39
1656954080502,CSE 11,A01,083080,Cao; Yingjun,4,15,40,36
1656954086537,CSE 12,A01,083652,Krause-Levy; Sophia Louisa,20,1,120,100
1656954092559,CSE 15L,A01,083654,Morris; Justin Loren,8,0,50,42
1656954092559,CSE 15L,A02,083655,Morris; Justin Loren,8,0,50,42
1656954098587,CSE 20,A01,083657,Tran; Khoa Dang,37,0,80,43
1656954104609,CSE 21,A01,095574,Bach; Quang Tran,21,0,48,27
1656954110645,CSE 30,A01,083084,Eldon; John,4,0,80,76
1656954110645,CSE 30,B01,095061,Bhaskar; Nishant,6,0,50,44
1656954116666,CSE 100,A01,083659,Cao; Yingjun,3,4,70,67
1656954122691,CSE 134B,A01,083661,Powell; Thomas Allan,19,0,100,81
1656954128716,CSE 140,A01,083663,Gungor; Onat,14,0,85,71
1656954134739,CSE 140L,A01,083088,Eldon; John,16,0,100,84
1656954140762,CSE 175,A01,083665,Kumar; Rakesh,3,0,25,22
1656954146788,CSE 190,A00,092507,Dubnov; Shlomo,7,0,20,13
1656954152816,ECE 45,A01,083139,Congero; Spencer William,5,0,75,70
1656954158844,ECE 65,A50,083695,Saad; Andrew S,12,0,30,18
1656954158844,ECE 65,A51,095125,Saad; Andrew S,25,0,26,1
1656954164867,ECE 109,A01,091882,Touri; Behrouz,16,0,70,54
1656954170896,ECE 180,A00,083140,Abi Samra; Nicholas Camill,0,0,30,30
1656954170896,ECE 180,B00,083141,Abi Samra; Nicholas Camill,0,0,30,30
1656954176920,MATH 10A,A01,083735,Patchell; Gregory David,1,0,30,29
1656954176920,MATH 10A,A02,083736,Patchell; Gregory David,20,0,30,10
1656954176920,MATH 10A,A03,083737,Patchell; Gregory David,15,0,30,15
1656954182948,MATH 10B,A01,083207,Lim; Seonhee,7,0,34,27
1656954182948,MATH 10B,A02,083208,Lim; Seonhee,9,0,35,26
1656954182948,MATH 10B,A03,093472,Lim; Seonhee,4,0,34,30
1656954182948,MATH 10B,B01,083739,Sinha; Shubham,9,0,30,21
1656954188971,MATH 18,A01,083743,Cinel; Cameron Alexander,6,0,30,24
1656954188971,MATH 18,A02,083744,Cinel; Cameron Alexander,15,0,30,15
1656954188971,MATH 18,A03,083745,Cinel; Cameron Alexander,8,0,30,22
1656954188971,MATH 18,B01,083748,Rideout; David Porter,4,0,37,33
1656954188971,MATH 18,B02,083749,Rideout; David Porter,3,0,36,33
1656954188971,MATH 18,B03,083750,Rideout; David Porter,2,0,37,35
1656954188971,MATH 18,B04,083751,Rideout; David Porter,5,0,36,31
1656954188971,MATH 18,B05,093473,Rideout; David Porter,4,0,36,32
1656954188971,MATH 18,B06,093474,Rideout; David Porter,5,0,36,31
1656954194995,MATH 20A,A01,083754,Zheng; Zequn,12,0,40,28
1656954201022,MATH 20B,A01,083756,Briones; Jor-el Thomas Caparas,1,0,36,35
1656954201022,MATH 20B,A02,083757,Briones; Jor-el Thomas Caparas,1,0,36,35
1656954201022,MATH 20B,A03,093475,Briones; Jor-el Thomas Caparas,0,0,36,36
1656954207050,MATH 20C,A01,083760,Briones; Jor-el Thomas Caparas,1,0,35,34
1656954207050,MATH 20C,A02,083761,Briones; Jor-el Thomas Caparas,8,0,35,27
1656954207050,MATH 20C,A03,093476,Briones; Jor-el Thomas Caparas,0,1,36,36
1656954207050,MATH 20C,B01,083762,Bach; Quang Tran,0,0,30,30
1656954213074,MATH 20D,A01,083765,Tran; Brian Kha,4,0,30,26
1656954213074,MATH 20D,A02,083766,Tran; Brian Kha,4,0,30,26
1656954213074,MATH 20D,A03,083767,Tran; Brian Kha,3,0,30,27
1656954219103,MATH 20E,A01,083771,Ganguly; Soumya,5,0,32,27
1656954219103,MATH 20E,A02,083772,Ganguly; Soumya,6,0,32,26
1656954219103,MATH 20E,B01,083773,Ciotti; Benjamin,18,0,35,17
1656954219103,MATH 20E,B02,083774,Ciotti; Benjamin,17,0,35,18
1656954225133,MATH 103A,A01,083777,Greenfeld; Be'Eri,2,0,36,34
1656954225133,MATH 103A,A02,083778,Greenfeld; Be'Eri,5,0,36,31
1656954225133,MATH 103A,A03,093561,Greenfeld; Be'Eri,4,0,36,32
1656954225133,MATH 103A,B01,083779,Greenfeld; Be'Eri,6,0,36,30
1656954225133,MATH 103A,B02,083780,Greenfeld; Be'Eri,2,0,36,34
1656954225133,MATH 103A,B03,093562,Greenfeld; Be'Eri,2,0,36,34
1656954231156,MATH 105,A01,085443,Carter; Anne Toulson,14,0,35,21
1656954231156,MATH 105,A02,093477,Carter; Anne Toulson,20,0,35,15
1656954237186,MATH 109,A01,083213,Ganzberger; Geoffrey Michael,2,0,34,32
1656954237186,MATH 109,A02,083214,Ganzberger; Geoffrey Michael,2,0,34,32
1656954237186,MATH 109,A03,093478,Ganzberger; Geoffrey Michael,1,0,34,33
1656954237186,MATH 109,B01,083215,Ganzberger; Geoffrey Michael,1,0,32,31
1656954237186,MATH 109,B02,083216,Ganzberger; Geoffrey Michael,1,0,32,31
1656954237186,MATH 109,B03,093479,Ganzberger; Geoffrey Michael,6,0,32,26
1656954243211,MATH 142A,A01,083219,Chow; Bennett,6,0,32,26
1656954243211,MATH 142A,A02,083220,Chow; Bennett,10,0,32,22
1656954243211,MATH 142A,A03,093480,Chow; Bennett,7,0,32,25
1656954243211,MATH 142A,B03,093481,Chow; Bennett,7,0,32,25
1656954243211,MATH 142A,B04,093558,Chow; Bennett,11,0,32,21
1656954243211,MATH 142A,B05,093559,Chow; Bennett,6,0,32,26
1656954249270,MATH 193A,A01,083224,Rotar; Vladimir,7,0,34,27
1656954249270,MATH 193A,A02,083225,Rotar; Vladimir,4,0,34,30
1656954249270,MATH 193A,A03,083781,Rotar; Vladimir,1,0,34,33
1656954249270,MATH 193A,A04,083782,Rotar; Vladimir,6,0,34,28
1656954249270,MATH 193A,A05,093482,Rotar; Vladimir,6,0,34,28
1656954255301,MATH 197,001,091859,McAuley; Julian John,9999,0,9999,0
1656954255301,MATH 197,002,095566,Kedlaya; Kiran S.,9997,0,9999,2
1656954255301,MATH 197,003,095567,Xiao; Ming,9999,0,9999,0
1656954255301,MATH 197,004,095571,Perols; Johan Lars,9998,0,9999,1
1656954262352,COGS 9,A01,083615,Shannon; Kyle Michael,7,0,75,68
1656954268375,COGS 11,A01,083617,Boyle; Mary E. T.,19,0,48,29
1656954274402,COGS 13,A01,083071,Bastos; Amalia Pinkusfeld,9,0,71,62
1656954280425,COGS 14A,A01,092681,Semenuks; Arturs,0,1,100,100
1656954286452,COGS 14B,A01,083073,Cheng; Tzu-Han,5,0,63,58
1656954292475,COGS 17,A01,092677,Semenuks; Arturs,4,0,81,77
1656954298501,COGS 100,A01,083619,Allen; Michael Gordon,15,0,70,55
1656954304525,COGS 101A,A01,083621,Davis; Joshua Daniel,9,0,68,59
1656954310547,COGS 101B,A01,091572,Allen; Michael Gordon,8,0,65,57
1656954316577,COGS 101C,A01,083625,Delgado; Tania,17,0,35,18
1656954322600,COGS 107A,A01,083627,Boyle; Mary E. T.,13,0,60,47
1656954328623,COGS 118A,A01,083075,Gupta; Anjum,15,0,76,61
1656954334649,CSE 3,A50,083646,Miranda; Gregory Joseph,22,0,50,28
1656954340671,CSE 8A,A50,083650,Miranda; Gregory Joseph,17,1,56,39
1656954346697,CSE 11,A01,083080,Cao; Yingjun,4,15,40,36
1656954352723,CSE 12,A01,083652,Krause-Levy; Sophia Louisa,20,1,120,100
1656954358745,CSE 15L,A01,083654,Morris; Justin Loren,8,0,50,42
1656954358745,CSE 15L,A02,083655,Morris; Justin Loren,8,0,50,42
1656954364768,CSE 20,A01,083657,Tran; Khoa Dang,37,0,80,43
1656954370795,CSE 21,A01,095574,Bach; Quang Tran,21,0,48,27
1656954376824,CSE 30,A01,083084,Eldon; John,4,0,80,76
1656954376824,CSE 30,B01,095061,Bhaskar; Nishant,6,0,50,44
1656954382845,CSE 100,A01,083659,Cao; Yingjun,3,4,70,67
1656954388875,CSE 134B,A01,083661,Powell; Thomas Allan,19,0,100,81
1656954394899,CSE 140,A01,083663,Gungor; Onat,14,0,85,71
1656954400934,CSE 140L,A01,083088,Eldon; John,16,0,100,84
1656954406968,CSE 175,A01,083665,Kumar; Rakesh,3,0,25,22
1656954412995,CSE 190,A00,092507,Dubnov; Shlomo,7,0,20,13
1656954419019,ECE 45,A01,083139,Congero; Spencer William,5,0,75,70
1656954425041,ECE 65,A50,083695,Saad; Andrew S,12,0,30,18
1656954425041,ECE 65,A51,095125,Saad; Andrew S,25,0,26,1
1656954431069,ECE 109,A01,091882,Touri; Behrouz,16,0,70,54
1656954437097,ECE 180,A00,083140,Abi Samra; Nicholas Camill,0,0,30,30
1656954437097,ECE 180,B00,083141,Abi Samra; Nicholas Camill,0,0,30,30
1656954443132,MATH 10A,A01,083735,Patchell; Gregory David,1,0,30,29
1656954443132,MATH 10A,A02,083736,Patchell; Gregory David,20,0,30,10
1656954443132,MATH 10A,A03,083737,Patchell; Gregory David,15,0,30,15
1656954449163,MATH 10B,A01,083207,Lim; Seonhee,7,0,34,27
1656954449163,MATH 10B,A02,083208,Lim; Seonhee,9,0,35,26
1656954449163,MATH 10B,A03,093472,Lim; Seonhee,4,0,34,30
1656954449163,MATH 10B,B01,083739,Sinha; Shubham,9,0,30,21
1656954455187,MATH 18,A01,083743,Cinel; Cameron Alexander,6,0,30,24
1656954455187,MATH 18,A02,083744,Cinel; Cameron Alexander,15,0,30,15
1656954455187,MATH 18,A03,083745,Cinel; Cameron Alexander,8,0,30,22
1656954455187,MATH 18,B01,083748,Rideout; David Porter,4,0,37,33
1656954455187,MATH 18,B02,083749,Rideout; David Porter,3,0,36,33
1656954455187,MATH 18,B03,083750,Rideout; David Porter,2,0,37,35
1656954455187,MATH 18,B04,083751,Rideout; David Porter,5,0,36,31
1656954455187,MATH 18,B05,093473,Rideout; David Porter,4,0,36,32
1656954455187,MATH 18,B06,093474,Rideout; David Porter,5,0,36,31
1656954461215,MATH 20A,A01,083754,Zheng; Zequn,12,0,40,28
1656954467243,MATH 20B,A01,083756,Briones; Jor-el Thomas Caparas,1,0,36,35
1656954467243,MATH 20B,A02,083757,Briones; Jor-el Thomas Caparas,1,0,36,35
1656954467243,MATH 20B,A03,093475,Briones; Jor-el Thomas Caparas,0,0,36,36
1656954473273,MATH 20C,A01,083760,Briones; Jor-el Thomas Caparas,1,0,35,34
1656954473273,MATH 20C,A02,083761,Briones; Jor-el Thomas Caparas,8,0,35,27
1656954473273,MATH 20C,A03,093476,Briones; Jor-el Thomas Caparas,0,1,36,36
1656954473273,MATH 20C,B01,083762,Bach; Quang Tran,0,0,30,30
1656954479301,MATH 20D,A01,083765,Tran; Brian Kha,4,0,30,26
1656954479301,MATH 20D,A02,083766,Tran; Brian Kha,4,0,30,26
1656954479301,MATH 20D,A03,083767,Tran; Brian Kha,3,0,30,27
1656954485327,MATH 20E,A01,083771,Ganguly; Soumya,5,0,32,27
1656954485327,MATH 20E,A02,083772,Ganguly; Soumya,6,0,32,26
1656954485327,MATH 20E,B01,083773,Ciotti; Benjamin,18,0,35,17
1656954485327,MATH 20E,B02,083774,Ciotti; Benjamin,17,0,35,18
1656954491356,MATH 103A,A01,083777,Greenfeld; Be'Eri,2,0,36,34
1656954491356,MATH 103A,A02,083778,Greenfeld; Be'Eri,5,0,36,31
1656954491356,MATH 103A,A03,093561,Greenfeld; Be'Eri,4,0,36,32
1656954491356,MATH 103A,B01,083779,Greenfeld; Be'Eri,6,0,36,30
1656954491356,MATH 103A,B02,083780,Greenfeld; Be'Eri,2,0,36,34
1656954491356,MATH 103A,B03,093562,Greenfeld; Be'Eri,2,0,36,34
1656954497380,MATH 105,A01,085443,Carter; Anne Toulson,14,0,35,21
1656954497380,MATH 105,A02,093477,Carter; Anne Toulson,20,0,35,15
1656954503405,MATH 109,A01,083213,Ganzberger; Geoffrey Michael,2,0,34,32
1656954503405,MATH 109,A02,083214,Ganzberger; Geoffrey Michael,2,0,34,32
1656954503405,MATH 109,A03,093478,Ganzberger; Geoffrey Michael,1,0,34,33
1656954503405,MATH 109,B01,083215,Ganzberger; Geoffrey Michael,1,0,32,31
1656954503405,MATH 109,B02,083216,Ganzberger; Geoffrey Michael,1,0,32,31
1656954503405,MATH 109,B03,093479,Ganzberger; Geoffrey Michael,6,0,32,26
1656954509428,MATH 142A,A01,083219,Chow; Bennett,6,0,32,26
1656954509428,MATH 142A,A02,083220,Chow; Bennett,10,0,32,22
1656954509428,MATH 142A,A03,093480,Chow; Bennett,7,0,32,25
1656954509428,MATH 142A,B03,093481,Chow; Bennett,7,0,32,25
1656954509428,MATH 142A,B04,093558,Chow; Bennett,11,0,32,21
1656954509428,MATH 142A,B05,093559,Chow; Bennett,6,0,32,26
1656954515455,MATH 193A,A01,083224,Rotar; Vladimir,7,0,34,27
1656954515455,MATH 193A,A02,083225,Rotar; Vladimir,4,0,34,30
1656954515455,MATH 193A,A03,083781,Rotar; Vladimir,1,0,34,33
1656954515455,MATH 193A,A04,083782,Rotar; Vladimir,6,0,34,28
1656954515455,MATH 193A,A05,093482,Rotar; Vladimir,6,0,34,28
1656954521478,MATH 197,001,091859,McAuley; Julian John,9999,0,9999,0
1656954521478,MATH 197,002,095566,Kedlaya; Kiran S.,9997,0,9999,2
1656954521478,MATH 197,003,095567,Xiao; Ming,9999,0,9999,0
1656954521478,MATH 197,004,095571,Perols; Johan Lars,9998,0,9999,1
1656954528541,COGS 9,A01,083615,Shannon; Kyle Michael,7,0,75,68
1656954534563,COGS 11,A01,083617,Boyle; Mary E. T.,19,0,48,29
1656954540588,COGS 13,A01,083071,Bastos; Amalia Pinkusfeld,9,0,71,62
1656954546612,COGS 14A,A01,092681,Semenuks; Arturs,0,1,100,100
1656954552638,COGS 14B,A01,083073,Cheng; Tzu-Han,5,0,63,58
1656954558664,COGS 17,A01,092677,Semenuks; Arturs,4,0,81,77
1656954564691,COGS 100,A01,083619,Allen; Michael Gordon,15,0,70,55
1656954570723,COGS 101A,A01,083621,Davis; Joshua Daniel,9,0,68,59
1656954576749,COGS 101B,A01,091572,Allen; Michael Gordon,8,0,65,57
1656954582771,COGS 101C,A01,083625,Delgado; Tania,17,0,35,18
1656954588794,COGS 107A,A01,083627,Boyle; Mary E. T.,13,0,60,47
1656954594816,COGS 118A,A01,083075,Gupta; Anjum,15,0,76,61
1656954600845,CSE 3,A50,083646,Miranda; Gregory Joseph,22,0,50,28
1656954606874,CSE 8A,A50,083650,Miranda; Gregory Joseph,17,1,56,39
1656954612897,CSE 11,A01,083080,Cao; Yingjun,4,15,40,36
1656954618927,CSE 12,A01,083652,Krause-Levy; Sophia Louisa,20,1,120,100
1656954624951,CSE 15L,A01,083654,Morris; Justin Loren,8,0,50,42
1656954624951,CSE 15L,A02,083655,Morris; Justin Loren,8,0,50,42
1656954630975,CSE 20,A01,083657,Tran; Khoa Dang,37,0,80,43
1656954636999,CSE 21,A01,095574,Bach; Quang Tran,21,0,48,27
1656954643027,CSE 30,A01,083084,Eldon; John,4,0,80,76
1656954643027,CSE 30,B01,095061,Bhaskar; Nishant,6,0,50,44
1656954649052,CSE 100,A01,083659,Cao; Yingjun,3,4,70,67
1656954655167,CSE 134B,A01,083661,Powell; Thomas Allan,19,0,100,81
1656954661191,CSE 140,A01,083663,Gungor; Onat,14,0,85,71
1656954667218,CSE 140L,A01,083088,Eldon; John,16,0,100,84
1656954673241,CSE 175,A01,083665,Kumar; Rakesh,3,0,25,22
1656954679268,CSE 190,A00,092507,Dubnov; Shlomo,7,0,20,13
1656954685292,ECE 45,A01,083139,Congero; Spencer William,5,0,75,70
1656954691315,ECE 65,A50,083695,Saad; Andrew S,12,0,30,18
1656954691315,ECE 65,A51,095125,Saad; Andrew S,25,0,26,1
1656954697339,ECE 109,A01,091882,Touri; Behrouz,16,0,70,54
1656954703367,ECE 180,A00,083140,Abi Samra; Nicholas Camill,0,0,30,30
1656954703367,ECE 180,B00,083141,Abi Samra; Nicholas Camill,0,0,30,30
1656954709396,MATH 10A,A01,083735,Patchell; Gregory David,1,0,30,29
1656954709396,MATH 10A,A02,083736,Patchell; Gregory David,20,0,30,10
1656954709396,MATH 10A,A03,083737,Patchell; Gregory David,15,0,30,15
1656954715420,MATH 10B,A01,083207,Lim; Seonhee,7,0,34,27
1656954715420,MATH 10B,A02,083208,Lim; Seonhee,9,0,35,26
1656954715420,MATH 10B,A03,093472,Lim; Seonhee,4,0,34,30
1656954715420,MATH 10B,B01,083739,Sinha; Shubham,9,0,30,21
1656954721449,MATH 18,A01,083743,Cinel; Cameron Alexander,6,0,30,24
1656954721449,MATH 18,A02,083744,Cinel; Cameron Alexander,15,0,30,15
1656954721449,MATH 18,A03,083745,Cinel; Cameron Alexander,8,0,30,22
1656954721449,MATH 18,B01,083748,Rideout; David Porter,4,0,37,33
1656954721449,MATH 18,B02,083749,Rideout; David Porter,3,0,36,33
1656954721449,MATH 18,B03,083750,Rideout; David Porter,2,0,37,35
1656954721449,MATH 18,B04,083751,Rideout; David Porter,5,0,36,31
1656954721449,MATH 18,B05,093473,Rideout; David Porter,4,0,36,32
1656954721449,MATH 18,B06,093474,Rideout; David Porter,5,0,36,31
1656954727472,MATH 20A,A01,083754,Zheng; Zequn,12,0,40,28
1656954733496,MATH 20B,A01,083756,Briones; Jor-el Thomas Caparas,1,0,36,35
1656954733496,MATH 20B,A02,083757,Briones; Jor-el Thomas Caparas,1,0,36,35
1656954733496,MATH 20B,A03,093475,Briones; Jor-el Thomas Caparas,0,0,36,36
1656954739526,MATH 20C,A01,083760,Briones; Jor-el Thomas Caparas,1,0,35,34
1656954739526,MATH 20C,A02,083761,Briones; Jor-el Thomas Caparas,8,0,35,27
1656954739526,MATH 20C,A03,093476,Briones; Jor-el Thomas Caparas,0,1,36,36
1656954739526,MATH 20C,B01,083762,Bach; Quang Tran,0,0,30,30
1656954745549,MATH 20D,A01,083765,Tran; Brian Kha,4,0,30,26
1656954745549,MATH 20D,A02,083766,Tran; Brian Kha,4,0,30,26
1656954745549,MATH 20D,A03,083767,Tran; Brian Kha,3,0,30,27
1656954751577,MATH 20E,A01,083771,Ganguly; Soumya,5,0,32,27
1656954751577,MATH 20E,A02,083772,Ganguly; Soumya,6,0,32,26
1656954751577,MATH 20E,B01,083773,Ciotti; Benjamin,18,0,35,17
1656954751577,MATH 20E,B02,083774,Ciotti; Benjamin,17,0,35,18
1656954757604,MATH 103A,A01,083777,Greenfeld; Be'Eri,2,0,36,34
1656954757604,MATH 103A,A02,083778,Greenfeld; Be'Eri,5,0,36,31
1656954757604,MATH 103A,A03,093561,Greenfeld; Be'Eri,4,0,36,32
1656954757604,MATH 103A,B01,083779,Greenfeld; Be'Eri,6,0,36,30
1656954757604,MATH 103A,B02,083780,Greenfeld; Be'Eri,2,0,36,34
1656954757604,MATH 103A,B03,093562,Greenfeld; Be'Eri,2,0,36,34
1656954763632,MATH 105,A01,085443,Carter; Anne Toulson,14,0,35,21
1656954763632,MATH 105,A02,093477,Carter; Anne Toulson,20,0,35,15
1656954769661,MATH 109,A01,083213,Ganzberger; Geoffrey Michael,2,0,34,32
1656954769661,MATH 109,A02,083214,Ganzberger; Geoffrey Michael,2,0,34,32
1656954769661,MATH 109,A03,093478,Ganzberger; Geoffrey Michael,1,0,34,33
1656954769661,MATH 109,B01,083215,Ganzberger; Geoffrey Michael,1,0,32,31
1656954769661,MATH 109,B02,083216,Ganzberger; Geoffrey Michael,1,0,32,31
1656954769661,MATH 109,B03,093479,Ganzberger; Geoffrey Michael,6,0,32,26
1656954775689,MATH 142A,A01,083219,Chow; Bennett,6,0,32,26
1656954775689,MATH 142A,A02,083220,Chow; Bennett,10,0,32,22
1656954775689,MATH 142A,A03,093480,Chow; Bennett,7,0,32,25
1656954775689,MATH 142A,B03,093481,Chow; Bennett,7,0,32,25
1656954775689,MATH 142A,B04,093558,Chow; Bennett,11,0,32,21
1656954775689,MATH 142A,B05,093559,Chow; Bennett,6,0,32,26
1656954781712,MATH 193A,A01,083224,Rotar; Vladimir,7,0,34,27
1656954781712,MATH 193A,A02,083225,Rotar; Vladimir,4,0,34,30
1656954781712,MATH 193A,A03,083781,Rotar; Vladimir,1,0,34,33
1656954781712,MATH 193A,A04,083782,Rotar; Vladimir,6,0,34,28
1656954781712,MATH 193A,A05,093482,Rotar; Vladimir,6,0,34,28
1656954787736,MATH 197,001,091859,McAuley; Julian John,9999,0,9999,0
1656954787736,MATH 197,002,095566,Kedlaya; Kiran S.,9997,0,9999,2
1656954787736,MATH 197,003,095567,Xiao; Ming,9999,0,9999,0
1656954787736,MATH 197,004,095571,Perols; Johan Lars,9998,0,9999,1
1656954794794,COGS 9,A01,083615,Shannon; Kyle Michael,7,0,75,68
1656954800821,COGS 11,A01,083617,Boyle; Mary E. T.,19,0,48,29
1656954806845,COGS 13,A01,083071,Bastos; Amalia Pinkusfeld,9,0,71,62
1656954812872,COGS 14A,A01,092681,Semenuks; Arturs,0,1,100,100
1656954818896,COGS 14B,A01,083073,Cheng; Tzu-Han,5,0,63,58
1656954824919,COGS 17,A01,092677,Semenuks; Arturs,4,0,81,77
1656954830942,COGS 100,A01,083619,Allen; Michael Gordon,15,0,70,55
1656954836971,COGS 101A,A01,083621,Davis; Joshua Daniel,9,0,68,59
1656954842996,COGS 101B,A01,091572,Allen; Michael Gordon,8,0,65,57
1656954849023,COGS 101C,A01,083625,Delgado; Tania,17,0,35,18
1656954855048,COGS 107A,A01,083627,Boyle; Mary E. T.,13,0,60,47
1656954861071,COGS 118A,A01,083075,Gupta; Anjum,15,0,76,61
1656954867099,CSE 3,A50,083646,Miranda; Gregory Joseph,22,0,50,28
1656954873122,CSE 8A,A50,083650,Miranda; Gregory Joseph,17,1,56,39
1656954879148,CSE 11,A01,083080,Cao; Yingjun,4,15,40,36
1656954885171,CSE 12,A01,083652,Krause-Levy; Sophia Louisa,20,1,120,100
1656954891199,CSE 15L,A01,083654,Morris; Justin Loren,8,0,50,42
1656954891199,CSE 15L,A02,083655,Morris; Justin Loren,8,0,50,42
1656954897222,CSE 20,A01,083657,Tran; Khoa Dang,37,0,80,43
1656954903246,CSE 21,A01,095574,Bach; Quang Tran,21,0,48,27
1656954909268,CSE 30,A01,083084,Eldon; John,4,0,80,76
1656954909268,CSE 30,B01,095061,Bhaskar; Nishant,6,0,50,44
1656954915291,CSE 100,A01,083659,Cao; Yingjun,3,4,70,67
1656954921315,CSE 134B,A01,083661,Powell; Thomas Allan,19,0,100,81
1656954927339,CSE 140,A01,083663,Gungor; Onat,14,0,85,71
1656954933369,CSE 140L,A01,083088,Eldon; John,16,0,100,84
1656954939397,CSE 175,A01,083665,Kumar; Rakesh,3,0,25,22
1656954945422,CSE 190,A00,092507,Dubnov; Shlomo,7,0,20,13
1656954951448,ECE 45,A01,083139,Congero; Spencer William,5,0,75,70
1656954957477,ECE 65,A50,083695,Saad; Andrew S,12,0,30,18
1656954957477,ECE 65,A51,095125,Saad; Andrew S,25,0,26,1
1656954963510,ECE 109,A01,091882,Touri; Behrouz,16,0,70,54
1656954969534,ECE 180,A00,083140,Abi Samra; Nicholas Camill,0,0,30,30
1656954969534,ECE 180,B00,083141,Abi Samra; Nicholas Camill,0,0,30,30
1656954975559,MATH 10A,A01,083735,Patchell; Gregory David,1,0,30,29
1656954975559,MATH 10A,A02,083736,Patchell; Gregory David,20,0,30,10
1656954975559,MATH 10A,A03,083737,Patchell; Gregory David,15,0,30,15
1656954981583,MATH 10B,A01,083207,Lim; Seonhee,7,0,34,27
1656954981583,MATH 10B,A02,083208,Lim; Seonhee,9,0,35,26
1656954981583,MATH 10B,A03,093472,Lim; Seonhee,4,0,34,30
1656954981583,MATH 10B,B01,083739,Sinha; Shubham,9,0,30,21
1656954987609,MATH 18,A01,083743,Cinel; Cameron Alexander,6,0,30,24
1656954987609,MATH 18,A02,083744,Cinel; Cameron Alexander,15,0,30,15
1656954987609,MATH 18,A03,083745,Cinel; Cameron Alexander,8,0,30,22
1656954987609,MATH 18,B01,083748,Rideout; David Porter,4,0,37,33
1656954987609,MATH 18,B02,083749,Rideout; David Porter,3,0,36,33
1656954987609,MATH 18,B03,083750,Rideout; David Porter,2,0,37,35
1656954987609,MATH 18,B04,083751,Rideout; David Porter,5,0,36,31
1656954987609,MATH 18,B05,093473,Rideout; David Porter,4,0,36,32
1656954987609,MATH 18,B06,093474,Rideout; David Porter,5,0,36,31
1656954993632,MATH 20A,A01,083754,Zheng; Zequn,12,0,40,28
1656954999659,MATH 20B,A01,083756,Briones; Jor-el Thomas Caparas,1,0,36,35
1656954999659,MATH 20B,A02,083757,Briones; Jor-el Thomas Caparas,1,0,36,35
1656954999659,MATH 20B,A03,093475,Briones; Jor-el Thomas Caparas,0,0,36,36
1656955005686,MATH 20C,A01,083760,Briones; Jor-el Thomas Caparas,1,0,35,34
1656955005686,MATH 20C,A02,083761,Briones; Jor-el Thomas Caparas,8,0,35,27
1656955005686,MATH 20C,A03,093476,Briones; Jor-el Thomas Caparas,0,1,36,36
1656955005686,MATH 20C,B01,083762,Bach; Quang Tran,0,0,30,30
1656955011710,MATH 20D,A01,083765,Tran; Brian Kha,4,0,30,26
1656955011710,MATH 20D,A02,083766,Tran; Brian Kha,4,0,30,26
1656955011710,MATH 20D,A03,083767,Tran; Brian Kha,3,0,30,27
1656955017734,MATH 20E,A01,083771,Ganguly; Soumya,5,0,32,27
1656955017734,MATH 20E,A02,083772,Ganguly; Soumya,6,0,32,26
1656955017734,MATH 20E,B01,083773,Ciotti; Benjamin,18,0,35,17
1656955017734,MATH 20E,B02,083774,Ciotti; Benjamin,17,0,35,18
1656955023757,MATH 103A,A01,083777,Greenfeld; Be'Eri,2,0,36,34
1656955023757,MATH 103A,A02,083778,Greenfeld; Be'Eri,5,0,36,31
1656955023757,MATH 103A,A03,093561,Greenfeld; Be'Eri,4,0,36,32
1656955023757,MATH 103A,B01,083779,Greenfeld; Be'Eri,6,0,36,30
1656955023757,MATH 103A,B02,083780,Greenfeld; Be'Eri,2,0,36,34
1656955023757,MATH 103A,B03,093562,Greenfeld; Be'Eri,2,0,36,34
1656955029781,MATH 105,A01,085443,Carter; Anne Toulson,14,0,35,21
1656955029781,MATH 105,A02,093477,Carter; Anne Toulson,20,0,35,15
1656955035810,MATH 109,A01,083213,Ganzberger; Geoffrey Michael,2,0,34,32
1656955035810,MATH 109,A02,083214,Ganzberger; Geoffrey Michael,2,0,34,32
1656955035810,MATH 109,A03,093478,Ganzberger; Geoffrey Michael,1,0,34,33
1656955035810,MATH 109,B01,083215,Ganzberger; Geoffrey Michael,1,0,32,31
1656955035810,MATH 109,B02,083216,Ganzberger; Geoffrey Michael,1,0,32,31
1656955035810,MATH 109,B03,093479,Ganzberger; Geoffrey Michael,6,0,32,26
1656955041833,MATH 142A,A01,083219,Chow; Bennett,6,0,32,26
1656955041833,MATH 142A,A02,083220,Chow; Bennett,10,0,32,22
1656955041833,MATH 142A,A03,093480,Chow; Bennett,7,0,32,25
1656955041833,MATH 142A,B03,093481,Chow; Bennett,7,0,32,25
1656955041833,MATH 142A,B04,093558,Chow; Bennett,11,0,32,21
1656955041833,MATH 142A,B05,093559,Chow; Bennett,6,0,32,26
1656955047863,MATH 193A,A01,083224,Rotar; Vladimir,7,0,34,27
1656955047863,MATH 193A,A02,083225,Rotar; Vladimir,4,0,34,30
1656955047863,MATH 193A,A03,083781,Rotar; Vladimir,1,0,34,33
1656955047863,MATH 193A,A04,083782,Rotar; Vladimir,6,0,34,28
1656955047863,MATH 193A,A05,093482,Rotar; Vladimir,6,0,34,28
1656955053889,MATH 197,001,091859,McAuley; Julian John,9999,0,9999,0
1656955053889,MATH 197,002,095566,Kedlaya; Kiran S.,9997,0,9999,2
1656955053889,MATH 197,003,095567,Xiao; Ming,9999,0,9999,0
1656955053889,MATH 197,004,095571,Perols; Johan Lars,9998,0,9999,1
1656955060957,COGS 9,A01,083615,Shannon; Kyle Michael,7,0,75,68
1656955066981,COGS 11,A01,083617,Boyle; Mary E. T.,19,0,48,29
1656955073007,COGS 13,A01,083071,Bastos; Amalia Pinkusfeld,9,0,71,62
1656955079031,COGS 14A,A01,092681,Semenuks; Arturs,0,1,100,100
1656955085056,COGS 14B,A01,083073,Cheng; Tzu-Han,5,0,63,58
1656955091081,COGS 17,A01,092677,Semenuks; Arturs,4,0,81,77
1656955097104,COGS 100,A01,083619,Allen; Michael Gordon,15,0,70,55
1656955103128,COGS 101A,A01,083621,Davis; Joshua Daniel,9,0,68,59
1656955109156,COGS 101B,A01,091572,Allen; Michael Gordon,8,0,65,57
1656955115178,COGS 101C,A01,083625,Delgado; Tania,17,0,35,18
1656955121204,COGS 107A,A01,083627,Boyle; Mary E. T.,13,0,60,47
1656955127228,COGS 118A,A01,083075,Gupta; Anjum,15,0,76,61
1656955133257,CSE 3,A50,083646,Miranda; Gregory Joseph,22,0,50,28
1656955139283,CSE 8A,A50,083650,Miranda; Gregory Joseph,17,1,56,39
1656955145306,CSE 11,A01,083080,Cao; Yingjun,4,15,40,36
1656955151332,CSE 12,A01,083652,Krause-Levy; Sophia Louisa,20,1,120,100
1656955157359,CSE 15L,A01,083654,Morris; Justin Loren,8,0,50,42
1656955157359,CSE 15L,A02,083655,Morris; Justin Loren,8,0,50,42
1656955163389,CSE 20,A01,083657,Tran; Khoa Dang,37,0,80,43
1656955169412,CSE 21,A01,095574,Bach; Quang Tran,21,0,48,27
1656955175434,CSE 30,A01,083084,Eldon; John,4,0,80,76
1656955175434,CSE 30,B01,095061,Bhaskar; Nishant,6,0,50,44
1656955181461,CSE 100,A01,083659,Cao; Yingjun,3,4,70,67
1656955187486,CSE 134B,A01,083661,Powell; Thomas Allan,19,0,100,81
1656955193510,CSE 140,A01,083663,Gungor; Onat,14,0,85,71
1656955199536,CSE 140L,A01,083088,Eldon; John,16,0,100,84
1656955205558,CSE 175,A01,083665,Kumar; Rakesh,3,0,25,22
1656955211585,CSE 190,A00,092507,Dubnov; Shlomo,7,0,20,13
1656955217608,ECE 45,A01,083139,Congero; Spencer William,5,0,75,70
1656955223631,ECE 65,A50,083695,Saad; Andrew S,12,0,30,18
1656955223631,ECE 65,A51,095125,Saad; Andrew S,25,0,26,1
1656955229657,ECE 109,A01,091882,Touri; Behrouz,16,0,70,54
1656955235693,ECE 180,A00,083140,Abi Samra; Nicholas Camill,0,0,30,30
1656955235693,ECE 180,B00,083141,Abi Samra; Nicholas Camill,0,0,30,30
1656955241718,MATH 10A,A01,083735,Patchell; Gregory David,1,0,30,29
1656955241718,MATH 10A,A02,083736,Patchell; Gregory David,20,0,30,10
1656955241718,MATH 10A,A03,083737,Patchell; Gregory David,15,0,30,15
1656955247743,MATH 10B,A01,083207,Lim; Seonhee,7,0,34,27
1656955247743,MATH 10B,A02,083208,Lim; Seonhee,9,0,35,26
1656955247743,MATH 10B,A03,093472,Lim; Seonhee,4,0,34,30
1656955247743,MATH 10B,B01,083739,Sinha; Shubham,9,0,30,21
1656955253851,MATH 18,A01,083743,Cinel; Cameron Alexander,6,0,30,24
1656955253851,MATH 18,A02,083744,Cinel; Cameron Alexander,15,0,30,15
1656955253851,MATH 18,A03,083745,Cinel; Cameron Alexander,8,0,30,22
1656955253851,MATH 18,B01,083748,Rideout; David Porter,4,0,37,33
1656955253851,MATH 18,B02,083749,Rideout; David Porter,3,0,36,33
1656955253851,MATH 18,B03,083750,Rideout; David Porter,2,0,37,35
1656955253851,MATH 18,B04,083751,Rideout; David Porter,5,0,36,31
1656955253851,MATH 18,B05,093473,Rideout; David Porter,4,0,36,32
1656955253851,MATH 18,B06,093474,Rideout; David Porter,5,0,36,31
1656955259874,MATH 20A,A01,083754,Zheng; Zequn,12,0,40,28
1656955265907,MATH 20B,A01,083756,Briones; Jor-el Thomas Caparas,1,0,36,35
1656955265907,MATH 20B,A02,083757,Briones; Jor-el Thomas Caparas,1,0,36,35
1656955265907,MATH 20B,A03,093475,Briones; Jor-el Thomas Caparas,0,0,36,36
1656955271936,MATH 20C,A01,083760,Briones; Jor-el Thomas Caparas,1,0,35,34
1656955271936,MATH 20C,A02,083761,Briones; Jor-el Thomas Caparas,8,0,35,27
1656955271936,MATH 20C,A03,093476,Briones; Jor-el Thomas Caparas,0,1,36,36
1656955271936,MATH 20C,B01,083762,Bach; Quang Tran,0,0,30,30
1656955277968,MATH 20D,A01,083765,Tran; Brian Kha,4,0,30,26
1656955277968,MATH 20D,A02,083766,Tran; Brian Kha,4,0,30,26
1656955277968,MATH 20D,A03,083767,Tran; Brian Kha,3,0,30,27
1656955284003,MATH 20E,A01,083771,Ganguly; Soumya,5,0,32,27
1656955284003,MATH 20E,A02,083772,Ganguly; Soumya,6,0,32,26
1656955284003,MATH 20E,B01,083773,Ciotti; Benjamin,18,0,35,17
1656955284003,MATH 20E,B02,083774,Ciotti; Benjamin,17,0,35,18
1656955290029,MATH 103A,A01,083777,Greenfeld; Be'Eri,2,0,36,34
1656955290029,MATH 103A,A02,083778,Greenfeld; Be'Eri,5,0,36,31
1656955290029,MATH 103A,A03,093561,Greenfeld; Be'Eri,4,0,36,32
1656955290029,MATH 103A,B01,083779,Greenfeld; Be'Eri,6,0,36,30
1656955290029,MATH 103A,B02,083780,Greenfeld; Be'Eri,2,0,36,34
1656955290029,MATH 103A,B03,093562,Greenfeld; Be'Eri,2,0,36,34
1656955296051,MATH 105,A01,085443,Carter; Anne Toulson,14,0,35,21
1656955296051,MATH 105,A02,093477,Carter; Anne Toulson,20,0,35,15
1656955302075,MATH 109,A01,083213,Ganzberger; Geoffrey Michael,2,0,34,32
1656955302075,MATH 109,A02,083214,Ganzberger; Geoffrey Michael,2,0,34,32
1656955302075,MATH 109,A03,093478,Ganzberger; Geoffrey Michael,1,0,34,33
1656955302075,MATH 109,B01,083215,Ganzberger; Geoffrey Michael,1,0,32,31
1656955302075,MATH 109,B02,083216,Ganzberger; Geoffrey Michael,1,0,32,31
1656955302075,MATH 109,B03,093479,Ganzberger; Geoffrey Michael,6,0,32,26
1656955308105,MATH 142A,A01,083219,Chow; Bennett,6,0,32,26
1656955308105,MATH 142A,A02,083220,Chow; Bennett,10,0,32,22
1656955308105,MATH 142A,A03,093480,Chow; Bennett,7,0,32,25
1656955308105,MATH 142A,B03,093481,Chow; Bennett,7,0,32,25
1656955308105,MATH 142A,B04,093558,Chow; Bennett,11,0,32,21
1656955308105,MATH 142A,B05,093559,Chow; Bennett,6,0,32,26
1656955314129,MATH 193A,A01,083224,Rotar; Vladimir,7,0,34,27
1656955314129,MATH 193A,A02,083225,Rotar; Vladimir,4,0,34,30
1656955314129,MATH 193A,A03,083781,Rotar; Vladimir,1,0,34,33
1656955314129,MATH 193A,A04,083782,Rotar; Vladimir,6,0,34,28
1656955314129,MATH 193A,A05,093482,Rotar; Vladimir,6,0,34,28
1656955320153,MATH 197,001,091859,McAuley; Julian John,9999,0,9999,0
1656955320153,MATH 197,002,095566,Kedlaya; Kiran S.,9997,0,9999,2
1656955320153,MATH 197,003,095567,Xiao; Ming,9999,0,9999,0
1656955320153,MATH 197,004,095571,Perols; Johan Lars,9998,0,9999,1
1656955327214,COGS 9,A01,083615,Shannon; Kyle Michael,7,0,75,68
1656955333240,COGS 11,A01,083617,Boyle; Mary E. T.,19,0,48,29
1656955339265,COGS 13,A01,083071,Bastos; Amalia Pinkusfeld,9,0,71,62
1656955345288,COGS 14A,A01,092681,Semenuks; Arturs,0,1,100,100
1656955351312,COGS 14B,A01,083073,Cheng; Tzu-Han,5,0,63,58
1656955357335,COGS 17,A01,092677,Semenuks; Arturs,4,0,81,77
1656955363357,COGS 100,A01,083619,Allen; Michael Gordon,15,0,70,55
1656955369380,COGS 101A,A01,083621,Davis; Joshua Daniel,9,0,68,59
1656955375408,COGS 101B,A01,091572,Allen; Michael Gordon,8,0,65,57
1656955381432,COGS 101C,A01,083625,Delgado; Tania,17,0,35,18
1656955387458,COGS 107A,A01,083627,Boyle; Mary E. T.,13,0,60,47
1656955393483,COGS 118A,A01,083075,Gupta; Anjum,15,0,76,61
1656955399507,CSE 3,A50,083646,Miranda; Gregory Joseph,22,0,50,28
1656955405530,CSE 8A,A50,083650,Miranda; Gregory Joseph,17,1,56,39
1656955411556,CSE 11,A01,083080,Cao; Yingjun,4,15,40,36
1656955417579,CSE 12,A01,083652,Krause-Levy; Sophia Louisa,20,1,120,100
1656955423603,CSE 15L,A01,083654,Morris; Justin Loren,8,0,50,42
1656955423603,CSE 15L,A02,083655,Morris; Justin Loren,8,0,50,42
1656955429625,CSE 20,A01,083657,Tran; Khoa Dang,37,0,80,43
1656955435651,CSE 21,A01,095574,Bach; Quang Tran,21,0,48,27
1656955441684,CSE 30,A01,083084,Eldon; John,4,0,80,76
1656955441684,CSE 30,B01,095061,Bhaskar; Nishant,6,0,50,44
1656955447709,CSE 100,A01,083659,Cao; Yingjun,3,4,70,67
1656955453736,CSE 134B,A01,083661,Powell; Thomas Allan,19,0,100,81
1656955459757,CSE 140,A01,083663,Gungor; Onat,14,0,85,71
1656955465780,CSE 140L,A01,083088,Eldon; John,16,0,100,84
1656955471805,CSE 175,A01,083665,Kumar; Rakesh,3,0,25,22
1656955477826,CSE 190,A00,092507,Dubnov; Shlomo,7,0,20,13
1656955483850,ECE 45,A01,083139,Congero; Spencer William,5,0,75,70
1656955489878,ECE 65,A50,083695,Saad; Andrew S,12,0,30,18
1656955489878,ECE 65,A51,095125,Saad; Andrew S,25,0,26,1
1656955495901,ECE 109,A01,091882,Touri; Behrouz,16,0,70,54
1656955501930,ECE 180,A00,083140,Abi Samra; Nicholas Camill,0,0,30,30
1656955501930,ECE 180,B00,083141,Abi Samra; Nicholas Camill,0,0,30,30
1656955507960,MATH 10A,A01,083735,Patchell; Gregory David,1,0,30,29
1656955507960,MATH 10A,A02,083736,Patchell; Gregory David,20,0,30,10
1656955507960,MATH 10A,A03,083737,Patchell; Gregory David,15,0,30,15
1656955513985,MATH 10B,A01,083207,Lim; Seonhee,7,0,34,27
1656955513985,MATH 10B,A02,083208,Lim; Seonhee,9,0,35,26
1656955513985,MATH 10B,A03,093472,Lim; Seonhee,4,0,34,30
1656955513985,MATH 10B,B01,083739,Sinha; Shubham,9,0,30,21
1656955520009,MATH 18,A01,083743,Cinel; Cameron Alexander,6,0,30,24
1656955520009,MATH 18,A02,083744,Cinel; Cameron Alexander,15,0,30,15
1656955520009,MATH 18,A03,083745,Cinel; Cameron Alexander,8,0,30,22
1656955520009,MATH 18,B01,083748,Rideout; David Porter,4,0,37,33
1656955520009,MATH 18,B02,083749,Rideout; David Porter,3,0,36,33
1656955520009,MATH 18,B03,083750,Rideout; David Porter,2,0,37,35
1656955520009,MATH 18,B04,083751,Rideout; David Porter,5,0,36,31
1656955520009,MATH 18,B05,093473,Rideout; David Porter,4,0,36,32
1656955520009,MATH 18,B06,093474,Rideout; David Porter,5,0,36,31
1656955526032,MATH 20A,A01,083754,Zheng; Zequn,12,0,40,28
1656955532062,MATH 20B,A01,083756,Briones; Jor-el Thomas Caparas,1,0,36,35
1656955532062,MATH 20B,A02,083757,Briones; Jor-el Thomas Caparas,1,0,36,35
1656955532062,MATH 20B,A03,093475,Briones; Jor-el Thomas Caparas,0,0,36,36
1656955538092,MATH 20C,A01,083760,Briones; Jor-el Thomas Caparas,1,0,35,34
1656955538092,MATH 20C,A02,083761,Briones; Jor-el Thomas Caparas,8,0,35,27
1656955538092,MATH 20C,A03,093476,Briones; Jor-el Thomas Caparas,0,1,36,36
1656955538092,MATH 20C,B01,083762,Bach; Quang Tran,0,0,30,30
1656955544122,MATH 20D,A01,083765,Tran; Brian Kha,4,0,30,26
1656955544122,MATH 20D,A02,083766,Tran; Brian Kha,4,0,30,26
1656955544122,MATH 20D,A03,083767,Tran; Brian Kha,3,0,30,27
1656955550145,MATH 20E,A01,083771,Ganguly; Soumya,5,0,32,27
1656955550145,MATH 20E,A02,083772,Ganguly; Soumya,6,0,32,26
1656955550145,MATH 20E,B01,083773,Ciotti; Benjamin,18,0,35,17
1656955550145,MATH 20E,B02,083774,Ciotti; Benjamin,17,0,35,18
1656955556175,MATH 103A,A01,083777,Greenfeld; Be'Eri,2,0,36,34
1656955556175,MATH 103A,A02,083778,Greenfeld; Be'Eri,5,0,36,31
1656955556175,MATH 103A,A03,093561,Greenfeld; Be'Eri,4,0,36,32
1656955556175,MATH 103A,B01,083779,Greenfeld; Be'Eri,6,0,36,30
1656955556175,MATH 103A,B02,083780,Greenfeld; Be'Eri,2,0,36,34
1656955556175,MATH 103A,B03,093562,Greenfeld; Be'Eri,2,0,36,34
1656955562200,MATH 105,A01,085443,Carter; Anne Toulson,14,0,35,21
1656955562200,MATH 105,A02,093477,Carter; Anne Toulson,20,0,35,15
1656955568228,MATH 109,A01,083213,Ganzberger; Geoffrey Michael,2,0,34,32
1656955568228,MATH 109,A02,083214,Ganzberger; Geoffrey Michael,2,0,34,32
1656955568228,MATH 109,A03,093478,Ganzberger; Geoffrey Michael,1,0,34,33
1656955568228,MATH 109,B01,083215,Ganzberger; Geoffrey Michael,1,0,32,31
1656955568228,MATH 109,B02,083216,Ganzberger; Geoffrey Michael,1,0,32,31
1656955568228,MATH 109,B03,093479,Ganzberger; Geoffrey Michael,6,0,32,26
1656955574259,MATH 142A,A01,083219,Chow; Bennett,6,0,32,26
1656955574259,MATH 142A,A02,083220,Chow; Bennett,10,0,32,22
1656955574259,MATH 142A,A03,093480,Chow; Bennett,7,0,32,25
1656955574259,MATH 142A,B03,093481,Chow; Bennett,7,0,32,25
1656955574259,MATH 142A,B04,093558,Chow; Bennett,11,0,32,21
1656955574259,MATH 142A,B05,093559,Chow; Bennett,6,0,32,26
1656955580287,MATH 193A,A01,083224,Rotar; Vladimir,7,0,34,27
1656955580287,MATH 193A,A02,083225,Rotar; Vladimir,4,0,34,30
1656955580287,MATH 193A,A03,083781,Rotar; Vladimir,1,0,34,33
1656955580287,MATH 193A,A04,083782,Rotar; Vladimir,6,0,34,28
1656955580287,MATH 193A,A05,093482,Rotar; Vladimir,6,0,34,28
1656955586311,MATH 197,001,091859,McAuley; Julian John,9999,0,9999,0
1656955586311,MATH 197,002,095566,Kedlaya; Kiran S.,9997,0,9999,2
1656955586311,MATH 197,003,095567,Xiao; Ming,9999,0,9999,0
1656955586311,MATH 197,004,095571,Perols; Johan Lars,9998,0,9999,1
1656955593366,COGS 9,A01,083615,Shannon; Kyle Michael,7,0,75,68
1656955599391,COGS 11,A01,083617,Boyle; Mary E. T.,19,0,48,29
1656955605413,COGS 13,A01,083071,Bastos; Amalia Pinkusfeld,9,0,71,62
1656955611438,COGS 14A,A01,092681,Semenuks; Arturs,0,1,100,100
1656955617462,COGS 14B,A01,083073,Cheng; Tzu-Han,5,0,63,58
1656955623484,COGS 17,A01,092677,Semenuks; Arturs,4,0,81,77
1656955629508,COGS 100,A01,083619,Allen; Michael Gordon,15,0,70,55
1656955635535,COGS 101A,A01,083621,Davis; Joshua Daniel,9,0,68,59
1656955641559,COGS 101B,A01,091572,Allen; Michael Gordon,8,0,65,57
1656955647582,COGS 101C,A01,083625,Delgado; Tania,17,0,35,18
1656955653608,COGS 107A,A01,083627,Boyle; Mary E. T.,13,0,60,47
1656955659631,COGS 118A,A01,083075,Gupta; Anjum,15,0,76,61
1656955665661,CSE 3,A50,083646,Miranda; Gregory Joseph,22,0,50,28
1656955671688,CSE 8A,A50,083650,Miranda; Gregory Joseph,17,1,56,39
1656955677714,CSE 11,A01,083080,Cao; Yingjun,4,15,40,36
1656955683737,CSE 12,A01,083652,Krause-Levy; Sophia Louisa,20,1,120,100
1656955689768,CSE 15L,A01,083654,Morris; Justin Loren,8,0,50,42
1656955689768,CSE 15L,A02,083655,Morris; Justin Loren,8,0,50,42
1656955695791,CSE 20,A01,083657,Tran; Khoa Dang,37,0,80,43
1656955701814,CSE 21,A01,095574,Bach; Quang Tran,21,0,48,27
1656955707839,CSE 30,A01,083084,Eldon; John,4,0,80,76
1656955707839,CSE 30,B01,095061,Bhaskar; Nishant,6,0,50,44
1656955713862,CSE 100,A01,083659,Cao; Yingjun,3,4,70,67
1656955719886,CSE 134B,A01,083661,Powell; Thomas Allan,19,0,100,81
1656955725910,CSE 140,A01,083663,Gungor; Onat,14,0,85,71
1656955731934,CSE 140L,A01,083088,Eldon; John,16,0,100,84
1656955737956,CSE 175,A01,083665,Kumar; Rakesh,3,0,25,22
1656955743982,CSE 190,A00,092507,Dubnov; Shlomo,7,0,20,13
1656955750004,ECE 45,A01,083139,Congero; Spencer William,5,0,75,70
1656955756027,ECE 65,A50,083695,Saad; Andrew S,12,0,30,18
1656955756027,ECE 65,A51,095125,Saad; Andrew S,25,0,26,1
1656955762049,ECE 109,A01,091882,Touri; Behrouz,16,0,70,54
1656955768076,ECE 180,A00,083140,Abi Samra; Nicholas Camill,0,0,30,30
1656955768076,ECE 180,B00,083141,Abi Samra; Nicholas Camill,0,0,30,30
1656955774102,MATH 10A,A01,083735,Patchell; Gregory David,1,0,30,29
1656955774102,MATH 10A,A02,083736,Patchell; Gregory David,20,0,30,10
1656955774102,MATH 10A,A03,083737,Patchell; Gregory David,15,0,30,15
1656955780134,MATH 10B,A01,083207,Lim; Seonhee,7,0,34,27
1656955780134,MATH 10B,A02,083208,Lim; Seonhee,9,0,35,26
1656955780134,MATH 10B,A03,093472,Lim; Seonhee,4,0,34,30
1656955780134,MATH 10B,B01,083739,Sinha; Shubham,9,0,30,21
1656955786159,MATH 18,A01,083743,Cinel; Cameron Alexander,6,0,30,24
1656955786159,MATH 18,A02,083744,Cinel; Cameron Alexander,15,0,30,15
1656955786159,MATH 18,A03,083745,Cinel; Cameron Alexander,8,0,30,22
1656955786159,MATH 18,B01,083748,Rideout; David Porter,4,0,37,33
1656955786159,MATH 18,B02,083749,Rideout; David Porter,3,0,36,33
1656955786159,MATH 18,B03,083750,Rideout; David Porter,2,0,37,35
1656955786159,MATH 18,B04,083751,Rideout; David Porter,5,0,36,31
1656955786159,MATH 18,B05,093473,Rideout; David Porter,4,0,36,32
1656955786159,MATH 18,B06,093474,Rideout; David Porter,5,0,36,31
1656955792182,MATH 20A,A01,083754,Zheng; Zequn,12,0,40,28
1656955798209,MATH 20B,A01,083756,Briones; Jor-el Thomas Caparas,1,0,36,35
1656955798209,MATH 20B,A02,083757,Briones; Jor-el Thomas Caparas,1,0,36,35
1656955798209,MATH 20B,A03,093475,Briones; Jor-el Thomas Caparas,0,0,36,36
1656955804231,MATH 20C,A01,083760,Briones; Jor-el Thomas Caparas,1,0,35,34
1656955804231,MATH 20C,A02,083761,Briones; Jor-el Thomas Caparas,8,0,35,27
1656955804231,MATH 20C,A03,093476,Briones; Jor-el Thomas Caparas,0,1,36,36
1656955804231,MATH 20C,B01,083762,Bach; Quang Tran,0,0,30,30
1656955810253,MATH 20D,A01,083765,Tran; Brian Kha,4,0,30,26
1656955810253,MATH 20D,A02,083766,Tran; Brian Kha,4,0,30,26
1656955810253,MATH 20D,A03,083767,Tran; Brian Kha,3,0,30,27
1656955816278,MATH 20E,A01,083771,Ganguly; Soumya,5,0,32,27
1656955816278,MATH 20E,A02,083772,Ganguly; Soumya,6,0,32,26
1656955816278,MATH 20E,B01,083773,Ciotti; Benjamin,18,0,35,17
1656955816278,MATH 20E,B02,083774,Ciotti; Benjamin,17,0,35,18
1656955822307,MATH 103A,A01,083777,Greenfeld; Be'Eri,2,0,36,34
1656955822307,MATH 103A,A02,083778,Greenfeld; Be'Eri,5,0,36,31
1656955822307,MATH 103A,A03,093561,Greenfeld; Be'Eri,4,0,36,32
1656955822307,MATH 103A,B01,083779,Greenfeld; Be'Eri,6,0,36,30
1656955822307,MATH 103A,B02,083780,Greenfeld; Be'Eri,2,0,36,34
1656955822307,MATH 103A,B03,093562,Greenfeld; Be'Eri,2,0,36,34
1656955828334,MATH 105,A01,085443,Carter; Anne Toulson,14,0,35,21
1656955828334,MATH 105,A02,093477,Carter; Anne Toulson,20,0,35,15
1656955834360,MATH 109,A01,083213,Ganzberger; Geoffrey Michael,2,0,34,32
1656955834360,MATH 109,A02,083214,Ganzberger; Geoffrey Michael,2,0,34,32
1656955834360,MATH 109,A03,093478,Ganzberger; Geoffrey Michael,1,0,34,33
1656955834360,MATH 109,B01,083215,Ganzberger; Geoffrey Michael,1,0,32,31
1656955834360,MATH 109,B02,083216,Ganzberger; Geoffrey Michael,1,0,32,31
1656955834360,MATH 109,B03,093479,Ganzberger; Geoffrey Michael,6,0,32,26
1656955840382,MATH 142A,A01,083219,Chow; Bennett,6,0,32,26
1656955840382,MATH 142A,A02,083220,Chow; Bennett,10,0,32,22
1656955840382,MATH 142A,A03,093480,Chow; Bennett,7,0,32,25
1656955840382,MATH 142A,B03,093481,Chow; Bennett,7,0,32,25
1656955840382,MATH 142A,B04,093558,Chow; Bennett,11,0,32,21
1656955840382,MATH 142A,B05,093559,Chow; Bennett,6,0,32,26
1656955846406,MATH 193A,A01,083224,Rotar; Vladimir,7,0,34,27
1656955846406,MATH 193A,A02,083225,Rotar; Vladimir,4,0,34,30
1656955846406,MATH 193A,A03,083781,Rotar; Vladimir,1,0,34,33
1656955846406,MATH 193A,A04,083782,Rotar; Vladimir,6,0,34,28
1656955846406,MATH 193A,A05,093482,Rotar; Vladimir,6,0,34,28
1656955852520,MATH 197,001,091859,McAuley; Julian John,9999,0,9999,0
1656955852520,MATH 197,002,095566,Kedlaya; Kiran S.,9997,0,9999,2
1656955852520,MATH 197,003,095567,Xiao; Ming,9999,0,9999,0
1656955852520,MATH 197,004,095571,Perols; Johan Lars,9998,0,9999,1
1656955859587,COGS 9,A01,083615,Shannon; Kyle Michael,7,0,75,68
1656955865611,COGS 11,A01,083617,Boyle; Mary E. T.,19,0,48,29
1656955871636,COGS 13,A01,083071,Bastos; Amalia Pinkusfeld,9,0,71,62
1656955877662,COGS 14A,A01,092681,Semenuks; Arturs,0,1,100,100
1656955883687,COGS 14B,A01,083073,Cheng; Tzu-Han,5,0,63,58
1656955889709,COGS 17,A01,092677,Semenuks; Arturs,4,0,81,77
1656955895731,COGS 100,A01,083619,Allen; Michael Gordon,15,0,70,55
1656955901759,COGS 101A,A01,083621,Davis; Joshua Daniel,9,0,68,59
1656955907782,COGS 101B,A01,091572,Allen; Michael Gordon,8,0,65,57
1656955913804,COGS 101C,A01,083625,Delgado; Tania,17,0,35,18
1656955919833,COGS 107A,A01,083627,Boyle; Mary E. T.,13,0,60,47
1656955925855,COGS 118A,A01,083075,Gupta; Anjum,15,0,76,61
1656955931888,CSE 3,A50,083646,Miranda; Gregory Joseph,22,0,50,28
1656955937916,CSE 8A,A50,083650,Miranda; Gregory Joseph,17,1,56,39
1656955943956,CSE 11,A01,083080,Cao; Yingjun,4,15,40,36
1656955949983,CSE 12,A01,083652,Krause-Levy; Sophia Louisa,20,1,120,100
1656955956007,CSE 15L,A01,083654,Morris; Justin Loren,8,0,50,42
1656955956007,CSE 15L,A02,083655,Morris; Justin Loren,8,0,50,42
1656955962035,CSE 20,A01,083657,Tran; Khoa Dang,37,0,80,43
1656955968059,CSE 21,A01,095574,Bach; Quang Tran,21,0,48,27
1656955974086,CSE 30,A01,083084,Eldon; John,4,0,80,76
1656955974086,CSE 30,B01,095061,Bhaskar; Nishant,6,0,50,44
1656955980114,CSE 100,A01,083659,Cao; Yingjun,3,4,70,67
1656955986145,CSE 134B,A01,083661,Powell; Thomas Allan,19,0,100,81
1656955992169,CSE 140,A01,083663,Gungor; Onat,14,0,85,71
1656955998191,CSE 140L,A01,083088,Eldon; John,16,0,100,84
1656956004214,CSE 175,A01,083665,Kumar; Rakesh,3,0,25,22
1656956010237,CSE 190,A00,092507,Dubnov; Shlomo,7,0,20,13
1656956016261,ECE 45,A01,083139,Congero; Spencer William,5,0,75,70
1656956022287,ECE 65,A50,083695,Saad; Andrew S,12,0,30,18
1656956022287,ECE 65,A51,095125,Saad; Andrew S,25,0,26,1
1656956028313,ECE 109,A01,091882,Touri; Behrouz,16,0,70,54
1656956034337,ECE 180,A00,083140,Abi Samra; Nicholas Camill,0,0,30,30
1656956034337,ECE 180,B00,083141,Abi Samra; Nicholas Camill,0,0,30,30
1656956040359,MATH 10A,A01,083735,Patchell; Gregory David,1,0,30,29
1656956040359,MATH 10A,A02,083736,Patchell; Gregory David,20,0,30,10
1656956040359,MATH 10A,A03,083737,Patchell; Gregory David,15,0,30,15
1656956046387,MATH 10B,A01,083207,Lim; Seonhee,7,0,34,27
1656956046387,MATH 10B,A02,083208,Lim; Seonhee,9,0,35,26
1656956046387,MATH 10B,A03,093472,Lim; Seonhee,4,0,34,30
1656956046387,MATH 10B,B01,083739,Sinha; Shubham,9,0,30,21
1656956052411,MATH 18,A01,083743,Cinel; Cameron Alexander,6,0,30,24
1656956052411,MATH 18,A02,083744,Cinel; Cameron Alexander,15,0,30,15
1656956052411,MATH 18,A03,083745,Cinel; Cameron Alexander,8,0,30,22
1656956052411,MATH 18,B01,083748,Rideout; David Porter,4,0,37,33
1656956052411,MATH 18,B02,083749,Rideout; David Porter,3,0,36,33
1656956052411,MATH 18,B03,083750,Rideout; David Porter,2,0,37,35
1656956052411,MATH 18,B04,083751,Rideout; David Porter,5,0,36,31
1656956052411,MATH 18,B05,093473,Rideout; David Porter,4,0,36,32
1656956052411,MATH 18,B06,093474,Rideout; David Porter,5,0,36,31
1656956058436,MATH 20A,A01,083754,Zheng; Zequn,12,0,40,28
1656956064469,MATH 20B,A01,083756,Briones; Jor-el Thomas Caparas,1,0,36,35
1656956064469,MATH 20B,A02,083757,Briones; Jor-el Thomas Caparas,1,0,36,35
1656956064469,MATH 20B,A03,093475,Briones; Jor-el Thomas Caparas,0,0,36,36
1656956070493,MATH 20C,A01,083760,Briones; Jor-el Thomas Caparas,1,0,35,34
1656956070493,MATH 20C,A02,083761,Briones; Jor-el Thomas Caparas,8,0,35,27
1656956070493,MATH 20C,A03,093476,Briones; Jor-el Thomas Caparas,0,1,36,36
1656956070493,MATH 20C,B01,083762,Bach; Quang Tran,0,0,30,30
1656956076518,MATH 20D,A01,083765,Tran; Brian Kha,4,0,30,26
1656956076518,MATH 20D,A02,083766,Tran; Brian Kha,4,0,30,26
1656956076518,MATH 20D,A03,083767,Tran; Brian Kha,3,0,30,27
1656956082545,MATH 20E,A01,083771,Ganguly; Soumya,5,0,32,27
1656956082545,MATH 20E,A02,083772,Ganguly; Soumya,6,0,32,26
1656956082545,MATH 20E,B01,083773,Ciotti; Benjamin,18,0,35,17
1656956082545,MATH 20E,B02,083774,Ciotti; Benjamin,17,0,35,18
1656956088570,MATH 103A,A01,083777,Greenfeld; Be'Eri,2,0,36,34
1656956088570,MATH 103A,A02,083778,Greenfeld; Be'Eri,5,0,36,31
1656956088570,MATH 103A,A03,093561,Greenfeld; Be'Eri,4,0,36,32
1656956088570,MATH 103A,B01,083779,Greenfeld; Be'Eri,6,0,36,30
1656956088570,MATH 103A,B02,083780,Greenfeld; Be'Eri,2,0,36,34
1656956088570,MATH 103A,B03,093562,Greenfeld; Be'Eri,2,0,36,34
1656956094594,MATH 105,A01,085443,Carter; Anne Toulson,14,0,35,21
1656956094594,MATH 105,A02,093477,Carter; Anne Toulson,20,0,35,15
1656956100624,MATH 109,A01,083213,Ganzberger; Geoffrey Michael,2,0,34,32
1656956100624,MATH 109,A02,083214,Ganzberger; Geoffrey Michael,2,0,34,32
1656956100624,MATH 109,A03,093478,Ganzberger; Geoffrey Michael,1,0,34,33
1656956100624,MATH 109,B01,083215,Ganzberger; Geoffrey Michael,1,0,32,31
1656956100624,MATH 109,B02,083216,Ganzberger; Geoffrey Michael,1,0,32,31
1656956100624,MATH 109,B03,093479,Ganzberger; Geoffrey Michael,6,0,32,26
1656956106653,MATH 142A,A01,083219,Chow; Bennett,6,0,32,26
1656956106653,MATH 142A,A02,083220,Chow; Bennett,10,0,32,22
1656956106653,MATH 142A,A03,093480,Chow; Bennett,7,0,32,25
1656956106653,MATH 142A,B03,093481,Chow; Bennett,7,0,32,25
1656956106653,MATH 142A,B04,093558,Chow; Bennett,11,0,32,21
1656956106653,MATH 142A,B05,093559,Chow; Bennett,6,0,32,26
1656956112676,MATH 193A,A01,083224,Rotar; Vladimir,7,0,34,27
1656956112676,MATH 193A,A02,083225,Rotar; Vladimir,4,0,34,30
1656956112676,MATH 193A,A03,083781,Rotar; Vladimir,1,0,34,33
1656956112676,MATH 193A,A04,083782,Rotar; Vladimir,6,0,34,28
1656956112676,MATH 193A,A05,093482,Rotar; Vladimir,6,0,34,28
1656956118700,MATH 197,001,091859,McAuley; Julian John,9999,0,9999,0
1656956118700,MATH 197,002,095566,Kedlaya; Kiran S.,9997,0,9999,2
1656956118700,MATH 197,003,095567,Xiao; Ming,9999,0,9999,0
1656956118700,MATH 197,004,095571,Perols; Johan Lars,9998,0,9999,1
1656956125753,COGS 9,A01,083615,Shannon; Kyle Michael,7,0,75,68
1656956131779,COGS 11,A01,083617,Boyle; Mary E. T.,19,0,48,29
1656956137804,COGS 13,A01,083071,Bastos; Amalia Pinkusfeld,9,0,71,62
1656956143830,COGS 14A,A01,092681,Semenuks; Arturs,0,1,100,100
1656956149854,COGS 14B,A01,083073,Cheng; Tzu-Han,5,0,63,58
1656956155877,COGS 17,A01,092677,Semenuks; Arturs,4,0,81,77
1656956161906,COGS 100,A01,083619,Allen; Michael Gordon,15,0,70,55
1656956167939,COGS 101A,A01,083621,Davis; Joshua Daniel,9,0,68,59
1656956173962,COGS 101B,A01,091572,Allen; Michael Gordon,8,0,65,57
1656956179984,COGS 101C,A01,083625,Delgado; Tania,17,0,35,18
1656956186015,COGS 107A,A01,083627,Boyle; Mary E. T.,13,0,60,47
1656956192042,COGS 118A,A01,083075,Gupta; Anjum,15,0,76,61
1656956198069,CSE 3,A50,083646,Miranda; Gregory Joseph,22,0,50,28
1656956204097,CSE 8A,A50,083650,Miranda; Gregory Joseph,17,1,56,39
1656956210121,CSE 11,A01,083080,Cao; Yingjun,4,15,40,36
1656956216161,CSE 12,A01,083652,Krause-Levy; Sophia Louisa,20,1,120,100
1656956222185,CSE 15L,A01,083654,Morris; Justin Loren,8,0,50,42
1656956222185,CSE 15L,A02,083655,Morris; Justin Loren,8,0,50,42
1656956228211,CSE 20,A01,083657,Tran; Khoa Dang,37,0,80,43
1656956234234,CSE 21,A01,095574,Bach; Quang Tran,21,0,48,27
1656956240258,CSE 30,A01,083084,Eldon; John,4,0,80,76
1656956240258,CSE 30,B01,095061,Bhaskar; Nishant,6,0,50,44
1656956246284,CSE 100,A01,083659,Cao; Yingjun,3,4,70,67
1656956252311,CSE 134B,A01,083661,Powell; Thomas Allan,19,0,100,81
1656956258338,CSE 140,A01,083663,Gungor; Onat,14,0,85,71
1656956264360,CSE 140L,A01,083088,Eldon; John,16,0,100,84
1656956270381,CSE 175,A01,083665,Kumar; Rakesh,3,0,25,22
1656956276407,CSE 190,A00,092507,Dubnov; Shlomo,7,0,20,13
1656956282431,ECE 45,A01,083139,Congero; Spencer William,5,0,75,70
1656956288457,ECE 65,A50,083695,Saad; Andrew S,12,0,30,18
1656956288457,ECE 65,A51,095125,Saad; Andrew S,25,0,26,1
1656956294480,ECE 109,A01,091882,Touri; Behrouz,16,0,70,54
1656956300504,ECE 180,A00,083140,Abi Samra; Nicholas Camill,0,0,30,30
1656956300504,ECE 180,B00,083141,Abi Samra; Nicholas Camill,0,0,30,30
1656956306527,MATH 10A,A01,083735,Patchell; Gregory David,1,0,30,29
1656956306527,MATH 10A,A02,083736,Patchell; Gregory David,20,0,30,10
1656956306527,MATH 10A,A03,083737,Patchell; Gregory David,15,0,30,15
1656956312549,MATH 10B,A01,083207,Lim; Seonhee,7,0,34,27
1656956312549,MATH 10B,A02,083208,Lim; Seonhee,9,0,35,26
1656956312549,MATH 10B,A03,093472,Lim; Seonhee,4,0,34,30
1656956312549,MATH 10B,B01,083739,Sinha; Shubham,9,0,30,21
1656956318580,MATH 18,A01,083743,Cinel; Cameron Alexander,6,0,30,24
1656956318580,MATH 18,A02,083744,Cinel; Cameron Alexander,15,0,30,15
1656956318580,MATH 18,A03,083745,Cinel; Cameron Alexander,8,0,30,22
1656956318580,MATH 18,B01,083748,Rideout; David Porter,4,0,37,33
1656956318580,MATH 18,B02,083749,Rideout; David Porter,3,0,36,33
1656956318580,MATH 18,B03,083750,Rideout; David Porter,2,0,37,35
1656956318580,MATH 18,B04,083751,Rideout; David Porter,5,0,36,31
1656956318580,MATH 18,B05,093473,Rideout; David Porter,4,0,36,32
1656956318580,MATH 18,B06,093474,Rideout; David Porter,5,0,36,31
1656956324603,MATH 20A,A01,083754,Zheng; Zequn,12,0,40,28
1656956330626,MATH 20B,A01,083756,Briones; Jor-el Thomas Caparas,1,0,36,35
1656956330626,MATH 20B,A02,083757,Briones; Jor-el Thomas Caparas,1,0,36,35
1656956330626,MATH 20B,A03,093475,Briones; Jor-el Thomas Caparas,0,0,36,36
1656956336654,MATH 20C,A01,083760,Briones; Jor-el Thomas Caparas,1,0,35,34
1656956336654,MATH 20C,A02,083761,Briones; Jor-el Thomas Caparas,8,0,35,27
1656956336654,MATH 20C,A03,093476,Briones; Jor-el Thomas Caparas,0,1,36,36
1656956336654,MATH 20C,B01,083762,Bach; Quang Tran,0,0,30,30
1656956346938,MATH 20D,A01,083765,Tran; Brian Kha,4,0,30,26
1656956346938,MATH 20D,A02,083766,Tran; Brian Kha,4,0,30,26
1656956346938,MATH 20D,A03,083767,Tran; Brian Kha,3,0,30,27
1656956352967,MATH 20E,A01,083771,Ganguly; Soumya,5,0,32,27
1656956352967,MATH 20E,A02,083772,Ganguly; Soumya,6,0,32,26
1656956352967,MATH 20E,B01,083773,Ciotti; Benjamin,18,0,35,17
1656956352967,MATH 20E,B02,083774,Ciotti; Benjamin,17,0,35,18
1656956359004,MATH 103A,A01,083777,Greenfeld; Be'Eri,2,0,36,34
1656956359004,MATH 103A,A02,083778,Greenfeld; Be'Eri,5,0,36,31
1656956359004,MATH 103A,A03,093561,Greenfeld; Be'Eri,4,0,36,32
1656956359004,MATH 103A,B01,083779,Greenfeld; Be'Eri,6,0,36,30
1656956359004,MATH 103A,B02,083780,Greenfeld; Be'Eri,2,0,36,34
1656956359004,MATH 103A,B03,093562,Greenfeld; Be'Eri,2,0,36,34
1656956365027,MATH 105,A01,085443,Carter; Anne Toulson,14,0,35,21
1656956365027,MATH 105,A02,093477,Carter; Anne Toulson,20,0,35,15
1656956371051,MATH 109,A01,083213,Ganzberger; Geoffrey Michael,2,0,34,32
1656956371051,MATH 109,A02,083214,Ganzberger; Geoffrey Michael,2,0,34,32
1656956371051,MATH 109,A03,093478,Ganzberger; Geoffrey Michael,1,0,34,33
1656956371051,MATH 109,B01,083215,Ganzberger; Geoffrey Michael,1,0,32,31
1656956371051,MATH 109,B02,083216,Ganzberger; Geoffrey Michael,1,0,32,31
1656956371051,MATH 109,B03,093479,Ganzberger; Geoffrey Michael,6,0,32,26
1656956377081,MATH 142A,A01,083219,Chow; Bennett,6,0,32,26
1656956377081,MATH 142A,A02,083220,Chow; Bennett,10,0,32,22
1656956377081,MATH 142A,A03,093480,Chow; Bennett,7,0,32,25
1656956377081,MATH 142A,B03,093481,Chow; Bennett,7,0,32,25
1656956377081,MATH 142A,B04,093558,Chow; Bennett,11,0,32,21
1656956377081,MATH 142A,B05,093559,Chow; Bennett,6,0,32,26
1656956383103,MATH 193A,A01,083224,Rotar; Vladimir,7,0,34,27
1656956383103,MATH 193A,A02,083225,Rotar; Vladimir,4,0,34,30
1656956383103,MATH 193A,A03,083781,Rotar; Vladimir,1,0,34,33
1656956383103,MATH 193A,A04,083782,Rotar; Vladimir,6,0,34,28
1656956383103,MATH 193A,A05,093482,Rotar; Vladimir,6,0,34,28
1656956389130,MATH 197,001,091859,McAuley; Julian John,9999,0,9999,0
1656956389130,MATH 197,002,095566,Kedlaya; Kiran S.,9997,0,9999,2
1656956389130,MATH 197,003,095567,Xiao; Ming,9999,0,9999,0
1656956389130,MATH 197,004,095571,Perols; Johan Lars,9998,0,9999,1
1656956396185,COGS 9,A01,083615,Shannon; Kyle Michael,7,0,75,68
1656956402213,COGS 11,A01,083617,Boyle; Mary E. T.,19,0,48,29
1656956408238,COGS 13,A01,083071,Bastos; Amalia Pinkusfeld,9,0,71,62
1656956414264,COGS 14A,A01,092681,Semenuks; Arturs,0,1,100,100
1656956420290,COGS 14B,A01,083073,Cheng; Tzu-Han,5,0,63,58
1656956426311,COGS 17,A01,092677,Semenuks; Arturs,4,0,81,77
1656956432338,COGS 100,A01,083619,Allen; Michael Gordon,15,0,70,55
1656956438366,COGS 101A,A01,083621,Davis; Joshua Daniel,9,0,68,59
1656956444389,COGS 101B,A01,091572,Allen; Michael Gordon,8,0,65,57
1656956450501,COGS 101C,A01,083625,Delgado; Tania,17,0,35,18
1656956456523,COGS 107A,A01,083627,Boyle; Mary E. T.,13,0,60,47
1656956462546,COGS 118A,A01,083075,Gupta; Anjum,15,0,76,61
1656956468571,CSE 3,A50,083646,Miranda; Gregory Joseph,22,0,50,28
1656956474599,CSE 8A,A50,083650,Miranda; Gregory Joseph,17,1,56,39
1656956480621,CSE 11,A01,083080,Cao; Yingjun,4,15,40,36
1656956486645,CSE 12,A01,083652,Krause-Levy; Sophia Louisa,20,1,120,100
1656956492670,CSE 15L,A01,083654,Morris; Justin Loren,8,0,50,42
1656956492670,CSE 15L,A02,083655,Morris; Justin Loren,8,0,50,42
1656956498693,CSE 20,A01,083657,Tran; Khoa Dang,37,0,80,43
1656956504720,CSE 21,A01,095574,Bach; Quang Tran,21,0,48,27
1656956510744,CSE 30,A01,083084,Eldon; John,4,0,80,76
1656956510744,CSE 30,B01,095061,Bhaskar; Nishant,6,0,50,44
1656956516771,CSE 100,A01,083659,Cao; Yingjun,3,4,70,67
1656956522794,CSE 134B,A01,083661,Powell; Thomas Allan,19,0,100,81
1656956528818,CSE 140,A01,083663,Gungor; Onat,14,0,85,71
1656956534847,CSE 140L,A01,083088,Eldon; John,16,0,100,84
1656956540869,CSE 175,A01,083665,Kumar; Rakesh,3,0,25,22
1656956546895,CSE 190,A00,092507,Dubnov; Shlomo,7,0,20,13
1656956552921,ECE 45,A01,083139,Congero; Spencer William,5,0,75,70
1656956558954,ECE 65,A50,083695,Saad; Andrew S,12,0,30,18
1656956558954,ECE 65,A51,095125,Saad; Andrew S,25,0,26,1
1656956564980,ECE 109,A01,091882,Touri; Behrouz,16,0,70,54
1656956571004,ECE 180,A00,083140,Abi Samra; Nicholas Camill,0,0,30,30
1656956571004,ECE 180,B00,083141,Abi Samra; Nicholas Camill,0,0,30,30
1656956577030,MATH 10A,A01,083735,Patchell; Gregory David,1,0,30,29
1656956577030,MATH 10A,A02,083736,Patchell; Gregory David,20,0,30,10
1656956577030,MATH 10A,A03,083737,Patchell; Gregory David,15,0,30,15
1656956583064,MATH 10B,A01,083207,Lim; Seonhee,7,0,34,27
1656956583064,MATH 10B,A02,083208,Lim; Seonhee,9,0,35,26
1656956583064,MATH 10B,A03,093472,Lim; Seonhee,4,0,34,30
1656956583064,MATH 10B,B01,083739,Sinha; Shubham,9,0,30,21
1656956589088,MATH 18,A01,083743,Cinel; Cameron Alexander,6,0,30,24
1656956589088,MATH 18,A02,083744,Cinel; Cameron Alexander,15,0,30,15
1656956589088,MATH 18,A03,083745,Cinel; Cameron Alexander,8,0,30,22
1656956589088,MATH 18,B01,083748,Rideout; David Porter,4,0,37,33
1656956589088,MATH 18,B02,083749,Rideout; David Porter,3,0,36,33
1656956589088,MATH 18,B03,083750,Rideout; David Porter,2,0,37,35
1656956589088,MATH 18,B04,083751,Rideout; David Porter,5,0,36,31
1656956589088,MATH 18,B05,093473,Rideout; David Porter,4,0,36,32
1656956589088,MATH 18,B06,093474,Rideout; David Porter,5,0,36,31
1656956595111,MATH 20A,A01,083754,Zheng; Zequn,12,0,40,28
1656956601138,MATH 20B,A01,083756,Briones; Jor-el Thomas Caparas,1,0,36,35
1656956601138,MATH 20B,A02,083757,Briones; Jor-el Thomas Caparas,1,0,36,35
1656956601138,MATH 20B,A03,093475,Briones; Jor-el Thomas Caparas,0,0,36,36
1656956607166,MATH 20C,A01,083760,Briones; Jor-el Thomas Caparas,1,0,35,34
1656956607166,MATH 20C,A02,083761,Briones; Jor-el Thomas Caparas,8,0,35,27
1656956607166,MATH 20C,A03,093476,Briones; Jor-el Thomas Caparas,0,1,36,36
1656956607166,MATH 20C,B01,083762,Bach; Quang Tran,0,0,30,30
1656956613195,MATH 20D,A01,083765,Tran; Brian Kha,4,0,30,26
1656956613195,MATH 20D,A02,083766,Tran; Brian Kha,4,0,30,26
1656956613195,MATH 20D,A03,083767,Tran; Brian Kha,3,0,30,27
1656956619218,MATH 20E,A01,083771,Ganguly; Soumya,5,0,32,27
1656956619218,MATH 20E,A02,083772,Ganguly; Soumya,6,0,32,26
1656956619218,MATH 20E,B01,083773,Ciotti; Benjamin,18,0,35,17
1656956619218,MATH 20E,B02,083774,Ciotti; Benjamin,17,0,35,18
1656956625244,MATH 103A,A01,083777,Greenfeld; Be'Eri,2,0,36,34
1656956625244,MATH 103A,A02,083778,Greenfeld; Be'Eri,5,0,36,31
1656956625244,MATH 103A,A03,093561,Greenfeld; Be'Eri,4,0,36,32
1656956625244,MATH 103A,B01,083779,Greenfeld; Be'Eri,6,0,36,30
1656956625244,MATH 103A,B02,083780,Greenfeld; Be'Eri,2,0,36,34
1656956625244,MATH 103A,B03,093562,Greenfeld; Be'Eri,2,0,36,34
1656956631266,MATH 105,A01,085443,Carter; Anne Toulson,14,0,35,21
1656956631266,MATH 105,A02,093477,Carter; Anne Toulson,20,0,35,15
1656956637291,MATH 109,A01,083213,Ganzberger; Geoffrey Michael,2,0,34,32
1656956637291,MATH 109,A02,083214,Ganzberger; Geoffrey Michael,2,0,34,32
1656956637291,MATH 109,A03,093478,Ganzberger; Geoffrey Michael,1,0,34,33
1656956637291,MATH 109,B01,083215,Ganzberger; Geoffrey Michael,1,0,32,31
1656956637291,MATH 109,B02,083216,Ganzberger; Geoffrey Michael,1,0,32,31
1656956637291,MATH 109,B03,093479,Ganzberger; Geoffrey Michael,6,0,32,26
1656956643316,MATH 142A,A01,083219,Chow; Bennett,6,0,32,26
1656956643316,MATH 142A,A02,083220,Chow; Bennett,10,0,32,22
1656956643316,MATH 142A,A03,093480,Chow; Bennett,7,0,32,25
1656956643316,MATH 142A,B03,093481,Chow; Bennett,7,0,32,25
1656956643316,MATH 142A,B04,093558,Chow; Bennett,11,0,32,21
1656956643316,MATH 142A,B05,093559,Chow; Bennett,6,0,32,26
1656956649340,MATH 193A,A01,083224,Rotar; Vladimir,7,0,34,27
1656956649340,MATH 193A,A02,083225,Rotar; Vladimir,4,0,34,30
1656956649340,MATH 193A,A03,083781,Rotar; Vladimir,1,0,34,33
1656956649340,MATH 193A,A04,083782,Rotar; Vladimir,6,0,34,28
1656956649340,MATH 193A,A05,093482,Rotar; Vladimir,6,0,34,28
1656956655368,MATH 197,001,091859,McAuley; Julian John,9999,0,9999,0
1656956655368,MATH 197,002,095566,Kedlaya; Kiran S.,9997,0,9999,2
1656956655368,MATH 197,003,095567,Xiao; Ming,9999,0,9999,0
1656956655368,MATH 197,004,095571,Perols; Johan Lars,9998,0,9999,1
1656956662448,COGS 9,A01,083615,Shannon; Kyle Michael,7,0,75,68
1656956668475,COGS 11,A01,083617,Boyle; Mary E. T.,19,0,48,29
1656956674500,COGS 13,A01,083071,Bastos; Amalia Pinkusfeld,9,0,71,62
1656956680534,COGS 14A,A01,092681,Semenuks; Arturs,0,1,100,100
1656956686557,COGS 14B,A01,083073,Cheng; Tzu-Han,5,0,63,58
1656956692585,COGS 17,A01,092677,Semenuks; Arturs,4,0,81,77
1656956698611,COGS 100,A01,083619,Allen; Michael Gordon,15,0,70,55
1656956704632,COGS 101A,A01,083621,Davis; Joshua Daniel,9,0,68,59
1656956710655,COGS 101B,A01,091572,Allen; Michael Gordon,8,0,65,57
1656956716676,COGS 101C,A01,083625,Delgado; Tania,17,0,35,18
1656956722699,COGS 107A,A01,083627,Boyle; Mary E. T.,13,0,60,47
1656956728721,COGS 118A,A01,083075,Gupta; Anjum,15,0,76,61
1656956734746,CSE 3,A50,083646,Miranda; Gregory Joseph,22,0,50,28
1656956740773,CSE 8A,A50,083650,Miranda; Gregory Joseph,17,1,56,39
1656956746799,CSE 11,A01,083080,Cao; Yingjun,4,15,40,36
1656956752821,CSE 12,A01,083652,Krause-Levy; Sophia Louisa,20,1,120,100
1656956758844,CSE 15L,A01,083654,Morris; Justin Loren,8,0,50,42
1656956758844,CSE 15L,A02,083655,Morris; Justin Loren,8,0,50,42
1656956764867,CSE 20,A01,083657,Tran; Khoa Dang,37,0,80,43
1656956770891,CSE 21,A01,095574,Bach; Quang Tran,21,0,48,27
1656956776918,CSE 30,A01,083084,Eldon; John,4,0,80,76
1656956776918,CSE 30,B01,095061,Bhaskar; Nishant,6,0,50,44
1656956782940,CSE 100,A01,083659,Cao; Yingjun,3,4,70,67
1656956788966,CSE 134B,A01,083661,Powell; Thomas Allan,19,0,100,81
1656956794995,CSE 140,A01,083663,Gungor; Onat,14,0,85,71
1656956801043,CSE 140L,A01,083088,Eldon; John,16,0,100,84
1656956807069,CSE 175,A01,083665,Kumar; Rakesh,3,0,25,22
1656956813094,CSE 190,A00,092507,Dubnov; Shlomo,7,0,20,13
1656956819117,ECE 45,A01,083139,Congero; Spencer William,5,0,75,70
1656956825140,ECE 65,A50,083695,Saad; Andrew S,12,0,30,18
1656956825140,ECE 65,A51,095125,Saad; Andrew S,25,0,26,1
1656956831168,ECE 109,A01,091882,Touri; Behrouz,16,0,70,54
1656956837195,ECE 180,A00,083140,Abi Samra; Nicholas Camill,0,0,30,30
1656956837195,ECE 180,B00,083141,Abi Samra; Nicholas Camill,0,0,30,30
1656956843219,MATH 10A,A01,083735,Patchell; Gregory David,1,0,30,29
1656956843219,MATH 10A,A02,083736,Patchell; Gregory David,20,0,30,10
1656956843219,MATH 10A,A03,083737,Patchell; Gregory David,15,0,30,15
1656956849247,MATH 10B,A01,083207,Lim; Seonhee,7,0,34,27
1656956849247,MATH 10B,A02,083208,Lim; Seonhee,9,0,35,26
1656956849247,MATH 10B,A03,093472,Lim; Seonhee,4,0,34,30
1656956849247,MATH 10B,B01,083739,Sinha; Shubham,9,0,30,21
1656956855278,MATH 18,A01,083743,Cinel; Cameron Alexander,6,0,30,24
1656956855278,MATH 18,A02,083744,Cinel; Cameron Alexander,15,0,30,15
1656956855278,MATH 18,A03,083745,Cinel; Cameron Alexander,8,0,30,22
1656956855278,MATH 18,B01,083748,Rideout; David Porter,4,0,37,33
1656956855278,MATH 18,B02,083749,Rideout; David Porter,3,0,36,33
1656956855278,MATH 18,B03,083750,Rideout; David Porter,2,0,37,35
1656956855278,MATH 18,B04,083751,Rideout; David Porter,5,0,36,31
1656956855278,MATH 18,B05,093473,Rideout; David Porter,4,0,36,32
1656956855278,MATH 18,B06,093474,Rideout; David Porter,5,0,36,31
1656956861305,MATH 20A,A01,083754,Zheng; Zequn,12,0,40,28
1656956867333,MATH 20B,A01,083756,Briones; Jor-el Thomas Caparas,1,0,36,35
1656956867333,MATH 20B,A02,083757,Briones; Jor-el Thomas Caparas,1,0,36,35
1656956867333,MATH 20B,A03,093475,Briones; Jor-el Thomas Caparas,0,0,36,36
1656956873365,MATH 20C,A01,083760,Briones; Jor-el Thomas Caparas,1,0,35,34
1656956873365,MATH 20C,A02,083761,Briones; Jor-el Thomas Caparas,8,0,35,27
1656956873365,MATH 20C,A03,093476,Briones; Jor-el Thomas Caparas,0,1,36,36
1656956873365,MATH 20C,B01,083762,Bach; Quang Tran,0,0,30,30
1656956879390,MATH 20D,A01,083765,Tran; Brian Kha,4,0,30,26
1656956879390,MATH 20D,A02,083766,Tran; Brian Kha,4,0,30,26
1656956879390,MATH 20D,A03,083767,Tran; Brian Kha,3,0,30,27
1656956885415,MATH 20E,A01,083771,Ganguly; Soumya,5,0,32,27
1656956885415,MATH 20E,A02,083772,Ganguly; Soumya,6,0,32,26
1656956885415,MATH 20E,B01,083773,Ciotti; Benjamin,18,0,35,17
1656956885415,MATH 20E,B02,083774,Ciotti; Benjamin,17,0,35,18
1656956891438,MATH 103A,A01,083777,Greenfeld; Be'Eri,2,0,36,34
1656956891438,MATH 103A,A02,083778,Greenfeld; Be'Eri,5,0,36,31
1656956891438,MATH 103A,A03,093561,Greenfeld; Be'Eri,4,0,36,32
1656956891438,MATH 103A,B01,083779,Greenfeld; Be'Eri,6,0,36,30
1656956891438,MATH 103A,B02,083780,Greenfeld; Be'Eri,2,0,36,34
1656956891438,MATH 103A,B03,093562,Greenfeld; Be'Eri,2,0,36,34
1656956897467,MATH 105,A01,085443,Carter; Anne Toulson,14,0,35,21
1656956897467,MATH 105,A02,093477,Carter; Anne Toulson,20,0,35,15
1656956903499,MATH 109,A01,083213,Ganzberger; Geoffrey Michael,2,0,34,32
1656956903499,MATH 109,A02,083214,Ganzberger; Geoffrey Michael,2,0,34,32
1656956903499,MATH 109,A03,093478,Ganzberger; Geoffrey Michael,1,0,34,33
1656956903499,MATH 109,B01,083215,Ganzberger; Geoffrey Michael,1,0,32,31
1656956903499,MATH 109,B02,083216,Ganzberger; Geoffrey Michael,1,0,32,31
1656956903499,MATH 109,B03,093479,Ganzberger; Geoffrey Michael,6,0,32,26
1656956909529,MATH 142A,A01,083219,Chow; Bennett,6,0,32,26
1656956909529,MATH 142A,A02,083220,Chow; Bennett,10,0,32,22
1656956909529,MATH 142A,A03,093480,Chow; Bennett,7,0,32,25
1656956909529,MATH 142A,B03,093481,Chow; Bennett,7,0,32,25
1656956909529,MATH 142A,B04,093558,Chow; Bennett,11,0,32,21
1656956909529,MATH 142A,B05,093559,Chow; Bennett,6,0,32,26
1656956915552,MATH 193A,A01,083224,Rotar; Vladimir,7,0,34,27
1656956915552,MATH 193A,A02,083225,Rotar; Vladimir,4,0,34,30
1656956915552,MATH 193A,A03,083781,Rotar; Vladimir,1,0,34,33
1656956915552,MATH 193A,A04,083782,Rotar; Vladimir,6,0,34,28
1656956915552,MATH 193A,A05,093482,Rotar; Vladimir,6,0,34,28
1656956921575,MATH 197,001,091859,McAuley; Julian John,9999,0,9999,0
1656956921575,MATH 197,002,095566,Kedlaya; Kiran S.,9997,0,9999,2
1656956921575,MATH 197,003,095567,Xiao; Ming,9999,0,9999,0
1656956921575,MATH 197,004,095571,Perols; Johan Lars,9998,0,9999,1
1656956928645,COGS 9,A01,083615,Shannon; Kyle Michael,7,0,75,68
1656956934681,COGS 11,A01,083617,Boyle; Mary E. T.,19,0,48,29
1656956940707,COGS 13,A01,083071,Bastos; Amalia Pinkusfeld,9,0,71,62
1656956946732,COGS 14A,A01,092681,Semenuks; Arturs,0,1,100,100
1656956952759,COGS 14B,A01,083073,Cheng; Tzu-Han,5,0,63,58
1656956958783,COGS 17,A01,092677,Semenuks; Arturs,4,0,81,77
1656956964809,COGS 100,A01,083619,Allen; Michael Gordon,15,0,70,55
1656956970834,COGS 101A,A01,083621,Davis; Joshua Daniel,9,0,68,59
1656956976864,COGS 101B,A01,091572,Allen; Michael Gordon,8,0,65,57
1656956982887,COGS 101C,A01,083625,Delgado; Tania,17,0,35,18
1656956988914,COGS 107A,A01,083627,Boyle; Mary E. T.,13,0,60,47
1656956994945,COGS 118A,A01,083075,Gupta; Anjum,15,0,76,61
1656957000968,CSE 3,A50,083646,Miranda; Gregory Joseph,22,0,50,28
1656957006990,CSE 8A,A50,083650,Miranda; Gregory Joseph,17,1,56,39
1656957013014,CSE 11,A01,083080,Cao; Yingjun,4,15,40,36
1656957019039,CSE 12,A01,083652,Krause-Levy; Sophia Louisa,20,1,120,100
1656957025062,CSE 15L,A01,083654,Morris; Justin Loren,8,0,50,42
1656957025062,CSE 15L,A02,083655,Morris; Justin Loren,8,0,50,42
1656957031089,CSE 20,A01,083657,Tran; Khoa Dang,37,0,80,43
1656957037115,CSE 21,A01,095574,Bach; Quang Tran,21,0,48,27
1656957043140,CSE 30,A01,083084,Eldon; John,4,0,80,76
1656957043140,CSE 30,B01,095061,Bhaskar; Nishant,6,0,50,44
1656957049241,CSE 100,A01,083659,Cao; Yingjun,3,4,70,67
1656957055265,CSE 134B,A01,083661,Powell; Thomas Allan,19,0,100,81
1656957061296,CSE 140,A01,083663,Gungor; Onat,14,0,85,71
1656957067320,CSE 140L,A01,083088,Eldon; John,16,0,100,84
1656957073346,CSE 175,A01,083665,Kumar; Rakesh,3,0,25,22
1656957079373,CSE 190,A00,092507,Dubnov; Shlomo,7,0,20,13
1656957085401,ECE 45,A01,083139,Congero; Spencer William,5,0,75,70
1656957091427,ECE 65,A50,083695,Saad; Andrew S,12,0,30,18
1656957091427,ECE 65,A51,095125,Saad; Andrew S,25,0,26,1
1656957097450,ECE 109,A01,091882,Touri; Behrouz,16,0,70,54
1656957103474,ECE 180,A00,083140,Abi Samra; Nicholas Camill,0,0,30,30
1656957103474,ECE 180,B00,083141,Abi Samra; Nicholas Camill,0,0,30,30
1656957109498,MATH 10A,A01,083735,Patchell; Gregory David,1,0,30,29
1656957109498,MATH 10A,A02,083736,Patchell; Gregory David,20,0,30,10
1656957109498,MATH 10A,A03,083737,Patchell; Gregory David,15,0,30,15
1656957115527,MATH 10B,A01,083207,Lim; Seonhee,7,0,34,27
1656957115527,MATH 10B,A02,083208,Lim; Seonhee,9,0,35,26
1656957115527,MATH 10B,A03,093472,Lim; Seonhee,4,0,34,30
1656957115527,MATH 10B,B01,083739,Sinha; Shubham,9,0,30,21
1656957121558,MATH 18,A01,083743,Cinel; Cameron Alexander,6,0,30,24
1656957121558,MATH 18,A02,083744,Cinel; Cameron Alexander,15,0,30,15
1656957121558,MATH 18,A03,083745,Cinel; Cameron Alexander,8,0,30,22
1656957121558,MATH 18,B01,083748,Rideout; David Porter,4,0,37,33
1656957121558,MATH 18,B02,083749,Rideout; David Porter,3,0,36,33
1656957121558,MATH 18,B03,083750,Rideout; David Porter,2,0,37,35
1656957121558,MATH 18,B04,083751,Rideout; David Porter,5,0,36,31
1656957121558,MATH 18,B05,093473,Rideout; David Porter,4,0,36,32
1656957121558,MATH 18,B06,093474,Rideout; David Porter,5,0,36,31
1656957127586,MATH 20A,A01,083754,Zheng; Zequn,12,0,40,28
1656957133608,MATH 20B,A01,083756,Briones; Jor-el Thomas Caparas,1,0,36,35
1656957133608,MATH 20B,A02,083757,Briones; Jor-el Thomas Caparas,1,0,36,35
1656957133608,MATH 20B,A03,093475,Briones; Jor-el Thomas Caparas,0,0,36,36
1656957139632,MATH 20C,A01,083760,Briones; Jor-el Thomas Caparas,1,0,35,34
1656957139632,MATH 20C,A02,083761,Briones; Jor-el Thomas Caparas,8,0,35,27
1656957139632,MATH 20C,A03,093476,Briones; Jor-el Thomas Caparas,0,1,36,36
1656957139632,MATH 20C,B01,083762,Bach; Quang Tran,0,0,30,30
1656957145656,MATH 20D,A01,083765,Tran; Brian Kha,4,0,30,26
1656957145656,MATH 20D,A02,083766,Tran; Brian Kha,4,0,30,26
1656957145656,MATH 20D,A03,083767,Tran; Brian Kha,3,0,30,27
1656957151685,MATH 20E,A01,083771,Ganguly; Soumya,5,0,32,27
1656957151685,MATH 20E,A02,083772,Ganguly; Soumya,6,0,32,26
1656957151685,MATH 20E,B01,083773,Ciotti; Benjamin,18,0,35,17
1656957151685,MATH 20E,B02,083774,Ciotti; Benjamin,17,0,35,18
1656957157712,MATH 103A,A01,083777,Greenfeld; Be'Eri,2,0,36,34
1656957157712,MATH 103A,A02,083778,Greenfeld; Be'Eri,5,0,36,31
1656957157712,MATH 103A,A03,093561,Greenfeld; Be'Eri,4,0,36,32
1656957157712,MATH 103A,B01,083779,Greenfeld; Be'Eri,6,0,36,30
1656957157712,MATH 103A,B02,083780,Greenfeld; Be'Eri,2,0,36,34
1656957157712,MATH 103A,B03,093562,Greenfeld; Be'Eri,2,0,36,34
1656957163737,MATH 105,A01,085443,Carter; Anne Toulson,14,0,35,21
1656957163737,MATH 105,A02,093477,Carter; Anne Toulson,20,0,35,15
1656957169763,MATH 109,A01,083213,Ganzberger; Geoffrey Michael,2,0,34,32
1656957169763,MATH 109,A02,083214,Ganzberger; Geoffrey Michael,2,0,34,32
1656957169763,MATH 109,A03,093478,Ganzberger; Geoffrey Michael,1,0,34,33
1656957169763,MATH 109,B01,083215,Ganzberger; Geoffrey Michael,1,0,32,31
1656957169763,MATH 109,B02,083216,Ganzberger; Geoffrey Michael,1,0,32,31
1656957169763,MATH 109,B03,093479,Ganzberger; Geoffrey Michael,6,0,32,26
1656957175791,MATH 142A,A01,083219,Chow; Bennett,6,0,32,26
1656957175791,MATH 142A,A02,083220,Chow; Bennett,10,0,32,22
1656957175791,MATH 142A,A03,093480,Chow; Bennett,7,0,32,25
1656957175791,MATH 142A,B03,093481,Chow; Bennett,7,0,32,25
1656957175791,MATH 142A,B04,093558,Chow; Bennett,11,0,32,21
1656957175791,MATH 142A,B05,093559,Chow; Bennett,6,0,32,26
1656957181815,MATH 193A,A01,083224,Rotar; Vladimir,7,0,34,27
1656957181815,MATH 193A,A02,083225,Rotar; Vladimir,4,0,34,30
1656957181815,MATH 193A,A03,083781,Rotar; Vladimir,1,0,34,33
1656957181815,MATH 193A,A04,083782,Rotar; Vladimir,6,0,34,28
1656957181815,MATH 193A,A05,093482,Rotar; Vladimir,6,0,34,28
1656957187838,MATH 197,001,091859,McAuley; Julian John,9999,0,9999,0
1656957187838,MATH 197,002,095566,Kedlaya; Kiran S.,9997,0,9999,2
1656957187838,MATH 197,003,095567,Xiao; Ming,9999,0,9999,0
1656957187838,MATH 197,004,095571,Perols; Johan Lars,9998,0,9999,1
1656957194890,COGS 9,A01,083615,Shannon; Kyle Michael,7,0,75,68
1656957200914,COGS 11,A01,083617,Boyle; Mary E. T.,19,0,48,29
1656957206943,COGS 13,A01,083071,Bastos; Amalia Pinkusfeld,9,0,71,62
1656957212966,COGS 14A,A01,092681,Semenuks; Arturs,0,1,100,100
1656957218989,COGS 14B,A01,083073,Cheng; Tzu-Han,5,0,63,58
1656957225010,COGS 17,A01,092677,Semenuks; Arturs,4,0,81,77
1656957231032,COGS 100,A01,083619,Allen; Michael Gordon,15,0,70,55
1656957237056,COGS 101A,A01,083621,Davis; Joshua Daniel,9,0,68,59
1656957243091,COGS 101B,A01,091572,Allen; Michael Gordon,8,0,65,57
1656957249112,COGS 101C,A01,083625,Delgado; Tania,17,0,35,18
1656957255136,COGS 107A,A01,083627,Boyle; Mary E. T.,13,0,60,47
1656957261165,COGS 118A,A01,083075,Gupta; Anjum,15,0,76,61
1656957267194,CSE 3,A50,083646,Miranda; Gregory Joseph,22,0,50,28
1656957273221,CSE 8A,A50,083650,Miranda; Gregory Joseph,17,1,56,39
1656957279249,CSE 11,A01,083080,Cao; Yingjun,4,15,40,36
1656957285273,CSE 12,A01,083652,Krause-Levy; Sophia Louisa,20,1,120,100
1656957291297,CSE 15L,A01,083654,Morris; Justin Loren,8,0,50,42
1656957291297,CSE 15L,A02,083655,Morris; Justin Loren,8,0,50,42
1656957297324,CSE 20,A01,083657,Tran; Khoa Dang,37,0,80,43
1656957303348,CSE 21,A01,095574,Bach; Quang Tran,21,0,48,27
1656957309374,CSE 30,A01,083084,Eldon; John,4,0,80,76
1656957309374,CSE 30,B01,095061,Bhaskar; Nishant,6,0,50,44
1656957315397,CSE 100,A01,083659,Cao; Yingjun,3,4,70,67
1656957321424,CSE 134B,A01,083661,Powell; Thomas Allan,19,0,100,81
1656957327457,CSE 140,A01,083663,Gungor; Onat,14,0,85,71
1656957333485,CSE 140L,A01,083088,Eldon; John,16,0,100,84
1656957339515,CSE 175,A01,083665,Kumar; Rakesh,3,0,25,22
1656957345538,CSE 190,A00,092507,Dubnov; Shlomo,7,0,20,13
1656957351561,ECE 45,A01,083139,Congero; Spencer William,5,0,75,70
1656957357584,ECE 65,A50,083695,Saad; Andrew S,12,0,30,18
1656957357584,ECE 65,A51,095125,Saad; Andrew S,25,0,26,1
1656957363607,ECE 109,A01,091882,Touri; Behrouz,16,0,70,54
1656957369630,ECE 180,A00,083140,Abi Samra; Nicholas Camill,0,0,30,30
1656957369630,ECE 180,B00,083141,Abi Samra; Nicholas Camill,0,0,30,30
1656957375674,MATH 10A,A01,083735,Patchell; Gregory David,1,0,30,29
1656957375674,MATH 10A,A02,083736,Patchell; Gregory David,20,0,30,10
1656957375674,MATH 10A,A03,083737,Patchell; Gregory David,15,0,30,15
1656957381704,MATH 10B,A01,083207,Lim; Seonhee,7,0,34,27
1656957381704,MATH 10B,A02,083208,Lim; Seonhee,9,0,35,26
1656957381704,MATH 10B,A03,093472,Lim; Seonhee,4,0,34,30
1656957381704,MATH 10B,B01,083739,Sinha; Shubham,9,0,30,21
1656957387735,MATH 18,A01,083743,Cinel; Cameron Alexander,6,0,30,24
1656957387735,MATH 18,A02,083744,Cinel; Cameron Alexander,15,0,30,15
1656957387735,MATH 18,A03,083745,Cinel; Cameron Alexander,8,0,30,22
1656957387735,MATH 18,B01,083748,Rideout; David Porter,4,0,37,33
1656957387735,MATH 18,B02,083749,Rideout; David Porter,3,0,36,33
1656957387735,MATH 18,B03,083750,Rideout; David Porter,2,0,37,35
1656957387735,MATH 18,B04,083751,Rideout; David Porter,5,0,36,31
1656957387735,MATH 18,B05,093473,Rideout; David Porter,4,0,36,32
1656957387735,MATH 18,B06,093474,Rideout; David Porter,5,0,36,31
1656957393759,MATH 20A,A01,083754,Zheng; Zequn,12,0,40,28
1656957399780,MATH 20B,A01,083756,Briones; Jor-el Thomas Caparas,1,0,36,35
1656957399780,MATH 20B,A02,083757,Briones; Jor-el Thomas Caparas,1,0,36,35
1656957399780,MATH 20B,A03,093475,Briones; Jor-el Thomas Caparas,0,0,36,36
1656957405809,MATH 20C,A01,083760,Briones; Jor-el Thomas Caparas,1,0,35,34
1656957405809,MATH 20C,A02,083761,Briones; Jor-el Thomas Caparas,8,0,35,27
1656957405809,MATH 20C,A03,093476,Briones; Jor-el Thomas Caparas,0,1,36,36
1656957405809,MATH 20C,B01,083762,Bach; Quang Tran,0,0,30,30
1656957411838,MATH 20D,A01,083765,Tran; Brian Kha,4,0,30,26
1656957411838,MATH 20D,A02,083766,Tran; Brian Kha,4,0,30,26
1656957411838,MATH 20D,A03,083767,Tran; Brian Kha,3,0,30,27
1656957417866,MATH 20E,A01,083771,Ganguly; Soumya,5,0,32,27
1656957417866,MATH 20E,A02,083772,Ganguly; Soumya,6,0,32,26
1656957417866,MATH 20E,B01,083773,Ciotti; Benjamin,18,0,35,17
1656957417866,MATH 20E,B02,083774,Ciotti; Benjamin,17,0,35,18
1656957423894,MATH 103A,A01,083777,Greenfeld; Be'Eri,2,0,36,34
1656957423894,MATH 103A,A02,083778,Greenfeld; Be'Eri,5,0,36,31
1656957423894,MATH 103A,A03,093561,Greenfeld; Be'Eri,4,0,36,32
1656957423894,MATH 103A,B01,083779,Greenfeld; Be'Eri,6,0,36,30
1656957423894,MATH 103A,B02,083780,Greenfeld; Be'Eri,2,0,36,34
1656957423894,MATH 103A,B03,093562,Greenfeld; Be'Eri,2,0,36,34
1656957429918,MATH 105,A01,085443,Carter; Anne Toulson,14,0,35,21
1656957429918,MATH 105,A02,093477,Carter; Anne Toulson,20,0,35,15
1656957435949,MATH 109,A01,083213,Ganzberger; Geoffrey Michael,2,0,34,32
1656957435949,MATH 109,A02,083214,Ganzberger; Geoffrey Michael,2,0,34,32
1656957435949,MATH 109,A03,093478,Ganzberger; Geoffrey Michael,1,0,34,33
1656957435949,MATH 109,B01,083215,Ganzberger; Geoffrey Michael,1,0,32,31
1656957435949,MATH 109,B02,083216,Ganzberger; Geoffrey Michael,1,0,32,31
1656957435949,MATH 109,B03,093479,Ganzberger; Geoffrey Michael,6,0,32,26
1656957441972,MATH 142A,A01,083219,Chow; Bennett,6,0,32,26
1656957441972,MATH 142A,A02,083220,Chow; Bennett,10,0,32,22
1656957441972,MATH 142A,A03,093480,Chow; Bennett,7,0,32,25
1656957441972,MATH 142A,B03,093481,Chow; Bennett,7,0,32,25
1656957441972,MATH 142A,B04,093558,Chow; Bennett,11,0,32,21
1656957441972,MATH 142A,B05,093559,Chow; Bennett,6,0,32,26
1656957447999,MATH 193A,A01,083224,Rotar; Vladimir,7,0,34,27
1656957447999,MATH 193A,A02,083225,Rotar; Vladimir,4,0,34,30
1656957447999,MATH 193A,A03,083781,Rotar; Vladimir,1,0,34,33
1656957447999,MATH 193A,A04,083782,Rotar; Vladimir,6,0,34,28
1656957447999,MATH 193A,A05,093482,Rotar; Vladimir,6,0,34,28
1656957454022,MATH 197,001,091859,McAuley; Julian John,9999,0,9999,0
1656957454022,MATH 197,002,095566,Kedlaya; Kiran S.,9997,0,9999,2
1656957454022,MATH 197,003,095567,Xiao; Ming,9999,0,9999,0
1656957454022,MATH 197,004,095571,Perols; Johan Lars,9998,0,9999,1
1656957461081,COGS 9,A01,083615,Shannon; Kyle Michael,7,0,75,68
1656957467105,COGS 11,A01,083617,Boyle; Mary E. T.,19,0,48,29
1656957473137,COGS 13,A01,083071,Bastos; Amalia Pinkusfeld,9,0,71,62
1656957479163,COGS 14A,A01,092681,Semenuks; Arturs,0,1,100,100
1656957485189,COGS 14B,A01,083073,Cheng; Tzu-Han,5,0,63,58
1656957491210,COGS 17,A01,092677,Semenuks; Arturs,4,0,81,77
1656957497233,COGS 100,A01,083619,Allen; Michael Gordon,15,0,70,55
1656957503256,COGS 101A,A01,083621,Davis; Joshua Daniel,9,0,68,59
1656957509283,COGS 101B,A01,091572,Allen; Michael Gordon,8,0,65,57
1656957515310,COGS 101C,A01,083625,Delgado; Tania,17,0,35,18
1656957521336,COGS 107A,A01,083627,Boyle; Mary E. T.,13,0,60,47
1656957527360,COGS 118A,A01,083075,Gupta; Anjum,15,0,76,61
1656957533385,CSE 3,A50,083646,Miranda; Gregory Joseph,22,0,50,28
1656957539407,CSE 8A,A50,083650,Miranda; Gregory Joseph,17,1,56,39
1656957545434,CSE 11,A01,083080,Cao; Yingjun,4,15,40,36
1656957551460,CSE 12,A01,083652,Krause-Levy; Sophia Louisa,20,1,120,100
1656957557484,CSE 15L,A01,083654,Morris; Justin Loren,8,0,50,42
1656957557484,CSE 15L,A02,083655,Morris; Justin Loren,8,0,50,42
1656957563508,CSE 20,A01,083657,Tran; Khoa Dang,37,0,80,43
1656957569533,CSE 21,A01,095574,Bach; Quang Tran,21,0,48,27
1656957575559,CSE 30,A01,083084,Eldon; John,4,0,80,76
1656957575559,CSE 30,B01,095061,Bhaskar; Nishant,6,0,50,44
1656957581593,CSE 100,A01,083659,Cao; Yingjun,3,4,70,67
1656957587617,CSE 134B,A01,083661,Powell; Thomas Allan,19,0,100,81
1656957593639,CSE 140,A01,083663,Gungor; Onat,14,0,85,71
1656957599662,CSE 140L,A01,083088,Eldon; John,16,0,100,84
1656957605690,CSE 175,A01,083665,Kumar; Rakesh,3,0,25,22
1656957611715,CSE 190,A00,092507,Dubnov; Shlomo,7,0,20,13
1656957617741,ECE 45,A01,083139,Congero; Spencer William,5,0,75,70
1656957623767,ECE 65,A50,083695,Saad; Andrew S,12,0,30,18
1656957623767,ECE 65,A51,095125,Saad; Andrew S,25,0,26,1
1656957629797,ECE 109,A01,091882,Touri; Behrouz,16,0,70,54
1656957635826,ECE 180,A00,083140,Abi Samra; Nicholas Camill,0,0,30,30
1656957635826,ECE 180,B00,083141,Abi Samra; Nicholas Camill,0,0,30,30
1656957641854,MATH 10A,A01,083735,Patchell; Gregory David,1,0,30,29
1656957641854,MATH 10A,A02,083736,Patchell; Gregory David,20,0,30,10
1656957641854,MATH 10A,A03,083737,Patchell; Gregory David,15,0,30,15
1656957647964,MATH 10B,A01,083207,Lim; Seonhee,7,0,34,27
1656957647964,MATH 10B,A02,083208,Lim; Seonhee,9,0,35,26
1656957647964,MATH 10B,A03,093472,Lim; Seonhee,4,0,34,30
1656957647964,MATH 10B,B01,083739,Sinha; Shubham,9,0,30,21
1656957653994,MATH 18,A01,083743,Cinel; Cameron Alexander,6,0,30,24
1656957653994,MATH 18,A02,083744,Cinel; Cameron Alexander,15,0,30,15
1656957653994,MATH 18,A03,083745,Cinel; Cameron Alexander,8,0,30,22
1656957653994,MATH 18,B01,083748,Rideout; David Porter,4,0,37,33
1656957653994,MATH 18,B02,083749,Rideout; David Porter,3,0,36,33
1656957653994,MATH 18,B03,083750,Rideout; David Porter,2,0,37,35
1656957653994,MATH 18,B04,083751,Rideout; David Porter,5,0,36,31
1656957653994,MATH 18,B05,093473,Rideout; David Porter,4,0,36,32
1656957653994,MATH 18,B06,093474,Rideout; David Porter,5,0,36,31
1656957660015,MATH 20A,A01,083754,Zheng; Zequn,12,0,40,28
1656957666038,MATH 20B,A01,083756,Briones; Jor-el Thomas Caparas,1,0,36,35
1656957666038,MATH 20B,A02,083757,Briones; Jor-el Thomas Caparas,1,0,36,35
1656957666038,MATH 20B,A03,093475,Briones; Jor-el Thomas Caparas,0,0,36,36
1656957672062,MATH 20C,A01,083760,Briones; Jor-el Thomas Caparas,1,0,35,34
1656957672062,MATH 20C,A02,083761,Briones; Jor-el Thomas Caparas,8,0,35,27
1656957672062,MATH 20C,A03,093476,Briones; Jor-el Thomas Caparas,0,1,36,36
1656957672062,MATH 20C,B01,083762,Bach; Quang Tran,0,0,30,30
1656957678105,MATH 20D,A01,083765,Tran; Brian Kha,4,0,30,26
1656957678105,MATH 20D,A02,083766,Tran; Brian Kha,4,0,30,26
1656957678105,MATH 20D,A03,083767,Tran; Brian Kha,3,0,30,27
1656957684137,MATH 20E,A01,083771,Ganguly; Soumya,5,0,32,27
1656957684137,MATH 20E,A02,083772,Ganguly; Soumya,6,0,32,26
1656957684137,MATH 20E,B01,083773,Ciotti; Benjamin,18,0,35,17
1656957684137,MATH 20E,B02,083774,Ciotti; Benjamin,17,0,35,18
1656957690160,MATH 103A,A01,083777,Greenfeld; Be'Eri,2,0,36,34
1656957690160,MATH 103A,A02,083778,Greenfeld; Be'Eri,5,0,36,31
1656957690160,MATH 103A,A03,093561,Greenfeld; Be'Eri,4,0,36,32
1656957690160,MATH 103A,B01,083779,Greenfeld; Be'Eri,6,0,36,30
1656957690160,MATH 103A,B02,083780,Greenfeld; Be'Eri,2,0,36,34
1656957690160,MATH 103A,B03,093562,Greenfeld; Be'Eri,2,0,36,34
1656957696186,MATH 105,A01,085443,Carter; Anne Toulson,14,0,35,21
1656957696186,MATH 105,A02,093477,Carter; Anne Toulson,20,0,35,15
1656957702209,MATH 109,A01,083213,Ganzberger; Geoffrey Michael,2,0,34,32
1656957702209,MATH 109,A02,083214,Ganzberger; Geoffrey Michael,2,0,34,32
1656957702209,MATH 109,A03,093478,Ganzberger; Geoffrey Michael,1,0,34,33
1656957702209,MATH 109,B01,083215,Ganzberger; Geoffrey Michael,1,0,32,31
1656957702209,MATH 109,B02,083216,Ganzberger; Geoffrey Michael,1,0,32,31
1656957702209,MATH 109,B03,093479,Ganzberger; Geoffrey Michael,6,0,32,26
1656957708237,MATH 142A,A01,083219,Chow; Bennett,6,0,32,26
1656957708237,MATH 142A,A02,083220,Chow; Bennett,10,0,32,22
1656957708237,MATH 142A,A03,093480,Chow; Bennett,7,0,32,25
1656957708237,MATH 142A,B03,093481,Chow; Bennett,7,0,32,25
1656957708237,MATH 142A,B04,093558,Chow; Bennett,11,0,32,21
1656957708237,MATH 142A,B05,093559,Chow; Bennett,6,0,32,26
1656957714260,MATH 193A,A01,083224,Rotar; Vladimir,7,0,34,27
1656957714260,MATH 193A,A02,083225,Rotar; Vladimir,4,0,34,30
1656957714260,MATH 193A,A03,083781,Rotar; Vladimir,1,0,34,33
1656957714260,MATH 193A,A04,083782,Rotar; Vladimir,6,0,34,28
1656957714260,MATH 193A,A05,093482,Rotar; Vladimir,6,0,34,28
1656957720289,MATH 197,001,091859,McAuley; Julian John,9999,0,9999,0
1656957720289,MATH 197,002,095566,Kedlaya; Kiran S.,9997,0,9999,2
1656957720289,MATH 197,003,095567,Xiao; Ming,9999,0,9999,0
1656957720289,MATH 197,004,095571,Perols; Johan Lars,9998,0,9999,1
1656957727338,COGS 9,A01,083615,Shannon; Kyle Michael,7,0,75,68
1656957733361,COGS 11,A01,083617,Boyle; Mary E. T.,19,0,48,29
1656957739387,COGS 13,A01,083071,Bastos; Amalia Pinkusfeld,9,0,71,62
1656957745413,COGS 14A,A01,092681,Semenuks; Arturs,0,1,100,100
1656957751435,COGS 14B,A01,083073,Cheng; Tzu-Han,5,0,63,58
1656957757459,COGS 17,A01,092677,Semenuks; Arturs,4,0,81,77
1656957763486,COGS 100,A01,083619,Allen; Michael Gordon,15,0,70,55
1656957769512,COGS 101A,A01,083621,Davis; Joshua Daniel,9,0,68,59
1656957775534,COGS 101B,A01,091572,Allen; Michael Gordon,8,0,65,57
1656957781557,COGS 101C,A01,083625,Delgado; Tania,17,0,35,18
1656957787580,COGS 107A,A01,083627,Boyle; Mary E. T.,13,0,60,47
1656957793602,COGS 118A,A01,083075,Gupta; Anjum,15,0,76,61
1656957799625,CSE 3,A50,083646,Miranda; Gregory Joseph,22,0,50,28
1656957805647,CSE 8A,A50,083650,Miranda; Gregory Joseph,17,1,56,39
1656957811670,CSE 11,A01,083080,Cao; Yingjun,4,15,40,36
1656957817692,CSE 12,A01,083652,Krause-Levy; Sophia Louisa,20,1,120,100
1656957823726,CSE 15L,A01,083654,Morris; Justin Loren,8,0,50,42
1656957823726,CSE 15L,A02,083655,Morris; Justin Loren,8,0,50,42
1656957829748,CSE 20,A01,083657,Tran; Khoa Dang,37,0,80,43
1656957835771,CSE 21,A01,095574,Bach; Quang Tran,21,0,48,27
1656957841798,CSE 30,A01,083084,Eldon; John,4,0,80,76
1656957841798,CSE 30,B01,095061,Bhaskar; Nishant,6,0,50,44
1656957847820,CSE 100,A01,083659,Cao; Yingjun,3,4,70,67
1656957853844,CSE 134B,A01,083661,Powell; Thomas Allan,19,0,100,81
1656957859872,CSE 140,A01,083663,Gungor; Onat,14,0,85,71
1656957865893,CSE 140L,A01,083088,Eldon; John,16,0,100,84
1656957871918,CSE 175,A01,083665,Kumar; Rakesh,3,0,25,22
1656957877940,CSE 190,A00,092507,Dubnov; Shlomo,7,0,20,13
1656957883965,ECE 45,A01,083139,Congero; Spencer William,5,0,75,70
1656957889988,ECE 65,A50,083695,Saad; Andrew S,12,0,30,18
1656957889988,ECE 65,A51,095125,Saad; Andrew S,25,0,26,1
1656957896022,ECE 109,A01,091882,Touri; Behrouz,16,0,70,54
1656957902046,ECE 180,A00,083140,Abi Samra; Nicholas Camill,0,0,30,30
1656957902046,ECE 180,B00,083141,Abi Samra; Nicholas Camill,0,0,30,30
1656957908074,MATH 10A,A01,083735,Patchell; Gregory David,1,0,30,29
1656957908074,MATH 10A,A02,083736,Patchell; Gregory David,20,0,30,10
1656957908074,MATH 10A,A03,083737,Patchell; Gregory David,15,0,30,15
1656957914097,MATH 10B,A01,083207,Lim; Seonhee,7,0,34,27
1656957914097,MATH 10B,A02,083208,Lim; Seonhee,9,0,35,26
1656957914097,MATH 10B,A03,093472,Lim; Seonhee,4,0,34,30
1656957914097,MATH 10B,B01,083739,Sinha; Shubham,9,0,30,21
1656957920120,MATH 18,A01,083743,Cinel; Cameron Alexander,6,0,30,24
1656957920120,MATH 18,A02,083744,Cinel; Cameron Alexander,15,0,30,15
1656957920120,MATH 18,A03,083745,Cinel; Cameron Alexander,8,0,30,22
1656957920120,MATH 18,B01,083748,Rideout; David Porter,4,0,37,33
1656957920120,MATH 18,B02,083749,Rideout; David Porter,3,0,36,33
1656957920120,MATH 18,B03,083750,Rideout; David Porter,2,0,37,35
1656957920120,MATH 18,B04,083751,Rideout; David Porter,5,0,36,31
1656957920120,MATH 18,B05,093473,Rideout; David Porter,4,0,36,32
1656957920120,MATH 18,B06,093474,Rideout; David Porter,5,0,36,31
1656957926145,MATH 20A,A01,083754,Zheng; Zequn,12,0,40,28
1656957932166,MATH 20B,A01,083756,Briones; Jor-el Thomas Caparas,1,0,36,35
1656957932166,MATH 20B,A02,083757,Briones; Jor-el Thomas Caparas,1,0,36,35
1656957932166,MATH 20B,A03,093475,Briones; Jor-el Thomas Caparas,0,0,36,36
1656957938191,MATH 20C,A01,083760,Briones; Jor-el Thomas Caparas,1,0,35,34
1656957938191,MATH 20C,A02,083761,Briones; Jor-el Thomas Caparas,8,0,35,27
1656957938191,MATH 20C,A03,093476,Briones; Jor-el Thomas Caparas,0,1,36,36
1656957938191,MATH 20C,B01,083762,Bach; Quang Tran,0,0,30,30
1656957944221,MATH 20D,A01,083765,Tran; Brian Kha,4,0,30,26
1656957944221,MATH 20D,A02,083766,Tran; Brian Kha,4,0,30,26
1656957944221,MATH 20D,A03,083767,Tran; Brian Kha,3,0,30,27
1656957950249,MATH 20E,A01,083771,Ganguly; Soumya,5,0,32,27
1656957950249,MATH 20E,A02,083772,Ganguly; Soumya,6,0,32,26
1656957950249,MATH 20E,B01,083773,Ciotti; Benjamin,18,0,35,17
1656957950249,MATH 20E,B02,083774,Ciotti; Benjamin,17,0,35,18
1656957956270,MATH 103A,A01,083777,Greenfeld; Be'Eri,2,0,36,34
1656957956270,MATH 103A,A02,083778,Greenfeld; Be'Eri,5,0,36,31
1656957956270,MATH 103A,A03,093561,Greenfeld; Be'Eri,4,0,36,32
1656957956270,MATH 103A,B01,083779,Greenfeld; Be'Eri,6,0,36,30
1656957956270,MATH 103A,B02,083780,Greenfeld; Be'Eri,2,0,36,34
1656957956270,MATH 103A,B03,093562,Greenfeld; Be'Eri,2,0,36,34
1656957962306,MATH 105,A01,085443,Carter; Anne Toulson,14,0,35,21
1656957962306,MATH 105,A02,093477,Carter; Anne Toulson,20,0,35,15
1656957968329,MATH 109,A01,083213,Ganzberger; Geoffrey Michael,2,0,34,32
1656957968329,MATH 109,A02,083214,Ganzberger; Geoffrey Michael,2,0,34,32
1656957968329,MATH 109,A03,093478,Ganzberger; Geoffrey Michael,1,0,34,33
1656957968329,MATH 109,B01,083215,Ganzberger; Geoffrey Michael,1,0,32,31
1656957968329,MATH 109,B02,083216,Ganzberger; Geoffrey Michael,1,0,32,31
1656957968329,MATH 109,B03,093479,Ganzberger; Geoffrey Michael,6,0,32,26
1656957974358,MATH 142A,A01,083219,Chow; Bennett,6,0,32,26
1656957974358,MATH 142A,A02,083220,Chow; Bennett,10,0,32,22
1656957974358,MATH 142A,A03,093480,Chow; Bennett,7,0,32,25
1656957974358,MATH 142A,B03,093481,Chow; Bennett,7,0,32,25
1656957974358,MATH 142A,B04,093558,Chow; Bennett,11,0,32,21
1656957974358,MATH 142A,B05,093559,Chow; Bennett,6,0,32,26
1656957980383,MATH 193A,A01,083224,Rotar; Vladimir,7,0,34,27
1656957980383,MATH 193A,A02,083225,Rotar; Vladimir,4,0,34,30
1656957980383,MATH 193A,A03,083781,Rotar; Vladimir,1,0,34,33
1656957980383,MATH 193A,A04,083782,Rotar; Vladimir,6,0,34,28
1656957980383,MATH 193A,A05,093482,Rotar; Vladimir,6,0,34,28
1656957986405,MATH 197,001,091859,McAuley; Julian John,9999,0,9999,0
1656957986405,MATH 197,002,095566,Kedlaya; Kiran S.,9997,0,9999,2
1656957986405,MATH 197,003,095567,Xiao; Ming,9999,0,9999,0
1656957986405,MATH 197,004,095571,Perols; Johan Lars,9998,0,9999,1
1656957993478,COGS 9,A01,083615,Shannon; Kyle Michael,7,0,75,68
1656957999500,COGS 11,A01,083617,Boyle; Mary E. T.,19,0,48,29
1656958005524,COGS 13,A01,083071,Bastos; Amalia Pinkusfeld,9,0,71,62
1656958011546,COGS 14A,A01,092681,Semenuks; Arturs,0,1,100,100
1656958017568,COGS 14B,A01,083073,Cheng; Tzu-Han,5,0,63,58
1656958023592,COGS 17,A01,092677,Semenuks; Arturs,4,0,81,77
1656958029615,COGS 100,A01,083619,Allen; Michael Gordon,15,0,70,55
1656958035642,COGS 101A,A01,083621,Davis; Joshua Daniel,9,0,68,59
1656958041669,COGS 101B,A01,091572,Allen; Michael Gordon,8,0,65,57
1656958047696,COGS 101C,A01,083625,Delgado; Tania,17,0,35,18
1656958053720,COGS 107A,A01,083627,Boyle; Mary E. T.,13,0,60,47
1656958059742,COGS 118A,A01,083075,Gupta; Anjum,15,0,76,61
1656958065769,CSE 3,A50,083646,Miranda; Gregory Joseph,22,0,50,28
1656958071792,CSE 8A,A50,083650,Miranda; Gregory Joseph,17,1,56,39
1656958077821,CSE 11,A01,083080,Cao; Yingjun,4,15,40,36
1656958083845,CSE 12,A01,083652,Krause-Levy; Sophia Louisa,20,1,120,100
1656958089871,CSE 15L,A01,083654,Morris; Justin Loren,8,0,50,42
1656958089871,CSE 15L,A02,083655,Morris; Justin Loren,8,0,50,42
1656958095894,CSE 20,A01,083657,Tran; Khoa Dang,37,0,80,43
1656958101919,CSE 21,A01,095574,Bach; Quang Tran,21,0,48,27
1656958107942,CSE 30,A01,083084,Eldon; John,4,0,80,76
1656958107942,CSE 30,B01,095061,Bhaskar; Nishant,6,0,50,44
1656958113969,CSE 100,A01,083659,Cao; Yingjun,3,4,70,67
1656958119991,CSE 134B,A01,083661,Powell; Thomas Allan,19,0,100,81
1656958126015,CSE 140,A01,083663,Gungor; Onat,14,0,85,71
1656958132038,CSE 140L,A01,083088,Eldon; John,16,0,100,84
1656958138059,CSE 175,A01,083665,Kumar; Rakesh,3,0,25,22
1656958144094,CSE 190,A00,092507,Dubnov; Shlomo,7,0,20,13
1656958150118,ECE 45,A01,083139,Congero; Spencer William,5,0,75,70
1656958156146,ECE 65,A50,083695,Saad; Andrew S,12,0,30,18
1656958156146,ECE 65,A51,095125,Saad; Andrew S,25,0,26,1
1656958162169,ECE 109,A01,091882,Touri; Behrouz,16,0,70,54
1656958168193,ECE 180,A00,083140,Abi Samra; Nicholas Camill,0,0,30,30
1656958168193,ECE 180,B00,083141,Abi Samra; Nicholas Camill,0,0,30,30
1656958174220,MATH 10A,A01,083735,Patchell; Gregory David,1,0,30,29
1656958174220,MATH 10A,A02,083736,Patchell; Gregory David,20,0,30,10
1656958174220,MATH 10A,A03,083737,Patchell; Gregory David,15,0,30,15
1656958180250,MATH 10B,A01,083207,Lim; Seonhee,7,0,34,27
1656958180250,MATH 10B,A02,083208,Lim; Seonhee,9,0,35,26
1656958180250,MATH 10B,A03,093472,Lim; Seonhee,4,0,34,30
1656958180250,MATH 10B,B01,083739,Sinha; Shubham,9,0,30,21
1656958186282,MATH 18,A01,083743,Cinel; Cameron Alexander,6,0,30,24
1656958186282,MATH 18,A02,083744,Cinel; Cameron Alexander,15,0,30,15
1656958186282,MATH 18,A03,083745,Cinel; Cameron Alexander,8,0,30,22
1656958186282,MATH 18,B01,083748,Rideout; David Porter,4,0,37,33
1656958186282,MATH 18,B02,083749,Rideout; David Porter,3,0,36,33
1656958186282,MATH 18,B03,083750,Rideout; David Porter,2,0,37,35
1656958186282,MATH 18,B04,083751,Rideout; David Porter,5,0,36,31
1656958186282,MATH 18,B05,093473,Rideout; David Porter,4,0,36,32
1656958186282,MATH 18,B06,093474,Rideout; David Porter,5,0,36,31
1656958192310,MATH 20A,A01,083754,Zheng; Zequn,12,0,40,28
1656958198339,MATH 20B,A01,083756,Briones; Jor-el Thomas Caparas,1,0,36,35
1656958198339,MATH 20B,A02,083757,Briones; Jor-el Thomas Caparas,1,0,36,35
1656958198339,MATH 20B,A03,093475,Briones; Jor-el Thomas Caparas,0,0,36,36
1656958204369,MATH 20C,A01,083760,Briones; Jor-el Thomas Caparas,1,0,35,34
1656958204369,MATH 20C,A02,083761,Briones; Jor-el Thomas Caparas,8,0,35,27
1656958204369,MATH 20C,A03,093476,Briones; Jor-el Thomas Caparas,0,1,36,36
1656958204369,MATH 20C,B01,083762,Bach; Quang Tran,0,0,30,30
1656958210393,MATH 20D,A01,083765,Tran; Brian Kha,4,0,30,26
1656958210393,MATH 20D,A02,083766,Tran; Brian Kha,4,0,30,26
1656958210393,MATH 20D,A03,083767,Tran; Brian Kha,3,0,30,27
1656958216418,MATH 20E,A01,083771,Ganguly; Soumya,5,0,32,27
1656958216418,MATH 20E,A02,083772,Ganguly; Soumya,6,0,32,26
1656958216418,MATH 20E,B01,083773,Ciotti; Benjamin,18,0,35,17
1656958216418,MATH 20E,B02,083774,Ciotti; Benjamin,17,0,35,18
1656958222458,MATH 103A,A01,083777,Greenfeld; Be'Eri,2,0,36,34
1656958222458,MATH 103A,A02,083778,Greenfeld; Be'Eri,5,0,36,31
1656958222458,MATH 103A,A03,093561,Greenfeld; Be'Eri,4,0,36,32
1656958222458,MATH 103A,B01,083779,Greenfeld; Be'Eri,6,0,36,30
1656958222458,MATH 103A,B02,083780,Greenfeld; Be'Eri,2,0,36,34
1656958222458,MATH 103A,B03,093562,Greenfeld; Be'Eri,2,0,36,34
1656958228495,MATH 105,A01,085443,Carter; Anne Toulson,14,0,35,21
1656958228495,MATH 105,A02,093477,Carter; Anne Toulson,20,0,35,15
1656958234523,MATH 109,A01,083213,Ganzberger; Geoffrey Michael,2,0,34,32
1656958234523,MATH 109,A02,083214,Ganzberger; Geoffrey Michael,2,0,34,32
1656958234523,MATH 109,A03,093478,Ganzberger; Geoffrey Michael,1,0,34,33
1656958234523,MATH 109,B01,083215,Ganzberger; Geoffrey Michael,1,0,32,31
1656958234523,MATH 109,B02,083216,Ganzberger; Geoffrey Michael,1,0,32,31
1656958234523,MATH 109,B03,093479,Ganzberger; Geoffrey Michael,6,0,32,26
1656958240552,MATH 142A,A01,083219,Chow; Bennett,6,0,32,26
1656958240552,MATH 142A,A02,083220,Chow; Bennett,10,0,32,22
1656958240552,MATH 142A,A03,093480,Chow; Bennett,7,0,32,25
1656958240552,MATH 142A,B03,093481,Chow; Bennett,7,0,32,25
1656958240552,MATH 142A,B04,093558,Chow; Bennett,11,0,32,21
1656958240552,MATH 142A,B05,093559,Chow; Bennett,6,0,32,26
1656958246651,MATH 193A,A01,083224,Rotar; Vladimir,7,0,34,27
1656958246651,MATH 193A,A02,083225,Rotar; Vladimir,4,0,34,30
1656958246651,MATH 193A,A03,083781,Rotar; Vladimir,1,0,34,33
1656958246651,MATH 193A,A04,083782,Rotar; Vladimir,6,0,34,28
1656958246651,MATH 193A,A05,093482,Rotar; Vladimir,6,0,34,28
1656958252676,MATH 197,001,091859,McAuley; Julian John,9999,0,9999,0
1656958252676,MATH 197,002,095566,Kedlaya; Kiran S.,9997,0,9999,2
1656958252676,MATH 197,003,095567,Xiao; Ming,9999,0,9999,0
1656958252676,MATH 197,004,095571,Perols; Johan Lars,9998,0,9999,1
1656958259730,COGS 9,A01,083615,Shannon; Kyle Michael,7,0,75,68
1656958265759,COGS 11,A01,083617,Boyle; Mary E. T.,19,0,48,29
1656958271788,COGS 13,A01,083071,Bastos; Amalia Pinkusfeld,9,0,71,62
1656958277811,COGS 14A,A01,092681,Semenuks; Arturs,0,1,100,100
1656958283838,COGS 14B,A01,083073,Cheng; Tzu-Han,5,0,63,58
1656958289865,COGS 17,A01,092677,Semenuks; Arturs,4,0,81,77
1656958295888,COGS 100,A01,083619,Allen; Michael Gordon,15,0,70,55
1656958301912,COGS 101A,A01,083621,Davis; Joshua Daniel,9,0,68,59
1656958307938,COGS 101B,A01,091572,Allen; Michael Gordon,8,0,65,57
1656958313963,COGS 101C,A01,083625,Delgado; Tania,17,0,35,18
1656958319986,COGS 107A,A01,083627,Boyle; Mary E. T.,13,0,60,47
1656958326016,COGS 118A,A01,083075,Gupta; Anjum,15,0,76,61
1656958332040,CSE 3,A50,083646,Miranda; Gregory Joseph,22,0,50,28
1656958338063,CSE 8A,A50,083650,Miranda; Gregory Joseph,17,1,56,39
1656958344087,CSE 11,A01,083080,Cao; Yingjun,4,15,40,36
1656958350119,CSE 12,A01,083652,Krause-Levy; Sophia Louisa,20,1,120,100
1656958356146,CSE 15L,A01,083654,Morris; Justin Loren,8,0,50,42
1656958356146,CSE 15L,A02,083655,Morris; Justin Loren,8,0,50,42
1656958362169,CSE 20,A01,083657,Tran; Khoa Dang,37,0,80,43
1656958368196,CSE 21,A01,095574,Bach; Quang Tran,21,0,48,27
1656958374220,CSE 30,A01,083084,Eldon; John,4,0,80,76
1656958374220,CSE 30,B01,095061,Bhaskar; Nishant,6,0,50,44
1656958380243,CSE 100,A01,083659,Cao; Yingjun,3,4,70,67
1656958386280,CSE 134B,A01,083661,Powell; Thomas Allan,19,0,100,81
1656958392304,CSE 140,A01,083663,Gungor; Onat,14,0,85,71
1656958398327,CSE 140L,A01,083088,Eldon; John,16,0,100,84
1656958404352,CSE 175,A01,083665,Kumar; Rakesh,3,0,25,22
1656958410382,CSE 190,A00,092507,Dubnov; Shlomo,7,0,20,13
1656958416407,ECE 45,A01,083139,Congero; Spencer William,5,0,75,70
1656958422430,ECE 65,A50,083695,Saad; Andrew S,12,0,30,18
1656958422430,ECE 65,A51,095125,Saad; Andrew S,25,0,26,1
1656958428454,ECE 109,A01,091882,Touri; Behrouz,16,0,70,54
1656958434481,ECE 180,A00,083140,Abi Samra; Nicholas Camill,0,0,30,30
1656958434481,ECE 180,B00,083141,Abi Samra; Nicholas Camill,0,0,30,30
1656958440504,MATH 10A,A01,083735,Patchell; Gregory David,1,0,30,29
1656958440504,MATH 10A,A02,083736,Patchell; Gregory David,20,0,30,10
1656958440504,MATH 10A,A03,083737,Patchell; Gregory David,15,0,30,15
1656958446533,MATH 10B,A01,083207,Lim; Seonhee,7,0,34,27
1656958446533,MATH 10B,A02,083208,Lim; Seonhee,9,0,35,26
1656958446533,MATH 10B,A03,093472,Lim; Seonhee,4,0,34,30
1656958446533,MATH 10B,B01,083739,Sinha; Shubham,9,0,30,21
1656958452575,MATH 18,A01,083743,Cinel; Cameron Alexander,6,0,30,24
1656958452575,MATH 18,A02,083744,Cinel; Cameron Alexander,15,0,30,15
1656958452575,MATH 18,A03,083745,Cinel; Cameron Alexander,8,0,30,22
1656958452575,MATH 18,B01,083748,Rideout; David Porter,4,0,37,33
1656958452575,MATH 18,B02,083749,Rideout; David Porter,3,0,36,33
1656958452575,MATH 18,B03,083750,Rideout; David Porter,2,0,37,35
1656958452575,MATH 18,B04,083751,Rideout; David Porter,5,0,36,31
1656958452575,MATH 18,B05,093473,Rideout; David Porter,4,0,36,32
1656958452575,MATH 18,B06,093474,Rideout; David Porter,5,0,36,31
1656958458597,MATH 20A,A01,083754,Zheng; Zequn,12,0,40,28
1656958464620,MATH 20B,A01,083756,Briones; Jor-el Thomas Caparas,1,0,36,35
1656958464620,MATH 20B,A02,083757,Briones; Jor-el Thomas Caparas,1,0,36,35
1656958464620,MATH 20B,A03,093475,Briones; Jor-el Thomas Caparas,0,0,36,36
1656958470645,MATH 20C,A01,083760,Briones; Jor-el Thomas Caparas,1,0,35,34
1656958470645,MATH 20C,A02,083761,Briones; Jor-el Thomas Caparas,8,0,35,27
1656958470645,MATH 20C,A03,093476,Briones; Jor-el Thomas Caparas,0,1,36,36
1656958470645,MATH 20C,B01,083762,Bach; Quang Tran,0,0,30,30
1656958476669,MATH 20D,A01,083765,Tran; Brian Kha,4,0,30,26
1656958476669,MATH 20D,A02,083766,Tran; Brian Kha,4,0,30,26
1656958476669,MATH 20D,A03,083767,Tran; Brian Kha,3,0,30,27
1656958482693,MATH 20E,A01,083771,Ganguly; Soumya,5,0,32,27
1656958482693,MATH 20E,A02,083772,Ganguly; Soumya,6,0,32,26
1656958482693,MATH 20E,B01,083773,Ciotti; Benjamin,18,0,35,17
1656958482693,MATH 20E,B02,083774,Ciotti; Benjamin,17,0,35,18
1656958488718,MATH 103A,A01,083777,Greenfeld; Be'Eri,2,0,36,34
1656958488718,MATH 103A,A02,083778,Greenfeld; Be'Eri,5,0,36,31
1656958488718,MATH 103A,A03,093561,Greenfeld; Be'Eri,4,0,36,32
1656958488718,MATH 103A,B01,083779,Greenfeld; Be'Eri,6,0,36,30
1656958488718,MATH 103A,B02,083780,Greenfeld; Be'Eri,2,0,36,34
1656958488718,MATH 103A,B03,093562,Greenfeld; Be'Eri,2,0,36,34
1656958494741,MATH 105,A01,085443,Carter; Anne Toulson,14,0,35,21
1656958494741,MATH 105,A02,093477,Carter; Anne Toulson,20,0,35,15
1656958500765,MATH 109,A01,083213,Ganzberger; Geoffrey Michael,2,0,34,32
1656958500765,MATH 109,A02,083214,Ganzberger; Geoffrey Michael,2,0,34,32
1656958500765,MATH 109,A03,093478,Ganzberger; Geoffrey Michael,1,0,34,33
1656958500765,MATH 109,B01,083215,Ganzberger; Geoffrey Michael,1,0,32,31
1656958500765,MATH 109,B02,083216,Ganzberger; Geoffrey Michael,1,0,32,31
1656958500765,MATH 109,B03,093479,Ganzberger; Geoffrey Michael,6,0,32,26
1656958506789,MATH 142A,A01,083219,Chow; Bennett,6,0,32,26
1656958506789,MATH 142A,A02,083220,Chow; Bennett,10,0,32,22
1656958506789,MATH 142A,A03,093480,Chow; Bennett,7,0,32,25
1656958506789,MATH 142A,B03,093481,Chow; Bennett,7,0,32,25
1656958506789,MATH 142A,B04,093558,Chow; Bennett,11,0,32,21
1656958506789,MATH 142A,B05,093559,Chow; Bennett,6,0,32,26
1656958512811,MATH 193A,A01,083224,Rotar; Vladimir,7,0,34,27
1656958512811,MATH 193A,A02,083225,Rotar; Vladimir,4,0,34,30
1656958512811,MATH 193A,A03,083781,Rotar; Vladimir,1,0,34,33
1656958512811,MATH 193A,A04,083782,Rotar; Vladimir,6,0,34,28
1656958512811,MATH 193A,A05,093482,Rotar; Vladimir,6,0,34,28
1656958518834,MATH 197,001,091859,McAuley; Julian John,9999,0,9999,0
1656958518834,MATH 197,002,095566,Kedlaya; Kiran S.,9997,0,9999,2
1656958518834,MATH 197,003,095567,Xiao; Ming,9999,0,9999,0
1656958518834,MATH 197,004,095571,Perols; Johan Lars,9998,0,9999,1
1656958525888,COGS 9,A01,083615,Shannon; Kyle Michael,7,0,75,68
1656958531911,COGS 11,A01,083617,Boyle; Mary E. T.,19,0,48,29
1656958537936,COGS 13,A01,083071,Bastos; Amalia Pinkusfeld,9,0,71,62
1656958543958,COGS 14A,A01,092681,Semenuks; Arturs,0,1,100,100
1656958549980,COGS 14B,A01,083073,Cheng; Tzu-Han,5,0,63,58
1656958556005,COGS 17,A01,092677,Semenuks; Arturs,4,0,81,77
1656958562031,COGS 100,A01,083619,Allen; Michael Gordon,15,0,70,55
1656958568055,COGS 101A,A01,083621,Davis; Joshua Daniel,9,0,68,59
1656958574089,COGS 101B,A01,091572,Allen; Michael Gordon,8,0,65,57
1656958580117,COGS 101C,A01,083625,Delgado; Tania,17,0,35,18
1656958586143,COGS 107A,A01,083627,Boyle; Mary E. T.,13,0,60,47
1656958592165,COGS 118A,A01,083075,Gupta; Anjum,15,0,76,61
1656958598187,CSE 3,A50,083646,Miranda; Gregory Joseph,22,0,50,28
1656958604211,CSE 8A,A50,083650,Miranda; Gregory Joseph,17,1,56,39
1656958610238,CSE 11,A01,083080,Cao; Yingjun,4,15,40,36
1656958616263,CSE 12,A01,083652,Krause-Levy; Sophia Louisa,20,1,120,100
1656958622285,CSE 15L,A01,083654,Morris; Justin Loren,8,0,50,42
1656958622285,CSE 15L,A02,083655,Morris; Justin Loren,8,0,50,42
1656958628308,CSE 20,A01,083657,Tran; Khoa Dang,37,0,80,43
1656958634332,CSE 21,A01,095574,Bach; Quang Tran,21,0,48,27
1656958640357,CSE 30,A01,083084,Eldon; John,4,0,80,76
1656958640357,CSE 30,B01,095061,Bhaskar; Nishant,6,0,50,44
1656958646380,CSE 100,A01,083659,Cao; Yingjun,3,4,70,67
1656958652407,CSE 134B,A01,083661,Powell; Thomas Allan,19,0,100,81
1656958658432,CSE 140,A01,083663,Gungor; Onat,14,0,85,71
1656958664457,CSE 140L,A01,083088,Eldon; John,16,0,100,84
1656958670484,CSE 175,A01,083665,Kumar; Rakesh,3,0,25,22
1656958676508,CSE 190,A00,092507,Dubnov; Shlomo,7,0,20,13
1656958682531,ECE 45,A01,083139,Congero; Spencer William,5,0,75,70
1656958688559,ECE 65,A50,083695,Saad; Andrew S,12,0,30,18
1656958688559,ECE 65,A51,095125,Saad; Andrew S,25,0,26,1
1656958694581,ECE 109,A01,091882,Touri; Behrouz,16,0,70,54
1656958700611,ECE 180,A00,083140,Abi Samra; Nicholas Camill,0,0,30,30
1656958700611,ECE 180,B00,083141,Abi Samra; Nicholas Camill,0,0,30,30
1656958706639,MATH 10A,A01,083735,Patchell; Gregory David,1,0,30,29
1656958706639,MATH 10A,A02,083736,Patchell; Gregory David,20,0,30,10
1656958706639,MATH 10A,A03,083737,Patchell; Gregory David,15,0,30,15
1656958712668,MATH 10B,A01,083207,Lim; Seonhee,7,0,34,27
1656958712668,MATH 10B,A02,083208,Lim; Seonhee,9,0,35,26
1656958712668,MATH 10B,A03,093472,Lim; Seonhee,4,0,34,30
1656958712668,MATH 10B,B01,083739,Sinha; Shubham,9,0,30,21
1656958718697,MATH 18,A01,083743,Cinel; Cameron Alexander,6,0,30,24
1656958718697,MATH 18,A02,083744,Cinel; Cameron Alexander,15,0,30,15
1656958718697,MATH 18,A03,083745,Cinel; Cameron Alexander,8,0,30,22
1656958718697,MATH 18,B01,083748,Rideout; David Porter,4,0,37,33
1656958718697,MATH 18,B02,083749,Rideout; David Porter,3,0,36,33
1656958718697,MATH 18,B03,083750,Rideout; David Porter,2,0,37,35
1656958718697,MATH 18,B04,083751,Rideout; David Porter,5,0,36,31
1656958718697,MATH 18,B05,093473,Rideout; David Porter,4,0,36,32
1656958718697,MATH 18,B06,093474,Rideout; David Porter,5,0,36,31
1656958724720,MATH 20A,A01,083754,Zheng; Zequn,12,0,40,28
1656958730748,MATH 20B,A01,083756,Briones; Jor-el Thomas Caparas,1,0,36,35
1656958730748,MATH 20B,A02,083757,Briones; Jor-el Thomas Caparas,1,0,36,35
1656958730748,MATH 20B,A03,093475,Briones; Jor-el Thomas Caparas,0,0,36,36
1656958736776,MATH 20C,A01,083760,Briones; Jor-el Thomas Caparas,1,0,35,34
1656958736776,MATH 20C,A02,083761,Briones; Jor-el Thomas Caparas,8,0,35,27
1656958736776,MATH 20C,A03,093476,Briones; Jor-el Thomas Caparas,0,1,36,36
1656958736776,MATH 20C,B01,083762,Bach; Quang Tran,0,0,30,30
1656958742799,MATH 20D,A01,083765,Tran; Brian Kha,4,0,30,26
1656958742799,MATH 20D,A02,083766,Tran; Brian Kha,4,0,30,26
1656958742799,MATH 20D,A03,083767,Tran; Brian Kha,3,0,30,27
1656958748828,MATH 20E,A01,083771,Ganguly; Soumya,5,0,32,27
1656958748828,MATH 20E,A02,083772,Ganguly; Soumya,6,0,32,26
1656958748828,MATH 20E,B01,083773,Ciotti; Benjamin,18,0,35,17
1656958748828,MATH 20E,B02,083774,Ciotti; Benjamin,17,0,35,18
1656958754850,MATH 103A,A01,083777,Greenfeld; Be'Eri,2,0,36,34
1656958754850,MATH 103A,A02,083778,Greenfeld; Be'Eri,5,0,36,31
1656958754850,MATH 103A,A03,093561,Greenfeld; Be'Eri,4,0,36,32
1656958754850,MATH 103A,B01,083779,Greenfeld; Be'Eri,6,0,36,30
1656958754850,MATH 103A,B02,083780,Greenfeld; Be'Eri,2,0,36,34
1656958754850,MATH 103A,B03,093562,Greenfeld; Be'Eri,2,0,36,34
1656958760876,MATH 105,A01,085443,Carter; Anne Toulson,14,0,35,21
1656958760876,MATH 105,A02,093477,Carter; Anne Toulson,20,0,35,15
1656958766906,MATH 109,A01,083213,Ganzberger; Geoffrey Michael,2,0,34,32
1656958766906,MATH 109,A02,083214,Ganzberger; Geoffrey Michael,2,0,34,32
1656958766906,MATH 109,A03,093478,Ganzberger; Geoffrey Michael,1,0,34,33
1656958766906,MATH 109,B01,083215,Ganzberger; Geoffrey Michael,1,0,32,31
1656958766906,MATH 109,B02,083216,Ganzberger; Geoffrey Michael,1,0,32,31
1656958766906,MATH 109,B03,093479,Ganzberger; Geoffrey Michael,6,0,32,26
1656958772931,MATH 142A,A01,083219,Chow; Bennett,6,0,32,26
1656958772931,MATH 142A,A02,083220,Chow; Bennett,10,0,32,22
1656958772931,MATH 142A,A03,093480,Chow; Bennett,7,0,32,25
1656958772931,MATH 142A,B03,093481,Chow; Bennett,7,0,32,25
1656958772931,MATH 142A,B04,093558,Chow; Bennett,11,0,32,21
1656958772931,MATH 142A,B05,093559,Chow; Bennett,6,0,32,26
1656958778958,MATH 193A,A01,083224,Rotar; Vladimir,7,0,34,27
1656958778958,MATH 193A,A02,083225,Rotar; Vladimir,4,0,34,30
1656958778958,MATH 193A,A03,083781,Rotar; Vladimir,1,0,34,33
1656958778958,MATH 193A,A04,083782,Rotar; Vladimir,6,0,34,28
1656958778958,MATH 193A,A05,093482,Rotar; Vladimir,6,0,34,28
1656958784984,MATH 197,001,091859,McAuley; Julian John,9999,0,9999,0
1656958784984,MATH 197,002,095566,Kedlaya; Kiran S.,9997,0,9999,2
1656958784984,MATH 197,003,095567,Xiao; Ming,9999,0,9999,0
1656958784984,MATH 197,004,095571,Perols; Johan Lars,9998,0,9999,1
1656958792034,COGS 9,A01,083615,Shannon; Kyle Michael,7,0,75,68
1656958798061,COGS 11,A01,083617,Boyle; Mary E. T.,19,0,48,29
1656958804085,COGS 13,A01,083071,Bastos; Amalia Pinkusfeld,9,0,71,62
1656958810117,COGS 14A,A01,092681,Semenuks; Arturs,0,1,100,100
1656958816147,COGS 14B,A01,083073,Cheng; Tzu-Han,5,0,63,58
1656958822180,COGS 17,A01,092677,Semenuks; Arturs,4,0,81,77
1656958828211,COGS 100,A01,083619,Allen; Michael Gordon,15,0,70,55
1656958834235,COGS 101A,A01,083621,Davis; Joshua Daniel,9,0,68,59
1656958840350,COGS 101B,A01,091572,Allen; Michael Gordon,8,0,65,57
1656958846378,COGS 101C,A01,083625,Delgado; Tania,17,0,35,18
1656958852400,COGS 107A,A01,083627,Boyle; Mary E. T.,13,0,60,47
1656958858423,COGS 118A,A01,083075,Gupta; Anjum,15,0,76,61
1656958864452,CSE 3,A50,083646,Miranda; Gregory Joseph,22,0,50,28
1656958870480,CSE 8A,A50,083650,Miranda; Gregory Joseph,17,1,56,39
1656958876504,CSE 11,A01,083080,Cao; Yingjun,4,15,40,36
1656958882527,CSE 12,A01,083652,Krause-Levy; Sophia Louisa,20,1,120,100
1656958888564,CSE 15L,A01,083654,Morris; Justin Loren,8,0,50,42
1656958888564,CSE 15L,A02,083655,Morris; Justin Loren,8,0,50,42
1656958894587,CSE 20,A01,083657,Tran; Khoa Dang,37,0,80,43
1656958900610,CSE 21,A01,095574,Bach; Quang Tran,21,0,48,27
1656958906634,CSE 30,A01,083084,Eldon; John,4,0,80,76
1656958906634,CSE 30,B01,095061,Bhaskar; Nishant,6,0,50,44
1656958912656,CSE 100,A01,083659,Cao; Yingjun,3,4,70,67
1656958918678,CSE 134B,A01,083661,Powell; Thomas Allan,19,0,100,81
1656958924700,CSE 140,A01,083663,Gungor; Onat,14,0,85,71
1656958930722,CSE 140L,A01,083088,Eldon; John,16,0,100,84
1656958936745,CSE 175,A01,083665,Kumar; Rakesh,3,0,25,22
1656958942772,CSE 190,A00,092507,Dubnov; Shlomo,7,0,20,13
1656958948793,ECE 45,A01,083139,Congero; Spencer William,5,0,75,70
1656958954824,ECE 65,A50,083695,Saad; Andrew S,12,0,30,18
1656958954824,ECE 65,A51,095125,Saad; Andrew S,25,0,26,1
1656958960850,ECE 109,A01,091882,Touri; Behrouz,16,0,70,54
1656958966877,ECE 180,A00,083140,Abi Samra; Nicholas Camill,0,0,30,30
1656958966877,ECE 180,B00,083141,Abi Samra; Nicholas Camill,0,0,30,30
1656958972905,MATH 10A,A01,083735,Patchell; Gregory David,1,0,30,29
1656958972905,MATH 10A,A02,083736,Patchell; Gregory David,20,0,30,10
1656958972905,MATH 10A,A03,083737,Patchell; Gregory David,15,0,30,15
1656958978928,MATH 10B,A01,083207,Lim; Seonhee,7,0,34,27
1656958978928,MATH 10B,A02,083208,Lim; Seonhee,9,0,35,26
1656958978928,MATH 10B,A03,093472,Lim; Seonhee,4,0,34,30
1656958978928,MATH 10B,B01,083739,Sinha; Shubham,9,0,30,21
1656958984971,MATH 18,A01,083743,Cinel; Cameron Alexander,6,0,30,24
1656958984971,MATH 18,A02,083744,Cinel; Cameron Alexander,15,0,30,15
1656958984971,MATH 18,A03,083745,Cinel; Cameron Alexander,8,0,30,22
1656958984971,MATH 18,B01,083748,Rideout; David Porter,4,0,37,33
1656958984971,MATH 18,B02,083749,Rideout; David Porter,3,0,36,33
1656958984971,MATH 18,B03,083750,Rideout; David Porter,2,0,37,35
1656958984971,MATH 18,B04,083751,Rideout; David Porter,5,0,36,31
1656958984971,MATH 18,B05,093473,Rideout; David Porter,4,0,36,32
1656958984971,MATH 18,B06,093474,Rideout; David Porter,5,0,36,31
1656958990996,MATH 20A,A01,083754,Zheng; Zequn,12,0,40,28
1656958997021,MATH 20B,A01,083756,Briones; Jor-el Thomas Caparas,1,0,36,35
1656958997021,MATH 20B,A02,083757,Briones; Jor-el Thomas Caparas,1,0,36,35
1656958997021,MATH 20B,A03,093475,Briones; Jor-el Thomas Caparas,0,0,36,36
1656959003045,MATH 20C,A01,083760,Briones; Jor-el Thomas Caparas,1,0,35,34
1656959003045,MATH 20C,A02,083761,Briones; Jor-el Thomas Caparas,8,0,35,27
1656959003045,MATH 20C,A03,093476,Briones; Jor-el Thomas Caparas,0,1,36,36
1656959003045,MATH 20C,B01,083762,Bach; Quang Tran,0,0,30,30
1656959009073,MATH 20D,A01,083765,Tran; Brian Kha,4,0,30,26
1656959009073,MATH 20D,A02,083766,Tran; Brian Kha,4,0,30,26
1656959009073,MATH 20D,A03,083767,Tran; Brian Kha,3,0,30,27
1656959015103,MATH 20E,A01,083771,Ganguly; Soumya,5,0,32,27
1656959015103,MATH 20E,A02,083772,Ganguly; Soumya,6,0,32,26
1656959015103,MATH 20E,B01,083773,Ciotti; Benjamin,18,0,35,17
1656959015103,MATH 20E,B02,083774,Ciotti; Benjamin,17,0,35,18
1656959021131,MATH 103A,A01,083777,Greenfeld; Be'Eri,2,0,36,34
1656959021131,MATH 103A,A02,083778,Greenfeld; Be'Eri,5,0,36,31
1656959021131,MATH 103A,A03,093561,Greenfeld; Be'Eri,4,0,36,32
1656959021131,MATH 103A,B01,083779,Greenfeld; Be'Eri,6,0,36,30
1656959021131,MATH 103A,B02,083780,Greenfeld; Be'Eri,2,0,36,34
1656959021131,MATH 103A,B03,093562,Greenfeld; Be'Eri,2,0,36,34
1656959027170,MATH 105,A01,085443,Carter; Anne Toulson,14,0,35,21
1656959027170,MATH 105,A02,093477,Carter; Anne Toulson,20,0,35,15
1656959033193,MATH 109,A01,083213,Ganzberger; Geoffrey Michael,2,0,34,32
1656959033193,MATH 109,A02,083214,Ganzberger; Geoffrey Michael,2,0,34,32
1656959033193,MATH 109,A03,093478,Ganzberger; Geoffrey Michael,1,0,34,33
1656959033193,MATH 109,B01,083215,Ganzberger; Geoffrey Michael,1,0,32,31
1656959033193,MATH 109,B02,083216,Ganzberger; Geoffrey Michael,1,0,32,31
1656959033193,MATH 109,B03,093479,Ganzberger; Geoffrey Michael,6,0,32,26
1656959039223,MATH 142A,A01,083219,Chow; Bennett,6,0,32,26
1656959039223,MATH 142A,A02,083220,Chow; Bennett,10,0,32,22
1656959039223,MATH 142A,A03,093480,Chow; Bennett,7,0,32,25
1656959039223,MATH 142A,B03,093481,Chow; Bennett,7,0,32,25
1656959039223,MATH 142A,B04,093558,Chow; Bennett,11,0,32,21
1656959039223,MATH 142A,B05,093559,Chow; Bennett,6,0,32,26
1656959045255,MATH 193A,A01,083224,Rotar; Vladimir,7,0,34,27
1656959045255,MATH 193A,A02,083225,Rotar; Vladimir,4,0,34,30
1656959045255,MATH 193A,A03,083781,Rotar; Vladimir,1,0,34,33
1656959045255,MATH 193A,A04,083782,Rotar; Vladimir,6,0,34,28
1656959045255,MATH 193A,A05,093482,Rotar; Vladimir,6,0,34,28
1656959051279,MATH 197,001,091859,McAuley; Julian John,9999,0,9999,0
1656959051279,MATH 197,002,095566,Kedlaya; Kiran S.,9997,0,9999,2
1656959051279,MATH 197,003,095567,Xiao; Ming,9999,0,9999,0
1656959051279,MATH 197,004,095571,Perols; Johan Lars,9998,0,9999,1
1656959058333,COGS 9,A01,083615,Shannon; Kyle Michael,7,0,75,68
1656959064360,COGS 11,A01,083617,Boyle; Mary E. T.,19,0,48,29
1656959070387,COGS 13,A01,083071,Bastos; Amalia Pinkusfeld,9,0,71,62
1656959076419,COGS 14A,A01,092681,Semenuks; Arturs,0,1,100,100
1656959082443,COGS 14B,A01,083073,Cheng; Tzu-Han,5,0,63,58
1656959088470,COGS 17,A01,092677,Semenuks; Arturs,4,0,81,77
1656959094497,COGS 100,A01,083619,Allen; Michael Gordon,15,0,70,55
1656959100530,COGS 101A,A01,083621,Davis; Joshua Daniel,9,0,68,59
1656959106559,COGS 101B,A01,091572,Allen; Michael Gordon,8,0,65,57
1656959112594,COGS 101C,A01,083625,Delgado; Tania,17,0,35,18
1656959118618,COGS 107A,A01,083627,Boyle; Mary E. T.,13,0,60,47
1656959124641,COGS 118A,A01,083075,Gupta; Anjum,15,0,76,61
1656959130664,CSE 3,A50,083646,Miranda; Gregory Joseph,22,0,50,28
1656959136692,CSE 8A,A50,083650,Miranda; Gregory Joseph,17,1,56,39
1656959142728,CSE 11,A01,083080,Cao; Yingjun,4,15,40,36
1656959148752,CSE 12,A01,083652,Krause-Levy; Sophia Louisa,20,1,120,100
1656959154777,CSE 15L,A01,083654,Morris; Justin Loren,8,0,50,42
1656959154777,CSE 15L,A02,083655,Morris; Justin Loren,8,0,50,42
1656959160799,CSE 20,A01,083657,Tran; Khoa Dang,37,0,80,43
1656959166825,CSE 21,A01,095574,Bach; Quang Tran,21,0,48,27
1656959172848,CSE 30,A01,083084,Eldon; John,4,0,80,76
1656959172848,CSE 30,B01,095061,Bhaskar; Nishant,6,0,50,44
1656959178872,CSE 100,A01,083659,Cao; Yingjun,3,4,70,67
1656959184899,CSE 134B,A01,083661,Powell; Thomas Allan,19,0,100,81
1656959190922,CSE 140,A01,083663,Gungor; Onat,14,0,85,71
1656959196946,CSE 140L,A01,083088,Eldon; John,16,0,100,84
1656959202970,CSE 175,A01,083665,Kumar; Rakesh,3,0,25,22
1656959208995,CSE 190,A00,092507,Dubnov; Shlomo,7,0,20,13
1656959215022,ECE 45,A01,083139,Congero; Spencer William,5,0,75,70
1656959221043,ECE 65,A50,083695,Saad; Andrew S,12,0,30,18
1656959221043,ECE 65,A51,095125,Saad; Andrew S,25,0,26,1
1656959227071,ECE 109,A01,091882,Touri; Behrouz,16,0,70,54
1656959233104,ECE 180,A00,083140,Abi Samra; Nicholas Camill,0,0,30,30
1656959233104,ECE 180,B00,083141,Abi Samra; Nicholas Camill,0,0,30,30
1656959239127,MATH 10A,A01,083735,Patchell; Gregory David,1,0,30,29
1656959239127,MATH 10A,A02,083736,Patchell; Gregory David,20,0,30,10
1656959239127,MATH 10A,A03,083737,Patchell; Gregory David,15,0,30,15
1656959245155,MATH 10B,A01,083207,Lim; Seonhee,7,0,34,27
1656959245155,MATH 10B,A02,083208,Lim; Seonhee,9,0,35,26
1656959245155,MATH 10B,A03,093472,Lim; Seonhee,4,0,34,30
1656959245155,MATH 10B,B01,083739,Sinha; Shubham,9,0,30,21
1656959251180,MATH 18,A01,083743,Cinel; Cameron Alexander,6,0,30,24
1656959251180,MATH 18,A02,083744,Cinel; Cameron Alexander,15,0,30,15
1656959251180,MATH 18,A03,083745,Cinel; Cameron Alexander,8,0,30,22
1656959251180,MATH 18,B01,083748,Rideout; David Porter,4,0,37,33
1656959251180,MATH 18,B02,083749,Rideout; David Porter,3,0,36,33
1656959251180,MATH 18,B03,083750,Rideout; David Porter,2,0,37,35
1656959251180,MATH 18,B04,083751,Rideout; David Porter,5,0,36,31
1656959251180,MATH 18,B05,093473,Rideout; David Porter,4,0,36,32
1656959251180,MATH 18,B06,093474,Rideout; David Porter,5,0,36,31
1656959257204,MATH 20A,A01,083754,Zheng; Zequn,12,0,40,28
1656959263232,MATH 20B,A01,083756,Briones; Jor-el Thomas Caparas,1,0,36,35
1656959263232,MATH 20B,A02,083757,Briones; Jor-el Thomas Caparas,1,0,36,35
1656959263232,MATH 20B,A03,093475,Briones; Jor-el Thomas Caparas,0,0,36,36
1656959269258,MATH 20C,A01,083760,Briones; Jor-el Thomas Caparas,1,0,35,34
1656959269258,MATH 20C,A02,083761,Briones; Jor-el Thomas Caparas,8,0,35,27
1656959269258,MATH 20C,A03,093476,Briones; Jor-el Thomas Caparas,0,1,36,36
1656959269258,MATH 20C,B01,083762,Bach; Quang Tran,0,0,30,30
1656959275286,MATH 20D,A01,083765,Tran; Brian Kha,4,0,30,26
1656959275286,MATH 20D,A02,083766,Tran; Brian Kha,4,0,30,26
1656959275286,MATH 20D,A03,083767,Tran; Brian Kha,3,0,30,27
1656959281315,MATH 20E,A01,083771,Ganguly; Soumya,5,0,32,27
1656959281315,MATH 20E,A02,083772,Ganguly; Soumya,6,0,32,26
1656959281315,MATH 20E,B01,083773,Ciotti; Benjamin,18,0,35,17
1656959281315,MATH 20E,B02,083774,Ciotti; Benjamin,17,0,35,18
1656959287339,MATH 103A,A01,083777,Greenfeld; Be'Eri,2,0,36,34
1656959287339,MATH 103A,A02,083778,Greenfeld; Be'Eri,5,0,36,31
1656959287339,MATH 103A,A03,093561,Greenfeld; Be'Eri,4,0,36,32
1656959287339,MATH 103A,B01,083779,Greenfeld; Be'Eri,6,0,36,30
1656959287339,MATH 103A,B02,083780,Greenfeld; Be'Eri,2,0,36,34
1656959287339,MATH 103A,B03,093562,Greenfeld; Be'Eri,2,0,36,34
1656959293361,MATH 105,A01,085443,Carter; Anne Toulson,14,0,35,21
1656959293361,MATH 105,A02,093477,Carter; Anne Toulson,20,0,35,15
1656959299393,MATH 109,A01,083213,Ganzberger; Geoffrey Michael,2,0,34,32
1656959299393,MATH 109,A02,083214,Ganzberger; Geoffrey Michael,2,0,34,32
1656959299393,MATH 109,A03,093478,Ganzberger; Geoffrey Michael,1,0,34,33
1656959299393,MATH 109,B01,083215,Ganzberger; Geoffrey Michael,1,0,32,31
1656959299393,MATH 109,B02,083216,Ganzberger; Geoffrey Michael,1,0,32,31
1656959299393,MATH 109,B03,093479,Ganzberger; Geoffrey Michael,6,0,32,26
1656959305416,MATH 142A,A01,083219,Chow; Bennett,6,0,32,26
1656959305416,MATH 142A,A02,083220,Chow; Bennett,10,0,32,22
1656959305416,MATH 142A,A03,093480,Chow; Bennett,7,0,32,25
1656959305416,MATH 142A,B03,093481,Chow; Bennett,7,0,32,25
1656959305416,MATH 142A,B04,093558,Chow; Bennett,11,0,32,21
1656959305416,MATH 142A,B05,093559,Chow; Bennett,6,0,32,26
1656959311439,MATH 193A,A01,083224,Rotar; Vladimir,7,0,34,27
1656959311439,MATH 193A,A02,083225,Rotar; Vladimir,4,0,34,30
1656959311439,MATH 193A,A03,083781,Rotar; Vladimir,1,0,34,33
1656959311439,MATH 193A,A04,083782,Rotar; Vladimir,6,0,34,28
1656959311439,MATH 193A,A05,093482,Rotar; Vladimir,6,0,34,28
1656959317461,MATH 197,001,091859,McAuley; Julian John,9999,0,9999,0
1656959317461,MATH 197,002,095566,Kedlaya; Kiran S.,9997,0,9999,2
1656959317461,MATH 197,003,095567,Xiao; Ming,9999,0,9999,0
1656959317461,MATH 197,004,095571,Perols; Johan Lars,9998,0,9999,1
1656959324523,COGS 9,A01,083615,Shannon; Kyle Michael,7,0,75,68
1656959330556,COGS 11,A01,083617,Boyle; Mary E. T.,19,0,48,29
1656959336578,COGS 13,A01,083071,Bastos; Amalia Pinkusfeld,9,0,71,62
1656959342603,COGS 14A,A01,092681,Semenuks; Arturs,0,1,100,100
1656959348632,COGS 14B,A01,083073,Cheng; Tzu-Han,5,0,63,58
1656959354655,COGS 17,A01,092677,Semenuks; Arturs,4,0,81,77
1656959360679,COGS 100,A01,083619,Allen; Michael Gordon,15,0,70,55
1656959366703,COGS 101A,A01,083621,Davis; Joshua Daniel,9,0,68,59
1656959372729,COGS 101B,A01,091572,Allen; Michael Gordon,8,0,65,57
1656959378752,COGS 101C,A01,083625,Delgado; Tania,17,0,35,18
1656959384775,COGS 107A,A01,083627,Boyle; Mary E. T.,13,0,60,47
1656959390798,COGS 118A,A01,083075,Gupta; Anjum,15,0,76,61
1656959396822,CSE 3,A50,083646,Miranda; Gregory Joseph,22,0,50,28
1656959402846,CSE 8A,A50,083650,Miranda; Gregory Joseph,17,1,56,39
1656959408870,CSE 11,A01,083080,Cao; Yingjun,4,15,40,36
1656959414895,CSE 12,A01,083652,Krause-Levy; Sophia Louisa,20,1,120,100
1656959420921,CSE 15L,A01,083654,Morris; Justin Loren,8,0,50,42
1656959420921,CSE 15L,A02,083655,Morris; Justin Loren,8,0,50,42
1656959426946,CSE 20,A01,083657,Tran; Khoa Dang,37,0,80,43
1656959432969,CSE 21,A01,095574,Bach; Quang Tran,21,0,48,27
1656959439066,CSE 30,A01,083084,Eldon; John,4,0,80,76
1656959439066,CSE 30,B01,095061,Bhaskar; Nishant,6,0,50,44
1656959445093,CSE 100,A01,083659,Cao; Yingjun,3,4,70,67
1656959451120,CSE 134B,A01,083661,Powell; Thomas Allan,19,0,100,81
1656959457149,CSE 140,A01,083663,Gungor; Onat,14,0,85,71
1656959463180,CSE 140L,A01,083088,Eldon; John,16,0,100,84
1656959469208,CSE 175,A01,083665,Kumar; Rakesh,3,0,25,22
1656959475233,CSE 190,A00,092507,Dubnov; Shlomo,7,0,20,13
1656959481259,ECE 45,A01,083139,Congero; Spencer William,5,0,75,70
1656959487282,ECE 65,A50,083695,Saad; Andrew S,12,0,30,18
1656959487282,ECE 65,A51,095125,Saad; Andrew S,25,0,26,1
1656959493310,ECE 109,A01,091882,Touri; Behrouz,16,0,70,54
1656959499338,ECE 180,A00,083140,Abi Samra; Nicholas Camill,0,0,30,30
1656959499338,ECE 180,B00,083141,Abi Samra; Nicholas Camill,0,0,30,30
1656959505363,MATH 10A,A01,083735,Patchell; Gregory David,1,0,30,29
1656959505363,MATH 10A,A02,083736,Patchell; Gregory David,20,0,30,10
1656959505363,MATH 10A,A03,083737,Patchell; Gregory David,15,0,30,15
1656959511392,MATH 10B,A01,083207,Lim; Seonhee,7,0,34,27
1656959511392,MATH 10B,A02,083208,Lim; Seonhee,9,0,35,26
1656959511392,MATH 10B,A03,093472,Lim; Seonhee,4,0,34,30
1656959511392,MATH 10B,B01,083739,Sinha; Shubham,9,0,30,21
1656959517418,MATH 18,A01,083743,Cinel; Cameron Alexander,6,0,30,24
1656959517418,MATH 18,A02,083744,Cinel; Cameron Alexander,15,0,30,15
1656959517418,MATH 18,A03,083745,Cinel; Cameron Alexander,8,0,30,22
1656959517418,MATH 18,B01,083748,Rideout; David Porter,4,0,37,33
1656959517418,MATH 18,B02,083749,Rideout; David Porter,3,0,36,33
1656959517418,MATH 18,B03,083750,Rideout; David Porter,2,0,37,35
1656959517418,MATH 18,B04,083751,Rideout; David Porter,5,0,36,31
1656959517418,MATH 18,B05,093473,Rideout; David Porter,4,0,36,32
1656959517418,MATH 18,B06,093474,Rideout; David Porter,5,0,36,31
1656959523443,MATH 20A,A01,083754,Zheng; Zequn,12,0,40,28
1656959529468,MATH 20B,A01,083756,Briones; Jor-el Thomas Caparas,1,0,36,35
1656959529468,MATH 20B,A02,083757,Briones; Jor-el Thomas Caparas,1,0,36,35
1656959529468,MATH 20B,A03,093475,Briones; Jor-el Thomas Caparas,0,0,36,36
1656959535498,MATH 20C,A01,083760,Briones; Jor-el Thomas Caparas,1,0,35,34
1656959535498,MATH 20C,A02,083761,Briones; Jor-el Thomas Caparas,8,0,35,27
1656959535498,MATH 20C,A03,093476,Briones; Jor-el Thomas Caparas,0,1,36,36
1656959535498,MATH 20C,B01,083762,Bach; Quang Tran,0,0,30,30
1656959541523,MATH 20D,A01,083765,Tran; Brian Kha,4,0,30,26
1656959541523,MATH 20D,A02,083766,Tran; Brian Kha,4,0,30,26
1656959541523,MATH 20D,A03,083767,Tran; Brian Kha,3,0,30,27
1656959547548,MATH 20E,A01,083771,Ganguly; Soumya,5,0,32,27
1656959547548,MATH 20E,A02,083772,Ganguly; Soumya,6,0,32,26
1656959547548,MATH 20E,B01,083773,Ciotti; Benjamin,18,0,35,17
1656959547548,MATH 20E,B02,083774,Ciotti; Benjamin,17,0,35,18
1656959553573,MATH 103A,A01,083777,Greenfeld; Be'Eri,2,0,36,34
1656959553573,MATH 103A,A02,083778,Greenfeld; Be'Eri,5,0,36,31
1656959553573,MATH 103A,A03,093561,Greenfeld; Be'Eri,4,0,36,32
1656959553573,MATH 103A,B01,083779,Greenfeld; Be'Eri,6,0,36,30
1656959553573,MATH 103A,B02,083780,Greenfeld; Be'Eri,2,0,36,34
1656959553573,MATH 103A,B03,093562,Greenfeld; Be'Eri,2,0,36,34
1656959559596,MATH 105,A01,085443,Carter; Anne Toulson,14,0,35,21
1656959559596,MATH 105,A02,093477,Carter; Anne Toulson,20,0,35,15
1656959565621,MATH 109,A01,083213,Ganzberger; Geoffrey Michael,2,0,34,32
1656959565621,MATH 109,A02,083214,Ganzberger; Geoffrey Michael,2,0,34,32
1656959565621,MATH 109,A03,093478,Ganzberger; Geoffrey Michael,1,0,34,33
1656959565621,MATH 109,B01,083215,Ganzberger; Geoffrey Michael,1,0,32,31
1656959565621,MATH 109,B02,083216,Ganzberger; Geoffrey Michael,1,0,32,31
1656959565621,MATH 109,B03,093479,Ganzberger; Geoffrey Michael,6,0,32,26
1656959571644,MATH 142A,A01,083219,Chow; Bennett,6,0,32,26
1656959571644,MATH 142A,A02,083220,Chow; Bennett,10,0,32,22
1656959571644,MATH 142A,A03,093480,Chow; Bennett,7,0,32,25
1656959571644,MATH 142A,B03,093481,Chow; Bennett,7,0,32,25
1656959571644,MATH 142A,B04,093558,Chow; Bennett,11,0,32,21
1656959571644,MATH 142A,B05,093559,Chow; Bennett,6,0,32,26
1656959577669,MATH 193A,A01,083224,Rotar; Vladimir,7,0,34,27
1656959577669,MATH 193A,A02,083225,Rotar; Vladimir,4,0,34,30
1656959577669,MATH 193A,A03,083781,Rotar; Vladimir,1,0,34,33
1656959577669,MATH 193A,A04,083782,Rotar; Vladimir,6,0,34,28
1656959577669,MATH 193A,A05,093482,Rotar; Vladimir,6,0,34,28
1656959583693,MATH 197,001,091859,McAuley; Julian John,9999,0,9999,0
1656959583693,MATH 197,002,095566,Kedlaya; Kiran S.,9997,0,9999,2
1656959583693,MATH 197,003,095567,Xiao; Ming,9999,0,9999,0
1656959583693,MATH 197,004,095571,Perols; Johan Lars,9998,0,9999,1
1656959590747,COGS 9,A01,083615,Shannon; Kyle Michael,7,0,75,68
1656959596770,COGS 11,A01,083617,Boyle; Mary E. T.,19,0,48,29
1656959602793,COGS 13,A01,083071,Bastos; Amalia Pinkusfeld,9,0,71,62
1656959608817,COGS 14A,A01,092681,Semenuks; Arturs,0,1,100,100
1656959614840,COGS 14B,A01,083073,Cheng; Tzu-Han,5,0,63,58
1656959620863,COGS 17,A01,092677,Semenuks; Arturs,4,0,81,77
1656959626889,COGS 100,A01,083619,Allen; Michael Gordon,15,0,70,55
1656959632917,COGS 101A,A01,083621,Davis; Joshua Daniel,9,0,68,59
1656959638940,COGS 101B,A01,091572,Allen; Michael Gordon,8,0,65,57
1656959644966,COGS 101C,A01,083625,Delgado; Tania,17,0,35,18
1656959650993,COGS 107A,A01,083627,Boyle; Mary E. T.,13,0,60,47
1656959657022,COGS 118A,A01,083075,Gupta; Anjum,15,0,76,61
1656959663045,CSE 3,A50,083646,Miranda; Gregory Joseph,22,0,50,28
1656959669067,CSE 8A,A50,083650,Miranda; Gregory Joseph,17,1,56,39
1656959675095,CSE 11,A01,083080,Cao; Yingjun,4,15,40,36
1656959681119,CSE 12,A01,083652,Krause-Levy; Sophia Louisa,20,1,120,100
1656959687145,CSE 15L,A01,083654,Morris; Justin Loren,8,0,50,42
1656959687145,CSE 15L,A02,083655,Morris; Justin Loren,8,0,50,42
1656959693180,CSE 20,A01,083657,Tran; Khoa Dang,37,0,80,43
1656959699208,CSE 21,A01,095574,Bach; Quang Tran,21,0,48,27
1656959705236,CSE 30,A01,083084,Eldon; John,4,0,80,76
1656959705236,CSE 30,B01,095061,Bhaskar; Nishant,6,0,50,44
1656959711258,CSE 100,A01,083659,Cao; Yingjun,3,4,70,67
1656959717281,CSE 134B,A01,083661,Powell; Thomas Allan,19,0,100,81
1656959723316,CSE 140,A01,083663,Gungor; Onat,14,0,85,71
1656959729349,CSE 140L,A01,083088,Eldon; John,16,0,100,84
1656959735376,CSE 175,A01,083665,Kumar; Rakesh,3,0,25,22
1656959741402,CSE 190,A00,092507,Dubnov; Shlomo,7,0,20,13
1656959747429,ECE 45,A01,083139,Congero; Spencer William,5,0,75,70
1656959753465,ECE 65,A50,083695,Saad; Andrew S,12,0,30,18
1656959753465,ECE 65,A51,095125,Saad; Andrew S,25,0,26,1
1656959759488,ECE 109,A01,091882,Touri; Behrouz,16,0,70,54
1656959765508,ECE 180,A00,083140,Abi Samra; Nicholas Camill,0,0,30,30
1656959765508,ECE 180,B00,083141,Abi Samra; Nicholas Camill,0,0,30,30
1656959771536,MATH 10A,A01,083735,Patchell; Gregory David,1,0,30,29
1656959771536,MATH 10A,A02,083736,Patchell; Gregory David,20,0,30,10
1656959771536,MATH 10A,A03,083737,Patchell; Gregory David,15,0,30,15
1656959777564,MATH 10B,A01,083207,Lim; Seonhee,7,0,34,27
1656959777564,MATH 10B,A02,083208,Lim; Seonhee,9,0,35,26
1656959777564,MATH 10B,A03,093472,Lim; Seonhee,4,0,34,30
1656959777564,MATH 10B,B01,083739,Sinha; Shubham,9,0,30,21
1656959783594,MATH 18,A01,083743,Cinel; Cameron Alexander,6,0,30,24
1656959783594,MATH 18,A02,083744,Cinel; Cameron Alexander,15,0,30,15
1656959783594,MATH 18,A03,083745,Cinel; Cameron Alexander,8,0,30,22
1656959783594,MATH 18,B01,083748,Rideout; David Porter,4,0,37,33
1656959783594,MATH 18,B02,083749,Rideout; David Porter,3,0,36,33
1656959783594,MATH 18,B03,083750,Rideout; David Porter,2,0,37,35
1656959783594,MATH 18,B04,083751,Rideout; David Porter,5,0,36,31
1656959783594,MATH 18,B05,093473,Rideout; David Porter,4,0,36,32
1656959783594,MATH 18,B06,093474,Rideout; David Porter,5,0,36,31
1656959789623,MATH 20A,A01,083754,Zheng; Zequn,12,0,40,28
1656959795652,MATH 20B,A01,083756,Briones; Jor-el Thomas Caparas,1,0,36,35
1656959795652,MATH 20B,A02,083757,Briones; Jor-el Thomas Caparas,1,0,36,35
1656959795652,MATH 20B,A03,093475,Briones; Jor-el Thomas Caparas,0,0,36,36
1656959801677,MATH 20C,A01,083760,Briones; Jor-el Thomas Caparas,1,0,35,34
1656959801677,MATH 20C,A02,083761,Briones; Jor-el Thomas Caparas,8,0,35,27
1656959801677,MATH 20C,A03,093476,Briones; Jor-el Thomas Caparas,0,1,36,36
1656959801677,MATH 20C,B01,083762,Bach; Quang Tran,0,0,30,30
1656959807705,MATH 20D,A01,083765,Tran; Brian Kha,4,0,30,26
1656959807705,MATH 20D,A02,083766,Tran; Brian Kha,4,0,30,26
1656959807705,MATH 20D,A03,083767,Tran; Brian Kha,3,0,30,27
1656959813736,MATH 20E,A01,083771,Ganguly; Soumya,5,0,32,27
1656959813736,MATH 20E,A02,083772,Ganguly; Soumya,6,0,32,26
1656959813736,MATH 20E,B01,083773,Ciotti; Benjamin,18,0,35,17
1656959813736,MATH 20E,B02,083774,Ciotti; Benjamin,17,0,35,18
1656959819760,MATH 103A,A01,083777,Greenfeld; Be'Eri,2,0,36,34
1656959819760,MATH 103A,A02,083778,Greenfeld; Be'Eri,5,0,36,31
1656959819760,MATH 103A,A03,093561,Greenfeld; Be'Eri,4,0,36,32
1656959819760,MATH 103A,B01,083779,Greenfeld; Be'Eri,6,0,36,30
1656959819760,MATH 103A,B02,083780,Greenfeld; Be'Eri,2,0,36,34
1656959819760,MATH 103A,B03,093562,Greenfeld; Be'Eri,2,0,36,34
1656959825788,MATH 105,A01,085443,Carter; Anne Toulson,14,0,35,21
1656959825788,MATH 105,A02,093477,Carter; Anne Toulson,20,0,35,15
1656959831813,MATH 109,A01,083213,Ganzberger; Geoffrey Michael,2,0,34,32
1656959831813,MATH 109,A02,083214,Ganzberger; Geoffrey Michael,2,0,34,32
1656959831813,MATH 109,A03,093478,Ganzberger; Geoffrey Michael,1,0,34,33
1656959831813,MATH 109,B01,083215,Ganzberger; Geoffrey Michael,1,0,32,31
1656959831813,MATH 109,B02,083216,Ganzberger; Geoffrey Michael,1,0,32,31
1656959831813,MATH 109,B03,093479,Ganzberger; Geoffrey Michael,6,0,32,26
1656959837841,MATH 142A,A01,083219,Chow; Bennett,6,0,32,26
1656959837841,MATH 142A,A02,083220,Chow; Bennett,10,0,32,22
1656959837841,MATH 142A,A03,093480,Chow; Bennett,7,0,32,25
1656959837841,MATH 142A,B03,093481,Chow; Bennett,7,0,32,25
1656959837841,MATH 142A,B04,093558,Chow; Bennett,11,0,32,21
1656959837841,MATH 142A,B05,093559,Chow; Bennett,6,0,32,26
1656959843870,MATH 193A,A01,083224,Rotar; Vladimir,7,0,34,27
1656959843870,MATH 193A,A02,083225,Rotar; Vladimir,4,0,34,30
1656959843870,MATH 193A,A03,083781,Rotar; Vladimir,1,0,34,33
1656959843870,MATH 193A,A04,083782,Rotar; Vladimir,6,0,34,28
1656959843870,MATH 193A,A05,093482,Rotar; Vladimir,6,0,34,28
1656959849892,MATH 197,001,091859,McAuley; Julian John,9999,0,9999,0
1656959849892,MATH 197,002,095566,Kedlaya; Kiran S.,9997,0,9999,2
1656959849892,MATH 197,003,095567,Xiao; Ming,9999,0,9999,0
1656959849892,MATH 197,004,095571,Perols; Johan Lars,9998,0,9999,1
1656959856956,COGS 9,A01,083615,Shannon; Kyle Michael,7,0,75,68
1656959862978,COGS 11,A01,083617,Boyle; Mary E. T.,19,0,48,29
1656959869004,COGS 13,A01,083071,Bastos; Amalia Pinkusfeld,9,0,71,62
1656959875026,COGS 14A,A01,092681,Semenuks; Arturs,0,1,100,100
1656959881055,COGS 14B,A01,083073,Cheng; Tzu-Han,5,0,63,58
1656959887078,COGS 17,A01,092677,Semenuks; Arturs,4,0,81,77
1656959893108,COGS 100,A01,083619,Allen; Michael Gordon,15,0,70,55
1656959899136,COGS 101A,A01,083621,Davis; Joshua Daniel,9,0,68,59
1656959905157,COGS 101B,A01,091572,Allen; Michael Gordon,8,0,65,57
1656959911185,COGS 101C,A01,083625,Delgado; Tania,17,0,35,18
1656959917210,COGS 107A,A01,083627,Boyle; Mary E. T.,13,0,60,47
1656959923237,COGS 118A,A01,083075,Gupta; Anjum,15,0,76,61
1656959929259,CSE 3,A50,083646,Miranda; Gregory Joseph,22,0,50,28
1656959935287,CSE 8A,A50,083650,Miranda; Gregory Joseph,17,1,56,39
1656959941313,CSE 11,A01,083080,Cao; Yingjun,4,15,40,36
1656959947337,CSE 12,A01,083652,Krause-Levy; Sophia Louisa,20,1,120,100
1656959953361,CSE 15L,A01,083654,Morris; Justin Loren,8,0,50,42
1656959953361,CSE 15L,A02,083655,Morris; Justin Loren,8,0,50,42
1656959959385,CSE 20,A01,083657,Tran; Khoa Dang,37,0,80,43
1656959965415,CSE 21,A01,095574,Bach; Quang Tran,21,0,48,27
1656959971439,CSE 30,A01,083084,Eldon; John,4,0,80,76
1656959971439,CSE 30,B01,095061,Bhaskar; Nishant,6,0,50,44
1656959977463,CSE 100,A01,083659,Cao; Yingjun,3,4,70,67
1656959983496,CSE 134B,A01,083661,Powell; Thomas Allan,19,0,100,81
1656959989520,CSE 140,A01,083663,Gungor; Onat,14,0,85,71
1656959995542,CSE 140L,A01,083088,Eldon; John,16,0,100,84
1656960001566,CSE 175,A01,083665,Kumar; Rakesh,3,0,25,22
1656960007589,CSE 190,A00,092507,Dubnov; Shlomo,7,0,20,13
1656960013615,ECE 45,A01,083139,Congero; Spencer William,5,0,75,70
1656960019637,ECE 65,A50,083695,Saad; Andrew S,12,0,30,18
1656960019637,ECE 65,A51,095125,Saad; Andrew S,25,0,26,1
1656960025663,ECE 109,A01,091882,Touri; Behrouz,16,0,70,54
1656960031695,ECE 180,A00,083140,Abi Samra; Nicholas Camill,0,0,30,30
1656960031695,ECE 180,B00,083141,Abi Samra; Nicholas Camill,0,0,30,30
1656960037795,MATH 10A,A01,083735,Patchell; Gregory David,1,0,30,29
1656960037795,MATH 10A,A02,083736,Patchell; Gregory David,20,0,30,10
1656960037795,MATH 10A,A03,083737,Patchell; Gregory David,15,0,30,15
1656960043824,MATH 10B,A01,083207,Lim; Seonhee,7,0,34,27
1656960043824,MATH 10B,A02,083208,Lim; Seonhee,9,0,35,26
1656960043824,MATH 10B,A03,093472,Lim; Seonhee,4,0,34,30
1656960043824,MATH 10B,B01,083739,Sinha; Shubham,9,0,30,21
1656960049855,MATH 18,A01,083743,Cinel; Cameron Alexander,6,0,30,24
1656960049855,MATH 18,A02,083744,Cinel; Cameron Alexander,15,0,30,15
1656960049855,MATH 18,A03,083745,Cinel; Cameron Alexander,8,0,30,22
1656960049855,MATH 18,B01,083748,Rideout; David Porter,4,0,37,33
1656960049855,MATH 18,B02,083749,Rideout; David Porter,3,0,36,33
1656960049855,MATH 18,B03,083750,Rideout; David Porter,2,0,37,35
1656960049855,MATH 18,B04,083751,Rideout; David Porter,5,0,36,31
1656960049855,MATH 18,B05,093473,Rideout; David Porter,4,0,36,32
1656960049855,MATH 18,B06,093474,Rideout; David Porter,5,0,36,31
1656960055879,MATH 20A,A01,083754,Zheng; Zequn,12,0,40,28
1656960061906,MATH 20B,A01,083756,Briones; Jor-el Thomas Caparas,1,0,36,35
1656960061906,MATH 20B,A02,083757,Briones; Jor-el Thomas Caparas,1,0,36,35
1656960061906,MATH 20B,A03,093475,Briones; Jor-el Thomas Caparas,0,0,36,36
1656960067933,MATH 20C,A01,083760,Briones; Jor-el Thomas Caparas,1,0,35,34
1656960067933,MATH 20C,A02,083761,Briones; Jor-el Thomas Caparas,8,0,35,27
1656960067933,MATH 20C,A03,093476,Briones; Jor-el Thomas Caparas,0,1,36,36
1656960067933,MATH 20C,B01,083762,Bach; Quang Tran,0,0,30,30
1656960073966,MATH 20D,A01,083765,Tran; Brian Kha,4,0,30,26
1656960073966,MATH 20D,A02,083766,Tran; Brian Kha,4,0,30,26
1656960073966,MATH 20D,A03,083767,Tran; Brian Kha,3,0,30,27
1656960079991,MATH 20E,A01,083771,Ganguly; Soumya,5,0,32,27
1656960079991,MATH 20E,A02,083772,Ganguly; Soumya,6,0,32,26
1656960079991,MATH 20E,B01,083773,Ciotti; Benjamin,18,0,35,17
1656960079991,MATH 20E,B02,083774,Ciotti; Benjamin,17,0,35,18
1656960086023,MATH 103A,A01,083777,Greenfeld; Be'Eri,2,0,36,34
1656960086023,MATH 103A,A02,083778,Greenfeld; Be'Eri,5,0,36,31
1656960086023,MATH 103A,A03,093561,Greenfeld; Be'Eri,4,0,36,32
1656960086023,MATH 103A,B01,083779,Greenfeld; Be'Eri,6,0,36,30
1656960086023,MATH 103A,B02,083780,Greenfeld; Be'Eri,2,0,36,34
1656960086023,MATH 103A,B03,093562,Greenfeld; Be'Eri,2,0,36,34
1656960092050,MATH 105,A01,085443,Carter; Anne Toulson,14,0,35,21
1656960092050,MATH 105,A02,093477,Carter; Anne Toulson,20,0,35,15
1656960098079,MATH 109,A01,083213,Ganzberger; Geoffrey Michael,2,0,34,32
1656960098079,MATH 109,A02,083214,Ganzberger; Geoffrey Michael,2,0,34,32
1656960098079,MATH 109,A03,093478,Ganzberger; Geoffrey Michael,1,0,34,33
1656960098079,MATH 109,B01,083215,Ganzberger; Geoffrey Michael,1,0,32,31
1656960098079,MATH 109,B02,083216,Ganzberger; Geoffrey Michael,1,0,32,31
1656960098079,MATH 109,B03,093479,Ganzberger; Geoffrey Michael,6,0,32,26
1656960104104,MATH 142A,A01,083219,Chow; Bennett,6,0,32,26
1656960104104,MATH 142A,A02,083220,Chow; Bennett,10,0,32,22
1656960104104,MATH 142A,A03,093480,Chow; Bennett,7,0,32,25
1656960104104,MATH 142A,B03,093481,Chow; Bennett,7,0,32,25
1656960104104,MATH 142A,B04,093558,Chow; Bennett,11,0,32,21
1656960104104,MATH 142A,B05,093559,Chow; Bennett,6,0,32,26
1656960110132,MATH 193A,A01,083224,Rotar; Vladimir,7,0,34,27
1656960110132,MATH 193A,A02,083225,Rotar; Vladimir,4,0,34,30
1656960110132,MATH 193A,A03,083781,Rotar; Vladimir,1,0,34,33
1656960110132,MATH 193A,A04,083782,Rotar; Vladimir,6,0,34,28
1656960110132,MATH 193A,A05,093482,Rotar; Vladimir,6,0,34,28
1656960116155,MATH 197,001,091859,McAuley; Julian John,9999,0,9999,0
1656960116155,MATH 197,002,095566,Kedlaya; Kiran S.,9997,0,9999,2
1656960116155,MATH 197,003,095567,Xiao; Ming,9999,0,9999,0
1656960116155,MATH 197,004,095571,Perols; Johan Lars,9998,0,9999,1
1656960123206,COGS 9,A01,083615,Shannon; Kyle Michael,7,0,75,68
1656960129230,COGS 11,A01,083617,Boyle; Mary E. T.,19,0,48,29
1656960135256,COGS 13,A01,083071,Bastos; Amalia Pinkusfeld,9,0,71,62
1656960141280,COGS 14A,A01,092681,Semenuks; Arturs,0,1,100,100
1656960147302,COGS 14B,A01,083073,Cheng; Tzu-Han,5,0,63,58
1656960153326,COGS 17,A01,092677,Semenuks; Arturs,4,0,81,77
1656960159352,COGS 100,A01,083619,Allen; Michael Gordon,15,0,70,55
1656960165380,COGS 101A,A01,083621,Davis; Joshua Daniel,9,0,68,59
1656960171404,COGS 101B,A01,091572,Allen; Michael Gordon,8,0,65,57
1656960177426,COGS 101C,A01,083625,Delgado; Tania,17,0,35,18
1656960183450,COGS 107A,A01,083627,Boyle; Mary E. T.,13,0,60,47
1656960189476,COGS 118A,A01,083075,Gupta; Anjum,15,0,76,61
1656960195505,CSE 3,A50,083646,Miranda; Gregory Joseph,22,0,50,28
1656960201530,CSE 8A,A50,083650,Miranda; Gregory Joseph,17,1,56,39
1656960207557,CSE 11,A01,083080,Cao; Yingjun,4,15,40,36
1656960213581,CSE 12,A01,083652,Krause-Levy; Sophia Louisa,20,1,120,100
1656960219609,CSE 15L,A01,083654,Morris; Justin Loren,8,0,50,42
1656960219609,CSE 15L,A02,083655,Morris; Justin Loren,8,0,50,42
1656960225634,CSE 20,A01,083657,Tran; Khoa Dang,37,0,80,43
1656960231658,CSE 21,A01,095574,Bach; Quang Tran,21,0,48,27
1656960237695,CSE 30,A01,083084,Eldon; John,4,0,80,76
1656960237695,CSE 30,B01,095061,Bhaskar; Nishant,6,0,50,44
1656960243722,CSE 100,A01,083659,Cao; Yingjun,3,4,70,67
1656960249745,CSE 134B,A01,083661,Powell; Thomas Allan,19,0,100,81
1656960255770,CSE 140,A01,083663,Gungor; Onat,14,0,85,71
1656960261797,CSE 140L,A01,083088,Eldon; John,16,0,100,84
1656960267824,CSE 175,A01,083665,Kumar; Rakesh,3,0,25,22
1656960273850,CSE 190,A00,092507,Dubnov; Shlomo,7,0,20,13
1656960279874,ECE 45,A01,083139,Congero; Spencer William,5,0,75,70
1656960285901,ECE 65,A50,083695,Saad; Andrew S,12,0,30,18
1656960285901,ECE 65,A51,095125,Saad; Andrew S,25,0,26,1
1656960291925,ECE 109,A01,091882,Touri; Behrouz,16,0,70,54
1656960297947,ECE 180,A00,083140,Abi Samra; Nicholas Camill,0,0,30,30
1656960297947,ECE 180,B00,083141,Abi Samra; Nicholas Camill,0,0,30,30
1656960303970,MATH 10A,A01,083735,Patchell; Gregory David,1,0,30,29
1656960303970,MATH 10A,A02,083736,Patchell; Gregory David,20,0,30,10
1656960303970,MATH 10A,A03,083737,Patchell; Gregory David,15,0,30,15
1656960310000,MATH 10B,A01,083207,Lim; Seonhee,7,0,34,27
1656960310000,MATH 10B,A02,083208,Lim; Seonhee,9,0,35,26
1656960310000,MATH 10B,A03,093472,Lim; Seonhee,4,0,34,30
1656960310000,MATH 10B,B01,083739,Sinha; Shubham,9,0,30,21
1656960316028,MATH 18,A01,083743,Cinel; Cameron Alexander,6,0,30,24
1656960316028,MATH 18,A02,083744,Cinel; Cameron Alexander,15,0,30,15
1656960316028,MATH 18,A03,083745,Cinel; Cameron Alexander,8,0,30,22
1656960316028,MATH 18,B01,083748,Rideout; David Porter,4,0,37,33
1656960316028,MATH 18,B02,083749,Rideout; David Porter,3,0,36,33
1656960316028,MATH 18,B03,083750,Rideout; David Porter,2,0,37,35
1656960316028,MATH 18,B04,083751,Rideout; David Porter,5,0,36,31
1656960316028,MATH 18,B05,093473,Rideout; David Porter,4,0,36,32
1656960316028,MATH 18,B06,093474,Rideout; David Porter,5,0,36,31
1656960322051,MATH 20A,A01,083754,Zheng; Zequn,12,0,40,28
1656960328079,MATH 20B,A01,083756,Briones; Jor-el Thomas Caparas,1,0,36,35
1656960328079,MATH 20B,A02,083757,Briones; Jor-el Thomas Caparas,1,0,36,35
1656960328079,MATH 20B,A03,093475,Briones; Jor-el Thomas Caparas,0,0,36,36
1656960334104,MATH 20C,A01,083760,Briones; Jor-el Thomas Caparas,1,0,35,34
1656960334104,MATH 20C,A02,083761,Briones; Jor-el Thomas Caparas,8,0,35,27
1656960334104,MATH 20C,A03,093476,Briones; Jor-el Thomas Caparas,0,1,36,36
1656960334104,MATH 20C,B01,083762,Bach; Quang Tran,0,0,30,30
1656960340128,MATH 20D,A01,083765,Tran; Brian Kha,4,0,30,26
1656960340128,MATH 20D,A02,083766,Tran; Brian Kha,4,0,30,26
1656960340128,MATH 20D,A03,083767,Tran; Brian Kha,3,0,30,27
1656960346160,MATH 20E,A01,083771,Ganguly; Soumya,5,0,32,27
1656960346160,MATH 20E,A02,083772,Ganguly; Soumya,6,0,32,26
1656960346160,MATH 20E,B01,083773,Ciotti; Benjamin,18,0,35,17
1656960346160,MATH 20E,B02,083774,Ciotti; Benjamin,17,0,35,18
1656960352186,MATH 103A,A01,083777,Greenfeld; Be'Eri,2,0,36,34
1656960352186,MATH 103A,A02,083778,Greenfeld; Be'Eri,5,0,36,31
1656960352186,MATH 103A,A03,093561,Greenfeld; Be'Eri,4,0,36,32
1656960352186,MATH 103A,B01,083779,Greenfeld; Be'Eri,6,0,36,30
1656960352186,MATH 103A,B02,083780,Greenfeld; Be'Eri,2,0,36,34
1656960352186,MATH 103A,B03,093562,Greenfeld; Be'Eri,2,0,36,34
1656960358209,MATH 105,A01,085443,Carter; Anne Toulson,14,0,35,21
1656960358209,MATH 105,A02,093477,Carter; Anne Toulson,20,0,35,15
1656960364242,MATH 109,A01,083213,Ganzberger; Geoffrey Michael,2,0,34,32
1656960364242,MATH 109,A02,083214,Ganzberger; Geoffrey Michael,2,0,34,32
1656960364242,MATH 109,A03,093478,Ganzberger; Geoffrey Michael,1,0,34,33
1656960364242,MATH 109,B01,083215,Ganzberger; Geoffrey Michael,1,0,32,31
1656960364242,MATH 109,B02,083216,Ganzberger; Geoffrey Michael,1,0,32,31
1656960364242,MATH 109,B03,093479,Ganzberger; Geoffrey Michael,6,0,32,26
1656960370265,MATH 142A,A01,083219,Chow; Bennett,6,0,32,26
1656960370265,MATH 142A,A02,083220,Chow; Bennett,10,0,32,22
1656960370265,MATH 142A,A03,093480,Chow; Bennett,7,0,32,25
1656960370265,MATH 142A,B03,093481,Chow; Bennett,7,0,32,25
1656960370265,MATH 142A,B04,093558,Chow; Bennett,11,0,32,21
1656960370265,MATH 142A,B05,093559,Chow; Bennett,6,0,32,26
1656960376289,MATH 193A,A01,083224,Rotar; Vladimir,7,0,34,27
1656960376289,MATH 193A,A02,083225,Rotar; Vladimir,4,0,34,30
1656960376289,MATH 193A,A03,083781,Rotar; Vladimir,1,0,34,33
1656960376289,MATH 193A,A04,083782,Rotar; Vladimir,6,0,34,28
1656960376289,MATH 193A,A05,093482,Rotar; Vladimir,6,0,34,28
1656960382320,MATH 197,001,091859,McAuley; Julian John,9999,0,9999,0
1656960382320,MATH 197,002,095566,Kedlaya; Kiran S.,9997,0,9999,2
1656960382320,MATH 197,003,095567,Xiao; Ming,9999,0,9999,0
1656960382320,MATH 197,004,095571,Perols; Johan Lars,9998,0,9999,1
1656960389375,COGS 9,A01,083615,Shannon; Kyle Michael,7,0,75,68
1656960395402,COGS 11,A01,083617,Boyle; Mary E. T.,19,0,48,29
1656960401425,COGS 13,A01,083071,Bastos; Amalia Pinkusfeld,9,0,71,62
1656960407452,COGS 14A,A01,092681,Semenuks; Arturs,0,1,100,100
1656960413474,COGS 14B,A01,083073,Cheng; Tzu-Han,5,0,63,58
1656960419498,COGS 17,A01,092677,Semenuks; Arturs,4,0,81,77
1656960425521,COGS 100,A01,083619,Allen; Michael Gordon,15,0,70,55
1656960431545,COGS 101A,A01,083621,Davis; Joshua Daniel,9,0,68,59
1656960437573,COGS 101B,A01,091572,Allen; Michael Gordon,8,0,65,57
1656960443603,COGS 101C,A01,083625,Delgado; Tania,17,0,35,18
1656960449630,COGS 107A,A01,083627,Boyle; Mary E. T.,13,0,60,47
1656960455657,COGS 118A,A01,083075,Gupta; Anjum,15,0,76,61
1656960461684,CSE 3,A50,083646,Miranda; Gregory Joseph,22,0,50,28
1656960467708,CSE 8A,A50,083650,Miranda; Gregory Joseph,17,1,56,39
1656960473731,CSE 11,A01,083080,Cao; Yingjun,4,15,40,36
1656960479758,CSE 12,A01,083652,Krause-Levy; Sophia Louisa,20,1,120,100
1656960485780,CSE 15L,A01,083654,Morris; Justin Loren,8,0,50,42
1656960485780,CSE 15L,A02,083655,Morris; Justin Loren,8,0,50,42
1656960491804,CSE 20,A01,083657,Tran; Khoa Dang,37,0,80,43
1656960497829,CSE 21,A01,095574,Bach; Quang Tran,21,0,48,27
1656960503863,CSE 30,A01,083084,Eldon; John,4,0,80,76
1656960503863,CSE 30,B01,095061,Bhaskar; Nishant,6,0,50,44
1656960509890,CSE 100,A01,083659,Cao; Yingjun,3,4,70,67
1656960515917,CSE 134B,A01,083661,Powell; Thomas Allan,19,0,100,81
1656960521949,CSE 140,A01,083663,Gungor; Onat,14,0,85,71
1656960527976,CSE 140L,A01,083088,Eldon; John,16,0,100,84
1656960534003,CSE 175,A01,083665,Kumar; Rakesh,3,0,25,22
1656960540028,CSE 190,A00,092507,Dubnov; Shlomo,7,0,20,13
1656960546056,ECE 45,A01,083139,Congero; Spencer William,5,0,75,70
1656960552078,ECE 65,A50,083695,Saad; Andrew S,12,0,30,18
1656960552078,ECE 65,A51,095125,Saad; Andrew S,25,0,26,1
1656960558104,ECE 109,A01,091882,Touri; Behrouz,16,0,70,54
1656960564129,ECE 180,A00,083140,Abi Samra; Nicholas Camill,0,0,30,30
1656960564129,ECE 180,B00,083141,Abi Samra; Nicholas Camill,0,0,30,30
1656960570153,MATH 10A,A01,083735,Patchell; Gregory David,1,0,30,29
1656960570153,MATH 10A,A02,083736,Patchell; Gregory David,20,0,30,10
1656960570153,MATH 10A,A03,083737,Patchell; Gregory David,15,0,30,15
1656960576182,MATH 10B,A01,083207,Lim; Seonhee,7,0,34,27
1656960576182,MATH 10B,A02,083208,Lim; Seonhee,9,0,35,26
1656960576182,MATH 10B,A03,093472,Lim; Seonhee,4,0,34,30
1656960576182,MATH 10B,B01,083739,Sinha; Shubham,9,0,30,21
1656960582208,MATH 18,A01,083743,Cinel; Cameron Alexander,6,0,30,24
1656960582208,MATH 18,A02,083744,Cinel; Cameron Alexander,15,0,30,15
1656960582208,MATH 18,A03,083745,Cinel; Cameron Alexander,8,0,30,22
1656960582208,MATH 18,B01,083748,Rideout; David Porter,4,0,37,33
1656960582208,MATH 18,B02,083749,Rideout; David Porter,3,0,36,33
1656960582208,MATH 18,B03,083750,Rideout; David Porter,2,0,37,35
1656960582208,MATH 18,B04,083751,Rideout; David Porter,5,0,36,31
1656960582208,MATH 18,B05,093473,Rideout; David Porter,4,0,36,32
1656960582208,MATH 18,B06,093474,Rideout; David Porter,5,0,36,31
1656960588234,MATH 20A,A01,083754,Zheng; Zequn,12,0,40,28
1656960594256,MATH 20B,A01,083756,Briones; Jor-el Thomas Caparas,1,0,36,35
1656960594256,MATH 20B,A02,083757,Briones; Jor-el Thomas Caparas,1,0,36,35
1656960594256,MATH 20B,A03,093475,Briones; Jor-el Thomas Caparas,0,0,36,36
1656960600283,MATH 20C,A01,083760,Briones; Jor-el Thomas Caparas,1,0,35,34
1656960600283,MATH 20C,A02,083761,Briones; Jor-el Thomas Caparas,8,0,35,27
1656960600283,MATH 20C,A03,093476,Briones; Jor-el Thomas Caparas,0,1,36,36
1656960600283,MATH 20C,B01,083762,Bach; Quang Tran,0,0,30,30
1656960606306,MATH 20D,A01,083765,Tran; Brian Kha,4,0,30,26
1656960606306,MATH 20D,A02,083766,Tran; Brian Kha,4,0,30,26
1656960606306,MATH 20D,A03,083767,Tran; Brian Kha,3,0,30,27
1656960612330,MATH 20E,A01,083771,Ganguly; Soumya,5,0,32,27
1656960612330,MATH 20E,A02,083772,Ganguly; Soumya,6,0,32,26
1656960612330,MATH 20E,B01,083773,Ciotti; Benjamin,18,0,35,17
1656960612330,MATH 20E,B02,083774,Ciotti; Benjamin,17,0,35,18
1656960618355,MATH 103A,A01,083777,Greenfeld; Be'Eri,2,0,36,34
1656960618355,MATH 103A,A02,083778,Greenfeld; Be'Eri,5,0,36,31
1656960618355,MATH 103A,A03,093561,Greenfeld; Be'Eri,4,0,36,32
1656960618355,MATH 103A,B01,083779,Greenfeld; Be'Eri,6,0,36,30
1656960618355,MATH 103A,B02,083780,Greenfeld; Be'Eri,2,0,36,34
1656960618355,MATH 103A,B03,093562,Greenfeld; Be'Eri,2,0,36,34
1656960624379,MATH 105,A01,085443,Carter; Anne Toulson,14,0,35,21
1656960624379,MATH 105,A02,093477,Carter; Anne Toulson,20,0,35,15
1656960630406,MATH 109,A01,083213,Ganzberger; Geoffrey Michael,2,0,34,32
1656960630406,MATH 109,A02,083214,Ganzberger; Geoffrey Michael,2,0,34,32
1656960630406,MATH 109,A03,093478,Ganzberger; Geoffrey Michael,1,0,34,33
1656960630406,MATH 109,B01,083215,Ganzberger; Geoffrey Michael,1,0,32,31
1656960630406,MATH 109,B02,083216,Ganzberger; Geoffrey Michael,1,0,32,31
1656960630406,MATH 109,B03,093479,Ganzberger; Geoffrey Michael,6,0,32,26
1656960636502,MATH 142A,A01,083219,Chow; Bennett,6,0,32,26
1656960636502,MATH 142A,A02,083220,Chow; Bennett,10,0,32,22
1656960636502,MATH 142A,A03,093480,Chow; Bennett,7,0,32,25
1656960636502,MATH 142A,B03,093481,Chow; Bennett,7,0,32,25
1656960636502,MATH 142A,B04,093558,Chow; Bennett,11,0,32,21
1656960636502,MATH 142A,B05,093559,Chow; Bennett,6,0,32,26
1656960642527,MATH 193A,A01,083224,Rotar; Vladimir,7,0,34,27
1656960642527,MATH 193A,A02,083225,Rotar; Vladimir,4,0,34,30
1656960642527,MATH 193A,A03,083781,Rotar; Vladimir,1,0,34,33
1656960642527,MATH 193A,A04,083782,Rotar; Vladimir,6,0,34,28
1656960642527,MATH 193A,A05,093482,Rotar; Vladimir,6,0,34,28
1656960648550,MATH 197,001,091859,McAuley; Julian John,9999,0,9999,0
1656960648550,MATH 197,002,095566,Kedlaya; Kiran S.,9997,0,9999,2
1656960648550,MATH 197,003,095567,Xiao; Ming,9999,0,9999,0
1656960648550,MATH 197,004,095571,Perols; Johan Lars,9998,0,9999,1
1656960655619,COGS 9,A01,083615,Shannon; Kyle Michael,7,0,75,68
1656960661642,COGS 11,A01,083617,Boyle; Mary E. T.,19,0,48,29
1656960667664,COGS 13,A01,083071,Bastos; Amalia Pinkusfeld,9,0,71,62
1656960673685,COGS 14A,A01,092681,Semenuks; Arturs,0,1,100,100
1656960679708,COGS 14B,A01,083073,Cheng; Tzu-Han,5,0,63,58
1656960685739,COGS 17,A01,092677,Semenuks; Arturs,4,0,81,77
1656960691766,COGS 100,A01,083619,Allen; Michael Gordon,15,0,70,55
1656960697788,COGS 101A,A01,083621,Davis; Joshua Daniel,9,0,68,59
1656960703813,COGS 101B,A01,091572,Allen; Michael Gordon,8,0,65,57
1656960709838,COGS 101C,A01,083625,Delgado; Tania,17,0,35,18
1656960715860,COGS 107A,A01,083627,Boyle; Mary E. T.,13,0,60,47
1656960721883,COGS 118A,A01,083075,Gupta; Anjum,15,0,76,61
1656960727908,CSE 3,A50,083646,Miranda; Gregory Joseph,22,0,50,28
1656960733935,CSE 8A,A50,083650,Miranda; Gregory Joseph,17,1,56,39
1656960739963,CSE 11,A01,083080,Cao; Yingjun,4,15,40,36
1656960745986,CSE 12,A01,083652,Krause-Levy; Sophia Louisa,20,1,120,100
1656960752012,CSE 15L,A01,083654,Morris; Justin Loren,8,0,50,42
1656960752012,CSE 15L,A02,083655,Morris; Justin Loren,8,0,50,42
1656960758035,CSE 20,A01,083657,Tran; Khoa Dang,37,0,80,43
1656960764059,CSE 21,A01,095574,Bach; Quang Tran,21,0,48,27
1656960770082,CSE 30,A01,083084,Eldon; John,4,0,80,76
1656960770082,CSE 30,B01,095061,Bhaskar; Nishant,6,0,50,44
1656960776108,CSE 100,A01,083659,Cao; Yingjun,3,4,70,67
1656960782132,CSE 134B,A01,083661,Powell; Thomas Allan,19,0,100,81
1656960788155,CSE 140,A01,083663,Gungor; Onat,14,0,85,71
1656960794196,CSE 140L,A01,083088,Eldon; John,16,0,100,84
1656960800223,CSE 175,A01,083665,Kumar; Rakesh,3,0,25,22
1656960806247,CSE 190,A00,092507,Dubnov; Shlomo,7,0,20,13
1656960812270,ECE 45,A01,083139,Congero; Spencer William,5,0,75,70
1656960818293,ECE 65,A50,083695,Saad; Andrew S,12,0,30,18
1656960818293,ECE 65,A51,095125,Saad; Andrew S,25,0,26,1
1656960824316,ECE 109,A01,091882,Touri; Behrouz,16,0,70,54
1656960830340,ECE 180,A00,083140,Abi Samra; Nicholas Camill,0,0,30,30
1656960830340,ECE 180,B00,083141,Abi Samra; Nicholas Camill,0,0,30,30
1656960836364,MATH 10A,A01,083735,Patchell; Gregory David,1,0,30,29
1656960836364,MATH 10A,A02,083736,Patchell; Gregory David,20,0,30,10
1656960836364,MATH 10A,A03,083737,Patchell; Gregory David,15,0,30,15
1656960842392,MATH 10B,A01,083207,Lim; Seonhee,7,0,34,27
1656960842392,MATH 10B,A02,083208,Lim; Seonhee,9,0,35,26
1656960842392,MATH 10B,A03,093472,Lim; Seonhee,4,0,34,30
1656960842392,MATH 10B,B01,083739,Sinha; Shubham,9,0,30,21
1656960848423,MATH 18,A01,083743,Cinel; Cameron Alexander,6,0,30,24
1656960848423,MATH 18,A02,083744,Cinel; Cameron Alexander,15,0,30,15
1656960848423,MATH 18,A03,083745,Cinel; Cameron Alexander,8,0,30,22
1656960848423,MATH 18,B01,083748,Rideout; David Porter,4,0,37,33
1656960848423,MATH 18,B02,083749,Rideout; David Porter,3,0,36,33
1656960848423,MATH 18,B03,083750,Rideout; David Porter,2,0,37,35
1656960848423,MATH 18,B04,083751,Rideout; David Porter,5,0,36,31
1656960848423,MATH 18,B05,093473,Rideout; David Porter,4,0,36,32
1656960848423,MATH 18,B06,093474,Rideout; David Porter,5,0,36,31
1656960854446,MATH 20A,A01,083754,Zheng; Zequn,12,0,40,28
1656960860471,MATH 20B,A01,083756,Briones; Jor-el Thomas Caparas,1,0,36,35
1656960860471,MATH 20B,A02,083757,Briones; Jor-el Thomas Caparas,1,0,36,35
1656960860471,MATH 20B,A03,093475,Briones; Jor-el Thomas Caparas,0,0,36,36
1656960866496,MATH 20C,A01,083760,Briones; Jor-el Thomas Caparas,1,0,35,34
1656960866496,MATH 20C,A02,083761,Briones; Jor-el Thomas Caparas,8,0,35,27
1656960866496,MATH 20C,A03,093476,Briones; Jor-el Thomas Caparas,0,1,36,36
1656960866496,MATH 20C,B01,083762,Bach; Quang Tran,0,0,30,30
1656960872518,MATH 20D,A01,083765,Tran; Brian Kha,4,0,30,26
1656960872518,MATH 20D,A02,083766,Tran; Brian Kha,4,0,30,26
1656960872518,MATH 20D,A03,083767,Tran; Brian Kha,3,0,30,27
1656960878547,MATH 20E,A01,083771,Ganguly; Soumya,5,0,32,27
1656960878547,MATH 20E,A02,083772,Ganguly; Soumya,6,0,32,26
1656960878547,MATH 20E,B01,083773,Ciotti; Benjamin,18,0,35,17
1656960878547,MATH 20E,B02,083774,Ciotti; Benjamin,17,0,35,18
1656960884572,MATH 103A,A01,083777,Greenfeld; Be'Eri,2,0,36,34
1656960884572,MATH 103A,A02,083778,Greenfeld; Be'Eri,5,0,36,31
1656960884572,MATH 103A,A03,093561,Greenfeld; Be'Eri,4,0,36,32
1656960884572,MATH 103A,B01,083779,Greenfeld; Be'Eri,6,0,36,30
1656960884572,MATH 103A,B02,083780,Greenfeld; Be'Eri,2,0,36,34
1656960884572,MATH 103A,B03,093562,Greenfeld; Be'Eri,2,0,36,34
1656960890603,MATH 105,A01,085443,Carter; Anne Toulson,14,0,35,21
1656960890603,MATH 105,A02,093477,Carter; Anne Toulson,20,0,35,15
1656960896628,MATH 109,A01,083213,Ganzberger; Geoffrey Michael,2,0,34,32
1656960896628,MATH 109,A02,083214,Ganzberger; Geoffrey Michael,2,0,34,32
1656960896628,MATH 109,A03,093478,Ganzberger; Geoffrey Michael,1,0,34,33
1656960896628,MATH 109,B01,083215,Ganzberger; Geoffrey Michael,1,0,32,31
1656960896628,MATH 109,B02,083216,Ganzberger; Geoffrey Michael,1,0,32,31
1656960896628,MATH 109,B03,093479,Ganzberger; Geoffrey Michael,6,0,32,26
1656960902651,MATH 142A,A01,083219,Chow; Bennett,6,0,32,26
1656960902651,MATH 142A,A02,083220,Chow; Bennett,10,0,32,22
1656960902651,MATH 142A,A03,093480,Chow; Bennett,7,0,32,25
1656960902651,MATH 142A,B03,093481,Chow; Bennett,7,0,32,25
1656960902651,MATH 142A,B04,093558,Chow; Bennett,11,0,32,21
1656960902651,MATH 142A,B05,093559,Chow; Bennett,6,0,32,26
1656960908677,MATH 193A,A01,083224,Rotar; Vladimir,7,0,34,27
1656960908677,MATH 193A,A02,083225,Rotar; Vladimir,4,0,34,30
1656960908677,MATH 193A,A03,083781,Rotar; Vladimir,1,0,34,33
1656960908677,MATH 193A,A04,083782,Rotar; Vladimir,6,0,34,28
1656960908677,MATH 193A,A05,093482,Rotar; Vladimir,6,0,34,28
1656960914703,MATH 197,001,091859,McAuley; Julian John,9999,0,9999,0
1656960914703,MATH 197,002,095566,Kedlaya; Kiran S.,9997,0,9999,2
1656960914703,MATH 197,003,095567,Xiao; Ming,9999,0,9999,0
1656960914703,MATH 197,004,095571,Perols; Johan Lars,9998,0,9999,1
1656960921756,COGS 9,A01,083615,Shannon; Kyle Michael,7,0,75,68
1656960927780,COGS 11,A01,083617,Boyle; Mary E. T.,19,0,48,29
1656960933803,COGS 13,A01,083071,Bastos; Amalia Pinkusfeld,9,0,71,62
1656960939825,COGS 14A,A01,092681,Semenuks; Arturs,0,1,100,100
1656960945851,COGS 14B,A01,083073,Cheng; Tzu-Han,5,0,63,58
1656960951874,COGS 17,A01,092677,Semenuks; Arturs,4,0,81,77
1656960957897,COGS 100,A01,083619,Allen; Michael Gordon,15,0,70,55
1656960963923,COGS 101A,A01,083621,Davis; Joshua Daniel,9,0,68,59
1656960969947,COGS 101B,A01,091572,Allen; Michael Gordon,8,0,65,57
1656960975974,COGS 101C,A01,083625,Delgado; Tania,17,0,35,18
1656960982000,COGS 107A,A01,083627,Boyle; Mary E. T.,13,0,60,47
1656960988033,COGS 118A,A01,083075,Gupta; Anjum,15,0,76,61
1656960994055,CSE 3,A50,083646,Miranda; Gregory Joseph,22,0,50,28
1656961000083,CSE 8A,A50,083650,Miranda; Gregory Joseph,17,1,56,39
1656961006121,CSE 11,A01,083080,Cao; Yingjun,4,15,40,36
1656961012143,CSE 12,A01,083652,Krause-Levy; Sophia Louisa,20,1,120,100
1656961018165,CSE 15L,A01,083654,Morris; Justin Loren,8,0,50,42
1656961018165,CSE 15L,A02,083655,Morris; Justin Loren,8,0,50,42
1656961024192,CSE 20,A01,083657,Tran; Khoa Dang,37,0,80,43
1656961030216,CSE 21,A01,095574,Bach; Quang Tran,21,0,48,27
1656961036240,CSE 30,A01,083084,Eldon; John,4,0,80,76
1656961036240,CSE 30,B01,095061,Bhaskar; Nishant,6,0,50,44
1656961042263,CSE 100,A01,083659,Cao; Yingjun,3,4,70,67
1656961048292,CSE 134B,A01,083661,Powell; Thomas Allan,19,0,100,81
1656961054319,CSE 140,A01,083663,Gungor; Onat,14,0,85,71
1656961060344,CSE 140L,A01,083088,Eldon; John,16,0,100,84
1656961066376,CSE 175,A01,083665,Kumar; Rakesh,3,0,25,22
1656961072403,CSE 190,A00,092507,Dubnov; Shlomo,7,0,20,13
1656961078430,ECE 45,A01,083139,Congero; Spencer William,5,0,75,70
1656961084457,ECE 65,A50,083695,Saad; Andrew S,12,0,30,18
1656961084457,ECE 65,A51,095125,Saad; Andrew S,25,0,26,1
1656961090486,ECE 109,A01,091882,Touri; Behrouz,16,0,70,54
1656961096512,ECE 180,A00,083140,Abi Samra; Nicholas Camill,0,0,30,30
1656961096512,ECE 180,B00,083141,Abi Samra; Nicholas Camill,0,0,30,30
1656961102543,MATH 10A,A01,083735,Patchell; Gregory David,1,0,30,29
1656961102543,MATH 10A,A02,083736,Patchell; Gregory David,20,0,30,10
1656961102543,MATH 10A,A03,083737,Patchell; Gregory David,15,0,30,15
1656961108573,MATH 10B,A01,083207,Lim; Seonhee,7,0,34,27
1656961108573,MATH 10B,A02,083208,Lim; Seonhee,9,0,35,26
1656961108573,MATH 10B,A03,093472,Lim; Seonhee,4,0,34,30
1656961108573,MATH 10B,B01,083739,Sinha; Shubham,9,0,30,21
1656961114607,MATH 18,A01,083743,Cinel; Cameron Alexander,6,0,30,24
1656961114607,MATH 18,A02,083744,Cinel; Cameron Alexander,15,0,30,15
1656961114607,MATH 18,A03,083745,Cinel; Cameron Alexander,8,0,30,22
1656961114607,MATH 18,B01,083748,Rideout; David Porter,4,0,37,33
1656961114607,MATH 18,B02,083749,Rideout; David Porter,3,0,36,33
1656961114607,MATH 18,B03,083750,Rideout; David Porter,2,0,37,35
1656961114607,MATH 18,B04,083751,Rideout; David Porter,5,0,36,31
1656961114607,MATH 18,B05,093473,Rideout; David Porter,4,0,36,32
1656961114607,MATH 18,B06,093474,Rideout; David Porter,5,0,36,31
1656961120629,MATH 20A,A01,083754,Zheng; Zequn,12,0,40,28
1656961126668,MATH 20B,A01,083756,Briones; Jor-el Thomas Caparas,1,0,36,35
1656961126668,MATH 20B,A02,083757,Briones; Jor-el Thomas Caparas,1,0,36,35
1656961126668,MATH 20B,A03,093475,Briones; Jor-el Thomas Caparas,0,0,36,36
1656961132692,MATH 20C,A01,083760,Briones; Jor-el Thomas Caparas,1,0,35,34
1656961132692,MATH 20C,A02,083761,Briones; Jor-el Thomas Caparas,8,0,35,27
1656961132692,MATH 20C,A03,093476,Briones; Jor-el Thomas Caparas,0,1,36,36
1656961132692,MATH 20C,B01,083762,Bach; Quang Tran,0,0,30,30
1656961138715,MATH 20D,A01,083765,Tran; Brian Kha,4,0,30,26
1656961138715,MATH 20D,A02,083766,Tran; Brian Kha,4,0,30,26
1656961138715,MATH 20D,A03,083767,Tran; Brian Kha,3,0,30,27
1656961144737,MATH 20E,A01,083771,Ganguly; Soumya,5,0,32,27
1656961144737,MATH 20E,A02,083772,Ganguly; Soumya,6,0,32,26
1656961144737,MATH 20E,B01,083773,Ciotti; Benjamin,18,0,35,17
1656961144737,MATH 20E,B02,083774,Ciotti; Benjamin,17,0,35,18
1656961150770,MATH 103A,A01,083777,Greenfeld; Be'Eri,2,0,36,34
1656961150770,MATH 103A,A02,083778,Greenfeld; Be'Eri,5,0,36,31
1656961150770,MATH 103A,A03,093561,Greenfeld; Be'Eri,4,0,36,32
1656961150770,MATH 103A,B01,083779,Greenfeld; Be'Eri,6,0,36,30
1656961150770,MATH 103A,B02,083780,Greenfeld; Be'Eri,2,0,36,34
1656961150770,MATH 103A,B03,093562,Greenfeld; Be'Eri,2,0,36,34
1656961156794,MATH 105,A01,085443,Carter; Anne Toulson,14,0,35,21
1656961156794,MATH 105,A02,093477,Carter; Anne Toulson,20,0,35,15
1656961162823,MATH 109,A01,083213,Ganzberger; Geoffrey Michael,2,0,34,32
1656961162823,MATH 109,A02,083214,Ganzberger; Geoffrey Michael,2,0,34,32
1656961162823,MATH 109,A03,093478,Ganzberger; Geoffrey Michael,1,0,34,33
1656961162823,MATH 109,B01,083215,Ganzberger; Geoffrey Michael,1,0,32,31
1656961162823,MATH 109,B02,083216,Ganzberger; Geoffrey Michael,1,0,32,31
1656961162823,MATH 109,B03,093479,Ganzberger; Geoffrey Michael,6,0,32,26
1656961168846,MATH 142A,A01,083219,Chow; Bennett,6,0,32,26
1656961168846,MATH 142A,A02,083220,Chow; Bennett,10,0,32,22
1656961168846,MATH 142A,A03,093480,Chow; Bennett,7,0,32,25
1656961168846,MATH 142A,B03,093481,Chow; Bennett,7,0,32,25
1656961168846,MATH 142A,B04,093558,Chow; Bennett,11,0,32,21
1656961168846,MATH 142A,B05,093559,Chow; Bennett,6,0,32,26
1656961174868,MATH 193A,A01,083224,Rotar; Vladimir,7,0,34,27
1656961174868,MATH 193A,A02,083225,Rotar; Vladimir,4,0,34,30
1656961174868,MATH 193A,A03,083781,Rotar; Vladimir,1,0,34,33
1656961174868,MATH 193A,A04,083782,Rotar; Vladimir,6,0,34,28
1656961174868,MATH 193A,A05,093482,Rotar; Vladimir,6,0,34,28
1656961180891,MATH 197,001,091859,McAuley; Julian John,9999,0,9999,0
1656961180891,MATH 197,002,095566,Kedlaya; Kiran S.,9997,0,9999,2
1656961180891,MATH 197,003,095567,Xiao; Ming,9999,0,9999,0
1656961180891,MATH 197,004,095571,Perols; Johan Lars,9998,0,9999,1
1656961187945,COGS 9,A01,083615,Shannon; Kyle Michael,7,0,75,68
1656961193970,COGS 11,A01,083617,Boyle; Mary E. T.,19,0,48,29
1656961199996,COGS 13,A01,083071,Bastos; Amalia Pinkusfeld,9,0,71,62
1656961206021,COGS 14A,A01,092681,Semenuks; Arturs,0,1,100,100
1656961212046,COGS 14B,A01,083073,Cheng; Tzu-Han,5,0,63,58
1656961218073,COGS 17,A01,092677,Semenuks; Arturs,4,0,81,77
1656961224094,COGS 100,A01,083619,Allen; Michael Gordon,15,0,70,55
1656961230190,COGS 101A,A01,083621,Davis; Joshua Daniel,9,0,68,59
1656961236217,COGS 101B,A01,091572,Allen; Michael Gordon,8,0,65,57
1656961242244,COGS 101C,A01,083625,Delgado; Tania,17,0,35,18
1656961248271,COGS 107A,A01,083627,Boyle; Mary E. T.,13,0,60,47
1656961254299,COGS 118A,A01,083075,Gupta; Anjum,15,0,76,61
1656961260333,CSE 3,A50,083646,Miranda; Gregory Joseph,22,0,50,28
1656961266369,CSE 8A,A50,083650,Miranda; Gregory Joseph,17,1,56,39
1656961272395,CSE 11,A01,083080,Cao; Yingjun,4,15,40,36
1656961278426,CSE 12,A01,083652,Krause-Levy; Sophia Louisa,20,1,120,100
1656961284451,CSE 15L,A01,083654,Morris; Justin Loren,8,0,50,42
1656961284451,CSE 15L,A02,083655,Morris; Justin Loren,8,0,50,42
1656961290475,CSE 20,A01,083657,Tran; Khoa Dang,37,0,80,43
1656961296499,CSE 21,A01,095574,Bach; Quang Tran,21,0,48,27
1656961302523,CSE 30,A01,083084,Eldon; John,4,0,80,76
1656961302523,CSE 30,B01,095061,Bhaskar; Nishant,6,0,50,44
1656961308549,CSE 100,A01,083659,Cao; Yingjun,3,4,70,67
1656961314575,CSE 134B,A01,083661,Powell; Thomas Allan,19,0,100,81
1656961320602,CSE 140,A01,083663,Gungor; Onat,14,0,85,71
1656961326629,CSE 140L,A01,083088,Eldon; John,16,0,100,84
1656961332657,CSE 175,A01,083665,Kumar; Rakesh,3,0,25,22
1656961338680,CSE 190,A00,092507,Dubnov; Shlomo,7,0,20,13
1656961344705,ECE 45,A01,083139,Congero; Spencer William,5,0,75,70
1656961350729,ECE 65,A50,083695,Saad; Andrew S,12,0,30,18
1656961350729,ECE 65,A51,095125,Saad; Andrew S,25,0,26,1
1656961356752,ECE 109,A01,091882,Touri; Behrouz,16,0,70,54
1656961362781,ECE 180,A00,083140,Abi Samra; Nicholas Camill,0,0,30,30
1656961362781,ECE 180,B00,083141,Abi Samra; Nicholas Camill,0,0,30,30
1656961368804,MATH 10A,A01,083735,Patchell; Gregory David,1,0,30,29
1656961368804,MATH 10A,A02,083736,Patchell; Gregory David,20,0,30,10
1656961368804,MATH 10A,A03,083737,Patchell; Gregory David,15,0,30,15
1656961374832,MATH 10B,A01,083207,Lim; Seonhee,7,0,34,27
1656961374832,MATH 10B,A02,083208,Lim; Seonhee,9,0,35,26
1656961374832,MATH 10B,A03,093472,Lim; Seonhee,4,0,34,30
1656961374832,MATH 10B,B01,083739,Sinha; Shubham,9,0,30,21
1656961380857,MATH 18,A01,083743,Cinel; Cameron Alexander,6,0,30,24
1656961380857,MATH 18,A02,083744,Cinel; Cameron Alexander,15,0,30,15
1656961380857,MATH 18,A03,083745,Cinel; Cameron Alexander,8,0,30,22
1656961380857,MATH 18,B01,083748,Rideout; David Porter,4,0,37,33
1656961380857,MATH 18,B02,083749,Rideout; David Porter,3,0,36,33
1656961380857,MATH 18,B03,083750,Rideout; David Porter,2,0,37,35
1656961380857,MATH 18,B04,083751,Rideout; David Porter,5,0,36,31
1656961380857,MATH 18,B05,093473,Rideout; David Porter,4,0,36,32
1656961380857,MATH 18,B06,093474,Rideout; David Porter,5,0,36,31
1656961386890,MATH 20A,A01,083754,Zheng; Zequn,12,0,40,28
1656961392914,MATH 20B,A01,083756,Briones; Jor-el Thomas Caparas,1,0,36,35
1656961392914,MATH 20B,A02,083757,Briones; Jor-el Thomas Caparas,1,0,36,35
1656961392914,MATH 20B,A03,093475,Briones; Jor-el Thomas Caparas,0,0,36,36
1656961398946,MATH 20C,A01,083760,Briones; Jor-el Thomas Caparas,1,0,35,34
1656961398946,MATH 20C,A02,083761,Briones; Jor-el Thomas Caparas,8,0,35,27
1656961398946,MATH 20C,A03,093476,Briones; Jor-el Thomas Caparas,0,1,36,36
1656961398946,MATH 20C,B01,083762,Bach; Quang Tran,0,0,30,30
1656961404969,MATH 20D,A01,083765,Tran; Brian Kha,4,0,30,26
1656961404969,MATH 20D,A02,083766,Tran; Brian Kha,4,0,30,26
1656961404969,MATH 20D,A03,083767,Tran; Brian Kha,3,0,30,27
1656961410997,MATH 20E,A01,083771,Ganguly; Soumya,5,0,32,27
1656961410997,MATH 20E,A02,083772,Ganguly; Soumya,6,0,32,26
1656961410997,MATH 20E,B01,083773,Ciotti; Benjamin,18,0,35,17
1656961410997,MATH 20E,B02,083774,Ciotti; Benjamin,17,0,35,18
1656961417029,MATH 103A,A01,083777,Greenfeld; Be'Eri,2,0,36,34
1656961417029,MATH 103A,A02,083778,Greenfeld; Be'Eri,5,0,36,31
1656961417029,MATH 103A,A03,093561,Greenfeld; Be'Eri,4,0,36,32
1656961417029,MATH 103A,B01,083779,Greenfeld; Be'Eri,6,0,36,30
1656961417029,MATH 103A,B02,083780,Greenfeld; Be'Eri,2,0,36,34
1656961417029,MATH 103A,B03,093562,Greenfeld; Be'Eri,2,0,36,34
1656961423053,MATH 105,A01,085443,Carter; Anne Toulson,14,0,35,21
1656961423053,MATH 105,A02,093477,Carter; Anne Toulson,20,0,35,15
1656961429079,MATH 109,A01,083213,Ganzberger; Geoffrey Michael,2,0,34,32
1656961429079,MATH 109,A02,083214,Ganzberger; Geoffrey Michael,2,0,34,32
1656961429079,MATH 109,A03,093478,Ganzberger; Geoffrey Michael,1,0,34,33
1656961429079,MATH 109,B01,083215,Ganzberger; Geoffrey Michael,1,0,32,31
1656961429079,MATH 109,B02,083216,Ganzberger; Geoffrey Michael,1,0,32,31
1656961429079,MATH 109,B03,093479,Ganzberger; Geoffrey Michael,6,0,32,26
1656961435103,MATH 142A,A01,083219,Chow; Bennett,6,0,32,26
1656961435103,MATH 142A,A02,083220,Chow; Bennett,10,0,32,22
1656961435103,MATH 142A,A03,093480,Chow; Bennett,7,0,32,25
1656961435103,MATH 142A,B03,093481,Chow; Bennett,7,0,32,25
1656961435103,MATH 142A,B04,093558,Chow; Bennett,11,0,32,21
1656961435103,MATH 142A,B05,093559,Chow; Bennett,6,0,32,26
1656961441129,MATH 193A,A01,083224,Rotar; Vladimir,7,0,34,27
1656961441129,MATH 193A,A02,083225,Rotar; Vladimir,4,0,34,30
1656961441129,MATH 193A,A03,083781,Rotar; Vladimir,1,0,34,33
1656961441129,MATH 193A,A04,083782,Rotar; Vladimir,6,0,34,28
1656961441129,MATH 193A,A05,093482,Rotar; Vladimir,6,0,34,28
1656961447153,MATH 197,001,091859,McAuley; Julian John,9999,0,9999,0
1656961447153,MATH 197,002,095566,Kedlaya; Kiran S.,9997,0,9999,2
1656961447153,MATH 197,003,095567,Xiao; Ming,9999,0,9999,0
1656961447153,MATH 197,004,095571,Perols; Johan Lars,9998,0,9999,1
1656961454205,COGS 9,A01,083615,Shannon; Kyle Michael,7,0,75,68
1656961460231,COGS 11,A01,083617,Boyle; Mary E. T.,19,0,48,29
1656961466253,COGS 13,A01,083071,Bastos; Amalia Pinkusfeld,9,0,71,62
1656961472275,COGS 14A,A01,092681,Semenuks; Arturs,0,1,100,100
1656961478299,COGS 14B,A01,083073,Cheng; Tzu-Han,5,0,63,58
1656961484325,COGS 17,A01,092677,Semenuks; Arturs,4,0,81,77
1656961490349,COGS 100,A01,083619,Allen; Michael Gordon,15,0,70,55
1656961496371,COGS 101A,A01,083621,Davis; Joshua Daniel,9,0,68,59
1656961502395,COGS 101B,A01,091572,Allen; Michael Gordon,8,0,65,57
1656961508417,COGS 101C,A01,083625,Delgado; Tania,17,0,35,18
1656961514465,COGS 107A,A01,083627,Boyle; Mary E. T.,13,0,60,47
1656961520489,COGS 118A,A01,083075,Gupta; Anjum,15,0,76,61
1656961526514,CSE 3,A50,083646,Miranda; Gregory Joseph,22,0,50,28
1656961532541,CSE 8A,A50,083650,Miranda; Gregory Joseph,17,1,56,39
1656961538565,CSE 11,A01,083080,Cao; Yingjun,4,15,40,36
1656961544587,CSE 12,A01,083652,Krause-Levy; Sophia Louisa,20,1,120,100
1656961550610,CSE 15L,A01,083654,Morris; Justin Loren,8,0,50,42
1656961550610,CSE 15L,A02,083655,Morris; Justin Loren,8,0,50,42
1656961556638,CSE 20,A01,083657,Tran; Khoa Dang,37,0,80,43
1656961562661,CSE 21,A01,095574,Bach; Quang Tran,21,0,48,27
1656961568687,CSE 30,A01,083084,Eldon; John,4,0,80,76
1656961568687,CSE 30,B01,095061,Bhaskar; Nishant,6,0,50,44
1656961574711,CSE 100,A01,083659,Cao; Yingjun,3,4,70,67
1656961580734,CSE 134B,A01,083661,Powell; Thomas Allan,19,0,100,81
1656961586757,CSE 140,A01,083663,Gungor; Onat,14,0,85,71
1656961592779,CSE 140L,A01,083088,Eldon; John,16,0,100,84
1656961598802,CSE 175,A01,083665,Kumar; Rakesh,3,0,25,22
1656961604828,CSE 190,A00,092507,Dubnov; Shlomo,7,0,20,13
1656961610856,ECE 45,A01,083139,Congero; Spencer William,5,0,75,70
1656961616882,ECE 65,A50,083695,Saad; Andrew S,12,0,30,18
1656961616882,ECE 65,A51,095125,Saad; Andrew S,25,0,26,1
1656961622905,ECE 109,A01,091882,Touri; Behrouz,16,0,70,54
1656961628929,ECE 180,A00,083140,Abi Samra; Nicholas Camill,0,0,30,30
1656961628929,ECE 180,B00,083141,Abi Samra; Nicholas Camill,0,0,30,30
1656961634957,MATH 10A,A01,083735,Patchell; Gregory David,1,0,30,29
1656961634957,MATH 10A,A02,083736,Patchell; Gregory David,20,0,30,10
1656961634957,MATH 10A,A03,083737,Patchell; Gregory David,15,0,30,15
1656961640981,MATH 10B,A01,083207,Lim; Seonhee,7,0,34,27
1656961640981,MATH 10B,A02,083208,Lim; Seonhee,9,0,35,26
1656961640981,MATH 10B,A03,093472,Lim; Seonhee,4,0,34,30
1656961640981,MATH 10B,B01,083739,Sinha; Shubham,9,0,30,21
1656961647003,MATH 18,A01,083743,Cinel; Cameron Alexander,6,0,30,24
1656961647003,MATH 18,A02,083744,Cinel; Cameron Alexander,15,0,30,15
1656961647003,MATH 18,A03,083745,Cinel; Cameron Alexander,8,0,30,22
1656961647003,MATH 18,B01,083748,Rideout; David Porter,4,0,37,33
1656961647003,MATH 18,B02,083749,Rideout; David Porter,3,0,36,33
1656961647003,MATH 18,B03,083750,Rideout; David Porter,2,0,37,35
1656961647003,MATH 18,B04,083751,Rideout; David Porter,5,0,36,31
1656961647003,MATH 18,B05,093473,Rideout; David Porter,4,0,36,32
1656961647003,MATH 18,B06,093474,Rideout; David Porter,5,0,36,31
1656961653029,MATH 20A,A01,083754,Zheng; Zequn,12,0,40,28
1656961659054,MATH 20B,A01,083756,Briones; Jor-el Thomas Caparas,1,0,36,35
1656961659054,MATH 20B,A02,083757,Briones; Jor-el Thomas Caparas,1,0,36,35
1656961659054,MATH 20B,A03,093475,Briones; Jor-el Thomas Caparas,0,0,36,36
1656961665084,MATH 20C,A01,083760,Briones; Jor-el Thomas Caparas,1,0,35,34
1656961665084,MATH 20C,A02,083761,Briones; Jor-el Thomas Caparas,8,0,35,27
1656961665084,MATH 20C,A03,093476,Briones; Jor-el Thomas Caparas,0,1,36,36
1656961665084,MATH 20C,B01,083762,Bach; Quang Tran,0,0,30,30
1656961671114,MATH 20D,A01,083765,Tran; Brian Kha,4,0,30,26
1656961671114,MATH 20D,A02,083766,Tran; Brian Kha,4,0,30,26
1656961671114,MATH 20D,A03,083767,Tran; Brian Kha,3,0,30,27
1656961677143,MATH 20E,A01,083771,Ganguly; Soumya,5,0,32,27
1656961677143,MATH 20E,A02,083772,Ganguly; Soumya,6,0,32,26
1656961677143,MATH 20E,B01,083773,Ciotti; Benjamin,18,0,35,17
1656961677143,MATH 20E,B02,083774,Ciotti; Benjamin,17,0,35,18
1656961683167,MATH 103A,A01,083777,Greenfeld; Be'Eri,2,0,36,34
1656961683167,MATH 103A,A02,083778,Greenfeld; Be'Eri,5,0,36,31
1656961683167,MATH 103A,A03,093561,Greenfeld; Be'Eri,4,0,36,32
1656961683167,MATH 103A,B01,083779,Greenfeld; Be'Eri,6,0,36,30
1656961683167,MATH 103A,B02,083780,Greenfeld; Be'Eri,2,0,36,34
1656961683167,MATH 103A,B03,093562,Greenfeld; Be'Eri,2,0,36,34
1656961689189,MATH 105,A01,085443,Carter; Anne Toulson,14,0,35,21
1656961689189,MATH 105,A02,093477,Carter; Anne Toulson,20,0,35,15
1656961695217,MATH 109,A01,083213,Ganzberger; Geoffrey Michael,2,0,34,32
1656961695217,MATH 109,A02,083214,Ganzberger; Geoffrey Michael,2,0,34,32
1656961695217,MATH 109,A03,093478,Ganzberger; Geoffrey Michael,1,0,34,33
1656961695217,MATH 109,B01,083215,Ganzberger; Geoffrey Michael,1,0,32,31
1656961695217,MATH 109,B02,083216,Ganzberger; Geoffrey Michael,1,0,32,31
1656961695217,MATH 109,B03,093479,Ganzberger; Geoffrey Michael,6,0,32,26
1656961701241,MATH 142A,A01,083219,Chow; Bennett,6,0,32,26
1656961701241,MATH 142A,A02,083220,Chow; Bennett,10,0,32,22
1656961701241,MATH 142A,A03,093480,Chow; Bennett,7,0,32,25
1656961701241,MATH 142A,B03,093481,Chow; Bennett,7,0,32,25
1656961701241,MATH 142A,B04,093558,Chow; Bennett,11,0,32,21
1656961701241,MATH 142A,B05,093559,Chow; Bennett,6,0,32,26
1656961707272,MATH 193A,A01,083224,Rotar; Vladimir,7,0,34,27
1656961707272,MATH 193A,A02,083225,Rotar; Vladimir,4,0,34,30
1656961707272,MATH 193A,A03,083781,Rotar; Vladimir,1,0,34,33
1656961707272,MATH 193A,A04,083782,Rotar; Vladimir,6,0,34,28
1656961707272,MATH 193A,A05,093482,Rotar; Vladimir,6,0,34,28
1656961713299,MATH 197,001,091859,McAuley; Julian John,9999,0,9999,0
1656961713299,MATH 197,002,095566,Kedlaya; Kiran S.,9997,0,9999,2
1656961713299,MATH 197,003,095567,Xiao; Ming,9999,0,9999,0
1656961713299,MATH 197,004,095571,Perols; Johan Lars,9998,0,9999,1
1656961720358,COGS 9,A01,083615,Shannon; Kyle Michael,7,0,75,68
1656961726387,COGS 11,A01,083617,Boyle; Mary E. T.,19,0,48,29
1656961732412,COGS 13,A01,083071,Bastos; Amalia Pinkusfeld,9,0,71,62
1656961738437,COGS 14A,A01,092681,Semenuks; Arturs,0,1,100,100
1656961744460,COGS 14B,A01,083073,Cheng; Tzu-Han,5,0,63,58
1656961750492,COGS 17,A01,092677,Semenuks; Arturs,4,0,81,77
1656961756515,COGS 100,A01,083619,Allen; Michael Gordon,15,0,70,55
1656961762544,COGS 101A,A01,083621,Davis; Joshua Daniel,9,0,68,59
1656961768572,COGS 101B,A01,091572,Allen; Michael Gordon,8,0,65,57
1656961774593,COGS 101C,A01,083625,Delgado; Tania,17,0,35,18
1656961780616,COGS 107A,A01,083627,Boyle; Mary E. T.,13,0,60,47
1656961786639,COGS 118A,A01,083075,Gupta; Anjum,15,0,76,61
1656961792662,CSE 3,A50,083646,Miranda; Gregory Joseph,22,0,50,28
1656961798686,CSE 8A,A50,083650,Miranda; Gregory Joseph,17,1,56,39
1656961804714,CSE 11,A01,083080,Cao; Yingjun,4,15,40,36
1656961810740,CSE 12,A01,083652,Krause-Levy; Sophia Louisa,20,1,120,100
1656961816765,CSE 15L,A01,083654,Morris; Justin Loren,8,0,50,42
1656961816765,CSE 15L,A02,083655,Morris; Justin Loren,8,0,50,42
1656961822787,CSE 20,A01,083657,Tran; Khoa Dang,37,0,80,43
1656961828892,CSE 21,A01,095574,Bach; Quang Tran,21,0,48,27
1656961834922,CSE 30,A01,083084,Eldon; John,4,0,80,76
1656961834922,CSE 30,B01,095061,Bhaskar; Nishant,6,0,50,44
1656961840946,CSE 100,A01,083659,Cao; Yingjun,3,4,70,67
1656961846968,CSE 134B,A01,083661,Powell; Thomas Allan,19,0,100,81
1656961852993,CSE 140,A01,083663,Gungor; Onat,14,0,85,71
1656961859017,CSE 140L,A01,083088,Eldon; John,16,0,100,84
1656961865081,CSE 175,A01,083665,Kumar; Rakesh,3,0,25,22
1656961871103,CSE 190,A00,092507,Dubnov; Shlomo,7,0,20,13
1656961877139,ECE 45,A01,083139,Congero; Spencer William,5,0,75,70
1656961883168,ECE 65,A50,083695,Saad; Andrew S,12,0,30,18
1656961883168,ECE 65,A51,095125,Saad; Andrew S,25,0,26,1
1656961889195,ECE 109,A01,091882,Touri; Behrouz,16,0,70,54
1656961895223,ECE 180,A00,083140,Abi Samra; Nicholas Camill,0,0,30,30
1656961895223,ECE 180,B00,083141,Abi Samra; Nicholas Camill,0,0,30,30
1656961901252,MATH 10A,A01,083735,Patchell; Gregory David,1,0,30,29
1656961901252,MATH 10A,A02,083736,Patchell; Gregory David,20,0,30,10
1656961901252,MATH 10A,A03,083737,Patchell; Gregory David,15,0,30,15
1656961907290,MATH 10B,A01,083207,Lim; Seonhee,7,0,34,27
1656961907290,MATH 10B,A02,083208,Lim; Seonhee,9,0,35,26
1656961907290,MATH 10B,A03,093472,Lim; Seonhee,4,0,34,30
1656961907290,MATH 10B,B01,083739,Sinha; Shubham,9,0,30,21
1656961913316,MATH 18,A01,083743,Cinel; Cameron Alexander,6,0,30,24
1656961913316,MATH 18,A02,083744,Cinel; Cameron Alexander,15,0,30,15
1656961913316,MATH 18,A03,083745,Cinel; Cameron Alexander,8,0,30,22
1656961913316,MATH 18,B01,083748,Rideout; David Porter,4,0,37,33
1656961913316,MATH 18,B02,083749,Rideout; David Porter,3,0,36,33
1656961913316,MATH 18,B03,083750,Rideout; David Porter,2,0,37,35
1656961913316,MATH 18,B04,083751,Rideout; David Porter,5,0,36,31
1656961913316,MATH 18,B05,093473,Rideout; David Porter,4,0,36,32
1656961913316,MATH 18,B06,093474,Rideout; David Porter,5,0,36,31
1656961919351,MATH 20A,A01,083754,Zheng; Zequn,12,0,40,28
1656961925385,MATH 20B,A01,083756,Briones; Jor-el Thomas Caparas,1,0,36,35
1656961925385,MATH 20B,A02,083757,Briones; Jor-el Thomas Caparas,1,0,36,35
1656961925385,MATH 20B,A03,093475,Briones; Jor-el Thomas Caparas,0,0,36,36
1656961931412,MATH 20C,A01,083760,Briones; Jor-el Thomas Caparas,1,0,35,34
1656961931412,MATH 20C,A02,083761,Briones; Jor-el Thomas Caparas,8,0,35,27
1656961931412,MATH 20C,A03,093476,Briones; Jor-el Thomas Caparas,0,1,36,36
1656961931412,MATH 20C,B01,083762,Bach; Quang Tran,0,0,30,30
1656961937439,MATH 20D,A01,083765,Tran; Brian Kha,4,0,30,26
1656961937439,MATH 20D,A02,083766,Tran; Brian Kha,4,0,30,26
1656961937439,MATH 20D,A03,083767,Tran; Brian Kha,3,0,30,27
1656961943464,MATH 20E,A01,083771,Ganguly; Soumya,5,0,32,27
1656961943464,MATH 20E,A02,083772,Ganguly; Soumya,6,0,32,26
1656961943464,MATH 20E,B01,083773,Ciotti; Benjamin,18,0,35,17
1656961943464,MATH 20E,B02,083774,Ciotti; Benjamin,17,0,35,18
1656961949489,MATH 103A,A01,083777,Greenfeld; Be'Eri,2,0,36,34
1656961949489,MATH 103A,A02,083778,Greenfeld; Be'Eri,5,0,36,31
1656961949489,MATH 103A,A03,093561,Greenfeld; Be'Eri,4,0,36,32
1656961949489,MATH 103A,B01,083779,Greenfeld; Be'Eri,6,0,36,30
1656961949489,MATH 103A,B02,083780,Greenfeld; Be'Eri,2,0,36,34
1656961949489,MATH 103A,B03,093562,Greenfeld; Be'Eri,2,0,36,34
1656961955524,MATH 105,A01,085443,Carter; Anne Toulson,14,0,35,21
1656961955524,MATH 105,A02,093477,Carter; Anne Toulson,20,0,35,15
1656961961548,MATH 109,A01,083213,Ganzberger; Geoffrey Michael,2,0,34,32
1656961961548,MATH 109,A02,083214,Ganzberger; Geoffrey Michael,2,0,34,32
1656961961548,MATH 109,A03,093478,Ganzberger; Geoffrey Michael,1,0,34,33
1656961961548,MATH 109,B01,083215,Ganzberger; Geoffrey Michael,1,0,32,31
1656961961548,MATH 109,B02,083216,Ganzberger; Geoffrey Michael,1,0,32,31
1656961961548,MATH 109,B03,093479,Ganzberger; Geoffrey Michael,6,0,32,26
1656961967584,MATH 142A,A01,083219,Chow; Bennett,6,0,32,26
1656961967584,MATH 142A,A02,083220,Chow; Bennett,10,0,32,22
1656961967584,MATH 142A,A03,093480,Chow; Bennett,7,0,32,25
1656961967584,MATH 142A,B03,093481,Chow; Bennett,7,0,32,25
1656961967584,MATH 142A,B04,093558,Chow; Bennett,11,0,32,21
1656961967584,MATH 142A,B05,093559,Chow; Bennett,6,0,32,26
1656961973609,MATH 193A,A01,083224,Rotar; Vladimir,7,0,34,27
1656961973609,MATH 193A,A02,083225,Rotar; Vladimir,4,0,34,30
1656961973609,MATH 193A,A03,083781,Rotar; Vladimir,1,0,34,33
1656961973609,MATH 193A,A04,083782,Rotar; Vladimir,6,0,34,28
1656961973609,MATH 193A,A05,093482,Rotar; Vladimir,6,0,34,28
1656961979630,MATH 197,001,091859,McAuley; Julian John,9999,0,9999,0
1656961979630,MATH 197,002,095566,Kedlaya; Kiran S.,9997,0,9999,2
1656961979630,MATH 197,003,095567,Xiao; Ming,9999,0,9999,0
1656961979630,MATH 197,004,095571,Perols; Johan Lars,9998,0,9999,1
1656961986688,COGS 9,A01,083615,Shannon; Kyle Michael,7,0,75,68
1656961992727,COGS 11,A01,083617,Boyle; Mary E. T.,20,0,48,28
1656961998757,COGS 13,A01,083071,Bastos; Amalia Pinkusfeld,9,0,71,62
1656962004780,COGS 14A,A01,092681,Semenuks; Arturs,0,1,100,100
1656962010804,COGS 14B,A01,083073,Cheng; Tzu-Han,5,0,63,58
1656962016827,COGS 17,A01,092677,Semenuks; Arturs,4,0,81,77
1656962022855,COGS 100,A01,083619,Allen; Michael Gordon,15,0,70,55
1656962028879,COGS 101A,A01,083621,Davis; Joshua Daniel,9,0,68,59
1656962034902,COGS 101B,A01,091572,Allen; Michael Gordon,8,0,65,57
1656962040941,COGS 101C,A01,083625,Delgado; Tania,17,0,35,18
1656962046968,COGS 107A,A01,083627,Boyle; Mary E. T.,13,0,60,47
1656962052994,COGS 118A,A01,083075,Gupta; Anjum,15,0,76,61
1656962059017,CSE 3,A50,083646,Miranda; Gregory Joseph,22,0,50,28
1656962065040,CSE 8A,A50,083650,Miranda; Gregory Joseph,17,1,56,39
1656962071061,CSE 11,A01,083080,Cao; Yingjun,4,15,40,36
1656962077089,CSE 12,A01,083652,Krause-Levy; Sophia Louisa,20,1,120,100
1656962083116,CSE 15L,A01,083654,Morris; Justin Loren,8,0,50,42
1656962083116,CSE 15L,A02,083655,Morris; Justin Loren,8,0,50,42
1656962089142,CSE 20,A01,083657,Tran; Khoa Dang,37,0,80,43
1656962095170,CSE 21,A01,095574,Bach; Quang Tran,21,0,48,27
1656962101198,CSE 30,A01,083084,Eldon; John,4,0,80,76
1656962101198,CSE 30,B01,095061,Bhaskar; Nishant,6,0,50,44
1656962107224,CSE 100,A01,083659,Cao; Yingjun,3,4,70,67
1656962113245,CSE 134B,A01,083661,Powell; Thomas Allan,19,0,100,81
1656962119269,CSE 140,A01,083663,Gungor; Onat,14,0,85,71
1656962125292,CSE 140L,A01,083088,Eldon; John,16,0,100,84
1656962131314,CSE 175,A01,083665,Kumar; Rakesh,3,0,25,22
1656962137339,CSE 190,A00,092507,Dubnov; Shlomo,7,0,20,13
1656962143366,ECE 45,A01,083139,Congero; Spencer William,5,0,75,70
1656962149390,ECE 65,A50,083695,Saad; Andrew S,12,0,30,18
1656962149390,ECE 65,A51,095125,Saad; Andrew S,25,0,26,1
1656962155416,ECE 109,A01,091882,Touri; Behrouz,16,0,70,54
1656962161443,ECE 180,A00,083140,Abi Samra; Nicholas Camill,0,0,30,30
1656962161443,ECE 180,B00,083141,Abi Samra; Nicholas Camill,0,0,30,30
1656962167467,MATH 10A,A01,083735,Patchell; Gregory David,1,0,30,29
1656962167467,MATH 10A,A02,083736,Patchell; Gregory David,20,0,30,10
1656962167467,MATH 10A,A03,083737,Patchell; Gregory David,15,0,30,15
1656962173491,MATH 10B,A01,083207,Lim; Seonhee,7,0,34,27
1656962173491,MATH 10B,A02,083208,Lim; Seonhee,9,0,35,26
1656962173491,MATH 10B,A03,093472,Lim; Seonhee,4,0,34,30
1656962173491,MATH 10B,B01,083739,Sinha; Shubham,9,0,30,21
1656962179515,MATH 18,A01,083743,Cinel; Cameron Alexander,6,0,30,24
1656962179515,MATH 18,A02,083744,Cinel; Cameron Alexander,15,0,30,15
1656962179515,MATH 18,A03,083745,Cinel; Cameron Alexander,8,0,30,22
1656962179515,MATH 18,B01,083748,Rideout; David Porter,4,0,37,33
1656962179515,MATH 18,B02,083749,Rideout; David Porter,3,0,36,33
1656962179515,MATH 18,B03,083750,Rideout; David Porter,2,0,37,35
1656962179515,MATH 18,B04,083751,Rideout; David Porter,5,0,36,31
1656962179515,MATH 18,B05,093473,Rideout; David Porter,4,0,36,32
1656962179515,MATH 18,B06,093474,Rideout; David Porter,5,0,36,31
1656962185540,MATH 20A,A01,083754,Zheng; Zequn,12,0,40,28
1656962191567,MATH 20B,A01,083756,Briones; Jor-el Thomas Caparas,1,0,36,35
1656962191567,MATH 20B,A02,083757,Briones; Jor-el Thomas Caparas,1,0,36,35
1656962191567,MATH 20B,A03,093475,Briones; Jor-el Thomas Caparas,0,0,36,36
1656962197589,MATH 20C,A01,083760,Briones; Jor-el Thomas Caparas,1,0,35,34
1656962197589,MATH 20C,A02,083761,Briones; Jor-el Thomas Caparas,8,0,35,27
1656962197589,MATH 20C,A03,093476,Briones; Jor-el Thomas Caparas,0,1,36,36
1656962197589,MATH 20C,B01,083762,Bach; Quang Tran,0,0,30,30
1656962203619,MATH 20D,A01,083765,Tran; Brian Kha,4,0,30,26
1656962203619,MATH 20D,A02,083766,Tran; Brian Kha,4,0,30,26
1656962203619,MATH 20D,A03,083767,Tran; Brian Kha,3,0,30,27
1656962209647,MATH 20E,A01,083771,Ganguly; Soumya,5,0,32,27
1656962209647,MATH 20E,A02,083772,Ganguly; Soumya,6,0,32,26
1656962209647,MATH 20E,B01,083773,Ciotti; Benjamin,18,0,35,17
1656962209647,MATH 20E,B02,083774,Ciotti; Benjamin,17,0,35,18
1656962215678,MATH 103A,A01,083777,Greenfeld; Be'Eri,2,0,36,34
1656962215678,MATH 103A,A02,083778,Greenfeld; Be'Eri,5,0,36,31
1656962215678,MATH 103A,A03,093561,Greenfeld; Be'Eri,4,0,36,32
1656962215678,MATH 103A,B01,083779,Greenfeld; Be'Eri,6,0,36,30
1656962215678,MATH 103A,B02,083780,Greenfeld; Be'Eri,2,0,36,34
1656962215678,MATH 103A,B03,093562,Greenfeld; Be'Eri,2,0,36,34
1656962221705,MATH 105,A01,085443,Carter; Anne Toulson,14,0,35,21
1656962221705,MATH 105,A02,093477,Carter; Anne Toulson,20,0,35,15
1656962227727,MATH 109,A01,083213,Ganzberger; Geoffrey Michael,2,0,34,32
1656962227727,MATH 109,A02,083214,Ganzberger; Geoffrey Michael,2,0,34,32
1656962227727,MATH 109,A03,093478,Ganzberger; Geoffrey Michael,1,0,34,33
1656962227727,MATH 109,B01,083215,Ganzberger; Geoffrey Michael,1,0,32,31
1656962227727,MATH 109,B02,083216,Ganzberger; Geoffrey Michael,1,0,32,31
1656962227727,MATH 109,B03,093479,Ganzberger; Geoffrey Michael,6,0,32,26
1656962233758,MATH 142A,A01,083219,Chow; Bennett,6,0,32,26
1656962233758,MATH 142A,A02,083220,Chow; Bennett,10,0,32,22
1656962233758,MATH 142A,A03,093480,Chow; Bennett,7,0,32,25
1656962233758,MATH 142A,B03,093481,Chow; Bennett,7,0,32,25
1656962233758,MATH 142A,B04,093558,Chow; Bennett,11,0,32,21
1656962233758,MATH 142A,B05,093559,Chow; Bennett,6,0,32,26
1656962239783,MATH 193A,A01,083224,Rotar; Vladimir,7,0,34,27
1656962239783,MATH 193A,A02,083225,Rotar; Vladimir,4,0,34,30
1656962239783,MATH 193A,A03,083781,Rotar; Vladimir,1,0,34,33
1656962239783,MATH 193A,A04,083782,Rotar; Vladimir,6,0,34,28
1656962239783,MATH 193A,A05,093482,Rotar; Vladimir,6,0,34,28
1656962245806,MATH 197,001,091859,McAuley; Julian John,9999,0,9999,0
1656962245806,MATH 197,002,095566,Kedlaya; Kiran S.,9997,0,9999,2
1656962245806,MATH 197,003,095567,Xiao; Ming,9999,0,9999,0
1656962245806,MATH 197,004,095571,Perols; Johan Lars,9998,0,9999,1
1656962252859,COGS 9,A01,083615,Shannon; Kyle Michael,7,0,75,68
1656962258884,COGS 11,A01,083617,Boyle; Mary E. T.,20,0,48,28
1656962264912,COGS 13,A01,083071,Bastos; Amalia Pinkusfeld,9,0,71,62
1656962270935,COGS 14A,A01,092681,Semenuks; Arturs,0,1,100,100
1656962276958,COGS 14B,A01,083073,Cheng; Tzu-Han,5,0,63,58
1656962282982,COGS 17,A01,092677,Semenuks; Arturs,4,0,81,77
1656962289008,COGS 100,A01,083619,Allen; Michael Gordon,15,0,70,55
1656962295031,COGS 101A,A01,083621,Davis; Joshua Daniel,9,0,68,59
1656962301054,COGS 101B,A01,091572,Allen; Michael Gordon,8,0,65,57
1656962307084,COGS 101C,A01,083625,Delgado; Tania,17,0,35,18
1656962313107,COGS 107A,A01,083627,Boyle; Mary E. T.,13,0,60,47
1656962319131,COGS 118A,A01,083075,Gupta; Anjum,15,0,76,61
1656962325155,CSE 3,A50,083646,Miranda; Gregory Joseph,22,0,50,28
1656962331178,CSE 8A,A50,083650,Miranda; Gregory Joseph,17,1,56,39
1656962337202,CSE 11,A01,083080,Cao; Yingjun,4,15,40,36
1656962343230,CSE 12,A01,083652,Krause-Levy; Sophia Louisa,20,1,120,100
1656962349253,CSE 15L,A01,083654,Morris; Justin Loren,8,0,50,42
1656962349253,CSE 15L,A02,083655,Morris; Justin Loren,8,0,50,42
1656962355294,CSE 20,A01,083657,Tran; Khoa Dang,37,0,80,43
1656962361316,CSE 21,A01,095574,Bach; Quang Tran,21,0,48,27
1656962367340,CSE 30,A01,083084,Eldon; John,4,0,80,76
1656962367340,CSE 30,B01,095061,Bhaskar; Nishant,6,0,50,44
1656962373364,CSE 100,A01,083659,Cao; Yingjun,3,4,70,67
1656962379388,CSE 134B,A01,083661,Powell; Thomas Allan,19,0,100,81
1656962385411,CSE 140,A01,083663,Gungor; Onat,14,0,85,71
1656962391438,CSE 140L,A01,083088,Eldon; John,16,0,100,84
1656962397471,CSE 175,A01,083665,Kumar; Rakesh,3,0,25,22
1656962403495,CSE 190,A00,092507,Dubnov; Shlomo,7,0,20,13
1656962409519,ECE 45,A01,083139,Congero; Spencer William,5,0,75,70
1656962415542,ECE 65,A50,083695,Saad; Andrew S,12,0,30,18
1656962415542,ECE 65,A51,095125,Saad; Andrew S,25,0,26,1
1656962421566,ECE 109,A01,091882,Touri; Behrouz,16,0,70,54
1656962427676,ECE 180,A00,083140,Abi Samra; Nicholas Camill,0,0,30,30
1656962427676,ECE 180,B00,083141,Abi Samra; Nicholas Camill,0,0,30,30
1656962433701,MATH 10A,A01,083735,Patchell; Gregory David,1,0,30,29
1656962433701,MATH 10A,A02,083736,Patchell; Gregory David,20,0,30,10
1656962433701,MATH 10A,A03,083737,Patchell; Gregory David,15,0,30,15
1656962439731,MATH 10B,A01,083207,Lim; Seonhee,7,0,34,27
1656962439731,MATH 10B,A02,083208,Lim; Seonhee,9,0,35,26
1656962439731,MATH 10B,A03,093472,Lim; Seonhee,4,0,34,30
1656962439731,MATH 10B,B01,083739,Sinha; Shubham,9,0,30,21
1656962445756,MATH 18,A01,083743,Cinel; Cameron Alexander,6,0,30,24
1656962445756,MATH 18,A02,083744,Cinel; Cameron Alexander,15,0,30,15
1656962445756,MATH 18,A03,083745,Cinel; Cameron Alexander,8,0,30,22
1656962445756,MATH 18,B01,083748,Rideout; David Porter,4,0,37,33
1656962445756,MATH 18,B02,083749,Rideout; David Porter,3,0,36,33
1656962445756,MATH 18,B03,083750,Rideout; David Porter,2,0,37,35
1656962445756,MATH 18,B04,083751,Rideout; David Porter,5,0,36,31
1656962445756,MATH 18,B05,093473,Rideout; David Porter,4,0,36,32
1656962445756,MATH 18,B06,093474,Rideout; David Porter,5,0,36,31
1656962451778,MATH 20A,A01,083754,Zheng; Zequn,12,0,40,28
1656962457803,MATH 20B,A01,083756,Briones; Jor-el Thomas Caparas,1,0,36,35
1656962457803,MATH 20B,A02,083757,Briones; Jor-el Thomas Caparas,1,0,36,35
1656962457803,MATH 20B,A03,093475,Briones; Jor-el Thomas Caparas,0,0,36,36
1656962463826,MATH 20C,A01,083760,Briones; Jor-el Thomas Caparas,1,0,35,34
1656962463826,MATH 20C,A02,083761,Briones; Jor-el Thomas Caparas,8,0,35,27
1656962463826,MATH 20C,A03,093476,Briones; Jor-el Thomas Caparas,0,1,36,36
1656962463826,MATH 20C,B01,083762,Bach; Quang Tran,0,0,30,30
1656962469854,MATH 20D,A01,083765,Tran; Brian Kha,4,0,30,26
1656962469854,MATH 20D,A02,083766,Tran; Brian Kha,4,0,30,26
1656962469854,MATH 20D,A03,083767,Tran; Brian Kha,3,0,30,27
1656962475878,MATH 20E,A01,083771,Ganguly; Soumya,5,0,32,27
1656962475878,MATH 20E,A02,083772,Ganguly; Soumya,6,0,32,26
1656962475878,MATH 20E,B01,083773,Ciotti; Benjamin,18,0,35,17
1656962475878,MATH 20E,B02,083774,Ciotti; Benjamin,17,0,35,18
1656962481903,MATH 103A,A01,083777,Greenfeld; Be'Eri,2,0,36,34
1656962481903,MATH 103A,A02,083778,Greenfeld; Be'Eri,5,0,36,31
1656962481903,MATH 103A,A03,093561,Greenfeld; Be'Eri,4,0,36,32
1656962481903,MATH 103A,B01,083779,Greenfeld; Be'Eri,6,0,36,30
1656962481903,MATH 103A,B02,083780,Greenfeld; Be'Eri,2,0,36,34
1656962481903,MATH 103A,B03,093562,Greenfeld; Be'Eri,2,0,36,34
1656962487931,MATH 105,A01,085443,Carter; Anne Toulson,14,0,35,21
1656962487931,MATH 105,A02,093477,Carter; Anne Toulson,20,0,35,15
1656962493962,MATH 109,A01,083213,Ganzberger; Geoffrey Michael,2,0,34,32
1656962493962,MATH 109,A02,083214,Ganzberger; Geoffrey Michael,2,0,34,32
1656962493962,MATH 109,A03,093478,Ganzberger; Geoffrey Michael,1,0,34,33
1656962493962,MATH 109,B01,083215,Ganzberger; Geoffrey Michael,1,0,32,31
1656962493962,MATH 109,B02,083216,Ganzberger; Geoffrey Michael,1,0,32,31
1656962493962,MATH 109,B03,093479,Ganzberger; Geoffrey Michael,6,0,32,26
1656962499990,MATH 142A,A01,083219,Chow; Bennett,6,0,32,26
1656962499990,MATH 142A,A02,083220,Chow; Bennett,10,0,32,22
1656962499990,MATH 142A,A03,093480,Chow; Bennett,7,0,32,25
1656962499990,MATH 142A,B03,093481,Chow; Bennett,7,0,32,25
1656962499990,MATH 142A,B04,093558,Chow; Bennett,11,0,32,21
1656962499990,MATH 142A,B05,093559,Chow; Bennett,6,0,32,26
1656962506019,MATH 193A,A01,083224,Rotar; Vladimir,7,0,34,27
1656962506019,MATH 193A,A02,083225,Rotar; Vladimir,4,0,34,30
1656962506019,MATH 193A,A03,083781,Rotar; Vladimir,1,0,34,33
1656962506019,MATH 193A,A04,083782,Rotar; Vladimir,6,0,34,28
1656962506019,MATH 193A,A05,093482,Rotar; Vladimir,6,0,34,28
1656962512042,MATH 197,001,091859,McAuley; Julian John,9999,0,9999,0
1656962512042,MATH 197,002,095566,Kedlaya; Kiran S.,9997,0,9999,2
1656962512042,MATH 197,003,095567,Xiao; Ming,9999,0,9999,0
1656962512042,MATH 197,004,095571,Perols; Johan Lars,9998,0,9999,1
1656962519102,COGS 9,A01,083615,Shannon; Kyle Michael,7,0,75,68
1656962525130,COGS 11,A01,083617,Boyle; Mary E. T.,20,0,48,28
1656962531157,COGS 13,A01,083071,Bastos; Amalia Pinkusfeld,9,0,71,62
1656962537182,COGS 14A,A01,092681,Semenuks; Arturs,0,1,100,100
1656962543207,COGS 14B,A01,083073,Cheng; Tzu-Han,5,0,63,58
1656962549234,COGS 17,A01,092677,Semenuks; Arturs,4,0,81,77
1656962555261,COGS 100,A01,083619,Allen; Michael Gordon,15,0,70,55
1656962561285,COGS 101A,A01,083621,Davis; Joshua Daniel,9,0,68,59
1656962567312,COGS 101B,A01,091572,Allen; Michael Gordon,8,0,65,57
1656962573336,COGS 101C,A01,083625,Delgado; Tania,17,0,35,18
1656962579361,COGS 107A,A01,083627,Boyle; Mary E. T.,13,0,60,47
1656962585385,COGS 118A,A01,083075,Gupta; Anjum,15,0,76,61
1656962591414,CSE 3,A50,083646,Miranda; Gregory Joseph,22,0,50,28
1656962597442,CSE 8A,A50,083650,Miranda; Gregory Joseph,17,1,56,39
1656962603463,CSE 11,A01,083080,Cao; Yingjun,4,15,40,36
1656962609489,CSE 12,A01,083652,Krause-Levy; Sophia Louisa,20,1,120,100
1656962615517,CSE 15L,A01,083654,Morris; Justin Loren,8,0,50,42
1656962615517,CSE 15L,A02,083655,Morris; Justin Loren,8,0,50,42
1656962621541,CSE 20,A01,083657,Tran; Khoa Dang,37,0,80,43
1656962627565,CSE 21,A01,095574,Bach; Quang Tran,21,0,48,27
1656962633591,CSE 30,A01,083084,Eldon; John,4,0,80,76
1656962633591,CSE 30,B01,095061,Bhaskar; Nishant,6,0,50,44
1656962639614,CSE 100,A01,083659,Cao; Yingjun,3,4,70,67
1656962645642,CSE 134B,A01,083661,Powell; Thomas Allan,19,0,100,81
1656962651666,CSE 140,A01,083663,Gungor; Onat,14,0,85,71
1656962657695,CSE 140L,A01,083088,Eldon; John,16,0,100,84
1656962663721,CSE 175,A01,083665,Kumar; Rakesh,3,0,25,22
1656962669745,CSE 190,A00,092507,Dubnov; Shlomo,7,0,20,13
1656962675769,ECE 45,A01,083139,Congero; Spencer William,5,0,75,70
1656962681793,ECE 65,A50,083695,Saad; Andrew S,12,0,30,18
1656962681793,ECE 65,A51,095125,Saad; Andrew S,25,0,26,1
1656962687817,ECE 109,A01,091882,Touri; Behrouz,16,0,70,54
1656962693841,ECE 180,A00,083140,Abi Samra; Nicholas Camill,0,0,30,30
1656962693841,ECE 180,B00,083141,Abi Samra; Nicholas Camill,0,0,30,30
1656962699864,MATH 10A,A01,083735,Patchell; Gregory David,1,0,30,29
1656962699864,MATH 10A,A02,083736,Patchell; Gregory David,20,0,30,10
1656962699864,MATH 10A,A03,083737,Patchell; Gregory David,15,0,30,15
1656962705901,MATH 10B,A01,083207,Lim; Seonhee,7,0,34,27
1656962705901,MATH 10B,A02,083208,Lim; Seonhee,9,0,35,26
1656962705901,MATH 10B,A03,093472,Lim; Seonhee,4,0,34,30
1656962705901,MATH 10B,B01,083739,Sinha; Shubham,9,0,30,21
1656962711931,MATH 18,A01,083743,Cinel; Cameron Alexander,6,0,30,24
1656962711931,MATH 18,A02,083744,Cinel; Cameron Alexander,15,0,30,15
1656962711931,MATH 18,A03,083745,Cinel; Cameron Alexander,8,0,30,22
1656962711931,MATH 18,B01,083748,Rideout; David Porter,4,0,37,33
1656962711931,MATH 18,B02,083749,Rideout; David Porter,3,0,36,33
1656962711931,MATH 18,B03,083750,Rideout; David Porter,2,0,37,35
1656962711931,MATH 18,B04,083751,Rideout; David Porter,5,0,36,31
1656962711931,MATH 18,B05,093473,Rideout; David Porter,4,0,36,32
1656962711931,MATH 18,B06,093474,Rideout; David Porter,5,0,36,31
1656962717956,MATH 20A,A01,083754,Zheng; Zequn,12,0,40,28
1656962723978,MATH 20B,A01,083756,Briones; Jor-el Thomas Caparas,1,0,36,35
1656962723978,MATH 20B,A02,083757,Briones; Jor-el Thomas Caparas,1,0,36,35
1656962723978,MATH 20B,A03,093475,Briones; Jor-el Thomas Caparas,0,0,36,36
1656962730006,MATH 20C,A01,083760,Briones; Jor-el Thomas Caparas,1,0,35,34
1656962730006,MATH 20C,A02,083761,Briones; Jor-el Thomas Caparas,8,0,35,27
1656962730006,MATH 20C,A03,093476,Briones; Jor-el Thomas Caparas,0,1,36,36
1656962730006,MATH 20C,B01,083762,Bach; Quang Tran,0,0,30,30
1656962736040,MATH 20D,A01,083765,Tran; Brian Kha,4,0,30,26
1656962736040,MATH 20D,A02,083766,Tran; Brian Kha,4,0,30,26
1656962736040,MATH 20D,A03,083767,Tran; Brian Kha,3,0,30,27
1656962742063,MATH 20E,A01,083771,Ganguly; Soumya,5,0,32,27
1656962742063,MATH 20E,A02,083772,Ganguly; Soumya,6,0,32,26
1656962742063,MATH 20E,B01,083773,Ciotti; Benjamin,18,0,35,17
1656962742063,MATH 20E,B02,083774,Ciotti; Benjamin,17,0,35,18
1656962748088,MATH 103A,A01,083777,Greenfeld; Be'Eri,2,0,36,34
1656962748088,MATH 103A,A02,083778,Greenfeld; Be'Eri,5,0,36,31
1656962748088,MATH 103A,A03,093561,Greenfeld; Be'Eri,4,0,36,32
1656962748088,MATH 103A,B01,083779,Greenfeld; Be'Eri,6,0,36,30
1656962748088,MATH 103A,B02,083780,Greenfeld; Be'Eri,2,0,36,34
1656962748088,MATH 103A,B03,093562,Greenfeld; Be'Eri,2,0,36,34
1656962754116,MATH 105,A01,085443,Carter; Anne Toulson,14,0,35,21
1656962754116,MATH 105,A02,093477,Carter; Anne Toulson,20,0,35,15
1656962760146,MATH 109,A01,083213,Ganzberger; Geoffrey Michael,2,0,34,32
1656962760146,MATH 109,A02,083214,Ganzberger; Geoffrey Michael,2,0,34,32
1656962760146,MATH 109,A03,093478,Ganzberger; Geoffrey Michael,1,0,34,33
1656962760146,MATH 109,B01,083215,Ganzberger; Geoffrey Michael,1,0,32,31
1656962760146,MATH 109,B02,083216,Ganzberger; Geoffrey Michael,1,0,32,31
1656962760146,MATH 109,B03,093479,Ganzberger; Geoffrey Michael,6,0,32,26
1656962766177,MATH 142A,A01,083219,Chow; Bennett,6,0,32,26
1656962766177,MATH 142A,A02,083220,Chow; Bennett,10,0,32,22
1656962766177,MATH 142A,A03,093480,Chow; Bennett,7,0,32,25
1656962766177,MATH 142A,B03,093481,Chow; Bennett,7,0,32,25
1656962766177,MATH 142A,B04,093558,Chow; Bennett,11,0,32,21
1656962766177,MATH 142A,B05,093559,Chow; Bennett,6,0,32,26
1656962772199,MATH 193A,A01,083224,Rotar; Vladimir,7,0,34,27
1656962772199,MATH 193A,A02,083225,Rotar; Vladimir,4,0,34,30
1656962772199,MATH 193A,A03,083781,Rotar; Vladimir,1,0,34,33
1656962772199,MATH 193A,A04,083782,Rotar; Vladimir,6,0,34,28
1656962772199,MATH 193A,A05,093482,Rotar; Vladimir,6,0,34,28
1656962778223,MATH 197,001,091859,McAuley; Julian John,9999,0,9999,0
1656962778223,MATH 197,002,095566,Kedlaya; Kiran S.,9997,0,9999,2
1656962778223,MATH 197,003,095567,Xiao; Ming,9999,0,9999,0
1656962778223,MATH 197,004,095571,Perols; Johan Lars,9998,0,9999,1
1656962785281,COGS 9,A01,083615,Shannon; Kyle Michael,7,0,75,68
1656962791304,COGS 11,A01,083617,Boyle; Mary E. T.,20,0,48,28
1656962797332,COGS 13,A01,083071,Bastos; Amalia Pinkusfeld,9,0,71,62
1656962803360,COGS 14A,A01,092681,Semenuks; Arturs,0,1,100,100
1656962809386,COGS 14B,A01,083073,Cheng; Tzu-Han,5,0,63,58
1656962815414,COGS 17,A01,092677,Semenuks; Arturs,4,0,81,77
1656962821437,COGS 100,A01,083619,Allen; Michael Gordon,15,0,70,55
1656962827462,COGS 101A,A01,083621,Davis; Joshua Daniel,9,0,68,59
1656962833486,COGS 101B,A01,091572,Allen; Michael Gordon,8,0,65,57
1656962839509,COGS 101C,A01,083625,Delgado; Tania,17,0,35,18
1656962845533,COGS 107A,A01,083627,Boyle; Mary E. T.,13,0,60,47
1656962851562,COGS 118A,A01,083075,Gupta; Anjum,15,0,76,61
1656962857593,CSE 3,A50,083646,Miranda; Gregory Joseph,22,0,50,28
1656962863623,CSE 8A,A50,083650,Miranda; Gregory Joseph,17,1,56,39
1656962869646,CSE 11,A01,083080,Cao; Yingjun,4,15,40,36
1656962875671,CSE 12,A01,083652,Krause-Levy; Sophia Louisa,20,1,120,100
1656962881697,CSE 15L,A01,083654,Morris; Justin Loren,8,0,50,42
1656962881697,CSE 15L,A02,083655,Morris; Justin Loren,8,0,50,42
1656962887723,CSE 20,A01,083657,Tran; Khoa Dang,37,0,80,43
1656962893748,CSE 21,A01,095574,Bach; Quang Tran,21,0,48,27
1656962899770,CSE 30,A01,083084,Eldon; John,4,0,80,76
1656962899770,CSE 30,B01,095061,Bhaskar; Nishant,6,0,50,44
1656962905795,CSE 100,A01,083659,Cao; Yingjun,3,4,70,67
1656962911824,CSE 134B,A01,083661,Powell; Thomas Allan,19,0,100,81
1656962917846,CSE 140,A01,083663,Gungor; Onat,14,0,85,71
1656962923868,CSE 140L,A01,083088,Eldon; John,16,0,100,84
1656962929893,CSE 175,A01,083665,Kumar; Rakesh,3,0,25,22
1656962935920,CSE 190,A00,092507,Dubnov; Shlomo,7,0,20,13
1656962941943,ECE 45,A01,083139,Congero; Spencer William,5,0,75,70
1656962947965,ECE 65,A50,083695,Saad; Andrew S,12,0,30,18
1656962947965,ECE 65,A51,095125,Saad; Andrew S,25,0,26,1
1656962953995,ECE 109,A01,091882,Touri; Behrouz,16,0,70,54
1656962960021,ECE 180,A00,083140,Abi Samra; Nicholas Camill,0,0,30,30
1656962960021,ECE 180,B00,083141,Abi Samra; Nicholas Camill,0,0,30,30
1656962966049,MATH 10A,A01,083735,Patchell; Gregory David,1,0,30,29
1656962966049,MATH 10A,A02,083736,Patchell; Gregory David,20,0,30,10
1656962966049,MATH 10A,A03,083737,Patchell; Gregory David,15,0,30,15
1656962972084,MATH 10B,A01,083207,Lim; Seonhee,7,0,34,27
1656962972084,MATH 10B,A02,083208,Lim; Seonhee,9,0,35,26
1656962972084,MATH 10B,A03,093472,Lim; Seonhee,4,0,34,30
1656962972084,MATH 10B,B01,083739,Sinha; Shubham,9,0,30,21
1656962978118,MATH 18,A01,083743,Cinel; Cameron Alexander,6,0,30,24
1656962978118,MATH 18,A02,083744,Cinel; Cameron Alexander,15,0,30,15
1656962978118,MATH 18,A03,083745,Cinel; Cameron Alexander,8,0,30,22
1656962978118,MATH 18,B01,083748,Rideout; David Porter,4,0,37,33
1656962978118,MATH 18,B02,083749,Rideout; David Porter,3,0,36,33
1656962978118,MATH 18,B03,083750,Rideout; David Porter,2,0,37,35
1656962978118,MATH 18,B04,083751,Rideout; David Porter,5,0,36,31
1656962978118,MATH 18,B05,093473,Rideout; David Porter,4,0,36,32
1656962978118,MATH 18,B06,093474,Rideout; David Porter,5,0,36,31
1656962984139,MATH 20A,A01,083754,Zheng; Zequn,12,0,40,28
1656962990170,MATH 20B,A01,083756,Briones; Jor-el Thomas Caparas,1,0,36,35
1656962990170,MATH 20B,A02,083757,Briones; Jor-el Thomas Caparas,1,0,36,35
1656962990170,MATH 20B,A03,093475,Briones; Jor-el Thomas Caparas,0,0,36,36
1656962996198,MATH 20C,A01,083760,Briones; Jor-el Thomas Caparas,1,0,35,34
1656962996198,MATH 20C,A02,083761,Briones; Jor-el Thomas Caparas,8,0,35,27
1656962996198,MATH 20C,A03,093476,Briones; Jor-el Thomas Caparas,0,1,36,36
1656962996198,MATH 20C,B01,083762,Bach; Quang Tran,0,0,30,30
1656963002226,MATH 20D,A01,083765,Tran; Brian Kha,4,0,30,26
1656963002226,MATH 20D,A02,083766,Tran; Brian Kha,4,0,30,26
1656963002226,MATH 20D,A03,083767,Tran; Brian Kha,3,0,30,27
1656963008255,MATH 20E,A01,083771,Ganguly; Soumya,5,0,32,27
1656963008255,MATH 20E,A02,083772,Ganguly; Soumya,6,0,32,26
1656963008255,MATH 20E,B01,083773,Ciotti; Benjamin,18,0,35,17
1656963008255,MATH 20E,B02,083774,Ciotti; Benjamin,17,0,35,18
1656963014283,MATH 103A,A01,083777,Greenfeld; Be'Eri,2,0,36,34
1656963014283,MATH 103A,A02,083778,Greenfeld; Be'Eri,5,0,36,31
1656963014283,MATH 103A,A03,093561,Greenfeld; Be'Eri,4,0,36,32
1656963014283,MATH 103A,B01,083779,Greenfeld; Be'Eri,6,0,36,30
1656963014283,MATH 103A,B02,083780,Greenfeld; Be'Eri,2,0,36,34
1656963014283,MATH 103A,B03,093562,Greenfeld; Be'Eri,2,0,36,34
1656963020311,MATH 105,A01,085443,Carter; Anne Toulson,14,0,35,21
1656963020311,MATH 105,A02,093477,Carter; Anne Toulson,20,0,35,15
1656963026407,MATH 109,A01,083213,Ganzberger; Geoffrey Michael,2,0,34,32
1656963026407,MATH 109,A02,083214,Ganzberger; Geoffrey Michael,2,0,34,32
1656963026407,MATH 109,A03,093478,Ganzberger; Geoffrey Michael,1,0,34,33
1656963026407,MATH 109,B01,083215,Ganzberger; Geoffrey Michael,1,0,32,31
1656963026407,MATH 109,B02,083216,Ganzberger; Geoffrey Michael,1,0,32,31
1656963026407,MATH 109,B03,093479,Ganzberger; Geoffrey Michael,6,0,32,26
1656963032437,MATH 142A,A01,083219,Chow; Bennett,6,0,32,26
1656963032437,MATH 142A,A02,083220,Chow; Bennett,10,0,32,22
1656963032437,MATH 142A,A03,093480,Chow; Bennett,7,0,32,25
1656963032437,MATH 142A,B03,093481,Chow; Bennett,7,0,32,25
1656963032437,MATH 142A,B04,093558,Chow; Bennett,11,0,32,21
1656963032437,MATH 142A,B05,093559,Chow; Bennett,6,0,32,26
1656963038461,MATH 193A,A01,083224,Rotar; Vladimir,7,0,34,27
1656963038461,MATH 193A,A02,083225,Rotar; Vladimir,4,0,34,30
1656963038461,MATH 193A,A03,083781,Rotar; Vladimir,1,0,34,33
1656963038461,MATH 193A,A04,083782,Rotar; Vladimir,6,0,34,28
1656963038461,MATH 193A,A05,093482,Rotar; Vladimir,6,0,34,28
1656963044484,MATH 197,001,091859,McAuley; Julian John,9999,0,9999,0
1656963044484,MATH 197,002,095566,Kedlaya; Kiran S.,9997,0,9999,2
1656963044484,MATH 197,003,095567,Xiao; Ming,9999,0,9999,0
1656963044484,MATH 197,004,095571,Perols; Johan Lars,9998,0,9999,1
1656963051539,COGS 9,A01,083615,Shannon; Kyle Michael,7,0,75,68
1656963057563,COGS 11,A01,083617,Boyle; Mary E. T.,20,0,48,28
1656963063589,COGS 13,A01,083071,Bastos; Amalia Pinkusfeld,9,0,71,62
1656963069615,COGS 14A,A01,092681,Semenuks; Arturs,0,1,100,100
1656963075641,COGS 14B,A01,083073,Cheng; Tzu-Han,5,0,63,58
1656963081665,COGS 17,A01,092677,Semenuks; Arturs,4,0,81,77
1656963087692,COGS 100,A01,083619,Allen; Michael Gordon,15,0,70,55
1656963093724,COGS 101A,A01,083621,Davis; Joshua Daniel,9,0,68,59
1656963099751,COGS 101B,A01,091572,Allen; Michael Gordon,8,0,65,57
1656963105777,COGS 101C,A01,083625,Delgado; Tania,17,0,35,18
1656963111805,COGS 107A,A01,083627,Boyle; Mary E. T.,13,0,60,47
1656963117831,COGS 118A,A01,083075,Gupta; Anjum,15,0,76,61
1656963123854,CSE 3,A50,083646,Miranda; Gregory Joseph,22,0,50,28
1656963129882,CSE 8A,A50,083650,Miranda; Gregory Joseph,17,1,56,39
1656963135903,CSE 11,A01,083080,Cao; Yingjun,4,15,40,36
1656963141948,CSE 12,A01,083652,Krause-Levy; Sophia Louisa,20,1,120,100
1656963147970,CSE 15L,A01,083654,Morris; Justin Loren,8,0,50,42
1656963147970,CSE 15L,A02,083655,Morris; Justin Loren,8,0,50,42
1656963153997,CSE 20,A01,083657,Tran; Khoa Dang,37,0,80,43
1656963160019,CSE 21,A01,095574,Bach; Quang Tran,21,0,48,27
1656963166043,CSE 30,A01,083084,Eldon; John,4,0,80,76
1656963166043,CSE 30,B01,095061,Bhaskar; Nishant,6,0,50,44
1656963172066,CSE 100,A01,083659,Cao; Yingjun,3,4,70,67
1656963178091,CSE 134B,A01,083661,Powell; Thomas Allan,19,0,100,81
1656963184118,CSE 140,A01,083663,Gungor; Onat,14,0,85,71
1656963190142,CSE 140L,A01,083088,Eldon; John,16,0,100,84
1656963196164,CSE 175,A01,083665,Kumar; Rakesh,3,0,25,22
1656963202187,CSE 190,A00,092507,Dubnov; Shlomo,7,0,20,13
1656963208215,ECE 45,A01,083139,Congero; Spencer William,5,0,75,70
1656963214240,ECE 65,A50,083695,Saad; Andrew S,12,0,30,18
1656963214240,ECE 65,A51,095125,Saad; Andrew S,25,0,26,1
1656963220264,ECE 109,A01,091882,Touri; Behrouz,16,0,70,54
1656963226288,ECE 180,A00,083140,Abi Samra; Nicholas Camill,0,0,30,30
1656963226288,ECE 180,B00,083141,Abi Samra; Nicholas Camill,0,0,30,30
1656963232311,MATH 10A,A01,083735,Patchell; Gregory David,1,0,30,29
1656963232311,MATH 10A,A02,083736,Patchell; Gregory David,20,0,30,10
1656963232311,MATH 10A,A03,083737,Patchell; Gregory David,15,0,30,15
1656963238333,MATH 10B,A01,083207,Lim; Seonhee,7,0,34,27
1656963238333,MATH 10B,A02,083208,Lim; Seonhee,9,0,35,26
1656963238333,MATH 10B,A03,093472,Lim; Seonhee,4,0,34,30
1656963238333,MATH 10B,B01,083739,Sinha; Shubham,9,0,30,21
1656963244363,MATH 18,A01,083743,Cinel; Cameron Alexander,6,0,30,24
1656963244363,MATH 18,A02,083744,Cinel; Cameron Alexander,15,0,30,15
1656963244363,MATH 18,A03,083745,Cinel; Cameron Alexander,8,0,30,22
1656963244363,MATH 18,B01,083748,Rideout; David Porter,4,0,37,33
1656963244363,MATH 18,B02,083749,Rideout; David Porter,3,0,36,33
1656963244363,MATH 18,B03,083750,Rideout; David Porter,2,0,37,35
1656963244363,MATH 18,B04,083751,Rideout; David Porter,5,0,36,31
1656963244363,MATH 18,B05,093473,Rideout; David Porter,4,0,36,32
1656963244363,MATH 18,B06,093474,Rideout; David Porter,5,0,36,31
1656963250390,MATH 20A,A01,083754,Zheng; Zequn,12,0,40,28
1656963256413,MATH 20B,A01,083756,Briones; Jor-el Thomas Caparas,1,0,36,35
1656963256413,MATH 20B,A02,083757,Briones; Jor-el Thomas Caparas,1,0,36,35
1656963256413,MATH 20B,A03,093475,Briones; Jor-el Thomas Caparas,0,0,36,36
1656963262435,MATH 20C,A01,083760,Briones; Jor-el Thomas Caparas,1,0,35,34
1656963262435,MATH 20C,A02,083761,Briones; Jor-el Thomas Caparas,8,0,35,27
1656963262435,MATH 20C,A03,093476,Briones; Jor-el Thomas Caparas,0,1,36,36
1656963262435,MATH 20C,B01,083762,Bach; Quang Tran,0,0,30,30
1656963268458,MATH 20D,A01,083765,Tran; Brian Kha,4,0,30,26
1656963268458,MATH 20D,A02,083766,Tran; Brian Kha,4,0,30,26
1656963268458,MATH 20D,A03,083767,Tran; Brian Kha,3,0,30,27
1656963274486,MATH 20E,A01,083771,Ganguly; Soumya,5,0,32,27
1656963274486,MATH 20E,A02,083772,Ganguly; Soumya,6,0,32,26
1656963274486,MATH 20E,B01,083773,Ciotti; Benjamin,18,0,35,17
1656963274486,MATH 20E,B02,083774,Ciotti; Benjamin,17,0,35,18
1656963280520,MATH 103A,A01,083777,Greenfeld; Be'Eri,2,0,36,34
1656963280520,MATH 103A,A02,083778,Greenfeld; Be'Eri,5,0,36,31
1656963280520,MATH 103A,A03,093561,Greenfeld; Be'Eri,4,0,36,32
1656963280520,MATH 103A,B01,083779,Greenfeld; Be'Eri,6,0,36,30
1656963280520,MATH 103A,B02,083780,Greenfeld; Be'Eri,2,0,36,34
1656963280520,MATH 103A,B03,093562,Greenfeld; Be'Eri,2,0,36,34
1656963286544,MATH 105,A01,085443,Carter; Anne Toulson,14,0,35,21
1656963286544,MATH 105,A02,093477,Carter; Anne Toulson,20,0,35,15
1656963292572,MATH 109,A01,083213,Ganzberger; Geoffrey Michael,2,0,34,32
1656963292572,MATH 109,A02,083214,Ganzberger; Geoffrey Michael,2,0,34,32
1656963292572,MATH 109,A03,093478,Ganzberger; Geoffrey Michael,1,0,34,33
1656963292572,MATH 109,B01,083215,Ganzberger; Geoffrey Michael,1,0,32,31
1656963292572,MATH 109,B02,083216,Ganzberger; Geoffrey Michael,1,0,32,31
1656963292572,MATH 109,B03,093479,Ganzberger; Geoffrey Michael,6,0,32,26
1656963298600,MATH 142A,A01,083219,Chow; Bennett,6,0,32,26
1656963298600,MATH 142A,A02,083220,Chow; Bennett,10,0,32,22
1656963298600,MATH 142A,A03,093480,Chow; Bennett,7,0,32,25
1656963298600,MATH 142A,B03,093481,Chow; Bennett,7,0,32,25
1656963298600,MATH 142A,B04,093558,Chow; Bennett,11,0,32,21
1656963298600,MATH 142A,B05,093559,Chow; Bennett,6,0,32,26
1656963304626,MATH 193A,A01,083224,Rotar; Vladimir,7,0,34,27
1656963304626,MATH 193A,A02,083225,Rotar; Vladimir,4,0,34,30
1656963304626,MATH 193A,A03,083781,Rotar; Vladimir,1,0,34,33
1656963304626,MATH 193A,A04,083782,Rotar; Vladimir,6,0,34,28
1656963304626,MATH 193A,A05,093482,Rotar; Vladimir,6,0,34,28
1656963310657,MATH 197,001,091859,McAuley; Julian John,9999,0,9999,0
1656963310657,MATH 197,002,095566,Kedlaya; Kiran S.,9997,0,9999,2
1656963310657,MATH 197,003,095567,Xiao; Ming,9999,0,9999,0
1656963310657,MATH 197,004,095571,Perols; Johan Lars,9998,0,9999,1
1656963317715,COGS 9,A01,083615,Shannon; Kyle Michael,7,0,75,68
1656963323742,COGS 11,A01,083617,Boyle; Mary E. T.,20,0,48,28
1656963329765,COGS 13,A01,083071,Bastos; Amalia Pinkusfeld,9,0,71,62
1656963335789,COGS 14A,A01,092681,Semenuks; Arturs,0,1,100,100
1656963341811,COGS 14B,A01,083073,Cheng; Tzu-Han,5,0,63,58
1656963347839,COGS 17,A01,092677,Semenuks; Arturs,4,0,81,77
1656963353866,COGS 100,A01,083619,Allen; Michael Gordon,15,0,70,55
1656963359892,COGS 101A,A01,083621,Davis; Joshua Daniel,9,0,68,59
1656963365917,COGS 101B,A01,091572,Allen; Michael Gordon,8,0,65,57
1656963371940,COGS 101C,A01,083625,Delgado; Tania,17,0,35,18
1656963377964,COGS 107A,A01,083627,Boyle; Mary E. T.,13,0,60,47
1656963383985,COGS 118A,A01,083075,Gupta; Anjum,15,0,76,61
1656963390009,CSE 3,A50,083646,Miranda; Gregory Joseph,22,0,50,28
1656963396032,CSE 8A,A50,083650,Miranda; Gregory Joseph,17,1,56,39
1656963402058,CSE 11,A01,083080,Cao; Yingjun,4,15,40,36
1656963408087,CSE 12,A01,083652,Krause-Levy; Sophia Louisa,20,1,120,100
1656963414113,CSE 15L,A01,083654,Morris; Justin Loren,8,0,50,42
1656963414113,CSE 15L,A02,083655,Morris; Justin Loren,8,0,50,42
1656963420139,CSE 20,A01,083657,Tran; Khoa Dang,37,0,80,43
1656963426166,CSE 21,A01,095574,Bach; Quang Tran,21,0,48,27
1656963432199,CSE 30,A01,083084,Eldon; John,4,0,80,76
1656963432199,CSE 30,B01,095061,Bhaskar; Nishant,6,0,50,44
1656963438233,CSE 100,A01,083659,Cao; Yingjun,3,4,70,67
1656963444260,CSE 134B,A01,083661,Powell; Thomas Allan,19,0,100,81
1656963450283,CSE 140,A01,083663,Gungor; Onat,14,0,85,71
1656963456308,CSE 140L,A01,083088,Eldon; John,16,0,100,84
1656963462332,CSE 175,A01,083665,Kumar; Rakesh,3,0,25,22
1656963468355,CSE 190,A00,092507,Dubnov; Shlomo,7,0,20,13
1656963474380,ECE 45,A01,083139,Congero; Spencer William,5,0,75,70
1656963480402,ECE 65,A50,083695,Saad; Andrew S,12,0,30,18
1656963480402,ECE 65,A51,095125,Saad; Andrew S,25,0,26,1
1656963486428,ECE 109,A01,091882,Touri; Behrouz,16,0,70,54
1656963492450,ECE 180,A00,083140,Abi Samra; Nicholas Camill,0,0,30,30
1656963492450,ECE 180,B00,083141,Abi Samra; Nicholas Camill,0,0,30,30
1656963498473,MATH 10A,A01,083735,Patchell; Gregory David,1,0,30,29
1656963498473,MATH 10A,A02,083736,Patchell; Gregory David,20,0,30,10
1656963498473,MATH 10A,A03,083737,Patchell; Gregory David,15,0,30,15
1656963504497,MATH 10B,A01,083207,Lim; Seonhee,7,0,34,27
1656963504497,MATH 10B,A02,083208,Lim; Seonhee,9,0,35,26
1656963504497,MATH 10B,A03,093472,Lim; Seonhee,4,0,34,30
1656963504497,MATH 10B,B01,083739,Sinha; Shubham,9,0,30,21
1656963510520,MATH 18,A01,083743,Cinel; Cameron Alexander,6,0,30,24
1656963510520,MATH 18,A02,083744,Cinel; Cameron Alexander,15,0,30,15
1656963510520,MATH 18,A03,083745,Cinel; Cameron Alexander,8,0,30,22
1656963510520,MATH 18,B01,083748,Rideout; David Porter,4,0,37,33
1656963510520,MATH 18,B02,083749,Rideout; David Porter,3,0,36,33
1656963510520,MATH 18,B03,083750,Rideout; David Porter,2,0,37,35
1656963510520,MATH 18,B04,083751,Rideout; David Porter,5,0,36,31
1656963510520,MATH 18,B05,093473,Rideout; David Porter,4,0,36,32
1656963510520,MATH 18,B06,093474,Rideout; David Porter,5,0,36,31
1656963516543,MATH 20A,A01,083754,Zheng; Zequn,12,0,40,28
1656963522571,MATH 20B,A01,083756,Briones; Jor-el Thomas Caparas,1,0,36,35
1656963522571,MATH 20B,A02,083757,Briones; Jor-el Thomas Caparas,1,0,36,35
1656963522571,MATH 20B,A03,093475,Briones; Jor-el Thomas Caparas,0,0,36,36
1656963528595,MATH 20C,A01,083760,Briones; Jor-el Thomas Caparas,1,0,35,34
1656963528595,MATH 20C,A02,083761,Briones; Jor-el Thomas Caparas,8,0,35,27
1656963528595,MATH 20C,A03,093476,Briones; Jor-el Thomas Caparas,0,1,36,36
1656963528595,MATH 20C,B01,083762,Bach; Quang Tran,0,0,30,30
1656963534619,MATH 20D,A01,083765,Tran; Brian Kha,4,0,30,26
1656963534619,MATH 20D,A02,083766,Tran; Brian Kha,4,0,30,26
1656963534619,MATH 20D,A03,083767,Tran; Brian Kha,3,0,30,27
1656963540643,MATH 20E,A01,083771,Ganguly; Soumya,5,0,32,27
1656963540643,MATH 20E,A02,083772,Ganguly; Soumya,6,0,32,26
1656963540643,MATH 20E,B01,083773,Ciotti; Benjamin,18,0,35,17
1656963540643,MATH 20E,B02,083774,Ciotti; Benjamin,17,0,35,18
1656963546672,MATH 103A,A01,083777,Greenfeld; Be'Eri,2,0,36,34
1656963546672,MATH 103A,A02,083778,Greenfeld; Be'Eri,5,0,36,31
1656963546672,MATH 103A,A03,093561,Greenfeld; Be'Eri,4,0,36,32
1656963546672,MATH 103A,B01,083779,Greenfeld; Be'Eri,6,0,36,30
1656963546672,MATH 103A,B02,083780,Greenfeld; Be'Eri,2,0,36,34
1656963546672,MATH 103A,B03,093562,Greenfeld; Be'Eri,2,0,36,34
1656963552694,MATH 105,A01,085443,Carter; Anne Toulson,14,0,35,21
1656963552694,MATH 105,A02,093477,Carter; Anne Toulson,20,0,35,15
1656963558719,MATH 109,A01,083213,Ganzberger; Geoffrey Michael,2,0,34,32
1656963558719,MATH 109,A02,083214,Ganzberger; Geoffrey Michael,2,0,34,32
1656963558719,MATH 109,A03,093478,Ganzberger; Geoffrey Michael,1,0,34,33
1656963558719,MATH 109,B01,083215,Ganzberger; Geoffrey Michael,1,0,32,31
1656963558719,MATH 109,B02,083216,Ganzberger; Geoffrey Michael,1,0,32,31
1656963558719,MATH 109,B03,093479,Ganzberger; Geoffrey Michael,6,0,32,26
1656963564743,MATH 142A,A01,083219,Chow; Bennett,6,0,32,26
1656963564743,MATH 142A,A02,083220,Chow; Bennett,10,0,32,22
1656963564743,MATH 142A,A03,093480,Chow; Bennett,7,0,32,25
1656963564743,MATH 142A,B03,093481,Chow; Bennett,7,0,32,25
1656963564743,MATH 142A,B04,093558,Chow; Bennett,11,0,32,21
1656963564743,MATH 142A,B05,093559,Chow; Bennett,6,0,32,26
1656963570767,MATH 193A,A01,083224,Rotar; Vladimir,7,0,34,27
1656963570767,MATH 193A,A02,083225,Rotar; Vladimir,4,0,34,30
1656963570767,MATH 193A,A03,083781,Rotar; Vladimir,1,0,34,33
1656963570767,MATH 193A,A04,083782,Rotar; Vladimir,6,0,34,28
1656963570767,MATH 193A,A05,093482,Rotar; Vladimir,6,0,34,28
1656963576789,MATH 197,001,091859,McAuley; Julian John,9999,0,9999,0
1656963576789,MATH 197,002,095566,Kedlaya; Kiran S.,9997,0,9999,2
1656963576789,MATH 197,003,095567,Xiao; Ming,9999,0,9999,0
1656963576789,MATH 197,004,095571,Perols; Johan Lars,9998,0,9999,1
1656963583855,COGS 9,A01,083615,Shannon; Kyle Michael,7,0,75,68
1656963589878,COGS 11,A01,083617,Boyle; Mary E. T.,20,0,48,28
1656963595902,COGS 13,A01,083071,Bastos; Amalia Pinkusfeld,9,0,71,62
1656963601929,COGS 14A,A01,092681,Semenuks; Arturs,0,1,100,100
1656963607950,COGS 14B,A01,083073,Cheng; Tzu-Han,5,0,63,58
1656963613973,COGS 17,A01,092677,Semenuks; Arturs,4,0,81,77
1656963620089,COGS 100,A01,083619,Allen; Michael Gordon,15,0,70,55
1656963626120,COGS 101A,A01,083621,Davis; Joshua Daniel,9,0,68,59
1656963632147,COGS 101B,A01,091572,Allen; Michael Gordon,8,0,65,57
1656963638172,COGS 101C,A01,083625,Delgado; Tania,17,0,35,18
1656963644199,COGS 107A,A01,083627,Boyle; Mary E. T.,13,0,60,47
1656963650234,COGS 118A,A01,083075,Gupta; Anjum,15,0,76,61
1656963656257,CSE 3,A50,083646,Miranda; Gregory Joseph,22,0,50,28
1656963662284,CSE 8A,A50,083650,Miranda; Gregory Joseph,17,1,56,39
1656963668308,CSE 11,A01,083080,Cao; Yingjun,4,15,40,36
1656963674335,CSE 12,A01,083652,Krause-Levy; Sophia Louisa,20,1,120,100
1656963680362,CSE 15L,A01,083654,Morris; Justin Loren,8,0,50,42
1656963680362,CSE 15L,A02,083655,Morris; Justin Loren,8,0,50,42
1656963686386,CSE 20,A01,083657,Tran; Khoa Dang,37,0,80,43
1656963692413,CSE 21,A01,095574,Bach; Quang Tran,21,0,48,27
1656963698438,CSE 30,A01,083084,Eldon; John,4,0,80,76
1656963698438,CSE 30,B01,095061,Bhaskar; Nishant,6,0,50,44
1656963704461,CSE 100,A01,083659,Cao; Yingjun,3,4,70,67
1656963710489,CSE 134B,A01,083661,Powell; Thomas Allan,19,0,100,81
1656963716540,CSE 140,A01,083663,Gungor; Onat,14,0,85,71
1656963722564,CSE 140L,A01,083088,Eldon; John,16,0,100,84
1656963728587,CSE 175,A01,083665,Kumar; Rakesh,3,0,25,22
1656963734610,CSE 190,A00,092507,Dubnov; Shlomo,7,0,20,13
1656963740635,ECE 45,A01,083139,Congero; Spencer William,5,0,75,70
1656963746661,ECE 65,A50,083695,Saad; Andrew S,12,0,30,18
1656963746661,ECE 65,A51,095125,Saad; Andrew S,25,0,26,1
1656963752685,ECE 109,A01,091882,Touri; Behrouz,16,0,70,54
1656963758708,ECE 180,A00,083140,Abi Samra; Nicholas Camill,0,0,30,30
1656963758708,ECE 180,B00,083141,Abi Samra; Nicholas Camill,0,0,30,30
1656963764738,MATH 10A,A01,083735,Patchell; Gregory David,1,0,30,29
1656963764738,MATH 10A,A02,083736,Patchell; Gregory David,20,0,30,10
1656963764738,MATH 10A,A03,083737,Patchell; Gregory David,15,0,30,15
1656963770767,MATH 10B,A01,083207,Lim; Seonhee,7,0,34,27
1656963770767,MATH 10B,A02,083208,Lim; Seonhee,9,0,35,26
1656963770767,MATH 10B,A03,093472,Lim; Seonhee,4,0,34,30
1656963770767,MATH 10B,B01,083739,Sinha; Shubham,9,0,30,21
1656963776793,MATH 18,A01,083743,Cinel; Cameron Alexander,6,0,30,24
1656963776793,MATH 18,A02,083744,Cinel; Cameron Alexander,15,0,30,15
1656963776793,MATH 18,A03,083745,Cinel; Cameron Alexander,8,0,30,22
1656963776793,MATH 18,B01,083748,Rideout; David Porter,4,0,37,33
1656963776793,MATH 18,B02,083749,Rideout; David Porter,3,0,36,33
1656963776793,MATH 18,B03,083750,Rideout; David Porter,2,0,37,35
1656963776793,MATH 18,B04,083751,Rideout; David Porter,5,0,36,31
1656963776793,MATH 18,B05,093473,Rideout; David Porter,4,0,36,32
1656963776793,MATH 18,B06,093474,Rideout; David Porter,5,0,36,31
1656963782818,MATH 20A,A01,083754,Zheng; Zequn,12,0,40,28
1656963788843,MATH 20B,A01,083756,Briones; Jor-el Thomas Caparas,1,0,36,35
1656963788843,MATH 20B,A02,083757,Briones; Jor-el Thomas Caparas,1,0,36,35
1656963788843,MATH 20B,A03,093475,Briones; Jor-el Thomas Caparas,0,0,36,36
1656963794865,MATH 20C,A01,083760,Briones; Jor-el Thomas Caparas,1,0,35,34
1656963794865,MATH 20C,A02,083761,Briones; Jor-el Thomas Caparas,8,0,35,27
1656963794865,MATH 20C,A03,093476,Briones; Jor-el Thomas Caparas,0,1,36,36
1656963794865,MATH 20C,B01,083762,Bach; Quang Tran,0,0,30,30
1656963800892,MATH 20D,A01,083765,Tran; Brian Kha,4,0,30,26
1656963800892,MATH 20D,A02,083766,Tran; Brian Kha,4,0,30,26
1656963800892,MATH 20D,A03,083767,Tran; Brian Kha,3,0,30,27
1656963806915,MATH 20E,A01,083771,Ganguly; Soumya,5,0,32,27
1656963806915,MATH 20E,A02,083772,Ganguly; Soumya,6,0,32,26
1656963806915,MATH 20E,B01,083773,Ciotti; Benjamin,18,0,35,17
1656963806915,MATH 20E,B02,083774,Ciotti; Benjamin,17,0,35,18
1656963812938,MATH 103A,A01,083777,Greenfeld; Be'Eri,2,0,36,34
1656963812938,MATH 103A,A02,083778,Greenfeld; Be'Eri,5,0,36,31
1656963812938,MATH 103A,A03,093561,Greenfeld; Be'Eri,4,0,36,32
1656963812938,MATH 103A,B01,083779,Greenfeld; Be'Eri,6,0,36,30
1656963812938,MATH 103A,B02,083780,Greenfeld; Be'Eri,2,0,36,34
1656963812938,MATH 103A,B03,093562,Greenfeld; Be'Eri,2,0,36,34
1656963818967,MATH 105,A01,085443,Carter; Anne Toulson,14,0,35,21
1656963818967,MATH 105,A02,093477,Carter; Anne Toulson,20,0,35,15
1656963824989,MATH 109,A01,083213,Ganzberger; Geoffrey Michael,2,0,34,32
1656963824989,MATH 109,A02,083214,Ganzberger; Geoffrey Michael,2,0,34,32
1656963824989,MATH 109,A03,093478,Ganzberger; Geoffrey Michael,1,0,34,33
1656963824989,MATH 109,B01,083215,Ganzberger; Geoffrey Michael,1,0,32,31
1656963824989,MATH 109,B02,083216,Ganzberger; Geoffrey Michael,1,0,32,31
1656963824989,MATH 109,B03,093479,Ganzberger; Geoffrey Michael,6,0,32,26
1656963831013,MATH 142A,A01,083219,Chow; Bennett,6,0,32,26
1656963831013,MATH 142A,A02,083220,Chow; Bennett,10,0,32,22
1656963831013,MATH 142A,A03,093480,Chow; Bennett,7,0,32,25
1656963831013,MATH 142A,B03,093481,Chow; Bennett,7,0,32,25
1656963831013,MATH 142A,B04,093558,Chow; Bennett,11,0,32,21
1656963831013,MATH 142A,B05,093559,Chow; Bennett,6,0,32,26
1656963837050,MATH 193A,A01,083224,Rotar; Vladimir,7,0,34,27
1656963837050,MATH 193A,A02,083225,Rotar; Vladimir,4,0,34,30
1656963837050,MATH 193A,A03,083781,Rotar; Vladimir,1,0,34,33
1656963837050,MATH 193A,A04,083782,Rotar; Vladimir,6,0,34,28
1656963837050,MATH 193A,A05,093482,Rotar; Vladimir,6,0,34,28
1656963843078,MATH 197,001,091859,McAuley; Julian John,9999,0,9999,0
1656963843078,MATH 197,002,095566,Kedlaya; Kiran S.,9997,0,9999,2
1656963843078,MATH 197,003,095567,Xiao; Ming,9999,0,9999,0
1656963843078,MATH 197,004,095571,Perols; Johan Lars,9998,0,9999,1
1656963850133,COGS 9,A01,083615,Shannon; Kyle Michael,7,0,75,68
1656963856161,COGS 11,A01,083617,Boyle; Mary E. T.,20,0,48,28
1656963862184,COGS 13,A01,083071,Bastos; Amalia Pinkusfeld,9,0,71,62
1656963868209,COGS 14A,A01,092681,Semenuks; Arturs,0,1,100,100
1656963874241,COGS 14B,A01,083073,Cheng; Tzu-Han,5,0,63,58
1656963880266,COGS 17,A01,092677,Semenuks; Arturs,4,0,81,77
1656963886293,COGS 100,A01,083619,Allen; Michael Gordon,15,0,70,55
1656963892316,COGS 101A,A01,083621,Davis; Joshua Daniel,9,0,68,59
1656963898344,COGS 101B,A01,091572,Allen; Michael Gordon,8,0,65,57
1656963904368,COGS 101C,A01,083625,Delgado; Tania,17,0,35,18
1656963910394,COGS 107A,A01,083627,Boyle; Mary E. T.,13,0,60,47
1656963916416,COGS 118A,A01,083075,Gupta; Anjum,15,0,76,61
1656963922445,CSE 3,A50,083646,Miranda; Gregory Joseph,22,0,50,28
1656963928470,CSE 8A,A50,083650,Miranda; Gregory Joseph,17,1,56,39
1656963934496,CSE 11,A01,083080,Cao; Yingjun,4,15,40,36
1656963940524,CSE 12,A01,083652,Krause-Levy; Sophia Louisa,20,1,120,100
1656963946551,CSE 15L,A01,083654,Morris; Justin Loren,8,0,50,42
1656963946551,CSE 15L,A02,083655,Morris; Justin Loren,8,0,50,42
1656963952577,CSE 20,A01,083657,Tran; Khoa Dang,37,0,80,43
1656963958599,CSE 21,A01,095574,Bach; Quang Tran,21,0,48,27
1656963964623,CSE 30,A01,083084,Eldon; John,4,0,80,76
1656963964623,CSE 30,B01,095061,Bhaskar; Nishant,6,0,50,44
1656963970647,CSE 100,A01,083659,Cao; Yingjun,3,4,70,67
1656963976672,CSE 134B,A01,083661,Powell; Thomas Allan,19,0,100,81
1656963982698,CSE 140,A01,083663,Gungor; Onat,14,0,85,71
1656963988720,CSE 140L,A01,083088,Eldon; John,16,0,100,84
1656963994742,CSE 175,A01,083665,Kumar; Rakesh,3,0,25,22
1656964000774,CSE 190,A00,092507,Dubnov; Shlomo,7,0,20,13
1656964006796,ECE 45,A01,083139,Congero; Spencer William,5,0,75,70
1656964012819,ECE 65,A50,083695,Saad; Andrew S,12,0,30,18
1656964012819,ECE 65,A51,095125,Saad; Andrew S,25,0,26,1
1656964018846,ECE 109,A01,091882,Touri; Behrouz,16,0,70,54
1656964024870,ECE 180,A00,083140,Abi Samra; Nicholas Camill,0,0,30,30
1656964024870,ECE 180,B00,083141,Abi Samra; Nicholas Camill,0,0,30,30
1656964030893,MATH 10A,A01,083735,Patchell; Gregory David,1,0,30,29
1656964030893,MATH 10A,A02,083736,Patchell; Gregory David,20,0,30,10
1656964030893,MATH 10A,A03,083737,Patchell; Gregory David,15,0,30,15
1656964036917,MATH 10B,A01,083207,Lim; Seonhee,7,0,34,27
1656964036917,MATH 10B,A02,083208,Lim; Seonhee,9,0,35,26
1656964036917,MATH 10B,A03,093472,Lim; Seonhee,4,0,34,30
1656964036917,MATH 10B,B01,083739,Sinha; Shubham,9,0,30,21
1656964042949,MATH 18,A01,083743,Cinel; Cameron Alexander,6,0,30,24
1656964042949,MATH 18,A02,083744,Cinel; Cameron Alexander,15,0,30,15
1656964042949,MATH 18,A03,083745,Cinel; Cameron Alexander,8,0,30,22
1656964042949,MATH 18,B01,083748,Rideout; David Porter,4,0,37,33
1656964042949,MATH 18,B02,083749,Rideout; David Porter,3,0,36,33
1656964042949,MATH 18,B03,083750,Rideout; David Porter,2,0,37,35
1656964042949,MATH 18,B04,083751,Rideout; David Porter,5,0,36,31
1656964042949,MATH 18,B05,093473,Rideout; David Porter,4,0,36,32
1656964042949,MATH 18,B06,093474,Rideout; David Porter,5,0,36,31
1656964048972,MATH 20A,A01,083754,Zheng; Zequn,12,0,40,28
1656964054998,MATH 20B,A01,083756,Briones; Jor-el Thomas Caparas,1,0,36,35
1656964054998,MATH 20B,A02,083757,Briones; Jor-el Thomas Caparas,1,0,36,35
1656964054998,MATH 20B,A03,093475,Briones; Jor-el Thomas Caparas,0,0,36,36
1656964061027,MATH 20C,A01,083760,Briones; Jor-el Thomas Caparas,1,0,35,34
1656964061027,MATH 20C,A02,083761,Briones; Jor-el Thomas Caparas,8,0,35,27
1656964061027,MATH 20C,A03,093476,Briones; Jor-el Thomas Caparas,0,1,36,36
1656964061027,MATH 20C,B01,083762,Bach; Quang Tran,0,0,30,30
1656964067056,MATH 20D,A01,083765,Tran; Brian Kha,4,0,30,26
1656964067056,MATH 20D,A02,083766,Tran; Brian Kha,4,0,30,26
1656964067056,MATH 20D,A03,083767,Tran; Brian Kha,3,0,30,27
1656964073080,MATH 20E,A01,083771,Ganguly; Soumya,5,0,32,27
1656964073080,MATH 20E,A02,083772,Ganguly; Soumya,6,0,32,26
1656964073080,MATH 20E,B01,083773,Ciotti; Benjamin,18,0,35,17
1656964073080,MATH 20E,B02,083774,Ciotti; Benjamin,17,0,35,18
1656964079102,MATH 103A,A01,083777,Greenfeld; Be'Eri,2,0,36,34
1656964079102,MATH 103A,A02,083778,Greenfeld; Be'Eri,5,0,36,31
1656964079102,MATH 103A,A03,093561,Greenfeld; Be'Eri,4,0,36,32
1656964079102,MATH 103A,B01,083779,Greenfeld; Be'Eri,6,0,36,30
1656964079102,MATH 103A,B02,083780,Greenfeld; Be'Eri,2,0,36,34
1656964079102,MATH 103A,B03,093562,Greenfeld; Be'Eri,2,0,36,34
1656964085143,MATH 105,A01,085443,Carter; Anne Toulson,14,0,35,21
1656964085143,MATH 105,A02,093477,Carter; Anne Toulson,20,0,35,15
1656964091167,MATH 109,A01,083213,Ganzberger; Geoffrey Michael,2,0,34,32
1656964091167,MATH 109,A02,083214,Ganzberger; Geoffrey Michael,2,0,34,32
1656964091167,MATH 109,A03,093478,Ganzberger; Geoffrey Michael,1,0,34,33
1656964091167,MATH 109,B01,083215,Ganzberger; Geoffrey Michael,1,0,32,31
1656964091167,MATH 109,B02,083216,Ganzberger; Geoffrey Michael,1,0,32,31
1656964091167,MATH 109,B03,093479,Ganzberger; Geoffrey Michael,6,0,32,26
1656964097198,MATH 142A,A01,083219,Chow; Bennett,6,0,32,26
1656964097198,MATH 142A,A02,083220,Chow; Bennett,10,0,32,22
1656964097198,MATH 142A,A03,093480,Chow; Bennett,7,0,32,25
1656964097198,MATH 142A,B03,093481,Chow; Bennett,7,0,32,25
1656964097198,MATH 142A,B04,093558,Chow; Bennett,11,0,32,21
1656964097198,MATH 142A,B05,093559,Chow; Bennett,6,0,32,26
1656964103221,MATH 193A,A01,083224,Rotar; Vladimir,7,0,34,27
1656964103221,MATH 193A,A02,083225,Rotar; Vladimir,4,0,34,30
1656964103221,MATH 193A,A03,083781,Rotar; Vladimir,1,0,34,33
1656964103221,MATH 193A,A04,083782,Rotar; Vladimir,6,0,34,28
1656964103221,MATH 193A,A05,093482,Rotar; Vladimir,6,0,34,28
1656964109245,MATH 197,001,091859,McAuley; Julian John,9999,0,9999,0
1656964109245,MATH 197,002,095566,Kedlaya; Kiran S.,9997,0,9999,2
1656964109245,MATH 197,003,095567,Xiao; Ming,9999,0,9999,0
1656964109245,MATH 197,004,095571,Perols; Johan Lars,9998,0,9999,1
1656964116302,COGS 9,A01,083615,Shannon; Kyle Michael,7,0,75,68
1656964122326,COGS 11,A01,083617,Boyle; Mary E. T.,20,0,48,28
1656964128349,COGS 13,A01,083071,Bastos; Amalia Pinkusfeld,9,0,71,62
1656964134376,COGS 14A,A01,092681,Semenuks; Arturs,0,1,100,100
1656964140404,COGS 14B,A01,083073,Cheng; Tzu-Han,5,0,63,58
1656964146427,COGS 17,A01,092677,Semenuks; Arturs,4,0,81,77
1656964152451,COGS 100,A01,083619,Allen; Michael Gordon,15,0,70,55
1656964158475,COGS 101A,A01,083621,Davis; Joshua Daniel,9,0,68,59
1656964164498,COGS 101B,A01,091572,Allen; Michael Gordon,8,0,65,57
1656964170527,COGS 101C,A01,083625,Delgado; Tania,17,0,35,18
1656964176551,COGS 107A,A01,083627,Boyle; Mary E. T.,13,0,60,47
1656964182578,COGS 118A,A01,083075,Gupta; Anjum,15,0,76,61
1656964188602,CSE 3,A50,083646,Miranda; Gregory Joseph,22,0,50,28
1656964194627,CSE 8A,A50,083650,Miranda; Gregory Joseph,17,1,56,39
1656964200652,CSE 11,A01,083080,Cao; Yingjun,4,15,40,36
1656964206674,CSE 12,A01,083652,Krause-Levy; Sophia Louisa,20,1,120,100
1656964212698,CSE 15L,A01,083654,Morris; Justin Loren,8,0,50,42
1656964212698,CSE 15L,A02,083655,Morris; Justin Loren,8,0,50,42
1656964218798,CSE 20,A01,083657,Tran; Khoa Dang,37,0,80,43
1656964224821,CSE 21,A01,095574,Bach; Quang Tran,21,0,48,27
1656964230846,CSE 30,A01,083084,Eldon; John,4,0,80,76
1656964230846,CSE 30,B01,095061,Bhaskar; Nishant,6,0,50,44
1656964236879,CSE 100,A01,083659,Cao; Yingjun,3,4,70,67
1656964242905,CSE 134B,A01,083661,Powell; Thomas Allan,19,0,100,81
1656964248932,CSE 140,A01,083663,Gungor; Onat,14,0,85,71
1656964254956,CSE 140L,A01,083088,Eldon; John,16,0,100,84
1656964260982,CSE 175,A01,083665,Kumar; Rakesh,3,0,25,22
1656964267006,CSE 190,A00,092507,Dubnov; Shlomo,7,0,20,13
1656964273031,ECE 45,A01,083139,Congero; Spencer William,5,0,75,70
1656964279054,ECE 65,A50,083695,Saad; Andrew S,12,0,30,18
1656964279054,ECE 65,A51,095125,Saad; Andrew S,25,0,26,1
1656964285076,ECE 109,A01,091882,Touri; Behrouz,16,0,70,54
1656964291103,ECE 180,A00,083140,Abi Samra; Nicholas Camill,0,0,30,30
1656964291103,ECE 180,B00,083141,Abi Samra; Nicholas Camill,0,0,30,30
1656964297130,MATH 10A,A01,083735,Patchell; Gregory David,1,0,30,29
1656964297130,MATH 10A,A02,083736,Patchell; Gregory David,20,0,30,10
1656964297130,MATH 10A,A03,083737,Patchell; Gregory David,15,0,30,15
1656964303160,MATH 10B,A01,083207,Lim; Seonhee,7,0,34,27
1656964303160,MATH 10B,A02,083208,Lim; Seonhee,9,0,35,26
1656964303160,MATH 10B,A03,093472,Lim; Seonhee,4,0,34,30
1656964303160,MATH 10B,B01,083739,Sinha; Shubham,9,0,30,21
1656964309185,MATH 18,A01,083743,Cinel; Cameron Alexander,6,0,30,24
1656964309185,MATH 18,A02,083744,Cinel; Cameron Alexander,15,0,30,15
1656964309185,MATH 18,A03,083745,Cinel; Cameron Alexander,8,0,30,22
1656964309185,MATH 18,B01,083748,Rideout; David Porter,4,0,37,33
1656964309185,MATH 18,B02,083749,Rideout; David Porter,3,0,36,33
1656964309185,MATH 18,B03,083750,Rideout; David Porter,2,0,37,35
1656964309185,MATH 18,B04,083751,Rideout; David Porter,5,0,36,31
1656964309185,MATH 18,B05,093473,Rideout; David Porter,4,0,36,32
1656964309185,MATH 18,B06,093474,Rideout; David Porter,5,0,36,31
1656964315213,MATH 20A,A01,083754,Zheng; Zequn,12,0,40,28
1656964321234,MATH 20B,A01,083756,Briones; Jor-el Thomas Caparas,1,0,36,35
1656964321234,MATH 20B,A02,083757,Briones; Jor-el Thomas Caparas,1,0,36,35
1656964321234,MATH 20B,A03,093475,Briones; Jor-el Thomas Caparas,0,0,36,36
1656964327258,MATH 20C,A01,083760,Briones; Jor-el Thomas Caparas,1,0,35,34
1656964327258,MATH 20C,A02,083761,Briones; Jor-el Thomas Caparas,8,0,35,27
1656964327258,MATH 20C,A03,093476,Briones; Jor-el Thomas Caparas,0,1,36,36
1656964327258,MATH 20C,B01,083762,Bach; Quang Tran,0,0,30,30
1656964333286,MATH 20D,A01,083765,Tran; Brian Kha,4,0,30,26
1656964333286,MATH 20D,A02,083766,Tran; Brian Kha,4,0,30,26
1656964333286,MATH 20D,A03,083767,Tran; Brian Kha,3,0,30,27
1656964339310,MATH 20E,A01,083771,Ganguly; Soumya,5,0,32,27
1656964339310,MATH 20E,A02,083772,Ganguly; Soumya,6,0,32,26
1656964339310,MATH 20E,B01,083773,Ciotti; Benjamin,18,0,35,17
1656964339310,MATH 20E,B02,083774,Ciotti; Benjamin,17,0,35,18
1656964345335,MATH 103A,A01,083777,Greenfeld; Be'Eri,2,0,36,34
1656964345335,MATH 103A,A02,083778,Greenfeld; Be'Eri,5,0,36,31
1656964345335,MATH 103A,A03,093561,Greenfeld; Be'Eri,4,0,36,32
1656964345335,MATH 103A,B01,083779,Greenfeld; Be'Eri,6,0,36,30
1656964345335,MATH 103A,B02,083780,Greenfeld; Be'Eri,2,0,36,34
1656964345335,MATH 103A,B03,093562,Greenfeld; Be'Eri,2,0,36,34
1656964351358,MATH 105,A01,085443,Carter; Anne Toulson,14,0,35,21
1656964351358,MATH 105,A02,093477,Carter; Anne Toulson,20,0,35,15
1656964357387,MATH 109,A01,083213,Ganzberger; Geoffrey Michael,2,0,34,32
1656964357387,MATH 109,A02,083214,Ganzberger; Geoffrey Michael,2,0,34,32
1656964357387,MATH 109,A03,093478,Ganzberger; Geoffrey Michael,1,0,34,33
1656964357387,MATH 109,B01,083215,Ganzberger; Geoffrey Michael,1,0,32,31
1656964357387,MATH 109,B02,083216,Ganzberger; Geoffrey Michael,1,0,32,31
1656964357387,MATH 109,B03,093479,Ganzberger; Geoffrey Michael,6,0,32,26
1656964363417,MATH 142A,A01,083219,Chow; Bennett,6,0,32,26
1656964363417,MATH 142A,A02,083220,Chow; Bennett,10,0,32,22
1656964363417,MATH 142A,A03,093480,Chow; Bennett,7,0,32,25
1656964363417,MATH 142A,B03,093481,Chow; Bennett,7,0,32,25
1656964363417,MATH 142A,B04,093558,Chow; Bennett,11,0,32,21
1656964363417,MATH 142A,B05,093559,Chow; Bennett,6,0,32,26
1656964369445,MATH 193A,A01,083224,Rotar; Vladimir,7,0,34,27
1656964369445,MATH 193A,A02,083225,Rotar; Vladimir,4,0,34,30
1656964369445,MATH 193A,A03,083781,Rotar; Vladimir,1,0,34,33
1656964369445,MATH 193A,A04,083782,Rotar; Vladimir,6,0,34,28
1656964369445,MATH 193A,A05,093482,Rotar; Vladimir,6,0,34,28
1656964375469,MATH 197,001,091859,McAuley; Julian John,9999,0,9999,0
1656964375469,MATH 197,002,095566,Kedlaya; Kiran S.,9997,0,9999,2
1656964375469,MATH 197,003,095567,Xiao; Ming,9999,0,9999,0
1656964375469,MATH 197,004,095571,Perols; Johan Lars,9998,0,9999,1
1656964382528,COGS 9,A01,083615,Shannon; Kyle Michael,7,0,75,68
1656964388553,COGS 11,A01,083617,Boyle; Mary E. T.,20,0,48,28
1656964394580,COGS 13,A01,083071,Bastos; Amalia Pinkusfeld,9,0,71,62
1656964400608,COGS 14A,A01,092681,Semenuks; Arturs,0,1,100,100
1656964406635,COGS 14B,A01,083073,Cheng; Tzu-Han,5,0,63,58
1656964412658,COGS 17,A01,092677,Semenuks; Arturs,4,0,81,77
1656964418682,COGS 100,A01,083619,Allen; Michael Gordon,15,0,70,55
1656964424706,COGS 101A,A01,083621,Davis; Joshua Daniel,9,0,68,59
1656964430728,COGS 101B,A01,091572,Allen; Michael Gordon,8,0,65,57
1656964436750,COGS 101C,A01,083625,Delgado; Tania,17,0,35,18
1656964442777,COGS 107A,A01,083627,Boyle; Mary E. T.,13,0,60,47
1656964448799,COGS 118A,A01,083075,Gupta; Anjum,15,0,76,61
1656964454825,CSE 3,A50,083646,Miranda; Gregory Joseph,22,0,50,28
1656964460848,CSE 8A,A50,083650,Miranda; Gregory Joseph,17,1,56,39
1656964466870,CSE 11,A01,083080,Cao; Yingjun,4,15,40,36
1656964472900,CSE 12,A01,083652,Krause-Levy; Sophia Louisa,20,1,120,100
1656964478927,CSE 15L,A01,083654,Morris; Justin Loren,8,0,50,42
1656964478927,CSE 15L,A02,083655,Morris; Justin Loren,8,0,50,42
1656964484951,CSE 20,A01,083657,Tran; Khoa Dang,37,0,80,43
1656964490977,CSE 21,A01,095574,Bach; Quang Tran,21,0,48,27
1656964497000,CSE 30,A01,083084,Eldon; John,4,0,80,76
1656964497000,CSE 30,B01,095061,Bhaskar; Nishant,6,0,50,44
1656964503024,CSE 100,A01,083659,Cao; Yingjun,3,4,70,67
1656964509049,CSE 134B,A01,083661,Powell; Thomas Allan,19,0,100,81
1656964515071,CSE 140,A01,083663,Gungor; Onat,14,0,85,71
1656964521094,CSE 140L,A01,083088,Eldon; John,16,0,100,84
1656964527117,CSE 175,A01,083665,Kumar; Rakesh,3,0,25,22
1656964533140,CSE 190,A00,092507,Dubnov; Shlomo,7,0,20,13
1656964539164,ECE 45,A01,083139,Congero; Spencer William,5,0,75,70
1656964545188,ECE 65,A50,083695,Saad; Andrew S,12,0,30,18
1656964545188,ECE 65,A51,095125,Saad; Andrew S,25,0,26,1
1656964551214,ECE 109,A01,091882,Touri; Behrouz,16,0,70,54
1656964557247,ECE 180,A00,083140,Abi Samra; Nicholas Camill,0,0,30,30
1656964557247,ECE 180,B00,083141,Abi Samra; Nicholas Camill,0,0,30,30
1656964563269,MATH 10A,A01,083735,Patchell; Gregory David,1,0,30,29
1656964563269,MATH 10A,A02,083736,Patchell; Gregory David,20,0,30,10
1656964563269,MATH 10A,A03,083737,Patchell; Gregory David,15,0,30,15
1656964569294,MATH 10B,A01,083207,Lim; Seonhee,7,0,34,27
1656964569294,MATH 10B,A02,083208,Lim; Seonhee,9,0,35,26
1656964569294,MATH 10B,A03,093472,Lim; Seonhee,4,0,34,30
1656964569294,MATH 10B,B01,083739,Sinha; Shubham,9,0,30,21
1656964575322,MATH 18,A01,083743,Cinel; Cameron Alexander,6,0,30,24
1656964575322,MATH 18,A02,083744,Cinel; Cameron Alexander,15,0,30,15
1656964575322,MATH 18,A03,083745,Cinel; Cameron Alexander,8,0,30,22
1656964575322,MATH 18,B01,083748,Rideout; David Porter,4,0,37,33
1656964575322,MATH 18,B02,083749,Rideout; David Porter,3,0,36,33
1656964575322,MATH 18,B03,083750,Rideout; David Porter,2,0,37,35
1656964575322,MATH 18,B04,083751,Rideout; David Porter,5,0,36,31
1656964575322,MATH 18,B05,093473,Rideout; David Porter,4,0,36,32
1656964575322,MATH 18,B06,093474,Rideout; David Porter,5,0,36,31
1656964581348,MATH 20A,A01,083754,Zheng; Zequn,12,0,40,28
1656964587377,MATH 20B,A01,083756,Briones; Jor-el Thomas Caparas,1,0,36,35
1656964587377,MATH 20B,A02,083757,Briones; Jor-el Thomas Caparas,1,0,36,35
1656964587377,MATH 20B,A03,093475,Briones; Jor-el Thomas Caparas,0,0,36,36
1656964593405,MATH 20C,A01,083760,Briones; Jor-el Thomas Caparas,1,0,35,34
1656964593405,MATH 20C,A02,083761,Briones; Jor-el Thomas Caparas,8,0,35,27
1656964593405,MATH 20C,A03,093476,Briones; Jor-el Thomas Caparas,0,1,36,36
1656964593405,MATH 20C,B01,083762,Bach; Quang Tran,0,0,30,30
1656964599434,MATH 20D,A01,083765,Tran; Brian Kha,4,0,30,26
1656964599434,MATH 20D,A02,083766,Tran; Brian Kha,4,0,30,26
1656964599434,MATH 20D,A03,083767,Tran; Brian Kha,3,0,30,27
1656964605463,MATH 20E,A01,083771,Ganguly; Soumya,5,0,32,27
1656964605463,MATH 20E,A02,083772,Ganguly; Soumya,6,0,32,26
1656964605463,MATH 20E,B01,083773,Ciotti; Benjamin,18,0,35,17
1656964605463,MATH 20E,B02,083774,Ciotti; Benjamin,17,0,35,18
1656964611491,MATH 103A,A01,083777,Greenfeld; Be'Eri,2,0,36,34
1656964611491,MATH 103A,A02,083778,Greenfeld; Be'Eri,5,0,36,31
1656964611491,MATH 103A,A03,093561,Greenfeld; Be'Eri,4,0,36,32
1656964611491,MATH 103A,B01,083779,Greenfeld; Be'Eri,6,0,36,30
1656964611491,MATH 103A,B02,083780,Greenfeld; Be'Eri,2,0,36,34
1656964611491,MATH 103A,B03,093562,Greenfeld; Be'Eri,2,0,36,34
1656964617514,MATH 105,A01,085443,Carter; Anne Toulson,14,0,35,21
1656964617514,MATH 105,A02,093477,Carter; Anne Toulson,20,0,35,15
1656964623542,MATH 109,A01,083213,Ganzberger; Geoffrey Michael,2,0,34,32
1656964623542,MATH 109,A02,083214,Ganzberger; Geoffrey Michael,2,0,34,32
1656964623542,MATH 109,A03,093478,Ganzberger; Geoffrey Michael,1,0,34,33
1656964623542,MATH 109,B01,083215,Ganzberger; Geoffrey Michael,1,0,32,31
1656964623542,MATH 109,B02,083216,Ganzberger; Geoffrey Michael,1,0,32,31
1656964623542,MATH 109,B03,093479,Ganzberger; Geoffrey Michael,6,0,32,26
1656964629566,MATH 142A,A01,083219,Chow; Bennett,6,0,32,26
1656964629566,MATH 142A,A02,083220,Chow; Bennett,10,0,32,22
1656964629566,MATH 142A,A03,093480,Chow; Bennett,7,0,32,25
1656964629566,MATH 142A,B03,093481,Chow; Bennett,7,0,32,25
1656964629566,MATH 142A,B04,093558,Chow; Bennett,11,0,32,21
1656964629566,MATH 142A,B05,093559,Chow; Bennett,6,0,32,26
1656964635591,MATH 193A,A01,083224,Rotar; Vladimir,7,0,34,27
1656964635591,MATH 193A,A02,083225,Rotar; Vladimir,4,0,34,30
1656964635591,MATH 193A,A03,083781,Rotar; Vladimir,1,0,34,33
1656964635591,MATH 193A,A04,083782,Rotar; Vladimir,6,0,34,28
1656964635591,MATH 193A,A05,093482,Rotar; Vladimir,6,0,34,28
1656964641615,MATH 197,001,091859,McAuley; Julian John,9999,0,9999,0
1656964641615,MATH 197,002,095566,Kedlaya; Kiran S.,9997,0,9999,2
1656964641615,MATH 197,003,095567,Xiao; Ming,9999,0,9999,0
1656964641615,MATH 197,004,095571,Perols; Johan Lars,9998,0,9999,1
1656964648668,COGS 9,A01,083615,Shannon; Kyle Michael,7,0,75,68
1656964654694,COGS 11,A01,083617,Boyle; Mary E. T.,20,0,48,28
1656964660716,COGS 13,A01,083071,Bastos; Amalia Pinkusfeld,9,0,71,62
1656964666740,COGS 14A,A01,092681,Semenuks; Arturs,0,1,100,100
1656964672766,COGS 14B,A01,083073,Cheng; Tzu-Han,5,0,63,58
1656964678792,COGS 17,A01,092677,Semenuks; Arturs,4,0,81,77
1656964684816,COGS 100,A01,083619,Allen; Michael Gordon,15,0,70,55
1656964690840,COGS 101A,A01,083621,Davis; Joshua Daniel,9,0,68,59
1656964696862,COGS 101B,A01,091572,Allen; Michael Gordon,8,0,65,57
1656964702886,COGS 101C,A01,083625,Delgado; Tania,17,0,35,18
1656964708910,COGS 107A,A01,083627,Boyle; Mary E. T.,13,0,60,47
1656964714932,COGS 118A,A01,083075,Gupta; Anjum,15,0,76,61
1656964720957,CSE 3,A50,083646,Miranda; Gregory Joseph,22,0,50,28
1656964726982,CSE 8A,A50,083650,Miranda; Gregory Joseph,17,1,56,39
1656964733007,CSE 11,A01,083080,Cao; Yingjun,4,15,40,36
1656964739030,CSE 12,A01,083652,Krause-Levy; Sophia Louisa,20,1,120,100
1656964745054,CSE 15L,A01,083654,Morris; Justin Loren,8,0,50,42
1656964745054,CSE 15L,A02,083655,Morris; Justin Loren,8,0,50,42
1656964751077,CSE 20,A01,083657,Tran; Khoa Dang,37,0,80,43
1656964757100,CSE 21,A01,095574,Bach; Quang Tran,21,0,48,27
1656964763128,CSE 30,A01,083084,Eldon; John,4,0,80,76
1656964763128,CSE 30,B01,095061,Bhaskar; Nishant,6,0,50,44
1656964769154,CSE 100,A01,083659,Cao; Yingjun,3,4,70,67
1656964775181,CSE 134B,A01,083661,Powell; Thomas Allan,19,0,100,81
1656964781207,CSE 140,A01,083663,Gungor; Onat,14,0,85,71
1656964787233,CSE 140L,A01,083088,Eldon; John,16,0,100,84
1656964793257,CSE 175,A01,083665,Kumar; Rakesh,3,0,25,22
1656964799281,CSE 190,A00,092507,Dubnov; Shlomo,7,0,20,13
1656964805312,ECE 45,A01,083139,Congero; Spencer William,5,0,75,70
1656964811343,ECE 65,A50,083695,Saad; Andrew S,12,0,30,18
1656964811343,ECE 65,A51,095125,Saad; Andrew S,25,0,26,1
1656964817441,ECE 109,A01,091882,Touri; Behrouz,16,0,70,54
1656964823467,ECE 180,A00,083140,Abi Samra; Nicholas Camill,0,0,30,30
1656964823467,ECE 180,B00,083141,Abi Samra; Nicholas Camill,0,0,30,30
1656964829490,MATH 10A,A01,083735,Patchell; Gregory David,1,0,30,29
1656964829490,MATH 10A,A02,083736,Patchell; Gregory David,20,0,30,10
1656964829490,MATH 10A,A03,083737,Patchell; Gregory David,15,0,30,15
1656964835519,MATH 10B,A01,083207,Lim; Seonhee,7,0,34,27
1656964835519,MATH 10B,A02,083208,Lim; Seonhee,9,0,35,26
1656964835519,MATH 10B,A03,093472,Lim; Seonhee,4,0,34,30
1656964835519,MATH 10B,B01,083739,Sinha; Shubham,9,0,30,21
1656964841543,MATH 18,A01,083743,Cinel; Cameron Alexander,6,0,30,24
1656964841543,MATH 18,A02,083744,Cinel; Cameron Alexander,15,0,30,15
1656964841543,MATH 18,A03,083745,Cinel; Cameron Alexander,8,0,30,22
1656964841543,MATH 18,B01,083748,Rideout; David Porter,4,0,37,33
1656964841543,MATH 18,B02,083749,Rideout; David Porter,3,0,36,33
1656964841543,MATH 18,B03,083750,Rideout; David Porter,2,0,37,35
1656964841543,MATH 18,B04,083751,Rideout; David Porter,5,0,36,31
1656964841543,MATH 18,B05,093473,Rideout; David Porter,4,0,36,32
1656964841543,MATH 18,B06,093474,Rideout; David Porter,5,0,36,31
1656964847566,MATH 20A,A01,083754,Zheng; Zequn,12,0,40,28
1656964853594,MATH 20B,A01,083756,Briones; Jor-el Thomas Caparas,1,0,36,35
1656964853594,MATH 20B,A02,083757,Briones; Jor-el Thomas Caparas,1,0,36,35
1656964853594,MATH 20B,A03,093475,Briones; Jor-el Thomas Caparas,0,0,36,36
1656964859638,MATH 20C,A01,083760,Briones; Jor-el Thomas Caparas,1,0,35,34
1656964859638,MATH 20C,A02,083761,Briones; Jor-el Thomas Caparas,8,0,35,27
1656964859638,MATH 20C,A03,093476,Briones; Jor-el Thomas Caparas,0,1,36,36
1656964859638,MATH 20C,B01,083762,Bach; Quang Tran,0,0,30,30
1656964865661,MATH 20D,A01,083765,Tran; Brian Kha,4,0,30,26
1656964865661,MATH 20D,A02,083766,Tran; Brian Kha,4,0,30,26
1656964865661,MATH 20D,A03,083767,Tran; Brian Kha,3,0,30,27
1656964871687,MATH 20E,A01,083771,Ganguly; Soumya,5,0,32,27
1656964871687,MATH 20E,A02,083772,Ganguly; Soumya,6,0,32,26
1656964871687,MATH 20E,B01,083773,Ciotti; Benjamin,18,0,35,17
1656964871687,MATH 20E,B02,083774,Ciotti; Benjamin,17,0,35,18
1656964877711,MATH 103A,A01,083777,Greenfeld; Be'Eri,2,0,36,34
1656964877711,MATH 103A,A02,083778,Greenfeld; Be'Eri,5,0,36,31
1656964877711,MATH 103A,A03,093561,Greenfeld; Be'Eri,4,0,36,32
1656964877711,MATH 103A,B01,083779,Greenfeld; Be'Eri,6,0,36,30
1656964877711,MATH 103A,B02,083780,Greenfeld; Be'Eri,2,0,36,34
1656964877711,MATH 103A,B03,093562,Greenfeld; Be'Eri,2,0,36,34
1656964883738,MATH 105,A01,085443,Carter; Anne Toulson,14,0,35,21
1656964883738,MATH 105,A02,093477,Carter; Anne Toulson,20,0,35,15
1656964889761,MATH 109,A01,083213,Ganzberger; Geoffrey Michael,2,0,34,32
1656964889761,MATH 109,A02,083214,Ganzberger; Geoffrey Michael,2,0,34,32
1656964889761,MATH 109,A03,093478,Ganzberger; Geoffrey Michael,1,0,34,33
1656964889761,MATH 109,B01,083215,Ganzberger; Geoffrey Michael,1,0,32,31
1656964889761,MATH 109,B02,083216,Ganzberger; Geoffrey Michael,1,0,32,31
1656964889761,MATH 109,B03,093479,Ganzberger; Geoffrey Michael,6,0,32,26
1656964895790,MATH 142A,A01,083219,Chow; Bennett,6,0,32,26
1656964895790,MATH 142A,A02,083220,Chow; Bennett,10,0,32,22
1656964895790,MATH 142A,A03,093480,Chow; Bennett,7,0,32,25
1656964895790,MATH 142A,B03,093481,Chow; Bennett,7,0,32,25
1656964895790,MATH 142A,B04,093558,Chow; Bennett,11,0,32,21
1656964895790,MATH 142A,B05,093559,Chow; Bennett,6,0,32,26
1656964901818,MATH 193A,A01,083224,Rotar; Vladimir,7,0,34,27
1656964901818,MATH 193A,A02,083225,Rotar; Vladimir,4,0,34,30
1656964901818,MATH 193A,A03,083781,Rotar; Vladimir,1,0,34,33
1656964901818,MATH 193A,A04,083782,Rotar; Vladimir,6,0,34,28
1656964901818,MATH 193A,A05,093482,Rotar; Vladimir,6,0,34,28
1656964907845,MATH 197,001,091859,McAuley; Julian John,9999,0,9999,0
1656964907845,MATH 197,002,095566,Kedlaya; Kiran S.,9997,0,9999,2
1656964907845,MATH 197,003,095567,Xiao; Ming,9999,0,9999,0
1656964907845,MATH 197,004,095571,Perols; Johan Lars,9998,0,9999,1
1656964914910,COGS 9,A01,083615,Shannon; Kyle Michael,7,0,75,68
1656964920939,COGS 11,A01,083617,Boyle; Mary E. T.,20,0,48,28
1656964926963,COGS 13,A01,083071,Bastos; Amalia Pinkusfeld,9,0,71,62
1656964932996,COGS 14A,A01,092681,Semenuks; Arturs,0,1,100,100
1656964939043,COGS 14B,A01,083073,Cheng; Tzu-Han,5,0,63,58
1656964945072,COGS 17,A01,092677,Semenuks; Arturs,4,0,81,77
1656964951096,COGS 100,A01,083619,Allen; Michael Gordon,15,0,70,55
1656964957132,COGS 101A,A01,083621,Davis; Joshua Daniel,9,0,68,59
1656964963158,COGS 101B,A01,091572,Allen; Michael Gordon,8,0,65,57
1656964969185,COGS 101C,A01,083625,Delgado; Tania,17,0,35,18
1656964975215,COGS 107A,A01,083627,Boyle; Mary E. T.,13,0,60,47
1656964981241,COGS 118A,A01,083075,Gupta; Anjum,15,0,76,61
1656964987280,CSE 3,A50,083646,Miranda; Gregory Joseph,22,0,50,28
1656964993303,CSE 8A,A50,083650,Miranda; Gregory Joseph,17,1,56,39
1656964999329,CSE 11,A01,083080,Cao; Yingjun,4,15,40,36
1656965005353,CSE 12,A01,083652,Krause-Levy; Sophia Louisa,20,1,120,100
1656965011387,CSE 15L,A01,083654,Morris; Justin Loren,8,0,50,42
1656965011387,CSE 15L,A02,083655,Morris; Justin Loren,8,0,50,42
1656965017412,CSE 20,A01,083657,Tran; Khoa Dang,37,0,80,43
1656965023436,CSE 21,A01,095574,Bach; Quang Tran,21,0,48,27
1656965029459,CSE 30,A01,083084,Eldon; John,4,0,80,76
1656965029459,CSE 30,B01,095061,Bhaskar; Nishant,6,0,50,44
1656965035483,CSE 100,A01,083659,Cao; Yingjun,3,4,70,67
1656965041514,CSE 134B,A01,083661,Powell; Thomas Allan,19,0,100,81
1656965047537,CSE 140,A01,083663,Gungor; Onat,14,0,85,71
1656965053559,CSE 140L,A01,083088,Eldon; John,16,0,100,84
1656965059581,CSE 175,A01,083665,Kumar; Rakesh,3,0,25,22
1656965065602,CSE 190,A00,092507,Dubnov; Shlomo,7,0,20,13
1656965071627,ECE 45,A01,083139,Congero; Spencer William,5,0,75,70
1656965077662,ECE 65,A50,083695,Saad; Andrew S,12,0,30,18
1656965077662,ECE 65,A51,095125,Saad; Andrew S,25,0,26,1
1656965083688,ECE 109,A01,091882,Touri; Behrouz,16,0,70,54
1656965089709,ECE 180,A00,083140,Abi Samra; Nicholas Camill,0,0,30,30
1656965089709,ECE 180,B00,083141,Abi Samra; Nicholas Camill,0,0,30,30
1656965095732,MATH 10A,A01,083735,Patchell; Gregory David,1,0,30,29
1656965095732,MATH 10A,A02,083736,Patchell; Gregory David,20,0,30,10
1656965095732,MATH 10A,A03,083737,Patchell; Gregory David,15,0,30,15
1656965101756,MATH 10B,A01,083207,Lim; Seonhee,7,0,34,27
1656965101756,MATH 10B,A02,083208,Lim; Seonhee,9,0,35,26
1656965101756,MATH 10B,A03,093472,Lim; Seonhee,4,0,34,30
1656965101756,MATH 10B,B01,083739,Sinha; Shubham,9,0,30,21
1656965107785,MATH 18,A01,083743,Cinel; Cameron Alexander,6,0,30,24
1656965107785,MATH 18,A02,083744,Cinel; Cameron Alexander,15,0,30,15
1656965107785,MATH 18,A03,083745,Cinel; Cameron Alexander,8,0,30,22
1656965107785,MATH 18,B01,083748,Rideout; David Porter,4,0,37,33
1656965107785,MATH 18,B02,083749,Rideout; David Porter,3,0,36,33
1656965107785,MATH 18,B03,083750,Rideout; David Porter,2,0,37,35
1656965107785,MATH 18,B04,083751,Rideout; David Porter,5,0,36,31
1656965107785,MATH 18,B05,093473,Rideout; David Porter,4,0,36,32
1656965107785,MATH 18,B06,093474,Rideout; David Porter,5,0,36,31
1656965113810,MATH 20A,A01,083754,Zheng; Zequn,12,0,40,28
1656965119833,MATH 20B,A01,083756,Briones; Jor-el Thomas Caparas,1,0,36,35
1656965119833,MATH 20B,A02,083757,Briones; Jor-el Thomas Caparas,1,0,36,35
1656965119833,MATH 20B,A03,093475,Briones; Jor-el Thomas Caparas,0,0,36,36
1656965125857,MATH 20C,A01,083760,Briones; Jor-el Thomas Caparas,1,0,35,34
1656965125857,MATH 20C,A02,083761,Briones; Jor-el Thomas Caparas,8,0,35,27
1656965125857,MATH 20C,A03,093476,Briones; Jor-el Thomas Caparas,0,1,36,36
1656965125857,MATH 20C,B01,083762,Bach; Quang Tran,0,0,30,30
1656965131886,MATH 20D,A01,083765,Tran; Brian Kha,4,0,30,26
1656965131886,MATH 20D,A02,083766,Tran; Brian Kha,4,0,30,26
1656965131886,MATH 20D,A03,083767,Tran; Brian Kha,3,0,30,27
1656965137908,MATH 20E,A01,083771,Ganguly; Soumya,5,0,32,27
1656965137908,MATH 20E,A02,083772,Ganguly; Soumya,6,0,32,26
1656965137908,MATH 20E,B01,083773,Ciotti; Benjamin,18,0,35,17
1656965137908,MATH 20E,B02,083774,Ciotti; Benjamin,17,0,35,18
1656965143934,MATH 103A,A01,083777,Greenfeld; Be'Eri,2,0,36,34
1656965143934,MATH 103A,A02,083778,Greenfeld; Be'Eri,5,0,36,31
1656965143934,MATH 103A,A03,093561,Greenfeld; Be'Eri,4,0,36,32
1656965143934,MATH 103A,B01,083779,Greenfeld; Be'Eri,6,0,36,30
1656965143934,MATH 103A,B02,083780,Greenfeld; Be'Eri,2,0,36,34
1656965143934,MATH 103A,B03,093562,Greenfeld; Be'Eri,2,0,36,34
1656965149959,MATH 105,A01,085443,Carter; Anne Toulson,14,0,35,21
1656965149959,MATH 105,A02,093477,Carter; Anne Toulson,20,0,35,15
1656965155983,MATH 109,A01,083213,Ganzberger; Geoffrey Michael,2,0,34,32
1656965155983,MATH 109,A02,083214,Ganzberger; Geoffrey Michael,2,0,34,32
1656965155983,MATH 109,A03,093478,Ganzberger; Geoffrey Michael,1,0,34,33
1656965155983,MATH 109,B01,083215,Ganzberger; Geoffrey Michael,1,0,32,31
1656965155983,MATH 109,B02,083216,Ganzberger; Geoffrey Michael,1,0,32,31
1656965155983,MATH 109,B03,093479,Ganzberger; Geoffrey Michael,6,0,32,26
1656965162012,MATH 142A,A01,083219,Chow; Bennett,6,0,32,26
1656965162012,MATH 142A,A02,083220,Chow; Bennett,10,0,32,22
1656965162012,MATH 142A,A03,093480,Chow; Bennett,7,0,32,25
1656965162012,MATH 142A,B03,093481,Chow; Bennett,7,0,32,25
1656965162012,MATH 142A,B04,093558,Chow; Bennett,11,0,32,21
1656965162012,MATH 142A,B05,093559,Chow; Bennett,6,0,32,26
1656965168035,MATH 193A,A01,083224,Rotar; Vladimir,7,0,34,27
1656965168035,MATH 193A,A02,083225,Rotar; Vladimir,4,0,34,30
1656965168035,MATH 193A,A03,083781,Rotar; Vladimir,1,0,34,33
1656965168035,MATH 193A,A04,083782,Rotar; Vladimir,6,0,34,28
1656965168035,MATH 193A,A05,093482,Rotar; Vladimir,6,0,34,28
1656965174059,MATH 197,001,091859,McAuley; Julian John,9999,0,9999,0
1656965174059,MATH 197,002,095566,Kedlaya; Kiran S.,9997,0,9999,2
1656965174059,MATH 197,003,095567,Xiao; Ming,9999,0,9999,0
1656965174059,MATH 197,004,095571,Perols; Johan Lars,9998,0,9999,1
1656965181114,COGS 9,A01,083615,Shannon; Kyle Michael,7,0,75,68
1656965187137,COGS 11,A01,083617,Boyle; Mary E. T.,20,0,48,28
1656965193168,COGS 13,A01,083071,Bastos; Amalia Pinkusfeld,9,0,71,62
1656965199201,COGS 14A,A01,092681,Semenuks; Arturs,0,1,100,100
1656965205225,COGS 14B,A01,083073,Cheng; Tzu-Han,5,0,63,58
1656965211257,COGS 17,A01,092677,Semenuks; Arturs,4,0,81,77
1656965217281,COGS 100,A01,083619,Allen; Michael Gordon,15,0,70,55
1656965223305,COGS 101A,A01,083621,Davis; Joshua Daniel,9,0,68,59
1656965229347,COGS 101B,A01,091572,Allen; Michael Gordon,8,0,65,57
1656965235371,COGS 101C,A01,083625,Delgado; Tania,17,0,35,18
1656965241394,COGS 107A,A01,083627,Boyle; Mary E. T.,13,0,60,47
1656965247422,COGS 118A,A01,083075,Gupta; Anjum,15,0,76,61
1656965253444,CSE 3,A50,083646,Miranda; Gregory Joseph,22,0,50,28
1656965259468,CSE 8A,A50,083650,Miranda; Gregory Joseph,17,1,56,39
1656965265491,CSE 11,A01,083080,Cao; Yingjun,4,15,40,36
1656965271517,CSE 12,A01,083652,Krause-Levy; Sophia Louisa,20,1,120,100
1656965277547,CSE 15L,A01,083654,Morris; Justin Loren,8,0,50,42
1656965277547,CSE 15L,A02,083655,Morris; Justin Loren,8,0,50,42
1656965283573,CSE 20,A01,083657,Tran; Khoa Dang,37,0,80,43
1656965289607,CSE 21,A01,095574,Bach; Quang Tran,21,0,48,27
1656965295631,CSE 30,A01,083084,Eldon; John,4,0,80,76
1656965295631,CSE 30,B01,095061,Bhaskar; Nishant,6,0,50,44
1656965301654,CSE 100,A01,083659,Cao; Yingjun,3,4,70,67
1656965307676,CSE 134B,A01,083661,Powell; Thomas Allan,19,0,100,81
1656965313706,CSE 140,A01,083663,Gungor; Onat,14,0,85,71
1656965319731,CSE 140L,A01,083088,Eldon; John,16,0,100,84
1656965325755,CSE 175,A01,083665,Kumar; Rakesh,3,0,25,22
1656965331778,CSE 190,A00,092507,Dubnov; Shlomo,7,0,20,13
1656965337802,ECE 45,A01,083139,Congero; Spencer William,5,0,75,70
1656965343824,ECE 65,A50,083695,Saad; Andrew S,12,0,30,18
1656965343824,ECE 65,A51,095125,Saad; Andrew S,25,0,26,1
1656965349855,ECE 109,A01,091882,Touri; Behrouz,16,0,70,54
1656965355886,ECE 180,A00,083140,Abi Samra; Nicholas Camill,0,0,30,30
1656965355886,ECE 180,B00,083141,Abi Samra; Nicholas Camill,0,0,30,30
1656965361909,MATH 10A,A01,083735,Patchell; Gregory David,1,0,30,29
1656965361909,MATH 10A,A02,083736,Patchell; Gregory David,20,0,30,10
1656965361909,MATH 10A,A03,083737,Patchell; Gregory David,15,0,30,15
1656965367934,MATH 10B,A01,083207,Lim; Seonhee,7,0,34,27
1656965367934,MATH 10B,A02,083208,Lim; Seonhee,9,0,35,26
1656965367934,MATH 10B,A03,093472,Lim; Seonhee,4,0,34,30
1656965367934,MATH 10B,B01,083739,Sinha; Shubham,9,0,30,21
1656965373964,MATH 18,A01,083743,Cinel; Cameron Alexander,6,0,30,24
1656965373964,MATH 18,A02,083744,Cinel; Cameron Alexander,15,0,30,15
1656965373964,MATH 18,A03,083745,Cinel; Cameron Alexander,8,0,30,22
1656965373964,MATH 18,B01,083748,Rideout; David Porter,4,0,37,33
1656965373964,MATH 18,B02,083749,Rideout; David Porter,3,0,36,33
1656965373964,MATH 18,B03,083750,Rideout; David Porter,2,0,37,35
1656965373964,MATH 18,B04,083751,Rideout; David Porter,5,0,36,31
1656965373964,MATH 18,B05,093473,Rideout; David Porter,4,0,36,32
1656965373964,MATH 18,B06,093474,Rideout; David Porter,5,0,36,31
1656965379986,MATH 20A,A01,083754,Zheng; Zequn,12,0,40,28
1656965386012,MATH 20B,A01,083756,Briones; Jor-el Thomas Caparas,1,0,36,35
1656965386012,MATH 20B,A02,083757,Briones; Jor-el Thomas Caparas,1,0,36,35
1656965386012,MATH 20B,A03,093475,Briones; Jor-el Thomas Caparas,0,0,36,36
1656965392035,MATH 20C,A01,083760,Briones; Jor-el Thomas Caparas,1,0,35,34
1656965392035,MATH 20C,A02,083761,Briones; Jor-el Thomas Caparas,8,0,35,27
1656965392035,MATH 20C,A03,093476,Briones; Jor-el Thomas Caparas,0,1,36,36
1656965392035,MATH 20C,B01,083762,Bach; Quang Tran,0,0,30,30
1656965398058,MATH 20D,A01,083765,Tran; Brian Kha,4,0,30,26
1656965398058,MATH 20D,A02,083766,Tran; Brian Kha,4,0,30,26
1656965398058,MATH 20D,A03,083767,Tran; Brian Kha,3,0,30,27
1656965404086,MATH 20E,A01,083771,Ganguly; Soumya,5,0,32,27
1656965404086,MATH 20E,A02,083772,Ganguly; Soumya,6,0,32,26
1656965404086,MATH 20E,B01,083773,Ciotti; Benjamin,18,0,35,17
1656965404086,MATH 20E,B02,083774,Ciotti; Benjamin,17,0,35,18
1656965410120,MATH 103A,A01,083777,Greenfeld; Be'Eri,2,0,36,34
1656965410120,MATH 103A,A02,083778,Greenfeld; Be'Eri,5,0,36,31
1656965410120,MATH 103A,A03,093561,Greenfeld; Be'Eri,4,0,36,32
1656965410120,MATH 103A,B01,083779,Greenfeld; Be'Eri,6,0,36,30
1656965410120,MATH 103A,B02,083780,Greenfeld; Be'Eri,2,0,36,34
1656965410120,MATH 103A,B03,093562,Greenfeld; Be'Eri,2,0,36,34
1656965416238,MATH 105,A01,085443,Carter; Anne Toulson,14,0,35,21
1656965416238,MATH 105,A02,093477,Carter; Anne Toulson,20,0,35,15
1656965422268,MATH 109,A01,083213,Ganzberger; Geoffrey Michael,2,0,34,32
1656965422268,MATH 109,A02,083214,Ganzberger; Geoffrey Michael,2,0,34,32
1656965422268,MATH 109,A03,093478,Ganzberger; Geoffrey Michael,1,0,34,33
1656965422268,MATH 109,B01,083215,Ganzberger; Geoffrey Michael,1,0,32,31
1656965422268,MATH 109,B02,083216,Ganzberger; Geoffrey Michael,1,0,32,31
1656965422268,MATH 109,B03,093479,Ganzberger; Geoffrey Michael,6,0,32,26
1656965428298,MATH 142A,A01,083219,Chow; Bennett,6,0,32,26
1656965428298,MATH 142A,A02,083220,Chow; Bennett,10,0,32,22
1656965428298,MATH 142A,A03,093480,Chow; Bennett,7,0,32,25
1656965428298,MATH 142A,B03,093481,Chow; Bennett,7,0,32,25
1656965428298,MATH 142A,B04,093558,Chow; Bennett,11,0,32,21
1656965428298,MATH 142A,B05,093559,Chow; Bennett,6,0,32,26
1656965434322,MATH 193A,A01,083224,Rotar; Vladimir,7,0,34,27
1656965434322,MATH 193A,A02,083225,Rotar; Vladimir,4,0,34,30
1656965434322,MATH 193A,A03,083781,Rotar; Vladimir,1,0,34,33
1656965434322,MATH 193A,A04,083782,Rotar; Vladimir,6,0,34,28
1656965434322,MATH 193A,A05,093482,Rotar; Vladimir,6,0,34,28
1656965440344,MATH 197,001,091859,McAuley; Julian John,9999,0,9999,0
1656965440344,MATH 197,002,095566,Kedlaya; Kiran S.,9997,0,9999,2
1656965440344,MATH 197,003,095567,Xiao; Ming,9999,0,9999,0
1656965440344,MATH 197,004,095571,Perols; Johan Lars,9998,0,9999,1
1656965447403,COGS 9,A01,083615,Shannon; Kyle Michael,7,0,75,68
1656965453427,COGS 11,A01,083617,Boyle; Mary E. T.,20,0,48,28
1656965459456,COGS 13,A01,083071,Bastos; Amalia Pinkusfeld,9,0,71,62
1656965465482,COGS 14A,A01,092681,Semenuks; Arturs,0,1,100,100
1656965471514,COGS 14B,A01,083073,Cheng; Tzu-Han,5,0,63,58
1656965477540,COGS 17,A01,092677,Semenuks; Arturs,4,0,81,77
1656965483562,COGS 100,A01,083619,Allen; Michael Gordon,15,0,70,55
1656965489586,COGS 101A,A01,083621,Davis; Joshua Daniel,9,0,68,59
1656965495612,COGS 101B,A01,091572,Allen; Michael Gordon,8,0,65,57
1656965501635,COGS 101C,A01,083625,Delgado; Tania,17,0,35,18
1656965507661,COGS 107A,A01,083627,Boyle; Mary E. T.,13,0,60,47
1656965513684,COGS 118A,A01,083075,Gupta; Anjum,15,0,76,61
1656965519708,CSE 3,A50,083646,Miranda; Gregory Joseph,22,0,50,28
1656965525732,CSE 8A,A50,083650,Miranda; Gregory Joseph,17,1,56,39
1656965531755,CSE 11,A01,083080,Cao; Yingjun,4,15,40,36
1656965537779,CSE 12,A01,083652,Krause-Levy; Sophia Louisa,20,1,120,100
1656965543803,CSE 15L,A01,083654,Morris; Justin Loren,8,0,50,42
1656965543803,CSE 15L,A02,083655,Morris; Justin Loren,8,0,50,42
1656965549830,CSE 20,A01,083657,Tran; Khoa Dang,37,0,80,43
1656965555854,CSE 21,A01,095574,Bach; Quang Tran,21,0,48,27
1656965561876,CSE 30,A01,083084,Eldon; John,4,0,80,76
1656965561876,CSE 30,B01,095061,Bhaskar; Nishant,6,0,50,44
1656965567899,CSE 100,A01,083659,Cao; Yingjun,3,4,70,67
1656965573923,CSE 134B,A01,083661,Powell; Thomas Allan,19,0,100,81
1656965579950,CSE 140,A01,083663,Gungor; Onat,14,0,85,71
1656965585977,CSE 140L,A01,083088,Eldon; John,16,0,100,84
1656965592001,CSE 175,A01,083665,Kumar; Rakesh,3,0,25,22
1656965598035,CSE 190,A00,092507,Dubnov; Shlomo,7,0,20,13
1656965604067,ECE 45,A01,083139,Congero; Spencer William,5,0,75,70
1656965610093,ECE 65,A50,083695,Saad; Andrew S,12,0,30,18
1656965610093,ECE 65,A51,095125,Saad; Andrew S,25,0,26,1
1656965616115,ECE 109,A01,091882,Touri; Behrouz,16,0,70,54
1656965622138,ECE 180,A00,083140,Abi Samra; Nicholas Camill,0,0,30,30
1656965622138,ECE 180,B00,083141,Abi Samra; Nicholas Camill,0,0,30,30
1656965628167,MATH 10A,A01,083735,Patchell; Gregory David,1,0,30,29
1656965628167,MATH 10A,A02,083736,Patchell; Gregory David,20,0,30,10
1656965628167,MATH 10A,A03,083737,Patchell; Gregory David,15,0,30,15
1656965634197,MATH 10B,A01,083207,Lim; Seonhee,7,0,34,27
1656965634197,MATH 10B,A02,083208,Lim; Seonhee,9,0,35,26
1656965634197,MATH 10B,A03,093472,Lim; Seonhee,4,0,34,30
1656965634197,MATH 10B,B01,083739,Sinha; Shubham,9,0,30,21
1656965640220,MATH 18,A01,083743,Cinel; Cameron Alexander,6,0,30,24
1656965640220,MATH 18,A02,083744,Cinel; Cameron Alexander,15,0,30,15
1656965640220,MATH 18,A03,083745,Cinel; Cameron Alexander,8,0,30,22
1656965640220,MATH 18,B01,083748,Rideout; David Porter,4,0,37,33
1656965640220,MATH 18,B02,083749,Rideout; David Porter,3,0,36,33
1656965640220,MATH 18,B03,083750,Rideout; David Porter,2,0,37,35
1656965640220,MATH 18,B04,083751,Rideout; David Porter,5,0,36,31
1656965640220,MATH 18,B05,093473,Rideout; David Porter,4,0,36,32
1656965640220,MATH 18,B06,093474,Rideout; David Porter,5,0,36,31
1656965646244,MATH 20A,A01,083754,Zheng; Zequn,12,0,40,28
1656965652271,MATH 20B,A01,083756,Briones; Jor-el Thomas Caparas,1,0,36,35
1656965652271,MATH 20B,A02,083757,Briones; Jor-el Thomas Caparas,1,0,36,35
1656965652271,MATH 20B,A03,093475,Briones; Jor-el Thomas Caparas,0,0,36,36
1656965658296,MATH 20C,A01,083760,Briones; Jor-el Thomas Caparas,1,0,35,34
1656965658296,MATH 20C,A02,083761,Briones; Jor-el Thomas Caparas,8,0,35,27
1656965658296,MATH 20C,A03,093476,Briones; Jor-el Thomas Caparas,0,1,36,36
1656965658296,MATH 20C,B01,083762,Bach; Quang Tran,0,0,30,30
1656965664323,MATH 20D,A01,083765,Tran; Brian Kha,4,0,30,26
1656965664323,MATH 20D,A02,083766,Tran; Brian Kha,4,0,30,26
1656965664323,MATH 20D,A03,083767,Tran; Brian Kha,3,0,30,27
1656965670348,MATH 20E,A01,083771,Ganguly; Soumya,5,0,32,27
1656965670348,MATH 20E,A02,083772,Ganguly; Soumya,6,0,32,26
1656965670348,MATH 20E,B01,083773,Ciotti; Benjamin,18,0,35,17
1656965670348,MATH 20E,B02,083774,Ciotti; Benjamin,17,0,35,18
1656965676377,MATH 103A,A01,083777,Greenfeld; Be'Eri,2,0,36,34
1656965676377,MATH 103A,A02,083778,Greenfeld; Be'Eri,5,0,36,31
1656965676377,MATH 103A,A03,093561,Greenfeld; Be'Eri,4,0,36,32
1656965676377,MATH 103A,B01,083779,Greenfeld; Be'Eri,6,0,36,30
1656965676377,MATH 103A,B02,083780,Greenfeld; Be'Eri,2,0,36,34
1656965676377,MATH 103A,B03,093562,Greenfeld; Be'Eri,2,0,36,34
1656965682404,MATH 105,A01,085443,Carter; Anne Toulson,14,0,35,21
1656965682404,MATH 105,A02,093477,Carter; Anne Toulson,20,0,35,15
1656965688429,MATH 109,A01,083213,Ganzberger; Geoffrey Michael,2,0,34,32
1656965688429,MATH 109,A02,083214,Ganzberger; Geoffrey Michael,2,0,34,32
1656965688429,MATH 109,A03,093478,Ganzberger; Geoffrey Michael,1,0,34,33
1656965688429,MATH 109,B01,083215,Ganzberger; Geoffrey Michael,1,0,32,31
1656965688429,MATH 109,B02,083216,Ganzberger; Geoffrey Michael,1,0,32,31
1656965688429,MATH 109,B03,093479,Ganzberger; Geoffrey Michael,6,0,32,26
1656965694453,MATH 142A,A01,083219,Chow; Bennett,6,0,32,26
1656965694453,MATH 142A,A02,083220,Chow; Bennett,10,0,32,22
1656965694453,MATH 142A,A03,093480,Chow; Bennett,7,0,32,25
1656965694453,MATH 142A,B03,093481,Chow; Bennett,7,0,32,25
1656965694453,MATH 142A,B04,093558,Chow; Bennett,11,0,32,21
1656965694453,MATH 142A,B05,093559,Chow; Bennett,6,0,32,26
1656965700483,MATH 193A,A01,083224,Rotar; Vladimir,7,0,34,27
1656965700483,MATH 193A,A02,083225,Rotar; Vladimir,4,0,34,30
1656965700483,MATH 193A,A03,083781,Rotar; Vladimir,1,0,34,33
1656965700483,MATH 193A,A04,083782,Rotar; Vladimir,6,0,34,28
1656965700483,MATH 193A,A05,093482,Rotar; Vladimir,6,0,34,28
1656965706509,MATH 197,001,091859,McAuley; Julian John,9999,0,9999,0
1656965706509,MATH 197,002,095566,Kedlaya; Kiran S.,9997,0,9999,2
1656965706509,MATH 197,003,095567,Xiao; Ming,9999,0,9999,0
1656965706509,MATH 197,004,095571,Perols; Johan Lars,9998,0,9999,1
1656965713567,COGS 9,A01,083615,Shannon; Kyle Michael,7,0,75,68
1656965719592,COGS 11,A01,083617,Boyle; Mary E. T.,20,0,48,28
1656965725617,COGS 13,A01,083071,Bastos; Amalia Pinkusfeld,9,0,71,62
1656965731640,COGS 14A,A01,092681,Semenuks; Arturs,0,1,100,100
1656965737665,COGS 14B,A01,083073,Cheng; Tzu-Han,5,0,63,58
1656965743687,COGS 17,A01,092677,Semenuks; Arturs,4,0,81,77
1656965749708,COGS 100,A01,083619,Allen; Michael Gordon,15,0,70,55
1656965755729,COGS 101A,A01,083621,Davis; Joshua Daniel,9,0,68,59
1656965761756,COGS 101B,A01,091572,Allen; Michael Gordon,8,0,65,57
1656965767784,COGS 101C,A01,083625,Delgado; Tania,17,0,35,18
1656965773807,COGS 107A,A01,083627,Boyle; Mary E. T.,13,0,60,47
1656965779835,COGS 118A,A01,083075,Gupta; Anjum,15,0,76,61
1656965785862,CSE 3,A50,083646,Miranda; Gregory Joseph,22,0,50,28
1656965791891,CSE 8A,A50,083650,Miranda; Gregory Joseph,17,1,56,39
1656965797918,CSE 11,A01,083080,Cao; Yingjun,4,15,40,36
1656965803940,CSE 12,A01,083652,Krause-Levy; Sophia Louisa,20,1,120,100
1656965809966,CSE 15L,A01,083654,Morris; Justin Loren,8,0,50,42
1656965809966,CSE 15L,A02,083655,Morris; Justin Loren,8,0,50,42
1656965815989,CSE 20,A01,083657,Tran; Khoa Dang,37,0,80,43
1656965822015,CSE 21,A01,095574,Bach; Quang Tran,21,0,48,27
1656965828040,CSE 30,A01,083084,Eldon; John,4,0,80,76
1656965828040,CSE 30,B01,095061,Bhaskar; Nishant,6,0,50,44
1656965834066,CSE 100,A01,083659,Cao; Yingjun,3,4,70,67
1656965840088,CSE 134B,A01,083661,Powell; Thomas Allan,19,0,100,81
1656965846114,CSE 140,A01,083663,Gungor; Onat,14,0,85,71
1656965852156,CSE 140L,A01,083088,Eldon; John,16,0,100,84
1656965858179,CSE 175,A01,083665,Kumar; Rakesh,3,0,25,22
1656965864206,CSE 190,A00,092507,Dubnov; Shlomo,7,0,20,13
1656965870230,ECE 45,A01,083139,Congero; Spencer William,5,0,75,70
1656965876262,ECE 65,A50,083695,Saad; Andrew S,12,0,30,18
1656965876262,ECE 65,A51,095125,Saad; Andrew S,25,0,26,1
1656965882288,ECE 109,A01,091882,Touri; Behrouz,16,0,70,54
1656965888312,ECE 180,A00,083140,Abi Samra; Nicholas Camill,0,0,30,30
1656965888312,ECE 180,B00,083141,Abi Samra; Nicholas Camill,0,0,30,30
1656965894337,MATH 10A,A01,083735,Patchell; Gregory David,1,0,30,29
1656965894337,MATH 10A,A02,083736,Patchell; Gregory David,20,0,30,10
1656965894337,MATH 10A,A03,083737,Patchell; Gregory David,15,0,30,15
1656965900360,MATH 10B,A01,083207,Lim; Seonhee,7,0,34,27
1656965900360,MATH 10B,A02,083208,Lim; Seonhee,9,0,35,26
1656965900360,MATH 10B,A03,093472,Lim; Seonhee,4,0,34,30
1656965900360,MATH 10B,B01,083739,Sinha; Shubham,9,0,30,21
1656965906386,MATH 18,A01,083743,Cinel; Cameron Alexander,6,0,30,24
1656965906386,MATH 18,A02,083744,Cinel; Cameron Alexander,15,0,30,15
1656965906386,MATH 18,A03,083745,Cinel; Cameron Alexander,8,0,30,22
1656965906386,MATH 18,B01,083748,Rideout; David Porter,4,0,37,33
1656965906386,MATH 18,B02,083749,Rideout; David Porter,3,0,36,33
1656965906386,MATH 18,B03,083750,Rideout; David Porter,2,0,37,35
1656965906386,MATH 18,B04,083751,Rideout; David Porter,5,0,36,31
1656965906386,MATH 18,B05,093473,Rideout; David Porter,4,0,36,32
1656965906386,MATH 18,B06,093474,Rideout; David Porter,5,0,36,31
1656965912420,MATH 20A,A01,083754,Zheng; Zequn,12,0,40,28
1656965918447,MATH 20B,A01,083756,Briones; Jor-el Thomas Caparas,1,0,36,35
1656965918447,MATH 20B,A02,083757,Briones; Jor-el Thomas Caparas,1,0,36,35
1656965918447,MATH 20B,A03,093475,Briones; Jor-el Thomas Caparas,0,0,36,36
1656965924471,MATH 20C,A01,083760,Briones; Jor-el Thomas Caparas,1,0,35,34
1656965924471,MATH 20C,A02,083761,Briones; Jor-el Thomas Caparas,8,0,35,27
1656965924471,MATH 20C,A03,093476,Briones; Jor-el Thomas Caparas,0,1,36,36
1656965924471,MATH 20C,B01,083762,Bach; Quang Tran,0,0,30,30
1656965930500,MATH 20D,A01,083765,Tran; Brian Kha,4,0,30,26
1656965930500,MATH 20D,A02,083766,Tran; Brian Kha,4,0,30,26
1656965930500,MATH 20D,A03,083767,Tran; Brian Kha,3,0,30,27
1656965936562,MATH 20E,A01,083771,Ganguly; Soumya,5,0,32,27
1656965936562,MATH 20E,A02,083772,Ganguly; Soumya,6,0,32,26
1656965936562,MATH 20E,B01,083773,Ciotti; Benjamin,18,0,35,17
1656965936562,MATH 20E,B02,083774,Ciotti; Benjamin,17,0,35,18
1656965942586,MATH 103A,A01,083777,Greenfeld; Be'Eri,2,0,36,34
1656965942586,MATH 103A,A02,083778,Greenfeld; Be'Eri,5,0,36,31
1656965942586,MATH 103A,A03,093561,Greenfeld; Be'Eri,4,0,36,32
1656965942586,MATH 103A,B01,083779,Greenfeld; Be'Eri,6,0,36,30
1656965942586,MATH 103A,B02,083780,Greenfeld; Be'Eri,2,0,36,34
1656965942586,MATH 103A,B03,093562,Greenfeld; Be'Eri,2,0,36,34
1656965948610,MATH 105,A01,085443,Carter; Anne Toulson,14,0,35,21
1656965948610,MATH 105,A02,093477,Carter; Anne Toulson,20,0,35,15
1656965954634,MATH 109,A01,083213,Ganzberger; Geoffrey Michael,2,0,34,32
1656965954634,MATH 109,A02,083214,Ganzberger; Geoffrey Michael,2,0,34,32
1656965954634,MATH 109,A03,093478,Ganzberger; Geoffrey Michael,1,0,34,33
1656965954634,MATH 109,B01,083215,Ganzberger; Geoffrey Michael,1,0,32,31
1656965954634,MATH 109,B02,083216,Ganzberger; Geoffrey Michael,1,0,32,31
1656965954634,MATH 109,B03,093479,Ganzberger; Geoffrey Michael,6,0,32,26
1656965960663,MATH 142A,A01,083219,Chow; Bennett,6,0,32,26
1656965960663,MATH 142A,A02,083220,Chow; Bennett,10,0,32,22
1656965960663,MATH 142A,A03,093480,Chow; Bennett,7,0,32,25
1656965960663,MATH 142A,B03,093481,Chow; Bennett,7,0,32,25
1656965960663,MATH 142A,B04,093558,Chow; Bennett,11,0,32,21
1656965960663,MATH 142A,B05,093559,Chow; Bennett,6,0,32,26
1656965966689,MATH 193A,A01,083224,Rotar; Vladimir,7,0,34,27
1656965966689,MATH 193A,A02,083225,Rotar; Vladimir,4,0,34,30
1656965966689,MATH 193A,A03,083781,Rotar; Vladimir,1,0,34,33
1656965966689,MATH 193A,A04,083782,Rotar; Vladimir,6,0,34,28
1656965966689,MATH 193A,A05,093482,Rotar; Vladimir,6,0,34,28
1656965972712,MATH 197,001,091859,McAuley; Julian John,9999,0,9999,0
1656965972712,MATH 197,002,095566,Kedlaya; Kiran S.,9997,0,9999,2
1656965972712,MATH 197,003,095567,Xiao; Ming,9999,0,9999,0
1656965972712,MATH 197,004,095571,Perols; Johan Lars,9998,0,9999,1
1656965979780,COGS 9,A01,083615,Shannon; Kyle Michael,7,0,75,68
1656965985805,COGS 11,A01,083617,Boyle; Mary E. T.,20,0,48,28
1656965991828,COGS 13,A01,083071,Bastos; Amalia Pinkusfeld,9,0,71,62
1656965997851,COGS 14A,A01,092681,Semenuks; Arturs,0,1,100,100
1656966003877,COGS 14B,A01,083073,Cheng; Tzu-Han,5,0,63,58
1656966009982,COGS 17,A01,092677,Semenuks; Arturs,4,0,81,77
1656966016005,COGS 100,A01,083619,Allen; Michael Gordon,15,0,70,55
1656966022027,COGS 101A,A01,083621,Davis; Joshua Daniel,9,0,68,59
1656966028055,COGS 101B,A01,091572,Allen; Michael Gordon,8,0,65,57
1656966034076,COGS 101C,A01,083625,Delgado; Tania,17,0,35,18
1656966040102,COGS 107A,A01,083627,Boyle; Mary E. T.,13,0,60,47
1656966046126,COGS 118A,A01,083075,Gupta; Anjum,15,0,76,61
1656966052152,CSE 3,A50,083646,Miranda; Gregory Joseph,22,0,50,28
1656966058179,CSE 8A,A50,083650,Miranda; Gregory Joseph,17,1,56,39
1656966064202,CSE 11,A01,083080,Cao; Yingjun,4,15,40,36
1656966070228,CSE 12,A01,083652,Krause-Levy; Sophia Louisa,20,1,120,100
1656966076250,CSE 15L,A01,083654,Morris; Justin Loren,8,0,50,42
1656966076250,CSE 15L,A02,083655,Morris; Justin Loren,8,0,50,42
1656966082274,CSE 20,A01,083657,Tran; Khoa Dang,37,0,80,43
1656966088301,CSE 21,A01,095574,Bach; Quang Tran,21,0,48,27
1656966094329,CSE 30,A01,083084,Eldon; John,4,0,80,76
1656966094329,CSE 30,B01,095061,Bhaskar; Nishant,6,0,50,44
1656966100351,CSE 100,A01,083659,Cao; Yingjun,3,4,70,67
1656966106377,CSE 134B,A01,083661,Powell; Thomas Allan,19,0,100,81
1656966112401,CSE 140,A01,083663,Gungor; Onat,14,0,85,71
1656966118425,CSE 140L,A01,083088,Eldon; John,16,0,100,84
1656966124447,CSE 175,A01,083665,Kumar; Rakesh,3,0,25,22
1656966130474,CSE 190,A00,092507,Dubnov; Shlomo,7,0,20,13
1656966136501,ECE 45,A01,083139,Congero; Spencer William,5,0,75,70
1656966142535,ECE 65,A50,083695,Saad; Andrew S,12,0,30,18
1656966142535,ECE 65,A51,095125,Saad; Andrew S,25,0,26,1
1656966148565,ECE 109,A01,091882,Touri; Behrouz,16,0,70,54
1656966154588,ECE 180,A00,083140,Abi Samra; Nicholas Camill,0,0,30,30
1656966154588,ECE 180,B00,083141,Abi Samra; Nicholas Camill,0,0,30,30
1656966160617,MATH 10A,A01,083735,Patchell; Gregory David,1,0,30,29
1656966160617,MATH 10A,A02,083736,Patchell; Gregory David,20,0,30,10
1656966160617,MATH 10A,A03,083737,Patchell; Gregory David,15,0,30,15
1656966166644,MATH 10B,A01,083207,Lim; Seonhee,7,0,34,27
1656966166644,MATH 10B,A02,083208,Lim; Seonhee,9,0,35,26
1656966166644,MATH 10B,A03,093472,Lim; Seonhee,4,0,34,30
1656966166644,MATH 10B,B01,083739,Sinha; Shubham,9,0,30,21
1656966172675,MATH 18,A01,083743,Cinel; Cameron Alexander,6,0,30,24
1656966172675,MATH 18,A02,083744,Cinel; Cameron Alexander,15,0,30,15
1656966172675,MATH 18,A03,083745,Cinel; Cameron Alexander,8,0,30,22
1656966172675,MATH 18,B01,083748,Rideout; David Porter,4,0,37,33
1656966172675,MATH 18,B02,083749,Rideout; David Porter,3,0,36,33
1656966172675,MATH 18,B03,083750,Rideout; David Porter,2,0,37,35
1656966172675,MATH 18,B04,083751,Rideout; David Porter,5,0,36,31
1656966172675,MATH 18,B05,093473,Rideout; David Porter,4,0,36,32
1656966172675,MATH 18,B06,093474,Rideout; David Porter,5,0,36,31
1656966178702,MATH 20A,A01,083754,Zheng; Zequn,12,0,40,28
1656966184728,MATH 20B,A01,083756,Briones; Jor-el Thomas Caparas,1,0,36,35
1656966184728,MATH 20B,A02,083757,Briones; Jor-el Thomas Caparas,1,0,36,35
1656966184728,MATH 20B,A03,093475,Briones; Jor-el Thomas Caparas,0,0,36,36
1656966190757,MATH 20C,A01,083760,Briones; Jor-el Thomas Caparas,1,0,35,34
1656966190757,MATH 20C,A02,083761,Briones; Jor-el Thomas Caparas,8,0,35,27
1656966190757,MATH 20C,A03,093476,Briones; Jor-el Thomas Caparas,0,1,36,36
1656966190757,MATH 20C,B01,083762,Bach; Quang Tran,0,0,30,30
1656966196779,MATH 20D,A01,083765,Tran; Brian Kha,4,0,30,26
1656966196779,MATH 20D,A02,083766,Tran; Brian Kha,4,0,30,26
1656966196779,MATH 20D,A03,083767,Tran; Brian Kha,3,0,30,27
1656966202802,MATH 20E,A01,083771,Ganguly; Soumya,5,0,32,27
1656966202802,MATH 20E,A02,083772,Ganguly; Soumya,6,0,32,26
1656966202802,MATH 20E,B01,083773,Ciotti; Benjamin,18,0,35,17
1656966202802,MATH 20E,B02,083774,Ciotti; Benjamin,17,0,35,18
1656966208830,MATH 103A,A01,083777,Greenfeld; Be'Eri,2,0,36,34
1656966208830,MATH 103A,A02,083778,Greenfeld; Be'Eri,5,0,36,31
1656966208830,MATH 103A,A03,093561,Greenfeld; Be'Eri,4,0,36,32
1656966208830,MATH 103A,B01,083779,Greenfeld; Be'Eri,6,0,36,30
1656966208830,MATH 103A,B02,083780,Greenfeld; Be'Eri,2,0,36,34
1656966208830,MATH 103A,B03,093562,Greenfeld; Be'Eri,2,0,36,34
1656966214857,MATH 105,A01,085443,Carter; Anne Toulson,14,0,35,21
1656966214857,MATH 105,A02,093477,Carter; Anne Toulson,20,0,35,15
1656966220880,MATH 109,A01,083213,Ganzberger; Geoffrey Michael,2,0,34,32
1656966220880,MATH 109,A02,083214,Ganzberger; Geoffrey Michael,2,0,34,32
1656966220880,MATH 109,A03,093478,Ganzberger; Geoffrey Michael,1,0,34,33
1656966220880,MATH 109,B01,083215,Ganzberger; Geoffrey Michael,1,0,32,31
1656966220880,MATH 109,B02,083216,Ganzberger; Geoffrey Michael,1,0,32,31
1656966220880,MATH 109,B03,093479,Ganzberger; Geoffrey Michael,6,0,32,26
1656966226904,MATH 142A,A01,083219,Chow; Bennett,6,0,32,26
1656966226904,MATH 142A,A02,083220,Chow; Bennett,10,0,32,22
1656966226904,MATH 142A,A03,093480,Chow; Bennett,7,0,32,25
1656966226904,MATH 142A,B03,093481,Chow; Bennett,7,0,32,25
1656966226904,MATH 142A,B04,093558,Chow; Bennett,11,0,32,21
1656966226904,MATH 142A,B05,093559,Chow; Bennett,6,0,32,26
1656966232928,MATH 193A,A01,083224,Rotar; Vladimir,7,0,34,27
1656966232928,MATH 193A,A02,083225,Rotar; Vladimir,4,0,34,30
1656966232928,MATH 193A,A03,083781,Rotar; Vladimir,1,0,34,33
1656966232928,MATH 193A,A04,083782,Rotar; Vladimir,6,0,34,28
1656966232928,MATH 193A,A05,093482,Rotar; Vladimir,6,0,34,28
1656966238954,MATH 197,001,091859,McAuley; Julian John,9999,0,9999,0
1656966238954,MATH 197,002,095566,Kedlaya; Kiran S.,9997,0,9999,2
1656966238954,MATH 197,003,095567,Xiao; Ming,9999,0,9999,0
1656966238954,MATH 197,004,095571,Perols; Johan Lars,9998,0,9999,1
1656966246005,COGS 9,A01,083615,Shannon; Kyle Michael,7,0,75,68
1656966252028,COGS 11,A01,083617,Boyle; Mary E. T.,20,0,48,28
1656966258054,COGS 13,A01,083071,Bastos; Amalia Pinkusfeld,9,0,71,62
1656966264078,COGS 14A,A01,092681,Semenuks; Arturs,0,1,100,100
1656966270102,COGS 14B,A01,083073,Cheng; Tzu-Han,5,0,63,58
1656966276130,COGS 17,A01,092677,Semenuks; Arturs,4,0,81,77
1656966282156,COGS 100,A01,083619,Allen; Michael Gordon,15,0,70,55
1656966288181,COGS 101A,A01,083621,Davis; Joshua Daniel,9,0,68,59
1656966294204,COGS 101B,A01,091572,Allen; Michael Gordon,8,0,65,57
1656966300227,COGS 101C,A01,083625,Delgado; Tania,17,0,35,18
1656966306251,COGS 107A,A01,083627,Boyle; Mary E. T.,13,0,60,47
1656966312279,COGS 118A,A01,083075,Gupta; Anjum,15,0,76,61
1656966318302,CSE 3,A50,083646,Miranda; Gregory Joseph,22,0,50,28
1656966324325,CSE 8A,A50,083650,Miranda; Gregory Joseph,17,1,56,39
1656966330348,CSE 11,A01,083080,Cao; Yingjun,4,15,40,36
1656966336374,CSE 12,A01,083652,Krause-Levy; Sophia Louisa,20,1,120,100
1656966342401,CSE 15L,A01,083654,Morris; Justin Loren,8,0,50,42
1656966342401,CSE 15L,A02,083655,Morris; Justin Loren,8,0,50,42
1656966348424,CSE 20,A01,083657,Tran; Khoa Dang,37,0,80,43
1656966354451,CSE 21,A01,095574,Bach; Quang Tran,21,0,48,27
1656966360480,CSE 30,A01,083084,Eldon; John,4,0,80,76
1656966360480,CSE 30,B01,095061,Bhaskar; Nishant,6,0,50,44
1656966366506,CSE 100,A01,083659,Cao; Yingjun,3,4,70,67
1656966372531,CSE 134B,A01,083661,Powell; Thomas Allan,19,0,100,81
1656966378555,CSE 140,A01,083663,Gungor; Onat,14,0,85,71
1656966384582,CSE 140L,A01,083088,Eldon; John,16,0,100,84
1656966390605,CSE 175,A01,083665,Kumar; Rakesh,3,0,25,22
1656966396635,CSE 190,A00,092507,Dubnov; Shlomo,7,0,20,13
1656966402659,ECE 45,A01,083139,Congero; Spencer William,5,0,75,70
1656966408683,ECE 65,A50,083695,Saad; Andrew S,12,0,30,18
1656966408683,ECE 65,A51,095125,Saad; Andrew S,25,0,26,1
1656966414706,ECE 109,A01,091882,Touri; Behrouz,16,0,70,54
1656966420733,ECE 180,A00,083140,Abi Samra; Nicholas Camill,0,0,30,30
1656966420733,ECE 180,B00,083141,Abi Samra; Nicholas Camill,0,0,30,30
1656966426757,MATH 10A,A01,083735,Patchell; Gregory David,1,0,30,29
1656966426757,MATH 10A,A02,083736,Patchell; Gregory David,20,0,30,10
1656966426757,MATH 10A,A03,083737,Patchell; Gregory David,15,0,30,15
1656966432781,MATH 10B,A01,083207,Lim; Seonhee,7,0,34,27
1656966432781,MATH 10B,A02,083208,Lim; Seonhee,9,0,35,26
1656966432781,MATH 10B,A03,093472,Lim; Seonhee,4,0,34,30
1656966432781,MATH 10B,B01,083739,Sinha; Shubham,9,0,30,21
1656966438806,MATH 18,A01,083743,Cinel; Cameron Alexander,6,0,30,24
1656966438806,MATH 18,A02,083744,Cinel; Cameron Alexander,15,0,30,15
1656966438806,MATH 18,A03,083745,Cinel; Cameron Alexander,8,0,30,22
1656966438806,MATH 18,B01,083748,Rideout; David Porter,4,0,37,33
1656966438806,MATH 18,B02,083749,Rideout; David Porter,3,0,36,33
1656966438806,MATH 18,B03,083750,Rideout; David Porter,2,0,37,35
1656966438806,MATH 18,B04,083751,Rideout; David Porter,5,0,36,31
1656966438806,MATH 18,B05,093473,Rideout; David Porter,4,0,36,32
1656966438806,MATH 18,B06,093474,Rideout; David Porter,5,0,36,31
1656966444829,MATH 20A,A01,083754,Zheng; Zequn,12,0,40,28
1656966450853,MATH 20B,A01,083756,Briones; Jor-el Thomas Caparas,1,0,36,35
1656966450853,MATH 20B,A02,083757,Briones; Jor-el Thomas Caparas,1,0,36,35
1656966450853,MATH 20B,A03,093475,Briones; Jor-el Thomas Caparas,0,0,36,36
1656966456883,MATH 20C,A01,083760,Briones; Jor-el Thomas Caparas,1,0,35,34
1656966456883,MATH 20C,A02,083761,Briones; Jor-el Thomas Caparas,8,0,35,27
1656966456883,MATH 20C,A03,093476,Briones; Jor-el Thomas Caparas,0,1,36,36
1656966456883,MATH 20C,B01,083762,Bach; Quang Tran,0,0,30,30
1656966462907,MATH 20D,A01,083765,Tran; Brian Kha,4,0,30,26
1656966462907,MATH 20D,A02,083766,Tran; Brian Kha,4,0,30,26
1656966462907,MATH 20D,A03,083767,Tran; Brian Kha,3,0,30,27
1656966468931,MATH 20E,A01,083771,Ganguly; Soumya,5,0,32,27
1656966468931,MATH 20E,A02,083772,Ganguly; Soumya,6,0,32,26
1656966468931,MATH 20E,B01,083773,Ciotti; Benjamin,18,0,35,17
1656966468931,MATH 20E,B02,083774,Ciotti; Benjamin,17,0,35,18
1656966474954,MATH 103A,A01,083777,Greenfeld; Be'Eri,2,0,36,34
1656966474954,MATH 103A,A02,083778,Greenfeld; Be'Eri,5,0,36,31
1656966474954,MATH 103A,A03,093561,Greenfeld; Be'Eri,4,0,36,32
1656966474954,MATH 103A,B01,083779,Greenfeld; Be'Eri,6,0,36,30
1656966474954,MATH 103A,B02,083780,Greenfeld; Be'Eri,2,0,36,34
1656966474954,MATH 103A,B03,093562,Greenfeld; Be'Eri,2,0,36,34
1656966480980,MATH 105,A01,085443,Carter; Anne Toulson,14,0,35,21
1656966480980,MATH 105,A02,093477,Carter; Anne Toulson,20,0,35,15
1656966487007,MATH 109,A01,083213,Ganzberger; Geoffrey Michael,2,0,34,32
1656966487007,MATH 109,A02,083214,Ganzberger; Geoffrey Michael,2,0,34,32
1656966487007,MATH 109,A03,093478,Ganzberger; Geoffrey Michael,1,0,34,33
1656966487007,MATH 109,B01,083215,Ganzberger; Geoffrey Michael,1,0,32,31
1656966487007,MATH 109,B02,083216,Ganzberger; Geoffrey Michael,1,0,32,31
1656966487007,MATH 109,B03,093479,Ganzberger; Geoffrey Michael,6,0,32,26
1656966493039,MATH 142A,A01,083219,Chow; Bennett,6,0,32,26
1656966493039,MATH 142A,A02,083220,Chow; Bennett,10,0,32,22
1656966493039,MATH 142A,A03,093480,Chow; Bennett,7,0,32,25
1656966493039,MATH 142A,B03,093481,Chow; Bennett,7,0,32,25
1656966493039,MATH 142A,B04,093558,Chow; Bennett,11,0,32,21
1656966493039,MATH 142A,B05,093559,Chow; Bennett,6,0,32,26
1656966499065,MATH 193A,A01,083224,Rotar; Vladimir,7,0,34,27
1656966499065,MATH 193A,A02,083225,Rotar; Vladimir,4,0,34,30
1656966499065,MATH 193A,A03,083781,Rotar; Vladimir,1,0,34,33
1656966499065,MATH 193A,A04,083782,Rotar; Vladimir,6,0,34,28
1656966499065,MATH 193A,A05,093482,Rotar; Vladimir,6,0,34,28
1656966505092,MATH 197,001,091859,McAuley; Julian John,9999,0,9999,0
1656966505092,MATH 197,002,095566,Kedlaya; Kiran S.,9997,0,9999,2
1656966505092,MATH 197,003,095567,Xiao; Ming,9999,0,9999,0
1656966505092,MATH 197,004,095571,Perols; Johan Lars,9998,0,9999,1
1656966512152,COGS 9,A01,083615,Shannon; Kyle Michael,7,0,75,68
1656966518178,COGS 11,A01,083617,Boyle; Mary E. T.,20,0,48,28
1656966524204,COGS 13,A01,083071,Bastos; Amalia Pinkusfeld,9,0,71,62
1656966530231,COGS 14A,A01,092681,Semenuks; Arturs,0,1,100,100
1656966536254,COGS 14B,A01,083073,Cheng; Tzu-Han,5,0,63,58
1656966542278,COGS 17,A01,092677,Semenuks; Arturs,4,0,81,77
1656966548301,COGS 100,A01,083619,Allen; Michael Gordon,15,0,70,55
1656966554323,COGS 101A,A01,083621,Davis; Joshua Daniel,9,0,68,59
1656966560349,COGS 101B,A01,091572,Allen; Michael Gordon,8,0,65,57
1656966566370,COGS 101C,A01,083625,Delgado; Tania,17,0,35,18
1656966572394,COGS 107A,A01,083627,Boyle; Mary E. T.,13,0,60,47
1656966578420,COGS 118A,A01,083075,Gupta; Anjum,15,0,76,61
1656966584443,CSE 3,A50,083646,Miranda; Gregory Joseph,22,0,50,28
1656966590470,CSE 8A,A50,083650,Miranda; Gregory Joseph,17,1,56,39
1656966596494,CSE 11,A01,083080,Cao; Yingjun,4,15,40,36
1656966602570,CSE 12,A01,083652,Krause-Levy; Sophia Louisa,20,1,120,100
1656966608669,CSE 15L,A01,083654,Morris; Justin Loren,8,0,50,42
1656966608669,CSE 15L,A02,083655,Morris; Justin Loren,8,0,50,42
1656966614691,CSE 20,A01,083657,Tran; Khoa Dang,37,0,80,43
1656966620716,CSE 21,A01,095574,Bach; Quang Tran,21,0,48,27
1656966626739,CSE 30,A01,083084,Eldon; John,4,0,80,76
1656966626739,CSE 30,B01,095061,Bhaskar; Nishant,6,0,50,44
1656966632763,CSE 100,A01,083659,Cao; Yingjun,3,4,70,67
1656966638783,CSE 134B,A01,083661,Powell; Thomas Allan,19,0,100,81
1656966644808,CSE 140,A01,083663,Gungor; Onat,14,0,85,71
1656966650847,CSE 140L,A01,083088,Eldon; John,16,0,100,84
1656966656871,CSE 175,A01,083665,Kumar; Rakesh,3,0,25,22
1656966662896,CSE 190,A00,092507,Dubnov; Shlomo,7,0,20,13
1656966668919,ECE 45,A01,083139,Congero; Spencer William,5,0,75,70
1656966674946,ECE 65,A50,083695,Saad; Andrew S,12,0,30,18
1656966674946,ECE 65,A51,095125,Saad; Andrew S,25,0,26,1
1656966680974,ECE 109,A01,091882,Touri; Behrouz,16,0,70,54
1656966687006,ECE 180,A00,083140,Abi Samra; Nicholas Camill,0,0,30,30
1656966687006,ECE 180,B00,083141,Abi Samra; Nicholas Camill,0,0,30,30
1656966693034,MATH 10A,A01,083735,Patchell; Gregory David,1,0,30,29
1656966693034,MATH 10A,A02,083736,Patchell; Gregory David,20,0,30,10
1656966693034,MATH 10A,A03,083737,Patchell; Gregory David,15,0,30,15
1656966699057,MATH 10B,A01,083207,Lim; Seonhee,7,0,34,27
1656966699057,MATH 10B,A02,083208,Lim; Seonhee,9,0,35,26
1656966699057,MATH 10B,A03,093472,Lim; Seonhee,4,0,34,30
1656966699057,MATH 10B,B01,083739,Sinha; Shubham,9,0,30,21
1656966705087,MATH 18,A01,083743,Cinel; Cameron Alexander,6,0,30,24
1656966705087,MATH 18,A02,083744,Cinel; Cameron Alexander,15,0,30,15
1656966705087,MATH 18,A03,083745,Cinel; Cameron Alexander,8,0,30,22
1656966705087,MATH 18,B01,083748,Rideout; David Porter,4,0,37,33
1656966705087,MATH 18,B02,083749,Rideout; David Porter,3,0,36,33
1656966705087,MATH 18,B03,083750,Rideout; David Porter,2,0,37,35
1656966705087,MATH 18,B04,083751,Rideout; David Porter,5,0,36,31
1656966705087,MATH 18,B05,093473,Rideout; David Porter,4,0,36,32
1656966705087,MATH 18,B06,093474,Rideout; David Porter,5,0,36,31
1656966711112,MATH 20A,A01,083754,Zheng; Zequn,12,0,40,28
1656966717135,MATH 20B,A01,083756,Briones; Jor-el Thomas Caparas,1,0,36,35
1656966717135,MATH 20B,A02,083757,Briones; Jor-el Thomas Caparas,1,0,36,35
1656966717135,MATH 20B,A03,093475,Briones; Jor-el Thomas Caparas,0,0,36,36
1656966723166,MATH 20C,A01,083760,Briones; Jor-el Thomas Caparas,1,0,35,34
1656966723166,MATH 20C,A02,083761,Briones; Jor-el Thomas Caparas,8,0,35,27
1656966723166,MATH 20C,A03,093476,Briones; Jor-el Thomas Caparas,0,1,36,36
1656966723166,MATH 20C,B01,083762,Bach; Quang Tran,0,0,30,30
1656966729189,MATH 20D,A01,083765,Tran; Brian Kha,4,0,30,26
1656966729189,MATH 20D,A02,083766,Tran; Brian Kha,4,0,30,26
1656966729189,MATH 20D,A03,083767,Tran; Brian Kha,3,0,30,27
1656966735215,MATH 20E,A01,083771,Ganguly; Soumya,5,0,32,27
1656966735215,MATH 20E,A02,083772,Ganguly; Soumya,6,0,32,26
1656966735215,MATH 20E,B01,083773,Ciotti; Benjamin,18,0,35,17
1656966735215,MATH 20E,B02,083774,Ciotti; Benjamin,17,0,35,18
1656966741243,MATH 103A,A01,083777,Greenfeld; Be'Eri,2,0,36,34
1656966741243,MATH 103A,A02,083778,Greenfeld; Be'Eri,5,0,36,31
1656966741243,MATH 103A,A03,093561,Greenfeld; Be'Eri,4,0,36,32
1656966741243,MATH 103A,B01,083779,Greenfeld; Be'Eri,6,0,36,30
1656966741243,MATH 103A,B02,083780,Greenfeld; Be'Eri,2,0,36,34
1656966741243,MATH 103A,B03,093562,Greenfeld; Be'Eri,2,0,36,34
1656966747264,MATH 105,A01,085443,Carter; Anne Toulson,14,0,35,21
1656966747264,MATH 105,A02,093477,Carter; Anne Toulson,20,0,35,15
1656966753290,MATH 109,A01,083213,Ganzberger; Geoffrey Michael,2,0,34,32
1656966753290,MATH 109,A02,083214,Ganzberger; Geoffrey Michael,2,0,34,32
1656966753290,MATH 109,A03,093478,Ganzberger; Geoffrey Michael,1,0,34,33
1656966753290,MATH 109,B01,083215,Ganzberger; Geoffrey Michael,1,0,32,31
1656966753290,MATH 109,B02,083216,Ganzberger; Geoffrey Michael,1,0,32,31
1656966753290,MATH 109,B03,093479,Ganzberger; Geoffrey Michael,6,0,32,26
1656966759314,MATH 142A,A01,083219,Chow; Bennett,6,0,32,26
1656966759314,MATH 142A,A02,083220,Chow; Bennett,10,0,32,22
1656966759314,MATH 142A,A03,093480,Chow; Bennett,7,0,32,25
1656966759314,MATH 142A,B03,093481,Chow; Bennett,7,0,32,25
1656966759314,MATH 142A,B04,093558,Chow; Bennett,11,0,32,21
1656966759314,MATH 142A,B05,093559,Chow; Bennett,6,0,32,26
1656966765353,MATH 193A,A01,083224,Rotar; Vladimir,7,0,34,27
1656966765353,MATH 193A,A02,083225,Rotar; Vladimir,4,0,34,30
1656966765353,MATH 193A,A03,083781,Rotar; Vladimir,1,0,34,33
1656966765353,MATH 193A,A04,083782,Rotar; Vladimir,6,0,34,28
1656966765353,MATH 193A,A05,093482,Rotar; Vladimir,6,0,34,28
1656966771378,MATH 197,001,091859,McAuley; Julian John,9999,0,9999,0
1656966771378,MATH 197,002,095566,Kedlaya; Kiran S.,9997,0,9999,2
1656966771378,MATH 197,003,095567,Xiao; Ming,9999,0,9999,0
1656966771378,MATH 197,004,095571,Perols; Johan Lars,9998,0,9999,1
1656966778432,COGS 9,A01,083615,Shannon; Kyle Michael,7,0,75,68
1656966784460,COGS 11,A01,083617,Boyle; Mary E. T.,20,0,48,28
1656966790481,COGS 13,A01,083071,Bastos; Amalia Pinkusfeld,9,0,71,62
1656966796503,COGS 14A,A01,092681,Semenuks; Arturs,0,1,100,100
1656966802524,COGS 14B,A01,083073,Cheng; Tzu-Han,5,0,63,58
1656966808550,COGS 17,A01,092677,Semenuks; Arturs,4,0,81,77
1656966814572,COGS 100,A01,083619,Allen; Michael Gordon,15,0,70,55
1656966820596,COGS 101A,A01,083621,Davis; Joshua Daniel,9,0,68,59
1656966826618,COGS 101B,A01,091572,Allen; Michael Gordon,8,0,65,57
1656966832641,COGS 101C,A01,083625,Delgado; Tania,17,0,35,18
1656966838662,COGS 107A,A01,083627,Boyle; Mary E. T.,13,0,60,47
1656966844685,COGS 118A,A01,083075,Gupta; Anjum,15,0,76,61
1656966850706,CSE 3,A50,083646,Miranda; Gregory Joseph,22,0,50,28
1656966856728,CSE 8A,A50,083650,Miranda; Gregory Joseph,17,1,56,39
1656966862754,CSE 11,A01,083080,Cao; Yingjun,4,15,40,36
1656966868779,CSE 12,A01,083652,Krause-Levy; Sophia Louisa,20,1,120,100
1656966874804,CSE 15L,A01,083654,Morris; Justin Loren,8,0,50,42
1656966874804,CSE 15L,A02,083655,Morris; Justin Loren,8,0,50,42
1656966880825,CSE 20,A01,083657,Tran; Khoa Dang,37,0,80,43
1656966886847,CSE 21,A01,095574,Bach; Quang Tran,21,0,48,27
1656966892879,CSE 30,A01,083084,Eldon; John,4,0,80,76
1656966892879,CSE 30,B01,095061,Bhaskar; Nishant,6,0,50,44
1656966898903,CSE 100,A01,083659,Cao; Yingjun,3,4,70,67
1656966904924,CSE 134B,A01,083661,Powell; Thomas Allan,19,0,100,81
1656966910950,CSE 140,A01,083663,Gungor; Onat,14,0,85,71
1656966916973,CSE 140L,A01,083088,Eldon; John,16,0,100,84
1656966922996,CSE 175,A01,083665,Kumar; Rakesh,3,0,25,22
1656966929021,CSE 190,A00,092507,Dubnov; Shlomo,7,0,20,13
1656966935045,ECE 45,A01,083139,Congero; Spencer William,5,0,75,70
1656966941069,ECE 65,A50,083695,Saad; Andrew S,12,0,30,18
1656966941069,ECE 65,A51,095125,Saad; Andrew S,25,0,26,1
1656966947092,ECE 109,A01,091882,Touri; Behrouz,16,0,70,54
1656966953118,ECE 180,A00,083140,Abi Samra; Nicholas Camill,0,0,30,30
1656966953118,ECE 180,B00,083141,Abi Samra; Nicholas Camill,0,0,30,30
1656966959141,MATH 10A,A01,083735,Patchell; Gregory David,1,0,30,29
1656966959141,MATH 10A,A02,083736,Patchell; Gregory David,20,0,30,10
1656966959141,MATH 10A,A03,083737,Patchell; Gregory David,15,0,30,15
1656966965171,MATH 10B,A01,083207,Lim; Seonhee,7,0,34,27
1656966965171,MATH 10B,A02,083208,Lim; Seonhee,9,0,35,26
1656966965171,MATH 10B,A03,093472,Lim; Seonhee,4,0,34,30
1656966965171,MATH 10B,B01,083739,Sinha; Shubham,9,0,30,21
1656966971196,MATH 18,A01,083743,Cinel; Cameron Alexander,6,0,30,24
1656966971196,MATH 18,A02,083744,Cinel; Cameron Alexander,15,0,30,15
1656966971196,MATH 18,A03,083745,Cinel; Cameron Alexander,8,0,30,22
1656966971196,MATH 18,B01,083748,Rideout; David Porter,4,0,37,33
1656966971196,MATH 18,B02,083749,Rideout; David Porter,3,0,36,33
1656966971196,MATH 18,B03,083750,Rideout; David Porter,2,0,37,35
1656966971196,MATH 18,B04,083751,Rideout; David Porter,5,0,36,31
1656966971196,MATH 18,B05,093473,Rideout; David Porter,4,0,36,32
1656966971196,MATH 18,B06,093474,Rideout; David Porter,5,0,36,31
1656966977220,MATH 20A,A01,083754,Zheng; Zequn,12,0,40,28
1656966983244,MATH 20B,A01,083756,Briones; Jor-el Thomas Caparas,1,0,36,35
1656966983244,MATH 20B,A02,083757,Briones; Jor-el Thomas Caparas,1,0,36,35
1656966983244,MATH 20B,A03,093475,Briones; Jor-el Thomas Caparas,0,0,36,36
1656966989265,MATH 20C,A01,083760,Briones; Jor-el Thomas Caparas,1,0,35,34
1656966989265,MATH 20C,A02,083761,Briones; Jor-el Thomas Caparas,8,0,35,27
1656966989265,MATH 20C,A03,093476,Briones; Jor-el Thomas Caparas,0,1,36,36
1656966989265,MATH 20C,B01,083762,Bach; Quang Tran,0,0,30,30
1656966995290,MATH 20D,A01,083765,Tran; Brian Kha,4,0,30,26
1656966995290,MATH 20D,A02,083766,Tran; Brian Kha,4,0,30,26
1656966995290,MATH 20D,A03,083767,Tran; Brian Kha,3,0,30,27
1656967001312,MATH 20E,A01,083771,Ganguly; Soumya,5,0,32,27
1656967001312,MATH 20E,A02,083772,Ganguly; Soumya,6,0,32,26
1656967001312,MATH 20E,B01,083773,Ciotti; Benjamin,18,0,35,17
1656967001312,MATH 20E,B02,083774,Ciotti; Benjamin,17,0,35,18
1656967007341,MATH 103A,A01,083777,Greenfeld; Be'Eri,2,0,36,34
1656967007341,MATH 103A,A02,083778,Greenfeld; Be'Eri,5,0,36,31
1656967007341,MATH 103A,A03,093561,Greenfeld; Be'Eri,4,0,36,32
1656967007341,MATH 103A,B01,083779,Greenfeld; Be'Eri,6,0,36,30
1656967007341,MATH 103A,B02,083780,Greenfeld; Be'Eri,2,0,36,34
1656967007341,MATH 103A,B03,093562,Greenfeld; Be'Eri,2,0,36,34
1656967013364,MATH 105,A01,085443,Carter; Anne Toulson,14,0,35,21
1656967013364,MATH 105,A02,093477,Carter; Anne Toulson,20,0,35,15
1656967019387,MATH 109,A01,083213,Ganzberger; Geoffrey Michael,2,0,34,32
1656967019387,MATH 109,A02,083214,Ganzberger; Geoffrey Michael,2,0,34,32
1656967019387,MATH 109,A03,093478,Ganzberger; Geoffrey Michael,1,0,34,33
1656967019387,MATH 109,B01,083215,Ganzberger; Geoffrey Michael,1,0,32,31
1656967019387,MATH 109,B02,083216,Ganzberger; Geoffrey Michael,1,0,32,31
1656967019387,MATH 109,B03,093479,Ganzberger; Geoffrey Michael,6,0,32,26
1656967025410,MATH 142A,A01,083219,Chow; Bennett,6,0,32,26
1656967025410,MATH 142A,A02,083220,Chow; Bennett,10,0,32,22
1656967025410,MATH 142A,A03,093480,Chow; Bennett,7,0,32,25
1656967025410,MATH 142A,B03,093481,Chow; Bennett,7,0,32,25
1656967025410,MATH 142A,B04,093558,Chow; Bennett,11,0,32,21
1656967025410,MATH 142A,B05,093559,Chow; Bennett,6,0,32,26
1656967031433,MATH 193A,A01,083224,Rotar; Vladimir,7,0,34,27
1656967031433,MATH 193A,A02,083225,Rotar; Vladimir,4,0,34,30
1656967031433,MATH 193A,A03,083781,Rotar; Vladimir,1,0,34,33
1656967031433,MATH 193A,A04,083782,Rotar; Vladimir,6,0,34,28
1656967031433,MATH 193A,A05,093482,Rotar; Vladimir,6,0,34,28
1656967037456,MATH 197,001,091859,McAuley; Julian John,9999,0,9999,0
1656967037456,MATH 197,002,095566,Kedlaya; Kiran S.,9997,0,9999,2
1656967037456,MATH 197,003,095567,Xiao; Ming,9999,0,9999,0
1656967037456,MATH 197,004,095571,Perols; Johan Lars,9998,0,9999,1
1656967044516,COGS 9,A01,083615,Shannon; Kyle Michael,7,0,75,68
1656967050542,COGS 11,A01,083617,Boyle; Mary E. T.,20,0,48,28
1656967056565,COGS 13,A01,083071,Bastos; Amalia Pinkusfeld,9,0,71,62
1656967062589,COGS 14A,A01,092681,Semenuks; Arturs,0,1,100,100
1656967068614,COGS 14B,A01,083073,Cheng; Tzu-Han,5,0,63,58
1656967074646,COGS 17,A01,092677,Semenuks; Arturs,4,0,81,77
1656967080669,COGS 100,A01,083619,Allen; Michael Gordon,15,0,70,55
1656967086693,COGS 101A,A01,083621,Davis; Joshua Daniel,9,0,68,59
1656967092721,COGS 101B,A01,091572,Allen; Michael Gordon,8,0,65,57
1656967098746,COGS 101C,A01,083625,Delgado; Tania,17,0,35,18
1656967104769,COGS 107A,A01,083627,Boyle; Mary E. T.,13,0,60,47
1656967110793,COGS 118A,A01,083075,Gupta; Anjum,15,0,76,61
1656967116820,CSE 3,A50,083646,Miranda; Gregory Joseph,22,0,50,28
1656967122844,CSE 8A,A50,083650,Miranda; Gregory Joseph,17,1,56,39
1656967128866,CSE 11,A01,083080,Cao; Yingjun,4,15,40,36
1656967134893,CSE 12,A01,083652,Krause-Levy; Sophia Louisa,20,1,120,100
1656967140916,CSE 15L,A01,083654,Morris; Justin Loren,8,0,50,42
1656967140916,CSE 15L,A02,083655,Morris; Justin Loren,8,0,50,42
1656967146938,CSE 20,A01,083657,Tran; Khoa Dang,37,0,80,43
1656967152963,CSE 21,A01,095574,Bach; Quang Tran,21,0,48,27
1656967158985,CSE 30,A01,083084,Eldon; John,4,0,80,76
1656967158985,CSE 30,B01,095061,Bhaskar; Nishant,6,0,50,44
1656967165010,CSE 100,A01,083659,Cao; Yingjun,3,4,70,67
1656967171034,CSE 134B,A01,083661,Powell; Thomas Allan,19,0,100,81
1656967177060,CSE 140,A01,083663,Gungor; Onat,14,0,85,71
1656967183087,CSE 140L,A01,083088,Eldon; John,16,0,100,84
1656967189111,CSE 175,A01,083665,Kumar; Rakesh,3,0,25,22
1656967195136,CSE 190,A00,092507,Dubnov; Shlomo,7,0,20,13
1656967201163,ECE 45,A01,083139,Congero; Spencer William,5,0,75,70
1656967207261,ECE 65,A50,083695,Saad; Andrew S,12,0,30,18
1656967207261,ECE 65,A51,095125,Saad; Andrew S,25,0,26,1
1656967213286,ECE 109,A01,091882,Touri; Behrouz,16,0,70,54
1656967219311,ECE 180,A00,083140,Abi Samra; Nicholas Camill,0,0,30,30
1656967219311,ECE 180,B00,083141,Abi Samra; Nicholas Camill,0,0,30,30
1656967225341,MATH 10A,A01,083735,Patchell; Gregory David,1,0,30,29
1656967225341,MATH 10A,A02,083736,Patchell; Gregory David,20,0,30,10
1656967225341,MATH 10A,A03,083737,Patchell; Gregory David,15,0,30,15
1656967231368,MATH 10B,A01,083207,Lim; Seonhee,7,0,34,27
1656967231368,MATH 10B,A02,083208,Lim; Seonhee,9,0,35,26
1656967231368,MATH 10B,A03,093472,Lim; Seonhee,4,0,34,30
1656967231368,MATH 10B,B01,083739,Sinha; Shubham,9,0,30,21
1656967237402,MATH 18,A01,083743,Cinel; Cameron Alexander,6,0,30,24
1656967237402,MATH 18,A02,083744,Cinel; Cameron Alexander,15,0,30,15
1656967237402,MATH 18,A03,083745,Cinel; Cameron Alexander,8,0,30,22
1656967237402,MATH 18,B01,083748,Rideout; David Porter,4,0,37,33
1656967237402,MATH 18,B02,083749,Rideout; David Porter,3,0,36,33
1656967237402,MATH 18,B03,083750,Rideout; David Porter,2,0,37,35
1656967237402,MATH 18,B04,083751,Rideout; David Porter,5,0,36,31
1656967237402,MATH 18,B05,093473,Rideout; David Porter,4,0,36,32
1656967237402,MATH 18,B06,093474,Rideout; David Porter,5,0,36,31
1656967243424,MATH 20A,A01,083754,Zheng; Zequn,12,0,40,28
1656967249458,MATH 20B,A01,083756,Briones; Jor-el Thomas Caparas,1,0,36,35
1656967249458,MATH 20B,A02,083757,Briones; Jor-el Thomas Caparas,1,0,36,35
1656967249458,MATH 20B,A03,093475,Briones; Jor-el Thomas Caparas,0,0,36,36
1656967255485,MATH 20C,A01,083760,Briones; Jor-el Thomas Caparas,1,0,35,34
1656967255485,MATH 20C,A02,083761,Briones; Jor-el Thomas Caparas,8,0,35,27
1656967255485,MATH 20C,A03,093476,Briones; Jor-el Thomas Caparas,0,1,36,36
1656967255485,MATH 20C,B01,083762,Bach; Quang Tran,0,0,30,30
1656967261511,MATH 20D,A01,083765,Tran; Brian Kha,4,0,30,26
1656967261511,MATH 20D,A02,083766,Tran; Brian Kha,4,0,30,26
1656967261511,MATH 20D,A03,083767,Tran; Brian Kha,3,0,30,27
1656967267539,MATH 20E,A01,083771,Ganguly; Soumya,5,0,32,27
1656967267539,MATH 20E,A02,083772,Ganguly; Soumya,6,0,32,26
1656967267539,MATH 20E,B01,083773,Ciotti; Benjamin,18,0,35,17
1656967267539,MATH 20E,B02,083774,Ciotti; Benjamin,17,0,35,18
1656967273563,MATH 103A,A01,083777,Greenfeld; Be'Eri,2,0,36,34
1656967273563,MATH 103A,A02,083778,Greenfeld; Be'Eri,5,0,36,31
1656967273563,MATH 103A,A03,093561,Greenfeld; Be'Eri,4,0,36,32
1656967273563,MATH 103A,B01,083779,Greenfeld; Be'Eri,6,0,36,30
1656967273563,MATH 103A,B02,083780,Greenfeld; Be'Eri,2,0,36,34
1656967273563,MATH 103A,B03,093562,Greenfeld; Be'Eri,2,0,36,34
1656967279585,MATH 105,A01,085443,Carter; Anne Toulson,14,0,35,21
1656967279585,MATH 105,A02,093477,Carter; Anne Toulson,20,0,35,15
1656967285612,MATH 109,A01,083213,Ganzberger; Geoffrey Michael,2,0,34,32
1656967285612,MATH 109,A02,083214,Ganzberger; Geoffrey Michael,2,0,34,32
1656967285612,MATH 109,A03,093478,Ganzberger; Geoffrey Michael,1,0,34,33
1656967285612,MATH 109,B01,083215,Ganzberger; Geoffrey Michael,1,0,32,31
1656967285612,MATH 109,B02,083216,Ganzberger; Geoffrey Michael,1,0,32,31
1656967285612,MATH 109,B03,093479,Ganzberger; Geoffrey Michael,6,0,32,26
1656967291643,MATH 142A,A01,083219,Chow; Bennett,6,0,32,26
1656967291643,MATH 142A,A02,083220,Chow; Bennett,10,0,32,22
1656967291643,MATH 142A,A03,093480,Chow; Bennett,7,0,32,25
1656967291643,MATH 142A,B03,093481,Chow; Bennett,7,0,32,25
1656967291643,MATH 142A,B04,093558,Chow; Bennett,11,0,32,21
1656967291643,MATH 142A,B05,093559,Chow; Bennett,6,0,32,26
1656967297665,MATH 193A,A01,083224,Rotar; Vladimir,7,0,34,27
1656967297665,MATH 193A,A02,083225,Rotar; Vladimir,4,0,34,30
1656967297665,MATH 193A,A03,083781,Rotar; Vladimir,1,0,34,33
1656967297665,MATH 193A,A04,083782,Rotar; Vladimir,6,0,34,28
1656967297665,MATH 193A,A05,093482,Rotar; Vladimir,6,0,34,28
1656967303690,MATH 197,001,091859,McAuley; Julian John,9999,0,9999,0
1656967303690,MATH 197,002,095566,Kedlaya; Kiran S.,9997,0,9999,2
1656967303690,MATH 197,003,095567,Xiao; Ming,9999,0,9999,0
1656967303690,MATH 197,004,095571,Perols; Johan Lars,9998,0,9999,1
1656967310750,COGS 9,A01,083615,Shannon; Kyle Michael,7,0,75,68
1656967316773,COGS 11,A01,083617,Boyle; Mary E. T.,20,0,48,28
1656967322796,COGS 13,A01,083071,Bastos; Amalia Pinkusfeld,9,0,71,62
1656967328819,COGS 14A,A01,092681,Semenuks; Arturs,0,1,100,100
1656967334846,COGS 14B,A01,083073,Cheng; Tzu-Han,5,0,63,58
1656967340872,COGS 17,A01,092677,Semenuks; Arturs,4,0,81,77
1656967346896,COGS 100,A01,083619,Allen; Michael Gordon,15,0,70,55
1656967352922,COGS 101A,A01,083621,Davis; Joshua Daniel,9,0,68,59
1656967358944,COGS 101B,A01,091572,Allen; Michael Gordon,8,0,65,57
1656967364966,COGS 101C,A01,083625,Delgado; Tania,17,0,35,18
1656967370988,COGS 107A,A01,083627,Boyle; Mary E. T.,13,0,60,47
1656967377011,COGS 118A,A01,083075,Gupta; Anjum,15,0,76,61
1656967383033,CSE 3,A50,083646,Miranda; Gregory Joseph,22,0,50,28
1656967389063,CSE 8A,A50,083650,Miranda; Gregory Joseph,17,1,56,39
1656967395086,CSE 11,A01,083080,Cao; Yingjun,4,15,40,36
1656967401109,CSE 12,A01,083652,Krause-Levy; Sophia Louisa,20,1,120,100
1656967407136,CSE 15L,A01,083654,Morris; Justin Loren,8,0,50,42
1656967407136,CSE 15L,A02,083655,Morris; Justin Loren,8,0,50,42
1656967413163,CSE 20,A01,083657,Tran; Khoa Dang,37,0,80,43
1656967419193,CSE 21,A01,095574,Bach; Quang Tran,21,0,48,27
1656967425215,CSE 30,A01,083084,Eldon; John,4,0,80,76
1656967425215,CSE 30,B01,095061,Bhaskar; Nishant,6,0,50,44
1656967431239,CSE 100,A01,083659,Cao; Yingjun,3,4,70,67
1656967437267,CSE 134B,A01,083661,Powell; Thomas Allan,19,0,100,81
1656967443290,CSE 140,A01,083663,Gungor; Onat,14,0,85,71
1656967449315,CSE 140L,A01,083088,Eldon; John,16,0,100,84
1656967455338,CSE 175,A01,083665,Kumar; Rakesh,3,0,25,22
1656967461360,CSE 190,A00,092507,Dubnov; Shlomo,7,0,20,13
1656967467384,ECE 45,A01,083139,Congero; Spencer William,5,0,75,70
1656967473411,ECE 65,A50,083695,Saad; Andrew S,12,0,30,18
1656967473411,ECE 65,A51,095125,Saad; Andrew S,25,0,26,1
1656967479432,ECE 109,A01,091882,Touri; Behrouz,16,0,70,54
1656967485468,ECE 180,A00,083140,Abi Samra; Nicholas Camill,0,0,30,30
1656967485468,ECE 180,B00,083141,Abi Samra; Nicholas Camill,0,0,30,30
1656967491492,MATH 10A,A01,083735,Patchell; Gregory David,1,0,30,29
1656967491492,MATH 10A,A02,083736,Patchell; Gregory David,20,0,30,10
1656967491492,MATH 10A,A03,083737,Patchell; Gregory David,15,0,30,15
1656967497524,MATH 10B,A01,083207,Lim; Seonhee,7,0,34,27
1656967497524,MATH 10B,A02,083208,Lim; Seonhee,9,0,35,26
1656967497524,MATH 10B,A03,093472,Lim; Seonhee,4,0,34,30
1656967497524,MATH 10B,B01,083739,Sinha; Shubham,9,0,30,21
1656967503550,MATH 18,A01,083743,Cinel; Cameron Alexander,6,0,30,24
1656967503550,MATH 18,A02,083744,Cinel; Cameron Alexander,15,0,30,15
1656967503550,MATH 18,A03,083745,Cinel; Cameron Alexander,8,0,30,22
1656967503550,MATH 18,B01,083748,Rideout; David Porter,4,0,37,33
1656967503550,MATH 18,B02,083749,Rideout; David Porter,3,0,36,33
1656967503550,MATH 18,B03,083750,Rideout; David Porter,2,0,37,35
1656967503550,MATH 18,B04,083751,Rideout; David Porter,5,0,36,31
1656967503550,MATH 18,B05,093473,Rideout; David Porter,4,0,36,32
1656967503550,MATH 18,B06,093474,Rideout; David Porter,5,0,36,31
1656967509572,MATH 20A,A01,083754,Zheng; Zequn,12,0,40,28
1656967515597,MATH 20B,A01,083756,Briones; Jor-el Thomas Caparas,1,0,36,35
1656967515597,MATH 20B,A02,083757,Briones; Jor-el Thomas Caparas,1,0,36,35
1656967515597,MATH 20B,A03,093475,Briones; Jor-el Thomas Caparas,0,0,36,36
1656967521621,MATH 20C,A01,083760,Briones; Jor-el Thomas Caparas,1,0,35,34
1656967521621,MATH 20C,A02,083761,Briones; Jor-el Thomas Caparas,8,0,35,27
1656967521621,MATH 20C,A03,093476,Briones; Jor-el Thomas Caparas,0,1,36,36
1656967521621,MATH 20C,B01,083762,Bach; Quang Tran,0,0,30,30
1656967527650,MATH 20D,A01,083765,Tran; Brian Kha,4,0,30,26
1656967527650,MATH 20D,A02,083766,Tran; Brian Kha,4,0,30,26
1656967527650,MATH 20D,A03,083767,Tran; Brian Kha,3,0,30,27
1656967533675,MATH 20E,A01,083771,Ganguly; Soumya,5,0,32,27
1656967533675,MATH 20E,A02,083772,Ganguly; Soumya,6,0,32,26
1656967533675,MATH 20E,B01,083773,Ciotti; Benjamin,18,0,35,17
1656967533675,MATH 20E,B02,083774,Ciotti; Benjamin,17,0,35,18
1656967539704,MATH 103A,A01,083777,Greenfeld; Be'Eri,2,0,36,34
1656967539704,MATH 103A,A02,083778,Greenfeld; Be'Eri,5,0,36,31
1656967539704,MATH 103A,A03,093561,Greenfeld; Be'Eri,4,0,36,32
1656967539704,MATH 103A,B01,083779,Greenfeld; Be'Eri,6,0,36,30
1656967539704,MATH 103A,B02,083780,Greenfeld; Be'Eri,2,0,36,34
1656967539704,MATH 103A,B03,093562,Greenfeld; Be'Eri,2,0,36,34
1656967545736,MATH 105,A01,085443,Carter; Anne Toulson,14,0,35,21
1656967545736,MATH 105,A02,093477,Carter; Anne Toulson,20,0,35,15
1656967551760,MATH 109,A01,083213,Ganzberger; Geoffrey Michael,2,0,34,32
1656967551760,MATH 109,A02,083214,Ganzberger; Geoffrey Michael,2,0,34,32
1656967551760,MATH 109,A03,093478,Ganzberger; Geoffrey Michael,1,0,34,33
1656967551760,MATH 109,B01,083215,Ganzberger; Geoffrey Michael,1,0,32,31
1656967551760,MATH 109,B02,083216,Ganzberger; Geoffrey Michael,1,0,32,31
1656967551760,MATH 109,B03,093479,Ganzberger; Geoffrey Michael,6,0,32,26
1656967557783,MATH 142A,A01,083219,Chow; Bennett,6,0,32,26
1656967557783,MATH 142A,A02,083220,Chow; Bennett,10,0,32,22
1656967557783,MATH 142A,A03,093480,Chow; Bennett,7,0,32,25
1656967557783,MATH 142A,B03,093481,Chow; Bennett,7,0,32,25
1656967557783,MATH 142A,B04,093558,Chow; Bennett,11,0,32,21
1656967557783,MATH 142A,B05,093559,Chow; Bennett,6,0,32,26
1656967563813,MATH 193A,A01,083224,Rotar; Vladimir,7,0,34,27
1656967563813,MATH 193A,A02,083225,Rotar; Vladimir,4,0,34,30
1656967563813,MATH 193A,A03,083781,Rotar; Vladimir,1,0,34,33
1656967563813,MATH 193A,A04,083782,Rotar; Vladimir,6,0,34,28
1656967563813,MATH 193A,A05,093482,Rotar; Vladimir,6,0,34,28
1656967569837,MATH 197,001,091859,McAuley; Julian John,9999,0,9999,0
1656967569837,MATH 197,002,095566,Kedlaya; Kiran S.,9997,0,9999,2
1656967569837,MATH 197,003,095567,Xiao; Ming,9999,0,9999,0
1656967569837,MATH 197,004,095571,Perols; Johan Lars,9998,0,9999,1
1656967576902,COGS 9,A01,083615,Shannon; Kyle Michael,7,0,75,68
1656967582926,COGS 11,A01,083617,Boyle; Mary E. T.,20,0,48,28
1656967588953,COGS 13,A01,083071,Bastos; Amalia Pinkusfeld,9,0,71,62
1656967594977,COGS 14A,A01,092681,Semenuks; Arturs,0,1,100,100
1656967600999,COGS 14B,A01,083073,Cheng; Tzu-Han,5,0,63,58
1656967607029,COGS 17,A01,092677,Semenuks; Arturs,4,0,81,77
1656967613055,COGS 100,A01,083619,Allen; Michael Gordon,15,0,70,55
1656967619079,COGS 101A,A01,083621,Davis; Joshua Daniel,9,0,68,59
1656967625108,COGS 101B,A01,091572,Allen; Michael Gordon,8,0,65,57
1656967631139,COGS 101C,A01,083625,Delgado; Tania,17,0,35,18
1656967637161,COGS 107A,A01,083627,Boyle; Mary E. T.,13,0,60,47
1656967643188,COGS 118A,A01,083075,Gupta; Anjum,15,0,76,61
1656967649212,CSE 3,A50,083646,Miranda; Gregory Joseph,22,0,50,28
1656967655240,CSE 8A,A50,083650,Miranda; Gregory Joseph,17,1,56,39
1656967661261,CSE 11,A01,083080,Cao; Yingjun,4,15,40,36
1656967667285,CSE 12,A01,083652,Krause-Levy; Sophia Louisa,20,1,120,100
1656967673309,CSE 15L,A01,083654,Morris; Justin Loren,8,0,50,42
1656967673309,CSE 15L,A02,083655,Morris; Justin Loren,8,0,50,42
1656967679333,CSE 20,A01,083657,Tran; Khoa Dang,37,0,80,43
1656967685360,CSE 21,A01,095574,Bach; Quang Tran,21,0,48,27
1656967691387,CSE 30,A01,083084,Eldon; John,4,0,80,76
1656967691387,CSE 30,B01,095061,Bhaskar; Nishant,6,0,50,44
1656967697409,CSE 100,A01,083659,Cao; Yingjun,3,4,70,67
1656967703430,CSE 134B,A01,083661,Powell; Thomas Allan,19,0,100,81
1656967709455,CSE 140,A01,083663,Gungor; Onat,14,0,85,71
1656967715479,CSE 140L,A01,083088,Eldon; John,16,0,100,84
1656967721502,CSE 175,A01,083665,Kumar; Rakesh,3,0,25,22
1656967727525,CSE 190,A00,092507,Dubnov; Shlomo,7,0,20,13
1656967733547,ECE 45,A01,083139,Congero; Spencer William,5,0,75,70
1656967739571,ECE 65,A50,083695,Saad; Andrew S,12,0,30,18
1656967739571,ECE 65,A51,095125,Saad; Andrew S,25,0,26,1
1656967745598,ECE 109,A01,091882,Touri; Behrouz,16,0,70,54
1656967751628,ECE 180,A00,083140,Abi Samra; Nicholas Camill,0,0,30,30
1656967751628,ECE 180,B00,083141,Abi Samra; Nicholas Camill,0,0,30,30
1656967757652,MATH 10A,A01,083735,Patchell; Gregory David,1,0,30,29
1656967757652,MATH 10A,A02,083736,Patchell; Gregory David,20,0,30,10
1656967757652,MATH 10A,A03,083737,Patchell; Gregory David,15,0,30,15
1656967763676,MATH 10B,A01,083207,Lim; Seonhee,7,0,34,27
1656967763676,MATH 10B,A02,083208,Lim; Seonhee,9,0,35,26
1656967763676,MATH 10B,A03,093472,Lim; Seonhee,4,0,34,30
1656967763676,MATH 10B,B01,083739,Sinha; Shubham,9,0,30,21
1656967769702,MATH 18,A01,083743,Cinel; Cameron Alexander,6,0,30,24
1656967769702,MATH 18,A02,083744,Cinel; Cameron Alexander,15,0,30,15
1656967769702,MATH 18,A03,083745,Cinel; Cameron Alexander,8,0,30,22
1656967769702,MATH 18,B01,083748,Rideout; David Porter,4,0,37,33
1656967769702,MATH 18,B02,083749,Rideout; David Porter,3,0,36,33
1656967769702,MATH 18,B03,083750,Rideout; David Porter,2,0,37,35
1656967769702,MATH 18,B04,083751,Rideout; David Porter,5,0,36,31
1656967769702,MATH 18,B05,093473,Rideout; David Porter,4,0,36,32
1656967769702,MATH 18,B06,093474,Rideout; David Porter,5,0,36,31
1656967775728,MATH 20A,A01,083754,Zheng; Zequn,12,0,40,28
1656967781756,MATH 20B,A01,083756,Briones; Jor-el Thomas Caparas,1,0,36,35
1656967781756,MATH 20B,A02,083757,Briones; Jor-el Thomas Caparas,1,0,36,35
1656967781756,MATH 20B,A03,093475,Briones; Jor-el Thomas Caparas,0,0,36,36
1656967787781,MATH 20C,A01,083760,Briones; Jor-el Thomas Caparas,1,0,35,34
1656967787781,MATH 20C,A02,083761,Briones; Jor-el Thomas Caparas,8,0,35,27
1656967787781,MATH 20C,A03,093476,Briones; Jor-el Thomas Caparas,0,1,36,36
1656967787781,MATH 20C,B01,083762,Bach; Quang Tran,0,0,30,30
1656967793809,MATH 20D,A01,083765,Tran; Brian Kha,4,0,30,26
1656967793809,MATH 20D,A02,083766,Tran; Brian Kha,4,0,30,26
1656967793809,MATH 20D,A03,083767,Tran; Brian Kha,3,0,30,27
1656967799839,MATH 20E,A01,083771,Ganguly; Soumya,5,0,32,27
1656967799839,MATH 20E,A02,083772,Ganguly; Soumya,6,0,32,26
1656967799839,MATH 20E,B01,083773,Ciotti; Benjamin,18,0,35,17
1656967799839,MATH 20E,B02,083774,Ciotti; Benjamin,17,0,35,18
1656967805940,MATH 103A,A01,083777,Greenfeld; Be'Eri,2,0,36,34
1656967805940,MATH 103A,A02,083778,Greenfeld; Be'Eri,5,0,36,31
1656967805940,MATH 103A,A03,093561,Greenfeld; Be'Eri,4,0,36,32
1656967805940,MATH 103A,B01,083779,Greenfeld; Be'Eri,6,0,36,30
1656967805940,MATH 103A,B02,083780,Greenfeld; Be'Eri,2,0,36,34
1656967805940,MATH 103A,B03,093562,Greenfeld; Be'Eri,2,0,36,34
1656967811963,MATH 105,A01,085443,Carter; Anne Toulson,14,0,35,21
1656967811963,MATH 105,A02,093477,Carter; Anne Toulson,20,0,35,15
1656967817993,MATH 109,A01,083213,Ganzberger; Geoffrey Michael,2,0,34,32
1656967817993,MATH 109,A02,083214,Ganzberger; Geoffrey Michael,2,0,34,32
1656967817993,MATH 109,A03,093478,Ganzberger; Geoffrey Michael,1,0,34,33
1656967817993,MATH 109,B01,083215,Ganzberger; Geoffrey Michael,1,0,32,31
1656967817993,MATH 109,B02,083216,Ganzberger; Geoffrey Michael,1,0,32,31
1656967817993,MATH 109,B03,093479,Ganzberger; Geoffrey Michael,6,0,32,26
1656967824018,MATH 142A,A01,083219,Chow; Bennett,6,0,32,26
1656967824018,MATH 142A,A02,083220,Chow; Bennett,10,0,32,22
1656967824018,MATH 142A,A03,093480,Chow; Bennett,7,0,32,25
1656967824018,MATH 142A,B03,093481,Chow; Bennett,7,0,32,25
1656967824018,MATH 142A,B04,093558,Chow; Bennett,11,0,32,21
1656967824018,MATH 142A,B05,093559,Chow; Bennett,6,0,32,26
1656967830047,MATH 193A,A01,083224,Rotar; Vladimir,7,0,34,27
1656967830047,MATH 193A,A02,083225,Rotar; Vladimir,4,0,34,30
1656967830047,MATH 193A,A03,083781,Rotar; Vladimir,1,0,34,33
1656967830047,MATH 193A,A04,083782,Rotar; Vladimir,6,0,34,28
1656967830047,MATH 193A,A05,093482,Rotar; Vladimir,6,0,34,28
1656967836073,MATH 197,001,091859,McAuley; Julian John,9999,0,9999,0
1656967836073,MATH 197,002,095566,Kedlaya; Kiran S.,9997,0,9999,2
1656967836073,MATH 197,003,095567,Xiao; Ming,9999,0,9999,0
1656967836073,MATH 197,004,095571,Perols; Johan Lars,9998,0,9999,1
1656967843141,COGS 9,A01,083615,Shannon; Kyle Michael,7,0,75,68
1656967849163,COGS 11,A01,083617,Boyle; Mary E. T.,20,0,48,28
1656967855188,COGS 13,A01,083071,Bastos; Amalia Pinkusfeld,9,0,71,62
1656967861214,COGS 14A,A01,092681,Semenuks; Arturs,0,1,100,100
1656967867237,COGS 14B,A01,083073,Cheng; Tzu-Han,5,0,63,58
1656967873260,COGS 17,A01,092677,Semenuks; Arturs,4,0,81,77
1656967879283,COGS 100,A01,083619,Allen; Michael Gordon,15,0,70,55
1656967885310,COGS 101A,A01,083621,Davis; Joshua Daniel,9,0,68,59
1656967891335,COGS 101B,A01,091572,Allen; Michael Gordon,8,0,65,57
1656967897363,COGS 101C,A01,083625,Delgado; Tania,17,0,35,18
1656967903387,COGS 107A,A01,083627,Boyle; Mary E. T.,13,0,60,47
1656967909414,COGS 118A,A01,083075,Gupta; Anjum,15,0,76,61
1656967915442,CSE 3,A50,083646,Miranda; Gregory Joseph,22,0,50,28
1656967921468,CSE 8A,A50,083650,Miranda; Gregory Joseph,17,1,56,39
1656967927501,CSE 11,A01,083080,Cao; Yingjun,4,15,40,36
1656967933529,CSE 12,A01,083652,Krause-Levy; Sophia Louisa,20,1,120,100
1656967939558,CSE 15L,A01,083654,Morris; Justin Loren,8,0,50,42
1656967939558,CSE 15L,A02,083655,Morris; Justin Loren,8,0,50,42
1656967945582,CSE 20,A01,083657,Tran; Khoa Dang,37,0,80,43
1656967951603,CSE 21,A01,095574,Bach; Quang Tran,21,0,48,27
1656967957648,CSE 30,A01,083084,Eldon; John,4,0,80,76
1656967957648,CSE 30,B01,095061,Bhaskar; Nishant,6,0,50,44
1656967963671,CSE 100,A01,083659,Cao; Yingjun,3,4,70,67
1656967969693,CSE 134B,A01,083661,Powell; Thomas Allan,19,0,100,81
1656967975716,CSE 140,A01,083663,Gungor; Onat,14,0,85,71
1656967981738,CSE 140L,A01,083088,Eldon; John,16,0,100,84
1656967987763,CSE 175,A01,083665,Kumar; Rakesh,3,0,25,22
1656967993785,CSE 190,A00,092507,Dubnov; Shlomo,7,0,20,13
1656967999812,ECE 45,A01,083139,Congero; Spencer William,5,0,75,70
1656968005836,ECE 65,A50,083695,Saad; Andrew S,12,0,30,18
1656968005836,ECE 65,A51,095125,Saad; Andrew S,25,0,26,1
1656968011860,ECE 109,A01,091882,Touri; Behrouz,16,0,70,54
1656968017886,ECE 180,A00,083140,Abi Samra; Nicholas Camill,0,0,30,30
1656968017886,ECE 180,B00,083141,Abi Samra; Nicholas Camill,0,0,30,30
1656968023915,MATH 10A,A01,083735,Patchell; Gregory David,1,0,30,29
1656968023915,MATH 10A,A02,083736,Patchell; Gregory David,20,0,30,10
1656968023915,MATH 10A,A03,083737,Patchell; Gregory David,15,0,30,15
1656968029943,MATH 10B,A01,083207,Lim; Seonhee,7,0,34,27
1656968029943,MATH 10B,A02,083208,Lim; Seonhee,9,0,35,26
1656968029943,MATH 10B,A03,093472,Lim; Seonhee,4,0,34,30
1656968029943,MATH 10B,B01,083739,Sinha; Shubham,9,0,30,21
1656968035969,MATH 18,A01,083743,Cinel; Cameron Alexander,6,0,30,24
1656968035969,MATH 18,A02,083744,Cinel; Cameron Alexander,15,0,30,15
1656968035969,MATH 18,A03,083745,Cinel; Cameron Alexander,8,0,30,22
1656968035969,MATH 18,B01,083748,Rideout; David Porter,4,0,37,33
1656968035969,MATH 18,B02,083749,Rideout; David Porter,3,0,36,33
1656968035969,MATH 18,B03,083750,Rideout; David Porter,2,0,37,35
1656968035969,MATH 18,B04,083751,Rideout; David Porter,5,0,36,31
1656968035969,MATH 18,B05,093473,Rideout; David Porter,4,0,36,32
1656968035969,MATH 18,B06,093474,Rideout; David Porter,5,0,36,31
1656968041992,MATH 20A,A01,083754,Zheng; Zequn,12,0,40,28
1656968048028,MATH 20B,A01,083756,Briones; Jor-el Thomas Caparas,1,0,36,35
1656968048028,MATH 20B,A02,083757,Briones; Jor-el Thomas Caparas,1,0,36,35
1656968048028,MATH 20B,A03,093475,Briones; Jor-el Thomas Caparas,0,0,36,36
1656968054051,MATH 20C,A01,083760,Briones; Jor-el Thomas Caparas,1,0,35,34
1656968054051,MATH 20C,A02,083761,Briones; Jor-el Thomas Caparas,8,0,35,27
1656968054051,MATH 20C,A03,093476,Briones; Jor-el Thomas Caparas,0,1,36,36
1656968054051,MATH 20C,B01,083762,Bach; Quang Tran,0,0,30,30
1656968060075,MATH 20D,A01,083765,Tran; Brian Kha,4,0,30,26
1656968060075,MATH 20D,A02,083766,Tran; Brian Kha,4,0,30,26
1656968060075,MATH 20D,A03,083767,Tran; Brian Kha,3,0,30,27
1656968066097,MATH 20E,A01,083771,Ganguly; Soumya,5,0,32,27
1656968066097,MATH 20E,A02,083772,Ganguly; Soumya,6,0,32,26
1656968066097,MATH 20E,B01,083773,Ciotti; Benjamin,18,0,35,17
1656968066097,MATH 20E,B02,083774,Ciotti; Benjamin,17,0,35,18
1656968072127,MATH 103A,A01,083777,Greenfeld; Be'Eri,2,0,36,34
1656968072127,MATH 103A,A02,083778,Greenfeld; Be'Eri,5,0,36,31
1656968072127,MATH 103A,A03,093561,Greenfeld; Be'Eri,4,0,36,32
1656968072127,MATH 103A,B01,083779,Greenfeld; Be'Eri,6,0,36,30
1656968072127,MATH 103A,B02,083780,Greenfeld; Be'Eri,2,0,36,34
1656968072127,MATH 103A,B03,093562,Greenfeld; Be'Eri,2,0,36,34
1656968078153,MATH 105,A01,085443,Carter; Anne Toulson,14,0,35,21
1656968078153,MATH 105,A02,093477,Carter; Anne Toulson,20,0,35,15
1656968084182,MATH 109,A01,083213,Ganzberger; Geoffrey Michael,2,0,34,32
1656968084182,MATH 109,A02,083214,Ganzberger; Geoffrey Michael,2,0,34,32
1656968084182,MATH 109,A03,093478,Ganzberger; Geoffrey Michael,1,0,34,33
1656968084182,MATH 109,B01,083215,Ganzberger; Geoffrey Michael,1,0,32,31
1656968084182,MATH 109,B02,083216,Ganzberger; Geoffrey Michael,1,0,32,31
1656968084182,MATH 109,B03,093479,Ganzberger; Geoffrey Michael,6,0,32,26
1656968090212,MATH 142A,A01,083219,Chow; Bennett,6,0,32,26
1656968090212,MATH 142A,A02,083220,Chow; Bennett,10,0,32,22
1656968090212,MATH 142A,A03,093480,Chow; Bennett,7,0,32,25
1656968090212,MATH 142A,B03,093481,Chow; Bennett,7,0,32,25
1656968090212,MATH 142A,B04,093558,Chow; Bennett,11,0,32,21
1656968090212,MATH 142A,B05,093559,Chow; Bennett,6,0,32,26
1656968096237,MATH 193A,A01,083224,Rotar; Vladimir,7,0,34,27
1656968096237,MATH 193A,A02,083225,Rotar; Vladimir,4,0,34,30
1656968096237,MATH 193A,A03,083781,Rotar; Vladimir,1,0,34,33
1656968096237,MATH 193A,A04,083782,Rotar; Vladimir,6,0,34,28
1656968096237,MATH 193A,A05,093482,Rotar; Vladimir,6,0,34,28
1656968102261,MATH 197,001,091859,McAuley; Julian John,9999,0,9999,0
1656968102261,MATH 197,002,095566,Kedlaya; Kiran S.,9997,0,9999,2
1656968102261,MATH 197,003,095567,Xiao; Ming,9999,0,9999,0
1656968102261,MATH 197,004,095571,Perols; Johan Lars,9998,0,9999,1
1656968109330,COGS 9,A01,083615,Shannon; Kyle Michael,7,0,75,68
1656968115357,COGS 11,A01,083617,Boyle; Mary E. T.,20,0,48,28
1656968121381,COGS 13,A01,083071,Bastos; Amalia Pinkusfeld,9,0,71,62
1656968127412,COGS 14A,A01,092681,Semenuks; Arturs,0,1,100,100
1656968133437,COGS 14B,A01,083073,Cheng; Tzu-Han,5,0,63,58
1656968139487,COGS 17,A01,092677,Semenuks; Arturs,4,0,81,77
1656968145513,COGS 100,A01,083619,Allen; Michael Gordon,15,0,70,55
1656968151537,COGS 101A,A01,083621,Davis; Joshua Daniel,9,0,68,59
1656968157560,COGS 101B,A01,091572,Allen; Michael Gordon,8,0,65,57
1656968163584,COGS 101C,A01,083625,Delgado; Tania,17,0,35,18
1656968169609,COGS 107A,A01,083627,Boyle; Mary E. T.,13,0,60,47
1656968175631,COGS 118A,A01,083075,Gupta; Anjum,15,0,76,61
1656968181656,CSE 3,A50,083646,Miranda; Gregory Joseph,22,0,50,28
1656968187681,CSE 8A,A50,083650,Miranda; Gregory Joseph,17,1,56,39
1656968193707,CSE 11,A01,083080,Cao; Yingjun,4,15,40,36
1656968199731,CSE 12,A01,083652,Krause-Levy; Sophia Louisa,20,1,120,100
1656968205755,CSE 15L,A01,083654,Morris; Justin Loren,8,0,50,42
1656968205755,CSE 15L,A02,083655,Morris; Justin Loren,8,0,50,42
1656968211778,CSE 20,A01,083657,Tran; Khoa Dang,37,0,80,43
1656968217812,CSE 21,A01,095574,Bach; Quang Tran,21,0,48,27
1656968223839,CSE 30,A01,083084,Eldon; John,4,0,80,76
1656968223839,CSE 30,B01,095061,Bhaskar; Nishant,6,0,50,44
1656968229863,CSE 100,A01,083659,Cao; Yingjun,3,4,70,67
1656968235895,CSE 134B,A01,083661,Powell; Thomas Allan,19,0,100,81
1656968241920,CSE 140,A01,083663,Gungor; Onat,14,0,85,71
1656968247943,CSE 140L,A01,083088,Eldon; John,16,0,100,84
1656968253967,CSE 175,A01,083665,Kumar; Rakesh,3,0,25,22
1656968259989,CSE 190,A00,092507,Dubnov; Shlomo,7,0,20,13
1656968266010,ECE 45,A01,083139,Congero; Spencer William,5,0,75,70
1656968272033,ECE 65,A50,083695,Saad; Andrew S,12,0,30,18
1656968272033,ECE 65,A51,095125,Saad; Andrew S,25,0,26,1
1656968278060,ECE 109,A01,091882,Touri; Behrouz,16,0,70,54
1656968284083,ECE 180,A00,083140,Abi Samra; Nicholas Camill,0,0,30,30
1656968284083,ECE 180,B00,083141,Abi Samra; Nicholas Camill,0,0,30,30
1656968290106,MATH 10A,A01,083735,Patchell; Gregory David,1,0,30,29
1656968290106,MATH 10A,A02,083736,Patchell; Gregory David,20,0,30,10
1656968290106,MATH 10A,A03,083737,Patchell; Gregory David,15,0,30,15
1656968296130,MATH 10B,A01,083207,Lim; Seonhee,7,0,34,27
1656968296130,MATH 10B,A02,083208,Lim; Seonhee,9,0,35,26
1656968296130,MATH 10B,A03,093472,Lim; Seonhee,4,0,34,30
1656968296130,MATH 10B,B01,083739,Sinha; Shubham,9,0,30,21
1656968302154,MATH 18,A01,083743,Cinel; Cameron Alexander,6,0,30,24
1656968302154,MATH 18,A02,083744,Cinel; Cameron Alexander,15,0,30,15
1656968302154,MATH 18,A03,083745,Cinel; Cameron Alexander,8,0,30,22
1656968302154,MATH 18,B01,083748,Rideout; David Porter,4,0,37,33
1656968302154,MATH 18,B02,083749,Rideout; David Porter,3,0,36,33
1656968302154,MATH 18,B03,083750,Rideout; David Porter,2,0,37,35
1656968302154,MATH 18,B04,083751,Rideout; David Porter,5,0,36,31
1656968302154,MATH 18,B05,093473,Rideout; David Porter,4,0,36,32
1656968302154,MATH 18,B06,093474,Rideout; David Porter,5,0,36,31
1656968308176,MATH 20A,A01,083754,Zheng; Zequn,12,0,40,28
1656968314204,MATH 20B,A01,083756,Briones; Jor-el Thomas Caparas,1,0,36,35
1656968314204,MATH 20B,A02,083757,Briones; Jor-el Thomas Caparas,1,0,36,35
1656968314204,MATH 20B,A03,093475,Briones; Jor-el Thomas Caparas,0,0,36,36
1656968320240,MATH 20C,A01,083760,Briones; Jor-el Thomas Caparas,1,0,35,34
1656968320240,MATH 20C,A02,083761,Briones; Jor-el Thomas Caparas,8,0,35,27
1656968320240,MATH 20C,A03,093476,Briones; Jor-el Thomas Caparas,0,1,36,36
1656968320240,MATH 20C,B01,083762,Bach; Quang Tran,0,0,30,30
1656968326280,MATH 20D,A01,083765,Tran; Brian Kha,4,0,30,26
1656968326280,MATH 20D,A02,083766,Tran; Brian Kha,4,0,30,26
1656968326280,MATH 20D,A03,083767,Tran; Brian Kha,3,0,30,27
1656968332318,MATH 20E,A01,083771,Ganguly; Soumya,5,0,32,27
1656968332318,MATH 20E,A02,083772,Ganguly; Soumya,6,0,32,26
1656968332318,MATH 20E,B01,083773,Ciotti; Benjamin,18,0,35,17
1656968332318,MATH 20E,B02,083774,Ciotti; Benjamin,17,0,35,18
1656968338343,MATH 103A,A01,083777,Greenfeld; Be'Eri,2,0,36,34
1656968338343,MATH 103A,A02,083778,Greenfeld; Be'Eri,5,0,36,31
1656968338343,MATH 103A,A03,093561,Greenfeld; Be'Eri,4,0,36,32
1656968338343,MATH 103A,B01,083779,Greenfeld; Be'Eri,6,0,36,30
1656968338343,MATH 103A,B02,083780,Greenfeld; Be'Eri,2,0,36,34
1656968338343,MATH 103A,B03,093562,Greenfeld; Be'Eri,2,0,36,34
1656968344373,MATH 105,A01,085443,Carter; Anne Toulson,14,0,35,21
1656968344373,MATH 105,A02,093477,Carter; Anne Toulson,20,0,35,15
1656968350408,MATH 109,A01,083213,Ganzberger; Geoffrey Michael,2,0,34,32
1656968350408,MATH 109,A02,083214,Ganzberger; Geoffrey Michael,2,0,34,32
1656968350408,MATH 109,A03,093478,Ganzberger; Geoffrey Michael,1,0,34,33
1656968350408,MATH 109,B01,083215,Ganzberger; Geoffrey Michael,1,0,32,31
1656968350408,MATH 109,B02,083216,Ganzberger; Geoffrey Michael,1,0,32,31
1656968350408,MATH 109,B03,093479,Ganzberger; Geoffrey Michael,6,0,32,26
1656968356432,MATH 142A,A01,083219,Chow; Bennett,6,0,32,26
1656968356432,MATH 142A,A02,083220,Chow; Bennett,10,0,32,22
1656968356432,MATH 142A,A03,093480,Chow; Bennett,7,0,32,25
1656968356432,MATH 142A,B03,093481,Chow; Bennett,7,0,32,25
1656968356432,MATH 142A,B04,093558,Chow; Bennett,11,0,32,21
1656968356432,MATH 142A,B05,093559,Chow; Bennett,6,0,32,26
1656968362460,MATH 193A,A01,083224,Rotar; Vladimir,7,0,34,27
1656968362460,MATH 193A,A02,083225,Rotar; Vladimir,4,0,34,30
1656968362460,MATH 193A,A03,083781,Rotar; Vladimir,1,0,34,33
1656968362460,MATH 193A,A04,083782,Rotar; Vladimir,6,0,34,28
1656968362460,MATH 193A,A05,093482,Rotar; Vladimir,6,0,34,28
1656968368485,MATH 197,001,091859,McAuley; Julian John,9999,0,9999,0
1656968368485,MATH 197,002,095566,Kedlaya; Kiran S.,9997,0,9999,2
1656968368485,MATH 197,003,095567,Xiao; Ming,9999,0,9999,0
1656968368485,MATH 197,004,095571,Perols; Johan Lars,9998,0,9999,1
1656968375544,COGS 9,A01,083615,Shannon; Kyle Michael,7,0,75,68
1656968381568,COGS 11,A01,083617,Boyle; Mary E. T.,20,0,48,28
1656968387590,COGS 13,A01,083071,Bastos; Amalia Pinkusfeld,9,0,71,62
1656968393613,COGS 14A,A01,092681,Semenuks; Arturs,0,1,100,100
1656968399727,COGS 14B,A01,083073,Cheng; Tzu-Han,5,0,63,58
1656968405753,COGS 17,A01,092677,Semenuks; Arturs,4,0,81,77
1656968411778,COGS 100,A01,083619,Allen; Michael Gordon,15,0,70,55
1656968417806,COGS 101A,A01,083621,Davis; Joshua Daniel,9,0,68,59
1656968423830,COGS 101B,A01,091572,Allen; Michael Gordon,8,0,65,57
1656968429852,COGS 101C,A01,083625,Delgado; Tania,17,0,35,18
1656968435876,COGS 107A,A01,083627,Boyle; Mary E. T.,13,0,60,47
1656968441899,COGS 118A,A01,083075,Gupta; Anjum,15,0,76,61
1656968447929,CSE 3,A50,083646,Miranda; Gregory Joseph,22,0,50,28
1656968453971,CSE 8A,A50,083650,Miranda; Gregory Joseph,17,1,56,39
1656968459992,CSE 11,A01,083080,Cao; Yingjun,4,15,40,36
1656968466014,CSE 12,A01,083652,Krause-Levy; Sophia Louisa,20,1,120,100
1656968472035,CSE 15L,A01,083654,Morris; Justin Loren,8,0,50,42
1656968472035,CSE 15L,A02,083655,Morris; Justin Loren,8,0,50,42
1656968478063,CSE 20,A01,083657,Tran; Khoa Dang,37,0,80,43
1656968484089,CSE 21,A01,095574,Bach; Quang Tran,21,0,48,27
1656968490118,CSE 30,A01,083084,Eldon; John,4,0,80,76
1656968490118,CSE 30,B01,095061,Bhaskar; Nishant,6,0,50,44
1656968496140,CSE 100,A01,083659,Cao; Yingjun,3,4,70,67
1656968502166,CSE 134B,A01,083661,Powell; Thomas Allan,19,0,100,81
1656968508193,CSE 140,A01,083663,Gungor; Onat,14,0,85,71
1656968514217,CSE 140L,A01,083088,Eldon; John,16,0,100,84
1656968520239,CSE 175,A01,083665,Kumar; Rakesh,3,0,25,22
1656968526261,CSE 190,A00,092507,Dubnov; Shlomo,7,0,20,13
1656968532288,ECE 45,A01,083139,Congero; Spencer William,5,0,75,70
1656968538310,ECE 65,A50,083695,Saad; Andrew S,12,0,30,18
1656968538310,ECE 65,A51,095125,Saad; Andrew S,25,0,26,1
1656968544333,ECE 109,A01,091882,Touri; Behrouz,16,0,70,54
1656968550355,ECE 180,A00,083140,Abi Samra; Nicholas Camill,0,0,30,30
1656968550355,ECE 180,B00,083141,Abi Samra; Nicholas Camill,0,0,30,30
1656968556378,MATH 10A,A01,083735,Patchell; Gregory David,1,0,30,29
1656968556378,MATH 10A,A02,083736,Patchell; Gregory David,20,0,30,10
1656968556378,MATH 10A,A03,083737,Patchell; Gregory David,15,0,30,15
1656968562402,MATH 10B,A01,083207,Lim; Seonhee,7,0,34,27
1656968562402,MATH 10B,A02,083208,Lim; Seonhee,9,0,35,26
1656968562402,MATH 10B,A03,093472,Lim; Seonhee,4,0,34,30
1656968562402,MATH 10B,B01,083739,Sinha; Shubham,9,0,30,21
1656968568433,MATH 18,A01,083743,Cinel; Cameron Alexander,6,0,30,24
1656968568433,MATH 18,A02,083744,Cinel; Cameron Alexander,15,0,30,15
1656968568433,MATH 18,A03,083745,Cinel; Cameron Alexander,8,0,30,22
1656968568433,MATH 18,B01,083748,Rideout; David Porter,4,0,37,33
1656968568433,MATH 18,B02,083749,Rideout; David Porter,3,0,36,33
1656968568433,MATH 18,B03,083750,Rideout; David Porter,2,0,37,35
1656968568433,MATH 18,B04,083751,Rideout; David Porter,5,0,36,31
1656968568433,MATH 18,B05,093473,Rideout; David Porter,4,0,36,32
1656968568433,MATH 18,B06,093474,Rideout; David Porter,5,0,36,31
1656968574467,MATH 20A,A01,083754,Zheng; Zequn,12,0,40,28
1656968580494,MATH 20B,A01,083756,Briones; Jor-el Thomas Caparas,1,0,36,35
1656968580494,MATH 20B,A02,083757,Briones; Jor-el Thomas Caparas,1,0,36,35
1656968580494,MATH 20B,A03,093475,Briones; Jor-el Thomas Caparas,0,0,36,36
1656968586518,MATH 20C,A01,083760,Briones; Jor-el Thomas Caparas,1,0,35,34
1656968586518,MATH 20C,A02,083761,Briones; Jor-el Thomas Caparas,8,0,35,27
1656968586518,MATH 20C,A03,093476,Briones; Jor-el Thomas Caparas,0,1,36,36
1656968586518,MATH 20C,B01,083762,Bach; Quang Tran,0,0,30,30
1656968592545,MATH 20D,A01,083765,Tran; Brian Kha,4,0,30,26
1656968592545,MATH 20D,A02,083766,Tran; Brian Kha,4,0,30,26
1656968592545,MATH 20D,A03,083767,Tran; Brian Kha,3,0,30,27
1656968598569,MATH 20E,A01,083771,Ganguly; Soumya,5,0,32,27
1656968598569,MATH 20E,A02,083772,Ganguly; Soumya,6,0,32,26
1656968598569,MATH 20E,B01,083773,Ciotti; Benjamin,18,0,35,17
1656968598569,MATH 20E,B02,083774,Ciotti; Benjamin,17,0,35,18
1656968604591,MATH 103A,A01,083777,Greenfeld; Be'Eri,2,0,36,34
1656968604591,MATH 103A,A02,083778,Greenfeld; Be'Eri,5,0,36,31
1656968604591,MATH 103A,A03,093561,Greenfeld; Be'Eri,4,0,36,32
1656968604591,MATH 103A,B01,083779,Greenfeld; Be'Eri,6,0,36,30
1656968604591,MATH 103A,B02,083780,Greenfeld; Be'Eri,2,0,36,34
1656968604591,MATH 103A,B03,093562,Greenfeld; Be'Eri,2,0,36,34
1656968610617,MATH 105,A01,085443,Carter; Anne Toulson,14,0,35,21
1656968610617,MATH 105,A02,093477,Carter; Anne Toulson,20,0,35,15
1656968616647,MATH 109,A01,083213,Ganzberger; Geoffrey Michael,2,0,34,32
1656968616647,MATH 109,A02,083214,Ganzberger; Geoffrey Michael,2,0,34,32
1656968616647,MATH 109,A03,093478,Ganzberger; Geoffrey Michael,1,0,34,33
1656968616647,MATH 109,B01,083215,Ganzberger; Geoffrey Michael,1,0,32,31
1656968616647,MATH 109,B02,083216,Ganzberger; Geoffrey Michael,1,0,32,31
1656968616647,MATH 109,B03,093479,Ganzberger; Geoffrey Michael,6,0,32,26
1656968622669,MATH 142A,A01,083219,Chow; Bennett,6,0,32,26
1656968622669,MATH 142A,A02,083220,Chow; Bennett,10,0,32,22
1656968622669,MATH 142A,A03,093480,Chow; Bennett,7,0,32,25
1656968622669,MATH 142A,B03,093481,Chow; Bennett,7,0,32,25
1656968622669,MATH 142A,B04,093558,Chow; Bennett,11,0,32,21
1656968622669,MATH 142A,B05,093559,Chow; Bennett,6,0,32,26
1656968628696,MATH 193A,A01,083224,Rotar; Vladimir,7,0,34,27
1656968628696,MATH 193A,A02,083225,Rotar; Vladimir,4,0,34,30
1656968628696,MATH 193A,A03,083781,Rotar; Vladimir,1,0,34,33
1656968628696,MATH 193A,A04,083782,Rotar; Vladimir,6,0,34,28
1656968628696,MATH 193A,A05,093482,Rotar; Vladimir,6,0,34,28
1656968634717,MATH 197,001,091859,McAuley; Julian John,9999,0,9999,0
1656968634717,MATH 197,002,095566,Kedlaya; Kiran S.,9997,0,9999,2
1656968634717,MATH 197,003,095567,Xiao; Ming,9999,0,9999,0
1656968634717,MATH 197,004,095571,Perols; Johan Lars,9998,0,9999,1
1656968641772,COGS 9,A01,083615,Shannon; Kyle Michael,7,0,75,68
1656968647794,COGS 11,A01,083617,Boyle; Mary E. T.,20,0,48,28
1656968653828,COGS 13,A01,083071,Bastos; Amalia Pinkusfeld,9,0,71,62
1656968659853,COGS 14A,A01,092681,Semenuks; Arturs,0,1,100,100
1656968665877,COGS 14B,A01,083073,Cheng; Tzu-Han,5,0,63,58
1656968671899,COGS 17,A01,092677,Semenuks; Arturs,4,0,81,77
1656968677925,COGS 100,A01,083619,Allen; Michael Gordon,15,0,70,55
1656968683948,COGS 101A,A01,083621,Davis; Joshua Daniel,9,0,68,59
1656968689975,COGS 101B,A01,091572,Allen; Michael Gordon,8,0,65,57
1656968695998,COGS 101C,A01,083625,Delgado; Tania,17,0,35,18
1656968702021,COGS 107A,A01,083627,Boyle; Mary E. T.,13,0,60,47
1656968708054,COGS 118A,A01,083075,Gupta; Anjum,15,0,76,61
1656968714078,CSE 3,A50,083646,Miranda; Gregory Joseph,22,0,50,28
1656968720104,CSE 8A,A50,083650,Miranda; Gregory Joseph,17,1,56,39
1656968726127,CSE 11,A01,083080,Cao; Yingjun,4,15,40,36
1656968732152,CSE 12,A01,083652,Krause-Levy; Sophia Louisa,20,1,120,100
1656968738176,CSE 15L,A01,083654,Morris; Justin Loren,8,0,50,42
1656968738176,CSE 15L,A02,083655,Morris; Justin Loren,8,0,50,42
1656968744211,CSE 20,A01,083657,Tran; Khoa Dang,37,0,80,43
1656968750239,CSE 21,A01,095574,Bach; Quang Tran,21,0,48,27
1656968756263,CSE 30,A01,083084,Eldon; John,4,0,80,76
1656968756263,CSE 30,B01,095061,Bhaskar; Nishant,6,0,50,44
1656968762289,CSE 100,A01,083659,Cao; Yingjun,3,4,70,67
1656968768312,CSE 134B,A01,083661,Powell; Thomas Allan,19,0,100,81
1656968774335,CSE 140,A01,083663,Gungor; Onat,14,0,85,71
1656968780356,CSE 140L,A01,083088,Eldon; John,16,0,100,84
1656968786379,CSE 175,A01,083665,Kumar; Rakesh,3,0,25,22
1656968792405,CSE 190,A00,092507,Dubnov; Shlomo,7,0,20,13
1656968798432,ECE 45,A01,083139,Congero; Spencer William,5,0,75,70
1656968804455,ECE 65,A50,083695,Saad; Andrew S,12,0,30,18
1656968804455,ECE 65,A51,095125,Saad; Andrew S,25,0,26,1
1656968810478,ECE 109,A01,091882,Touri; Behrouz,16,0,70,54
1656968816505,ECE 180,A00,083140,Abi Samra; Nicholas Camill,0,0,30,30
1656968816505,ECE 180,B00,083141,Abi Samra; Nicholas Camill,0,0,30,30
1656968822532,MATH 10A,A01,083735,Patchell; Gregory David,1,0,30,29
1656968822532,MATH 10A,A02,083736,Patchell; Gregory David,20,0,30,10
1656968822532,MATH 10A,A03,083737,Patchell; Gregory David,15,0,30,15
1656968828557,MATH 10B,A01,083207,Lim; Seonhee,7,0,34,27
1656968828557,MATH 10B,A02,083208,Lim; Seonhee,9,0,35,26
1656968828557,MATH 10B,A03,093472,Lim; Seonhee,4,0,34,30
1656968828557,MATH 10B,B01,083739,Sinha; Shubham,9,0,30,21
1656968834582,MATH 18,A01,083743,Cinel; Cameron Alexander,6,0,30,24
1656968834582,MATH 18,A02,083744,Cinel; Cameron Alexander,15,0,30,15
1656968834582,MATH 18,A03,083745,Cinel; Cameron Alexander,8,0,30,22
1656968834582,MATH 18,B01,083748,Rideout; David Porter,4,0,37,33
1656968834582,MATH 18,B02,083749,Rideout; David Porter,3,0,36,33
1656968834582,MATH 18,B03,083750,Rideout; David Porter,2,0,37,35
1656968834582,MATH 18,B04,083751,Rideout; David Porter,5,0,36,31
1656968834582,MATH 18,B05,093473,Rideout; David Porter,4,0,36,32
1656968834582,MATH 18,B06,093474,Rideout; David Porter,5,0,36,31
1656968840605,MATH 20A,A01,083754,Zheng; Zequn,12,0,40,28
1656968846633,MATH 20B,A01,083756,Briones; Jor-el Thomas Caparas,1,0,36,35
1656968846633,MATH 20B,A02,083757,Briones; Jor-el Thomas Caparas,1,0,36,35
1656968846633,MATH 20B,A03,093475,Briones; Jor-el Thomas Caparas,0,0,36,36
1656968852657,MATH 20C,A01,083760,Briones; Jor-el Thomas Caparas,1,0,35,34
1656968852657,MATH 20C,A02,083761,Briones; Jor-el Thomas Caparas,8,0,35,27
1656968852657,MATH 20C,A03,093476,Briones; Jor-el Thomas Caparas,0,1,36,36
1656968852657,MATH 20C,B01,083762,Bach; Quang Tran,0,0,30,30
1656968858686,MATH 20D,A01,083765,Tran; Brian Kha,4,0,30,26
1656968858686,MATH 20D,A02,083766,Tran; Brian Kha,4,0,30,26
1656968858686,MATH 20D,A03,083767,Tran; Brian Kha,3,0,30,27
1656968864715,MATH 20E,A01,083771,Ganguly; Soumya,5,0,32,27
1656968864715,MATH 20E,A02,083772,Ganguly; Soumya,6,0,32,26
1656968864715,MATH 20E,B01,083773,Ciotti; Benjamin,18,0,35,17
1656968864715,MATH 20E,B02,083774,Ciotti; Benjamin,17,0,35,18
1656968870739,MATH 103A,A01,083777,Greenfeld; Be'Eri,2,0,36,34
1656968870739,MATH 103A,A02,083778,Greenfeld; Be'Eri,5,0,36,31
1656968870739,MATH 103A,A03,093561,Greenfeld; Be'Eri,4,0,36,32
1656968870739,MATH 103A,B01,083779,Greenfeld; Be'Eri,6,0,36,30
1656968870739,MATH 103A,B02,083780,Greenfeld; Be'Eri,2,0,36,34
1656968870739,MATH 103A,B03,093562,Greenfeld; Be'Eri,2,0,36,34
1656968876767,MATH 105,A01,085443,Carter; Anne Toulson,14,0,35,21
1656968876767,MATH 105,A02,093477,Carter; Anne Toulson,20,0,35,15
1656968882804,MATH 109,A01,083213,Ganzberger; Geoffrey Michael,2,0,34,32
1656968882804,MATH 109,A02,083214,Ganzberger; Geoffrey Michael,2,0,34,32
1656968882804,MATH 109,A03,093478,Ganzberger; Geoffrey Michael,1,0,34,33
1656968882804,MATH 109,B01,083215,Ganzberger; Geoffrey Michael,1,0,32,31
1656968882804,MATH 109,B02,083216,Ganzberger; Geoffrey Michael,1,0,32,31
1656968882804,MATH 109,B03,093479,Ganzberger; Geoffrey Michael,6,0,32,26
1656968888836,MATH 142A,A01,083219,Chow; Bennett,6,0,32,26
1656968888836,MATH 142A,A02,083220,Chow; Bennett,10,0,32,22
1656968888836,MATH 142A,A03,093480,Chow; Bennett,7,0,32,25
1656968888836,MATH 142A,B03,093481,Chow; Bennett,7,0,32,25
1656968888836,MATH 142A,B04,093558,Chow; Bennett,11,0,32,21
1656968888836,MATH 142A,B05,093559,Chow; Bennett,6,0,32,26
1656968894859,MATH 193A,A01,083224,Rotar; Vladimir,7,0,34,27
1656968894859,MATH 193A,A02,083225,Rotar; Vladimir,4,0,34,30
1656968894859,MATH 193A,A03,083781,Rotar; Vladimir,1,0,34,33
1656968894859,MATH 193A,A04,083782,Rotar; Vladimir,6,0,34,28
1656968894859,MATH 193A,A05,093482,Rotar; Vladimir,6,0,34,28
1656968900888,MATH 197,001,091859,McAuley; Julian John,9999,0,9999,0
1656968900888,MATH 197,002,095566,Kedlaya; Kiran S.,9997,0,9999,2
1656968900888,MATH 197,003,095567,Xiao; Ming,9999,0,9999,0
1656968900888,MATH 197,004,095571,Perols; Johan Lars,9998,0,9999,1
1656968907957,COGS 9,A01,083615,Shannon; Kyle Michael,7,0,75,68
1656968913982,COGS 11,A01,083617,Boyle; Mary E. T.,20,0,48,28
1656968920003,COGS 13,A01,083071,Bastos; Amalia Pinkusfeld,9,0,71,62
1656968926026,COGS 14A,A01,092681,Semenuks; Arturs,0,1,100,100
1656968932053,COGS 14B,A01,083073,Cheng; Tzu-Han,5,0,63,58
1656968938077,COGS 17,A01,092677,Semenuks; Arturs,4,0,81,77
1656968944103,COGS 100,A01,083619,Allen; Michael Gordon,15,0,70,55
1656968950135,COGS 101A,A01,083621,Davis; Joshua Daniel,9,0,68,59
1656968956159,COGS 101B,A01,091572,Allen; Michael Gordon,8,0,65,57
1656968962185,COGS 101C,A01,083625,Delgado; Tania,17,0,35,18
1656968968210,COGS 107A,A01,083627,Boyle; Mary E. T.,13,0,60,47
1656968974236,COGS 118A,A01,083075,Gupta; Anjum,15,0,76,61
1656968980263,CSE 3,A50,083646,Miranda; Gregory Joseph,22,0,50,28
1656968986286,CSE 8A,A50,083650,Miranda; Gregory Joseph,17,1,56,39
1656968992309,CSE 11,A01,083080,Cao; Yingjun,4,15,40,36
1656968998420,CSE 12,A01,083652,Krause-Levy; Sophia Louisa,20,1,120,100
1656969004452,CSE 15L,A01,083654,Morris; Justin Loren,8,0,50,42
1656969004452,CSE 15L,A02,083655,Morris; Justin Loren,8,0,50,42
1656969010480,CSE 20,A01,083657,Tran; Khoa Dang,37,0,80,43
1656969016504,CSE 21,A01,095574,Bach; Quang Tran,21,0,48,27
1656969022533,CSE 30,A01,083084,Eldon; John,4,0,80,76
1656969022533,CSE 30,B01,095061,Bhaskar; Nishant,6,0,50,44
1656969028559,CSE 100,A01,083659,Cao; Yingjun,3,4,70,67
1656969034582,CSE 134B,A01,083661,Powell; Thomas Allan,19,0,100,81
1656969040606,CSE 140,A01,083663,Gungor; Onat,14,0,85,71
1656969046630,CSE 140L,A01,083088,Eldon; John,16,0,100,84
1656969052651,CSE 175,A01,083665,Kumar; Rakesh,3,0,25,22
1656969058678,CSE 190,A00,092507,Dubnov; Shlomo,7,0,20,13
1656969064705,ECE 45,A01,083139,Congero; Spencer William,5,0,75,70
1656969070726,ECE 65,A50,083695,Saad; Andrew S,12,0,30,18
1656969070726,ECE 65,A51,095125,Saad; Andrew S,25,0,26,1
1656969076754,ECE 109,A01,091882,Touri; Behrouz,16,0,70,54
1656969082779,ECE 180,A00,083140,Abi Samra; Nicholas Camill,0,0,30,30
1656969082779,ECE 180,B00,083141,Abi Samra; Nicholas Camill,0,0,30,30
1656969088807,MATH 10A,A01,083735,Patchell; Gregory David,1,0,30,29
1656969088807,MATH 10A,A02,083736,Patchell; Gregory David,20,0,30,10
1656969088807,MATH 10A,A03,083737,Patchell; Gregory David,15,0,30,15
1656969094834,MATH 10B,A01,083207,Lim; Seonhee,7,0,34,27
1656969094834,MATH 10B,A02,083208,Lim; Seonhee,9,0,35,26
1656969094834,MATH 10B,A03,093472,Lim; Seonhee,4,0,34,30
1656969094834,MATH 10B,B01,083739,Sinha; Shubham,9,0,30,21
1656969100858,MATH 18,A01,083743,Cinel; Cameron Alexander,6,0,30,24
1656969100858,MATH 18,A02,083744,Cinel; Cameron Alexander,15,0,30,15
1656969100858,MATH 18,A03,083745,Cinel; Cameron Alexander,8,0,30,22
1656969100858,MATH 18,B01,083748,Rideout; David Porter,4,0,37,33
1656969100858,MATH 18,B02,083749,Rideout; David Porter,3,0,36,33
1656969100858,MATH 18,B03,083750,Rideout; David Porter,2,0,37,35
1656969100858,MATH 18,B04,083751,Rideout; David Porter,5,0,36,31
1656969100858,MATH 18,B05,093473,Rideout; David Porter,4,0,36,32
1656969100858,MATH 18,B06,093474,Rideout; David Porter,5,0,36,31
1656969106884,MATH 20A,A01,083754,Zheng; Zequn,12,0,40,28
1656969112912,MATH 20B,A01,083756,Briones; Jor-el Thomas Caparas,1,0,36,35
1656969112912,MATH 20B,A02,083757,Briones; Jor-el Thomas Caparas,1,0,36,35
1656969112912,MATH 20B,A03,093475,Briones; Jor-el Thomas Caparas,0,0,36,36
1656969118935,MATH 20C,A01,083760,Briones; Jor-el Thomas Caparas,1,0,35,34
1656969118935,MATH 20C,A02,083761,Briones; Jor-el Thomas Caparas,8,0,35,27
1656969118935,MATH 20C,A03,093476,Briones; Jor-el Thomas Caparas,0,1,36,36
1656969118935,MATH 20C,B01,083762,Bach; Quang Tran,0,0,30,30
1656969124969,MATH 20D,A01,083765,Tran; Brian Kha,4,0,30,26
1656969124969,MATH 20D,A02,083766,Tran; Brian Kha,4,0,30,26
1656969124969,MATH 20D,A03,083767,Tran; Brian Kha,3,0,30,27
1656969130998,MATH 20E,A01,083771,Ganguly; Soumya,5,0,32,27
1656969130998,MATH 20E,A02,083772,Ganguly; Soumya,6,0,32,26
1656969130998,MATH 20E,B01,083773,Ciotti; Benjamin,18,0,35,17
1656969130998,MATH 20E,B02,083774,Ciotti; Benjamin,17,0,35,18
1656969137028,MATH 103A,A01,083777,Greenfeld; Be'Eri,2,0,36,34
1656969137028,MATH 103A,A02,083778,Greenfeld; Be'Eri,5,0,36,31
1656969137028,MATH 103A,A03,093561,Greenfeld; Be'Eri,4,0,36,32
1656969137028,MATH 103A,B01,083779,Greenfeld; Be'Eri,6,0,36,30
1656969137028,MATH 103A,B02,083780,Greenfeld; Be'Eri,2,0,36,34
1656969137028,MATH 103A,B03,093562,Greenfeld; Be'Eri,2,0,36,34
1656969143054,MATH 105,A01,085443,Carter; Anne Toulson,14,0,35,21
1656969143054,MATH 105,A02,093477,Carter; Anne Toulson,20,0,35,15
1656969149079,MATH 109,A01,083213,Ganzberger; Geoffrey Michael,2,0,34,32
1656969149079,MATH 109,A02,083214,Ganzberger; Geoffrey Michael,2,0,34,32
1656969149079,MATH 109,A03,093478,Ganzberger; Geoffrey Michael,1,0,34,33
1656969149079,MATH 109,B01,083215,Ganzberger; Geoffrey Michael,1,0,32,31
1656969149079,MATH 109,B02,083216,Ganzberger; Geoffrey Michael,1,0,32,31
1656969149079,MATH 109,B03,093479,Ganzberger; Geoffrey Michael,6,0,32,26
1656969155102,MATH 142A,A01,083219,Chow; Bennett,6,0,32,26
1656969155102,MATH 142A,A02,083220,Chow; Bennett,10,0,32,22
1656969155102,MATH 142A,A03,093480,Chow; Bennett,7,0,32,25
1656969155102,MATH 142A,B03,093481,Chow; Bennett,7,0,32,25
1656969155102,MATH 142A,B04,093558,Chow; Bennett,11,0,32,21
1656969155102,MATH 142A,B05,093559,Chow; Bennett,6,0,32,26
1656969161130,MATH 193A,A01,083224,Rotar; Vladimir,7,0,34,27
1656969161130,MATH 193A,A02,083225,Rotar; Vladimir,4,0,34,30
1656969161130,MATH 193A,A03,083781,Rotar; Vladimir,1,0,34,33
1656969161130,MATH 193A,A04,083782,Rotar; Vladimir,6,0,34,28
1656969161130,MATH 193A,A05,093482,Rotar; Vladimir,6,0,34,28
1656969167156,MATH 197,001,091859,McAuley; Julian John,9999,0,9999,0
1656969167156,MATH 197,002,095566,Kedlaya; Kiran S.,9997,0,9999,2
1656969167156,MATH 197,003,095567,Xiao; Ming,9999,0,9999,0
1656969167156,MATH 197,004,095571,Perols; Johan Lars,9998,0,9999,1
1656969174222,COGS 9,A01,083615,Shannon; Kyle Michael,7,0,75,68
1656969180256,COGS 11,A01,083617,Boyle; Mary E. T.,20,0,48,28
1656969186284,COGS 13,A01,083071,Bastos; Amalia Pinkusfeld,9,0,71,62
1656969192306,COGS 14A,A01,092681,Semenuks; Arturs,0,1,100,100
1656969198366,COGS 14B,A01,083073,Cheng; Tzu-Han,5,0,63,58
1656969204392,COGS 17,A01,092677,Semenuks; Arturs,4,0,81,77
1656969210414,COGS 100,A01,083619,Allen; Michael Gordon,15,0,70,55
1656969216441,COGS 101A,A01,083621,Davis; Joshua Daniel,9,0,68,59
1656969222474,COGS 101B,A01,091572,Allen; Michael Gordon,8,0,65,57
1656969228496,COGS 101C,A01,083625,Delgado; Tania,17,0,35,18
1656969234522,COGS 107A,A01,083627,Boyle; Mary E. T.,13,0,60,47
1656969240549,COGS 118A,A01,083075,Gupta; Anjum,15,0,76,61
1656969246571,CSE 3,A50,083646,Miranda; Gregory Joseph,22,0,50,28
1656969252599,CSE 8A,A50,083650,Miranda; Gregory Joseph,17,1,56,39
1656969258625,CSE 11,A01,083080,Cao; Yingjun,4,15,40,36
1656969264652,CSE 12,A01,083652,Krause-Levy; Sophia Louisa,20,1,120,100
1656969270675,CSE 15L,A01,083654,Morris; Justin Loren,8,0,50,42
1656969270675,CSE 15L,A02,083655,Morris; Justin Loren,8,0,50,42
1656969276701,CSE 20,A01,083657,Tran; Khoa Dang,37,0,80,43
1656969282724,CSE 21,A01,095574,Bach; Quang Tran,21,0,48,27
1656969288746,CSE 30,A01,083084,Eldon; John,4,0,80,76
1656969288746,CSE 30,B01,095061,Bhaskar; Nishant,6,0,50,44
1656969294773,CSE 100,A01,083659,Cao; Yingjun,3,4,70,67
1656969300797,CSE 134B,A01,083661,Powell; Thomas Allan,19,0,100,81
1656969306823,CSE 140,A01,083663,Gungor; Onat,14,0,85,71
1656969312846,CSE 140L,A01,083088,Eldon; John,16,0,100,84
1656969318868,CSE 175,A01,083665,Kumar; Rakesh,3,0,25,22
1656969324891,CSE 190,A00,092507,Dubnov; Shlomo,7,0,20,13
1656969330914,ECE 45,A01,083139,Congero; Spencer William,5,0,75,70
1656969336939,ECE 65,A50,083695,Saad; Andrew S,12,0,30,18
1656969336939,ECE 65,A51,095125,Saad; Andrew S,25,0,26,1
1656969342965,ECE 109,A01,091882,Touri; Behrouz,16,0,70,54
1656969348988,ECE 180,A00,083140,Abi Samra; Nicholas Camill,0,0,30,30
1656969348988,ECE 180,B00,083141,Abi Samra; Nicholas Camill,0,0,30,30
1656969355019,MATH 10A,A01,083735,Patchell; Gregory David,1,0,30,29
1656969355019,MATH 10A,A02,083736,Patchell; Gregory David,20,0,30,10
1656969355019,MATH 10A,A03,083737,Patchell; Gregory David,15,0,30,15
1656969361042,MATH 10B,A01,083207,Lim; Seonhee,7,0,34,27
1656969361042,MATH 10B,A02,083208,Lim; Seonhee,9,0,35,26
1656969361042,MATH 10B,A03,093472,Lim; Seonhee,4,0,34,30
1656969361042,MATH 10B,B01,083739,Sinha; Shubham,9,0,30,21
1656969367065,MATH 18,A01,083743,Cinel; Cameron Alexander,6,0,30,24
1656969367065,MATH 18,A02,083744,Cinel; Cameron Alexander,15,0,30,15
1656969367065,MATH 18,A03,083745,Cinel; Cameron Alexander,8,0,30,22
1656969367065,MATH 18,B01,083748,Rideout; David Porter,4,0,37,33
1656969367065,MATH 18,B02,083749,Rideout; David Porter,3,0,36,33
1656969367065,MATH 18,B03,083750,Rideout; David Porter,2,0,37,35
1656969367065,MATH 18,B04,083751,Rideout; David Porter,5,0,36,31
1656969367065,MATH 18,B05,093473,Rideout; David Porter,4,0,36,32
1656969367065,MATH 18,B06,093474,Rideout; David Porter,5,0,36,31
1656969373089,MATH 20A,A01,083754,Zheng; Zequn,12,0,40,28
1656969379116,MATH 20B,A01,083756,Briones; Jor-el Thomas Caparas,1,0,36,35
1656969379116,MATH 20B,A02,083757,Briones; Jor-el Thomas Caparas,1,0,36,35
1656969379116,MATH 20B,A03,093475,Briones; Jor-el Thomas Caparas,0,0,36,36
1656969385140,MATH 20C,A01,083760,Briones; Jor-el Thomas Caparas,1,0,35,34
1656969385140,MATH 20C,A02,083761,Briones; Jor-el Thomas Caparas,8,0,35,27
1656969385140,MATH 20C,A03,093476,Briones; Jor-el Thomas Caparas,0,1,36,36
1656969385140,MATH 20C,B01,083762,Bach; Quang Tran,0,0,30,30
1656969391164,MATH 20D,A01,083765,Tran; Brian Kha,4,0,30,26
1656969391164,MATH 20D,A02,083766,Tran; Brian Kha,4,0,30,26
1656969391164,MATH 20D,A03,083767,Tran; Brian Kha,3,0,30,27
1656969397188,MATH 20E,A01,083771,Ganguly; Soumya,5,0,32,27
1656969397188,MATH 20E,A02,083772,Ganguly; Soumya,6,0,32,26
1656969397188,MATH 20E,B01,083773,Ciotti; Benjamin,18,0,35,17
1656969397188,MATH 20E,B02,083774,Ciotti; Benjamin,17,0,35,18
1656969403212,MATH 103A,A01,083777,Greenfeld; Be'Eri,2,0,36,34
1656969403212,MATH 103A,A02,083778,Greenfeld; Be'Eri,5,0,36,31
1656969403212,MATH 103A,A03,093561,Greenfeld; Be'Eri,4,0,36,32
1656969403212,MATH 103A,B01,083779,Greenfeld; Be'Eri,6,0,36,30
1656969403212,MATH 103A,B02,083780,Greenfeld; Be'Eri,2,0,36,34
1656969403212,MATH 103A,B03,093562,Greenfeld; Be'Eri,2,0,36,34
1656969409235,MATH 105,A01,085443,Carter; Anne Toulson,14,0,35,21
1656969409235,MATH 105,A02,093477,Carter; Anne Toulson,20,0,35,15
1656969415259,MATH 109,A01,083213,Ganzberger; Geoffrey Michael,2,0,34,32
1656969415259,MATH 109,A02,083214,Ganzberger; Geoffrey Michael,2,0,34,32
1656969415259,MATH 109,A03,093478,Ganzberger; Geoffrey Michael,1,0,34,33
1656969415259,MATH 109,B01,083215,Ganzberger; Geoffrey Michael,1,0,32,31
1656969415259,MATH 109,B02,083216,Ganzberger; Geoffrey Michael,1,0,32,31
1656969415259,MATH 109,B03,093479,Ganzberger; Geoffrey Michael,6,0,32,26
1656969421288,MATH 142A,A01,083219,Chow; Bennett,6,0,32,26
1656969421288,MATH 142A,A02,083220,Chow; Bennett,10,0,32,22
1656969421288,MATH 142A,A03,093480,Chow; Bennett,7,0,32,25
1656969421288,MATH 142A,B03,093481,Chow; Bennett,7,0,32,25
1656969421288,MATH 142A,B04,093558,Chow; Bennett,11,0,32,21
1656969421288,MATH 142A,B05,093559,Chow; Bennett,6,0,32,26
1656969427313,MATH 193A,A01,083224,Rotar; Vladimir,7,0,34,27
1656969427313,MATH 193A,A02,083225,Rotar; Vladimir,4,0,34,30
1656969427313,MATH 193A,A03,083781,Rotar; Vladimir,1,0,34,33
1656969427313,MATH 193A,A04,083782,Rotar; Vladimir,6,0,34,28
1656969427313,MATH 193A,A05,093482,Rotar; Vladimir,6,0,34,28
1656969433337,MATH 197,001,091859,McAuley; Julian John,9999,0,9999,0
1656969433337,MATH 197,002,095566,Kedlaya; Kiran S.,9997,0,9999,2
1656969433337,MATH 197,003,095567,Xiao; Ming,9999,0,9999,0
1656969433337,MATH 197,004,095571,Perols; Johan Lars,9998,0,9999,1
1656969440400,COGS 9,A01,083615,Shannon; Kyle Michael,7,0,75,68
1656969446423,COGS 11,A01,083617,Boyle; Mary E. T.,20,0,48,28
1656969452454,COGS 13,A01,083071,Bastos; Amalia Pinkusfeld,9,0,71,62
1656969458477,COGS 14A,A01,092681,Semenuks; Arturs,0,1,100,100
1656969464501,COGS 14B,A01,083073,Cheng; Tzu-Han,5,0,63,58
1656969470524,COGS 17,A01,092677,Semenuks; Arturs,4,0,81,77
1656969476548,COGS 100,A01,083619,Allen; Michael Gordon,15,0,70,55
1656969482572,COGS 101A,A01,083621,Davis; Joshua Daniel,9,0,68,59
1656969488596,COGS 101B,A01,091572,Allen; Michael Gordon,8,0,65,57
1656969494622,COGS 101C,A01,083625,Delgado; Tania,17,0,35,18
1656969500650,COGS 107A,A01,083627,Boyle; Mary E. T.,13,0,60,47
1656969506673,COGS 118A,A01,083075,Gupta; Anjum,15,0,76,61
1656969512700,CSE 3,A50,083646,Miranda; Gregory Joseph,22,0,50,28
1656969518734,CSE 8A,A50,083650,Miranda; Gregory Joseph,17,1,56,39
1656969524759,CSE 11,A01,083080,Cao; Yingjun,4,15,40,36
1656969530785,CSE 12,A01,083652,Krause-Levy; Sophia Louisa,20,1,120,100
1656969536808,CSE 15L,A01,083654,Morris; Justin Loren,8,0,50,42
1656969536808,CSE 15L,A02,083655,Morris; Justin Loren,8,0,50,42
1656969542832,CSE 20,A01,083657,Tran; Khoa Dang,37,0,80,43
1656969548856,CSE 21,A01,095574,Bach; Quang Tran,21,0,48,27
1656969554885,CSE 30,A01,083084,Eldon; John,4,0,80,76
1656969554885,CSE 30,B01,095061,Bhaskar; Nishant,6,0,50,44
1656969560911,CSE 100,A01,083659,Cao; Yingjun,3,4,70,67
1656969566938,CSE 134B,A01,083661,Powell; Thomas Allan,19,0,100,81
1656969572964,CSE 140,A01,083663,Gungor; Onat,14,0,85,71
1656969578985,CSE 140L,A01,083088,Eldon; John,16,0,100,84
1656969585007,CSE 175,A01,083665,Kumar; Rakesh,3,0,25,22
1656969591042,CSE 190,A00,092507,Dubnov; Shlomo,7,0,20,13
1656969597141,ECE 45,A01,083139,Congero; Spencer William,5,0,75,70
1656969603166,ECE 65,A50,083695,Saad; Andrew S,12,0,30,18
1656969603166,ECE 65,A51,095125,Saad; Andrew S,25,0,26,1
1656969609193,ECE 109,A01,091882,Touri; Behrouz,16,0,70,54
1656969615217,ECE 180,A00,083140,Abi Samra; Nicholas Camill,1,0,30,29
1656969615217,ECE 180,B00,083141,Abi Samra; Nicholas Camill,0,0,30,30
1656969621239,MATH 10A,A01,083735,Patchell; Gregory David,1,0,30,29
1656969621239,MATH 10A,A02,083736,Patchell; Gregory David,20,0,30,10
1656969621239,MATH 10A,A03,083737,Patchell; Gregory David,15,0,30,15
1656969627263,MATH 10B,A01,083207,Lim; Seonhee,7,0,34,27
1656969627263,MATH 10B,A02,083208,Lim; Seonhee,9,0,35,26
1656969627263,MATH 10B,A03,093472,Lim; Seonhee,4,0,34,30
1656969627263,MATH 10B,B01,083739,Sinha; Shubham,9,0,30,21
1656969633296,MATH 18,A01,083743,Cinel; Cameron Alexander,6,0,30,24
1656969633296,MATH 18,A02,083744,Cinel; Cameron Alexander,15,0,30,15
1656969633296,MATH 18,A03,083745,Cinel; Cameron Alexander,8,0,30,22
1656969633296,MATH 18,B01,083748,Rideout; David Porter,4,0,37,33
1656969633296,MATH 18,B02,083749,Rideout; David Porter,3,0,36,33
1656969633296,MATH 18,B03,083750,Rideout; David Porter,2,0,37,35
1656969633296,MATH 18,B04,083751,Rideout; David Porter,5,0,36,31
1656969633296,MATH 18,B05,093473,Rideout; David Porter,4,0,36,32
1656969633296,MATH 18,B06,093474,Rideout; David Porter,5,0,36,31
1656969639324,MATH 20A,A01,083754,Zheng; Zequn,12,0,40,28
1656969645350,MATH 20B,A01,083756,Briones; Jor-el Thomas Caparas,1,0,36,35
1656969645350,MATH 20B,A02,083757,Briones; Jor-el Thomas Caparas,1,0,36,35
1656969645350,MATH 20B,A03,093475,Briones; Jor-el Thomas Caparas,0,0,36,36
1656969651373,MATH 20C,A01,083760,Briones; Jor-el Thomas Caparas,1,0,35,34
1656969651373,MATH 20C,A02,083761,Briones; Jor-el Thomas Caparas,8,0,35,27
1656969651373,MATH 20C,A03,093476,Briones; Jor-el Thomas Caparas,0,1,36,36
1656969651373,MATH 20C,B01,083762,Bach; Quang Tran,0,0,30,30
1656969657397,MATH 20D,A01,083765,Tran; Brian Kha,4,0,30,26
1656969657397,MATH 20D,A02,083766,Tran; Brian Kha,4,0,30,26
1656969657397,MATH 20D,A03,083767,Tran; Brian Kha,3,0,30,27
1656969663424,MATH 20E,A01,083771,Ganguly; Soumya,5,0,32,27
1656969663424,MATH 20E,A02,083772,Ganguly; Soumya,6,0,32,26
1656969663424,MATH 20E,B01,083773,Ciotti; Benjamin,18,0,35,17
1656969663424,MATH 20E,B02,083774,Ciotti; Benjamin,17,0,35,18
1656969669465,MATH 103A,A01,083777,Greenfeld; Be'Eri,2,0,36,34
1656969669465,MATH 103A,A02,083778,Greenfeld; Be'Eri,5,0,36,31
1656969669465,MATH 103A,A03,093561,Greenfeld; Be'Eri,4,0,36,32
1656969669465,MATH 103A,B01,083779,Greenfeld; Be'Eri,6,0,36,30
1656969669465,MATH 103A,B02,083780,Greenfeld; Be'Eri,2,0,36,34
1656969669465,MATH 103A,B03,093562,Greenfeld; Be'Eri,2,0,36,34
1656969675489,MATH 105,A01,085443,Carter; Anne Toulson,14,0,35,21
1656969675489,MATH 105,A02,093477,Carter; Anne Toulson,20,0,35,15
1656969681512,MATH 109,A01,083213,Ganzberger; Geoffrey Michael,2,0,34,32
1656969681512,MATH 109,A02,083214,Ganzberger; Geoffrey Michael,2,0,34,32
1656969681512,MATH 109,A03,093478,Ganzberger; Geoffrey Michael,1,0,34,33
1656969681512,MATH 109,B01,083215,Ganzberger; Geoffrey Michael,1,0,32,31
1656969681512,MATH 109,B02,083216,Ganzberger; Geoffrey Michael,1,0,32,31
1656969681512,MATH 109,B03,093479,Ganzberger; Geoffrey Michael,6,0,32,26
1656969687549,MATH 142A,A01,083219,Chow; Bennett,6,0,32,26
1656969687549,MATH 142A,A02,083220,Chow; Bennett,10,0,32,22
1656969687549,MATH 142A,A03,093480,Chow; Bennett,7,0,32,25
1656969687549,MATH 142A,B03,093481,Chow; Bennett,7,0,32,25
1656969687549,MATH 142A,B04,093558,Chow; Bennett,11,0,32,21
1656969687549,MATH 142A,B05,093559,Chow; Bennett,6,0,32,26
1656969693572,MATH 193A,A01,083224,Rotar; Vladimir,7,0,34,27
1656969693572,MATH 193A,A02,083225,Rotar; Vladimir,4,0,34,30
1656969693572,MATH 193A,A03,083781,Rotar; Vladimir,1,0,34,33
1656969693572,MATH 193A,A04,083782,Rotar; Vladimir,6,0,34,28
1656969693572,MATH 193A,A05,093482,Rotar; Vladimir,6,0,34,28
1656969699596,MATH 197,001,091859,McAuley; Julian John,9999,0,9999,0
1656969699596,MATH 197,002,095566,Kedlaya; Kiran S.,9997,0,9999,2
1656969699596,MATH 197,003,095567,Xiao; Ming,9999,0,9999,0
1656969699596,MATH 197,004,095571,Perols; Johan Lars,9998,0,9999,1
1656969706665,COGS 9,A01,083615,Shannon; Kyle Michael,7,0,75,68
1656969712688,COGS 11,A01,083617,Boyle; Mary E. T.,20,0,48,28
1656969718711,COGS 13,A01,083071,Bastos; Amalia Pinkusfeld,9,0,71,62
1656969724737,COGS 14A,A01,092681,Semenuks; Arturs,0,1,100,100
1656969730765,COGS 14B,A01,083073,Cheng; Tzu-Han,5,0,63,58
1656969736788,COGS 17,A01,092677,Semenuks; Arturs,4,0,81,77
1656969742810,COGS 100,A01,083619,Allen; Michael Gordon,15,0,70,55
1656969748837,COGS 101A,A01,083621,Davis; Joshua Daniel,9,0,68,59
1656969754861,COGS 101B,A01,091572,Allen; Michael Gordon,8,0,65,57
1656969760886,COGS 101C,A01,083625,Delgado; Tania,17,0,35,18
1656969766912,COGS 107A,A01,083627,Boyle; Mary E. T.,13,0,60,47
1656969772936,COGS 118A,A01,083075,Gupta; Anjum,15,0,76,61
1656969778959,CSE 3,A50,083646,Miranda; Gregory Joseph,22,0,50,28
1656969784984,CSE 8A,A50,083650,Miranda; Gregory Joseph,17,1,56,39
1656969791018,CSE 11,A01,083080,Cao; Yingjun,4,15,40,36
1656969797039,CSE 12,A01,083652,Krause-Levy; Sophia Louisa,20,1,120,100
1656969803062,CSE 15L,A01,083654,Morris; Justin Loren,8,0,50,42
1656969803062,CSE 15L,A02,083655,Morris; Justin Loren,8,0,50,42
1656969809084,CSE 20,A01,083657,Tran; Khoa Dang,37,0,80,43
1656969815113,CSE 21,A01,095574,Bach; Quang Tran,21,0,48,27
1656969821141,CSE 30,A01,083084,Eldon; John,4,0,80,76
1656969821141,CSE 30,B01,095061,Bhaskar; Nishant,6,0,50,44
1656969827164,CSE 100,A01,083659,Cao; Yingjun,3,4,70,67
1656969833186,CSE 134B,A01,083661,Powell; Thomas Allan,19,0,100,81
1656969839209,CSE 140,A01,083663,Gungor; Onat,14,0,85,71
1656969845233,CSE 140L,A01,083088,Eldon; John,16,0,100,84
1656969851260,CSE 175,A01,083665,Kumar; Rakesh,3,0,25,22
1656969857285,CSE 190,A00,092507,Dubnov; Shlomo,7,0,20,13
1656969863309,ECE 45,A01,083139,Congero; Spencer William,5,0,75,70
1656969869335,ECE 65,A50,083695,Saad; Andrew S,12,0,30,18
1656969869335,ECE 65,A51,095125,Saad; Andrew S,25,0,26,1
1656969875367,ECE 109,A01,091882,Touri; Behrouz,16,0,70,54
1656969881395,ECE 180,A00,083140,Abi Samra; Nicholas Camill,1,0,30,29
1656969881395,ECE 180,B00,083141,Abi Samra; Nicholas Camill,0,0,30,30
1656969887418,MATH 10A,A01,083735,Patchell; Gregory David,1,0,30,29
1656969887418,MATH 10A,A02,083736,Patchell; Gregory David,20,0,30,10
1656969887418,MATH 10A,A03,083737,Patchell; Gregory David,15,0,30,15
1656969893443,MATH 10B,A01,083207,Lim; Seonhee,7,0,34,27
1656969893443,MATH 10B,A02,083208,Lim; Seonhee,9,0,35,26
1656969893443,MATH 10B,A03,093472,Lim; Seonhee,4,0,34,30
1656969893443,MATH 10B,B01,083739,Sinha; Shubham,9,0,30,21
1656969899466,MATH 18,A01,083743,Cinel; Cameron Alexander,6,0,30,24
1656969899466,MATH 18,A02,083744,Cinel; Cameron Alexander,15,0,30,15
1656969899466,MATH 18,A03,083745,Cinel; Cameron Alexander,8,0,30,22
1656969899466,MATH 18,B01,083748,Rideout; David Porter,4,0,37,33
1656969899466,MATH 18,B02,083749,Rideout; David Porter,3,0,36,33
1656969899466,MATH 18,B03,083750,Rideout; David Porter,2,0,37,35
1656969899466,MATH 18,B04,083751,Rideout; David Porter,5,0,36,31
1656969899466,MATH 18,B05,093473,Rideout; David Porter,4,0,36,32
1656969899466,MATH 18,B06,093474,Rideout; David Porter,5,0,36,31
1656969905492,MATH 20A,A01,083754,Zheng; Zequn,12,0,40,28
1656969911516,MATH 20B,A01,083756,Briones; Jor-el Thomas Caparas,1,0,36,35
1656969911516,MATH 20B,A02,083757,Briones; Jor-el Thomas Caparas,1,0,36,35
1656969911516,MATH 20B,A03,093475,Briones; Jor-el Thomas Caparas,0,0,36,36
1656969917540,MATH 20C,A01,083760,Briones; Jor-el Thomas Caparas,1,0,35,34
1656969917540,MATH 20C,A02,083761,Briones; Jor-el Thomas Caparas,8,0,35,27
1656969917540,MATH 20C,A03,093476,Briones; Jor-el Thomas Caparas,0,1,36,36
1656969917540,MATH 20C,B01,083762,Bach; Quang Tran,0,0,30,30
1656969923564,MATH 20D,A01,083765,Tran; Brian Kha,4,0,30,26
1656969923564,MATH 20D,A02,083766,Tran; Brian Kha,4,0,30,26
1656969923564,MATH 20D,A03,083767,Tran; Brian Kha,3,0,30,27
1656969929601,MATH 20E,A01,083771,Ganguly; Soumya,5,0,32,27
1656969929601,MATH 20E,A02,083772,Ganguly; Soumya,6,0,32,26
1656969929601,MATH 20E,B01,083773,Ciotti; Benjamin,18,0,35,17
1656969929601,MATH 20E,B02,083774,Ciotti; Benjamin,17,0,35,18
1656969935626,MATH 103A,A01,083777,Greenfeld; Be'Eri,2,0,36,34
1656969935626,MATH 103A,A02,083778,Greenfeld; Be'Eri,5,0,36,31
1656969935626,MATH 103A,A03,093561,Greenfeld; Be'Eri,4,0,36,32
1656969935626,MATH 103A,B01,083779,Greenfeld; Be'Eri,6,0,36,30
1656969935626,MATH 103A,B02,083780,Greenfeld; Be'Eri,2,0,36,34
1656969935626,MATH 103A,B03,093562,Greenfeld; Be'Eri,2,0,36,34
1656969941653,MATH 105,A01,085443,Carter; Anne Toulson,14,0,35,21
1656969941653,MATH 105,A02,093477,Carter; Anne Toulson,20,0,35,15
1656969947683,MATH 109,A01,083213,Ganzberger; Geoffrey Michael,2,0,34,32
1656969947683,MATH 109,A02,083214,Ganzberger; Geoffrey Michael,2,0,34,32
1656969947683,MATH 109,A03,093478,Ganzberger; Geoffrey Michael,1,0,34,33
1656969947683,MATH 109,B01,083215,Ganzberger; Geoffrey Michael,1,0,32,31
1656969947683,MATH 109,B02,083216,Ganzberger; Geoffrey Michael,1,0,32,31
1656969947683,MATH 109,B03,093479,Ganzberger; Geoffrey Michael,6,0,32,26
1656969953708,MATH 142A,A01,083219,Chow; Bennett,6,0,32,26
1656969953708,MATH 142A,A02,083220,Chow; Bennett,10,0,32,22
1656969953708,MATH 142A,A03,093480,Chow; Bennett,7,0,32,25
1656969953708,MATH 142A,B03,093481,Chow; Bennett,7,0,32,25
1656969953708,MATH 142A,B04,093558,Chow; Bennett,11,0,32,21
1656969953708,MATH 142A,B05,093559,Chow; Bennett,6,0,32,26
1656969959736,MATH 193A,A01,083224,Rotar; Vladimir,7,0,34,27
1656969959736,MATH 193A,A02,083225,Rotar; Vladimir,4,0,34,30
1656969959736,MATH 193A,A03,083781,Rotar; Vladimir,1,0,34,33
1656969959736,MATH 193A,A04,083782,Rotar; Vladimir,6,0,34,28
1656969959736,MATH 193A,A05,093482,Rotar; Vladimir,6,0,34,28
1656969965760,MATH 197,001,091859,McAuley; Julian John,9999,0,9999,0
1656969965760,MATH 197,002,095566,Kedlaya; Kiran S.,9997,0,9999,2
1656969965760,MATH 197,003,095567,Xiao; Ming,9999,0,9999,0
1656969965760,MATH 197,004,095571,Perols; Johan Lars,9998,0,9999,1
1656969972816,COGS 9,A01,083615,Shannon; Kyle Michael,7,0,75,68
1656969978839,COGS 11,A01,083617,Boyle; Mary E. T.,20,0,48,28
1656969984861,COGS 13,A01,083071,Bastos; Amalia Pinkusfeld,9,0,71,62
1656969990887,COGS 14A,A01,092681,Semenuks; Arturs,0,1,100,100
1656969996913,COGS 14B,A01,083073,Cheng; Tzu-Han,5,0,63,58
1656970002939,COGS 17,A01,092677,Semenuks; Arturs,4,0,81,77
1656970008964,COGS 100,A01,083619,Allen; Michael Gordon,15,0,70,55
1656970014985,COGS 101A,A01,083621,Davis; Joshua Daniel,9,0,68,59
1656970021008,COGS 101B,A01,091572,Allen; Michael Gordon,8,0,65,57
1656970027034,COGS 101C,A01,083625,Delgado; Tania,17,0,35,18
1656970033057,COGS 107A,A01,083627,Boyle; Mary E. T.,13,0,60,47
1656970039079,COGS 118A,A01,083075,Gupta; Anjum,15,0,76,61
1656970045104,CSE 3,A50,083646,Miranda; Gregory Joseph,22,0,50,28
1656970051128,CSE 8A,A50,083650,Miranda; Gregory Joseph,17,1,56,39
1656970057155,CSE 11,A01,083080,Cao; Yingjun,4,15,40,36
1656970063177,CSE 12,A01,083652,Krause-Levy; Sophia Louisa,20,1,120,100
1656970069204,CSE 15L,A01,083654,Morris; Justin Loren,8,0,50,42
1656970069204,CSE 15L,A02,083655,Morris; Justin Loren,8,0,50,42
1656970075228,CSE 20,A01,083657,Tran; Khoa Dang,37,0,80,43
1656970081249,CSE 21,A01,095574,Bach; Quang Tran,21,0,48,27
1656970087276,CSE 30,A01,083084,Eldon; John,4,0,80,76
1656970087276,CSE 30,B01,095061,Bhaskar; Nishant,6,0,50,44
1656970093299,CSE 100,A01,083659,Cao; Yingjun,3,4,70,67
1656970099326,CSE 134B,A01,083661,Powell; Thomas Allan,19,0,100,81
1656970105351,CSE 140,A01,083663,Gungor; Onat,14,0,85,71
1656970111390,CSE 140L,A01,083088,Eldon; John,16,0,100,84
1656970117410,CSE 175,A01,083665,Kumar; Rakesh,3,0,25,22
1656970123433,CSE 190,A00,092507,Dubnov; Shlomo,7,0,20,13
1656970129458,ECE 45,A01,083139,Congero; Spencer William,5,0,75,70
1656970135482,ECE 65,A50,083695,Saad; Andrew S,12,0,30,18
1656970135482,ECE 65,A51,095125,Saad; Andrew S,25,0,26,1
1656970141516,ECE 109,A01,091882,Touri; Behrouz,16,0,70,54
1656970147538,ECE 180,A00,083140,Abi Samra; Nicholas Camill,1,0,30,29
1656970147538,ECE 180,B00,083141,Abi Samra; Nicholas Camill,0,0,30,30
1656970153566,MATH 10A,A01,083735,Patchell; Gregory David,1,0,30,29
1656970153566,MATH 10A,A02,083736,Patchell; Gregory David,20,0,30,10
1656970153566,MATH 10A,A03,083737,Patchell; Gregory David,15,0,30,15
1656970159596,MATH 10B,A01,083207,Lim; Seonhee,7,0,34,27
1656970159596,MATH 10B,A02,083208,Lim; Seonhee,9,0,35,26
1656970159596,MATH 10B,A03,093472,Lim; Seonhee,4,0,34,30
1656970159596,MATH 10B,B01,083739,Sinha; Shubham,9,0,30,21
1656970165627,MATH 18,A01,083743,Cinel; Cameron Alexander,6,0,30,24
1656970165627,MATH 18,A02,083744,Cinel; Cameron Alexander,15,0,30,15
1656970165627,MATH 18,A03,083745,Cinel; Cameron Alexander,8,0,30,22
1656970165627,MATH 18,B01,083748,Rideout; David Porter,4,0,37,33
1656970165627,MATH 18,B02,083749,Rideout; David Porter,3,0,36,33
1656970165627,MATH 18,B03,083750,Rideout; David Porter,2,0,37,35
1656970165627,MATH 18,B04,083751,Rideout; David Porter,5,0,36,31
1656970165627,MATH 18,B05,093473,Rideout; David Porter,4,0,36,32
1656970165627,MATH 18,B06,093474,Rideout; David Porter,5,0,36,31
1656970171663,MATH 20A,A01,083754,Zheng; Zequn,12,0,40,28
1656970177685,MATH 20B,A01,083756,Briones; Jor-el Thomas Caparas,1,0,36,35
1656970177685,MATH 20B,A02,083757,Briones; Jor-el Thomas Caparas,1,0,36,35
1656970177685,MATH 20B,A03,093475,Briones; Jor-el Thomas Caparas,0,0,36,36
1656970183708,MATH 20C,A01,083760,Briones; Jor-el Thomas Caparas,1,0,35,34
1656970183708,MATH 20C,A02,083761,Briones; Jor-el Thomas Caparas,8,0,35,27
1656970183708,MATH 20C,A03,093476,Briones; Jor-el Thomas Caparas,0,1,36,36
1656970183708,MATH 20C,B01,083762,Bach; Quang Tran,0,0,30,30
1656970189735,MATH 20D,A01,083765,Tran; Brian Kha,4,0,30,26
1656970189735,MATH 20D,A02,083766,Tran; Brian Kha,4,0,30,26
1656970189735,MATH 20D,A03,083767,Tran; Brian Kha,3,0,30,27
1656970195857,MATH 20E,A01,083771,Ganguly; Soumya,5,0,32,27
1656970195857,MATH 20E,A02,083772,Ganguly; Soumya,6,0,32,26
1656970195857,MATH 20E,B01,083773,Ciotti; Benjamin,18,0,35,17
1656970195857,MATH 20E,B02,083774,Ciotti; Benjamin,17,0,35,18
1656970201887,MATH 103A,A01,083777,Greenfeld; Be'Eri,2,0,36,34
1656970201887,MATH 103A,A02,083778,Greenfeld; Be'Eri,5,0,36,31
1656970201887,MATH 103A,A03,093561,Greenfeld; Be'Eri,4,0,36,32
1656970201887,MATH 103A,B01,083779,Greenfeld; Be'Eri,6,0,36,30
1656970201887,MATH 103A,B02,083780,Greenfeld; Be'Eri,2,0,36,34
1656970201887,MATH 103A,B03,093562,Greenfeld; Be'Eri,2,0,36,34
1656970207919,MATH 105,A01,085443,Carter; Anne Toulson,14,0,35,21
1656970207919,MATH 105,A02,093477,Carter; Anne Toulson,20,0,35,15
1656970213941,MATH 109,A01,083213,Ganzberger; Geoffrey Michael,2,0,34,32
1656970213941,MATH 109,A02,083214,Ganzberger; Geoffrey Michael,2,0,34,32
1656970213941,MATH 109,A03,093478,Ganzberger; Geoffrey Michael,1,0,34,33
1656970213941,MATH 109,B01,083215,Ganzberger; Geoffrey Michael,1,0,32,31
1656970213941,MATH 109,B02,083216,Ganzberger; Geoffrey Michael,1,0,32,31
1656970213941,MATH 109,B03,093479,Ganzberger; Geoffrey Michael,6,0,32,26
1656970219972,MATH 142A,A01,083219,Chow; Bennett,6,0,32,26
1656970219972,MATH 142A,A02,083220,Chow; Bennett,10,0,32,22
1656970219972,MATH 142A,A03,093480,Chow; Bennett,7,0,32,25
1656970219972,MATH 142A,B03,093481,Chow; Bennett,7,0,32,25
1656970219972,MATH 142A,B04,093558,Chow; Bennett,11,0,32,21
1656970219972,MATH 142A,B05,093559,Chow; Bennett,6,0,32,26
1656970225993,MATH 193A,A01,083224,Rotar; Vladimir,7,0,34,27
1656970225993,MATH 193A,A02,083225,Rotar; Vladimir,4,0,34,30
1656970225993,MATH 193A,A03,083781,Rotar; Vladimir,1,0,34,33
1656970225993,MATH 193A,A04,083782,Rotar; Vladimir,6,0,34,28
1656970225993,MATH 193A,A05,093482,Rotar; Vladimir,6,0,34,28
1656970232019,MATH 197,001,091859,McAuley; Julian John,9999,0,9999,0
1656970232019,MATH 197,002,095566,Kedlaya; Kiran S.,9997,0,9999,2
1656970232019,MATH 197,003,095567,Xiao; Ming,9999,0,9999,0
1656970232019,MATH 197,004,095571,Perols; Johan Lars,9998,0,9999,1
1656970239070,COGS 9,A01,083615,Shannon; Kyle Michael,7,0,75,68
1656970245098,COGS 11,A01,083617,Boyle; Mary E. T.,20,0,48,28
1656970251131,COGS 13,A01,083071,Bastos; Amalia Pinkusfeld,9,0,71,62
1656970257157,COGS 14A,A01,092681,Semenuks; Arturs,0,1,100,100
1656970263178,COGS 14B,A01,083073,Cheng; Tzu-Han,5,0,63,58
1656970269202,COGS 17,A01,092677,Semenuks; Arturs,4,0,81,77
1656970275228,COGS 100,A01,083619,Allen; Michael Gordon,15,0,70,55
1656970281261,COGS 101A,A01,083621,Davis; Joshua Daniel,9,0,68,59
1656970287290,COGS 101B,A01,091572,Allen; Michael Gordon,8,0,65,57
1656970293313,COGS 101C,A01,083625,Delgado; Tania,17,0,35,18
1656970299339,COGS 107A,A01,083627,Boyle; Mary E. T.,13,0,60,47
1656970305362,COGS 118A,A01,083075,Gupta; Anjum,15,0,76,61
1656970311388,CSE 3,A50,083646,Miranda; Gregory Joseph,22,0,50,28
1656970317412,CSE 8A,A50,083650,Miranda; Gregory Joseph,17,1,56,39
1656970323435,CSE 11,A01,083080,Cao; Yingjun,4,15,40,36
1656970329462,CSE 12,A01,083652,Krause-Levy; Sophia Louisa,20,1,120,100
1656970335483,CSE 15L,A01,083654,Morris; Justin Loren,8,0,50,42
1656970335483,CSE 15L,A02,083655,Morris; Justin Loren,8,0,50,42
1656970341505,CSE 20,A01,083657,Tran; Khoa Dang,37,0,80,43
1656970347528,CSE 21,A01,095574,Bach; Quang Tran,21,0,48,27
1656970353557,CSE 30,A01,083084,Eldon; John,4,0,80,76
1656970353557,CSE 30,B01,095061,Bhaskar; Nishant,6,0,50,44
1656970359579,CSE 100,A01,083659,Cao; Yingjun,3,4,70,67
1656970365603,CSE 134B,A01,083661,Powell; Thomas Allan,19,0,100,81
1656970371630,CSE 140,A01,083663,Gungor; Onat,14,0,85,71
1656970377655,CSE 140L,A01,083088,Eldon; John,16,0,100,84
1656970383748,CSE 175,A01,083665,Kumar; Rakesh,3,0,25,22
1656970389774,CSE 190,A00,092507,Dubnov; Shlomo,7,0,20,13
1656970395800,ECE 45,A01,083139,Congero; Spencer William,5,0,75,70
1656970401826,ECE 65,A50,083695,Saad; Andrew S,12,0,30,18
1656970401826,ECE 65,A51,095125,Saad; Andrew S,25,0,26,1
1656970407850,ECE 109,A01,091882,Touri; Behrouz,16,0,70,54
1656970413876,ECE 180,A00,083140,Abi Samra; Nicholas Camill,1,0,30,29
1656970413876,ECE 180,B00,083141,Abi Samra; Nicholas Camill,0,0,30,30
1656970419902,MATH 10A,A01,083735,Patchell; Gregory David,1,0,30,29
1656970419902,MATH 10A,A02,083736,Patchell; Gregory David,20,0,30,10
1656970419902,MATH 10A,A03,083737,Patchell; Gregory David,15,0,30,15
1656970425933,MATH 10B,A01,083207,Lim; Seonhee,7,0,34,27
1656970425933,MATH 10B,A02,083208,Lim; Seonhee,9,0,35,26
1656970425933,MATH 10B,A03,093472,Lim; Seonhee,4,0,34,30
1656970425933,MATH 10B,B01,083739,Sinha; Shubham,9,0,30,21
1656970431963,MATH 18,A01,083743,Cinel; Cameron Alexander,6,0,30,24
1656970431963,MATH 18,A02,083744,Cinel; Cameron Alexander,15,0,30,15
1656970431963,MATH 18,A03,083745,Cinel; Cameron Alexander,8,0,30,22
1656970431963,MATH 18,B01,083748,Rideout; David Porter,4,0,37,33
1656970431963,MATH 18,B02,083749,Rideout; David Porter,3,0,36,33
1656970431963,MATH 18,B03,083750,Rideout; David Porter,2,0,37,35
1656970431963,MATH 18,B04,083751,Rideout; David Porter,5,0,36,31
1656970431963,MATH 18,B05,093473,Rideout; David Porter,4,0,36,32
1656970431963,MATH 18,B06,093474,Rideout; David Porter,5,0,36,31
1656970437988,MATH 20A,A01,083754,Zheng; Zequn,12,0,40,28
1656970444016,MATH 20B,A01,083756,Briones; Jor-el Thomas Caparas,1,0,36,35
1656970444016,MATH 20B,A02,083757,Briones; Jor-el Thomas Caparas,1,0,36,35
1656970444016,MATH 20B,A03,093475,Briones; Jor-el Thomas Caparas,0,0,36,36
1656970450042,MATH 20C,A01,083760,Briones; Jor-el Thomas Caparas,1,0,35,34
1656970450042,MATH 20C,A02,083761,Briones; Jor-el Thomas Caparas,8,0,35,27
1656970450042,MATH 20C,A03,093476,Briones; Jor-el Thomas Caparas,0,1,36,36
1656970450042,MATH 20C,B01,083762,Bach; Quang Tran,0,0,30,30
1656970456068,MATH 20D,A01,083765,Tran; Brian Kha,4,0,30,26
1656970456068,MATH 20D,A02,083766,Tran; Brian Kha,4,0,30,26
1656970456068,MATH 20D,A03,083767,Tran; Brian Kha,3,0,30,27
1656970462096,MATH 20E,A01,083771,Ganguly; Soumya,5,0,32,27
1656970462096,MATH 20E,A02,083772,Ganguly; Soumya,6,0,32,26
1656970462096,MATH 20E,B01,083773,Ciotti; Benjamin,18,0,35,17
1656970462096,MATH 20E,B02,083774,Ciotti; Benjamin,17,0,35,18
1656970468125,MATH 103A,A01,083777,Greenfeld; Be'Eri,2,0,36,34
1656970468125,MATH 103A,A02,083778,Greenfeld; Be'Eri,5,0,36,31
1656970468125,MATH 103A,A03,093561,Greenfeld; Be'Eri,4,0,36,32
1656970468125,MATH 103A,B01,083779,Greenfeld; Be'Eri,6,0,36,30
1656970468125,MATH 103A,B02,083780,Greenfeld; Be'Eri,2,0,36,34
1656970468125,MATH 103A,B03,093562,Greenfeld; Be'Eri,2,0,36,34
1656970474152,MATH 105,A01,085443,Carter; Anne Toulson,14,0,35,21
1656970474152,MATH 105,A02,093477,Carter; Anne Toulson,20,0,35,15
1656970480177,MATH 109,A01,083213,Ganzberger; Geoffrey Michael,2,0,34,32
1656970480177,MATH 109,A02,083214,Ganzberger; Geoffrey Michael,2,0,34,32
1656970480177,MATH 109,A03,093478,Ganzberger; Geoffrey Michael,1,0,34,33
1656970480177,MATH 109,B01,083215,Ganzberger; Geoffrey Michael,1,0,32,31
1656970480177,MATH 109,B02,083216,Ganzberger; Geoffrey Michael,1,0,32,31
1656970480177,MATH 109,B03,093479,Ganzberger; Geoffrey Michael,6,0,32,26
1656970486204,MATH 142A,A01,083219,Chow; Bennett,6,0,32,26
1656970486204,MATH 142A,A02,083220,Chow; Bennett,10,0,32,22
1656970486204,MATH 142A,A03,093480,Chow; Bennett,7,0,32,25
1656970486204,MATH 142A,B03,093481,Chow; Bennett,7,0,32,25
1656970486204,MATH 142A,B04,093558,Chow; Bennett,11,0,32,21
1656970486204,MATH 142A,B05,093559,Chow; Bennett,6,0,32,26
1656970492231,MATH 193A,A01,083224,Rotar; Vladimir,7,0,34,27
1656970492231,MATH 193A,A02,083225,Rotar; Vladimir,4,0,34,30
1656970492231,MATH 193A,A03,083781,Rotar; Vladimir,1,0,34,33
1656970492231,MATH 193A,A04,083782,Rotar; Vladimir,6,0,34,28
1656970492231,MATH 193A,A05,093482,Rotar; Vladimir,6,0,34,28
1656970498255,MATH 197,001,091859,McAuley; Julian John,9999,0,9999,0
1656970498255,MATH 197,002,095566,Kedlaya; Kiran S.,9997,0,9999,2
1656970498255,MATH 197,003,095567,Xiao; Ming,9999,0,9999,0
1656970498255,MATH 197,004,095571,Perols; Johan Lars,9998,0,9999,1
1656970505316,COGS 9,A01,083615,Shannon; Kyle Michael,7,0,75,68
1656970511341,COGS 11,A01,083617,Boyle; Mary E. T.,20,0,48,28
1656970517367,COGS 13,A01,083071,Bastos; Amalia Pinkusfeld,9,0,71,62
1656970523392,COGS 14A,A01,092681,Semenuks; Arturs,0,1,100,100
1656970529424,COGS 14B,A01,083073,Cheng; Tzu-Han,5,0,63,58
1656970535450,COGS 17,A01,092677,Semenuks; Arturs,4,0,81,77
1656970541485,COGS 100,A01,083619,Allen; Michael Gordon,15,0,70,55
1656970547517,COGS 101A,A01,083621,Davis; Joshua Daniel,9,0,68,59
1656970553547,COGS 101B,A01,091572,Allen; Michael Gordon,8,0,65,57
1656970559575,COGS 101C,A01,083625,Delgado; Tania,17,0,35,18
1656970565601,COGS 107A,A01,083627,Boyle; Mary E. T.,13,0,60,47
1656970571633,COGS 118A,A01,083075,Gupta; Anjum,15,0,76,61
1656970577665,CSE 3,A50,083646,Miranda; Gregory Joseph,22,0,50,28
1656970583687,CSE 8A,A50,083650,Miranda; Gregory Joseph,17,1,56,39
1656970589712,CSE 11,A01,083080,Cao; Yingjun,4,15,40,36
1656970595738,CSE 12,A01,083652,Krause-Levy; Sophia Louisa,20,1,120,100
1656970601761,CSE 15L,A01,083654,Morris; Justin Loren,8,0,50,42
1656970601761,CSE 15L,A02,083655,Morris; Justin Loren,8,0,50,42
1656970607784,CSE 20,A01,083657,Tran; Khoa Dang,37,0,80,43
1656970613815,CSE 21,A01,095574,Bach; Quang Tran,21,0,48,27
1656970619839,CSE 30,A01,083084,Eldon; John,4,0,80,76
1656970619839,CSE 30,B01,095061,Bhaskar; Nishant,6,0,50,44
1656970625861,CSE 100,A01,083659,Cao; Yingjun,3,4,70,67
1656970631886,CSE 134B,A01,083661,Powell; Thomas Allan,19,0,100,81
1656970637908,CSE 140,A01,083663,Gungor; Onat,14,0,85,71
1656970643935,CSE 140L,A01,083088,Eldon; John,16,0,100,84
1656970649958,CSE 175,A01,083665,Kumar; Rakesh,3,0,25,22
1656970655988,CSE 190,A00,092507,Dubnov; Shlomo,7,0,20,13
1656970662010,ECE 45,A01,083139,Congero; Spencer William,5,0,75,70
1656970668035,ECE 65,A50,083695,Saad; Andrew S,12,0,30,18
1656970668035,ECE 65,A51,095125,Saad; Andrew S,25,0,26,1
1656970674060,ECE 109,A01,091882,Touri; Behrouz,16,0,70,54
1656970680085,ECE 180,A00,083140,Abi Samra; Nicholas Camill,1,0,30,29
1656970680085,ECE 180,B00,083141,Abi Samra; Nicholas Camill,0,0,30,30
1656970686108,MATH 10A,A01,083735,Patchell; Gregory David,1,0,30,29
1656970686108,MATH 10A,A02,083736,Patchell; Gregory David,20,0,30,10
1656970686108,MATH 10A,A03,083737,Patchell; Gregory David,15,0,30,15
1656970692142,MATH 10B,A01,083207,Lim; Seonhee,7,0,34,27
1656970692142,MATH 10B,A02,083208,Lim; Seonhee,9,0,35,26
1656970692142,MATH 10B,A03,093472,Lim; Seonhee,4,0,34,30
1656970692142,MATH 10B,B01,083739,Sinha; Shubham,9,0,30,21
1656970698163,MATH 18,A01,083743,Cinel; Cameron Alexander,6,0,30,24
1656970698163,MATH 18,A02,083744,Cinel; Cameron Alexander,15,0,30,15
1656970698163,MATH 18,A03,083745,Cinel; Cameron Alexander,8,0,30,22
1656970698163,MATH 18,B01,083748,Rideout; David Porter,4,0,37,33
1656970698163,MATH 18,B02,083749,Rideout; David Porter,3,0,36,33
1656970698163,MATH 18,B03,083750,Rideout; David Porter,2,0,37,35
1656970698163,MATH 18,B04,083751,Rideout; David Porter,5,0,36,31
1656970698163,MATH 18,B05,093473,Rideout; David Porter,4,0,36,32
1656970698163,MATH 18,B06,093474,Rideout; David Porter,5,0,36,31
1656970704186,MATH 20A,A01,083754,Zheng; Zequn,12,0,40,28
1656970710214,MATH 20B,A01,083756,Briones; Jor-el Thomas Caparas,1,0,36,35
1656970710214,MATH 20B,A02,083757,Briones; Jor-el Thomas Caparas,1,0,36,35
1656970710214,MATH 20B,A03,093475,Briones; Jor-el Thomas Caparas,0,0,36,36
1656970716237,MATH 20C,A01,083760,Briones; Jor-el Thomas Caparas,1,0,35,34
1656970716237,MATH 20C,A02,083761,Briones; Jor-el Thomas Caparas,8,0,35,27
1656970716237,MATH 20C,A03,093476,Briones; Jor-el Thomas Caparas,0,1,36,36
1656970716237,MATH 20C,B01,083762,Bach; Quang Tran,0,0,30,30
1656970722260,MATH 20D,A01,083765,Tran; Brian Kha,4,0,30,26
1656970722260,MATH 20D,A02,083766,Tran; Brian Kha,4,0,30,26
1656970722260,MATH 20D,A03,083767,Tran; Brian Kha,3,0,30,27
1656970728296,MATH 20E,A01,083771,Ganguly; Soumya,5,0,32,27
1656970728296,MATH 20E,A02,083772,Ganguly; Soumya,6,0,32,26
1656970728296,MATH 20E,B01,083773,Ciotti; Benjamin,18,0,35,17
1656970728296,MATH 20E,B02,083774,Ciotti; Benjamin,17,0,35,18
1656970734325,MATH 103A,A01,083777,Greenfeld; Be'Eri,2,0,36,34
1656970734325,MATH 103A,A02,083778,Greenfeld; Be'Eri,5,0,36,31
1656970734325,MATH 103A,A03,093561,Greenfeld; Be'Eri,4,0,36,32
1656970734325,MATH 103A,B01,083779,Greenfeld; Be'Eri,6,0,36,30
1656970734325,MATH 103A,B02,083780,Greenfeld; Be'Eri,2,0,36,34
1656970734325,MATH 103A,B03,093562,Greenfeld; Be'Eri,2,0,36,34
1656970740351,MATH 105,A01,085443,Carter; Anne Toulson,14,0,35,21
1656970740351,MATH 105,A02,093477,Carter; Anne Toulson,20,0,35,15
1656970746375,MATH 109,A01,083213,Ganzberger; Geoffrey Michael,2,0,34,32
1656970746375,MATH 109,A02,083214,Ganzberger; Geoffrey Michael,2,0,34,32
1656970746375,MATH 109,A03,093478,Ganzberger; Geoffrey Michael,1,0,34,33
1656970746375,MATH 109,B01,083215,Ganzberger; Geoffrey Michael,1,0,32,31
1656970746375,MATH 109,B02,083216,Ganzberger; Geoffrey Michael,1,0,32,31
1656970746375,MATH 109,B03,093479,Ganzberger; Geoffrey Michael,6,0,32,26
1656970752399,MATH 142A,A01,083219,Chow; Bennett,6,0,32,26
1656970752399,MATH 142A,A02,083220,Chow; Bennett,10,0,32,22
1656970752399,MATH 142A,A03,093480,Chow; Bennett,7,0,32,25
1656970752399,MATH 142A,B03,093481,Chow; Bennett,7,0,32,25
1656970752399,MATH 142A,B04,093558,Chow; Bennett,11,0,32,21
1656970752399,MATH 142A,B05,093559,Chow; Bennett,6,0,32,26
1656970758426,MATH 193A,A01,083224,Rotar; Vladimir,7,0,34,27
1656970758426,MATH 193A,A02,083225,Rotar; Vladimir,4,0,34,30
1656970758426,MATH 193A,A03,083781,Rotar; Vladimir,1,0,34,33
1656970758426,MATH 193A,A04,083782,Rotar; Vladimir,6,0,34,28
1656970758426,MATH 193A,A05,093482,Rotar; Vladimir,6,0,34,28
1656970764448,MATH 197,001,091859,McAuley; Julian John,9999,0,9999,0
1656970764448,MATH 197,002,095566,Kedlaya; Kiran S.,9997,0,9999,2
1656970764448,MATH 197,003,095567,Xiao; Ming,9999,0,9999,0
1656970764448,MATH 197,004,095571,Perols; Johan Lars,9998,0,9999,1
1656970771514,COGS 9,A01,083615,Shannon; Kyle Michael,7,0,75,68
1656970777539,COGS 11,A01,083617,Boyle; Mary E. T.,20,0,48,28
1656970783572,COGS 13,A01,083071,Bastos; Amalia Pinkusfeld,9,0,71,62
1656970789684,COGS 14A,A01,092681,Semenuks; Arturs,0,1,100,100
1656970795710,COGS 14B,A01,083073,Cheng; Tzu-Han,5,0,63,58
1656970801735,COGS 17,A01,092677,Semenuks; Arturs,4,0,81,77
1656970807757,COGS 100,A01,083619,Allen; Michael Gordon,15,0,70,55
1656970813780,COGS 101A,A01,083621,Davis; Joshua Daniel,9,0,68,59
1656970819803,COGS 101B,A01,091572,Allen; Michael Gordon,8,0,65,57
1656970825826,COGS 101C,A01,083625,Delgado; Tania,17,0,35,18
1656970831850,COGS 107A,A01,083627,Boyle; Mary E. T.,13,0,60,47
1656970837877,COGS 118A,A01,083075,Gupta; Anjum,15,0,76,61
1656970843898,CSE 3,A50,083646,Miranda; Gregory Joseph,22,0,50,28
1656970849921,CSE 8A,A50,083650,Miranda; Gregory Joseph,17,1,56,39
1656970855943,CSE 11,A01,083080,Cao; Yingjun,4,15,40,36
1656970861966,CSE 12,A01,083652,Krause-Levy; Sophia Louisa,20,1,120,100
1656970867992,CSE 15L,A01,083654,Morris; Justin Loren,8,0,50,42
1656970867992,CSE 15L,A02,083655,Morris; Justin Loren,8,0,50,42
1656970874014,CSE 20,A01,083657,Tran; Khoa Dang,37,0,80,43
1656970880041,CSE 21,A01,095574,Bach; Quang Tran,21,0,48,27
1656970886068,CSE 30,A01,083084,Eldon; John,4,0,80,76
1656970886068,CSE 30,B01,095061,Bhaskar; Nishant,6,0,50,44
1656970892090,CSE 100,A01,083659,Cao; Yingjun,3,4,70,67
1656970898111,CSE 134B,A01,083661,Powell; Thomas Allan,19,0,100,81
1656970904135,CSE 140,A01,083663,Gungor; Onat,14,0,85,71
1656970910166,CSE 140L,A01,083088,Eldon; John,16,0,100,84
1656970916188,CSE 175,A01,083665,Kumar; Rakesh,3,0,25,22
1656970922213,CSE 190,A00,092507,Dubnov; Shlomo,7,0,20,13
1656970928242,ECE 45,A01,083139,Congero; Spencer William,5,0,75,70
1656970940156,ECE 65,A50,083695,Saad; Andrew S,12,0,30,18
1656970940156,ECE 65,A51,095125,Saad; Andrew S,25,0,26,1
1656970946178,ECE 109,A01,091882,Touri; Behrouz,16,0,70,54
1656970952201,ECE 180,A00,083140,Abi Samra; Nicholas Camill,1,0,30,29
1656970952201,ECE 180,B00,083141,Abi Samra; Nicholas Camill,0,0,30,30
1656970958226,MATH 10A,A01,083735,Patchell; Gregory David,1,0,30,29
1656970958226,MATH 10A,A02,083736,Patchell; Gregory David,20,0,30,10
1656970958226,MATH 10A,A03,083737,Patchell; Gregory David,15,0,30,15
1656970964263,MATH 10B,A01,083207,Lim; Seonhee,7,0,34,27
1656970964263,MATH 10B,A02,083208,Lim; Seonhee,9,0,35,26
1656970964263,MATH 10B,A03,093472,Lim; Seonhee,4,0,34,30
1656970964263,MATH 10B,B01,083739,Sinha; Shubham,9,0,30,21
1656970970287,MATH 18,A01,083743,Cinel; Cameron Alexander,6,0,30,24
1656970970287,MATH 18,A02,083744,Cinel; Cameron Alexander,15,0,30,15
1656970970287,MATH 18,A03,083745,Cinel; Cameron Alexander,8,0,30,22
1656970970287,MATH 18,B01,083748,Rideout; David Porter,4,0,37,33
1656970970287,MATH 18,B02,083749,Rideout; David Porter,3,0,36,33
1656970970287,MATH 18,B03,083750,Rideout; David Porter,2,0,37,35
1656970970287,MATH 18,B04,083751,Rideout; David Porter,5,0,36,31
1656970970287,MATH 18,B05,093473,Rideout; David Porter,4,0,36,32
1656970970287,MATH 18,B06,093474,Rideout; David Porter,5,0,36,31
1656970976311,MATH 20A,A01,083754,Zheng; Zequn,12,0,40,28
1656970982333,MATH 20B,A01,083756,Briones; Jor-el Thomas Caparas,1,0,36,35
1656970982333,MATH 20B,A02,083757,Briones; Jor-el Thomas Caparas,1,0,36,35
1656970982333,MATH 20B,A03,093475,Briones; Jor-el Thomas Caparas,0,0,36,36
1656970988357,MATH 20C,A01,083760,Briones; Jor-el Thomas Caparas,1,0,35,34
1656970988357,MATH 20C,A02,083761,Briones; Jor-el Thomas Caparas,8,0,35,27
1656970988357,MATH 20C,A03,093476,Briones; Jor-el Thomas Caparas,0,1,36,36
1656970988357,MATH 20C,B01,083762,Bach; Quang Tran,0,0,30,30
1656970994384,MATH 20D,A01,083765,Tran; Brian Kha,4,0,30,26
1656970994384,MATH 20D,A02,083766,Tran; Brian Kha,4,0,30,26
1656970994384,MATH 20D,A03,083767,Tran; Brian Kha,3,0,30,27
1656971000410,MATH 20E,A01,083771,Ganguly; Soumya,5,0,32,27
1656971000410,MATH 20E,A02,083772,Ganguly; Soumya,6,0,32,26
1656971000410,MATH 20E,B01,083773,Ciotti; Benjamin,18,0,35,17
1656971000410,MATH 20E,B02,083774,Ciotti; Benjamin,17,0,35,18
1656971006434,MATH 103A,A01,083777,Greenfeld; Be'Eri,2,0,36,34
1656971006434,MATH 103A,A02,083778,Greenfeld; Be'Eri,5,0,36,31
1656971006434,MATH 103A,A03,093561,Greenfeld; Be'Eri,4,0,36,32
1656971006434,MATH 103A,B01,083779,Greenfeld; Be'Eri,6,0,36,30
1656971006434,MATH 103A,B02,083780,Greenfeld; Be'Eri,2,0,36,34
1656971006434,MATH 103A,B03,093562,Greenfeld; Be'Eri,2,0,36,34
1656971012455,MATH 105,A01,085443,Carter; Anne Toulson,14,0,35,21
1656971012455,MATH 105,A02,093477,Carter; Anne Toulson,20,0,35,15
1656971018482,MATH 109,A01,083213,Ganzberger; Geoffrey Michael,2,0,34,32
1656971018482,MATH 109,A02,083214,Ganzberger; Geoffrey Michael,2,0,34,32
1656971018482,MATH 109,A03,093478,Ganzberger; Geoffrey Michael,1,0,34,33
1656971018482,MATH 109,B01,083215,Ganzberger; Geoffrey Michael,1,0,32,31
1656971018482,MATH 109,B02,083216,Ganzberger; Geoffrey Michael,1,0,32,31
1656971018482,MATH 109,B03,093479,Ganzberger; Geoffrey Michael,6,0,32,26
1656971024513,MATH 142A,A01,083219,Chow; Bennett,6,0,32,26
1656971024513,MATH 142A,A02,083220,Chow; Bennett,10,0,32,22
1656971024513,MATH 142A,A03,093480,Chow; Bennett,7,0,32,25
1656971024513,MATH 142A,B03,093481,Chow; Bennett,7,0,32,25
1656971024513,MATH 142A,B04,093558,Chow; Bennett,11,0,32,21
1656971024513,MATH 142A,B05,093559,Chow; Bennett,6,0,32,26
1656971030536,MATH 193A,A01,083224,Rotar; Vladimir,7,0,34,27
1656971030536,MATH 193A,A02,083225,Rotar; Vladimir,4,0,34,30
1656971030536,MATH 193A,A03,083781,Rotar; Vladimir,1,0,34,33
1656971030536,MATH 193A,A04,083782,Rotar; Vladimir,6,0,34,28
1656971030536,MATH 193A,A05,093482,Rotar; Vladimir,6,0,34,28
1656971036559,MATH 197,001,091859,McAuley; Julian John,9999,0,9999,0
1656971036559,MATH 197,002,095566,Kedlaya; Kiran S.,9997,0,9999,2
1656971036559,MATH 197,003,095567,Xiao; Ming,9999,0,9999,0
1656971036559,MATH 197,004,095571,Perols; Johan Lars,9998,0,9999,1
1656971043613,COGS 9,A01,083615,Shannon; Kyle Michael,7,0,75,68
1656971049636,COGS 11,A01,083617,Boyle; Mary E. T.,20,0,48,28
1656971055665,COGS 13,A01,083071,Bastos; Amalia Pinkusfeld,9,0,71,62
1656971061693,COGS 14A,A01,092681,Semenuks; Arturs,0,1,100,100
1656971067716,COGS 14B,A01,083073,Cheng; Tzu-Han,5,0,63,58
1656971073738,COGS 17,A01,092677,Semenuks; Arturs,4,0,81,77
1656971079760,COGS 100,A01,083619,Allen; Michael Gordon,15,0,70,55
1656971085788,COGS 101A,A01,083621,Davis; Joshua Daniel,9,0,68,59
1656971091815,COGS 101B,A01,091572,Allen; Michael Gordon,8,0,65,57
1656971097837,COGS 101C,A01,083625,Delgado; Tania,17,0,35,18
1656971103867,COGS 107A,A01,083627,Boyle; Mary E. T.,13,0,60,47
1656971109893,COGS 118A,A01,083075,Gupta; Anjum,15,0,76,61
1656971115920,CSE 3,A50,083646,Miranda; Gregory Joseph,22,0,50,28
1656971121945,CSE 8A,A50,083650,Miranda; Gregory Joseph,17,1,56,39
1656971127968,CSE 11,A01,083080,Cao; Yingjun,4,15,40,36
1656971134002,CSE 12,A01,083652,Krause-Levy; Sophia Louisa,20,1,120,100
1656971140024,CSE 15L,A01,083654,Morris; Justin Loren,8,0,50,42
1656971140024,CSE 15L,A02,083655,Morris; Justin Loren,8,0,50,42
1656971146051,CSE 20,A01,083657,Tran; Khoa Dang,37,0,80,43
1656971152081,CSE 21,A01,095574,Bach; Quang Tran,21,0,48,27
1656971158106,CSE 30,A01,083084,Eldon; John,4,0,80,76
1656971158106,CSE 30,B01,095061,Bhaskar; Nishant,6,0,50,44
1656971164130,CSE 100,A01,083659,Cao; Yingjun,3,4,70,67
1656971170173,CSE 134B,A01,083661,Powell; Thomas Allan,19,0,100,81
1656971176197,CSE 140,A01,083663,Gungor; Onat,14,0,85,71
1656971182220,CSE 140L,A01,083088,Eldon; John,16,0,100,84
1656971188246,CSE 175,A01,083665,Kumar; Rakesh,3,0,25,22
1656971194278,CSE 190,A00,092507,Dubnov; Shlomo,7,0,20,13
1656971200301,ECE 45,A01,083139,Congero; Spencer William,5,0,75,70
1656971206324,ECE 65,A50,083695,Saad; Andrew S,12,0,30,18
1656971206324,ECE 65,A51,095125,Saad; Andrew S,25,0,26,1
1656971212348,ECE 109,A01,091882,Touri; Behrouz,16,0,70,54
1656971218372,ECE 180,A00,083140,Abi Samra; Nicholas Camill,1,0,30,29
1656971218372,ECE 180,B00,083141,Abi Samra; Nicholas Camill,0,0,30,30
1656971224395,MATH 10A,A01,083735,Patchell; Gregory David,1,0,30,29
1656971224395,MATH 10A,A02,083736,Patchell; Gregory David,20,0,30,10
1656971224395,MATH 10A,A03,083737,Patchell; Gregory David,15,0,30,15
1656971230418,MATH 10B,A01,083207,Lim; Seonhee,7,0,34,27
1656971230418,MATH 10B,A02,083208,Lim; Seonhee,9,0,35,26
1656971230418,MATH 10B,A03,093472,Lim; Seonhee,4,0,34,30
1656971230418,MATH 10B,B01,083739,Sinha; Shubham,9,0,30,21
1656971236448,MATH 18,A01,083743,Cinel; Cameron Alexander,6,0,30,24
1656971236448,MATH 18,A02,083744,Cinel; Cameron Alexander,15,0,30,15
1656971236448,MATH 18,A03,083745,Cinel; Cameron Alexander,8,0,30,22
1656971236448,MATH 18,B01,083748,Rideout; David Porter,4,0,37,33
1656971236448,MATH 18,B02,083749,Rideout; David Porter,3,0,36,33
1656971236448,MATH 18,B03,083750,Rideout; David Porter,2,0,37,35
1656971236448,MATH 18,B04,083751,Rideout; David Porter,5,0,36,31
1656971236448,MATH 18,B05,093473,Rideout; David Porter,4,0,36,32
1656971236448,MATH 18,B06,093474,Rideout; David Porter,5,0,36,31
1656971242474,MATH 20A,A01,083754,Zheng; Zequn,12,0,40,28
1656971248500,MATH 20B,A01,083756,Briones; Jor-el Thomas Caparas,1,0,36,35
1656971248500,MATH 20B,A02,083757,Briones; Jor-el Thomas Caparas,1,0,36,35
1656971248500,MATH 20B,A03,093475,Briones; Jor-el Thomas Caparas,0,0,36,36
1656971254523,MATH 20C,A01,083760,Briones; Jor-el Thomas Caparas,1,0,35,34
1656971254523,MATH 20C,A02,083761,Briones; Jor-el Thomas Caparas,8,0,35,27
1656971254523,MATH 20C,A03,093476,Briones; Jor-el Thomas Caparas,0,1,36,36
1656971254523,MATH 20C,B01,083762,Bach; Quang Tran,0,0,30,30
1656971260547,MATH 20D,A01,083765,Tran; Brian Kha,4,0,30,26
1656971260547,MATH 20D,A02,083766,Tran; Brian Kha,4,0,30,26
1656971260547,MATH 20D,A03,083767,Tran; Brian Kha,3,0,30,27
1656971266575,MATH 20E,A01,083771,Ganguly; Soumya,5,0,32,27
1656971266575,MATH 20E,A02,083772,Ganguly; Soumya,6,0,32,26
1656971266575,MATH 20E,B01,083773,Ciotti; Benjamin,18,0,35,17
1656971266575,MATH 20E,B02,083774,Ciotti; Benjamin,17,0,35,18
1656971272605,MATH 103A,A01,083777,Greenfeld; Be'Eri,2,0,36,34
1656971272605,MATH 103A,A02,083778,Greenfeld; Be'Eri,5,0,36,31
1656971272605,MATH 103A,A03,093561,Greenfeld; Be'Eri,4,0,36,32
1656971272605,MATH 103A,B01,083779,Greenfeld; Be'Eri,6,0,36,30
1656971272605,MATH 103A,B02,083780,Greenfeld; Be'Eri,2,0,36,34
1656971272605,MATH 103A,B03,093562,Greenfeld; Be'Eri,2,0,36,34
1656971278627,MATH 105,A01,085443,Carter; Anne Toulson,14,0,35,21
1656971278627,MATH 105,A02,093477,Carter; Anne Toulson,20,0,35,15
1656971284655,MATH 109,A01,083213,Ganzberger; Geoffrey Michael,2,0,34,32
1656971284655,MATH 109,A02,083214,Ganzberger; Geoffrey Michael,2,0,34,32
1656971284655,MATH 109,A03,093478,Ganzberger; Geoffrey Michael,1,0,34,33
1656971284655,MATH 109,B01,083215,Ganzberger; Geoffrey Michael,1,0,32,31
1656971284655,MATH 109,B02,083216,Ganzberger; Geoffrey Michael,1,0,32,31
1656971284655,MATH 109,B03,093479,Ganzberger; Geoffrey Michael,6,0,32,26
1656971290678,MATH 142A,A01,083219,Chow; Bennett,6,0,32,26
1656971290678,MATH 142A,A02,083220,Chow; Bennett,10,0,32,22
1656971290678,MATH 142A,A03,093480,Chow; Bennett,7,0,32,25
1656971290678,MATH 142A,B03,093481,Chow; Bennett,7,0,32,25
1656971290678,MATH 142A,B04,093558,Chow; Bennett,11,0,32,21
1656971290678,MATH 142A,B05,093559,Chow; Bennett,6,0,32,26
1656971296700,MATH 193A,A01,083224,Rotar; Vladimir,7,0,34,27
1656971296700,MATH 193A,A02,083225,Rotar; Vladimir,4,0,34,30
1656971296700,MATH 193A,A03,083781,Rotar; Vladimir,1,0,34,33
1656971296700,MATH 193A,A04,083782,Rotar; Vladimir,6,0,34,28
1656971296700,MATH 193A,A05,093482,Rotar; Vladimir,6,0,34,28
1656971302726,MATH 197,001,091859,McAuley; Julian John,9999,0,9999,0
1656971302726,MATH 197,002,095566,Kedlaya; Kiran S.,9997,0,9999,2
1656971302726,MATH 197,003,095567,Xiao; Ming,9999,0,9999,0
1656971302726,MATH 197,004,095571,Perols; Johan Lars,9998,0,9999,1
1656971309789,COGS 9,A01,083615,Shannon; Kyle Michael,7,0,75,68
1656971315817,COGS 11,A01,083617,Boyle; Mary E. T.,20,0,48,28
1656971321843,COGS 13,A01,083071,Bastos; Amalia Pinkusfeld,9,0,71,62
1656971327867,COGS 14A,A01,092681,Semenuks; Arturs,0,1,100,100
1656971333890,COGS 14B,A01,083073,Cheng; Tzu-Han,5,0,63,58
1656971339914,COGS 17,A01,092677,Semenuks; Arturs,4,0,81,77
1656971345937,COGS 100,A01,083619,Allen; Michael Gordon,15,0,70,55
1656971351960,COGS 101A,A01,083621,Davis; Joshua Daniel,9,0,68,59
1656971357982,COGS 101B,A01,091572,Allen; Michael Gordon,8,0,65,57
1656971364005,COGS 101C,A01,083625,Delgado; Tania,17,0,35,18
1656971370026,COGS 107A,A01,083627,Boyle; Mary E. T.,13,0,60,47
1656971376049,COGS 118A,A01,083075,Gupta; Anjum,15,0,76,61
1656971382073,CSE 3,A50,083646,Miranda; Gregory Joseph,22,0,50,28
1656971388100,CSE 8A,A50,083650,Miranda; Gregory Joseph,17,1,56,39
1656971394197,CSE 11,A01,083080,Cao; Yingjun,4,15,40,36
1656971400224,CSE 12,A01,083652,Krause-Levy; Sophia Louisa,20,1,120,100
1656971406249,CSE 15L,A01,083654,Morris; Justin Loren,8,0,50,42
1656971406249,CSE 15L,A02,083655,Morris; Justin Loren,8,0,50,42
1656971412276,CSE 20,A01,083657,Tran; Khoa Dang,37,0,80,43
1656971418299,CSE 21,A01,095574,Bach; Quang Tran,21,0,48,27
1656971424326,CSE 30,A01,083084,Eldon; John,4,0,80,76
1656971424326,CSE 30,B01,095061,Bhaskar; Nishant,6,0,50,44
1656971430348,CSE 100,A01,083659,Cao; Yingjun,3,4,70,67
1656971436375,CSE 134B,A01,083661,Powell; Thomas Allan,19,0,100,81
1656971442403,CSE 140,A01,083663,Gungor; Onat,14,0,85,71
1656971448426,CSE 140L,A01,083088,Eldon; John,16,0,100,84
1656971454453,CSE 175,A01,083665,Kumar; Rakesh,3,0,25,22
1656971460479,CSE 190,A00,092507,Dubnov; Shlomo,7,0,20,13
1656971466502,ECE 45,A01,083139,Congero; Spencer William,5,0,75,70
1656971472529,ECE 65,A50,083695,Saad; Andrew S,12,0,30,18
1656971472529,ECE 65,A51,095125,Saad; Andrew S,25,0,26,1
1656971478554,ECE 109,A01,091882,Touri; Behrouz,16,0,70,54
1656971484577,ECE 180,A00,083140,Abi Samra; Nicholas Camill,1,0,30,29
1656971484577,ECE 180,B00,083141,Abi Samra; Nicholas Camill,0,0,30,30
1656971490603,MATH 10A,A01,083735,Patchell; Gregory David,1,0,30,29
1656971490603,MATH 10A,A02,083736,Patchell; Gregory David,20,0,30,10
1656971490603,MATH 10A,A03,083737,Patchell; Gregory David,15,0,30,15
1656971496626,MATH 10B,A01,083207,Lim; Seonhee,7,0,34,27
1656971496626,MATH 10B,A02,083208,Lim; Seonhee,9,0,35,26
1656971496626,MATH 10B,A03,093472,Lim; Seonhee,4,0,34,30
1656971496626,MATH 10B,B01,083739,Sinha; Shubham,9,0,30,21
1656971502656,MATH 18,A01,083743,Cinel; Cameron Alexander,6,0,30,24
1656971502656,MATH 18,A02,083744,Cinel; Cameron Alexander,15,0,30,15
1656971502656,MATH 18,A03,083745,Cinel; Cameron Alexander,8,0,30,22
1656971502656,MATH 18,B01,083748,Rideout; David Porter,4,0,37,33
1656971502656,MATH 18,B02,083749,Rideout; David Porter,3,0,36,33
1656971502656,MATH 18,B03,083750,Rideout; David Porter,2,0,37,35
1656971502656,MATH 18,B04,083751,Rideout; David Porter,5,0,36,31
1656971502656,MATH 18,B05,093473,Rideout; David Porter,4,0,36,32
1656971502656,MATH 18,B06,093474,Rideout; David Porter,5,0,36,31
1656971508680,MATH 20A,A01,083754,Zheng; Zequn,12,0,40,28
1656971514711,MATH 20B,A01,083756,Briones; Jor-el Thomas Caparas,1,0,36,35
1656971514711,MATH 20B,A02,083757,Briones; Jor-el Thomas Caparas,1,0,36,35
1656971514711,MATH 20B,A03,093475,Briones; Jor-el Thomas Caparas,0,0,36,36
1656971520735,MATH 20C,A01,083760,Briones; Jor-el Thomas Caparas,1,0,35,34
1656971520735,MATH 20C,A02,083761,Briones; Jor-el Thomas Caparas,8,0,35,27
1656971520735,MATH 20C,A03,093476,Briones; Jor-el Thomas Caparas,0,1,36,36
1656971520735,MATH 20C,B01,083762,Bach; Quang Tran,0,0,30,30
1656971526765,MATH 20D,A01,083765,Tran; Brian Kha,4,0,30,26
1656971526765,MATH 20D,A02,083766,Tran; Brian Kha,4,0,30,26
1656971526765,MATH 20D,A03,083767,Tran; Brian Kha,3,0,30,27
1656971532790,MATH 20E,A01,083771,Ganguly; Soumya,5,0,32,27
1656971532790,MATH 20E,A02,083772,Ganguly; Soumya,6,0,32,26
1656971532790,MATH 20E,B01,083773,Ciotti; Benjamin,18,0,35,17
1656971532790,MATH 20E,B02,083774,Ciotti; Benjamin,17,0,35,18
1656971538815,MATH 103A,A01,083777,Greenfeld; Be'Eri,2,0,36,34
1656971538815,MATH 103A,A02,083778,Greenfeld; Be'Eri,5,0,36,31
1656971538815,MATH 103A,A03,093561,Greenfeld; Be'Eri,4,0,36,32
1656971538815,MATH 103A,B01,083779,Greenfeld; Be'Eri,6,0,36,30
1656971538815,MATH 103A,B02,083780,Greenfeld; Be'Eri,2,0,36,34
1656971538815,MATH 103A,B03,093562,Greenfeld; Be'Eri,2,0,36,34
1656971544852,MATH 105,A01,085443,Carter; Anne Toulson,14,0,35,21
1656971544852,MATH 105,A02,093477,Carter; Anne Toulson,20,0,35,15
1656971550874,MATH 109,A01,083213,Ganzberger; Geoffrey Michael,2,0,34,32
1656971550874,MATH 109,A02,083214,Ganzberger; Geoffrey Michael,2,0,34,32
1656971550874,MATH 109,A03,093478,Ganzberger; Geoffrey Michael,1,0,34,33
1656971550874,MATH 109,B01,083215,Ganzberger; Geoffrey Michael,1,0,32,31
1656971550874,MATH 109,B02,083216,Ganzberger; Geoffrey Michael,1,0,32,31
1656971550874,MATH 109,B03,093479,Ganzberger; Geoffrey Michael,6,0,32,26
1656971556898,MATH 142A,A01,083219,Chow; Bennett,6,0,32,26
1656971556898,MATH 142A,A02,083220,Chow; Bennett,10,0,32,22
1656971556898,MATH 142A,A03,093480,Chow; Bennett,7,0,32,25
1656971556898,MATH 142A,B03,093481,Chow; Bennett,7,0,32,25
1656971556898,MATH 142A,B04,093558,Chow; Bennett,11,0,32,21
1656971556898,MATH 142A,B05,093559,Chow; Bennett,6,0,32,26
1656971562927,MATH 193A,A01,083224,Rotar; Vladimir,7,0,34,27
1656971562927,MATH 193A,A02,083225,Rotar; Vladimir,4,0,34,30
1656971562927,MATH 193A,A03,083781,Rotar; Vladimir,1,0,34,33
1656971562927,MATH 193A,A04,083782,Rotar; Vladimir,6,0,34,28
1656971562927,MATH 193A,A05,093482,Rotar; Vladimir,6,0,34,28
1656971568951,MATH 197,001,091859,McAuley; Julian John,9999,0,9999,0
1656971568951,MATH 197,002,095566,Kedlaya; Kiran S.,9997,0,9999,2
1656971568951,MATH 197,003,095567,Xiao; Ming,9999,0,9999,0
1656971568951,MATH 197,004,095571,Perols; Johan Lars,9998,0,9999,1
1656971576007,COGS 9,A01,083615,Shannon; Kyle Michael,7,0,75,68
1656971582033,COGS 11,A01,083617,Boyle; Mary E. T.,20,0,48,28
1656971588057,COGS 13,A01,083071,Bastos; Amalia Pinkusfeld,9,0,71,62
1656971594079,COGS 14A,A01,092681,Semenuks; Arturs,0,1,100,100
1656971600105,COGS 14B,A01,083073,Cheng; Tzu-Han,5,0,63,58
1656971606130,COGS 17,A01,092677,Semenuks; Arturs,4,0,81,77
1656971612161,COGS 100,A01,083619,Allen; Michael Gordon,15,0,70,55
1656971618185,COGS 101A,A01,083621,Davis; Joshua Daniel,9,0,68,59
1656971624210,COGS 101B,A01,091572,Allen; Michael Gordon,8,0,65,57
1656971630234,COGS 101C,A01,083625,Delgado; Tania,17,0,35,18
1656971636255,COGS 107A,A01,083627,Boyle; Mary E. T.,13,0,60,47
1656971642282,COGS 118A,A01,083075,Gupta; Anjum,15,0,76,61
1656971648309,CSE 3,A50,083646,Miranda; Gregory Joseph,22,0,50,28
1656971654332,CSE 8A,A50,083650,Miranda; Gregory Joseph,17,1,56,39
1656971660359,CSE 11,A01,083080,Cao; Yingjun,4,15,40,36
1656971666383,CSE 12,A01,083652,Krause-Levy; Sophia Louisa,20,1,120,100
1656971672406,CSE 15L,A01,083654,Morris; Justin Loren,8,0,50,42
1656971672406,CSE 15L,A02,083655,Morris; Justin Loren,8,0,50,42
1656971678431,CSE 20,A01,083657,Tran; Khoa Dang,37,0,80,43
1656971684457,CSE 21,A01,095574,Bach; Quang Tran,21,0,48,27
1656971690480,CSE 30,A01,083084,Eldon; John,4,0,80,76
1656971690480,CSE 30,B01,095061,Bhaskar; Nishant,6,0,50,44
1656971696507,CSE 100,A01,083659,Cao; Yingjun,3,4,70,67
1656971702534,CSE 134B,A01,083661,Powell; Thomas Allan,19,0,100,81
1656971708558,CSE 140,A01,083663,Gungor; Onat,14,0,85,71
1656971714584,CSE 140L,A01,083088,Eldon; John,16,0,100,84
1656971720612,CSE 175,A01,083665,Kumar; Rakesh,3,0,25,22
1656971726636,CSE 190,A00,092507,Dubnov; Shlomo,7,0,20,13
1656971732668,ECE 45,A01,083139,Congero; Spencer William,5,0,75,70
1656971738691,ECE 65,A50,083695,Saad; Andrew S,12,0,30,18
1656971738691,ECE 65,A51,095125,Saad; Andrew S,25,0,26,1
1656971744716,ECE 109,A01,091882,Touri; Behrouz,16,0,70,54
1656971750746,ECE 180,A00,083140,Abi Samra; Nicholas Camill,1,0,30,29
1656971750746,ECE 180,B00,083141,Abi Samra; Nicholas Camill,0,0,30,30
1656971756770,MATH 10A,A01,083735,Patchell; Gregory David,1,0,30,29
1656971756770,MATH 10A,A02,083736,Patchell; Gregory David,20,0,30,10
1656971756770,MATH 10A,A03,083737,Patchell; Gregory David,15,0,30,15
1656971762794,MATH 10B,A01,083207,Lim; Seonhee,7,0,34,27
1656971762794,MATH 10B,A02,083208,Lim; Seonhee,9,0,35,26
1656971762794,MATH 10B,A03,093472,Lim; Seonhee,4,0,34,30
1656971762794,MATH 10B,B01,083739,Sinha; Shubham,9,0,30,21
1656971768828,MATH 18,A01,083743,Cinel; Cameron Alexander,6,0,30,24
1656971768828,MATH 18,A02,083744,Cinel; Cameron Alexander,15,0,30,15
1656971768828,MATH 18,A03,083745,Cinel; Cameron Alexander,8,0,30,22
1656971768828,MATH 18,B01,083748,Rideout; David Porter,4,0,37,33
1656971768828,MATH 18,B02,083749,Rideout; David Porter,3,0,36,33
1656971768828,MATH 18,B03,083750,Rideout; David Porter,2,0,37,35
1656971768828,MATH 18,B04,083751,Rideout; David Porter,5,0,36,31
1656971768828,MATH 18,B05,093473,Rideout; David Porter,4,0,36,32
1656971768828,MATH 18,B06,093474,Rideout; David Porter,5,0,36,31
1656971774852,MATH 20A,A01,083754,Zheng; Zequn,12,0,40,28
1656971780878,MATH 20B,A01,083756,Briones; Jor-el Thomas Caparas,1,0,36,35
1656971780878,MATH 20B,A02,083757,Briones; Jor-el Thomas Caparas,1,0,36,35
1656971780878,MATH 20B,A03,093475,Briones; Jor-el Thomas Caparas,0,0,36,36
1656971786902,MATH 20C,A01,083760,Briones; Jor-el Thomas Caparas,1,0,35,34
1656971786902,MATH 20C,A02,083761,Briones; Jor-el Thomas Caparas,8,0,35,27
1656971786902,MATH 20C,A03,093476,Briones; Jor-el Thomas Caparas,0,1,36,36
1656971786902,MATH 20C,B01,083762,Bach; Quang Tran,0,0,30,30
1656971792926,MATH 20D,A01,083765,Tran; Brian Kha,4,0,30,26
1656971792926,MATH 20D,A02,083766,Tran; Brian Kha,4,0,30,26
1656971792926,MATH 20D,A03,083767,Tran; Brian Kha,3,0,30,27
1656971798951,MATH 20E,A01,083771,Ganguly; Soumya,5,0,32,27
1656971798951,MATH 20E,A02,083772,Ganguly; Soumya,6,0,32,26
1656971798951,MATH 20E,B01,083773,Ciotti; Benjamin,18,0,35,17
1656971798951,MATH 20E,B02,083774,Ciotti; Benjamin,17,0,35,18
1656971804975,MATH 103A,A01,083777,Greenfeld; Be'Eri,2,0,36,34
1656971804975,MATH 103A,A02,083778,Greenfeld; Be'Eri,5,0,36,31
1656971804975,MATH 103A,A03,093561,Greenfeld; Be'Eri,4,0,36,32
1656971804975,MATH 103A,B01,083779,Greenfeld; Be'Eri,6,0,36,30
1656971804975,MATH 103A,B02,083780,Greenfeld; Be'Eri,2,0,36,34
1656971804975,MATH 103A,B03,093562,Greenfeld; Be'Eri,2,0,36,34
1656971810998,MATH 105,A01,085443,Carter; Anne Toulson,14,0,35,21
1656971810998,MATH 105,A02,093477,Carter; Anne Toulson,20,0,35,15
1656971817022,MATH 109,A01,083213,Ganzberger; Geoffrey Michael,2,0,34,32
1656971817022,MATH 109,A02,083214,Ganzberger; Geoffrey Michael,2,0,34,32
1656971817022,MATH 109,A03,093478,Ganzberger; Geoffrey Michael,1,0,34,33
1656971817022,MATH 109,B01,083215,Ganzberger; Geoffrey Michael,1,0,32,31
1656971817022,MATH 109,B02,083216,Ganzberger; Geoffrey Michael,1,0,32,31
1656971817022,MATH 109,B03,093479,Ganzberger; Geoffrey Michael,6,0,32,26
1656971823047,MATH 142A,A01,083219,Chow; Bennett,6,0,32,26
1656971823047,MATH 142A,A02,083220,Chow; Bennett,10,0,32,22
1656971823047,MATH 142A,A03,093480,Chow; Bennett,7,0,32,25
1656971823047,MATH 142A,B03,093481,Chow; Bennett,7,0,32,25
1656971823047,MATH 142A,B04,093558,Chow; Bennett,11,0,32,21
1656971823047,MATH 142A,B05,093559,Chow; Bennett,6,0,32,26
1656971829076,MATH 193A,A01,083224,Rotar; Vladimir,7,0,34,27
1656971829076,MATH 193A,A02,083225,Rotar; Vladimir,4,0,34,30
1656971829076,MATH 193A,A03,083781,Rotar; Vladimir,1,0,34,33
1656971829076,MATH 193A,A04,083782,Rotar; Vladimir,6,0,34,28
1656971829076,MATH 193A,A05,093482,Rotar; Vladimir,6,0,34,28
1656971835099,MATH 197,001,091859,McAuley; Julian John,9999,0,9999,0
1656971835099,MATH 197,002,095566,Kedlaya; Kiran S.,9997,0,9999,2
1656971835099,MATH 197,003,095567,Xiao; Ming,9999,0,9999,0
1656971835099,MATH 197,004,095571,Perols; Johan Lars,9998,0,9999,1
1656971842161,COGS 9,A01,083615,Shannon; Kyle Michael,7,0,75,68
1656971848184,COGS 11,A01,083617,Boyle; Mary E. T.,20,0,48,28
1656971854207,COGS 13,A01,083071,Bastos; Amalia Pinkusfeld,9,0,71,62
1656971860235,COGS 14A,A01,092681,Semenuks; Arturs,0,1,100,100
1656971866258,COGS 14B,A01,083073,Cheng; Tzu-Han,5,0,63,58
1656971872301,COGS 17,A01,092677,Semenuks; Arturs,4,0,81,77
1656971878324,COGS 100,A01,083619,Allen; Michael Gordon,15,0,70,55
1656971884348,COGS 101A,A01,083621,Davis; Joshua Daniel,9,0,68,59
1656971890371,COGS 101B,A01,091572,Allen; Michael Gordon,8,0,65,57
1656971896393,COGS 101C,A01,083625,Delgado; Tania,17,0,35,18
1656971902418,COGS 107A,A01,083627,Boyle; Mary E. T.,13,0,60,47
1656971908445,COGS 118A,A01,083075,Gupta; Anjum,15,0,76,61
1656971914476,CSE 3,A50,083646,Miranda; Gregory Joseph,22,0,50,28
1656971920499,CSE 8A,A50,083650,Miranda; Gregory Joseph,17,1,56,39
1656971926523,CSE 11,A01,083080,Cao; Yingjun,4,15,40,36
1656971932549,CSE 12,A01,083652,Krause-Levy; Sophia Louisa,20,1,120,100
1656971938573,CSE 15L,A01,083654,Morris; Justin Loren,8,0,50,42
1656971938573,CSE 15L,A02,083655,Morris; Justin Loren,8,0,50,42
1656971944598,CSE 20,A01,083657,Tran; Khoa Dang,37,0,80,43
1656971950621,CSE 21,A01,095574,Bach; Quang Tran,21,0,48,27
1656971956645,CSE 30,A01,083084,Eldon; John,4,0,80,76
1656971956645,CSE 30,B01,095061,Bhaskar; Nishant,6,0,50,44
1656971962671,CSE 100,A01,083659,Cao; Yingjun,3,4,70,67
1656971968697,CSE 134B,A01,083661,Powell; Thomas Allan,19,0,100,81
1656971974721,CSE 140,A01,083663,Gungor; Onat,14,0,85,71
1656971980744,CSE 140L,A01,083088,Eldon; John,16,0,100,84
1656971986767,CSE 175,A01,083665,Kumar; Rakesh,3,0,25,22
1656971992864,CSE 190,A00,092507,Dubnov; Shlomo,7,0,20,13
1656971998888,ECE 45,A01,083139,Congero; Spencer William,5,0,75,70
1656972004914,ECE 65,A50,083695,Saad; Andrew S,12,0,30,18
1656972004914,ECE 65,A51,095125,Saad; Andrew S,25,0,26,1
1656972010941,ECE 109,A01,091882,Touri; Behrouz,16,0,70,54
1656972016964,ECE 180,A00,083140,Abi Samra; Nicholas Camill,1,0,30,29
1656972016964,ECE 180,B00,083141,Abi Samra; Nicholas Camill,0,0,30,30
1656972022987,MATH 10A,A01,083735,Patchell; Gregory David,1,0,30,29
1656972022987,MATH 10A,A02,083736,Patchell; Gregory David,20,0,30,10
1656972022987,MATH 10A,A03,083737,Patchell; Gregory David,15,0,30,15
1656972029010,MATH 10B,A01,083207,Lim; Seonhee,7,0,34,27
1656972029010,MATH 10B,A02,083208,Lim; Seonhee,9,0,35,26
1656972029010,MATH 10B,A03,093472,Lim; Seonhee,4,0,34,30
1656972029010,MATH 10B,B01,083739,Sinha; Shubham,9,0,30,21
1656972035039,MATH 18,A01,083743,Cinel; Cameron Alexander,6,0,30,24
1656972035039,MATH 18,A02,083744,Cinel; Cameron Alexander,15,0,30,15
1656972035039,MATH 18,A03,083745,Cinel; Cameron Alexander,8,0,30,22
1656972035039,MATH 18,B01,083748,Rideout; David Porter,4,0,37,33
1656972035039,MATH 18,B02,083749,Rideout; David Porter,3,0,36,33
1656972035039,MATH 18,B03,083750,Rideout; David Porter,2,0,37,35
1656972035039,MATH 18,B04,083751,Rideout; David Porter,5,0,36,31
1656972035039,MATH 18,B05,093473,Rideout; David Porter,4,0,36,32
1656972035039,MATH 18,B06,093474,Rideout; David Porter,5,0,36,31
1656972041062,MATH 20A,A01,083754,Zheng; Zequn,12,0,40,28
1656972047085,MATH 20B,A01,083756,Briones; Jor-el Thomas Caparas,1,0,36,35
1656972047085,MATH 20B,A02,083757,Briones; Jor-el Thomas Caparas,1,0,36,35
1656972047085,MATH 20B,A03,093475,Briones; Jor-el Thomas Caparas,0,0,36,36
1656972053108,MATH 20C,A01,083760,Briones; Jor-el Thomas Caparas,1,0,35,34
1656972053108,MATH 20C,A02,083761,Briones; Jor-el Thomas Caparas,8,0,35,27
1656972053108,MATH 20C,A03,093476,Briones; Jor-el Thomas Caparas,0,1,36,36
1656972053108,MATH 20C,B01,083762,Bach; Quang Tran,0,0,30,30
1656972059136,MATH 20D,A01,083765,Tran; Brian Kha,4,0,30,26
1656972059136,MATH 20D,A02,083766,Tran; Brian Kha,4,0,30,26
1656972059136,MATH 20D,A03,083767,Tran; Brian Kha,3,0,30,27
1656972065166,MATH 20E,A01,083771,Ganguly; Soumya,5,0,32,27
1656972065166,MATH 20E,A02,083772,Ganguly; Soumya,6,0,32,26
1656972065166,MATH 20E,B01,083773,Ciotti; Benjamin,18,0,35,17
1656972065166,MATH 20E,B02,083774,Ciotti; Benjamin,17,0,35,18
1656972071189,MATH 103A,A01,083777,Greenfeld; Be'Eri,2,0,36,34
1656972071189,MATH 103A,A02,083778,Greenfeld; Be'Eri,5,0,36,31
1656972071189,MATH 103A,A03,093561,Greenfeld; Be'Eri,4,0,36,32
1656972071189,MATH 103A,B01,083779,Greenfeld; Be'Eri,6,0,36,30
1656972071189,MATH 103A,B02,083780,Greenfeld; Be'Eri,2,0,36,34
1656972071189,MATH 103A,B03,093562,Greenfeld; Be'Eri,2,0,36,34
1656972077216,MATH 105,A01,085443,Carter; Anne Toulson,14,0,35,21
1656972077216,MATH 105,A02,093477,Carter; Anne Toulson,20,0,35,15
1656972083240,MATH 109,A01,083213,Ganzberger; Geoffrey Michael,2,0,34,32
1656972083240,MATH 109,A02,083214,Ganzberger; Geoffrey Michael,2,0,34,32
1656972083240,MATH 109,A03,093478,Ganzberger; Geoffrey Michael,1,0,34,33
1656972083240,MATH 109,B01,083215,Ganzberger; Geoffrey Michael,1,0,32,31
1656972083240,MATH 109,B02,083216,Ganzberger; Geoffrey Michael,1,0,32,31
1656972083240,MATH 109,B03,093479,Ganzberger; Geoffrey Michael,6,0,32,26
1656972089267,MATH 142A,A01,083219,Chow; Bennett,6,0,32,26
1656972089267,MATH 142A,A02,083220,Chow; Bennett,10,0,32,22
1656972089267,MATH 142A,A03,093480,Chow; Bennett,7,0,32,25
1656972089267,MATH 142A,B03,093481,Chow; Bennett,7,0,32,25
1656972089267,MATH 142A,B04,093558,Chow; Bennett,11,0,32,21
1656972089267,MATH 142A,B05,093559,Chow; Bennett,6,0,32,26
1656972095295,MATH 193A,A01,083224,Rotar; Vladimir,7,0,34,27
1656972095295,MATH 193A,A02,083225,Rotar; Vladimir,4,0,34,30
1656972095295,MATH 193A,A03,083781,Rotar; Vladimir,1,0,34,33
1656972095295,MATH 193A,A04,083782,Rotar; Vladimir,6,0,34,28
1656972095295,MATH 193A,A05,093482,Rotar; Vladimir,6,0,34,28
1656972101320,MATH 197,001,091859,McAuley; Julian John,9999,0,9999,0
1656972101320,MATH 197,002,095566,Kedlaya; Kiran S.,9997,0,9999,2
1656972101320,MATH 197,003,095567,Xiao; Ming,9999,0,9999,0
1656972101320,MATH 197,004,095571,Perols; Johan Lars,9998,0,9999,1
1656972108382,COGS 9,A01,083615,Shannon; Kyle Michael,7,0,75,68
1656972114407,COGS 11,A01,083617,Boyle; Mary E. T.,20,0,48,28
1656972120435,COGS 13,A01,083071,Bastos; Amalia Pinkusfeld,9,0,71,62
1656972126460,COGS 14A,A01,092681,Semenuks; Arturs,0,1,100,100
1656972132483,COGS 14B,A01,083073,Cheng; Tzu-Han,5,0,63,58
1656972138509,COGS 17,A01,092677,Semenuks; Arturs,4,0,81,77
1656972144536,COGS 100,A01,083619,Allen; Michael Gordon,15,0,70,55
1656972150559,COGS 101A,A01,083621,Davis; Joshua Daniel,9,0,68,59
1656972156584,COGS 101B,A01,091572,Allen; Michael Gordon,8,0,65,57
1656972162607,COGS 101C,A01,083625,Delgado; Tania,17,0,35,18
1656972168633,COGS 107A,A01,083627,Boyle; Mary E. T.,13,0,60,47
1656972174656,COGS 118A,A01,083075,Gupta; Anjum,15,0,76,61
1656972180680,CSE 3,A50,083646,Miranda; Gregory Joseph,22,0,50,28
1656972186704,CSE 8A,A50,083650,Miranda; Gregory Joseph,17,1,56,39
1656972192730,CSE 11,A01,083080,Cao; Yingjun,4,15,40,36
1656972198755,CSE 12,A01,083652,Krause-Levy; Sophia Louisa,20,1,120,100
1656972204777,CSE 15L,A01,083654,Morris; Justin Loren,8,0,50,42
1656972204777,CSE 15L,A02,083655,Morris; Justin Loren,8,0,50,42
1656972210800,CSE 20,A01,083657,Tran; Khoa Dang,37,0,80,43
1656972216828,CSE 21,A01,095574,Bach; Quang Tran,21,0,48,27
1656972222852,CSE 30,A01,083084,Eldon; John,4,0,80,76
1656972222852,CSE 30,B01,095061,Bhaskar; Nishant,6,0,50,44
1656972228879,CSE 100,A01,083659,Cao; Yingjun,3,4,70,67
1656972234902,CSE 134B,A01,083661,Powell; Thomas Allan,19,0,100,81
1656972240926,CSE 140,A01,083663,Gungor; Onat,14,0,85,71
1656972246949,CSE 140L,A01,083088,Eldon; John,16,0,100,84
1656972252974,CSE 175,A01,083665,Kumar; Rakesh,3,0,25,22
1656972259008,CSE 190,A00,092507,Dubnov; Shlomo,7,0,20,13
1656972265034,ECE 45,A01,083139,Congero; Spencer William,5,0,75,70
1656972271060,ECE 65,A50,083695,Saad; Andrew S,12,0,30,18
1656972271060,ECE 65,A51,095125,Saad; Andrew S,25,0,26,1
1656972277087,ECE 109,A01,091882,Touri; Behrouz,16,0,70,54
1656972283113,ECE 180,A00,083140,Abi Samra; Nicholas Camill,1,0,30,29
1656972283113,ECE 180,B00,083141,Abi Samra; Nicholas Camill,0,0,30,30
1656972289135,MATH 10A,A01,083735,Patchell; Gregory David,1,0,30,29
1656972289135,MATH 10A,A02,083736,Patchell; Gregory David,20,0,30,10
1656972289135,MATH 10A,A03,083737,Patchell; Gregory David,15,0,30,15
1656972295158,MATH 10B,A01,083207,Lim; Seonhee,7,0,34,27
1656972295158,MATH 10B,A02,083208,Lim; Seonhee,9,0,35,26
1656972295158,MATH 10B,A03,093472,Lim; Seonhee,4,0,34,30
1656972295158,MATH 10B,B01,083739,Sinha; Shubham,9,0,30,21
1656972301187,MATH 18,A01,083743,Cinel; Cameron Alexander,6,0,30,24
1656972301187,MATH 18,A02,083744,Cinel; Cameron Alexander,15,0,30,15
1656972301187,MATH 18,A03,083745,Cinel; Cameron Alexander,8,0,30,22
1656972301187,MATH 18,B01,083748,Rideout; David Porter,4,0,37,33
1656972301187,MATH 18,B02,083749,Rideout; David Porter,3,0,36,33
1656972301187,MATH 18,B03,083750,Rideout; David Porter,2,0,37,35
1656972301187,MATH 18,B04,083751,Rideout; David Porter,5,0,36,31
1656972301187,MATH 18,B05,093473,Rideout; David Porter,4,0,36,32
1656972301187,MATH 18,B06,093474,Rideout; David Porter,5,0,36,31
1656972307217,MATH 20A,A01,083754,Zheng; Zequn,12,0,40,28
1656972313240,MATH 20B,A01,083756,Briones; Jor-el Thomas Caparas,1,0,36,35
1656972313240,MATH 20B,A02,083757,Briones; Jor-el Thomas Caparas,1,0,36,35
1656972313240,MATH 20B,A03,093475,Briones; Jor-el Thomas Caparas,0,0,36,36
1656972319267,MATH 20C,A01,083760,Briones; Jor-el Thomas Caparas,1,0,35,34
1656972319267,MATH 20C,A02,083761,Briones; Jor-el Thomas Caparas,8,0,35,27
1656972319267,MATH 20C,A03,093476,Briones; Jor-el Thomas Caparas,0,1,36,36
1656972319267,MATH 20C,B01,083762,Bach; Quang Tran,0,0,30,30
1656972325293,MATH 20D,A01,083765,Tran; Brian Kha,4,0,30,26
1656972325293,MATH 20D,A02,083766,Tran; Brian Kha,4,0,30,26
1656972325293,MATH 20D,A03,083767,Tran; Brian Kha,3,0,30,27
1656972331317,MATH 20E,A01,083771,Ganguly; Soumya,5,0,32,27
1656972331317,MATH 20E,A02,083772,Ganguly; Soumya,6,0,32,26
1656972331317,MATH 20E,B01,083773,Ciotti; Benjamin,18,0,35,17
1656972331317,MATH 20E,B02,083774,Ciotti; Benjamin,17,0,35,18
1656972337346,MATH 103A,A01,083777,Greenfeld; Be'Eri,2,0,36,34
1656972337346,MATH 103A,A02,083778,Greenfeld; Be'Eri,5,0,36,31
1656972337346,MATH 103A,A03,093561,Greenfeld; Be'Eri,4,0,36,32
1656972337346,MATH 103A,B01,083779,Greenfeld; Be'Eri,6,0,36,30
1656972337346,MATH 103A,B02,083780,Greenfeld; Be'Eri,2,0,36,34
1656972337346,MATH 103A,B03,093562,Greenfeld; Be'Eri,2,0,36,34
1656972343384,MATH 105,A01,085443,Carter; Anne Toulson,14,0,35,21
1656972343384,MATH 105,A02,093477,Carter; Anne Toulson,20,0,35,15
1656972349408,MATH 109,A01,083213,Ganzberger; Geoffrey Michael,2,0,34,32
1656972349408,MATH 109,A02,083214,Ganzberger; Geoffrey Michael,2,0,34,32
1656972349408,MATH 109,A03,093478,Ganzberger; Geoffrey Michael,1,0,34,33
1656972349408,MATH 109,B01,083215,Ganzberger; Geoffrey Michael,1,0,32,31
1656972349408,MATH 109,B02,083216,Ganzberger; Geoffrey Michael,1,0,32,31
1656972349408,MATH 109,B03,093479,Ganzberger; Geoffrey Michael,6,0,32,26
1656972355433,MATH 142A,A01,083219,Chow; Bennett,6,0,32,26
1656972355433,MATH 142A,A02,083220,Chow; Bennett,10,0,32,22
1656972355433,MATH 142A,A03,093480,Chow; Bennett,7,0,32,25
1656972355433,MATH 142A,B03,093481,Chow; Bennett,7,0,32,25
1656972355433,MATH 142A,B04,093558,Chow; Bennett,11,0,32,21
1656972355433,MATH 142A,B05,093559,Chow; Bennett,6,0,32,26
1656972361458,MATH 193A,A01,083224,Rotar; Vladimir,7,0,34,27
1656972361458,MATH 193A,A02,083225,Rotar; Vladimir,4,0,34,30
1656972361458,MATH 193A,A03,083781,Rotar; Vladimir,1,0,34,33
1656972361458,MATH 193A,A04,083782,Rotar; Vladimir,6,0,34,28
1656972361458,MATH 193A,A05,093482,Rotar; Vladimir,6,0,34,28
1656972367484,MATH 197,001,091859,McAuley; Julian John,9999,0,9999,0
1656972367484,MATH 197,002,095566,Kedlaya; Kiran S.,9997,0,9999,2
1656972367484,MATH 197,003,095567,Xiao; Ming,9999,0,9999,0
1656972367484,MATH 197,004,095571,Perols; Johan Lars,9998,0,9999,1
1656972374538,COGS 9,A01,083615,Shannon; Kyle Michael,7,0,75,68
1656972380569,COGS 11,A01,083617,Boyle; Mary E. T.,20,0,48,28
1656972386594,COGS 13,A01,083071,Bastos; Amalia Pinkusfeld,9,0,71,62
1656972392617,COGS 14A,A01,092681,Semenuks; Arturs,0,1,100,100
1656972398641,COGS 14B,A01,083073,Cheng; Tzu-Han,5,0,63,58
1656972404664,COGS 17,A01,092677,Semenuks; Arturs,4,0,81,77
1656972410690,COGS 100,A01,083619,Allen; Michael Gordon,15,0,70,55
1656972416714,COGS 101A,A01,083621,Davis; Joshua Daniel,9,0,68,59
1656972422737,COGS 101B,A01,091572,Allen; Michael Gordon,8,0,65,57
1656972428763,COGS 101C,A01,083625,Delgado; Tania,17,0,35,18
1656972434787,COGS 107A,A01,083627,Boyle; Mary E. T.,13,0,60,47
1656972440813,COGS 118A,A01,083075,Gupta; Anjum,15,0,76,61
1656972446836,CSE 3,A50,083646,Miranda; Gregory Joseph,22,0,50,28
1656972452866,CSE 8A,A50,083650,Miranda; Gregory Joseph,17,1,56,39
1656972458890,CSE 11,A01,083080,Cao; Yingjun,4,15,40,36
1656972464912,CSE 12,A01,083652,Krause-Levy; Sophia Louisa,20,1,120,100
1656972470939,CSE 15L,A01,083654,Morris; Justin Loren,8,0,50,42
1656972470939,CSE 15L,A02,083655,Morris; Justin Loren,8,0,50,42
1656972476966,CSE 20,A01,083657,Tran; Khoa Dang,37,0,80,43
1656972482992,CSE 21,A01,095574,Bach; Quang Tran,21,0,48,27
1656972489015,CSE 30,A01,083084,Eldon; John,4,0,80,76
1656972489015,CSE 30,B01,095061,Bhaskar; Nishant,6,0,50,44
1656972495044,CSE 100,A01,083659,Cao; Yingjun,3,4,70,67
1656972501068,CSE 134B,A01,083661,Powell; Thomas Allan,19,0,100,81
1656972507091,CSE 140,A01,083663,Gungor; Onat,14,0,85,71
1656972513117,CSE 140L,A01,083088,Eldon; John,16,0,100,84
1656972519141,CSE 175,A01,083665,Kumar; Rakesh,3,0,25,22
1656972525165,CSE 190,A00,092507,Dubnov; Shlomo,7,0,20,13
1656972531191,ECE 45,A01,083139,Congero; Spencer William,5,0,75,70
1656972537217,ECE 65,A50,083695,Saad; Andrew S,12,0,30,18
1656972537217,ECE 65,A51,095125,Saad; Andrew S,25,0,26,1
1656972543242,ECE 109,A01,091882,Touri; Behrouz,16,0,70,54
1656972549265,ECE 180,A00,083140,Abi Samra; Nicholas Camill,1,0,30,29
1656972549265,ECE 180,B00,083141,Abi Samra; Nicholas Camill,0,0,30,30
1656972555299,MATH 10A,A01,083735,Patchell; Gregory David,1,0,30,29
1656972555299,MATH 10A,A02,083736,Patchell; Gregory David,20,0,30,10
1656972555299,MATH 10A,A03,083737,Patchell; Gregory David,15,0,30,15
1656972561323,MATH 10B,A01,083207,Lim; Seonhee,7,0,34,27
1656972561323,MATH 10B,A02,083208,Lim; Seonhee,9,0,35,26
1656972561323,MATH 10B,A03,093472,Lim; Seonhee,4,0,34,30
1656972561323,MATH 10B,B01,083739,Sinha; Shubham,9,0,30,21
1656972567352,MATH 18,A01,083743,Cinel; Cameron Alexander,6,0,30,24
1656972567352,MATH 18,A02,083744,Cinel; Cameron Alexander,15,0,30,15
1656972567352,MATH 18,A03,083745,Cinel; Cameron Alexander,8,0,30,22
1656972567352,MATH 18,B01,083748,Rideout; David Porter,4,0,37,33
1656972567352,MATH 18,B02,083749,Rideout; David Porter,3,0,36,33
1656972567352,MATH 18,B03,083750,Rideout; David Porter,2,0,37,35
1656972567352,MATH 18,B04,083751,Rideout; David Porter,5,0,36,31
1656972567352,MATH 18,B05,093473,Rideout; David Porter,4,0,36,32
1656972567352,MATH 18,B06,093474,Rideout; David Porter,5,0,36,31
1656972573374,MATH 20A,A01,083754,Zheng; Zequn,12,0,40,28
1656972579396,MATH 20B,A01,083756,Briones; Jor-el Thomas Caparas,1,0,36,35
1656972579396,MATH 20B,A02,083757,Briones; Jor-el Thomas Caparas,1,0,36,35
1656972579396,MATH 20B,A03,093475,Briones; Jor-el Thomas Caparas,0,0,36,36
1656972585424,MATH 20C,A01,083760,Briones; Jor-el Thomas Caparas,1,0,35,34
1656972585424,MATH 20C,A02,083761,Briones; Jor-el Thomas Caparas,8,0,35,27
1656972585424,MATH 20C,A03,093476,Briones; Jor-el Thomas Caparas,0,1,36,36
1656972585424,MATH 20C,B01,083762,Bach; Quang Tran,0,0,30,30
1656972591519,MATH 20D,A01,083765,Tran; Brian Kha,4,0,30,26
1656972591519,MATH 20D,A02,083766,Tran; Brian Kha,4,0,30,26
1656972591519,MATH 20D,A03,083767,Tran; Brian Kha,3,0,30,27
1656972597544,MATH 20E,A01,083771,Ganguly; Soumya,5,0,32,27
1656972597544,MATH 20E,A02,083772,Ganguly; Soumya,6,0,32,26
1656972597544,MATH 20E,B01,083773,Ciotti; Benjamin,18,0,35,17
1656972597544,MATH 20E,B02,083774,Ciotti; Benjamin,17,0,35,18
1656972603568,MATH 103A,A01,083777,Greenfeld; Be'Eri,2,0,36,34
1656972603568,MATH 103A,A02,083778,Greenfeld; Be'Eri,5,0,36,31
1656972603568,MATH 103A,A03,093561,Greenfeld; Be'Eri,4,0,36,32
1656972603568,MATH 103A,B01,083779,Greenfeld; Be'Eri,6,0,36,30
1656972603568,MATH 103A,B02,083780,Greenfeld; Be'Eri,2,0,36,34
1656972603568,MATH 103A,B03,093562,Greenfeld; Be'Eri,2,0,36,34
1656972609592,MATH 105,A01,085443,Carter; Anne Toulson,14,0,35,21
1656972609592,MATH 105,A02,093477,Carter; Anne Toulson,20,0,35,15
1656972615623,MATH 109,A01,083213,Ganzberger; Geoffrey Michael,2,0,34,32
1656972615623,MATH 109,A02,083214,Ganzberger; Geoffrey Michael,2,0,34,32
1656972615623,MATH 109,A03,093478,Ganzberger; Geoffrey Michael,1,0,34,33
1656972615623,MATH 109,B01,083215,Ganzberger; Geoffrey Michael,1,0,32,31
1656972615623,MATH 109,B02,083216,Ganzberger; Geoffrey Michael,1,0,32,31
1656972615623,MATH 109,B03,093479,Ganzberger; Geoffrey Michael,6,0,32,26
1656972621655,MATH 142A,A01,083219,Chow; Bennett,6,0,32,26
1656972621655,MATH 142A,A02,083220,Chow; Bennett,10,0,32,22
1656972621655,MATH 142A,A03,093480,Chow; Bennett,7,0,32,25
1656972621655,MATH 142A,B03,093481,Chow; Bennett,7,0,32,25
1656972621655,MATH 142A,B04,093558,Chow; Bennett,11,0,32,21
1656972621655,MATH 142A,B05,093559,Chow; Bennett,6,0,32,26
1656972627679,MATH 193A,A01,083224,Rotar; Vladimir,7,0,34,27
1656972627679,MATH 193A,A02,083225,Rotar; Vladimir,4,0,34,30
1656972627679,MATH 193A,A03,083781,Rotar; Vladimir,1,0,34,33
1656972627679,MATH 193A,A04,083782,Rotar; Vladimir,6,0,34,28
1656972627679,MATH 193A,A05,093482,Rotar; Vladimir,6,0,34,28
1656972633705,MATH 197,001,091859,McAuley; Julian John,9999,0,9999,0
1656972633705,MATH 197,002,095566,Kedlaya; Kiran S.,9997,0,9999,2
1656972633705,MATH 197,003,095567,Xiao; Ming,9999,0,9999,0
1656972633705,MATH 197,004,095571,Perols; Johan Lars,9998,0,9999,1
1656972640767,COGS 9,A01,083615,Shannon; Kyle Michael,7,0,75,68
1656972646793,COGS 11,A01,083617,Boyle; Mary E. T.,20,0,48,28
1656972652819,COGS 13,A01,083071,Bastos; Amalia Pinkusfeld,9,0,71,62
1656972658846,COGS 14A,A01,092681,Semenuks; Arturs,0,1,100,100
1656972664874,COGS 14B,A01,083073,Cheng; Tzu-Han,5,0,63,58
1656972670897,COGS 17,A01,092677,Semenuks; Arturs,4,0,81,77
1656972676920,COGS 100,A01,083619,Allen; Michael Gordon,15,0,70,55
1656972682947,COGS 101A,A01,083621,Davis; Joshua Daniel,9,0,68,59
1656972688973,COGS 101B,A01,091572,Allen; Michael Gordon,8,0,65,57
1656972694999,COGS 101C,A01,083625,Delgado; Tania,17,0,35,18
1656972701023,COGS 107A,A01,083627,Boyle; Mary E. T.,13,0,60,47
1656972707045,COGS 118A,A01,083075,Gupta; Anjum,15,0,76,61
1656972713069,CSE 3,A50,083646,Miranda; Gregory Joseph,22,0,50,28
1656972719094,CSE 8A,A50,083650,Miranda; Gregory Joseph,17,1,56,39
1656972725120,CSE 11,A01,083080,Cao; Yingjun,4,15,40,36
1656972731144,CSE 12,A01,083652,Krause-Levy; Sophia Louisa,20,1,120,100
1656972737169,CSE 15L,A01,083654,Morris; Justin Loren,8,0,50,42
1656972737169,CSE 15L,A02,083655,Morris; Justin Loren,8,0,50,42
1656972743199,CSE 20,A01,083657,Tran; Khoa Dang,37,0,80,43
1656972749225,CSE 21,A01,095574,Bach; Quang Tran,21,0,48,27
1656972755253,CSE 30,A01,083084,Eldon; John,4,0,80,76
1656972755253,CSE 30,B01,095061,Bhaskar; Nishant,6,0,50,44
1656972761278,CSE 100,A01,083659,Cao; Yingjun,3,4,70,67
1656972767307,CSE 134B,A01,083661,Powell; Thomas Allan,19,0,100,81
1656972773334,CSE 140,A01,083663,Gungor; Onat,14,0,85,71
1656972779361,CSE 140L,A01,083088,Eldon; John,16,0,100,84
1656972785384,CSE 175,A01,083665,Kumar; Rakesh,3,0,25,22
1656972791406,CSE 190,A00,092507,Dubnov; Shlomo,7,0,20,13
1656972797435,ECE 45,A01,083139,Congero; Spencer William,5,0,75,70
1656972803462,ECE 65,A50,083695,Saad; Andrew S,12,0,30,18
1656972803462,ECE 65,A51,095125,Saad; Andrew S,25,0,26,1
1656972809489,ECE 109,A01,091882,Touri; Behrouz,16,0,70,54
1656972815513,ECE 180,A00,083140,Abi Samra; Nicholas Camill,1,0,30,29
1656972815513,ECE 180,B00,083141,Abi Samra; Nicholas Camill,0,0,30,30
1656972821538,MATH 10A,A01,083735,Patchell; Gregory David,1,0,30,29
1656972821538,MATH 10A,A02,083736,Patchell; Gregory David,20,0,30,10
1656972821538,MATH 10A,A03,083737,Patchell; Gregory David,15,0,30,15
1656972827566,MATH 10B,A01,083207,Lim; Seonhee,7,0,34,27
1656972827566,MATH 10B,A02,083208,Lim; Seonhee,9,0,35,26
1656972827566,MATH 10B,A03,093472,Lim; Seonhee,4,0,34,30
1656972827566,MATH 10B,B01,083739,Sinha; Shubham,9,0,30,21
1656972833599,MATH 18,A01,083743,Cinel; Cameron Alexander,6,0,30,24
1656972833599,MATH 18,A02,083744,Cinel; Cameron Alexander,15,0,30,15
1656972833599,MATH 18,A03,083745,Cinel; Cameron Alexander,8,0,30,22
1656972833599,MATH 18,B01,083748,Rideout; David Porter,4,0,37,33
1656972833599,MATH 18,B02,083749,Rideout; David Porter,3,0,36,33
1656972833599,MATH 18,B03,083750,Rideout; David Porter,2,0,37,35
1656972833599,MATH 18,B04,083751,Rideout; David Porter,5,0,36,31
1656972833599,MATH 18,B05,093473,Rideout; David Porter,4,0,36,32
1656972833599,MATH 18,B06,093474,Rideout; David Porter,5,0,36,31
1656972839622,MATH 20A,A01,083754,Zheng; Zequn,12,0,40,28
1656972845646,MATH 20B,A01,083756,Briones; Jor-el Thomas Caparas,1,0,36,35
1656972845646,MATH 20B,A02,083757,Briones; Jor-el Thomas Caparas,1,0,36,35
1656972845646,MATH 20B,A03,093475,Briones; Jor-el Thomas Caparas,0,0,36,36
1656972851673,MATH 20C,A01,083760,Briones; Jor-el Thomas Caparas,1,0,35,34
1656972851673,MATH 20C,A02,083761,Briones; Jor-el Thomas Caparas,8,0,35,27
1656972851673,MATH 20C,A03,093476,Briones; Jor-el Thomas Caparas,0,1,36,36
1656972851673,MATH 20C,B01,083762,Bach; Quang Tran,0,0,30,30
1656972857702,MATH 20D,A01,083765,Tran; Brian Kha,4,0,30,26
1656972857702,MATH 20D,A02,083766,Tran; Brian Kha,4,0,30,26
1656972857702,MATH 20D,A03,083767,Tran; Brian Kha,3,0,30,27
1656972863731,MATH 20E,A01,083771,Ganguly; Soumya,5,0,32,27
1656972863731,MATH 20E,A02,083772,Ganguly; Soumya,6,0,32,26
1656972863731,MATH 20E,B01,083773,Ciotti; Benjamin,18,0,35,17
1656972863731,MATH 20E,B02,083774,Ciotti; Benjamin,17,0,35,18
1656972869760,MATH 103A,A01,083777,Greenfeld; Be'Eri,2,0,36,34
1656972869760,MATH 103A,A02,083778,Greenfeld; Be'Eri,5,0,36,31
1656972869760,MATH 103A,A03,093561,Greenfeld; Be'Eri,4,0,36,32
1656972869760,MATH 103A,B01,083779,Greenfeld; Be'Eri,6,0,36,30
1656972869760,MATH 103A,B02,083780,Greenfeld; Be'Eri,2,0,36,34
1656972869760,MATH 103A,B03,093562,Greenfeld; Be'Eri,2,0,36,34
1656972875784,MATH 105,A01,085443,Carter; Anne Toulson,14,0,35,21
1656972875784,MATH 105,A02,093477,Carter; Anne Toulson,20,0,35,15
1656972881807,MATH 109,A01,083213,Ganzberger; Geoffrey Michael,2,0,34,32
1656972881807,MATH 109,A02,083214,Ganzberger; Geoffrey Michael,2,0,34,32
1656972881807,MATH 109,A03,093478,Ganzberger; Geoffrey Michael,1,0,34,33
1656972881807,MATH 109,B01,083215,Ganzberger; Geoffrey Michael,1,0,32,31
1656972881807,MATH 109,B02,083216,Ganzberger; Geoffrey Michael,1,0,32,31
1656972881807,MATH 109,B03,093479,Ganzberger; Geoffrey Michael,6,0,32,26
1656972887835,MATH 142A,A01,083219,Chow; Bennett,6,0,32,26
1656972887835,MATH 142A,A02,083220,Chow; Bennett,10,0,32,22
1656972887835,MATH 142A,A03,093480,Chow; Bennett,7,0,32,25
1656972887835,MATH 142A,B03,093481,Chow; Bennett,7,0,32,25
1656972887835,MATH 142A,B04,093558,Chow; Bennett,11,0,32,21
1656972887835,MATH 142A,B05,093559,Chow; Bennett,6,0,32,26
1656972893860,MATH 193A,A01,083224,Rotar; Vladimir,7,0,34,27
1656972893860,MATH 193A,A02,083225,Rotar; Vladimir,4,0,34,30
1656972893860,MATH 193A,A03,083781,Rotar; Vladimir,1,0,34,33
1656972893860,MATH 193A,A04,083782,Rotar; Vladimir,6,0,34,28
1656972893860,MATH 193A,A05,093482,Rotar; Vladimir,6,0,34,28
1656972899883,MATH 197,001,091859,McAuley; Julian John,9999,0,9999,0
1656972899883,MATH 197,002,095566,Kedlaya; Kiran S.,9997,0,9999,2
1656972899883,MATH 197,003,095567,Xiao; Ming,9999,0,9999,0
1656972899883,MATH 197,004,095571,Perols; Johan Lars,9998,0,9999,1
1656972906937,COGS 9,A01,083615,Shannon; Kyle Michael,7,0,75,68
1656972912960,COGS 11,A01,083617,Boyle; Mary E. T.,20,0,48,28
1656972918988,COGS 13,A01,083071,Bastos; Amalia Pinkusfeld,9,0,71,62
1656972925014,COGS 14A,A01,092681,Semenuks; Arturs,0,1,100,100
1656972931042,COGS 14B,A01,083073,Cheng; Tzu-Han,5,0,63,58
1656972937065,COGS 17,A01,092677,Semenuks; Arturs,4,0,81,77
1656972943092,COGS 100,A01,083619,Allen; Michael Gordon,15,0,70,55
1656972949113,COGS 101A,A01,083621,Davis; Joshua Daniel,9,0,68,59
1656972955136,COGS 101B,A01,091572,Allen; Michael Gordon,8,0,65,57
1656972961163,COGS 101C,A01,083625,Delgado; Tania,17,0,35,18
1656972967185,COGS 107A,A01,083627,Boyle; Mary E. T.,13,0,60,47
1656972973213,COGS 118A,A01,083075,Gupta; Anjum,15,0,76,61
1656972979240,CSE 3,A50,083646,Miranda; Gregory Joseph,22,0,50,28
1656972985265,CSE 8A,A50,083650,Miranda; Gregory Joseph,17,1,56,39
1656972991288,CSE 11,A01,083080,Cao; Yingjun,4,15,40,36
1656972997315,CSE 12,A01,083652,Krause-Levy; Sophia Louisa,20,1,120,100
1656973003340,CSE 15L,A01,083654,Morris; Justin Loren,8,0,50,42
1656973003340,CSE 15L,A02,083655,Morris; Justin Loren,8,0,50,42
1656973009364,CSE 20,A01,083657,Tran; Khoa Dang,37,0,80,43
1656973015386,CSE 21,A01,095574,Bach; Quang Tran,21,0,48,27
1656973021414,CSE 30,A01,083084,Eldon; John,4,0,80,76
1656973021414,CSE 30,B01,095061,Bhaskar; Nishant,6,0,50,44
1656973027438,CSE 100,A01,083659,Cao; Yingjun,3,4,70,67
1656973033461,CSE 134B,A01,083661,Powell; Thomas Allan,19,0,100,81
1656973039483,CSE 140,A01,083663,Gungor; Onat,14,0,85,71
1656973045507,CSE 140L,A01,083088,Eldon; John,16,0,100,84
1656973051530,CSE 175,A01,083665,Kumar; Rakesh,3,0,25,22
1656973057552,CSE 190,A00,092507,Dubnov; Shlomo,7,0,20,13
1656973063575,ECE 45,A01,083139,Congero; Spencer William,5,0,75,70
1656973069598,ECE 65,A50,083695,Saad; Andrew S,12,0,30,18
1656973069598,ECE 65,A51,095125,Saad; Andrew S,25,0,26,1
1656973075626,ECE 109,A01,091882,Touri; Behrouz,16,0,70,54
1656973081650,ECE 180,A00,083140,Abi Samra; Nicholas Camill,1,0,30,29
1656973081650,ECE 180,B00,083141,Abi Samra; Nicholas Camill,0,0,30,30
1656973087677,MATH 10A,A01,083735,Patchell; Gregory David,1,0,30,29
1656973087677,MATH 10A,A02,083736,Patchell; Gregory David,20,0,30,10
1656973087677,MATH 10A,A03,083737,Patchell; Gregory David,15,0,30,15
1656973093704,MATH 10B,A01,083207,Lim; Seonhee,7,0,34,27
1656973093704,MATH 10B,A02,083208,Lim; Seonhee,9,0,35,26
1656973093704,MATH 10B,A03,093472,Lim; Seonhee,4,0,34,30
1656973093704,MATH 10B,B01,083739,Sinha; Shubham,9,0,30,21
1656973099728,MATH 18,A01,083743,Cinel; Cameron Alexander,6,0,30,24
1656973099728,MATH 18,A02,083744,Cinel; Cameron Alexander,15,0,30,15
1656973099728,MATH 18,A03,083745,Cinel; Cameron Alexander,8,0,30,22
1656973099728,MATH 18,B01,083748,Rideout; David Porter,4,0,37,33
1656973099728,MATH 18,B02,083749,Rideout; David Porter,3,0,36,33
1656973099728,MATH 18,B03,083750,Rideout; David Porter,2,0,37,35
1656973099728,MATH 18,B04,083751,Rideout; David Porter,5,0,36,31
1656973099728,MATH 18,B05,093473,Rideout; David Porter,4,0,36,32
1656973099728,MATH 18,B06,093474,Rideout; David Porter,5,0,36,31
1656973105754,MATH 20A,A01,083754,Zheng; Zequn,12,0,40,28
1656973111780,MATH 20B,A01,083756,Briones; Jor-el Thomas Caparas,1,0,36,35
1656973111780,MATH 20B,A02,083757,Briones; Jor-el Thomas Caparas,1,0,36,35
1656973111780,MATH 20B,A03,093475,Briones; Jor-el Thomas Caparas,0,0,36,36
1656973117803,MATH 20C,A01,083760,Briones; Jor-el Thomas Caparas,1,0,35,34
1656973117803,MATH 20C,A02,083761,Briones; Jor-el Thomas Caparas,8,0,35,27
1656973117803,MATH 20C,A03,093476,Briones; Jor-el Thomas Caparas,0,1,36,36
1656973117803,MATH 20C,B01,083762,Bach; Quang Tran,0,0,30,30
1656973123832,MATH 20D,A01,083765,Tran; Brian Kha,4,0,30,26
1656973123832,MATH 20D,A02,083766,Tran; Brian Kha,4,0,30,26
1656973123832,MATH 20D,A03,083767,Tran; Brian Kha,3,0,30,27
1656973129856,MATH 20E,A01,083771,Ganguly; Soumya,5,0,32,27
1656973129856,MATH 20E,A02,083772,Ganguly; Soumya,6,0,32,26
1656973129856,MATH 20E,B01,083773,Ciotti; Benjamin,18,0,35,17
1656973129856,MATH 20E,B02,083774,Ciotti; Benjamin,17,0,35,18
1656973135886,MATH 103A,A01,083777,Greenfeld; Be'Eri,2,0,36,34
1656973135886,MATH 103A,A02,083778,Greenfeld; Be'Eri,5,0,36,31
1656973135886,MATH 103A,A03,093561,Greenfeld; Be'Eri,4,0,36,32
1656973135886,MATH 103A,B01,083779,Greenfeld; Be'Eri,6,0,36,30
1656973135886,MATH 103A,B02,083780,Greenfeld; Be'Eri,2,0,36,34
1656973135886,MATH 103A,B03,093562,Greenfeld; Be'Eri,2,0,36,34
1656973141908,MATH 105,A01,085443,Carter; Anne Toulson,14,0,35,21
1656973141908,MATH 105,A02,093477,Carter; Anne Toulson,20,0,35,15
1656973147938,MATH 109,A01,083213,Ganzberger; Geoffrey Michael,2,0,34,32
1656973147938,MATH 109,A02,083214,Ganzberger; Geoffrey Michael,2,0,34,32
1656973147938,MATH 109,A03,093478,Ganzberger; Geoffrey Michael,1,0,34,33
1656973147938,MATH 109,B01,083215,Ganzberger; Geoffrey Michael,1,0,32,31
1656973147938,MATH 109,B02,083216,Ganzberger; Geoffrey Michael,1,0,32,31
1656973147938,MATH 109,B03,093479,Ganzberger; Geoffrey Michael,6,0,32,26
1656973153962,MATH 142A,A01,083219,Chow; Bennett,6,0,32,26
1656973153962,MATH 142A,A02,083220,Chow; Bennett,10,0,32,22
1656973153962,MATH 142A,A03,093480,Chow; Bennett,7,0,32,25
1656973153962,MATH 142A,B03,093481,Chow; Bennett,7,0,32,25
1656973153962,MATH 142A,B04,093558,Chow; Bennett,11,0,32,21
1656973153962,MATH 142A,B05,093559,Chow; Bennett,6,0,32,26
1656973159999,MATH 193A,A01,083224,Rotar; Vladimir,7,0,34,27
1656973159999,MATH 193A,A02,083225,Rotar; Vladimir,4,0,34,30
1656973159999,MATH 193A,A03,083781,Rotar; Vladimir,1,0,34,33
1656973159999,MATH 193A,A04,083782,Rotar; Vladimir,6,0,34,28
1656973159999,MATH 193A,A05,093482,Rotar; Vladimir,6,0,34,28
1656973166023,MATH 197,001,091859,McAuley; Julian John,9999,0,9999,0
1656973166023,MATH 197,002,095566,Kedlaya; Kiran S.,9997,0,9999,2
1656973166023,MATH 197,003,095567,Xiao; Ming,9999,0,9999,0
1656973166023,MATH 197,004,095571,Perols; Johan Lars,9998,0,9999,1
1656973173082,COGS 9,A01,083615,Shannon; Kyle Michael,7,0,75,68
1656973179106,COGS 11,A01,083617,Boyle; Mary E. T.,20,0,48,28
1656973185200,COGS 13,A01,083071,Bastos; Amalia Pinkusfeld,9,0,71,62
1656973191224,COGS 14A,A01,092681,Semenuks; Arturs,0,1,100,100
1656973197252,COGS 14B,A01,083073,Cheng; Tzu-Han,5,0,63,58
1656973203274,COGS 17,A01,092677,Semenuks; Arturs,4,0,81,77
1656973209297,COGS 100,A01,083619,Allen; Michael Gordon,15,0,70,55
1656973215327,COGS 101A,A01,083621,Davis; Joshua Daniel,9,0,68,59
1656973221352,COGS 101B,A01,091572,Allen; Michael Gordon,8,0,65,57
1656973227376,COGS 101C,A01,083625,Delgado; Tania,17,0,35,18
1656973233403,COGS 107A,A01,083627,Boyle; Mary E. T.,13,0,60,47
1656973239427,COGS 118A,A01,083075,Gupta; Anjum,15,0,76,61
1656973245450,CSE 3,A50,083646,Miranda; Gregory Joseph,22,0,50,28
1656973251471,CSE 8A,A50,083650,Miranda; Gregory Joseph,17,1,56,39
1656973257509,CSE 11,A01,083080,Cao; Yingjun,4,15,40,36
1656973263533,CSE 12,A01,083652,Krause-Levy; Sophia Louisa,20,1,120,100
1656973269559,CSE 15L,A01,083654,Morris; Justin Loren,8,0,50,42
1656973269559,CSE 15L,A02,083655,Morris; Justin Loren,8,0,50,42
1656973275595,CSE 20,A01,083657,Tran; Khoa Dang,37,0,80,43
1656973281618,CSE 21,A01,095574,Bach; Quang Tran,21,0,48,27
1656973287652,CSE 30,A01,083084,Eldon; John,4,0,80,76
1656973287652,CSE 30,B01,095061,Bhaskar; Nishant,6,0,50,44
1656973293676,CSE 100,A01,083659,Cao; Yingjun,3,4,70,67
1656973299704,CSE 134B,A01,083661,Powell; Thomas Allan,19,0,100,81
1656973305726,CSE 140,A01,083663,Gungor; Onat,14,0,85,71
1656973311749,CSE 140L,A01,083088,Eldon; John,16,0,100,84
1656973317777,CSE 175,A01,083665,Kumar; Rakesh,3,0,25,22
1656973323804,CSE 190,A00,092507,Dubnov; Shlomo,7,0,20,13
1656973329830,ECE 45,A01,083139,Congero; Spencer William,5,0,75,70
1656973335853,ECE 65,A50,083695,Saad; Andrew S,12,0,30,18
1656973335853,ECE 65,A51,095125,Saad; Andrew S,25,0,26,1
1656973341888,ECE 109,A01,091882,Touri; Behrouz,16,0,70,54
1656973347911,ECE 180,A00,083140,Abi Samra; Nicholas Camill,1,0,30,29
1656973347911,ECE 180,B00,083141,Abi Samra; Nicholas Camill,0,0,30,30
1656973353939,MATH 10A,A01,083735,Patchell; Gregory David,1,0,30,29
1656973353939,MATH 10A,A02,083736,Patchell; Gregory David,20,0,30,10
1656973353939,MATH 10A,A03,083737,Patchell; Gregory David,15,0,30,15
1656973359966,MATH 10B,A01,083207,Lim; Seonhee,7,0,34,27
1656973359966,MATH 10B,A02,083208,Lim; Seonhee,9,0,35,26
1656973359966,MATH 10B,A03,093472,Lim; Seonhee,4,0,34,30
1656973359966,MATH 10B,B01,083739,Sinha; Shubham,9,0,30,21
1656973366002,MATH 18,A01,083743,Cinel; Cameron Alexander,6,0,30,24
1656973366002,MATH 18,A02,083744,Cinel; Cameron Alexander,15,0,30,15
1656973366002,MATH 18,A03,083745,Cinel; Cameron Alexander,8,0,30,22
1656973366002,MATH 18,B01,083748,Rideout; David Porter,4,0,37,33
1656973366002,MATH 18,B02,083749,Rideout; David Porter,3,0,36,33
1656973366002,MATH 18,B03,083750,Rideout; David Porter,2,0,37,35
1656973366002,MATH 18,B04,083751,Rideout; David Porter,5,0,36,31
1656973366002,MATH 18,B05,093473,Rideout; David Porter,4,0,36,32
1656973366002,MATH 18,B06,093474,Rideout; David Porter,5,0,36,31
1656973372025,MATH 20A,A01,083754,Zheng; Zequn,12,0,40,28
1656973378052,MATH 20B,A01,083756,Briones; Jor-el Thomas Caparas,1,0,36,35
1656973378052,MATH 20B,A02,083757,Briones; Jor-el Thomas Caparas,1,0,36,35
1656973378052,MATH 20B,A03,093475,Briones; Jor-el Thomas Caparas,0,0,36,36
1656973384078,MATH 20C,A01,083760,Briones; Jor-el Thomas Caparas,1,0,35,34
1656973384078,MATH 20C,A02,083761,Briones; Jor-el Thomas Caparas,8,0,35,27
1656973384078,MATH 20C,A03,093476,Briones; Jor-el Thomas Caparas,0,1,36,36
1656973384078,MATH 20C,B01,083762,Bach; Quang Tran,0,0,30,30
1656973390102,MATH 20D,A01,083765,Tran; Brian Kha,4,0,30,26
1656973390102,MATH 20D,A02,083766,Tran; Brian Kha,4,0,30,26
1656973390102,MATH 20D,A03,083767,Tran; Brian Kha,3,0,30,27
1656973396125,MATH 20E,A01,083771,Ganguly; Soumya,5,0,32,27
1656973396125,MATH 20E,A02,083772,Ganguly; Soumya,6,0,32,26
1656973396125,MATH 20E,B01,083773,Ciotti; Benjamin,18,0,35,17
1656973396125,MATH 20E,B02,083774,Ciotti; Benjamin,17,0,35,18
1656973402149,MATH 103A,A01,083777,Greenfeld; Be'Eri,2,0,36,34
1656973402149,MATH 103A,A02,083778,Greenfeld; Be'Eri,5,0,36,31
1656973402149,MATH 103A,A03,093561,Greenfeld; Be'Eri,4,0,36,32
1656973402149,MATH 103A,B01,083779,Greenfeld; Be'Eri,6,0,36,30
1656973402149,MATH 103A,B02,083780,Greenfeld; Be'Eri,2,0,36,34
1656973402149,MATH 103A,B03,093562,Greenfeld; Be'Eri,2,0,36,34
1656973408176,MATH 105,A01,085443,Carter; Anne Toulson,14,0,35,21
1656973408176,MATH 105,A02,093477,Carter; Anne Toulson,20,0,35,15
1656973414200,MATH 109,A01,083213,Ganzberger; Geoffrey Michael,2,0,34,32
1656973414200,MATH 109,A02,083214,Ganzberger; Geoffrey Michael,2,0,34,32
1656973414200,MATH 109,A03,093478,Ganzberger; Geoffrey Michael,1,0,34,33
1656973414200,MATH 109,B01,083215,Ganzberger; Geoffrey Michael,1,0,32,31
1656973414200,MATH 109,B02,083216,Ganzberger; Geoffrey Michael,1,0,32,31
1656973414200,MATH 109,B03,093479,Ganzberger; Geoffrey Michael,6,0,32,26
1656973420225,MATH 142A,A01,083219,Chow; Bennett,6,0,32,26
1656973420225,MATH 142A,A02,083220,Chow; Bennett,10,0,32,22
1656973420225,MATH 142A,A03,093480,Chow; Bennett,7,0,32,25
1656973420225,MATH 142A,B03,093481,Chow; Bennett,7,0,32,25
1656973420225,MATH 142A,B04,093558,Chow; Bennett,11,0,32,21
1656973420225,MATH 142A,B05,093559,Chow; Bennett,6,0,32,26
1656973426249,MATH 193A,A01,083224,Rotar; Vladimir,7,0,34,27
1656973426249,MATH 193A,A02,083225,Rotar; Vladimir,4,0,34,30
1656973426249,MATH 193A,A03,083781,Rotar; Vladimir,1,0,34,33
1656973426249,MATH 193A,A04,083782,Rotar; Vladimir,6,0,34,28
1656973426249,MATH 193A,A05,093482,Rotar; Vladimir,6,0,34,28
1656973432271,MATH 197,001,091859,McAuley; Julian John,9999,0,9999,0
1656973432271,MATH 197,002,095566,Kedlaya; Kiran S.,9997,0,9999,2
1656973432271,MATH 197,003,095567,Xiao; Ming,9999,0,9999,0
1656973432271,MATH 197,004,095571,Perols; Johan Lars,9998,0,9999,1
1656973439337,COGS 9,A01,083615,Shannon; Kyle Michael,7,0,75,68
1656973445371,COGS 11,A01,083617,Boyle; Mary E. T.,20,0,48,28
1656973451393,COGS 13,A01,083071,Bastos; Amalia Pinkusfeld,9,0,71,62
1656973457420,COGS 14A,A01,092681,Semenuks; Arturs,0,1,100,100
1656973463442,COGS 14B,A01,083073,Cheng; Tzu-Han,5,0,63,58
1656973469466,COGS 17,A01,092677,Semenuks; Arturs,4,0,81,77
1656973475493,COGS 100,A01,083619,Allen; Michael Gordon,15,0,70,55
1656973481517,COGS 101A,A01,083621,Davis; Joshua Daniel,9,0,68,59
1656973487545,COGS 101B,A01,091572,Allen; Michael Gordon,8,0,65,57
1656973493568,COGS 101C,A01,083625,Delgado; Tania,17,0,35,18
1656973499592,COGS 107A,A01,083627,Boyle; Mary E. T.,13,0,60,47
1656973505614,COGS 118A,A01,083075,Gupta; Anjum,15,0,76,61
1656973511636,CSE 3,A50,083646,Miranda; Gregory Joseph,22,0,50,28
1656973517659,CSE 8A,A50,083650,Miranda; Gregory Joseph,17,1,56,39
1656973523685,CSE 11,A01,083080,Cao; Yingjun,4,15,40,36
1656973529707,CSE 12,A01,083652,Krause-Levy; Sophia Louisa,20,1,120,100
1656973535734,CSE 15L,A01,083654,Morris; Justin Loren,8,0,50,42
1656973535734,CSE 15L,A02,083655,Morris; Justin Loren,8,0,50,42
1656973541757,CSE 20,A01,083657,Tran; Khoa Dang,37,0,80,43
1656973547783,CSE 21,A01,095574,Bach; Quang Tran,21,0,48,27
1656973553808,CSE 30,A01,083084,Eldon; John,4,0,80,76
1656973553808,CSE 30,B01,095061,Bhaskar; Nishant,6,0,50,44
1656973559832,CSE 100,A01,083659,Cao; Yingjun,3,4,70,67
1656973565855,CSE 134B,A01,083661,Powell; Thomas Allan,19,0,100,81
1656973571879,CSE 140,A01,083663,Gungor; Onat,14,0,85,71
1656973577905,CSE 140L,A01,083088,Eldon; John,16,0,100,84
1656973583934,CSE 175,A01,083665,Kumar; Rakesh,3,0,25,22
1656973589962,CSE 190,A00,092507,Dubnov; Shlomo,7,0,20,13
1656973595986,ECE 45,A01,083139,Congero; Spencer William,5,0,75,70
1656973602011,ECE 65,A50,083695,Saad; Andrew S,12,0,30,18
1656973602011,ECE 65,A51,095125,Saad; Andrew S,25,0,26,1
1656973608036,ECE 109,A01,091882,Touri; Behrouz,16,0,70,54
1656973614059,ECE 180,A00,083140,Abi Samra; Nicholas Camill,1,0,30,29
1656973614059,ECE 180,B00,083141,Abi Samra; Nicholas Camill,0,0,30,30
1656973620088,MATH 10A,A01,083735,Patchell; Gregory David,1,0,30,29
1656973620088,MATH 10A,A02,083736,Patchell; Gregory David,20,0,30,10
1656973620088,MATH 10A,A03,083737,Patchell; Gregory David,15,0,30,15
1656973626113,MATH 10B,A01,083207,Lim; Seonhee,7,0,34,27
1656973626113,MATH 10B,A02,083208,Lim; Seonhee,9,0,35,26
1656973626113,MATH 10B,A03,093472,Lim; Seonhee,4,0,34,30
1656973626113,MATH 10B,B01,083739,Sinha; Shubham,9,0,30,21
1656973632138,MATH 18,A01,083743,Cinel; Cameron Alexander,6,0,30,24
1656973632138,MATH 18,A02,083744,Cinel; Cameron Alexander,15,0,30,15
1656973632138,MATH 18,A03,083745,Cinel; Cameron Alexander,8,0,30,22
1656973632138,MATH 18,B01,083748,Rideout; David Porter,4,0,37,33
1656973632138,MATH 18,B02,083749,Rideout; David Porter,3,0,36,33
1656973632138,MATH 18,B03,083750,Rideout; David Porter,2,0,37,35
1656973632138,MATH 18,B04,083751,Rideout; David Porter,5,0,36,31
1656973632138,MATH 18,B05,093473,Rideout; David Porter,4,0,36,32
1656973632138,MATH 18,B06,093474,Rideout; David Porter,5,0,36,31
1656973638164,MATH 20A,A01,083754,Zheng; Zequn,12,0,40,28
1656973644190,MATH 20B,A01,083756,Briones; Jor-el Thomas Caparas,1,0,36,35
1656973644190,MATH 20B,A02,083757,Briones; Jor-el Thomas Caparas,1,0,36,35
1656973644190,MATH 20B,A03,093475,Briones; Jor-el Thomas Caparas,0,0,36,36
1656973650215,MATH 20C,A01,083760,Briones; Jor-el Thomas Caparas,1,0,35,34
1656973650215,MATH 20C,A02,083761,Briones; Jor-el Thomas Caparas,8,0,35,27
1656973650215,MATH 20C,A03,093476,Briones; Jor-el Thomas Caparas,0,1,36,36
1656973650215,MATH 20C,B01,083762,Bach; Quang Tran,0,0,30,30
1656973656238,MATH 20D,A01,083765,Tran; Brian Kha,4,0,30,26
1656973656238,MATH 20D,A02,083766,Tran; Brian Kha,4,0,30,26
1656973656238,MATH 20D,A03,083767,Tran; Brian Kha,3,0,30,27
1656973662266,MATH 20E,A01,083771,Ganguly; Soumya,5,0,32,27
1656973662266,MATH 20E,A02,083772,Ganguly; Soumya,6,0,32,26
1656973662266,MATH 20E,B01,083773,Ciotti; Benjamin,18,0,35,17
1656973662266,MATH 20E,B02,083774,Ciotti; Benjamin,17,0,35,18
1656973668290,MATH 103A,A01,083777,Greenfeld; Be'Eri,2,0,36,34
1656973668290,MATH 103A,A02,083778,Greenfeld; Be'Eri,5,0,36,31
1656973668290,MATH 103A,A03,093561,Greenfeld; Be'Eri,4,0,36,32
1656973668290,MATH 103A,B01,083779,Greenfeld; Be'Eri,6,0,36,30
1656973668290,MATH 103A,B02,083780,Greenfeld; Be'Eri,2,0,36,34
1656973668290,MATH 103A,B03,093562,Greenfeld; Be'Eri,2,0,36,34
1656973674312,MATH 105,A01,085443,Carter; Anne Toulson,14,0,35,21
1656973674312,MATH 105,A02,093477,Carter; Anne Toulson,20,0,35,15
1656973680335,MATH 109,A01,083213,Ganzberger; Geoffrey Michael,2,0,34,32
1656973680335,MATH 109,A02,083214,Ganzberger; Geoffrey Michael,2,0,34,32
1656973680335,MATH 109,A03,093478,Ganzberger; Geoffrey Michael,1,0,34,33
1656973680335,MATH 109,B01,083215,Ganzberger; Geoffrey Michael,1,0,32,31
1656973680335,MATH 109,B02,083216,Ganzberger; Geoffrey Michael,1,0,32,31
1656973680335,MATH 109,B03,093479,Ganzberger; Geoffrey Michael,6,0,32,26
1656973686368,MATH 142A,A01,083219,Chow; Bennett,6,0,32,26
1656973686368,MATH 142A,A02,083220,Chow; Bennett,10,0,32,22
1656973686368,MATH 142A,A03,093480,Chow; Bennett,7,0,32,25
1656973686368,MATH 142A,B03,093481,Chow; Bennett,7,0,32,25
1656973686368,MATH 142A,B04,093558,Chow; Bennett,11,0,32,21
1656973686368,MATH 142A,B05,093559,Chow; Bennett,6,0,32,26
1656973692396,MATH 193A,A01,083224,Rotar; Vladimir,7,0,34,27
1656973692396,MATH 193A,A02,083225,Rotar; Vladimir,4,0,34,30
1656973692396,MATH 193A,A03,083781,Rotar; Vladimir,1,0,34,33
1656973692396,MATH 193A,A04,083782,Rotar; Vladimir,6,0,34,28
1656973692396,MATH 193A,A05,093482,Rotar; Vladimir,6,0,34,28
1656973698421,MATH 197,001,091859,McAuley; Julian John,9999,0,9999,0
1656973698421,MATH 197,002,095566,Kedlaya; Kiran S.,9997,0,9999,2
1656973698421,MATH 197,003,095567,Xiao; Ming,9999,0,9999,0
1656973698421,MATH 197,004,095571,Perols; Johan Lars,9998,0,9999,1
1656973705480,COGS 9,A01,083615,Shannon; Kyle Michael,7,0,75,68
1656973711507,COGS 11,A01,083617,Boyle; Mary E. T.,20,0,48,28
1656973717529,COGS 13,A01,083071,Bastos; Amalia Pinkusfeld,9,0,71,62
1656973723553,COGS 14A,A01,092681,Semenuks; Arturs,0,1,100,100
1656973729591,COGS 14B,A01,083073,Cheng; Tzu-Han,5,0,63,58
1656973735618,COGS 17,A01,092677,Semenuks; Arturs,4,0,81,77
1656973741642,COGS 100,A01,083619,Allen; Michael Gordon,15,0,70,55
1656973747664,COGS 101A,A01,083621,Davis; Joshua Daniel,9,0,68,59
1656973753686,COGS 101B,A01,091572,Allen; Michael Gordon,8,0,65,57
1656973759711,COGS 101C,A01,083625,Delgado; Tania,17,0,35,18
1656973765737,COGS 107A,A01,083627,Boyle; Mary E. T.,13,0,60,47
1656973771759,COGS 118A,A01,083075,Gupta; Anjum,15,0,76,61
1656973777803,CSE 3,A50,083646,Miranda; Gregory Joseph,22,0,50,28
1656973783924,CSE 8A,A50,083650,Miranda; Gregory Joseph,17,1,56,39
1656973789948,CSE 11,A01,083080,Cao; Yingjun,4,15,40,36
1656973795970,CSE 12,A01,083652,Krause-Levy; Sophia Louisa,20,1,120,100
1656973801994,CSE 15L,A01,083654,Morris; Justin Loren,8,0,50,42
1656973801994,CSE 15L,A02,083655,Morris; Justin Loren,8,0,50,42
1656973808018,CSE 20,A01,083657,Tran; Khoa Dang,37,0,80,43
1656973814046,CSE 21,A01,095574,Bach; Quang Tran,21,0,48,27
1656973820075,CSE 30,A01,083084,Eldon; John,4,0,80,76
1656973820075,CSE 30,B01,095061,Bhaskar; Nishant,6,0,50,44
1656973826098,CSE 100,A01,083659,Cao; Yingjun,3,4,70,67
1656973832123,CSE 134B,A01,083661,Powell; Thomas Allan,19,0,100,81
1656973838152,CSE 140,A01,083663,Gungor; Onat,14,0,85,71
1656973844176,CSE 140L,A01,083088,Eldon; John,16,0,100,84
1656973850201,CSE 175,A01,083665,Kumar; Rakesh,3,0,25,22
1656973856225,CSE 190,A00,092507,Dubnov; Shlomo,7,0,20,13
1656973862252,ECE 45,A01,083139,Congero; Spencer William,5,0,75,70
1656973868275,ECE 65,A50,083695,Saad; Andrew S,12,0,30,18
1656973868275,ECE 65,A51,095125,Saad; Andrew S,25,0,26,1
1656973874302,ECE 109,A01,091882,Touri; Behrouz,16,0,70,54
1656973880325,ECE 180,A00,083140,Abi Samra; Nicholas Camill,1,0,30,29
1656973880325,ECE 180,B00,083141,Abi Samra; Nicholas Camill,0,0,30,30
1656973886363,MATH 10A,A01,083735,Patchell; Gregory David,1,0,30,29
1656973886363,MATH 10A,A02,083736,Patchell; Gregory David,20,0,30,10
1656973886363,MATH 10A,A03,083737,Patchell; Gregory David,15,0,30,15
1656973892392,MATH 10B,A01,083207,Lim; Seonhee,7,0,34,27
1656973892392,MATH 10B,A02,083208,Lim; Seonhee,9,0,35,26
1656973892392,MATH 10B,A03,093472,Lim; Seonhee,4,0,34,30
1656973892392,MATH 10B,B01,083739,Sinha; Shubham,9,0,30,21
1656973898423,MATH 18,A01,083743,Cinel; Cameron Alexander,6,0,30,24
1656973898423,MATH 18,A02,083744,Cinel; Cameron Alexander,15,0,30,15
1656973898423,MATH 18,A03,083745,Cinel; Cameron Alexander,8,0,30,22
1656973898423,MATH 18,B01,083748,Rideout; David Porter,4,0,37,33
1656973898423,MATH 18,B02,083749,Rideout; David Porter,3,0,36,33
1656973898423,MATH 18,B03,083750,Rideout; David Porter,2,0,37,35
1656973898423,MATH 18,B04,083751,Rideout; David Porter,5,0,36,31
1656973898423,MATH 18,B05,093473,Rideout; David Porter,4,0,36,32
1656973898423,MATH 18,B06,093474,Rideout; David Porter,5,0,36,31
1656973904446,MATH 20A,A01,083754,Zheng; Zequn,12,0,40,28
1656973910469,MATH 20B,A01,083756,Briones; Jor-el Thomas Caparas,1,0,36,35
1656973910469,MATH 20B,A02,083757,Briones; Jor-el Thomas Caparas,1,0,36,35
1656973910469,MATH 20B,A03,093475,Briones; Jor-el Thomas Caparas,0,0,36,36
1656973916497,MATH 20C,A01,083760,Briones; Jor-el Thomas Caparas,1,0,35,34
1656973916497,MATH 20C,A02,083761,Briones; Jor-el Thomas Caparas,8,0,35,27
1656973916497,MATH 20C,A03,093476,Briones; Jor-el Thomas Caparas,0,1,36,36
1656973916497,MATH 20C,B01,083762,Bach; Quang Tran,0,0,30,30
1656973922527,MATH 20D,A01,083765,Tran; Brian Kha,4,0,30,26
1656973922527,MATH 20D,A02,083766,Tran; Brian Kha,4,0,30,26
1656973922527,MATH 20D,A03,083767,Tran; Brian Kha,3,0,30,27
1656973928554,MATH 20E,A01,083771,Ganguly; Soumya,5,0,32,27
1656973928554,MATH 20E,A02,083772,Ganguly; Soumya,6,0,32,26
1656973928554,MATH 20E,B01,083773,Ciotti; Benjamin,18,0,35,17
1656973928554,MATH 20E,B02,083774,Ciotti; Benjamin,17,0,35,18
1656973934588,MATH 103A,A01,083777,Greenfeld; Be'Eri,2,0,36,34
1656973934588,MATH 103A,A02,083778,Greenfeld; Be'Eri,5,0,36,31
1656973934588,MATH 103A,A03,093561,Greenfeld; Be'Eri,4,0,36,32
1656973934588,MATH 103A,B01,083779,Greenfeld; Be'Eri,6,0,36,30
1656973934588,MATH 103A,B02,083780,Greenfeld; Be'Eri,2,0,36,34
1656973934588,MATH 103A,B03,093562,Greenfeld; Be'Eri,2,0,36,34
1656973940611,MATH 105,A01,085443,Carter; Anne Toulson,14,0,35,21
1656973940611,MATH 105,A02,093477,Carter; Anne Toulson,20,0,35,15
1656973946640,MATH 109,A01,083213,Ganzberger; Geoffrey Michael,2,0,34,32
1656973946640,MATH 109,A02,083214,Ganzberger; Geoffrey Michael,2,0,34,32
1656973946640,MATH 109,A03,093478,Ganzberger; Geoffrey Michael,1,0,34,33
1656973946640,MATH 109,B01,083215,Ganzberger; Geoffrey Michael,1,0,32,31
1656973946640,MATH 109,B02,083216,Ganzberger; Geoffrey Michael,1,0,32,31
1656973946640,MATH 109,B03,093479,Ganzberger; Geoffrey Michael,6,0,32,26
1656973952688,MATH 142A,A01,083219,Chow; Bennett,6,0,32,26
1656973952688,MATH 142A,A02,083220,Chow; Bennett,10,0,32,22
1656973952688,MATH 142A,A03,093480,Chow; Bennett,7,0,32,25
1656973952688,MATH 142A,B03,093481,Chow; Bennett,7,0,32,25
1656973952688,MATH 142A,B04,093558,Chow; Bennett,11,0,32,21
1656973952688,MATH 142A,B05,093559,Chow; Bennett,6,0,32,26
1656973958716,MATH 193A,A01,083224,Rotar; Vladimir,7,0,34,27
1656973958716,MATH 193A,A02,083225,Rotar; Vladimir,4,0,34,30
1656973958716,MATH 193A,A03,083781,Rotar; Vladimir,1,0,34,33
1656973958716,MATH 193A,A04,083782,Rotar; Vladimir,6,0,34,28
1656973958716,MATH 193A,A05,093482,Rotar; Vladimir,6,0,34,28
1656973964740,MATH 197,001,091859,McAuley; Julian John,9999,0,9999,0
1656973964740,MATH 197,002,095566,Kedlaya; Kiran S.,9997,0,9999,2
1656973964740,MATH 197,003,095567,Xiao; Ming,9999,0,9999,0
1656973964740,MATH 197,004,095571,Perols; Johan Lars,9998,0,9999,1
1656973971799,COGS 9,A01,083615,Shannon; Kyle Michael,7,0,75,68
1656973977824,COGS 11,A01,083617,Boyle; Mary E. T.,20,0,48,28
1656973983851,COGS 13,A01,083071,Bastos; Amalia Pinkusfeld,9,0,71,62
1656973989879,COGS 14A,A01,092681,Semenuks; Arturs,0,1,100,100
1656973995907,COGS 14B,A01,083073,Cheng; Tzu-Han,5,0,63,58
1656974001931,COGS 17,A01,092677,Semenuks; Arturs,4,0,81,77
1656974007960,COGS 100,A01,083619,Allen; Michael Gordon,15,0,70,55
1656974013987,COGS 101A,A01,083621,Davis; Joshua Daniel,9,0,68,59
1656974020009,COGS 101B,A01,091572,Allen; Michael Gordon,8,0,65,57
1656974026037,COGS 101C,A01,083625,Delgado; Tania,17,0,35,18
1656974032062,COGS 107A,A01,083627,Boyle; Mary E. T.,13,0,60,47
1656974038086,COGS 118A,A01,083075,Gupta; Anjum,15,0,76,61
1656974044109,CSE 3,A50,083646,Miranda; Gregory Joseph,22,0,50,28
1656974050132,CSE 8A,A50,083650,Miranda; Gregory Joseph,17,1,56,39
1656974056170,CSE 11,A01,083080,Cao; Yingjun,4,15,40,36
1656974062202,CSE 12,A01,083652,Krause-Levy; Sophia Louisa,20,1,120,100
1656974068233,CSE 15L,A01,083654,Morris; Justin Loren,8,0,50,42
1656974068233,CSE 15L,A02,083655,Morris; Justin Loren,8,0,50,42
1656974074256,CSE 20,A01,083657,Tran; Khoa Dang,37,0,80,43
1656974080281,CSE 21,A01,095574,Bach; Quang Tran,21,0,48,27
1656974086308,CSE 30,A01,083084,Eldon; John,4,0,80,76
1656974086308,CSE 30,B01,095061,Bhaskar; Nishant,6,0,50,44
1656974092332,CSE 100,A01,083659,Cao; Yingjun,3,4,70,67
1656974098357,CSE 134B,A01,083661,Powell; Thomas Allan,19,0,100,81
1656974104382,CSE 140,A01,083663,Gungor; Onat,14,0,85,71
1656974110410,CSE 140L,A01,083088,Eldon; John,16,0,100,84
1656974116436,CSE 175,A01,083665,Kumar; Rakesh,3,0,25,22
1656974122457,CSE 190,A00,092507,Dubnov; Shlomo,7,0,20,13
1656974128479,ECE 45,A01,083139,Congero; Spencer William,5,0,75,70
1656974134504,ECE 65,A50,083695,Saad; Andrew S,12,0,30,18
1656974134504,ECE 65,A51,095125,Saad; Andrew S,25,0,26,1
1656974140528,ECE 109,A01,091882,Touri; Behrouz,16,0,70,54
1656974146553,ECE 180,A00,083140,Abi Samra; Nicholas Camill,1,0,30,29
1656974146553,ECE 180,B00,083141,Abi Samra; Nicholas Camill,0,0,30,30
1656974152577,MATH 10A,A01,083735,Patchell; Gregory David,1,0,30,29
1656974152577,MATH 10A,A02,083736,Patchell; Gregory David,20,0,30,10
1656974152577,MATH 10A,A03,083737,Patchell; Gregory David,15,0,30,15
1656974158600,MATH 10B,A01,083207,Lim; Seonhee,7,0,34,27
1656974158600,MATH 10B,A02,083208,Lim; Seonhee,9,0,35,26
1656974158600,MATH 10B,A03,093472,Lim; Seonhee,4,0,34,30
1656974158600,MATH 10B,B01,083739,Sinha; Shubham,9,0,30,21
1656974164631,MATH 18,A01,083743,Cinel; Cameron Alexander,6,0,30,24
1656974164631,MATH 18,A02,083744,Cinel; Cameron Alexander,15,0,30,15
1656974164631,MATH 18,A03,083745,Cinel; Cameron Alexander,8,0,30,22
1656974164631,MATH 18,B01,083748,Rideout; David Porter,4,0,37,33
1656974164631,MATH 18,B02,083749,Rideout; David Porter,3,0,36,33
1656974164631,MATH 18,B03,083750,Rideout; David Porter,2,0,37,35
1656974164631,MATH 18,B04,083751,Rideout; David Porter,5,0,36,31
1656974164631,MATH 18,B05,093473,Rideout; David Porter,4,0,36,32
1656974164631,MATH 18,B06,093474,Rideout; David Porter,5,0,36,31
1656974170658,MATH 20A,A01,083754,Zheng; Zequn,12,0,40,28
1656974176684,MATH 20B,A01,083756,Briones; Jor-el Thomas Caparas,1,0,36,35
1656974176684,MATH 20B,A02,083757,Briones; Jor-el Thomas Caparas,1,0,36,35
1656974176684,MATH 20B,A03,093475,Briones; Jor-el Thomas Caparas,0,0,36,36
1656974182707,MATH 20C,A01,083760,Briones; Jor-el Thomas Caparas,1,0,35,34
1656974182707,MATH 20C,A02,083761,Briones; Jor-el Thomas Caparas,8,0,35,27
1656974182707,MATH 20C,A03,093476,Briones; Jor-el Thomas Caparas,0,1,36,36
1656974182707,MATH 20C,B01,083762,Bach; Quang Tran,0,0,30,30
1656974188733,MATH 20D,A01,083765,Tran; Brian Kha,4,0,30,26
1656974188733,MATH 20D,A02,083766,Tran; Brian Kha,4,0,30,26
1656974188733,MATH 20D,A03,083767,Tran; Brian Kha,3,0,30,27
1656974194755,MATH 20E,A01,083771,Ganguly; Soumya,5,0,32,27
1656974194755,MATH 20E,A02,083772,Ganguly; Soumya,6,0,32,26
1656974194755,MATH 20E,B01,083773,Ciotti; Benjamin,18,0,35,17
1656974194755,MATH 20E,B02,083774,Ciotti; Benjamin,17,0,35,18
1656974200784,MATH 103A,A01,083777,Greenfeld; Be'Eri,2,0,36,34
1656974200784,MATH 103A,A02,083778,Greenfeld; Be'Eri,5,0,36,31
1656974200784,MATH 103A,A03,093561,Greenfeld; Be'Eri,4,0,36,32
1656974200784,MATH 103A,B01,083779,Greenfeld; Be'Eri,6,0,36,30
1656974200784,MATH 103A,B02,083780,Greenfeld; Be'Eri,2,0,36,34
1656974200784,MATH 103A,B03,093562,Greenfeld; Be'Eri,2,0,36,34
1656974206810,MATH 105,A01,085443,Carter; Anne Toulson,14,0,35,21
1656974206810,MATH 105,A02,093477,Carter; Anne Toulson,20,0,35,15
1656974212838,MATH 109,A01,083213,Ganzberger; Geoffrey Michael,2,0,34,32
1656974212838,MATH 109,A02,083214,Ganzberger; Geoffrey Michael,2,0,34,32
1656974212838,MATH 109,A03,093478,Ganzberger; Geoffrey Michael,1,0,34,33
1656974212838,MATH 109,B01,083215,Ganzberger; Geoffrey Michael,1,0,32,31
1656974212838,MATH 109,B02,083216,Ganzberger; Geoffrey Michael,1,0,32,31
1656974212838,MATH 109,B03,093479,Ganzberger; Geoffrey Michael,6,0,32,26
1656974218864,MATH 142A,A01,083219,Chow; Bennett,6,0,32,26
1656974218864,MATH 142A,A02,083220,Chow; Bennett,10,0,32,22
1656974218864,MATH 142A,A03,093480,Chow; Bennett,7,0,32,25
1656974218864,MATH 142A,B03,093481,Chow; Bennett,7,0,32,25
1656974218864,MATH 142A,B04,093558,Chow; Bennett,11,0,32,21
1656974218864,MATH 142A,B05,093559,Chow; Bennett,6,0,32,26
1656974224886,MATH 193A,A01,083224,Rotar; Vladimir,7,0,34,27
1656974224886,MATH 193A,A02,083225,Rotar; Vladimir,4,0,34,30
1656974224886,MATH 193A,A03,083781,Rotar; Vladimir,1,0,34,33
1656974224886,MATH 193A,A04,083782,Rotar; Vladimir,6,0,34,28
1656974224886,MATH 193A,A05,093482,Rotar; Vladimir,6,0,34,28
1656974230909,MATH 197,001,091859,McAuley; Julian John,9999,0,9999,0
1656974230909,MATH 197,002,095566,Kedlaya; Kiran S.,9997,0,9999,2
1656974230909,MATH 197,003,095567,Xiao; Ming,9999,0,9999,0
1656974230909,MATH 197,004,095571,Perols; Johan Lars,9998,0,9999,1
1656974237962,COGS 9,A01,083615,Shannon; Kyle Michael,7,0,75,68
1656974243989,COGS 11,A01,083617,Boyle; Mary E. T.,20,0,48,28
1656974250017,COGS 13,A01,083071,Bastos; Amalia Pinkusfeld,9,0,71,62
1656974256040,COGS 14A,A01,092681,Semenuks; Arturs,0,1,100,100
1656974262063,COGS 14B,A01,083073,Cheng; Tzu-Han,5,0,63,58
1656974268090,COGS 17,A01,092677,Semenuks; Arturs,4,0,81,77
1656974274119,COGS 100,A01,083619,Allen; Michael Gordon,15,0,70,55
1656974280148,COGS 101A,A01,083621,Davis; Joshua Daniel,9,0,68,59
1656974286170,COGS 101B,A01,091572,Allen; Michael Gordon,8,0,65,57
1656974292192,COGS 101C,A01,083625,Delgado; Tania,17,0,35,18
1656974298221,COGS 107A,A01,083627,Boyle; Mary E. T.,13,0,60,47
1656974304243,COGS 118A,A01,083075,Gupta; Anjum,15,0,76,61
1656974310268,CSE 3,A50,083646,Miranda; Gregory Joseph,22,0,50,28
1656974316289,CSE 8A,A50,083650,Miranda; Gregory Joseph,17,1,56,39
1656974322316,CSE 11,A01,083080,Cao; Yingjun,4,15,40,36
1656974328351,CSE 12,A01,083652,Krause-Levy; Sophia Louisa,20,1,120,100
1656974334374,CSE 15L,A01,083654,Morris; Justin Loren,8,0,50,42
1656974334374,CSE 15L,A02,083655,Morris; Justin Loren,8,0,50,42
1656974340399,CSE 20,A01,083657,Tran; Khoa Dang,37,0,80,43
1656974346427,CSE 21,A01,095574,Bach; Quang Tran,21,0,48,27
1656974352455,CSE 30,A01,083084,Eldon; John,4,0,80,76
1656974352455,CSE 30,B01,095061,Bhaskar; Nishant,6,0,50,44
1656974358487,CSE 100,A01,083659,Cao; Yingjun,3,4,70,67
1656974364515,CSE 134B,A01,083661,Powell; Thomas Allan,19,0,100,81
1656974370541,CSE 140,A01,083663,Gungor; Onat,14,0,85,71
1656974376565,CSE 140L,A01,083088,Eldon; John,16,0,100,84
1656974382685,CSE 175,A01,083665,Kumar; Rakesh,3,0,25,22
1656974388711,CSE 190,A00,092507,Dubnov; Shlomo,7,0,20,13
1656974394741,ECE 45,A01,083139,Congero; Spencer William,5,0,75,70
1656974400767,ECE 65,A50,083695,Saad; Andrew S,12,0,30,18
1656974400767,ECE 65,A51,095125,Saad; Andrew S,25,0,26,1
1656974406801,ECE 109,A01,091882,Touri; Behrouz,16,0,70,54
1656974412829,ECE 180,A00,083140,Abi Samra; Nicholas Camill,1,0,30,29
1656974412829,ECE 180,B00,083141,Abi Samra; Nicholas Camill,0,0,30,30
1656974418859,MATH 10A,A01,083735,Patchell; Gregory David,1,0,30,29
1656974418859,MATH 10A,A02,083736,Patchell; Gregory David,20,0,30,10
1656974418859,MATH 10A,A03,083737,Patchell; Gregory David,15,0,30,15
1656974424884,MATH 10B,A01,083207,Lim; Seonhee,7,0,34,27
1656974424884,MATH 10B,A02,083208,Lim; Seonhee,9,0,35,26
1656974424884,MATH 10B,A03,093472,Lim; Seonhee,4,0,34,30
1656974424884,MATH 10B,B01,083739,Sinha; Shubham,9,0,30,21
1656974430908,MATH 18,A01,083743,Cinel; Cameron Alexander,6,0,30,24
1656974430908,MATH 18,A02,083744,Cinel; Cameron Alexander,15,0,30,15
1656974430908,MATH 18,A03,083745,Cinel; Cameron Alexander,8,0,30,22
1656974430908,MATH 18,B01,083748,Rideout; David Porter,4,0,37,33
1656974430908,MATH 18,B02,083749,Rideout; David Porter,3,0,36,33
1656974430908,MATH 18,B03,083750,Rideout; David Porter,2,0,37,35
1656974430908,MATH 18,B04,083751,Rideout; David Porter,5,0,36,31
1656974430908,MATH 18,B05,093473,Rideout; David Porter,4,0,36,32
1656974430908,MATH 18,B06,093474,Rideout; David Porter,5,0,36,31
1656974436935,MATH 20A,A01,083754,Zheng; Zequn,12,0,40,28
1656974442962,MATH 20B,A01,083756,Briones; Jor-el Thomas Caparas,1,0,36,35
1656974442962,MATH 20B,A02,083757,Briones; Jor-el Thomas Caparas,1,0,36,35
1656974442962,MATH 20B,A03,093475,Briones; Jor-el Thomas Caparas,0,0,36,36
1656974448985,MATH 20C,A01,083760,Briones; Jor-el Thomas Caparas,1,0,35,34
1656974448985,MATH 20C,A02,083761,Briones; Jor-el Thomas Caparas,8,0,35,27
1656974448985,MATH 20C,A03,093476,Briones; Jor-el Thomas Caparas,0,1,36,36
1656974448985,MATH 20C,B01,083762,Bach; Quang Tran,0,0,30,30
1656974455007,MATH 20D,A01,083765,Tran; Brian Kha,4,0,30,26
1656974455007,MATH 20D,A02,083766,Tran; Brian Kha,4,0,30,26
1656974455007,MATH 20D,A03,083767,Tran; Brian Kha,3,0,30,27
1656974461034,MATH 20E,A01,083771,Ganguly; Soumya,5,0,32,27
1656974461034,MATH 20E,A02,083772,Ganguly; Soumya,6,0,32,26
1656974461034,MATH 20E,B01,083773,Ciotti; Benjamin,18,0,35,17
1656974461034,MATH 20E,B02,083774,Ciotti; Benjamin,17,0,35,18
1656974467059,MATH 103A,A01,083777,Greenfeld; Be'Eri,2,0,36,34
1656974467059,MATH 103A,A02,083778,Greenfeld; Be'Eri,5,0,36,31
1656974467059,MATH 103A,A03,093561,Greenfeld; Be'Eri,4,0,36,32
1656974467059,MATH 103A,B01,083779,Greenfeld; Be'Eri,6,0,36,30
1656974467059,MATH 103A,B02,083780,Greenfeld; Be'Eri,2,0,36,34
1656974467059,MATH 103A,B03,093562,Greenfeld; Be'Eri,2,0,36,34
1656974473086,MATH 105,A01,085443,Carter; Anne Toulson,14,0,35,21
1656974473086,MATH 105,A02,093477,Carter; Anne Toulson,20,0,35,15
1656974479111,MATH 109,A01,083213,Ganzberger; Geoffrey Michael,2,0,34,32
1656974479111,MATH 109,A02,083214,Ganzberger; Geoffrey Michael,2,0,34,32
1656974479111,MATH 109,A03,093478,Ganzberger; Geoffrey Michael,1,0,34,33
1656974479111,MATH 109,B01,083215,Ganzberger; Geoffrey Michael,1,0,32,31
1656974479111,MATH 109,B02,083216,Ganzberger; Geoffrey Michael,1,0,32,31
1656974479111,MATH 109,B03,093479,Ganzberger; Geoffrey Michael,6,0,32,26
1656974485134,MATH 142A,A01,083219,Chow; Bennett,6,0,32,26
1656974485134,MATH 142A,A02,083220,Chow; Bennett,10,0,32,22
1656974485134,MATH 142A,A03,093480,Chow; Bennett,7,0,32,25
1656974485134,MATH 142A,B03,093481,Chow; Bennett,7,0,32,25
1656974485134,MATH 142A,B04,093558,Chow; Bennett,11,0,32,21
1656974485134,MATH 142A,B05,093559,Chow; Bennett,6,0,32,26
1656974491158,MATH 193A,A01,083224,Rotar; Vladimir,7,0,34,27
1656974491158,MATH 193A,A02,083225,Rotar; Vladimir,4,0,34,30
1656974491158,MATH 193A,A03,083781,Rotar; Vladimir,1,0,34,33
1656974491158,MATH 193A,A04,083782,Rotar; Vladimir,6,0,34,28
1656974491158,MATH 193A,A05,093482,Rotar; Vladimir,6,0,34,28
1656974497184,MATH 197,001,091859,McAuley; Julian John,9999,0,9999,0
1656974497184,MATH 197,002,095566,Kedlaya; Kiran S.,9997,0,9999,2
1656974497184,MATH 197,003,095567,Xiao; Ming,9999,0,9999,0
1656974497184,MATH 197,004,095571,Perols; Johan Lars,9998,0,9999,1
1656974504234,COGS 9,A01,083615,Shannon; Kyle Michael,7,0,75,68
1656974510261,COGS 11,A01,083617,Boyle; Mary E. T.,20,0,48,28
1656974516295,COGS 13,A01,083071,Bastos; Amalia Pinkusfeld,9,0,71,62
1656974522318,COGS 14A,A01,092681,Semenuks; Arturs,0,1,100,100
1656974528341,COGS 14B,A01,083073,Cheng; Tzu-Han,5,0,63,58
1656974534366,COGS 17,A01,092677,Semenuks; Arturs,4,0,81,77
1656974540389,COGS 100,A01,083619,Allen; Michael Gordon,15,0,70,55
1656974546416,COGS 101A,A01,083621,Davis; Joshua Daniel,9,0,68,59
1656974552440,COGS 101B,A01,091572,Allen; Michael Gordon,8,0,65,57
1656974558464,COGS 101C,A01,083625,Delgado; Tania,17,0,35,18
1656974564488,COGS 107A,A01,083627,Boyle; Mary E. T.,13,0,60,47
1656974570509,COGS 118A,A01,083075,Gupta; Anjum,15,0,76,61
1656974576533,CSE 3,A50,083646,Miranda; Gregory Joseph,22,0,50,28
1656974582559,CSE 8A,A50,083650,Miranda; Gregory Joseph,17,1,56,39
1656974588586,CSE 11,A01,083080,Cao; Yingjun,4,15,40,36
1656974594610,CSE 12,A01,083652,Krause-Levy; Sophia Louisa,20,1,120,100
1656974600633,CSE 15L,A01,083654,Morris; Justin Loren,8,0,50,42
1656974600633,CSE 15L,A02,083655,Morris; Justin Loren,8,0,50,42
1656974606655,CSE 20,A01,083657,Tran; Khoa Dang,37,0,80,43
1656974612682,CSE 21,A01,095574,Bach; Quang Tran,21,0,48,27
1656974618710,CSE 30,A01,083084,Eldon; John,4,0,80,76
1656974618710,CSE 30,B01,095061,Bhaskar; Nishant,6,0,50,44
1656974624736,CSE 100,A01,083659,Cao; Yingjun,3,4,70,67
1656974630762,CSE 134B,A01,083661,Powell; Thomas Allan,19,0,100,81
1656974636783,CSE 140,A01,083663,Gungor; Onat,14,0,85,71
1656974642805,CSE 140L,A01,083088,Eldon; John,16,0,100,84
1656974648832,CSE 175,A01,083665,Kumar; Rakesh,3,0,25,22
1656974654859,CSE 190,A00,092507,Dubnov; Shlomo,7,0,20,13
1656974660883,ECE 45,A01,083139,Congero; Spencer William,5,0,75,70
1656974666910,ECE 65,A50,083695,Saad; Andrew S,12,0,30,18
1656974666910,ECE 65,A51,095125,Saad; Andrew S,25,0,26,1
1656974672936,ECE 109,A01,091882,Touri; Behrouz,16,0,70,54
1656974678961,ECE 180,A00,083140,Abi Samra; Nicholas Camill,1,0,30,29
1656974678961,ECE 180,B00,083141,Abi Samra; Nicholas Camill,0,0,30,30
1656974684993,MATH 10A,A01,083735,Patchell; Gregory David,1,0,30,29
1656974684993,MATH 10A,A02,083736,Patchell; Gregory David,20,0,30,10
1656974684993,MATH 10A,A03,083737,Patchell; Gregory David,15,0,30,15
1656974691022,MATH 10B,A01,083207,Lim; Seonhee,7,0,34,27
1656974691022,MATH 10B,A02,083208,Lim; Seonhee,9,0,35,26
1656974691022,MATH 10B,A03,093472,Lim; Seonhee,4,0,34,30
1656974691022,MATH 10B,B01,083739,Sinha; Shubham,9,0,30,21
1656974697062,MATH 18,A01,083743,Cinel; Cameron Alexander,6,0,30,24
1656974697062,MATH 18,A02,083744,Cinel; Cameron Alexander,15,0,30,15
1656974697062,MATH 18,A03,083745,Cinel; Cameron Alexander,8,0,30,22
1656974697062,MATH 18,B01,083748,Rideout; David Porter,4,0,37,33
1656974697062,MATH 18,B02,083749,Rideout; David Porter,3,0,36,33
1656974697062,MATH 18,B03,083750,Rideout; David Porter,2,0,37,35
1656974697062,MATH 18,B04,083751,Rideout; David Porter,5,0,36,31
1656974697062,MATH 18,B05,093473,Rideout; David Porter,4,0,36,32
1656974697062,MATH 18,B06,093474,Rideout; David Porter,5,0,36,31
1656974703086,MATH 20A,A01,083754,Zheng; Zequn,12,0,40,28
1656974709109,MATH 20B,A01,083756,Briones; Jor-el Thomas Caparas,1,0,36,35
1656974709109,MATH 20B,A02,083757,Briones; Jor-el Thomas Caparas,1,0,36,35
1656974709109,MATH 20B,A03,093475,Briones; Jor-el Thomas Caparas,0,0,36,36
1656974715137,MATH 20C,A01,083760,Briones; Jor-el Thomas Caparas,1,0,35,34
1656974715137,MATH 20C,A02,083761,Briones; Jor-el Thomas Caparas,8,0,35,27
1656974715137,MATH 20C,A03,093476,Briones; Jor-el Thomas Caparas,0,1,36,36
1656974715137,MATH 20C,B01,083762,Bach; Quang Tran,0,0,30,30
1656974721160,MATH 20D,A01,083765,Tran; Brian Kha,4,0,30,26
1656974721160,MATH 20D,A02,083766,Tran; Brian Kha,4,0,30,26
1656974721160,MATH 20D,A03,083767,Tran; Brian Kha,3,0,30,27
1656974727185,MATH 20E,A01,083771,Ganguly; Soumya,5,0,32,27
1656974727185,MATH 20E,A02,083772,Ganguly; Soumya,6,0,32,26
1656974727185,MATH 20E,B01,083773,Ciotti; Benjamin,18,0,35,17
1656974727185,MATH 20E,B02,083774,Ciotti; Benjamin,17,0,35,18
1656974733214,MATH 103A,A01,083777,Greenfeld; Be'Eri,2,0,36,34
1656974733214,MATH 103A,A02,083778,Greenfeld; Be'Eri,5,0,36,31
1656974733214,MATH 103A,A03,093561,Greenfeld; Be'Eri,4,0,36,32
1656974733214,MATH 103A,B01,083779,Greenfeld; Be'Eri,6,0,36,30
1656974733214,MATH 103A,B02,083780,Greenfeld; Be'Eri,2,0,36,34
1656974733214,MATH 103A,B03,093562,Greenfeld; Be'Eri,2,0,36,34
1656974739237,MATH 105,A01,085443,Carter; Anne Toulson,14,0,35,21
1656974739237,MATH 105,A02,093477,Carter; Anne Toulson,20,0,35,15
1656974745266,MATH 109,A01,083213,Ganzberger; Geoffrey Michael,2,0,34,32
1656974745266,MATH 109,A02,083214,Ganzberger; Geoffrey Michael,2,0,34,32
1656974745266,MATH 109,A03,093478,Ganzberger; Geoffrey Michael,1,0,34,33
1656974745266,MATH 109,B01,083215,Ganzberger; Geoffrey Michael,1,0,32,31
1656974745266,MATH 109,B02,083216,Ganzberger; Geoffrey Michael,1,0,32,31
1656974745266,MATH 109,B03,093479,Ganzberger; Geoffrey Michael,6,0,32,26
1656974751291,MATH 142A,A01,083219,Chow; Bennett,6,0,32,26
1656974751291,MATH 142A,A02,083220,Chow; Bennett,10,0,32,22
1656974751291,MATH 142A,A03,093480,Chow; Bennett,7,0,32,25
1656974751291,MATH 142A,B03,093481,Chow; Bennett,7,0,32,25
1656974751291,MATH 142A,B04,093558,Chow; Bennett,11,0,32,21
1656974751291,MATH 142A,B05,093559,Chow; Bennett,6,0,32,26
1656974757314,MATH 193A,A01,083224,Rotar; Vladimir,7,0,34,27
1656974757314,MATH 193A,A02,083225,Rotar; Vladimir,4,0,34,30
1656974757314,MATH 193A,A03,083781,Rotar; Vladimir,1,0,34,33
1656974757314,MATH 193A,A04,083782,Rotar; Vladimir,6,0,34,28
1656974757314,MATH 193A,A05,093482,Rotar; Vladimir,6,0,34,28
1656974763338,MATH 197,001,091859,McAuley; Julian John,9999,0,9999,0
1656974763338,MATH 197,002,095566,Kedlaya; Kiran S.,9997,0,9999,2
1656974763338,MATH 197,003,095567,Xiao; Ming,9999,0,9999,0
1656974763338,MATH 197,004,095571,Perols; Johan Lars,9998,0,9999,1
1656974770407,COGS 9,A01,083615,Shannon; Kyle Michael,7,0,75,68
1656974776436,COGS 11,A01,083617,Boyle; Mary E. T.,20,0,48,28
1656974782460,COGS 13,A01,083071,Bastos; Amalia Pinkusfeld,9,0,71,62
1656974788486,COGS 14A,A01,092681,Semenuks; Arturs,0,1,100,100
1656974794511,COGS 14B,A01,083073,Cheng; Tzu-Han,5,0,63,58
1656974800538,COGS 17,A01,092677,Semenuks; Arturs,4,0,81,77
1656974806565,COGS 100,A01,083619,Allen; Michael Gordon,15,0,70,55
1656974812587,COGS 101A,A01,083621,Davis; Joshua Daniel,9,0,68,59
1656974818611,COGS 101B,A01,091572,Allen; Michael Gordon,8,0,65,57
1656974824637,COGS 101C,A01,083625,Delgado; Tania,17,0,35,18
1656974830661,COGS 107A,A01,083627,Boyle; Mary E. T.,13,0,60,47
1656974836688,COGS 118A,A01,083075,Gupta; Anjum,15,0,76,61
1656974842712,CSE 3,A50,083646,Miranda; Gregory Joseph,22,0,50,28
1656974848736,CSE 8A,A50,083650,Miranda; Gregory Joseph,17,1,56,39
1656974854760,CSE 11,A01,083080,Cao; Yingjun,4,15,40,36
1656974860784,CSE 12,A01,083652,Krause-Levy; Sophia Louisa,20,1,120,100
1656974866812,CSE 15L,A01,083654,Morris; Justin Loren,8,0,50,42
1656974866812,CSE 15L,A02,083655,Morris; Justin Loren,8,0,50,42
1656974872836,CSE 20,A01,083657,Tran; Khoa Dang,37,0,80,43
1656974878860,CSE 21,A01,095574,Bach; Quang Tran,21,0,48,27
1656974884884,CSE 30,A01,083084,Eldon; John,4,0,80,76
1656974884884,CSE 30,B01,095061,Bhaskar; Nishant,6,0,50,44
1656974890908,CSE 100,A01,083659,Cao; Yingjun,3,4,70,67
1656974896932,CSE 134B,A01,083661,Powell; Thomas Allan,19,0,100,81
1656974902962,CSE 140,A01,083663,Gungor; Onat,14,0,85,71
1656974908995,CSE 140L,A01,083088,Eldon; John,16,0,100,84
1656974915020,CSE 175,A01,083665,Kumar; Rakesh,3,0,25,22
1656974921046,CSE 190,A00,092507,Dubnov; Shlomo,7,0,20,13
1656974927075,ECE 45,A01,083139,Congero; Spencer William,5,0,75,70
1656974933099,ECE 65,A50,083695,Saad; Andrew S,12,0,30,18
1656974933099,ECE 65,A51,095125,Saad; Andrew S,25,0,26,1
1656974939140,ECE 109,A01,091882,Touri; Behrouz,16,0,70,54
1656974945164,ECE 180,A00,083140,Abi Samra; Nicholas Camill,1,0,30,29
1656974945164,ECE 180,B00,083141,Abi Samra; Nicholas Camill,0,0,30,30
1656974951196,MATH 10A,A01,083735,Patchell; Gregory David,1,0,30,29
1656974951196,MATH 10A,A02,083736,Patchell; Gregory David,20,0,30,10
1656974951196,MATH 10A,A03,083737,Patchell; Gregory David,15,0,30,15
1656974957220,MATH 10B,A01,083207,Lim; Seonhee,7,0,34,27
1656974957220,MATH 10B,A02,083208,Lim; Seonhee,9,0,35,26
1656974957220,MATH 10B,A03,093472,Lim; Seonhee,4,0,34,30
1656974957220,MATH 10B,B01,083739,Sinha; Shubham,9,0,30,21
1656974963247,MATH 18,A01,083743,Cinel; Cameron Alexander,6,0,30,24
1656974963247,MATH 18,A02,083744,Cinel; Cameron Alexander,15,0,30,15
1656974963247,MATH 18,A03,083745,Cinel; Cameron Alexander,8,0,30,22
1656974963247,MATH 18,B01,083748,Rideout; David Porter,4,0,37,33
1656974963247,MATH 18,B02,083749,Rideout; David Porter,3,0,36,33
1656974963247,MATH 18,B03,083750,Rideout; David Porter,2,0,37,35
1656974963247,MATH 18,B04,083751,Rideout; David Porter,5,0,36,31
1656974963247,MATH 18,B05,093473,Rideout; David Porter,4,0,36,32
1656974963247,MATH 18,B06,093474,Rideout; David Porter,5,0,36,31
1656974969273,MATH 20A,A01,083754,Zheng; Zequn,12,0,40,28
1656974975297,MATH 20B,A01,083756,Briones; Jor-el Thomas Caparas,1,0,36,35
1656974975297,MATH 20B,A02,083757,Briones; Jor-el Thomas Caparas,1,0,36,35
1656974975297,MATH 20B,A03,093475,Briones; Jor-el Thomas Caparas,0,0,36,36
1656974981394,MATH 20C,A01,083760,Briones; Jor-el Thomas Caparas,1,0,35,34
1656974981394,MATH 20C,A02,083761,Briones; Jor-el Thomas Caparas,8,0,35,27
1656974981394,MATH 20C,A03,093476,Briones; Jor-el Thomas Caparas,0,1,36,36
1656974981394,MATH 20C,B01,083762,Bach; Quang Tran,0,0,30,30
1656974987417,MATH 20D,A01,083765,Tran; Brian Kha,4,0,30,26
1656974987417,MATH 20D,A02,083766,Tran; Brian Kha,4,0,30,26
1656974987417,MATH 20D,A03,083767,Tran; Brian Kha,3,0,30,27
1656974993443,MATH 20E,A01,083771,Ganguly; Soumya,5,0,32,27
1656974993443,MATH 20E,A02,083772,Ganguly; Soumya,6,0,32,26
1656974993443,MATH 20E,B01,083773,Ciotti; Benjamin,18,0,35,17
1656974993443,MATH 20E,B02,083774,Ciotti; Benjamin,17,0,35,18
1656974999467,MATH 103A,A01,083777,Greenfeld; Be'Eri,2,0,36,34
1656974999467,MATH 103A,A02,083778,Greenfeld; Be'Eri,5,0,36,31
1656974999467,MATH 103A,A03,093561,Greenfeld; Be'Eri,4,0,36,32
1656974999467,MATH 103A,B01,083779,Greenfeld; Be'Eri,6,0,36,30
1656974999467,MATH 103A,B02,083780,Greenfeld; Be'Eri,2,0,36,34
1656974999467,MATH 103A,B03,093562,Greenfeld; Be'Eri,2,0,36,34
1656975005499,MATH 105,A01,085443,Carter; Anne Toulson,14,0,35,21
1656975005499,MATH 105,A02,093477,Carter; Anne Toulson,20,0,35,15
1656975011524,MATH 109,A01,083213,Ganzberger; Geoffrey Michael,2,0,34,32
1656975011524,MATH 109,A02,083214,Ganzberger; Geoffrey Michael,2,0,34,32
1656975011524,MATH 109,A03,093478,Ganzberger; Geoffrey Michael,1,0,34,33
1656975011524,MATH 109,B01,083215,Ganzberger; Geoffrey Michael,1,0,32,31
1656975011524,MATH 109,B02,083216,Ganzberger; Geoffrey Michael,1,0,32,31
1656975011524,MATH 109,B03,093479,Ganzberger; Geoffrey Michael,6,0,32,26
1656975017556,MATH 142A,A01,083219,Chow; Bennett,6,0,32,26
1656975017556,MATH 142A,A02,083220,Chow; Bennett,10,0,32,22
1656975017556,MATH 142A,A03,093480,Chow; Bennett,7,0,32,25
1656975017556,MATH 142A,B03,093481,Chow; Bennett,7,0,32,25
1656975017556,MATH 142A,B04,093558,Chow; Bennett,11,0,32,21
1656975017556,MATH 142A,B05,093559,Chow; Bennett,6,0,32,26
1656975023585,MATH 193A,A01,083224,Rotar; Vladimir,7,0,34,27
1656975023585,MATH 193A,A02,083225,Rotar; Vladimir,4,0,34,30
1656975023585,MATH 193A,A03,083781,Rotar; Vladimir,1,0,34,33
1656975023585,MATH 193A,A04,083782,Rotar; Vladimir,6,0,34,28
1656975023585,MATH 193A,A05,093482,Rotar; Vladimir,6,0,34,28
1656975029612,MATH 197,001,091859,McAuley; Julian John,9999,0,9999,0
1656975029612,MATH 197,002,095566,Kedlaya; Kiran S.,9997,0,9999,2
1656975029612,MATH 197,003,095567,Xiao; Ming,9999,0,9999,0
1656975029612,MATH 197,004,095571,Perols; Johan Lars,9998,0,9999,1
1656975036663,COGS 9,A01,083615,Shannon; Kyle Michael,7,0,75,68
1656975042687,COGS 11,A01,083617,Boyle; Mary E. T.,20,0,48,28
1656975048710,COGS 13,A01,083071,Bastos; Amalia Pinkusfeld,9,0,71,62
1656975054734,COGS 14A,A01,092681,Semenuks; Arturs,0,1,100,100
1656975060761,COGS 14B,A01,083073,Cheng; Tzu-Han,5,0,63,58
1656975066782,COGS 17,A01,092677,Semenuks; Arturs,4,0,81,77
1656975072806,COGS 100,A01,083619,Allen; Michael Gordon,15,0,70,55
1656975078840,COGS 101A,A01,083621,Davis; Joshua Daniel,9,0,68,59
1656975084864,COGS 101B,A01,091572,Allen; Michael Gordon,8,0,65,57
1656975090891,COGS 101C,A01,083625,Delgado; Tania,17,0,35,18
1656975096920,COGS 107A,A01,083627,Boyle; Mary E. T.,13,0,60,47
1656975102945,COGS 118A,A01,083075,Gupta; Anjum,15,0,76,61
1656975108973,CSE 3,A50,083646,Miranda; Gregory Joseph,22,0,50,28
1656975115001,CSE 8A,A50,083650,Miranda; Gregory Joseph,17,1,56,39
1656975121031,CSE 11,A01,083080,Cao; Yingjun,4,15,40,36
1656975127056,CSE 12,A01,083652,Krause-Levy; Sophia Louisa,20,1,120,100
1656975133079,CSE 15L,A01,083654,Morris; Justin Loren,8,0,50,42
1656975133079,CSE 15L,A02,083655,Morris; Justin Loren,8,0,50,42
1656975139102,CSE 20,A01,083657,Tran; Khoa Dang,37,0,80,43
1656975145124,CSE 21,A01,095574,Bach; Quang Tran,21,0,48,27
1656975151147,CSE 30,A01,083084,Eldon; John,4,0,80,76
1656975151147,CSE 30,B01,095061,Bhaskar; Nishant,6,0,50,44
1656975157182,CSE 100,A01,083659,Cao; Yingjun,3,4,70,67
1656975163208,CSE 134B,A01,083661,Powell; Thomas Allan,19,0,100,81
1656975169230,CSE 140,A01,083663,Gungor; Onat,14,0,85,71
1656975175257,CSE 140L,A01,083088,Eldon; John,16,0,100,84
1656975181281,CSE 175,A01,083665,Kumar; Rakesh,3,0,25,22
1656975187308,CSE 190,A00,092507,Dubnov; Shlomo,7,0,20,13
1656975193336,ECE 45,A01,083139,Congero; Spencer William,5,0,75,70
1656975199362,ECE 65,A50,083695,Saad; Andrew S,12,0,30,18
1656975199362,ECE 65,A51,095125,Saad; Andrew S,25,0,26,1
1656975205387,ECE 109,A01,091882,Touri; Behrouz,16,0,70,54
1656975211411,ECE 180,A00,083140,Abi Samra; Nicholas Camill,1,0,30,29
1656975211411,ECE 180,B00,083141,Abi Samra; Nicholas Camill,0,0,30,30
1656975217440,MATH 10A,A01,083735,Patchell; Gregory David,1,0,30,29
1656975217440,MATH 10A,A02,083736,Patchell; Gregory David,20,0,30,10
1656975217440,MATH 10A,A03,083737,Patchell; Gregory David,15,0,30,15
1656975223470,MATH 10B,A01,083207,Lim; Seonhee,7,0,34,27
1656975223470,MATH 10B,A02,083208,Lim; Seonhee,9,0,35,26
1656975223470,MATH 10B,A03,093472,Lim; Seonhee,4,0,34,30
1656975223470,MATH 10B,B01,083739,Sinha; Shubham,9,0,30,21
1656975229495,MATH 18,A01,083743,Cinel; Cameron Alexander,6,0,30,24
1656975229495,MATH 18,A02,083744,Cinel; Cameron Alexander,15,0,30,15
1656975229495,MATH 18,A03,083745,Cinel; Cameron Alexander,8,0,30,22
1656975229495,MATH 18,B01,083748,Rideout; David Porter,4,0,37,33
1656975229495,MATH 18,B02,083749,Rideout; David Porter,3,0,36,33
1656975229495,MATH 18,B03,083750,Rideout; David Porter,2,0,37,35
1656975229495,MATH 18,B04,083751,Rideout; David Porter,5,0,36,31
1656975229495,MATH 18,B05,093473,Rideout; David Porter,4,0,36,32
1656975229495,MATH 18,B06,093474,Rideout; David Porter,5,0,36,31
1656975235522,MATH 20A,A01,083754,Zheng; Zequn,12,0,40,28
1656975241544,MATH 20B,A01,083756,Briones; Jor-el Thomas Caparas,1,0,36,35
1656975241544,MATH 20B,A02,083757,Briones; Jor-el Thomas Caparas,1,0,36,35
1656975241544,MATH 20B,A03,093475,Briones; Jor-el Thomas Caparas,0,0,36,36
1656975247573,MATH 20C,A01,083760,Briones; Jor-el Thomas Caparas,1,0,35,34
1656975247573,MATH 20C,A02,083761,Briones; Jor-el Thomas Caparas,8,0,35,27
1656975247573,MATH 20C,A03,093476,Briones; Jor-el Thomas Caparas,0,1,36,36
1656975247573,MATH 20C,B01,083762,Bach; Quang Tran,0,0,30,30
1656975253597,MATH 20D,A01,083765,Tran; Brian Kha,4,0,30,26
1656975253597,MATH 20D,A02,083766,Tran; Brian Kha,4,0,30,26
1656975253597,MATH 20D,A03,083767,Tran; Brian Kha,3,0,30,27
1656975259620,MATH 20E,A01,083771,Ganguly; Soumya,5,0,32,27
1656975259620,MATH 20E,A02,083772,Ganguly; Soumya,6,0,32,26
1656975259620,MATH 20E,B01,083773,Ciotti; Benjamin,18,0,35,17
1656975259620,MATH 20E,B02,083774,Ciotti; Benjamin,17,0,35,18
1656975265645,MATH 103A,A01,083777,Greenfeld; Be'Eri,2,0,36,34
1656975265645,MATH 103A,A02,083778,Greenfeld; Be'Eri,5,0,36,31
1656975265645,MATH 103A,A03,093561,Greenfeld; Be'Eri,4,0,36,32
1656975265645,MATH 103A,B01,083779,Greenfeld; Be'Eri,6,0,36,30
1656975265645,MATH 103A,B02,083780,Greenfeld; Be'Eri,2,0,36,34
1656975265645,MATH 103A,B03,093562,Greenfeld; Be'Eri,2,0,36,34
1656975271667,MATH 105,A01,085443,Carter; Anne Toulson,14,0,35,21
1656975271667,MATH 105,A02,093477,Carter; Anne Toulson,20,0,35,15
1656975277690,MATH 109,A01,083213,Ganzberger; Geoffrey Michael,2,0,34,32
1656975277690,MATH 109,A02,083214,Ganzberger; Geoffrey Michael,2,0,34,32
1656975277690,MATH 109,A03,093478,Ganzberger; Geoffrey Michael,1,0,34,33
1656975277690,MATH 109,B01,083215,Ganzberger; Geoffrey Michael,1,0,32,31
1656975277690,MATH 109,B02,083216,Ganzberger; Geoffrey Michael,1,0,32,31
1656975277690,MATH 109,B03,093479,Ganzberger; Geoffrey Michael,6,0,32,26
1656975283720,MATH 142A,A01,083219,Chow; Bennett,6,0,32,26
1656975283720,MATH 142A,A02,083220,Chow; Bennett,10,0,32,22
1656975283720,MATH 142A,A03,093480,Chow; Bennett,7,0,32,25
1656975283720,MATH 142A,B03,093481,Chow; Bennett,7,0,32,25
1656975283720,MATH 142A,B04,093558,Chow; Bennett,11,0,32,21
1656975283720,MATH 142A,B05,093559,Chow; Bennett,6,0,32,26
1656975289747,MATH 193A,A01,083224,Rotar; Vladimir,7,0,34,27
1656975289747,MATH 193A,A02,083225,Rotar; Vladimir,4,0,34,30
1656975289747,MATH 193A,A03,083781,Rotar; Vladimir,1,0,34,33
1656975289747,MATH 193A,A04,083782,Rotar; Vladimir,6,0,34,28
1656975289747,MATH 193A,A05,093482,Rotar; Vladimir,6,0,34,28
1656975295768,MATH 197,001,091859,McAuley; Julian John,9999,0,9999,0
1656975295768,MATH 197,002,095566,Kedlaya; Kiran S.,9997,0,9999,2
1656975295768,MATH 197,003,095567,Xiao; Ming,9999,0,9999,0
1656975295768,MATH 197,004,095571,Perols; Johan Lars,9998,0,9999,1
1656975302824,COGS 9,A01,083615,Shannon; Kyle Michael,7,0,75,68
1656975308850,COGS 11,A01,083617,Boyle; Mary E. T.,20,0,48,28
1656975314873,COGS 13,A01,083071,Bastos; Amalia Pinkusfeld,9,0,71,62
1656975320895,COGS 14A,A01,092681,Semenuks; Arturs,0,1,100,100
1656975326919,COGS 14B,A01,083073,Cheng; Tzu-Han,5,0,63,58
1656975332942,COGS 17,A01,092677,Semenuks; Arturs,4,0,81,77
1656975338965,COGS 100,A01,083619,Allen; Michael Gordon,15,0,70,55
1656975344991,COGS 101A,A01,083621,Davis; Joshua Daniel,9,0,68,59
1656975351016,COGS 101B,A01,091572,Allen; Michael Gordon,8,0,65,57
1656975357042,COGS 101C,A01,083625,Delgado; Tania,17,0,35,18
1656975363067,COGS 107A,A01,083627,Boyle; Mary E. T.,13,0,60,47
1656975369093,COGS 118A,A01,083075,Gupta; Anjum,15,0,76,61
1656975375117,CSE 3,A50,083646,Miranda; Gregory Joseph,22,0,50,28
1656975381145,CSE 8A,A50,083650,Miranda; Gregory Joseph,17,1,56,39
1656975387168,CSE 11,A01,083080,Cao; Yingjun,4,15,40,36
1656975393194,CSE 12,A01,083652,Krause-Levy; Sophia Louisa,20,1,120,100
1656975399217,CSE 15L,A01,083654,Morris; Justin Loren,8,0,50,42
1656975399217,CSE 15L,A02,083655,Morris; Justin Loren,8,0,50,42
1656975405246,CSE 20,A01,083657,Tran; Khoa Dang,37,0,80,43
1656975411274,CSE 21,A01,095574,Bach; Quang Tran,21,0,48,27
1656975417301,CSE 30,A01,083084,Eldon; John,4,0,80,76
1656975417301,CSE 30,B01,095061,Bhaskar; Nishant,6,0,50,44
1656975423329,CSE 100,A01,083659,Cao; Yingjun,3,4,70,67
1656975429352,CSE 134B,A01,083661,Powell; Thomas Allan,19,0,100,81
1656975435374,CSE 140,A01,083663,Gungor; Onat,14,0,85,71
1656975441407,CSE 140L,A01,083088,Eldon; John,16,0,100,84
1656975447432,CSE 175,A01,083665,Kumar; Rakesh,3,0,25,22
1656975453458,CSE 190,A00,092507,Dubnov; Shlomo,7,0,20,13
1656975459480,ECE 45,A01,083139,Congero; Spencer William,5,0,75,70
1656975465514,ECE 65,A50,083695,Saad; Andrew S,12,0,30,18
1656975465514,ECE 65,A51,095125,Saad; Andrew S,25,0,26,1
1656975471539,ECE 109,A01,091882,Touri; Behrouz,16,0,70,54
1656975477562,ECE 180,A00,083140,Abi Samra; Nicholas Camill,1,0,30,29
1656975477562,ECE 180,B00,083141,Abi Samra; Nicholas Camill,0,0,30,30
1656975483586,MATH 10A,A01,083735,Patchell; Gregory David,1,0,30,29
1656975483586,MATH 10A,A02,083736,Patchell; Gregory David,20,0,30,10
1656975483586,MATH 10A,A03,083737,Patchell; Gregory David,15,0,30,15
1656975489610,MATH 10B,A01,083207,Lim; Seonhee,7,0,34,27
1656975489610,MATH 10B,A02,083208,Lim; Seonhee,9,0,35,26
1656975489610,MATH 10B,A03,093472,Lim; Seonhee,4,0,34,30
1656975489610,MATH 10B,B01,083739,Sinha; Shubham,9,0,30,21
1656975495640,MATH 18,A01,083743,Cinel; Cameron Alexander,6,0,30,24
1656975495640,MATH 18,A02,083744,Cinel; Cameron Alexander,15,0,30,15
1656975495640,MATH 18,A03,083745,Cinel; Cameron Alexander,8,0,30,22
1656975495640,MATH 18,B01,083748,Rideout; David Porter,4,0,37,33
1656975495640,MATH 18,B02,083749,Rideout; David Porter,3,0,36,33
1656975495640,MATH 18,B03,083750,Rideout; David Porter,2,0,37,35
1656975495640,MATH 18,B04,083751,Rideout; David Porter,5,0,36,31
1656975495640,MATH 18,B05,093473,Rideout; David Porter,4,0,36,32
1656975495640,MATH 18,B06,093474,Rideout; David Porter,5,0,36,31
1656975501663,MATH 20A,A01,083754,Zheng; Zequn,12,0,40,28
1656975507687,MATH 20B,A01,083756,Briones; Jor-el Thomas Caparas,1,0,36,35
1656975507687,MATH 20B,A02,083757,Briones; Jor-el Thomas Caparas,1,0,36,35
1656975507687,MATH 20B,A03,093475,Briones; Jor-el Thomas Caparas,0,0,36,36
1656975513712,MATH 20C,A01,083760,Briones; Jor-el Thomas Caparas,1,0,35,34
1656975513712,MATH 20C,A02,083761,Briones; Jor-el Thomas Caparas,8,0,35,27
1656975513712,MATH 20C,A03,093476,Briones; Jor-el Thomas Caparas,0,1,36,36
1656975513712,MATH 20C,B01,083762,Bach; Quang Tran,0,0,30,30
1656975519735,MATH 20D,A01,083765,Tran; Brian Kha,4,0,30,26
1656975519735,MATH 20D,A02,083766,Tran; Brian Kha,4,0,30,26
1656975519735,MATH 20D,A03,083767,Tran; Brian Kha,3,0,30,27
1656975525760,MATH 20E,A01,083771,Ganguly; Soumya,5,0,32,27
1656975525760,MATH 20E,A02,083772,Ganguly; Soumya,6,0,32,26
1656975525760,MATH 20E,B01,083773,Ciotti; Benjamin,18,0,35,17
1656975525760,MATH 20E,B02,083774,Ciotti; Benjamin,17,0,35,18
1656975531784,MATH 103A,A01,083777,Greenfeld; Be'Eri,2,0,36,34
1656975531784,MATH 103A,A02,083778,Greenfeld; Be'Eri,5,0,36,31
1656975531784,MATH 103A,A03,093561,Greenfeld; Be'Eri,4,0,36,32
1656975531784,MATH 103A,B01,083779,Greenfeld; Be'Eri,6,0,36,30
1656975531784,MATH 103A,B02,083780,Greenfeld; Be'Eri,2,0,36,34
1656975531784,MATH 103A,B03,093562,Greenfeld; Be'Eri,2,0,36,34
1656975537807,MATH 105,A01,085443,Carter; Anne Toulson,14,0,35,21
1656975537807,MATH 105,A02,093477,Carter; Anne Toulson,20,0,35,15
1656975543835,MATH 109,A01,083213,Ganzberger; Geoffrey Michael,2,0,34,32
1656975543835,MATH 109,A02,083214,Ganzberger; Geoffrey Michael,2,0,34,32
1656975543835,MATH 109,A03,093478,Ganzberger; Geoffrey Michael,1,0,34,33
1656975543835,MATH 109,B01,083215,Ganzberger; Geoffrey Michael,1,0,32,31
1656975543835,MATH 109,B02,083216,Ganzberger; Geoffrey Michael,1,0,32,31
1656975543835,MATH 109,B03,093479,Ganzberger; Geoffrey Michael,6,0,32,26
1656975549873,MATH 142A,A01,083219,Chow; Bennett,6,0,32,26
1656975549873,MATH 142A,A02,083220,Chow; Bennett,10,0,32,22
1656975549873,MATH 142A,A03,093480,Chow; Bennett,7,0,32,25
1656975549873,MATH 142A,B03,093481,Chow; Bennett,7,0,32,25
1656975549873,MATH 142A,B04,093558,Chow; Bennett,11,0,32,21
1656975549873,MATH 142A,B05,093559,Chow; Bennett,6,0,32,26
1656975555902,MATH 193A,A01,083224,Rotar; Vladimir,7,0,34,27
1656975555902,MATH 193A,A02,083225,Rotar; Vladimir,4,0,34,30
1656975555902,MATH 193A,A03,083781,Rotar; Vladimir,1,0,34,33
1656975555902,MATH 193A,A04,083782,Rotar; Vladimir,6,0,34,28
1656975555902,MATH 193A,A05,093482,Rotar; Vladimir,6,0,34,28
1656975561925,MATH 197,001,091859,McAuley; Julian John,9999,0,9999,0
1656975561925,MATH 197,002,095566,Kedlaya; Kiran S.,9997,0,9999,2
1656975561925,MATH 197,003,095567,Xiao; Ming,9999,0,9999,0
1656975561925,MATH 197,004,095571,Perols; Johan Lars,9998,0,9999,1
1656975568985,COGS 9,A01,083615,Shannon; Kyle Michael,7,0,75,68
1656975575084,COGS 11,A01,083617,Boyle; Mary E. T.,20,0,48,28
1656975581107,COGS 13,A01,083071,Bastos; Amalia Pinkusfeld,9,0,71,62
1656975587139,COGS 14A,A01,092681,Semenuks; Arturs,0,1,100,100
1656975593168,COGS 14B,A01,083073,Cheng; Tzu-Han,5,0,63,58
1656975599193,COGS 17,A01,092677,Semenuks; Arturs,4,0,81,77
1656975605216,COGS 100,A01,083619,Allen; Michael Gordon,15,0,70,55
1656975611256,COGS 101A,A01,083621,Davis; Joshua Daniel,9,0,68,59
1656975617282,COGS 101B,A01,091572,Allen; Michael Gordon,8,0,65,57
1656975623304,COGS 101C,A01,083625,Delgado; Tania,17,0,35,18
1656975629331,COGS 107A,A01,083627,Boyle; Mary E. T.,13,0,60,47
1656975635357,COGS 118A,A01,083075,Gupta; Anjum,15,0,76,61
1656975641380,CSE 3,A50,083646,Miranda; Gregory Joseph,22,0,50,28
1656975647406,CSE 8A,A50,083650,Miranda; Gregory Joseph,17,1,56,39
1656975653428,CSE 11,A01,083080,Cao; Yingjun,4,15,40,36
1656975659452,CSE 12,A01,083652,Krause-Levy; Sophia Louisa,20,1,120,100
1656975665475,CSE 15L,A01,083654,Morris; Justin Loren,8,0,50,42
1656975665475,CSE 15L,A02,083655,Morris; Justin Loren,8,0,50,42
1656975671501,CSE 20,A01,083657,Tran; Khoa Dang,37,0,80,43
1656975677527,CSE 21,A01,095574,Bach; Quang Tran,21,0,48,27
1656975683552,CSE 30,A01,083084,Eldon; John,4,0,80,76
1656975683552,CSE 30,B01,095061,Bhaskar; Nishant,6,0,50,44
1656975689575,CSE 100,A01,083659,Cao; Yingjun,3,4,70,67
1656975695597,CSE 134B,A01,083661,Powell; Thomas Allan,19,0,100,81
1656975701630,CSE 140,A01,083663,Gungor; Onat,14,0,85,71
1656975707653,CSE 140L,A01,083088,Eldon; John,16,0,100,84
1656975713676,CSE 175,A01,083665,Kumar; Rakesh,3,0,25,22
1656975719706,CSE 190,A00,092507,Dubnov; Shlomo,7,0,20,13
1656975725730,ECE 45,A01,083139,Congero; Spencer William,5,0,75,70
1656975731751,ECE 65,A50,083695,Saad; Andrew S,12,0,30,18
1656975731751,ECE 65,A51,095125,Saad; Andrew S,25,0,26,1
1656975737773,ECE 109,A01,091882,Touri; Behrouz,16,0,70,54
1656975743800,ECE 180,A00,083140,Abi Samra; Nicholas Camill,1,0,30,29
1656975743800,ECE 180,B00,083141,Abi Samra; Nicholas Camill,0,0,30,30
1656975749828,MATH 10A,A01,083735,Patchell; Gregory David,1,0,30,29
1656975749828,MATH 10A,A02,083736,Patchell; Gregory David,20,0,30,10
1656975749828,MATH 10A,A03,083737,Patchell; Gregory David,15,0,30,15
1656975755858,MATH 10B,A01,083207,Lim; Seonhee,7,0,34,27
1656975755858,MATH 10B,A02,083208,Lim; Seonhee,9,0,35,26
1656975755858,MATH 10B,A03,093472,Lim; Seonhee,4,0,34,30
1656975755858,MATH 10B,B01,083739,Sinha; Shubham,9,0,30,21
1656975761881,MATH 18,A01,083743,Cinel; Cameron Alexander,6,0,30,24
1656975761881,MATH 18,A02,083744,Cinel; Cameron Alexander,15,0,30,15
1656975761881,MATH 18,A03,083745,Cinel; Cameron Alexander,8,0,30,22
1656975761881,MATH 18,B01,083748,Rideout; David Porter,4,0,37,33
1656975761881,MATH 18,B02,083749,Rideout; David Porter,3,0,36,33
1656975761881,MATH 18,B03,083750,Rideout; David Porter,2,0,37,35
1656975761881,MATH 18,B04,083751,Rideout; David Porter,5,0,36,31
1656975761881,MATH 18,B05,093473,Rideout; David Porter,4,0,36,32
1656975761881,MATH 18,B06,093474,Rideout; David Porter,5,0,36,31
1656975767904,MATH 20A,A01,083754,Zheng; Zequn,12,0,40,28
1656975773930,MATH 20B,A01,083756,Briones; Jor-el Thomas Caparas,1,0,36,35
1656975773930,MATH 20B,A02,083757,Briones; Jor-el Thomas Caparas,1,0,36,35
1656975773930,MATH 20B,A03,093475,Briones; Jor-el Thomas Caparas,0,0,36,36
1656975779960,MATH 20C,A01,083760,Briones; Jor-el Thomas Caparas,1,0,35,34
1656975779960,MATH 20C,A02,083761,Briones; Jor-el Thomas Caparas,8,0,35,27
1656975779960,MATH 20C,A03,093476,Briones; Jor-el Thomas Caparas,0,1,36,36
1656975779960,MATH 20C,B01,083762,Bach; Quang Tran,0,0,30,30
1656975785985,MATH 20D,A01,083765,Tran; Brian Kha,4,0,30,26
1656975785985,MATH 20D,A02,083766,Tran; Brian Kha,4,0,30,26
1656975785985,MATH 20D,A03,083767,Tran; Brian Kha,3,0,30,27
1656975792008,MATH 20E,A01,083771,Ganguly; Soumya,5,0,32,27
1656975792008,MATH 20E,A02,083772,Ganguly; Soumya,6,0,32,26
1656975792008,MATH 20E,B01,083773,Ciotti; Benjamin,18,0,35,17
1656975792008,MATH 20E,B02,083774,Ciotti; Benjamin,17,0,35,18
1656975798036,MATH 103A,A01,083777,Greenfeld; Be'Eri,2,0,36,34
1656975798036,MATH 103A,A02,083778,Greenfeld; Be'Eri,5,0,36,31
1656975798036,MATH 103A,A03,093561,Greenfeld; Be'Eri,4,0,36,32
1656975798036,MATH 103A,B01,083779,Greenfeld; Be'Eri,6,0,36,30
1656975798036,MATH 103A,B02,083780,Greenfeld; Be'Eri,2,0,36,34
1656975798036,MATH 103A,B03,093562,Greenfeld; Be'Eri,2,0,36,34
1656975804064,MATH 105,A01,085443,Carter; Anne Toulson,14,0,35,21
1656975804064,MATH 105,A02,093477,Carter; Anne Toulson,20,0,35,15
1656975810088,MATH 109,A01,083213,Ganzberger; Geoffrey Michael,2,0,34,32
1656975810088,MATH 109,A02,083214,Ganzberger; Geoffrey Michael,2,0,34,32
1656975810088,MATH 109,A03,093478,Ganzberger; Geoffrey Michael,1,0,34,33
1656975810088,MATH 109,B01,083215,Ganzberger; Geoffrey Michael,1,0,32,31
1656975810088,MATH 109,B02,083216,Ganzberger; Geoffrey Michael,1,0,32,31
1656975810088,MATH 109,B03,093479,Ganzberger; Geoffrey Michael,6,0,32,26
1656975816119,MATH 142A,A01,083219,Chow; Bennett,6,0,32,26
1656975816119,MATH 142A,A02,083220,Chow; Bennett,10,0,32,22
1656975816119,MATH 142A,A03,093480,Chow; Bennett,7,0,32,25
1656975816119,MATH 142A,B03,093481,Chow; Bennett,7,0,32,25
1656975816119,MATH 142A,B04,093558,Chow; Bennett,11,0,32,21
1656975816119,MATH 142A,B05,093559,Chow; Bennett,6,0,32,26
1656975822142,MATH 193A,A01,083224,Rotar; Vladimir,7,0,34,27
1656975822142,MATH 193A,A02,083225,Rotar; Vladimir,4,0,34,30
1656975822142,MATH 193A,A03,083781,Rotar; Vladimir,1,0,34,33
1656975822142,MATH 193A,A04,083782,Rotar; Vladimir,6,0,34,28
1656975822142,MATH 193A,A05,093482,Rotar; Vladimir,6,0,34,28
1656975828170,MATH 197,001,091859,McAuley; Julian John,9999,0,9999,0
1656975828170,MATH 197,002,095566,Kedlaya; Kiran S.,9997,0,9999,2
1656975828170,MATH 197,003,095567,Xiao; Ming,9999,0,9999,0
1656975828170,MATH 197,004,095571,Perols; Johan Lars,9998,0,9999,1
1656975835225,COGS 9,A01,083615,Shannon; Kyle Michael,7,0,75,68
1656975841247,COGS 11,A01,083617,Boyle; Mary E. T.,20,0,48,28
1656975847269,COGS 13,A01,083071,Bastos; Amalia Pinkusfeld,9,0,71,62
1656975853293,COGS 14A,A01,092681,Semenuks; Arturs,0,1,100,100
1656975859318,COGS 14B,A01,083073,Cheng; Tzu-Han,5,0,63,58
1656975865343,COGS 17,A01,092677,Semenuks; Arturs,4,0,81,77
1656975871366,COGS 100,A01,083619,Allen; Michael Gordon,15,0,70,55
1656975877392,COGS 101A,A01,083621,Davis; Joshua Daniel,9,0,68,59
1656975883419,COGS 101B,A01,091572,Allen; Michael Gordon,8,0,65,57
1656975889448,COGS 101C,A01,083625,Delgado; Tania,17,0,35,18
1656975895475,COGS 107A,A01,083627,Boyle; Mary E. T.,13,0,60,47
1656975901499,COGS 118A,A01,083075,Gupta; Anjum,15,0,76,61
1656975907526,CSE 3,A50,083646,Miranda; Gregory Joseph,22,0,50,28
1656975913550,CSE 8A,A50,083650,Miranda; Gregory Joseph,17,1,56,39
1656975919580,CSE 11,A01,083080,Cao; Yingjun,4,15,40,36
1656975925606,CSE 12,A01,083652,Krause-Levy; Sophia Louisa,20,1,120,100
1656975931630,CSE 15L,A01,083654,Morris; Justin Loren,8,0,50,42
1656975931630,CSE 15L,A02,083655,Morris; Justin Loren,8,0,50,42
1656975937656,CSE 20,A01,083657,Tran; Khoa Dang,37,0,80,43
1656975943679,CSE 21,A01,095574,Bach; Quang Tran,21,0,48,27
1656975949703,CSE 30,A01,083084,Eldon; John,4,0,80,76
1656975949703,CSE 30,B01,095061,Bhaskar; Nishant,6,0,50,44
1656975955726,CSE 100,A01,083659,Cao; Yingjun,3,4,70,67
1656975961750,CSE 134B,A01,083661,Powell; Thomas Allan,19,0,100,81
1656975967776,CSE 140,A01,083663,Gungor; Onat,14,0,85,71
1656975973801,CSE 140L,A01,083088,Eldon; John,16,0,100,84
1656975979825,CSE 175,A01,083665,Kumar; Rakesh,3,0,25,22
1656975985848,CSE 190,A00,092507,Dubnov; Shlomo,7,0,20,13
1656975991876,ECE 45,A01,083139,Congero; Spencer William,5,0,75,70
1656975997902,ECE 65,A50,083695,Saad; Andrew S,12,0,30,18
1656975997902,ECE 65,A51,095125,Saad; Andrew S,25,0,26,1
1656976003929,ECE 109,A01,091882,Touri; Behrouz,16,0,70,54
1656976009957,ECE 180,A00,083140,Abi Samra; Nicholas Camill,1,0,30,29
1656976009957,ECE 180,B00,083141,Abi Samra; Nicholas Camill,0,0,30,30
1656976015978,MATH 10A,A01,083735,Patchell; Gregory David,1,0,30,29
1656976015978,MATH 10A,A02,083736,Patchell; Gregory David,20,0,30,10
1656976015978,MATH 10A,A03,083737,Patchell; Gregory David,15,0,30,15
1656976022000,MATH 10B,A01,083207,Lim; Seonhee,7,0,34,27
1656976022000,MATH 10B,A02,083208,Lim; Seonhee,9,0,35,26
1656976022000,MATH 10B,A03,093472,Lim; Seonhee,4,0,34,30
1656976022000,MATH 10B,B01,083739,Sinha; Shubham,9,0,30,21
1656976028026,MATH 18,A01,083743,Cinel; Cameron Alexander,6,0,30,24
1656976028026,MATH 18,A02,083744,Cinel; Cameron Alexander,15,0,30,15
1656976028026,MATH 18,A03,083745,Cinel; Cameron Alexander,8,0,30,22
1656976028026,MATH 18,B01,083748,Rideout; David Porter,4,0,37,33
1656976028026,MATH 18,B02,083749,Rideout; David Porter,3,0,36,33
1656976028026,MATH 18,B03,083750,Rideout; David Porter,2,0,37,35
1656976028026,MATH 18,B04,083751,Rideout; David Porter,5,0,36,31
1656976028026,MATH 18,B05,093473,Rideout; David Porter,4,0,36,32
1656976028026,MATH 18,B06,093474,Rideout; David Porter,5,0,36,31
1656976034055,MATH 20A,A01,083754,Zheng; Zequn,12,0,40,28
1656976040082,MATH 20B,A01,083756,Briones; Jor-el Thomas Caparas,1,0,36,35
1656976040082,MATH 20B,A02,083757,Briones; Jor-el Thomas Caparas,1,0,36,35
1656976040082,MATH 20B,A03,093475,Briones; Jor-el Thomas Caparas,0,0,36,36
1656976046104,MATH 20C,A01,083760,Briones; Jor-el Thomas Caparas,1,0,35,34
1656976046104,MATH 20C,A02,083761,Briones; Jor-el Thomas Caparas,8,0,35,27
1656976046104,MATH 20C,A03,093476,Briones; Jor-el Thomas Caparas,0,1,36,36
1656976046104,MATH 20C,B01,083762,Bach; Quang Tran,0,0,30,30
1656976052132,MATH 20D,A01,083765,Tran; Brian Kha,4,0,30,26
1656976052132,MATH 20D,A02,083766,Tran; Brian Kha,4,0,30,26
1656976052132,MATH 20D,A03,083767,Tran; Brian Kha,3,0,30,27
1656976058156,MATH 20E,A01,083771,Ganguly; Soumya,5,0,32,27
1656976058156,MATH 20E,A02,083772,Ganguly; Soumya,6,0,32,26
1656976058156,MATH 20E,B01,083773,Ciotti; Benjamin,18,0,35,17
1656976058156,MATH 20E,B02,083774,Ciotti; Benjamin,17,0,35,18
1656976064187,MATH 103A,A01,083777,Greenfeld; Be'Eri,2,0,36,34
1656976064187,MATH 103A,A02,083778,Greenfeld; Be'Eri,5,0,36,31
1656976064187,MATH 103A,A03,093561,Greenfeld; Be'Eri,4,0,36,32
1656976064187,MATH 103A,B01,083779,Greenfeld; Be'Eri,6,0,36,30
1656976064187,MATH 103A,B02,083780,Greenfeld; Be'Eri,2,0,36,34
1656976064187,MATH 103A,B03,093562,Greenfeld; Be'Eri,2,0,36,34
1656976070212,MATH 105,A01,085443,Carter; Anne Toulson,14,0,35,21
1656976070212,MATH 105,A02,093477,Carter; Anne Toulson,20,0,35,15
1656976076245,MATH 109,A01,083213,Ganzberger; Geoffrey Michael,2,0,34,32
1656976076245,MATH 109,A02,083214,Ganzberger; Geoffrey Michael,2,0,34,32
1656976076245,MATH 109,A03,093478,Ganzberger; Geoffrey Michael,1,0,34,33
1656976076245,MATH 109,B01,083215,Ganzberger; Geoffrey Michael,1,0,32,31
1656976076245,MATH 109,B02,083216,Ganzberger; Geoffrey Michael,1,0,32,31
1656976076245,MATH 109,B03,093479,Ganzberger; Geoffrey Michael,6,0,32,26
1656976082284,MATH 142A,A01,083219,Chow; Bennett,6,0,32,26
1656976082284,MATH 142A,A02,083220,Chow; Bennett,10,0,32,22
1656976082284,MATH 142A,A03,093480,Chow; Bennett,7,0,32,25
1656976082284,MATH 142A,B03,093481,Chow; Bennett,7,0,32,25
1656976082284,MATH 142A,B04,093558,Chow; Bennett,11,0,32,21
1656976082284,MATH 142A,B05,093559,Chow; Bennett,6,0,32,26
1656976088311,MATH 193A,A01,083224,Rotar; Vladimir,7,0,34,27
1656976088311,MATH 193A,A02,083225,Rotar; Vladimir,4,0,34,30
1656976088311,MATH 193A,A03,083781,Rotar; Vladimir,1,0,34,33
1656976088311,MATH 193A,A04,083782,Rotar; Vladimir,6,0,34,28
1656976088311,MATH 193A,A05,093482,Rotar; Vladimir,6,0,34,28
1656976094336,MATH 197,001,091859,McAuley; Julian John,9999,0,9999,0
1656976094336,MATH 197,002,095566,Kedlaya; Kiran S.,9997,0,9999,2
1656976094336,MATH 197,003,095567,Xiao; Ming,9999,0,9999,0
1656976094336,MATH 197,004,095571,Perols; Johan Lars,9998,0,9999,1
1656976101394,COGS 9,A01,083615,Shannon; Kyle Michael,7,0,75,68
1656976107417,COGS 11,A01,083617,Boyle; Mary E. T.,20,0,48,28
1656976113444,COGS 13,A01,083071,Bastos; Amalia Pinkusfeld,9,0,71,62
1656976119467,COGS 14A,A01,092681,Semenuks; Arturs,0,1,100,100
1656976125492,COGS 14B,A01,083073,Cheng; Tzu-Han,5,0,63,58
1656976131518,COGS 17,A01,092677,Semenuks; Arturs,4,0,81,77
1656976137541,COGS 100,A01,083619,Allen; Michael Gordon,15,0,70,55
1656976143565,COGS 101A,A01,083621,Davis; Joshua Daniel,9,0,68,59
1656976149591,COGS 101B,A01,091572,Allen; Michael Gordon,8,0,65,57
1656976155615,COGS 101C,A01,083625,Delgado; Tania,17,0,35,18
1656976161639,COGS 107A,A01,083627,Boyle; Mary E. T.,13,0,60,47
1656976167661,COGS 118A,A01,083075,Gupta; Anjum,15,0,76,61
1656976173774,CSE 3,A50,083646,Miranda; Gregory Joseph,22,0,50,28
1656976179801,CSE 8A,A50,083650,Miranda; Gregory Joseph,17,1,56,39
1656976185823,CSE 11,A01,083080,Cao; Yingjun,4,15,40,36
1656976191848,CSE 12,A01,083652,Krause-Levy; Sophia Louisa,20,1,120,100
1656976197878,CSE 15L,A01,083654,Morris; Justin Loren,8,0,50,42
1656976197878,CSE 15L,A02,083655,Morris; Justin Loren,8,0,50,42
1656976203902,CSE 20,A01,083657,Tran; Khoa Dang,37,0,80,43
1656976209927,CSE 21,A01,095574,Bach; Quang Tran,21,0,48,27
1656976215951,CSE 30,A01,083084,Eldon; John,4,0,80,76
1656976215951,CSE 30,B01,095061,Bhaskar; Nishant,6,0,50,44
1656976221976,CSE 100,A01,083659,Cao; Yingjun,3,4,70,67
1656976228002,CSE 134B,A01,083661,Powell; Thomas Allan,19,0,100,81
1656976234029,CSE 140,A01,083663,Gungor; Onat,14,0,85,71
1656976240056,CSE 140L,A01,083088,Eldon; John,16,0,100,84
1656976246084,CSE 175,A01,083665,Kumar; Rakesh,3,0,25,22
1656976252105,CSE 190,A00,092507,Dubnov; Shlomo,7,0,20,13
1656976258129,ECE 45,A01,083139,Congero; Spencer William,5,0,75,70
1656976264151,ECE 65,A50,083695,Saad; Andrew S,12,0,30,18
1656976264151,ECE 65,A51,095125,Saad; Andrew S,25,0,26,1
1656976270175,ECE 109,A01,091882,Touri; Behrouz,16,0,70,54
1656976276199,ECE 180,A00,083140,Abi Samra; Nicholas Camill,1,0,30,29
1656976276199,ECE 180,B00,083141,Abi Samra; Nicholas Camill,0,0,30,30
1656976282226,MATH 10A,A01,083735,Patchell; Gregory David,1,0,30,29
1656976282226,MATH 10A,A02,083736,Patchell; Gregory David,20,0,30,10
1656976282226,MATH 10A,A03,083737,Patchell; Gregory David,15,0,30,15
1656976288255,MATH 10B,A01,083207,Lim; Seonhee,7,0,34,27
1656976288255,MATH 10B,A02,083208,Lim; Seonhee,9,0,35,26
1656976288255,MATH 10B,A03,093472,Lim; Seonhee,4,0,34,30
1656976288255,MATH 10B,B01,083739,Sinha; Shubham,9,0,30,21
1656976294288,MATH 18,A01,083743,Cinel; Cameron Alexander,6,0,30,24
1656976294288,MATH 18,A02,083744,Cinel; Cameron Alexander,15,0,30,15
1656976294288,MATH 18,A03,083745,Cinel; Cameron Alexander,8,0,30,22
1656976294288,MATH 18,B01,083748,Rideout; David Porter,4,0,37,33
1656976294288,MATH 18,B02,083749,Rideout; David Porter,3,0,36,33
1656976294288,MATH 18,B03,083750,Rideout; David Porter,2,0,37,35
1656976294288,MATH 18,B04,083751,Rideout; David Porter,5,0,36,31
1656976294288,MATH 18,B05,093473,Rideout; David Porter,4,0,36,32
1656976294288,MATH 18,B06,093474,Rideout; David Porter,5,0,36,31
1656976300313,MATH 20A,A01,083754,Zheng; Zequn,12,0,40,28
1656976306339,MATH 20B,A01,083756,Briones; Jor-el Thomas Caparas,1,0,36,35
1656976306339,MATH 20B,A02,083757,Briones; Jor-el Thomas Caparas,1,0,36,35
1656976306339,MATH 20B,A03,093475,Briones; Jor-el Thomas Caparas,0,0,36,36
1656976312362,MATH 20C,A01,083760,Briones; Jor-el Thomas Caparas,1,0,35,34
1656976312362,MATH 20C,A02,083761,Briones; Jor-el Thomas Caparas,8,0,35,27
1656976312362,MATH 20C,A03,093476,Briones; Jor-el Thomas Caparas,0,1,36,36
1656976312362,MATH 20C,B01,083762,Bach; Quang Tran,0,0,30,30
1656976318385,MATH 20D,A01,083765,Tran; Brian Kha,4,0,30,26
1656976318385,MATH 20D,A02,083766,Tran; Brian Kha,4,0,30,26
1656976318385,MATH 20D,A03,083767,Tran; Brian Kha,3,0,30,27
1656976324408,MATH 20E,A01,083771,Ganguly; Soumya,5,0,32,27
1656976324408,MATH 20E,A02,083772,Ganguly; Soumya,6,0,32,26
1656976324408,MATH 20E,B01,083773,Ciotti; Benjamin,18,0,35,17
1656976324408,MATH 20E,B02,083774,Ciotti; Benjamin,17,0,35,18
1656976330438,MATH 103A,A01,083777,Greenfeld; Be'Eri,2,0,36,34
1656976330438,MATH 103A,A02,083778,Greenfeld; Be'Eri,5,0,36,31
1656976330438,MATH 103A,A03,093561,Greenfeld; Be'Eri,4,0,36,32
1656976330438,MATH 103A,B01,083779,Greenfeld; Be'Eri,6,0,36,30
1656976330438,MATH 103A,B02,083780,Greenfeld; Be'Eri,2,0,36,34
1656976330438,MATH 103A,B03,093562,Greenfeld; Be'Eri,2,0,36,34
1656976336466,MATH 105,A01,085443,Carter; Anne Toulson,14,0,35,21
1656976336466,MATH 105,A02,093477,Carter; Anne Toulson,20,0,35,15
1656976342491,MATH 109,A01,083213,Ganzberger; Geoffrey Michael,2,0,34,32
1656976342491,MATH 109,A02,083214,Ganzberger; Geoffrey Michael,2,0,34,32
1656976342491,MATH 109,A03,093478,Ganzberger; Geoffrey Michael,1,0,34,33
1656976342491,MATH 109,B01,083215,Ganzberger; Geoffrey Michael,1,0,32,31
1656976342491,MATH 109,B02,083216,Ganzberger; Geoffrey Michael,1,0,32,31
1656976342491,MATH 109,B03,093479,Ganzberger; Geoffrey Michael,6,0,32,26
1656976348516,MATH 142A,A01,083219,Chow; Bennett,6,0,32,26
1656976348516,MATH 142A,A02,083220,Chow; Bennett,10,0,32,22
1656976348516,MATH 142A,A03,093480,Chow; Bennett,7,0,32,25
1656976348516,MATH 142A,B03,093481,Chow; Bennett,7,0,32,25
1656976348516,MATH 142A,B04,093558,Chow; Bennett,11,0,32,21
1656976348516,MATH 142A,B05,093559,Chow; Bennett,6,0,32,26
1656976354540,MATH 193A,A01,083224,Rotar; Vladimir,7,0,34,27
1656976354540,MATH 193A,A02,083225,Rotar; Vladimir,4,0,34,30
1656976354540,MATH 193A,A03,083781,Rotar; Vladimir,1,0,34,33
1656976354540,MATH 193A,A04,083782,Rotar; Vladimir,6,0,34,28
1656976354540,MATH 193A,A05,093482,Rotar; Vladimir,6,0,34,28
1656976360563,MATH 197,001,091859,McAuley; Julian John,9999,0,9999,0
1656976360563,MATH 197,002,095566,Kedlaya; Kiran S.,9997,0,9999,2
1656976360563,MATH 197,003,095567,Xiao; Ming,9999,0,9999,0
1656976360563,MATH 197,004,095571,Perols; Johan Lars,9998,0,9999,1
1656976367618,COGS 9,A01,083615,Shannon; Kyle Michael,7,0,75,68
1656976373642,COGS 11,A01,083617,Boyle; Mary E. T.,20,0,48,28
1656976379664,COGS 13,A01,083071,Bastos; Amalia Pinkusfeld,9,0,71,62
1656976385693,COGS 14A,A01,092681,Semenuks; Arturs,0,1,100,100
1656976391721,COGS 14B,A01,083073,Cheng; Tzu-Han,5,0,63,58
1656976397747,COGS 17,A01,092677,Semenuks; Arturs,4,0,81,77
1656976403770,COGS 100,A01,083619,Allen; Michael Gordon,15,0,70,55
1656976409793,COGS 101A,A01,083621,Davis; Joshua Daniel,9,0,68,59
1656976415815,COGS 101B,A01,091572,Allen; Michael Gordon,8,0,65,57
1656976421843,COGS 101C,A01,083625,Delgado; Tania,17,0,35,18
1656976427881,COGS 107A,A01,083627,Boyle; Mary E. T.,13,0,60,47
1656976433903,COGS 118A,A01,083075,Gupta; Anjum,15,0,76,61
1656976439930,CSE 3,A50,083646,Miranda; Gregory Joseph,22,0,50,28
1656976445957,CSE 8A,A50,083650,Miranda; Gregory Joseph,17,1,56,39
1656976451979,CSE 11,A01,083080,Cao; Yingjun,4,15,40,36
1656976458002,CSE 12,A01,083652,Krause-Levy; Sophia Louisa,20,1,120,100
1656976464027,CSE 15L,A01,083654,Morris; Justin Loren,8,0,50,42
1656976464027,CSE 15L,A02,083655,Morris; Justin Loren,8,0,50,42
1656976470050,CSE 20,A01,083657,Tran; Khoa Dang,37,0,80,43
1656976476074,CSE 21,A01,095574,Bach; Quang Tran,21,0,48,27
1656976482101,CSE 30,A01,083084,Eldon; John,4,0,80,76
1656976482101,CSE 30,B01,095061,Bhaskar; Nishant,6,0,50,44
1656976488128,CSE 100,A01,083659,Cao; Yingjun,3,4,70,67
1656976494152,CSE 134B,A01,083661,Powell; Thomas Allan,19,0,100,81
1656976500175,CSE 140,A01,083663,Gungor; Onat,14,0,85,71
1656976506198,CSE 140L,A01,083088,Eldon; John,16,0,100,84
1656976512221,CSE 175,A01,083665,Kumar; Rakesh,3,0,25,22
1656976518244,CSE 190,A00,092507,Dubnov; Shlomo,7,0,20,13
1656976524270,ECE 45,A01,083139,Congero; Spencer William,5,0,75,70
1656976530293,ECE 65,A50,083695,Saad; Andrew S,12,0,30,18
1656976530293,ECE 65,A51,095125,Saad; Andrew S,25,0,26,1
1656976536316,ECE 109,A01,091882,Touri; Behrouz,16,0,70,54
1656976542342,ECE 180,A00,083140,Abi Samra; Nicholas Camill,1,0,30,29
1656976542342,ECE 180,B00,083141,Abi Samra; Nicholas Camill,0,0,30,30
1656976548365,MATH 10A,A01,083735,Patchell; Gregory David,1,0,30,29
1656976548365,MATH 10A,A02,083736,Patchell; Gregory David,20,0,30,10
1656976548365,MATH 10A,A03,083737,Patchell; Gregory David,15,0,30,15
1656976554390,MATH 10B,A01,083207,Lim; Seonhee,7,0,34,27
1656976554390,MATH 10B,A02,083208,Lim; Seonhee,9,0,35,26
1656976554390,MATH 10B,A03,093472,Lim; Seonhee,4,0,34,30
1656976554390,MATH 10B,B01,083739,Sinha; Shubham,9,0,30,21
1656976560414,MATH 18,A01,083743,Cinel; Cameron Alexander,6,0,30,24
1656976560414,MATH 18,A02,083744,Cinel; Cameron Alexander,15,0,30,15
1656976560414,MATH 18,A03,083745,Cinel; Cameron Alexander,8,0,30,22
1656976560414,MATH 18,B01,083748,Rideout; David Porter,4,0,37,33
1656976560414,MATH 18,B02,083749,Rideout; David Porter,3,0,36,33
1656976560414,MATH 18,B03,083750,Rideout; David Porter,2,0,37,35
1656976560414,MATH 18,B04,083751,Rideout; David Porter,5,0,36,31
1656976560414,MATH 18,B05,093473,Rideout; David Porter,4,0,36,32
1656976560414,MATH 18,B06,093474,Rideout; David Porter,5,0,36,31
1656976566436,MATH 20A,A01,083754,Zheng; Zequn,12,0,40,28
1656976572460,MATH 20B,A01,083756,Briones; Jor-el Thomas Caparas,1,0,36,35
1656976572460,MATH 20B,A02,083757,Briones; Jor-el Thomas Caparas,1,0,36,35
1656976572460,MATH 20B,A03,093475,Briones; Jor-el Thomas Caparas,0,0,36,36
1656976578486,MATH 20C,A01,083760,Briones; Jor-el Thomas Caparas,1,0,35,34
1656976578486,MATH 20C,A02,083761,Briones; Jor-el Thomas Caparas,8,0,35,27
1656976578486,MATH 20C,A03,093476,Briones; Jor-el Thomas Caparas,0,1,36,36
1656976578486,MATH 20C,B01,083762,Bach; Quang Tran,0,0,30,30
1656976584515,MATH 20D,A01,083765,Tran; Brian Kha,4,0,30,26
1656976584515,MATH 20D,A02,083766,Tran; Brian Kha,4,0,30,26
1656976584515,MATH 20D,A03,083767,Tran; Brian Kha,3,0,30,27
1656976590550,MATH 20E,A01,083771,Ganguly; Soumya,5,0,32,27
1656976590550,MATH 20E,A02,083772,Ganguly; Soumya,6,0,32,26
1656976590550,MATH 20E,B01,083773,Ciotti; Benjamin,18,0,35,17
1656976590550,MATH 20E,B02,083774,Ciotti; Benjamin,17,0,35,18
1656976596575,MATH 103A,A01,083777,Greenfeld; Be'Eri,2,0,36,34
1656976596575,MATH 103A,A02,083778,Greenfeld; Be'Eri,5,0,36,31
1656976596575,MATH 103A,A03,093561,Greenfeld; Be'Eri,4,0,36,32
1656976596575,MATH 103A,B01,083779,Greenfeld; Be'Eri,6,0,36,30
1656976596575,MATH 103A,B02,083780,Greenfeld; Be'Eri,2,0,36,34
1656976596575,MATH 103A,B03,093562,Greenfeld; Be'Eri,2,0,36,34
1656976602598,MATH 105,A01,085443,Carter; Anne Toulson,14,0,35,21
1656976602598,MATH 105,A02,093477,Carter; Anne Toulson,20,0,35,15
1656976608629,MATH 109,A01,083213,Ganzberger; Geoffrey Michael,2,0,34,32
1656976608629,MATH 109,A02,083214,Ganzberger; Geoffrey Michael,2,0,34,32
1656976608629,MATH 109,A03,093478,Ganzberger; Geoffrey Michael,1,0,34,33
1656976608629,MATH 109,B01,083215,Ganzberger; Geoffrey Michael,1,0,32,31
1656976608629,MATH 109,B02,083216,Ganzberger; Geoffrey Michael,1,0,32,31
1656976608629,MATH 109,B03,093479,Ganzberger; Geoffrey Michael,6,0,32,26
1656976614652,MATH 142A,A01,083219,Chow; Bennett,6,0,32,26
1656976614652,MATH 142A,A02,083220,Chow; Bennett,10,0,32,22
1656976614652,MATH 142A,A03,093480,Chow; Bennett,7,0,32,25
1656976614652,MATH 142A,B03,093481,Chow; Bennett,7,0,32,25
1656976614652,MATH 142A,B04,093558,Chow; Bennett,11,0,32,21
1656976614652,MATH 142A,B05,093559,Chow; Bennett,6,0,32,26
1656976620677,MATH 193A,A01,083224,Rotar; Vladimir,7,0,34,27
1656976620677,MATH 193A,A02,083225,Rotar; Vladimir,4,0,34,30
1656976620677,MATH 193A,A03,083781,Rotar; Vladimir,1,0,34,33
1656976620677,MATH 193A,A04,083782,Rotar; Vladimir,6,0,34,28
1656976620677,MATH 193A,A05,093482,Rotar; Vladimir,6,0,34,28
1656976626718,MATH 197,001,091859,McAuley; Julian John,9999,0,9999,0
1656976626718,MATH 197,002,095566,Kedlaya; Kiran S.,9997,0,9999,2
1656976626718,MATH 197,003,095567,Xiao; Ming,9999,0,9999,0
1656976626718,MATH 197,004,095571,Perols; Johan Lars,9998,0,9999,1
1656976633772,COGS 9,A01,083615,Shannon; Kyle Michael,7,0,75,68
1656976639796,COGS 11,A01,083617,Boyle; Mary E. T.,20,0,48,28
1656976645819,COGS 13,A01,083071,Bastos; Amalia Pinkusfeld,9,0,71,62
1656976651846,COGS 14A,A01,092681,Semenuks; Arturs,0,1,100,100
1656976657868,COGS 14B,A01,083073,Cheng; Tzu-Han,5,0,63,58
1656976663890,COGS 17,A01,092677,Semenuks; Arturs,4,0,81,77
1656976669916,COGS 100,A01,083619,Allen; Michael Gordon,15,0,70,55
1656976675946,COGS 101A,A01,083621,Davis; Joshua Daniel,9,0,68,59
1656976681972,COGS 101B,A01,091572,Allen; Michael Gordon,8,0,65,57
1656976688000,COGS 101C,A01,083625,Delgado; Tania,17,0,35,18
1656976694025,COGS 107A,A01,083627,Boyle; Mary E. T.,13,0,60,47
1656976700050,COGS 118A,A01,083075,Gupta; Anjum,15,0,76,61
1656976706072,CSE 3,A50,083646,Miranda; Gregory Joseph,22,0,50,28
1656976712097,CSE 8A,A50,083650,Miranda; Gregory Joseph,17,1,56,39
1656976718121,CSE 11,A01,083080,Cao; Yingjun,4,15,40,36
1656976724148,CSE 12,A01,083652,Krause-Levy; Sophia Louisa,20,1,120,100
1656976730172,CSE 15L,A01,083654,Morris; Justin Loren,8,0,50,42
1656976730172,CSE 15L,A02,083655,Morris; Justin Loren,8,0,50,42
1656976736200,CSE 20,A01,083657,Tran; Khoa Dang,37,0,80,43
1656976742223,CSE 21,A01,095574,Bach; Quang Tran,21,0,48,27
1656976748246,CSE 30,A01,083084,Eldon; John,4,0,80,76
1656976748246,CSE 30,B01,095061,Bhaskar; Nishant,6,0,50,44
1656976754270,CSE 100,A01,083659,Cao; Yingjun,3,4,70,67
1656976760293,CSE 134B,A01,083661,Powell; Thomas Allan,19,0,100,81
1656976766317,CSE 140,A01,083663,Gungor; Onat,14,0,85,71
1656976772436,CSE 140L,A01,083088,Eldon; John,16,0,100,84
1656976778461,CSE 175,A01,083665,Kumar; Rakesh,3,0,25,22
1656976784485,CSE 190,A00,092507,Dubnov; Shlomo,7,0,20,13
1656976790509,ECE 45,A01,083139,Congero; Spencer William,5,0,75,70
1656976796532,ECE 65,A50,083695,Saad; Andrew S,12,0,30,18
1656976796532,ECE 65,A51,095125,Saad; Andrew S,25,0,26,1
1656976802554,ECE 109,A01,091882,Touri; Behrouz,16,0,70,54
1656976808576,ECE 180,A00,083140,Abi Samra; Nicholas Camill,1,0,30,29
1656976808576,ECE 180,B00,083141,Abi Samra; Nicholas Camill,0,0,30,30
1656976814602,MATH 10A,A01,083735,Patchell; Gregory David,1,0,30,29
1656976814602,MATH 10A,A02,083736,Patchell; Gregory David,20,0,30,10
1656976814602,MATH 10A,A03,083737,Patchell; Gregory David,15,0,30,15
1656976820630,MATH 10B,A01,083207,Lim; Seonhee,7,0,34,27
1656976820630,MATH 10B,A02,083208,Lim; Seonhee,9,0,35,26
1656976820630,MATH 10B,A03,093472,Lim; Seonhee,4,0,34,30
1656976820630,MATH 10B,B01,083739,Sinha; Shubham,9,0,30,21
1656976826672,MATH 18,A01,083743,Cinel; Cameron Alexander,6,0,30,24
1656976826672,MATH 18,A02,083744,Cinel; Cameron Alexander,15,0,30,15
1656976826672,MATH 18,A03,083745,Cinel; Cameron Alexander,8,0,30,22
1656976826672,MATH 18,B01,083748,Rideout; David Porter,4,0,37,33
1656976826672,MATH 18,B02,083749,Rideout; David Porter,3,0,36,33
1656976826672,MATH 18,B03,083750,Rideout; David Porter,2,0,37,35
1656976826672,MATH 18,B04,083751,Rideout; David Porter,5,0,36,31
1656976826672,MATH 18,B05,093473,Rideout; David Porter,4,0,36,32
1656976826672,MATH 18,B06,093474,Rideout; David Porter,5,0,36,31
1656976832696,MATH 20A,A01,083754,Zheng; Zequn,12,0,40,28
1656976838722,MATH 20B,A01,083756,Briones; Jor-el Thomas Caparas,1,0,36,35
1656976838722,MATH 20B,A02,083757,Briones; Jor-el Thomas Caparas,1,0,36,35
1656976838722,MATH 20B,A03,093475,Briones; Jor-el Thomas Caparas,0,0,36,36
1656976844745,MATH 20C,A01,083760,Briones; Jor-el Thomas Caparas,1,0,35,34
1656976844745,MATH 20C,A02,083761,Briones; Jor-el Thomas Caparas,8,0,35,27
1656976844745,MATH 20C,A03,093476,Briones; Jor-el Thomas Caparas,0,1,36,36
1656976844745,MATH 20C,B01,083762,Bach; Quang Tran,0,0,30,30
1656976850768,MATH 20D,A01,083765,Tran; Brian Kha,4,0,30,26
1656976850768,MATH 20D,A02,083766,Tran; Brian Kha,4,0,30,26
1656976850768,MATH 20D,A03,083767,Tran; Brian Kha,3,0,30,27
1656976856792,MATH 20E,A01,083771,Ganguly; Soumya,5,0,32,27
1656976856792,MATH 20E,A02,083772,Ganguly; Soumya,6,0,32,26
1656976856792,MATH 20E,B01,083773,Ciotti; Benjamin,18,0,35,17
1656976856792,MATH 20E,B02,083774,Ciotti; Benjamin,17,0,35,18
1656976862821,MATH 103A,A01,083777,Greenfeld; Be'Eri,2,0,36,34
1656976862821,MATH 103A,A02,083778,Greenfeld; Be'Eri,5,0,36,31
1656976862821,MATH 103A,A03,093561,Greenfeld; Be'Eri,4,0,36,32
1656976862821,MATH 103A,B01,083779,Greenfeld; Be'Eri,6,0,36,30
1656976862821,MATH 103A,B02,083780,Greenfeld; Be'Eri,2,0,36,34
1656976862821,MATH 103A,B03,093562,Greenfeld; Be'Eri,2,0,36,34
1656976868845,MATH 105,A01,085443,Carter; Anne Toulson,14,0,35,21
1656976868845,MATH 105,A02,093477,Carter; Anne Toulson,20,0,35,15
1656976874874,MATH 109,A01,083213,Ganzberger; Geoffrey Michael,2,0,34,32
1656976874874,MATH 109,A02,083214,Ganzberger; Geoffrey Michael,2,0,34,32
1656976874874,MATH 109,A03,093478,Ganzberger; Geoffrey Michael,1,0,34,33
1656976874874,MATH 109,B01,083215,Ganzberger; Geoffrey Michael,1,0,32,31
1656976874874,MATH 109,B02,083216,Ganzberger; Geoffrey Michael,1,0,32,31
1656976874874,MATH 109,B03,093479,Ganzberger; Geoffrey Michael,6,0,32,26
1656976880901,MATH 142A,A01,083219,Chow; Bennett,6,0,32,26
1656976880901,MATH 142A,A02,083220,Chow; Bennett,10,0,32,22
1656976880901,MATH 142A,A03,093480,Chow; Bennett,7,0,32,25
1656976880901,MATH 142A,B03,093481,Chow; Bennett,7,0,32,25
1656976880901,MATH 142A,B04,093558,Chow; Bennett,11,0,32,21
1656976880901,MATH 142A,B05,093559,Chow; Bennett,6,0,32,26
1656976886924,MATH 193A,A01,083224,Rotar; Vladimir,7,0,34,27
1656976886924,MATH 193A,A02,083225,Rotar; Vladimir,4,0,34,30
1656976886924,MATH 193A,A03,083781,Rotar; Vladimir,1,0,34,33
1656976886924,MATH 193A,A04,083782,Rotar; Vladimir,6,0,34,28
1656976886924,MATH 193A,A05,093482,Rotar; Vladimir,6,0,34,28
1656976892951,MATH 197,001,091859,McAuley; Julian John,9999,0,9999,0
1656976892951,MATH 197,002,095566,Kedlaya; Kiran S.,9997,0,9999,2
1656976892951,MATH 197,003,095567,Xiao; Ming,9999,0,9999,0
1656976892951,MATH 197,004,095571,Perols; Johan Lars,9998,0,9999,1
1656976900003,COGS 9,A01,083615,Shannon; Kyle Michael,7,0,75,68
1656976906027,COGS 11,A01,083617,Boyle; Mary E. T.,20,0,48,28
1656976912055,COGS 13,A01,083071,Bastos; Amalia Pinkusfeld,9,0,71,62
1656976918078,COGS 14A,A01,092681,Semenuks; Arturs,0,1,100,100
1656976924105,COGS 14B,A01,083073,Cheng; Tzu-Han,5,0,63,58
1656976930129,COGS 17,A01,092677,Semenuks; Arturs,4,0,81,77
1656976936151,COGS 100,A01,083619,Allen; Michael Gordon,15,0,70,55
1656976942179,COGS 101A,A01,083621,Davis; Joshua Daniel,9,0,68,59
1656976948203,COGS 101B,A01,091572,Allen; Michael Gordon,8,0,65,57
1656976954226,COGS 101C,A01,083625,Delgado; Tania,17,0,35,18
1656976960247,COGS 107A,A01,083627,Boyle; Mary E. T.,13,0,60,47
1656976966271,COGS 118A,A01,083075,Gupta; Anjum,15,0,76,61
1656976972296,CSE 3,A50,083646,Miranda; Gregory Joseph,22,0,50,28
1656976978324,CSE 8A,A50,083650,Miranda; Gregory Joseph,17,1,56,39
1656976984350,CSE 11,A01,083080,Cao; Yingjun,4,15,40,36
1656976990375,CSE 12,A01,083652,Krause-Levy; Sophia Louisa,20,1,120,100
1656976996403,CSE 15L,A01,083654,Morris; Justin Loren,8,0,50,42
1656976996403,CSE 15L,A02,083655,Morris; Justin Loren,8,0,50,42
1656977002425,CSE 20,A01,083657,Tran; Khoa Dang,37,0,80,43
1656977008452,CSE 21,A01,095574,Bach; Quang Tran,21,0,48,27
1656977014479,CSE 30,A01,083084,Eldon; John,4,0,80,76
1656977014479,CSE 30,B01,095061,Bhaskar; Nishant,6,0,50,44
1656977020502,CSE 100,A01,083659,Cao; Yingjun,3,4,70,67
1656977026525,CSE 134B,A01,083661,Powell; Thomas Allan,19,0,100,81
1656977032553,CSE 140,A01,083663,Gungor; Onat,14,0,85,71
1656977038579,CSE 140L,A01,083088,Eldon; John,16,0,100,84
1656977044601,CSE 175,A01,083665,Kumar; Rakesh,3,0,25,22
1656977050628,CSE 190,A00,092507,Dubnov; Shlomo,7,0,20,13
1656977056653,ECE 45,A01,083139,Congero; Spencer William,5,0,75,70
1656977062676,ECE 65,A50,083695,Saad; Andrew S,12,0,30,18
1656977062676,ECE 65,A51,095125,Saad; Andrew S,25,0,26,1
1656977068698,ECE 109,A01,091882,Touri; Behrouz,16,0,70,54
1656977074723,ECE 180,A00,083140,Abi Samra; Nicholas Camill,1,0,30,29
1656977074723,ECE 180,B00,083141,Abi Samra; Nicholas Camill,0,0,30,30
1656977080748,MATH 10A,A01,083735,Patchell; Gregory David,1,0,30,29
1656977080748,MATH 10A,A02,083736,Patchell; Gregory David,20,0,30,10
1656977080748,MATH 10A,A03,083737,Patchell; Gregory David,15,0,30,15
1656977086776,MATH 10B,A01,083207,Lim; Seonhee,7,0,34,27
1656977086776,MATH 10B,A02,083208,Lim; Seonhee,9,0,35,26
1656977086776,MATH 10B,A03,093472,Lim; Seonhee,4,0,34,30
1656977086776,MATH 10B,B01,083739,Sinha; Shubham,9,0,30,21
1656977092808,MATH 18,A01,083743,Cinel; Cameron Alexander,6,0,30,24
1656977092808,MATH 18,A02,083744,Cinel; Cameron Alexander,15,0,30,15
1656977092808,MATH 18,A03,083745,Cinel; Cameron Alexander,8,0,30,22
1656977092808,MATH 18,B01,083748,Rideout; David Porter,4,0,37,33
1656977092808,MATH 18,B02,083749,Rideout; David Porter,3,0,36,33
1656977092808,MATH 18,B03,083750,Rideout; David Porter,2,0,37,35
1656977092808,MATH 18,B04,083751,Rideout; David Porter,5,0,36,31
1656977092808,MATH 18,B05,093473,Rideout; David Porter,4,0,36,32
1656977092808,MATH 18,B06,093474,Rideout; David Porter,5,0,36,31
1656977098832,MATH 20A,A01,083754,Zheng; Zequn,12,0,40,28
1656977104856,MATH 20B,A01,083756,Briones; Jor-el Thomas Caparas,1,0,36,35
1656977104856,MATH 20B,A02,083757,Briones; Jor-el Thomas Caparas,1,0,36,35
1656977104856,MATH 20B,A03,093475,Briones; Jor-el Thomas Caparas,0,0,36,36
1656977110880,MATH 20C,A01,083760,Briones; Jor-el Thomas Caparas,1,0,35,34
1656977110880,MATH 20C,A02,083761,Briones; Jor-el Thomas Caparas,8,0,35,27
1656977110880,MATH 20C,A03,093476,Briones; Jor-el Thomas Caparas,0,1,36,36
1656977110880,MATH 20C,B01,083762,Bach; Quang Tran,0,0,30,30
1656977116911,MATH 20D,A01,083765,Tran; Brian Kha,4,0,30,26
1656977116911,MATH 20D,A02,083766,Tran; Brian Kha,4,0,30,26
1656977116911,MATH 20D,A03,083767,Tran; Brian Kha,3,0,30,27
1656977122936,MATH 20E,A01,083771,Ganguly; Soumya,5,0,32,27
1656977122936,MATH 20E,A02,083772,Ganguly; Soumya,6,0,32,26
1656977122936,MATH 20E,B01,083773,Ciotti; Benjamin,18,0,35,17
1656977122936,MATH 20E,B02,083774,Ciotti; Benjamin,17,0,35,18
1656977128961,MATH 103A,A01,083777,Greenfeld; Be'Eri,2,0,36,34
1656977128961,MATH 103A,A02,083778,Greenfeld; Be'Eri,5,0,36,31
1656977128961,MATH 103A,A03,093561,Greenfeld; Be'Eri,4,0,36,32
1656977128961,MATH 103A,B01,083779,Greenfeld; Be'Eri,6,0,36,30
1656977128961,MATH 103A,B02,083780,Greenfeld; Be'Eri,2,0,36,34
1656977128961,MATH 103A,B03,093562,Greenfeld; Be'Eri,2,0,36,34
1656977134982,MATH 105,A01,085443,Carter; Anne Toulson,14,0,35,21
1656977134982,MATH 105,A02,093477,Carter; Anne Toulson,20,0,35,15
1656977141020,MATH 109,A01,083213,Ganzberger; Geoffrey Michael,2,0,34,32
1656977141020,MATH 109,A02,083214,Ganzberger; Geoffrey Michael,2,0,34,32
1656977141020,MATH 109,A03,093478,Ganzberger; Geoffrey Michael,1,0,34,33
1656977141020,MATH 109,B01,083215,Ganzberger; Geoffrey Michael,1,0,32,31
1656977141020,MATH 109,B02,083216,Ganzberger; Geoffrey Michael,1,0,32,31
1656977141020,MATH 109,B03,093479,Ganzberger; Geoffrey Michael,6,0,32,26
1656977147050,MATH 142A,A01,083219,Chow; Bennett,6,0,32,26
1656977147050,MATH 142A,A02,083220,Chow; Bennett,10,0,32,22
1656977147050,MATH 142A,A03,093480,Chow; Bennett,7,0,32,25
1656977147050,MATH 142A,B03,093481,Chow; Bennett,7,0,32,25
1656977147050,MATH 142A,B04,093558,Chow; Bennett,11,0,32,21
1656977147050,MATH 142A,B05,093559,Chow; Bennett,6,0,32,26
1656977153076,MATH 193A,A01,083224,Rotar; Vladimir,7,0,34,27
1656977153076,MATH 193A,A02,083225,Rotar; Vladimir,4,0,34,30
1656977153076,MATH 193A,A03,083781,Rotar; Vladimir,1,0,34,33
1656977153076,MATH 193A,A04,083782,Rotar; Vladimir,6,0,34,28
1656977153076,MATH 193A,A05,093482,Rotar; Vladimir,6,0,34,28
1656977159099,MATH 197,001,091859,McAuley; Julian John,9999,0,9999,0
1656977159099,MATH 197,002,095566,Kedlaya; Kiran S.,9997,0,9999,2
1656977159099,MATH 197,003,095567,Xiao; Ming,9999,0,9999,0
1656977159099,MATH 197,004,095571,Perols; Johan Lars,9998,0,9999,1
1656977166153,COGS 9,A01,083615,Shannon; Kyle Michael,7,0,75,68
1656977172179,COGS 11,A01,083617,Boyle; Mary E. T.,20,0,48,28
1656977178204,COGS 13,A01,083071,Bastos; Amalia Pinkusfeld,9,0,71,62
1656977184233,COGS 14A,A01,092681,Semenuks; Arturs,0,1,100,100
1656977190256,COGS 14B,A01,083073,Cheng; Tzu-Han,5,0,63,58
1656977196292,COGS 17,A01,092677,Semenuks; Arturs,4,0,81,77
1656977202318,COGS 100,A01,083619,Allen; Michael Gordon,15,0,70,55
1656977208343,COGS 101A,A01,083621,Davis; Joshua Daniel,9,0,68,59
1656977214371,COGS 101B,A01,091572,Allen; Michael Gordon,8,0,65,57
1656977220395,COGS 101C,A01,083625,Delgado; Tania,17,0,35,18
1656977226418,COGS 107A,A01,083627,Boyle; Mary E. T.,13,0,60,47
1656977232445,COGS 118A,A01,083075,Gupta; Anjum,15,0,76,61
1656977238468,CSE 3,A50,083646,Miranda; Gregory Joseph,22,0,50,28
1656977244492,CSE 8A,A50,083650,Miranda; Gregory Joseph,17,1,56,39
1656977250515,CSE 11,A01,083080,Cao; Yingjun,4,15,40,36
1656977256541,CSE 12,A01,083652,Krause-Levy; Sophia Louisa,20,1,120,100
1656977262564,CSE 15L,A01,083654,Morris; Justin Loren,8,0,50,42
1656977262564,CSE 15L,A02,083655,Morris; Justin Loren,8,0,50,42
1656977268588,CSE 20,A01,083657,Tran; Khoa Dang,37,0,80,43
1656977274613,CSE 21,A01,095574,Bach; Quang Tran,21,0,48,27
1656977280637,CSE 30,A01,083084,Eldon; John,4,0,80,76
1656977280637,CSE 30,B01,095061,Bhaskar; Nishant,6,0,50,44
1656977286659,CSE 100,A01,083659,Cao; Yingjun,3,4,70,67
1656977292683,CSE 134B,A01,083661,Powell; Thomas Allan,19,0,100,81
1656977298706,CSE 140,A01,083663,Gungor; Onat,14,0,85,71
1656977304744,CSE 140L,A01,083088,Eldon; John,16,0,100,84
1656977310765,CSE 175,A01,083665,Kumar; Rakesh,3,0,25,22
1656977316788,CSE 190,A00,092507,Dubnov; Shlomo,7,0,20,13
1656977322810,ECE 45,A01,083139,Congero; Spencer William,5,0,75,70
1656977328832,ECE 65,A50,083695,Saad; Andrew S,12,0,30,18
1656977328832,ECE 65,A51,095125,Saad; Andrew S,25,0,26,1
1656977334858,ECE 109,A01,091882,Touri; Behrouz,16,0,70,54
1656977340885,ECE 180,A00,083140,Abi Samra; Nicholas Camill,1,0,30,29
1656977340885,ECE 180,B00,083141,Abi Samra; Nicholas Camill,0,0,30,30
1656977346915,MATH 10A,A01,083735,Patchell; Gregory David,1,0,30,29
1656977346915,MATH 10A,A02,083736,Patchell; Gregory David,20,0,30,10
1656977346915,MATH 10A,A03,083737,Patchell; Gregory David,15,0,30,15
1656977352940,MATH 10B,A01,083207,Lim; Seonhee,7,0,34,27
1656977352940,MATH 10B,A02,083208,Lim; Seonhee,9,0,35,26
1656977352940,MATH 10B,A03,093472,Lim; Seonhee,4,0,34,30
1656977352940,MATH 10B,B01,083739,Sinha; Shubham,9,0,30,21
1656977358968,MATH 18,A01,083743,Cinel; Cameron Alexander,6,0,30,24
1656977358968,MATH 18,A02,083744,Cinel; Cameron Alexander,15,0,30,15
1656977358968,MATH 18,A03,083745,Cinel; Cameron Alexander,8,0,30,22
1656977358968,MATH 18,B01,083748,Rideout; David Porter,4,0,37,33
1656977358968,MATH 18,B02,083749,Rideout; David Porter,3,0,36,33
1656977358968,MATH 18,B03,083750,Rideout; David Porter,2,0,37,35
1656977358968,MATH 18,B04,083751,Rideout; David Porter,5,0,36,31
1656977358968,MATH 18,B05,093473,Rideout; David Porter,4,0,36,32
1656977358968,MATH 18,B06,093474,Rideout; David Porter,5,0,36,31
1656977364991,MATH 20A,A01,083754,Zheng; Zequn,12,0,40,28
1656977371088,MATH 20B,A01,083756,Briones; Jor-el Thomas Caparas,1,0,36,35
1656977371088,MATH 20B,A02,083757,Briones; Jor-el Thomas Caparas,1,0,36,35
1656977371088,MATH 20B,A03,093475,Briones; Jor-el Thomas Caparas,0,0,36,36
1656977377118,MATH 20C,A01,083760,Briones; Jor-el Thomas Caparas,1,0,35,34
1656977377118,MATH 20C,A02,083761,Briones; Jor-el Thomas Caparas,8,0,35,27
1656977377118,MATH 20C,A03,093476,Briones; Jor-el Thomas Caparas,0,1,36,36
1656977377118,MATH 20C,B01,083762,Bach; Quang Tran,0,0,30,30
1656977383141,MATH 20D,A01,083765,Tran; Brian Kha,4,0,30,26
1656977383141,MATH 20D,A02,083766,Tran; Brian Kha,4,0,30,26
1656977383141,MATH 20D,A03,083767,Tran; Brian Kha,3,0,30,27
1656977389183,MATH 20E,A01,083771,Ganguly; Soumya,5,0,32,27
1656977389183,MATH 20E,A02,083772,Ganguly; Soumya,6,0,32,26
1656977389183,MATH 20E,B01,083773,Ciotti; Benjamin,18,0,35,17
1656977389183,MATH 20E,B02,083774,Ciotti; Benjamin,17,0,35,18
1656977395206,MATH 103A,A01,083777,Greenfeld; Be'Eri,2,0,36,34
1656977395206,MATH 103A,A02,083778,Greenfeld; Be'Eri,5,0,36,31
1656977395206,MATH 103A,A03,093561,Greenfeld; Be'Eri,4,0,36,32
1656977395206,MATH 103A,B01,083779,Greenfeld; Be'Eri,6,0,36,30
1656977395206,MATH 103A,B02,083780,Greenfeld; Be'Eri,2,0,36,34
1656977395206,MATH 103A,B03,093562,Greenfeld; Be'Eri,2,0,36,34
1656977401233,MATH 105,A01,085443,Carter; Anne Toulson,14,0,35,21
1656977401233,MATH 105,A02,093477,Carter; Anne Toulson,20,0,35,15
1656977407262,MATH 109,A01,083213,Ganzberger; Geoffrey Michael,2,0,34,32
1656977407262,MATH 109,A02,083214,Ganzberger; Geoffrey Michael,2,0,34,32
1656977407262,MATH 109,A03,093478,Ganzberger; Geoffrey Michael,1,0,34,33
1656977407262,MATH 109,B01,083215,Ganzberger; Geoffrey Michael,1,0,32,31
1656977407262,MATH 109,B02,083216,Ganzberger; Geoffrey Michael,1,0,32,31
1656977407262,MATH 109,B03,093479,Ganzberger; Geoffrey Michael,6,0,32,26
1656977413284,MATH 142A,A01,083219,Chow; Bennett,6,0,32,26
1656977413284,MATH 142A,A02,083220,Chow; Bennett,10,0,32,22
1656977413284,MATH 142A,A03,093480,Chow; Bennett,7,0,32,25
1656977413284,MATH 142A,B03,093481,Chow; Bennett,7,0,32,25
1656977413284,MATH 142A,B04,093558,Chow; Bennett,11,0,32,21
1656977413284,MATH 142A,B05,093559,Chow; Bennett,6,0,32,26
1656977419311,MATH 193A,A01,083224,Rotar; Vladimir,7,0,34,27
1656977419311,MATH 193A,A02,083225,Rotar; Vladimir,4,0,34,30
1656977419311,MATH 193A,A03,083781,Rotar; Vladimir,1,0,34,33
1656977419311,MATH 193A,A04,083782,Rotar; Vladimir,6,0,34,28
1656977419311,MATH 193A,A05,093482,Rotar; Vladimir,6,0,34,28
1656977425337,MATH 197,001,091859,McAuley; Julian John,9999,0,9999,0
1656977425337,MATH 197,002,095566,Kedlaya; Kiran S.,9997,0,9999,2
1656977425337,MATH 197,003,095567,Xiao; Ming,9999,0,9999,0
1656977425337,MATH 197,004,095571,Perols; Johan Lars,9998,0,9999,1
1656977432404,COGS 9,A01,083615,Shannon; Kyle Michael,7,0,75,68
1656977438429,COGS 11,A01,083617,Boyle; Mary E. T.,20,0,48,28
1656977444455,COGS 13,A01,083071,Bastos; Amalia Pinkusfeld,9,0,71,62
1656977450486,COGS 14A,A01,092681,Semenuks; Arturs,0,1,100,100
1656977456509,COGS 14B,A01,083073,Cheng; Tzu-Han,5,0,63,58
1656977462533,COGS 17,A01,092677,Semenuks; Arturs,4,0,81,77
1656977468562,COGS 100,A01,083619,Allen; Michael Gordon,15,0,70,55
1656977474585,COGS 101A,A01,083621,Davis; Joshua Daniel,9,0,68,59
1656977480607,COGS 101B,A01,091572,Allen; Michael Gordon,8,0,65,57
1656977486630,COGS 101C,A01,083625,Delgado; Tania,17,0,35,18
1656977492663,COGS 107A,A01,083627,Boyle; Mary E. T.,13,0,60,47
1656977498685,COGS 118A,A01,083075,Gupta; Anjum,15,0,76,61
1656977504710,CSE 3,A50,083646,Miranda; Gregory Joseph,22,0,50,28
1656977510732,CSE 8A,A50,083650,Miranda; Gregory Joseph,17,1,56,39
1656977516771,CSE 11,A01,083080,Cao; Yingjun,4,15,40,36
1656977522794,CSE 12,A01,083652,Krause-Levy; Sophia Louisa,20,1,120,100
1656977528822,CSE 15L,A01,083654,Morris; Justin Loren,8,0,50,42
1656977528822,CSE 15L,A02,083655,Morris; Justin Loren,8,0,50,42
1656977534846,CSE 20,A01,083657,Tran; Khoa Dang,37,0,80,43
1656977540881,CSE 21,A01,095574,Bach; Quang Tran,21,0,48,27
1656977546903,CSE 30,A01,083084,Eldon; John,4,0,80,76
1656977546903,CSE 30,B01,095061,Bhaskar; Nishant,6,0,50,44
1656977552927,CSE 100,A01,083659,Cao; Yingjun,3,4,70,67
1656977558951,CSE 134B,A01,083661,Powell; Thomas Allan,19,0,100,81
1656977564974,CSE 140,A01,083663,Gungor; Onat,14,0,85,71
1656977570998,CSE 140L,A01,083088,Eldon; John,16,0,100,84
1656977577020,CSE 175,A01,083665,Kumar; Rakesh,3,0,25,22
1656977583042,CSE 190,A00,092507,Dubnov; Shlomo,7,0,20,13
1656977589066,ECE 45,A01,083139,Congero; Spencer William,5,0,75,70
1656977595093,ECE 65,A50,083695,Saad; Andrew S,12,0,30,18
1656977595093,ECE 65,A51,095125,Saad; Andrew S,25,0,26,1
1656977601120,ECE 109,A01,091882,Touri; Behrouz,16,0,70,54
1656977607144,ECE 180,A00,083140,Abi Samra; Nicholas Camill,1,0,30,29
1656977607144,ECE 180,B00,083141,Abi Samra; Nicholas Camill,0,0,30,30
1656977613172,MATH 10A,A01,083735,Patchell; Gregory David,1,0,30,29
1656977613172,MATH 10A,A02,083736,Patchell; Gregory David,20,0,30,10
1656977613172,MATH 10A,A03,083737,Patchell; Gregory David,15,0,30,15
1656977619198,MATH 10B,A01,083207,Lim; Seonhee,7,0,34,27
1656977619198,MATH 10B,A02,083208,Lim; Seonhee,9,0,35,26
1656977619198,MATH 10B,A03,093472,Lim; Seonhee,4,0,34,30
1656977619198,MATH 10B,B01,083739,Sinha; Shubham,9,0,30,21
1656977625220,MATH 18,A01,083743,Cinel; Cameron Alexander,6,0,30,24
1656977625220,MATH 18,A02,083744,Cinel; Cameron Alexander,15,0,30,15
1656977625220,MATH 18,A03,083745,Cinel; Cameron Alexander,8,0,30,22
1656977625220,MATH 18,B01,083748,Rideout; David Porter,4,0,37,33
1656977625220,MATH 18,B02,083749,Rideout; David Porter,3,0,36,33
1656977625220,MATH 18,B03,083750,Rideout; David Porter,2,0,37,35
1656977625220,MATH 18,B04,083751,Rideout; David Porter,5,0,36,31
1656977625220,MATH 18,B05,093473,Rideout; David Porter,4,0,36,32
1656977625220,MATH 18,B06,093474,Rideout; David Porter,5,0,36,31
1656977631242,MATH 20A,A01,083754,Zheng; Zequn,12,0,40,28
1656977637267,MATH 20B,A01,083756,Briones; Jor-el Thomas Caparas,1,0,36,35
1656977637267,MATH 20B,A02,083757,Briones; Jor-el Thomas Caparas,1,0,36,35
1656977637267,MATH 20B,A03,093475,Briones; Jor-el Thomas Caparas,0,0,36,36
1656977643296,MATH 20C,A01,083760,Briones; Jor-el Thomas Caparas,1,0,35,34
1656977643296,MATH 20C,A02,083761,Briones; Jor-el Thomas Caparas,8,0,35,27
1656977643296,MATH 20C,A03,093476,Briones; Jor-el Thomas Caparas,0,1,36,36
1656977643296,MATH 20C,B01,083762,Bach; Quang Tran,0,0,30,30
1656977649335,MATH 20D,A01,083765,Tran; Brian Kha,4,0,30,26
1656977649335,MATH 20D,A02,083766,Tran; Brian Kha,4,0,30,26
1656977649335,MATH 20D,A03,083767,Tran; Brian Kha,3,0,30,27
1656977655361,MATH 20E,A01,083771,Ganguly; Soumya,5,0,32,27
1656977655361,MATH 20E,A02,083772,Ganguly; Soumya,6,0,32,26
1656977655361,MATH 20E,B01,083773,Ciotti; Benjamin,18,0,35,17
1656977655361,MATH 20E,B02,083774,Ciotti; Benjamin,17,0,35,18
1656977661390,MATH 103A,A01,083777,Greenfeld; Be'Eri,2,0,36,34
1656977661390,MATH 103A,A02,083778,Greenfeld; Be'Eri,5,0,36,31
1656977661390,MATH 103A,A03,093561,Greenfeld; Be'Eri,4,0,36,32
1656977661390,MATH 103A,B01,083779,Greenfeld; Be'Eri,6,0,36,30
1656977661390,MATH 103A,B02,083780,Greenfeld; Be'Eri,2,0,36,34
1656977661390,MATH 103A,B03,093562,Greenfeld; Be'Eri,2,0,36,34
1656977667414,MATH 105,A01,085443,Carter; Anne Toulson,14,0,35,21
1656977667414,MATH 105,A02,093477,Carter; Anne Toulson,20,0,35,15
1656977673437,MATH 109,A01,083213,Ganzberger; Geoffrey Michael,2,0,34,32
1656977673437,MATH 109,A02,083214,Ganzberger; Geoffrey Michael,2,0,34,32
1656977673437,MATH 109,A03,093478,Ganzberger; Geoffrey Michael,1,0,34,33
1656977673437,MATH 109,B01,083215,Ganzberger; Geoffrey Michael,1,0,32,31
1656977673437,MATH 109,B02,083216,Ganzberger; Geoffrey Michael,1,0,32,31
1656977673437,MATH 109,B03,093479,Ganzberger; Geoffrey Michael,6,0,32,26
1656977679465,MATH 142A,A01,083219,Chow; Bennett,6,0,32,26
1656977679465,MATH 142A,A02,083220,Chow; Bennett,10,0,32,22
1656977679465,MATH 142A,A03,093480,Chow; Bennett,7,0,32,25
1656977679465,MATH 142A,B03,093481,Chow; Bennett,7,0,32,25
1656977679465,MATH 142A,B04,093558,Chow; Bennett,11,0,32,21
1656977679465,MATH 142A,B05,093559,Chow; Bennett,6,0,32,26
1656977685493,MATH 193A,A01,083224,Rotar; Vladimir,7,0,34,27
1656977685493,MATH 193A,A02,083225,Rotar; Vladimir,4,0,34,30
1656977685493,MATH 193A,A03,083781,Rotar; Vladimir,1,0,34,33
1656977685493,MATH 193A,A04,083782,Rotar; Vladimir,6,0,34,28
1656977685493,MATH 193A,A05,093482,Rotar; Vladimir,6,0,34,28
1656977691516,MATH 197,001,091859,McAuley; Julian John,9999,0,9999,0
1656977691516,MATH 197,002,095566,Kedlaya; Kiran S.,9997,0,9999,2
1656977691516,MATH 197,003,095567,Xiao; Ming,9999,0,9999,0
1656977691516,MATH 197,004,095571,Perols; Johan Lars,9998,0,9999,1
1656977698570,COGS 9,A01,083615,Shannon; Kyle Michael,7,0,75,68
1656977704596,COGS 11,A01,083617,Boyle; Mary E. T.,20,0,48,28
1656977710619,COGS 13,A01,083071,Bastos; Amalia Pinkusfeld,9,0,71,62
1656977716647,COGS 14A,A01,092681,Semenuks; Arturs,0,1,100,100
1656977722671,COGS 14B,A01,083073,Cheng; Tzu-Han,5,0,63,58
1656977728698,COGS 17,A01,092677,Semenuks; Arturs,4,0,81,77
1656977734721,COGS 100,A01,083619,Allen; Michael Gordon,15,0,70,55
1656977740748,COGS 101A,A01,083621,Davis; Joshua Daniel,9,0,68,59
1656977746769,COGS 101B,A01,091572,Allen; Michael Gordon,8,0,65,57
1656977752792,COGS 101C,A01,083625,Delgado; Tania,17,0,35,18
1656977758818,COGS 107A,A01,083627,Boyle; Mary E. T.,13,0,60,47
1656977764845,COGS 118A,A01,083075,Gupta; Anjum,15,0,76,61
1656977770872,CSE 3,A50,083646,Miranda; Gregory Joseph,22,0,50,28
1656977776894,CSE 8A,A50,083650,Miranda; Gregory Joseph,17,1,56,39
1656977782921,CSE 11,A01,083080,Cao; Yingjun,4,15,40,36
1656977788953,CSE 12,A01,083652,Krause-Levy; Sophia Louisa,20,1,120,100
1656977794979,CSE 15L,A01,083654,Morris; Justin Loren,8,0,50,42
1656977794979,CSE 15L,A02,083655,Morris; Justin Loren,8,0,50,42
1656977801004,CSE 20,A01,083657,Tran; Khoa Dang,37,0,80,43
1656977807028,CSE 21,A01,095574,Bach; Quang Tran,21,0,48,27
1656977813055,CSE 30,A01,083084,Eldon; John,4,0,80,76
1656977813055,CSE 30,B01,095061,Bhaskar; Nishant,6,0,50,44
1656977819082,CSE 100,A01,083659,Cao; Yingjun,3,4,70,67
1656977825109,CSE 134B,A01,083661,Powell; Thomas Allan,19,0,100,81
1656977831136,CSE 140,A01,083663,Gungor; Onat,14,0,85,71
1656977837162,CSE 140L,A01,083088,Eldon; John,16,0,100,84
1656977843184,CSE 175,A01,083665,Kumar; Rakesh,3,0,25,22
1656977849216,CSE 190,A00,092507,Dubnov; Shlomo,7,0,20,13
1656977855240,ECE 45,A01,083139,Congero; Spencer William,5,0,75,70
1656977861267,ECE 65,A50,083695,Saad; Andrew S,12,0,30,18
1656977861267,ECE 65,A51,095125,Saad; Andrew S,25,0,26,1
1656977867295,ECE 109,A01,091882,Touri; Behrouz,16,0,70,54
1656977873318,ECE 180,A00,083140,Abi Samra; Nicholas Camill,1,0,30,29
1656977873318,ECE 180,B00,083141,Abi Samra; Nicholas Camill,0,0,30,30
1656977879341,MATH 10A,A01,083735,Patchell; Gregory David,1,0,30,29
1656977879341,MATH 10A,A02,083736,Patchell; Gregory David,20,0,30,10
1656977879341,MATH 10A,A03,083737,Patchell; Gregory David,15,0,30,15
1656977885365,MATH 10B,A01,083207,Lim; Seonhee,7,0,34,27
1656977885365,MATH 10B,A02,083208,Lim; Seonhee,9,0,35,26
1656977885365,MATH 10B,A03,093472,Lim; Seonhee,4,0,34,30
1656977885365,MATH 10B,B01,083739,Sinha; Shubham,9,0,30,21
1656977891388,MATH 18,A01,083743,Cinel; Cameron Alexander,6,0,30,24
1656977891388,MATH 18,A02,083744,Cinel; Cameron Alexander,15,0,30,15
1656977891388,MATH 18,A03,083745,Cinel; Cameron Alexander,8,0,30,22
1656977891388,MATH 18,B01,083748,Rideout; David Porter,4,0,37,33
1656977891388,MATH 18,B02,083749,Rideout; David Porter,3,0,36,33
1656977891388,MATH 18,B03,083750,Rideout; David Porter,2,0,37,35
1656977891388,MATH 18,B04,083751,Rideout; David Porter,5,0,36,31
1656977891388,MATH 18,B05,093473,Rideout; David Porter,4,0,36,32
1656977891388,MATH 18,B06,093474,Rideout; David Porter,5,0,36,31
1656977897415,MATH 20A,A01,083754,Zheng; Zequn,12,0,40,28
1656977903441,MATH 20B,A01,083756,Briones; Jor-el Thomas Caparas,1,0,36,35
1656977903441,MATH 20B,A02,083757,Briones; Jor-el Thomas Caparas,1,0,36,35
1656977903441,MATH 20B,A03,093475,Briones; Jor-el Thomas Caparas,0,0,36,36
1656977909468,MATH 20C,A01,083760,Briones; Jor-el Thomas Caparas,1,0,35,34
1656977909468,MATH 20C,A02,083761,Briones; Jor-el Thomas Caparas,8,0,35,27
1656977909468,MATH 20C,A03,093476,Briones; Jor-el Thomas Caparas,0,1,36,36
1656977909468,MATH 20C,B01,083762,Bach; Quang Tran,0,0,30,30
1656977915498,MATH 20D,A01,083765,Tran; Brian Kha,4,0,30,26
1656977915498,MATH 20D,A02,083766,Tran; Brian Kha,4,0,30,26
1656977915498,MATH 20D,A03,083767,Tran; Brian Kha,3,0,30,27
1656977921521,MATH 20E,A01,083771,Ganguly; Soumya,5,0,32,27
1656977921521,MATH 20E,A02,083772,Ganguly; Soumya,6,0,32,26
1656977921521,MATH 20E,B01,083773,Ciotti; Benjamin,18,0,35,17
1656977921521,MATH 20E,B02,083774,Ciotti; Benjamin,17,0,35,18
1656977927550,MATH 103A,A01,083777,Greenfeld; Be'Eri,2,0,36,34
1656977927550,MATH 103A,A02,083778,Greenfeld; Be'Eri,5,0,36,31
1656977927550,MATH 103A,A03,093561,Greenfeld; Be'Eri,4,0,36,32
1656977927550,MATH 103A,B01,083779,Greenfeld; Be'Eri,6,0,36,30
1656977927550,MATH 103A,B02,083780,Greenfeld; Be'Eri,2,0,36,34
1656977927550,MATH 103A,B03,093562,Greenfeld; Be'Eri,2,0,36,34
1656977933573,MATH 105,A01,085443,Carter; Anne Toulson,14,0,35,21
1656977933573,MATH 105,A02,093477,Carter; Anne Toulson,20,0,35,15
1656977939601,MATH 109,A01,083213,Ganzberger; Geoffrey Michael,2,0,34,32
1656977939601,MATH 109,A02,083214,Ganzberger; Geoffrey Michael,2,0,34,32
1656977939601,MATH 109,A03,093478,Ganzberger; Geoffrey Michael,1,0,34,33
1656977939601,MATH 109,B01,083215,Ganzberger; Geoffrey Michael,1,0,32,31
1656977939601,MATH 109,B02,083216,Ganzberger; Geoffrey Michael,1,0,32,31
1656977939601,MATH 109,B03,093479,Ganzberger; Geoffrey Michael,6,0,32,26
1656977945626,MATH 142A,A01,083219,Chow; Bennett,6,0,32,26
1656977945626,MATH 142A,A02,083220,Chow; Bennett,10,0,32,22
1656977945626,MATH 142A,A03,093480,Chow; Bennett,7,0,32,25
1656977945626,MATH 142A,B03,093481,Chow; Bennett,7,0,32,25
1656977945626,MATH 142A,B04,093558,Chow; Bennett,11,0,32,21
1656977945626,MATH 142A,B05,093559,Chow; Bennett,6,0,32,26
1656977951649,MATH 193A,A01,083224,Rotar; Vladimir,7,0,34,27
1656977951649,MATH 193A,A02,083225,Rotar; Vladimir,4,0,34,30
1656977951649,MATH 193A,A03,083781,Rotar; Vladimir,1,0,34,33
1656977951649,MATH 193A,A04,083782,Rotar; Vladimir,6,0,34,28
1656977951649,MATH 193A,A05,093482,Rotar; Vladimir,6,0,34,28
1656977957672,MATH 197,001,091859,McAuley; Julian John,9999,0,9999,0
1656977957672,MATH 197,002,095566,Kedlaya; Kiran S.,9997,0,9999,2
1656977957672,MATH 197,003,095567,Xiao; Ming,9999,0,9999,0
1656977957672,MATH 197,004,095571,Perols; Johan Lars,9998,0,9999,1
1656977964800,COGS 9,A01,083615,Shannon; Kyle Michael,7,0,75,68
1656977970827,COGS 11,A01,083617,Boyle; Mary E. T.,20,0,48,28
1656977976850,COGS 13,A01,083071,Bastos; Amalia Pinkusfeld,9,0,71,62
1656977982875,COGS 14A,A01,092681,Semenuks; Arturs,0,1,100,100
1656977988901,COGS 14B,A01,083073,Cheng; Tzu-Han,5,0,63,58
1656977994927,COGS 17,A01,092677,Semenuks; Arturs,4,0,81,77
1656978000960,COGS 100,A01,083619,Allen; Michael Gordon,15,0,70,55
1656978006983,COGS 101A,A01,083621,Davis; Joshua Daniel,9,0,68,59
1656978013007,COGS 101B,A01,091572,Allen; Michael Gordon,8,0,65,57
1656978019030,COGS 101C,A01,083625,Delgado; Tania,17,0,35,18
1656978025053,COGS 107A,A01,083627,Boyle; Mary E. T.,13,0,60,47
1656978031080,COGS 118A,A01,083075,Gupta; Anjum,15,0,76,61
1656978037108,CSE 3,A50,083646,Miranda; Gregory Joseph,22,0,50,28
1656978043131,CSE 8A,A50,083650,Miranda; Gregory Joseph,17,1,56,39
1656978049156,CSE 11,A01,083080,Cao; Yingjun,4,15,40,36
1656978055180,CSE 12,A01,083652,Krause-Levy; Sophia Louisa,20,1,120,100
1656978061207,CSE 15L,A01,083654,Morris; Justin Loren,8,0,50,42
1656978061207,CSE 15L,A02,083655,Morris; Justin Loren,8,0,50,42
1656978067232,CSE 20,A01,083657,Tran; Khoa Dang,37,0,80,43
1656978073255,CSE 21,A01,095574,Bach; Quang Tran,21,0,48,27
1656978079278,CSE 30,A01,083084,Eldon; John,4,0,80,76
1656978079278,CSE 30,B01,095061,Bhaskar; Nishant,6,0,50,44
1656978085301,CSE 100,A01,083659,Cao; Yingjun,3,4,70,67
1656978091324,CSE 134B,A01,083661,Powell; Thomas Allan,19,0,100,81
1656978097350,CSE 140,A01,083663,Gungor; Onat,14,0,85,71
1656978103373,CSE 140L,A01,083088,Eldon; John,16,0,100,84
1656978109398,CSE 175,A01,083665,Kumar; Rakesh,3,0,25,22
1656978115422,CSE 190,A00,092507,Dubnov; Shlomo,7,0,20,13
1656978121446,ECE 45,A01,083139,Congero; Spencer William,5,0,75,70
1656978127473,ECE 65,A50,083695,Saad; Andrew S,12,0,30,18
1656978127473,ECE 65,A51,095125,Saad; Andrew S,25,0,26,1
1656978133496,ECE 109,A01,091882,Touri; Behrouz,16,0,70,54
1656978139524,ECE 180,A00,083140,Abi Samra; Nicholas Camill,1,0,30,29
1656978139524,ECE 180,B00,083141,Abi Samra; Nicholas Camill,0,0,30,30
1656978145551,MATH 10A,A01,083735,Patchell; Gregory David,1,0,30,29
1656978145551,MATH 10A,A02,083736,Patchell; Gregory David,20,0,30,10
1656978145551,MATH 10A,A03,083737,Patchell; Gregory David,15,0,30,15
1656978151582,MATH 10B,A01,083207,Lim; Seonhee,7,0,34,27
1656978151582,MATH 10B,A02,083208,Lim; Seonhee,9,0,35,26
1656978151582,MATH 10B,A03,093472,Lim; Seonhee,4,0,34,30
1656978151582,MATH 10B,B01,083739,Sinha; Shubham,9,0,30,21
1656978157611,MATH 18,A01,083743,Cinel; Cameron Alexander,6,0,30,24
1656978157611,MATH 18,A02,083744,Cinel; Cameron Alexander,15,0,30,15
1656978157611,MATH 18,A03,083745,Cinel; Cameron Alexander,8,0,30,22
1656978157611,MATH 18,B01,083748,Rideout; David Porter,4,0,37,33
1656978157611,MATH 18,B02,083749,Rideout; David Porter,3,0,36,33
1656978157611,MATH 18,B03,083750,Rideout; David Porter,2,0,37,35
1656978157611,MATH 18,B04,083751,Rideout; David Porter,5,0,36,31
1656978157611,MATH 18,B05,093473,Rideout; David Porter,4,0,36,32
1656978157611,MATH 18,B06,093474,Rideout; David Porter,5,0,36,31
1656978163637,MATH 20A,A01,083754,Zheng; Zequn,12,0,40,28
1656978169658,MATH 20B,A01,083756,Briones; Jor-el Thomas Caparas,1,0,36,35
1656978169658,MATH 20B,A02,083757,Briones; Jor-el Thomas Caparas,1,0,36,35
1656978169658,MATH 20B,A03,093475,Briones; Jor-el Thomas Caparas,0,0,36,36
1656978175684,MATH 20C,A01,083760,Briones; Jor-el Thomas Caparas,1,0,35,34
1656978175684,MATH 20C,A02,083761,Briones; Jor-el Thomas Caparas,8,0,35,27
1656978175684,MATH 20C,A03,093476,Briones; Jor-el Thomas Caparas,0,1,36,36
1656978175684,MATH 20C,B01,083762,Bach; Quang Tran,0,0,30,30
1656978181721,MATH 20D,A01,083765,Tran; Brian Kha,4,0,30,26
1656978181721,MATH 20D,A02,083766,Tran; Brian Kha,4,0,30,26
1656978181721,MATH 20D,A03,083767,Tran; Brian Kha,3,0,30,27
1656978187742,MATH 20E,A01,083771,Ganguly; Soumya,5,0,32,27
1656978187742,MATH 20E,A02,083772,Ganguly; Soumya,6,0,32,26
1656978187742,MATH 20E,B01,083773,Ciotti; Benjamin,18,0,35,17
1656978187742,MATH 20E,B02,083774,Ciotti; Benjamin,17,0,35,18
1656978193771,MATH 103A,A01,083777,Greenfeld; Be'Eri,2,0,36,34
1656978193771,MATH 103A,A02,083778,Greenfeld; Be'Eri,5,0,36,31
1656978193771,MATH 103A,A03,093561,Greenfeld; Be'Eri,4,0,36,32
1656978193771,MATH 103A,B01,083779,Greenfeld; Be'Eri,6,0,36,30
1656978193771,MATH 103A,B02,083780,Greenfeld; Be'Eri,2,0,36,34
1656978193771,MATH 103A,B03,093562,Greenfeld; Be'Eri,2,0,36,34
1656978199792,MATH 105,A01,085443,Carter; Anne Toulson,14,0,35,21
1656978199792,MATH 105,A02,093477,Carter; Anne Toulson,20,0,35,15
1656978205815,MATH 109,A01,083213,Ganzberger; Geoffrey Michael,2,0,34,32
1656978205815,MATH 109,A02,083214,Ganzberger; Geoffrey Michael,2,0,34,32
1656978205815,MATH 109,A03,093478,Ganzberger; Geoffrey Michael,1,0,34,33
1656978205815,MATH 109,B01,083215,Ganzberger; Geoffrey Michael,1,0,32,31
1656978205815,MATH 109,B02,083216,Ganzberger; Geoffrey Michael,1,0,32,31
1656978205815,MATH 109,B03,093479,Ganzberger; Geoffrey Michael,6,0,32,26
1656978211851,MATH 142A,A01,083219,Chow; Bennett,6,0,32,26
1656978211851,MATH 142A,A02,083220,Chow; Bennett,10,0,32,22
1656978211851,MATH 142A,A03,093480,Chow; Bennett,7,0,32,25
1656978211851,MATH 142A,B03,093481,Chow; Bennett,7,0,32,25
1656978211851,MATH 142A,B04,093558,Chow; Bennett,11,0,32,21
1656978211851,MATH 142A,B05,093559,Chow; Bennett,6,0,32,26
1656978217878,MATH 193A,A01,083224,Rotar; Vladimir,7,0,34,27
1656978217878,MATH 193A,A02,083225,Rotar; Vladimir,4,0,34,30
1656978217878,MATH 193A,A03,083781,Rotar; Vladimir,1,0,34,33
1656978217878,MATH 193A,A04,083782,Rotar; Vladimir,6,0,34,28
1656978217878,MATH 193A,A05,093482,Rotar; Vladimir,6,0,34,28
1656978223905,MATH 197,001,091859,McAuley; Julian John,9999,0,9999,0
1656978223905,MATH 197,002,095566,Kedlaya; Kiran S.,9997,0,9999,2
1656978223905,MATH 197,003,095567,Xiao; Ming,9999,0,9999,0
1656978223905,MATH 197,004,095571,Perols; Johan Lars,9998,0,9999,1
1656978230957,COGS 9,A01,083615,Shannon; Kyle Michael,7,0,75,68
1656978236980,COGS 11,A01,083617,Boyle; Mary E. T.,20,0,48,28
1656978243002,COGS 13,A01,083071,Bastos; Amalia Pinkusfeld,9,0,71,62
1656978249024,COGS 14A,A01,092681,Semenuks; Arturs,0,1,100,100
1656978255047,COGS 14B,A01,083073,Cheng; Tzu-Han,5,0,63,58
1656978261070,COGS 17,A01,092677,Semenuks; Arturs,4,0,81,77
1656978267108,COGS 100,A01,083619,Allen; Michael Gordon,15,0,70,55
1656978273136,COGS 101A,A01,083621,Davis; Joshua Daniel,9,0,68,59
1656978279160,COGS 101B,A01,091572,Allen; Michael Gordon,8,0,65,57
1656978285185,COGS 101C,A01,083625,Delgado; Tania,17,0,35,18
1656978291211,COGS 107A,A01,083627,Boyle; Mary E. T.,13,0,60,47
1656978297240,COGS 118A,A01,083075,Gupta; Anjum,15,0,76,61
1656978303264,CSE 3,A50,083646,Miranda; Gregory Joseph,22,0,50,28
1656978309285,CSE 8A,A50,083650,Miranda; Gregory Joseph,17,1,56,39
1656978315312,CSE 11,A01,083080,Cao; Yingjun,4,15,40,36
1656978321335,CSE 12,A01,083652,Krause-Levy; Sophia Louisa,20,1,120,100
1656978327359,CSE 15L,A01,083654,Morris; Justin Loren,8,0,50,42
1656978327359,CSE 15L,A02,083655,Morris; Justin Loren,8,0,50,42
1656978333382,CSE 20,A01,083657,Tran; Khoa Dang,37,0,80,43
1656978339404,CSE 21,A01,095574,Bach; Quang Tran,21,0,48,27
1656978345428,CSE 30,A01,083084,Eldon; John,4,0,80,76
1656978345428,CSE 30,B01,095061,Bhaskar; Nishant,6,0,50,44
1656978351452,CSE 100,A01,083659,Cao; Yingjun,3,4,70,67
1656978357477,CSE 134B,A01,083661,Powell; Thomas Allan,19,0,100,81
1656978363501,CSE 140,A01,083663,Gungor; Onat,14,0,85,71
1656978369528,CSE 140L,A01,083088,Eldon; John,16,0,100,84
1656978375551,CSE 175,A01,083665,Kumar; Rakesh,3,0,25,22
1656978381574,CSE 190,A00,092507,Dubnov; Shlomo,7,0,20,13
1656978387603,ECE 45,A01,083139,Congero; Spencer William,5,0,75,70
1656978393626,ECE 65,A50,083695,Saad; Andrew S,12,0,30,18
1656978393626,ECE 65,A51,095125,Saad; Andrew S,25,0,26,1
1656978399653,ECE 109,A01,091882,Touri; Behrouz,16,0,70,54
1656978405677,ECE 180,A00,083140,Abi Samra; Nicholas Camill,1,0,30,29
1656978405677,ECE 180,B00,083141,Abi Samra; Nicholas Camill,0,0,30,30
1656978411700,MATH 10A,A01,083735,Patchell; Gregory David,1,0,30,29
1656978411700,MATH 10A,A02,083736,Patchell; Gregory David,20,0,30,10
1656978411700,MATH 10A,A03,083737,Patchell; Gregory David,15,0,30,15
1656978417725,MATH 10B,A01,083207,Lim; Seonhee,7,0,34,27
1656978417725,MATH 10B,A02,083208,Lim; Seonhee,9,0,35,26
1656978417725,MATH 10B,A03,093472,Lim; Seonhee,4,0,34,30
1656978417725,MATH 10B,B01,083739,Sinha; Shubham,9,0,30,21
1656978423751,MATH 18,A01,083743,Cinel; Cameron Alexander,6,0,30,24
1656978423751,MATH 18,A02,083744,Cinel; Cameron Alexander,15,0,30,15
1656978423751,MATH 18,A03,083745,Cinel; Cameron Alexander,8,0,30,22
1656978423751,MATH 18,B01,083748,Rideout; David Porter,4,0,37,33
1656978423751,MATH 18,B02,083749,Rideout; David Porter,3,0,36,33
1656978423751,MATH 18,B03,083750,Rideout; David Porter,2,0,37,35
1656978423751,MATH 18,B04,083751,Rideout; David Porter,5,0,36,31
1656978423751,MATH 18,B05,093473,Rideout; David Porter,4,0,36,32
1656978423751,MATH 18,B06,093474,Rideout; David Porter,5,0,36,31
1656978429775,MATH 20A,A01,083754,Zheng; Zequn,12,0,40,28
1656978435797,MATH 20B,A01,083756,Briones; Jor-el Thomas Caparas,1,0,36,35
1656978435797,MATH 20B,A02,083757,Briones; Jor-el Thomas Caparas,1,0,36,35
1656978435797,MATH 20B,A03,093475,Briones; Jor-el Thomas Caparas,0,0,36,36
1656978441820,MATH 20C,A01,083760,Briones; Jor-el Thomas Caparas,1,0,35,34
1656978441820,MATH 20C,A02,083761,Briones; Jor-el Thomas Caparas,8,0,35,27
1656978441820,MATH 20C,A03,093476,Briones; Jor-el Thomas Caparas,0,1,36,36
1656978441820,MATH 20C,B01,083762,Bach; Quang Tran,0,0,30,30
1656978447848,MATH 20D,A01,083765,Tran; Brian Kha,4,0,30,26
1656978447848,MATH 20D,A02,083766,Tran; Brian Kha,4,0,30,26
1656978447848,MATH 20D,A03,083767,Tran; Brian Kha,3,0,30,27
1656978453877,MATH 20E,A01,083771,Ganguly; Soumya,5,0,32,27
1656978453877,MATH 20E,A02,083772,Ganguly; Soumya,6,0,32,26
1656978453877,MATH 20E,B01,083773,Ciotti; Benjamin,18,0,35,17
1656978453877,MATH 20E,B02,083774,Ciotti; Benjamin,17,0,35,18
1656978459901,MATH 103A,A01,083777,Greenfeld; Be'Eri,2,0,36,34
1656978459901,MATH 103A,A02,083778,Greenfeld; Be'Eri,5,0,36,31
1656978459901,MATH 103A,A03,093561,Greenfeld; Be'Eri,4,0,36,32
1656978459901,MATH 103A,B01,083779,Greenfeld; Be'Eri,6,0,36,30
1656978459901,MATH 103A,B02,083780,Greenfeld; Be'Eri,2,0,36,34
1656978459901,MATH 103A,B03,093562,Greenfeld; Be'Eri,2,0,36,34
1656978465923,MATH 105,A01,085443,Carter; Anne Toulson,14,0,35,21
1656978465923,MATH 105,A02,093477,Carter; Anne Toulson,20,0,35,15
1656978471952,MATH 109,A01,083213,Ganzberger; Geoffrey Michael,2,0,34,32
1656978471952,MATH 109,A02,083214,Ganzberger; Geoffrey Michael,2,0,34,32
1656978471952,MATH 109,A03,093478,Ganzberger; Geoffrey Michael,1,0,34,33
1656978471952,MATH 109,B01,083215,Ganzberger; Geoffrey Michael,1,0,32,31
1656978471952,MATH 109,B02,083216,Ganzberger; Geoffrey Michael,1,0,32,31
1656978471952,MATH 109,B03,093479,Ganzberger; Geoffrey Michael,6,0,32,26
1656978477977,MATH 142A,A01,083219,Chow; Bennett,6,0,32,26
1656978477977,MATH 142A,A02,083220,Chow; Bennett,10,0,32,22
1656978477977,MATH 142A,A03,093480,Chow; Bennett,7,0,32,25
1656978477977,MATH 142A,B03,093481,Chow; Bennett,7,0,32,25
1656978477977,MATH 142A,B04,093558,Chow; Bennett,11,0,32,21
1656978477977,MATH 142A,B05,093559,Chow; Bennett,6,0,32,26
1656978484005,MATH 193A,A01,083224,Rotar; Vladimir,7,0,34,27
1656978484005,MATH 193A,A02,083225,Rotar; Vladimir,4,0,34,30
1656978484005,MATH 193A,A03,083781,Rotar; Vladimir,1,0,34,33
1656978484005,MATH 193A,A04,083782,Rotar; Vladimir,6,0,34,28
1656978484005,MATH 193A,A05,093482,Rotar; Vladimir,6,0,34,28
1656978490032,MATH 197,001,091859,McAuley; Julian John,9999,0,9999,0
1656978490032,MATH 197,002,095566,Kedlaya; Kiran S.,9997,0,9999,2
1656978490032,MATH 197,003,095567,Xiao; Ming,9999,0,9999,0
1656978490032,MATH 197,004,095571,Perols; Johan Lars,9998,0,9999,1
1656978497093,COGS 9,A01,083615,Shannon; Kyle Michael,7,0,75,68
1656978503135,COGS 11,A01,083617,Boyle; Mary E. T.,20,0,48,28
1656978509157,COGS 13,A01,083071,Bastos; Amalia Pinkusfeld,9,0,71,62
1656978515186,COGS 14A,A01,092681,Semenuks; Arturs,0,1,100,100
1656978521208,COGS 14B,A01,083073,Cheng; Tzu-Han,5,0,63,58
1656978527232,COGS 17,A01,092677,Semenuks; Arturs,4,0,81,77
1656978533260,COGS 100,A01,083619,Allen; Michael Gordon,15,0,70,55
1656978539287,COGS 101A,A01,083621,Davis; Joshua Daniel,9,0,68,59
1656978545315,COGS 101B,A01,091572,Allen; Michael Gordon,8,0,65,57
1656978551340,COGS 101C,A01,083625,Delgado; Tania,17,0,35,18
1656978557362,COGS 107A,A01,083627,Boyle; Mary E. T.,13,0,60,47
1656978563720,COGS 118A,A01,083075,Gupta; Anjum,15,0,76,61
1656978569742,CSE 3,A50,083646,Miranda; Gregory Joseph,22,0,50,28
1656978575766,CSE 8A,A50,083650,Miranda; Gregory Joseph,17,1,56,39
1656978581799,CSE 11,A01,083080,Cao; Yingjun,4,15,40,36
1656978587821,CSE 12,A01,083652,Krause-Levy; Sophia Louisa,20,1,120,100
1656978593848,CSE 15L,A01,083654,Morris; Justin Loren,8,0,50,42
1656978593848,CSE 15L,A02,083655,Morris; Justin Loren,8,0,50,42
1656978599874,CSE 20,A01,083657,Tran; Khoa Dang,37,0,80,43
1656978605900,CSE 21,A01,095574,Bach; Quang Tran,21,0,48,27
1656978611932,CSE 30,A01,083084,Eldon; John,4,0,80,76
1656978611932,CSE 30,B01,095061,Bhaskar; Nishant,6,0,50,44
1656978617954,CSE 100,A01,083659,Cao; Yingjun,3,4,70,67
1656978623979,CSE 134B,A01,083661,Powell; Thomas Allan,19,0,100,81
1656978630002,CSE 140,A01,083663,Gungor; Onat,14,0,85,71
1656978636028,CSE 140L,A01,083088,Eldon; John,16,0,100,84
1656978642051,CSE 175,A01,083665,Kumar; Rakesh,3,0,25,22
1656978648078,CSE 190,A00,092507,Dubnov; Shlomo,7,0,20,13
1656978654102,ECE 45,A01,083139,Congero; Spencer William,5,0,75,70
1656978660125,ECE 65,A50,083695,Saad; Andrew S,12,0,30,18
1656978660125,ECE 65,A51,095125,Saad; Andrew S,25,0,26,1
1656978666150,ECE 109,A01,091882,Touri; Behrouz,16,0,70,54
1656978672172,ECE 180,A00,083140,Abi Samra; Nicholas Camill,1,0,30,29
1656978672172,ECE 180,B00,083141,Abi Samra; Nicholas Camill,0,0,30,30
1656978678199,MATH 10A,A01,083735,Patchell; Gregory David,1,0,30,29
1656978678199,MATH 10A,A02,083736,Patchell; Gregory David,20,0,30,10
1656978678199,MATH 10A,A03,083737,Patchell; Gregory David,15,0,30,15
1656978684221,MATH 10B,A01,083207,Lim; Seonhee,7,0,34,27
1656978684221,MATH 10B,A02,083208,Lim; Seonhee,9,0,35,26
1656978684221,MATH 10B,A03,093472,Lim; Seonhee,4,0,34,30
1656978684221,MATH 10B,B01,083739,Sinha; Shubham,9,0,30,21
1656978690246,MATH 18,A01,083743,Cinel; Cameron Alexander,6,0,30,24
1656978690246,MATH 18,A02,083744,Cinel; Cameron Alexander,15,0,30,15
1656978690246,MATH 18,A03,083745,Cinel; Cameron Alexander,8,0,30,22
1656978690246,MATH 18,B01,083748,Rideout; David Porter,4,0,37,33
1656978690246,MATH 18,B02,083749,Rideout; David Porter,3,0,36,33
1656978690246,MATH 18,B03,083750,Rideout; David Porter,2,0,37,35
1656978690246,MATH 18,B04,083751,Rideout; David Porter,5,0,36,31
1656978690246,MATH 18,B05,093473,Rideout; David Porter,4,0,36,32
1656978690246,MATH 18,B06,093474,Rideout; David Porter,5,0,36,31
1656978696272,MATH 20A,A01,083754,Zheng; Zequn,12,0,40,28
1656978702297,MATH 20B,A01,083756,Briones; Jor-el Thomas Caparas,1,0,36,35
1656978702297,MATH 20B,A02,083757,Briones; Jor-el Thomas Caparas,1,0,36,35
1656978702297,MATH 20B,A03,093475,Briones; Jor-el Thomas Caparas,0,0,36,36
1656978708327,MATH 20C,A01,083760,Briones; Jor-el Thomas Caparas,1,0,35,34
1656978708327,MATH 20C,A02,083761,Briones; Jor-el Thomas Caparas,8,0,35,27
1656978708327,MATH 20C,A03,093476,Briones; Jor-el Thomas Caparas,0,1,36,36
1656978708327,MATH 20C,B01,083762,Bach; Quang Tran,0,0,30,30
1656978714352,MATH 20D,A01,083765,Tran; Brian Kha,4,0,30,26
1656978714352,MATH 20D,A02,083766,Tran; Brian Kha,4,0,30,26
1656978714352,MATH 20D,A03,083767,Tran; Brian Kha,3,0,30,27
1656978720381,MATH 20E,A01,083771,Ganguly; Soumya,5,0,32,27
1656978720381,MATH 20E,A02,083772,Ganguly; Soumya,6,0,32,26
1656978720381,MATH 20E,B01,083773,Ciotti; Benjamin,18,0,35,17
1656978720381,MATH 20E,B02,083774,Ciotti; Benjamin,17,0,35,18
1656978726405,MATH 103A,A01,083777,Greenfeld; Be'Eri,2,0,36,34
1656978726405,MATH 103A,A02,083778,Greenfeld; Be'Eri,5,0,36,31
1656978726405,MATH 103A,A03,093561,Greenfeld; Be'Eri,4,0,36,32
1656978726405,MATH 103A,B01,083779,Greenfeld; Be'Eri,6,0,36,30
1656978726405,MATH 103A,B02,083780,Greenfeld; Be'Eri,2,0,36,34
1656978726405,MATH 103A,B03,093562,Greenfeld; Be'Eri,2,0,36,34
1656978732432,MATH 105,A01,085443,Carter; Anne Toulson,14,0,35,21
1656978732432,MATH 105,A02,093477,Carter; Anne Toulson,20,0,35,15
1656978738459,MATH 109,A01,083213,Ganzberger; Geoffrey Michael,2,0,34,32
1656978738459,MATH 109,A02,083214,Ganzberger; Geoffrey Michael,2,0,34,32
1656978738459,MATH 109,A03,093478,Ganzberger; Geoffrey Michael,1,0,34,33
1656978738459,MATH 109,B01,083215,Ganzberger; Geoffrey Michael,1,0,32,31
1656978738459,MATH 109,B02,083216,Ganzberger; Geoffrey Michael,1,0,32,31
1656978738459,MATH 109,B03,093479,Ganzberger; Geoffrey Michael,6,0,32,26
1656978744488,MATH 142A,A01,083219,Chow; Bennett,6,0,32,26
1656978744488,MATH 142A,A02,083220,Chow; Bennett,10,0,32,22
1656978744488,MATH 142A,A03,093480,Chow; Bennett,7,0,32,25
1656978744488,MATH 142A,B03,093481,Chow; Bennett,7,0,32,25
1656978744488,MATH 142A,B04,093558,Chow; Bennett,11,0,32,21
1656978744488,MATH 142A,B05,093559,Chow; Bennett,6,0,32,26
1656978750516,MATH 193A,A01,083224,Rotar; Vladimir,7,0,34,27
1656978750516,MATH 193A,A02,083225,Rotar; Vladimir,4,0,34,30
1656978750516,MATH 193A,A03,083781,Rotar; Vladimir,1,0,34,33
1656978750516,MATH 193A,A04,083782,Rotar; Vladimir,6,0,34,28
1656978750516,MATH 193A,A05,093482,Rotar; Vladimir,6,0,34,28
1656978756540,MATH 197,001,091859,McAuley; Julian John,9999,0,9999,0
1656978756540,MATH 197,002,095566,Kedlaya; Kiran S.,9997,0,9999,2
1656978756540,MATH 197,003,095567,Xiao; Ming,9999,0,9999,0
1656978756540,MATH 197,004,095571,Perols; Johan Lars,9998,0,9999,1
1656978763592,COGS 9,A01,083615,Shannon; Kyle Michael,7,0,75,68
1656978769616,COGS 11,A01,083617,Boyle; Mary E. T.,20,0,48,28
1656978775639,COGS 13,A01,083071,Bastos; Amalia Pinkusfeld,9,0,71,62
1656978781662,COGS 14A,A01,092681,Semenuks; Arturs,0,1,100,100
1656978787684,COGS 14B,A01,083073,Cheng; Tzu-Han,5,0,63,58
1656978793707,COGS 17,A01,092677,Semenuks; Arturs,4,0,81,77
1656978799742,COGS 100,A01,083619,Allen; Michael Gordon,15,0,70,55
1656978805767,COGS 101A,A01,083621,Davis; Joshua Daniel,9,0,68,59
1656978811792,COGS 101B,A01,091572,Allen; Michael Gordon,8,0,65,57
1656978817814,COGS 101C,A01,083625,Delgado; Tania,17,0,35,18
1656978823838,COGS 107A,A01,083627,Boyle; Mary E. T.,13,0,60,47
1656978829864,COGS 118A,A01,083075,Gupta; Anjum,15,0,76,61
1656978835910,CSE 3,A50,083646,Miranda; Gregory Joseph,22,0,50,28
1656978841932,CSE 8A,A50,083650,Miranda; Gregory Joseph,17,1,56,39
1656978847954,CSE 11,A01,083080,Cao; Yingjun,4,15,40,36
1656978853976,CSE 12,A01,083652,Krause-Levy; Sophia Louisa,20,1,120,100
1656978859999,CSE 15L,A01,083654,Morris; Justin Loren,8,0,50,42
1656978859999,CSE 15L,A02,083655,Morris; Justin Loren,8,0,50,42
1656978866022,CSE 20,A01,083657,Tran; Khoa Dang,37,0,80,43
1656978872047,CSE 21,A01,095574,Bach; Quang Tran,21,0,48,27
1656978878070,CSE 30,A01,083084,Eldon; John,4,0,80,76
1656978878070,CSE 30,B01,095061,Bhaskar; Nishant,6,0,50,44
1656978884096,CSE 100,A01,083659,Cao; Yingjun,3,4,70,67
1656978890119,CSE 134B,A01,083661,Powell; Thomas Allan,19,0,100,81
1656978896146,CSE 140,A01,083663,Gungor; Onat,14,0,85,71
1656978902172,CSE 140L,A01,083088,Eldon; John,16,0,100,84
1656978908195,CSE 175,A01,083665,Kumar; Rakesh,3,0,25,22
1656978914219,CSE 190,A00,092507,Dubnov; Shlomo,7,0,20,13
1656978920246,ECE 45,A01,083139,Congero; Spencer William,5,0,75,70
1656978926269,ECE 65,A50,083695,Saad; Andrew S,12,0,30,18
1656978926269,ECE 65,A51,095125,Saad; Andrew S,25,0,26,1
1656978932292,ECE 109,A01,091882,Touri; Behrouz,16,0,70,54
1656978938322,ECE 180,A00,083140,Abi Samra; Nicholas Camill,1,0,30,29
1656978938322,ECE 180,B00,083141,Abi Samra; Nicholas Camill,0,0,30,30
1656978944349,MATH 10A,A01,083735,Patchell; Gregory David,1,0,30,29
1656978944349,MATH 10A,A02,083736,Patchell; Gregory David,20,0,30,10
1656978944349,MATH 10A,A03,083737,Patchell; Gregory David,15,0,30,15
1656978950378,MATH 10B,A01,083207,Lim; Seonhee,7,0,34,27
1656978950378,MATH 10B,A02,083208,Lim; Seonhee,9,0,35,26
1656978950378,MATH 10B,A03,093472,Lim; Seonhee,4,0,34,30
1656978950378,MATH 10B,B01,083739,Sinha; Shubham,9,0,30,21
1656978956402,MATH 18,A01,083743,Cinel; Cameron Alexander,6,0,30,24
1656978956402,MATH 18,A02,083744,Cinel; Cameron Alexander,15,0,30,15
1656978956402,MATH 18,A03,083745,Cinel; Cameron Alexander,8,0,30,22
1656978956402,MATH 18,B01,083748,Rideout; David Porter,4,0,37,33
1656978956402,MATH 18,B02,083749,Rideout; David Porter,3,0,36,33
1656978956402,MATH 18,B03,083750,Rideout; David Porter,2,0,37,35
1656978956402,MATH 18,B04,083751,Rideout; David Porter,5,0,36,31
1656978956402,MATH 18,B05,093473,Rideout; David Porter,4,0,36,32
1656978956402,MATH 18,B06,093474,Rideout; David Porter,5,0,36,31
1656978962424,MATH 20A,A01,083754,Zheng; Zequn,12,0,40,28
1656978968447,MATH 20B,A01,083756,Briones; Jor-el Thomas Caparas,1,0,36,35
1656978968447,MATH 20B,A02,083757,Briones; Jor-el Thomas Caparas,1,0,36,35
1656978968447,MATH 20B,A03,093475,Briones; Jor-el Thomas Caparas,0,0,36,36
1656978974476,MATH 20C,A01,083760,Briones; Jor-el Thomas Caparas,1,0,35,34
1656978974476,MATH 20C,A02,083761,Briones; Jor-el Thomas Caparas,8,0,35,27
1656978974476,MATH 20C,A03,093476,Briones; Jor-el Thomas Caparas,0,1,36,36
1656978974476,MATH 20C,B01,083762,Bach; Quang Tran,0,0,30,30
1656978980505,MATH 20D,A01,083765,Tran; Brian Kha,4,0,30,26
1656978980505,MATH 20D,A02,083766,Tran; Brian Kha,4,0,30,26
1656978980505,MATH 20D,A03,083767,Tran; Brian Kha,3,0,30,27
1656978986530,MATH 20E,A01,083771,Ganguly; Soumya,5,0,32,27
1656978986530,MATH 20E,A02,083772,Ganguly; Soumya,6,0,32,26
1656978986530,MATH 20E,B01,083773,Ciotti; Benjamin,18,0,35,17
1656978986530,MATH 20E,B02,083774,Ciotti; Benjamin,17,0,35,18
1656978992553,MATH 103A,A01,083777,Greenfeld; Be'Eri,2,0,36,34
1656978992553,MATH 103A,A02,083778,Greenfeld; Be'Eri,5,0,36,31
1656978992553,MATH 103A,A03,093561,Greenfeld; Be'Eri,4,0,36,32
1656978992553,MATH 103A,B01,083779,Greenfeld; Be'Eri,6,0,36,30
1656978992553,MATH 103A,B02,083780,Greenfeld; Be'Eri,2,0,36,34
1656978992553,MATH 103A,B03,093562,Greenfeld; Be'Eri,2,0,36,34
1656978998580,MATH 105,A01,085443,Carter; Anne Toulson,14,0,35,21
1656978998580,MATH 105,A02,093477,Carter; Anne Toulson,20,0,35,15
1656979004603,MATH 109,A01,083213,Ganzberger; Geoffrey Michael,2,0,34,32
1656979004603,MATH 109,A02,083214,Ganzberger; Geoffrey Michael,2,0,34,32
1656979004603,MATH 109,A03,093478,Ganzberger; Geoffrey Michael,1,0,34,33
1656979004603,MATH 109,B01,083215,Ganzberger; Geoffrey Michael,1,0,32,31
1656979004603,MATH 109,B02,083216,Ganzberger; Geoffrey Michael,1,0,32,31
1656979004603,MATH 109,B03,093479,Ganzberger; Geoffrey Michael,6,0,32,26
1656979010633,MATH 142A,A01,083219,Chow; Bennett,6,0,32,26
1656979010633,MATH 142A,A02,083220,Chow; Bennett,10,0,32,22
1656979010633,MATH 142A,A03,093480,Chow; Bennett,7,0,32,25
1656979010633,MATH 142A,B03,093481,Chow; Bennett,7,0,32,25
1656979010633,MATH 142A,B04,093558,Chow; Bennett,11,0,32,21
1656979010633,MATH 142A,B05,093559,Chow; Bennett,6,0,32,26
1656979016657,MATH 193A,A01,083224,Rotar; Vladimir,7,0,34,27
1656979016657,MATH 193A,A02,083225,Rotar; Vladimir,4,0,34,30
1656979016657,MATH 193A,A03,083781,Rotar; Vladimir,1,0,34,33
1656979016657,MATH 193A,A04,083782,Rotar; Vladimir,6,0,34,28
1656979016657,MATH 193A,A05,093482,Rotar; Vladimir,6,0,34,28
1656979022680,MATH 197,001,091859,McAuley; Julian John,9999,0,9999,0
1656979022680,MATH 197,002,095566,Kedlaya; Kiran S.,9997,0,9999,2
1656979022680,MATH 197,003,095567,Xiao; Ming,9999,0,9999,0
1656979022680,MATH 197,004,095571,Perols; Johan Lars,9998,0,9999,1
1656979029739,COGS 9,A01,083615,Shannon; Kyle Michael,7,0,75,68
1656979035763,COGS 11,A01,083617,Boyle; Mary E. T.,20,0,48,28
1656979041790,COGS 13,A01,083071,Bastos; Amalia Pinkusfeld,9,0,71,62
1656979047813,COGS 14A,A01,092681,Semenuks; Arturs,0,1,100,100
1656979053836,COGS 14B,A01,083073,Cheng; Tzu-Han,5,0,63,58
1656979059859,COGS 17,A01,092677,Semenuks; Arturs,4,0,81,77
1656979065885,COGS 100,A01,083619,Allen; Michael Gordon,15,0,70,55
1656979071908,COGS 101A,A01,083621,Davis; Joshua Daniel,9,0,68,59
1656979077935,COGS 101B,A01,091572,Allen; Michael Gordon,8,0,65,57
1656979083961,COGS 101C,A01,083625,Delgado; Tania,17,0,35,18
1656979089987,COGS 107A,A01,083627,Boyle; Mary E. T.,13,0,60,47
1656979096011,COGS 118A,A01,083075,Gupta; Anjum,15,0,76,61
1656979102039,CSE 3,A50,083646,Miranda; Gregory Joseph,22,0,50,28
1656979108114,CSE 8A,A50,083650,Miranda; Gregory Joseph,17,1,56,39
1656979114140,CSE 11,A01,083080,Cao; Yingjun,4,15,40,36
1656979120166,CSE 12,A01,083652,Krause-Levy; Sophia Louisa,20,1,120,100
1656979126189,CSE 15L,A01,083654,Morris; Justin Loren,8,0,50,42
1656979126189,CSE 15L,A02,083655,Morris; Justin Loren,8,0,50,42
1656979132216,CSE 20,A01,083657,Tran; Khoa Dang,37,0,80,43
1656979138244,CSE 21,A01,095574,Bach; Quang Tran,21,0,48,27
1656979144272,CSE 30,A01,083084,Eldon; John,4,0,80,76
1656979144272,CSE 30,B01,095061,Bhaskar; Nishant,6,0,50,44
1656979150295,CSE 100,A01,083659,Cao; Yingjun,3,4,70,67
1656979156318,CSE 134B,A01,083661,Powell; Thomas Allan,19,0,100,81
1656979162415,CSE 140,A01,083663,Gungor; Onat,14,0,85,71
1656979168442,CSE 140L,A01,083088,Eldon; John,16,0,100,84
1656979174470,CSE 175,A01,083665,Kumar; Rakesh,3,0,25,22
1656979180492,CSE 190,A00,092507,Dubnov; Shlomo,7,0,20,13
1656979186514,ECE 45,A01,083139,Congero; Spencer William,5,0,75,70
1656979192538,ECE 65,A50,083695,Saad; Andrew S,12,0,30,18
1656979192538,ECE 65,A51,095125,Saad; Andrew S,25,0,26,1
1656979198561,ECE 109,A01,091882,Touri; Behrouz,16,0,70,54
1656979204587,ECE 180,A00,083140,Abi Samra; Nicholas Camill,1,0,30,29
1656979204587,ECE 180,B00,083141,Abi Samra; Nicholas Camill,0,0,30,30
1656979210610,MATH 10A,A01,083735,Patchell; Gregory David,1,0,30,29
1656979210610,MATH 10A,A02,083736,Patchell; Gregory David,20,0,30,10
1656979210610,MATH 10A,A03,083737,Patchell; Gregory David,15,0,30,15
1656979216637,MATH 10B,A01,083207,Lim; Seonhee,7,0,34,27
1656979216637,MATH 10B,A02,083208,Lim; Seonhee,9,0,35,26
1656979216637,MATH 10B,A03,093472,Lim; Seonhee,4,0,34,30
1656979216637,MATH 10B,B01,083739,Sinha; Shubham,9,0,30,21
1656979222661,MATH 18,A01,083743,Cinel; Cameron Alexander,6,0,30,24
1656979222661,MATH 18,A02,083744,Cinel; Cameron Alexander,15,0,30,15
1656979222661,MATH 18,A03,083745,Cinel; Cameron Alexander,8,0,30,22
1656979222661,MATH 18,B01,083748,Rideout; David Porter,4,0,37,33
1656979222661,MATH 18,B02,083749,Rideout; David Porter,3,0,36,33
1656979222661,MATH 18,B03,083750,Rideout; David Porter,2,0,37,35
1656979222661,MATH 18,B04,083751,Rideout; David Porter,5,0,36,31
1656979222661,MATH 18,B05,093473,Rideout; David Porter,4,0,36,32
1656979222661,MATH 18,B06,093474,Rideout; David Porter,5,0,36,31
1656979228683,MATH 20A,A01,083754,Zheng; Zequn,12,0,40,28
1656979234723,MATH 20B,A01,083756,Briones; Jor-el Thomas Caparas,1,0,36,35
1656979234723,MATH 20B,A02,083757,Briones; Jor-el Thomas Caparas,1,0,36,35
1656979234723,MATH 20B,A03,093475,Briones; Jor-el Thomas Caparas,0,0,36,36
1656979240747,MATH 20C,A01,083760,Briones; Jor-el Thomas Caparas,1,0,35,34
1656979240747,MATH 20C,A02,083761,Briones; Jor-el Thomas Caparas,8,0,35,27
1656979240747,MATH 20C,A03,093476,Briones; Jor-el Thomas Caparas,0,1,36,36
1656979240747,MATH 20C,B01,083762,Bach; Quang Tran,0,0,30,30
1656979246773,MATH 20D,A01,083765,Tran; Brian Kha,4,0,30,26
1656979246773,MATH 20D,A02,083766,Tran; Brian Kha,4,0,30,26
1656979246773,MATH 20D,A03,083767,Tran; Brian Kha,3,0,30,27
1656979252800,MATH 20E,A01,083771,Ganguly; Soumya,5,0,32,27
1656979252800,MATH 20E,A02,083772,Ganguly; Soumya,6,0,32,26
1656979252800,MATH 20E,B01,083773,Ciotti; Benjamin,18,0,35,17
1656979252800,MATH 20E,B02,083774,Ciotti; Benjamin,17,0,35,18
1656979258823,MATH 103A,A01,083777,Greenfeld; Be'Eri,2,0,36,34
1656979258823,MATH 103A,A02,083778,Greenfeld; Be'Eri,5,0,36,31
1656979258823,MATH 103A,A03,093561,Greenfeld; Be'Eri,4,0,36,32
1656979258823,MATH 103A,B01,083779,Greenfeld; Be'Eri,6,0,36,30
1656979258823,MATH 103A,B02,083780,Greenfeld; Be'Eri,2,0,36,34
1656979258823,MATH 103A,B03,093562,Greenfeld; Be'Eri,2,0,36,34
1656979264846,MATH 105,A01,085443,Carter; Anne Toulson,14,0,35,21
1656979264846,MATH 105,A02,093477,Carter; Anne Toulson,20,0,35,15
1656979270874,MATH 109,A01,083213,Ganzberger; Geoffrey Michael,2,0,34,32
1656979270874,MATH 109,A02,083214,Ganzberger; Geoffrey Michael,2,0,34,32
1656979270874,MATH 109,A03,093478,Ganzberger; Geoffrey Michael,1,0,34,33
1656979270874,MATH 109,B01,083215,Ganzberger; Geoffrey Michael,1,0,32,31
1656979270874,MATH 109,B02,083216,Ganzberger; Geoffrey Michael,1,0,32,31
1656979270874,MATH 109,B03,093479,Ganzberger; Geoffrey Michael,6,0,32,26
1656979276912,MATH 142A,A01,083219,Chow; Bennett,6,0,32,26
1656979276912,MATH 142A,A02,083220,Chow; Bennett,10,0,32,22
1656979276912,MATH 142A,A03,093480,Chow; Bennett,7,0,32,25
1656979276912,MATH 142A,B03,093481,Chow; Bennett,7,0,32,25
1656979276912,MATH 142A,B04,093558,Chow; Bennett,11,0,32,21
1656979276912,MATH 142A,B05,093559,Chow; Bennett,6,0,32,26
1656979282936,MATH 193A,A01,083224,Rotar; Vladimir,7,0,34,27
1656979282936,MATH 193A,A02,083225,Rotar; Vladimir,4,0,34,30
1656979282936,MATH 193A,A03,083781,Rotar; Vladimir,1,0,34,33
1656979282936,MATH 193A,A04,083782,Rotar; Vladimir,6,0,34,28
1656979282936,MATH 193A,A05,093482,Rotar; Vladimir,6,0,34,28
1656979288960,MATH 197,001,091859,McAuley; Julian John,9999,0,9999,0
1656979288960,MATH 197,002,095566,Kedlaya; Kiran S.,9997,0,9999,2
1656979288960,MATH 197,003,095567,Xiao; Ming,9999,0,9999,0
1656979288960,MATH 197,004,095571,Perols; Johan Lars,9998,0,9999,1
1656979296014,COGS 9,A01,083615,Shannon; Kyle Michael,7,0,75,68
1656979302043,COGS 11,A01,083617,Boyle; Mary E. T.,20,0,48,28
1656979308069,COGS 13,A01,083071,Bastos; Amalia Pinkusfeld,9,0,71,62
1656979314093,COGS 14A,A01,092681,Semenuks; Arturs,0,1,100,100
1656979320120,COGS 14B,A01,083073,Cheng; Tzu-Han,5,0,63,58
1656979326148,COGS 17,A01,092677,Semenuks; Arturs,4,0,81,77
1656979332172,COGS 100,A01,083619,Allen; Michael Gordon,15,0,70,55
1656979338200,COGS 101A,A01,083621,Davis; Joshua Daniel,9,0,68,59
1656979344226,COGS 101B,A01,091572,Allen; Michael Gordon,8,0,65,57
1656979350262,COGS 101C,A01,083625,Delgado; Tania,17,0,35,18
1656979356286,COGS 107A,A01,083627,Boyle; Mary E. T.,13,0,60,47
1656979362310,COGS 118A,A01,083075,Gupta; Anjum,15,0,76,61
1656979368338,CSE 3,A50,083646,Miranda; Gregory Joseph,22,0,50,28
1656979374365,CSE 8A,A50,083650,Miranda; Gregory Joseph,17,1,56,39
1656979380392,CSE 11,A01,083080,Cao; Yingjun,4,15,40,36
1656979386416,CSE 12,A01,083652,Krause-Levy; Sophia Louisa,20,1,120,100
1656979392439,CSE 15L,A01,083654,Morris; Justin Loren,8,0,50,42
1656979392439,CSE 15L,A02,083655,Morris; Justin Loren,8,0,50,42
1656979398465,CSE 20,A01,083657,Tran; Khoa Dang,37,0,80,43
1656979404488,CSE 21,A01,095574,Bach; Quang Tran,21,0,48,27
1656979410511,CSE 30,A01,083084,Eldon; John,4,0,80,76
1656979410511,CSE 30,B01,095061,Bhaskar; Nishant,6,0,50,44
1656979416540,CSE 100,A01,083659,Cao; Yingjun,3,4,70,67
1656979422565,CSE 134B,A01,083661,Powell; Thomas Allan,19,0,100,81
1656979428592,CSE 140,A01,083663,Gungor; Onat,14,0,85,71
1656979434616,CSE 140L,A01,083088,Eldon; John,16,0,100,84
1656979440640,CSE 175,A01,083665,Kumar; Rakesh,3,0,25,22
1656979446667,CSE 190,A00,092507,Dubnov; Shlomo,7,0,20,13
1656979452691,ECE 45,A01,083139,Congero; Spencer William,5,0,75,70
1656979458715,ECE 65,A50,083695,Saad; Andrew S,12,0,30,18
1656979458715,ECE 65,A51,095125,Saad; Andrew S,25,0,26,1
1656979464747,ECE 109,A01,091882,Touri; Behrouz,16,0,70,54
1656979470771,ECE 180,A00,083140,Abi Samra; Nicholas Camill,1,0,30,29
1656979470771,ECE 180,B00,083141,Abi Samra; Nicholas Camill,0,0,30,30
1656979476799,MATH 10A,A01,083735,Patchell; Gregory David,1,0,30,29
1656979476799,MATH 10A,A02,083736,Patchell; Gregory David,20,0,30,10
1656979476799,MATH 10A,A03,083737,Patchell; Gregory David,15,0,30,15
1656979482827,MATH 10B,A01,083207,Lim; Seonhee,7,0,34,27
1656979482827,MATH 10B,A02,083208,Lim; Seonhee,9,0,35,26
1656979482827,MATH 10B,A03,093472,Lim; Seonhee,4,0,34,30
1656979482827,MATH 10B,B01,083739,Sinha; Shubham,9,0,30,21
1656979488858,MATH 18,A01,083743,Cinel; Cameron Alexander,6,0,30,24
1656979488858,MATH 18,A02,083744,Cinel; Cameron Alexander,15,0,30,15
1656979488858,MATH 18,A03,083745,Cinel; Cameron Alexander,8,0,30,22
1656979488858,MATH 18,B01,083748,Rideout; David Porter,4,0,37,33
1656979488858,MATH 18,B02,083749,Rideout; David Porter,3,0,36,33
1656979488858,MATH 18,B03,083750,Rideout; David Porter,2,0,37,35
1656979488858,MATH 18,B04,083751,Rideout; David Porter,5,0,36,31
1656979488858,MATH 18,B05,093473,Rideout; David Porter,4,0,36,32
1656979488858,MATH 18,B06,093474,Rideout; David Porter,5,0,36,31
1656979494884,MATH 20A,A01,083754,Zheng; Zequn,12,0,40,28
1656979500908,MATH 20B,A01,083756,Briones; Jor-el Thomas Caparas,1,0,36,35
1656979500908,MATH 20B,A02,083757,Briones; Jor-el Thomas Caparas,1,0,36,35
1656979500908,MATH 20B,A03,093475,Briones; Jor-el Thomas Caparas,0,0,36,36
1656979506933,MATH 20C,A01,083760,Briones; Jor-el Thomas Caparas,1,0,35,34
1656979506933,MATH 20C,A02,083761,Briones; Jor-el Thomas Caparas,8,0,35,27
1656979506933,MATH 20C,A03,093476,Briones; Jor-el Thomas Caparas,0,1,36,36
1656979506933,MATH 20C,B01,083762,Bach; Quang Tran,0,0,30,30
1656979512959,MATH 20D,A01,083765,Tran; Brian Kha,4,0,30,26
1656979512959,MATH 20D,A02,083766,Tran; Brian Kha,4,0,30,26
1656979512959,MATH 20D,A03,083767,Tran; Brian Kha,3,0,30,27
1656979518988,MATH 20E,A01,083771,Ganguly; Soumya,5,0,32,27
1656979518988,MATH 20E,A02,083772,Ganguly; Soumya,6,0,32,26
1656979518988,MATH 20E,B01,083773,Ciotti; Benjamin,18,0,35,17
1656979518988,MATH 20E,B02,083774,Ciotti; Benjamin,17,0,35,18
1656979525018,MATH 103A,A01,083777,Greenfeld; Be'Eri,2,0,36,34
1656979525018,MATH 103A,A02,083778,Greenfeld; Be'Eri,5,0,36,31
1656979525018,MATH 103A,A03,093561,Greenfeld; Be'Eri,4,0,36,32
1656979525018,MATH 103A,B01,083779,Greenfeld; Be'Eri,6,0,36,30
1656979525018,MATH 103A,B02,083780,Greenfeld; Be'Eri,2,0,36,34
1656979525018,MATH 103A,B03,093562,Greenfeld; Be'Eri,2,0,36,34
1656979531047,MATH 105,A01,085443,Carter; Anne Toulson,14,0,35,21
1656979531047,MATH 105,A02,093477,Carter; Anne Toulson,20,0,35,15
1656979537077,MATH 109,A01,083213,Ganzberger; Geoffrey Michael,2,0,34,32
1656979537077,MATH 109,A02,083214,Ganzberger; Geoffrey Michael,2,0,34,32
1656979537077,MATH 109,A03,093478,Ganzberger; Geoffrey Michael,1,0,34,33
1656979537077,MATH 109,B01,083215,Ganzberger; Geoffrey Michael,1,0,32,31
1656979537077,MATH 109,B02,083216,Ganzberger; Geoffrey Michael,1,0,32,31
1656979537077,MATH 109,B03,093479,Ganzberger; Geoffrey Michael,6,0,32,26
1656979543106,MATH 142A,A01,083219,Chow; Bennett,6,0,32,26
1656979543106,MATH 142A,A02,083220,Chow; Bennett,10,0,32,22
1656979543106,MATH 142A,A03,093480,Chow; Bennett,7,0,32,25
1656979543106,MATH 142A,B03,093481,Chow; Bennett,7,0,32,25
1656979543106,MATH 142A,B04,093558,Chow; Bennett,11,0,32,21
1656979543106,MATH 142A,B05,093559,Chow; Bennett,6,0,32,26
1656979549130,MATH 193A,A01,083224,Rotar; Vladimir,7,0,34,27
1656979549130,MATH 193A,A02,083225,Rotar; Vladimir,4,0,34,30
1656979549130,MATH 193A,A03,083781,Rotar; Vladimir,1,0,34,33
1656979549130,MATH 193A,A04,083782,Rotar; Vladimir,6,0,34,28
1656979549130,MATH 193A,A05,093482,Rotar; Vladimir,6,0,34,28
1656979555163,MATH 197,001,091859,McAuley; Julian John,9999,0,9999,0
1656979555163,MATH 197,002,095566,Kedlaya; Kiran S.,9997,0,9999,2
1656979555163,MATH 197,003,095567,Xiao; Ming,9999,0,9999,0
1656979555163,MATH 197,004,095571,Perols; Johan Lars,9998,0,9999,1
1656979562219,COGS 9,A01,083615,Shannon; Kyle Michael,7,0,75,68
1656979568246,COGS 11,A01,083617,Boyle; Mary E. T.,20,0,48,28
1656979574273,COGS 13,A01,083071,Bastos; Amalia Pinkusfeld,9,0,71,62
1656979580297,COGS 14A,A01,092681,Semenuks; Arturs,0,1,100,100
1656979586322,COGS 14B,A01,083073,Cheng; Tzu-Han,5,0,63,58
1656979592348,COGS 17,A01,092677,Semenuks; Arturs,4,0,81,77
1656979598371,COGS 100,A01,083619,Allen; Michael Gordon,15,0,70,55
1656979604395,COGS 101A,A01,083621,Davis; Joshua Daniel,9,0,68,59
1656979610418,COGS 101B,A01,091572,Allen; Michael Gordon,8,0,65,57
1656979616445,COGS 101C,A01,083625,Delgado; Tania,17,0,35,18
1656979622467,COGS 107A,A01,083627,Boyle; Mary E. T.,13,0,60,47
1656979628495,COGS 118A,A01,083075,Gupta; Anjum,15,0,76,61
1656979634519,CSE 3,A50,083646,Miranda; Gregory Joseph,22,0,50,28
1656979640542,CSE 8A,A50,083650,Miranda; Gregory Joseph,17,1,56,39
1656979646567,CSE 11,A01,083080,Cao; Yingjun,4,15,40,36
1656979652596,CSE 12,A01,083652,Krause-Levy; Sophia Louisa,20,1,120,100
1656979658623,CSE 15L,A01,083654,Morris; Justin Loren,8,0,50,42
1656979658623,CSE 15L,A02,083655,Morris; Justin Loren,8,0,50,42
1656979664651,CSE 20,A01,083657,Tran; Khoa Dang,37,0,80,43
1656979670676,CSE 21,A01,095574,Bach; Quang Tran,21,0,48,27
1656979676704,CSE 30,A01,083084,Eldon; John,4,0,80,76
1656979676704,CSE 30,B01,095061,Bhaskar; Nishant,6,0,50,44
1656979682731,CSE 100,A01,083659,Cao; Yingjun,3,4,70,67
1656979688758,CSE 134B,A01,083661,Powell; Thomas Allan,19,0,100,81
1656979694781,CSE 140,A01,083663,Gungor; Onat,14,0,85,71
1656979700809,CSE 140L,A01,083088,Eldon; John,16,0,100,84
1656979706832,CSE 175,A01,083665,Kumar; Rakesh,3,0,25,22
1656979712855,CSE 190,A00,092507,Dubnov; Shlomo,7,0,20,13
1656979718877,ECE 45,A01,083139,Congero; Spencer William,5,0,75,70
1656979724902,ECE 65,A50,083695,Saad; Andrew S,12,0,30,18
1656979724902,ECE 65,A51,095125,Saad; Andrew S,25,0,26,1
1656979730929,ECE 109,A01,091882,Touri; Behrouz,16,0,70,54
1656979736953,ECE 180,A00,083140,Abi Samra; Nicholas Camill,1,0,30,29
1656979736953,ECE 180,B00,083141,Abi Samra; Nicholas Camill,0,0,30,30
1656979742979,MATH 10A,A01,083735,Patchell; Gregory David,1,0,30,29
1656979742979,MATH 10A,A02,083736,Patchell; Gregory David,20,0,30,10
1656979742979,MATH 10A,A03,083737,Patchell; Gregory David,15,0,30,15
1656979749010,MATH 10B,A01,083207,Lim; Seonhee,7,0,34,27
1656979749010,MATH 10B,A02,083208,Lim; Seonhee,9,0,35,26
1656979749010,MATH 10B,A03,093472,Lim; Seonhee,4,0,34,30
1656979749010,MATH 10B,B01,083739,Sinha; Shubham,9,0,30,21
1656979755042,MATH 18,A01,083743,Cinel; Cameron Alexander,6,0,30,24
1656979755042,MATH 18,A02,083744,Cinel; Cameron Alexander,15,0,30,15
1656979755042,MATH 18,A03,083745,Cinel; Cameron Alexander,8,0,30,22
1656979755042,MATH 18,B01,083748,Rideout; David Porter,4,0,37,33
1656979755042,MATH 18,B02,083749,Rideout; David Porter,3,0,36,33
1656979755042,MATH 18,B03,083750,Rideout; David Porter,2,0,37,35
1656979755042,MATH 18,B04,083751,Rideout; David Porter,5,0,36,31
1656979755042,MATH 18,B05,093473,Rideout; David Porter,4,0,36,32
1656979755042,MATH 18,B06,093474,Rideout; David Porter,5,0,36,31
1656979761183,MATH 20A,A01,083754,Zheng; Zequn,12,0,40,28
1656979767215,MATH 20B,A01,083756,Briones; Jor-el Thomas Caparas,1,0,36,35
1656979767215,MATH 20B,A02,083757,Briones; Jor-el Thomas Caparas,1,0,36,35
1656979767215,MATH 20B,A03,093475,Briones; Jor-el Thomas Caparas,0,0,36,36
1656979773240,MATH 20C,A01,083760,Briones; Jor-el Thomas Caparas,1,0,35,34
1656979773240,MATH 20C,A02,083761,Briones; Jor-el Thomas Caparas,8,0,35,27
1656979773240,MATH 20C,A03,093476,Briones; Jor-el Thomas Caparas,0,1,36,36
1656979773240,MATH 20C,B01,083762,Bach; Quang Tran,0,0,30,30
1656979779263,MATH 20D,A01,083765,Tran; Brian Kha,4,0,30,26
1656979779263,MATH 20D,A02,083766,Tran; Brian Kha,4,0,30,26
1656979779263,MATH 20D,A03,083767,Tran; Brian Kha,3,0,30,27
1656979785294,MATH 20E,A01,083771,Ganguly; Soumya,5,0,32,27
1656979785294,MATH 20E,A02,083772,Ganguly; Soumya,6,0,32,26
1656979785294,MATH 20E,B01,083773,Ciotti; Benjamin,18,0,35,17
1656979785294,MATH 20E,B02,083774,Ciotti; Benjamin,17,0,35,18
1656979791326,MATH 103A,A01,083777,Greenfeld; Be'Eri,2,0,36,34
1656979791326,MATH 103A,A02,083778,Greenfeld; Be'Eri,5,0,36,31
1656979791326,MATH 103A,A03,093561,Greenfeld; Be'Eri,4,0,36,32
1656979791326,MATH 103A,B01,083779,Greenfeld; Be'Eri,6,0,36,30
1656979791326,MATH 103A,B02,083780,Greenfeld; Be'Eri,2,0,36,34
1656979791326,MATH 103A,B03,093562,Greenfeld; Be'Eri,2,0,36,34
1656979797349,MATH 105,A01,085443,Carter; Anne Toulson,14,0,35,21
1656979797349,MATH 105,A02,093477,Carter; Anne Toulson,20,0,35,15
1656979803372,MATH 109,A01,083213,Ganzberger; Geoffrey Michael,2,0,34,32
1656979803372,MATH 109,A02,083214,Ganzberger; Geoffrey Michael,2,0,34,32
1656979803372,MATH 109,A03,093478,Ganzberger; Geoffrey Michael,1,0,34,33
1656979803372,MATH 109,B01,083215,Ganzberger; Geoffrey Michael,1,0,32,31
1656979803372,MATH 109,B02,083216,Ganzberger; Geoffrey Michael,1,0,32,31
1656979803372,MATH 109,B03,093479,Ganzberger; Geoffrey Michael,6,0,32,26
1656979809406,MATH 142A,A01,083219,Chow; Bennett,6,0,32,26
1656979809406,MATH 142A,A02,083220,Chow; Bennett,10,0,32,22
1656979809406,MATH 142A,A03,093480,Chow; Bennett,7,0,32,25
1656979809406,MATH 142A,B03,093481,Chow; Bennett,7,0,32,25
1656979809406,MATH 142A,B04,093558,Chow; Bennett,11,0,32,21
1656979809406,MATH 142A,B05,093559,Chow; Bennett,6,0,32,26
1656979815439,MATH 193A,A01,083224,Rotar; Vladimir,7,0,34,27
1656979815439,MATH 193A,A02,083225,Rotar; Vladimir,4,0,34,30
1656979815439,MATH 193A,A03,083781,Rotar; Vladimir,1,0,34,33
1656979815439,MATH 193A,A04,083782,Rotar; Vladimir,6,0,34,28
1656979815439,MATH 193A,A05,093482,Rotar; Vladimir,6,0,34,28
1656979821462,MATH 197,001,091859,McAuley; Julian John,9999,0,9999,0
1656979821462,MATH 197,002,095566,Kedlaya; Kiran S.,9997,0,9999,2
1656979821462,MATH 197,003,095567,Xiao; Ming,9999,0,9999,0
1656979821462,MATH 197,004,095571,Perols; Johan Lars,9998,0,9999,1
1656979828541,COGS 9,A01,083615,Shannon; Kyle Michael,7,0,75,68
1656979834568,COGS 11,A01,083617,Boyle; Mary E. T.,20,0,48,28
1656979840596,COGS 13,A01,083071,Bastos; Amalia Pinkusfeld,9,0,71,62
1656979846627,COGS 14A,A01,092681,Semenuks; Arturs,0,1,100,100
1656979852649,COGS 14B,A01,083073,Cheng; Tzu-Han,5,0,63,58
1656979858676,COGS 17,A01,092677,Semenuks; Arturs,4,0,81,77
1656979864699,COGS 100,A01,083619,Allen; Michael Gordon,15,0,70,55
1656979870722,COGS 101A,A01,083621,Davis; Joshua Daniel,9,0,68,59
1656979876759,COGS 101B,A01,091572,Allen; Michael Gordon,8,0,65,57
1656979882782,COGS 101C,A01,083625,Delgado; Tania,17,0,35,18
1656979888808,COGS 107A,A01,083627,Boyle; Mary E. T.,13,0,60,47
1656979894831,COGS 118A,A01,083075,Gupta; Anjum,15,0,76,61
1656979900855,CSE 3,A50,083646,Miranda; Gregory Joseph,22,0,50,28
1656979906879,CSE 8A,A50,083650,Miranda; Gregory Joseph,17,1,56,39
1656979912903,CSE 11,A01,083080,Cao; Yingjun,4,15,40,36
1656979918927,CSE 12,A01,083652,Krause-Levy; Sophia Louisa,20,1,120,100
1656979924952,CSE 15L,A01,083654,Morris; Justin Loren,8,0,50,42
1656979924952,CSE 15L,A02,083655,Morris; Justin Loren,8,0,50,42
1656979930979,CSE 20,A01,083657,Tran; Khoa Dang,37,0,80,43
1656979937001,CSE 21,A01,095574,Bach; Quang Tran,21,0,48,27
1656979943027,CSE 30,A01,083084,Eldon; John,4,0,80,76
1656979943027,CSE 30,B01,095061,Bhaskar; Nishant,6,0,50,44
1656979949054,CSE 100,A01,083659,Cao; Yingjun,3,4,70,67
1656979955080,CSE 134B,A01,083661,Powell; Thomas Allan,19,0,100,81
1656979961104,CSE 140,A01,083663,Gungor; Onat,14,0,85,71
1656979967143,CSE 140L,A01,083088,Eldon; John,16,0,100,84
1656979973165,CSE 175,A01,083665,Kumar; Rakesh,3,0,25,22
1656979979189,CSE 190,A00,092507,Dubnov; Shlomo,7,0,20,13
1656979985216,ECE 45,A01,083139,Congero; Spencer William,5,0,75,70
1656979991239,ECE 65,A50,083695,Saad; Andrew S,12,0,30,18
1656979991239,ECE 65,A51,095125,Saad; Andrew S,25,0,26,1
1656979997266,ECE 109,A01,091882,Touri; Behrouz,16,0,70,54
1656980003292,ECE 180,A00,083140,Abi Samra; Nicholas Camill,1,0,30,29
1656980003292,ECE 180,B00,083141,Abi Samra; Nicholas Camill,0,0,30,30
1656980009329,MATH 10A,A01,083735,Patchell; Gregory David,1,0,30,29
1656980009329,MATH 10A,A02,083736,Patchell; Gregory David,20,0,30,10
1656980009329,MATH 10A,A03,083737,Patchell; Gregory David,15,0,30,15
1656980015355,MATH 10B,A01,083207,Lim; Seonhee,7,0,34,27
1656980015355,MATH 10B,A02,083208,Lim; Seonhee,9,0,35,26
1656980015355,MATH 10B,A03,093472,Lim; Seonhee,4,0,34,30
1656980015355,MATH 10B,B01,083739,Sinha; Shubham,9,0,30,21
1656980021385,MATH 18,A01,083743,Cinel; Cameron Alexander,6,0,30,24
1656980021385,MATH 18,A02,083744,Cinel; Cameron Alexander,15,0,30,15
1656980021385,MATH 18,A03,083745,Cinel; Cameron Alexander,8,0,30,22
1656980021385,MATH 18,B01,083748,Rideout; David Porter,4,0,37,33
1656980021385,MATH 18,B02,083749,Rideout; David Porter,3,0,36,33
1656980021385,MATH 18,B03,083750,Rideout; David Porter,2,0,37,35
1656980021385,MATH 18,B04,083751,Rideout; David Porter,5,0,36,31
1656980021385,MATH 18,B05,093473,Rideout; David Porter,4,0,36,32
1656980021385,MATH 18,B06,093474,Rideout; David Porter,5,0,36,31
1656980027409,MATH 20A,A01,083754,Zheng; Zequn,12,0,40,28
1656980033432,MATH 20B,A01,083756,Briones; Jor-el Thomas Caparas,1,0,36,35
1656980033432,MATH 20B,A02,083757,Briones; Jor-el Thomas Caparas,1,0,36,35
1656980033432,MATH 20B,A03,093475,Briones; Jor-el Thomas Caparas,0,0,36,36
1656980039456,MATH 20C,A01,083760,Briones; Jor-el Thomas Caparas,1,0,35,34
1656980039456,MATH 20C,A02,083761,Briones; Jor-el Thomas Caparas,8,0,35,27
1656980039456,MATH 20C,A03,093476,Briones; Jor-el Thomas Caparas,0,1,36,36
1656980039456,MATH 20C,B01,083762,Bach; Quang Tran,0,0,30,30
1656980045487,MATH 20D,A01,083765,Tran; Brian Kha,4,0,30,26
1656980045487,MATH 20D,A02,083766,Tran; Brian Kha,4,0,30,26
1656980045487,MATH 20D,A03,083767,Tran; Brian Kha,3,0,30,27
1656980051511,MATH 20E,A01,083771,Ganguly; Soumya,5,0,32,27
1656980051511,MATH 20E,A02,083772,Ganguly; Soumya,6,0,32,26
1656980051511,MATH 20E,B01,083773,Ciotti; Benjamin,18,0,35,17
1656980051511,MATH 20E,B02,083774,Ciotti; Benjamin,17,0,35,18
1656980057541,MATH 103A,A01,083777,Greenfeld; Be'Eri,2,0,36,34
1656980057541,MATH 103A,A02,083778,Greenfeld; Be'Eri,5,0,36,31
1656980057541,MATH 103A,A03,093561,Greenfeld; Be'Eri,4,0,36,32
1656980057541,MATH 103A,B01,083779,Greenfeld; Be'Eri,6,0,36,30
1656980057541,MATH 103A,B02,083780,Greenfeld; Be'Eri,2,0,36,34
1656980057541,MATH 103A,B03,093562,Greenfeld; Be'Eri,2,0,36,34
1656980063567,MATH 105,A01,085443,Carter; Anne Toulson,14,0,35,21
1656980063567,MATH 105,A02,093477,Carter; Anne Toulson,20,0,35,15
1656980069602,MATH 109,A01,083213,Ganzberger; Geoffrey Michael,2,0,34,32
1656980069602,MATH 109,A02,083214,Ganzberger; Geoffrey Michael,2,0,34,32
1656980069602,MATH 109,A03,093478,Ganzberger; Geoffrey Michael,1,0,34,33
1656980069602,MATH 109,B01,083215,Ganzberger; Geoffrey Michael,1,0,32,31
1656980069602,MATH 109,B02,083216,Ganzberger; Geoffrey Michael,1,0,32,31
1656980069602,MATH 109,B03,093479,Ganzberger; Geoffrey Michael,6,0,32,26
1656980075624,MATH 142A,A01,083219,Chow; Bennett,6,0,32,26
1656980075624,MATH 142A,A02,083220,Chow; Bennett,10,0,32,22
1656980075624,MATH 142A,A03,093480,Chow; Bennett,7,0,32,25
1656980075624,MATH 142A,B03,093481,Chow; Bennett,7,0,32,25
1656980075624,MATH 142A,B04,093558,Chow; Bennett,11,0,32,21
1656980075624,MATH 142A,B05,093559,Chow; Bennett,6,0,32,26
1656980081649,MATH 193A,A01,083224,Rotar; Vladimir,7,0,34,27
1656980081649,MATH 193A,A02,083225,Rotar; Vladimir,4,0,34,30
1656980081649,MATH 193A,A03,083781,Rotar; Vladimir,1,0,34,33
1656980081649,MATH 193A,A04,083782,Rotar; Vladimir,6,0,34,28
1656980081649,MATH 193A,A05,093482,Rotar; Vladimir,6,0,34,28
1656980087683,MATH 197,001,091859,McAuley; Julian John,9999,0,9999,0
1656980087683,MATH 197,002,095566,Kedlaya; Kiran S.,9997,0,9999,2
1656980087683,MATH 197,003,095567,Xiao; Ming,9999,0,9999,0
1656980087683,MATH 197,004,095571,Perols; Johan Lars,9998,0,9999,1
1656980094748,COGS 9,A01,083615,Shannon; Kyle Michael,7,0,75,68
1656980100773,COGS 11,A01,083617,Boyle; Mary E. T.,20,0,48,28
1656980106798,COGS 13,A01,083071,Bastos; Amalia Pinkusfeld,9,0,71,62
1656980112821,COGS 14A,A01,092681,Semenuks; Arturs,0,1,100,100
1656980118845,COGS 14B,A01,083073,Cheng; Tzu-Han,5,0,63,58
1656980124868,COGS 17,A01,092677,Semenuks; Arturs,4,0,81,77
1656980130892,COGS 100,A01,083619,Allen; Michael Gordon,15,0,70,55
1656980136945,COGS 101A,A01,083621,Davis; Joshua Daniel,9,0,68,59
1656980142968,COGS 101B,A01,091572,Allen; Michael Gordon,8,0,65,57
1656980148991,COGS 101C,A01,083625,Delgado; Tania,17,0,35,18
1656980155023,COGS 107A,A01,083627,Boyle; Mary E. T.,13,0,60,47
1656980161047,COGS 118A,A01,083075,Gupta; Anjum,15,0,76,61
1656980167070,CSE 3,A50,083646,Miranda; Gregory Joseph,22,0,50,28
1656980173099,CSE 8A,A50,083650,Miranda; Gregory Joseph,17,1,56,39
1656980179126,CSE 11,A01,083080,Cao; Yingjun,4,15,40,36
1656980185153,CSE 12,A01,083652,Krause-Levy; Sophia Louisa,20,1,120,100
1656980191185,CSE 15L,A01,083654,Morris; Justin Loren,8,0,50,42
1656980191185,CSE 15L,A02,083655,Morris; Justin Loren,8,0,50,42
1656980197213,CSE 20,A01,083657,Tran; Khoa Dang,37,0,80,43
1656980203241,CSE 21,A01,095574,Bach; Quang Tran,21,0,48,27
1656980209267,CSE 30,A01,083084,Eldon; John,4,0,80,76
1656980209267,CSE 30,B01,095061,Bhaskar; Nishant,6,0,50,44
1656980215291,CSE 100,A01,083659,Cao; Yingjun,3,4,70,67
1656980221314,CSE 134B,A01,083661,Powell; Thomas Allan,19,0,100,81
1656980227341,CSE 140,A01,083663,Gungor; Onat,14,0,85,71
1656980233367,CSE 140L,A01,083088,Eldon; John,16,0,100,84
1656980239393,CSE 175,A01,083665,Kumar; Rakesh,3,0,25,22
1656980245424,CSE 190,A00,092507,Dubnov; Shlomo,7,0,20,13
1656980251456,ECE 45,A01,083139,Congero; Spencer William,5,0,75,70
1656980257480,ECE 65,A50,083695,Saad; Andrew S,12,0,30,18
1656980257480,ECE 65,A51,095125,Saad; Andrew S,25,0,26,1
1656980263506,ECE 109,A01,091882,Touri; Behrouz,16,0,70,54
1656980269533,ECE 180,A00,083140,Abi Samra; Nicholas Camill,1,0,30,29
1656980269533,ECE 180,B00,083141,Abi Samra; Nicholas Camill,0,0,30,30
1656980275560,MATH 10A,A01,083735,Patchell; Gregory David,1,0,30,29
1656980275560,MATH 10A,A02,083736,Patchell; Gregory David,20,0,30,10
1656980275560,MATH 10A,A03,083737,Patchell; Gregory David,15,0,30,15
1656980281582,MATH 10B,A01,083207,Lim; Seonhee,7,0,34,27
1656980281582,MATH 10B,A02,083208,Lim; Seonhee,9,0,35,26
1656980281582,MATH 10B,A03,093472,Lim; Seonhee,4,0,34,30
1656980281582,MATH 10B,B01,083739,Sinha; Shubham,9,0,30,21
1656980287608,MATH 18,A01,083743,Cinel; Cameron Alexander,6,0,30,24
1656980287608,MATH 18,A02,083744,Cinel; Cameron Alexander,15,0,30,15
1656980287608,MATH 18,A03,083745,Cinel; Cameron Alexander,8,0,30,22
1656980287608,MATH 18,B01,083748,Rideout; David Porter,4,0,37,33
1656980287608,MATH 18,B02,083749,Rideout; David Porter,3,0,36,33
1656980287608,MATH 18,B03,083750,Rideout; David Porter,2,0,37,35
1656980287608,MATH 18,B04,083751,Rideout; David Porter,5,0,36,31
1656980287608,MATH 18,B05,093473,Rideout; David Porter,4,0,36,32
1656980287608,MATH 18,B06,093474,Rideout; David Porter,5,0,36,31
1656980293630,MATH 20A,A01,083754,Zheng; Zequn,12,0,40,28
1656980299659,MATH 20B,A01,083756,Briones; Jor-el Thomas Caparas,1,0,36,35
1656980299659,MATH 20B,A02,083757,Briones; Jor-el Thomas Caparas,1,0,36,35
1656980299659,MATH 20B,A03,093475,Briones; Jor-el Thomas Caparas,0,0,36,36
1656980305687,MATH 20C,A01,083760,Briones; Jor-el Thomas Caparas,1,0,35,34
1656980305687,MATH 20C,A02,083761,Briones; Jor-el Thomas Caparas,8,0,35,27
1656980305687,MATH 20C,A03,093476,Briones; Jor-el Thomas Caparas,0,1,36,36
1656980305687,MATH 20C,B01,083762,Bach; Quang Tran,0,0,30,30
1656980311715,MATH 20D,A01,083765,Tran; Brian Kha,4,0,30,26
1656980311715,MATH 20D,A02,083766,Tran; Brian Kha,4,0,30,26
1656980311715,MATH 20D,A03,083767,Tran; Brian Kha,3,0,30,27
1656980317743,MATH 20E,A01,083771,Ganguly; Soumya,5,0,32,27
1656980317743,MATH 20E,A02,083772,Ganguly; Soumya,6,0,32,26
1656980317743,MATH 20E,B01,083773,Ciotti; Benjamin,18,0,35,17
1656980317743,MATH 20E,B02,083774,Ciotti; Benjamin,17,0,35,18
1656980323767,MATH 103A,A01,083777,Greenfeld; Be'Eri,2,0,36,34
1656980323767,MATH 103A,A02,083778,Greenfeld; Be'Eri,5,0,36,31
1656980323767,MATH 103A,A03,093561,Greenfeld; Be'Eri,4,0,36,32
1656980323767,MATH 103A,B01,083779,Greenfeld; Be'Eri,6,0,36,30
1656980323767,MATH 103A,B02,083780,Greenfeld; Be'Eri,2,0,36,34
1656980323767,MATH 103A,B03,093562,Greenfeld; Be'Eri,2,0,36,34
1656980329789,MATH 105,A01,085443,Carter; Anne Toulson,14,0,35,21
1656980329789,MATH 105,A02,093477,Carter; Anne Toulson,20,0,35,15
1656980335816,MATH 109,A01,083213,Ganzberger; Geoffrey Michael,2,0,34,32
1656980335816,MATH 109,A02,083214,Ganzberger; Geoffrey Michael,2,0,34,32
1656980335816,MATH 109,A03,093478,Ganzberger; Geoffrey Michael,1,0,34,33
1656980335816,MATH 109,B01,083215,Ganzberger; Geoffrey Michael,1,0,32,31
1656980335816,MATH 109,B02,083216,Ganzberger; Geoffrey Michael,1,0,32,31
1656980335816,MATH 109,B03,093479,Ganzberger; Geoffrey Michael,6,0,32,26
1656980341844,MATH 142A,A01,083219,Chow; Bennett,6,0,32,26
1656980341844,MATH 142A,A02,083220,Chow; Bennett,10,0,32,22
1656980341844,MATH 142A,A03,093480,Chow; Bennett,7,0,32,25
1656980341844,MATH 142A,B03,093481,Chow; Bennett,7,0,32,25
1656980341844,MATH 142A,B04,093558,Chow; Bennett,11,0,32,21
1656980341844,MATH 142A,B05,093559,Chow; Bennett,6,0,32,26
1656980347866,MATH 193A,A01,083224,Rotar; Vladimir,7,0,34,27
1656980347866,MATH 193A,A02,083225,Rotar; Vladimir,4,0,34,30
1656980347866,MATH 193A,A03,083781,Rotar; Vladimir,1,0,34,33
1656980347866,MATH 193A,A04,083782,Rotar; Vladimir,6,0,34,28
1656980347866,MATH 193A,A05,093482,Rotar; Vladimir,6,0,34,28
1656980353890,MATH 197,001,091859,McAuley; Julian John,9999,0,9999,0
1656980353890,MATH 197,002,095566,Kedlaya; Kiran S.,9997,0,9999,2
1656980353890,MATH 197,003,095567,Xiao; Ming,9999,0,9999,0
1656980353890,MATH 197,004,095571,Perols; Johan Lars,9998,0,9999,1
1656980361094,COGS 9,A01,083615,Shannon; Kyle Michael,7,0,75,68
1656980367117,COGS 11,A01,083617,Boyle; Mary E. T.,20,0,48,28
1656980373143,COGS 13,A01,083071,Bastos; Amalia Pinkusfeld,9,0,71,62
1656980379170,COGS 14A,A01,092681,Semenuks; Arturs,0,1,100,100
1656980385195,COGS 14B,A01,083073,Cheng; Tzu-Han,5,0,63,58
1656980391218,COGS 17,A01,092677,Semenuks; Arturs,4,0,81,77
1656980397241,COGS 100,A01,083619,Allen; Michael Gordon,15,0,70,55
1656980403264,COGS 101A,A01,083621,Davis; Joshua Daniel,9,0,68,59
1656980409288,COGS 101B,A01,091572,Allen; Michael Gordon,8,0,65,57
1656980415314,COGS 101C,A01,083625,Delgado; Tania,17,0,35,18
1656980421340,COGS 107A,A01,083627,Boyle; Mary E. T.,13,0,60,47
1656980427363,COGS 118A,A01,083075,Gupta; Anjum,15,0,76,61
1656980433387,CSE 3,A50,083646,Miranda; Gregory Joseph,22,0,50,28
1656980439411,CSE 8A,A50,083650,Miranda; Gregory Joseph,17,1,56,39
1656980445435,CSE 11,A01,083080,Cao; Yingjun,4,15,40,36
1656980451460,CSE 12,A01,083652,Krause-Levy; Sophia Louisa,20,1,120,100
1656980457485,CSE 15L,A01,083654,Morris; Justin Loren,8,0,50,42
1656980457485,CSE 15L,A02,083655,Morris; Justin Loren,8,0,50,42
1656980463512,CSE 20,A01,083657,Tran; Khoa Dang,37,0,80,43
1656980469537,CSE 21,A01,095574,Bach; Quang Tran,21,0,48,27
1656980475580,CSE 30,A01,083084,Eldon; John,4,0,80,76
1656980475580,CSE 30,B01,095061,Bhaskar; Nishant,6,0,50,44
1656980481607,CSE 100,A01,083659,Cao; Yingjun,3,4,70,67
1656980487630,CSE 134B,A01,083661,Powell; Thomas Allan,19,0,100,81
1656980493654,CSE 140,A01,083663,Gungor; Onat,14,0,85,71
1656980499678,CSE 140L,A01,083088,Eldon; John,16,0,100,84
1656980505701,CSE 175,A01,083665,Kumar; Rakesh,3,0,25,22
1656980511729,CSE 190,A00,092507,Dubnov; Shlomo,7,0,20,13
1656980517755,ECE 45,A01,083139,Congero; Spencer William,5,0,75,70
1656980523783,ECE 65,A50,083695,Saad; Andrew S,12,0,30,18
1656980523783,ECE 65,A51,095125,Saad; Andrew S,25,0,26,1
1656980529806,ECE 109,A01,091882,Touri; Behrouz,16,0,70,54
1656980535831,ECE 180,A00,083140,Abi Samra; Nicholas Camill,1,0,30,29
1656980535831,ECE 180,B00,083141,Abi Samra; Nicholas Camill,0,0,30,30
1656980541854,MATH 10A,A01,083735,Patchell; Gregory David,1,0,30,29
1656980541854,MATH 10A,A02,083736,Patchell; Gregory David,20,0,30,10
1656980541854,MATH 10A,A03,083737,Patchell; Gregory David,15,0,30,15
1656980547877,MATH 10B,A01,083207,Lim; Seonhee,7,0,34,27
1656980547877,MATH 10B,A02,083208,Lim; Seonhee,9,0,35,26
1656980547877,MATH 10B,A03,093472,Lim; Seonhee,4,0,34,30
1656980547877,MATH 10B,B01,083739,Sinha; Shubham,9,0,30,21
1656980553910,MATH 18,A01,083743,Cinel; Cameron Alexander,6,0,30,24
1656980553910,MATH 18,A02,083744,Cinel; Cameron Alexander,15,0,30,15
1656980553910,MATH 18,A03,083745,Cinel; Cameron Alexander,8,0,30,22
1656980553910,MATH 18,B01,083748,Rideout; David Porter,4,0,37,33
1656980553910,MATH 18,B02,083749,Rideout; David Porter,3,0,36,33
1656980553910,MATH 18,B03,083750,Rideout; David Porter,2,0,37,35
1656980553910,MATH 18,B04,083751,Rideout; David Porter,5,0,36,31
1656980553910,MATH 18,B05,093473,Rideout; David Porter,4,0,36,32
1656980553910,MATH 18,B06,093474,Rideout; David Porter,5,0,36,31
1656980559937,MATH 20A,A01,083754,Zheng; Zequn,12,0,40,28
1656980565964,MATH 20B,A01,083756,Briones; Jor-el Thomas Caparas,1,0,36,35
1656980565964,MATH 20B,A02,083757,Briones; Jor-el Thomas Caparas,1,0,36,35
1656980565964,MATH 20B,A03,093475,Briones; Jor-el Thomas Caparas,0,0,36,36
1656980571992,MATH 20C,A01,083760,Briones; Jor-el Thomas Caparas,1,0,35,34
1656980571992,MATH 20C,A02,083761,Briones; Jor-el Thomas Caparas,8,0,35,27
1656980571992,MATH 20C,A03,093476,Briones; Jor-el Thomas Caparas,0,1,36,36
1656980571992,MATH 20C,B01,083762,Bach; Quang Tran,0,0,30,30
1656980578030,MATH 20D,A01,083765,Tran; Brian Kha,4,0,30,26
1656980578030,MATH 20D,A02,083766,Tran; Brian Kha,4,0,30,26
1656980578030,MATH 20D,A03,083767,Tran; Brian Kha,3,0,30,27
1656980584053,MATH 20E,A01,083771,Ganguly; Soumya,5,0,32,27
1656980584053,MATH 20E,A02,083772,Ganguly; Soumya,6,0,32,26
1656980584053,MATH 20E,B01,083773,Ciotti; Benjamin,18,0,35,17
1656980584053,MATH 20E,B02,083774,Ciotti; Benjamin,17,0,35,18
1656980590103,MATH 103A,A01,083777,Greenfeld; Be'Eri,2,0,36,34
1656980590103,MATH 103A,A02,083778,Greenfeld; Be'Eri,5,0,36,31
1656980590103,MATH 103A,A03,093561,Greenfeld; Be'Eri,4,0,36,32
1656980590103,MATH 103A,B01,083779,Greenfeld; Be'Eri,6,0,36,30
1656980590103,MATH 103A,B02,083780,Greenfeld; Be'Eri,2,0,36,34
1656980590103,MATH 103A,B03,093562,Greenfeld; Be'Eri,2,0,36,34
1656980596126,MATH 105,A01,085443,Carter; Anne Toulson,14,0,35,21
1656980596126,MATH 105,A02,093477,Carter; Anne Toulson,20,0,35,15
1656980602150,MATH 109,A01,083213,Ganzberger; Geoffrey Michael,2,0,34,32
1656980602150,MATH 109,A02,083214,Ganzberger; Geoffrey Michael,2,0,34,32
1656980602150,MATH 109,A03,093478,Ganzberger; Geoffrey Michael,1,0,34,33
1656980602150,MATH 109,B01,083215,Ganzberger; Geoffrey Michael,1,0,32,31
1656980602150,MATH 109,B02,083216,Ganzberger; Geoffrey Michael,1,0,32,31
1656980602150,MATH 109,B03,093479,Ganzberger; Geoffrey Michael,6,0,32,26
1656980608173,MATH 142A,A01,083219,Chow; Bennett,6,0,32,26
1656980608173,MATH 142A,A02,083220,Chow; Bennett,10,0,32,22
1656980608173,MATH 142A,A03,093480,Chow; Bennett,7,0,32,25
1656980608173,MATH 142A,B03,093481,Chow; Bennett,7,0,32,25
1656980608173,MATH 142A,B04,093558,Chow; Bennett,11,0,32,21
1656980608173,MATH 142A,B05,093559,Chow; Bennett,6,0,32,26
1656980614204,MATH 193A,A01,083224,Rotar; Vladimir,7,0,34,27
1656980614204,MATH 193A,A02,083225,Rotar; Vladimir,4,0,34,30
1656980614204,MATH 193A,A03,083781,Rotar; Vladimir,1,0,34,33
1656980614204,MATH 193A,A04,083782,Rotar; Vladimir,6,0,34,28
1656980614204,MATH 193A,A05,093482,Rotar; Vladimir,6,0,34,28
1656980620227,MATH 197,001,091859,McAuley; Julian John,9999,0,9999,0
1656980620227,MATH 197,002,095566,Kedlaya; Kiran S.,9997,0,9999,2
1656980620227,MATH 197,003,095567,Xiao; Ming,9999,0,9999,0
1656980620227,MATH 197,004,095571,Perols; Johan Lars,9998,0,9999,1
1656980627285,COGS 9,A01,083615,Shannon; Kyle Michael,7,0,75,68
1656980633309,COGS 11,A01,083617,Boyle; Mary E. T.,20,0,48,28
1656980639340,COGS 13,A01,083071,Bastos; Amalia Pinkusfeld,9,0,71,62
1656980645369,COGS 14A,A01,092681,Semenuks; Arturs,0,1,100,100
1656980651403,COGS 14B,A01,083073,Cheng; Tzu-Han,5,0,63,58
1656980657426,COGS 17,A01,092677,Semenuks; Arturs,4,0,81,77
1656980663449,COGS 100,A01,083619,Allen; Michael Gordon,15,0,70,55
1656980669479,COGS 101A,A01,083621,Davis; Joshua Daniel,9,0,68,59
1656980675507,COGS 101B,A01,091572,Allen; Michael Gordon,8,0,65,57
1656980681531,COGS 101C,A01,083625,Delgado; Tania,17,0,35,18
1656980687559,COGS 107A,A01,083627,Boyle; Mary E. T.,13,0,60,47
1656980693593,COGS 118A,A01,083075,Gupta; Anjum,15,0,76,61
1656980699616,CSE 3,A50,083646,Miranda; Gregory Joseph,22,0,50,28
1656980705644,CSE 8A,A50,083650,Miranda; Gregory Joseph,17,1,56,39
1656980711667,CSE 11,A01,083080,Cao; Yingjun,4,15,40,36
1656980717695,CSE 12,A01,083652,Krause-Levy; Sophia Louisa,20,1,120,100
1656980723721,CSE 15L,A01,083654,Morris; Justin Loren,8,0,50,42
1656980723721,CSE 15L,A02,083655,Morris; Justin Loren,8,0,50,42
1656980729745,CSE 20,A01,083657,Tran; Khoa Dang,37,0,80,43
1656980735771,CSE 21,A01,095574,Bach; Quang Tran,21,0,48,27
1656980741795,CSE 30,A01,083084,Eldon; John,4,0,80,76
1656980741795,CSE 30,B01,095061,Bhaskar; Nishant,6,0,50,44
1656980747819,CSE 100,A01,083659,Cao; Yingjun,3,4,70,67
1656980753846,CSE 134B,A01,083661,Powell; Thomas Allan,19,0,100,81
1656980759869,CSE 140,A01,083663,Gungor; Onat,14,0,85,71
1656980765904,CSE 140L,A01,083088,Eldon; John,16,0,100,84
1656980771927,CSE 175,A01,083665,Kumar; Rakesh,3,0,25,22
1656980777954,CSE 190,A00,092507,Dubnov; Shlomo,7,0,20,13
1656980783981,ECE 45,A01,083139,Congero; Spencer William,5,0,75,70
1656980790008,ECE 65,A50,083695,Saad; Andrew S,12,0,30,18
1656980790008,ECE 65,A51,095125,Saad; Andrew S,25,0,26,1
1656980796032,ECE 109,A01,091882,Touri; Behrouz,16,0,70,54
1656980802059,ECE 180,A00,083140,Abi Samra; Nicholas Camill,1,0,30,29
1656980802059,ECE 180,B00,083141,Abi Samra; Nicholas Camill,0,0,30,30
1656980808096,MATH 10A,A01,083735,Patchell; Gregory David,1,0,30,29
1656980808096,MATH 10A,A02,083736,Patchell; Gregory David,20,0,30,10
1656980808096,MATH 10A,A03,083737,Patchell; Gregory David,15,0,30,15
1656980814121,MATH 10B,A01,083207,Lim; Seonhee,7,0,34,27
1656980814121,MATH 10B,A02,083208,Lim; Seonhee,9,0,35,26
1656980814121,MATH 10B,A03,093472,Lim; Seonhee,4,0,34,30
1656980814121,MATH 10B,B01,083739,Sinha; Shubham,9,0,30,21
1656980820152,MATH 18,A01,083743,Cinel; Cameron Alexander,6,0,30,24
1656980820152,MATH 18,A02,083744,Cinel; Cameron Alexander,15,0,30,15
1656980820152,MATH 18,A03,083745,Cinel; Cameron Alexander,8,0,30,22
1656980820152,MATH 18,B01,083748,Rideout; David Porter,4,0,37,33
1656980820152,MATH 18,B02,083749,Rideout; David Porter,3,0,36,33
1656980820152,MATH 18,B03,083750,Rideout; David Porter,2,0,37,35
1656980820152,MATH 18,B04,083751,Rideout; David Porter,5,0,36,31
1656980820152,MATH 18,B05,093473,Rideout; David Porter,4,0,36,32
1656980820152,MATH 18,B06,093474,Rideout; David Porter,5,0,36,31
1656980826179,MATH 20A,A01,083754,Zheng; Zequn,12,0,40,28
1656980832202,MATH 20B,A01,083756,Briones; Jor-el Thomas Caparas,1,0,36,35
1656980832202,MATH 20B,A02,083757,Briones; Jor-el Thomas Caparas,1,0,36,35
1656980832202,MATH 20B,A03,093475,Briones; Jor-el Thomas Caparas,0,0,36,36
1656980838226,MATH 20C,A01,083760,Briones; Jor-el Thomas Caparas,1,0,35,34
1656980838226,MATH 20C,A02,083761,Briones; Jor-el Thomas Caparas,8,0,35,27
1656980838226,MATH 20C,A03,093476,Briones; Jor-el Thomas Caparas,0,1,36,36
1656980838226,MATH 20C,B01,083762,Bach; Quang Tran,0,0,30,30
1656980844251,MATH 20D,A01,083765,Tran; Brian Kha,4,0,30,26
1656980844251,MATH 20D,A02,083766,Tran; Brian Kha,4,0,30,26
1656980844251,MATH 20D,A03,083767,Tran; Brian Kha,3,0,30,27
1656980850279,MATH 20E,A01,083771,Ganguly; Soumya,5,0,32,27
1656980850279,MATH 20E,A02,083772,Ganguly; Soumya,6,0,32,26
1656980850279,MATH 20E,B01,083773,Ciotti; Benjamin,18,0,35,17
1656980850279,MATH 20E,B02,083774,Ciotti; Benjamin,17,0,35,18
1656980856309,MATH 103A,A01,083777,Greenfeld; Be'Eri,2,0,36,34
1656980856309,MATH 103A,A02,083778,Greenfeld; Be'Eri,5,0,36,31
1656980856309,MATH 103A,A03,093561,Greenfeld; Be'Eri,4,0,36,32
1656980856309,MATH 103A,B01,083779,Greenfeld; Be'Eri,6,0,36,30
1656980856309,MATH 103A,B02,083780,Greenfeld; Be'Eri,2,0,36,34
1656980856309,MATH 103A,B03,093562,Greenfeld; Be'Eri,2,0,36,34
1656980862334,MATH 105,A01,085443,Carter; Anne Toulson,14,0,35,21
1656980862334,MATH 105,A02,093477,Carter; Anne Toulson,20,0,35,15
1656980868356,MATH 109,A01,083213,Ganzberger; Geoffrey Michael,2,0,34,32
1656980868356,MATH 109,A02,083214,Ganzberger; Geoffrey Michael,2,0,34,32
1656980868356,MATH 109,A03,093478,Ganzberger; Geoffrey Michael,1,0,34,33
1656980868356,MATH 109,B01,083215,Ganzberger; Geoffrey Michael,1,0,32,31
1656980868356,MATH 109,B02,083216,Ganzberger; Geoffrey Michael,1,0,32,31
1656980868356,MATH 109,B03,093479,Ganzberger; Geoffrey Michael,6,0,32,26
1656980874383,MATH 142A,A01,083219,Chow; Bennett,6,0,32,26
1656980874383,MATH 142A,A02,083220,Chow; Bennett,10,0,32,22
1656980874383,MATH 142A,A03,093480,Chow; Bennett,7,0,32,25
1656980874383,MATH 142A,B03,093481,Chow; Bennett,7,0,32,25
1656980874383,MATH 142A,B04,093558,Chow; Bennett,11,0,32,21
1656980874383,MATH 142A,B05,093559,Chow; Bennett,6,0,32,26
1656980880409,MATH 193A,A01,083224,Rotar; Vladimir,7,0,34,27
1656980880409,MATH 193A,A02,083225,Rotar; Vladimir,4,0,34,30
1656980880409,MATH 193A,A03,083781,Rotar; Vladimir,1,0,34,33
1656980880409,MATH 193A,A04,083782,Rotar; Vladimir,6,0,34,28
1656980880409,MATH 193A,A05,093482,Rotar; Vladimir,6,0,34,28
1656980886433,MATH 197,001,091859,McAuley; Julian John,9999,0,9999,0
1656980886433,MATH 197,002,095566,Kedlaya; Kiran S.,9997,0,9999,2
1656980886433,MATH 197,003,095567,Xiao; Ming,9999,0,9999,0
1656980886433,MATH 197,004,095571,Perols; Johan Lars,9998,0,9999,1
1656980893495,COGS 9,A01,083615,Shannon; Kyle Michael,7,0,75,68
1656980899519,COGS 11,A01,083617,Boyle; Mary E. T.,20,0,48,28
1656980905541,COGS 13,A01,083071,Bastos; Amalia Pinkusfeld,9,0,71,62
1656980911565,COGS 14A,A01,092681,Semenuks; Arturs,0,1,100,100
1656980917591,COGS 14B,A01,083073,Cheng; Tzu-Han,5,0,63,58
1656980923612,COGS 17,A01,092677,Semenuks; Arturs,4,0,81,77
1656980929634,COGS 100,A01,083619,Allen; Michael Gordon,15,0,70,55
1656980935656,COGS 101A,A01,083621,Davis; Joshua Daniel,9,0,68,59
1656980941677,COGS 101B,A01,091572,Allen; Michael Gordon,8,0,65,57
1656980947703,COGS 101C,A01,083625,Delgado; Tania,17,0,35,18
1656980953795,COGS 107A,A01,083627,Boyle; Mary E. T.,13,0,60,47
1656980959820,COGS 118A,A01,083075,Gupta; Anjum,15,0,76,61
1656980965842,CSE 3,A50,083646,Miranda; Gregory Joseph,22,0,50,28
1656980971867,CSE 8A,A50,083650,Miranda; Gregory Joseph,17,1,56,39
1656980977892,CSE 11,A01,083080,Cao; Yingjun,4,15,40,36
1656980983919,CSE 12,A01,083652,Krause-Levy; Sophia Louisa,20,1,120,100
1656980989943,CSE 15L,A01,083654,Morris; Justin Loren,8,0,50,42
1656980989943,CSE 15L,A02,083655,Morris; Justin Loren,8,0,50,42
1656980995967,CSE 20,A01,083657,Tran; Khoa Dang,37,0,80,43
1656981001990,CSE 21,A01,095574,Bach; Quang Tran,21,0,48,27
1656981008016,CSE 30,A01,083084,Eldon; John,4,0,80,76
1656981008016,CSE 30,B01,095061,Bhaskar; Nishant,6,0,50,44
1656981014040,CSE 100,A01,083659,Cao; Yingjun,3,4,70,67
1656981020065,CSE 134B,A01,083661,Powell; Thomas Allan,19,0,100,81
1656981026093,CSE 140,A01,083663,Gungor; Onat,14,0,85,71
1656981032122,CSE 140L,A01,083088,Eldon; John,16,0,100,84
1656981038149,CSE 175,A01,083665,Kumar; Rakesh,3,0,25,22
1656981044174,CSE 190,A00,092507,Dubnov; Shlomo,7,0,20,13
1656981050199,ECE 45,A01,083139,Congero; Spencer William,5,0,75,70
1656981056224,ECE 65,A50,083695,Saad; Andrew S,12,0,30,18
1656981056224,ECE 65,A51,095125,Saad; Andrew S,25,0,26,1
1656981062253,ECE 109,A01,091882,Touri; Behrouz,16,0,70,54
1656981068282,ECE 180,A00,083140,Abi Samra; Nicholas Camill,1,0,30,29
1656981068282,ECE 180,B00,083141,Abi Samra; Nicholas Camill,0,0,30,30
1656981074308,MATH 10A,A01,083735,Patchell; Gregory David,1,0,30,29
1656981074308,MATH 10A,A02,083736,Patchell; Gregory David,20,0,30,10
1656981074308,MATH 10A,A03,083737,Patchell; Gregory David,15,0,30,15
1656981080333,MATH 10B,A01,083207,Lim; Seonhee,7,0,34,27
1656981080333,MATH 10B,A02,083208,Lim; Seonhee,9,0,35,26
1656981080333,MATH 10B,A03,093472,Lim; Seonhee,4,0,34,30
1656981080333,MATH 10B,B01,083739,Sinha; Shubham,9,0,30,21
1656981086365,MATH 18,A01,083743,Cinel; Cameron Alexander,6,0,30,24
1656981086365,MATH 18,A02,083744,Cinel; Cameron Alexander,15,0,30,15
1656981086365,MATH 18,A03,083745,Cinel; Cameron Alexander,8,0,30,22
1656981086365,MATH 18,B01,083748,Rideout; David Porter,4,0,37,33
1656981086365,MATH 18,B02,083749,Rideout; David Porter,3,0,36,33
1656981086365,MATH 18,B03,083750,Rideout; David Porter,2,0,37,35
1656981086365,MATH 18,B04,083751,Rideout; David Porter,5,0,36,31
1656981086365,MATH 18,B05,093473,Rideout; David Porter,4,0,36,32
1656981086365,MATH 18,B06,093474,Rideout; David Porter,5,0,36,31
1656981092390,MATH 20A,A01,083754,Zheng; Zequn,12,0,40,28
1656981098415,MATH 20B,A01,083756,Briones; Jor-el Thomas Caparas,1,0,36,35
1656981098415,MATH 20B,A02,083757,Briones; Jor-el Thomas Caparas,1,0,36,35
1656981098415,MATH 20B,A03,093475,Briones; Jor-el Thomas Caparas,0,0,36,36
1656981104454,MATH 20C,A01,083760,Briones; Jor-el Thomas Caparas,1,0,35,34
1656981104454,MATH 20C,A02,083761,Briones; Jor-el Thomas Caparas,8,0,35,27
1656981104454,MATH 20C,A03,093476,Briones; Jor-el Thomas Caparas,0,1,36,36
1656981104454,MATH 20C,B01,083762,Bach; Quang Tran,0,0,30,30
1656981110479,MATH 20D,A01,083765,Tran; Brian Kha,4,0,30,26
1656981110479,MATH 20D,A02,083766,Tran; Brian Kha,4,0,30,26
1656981110479,MATH 20D,A03,083767,Tran; Brian Kha,3,0,30,27
1656981116514,MATH 20E,A01,083771,Ganguly; Soumya,5,0,32,27
1656981116514,MATH 20E,A02,083772,Ganguly; Soumya,6,0,32,26
1656981116514,MATH 20E,B01,083773,Ciotti; Benjamin,18,0,35,17
1656981116514,MATH 20E,B02,083774,Ciotti; Benjamin,17,0,35,18
1656981122538,MATH 103A,A01,083777,Greenfeld; Be'Eri,2,0,36,34
1656981122538,MATH 103A,A02,083778,Greenfeld; Be'Eri,5,0,36,31
1656981122538,MATH 103A,A03,093561,Greenfeld; Be'Eri,4,0,36,32
1656981122538,MATH 103A,B01,083779,Greenfeld; Be'Eri,6,0,36,30
1656981122538,MATH 103A,B02,083780,Greenfeld; Be'Eri,2,0,36,34
1656981122538,MATH 103A,B03,093562,Greenfeld; Be'Eri,2,0,36,34
1656981128561,MATH 105,A01,085443,Carter; Anne Toulson,14,0,35,21
1656981128561,MATH 105,A02,093477,Carter; Anne Toulson,20,0,35,15
1656981134590,MATH 109,A01,083213,Ganzberger; Geoffrey Michael,2,0,34,32
1656981134590,MATH 109,A02,083214,Ganzberger; Geoffrey Michael,2,0,34,32
1656981134590,MATH 109,A03,093478,Ganzberger; Geoffrey Michael,1,0,34,33
1656981134590,MATH 109,B01,083215,Ganzberger; Geoffrey Michael,1,0,32,31
1656981134590,MATH 109,B02,083216,Ganzberger; Geoffrey Michael,1,0,32,31
1656981134590,MATH 109,B03,093479,Ganzberger; Geoffrey Michael,6,0,32,26
1656981140617,MATH 142A,A01,083219,Chow; Bennett,6,0,32,26
1656981140617,MATH 142A,A02,083220,Chow; Bennett,10,0,32,22
1656981140617,MATH 142A,A03,093480,Chow; Bennett,7,0,32,25
1656981140617,MATH 142A,B03,093481,Chow; Bennett,7,0,32,25
1656981140617,MATH 142A,B04,093558,Chow; Bennett,11,0,32,21
1656981140617,MATH 142A,B05,093559,Chow; Bennett,6,0,32,26
1656981146640,MATH 193A,A01,083224,Rotar; Vladimir,7,0,34,27
1656981146640,MATH 193A,A02,083225,Rotar; Vladimir,4,0,34,30
1656981146640,MATH 193A,A03,083781,Rotar; Vladimir,1,0,34,33
1656981146640,MATH 193A,A04,083782,Rotar; Vladimir,6,0,34,28
1656981146640,MATH 193A,A05,093482,Rotar; Vladimir,6,0,34,28
1656981152665,MATH 197,001,091859,McAuley; Julian John,9999,0,9999,0
1656981152665,MATH 197,002,095566,Kedlaya; Kiran S.,9997,0,9999,2
1656981152665,MATH 197,003,095567,Xiao; Ming,9999,0,9999,0
1656981152665,MATH 197,004,095571,Perols; Johan Lars,9998,0,9999,1
1656981159720,COGS 9,A01,083615,Shannon; Kyle Michael,7,0,75,68
1656981165743,COGS 11,A01,083617,Boyle; Mary E. T.,20,0,48,28
1656981171764,COGS 13,A01,083071,Bastos; Amalia Pinkusfeld,9,0,71,62
1656981177788,COGS 14A,A01,092681,Semenuks; Arturs,0,1,100,100
1656981183816,COGS 14B,A01,083073,Cheng; Tzu-Han,5,0,63,58
1656981189861,COGS 17,A01,092677,Semenuks; Arturs,4,0,81,77
1656981195882,COGS 100,A01,083619,Allen; Michael Gordon,15,0,70,55
1656981201905,COGS 101A,A01,083621,Davis; Joshua Daniel,9,0,68,59
1656981207927,COGS 101B,A01,091572,Allen; Michael Gordon,8,0,65,57
1656981213956,COGS 101C,A01,083625,Delgado; Tania,17,0,35,18
1656981219981,COGS 107A,A01,083627,Boyle; Mary E. T.,13,0,60,47
1656981226005,COGS 118A,A01,083075,Gupta; Anjum,15,0,76,61
1656981232028,CSE 3,A50,083646,Miranda; Gregory Joseph,22,0,50,28
1656981238054,CSE 8A,A50,083650,Miranda; Gregory Joseph,17,1,56,39
1656981244076,CSE 11,A01,083080,Cao; Yingjun,4,15,40,36
1656981250109,CSE 12,A01,083652,Krause-Levy; Sophia Louisa,20,1,120,100
1656981256136,CSE 15L,A01,083654,Morris; Justin Loren,8,0,50,42
1656981256136,CSE 15L,A02,083655,Morris; Justin Loren,8,0,50,42
1656981262157,CSE 20,A01,083657,Tran; Khoa Dang,37,0,80,43
1656981268182,CSE 21,A01,095574,Bach; Quang Tran,21,0,48,27
1656981274207,CSE 30,A01,083084,Eldon; John,4,0,80,76
1656981274207,CSE 30,B01,095061,Bhaskar; Nishant,6,0,50,44
1656981280233,CSE 100,A01,083659,Cao; Yingjun,3,4,70,67
1656981286267,CSE 134B,A01,083661,Powell; Thomas Allan,19,0,100,81
1656981292291,CSE 140,A01,083663,Gungor; Onat,14,0,85,71
1656981298318,CSE 140L,A01,083088,Eldon; John,16,0,100,84
1656981304343,CSE 175,A01,083665,Kumar; Rakesh,3,0,25,22
1656981310372,CSE 190,A00,092507,Dubnov; Shlomo,7,0,20,13
1656981316395,ECE 45,A01,083139,Congero; Spencer William,5,0,75,70
1656981322440,ECE 65,A50,083695,Saad; Andrew S,12,0,30,18
1656981322440,ECE 65,A51,095125,Saad; Andrew S,25,0,26,1
1656981328463,ECE 109,A01,091882,Touri; Behrouz,16,0,70,54
1656981334492,ECE 180,A00,083140,Abi Samra; Nicholas Camill,1,0,30,29
1656981334492,ECE 180,B00,083141,Abi Samra; Nicholas Camill,0,0,30,30
1656981340516,MATH 10A,A01,083735,Patchell; Gregory David,1,0,30,29
1656981340516,MATH 10A,A02,083736,Patchell; Gregory David,20,0,30,10
1656981340516,MATH 10A,A03,083737,Patchell; Gregory David,15,0,30,15
1656981346547,MATH 10B,A01,083207,Lim; Seonhee,7,0,34,27
1656981346547,MATH 10B,A02,083208,Lim; Seonhee,9,0,35,26
1656981346547,MATH 10B,A03,093472,Lim; Seonhee,4,0,34,30
1656981346547,MATH 10B,B01,083739,Sinha; Shubham,9,0,30,21
1656981352572,MATH 18,A01,083743,Cinel; Cameron Alexander,6,0,30,24
1656981352572,MATH 18,A02,083744,Cinel; Cameron Alexander,15,0,30,15
1656981352572,MATH 18,A03,083745,Cinel; Cameron Alexander,8,0,30,22
1656981352572,MATH 18,B01,083748,Rideout; David Porter,4,0,37,33
1656981352572,MATH 18,B02,083749,Rideout; David Porter,3,0,36,33
1656981352572,MATH 18,B03,083750,Rideout; David Porter,2,0,37,35
1656981352572,MATH 18,B04,083751,Rideout; David Porter,5,0,36,31
1656981352572,MATH 18,B05,093473,Rideout; David Porter,4,0,36,32
1656981352572,MATH 18,B06,093474,Rideout; David Porter,5,0,36,31
1656981358609,MATH 20A,A01,083754,Zheng; Zequn,12,0,40,28
1656981364642,MATH 20B,A01,083756,Briones; Jor-el Thomas Caparas,1,0,36,35
1656981364642,MATH 20B,A02,083757,Briones; Jor-el Thomas Caparas,1,0,36,35
1656981364642,MATH 20B,A03,093475,Briones; Jor-el Thomas Caparas,0,0,36,36
1656981370664,MATH 20C,A01,083760,Briones; Jor-el Thomas Caparas,1,0,35,34
1656981370664,MATH 20C,A02,083761,Briones; Jor-el Thomas Caparas,8,0,35,27
1656981370664,MATH 20C,A03,093476,Briones; Jor-el Thomas Caparas,0,1,36,36
1656981370664,MATH 20C,B01,083762,Bach; Quang Tran,0,0,30,30
1656981376698,MATH 20D,A01,083765,Tran; Brian Kha,4,0,30,26
1656981376698,MATH 20D,A02,083766,Tran; Brian Kha,4,0,30,26
1656981376698,MATH 20D,A03,083767,Tran; Brian Kha,3,0,30,27
1656981382725,MATH 20E,A01,083771,Ganguly; Soumya,5,0,32,27
1656981382725,MATH 20E,A02,083772,Ganguly; Soumya,6,0,32,26
1656981382725,MATH 20E,B01,083773,Ciotti; Benjamin,18,0,35,17
1656981382725,MATH 20E,B02,083774,Ciotti; Benjamin,17,0,35,18
1656981388752,MATH 103A,A01,083777,Greenfeld; Be'Eri,2,0,36,34
1656981388752,MATH 103A,A02,083778,Greenfeld; Be'Eri,5,0,36,31
1656981388752,MATH 103A,A03,093561,Greenfeld; Be'Eri,4,0,36,32
1656981388752,MATH 103A,B01,083779,Greenfeld; Be'Eri,6,0,36,30
1656981388752,MATH 103A,B02,083780,Greenfeld; Be'Eri,2,0,36,34
1656981388752,MATH 103A,B03,093562,Greenfeld; Be'Eri,2,0,36,34
1656981394775,MATH 105,A01,085443,Carter; Anne Toulson,14,0,35,21
1656981394775,MATH 105,A02,093477,Carter; Anne Toulson,20,0,35,15
1656981400798,MATH 109,A01,083213,Ganzberger; Geoffrey Michael,2,0,34,32
1656981400798,MATH 109,A02,083214,Ganzberger; Geoffrey Michael,2,0,34,32
1656981400798,MATH 109,A03,093478,Ganzberger; Geoffrey Michael,1,0,34,33
1656981400798,MATH 109,B01,083215,Ganzberger; Geoffrey Michael,1,0,32,31
1656981400798,MATH 109,B02,083216,Ganzberger; Geoffrey Michael,1,0,32,31
1656981400798,MATH 109,B03,093479,Ganzberger; Geoffrey Michael,6,0,32,26
1656981406822,MATH 142A,A01,083219,Chow; Bennett,6,0,32,26
1656981406822,MATH 142A,A02,083220,Chow; Bennett,10,0,32,22
1656981406822,MATH 142A,A03,093480,Chow; Bennett,7,0,32,25
1656981406822,MATH 142A,B03,093481,Chow; Bennett,7,0,32,25
1656981406822,MATH 142A,B04,093558,Chow; Bennett,11,0,32,21
1656981406822,MATH 142A,B05,093559,Chow; Bennett,6,0,32,26
1656981412846,MATH 193A,A01,083224,Rotar; Vladimir,7,0,34,27
1656981412846,MATH 193A,A02,083225,Rotar; Vladimir,4,0,34,30
1656981412846,MATH 193A,A03,083781,Rotar; Vladimir,1,0,34,33
1656981412846,MATH 193A,A04,083782,Rotar; Vladimir,6,0,34,28
1656981412846,MATH 193A,A05,093482,Rotar; Vladimir,6,0,34,28
1656981418869,MATH 197,001,091859,McAuley; Julian John,9999,0,9999,0
1656981418869,MATH 197,002,095566,Kedlaya; Kiran S.,9997,0,9999,2
1656981418869,MATH 197,003,095567,Xiao; Ming,9999,0,9999,0
1656981418869,MATH 197,004,095571,Perols; Johan Lars,9998,0,9999,1
1656981425928,COGS 9,A01,083615,Shannon; Kyle Michael,7,0,75,68
1656981431951,COGS 11,A01,083617,Boyle; Mary E. T.,20,0,48,28
1656981437978,COGS 13,A01,083071,Bastos; Amalia Pinkusfeld,9,0,71,62
1656981444004,COGS 14A,A01,092681,Semenuks; Arturs,0,1,100,100
1656981450033,COGS 14B,A01,083073,Cheng; Tzu-Han,5,0,63,58
1656981456062,COGS 17,A01,092677,Semenuks; Arturs,4,0,81,77
1656981462089,COGS 100,A01,083619,Allen; Michael Gordon,15,0,70,55
1656981468116,COGS 101A,A01,083621,Davis; Joshua Daniel,9,0,68,59
1656981474143,COGS 101B,A01,091572,Allen; Michael Gordon,8,0,65,57
1656981480166,COGS 101C,A01,083625,Delgado; Tania,17,0,35,18
1656981486189,COGS 107A,A01,083627,Boyle; Mary E. T.,13,0,60,47
1656981492212,COGS 118A,A01,083075,Gupta; Anjum,15,0,76,61
1656981498239,CSE 3,A50,083646,Miranda; Gregory Joseph,22,0,50,28
1656981504262,CSE 8A,A50,083650,Miranda; Gregory Joseph,17,1,56,39
1656981510285,CSE 11,A01,083080,Cao; Yingjun,4,15,40,36
1656981516307,CSE 12,A01,083652,Krause-Levy; Sophia Louisa,20,1,120,100
1656981522330,CSE 15L,A01,083654,Morris; Justin Loren,8,0,50,42
1656981522330,CSE 15L,A02,083655,Morris; Justin Loren,8,0,50,42
1656981528358,CSE 20,A01,083657,Tran; Khoa Dang,37,0,80,43
1656981534386,CSE 21,A01,095574,Bach; Quang Tran,21,0,48,27
1656981540408,CSE 30,A01,083084,Eldon; John,4,0,80,76
1656981540408,CSE 30,B01,095061,Bhaskar; Nishant,6,0,50,44
1656981546435,CSE 100,A01,083659,Cao; Yingjun,3,4,70,67
1656981552548,CSE 134B,A01,083661,Powell; Thomas Allan,19,0,100,81
1656981558572,CSE 140,A01,083663,Gungor; Onat,14,0,85,71
1656981564596,CSE 140L,A01,083088,Eldon; John,16,0,100,84
1656981570623,CSE 175,A01,083665,Kumar; Rakesh,3,0,25,22
1656981576650,CSE 190,A00,092507,Dubnov; Shlomo,7,0,20,13
1656981582678,ECE 45,A01,083139,Congero; Spencer William,5,0,75,70
1656981588702,ECE 65,A50,083695,Saad; Andrew S,12,0,30,18
1656981588702,ECE 65,A51,095125,Saad; Andrew S,25,0,26,1
1656981594725,ECE 109,A01,091882,Touri; Behrouz,16,0,70,54
1656981600749,ECE 180,A00,083140,Abi Samra; Nicholas Camill,1,0,30,29
1656981600749,ECE 180,B00,083141,Abi Samra; Nicholas Camill,0,0,30,30
1656981606792,MATH 10A,A01,083735,Patchell; Gregory David,1,0,30,29
1656981606792,MATH 10A,A02,083736,Patchell; Gregory David,20,0,30,10
1656981606792,MATH 10A,A03,083737,Patchell; Gregory David,15,0,30,15
1656981612817,MATH 10B,A01,083207,Lim; Seonhee,7,0,34,27
1656981612817,MATH 10B,A02,083208,Lim; Seonhee,9,0,35,26
1656981612817,MATH 10B,A03,093472,Lim; Seonhee,4,0,34,30
1656981612817,MATH 10B,B01,083739,Sinha; Shubham,9,0,30,21
1656981618842,MATH 18,A01,083743,Cinel; Cameron Alexander,6,0,30,24
1656981618842,MATH 18,A02,083744,Cinel; Cameron Alexander,15,0,30,15
1656981618842,MATH 18,A03,083745,Cinel; Cameron Alexander,8,0,30,22
1656981618842,MATH 18,B01,083748,Rideout; David Porter,4,0,37,33
1656981618842,MATH 18,B02,083749,Rideout; David Porter,3,0,36,33
1656981618842,MATH 18,B03,083750,Rideout; David Porter,2,0,37,35
1656981618842,MATH 18,B04,083751,Rideout; David Porter,5,0,36,31
1656981618842,MATH 18,B05,093473,Rideout; David Porter,4,0,36,32
1656981618842,MATH 18,B06,093474,Rideout; David Porter,5,0,36,31
1656981624878,MATH 20A,A01,083754,Zheng; Zequn,12,0,40,28
1656981630905,MATH 20B,A01,083756,Briones; Jor-el Thomas Caparas,1,0,36,35
1656981630905,MATH 20B,A02,083757,Briones; Jor-el Thomas Caparas,1,0,36,35
1656981630905,MATH 20B,A03,093475,Briones; Jor-el Thomas Caparas,0,0,36,36
1656981636929,MATH 20C,A01,083760,Briones; Jor-el Thomas Caparas,1,0,35,34
1656981636929,MATH 20C,A02,083761,Briones; Jor-el Thomas Caparas,8,0,35,27
1656981636929,MATH 20C,A03,093476,Briones; Jor-el Thomas Caparas,0,1,36,36
1656981636929,MATH 20C,B01,083762,Bach; Quang Tran,0,0,30,30
1656981642953,MATH 20D,A01,083765,Tran; Brian Kha,4,0,30,26
1656981642953,MATH 20D,A02,083766,Tran; Brian Kha,4,0,30,26
1656981642953,MATH 20D,A03,083767,Tran; Brian Kha,3,0,30,27
1656981648981,MATH 20E,A01,083771,Ganguly; Soumya,5,0,32,27
1656981648981,MATH 20E,A02,083772,Ganguly; Soumya,6,0,32,26
1656981648981,MATH 20E,B01,083773,Ciotti; Benjamin,18,0,35,17
1656981648981,MATH 20E,B02,083774,Ciotti; Benjamin,17,0,35,18
1656981655005,MATH 103A,A01,083777,Greenfeld; Be'Eri,2,0,36,34
1656981655005,MATH 103A,A02,083778,Greenfeld; Be'Eri,5,0,36,31
1656981655005,MATH 103A,A03,093561,Greenfeld; Be'Eri,4,0,36,32
1656981655005,MATH 103A,B01,083779,Greenfeld; Be'Eri,6,0,36,30
1656981655005,MATH 103A,B02,083780,Greenfeld; Be'Eri,2,0,36,34
1656981655005,MATH 103A,B03,093562,Greenfeld; Be'Eri,2,0,36,34
1656981661030,MATH 105,A01,085443,Carter; Anne Toulson,14,0,35,21
1656981661030,MATH 105,A02,093477,Carter; Anne Toulson,20,0,35,15
1656981667053,MATH 109,A01,083213,Ganzberger; Geoffrey Michael,2,0,34,32
1656981667053,MATH 109,A02,083214,Ganzberger; Geoffrey Michael,2,0,34,32
1656981667053,MATH 109,A03,093478,Ganzberger; Geoffrey Michael,1,0,34,33
1656981667053,MATH 109,B01,083215,Ganzberger; Geoffrey Michael,1,0,32,31
1656981667053,MATH 109,B02,083216,Ganzberger; Geoffrey Michael,1,0,32,31
1656981667053,MATH 109,B03,093479,Ganzberger; Geoffrey Michael,6,0,32,26
1656981673078,MATH 142A,A01,083219,Chow; Bennett,6,0,32,26
1656981673078,MATH 142A,A02,083220,Chow; Bennett,10,0,32,22
1656981673078,MATH 142A,A03,093480,Chow; Bennett,7,0,32,25
1656981673078,MATH 142A,B03,093481,Chow; Bennett,7,0,32,25
1656981673078,MATH 142A,B04,093558,Chow; Bennett,11,0,32,21
1656981673078,MATH 142A,B05,093559,Chow; Bennett,6,0,32,26
1656981679106,MATH 193A,A01,083224,Rotar; Vladimir,7,0,34,27
1656981679106,MATH 193A,A02,083225,Rotar; Vladimir,4,0,34,30
1656981679106,MATH 193A,A03,083781,Rotar; Vladimir,1,0,34,33
1656981679106,MATH 193A,A04,083782,Rotar; Vladimir,6,0,34,28
1656981679106,MATH 193A,A05,093482,Rotar; Vladimir,6,0,34,28
1656981685131,MATH 197,001,091859,McAuley; Julian John,9999,0,9999,0
1656981685131,MATH 197,002,095566,Kedlaya; Kiran S.,9997,0,9999,2
1656981685131,MATH 197,003,095567,Xiao; Ming,9999,0,9999,0
1656981685131,MATH 197,004,095571,Perols; Johan Lars,9998,0,9999,1
1656981692197,COGS 9,A01,083615,Shannon; Kyle Michael,7,0,75,68
1656981698224,COGS 11,A01,083617,Boyle; Mary E. T.,20,0,48,28
1656981704249,COGS 13,A01,083071,Bastos; Amalia Pinkusfeld,9,0,71,62
1656981710272,COGS 14A,A01,092681,Semenuks; Arturs,0,1,100,100
1656981716297,COGS 14B,A01,083073,Cheng; Tzu-Han,5,0,63,58
1656981722324,COGS 17,A01,092677,Semenuks; Arturs,4,0,81,77
1656981728349,COGS 100,A01,083619,Allen; Michael Gordon,15,0,70,55
1656981734373,COGS 101A,A01,083621,Davis; Joshua Daniel,9,0,68,59
1656981740397,COGS 101B,A01,091572,Allen; Michael Gordon,8,0,65,57
1656981746432,COGS 101C,A01,083625,Delgado; Tania,17,0,35,18
1656981752456,COGS 107A,A01,083627,Boyle; Mary E. T.,13,0,60,47
1656981758479,COGS 118A,A01,083075,Gupta; Anjum,15,0,76,61
1656981764508,CSE 3,A50,083646,Miranda; Gregory Joseph,22,0,50,28
1656981770532,CSE 8A,A50,083650,Miranda; Gregory Joseph,17,1,56,39
1656981776556,CSE 11,A01,083080,Cao; Yingjun,4,15,40,36
1656981782579,CSE 12,A01,083652,Krause-Levy; Sophia Louisa,20,1,120,100
1656981788607,CSE 15L,A01,083654,Morris; Justin Loren,8,0,50,42
1656981788607,CSE 15L,A02,083655,Morris; Justin Loren,8,0,50,42
1656981794632,CSE 20,A01,083657,Tran; Khoa Dang,37,0,80,43
1656981800655,CSE 21,A01,095574,Bach; Quang Tran,21,0,48,27
1656981806683,CSE 30,A01,083084,Eldon; John,4,0,80,76
1656981806683,CSE 30,B01,095061,Bhaskar; Nishant,6,0,50,44
1656981812711,CSE 100,A01,083659,Cao; Yingjun,3,4,70,67
1656981818738,CSE 134B,A01,083661,Powell; Thomas Allan,19,0,100,81
1656981824764,CSE 140,A01,083663,Gungor; Onat,14,0,85,71
1656981830793,CSE 140L,A01,083088,Eldon; John,16,0,100,84
1656981836816,CSE 175,A01,083665,Kumar; Rakesh,3,0,25,22
1656981842842,CSE 190,A00,092507,Dubnov; Shlomo,7,0,20,13
1656981848865,ECE 45,A01,083139,Congero; Spencer William,5,0,75,70
1656981854897,ECE 65,A50,083695,Saad; Andrew S,12,0,30,18
1656981854897,ECE 65,A51,095125,Saad; Andrew S,25,0,26,1
1656981860922,ECE 109,A01,091882,Touri; Behrouz,16,0,70,54
1656981866960,ECE 180,A00,083140,Abi Samra; Nicholas Camill,1,0,30,29
1656981866960,ECE 180,B00,083141,Abi Samra; Nicholas Camill,0,0,30,30
1656981872983,MATH 10A,A01,083735,Patchell; Gregory David,1,0,30,29
1656981872983,MATH 10A,A02,083736,Patchell; Gregory David,20,0,30,10
1656981872983,MATH 10A,A03,083737,Patchell; Gregory David,15,0,30,15
1656981879010,MATH 10B,A01,083207,Lim; Seonhee,7,0,34,27
1656981879010,MATH 10B,A02,083208,Lim; Seonhee,9,0,35,26
1656981879010,MATH 10B,A03,093472,Lim; Seonhee,4,0,34,30
1656981879010,MATH 10B,B01,083739,Sinha; Shubham,9,0,30,21
1656981885038,MATH 18,A01,083743,Cinel; Cameron Alexander,6,0,30,24
1656981885038,MATH 18,A02,083744,Cinel; Cameron Alexander,15,0,30,15
1656981885038,MATH 18,A03,083745,Cinel; Cameron Alexander,8,0,30,22
1656981885038,MATH 18,B01,083748,Rideout; David Porter,4,0,37,33
1656981885038,MATH 18,B02,083749,Rideout; David Porter,3,0,36,33
1656981885038,MATH 18,B03,083750,Rideout; David Porter,2,0,37,35
1656981885038,MATH 18,B04,083751,Rideout; David Porter,5,0,36,31
1656981885038,MATH 18,B05,093473,Rideout; David Porter,4,0,36,32
1656981885038,MATH 18,B06,093474,Rideout; David Porter,5,0,36,31
1656981891061,MATH 20A,A01,083754,Zheng; Zequn,12,0,40,28
1656981897085,MATH 20B,A01,083756,Briones; Jor-el Thomas Caparas,1,0,36,35
1656981897085,MATH 20B,A02,083757,Briones; Jor-el Thomas Caparas,1,0,36,35
1656981897085,MATH 20B,A03,093475,Briones; Jor-el Thomas Caparas,0,0,36,36
1656981903109,MATH 20C,A01,083760,Briones; Jor-el Thomas Caparas,1,0,35,34
1656981903109,MATH 20C,A02,083761,Briones; Jor-el Thomas Caparas,8,0,35,27
1656981903109,MATH 20C,A03,093476,Briones; Jor-el Thomas Caparas,0,1,36,36
1656981903109,MATH 20C,B01,083762,Bach; Quang Tran,0,0,30,30
1656981909132,MATH 20D,A01,083765,Tran; Brian Kha,4,0,30,26
1656981909132,MATH 20D,A02,083766,Tran; Brian Kha,4,0,30,26
1656981909132,MATH 20D,A03,083767,Tran; Brian Kha,3,0,30,27
1656981915161,MATH 20E,A01,083771,Ganguly; Soumya,5,0,32,27
1656981915161,MATH 20E,A02,083772,Ganguly; Soumya,6,0,32,26
1656981915161,MATH 20E,B01,083773,Ciotti; Benjamin,18,0,35,17
1656981915161,MATH 20E,B02,083774,Ciotti; Benjamin,17,0,35,18
1656981921186,MATH 103A,A01,083777,Greenfeld; Be'Eri,2,0,36,34
1656981921186,MATH 103A,A02,083778,Greenfeld; Be'Eri,5,0,36,31
1656981921186,MATH 103A,A03,093561,Greenfeld; Be'Eri,4,0,36,32
1656981921186,MATH 103A,B01,083779,Greenfeld; Be'Eri,6,0,36,30
1656981921186,MATH 103A,B02,083780,Greenfeld; Be'Eri,2,0,36,34
1656981921186,MATH 103A,B03,093562,Greenfeld; Be'Eri,2,0,36,34
1656981927215,MATH 105,A01,085443,Carter; Anne Toulson,14,0,35,21
1656981927215,MATH 105,A02,093477,Carter; Anne Toulson,20,0,35,15
1656981933239,MATH 109,A01,083213,Ganzberger; Geoffrey Michael,2,0,34,32
1656981933239,MATH 109,A02,083214,Ganzberger; Geoffrey Michael,2,0,34,32
1656981933239,MATH 109,A03,093478,Ganzberger; Geoffrey Michael,1,0,34,33
1656981933239,MATH 109,B01,083215,Ganzberger; Geoffrey Michael,1,0,32,31
1656981933239,MATH 109,B02,083216,Ganzberger; Geoffrey Michael,1,0,32,31
1656981933239,MATH 109,B03,093479,Ganzberger; Geoffrey Michael,6,0,32,26
1656981939266,MATH 142A,A01,083219,Chow; Bennett,6,0,32,26
1656981939266,MATH 142A,A02,083220,Chow; Bennett,10,0,32,22
1656981939266,MATH 142A,A03,093480,Chow; Bennett,7,0,32,25
1656981939266,MATH 142A,B03,093481,Chow; Bennett,7,0,32,25
1656981939266,MATH 142A,B04,093558,Chow; Bennett,11,0,32,21
1656981939266,MATH 142A,B05,093559,Chow; Bennett,6,0,32,26
1656981945300,MATH 193A,A01,083224,Rotar; Vladimir,7,0,34,27
1656981945300,MATH 193A,A02,083225,Rotar; Vladimir,4,0,34,30
1656981945300,MATH 193A,A03,083781,Rotar; Vladimir,1,0,34,33
1656981945300,MATH 193A,A04,083782,Rotar; Vladimir,6,0,34,28
1656981945300,MATH 193A,A05,093482,Rotar; Vladimir,6,0,34,28
1656981951325,MATH 197,001,091859,McAuley; Julian John,9999,0,9999,0
1656981951325,MATH 197,002,095566,Kedlaya; Kiran S.,9997,0,9999,2
1656981951325,MATH 197,003,095567,Xiao; Ming,9999,0,9999,0
1656981951325,MATH 197,004,095571,Perols; Johan Lars,9998,0,9999,1
1656981958381,COGS 9,A01,083615,Shannon; Kyle Michael,7,0,75,68
1656981964405,COGS 11,A01,083617,Boyle; Mary E. T.,20,0,48,28
1656981970433,COGS 13,A01,083071,Bastos; Amalia Pinkusfeld,9,0,71,62
1656981976456,COGS 14A,A01,092681,Semenuks; Arturs,0,1,100,100
1656981982483,COGS 14B,A01,083073,Cheng; Tzu-Han,5,0,63,58
1656981988507,COGS 17,A01,092677,Semenuks; Arturs,4,0,81,77
1656981994535,COGS 100,A01,083619,Allen; Michael Gordon,15,0,70,55
1656982000562,COGS 101A,A01,083621,Davis; Joshua Daniel,9,0,68,59
1656982006585,COGS 101B,A01,091572,Allen; Michael Gordon,8,0,65,57
1656982012610,COGS 101C,A01,083625,Delgado; Tania,17,0,35,18
1656982018644,COGS 107A,A01,083627,Boyle; Mary E. T.,13,0,60,47
1656982024668,COGS 118A,A01,083075,Gupta; Anjum,15,0,76,61
1656982030692,CSE 3,A50,083646,Miranda; Gregory Joseph,22,0,50,28
1656982036721,CSE 8A,A50,083650,Miranda; Gregory Joseph,17,1,56,39
1656982042744,CSE 11,A01,083080,Cao; Yingjun,4,15,40,36
1656982048771,CSE 12,A01,083652,Krause-Levy; Sophia Louisa,20,1,120,100
1656982054797,CSE 15L,A01,083654,Morris; Justin Loren,8,0,50,42
1656982054797,CSE 15L,A02,083655,Morris; Justin Loren,8,0,50,42
1656982060819,CSE 20,A01,083657,Tran; Khoa Dang,37,0,80,43
1656982066845,CSE 21,A01,095574,Bach; Quang Tran,21,0,48,27
1656982072873,CSE 30,A01,083084,Eldon; John,4,0,80,76
1656982072873,CSE 30,B01,095061,Bhaskar; Nishant,6,0,50,44
1656982078896,CSE 100,A01,083659,Cao; Yingjun,3,4,70,67
1656982084919,CSE 134B,A01,083661,Powell; Thomas Allan,19,0,100,81
1656982091038,CSE 140,A01,083663,Gungor; Onat,14,0,85,71
1656982097065,CSE 140L,A01,083088,Eldon; John,16,0,100,84
1656982103092,CSE 175,A01,083665,Kumar; Rakesh,3,0,25,22
1656982109113,CSE 190,A00,092507,Dubnov; Shlomo,7,0,20,13
1656982115138,ECE 45,A01,083139,Congero; Spencer William,5,0,75,70
1656982121165,ECE 65,A50,083695,Saad; Andrew S,12,0,30,18
1656982121165,ECE 65,A51,095125,Saad; Andrew S,25,0,26,1
1656982127189,ECE 109,A01,091882,Touri; Behrouz,16,0,70,54
1656982133212,ECE 180,A00,083140,Abi Samra; Nicholas Camill,1,0,30,29
1656982133212,ECE 180,B00,083141,Abi Samra; Nicholas Camill,0,0,30,30
1656982139236,MATH 10A,A01,083735,Patchell; Gregory David,1,0,30,29
1656982139236,MATH 10A,A02,083736,Patchell; Gregory David,20,0,30,10
1656982139236,MATH 10A,A03,083737,Patchell; Gregory David,15,0,30,15
1656982145260,MATH 10B,A01,083207,Lim; Seonhee,7,0,34,27
1656982145260,MATH 10B,A02,083208,Lim; Seonhee,9,0,35,26
1656982145260,MATH 10B,A03,093472,Lim; Seonhee,4,0,34,30
1656982145260,MATH 10B,B01,083739,Sinha; Shubham,9,0,30,21
1656982151417,MATH 18,A01,083743,Cinel; Cameron Alexander,6,0,30,24
1656982151417,MATH 18,A02,083744,Cinel; Cameron Alexander,15,0,30,15
1656982151417,MATH 18,A03,083745,Cinel; Cameron Alexander,8,0,30,22
1656982151417,MATH 18,B01,083748,Rideout; David Porter,4,0,37,33
1656982151417,MATH 18,B02,083749,Rideout; David Porter,3,0,36,33
1656982151417,MATH 18,B03,083750,Rideout; David Porter,2,0,37,35
1656982151417,MATH 18,B04,083751,Rideout; David Porter,5,0,36,31
1656982151417,MATH 18,B05,093473,Rideout; David Porter,4,0,36,32
1656982151417,MATH 18,B06,093474,Rideout; David Porter,5,0,36,31
1656982157443,MATH 20A,A01,083754,Zheng; Zequn,12,0,40,28
1656982163472,MATH 20B,A01,083756,Briones; Jor-el Thomas Caparas,1,0,36,35
1656982163472,MATH 20B,A02,083757,Briones; Jor-el Thomas Caparas,1,0,36,35
1656982163472,MATH 20B,A03,093475,Briones; Jor-el Thomas Caparas,0,0,36,36
1656982169496,MATH 20C,A01,083760,Briones; Jor-el Thomas Caparas,1,0,35,34
1656982169496,MATH 20C,A02,083761,Briones; Jor-el Thomas Caparas,8,0,35,27
1656982169496,MATH 20C,A03,093476,Briones; Jor-el Thomas Caparas,0,1,36,36
1656982169496,MATH 20C,B01,083762,Bach; Quang Tran,0,0,30,30
1656982175521,MATH 20D,A01,083765,Tran; Brian Kha,4,0,30,26
1656982175521,MATH 20D,A02,083766,Tran; Brian Kha,4,0,30,26
1656982175521,MATH 20D,A03,083767,Tran; Brian Kha,3,0,30,27
1656982181550,MATH 20E,A01,083771,Ganguly; Soumya,5,0,32,27
1656982181550,MATH 20E,A02,083772,Ganguly; Soumya,6,0,32,26
1656982181550,MATH 20E,B01,083773,Ciotti; Benjamin,18,0,35,17
1656982181550,MATH 20E,B02,083774,Ciotti; Benjamin,17,0,35,18
1656982187580,MATH 103A,A01,083777,Greenfeld; Be'Eri,2,0,36,34
1656982187580,MATH 103A,A02,083778,Greenfeld; Be'Eri,5,0,36,31
1656982187580,MATH 103A,A03,093561,Greenfeld; Be'Eri,4,0,36,32
1656982187580,MATH 103A,B01,083779,Greenfeld; Be'Eri,6,0,36,30
1656982187580,MATH 103A,B02,083780,Greenfeld; Be'Eri,2,0,36,34
1656982187580,MATH 103A,B03,093562,Greenfeld; Be'Eri,2,0,36,34
1656982193601,MATH 105,A01,085443,Carter; Anne Toulson,14,0,35,21
1656982193601,MATH 105,A02,093477,Carter; Anne Toulson,20,0,35,15
1656982199624,MATH 109,A01,083213,Ganzberger; Geoffrey Michael,2,0,34,32
1656982199624,MATH 109,A02,083214,Ganzberger; Geoffrey Michael,2,0,34,32
1656982199624,MATH 109,A03,093478,Ganzberger; Geoffrey Michael,1,0,34,33
1656982199624,MATH 109,B01,083215,Ganzberger; Geoffrey Michael,1,0,32,31
1656982199624,MATH 109,B02,083216,Ganzberger; Geoffrey Michael,1,0,32,31
1656982199624,MATH 109,B03,093479,Ganzberger; Geoffrey Michael,6,0,32,26
1656982205652,MATH 142A,A01,083219,Chow; Bennett,6,0,32,26
1656982205652,MATH 142A,A02,083220,Chow; Bennett,10,0,32,22
1656982205652,MATH 142A,A03,093480,Chow; Bennett,7,0,32,25
1656982205652,MATH 142A,B03,093481,Chow; Bennett,7,0,32,25
1656982205652,MATH 142A,B04,093558,Chow; Bennett,11,0,32,21
1656982205652,MATH 142A,B05,093559,Chow; Bennett,6,0,32,26
1656982211681,MATH 193A,A01,083224,Rotar; Vladimir,7,0,34,27
1656982211681,MATH 193A,A02,083225,Rotar; Vladimir,4,0,34,30
1656982211681,MATH 193A,A03,083781,Rotar; Vladimir,1,0,34,33
1656982211681,MATH 193A,A04,083782,Rotar; Vladimir,6,0,34,28
1656982211681,MATH 193A,A05,093482,Rotar; Vladimir,6,0,34,28
1656982217704,MATH 197,001,091859,McAuley; Julian John,9999,0,9999,0
1656982217704,MATH 197,002,095566,Kedlaya; Kiran S.,9997,0,9999,2
1656982217704,MATH 197,003,095567,Xiao; Ming,9999,0,9999,0
1656982217704,MATH 197,004,095571,Perols; Johan Lars,9998,0,9999,1
1656982224758,COGS 9,A01,083615,Shannon; Kyle Michael,7,0,75,68
1656982230781,COGS 11,A01,083617,Boyle; Mary E. T.,20,0,48,28
1656982236809,COGS 13,A01,083071,Bastos; Amalia Pinkusfeld,9,0,71,62
1656982242836,COGS 14A,A01,092681,Semenuks; Arturs,0,1,100,100
1656982248862,COGS 14B,A01,083073,Cheng; Tzu-Han,5,0,63,58
1656982254888,COGS 17,A01,092677,Semenuks; Arturs,4,0,81,77
1656982260916,COGS 100,A01,083619,Allen; Michael Gordon,15,0,70,55
1656982266947,COGS 101A,A01,083621,Davis; Joshua Daniel,9,0,68,59
1656982272974,COGS 101B,A01,091572,Allen; Michael Gordon,8,0,65,57
1656982278999,COGS 101C,A01,083625,Delgado; Tania,17,0,35,18
1656982285023,COGS 107A,A01,083627,Boyle; Mary E. T.,13,0,60,47
1656982291047,COGS 118A,A01,083075,Gupta; Anjum,15,0,76,61
1656982297070,CSE 3,A50,083646,Miranda; Gregory Joseph,22,0,50,28
1656982303097,CSE 8A,A50,083650,Miranda; Gregory Joseph,17,1,56,39
1656982309123,CSE 11,A01,083080,Cao; Yingjun,4,15,40,36
1656982315148,CSE 12,A01,083652,Krause-Levy; Sophia Louisa,20,1,120,100
1656982321171,CSE 15L,A01,083654,Morris; Justin Loren,8,0,50,42
1656982321171,CSE 15L,A02,083655,Morris; Justin Loren,8,0,50,42
1656982327197,CSE 20,A01,083657,Tran; Khoa Dang,37,0,80,43
1656982333222,CSE 21,A01,095574,Bach; Quang Tran,21,0,48,27
1656982339245,CSE 30,A01,083084,Eldon; John,4,0,80,76
1656982339245,CSE 30,B01,095061,Bhaskar; Nishant,6,0,50,44
1656982345269,CSE 100,A01,083659,Cao; Yingjun,3,4,70,67
1656982351292,CSE 134B,A01,083661,Powell; Thomas Allan,19,0,100,81
1656982357319,CSE 140,A01,083663,Gungor; Onat,14,0,85,71
1656982363346,CSE 140L,A01,083088,Eldon; John,16,0,100,84
1656982369367,CSE 175,A01,083665,Kumar; Rakesh,3,0,25,22
1656982375390,CSE 190,A00,092507,Dubnov; Shlomo,7,0,20,13
1656982381414,ECE 45,A01,083139,Congero; Spencer William,5,0,75,70
1656982387439,ECE 65,A50,083695,Saad; Andrew S,12,0,30,18
1656982387439,ECE 65,A51,095125,Saad; Andrew S,25,0,26,1
1656982393465,ECE 109,A01,091882,Touri; Behrouz,16,0,70,54
1656982399490,ECE 180,A00,083140,Abi Samra; Nicholas Camill,1,0,30,29
1656982399490,ECE 180,B00,083141,Abi Samra; Nicholas Camill,0,0,30,30
1656982405513,MATH 10A,A01,083735,Patchell; Gregory David,1,0,30,29
1656982405513,MATH 10A,A02,083736,Patchell; Gregory David,20,0,30,10
1656982405513,MATH 10A,A03,083737,Patchell; Gregory David,15,0,30,15
1656982411537,MATH 10B,A01,083207,Lim; Seonhee,7,0,34,27
1656982411537,MATH 10B,A02,083208,Lim; Seonhee,9,0,35,26
1656982411537,MATH 10B,A03,093472,Lim; Seonhee,4,0,34,30
1656982411537,MATH 10B,B01,083739,Sinha; Shubham,9,0,30,21
1656982417569,MATH 18,A01,083743,Cinel; Cameron Alexander,6,0,30,24
1656982417569,MATH 18,A02,083744,Cinel; Cameron Alexander,15,0,30,15
1656982417569,MATH 18,A03,083745,Cinel; Cameron Alexander,8,0,30,22
1656982417569,MATH 18,B01,083748,Rideout; David Porter,4,0,37,33
1656982417569,MATH 18,B02,083749,Rideout; David Porter,3,0,36,33
1656982417569,MATH 18,B03,083750,Rideout; David Porter,2,0,37,35
1656982417569,MATH 18,B04,083751,Rideout; David Porter,5,0,36,31
1656982417569,MATH 18,B05,093473,Rideout; David Porter,4,0,36,32
1656982417569,MATH 18,B06,093474,Rideout; David Porter,5,0,36,31
1656982423594,MATH 20A,A01,083754,Zheng; Zequn,12,0,40,28
1656982429616,MATH 20B,A01,083756,Briones; Jor-el Thomas Caparas,1,0,36,35
1656982429616,MATH 20B,A02,083757,Briones; Jor-el Thomas Caparas,1,0,36,35
1656982429616,MATH 20B,A03,093475,Briones; Jor-el Thomas Caparas,0,0,36,36
1656982435641,MATH 20C,A01,083760,Briones; Jor-el Thomas Caparas,1,0,35,34
1656982435641,MATH 20C,A02,083761,Briones; Jor-el Thomas Caparas,8,0,35,27
1656982435641,MATH 20C,A03,093476,Briones; Jor-el Thomas Caparas,0,1,36,36
1656982435641,MATH 20C,B01,083762,Bach; Quang Tran,0,0,30,30
1656982441664,MATH 20D,A01,083765,Tran; Brian Kha,4,0,30,26
1656982441664,MATH 20D,A02,083766,Tran; Brian Kha,4,0,30,26
1656982441664,MATH 20D,A03,083767,Tran; Brian Kha,3,0,30,27
1656982447691,MATH 20E,A01,083771,Ganguly; Soumya,5,0,32,27
1656982447691,MATH 20E,A02,083772,Ganguly; Soumya,6,0,32,26
1656982447691,MATH 20E,B01,083773,Ciotti; Benjamin,18,0,35,17
1656982447691,MATH 20E,B02,083774,Ciotti; Benjamin,17,0,35,18
1656982453714,MATH 103A,A01,083777,Greenfeld; Be'Eri,2,0,36,34
1656982453714,MATH 103A,A02,083778,Greenfeld; Be'Eri,5,0,36,31
1656982453714,MATH 103A,A03,093561,Greenfeld; Be'Eri,4,0,36,32
1656982453714,MATH 103A,B01,083779,Greenfeld; Be'Eri,6,0,36,30
1656982453714,MATH 103A,B02,083780,Greenfeld; Be'Eri,2,0,36,34
1656982453714,MATH 103A,B03,093562,Greenfeld; Be'Eri,2,0,36,34
1656982459736,MATH 105,A01,085443,Carter; Anne Toulson,14,0,35,21
1656982459736,MATH 105,A02,093477,Carter; Anne Toulson,20,0,35,15
1656982465759,MATH 109,A01,083213,Ganzberger; Geoffrey Michael,2,0,34,32
1656982465759,MATH 109,A02,083214,Ganzberger; Geoffrey Michael,2,0,34,32
1656982465759,MATH 109,A03,093478,Ganzberger; Geoffrey Michael,1,0,34,33
1656982465759,MATH 109,B01,083215,Ganzberger; Geoffrey Michael,1,0,32,31
1656982465759,MATH 109,B02,083216,Ganzberger; Geoffrey Michael,1,0,32,31
1656982465759,MATH 109,B03,093479,Ganzberger; Geoffrey Michael,6,0,32,26
1656982471789,MATH 142A,A01,083219,Chow; Bennett,6,0,32,26
1656982471789,MATH 142A,A02,083220,Chow; Bennett,10,0,32,22
1656982471789,MATH 142A,A03,093480,Chow; Bennett,7,0,32,25
1656982471789,MATH 142A,B03,093481,Chow; Bennett,7,0,32,25
1656982471789,MATH 142A,B04,093558,Chow; Bennett,11,0,32,21
1656982471789,MATH 142A,B05,093559,Chow; Bennett,6,0,32,26
1656982477810,MATH 193A,A01,083224,Rotar; Vladimir,7,0,34,27
1656982477810,MATH 193A,A02,083225,Rotar; Vladimir,4,0,34,30
1656982477810,MATH 193A,A03,083781,Rotar; Vladimir,1,0,34,33
1656982477810,MATH 193A,A04,083782,Rotar; Vladimir,6,0,34,28
1656982477810,MATH 193A,A05,093482,Rotar; Vladimir,6,0,34,28
1656982483833,MATH 197,001,091859,McAuley; Julian John,9999,0,9999,0
1656982483833,MATH 197,002,095566,Kedlaya; Kiran S.,9997,0,9999,2
1656982483833,MATH 197,003,095567,Xiao; Ming,9999,0,9999,0
1656982483833,MATH 197,004,095571,Perols; Johan Lars,9998,0,9999,1
1656982490897,COGS 9,A01,083615,Shannon; Kyle Michael,7,0,75,68
1656982496919,COGS 11,A01,083617,Boyle; Mary E. T.,20,0,48,28
1656982502942,COGS 13,A01,083071,Bastos; Amalia Pinkusfeld,9,0,71,62
1656982508970,COGS 14A,A01,092681,Semenuks; Arturs,0,1,100,100
1656982514993,COGS 14B,A01,083073,Cheng; Tzu-Han,5,0,63,58
1656982521016,COGS 17,A01,092677,Semenuks; Arturs,4,0,81,77
1656982527044,COGS 100,A01,083619,Allen; Michael Gordon,15,0,70,55
1656982533066,COGS 101A,A01,083621,Davis; Joshua Daniel,9,0,68,59
1656982539090,COGS 101B,A01,091572,Allen; Michael Gordon,8,0,65,57
1656982545115,COGS 101C,A01,083625,Delgado; Tania,17,0,35,18
1656982551137,COGS 107A,A01,083627,Boyle; Mary E. T.,13,0,60,47
1656982557160,COGS 118A,A01,083075,Gupta; Anjum,15,0,76,61
1656982563190,CSE 3,A50,083646,Miranda; Gregory Joseph,22,0,50,28
1656982569217,CSE 8A,A50,083650,Miranda; Gregory Joseph,17,1,56,39
1656982575242,CSE 11,A01,083080,Cao; Yingjun,4,15,40,36
1656982581270,CSE 12,A01,083652,Krause-Levy; Sophia Louisa,20,1,120,100
1656982587298,CSE 15L,A01,083654,Morris; Justin Loren,8,0,50,42
1656982587298,CSE 15L,A02,083655,Morris; Justin Loren,8,0,50,42
1656982593321,CSE 20,A01,083657,Tran; Khoa Dang,37,0,80,43
1656982599344,CSE 21,A01,095574,Bach; Quang Tran,21,0,48,27
1656982605372,CSE 30,A01,083084,Eldon; John,4,0,80,76
1656982605372,CSE 30,B01,095061,Bhaskar; Nishant,6,0,50,44
1656982611399,CSE 100,A01,083659,Cao; Yingjun,3,4,70,67
1656982617427,CSE 134B,A01,083661,Powell; Thomas Allan,19,0,100,81
1656982623477,CSE 140,A01,083663,Gungor; Onat,14,0,85,71
1656982629504,CSE 140L,A01,083088,Eldon; John,16,0,100,84
1656982635531,CSE 175,A01,083665,Kumar; Rakesh,3,0,25,22
1656982641556,CSE 190,A00,092507,Dubnov; Shlomo,7,0,20,13
1656982647582,ECE 45,A01,083139,Congero; Spencer William,5,0,75,70
1656982653629,ECE 65,A50,083695,Saad; Andrew S,12,0,30,18
1656982653629,ECE 65,A51,095125,Saad; Andrew S,25,0,26,1
1656982659655,ECE 109,A01,091882,Touri; Behrouz,16,0,70,54
1656982665677,ECE 180,A00,083140,Abi Samra; Nicholas Camill,1,0,30,29
1656982665677,ECE 180,B00,083141,Abi Samra; Nicholas Camill,0,0,30,30
1656982671705,MATH 10A,A01,083735,Patchell; Gregory David,1,0,30,29
1656982671705,MATH 10A,A02,083736,Patchell; Gregory David,20,0,30,10
1656982671705,MATH 10A,A03,083737,Patchell; Gregory David,15,0,30,15
1656982677728,MATH 10B,A01,083207,Lim; Seonhee,7,0,34,27
1656982677728,MATH 10B,A02,083208,Lim; Seonhee,9,0,35,26
1656982677728,MATH 10B,A03,093472,Lim; Seonhee,4,0,34,30
1656982677728,MATH 10B,B01,083739,Sinha; Shubham,9,0,30,21
1656982683760,MATH 18,A01,083743,Cinel; Cameron Alexander,6,0,30,24
1656982683760,MATH 18,A02,083744,Cinel; Cameron Alexander,15,0,30,15
1656982683760,MATH 18,A03,083745,Cinel; Cameron Alexander,8,0,30,22
1656982683760,MATH 18,B01,083748,Rideout; David Porter,4,0,37,33
1656982683760,MATH 18,B02,083749,Rideout; David Porter,3,0,36,33
1656982683760,MATH 18,B03,083750,Rideout; David Porter,2,0,37,35
1656982683760,MATH 18,B04,083751,Rideout; David Porter,5,0,36,31
1656982683760,MATH 18,B05,093473,Rideout; David Porter,4,0,36,32
1656982683760,MATH 18,B06,093474,Rideout; David Porter,5,0,36,31
1656982689785,MATH 20A,A01,083754,Zheng; Zequn,12,0,40,28
1656982695812,MATH 20B,A01,083756,Briones; Jor-el Thomas Caparas,1,0,36,35
1656982695812,MATH 20B,A02,083757,Briones; Jor-el Thomas Caparas,1,0,36,35
1656982695812,MATH 20B,A03,093475,Briones; Jor-el Thomas Caparas,0,0,36,36
1656982701836,MATH 20C,A01,083760,Briones; Jor-el Thomas Caparas,1,0,35,34
1656982701836,MATH 20C,A02,083761,Briones; Jor-el Thomas Caparas,8,0,35,27
1656982701836,MATH 20C,A03,093476,Briones; Jor-el Thomas Caparas,0,1,36,36
1656982701836,MATH 20C,B01,083762,Bach; Quang Tran,0,0,30,30
1656982707861,MATH 20D,A01,083765,Tran; Brian Kha,4,0,30,26
1656982707861,MATH 20D,A02,083766,Tran; Brian Kha,4,0,30,26
1656982707861,MATH 20D,A03,083767,Tran; Brian Kha,3,0,30,27
1656982713885,MATH 20E,A01,083771,Ganguly; Soumya,5,0,32,27
1656982713885,MATH 20E,A02,083772,Ganguly; Soumya,6,0,32,26
1656982713885,MATH 20E,B01,083773,Ciotti; Benjamin,18,0,35,17
1656982713885,MATH 20E,B02,083774,Ciotti; Benjamin,17,0,35,18
1656982719909,MATH 103A,A01,083777,Greenfeld; Be'Eri,2,0,36,34
1656982719909,MATH 103A,A02,083778,Greenfeld; Be'Eri,5,0,36,31
1656982719909,MATH 103A,A03,093561,Greenfeld; Be'Eri,4,0,36,32
1656982719909,MATH 103A,B01,083779,Greenfeld; Be'Eri,6,0,36,30
1656982719909,MATH 103A,B02,083780,Greenfeld; Be'Eri,2,0,36,34
1656982719909,MATH 103A,B03,093562,Greenfeld; Be'Eri,2,0,36,34
1656982725935,MATH 105,A01,085443,Carter; Anne Toulson,14,0,35,21
1656982725935,MATH 105,A02,093477,Carter; Anne Toulson,20,0,35,15
1656982731964,MATH 109,A01,083213,Ganzberger; Geoffrey Michael,2,0,34,32
1656982731964,MATH 109,A02,083214,Ganzberger; Geoffrey Michael,2,0,34,32
1656982731964,MATH 109,A03,093478,Ganzberger; Geoffrey Michael,1,0,34,33
1656982731964,MATH 109,B01,083215,Ganzberger; Geoffrey Michael,1,0,32,31
1656982731964,MATH 109,B02,083216,Ganzberger; Geoffrey Michael,1,0,32,31
1656982731964,MATH 109,B03,093479,Ganzberger; Geoffrey Michael,6,0,32,26
1656982737992,MATH 142A,A01,083219,Chow; Bennett,6,0,32,26
1656982737992,MATH 142A,A02,083220,Chow; Bennett,10,0,32,22
1656982737992,MATH 142A,A03,093480,Chow; Bennett,7,0,32,25
1656982737992,MATH 142A,B03,093481,Chow; Bennett,7,0,32,25
1656982737992,MATH 142A,B04,093558,Chow; Bennett,11,0,32,21
1656982737992,MATH 142A,B05,093559,Chow; Bennett,6,0,32,26
1656982744020,MATH 193A,A01,083224,Rotar; Vladimir,7,0,34,27
1656982744020,MATH 193A,A02,083225,Rotar; Vladimir,4,0,34,30
1656982744020,MATH 193A,A03,083781,Rotar; Vladimir,1,0,34,33
1656982744020,MATH 193A,A04,083782,Rotar; Vladimir,6,0,34,28
1656982744020,MATH 193A,A05,093482,Rotar; Vladimir,6,0,34,28
1656982750119,MATH 197,001,091859,McAuley; Julian John,9999,0,9999,0
1656982750119,MATH 197,002,095566,Kedlaya; Kiran S.,9997,0,9999,2
1656982750119,MATH 197,003,095567,Xiao; Ming,9999,0,9999,0
1656982750119,MATH 197,004,095571,Perols; Johan Lars,9998,0,9999,1
1656982757174,COGS 9,A01,083615,Shannon; Kyle Michael,7,0,75,68
1656982763197,COGS 11,A01,083617,Boyle; Mary E. T.,20,0,48,28
1656982769222,COGS 13,A01,083071,Bastos; Amalia Pinkusfeld,9,0,71,62
1656982775246,COGS 14A,A01,092681,Semenuks; Arturs,0,1,100,100
1656982781280,COGS 14B,A01,083073,Cheng; Tzu-Han,5,0,63,58
1656982787306,COGS 17,A01,092677,Semenuks; Arturs,4,0,81,77
1656982793331,COGS 100,A01,083619,Allen; Michael Gordon,15,0,70,55
1656982799357,COGS 101A,A01,083621,Davis; Joshua Daniel,9,0,68,59
1656982805396,COGS 101B,A01,091572,Allen; Michael Gordon,8,0,65,57
1656982811418,COGS 101C,A01,083625,Delgado; Tania,17,0,35,18
1656982817440,COGS 107A,A01,083627,Boyle; Mary E. T.,13,0,60,47
1656982823462,COGS 118A,A01,083075,Gupta; Anjum,15,0,76,61
1656982829486,CSE 3,A50,083646,Miranda; Gregory Joseph,22,0,50,28
1656982835512,CSE 8A,A50,083650,Miranda; Gregory Joseph,17,1,56,39
1656982841536,CSE 11,A01,083080,Cao; Yingjun,4,15,40,36
1656982847559,CSE 12,A01,083652,Krause-Levy; Sophia Louisa,20,1,120,100
1656982853581,CSE 15L,A01,083654,Morris; Justin Loren,8,0,50,42
1656982853581,CSE 15L,A02,083655,Morris; Justin Loren,8,0,50,42
1656982859605,CSE 20,A01,083657,Tran; Khoa Dang,37,0,80,43
1656982865632,CSE 21,A01,095574,Bach; Quang Tran,21,0,48,27
1656982871654,CSE 30,A01,083084,Eldon; John,4,0,80,76
1656982871654,CSE 30,B01,095061,Bhaskar; Nishant,6,0,50,44
1656982877676,CSE 100,A01,083659,Cao; Yingjun,3,4,70,67
1656982883703,CSE 134B,A01,083661,Powell; Thomas Allan,19,0,100,81
1656982889732,CSE 140,A01,083663,Gungor; Onat,14,0,85,71
1656982895755,CSE 140L,A01,083088,Eldon; John,16,0,100,84
1656982901778,CSE 175,A01,083665,Kumar; Rakesh,3,0,25,22
1656982907801,CSE 190,A00,092507,Dubnov; Shlomo,7,0,20,13
1656982913825,ECE 45,A01,083139,Congero; Spencer William,5,0,75,70
1656982919848,ECE 65,A50,083695,Saad; Andrew S,12,0,30,18
1656982919848,ECE 65,A51,095125,Saad; Andrew S,25,0,26,1
1656982925874,ECE 109,A01,091882,Touri; Behrouz,16,0,70,54
1656982931897,ECE 180,A00,083140,Abi Samra; Nicholas Camill,1,0,30,29
1656982931897,ECE 180,B00,083141,Abi Samra; Nicholas Camill,0,0,30,30
1656982937922,MATH 10A,A01,083735,Patchell; Gregory David,1,0,30,29
1656982937922,MATH 10A,A02,083736,Patchell; Gregory David,20,0,30,10
1656982937922,MATH 10A,A03,083737,Patchell; Gregory David,15,0,30,15
1656982943960,MATH 10B,A01,083207,Lim; Seonhee,7,0,34,27
1656982943960,MATH 10B,A02,083208,Lim; Seonhee,9,0,35,26
1656982943960,MATH 10B,A03,093472,Lim; Seonhee,4,0,34,30
1656982943960,MATH 10B,B01,083739,Sinha; Shubham,9,0,30,21
1656982949992,MATH 18,A01,083743,Cinel; Cameron Alexander,6,0,30,24
1656982949992,MATH 18,A02,083744,Cinel; Cameron Alexander,15,0,30,15
1656982949992,MATH 18,A03,083745,Cinel; Cameron Alexander,8,0,30,22
1656982949992,MATH 18,B01,083748,Rideout; David Porter,4,0,37,33
1656982949992,MATH 18,B02,083749,Rideout; David Porter,3,0,36,33
1656982949992,MATH 18,B03,083750,Rideout; David Porter,2,0,37,35
1656982949992,MATH 18,B04,083751,Rideout; David Porter,5,0,36,31
1656982949992,MATH 18,B05,093473,Rideout; David Porter,4,0,36,32
1656982949992,MATH 18,B06,093474,Rideout; David Porter,5,0,36,31
1656982956013,MATH 20A,A01,083754,Zheng; Zequn,12,0,40,28
1656982962040,MATH 20B,A01,083756,Briones; Jor-el Thomas Caparas,1,0,36,35
1656982962040,MATH 20B,A02,083757,Briones; Jor-el Thomas Caparas,1,0,36,35
1656982962040,MATH 20B,A03,093475,Briones; Jor-el Thomas Caparas,0,0,36,36
1656982968074,MATH 20C,A01,083760,Briones; Jor-el Thomas Caparas,1,0,35,34
1656982968074,MATH 20C,A02,083761,Briones; Jor-el Thomas Caparas,8,0,35,27
1656982968074,MATH 20C,A03,093476,Briones; Jor-el Thomas Caparas,0,1,36,36
1656982968074,MATH 20C,B01,083762,Bach; Quang Tran,0,0,30,30
1656982974098,MATH 20D,A01,083765,Tran; Brian Kha,4,0,30,26
1656982974098,MATH 20D,A02,083766,Tran; Brian Kha,4,0,30,26
1656982974098,MATH 20D,A03,083767,Tran; Brian Kha,3,0,30,27
1656982980120,MATH 20E,A01,083771,Ganguly; Soumya,5,0,32,27
1656982980120,MATH 20E,A02,083772,Ganguly; Soumya,6,0,32,26
1656982980120,MATH 20E,B01,083773,Ciotti; Benjamin,18,0,35,17
1656982980120,MATH 20E,B02,083774,Ciotti; Benjamin,17,0,35,18
1656982986142,MATH 103A,A01,083777,Greenfeld; Be'Eri,2,0,36,34
1656982986142,MATH 103A,A02,083778,Greenfeld; Be'Eri,5,0,36,31
1656982986142,MATH 103A,A03,093561,Greenfeld; Be'Eri,4,0,36,32
1656982986142,MATH 103A,B01,083779,Greenfeld; Be'Eri,6,0,36,30
1656982986142,MATH 103A,B02,083780,Greenfeld; Be'Eri,2,0,36,34
1656982986142,MATH 103A,B03,093562,Greenfeld; Be'Eri,2,0,36,34
1656982992172,MATH 105,A01,085443,Carter; Anne Toulson,14,0,35,21
1656982992172,MATH 105,A02,093477,Carter; Anne Toulson,20,0,35,15
1656982998200,MATH 109,A01,083213,Ganzberger; Geoffrey Michael,2,0,34,32
1656982998200,MATH 109,A02,083214,Ganzberger; Geoffrey Michael,2,0,34,32
1656982998200,MATH 109,A03,093478,Ganzberger; Geoffrey Michael,1,0,34,33
1656982998200,MATH 109,B01,083215,Ganzberger; Geoffrey Michael,1,0,32,31
1656982998200,MATH 109,B02,083216,Ganzberger; Geoffrey Michael,1,0,32,31
1656982998200,MATH 109,B03,093479,Ganzberger; Geoffrey Michael,6,0,32,26
1656983004222,MATH 142A,A01,083219,Chow; Bennett,6,0,32,26
1656983004222,MATH 142A,A02,083220,Chow; Bennett,10,0,32,22
1656983004222,MATH 142A,A03,093480,Chow; Bennett,7,0,32,25
1656983004222,MATH 142A,B03,093481,Chow; Bennett,7,0,32,25
1656983004222,MATH 142A,B04,093558,Chow; Bennett,11,0,32,21
1656983004222,MATH 142A,B05,093559,Chow; Bennett,6,0,32,26
1656983010246,MATH 193A,A01,083224,Rotar; Vladimir,7,0,34,27
1656983010246,MATH 193A,A02,083225,Rotar; Vladimir,4,0,34,30
1656983010246,MATH 193A,A03,083781,Rotar; Vladimir,1,0,34,33
1656983010246,MATH 193A,A04,083782,Rotar; Vladimir,6,0,34,28
1656983010246,MATH 193A,A05,093482,Rotar; Vladimir,6,0,34,28
1656983016268,MATH 197,001,091859,McAuley; Julian John,9999,0,9999,0
1656983016268,MATH 197,002,095566,Kedlaya; Kiran S.,9997,0,9999,2
1656983016268,MATH 197,003,095567,Xiao; Ming,9999,0,9999,0
1656983016268,MATH 197,004,095571,Perols; Johan Lars,9998,0,9999,1
1656983023320,COGS 9,A01,083615,Shannon; Kyle Michael,7,0,75,68
1656983029347,COGS 11,A01,083617,Boyle; Mary E. T.,20,0,48,28
1656983035375,COGS 13,A01,083071,Bastos; Amalia Pinkusfeld,9,0,71,62
1656983041399,COGS 14A,A01,092681,Semenuks; Arturs,0,1,100,100
1656983047427,COGS 14B,A01,083073,Cheng; Tzu-Han,5,0,63,58
1656983053450,COGS 17,A01,092677,Semenuks; Arturs,4,0,81,77
1656983059474,COGS 100,A01,083619,Allen; Michael Gordon,15,0,70,55
1656983065498,COGS 101A,A01,083621,Davis; Joshua Daniel,9,0,68,59
1656983071518,COGS 101B,A01,091572,Allen; Michael Gordon,8,0,65,57
1656983077542,COGS 101C,A01,083625,Delgado; Tania,17,0,35,18
1656983083569,COGS 107A,A01,083627,Boyle; Mary E. T.,13,0,60,47
1656983089595,COGS 118A,A01,083075,Gupta; Anjum,15,0,76,61
1656983095621,CSE 3,A50,083646,Miranda; Gregory Joseph,22,0,50,28
1656983101645,CSE 8A,A50,083650,Miranda; Gregory Joseph,17,1,56,39
1656983107691,CSE 11,A01,083080,Cao; Yingjun,4,15,40,36
1656983113712,CSE 12,A01,083652,Krause-Levy; Sophia Louisa,20,1,120,100
1656983119733,CSE 15L,A01,083654,Morris; Justin Loren,8,0,50,42
1656983119733,CSE 15L,A02,083655,Morris; Justin Loren,8,0,50,42
1656983125760,CSE 20,A01,083657,Tran; Khoa Dang,37,0,80,43
1656983131781,CSE 21,A01,095574,Bach; Quang Tran,21,0,48,27
1656983137802,CSE 30,A01,083084,Eldon; John,4,0,80,76
1656983137802,CSE 30,B01,095061,Bhaskar; Nishant,6,0,50,44
1656983143827,CSE 100,A01,083659,Cao; Yingjun,3,4,70,67
1656983149849,CSE 134B,A01,083661,Powell; Thomas Allan,19,0,100,81
1656983155873,CSE 140,A01,083663,Gungor; Onat,14,0,85,71
1656983161894,CSE 140L,A01,083088,Eldon; John,16,0,100,84
1656983167917,CSE 175,A01,083665,Kumar; Rakesh,3,0,25,22
1656983173939,CSE 190,A00,092507,Dubnov; Shlomo,7,0,20,13
1656983179966,ECE 45,A01,083139,Congero; Spencer William,5,0,75,70
1656983185990,ECE 65,A50,083695,Saad; Andrew S,12,0,30,18
1656983185990,ECE 65,A51,095125,Saad; Andrew S,25,0,26,1
1656983192016,ECE 109,A01,091882,Touri; Behrouz,16,0,70,54
1656983198039,ECE 180,A00,083140,Abi Samra; Nicholas Camill,1,0,30,29
1656983198039,ECE 180,B00,083141,Abi Samra; Nicholas Camill,0,0,30,30
1656983204062,MATH 10A,A01,083735,Patchell; Gregory David,1,0,30,29
1656983204062,MATH 10A,A02,083736,Patchell; Gregory David,20,0,30,10
1656983204062,MATH 10A,A03,083737,Patchell; Gregory David,15,0,30,15
1656983210087,MATH 10B,A01,083207,Lim; Seonhee,7,0,34,27
1656983210087,MATH 10B,A02,083208,Lim; Seonhee,9,0,35,26
1656983210087,MATH 10B,A03,093472,Lim; Seonhee,4,0,34,30
1656983210087,MATH 10B,B01,083739,Sinha; Shubham,9,0,30,21
1656983216112,MATH 18,A01,083743,Cinel; Cameron Alexander,6,0,30,24
1656983216112,MATH 18,A02,083744,Cinel; Cameron Alexander,15,0,30,15
1656983216112,MATH 18,A03,083745,Cinel; Cameron Alexander,8,0,30,22
1656983216112,MATH 18,B01,083748,Rideout; David Porter,4,0,37,33
1656983216112,MATH 18,B02,083749,Rideout; David Porter,3,0,36,33
1656983216112,MATH 18,B03,083750,Rideout; David Porter,2,0,37,35
1656983216112,MATH 18,B04,083751,Rideout; David Porter,5,0,36,31
1656983216112,MATH 18,B05,093473,Rideout; David Porter,4,0,36,32
1656983216112,MATH 18,B06,093474,Rideout; David Porter,5,0,36,31
1656983222141,MATH 20A,A01,083754,Zheng; Zequn,12,0,40,28
1656983228164,MATH 20B,A01,083756,Briones; Jor-el Thomas Caparas,1,0,36,35
1656983228164,MATH 20B,A02,083757,Briones; Jor-el Thomas Caparas,1,0,36,35
1656983228164,MATH 20B,A03,093475,Briones; Jor-el Thomas Caparas,0,0,36,36
1656983234188,MATH 20C,A01,083760,Briones; Jor-el Thomas Caparas,1,0,35,34
1656983234188,MATH 20C,A02,083761,Briones; Jor-el Thomas Caparas,8,0,35,27
1656983234188,MATH 20C,A03,093476,Briones; Jor-el Thomas Caparas,0,1,36,36
1656983234188,MATH 20C,B01,083762,Bach; Quang Tran,0,0,30,30
1656983240211,MATH 20D,A01,083765,Tran; Brian Kha,4,0,30,26
1656983240211,MATH 20D,A02,083766,Tran; Brian Kha,4,0,30,26
1656983240211,MATH 20D,A03,083767,Tran; Brian Kha,3,0,30,27
1656983246240,MATH 20E,A01,083771,Ganguly; Soumya,5,0,32,27
1656983246240,MATH 20E,A02,083772,Ganguly; Soumya,6,0,32,26
1656983246240,MATH 20E,B01,083773,Ciotti; Benjamin,18,0,35,17
1656983246240,MATH 20E,B02,083774,Ciotti; Benjamin,17,0,35,18
1656983252267,MATH 103A,A01,083777,Greenfeld; Be'Eri,2,0,36,34
1656983252267,MATH 103A,A02,083778,Greenfeld; Be'Eri,5,0,36,31
1656983252267,MATH 103A,A03,093561,Greenfeld; Be'Eri,4,0,36,32
1656983252267,MATH 103A,B01,083779,Greenfeld; Be'Eri,6,0,36,30
1656983252267,MATH 103A,B02,083780,Greenfeld; Be'Eri,2,0,36,34
1656983252267,MATH 103A,B03,093562,Greenfeld; Be'Eri,2,0,36,34
1656983258291,MATH 105,A01,085443,Carter; Anne Toulson,14,0,35,21
1656983258291,MATH 105,A02,093477,Carter; Anne Toulson,20,0,35,15
1656983264319,MATH 109,A01,083213,Ganzberger; Geoffrey Michael,2,0,34,32
1656983264319,MATH 109,A02,083214,Ganzberger; Geoffrey Michael,2,0,34,32
1656983264319,MATH 109,A03,093478,Ganzberger; Geoffrey Michael,1,0,34,33
1656983264319,MATH 109,B01,083215,Ganzberger; Geoffrey Michael,1,0,32,31
1656983264319,MATH 109,B02,083216,Ganzberger; Geoffrey Michael,1,0,32,31
1656983264319,MATH 109,B03,093479,Ganzberger; Geoffrey Michael,6,0,32,26
1656983270341,MATH 142A,A01,083219,Chow; Bennett,6,0,32,26
1656983270341,MATH 142A,A02,083220,Chow; Bennett,10,0,32,22
1656983270341,MATH 142A,A03,093480,Chow; Bennett,7,0,32,25
1656983270341,MATH 142A,B03,093481,Chow; Bennett,7,0,32,25
1656983270341,MATH 142A,B04,093558,Chow; Bennett,11,0,32,21
1656983270341,MATH 142A,B05,093559,Chow; Bennett,6,0,32,26
1656983276364,MATH 193A,A01,083224,Rotar; Vladimir,7,0,34,27
1656983276364,MATH 193A,A02,083225,Rotar; Vladimir,4,0,34,30
1656983276364,MATH 193A,A03,083781,Rotar; Vladimir,1,0,34,33
1656983276364,MATH 193A,A04,083782,Rotar; Vladimir,6,0,34,28
1656983276364,MATH 193A,A05,093482,Rotar; Vladimir,6,0,34,28
1656983282388,MATH 197,001,091859,McAuley; Julian John,9999,0,9999,0
1656983282388,MATH 197,002,095566,Kedlaya; Kiran S.,9997,0,9999,2
1656983282388,MATH 197,003,095567,Xiao; Ming,9999,0,9999,0
1656983282388,MATH 197,004,095571,Perols; Johan Lars,9998,0,9999,1
1656983289440,COGS 9,A01,083615,Shannon; Kyle Michael,7,0,75,68
1656983295463,COGS 11,A01,083617,Boyle; Mary E. T.,20,0,48,28
1656983301485,COGS 13,A01,083071,Bastos; Amalia Pinkusfeld,9,0,71,62
1656983307509,COGS 14A,A01,092681,Semenuks; Arturs,0,1,100,100
1656983313532,COGS 14B,A01,083073,Cheng; Tzu-Han,5,0,63,58
1656983319558,COGS 17,A01,092677,Semenuks; Arturs,4,0,81,77
1656983325582,COGS 100,A01,083619,Allen; Michael Gordon,15,0,70,55
1656983331611,COGS 101A,A01,083621,Davis; Joshua Daniel,9,0,68,59
1656983337635,COGS 101B,A01,091572,Allen; Michael Gordon,8,0,65,57
1656983343756,COGS 101C,A01,083625,Delgado; Tania,17,0,35,18
1656983349781,COGS 107A,A01,083627,Boyle; Mary E. T.,13,0,60,47
1656983355803,COGS 118A,A01,083075,Gupta; Anjum,15,0,76,61
1656983361827,CSE 3,A50,083646,Miranda; Gregory Joseph,22,0,50,28
1656983367855,CSE 8A,A50,083650,Miranda; Gregory Joseph,17,1,56,39
1656983373886,CSE 11,A01,083080,Cao; Yingjun,4,15,40,36
1656983379912,CSE 12,A01,083652,Krause-Levy; Sophia Louisa,20,1,120,100
1656983385939,CSE 15L,A01,083654,Morris; Justin Loren,8,0,50,42
1656983385939,CSE 15L,A02,083655,Morris; Justin Loren,8,0,50,42
1656983391965,CSE 20,A01,083657,Tran; Khoa Dang,37,0,80,43
1656983397987,CSE 21,A01,095574,Bach; Quang Tran,21,0,48,27
1656983404010,CSE 30,A01,083084,Eldon; John,4,0,80,76
1656983404010,CSE 30,B01,095061,Bhaskar; Nishant,6,0,50,44
1656983410042,CSE 100,A01,083659,Cao; Yingjun,3,4,70,67
1656983416065,CSE 134B,A01,083661,Powell; Thomas Allan,19,0,100,81
1656983422089,CSE 140,A01,083663,Gungor; Onat,14,0,85,71
1656983428123,CSE 140L,A01,083088,Eldon; John,16,0,100,84
1656983434152,CSE 175,A01,083665,Kumar; Rakesh,3,0,25,22
1656983440176,CSE 190,A00,092507,Dubnov; Shlomo,7,0,20,13
1656983446199,ECE 45,A01,083139,Congero; Spencer William,5,0,75,70
1656983452222,ECE 65,A50,083695,Saad; Andrew S,12,0,30,18
1656983452222,ECE 65,A51,095125,Saad; Andrew S,25,0,26,1
1656983458249,ECE 109,A01,091882,Touri; Behrouz,16,0,70,54
1656983464272,ECE 180,A00,083140,Abi Samra; Nicholas Camill,1,0,30,29
1656983464272,ECE 180,B00,083141,Abi Samra; Nicholas Camill,0,0,30,30
1656983470296,MATH 10A,A01,083735,Patchell; Gregory David,1,0,30,29
1656983470296,MATH 10A,A02,083736,Patchell; Gregory David,20,0,30,10
1656983470296,MATH 10A,A03,083737,Patchell; Gregory David,15,0,30,15
1656983476327,MATH 10B,A01,083207,Lim; Seonhee,7,0,34,27
1656983476327,MATH 10B,A02,083208,Lim; Seonhee,9,0,35,26
1656983476327,MATH 10B,A03,093472,Lim; Seonhee,4,0,34,30
1656983476327,MATH 10B,B01,083739,Sinha; Shubham,9,0,30,21
1656983482350,MATH 18,A01,083743,Cinel; Cameron Alexander,6,0,30,24
1656983482350,MATH 18,A02,083744,Cinel; Cameron Alexander,15,0,30,15
1656983482350,MATH 18,A03,083745,Cinel; Cameron Alexander,8,0,30,22
1656983482350,MATH 18,B01,083748,Rideout; David Porter,4,0,37,33
1656983482350,MATH 18,B02,083749,Rideout; David Porter,3,0,36,33
1656983482350,MATH 18,B03,083750,Rideout; David Porter,2,0,37,35
1656983482350,MATH 18,B04,083751,Rideout; David Porter,5,0,36,31
1656983482350,MATH 18,B05,093473,Rideout; David Porter,4,0,36,32
1656983482350,MATH 18,B06,093474,Rideout; David Porter,5,0,36,31
1656983488377,MATH 20A,A01,083754,Zheng; Zequn,12,0,40,28
1656983494405,MATH 20B,A01,083756,Briones; Jor-el Thomas Caparas,1,0,36,35
1656983494405,MATH 20B,A02,083757,Briones; Jor-el Thomas Caparas,1,0,36,35
1656983494405,MATH 20B,A03,093475,Briones; Jor-el Thomas Caparas,0,0,36,36
1656983500432,MATH 20C,A01,083760,Briones; Jor-el Thomas Caparas,1,0,35,34
1656983500432,MATH 20C,A02,083761,Briones; Jor-el Thomas Caparas,8,0,35,27
1656983500432,MATH 20C,A03,093476,Briones; Jor-el Thomas Caparas,0,1,36,36
1656983500432,MATH 20C,B01,083762,Bach; Quang Tran,0,0,30,30
1656983506460,MATH 20D,A01,083765,Tran; Brian Kha,4,0,30,26
1656983506460,MATH 20D,A02,083766,Tran; Brian Kha,4,0,30,26
1656983506460,MATH 20D,A03,083767,Tran; Brian Kha,3,0,30,27
1656983512485,MATH 20E,A01,083771,Ganguly; Soumya,5,0,32,27
1656983512485,MATH 20E,A02,083772,Ganguly; Soumya,6,0,32,26
1656983512485,MATH 20E,B01,083773,Ciotti; Benjamin,18,0,35,17
1656983512485,MATH 20E,B02,083774,Ciotti; Benjamin,17,0,35,18
1656983518511,MATH 103A,A01,083777,Greenfeld; Be'Eri,2,0,36,34
1656983518511,MATH 103A,A02,083778,Greenfeld; Be'Eri,5,0,36,31
1656983518511,MATH 103A,A03,093561,Greenfeld; Be'Eri,4,0,36,32
1656983518511,MATH 103A,B01,083779,Greenfeld; Be'Eri,6,0,36,30
1656983518511,MATH 103A,B02,083780,Greenfeld; Be'Eri,2,0,36,34
1656983518511,MATH 103A,B03,093562,Greenfeld; Be'Eri,2,0,36,34
1656983524534,MATH 105,A01,085443,Carter; Anne Toulson,14,0,35,21
1656983524534,MATH 105,A02,093477,Carter; Anne Toulson,20,0,35,15
1656983530563,MATH 109,A01,083213,Ganzberger; Geoffrey Michael,2,0,34,32
1656983530563,MATH 109,A02,083214,Ganzberger; Geoffrey Michael,2,0,34,32
1656983530563,MATH 109,A03,093478,Ganzberger; Geoffrey Michael,1,0,34,33
1656983530563,MATH 109,B01,083215,Ganzberger; Geoffrey Michael,1,0,32,31
1656983530563,MATH 109,B02,083216,Ganzberger; Geoffrey Michael,1,0,32,31
1656983530563,MATH 109,B03,093479,Ganzberger; Geoffrey Michael,6,0,32,26
1656983536584,MATH 142A,A01,083219,Chow; Bennett,6,0,32,26
1656983536584,MATH 142A,A02,083220,Chow; Bennett,10,0,32,22
1656983536584,MATH 142A,A03,093480,Chow; Bennett,7,0,32,25
1656983536584,MATH 142A,B03,093481,Chow; Bennett,7,0,32,25
1656983536584,MATH 142A,B04,093558,Chow; Bennett,11,0,32,21
1656983536584,MATH 142A,B05,093559,Chow; Bennett,6,0,32,26
1656983542610,MATH 193A,A01,083224,Rotar; Vladimir,7,0,34,27
1656983542610,MATH 193A,A02,083225,Rotar; Vladimir,4,0,34,30
1656983542610,MATH 193A,A03,083781,Rotar; Vladimir,1,0,34,33
1656983542610,MATH 193A,A04,083782,Rotar; Vladimir,6,0,34,28
1656983542610,MATH 193A,A05,093482,Rotar; Vladimir,6,0,34,28
1656983548635,MATH 197,001,091859,McAuley; Julian John,9999,0,9999,0
1656983548635,MATH 197,002,095566,Kedlaya; Kiran S.,9997,0,9999,2
1656983548635,MATH 197,003,095567,Xiao; Ming,9999,0,9999,0
1656983548635,MATH 197,004,095571,Perols; Johan Lars,9998,0,9999,1
1656983555708,COGS 9,A01,083615,Shannon; Kyle Michael,7,0,75,68
1656983561731,COGS 11,A01,083617,Boyle; Mary E. T.,20,0,48,28
1656983567754,COGS 13,A01,083071,Bastos; Amalia Pinkusfeld,9,0,71,62
1656983573782,COGS 14A,A01,092681,Semenuks; Arturs,0,1,100,100
1656983579816,COGS 14B,A01,083073,Cheng; Tzu-Han,5,0,63,58
1656983585839,COGS 17,A01,092677,Semenuks; Arturs,4,0,81,77
1656983591873,COGS 100,A01,083619,Allen; Michael Gordon,15,0,70,55
1656983597895,COGS 101A,A01,083621,Davis; Joshua Daniel,9,0,68,59
1656983603922,COGS 101B,A01,091572,Allen; Michael Gordon,8,0,65,57
1656983609944,COGS 101C,A01,083625,Delgado; Tania,17,0,35,18
1656983615968,COGS 107A,A01,083627,Boyle; Mary E. T.,13,0,60,47
1656983621994,COGS 118A,A01,083075,Gupta; Anjum,15,0,76,61
1656983628018,CSE 3,A50,083646,Miranda; Gregory Joseph,22,0,50,28
1656983634042,CSE 8A,A50,083650,Miranda; Gregory Joseph,17,1,56,39
1656983640063,CSE 11,A01,083080,Cao; Yingjun,4,15,40,36
1656983646089,CSE 12,A01,083652,Krause-Levy; Sophia Louisa,20,1,120,100
1656983652114,CSE 15L,A01,083654,Morris; Justin Loren,8,0,50,42
1656983652114,CSE 15L,A02,083655,Morris; Justin Loren,8,0,50,42
1656983658152,CSE 20,A01,083657,Tran; Khoa Dang,37,0,80,43
1656983664175,CSE 21,A01,095574,Bach; Quang Tran,21,0,48,27
1656983670205,CSE 30,A01,083084,Eldon; John,4,0,80,76
1656983670205,CSE 30,B01,095061,Bhaskar; Nishant,6,0,50,44
1656983676229,CSE 100,A01,083659,Cao; Yingjun,3,4,70,67
1656983682257,CSE 134B,A01,083661,Powell; Thomas Allan,19,0,100,81
1656983688282,CSE 140,A01,083663,Gungor; Onat,14,0,85,71
1656983694305,CSE 140L,A01,083088,Eldon; John,16,0,100,84
1656983700335,CSE 175,A01,083665,Kumar; Rakesh,3,0,25,22
1656983706360,CSE 190,A00,092507,Dubnov; Shlomo,7,0,20,13
1656983712382,ECE 45,A01,083139,Congero; Spencer William,5,0,75,70
1656983718406,ECE 65,A50,083695,Saad; Andrew S,12,0,30,18
1656983718406,ECE 65,A51,095125,Saad; Andrew S,25,0,26,1
1656983724432,ECE 109,A01,091882,Touri; Behrouz,16,0,70,54
1656983730459,ECE 180,A00,083140,Abi Samra; Nicholas Camill,1,0,30,29
1656983730459,ECE 180,B00,083141,Abi Samra; Nicholas Camill,0,0,30,30
1656983736482,MATH 10A,A01,083735,Patchell; Gregory David,1,0,30,29
1656983736482,MATH 10A,A02,083736,Patchell; Gregory David,20,0,30,10
1656983736482,MATH 10A,A03,083737,Patchell; Gregory David,15,0,30,15
1656983742506,MATH 10B,A01,083207,Lim; Seonhee,7,0,34,27
1656983742506,MATH 10B,A02,083208,Lim; Seonhee,9,0,35,26
1656983742506,MATH 10B,A03,093472,Lim; Seonhee,4,0,34,30
1656983742506,MATH 10B,B01,083739,Sinha; Shubham,9,0,30,21
1656983748548,MATH 18,A01,083743,Cinel; Cameron Alexander,6,0,30,24
1656983748548,MATH 18,A02,083744,Cinel; Cameron Alexander,15,0,30,15
1656983748548,MATH 18,A03,083745,Cinel; Cameron Alexander,8,0,30,22
1656983748548,MATH 18,B01,083748,Rideout; David Porter,4,0,37,33
1656983748548,MATH 18,B02,083749,Rideout; David Porter,3,0,36,33
1656983748548,MATH 18,B03,083750,Rideout; David Porter,2,0,37,35
1656983748548,MATH 18,B04,083751,Rideout; David Porter,5,0,36,31
1656983748548,MATH 18,B05,093473,Rideout; David Porter,4,0,36,32
1656983748548,MATH 18,B06,093474,Rideout; David Porter,5,0,36,31
1656983754570,MATH 20A,A01,083754,Zheng; Zequn,12,0,40,28
1656983760608,MATH 20B,A01,083756,Briones; Jor-el Thomas Caparas,1,0,36,35
1656983760608,MATH 20B,A02,083757,Briones; Jor-el Thomas Caparas,1,0,36,35
1656983760608,MATH 20B,A03,093475,Briones; Jor-el Thomas Caparas,0,0,36,36
1656983766643,MATH 20C,A01,083760,Briones; Jor-el Thomas Caparas,1,0,35,34
1656983766643,MATH 20C,A02,083761,Briones; Jor-el Thomas Caparas,8,0,35,27
1656983766643,MATH 20C,A03,093476,Briones; Jor-el Thomas Caparas,0,1,36,36
1656983766643,MATH 20C,B01,083762,Bach; Quang Tran,0,0,30,30
1656983772668,MATH 20D,A01,083765,Tran; Brian Kha,4,0,30,26
1656983772668,MATH 20D,A02,083766,Tran; Brian Kha,4,0,30,26
1656983772668,MATH 20D,A03,083767,Tran; Brian Kha,3,0,30,27
1656983778693,MATH 20E,A01,083771,Ganguly; Soumya,5,0,32,27
1656983778693,MATH 20E,A02,083772,Ganguly; Soumya,6,0,32,26
1656983778693,MATH 20E,B01,083773,Ciotti; Benjamin,18,0,35,17
1656983778693,MATH 20E,B02,083774,Ciotti; Benjamin,17,0,35,18
1656983784723,MATH 103A,A01,083777,Greenfeld; Be'Eri,2,0,36,34
1656983784723,MATH 103A,A02,083778,Greenfeld; Be'Eri,5,0,36,31
1656983784723,MATH 103A,A03,093561,Greenfeld; Be'Eri,4,0,36,32
1656983784723,MATH 103A,B01,083779,Greenfeld; Be'Eri,6,0,36,30
1656983784723,MATH 103A,B02,083780,Greenfeld; Be'Eri,2,0,36,34
1656983784723,MATH 103A,B03,093562,Greenfeld; Be'Eri,2,0,36,34
1656983790745,MATH 105,A01,085443,Carter; Anne Toulson,14,0,35,21
1656983790745,MATH 105,A02,093477,Carter; Anne Toulson,20,0,35,15
1656983796773,MATH 109,A01,083213,Ganzberger; Geoffrey Michael,2,0,34,32
1656983796773,MATH 109,A02,083214,Ganzberger; Geoffrey Michael,2,0,34,32
1656983796773,MATH 109,A03,093478,Ganzberger; Geoffrey Michael,1,0,34,33
1656983796773,MATH 109,B01,083215,Ganzberger; Geoffrey Michael,1,0,32,31
1656983796773,MATH 109,B02,083216,Ganzberger; Geoffrey Michael,1,0,32,31
1656983796773,MATH 109,B03,093479,Ganzberger; Geoffrey Michael,6,0,32,26
1656983802803,MATH 142A,A01,083219,Chow; Bennett,6,0,32,26
1656983802803,MATH 142A,A02,083220,Chow; Bennett,10,0,32,22
1656983802803,MATH 142A,A03,093480,Chow; Bennett,7,0,32,25
1656983802803,MATH 142A,B03,093481,Chow; Bennett,7,0,32,25
1656983802803,MATH 142A,B04,093558,Chow; Bennett,11,0,32,21
1656983802803,MATH 142A,B05,093559,Chow; Bennett,6,0,32,26
1656983808827,MATH 193A,A01,083224,Rotar; Vladimir,7,0,34,27
1656983808827,MATH 193A,A02,083225,Rotar; Vladimir,4,0,34,30
1656983808827,MATH 193A,A03,083781,Rotar; Vladimir,1,0,34,33
1656983808827,MATH 193A,A04,083782,Rotar; Vladimir,6,0,34,28
1656983808827,MATH 193A,A05,093482,Rotar; Vladimir,6,0,34,28
1656983814852,MATH 197,001,091859,McAuley; Julian John,9999,0,9999,0
1656983814852,MATH 197,002,095566,Kedlaya; Kiran S.,9997,0,9999,2
1656983814852,MATH 197,003,095567,Xiao; Ming,9999,0,9999,0
1656983814852,MATH 197,004,095571,Perols; Johan Lars,9998,0,9999,1
1656983821917,COGS 9,A01,083615,Shannon; Kyle Michael,7,0,75,68
1656983827941,COGS 11,A01,083617,Boyle; Mary E. T.,20,0,48,28
1656983833962,COGS 13,A01,083071,Bastos; Amalia Pinkusfeld,9,0,71,62
1656983839986,COGS 14A,A01,092681,Semenuks; Arturs,0,1,100,100
1656983846011,COGS 14B,A01,083073,Cheng; Tzu-Han,5,0,63,58
1656983852039,COGS 17,A01,092677,Semenuks; Arturs,4,0,81,77
1656983858066,COGS 100,A01,083619,Allen; Michael Gordon,15,0,70,55
1656983864092,COGS 101A,A01,083621,Davis; Joshua Daniel,9,0,68,59
1656983870121,COGS 101B,A01,091572,Allen; Michael Gordon,8,0,65,57
1656983876147,COGS 101C,A01,083625,Delgado; Tania,17,0,35,18
1656983882175,COGS 107A,A01,083627,Boyle; Mary E. T.,13,0,60,47
1656983888198,COGS 118A,A01,083075,Gupta; Anjum,15,0,76,61
1656983894224,CSE 3,A50,083646,Miranda; Gregory Joseph,22,0,50,28
1656983900249,CSE 8A,A50,083650,Miranda; Gregory Joseph,17,1,56,39
1656983906275,CSE 11,A01,083080,Cao; Yingjun,4,15,40,36
1656983912299,CSE 12,A01,083652,Krause-Levy; Sophia Louisa,20,1,120,100
1656983918322,CSE 15L,A01,083654,Morris; Justin Loren,8,0,50,42
1656983918322,CSE 15L,A02,083655,Morris; Justin Loren,8,0,50,42
1656983924349,CSE 20,A01,083657,Tran; Khoa Dang,37,0,80,43
1656983930380,CSE 21,A01,095574,Bach; Quang Tran,21,0,48,27
1656983936408,CSE 30,A01,083084,Eldon; John,4,0,80,76
1656983936408,CSE 30,B01,095061,Bhaskar; Nishant,6,0,50,44
1656983942523,CSE 100,A01,083659,Cao; Yingjun,3,4,70,67
1656983948546,CSE 134B,A01,083661,Powell; Thomas Allan,19,0,100,81
1656983954569,CSE 140,A01,083663,Gungor; Onat,14,0,85,71
1656983960592,CSE 140L,A01,083088,Eldon; John,16,0,100,84
1656983966614,CSE 175,A01,083665,Kumar; Rakesh,3,0,25,22
1656983972637,CSE 190,A00,092507,Dubnov; Shlomo,7,0,20,13
1656983978665,ECE 45,A01,083139,Congero; Spencer William,5,0,75,70
1656983984690,ECE 65,A50,083695,Saad; Andrew S,12,0,30,18
1656983984690,ECE 65,A51,095125,Saad; Andrew S,25,0,26,1
1656983990716,ECE 109,A01,091882,Touri; Behrouz,16,0,70,54
1656983996741,ECE 180,A00,083140,Abi Samra; Nicholas Camill,1,0,30,29
1656983996741,ECE 180,B00,083141,Abi Samra; Nicholas Camill,0,0,30,30
1656984002768,MATH 10A,A01,083735,Patchell; Gregory David,1,0,30,29
1656984002768,MATH 10A,A02,083736,Patchell; Gregory David,20,0,30,10
1656984002768,MATH 10A,A03,083737,Patchell; Gregory David,15,0,30,15
1656984008792,MATH 10B,A01,083207,Lim; Seonhee,7,0,34,27
1656984008792,MATH 10B,A02,083208,Lim; Seonhee,9,0,35,26
1656984008792,MATH 10B,A03,093472,Lim; Seonhee,4,0,34,30
1656984008792,MATH 10B,B01,083739,Sinha; Shubham,9,0,30,21
1656984014815,MATH 18,A01,083743,Cinel; Cameron Alexander,6,0,30,24
1656984014815,MATH 18,A02,083744,Cinel; Cameron Alexander,15,0,30,15
1656984014815,MATH 18,A03,083745,Cinel; Cameron Alexander,8,0,30,22
1656984014815,MATH 18,B01,083748,Rideout; David Porter,4,0,37,33
1656984014815,MATH 18,B02,083749,Rideout; David Porter,3,0,36,33
1656984014815,MATH 18,B03,083750,Rideout; David Porter,2,0,37,35
1656984014815,MATH 18,B04,083751,Rideout; David Porter,5,0,36,31
1656984014815,MATH 18,B05,093473,Rideout; David Porter,4,0,36,32
1656984014815,MATH 18,B06,093474,Rideout; David Porter,5,0,36,31
1656984020842,MATH 20A,A01,083754,Zheng; Zequn,12,0,40,28
1656984026864,MATH 20B,A01,083756,Briones; Jor-el Thomas Caparas,1,0,36,35
1656984026864,MATH 20B,A02,083757,Briones; Jor-el Thomas Caparas,1,0,36,35
1656984026864,MATH 20B,A03,093475,Briones; Jor-el Thomas Caparas,0,0,36,36
1656984032890,MATH 20C,A01,083760,Briones; Jor-el Thomas Caparas,1,0,35,34
1656984032890,MATH 20C,A02,083761,Briones; Jor-el Thomas Caparas,8,0,35,27
1656984032890,MATH 20C,A03,093476,Briones; Jor-el Thomas Caparas,0,1,36,36
1656984032890,MATH 20C,B01,083762,Bach; Quang Tran,0,0,30,30
1656984038918,MATH 20D,A01,083765,Tran; Brian Kha,4,0,30,26
1656984038918,MATH 20D,A02,083766,Tran; Brian Kha,4,0,30,26
1656984038918,MATH 20D,A03,083767,Tran; Brian Kha,3,0,30,27
1656984044942,MATH 20E,A01,083771,Ganguly; Soumya,5,0,32,27
1656984044942,MATH 20E,A02,083772,Ganguly; Soumya,6,0,32,26
1656984044942,MATH 20E,B01,083773,Ciotti; Benjamin,18,0,35,17
1656984044942,MATH 20E,B02,083774,Ciotti; Benjamin,17,0,35,18
1656984050966,MATH 103A,A01,083777,Greenfeld; Be'Eri,2,0,36,34
1656984050966,MATH 103A,A02,083778,Greenfeld; Be'Eri,5,0,36,31
1656984050966,MATH 103A,A03,093561,Greenfeld; Be'Eri,4,0,36,32
1656984050966,MATH 103A,B01,083779,Greenfeld; Be'Eri,6,0,36,30
1656984050966,MATH 103A,B02,083780,Greenfeld; Be'Eri,2,0,36,34
1656984050966,MATH 103A,B03,093562,Greenfeld; Be'Eri,2,0,36,34
1656984056989,MATH 105,A01,085443,Carter; Anne Toulson,14,0,35,21
1656984056989,MATH 105,A02,093477,Carter; Anne Toulson,20,0,35,15
1656984063017,MATH 109,A01,083213,Ganzberger; Geoffrey Michael,2,0,34,32
1656984063017,MATH 109,A02,083214,Ganzberger; Geoffrey Michael,2,0,34,32
1656984063017,MATH 109,A03,093478,Ganzberger; Geoffrey Michael,1,0,34,33
1656984063017,MATH 109,B01,083215,Ganzberger; Geoffrey Michael,1,0,32,31
1656984063017,MATH 109,B02,083216,Ganzberger; Geoffrey Michael,1,0,32,31
1656984063017,MATH 109,B03,093479,Ganzberger; Geoffrey Michael,6,0,32,26
1656984069046,MATH 142A,A01,083219,Chow; Bennett,6,0,32,26
1656984069046,MATH 142A,A02,083220,Chow; Bennett,10,0,32,22
1656984069046,MATH 142A,A03,093480,Chow; Bennett,7,0,32,25
1656984069046,MATH 142A,B03,093481,Chow; Bennett,7,0,32,25
1656984069046,MATH 142A,B04,093558,Chow; Bennett,11,0,32,21
1656984069046,MATH 142A,B05,093559,Chow; Bennett,6,0,32,26
1656984075073,MATH 193A,A01,083224,Rotar; Vladimir,7,0,34,27
1656984075073,MATH 193A,A02,083225,Rotar; Vladimir,4,0,34,30
1656984075073,MATH 193A,A03,083781,Rotar; Vladimir,1,0,34,33
1656984075073,MATH 193A,A04,083782,Rotar; Vladimir,6,0,34,28
1656984075073,MATH 193A,A05,093482,Rotar; Vladimir,6,0,34,28
1656984081097,MATH 197,001,091859,McAuley; Julian John,9999,0,9999,0
1656984081097,MATH 197,002,095566,Kedlaya; Kiran S.,9997,0,9999,2
1656984081097,MATH 197,003,095567,Xiao; Ming,9999,0,9999,0
1656984081097,MATH 197,004,095571,Perols; Johan Lars,9998,0,9999,1
1656984088158,COGS 9,A01,083615,Shannon; Kyle Michael,7,0,75,68
1656984094181,COGS 11,A01,083617,Boyle; Mary E. T.,20,0,48,28
1656984100203,COGS 13,A01,083071,Bastos; Amalia Pinkusfeld,9,0,71,62
1656984106231,COGS 14A,A01,092681,Semenuks; Arturs,0,1,100,100
1656984112266,COGS 14B,A01,083073,Cheng; Tzu-Han,5,0,63,58
1656984118292,COGS 17,A01,092677,Semenuks; Arturs,4,0,81,77
1656984124315,COGS 100,A01,083619,Allen; Michael Gordon,15,0,70,55
1656984130358,COGS 101A,A01,083621,Davis; Joshua Daniel,9,0,68,59
1656984136384,COGS 101B,A01,091572,Allen; Michael Gordon,8,0,65,57
1656984142411,COGS 101C,A01,083625,Delgado; Tania,17,0,35,18
1656984148443,COGS 107A,A01,083627,Boyle; Mary E. T.,13,0,60,47
1656984154469,COGS 118A,A01,083075,Gupta; Anjum,15,0,76,61
1656984160493,CSE 3,A50,083646,Miranda; Gregory Joseph,22,0,50,28
1656984166517,CSE 8A,A50,083650,Miranda; Gregory Joseph,17,1,56,39
1656984172540,CSE 11,A01,083080,Cao; Yingjun,4,15,40,36
1656984178564,CSE 12,A01,083652,Krause-Levy; Sophia Louisa,20,1,120,100
1656984184587,CSE 15L,A01,083654,Morris; Justin Loren,8,0,50,42
1656984184587,CSE 15L,A02,083655,Morris; Justin Loren,8,0,50,42
1656984190610,CSE 20,A01,083657,Tran; Khoa Dang,37,0,80,43
1656984196631,CSE 21,A01,095574,Bach; Quang Tran,21,0,48,27
1656984202653,CSE 30,A01,083084,Eldon; John,4,0,80,76
1656984202653,CSE 30,B01,095061,Bhaskar; Nishant,6,0,50,44
1656984208674,CSE 100,A01,083659,Cao; Yingjun,3,4,70,67
1656984214696,CSE 134B,A01,083661,Powell; Thomas Allan,19,0,100,81
1656984220726,CSE 140,A01,083663,Gungor; Onat,14,0,85,71
1656984226748,CSE 140L,A01,083088,Eldon; John,16,0,100,84
1656984232773,CSE 175,A01,083665,Kumar; Rakesh,3,0,25,22
1656984238796,CSE 190,A00,092507,Dubnov; Shlomo,7,0,20,13
1656984244820,ECE 45,A01,083139,Congero; Spencer William,5,0,75,70
1656984250842,ECE 65,A50,083695,Saad; Andrew S,12,0,30,18
1656984250842,ECE 65,A51,095125,Saad; Andrew S,25,0,26,1
1656984256867,ECE 109,A01,091882,Touri; Behrouz,16,0,70,54
1656984262890,ECE 180,A00,083140,Abi Samra; Nicholas Camill,1,0,30,29
1656984262890,ECE 180,B00,083141,Abi Samra; Nicholas Camill,0,0,30,30
1656984268911,MATH 10A,A01,083735,Patchell; Gregory David,1,0,30,29
1656984268911,MATH 10A,A02,083736,Patchell; Gregory David,20,0,30,10
1656984268911,MATH 10A,A03,083737,Patchell; Gregory David,15,0,30,15
1656984274941,MATH 10B,A01,083207,Lim; Seonhee,7,0,34,27
1656984274941,MATH 10B,A02,083208,Lim; Seonhee,9,0,35,26
1656984274941,MATH 10B,A03,093472,Lim; Seonhee,4,0,34,30
1656984274941,MATH 10B,B01,083739,Sinha; Shubham,9,0,30,21
1656984280972,MATH 18,A01,083743,Cinel; Cameron Alexander,6,0,30,24
1656984280972,MATH 18,A02,083744,Cinel; Cameron Alexander,15,0,30,15
1656984280972,MATH 18,A03,083745,Cinel; Cameron Alexander,8,0,30,22
1656984280972,MATH 18,B01,083748,Rideout; David Porter,4,0,37,33
1656984280972,MATH 18,B02,083749,Rideout; David Porter,3,0,36,33
1656984280972,MATH 18,B03,083750,Rideout; David Porter,2,0,37,35
1656984280972,MATH 18,B04,083751,Rideout; David Porter,5,0,36,31
1656984280972,MATH 18,B05,093473,Rideout; David Porter,4,0,36,32
1656984280972,MATH 18,B06,093474,Rideout; David Porter,5,0,36,31
1656984286994,MATH 20A,A01,083754,Zheng; Zequn,12,0,40,28
1656984293016,MATH 20B,A01,083756,Briones; Jor-el Thomas Caparas,1,0,36,35
1656984293016,MATH 20B,A02,083757,Briones; Jor-el Thomas Caparas,1,0,36,35
1656984293016,MATH 20B,A03,093475,Briones; Jor-el Thomas Caparas,0,0,36,36
1656984299052,MATH 20C,A01,083760,Briones; Jor-el Thomas Caparas,1,0,35,34
1656984299052,MATH 20C,A02,083761,Briones; Jor-el Thomas Caparas,8,0,35,27
1656984299052,MATH 20C,A03,093476,Briones; Jor-el Thomas Caparas,0,1,36,36
1656984299052,MATH 20C,B01,083762,Bach; Quang Tran,0,0,30,30
1656984305075,MATH 20D,A01,083765,Tran; Brian Kha,4,0,30,26
1656984305075,MATH 20D,A02,083766,Tran; Brian Kha,4,0,30,26
1656984305075,MATH 20D,A03,083767,Tran; Brian Kha,3,0,30,27
1656984311100,MATH 20E,A01,083771,Ganguly; Soumya,5,0,32,27
1656984311100,MATH 20E,A02,083772,Ganguly; Soumya,6,0,32,26
1656984311100,MATH 20E,B01,083773,Ciotti; Benjamin,18,0,35,17
1656984311100,MATH 20E,B02,083774,Ciotti; Benjamin,17,0,35,18
1656984317130,MATH 103A,A01,083777,Greenfeld; Be'Eri,2,0,36,34
1656984317130,MATH 103A,A02,083778,Greenfeld; Be'Eri,5,0,36,31
1656984317130,MATH 103A,A03,093561,Greenfeld; Be'Eri,4,0,36,32
1656984317130,MATH 103A,B01,083779,Greenfeld; Be'Eri,6,0,36,30
1656984317130,MATH 103A,B02,083780,Greenfeld; Be'Eri,2,0,36,34
1656984317130,MATH 103A,B03,093562,Greenfeld; Be'Eri,2,0,36,34
1656984323153,MATH 105,A01,085443,Carter; Anne Toulson,14,0,35,21
1656984323153,MATH 105,A02,093477,Carter; Anne Toulson,20,0,35,15
1656984329181,MATH 109,A01,083213,Ganzberger; Geoffrey Michael,2,0,34,32
1656984329181,MATH 109,A02,083214,Ganzberger; Geoffrey Michael,2,0,34,32
1656984329181,MATH 109,A03,093478,Ganzberger; Geoffrey Michael,1,0,34,33
1656984329181,MATH 109,B01,083215,Ganzberger; Geoffrey Michael,1,0,32,31
1656984329181,MATH 109,B02,083216,Ganzberger; Geoffrey Michael,1,0,32,31
1656984329181,MATH 109,B03,093479,Ganzberger; Geoffrey Michael,6,0,32,26
1656984335211,MATH 142A,A01,083219,Chow; Bennett,6,0,32,26
1656984335211,MATH 142A,A02,083220,Chow; Bennett,10,0,32,22
1656984335211,MATH 142A,A03,093480,Chow; Bennett,7,0,32,25
1656984335211,MATH 142A,B03,093481,Chow; Bennett,7,0,32,25
1656984335211,MATH 142A,B04,093558,Chow; Bennett,11,0,32,21
1656984335211,MATH 142A,B05,093559,Chow; Bennett,6,0,32,26
1656984341240,MATH 193A,A01,083224,Rotar; Vladimir,7,0,34,27
1656984341240,MATH 193A,A02,083225,Rotar; Vladimir,4,0,34,30
1656984341240,MATH 193A,A03,083781,Rotar; Vladimir,1,0,34,33
1656984341240,MATH 193A,A04,083782,Rotar; Vladimir,6,0,34,28
1656984341240,MATH 193A,A05,093482,Rotar; Vladimir,6,0,34,28
1656984347267,MATH 197,001,091859,McAuley; Julian John,9999,0,9999,0
1656984347267,MATH 197,002,095566,Kedlaya; Kiran S.,9997,0,9999,2
1656984347267,MATH 197,003,095567,Xiao; Ming,9999,0,9999,0
1656984347267,MATH 197,004,095571,Perols; Johan Lars,9998,0,9999,1
1656984354342,COGS 9,A01,083615,Shannon; Kyle Michael,7,0,75,68
1656984360366,COGS 11,A01,083617,Boyle; Mary E. T.,20,0,48,28
1656984366390,COGS 13,A01,083071,Bastos; Amalia Pinkusfeld,9,0,71,62
1656984372411,COGS 14A,A01,092681,Semenuks; Arturs,0,1,100,100
1656984378434,COGS 14B,A01,083073,Cheng; Tzu-Han,5,0,63,58
1656984384461,COGS 17,A01,092677,Semenuks; Arturs,4,0,81,77
1656984390489,COGS 100,A01,083619,Allen; Michael Gordon,15,0,70,55
1656984396512,COGS 101A,A01,083621,Davis; Joshua Daniel,9,0,68,59
1656984402536,COGS 101B,A01,091572,Allen; Michael Gordon,8,0,65,57
1656984408562,COGS 101C,A01,083625,Delgado; Tania,17,0,35,18
1656984414586,COGS 107A,A01,083627,Boyle; Mary E. T.,13,0,60,47
1656984420611,COGS 118A,A01,083075,Gupta; Anjum,15,0,76,61
1656984426633,CSE 3,A50,083646,Miranda; Gregory Joseph,22,0,50,28
1656984432661,CSE 8A,A50,083650,Miranda; Gregory Joseph,17,1,56,39
1656984438697,CSE 11,A01,083080,Cao; Yingjun,4,15,40,36
1656984444721,CSE 12,A01,083652,Krause-Levy; Sophia Louisa,20,1,120,100
1656984450745,CSE 15L,A01,083654,Morris; Justin Loren,8,0,50,42
1656984450745,CSE 15L,A02,083655,Morris; Justin Loren,8,0,50,42
1656984456774,CSE 20,A01,083657,Tran; Khoa Dang,37,0,80,43
1656984462800,CSE 21,A01,095574,Bach; Quang Tran,21,0,48,27
1656984468825,CSE 30,A01,083084,Eldon; John,4,0,80,76
1656984468825,CSE 30,B01,095061,Bhaskar; Nishant,6,0,50,44
1656984474852,CSE 100,A01,083659,Cao; Yingjun,3,4,70,67
1656984480880,CSE 134B,A01,083661,Powell; Thomas Allan,19,0,100,81
1656984486904,CSE 140,A01,083663,Gungor; Onat,14,0,85,71
1656984492927,CSE 140L,A01,083088,Eldon; John,16,0,100,84
1656984498952,CSE 175,A01,083665,Kumar; Rakesh,3,0,25,22
1656984504975,CSE 190,A00,092507,Dubnov; Shlomo,7,0,20,13
1656984510997,ECE 45,A01,083139,Congero; Spencer William,5,0,75,70
1656984517023,ECE 65,A50,083695,Saad; Andrew S,12,0,30,18
1656984517023,ECE 65,A51,095125,Saad; Andrew S,25,0,26,1
1656984523047,ECE 109,A01,091882,Touri; Behrouz,16,0,70,54
1656984529070,ECE 180,A00,083140,Abi Samra; Nicholas Camill,1,0,30,29
1656984529070,ECE 180,B00,083141,Abi Samra; Nicholas Camill,0,0,30,30
1656984535098,MATH 10A,A01,083735,Patchell; Gregory David,1,0,30,29
1656984535098,MATH 10A,A02,083736,Patchell; Gregory David,20,0,30,10
1656984535098,MATH 10A,A03,083737,Patchell; Gregory David,15,0,30,15
1656984541224,MATH 10B,A01,083207,Lim; Seonhee,7,0,34,27
1656984541224,MATH 10B,A02,083208,Lim; Seonhee,9,0,35,26
1656984541224,MATH 10B,A03,093472,Lim; Seonhee,4,0,34,30
1656984541224,MATH 10B,B01,083739,Sinha; Shubham,9,0,30,21
1656984547249,MATH 18,A01,083743,Cinel; Cameron Alexander,6,0,30,24
1656984547249,MATH 18,A02,083744,Cinel; Cameron Alexander,15,0,30,15
1656984547249,MATH 18,A03,083745,Cinel; Cameron Alexander,8,0,30,22
1656984547249,MATH 18,B01,083748,Rideout; David Porter,4,0,37,33
1656984547249,MATH 18,B02,083749,Rideout; David Porter,3,0,36,33
1656984547249,MATH 18,B03,083750,Rideout; David Porter,2,0,37,35
1656984547249,MATH 18,B04,083751,Rideout; David Porter,5,0,36,31
1656984547249,MATH 18,B05,093473,Rideout; David Porter,4,0,36,32
1656984547249,MATH 18,B06,093474,Rideout; David Porter,5,0,36,31
1656984553276,MATH 20A,A01,083754,Zheng; Zequn,12,0,40,28
1656984559304,MATH 20B,A01,083756,Briones; Jor-el Thomas Caparas,1,0,36,35
1656984559304,MATH 20B,A02,083757,Briones; Jor-el Thomas Caparas,1,0,36,35
1656984559304,MATH 20B,A03,093475,Briones; Jor-el Thomas Caparas,0,0,36,36
1656984565328,MATH 20C,A01,083760,Briones; Jor-el Thomas Caparas,1,0,35,34
1656984565328,MATH 20C,A02,083761,Briones; Jor-el Thomas Caparas,8,0,35,27
1656984565328,MATH 20C,A03,093476,Briones; Jor-el Thomas Caparas,0,1,36,36
1656984565328,MATH 20C,B01,083762,Bach; Quang Tran,0,0,30,30
1656984571353,MATH 20D,A01,083765,Tran; Brian Kha,4,0,30,26
1656984571353,MATH 20D,A02,083766,Tran; Brian Kha,4,0,30,26
1656984571353,MATH 20D,A03,083767,Tran; Brian Kha,3,0,30,27
1656984577376,MATH 20E,A01,083771,Ganguly; Soumya,5,0,32,27
1656984577376,MATH 20E,A02,083772,Ganguly; Soumya,6,0,32,26
1656984577376,MATH 20E,B01,083773,Ciotti; Benjamin,18,0,35,17
1656984577376,MATH 20E,B02,083774,Ciotti; Benjamin,17,0,35,18
1656984583401,MATH 103A,A01,083777,Greenfeld; Be'Eri,2,0,36,34
1656984583401,MATH 103A,A02,083778,Greenfeld; Be'Eri,5,0,36,31
1656984583401,MATH 103A,A03,093561,Greenfeld; Be'Eri,4,0,36,32
1656984583401,MATH 103A,B01,083779,Greenfeld; Be'Eri,6,0,36,30
1656984583401,MATH 103A,B02,083780,Greenfeld; Be'Eri,2,0,36,34
1656984583401,MATH 103A,B03,093562,Greenfeld; Be'Eri,2,0,36,34
1656984589423,MATH 105,A01,085443,Carter; Anne Toulson,14,0,35,21
1656984589423,MATH 105,A02,093477,Carter; Anne Toulson,20,0,35,15
1656984595453,MATH 109,A01,083213,Ganzberger; Geoffrey Michael,2,0,34,32
1656984595453,MATH 109,A02,083214,Ganzberger; Geoffrey Michael,2,0,34,32
1656984595453,MATH 109,A03,093478,Ganzberger; Geoffrey Michael,1,0,34,33
1656984595453,MATH 109,B01,083215,Ganzberger; Geoffrey Michael,1,0,32,31
1656984595453,MATH 109,B02,083216,Ganzberger; Geoffrey Michael,1,0,32,31
1656984595453,MATH 109,B03,093479,Ganzberger; Geoffrey Michael,6,0,32,26
1656984601480,MATH 142A,A01,083219,Chow; Bennett,6,0,32,26
1656984601480,MATH 142A,A02,083220,Chow; Bennett,10,0,32,22
1656984601480,MATH 142A,A03,093480,Chow; Bennett,7,0,32,25
1656984601480,MATH 142A,B03,093481,Chow; Bennett,7,0,32,25
1656984601480,MATH 142A,B04,093558,Chow; Bennett,11,0,32,21
1656984601480,MATH 142A,B05,093559,Chow; Bennett,6,0,32,26
1656984607508,MATH 193A,A01,083224,Rotar; Vladimir,7,0,34,27
1656984607508,MATH 193A,A02,083225,Rotar; Vladimir,4,0,34,30
1656984607508,MATH 193A,A03,083781,Rotar; Vladimir,1,0,34,33
1656984607508,MATH 193A,A04,083782,Rotar; Vladimir,6,0,34,28
1656984607508,MATH 193A,A05,093482,Rotar; Vladimir,6,0,34,28
1656984613531,MATH 197,001,091859,McAuley; Julian John,9999,0,9999,0
1656984613531,MATH 197,002,095566,Kedlaya; Kiran S.,9997,0,9999,2
1656984613531,MATH 197,003,095567,Xiao; Ming,9999,0,9999,0
1656984613531,MATH 197,004,095571,Perols; Johan Lars,9998,0,9999,1
1656984620583,COGS 9,A01,083615,Shannon; Kyle Michael,7,0,75,68
1656984626608,COGS 11,A01,083617,Boyle; Mary E. T.,20,0,48,28
1656984632633,COGS 13,A01,083071,Bastos; Amalia Pinkusfeld,9,0,71,62
1656984638657,COGS 14A,A01,092681,Semenuks; Arturs,0,1,100,100
1656984644681,COGS 14B,A01,083073,Cheng; Tzu-Han,5,0,63,58
1656984650705,COGS 17,A01,092677,Semenuks; Arturs,4,0,81,77
1656984656730,COGS 100,A01,083619,Allen; Michael Gordon,15,0,70,55
1656984662757,COGS 101A,A01,083621,Davis; Joshua Daniel,9,0,68,59
1656984668782,COGS 101B,A01,091572,Allen; Michael Gordon,8,0,65,57
1656984674806,COGS 101C,A01,083625,Delgado; Tania,17,0,35,18
1656984680831,COGS 107A,A01,083627,Boyle; Mary E. T.,13,0,60,47
1656984686854,COGS 118A,A01,083075,Gupta; Anjum,15,0,76,61
1656984692884,CSE 3,A50,083646,Miranda; Gregory Joseph,22,0,50,28
1656984698913,CSE 8A,A50,083650,Miranda; Gregory Joseph,17,1,56,39
1656984704936,CSE 11,A01,083080,Cao; Yingjun,4,15,40,36
1656984710963,CSE 12,A01,083652,Krause-Levy; Sophia Louisa,20,1,120,100
1656984716989,CSE 15L,A01,083654,Morris; Justin Loren,8,0,50,42
1656984716989,CSE 15L,A02,083655,Morris; Justin Loren,8,0,50,42
1656984723019,CSE 20,A01,083657,Tran; Khoa Dang,37,0,80,43
1656984729046,CSE 21,A01,095574,Bach; Quang Tran,21,0,48,27
1656984735070,CSE 30,A01,083084,Eldon; John,4,0,80,76
1656984735070,CSE 30,B01,095061,Bhaskar; Nishant,6,0,50,44
1656984741097,CSE 100,A01,083659,Cao; Yingjun,3,4,70,67
1656984747124,CSE 134B,A01,083661,Powell; Thomas Allan,19,0,100,81
1656984753148,CSE 140,A01,083663,Gungor; Onat,14,0,85,71
1656984759175,CSE 140L,A01,083088,Eldon; John,16,0,100,84
1656984765199,CSE 175,A01,083665,Kumar; Rakesh,3,0,25,22
1656984771222,CSE 190,A00,092507,Dubnov; Shlomo,7,0,20,13
1656984777250,ECE 45,A01,083139,Congero; Spencer William,5,0,75,70
1656984783279,ECE 65,A50,083695,Saad; Andrew S,12,0,30,18
1656984783279,ECE 65,A51,095125,Saad; Andrew S,25,0,26,1
1656984789304,ECE 109,A01,091882,Touri; Behrouz,16,0,70,54
1656984795327,ECE 180,A00,083140,Abi Samra; Nicholas Camill,1,0,30,29
1656984795327,ECE 180,B00,083141,Abi Samra; Nicholas Camill,0,0,30,30
1656984801350,MATH 10A,A01,083735,Patchell; Gregory David,1,0,30,29
1656984801350,MATH 10A,A02,083736,Patchell; Gregory David,20,0,30,10
1656984801350,MATH 10A,A03,083737,Patchell; Gregory David,15,0,30,15
1656984807374,MATH 10B,A01,083207,Lim; Seonhee,7,0,34,27
1656984807374,MATH 10B,A02,083208,Lim; Seonhee,9,0,35,26
1656984807374,MATH 10B,A03,093472,Lim; Seonhee,4,0,34,30
1656984807374,MATH 10B,B01,083739,Sinha; Shubham,9,0,30,21
1656984813399,MATH 18,A01,083743,Cinel; Cameron Alexander,6,0,30,24
1656984813399,MATH 18,A02,083744,Cinel; Cameron Alexander,15,0,30,15
1656984813399,MATH 18,A03,083745,Cinel; Cameron Alexander,8,0,30,22
1656984813399,MATH 18,B01,083748,Rideout; David Porter,4,0,37,33
1656984813399,MATH 18,B02,083749,Rideout; David Porter,3,0,36,33
1656984813399,MATH 18,B03,083750,Rideout; David Porter,2,0,37,35
1656984813399,MATH 18,B04,083751,Rideout; David Porter,5,0,36,31
1656984813399,MATH 18,B05,093473,Rideout; David Porter,4,0,36,32
1656984813399,MATH 18,B06,093474,Rideout; David Porter,5,0,36,31
1656984819425,MATH 20A,A01,083754,Zheng; Zequn,12,0,40,28
1656984825447,MATH 20B,A01,083756,Briones; Jor-el Thomas Caparas,1,0,36,35
1656984825447,MATH 20B,A02,083757,Briones; Jor-el Thomas Caparas,1,0,36,35
1656984825447,MATH 20B,A03,093475,Briones; Jor-el Thomas Caparas,0,0,36,36
1656984831478,MATH 20C,A01,083760,Briones; Jor-el Thomas Caparas,1,0,35,34
1656984831478,MATH 20C,A02,083761,Briones; Jor-el Thomas Caparas,8,0,35,27
1656984831478,MATH 20C,A03,093476,Briones; Jor-el Thomas Caparas,0,1,36,36
1656984831478,MATH 20C,B01,083762,Bach; Quang Tran,0,0,30,30
1656984837503,MATH 20D,A01,083765,Tran; Brian Kha,4,0,30,26
1656984837503,MATH 20D,A02,083766,Tran; Brian Kha,4,0,30,26
1656984837503,MATH 20D,A03,083767,Tran; Brian Kha,3,0,30,27
1656984843528,MATH 20E,A01,083771,Ganguly; Soumya,5,0,32,27
1656984843528,MATH 20E,A02,083772,Ganguly; Soumya,6,0,32,26
1656984843528,MATH 20E,B01,083773,Ciotti; Benjamin,18,0,35,17
1656984843528,MATH 20E,B02,083774,Ciotti; Benjamin,17,0,35,18
1656984849552,MATH 103A,A01,083777,Greenfeld; Be'Eri,2,0,36,34
1656984849552,MATH 103A,A02,083778,Greenfeld; Be'Eri,5,0,36,31
1656984849552,MATH 103A,A03,093561,Greenfeld; Be'Eri,4,0,36,32
1656984849552,MATH 103A,B01,083779,Greenfeld; Be'Eri,6,0,36,30
1656984849552,MATH 103A,B02,083780,Greenfeld; Be'Eri,2,0,36,34
1656984849552,MATH 103A,B03,093562,Greenfeld; Be'Eri,2,0,36,34
1656984855575,MATH 105,A01,085443,Carter; Anne Toulson,14,0,35,21
1656984855575,MATH 105,A02,093477,Carter; Anne Toulson,20,0,35,15
1656984861603,MATH 109,A01,083213,Ganzberger; Geoffrey Michael,2,0,34,32
1656984861603,MATH 109,A02,083214,Ganzberger; Geoffrey Michael,2,0,34,32
1656984861603,MATH 109,A03,093478,Ganzberger; Geoffrey Michael,1,0,34,33
1656984861603,MATH 109,B01,083215,Ganzberger; Geoffrey Michael,1,0,32,31
1656984861603,MATH 109,B02,083216,Ganzberger; Geoffrey Michael,1,0,32,31
1656984861603,MATH 109,B03,093479,Ganzberger; Geoffrey Michael,6,0,32,26
1656984867628,MATH 142A,A01,083219,Chow; Bennett,6,0,32,26
1656984867628,MATH 142A,A02,083220,Chow; Bennett,10,0,32,22
1656984867628,MATH 142A,A03,093480,Chow; Bennett,7,0,32,25
1656984867628,MATH 142A,B03,093481,Chow; Bennett,7,0,32,25
1656984867628,MATH 142A,B04,093558,Chow; Bennett,11,0,32,21
1656984867628,MATH 142A,B05,093559,Chow; Bennett,6,0,32,26
1656984873657,MATH 193A,A01,083224,Rotar; Vladimir,7,0,34,27
1656984873657,MATH 193A,A02,083225,Rotar; Vladimir,4,0,34,30
1656984873657,MATH 193A,A03,083781,Rotar; Vladimir,1,0,34,33
1656984873657,MATH 193A,A04,083782,Rotar; Vladimir,6,0,34,28
1656984873657,MATH 193A,A05,093482,Rotar; Vladimir,6,0,34,28
1656984879685,MATH 197,001,091859,McAuley; Julian John,9999,0,9999,0
1656984879685,MATH 197,002,095566,Kedlaya; Kiran S.,9997,0,9999,2
1656984879685,MATH 197,003,095567,Xiao; Ming,9999,0,9999,0
1656984879685,MATH 197,004,095571,Perols; Johan Lars,9998,0,9999,1
1656984886734,COGS 9,A01,083615,Shannon; Kyle Michael,7,0,75,68
1656984892763,COGS 11,A01,083617,Boyle; Mary E. T.,20,0,48,28
1656984898784,COGS 13,A01,083071,Bastos; Amalia Pinkusfeld,9,0,71,62
1656984904807,COGS 14A,A01,092681,Semenuks; Arturs,0,1,100,100
1656984910830,COGS 14B,A01,083073,Cheng; Tzu-Han,5,0,63,58
1656984916861,COGS 17,A01,092677,Semenuks; Arturs,4,0,81,77
1656984922891,COGS 100,A01,083619,Allen; Michael Gordon,15,0,70,55
1656984928914,COGS 101A,A01,083621,Davis; Joshua Daniel,9,0,68,59
1656984934938,COGS 101B,A01,091572,Allen; Michael Gordon,8,0,65,57
1656984940972,COGS 101C,A01,083625,Delgado; Tania,17,0,35,18
1656984946994,COGS 107A,A01,083627,Boyle; Mary E. T.,13,0,60,47
1656984953021,COGS 118A,A01,083075,Gupta; Anjum,15,0,76,61
1656984959045,CSE 3,A50,083646,Miranda; Gregory Joseph,22,0,50,28
1656984965069,CSE 8A,A50,083650,Miranda; Gregory Joseph,17,1,56,39
1656984971094,CSE 11,A01,083080,Cao; Yingjun,4,15,40,36
1656984977128,CSE 12,A01,083652,Krause-Levy; Sophia Louisa,20,1,120,100
1656984983151,CSE 15L,A01,083654,Morris; Justin Loren,8,0,50,42
1656984983151,CSE 15L,A02,083655,Morris; Justin Loren,8,0,50,42
1656984989179,CSE 20,A01,083657,Tran; Khoa Dang,37,0,80,43
1656984995205,CSE 21,A01,095574,Bach; Quang Tran,21,0,48,27
1656985001229,CSE 30,A01,083084,Eldon; John,4,0,80,76
1656985001229,CSE 30,B01,095061,Bhaskar; Nishant,6,0,50,44
1656985007254,CSE 100,A01,083659,Cao; Yingjun,3,4,70,67
1656985013281,CSE 134B,A01,083661,Powell; Thomas Allan,19,0,100,81
1656985019305,CSE 140,A01,083663,Gungor; Onat,14,0,85,71
1656985025330,CSE 140L,A01,083088,Eldon; John,16,0,100,84
1656985031353,CSE 175,A01,083665,Kumar; Rakesh,3,0,25,22
1656985037377,CSE 190,A00,092507,Dubnov; Shlomo,7,0,20,13
1656985043399,ECE 45,A01,083139,Congero; Spencer William,5,0,75,70
1656985049442,ECE 65,A50,083695,Saad; Andrew S,12,0,30,18
1656985049442,ECE 65,A51,095125,Saad; Andrew S,25,0,26,1
1656985055467,ECE 109,A01,091882,Touri; Behrouz,16,0,70,54
1656985061491,ECE 180,A00,083140,Abi Samra; Nicholas Camill,1,0,30,29
1656985061491,ECE 180,B00,083141,Abi Samra; Nicholas Camill,0,0,30,30
1656985067521,MATH 10A,A01,083735,Patchell; Gregory David,1,0,30,29
1656985067521,MATH 10A,A02,083736,Patchell; Gregory David,20,0,30,10
1656985067521,MATH 10A,A03,083737,Patchell; Gregory David,15,0,30,15
1656985073550,MATH 10B,A01,083207,Lim; Seonhee,7,0,34,27
1656985073550,MATH 10B,A02,083208,Lim; Seonhee,9,0,35,26
1656985073550,MATH 10B,A03,093472,Lim; Seonhee,4,0,34,30
1656985073550,MATH 10B,B01,083739,Sinha; Shubham,9,0,30,21
1656985079576,MATH 18,A01,083743,Cinel; Cameron Alexander,6,0,30,24
1656985079576,MATH 18,A02,083744,Cinel; Cameron Alexander,15,0,30,15
1656985079576,MATH 18,A03,083745,Cinel; Cameron Alexander,8,0,30,22
1656985079576,MATH 18,B01,083748,Rideout; David Porter,4,0,37,33
1656985079576,MATH 18,B02,083749,Rideout; David Porter,3,0,36,33
1656985079576,MATH 18,B03,083750,Rideout; David Porter,2,0,37,35
1656985079576,MATH 18,B04,083751,Rideout; David Porter,5,0,36,31
1656985079576,MATH 18,B05,093473,Rideout; David Porter,4,0,36,32
1656985079576,MATH 18,B06,093474,Rideout; David Porter,5,0,36,31
1656985085599,MATH 20A,A01,083754,Zheng; Zequn,12,0,40,28
1656985091628,MATH 20B,A01,083756,Briones; Jor-el Thomas Caparas,1,0,36,35
1656985091628,MATH 20B,A02,083757,Briones; Jor-el Thomas Caparas,1,0,36,35
1656985091628,MATH 20B,A03,093475,Briones; Jor-el Thomas Caparas,0,0,36,36
1656985097650,MATH 20C,A01,083760,Briones; Jor-el Thomas Caparas,1,0,35,34
1656985097650,MATH 20C,A02,083761,Briones; Jor-el Thomas Caparas,8,0,35,27
1656985097650,MATH 20C,A03,093476,Briones; Jor-el Thomas Caparas,0,1,36,36
1656985097650,MATH 20C,B01,083762,Bach; Quang Tran,0,0,30,30
1656985103672,MATH 20D,A01,083765,Tran; Brian Kha,4,0,30,26
1656985103672,MATH 20D,A02,083766,Tran; Brian Kha,4,0,30,26
1656985103672,MATH 20D,A03,083767,Tran; Brian Kha,3,0,30,27
1656985109695,MATH 20E,A01,083771,Ganguly; Soumya,5,0,32,27
1656985109695,MATH 20E,A02,083772,Ganguly; Soumya,6,0,32,26
1656985109695,MATH 20E,B01,083773,Ciotti; Benjamin,18,0,35,17
1656985109695,MATH 20E,B02,083774,Ciotti; Benjamin,17,0,35,18
1656985115724,MATH 103A,A01,083777,Greenfeld; Be'Eri,2,0,36,34
1656985115724,MATH 103A,A02,083778,Greenfeld; Be'Eri,5,0,36,31
1656985115724,MATH 103A,A03,093561,Greenfeld; Be'Eri,4,0,36,32
1656985115724,MATH 103A,B01,083779,Greenfeld; Be'Eri,6,0,36,30
1656985115724,MATH 103A,B02,083780,Greenfeld; Be'Eri,2,0,36,34
1656985115724,MATH 103A,B03,093562,Greenfeld; Be'Eri,2,0,36,34
1656985121749,MATH 105,A01,085443,Carter; Anne Toulson,14,0,35,21
1656985121749,MATH 105,A02,093477,Carter; Anne Toulson,20,0,35,15
1656985127772,MATH 109,A01,083213,Ganzberger; Geoffrey Michael,2,0,34,32
1656985127772,MATH 109,A02,083214,Ganzberger; Geoffrey Michael,2,0,34,32
1656985127772,MATH 109,A03,093478,Ganzberger; Geoffrey Michael,1,0,34,33
1656985127772,MATH 109,B01,083215,Ganzberger; Geoffrey Michael,1,0,32,31
1656985127772,MATH 109,B02,083216,Ganzberger; Geoffrey Michael,1,0,32,31
1656985127772,MATH 109,B03,093479,Ganzberger; Geoffrey Michael,6,0,32,26
1656985133920,MATH 142A,A01,083219,Chow; Bennett,6,0,32,26
1656985133920,MATH 142A,A02,083220,Chow; Bennett,10,0,32,22
1656985133920,MATH 142A,A03,093480,Chow; Bennett,7,0,32,25
1656985133920,MATH 142A,B03,093481,Chow; Bennett,7,0,32,25
1656985133920,MATH 142A,B04,093558,Chow; Bennett,11,0,32,21
1656985133920,MATH 142A,B05,093559,Chow; Bennett,6,0,32,26
1656985140032,MATH 193A,A01,083224,Rotar; Vladimir,7,0,34,27
1656985140032,MATH 193A,A02,083225,Rotar; Vladimir,4,0,34,30
1656985140032,MATH 193A,A03,083781,Rotar; Vladimir,1,0,34,33
1656985140032,MATH 193A,A04,083782,Rotar; Vladimir,6,0,34,28
1656985140032,MATH 193A,A05,093482,Rotar; Vladimir,6,0,34,28
1656985146059,MATH 197,001,091859,McAuley; Julian John,9999,0,9999,0
1656985146059,MATH 197,002,095566,Kedlaya; Kiran S.,9997,0,9999,2
1656985146059,MATH 197,003,095567,Xiao; Ming,9999,0,9999,0
1656985146059,MATH 197,004,095571,Perols; Johan Lars,9998,0,9999,1
1656985153132,COGS 9,A01,083615,Shannon; Kyle Michael,7,0,75,68
1656985159159,COGS 11,A01,083617,Boyle; Mary E. T.,20,0,48,28
1656985165183,COGS 13,A01,083071,Bastos; Amalia Pinkusfeld,9,0,71,62
1656985171209,COGS 14A,A01,092681,Semenuks; Arturs,0,1,100,100
1656985177235,COGS 14B,A01,083073,Cheng; Tzu-Han,5,0,63,58
1656985183259,COGS 17,A01,092677,Semenuks; Arturs,4,0,81,77
1656985189285,COGS 100,A01,083619,Allen; Michael Gordon,15,0,70,55
1656985195312,COGS 101A,A01,083621,Davis; Joshua Daniel,9,0,68,59
1656985201336,COGS 101B,A01,091572,Allen; Michael Gordon,8,0,65,57
1656985207363,COGS 101C,A01,083625,Delgado; Tania,17,0,35,18
1656985213397,COGS 107A,A01,083627,Boyle; Mary E. T.,13,0,60,47
1656985219430,COGS 118A,A01,083075,Gupta; Anjum,15,0,76,61
1656985225458,CSE 3,A50,083646,Miranda; Gregory Joseph,22,0,50,28
1656985231483,CSE 8A,A50,083650,Miranda; Gregory Joseph,17,1,56,39
1656985237506,CSE 11,A01,083080,Cao; Yingjun,4,15,40,36
1656985243538,CSE 12,A01,083652,Krause-Levy; Sophia Louisa,20,1,120,100
1656985249564,CSE 15L,A01,083654,Morris; Justin Loren,8,0,50,42
1656985249564,CSE 15L,A02,083655,Morris; Justin Loren,8,0,50,42
1656985255591,CSE 20,A01,083657,Tran; Khoa Dang,37,0,80,43
1656985261617,CSE 21,A01,095574,Bach; Quang Tran,21,0,48,27
1656985267643,CSE 30,A01,083084,Eldon; John,4,0,80,76
1656985267643,CSE 30,B01,095061,Bhaskar; Nishant,6,0,50,44
1656985273665,CSE 100,A01,083659,Cao; Yingjun,3,4,70,67
1656985279692,CSE 134B,A01,083661,Powell; Thomas Allan,19,0,100,81
1656985285718,CSE 140,A01,083663,Gungor; Onat,14,0,85,71
1656985291741,CSE 140L,A01,083088,Eldon; John,16,0,100,84
1656985297762,CSE 175,A01,083665,Kumar; Rakesh,3,0,25,22
1656985303786,CSE 190,A00,092507,Dubnov; Shlomo,7,0,20,13
1656985309808,ECE 45,A01,083139,Congero; Spencer William,5,0,75,70
1656985315835,ECE 65,A50,083695,Saad; Andrew S,12,0,30,18
1656985315835,ECE 65,A51,095125,Saad; Andrew S,25,0,26,1
1656985321858,ECE 109,A01,091882,Touri; Behrouz,16,0,70,54
1656985327883,ECE 180,A00,083140,Abi Samra; Nicholas Camill,1,0,30,29
1656985327883,ECE 180,B00,083141,Abi Samra; Nicholas Camill,0,0,30,30
1656985333913,MATH 10A,A01,083735,Patchell; Gregory David,1,0,30,29
1656985333913,MATH 10A,A02,083736,Patchell; Gregory David,20,0,30,10
1656985333913,MATH 10A,A03,083737,Patchell; Gregory David,15,0,30,15
1656985339936,MATH 10B,A01,083207,Lim; Seonhee,7,0,34,27
1656985339936,MATH 10B,A02,083208,Lim; Seonhee,9,0,35,26
1656985339936,MATH 10B,A03,093472,Lim; Seonhee,4,0,34,30
1656985339936,MATH 10B,B01,083739,Sinha; Shubham,9,0,30,21
1656985345971,MATH 18,A01,083743,Cinel; Cameron Alexander,6,0,30,24
1656985345971,MATH 18,A02,083744,Cinel; Cameron Alexander,15,0,30,15
1656985345971,MATH 18,A03,083745,Cinel; Cameron Alexander,8,0,30,22
1656985345971,MATH 18,B01,083748,Rideout; David Porter,4,0,37,33
1656985345971,MATH 18,B02,083749,Rideout; David Porter,3,0,36,33
1656985345971,MATH 18,B03,083750,Rideout; David Porter,2,0,37,35
1656985345971,MATH 18,B04,083751,Rideout; David Porter,5,0,36,31
1656985345971,MATH 18,B05,093473,Rideout; David Porter,4,0,36,32
1656985345971,MATH 18,B06,093474,Rideout; David Porter,5,0,36,31
1656985351998,MATH 20A,A01,083754,Zheng; Zequn,12,0,40,28
1656985358022,MATH 20B,A01,083756,Briones; Jor-el Thomas Caparas,1,0,36,35
1656985358022,MATH 20B,A02,083757,Briones; Jor-el Thomas Caparas,1,0,36,35
1656985358022,MATH 20B,A03,093475,Briones; Jor-el Thomas Caparas,0,0,36,36
1656985364045,MATH 20C,A01,083760,Briones; Jor-el Thomas Caparas,1,0,35,34
1656985364045,MATH 20C,A02,083761,Briones; Jor-el Thomas Caparas,8,0,35,27
1656985364045,MATH 20C,A03,093476,Briones; Jor-el Thomas Caparas,0,1,36,36
1656985364045,MATH 20C,B01,083762,Bach; Quang Tran,0,0,30,30
1656985370071,MATH 20D,A01,083765,Tran; Brian Kha,4,0,30,26
1656985370071,MATH 20D,A02,083766,Tran; Brian Kha,4,0,30,26
1656985370071,MATH 20D,A03,083767,Tran; Brian Kha,3,0,30,27
1656985376096,MATH 20E,A01,083771,Ganguly; Soumya,5,0,32,27
1656985376096,MATH 20E,A02,083772,Ganguly; Soumya,6,0,32,26
1656985376096,MATH 20E,B01,083773,Ciotti; Benjamin,18,0,35,17
1656985376096,MATH 20E,B02,083774,Ciotti; Benjamin,17,0,35,18
1656985382119,MATH 103A,A01,083777,Greenfeld; Be'Eri,2,0,36,34
1656985382119,MATH 103A,A02,083778,Greenfeld; Be'Eri,5,0,36,31
1656985382119,MATH 103A,A03,093561,Greenfeld; Be'Eri,4,0,36,32
1656985382119,MATH 103A,B01,083779,Greenfeld; Be'Eri,6,0,36,30
1656985382119,MATH 103A,B02,083780,Greenfeld; Be'Eri,2,0,36,34
1656985382119,MATH 103A,B03,093562,Greenfeld; Be'Eri,2,0,36,34
1656985388141,MATH 105,A01,085443,Carter; Anne Toulson,14,0,35,21
1656985388141,MATH 105,A02,093477,Carter; Anne Toulson,20,0,35,15
1656985394166,MATH 109,A01,083213,Ganzberger; Geoffrey Michael,2,0,34,32
1656985394166,MATH 109,A02,083214,Ganzberger; Geoffrey Michael,2,0,34,32
1656985394166,MATH 109,A03,093478,Ganzberger; Geoffrey Michael,1,0,34,33
1656985394166,MATH 109,B01,083215,Ganzberger; Geoffrey Michael,1,0,32,31
1656985394166,MATH 109,B02,083216,Ganzberger; Geoffrey Michael,1,0,32,31
1656985394166,MATH 109,B03,093479,Ganzberger; Geoffrey Michael,6,0,32,26
1656985400189,MATH 142A,A01,083219,Chow; Bennett,6,0,32,26
1656985400189,MATH 142A,A02,083220,Chow; Bennett,10,0,32,22
1656985400189,MATH 142A,A03,093480,Chow; Bennett,7,0,32,25
1656985400189,MATH 142A,B03,093481,Chow; Bennett,7,0,32,25
1656985400189,MATH 142A,B04,093558,Chow; Bennett,11,0,32,21
1656985400189,MATH 142A,B05,093559,Chow; Bennett,6,0,32,26
1656985406212,MATH 193A,A01,083224,Rotar; Vladimir,7,0,34,27
1656985406212,MATH 193A,A02,083225,Rotar; Vladimir,4,0,34,30
1656985406212,MATH 193A,A03,083781,Rotar; Vladimir,1,0,34,33
1656985406212,MATH 193A,A04,083782,Rotar; Vladimir,6,0,34,28
1656985406212,MATH 193A,A05,093482,Rotar; Vladimir,6,0,34,28
1656985412239,MATH 197,001,091859,McAuley; Julian John,9999,0,9999,0
1656985412239,MATH 197,002,095566,Kedlaya; Kiran S.,9997,0,9999,2
1656985412239,MATH 197,003,095567,Xiao; Ming,9999,0,9999,0
1656985412239,MATH 197,004,095571,Perols; Johan Lars,9998,0,9999,1
1656985419302,COGS 9,A01,083615,Shannon; Kyle Michael,7,0,75,68
1656985425325,COGS 11,A01,083617,Boyle; Mary E. T.,20,0,48,28
1656985431349,COGS 13,A01,083071,Bastos; Amalia Pinkusfeld,9,0,71,62
1656985437375,COGS 14A,A01,092681,Semenuks; Arturs,0,1,100,100
1656985443402,COGS 14B,A01,083073,Cheng; Tzu-Han,5,0,63,58
1656985449427,COGS 17,A01,092677,Semenuks; Arturs,4,0,81,77
1656985455453,COGS 100,A01,083619,Allen; Michael Gordon,15,0,70,55
1656985461476,COGS 101A,A01,083621,Davis; Joshua Daniel,9,0,68,59
1656985467505,COGS 101B,A01,091572,Allen; Michael Gordon,8,0,65,57
1656985473530,COGS 101C,A01,083625,Delgado; Tania,17,0,35,18
1656985479556,COGS 107A,A01,083627,Boyle; Mary E. T.,13,0,60,47
1656985485578,COGS 118A,A01,083075,Gupta; Anjum,15,0,76,61
1656985491606,CSE 3,A50,083646,Miranda; Gregory Joseph,22,0,50,28
1656985497633,CSE 8A,A50,083650,Miranda; Gregory Joseph,17,1,56,39
1656985503656,CSE 11,A01,083080,Cao; Yingjun,4,15,40,36
1656985509682,CSE 12,A01,083652,Krause-Levy; Sophia Louisa,20,1,120,100
1656985515706,CSE 15L,A01,083654,Morris; Justin Loren,8,0,50,42
1656985515706,CSE 15L,A02,083655,Morris; Justin Loren,8,0,50,42
1656985521728,CSE 20,A01,083657,Tran; Khoa Dang,37,0,80,43
1656985527752,CSE 21,A01,095574,Bach; Quang Tran,21,0,48,27
1656985533778,CSE 30,A01,083084,Eldon; John,4,0,80,76
1656985533778,CSE 30,B01,095061,Bhaskar; Nishant,6,0,50,44
1656985539805,CSE 100,A01,083659,Cao; Yingjun,3,4,70,67
1656985545832,CSE 134B,A01,083661,Powell; Thomas Allan,19,0,100,81
1656985551854,CSE 140,A01,083663,Gungor; Onat,14,0,85,71
1656985557879,CSE 140L,A01,083088,Eldon; John,16,0,100,84
1656985563905,CSE 175,A01,083665,Kumar; Rakesh,3,0,25,22
1656985569928,CSE 190,A00,092507,Dubnov; Shlomo,7,0,20,13
1656985575951,ECE 45,A01,083139,Congero; Spencer William,5,0,75,70
1656985581984,ECE 65,A50,083695,Saad; Andrew S,12,0,30,18
1656985581984,ECE 65,A51,095125,Saad; Andrew S,25,0,26,1
1656985588009,ECE 109,A01,091882,Touri; Behrouz,16,0,70,54
1656985594033,ECE 180,A00,083140,Abi Samra; Nicholas Camill,1,0,30,29
1656985594033,ECE 180,B00,083141,Abi Samra; Nicholas Camill,0,0,30,30
1656985600061,MATH 10A,A01,083735,Patchell; Gregory David,1,0,30,29
1656985600061,MATH 10A,A02,083736,Patchell; Gregory David,20,0,30,10
1656985600061,MATH 10A,A03,083737,Patchell; Gregory David,15,0,30,15
1656985606085,MATH 10B,A01,083207,Lim; Seonhee,7,0,34,27
1656985606085,MATH 10B,A02,083208,Lim; Seonhee,9,0,35,26
1656985606085,MATH 10B,A03,093472,Lim; Seonhee,4,0,34,30
1656985606085,MATH 10B,B01,083739,Sinha; Shubham,9,0,30,21
1656985612116,MATH 18,A01,083743,Cinel; Cameron Alexander,6,0,30,24
1656985612116,MATH 18,A02,083744,Cinel; Cameron Alexander,15,0,30,15
1656985612116,MATH 18,A03,083745,Cinel; Cameron Alexander,8,0,30,22
1656985612116,MATH 18,B01,083748,Rideout; David Porter,4,0,37,33
1656985612116,MATH 18,B02,083749,Rideout; David Porter,3,0,36,33
1656985612116,MATH 18,B03,083750,Rideout; David Porter,2,0,37,35
1656985612116,MATH 18,B04,083751,Rideout; David Porter,5,0,36,31
1656985612116,MATH 18,B05,093473,Rideout; David Porter,4,0,36,32
1656985612116,MATH 18,B06,093474,Rideout; David Porter,5,0,36,31
1656985618143,MATH 20A,A01,083754,Zheng; Zequn,12,0,40,28
1656985624167,MATH 20B,A01,083756,Briones; Jor-el Thomas Caparas,1,0,36,35
1656985624167,MATH 20B,A02,083757,Briones; Jor-el Thomas Caparas,1,0,36,35
1656985624167,MATH 20B,A03,093475,Briones; Jor-el Thomas Caparas,0,0,36,36
1656985630191,MATH 20C,A01,083760,Briones; Jor-el Thomas Caparas,1,0,35,34
1656985630191,MATH 20C,A02,083761,Briones; Jor-el Thomas Caparas,8,0,35,27
1656985630191,MATH 20C,A03,093476,Briones; Jor-el Thomas Caparas,0,1,36,36
1656985630191,MATH 20C,B01,083762,Bach; Quang Tran,0,0,30,30
1656985636216,MATH 20D,A01,083765,Tran; Brian Kha,4,0,30,26
1656985636216,MATH 20D,A02,083766,Tran; Brian Kha,4,0,30,26
1656985636216,MATH 20D,A03,083767,Tran; Brian Kha,3,0,30,27
1656985642239,MATH 20E,A01,083771,Ganguly; Soumya,5,0,32,27
1656985642239,MATH 20E,A02,083772,Ganguly; Soumya,6,0,32,26
1656985642239,MATH 20E,B01,083773,Ciotti; Benjamin,18,0,35,17
1656985642239,MATH 20E,B02,083774,Ciotti; Benjamin,17,0,35,18
1656985648267,MATH 103A,A01,083777,Greenfeld; Be'Eri,2,0,36,34
1656985648267,MATH 103A,A02,083778,Greenfeld; Be'Eri,5,0,36,31
1656985648267,MATH 103A,A03,093561,Greenfeld; Be'Eri,4,0,36,32
1656985648267,MATH 103A,B01,083779,Greenfeld; Be'Eri,6,0,36,30
1656985648267,MATH 103A,B02,083780,Greenfeld; Be'Eri,2,0,36,34
1656985648267,MATH 103A,B03,093562,Greenfeld; Be'Eri,2,0,36,34
1656985654290,MATH 105,A01,085443,Carter; Anne Toulson,14,0,35,21
1656985654290,MATH 105,A02,093477,Carter; Anne Toulson,20,0,35,15
1656985660313,MATH 109,A01,083213,Ganzberger; Geoffrey Michael,2,0,34,32
1656985660313,MATH 109,A02,083214,Ganzberger; Geoffrey Michael,2,0,34,32
1656985660313,MATH 109,A03,093478,Ganzberger; Geoffrey Michael,1,0,34,33
1656985660313,MATH 109,B01,083215,Ganzberger; Geoffrey Michael,1,0,32,31
1656985660313,MATH 109,B02,083216,Ganzberger; Geoffrey Michael,1,0,32,31
1656985660313,MATH 109,B03,093479,Ganzberger; Geoffrey Michael,6,0,32,26
1656985666337,MATH 142A,A01,083219,Chow; Bennett,6,0,32,26
1656985666337,MATH 142A,A02,083220,Chow; Bennett,10,0,32,22
1656985666337,MATH 142A,A03,093480,Chow; Bennett,7,0,32,25
1656985666337,MATH 142A,B03,093481,Chow; Bennett,7,0,32,25
1656985666337,MATH 142A,B04,093558,Chow; Bennett,11,0,32,21
1656985666337,MATH 142A,B05,093559,Chow; Bennett,6,0,32,26
1656985672359,MATH 193A,A01,083224,Rotar; Vladimir,7,0,34,27
1656985672359,MATH 193A,A02,083225,Rotar; Vladimir,4,0,34,30
1656985672359,MATH 193A,A03,083781,Rotar; Vladimir,1,0,34,33
1656985672359,MATH 193A,A04,083782,Rotar; Vladimir,6,0,34,28
1656985672359,MATH 193A,A05,093482,Rotar; Vladimir,6,0,34,28
1656985678381,MATH 197,001,091859,McAuley; Julian John,9999,0,9999,0
1656985678381,MATH 197,002,095566,Kedlaya; Kiran S.,9997,0,9999,2
1656985678381,MATH 197,003,095567,Xiao; Ming,9999,0,9999,0
1656985678381,MATH 197,004,095571,Perols; Johan Lars,9998,0,9999,1
1656985685437,COGS 9,A01,083615,Shannon; Kyle Michael,7,0,75,68
1656985691459,COGS 11,A01,083617,Boyle; Mary E. T.,20,0,48,28
1656985697483,COGS 13,A01,083071,Bastos; Amalia Pinkusfeld,9,0,71,62
1656985703508,COGS 14A,A01,092681,Semenuks; Arturs,0,1,100,100
1656985709534,COGS 14B,A01,083073,Cheng; Tzu-Han,5,0,63,58
1656985715558,COGS 17,A01,092677,Semenuks; Arturs,4,0,81,77
1656985721579,COGS 100,A01,083619,Allen; Michael Gordon,15,0,70,55
1656985727609,COGS 101A,A01,083621,Davis; Joshua Daniel,9,0,68,59
1656985733740,COGS 101B,A01,091572,Allen; Michael Gordon,8,0,65,57
1656985739764,COGS 101C,A01,083625,Delgado; Tania,17,0,35,18
1656985745787,COGS 107A,A01,083627,Boyle; Mary E. T.,13,0,60,47
1656985751810,COGS 118A,A01,083075,Gupta; Anjum,15,0,76,61
1656985757834,CSE 3,A50,083646,Miranda; Gregory Joseph,22,0,50,28
1656985763862,CSE 8A,A50,083650,Miranda; Gregory Joseph,17,1,56,39
1656985769886,CSE 11,A01,083080,Cao; Yingjun,4,15,40,36
1656985775908,CSE 12,A01,083652,Krause-Levy; Sophia Louisa,20,1,120,100
1656985781934,CSE 15L,A01,083654,Morris; Justin Loren,8,0,50,42
1656985781934,CSE 15L,A02,083655,Morris; Justin Loren,8,0,50,42
1656985787958,CSE 20,A01,083657,Tran; Khoa Dang,37,0,80,43
1656985793983,CSE 21,A01,095574,Bach; Quang Tran,21,0,48,27
1656985800009,CSE 30,A01,083084,Eldon; John,4,0,80,76
1656985800009,CSE 30,B01,095061,Bhaskar; Nishant,6,0,50,44
1656985806042,CSE 100,A01,083659,Cao; Yingjun,3,4,70,67
1656985812069,CSE 134B,A01,083661,Powell; Thomas Allan,19,0,100,81
1656985818094,CSE 140,A01,083663,Gungor; Onat,14,0,85,71
1656985824117,CSE 140L,A01,083088,Eldon; John,16,0,100,84
1656985830141,CSE 175,A01,083665,Kumar; Rakesh,3,0,25,22
1656985836168,CSE 190,A00,092507,Dubnov; Shlomo,7,0,20,13
1656985842191,ECE 45,A01,083139,Congero; Spencer William,5,0,75,70
1656985848214,ECE 65,A50,083695,Saad; Andrew S,12,0,30,18
1656985848214,ECE 65,A51,095125,Saad; Andrew S,25,0,26,1
1656985854238,ECE 109,A01,091882,Touri; Behrouz,16,0,70,54
1656985860263,ECE 180,A00,083140,Abi Samra; Nicholas Camill,1,0,30,29
1656985860263,ECE 180,B00,083141,Abi Samra; Nicholas Camill,0,0,30,30
1656985866289,MATH 10A,A01,083735,Patchell; Gregory David,1,0,30,29
1656985866289,MATH 10A,A02,083736,Patchell; Gregory David,20,0,30,10
1656985866289,MATH 10A,A03,083737,Patchell; Gregory David,15,0,30,15
1656985872313,MATH 10B,A01,083207,Lim; Seonhee,7,0,34,27
1656985872313,MATH 10B,A02,083208,Lim; Seonhee,9,0,35,26
1656985872313,MATH 10B,A03,093472,Lim; Seonhee,4,0,34,30
1656985872313,MATH 10B,B01,083739,Sinha; Shubham,9,0,30,21
1656985878338,MATH 18,A01,083743,Cinel; Cameron Alexander,6,0,30,24
1656985878338,MATH 18,A02,083744,Cinel; Cameron Alexander,15,0,30,15
1656985878338,MATH 18,A03,083745,Cinel; Cameron Alexander,8,0,30,22
1656985878338,MATH 18,B01,083748,Rideout; David Porter,4,0,37,33
1656985878338,MATH 18,B02,083749,Rideout; David Porter,3,0,36,33
1656985878338,MATH 18,B03,083750,Rideout; David Porter,2,0,37,35
1656985878338,MATH 18,B04,083751,Rideout; David Porter,5,0,36,31
1656985878338,MATH 18,B05,093473,Rideout; David Porter,4,0,36,32
1656985878338,MATH 18,B06,093474,Rideout; David Porter,5,0,36,31
1656985884370,MATH 20A,A01,083754,Zheng; Zequn,12,0,40,28
1656985890404,MATH 20B,A01,083756,Briones; Jor-el Thomas Caparas,1,0,36,35
1656985890404,MATH 20B,A02,083757,Briones; Jor-el Thomas Caparas,1,0,36,35
1656985890404,MATH 20B,A03,093475,Briones; Jor-el Thomas Caparas,0,0,36,36
1656985896433,MATH 20C,A01,083760,Briones; Jor-el Thomas Caparas,1,0,35,34
1656985896433,MATH 20C,A02,083761,Briones; Jor-el Thomas Caparas,8,0,35,27
1656985896433,MATH 20C,A03,093476,Briones; Jor-el Thomas Caparas,0,1,36,36
1656985896433,MATH 20C,B01,083762,Bach; Quang Tran,0,0,30,30
1656985902463,MATH 20D,A01,083765,Tran; Brian Kha,4,0,30,26
1656985902463,MATH 20D,A02,083766,Tran; Brian Kha,4,0,30,26
1656985902463,MATH 20D,A03,083767,Tran; Brian Kha,3,0,30,27
1656985908488,MATH 20E,A01,083771,Ganguly; Soumya,5,0,32,27
1656985908488,MATH 20E,A02,083772,Ganguly; Soumya,6,0,32,26
1656985908488,MATH 20E,B01,083773,Ciotti; Benjamin,18,0,35,17
1656985908488,MATH 20E,B02,083774,Ciotti; Benjamin,17,0,35,18
1656985914523,MATH 103A,A01,083777,Greenfeld; Be'Eri,2,0,36,34
1656985914523,MATH 103A,A02,083778,Greenfeld; Be'Eri,5,0,36,31
1656985914523,MATH 103A,A03,093561,Greenfeld; Be'Eri,4,0,36,32
1656985914523,MATH 103A,B01,083779,Greenfeld; Be'Eri,6,0,36,30
1656985914523,MATH 103A,B02,083780,Greenfeld; Be'Eri,2,0,36,34
1656985914523,MATH 103A,B03,093562,Greenfeld; Be'Eri,2,0,36,34
1656985920553,MATH 105,A01,085443,Carter; Anne Toulson,14,0,35,21
1656985920553,MATH 105,A02,093477,Carter; Anne Toulson,20,0,35,15
1656985926577,MATH 109,A01,083213,Ganzberger; Geoffrey Michael,2,0,34,32
1656985926577,MATH 109,A02,083214,Ganzberger; Geoffrey Michael,2,0,34,32
1656985926577,MATH 109,A03,093478,Ganzberger; Geoffrey Michael,1,0,34,33
1656985926577,MATH 109,B01,083215,Ganzberger; Geoffrey Michael,1,0,32,31
1656985926577,MATH 109,B02,083216,Ganzberger; Geoffrey Michael,1,0,32,31
1656985926577,MATH 109,B03,093479,Ganzberger; Geoffrey Michael,6,0,32,26
1656985932601,MATH 142A,A01,083219,Chow; Bennett,6,0,32,26
1656985932601,MATH 142A,A02,083220,Chow; Bennett,10,0,32,22
1656985932601,MATH 142A,A03,093480,Chow; Bennett,7,0,32,25
1656985932601,MATH 142A,B03,093481,Chow; Bennett,7,0,32,25
1656985932601,MATH 142A,B04,093558,Chow; Bennett,11,0,32,21
1656985932601,MATH 142A,B05,093559,Chow; Bennett,6,0,32,26
1656985938629,MATH 193A,A01,083224,Rotar; Vladimir,7,0,34,27
1656985938629,MATH 193A,A02,083225,Rotar; Vladimir,4,0,34,30
1656985938629,MATH 193A,A03,083781,Rotar; Vladimir,1,0,34,33
1656985938629,MATH 193A,A04,083782,Rotar; Vladimir,6,0,34,28
1656985938629,MATH 193A,A05,093482,Rotar; Vladimir,6,0,34,28
1656985944654,MATH 197,001,091859,McAuley; Julian John,9999,0,9999,0
1656985944654,MATH 197,002,095566,Kedlaya; Kiran S.,9997,0,9999,2
1656985944654,MATH 197,003,095567,Xiao; Ming,9999,0,9999,0
1656985944654,MATH 197,004,095571,Perols; Johan Lars,9998,0,9999,1
1656985951705,COGS 9,A01,083615,Shannon; Kyle Michael,7,0,75,68
1656985957731,COGS 11,A01,083617,Boyle; Mary E. T.,20,0,48,28
1656985963754,COGS 13,A01,083071,Bastos; Amalia Pinkusfeld,9,0,71,62
1656985969780,COGS 14A,A01,092681,Semenuks; Arturs,0,1,100,100
1656985975802,COGS 14B,A01,083073,Cheng; Tzu-Han,5,0,63,58
1656985981828,COGS 17,A01,092677,Semenuks; Arturs,4,0,81,77
1656985987851,COGS 100,A01,083619,Allen; Michael Gordon,15,0,70,55
1656985993875,COGS 101A,A01,083621,Davis; Joshua Daniel,9,0,68,59
1656985999903,COGS 101B,A01,091572,Allen; Michael Gordon,8,0,65,57
1656986005925,COGS 101C,A01,083625,Delgado; Tania,17,0,35,18
1656986011951,COGS 107A,A01,083627,Boyle; Mary E. T.,13,0,60,47
1656986017973,COGS 118A,A01,083075,Gupta; Anjum,15,0,76,61
1656986023995,CSE 3,A50,083646,Miranda; Gregory Joseph,22,0,50,28
1656986030021,CSE 8A,A50,083650,Miranda; Gregory Joseph,17,1,56,39
1656986036045,CSE 11,A01,083080,Cao; Yingjun,4,15,40,36
1656986042072,CSE 12,A01,083652,Krause-Levy; Sophia Louisa,20,1,120,100
1656986048094,CSE 15L,A01,083654,Morris; Justin Loren,8,0,50,42
1656986048094,CSE 15L,A02,083655,Morris; Justin Loren,8,0,50,42
1656986054122,CSE 20,A01,083657,Tran; Khoa Dang,37,0,80,43
1656986060149,CSE 21,A01,095574,Bach; Quang Tran,21,0,48,27
1656986066172,CSE 30,A01,083084,Eldon; John,4,0,80,76
1656986066172,CSE 30,B01,095061,Bhaskar; Nishant,6,0,50,44
1656986072195,CSE 100,A01,083659,Cao; Yingjun,3,4,70,67
1656986078218,CSE 134B,A01,083661,Powell; Thomas Allan,19,0,100,81
1656986084244,CSE 140,A01,083663,Gungor; Onat,14,0,85,71
1656986090269,CSE 140L,A01,083088,Eldon; John,16,0,100,84
1656986096292,CSE 175,A01,083665,Kumar; Rakesh,3,0,25,22
1656986102317,CSE 190,A00,092507,Dubnov; Shlomo,7,0,20,13
1656986108340,ECE 45,A01,083139,Congero; Spencer William,5,0,75,70
1656986114367,ECE 65,A50,083695,Saad; Andrew S,12,0,30,18
1656986114367,ECE 65,A51,095125,Saad; Andrew S,25,0,26,1
1656986120393,ECE 109,A01,091882,Touri; Behrouz,16,0,70,54
1656986126416,ECE 180,A00,083140,Abi Samra; Nicholas Camill,1,0,30,29
1656986126416,ECE 180,B00,083141,Abi Samra; Nicholas Camill,0,0,30,30
1656986132439,MATH 10A,A01,083735,Patchell; Gregory David,1,0,30,29
1656986132439,MATH 10A,A02,083736,Patchell; Gregory David,20,0,30,10
1656986132439,MATH 10A,A03,083737,Patchell; Gregory David,15,0,30,15
1656986138462,MATH 10B,A01,083207,Lim; Seonhee,7,0,34,27
1656986138462,MATH 10B,A02,083208,Lim; Seonhee,9,0,35,26
1656986138462,MATH 10B,A03,093472,Lim; Seonhee,4,0,34,30
1656986138462,MATH 10B,B01,083739,Sinha; Shubham,9,0,30,21
1656986144487,MATH 18,A01,083743,Cinel; Cameron Alexander,6,0,30,24
1656986144487,MATH 18,A02,083744,Cinel; Cameron Alexander,15,0,30,15
1656986144487,MATH 18,A03,083745,Cinel; Cameron Alexander,8,0,30,22
1656986144487,MATH 18,B01,083748,Rideout; David Porter,4,0,37,33
1656986144487,MATH 18,B02,083749,Rideout; David Porter,3,0,36,33
1656986144487,MATH 18,B03,083750,Rideout; David Porter,2,0,37,35
1656986144487,MATH 18,B04,083751,Rideout; David Porter,5,0,36,31
1656986144487,MATH 18,B05,093473,Rideout; David Porter,4,0,36,32
1656986144487,MATH 18,B06,093474,Rideout; David Porter,5,0,36,31
1656986150513,MATH 20A,A01,083754,Zheng; Zequn,12,0,40,28
1656986156543,MATH 20B,A01,083756,Briones; Jor-el Thomas Caparas,1,0,36,35
1656986156543,MATH 20B,A02,083757,Briones; Jor-el Thomas Caparas,1,0,36,35
1656986156543,MATH 20B,A03,093475,Briones; Jor-el Thomas Caparas,0,0,36,36
1656986162567,MATH 20C,A01,083760,Briones; Jor-el Thomas Caparas,1,0,35,34
1656986162567,MATH 20C,A02,083761,Briones; Jor-el Thomas Caparas,8,0,35,27
1656986162567,MATH 20C,A03,093476,Briones; Jor-el Thomas Caparas,0,1,36,36
1656986162567,MATH 20C,B01,083762,Bach; Quang Tran,0,0,30,30
1656986168590,MATH 20D,A01,083765,Tran; Brian Kha,4,0,30,26
1656986168590,MATH 20D,A02,083766,Tran; Brian Kha,4,0,30,26
1656986168590,MATH 20D,A03,083767,Tran; Brian Kha,3,0,30,27
1656986174611,MATH 20E,A01,083771,Ganguly; Soumya,5,0,32,27
1656986174611,MATH 20E,A02,083772,Ganguly; Soumya,6,0,32,26
1656986174611,MATH 20E,B01,083773,Ciotti; Benjamin,18,0,35,17
1656986174611,MATH 20E,B02,083774,Ciotti; Benjamin,17,0,35,18
1656986180641,MATH 103A,A01,083777,Greenfeld; Be'Eri,2,0,36,34
1656986180641,MATH 103A,A02,083778,Greenfeld; Be'Eri,5,0,36,31
1656986180641,MATH 103A,A03,093561,Greenfeld; Be'Eri,4,0,36,32
1656986180641,MATH 103A,B01,083779,Greenfeld; Be'Eri,6,0,36,30
1656986180641,MATH 103A,B02,083780,Greenfeld; Be'Eri,2,0,36,34
1656986180641,MATH 103A,B03,093562,Greenfeld; Be'Eri,2,0,36,34
1656986186668,MATH 105,A01,085443,Carter; Anne Toulson,14,0,35,21
1656986186668,MATH 105,A02,093477,Carter; Anne Toulson,20,0,35,15
1656986192692,MATH 109,A01,083213,Ganzberger; Geoffrey Michael,2,0,34,32
1656986192692,MATH 109,A02,083214,Ganzberger; Geoffrey Michael,2,0,34,32
1656986192692,MATH 109,A03,093478,Ganzberger; Geoffrey Michael,1,0,34,33
1656986192692,MATH 109,B01,083215,Ganzberger; Geoffrey Michael,1,0,32,31
1656986192692,MATH 109,B02,083216,Ganzberger; Geoffrey Michael,1,0,32,31
1656986192692,MATH 109,B03,093479,Ganzberger; Geoffrey Michael,6,0,32,26
1656986198721,MATH 142A,A01,083219,Chow; Bennett,6,0,32,26
1656986198721,MATH 142A,A02,083220,Chow; Bennett,10,0,32,22
1656986198721,MATH 142A,A03,093480,Chow; Bennett,7,0,32,25
1656986198721,MATH 142A,B03,093481,Chow; Bennett,7,0,32,25
1656986198721,MATH 142A,B04,093558,Chow; Bennett,11,0,32,21
1656986198721,MATH 142A,B05,093559,Chow; Bennett,6,0,32,26
1656986204744,MATH 193A,A01,083224,Rotar; Vladimir,7,0,34,27
1656986204744,MATH 193A,A02,083225,Rotar; Vladimir,4,0,34,30
1656986204744,MATH 193A,A03,083781,Rotar; Vladimir,1,0,34,33
1656986204744,MATH 193A,A04,083782,Rotar; Vladimir,6,0,34,28
1656986204744,MATH 193A,A05,093482,Rotar; Vladimir,6,0,34,28
1656986210768,MATH 197,001,091859,McAuley; Julian John,9999,0,9999,0
1656986210768,MATH 197,002,095566,Kedlaya; Kiran S.,9997,0,9999,2
1656986210768,MATH 197,003,095567,Xiao; Ming,9999,0,9999,0
1656986210768,MATH 197,004,095571,Perols; Johan Lars,9998,0,9999,1
1656986217825,COGS 9,A01,083615,Shannon; Kyle Michael,7,0,75,68
1656986223853,COGS 11,A01,083617,Boyle; Mary E. T.,20,0,48,28
1656986229880,COGS 13,A01,083071,Bastos; Amalia Pinkusfeld,9,0,71,62
1656986235902,COGS 14A,A01,092681,Semenuks; Arturs,0,1,100,100
1656986241931,COGS 14B,A01,083073,Cheng; Tzu-Han,5,0,63,58
1656986247953,COGS 17,A01,092677,Semenuks; Arturs,4,0,81,77
1656986253979,COGS 100,A01,083619,Allen; Michael Gordon,15,0,70,55
1656986260002,COGS 101A,A01,083621,Davis; Joshua Daniel,9,0,68,59
1656986266024,COGS 101B,A01,091572,Allen; Michael Gordon,8,0,65,57
1656986272046,COGS 101C,A01,083625,Delgado; Tania,17,0,35,18
1656986278073,COGS 107A,A01,083627,Boyle; Mary E. T.,13,0,60,47
1656986284096,COGS 118A,A01,083075,Gupta; Anjum,15,0,76,61
1656986290124,CSE 3,A50,083646,Miranda; Gregory Joseph,22,0,50,28
1656986296148,CSE 8A,A50,083650,Miranda; Gregory Joseph,17,1,56,39
1656986302175,CSE 11,A01,083080,Cao; Yingjun,4,15,40,36
1656986308201,CSE 12,A01,083652,Krause-Levy; Sophia Louisa,20,1,120,100
1656986314224,CSE 15L,A01,083654,Morris; Justin Loren,8,0,50,42
1656986314224,CSE 15L,A02,083655,Morris; Justin Loren,8,0,50,42
1656986320245,CSE 20,A01,083657,Tran; Khoa Dang,37,0,80,43
1656986326270,CSE 21,A01,095574,Bach; Quang Tran,21,0,48,27
1656986332368,CSE 30,A01,083084,Eldon; John,4,0,80,76
1656986332368,CSE 30,B01,095061,Bhaskar; Nishant,6,0,50,44
1656986338392,CSE 100,A01,083659,Cao; Yingjun,3,4,70,67
1656986344416,CSE 134B,A01,083661,Powell; Thomas Allan,19,0,100,81
1656986350444,CSE 140,A01,083663,Gungor; Onat,14,0,85,71
1656986356467,CSE 140L,A01,083088,Eldon; John,16,0,100,84
1656986362490,CSE 175,A01,083665,Kumar; Rakesh,3,0,25,22
1656986368516,CSE 190,A00,092507,Dubnov; Shlomo,7,0,20,13
1656986374540,ECE 45,A01,083139,Congero; Spencer William,5,0,75,70
1656986380562,ECE 65,A50,083695,Saad; Andrew S,12,0,30,18
1656986380562,ECE 65,A51,095125,Saad; Andrew S,25,0,26,1
1656986386586,ECE 109,A01,091882,Touri; Behrouz,16,0,70,54
1656986392609,ECE 180,A00,083140,Abi Samra; Nicholas Camill,1,0,30,29
1656986392609,ECE 180,B00,083141,Abi Samra; Nicholas Camill,0,0,30,30
1656986398635,MATH 10A,A01,083735,Patchell; Gregory David,1,0,30,29
1656986398635,MATH 10A,A02,083736,Patchell; Gregory David,20,0,30,10
1656986398635,MATH 10A,A03,083737,Patchell; Gregory David,15,0,30,15
1656986404657,MATH 10B,A01,083207,Lim; Seonhee,7,0,34,27
1656986404657,MATH 10B,A02,083208,Lim; Seonhee,9,0,35,26
1656986404657,MATH 10B,A03,093472,Lim; Seonhee,4,0,34,30
1656986404657,MATH 10B,B01,083739,Sinha; Shubham,9,0,30,21
1656986410686,MATH 18,A01,083743,Cinel; Cameron Alexander,6,0,30,24
1656986410686,MATH 18,A02,083744,Cinel; Cameron Alexander,15,0,30,15
1656986410686,MATH 18,A03,083745,Cinel; Cameron Alexander,8,0,30,22
1656986410686,MATH 18,B01,083748,Rideout; David Porter,4,0,37,33
1656986410686,MATH 18,B02,083749,Rideout; David Porter,3,0,36,33
1656986410686,MATH 18,B03,083750,Rideout; David Porter,2,0,37,35
1656986410686,MATH 18,B04,083751,Rideout; David Porter,5,0,36,31
1656986410686,MATH 18,B05,093473,Rideout; David Porter,4,0,36,32
1656986410686,MATH 18,B06,093474,Rideout; David Porter,5,0,36,31
1656986416712,MATH 20A,A01,083754,Zheng; Zequn,12,0,40,28
1656986422738,MATH 20B,A01,083756,Briones; Jor-el Thomas Caparas,1,0,36,35
1656986422738,MATH 20B,A02,083757,Briones; Jor-el Thomas Caparas,1,0,36,35
1656986422738,MATH 20B,A03,093475,Briones; Jor-el Thomas Caparas,0,0,36,36
1656986428773,MATH 20C,A01,083760,Briones; Jor-el Thomas Caparas,1,0,35,34
1656986428773,MATH 20C,A02,083761,Briones; Jor-el Thomas Caparas,8,0,35,27
1656986428773,MATH 20C,A03,093476,Briones; Jor-el Thomas Caparas,0,1,36,36
1656986428773,MATH 20C,B01,083762,Bach; Quang Tran,0,0,30,30
1656986434800,MATH 20D,A01,083765,Tran; Brian Kha,4,0,30,26
1656986434800,MATH 20D,A02,083766,Tran; Brian Kha,4,0,30,26
1656986434800,MATH 20D,A03,083767,Tran; Brian Kha,3,0,30,27
1656986440822,MATH 20E,A01,083771,Ganguly; Soumya,5,0,32,27
1656986440822,MATH 20E,A02,083772,Ganguly; Soumya,6,0,32,26
1656986440822,MATH 20E,B01,083773,Ciotti; Benjamin,18,0,35,17
1656986440822,MATH 20E,B02,083774,Ciotti; Benjamin,17,0,35,18
1656986446845,MATH 103A,A01,083777,Greenfeld; Be'Eri,2,0,36,34
1656986446845,MATH 103A,A02,083778,Greenfeld; Be'Eri,5,0,36,31
1656986446845,MATH 103A,A03,093561,Greenfeld; Be'Eri,4,0,36,32
1656986446845,MATH 103A,B01,083779,Greenfeld; Be'Eri,6,0,36,30
1656986446845,MATH 103A,B02,083780,Greenfeld; Be'Eri,2,0,36,34
1656986446845,MATH 103A,B03,093562,Greenfeld; Be'Eri,2,0,36,34
1656986452873,MATH 105,A01,085443,Carter; Anne Toulson,14,0,35,21
1656986452873,MATH 105,A02,093477,Carter; Anne Toulson,20,0,35,15
1656986458904,MATH 109,A01,083213,Ganzberger; Geoffrey Michael,2,0,34,32
1656986458904,MATH 109,A02,083214,Ganzberger; Geoffrey Michael,2,0,34,32
1656986458904,MATH 109,A03,093478,Ganzberger; Geoffrey Michael,1,0,34,33
1656986458904,MATH 109,B01,083215,Ganzberger; Geoffrey Michael,1,0,32,31
1656986458904,MATH 109,B02,083216,Ganzberger; Geoffrey Michael,1,0,32,31
1656986458904,MATH 109,B03,093479,Ganzberger; Geoffrey Michael,6,0,32,26
1656986464926,MATH 142A,A01,083219,Chow; Bennett,6,0,32,26
1656986464926,MATH 142A,A02,083220,Chow; Bennett,10,0,32,22
1656986464926,MATH 142A,A03,093480,Chow; Bennett,7,0,32,25
1656986464926,MATH 142A,B03,093481,Chow; Bennett,7,0,32,25
1656986464926,MATH 142A,B04,093558,Chow; Bennett,11,0,32,21
1656986464926,MATH 142A,B05,093559,Chow; Bennett,6,0,32,26
1656986470952,MATH 193A,A01,083224,Rotar; Vladimir,7,0,34,27
1656986470952,MATH 193A,A02,083225,Rotar; Vladimir,4,0,34,30
1656986470952,MATH 193A,A03,083781,Rotar; Vladimir,1,0,34,33
1656986470952,MATH 193A,A04,083782,Rotar; Vladimir,6,0,34,28
1656986470952,MATH 193A,A05,093482,Rotar; Vladimir,6,0,34,28
1656986476976,MATH 197,001,091859,McAuley; Julian John,9999,0,9999,0
1656986476976,MATH 197,002,095566,Kedlaya; Kiran S.,9997,0,9999,2
1656986476976,MATH 197,003,095567,Xiao; Ming,9999,0,9999,0
1656986476976,MATH 197,004,095571,Perols; Johan Lars,9998,0,9999,1
1656986484050,COGS 9,A01,083615,Shannon; Kyle Michael,7,0,75,68
1656986490077,COGS 11,A01,083617,Boyle; Mary E. T.,20,0,48,28
1656986496110,COGS 13,A01,083071,Bastos; Amalia Pinkusfeld,9,0,71,62
1656986502134,COGS 14A,A01,092681,Semenuks; Arturs,0,1,100,100
1656986508156,COGS 14B,A01,083073,Cheng; Tzu-Han,5,0,63,58
1656986514180,COGS 17,A01,092677,Semenuks; Arturs,4,0,81,77
1656986520207,COGS 100,A01,083619,Allen; Michael Gordon,15,0,70,55
1656986526233,COGS 101A,A01,083621,Davis; Joshua Daniel,9,0,68,59
1656986532290,COGS 101B,A01,091572,Allen; Michael Gordon,8,0,65,57
1656986538312,COGS 101C,A01,083625,Delgado; Tania,17,0,35,18
1656986544338,COGS 107A,A01,083627,Boyle; Mary E. T.,13,0,60,47
1656986550364,COGS 118A,A01,083075,Gupta; Anjum,15,0,76,61
1656986556387,CSE 3,A50,083646,Miranda; Gregory Joseph,22,0,50,28
1656986562414,CSE 8A,A50,083650,Miranda; Gregory Joseph,17,1,56,39
1656986568440,CSE 11,A01,083080,Cao; Yingjun,4,15,40,36
1656986574463,CSE 12,A01,083652,Krause-Levy; Sophia Louisa,20,1,120,100
1656986580490,CSE 15L,A01,083654,Morris; Justin Loren,8,0,50,42
1656986580490,CSE 15L,A02,083655,Morris; Justin Loren,8,0,50,42
1656986586517,CSE 20,A01,083657,Tran; Khoa Dang,37,0,80,43
1656986592545,CSE 21,A01,095574,Bach; Quang Tran,21,0,48,27
1656986598566,CSE 30,A01,083084,Eldon; John,4,0,80,76
1656986598566,CSE 30,B01,095061,Bhaskar; Nishant,6,0,50,44
1656986604589,CSE 100,A01,083659,Cao; Yingjun,3,4,70,67
1656986610615,CSE 134B,A01,083661,Powell; Thomas Allan,19,0,100,81
1656986616642,CSE 140,A01,083663,Gungor; Onat,14,0,85,71
1656986622670,CSE 140L,A01,083088,Eldon; John,16,0,100,84
1656986628693,CSE 175,A01,083665,Kumar; Rakesh,3,0,25,22
1656986634719,CSE 190,A00,092507,Dubnov; Shlomo,7,0,20,13
1656986640746,ECE 45,A01,083139,Congero; Spencer William,5,0,75,70
1656986646770,ECE 65,A50,083695,Saad; Andrew S,12,0,30,18
1656986646770,ECE 65,A51,095125,Saad; Andrew S,25,0,26,1
1656986652798,ECE 109,A01,091882,Touri; Behrouz,16,0,70,54
1656986658822,ECE 180,A00,083140,Abi Samra; Nicholas Camill,1,0,30,29
1656986658822,ECE 180,B00,083141,Abi Samra; Nicholas Camill,0,0,30,30
1656986664850,MATH 10A,A01,083735,Patchell; Gregory David,1,0,30,29
1656986664850,MATH 10A,A02,083736,Patchell; Gregory David,20,0,30,10
1656986664850,MATH 10A,A03,083737,Patchell; Gregory David,15,0,30,15
1656986670872,MATH 10B,A01,083207,Lim; Seonhee,7,0,34,27
1656986670872,MATH 10B,A02,083208,Lim; Seonhee,9,0,35,26
1656986670872,MATH 10B,A03,093472,Lim; Seonhee,4,0,34,30
1656986670872,MATH 10B,B01,083739,Sinha; Shubham,9,0,30,21
1656986676901,MATH 18,A01,083743,Cinel; Cameron Alexander,6,0,30,24
1656986676901,MATH 18,A02,083744,Cinel; Cameron Alexander,15,0,30,15
1656986676901,MATH 18,A03,083745,Cinel; Cameron Alexander,8,0,30,22
1656986676901,MATH 18,B01,083748,Rideout; David Porter,4,0,37,33
1656986676901,MATH 18,B02,083749,Rideout; David Porter,3,0,36,33
1656986676901,MATH 18,B03,083750,Rideout; David Porter,2,0,37,35
1656986676901,MATH 18,B04,083751,Rideout; David Porter,5,0,36,31
1656986676901,MATH 18,B05,093473,Rideout; David Porter,4,0,36,32
1656986676901,MATH 18,B06,093474,Rideout; David Porter,5,0,36,31
1656986682925,MATH 20A,A01,083754,Zheng; Zequn,12,0,40,28
1656986688953,MATH 20B,A01,083756,Briones; Jor-el Thomas Caparas,1,0,36,35
1656986688953,MATH 20B,A02,083757,Briones; Jor-el Thomas Caparas,1,0,36,35
1656986688953,MATH 20B,A03,093475,Briones; Jor-el Thomas Caparas,0,0,36,36
1656986694981,MATH 20C,A01,083760,Briones; Jor-el Thomas Caparas,1,0,35,34
1656986694981,MATH 20C,A02,083761,Briones; Jor-el Thomas Caparas,8,0,35,27
1656986694981,MATH 20C,A03,093476,Briones; Jor-el Thomas Caparas,0,1,36,36
1656986694981,MATH 20C,B01,083762,Bach; Quang Tran,0,0,30,30
1656986701004,MATH 20D,A01,083765,Tran; Brian Kha,4,0,30,26
1656986701004,MATH 20D,A02,083766,Tran; Brian Kha,4,0,30,26
1656986701004,MATH 20D,A03,083767,Tran; Brian Kha,3,0,30,27
1656986707028,MATH 20E,A01,083771,Ganguly; Soumya,5,0,32,27
1656986707028,MATH 20E,A02,083772,Ganguly; Soumya,6,0,32,26
1656986707028,MATH 20E,B01,083773,Ciotti; Benjamin,18,0,35,17
1656986707028,MATH 20E,B02,083774,Ciotti; Benjamin,17,0,35,18
1656986713057,MATH 103A,A01,083777,Greenfeld; Be'Eri,2,0,36,34
1656986713057,MATH 103A,A02,083778,Greenfeld; Be'Eri,5,0,36,31
1656986713057,MATH 103A,A03,093561,Greenfeld; Be'Eri,4,0,36,32
1656986713057,MATH 103A,B01,083779,Greenfeld; Be'Eri,6,0,36,30
1656986713057,MATH 103A,B02,083780,Greenfeld; Be'Eri,2,0,36,34
1656986713057,MATH 103A,B03,093562,Greenfeld; Be'Eri,2,0,36,34
1656986719081,MATH 105,A01,085443,Carter; Anne Toulson,14,0,35,21
1656986719081,MATH 105,A02,093477,Carter; Anne Toulson,20,0,35,15
1656986725106,MATH 109,A01,083213,Ganzberger; Geoffrey Michael,2,0,34,32
1656986725106,MATH 109,A02,083214,Ganzberger; Geoffrey Michael,2,0,34,32
1656986725106,MATH 109,A03,093478,Ganzberger; Geoffrey Michael,1,0,34,33
1656986725106,MATH 109,B01,083215,Ganzberger; Geoffrey Michael,1,0,32,31
1656986725106,MATH 109,B02,083216,Ganzberger; Geoffrey Michael,1,0,32,31
1656986725106,MATH 109,B03,093479,Ganzberger; Geoffrey Michael,6,0,32,26
1656986731130,MATH 142A,A01,083219,Chow; Bennett,6,0,32,26
1656986731130,MATH 142A,A02,083220,Chow; Bennett,10,0,32,22
1656986731130,MATH 142A,A03,093480,Chow; Bennett,7,0,32,25
1656986731130,MATH 142A,B03,093481,Chow; Bennett,7,0,32,25
1656986731130,MATH 142A,B04,093558,Chow; Bennett,11,0,32,21
1656986731130,MATH 142A,B05,093559,Chow; Bennett,6,0,32,26
1656986737155,MATH 193A,A01,083224,Rotar; Vladimir,7,0,34,27
1656986737155,MATH 193A,A02,083225,Rotar; Vladimir,4,0,34,30
1656986737155,MATH 193A,A03,083781,Rotar; Vladimir,1,0,34,33
1656986737155,MATH 193A,A04,083782,Rotar; Vladimir,6,0,34,28
1656986737155,MATH 193A,A05,093482,Rotar; Vladimir,6,0,34,28
1656986743178,MATH 197,001,091859,McAuley; Julian John,9999,0,9999,0
1656986743178,MATH 197,002,095566,Kedlaya; Kiran S.,9997,0,9999,2
1656986743178,MATH 197,003,095567,Xiao; Ming,9999,0,9999,0
1656986743178,MATH 197,004,095571,Perols; Johan Lars,9998,0,9999,1
1656986750235,COGS 9,A01,083615,Shannon; Kyle Michael,7,0,75,68
1656986756257,COGS 11,A01,083617,Boyle; Mary E. T.,20,0,48,28
1656986762280,COGS 13,A01,083071,Bastos; Amalia Pinkusfeld,9,0,71,62
1656986768306,COGS 14A,A01,092681,Semenuks; Arturs,0,1,100,100
1656986774333,COGS 14B,A01,083073,Cheng; Tzu-Han,5,0,63,58
1656986780356,COGS 17,A01,092677,Semenuks; Arturs,4,0,81,77
1656986786379,COGS 100,A01,083619,Allen; Michael Gordon,15,0,70,55
1656986792404,COGS 101A,A01,083621,Davis; Joshua Daniel,9,0,68,59
1656986798427,COGS 101B,A01,091572,Allen; Michael Gordon,8,0,65,57
1656986804454,COGS 101C,A01,083625,Delgado; Tania,17,0,35,18
1656986810481,COGS 107A,A01,083627,Boyle; Mary E. T.,13,0,60,47
1656986816505,COGS 118A,A01,083075,Gupta; Anjum,15,0,76,61
1656986822532,CSE 3,A50,083646,Miranda; Gregory Joseph,22,0,50,28
1656986828562,CSE 8A,A50,083650,Miranda; Gregory Joseph,17,1,56,39
1656986834587,CSE 11,A01,083080,Cao; Yingjun,4,15,40,36
1656986840614,CSE 12,A01,083652,Krause-Levy; Sophia Louisa,20,1,120,100
1656986846636,CSE 15L,A01,083654,Morris; Justin Loren,8,0,50,42
1656986846636,CSE 15L,A02,083655,Morris; Justin Loren,8,0,50,42
1656986852666,CSE 20,A01,083657,Tran; Khoa Dang,37,0,80,43
1656986858690,CSE 21,A01,095574,Bach; Quang Tran,21,0,48,27
1656986864715,CSE 30,A01,083084,Eldon; John,4,0,80,76
1656986864715,CSE 30,B01,095061,Bhaskar; Nishant,6,0,50,44
1656986870738,CSE 100,A01,083659,Cao; Yingjun,3,4,70,67
1656986876762,CSE 134B,A01,083661,Powell; Thomas Allan,19,0,100,81
1656986882789,CSE 140,A01,083663,Gungor; Onat,14,0,85,71
1656986888816,CSE 140L,A01,083088,Eldon; John,16,0,100,84
1656986894842,CSE 175,A01,083665,Kumar; Rakesh,3,0,25,22
1656986900865,CSE 190,A00,092507,Dubnov; Shlomo,7,0,20,13
1656986906887,ECE 45,A01,083139,Congero; Spencer William,5,0,75,70
1656986912911,ECE 65,A50,083695,Saad; Andrew S,12,0,30,18
1656986912911,ECE 65,A51,095125,Saad; Andrew S,25,0,26,1
1656986918936,ECE 109,A01,091882,Touri; Behrouz,16,0,70,54
1656986924961,ECE 180,A00,083140,Abi Samra; Nicholas Camill,1,0,30,29
1656986924961,ECE 180,B00,083141,Abi Samra; Nicholas Camill,0,0,30,30
1656986931054,MATH 10A,A01,083735,Patchell; Gregory David,1,0,30,29
1656986931054,MATH 10A,A02,083736,Patchell; Gregory David,20,0,30,10
1656986931054,MATH 10A,A03,083737,Patchell; Gregory David,15,0,30,15
1656986937078,MATH 10B,A01,083207,Lim; Seonhee,7,0,34,27
1656986937078,MATH 10B,A02,083208,Lim; Seonhee,9,0,35,26
1656986937078,MATH 10B,A03,093472,Lim; Seonhee,4,0,34,30
1656986937078,MATH 10B,B01,083739,Sinha; Shubham,9,0,30,21
1656986943111,MATH 18,A01,083743,Cinel; Cameron Alexander,6,0,30,24
1656986943111,MATH 18,A02,083744,Cinel; Cameron Alexander,15,0,30,15
1656986943111,MATH 18,A03,083745,Cinel; Cameron Alexander,8,0,30,22
1656986943111,MATH 18,B01,083748,Rideout; David Porter,4,0,37,33
1656986943111,MATH 18,B02,083749,Rideout; David Porter,3,0,36,33
1656986943111,MATH 18,B03,083750,Rideout; David Porter,2,0,37,35
1656986943111,MATH 18,B04,083751,Rideout; David Porter,5,0,36,31
1656986943111,MATH 18,B05,093473,Rideout; David Porter,4,0,36,32
1656986943111,MATH 18,B06,093474,Rideout; David Porter,5,0,36,31
1656986949133,MATH 20A,A01,083754,Zheng; Zequn,12,0,40,28
1656986955157,MATH 20B,A01,083756,Briones; Jor-el Thomas Caparas,1,0,36,35
1656986955157,MATH 20B,A02,083757,Briones; Jor-el Thomas Caparas,1,0,36,35
1656986955157,MATH 20B,A03,093475,Briones; Jor-el Thomas Caparas,0,0,36,36
1656986961186,MATH 20C,A01,083760,Briones; Jor-el Thomas Caparas,1,0,35,34
1656986961186,MATH 20C,A02,083761,Briones; Jor-el Thomas Caparas,8,0,35,27
1656986961186,MATH 20C,A03,093476,Briones; Jor-el Thomas Caparas,0,1,36,36
1656986961186,MATH 20C,B01,083762,Bach; Quang Tran,0,0,30,30
1656986967214,MATH 20D,A01,083765,Tran; Brian Kha,4,0,30,26
1656986967214,MATH 20D,A02,083766,Tran; Brian Kha,4,0,30,26
1656986967214,MATH 20D,A03,083767,Tran; Brian Kha,3,0,30,27
1656986973243,MATH 20E,A01,083771,Ganguly; Soumya,5,0,32,27
1656986973243,MATH 20E,A02,083772,Ganguly; Soumya,6,0,32,26
1656986973243,MATH 20E,B01,083773,Ciotti; Benjamin,18,0,35,17
1656986973243,MATH 20E,B02,083774,Ciotti; Benjamin,17,0,35,18
1656986979272,MATH 103A,A01,083777,Greenfeld; Be'Eri,2,0,36,34
1656986979272,MATH 103A,A02,083778,Greenfeld; Be'Eri,5,0,36,31
1656986979272,MATH 103A,A03,093561,Greenfeld; Be'Eri,4,0,36,32
1656986979272,MATH 103A,B01,083779,Greenfeld; Be'Eri,6,0,36,30
1656986979272,MATH 103A,B02,083780,Greenfeld; Be'Eri,2,0,36,34
1656986979272,MATH 103A,B03,093562,Greenfeld; Be'Eri,2,0,36,34
1656986985300,MATH 105,A01,085443,Carter; Anne Toulson,14,0,35,21
1656986985300,MATH 105,A02,093477,Carter; Anne Toulson,20,0,35,15
1656986991326,MATH 109,A01,083213,Ganzberger; Geoffrey Michael,2,0,34,32
1656986991326,MATH 109,A02,083214,Ganzberger; Geoffrey Michael,2,0,34,32
1656986991326,MATH 109,A03,093478,Ganzberger; Geoffrey Michael,1,0,34,33
1656986991326,MATH 109,B01,083215,Ganzberger; Geoffrey Michael,1,0,32,31
1656986991326,MATH 109,B02,083216,Ganzberger; Geoffrey Michael,1,0,32,31
1656986991326,MATH 109,B03,093479,Ganzberger; Geoffrey Michael,6,0,32,26
1656986997349,MATH 142A,A01,083219,Chow; Bennett,6,0,32,26
1656986997349,MATH 142A,A02,083220,Chow; Bennett,10,0,32,22
1656986997349,MATH 142A,A03,093480,Chow; Bennett,7,0,32,25
1656986997349,MATH 142A,B03,093481,Chow; Bennett,7,0,32,25
1656986997349,MATH 142A,B04,093558,Chow; Bennett,11,0,32,21
1656986997349,MATH 142A,B05,093559,Chow; Bennett,6,0,32,26
1656987003374,MATH 193A,A01,083224,Rotar; Vladimir,7,0,34,27
1656987003374,MATH 193A,A02,083225,Rotar; Vladimir,4,0,34,30
1656987003374,MATH 193A,A03,083781,Rotar; Vladimir,1,0,34,33
1656987003374,MATH 193A,A04,083782,Rotar; Vladimir,6,0,34,28
1656987003374,MATH 193A,A05,093482,Rotar; Vladimir,6,0,34,28
1656987009399,MATH 197,001,091859,McAuley; Julian John,9999,0,9999,0
1656987009399,MATH 197,002,095566,Kedlaya; Kiran S.,9997,0,9999,2
1656987009399,MATH 197,003,095567,Xiao; Ming,9999,0,9999,0
1656987009399,MATH 197,004,095571,Perols; Johan Lars,9998,0,9999,1
1656987016467,COGS 9,A01,083615,Shannon; Kyle Michael,7,0,75,68
1656987022491,COGS 11,A01,083617,Boyle; Mary E. T.,20,0,48,28
1656987028517,COGS 13,A01,083071,Bastos; Amalia Pinkusfeld,9,0,71,62
1656987034542,COGS 14A,A01,092681,Semenuks; Arturs,0,1,100,100
1656987040568,COGS 14B,A01,083073,Cheng; Tzu-Han,5,0,63,58
1656987046593,COGS 17,A01,092677,Semenuks; Arturs,4,0,81,77
1656987052617,COGS 100,A01,083619,Allen; Michael Gordon,15,0,70,55
1656987058638,COGS 101A,A01,083621,Davis; Joshua Daniel,9,0,68,59
1656987064660,COGS 101B,A01,091572,Allen; Michael Gordon,8,0,65,57
1656987070684,COGS 101C,A01,083625,Delgado; Tania,17,0,35,18
1656987076715,COGS 107A,A01,083627,Boyle; Mary E. T.,13,0,60,47
1656987082738,COGS 118A,A01,083075,Gupta; Anjum,15,0,76,61
1656987088765,CSE 3,A50,083646,Miranda; Gregory Joseph,22,0,50,28
1656987094798,CSE 8A,A50,083650,Miranda; Gregory Joseph,17,1,56,39
1656987100824,CSE 11,A01,083080,Cao; Yingjun,4,15,40,36
1656987106847,CSE 12,A01,083652,Krause-Levy; Sophia Louisa,20,1,120,100
1656987112872,CSE 15L,A01,083654,Morris; Justin Loren,8,0,50,42
1656987112872,CSE 15L,A02,083655,Morris; Justin Loren,8,0,50,42
1656987118899,CSE 20,A01,083657,Tran; Khoa Dang,37,0,80,43
1656987124926,CSE 21,A01,095574,Bach; Quang Tran,21,0,48,27
1656987130954,CSE 30,A01,083084,Eldon; John,4,0,80,76
1656987130954,CSE 30,B01,095061,Bhaskar; Nishant,6,0,50,44
1656987136988,CSE 100,A01,083659,Cao; Yingjun,3,4,70,67
1656987143010,CSE 134B,A01,083661,Powell; Thomas Allan,19,0,100,81
1656987149045,CSE 140,A01,083663,Gungor; Onat,14,0,85,71
1656987155069,CSE 140L,A01,083088,Eldon; John,16,0,100,84
1656987161092,CSE 175,A01,083665,Kumar; Rakesh,3,0,25,22
1656987167116,CSE 190,A00,092507,Dubnov; Shlomo,7,0,20,13
1656987173140,ECE 45,A01,083139,Congero; Spencer William,5,0,75,70
1656987179161,ECE 65,A50,083695,Saad; Andrew S,12,0,30,18
1656987179161,ECE 65,A51,095125,Saad; Andrew S,25,0,26,1
1656987185185,ECE 109,A01,091882,Touri; Behrouz,16,0,70,54
1656987191212,ECE 180,A00,083140,Abi Samra; Nicholas Camill,1,0,30,29
1656987191212,ECE 180,B00,083141,Abi Samra; Nicholas Camill,0,0,30,30
1656987197236,MATH 10A,A01,083735,Patchell; Gregory David,1,0,30,29
1656987197236,MATH 10A,A02,083736,Patchell; Gregory David,20,0,30,10
1656987197236,MATH 10A,A03,083737,Patchell; Gregory David,15,0,30,15
1656987203264,MATH 10B,A01,083207,Lim; Seonhee,7,0,34,27
1656987203264,MATH 10B,A02,083208,Lim; Seonhee,9,0,35,26
1656987203264,MATH 10B,A03,093472,Lim; Seonhee,4,0,34,30
1656987203264,MATH 10B,B01,083739,Sinha; Shubham,9,0,30,21
1656987209287,MATH 18,A01,083743,Cinel; Cameron Alexander,6,0,30,24
1656987209287,MATH 18,A02,083744,Cinel; Cameron Alexander,15,0,30,15
1656987209287,MATH 18,A03,083745,Cinel; Cameron Alexander,8,0,30,22
1656987209287,MATH 18,B01,083748,Rideout; David Porter,4,0,37,33
1656987209287,MATH 18,B02,083749,Rideout; David Porter,3,0,36,33
1656987209287,MATH 18,B03,083750,Rideout; David Porter,2,0,37,35
1656987209287,MATH 18,B04,083751,Rideout; David Porter,5,0,36,31
1656987209287,MATH 18,B05,093473,Rideout; David Porter,4,0,36,32
1656987209287,MATH 18,B06,093474,Rideout; David Porter,5,0,36,31
1656987215318,MATH 20A,A01,083754,Zheng; Zequn,12,0,40,28
1656987221341,MATH 20B,A01,083756,Briones; Jor-el Thomas Caparas,1,0,36,35
1656987221341,MATH 20B,A02,083757,Briones; Jor-el Thomas Caparas,1,0,36,35
1656987221341,MATH 20B,A03,093475,Briones; Jor-el Thomas Caparas,0,0,36,36
1656987227364,MATH 20C,A01,083760,Briones; Jor-el Thomas Caparas,1,0,35,34
1656987227364,MATH 20C,A02,083761,Briones; Jor-el Thomas Caparas,8,0,35,27
1656987227364,MATH 20C,A03,093476,Briones; Jor-el Thomas Caparas,0,1,36,36
1656987227364,MATH 20C,B01,083762,Bach; Quang Tran,0,0,30,30
1656987233389,MATH 20D,A01,083765,Tran; Brian Kha,4,0,30,26
1656987233389,MATH 20D,A02,083766,Tran; Brian Kha,4,0,30,26
1656987233389,MATH 20D,A03,083767,Tran; Brian Kha,3,0,30,27
1656987239413,MATH 20E,A01,083771,Ganguly; Soumya,5,0,32,27
1656987239413,MATH 20E,A02,083772,Ganguly; Soumya,6,0,32,26
1656987239413,MATH 20E,B01,083773,Ciotti; Benjamin,18,0,35,17
1656987239413,MATH 20E,B02,083774,Ciotti; Benjamin,17,0,35,18
1656987245443,MATH 103A,A01,083777,Greenfeld; Be'Eri,2,0,36,34
1656987245443,MATH 103A,A02,083778,Greenfeld; Be'Eri,5,0,36,31
1656987245443,MATH 103A,A03,093561,Greenfeld; Be'Eri,4,0,36,32
1656987245443,MATH 103A,B01,083779,Greenfeld; Be'Eri,6,0,36,30
1656987245443,MATH 103A,B02,083780,Greenfeld; Be'Eri,2,0,36,34
1656987245443,MATH 103A,B03,093562,Greenfeld; Be'Eri,2,0,36,34
1656987251474,MATH 105,A01,085443,Carter; Anne Toulson,14,0,35,21
1656987251474,MATH 105,A02,093477,Carter; Anne Toulson,20,0,35,15
1656987257501,MATH 109,A01,083213,Ganzberger; Geoffrey Michael,2,0,34,32
1656987257501,MATH 109,A02,083214,Ganzberger; Geoffrey Michael,2,0,34,32
1656987257501,MATH 109,A03,093478,Ganzberger; Geoffrey Michael,1,0,34,33
1656987257501,MATH 109,B01,083215,Ganzberger; Geoffrey Michael,1,0,32,31
1656987257501,MATH 109,B02,083216,Ganzberger; Geoffrey Michael,1,0,32,31
1656987257501,MATH 109,B03,093479,Ganzberger; Geoffrey Michael,6,0,32,26
1656987263528,MATH 142A,A01,083219,Chow; Bennett,6,0,32,26
1656987263528,MATH 142A,A02,083220,Chow; Bennett,10,0,32,22
1656987263528,MATH 142A,A03,093480,Chow; Bennett,7,0,32,25
1656987263528,MATH 142A,B03,093481,Chow; Bennett,7,0,32,25
1656987263528,MATH 142A,B04,093558,Chow; Bennett,11,0,32,21
1656987263528,MATH 142A,B05,093559,Chow; Bennett,6,0,32,26
1656987269552,MATH 193A,A01,083224,Rotar; Vladimir,7,0,34,27
1656987269552,MATH 193A,A02,083225,Rotar; Vladimir,4,0,34,30
1656987269552,MATH 193A,A03,083781,Rotar; Vladimir,1,0,34,33
1656987269552,MATH 193A,A04,083782,Rotar; Vladimir,6,0,34,28
1656987269552,MATH 193A,A05,093482,Rotar; Vladimir,6,0,34,28
1656987275580,MATH 197,001,091859,McAuley; Julian John,9999,0,9999,0
1656987275580,MATH 197,002,095566,Kedlaya; Kiran S.,9997,0,9999,2
1656987275580,MATH 197,003,095567,Xiao; Ming,9999,0,9999,0
1656987275580,MATH 197,004,095571,Perols; Johan Lars,9998,0,9999,1
1656987282633,COGS 9,A01,083615,Shannon; Kyle Michael,7,0,75,68
1656987288656,COGS 11,A01,083617,Boyle; Mary E. T.,20,0,48,28
1656987294681,COGS 13,A01,083071,Bastos; Amalia Pinkusfeld,9,0,71,62
1656987300704,COGS 14A,A01,092681,Semenuks; Arturs,0,1,100,100
1656987306730,COGS 14B,A01,083073,Cheng; Tzu-Han,5,0,63,58
1656987312752,COGS 17,A01,092677,Semenuks; Arturs,4,0,81,77
1656987318775,COGS 100,A01,083619,Allen; Michael Gordon,15,0,70,55
1656987324804,COGS 101A,A01,083621,Davis; Joshua Daniel,9,0,68,59
1656987330826,COGS 101B,A01,091572,Allen; Michael Gordon,8,0,65,57
1656987336852,COGS 101C,A01,083625,Delgado; Tania,17,0,35,18
1656987342885,COGS 107A,A01,083627,Boyle; Mary E. T.,13,0,60,47
1656987348908,COGS 118A,A01,083075,Gupta; Anjum,15,0,76,61
1656987354932,CSE 3,A50,083646,Miranda; Gregory Joseph,22,0,50,28
1656987360963,CSE 8A,A50,083650,Miranda; Gregory Joseph,17,1,56,39
1656987366985,CSE 11,A01,083080,Cao; Yingjun,4,15,40,36
1656987373010,CSE 12,A01,083652,Krause-Levy; Sophia Louisa,20,1,120,100
1656987379041,CSE 15L,A01,083654,Morris; Justin Loren,8,0,50,42
1656987379041,CSE 15L,A02,083655,Morris; Justin Loren,8,0,50,42
1656987385082,CSE 20,A01,083657,Tran; Khoa Dang,37,0,80,43
1656987391105,CSE 21,A01,095574,Bach; Quang Tran,21,0,48,27
1656987397129,CSE 30,A01,083084,Eldon; John,4,0,80,76
1656987397129,CSE 30,B01,095061,Bhaskar; Nishant,6,0,50,44
1656987403152,CSE 100,A01,083659,Cao; Yingjun,3,4,70,67
1656987409180,CSE 134B,A01,083661,Powell; Thomas Allan,19,0,100,81
1656987415205,CSE 140,A01,083663,Gungor; Onat,14,0,85,71
1656987421231,CSE 140L,A01,083088,Eldon; John,16,0,100,84
1656987427255,CSE 175,A01,083665,Kumar; Rakesh,3,0,25,22
1656987433288,CSE 190,A00,092507,Dubnov; Shlomo,7,0,20,13
1656987439312,ECE 45,A01,083139,Congero; Spencer William,5,0,75,70
1656987445336,ECE 65,A50,083695,Saad; Andrew S,12,0,30,18
1656987445336,ECE 65,A51,095125,Saad; Andrew S,25,0,26,1
1656987451358,ECE 109,A01,091882,Touri; Behrouz,16,0,70,54
1656987457381,ECE 180,A00,083140,Abi Samra; Nicholas Camill,1,0,30,29
1656987457381,ECE 180,B00,083141,Abi Samra; Nicholas Camill,0,0,30,30
1656987463410,MATH 10A,A01,083735,Patchell; Gregory David,1,0,30,29
1656987463410,MATH 10A,A02,083736,Patchell; Gregory David,20,0,30,10
1656987463410,MATH 10A,A03,083737,Patchell; Gregory David,15,0,30,15
1656987469444,MATH 10B,A01,083207,Lim; Seonhee,7,0,34,27
1656987469444,MATH 10B,A02,083208,Lim; Seonhee,9,0,35,26
1656987469444,MATH 10B,A03,093472,Lim; Seonhee,4,0,34,30
1656987469444,MATH 10B,B01,083739,Sinha; Shubham,9,0,30,21
1656987475478,MATH 18,A01,083743,Cinel; Cameron Alexander,6,0,30,24
1656987475478,MATH 18,A02,083744,Cinel; Cameron Alexander,15,0,30,15
1656987475478,MATH 18,A03,083745,Cinel; Cameron Alexander,8,0,30,22
1656987475478,MATH 18,B01,083748,Rideout; David Porter,4,0,37,33
1656987475478,MATH 18,B02,083749,Rideout; David Porter,3,0,36,33
1656987475478,MATH 18,B03,083750,Rideout; David Porter,2,0,37,35
1656987475478,MATH 18,B04,083751,Rideout; David Porter,5,0,36,31
1656987475478,MATH 18,B05,093473,Rideout; David Porter,4,0,36,32
1656987475478,MATH 18,B06,093474,Rideout; David Porter,5,0,36,31
1656987481510,MATH 20A,A01,083754,Zheng; Zequn,12,0,40,28
1656987487541,MATH 20B,A01,083756,Briones; Jor-el Thomas Caparas,1,0,36,35
1656987487541,MATH 20B,A02,083757,Briones; Jor-el Thomas Caparas,1,0,36,35
1656987487541,MATH 20B,A03,093475,Briones; Jor-el Thomas Caparas,0,0,36,36
1656987493564,MATH 20C,A01,083760,Briones; Jor-el Thomas Caparas,1,0,35,34
1656987493564,MATH 20C,A02,083761,Briones; Jor-el Thomas Caparas,8,0,35,27
1656987493564,MATH 20C,A03,093476,Briones; Jor-el Thomas Caparas,0,1,36,36
1656987493564,MATH 20C,B01,083762,Bach; Quang Tran,0,0,30,30
1656987499614,MATH 20D,A01,083765,Tran; Brian Kha,4,0,30,26
1656987499614,MATH 20D,A02,083766,Tran; Brian Kha,4,0,30,26
1656987499614,MATH 20D,A03,083767,Tran; Brian Kha,3,0,30,27
1656987505639,MATH 20E,A01,083771,Ganguly; Soumya,5,0,32,27
1656987505639,MATH 20E,A02,083772,Ganguly; Soumya,6,0,32,26
1656987505639,MATH 20E,B01,083773,Ciotti; Benjamin,18,0,35,17
1656987505639,MATH 20E,B02,083774,Ciotti; Benjamin,17,0,35,18
1656987511664,MATH 103A,A01,083777,Greenfeld; Be'Eri,2,0,36,34
1656987511664,MATH 103A,A02,083778,Greenfeld; Be'Eri,5,0,36,31
1656987511664,MATH 103A,A03,093561,Greenfeld; Be'Eri,4,0,36,32
1656987511664,MATH 103A,B01,083779,Greenfeld; Be'Eri,6,0,36,30
1656987511664,MATH 103A,B02,083780,Greenfeld; Be'Eri,2,0,36,34
1656987511664,MATH 103A,B03,093562,Greenfeld; Be'Eri,2,0,36,34
1656987517687,MATH 105,A01,085443,Carter; Anne Toulson,14,0,35,21
1656987517687,MATH 105,A02,093477,Carter; Anne Toulson,20,0,35,15
1656987523717,MATH 109,A01,083213,Ganzberger; Geoffrey Michael,2,0,34,32
1656987523717,MATH 109,A02,083214,Ganzberger; Geoffrey Michael,2,0,34,32
1656987523717,MATH 109,A03,093478,Ganzberger; Geoffrey Michael,1,0,34,33
1656987523717,MATH 109,B01,083215,Ganzberger; Geoffrey Michael,1,0,32,31
1656987523717,MATH 109,B02,083216,Ganzberger; Geoffrey Michael,1,0,32,31
1656987523717,MATH 109,B03,093479,Ganzberger; Geoffrey Michael,6,0,32,26
1656987529834,MATH 142A,A01,083219,Chow; Bennett,6,0,32,26
1656987529834,MATH 142A,A02,083220,Chow; Bennett,10,0,32,22
1656987529834,MATH 142A,A03,093480,Chow; Bennett,7,0,32,25
1656987529834,MATH 142A,B03,093481,Chow; Bennett,7,0,32,25
1656987529834,MATH 142A,B04,093558,Chow; Bennett,11,0,32,21
1656987529834,MATH 142A,B05,093559,Chow; Bennett,6,0,32,26
1656987535857,MATH 193A,A01,083224,Rotar; Vladimir,7,0,34,27
1656987535857,MATH 193A,A02,083225,Rotar; Vladimir,4,0,34,30
1656987535857,MATH 193A,A03,083781,Rotar; Vladimir,1,0,34,33
1656987535857,MATH 193A,A04,083782,Rotar; Vladimir,6,0,34,28
1656987535857,MATH 193A,A05,093482,Rotar; Vladimir,6,0,34,28
1656987541885,MATH 197,001,091859,McAuley; Julian John,9999,0,9999,0
1656987541885,MATH 197,002,095566,Kedlaya; Kiran S.,9997,0,9999,2
1656987541885,MATH 197,003,095567,Xiao; Ming,9999,0,9999,0
1656987541885,MATH 197,004,095571,Perols; Johan Lars,9998,0,9999,1
1656987548963,COGS 9,A01,083615,Shannon; Kyle Michael,7,0,75,68
1656987554994,COGS 11,A01,083617,Boyle; Mary E. T.,20,0,48,28
1656987561015,COGS 13,A01,083071,Bastos; Amalia Pinkusfeld,9,0,71,62
1656987572346,COGS 14A,A01,092681,Semenuks; Arturs,0,1,100,100
1656987578374,COGS 14B,A01,083073,Cheng; Tzu-Han,5,0,63,58
1656987584395,COGS 17,A01,092677,Semenuks; Arturs,4,0,81,77
1656987590422,COGS 100,A01,083619,Allen; Michael Gordon,15,0,70,55
1656987596446,COGS 101A,A01,083621,Davis; Joshua Daniel,9,0,68,59
1656987602468,COGS 101B,A01,091572,Allen; Michael Gordon,8,0,65,57
1656987608490,COGS 101C,A01,083625,Delgado; Tania,17,0,35,18
1656987614516,COGS 107A,A01,083627,Boyle; Mary E. T.,13,0,60,47
1656987620541,COGS 118A,A01,083075,Gupta; Anjum,15,0,76,61
1656987626569,CSE 3,A50,083646,Miranda; Gregory Joseph,22,0,50,28
1656987632591,CSE 8A,A50,083650,Miranda; Gregory Joseph,17,1,56,39
1656987638615,CSE 11,A01,083080,Cao; Yingjun,4,15,40,36
1656987644642,CSE 12,A01,083652,Krause-Levy; Sophia Louisa,20,1,120,100
1656987650666,CSE 15L,A01,083654,Morris; Justin Loren,8,0,50,42
1656987650666,CSE 15L,A02,083655,Morris; Justin Loren,8,0,50,42
1656987656693,CSE 20,A01,083657,Tran; Khoa Dang,37,0,80,43
1656987662717,CSE 21,A01,095574,Bach; Quang Tran,21,0,48,27
1656987668742,CSE 30,A01,083084,Eldon; John,4,0,80,76
1656987668742,CSE 30,B01,095061,Bhaskar; Nishant,6,0,50,44
1656987674768,CSE 100,A01,083659,Cao; Yingjun,3,4,70,67
1656987680792,CSE 134B,A01,083661,Powell; Thomas Allan,19,0,100,81
1656987686817,CSE 140,A01,083663,Gungor; Onat,14,0,85,71
1656987692842,CSE 140L,A01,083088,Eldon; John,16,0,100,84
1656987698867,CSE 175,A01,083665,Kumar; Rakesh,3,0,25,22
1656987704892,CSE 190,A00,092507,Dubnov; Shlomo,7,0,20,13
1656987710918,ECE 45,A01,083139,Congero; Spencer William,5,0,75,70
1656987716950,ECE 65,A50,083695,Saad; Andrew S,12,0,30,18
1656987716950,ECE 65,A51,095125,Saad; Andrew S,25,0,26,1
1656987722977,ECE 109,A01,091882,Touri; Behrouz,16,0,70,54
1656987728998,ECE 180,A00,083140,Abi Samra; Nicholas Camill,1,0,30,29
1656987728998,ECE 180,B00,083141,Abi Samra; Nicholas Camill,0,0,30,30
1656987735029,MATH 10A,A01,083735,Patchell; Gregory David,1,0,30,29
1656987735029,MATH 10A,A02,083736,Patchell; Gregory David,20,0,30,10
1656987735029,MATH 10A,A03,083737,Patchell; Gregory David,15,0,30,15
1656987741058,MATH 10B,A01,083207,Lim; Seonhee,7,0,34,27
1656987741058,MATH 10B,A02,083208,Lim; Seonhee,9,0,35,26
1656987741058,MATH 10B,A03,093472,Lim; Seonhee,4,0,34,30
1656987741058,MATH 10B,B01,083739,Sinha; Shubham,9,0,30,21
1656987747083,MATH 18,A01,083743,Cinel; Cameron Alexander,6,0,30,24
1656987747083,MATH 18,A02,083744,Cinel; Cameron Alexander,15,0,30,15
1656987747083,MATH 18,A03,083745,Cinel; Cameron Alexander,8,0,30,22
1656987747083,MATH 18,B01,083748,Rideout; David Porter,4,0,37,33
1656987747083,MATH 18,B02,083749,Rideout; David Porter,3,0,36,33
1656987747083,MATH 18,B03,083750,Rideout; David Porter,2,0,37,35
1656987747083,MATH 18,B04,083751,Rideout; David Porter,5,0,36,31
1656987747083,MATH 18,B05,093473,Rideout; David Porter,4,0,36,32
1656987747083,MATH 18,B06,093474,Rideout; David Porter,5,0,36,31
1656987753107,MATH 20A,A01,083754,Zheng; Zequn,12,0,40,28
1656987759131,MATH 20B,A01,083756,Briones; Jor-el Thomas Caparas,1,0,36,35
1656987759131,MATH 20B,A02,083757,Briones; Jor-el Thomas Caparas,1,0,36,35
1656987759131,MATH 20B,A03,093475,Briones; Jor-el Thomas Caparas,0,0,36,36
1656987765156,MATH 20C,A01,083760,Briones; Jor-el Thomas Caparas,1,0,35,34
1656987765156,MATH 20C,A02,083761,Briones; Jor-el Thomas Caparas,8,0,35,27
1656987765156,MATH 20C,A03,093476,Briones; Jor-el Thomas Caparas,0,1,36,36
1656987765156,MATH 20C,B01,083762,Bach; Quang Tran,0,0,30,30
1656987771184,MATH 20D,A01,083765,Tran; Brian Kha,4,0,30,26
1656987771184,MATH 20D,A02,083766,Tran; Brian Kha,4,0,30,26
1656987771184,MATH 20D,A03,083767,Tran; Brian Kha,3,0,30,27
1656987777218,MATH 20E,A01,083771,Ganguly; Soumya,5,0,32,27
1656987777218,MATH 20E,A02,083772,Ganguly; Soumya,6,0,32,26
1656987777218,MATH 20E,B01,083773,Ciotti; Benjamin,18,0,35,17
1656987777218,MATH 20E,B02,083774,Ciotti; Benjamin,17,0,35,18
1656987783256,MATH 103A,A01,083777,Greenfeld; Be'Eri,2,0,36,34
1656987783256,MATH 103A,A02,083778,Greenfeld; Be'Eri,5,0,36,31
1656987783256,MATH 103A,A03,093561,Greenfeld; Be'Eri,4,0,36,32
1656987783256,MATH 103A,B01,083779,Greenfeld; Be'Eri,6,0,36,30
1656987783256,MATH 103A,B02,083780,Greenfeld; Be'Eri,2,0,36,34
1656987783256,MATH 103A,B03,093562,Greenfeld; Be'Eri,2,0,36,34
1656987789278,MATH 105,A01,085443,Carter; Anne Toulson,14,0,35,21
1656987789278,MATH 105,A02,093477,Carter; Anne Toulson,20,0,35,15
1656987795303,MATH 109,A01,083213,Ganzberger; Geoffrey Michael,2,0,34,32
1656987795303,MATH 109,A02,083214,Ganzberger; Geoffrey Michael,2,0,34,32
1656987795303,MATH 109,A03,093478,Ganzberger; Geoffrey Michael,1,0,34,33
1656987795303,MATH 109,B01,083215,Ganzberger; Geoffrey Michael,1,0,32,31
1656987795303,MATH 109,B02,083216,Ganzberger; Geoffrey Michael,1,0,32,31
1656987795303,MATH 109,B03,093479,Ganzberger; Geoffrey Michael,6,0,32,26
1656987801331,MATH 142A,A01,083219,Chow; Bennett,6,0,32,26
1656987801331,MATH 142A,A02,083220,Chow; Bennett,10,0,32,22
1656987801331,MATH 142A,A03,093480,Chow; Bennett,7,0,32,25
1656987801331,MATH 142A,B03,093481,Chow; Bennett,7,0,32,25
1656987801331,MATH 142A,B04,093558,Chow; Bennett,11,0,32,21
1656987801331,MATH 142A,B05,093559,Chow; Bennett,6,0,32,26
1656987807355,MATH 193A,A01,083224,Rotar; Vladimir,7,0,34,27
1656987807355,MATH 193A,A02,083225,Rotar; Vladimir,4,0,34,30
1656987807355,MATH 193A,A03,083781,Rotar; Vladimir,1,0,34,33
1656987807355,MATH 193A,A04,083782,Rotar; Vladimir,6,0,34,28
1656987807355,MATH 193A,A05,093482,Rotar; Vladimir,6,0,34,28
1656987813377,MATH 197,001,091859,McAuley; Julian John,9999,0,9999,0
1656987813377,MATH 197,002,095566,Kedlaya; Kiran S.,9997,0,9999,2
1656987813377,MATH 197,003,095567,Xiao; Ming,9999,0,9999,0
1656987813377,MATH 197,004,095571,Perols; Johan Lars,9998,0,9999,1
1656987820438,COGS 9,A01,083615,Shannon; Kyle Michael,7,0,75,68
1656987826462,COGS 11,A01,083617,Boyle; Mary E. T.,20,0,48,28
1656987832484,COGS 13,A01,083071,Bastos; Amalia Pinkusfeld,9,0,71,62
1656987838508,COGS 14A,A01,092681,Semenuks; Arturs,0,1,100,100
1656987844532,COGS 14B,A01,083073,Cheng; Tzu-Han,5,0,63,58
1656987850555,COGS 17,A01,092677,Semenuks; Arturs,4,0,81,77
1656987856582,COGS 100,A01,083619,Allen; Michael Gordon,15,0,70,55
1656987862608,COGS 101A,A01,083621,Davis; Joshua Daniel,9,0,68,59
1656987868636,COGS 101B,A01,091572,Allen; Michael Gordon,8,0,65,57
1656987874664,COGS 101C,A01,083625,Delgado; Tania,17,0,35,18
1656987880689,COGS 107A,A01,083627,Boyle; Mary E. T.,13,0,60,47
1656987886713,COGS 118A,A01,083075,Gupta; Anjum,15,0,76,61
1656987892738,CSE 3,A50,083646,Miranda; Gregory Joseph,22,0,50,28
1656987898780,CSE 8A,A50,083650,Miranda; Gregory Joseph,17,1,56,39
1656987904821,CSE 11,A01,083080,Cao; Yingjun,4,15,40,36
1656987910846,CSE 12,A01,083652,Krause-Levy; Sophia Louisa,20,1,120,100
1656987916877,CSE 15L,A01,083654,Morris; Justin Loren,8,0,50,42
1656987916877,CSE 15L,A02,083655,Morris; Justin Loren,8,0,50,42
1656987922900,CSE 20,A01,083657,Tran; Khoa Dang,37,0,80,43
1656987928927,CSE 21,A01,095574,Bach; Quang Tran,21,0,48,27
1656987934954,CSE 30,A01,083084,Eldon; John,4,0,80,76
1656987934954,CSE 30,B01,095061,Bhaskar; Nishant,6,0,50,44
1656987940977,CSE 100,A01,083659,Cao; Yingjun,3,4,70,67
1656987947001,CSE 134B,A01,083661,Powell; Thomas Allan,19,0,100,81
1656987953024,CSE 140,A01,083663,Gungor; Onat,14,0,85,71
1656987959048,CSE 140L,A01,083088,Eldon; John,16,0,100,84
1656987965069,CSE 175,A01,083665,Kumar; Rakesh,3,0,25,22
1656987971094,CSE 190,A00,092507,Dubnov; Shlomo,7,0,20,13
1656987977118,ECE 45,A01,083139,Congero; Spencer William,5,0,75,70
1656987983144,ECE 65,A50,083695,Saad; Andrew S,12,0,30,18
1656987983144,ECE 65,A51,095125,Saad; Andrew S,25,0,26,1
1656987989169,ECE 109,A01,091882,Touri; Behrouz,16,0,70,54
1656987995192,ECE 180,A00,083140,Abi Samra; Nicholas Camill,1,0,30,29
1656987995192,ECE 180,B00,083141,Abi Samra; Nicholas Camill,0,0,30,30
1656988001218,MATH 10A,A01,083735,Patchell; Gregory David,1,0,30,29
1656988001218,MATH 10A,A02,083736,Patchell; Gregory David,20,0,30,10
1656988001218,MATH 10A,A03,083737,Patchell; Gregory David,15,0,30,15
1656988007243,MATH 10B,A01,083207,Lim; Seonhee,7,0,34,27
1656988007243,MATH 10B,A02,083208,Lim; Seonhee,9,0,35,26
1656988007243,MATH 10B,A03,093472,Lim; Seonhee,4,0,34,30
1656988007243,MATH 10B,B01,083739,Sinha; Shubham,9,0,30,21
1656988013267,MATH 18,A01,083743,Cinel; Cameron Alexander,6,0,30,24
1656988013267,MATH 18,A02,083744,Cinel; Cameron Alexander,15,0,30,15
1656988013267,MATH 18,A03,083745,Cinel; Cameron Alexander,8,0,30,22
1656988013267,MATH 18,B01,083748,Rideout; David Porter,4,0,37,33
1656988013267,MATH 18,B02,083749,Rideout; David Porter,3,0,36,33
1656988013267,MATH 18,B03,083750,Rideout; David Porter,2,0,37,35
1656988013267,MATH 18,B04,083751,Rideout; David Porter,5,0,36,31
1656988013267,MATH 18,B05,093473,Rideout; David Porter,4,0,36,32
1656988013267,MATH 18,B06,093474,Rideout; David Porter,5,0,36,31
1656988019294,MATH 20A,A01,083754,Zheng; Zequn,12,0,40,28
1656988025324,MATH 20B,A01,083756,Briones; Jor-el Thomas Caparas,1,0,36,35
1656988025324,MATH 20B,A02,083757,Briones; Jor-el Thomas Caparas,1,0,36,35
1656988025324,MATH 20B,A03,093475,Briones; Jor-el Thomas Caparas,0,0,36,36
1656988031347,MATH 20C,A01,083760,Briones; Jor-el Thomas Caparas,1,0,35,34
1656988031347,MATH 20C,A02,083761,Briones; Jor-el Thomas Caparas,8,0,35,27
1656988031347,MATH 20C,A03,093476,Briones; Jor-el Thomas Caparas,0,1,36,36
1656988031347,MATH 20C,B01,083762,Bach; Quang Tran,0,0,30,30
1656988037374,MATH 20D,A01,083765,Tran; Brian Kha,4,0,30,26
1656988037374,MATH 20D,A02,083766,Tran; Brian Kha,5,0,30,25
1656988037374,MATH 20D,A03,083767,Tran; Brian Kha,3,0,30,27
1656988043399,MATH 20E,A01,083771,Ganguly; Soumya,5,0,32,27
1656988043399,MATH 20E,A02,083772,Ganguly; Soumya,6,0,32,26
1656988043399,MATH 20E,B01,083773,Ciotti; Benjamin,18,0,35,17
1656988043399,MATH 20E,B02,083774,Ciotti; Benjamin,17,0,35,18
1656988049423,MATH 103A,A01,083777,Greenfeld; Be'Eri,2,0,36,34
1656988049423,MATH 103A,A02,083778,Greenfeld; Be'Eri,5,0,36,31
1656988049423,MATH 103A,A03,093561,Greenfeld; Be'Eri,4,0,36,32
1656988049423,MATH 103A,B01,083779,Greenfeld; Be'Eri,6,0,36,30
1656988049423,MATH 103A,B02,083780,Greenfeld; Be'Eri,2,0,36,34
1656988049423,MATH 103A,B03,093562,Greenfeld; Be'Eri,2,0,36,34
1656988055445,MATH 105,A01,085443,Carter; Anne Toulson,14,0,35,21
1656988055445,MATH 105,A02,093477,Carter; Anne Toulson,20,0,35,15
1656988061486,MATH 109,A01,083213,Ganzberger; Geoffrey Michael,2,0,34,32
1656988061486,MATH 109,A02,083214,Ganzberger; Geoffrey Michael,2,0,34,32
1656988061486,MATH 109,A03,093478,Ganzberger; Geoffrey Michael,1,0,34,33
1656988061486,MATH 109,B01,083215,Ganzberger; Geoffrey Michael,1,0,32,31
1656988061486,MATH 109,B02,083216,Ganzberger; Geoffrey Michael,1,0,32,31
1656988061486,MATH 109,B03,093479,Ganzberger; Geoffrey Michael,6,0,32,26
1656988067518,MATH 142A,A01,083219,Chow; Bennett,6,0,32,26
1656988067518,MATH 142A,A02,083220,Chow; Bennett,10,0,32,22
1656988067518,MATH 142A,A03,093480,Chow; Bennett,7,0,32,25
1656988067518,MATH 142A,B03,093481,Chow; Bennett,7,0,32,25
1656988067518,MATH 142A,B04,093558,Chow; Bennett,11,0,32,21
1656988067518,MATH 142A,B05,093559,Chow; Bennett,6,0,32,26
1656988073542,MATH 193A,A01,083224,Rotar; Vladimir,7,0,34,27
1656988073542,MATH 193A,A02,083225,Rotar; Vladimir,4,0,34,30
1656988073542,MATH 193A,A03,083781,Rotar; Vladimir,1,0,34,33
1656988073542,MATH 193A,A04,083782,Rotar; Vladimir,6,0,34,28
1656988073542,MATH 193A,A05,093482,Rotar; Vladimir,6,0,34,28
1656988079566,MATH 197,001,091859,McAuley; Julian John,9999,0,9999,0
1656988079566,MATH 197,002,095566,Kedlaya; Kiran S.,9997,0,9999,2
1656988079566,MATH 197,003,095567,Xiao; Ming,9999,0,9999,0
1656988079566,MATH 197,004,095571,Perols; Johan Lars,9998,0,9999,1
1656988086641,COGS 9,A01,083615,Shannon; Kyle Michael,7,0,75,68
1656988092664,COGS 11,A01,083617,Boyle; Mary E. T.,20,0,48,28
1656988098687,COGS 13,A01,083071,Bastos; Amalia Pinkusfeld,9,0,71,62
1656988104716,COGS 14A,A01,092681,Semenuks; Arturs,0,1,100,100
1656988110740,COGS 14B,A01,083073,Cheng; Tzu-Han,5,0,63,58
1656988116764,COGS 17,A01,092677,Semenuks; Arturs,4,0,81,77
1656988122788,COGS 100,A01,083619,Allen; Michael Gordon,15,0,70,55
1656988128909,COGS 101A,A01,083621,Davis; Joshua Daniel,9,0,68,59
1656988134933,COGS 101B,A01,091572,Allen; Michael Gordon,8,0,65,57
1656988140956,COGS 101C,A01,083625,Delgado; Tania,17,0,35,18
1656988146978,COGS 107A,A01,083627,Boyle; Mary E. T.,13,0,60,47
1656988153000,COGS 118A,A01,083075,Gupta; Anjum,15,0,76,61
1656988159027,CSE 3,A50,083646,Miranda; Gregory Joseph,22,0,50,28
1656988165055,CSE 8A,A50,083650,Miranda; Gregory Joseph,17,1,56,39
1656988171081,CSE 11,A01,083080,Cao; Yingjun,4,15,40,36
1656988177110,CSE 12,A01,083652,Krause-Levy; Sophia Louisa,20,1,120,100
1656988183137,CSE 15L,A01,083654,Morris; Justin Loren,8,0,50,42
1656988183137,CSE 15L,A02,083655,Morris; Justin Loren,8,0,50,42
1656988189165,CSE 20,A01,083657,Tran; Khoa Dang,37,0,80,43
1656988195192,CSE 21,A01,095574,Bach; Quang Tran,21,0,48,27
1656988201214,CSE 30,A01,083084,Eldon; John,4,0,80,76
1656988201214,CSE 30,B01,095061,Bhaskar; Nishant,6,0,50,44
1656988207242,CSE 100,A01,083659,Cao; Yingjun,3,4,70,67
1656988213264,CSE 134B,A01,083661,Powell; Thomas Allan,19,0,100,81
1656988219290,CSE 140,A01,083663,Gungor; Onat,14,0,85,71
1656988225317,CSE 140L,A01,083088,Eldon; John,16,0,100,84
1656988231339,CSE 175,A01,083665,Kumar; Rakesh,3,0,25,22
1656988237366,CSE 190,A00,092507,Dubnov; Shlomo,7,0,20,13
1656988243392,ECE 45,A01,083139,Congero; Spencer William,5,0,75,70
1656988249416,ECE 65,A50,083695,Saad; Andrew S,12,0,30,18
1656988249416,ECE 65,A51,095125,Saad; Andrew S,25,0,26,1
1656988255439,ECE 109,A01,091882,Touri; Behrouz,16,0,70,54
1656988261466,ECE 180,A00,083140,Abi Samra; Nicholas Camill,1,0,30,29
1656988261466,ECE 180,B00,083141,Abi Samra; Nicholas Camill,0,0,30,30
1656988267490,MATH 10A,A01,083735,Patchell; Gregory David,1,0,30,29
1656988267490,MATH 10A,A02,083736,Patchell; Gregory David,20,0,30,10
1656988267490,MATH 10A,A03,083737,Patchell; Gregory David,15,0,30,15
1656988273517,MATH 10B,A01,083207,Lim; Seonhee,7,0,34,27
1656988273517,MATH 10B,A02,083208,Lim; Seonhee,9,0,35,26
1656988273517,MATH 10B,A03,093472,Lim; Seonhee,4,0,34,30
1656988273517,MATH 10B,B01,083739,Sinha; Shubham,9,0,30,21
1656988279548,MATH 18,A01,083743,Cinel; Cameron Alexander,6,0,30,24
1656988279548,MATH 18,A02,083744,Cinel; Cameron Alexander,15,0,30,15
1656988279548,MATH 18,A03,083745,Cinel; Cameron Alexander,8,0,30,22
1656988279548,MATH 18,B01,083748,Rideout; David Porter,4,0,37,33
1656988279548,MATH 18,B02,083749,Rideout; David Porter,3,0,36,33
1656988279548,MATH 18,B03,083750,Rideout; David Porter,2,0,37,35
1656988279548,MATH 18,B04,083751,Rideout; David Porter,5,0,36,31
1656988279548,MATH 18,B05,093473,Rideout; David Porter,4,0,36,32
1656988279548,MATH 18,B06,093474,Rideout; David Porter,5,0,36,31
1656988285572,MATH 20A,A01,083754,Zheng; Zequn,12,0,40,28
1656988291596,MATH 20B,A01,083756,Briones; Jor-el Thomas Caparas,1,0,36,35
1656988291596,MATH 20B,A02,083757,Briones; Jor-el Thomas Caparas,1,0,36,35
1656988291596,MATH 20B,A03,093475,Briones; Jor-el Thomas Caparas,0,0,36,36
1656988297624,MATH 20C,A01,083760,Briones; Jor-el Thomas Caparas,1,0,35,34
1656988297624,MATH 20C,A02,083761,Briones; Jor-el Thomas Caparas,8,0,35,27
1656988297624,MATH 20C,A03,093476,Briones; Jor-el Thomas Caparas,0,1,36,36
1656988297624,MATH 20C,B01,083762,Bach; Quang Tran,0,0,30,30
1656988303653,MATH 20D,A01,083765,Tran; Brian Kha,4,0,30,26
1656988303653,MATH 20D,A02,083766,Tran; Brian Kha,5,0,30,25
1656988303653,MATH 20D,A03,083767,Tran; Brian Kha,3,0,30,27
1656988309676,MATH 20E,A01,083771,Ganguly; Soumya,5,0,32,27
1656988309676,MATH 20E,A02,083772,Ganguly; Soumya,6,0,32,26
1656988309676,MATH 20E,B01,083773,Ciotti; Benjamin,18,0,35,17
1656988309676,MATH 20E,B02,083774,Ciotti; Benjamin,17,0,35,18
1656988315701,MATH 103A,A01,083777,Greenfeld; Be'Eri,2,0,36,34
1656988315701,MATH 103A,A02,083778,Greenfeld; Be'Eri,5,0,36,31
1656988315701,MATH 103A,A03,093561,Greenfeld; Be'Eri,4,0,36,32
1656988315701,MATH 103A,B01,083779,Greenfeld; Be'Eri,6,0,36,30
1656988315701,MATH 103A,B02,083780,Greenfeld; Be'Eri,2,0,36,34
1656988315701,MATH 103A,B03,093562,Greenfeld; Be'Eri,2,0,36,34
1656988321727,MATH 105,A01,085443,Carter; Anne Toulson,14,0,35,21
1656988321727,MATH 105,A02,093477,Carter; Anne Toulson,20,0,35,15
1656988327748,MATH 109,A01,083213,Ganzberger; Geoffrey Michael,2,0,34,32
1656988327748,MATH 109,A02,083214,Ganzberger; Geoffrey Michael,2,0,34,32
1656988327748,MATH 109,A03,093478,Ganzberger; Geoffrey Michael,1,0,34,33
1656988327748,MATH 109,B01,083215,Ganzberger; Geoffrey Michael,1,0,32,31
1656988327748,MATH 109,B02,083216,Ganzberger; Geoffrey Michael,1,0,32,31
1656988327748,MATH 109,B03,093479,Ganzberger; Geoffrey Michael,6,0,32,26
1656988333772,MATH 142A,A01,083219,Chow; Bennett,6,0,32,26
1656988333772,MATH 142A,A02,083220,Chow; Bennett,10,0,32,22
1656988333772,MATH 142A,A03,093480,Chow; Bennett,7,0,32,25
1656988333772,MATH 142A,B03,093481,Chow; Bennett,7,0,32,25
1656988333772,MATH 142A,B04,093558,Chow; Bennett,11,0,32,21
1656988333772,MATH 142A,B05,093559,Chow; Bennett,6,0,32,26
1656988339794,MATH 193A,A01,083224,Rotar; Vladimir,7,0,34,27
1656988339794,MATH 193A,A02,083225,Rotar; Vladimir,4,0,34,30
1656988339794,MATH 193A,A03,083781,Rotar; Vladimir,1,0,34,33
1656988339794,MATH 193A,A04,083782,Rotar; Vladimir,6,0,34,28
1656988339794,MATH 193A,A05,093482,Rotar; Vladimir,6,0,34,28
1656988345818,MATH 197,001,091859,McAuley; Julian John,9999,0,9999,0
1656988345818,MATH 197,002,095566,Kedlaya; Kiran S.,9997,0,9999,2
1656988345818,MATH 197,003,095567,Xiao; Ming,9999,0,9999,0
1656988345818,MATH 197,004,095571,Perols; Johan Lars,9998,0,9999,1
1656988352884,COGS 9,A01,083615,Shannon; Kyle Michael,7,0,75,68
1656988358907,COGS 11,A01,083617,Boyle; Mary E. T.,20,0,48,28
1656988364931,COGS 13,A01,083071,Bastos; Amalia Pinkusfeld,9,0,71,62
1656988370956,COGS 14A,A01,092681,Semenuks; Arturs,0,1,100,100
1656988376980,COGS 14B,A01,083073,Cheng; Tzu-Han,5,0,63,58
1656988383007,COGS 17,A01,092677,Semenuks; Arturs,4,0,81,77
1656988389034,COGS 100,A01,083619,Allen; Michael Gordon,15,0,70,55
1656988395057,COGS 101A,A01,083621,Davis; Joshua Daniel,9,0,68,59
1656988401088,COGS 101B,A01,091572,Allen; Michael Gordon,8,0,65,57
1656988407116,COGS 101C,A01,083625,Delgado; Tania,17,0,35,18
1656988413138,COGS 107A,A01,083627,Boyle; Mary E. T.,13,0,60,47
1656988419160,COGS 118A,A01,083075,Gupta; Anjum,15,0,76,61
1656988425182,CSE 3,A50,083646,Miranda; Gregory Joseph,22,0,50,28
1656988431206,CSE 8A,A50,083650,Miranda; Gregory Joseph,17,1,56,39
1656988437240,CSE 11,A01,083080,Cao; Yingjun,4,15,40,36
1656988443267,CSE 12,A01,083652,Krause-Levy; Sophia Louisa,20,1,120,100
1656988449294,CSE 15L,A01,083654,Morris; Justin Loren,8,0,50,42
1656988449294,CSE 15L,A02,083655,Morris; Justin Loren,8,0,50,42
1656988455321,CSE 20,A01,083657,Tran; Khoa Dang,37,0,80,43
1656988461349,CSE 21,A01,095574,Bach; Quang Tran,21,0,48,27
1656988467374,CSE 30,A01,083084,Eldon; John,4,0,80,76
1656988467374,CSE 30,B01,095061,Bhaskar; Nishant,6,0,50,44
1656988473400,CSE 100,A01,083659,Cao; Yingjun,3,4,70,67
1656988479428,CSE 134B,A01,083661,Powell; Thomas Allan,19,0,100,81
1656988485452,CSE 140,A01,083663,Gungor; Onat,14,0,85,71
1656988491474,CSE 140L,A01,083088,Eldon; John,16,0,100,84
1656988497501,CSE 175,A01,083665,Kumar; Rakesh,3,0,25,22
1656988503528,CSE 190,A00,092507,Dubnov; Shlomo,7,0,20,13
1656988509554,ECE 45,A01,083139,Congero; Spencer William,5,0,75,70
1656988515582,ECE 65,A50,083695,Saad; Andrew S,12,0,30,18
1656988515582,ECE 65,A51,095125,Saad; Andrew S,25,0,26,1
1656988521604,ECE 109,A01,091882,Touri; Behrouz,16,0,70,54
1656988527628,ECE 180,A00,083140,Abi Samra; Nicholas Camill,1,0,30,29
1656988527628,ECE 180,B00,083141,Abi Samra; Nicholas Camill,0,0,30,30
1656988533657,MATH 10A,A01,083735,Patchell; Gregory David,1,0,30,29
1656988533657,MATH 10A,A02,083736,Patchell; Gregory David,20,0,30,10
1656988533657,MATH 10A,A03,083737,Patchell; Gregory David,15,0,30,15
1656988539680,MATH 10B,A01,083207,Lim; Seonhee,7,0,34,27
1656988539680,MATH 10B,A02,083208,Lim; Seonhee,9,0,35,26
1656988539680,MATH 10B,A03,093472,Lim; Seonhee,4,0,34,30
1656988539680,MATH 10B,B01,083739,Sinha; Shubham,9,0,30,21
1656988545706,MATH 18,A01,083743,Cinel; Cameron Alexander,6,0,30,24
1656988545706,MATH 18,A02,083744,Cinel; Cameron Alexander,15,0,30,15
1656988545706,MATH 18,A03,083745,Cinel; Cameron Alexander,8,0,30,22
1656988545706,MATH 18,B01,083748,Rideout; David Porter,4,0,37,33
1656988545706,MATH 18,B02,083749,Rideout; David Porter,3,0,36,33
1656988545706,MATH 18,B03,083750,Rideout; David Porter,2,0,37,35
1656988545706,MATH 18,B04,083751,Rideout; David Porter,5,0,36,31
1656988545706,MATH 18,B05,093473,Rideout; David Porter,4,0,36,32
1656988545706,MATH 18,B06,093474,Rideout; David Porter,5,0,36,31
1656988551732,MATH 20A,A01,083754,Zheng; Zequn,12,0,40,28
1656988557756,MATH 20B,A01,083756,Briones; Jor-el Thomas Caparas,1,0,36,35
1656988557756,MATH 20B,A02,083757,Briones; Jor-el Thomas Caparas,1,0,36,35
1656988557756,MATH 20B,A03,093475,Briones; Jor-el Thomas Caparas,0,0,36,36
1656988563778,MATH 20C,A01,083760,Briones; Jor-el Thomas Caparas,1,0,35,34
1656988563778,MATH 20C,A02,083761,Briones; Jor-el Thomas Caparas,8,0,35,27
1656988563778,MATH 20C,A03,093476,Briones; Jor-el Thomas Caparas,0,1,36,36
1656988563778,MATH 20C,B01,083762,Bach; Quang Tran,0,0,30,30
1656988569807,MATH 20D,A01,083765,Tran; Brian Kha,4,0,30,26
1656988569807,MATH 20D,A02,083766,Tran; Brian Kha,5,0,30,25
1656988569807,MATH 20D,A03,083767,Tran; Brian Kha,3,0,30,27
1656988575832,MATH 20E,A01,083771,Ganguly; Soumya,5,0,32,27
1656988575832,MATH 20E,A02,083772,Ganguly; Soumya,6,0,32,26
1656988575832,MATH 20E,B01,083773,Ciotti; Benjamin,18,0,35,17
1656988575832,MATH 20E,B02,083774,Ciotti; Benjamin,17,0,35,18
1656988581862,MATH 103A,A01,083777,Greenfeld; Be'Eri,2,0,36,34
1656988581862,MATH 103A,A02,083778,Greenfeld; Be'Eri,5,0,36,31
1656988581862,MATH 103A,A03,093561,Greenfeld; Be'Eri,4,0,36,32
1656988581862,MATH 103A,B01,083779,Greenfeld; Be'Eri,6,0,36,30
1656988581862,MATH 103A,B02,083780,Greenfeld; Be'Eri,2,0,36,34
1656988581862,MATH 103A,B03,093562,Greenfeld; Be'Eri,2,0,36,34
1656988587888,MATH 105,A01,085443,Carter; Anne Toulson,14,0,35,21
1656988587888,MATH 105,A02,093477,Carter; Anne Toulson,20,0,35,15
1656988593918,MATH 109,A01,083213,Ganzberger; Geoffrey Michael,2,0,34,32
1656988593918,MATH 109,A02,083214,Ganzberger; Geoffrey Michael,2,0,34,32
1656988593918,MATH 109,A03,093478,Ganzberger; Geoffrey Michael,1,0,34,33
1656988593918,MATH 109,B01,083215,Ganzberger; Geoffrey Michael,1,0,32,31
1656988593918,MATH 109,B02,083216,Ganzberger; Geoffrey Michael,1,0,32,31
1656988593918,MATH 109,B03,093479,Ganzberger; Geoffrey Michael,6,0,32,26
1656988599948,MATH 142A,A01,083219,Chow; Bennett,6,0,32,26
1656988599948,MATH 142A,A02,083220,Chow; Bennett,10,0,32,22
1656988599948,MATH 142A,A03,093480,Chow; Bennett,7,0,32,25
1656988599948,MATH 142A,B03,093481,Chow; Bennett,7,0,32,25
1656988599948,MATH 142A,B04,093558,Chow; Bennett,11,0,32,21
1656988599948,MATH 142A,B05,093559,Chow; Bennett,6,0,32,26
1656988605970,MATH 193A,A01,083224,Rotar; Vladimir,7,0,34,27
1656988605970,MATH 193A,A02,083225,Rotar; Vladimir,4,0,34,30
1656988605970,MATH 193A,A03,083781,Rotar; Vladimir,1,0,34,33
1656988605970,MATH 193A,A04,083782,Rotar; Vladimir,6,0,34,28
1656988605970,MATH 193A,A05,093482,Rotar; Vladimir,6,0,34,28
1656988611995,MATH 197,001,091859,McAuley; Julian John,9999,0,9999,0
1656988611995,MATH 197,002,095566,Kedlaya; Kiran S.,9997,0,9999,2
1656988611995,MATH 197,003,095567,Xiao; Ming,9999,0,9999,0
1656988611995,MATH 197,004,095571,Perols; Johan Lars,9998,0,9999,1
1656988619052,COGS 9,A01,083615,Shannon; Kyle Michael,7,0,75,68
1656988625076,COGS 11,A01,083617,Boyle; Mary E. T.,20,0,48,28
1656988631103,COGS 13,A01,083071,Bastos; Amalia Pinkusfeld,9,0,71,62
1656988637132,COGS 14A,A01,092681,Semenuks; Arturs,0,1,100,100
1656988643160,COGS 14B,A01,083073,Cheng; Tzu-Han,5,0,63,58
1656988649187,COGS 17,A01,092677,Semenuks; Arturs,4,0,81,77
1656988655211,COGS 100,A01,083619,Allen; Michael Gordon,15,0,70,55
1656988661236,COGS 101A,A01,083621,Davis; Joshua Daniel,9,0,68,59
1656988667258,COGS 101B,A01,091572,Allen; Michael Gordon,8,0,65,57
1656988673284,COGS 101C,A01,083625,Delgado; Tania,17,0,35,18
1656988679307,COGS 107A,A01,083627,Boyle; Mary E. T.,13,0,60,47
1656988685333,COGS 118A,A01,083075,Gupta; Anjum,15,0,76,61
1656988691360,CSE 3,A50,083646,Miranda; Gregory Joseph,22,0,50,28
1656988697384,CSE 8A,A50,083650,Miranda; Gregory Joseph,17,1,56,39
1656988703410,CSE 11,A01,083080,Cao; Yingjun,4,15,40,36
1656988709434,CSE 12,A01,083652,Krause-Levy; Sophia Louisa,20,1,120,100
1656988715458,CSE 15L,A01,083654,Morris; Justin Loren,8,0,50,42
1656988715458,CSE 15L,A02,083655,Morris; Justin Loren,8,0,50,42
1656988721485,CSE 20,A01,083657,Tran; Khoa Dang,37,0,80,43
1656988727580,CSE 21,A01,095574,Bach; Quang Tran,21,0,48,27
1656988733608,CSE 30,A01,083084,Eldon; John,4,0,80,76
1656988733608,CSE 30,B01,095061,Bhaskar; Nishant,6,0,50,44
1656988739633,CSE 100,A01,083659,Cao; Yingjun,3,4,70,67
1656988745656,CSE 134B,A01,083661,Powell; Thomas Allan,19,0,100,81
1656988751680,CSE 140,A01,083663,Gungor; Onat,14,0,85,71
1656988757704,CSE 140L,A01,083088,Eldon; John,16,0,100,84
1656988763731,CSE 175,A01,083665,Kumar; Rakesh,3,0,25,22
1656988769752,CSE 190,A00,092507,Dubnov; Shlomo,7,0,20,13
1656988775778,ECE 45,A01,083139,Congero; Spencer William,5,0,75,70
1656988781805,ECE 65,A50,083695,Saad; Andrew S,12,0,30,18
1656988781805,ECE 65,A51,095125,Saad; Andrew S,25,0,26,1
1656988787829,ECE 109,A01,091882,Touri; Behrouz,16,0,70,54
1656988793854,ECE 180,A00,083140,Abi Samra; Nicholas Camill,1,0,30,29
1656988793854,ECE 180,B00,083141,Abi Samra; Nicholas Camill,0,0,30,30
1656988799877,MATH 10A,A01,083735,Patchell; Gregory David,1,0,30,29
1656988799877,MATH 10A,A02,083736,Patchell; Gregory David,20,0,30,10
1656988799877,MATH 10A,A03,083737,Patchell; Gregory David,15,0,30,15
1656988805900,MATH 10B,A01,083207,Lim; Seonhee,7,0,34,27
1656988805900,MATH 10B,A02,083208,Lim; Seonhee,9,0,35,26
1656988805900,MATH 10B,A03,093472,Lim; Seonhee,4,0,34,30
1656988805900,MATH 10B,B01,083739,Sinha; Shubham,9,0,30,21
1656988811928,MATH 18,A01,083743,Cinel; Cameron Alexander,6,0,30,24
1656988811928,MATH 18,A02,083744,Cinel; Cameron Alexander,15,0,30,15
1656988811928,MATH 18,A03,083745,Cinel; Cameron Alexander,8,0,30,22
1656988811928,MATH 18,B01,083748,Rideout; David Porter,4,0,37,33
1656988811928,MATH 18,B02,083749,Rideout; David Porter,3,0,36,33
1656988811928,MATH 18,B03,083750,Rideout; David Porter,2,0,37,35
1656988811928,MATH 18,B04,083751,Rideout; David Porter,5,0,36,31
1656988811928,MATH 18,B05,093473,Rideout; David Porter,4,0,36,32
1656988811928,MATH 18,B06,093474,Rideout; David Porter,5,0,36,31
1656988817953,MATH 20A,A01,083754,Zheng; Zequn,12,0,40,28
1656988823979,MATH 20B,A01,083756,Briones; Jor-el Thomas Caparas,1,0,36,35
1656988823979,MATH 20B,A02,083757,Briones; Jor-el Thomas Caparas,1,0,36,35
1656988823979,MATH 20B,A03,093475,Briones; Jor-el Thomas Caparas,0,0,36,36
1656988830003,MATH 20C,A01,083760,Briones; Jor-el Thomas Caparas,1,0,35,34
1656988830003,MATH 20C,A02,083761,Briones; Jor-el Thomas Caparas,8,0,35,27
1656988830003,MATH 20C,A03,093476,Briones; Jor-el Thomas Caparas,0,1,36,36
1656988830003,MATH 20C,B01,083762,Bach; Quang Tran,0,0,30,30
1656988836031,MATH 20D,A01,083765,Tran; Brian Kha,4,0,30,26
1656988836031,MATH 20D,A02,083766,Tran; Brian Kha,5,0,30,25
1656988836031,MATH 20D,A03,083767,Tran; Brian Kha,3,0,30,27
1656988842076,MATH 20E,A01,083771,Ganguly; Soumya,5,0,32,27
1656988842076,MATH 20E,A02,083772,Ganguly; Soumya,6,0,32,26
1656988842076,MATH 20E,B01,083773,Ciotti; Benjamin,18,0,35,17
1656988842076,MATH 20E,B02,083774,Ciotti; Benjamin,17,0,35,18
1656988848100,MATH 103A,A01,083777,Greenfeld; Be'Eri,2,0,36,34
1656988848100,MATH 103A,A02,083778,Greenfeld; Be'Eri,5,0,36,31
1656988848100,MATH 103A,A03,093561,Greenfeld; Be'Eri,4,0,36,32
1656988848100,MATH 103A,B01,083779,Greenfeld; Be'Eri,6,0,36,30
1656988848100,MATH 103A,B02,083780,Greenfeld; Be'Eri,2,0,36,34
1656988848100,MATH 103A,B03,093562,Greenfeld; Be'Eri,2,0,36,34
1656988854124,MATH 105,A01,085443,Carter; Anne Toulson,14,0,35,21
1656988854124,MATH 105,A02,093477,Carter; Anne Toulson,20,0,35,15
1656988860154,MATH 109,A01,083213,Ganzberger; Geoffrey Michael,2,0,34,32
1656988860154,MATH 109,A02,083214,Ganzberger; Geoffrey Michael,2,0,34,32
1656988860154,MATH 109,A03,093478,Ganzberger; Geoffrey Michael,1,0,34,33
1656988860154,MATH 109,B01,083215,Ganzberger; Geoffrey Michael,1,0,32,31
1656988860154,MATH 109,B02,083216,Ganzberger; Geoffrey Michael,1,0,32,31
1656988860154,MATH 109,B03,093479,Ganzberger; Geoffrey Michael,6,0,32,26
1656988866178,MATH 142A,A01,083219,Chow; Bennett,6,0,32,26
1656988866178,MATH 142A,A02,083220,Chow; Bennett,10,0,32,22
1656988866178,MATH 142A,A03,093480,Chow; Bennett,7,0,32,25
1656988866178,MATH 142A,B03,093481,Chow; Bennett,7,0,32,25
1656988866178,MATH 142A,B04,093558,Chow; Bennett,11,0,32,21
1656988866178,MATH 142A,B05,093559,Chow; Bennett,6,0,32,26
1656988872211,MATH 193A,A01,083224,Rotar; Vladimir,7,0,34,27
1656988872211,MATH 193A,A02,083225,Rotar; Vladimir,4,0,34,30
1656988872211,MATH 193A,A03,083781,Rotar; Vladimir,1,0,34,33
1656988872211,MATH 193A,A04,083782,Rotar; Vladimir,6,0,34,28
1656988872211,MATH 193A,A05,093482,Rotar; Vladimir,6,0,34,28
1656988878238,MATH 197,001,091859,McAuley; Julian John,9999,0,9999,0
1656988878238,MATH 197,002,095566,Kedlaya; Kiran S.,9997,0,9999,2
1656988878238,MATH 197,003,095567,Xiao; Ming,9999,0,9999,0
1656988878238,MATH 197,004,095571,Perols; Johan Lars,9998,0,9999,1
1656988885307,COGS 9,A01,083615,Shannon; Kyle Michael,7,0,75,68
1656988891329,COGS 11,A01,083617,Boyle; Mary E. T.,20,0,48,28
1656988897361,COGS 13,A01,083071,Bastos; Amalia Pinkusfeld,9,0,71,62
1656988903388,COGS 14A,A01,092681,Semenuks; Arturs,0,1,100,100
1656988909417,COGS 14B,A01,083073,Cheng; Tzu-Han,5,0,63,58
1656988915440,COGS 17,A01,092677,Semenuks; Arturs,4,0,81,77
1656988921467,COGS 100,A01,083619,Allen; Michael Gordon,15,0,70,55
1656988927490,COGS 101A,A01,083621,Davis; Joshua Daniel,9,0,68,59
1656988933514,COGS 101B,A01,091572,Allen; Michael Gordon,8,0,65,57
1656988939536,COGS 101C,A01,083625,Delgado; Tania,17,0,35,18
1656988945563,COGS 107A,A01,083627,Boyle; Mary E. T.,13,0,60,47
1656988951584,COGS 118A,A01,083075,Gupta; Anjum,15,0,76,61
1656988957626,CSE 3,A50,083646,Miranda; Gregory Joseph,22,0,50,28
1656988963653,CSE 8A,A50,083650,Miranda; Gregory Joseph,17,1,56,39
1656988969676,CSE 11,A01,083080,Cao; Yingjun,4,15,40,36
1656988975698,CSE 12,A01,083652,Krause-Levy; Sophia Louisa,20,1,120,100
1656988981722,CSE 15L,A01,083654,Morris; Justin Loren,8,0,50,42
1656988981722,CSE 15L,A02,083655,Morris; Justin Loren,8,0,50,42
1656988987747,CSE 20,A01,083657,Tran; Khoa Dang,37,0,80,43
1656988993770,CSE 21,A01,095574,Bach; Quang Tran,21,0,48,27
1656988999798,CSE 30,A01,083084,Eldon; John,4,0,80,76
1656988999798,CSE 30,B01,095061,Bhaskar; Nishant,6,0,50,44
1656989005820,CSE 100,A01,083659,Cao; Yingjun,3,4,70,67
1656989011844,CSE 134B,A01,083661,Powell; Thomas Allan,19,0,100,81
1656989017873,CSE 140,A01,083663,Gungor; Onat,14,0,85,71
1656989023896,CSE 140L,A01,083088,Eldon; John,16,0,100,84
1656989029918,CSE 175,A01,083665,Kumar; Rakesh,3,0,25,22
1656989035950,CSE 190,A00,092507,Dubnov; Shlomo,7,0,20,13
1656989042030,ECE 45,A01,083139,Congero; Spencer William,5,0,75,70
1656989048054,ECE 65,A50,083695,Saad; Andrew S,12,0,30,18
1656989048054,ECE 65,A51,095125,Saad; Andrew S,25,0,26,1
1656989054080,ECE 109,A01,091882,Touri; Behrouz,16,0,70,54
1656989060103,ECE 180,A00,083140,Abi Samra; Nicholas Camill,1,0,30,29
1656989060103,ECE 180,B00,083141,Abi Samra; Nicholas Camill,0,0,30,30
1656989066133,MATH 10A,A01,083735,Patchell; Gregory David,1,0,30,29
1656989066133,MATH 10A,A02,083736,Patchell; Gregory David,20,0,30,10
1656989066133,MATH 10A,A03,083737,Patchell; Gregory David,15,0,30,15
1656989072158,MATH 10B,A01,083207,Lim; Seonhee,7,0,34,27
1656989072158,MATH 10B,A02,083208,Lim; Seonhee,9,0,35,26
1656989072158,MATH 10B,A03,093472,Lim; Seonhee,4,0,34,30
1656989072158,MATH 10B,B01,083739,Sinha; Shubham,9,0,30,21
1656989078194,MATH 18,A01,083743,Cinel; Cameron Alexander,6,0,30,24
1656989078194,MATH 18,A02,083744,Cinel; Cameron Alexander,15,0,30,15
1656989078194,MATH 18,A03,083745,Cinel; Cameron Alexander,8,0,30,22
1656989078194,MATH 18,B01,083748,Rideout; David Porter,4,0,37,33
1656989078194,MATH 18,B02,083749,Rideout; David Porter,3,0,36,33
1656989078194,MATH 18,B03,083750,Rideout; David Porter,2,0,37,35
1656989078194,MATH 18,B04,083751,Rideout; David Porter,5,0,36,31
1656989078194,MATH 18,B05,093473,Rideout; David Porter,4,0,36,32
1656989078194,MATH 18,B06,093474,Rideout; David Porter,5,0,36,31
1656989084223,MATH 20A,A01,083754,Zheng; Zequn,12,0,40,28
1656989090246,MATH 20B,A01,083756,Briones; Jor-el Thomas Caparas,1,0,36,35
1656989090246,MATH 20B,A02,083757,Briones; Jor-el Thomas Caparas,1,0,36,35
1656989090246,MATH 20B,A03,093475,Briones; Jor-el Thomas Caparas,0,0,36,36
1656989096271,MATH 20C,A01,083760,Briones; Jor-el Thomas Caparas,1,0,35,34
1656989096271,MATH 20C,A02,083761,Briones; Jor-el Thomas Caparas,8,0,35,27
1656989096271,MATH 20C,A03,093476,Briones; Jor-el Thomas Caparas,0,1,36,36
1656989096271,MATH 20C,B01,083762,Bach; Quang Tran,0,0,30,30
1656989102306,MATH 20D,A01,083765,Tran; Brian Kha,4,0,30,26
1656989102306,MATH 20D,A02,083766,Tran; Brian Kha,5,0,30,25
1656989102306,MATH 20D,A03,083767,Tran; Brian Kha,3,0,30,27
1656989108349,MATH 20E,A01,083771,Ganguly; Soumya,5,0,32,27
1656989108349,MATH 20E,A02,083772,Ganguly; Soumya,6,0,32,26
1656989108349,MATH 20E,B01,083773,Ciotti; Benjamin,18,0,35,17
1656989108349,MATH 20E,B02,083774,Ciotti; Benjamin,17,0,35,18
1656989114377,MATH 103A,A01,083777,Greenfeld; Be'Eri,2,0,36,34
1656989114377,MATH 103A,A02,083778,Greenfeld; Be'Eri,5,0,36,31
1656989114377,MATH 103A,A03,093561,Greenfeld; Be'Eri,4,0,36,32
1656989114377,MATH 103A,B01,083779,Greenfeld; Be'Eri,6,0,36,30
1656989114377,MATH 103A,B02,083780,Greenfeld; Be'Eri,2,0,36,34
1656989114377,MATH 103A,B03,093562,Greenfeld; Be'Eri,2,0,36,34
1656989120403,MATH 105,A01,085443,Carter; Anne Toulson,14,0,35,21
1656989120403,MATH 105,A02,093477,Carter; Anne Toulson,20,0,35,15
1656989126426,MATH 109,A01,083213,Ganzberger; Geoffrey Michael,2,0,34,32
1656989126426,MATH 109,A02,083214,Ganzberger; Geoffrey Michael,2,0,34,32
1656989126426,MATH 109,A03,093478,Ganzberger; Geoffrey Michael,1,0,34,33
1656989126426,MATH 109,B01,083215,Ganzberger; Geoffrey Michael,1,0,32,31
1656989126426,MATH 109,B02,083216,Ganzberger; Geoffrey Michael,1,0,32,31
1656989126426,MATH 109,B03,093479,Ganzberger; Geoffrey Michael,6,0,32,26
1656989132451,MATH 142A,A01,083219,Chow; Bennett,6,0,32,26
1656989132451,MATH 142A,A02,083220,Chow; Bennett,10,0,32,22
1656989132451,MATH 142A,A03,093480,Chow; Bennett,7,0,32,25
1656989132451,MATH 142A,B03,093481,Chow; Bennett,7,0,32,25
1656989132451,MATH 142A,B04,093558,Chow; Bennett,11,0,32,21
1656989132451,MATH 142A,B05,093559,Chow; Bennett,6,0,32,26
1656989138478,MATH 193A,A01,083224,Rotar; Vladimir,7,0,34,27
1656989138478,MATH 193A,A02,083225,Rotar; Vladimir,4,0,34,30
1656989138478,MATH 193A,A03,083781,Rotar; Vladimir,1,0,34,33
1656989138478,MATH 193A,A04,083782,Rotar; Vladimir,6,0,34,28
1656989138478,MATH 193A,A05,093482,Rotar; Vladimir,6,0,34,28
1656989144501,MATH 197,001,091859,McAuley; Julian John,9999,0,9999,0
1656989144501,MATH 197,002,095566,Kedlaya; Kiran S.,9997,0,9999,2
1656989144501,MATH 197,003,095567,Xiao; Ming,9999,0,9999,0
1656989144501,MATH 197,004,095571,Perols; Johan Lars,9998,0,9999,1
1656989151567,COGS 9,A01,083615,Shannon; Kyle Michael,7,0,75,68
1656989157598,COGS 11,A01,083617,Boyle; Mary E. T.,20,0,48,28
1656989163629,COGS 13,A01,083071,Bastos; Amalia Pinkusfeld,9,0,71,62
1656989169656,COGS 14A,A01,092681,Semenuks; Arturs,0,1,100,100
1656989175682,COGS 14B,A01,083073,Cheng; Tzu-Han,5,0,63,58
1656989181706,COGS 17,A01,092677,Semenuks; Arturs,4,0,81,77
1656989187731,COGS 100,A01,083619,Allen; Michael Gordon,15,0,70,55
1656989193759,COGS 101A,A01,083621,Davis; Joshua Daniel,9,0,68,59
1656989199782,COGS 101B,A01,091572,Allen; Michael Gordon,8,0,65,57
1656989205808,COGS 101C,A01,083625,Delgado; Tania,17,0,35,18
1656989211835,COGS 107A,A01,083627,Boyle; Mary E. T.,13,0,60,47
1656989217859,COGS 118A,A01,083075,Gupta; Anjum,15,0,76,61
1656989223883,CSE 3,A50,083646,Miranda; Gregory Joseph,22,0,50,28
1656989229911,CSE 8A,A50,083650,Miranda; Gregory Joseph,17,1,56,39
1656989235935,CSE 11,A01,083080,Cao; Yingjun,4,15,40,36
1656989241963,CSE 12,A01,083652,Krause-Levy; Sophia Louisa,20,1,120,100
1656989247987,CSE 15L,A01,083654,Morris; Justin Loren,8,0,50,42
1656989247987,CSE 15L,A02,083655,Morris; Justin Loren,8,0,50,42
1656989254012,CSE 20,A01,083657,Tran; Khoa Dang,37,0,80,43
1656989260039,CSE 21,A01,095574,Bach; Quang Tran,21,0,48,27
1656989266063,CSE 30,A01,083084,Eldon; John,4,0,80,76
1656989266063,CSE 30,B01,095061,Bhaskar; Nishant,6,0,50,44
1656989272087,CSE 100,A01,083659,Cao; Yingjun,3,4,70,67
1656989278111,CSE 134B,A01,083661,Powell; Thomas Allan,19,0,100,81
1656989284134,CSE 140,A01,083663,Gungor; Onat,14,0,85,71
1656989290158,CSE 140L,A01,083088,Eldon; John,16,0,100,84
1656989296193,CSE 175,A01,083665,Kumar; Rakesh,3,0,25,22
1656989302217,CSE 190,A00,092507,Dubnov; Shlomo,7,0,20,13
1656989308242,ECE 45,A01,083139,Congero; Spencer William,5,0,75,70
1656989314266,ECE 65,A50,083695,Saad; Andrew S,12,0,30,18
1656989314266,ECE 65,A51,095125,Saad; Andrew S,25,0,26,1
1656989320293,ECE 109,A01,091882,Touri; Behrouz,16,0,70,54
1656989326386,ECE 180,A00,083140,Abi Samra; Nicholas Camill,1,0,30,29
1656989326386,ECE 180,B00,083141,Abi Samra; Nicholas Camill,0,0,30,30
1656989332408,MATH 10A,A01,083735,Patchell; Gregory David,1,0,30,29
1656989332408,MATH 10A,A02,083736,Patchell; Gregory David,20,0,30,10
1656989332408,MATH 10A,A03,083737,Patchell; Gregory David,15,0,30,15
1656989338445,MATH 10B,A01,083207,Lim; Seonhee,7,0,34,27
1656989338445,MATH 10B,A02,083208,Lim; Seonhee,9,0,35,26
1656989338445,MATH 10B,A03,093472,Lim; Seonhee,4,0,34,30
1656989338445,MATH 10B,B01,083739,Sinha; Shubham,9,0,30,21
1656989344476,MATH 18,A01,083743,Cinel; Cameron Alexander,6,0,30,24
1656989344476,MATH 18,A02,083744,Cinel; Cameron Alexander,15,0,30,15
1656989344476,MATH 18,A03,083745,Cinel; Cameron Alexander,8,0,30,22
1656989344476,MATH 18,B01,083748,Rideout; David Porter,4,0,37,33
1656989344476,MATH 18,B02,083749,Rideout; David Porter,3,0,36,33
1656989344476,MATH 18,B03,083750,Rideout; David Porter,2,0,37,35
1656989344476,MATH 18,B04,083751,Rideout; David Porter,5,0,36,31
1656989344476,MATH 18,B05,093473,Rideout; David Porter,4,0,36,32
1656989344476,MATH 18,B06,093474,Rideout; David Porter,5,0,36,31
1656989350500,MATH 20A,A01,083754,Zheng; Zequn,12,0,40,28
1656989356524,MATH 20B,A01,083756,Briones; Jor-el Thomas Caparas,1,0,36,35
1656989356524,MATH 20B,A02,083757,Briones; Jor-el Thomas Caparas,1,0,36,35
1656989356524,MATH 20B,A03,093475,Briones; Jor-el Thomas Caparas,0,0,36,36
1656989362569,MATH 20C,A01,083760,Briones; Jor-el Thomas Caparas,1,0,35,34
1656989362569,MATH 20C,A02,083761,Briones; Jor-el Thomas Caparas,8,0,35,27
1656989362569,MATH 20C,A03,093476,Briones; Jor-el Thomas Caparas,0,1,36,36
1656989362569,MATH 20C,B01,083762,Bach; Quang Tran,0,0,30,30
1656989368606,MATH 20D,A01,083765,Tran; Brian Kha,4,0,30,26
1656989368606,MATH 20D,A02,083766,Tran; Brian Kha,5,0,30,25
1656989368606,MATH 20D,A03,083767,Tran; Brian Kha,3,0,30,27
1656989374629,MATH 20E,A01,083771,Ganguly; Soumya,5,0,32,27
1656989374629,MATH 20E,A02,083772,Ganguly; Soumya,6,0,32,26
1656989374629,MATH 20E,B01,083773,Ciotti; Benjamin,18,0,35,17
1656989374629,MATH 20E,B02,083774,Ciotti; Benjamin,17,0,35,18
1656989380651,MATH 103A,A01,083777,Greenfeld; Be'Eri,2,0,36,34
1656989380651,MATH 103A,A02,083778,Greenfeld; Be'Eri,5,0,36,31
1656989380651,MATH 103A,A03,093561,Greenfeld; Be'Eri,4,0,36,32
1656989380651,MATH 103A,B01,083779,Greenfeld; Be'Eri,6,0,36,30
1656989380651,MATH 103A,B02,083780,Greenfeld; Be'Eri,2,0,36,34
1656989380651,MATH 103A,B03,093562,Greenfeld; Be'Eri,2,0,36,34
1656989386676,MATH 105,A01,085443,Carter; Anne Toulson,14,0,35,21
1656989386676,MATH 105,A02,093477,Carter; Anne Toulson,20,0,35,15
1656989392706,MATH 109,A01,083213,Ganzberger; Geoffrey Michael,2,0,34,32
1656989392706,MATH 109,A02,083214,Ganzberger; Geoffrey Michael,2,0,34,32
1656989392706,MATH 109,A03,093478,Ganzberger; Geoffrey Michael,1,0,34,33
1656989392706,MATH 109,B01,083215,Ganzberger; Geoffrey Michael,1,0,32,31
1656989392706,MATH 109,B02,083216,Ganzberger; Geoffrey Michael,1,0,32,31
1656989392706,MATH 109,B03,093479,Ganzberger; Geoffrey Michael,6,0,32,26
1656989398734,MATH 142A,A01,083219,Chow; Bennett,6,0,32,26
1656989398734,MATH 142A,A02,083220,Chow; Bennett,10,0,32,22
1656989398734,MATH 142A,A03,093480,Chow; Bennett,7,0,32,25
1656989398734,MATH 142A,B03,093481,Chow; Bennett,7,0,32,25
1656989398734,MATH 142A,B04,093558,Chow; Bennett,11,0,32,21
1656989398734,MATH 142A,B05,093559,Chow; Bennett,6,0,32,26
1656989404758,MATH 193A,A01,083224,Rotar; Vladimir,7,0,34,27
1656989404758,MATH 193A,A02,083225,Rotar; Vladimir,4,0,34,30
1656989404758,MATH 193A,A03,083781,Rotar; Vladimir,1,0,34,33
1656989404758,MATH 193A,A04,083782,Rotar; Vladimir,6,0,34,28
1656989404758,MATH 193A,A05,093482,Rotar; Vladimir,6,0,34,28
1656989410784,MATH 197,001,091859,McAuley; Julian John,9999,0,9999,0
1656989410784,MATH 197,002,095566,Kedlaya; Kiran S.,9997,0,9999,2
1656989410784,MATH 197,003,095567,Xiao; Ming,9999,0,9999,0
1656989410784,MATH 197,004,095571,Perols; Johan Lars,9998,0,9999,1
1656989417838,COGS 9,A01,083615,Shannon; Kyle Michael,7,0,75,68
1656989423864,COGS 11,A01,083617,Boyle; Mary E. T.,20,0,48,28
1656989429888,COGS 13,A01,083071,Bastos; Amalia Pinkusfeld,9,0,71,62
1656989435912,COGS 14A,A01,092681,Semenuks; Arturs,0,1,100,100
1656989441944,COGS 14B,A01,083073,Cheng; Tzu-Han,5,0,63,58
1656989447967,COGS 17,A01,092677,Semenuks; Arturs,4,0,81,77
1656989453992,COGS 100,A01,083619,Allen; Michael Gordon,15,0,70,55
1656989460015,COGS 101A,A01,083621,Davis; Joshua Daniel,9,0,68,59
1656989466038,COGS 101B,A01,091572,Allen; Michael Gordon,8,0,65,57
1656989472063,COGS 101C,A01,083625,Delgado; Tania,17,0,35,18
1656989478085,COGS 107A,A01,083627,Boyle; Mary E. T.,13,0,60,47
1656989484111,COGS 118A,A01,083075,Gupta; Anjum,15,0,76,61
1656989490135,CSE 3,A50,083646,Miranda; Gregory Joseph,22,0,50,28
1656989496159,CSE 8A,A50,083650,Miranda; Gregory Joseph,17,1,56,39
1656989502186,CSE 11,A01,083080,Cao; Yingjun,4,15,40,36
1656989508214,CSE 12,A01,083652,Krause-Levy; Sophia Louisa,20,1,120,100
1656989514238,CSE 15L,A01,083654,Morris; Justin Loren,8,0,50,42
1656989514238,CSE 15L,A02,083655,Morris; Justin Loren,8,0,50,42
1656989520264,CSE 20,A01,083657,Tran; Khoa Dang,37,0,80,43
1656989526288,CSE 21,A01,095574,Bach; Quang Tran,21,0,48,27
1656989532313,CSE 30,A01,083084,Eldon; John,4,0,80,76
1656989532313,CSE 30,B01,095061,Bhaskar; Nishant,6,0,50,44
1656989538336,CSE 100,A01,083659,Cao; Yingjun,3,4,70,67
1656989544359,CSE 134B,A01,083661,Powell; Thomas Allan,19,0,100,81
1656989550380,CSE 140,A01,083663,Gungor; Onat,14,0,85,71
1656989556413,CSE 140L,A01,083088,Eldon; John,16,0,100,84
1656989562442,CSE 175,A01,083665,Kumar; Rakesh,3,0,25,22
1656989568468,CSE 190,A00,092507,Dubnov; Shlomo,7,0,20,13
1656989574491,ECE 45,A01,083139,Congero; Spencer William,5,0,75,70
1656989580518,ECE 65,A50,083695,Saad; Andrew S,12,0,30,18
1656989580518,ECE 65,A51,095125,Saad; Andrew S,25,0,26,1
1656989586541,ECE 109,A01,091882,Touri; Behrouz,16,0,70,54
1656989592568,ECE 180,A00,083140,Abi Samra; Nicholas Camill,1,0,30,29
1656989592568,ECE 180,B00,083141,Abi Samra; Nicholas Camill,0,0,30,30
1656989598592,MATH 10A,A01,083735,Patchell; Gregory David,1,0,30,29
1656989598592,MATH 10A,A02,083736,Patchell; Gregory David,20,0,30,10
1656989598592,MATH 10A,A03,083737,Patchell; Gregory David,15,0,30,15
1656989604621,MATH 10B,A01,083207,Lim; Seonhee,7,0,34,27
1656989604621,MATH 10B,A02,083208,Lim; Seonhee,9,0,35,26
1656989604621,MATH 10B,A03,093472,Lim; Seonhee,4,0,34,30
1656989604621,MATH 10B,B01,083739,Sinha; Shubham,9,0,30,21
1656989610653,MATH 18,A01,083743,Cinel; Cameron Alexander,6,0,30,24
1656989610653,MATH 18,A02,083744,Cinel; Cameron Alexander,15,0,30,15
1656989610653,MATH 18,A03,083745,Cinel; Cameron Alexander,8,0,30,22
1656989610653,MATH 18,B01,083748,Rideout; David Porter,4,0,37,33
1656989610653,MATH 18,B02,083749,Rideout; David Porter,3,0,36,33
1656989610653,MATH 18,B03,083750,Rideout; David Porter,2,0,37,35
1656989610653,MATH 18,B04,083751,Rideout; David Porter,5,0,36,31
1656989610653,MATH 18,B05,093473,Rideout; David Porter,4,0,36,32
1656989610653,MATH 18,B06,093474,Rideout; David Porter,5,0,36,31
1656989616679,MATH 20A,A01,083754,Zheng; Zequn,12,0,40,28
1656989622706,MATH 20B,A01,083756,Briones; Jor-el Thomas Caparas,1,0,36,35
1656989622706,MATH 20B,A02,083757,Briones; Jor-el Thomas Caparas,1,0,36,35
1656989622706,MATH 20B,A03,093475,Briones; Jor-el Thomas Caparas,0,0,36,36
1656989628734,MATH 20C,A01,083760,Briones; Jor-el Thomas Caparas,1,0,35,34
1656989628734,MATH 20C,A02,083761,Briones; Jor-el Thomas Caparas,8,0,35,27
1656989628734,MATH 20C,A03,093476,Briones; Jor-el Thomas Caparas,0,1,36,36
1656989628734,MATH 20C,B01,083762,Bach; Quang Tran,0,0,30,30
1656989634762,MATH 20D,A01,083765,Tran; Brian Kha,4,0,30,26
1656989634762,MATH 20D,A02,083766,Tran; Brian Kha,5,0,30,25
1656989634762,MATH 20D,A03,083767,Tran; Brian Kha,3,0,30,27
1656989640789,MATH 20E,A01,083771,Ganguly; Soumya,5,0,32,27
1656989640789,MATH 20E,A02,083772,Ganguly; Soumya,6,0,32,26
1656989640789,MATH 20E,B01,083773,Ciotti; Benjamin,18,0,35,17
1656989640789,MATH 20E,B02,083774,Ciotti; Benjamin,17,0,35,18
1656989646813,MATH 103A,A01,083777,Greenfeld; Be'Eri,2,0,36,34
1656989646813,MATH 103A,A02,083778,Greenfeld; Be'Eri,5,0,36,31
1656989646813,MATH 103A,A03,093561,Greenfeld; Be'Eri,4,0,36,32
1656989646813,MATH 103A,B01,083779,Greenfeld; Be'Eri,6,0,36,30
1656989646813,MATH 103A,B02,083780,Greenfeld; Be'Eri,2,0,36,34
1656989646813,MATH 103A,B03,093562,Greenfeld; Be'Eri,2,0,36,34
1656989652836,MATH 105,A01,085443,Carter; Anne Toulson,14,0,35,21
1656989652836,MATH 105,A02,093477,Carter; Anne Toulson,20,0,35,15
1656989658864,MATH 109,A01,083213,Ganzberger; Geoffrey Michael,2,0,34,32
1656989658864,MATH 109,A02,083214,Ganzberger; Geoffrey Michael,2,0,34,32
1656989658864,MATH 109,A03,093478,Ganzberger; Geoffrey Michael,1,0,34,33
1656989658864,MATH 109,B01,083215,Ganzberger; Geoffrey Michael,1,0,32,31
1656989658864,MATH 109,B02,083216,Ganzberger; Geoffrey Michael,1,0,32,31
1656989658864,MATH 109,B03,093479,Ganzberger; Geoffrey Michael,6,0,32,26
1656989664895,MATH 142A,A01,083219,Chow; Bennett,6,0,32,26
1656989664895,MATH 142A,A02,083220,Chow; Bennett,10,0,32,22
1656989664895,MATH 142A,A03,093480,Chow; Bennett,7,0,32,25
1656989664895,MATH 142A,B03,093481,Chow; Bennett,7,0,32,25
1656989664895,MATH 142A,B04,093558,Chow; Bennett,11,0,32,21
1656989664895,MATH 142A,B05,093559,Chow; Bennett,6,0,32,26
1656989670922,MATH 193A,A01,083224,Rotar; Vladimir,7,0,34,27
1656989670922,MATH 193A,A02,083225,Rotar; Vladimir,4,0,34,30
1656989670922,MATH 193A,A03,083781,Rotar; Vladimir,1,0,34,33
1656989670922,MATH 193A,A04,083782,Rotar; Vladimir,6,0,34,28
1656989670922,MATH 193A,A05,093482,Rotar; Vladimir,6,0,34,28
1656989676952,MATH 197,001,091859,McAuley; Julian John,9999,0,9999,0
1656989676952,MATH 197,002,095566,Kedlaya; Kiran S.,9997,0,9999,2
1656989676952,MATH 197,003,095567,Xiao; Ming,9999,0,9999,0
1656989676952,MATH 197,004,095571,Perols; Johan Lars,9998,0,9999,1
1656989684003,COGS 9,A01,083615,Shannon; Kyle Michael,7,0,75,68
1656989690025,COGS 11,A01,083617,Boyle; Mary E. T.,20,0,48,28
1656989696049,COGS 13,A01,083071,Bastos; Amalia Pinkusfeld,9,0,71,62
1656989702077,COGS 14A,A01,092681,Semenuks; Arturs,0,1,100,100
1656989708100,COGS 14B,A01,083073,Cheng; Tzu-Han,5,0,63,58
1656989714126,COGS 17,A01,092677,Semenuks; Arturs,4,0,81,77
1656989720150,COGS 100,A01,083619,Allen; Michael Gordon,15,0,70,55
1656989726174,COGS 101A,A01,083621,Davis; Joshua Daniel,9,0,68,59
1656989732197,COGS 101B,A01,091572,Allen; Michael Gordon,8,0,65,57
1656989738222,COGS 101C,A01,083625,Delgado; Tania,17,0,35,18
1656989744245,COGS 107A,A01,083627,Boyle; Mary E. T.,13,0,60,47
1656989750268,COGS 118A,A01,083075,Gupta; Anjum,15,0,76,61
1656989756297,CSE 3,A50,083646,Miranda; Gregory Joseph,22,0,50,28
1656989762325,CSE 8A,A50,083650,Miranda; Gregory Joseph,17,1,56,39
1656989768348,CSE 11,A01,083080,Cao; Yingjun,4,15,40,36
1656989774373,CSE 12,A01,083652,Krause-Levy; Sophia Louisa,20,1,120,100
1656989780395,CSE 15L,A01,083654,Morris; Justin Loren,8,0,50,42
1656989780395,CSE 15L,A02,083655,Morris; Justin Loren,8,0,50,42
1656989786420,CSE 20,A01,083657,Tran; Khoa Dang,37,0,80,43
1656989792444,CSE 21,A01,095574,Bach; Quang Tran,21,0,48,27
1656989798468,CSE 30,A01,083084,Eldon; John,4,0,80,76
1656989798468,CSE 30,B01,095061,Bhaskar; Nishant,6,0,50,44
1656989804492,CSE 100,A01,083659,Cao; Yingjun,3,4,70,67
1656989810515,CSE 134B,A01,083661,Powell; Thomas Allan,19,0,100,81
1656989816537,CSE 140,A01,083663,Gungor; Onat,14,0,85,71
1656989822560,CSE 140L,A01,083088,Eldon; John,16,0,100,84
1656989828587,CSE 175,A01,083665,Kumar; Rakesh,3,0,25,22
1656989834611,CSE 190,A00,092507,Dubnov; Shlomo,7,0,20,13
1656989840643,ECE 45,A01,083139,Congero; Spencer William,5,0,75,70
1656989846666,ECE 65,A50,083695,Saad; Andrew S,12,0,30,18
1656989846666,ECE 65,A51,095125,Saad; Andrew S,25,0,26,1
1656989852693,ECE 109,A01,091882,Touri; Behrouz,16,0,70,54
1656989858718,ECE 180,A00,083140,Abi Samra; Nicholas Camill,1,0,30,29
1656989858718,ECE 180,B00,083141,Abi Samra; Nicholas Camill,0,0,30,30
1656989864742,MATH 10A,A01,083735,Patchell; Gregory David,1,0,30,29
1656989864742,MATH 10A,A02,083736,Patchell; Gregory David,20,0,30,10
1656989864742,MATH 10A,A03,083737,Patchell; Gregory David,15,0,30,15
1656989870767,MATH 10B,A01,083207,Lim; Seonhee,7,0,34,27
1656989870767,MATH 10B,A02,083208,Lim; Seonhee,9,0,35,26
1656989870767,MATH 10B,A03,093472,Lim; Seonhee,4,0,34,30
1656989870767,MATH 10B,B01,083739,Sinha; Shubham,9,0,30,21
1656989876793,MATH 18,A01,083743,Cinel; Cameron Alexander,6,0,30,24
1656989876793,MATH 18,A02,083744,Cinel; Cameron Alexander,15,0,30,15
1656989876793,MATH 18,A03,083745,Cinel; Cameron Alexander,8,0,30,22
1656989876793,MATH 18,B01,083748,Rideout; David Porter,4,0,37,33
1656989876793,MATH 18,B02,083749,Rideout; David Porter,3,0,36,33
1656989876793,MATH 18,B03,083750,Rideout; David Porter,2,0,37,35
1656989876793,MATH 18,B04,083751,Rideout; David Porter,5,0,36,31
1656989876793,MATH 18,B05,093473,Rideout; David Porter,4,0,36,32
1656989876793,MATH 18,B06,093474,Rideout; David Porter,5,0,36,31
1656989882819,MATH 20A,A01,083754,Zheng; Zequn,12,0,40,28
1656989888841,MATH 20B,A01,083756,Briones; Jor-el Thomas Caparas,1,0,36,35
1656989888841,MATH 20B,A02,083757,Briones; Jor-el Thomas Caparas,1,0,36,35
1656989888841,MATH 20B,A03,093475,Briones; Jor-el Thomas Caparas,0,0,36,36
1656989894871,MATH 20C,A01,083760,Briones; Jor-el Thomas Caparas,1,0,35,34
1656989894871,MATH 20C,A02,083761,Briones; Jor-el Thomas Caparas,8,0,35,27
1656989894871,MATH 20C,A03,093476,Briones; Jor-el Thomas Caparas,0,1,36,36
1656989894871,MATH 20C,B01,083762,Bach; Quang Tran,0,0,30,30
1656989900894,MATH 20D,A01,083765,Tran; Brian Kha,4,0,30,26
1656989900894,MATH 20D,A02,083766,Tran; Brian Kha,5,0,30,25
1656989900894,MATH 20D,A03,083767,Tran; Brian Kha,3,0,30,27
1656989906919,MATH 20E,A01,083771,Ganguly; Soumya,5,0,32,27
1656989906919,MATH 20E,A02,083772,Ganguly; Soumya,6,0,32,26
1656989906919,MATH 20E,B01,083773,Ciotti; Benjamin,18,0,35,17
1656989906919,MATH 20E,B02,083774,Ciotti; Benjamin,17,0,35,18
1656989912946,MATH 103A,A01,083777,Greenfeld; Be'Eri,2,0,36,34
1656989912946,MATH 103A,A02,083778,Greenfeld; Be'Eri,5,0,36,31
1656989912946,MATH 103A,A03,093561,Greenfeld; Be'Eri,4,0,36,32
1656989912946,MATH 103A,B01,083779,Greenfeld; Be'Eri,6,0,36,30
1656989912946,MATH 103A,B02,083780,Greenfeld; Be'Eri,2,0,36,34
1656989912946,MATH 103A,B03,093562,Greenfeld; Be'Eri,2,0,36,34
1656989918969,MATH 105,A01,085443,Carter; Anne Toulson,14,0,35,21
1656989918969,MATH 105,A02,093477,Carter; Anne Toulson,20,0,35,15
1656989925069,MATH 109,A01,083213,Ganzberger; Geoffrey Michael,2,0,34,32
1656989925069,MATH 109,A02,083214,Ganzberger; Geoffrey Michael,2,0,34,32
1656989925069,MATH 109,A03,093478,Ganzberger; Geoffrey Michael,1,0,34,33
1656989925069,MATH 109,B01,083215,Ganzberger; Geoffrey Michael,1,0,32,31
1656989925069,MATH 109,B02,083216,Ganzberger; Geoffrey Michael,1,0,32,31
1656989925069,MATH 109,B03,093479,Ganzberger; Geoffrey Michael,6,0,32,26
1656989931092,MATH 142A,A01,083219,Chow; Bennett,6,0,32,26
1656989931092,MATH 142A,A02,083220,Chow; Bennett,10,0,32,22
1656989931092,MATH 142A,A03,093480,Chow; Bennett,7,0,32,25
1656989931092,MATH 142A,B03,093481,Chow; Bennett,7,0,32,25
1656989931092,MATH 142A,B04,093558,Chow; Bennett,11,0,32,21
1656989931092,MATH 142A,B05,093559,Chow; Bennett,6,0,32,26
1656989937121,MATH 193A,A01,083224,Rotar; Vladimir,7,0,34,27
1656989937121,MATH 193A,A02,083225,Rotar; Vladimir,4,0,34,30
1656989937121,MATH 193A,A03,083781,Rotar; Vladimir,1,0,34,33
1656989937121,MATH 193A,A04,083782,Rotar; Vladimir,6,0,34,28
1656989937121,MATH 193A,A05,093482,Rotar; Vladimir,6,0,34,28
1656989943145,MATH 197,001,091859,McAuley; Julian John,9999,0,9999,0
1656989943145,MATH 197,002,095566,Kedlaya; Kiran S.,9997,0,9999,2
1656989943145,MATH 197,003,095567,Xiao; Ming,9999,0,9999,0
1656989943145,MATH 197,004,095571,Perols; Johan Lars,9998,0,9999,1
1656989950208,COGS 9,A01,083615,Shannon; Kyle Michael,7,0,75,68
1656989956231,COGS 11,A01,083617,Boyle; Mary E. T.,20,0,48,28
1656989962254,COGS 13,A01,083071,Bastos; Amalia Pinkusfeld,9,0,71,62
1656989968278,COGS 14A,A01,092681,Semenuks; Arturs,0,1,100,100
1656989974302,COGS 14B,A01,083073,Cheng; Tzu-Han,5,0,63,58
1656989980323,COGS 17,A01,092677,Semenuks; Arturs,4,0,81,77
1656989986353,COGS 100,A01,083619,Allen; Michael Gordon,15,0,70,55
1656989992376,COGS 101A,A01,083621,Davis; Joshua Daniel,9,0,68,59
1656989998398,COGS 101B,A01,091572,Allen; Michael Gordon,8,0,65,57
1656990004422,COGS 101C,A01,083625,Delgado; Tania,17,0,35,18
1656990010453,COGS 107A,A01,083627,Boyle; Mary E. T.,13,0,60,47
1656990016476,COGS 118A,A01,083075,Gupta; Anjum,15,0,76,61
1656990022501,CSE 3,A50,083646,Miranda; Gregory Joseph,22,0,50,28
1656990028528,CSE 8A,A50,083650,Miranda; Gregory Joseph,17,1,56,39
1656990034559,CSE 11,A01,083080,Cao; Yingjun,4,15,40,36
1656990040592,CSE 12,A01,083652,Krause-Levy; Sophia Louisa,20,1,120,100
1656990046616,CSE 15L,A01,083654,Morris; Justin Loren,8,0,50,42
1656990046616,CSE 15L,A02,083655,Morris; Justin Loren,8,0,50,42
1656990052643,CSE 20,A01,083657,Tran; Khoa Dang,37,0,80,43
1656990058670,CSE 21,A01,095574,Bach; Quang Tran,21,0,48,27
1656990064703,CSE 30,A01,083084,Eldon; John,4,0,80,76
1656990064703,CSE 30,B01,095061,Bhaskar; Nishant,6,0,50,44
1656990070726,CSE 100,A01,083659,Cao; Yingjun,3,4,70,67
1656990076749,CSE 134B,A01,083661,Powell; Thomas Allan,19,0,100,81
1656990082771,CSE 140,A01,083663,Gungor; Onat,14,0,85,71
1656990088795,CSE 140L,A01,083088,Eldon; John,16,0,100,84
1656990094822,CSE 175,A01,083665,Kumar; Rakesh,3,0,25,22
1656990100850,CSE 190,A00,092507,Dubnov; Shlomo,7,0,20,13
1656990106876,ECE 45,A01,083139,Congero; Spencer William,5,0,75,70
1656990112898,ECE 65,A50,083695,Saad; Andrew S,12,0,30,18
1656990112898,ECE 65,A51,095125,Saad; Andrew S,25,0,26,1
1656990118923,ECE 109,A01,091882,Touri; Behrouz,16,0,70,54
1656990124950,ECE 180,A00,083140,Abi Samra; Nicholas Camill,1,0,30,29
1656990124950,ECE 180,B00,083141,Abi Samra; Nicholas Camill,0,0,30,30
1656990130978,MATH 10A,A01,083735,Patchell; Gregory David,1,0,30,29
1656990130978,MATH 10A,A02,083736,Patchell; Gregory David,20,0,30,10
1656990130978,MATH 10A,A03,083737,Patchell; Gregory David,15,0,30,15
1656990137003,MATH 10B,A01,083207,Lim; Seonhee,7,0,34,27
1656990137003,MATH 10B,A02,083208,Lim; Seonhee,9,0,35,26
1656990137003,MATH 10B,A03,093472,Lim; Seonhee,4,0,34,30
1656990137003,MATH 10B,B01,083739,Sinha; Shubham,9,0,30,21
1656990143035,MATH 18,A01,083743,Cinel; Cameron Alexander,6,0,30,24
1656990143035,MATH 18,A02,083744,Cinel; Cameron Alexander,15,0,30,15
1656990143035,MATH 18,A03,083745,Cinel; Cameron Alexander,8,0,30,22
1656990143035,MATH 18,B01,083748,Rideout; David Porter,4,0,37,33
1656990143035,MATH 18,B02,083749,Rideout; David Porter,3,0,36,33
1656990143035,MATH 18,B03,083750,Rideout; David Porter,2,0,37,35
1656990143035,MATH 18,B04,083751,Rideout; David Porter,5,0,36,31
1656990143035,MATH 18,B05,093473,Rideout; David Porter,4,0,36,32
1656990143035,MATH 18,B06,093474,Rideout; David Porter,5,0,36,31
1656990149061,MATH 20A,A01,083754,Zheng; Zequn,12,0,40,28
1656990155089,MATH 20B,A01,083756,Briones; Jor-el Thomas Caparas,1,0,36,35
1656990155089,MATH 20B,A02,083757,Briones; Jor-el Thomas Caparas,1,0,36,35
1656990155089,MATH 20B,A03,093475,Briones; Jor-el Thomas Caparas,0,0,36,36
1656990161112,MATH 20C,A01,083760,Briones; Jor-el Thomas Caparas,1,0,35,34
1656990161112,MATH 20C,A02,083761,Briones; Jor-el Thomas Caparas,8,0,35,27
1656990161112,MATH 20C,A03,093476,Briones; Jor-el Thomas Caparas,0,1,36,36
1656990161112,MATH 20C,B01,083762,Bach; Quang Tran,0,0,30,30
1656990167136,MATH 20D,A01,083765,Tran; Brian Kha,4,0,30,26
1656990167136,MATH 20D,A02,083766,Tran; Brian Kha,5,0,30,25
1656990167136,MATH 20D,A03,083767,Tran; Brian Kha,3,0,30,27
1656990173164,MATH 20E,A01,083771,Ganguly; Soumya,5,0,32,27
1656990173164,MATH 20E,A02,083772,Ganguly; Soumya,6,0,32,26
1656990173164,MATH 20E,B01,083773,Ciotti; Benjamin,18,0,35,17
1656990173164,MATH 20E,B02,083774,Ciotti; Benjamin,17,0,35,18
1656990179188,MATH 103A,A01,083777,Greenfeld; Be'Eri,2,0,36,34
1656990179188,MATH 103A,A02,083778,Greenfeld; Be'Eri,5,0,36,31
1656990179188,MATH 103A,A03,093561,Greenfeld; Be'Eri,4,0,36,32
1656990179188,MATH 103A,B01,083779,Greenfeld; Be'Eri,6,0,36,30
1656990179188,MATH 103A,B02,083780,Greenfeld; Be'Eri,2,0,36,34
1656990179188,MATH 103A,B03,093562,Greenfeld; Be'Eri,2,0,36,34
1656990185216,MATH 105,A01,085443,Carter; Anne Toulson,14,0,35,21
1656990185216,MATH 105,A02,093477,Carter; Anne Toulson,20,0,35,15
1656990191246,MATH 109,A01,083213,Ganzberger; Geoffrey Michael,2,0,34,32
1656990191246,MATH 109,A02,083214,Ganzberger; Geoffrey Michael,2,0,34,32
1656990191246,MATH 109,A03,093478,Ganzberger; Geoffrey Michael,1,0,34,33
1656990191246,MATH 109,B01,083215,Ganzberger; Geoffrey Michael,1,0,32,31
1656990191246,MATH 109,B02,083216,Ganzberger; Geoffrey Michael,1,0,32,31
1656990191246,MATH 109,B03,093479,Ganzberger; Geoffrey Michael,6,0,32,26
1656990197275,MATH 142A,A01,083219,Chow; Bennett,6,0,32,26
1656990197275,MATH 142A,A02,083220,Chow; Bennett,10,0,32,22
1656990197275,MATH 142A,A03,093480,Chow; Bennett,7,0,32,25
1656990197275,MATH 142A,B03,093481,Chow; Bennett,7,0,32,25
1656990197275,MATH 142A,B04,093558,Chow; Bennett,11,0,32,21
1656990197275,MATH 142A,B05,093559,Chow; Bennett,6,0,32,26
1656990203309,MATH 193A,A01,083224,Rotar; Vladimir,7,0,34,27
1656990203309,MATH 193A,A02,083225,Rotar; Vladimir,4,0,34,30
1656990203309,MATH 193A,A03,083781,Rotar; Vladimir,1,0,34,33
1656990203309,MATH 193A,A04,083782,Rotar; Vladimir,6,0,34,28
1656990203309,MATH 193A,A05,093482,Rotar; Vladimir,6,0,34,28
1656990209332,MATH 197,001,091859,McAuley; Julian John,9999,0,9999,0
1656990209332,MATH 197,002,095566,Kedlaya; Kiran S.,9997,0,9999,2
1656990209332,MATH 197,003,095567,Xiao; Ming,9999,0,9999,0
1656990209332,MATH 197,004,095571,Perols; Johan Lars,9998,0,9999,1
1656990216383,COGS 9,A01,083615,Shannon; Kyle Michael,7,0,75,68
1656990222409,COGS 11,A01,083617,Boyle; Mary E. T.,20,0,48,28
1656990228436,COGS 13,A01,083071,Bastos; Amalia Pinkusfeld,9,0,71,62
1656990234471,COGS 14A,A01,092681,Semenuks; Arturs,0,1,100,100
1656990240497,COGS 14B,A01,083073,Cheng; Tzu-Han,5,0,63,58
1656990246525,COGS 17,A01,092677,Semenuks; Arturs,4,0,81,77
1656990252548,COGS 100,A01,083619,Allen; Michael Gordon,15,0,70,55
1656990258574,COGS 101A,A01,083621,Davis; Joshua Daniel,9,0,68,59
1656990264597,COGS 101B,A01,091572,Allen; Michael Gordon,8,0,65,57
1656990270621,COGS 101C,A01,083625,Delgado; Tania,17,0,35,18
1656990276645,COGS 107A,A01,083627,Boyle; Mary E. T.,13,0,60,47
1656990282668,COGS 118A,A01,083075,Gupta; Anjum,15,0,76,61
1656990288695,CSE 3,A50,083646,Miranda; Gregory Joseph,22,0,50,28
1656990294720,CSE 8A,A50,083650,Miranda; Gregory Joseph,17,1,56,39
1656990300748,CSE 11,A01,083080,Cao; Yingjun,4,15,40,36
1656990306770,CSE 12,A01,083652,Krause-Levy; Sophia Louisa,20,1,120,100
1656990312797,CSE 15L,A01,083654,Morris; Justin Loren,8,0,50,42
1656990312797,CSE 15L,A02,083655,Morris; Justin Loren,8,0,50,42
1656990318820,CSE 20,A01,083657,Tran; Khoa Dang,37,0,80,43
1656990324847,CSE 21,A01,095574,Bach; Quang Tran,21,0,48,27
1656990330874,CSE 30,A01,083084,Eldon; John,4,0,80,76
1656990330874,CSE 30,B01,095061,Bhaskar; Nishant,6,0,50,44
1656990336900,CSE 100,A01,083659,Cao; Yingjun,3,4,70,67
1656990342924,CSE 134B,A01,083661,Powell; Thomas Allan,19,0,100,81
1656990348949,CSE 140,A01,083663,Gungor; Onat,14,0,85,71
1656990354975,CSE 140L,A01,083088,Eldon; John,16,0,100,84
1656990360998,CSE 175,A01,083665,Kumar; Rakesh,3,0,25,22
1656990367021,CSE 190,A00,092507,Dubnov; Shlomo,7,0,20,13
1656990373043,ECE 45,A01,083139,Congero; Spencer William,5,0,75,70
1656990379068,ECE 65,A50,083695,Saad; Andrew S,12,0,30,18
1656990379068,ECE 65,A51,095125,Saad; Andrew S,25,0,26,1
1656990385094,ECE 109,A01,091882,Touri; Behrouz,16,0,70,54
1656990391118,ECE 180,A00,083140,Abi Samra; Nicholas Camill,1,0,30,29
1656990391118,ECE 180,B00,083141,Abi Samra; Nicholas Camill,0,0,30,30
1656990397145,MATH 10A,A01,083735,Patchell; Gregory David,1,0,30,29
1656990397145,MATH 10A,A02,083736,Patchell; Gregory David,20,0,30,10
1656990397145,MATH 10A,A03,083737,Patchell; Gregory David,15,0,30,15
1656990403169,MATH 10B,A01,083207,Lim; Seonhee,7,0,34,27
1656990403169,MATH 10B,A02,083208,Lim; Seonhee,9,0,35,26
1656990403169,MATH 10B,A03,093472,Lim; Seonhee,4,0,34,30
1656990403169,MATH 10B,B01,083739,Sinha; Shubham,9,0,30,21
1656990409195,MATH 18,A01,083743,Cinel; Cameron Alexander,6,0,30,24
1656990409195,MATH 18,A02,083744,Cinel; Cameron Alexander,15,0,30,15
1656990409195,MATH 18,A03,083745,Cinel; Cameron Alexander,8,0,30,22
1656990409195,MATH 18,B01,083748,Rideout; David Porter,4,0,37,33
1656990409195,MATH 18,B02,083749,Rideout; David Porter,3,0,36,33
1656990409195,MATH 18,B03,083750,Rideout; David Porter,2,0,37,35
1656990409195,MATH 18,B04,083751,Rideout; David Porter,5,0,36,31
1656990409195,MATH 18,B05,093473,Rideout; David Porter,4,0,36,32
1656990409195,MATH 18,B06,093474,Rideout; David Porter,5,0,36,31
1656990415220,MATH 20A,A01,083754,Zheng; Zequn,12,0,40,28
1656990421247,MATH 20B,A01,083756,Briones; Jor-el Thomas Caparas,1,0,36,35
1656990421247,MATH 20B,A02,083757,Briones; Jor-el Thomas Caparas,1,0,36,35
1656990421247,MATH 20B,A03,093475,Briones; Jor-el Thomas Caparas,0,0,36,36
1656990427271,MATH 20C,A01,083760,Briones; Jor-el Thomas Caparas,1,0,35,34
1656990427271,MATH 20C,A02,083761,Briones; Jor-el Thomas Caparas,8,0,35,27
1656990427271,MATH 20C,A03,093476,Briones; Jor-el Thomas Caparas,0,1,36,36
1656990427271,MATH 20C,B01,083762,Bach; Quang Tran,0,0,30,30
1656990433294,MATH 20D,A01,083765,Tran; Brian Kha,4,0,30,26
1656990433294,MATH 20D,A02,083766,Tran; Brian Kha,5,0,30,25
1656990433294,MATH 20D,A03,083767,Tran; Brian Kha,3,0,30,27
1656990439322,MATH 20E,A01,083771,Ganguly; Soumya,5,0,32,27
1656990439322,MATH 20E,A02,083772,Ganguly; Soumya,6,0,32,26
1656990439322,MATH 20E,B01,083773,Ciotti; Benjamin,18,0,35,17
1656990439322,MATH 20E,B02,083774,Ciotti; Benjamin,17,0,35,18
1656990445345,MATH 103A,A01,083777,Greenfeld; Be'Eri,2,0,36,34
1656990445345,MATH 103A,A02,083778,Greenfeld; Be'Eri,5,0,36,31
1656990445345,MATH 103A,A03,093561,Greenfeld; Be'Eri,4,0,36,32
1656990445345,MATH 103A,B01,083779,Greenfeld; Be'Eri,6,0,36,30
1656990445345,MATH 103A,B02,083780,Greenfeld; Be'Eri,2,0,36,34
1656990445345,MATH 103A,B03,093562,Greenfeld; Be'Eri,2,0,36,34
1656990451373,MATH 105,A01,085443,Carter; Anne Toulson,14,0,35,21
1656990451373,MATH 105,A02,093477,Carter; Anne Toulson,20,0,35,15
1656990457398,MATH 109,A01,083213,Ganzberger; Geoffrey Michael,2,0,34,32
1656990457398,MATH 109,A02,083214,Ganzberger; Geoffrey Michael,2,0,34,32
1656990457398,MATH 109,A03,093478,Ganzberger; Geoffrey Michael,1,0,34,33
1656990457398,MATH 109,B01,083215,Ganzberger; Geoffrey Michael,1,0,32,31
1656990457398,MATH 109,B02,083216,Ganzberger; Geoffrey Michael,1,0,32,31
1656990457398,MATH 109,B03,093479,Ganzberger; Geoffrey Michael,6,0,32,26
1656990463426,MATH 142A,A01,083219,Chow; Bennett,6,0,32,26
1656990463426,MATH 142A,A02,083220,Chow; Bennett,10,0,32,22
1656990463426,MATH 142A,A03,093480,Chow; Bennett,7,0,32,25
1656990463426,MATH 142A,B03,093481,Chow; Bennett,7,0,32,25
1656990463426,MATH 142A,B04,093558,Chow; Bennett,11,0,32,21
1656990463426,MATH 142A,B05,093559,Chow; Bennett,6,0,32,26
1656990469458,MATH 193A,A01,083224,Rotar; Vladimir,7,0,34,27
1656990469458,MATH 193A,A02,083225,Rotar; Vladimir,4,0,34,30
1656990469458,MATH 193A,A03,083781,Rotar; Vladimir,1,0,34,33
1656990469458,MATH 193A,A04,083782,Rotar; Vladimir,6,0,34,28
1656990469458,MATH 193A,A05,093482,Rotar; Vladimir,6,0,34,28
1656990475482,MATH 197,001,091859,McAuley; Julian John,9999,0,9999,0
1656990475482,MATH 197,002,095566,Kedlaya; Kiran S.,9997,0,9999,2
1656990475482,MATH 197,003,095567,Xiao; Ming,9999,0,9999,0
1656990475482,MATH 197,004,095571,Perols; Johan Lars,9998,0,9999,1
1656990482542,COGS 9,A01,083615,Shannon; Kyle Michael,7,0,75,68
1656990488574,COGS 11,A01,083617,Boyle; Mary E. T.,20,0,48,28
1656990494601,COGS 13,A01,083071,Bastos; Amalia Pinkusfeld,9,0,71,62
1656990500635,COGS 14A,A01,092681,Semenuks; Arturs,0,1,100,100
1656990506659,COGS 14B,A01,083073,Cheng; Tzu-Han,5,0,63,58
1656990512686,COGS 17,A01,092677,Semenuks; Arturs,4,0,81,77
1656990518790,COGS 100,A01,083619,Allen; Michael Gordon,15,0,70,55
1656990524817,COGS 101A,A01,083621,Davis; Joshua Daniel,9,0,68,59
1656990530845,COGS 101B,A01,091572,Allen; Michael Gordon,8,0,65,57
1656990536871,COGS 101C,A01,083625,Delgado; Tania,17,0,35,18
1656990542894,COGS 107A,A01,083627,Boyle; Mary E. T.,13,0,60,47
1656990548918,COGS 118A,A01,083075,Gupta; Anjum,15,0,76,61
1656990554942,CSE 3,A50,083646,Miranda; Gregory Joseph,22,0,50,28
1656990560966,CSE 8A,A50,083650,Miranda; Gregory Joseph,17,1,56,39
1656990566991,CSE 11,A01,083080,Cao; Yingjun,4,15,40,36
1656990573014,CSE 12,A01,083652,Krause-Levy; Sophia Louisa,20,1,120,100
1656990579038,CSE 15L,A01,083654,Morris; Justin Loren,8,0,50,42
1656990579038,CSE 15L,A02,083655,Morris; Justin Loren,8,0,50,42
1656990585062,CSE 20,A01,083657,Tran; Khoa Dang,37,0,80,43
1656990591084,CSE 21,A01,095574,Bach; Quang Tran,21,0,48,27
1656990597129,CSE 30,A01,083084,Eldon; John,4,0,80,76
1656990597129,CSE 30,B01,095061,Bhaskar; Nishant,6,0,50,44
1656990603153,CSE 100,A01,083659,Cao; Yingjun,3,4,70,67
1656990609175,CSE 134B,A01,083661,Powell; Thomas Allan,19,0,100,81
1656990615202,CSE 140,A01,083663,Gungor; Onat,14,0,85,71
1656990621227,CSE 140L,A01,083088,Eldon; John,16,0,100,84
1656990627254,CSE 175,A01,083665,Kumar; Rakesh,3,0,25,22
1656990633281,CSE 190,A00,092507,Dubnov; Shlomo,7,0,20,13
1656990639305,ECE 45,A01,083139,Congero; Spencer William,5,0,75,70
1656990645329,ECE 65,A50,083695,Saad; Andrew S,12,0,30,18
1656990645329,ECE 65,A51,095125,Saad; Andrew S,25,0,26,1
1656990651355,ECE 109,A01,091882,Touri; Behrouz,16,0,70,54
1656990657382,ECE 180,A00,083140,Abi Samra; Nicholas Camill,1,0,30,29
1656990657382,ECE 180,B00,083141,Abi Samra; Nicholas Camill,0,0,30,30
1656990663414,MATH 10A,A01,083735,Patchell; Gregory David,1,0,30,29
1656990663414,MATH 10A,A02,083736,Patchell; Gregory David,20,0,30,10
1656990663414,MATH 10A,A03,083737,Patchell; Gregory David,15,0,30,15
1656990669450,MATH 10B,A01,083207,Lim; Seonhee,7,0,34,27
1656990669450,MATH 10B,A02,083208,Lim; Seonhee,9,0,35,26
1656990669450,MATH 10B,A03,093472,Lim; Seonhee,4,0,34,30
1656990669450,MATH 10B,B01,083739,Sinha; Shubham,9,0,30,21
1656990675476,MATH 18,A01,083743,Cinel; Cameron Alexander,6,0,30,24
1656990675476,MATH 18,A02,083744,Cinel; Cameron Alexander,15,0,30,15
1656990675476,MATH 18,A03,083745,Cinel; Cameron Alexander,8,0,30,22
1656990675476,MATH 18,B01,083748,Rideout; David Porter,4,0,37,33
1656990675476,MATH 18,B02,083749,Rideout; David Porter,3,0,36,33
1656990675476,MATH 18,B03,083750,Rideout; David Porter,2,0,37,35
1656990675476,MATH 18,B04,083751,Rideout; David Porter,5,0,36,31
1656990675476,MATH 18,B05,093473,Rideout; David Porter,4,0,36,32
1656990675476,MATH 18,B06,093474,Rideout; David Porter,5,0,36,31
1656990681502,MATH 20A,A01,083754,Zheng; Zequn,12,0,40,28
1656990687526,MATH 20B,A01,083756,Briones; Jor-el Thomas Caparas,1,0,36,35
1656990687526,MATH 20B,A02,083757,Briones; Jor-el Thomas Caparas,1,0,36,35
1656990687526,MATH 20B,A03,093475,Briones; Jor-el Thomas Caparas,0,0,36,36
1656990693555,MATH 20C,A01,083760,Briones; Jor-el Thomas Caparas,1,0,35,34
1656990693555,MATH 20C,A02,083761,Briones; Jor-el Thomas Caparas,8,0,35,27
1656990693555,MATH 20C,A03,093476,Briones; Jor-el Thomas Caparas,0,1,36,36
1656990693555,MATH 20C,B01,083762,Bach; Quang Tran,0,0,30,30
1656990699582,MATH 20D,A01,083765,Tran; Brian Kha,4,0,30,26
1656990699582,MATH 20D,A02,083766,Tran; Brian Kha,5,0,30,25
1656990699582,MATH 20D,A03,083767,Tran; Brian Kha,3,0,30,27
1656990705611,MATH 20E,A01,083771,Ganguly; Soumya,5,0,32,27
1656990705611,MATH 20E,A02,083772,Ganguly; Soumya,6,0,32,26
1656990705611,MATH 20E,B01,083773,Ciotti; Benjamin,18,0,35,17
1656990705611,MATH 20E,B02,083774,Ciotti; Benjamin,17,0,35,18
1656990711633,MATH 103A,A01,083777,Greenfeld; Be'Eri,2,0,36,34
1656990711633,MATH 103A,A02,083778,Greenfeld; Be'Eri,5,0,36,31
1656990711633,MATH 103A,A03,093561,Greenfeld; Be'Eri,4,0,36,32
1656990711633,MATH 103A,B01,083779,Greenfeld; Be'Eri,6,0,36,30
1656990711633,MATH 103A,B02,083780,Greenfeld; Be'Eri,2,0,36,34
1656990711633,MATH 103A,B03,093562,Greenfeld; Be'Eri,2,0,36,34
1656990717656,MATH 105,A01,085443,Carter; Anne Toulson,14,0,35,21
1656990717656,MATH 105,A02,093477,Carter; Anne Toulson,20,0,35,15
1656990723680,MATH 109,A01,083213,Ganzberger; Geoffrey Michael,2,0,34,32
1656990723680,MATH 109,A02,083214,Ganzberger; Geoffrey Michael,2,0,34,32
1656990723680,MATH 109,A03,093478,Ganzberger; Geoffrey Michael,1,0,34,33
1656990723680,MATH 109,B01,083215,Ganzberger; Geoffrey Michael,1,0,32,31
1656990723680,MATH 109,B02,083216,Ganzberger; Geoffrey Michael,1,0,32,31
1656990723680,MATH 109,B03,093479,Ganzberger; Geoffrey Michael,6,0,32,26
1656990729710,MATH 142A,A01,083219,Chow; Bennett,6,0,32,26
1656990729710,MATH 142A,A02,083220,Chow; Bennett,10,0,32,22
1656990729710,MATH 142A,A03,093480,Chow; Bennett,7,0,32,25
1656990729710,MATH 142A,B03,093481,Chow; Bennett,7,0,32,25
1656990729710,MATH 142A,B04,093558,Chow; Bennett,11,0,32,21
1656990729710,MATH 142A,B05,093559,Chow; Bennett,6,0,32,26
1656990735738,MATH 193A,A01,083224,Rotar; Vladimir,7,0,34,27
1656990735738,MATH 193A,A02,083225,Rotar; Vladimir,4,0,34,30
1656990735738,MATH 193A,A03,083781,Rotar; Vladimir,1,0,34,33
1656990735738,MATH 193A,A04,083782,Rotar; Vladimir,6,0,34,28
1656990735738,MATH 193A,A05,093482,Rotar; Vladimir,6,0,34,28
1656990741761,MATH 197,001,091859,McAuley; Julian John,9999,0,9999,0
1656990741761,MATH 197,002,095566,Kedlaya; Kiran S.,9997,0,9999,2
1656990741761,MATH 197,003,095567,Xiao; Ming,9999,0,9999,0
1656990741761,MATH 197,004,095571,Perols; Johan Lars,9998,0,9999,1
1656990748813,COGS 9,A01,083615,Shannon; Kyle Michael,7,0,75,68
1656990754833,COGS 11,A01,083617,Boyle; Mary E. T.,20,0,48,28
1656990760857,COGS 13,A01,083071,Bastos; Amalia Pinkusfeld,9,0,71,62
1656990766882,COGS 14A,A01,092681,Semenuks; Arturs,0,1,100,100
1656990772907,COGS 14B,A01,083073,Cheng; Tzu-Han,5,0,63,58
1656990778934,COGS 17,A01,092677,Semenuks; Arturs,4,0,81,77
1656990784962,COGS 100,A01,083619,Allen; Michael Gordon,15,0,70,55
1656990790984,COGS 101A,A01,083621,Davis; Joshua Daniel,9,0,68,59
1656990797010,COGS 101B,A01,091572,Allen; Michael Gordon,8,0,65,57
1656990803036,COGS 101C,A01,083625,Delgado; Tania,17,0,35,18
1656990809060,COGS 107A,A01,083627,Boyle; Mary E. T.,13,0,60,47
1656990815083,COGS 118A,A01,083075,Gupta; Anjum,15,0,76,61
1656990821110,CSE 3,A50,083646,Miranda; Gregory Joseph,22,0,50,28
1656990827134,CSE 8A,A50,083650,Miranda; Gregory Joseph,17,1,56,39
1656990833160,CSE 11,A01,083080,Cao; Yingjun,4,15,40,36
1656990839187,CSE 12,A01,083652,Krause-Levy; Sophia Louisa,20,1,120,100
1656990845209,CSE 15L,A01,083654,Morris; Justin Loren,8,0,50,42
1656990845209,CSE 15L,A02,083655,Morris; Justin Loren,8,0,50,42
1656990851231,CSE 20,A01,083657,Tran; Khoa Dang,37,0,80,43
1656990857257,CSE 21,A01,095574,Bach; Quang Tran,21,0,48,27
1656990863283,CSE 30,A01,083084,Eldon; John,4,0,80,76
1656990863283,CSE 30,B01,095061,Bhaskar; Nishant,6,0,50,44
1656990869305,CSE 100,A01,083659,Cao; Yingjun,3,4,70,67
1656990875332,CSE 134B,A01,083661,Powell; Thomas Allan,19,0,100,81
1656990881357,CSE 140,A01,083663,Gungor; Onat,14,0,85,71
1656990887387,CSE 140L,A01,083088,Eldon; John,16,0,100,84
1656990893412,CSE 175,A01,083665,Kumar; Rakesh,3,0,25,22
1656990899439,CSE 190,A00,092507,Dubnov; Shlomo,7,0,20,13
1656990905462,ECE 45,A01,083139,Congero; Spencer William,5,0,75,70
1656990911484,ECE 65,A50,083695,Saad; Andrew S,12,0,30,18
1656990911484,ECE 65,A51,095125,Saad; Andrew S,25,0,26,1
1656990917507,ECE 109,A01,091882,Touri; Behrouz,16,0,70,54
1656990923539,ECE 180,A00,083140,Abi Samra; Nicholas Camill,1,0,30,29
1656990923539,ECE 180,B00,083141,Abi Samra; Nicholas Camill,0,0,30,30
1656990929566,MATH 10A,A01,083735,Patchell; Gregory David,1,0,30,29
1656990929566,MATH 10A,A02,083736,Patchell; Gregory David,20,0,30,10
1656990929566,MATH 10A,A03,083737,Patchell; Gregory David,15,0,30,15
1656990935588,MATH 10B,A01,083207,Lim; Seonhee,7,0,34,27
1656990935588,MATH 10B,A02,083208,Lim; Seonhee,9,0,35,26
1656990935588,MATH 10B,A03,093472,Lim; Seonhee,4,0,34,30
1656990935588,MATH 10B,B01,083739,Sinha; Shubham,9,0,30,21
1656990941620,MATH 18,A01,083743,Cinel; Cameron Alexander,6,0,30,24
1656990941620,MATH 18,A02,083744,Cinel; Cameron Alexander,15,0,30,15
1656990941620,MATH 18,A03,083745,Cinel; Cameron Alexander,8,0,30,22
1656990941620,MATH 18,B01,083748,Rideout; David Porter,4,0,37,33
1656990941620,MATH 18,B02,083749,Rideout; David Porter,3,0,36,33
1656990941620,MATH 18,B03,083750,Rideout; David Porter,2,0,37,35
1656990941620,MATH 18,B04,083751,Rideout; David Porter,5,0,36,31
1656990941620,MATH 18,B05,093473,Rideout; David Porter,4,0,36,32
1656990941620,MATH 18,B06,093474,Rideout; David Porter,5,0,36,31
1656990947644,MATH 20A,A01,083754,Zheng; Zequn,12,0,40,28
1656990953672,MATH 20B,A01,083756,Briones; Jor-el Thomas Caparas,1,0,36,35
1656990953672,MATH 20B,A02,083757,Briones; Jor-el Thomas Caparas,1,0,36,35
1656990953672,MATH 20B,A03,093475,Briones; Jor-el Thomas Caparas,0,0,36,36
1656990959701,MATH 20C,A01,083760,Briones; Jor-el Thomas Caparas,1,0,35,34
1656990959701,MATH 20C,A02,083761,Briones; Jor-el Thomas Caparas,8,0,35,27
1656990959701,MATH 20C,A03,093476,Briones; Jor-el Thomas Caparas,0,1,36,36
1656990959701,MATH 20C,B01,083762,Bach; Quang Tran,0,0,30,30
1656990965726,MATH 20D,A01,083765,Tran; Brian Kha,4,0,30,26
1656990965726,MATH 20D,A02,083766,Tran; Brian Kha,5,0,30,25
1656990965726,MATH 20D,A03,083767,Tran; Brian Kha,3,0,30,27
1656990971758,MATH 20E,A01,083771,Ganguly; Soumya,5,0,32,27
1656990971758,MATH 20E,A02,083772,Ganguly; Soumya,6,0,32,26
1656990971758,MATH 20E,B01,083773,Ciotti; Benjamin,18,0,35,17
1656990971758,MATH 20E,B02,083774,Ciotti; Benjamin,17,0,35,18
1656990977785,MATH 103A,A01,083777,Greenfeld; Be'Eri,2,0,36,34
1656990977785,MATH 103A,A02,083778,Greenfeld; Be'Eri,5,0,36,31
1656990977785,MATH 103A,A03,093561,Greenfeld; Be'Eri,4,0,36,32
1656990977785,MATH 103A,B01,083779,Greenfeld; Be'Eri,6,0,36,30
1656990977785,MATH 103A,B02,083780,Greenfeld; Be'Eri,2,0,36,34
1656990977785,MATH 103A,B03,093562,Greenfeld; Be'Eri,2,0,36,34
1656990983811,MATH 105,A01,085443,Carter; Anne Toulson,14,0,35,21
1656990983811,MATH 105,A02,093477,Carter; Anne Toulson,20,0,35,15
1656990989834,MATH 109,A01,083213,Ganzberger; Geoffrey Michael,2,0,34,32
1656990989834,MATH 109,A02,083214,Ganzberger; Geoffrey Michael,2,0,34,32
1656990989834,MATH 109,A03,093478,Ganzberger; Geoffrey Michael,1,0,34,33
1656990989834,MATH 109,B01,083215,Ganzberger; Geoffrey Michael,1,0,32,31
1656990989834,MATH 109,B02,083216,Ganzberger; Geoffrey Michael,1,0,32,31
1656990989834,MATH 109,B03,093479,Ganzberger; Geoffrey Michael,6,0,32,26
1656990995857,MATH 142A,A01,083219,Chow; Bennett,6,0,32,26
1656990995857,MATH 142A,A02,083220,Chow; Bennett,10,0,32,22
1656990995857,MATH 142A,A03,093480,Chow; Bennett,7,0,32,25
1656990995857,MATH 142A,B03,093481,Chow; Bennett,7,0,32,25
1656990995857,MATH 142A,B04,093558,Chow; Bennett,11,0,32,21
1656990995857,MATH 142A,B05,093559,Chow; Bennett,6,0,32,26
1656991001882,MATH 193A,A01,083224,Rotar; Vladimir,7,0,34,27
1656991001882,MATH 193A,A02,083225,Rotar; Vladimir,4,0,34,30
1656991001882,MATH 193A,A03,083781,Rotar; Vladimir,1,0,34,33
1656991001882,MATH 193A,A04,083782,Rotar; Vladimir,6,0,34,28
1656991001882,MATH 193A,A05,093482,Rotar; Vladimir,6,0,34,28
1656991007913,MATH 197,001,091859,McAuley; Julian John,9999,0,9999,0
1656991007913,MATH 197,002,095566,Kedlaya; Kiran S.,9997,0,9999,2
1656991007913,MATH 197,003,095567,Xiao; Ming,9999,0,9999,0
1656991007913,MATH 197,004,095571,Perols; Johan Lars,9998,0,9999,1
1656991014965,COGS 9,A01,083615,Shannon; Kyle Michael,7,0,75,68
1656991020987,COGS 11,A01,083617,Boyle; Mary E. T.,20,0,48,28
1656991027009,COGS 13,A01,083071,Bastos; Amalia Pinkusfeld,9,0,71,62
1656991033047,COGS 14A,A01,092681,Semenuks; Arturs,0,1,100,100
1656991039071,COGS 14B,A01,083073,Cheng; Tzu-Han,5,0,63,58
1656991045095,COGS 17,A01,092677,Semenuks; Arturs,4,0,81,77
1656991051117,COGS 100,A01,083619,Allen; Michael Gordon,15,0,70,55
1656991057140,COGS 101A,A01,083621,Davis; Joshua Daniel,9,0,68,59
1656991063162,COGS 101B,A01,091572,Allen; Michael Gordon,8,0,65,57
1656991069189,COGS 101C,A01,083625,Delgado; Tania,17,0,35,18
1656991075216,COGS 107A,A01,083627,Boyle; Mary E. T.,13,0,60,47
1656991081243,COGS 118A,A01,083075,Gupta; Anjum,15,0,76,61
1656991087265,CSE 3,A50,083646,Miranda; Gregory Joseph,22,0,50,28
1656991093293,CSE 8A,A50,083650,Miranda; Gregory Joseph,17,1,56,39
1656991099316,CSE 11,A01,083080,Cao; Yingjun,4,15,40,36
1656991105343,CSE 12,A01,083652,Krause-Levy; Sophia Louisa,20,1,120,100
1656991111368,CSE 15L,A01,083654,Morris; Justin Loren,8,0,50,42
1656991111368,CSE 15L,A02,083655,Morris; Justin Loren,8,0,50,42
1656991117492,CSE 20,A01,083657,Tran; Khoa Dang,37,0,80,43
1656991123519,CSE 21,A01,095574,Bach; Quang Tran,21,0,48,27
1656991129543,CSE 30,A01,083084,Eldon; John,4,0,80,76
1656991129543,CSE 30,B01,095061,Bhaskar; Nishant,6,0,50,44
1656991135567,CSE 100,A01,083659,Cao; Yingjun,3,4,70,67
1656991141600,CSE 134B,A01,083661,Powell; Thomas Allan,19,0,100,81
1656991147623,CSE 140,A01,083663,Gungor; Onat,14,0,85,71
1656991153647,CSE 140L,A01,083088,Eldon; John,16,0,100,84
1656991159670,CSE 175,A01,083665,Kumar; Rakesh,3,0,25,22
1656991165696,CSE 190,A00,092507,Dubnov; Shlomo,7,0,20,13
1656991171721,ECE 45,A01,083139,Congero; Spencer William,5,0,75,70
1656991177743,ECE 65,A50,083695,Saad; Andrew S,12,0,30,18
1656991177743,ECE 65,A51,095125,Saad; Andrew S,25,0,26,1
1656991183765,ECE 109,A01,091882,Touri; Behrouz,16,0,70,54
1656991189789,ECE 180,A00,083140,Abi Samra; Nicholas Camill,1,0,30,29
1656991189789,ECE 180,B00,083141,Abi Samra; Nicholas Camill,0,0,30,30
1656991195816,MATH 10A,A01,083735,Patchell; Gregory David,1,0,30,29
1656991195816,MATH 10A,A02,083736,Patchell; Gregory David,20,0,30,10
1656991195816,MATH 10A,A03,083737,Patchell; Gregory David,15,0,30,15
1656991201845,MATH 10B,A01,083207,Lim; Seonhee,7,0,34,27
1656991201845,MATH 10B,A02,083208,Lim; Seonhee,9,0,35,26
1656991201845,MATH 10B,A03,093472,Lim; Seonhee,4,0,34,30
1656991201845,MATH 10B,B01,083739,Sinha; Shubham,9,0,30,21
1656991207876,MATH 18,A01,083743,Cinel; Cameron Alexander,6,0,30,24
1656991207876,MATH 18,A02,083744,Cinel; Cameron Alexander,15,0,30,15
1656991207876,MATH 18,A03,083745,Cinel; Cameron Alexander,8,0,30,22
1656991207876,MATH 18,B01,083748,Rideout; David Porter,4,0,37,33
1656991207876,MATH 18,B02,083749,Rideout; David Porter,3,0,36,33
1656991207876,MATH 18,B03,083750,Rideout; David Porter,2,0,37,35
1656991207876,MATH 18,B04,083751,Rideout; David Porter,5,0,36,31
1656991207876,MATH 18,B05,093473,Rideout; David Porter,4,0,36,32
1656991207876,MATH 18,B06,093474,Rideout; David Porter,5,0,36,31
1656991213898,MATH 20A,A01,083754,Zheng; Zequn,12,0,40,28
1656991219926,MATH 20B,A01,083756,Briones; Jor-el Thomas Caparas,1,0,36,35
1656991219926,MATH 20B,A02,083757,Briones; Jor-el Thomas Caparas,1,0,36,35
1656991219926,MATH 20B,A03,093475,Briones; Jor-el Thomas Caparas,0,0,36,36
1656991225956,MATH 20C,A01,083760,Briones; Jor-el Thomas Caparas,1,0,35,34
1656991225956,MATH 20C,A02,083761,Briones; Jor-el Thomas Caparas,8,0,35,27
1656991225956,MATH 20C,A03,093476,Briones; Jor-el Thomas Caparas,0,1,36,36
1656991225956,MATH 20C,B01,083762,Bach; Quang Tran,0,0,30,30
1656991231979,MATH 20D,A01,083765,Tran; Brian Kha,4,0,30,26
1656991231979,MATH 20D,A02,083766,Tran; Brian Kha,5,0,30,25
1656991231979,MATH 20D,A03,083767,Tran; Brian Kha,3,0,30,27
1656991238008,MATH 20E,A01,083771,Ganguly; Soumya,5,0,32,27
1656991238008,MATH 20E,A02,083772,Ganguly; Soumya,6,0,32,26
1656991238008,MATH 20E,B01,083773,Ciotti; Benjamin,18,0,35,17
1656991238008,MATH 20E,B02,083774,Ciotti; Benjamin,17,0,35,18
1656991244038,MATH 103A,A01,083777,Greenfeld; Be'Eri,2,0,36,34
1656991244038,MATH 103A,A02,083778,Greenfeld; Be'Eri,5,0,36,31
1656991244038,MATH 103A,A03,093561,Greenfeld; Be'Eri,4,0,36,32
1656991244038,MATH 103A,B01,083779,Greenfeld; Be'Eri,6,0,36,30
1656991244038,MATH 103A,B02,083780,Greenfeld; Be'Eri,2,0,36,34
1656991244038,MATH 103A,B03,093562,Greenfeld; Be'Eri,2,0,36,34
1656991250062,MATH 105,A01,085443,Carter; Anne Toulson,14,0,35,21
1656991250062,MATH 105,A02,093477,Carter; Anne Toulson,20,0,35,15
1656991256087,MATH 109,A01,083213,Ganzberger; Geoffrey Michael,2,0,34,32
1656991256087,MATH 109,A02,083214,Ganzberger; Geoffrey Michael,2,0,34,32
1656991256087,MATH 109,A03,093478,Ganzberger; Geoffrey Michael,1,0,34,33
1656991256087,MATH 109,B01,083215,Ganzberger; Geoffrey Michael,1,0,32,31
1656991256087,MATH 109,B02,083216,Ganzberger; Geoffrey Michael,1,0,32,31
1656991256087,MATH 109,B03,093479,Ganzberger; Geoffrey Michael,6,0,32,26
1656991262118,MATH 142A,A01,083219,Chow; Bennett,6,0,32,26
1656991262118,MATH 142A,A02,083220,Chow; Bennett,10,0,32,22
1656991262118,MATH 142A,A03,093480,Chow; Bennett,7,0,32,25
1656991262118,MATH 142A,B03,093481,Chow; Bennett,7,0,32,25
1656991262118,MATH 142A,B04,093558,Chow; Bennett,11,0,32,21
1656991262118,MATH 142A,B05,093559,Chow; Bennett,6,0,32,26
1656991268143,MATH 193A,A01,083224,Rotar; Vladimir,7,0,34,27
1656991268143,MATH 193A,A02,083225,Rotar; Vladimir,4,0,34,30
1656991268143,MATH 193A,A03,083781,Rotar; Vladimir,1,0,34,33
1656991268143,MATH 193A,A04,083782,Rotar; Vladimir,6,0,34,28
1656991268143,MATH 193A,A05,093482,Rotar; Vladimir,6,0,34,28
1656991274166,MATH 197,001,091859,McAuley; Julian John,9999,0,9999,0
1656991274166,MATH 197,002,095566,Kedlaya; Kiran S.,9997,0,9999,2
1656991274166,MATH 197,003,095567,Xiao; Ming,9999,0,9999,0
1656991274166,MATH 197,004,095571,Perols; Johan Lars,9998,0,9999,1
1656991281216,COGS 9,A01,083615,Shannon; Kyle Michael,7,0,75,68
1656991287238,COGS 11,A01,083617,Boyle; Mary E. T.,20,0,48,28
1656991293268,COGS 13,A01,083071,Bastos; Amalia Pinkusfeld,9,0,71,62
1656991299290,COGS 14A,A01,092681,Semenuks; Arturs,0,1,100,100
1656991305312,COGS 14B,A01,083073,Cheng; Tzu-Han,5,0,63,58
1656991311335,COGS 17,A01,092677,Semenuks; Arturs,4,0,81,77
1656991317359,COGS 100,A01,083619,Allen; Michael Gordon,15,0,70,55
1656991323381,COGS 101A,A01,083621,Davis; Joshua Daniel,9,0,68,59
1656991329404,COGS 101B,A01,091572,Allen; Michael Gordon,8,0,65,57
1656991335428,COGS 101C,A01,083625,Delgado; Tania,17,0,35,18
1656991341455,COGS 107A,A01,083627,Boyle; Mary E. T.,13,0,60,47
1656991347480,COGS 118A,A01,083075,Gupta; Anjum,15,0,76,61
1656991353504,CSE 3,A50,083646,Miranda; Gregory Joseph,22,0,50,28
1656991359532,CSE 8A,A50,083650,Miranda; Gregory Joseph,17,1,56,39
1656991365555,CSE 11,A01,083080,Cao; Yingjun,4,15,40,36
1656991371586,CSE 12,A01,083652,Krause-Levy; Sophia Louisa,20,1,120,100
1656991377611,CSE 15L,A01,083654,Morris; Justin Loren,8,0,50,42
1656991377611,CSE 15L,A02,083655,Morris; Justin Loren,8,0,50,42
1656991383635,CSE 20,A01,083657,Tran; Khoa Dang,37,0,80,43
1656991389657,CSE 21,A01,095574,Bach; Quang Tran,21,0,48,27
1656991395684,CSE 30,A01,083084,Eldon; John,4,0,80,76
1656991395684,CSE 30,B01,095061,Bhaskar; Nishant,6,0,50,44
1656991401710,CSE 100,A01,083659,Cao; Yingjun,3,4,70,67
1656991407733,CSE 134B,A01,083661,Powell; Thomas Allan,19,0,100,81
1656991413757,CSE 140,A01,083663,Gungor; Onat,14,0,85,71
1656991419784,CSE 140L,A01,083088,Eldon; John,16,0,100,84
1656991425806,CSE 175,A01,083665,Kumar; Rakesh,3,0,25,22
1656991431830,CSE 190,A00,092507,Dubnov; Shlomo,7,0,20,13
1656991437855,ECE 45,A01,083139,Congero; Spencer William,5,0,75,70
1656991443881,ECE 65,A50,083695,Saad; Andrew S,12,0,30,18
1656991443881,ECE 65,A51,095125,Saad; Andrew S,25,0,26,1
1656991449906,ECE 109,A01,091882,Touri; Behrouz,16,0,70,54
1656991455930,ECE 180,A00,083140,Abi Samra; Nicholas Camill,1,0,30,29
1656991455930,ECE 180,B00,083141,Abi Samra; Nicholas Camill,0,0,30,30
1656991461958,MATH 10A,A01,083735,Patchell; Gregory David,1,0,30,29
1656991461958,MATH 10A,A02,083736,Patchell; Gregory David,20,0,30,10
1656991461958,MATH 10A,A03,083737,Patchell; Gregory David,15,0,30,15
1656991467985,MATH 10B,A01,083207,Lim; Seonhee,7,0,34,27
1656991467985,MATH 10B,A02,083208,Lim; Seonhee,9,0,35,26
1656991467985,MATH 10B,A03,093472,Lim; Seonhee,4,0,34,30
1656991467985,MATH 10B,B01,083739,Sinha; Shubham,9,0,30,21
1656991474010,MATH 18,A01,083743,Cinel; Cameron Alexander,6,0,30,24
1656991474010,MATH 18,A02,083744,Cinel; Cameron Alexander,15,0,30,15
1656991474010,MATH 18,A03,083745,Cinel; Cameron Alexander,8,0,30,22
1656991474010,MATH 18,B01,083748,Rideout; David Porter,4,0,37,33
1656991474010,MATH 18,B02,083749,Rideout; David Porter,3,0,36,33
1656991474010,MATH 18,B03,083750,Rideout; David Porter,2,0,37,35
1656991474010,MATH 18,B04,083751,Rideout; David Porter,5,0,36,31
1656991474010,MATH 18,B05,093473,Rideout; David Porter,4,0,36,32
1656991474010,MATH 18,B06,093474,Rideout; David Porter,5,0,36,31
1656991480033,MATH 20A,A01,083754,Zheng; Zequn,12,0,40,28
1656991486062,MATH 20B,A01,083756,Briones; Jor-el Thomas Caparas,1,0,36,35
1656991486062,MATH 20B,A02,083757,Briones; Jor-el Thomas Caparas,1,0,36,35
1656991486062,MATH 20B,A03,093475,Briones; Jor-el Thomas Caparas,0,0,36,36
1656991492092,MATH 20C,A01,083760,Briones; Jor-el Thomas Caparas,1,0,35,34
1656991492092,MATH 20C,A02,083761,Briones; Jor-el Thomas Caparas,8,0,35,27
1656991492092,MATH 20C,A03,093476,Briones; Jor-el Thomas Caparas,0,1,36,36
1656991492092,MATH 20C,B01,083762,Bach; Quang Tran,0,0,30,30
1656991498120,MATH 20D,A01,083765,Tran; Brian Kha,4,0,30,26
1656991498120,MATH 20D,A02,083766,Tran; Brian Kha,5,0,30,25
1656991498120,MATH 20D,A03,083767,Tran; Brian Kha,3,0,30,27
1656991504143,MATH 20E,A01,083771,Ganguly; Soumya,5,0,32,27
1656991504143,MATH 20E,A02,083772,Ganguly; Soumya,6,0,32,26
1656991504143,MATH 20E,B01,083773,Ciotti; Benjamin,18,0,35,17
1656991504143,MATH 20E,B02,083774,Ciotti; Benjamin,17,0,35,18
1656991510176,MATH 103A,A01,083777,Greenfeld; Be'Eri,2,0,36,34
1656991510176,MATH 103A,A02,083778,Greenfeld; Be'Eri,5,0,36,31
1656991510176,MATH 103A,A03,093561,Greenfeld; Be'Eri,4,0,36,32
1656991510176,MATH 103A,B01,083779,Greenfeld; Be'Eri,6,0,36,30
1656991510176,MATH 103A,B02,083780,Greenfeld; Be'Eri,2,0,36,34
1656991510176,MATH 103A,B03,093562,Greenfeld; Be'Eri,2,0,36,34
1656991516201,MATH 105,A01,085443,Carter; Anne Toulson,14,0,35,21
1656991516201,MATH 105,A02,093477,Carter; Anne Toulson,20,0,35,15
1656991522232,MATH 109,A01,083213,Ganzberger; Geoffrey Michael,2,0,34,32
1656991522232,MATH 109,A02,083214,Ganzberger; Geoffrey Michael,2,0,34,32
1656991522232,MATH 109,A03,093478,Ganzberger; Geoffrey Michael,1,0,34,33
1656991522232,MATH 109,B01,083215,Ganzberger; Geoffrey Michael,1,0,32,31
1656991522232,MATH 109,B02,083216,Ganzberger; Geoffrey Michael,1,0,32,31
1656991522232,MATH 109,B03,093479,Ganzberger; Geoffrey Michael,6,0,32,26
1656991528262,MATH 142A,A01,083219,Chow; Bennett,6,0,32,26
1656991528262,MATH 142A,A02,083220,Chow; Bennett,10,0,32,22
1656991528262,MATH 142A,A03,093480,Chow; Bennett,7,0,32,25
1656991528262,MATH 142A,B03,093481,Chow; Bennett,7,0,32,25
1656991528262,MATH 142A,B04,093558,Chow; Bennett,11,0,32,21
1656991528262,MATH 142A,B05,093559,Chow; Bennett,6,0,32,26
1656991534288,MATH 193A,A01,083224,Rotar; Vladimir,7,0,34,27
1656991534288,MATH 193A,A02,083225,Rotar; Vladimir,4,0,34,30
1656991534288,MATH 193A,A03,083781,Rotar; Vladimir,1,0,34,33
1656991534288,MATH 193A,A04,083782,Rotar; Vladimir,6,0,34,28
1656991534288,MATH 193A,A05,093482,Rotar; Vladimir,6,0,34,28
1656991540315,MATH 197,001,091859,McAuley; Julian John,9999,0,9999,0
1656991540315,MATH 197,002,095566,Kedlaya; Kiran S.,9997,0,9999,2
1656991540315,MATH 197,003,095567,Xiao; Ming,9999,0,9999,0
1656991540315,MATH 197,004,095571,Perols; Johan Lars,9998,0,9999,1
1656991547380,COGS 9,A01,083615,Shannon; Kyle Michael,7,0,75,68
1656991553404,COGS 11,A01,083617,Boyle; Mary E. T.,20,0,48,28
1656991559426,COGS 13,A01,083071,Bastos; Amalia Pinkusfeld,9,0,71,62
1656991565455,COGS 14A,A01,092681,Semenuks; Arturs,0,1,100,100
1656991571479,COGS 14B,A01,083073,Cheng; Tzu-Han,5,0,63,58
1656991577503,COGS 17,A01,092677,Semenuks; Arturs,4,0,81,77
1656991583527,COGS 100,A01,083619,Allen; Michael Gordon,15,0,70,55
1656991589550,COGS 101A,A01,083621,Davis; Joshua Daniel,9,0,68,59
1656991595573,COGS 101B,A01,091572,Allen; Michael Gordon,8,0,65,57
1656991601596,COGS 101C,A01,083625,Delgado; Tania,17,0,35,18
1656991607621,COGS 107A,A01,083627,Boyle; Mary E. T.,13,0,60,47
1656991613645,COGS 118A,A01,083075,Gupta; Anjum,15,0,76,61
1656991619669,CSE 3,A50,083646,Miranda; Gregory Joseph,22,0,50,28
1656991625693,CSE 8A,A50,083650,Miranda; Gregory Joseph,17,1,56,39
1656991631729,CSE 11,A01,083080,Cao; Yingjun,4,15,40,36
1656991637753,CSE 12,A01,083652,Krause-Levy; Sophia Louisa,20,1,120,100
1656991643777,CSE 15L,A01,083654,Morris; Justin Loren,8,0,50,42
1656991643777,CSE 15L,A02,083655,Morris; Justin Loren,8,0,50,42
1656991649802,CSE 20,A01,083657,Tran; Khoa Dang,37,0,80,43
1656991655825,CSE 21,A01,095574,Bach; Quang Tran,21,0,48,27
1656991661850,CSE 30,A01,083084,Eldon; John,4,0,80,76
1656991661850,CSE 30,B01,095061,Bhaskar; Nishant,6,0,50,44
1656991667876,CSE 100,A01,083659,Cao; Yingjun,3,4,70,67
1656991673900,CSE 134B,A01,083661,Powell; Thomas Allan,19,0,100,81
1656991679924,CSE 140,A01,083663,Gungor; Onat,14,0,85,71
1656991685951,CSE 140L,A01,083088,Eldon; John,16,0,100,84
1656991691976,CSE 175,A01,083665,Kumar; Rakesh,3,0,25,22
1656991697999,CSE 190,A00,092507,Dubnov; Shlomo,7,0,20,13
1656991704025,ECE 45,A01,083139,Congero; Spencer William,5,0,75,70
1656991710048,ECE 65,A50,083695,Saad; Andrew S,12,0,30,18
1656991710048,ECE 65,A51,095125,Saad; Andrew S,25,0,26,1
1656991716159,ECE 109,A01,091882,Touri; Behrouz,16,0,70,54
1656991722184,ECE 180,A00,083140,Abi Samra; Nicholas Camill,1,0,30,29
1656991722184,ECE 180,B00,083141,Abi Samra; Nicholas Camill,0,0,30,30
1656991728209,MATH 10A,A01,083735,Patchell; Gregory David,1,0,30,29
1656991728209,MATH 10A,A02,083736,Patchell; Gregory David,20,0,30,10
1656991728209,MATH 10A,A03,083737,Patchell; Gregory David,15,0,30,15
1656991734239,MATH 10B,A01,083207,Lim; Seonhee,7,0,34,27
1656991734239,MATH 10B,A02,083208,Lim; Seonhee,9,0,35,26
1656991734239,MATH 10B,A03,093472,Lim; Seonhee,4,0,34,30
1656991734239,MATH 10B,B01,083739,Sinha; Shubham,9,0,30,21
1656991740272,MATH 18,A01,083743,Cinel; Cameron Alexander,6,0,30,24
1656991740272,MATH 18,A02,083744,Cinel; Cameron Alexander,15,0,30,15
1656991740272,MATH 18,A03,083745,Cinel; Cameron Alexander,8,0,30,22
1656991740272,MATH 18,B01,083748,Rideout; David Porter,4,0,37,33
1656991740272,MATH 18,B02,083749,Rideout; David Porter,3,0,36,33
1656991740272,MATH 18,B03,083750,Rideout; David Porter,2,0,37,35
1656991740272,MATH 18,B04,083751,Rideout; David Porter,5,0,36,31
1656991740272,MATH 18,B05,093473,Rideout; David Porter,4,0,36,32
1656991740272,MATH 18,B06,093474,Rideout; David Porter,5,0,36,31
1656991746298,MATH 20A,A01,083754,Zheng; Zequn,12,0,40,28
1656991752321,MATH 20B,A01,083756,Briones; Jor-el Thomas Caparas,1,0,36,35
1656991752321,MATH 20B,A02,083757,Briones; Jor-el Thomas Caparas,1,0,36,35
1656991752321,MATH 20B,A03,093475,Briones; Jor-el Thomas Caparas,0,0,36,36
1656991758343,MATH 20C,A01,083760,Briones; Jor-el Thomas Caparas,1,0,35,34
1656991758343,MATH 20C,A02,083761,Briones; Jor-el Thomas Caparas,8,0,35,27
1656991758343,MATH 20C,A03,093476,Briones; Jor-el Thomas Caparas,0,1,36,36
1656991758343,MATH 20C,B01,083762,Bach; Quang Tran,0,0,30,30
1656991764370,MATH 20D,A01,083765,Tran; Brian Kha,4,0,30,26
1656991764370,MATH 20D,A02,083766,Tran; Brian Kha,5,0,30,25
1656991764370,MATH 20D,A03,083767,Tran; Brian Kha,3,0,30,27
1656991770401,MATH 20E,A01,083771,Ganguly; Soumya,5,0,32,27
1656991770401,MATH 20E,A02,083772,Ganguly; Soumya,6,0,32,26
1656991770401,MATH 20E,B01,083773,Ciotti; Benjamin,18,0,35,17
1656991770401,MATH 20E,B02,083774,Ciotti; Benjamin,17,0,35,18
1656991776426,MATH 103A,A01,083777,Greenfeld; Be'Eri,2,0,36,34
1656991776426,MATH 103A,A02,083778,Greenfeld; Be'Eri,5,0,36,31
1656991776426,MATH 103A,A03,093561,Greenfeld; Be'Eri,4,0,36,32
1656991776426,MATH 103A,B01,083779,Greenfeld; Be'Eri,6,0,36,30
1656991776426,MATH 103A,B02,083780,Greenfeld; Be'Eri,2,0,36,34
1656991776426,MATH 103A,B03,093562,Greenfeld; Be'Eri,2,0,36,34
1656991782452,MATH 105,A01,085443,Carter; Anne Toulson,14,0,35,21
1656991782452,MATH 105,A02,093477,Carter; Anne Toulson,20,0,35,15
1656991788476,MATH 109,A01,083213,Ganzberger; Geoffrey Michael,2,0,34,32
1656991788476,MATH 109,A02,083214,Ganzberger; Geoffrey Michael,2,0,34,32
1656991788476,MATH 109,A03,093478,Ganzberger; Geoffrey Michael,1,0,34,33
1656991788476,MATH 109,B01,083215,Ganzberger; Geoffrey Michael,1,0,32,31
1656991788476,MATH 109,B02,083216,Ganzberger; Geoffrey Michael,1,0,32,31
1656991788476,MATH 109,B03,093479,Ganzberger; Geoffrey Michael,6,0,32,26
1656991794501,MATH 142A,A01,083219,Chow; Bennett,6,0,32,26
1656991794501,MATH 142A,A02,083220,Chow; Bennett,10,0,32,22
1656991794501,MATH 142A,A03,093480,Chow; Bennett,7,0,32,25
1656991794501,MATH 142A,B03,093481,Chow; Bennett,7,0,32,25
1656991794501,MATH 142A,B04,093558,Chow; Bennett,11,0,32,21
1656991794501,MATH 142A,B05,093559,Chow; Bennett,6,0,32,26
1656991800523,MATH 193A,A01,083224,Rotar; Vladimir,7,0,34,27
1656991800523,MATH 193A,A02,083225,Rotar; Vladimir,4,0,34,30
1656991800523,MATH 193A,A03,083781,Rotar; Vladimir,1,0,34,33
1656991800523,MATH 193A,A04,083782,Rotar; Vladimir,6,0,34,28
1656991800523,MATH 193A,A05,093482,Rotar; Vladimir,6,0,34,28
1656991806546,MATH 197,001,091859,McAuley; Julian John,9999,0,9999,0
1656991806546,MATH 197,002,095566,Kedlaya; Kiran S.,9997,0,9999,2
1656991806546,MATH 197,003,095567,Xiao; Ming,9999,0,9999,0
1656991806546,MATH 197,004,095571,Perols; Johan Lars,9998,0,9999,1
1656991813595,COGS 9,A01,083615,Shannon; Kyle Michael,7,0,75,68
1656991819621,COGS 11,A01,083617,Boyle; Mary E. T.,20,0,48,28
1656991825648,COGS 13,A01,083071,Bastos; Amalia Pinkusfeld,9,0,71,62
1656991831672,COGS 14A,A01,092681,Semenuks; Arturs,0,1,100,100
1656991837699,COGS 14B,A01,083073,Cheng; Tzu-Han,5,0,63,58
1656991843721,COGS 17,A01,092677,Semenuks; Arturs,4,0,81,77
1656991849748,COGS 100,A01,083619,Allen; Michael Gordon,15,0,70,55
1656991855776,COGS 101A,A01,083621,Davis; Joshua Daniel,9,0,68,59
1656991861801,COGS 101B,A01,091572,Allen; Michael Gordon,8,0,65,57
1656991867824,COGS 101C,A01,083625,Delgado; Tania,17,0,35,18
1656991873859,COGS 107A,A01,083627,Boyle; Mary E. T.,13,0,60,47
1656991879883,COGS 118A,A01,083075,Gupta; Anjum,15,0,76,61
1656991885907,CSE 3,A50,083646,Miranda; Gregory Joseph,22,0,50,28
1656991891934,CSE 8A,A50,083650,Miranda; Gregory Joseph,17,1,56,39
1656991897960,CSE 11,A01,083080,Cao; Yingjun,4,15,40,36
1656991903988,CSE 12,A01,083652,Krause-Levy; Sophia Louisa,20,1,120,100
1656991910011,CSE 15L,A01,083654,Morris; Justin Loren,8,0,50,42
1656991910011,CSE 15L,A02,083655,Morris; Justin Loren,8,0,50,42
1656991916036,CSE 20,A01,083657,Tran; Khoa Dang,37,0,80,43
1656991922059,CSE 21,A01,095574,Bach; Quang Tran,21,0,48,27
1656991928083,CSE 30,A01,083084,Eldon; John,4,0,80,76
1656991928083,CSE 30,B01,095061,Bhaskar; Nishant,6,0,50,44
1656991934112,CSE 100,A01,083659,Cao; Yingjun,3,4,70,67
1656991940137,CSE 134B,A01,083661,Powell; Thomas Allan,19,0,100,81
1656991946163,CSE 140,A01,083663,Gungor; Onat,14,0,85,71
1656991952190,CSE 140L,A01,083088,Eldon; John,16,0,100,84
1656991958216,CSE 175,A01,083665,Kumar; Rakesh,3,0,25,22
1656991964243,CSE 190,A00,092507,Dubnov; Shlomo,7,0,20,13
1656991970266,ECE 45,A01,083139,Congero; Spencer William,5,0,75,70
1656991976293,ECE 65,A50,083695,Saad; Andrew S,12,0,30,18
1656991976293,ECE 65,A51,095125,Saad; Andrew S,25,0,26,1
1656991982320,ECE 109,A01,091882,Touri; Behrouz,16,0,70,54
1656991988346,ECE 180,A00,083140,Abi Samra; Nicholas Camill,1,0,30,29
1656991988346,ECE 180,B00,083141,Abi Samra; Nicholas Camill,0,0,30,30
1656991994370,MATH 10A,A01,083735,Patchell; Gregory David,1,0,30,29
1656991994370,MATH 10A,A02,083736,Patchell; Gregory David,20,0,30,10
1656991994370,MATH 10A,A03,083737,Patchell; Gregory David,15,0,30,15
1656992000399,MATH 10B,A01,083207,Lim; Seonhee,7,0,34,27
1656992000399,MATH 10B,A02,083208,Lim; Seonhee,9,0,35,26
1656992000399,MATH 10B,A03,093472,Lim; Seonhee,4,0,34,30
1656992000399,MATH 10B,B01,083739,Sinha; Shubham,9,0,30,21
1656992006434,MATH 18,A01,083743,Cinel; Cameron Alexander,6,0,30,24
1656992006434,MATH 18,A02,083744,Cinel; Cameron Alexander,15,0,30,15
1656992006434,MATH 18,A03,083745,Cinel; Cameron Alexander,8,0,30,22
1656992006434,MATH 18,B01,083748,Rideout; David Porter,4,0,37,33
1656992006434,MATH 18,B02,083749,Rideout; David Porter,3,0,36,33
1656992006434,MATH 18,B03,083750,Rideout; David Porter,2,0,37,35
1656992006434,MATH 18,B04,083751,Rideout; David Porter,5,0,36,31
1656992006434,MATH 18,B05,093473,Rideout; David Porter,4,0,36,32
1656992006434,MATH 18,B06,093474,Rideout; David Porter,5,0,36,31
1656992012459,MATH 20A,A01,083754,Zheng; Zequn,12,0,40,28
1656992018487,MATH 20B,A01,083756,Briones; Jor-el Thomas Caparas,1,0,36,35
1656992018487,MATH 20B,A02,083757,Briones; Jor-el Thomas Caparas,1,0,36,35
1656992018487,MATH 20B,A03,093475,Briones; Jor-el Thomas Caparas,0,0,36,36
1656992024519,MATH 20C,A01,083760,Briones; Jor-el Thomas Caparas,1,0,35,34
1656992024519,MATH 20C,A02,083761,Briones; Jor-el Thomas Caparas,8,0,35,27
1656992024519,MATH 20C,A03,093476,Briones; Jor-el Thomas Caparas,0,1,36,36
1656992024519,MATH 20C,B01,083762,Bach; Quang Tran,0,0,30,30
1656992030542,MATH 20D,A01,083765,Tran; Brian Kha,4,0,30,26
1656992030542,MATH 20D,A02,083766,Tran; Brian Kha,5,0,30,25
1656992030542,MATH 20D,A03,083767,Tran; Brian Kha,3,0,30,27
1656992036569,MATH 20E,A01,083771,Ganguly; Soumya,5,0,32,27
1656992036569,MATH 20E,A02,083772,Ganguly; Soumya,6,0,32,26
1656992036569,MATH 20E,B01,083773,Ciotti; Benjamin,18,0,35,17
1656992036569,MATH 20E,B02,083774,Ciotti; Benjamin,17,0,35,18
1656992042594,MATH 103A,A01,083777,Greenfeld; Be'Eri,2,0,36,34
1656992042594,MATH 103A,A02,083778,Greenfeld; Be'Eri,5,0,36,31
1656992042594,MATH 103A,A03,093561,Greenfeld; Be'Eri,4,0,36,32
1656992042594,MATH 103A,B01,083779,Greenfeld; Be'Eri,6,0,36,30
1656992042594,MATH 103A,B02,083780,Greenfeld; Be'Eri,2,0,36,34
1656992042594,MATH 103A,B03,093562,Greenfeld; Be'Eri,2,0,36,34
1656992048618,MATH 105,A01,085443,Carter; Anne Toulson,14,0,35,21
1656992048618,MATH 105,A02,093477,Carter; Anne Toulson,20,0,35,15
1656992054658,MATH 109,A01,083213,Ganzberger; Geoffrey Michael,2,0,34,32
1656992054658,MATH 109,A02,083214,Ganzberger; Geoffrey Michael,2,0,34,32
1656992054658,MATH 109,A03,093478,Ganzberger; Geoffrey Michael,1,0,34,33
1656992054658,MATH 109,B01,083215,Ganzberger; Geoffrey Michael,1,0,32,31
1656992054658,MATH 109,B02,083216,Ganzberger; Geoffrey Michael,1,0,32,31
1656992054658,MATH 109,B03,093479,Ganzberger; Geoffrey Michael,6,0,32,26
1656992060688,MATH 142A,A01,083219,Chow; Bennett,6,0,32,26
1656992060688,MATH 142A,A02,083220,Chow; Bennett,10,0,32,22
1656992060688,MATH 142A,A03,093480,Chow; Bennett,7,0,32,25
1656992060688,MATH 142A,B03,093481,Chow; Bennett,7,0,32,25
1656992060688,MATH 142A,B04,093558,Chow; Bennett,11,0,32,21
1656992060688,MATH 142A,B05,093559,Chow; Bennett,6,0,32,26
1656992066716,MATH 193A,A01,083224,Rotar; Vladimir,7,0,34,27
1656992066716,MATH 193A,A02,083225,Rotar; Vladimir,4,0,34,30
1656992066716,MATH 193A,A03,083781,Rotar; Vladimir,1,0,34,33
1656992066716,MATH 193A,A04,083782,Rotar; Vladimir,6,0,34,28
1656992066716,MATH 193A,A05,093482,Rotar; Vladimir,6,0,34,28
1656992072740,MATH 197,001,091859,McAuley; Julian John,9999,0,9999,0
1656992072740,MATH 197,002,095566,Kedlaya; Kiran S.,9997,0,9999,2
1656992072740,MATH 197,003,095567,Xiao; Ming,9999,0,9999,0
1656992072740,MATH 197,004,095571,Perols; Johan Lars,9998,0,9999,1
1656992079793,COGS 9,A01,083615,Shannon; Kyle Michael,7,0,75,68
1656992085814,COGS 11,A01,083617,Boyle; Mary E. T.,20,0,48,28
1656992091840,COGS 13,A01,083071,Bastos; Amalia Pinkusfeld,9,0,71,62
1656992097866,COGS 14A,A01,092681,Semenuks; Arturs,0,1,100,100
1656992103890,COGS 14B,A01,083073,Cheng; Tzu-Han,5,0,63,58
1656992109912,COGS 17,A01,092677,Semenuks; Arturs,4,0,81,77
1656992115939,COGS 100,A01,083619,Allen; Michael Gordon,15,0,70,55
1656992121966,COGS 101A,A01,083621,Davis; Joshua Daniel,9,0,68,59
1656992127989,COGS 101B,A01,091572,Allen; Michael Gordon,8,0,65,57
1656992134012,COGS 101C,A01,083625,Delgado; Tania,17,0,35,18
1656992140046,COGS 107A,A01,083627,Boyle; Mary E. T.,13,0,60,47
1656992146068,COGS 118A,A01,083075,Gupta; Anjum,15,0,76,61
1656992152097,CSE 3,A50,083646,Miranda; Gregory Joseph,22,0,50,28
1656992158119,CSE 8A,A50,083650,Miranda; Gregory Joseph,17,1,56,39
1656992164143,CSE 11,A01,083080,Cao; Yingjun,4,15,40,36
1656992170167,CSE 12,A01,083652,Krause-Levy; Sophia Louisa,20,1,120,100
1656992176190,CSE 15L,A01,083654,Morris; Justin Loren,8,0,50,42
1656992176190,CSE 15L,A02,083655,Morris; Justin Loren,8,0,50,42
1656992182218,CSE 20,A01,083657,Tran; Khoa Dang,37,0,80,43
1656992188240,CSE 21,A01,095574,Bach; Quang Tran,21,0,48,27
1656992194264,CSE 30,A01,083084,Eldon; John,4,0,80,76
1656992194264,CSE 30,B01,095061,Bhaskar; Nishant,6,0,50,44
1656992200290,CSE 100,A01,083659,Cao; Yingjun,3,4,70,67
1656992206313,CSE 134B,A01,083661,Powell; Thomas Allan,19,0,100,81
1656992212338,CSE 140,A01,083663,Gungor; Onat,14,0,85,71
1656992218362,CSE 140L,A01,083088,Eldon; John,16,0,100,84
1656992224385,CSE 175,A01,083665,Kumar; Rakesh,3,0,25,22
1656992230411,CSE 190,A00,092507,Dubnov; Shlomo,7,0,20,13
1656992236434,ECE 45,A01,083139,Congero; Spencer William,5,0,75,70
1656992242462,ECE 65,A50,083695,Saad; Andrew S,12,0,30,18
1656992242462,ECE 65,A51,095125,Saad; Andrew S,25,0,26,1
1656992248490,ECE 109,A01,091882,Touri; Behrouz,16,0,70,54
1656992254512,ECE 180,A00,083140,Abi Samra; Nicholas Camill,1,0,30,29
1656992254512,ECE 180,B00,083141,Abi Samra; Nicholas Camill,0,0,30,30
1656992260539,MATH 10A,A01,083735,Patchell; Gregory David,1,0,30,29
1656992260539,MATH 10A,A02,083736,Patchell; Gregory David,20,0,30,10
1656992260539,MATH 10A,A03,083737,Patchell; Gregory David,15,0,30,15
1656992266570,MATH 10B,A01,083207,Lim; Seonhee,7,0,34,27
1656992266570,MATH 10B,A02,083208,Lim; Seonhee,9,0,35,26
1656992266570,MATH 10B,A03,093472,Lim; Seonhee,4,0,34,30
1656992266570,MATH 10B,B01,083739,Sinha; Shubham,9,0,30,21
1656992272601,MATH 18,A01,083743,Cinel; Cameron Alexander,6,0,30,24
1656992272601,MATH 18,A02,083744,Cinel; Cameron Alexander,15,0,30,15
1656992272601,MATH 18,A03,083745,Cinel; Cameron Alexander,8,0,30,22
1656992272601,MATH 18,B01,083748,Rideout; David Porter,4,0,37,33
1656992272601,MATH 18,B02,083749,Rideout; David Porter,3,0,36,33
1656992272601,MATH 18,B03,083750,Rideout; David Porter,2,0,37,35
1656992272601,MATH 18,B04,083751,Rideout; David Porter,5,0,36,31
1656992272601,MATH 18,B05,093473,Rideout; David Porter,4,0,36,32
1656992272601,MATH 18,B06,093474,Rideout; David Porter,5,0,36,31
1656992278623,MATH 20A,A01,083754,Zheng; Zequn,12,0,40,28
1656992284648,MATH 20B,A01,083756,Briones; Jor-el Thomas Caparas,1,0,36,35
1656992284648,MATH 20B,A02,083757,Briones; Jor-el Thomas Caparas,1,0,36,35
1656992284648,MATH 20B,A03,093475,Briones; Jor-el Thomas Caparas,0,0,36,36
1656992290670,MATH 20C,A01,083760,Briones; Jor-el Thomas Caparas,1,0,35,34
1656992290670,MATH 20C,A02,083761,Briones; Jor-el Thomas Caparas,8,0,35,27
1656992290670,MATH 20C,A03,093476,Briones; Jor-el Thomas Caparas,0,1,36,36
1656992290670,MATH 20C,B01,083762,Bach; Quang Tran,0,0,30,30
1656992296693,MATH 20D,A01,083765,Tran; Brian Kha,4,0,30,26
1656992296693,MATH 20D,A02,083766,Tran; Brian Kha,5,0,30,25
1656992296693,MATH 20D,A03,083767,Tran; Brian Kha,3,0,30,27
1656992302721,MATH 20E,A01,083771,Ganguly; Soumya,5,0,32,27
1656992302721,MATH 20E,A02,083772,Ganguly; Soumya,6,0,32,26
1656992302721,MATH 20E,B01,083773,Ciotti; Benjamin,18,0,35,17
1656992302721,MATH 20E,B02,083774,Ciotti; Benjamin,17,0,35,18
1656992308756,MATH 103A,A01,083777,Greenfeld; Be'Eri,2,0,36,34
1656992308756,MATH 103A,A02,083778,Greenfeld; Be'Eri,5,0,36,31
1656992308756,MATH 103A,A03,093561,Greenfeld; Be'Eri,4,0,36,32
1656992308756,MATH 103A,B01,083779,Greenfeld; Be'Eri,6,0,36,30
1656992308756,MATH 103A,B02,083780,Greenfeld; Be'Eri,2,0,36,34
1656992308756,MATH 103A,B03,093562,Greenfeld; Be'Eri,2,0,36,34
1656992314855,MATH 105,A01,085443,Carter; Anne Toulson,14,0,35,21
1656992314855,MATH 105,A02,093477,Carter; Anne Toulson,20,0,35,15
1656992320879,MATH 109,A01,083213,Ganzberger; Geoffrey Michael,2,0,34,32
1656992320879,MATH 109,A02,083214,Ganzberger; Geoffrey Michael,2,0,34,32
1656992320879,MATH 109,A03,093478,Ganzberger; Geoffrey Michael,1,0,34,33
1656992320879,MATH 109,B01,083215,Ganzberger; Geoffrey Michael,1,0,32,31
1656992320879,MATH 109,B02,083216,Ganzberger; Geoffrey Michael,1,0,32,31
1656992320879,MATH 109,B03,093479,Ganzberger; Geoffrey Michael,6,0,32,26
1656992326901,MATH 142A,A01,083219,Chow; Bennett,6,0,32,26
1656992326901,MATH 142A,A02,083220,Chow; Bennett,10,0,32,22
1656992326901,MATH 142A,A03,093480,Chow; Bennett,7,0,32,25
1656992326901,MATH 142A,B03,093481,Chow; Bennett,7,0,32,25
1656992326901,MATH 142A,B04,093558,Chow; Bennett,11,0,32,21
1656992326901,MATH 142A,B05,093559,Chow; Bennett,6,0,32,26
1656992332929,MATH 193A,A01,083224,Rotar; Vladimir,7,0,34,27
1656992332929,MATH 193A,A02,083225,Rotar; Vladimir,4,0,34,30
1656992332929,MATH 193A,A03,083781,Rotar; Vladimir,1,0,34,33
1656992332929,MATH 193A,A04,083782,Rotar; Vladimir,6,0,34,28
1656992332929,MATH 193A,A05,093482,Rotar; Vladimir,6,0,34,28
1656992338957,MATH 197,001,091859,McAuley; Julian John,9999,0,9999,0
1656992338957,MATH 197,002,095566,Kedlaya; Kiran S.,9997,0,9999,2
1656992338957,MATH 197,003,095567,Xiao; Ming,9999,0,9999,0
1656992338957,MATH 197,004,095571,Perols; Johan Lars,9998,0,9999,1
1656992346021,COGS 9,A01,083615,Shannon; Kyle Michael,7,0,75,68
1656992352047,COGS 11,A01,083617,Boyle; Mary E. T.,20,0,48,28
1656992358070,COGS 13,A01,083071,Bastos; Amalia Pinkusfeld,9,0,71,62
1656992364099,COGS 14A,A01,092681,Semenuks; Arturs,0,1,100,100
1656992370123,COGS 14B,A01,083073,Cheng; Tzu-Han,5,0,63,58
1656992376145,COGS 17,A01,092677,Semenuks; Arturs,4,0,81,77
1656992382170,COGS 100,A01,083619,Allen; Michael Gordon,15,0,70,55
1656992388198,COGS 101A,A01,083621,Davis; Joshua Daniel,9,0,68,59
1656992394222,COGS 101B,A01,091572,Allen; Michael Gordon,8,0,65,57
1656992400249,COGS 101C,A01,083625,Delgado; Tania,17,0,35,18
1656992406278,COGS 107A,A01,083627,Boyle; Mary E. T.,13,0,60,47
1656992412301,COGS 118A,A01,083075,Gupta; Anjum,15,0,76,61
1656992418324,CSE 3,A50,083646,Miranda; Gregory Joseph,22,0,50,28
1656992424349,CSE 8A,A50,083650,Miranda; Gregory Joseph,17,1,56,39
1656992430373,CSE 11,A01,083080,Cao; Yingjun,4,15,40,36
1656992436395,CSE 12,A01,083652,Krause-Levy; Sophia Louisa,20,1,120,100
1656992442422,CSE 15L,A01,083654,Morris; Justin Loren,8,0,50,42
1656992442422,CSE 15L,A02,083655,Morris; Justin Loren,8,0,50,42
1656992448449,CSE 20,A01,083657,Tran; Khoa Dang,37,0,80,43
1656992454472,CSE 21,A01,095574,Bach; Quang Tran,21,0,48,27
1656992460506,CSE 30,A01,083084,Eldon; John,4,0,80,76
1656992460506,CSE 30,B01,095061,Bhaskar; Nishant,6,0,50,44
1656992466528,CSE 100,A01,083659,Cao; Yingjun,3,4,70,67
1656992472553,CSE 134B,A01,083661,Powell; Thomas Allan,19,0,100,81
1656992478579,CSE 140,A01,083663,Gungor; Onat,14,0,85,71
1656992484600,CSE 140L,A01,083088,Eldon; John,16,0,100,84
1656992490625,CSE 175,A01,083665,Kumar; Rakesh,3,0,25,22
1656992496653,CSE 190,A00,092507,Dubnov; Shlomo,7,0,20,13
1656992502679,ECE 45,A01,083139,Congero; Spencer William,5,0,75,70
1656992508723,ECE 65,A50,083695,Saad; Andrew S,12,0,30,18
1656992508723,ECE 65,A51,095125,Saad; Andrew S,25,0,26,1
1656992514750,ECE 109,A01,091882,Touri; Behrouz,16,0,70,54
1656992520778,ECE 180,A00,083140,Abi Samra; Nicholas Camill,1,0,30,29
1656992520778,ECE 180,B00,083141,Abi Samra; Nicholas Camill,0,0,30,30
1656992526805,MATH 10A,A01,083735,Patchell; Gregory David,1,0,30,29
1656992526805,MATH 10A,A02,083736,Patchell; Gregory David,20,0,30,10
1656992526805,MATH 10A,A03,083737,Patchell; Gregory David,15,0,30,15
1656992532829,MATH 10B,A01,083207,Lim; Seonhee,7,0,34,27
1656992532829,MATH 10B,A02,083208,Lim; Seonhee,9,0,35,26
1656992532829,MATH 10B,A03,093472,Lim; Seonhee,4,0,34,30
1656992532829,MATH 10B,B01,083739,Sinha; Shubham,9,0,30,21
1656992538861,MATH 18,A01,083743,Cinel; Cameron Alexander,6,0,30,24
1656992538861,MATH 18,A02,083744,Cinel; Cameron Alexander,15,0,30,15
1656992538861,MATH 18,A03,083745,Cinel; Cameron Alexander,8,0,30,22
1656992538861,MATH 18,B01,083748,Rideout; David Porter,4,0,37,33
1656992538861,MATH 18,B02,083749,Rideout; David Porter,3,0,36,33
1656992538861,MATH 18,B03,083750,Rideout; David Porter,2,0,37,35
1656992538861,MATH 18,B04,083751,Rideout; David Porter,5,0,36,31
1656992538861,MATH 18,B05,093473,Rideout; David Porter,4,0,36,32
1656992538861,MATH 18,B06,093474,Rideout; David Porter,5,0,36,31
1656992544883,MATH 20A,A01,083754,Zheng; Zequn,12,0,40,28
1656992550906,MATH 20B,A01,083756,Briones; Jor-el Thomas Caparas,1,0,36,35
1656992550906,MATH 20B,A02,083757,Briones; Jor-el Thomas Caparas,1,0,36,35
1656992550906,MATH 20B,A03,093475,Briones; Jor-el Thomas Caparas,0,0,36,36
1656992556930,MATH 20C,A01,083760,Briones; Jor-el Thomas Caparas,1,0,35,34
1656992556930,MATH 20C,A02,083761,Briones; Jor-el Thomas Caparas,8,0,35,27
1656992556930,MATH 20C,A03,093476,Briones; Jor-el Thomas Caparas,0,1,36,36
1656992556930,MATH 20C,B01,083762,Bach; Quang Tran,0,0,30,30
1656992562960,MATH 20D,A01,083765,Tran; Brian Kha,4,0,30,26
1656992562960,MATH 20D,A02,083766,Tran; Brian Kha,5,0,30,25
1656992562960,MATH 20D,A03,083767,Tran; Brian Kha,3,0,30,27
1656992568983,MATH 20E,A01,083771,Ganguly; Soumya,5,0,32,27
1656992568983,MATH 20E,A02,083772,Ganguly; Soumya,6,0,32,26
1656992568983,MATH 20E,B01,083773,Ciotti; Benjamin,18,0,35,17
1656992568983,MATH 20E,B02,083774,Ciotti; Benjamin,17,0,35,18
1656992575010,MATH 103A,A01,083777,Greenfeld; Be'Eri,2,0,36,34
1656992575010,MATH 103A,A02,083778,Greenfeld; Be'Eri,5,0,36,31
1656992575010,MATH 103A,A03,093561,Greenfeld; Be'Eri,4,0,36,32
1656992575010,MATH 103A,B01,083779,Greenfeld; Be'Eri,6,0,36,30
1656992575010,MATH 103A,B02,083780,Greenfeld; Be'Eri,2,0,36,34
1656992575010,MATH 103A,B03,093562,Greenfeld; Be'Eri,2,0,36,34
1656992581036,MATH 105,A01,085443,Carter; Anne Toulson,14,0,35,21
1656992581036,MATH 105,A02,093477,Carter; Anne Toulson,20,0,35,15
1656992587059,MATH 109,A01,083213,Ganzberger; Geoffrey Michael,2,0,34,32
1656992587059,MATH 109,A02,083214,Ganzberger; Geoffrey Michael,2,0,34,32
1656992587059,MATH 109,A03,093478,Ganzberger; Geoffrey Michael,1,0,34,33
1656992587059,MATH 109,B01,083215,Ganzberger; Geoffrey Michael,1,0,32,31
1656992587059,MATH 109,B02,083216,Ganzberger; Geoffrey Michael,1,0,32,31
1656992587059,MATH 109,B03,093479,Ganzberger; Geoffrey Michael,6,0,32,26
1656992593084,MATH 142A,A01,083219,Chow; Bennett,6,0,32,26
1656992593084,MATH 142A,A02,083220,Chow; Bennett,10,0,32,22
1656992593084,MATH 142A,A03,093480,Chow; Bennett,7,0,32,25
1656992593084,MATH 142A,B03,093481,Chow; Bennett,7,0,32,25
1656992593084,MATH 142A,B04,093558,Chow; Bennett,11,0,32,21
1656992593084,MATH 142A,B05,093559,Chow; Bennett,6,0,32,26
1656992599112,MATH 193A,A01,083224,Rotar; Vladimir,7,0,34,27
1656992599112,MATH 193A,A02,083225,Rotar; Vladimir,4,0,34,30
1656992599112,MATH 193A,A03,083781,Rotar; Vladimir,1,0,34,33
1656992599112,MATH 193A,A04,083782,Rotar; Vladimir,6,0,34,28
1656992599112,MATH 193A,A05,093482,Rotar; Vladimir,6,0,34,28
1656992605140,MATH 197,001,091859,McAuley; Julian John,9999,0,9999,0
1656992605140,MATH 197,002,095566,Kedlaya; Kiran S.,9997,0,9999,2
1656992605140,MATH 197,003,095567,Xiao; Ming,9999,0,9999,0
1656992605140,MATH 197,004,095571,Perols; Johan Lars,9998,0,9999,1
1656992612191,COGS 9,A01,083615,Shannon; Kyle Michael,7,0,75,68
1656992618213,COGS 11,A01,083617,Boyle; Mary E. T.,20,0,48,28
1656992624236,COGS 13,A01,083071,Bastos; Amalia Pinkusfeld,9,0,71,62
1656992630259,COGS 14A,A01,092681,Semenuks; Arturs,0,1,100,100
1656992636283,COGS 14B,A01,083073,Cheng; Tzu-Han,5,0,63,58
1656992642306,COGS 17,A01,092677,Semenuks; Arturs,4,0,81,77
1656992648330,COGS 100,A01,083619,Allen; Michael Gordon,15,0,70,55
1656992654357,COGS 101A,A01,083621,Davis; Joshua Daniel,9,0,68,59
1656992660382,COGS 101B,A01,091572,Allen; Michael Gordon,8,0,65,57
1656992666405,COGS 101C,A01,083625,Delgado; Tania,17,0,35,18
1656992672431,COGS 107A,A01,083627,Boyle; Mary E. T.,13,0,60,47
1656992678454,COGS 118A,A01,083075,Gupta; Anjum,15,0,76,61
1656992684485,CSE 3,A50,083646,Miranda; Gregory Joseph,22,0,50,28
1656992690508,CSE 8A,A50,083650,Miranda; Gregory Joseph,17,1,56,39
1656992696540,CSE 11,A01,083080,Cao; Yingjun,4,15,40,36
1656992702564,CSE 12,A01,083652,Krause-Levy; Sophia Louisa,20,1,120,100
1656992708587,CSE 15L,A01,083654,Morris; Justin Loren,8,0,50,42
1656992708587,CSE 15L,A02,083655,Morris; Justin Loren,8,0,50,42
1656992714615,CSE 20,A01,083657,Tran; Khoa Dang,37,0,80,43
1656992720638,CSE 21,A01,095574,Bach; Quang Tran,21,0,48,27
1656992726661,CSE 30,A01,083084,Eldon; John,4,0,80,76
1656992726661,CSE 30,B01,095061,Bhaskar; Nishant,6,0,50,44
1656992732683,CSE 100,A01,083659,Cao; Yingjun,3,4,70,67
1656992738709,CSE 134B,A01,083661,Powell; Thomas Allan,19,0,100,81
1656992744739,CSE 140,A01,083663,Gungor; Onat,14,0,85,71
1656992750762,CSE 140L,A01,083088,Eldon; John,16,0,100,84
1656992756789,CSE 175,A01,083665,Kumar; Rakesh,3,0,25,22
1656992762822,CSE 190,A00,092507,Dubnov; Shlomo,7,0,20,13
1656992768846,ECE 45,A01,083139,Congero; Spencer William,5,0,75,70
1656992774870,ECE 65,A50,083695,Saad; Andrew S,12,0,30,18
1656992774870,ECE 65,A51,095125,Saad; Andrew S,25,0,26,1
1656992780892,ECE 109,A01,091882,Touri; Behrouz,16,0,70,54
1656992786919,ECE 180,A00,083140,Abi Samra; Nicholas Camill,1,0,30,29
1656992786919,ECE 180,B00,083141,Abi Samra; Nicholas Camill,0,0,30,30
1656992792946,MATH 10A,A01,083735,Patchell; Gregory David,1,0,30,29
1656992792946,MATH 10A,A02,083736,Patchell; Gregory David,20,0,30,10
1656992792946,MATH 10A,A03,083737,Patchell; Gregory David,15,0,30,15
1656992798968,MATH 10B,A01,083207,Lim; Seonhee,7,0,34,27
1656992798968,MATH 10B,A02,083208,Lim; Seonhee,9,0,35,26
1656992798968,MATH 10B,A03,093472,Lim; Seonhee,4,0,34,30
1656992798968,MATH 10B,B01,083739,Sinha; Shubham,9,0,30,21
1656992805001,MATH 18,A01,083743,Cinel; Cameron Alexander,6,0,30,24
1656992805001,MATH 18,A02,083744,Cinel; Cameron Alexander,15,0,30,15
1656992805001,MATH 18,A03,083745,Cinel; Cameron Alexander,8,0,30,22
1656992805001,MATH 18,B01,083748,Rideout; David Porter,4,0,37,33
1656992805001,MATH 18,B02,083749,Rideout; David Porter,3,0,36,33
1656992805001,MATH 18,B03,083750,Rideout; David Porter,2,0,37,35
1656992805001,MATH 18,B04,083751,Rideout; David Porter,5,0,36,31
1656992805001,MATH 18,B05,093473,Rideout; David Porter,4,0,36,32
1656992805001,MATH 18,B06,093474,Rideout; David Porter,5,0,36,31
1656992811025,MATH 20A,A01,083754,Zheng; Zequn,12,0,40,28
1656992817052,MATH 20B,A01,083756,Briones; Jor-el Thomas Caparas,1,0,36,35
1656992817052,MATH 20B,A02,083757,Briones; Jor-el Thomas Caparas,1,0,36,35
1656992817052,MATH 20B,A03,093475,Briones; Jor-el Thomas Caparas,0,0,36,36
1656992823076,MATH 20C,A01,083760,Briones; Jor-el Thomas Caparas,1,0,35,34
1656992823076,MATH 20C,A02,083761,Briones; Jor-el Thomas Caparas,8,0,35,27
1656992823076,MATH 20C,A03,093476,Briones; Jor-el Thomas Caparas,0,1,36,36
1656992823076,MATH 20C,B01,083762,Bach; Quang Tran,0,0,30,30
1656992829103,MATH 20D,A01,083765,Tran; Brian Kha,4,0,30,26
1656992829103,MATH 20D,A02,083766,Tran; Brian Kha,5,0,30,25
1656992829103,MATH 20D,A03,083767,Tran; Brian Kha,3,0,30,27
1656992835138,MATH 20E,A01,083771,Ganguly; Soumya,5,0,32,27
1656992835138,MATH 20E,A02,083772,Ganguly; Soumya,6,0,32,26
1656992835138,MATH 20E,B01,083773,Ciotti; Benjamin,18,0,35,17
1656992835138,MATH 20E,B02,083774,Ciotti; Benjamin,17,0,35,18
1656992841162,MATH 103A,A01,083777,Greenfeld; Be'Eri,2,0,36,34
1656992841162,MATH 103A,A02,083778,Greenfeld; Be'Eri,5,0,36,31
1656992841162,MATH 103A,A03,093561,Greenfeld; Be'Eri,4,0,36,32
1656992841162,MATH 103A,B01,083779,Greenfeld; Be'Eri,6,0,36,30
1656992841162,MATH 103A,B02,083780,Greenfeld; Be'Eri,2,0,36,34
1656992841162,MATH 103A,B03,093562,Greenfeld; Be'Eri,2,0,36,34
1656992847184,MATH 105,A01,085443,Carter; Anne Toulson,14,0,35,21
1656992847184,MATH 105,A02,093477,Carter; Anne Toulson,20,0,35,15
1656992853214,MATH 109,A01,083213,Ganzberger; Geoffrey Michael,2,0,34,32
1656992853214,MATH 109,A02,083214,Ganzberger; Geoffrey Michael,2,0,34,32
1656992853214,MATH 109,A03,093478,Ganzberger; Geoffrey Michael,1,0,34,33
1656992853214,MATH 109,B01,083215,Ganzberger; Geoffrey Michael,1,0,32,31
1656992853214,MATH 109,B02,083216,Ganzberger; Geoffrey Michael,1,0,32,31
1656992853214,MATH 109,B03,093479,Ganzberger; Geoffrey Michael,6,0,32,26
1656992859239,MATH 142A,A01,083219,Chow; Bennett,6,0,32,26
1656992859239,MATH 142A,A02,083220,Chow; Bennett,10,0,32,22
1656992859239,MATH 142A,A03,093480,Chow; Bennett,7,0,32,25
1656992859239,MATH 142A,B03,093481,Chow; Bennett,7,0,32,25
1656992859239,MATH 142A,B04,093558,Chow; Bennett,11,0,32,21
1656992859239,MATH 142A,B05,093559,Chow; Bennett,6,0,32,26
1656992865262,MATH 193A,A01,083224,Rotar; Vladimir,7,0,34,27
1656992865262,MATH 193A,A02,083225,Rotar; Vladimir,4,0,34,30
1656992865262,MATH 193A,A03,083781,Rotar; Vladimir,1,0,34,33
1656992865262,MATH 193A,A04,083782,Rotar; Vladimir,6,0,34,28
1656992865262,MATH 193A,A05,093482,Rotar; Vladimir,6,0,34,28
1656992871290,MATH 197,001,091859,McAuley; Julian John,9999,0,9999,0
1656992871290,MATH 197,002,095566,Kedlaya; Kiran S.,9997,0,9999,2
1656992871290,MATH 197,003,095567,Xiao; Ming,9999,0,9999,0
1656992871290,MATH 197,004,095571,Perols; Johan Lars,9998,0,9999,1
1656992878353,COGS 9,A01,083615,Shannon; Kyle Michael,7,0,75,68
1656992884390,COGS 11,A01,083617,Boyle; Mary E. T.,20,0,48,28
1656992890414,COGS 13,A01,083071,Bastos; Amalia Pinkusfeld,9,0,71,62
1656992896436,COGS 14A,A01,092681,Semenuks; Arturs,0,1,100,100
1656992902464,COGS 14B,A01,083073,Cheng; Tzu-Han,5,0,63,58
1656992908564,COGS 17,A01,092677,Semenuks; Arturs,4,0,81,77
1656992914589,COGS 100,A01,083619,Allen; Michael Gordon,15,0,70,55
1656992920610,COGS 101A,A01,083621,Davis; Joshua Daniel,9,0,68,59
1656992926631,COGS 101B,A01,091572,Allen; Michael Gordon,8,0,65,57
1656992932654,COGS 101C,A01,083625,Delgado; Tania,17,0,35,18
1656992938678,COGS 107A,A01,083627,Boyle; Mary E. T.,13,0,60,47
1656992944701,COGS 118A,A01,083075,Gupta; Anjum,15,0,76,61
1656992950728,CSE 3,A50,083646,Miranda; Gregory Joseph,22,0,50,28
1656992956749,CSE 8A,A50,083650,Miranda; Gregory Joseph,17,1,56,39
1656992962772,CSE 11,A01,083080,Cao; Yingjun,4,15,40,36
1656992968794,CSE 12,A01,083652,Krause-Levy; Sophia Louisa,20,1,120,100
1656992974817,CSE 15L,A01,083654,Morris; Justin Loren,8,0,50,42
1656992974817,CSE 15L,A02,083655,Morris; Justin Loren,8,0,50,42
1656992980843,CSE 20,A01,083657,Tran; Khoa Dang,37,0,80,43
1656992986866,CSE 21,A01,095574,Bach; Quang Tran,21,0,48,27
1656992992893,CSE 30,A01,083084,Eldon; John,4,0,80,76
1656992992893,CSE 30,B01,095061,Bhaskar; Nishant,6,0,50,44
1656992998914,CSE 100,A01,083659,Cao; Yingjun,3,4,70,67
1656993004940,CSE 134B,A01,083661,Powell; Thomas Allan,19,0,100,81
1656993010976,CSE 140,A01,083663,Gungor; Onat,14,0,85,71
1656993017002,CSE 140L,A01,083088,Eldon; John,16,0,100,84
1656993023024,CSE 175,A01,083665,Kumar; Rakesh,3,0,25,22
1656993029046,CSE 190,A00,092507,Dubnov; Shlomo,7,0,20,13
1656993035079,ECE 45,A01,083139,Congero; Spencer William,5,0,75,70
1656993041104,ECE 65,A50,083695,Saad; Andrew S,12,0,30,18
1656993041104,ECE 65,A51,095125,Saad; Andrew S,25,0,26,1
1656993047126,ECE 109,A01,091882,Touri; Behrouz,16,0,70,54
1656993053153,ECE 180,A00,083140,Abi Samra; Nicholas Camill,1,0,30,29
1656993053153,ECE 180,B00,083141,Abi Samra; Nicholas Camill,0,0,30,30
1656993059182,MATH 10A,A01,083735,Patchell; Gregory David,1,0,30,29
1656993059182,MATH 10A,A02,083736,Patchell; Gregory David,20,0,30,10
1656993059182,MATH 10A,A03,083737,Patchell; Gregory David,15,0,30,15
1656993065208,MATH 10B,A01,083207,Lim; Seonhee,7,0,34,27
1656993065208,MATH 10B,A02,083208,Lim; Seonhee,9,0,35,26
1656993065208,MATH 10B,A03,093472,Lim; Seonhee,4,0,34,30
1656993065208,MATH 10B,B01,083739,Sinha; Shubham,9,0,30,21
1656993071232,MATH 18,A01,083743,Cinel; Cameron Alexander,6,0,30,24
1656993071232,MATH 18,A02,083744,Cinel; Cameron Alexander,15,0,30,15
1656993071232,MATH 18,A03,083745,Cinel; Cameron Alexander,8,0,30,22
1656993071232,MATH 18,B01,083748,Rideout; David Porter,4,0,37,33
1656993071232,MATH 18,B02,083749,Rideout; David Porter,3,0,36,33
1656993071232,MATH 18,B03,083750,Rideout; David Porter,2,0,37,35
1656993071232,MATH 18,B04,083751,Rideout; David Porter,5,0,36,31
1656993071232,MATH 18,B05,093473,Rideout; David Porter,4,0,36,32
1656993071232,MATH 18,B06,093474,Rideout; David Porter,5,0,36,31
1656993077256,MATH 20A,A01,083754,Zheng; Zequn,12,0,40,28
1656993083285,MATH 20B,A01,083756,Briones; Jor-el Thomas Caparas,1,0,36,35
1656993083285,MATH 20B,A02,083757,Briones; Jor-el Thomas Caparas,1,0,36,35
1656993083285,MATH 20B,A03,093475,Briones; Jor-el Thomas Caparas,0,0,36,36
1656993089309,MATH 20C,A01,083760,Briones; Jor-el Thomas Caparas,1,0,35,34
1656993089309,MATH 20C,A02,083761,Briones; Jor-el Thomas Caparas,8,0,35,27
1656993089309,MATH 20C,A03,093476,Briones; Jor-el Thomas Caparas,0,1,36,36
1656993089309,MATH 20C,B01,083762,Bach; Quang Tran,0,0,30,30
1656993095335,MATH 20D,A01,083765,Tran; Brian Kha,4,0,30,26
1656993095335,MATH 20D,A02,083766,Tran; Brian Kha,5,0,30,25
1656993095335,MATH 20D,A03,083767,Tran; Brian Kha,3,0,30,27
1656993101364,MATH 20E,A01,083771,Ganguly; Soumya,5,0,32,27
1656993101364,MATH 20E,A02,083772,Ganguly; Soumya,6,0,32,26
1656993101364,MATH 20E,B01,083773,Ciotti; Benjamin,18,0,35,17
1656993101364,MATH 20E,B02,083774,Ciotti; Benjamin,17,0,35,18
1656993107393,MATH 103A,A01,083777,Greenfeld; Be'Eri,2,0,36,34
1656993107393,MATH 103A,A02,083778,Greenfeld; Be'Eri,5,0,36,31
1656993107393,MATH 103A,A03,093561,Greenfeld; Be'Eri,4,0,36,32
1656993107393,MATH 103A,B01,083779,Greenfeld; Be'Eri,6,0,36,30
1656993107393,MATH 103A,B02,083780,Greenfeld; Be'Eri,2,0,36,34
1656993107393,MATH 103A,B03,093562,Greenfeld; Be'Eri,2,0,36,34
1656993113417,MATH 105,A01,085443,Carter; Anne Toulson,14,0,35,21
1656993113417,MATH 105,A02,093477,Carter; Anne Toulson,20,0,35,15
1656993119445,MATH 109,A01,083213,Ganzberger; Geoffrey Michael,2,0,34,32
1656993119445,MATH 109,A02,083214,Ganzberger; Geoffrey Michael,2,0,34,32
1656993119445,MATH 109,A03,093478,Ganzberger; Geoffrey Michael,1,0,34,33
1656993119445,MATH 109,B01,083215,Ganzberger; Geoffrey Michael,1,0,32,31
1656993119445,MATH 109,B02,083216,Ganzberger; Geoffrey Michael,1,0,32,31
1656993119445,MATH 109,B03,093479,Ganzberger; Geoffrey Michael,6,0,32,26
1656993125474,MATH 142A,A01,083219,Chow; Bennett,6,0,32,26
1656993125474,MATH 142A,A02,083220,Chow; Bennett,10,0,32,22
1656993125474,MATH 142A,A03,093480,Chow; Bennett,7,0,32,25
1656993125474,MATH 142A,B03,093481,Chow; Bennett,7,0,32,25
1656993125474,MATH 142A,B04,093558,Chow; Bennett,11,0,32,21
1656993125474,MATH 142A,B05,093559,Chow; Bennett,6,0,32,26
1656993131511,MATH 193A,A01,083224,Rotar; Vladimir,7,0,34,27
1656993131511,MATH 193A,A02,083225,Rotar; Vladimir,4,0,34,30
1656993131511,MATH 193A,A03,083781,Rotar; Vladimir,1,0,34,33
1656993131511,MATH 193A,A04,083782,Rotar; Vladimir,6,0,34,28
1656993131511,MATH 193A,A05,093482,Rotar; Vladimir,6,0,34,28
1656993137539,MATH 197,001,091859,McAuley; Julian John,9999,0,9999,0
1656993137539,MATH 197,002,095566,Kedlaya; Kiran S.,9997,0,9999,2
1656993137539,MATH 197,003,095567,Xiao; Ming,9999,0,9999,0
1656993137539,MATH 197,004,095571,Perols; Johan Lars,9998,0,9999,1
1656993144591,COGS 9,A01,083615,Shannon; Kyle Michael,7,0,75,68
1656993150612,COGS 11,A01,083617,Boyle; Mary E. T.,20,0,48,28
1656993156634,COGS 13,A01,083071,Bastos; Amalia Pinkusfeld,9,0,71,62
1656993162660,COGS 14A,A01,092681,Semenuks; Arturs,0,1,100,100
1656993168683,COGS 14B,A01,083073,Cheng; Tzu-Han,5,0,63,58
1656993174707,COGS 17,A01,092677,Semenuks; Arturs,4,0,81,77
1656993180730,COGS 100,A01,083619,Allen; Michael Gordon,15,0,70,55
1656993186756,COGS 101A,A01,083621,Davis; Joshua Daniel,9,0,68,59
1656993192779,COGS 101B,A01,091572,Allen; Michael Gordon,8,0,65,57
1656993198802,COGS 101C,A01,083625,Delgado; Tania,17,0,35,18
1656993204836,COGS 107A,A01,083627,Boyle; Mary E. T.,13,0,60,47
1656993210859,COGS 118A,A01,083075,Gupta; Anjum,15,0,76,61
1656993216883,CSE 3,A50,083646,Miranda; Gregory Joseph,22,0,50,28
1656993222910,CSE 8A,A50,083650,Miranda; Gregory Joseph,17,1,56,39
1656993228938,CSE 11,A01,083080,Cao; Yingjun,4,15,40,36
1656993234961,CSE 12,A01,083652,Krause-Levy; Sophia Louisa,20,1,120,100
1656993240994,CSE 15L,A01,083654,Morris; Justin Loren,8,0,50,42
1656993240994,CSE 15L,A02,083655,Morris; Justin Loren,8,0,50,42
1656993247017,CSE 20,A01,083657,Tran; Khoa Dang,37,0,80,43
1656993253041,CSE 21,A01,095574,Bach; Quang Tran,21,0,48,27
1656993259065,CSE 30,A01,083084,Eldon; John,4,0,80,76
1656993259065,CSE 30,B01,095061,Bhaskar; Nishant,6,0,50,44
1656993265089,CSE 100,A01,083659,Cao; Yingjun,3,4,70,67
1656993271138,CSE 134B,A01,083661,Powell; Thomas Allan,19,0,100,81
1656993277162,CSE 140,A01,083663,Gungor; Onat,14,0,85,71
1656993283186,CSE 140L,A01,083088,Eldon; John,16,0,100,84
1656993289212,CSE 175,A01,083665,Kumar; Rakesh,3,0,25,22
1656993295236,CSE 190,A00,092507,Dubnov; Shlomo,7,0,20,13
1656993301268,ECE 45,A01,083139,Congero; Spencer William,5,0,75,70
1656993307291,ECE 65,A50,083695,Saad; Andrew S,12,0,30,18
1656993307291,ECE 65,A51,095125,Saad; Andrew S,25,0,26,1
1656993313315,ECE 109,A01,091882,Touri; Behrouz,16,0,70,54
1656993319339,ECE 180,A00,083140,Abi Samra; Nicholas Camill,1,0,30,29
1656993319339,ECE 180,B00,083141,Abi Samra; Nicholas Camill,0,0,30,30
1656993325370,MATH 10A,A01,083735,Patchell; Gregory David,1,0,30,29
1656993325370,MATH 10A,A02,083736,Patchell; Gregory David,20,0,30,10
1656993325370,MATH 10A,A03,083737,Patchell; Gregory David,15,0,30,15
1656993331395,MATH 10B,A01,083207,Lim; Seonhee,7,0,34,27
1656993331395,MATH 10B,A02,083208,Lim; Seonhee,9,0,35,26
1656993331395,MATH 10B,A03,093472,Lim; Seonhee,4,0,34,30
1656993331395,MATH 10B,B01,083739,Sinha; Shubham,9,0,30,21
1656993337420,MATH 18,A01,083743,Cinel; Cameron Alexander,6,0,30,24
1656993337420,MATH 18,A02,083744,Cinel; Cameron Alexander,15,0,30,15
1656993337420,MATH 18,A03,083745,Cinel; Cameron Alexander,8,0,30,22
1656993337420,MATH 18,B01,083748,Rideout; David Porter,4,0,37,33
1656993337420,MATH 18,B02,083749,Rideout; David Porter,3,0,36,33
1656993337420,MATH 18,B03,083750,Rideout; David Porter,2,0,37,35
1656993337420,MATH 18,B04,083751,Rideout; David Porter,5,0,36,31
1656993337420,MATH 18,B05,093473,Rideout; David Porter,4,0,36,32
1656993337420,MATH 18,B06,093474,Rideout; David Porter,5,0,36,31
1656993343448,MATH 20A,A01,083754,Zheng; Zequn,12,0,40,28
1656993349471,MATH 20B,A01,083756,Briones; Jor-el Thomas Caparas,1,0,36,35
1656993349471,MATH 20B,A02,083757,Briones; Jor-el Thomas Caparas,1,0,36,35
1656993349471,MATH 20B,A03,093475,Briones; Jor-el Thomas Caparas,0,0,36,36
1656993355495,MATH 20C,A01,083760,Briones; Jor-el Thomas Caparas,1,0,35,34
1656993355495,MATH 20C,A02,083761,Briones; Jor-el Thomas Caparas,8,0,35,27
1656993355495,MATH 20C,A03,093476,Briones; Jor-el Thomas Caparas,0,1,36,36
1656993355495,MATH 20C,B01,083762,Bach; Quang Tran,0,0,30,30
1656993361529,MATH 20D,A01,083765,Tran; Brian Kha,4,0,30,26
1656993361529,MATH 20D,A02,083766,Tran; Brian Kha,5,0,30,25
1656993361529,MATH 20D,A03,083767,Tran; Brian Kha,3,0,30,27
1656993367554,MATH 20E,A01,083771,Ganguly; Soumya,5,0,32,27
1656993367554,MATH 20E,A02,083772,Ganguly; Soumya,6,0,32,26
1656993367554,MATH 20E,B01,083773,Ciotti; Benjamin,18,0,35,17
1656993367554,MATH 20E,B02,083774,Ciotti; Benjamin,17,0,35,18
1656993373581,MATH 103A,A01,083777,Greenfeld; Be'Eri,2,0,36,34
1656993373581,MATH 103A,A02,083778,Greenfeld; Be'Eri,5,0,36,31
1656993373581,MATH 103A,A03,093561,Greenfeld; Be'Eri,4,0,36,32
1656993373581,MATH 103A,B01,083779,Greenfeld; Be'Eri,6,0,36,30
1656993373581,MATH 103A,B02,083780,Greenfeld; Be'Eri,2,0,36,34
1656993373581,MATH 103A,B03,093562,Greenfeld; Be'Eri,2,0,36,34
1656993379609,MATH 105,A01,085443,Carter; Anne Toulson,14,0,35,21
1656993379609,MATH 105,A02,093477,Carter; Anne Toulson,20,0,35,15
1656993385634,MATH 109,A01,083213,Ganzberger; Geoffrey Michael,2,0,34,32
1656993385634,MATH 109,A02,083214,Ganzberger; Geoffrey Michael,2,0,34,32
1656993385634,MATH 109,A03,093478,Ganzberger; Geoffrey Michael,1,0,34,33
1656993385634,MATH 109,B01,083215,Ganzberger; Geoffrey Michael,1,0,32,31
1656993385634,MATH 109,B02,083216,Ganzberger; Geoffrey Michael,1,0,32,31
1656993385634,MATH 109,B03,093479,Ganzberger; Geoffrey Michael,6,0,32,26
1656993391658,MATH 142A,A01,083219,Chow; Bennett,6,0,32,26
1656993391658,MATH 142A,A02,083220,Chow; Bennett,10,0,32,22
1656993391658,MATH 142A,A03,093480,Chow; Bennett,7,0,32,25
1656993391658,MATH 142A,B03,093481,Chow; Bennett,7,0,32,25
1656993391658,MATH 142A,B04,093558,Chow; Bennett,11,0,32,21
1656993391658,MATH 142A,B05,093559,Chow; Bennett,6,0,32,26
1656993397686,MATH 193A,A01,083224,Rotar; Vladimir,7,0,34,27
1656993397686,MATH 193A,A02,083225,Rotar; Vladimir,4,0,34,30
1656993397686,MATH 193A,A03,083781,Rotar; Vladimir,1,0,34,33
1656993397686,MATH 193A,A04,083782,Rotar; Vladimir,6,0,34,28
1656993397686,MATH 193A,A05,093482,Rotar; Vladimir,6,0,34,28
1656993403707,MATH 197,001,091859,McAuley; Julian John,9999,0,9999,0
1656993403707,MATH 197,002,095566,Kedlaya; Kiran S.,9997,0,9999,2
1656993403707,MATH 197,003,095567,Xiao; Ming,9999,0,9999,0
1656993403707,MATH 197,004,095571,Perols; Johan Lars,9998,0,9999,1
1656993410771,COGS 9,A01,083615,Shannon; Kyle Michael,7,0,75,68
1656993416798,COGS 11,A01,083617,Boyle; Mary E. T.,20,0,48,28
1656993422824,COGS 13,A01,083071,Bastos; Amalia Pinkusfeld,9,0,71,62
1656993428847,COGS 14A,A01,092681,Semenuks; Arturs,0,1,100,100
1656993434879,COGS 14B,A01,083073,Cheng; Tzu-Han,5,0,63,58
1656993440907,COGS 17,A01,092677,Semenuks; Arturs,4,0,81,77
1656993446930,COGS 100,A01,083619,Allen; Michael Gordon,15,0,70,55
1656993452956,COGS 101A,A01,083621,Davis; Joshua Daniel,9,0,68,59
1656993458984,COGS 101B,A01,091572,Allen; Michael Gordon,8,0,65,57
1656993465006,COGS 101C,A01,083625,Delgado; Tania,17,0,35,18
1656993471029,COGS 107A,A01,083627,Boyle; Mary E. T.,13,0,60,47
1656993477053,COGS 118A,A01,083075,Gupta; Anjum,15,0,76,61
1656993483076,CSE 3,A50,083646,Miranda; Gregory Joseph,22,0,50,28
1656993489103,CSE 8A,A50,083650,Miranda; Gregory Joseph,17,1,56,39
1656993495127,CSE 11,A01,083080,Cao; Yingjun,4,15,40,36
1656993501152,CSE 12,A01,083652,Krause-Levy; Sophia Louisa,20,1,120,100
1656993507262,CSE 15L,A01,083654,Morris; Justin Loren,8,0,50,42
1656993507262,CSE 15L,A02,083655,Morris; Justin Loren,8,0,50,42
1656993513296,CSE 20,A01,083657,Tran; Khoa Dang,37,0,80,43
1656993519322,CSE 21,A01,095574,Bach; Quang Tran,21,0,48,27
1656993525345,CSE 30,A01,083084,Eldon; John,4,0,80,76
1656993525345,CSE 30,B01,095061,Bhaskar; Nishant,6,0,50,44
1656993531380,CSE 100,A01,083659,Cao; Yingjun,3,4,70,67
1656993537404,CSE 134B,A01,083661,Powell; Thomas Allan,19,0,100,81
1656993543431,CSE 140,A01,083663,Gungor; Onat,14,0,85,71
1656993549456,CSE 140L,A01,083088,Eldon; John,16,0,100,84
1656993555482,CSE 175,A01,083665,Kumar; Rakesh,3,0,25,22
1656993561506,CSE 190,A00,092507,Dubnov; Shlomo,7,0,20,13
1656993567533,ECE 45,A01,083139,Congero; Spencer William,5,0,75,70
1656993573571,ECE 65,A50,083695,Saad; Andrew S,12,0,30,18
1656993573571,ECE 65,A51,095125,Saad; Andrew S,25,0,26,1
1656993579598,ECE 109,A01,091882,Touri; Behrouz,16,0,70,54
1656993585629,ECE 180,A00,083140,Abi Samra; Nicholas Camill,1,0,30,29
1656993585629,ECE 180,B00,083141,Abi Samra; Nicholas Camill,0,0,30,30
1656993591664,MATH 10A,A01,083735,Patchell; Gregory David,1,0,30,29
1656993591664,MATH 10A,A02,083736,Patchell; Gregory David,20,0,30,10
1656993591664,MATH 10A,A03,083737,Patchell; Gregory David,15,0,30,15
1656993597688,MATH 10B,A01,083207,Lim; Seonhee,7,0,34,27
1656993597688,MATH 10B,A02,083208,Lim; Seonhee,9,0,35,26
1656993597688,MATH 10B,A03,093472,Lim; Seonhee,4,0,34,30
1656993597688,MATH 10B,B01,083739,Sinha; Shubham,9,0,30,21
1656993603713,MATH 18,A01,083743,Cinel; Cameron Alexander,6,0,30,24
1656993603713,MATH 18,A02,083744,Cinel; Cameron Alexander,15,0,30,15
1656993603713,MATH 18,A03,083745,Cinel; Cameron Alexander,8,0,30,22
1656993603713,MATH 18,B01,083748,Rideout; David Porter,4,0,37,33
1656993603713,MATH 18,B02,083749,Rideout; David Porter,3,0,36,33
1656993603713,MATH 18,B03,083750,Rideout; David Porter,2,0,37,35
1656993603713,MATH 18,B04,083751,Rideout; David Porter,5,0,36,31
1656993603713,MATH 18,B05,093473,Rideout; David Porter,4,0,36,32
1656993603713,MATH 18,B06,093474,Rideout; David Porter,5,0,36,31
1656993609739,MATH 20A,A01,083754,Zheng; Zequn,12,0,40,28
1656993615767,MATH 20B,A01,083756,Briones; Jor-el Thomas Caparas,1,0,36,35
1656993615767,MATH 20B,A02,083757,Briones; Jor-el Thomas Caparas,1,0,36,35
1656993615767,MATH 20B,A03,093475,Briones; Jor-el Thomas Caparas,0,0,36,36
1656993621795,MATH 20C,A01,083760,Briones; Jor-el Thomas Caparas,1,0,35,34
1656993621795,MATH 20C,A02,083761,Briones; Jor-el Thomas Caparas,8,0,35,27
1656993621795,MATH 20C,A03,093476,Briones; Jor-el Thomas Caparas,0,1,36,36
1656993621795,MATH 20C,B01,083762,Bach; Quang Tran,0,0,30,30
1656993627833,MATH 20D,A01,083765,Tran; Brian Kha,4,0,30,26
1656993627833,MATH 20D,A02,083766,Tran; Brian Kha,5,0,30,25
1656993627833,MATH 20D,A03,083767,Tran; Brian Kha,3,0,30,27
1656993633867,MATH 20E,A01,083771,Ganguly; Soumya,5,0,32,27
1656993633867,MATH 20E,A02,083772,Ganguly; Soumya,6,0,32,26
1656993633867,MATH 20E,B01,083773,Ciotti; Benjamin,18,0,35,17
1656993633867,MATH 20E,B02,083774,Ciotti; Benjamin,17,0,35,18
1656993639914,MATH 103A,A01,083777,Greenfeld; Be'Eri,2,0,36,34
1656993639914,MATH 103A,A02,083778,Greenfeld; Be'Eri,5,0,36,31
1656993639914,MATH 103A,A03,093561,Greenfeld; Be'Eri,4,0,36,32
1656993639914,MATH 103A,B01,083779,Greenfeld; Be'Eri,6,0,36,30
1656993639914,MATH 103A,B02,083780,Greenfeld; Be'Eri,2,0,36,34
1656993639914,MATH 103A,B03,093562,Greenfeld; Be'Eri,2,0,36,34
1656993645936,MATH 105,A01,085443,Carter; Anne Toulson,14,0,35,21
1656993645936,MATH 105,A02,093477,Carter; Anne Toulson,20,0,35,15
1656993651965,MATH 109,A01,083213,Ganzberger; Geoffrey Michael,2,0,34,32
1656993651965,MATH 109,A02,083214,Ganzberger; Geoffrey Michael,2,0,34,32
1656993651965,MATH 109,A03,093478,Ganzberger; Geoffrey Michael,1,0,34,33
1656993651965,MATH 109,B01,083215,Ganzberger; Geoffrey Michael,1,0,32,31
1656993651965,MATH 109,B02,083216,Ganzberger; Geoffrey Michael,1,0,32,31
1656993651965,MATH 109,B03,093479,Ganzberger; Geoffrey Michael,6,0,32,26
1656993657992,MATH 142A,A01,083219,Chow; Bennett,6,0,32,26
1656993657992,MATH 142A,A02,083220,Chow; Bennett,10,0,32,22
1656993657992,MATH 142A,A03,093480,Chow; Bennett,7,0,32,25
1656993657992,MATH 142A,B03,093481,Chow; Bennett,7,0,32,25
1656993657992,MATH 142A,B04,093558,Chow; Bennett,11,0,32,21
1656993657992,MATH 142A,B05,093559,Chow; Bennett,6,0,32,26
1656993664014,MATH 193A,A01,083224,Rotar; Vladimir,7,0,34,27
1656993664014,MATH 193A,A02,083225,Rotar; Vladimir,4,0,34,30
1656993664014,MATH 193A,A03,083781,Rotar; Vladimir,1,0,34,33
1656993664014,MATH 193A,A04,083782,Rotar; Vladimir,6,0,34,28
1656993664014,MATH 193A,A05,093482,Rotar; Vladimir,6,0,34,28
1656993670041,MATH 197,001,091859,McAuley; Julian John,9999,0,9999,0
1656993670041,MATH 197,002,095566,Kedlaya; Kiran S.,9997,0,9999,2
1656993670041,MATH 197,003,095567,Xiao; Ming,9999,0,9999,0
1656993670041,MATH 197,004,095571,Perols; Johan Lars,9998,0,9999,1
1656993677099,COGS 9,A01,083615,Shannon; Kyle Michael,7,0,75,68
1656993683128,COGS 11,A01,083617,Boyle; Mary E. T.,20,0,48,28
1656993689150,COGS 13,A01,083071,Bastos; Amalia Pinkusfeld,9,0,71,62
1656993695173,COGS 14A,A01,092681,Semenuks; Arturs,0,1,100,100
1656993701200,COGS 14B,A01,083073,Cheng; Tzu-Han,5,0,63,58
1656993707226,COGS 17,A01,092677,Semenuks; Arturs,4,0,81,77
1656993713248,COGS 100,A01,083619,Allen; Michael Gordon,15,0,70,55
1656993719272,COGS 101A,A01,083621,Davis; Joshua Daniel,9,0,68,59
1656993725301,COGS 101B,A01,091572,Allen; Michael Gordon,8,0,65,57
1656993731324,COGS 101C,A01,083625,Delgado; Tania,17,0,35,18
1656993737351,COGS 107A,A01,083627,Boyle; Mary E. T.,13,0,60,47
1656993743383,COGS 118A,A01,083075,Gupta; Anjum,15,0,76,61
1656993749415,CSE 3,A50,083646,Miranda; Gregory Joseph,22,0,50,28
1656993755442,CSE 8A,A50,083650,Miranda; Gregory Joseph,17,1,56,39
1656993761464,CSE 11,A01,083080,Cao; Yingjun,4,15,40,36
1656993767490,CSE 12,A01,083652,Krause-Levy; Sophia Louisa,20,1,120,100
1656993773516,CSE 15L,A01,083654,Morris; Justin Loren,8,0,50,42
1656993773516,CSE 15L,A02,083655,Morris; Justin Loren,8,0,50,42
1656993779543,CSE 20,A01,083657,Tran; Khoa Dang,37,0,80,43
1656993785565,CSE 21,A01,095574,Bach; Quang Tran,21,0,48,27
1656993791595,CSE 30,A01,083084,Eldon; John,4,0,80,76
1656993791595,CSE 30,B01,095061,Bhaskar; Nishant,6,0,50,44
1656993797620,CSE 100,A01,083659,Cao; Yingjun,3,4,70,67
1656993803647,CSE 134B,A01,083661,Powell; Thomas Allan,19,0,100,81
1656993809677,CSE 140,A01,083663,Gungor; Onat,14,0,85,71
1656993815702,CSE 140L,A01,083088,Eldon; John,16,0,100,84
1656993821729,CSE 175,A01,083665,Kumar; Rakesh,3,0,25,22
1656993827756,CSE 190,A00,092507,Dubnov; Shlomo,7,0,20,13
1656993833780,ECE 45,A01,083139,Congero; Spencer William,5,0,75,70
1656993839804,ECE 65,A50,083695,Saad; Andrew S,12,0,30,18
1656993839804,ECE 65,A51,095125,Saad; Andrew S,25,0,26,1
1656993845827,ECE 109,A01,091882,Touri; Behrouz,16,0,70,54
1656993851865,ECE 180,A00,083140,Abi Samra; Nicholas Camill,1,0,30,29
1656993851865,ECE 180,B00,083141,Abi Samra; Nicholas Camill,0,0,30,30
1656993857889,MATH 10A,A01,083735,Patchell; Gregory David,1,0,30,29
1656993857889,MATH 10A,A02,083736,Patchell; Gregory David,20,0,30,10
1656993857889,MATH 10A,A03,083737,Patchell; Gregory David,15,0,30,15
1656993863917,MATH 10B,A01,083207,Lim; Seonhee,7,0,34,27
1656993863917,MATH 10B,A02,083208,Lim; Seonhee,9,0,35,26
1656993863917,MATH 10B,A03,093472,Lim; Seonhee,4,0,34,30
1656993863917,MATH 10B,B01,083739,Sinha; Shubham,9,0,30,21
1656993869961,MATH 18,A01,083743,Cinel; Cameron Alexander,6,0,30,24
1656993869961,MATH 18,A02,083744,Cinel; Cameron Alexander,15,0,30,15
1656993869961,MATH 18,A03,083745,Cinel; Cameron Alexander,8,0,30,22
1656993869961,MATH 18,B01,083748,Rideout; David Porter,4,0,37,33
1656993869961,MATH 18,B02,083749,Rideout; David Porter,3,0,36,33
1656993869961,MATH 18,B03,083750,Rideout; David Porter,2,0,37,35
1656993869961,MATH 18,B04,083751,Rideout; David Porter,5,0,36,31
1656993869961,MATH 18,B05,093473,Rideout; David Porter,4,0,36,32
1656993869961,MATH 18,B06,093474,Rideout; David Porter,5,0,36,31
1656993875986,MATH 20A,A01,083754,Zheng; Zequn,12,0,40,28
1656993882009,MATH 20B,A01,083756,Briones; Jor-el Thomas Caparas,1,0,36,35
1656993882009,MATH 20B,A02,083757,Briones; Jor-el Thomas Caparas,1,0,36,35
1656993882009,MATH 20B,A03,093475,Briones; Jor-el Thomas Caparas,0,0,36,36
1656993888032,MATH 20C,A01,083760,Briones; Jor-el Thomas Caparas,1,0,35,34
1656993888032,MATH 20C,A02,083761,Briones; Jor-el Thomas Caparas,8,0,35,27
1656993888032,MATH 20C,A03,093476,Briones; Jor-el Thomas Caparas,0,1,36,36
1656993888032,MATH 20C,B01,083762,Bach; Quang Tran,0,0,30,30
1656993894057,MATH 20D,A01,083765,Tran; Brian Kha,4,0,30,26
1656993894057,MATH 20D,A02,083766,Tran; Brian Kha,5,0,30,25
1656993894057,MATH 20D,A03,083767,Tran; Brian Kha,3,0,30,27
1656993900089,MATH 20E,A01,083771,Ganguly; Soumya,5,0,32,27
1656993900089,MATH 20E,A02,083772,Ganguly; Soumya,6,0,32,26
1656993900089,MATH 20E,B01,083773,Ciotti; Benjamin,18,0,35,17
1656993900089,MATH 20E,B02,083774,Ciotti; Benjamin,17,0,35,18
1656993906111,MATH 103A,A01,083777,Greenfeld; Be'Eri,2,0,36,34
1656993906111,MATH 103A,A02,083778,Greenfeld; Be'Eri,5,0,36,31
1656993906111,MATH 103A,A03,093561,Greenfeld; Be'Eri,4,0,36,32
1656993906111,MATH 103A,B01,083779,Greenfeld; Be'Eri,6,0,36,30
1656993906111,MATH 103A,B02,083780,Greenfeld; Be'Eri,2,0,36,34
1656993906111,MATH 103A,B03,093562,Greenfeld; Be'Eri,2,0,36,34
1656993912135,MATH 105,A01,085443,Carter; Anne Toulson,14,0,35,21
1656993912135,MATH 105,A02,093477,Carter; Anne Toulson,20,0,35,15
1656993918160,MATH 109,A01,083213,Ganzberger; Geoffrey Michael,2,0,34,32
1656993918160,MATH 109,A02,083214,Ganzberger; Geoffrey Michael,2,0,34,32
1656993918160,MATH 109,A03,093478,Ganzberger; Geoffrey Michael,1,0,34,33
1656993918160,MATH 109,B01,083215,Ganzberger; Geoffrey Michael,1,0,32,31
1656993918160,MATH 109,B02,083216,Ganzberger; Geoffrey Michael,1,0,32,31
1656993918160,MATH 109,B03,093479,Ganzberger; Geoffrey Michael,6,0,32,26
1656993924189,MATH 142A,A01,083219,Chow; Bennett,6,0,32,26
1656993924189,MATH 142A,A02,083220,Chow; Bennett,10,0,32,22
1656993924189,MATH 142A,A03,093480,Chow; Bennett,7,0,32,25
1656993924189,MATH 142A,B03,093481,Chow; Bennett,7,0,32,25
1656993924189,MATH 142A,B04,093558,Chow; Bennett,11,0,32,21
1656993924189,MATH 142A,B05,093559,Chow; Bennett,6,0,32,26
1656993930225,MATH 193A,A01,083224,Rotar; Vladimir,7,0,34,27
1656993930225,MATH 193A,A02,083225,Rotar; Vladimir,4,0,34,30
1656993930225,MATH 193A,A03,083781,Rotar; Vladimir,1,0,34,33
1656993930225,MATH 193A,A04,083782,Rotar; Vladimir,6,0,34,28
1656993930225,MATH 193A,A05,093482,Rotar; Vladimir,6,0,34,28
1656993936249,MATH 197,001,091859,McAuley; Julian John,9999,0,9999,0
1656993936249,MATH 197,002,095566,Kedlaya; Kiran S.,9997,0,9999,2
1656993936249,MATH 197,003,095567,Xiao; Ming,9999,0,9999,0
1656993936249,MATH 197,004,095571,Perols; Johan Lars,9998,0,9999,1
1656993943306,COGS 9,A01,083615,Shannon; Kyle Michael,7,0,75,68
1656993949330,COGS 11,A01,083617,Boyle; Mary E. T.,20,0,48,28
1656993955354,COGS 13,A01,083071,Bastos; Amalia Pinkusfeld,9,0,71,62
1656993961381,COGS 14A,A01,092681,Semenuks; Arturs,0,1,100,100
1656993967408,COGS 14B,A01,083073,Cheng; Tzu-Han,5,0,63,58
1656993973431,COGS 17,A01,092677,Semenuks; Arturs,4,0,81,77
1656993979460,COGS 100,A01,083619,Allen; Michael Gordon,15,0,70,55
1656993985484,COGS 101A,A01,083621,Davis; Joshua Daniel,9,0,68,59
1656993991507,COGS 101B,A01,091572,Allen; Michael Gordon,8,0,65,57
1656993997529,COGS 101C,A01,083625,Delgado; Tania,17,0,35,18
1656994003555,COGS 107A,A01,083627,Boyle; Mary E. T.,13,0,60,47
1656994009577,COGS 118A,A01,083075,Gupta; Anjum,15,0,76,61
1656994015618,CSE 3,A50,083646,Miranda; Gregory Joseph,22,0,50,28
1656994021658,CSE 8A,A50,083650,Miranda; Gregory Joseph,17,1,56,39
1656994027688,CSE 11,A01,083080,Cao; Yingjun,4,15,40,36
1656994033710,CSE 12,A01,083652,Krause-Levy; Sophia Louisa,20,1,120,100
1656994039733,CSE 15L,A01,083654,Morris; Justin Loren,8,0,50,42
1656994039733,CSE 15L,A02,083655,Morris; Justin Loren,8,0,50,42
1656994045770,CSE 20,A01,083657,Tran; Khoa Dang,37,0,80,43
1656994051793,CSE 21,A01,095574,Bach; Quang Tran,21,0,48,27
1656994057818,CSE 30,A01,083084,Eldon; John,4,0,80,76
1656994057818,CSE 30,B01,095061,Bhaskar; Nishant,6,0,50,44
1656994063846,CSE 100,A01,083659,Cao; Yingjun,3,4,70,67
1656994069870,CSE 134B,A01,083661,Powell; Thomas Allan,19,0,100,81
1656994075895,CSE 140,A01,083663,Gungor; Onat,14,0,85,71
1656994081918,CSE 140L,A01,083088,Eldon; John,16,0,100,84
1656994087940,CSE 175,A01,083665,Kumar; Rakesh,3,0,25,22
1656994093969,CSE 190,A00,092507,Dubnov; Shlomo,7,0,20,13
1656994099991,ECE 45,A01,083139,Congero; Spencer William,5,0,75,70
1656994106091,ECE 65,A50,083695,Saad; Andrew S,12,0,30,18
1656994106091,ECE 65,A51,095125,Saad; Andrew S,25,0,26,1
1656994112113,ECE 109,A01,091882,Touri; Behrouz,16,0,70,54
1656994118139,ECE 180,A00,083140,Abi Samra; Nicholas Camill,1,0,30,29
1656994118139,ECE 180,B00,083141,Abi Samra; Nicholas Camill,0,0,30,30
1656994124163,MATH 10A,A01,083735,Patchell; Gregory David,1,0,30,29
1656994124163,MATH 10A,A02,083736,Patchell; Gregory David,20,0,30,10
1656994124163,MATH 10A,A03,083737,Patchell; Gregory David,15,0,30,15
1656994130193,MATH 10B,A01,083207,Lim; Seonhee,7,0,34,27
1656994130193,MATH 10B,A02,083208,Lim; Seonhee,9,0,35,26
1656994130193,MATH 10B,A03,093472,Lim; Seonhee,4,0,34,30
1656994130193,MATH 10B,B01,083739,Sinha; Shubham,9,0,30,21
1656994136225,MATH 18,A01,083743,Cinel; Cameron Alexander,6,0,30,24
1656994136225,MATH 18,A02,083744,Cinel; Cameron Alexander,15,0,30,15
1656994136225,MATH 18,A03,083745,Cinel; Cameron Alexander,8,0,30,22
1656994136225,MATH 18,B01,083748,Rideout; David Porter,4,0,37,33
1656994136225,MATH 18,B02,083749,Rideout; David Porter,3,0,36,33
1656994136225,MATH 18,B03,083750,Rideout; David Porter,2,0,37,35
1656994136225,MATH 18,B04,083751,Rideout; David Porter,5,0,36,31
1656994136225,MATH 18,B05,093473,Rideout; David Porter,4,0,36,32
1656994136225,MATH 18,B06,093474,Rideout; David Porter,5,0,36,31
1656994142253,MATH 20A,A01,083754,Zheng; Zequn,12,0,40,28
1656994148276,MATH 20B,A01,083756,Briones; Jor-el Thomas Caparas,1,0,36,35
1656994148276,MATH 20B,A02,083757,Briones; Jor-el Thomas Caparas,1,0,36,35
1656994148276,MATH 20B,A03,093475,Briones; Jor-el Thomas Caparas,0,0,36,36
1656994154305,MATH 20C,A01,083760,Briones; Jor-el Thomas Caparas,1,0,35,34
1656994154305,MATH 20C,A02,083761,Briones; Jor-el Thomas Caparas,8,0,35,27
1656994154305,MATH 20C,A03,093476,Briones; Jor-el Thomas Caparas,0,1,36,36
1656994154305,MATH 20C,B01,083762,Bach; Quang Tran,0,0,30,30
1656994160332,MATH 20D,A01,083765,Tran; Brian Kha,4,0,30,26
1656994160332,MATH 20D,A02,083766,Tran; Brian Kha,5,0,30,25
1656994160332,MATH 20D,A03,083767,Tran; Brian Kha,3,0,30,27
1656994166359,MATH 20E,A01,083771,Ganguly; Soumya,5,0,32,27
1656994166359,MATH 20E,A02,083772,Ganguly; Soumya,6,0,32,26
1656994166359,MATH 20E,B01,083773,Ciotti; Benjamin,18,0,35,17
1656994166359,MATH 20E,B02,083774,Ciotti; Benjamin,17,0,35,18
1656994172389,MATH 103A,A01,083777,Greenfeld; Be'Eri,2,0,36,34
1656994172389,MATH 103A,A02,083778,Greenfeld; Be'Eri,5,0,36,31
1656994172389,MATH 103A,A03,093561,Greenfeld; Be'Eri,4,0,36,32
1656994172389,MATH 103A,B01,083779,Greenfeld; Be'Eri,6,0,36,30
1656994172389,MATH 103A,B02,083780,Greenfeld; Be'Eri,2,0,36,34
1656994172389,MATH 103A,B03,093562,Greenfeld; Be'Eri,2,0,36,34
1656994178412,MATH 105,A01,085443,Carter; Anne Toulson,14,0,35,21
1656994178412,MATH 105,A02,093477,Carter; Anne Toulson,20,0,35,15
1656994184435,MATH 109,A01,083213,Ganzberger; Geoffrey Michael,2,0,34,32
1656994184435,MATH 109,A02,083214,Ganzberger; Geoffrey Michael,2,0,34,32
1656994184435,MATH 109,A03,093478,Ganzberger; Geoffrey Michael,1,0,34,33
1656994184435,MATH 109,B01,083215,Ganzberger; Geoffrey Michael,1,0,32,31
1656994184435,MATH 109,B02,083216,Ganzberger; Geoffrey Michael,1,0,32,31
1656994184435,MATH 109,B03,093479,Ganzberger; Geoffrey Michael,6,0,32,26
1656994190463,MATH 142A,A01,083219,Chow; Bennett,6,0,32,26
1656994190463,MATH 142A,A02,083220,Chow; Bennett,10,0,32,22
1656994190463,MATH 142A,A03,093480,Chow; Bennett,7,0,32,25
1656994190463,MATH 142A,B03,093481,Chow; Bennett,7,0,32,25
1656994190463,MATH 142A,B04,093558,Chow; Bennett,11,0,32,21
1656994190463,MATH 142A,B05,093559,Chow; Bennett,6,0,32,26
1656994196490,MATH 193A,A01,083224,Rotar; Vladimir,7,0,34,27
1656994196490,MATH 193A,A02,083225,Rotar; Vladimir,4,0,34,30
1656994196490,MATH 193A,A03,083781,Rotar; Vladimir,1,0,34,33
1656994196490,MATH 193A,A04,083782,Rotar; Vladimir,6,0,34,28
1656994196490,MATH 193A,A05,093482,Rotar; Vladimir,6,0,34,28
1656994202522,MATH 197,001,091859,McAuley; Julian John,9999,0,9999,0
1656994202522,MATH 197,002,095566,Kedlaya; Kiran S.,9997,0,9999,2
1656994202522,MATH 197,003,095567,Xiao; Ming,9999,0,9999,0
1656994202522,MATH 197,004,095571,Perols; Johan Lars,9998,0,9999,1
1656994209571,COGS 9,A01,083615,Shannon; Kyle Michael,7,0,75,68
1656994215605,COGS 11,A01,083617,Boyle; Mary E. T.,20,0,48,28
1656994221631,COGS 13,A01,083071,Bastos; Amalia Pinkusfeld,9,0,71,62
1656994227655,COGS 14A,A01,092681,Semenuks; Arturs,0,1,100,100
1656994233681,COGS 14B,A01,083073,Cheng; Tzu-Han,5,0,63,58
1656994239705,COGS 17,A01,092677,Semenuks; Arturs,4,0,81,77
1656994245733,COGS 100,A01,083619,Allen; Michael Gordon,15,0,70,55
1656994251756,COGS 101A,A01,083621,Davis; Joshua Daniel,9,0,68,59
1656994257783,COGS 101B,A01,091572,Allen; Michael Gordon,8,0,65,57
1656994263815,COGS 101C,A01,083625,Delgado; Tania,17,0,35,18
1656994269839,COGS 107A,A01,083627,Boyle; Mary E. T.,13,0,60,47
1656994275861,COGS 118A,A01,083075,Gupta; Anjum,15,0,76,61
1656994281888,CSE 3,A50,083646,Miranda; Gregory Joseph,22,0,50,28
1656994287911,CSE 8A,A50,083650,Miranda; Gregory Joseph,17,1,56,39
1656994293937,CSE 11,A01,083080,Cao; Yingjun,4,15,40,36
1656994299961,CSE 12,A01,083652,Krause-Levy; Sophia Louisa,20,1,120,100
1656994305987,CSE 15L,A01,083654,Morris; Justin Loren,8,0,50,42
1656994305987,CSE 15L,A02,083655,Morris; Justin Loren,8,0,50,42
1656994312008,CSE 20,A01,083657,Tran; Khoa Dang,37,0,80,43
1656994318035,CSE 21,A01,095574,Bach; Quang Tran,21,0,48,27
1656994324063,CSE 30,A01,083084,Eldon; John,4,0,80,76
1656994324063,CSE 30,B01,095061,Bhaskar; Nishant,6,0,50,44
1656994330088,CSE 100,A01,083659,Cao; Yingjun,3,4,70,67
1656994336120,CSE 134B,A01,083661,Powell; Thomas Allan,19,0,100,81
1656994342144,CSE 140,A01,083663,Gungor; Onat,14,0,85,71
1656994348168,CSE 140L,A01,083088,Eldon; John,16,0,100,84
1656994354191,CSE 175,A01,083665,Kumar; Rakesh,3,0,25,22
1656994360216,CSE 190,A00,092507,Dubnov; Shlomo,7,0,20,13
1656994366244,ECE 45,A01,083139,Congero; Spencer William,5,0,75,70
1656994372268,ECE 65,A50,083695,Saad; Andrew S,12,0,30,18
1656994372268,ECE 65,A51,095125,Saad; Andrew S,25,0,26,1
1656994378292,ECE 109,A01,091882,Touri; Behrouz,16,0,70,54
1656994384319,ECE 180,A00,083140,Abi Samra; Nicholas Camill,1,0,30,29
1656994384319,ECE 180,B00,083141,Abi Samra; Nicholas Camill,0,0,30,30
1656994390346,MATH 10A,A01,083735,Patchell; Gregory David,1,0,30,29
1656994390346,MATH 10A,A02,083736,Patchell; Gregory David,20,0,30,10
1656994390346,MATH 10A,A03,083737,Patchell; Gregory David,15,0,30,15
1656994396370,MATH 10B,A01,083207,Lim; Seonhee,7,0,34,27
1656994396370,MATH 10B,A02,083208,Lim; Seonhee,9,0,35,26
1656994396370,MATH 10B,A03,093472,Lim; Seonhee,4,0,34,30
1656994396370,MATH 10B,B01,083739,Sinha; Shubham,9,0,30,21
1656994402403,MATH 18,A01,083743,Cinel; Cameron Alexander,6,0,30,24
1656994402403,MATH 18,A02,083744,Cinel; Cameron Alexander,15,0,30,15
1656994402403,MATH 18,A03,083745,Cinel; Cameron Alexander,8,0,30,22
1656994402403,MATH 18,B01,083748,Rideout; David Porter,4,0,37,33
1656994402403,MATH 18,B02,083749,Rideout; David Porter,3,0,36,33
1656994402403,MATH 18,B03,083750,Rideout; David Porter,2,0,37,35
1656994402403,MATH 18,B04,083751,Rideout; David Porter,5,0,36,31
1656994402403,MATH 18,B05,093473,Rideout; David Porter,4,0,36,32
1656994402403,MATH 18,B06,093474,Rideout; David Porter,5,0,36,31
1656994408434,MATH 20A,A01,083754,Zheng; Zequn,12,0,40,28
1656994414458,MATH 20B,A01,083756,Briones; Jor-el Thomas Caparas,1,0,36,35
1656994414458,MATH 20B,A02,083757,Briones; Jor-el Thomas Caparas,1,0,36,35
1656994414458,MATH 20B,A03,093475,Briones; Jor-el Thomas Caparas,0,0,36,36
1656994420482,MATH 20C,A01,083760,Briones; Jor-el Thomas Caparas,1,0,35,34
1656994420482,MATH 20C,A02,083761,Briones; Jor-el Thomas Caparas,8,0,35,27
1656994420482,MATH 20C,A03,093476,Briones; Jor-el Thomas Caparas,0,1,36,36
1656994420482,MATH 20C,B01,083762,Bach; Quang Tran,0,0,30,30
1656994426509,MATH 20D,A01,083765,Tran; Brian Kha,4,0,30,26
1656994426509,MATH 20D,A02,083766,Tran; Brian Kha,5,0,30,25
1656994426509,MATH 20D,A03,083767,Tran; Brian Kha,3,0,30,27
1656994432534,MATH 20E,A01,083771,Ganguly; Soumya,5,0,32,27
1656994432534,MATH 20E,A02,083772,Ganguly; Soumya,6,0,32,26
1656994432534,MATH 20E,B01,083773,Ciotti; Benjamin,18,0,35,17
1656994432534,MATH 20E,B02,083774,Ciotti; Benjamin,17,0,35,18
1656994438557,MATH 103A,A01,083777,Greenfeld; Be'Eri,2,0,36,34
1656994438557,MATH 103A,A02,083778,Greenfeld; Be'Eri,5,0,36,31
1656994438557,MATH 103A,A03,093561,Greenfeld; Be'Eri,4,0,36,32
1656994438557,MATH 103A,B01,083779,Greenfeld; Be'Eri,6,0,36,30
1656994438557,MATH 103A,B02,083780,Greenfeld; Be'Eri,2,0,36,34
1656994438557,MATH 103A,B03,093562,Greenfeld; Be'Eri,2,0,36,34
1656994444582,MATH 105,A01,085443,Carter; Anne Toulson,14,0,35,21
1656994444582,MATH 105,A02,093477,Carter; Anne Toulson,20,0,35,15
1656994450610,MATH 109,A01,083213,Ganzberger; Geoffrey Michael,2,0,34,32
1656994450610,MATH 109,A02,083214,Ganzberger; Geoffrey Michael,2,0,34,32
1656994450610,MATH 109,A03,093478,Ganzberger; Geoffrey Michael,1,0,34,33
1656994450610,MATH 109,B01,083215,Ganzberger; Geoffrey Michael,1,0,32,31
1656994450610,MATH 109,B02,083216,Ganzberger; Geoffrey Michael,1,0,32,31
1656994450610,MATH 109,B03,093479,Ganzberger; Geoffrey Michael,6,0,32,26
1656994456637,MATH 142A,A01,083219,Chow; Bennett,6,0,32,26
1656994456637,MATH 142A,A02,083220,Chow; Bennett,10,0,32,22
1656994456637,MATH 142A,A03,093480,Chow; Bennett,7,0,32,25
1656994456637,MATH 142A,B03,093481,Chow; Bennett,7,0,32,25
1656994456637,MATH 142A,B04,093558,Chow; Bennett,11,0,32,21
1656994456637,MATH 142A,B05,093559,Chow; Bennett,6,0,32,26
1656994462660,MATH 193A,A01,083224,Rotar; Vladimir,7,0,34,27
1656994462660,MATH 193A,A02,083225,Rotar; Vladimir,4,0,34,30
1656994462660,MATH 193A,A03,083781,Rotar; Vladimir,1,0,34,33
1656994462660,MATH 193A,A04,083782,Rotar; Vladimir,6,0,34,28
1656994462660,MATH 193A,A05,093482,Rotar; Vladimir,6,0,34,28
1656994468687,MATH 197,001,091859,McAuley; Julian John,9999,0,9999,0
1656994468687,MATH 197,002,095566,Kedlaya; Kiran S.,9997,0,9999,2
1656994468687,MATH 197,003,095567,Xiao; Ming,9999,0,9999,0
1656994468687,MATH 197,004,095571,Perols; Johan Lars,9998,0,9999,1
1656994475744,COGS 9,A01,083615,Shannon; Kyle Michael,7,0,75,68
1656994481768,COGS 11,A01,083617,Boyle; Mary E. T.,20,0,48,28
1656994487798,COGS 13,A01,083071,Bastos; Amalia Pinkusfeld,9,0,71,62
1656994493825,COGS 14A,A01,092681,Semenuks; Arturs,0,1,100,100
1656994499849,COGS 14B,A01,083073,Cheng; Tzu-Han,5,0,63,58
1656994505871,COGS 17,A01,092677,Semenuks; Arturs,4,0,81,77
1656994511893,COGS 100,A01,083619,Allen; Michael Gordon,15,0,70,55
1656994517917,COGS 101A,A01,083621,Davis; Joshua Daniel,9,0,68,59
1656994523943,COGS 101B,A01,091572,Allen; Michael Gordon,8,0,65,57
1656994529968,COGS 101C,A01,083625,Delgado; Tania,17,0,35,18
1656994535991,COGS 107A,A01,083627,Boyle; Mary E. T.,13,0,60,47
1656994542015,COGS 118A,A01,083075,Gupta; Anjum,15,0,76,61
1656994548038,CSE 3,A50,083646,Miranda; Gregory Joseph,22,0,50,28
1656994554061,CSE 8A,A50,083650,Miranda; Gregory Joseph,17,1,56,39
1656994560084,CSE 11,A01,083080,Cao; Yingjun,4,15,40,36
1656994566112,CSE 12,A01,083652,Krause-Levy; Sophia Louisa,20,1,120,100
1656994572136,CSE 15L,A01,083654,Morris; Justin Loren,8,0,50,42
1656994572136,CSE 15L,A02,083655,Morris; Justin Loren,8,0,50,42
1656994578162,CSE 20,A01,083657,Tran; Khoa Dang,37,0,80,43
1656994584187,CSE 21,A01,095574,Bach; Quang Tran,21,0,48,27
1656994590223,CSE 30,A01,083084,Eldon; John,4,0,80,76
1656994590223,CSE 30,B01,095061,Bhaskar; Nishant,6,0,50,44
1656994596246,CSE 100,A01,083659,Cao; Yingjun,3,4,70,67
1656994602269,CSE 134B,A01,083661,Powell; Thomas Allan,19,0,100,81
1656994608290,CSE 140,A01,083663,Gungor; Onat,14,0,85,71
1656994614315,CSE 140L,A01,083088,Eldon; John,16,0,100,84
1656994620348,CSE 175,A01,083665,Kumar; Rakesh,3,0,25,22
1656994626371,CSE 190,A00,092507,Dubnov; Shlomo,7,0,20,13
1656994632395,ECE 45,A01,083139,Congero; Spencer William,5,0,75,70
1656994638417,ECE 65,A50,083695,Saad; Andrew S,12,0,30,18
1656994638417,ECE 65,A51,095125,Saad; Andrew S,25,0,26,1
1656994644440,ECE 109,A01,091882,Touri; Behrouz,16,0,70,54
1656994650464,ECE 180,A00,083140,Abi Samra; Nicholas Camill,1,0,30,29
1656994650464,ECE 180,B00,083141,Abi Samra; Nicholas Camill,0,0,30,30
1656994656493,MATH 10A,A01,083735,Patchell; Gregory David,1,0,30,29
1656994656493,MATH 10A,A02,083736,Patchell; Gregory David,20,0,30,10
1656994656493,MATH 10A,A03,083737,Patchell; Gregory David,15,0,30,15
1656994662522,MATH 10B,A01,083207,Lim; Seonhee,7,0,34,27
1656994662522,MATH 10B,A02,083208,Lim; Seonhee,9,0,35,26
1656994662522,MATH 10B,A03,093472,Lim; Seonhee,4,0,34,30
1656994662522,MATH 10B,B01,083739,Sinha; Shubham,9,0,30,21
1656994668547,MATH 18,A01,083743,Cinel; Cameron Alexander,6,0,30,24
1656994668547,MATH 18,A02,083744,Cinel; Cameron Alexander,15,0,30,15
1656994668547,MATH 18,A03,083745,Cinel; Cameron Alexander,8,0,30,22
1656994668547,MATH 18,B01,083748,Rideout; David Porter,4,0,37,33
1656994668547,MATH 18,B02,083749,Rideout; David Porter,3,0,36,33
1656994668547,MATH 18,B03,083750,Rideout; David Porter,2,0,37,35
1656994668547,MATH 18,B04,083751,Rideout; David Porter,5,0,36,31
1656994668547,MATH 18,B05,093473,Rideout; David Porter,4,0,36,32
1656994668547,MATH 18,B06,093474,Rideout; David Porter,5,0,36,31
1656994674574,MATH 20A,A01,083754,Zheng; Zequn,12,0,40,28
1656994680603,MATH 20B,A01,083756,Briones; Jor-el Thomas Caparas,1,0,36,35
1656994680603,MATH 20B,A02,083757,Briones; Jor-el Thomas Caparas,1,0,36,35
1656994680603,MATH 20B,A03,093475,Briones; Jor-el Thomas Caparas,0,0,36,36
1656994686633,MATH 20C,A01,083760,Briones; Jor-el Thomas Caparas,1,0,35,34
1656994686633,MATH 20C,A02,083761,Briones; Jor-el Thomas Caparas,8,0,35,27
1656994686633,MATH 20C,A03,093476,Briones; Jor-el Thomas Caparas,0,1,36,36
1656994686633,MATH 20C,B01,083762,Bach; Quang Tran,0,0,30,30
1656994692657,MATH 20D,A01,083765,Tran; Brian Kha,4,0,30,26
1656994692657,MATH 20D,A02,083766,Tran; Brian Kha,5,0,30,25
1656994692657,MATH 20D,A03,083767,Tran; Brian Kha,3,0,30,27
1656994698682,MATH 20E,A01,083771,Ganguly; Soumya,5,0,32,27
1656994698682,MATH 20E,A02,083772,Ganguly; Soumya,6,0,32,26
1656994698682,MATH 20E,B01,083773,Ciotti; Benjamin,18,0,35,17
1656994698682,MATH 20E,B02,083774,Ciotti; Benjamin,17,0,35,18
1656994704780,MATH 103A,A01,083777,Greenfeld; Be'Eri,2,0,36,34
1656994704780,MATH 103A,A02,083778,Greenfeld; Be'Eri,5,0,36,31
1656994704780,MATH 103A,A03,093561,Greenfeld; Be'Eri,4,0,36,32
1656994704780,MATH 103A,B01,083779,Greenfeld; Be'Eri,6,0,36,30
1656994704780,MATH 103A,B02,083780,Greenfeld; Be'Eri,2,0,36,34
1656994704780,MATH 103A,B03,093562,Greenfeld; Be'Eri,2,0,36,34
1656994710807,MATH 105,A01,085443,Carter; Anne Toulson,14,0,35,21
1656994710807,MATH 105,A02,093477,Carter; Anne Toulson,20,0,35,15
1656994716837,MATH 109,A01,083213,Ganzberger; Geoffrey Michael,2,0,34,32
1656994716837,MATH 109,A02,083214,Ganzberger; Geoffrey Michael,2,0,34,32
1656994716837,MATH 109,A03,093478,Ganzberger; Geoffrey Michael,1,0,34,33
1656994716837,MATH 109,B01,083215,Ganzberger; Geoffrey Michael,1,0,32,31
1656994716837,MATH 109,B02,083216,Ganzberger; Geoffrey Michael,1,0,32,31
1656994716837,MATH 109,B03,093479,Ganzberger; Geoffrey Michael,6,0,32,26
1656994722869,MATH 142A,A01,083219,Chow; Bennett,6,0,32,26
1656994722869,MATH 142A,A02,083220,Chow; Bennett,10,0,32,22
1656994722869,MATH 142A,A03,093480,Chow; Bennett,7,0,32,25
1656994722869,MATH 142A,B03,093481,Chow; Bennett,7,0,32,25
1656994722869,MATH 142A,B04,093558,Chow; Bennett,11,0,32,21
1656994722869,MATH 142A,B05,093559,Chow; Bennett,6,0,32,26
1656994728900,MATH 193A,A01,083224,Rotar; Vladimir,7,0,34,27
1656994728900,MATH 193A,A02,083225,Rotar; Vladimir,4,0,34,30
1656994728900,MATH 193A,A03,083781,Rotar; Vladimir,1,0,34,33
1656994728900,MATH 193A,A04,083782,Rotar; Vladimir,6,0,34,28
1656994728900,MATH 193A,A05,093482,Rotar; Vladimir,6,0,34,28
1656994734924,MATH 197,001,091859,McAuley; Julian John,9999,0,9999,0
1656994734924,MATH 197,002,095566,Kedlaya; Kiran S.,9997,0,9999,2
1656994734924,MATH 197,003,095567,Xiao; Ming,9999,0,9999,0
1656994734924,MATH 197,004,095571,Perols; Johan Lars,9998,0,9999,1
1656994741986,COGS 9,A01,083615,Shannon; Kyle Michael,7,0,75,68
1656994748010,COGS 11,A01,083617,Boyle; Mary E. T.,20,0,48,28
1656994754032,COGS 13,A01,083071,Bastos; Amalia Pinkusfeld,9,0,71,62
1656994760057,COGS 14A,A01,092681,Semenuks; Arturs,0,1,100,100
1656994766081,COGS 14B,A01,083073,Cheng; Tzu-Han,5,0,63,58
1656994772108,COGS 17,A01,092677,Semenuks; Arturs,4,0,81,77
1656994778135,COGS 100,A01,083619,Allen; Michael Gordon,15,0,70,55
1656994784162,COGS 101A,A01,083621,Davis; Joshua Daniel,9,0,68,59
1656994790189,COGS 101B,A01,091572,Allen; Michael Gordon,8,0,65,57
1656994796214,COGS 101C,A01,083625,Delgado; Tania,17,0,35,18
1656994802239,COGS 107A,A01,083627,Boyle; Mary E. T.,13,0,60,47
1656994808264,COGS 118A,A01,083075,Gupta; Anjum,15,0,76,61
1656994814287,CSE 3,A50,083646,Miranda; Gregory Joseph,22,0,50,28
1656994820316,CSE 8A,A50,083650,Miranda; Gregory Joseph,17,1,56,39
1656994826343,CSE 11,A01,083080,Cao; Yingjun,4,15,40,36
1656994832368,CSE 12,A01,083652,Krause-Levy; Sophia Louisa,20,1,120,100
1656994838395,CSE 15L,A01,083654,Morris; Justin Loren,8,0,50,42
1656994838395,CSE 15L,A02,083655,Morris; Justin Loren,8,0,50,42
1656994844419,CSE 20,A01,083657,Tran; Khoa Dang,37,0,80,43
1656994850446,CSE 21,A01,095574,Bach; Quang Tran,21,0,48,27
1656994856475,CSE 30,A01,083084,Eldon; John,4,0,80,76
1656994856475,CSE 30,B01,095061,Bhaskar; Nishant,6,0,50,44
1656994862501,CSE 100,A01,083659,Cao; Yingjun,3,4,70,67
1656994868530,CSE 134B,A01,083661,Powell; Thomas Allan,19,0,100,81
1656994874551,CSE 140,A01,083663,Gungor; Onat,14,0,85,71
1656994880578,CSE 140L,A01,083088,Eldon; John,16,0,100,84
1656994886605,CSE 175,A01,083665,Kumar; Rakesh,3,0,25,22
1656994892635,CSE 190,A00,092507,Dubnov; Shlomo,7,0,20,13
1656994898658,ECE 45,A01,083139,Congero; Spencer William,5,0,75,70
1656994904681,ECE 65,A50,083695,Saad; Andrew S,12,0,30,18
1656994904681,ECE 65,A51,095125,Saad; Andrew S,25,0,26,1
1656994910705,ECE 109,A01,091882,Touri; Behrouz,16,0,70,54
1656994916729,ECE 180,A00,083140,Abi Samra; Nicholas Camill,1,0,30,29
1656994916729,ECE 180,B00,083141,Abi Samra; Nicholas Camill,0,0,30,30
1656994922758,MATH 10A,A01,083735,Patchell; Gregory David,1,0,30,29
1656994922758,MATH 10A,A02,083736,Patchell; Gregory David,20,0,30,10
1656994922758,MATH 10A,A03,083737,Patchell; Gregory David,15,0,30,15
1656994928783,MATH 10B,A01,083207,Lim; Seonhee,7,0,34,27
1656994928783,MATH 10B,A02,083208,Lim; Seonhee,9,0,35,26
1656994928783,MATH 10B,A03,093472,Lim; Seonhee,4,0,34,30
1656994928783,MATH 10B,B01,083739,Sinha; Shubham,9,0,30,21
1656994934815,MATH 18,A01,083743,Cinel; Cameron Alexander,6,0,30,24
1656994934815,MATH 18,A02,083744,Cinel; Cameron Alexander,15,0,30,15
1656994934815,MATH 18,A03,083745,Cinel; Cameron Alexander,8,0,30,22
1656994934815,MATH 18,B01,083748,Rideout; David Porter,4,0,37,33
1656994934815,MATH 18,B02,083749,Rideout; David Porter,3,0,36,33
1656994934815,MATH 18,B03,083750,Rideout; David Porter,2,0,37,35
1656994934815,MATH 18,B04,083751,Rideout; David Porter,5,0,36,31
1656994934815,MATH 18,B05,093473,Rideout; David Porter,4,0,36,32
1656994934815,MATH 18,B06,093474,Rideout; David Porter,5,0,36,31
1656994940839,MATH 20A,A01,083754,Zheng; Zequn,12,0,40,28
1656994946862,MATH 20B,A01,083756,Briones; Jor-el Thomas Caparas,1,0,36,35
1656994946862,MATH 20B,A02,083757,Briones; Jor-el Thomas Caparas,1,0,36,35
1656994946862,MATH 20B,A03,093475,Briones; Jor-el Thomas Caparas,0,0,36,36
1656994952888,MATH 20C,A01,083760,Briones; Jor-el Thomas Caparas,1,0,35,34
1656994952888,MATH 20C,A02,083761,Briones; Jor-el Thomas Caparas,8,0,35,27
1656994952888,MATH 20C,A03,093476,Briones; Jor-el Thomas Caparas,0,1,36,36
1656994952888,MATH 20C,B01,083762,Bach; Quang Tran,0,0,30,30
1656994958916,MATH 20D,A01,083765,Tran; Brian Kha,4,0,30,26
1656994958916,MATH 20D,A02,083766,Tran; Brian Kha,5,0,30,25
1656994958916,MATH 20D,A03,083767,Tran; Brian Kha,3,0,30,27
1656994964946,MATH 20E,A01,083771,Ganguly; Soumya,5,0,32,27
1656994964946,MATH 20E,A02,083772,Ganguly; Soumya,6,0,32,26
1656994964946,MATH 20E,B01,083773,Ciotti; Benjamin,18,0,35,17
1656994964946,MATH 20E,B02,083774,Ciotti; Benjamin,17,0,35,18
1656994970972,MATH 103A,A01,083777,Greenfeld; Be'Eri,2,0,36,34
1656994970972,MATH 103A,A02,083778,Greenfeld; Be'Eri,5,0,36,31
1656994970972,MATH 103A,A03,093561,Greenfeld; Be'Eri,4,0,36,32
1656994970972,MATH 103A,B01,083779,Greenfeld; Be'Eri,6,0,36,30
1656994970972,MATH 103A,B02,083780,Greenfeld; Be'Eri,2,0,36,34
1656994970972,MATH 103A,B03,093562,Greenfeld; Be'Eri,2,0,36,34
1656994976999,MATH 105,A01,085443,Carter; Anne Toulson,14,0,35,21
1656994976999,MATH 105,A02,093477,Carter; Anne Toulson,20,0,35,15
1656994983024,MATH 109,A01,083213,Ganzberger; Geoffrey Michael,2,0,34,32
1656994983024,MATH 109,A02,083214,Ganzberger; Geoffrey Michael,2,0,34,32
1656994983024,MATH 109,A03,093478,Ganzberger; Geoffrey Michael,1,0,34,33
1656994983024,MATH 109,B01,083215,Ganzberger; Geoffrey Michael,1,0,32,31
1656994983024,MATH 109,B02,083216,Ganzberger; Geoffrey Michael,1,0,32,31
1656994983024,MATH 109,B03,093479,Ganzberger; Geoffrey Michael,6,0,32,26
1656994989047,MATH 142A,A01,083219,Chow; Bennett,6,0,32,26
1656994989047,MATH 142A,A02,083220,Chow; Bennett,10,0,32,22
1656994989047,MATH 142A,A03,093480,Chow; Bennett,7,0,32,25
1656994989047,MATH 142A,B03,093481,Chow; Bennett,7,0,32,25
1656994989047,MATH 142A,B04,093558,Chow; Bennett,11,0,32,21
1656994989047,MATH 142A,B05,093559,Chow; Bennett,6,0,32,26
1656994995075,MATH 193A,A01,083224,Rotar; Vladimir,7,0,34,27
1656994995075,MATH 193A,A02,083225,Rotar; Vladimir,4,0,34,30
1656994995075,MATH 193A,A03,083781,Rotar; Vladimir,1,0,34,33
1656994995075,MATH 193A,A04,083782,Rotar; Vladimir,6,0,34,28
1656994995075,MATH 193A,A05,093482,Rotar; Vladimir,6,0,34,28
1656995001102,MATH 197,001,091859,McAuley; Julian John,9999,0,9999,0
1656995001102,MATH 197,002,095566,Kedlaya; Kiran S.,9997,0,9999,2
1656995001102,MATH 197,003,095567,Xiao; Ming,9999,0,9999,0
1656995001102,MATH 197,004,095571,Perols; Johan Lars,9998,0,9999,1
1656995008159,COGS 9,A01,083615,Shannon; Kyle Michael,7,0,75,68
1656995014182,COGS 11,A01,083617,Boyle; Mary E. T.,20,0,48,28
1656995020207,COGS 13,A01,083071,Bastos; Amalia Pinkusfeld,9,0,71,62
1656995026233,COGS 14A,A01,092681,Semenuks; Arturs,0,1,100,100
1656995032258,COGS 14B,A01,083073,Cheng; Tzu-Han,5,0,63,58
1656995038279,COGS 17,A01,092677,Semenuks; Arturs,4,0,81,77
1656995044302,COGS 100,A01,083619,Allen; Michael Gordon,15,0,70,55
1656995050326,COGS 101A,A01,083621,Davis; Joshua Daniel,9,0,68,59
1656995056354,COGS 101B,A01,091572,Allen; Michael Gordon,8,0,65,57
1656995062377,COGS 101C,A01,083625,Delgado; Tania,17,0,35,18
1656995068408,COGS 107A,A01,083627,Boyle; Mary E. T.,13,0,60,47
1656995074432,COGS 118A,A01,083075,Gupta; Anjum,15,0,76,61
1656995080458,CSE 3,A50,083646,Miranda; Gregory Joseph,22,0,50,28
1656995086486,CSE 8A,A50,083650,Miranda; Gregory Joseph,17,1,56,39
1656995092511,CSE 11,A01,083080,Cao; Yingjun,4,15,40,36
1656995098534,CSE 12,A01,083652,Krause-Levy; Sophia Louisa,20,1,120,100
1656995104559,CSE 15L,A01,083654,Morris; Justin Loren,8,0,50,42
1656995104559,CSE 15L,A02,083655,Morris; Justin Loren,8,0,50,42
1656995110584,CSE 20,A01,083657,Tran; Khoa Dang,37,0,80,43
1656995116608,CSE 21,A01,095574,Bach; Quang Tran,21,0,48,27
1656995122631,CSE 30,A01,083084,Eldon; John,4,0,80,76
1656995122631,CSE 30,B01,095061,Bhaskar; Nishant,6,0,50,44
1656995128653,CSE 100,A01,083659,Cao; Yingjun,3,4,70,67
1656995134694,CSE 134B,A01,083661,Powell; Thomas Allan,19,0,100,81
1656995140718,CSE 140,A01,083663,Gungor; Onat,14,0,85,71
1656995146743,CSE 140L,A01,083088,Eldon; John,16,0,100,84
1656995152766,CSE 175,A01,083665,Kumar; Rakesh,3,0,25,22
1656995158787,CSE 190,A00,092507,Dubnov; Shlomo,7,0,20,13
1656995164810,ECE 45,A01,083139,Congero; Spencer William,5,0,75,70
1656995170832,ECE 65,A50,083695,Saad; Andrew S,12,0,30,18
1656995170832,ECE 65,A51,095125,Saad; Andrew S,25,0,26,1
1656995176856,ECE 109,A01,091882,Touri; Behrouz,16,0,70,54
1656995182880,ECE 180,A00,083140,Abi Samra; Nicholas Camill,1,0,30,29
1656995182880,ECE 180,B00,083141,Abi Samra; Nicholas Camill,0,0,30,30
1656995188903,MATH 10A,A01,083735,Patchell; Gregory David,1,0,30,29
1656995188903,MATH 10A,A02,083736,Patchell; Gregory David,20,0,30,10
1656995188903,MATH 10A,A03,083737,Patchell; Gregory David,15,0,30,15
1656995194926,MATH 10B,A01,083207,Lim; Seonhee,7,0,34,27
1656995194926,MATH 10B,A02,083208,Lim; Seonhee,9,0,35,26
1656995194926,MATH 10B,A03,093472,Lim; Seonhee,4,0,34,30
1656995194926,MATH 10B,B01,083739,Sinha; Shubham,9,0,30,21
1656995200955,MATH 18,A01,083743,Cinel; Cameron Alexander,6,0,30,24
1656995200955,MATH 18,A02,083744,Cinel; Cameron Alexander,15,0,30,15
1656995200955,MATH 18,A03,083745,Cinel; Cameron Alexander,8,0,30,22
1656995200955,MATH 18,B01,083748,Rideout; David Porter,4,0,37,33
1656995200955,MATH 18,B02,083749,Rideout; David Porter,3,0,36,33
1656995200955,MATH 18,B03,083750,Rideout; David Porter,2,0,37,35
1656995200955,MATH 18,B04,083751,Rideout; David Porter,5,0,36,31
1656995200955,MATH 18,B05,093473,Rideout; David Porter,4,0,36,32
1656995200955,MATH 18,B06,093474,Rideout; David Porter,5,0,36,31
1656995206978,MATH 20A,A01,083754,Zheng; Zequn,12,0,40,28
1656995213006,MATH 20B,A01,083756,Briones; Jor-el Thomas Caparas,1,0,36,35
1656995213006,MATH 20B,A02,083757,Briones; Jor-el Thomas Caparas,1,0,36,35
1656995213006,MATH 20B,A03,093475,Briones; Jor-el Thomas Caparas,0,0,36,36
1656995219027,MATH 20C,A01,083760,Briones; Jor-el Thomas Caparas,1,0,35,34
1656995219027,MATH 20C,A02,083761,Briones; Jor-el Thomas Caparas,8,0,35,27
1656995219027,MATH 20C,A03,093476,Briones; Jor-el Thomas Caparas,0,1,36,36
1656995219027,MATH 20C,B01,083762,Bach; Quang Tran,0,0,30,30
1656995225051,MATH 20D,A01,083765,Tran; Brian Kha,4,0,30,26
1656995225051,MATH 20D,A02,083766,Tran; Brian Kha,5,0,30,25
1656995225051,MATH 20D,A03,083767,Tran; Brian Kha,3,0,30,27
1656995231079,MATH 20E,A01,083771,Ganguly; Soumya,5,0,32,27
1656995231079,MATH 20E,A02,083772,Ganguly; Soumya,6,0,32,26
1656995231079,MATH 20E,B01,083773,Ciotti; Benjamin,18,0,35,17
1656995231079,MATH 20E,B02,083774,Ciotti; Benjamin,17,0,35,18
1656995237110,MATH 103A,A01,083777,Greenfeld; Be'Eri,2,0,36,34
1656995237110,MATH 103A,A02,083778,Greenfeld; Be'Eri,5,0,36,31
1656995237110,MATH 103A,A03,093561,Greenfeld; Be'Eri,4,0,36,32
1656995237110,MATH 103A,B01,083779,Greenfeld; Be'Eri,6,0,36,30
1656995237110,MATH 103A,B02,083780,Greenfeld; Be'Eri,2,0,36,34
1656995237110,MATH 103A,B03,093562,Greenfeld; Be'Eri,2,0,36,34
1656995243139,MATH 105,A01,085443,Carter; Anne Toulson,14,0,35,21
1656995243139,MATH 105,A02,093477,Carter; Anne Toulson,20,0,35,15
1656995249176,MATH 109,A01,083213,Ganzberger; Geoffrey Michael,2,0,34,32
1656995249176,MATH 109,A02,083214,Ganzberger; Geoffrey Michael,2,0,34,32
1656995249176,MATH 109,A03,093478,Ganzberger; Geoffrey Michael,1,0,34,33
1656995249176,MATH 109,B01,083215,Ganzberger; Geoffrey Michael,1,0,32,31
1656995249176,MATH 109,B02,083216,Ganzberger; Geoffrey Michael,1,0,32,31
1656995249176,MATH 109,B03,093479,Ganzberger; Geoffrey Michael,6,0,32,26
1656995255201,MATH 142A,A01,083219,Chow; Bennett,6,0,32,26
1656995255201,MATH 142A,A02,083220,Chow; Bennett,10,0,32,22
1656995255201,MATH 142A,A03,093480,Chow; Bennett,7,0,32,25
1656995255201,MATH 142A,B03,093481,Chow; Bennett,7,0,32,25
1656995255201,MATH 142A,B04,093558,Chow; Bennett,11,0,32,21
1656995255201,MATH 142A,B05,093559,Chow; Bennett,6,0,32,26
1656995261226,MATH 193A,A01,083224,Rotar; Vladimir,7,0,34,27
1656995261226,MATH 193A,A02,083225,Rotar; Vladimir,4,0,34,30
1656995261226,MATH 193A,A03,083781,Rotar; Vladimir,1,0,34,33
1656995261226,MATH 193A,A04,083782,Rotar; Vladimir,6,0,34,28
1656995261226,MATH 193A,A05,093482,Rotar; Vladimir,6,0,34,28
1656995267253,MATH 197,001,091859,McAuley; Julian John,9999,0,9999,0
1656995267253,MATH 197,002,095566,Kedlaya; Kiran S.,9997,0,9999,2
1656995267253,MATH 197,003,095567,Xiao; Ming,9999,0,9999,0
1656995267253,MATH 197,004,095571,Perols; Johan Lars,9998,0,9999,1
1656995274314,COGS 9,A01,083615,Shannon; Kyle Michael,7,0,75,68
1656995280344,COGS 11,A01,083617,Boyle; Mary E. T.,20,0,48,28
1656995286368,COGS 13,A01,083071,Bastos; Amalia Pinkusfeld,9,0,71,62
1656995292389,COGS 14A,A01,092681,Semenuks; Arturs,0,1,100,100
1656995298485,COGS 14B,A01,083073,Cheng; Tzu-Han,5,0,63,58
1656995304511,COGS 17,A01,092677,Semenuks; Arturs,4,0,81,77
1656995310534,COGS 100,A01,083619,Allen; Michael Gordon,15,0,70,55
1656995316563,COGS 101A,A01,083621,Davis; Joshua Daniel,9,0,68,59
1656995322589,COGS 101B,A01,091572,Allen; Michael Gordon,8,0,65,57
1656995328621,COGS 101C,A01,083625,Delgado; Tania,17,0,35,18
1656995334645,COGS 107A,A01,083627,Boyle; Mary E. T.,13,0,60,47
1656995340667,COGS 118A,A01,083075,Gupta; Anjum,15,0,76,61
1656995346692,CSE 3,A50,083646,Miranda; Gregory Joseph,22,0,50,28
1656995352722,CSE 8A,A50,083650,Miranda; Gregory Joseph,17,1,56,39
1656995358750,CSE 11,A01,083080,Cao; Yingjun,4,15,40,36
1656995364774,CSE 12,A01,083652,Krause-Levy; Sophia Louisa,20,1,120,100
1656995370797,CSE 15L,A01,083654,Morris; Justin Loren,8,0,50,42
1656995370797,CSE 15L,A02,083655,Morris; Justin Loren,8,0,50,42
1656995376829,CSE 20,A01,083657,Tran; Khoa Dang,37,0,80,43
1656995382855,CSE 21,A01,095574,Bach; Quang Tran,21,0,48,27
1656995388878,CSE 30,A01,083084,Eldon; John,4,0,80,76
1656995388878,CSE 30,B01,095061,Bhaskar; Nishant,6,0,50,44
1656995394905,CSE 100,A01,083659,Cao; Yingjun,3,4,70,67
1656995400930,CSE 134B,A01,083661,Powell; Thomas Allan,19,0,100,81
1656995406955,CSE 140,A01,083663,Gungor; Onat,14,0,85,71
1656995412978,CSE 140L,A01,083088,Eldon; John,16,0,100,84
1656995418999,CSE 175,A01,083665,Kumar; Rakesh,3,0,25,22
1656995425021,CSE 190,A00,092507,Dubnov; Shlomo,7,0,20,13
1656995431049,ECE 45,A01,083139,Congero; Spencer William,5,0,75,70
1656995437072,ECE 65,A50,083695,Saad; Andrew S,12,0,30,18
1656995437072,ECE 65,A51,095125,Saad; Andrew S,25,0,26,1
1656995443096,ECE 109,A01,091882,Touri; Behrouz,16,0,70,54
1656995449122,ECE 180,A00,083140,Abi Samra; Nicholas Camill,1,0,30,29
1656995449122,ECE 180,B00,083141,Abi Samra; Nicholas Camill,0,0,30,30
1656995455144,MATH 10A,A01,083735,Patchell; Gregory David,1,0,30,29
1656995455144,MATH 10A,A02,083736,Patchell; Gregory David,20,0,30,10
1656995455144,MATH 10A,A03,083737,Patchell; Gregory David,15,0,30,15
1656995461174,MATH 10B,A01,083207,Lim; Seonhee,7,0,34,27
1656995461174,MATH 10B,A02,083208,Lim; Seonhee,9,0,35,26
1656995461174,MATH 10B,A03,093472,Lim; Seonhee,4,0,34,30
1656995461174,MATH 10B,B01,083739,Sinha; Shubham,9,0,30,21
1656995467197,MATH 18,A01,083743,Cinel; Cameron Alexander,6,0,30,24
1656995467197,MATH 18,A02,083744,Cinel; Cameron Alexander,15,0,30,15
1656995467197,MATH 18,A03,083745,Cinel; Cameron Alexander,8,0,30,22
1656995467197,MATH 18,B01,083748,Rideout; David Porter,4,0,37,33
1656995467197,MATH 18,B02,083749,Rideout; David Porter,3,0,36,33
1656995467197,MATH 18,B03,083750,Rideout; David Porter,2,0,37,35
1656995467197,MATH 18,B04,083751,Rideout; David Porter,5,0,36,31
1656995467197,MATH 18,B05,093473,Rideout; David Porter,4,0,36,32
1656995467197,MATH 18,B06,093474,Rideout; David Porter,5,0,36,31
1656995473220,MATH 20A,A01,083754,Zheng; Zequn,12,0,40,28
1656995479256,MATH 20B,A01,083756,Briones; Jor-el Thomas Caparas,1,0,36,35
1656995479256,MATH 20B,A02,083757,Briones; Jor-el Thomas Caparas,1,0,36,35
1656995479256,MATH 20B,A03,093475,Briones; Jor-el Thomas Caparas,0,0,36,36
1656995485278,MATH 20C,A01,083760,Briones; Jor-el Thomas Caparas,1,0,35,34
1656995485278,MATH 20C,A02,083761,Briones; Jor-el Thomas Caparas,8,0,35,27
1656995485278,MATH 20C,A03,093476,Briones; Jor-el Thomas Caparas,0,1,36,36
1656995485278,MATH 20C,B01,083762,Bach; Quang Tran,0,0,30,30
1656995491310,MATH 20D,A01,083765,Tran; Brian Kha,4,0,30,26
1656995491310,MATH 20D,A02,083766,Tran; Brian Kha,5,0,30,25
1656995491310,MATH 20D,A03,083767,Tran; Brian Kha,3,0,30,27
1656995497337,MATH 20E,A01,083771,Ganguly; Soumya,5,0,32,27
1656995497337,MATH 20E,A02,083772,Ganguly; Soumya,6,0,32,26
1656995497337,MATH 20E,B01,083773,Ciotti; Benjamin,18,0,35,17
1656995497337,MATH 20E,B02,083774,Ciotti; Benjamin,17,0,35,18
1656995503367,MATH 103A,A01,083777,Greenfeld; Be'Eri,2,0,36,34
1656995503367,MATH 103A,A02,083778,Greenfeld; Be'Eri,5,0,36,31
1656995503367,MATH 103A,A03,093561,Greenfeld; Be'Eri,4,0,36,32
1656995503367,MATH 103A,B01,083779,Greenfeld; Be'Eri,6,0,36,30
1656995503367,MATH 103A,B02,083780,Greenfeld; Be'Eri,2,0,36,34
1656995503367,MATH 103A,B03,093562,Greenfeld; Be'Eri,2,0,36,34
1656995509394,MATH 105,A01,085443,Carter; Anne Toulson,14,0,35,21
1656995509394,MATH 105,A02,093477,Carter; Anne Toulson,20,0,35,15
1656995515429,MATH 109,A01,083213,Ganzberger; Geoffrey Michael,2,0,34,32
1656995515429,MATH 109,A02,083214,Ganzberger; Geoffrey Michael,2,0,34,32
1656995515429,MATH 109,A03,093478,Ganzberger; Geoffrey Michael,1,0,34,33
1656995515429,MATH 109,B01,083215,Ganzberger; Geoffrey Michael,1,0,32,31
1656995515429,MATH 109,B02,083216,Ganzberger; Geoffrey Michael,1,0,32,31
1656995515429,MATH 109,B03,093479,Ganzberger; Geoffrey Michael,6,0,32,26
1656995521458,MATH 142A,A01,083219,Chow; Bennett,6,0,32,26
1656995521458,MATH 142A,A02,083220,Chow; Bennett,10,0,32,22
1656995521458,MATH 142A,A03,093480,Chow; Bennett,7,0,32,25
1656995521458,MATH 142A,B03,093481,Chow; Bennett,7,0,32,25
1656995521458,MATH 142A,B04,093558,Chow; Bennett,11,0,32,21
1656995521458,MATH 142A,B05,093559,Chow; Bennett,6,0,32,26
1656995527480,MATH 193A,A01,083224,Rotar; Vladimir,7,0,34,27
1656995527480,MATH 193A,A02,083225,Rotar; Vladimir,4,0,34,30
1656995527480,MATH 193A,A03,083781,Rotar; Vladimir,1,0,34,33
1656995527480,MATH 193A,A04,083782,Rotar; Vladimir,6,0,34,28
1656995527480,MATH 193A,A05,093482,Rotar; Vladimir,6,0,34,28
1656995533504,MATH 197,001,091859,McAuley; Julian John,9999,0,9999,0
1656995533504,MATH 197,002,095566,Kedlaya; Kiran S.,9997,0,9999,2
1656995533504,MATH 197,003,095567,Xiao; Ming,9999,0,9999,0
1656995533504,MATH 197,004,095571,Perols; Johan Lars,9998,0,9999,1
1656995540564,COGS 9,A01,083615,Shannon; Kyle Michael,7,0,75,68
1656995546587,COGS 11,A01,083617,Boyle; Mary E. T.,20,0,48,28
1656995552612,COGS 13,A01,083071,Bastos; Amalia Pinkusfeld,9,0,71,62
1656995558638,COGS 14A,A01,092681,Semenuks; Arturs,0,1,100,100
1656995564666,COGS 14B,A01,083073,Cheng; Tzu-Han,5,0,63,58
1656995570690,COGS 17,A01,092677,Semenuks; Arturs,4,0,81,77
1656995576716,COGS 100,A01,083619,Allen; Michael Gordon,15,0,70,55
1656995582739,COGS 101A,A01,083621,Davis; Joshua Daniel,9,0,68,59
1656995588761,COGS 101B,A01,091572,Allen; Michael Gordon,8,0,65,57
1656995594787,COGS 101C,A01,083625,Delgado; Tania,17,0,35,18
1656995600809,COGS 107A,A01,083627,Boyle; Mary E. T.,13,0,60,47
1656995606836,COGS 118A,A01,083075,Gupta; Anjum,15,0,76,61
1656995612864,CSE 3,A50,083646,Miranda; Gregory Joseph,22,0,50,28
1656995618892,CSE 8A,A50,083650,Miranda; Gregory Joseph,17,1,56,39
1656995624918,CSE 11,A01,083080,Cao; Yingjun,4,15,40,36
1656995630942,CSE 12,A01,083652,Krause-Levy; Sophia Louisa,20,1,120,100
1656995636968,CSE 15L,A01,083654,Morris; Justin Loren,8,0,50,42
1656995636968,CSE 15L,A02,083655,Morris; Justin Loren,8,0,50,42
1656995642992,CSE 20,A01,083657,Tran; Khoa Dang,37,0,80,43
1656995649016,CSE 21,A01,095574,Bach; Quang Tran,21,0,48,27
1656995655044,CSE 30,A01,083084,Eldon; John,4,0,80,76
1656995655044,CSE 30,B01,095061,Bhaskar; Nishant,6,0,50,44
1656995661066,CSE 100,A01,083659,Cao; Yingjun,3,4,70,67
1656995667100,CSE 134B,A01,083661,Powell; Thomas Allan,19,0,100,81
1656995673128,CSE 140,A01,083663,Gungor; Onat,14,0,85,71
1656995679149,CSE 140L,A01,083088,Eldon; John,16,0,100,84
1656995685172,CSE 175,A01,083665,Kumar; Rakesh,3,0,25,22
1656995691194,CSE 190,A00,092507,Dubnov; Shlomo,7,0,20,13
1656995697223,ECE 45,A01,083139,Congero; Spencer William,5,0,75,70
1656995703252,ECE 65,A50,083695,Saad; Andrew S,12,0,30,18
1656995703252,ECE 65,A51,095125,Saad; Andrew S,25,0,26,1
1656995709278,ECE 109,A01,091882,Touri; Behrouz,16,0,70,54
1656995715306,ECE 180,A00,083140,Abi Samra; Nicholas Camill,1,0,30,29
1656995715306,ECE 180,B00,083141,Abi Samra; Nicholas Camill,0,0,30,30
1656995721329,MATH 10A,A01,083735,Patchell; Gregory David,1,0,30,29
1656995721329,MATH 10A,A02,083736,Patchell; Gregory David,20,0,30,10
1656995721329,MATH 10A,A03,083737,Patchell; Gregory David,15,0,30,15
1656995727359,MATH 10B,A01,083207,Lim; Seonhee,7,0,34,27
1656995727359,MATH 10B,A02,083208,Lim; Seonhee,9,0,35,26
1656995727359,MATH 10B,A03,093472,Lim; Seonhee,4,0,34,30
1656995727359,MATH 10B,B01,083739,Sinha; Shubham,9,0,30,21
1656995733385,MATH 18,A01,083743,Cinel; Cameron Alexander,6,0,30,24
1656995733385,MATH 18,A02,083744,Cinel; Cameron Alexander,15,0,30,15
1656995733385,MATH 18,A03,083745,Cinel; Cameron Alexander,8,0,30,22
1656995733385,MATH 18,B01,083748,Rideout; David Porter,4,0,37,33
1656995733385,MATH 18,B02,083749,Rideout; David Porter,3,0,36,33
1656995733385,MATH 18,B03,083750,Rideout; David Porter,2,0,37,35
1656995733385,MATH 18,B04,083751,Rideout; David Porter,5,0,36,31
1656995733385,MATH 18,B05,093473,Rideout; David Porter,4,0,36,32
1656995733385,MATH 18,B06,093474,Rideout; David Porter,5,0,36,31
1656995739407,MATH 20A,A01,083754,Zheng; Zequn,12,0,40,28
1656995745431,MATH 20B,A01,083756,Briones; Jor-el Thomas Caparas,1,0,36,35
1656995745431,MATH 20B,A02,083757,Briones; Jor-el Thomas Caparas,1,0,36,35
1656995745431,MATH 20B,A03,093475,Briones; Jor-el Thomas Caparas,0,0,36,36
1656995751456,MATH 20C,A01,083760,Briones; Jor-el Thomas Caparas,1,0,35,34
1656995751456,MATH 20C,A02,083761,Briones; Jor-el Thomas Caparas,8,0,35,27
1656995751456,MATH 20C,A03,093476,Briones; Jor-el Thomas Caparas,0,1,36,36
1656995751456,MATH 20C,B01,083762,Bach; Quang Tran,0,0,30,30
1656995757485,MATH 20D,A01,083765,Tran; Brian Kha,4,0,30,26
1656995757485,MATH 20D,A02,083766,Tran; Brian Kha,5,0,30,25
1656995757485,MATH 20D,A03,083767,Tran; Brian Kha,3,0,30,27
1656995763510,MATH 20E,A01,083771,Ganguly; Soumya,5,0,32,27
1656995763510,MATH 20E,A02,083772,Ganguly; Soumya,6,0,32,26
1656995763510,MATH 20E,B01,083773,Ciotti; Benjamin,18,0,35,17
1656995763510,MATH 20E,B02,083774,Ciotti; Benjamin,17,0,35,18
1656995769535,MATH 103A,A01,083777,Greenfeld; Be'Eri,2,0,36,34
1656995769535,MATH 103A,A02,083778,Greenfeld; Be'Eri,5,0,36,31
1656995769535,MATH 103A,A03,093561,Greenfeld; Be'Eri,4,0,36,32
1656995769535,MATH 103A,B01,083779,Greenfeld; Be'Eri,6,0,36,30
1656995769535,MATH 103A,B02,083780,Greenfeld; Be'Eri,2,0,36,34
1656995769535,MATH 103A,B03,093562,Greenfeld; Be'Eri,2,0,36,34
1656995775560,MATH 105,A01,085443,Carter; Anne Toulson,14,0,35,21
1656995775560,MATH 105,A02,093477,Carter; Anne Toulson,20,0,35,15
1656995781588,MATH 109,A01,083213,Ganzberger; Geoffrey Michael,2,0,34,32
1656995781588,MATH 109,A02,083214,Ganzberger; Geoffrey Michael,2,0,34,32
1656995781588,MATH 109,A03,093478,Ganzberger; Geoffrey Michael,1,0,34,33
1656995781588,MATH 109,B01,083215,Ganzberger; Geoffrey Michael,1,0,32,31
1656995781588,MATH 109,B02,083216,Ganzberger; Geoffrey Michael,1,0,32,31
1656995781588,MATH 109,B03,093479,Ganzberger; Geoffrey Michael,6,0,32,26
1656995787618,MATH 142A,A01,083219,Chow; Bennett,6,0,32,26
1656995787618,MATH 142A,A02,083220,Chow; Bennett,10,0,32,22
1656995787618,MATH 142A,A03,093480,Chow; Bennett,7,0,32,25
1656995787618,MATH 142A,B03,093481,Chow; Bennett,7,0,32,25
1656995787618,MATH 142A,B04,093558,Chow; Bennett,11,0,32,21
1656995787618,MATH 142A,B05,093559,Chow; Bennett,6,0,32,26
1656995793644,MATH 193A,A01,083224,Rotar; Vladimir,7,0,34,27
1656995793644,MATH 193A,A02,083225,Rotar; Vladimir,4,0,34,30
1656995793644,MATH 193A,A03,083781,Rotar; Vladimir,1,0,34,33
1656995793644,MATH 193A,A04,083782,Rotar; Vladimir,6,0,34,28
1656995793644,MATH 193A,A05,093482,Rotar; Vladimir,6,0,34,28
1656995799667,MATH 197,001,091859,McAuley; Julian John,9999,0,9999,0
1656995799667,MATH 197,002,095566,Kedlaya; Kiran S.,9997,0,9999,2
1656995799667,MATH 197,003,095567,Xiao; Ming,9999,0,9999,0
1656995799667,MATH 197,004,095571,Perols; Johan Lars,9998,0,9999,1
1656995806736,COGS 9,A01,083615,Shannon; Kyle Michael,7,0,75,68
1656995812768,COGS 11,A01,083617,Boyle; Mary E. T.,20,0,48,28
1656995818792,COGS 13,A01,083071,Bastos; Amalia Pinkusfeld,9,0,71,62
1656995824816,COGS 14A,A01,092681,Semenuks; Arturs,0,1,100,100
1656995830843,COGS 14B,A01,083073,Cheng; Tzu-Han,5,0,63,58
1656995836867,COGS 17,A01,092677,Semenuks; Arturs,4,0,81,77
1656995842891,COGS 100,A01,083619,Allen; Michael Gordon,15,0,70,55
1656995848915,COGS 101A,A01,083621,Davis; Joshua Daniel,9,0,68,59
1656995854938,COGS 101B,A01,091572,Allen; Michael Gordon,8,0,65,57
1656995860962,COGS 101C,A01,083625,Delgado; Tania,17,0,35,18
1656995866992,COGS 107A,A01,083627,Boyle; Mary E. T.,13,0,60,47
1656995873016,COGS 118A,A01,083075,Gupta; Anjum,15,0,76,61
1656995879045,CSE 3,A50,083646,Miranda; Gregory Joseph,22,0,50,28
1656995885071,CSE 8A,A50,083650,Miranda; Gregory Joseph,17,1,56,39
1656995891097,CSE 11,A01,083080,Cao; Yingjun,4,15,40,36
1656995897234,CSE 12,A01,083652,Krause-Levy; Sophia Louisa,20,1,120,100
1656995903256,CSE 15L,A01,083654,Morris; Justin Loren,8,0,50,42
1656995903256,CSE 15L,A02,083655,Morris; Justin Loren,8,0,50,42
1656995909281,CSE 20,A01,083657,Tran; Khoa Dang,37,0,80,43
1656995915308,CSE 21,A01,095574,Bach; Quang Tran,21,0,48,27
1656995921347,CSE 30,A01,083084,Eldon; John,4,0,80,76
1656995921347,CSE 30,B01,095061,Bhaskar; Nishant,6,0,50,44
1656995927370,CSE 100,A01,083659,Cao; Yingjun,3,4,70,67
1656995933394,CSE 134B,A01,083661,Powell; Thomas Allan,19,0,100,81
1656995939415,CSE 140,A01,083663,Gungor; Onat,14,0,85,71
1656995945443,CSE 140L,A01,083088,Eldon; John,16,0,100,84
1656995951466,CSE 175,A01,083665,Kumar; Rakesh,3,0,25,22
1656995957488,CSE 190,A00,092507,Dubnov; Shlomo,7,0,20,13
1656995963519,ECE 45,A01,083139,Congero; Spencer William,5,0,75,70
1656995969546,ECE 65,A50,083695,Saad; Andrew S,12,0,30,18
1656995969546,ECE 65,A51,095125,Saad; Andrew S,25,0,26,1
1656995975569,ECE 109,A01,091882,Touri; Behrouz,16,0,70,54
1656995981593,ECE 180,A00,083140,Abi Samra; Nicholas Camill,1,0,30,29
1656995981593,ECE 180,B00,083141,Abi Samra; Nicholas Camill,0,0,30,30
1656995987620,MATH 10A,A01,083735,Patchell; Gregory David,1,0,30,29
1656995987620,MATH 10A,A02,083736,Patchell; Gregory David,20,0,30,10
1656995987620,MATH 10A,A03,083737,Patchell; Gregory David,15,0,30,15
1656995993650,MATH 10B,A01,083207,Lim; Seonhee,7,0,34,27
1656995993650,MATH 10B,A02,083208,Lim; Seonhee,9,0,35,26
1656995993650,MATH 10B,A03,093472,Lim; Seonhee,4,0,34,30
1656995993650,MATH 10B,B01,083739,Sinha; Shubham,9,0,30,21
1656995999675,MATH 18,A01,083743,Cinel; Cameron Alexander,6,0,30,24
1656995999675,MATH 18,A02,083744,Cinel; Cameron Alexander,15,0,30,15
1656995999675,MATH 18,A03,083745,Cinel; Cameron Alexander,8,0,30,22
1656995999675,MATH 18,B01,083748,Rideout; David Porter,4,0,37,33
1656995999675,MATH 18,B02,083749,Rideout; David Porter,3,0,36,33
1656995999675,MATH 18,B03,083750,Rideout; David Porter,2,0,37,35
1656995999675,MATH 18,B04,083751,Rideout; David Porter,5,0,36,31
1656995999675,MATH 18,B05,093473,Rideout; David Porter,4,0,36,32
1656995999675,MATH 18,B06,093474,Rideout; David Porter,5,0,36,31
1656996005702,MATH 20A,A01,083754,Zheng; Zequn,12,0,40,28
1656996011728,MATH 20B,A01,083756,Briones; Jor-el Thomas Caparas,1,0,36,35
1656996011728,MATH 20B,A02,083757,Briones; Jor-el Thomas Caparas,1,0,36,35
1656996011728,MATH 20B,A03,093475,Briones; Jor-el Thomas Caparas,0,0,36,36
1656996017758,MATH 20C,A01,083760,Briones; Jor-el Thomas Caparas,1,0,35,34
1656996017758,MATH 20C,A02,083761,Briones; Jor-el Thomas Caparas,8,0,35,27
1656996017758,MATH 20C,A03,093476,Briones; Jor-el Thomas Caparas,0,1,36,36
1656996017758,MATH 20C,B01,083762,Bach; Quang Tran,0,0,30,30
1656996023783,MATH 20D,A01,083765,Tran; Brian Kha,4,0,30,26
1656996023783,MATH 20D,A02,083766,Tran; Brian Kha,5,0,30,25
1656996023783,MATH 20D,A03,083767,Tran; Brian Kha,3,0,30,27
1656996029809,MATH 20E,A01,083771,Ganguly; Soumya,5,0,32,27
1656996029809,MATH 20E,A02,083772,Ganguly; Soumya,6,0,32,26
1656996029809,MATH 20E,B01,083773,Ciotti; Benjamin,18,0,35,17
1656996029809,MATH 20E,B02,083774,Ciotti; Benjamin,17,0,35,18
1656996035837,MATH 103A,A01,083777,Greenfeld; Be'Eri,2,0,36,34
1656996035837,MATH 103A,A02,083778,Greenfeld; Be'Eri,5,0,36,31
1656996035837,MATH 103A,A03,093561,Greenfeld; Be'Eri,4,0,36,32
1656996035837,MATH 103A,B01,083779,Greenfeld; Be'Eri,6,0,36,30
1656996035837,MATH 103A,B02,083780,Greenfeld; Be'Eri,2,0,36,34
1656996035837,MATH 103A,B03,093562,Greenfeld; Be'Eri,2,0,36,34
1656996041859,MATH 105,A01,085443,Carter; Anne Toulson,14,0,35,21
1656996041859,MATH 105,A02,093477,Carter; Anne Toulson,20,0,35,15
1656996047884,MATH 109,A01,083213,Ganzberger; Geoffrey Michael,2,0,34,32
1656996047884,MATH 109,A02,083214,Ganzberger; Geoffrey Michael,2,0,34,32
1656996047884,MATH 109,A03,093478,Ganzberger; Geoffrey Michael,1,0,34,33
1656996047884,MATH 109,B01,083215,Ganzberger; Geoffrey Michael,1,0,32,31
1656996047884,MATH 109,B02,083216,Ganzberger; Geoffrey Michael,1,0,32,31
1656996047884,MATH 109,B03,093479,Ganzberger; Geoffrey Michael,6,0,32,26
1656996053912,MATH 142A,A01,083219,Chow; Bennett,6,0,32,26
1656996053912,MATH 142A,A02,083220,Chow; Bennett,10,0,32,22
1656996053912,MATH 142A,A03,093480,Chow; Bennett,7,0,32,25
1656996053912,MATH 142A,B03,093481,Chow; Bennett,7,0,32,25
1656996053912,MATH 142A,B04,093558,Chow; Bennett,11,0,32,21
1656996053912,MATH 142A,B05,093559,Chow; Bennett,6,0,32,26
1656996059936,MATH 193A,A01,083224,Rotar; Vladimir,7,0,34,27
1656996059936,MATH 193A,A02,083225,Rotar; Vladimir,4,0,34,30
1656996059936,MATH 193A,A03,083781,Rotar; Vladimir,1,0,34,33
1656996059936,MATH 193A,A04,083782,Rotar; Vladimir,6,0,34,28
1656996059936,MATH 193A,A05,093482,Rotar; Vladimir,6,0,34,28
1656996065964,MATH 197,001,091859,McAuley; Julian John,9999,0,9999,0
1656996065964,MATH 197,002,095566,Kedlaya; Kiran S.,9997,0,9999,2
1656996065964,MATH 197,003,095567,Xiao; Ming,9999,0,9999,0
1656996065964,MATH 197,004,095571,Perols; Johan Lars,9998,0,9999,1
1656996073033,COGS 9,A01,083615,Shannon; Kyle Michael,7,0,75,68
1656996079056,COGS 11,A01,083617,Boyle; Mary E. T.,20,0,48,28
1656996085085,COGS 13,A01,083071,Bastos; Amalia Pinkusfeld,9,0,71,62
1656996091110,COGS 14A,A01,092681,Semenuks; Arturs,0,1,100,100
1656996097137,COGS 14B,A01,083073,Cheng; Tzu-Han,5,0,63,58
1656996103161,COGS 17,A01,092677,Semenuks; Arturs,4,0,81,77
1656996109185,COGS 100,A01,083619,Allen; Michael Gordon,15,0,70,55
1656996115207,COGS 101A,A01,083621,Davis; Joshua Daniel,9,0,68,59
1656996121233,COGS 101B,A01,091572,Allen; Michael Gordon,8,0,65,57
1656996127256,COGS 101C,A01,083625,Delgado; Tania,17,0,35,18
1656996133279,COGS 107A,A01,083627,Boyle; Mary E. T.,13,0,60,47
1656996139304,COGS 118A,A01,083075,Gupta; Anjum,15,0,76,61
1656996145333,CSE 3,A50,083646,Miranda; Gregory Joseph,22,0,50,28
1656996151360,CSE 8A,A50,083650,Miranda; Gregory Joseph,17,1,56,39
1656996157384,CSE 11,A01,083080,Cao; Yingjun,4,15,40,36
1656996163407,CSE 12,A01,083652,Krause-Levy; Sophia Louisa,20,1,120,100
1656996169430,CSE 15L,A01,083654,Morris; Justin Loren,8,0,50,42
1656996169430,CSE 15L,A02,083655,Morris; Justin Loren,8,0,50,42
1656996175460,CSE 20,A01,083657,Tran; Khoa Dang,37,0,80,43
1656996181483,CSE 21,A01,095574,Bach; Quang Tran,21,0,48,27
1656996187506,CSE 30,A01,083084,Eldon; John,4,0,80,76
1656996187506,CSE 30,B01,095061,Bhaskar; Nishant,6,0,50,44
1656996193532,CSE 100,A01,083659,Cao; Yingjun,3,4,70,67
1656996199554,CSE 134B,A01,083661,Powell; Thomas Allan,19,0,100,81
1656996205580,CSE 140,A01,083663,Gungor; Onat,14,0,85,71
1656996211607,CSE 140L,A01,083088,Eldon; John,16,0,100,84
1656996217634,CSE 175,A01,083665,Kumar; Rakesh,3,0,25,22
1656996223658,CSE 190,A00,092507,Dubnov; Shlomo,7,0,20,13
1656996229684,ECE 45,A01,083139,Congero; Spencer William,5,0,75,70
1656996235708,ECE 65,A50,083695,Saad; Andrew S,12,0,30,18
1656996235708,ECE 65,A51,095125,Saad; Andrew S,25,0,26,1
1656996241739,ECE 109,A01,091882,Touri; Behrouz,16,0,70,54
1656996247760,ECE 180,A00,083140,Abi Samra; Nicholas Camill,1,0,30,29
1656996247760,ECE 180,B00,083141,Abi Samra; Nicholas Camill,0,0,30,30
1656996253787,MATH 10A,A01,083735,Patchell; Gregory David,1,0,30,29
1656996253787,MATH 10A,A02,083736,Patchell; Gregory David,20,0,30,10
1656996253787,MATH 10A,A03,083737,Patchell; Gregory David,16,0,30,14
1656996259813,MATH 10B,A01,083207,Lim; Seonhee,7,0,34,27
1656996259813,MATH 10B,A02,083208,Lim; Seonhee,9,0,35,26
1656996259813,MATH 10B,A03,093472,Lim; Seonhee,4,0,34,30
1656996259813,MATH 10B,B01,083739,Sinha; Shubham,9,0,30,21
1656996265843,MATH 18,A01,083743,Cinel; Cameron Alexander,6,0,30,24
1656996265843,MATH 18,A02,083744,Cinel; Cameron Alexander,15,0,30,15
1656996265843,MATH 18,A03,083745,Cinel; Cameron Alexander,8,0,30,22
1656996265843,MATH 18,B01,083748,Rideout; David Porter,4,0,37,33
1656996265843,MATH 18,B02,083749,Rideout; David Porter,3,0,36,33
1656996265843,MATH 18,B03,083750,Rideout; David Porter,2,0,37,35
1656996265843,MATH 18,B04,083751,Rideout; David Porter,5,0,36,31
1656996265843,MATH 18,B05,093473,Rideout; David Porter,4,0,36,32
1656996265843,MATH 18,B06,093474,Rideout; David Porter,5,0,36,31
1656996271870,MATH 20A,A01,083754,Zheng; Zequn,12,0,40,28
1656996277909,MATH 20B,A01,083756,Briones; Jor-el Thomas Caparas,1,0,36,35
1656996277909,MATH 20B,A02,083757,Briones; Jor-el Thomas Caparas,1,0,36,35
1656996277909,MATH 20B,A03,093475,Briones; Jor-el Thomas Caparas,0,0,36,36
1656996283937,MATH 20C,A01,083760,Briones; Jor-el Thomas Caparas,1,0,35,34
1656996283937,MATH 20C,A02,083761,Briones; Jor-el Thomas Caparas,8,0,35,27
1656996283937,MATH 20C,A03,093476,Briones; Jor-el Thomas Caparas,0,1,36,36
1656996283937,MATH 20C,B01,083762,Bach; Quang Tran,0,0,30,30
1656996289960,MATH 20D,A01,083765,Tran; Brian Kha,4,0,30,26
1656996289960,MATH 20D,A02,083766,Tran; Brian Kha,5,0,30,25
1656996289960,MATH 20D,A03,083767,Tran; Brian Kha,3,0,30,27
1656996295984,MATH 20E,A01,083771,Ganguly; Soumya,5,0,32,27
1656996295984,MATH 20E,A02,083772,Ganguly; Soumya,6,0,32,26
1656996295984,MATH 20E,B01,083773,Ciotti; Benjamin,18,0,35,17
1656996295984,MATH 20E,B02,083774,Ciotti; Benjamin,17,0,35,18
1656996302012,MATH 103A,A01,083777,Greenfeld; Be'Eri,2,0,36,34
1656996302012,MATH 103A,A02,083778,Greenfeld; Be'Eri,5,0,36,31
1656996302012,MATH 103A,A03,093561,Greenfeld; Be'Eri,4,0,36,32
1656996302012,MATH 103A,B01,083779,Greenfeld; Be'Eri,6,0,36,30
1656996302012,MATH 103A,B02,083780,Greenfeld; Be'Eri,2,0,36,34
1656996302012,MATH 103A,B03,093562,Greenfeld; Be'Eri,2,0,36,34
1656996308034,MATH 105,A01,085443,Carter; Anne Toulson,14,0,35,21
1656996308034,MATH 105,A02,093477,Carter; Anne Toulson,20,0,35,15
1656996314057,MATH 109,A01,083213,Ganzberger; Geoffrey Michael,2,0,34,32
1656996314057,MATH 109,A02,083214,Ganzberger; Geoffrey Michael,2,0,34,32
1656996314057,MATH 109,A03,093478,Ganzberger; Geoffrey Michael,1,0,34,33
1656996314057,MATH 109,B01,083215,Ganzberger; Geoffrey Michael,1,0,32,31
1656996314057,MATH 109,B02,083216,Ganzberger; Geoffrey Michael,1,0,32,31
1656996314057,MATH 109,B03,093479,Ganzberger; Geoffrey Michael,6,0,32,26
1656996320081,MATH 142A,A01,083219,Chow; Bennett,6,0,32,26
1656996320081,MATH 142A,A02,083220,Chow; Bennett,10,0,32,22
1656996320081,MATH 142A,A03,093480,Chow; Bennett,7,0,32,25
1656996320081,MATH 142A,B03,093481,Chow; Bennett,7,0,32,25
1656996320081,MATH 142A,B04,093558,Chow; Bennett,11,0,32,21
1656996320081,MATH 142A,B05,093559,Chow; Bennett,6,0,32,26
1656996326106,MATH 193A,A01,083224,Rotar; Vladimir,7,0,34,27
1656996326106,MATH 193A,A02,083225,Rotar; Vladimir,4,0,34,30
1656996326106,MATH 193A,A03,083781,Rotar; Vladimir,1,0,34,33
1656996326106,MATH 193A,A04,083782,Rotar; Vladimir,6,0,34,28
1656996326106,MATH 193A,A05,093482,Rotar; Vladimir,6,0,34,28
1656996332133,MATH 197,001,091859,McAuley; Julian John,9999,0,9999,0
1656996332133,MATH 197,002,095566,Kedlaya; Kiran S.,9997,0,9999,2
1656996332133,MATH 197,003,095567,Xiao; Ming,9999,0,9999,0
1656996332133,MATH 197,004,095571,Perols; Johan Lars,9998,0,9999,1
1656996339190,COGS 9,A01,083615,Shannon; Kyle Michael,7,0,75,68
1656996345214,COGS 11,A01,083617,Boyle; Mary E. T.,20,0,48,28
1656996351241,COGS 13,A01,083071,Bastos; Amalia Pinkusfeld,9,0,71,62
1656996357268,COGS 14A,A01,092681,Semenuks; Arturs,0,1,100,100
1656996363294,COGS 14B,A01,083073,Cheng; Tzu-Han,5,0,63,58
1656996369316,COGS 17,A01,092677,Semenuks; Arturs,4,0,81,77
1656996375342,COGS 100,A01,083619,Allen; Michael Gordon,15,0,70,55
1656996381374,COGS 101A,A01,083621,Davis; Joshua Daniel,9,0,68,59
1656996387404,COGS 101B,A01,091572,Allen; Michael Gordon,8,0,65,57
1656996393430,COGS 101C,A01,083625,Delgado; Tania,17,0,35,18
1656996399453,COGS 107A,A01,083627,Boyle; Mary E. T.,13,0,60,47
1656996405476,COGS 118A,A01,083075,Gupta; Anjum,15,0,76,61
1656996411499,CSE 3,A50,083646,Miranda; Gregory Joseph,22,0,50,28
1656996417529,CSE 8A,A50,083650,Miranda; Gregory Joseph,17,1,56,39
1656996423552,CSE 11,A01,083080,Cao; Yingjun,4,15,40,36
1656996429574,CSE 12,A01,083652,Krause-Levy; Sophia Louisa,20,1,120,100
1656996435600,CSE 15L,A01,083654,Morris; Justin Loren,8,0,50,42
1656996435600,CSE 15L,A02,083655,Morris; Justin Loren,8,0,50,42
1656996441625,CSE 20,A01,083657,Tran; Khoa Dang,37,0,80,43
1656996447650,CSE 21,A01,095574,Bach; Quang Tran,21,0,48,27
1656996453677,CSE 30,A01,083084,Eldon; John,4,0,80,76
1656996453677,CSE 30,B01,095061,Bhaskar; Nishant,6,0,50,44
1656996459699,CSE 100,A01,083659,Cao; Yingjun,3,4,70,67
1656996465727,CSE 134B,A01,083661,Powell; Thomas Allan,19,0,100,81
1656996471752,CSE 140,A01,083663,Gungor; Onat,14,0,85,71
1656996477780,CSE 140L,A01,083088,Eldon; John,16,0,100,84
1656996483802,CSE 175,A01,083665,Kumar; Rakesh,3,0,25,22
1656996489826,CSE 190,A00,092507,Dubnov; Shlomo,7,0,20,13
1656996495923,ECE 45,A01,083139,Congero; Spencer William,5,0,75,70
1656996501950,ECE 65,A50,083695,Saad; Andrew S,12,0,30,18
1656996501950,ECE 65,A51,095125,Saad; Andrew S,25,0,26,1
1656996507971,ECE 109,A01,091882,Touri; Behrouz,16,0,70,54
1656996513995,ECE 180,A00,083140,Abi Samra; Nicholas Camill,1,0,30,29
1656996513995,ECE 180,B00,083141,Abi Samra; Nicholas Camill,0,0,30,30
1656996520017,MATH 10A,A01,083735,Patchell; Gregory David,1,0,30,29
1656996520017,MATH 10A,A02,083736,Patchell; Gregory David,20,0,30,10
1656996520017,MATH 10A,A03,083737,Patchell; Gregory David,16,0,30,14
1656996526040,MATH 10B,A01,083207,Lim; Seonhee,7,0,34,27
1656996526040,MATH 10B,A02,083208,Lim; Seonhee,9,0,35,26
1656996526040,MATH 10B,A03,093472,Lim; Seonhee,4,0,34,30
1656996526040,MATH 10B,B01,083739,Sinha; Shubham,9,0,30,21
1656996532072,MATH 18,A01,083743,Cinel; Cameron Alexander,6,0,30,24
1656996532072,MATH 18,A02,083744,Cinel; Cameron Alexander,15,0,30,15
1656996532072,MATH 18,A03,083745,Cinel; Cameron Alexander,8,0,30,22
1656996532072,MATH 18,B01,083748,Rideout; David Porter,4,0,37,33
1656996532072,MATH 18,B02,083749,Rideout; David Porter,3,0,36,33
1656996532072,MATH 18,B03,083750,Rideout; David Porter,2,0,37,35
1656996532072,MATH 18,B04,083751,Rideout; David Porter,5,0,36,31
1656996532072,MATH 18,B05,093473,Rideout; David Porter,4,0,36,32
1656996532072,MATH 18,B06,093474,Rideout; David Porter,5,0,36,31
1656996538098,MATH 20A,A01,083754,Zheng; Zequn,12,0,40,28
1656996544122,MATH 20B,A01,083756,Briones; Jor-el Thomas Caparas,1,0,36,35
1656996544122,MATH 20B,A02,083757,Briones; Jor-el Thomas Caparas,1,0,36,35
1656996544122,MATH 20B,A03,093475,Briones; Jor-el Thomas Caparas,0,0,36,36
1656996550148,MATH 20C,A01,083760,Briones; Jor-el Thomas Caparas,1,0,35,34
1656996550148,MATH 20C,A02,083761,Briones; Jor-el Thomas Caparas,8,0,35,27
1656996550148,MATH 20C,A03,093476,Briones; Jor-el Thomas Caparas,0,1,36,36
1656996550148,MATH 20C,B01,083762,Bach; Quang Tran,0,0,30,30
1656996556173,MATH 20D,A01,083765,Tran; Brian Kha,4,0,30,26
1656996556173,MATH 20D,A02,083766,Tran; Brian Kha,5,0,30,25
1656996556173,MATH 20D,A03,083767,Tran; Brian Kha,3,0,30,27
1656996562196,MATH 20E,A01,083771,Ganguly; Soumya,5,0,32,27
1656996562196,MATH 20E,A02,083772,Ganguly; Soumya,6,0,32,26
1656996562196,MATH 20E,B01,083773,Ciotti; Benjamin,18,0,35,17
1656996562196,MATH 20E,B02,083774,Ciotti; Benjamin,17,0,35,18
1656996568227,MATH 103A,A01,083777,Greenfeld; Be'Eri,2,0,36,34
1656996568227,MATH 103A,A02,083778,Greenfeld; Be'Eri,5,0,36,31
1656996568227,MATH 103A,A03,093561,Greenfeld; Be'Eri,4,0,36,32
1656996568227,MATH 103A,B01,083779,Greenfeld; Be'Eri,6,0,36,30
1656996568227,MATH 103A,B02,083780,Greenfeld; Be'Eri,2,0,36,34
1656996568227,MATH 103A,B03,093562,Greenfeld; Be'Eri,2,0,36,34
1656996574250,MATH 105,A01,085443,Carter; Anne Toulson,14,0,35,21
1656996574250,MATH 105,A02,093477,Carter; Anne Toulson,20,0,35,15
1656996580278,MATH 109,A01,083213,Ganzberger; Geoffrey Michael,2,0,34,32
1656996580278,MATH 109,A02,083214,Ganzberger; Geoffrey Michael,2,0,34,32
1656996580278,MATH 109,A03,093478,Ganzberger; Geoffrey Michael,1,0,34,33
1656996580278,MATH 109,B01,083215,Ganzberger; Geoffrey Michael,1,0,32,31
1656996580278,MATH 109,B02,083216,Ganzberger; Geoffrey Michael,1,0,32,31
1656996580278,MATH 109,B03,093479,Ganzberger; Geoffrey Michael,6,0,32,26
1656996586303,MATH 142A,A01,083219,Chow; Bennett,6,0,32,26
1656996586303,MATH 142A,A02,083220,Chow; Bennett,10,0,32,22
1656996586303,MATH 142A,A03,093480,Chow; Bennett,7,0,32,25
1656996586303,MATH 142A,B03,093481,Chow; Bennett,7,0,32,25
1656996586303,MATH 142A,B04,093558,Chow; Bennett,11,0,32,21
1656996586303,MATH 142A,B05,093559,Chow; Bennett,6,0,32,26
1656996592327,MATH 193A,A01,083224,Rotar; Vladimir,7,0,34,27
1656996592327,MATH 193A,A02,083225,Rotar; Vladimir,4,0,34,30
1656996592327,MATH 193A,A03,083781,Rotar; Vladimir,1,0,34,33
1656996592327,MATH 193A,A04,083782,Rotar; Vladimir,6,0,34,28
1656996592327,MATH 193A,A05,093482,Rotar; Vladimir,6,0,34,28
1656996598351,MATH 197,001,091859,McAuley; Julian John,9999,0,9999,0
1656996598351,MATH 197,002,095566,Kedlaya; Kiran S.,9997,0,9999,2
1656996598351,MATH 197,003,095567,Xiao; Ming,9999,0,9999,0
1656996598351,MATH 197,004,095571,Perols; Johan Lars,9998,0,9999,1
1656996605409,COGS 9,A01,083615,Shannon; Kyle Michael,7,0,75,68
1656996611436,COGS 11,A01,083617,Boyle; Mary E. T.,20,0,48,28
1656996617462,COGS 13,A01,083071,Bastos; Amalia Pinkusfeld,9,0,71,62
1656996623486,COGS 14A,A01,092681,Semenuks; Arturs,0,1,100,100
1656996629509,COGS 14B,A01,083073,Cheng; Tzu-Han,5,0,63,58
1656996635535,COGS 17,A01,092677,Semenuks; Arturs,4,0,81,77
1656996641562,COGS 100,A01,083619,Allen; Michael Gordon,15,0,70,55
1656996647589,COGS 101A,A01,083621,Davis; Joshua Daniel,9,0,68,59
1656996653613,COGS 101B,A01,091572,Allen; Michael Gordon,8,0,65,57
1656996659640,COGS 101C,A01,083625,Delgado; Tania,17,0,35,18
1656996665667,COGS 107A,A01,083627,Boyle; Mary E. T.,13,0,60,47
1656996671691,COGS 118A,A01,083075,Gupta; Anjum,15,0,76,61
1656996677723,CSE 3,A50,083646,Miranda; Gregory Joseph,22,0,50,28
1656996683750,CSE 8A,A50,083650,Miranda; Gregory Joseph,17,1,56,39
1656996689774,CSE 11,A01,083080,Cao; Yingjun,4,15,40,36
1656996695797,CSE 12,A01,083652,Krause-Levy; Sophia Louisa,20,1,120,100
1656996701823,CSE 15L,A01,083654,Morris; Justin Loren,8,0,50,42
1656996701823,CSE 15L,A02,083655,Morris; Justin Loren,8,0,50,42
1656996707847,CSE 20,A01,083657,Tran; Khoa Dang,37,0,80,43
1656996713870,CSE 21,A01,095574,Bach; Quang Tran,21,0,48,27
1656996719895,CSE 30,A01,083084,Eldon; John,4,0,80,76
1656996719895,CSE 30,B01,095061,Bhaskar; Nishant,6,0,50,44
1656996725922,CSE 100,A01,083659,Cao; Yingjun,3,4,70,67
1656996731947,CSE 134B,A01,083661,Powell; Thomas Allan,19,0,100,81
1656996737976,CSE 140,A01,083663,Gungor; Onat,14,0,85,71
1656996744000,CSE 140L,A01,083088,Eldon; John,16,0,100,84
1656996750025,CSE 175,A01,083665,Kumar; Rakesh,3,0,25,22
1656996756050,CSE 190,A00,092507,Dubnov; Shlomo,7,0,20,13
1656996762074,ECE 45,A01,083139,Congero; Spencer William,5,0,75,70
1656996768098,ECE 65,A50,083695,Saad; Andrew S,12,0,30,18
1656996768098,ECE 65,A51,095125,Saad; Andrew S,25,0,26,1
1656996774123,ECE 109,A01,091882,Touri; Behrouz,16,0,70,54
1656996780148,ECE 180,A00,083140,Abi Samra; Nicholas Camill,1,0,30,29
1656996780148,ECE 180,B00,083141,Abi Samra; Nicholas Camill,0,0,30,30
1656996786172,MATH 10A,A01,083735,Patchell; Gregory David,1,0,30,29
1656996786172,MATH 10A,A02,083736,Patchell; Gregory David,20,0,30,10
1656996786172,MATH 10A,A03,083737,Patchell; Gregory David,16,0,30,14
1656996792200,MATH 10B,A01,083207,Lim; Seonhee,7,0,34,27
1656996792200,MATH 10B,A02,083208,Lim; Seonhee,9,0,35,26
1656996792200,MATH 10B,A03,093472,Lim; Seonhee,4,0,34,30
1656996792200,MATH 10B,B01,083739,Sinha; Shubham,9,0,30,21
1656996798239,MATH 18,A01,083743,Cinel; Cameron Alexander,6,0,30,24
1656996798239,MATH 18,A02,083744,Cinel; Cameron Alexander,15,0,30,15
1656996798239,MATH 18,A03,083745,Cinel; Cameron Alexander,8,0,30,22
1656996798239,MATH 18,B01,083748,Rideout; David Porter,4,0,37,33
1656996798239,MATH 18,B02,083749,Rideout; David Porter,3,0,36,33
1656996798239,MATH 18,B03,083750,Rideout; David Porter,2,0,37,35
1656996798239,MATH 18,B04,083751,Rideout; David Porter,5,0,36,31
1656996798239,MATH 18,B05,093473,Rideout; David Porter,4,0,36,32
1656996798239,MATH 18,B06,093474,Rideout; David Porter,5,0,36,31
1656996804270,MATH 20A,A01,083754,Zheng; Zequn,12,0,40,28
1656996810297,MATH 20B,A01,083756,Briones; Jor-el Thomas Caparas,1,0,36,35
1656996810297,MATH 20B,A02,083757,Briones; Jor-el Thomas Caparas,1,0,36,35
1656996810297,MATH 20B,A03,093475,Briones; Jor-el Thomas Caparas,0,0,36,36
1656996816325,MATH 20C,A01,083760,Briones; Jor-el Thomas Caparas,1,0,35,34
1656996816325,MATH 20C,A02,083761,Briones; Jor-el Thomas Caparas,8,0,35,27
1656996816325,MATH 20C,A03,093476,Briones; Jor-el Thomas Caparas,0,1,36,36
1656996816325,MATH 20C,B01,083762,Bach; Quang Tran,0,0,30,30
1656996822348,MATH 20D,A01,083765,Tran; Brian Kha,4,0,30,26
1656996822348,MATH 20D,A02,083766,Tran; Brian Kha,5,0,30,25
1656996822348,MATH 20D,A03,083767,Tran; Brian Kha,3,0,30,27
1656996828372,MATH 20E,A01,083771,Ganguly; Soumya,5,0,32,27
1656996828372,MATH 20E,A02,083772,Ganguly; Soumya,6,0,32,26
1656996828372,MATH 20E,B01,083773,Ciotti; Benjamin,18,0,35,17
1656996828372,MATH 20E,B02,083774,Ciotti; Benjamin,17,0,35,18
1656996834396,MATH 103A,A01,083777,Greenfeld; Be'Eri,2,0,36,34
1656996834396,MATH 103A,A02,083778,Greenfeld; Be'Eri,5,0,36,31
1656996834396,MATH 103A,A03,093561,Greenfeld; Be'Eri,4,0,36,32
1656996834396,MATH 103A,B01,083779,Greenfeld; Be'Eri,6,0,36,30
1656996834396,MATH 103A,B02,083780,Greenfeld; Be'Eri,2,0,36,34
1656996834396,MATH 103A,B03,093562,Greenfeld; Be'Eri,2,0,36,34
1656996840423,MATH 105,A01,085443,Carter; Anne Toulson,14,0,35,21
1656996840423,MATH 105,A02,093477,Carter; Anne Toulson,20,0,35,15
1656996846446,MATH 109,A01,083213,Ganzberger; Geoffrey Michael,2,0,34,32
1656996846446,MATH 109,A02,083214,Ganzberger; Geoffrey Michael,2,0,34,32
1656996846446,MATH 109,A03,093478,Ganzberger; Geoffrey Michael,1,0,34,33
1656996846446,MATH 109,B01,083215,Ganzberger; Geoffrey Michael,1,0,32,31
1656996846446,MATH 109,B02,083216,Ganzberger; Geoffrey Michael,1,0,32,31
1656996846446,MATH 109,B03,093479,Ganzberger; Geoffrey Michael,6,0,32,26
1656996852469,MATH 142A,A01,083219,Chow; Bennett,6,0,32,26
1656996852469,MATH 142A,A02,083220,Chow; Bennett,10,0,32,22
1656996852469,MATH 142A,A03,093480,Chow; Bennett,7,0,32,25
1656996852469,MATH 142A,B03,093481,Chow; Bennett,7,0,32,25
1656996852469,MATH 142A,B04,093558,Chow; Bennett,11,0,32,21
1656996852469,MATH 142A,B05,093559,Chow; Bennett,6,0,32,26
1656996858494,MATH 193A,A01,083224,Rotar; Vladimir,7,0,34,27
1656996858494,MATH 193A,A02,083225,Rotar; Vladimir,4,0,34,30
1656996858494,MATH 193A,A03,083781,Rotar; Vladimir,1,0,34,33
1656996858494,MATH 193A,A04,083782,Rotar; Vladimir,6,0,34,28
1656996858494,MATH 193A,A05,093482,Rotar; Vladimir,6,0,34,28
1656996864519,MATH 197,001,091859,McAuley; Julian John,9999,0,9999,0
1656996864519,MATH 197,002,095566,Kedlaya; Kiran S.,9997,0,9999,2
1656996864519,MATH 197,003,095567,Xiao; Ming,9999,0,9999,0
1656996864519,MATH 197,004,095571,Perols; Johan Lars,9998,0,9999,1
1656996871571,COGS 9,A01,083615,Shannon; Kyle Michael,7,0,75,68
1656996877597,COGS 11,A01,083617,Boyle; Mary E. T.,20,0,48,28
1656996883626,COGS 13,A01,083071,Bastos; Amalia Pinkusfeld,9,0,71,62
1656996889648,COGS 14A,A01,092681,Semenuks; Arturs,0,1,100,100
1656996895671,COGS 14B,A01,083073,Cheng; Tzu-Han,5,0,63,58
1656996901698,COGS 17,A01,092677,Semenuks; Arturs,4,0,81,77
1656996907720,COGS 100,A01,083619,Allen; Michael Gordon,15,0,70,55
1656996913742,COGS 101A,A01,083621,Davis; Joshua Daniel,9,0,68,59
1656996919768,COGS 101B,A01,091572,Allen; Michael Gordon,8,0,65,57
1656996925794,COGS 101C,A01,083625,Delgado; Tania,17,0,35,18
1656996931820,COGS 107A,A01,083627,Boyle; Mary E. T.,13,0,60,47
1656996937842,COGS 118A,A01,083075,Gupta; Anjum,15,0,76,61
1656996943864,CSE 3,A50,083646,Miranda; Gregory Joseph,22,0,50,28
1656996949886,CSE 8A,A50,083650,Miranda; Gregory Joseph,17,1,56,39
1656996955910,CSE 11,A01,083080,Cao; Yingjun,4,15,40,36
1656996961932,CSE 12,A01,083652,Krause-Levy; Sophia Louisa,20,1,120,100
1656996967964,CSE 15L,A01,083654,Morris; Justin Loren,8,0,50,42
1656996967964,CSE 15L,A02,083655,Morris; Justin Loren,8,0,50,42
1656996973999,CSE 20,A01,083657,Tran; Khoa Dang,37,0,80,43
1656996980026,CSE 21,A01,095574,Bach; Quang Tran,21,0,48,27
1656996986054,CSE 30,A01,083084,Eldon; John,4,0,80,76
1656996986054,CSE 30,B01,095061,Bhaskar; Nishant,6,0,50,44
1656996992083,CSE 100,A01,083659,Cao; Yingjun,3,4,70,67
1656996998114,CSE 134B,A01,083661,Powell; Thomas Allan,19,0,100,81
1656997004140,CSE 140,A01,083663,Gungor; Onat,14,0,85,71
1656997010163,CSE 140L,A01,083088,Eldon; John,16,0,100,84
1656997016185,CSE 175,A01,083665,Kumar; Rakesh,3,0,25,22
1656997022212,CSE 190,A00,092507,Dubnov; Shlomo,7,0,20,13
1656997028239,ECE 45,A01,083139,Congero; Spencer William,5,0,75,70
1656997034265,ECE 65,A50,083695,Saad; Andrew S,12,0,30,18
1656997034265,ECE 65,A51,095125,Saad; Andrew S,25,0,26,1
1656997040288,ECE 109,A01,091882,Touri; Behrouz,16,0,70,54
1656997046313,ECE 180,A00,083140,Abi Samra; Nicholas Camill,1,0,30,29
1656997046313,ECE 180,B00,083141,Abi Samra; Nicholas Camill,0,0,30,30
1656997052339,MATH 10A,A01,083735,Patchell; Gregory David,1,0,30,29
1656997052339,MATH 10A,A02,083736,Patchell; Gregory David,20,0,30,10
1656997052339,MATH 10A,A03,083737,Patchell; Gregory David,16,0,30,14
1656997058363,MATH 10B,A01,083207,Lim; Seonhee,7,0,34,27
1656997058363,MATH 10B,A02,083208,Lim; Seonhee,9,0,35,26
1656997058363,MATH 10B,A03,093472,Lim; Seonhee,4,0,34,30
1656997058363,MATH 10B,B01,083739,Sinha; Shubham,9,0,30,21
1656997064395,MATH 18,A01,083743,Cinel; Cameron Alexander,6,0,30,24
1656997064395,MATH 18,A02,083744,Cinel; Cameron Alexander,15,0,30,15
1656997064395,MATH 18,A03,083745,Cinel; Cameron Alexander,8,0,30,22
1656997064395,MATH 18,B01,083748,Rideout; David Porter,4,0,37,33
1656997064395,MATH 18,B02,083749,Rideout; David Porter,3,0,36,33
1656997064395,MATH 18,B03,083750,Rideout; David Porter,2,0,37,35
1656997064395,MATH 18,B04,083751,Rideout; David Porter,5,0,36,31
1656997064395,MATH 18,B05,093473,Rideout; David Porter,4,0,36,32
1656997064395,MATH 18,B06,093474,Rideout; David Porter,5,0,36,31
1656997070422,MATH 20A,A01,083754,Zheng; Zequn,12,0,40,28
1656997076450,MATH 20B,A01,083756,Briones; Jor-el Thomas Caparas,1,0,36,35
1656997076450,MATH 20B,A02,083757,Briones; Jor-el Thomas Caparas,1,0,36,35
1656997076450,MATH 20B,A03,093475,Briones; Jor-el Thomas Caparas,0,0,36,36
1656997082479,MATH 20C,A01,083760,Briones; Jor-el Thomas Caparas,1,0,35,34
1656997082479,MATH 20C,A02,083761,Briones; Jor-el Thomas Caparas,8,0,35,27
1656997082479,MATH 20C,A03,093476,Briones; Jor-el Thomas Caparas,0,1,36,36
1656997082479,MATH 20C,B01,083762,Bach; Quang Tran,0,0,30,30
1656997088503,MATH 20D,A01,083765,Tran; Brian Kha,4,0,30,26
1656997088503,MATH 20D,A02,083766,Tran; Brian Kha,5,0,30,25
1656997088503,MATH 20D,A03,083767,Tran; Brian Kha,3,0,30,27
1656997094601,MATH 20E,A01,083771,Ganguly; Soumya,5,0,32,27
1656997094601,MATH 20E,A02,083772,Ganguly; Soumya,6,0,32,26
1656997094601,MATH 20E,B01,083773,Ciotti; Benjamin,18,0,35,17
1656997094601,MATH 20E,B02,083774,Ciotti; Benjamin,17,0,35,18
1656997100626,MATH 103A,A01,083777,Greenfeld; Be'Eri,2,0,36,34
1656997100626,MATH 103A,A02,083778,Greenfeld; Be'Eri,5,0,36,31
1656997100626,MATH 103A,A03,093561,Greenfeld; Be'Eri,4,0,36,32
1656997100626,MATH 103A,B01,083779,Greenfeld; Be'Eri,6,0,36,30
1656997100626,MATH 103A,B02,083780,Greenfeld; Be'Eri,2,0,36,34
1656997100626,MATH 103A,B03,093562,Greenfeld; Be'Eri,2,0,36,34
1656997106649,MATH 105,A01,085443,Carter; Anne Toulson,14,0,35,21
1656997106649,MATH 105,A02,093477,Carter; Anne Toulson,20,0,35,15
1656997112677,MATH 109,A01,083213,Ganzberger; Geoffrey Michael,2,0,34,32
1656997112677,MATH 109,A02,083214,Ganzberger; Geoffrey Michael,2,0,34,32
1656997112677,MATH 109,A03,093478,Ganzberger; Geoffrey Michael,1,0,34,33
1656997112677,MATH 109,B01,083215,Ganzberger; Geoffrey Michael,1,0,32,31
1656997112677,MATH 109,B02,083216,Ganzberger; Geoffrey Michael,1,0,32,31
1656997112677,MATH 109,B03,093479,Ganzberger; Geoffrey Michael,6,0,32,26
1656997118702,MATH 142A,A01,083219,Chow; Bennett,6,0,32,26
1656997118702,MATH 142A,A02,083220,Chow; Bennett,10,0,32,22
1656997118702,MATH 142A,A03,093480,Chow; Bennett,7,0,32,25
1656997118702,MATH 142A,B03,093481,Chow; Bennett,7,0,32,25
1656997118702,MATH 142A,B04,093558,Chow; Bennett,11,0,32,21
1656997118702,MATH 142A,B05,093559,Chow; Bennett,6,0,32,26
1656997124727,MATH 193A,A01,083224,Rotar; Vladimir,7,0,34,27
1656997124727,MATH 193A,A02,083225,Rotar; Vladimir,4,0,34,30
1656997124727,MATH 193A,A03,083781,Rotar; Vladimir,1,0,34,33
1656997124727,MATH 193A,A04,083782,Rotar; Vladimir,6,0,34,28
1656997124727,MATH 193A,A05,093482,Rotar; Vladimir,6,0,34,28
1656997130752,MATH 197,001,091859,McAuley; Julian John,9999,0,9999,0
1656997130752,MATH 197,002,095566,Kedlaya; Kiran S.,9997,0,9999,2
1656997130752,MATH 197,003,095567,Xiao; Ming,9999,0,9999,0
1656997130752,MATH 197,004,095571,Perols; Johan Lars,9998,0,9999,1
1656997137811,COGS 9,A01,083615,Shannon; Kyle Michael,7,0,75,68
1656997143833,COGS 11,A01,083617,Boyle; Mary E. T.,20,0,48,28
1656997149860,COGS 13,A01,083071,Bastos; Amalia Pinkusfeld,9,0,71,62
1656997155883,COGS 14A,A01,092681,Semenuks; Arturs,0,1,100,100
1656997161908,COGS 14B,A01,083073,Cheng; Tzu-Han,5,0,63,58
1656997167930,COGS 17,A01,092677,Semenuks; Arturs,4,0,81,77
1656997173953,COGS 100,A01,083619,Allen; Michael Gordon,15,0,70,55
1656997179976,COGS 101A,A01,083621,Davis; Joshua Daniel,9,0,68,59
1656997186001,COGS 101B,A01,091572,Allen; Michael Gordon,8,0,65,57
1656997192027,COGS 101C,A01,083625,Delgado; Tania,17,0,35,18
1656997198050,COGS 107A,A01,083627,Boyle; Mary E. T.,13,0,60,47
1656997204077,COGS 118A,A01,083075,Gupta; Anjum,15,0,76,61
1656997210104,CSE 3,A50,083646,Miranda; Gregory Joseph,22,0,50,28
1656997216131,CSE 8A,A50,083650,Miranda; Gregory Joseph,17,1,56,39
1656997222159,CSE 11,A01,083080,Cao; Yingjun,4,15,40,36
1656997228181,CSE 12,A01,083652,Krause-Levy; Sophia Louisa,20,1,120,100
1656997234205,CSE 15L,A01,083654,Morris; Justin Loren,8,0,50,42
1656997234205,CSE 15L,A02,083655,Morris; Justin Loren,8,0,50,42
1656997240228,CSE 20,A01,083657,Tran; Khoa Dang,37,0,80,43
1656997246252,CSE 21,A01,095574,Bach; Quang Tran,21,0,48,27
1656997252276,CSE 30,A01,083084,Eldon; John,4,0,80,76
1656997252276,CSE 30,B01,095061,Bhaskar; Nishant,6,0,50,44
1656997258298,CSE 100,A01,083659,Cao; Yingjun,3,4,70,67
1656997264320,CSE 134B,A01,083661,Powell; Thomas Allan,19,0,100,81
1656997270341,CSE 140,A01,083663,Gungor; Onat,14,0,85,71
1656997276394,CSE 140L,A01,083088,Eldon; John,16,0,100,84
1656997282421,CSE 175,A01,083665,Kumar; Rakesh,3,0,25,22
1656997288447,CSE 190,A00,092507,Dubnov; Shlomo,7,0,20,13
1656997294475,ECE 45,A01,083139,Congero; Spencer William,5,0,75,70
1656997300505,ECE 65,A50,083695,Saad; Andrew S,12,0,30,18
1656997300505,ECE 65,A51,095125,Saad; Andrew S,25,0,26,1
1656997306531,ECE 109,A01,091882,Touri; Behrouz,16,0,70,54
1656997312554,ECE 180,A00,083140,Abi Samra; Nicholas Camill,1,0,30,29
1656997312554,ECE 180,B00,083141,Abi Samra; Nicholas Camill,0,0,30,30
1656997318580,MATH 10A,A01,083735,Patchell; Gregory David,1,0,30,29
1656997318580,MATH 10A,A02,083736,Patchell; Gregory David,20,0,30,10
1656997318580,MATH 10A,A03,083737,Patchell; Gregory David,16,0,30,14
1656997324605,MATH 10B,A01,083207,Lim; Seonhee,7,0,34,27
1656997324605,MATH 10B,A02,083208,Lim; Seonhee,9,0,35,26
1656997324605,MATH 10B,A03,093472,Lim; Seonhee,4,0,34,30
1656997324605,MATH 10B,B01,083739,Sinha; Shubham,9,0,30,21
1656997330631,MATH 18,A01,083743,Cinel; Cameron Alexander,6,0,30,24
1656997330631,MATH 18,A02,083744,Cinel; Cameron Alexander,15,0,30,15
1656997330631,MATH 18,A03,083745,Cinel; Cameron Alexander,8,0,30,22
1656997330631,MATH 18,B01,083748,Rideout; David Porter,4,0,37,33
1656997330631,MATH 18,B02,083749,Rideout; David Porter,3,0,36,33
1656997330631,MATH 18,B03,083750,Rideout; David Porter,2,0,37,35
1656997330631,MATH 18,B04,083751,Rideout; David Porter,5,0,36,31
1656997330631,MATH 18,B05,093473,Rideout; David Porter,4,0,36,32
1656997330631,MATH 18,B06,093474,Rideout; David Porter,5,0,36,31
1656997336658,MATH 20A,A01,083754,Zheng; Zequn,12,0,40,28
1656997342682,MATH 20B,A01,083756,Briones; Jor-el Thomas Caparas,1,0,36,35
1656997342682,MATH 20B,A02,083757,Briones; Jor-el Thomas Caparas,1,0,36,35
1656997342682,MATH 20B,A03,093475,Briones; Jor-el Thomas Caparas,0,0,36,36
1656997348709,MATH 20C,A01,083760,Briones; Jor-el Thomas Caparas,1,0,35,34
1656997348709,MATH 20C,A02,083761,Briones; Jor-el Thomas Caparas,8,0,35,27
1656997348709,MATH 20C,A03,093476,Briones; Jor-el Thomas Caparas,0,1,36,36
1656997348709,MATH 20C,B01,083762,Bach; Quang Tran,0,0,30,30
1656997354734,MATH 20D,A01,083765,Tran; Brian Kha,4,0,30,26
1656997354734,MATH 20D,A02,083766,Tran; Brian Kha,5,0,30,25
1656997354734,MATH 20D,A03,083767,Tran; Brian Kha,3,0,30,27
1656997360762,MATH 20E,A01,083771,Ganguly; Soumya,5,0,32,27
1656997360762,MATH 20E,A02,083772,Ganguly; Soumya,6,0,32,26
1656997360762,MATH 20E,B01,083773,Ciotti; Benjamin,18,0,35,17
1656997360762,MATH 20E,B02,083774,Ciotti; Benjamin,17,0,35,18
1656997366784,MATH 103A,A01,083777,Greenfeld; Be'Eri,2,0,36,34
1656997366784,MATH 103A,A02,083778,Greenfeld; Be'Eri,5,0,36,31
1656997366784,MATH 103A,A03,093561,Greenfeld; Be'Eri,4,0,36,32
1656997366784,MATH 103A,B01,083779,Greenfeld; Be'Eri,6,0,36,30
1656997366784,MATH 103A,B02,083780,Greenfeld; Be'Eri,2,0,36,34
1656997366784,MATH 103A,B03,093562,Greenfeld; Be'Eri,2,0,36,34
1656997372807,MATH 105,A01,085443,Carter; Anne Toulson,14,0,35,21
1656997372807,MATH 105,A02,093477,Carter; Anne Toulson,20,0,35,15
1656997378835,MATH 109,A01,083213,Ganzberger; Geoffrey Michael,2,0,34,32
1656997378835,MATH 109,A02,083214,Ganzberger; Geoffrey Michael,2,0,34,32
1656997378835,MATH 109,A03,093478,Ganzberger; Geoffrey Michael,1,0,34,33
1656997378835,MATH 109,B01,083215,Ganzberger; Geoffrey Michael,1,0,32,31
1656997378835,MATH 109,B02,083216,Ganzberger; Geoffrey Michael,1,0,32,31
1656997378835,MATH 109,B03,093479,Ganzberger; Geoffrey Michael,6,0,32,26
1656997384864,MATH 142A,A01,083219,Chow; Bennett,6,0,32,26
1656997384864,MATH 142A,A02,083220,Chow; Bennett,10,0,32,22
1656997384864,MATH 142A,A03,093480,Chow; Bennett,7,0,32,25
1656997384864,MATH 142A,B03,093481,Chow; Bennett,7,0,32,25
1656997384864,MATH 142A,B04,093558,Chow; Bennett,11,0,32,21
1656997384864,MATH 142A,B05,093559,Chow; Bennett,6,0,32,26
1656997390893,MATH 193A,A01,083224,Rotar; Vladimir,7,0,34,27
1656997390893,MATH 193A,A02,083225,Rotar; Vladimir,4,0,34,30
1656997390893,MATH 193A,A03,083781,Rotar; Vladimir,1,0,34,33
1656997390893,MATH 193A,A04,083782,Rotar; Vladimir,6,0,34,28
1656997390893,MATH 193A,A05,093482,Rotar; Vladimir,6,0,34,28
1656997396915,MATH 197,001,091859,McAuley; Julian John,9999,0,9999,0
1656997396915,MATH 197,002,095566,Kedlaya; Kiran S.,9997,0,9999,2
1656997396915,MATH 197,003,095567,Xiao; Ming,9999,0,9999,0
1656997396915,MATH 197,004,095571,Perols; Johan Lars,9998,0,9999,1
1656997403990,COGS 9,A01,083615,Shannon; Kyle Michael,7,0,75,68
1656997410017,COGS 11,A01,083617,Boyle; Mary E. T.,20,0,48,28
1656997416043,COGS 13,A01,083071,Bastos; Amalia Pinkusfeld,9,0,71,62
1656997422066,COGS 14A,A01,092681,Semenuks; Arturs,0,1,100,100
1656997428092,COGS 14B,A01,083073,Cheng; Tzu-Han,5,0,63,58
1656997434119,COGS 17,A01,092677,Semenuks; Arturs,4,0,81,77
1656997440142,COGS 100,A01,083619,Allen; Michael Gordon,15,0,70,55
1656997446166,COGS 101A,A01,083621,Davis; Joshua Daniel,9,0,68,59
1656997452189,COGS 101B,A01,091572,Allen; Michael Gordon,8,0,65,57
1656997458217,COGS 101C,A01,083625,Delgado; Tania,17,0,35,18
1656997464239,COGS 107A,A01,083627,Boyle; Mary E. T.,13,0,60,47
1656997470263,COGS 118A,A01,083075,Gupta; Anjum,15,0,76,61
1656997476292,CSE 3,A50,083646,Miranda; Gregory Joseph,22,0,50,28
1656997482316,CSE 8A,A50,083650,Miranda; Gregory Joseph,17,1,56,39
1656997488340,CSE 11,A01,083080,Cao; Yingjun,4,15,40,36
1656997494364,CSE 12,A01,083652,Krause-Levy; Sophia Louisa,20,1,120,100
1656997500387,CSE 15L,A01,083654,Morris; Justin Loren,8,0,50,42
1656997500387,CSE 15L,A02,083655,Morris; Justin Loren,8,0,50,42
1656997506412,CSE 20,A01,083657,Tran; Khoa Dang,37,0,80,43
1656997512437,CSE 21,A01,095574,Bach; Quang Tran,21,0,48,27
1656997518471,CSE 30,A01,083084,Eldon; John,4,0,80,76
1656997518471,CSE 30,B01,095061,Bhaskar; Nishant,6,0,50,44
1656997524494,CSE 100,A01,083659,Cao; Yingjun,3,4,70,67
1656997530518,CSE 134B,A01,083661,Powell; Thomas Allan,19,0,100,81
1656997536542,CSE 140,A01,083663,Gungor; Onat,14,0,85,71
1656997542567,CSE 140L,A01,083088,Eldon; John,16,0,100,84
1656997548593,CSE 175,A01,083665,Kumar; Rakesh,3,0,25,22
1656997554620,CSE 190,A00,092507,Dubnov; Shlomo,7,0,20,13
1656997560652,ECE 45,A01,083139,Congero; Spencer William,5,0,75,70
1656997566680,ECE 65,A50,083695,Saad; Andrew S,12,0,30,18
1656997566680,ECE 65,A51,095125,Saad; Andrew S,25,0,26,1
1656997572703,ECE 109,A01,091882,Touri; Behrouz,16,0,70,54
1656997578726,ECE 180,A00,083140,Abi Samra; Nicholas Camill,1,0,30,29
1656997578726,ECE 180,B00,083141,Abi Samra; Nicholas Camill,0,0,30,30
1656997584749,MATH 10A,A01,083735,Patchell; Gregory David,1,0,30,29
1656997584749,MATH 10A,A02,083736,Patchell; Gregory David,20,0,30,10
1656997584749,MATH 10A,A03,083737,Patchell; Gregory David,16,0,30,14
1656997590774,MATH 10B,A01,083207,Lim; Seonhee,7,0,34,27
1656997590774,MATH 10B,A02,083208,Lim; Seonhee,9,0,35,26
1656997590774,MATH 10B,A03,093472,Lim; Seonhee,4,0,34,30
1656997590774,MATH 10B,B01,083739,Sinha; Shubham,9,0,30,21
1656997596810,MATH 18,A01,083743,Cinel; Cameron Alexander,6,0,30,24
1656997596810,MATH 18,A02,083744,Cinel; Cameron Alexander,15,0,30,15
1656997596810,MATH 18,A03,083745,Cinel; Cameron Alexander,8,0,30,22
1656997596810,MATH 18,B01,083748,Rideout; David Porter,4,0,37,33
1656997596810,MATH 18,B02,083749,Rideout; David Porter,3,0,36,33
1656997596810,MATH 18,B03,083750,Rideout; David Porter,2,0,37,35
1656997596810,MATH 18,B04,083751,Rideout; David Porter,5,0,36,31
1656997596810,MATH 18,B05,093473,Rideout; David Porter,4,0,36,32
1656997596810,MATH 18,B06,093474,Rideout; David Porter,5,0,36,31
1656997602834,MATH 20A,A01,083754,Zheng; Zequn,12,0,40,28
1656997608859,MATH 20B,A01,083756,Briones; Jor-el Thomas Caparas,1,0,36,35
1656997608859,MATH 20B,A02,083757,Briones; Jor-el Thomas Caparas,1,0,36,35
1656997608859,MATH 20B,A03,093475,Briones; Jor-el Thomas Caparas,0,0,36,36
1656997614883,MATH 20C,A01,083760,Briones; Jor-el Thomas Caparas,1,0,35,34
1656997614883,MATH 20C,A02,083761,Briones; Jor-el Thomas Caparas,8,0,35,27
1656997614883,MATH 20C,A03,093476,Briones; Jor-el Thomas Caparas,0,1,36,36
1656997614883,MATH 20C,B01,083762,Bach; Quang Tran,0,0,30,30
1656997620906,MATH 20D,A01,083765,Tran; Brian Kha,4,0,30,26
1656997620906,MATH 20D,A02,083766,Tran; Brian Kha,5,0,30,25
1656997620906,MATH 20D,A03,083767,Tran; Brian Kha,3,0,30,27
1656997626941,MATH 20E,A01,083771,Ganguly; Soumya,5,0,32,27
1656997626941,MATH 20E,A02,083772,Ganguly; Soumya,6,0,32,26
1656997626941,MATH 20E,B01,083773,Ciotti; Benjamin,18,0,35,17
1656997626941,MATH 20E,B02,083774,Ciotti; Benjamin,17,0,35,18
1656997632965,MATH 103A,A01,083777,Greenfeld; Be'Eri,2,0,36,34
1656997632965,MATH 103A,A02,083778,Greenfeld; Be'Eri,5,0,36,31
1656997632965,MATH 103A,A03,093561,Greenfeld; Be'Eri,4,0,36,32
1656997632965,MATH 103A,B01,083779,Greenfeld; Be'Eri,6,0,36,30
1656997632965,MATH 103A,B02,083780,Greenfeld; Be'Eri,2,0,36,34
1656997632965,MATH 103A,B03,093562,Greenfeld; Be'Eri,2,0,36,34
1656997638996,MATH 105,A01,085443,Carter; Anne Toulson,14,0,35,21
1656997638996,MATH 105,A02,093477,Carter; Anne Toulson,20,0,35,15
1656997645021,MATH 109,A01,083213,Ganzberger; Geoffrey Michael,2,0,34,32
1656997645021,MATH 109,A02,083214,Ganzberger; Geoffrey Michael,2,0,34,32
1656997645021,MATH 109,A03,093478,Ganzberger; Geoffrey Michael,1,0,34,33
1656997645021,MATH 109,B01,083215,Ganzberger; Geoffrey Michael,1,0,32,31
1656997645021,MATH 109,B02,083216,Ganzberger; Geoffrey Michael,1,0,32,31
1656997645021,MATH 109,B03,093479,Ganzberger; Geoffrey Michael,6,0,32,26
1656997651045,MATH 142A,A01,083219,Chow; Bennett,6,0,32,26
1656997651045,MATH 142A,A02,083220,Chow; Bennett,10,0,32,22
1656997651045,MATH 142A,A03,093480,Chow; Bennett,7,0,32,25
1656997651045,MATH 142A,B03,093481,Chow; Bennett,7,0,32,25
1656997651045,MATH 142A,B04,093558,Chow; Bennett,11,0,32,21
1656997651045,MATH 142A,B05,093559,Chow; Bennett,6,0,32,26
1656997657070,MATH 193A,A01,083224,Rotar; Vladimir,7,0,34,27
1656997657070,MATH 193A,A02,083225,Rotar; Vladimir,4,0,34,30
1656997657070,MATH 193A,A03,083781,Rotar; Vladimir,1,0,34,33
1656997657070,MATH 193A,A04,083782,Rotar; Vladimir,6,0,34,28
1656997657070,MATH 193A,A05,093482,Rotar; Vladimir,6,0,34,28
1656997663102,MATH 197,001,091859,McAuley; Julian John,9999,0,9999,0
1656997663102,MATH 197,002,095566,Kedlaya; Kiran S.,9997,0,9999,2
1656997663102,MATH 197,003,095567,Xiao; Ming,9999,0,9999,0
1656997663102,MATH 197,004,095571,Perols; Johan Lars,9998,0,9999,1
1656997670154,COGS 9,A01,083615,Shannon; Kyle Michael,7,0,75,68
1656997676181,COGS 11,A01,083617,Boyle; Mary E. T.,20,0,48,28
1656997682205,COGS 13,A01,083071,Bastos; Amalia Pinkusfeld,9,0,71,62
1656997688305,COGS 14A,A01,092681,Semenuks; Arturs,0,1,100,100
1656997694328,COGS 14B,A01,083073,Cheng; Tzu-Han,5,0,63,58
1656997700349,COGS 17,A01,092677,Semenuks; Arturs,4,0,81,77
1656997706376,COGS 100,A01,083619,Allen; Michael Gordon,15,0,70,55
1656997712404,COGS 101A,A01,083621,Davis; Joshua Daniel,9,0,68,59
1656997718426,COGS 101B,A01,091572,Allen; Michael Gordon,8,0,65,57
1656997724449,COGS 101C,A01,083625,Delgado; Tania,17,0,35,18
1656997730472,COGS 107A,A01,083627,Boyle; Mary E. T.,13,0,60,47
1656997736497,COGS 118A,A01,083075,Gupta; Anjum,15,0,76,61
1656997742521,CSE 3,A50,083646,Miranda; Gregory Joseph,22,0,50,28
1656997748546,CSE 8A,A50,083650,Miranda; Gregory Joseph,17,1,56,39
1656997754568,CSE 11,A01,083080,Cao; Yingjun,4,15,40,36
1656997760596,CSE 12,A01,083652,Krause-Levy; Sophia Louisa,21,1,120,99
1656997766623,CSE 15L,A01,083654,Morris; Justin Loren,8,0,50,42
1656997766623,CSE 15L,A02,083655,Morris; Justin Loren,9,0,50,41
1656997772649,CSE 20,A01,083657,Tran; Khoa Dang,37,0,80,43
1656997778673,CSE 21,A01,095574,Bach; Quang Tran,21,0,48,27
1656997784700,CSE 30,A01,083084,Eldon; John,4,0,80,76
1656997784700,CSE 30,B01,095061,Bhaskar; Nishant,6,0,50,44
1656997790733,CSE 100,A01,083659,Cao; Yingjun,3,4,70,67
1656997796765,CSE 134B,A01,083661,Powell; Thomas Allan,19,0,100,81
1656997802799,CSE 140,A01,083663,Gungor; Onat,14,0,85,71
1656997808823,CSE 140L,A01,083088,Eldon; John,16,0,100,84
1656997814849,CSE 175,A01,083665,Kumar; Rakesh,3,0,25,22
1656997820872,CSE 190,A00,092507,Dubnov; Shlomo,7,0,20,13
1656997826905,ECE 45,A01,083139,Congero; Spencer William,5,0,75,70
1656997832930,ECE 65,A50,083695,Saad; Andrew S,12,0,30,18
1656997832930,ECE 65,A51,095125,Saad; Andrew S,25,0,26,1
1656997838953,ECE 109,A01,091882,Touri; Behrouz,16,0,70,54
1656997844976,ECE 180,A00,083140,Abi Samra; Nicholas Camill,1,0,30,29
1656997844976,ECE 180,B00,083141,Abi Samra; Nicholas Camill,0,0,30,30
1656997851002,MATH 10A,A01,083735,Patchell; Gregory David,1,0,30,29
1656997851002,MATH 10A,A02,083736,Patchell; Gregory David,20,0,30,10
1656997851002,MATH 10A,A03,083737,Patchell; Gregory David,16,0,30,14
1656997857027,MATH 10B,A01,083207,Lim; Seonhee,7,0,34,27
1656997857027,MATH 10B,A02,083208,Lim; Seonhee,9,0,35,26
1656997857027,MATH 10B,A03,093472,Lim; Seonhee,4,0,34,30
1656997857027,MATH 10B,B01,083739,Sinha; Shubham,9,0,30,21
1656997863053,MATH 18,A01,083743,Cinel; Cameron Alexander,6,0,30,24
1656997863053,MATH 18,A02,083744,Cinel; Cameron Alexander,15,0,30,15
1656997863053,MATH 18,A03,083745,Cinel; Cameron Alexander,8,0,30,22
1656997863053,MATH 18,B01,083748,Rideout; David Porter,4,0,37,33
1656997863053,MATH 18,B02,083749,Rideout; David Porter,3,0,36,33
1656997863053,MATH 18,B03,083750,Rideout; David Porter,2,0,37,35
1656997863053,MATH 18,B04,083751,Rideout; David Porter,5,0,36,31
1656997863053,MATH 18,B05,093473,Rideout; David Porter,4,0,36,32
1656997863053,MATH 18,B06,093474,Rideout; David Porter,5,0,36,31
1656997869077,MATH 20A,A01,083754,Zheng; Zequn,12,0,40,28
1656997875100,MATH 20B,A01,083756,Briones; Jor-el Thomas Caparas,1,0,36,35
1656997875100,MATH 20B,A02,083757,Briones; Jor-el Thomas Caparas,1,0,36,35
1656997875100,MATH 20B,A03,093475,Briones; Jor-el Thomas Caparas,0,0,36,36
1656997881128,MATH 20C,A01,083760,Briones; Jor-el Thomas Caparas,1,0,35,34
1656997881128,MATH 20C,A02,083761,Briones; Jor-el Thomas Caparas,8,0,35,27
1656997881128,MATH 20C,A03,093476,Briones; Jor-el Thomas Caparas,0,1,36,36
1656997881128,MATH 20C,B01,083762,Bach; Quang Tran,0,0,30,30
1656997887162,MATH 20D,A01,083765,Tran; Brian Kha,4,0,30,26
1656997887162,MATH 20D,A02,083766,Tran; Brian Kha,5,0,30,25
1656997887162,MATH 20D,A03,083767,Tran; Brian Kha,3,0,30,27
1656997893186,MATH 20E,A01,083771,Ganguly; Soumya,5,0,32,27
1656997893186,MATH 20E,A02,083772,Ganguly; Soumya,6,0,32,26
1656997893186,MATH 20E,B01,083773,Ciotti; Benjamin,18,0,35,17
1656997893186,MATH 20E,B02,083774,Ciotti; Benjamin,17,0,35,18
1656997899210,MATH 103A,A01,083777,Greenfeld; Be'Eri,2,0,36,34
1656997899210,MATH 103A,A02,083778,Greenfeld; Be'Eri,5,0,36,31
1656997899210,MATH 103A,A03,093561,Greenfeld; Be'Eri,4,0,36,32
1656997899210,MATH 103A,B01,083779,Greenfeld; Be'Eri,6,0,36,30
1656997899210,MATH 103A,B02,083780,Greenfeld; Be'Eri,2,0,36,34
1656997899210,MATH 103A,B03,093562,Greenfeld; Be'Eri,2,0,36,34
1656997905238,MATH 105,A01,085443,Carter; Anne Toulson,14,0,35,21
1656997905238,MATH 105,A02,093477,Carter; Anne Toulson,20,0,35,15
1656997911263,MATH 109,A01,083213,Ganzberger; Geoffrey Michael,2,0,34,32
1656997911263,MATH 109,A02,083214,Ganzberger; Geoffrey Michael,2,0,34,32
1656997911263,MATH 109,A03,093478,Ganzberger; Geoffrey Michael,1,0,34,33
1656997911263,MATH 109,B01,083215,Ganzberger; Geoffrey Michael,1,0,32,31
1656997911263,MATH 109,B02,083216,Ganzberger; Geoffrey Michael,1,0,32,31
1656997911263,MATH 109,B03,093479,Ganzberger; Geoffrey Michael,6,0,32,26
1656997917287,MATH 142A,A01,083219,Chow; Bennett,6,0,32,26
1656997917287,MATH 142A,A02,083220,Chow; Bennett,10,0,32,22
1656997917287,MATH 142A,A03,093480,Chow; Bennett,7,0,32,25
1656997917287,MATH 142A,B03,093481,Chow; Bennett,7,0,32,25
1656997917287,MATH 142A,B04,093558,Chow; Bennett,11,0,32,21
1656997917287,MATH 142A,B05,093559,Chow; Bennett,6,0,32,26
1656997923315,MATH 193A,A01,083224,Rotar; Vladimir,7,0,34,27
1656997923315,MATH 193A,A02,083225,Rotar; Vladimir,4,0,34,30
1656997923315,MATH 193A,A03,083781,Rotar; Vladimir,1,0,34,33
1656997923315,MATH 193A,A04,083782,Rotar; Vladimir,6,0,34,28
1656997923315,MATH 193A,A05,093482,Rotar; Vladimir,6,0,34,28
1656997929346,MATH 197,001,091859,McAuley; Julian John,9999,0,9999,0
1656997929346,MATH 197,002,095566,Kedlaya; Kiran S.,9997,0,9999,2
1656997929346,MATH 197,003,095567,Xiao; Ming,9999,0,9999,0
1656997929346,MATH 197,004,095571,Perols; Johan Lars,9998,0,9999,1
1656997936417,COGS 9,A01,083615,Shannon; Kyle Michael,7,0,75,68
1656997942440,COGS 11,A01,083617,Boyle; Mary E. T.,20,0,48,28
1656997948465,COGS 13,A01,083071,Bastos; Amalia Pinkusfeld,9,0,71,62
1656997954492,COGS 14A,A01,092681,Semenuks; Arturs,0,1,100,100
1656997960517,COGS 14B,A01,083073,Cheng; Tzu-Han,5,0,63,58
1656997966545,COGS 17,A01,092677,Semenuks; Arturs,4,0,81,77
1656997972572,COGS 100,A01,083619,Allen; Michael Gordon,15,0,70,55
1656997978597,COGS 101A,A01,083621,Davis; Joshua Daniel,9,0,68,59
1656997984624,COGS 101B,A01,091572,Allen; Michael Gordon,8,0,65,57
1656997990645,COGS 101C,A01,083625,Delgado; Tania,17,0,35,18
1656997996669,COGS 107A,A01,083627,Boyle; Mary E. T.,13,0,60,47
1656998002691,COGS 118A,A01,083075,Gupta; Anjum,15,0,76,61
1656998008715,CSE 3,A50,083646,Miranda; Gregory Joseph,22,0,50,28
1656998014744,CSE 8A,A50,083650,Miranda; Gregory Joseph,17,1,56,39
1656998020768,CSE 11,A01,083080,Cao; Yingjun,4,15,40,36
1656998026793,CSE 12,A01,083652,Krause-Levy; Sophia Louisa,21,1,120,99
1656998032818,CSE 15L,A01,083654,Morris; Justin Loren,8,0,50,42
1656998032818,CSE 15L,A02,083655,Morris; Justin Loren,9,0,50,41
1656998038841,CSE 20,A01,083657,Tran; Khoa Dang,37,0,80,43
1656998044870,CSE 21,A01,095574,Bach; Quang Tran,21,0,48,27
1656998050897,CSE 30,A01,083084,Eldon; John,4,0,80,76
1656998050897,CSE 30,B01,095061,Bhaskar; Nishant,6,0,50,44
1656998056919,CSE 100,A01,083659,Cao; Yingjun,3,4,70,67
1656998062942,CSE 134B,A01,083661,Powell; Thomas Allan,19,0,100,81
1656998068969,CSE 140,A01,083663,Gungor; Onat,14,0,85,71
1656998074995,CSE 140L,A01,083088,Eldon; John,16,0,100,84
1656998081022,CSE 175,A01,083665,Kumar; Rakesh,3,0,25,22
1656998087047,CSE 190,A00,092507,Dubnov; Shlomo,7,0,20,13
1656998093073,ECE 45,A01,083139,Congero; Spencer William,5,0,75,70
1656998099096,ECE 65,A50,083695,Saad; Andrew S,12,0,30,18
1656998099096,ECE 65,A51,095125,Saad; Andrew S,25,0,26,1
1656998105119,ECE 109,A01,091882,Touri; Behrouz,16,0,70,54
1656998111143,ECE 180,A00,083140,Abi Samra; Nicholas Camill,1,0,30,29
1656998111143,ECE 180,B00,083141,Abi Samra; Nicholas Camill,0,0,30,30
1656998117166,MATH 10A,A01,083735,Patchell; Gregory David,1,0,30,29
1656998117166,MATH 10A,A02,083736,Patchell; Gregory David,20,0,30,10
1656998117166,MATH 10A,A03,083737,Patchell; Gregory David,16,0,30,14
1656998123188,MATH 10B,A01,083207,Lim; Seonhee,7,0,34,27
1656998123188,MATH 10B,A02,083208,Lim; Seonhee,9,0,35,26
1656998123188,MATH 10B,A03,093472,Lim; Seonhee,4,0,34,30
1656998123188,MATH 10B,B01,083739,Sinha; Shubham,9,0,30,21
1656998129219,MATH 18,A01,083743,Cinel; Cameron Alexander,6,0,30,24
1656998129219,MATH 18,A02,083744,Cinel; Cameron Alexander,15,0,30,15
1656998129219,MATH 18,A03,083745,Cinel; Cameron Alexander,8,0,30,22
1656998129219,MATH 18,B01,083748,Rideout; David Porter,4,0,37,33
1656998129219,MATH 18,B02,083749,Rideout; David Porter,3,0,36,33
1656998129219,MATH 18,B03,083750,Rideout; David Porter,2,0,37,35
1656998129219,MATH 18,B04,083751,Rideout; David Porter,5,0,36,31
1656998129219,MATH 18,B05,093473,Rideout; David Porter,4,0,36,32
1656998129219,MATH 18,B06,093474,Rideout; David Porter,5,0,36,31
1656998135242,MATH 20A,A01,083754,Zheng; Zequn,12,0,40,28
1656998141270,MATH 20B,A01,083756,Briones; Jor-el Thomas Caparas,1,0,36,35
1656998141270,MATH 20B,A02,083757,Briones; Jor-el Thomas Caparas,1,0,36,35
1656998141270,MATH 20B,A03,093475,Briones; Jor-el Thomas Caparas,0,0,36,36
1656998147294,MATH 20C,A01,083760,Briones; Jor-el Thomas Caparas,1,0,35,34
1656998147294,MATH 20C,A02,083761,Briones; Jor-el Thomas Caparas,8,0,35,27
1656998147294,MATH 20C,A03,093476,Briones; Jor-el Thomas Caparas,0,1,36,36
1656998147294,MATH 20C,B01,083762,Bach; Quang Tran,0,0,30,30
1656998153316,MATH 20D,A01,083765,Tran; Brian Kha,4,0,30,26
1656998153316,MATH 20D,A02,083766,Tran; Brian Kha,5,0,30,25
1656998153316,MATH 20D,A03,083767,Tran; Brian Kha,3,0,30,27
1656998159341,MATH 20E,A01,083771,Ganguly; Soumya,5,0,32,27
1656998159341,MATH 20E,A02,083772,Ganguly; Soumya,6,0,32,26
1656998159341,MATH 20E,B01,083773,Ciotti; Benjamin,18,0,35,17
1656998159341,MATH 20E,B02,083774,Ciotti; Benjamin,17,0,35,18
1656998165372,MATH 103A,A01,083777,Greenfeld; Be'Eri,2,0,36,34
1656998165372,MATH 103A,A02,083778,Greenfeld; Be'Eri,5,0,36,31
1656998165372,MATH 103A,A03,093561,Greenfeld; Be'Eri,4,0,36,32
1656998165372,MATH 103A,B01,083779,Greenfeld; Be'Eri,6,0,36,30
1656998165372,MATH 103A,B02,083780,Greenfeld; Be'Eri,2,0,36,34
1656998165372,MATH 103A,B03,093562,Greenfeld; Be'Eri,2,0,36,34
1656998171397,MATH 105,A01,085443,Carter; Anne Toulson,14,0,35,21
1656998171397,MATH 105,A02,093477,Carter; Anne Toulson,20,0,35,15
1656998177426,MATH 109,A01,083213,Ganzberger; Geoffrey Michael,2,0,34,32
1656998177426,MATH 109,A02,083214,Ganzberger; Geoffrey Michael,2,0,34,32
1656998177426,MATH 109,A03,093478,Ganzberger; Geoffrey Michael,1,0,34,33
1656998177426,MATH 109,B01,083215,Ganzberger; Geoffrey Michael,1,0,32,31
1656998177426,MATH 109,B02,083216,Ganzberger; Geoffrey Michael,1,0,32,31
1656998177426,MATH 109,B03,093479,Ganzberger; Geoffrey Michael,6,0,32,26
1656998183457,MATH 142A,A01,083219,Chow; Bennett,6,0,32,26
1656998183457,MATH 142A,A02,083220,Chow; Bennett,10,0,32,22
1656998183457,MATH 142A,A03,093480,Chow; Bennett,7,0,32,25
1656998183457,MATH 142A,B03,093481,Chow; Bennett,7,0,32,25
1656998183457,MATH 142A,B04,093558,Chow; Bennett,11,0,32,21
1656998183457,MATH 142A,B05,093559,Chow; Bennett,6,0,32,26
1656998189487,MATH 193A,A01,083224,Rotar; Vladimir,7,0,34,27
1656998189487,MATH 193A,A02,083225,Rotar; Vladimir,4,0,34,30
1656998189487,MATH 193A,A03,083781,Rotar; Vladimir,1,0,34,33
1656998189487,MATH 193A,A04,083782,Rotar; Vladimir,6,0,34,28
1656998189487,MATH 193A,A05,093482,Rotar; Vladimir,6,0,34,28
1656998195518,MATH 197,001,091859,McAuley; Julian John,9999,0,9999,0
1656998195518,MATH 197,002,095566,Kedlaya; Kiran S.,9997,0,9999,2
1656998195518,MATH 197,003,095567,Xiao; Ming,9999,0,9999,0
1656998195518,MATH 197,004,095571,Perols; Johan Lars,9998,0,9999,1
1656998202570,COGS 9,A01,083615,Shannon; Kyle Michael,7,0,75,68
1656998208593,COGS 11,A01,083617,Boyle; Mary E. T.,20,0,48,28
1656998214616,COGS 13,A01,083071,Bastos; Amalia Pinkusfeld,9,0,71,62
1656998220651,COGS 14A,A01,092681,Semenuks; Arturs,0,1,100,100
1656998226674,COGS 14B,A01,083073,Cheng; Tzu-Han,5,0,63,58
1656998232704,COGS 17,A01,092677,Semenuks; Arturs,4,0,81,77
1656998238727,COGS 100,A01,083619,Allen; Michael Gordon,15,0,70,55
1656998244750,COGS 101A,A01,083621,Davis; Joshua Daniel,9,0,68,59
1656998250777,COGS 101B,A01,091572,Allen; Michael Gordon,8,0,65,57
1656998256800,COGS 101C,A01,083625,Delgado; Tania,17,0,35,18
1656998262826,COGS 107A,A01,083627,Boyle; Mary E. T.,13,0,60,47
1656998268853,COGS 118A,A01,083075,Gupta; Anjum,15,0,76,61
1656998274876,CSE 3,A50,083646,Miranda; Gregory Joseph,22,0,50,28
1656998280904,CSE 8A,A50,083650,Miranda; Gregory Joseph,17,1,56,39
1656998287000,CSE 11,A01,083080,Cao; Yingjun,4,15,40,36
1656998293022,CSE 12,A01,083652,Krause-Levy; Sophia Louisa,21,1,120,99
1656998299046,CSE 15L,A01,083654,Morris; Justin Loren,8,0,50,42
1656998299046,CSE 15L,A02,083655,Morris; Justin Loren,9,0,50,41
1656998305069,CSE 20,A01,083657,Tran; Khoa Dang,37,0,80,43
1656998311095,CSE 21,A01,095574,Bach; Quang Tran,21,0,48,27
1656998317118,CSE 30,A01,083084,Eldon; John,4,0,80,76
1656998317118,CSE 30,B01,095061,Bhaskar; Nishant,6,0,50,44
1656998323144,CSE 100,A01,083659,Cao; Yingjun,3,4,70,67
1656998329172,CSE 134B,A01,083661,Powell; Thomas Allan,19,0,100,81
1656998335206,CSE 140,A01,083663,Gungor; Onat,14,0,85,71
1656998341229,CSE 140L,A01,083088,Eldon; John,16,0,100,84
1656998347255,CSE 175,A01,083665,Kumar; Rakesh,3,0,25,22
1656998353279,CSE 190,A00,092507,Dubnov; Shlomo,7,0,20,13
1656998359301,ECE 45,A01,083139,Congero; Spencer William,5,0,75,70
1656998365332,ECE 65,A50,083695,Saad; Andrew S,12,0,30,18
1656998365332,ECE 65,A51,095125,Saad; Andrew S,25,0,26,1
1656998371356,ECE 109,A01,091882,Touri; Behrouz,16,0,70,54
1656998377383,ECE 180,A00,083140,Abi Samra; Nicholas Camill,1,0,30,29
1656998377383,ECE 180,B00,083141,Abi Samra; Nicholas Camill,0,0,30,30
1656998383407,MATH 10A,A01,083735,Patchell; Gregory David,1,0,30,29
1656998383407,MATH 10A,A02,083736,Patchell; Gregory David,20,0,30,10
1656998383407,MATH 10A,A03,083737,Patchell; Gregory David,16,0,30,14
1656998389430,MATH 10B,A01,083207,Lim; Seonhee,7,0,34,27
1656998389430,MATH 10B,A02,083208,Lim; Seonhee,9,0,35,26
1656998389430,MATH 10B,A03,093472,Lim; Seonhee,4,0,34,30
1656998389430,MATH 10B,B01,083739,Sinha; Shubham,9,0,30,21
1656998395455,MATH 18,A01,083743,Cinel; Cameron Alexander,6,0,30,24
1656998395455,MATH 18,A02,083744,Cinel; Cameron Alexander,15,0,30,15
1656998395455,MATH 18,A03,083745,Cinel; Cameron Alexander,8,0,30,22
1656998395455,MATH 18,B01,083748,Rideout; David Porter,4,0,37,33
1656998395455,MATH 18,B02,083749,Rideout; David Porter,3,0,36,33
1656998395455,MATH 18,B03,083750,Rideout; David Porter,2,0,37,35
1656998395455,MATH 18,B04,083751,Rideout; David Porter,5,0,36,31
1656998395455,MATH 18,B05,093473,Rideout; David Porter,4,0,36,32
1656998395455,MATH 18,B06,093474,Rideout; David Porter,5,0,36,31
1656998401482,MATH 20A,A01,083754,Zheng; Zequn,12,0,40,28
1656998407506,MATH 20B,A01,083756,Briones; Jor-el Thomas Caparas,1,0,36,35
1656998407506,MATH 20B,A02,083757,Briones; Jor-el Thomas Caparas,1,0,36,35
1656998407506,MATH 20B,A03,093475,Briones; Jor-el Thomas Caparas,0,0,36,36
1656998413538,MATH 20C,A01,083760,Briones; Jor-el Thomas Caparas,1,0,35,34
1656998413538,MATH 20C,A02,083761,Briones; Jor-el Thomas Caparas,8,0,35,27
1656998413538,MATH 20C,A03,093476,Briones; Jor-el Thomas Caparas,0,1,36,36
1656998413538,MATH 20C,B01,083762,Bach; Quang Tran,0,0,30,30
1656998419568,MATH 20D,A01,083765,Tran; Brian Kha,4,0,30,26
1656998419568,MATH 20D,A02,083766,Tran; Brian Kha,5,0,30,25
1656998419568,MATH 20D,A03,083767,Tran; Brian Kha,3,0,30,27
1656998425596,MATH 20E,A01,083771,Ganguly; Soumya,5,0,32,27
1656998425596,MATH 20E,A02,083772,Ganguly; Soumya,6,0,32,26
1656998425596,MATH 20E,B01,083773,Ciotti; Benjamin,18,0,35,17
1656998425596,MATH 20E,B02,083774,Ciotti; Benjamin,17,0,35,18
1656998431620,MATH 103A,A01,083777,Greenfeld; Be'Eri,2,0,36,34
1656998431620,MATH 103A,A02,083778,Greenfeld; Be'Eri,5,0,36,31
1656998431620,MATH 103A,A03,093561,Greenfeld; Be'Eri,4,0,36,32
1656998431620,MATH 103A,B01,083779,Greenfeld; Be'Eri,6,0,36,30
1656998431620,MATH 103A,B02,083780,Greenfeld; Be'Eri,2,0,36,34
1656998431620,MATH 103A,B03,093562,Greenfeld; Be'Eri,2,0,36,34
1656998437645,MATH 105,A01,085443,Carter; Anne Toulson,14,0,35,21
1656998437645,MATH 105,A02,093477,Carter; Anne Toulson,20,0,35,15
1656998443675,MATH 109,A01,083213,Ganzberger; Geoffrey Michael,2,0,34,32
1656998443675,MATH 109,A02,083214,Ganzberger; Geoffrey Michael,2,0,34,32
1656998443675,MATH 109,A03,093478,Ganzberger; Geoffrey Michael,1,0,34,33
1656998443675,MATH 109,B01,083215,Ganzberger; Geoffrey Michael,1,0,32,31
1656998443675,MATH 109,B02,083216,Ganzberger; Geoffrey Michael,1,0,32,31
1656998443675,MATH 109,B03,093479,Ganzberger; Geoffrey Michael,6,0,32,26
1656998449715,MATH 142A,A01,083219,Chow; Bennett,6,0,32,26
1656998449715,MATH 142A,A02,083220,Chow; Bennett,10,0,32,22
1656998449715,MATH 142A,A03,093480,Chow; Bennett,7,0,32,25
1656998449715,MATH 142A,B03,093481,Chow; Bennett,7,0,32,25
1656998449715,MATH 142A,B04,093558,Chow; Bennett,11,0,32,21
1656998449715,MATH 142A,B05,093559,Chow; Bennett,6,0,32,26
1656998455741,MATH 193A,A01,083224,Rotar; Vladimir,7,0,34,27
1656998455741,MATH 193A,A02,083225,Rotar; Vladimir,4,0,34,30
1656998455741,MATH 193A,A03,083781,Rotar; Vladimir,1,0,34,33
1656998455741,MATH 193A,A04,083782,Rotar; Vladimir,6,0,34,28
1656998455741,MATH 193A,A05,093482,Rotar; Vladimir,6,0,34,28
1656998461764,MATH 197,001,091859,McAuley; Julian John,9999,0,9999,0
1656998461764,MATH 197,002,095566,Kedlaya; Kiran S.,9997,0,9999,2
1656998461764,MATH 197,003,095567,Xiao; Ming,9999,0,9999,0
1656998461764,MATH 197,004,095571,Perols; Johan Lars,9998,0,9999,1
1656998468826,COGS 9,A01,083615,Shannon; Kyle Michael,7,0,75,68
1656998474848,COGS 11,A01,083617,Boyle; Mary E. T.,20,0,48,28
1656998480873,COGS 13,A01,083071,Bastos; Amalia Pinkusfeld,9,0,71,62
1656998486898,COGS 14A,A01,092681,Semenuks; Arturs,0,1,100,100
1656998492921,COGS 14B,A01,083073,Cheng; Tzu-Han,5,0,63,58
1656998498944,COGS 17,A01,092677,Semenuks; Arturs,4,0,81,77
1656998504967,COGS 100,A01,083619,Allen; Michael Gordon,15,0,70,55
1656998510994,COGS 101A,A01,083621,Davis; Joshua Daniel,9,0,68,59
1656998517017,COGS 101B,A01,091572,Allen; Michael Gordon,8,0,65,57
1656998523040,COGS 101C,A01,083625,Delgado; Tania,17,0,35,18
1656998529066,COGS 107A,A01,083627,Boyle; Mary E. T.,13,0,60,47
1656998535098,COGS 118A,A01,083075,Gupta; Anjum,15,0,76,61
1656998541122,CSE 3,A50,083646,Miranda; Gregory Joseph,22,0,50,28
1656998547153,CSE 8A,A50,083650,Miranda; Gregory Joseph,17,1,56,39
1656998553177,CSE 11,A01,083080,Cao; Yingjun,4,15,40,36
1656998559201,CSE 12,A01,083652,Krause-Levy; Sophia Louisa,21,1,120,99
1656998565224,CSE 15L,A01,083654,Morris; Justin Loren,8,0,50,42
1656998565224,CSE 15L,A02,083655,Morris; Justin Loren,9,0,50,41
1656998571248,CSE 20,A01,083657,Tran; Khoa Dang,37,0,80,43
1656998577271,CSE 21,A01,095574,Bach; Quang Tran,21,0,48,27
1656998583299,CSE 30,A01,083084,Eldon; John,4,0,80,76
1656998583299,CSE 30,B01,095061,Bhaskar; Nishant,6,0,50,44
1656998589326,CSE 100,A01,083659,Cao; Yingjun,3,4,70,67
1656998595351,CSE 134B,A01,083661,Powell; Thomas Allan,19,0,100,81
1656998601378,CSE 140,A01,083663,Gungor; Onat,14,0,85,71
1656998607402,CSE 140L,A01,083088,Eldon; John,16,0,100,84
1656998613431,CSE 175,A01,083665,Kumar; Rakesh,3,0,25,22
1656998619455,CSE 190,A00,092507,Dubnov; Shlomo,7,0,20,13
1656998625479,ECE 45,A01,083139,Congero; Spencer William,5,0,75,70
1656998631506,ECE 65,A50,083695,Saad; Andrew S,12,0,30,18
1656998631506,ECE 65,A51,095125,Saad; Andrew S,25,0,26,1
1656998637530,ECE 109,A01,091882,Touri; Behrouz,16,0,70,54
1656998643567,ECE 180,A00,083140,Abi Samra; Nicholas Camill,1,0,30,29
1656998643567,ECE 180,B00,083141,Abi Samra; Nicholas Camill,0,0,30,30
1656998649589,MATH 10A,A01,083735,Patchell; Gregory David,1,0,30,29
1656998649589,MATH 10A,A02,083736,Patchell; Gregory David,20,0,30,10
1656998649589,MATH 10A,A03,083737,Patchell; Gregory David,16,0,30,14
1656998655614,MATH 10B,A01,083207,Lim; Seonhee,7,0,34,27
1656998655614,MATH 10B,A02,083208,Lim; Seonhee,9,0,35,26
1656998655614,MATH 10B,A03,093472,Lim; Seonhee,4,0,34,30
1656998655614,MATH 10B,B01,083739,Sinha; Shubham,9,0,30,21
1656998661652,MATH 18,A01,083743,Cinel; Cameron Alexander,6,0,30,24
1656998661652,MATH 18,A02,083744,Cinel; Cameron Alexander,15,0,30,15
1656998661652,MATH 18,A03,083745,Cinel; Cameron Alexander,8,0,30,22
1656998661652,MATH 18,B01,083748,Rideout; David Porter,4,0,37,33
1656998661652,MATH 18,B02,083749,Rideout; David Porter,3,0,36,33
1656998661652,MATH 18,B03,083750,Rideout; David Porter,2,0,37,35
1656998661652,MATH 18,B04,083751,Rideout; David Porter,5,0,36,31
1656998661652,MATH 18,B05,093473,Rideout; David Porter,4,0,36,32
1656998661652,MATH 18,B06,093474,Rideout; David Porter,5,0,36,31
1656998667675,MATH 20A,A01,083754,Zheng; Zequn,12,0,40,28
1656998673702,MATH 20B,A01,083756,Briones; Jor-el Thomas Caparas,1,0,36,35
1656998673702,MATH 20B,A02,083757,Briones; Jor-el Thomas Caparas,1,0,36,35
1656998673702,MATH 20B,A03,093475,Briones; Jor-el Thomas Caparas,0,0,36,36
1656998679730,MATH 20C,A01,083760,Briones; Jor-el Thomas Caparas,1,0,35,34
1656998679730,MATH 20C,A02,083761,Briones; Jor-el Thomas Caparas,8,0,35,27
1656998679730,MATH 20C,A03,093476,Briones; Jor-el Thomas Caparas,0,1,36,36
1656998679730,MATH 20C,B01,083762,Bach; Quang Tran,0,0,30,30
1656998685758,MATH 20D,A01,083765,Tran; Brian Kha,4,0,30,26
1656998685758,MATH 20D,A02,083766,Tran; Brian Kha,5,0,30,25
1656998685758,MATH 20D,A03,083767,Tran; Brian Kha,3,0,30,27
1656998691781,MATH 20E,A01,083771,Ganguly; Soumya,5,0,32,27
1656998691781,MATH 20E,A02,083772,Ganguly; Soumya,6,0,32,26
1656998691781,MATH 20E,B01,083773,Ciotti; Benjamin,18,0,35,17
1656998691781,MATH 20E,B02,083774,Ciotti; Benjamin,17,0,35,18
1656998697821,MATH 103A,A01,083777,Greenfeld; Be'Eri,2,0,36,34
1656998697821,MATH 103A,A02,083778,Greenfeld; Be'Eri,5,0,36,31
1656998697821,MATH 103A,A03,093561,Greenfeld; Be'Eri,4,0,36,32
1656998697821,MATH 103A,B01,083779,Greenfeld; Be'Eri,6,0,36,30
1656998697821,MATH 103A,B02,083780,Greenfeld; Be'Eri,2,0,36,34
1656998697821,MATH 103A,B03,093562,Greenfeld; Be'Eri,2,0,36,34
1656998703849,MATH 105,A01,085443,Carter; Anne Toulson,14,0,35,21
1656998703849,MATH 105,A02,093477,Carter; Anne Toulson,20,0,35,15
1656998709877,MATH 109,A01,083213,Ganzberger; Geoffrey Michael,2,0,34,32
1656998709877,MATH 109,A02,083214,Ganzberger; Geoffrey Michael,2,0,34,32
1656998709877,MATH 109,A03,093478,Ganzberger; Geoffrey Michael,1,0,34,33
1656998709877,MATH 109,B01,083215,Ganzberger; Geoffrey Michael,1,0,32,31
1656998709877,MATH 109,B02,083216,Ganzberger; Geoffrey Michael,1,0,32,31
1656998709877,MATH 109,B03,093479,Ganzberger; Geoffrey Michael,6,0,32,26
1656998715903,MATH 142A,A01,083219,Chow; Bennett,6,0,32,26
1656998715903,MATH 142A,A02,083220,Chow; Bennett,10,0,32,22
1656998715903,MATH 142A,A03,093480,Chow; Bennett,7,0,32,25
1656998715903,MATH 142A,B03,093481,Chow; Bennett,7,0,32,25
1656998715903,MATH 142A,B04,093558,Chow; Bennett,11,0,32,21
1656998715903,MATH 142A,B05,093559,Chow; Bennett,6,0,32,26
1656998721927,MATH 193A,A01,083224,Rotar; Vladimir,7,0,34,27
1656998721927,MATH 193A,A02,083225,Rotar; Vladimir,4,0,34,30
1656998721927,MATH 193A,A03,083781,Rotar; Vladimir,1,0,34,33
1656998721927,MATH 193A,A04,083782,Rotar; Vladimir,6,0,34,28
1656998721927,MATH 193A,A05,093482,Rotar; Vladimir,6,0,34,28
1656998727958,MATH 197,001,091859,McAuley; Julian John,9999,0,9999,0
1656998727958,MATH 197,002,095566,Kedlaya; Kiran S.,9997,0,9999,2
1656998727958,MATH 197,003,095567,Xiao; Ming,9999,0,9999,0
1656998727958,MATH 197,004,095571,Perols; Johan Lars,9998,0,9999,1
1656998735023,COGS 9,A01,083615,Shannon; Kyle Michael,7,0,75,68
1656998741049,COGS 11,A01,083617,Boyle; Mary E. T.,20,0,48,28
1656998747073,COGS 13,A01,083071,Bastos; Amalia Pinkusfeld,9,0,71,62
1656998753099,COGS 14A,A01,092681,Semenuks; Arturs,0,1,100,100
1656998759126,COGS 14B,A01,083073,Cheng; Tzu-Han,5,0,63,58
1656998765153,COGS 17,A01,092677,Semenuks; Arturs,4,0,81,77
1656998771181,COGS 100,A01,083619,Allen; Michael Gordon,15,0,70,55
1656998777208,COGS 101A,A01,083621,Davis; Joshua Daniel,9,0,68,59
1656998783232,COGS 101B,A01,091572,Allen; Michael Gordon,8,0,65,57
1656998789256,COGS 101C,A01,083625,Delgado; Tania,17,0,35,18
1656998795280,COGS 107A,A01,083627,Boyle; Mary E. T.,13,0,60,47
1656998801308,COGS 118A,A01,083075,Gupta; Anjum,15,0,76,61
1656998807340,CSE 3,A50,083646,Miranda; Gregory Joseph,22,0,50,28
1656998813365,CSE 8A,A50,083650,Miranda; Gregory Joseph,17,1,56,39
1656998819394,CSE 11,A01,083080,Cao; Yingjun,4,15,40,36
1656998825417,CSE 12,A01,083652,Krause-Levy; Sophia Louisa,21,1,120,99
1656998831441,CSE 15L,A01,083654,Morris; Justin Loren,8,0,50,42
1656998831441,CSE 15L,A02,083655,Morris; Justin Loren,9,0,50,41
1656998837472,CSE 20,A01,083657,Tran; Khoa Dang,37,0,80,43
1656998843498,CSE 21,A01,095574,Bach; Quang Tran,21,0,48,27
1656998849522,CSE 30,A01,083084,Eldon; John,4,0,80,76
1656998849522,CSE 30,B01,095061,Bhaskar; Nishant,6,0,50,44
1656998855555,CSE 100,A01,083659,Cao; Yingjun,3,4,70,67
1656998861582,CSE 134B,A01,083661,Powell; Thomas Allan,19,0,100,81
1656998867610,CSE 140,A01,083663,Gungor; Onat,14,0,85,71
1656998873650,CSE 140L,A01,083088,Eldon; John,16,0,100,84
1656998879671,CSE 175,A01,083665,Kumar; Rakesh,3,0,25,22
1656998885774,CSE 190,A00,092507,Dubnov; Shlomo,7,0,20,13
1656998891801,ECE 45,A01,083139,Congero; Spencer William,5,0,75,70
1656998897831,ECE 65,A50,083695,Saad; Andrew S,12,0,30,18
1656998897831,ECE 65,A51,095125,Saad; Andrew S,25,0,26,1
1656998903860,ECE 109,A01,091882,Touri; Behrouz,16,0,70,54
1656998909886,ECE 180,A00,083140,Abi Samra; Nicholas Camill,1,0,30,29
1656998909886,ECE 180,B00,083141,Abi Samra; Nicholas Camill,0,0,30,30
1656998915917,MATH 10A,A01,083735,Patchell; Gregory David,1,0,30,29
1656998915917,MATH 10A,A02,083736,Patchell; Gregory David,20,0,30,10
1656998915917,MATH 10A,A03,083737,Patchell; Gregory David,16,0,30,14
1656998921942,MATH 10B,A01,083207,Lim; Seonhee,7,0,34,27
1656998921942,MATH 10B,A02,083208,Lim; Seonhee,9,0,35,26
1656998921942,MATH 10B,A03,093472,Lim; Seonhee,4,0,34,30
1656998921942,MATH 10B,B01,083739,Sinha; Shubham,9,0,30,21
1656998927966,MATH 18,A01,083743,Cinel; Cameron Alexander,6,0,30,24
1656998927966,MATH 18,A02,083744,Cinel; Cameron Alexander,15,0,30,15
1656998927966,MATH 18,A03,083745,Cinel; Cameron Alexander,8,0,30,22
1656998927966,MATH 18,B01,083748,Rideout; David Porter,4,0,37,33
1656998927966,MATH 18,B02,083749,Rideout; David Porter,3,0,36,33
1656998927966,MATH 18,B03,083750,Rideout; David Porter,2,0,37,35
1656998927966,MATH 18,B04,083751,Rideout; David Porter,5,0,36,31
1656998927966,MATH 18,B05,093473,Rideout; David Porter,4,0,36,32
1656998927966,MATH 18,B06,093474,Rideout; David Porter,5,0,36,31
1656998933989,MATH 20A,A01,083754,Zheng; Zequn,12,0,40,28
1656998940016,MATH 20B,A01,083756,Briones; Jor-el Thomas Caparas,1,0,36,35
1656998940016,MATH 20B,A02,083757,Briones; Jor-el Thomas Caparas,1,0,36,35
1656998940016,MATH 20B,A03,093475,Briones; Jor-el Thomas Caparas,0,0,36,36
1656998946042,MATH 20C,A01,083760,Briones; Jor-el Thomas Caparas,1,0,35,34
1656998946042,MATH 20C,A02,083761,Briones; Jor-el Thomas Caparas,8,0,35,27
1656998946042,MATH 20C,A03,093476,Briones; Jor-el Thomas Caparas,0,1,36,36
1656998946042,MATH 20C,B01,083762,Bach; Quang Tran,0,0,30,30
1656998952069,MATH 20D,A01,083765,Tran; Brian Kha,4,0,30,26
1656998952069,MATH 20D,A02,083766,Tran; Brian Kha,5,0,30,25
1656998952069,MATH 20D,A03,083767,Tran; Brian Kha,3,0,30,27
1656998958098,MATH 20E,A01,083771,Ganguly; Soumya,5,0,32,27
1656998958098,MATH 20E,A02,083772,Ganguly; Soumya,6,0,32,26
1656998958098,MATH 20E,B01,083773,Ciotti; Benjamin,18,0,35,17
1656998958098,MATH 20E,B02,083774,Ciotti; Benjamin,17,0,35,18
1656998964120,MATH 103A,A01,083777,Greenfeld; Be'Eri,2,0,36,34
1656998964120,MATH 103A,A02,083778,Greenfeld; Be'Eri,5,0,36,31
1656998964120,MATH 103A,A03,093561,Greenfeld; Be'Eri,4,0,36,32
1656998964120,MATH 103A,B01,083779,Greenfeld; Be'Eri,6,0,36,30
1656998964120,MATH 103A,B02,083780,Greenfeld; Be'Eri,2,0,36,34
1656998964120,MATH 103A,B03,093562,Greenfeld; Be'Eri,2,0,36,34
1656998970146,MATH 105,A01,085443,Carter; Anne Toulson,14,0,35,21
1656998970146,MATH 105,A02,093477,Carter; Anne Toulson,20,0,35,15
1656998976174,MATH 109,A01,083213,Ganzberger; Geoffrey Michael,2,0,34,32
1656998976174,MATH 109,A02,083214,Ganzberger; Geoffrey Michael,2,0,34,32
1656998976174,MATH 109,A03,093478,Ganzberger; Geoffrey Michael,1,0,34,33
1656998976174,MATH 109,B01,083215,Ganzberger; Geoffrey Michael,1,0,32,31
1656998976174,MATH 109,B02,083216,Ganzberger; Geoffrey Michael,1,0,32,31
1656998976174,MATH 109,B03,093479,Ganzberger; Geoffrey Michael,6,0,32,26
1656998982200,MATH 142A,A01,083219,Chow; Bennett,6,0,32,26
1656998982200,MATH 142A,A02,083220,Chow; Bennett,10,0,32,22
1656998982200,MATH 142A,A03,093480,Chow; Bennett,7,0,32,25
1656998982200,MATH 142A,B03,093481,Chow; Bennett,7,0,32,25
1656998982200,MATH 142A,B04,093558,Chow; Bennett,11,0,32,21
1656998982200,MATH 142A,B05,093559,Chow; Bennett,6,0,32,26
1656998988228,MATH 193A,A01,083224,Rotar; Vladimir,7,0,34,27
1656998988228,MATH 193A,A02,083225,Rotar; Vladimir,4,0,34,30
1656998988228,MATH 193A,A03,083781,Rotar; Vladimir,1,0,34,33
1656998988228,MATH 193A,A04,083782,Rotar; Vladimir,6,0,34,28
1656998988228,MATH 193A,A05,093482,Rotar; Vladimir,6,0,34,28
1656998994249,MATH 197,001,091859,McAuley; Julian John,9999,0,9999,0
1656998994249,MATH 197,002,095566,Kedlaya; Kiran S.,9997,0,9999,2
1656998994249,MATH 197,003,095567,Xiao; Ming,9999,0,9999,0
1656998994249,MATH 197,004,095571,Perols; Johan Lars,9998,0,9999,1
1656999001305,COGS 9,A01,083615,Shannon; Kyle Michael,7,0,75,68
1656999007327,COGS 11,A01,083617,Boyle; Mary E. T.,20,0,48,28
1656999013354,COGS 13,A01,083071,Bastos; Amalia Pinkusfeld,9,0,71,62
1656999019381,COGS 14A,A01,092681,Semenuks; Arturs,0,1,100,100
1656999025405,COGS 14B,A01,083073,Cheng; Tzu-Han,5,0,63,58
1656999031432,COGS 17,A01,092677,Semenuks; Arturs,4,0,81,77
1656999037458,COGS 100,A01,083619,Allen; Michael Gordon,15,0,70,55
1656999043485,COGS 101A,A01,083621,Davis; Joshua Daniel,9,0,68,59
1656999049512,COGS 101B,A01,091572,Allen; Michael Gordon,8,0,65,57
1656999055537,COGS 101C,A01,083625,Delgado; Tania,17,0,35,18
1656999061563,COGS 107A,A01,083627,Boyle; Mary E. T.,13,0,60,47
1656999067584,COGS 118A,A01,083075,Gupta; Anjum,15,0,76,61
1656999073608,CSE 3,A50,083646,Miranda; Gregory Joseph,22,0,50,28
1656999079637,CSE 8A,A50,083650,Miranda; Gregory Joseph,17,1,56,39
1656999085658,CSE 11,A01,083080,Cao; Yingjun,4,15,40,36
1656999091688,CSE 12,A01,083652,Krause-Levy; Sophia Louisa,21,1,120,99
1656999097715,CSE 15L,A01,083654,Morris; Justin Loren,8,0,50,42
1656999097715,CSE 15L,A02,083655,Morris; Justin Loren,9,0,50,41
1656999103737,CSE 20,A01,083657,Tran; Khoa Dang,37,0,80,43
1656999109759,CSE 21,A01,095574,Bach; Quang Tran,21,0,48,27
1656999115785,CSE 30,A01,083084,Eldon; John,4,0,80,76
1656999115785,CSE 30,B01,095061,Bhaskar; Nishant,6,0,50,44
1656999121807,CSE 100,A01,083659,Cao; Yingjun,3,4,70,67
1656999127828,CSE 134B,A01,083661,Powell; Thomas Allan,19,0,100,81
1656999133852,CSE 140,A01,083663,Gungor; Onat,14,0,85,71
1656999139879,CSE 140L,A01,083088,Eldon; John,16,0,100,84
1656999145902,CSE 175,A01,083665,Kumar; Rakesh,3,0,25,22
1656999151926,CSE 190,A00,092507,Dubnov; Shlomo,7,0,20,13
1656999157947,ECE 45,A01,083139,Congero; Spencer William,5,0,75,70
1656999163976,ECE 65,A50,083695,Saad; Andrew S,12,0,30,18
1656999163976,ECE 65,A51,095125,Saad; Andrew S,25,0,26,1
1656999170003,ECE 109,A01,091882,Touri; Behrouz,16,0,70,54
1656999176025,ECE 180,A00,083140,Abi Samra; Nicholas Camill,1,0,30,29
1656999176025,ECE 180,B00,083141,Abi Samra; Nicholas Camill,0,0,30,30
1656999182048,MATH 10A,A01,083735,Patchell; Gregory David,1,0,30,29
1656999182048,MATH 10A,A02,083736,Patchell; Gregory David,20,0,30,10
1656999182048,MATH 10A,A03,083737,Patchell; Gregory David,16,0,30,14
1656999188077,MATH 10B,A01,083207,Lim; Seonhee,7,0,34,27
1656999188077,MATH 10B,A02,083208,Lim; Seonhee,9,0,35,26
1656999188077,MATH 10B,A03,093472,Lim; Seonhee,4,0,34,30
1656999188077,MATH 10B,B01,083739,Sinha; Shubham,9,0,30,21
1656999194107,MATH 18,A01,083743,Cinel; Cameron Alexander,6,0,30,24
1656999194107,MATH 18,A02,083744,Cinel; Cameron Alexander,15,0,30,15
1656999194107,MATH 18,A03,083745,Cinel; Cameron Alexander,8,0,30,22
1656999194107,MATH 18,B01,083748,Rideout; David Porter,4,0,37,33
1656999194107,MATH 18,B02,083749,Rideout; David Porter,3,0,36,33
1656999194107,MATH 18,B03,083750,Rideout; David Porter,2,0,37,35
1656999194107,MATH 18,B04,083751,Rideout; David Porter,5,0,36,31
1656999194107,MATH 18,B05,093473,Rideout; David Porter,4,0,36,32
1656999194107,MATH 18,B06,093474,Rideout; David Porter,5,0,36,31
1656999200132,MATH 20A,A01,083754,Zheng; Zequn,12,0,40,28
1656999206154,MATH 20B,A01,083756,Briones; Jor-el Thomas Caparas,1,0,36,35
1656999206154,MATH 20B,A02,083757,Briones; Jor-el Thomas Caparas,1,0,36,35
1656999206154,MATH 20B,A03,093475,Briones; Jor-el Thomas Caparas,0,0,36,36
1656999212185,MATH 20C,A01,083760,Briones; Jor-el Thomas Caparas,1,0,35,34
1656999212185,MATH 20C,A02,083761,Briones; Jor-el Thomas Caparas,8,0,35,27
1656999212185,MATH 20C,A03,093476,Briones; Jor-el Thomas Caparas,0,1,36,36
1656999212185,MATH 20C,B01,083762,Bach; Quang Tran,0,0,30,30
1656999218213,MATH 20D,A01,083765,Tran; Brian Kha,4,0,30,26
1656999218213,MATH 20D,A02,083766,Tran; Brian Kha,5,0,30,25
1656999218213,MATH 20D,A03,083767,Tran; Brian Kha,3,0,30,27
1656999224237,MATH 20E,A01,083771,Ganguly; Soumya,5,0,32,27
1656999224237,MATH 20E,A02,083772,Ganguly; Soumya,6,0,32,26
1656999224237,MATH 20E,B01,083773,Ciotti; Benjamin,18,0,35,17
1656999224237,MATH 20E,B02,083774,Ciotti; Benjamin,17,0,35,18
1656999230261,MATH 103A,A01,083777,Greenfeld; Be'Eri,2,0,36,34
1656999230261,MATH 103A,A02,083778,Greenfeld; Be'Eri,5,0,36,31
1656999230261,MATH 103A,A03,093561,Greenfeld; Be'Eri,4,0,36,32
1656999230261,MATH 103A,B01,083779,Greenfeld; Be'Eri,6,0,36,30
1656999230261,MATH 103A,B02,083780,Greenfeld; Be'Eri,2,0,36,34
1656999230261,MATH 103A,B03,093562,Greenfeld; Be'Eri,2,0,36,34
1656999236292,MATH 105,A01,085443,Carter; Anne Toulson,14,0,35,21
1656999236292,MATH 105,A02,093477,Carter; Anne Toulson,20,0,35,15
1656999242316,MATH 109,A01,083213,Ganzberger; Geoffrey Michael,2,0,34,32
1656999242316,MATH 109,A02,083214,Ganzberger; Geoffrey Michael,2,0,34,32
1656999242316,MATH 109,A03,093478,Ganzberger; Geoffrey Michael,1,0,34,33
1656999242316,MATH 109,B01,083215,Ganzberger; Geoffrey Michael,1,0,32,31
1656999242316,MATH 109,B02,083216,Ganzberger; Geoffrey Michael,1,0,32,31
1656999242316,MATH 109,B03,093479,Ganzberger; Geoffrey Michael,6,0,32,26
1656999248341,MATH 142A,A01,083219,Chow; Bennett,6,0,32,26
1656999248341,MATH 142A,A02,083220,Chow; Bennett,10,0,32,22
1656999248341,MATH 142A,A03,093480,Chow; Bennett,7,0,32,25
1656999248341,MATH 142A,B03,093481,Chow; Bennett,7,0,32,25
1656999248341,MATH 142A,B04,093558,Chow; Bennett,11,0,32,21
1656999248341,MATH 142A,B05,093559,Chow; Bennett,6,0,32,26
1656999254365,MATH 193A,A01,083224,Rotar; Vladimir,7,0,34,27
1656999254365,MATH 193A,A02,083225,Rotar; Vladimir,4,0,34,30
1656999254365,MATH 193A,A03,083781,Rotar; Vladimir,1,0,34,33
1656999254365,MATH 193A,A04,083782,Rotar; Vladimir,6,0,34,28
1656999254365,MATH 193A,A05,093482,Rotar; Vladimir,6,0,34,28
1656999260390,MATH 197,001,091859,McAuley; Julian John,9999,0,9999,0
1656999260390,MATH 197,002,095566,Kedlaya; Kiran S.,9997,0,9999,2
1656999260390,MATH 197,003,095567,Xiao; Ming,9999,0,9999,0
1656999260390,MATH 197,004,095571,Perols; Johan Lars,9998,0,9999,1
1656999267461,COGS 9,A01,083615,Shannon; Kyle Michael,7,0,75,68
1656999273485,COGS 11,A01,083617,Boyle; Mary E. T.,20,0,48,28
1656999279509,COGS 13,A01,083071,Bastos; Amalia Pinkusfeld,9,0,71,62
1656999285535,COGS 14A,A01,092681,Semenuks; Arturs,0,1,100,100
1656999291563,COGS 14B,A01,083073,Cheng; Tzu-Han,5,0,63,58
1656999297588,COGS 17,A01,092677,Semenuks; Arturs,4,0,81,77
1656999303616,COGS 100,A01,083619,Allen; Michael Gordon,15,0,70,55
1656999309638,COGS 101A,A01,083621,Davis; Joshua Daniel,9,0,68,59
1656999315663,COGS 101B,A01,091572,Allen; Michael Gordon,8,0,65,57
1656999321691,COGS 101C,A01,083625,Delgado; Tania,17,0,35,18
1656999327717,COGS 107A,A01,083627,Boyle; Mary E. T.,13,0,60,47
1656999333740,COGS 118A,A01,083075,Gupta; Anjum,15,0,76,61
1656999339774,CSE 3,A50,083646,Miranda; Gregory Joseph,22,0,50,28
1656999345801,CSE 8A,A50,083650,Miranda; Gregory Joseph,17,1,56,39
1656999351827,CSE 11,A01,083080,Cao; Yingjun,4,15,40,36
1656999357852,CSE 12,A01,083652,Krause-Levy; Sophia Louisa,21,1,120,99
1656999363880,CSE 15L,A01,083654,Morris; Justin Loren,8,0,50,42
1656999363880,CSE 15L,A02,083655,Morris; Justin Loren,9,0,50,41
1656999369903,CSE 20,A01,083657,Tran; Khoa Dang,37,0,80,43
1656999375928,CSE 21,A01,095574,Bach; Quang Tran,21,0,48,27
1656999381952,CSE 30,A01,083084,Eldon; John,4,0,80,76
1656999381952,CSE 30,B01,095061,Bhaskar; Nishant,6,0,50,44
1656999387978,CSE 100,A01,083659,Cao; Yingjun,3,4,70,67
1656999394000,CSE 134B,A01,083661,Powell; Thomas Allan,19,0,100,81
1656999400023,CSE 140,A01,083663,Gungor; Onat,14,0,85,71
1656999406049,CSE 140L,A01,083088,Eldon; John,16,0,100,84
1656999412078,CSE 175,A01,083665,Kumar; Rakesh,3,0,25,22
1656999418109,CSE 190,A00,092507,Dubnov; Shlomo,7,0,20,13
1656999424131,ECE 45,A01,083139,Congero; Spencer William,5,0,75,70
1656999430155,ECE 65,A50,083695,Saad; Andrew S,12,0,30,18
1656999430155,ECE 65,A51,095125,Saad; Andrew S,25,0,26,1
1656999436178,ECE 109,A01,091882,Touri; Behrouz,16,0,70,54
1656999442203,ECE 180,A00,083140,Abi Samra; Nicholas Camill,1,0,30,29
1656999442203,ECE 180,B00,083141,Abi Samra; Nicholas Camill,0,0,30,30
1656999448229,MATH 10A,A01,083735,Patchell; Gregory David,1,0,30,29
1656999448229,MATH 10A,A02,083736,Patchell; Gregory David,20,0,30,10
1656999448229,MATH 10A,A03,083737,Patchell; Gregory David,16,0,30,14
1656999454259,MATH 10B,A01,083207,Lim; Seonhee,7,0,34,27
1656999454259,MATH 10B,A02,083208,Lim; Seonhee,9,0,35,26
1656999454259,MATH 10B,A03,093472,Lim; Seonhee,4,0,34,30
1656999454259,MATH 10B,B01,083739,Sinha; Shubham,9,0,30,21
1656999460283,MATH 18,A01,083743,Cinel; Cameron Alexander,6,0,30,24
1656999460283,MATH 18,A02,083744,Cinel; Cameron Alexander,15,0,30,15
1656999460283,MATH 18,A03,083745,Cinel; Cameron Alexander,8,0,30,22
1656999460283,MATH 18,B01,083748,Rideout; David Porter,4,0,37,33
1656999460283,MATH 18,B02,083749,Rideout; David Porter,3,0,36,33
1656999460283,MATH 18,B03,083750,Rideout; David Porter,2,0,37,35
1656999460283,MATH 18,B04,083751,Rideout; David Porter,5,0,36,31
1656999460283,MATH 18,B05,093473,Rideout; David Porter,4,0,36,32
1656999460283,MATH 18,B06,093474,Rideout; David Porter,5,0,36,31
1656999466310,MATH 20A,A01,083754,Zheng; Zequn,12,0,40,28
1656999472333,MATH 20B,A01,083756,Briones; Jor-el Thomas Caparas,1,0,36,35
1656999472333,MATH 20B,A02,083757,Briones; Jor-el Thomas Caparas,1,0,36,35
1656999472333,MATH 20B,A03,093475,Briones; Jor-el Thomas Caparas,0,0,36,36
1656999478358,MATH 20C,A01,083760,Briones; Jor-el Thomas Caparas,1,0,35,34
1656999478358,MATH 20C,A02,083761,Briones; Jor-el Thomas Caparas,8,0,35,27
1656999478358,MATH 20C,A03,093476,Briones; Jor-el Thomas Caparas,0,1,36,36
1656999478358,MATH 20C,B01,083762,Bach; Quang Tran,0,0,30,30
1656999484475,MATH 20D,A01,083765,Tran; Brian Kha,4,0,30,26
1656999484475,MATH 20D,A02,083766,Tran; Brian Kha,5,0,30,25
1656999484475,MATH 20D,A03,083767,Tran; Brian Kha,3,0,30,27
1656999490499,MATH 20E,A01,083771,Ganguly; Soumya,5,0,32,27
1656999490499,MATH 20E,A02,083772,Ganguly; Soumya,6,0,32,26
1656999490499,MATH 20E,B01,083773,Ciotti; Benjamin,18,0,35,17
1656999490499,MATH 20E,B02,083774,Ciotti; Benjamin,17,0,35,18
1656999496522,MATH 103A,A01,083777,Greenfeld; Be'Eri,2,0,36,34
1656999496522,MATH 103A,A02,083778,Greenfeld; Be'Eri,5,0,36,31
1656999496522,MATH 103A,A03,093561,Greenfeld; Be'Eri,4,0,36,32
1656999496522,MATH 103A,B01,083779,Greenfeld; Be'Eri,6,0,36,30
1656999496522,MATH 103A,B02,083780,Greenfeld; Be'Eri,2,0,36,34
1656999496522,MATH 103A,B03,093562,Greenfeld; Be'Eri,2,0,36,34
1656999502550,MATH 105,A01,085443,Carter; Anne Toulson,14,0,35,21
1656999502550,MATH 105,A02,093477,Carter; Anne Toulson,20,0,35,15
1656999508574,MATH 109,A01,083213,Ganzberger; Geoffrey Michael,2,0,34,32
1656999508574,MATH 109,A02,083214,Ganzberger; Geoffrey Michael,2,0,34,32
1656999508574,MATH 109,A03,093478,Ganzberger; Geoffrey Michael,1,0,34,33
1656999508574,MATH 109,B01,083215,Ganzberger; Geoffrey Michael,1,0,32,31
1656999508574,MATH 109,B02,083216,Ganzberger; Geoffrey Michael,1,0,32,31
1656999508574,MATH 109,B03,093479,Ganzberger; Geoffrey Michael,6,0,32,26
1656999514604,MATH 142A,A01,083219,Chow; Bennett,6,0,32,26
1656999514604,MATH 142A,A02,083220,Chow; Bennett,10,0,32,22
1656999514604,MATH 142A,A03,093480,Chow; Bennett,7,0,32,25
1656999514604,MATH 142A,B03,093481,Chow; Bennett,7,0,32,25
1656999514604,MATH 142A,B04,093558,Chow; Bennett,11,0,32,21
1656999514604,MATH 142A,B05,093559,Chow; Bennett,6,0,32,26
1656999520627,MATH 193A,A01,083224,Rotar; Vladimir,7,0,34,27
1656999520627,MATH 193A,A02,083225,Rotar; Vladimir,4,0,34,30
1656999520627,MATH 193A,A03,083781,Rotar; Vladimir,1,0,34,33
1656999520627,MATH 193A,A04,083782,Rotar; Vladimir,6,0,34,28
1656999520627,MATH 193A,A05,093482,Rotar; Vladimir,6,0,34,28
1656999526649,MATH 197,001,091859,McAuley; Julian John,9999,0,9999,0
1656999526649,MATH 197,002,095566,Kedlaya; Kiran S.,9997,0,9999,2
1656999526649,MATH 197,003,095567,Xiao; Ming,9999,0,9999,0
1656999526649,MATH 197,004,095571,Perols; Johan Lars,9998,0,9999,1
1656999533712,COGS 9,A01,083615,Shannon; Kyle Michael,7,0,75,68
1656999539735,COGS 11,A01,083617,Boyle; Mary E. T.,20,0,48,28
1656999545759,COGS 13,A01,083071,Bastos; Amalia Pinkusfeld,9,0,71,62
1656999551780,COGS 14A,A01,092681,Semenuks; Arturs,0,1,100,100
1656999557805,COGS 14B,A01,083073,Cheng; Tzu-Han,5,0,63,58
1656999563828,COGS 17,A01,092677,Semenuks; Arturs,4,0,81,77
1656999569854,COGS 100,A01,083619,Allen; Michael Gordon,15,0,70,55
1656999575879,COGS 101A,A01,083621,Davis; Joshua Daniel,9,0,68,59
1656999581901,COGS 101B,A01,091572,Allen; Michael Gordon,8,0,65,57
1656999587924,COGS 101C,A01,083625,Delgado; Tania,17,0,35,18
1656999593948,COGS 107A,A01,083627,Boyle; Mary E. T.,13,0,60,47
1656999599976,COGS 118A,A01,083075,Gupta; Anjum,15,0,76,61
1656999606014,CSE 3,A50,083646,Miranda; Gregory Joseph,22,0,50,28
1656999612039,CSE 8A,A50,083650,Miranda; Gregory Joseph,17,1,56,39
1656999618062,CSE 11,A01,083080,Cao; Yingjun,4,15,40,36
1656999624095,CSE 12,A01,083652,Krause-Levy; Sophia Louisa,21,1,120,99
1656999630119,CSE 15L,A01,083654,Morris; Justin Loren,8,0,50,42
1656999630119,CSE 15L,A02,083655,Morris; Justin Loren,9,0,50,41
1656999636145,CSE 20,A01,083657,Tran; Khoa Dang,37,0,80,43
1656999642173,CSE 21,A01,095574,Bach; Quang Tran,21,0,48,27
1656999648196,CSE 30,A01,083084,Eldon; John,4,0,80,76
1656999648196,CSE 30,B01,095061,Bhaskar; Nishant,6,0,50,44
1656999654220,CSE 100,A01,083659,Cao; Yingjun,3,4,70,67
1656999660254,CSE 134B,A01,083661,Powell; Thomas Allan,19,0,100,81
1656999666276,CSE 140,A01,083663,Gungor; Onat,14,0,85,71
1656999672301,CSE 140L,A01,083088,Eldon; John,16,0,100,84
1656999678325,CSE 175,A01,083665,Kumar; Rakesh,3,0,25,22
1656999684348,CSE 190,A00,092507,Dubnov; Shlomo,7,0,20,13
1656999690374,ECE 45,A01,083139,Congero; Spencer William,5,0,75,70
1656999696397,ECE 65,A50,083695,Saad; Andrew S,12,0,30,18
1656999696397,ECE 65,A51,095125,Saad; Andrew S,25,0,26,1
1656999702424,ECE 109,A01,091882,Touri; Behrouz,16,0,70,54
1656999708450,ECE 180,A00,083140,Abi Samra; Nicholas Camill,1,0,30,29
1656999708450,ECE 180,B00,083141,Abi Samra; Nicholas Camill,0,0,30,30
1656999714474,MATH 10A,A01,083735,Patchell; Gregory David,1,0,30,29
1656999714474,MATH 10A,A02,083736,Patchell; Gregory David,20,0,30,10
1656999714474,MATH 10A,A03,083737,Patchell; Gregory David,16,0,30,14
1656999720504,MATH 10B,A01,083207,Lim; Seonhee,7,0,34,27
1656999720504,MATH 10B,A02,083208,Lim; Seonhee,9,0,35,26
1656999720504,MATH 10B,A03,093472,Lim; Seonhee,4,0,34,30
1656999720504,MATH 10B,B01,083739,Sinha; Shubham,9,0,30,21
1656999726528,MATH 18,A01,083743,Cinel; Cameron Alexander,6,0,30,24
1656999726528,MATH 18,A02,083744,Cinel; Cameron Alexander,15,0,30,15
1656999726528,MATH 18,A03,083745,Cinel; Cameron Alexander,8,0,30,22
1656999726528,MATH 18,B01,083748,Rideout; David Porter,4,0,37,33
1656999726528,MATH 18,B02,083749,Rideout; David Porter,3,0,36,33
1656999726528,MATH 18,B03,083750,Rideout; David Porter,2,0,37,35
1656999726528,MATH 18,B04,083751,Rideout; David Porter,5,0,36,31
1656999726528,MATH 18,B05,093473,Rideout; David Porter,4,0,36,32
1656999726528,MATH 18,B06,093474,Rideout; David Porter,5,0,36,31
1656999732552,MATH 20A,A01,083754,Zheng; Zequn,12,0,40,28
1656999738576,MATH 20B,A01,083756,Briones; Jor-el Thomas Caparas,1,0,36,35
1656999738576,MATH 20B,A02,083757,Briones; Jor-el Thomas Caparas,1,0,36,35
1656999738576,MATH 20B,A03,093475,Briones; Jor-el Thomas Caparas,0,0,36,36
1656999744599,MATH 20C,A01,083760,Briones; Jor-el Thomas Caparas,1,0,35,34
1656999744599,MATH 20C,A02,083761,Briones; Jor-el Thomas Caparas,8,0,35,27
1656999744599,MATH 20C,A03,093476,Briones; Jor-el Thomas Caparas,0,1,36,36
1656999744599,MATH 20C,B01,083762,Bach; Quang Tran,0,0,30,30
1656999750623,MATH 20D,A01,083765,Tran; Brian Kha,4,0,30,26
1656999750623,MATH 20D,A02,083766,Tran; Brian Kha,5,0,30,25
1656999750623,MATH 20D,A03,083767,Tran; Brian Kha,3,0,30,27
1656999756651,MATH 20E,A01,083771,Ganguly; Soumya,5,0,32,27
1656999756651,MATH 20E,A02,083772,Ganguly; Soumya,6,0,32,26
1656999756651,MATH 20E,B01,083773,Ciotti; Benjamin,18,0,35,17
1656999756651,MATH 20E,B02,083774,Ciotti; Benjamin,17,0,35,18
1656999762675,MATH 103A,A01,083777,Greenfeld; Be'Eri,2,0,36,34
1656999762675,MATH 103A,A02,083778,Greenfeld; Be'Eri,5,0,36,31
1656999762675,MATH 103A,A03,093561,Greenfeld; Be'Eri,4,0,36,32
1656999762675,MATH 103A,B01,083779,Greenfeld; Be'Eri,6,0,36,30
1656999762675,MATH 103A,B02,083780,Greenfeld; Be'Eri,2,0,36,34
1656999762675,MATH 103A,B03,093562,Greenfeld; Be'Eri,2,0,36,34
1656999768702,MATH 105,A01,085443,Carter; Anne Toulson,14,0,35,21
1656999768702,MATH 105,A02,093477,Carter; Anne Toulson,20,0,35,15
1656999774731,MATH 109,A01,083213,Ganzberger; Geoffrey Michael,2,0,34,32
1656999774731,MATH 109,A02,083214,Ganzberger; Geoffrey Michael,2,0,34,32
1656999774731,MATH 109,A03,093478,Ganzberger; Geoffrey Michael,1,0,34,33
1656999774731,MATH 109,B01,083215,Ganzberger; Geoffrey Michael,1,0,32,31
1656999774731,MATH 109,B02,083216,Ganzberger; Geoffrey Michael,1,0,32,31
1656999774731,MATH 109,B03,093479,Ganzberger; Geoffrey Michael,6,0,32,26
1656999780755,MATH 142A,A01,083219,Chow; Bennett,6,0,32,26
1656999780755,MATH 142A,A02,083220,Chow; Bennett,10,0,32,22
1656999780755,MATH 142A,A03,093480,Chow; Bennett,7,0,32,25
1656999780755,MATH 142A,B03,093481,Chow; Bennett,7,0,32,25
1656999780755,MATH 142A,B04,093558,Chow; Bennett,11,0,32,21
1656999780755,MATH 142A,B05,093559,Chow; Bennett,6,0,32,26
1656999786781,MATH 193A,A01,083224,Rotar; Vladimir,7,0,34,27
1656999786781,MATH 193A,A02,083225,Rotar; Vladimir,4,0,34,30
1656999786781,MATH 193A,A03,083781,Rotar; Vladimir,1,0,34,33
1656999786781,MATH 193A,A04,083782,Rotar; Vladimir,6,0,34,28
1656999786781,MATH 193A,A05,093482,Rotar; Vladimir,6,0,34,28
1656999792810,MATH 197,001,091859,McAuley; Julian John,9999,0,9999,0
1656999792810,MATH 197,002,095566,Kedlaya; Kiran S.,9997,0,9999,2
1656999792810,MATH 197,003,095567,Xiao; Ming,9999,0,9999,0
1656999792810,MATH 197,004,095571,Perols; Johan Lars,9998,0,9999,1
1656999799877,COGS 9,A01,083615,Shannon; Kyle Michael,7,0,75,68
1656999805901,COGS 11,A01,083617,Boyle; Mary E. T.,20,0,48,28
1656999811922,COGS 13,A01,083071,Bastos; Amalia Pinkusfeld,9,0,71,62
1656999817948,COGS 14A,A01,092681,Semenuks; Arturs,0,1,100,100
1656999823976,COGS 14B,A01,083073,Cheng; Tzu-Han,5,0,63,58
1656999830003,COGS 17,A01,092677,Semenuks; Arturs,4,0,81,77
1656999836025,COGS 100,A01,083619,Allen; Michael Gordon,15,0,70,55
1656999842052,COGS 101A,A01,083621,Davis; Joshua Daniel,9,0,68,59
1656999848076,COGS 101B,A01,091572,Allen; Michael Gordon,8,0,65,57
1656999854099,COGS 101C,A01,083625,Delgado; Tania,17,0,35,18
1656999860124,COGS 107A,A01,083627,Boyle; Mary E. T.,13,0,60,47
1656999866147,COGS 118A,A01,083075,Gupta; Anjum,15,0,76,61
1656999872176,CSE 3,A50,083646,Miranda; Gregory Joseph,22,0,50,28
1656999878202,CSE 8A,A50,083650,Miranda; Gregory Joseph,17,1,56,39
1656999884225,CSE 11,A01,083080,Cao; Yingjun,4,15,40,36
1656999890248,CSE 12,A01,083652,Krause-Levy; Sophia Louisa,21,1,120,99
1656999896273,CSE 15L,A01,083654,Morris; Justin Loren,8,0,50,42
1656999896273,CSE 15L,A02,083655,Morris; Justin Loren,9,0,50,41
1656999902300,CSE 20,A01,083657,Tran; Khoa Dang,37,0,80,43
1656999908324,CSE 21,A01,095574,Bach; Quang Tran,21,0,48,27
1656999914353,CSE 30,A01,083084,Eldon; John,4,0,80,76
1656999914353,CSE 30,B01,095061,Bhaskar; Nishant,6,0,50,44
1656999920379,CSE 100,A01,083659,Cao; Yingjun,3,4,70,67
1656999926409,CSE 134B,A01,083661,Powell; Thomas Allan,19,0,100,81
1656999932433,CSE 140,A01,083663,Gungor; Onat,14,0,85,71
1656999938460,CSE 140L,A01,083088,Eldon; John,16,0,100,84
1656999944483,CSE 175,A01,083665,Kumar; Rakesh,3,0,25,22
1656999950510,CSE 190,A00,092507,Dubnov; Shlomo,7,0,20,13
1656999956532,ECE 45,A01,083139,Congero; Spencer William,5,0,75,70
1656999962563,ECE 65,A50,083695,Saad; Andrew S,12,0,30,18
1656999962563,ECE 65,A51,095125,Saad; Andrew S,25,0,26,1
1656999968586,ECE 109,A01,091882,Touri; Behrouz,16,0,70,54
1656999974611,ECE 180,A00,083140,Abi Samra; Nicholas Camill,1,0,30,29
1656999974611,ECE 180,B00,083141,Abi Samra; Nicholas Camill,0,0,30,30
1656999980635,MATH 10A,A01,083735,Patchell; Gregory David,1,0,30,29
1656999980635,MATH 10A,A02,083736,Patchell; Gregory David,20,0,30,10
1656999980635,MATH 10A,A03,083737,Patchell; Gregory David,16,0,30,14
1656999986659,MATH 10B,A01,083207,Lim; Seonhee,7,0,34,27
1656999986659,MATH 10B,A02,083208,Lim; Seonhee,9,0,35,26
1656999986659,MATH 10B,A03,093472,Lim; Seonhee,4,0,34,30
1656999986659,MATH 10B,B01,083739,Sinha; Shubham,9,0,30,21
1656999992690,MATH 18,A01,083743,Cinel; Cameron Alexander,6,0,30,24
1656999992690,MATH 18,A02,083744,Cinel; Cameron Alexander,15,0,30,15
1656999992690,MATH 18,A03,083745,Cinel; Cameron Alexander,8,0,30,22
1656999992690,MATH 18,B01,083748,Rideout; David Porter,4,0,37,33
1656999992690,MATH 18,B02,083749,Rideout; David Porter,3,0,36,33
1656999992690,MATH 18,B03,083750,Rideout; David Porter,2,0,37,35
1656999992690,MATH 18,B04,083751,Rideout; David Porter,5,0,36,31
1656999992690,MATH 18,B05,093473,Rideout; David Porter,4,0,36,32
1656999992690,MATH 18,B06,093474,Rideout; David Porter,5,0,36,31
1656999998715,MATH 20A,A01,083754,Zheng; Zequn,12,0,40,28
1657000004742,MATH 20B,A01,083756,Briones; Jor-el Thomas Caparas,1,0,36,35
1657000004742,MATH 20B,A02,083757,Briones; Jor-el Thomas Caparas,1,0,36,35
1657000004742,MATH 20B,A03,093475,Briones; Jor-el Thomas Caparas,0,0,36,36
1657000010766,MATH 20C,A01,083760,Briones; Jor-el Thomas Caparas,1,0,35,34
1657000010766,MATH 20C,A02,083761,Briones; Jor-el Thomas Caparas,8,0,35,27
1657000010766,MATH 20C,A03,093476,Briones; Jor-el Thomas Caparas,0,1,36,36
1657000010766,MATH 20C,B01,083762,Bach; Quang Tran,0,0,30,30
1657000016790,MATH 20D,A01,083765,Tran; Brian Kha,4,0,30,26
1657000016790,MATH 20D,A02,083766,Tran; Brian Kha,5,0,30,25
1657000016790,MATH 20D,A03,083767,Tran; Brian Kha,3,0,30,27
1657000022823,MATH 20E,A01,083771,Ganguly; Soumya,5,0,32,27
1657000022823,MATH 20E,A02,083772,Ganguly; Soumya,6,0,32,26
1657000022823,MATH 20E,B01,083773,Ciotti; Benjamin,18,0,35,17
1657000022823,MATH 20E,B02,083774,Ciotti; Benjamin,17,0,35,18
1657000028847,MATH 103A,A01,083777,Greenfeld; Be'Eri,2,0,36,34
1657000028847,MATH 103A,A02,083778,Greenfeld; Be'Eri,5,0,36,31
1657000028847,MATH 103A,A03,093561,Greenfeld; Be'Eri,4,0,36,32
1657000028847,MATH 103A,B01,083779,Greenfeld; Be'Eri,6,0,36,30
1657000028847,MATH 103A,B02,083780,Greenfeld; Be'Eri,2,0,36,34
1657000028847,MATH 103A,B03,093562,Greenfeld; Be'Eri,2,0,36,34
1657000034871,MATH 105,A01,085443,Carter; Anne Toulson,14,0,35,21
1657000034871,MATH 105,A02,093477,Carter; Anne Toulson,20,0,35,15
1657000040893,MATH 109,A01,083213,Ganzberger; Geoffrey Michael,2,0,34,32
1657000040893,MATH 109,A02,083214,Ganzberger; Geoffrey Michael,2,0,34,32
1657000040893,MATH 109,A03,093478,Ganzberger; Geoffrey Michael,1,0,34,33
1657000040893,MATH 109,B01,083215,Ganzberger; Geoffrey Michael,1,0,32,31
1657000040893,MATH 109,B02,083216,Ganzberger; Geoffrey Michael,1,0,32,31
1657000040893,MATH 109,B03,093479,Ganzberger; Geoffrey Michael,6,0,32,26
1657000046920,MATH 142A,A01,083219,Chow; Bennett,6,0,32,26
1657000046920,MATH 142A,A02,083220,Chow; Bennett,10,0,32,22
1657000046920,MATH 142A,A03,093480,Chow; Bennett,7,0,32,25
1657000046920,MATH 142A,B03,093481,Chow; Bennett,7,0,32,25
1657000046920,MATH 142A,B04,093558,Chow; Bennett,11,0,32,21
1657000046920,MATH 142A,B05,093559,Chow; Bennett,6,0,32,26
1657000052950,MATH 193A,A01,083224,Rotar; Vladimir,7,0,34,27
1657000052950,MATH 193A,A02,083225,Rotar; Vladimir,4,0,34,30
1657000052950,MATH 193A,A03,083781,Rotar; Vladimir,1,0,34,33
1657000052950,MATH 193A,A04,083782,Rotar; Vladimir,6,0,34,28
1657000052950,MATH 193A,A05,093482,Rotar; Vladimir,6,0,34,28
1657000058984,MATH 197,001,091859,McAuley; Julian John,9999,0,9999,0
1657000058984,MATH 197,002,095566,Kedlaya; Kiran S.,9997,0,9999,2
1657000058984,MATH 197,003,095567,Xiao; Ming,9999,0,9999,0
1657000058984,MATH 197,004,095571,Perols; Johan Lars,9998,0,9999,1
1657000066044,COGS 9,A01,083615,Shannon; Kyle Michael,7,0,75,68
1657000072068,COGS 11,A01,083617,Boyle; Mary E. T.,20,0,48,28
1657000078166,COGS 13,A01,083071,Bastos; Amalia Pinkusfeld,9,0,71,62
1657000084194,COGS 14A,A01,092681,Semenuks; Arturs,0,1,100,100
1657000090216,COGS 14B,A01,083073,Cheng; Tzu-Han,5,0,63,58
1657000096240,COGS 17,A01,092677,Semenuks; Arturs,4,0,81,77
1657000102261,COGS 100,A01,083619,Allen; Michael Gordon,15,0,70,55
1657000108284,COGS 101A,A01,083621,Davis; Joshua Daniel,9,0,68,59
1657000114309,COGS 101B,A01,091572,Allen; Michael Gordon,8,0,65,57
1657000120336,COGS 101C,A01,083625,Delgado; Tania,17,0,35,18
1657000126362,COGS 107A,A01,083627,Boyle; Mary E. T.,13,0,60,47
1657000132385,COGS 118A,A01,083075,Gupta; Anjum,15,0,76,61
1657000138407,CSE 3,A50,083646,Miranda; Gregory Joseph,22,0,50,28
1657000144431,CSE 8A,A50,083650,Miranda; Gregory Joseph,17,1,56,39
1657000150456,CSE 11,A01,083080,Cao; Yingjun,4,15,40,36
1657000156480,CSE 12,A01,083652,Krause-Levy; Sophia Louisa,21,1,120,99
1657000162504,CSE 15L,A01,083654,Morris; Justin Loren,8,0,50,42
1657000162504,CSE 15L,A02,083655,Morris; Justin Loren,9,0,50,41
1657000168533,CSE 20,A01,083657,Tran; Khoa Dang,37,0,80,43
1657000174565,CSE 21,A01,095574,Bach; Quang Tran,21,0,48,27
1657000180591,CSE 30,A01,083084,Eldon; John,4,0,80,76
1657000180591,CSE 30,B01,095061,Bhaskar; Nishant,6,0,50,44
1657000186621,CSE 100,A01,083659,Cao; Yingjun,3,4,70,67
1657000192644,CSE 134B,A01,083661,Powell; Thomas Allan,19,0,100,81
1657000198670,CSE 140,A01,083663,Gungor; Onat,14,0,85,71
1657000204691,CSE 140L,A01,083088,Eldon; John,16,0,100,84
1657000210718,CSE 175,A01,083665,Kumar; Rakesh,3,0,25,22
1657000216744,CSE 190,A00,092507,Dubnov; Shlomo,7,0,20,13
1657000222771,ECE 45,A01,083139,Congero; Spencer William,5,0,75,70
1657000228796,ECE 65,A50,083695,Saad; Andrew S,12,0,30,18
1657000228796,ECE 65,A51,095125,Saad; Andrew S,25,0,26,1
1657000234819,ECE 109,A01,091882,Touri; Behrouz,16,0,70,54
1657000240846,ECE 180,A00,083140,Abi Samra; Nicholas Camill,1,0,30,29
1657000240846,ECE 180,B00,083141,Abi Samra; Nicholas Camill,0,0,30,30
1657000246874,MATH 10A,A01,083735,Patchell; Gregory David,1,0,30,29
1657000246874,MATH 10A,A02,083736,Patchell; Gregory David,20,0,30,10
1657000246874,MATH 10A,A03,083737,Patchell; Gregory David,16,0,30,14
1657000252900,MATH 10B,A01,083207,Lim; Seonhee,7,0,34,27
1657000252900,MATH 10B,A02,083208,Lim; Seonhee,9,0,35,26
1657000252900,MATH 10B,A03,093472,Lim; Seonhee,4,0,34,30
1657000252900,MATH 10B,B01,083739,Sinha; Shubham,9,0,30,21
1657000258932,MATH 18,A01,083743,Cinel; Cameron Alexander,6,0,30,24
1657000258932,MATH 18,A02,083744,Cinel; Cameron Alexander,15,0,30,15
1657000258932,MATH 18,A03,083745,Cinel; Cameron Alexander,8,0,30,22
1657000258932,MATH 18,B01,083748,Rideout; David Porter,4,0,37,33
1657000258932,MATH 18,B02,083749,Rideout; David Porter,3,0,36,33
1657000258932,MATH 18,B03,083750,Rideout; David Porter,2,0,37,35
1657000258932,MATH 18,B04,083751,Rideout; David Porter,5,0,36,31
1657000258932,MATH 18,B05,093473,Rideout; David Porter,4,0,36,32
1657000258932,MATH 18,B06,093474,Rideout; David Porter,5,0,36,31
1657000264955,MATH 20A,A01,083754,Zheng; Zequn,12,0,40,28
1657000270979,MATH 20B,A01,083756,Briones; Jor-el Thomas Caparas,1,0,36,35
1657000270979,MATH 20B,A02,083757,Briones; Jor-el Thomas Caparas,1,0,36,35
1657000270979,MATH 20B,A03,093475,Briones; Jor-el Thomas Caparas,0,0,36,36
1657000277004,MATH 20C,A01,083760,Briones; Jor-el Thomas Caparas,1,0,35,34
1657000277004,MATH 20C,A02,083761,Briones; Jor-el Thomas Caparas,8,0,35,27
1657000277004,MATH 20C,A03,093476,Briones; Jor-el Thomas Caparas,0,1,36,36
1657000277004,MATH 20C,B01,083762,Bach; Quang Tran,0,0,30,30
1657000283031,MATH 20D,A01,083765,Tran; Brian Kha,4,0,30,26
1657000283031,MATH 20D,A02,083766,Tran; Brian Kha,5,0,30,25
1657000283031,MATH 20D,A03,083767,Tran; Brian Kha,3,0,30,27
1657000289056,MATH 20E,A01,083771,Ganguly; Soumya,5,0,32,27
1657000289056,MATH 20E,A02,083772,Ganguly; Soumya,6,0,32,26
1657000289056,MATH 20E,B01,083773,Ciotti; Benjamin,18,0,35,17
1657000289056,MATH 20E,B02,083774,Ciotti; Benjamin,17,0,35,18
1657000295086,MATH 103A,A01,083777,Greenfeld; Be'Eri,2,0,36,34
1657000295086,MATH 103A,A02,083778,Greenfeld; Be'Eri,5,0,36,31
1657000295086,MATH 103A,A03,093561,Greenfeld; Be'Eri,4,0,36,32
1657000295086,MATH 103A,B01,083779,Greenfeld; Be'Eri,6,0,36,30
1657000295086,MATH 103A,B02,083780,Greenfeld; Be'Eri,2,0,36,34
1657000295086,MATH 103A,B03,093562,Greenfeld; Be'Eri,2,0,36,34
1657000301110,MATH 105,A01,085443,Carter; Anne Toulson,14,0,35,21
1657000301110,MATH 105,A02,093477,Carter; Anne Toulson,20,0,35,15
1657000307138,MATH 109,A01,083213,Ganzberger; Geoffrey Michael,2,0,34,32
1657000307138,MATH 109,A02,083214,Ganzberger; Geoffrey Michael,2,0,34,32
1657000307138,MATH 109,A03,093478,Ganzberger; Geoffrey Michael,1,0,34,33
1657000307138,MATH 109,B01,083215,Ganzberger; Geoffrey Michael,1,0,32,31
1657000307138,MATH 109,B02,083216,Ganzberger; Geoffrey Michael,1,0,32,31
1657000307138,MATH 109,B03,093479,Ganzberger; Geoffrey Michael,6,0,32,26
1657000313176,MATH 142A,A01,083219,Chow; Bennett,6,0,32,26
1657000313176,MATH 142A,A02,083220,Chow; Bennett,10,0,32,22
1657000313176,MATH 142A,A03,093480,Chow; Bennett,7,0,32,25
1657000313176,MATH 142A,B03,093481,Chow; Bennett,7,0,32,25
1657000313176,MATH 142A,B04,093558,Chow; Bennett,11,0,32,21
1657000313176,MATH 142A,B05,093559,Chow; Bennett,6,0,32,26
1657000319198,MATH 193A,A01,083224,Rotar; Vladimir,7,0,34,27
1657000319198,MATH 193A,A02,083225,Rotar; Vladimir,4,0,34,30
1657000319198,MATH 193A,A03,083781,Rotar; Vladimir,1,0,34,33
1657000319198,MATH 193A,A04,083782,Rotar; Vladimir,6,0,34,28
1657000319198,MATH 193A,A05,093482,Rotar; Vladimir,6,0,34,28
1657000325225,MATH 197,001,091859,McAuley; Julian John,9999,0,9999,0
1657000325225,MATH 197,002,095566,Kedlaya; Kiran S.,9997,0,9999,2
1657000325225,MATH 197,003,095567,Xiao; Ming,9999,0,9999,0
1657000325225,MATH 197,004,095571,Perols; Johan Lars,9998,0,9999,1
1657000332289,COGS 9,A01,083615,Shannon; Kyle Michael,7,0,75,68
1657000338313,COGS 11,A01,083617,Boyle; Mary E. T.,20,0,48,28
1657000344338,COGS 13,A01,083071,Bastos; Amalia Pinkusfeld,9,0,71,62
1657000350365,COGS 14A,A01,092681,Semenuks; Arturs,0,1,100,100
1657000356392,COGS 14B,A01,083073,Cheng; Tzu-Han,5,0,63,58
1657000362418,COGS 17,A01,092677,Semenuks; Arturs,4,0,81,77
1657000368441,COGS 100,A01,083619,Allen; Michael Gordon,15,0,70,55
1657000374466,COGS 101A,A01,083621,Davis; Joshua Daniel,9,0,68,59
1657000380489,COGS 101B,A01,091572,Allen; Michael Gordon,8,0,65,57
1657000386512,COGS 101C,A01,083625,Delgado; Tania,17,0,35,18
1657000392542,COGS 107A,A01,083627,Boyle; Mary E. T.,13,0,60,47
1657000398568,COGS 118A,A01,083075,Gupta; Anjum,15,0,76,61
1657000404595,CSE 3,A50,083646,Miranda; Gregory Joseph,22,0,50,28
1657000410621,CSE 8A,A50,083650,Miranda; Gregory Joseph,17,1,56,39
1657000416648,CSE 11,A01,083080,Cao; Yingjun,4,15,40,36
1657000422672,CSE 12,A01,083652,Krause-Levy; Sophia Louisa,21,1,120,99
1657000428699,CSE 15L,A01,083654,Morris; Justin Loren,8,0,50,42
1657000428699,CSE 15L,A02,083655,Morris; Justin Loren,9,0,50,41
1657000434723,CSE 20,A01,083657,Tran; Khoa Dang,37,0,80,43
1657000440746,CSE 21,A01,095574,Bach; Quang Tran,21,0,48,27
1657000446786,CSE 30,A01,083084,Eldon; John,4,0,80,76
1657000446786,CSE 30,B01,095061,Bhaskar; Nishant,6,0,50,44
1657000452812,CSE 100,A01,083659,Cao; Yingjun,3,4,70,67
1657000458840,CSE 134B,A01,083661,Powell; Thomas Allan,19,0,100,81
1657000464864,CSE 140,A01,083663,Gungor; Onat,14,0,85,71
1657000470888,CSE 140L,A01,083088,Eldon; John,16,0,100,84
1657000476911,CSE 175,A01,083665,Kumar; Rakesh,3,0,25,22
1657000482937,CSE 190,A00,092507,Dubnov; Shlomo,7,0,20,13
1657000488968,ECE 45,A01,083139,Congero; Spencer William,5,0,75,70
1657000494996,ECE 65,A50,083695,Saad; Andrew S,12,0,30,18
1657000494996,ECE 65,A51,095125,Saad; Andrew S,25,0,26,1
1657000501021,ECE 109,A01,091882,Touri; Behrouz,16,0,70,54
1657000507044,ECE 180,A00,083140,Abi Samra; Nicholas Camill,1,0,30,29
1657000507044,ECE 180,B00,083141,Abi Samra; Nicholas Camill,0,0,30,30
1657000513073,MATH 10A,A01,083735,Patchell; Gregory David,1,0,30,29
1657000513073,MATH 10A,A02,083736,Patchell; Gregory David,20,0,30,10
1657000513073,MATH 10A,A03,083737,Patchell; Gregory David,16,0,30,14
1657000519094,MATH 10B,A01,083207,Lim; Seonhee,7,0,34,27
1657000519094,MATH 10B,A02,083208,Lim; Seonhee,9,0,35,26
1657000519094,MATH 10B,A03,093472,Lim; Seonhee,4,0,34,30
1657000519094,MATH 10B,B01,083739,Sinha; Shubham,9,0,30,21
1657000525124,MATH 18,A01,083743,Cinel; Cameron Alexander,6,0,30,24
1657000525124,MATH 18,A02,083744,Cinel; Cameron Alexander,15,0,30,15
1657000525124,MATH 18,A03,083745,Cinel; Cameron Alexander,8,0,30,22
1657000525124,MATH 18,B01,083748,Rideout; David Porter,4,0,37,33
1657000525124,MATH 18,B02,083749,Rideout; David Porter,3,0,36,33
1657000525124,MATH 18,B03,083750,Rideout; David Porter,2,0,37,35
1657000525124,MATH 18,B04,083751,Rideout; David Porter,5,0,36,31
1657000525124,MATH 18,B05,093473,Rideout; David Porter,4,0,36,32
1657000525124,MATH 18,B06,093474,Rideout; David Porter,5,0,36,31
1657000531151,MATH 20A,A01,083754,Zheng; Zequn,12,0,40,28
1657000537174,MATH 20B,A01,083756,Briones; Jor-el Thomas Caparas,1,0,36,35
1657000537174,MATH 20B,A02,083757,Briones; Jor-el Thomas Caparas,1,0,36,35
1657000537174,MATH 20B,A03,093475,Briones; Jor-el Thomas Caparas,0,0,36,36
1657000543203,MATH 20C,A01,083760,Briones; Jor-el Thomas Caparas,1,0,35,34
1657000543203,MATH 20C,A02,083761,Briones; Jor-el Thomas Caparas,8,0,35,27
1657000543203,MATH 20C,A03,093476,Briones; Jor-el Thomas Caparas,0,1,36,36
1657000543203,MATH 20C,B01,083762,Bach; Quang Tran,0,0,30,30
1657000549227,MATH 20D,A01,083765,Tran; Brian Kha,4,0,30,26
1657000549227,MATH 20D,A02,083766,Tran; Brian Kha,5,0,30,25
1657000549227,MATH 20D,A03,083767,Tran; Brian Kha,3,0,30,27
1657000555255,MATH 20E,A01,083771,Ganguly; Soumya,5,0,32,27
1657000555255,MATH 20E,A02,083772,Ganguly; Soumya,6,0,32,26
1657000555255,MATH 20E,B01,083773,Ciotti; Benjamin,18,0,35,17
1657000555255,MATH 20E,B02,083774,Ciotti; Benjamin,17,0,35,18
1657000561280,MATH 103A,A01,083777,Greenfeld; Be'Eri,2,0,36,34
1657000561280,MATH 103A,A02,083778,Greenfeld; Be'Eri,5,0,36,31
1657000561280,MATH 103A,A03,093561,Greenfeld; Be'Eri,4,0,36,32
1657000561280,MATH 103A,B01,083779,Greenfeld; Be'Eri,6,0,36,30
1657000561280,MATH 103A,B02,083780,Greenfeld; Be'Eri,2,0,36,34
1657000561280,MATH 103A,B03,093562,Greenfeld; Be'Eri,2,0,36,34
1657000567303,MATH 105,A01,085443,Carter; Anne Toulson,14,0,35,21
1657000567303,MATH 105,A02,093477,Carter; Anne Toulson,20,0,35,15
1657000573331,MATH 109,A01,083213,Ganzberger; Geoffrey Michael,2,0,34,32
1657000573331,MATH 109,A02,083214,Ganzberger; Geoffrey Michael,2,0,34,32
1657000573331,MATH 109,A03,093478,Ganzberger; Geoffrey Michael,1,0,34,33
1657000573331,MATH 109,B01,083215,Ganzberger; Geoffrey Michael,1,0,32,31
1657000573331,MATH 109,B02,083216,Ganzberger; Geoffrey Michael,1,0,32,31
1657000573331,MATH 109,B03,093479,Ganzberger; Geoffrey Michael,6,0,32,26
1657000579361,MATH 142A,A01,083219,Chow; Bennett,6,0,32,26
1657000579361,MATH 142A,A02,083220,Chow; Bennett,10,0,32,22
1657000579361,MATH 142A,A03,093480,Chow; Bennett,7,0,32,25
1657000579361,MATH 142A,B03,093481,Chow; Bennett,7,0,32,25
1657000579361,MATH 142A,B04,093558,Chow; Bennett,11,0,32,21
1657000579361,MATH 142A,B05,093559,Chow; Bennett,6,0,32,26
1657000585384,MATH 193A,A01,083224,Rotar; Vladimir,7,0,34,27
1657000585384,MATH 193A,A02,083225,Rotar; Vladimir,4,0,34,30
1657000585384,MATH 193A,A03,083781,Rotar; Vladimir,1,0,34,33
1657000585384,MATH 193A,A04,083782,Rotar; Vladimir,6,0,34,28
1657000585384,MATH 193A,A05,093482,Rotar; Vladimir,6,0,34,28
1657000591406,MATH 197,001,091859,McAuley; Julian John,9999,0,9999,0
1657000591406,MATH 197,002,095566,Kedlaya; Kiran S.,9997,0,9999,2
1657000591406,MATH 197,003,095567,Xiao; Ming,9999,0,9999,0
1657000591406,MATH 197,004,095571,Perols; Johan Lars,9998,0,9999,1
1657000598475,COGS 9,A01,083615,Shannon; Kyle Michael,7,0,75,68
1657000604497,COGS 11,A01,083617,Boyle; Mary E. T.,20,0,48,28
1657000610526,COGS 13,A01,083071,Bastos; Amalia Pinkusfeld,9,0,71,62
1657000616552,COGS 14A,A01,092681,Semenuks; Arturs,0,1,100,100
1657000622575,COGS 14B,A01,083073,Cheng; Tzu-Han,5,0,63,58
1657000628598,COGS 17,A01,092677,Semenuks; Arturs,4,0,81,77
1657000634636,COGS 100,A01,083619,Allen; Michael Gordon,15,0,70,55
1657000640664,COGS 101A,A01,083621,Davis; Joshua Daniel,9,0,68,59
1657000646687,COGS 101B,A01,091572,Allen; Michael Gordon,8,0,65,57
1657000652711,COGS 101C,A01,083625,Delgado; Tania,17,0,35,18
1657000658736,COGS 107A,A01,083627,Boyle; Mary E. T.,13,0,60,47
1657000664760,COGS 118A,A01,083075,Gupta; Anjum,15,0,76,61
1657000670788,CSE 3,A50,083646,Miranda; Gregory Joseph,22,0,50,28
1657000676889,CSE 8A,A50,083650,Miranda; Gregory Joseph,17,1,56,39
1657000682915,CSE 11,A01,083080,Cao; Yingjun,4,15,40,36
1657000688940,CSE 12,A01,083652,Krause-Levy; Sophia Louisa,21,1,120,99
1657000694962,CSE 15L,A01,083654,Morris; Justin Loren,8,0,50,42
1657000694962,CSE 15L,A02,083655,Morris; Justin Loren,9,0,50,41
1657000700986,CSE 20,A01,083657,Tran; Khoa Dang,37,0,80,43
1657000707010,CSE 21,A01,095574,Bach; Quang Tran,21,0,48,27
1657000713035,CSE 30,A01,083084,Eldon; John,4,0,80,76
1657000713035,CSE 30,B01,095061,Bhaskar; Nishant,6,0,50,44
1657000719057,CSE 100,A01,083659,Cao; Yingjun,3,4,70,67
1657000725084,CSE 134B,A01,083661,Powell; Thomas Allan,19,0,100,81
1657000731110,CSE 140,A01,083663,Gungor; Onat,14,0,85,71
1657000737134,CSE 140L,A01,083088,Eldon; John,16,0,100,84
1657000743162,CSE 175,A01,083665,Kumar; Rakesh,3,0,25,22
1657000749189,CSE 190,A00,092507,Dubnov; Shlomo,7,0,20,13
1657000755216,ECE 45,A01,083139,Congero; Spencer William,5,0,75,70
1657000761237,ECE 65,A50,083695,Saad; Andrew S,12,0,30,18
1657000761237,ECE 65,A51,095125,Saad; Andrew S,25,0,26,1
1657000767260,ECE 109,A01,091882,Touri; Behrouz,16,0,70,54
1657000773283,ECE 180,A00,083140,Abi Samra; Nicholas Camill,1,0,30,29
1657000773283,ECE 180,B00,083141,Abi Samra; Nicholas Camill,0,0,30,30
1657000779320,MATH 10A,A01,083735,Patchell; Gregory David,1,0,30,29
1657000779320,MATH 10A,A02,083736,Patchell; Gregory David,20,0,30,10
1657000779320,MATH 10A,A03,083737,Patchell; Gregory David,16,0,30,14
1657000785344,MATH 10B,A01,083207,Lim; Seonhee,7,0,34,27
1657000785344,MATH 10B,A02,083208,Lim; Seonhee,9,0,35,26
1657000785344,MATH 10B,A03,093472,Lim; Seonhee,4,0,34,30
1657000785344,MATH 10B,B01,083739,Sinha; Shubham,9,0,30,21
1657000791374,MATH 18,A01,083743,Cinel; Cameron Alexander,6,0,30,24
1657000791374,MATH 18,A02,083744,Cinel; Cameron Alexander,15,0,30,15
1657000791374,MATH 18,A03,083745,Cinel; Cameron Alexander,8,0,30,22
1657000791374,MATH 18,B01,083748,Rideout; David Porter,4,0,37,33
1657000791374,MATH 18,B02,083749,Rideout; David Porter,3,0,36,33
1657000791374,MATH 18,B03,083750,Rideout; David Porter,2,0,37,35
1657000791374,MATH 18,B04,083751,Rideout; David Porter,5,0,36,31
1657000791374,MATH 18,B05,093473,Rideout; David Porter,4,0,36,32
1657000791374,MATH 18,B06,093474,Rideout; David Porter,5,0,36,31
1657000797407,MATH 20A,A01,083754,Zheng; Zequn,12,0,40,28
1657000803435,MATH 20B,A01,083756,Briones; Jor-el Thomas Caparas,1,0,36,35
1657000803435,MATH 20B,A02,083757,Briones; Jor-el Thomas Caparas,1,0,36,35
1657000803435,MATH 20B,A03,093475,Briones; Jor-el Thomas Caparas,0,0,36,36
1657000809459,MATH 20C,A01,083760,Briones; Jor-el Thomas Caparas,1,0,35,34
1657000809459,MATH 20C,A02,083761,Briones; Jor-el Thomas Caparas,8,0,35,27
1657000809459,MATH 20C,A03,093476,Briones; Jor-el Thomas Caparas,0,1,36,36
1657000809459,MATH 20C,B01,083762,Bach; Quang Tran,0,0,30,30
1657000815487,MATH 20D,A01,083765,Tran; Brian Kha,4,0,30,26
1657000815487,MATH 20D,A02,083766,Tran; Brian Kha,5,0,30,25
1657000815487,MATH 20D,A03,083767,Tran; Brian Kha,3,0,30,27
1657000821510,MATH 20E,A01,083771,Ganguly; Soumya,5,0,32,27
1657000821510,MATH 20E,A02,083772,Ganguly; Soumya,6,0,32,26
1657000821510,MATH 20E,B01,083773,Ciotti; Benjamin,18,0,35,17
1657000821510,MATH 20E,B02,083774,Ciotti; Benjamin,17,0,35,18
1657000827540,MATH 103A,A01,083777,Greenfeld; Be'Eri,2,0,36,34
1657000827540,MATH 103A,A02,083778,Greenfeld; Be'Eri,5,0,36,31
1657000827540,MATH 103A,A03,093561,Greenfeld; Be'Eri,4,0,36,32
1657000827540,MATH 103A,B01,083779,Greenfeld; Be'Eri,6,0,36,30
1657000827540,MATH 103A,B02,083780,Greenfeld; Be'Eri,2,0,36,34
1657000827540,MATH 103A,B03,093562,Greenfeld; Be'Eri,2,0,36,34
1657000833563,MATH 105,A01,085443,Carter; Anne Toulson,14,0,35,21
1657000833563,MATH 105,A02,093477,Carter; Anne Toulson,20,0,35,15
1657000839589,MATH 109,A01,083213,Ganzberger; Geoffrey Michael,2,0,34,32
1657000839589,MATH 109,A02,083214,Ganzberger; Geoffrey Michael,2,0,34,32
1657000839589,MATH 109,A03,093478,Ganzberger; Geoffrey Michael,1,0,34,33
1657000839589,MATH 109,B01,083215,Ganzberger; Geoffrey Michael,1,0,32,31
1657000839589,MATH 109,B02,083216,Ganzberger; Geoffrey Michael,1,0,32,31
1657000839589,MATH 109,B03,093479,Ganzberger; Geoffrey Michael,6,0,32,26
1657000845622,MATH 142A,A01,083219,Chow; Bennett,6,0,32,26
1657000845622,MATH 142A,A02,083220,Chow; Bennett,10,0,32,22
1657000845622,MATH 142A,A03,093480,Chow; Bennett,7,0,32,25
1657000845622,MATH 142A,B03,093481,Chow; Bennett,7,0,32,25
1657000845622,MATH 142A,B04,093558,Chow; Bennett,11,0,32,21
1657000845622,MATH 142A,B05,093559,Chow; Bennett,6,0,32,26
1657000851661,MATH 193A,A01,083224,Rotar; Vladimir,7,0,34,27
1657000851661,MATH 193A,A02,083225,Rotar; Vladimir,4,0,34,30
1657000851661,MATH 193A,A03,083781,Rotar; Vladimir,1,0,34,33
1657000851661,MATH 193A,A04,083782,Rotar; Vladimir,6,0,34,28
1657000851661,MATH 193A,A05,093482,Rotar; Vladimir,6,0,34,28
1657000857696,MATH 197,001,091859,McAuley; Julian John,9999,0,9999,0
1657000857696,MATH 197,002,095566,Kedlaya; Kiran S.,9997,0,9999,2
1657000857696,MATH 197,003,095567,Xiao; Ming,9999,0,9999,0
1657000857696,MATH 197,004,095571,Perols; Johan Lars,9998,0,9999,1
1657000864778,COGS 9,A01,083615,Shannon; Kyle Michael,7,0,75,68
1657000870814,COGS 11,A01,083617,Boyle; Mary E. T.,20,0,48,28
1657000876838,COGS 13,A01,083071,Bastos; Amalia Pinkusfeld,9,0,71,62
1657000882864,COGS 14A,A01,092681,Semenuks; Arturs,0,1,100,100
1657000888886,COGS 14B,A01,083073,Cheng; Tzu-Han,5,0,63,58
1657000894910,COGS 17,A01,092677,Semenuks; Arturs,4,0,81,77
1657000900940,COGS 100,A01,083619,Allen; Michael Gordon,15,0,70,55
1657000906965,COGS 101A,A01,083621,Davis; Joshua Daniel,9,0,68,59
1657000912988,COGS 101B,A01,091572,Allen; Michael Gordon,8,0,65,57
1657000919011,COGS 101C,A01,083625,Delgado; Tania,17,0,35,18
1657000925035,COGS 107A,A01,083627,Boyle; Mary E. T.,13,0,60,47
1657000931072,COGS 118A,A01,083075,Gupta; Anjum,15,0,76,61
1657000937099,CSE 3,A50,083646,Miranda; Gregory Joseph,22,0,50,28
1657000943124,CSE 8A,A50,083650,Miranda; Gregory Joseph,17,1,56,39
1657000949147,CSE 11,A01,083080,Cao; Yingjun,4,15,40,36
1657000955205,CSE 12,A01,083652,Krause-Levy; Sophia Louisa,21,1,120,99
1657000961228,CSE 15L,A01,083654,Morris; Justin Loren,8,0,50,42
1657000961228,CSE 15L,A02,083655,Morris; Justin Loren,9,0,50,41
1657000967261,CSE 20,A01,083657,Tran; Khoa Dang,37,0,80,43
1657000973290,CSE 21,A01,095574,Bach; Quang Tran,21,0,48,27
1657000979317,CSE 30,A01,083084,Eldon; John,4,0,80,76
1657000979317,CSE 30,B01,095061,Bhaskar; Nishant,6,0,50,44
1657000985344,CSE 100,A01,083659,Cao; Yingjun,3,4,70,67
1657000991375,CSE 134B,A01,083661,Powell; Thomas Allan,19,0,100,81
1657000997403,CSE 140,A01,083663,Gungor; Onat,14,0,85,71
1657001003427,CSE 140L,A01,083088,Eldon; John,16,0,100,84
1657001009451,CSE 175,A01,083665,Kumar; Rakesh,3,0,25,22
1657001015474,CSE 190,A00,092507,Dubnov; Shlomo,7,0,20,13
1657001021500,ECE 45,A01,083139,Congero; Spencer William,5,0,75,70
1657001027525,ECE 65,A50,083695,Saad; Andrew S,12,0,30,18
1657001027525,ECE 65,A51,095125,Saad; Andrew S,25,0,26,1
1657001033559,ECE 109,A01,091882,Touri; Behrouz,16,0,70,54
1657001039582,ECE 180,A00,083140,Abi Samra; Nicholas Camill,1,0,30,29
1657001039582,ECE 180,B00,083141,Abi Samra; Nicholas Camill,0,0,30,30
1657001045615,MATH 10A,A01,083735,Patchell; Gregory David,1,0,30,29
1657001045615,MATH 10A,A02,083736,Patchell; Gregory David,20,0,30,10
1657001045615,MATH 10A,A03,083737,Patchell; Gregory David,16,0,30,14
1657001051641,MATH 10B,A01,083207,Lim; Seonhee,7,0,34,27
1657001051641,MATH 10B,A02,083208,Lim; Seonhee,9,0,35,26
1657001051641,MATH 10B,A03,093472,Lim; Seonhee,4,0,34,30
1657001051641,MATH 10B,B01,083739,Sinha; Shubham,9,0,30,21
1657001057676,MATH 18,A01,083743,Cinel; Cameron Alexander,6,0,30,24
1657001057676,MATH 18,A02,083744,Cinel; Cameron Alexander,15,0,30,15
1657001057676,MATH 18,A03,083745,Cinel; Cameron Alexander,8,0,30,22
1657001057676,MATH 18,B01,083748,Rideout; David Porter,4,0,37,33
1657001057676,MATH 18,B02,083749,Rideout; David Porter,3,0,36,33
1657001057676,MATH 18,B03,083750,Rideout; David Porter,2,0,37,35
1657001057676,MATH 18,B04,083751,Rideout; David Porter,5,0,36,31
1657001057676,MATH 18,B05,093473,Rideout; David Porter,4,0,36,32
1657001057676,MATH 18,B06,093474,Rideout; David Porter,5,0,36,31
1657001063721,MATH 20A,A01,083754,Zheng; Zequn,12,0,40,28
1657001069745,MATH 20B,A01,083756,Briones; Jor-el Thomas Caparas,1,0,36,35
1657001069745,MATH 20B,A02,083757,Briones; Jor-el Thomas Caparas,1,0,36,35
1657001069745,MATH 20B,A03,093475,Briones; Jor-el Thomas Caparas,0,0,36,36
1657001075776,MATH 20C,A01,083760,Briones; Jor-el Thomas Caparas,1,0,35,34
1657001075776,MATH 20C,A02,083761,Briones; Jor-el Thomas Caparas,8,0,35,27
1657001075776,MATH 20C,A03,093476,Briones; Jor-el Thomas Caparas,0,1,36,36
1657001075776,MATH 20C,B01,083762,Bach; Quang Tran,0,0,30,30
1657001081799,MATH 20D,A01,083765,Tran; Brian Kha,4,0,30,26
1657001081799,MATH 20D,A02,083766,Tran; Brian Kha,5,0,30,25
1657001081799,MATH 20D,A03,083767,Tran; Brian Kha,3,0,30,27
1657001087824,MATH 20E,A01,083771,Ganguly; Soumya,5,0,32,27
1657001087824,MATH 20E,A02,083772,Ganguly; Soumya,6,0,32,26
1657001087824,MATH 20E,B01,083773,Ciotti; Benjamin,18,0,35,17
1657001087824,MATH 20E,B02,083774,Ciotti; Benjamin,17,0,35,18
1657001093863,MATH 103A,A01,083777,Greenfeld; Be'Eri,2,0,36,34
1657001093863,MATH 103A,A02,083778,Greenfeld; Be'Eri,5,0,36,31
1657001093863,MATH 103A,A03,093561,Greenfeld; Be'Eri,4,0,36,32
1657001093863,MATH 103A,B01,083779,Greenfeld; Be'Eri,6,0,36,30
1657001093863,MATH 103A,B02,083780,Greenfeld; Be'Eri,2,0,36,34
1657001093863,MATH 103A,B03,093562,Greenfeld; Be'Eri,2,0,36,34
1657001099891,MATH 105,A01,085443,Carter; Anne Toulson,14,0,35,21
1657001099891,MATH 105,A02,093477,Carter; Anne Toulson,20,0,35,15
1657001105918,MATH 109,A01,083213,Ganzberger; Geoffrey Michael,2,0,34,32
1657001105918,MATH 109,A02,083214,Ganzberger; Geoffrey Michael,2,0,34,32
1657001105918,MATH 109,A03,093478,Ganzberger; Geoffrey Michael,1,0,34,33
1657001105918,MATH 109,B01,083215,Ganzberger; Geoffrey Michael,1,0,32,31
1657001105918,MATH 109,B02,083216,Ganzberger; Geoffrey Michael,1,0,32,31
1657001105918,MATH 109,B03,093479,Ganzberger; Geoffrey Michael,6,0,32,26
1657001111949,MATH 142A,A01,083219,Chow; Bennett,6,0,32,26
1657001111949,MATH 142A,A02,083220,Chow; Bennett,10,0,32,22
1657001111949,MATH 142A,A03,093480,Chow; Bennett,7,0,32,25
1657001111949,MATH 142A,B03,093481,Chow; Bennett,7,0,32,25
1657001111949,MATH 142A,B04,093558,Chow; Bennett,11,0,32,21
1657001111949,MATH 142A,B05,093559,Chow; Bennett,6,0,32,26
1657001117977,MATH 193A,A01,083224,Rotar; Vladimir,7,0,34,27
1657001117977,MATH 193A,A02,083225,Rotar; Vladimir,4,0,34,30
1657001117977,MATH 193A,A03,083781,Rotar; Vladimir,1,0,34,33
1657001117977,MATH 193A,A04,083782,Rotar; Vladimir,6,0,34,28
1657001117977,MATH 193A,A05,093482,Rotar; Vladimir,6,0,34,28
1657001124003,MATH 197,001,091859,McAuley; Julian John,9999,0,9999,0
1657001124003,MATH 197,002,095566,Kedlaya; Kiran S.,9997,0,9999,2
1657001124003,MATH 197,003,095567,Xiao; Ming,9999,0,9999,0
1657001124003,MATH 197,004,095571,Perols; Johan Lars,9998,0,9999,1
1657001131062,COGS 9,A01,083615,Shannon; Kyle Michael,7,0,75,68
1657001137086,COGS 11,A01,083617,Boyle; Mary E. T.,20,0,48,28
1657001143121,COGS 13,A01,083071,Bastos; Amalia Pinkusfeld,9,0,71,62
1657001149145,COGS 14A,A01,092681,Semenuks; Arturs,0,1,100,100
1657001155170,COGS 14B,A01,083073,Cheng; Tzu-Han,5,0,63,58
1657001161192,COGS 17,A01,092677,Semenuks; Arturs,4,0,81,77
1657001167217,COGS 100,A01,083619,Allen; Michael Gordon,15,0,70,55
1657001173241,COGS 101A,A01,083621,Davis; Joshua Daniel,9,0,68,59
1657001179267,COGS 101B,A01,091572,Allen; Michael Gordon,8,0,65,57
1657001185290,COGS 101C,A01,083625,Delgado; Tania,17,0,35,18
1657001191315,COGS 107A,A01,083627,Boyle; Mary E. T.,13,0,60,47
1657001204566,COGS 118A,A01,083075,Gupta; Anjum,15,0,76,61
1657001210590,CSE 3,A50,083646,Miranda; Gregory Joseph,22,0,50,28
1657001216613,CSE 8A,A50,083650,Miranda; Gregory Joseph,17,1,56,39
1657001222637,CSE 11,A01,083080,Cao; Yingjun,4,15,40,36
1657001228670,CSE 12,A01,083652,Krause-Levy; Sophia Louisa,21,1,120,99
1657001234694,CSE 15L,A01,083654,Morris; Justin Loren,8,0,50,42
1657001234694,CSE 15L,A02,083655,Morris; Justin Loren,9,0,50,41
1657001240731,CSE 20,A01,083657,Tran; Khoa Dang,37,0,80,43
1657001246754,CSE 21,A01,095574,Bach; Quang Tran,21,0,48,27
1657001252779,CSE 30,A01,083084,Eldon; John,4,0,80,76
1657001252779,CSE 30,B01,095061,Bhaskar; Nishant,6,0,50,44
1657001258803,CSE 100,A01,083659,Cao; Yingjun,3,4,70,67
1657001264831,CSE 134B,A01,083661,Powell; Thomas Allan,19,0,100,81
1657001270857,CSE 140,A01,083663,Gungor; Onat,14,0,85,71
1657001276883,CSE 140L,A01,083088,Eldon; John,16,0,100,84
1657001282982,CSE 175,A01,083665,Kumar; Rakesh,3,0,25,22
1657001289005,CSE 190,A00,092507,Dubnov; Shlomo,7,0,20,13
1657001295033,ECE 45,A01,083139,Congero; Spencer William,5,0,75,70
1657001301062,ECE 65,A50,083695,Saad; Andrew S,12,0,30,18
1657001301062,ECE 65,A51,095125,Saad; Andrew S,25,0,26,1
1657001307092,ECE 109,A01,091882,Touri; Behrouz,16,0,70,54
1657001313115,ECE 180,A00,083140,Abi Samra; Nicholas Camill,1,0,30,29
1657001313115,ECE 180,B00,083141,Abi Samra; Nicholas Camill,0,0,30,30
1657001319143,MATH 10A,A01,083735,Patchell; Gregory David,1,0,30,29
1657001319143,MATH 10A,A02,083736,Patchell; Gregory David,20,0,30,10
1657001319143,MATH 10A,A03,083737,Patchell; Gregory David,16,0,30,14
1657001325174,MATH 10B,A01,083207,Lim; Seonhee,7,0,34,27
1657001325174,MATH 10B,A02,083208,Lim; Seonhee,9,0,35,26
1657001325174,MATH 10B,A03,093472,Lim; Seonhee,4,0,34,30
1657001325174,MATH 10B,B01,083739,Sinha; Shubham,9,0,30,21
1657001331202,MATH 18,A01,083743,Cinel; Cameron Alexander,6,0,30,24
1657001331202,MATH 18,A02,083744,Cinel; Cameron Alexander,15,0,30,15
1657001331202,MATH 18,A03,083745,Cinel; Cameron Alexander,8,0,30,22
1657001331202,MATH 18,B01,083748,Rideout; David Porter,4,0,37,33
1657001331202,MATH 18,B02,083749,Rideout; David Porter,3,0,36,33
1657001331202,MATH 18,B03,083750,Rideout; David Porter,2,0,37,35
1657001331202,MATH 18,B04,083751,Rideout; David Porter,5,0,36,31
1657001331202,MATH 18,B05,093473,Rideout; David Porter,4,0,36,32
1657001331202,MATH 18,B06,093474,Rideout; David Porter,5,0,36,31
1657001337225,MATH 20A,A01,083754,Zheng; Zequn,12,0,40,28
1657001343266,MATH 20B,A01,083756,Briones; Jor-el Thomas Caparas,1,0,36,35
1657001343266,MATH 20B,A02,083757,Briones; Jor-el Thomas Caparas,1,0,36,35
1657001343266,MATH 20B,A03,093475,Briones; Jor-el Thomas Caparas,0,0,36,36
1657001349295,MATH 20C,A01,083760,Briones; Jor-el Thomas Caparas,1,0,35,34
1657001349295,MATH 20C,A02,083761,Briones; Jor-el Thomas Caparas,8,0,35,27
1657001349295,MATH 20C,A03,093476,Briones; Jor-el Thomas Caparas,0,1,36,36
1657001349295,MATH 20C,B01,083762,Bach; Quang Tran,0,0,30,30
1657001355319,MATH 20D,A01,083765,Tran; Brian Kha,4,0,30,26
1657001355319,MATH 20D,A02,083766,Tran; Brian Kha,5,0,30,25
1657001355319,MATH 20D,A03,083767,Tran; Brian Kha,3,0,30,27
1657001361345,MATH 20E,A01,083771,Ganguly; Soumya,5,0,32,27
1657001361345,MATH 20E,A02,083772,Ganguly; Soumya,6,0,32,26
1657001361345,MATH 20E,B01,083773,Ciotti; Benjamin,18,0,35,17
1657001361345,MATH 20E,B02,083774,Ciotti; Benjamin,17,0,35,18
1657001367380,MATH 103A,A01,083777,Greenfeld; Be'Eri,2,0,36,34
1657001367380,MATH 103A,A02,083778,Greenfeld; Be'Eri,5,0,36,31
1657001367380,MATH 103A,A03,093561,Greenfeld; Be'Eri,4,0,36,32
1657001367380,MATH 103A,B01,083779,Greenfeld; Be'Eri,6,0,36,30
1657001367380,MATH 103A,B02,083780,Greenfeld; Be'Eri,2,0,36,34
1657001367380,MATH 103A,B03,093562,Greenfeld; Be'Eri,2,0,36,34
1657001373408,MATH 105,A01,085443,Carter; Anne Toulson,14,0,35,21
1657001373408,MATH 105,A02,093477,Carter; Anne Toulson,20,0,35,15
1657001379437,MATH 109,A01,083213,Ganzberger; Geoffrey Michael,2,0,34,32
1657001379437,MATH 109,A02,083214,Ganzberger; Geoffrey Michael,2,0,34,32
1657001379437,MATH 109,A03,093478,Ganzberger; Geoffrey Michael,1,0,34,33
1657001379437,MATH 109,B01,083215,Ganzberger; Geoffrey Michael,1,0,32,31
1657001379437,MATH 109,B02,083216,Ganzberger; Geoffrey Michael,1,0,32,31
1657001379437,MATH 109,B03,093479,Ganzberger; Geoffrey Michael,6,0,32,26
1657001385466,MATH 142A,A01,083219,Chow; Bennett,6,0,32,26
1657001385466,MATH 142A,A02,083220,Chow; Bennett,10,0,32,22
1657001385466,MATH 142A,A03,093480,Chow; Bennett,7,0,32,25
1657001385466,MATH 142A,B03,093481,Chow; Bennett,7,0,32,25
1657001385466,MATH 142A,B04,093558,Chow; Bennett,11,0,32,21
1657001385466,MATH 142A,B05,093559,Chow; Bennett,6,0,32,26
1657001391494,MATH 193A,A01,083224,Rotar; Vladimir,7,0,34,27
1657001391494,MATH 193A,A02,083225,Rotar; Vladimir,4,0,34,30
1657001391494,MATH 193A,A03,083781,Rotar; Vladimir,1,0,34,33
1657001391494,MATH 193A,A04,083782,Rotar; Vladimir,6,0,34,28
1657001391494,MATH 193A,A05,093482,Rotar; Vladimir,6,0,34,28
1657001397517,MATH 197,001,091859,McAuley; Julian John,9999,0,9999,0
1657001397517,MATH 197,002,095566,Kedlaya; Kiran S.,9997,0,9999,2
1657001397517,MATH 197,003,095567,Xiao; Ming,9999,0,9999,0
1657001397517,MATH 197,004,095571,Perols; Johan Lars,9998,0,9999,1
1657001404572,COGS 9,A01,083615,Shannon; Kyle Michael,7,0,75,68
1657001410595,COGS 11,A01,083617,Boyle; Mary E. T.,20,0,48,28
1657001416619,COGS 13,A01,083071,Bastos; Amalia Pinkusfeld,9,0,71,62
1657001422644,COGS 14A,A01,092681,Semenuks; Arturs,0,1,100,100
1657001428673,COGS 14B,A01,083073,Cheng; Tzu-Han,5,0,63,58
1657001434696,COGS 17,A01,092677,Semenuks; Arturs,4,0,81,77
1657001440721,COGS 100,A01,083619,Allen; Michael Gordon,15,0,70,55
1657001446747,COGS 101A,A01,083621,Davis; Joshua Daniel,9,0,68,59
1657001452773,COGS 101B,A01,091572,Allen; Michael Gordon,8,0,65,57
1657001458808,COGS 101C,A01,083625,Delgado; Tania,17,0,35,18
1657001464830,COGS 107A,A01,083627,Boyle; Mary E. T.,13,0,60,47
1657001470860,COGS 118A,A01,083075,Gupta; Anjum,15,0,76,61
1657001476884,CSE 3,A50,083646,Miranda; Gregory Joseph,22,0,50,28
1657001482914,CSE 8A,A50,083650,Miranda; Gregory Joseph,17,1,56,39
1657001488942,CSE 11,A01,083080,Cao; Yingjun,4,15,40,36
1657001494964,CSE 12,A01,083652,Krause-Levy; Sophia Louisa,21,1,120,99
1657001500993,CSE 15L,A01,083654,Morris; Justin Loren,8,0,50,42
1657001500993,CSE 15L,A02,083655,Morris; Justin Loren,9,0,50,41
1657001507020,CSE 20,A01,083657,Tran; Khoa Dang,37,0,80,43
1657001513045,CSE 21,A01,095574,Bach; Quang Tran,21,0,48,27
1657001519071,CSE 30,A01,083084,Eldon; John,4,0,80,76
1657001519071,CSE 30,B01,095061,Bhaskar; Nishant,6,0,50,44
1657001525096,CSE 100,A01,083659,Cao; Yingjun,3,4,70,67
1657001531127,CSE 134B,A01,083661,Powell; Thomas Allan,19,0,100,81
1657001537149,CSE 140,A01,083663,Gungor; Onat,14,0,85,71
1657001543175,CSE 140L,A01,083088,Eldon; John,16,0,100,84
1657001549200,CSE 175,A01,083665,Kumar; Rakesh,3,0,25,22
1657001555228,CSE 190,A00,092507,Dubnov; Shlomo,7,0,20,13
1657001561251,ECE 45,A01,083139,Congero; Spencer William,5,0,75,70
1657001567279,ECE 65,A50,083695,Saad; Andrew S,12,0,30,18
1657001567279,ECE 65,A51,095125,Saad; Andrew S,25,0,26,1
1657001573303,ECE 109,A01,091882,Touri; Behrouz,16,0,70,54
1657001579325,ECE 180,A00,083140,Abi Samra; Nicholas Camill,1,0,30,29
1657001579325,ECE 180,B00,083141,Abi Samra; Nicholas Camill,0,0,30,30
1657001585354,MATH 10A,A01,083735,Patchell; Gregory David,1,0,30,29
1657001585354,MATH 10A,A02,083736,Patchell; Gregory David,20,0,30,10
1657001585354,MATH 10A,A03,083737,Patchell; Gregory David,16,0,30,14
1657001591377,MATH 10B,A01,083207,Lim; Seonhee,7,0,34,27
1657001591377,MATH 10B,A02,083208,Lim; Seonhee,9,0,35,26
1657001591377,MATH 10B,A03,093472,Lim; Seonhee,4,0,34,30
1657001591377,MATH 10B,B01,083739,Sinha; Shubham,9,0,30,21
1657001597402,MATH 18,A01,083743,Cinel; Cameron Alexander,6,0,30,24
1657001597402,MATH 18,A02,083744,Cinel; Cameron Alexander,15,0,30,15
1657001597402,MATH 18,A03,083745,Cinel; Cameron Alexander,8,0,30,22
1657001597402,MATH 18,B01,083748,Rideout; David Porter,4,0,37,33
1657001597402,MATH 18,B02,083749,Rideout; David Porter,3,0,36,33
1657001597402,MATH 18,B03,083750,Rideout; David Porter,2,0,37,35
1657001597402,MATH 18,B04,083751,Rideout; David Porter,5,0,36,31
1657001597402,MATH 18,B05,093473,Rideout; David Porter,4,0,36,32
1657001597402,MATH 18,B06,093474,Rideout; David Porter,5,0,36,31
1657001603430,MATH 20A,A01,083754,Zheng; Zequn,12,0,40,28
1657001609468,MATH 20B,A01,083756,Briones; Jor-el Thomas Caparas,1,0,36,35
1657001609468,MATH 20B,A02,083757,Briones; Jor-el Thomas Caparas,1,0,36,35
1657001609468,MATH 20B,A03,093475,Briones; Jor-el Thomas Caparas,0,0,36,36
1657001615492,MATH 20C,A01,083760,Briones; Jor-el Thomas Caparas,1,0,35,34
1657001615492,MATH 20C,A02,083761,Briones; Jor-el Thomas Caparas,8,0,35,27
1657001615492,MATH 20C,A03,093476,Briones; Jor-el Thomas Caparas,0,1,36,36
1657001615492,MATH 20C,B01,083762,Bach; Quang Tran,0,0,30,30
1657001621519,MATH 20D,A01,083765,Tran; Brian Kha,4,0,30,26
1657001621519,MATH 20D,A02,083766,Tran; Brian Kha,5,0,30,25
1657001621519,MATH 20D,A03,083767,Tran; Brian Kha,3,0,30,27
1657001627545,MATH 20E,A01,083771,Ganguly; Soumya,5,0,32,27
1657001627545,MATH 20E,A02,083772,Ganguly; Soumya,6,0,32,26
1657001627545,MATH 20E,B01,083773,Ciotti; Benjamin,18,0,35,17
1657001627545,MATH 20E,B02,083774,Ciotti; Benjamin,17,0,35,18
1657001633578,MATH 103A,A01,083777,Greenfeld; Be'Eri,2,0,36,34
1657001633578,MATH 103A,A02,083778,Greenfeld; Be'Eri,5,0,36,31
1657001633578,MATH 103A,A03,093561,Greenfeld; Be'Eri,4,0,36,32
1657001633578,MATH 103A,B01,083779,Greenfeld; Be'Eri,6,0,36,30
1657001633578,MATH 103A,B02,083780,Greenfeld; Be'Eri,2,0,36,34
1657001633578,MATH 103A,B03,093562,Greenfeld; Be'Eri,2,0,36,34
1657001639606,MATH 105,A01,085443,Carter; Anne Toulson,14,0,35,21
1657001639606,MATH 105,A02,093477,Carter; Anne Toulson,20,0,35,15
1657001645644,MATH 109,A01,083213,Ganzberger; Geoffrey Michael,2,0,34,32
1657001645644,MATH 109,A02,083214,Ganzberger; Geoffrey Michael,2,0,34,32
1657001645644,MATH 109,A03,093478,Ganzberger; Geoffrey Michael,1,0,34,33
1657001645644,MATH 109,B01,083215,Ganzberger; Geoffrey Michael,1,0,32,31
1657001645644,MATH 109,B02,083216,Ganzberger; Geoffrey Michael,1,0,32,31
1657001645644,MATH 109,B03,093479,Ganzberger; Geoffrey Michael,6,0,32,26
1657001651673,MATH 142A,A01,083219,Chow; Bennett,6,0,32,26
1657001651673,MATH 142A,A02,083220,Chow; Bennett,10,0,32,22
1657001651673,MATH 142A,A03,093480,Chow; Bennett,7,0,32,25
1657001651673,MATH 142A,B03,093481,Chow; Bennett,7,0,32,25
1657001651673,MATH 142A,B04,093558,Chow; Bennett,11,0,32,21
1657001651673,MATH 142A,B05,093559,Chow; Bennett,6,0,32,26
1657001657698,MATH 193A,A01,083224,Rotar; Vladimir,7,0,34,27
1657001657698,MATH 193A,A02,083225,Rotar; Vladimir,4,0,34,30
1657001657698,MATH 193A,A03,083781,Rotar; Vladimir,1,0,34,33
1657001657698,MATH 193A,A04,083782,Rotar; Vladimir,6,0,34,28
1657001657698,MATH 193A,A05,093482,Rotar; Vladimir,6,0,34,28
1657001663724,MATH 197,001,091859,McAuley; Julian John,9999,0,9999,0
1657001663724,MATH 197,002,095566,Kedlaya; Kiran S.,9997,0,9999,2
1657001663724,MATH 197,003,095567,Xiao; Ming,9999,0,9999,0
1657001663724,MATH 197,004,095571,Perols; Johan Lars,9998,0,9999,1
1657001670801,COGS 9,A01,083615,Shannon; Kyle Michael,7,0,75,68
1657001676823,COGS 11,A01,083617,Boyle; Mary E. T.,20,0,48,28
1657001682852,COGS 13,A01,083071,Bastos; Amalia Pinkusfeld,9,0,71,62
1657001688879,COGS 14A,A01,092681,Semenuks; Arturs,0,1,100,100
1657001694906,COGS 14B,A01,083073,Cheng; Tzu-Han,5,0,63,58
1657001700931,COGS 17,A01,092677,Semenuks; Arturs,4,0,81,77
1657001706959,COGS 100,A01,083619,Allen; Michael Gordon,15,0,70,55
1657001712986,COGS 101A,A01,083621,Davis; Joshua Daniel,9,0,68,59
1657001719008,COGS 101B,A01,091572,Allen; Michael Gordon,8,0,65,57
1657001725032,COGS 101C,A01,083625,Delgado; Tania,17,0,35,18
1657001731062,COGS 107A,A01,083627,Boyle; Mary E. T.,13,0,60,47
1657001737089,COGS 118A,A01,083075,Gupta; Anjum,15,0,76,61
1657001743120,CSE 3,A50,083646,Miranda; Gregory Joseph,22,0,50,28
1657001749151,CSE 8A,A50,083650,Miranda; Gregory Joseph,17,1,56,39
1657001755174,CSE 11,A01,083080,Cao; Yingjun,4,15,40,36
1657001761198,CSE 12,A01,083652,Krause-Levy; Sophia Louisa,21,1,120,99
1657001767221,CSE 15L,A01,083654,Morris; Justin Loren,8,0,50,42
1657001767221,CSE 15L,A02,083655,Morris; Justin Loren,9,0,50,41
1657001773249,CSE 20,A01,083657,Tran; Khoa Dang,37,0,80,43
1657001779277,CSE 21,A01,095574,Bach; Quang Tran,21,0,48,27
1657001785302,CSE 30,A01,083084,Eldon; John,4,0,80,76
1657001785302,CSE 30,B01,095061,Bhaskar; Nishant,6,0,50,44
1657001791324,CSE 100,A01,083659,Cao; Yingjun,3,4,70,67
1657001797349,CSE 134B,A01,083661,Powell; Thomas Allan,19,0,100,81
1657001803376,CSE 140,A01,083663,Gungor; Onat,14,0,85,71
1657001809398,CSE 140L,A01,083088,Eldon; John,16,0,100,84
1657001815424,CSE 175,A01,083665,Kumar; Rakesh,3,0,25,22
1657001821446,CSE 190,A00,092507,Dubnov; Shlomo,7,0,20,13
1657001827474,ECE 45,A01,083139,Congero; Spencer William,5,0,75,70
1657001833502,ECE 65,A50,083695,Saad; Andrew S,12,0,30,18
1657001833502,ECE 65,A51,095125,Saad; Andrew S,25,0,26,1
1657001839526,ECE 109,A01,091882,Touri; Behrouz,16,0,70,54
1657001845555,ECE 180,A00,083140,Abi Samra; Nicholas Camill,1,0,30,29
1657001845555,ECE 180,B00,083141,Abi Samra; Nicholas Camill,0,0,30,30
1657001851591,MATH 10A,A01,083735,Patchell; Gregory David,1,0,30,29
1657001851591,MATH 10A,A02,083736,Patchell; Gregory David,20,0,30,10
1657001851591,MATH 10A,A03,083737,Patchell; Gregory David,16,0,30,14
1657001857613,MATH 10B,A01,083207,Lim; Seonhee,7,0,34,27
1657001857613,MATH 10B,A02,083208,Lim; Seonhee,9,0,35,26
1657001857613,MATH 10B,A03,093472,Lim; Seonhee,4,0,34,30
1657001857613,MATH 10B,B01,083739,Sinha; Shubham,9,0,30,21
1657001863649,MATH 18,A01,083743,Cinel; Cameron Alexander,6,0,30,24
1657001863649,MATH 18,A02,083744,Cinel; Cameron Alexander,15,0,30,15
1657001863649,MATH 18,A03,083745,Cinel; Cameron Alexander,8,0,30,22
1657001863649,MATH 18,B01,083748,Rideout; David Porter,4,0,37,33
1657001863649,MATH 18,B02,083749,Rideout; David Porter,3,0,36,33
1657001863649,MATH 18,B03,083750,Rideout; David Porter,2,0,37,35
1657001863649,MATH 18,B04,083751,Rideout; David Porter,5,0,36,31
1657001863649,MATH 18,B05,093473,Rideout; David Porter,4,0,36,32
1657001863649,MATH 18,B06,093474,Rideout; David Porter,5,0,36,31
1657001869672,MATH 20A,A01,083754,Zheng; Zequn,12,0,40,28
1657001875695,MATH 20B,A01,083756,Briones; Jor-el Thomas Caparas,1,0,36,35
1657001875695,MATH 20B,A02,083757,Briones; Jor-el Thomas Caparas,1,0,36,35
1657001875695,MATH 20B,A03,093475,Briones; Jor-el Thomas Caparas,0,0,36,36
1657001881801,MATH 20C,A01,083760,Briones; Jor-el Thomas Caparas,1,0,35,34
1657001881801,MATH 20C,A02,083761,Briones; Jor-el Thomas Caparas,8,0,35,27
1657001881801,MATH 20C,A03,093476,Briones; Jor-el Thomas Caparas,0,1,36,36
1657001881801,MATH 20C,B01,083762,Bach; Quang Tran,0,0,30,30
1657001887831,MATH 20D,A01,083765,Tran; Brian Kha,4,0,30,26
1657001887831,MATH 20D,A02,083766,Tran; Brian Kha,5,0,30,25
1657001887831,MATH 20D,A03,083767,Tran; Brian Kha,3,0,30,27
1657001893854,MATH 20E,A01,083771,Ganguly; Soumya,5,0,32,27
1657001893854,MATH 20E,A02,083772,Ganguly; Soumya,6,0,32,26
1657001893854,MATH 20E,B01,083773,Ciotti; Benjamin,18,0,35,17
1657001893854,MATH 20E,B02,083774,Ciotti; Benjamin,17,0,35,18
1657001899885,MATH 103A,A01,083777,Greenfeld; Be'Eri,2,0,36,34
1657001899885,MATH 103A,A02,083778,Greenfeld; Be'Eri,5,0,36,31
1657001899885,MATH 103A,A03,093561,Greenfeld; Be'Eri,4,0,36,32
1657001899885,MATH 103A,B01,083779,Greenfeld; Be'Eri,6,0,36,30
1657001899885,MATH 103A,B02,083780,Greenfeld; Be'Eri,2,0,36,34
1657001899885,MATH 103A,B03,093562,Greenfeld; Be'Eri,2,0,36,34
1657001905919,MATH 105,A01,085443,Carter; Anne Toulson,14,0,35,21
1657001905919,MATH 105,A02,093477,Carter; Anne Toulson,20,0,35,15
1657001911954,MATH 109,A01,083213,Ganzberger; Geoffrey Michael,2,0,34,32
1657001911954,MATH 109,A02,083214,Ganzberger; Geoffrey Michael,2,0,34,32
1657001911954,MATH 109,A03,093478,Ganzberger; Geoffrey Michael,1,0,34,33
1657001911954,MATH 109,B01,083215,Ganzberger; Geoffrey Michael,1,0,32,31
1657001911954,MATH 109,B02,083216,Ganzberger; Geoffrey Michael,1,0,32,31
1657001911954,MATH 109,B03,093479,Ganzberger; Geoffrey Michael,6,0,32,26
1657001917976,MATH 142A,A01,083219,Chow; Bennett,6,0,32,26
1657001917976,MATH 142A,A02,083220,Chow; Bennett,10,0,32,22
1657001917976,MATH 142A,A03,093480,Chow; Bennett,7,0,32,25
1657001917976,MATH 142A,B03,093481,Chow; Bennett,7,0,32,25
1657001917976,MATH 142A,B04,093558,Chow; Bennett,11,0,32,21
1657001917976,MATH 142A,B05,093559,Chow; Bennett,6,0,32,26
1657001924005,MATH 193A,A01,083224,Rotar; Vladimir,7,0,34,27
1657001924005,MATH 193A,A02,083225,Rotar; Vladimir,4,0,34,30
1657001924005,MATH 193A,A03,083781,Rotar; Vladimir,1,0,34,33
1657001924005,MATH 193A,A04,083782,Rotar; Vladimir,6,0,34,28
1657001924005,MATH 193A,A05,093482,Rotar; Vladimir,6,0,34,28
1657001930032,MATH 197,001,091859,McAuley; Julian John,9999,0,9999,0
1657001930032,MATH 197,002,095566,Kedlaya; Kiran S.,9997,0,9999,2
1657001930032,MATH 197,003,095567,Xiao; Ming,9999,0,9999,0
1657001930032,MATH 197,004,095571,Perols; Johan Lars,9998,0,9999,1
1657001937084,COGS 9,A01,083615,Shannon; Kyle Michael,7,0,75,68
1657001943108,COGS 11,A01,083617,Boyle; Mary E. T.,20,0,48,28
1657001949135,COGS 13,A01,083071,Bastos; Amalia Pinkusfeld,9,0,71,62
1657001955165,COGS 14A,A01,092681,Semenuks; Arturs,0,1,100,100
1657001961188,COGS 14B,A01,083073,Cheng; Tzu-Han,5,0,63,58
1657001967215,COGS 17,A01,092677,Semenuks; Arturs,4,0,81,77
1657001973246,COGS 100,A01,083619,Allen; Michael Gordon,15,0,70,55
1657001979275,COGS 101A,A01,083621,Davis; Joshua Daniel,9,0,68,59
1657001985302,COGS 101B,A01,091572,Allen; Michael Gordon,8,0,65,57
1657001991324,COGS 101C,A01,083625,Delgado; Tania,17,0,35,18
1657001997348,COGS 107A,A01,083627,Boyle; Mary E. T.,13,0,60,47
1657002003374,COGS 118A,A01,083075,Gupta; Anjum,15,0,76,61
1657002009401,CSE 3,A50,083646,Miranda; Gregory Joseph,22,0,50,28
1657002015424,CSE 8A,A50,083650,Miranda; Gregory Joseph,17,1,56,39
1657002021446,CSE 11,A01,083080,Cao; Yingjun,4,15,40,36
1657002027479,CSE 12,A01,083652,Krause-Levy; Sophia Louisa,21,1,120,99
1657002033504,CSE 15L,A01,083654,Morris; Justin Loren,8,0,50,42
1657002033504,CSE 15L,A02,083655,Morris; Justin Loren,9,0,50,41
1657002039537,CSE 20,A01,083657,Tran; Khoa Dang,37,0,80,43
1657002045568,CSE 21,A01,095574,Bach; Quang Tran,21,0,48,27
1657002051592,CSE 30,A01,083084,Eldon; John,4,0,80,76
1657002051592,CSE 30,B01,095061,Bhaskar; Nishant,6,0,50,44
1657002057615,CSE 100,A01,083659,Cao; Yingjun,3,4,70,67
1657002063638,CSE 134B,A01,083661,Powell; Thomas Allan,19,0,100,81
1657002069672,CSE 140,A01,083663,Gungor; Onat,14,0,85,71
1657002075694,CSE 140L,A01,083088,Eldon; John,16,0,100,84
1657002081717,CSE 175,A01,083665,Kumar; Rakesh,3,0,25,22
1657002087743,CSE 190,A00,092507,Dubnov; Shlomo,7,0,20,13
1657002093767,ECE 45,A01,083139,Congero; Spencer William,5,0,75,70
1657002099802,ECE 65,A50,083695,Saad; Andrew S,12,0,30,18
1657002099802,ECE 65,A51,095125,Saad; Andrew S,25,0,26,1
1657002105825,ECE 109,A01,091882,Touri; Behrouz,16,0,70,54
1657002111859,ECE 180,A00,083140,Abi Samra; Nicholas Camill,1,0,30,29
1657002111859,ECE 180,B00,083141,Abi Samra; Nicholas Camill,0,0,30,30
1657002117883,MATH 10A,A01,083735,Patchell; Gregory David,1,0,30,29
1657002117883,MATH 10A,A02,083736,Patchell; Gregory David,20,0,30,10
1657002117883,MATH 10A,A03,083737,Patchell; Gregory David,16,0,30,14
1657002123908,MATH 10B,A01,083207,Lim; Seonhee,7,0,34,27
1657002123908,MATH 10B,A02,083208,Lim; Seonhee,9,0,35,26
1657002123908,MATH 10B,A03,093472,Lim; Seonhee,4,0,34,30
1657002123908,MATH 10B,B01,083739,Sinha; Shubham,9,0,30,21
1657002129938,MATH 18,A01,083743,Cinel; Cameron Alexander,6,0,30,24
1657002129938,MATH 18,A02,083744,Cinel; Cameron Alexander,15,0,30,15
1657002129938,MATH 18,A03,083745,Cinel; Cameron Alexander,8,0,30,22
1657002129938,MATH 18,B01,083748,Rideout; David Porter,4,0,37,33
1657002129938,MATH 18,B02,083749,Rideout; David Porter,3,0,36,33
1657002129938,MATH 18,B03,083750,Rideout; David Porter,2,0,37,35
1657002129938,MATH 18,B04,083751,Rideout; David Porter,5,0,36,31
1657002129938,MATH 18,B05,093473,Rideout; David Porter,4,0,36,32
1657002129938,MATH 18,B06,093474,Rideout; David Porter,5,0,36,31
1657002135968,MATH 20A,A01,083754,Zheng; Zequn,12,0,40,28
1657002142008,MATH 20B,A01,083756,Briones; Jor-el Thomas Caparas,1,0,36,35
1657002142008,MATH 20B,A02,083757,Briones; Jor-el Thomas Caparas,1,0,36,35
1657002142008,MATH 20B,A03,093475,Briones; Jor-el Thomas Caparas,0,0,36,36
1657002148037,MATH 20C,A01,083760,Briones; Jor-el Thomas Caparas,1,0,35,34
1657002148037,MATH 20C,A02,083761,Briones; Jor-el Thomas Caparas,8,0,35,27
1657002148037,MATH 20C,A03,093476,Briones; Jor-el Thomas Caparas,0,1,36,36
1657002148037,MATH 20C,B01,083762,Bach; Quang Tran,0,0,30,30
1657002154061,MATH 20D,A01,083765,Tran; Brian Kha,4,0,30,26
1657002154061,MATH 20D,A02,083766,Tran; Brian Kha,5,0,30,25
1657002154061,MATH 20D,A03,083767,Tran; Brian Kha,3,0,30,27
1657002160086,MATH 20E,A01,083771,Ganguly; Soumya,5,0,32,27
1657002160086,MATH 20E,A02,083772,Ganguly; Soumya,6,0,32,26
1657002160086,MATH 20E,B01,083773,Ciotti; Benjamin,18,0,35,17
1657002160086,MATH 20E,B02,083774,Ciotti; Benjamin,17,0,35,18
1657002166118,MATH 103A,A01,083777,Greenfeld; Be'Eri,2,0,36,34
1657002166118,MATH 103A,A02,083778,Greenfeld; Be'Eri,5,0,36,31
1657002166118,MATH 103A,A03,093561,Greenfeld; Be'Eri,4,0,36,32
1657002166118,MATH 103A,B01,083779,Greenfeld; Be'Eri,6,0,36,30
1657002166118,MATH 103A,B02,083780,Greenfeld; Be'Eri,2,0,36,34
1657002166118,MATH 103A,B03,093562,Greenfeld; Be'Eri,2,0,36,34
1657002172154,MATH 105,A01,085443,Carter; Anne Toulson,14,0,35,21
1657002172154,MATH 105,A02,093477,Carter; Anne Toulson,20,0,35,15
1657002178194,MATH 109,A01,083213,Ganzberger; Geoffrey Michael,2,0,34,32
1657002178194,MATH 109,A02,083214,Ganzberger; Geoffrey Michael,2,0,34,32
1657002178194,MATH 109,A03,093478,Ganzberger; Geoffrey Michael,1,0,34,33
1657002178194,MATH 109,B01,083215,Ganzberger; Geoffrey Michael,1,0,32,31
1657002178194,MATH 109,B02,083216,Ganzberger; Geoffrey Michael,1,0,32,31
1657002178194,MATH 109,B03,093479,Ganzberger; Geoffrey Michael,6,0,32,26
1657002184218,MATH 142A,A01,083219,Chow; Bennett,6,0,32,26
1657002184218,MATH 142A,A02,083220,Chow; Bennett,10,0,32,22
1657002184218,MATH 142A,A03,093480,Chow; Bennett,7,0,32,25
1657002184218,MATH 142A,B03,093481,Chow; Bennett,7,0,32,25
1657002184218,MATH 142A,B04,093558,Chow; Bennett,11,0,32,21
1657002184218,MATH 142A,B05,093559,Chow; Bennett,6,0,32,26
1657002190244,MATH 193A,A01,083224,Rotar; Vladimir,7,0,34,27
1657002190244,MATH 193A,A02,083225,Rotar; Vladimir,4,0,34,30
1657002190244,MATH 193A,A03,083781,Rotar; Vladimir,1,0,34,33
1657002190244,MATH 193A,A04,083782,Rotar; Vladimir,6,0,34,28
1657002190244,MATH 193A,A05,093482,Rotar; Vladimir,6,0,34,28
1657002196269,MATH 197,001,091859,McAuley; Julian John,9999,0,9999,0
1657002196269,MATH 197,002,095566,Kedlaya; Kiran S.,9997,0,9999,2
1657002196269,MATH 197,003,095567,Xiao; Ming,9999,0,9999,0
1657002196269,MATH 197,004,095571,Perols; Johan Lars,9998,0,9999,1
1657002203334,COGS 9,A01,083615,Shannon; Kyle Michael,7,0,75,68
1657002209360,COGS 11,A01,083617,Boyle; Mary E. T.,20,0,48,28
1657002215388,COGS 13,A01,083071,Bastos; Amalia Pinkusfeld,9,0,71,62
1657002221411,COGS 14A,A01,092681,Semenuks; Arturs,0,1,100,100
1657002227440,COGS 14B,A01,083073,Cheng; Tzu-Han,5,0,63,58
1657002233464,COGS 17,A01,092677,Semenuks; Arturs,4,0,81,77
1657002239488,COGS 100,A01,083619,Allen; Michael Gordon,15,0,70,55
1657002245514,COGS 101A,A01,083621,Davis; Joshua Daniel,9,0,68,59
1657002251549,COGS 101B,A01,091572,Allen; Michael Gordon,8,0,65,57
1657002257571,COGS 101C,A01,083625,Delgado; Tania,17,0,35,18
1657002263600,COGS 107A,A01,083627,Boyle; Mary E. T.,13,0,60,47
1657002269623,COGS 118A,A01,083075,Gupta; Anjum,15,0,76,61
1657002275646,CSE 3,A50,083646,Miranda; Gregory Joseph,22,0,50,28
1657002281670,CSE 8A,A50,083650,Miranda; Gregory Joseph,17,1,56,39
1657002287698,CSE 11,A01,083080,Cao; Yingjun,4,15,40,36
1657002293722,CSE 12,A01,083652,Krause-Levy; Sophia Louisa,21,1,120,99
1657002299747,CSE 15L,A01,083654,Morris; Justin Loren,8,0,50,42
1657002299747,CSE 15L,A02,083655,Morris; Justin Loren,9,0,50,41
1657002305771,CSE 20,A01,083657,Tran; Khoa Dang,37,0,80,43
1657002311800,CSE 21,A01,095574,Bach; Quang Tran,21,0,48,27
1657002317824,CSE 30,A01,083084,Eldon; John,4,0,80,76
1657002317824,CSE 30,B01,095061,Bhaskar; Nishant,6,0,50,44
1657002323851,CSE 100,A01,083659,Cao; Yingjun,3,4,70,67
1657002329874,CSE 134B,A01,083661,Powell; Thomas Allan,19,0,100,81
1657002335905,CSE 140,A01,083663,Gungor; Onat,14,0,85,71
1657002341930,CSE 140L,A01,083088,Eldon; John,16,0,100,84
1657002347958,CSE 175,A01,083665,Kumar; Rakesh,3,0,25,22
1657002353985,CSE 190,A00,092507,Dubnov; Shlomo,7,0,20,13
1657002360011,ECE 45,A01,083139,Congero; Spencer William,5,0,75,70
1657002366044,ECE 65,A50,083695,Saad; Andrew S,12,0,30,18
1657002366044,ECE 65,A51,095125,Saad; Andrew S,25,0,26,1
1657002372068,ECE 109,A01,091882,Touri; Behrouz,16,0,70,54
1657002378092,ECE 180,A00,083140,Abi Samra; Nicholas Camill,1,0,30,29
1657002378092,ECE 180,B00,083141,Abi Samra; Nicholas Camill,0,0,30,30
1657002384117,MATH 10A,A01,083735,Patchell; Gregory David,1,0,30,29
1657002384117,MATH 10A,A02,083736,Patchell; Gregory David,20,0,30,10
1657002384117,MATH 10A,A03,083737,Patchell; Gregory David,16,0,30,14
1657002390141,MATH 10B,A01,083207,Lim; Seonhee,7,0,34,27
1657002390141,MATH 10B,A02,083208,Lim; Seonhee,9,0,35,26
1657002390141,MATH 10B,A03,093472,Lim; Seonhee,4,0,34,30
1657002390141,MATH 10B,B01,083739,Sinha; Shubham,9,0,30,21
1657002396174,MATH 18,A01,083743,Cinel; Cameron Alexander,6,0,30,24
1657002396174,MATH 18,A02,083744,Cinel; Cameron Alexander,15,0,30,15
1657002396174,MATH 18,A03,083745,Cinel; Cameron Alexander,8,0,30,22
1657002396174,MATH 18,B01,083748,Rideout; David Porter,4,0,37,33
1657002396174,MATH 18,B02,083749,Rideout; David Porter,3,0,36,33
1657002396174,MATH 18,B03,083750,Rideout; David Porter,2,0,37,35
1657002396174,MATH 18,B04,083751,Rideout; David Porter,5,0,36,31
1657002396174,MATH 18,B05,093473,Rideout; David Porter,4,0,36,32
1657002396174,MATH 18,B06,093474,Rideout; David Porter,5,0,36,31
1657002402200,MATH 20A,A01,083754,Zheng; Zequn,12,0,40,28
1657002408226,MATH 20B,A01,083756,Briones; Jor-el Thomas Caparas,1,0,36,35
1657002408226,MATH 20B,A02,083757,Briones; Jor-el Thomas Caparas,1,0,36,35
1657002408226,MATH 20B,A03,093475,Briones; Jor-el Thomas Caparas,0,0,36,36
1657002414255,MATH 20C,A01,083760,Briones; Jor-el Thomas Caparas,1,0,35,34
1657002414255,MATH 20C,A02,083761,Briones; Jor-el Thomas Caparas,8,0,35,27
1657002414255,MATH 20C,A03,093476,Briones; Jor-el Thomas Caparas,0,1,36,36
1657002414255,MATH 20C,B01,083762,Bach; Quang Tran,0,0,30,30
1657002420290,MATH 20D,A01,083765,Tran; Brian Kha,4,0,30,26
1657002420290,MATH 20D,A02,083766,Tran; Brian Kha,5,0,30,25
1657002420290,MATH 20D,A03,083767,Tran; Brian Kha,3,0,30,27
1657002426317,MATH 20E,A01,083771,Ganguly; Soumya,5,0,32,27
1657002426317,MATH 20E,A02,083772,Ganguly; Soumya,6,0,32,26
1657002426317,MATH 20E,B01,083773,Ciotti; Benjamin,18,0,35,17
1657002426317,MATH 20E,B02,083774,Ciotti; Benjamin,17,0,35,18
1657002432351,MATH 103A,A01,083777,Greenfeld; Be'Eri,2,0,36,34
1657002432351,MATH 103A,A02,083778,Greenfeld; Be'Eri,5,0,36,31
1657002432351,MATH 103A,A03,093561,Greenfeld; Be'Eri,4,0,36,32
1657002432351,MATH 103A,B01,083779,Greenfeld; Be'Eri,6,0,36,30
1657002432351,MATH 103A,B02,083780,Greenfeld; Be'Eri,2,0,36,34
1657002432351,MATH 103A,B03,093562,Greenfeld; Be'Eri,2,0,36,34
1657002438375,MATH 105,A01,085443,Carter; Anne Toulson,14,0,35,21
1657002438375,MATH 105,A02,093477,Carter; Anne Toulson,20,0,35,15
1657002444405,MATH 109,A01,083213,Ganzberger; Geoffrey Michael,2,0,34,32
1657002444405,MATH 109,A02,083214,Ganzberger; Geoffrey Michael,2,0,34,32
1657002444405,MATH 109,A03,093478,Ganzberger; Geoffrey Michael,1,0,34,33
1657002444405,MATH 109,B01,083215,Ganzberger; Geoffrey Michael,1,0,32,31
1657002444405,MATH 109,B02,083216,Ganzberger; Geoffrey Michael,1,0,32,31
1657002444405,MATH 109,B03,093479,Ganzberger; Geoffrey Michael,6,0,32,26
1657002450430,MATH 142A,A01,083219,Chow; Bennett,6,0,32,26
1657002450430,MATH 142A,A02,083220,Chow; Bennett,10,0,32,22
1657002450430,MATH 142A,A03,093480,Chow; Bennett,7,0,32,25
1657002450430,MATH 142A,B03,093481,Chow; Bennett,7,0,32,25
1657002450430,MATH 142A,B04,093558,Chow; Bennett,11,0,32,21
1657002450430,MATH 142A,B05,093559,Chow; Bennett,6,0,32,26
1657002456455,MATH 193A,A01,083224,Rotar; Vladimir,7,0,34,27
1657002456455,MATH 193A,A02,083225,Rotar; Vladimir,4,0,34,30
1657002456455,MATH 193A,A03,083781,Rotar; Vladimir,1,0,34,33
1657002456455,MATH 193A,A04,083782,Rotar; Vladimir,6,0,34,28
1657002456455,MATH 193A,A05,093482,Rotar; Vladimir,6,0,34,28
1657002462477,MATH 197,001,091859,McAuley; Julian John,9999,0,9999,0
1657002462477,MATH 197,002,095566,Kedlaya; Kiran S.,9997,0,9999,2
1657002462477,MATH 197,003,095567,Xiao; Ming,9999,0,9999,0
1657002462477,MATH 197,004,095571,Perols; Johan Lars,9998,0,9999,1
1657002469530,COGS 9,A01,083615,Shannon; Kyle Michael,7,0,75,68
1657002475651,COGS 11,A01,083617,Boyle; Mary E. T.,20,0,48,28
1657002481674,COGS 13,A01,083071,Bastos; Amalia Pinkusfeld,9,0,71,62
1657002487701,COGS 14A,A01,092681,Semenuks; Arturs,0,1,100,100
1657002493726,COGS 14B,A01,083073,Cheng; Tzu-Han,5,0,63,58
1657002499750,COGS 17,A01,092677,Semenuks; Arturs,4,0,81,77
1657002505773,COGS 100,A01,083619,Allen; Michael Gordon,15,0,70,55
1657002511805,COGS 101A,A01,083621,Davis; Joshua Daniel,9,0,68,59
1657002517836,COGS 101B,A01,091572,Allen; Michael Gordon,8,0,65,57
1657002523863,COGS 101C,A01,083625,Delgado; Tania,17,0,35,18
1657002529886,COGS 107A,A01,083627,Boyle; Mary E. T.,13,0,60,47
1657002535912,COGS 118A,A01,083075,Gupta; Anjum,15,0,76,61
1657002541935,CSE 3,A50,083646,Miranda; Gregory Joseph,22,0,50,28
1657002547961,CSE 8A,A50,083650,Miranda; Gregory Joseph,17,1,56,39
1657002553985,CSE 11,A01,083080,Cao; Yingjun,4,15,40,36
1657002560008,CSE 12,A01,083652,Krause-Levy; Sophia Louisa,21,1,120,99
1657002566035,CSE 15L,A01,083654,Morris; Justin Loren,8,0,50,42
1657002566035,CSE 15L,A02,083655,Morris; Justin Loren,9,0,50,41
1657002572060,CSE 20,A01,083657,Tran; Khoa Dang,37,0,80,43
1657002578082,CSE 21,A01,095574,Bach; Quang Tran,21,0,48,27
1657002584105,CSE 30,A01,083084,Eldon; John,4,0,80,76
1657002584105,CSE 30,B01,095061,Bhaskar; Nishant,6,0,50,44
1657002590128,CSE 100,A01,083659,Cao; Yingjun,3,4,70,67
1657002596150,CSE 134B,A01,083661,Powell; Thomas Allan,19,0,100,81
1657002602180,CSE 140,A01,083663,Gungor; Onat,14,0,85,71
1657002608206,CSE 140L,A01,083088,Eldon; John,16,0,100,84
1657002614233,CSE 175,A01,083665,Kumar; Rakesh,3,0,25,22
1657002620255,CSE 190,A00,092507,Dubnov; Shlomo,7,0,20,13
1657002626296,ECE 45,A01,083139,Congero; Spencer William,5,0,75,70
1657002632323,ECE 65,A50,083695,Saad; Andrew S,12,0,30,18
1657002632323,ECE 65,A51,095125,Saad; Andrew S,25,0,26,1
1657002638350,ECE 109,A01,091882,Touri; Behrouz,16,0,70,54
1657002644382,ECE 180,A00,083140,Abi Samra; Nicholas Camill,1,0,30,29
1657002644382,ECE 180,B00,083141,Abi Samra; Nicholas Camill,0,0,30,30
1657002650423,MATH 10A,A01,083735,Patchell; Gregory David,1,0,30,29
1657002650423,MATH 10A,A02,083736,Patchell; Gregory David,20,0,30,10
1657002650423,MATH 10A,A03,083737,Patchell; Gregory David,16,0,30,14
1657002656453,MATH 10B,A01,083207,Lim; Seonhee,7,0,34,27
1657002656453,MATH 10B,A02,083208,Lim; Seonhee,9,0,35,26
1657002656453,MATH 10B,A03,093472,Lim; Seonhee,4,0,34,30
1657002656453,MATH 10B,B01,083739,Sinha; Shubham,9,0,30,21
1657002662483,MATH 18,A01,083743,Cinel; Cameron Alexander,6,0,30,24
1657002662483,MATH 18,A02,083744,Cinel; Cameron Alexander,15,0,30,15
1657002662483,MATH 18,A03,083745,Cinel; Cameron Alexander,8,0,30,22
1657002662483,MATH 18,B01,083748,Rideout; David Porter,4,0,37,33
1657002662483,MATH 18,B02,083749,Rideout; David Porter,3,0,36,33
1657002662483,MATH 18,B03,083750,Rideout; David Porter,2,0,37,35
1657002662483,MATH 18,B04,083751,Rideout; David Porter,5,0,36,31
1657002662483,MATH 18,B05,093473,Rideout; David Porter,4,0,36,32
1657002662483,MATH 18,B06,093474,Rideout; David Porter,5,0,36,31
1657002668505,MATH 20A,A01,083754,Zheng; Zequn,12,0,40,28
1657002674533,MATH 20B,A01,083756,Briones; Jor-el Thomas Caparas,1,0,36,35
1657002674533,MATH 20B,A02,083757,Briones; Jor-el Thomas Caparas,1,0,36,35
1657002674533,MATH 20B,A03,093475,Briones; Jor-el Thomas Caparas,0,0,36,36
1657002680558,MATH 20C,A01,083760,Briones; Jor-el Thomas Caparas,1,0,35,34
1657002680558,MATH 20C,A02,083761,Briones; Jor-el Thomas Caparas,8,0,35,27
1657002680558,MATH 20C,A03,093476,Briones; Jor-el Thomas Caparas,0,1,36,36
1657002680558,MATH 20C,B01,083762,Bach; Quang Tran,0,0,30,30
1657002686588,MATH 20D,A01,083765,Tran; Brian Kha,4,0,30,26
1657002686588,MATH 20D,A02,083766,Tran; Brian Kha,5,0,30,25
1657002686588,MATH 20D,A03,083767,Tran; Brian Kha,3,0,30,27
1657002692613,MATH 20E,A01,083771,Ganguly; Soumya,5,0,32,27
1657002692613,MATH 20E,A02,083772,Ganguly; Soumya,6,0,32,26
1657002692613,MATH 20E,B01,083773,Ciotti; Benjamin,18,0,35,17
1657002692613,MATH 20E,B02,083774,Ciotti; Benjamin,17,0,35,18
1657002698636,MATH 103A,A01,083777,Greenfeld; Be'Eri,2,0,36,34
1657002698636,MATH 103A,A02,083778,Greenfeld; Be'Eri,5,0,36,31
1657002698636,MATH 103A,A03,093561,Greenfeld; Be'Eri,4,0,36,32
1657002698636,MATH 103A,B01,083779,Greenfeld; Be'Eri,6,0,36,30
1657002698636,MATH 103A,B02,083780,Greenfeld; Be'Eri,2,0,36,34
1657002698636,MATH 103A,B03,093562,Greenfeld; Be'Eri,2,0,36,34
1657002704662,MATH 105,A01,085443,Carter; Anne Toulson,14,0,35,21
1657002704662,MATH 105,A02,093477,Carter; Anne Toulson,20,0,35,15
1657002710687,MATH 109,A01,083213,Ganzberger; Geoffrey Michael,2,0,34,32
1657002710687,MATH 109,A02,083214,Ganzberger; Geoffrey Michael,2,0,34,32
1657002710687,MATH 109,A03,093478,Ganzberger; Geoffrey Michael,1,0,34,33
1657002710687,MATH 109,B01,083215,Ganzberger; Geoffrey Michael,1,0,32,31
1657002710687,MATH 109,B02,083216,Ganzberger; Geoffrey Michael,1,0,32,31
1657002710687,MATH 109,B03,093479,Ganzberger; Geoffrey Michael,6,0,32,26
1657002716711,MATH 142A,A01,083219,Chow; Bennett,6,0,32,26
1657002716711,MATH 142A,A02,083220,Chow; Bennett,10,0,32,22
1657002716711,MATH 142A,A03,093480,Chow; Bennett,7,0,32,25
1657002716711,MATH 142A,B03,093481,Chow; Bennett,7,0,32,25
1657002716711,MATH 142A,B04,093558,Chow; Bennett,11,0,32,21
1657002716711,MATH 142A,B05,093559,Chow; Bennett,6,0,32,26
1657002722744,MATH 193A,A01,083224,Rotar; Vladimir,7,0,34,27
1657002722744,MATH 193A,A02,083225,Rotar; Vladimir,4,0,34,30
1657002722744,MATH 193A,A03,083781,Rotar; Vladimir,1,0,34,33
1657002722744,MATH 193A,A04,083782,Rotar; Vladimir,6,0,34,28
1657002722744,MATH 193A,A05,093482,Rotar; Vladimir,6,0,34,28
1657002728766,MATH 197,001,091859,McAuley; Julian John,9999,0,9999,0
1657002728766,MATH 197,002,095566,Kedlaya; Kiran S.,9997,0,9999,2
1657002728766,MATH 197,003,095567,Xiao; Ming,9999,0,9999,0
1657002728766,MATH 197,004,095571,Perols; Johan Lars,9998,0,9999,1
1657002735821,COGS 9,A01,083615,Shannon; Kyle Michael,7,0,75,68
1657002741845,COGS 11,A01,083617,Boyle; Mary E. T.,20,0,48,28
1657002747868,COGS 13,A01,083071,Bastos; Amalia Pinkusfeld,9,0,71,62
1657002753895,COGS 14A,A01,092681,Semenuks; Arturs,0,1,100,100
1657002759926,COGS 14B,A01,083073,Cheng; Tzu-Han,5,0,63,58
1657002765953,COGS 17,A01,092677,Semenuks; Arturs,4,0,81,77
1657002771977,COGS 100,A01,083619,Allen; Michael Gordon,15,0,70,55
1657002778003,COGS 101A,A01,083621,Davis; Joshua Daniel,9,0,68,59
1657002784031,COGS 101B,A01,091572,Allen; Michael Gordon,8,0,65,57
1657002790054,COGS 101C,A01,083625,Delgado; Tania,17,0,35,18
1657002796077,COGS 107A,A01,083627,Boyle; Mary E. T.,13,0,60,47
1657002802105,COGS 118A,A01,083075,Gupta; Anjum,15,0,76,61
1657002808132,CSE 3,A50,083646,Miranda; Gregory Joseph,22,0,50,28
1657002814162,CSE 8A,A50,083650,Miranda; Gregory Joseph,17,1,56,39
1657002820188,CSE 11,A01,083080,Cao; Yingjun,4,15,40,36
1657002826217,CSE 12,A01,083652,Krause-Levy; Sophia Louisa,21,1,120,99
1657002832243,CSE 15L,A01,083654,Morris; Justin Loren,8,0,50,42
1657002832243,CSE 15L,A02,083655,Morris; Justin Loren,9,0,50,41
1657002838271,CSE 20,A01,083657,Tran; Khoa Dang,37,0,80,43
1657002844294,CSE 21,A01,095574,Bach; Quang Tran,21,0,48,27
1657002850317,CSE 30,A01,083084,Eldon; John,4,0,80,76
1657002850317,CSE 30,B01,095061,Bhaskar; Nishant,6,0,50,44
1657002856342,CSE 100,A01,083659,Cao; Yingjun,3,4,70,67
1657002862367,CSE 134B,A01,083661,Powell; Thomas Allan,19,0,100,81
1657002868390,CSE 140,A01,083663,Gungor; Onat,14,0,85,71
1657002874418,CSE 140L,A01,083088,Eldon; John,16,0,100,84
1657002880442,CSE 175,A01,083665,Kumar; Rakesh,3,0,25,22
1657002886490,CSE 190,A00,092507,Dubnov; Shlomo,7,0,20,13
1657002892518,ECE 45,A01,083139,Congero; Spencer William,5,0,75,70
1657002898542,ECE 65,A50,083695,Saad; Andrew S,12,0,30,18
1657002898542,ECE 65,A51,095125,Saad; Andrew S,25,0,26,1
1657002904575,ECE 109,A01,091882,Touri; Behrouz,16,0,70,54
1657002910602,ECE 180,A00,083140,Abi Samra; Nicholas Camill,1,0,30,29
1657002910602,ECE 180,B00,083141,Abi Samra; Nicholas Camill,0,0,30,30
1657002916625,MATH 10A,A01,083735,Patchell; Gregory David,1,0,30,29
1657002916625,MATH 10A,A02,083736,Patchell; Gregory David,20,0,30,10
1657002916625,MATH 10A,A03,083737,Patchell; Gregory David,16,0,30,14
1657002922653,MATH 10B,A01,083207,Lim; Seonhee,7,0,34,27
1657002922653,MATH 10B,A02,083208,Lim; Seonhee,9,0,35,26
1657002922653,MATH 10B,A03,093472,Lim; Seonhee,4,0,34,30
1657002922653,MATH 10B,B01,083739,Sinha; Shubham,9,0,30,21
1657002928681,MATH 18,A01,083743,Cinel; Cameron Alexander,6,0,30,24
1657002928681,MATH 18,A02,083744,Cinel; Cameron Alexander,15,0,30,15
1657002928681,MATH 18,A03,083745,Cinel; Cameron Alexander,8,0,30,22
1657002928681,MATH 18,B01,083748,Rideout; David Porter,4,0,37,33
1657002928681,MATH 18,B02,083749,Rideout; David Porter,3,0,36,33
1657002928681,MATH 18,B03,083750,Rideout; David Porter,2,0,37,35
1657002928681,MATH 18,B04,083751,Rideout; David Porter,5,0,36,31
1657002928681,MATH 18,B05,093473,Rideout; David Porter,4,0,36,32
1657002928681,MATH 18,B06,093474,Rideout; David Porter,5,0,36,31
1657002934702,MATH 20A,A01,083754,Zheng; Zequn,12,0,40,28
1657002940726,MATH 20B,A01,083756,Briones; Jor-el Thomas Caparas,1,0,36,35
1657002940726,MATH 20B,A02,083757,Briones; Jor-el Thomas Caparas,1,0,36,35
1657002940726,MATH 20B,A03,093475,Briones; Jor-el Thomas Caparas,0,0,36,36
1657002946754,MATH 20C,A01,083760,Briones; Jor-el Thomas Caparas,1,0,35,34
1657002946754,MATH 20C,A02,083761,Briones; Jor-el Thomas Caparas,8,0,35,27
1657002946754,MATH 20C,A03,093476,Briones; Jor-el Thomas Caparas,0,1,36,36
1657002946754,MATH 20C,B01,083762,Bach; Quang Tran,0,0,30,30
1657002952782,MATH 20D,A01,083765,Tran; Brian Kha,4,0,30,26
1657002952782,MATH 20D,A02,083766,Tran; Brian Kha,5,0,30,25
1657002952782,MATH 20D,A03,083767,Tran; Brian Kha,3,0,30,27
1657002958806,MATH 20E,A01,083771,Ganguly; Soumya,5,0,32,27
1657002958806,MATH 20E,A02,083772,Ganguly; Soumya,6,0,32,26
1657002958806,MATH 20E,B01,083773,Ciotti; Benjamin,18,0,35,17
1657002958806,MATH 20E,B02,083774,Ciotti; Benjamin,17,0,35,18
1657002964834,MATH 103A,A01,083777,Greenfeld; Be'Eri,2,0,36,34
1657002964834,MATH 103A,A02,083778,Greenfeld; Be'Eri,5,0,36,31
1657002964834,MATH 103A,A03,093561,Greenfeld; Be'Eri,4,0,36,32
1657002964834,MATH 103A,B01,083779,Greenfeld; Be'Eri,6,0,36,30
1657002964834,MATH 103A,B02,083780,Greenfeld; Be'Eri,2,0,36,34
1657002964834,MATH 103A,B03,093562,Greenfeld; Be'Eri,2,0,36,34
1657002970870,MATH 105,A01,085443,Carter; Anne Toulson,14,0,35,21
1657002970870,MATH 105,A02,093477,Carter; Anne Toulson,20,0,35,15
1657002976894,MATH 109,A01,083213,Ganzberger; Geoffrey Michael,2,0,34,32
1657002976894,MATH 109,A02,083214,Ganzberger; Geoffrey Michael,2,0,34,32
1657002976894,MATH 109,A03,093478,Ganzberger; Geoffrey Michael,1,0,34,33
1657002976894,MATH 109,B01,083215,Ganzberger; Geoffrey Michael,1,0,32,31
1657002976894,MATH 109,B02,083216,Ganzberger; Geoffrey Michael,1,0,32,31
1657002976894,MATH 109,B03,093479,Ganzberger; Geoffrey Michael,6,0,32,26
1657002982924,MATH 142A,A01,083219,Chow; Bennett,6,0,32,26
1657002982924,MATH 142A,A02,083220,Chow; Bennett,10,0,32,22
1657002982924,MATH 142A,A03,093480,Chow; Bennett,7,0,32,25
1657002982924,MATH 142A,B03,093481,Chow; Bennett,7,0,32,25
1657002982924,MATH 142A,B04,093558,Chow; Bennett,11,0,32,21
1657002982924,MATH 142A,B05,093559,Chow; Bennett,6,0,32,26
1657002988951,MATH 193A,A01,083224,Rotar; Vladimir,7,0,34,27
1657002988951,MATH 193A,A02,083225,Rotar; Vladimir,4,0,34,30
1657002988951,MATH 193A,A03,083781,Rotar; Vladimir,1,0,34,33
1657002988951,MATH 193A,A04,083782,Rotar; Vladimir,6,0,34,28
1657002988951,MATH 193A,A05,093482,Rotar; Vladimir,6,0,34,28
1657002994974,MATH 197,001,091859,McAuley; Julian John,9999,0,9999,0
1657002994974,MATH 197,002,095566,Kedlaya; Kiran S.,9997,0,9999,2
1657002994974,MATH 197,003,095567,Xiao; Ming,9999,0,9999,0
1657002994974,MATH 197,004,095571,Perols; Johan Lars,9998,0,9999,1
1657003002031,COGS 9,A01,083615,Shannon; Kyle Michael,7,0,75,68
1657003008055,COGS 11,A01,083617,Boyle; Mary E. T.,20,0,48,28
1657003014080,COGS 13,A01,083071,Bastos; Amalia Pinkusfeld,9,0,71,62
1657003020106,COGS 14A,A01,092681,Semenuks; Arturs,0,1,100,100
1657003026130,COGS 14B,A01,083073,Cheng; Tzu-Han,5,0,63,58
1657003032152,COGS 17,A01,092677,Semenuks; Arturs,4,0,81,77
1657003038183,COGS 100,A01,083619,Allen; Michael Gordon,15,0,70,55
1657003044206,COGS 101A,A01,083621,Davis; Joshua Daniel,9,0,68,59
1657003050230,COGS 101B,A01,091572,Allen; Michael Gordon,8,0,65,57
1657003056259,COGS 101C,A01,083625,Delgado; Tania,17,0,35,18
1657003062285,COGS 107A,A01,083627,Boyle; Mary E. T.,13,0,60,47
1657003068310,COGS 118A,A01,083075,Gupta; Anjum,15,0,76,61
1657003074411,CSE 3,A50,083646,Miranda; Gregory Joseph,22,0,50,28
1657003080434,CSE 8A,A50,083650,Miranda; Gregory Joseph,17,1,56,39
1657003086461,CSE 11,A01,083080,Cao; Yingjun,4,15,40,36
1657003092487,CSE 12,A01,083652,Krause-Levy; Sophia Louisa,21,1,120,99
1657003098514,CSE 15L,A01,083654,Morris; Justin Loren,8,0,50,42
1657003098514,CSE 15L,A02,083655,Morris; Justin Loren,9,0,50,41
1657003104536,CSE 20,A01,083657,Tran; Khoa Dang,37,0,80,43
1657003110559,CSE 21,A01,095574,Bach; Quang Tran,21,0,48,27
1657003116583,CSE 30,A01,083084,Eldon; John,4,0,80,76
1657003116583,CSE 30,B01,095061,Bhaskar; Nishant,6,0,50,44
1657003122606,CSE 100,A01,083659,Cao; Yingjun,3,4,70,67
1657003128632,CSE 134B,A01,083661,Powell; Thomas Allan,19,0,100,81
1657003134659,CSE 140,A01,083663,Gungor; Onat,14,0,85,71
1657003140681,CSE 140L,A01,083088,Eldon; John,16,0,100,84
1657003146710,CSE 175,A01,083665,Kumar; Rakesh,3,0,25,22
1657003152734,CSE 190,A00,092507,Dubnov; Shlomo,7,0,20,13
1657003158757,ECE 45,A01,083139,Congero; Spencer William,5,0,75,70
1657003164780,ECE 65,A50,083695,Saad; Andrew S,12,0,30,18
1657003164780,ECE 65,A51,095125,Saad; Andrew S,25,0,26,1
1657003170803,ECE 109,A01,091882,Touri; Behrouz,16,0,70,54
1657003176830,ECE 180,A00,083140,Abi Samra; Nicholas Camill,1,0,30,29
1657003176830,ECE 180,B00,083141,Abi Samra; Nicholas Camill,0,0,30,30
1657003182858,MATH 10A,A01,083735,Patchell; Gregory David,1,0,30,29
1657003182858,MATH 10A,A02,083736,Patchell; Gregory David,20,0,30,10
1657003182858,MATH 10A,A03,083737,Patchell; Gregory David,16,0,30,14
1657003188887,MATH 10B,A01,083207,Lim; Seonhee,7,0,34,27
1657003188887,MATH 10B,A02,083208,Lim; Seonhee,9,0,35,26
1657003188887,MATH 10B,A03,093472,Lim; Seonhee,4,0,34,30
1657003188887,MATH 10B,B01,083739,Sinha; Shubham,9,0,30,21
1657003194917,MATH 18,A01,083743,Cinel; Cameron Alexander,6,0,30,24
1657003194917,MATH 18,A02,083744,Cinel; Cameron Alexander,15,0,30,15
1657003194917,MATH 18,A03,083745,Cinel; Cameron Alexander,8,0,30,22
1657003194917,MATH 18,B01,083748,Rideout; David Porter,4,0,37,33
1657003194917,MATH 18,B02,083749,Rideout; David Porter,3,0,36,33
1657003194917,MATH 18,B03,083750,Rideout; David Porter,2,0,37,35
1657003194917,MATH 18,B04,083751,Rideout; David Porter,5,0,36,31
1657003194917,MATH 18,B05,093473,Rideout; David Porter,4,0,36,32
1657003194917,MATH 18,B06,093474,Rideout; David Porter,5,0,36,31
1657003200943,MATH 20A,A01,083754,Zheng; Zequn,12,0,40,28
1657003206970,MATH 20B,A01,083756,Briones; Jor-el Thomas Caparas,1,0,36,35
1657003206970,MATH 20B,A02,083757,Briones; Jor-el Thomas Caparas,1,0,36,35
1657003206970,MATH 20B,A03,093475,Briones; Jor-el Thomas Caparas,0,0,36,36
1657003212999,MATH 20C,A01,083760,Briones; Jor-el Thomas Caparas,1,0,35,34
1657003212999,MATH 20C,A02,083761,Briones; Jor-el Thomas Caparas,8,0,35,27
1657003212999,MATH 20C,A03,093476,Briones; Jor-el Thomas Caparas,0,1,36,36
1657003212999,MATH 20C,B01,083762,Bach; Quang Tran,0,0,30,30
1657003219021,MATH 20D,A01,083765,Tran; Brian Kha,4,0,30,26
1657003219021,MATH 20D,A02,083766,Tran; Brian Kha,5,0,30,25
1657003219021,MATH 20D,A03,083767,Tran; Brian Kha,3,0,30,27
1657003225048,MATH 20E,A01,083771,Ganguly; Soumya,5,0,32,27
1657003225048,MATH 20E,A02,083772,Ganguly; Soumya,6,0,32,26
1657003225048,MATH 20E,B01,083773,Ciotti; Benjamin,18,0,35,17
1657003225048,MATH 20E,B02,083774,Ciotti; Benjamin,17,0,35,18
1657003231071,MATH 103A,A01,083777,Greenfeld; Be'Eri,2,0,36,34
1657003231071,MATH 103A,A02,083778,Greenfeld; Be'Eri,5,0,36,31
1657003231071,MATH 103A,A03,093561,Greenfeld; Be'Eri,4,0,36,32
1657003231071,MATH 103A,B01,083779,Greenfeld; Be'Eri,6,0,36,30
1657003231071,MATH 103A,B02,083780,Greenfeld; Be'Eri,2,0,36,34
1657003231071,MATH 103A,B03,093562,Greenfeld; Be'Eri,2,0,36,34
1657003237096,MATH 105,A01,085443,Carter; Anne Toulson,14,0,35,21
1657003237096,MATH 105,A02,093477,Carter; Anne Toulson,20,0,35,15
1657003243122,MATH 109,A01,083213,Ganzberger; Geoffrey Michael,2,0,34,32
1657003243122,MATH 109,A02,083214,Ganzberger; Geoffrey Michael,2,0,34,32
1657003243122,MATH 109,A03,093478,Ganzberger; Geoffrey Michael,1,0,34,33
1657003243122,MATH 109,B01,083215,Ganzberger; Geoffrey Michael,1,0,32,31
1657003243122,MATH 109,B02,083216,Ganzberger; Geoffrey Michael,1,0,32,31
1657003243122,MATH 109,B03,093479,Ganzberger; Geoffrey Michael,6,0,32,26
1657003249146,MATH 142A,A01,083219,Chow; Bennett,6,0,32,26
1657003249146,MATH 142A,A02,083220,Chow; Bennett,10,0,32,22
1657003249146,MATH 142A,A03,093480,Chow; Bennett,7,0,32,25
1657003249146,MATH 142A,B03,093481,Chow; Bennett,7,0,32,25
1657003249146,MATH 142A,B04,093558,Chow; Bennett,11,0,32,21
1657003249146,MATH 142A,B05,093559,Chow; Bennett,6,0,32,26
1657003255177,MATH 193A,A01,083224,Rotar; Vladimir,7,0,34,27
1657003255177,MATH 193A,A02,083225,Rotar; Vladimir,4,0,34,30
1657003255177,MATH 193A,A03,083781,Rotar; Vladimir,1,0,34,33
1657003255177,MATH 193A,A04,083782,Rotar; Vladimir,6,0,34,28
1657003255177,MATH 193A,A05,093482,Rotar; Vladimir,6,0,34,28
1657003261201,MATH 197,001,091859,McAuley; Julian John,9999,0,9999,0
1657003261201,MATH 197,002,095566,Kedlaya; Kiran S.,9997,0,9999,2
1657003261201,MATH 197,003,095567,Xiao; Ming,9999,0,9999,0
1657003261201,MATH 197,004,095571,Perols; Johan Lars,9998,0,9999,1
1657003268258,COGS 9,A01,083615,Shannon; Kyle Michael,7,0,75,68
1657003274280,COGS 11,A01,083617,Boyle; Mary E. T.,20,0,48,28
1657003280310,COGS 13,A01,083071,Bastos; Amalia Pinkusfeld,9,0,71,62
1657003286332,COGS 14A,A01,092681,Semenuks; Arturs,0,1,100,100
1657003292356,COGS 14B,A01,083073,Cheng; Tzu-Han,5,0,63,58
1657003298388,COGS 17,A01,092677,Semenuks; Arturs,4,0,81,77
1657003304416,COGS 100,A01,083619,Allen; Michael Gordon,15,0,70,55
1657003310446,COGS 101A,A01,083621,Davis; Joshua Daniel,9,0,68,59
1657003316470,COGS 101B,A01,091572,Allen; Michael Gordon,8,0,65,57
1657003322497,COGS 101C,A01,083625,Delgado; Tania,17,0,35,18
1657003328534,COGS 107A,A01,083627,Boyle; Mary E. T.,13,0,60,47
1657003334559,COGS 118A,A01,083075,Gupta; Anjum,15,0,76,61
1657003340590,CSE 3,A50,083646,Miranda; Gregory Joseph,22,0,50,28
1657003346620,CSE 8A,A50,083650,Miranda; Gregory Joseph,17,1,56,39
1657003352647,CSE 11,A01,083080,Cao; Yingjun,4,15,40,36
1657003358670,CSE 12,A01,083652,Krause-Levy; Sophia Louisa,21,1,120,99
1657003364693,CSE 15L,A01,083654,Morris; Justin Loren,8,0,50,42
1657003364693,CSE 15L,A02,083655,Morris; Justin Loren,9,0,50,41
1657003370720,CSE 20,A01,083657,Tran; Khoa Dang,37,0,80,43
1657003376742,CSE 21,A01,095574,Bach; Quang Tran,21,0,48,27
1657003382790,CSE 30,A01,083084,Eldon; John,4,0,80,76
1657003382790,CSE 30,B01,095061,Bhaskar; Nishant,6,0,50,44
1657003388813,CSE 100,A01,083659,Cao; Yingjun,3,4,70,67
1657003394837,CSE 134B,A01,083661,Powell; Thomas Allan,19,0,100,81
1657003400863,CSE 140,A01,083663,Gungor; Onat,14,0,85,71
1657003406886,CSE 140L,A01,083088,Eldon; John,16,0,100,84
1657003412911,CSE 175,A01,083665,Kumar; Rakesh,3,0,25,22
1657003418934,CSE 190,A00,092507,Dubnov; Shlomo,7,0,20,13
1657003424957,ECE 45,A01,083139,Congero; Spencer William,5,0,75,70
1657003430982,ECE 65,A50,083695,Saad; Andrew S,12,0,30,18
1657003430982,ECE 65,A51,095125,Saad; Andrew S,25,0,26,1
1657003437004,ECE 109,A01,091882,Touri; Behrouz,16,0,70,54
1657003443027,ECE 180,A00,083140,Abi Samra; Nicholas Camill,1,0,30,29
1657003443027,ECE 180,B00,083141,Abi Samra; Nicholas Camill,0,0,30,30
1657003449051,MATH 10A,A01,083735,Patchell; Gregory David,1,0,30,29
1657003449051,MATH 10A,A02,083736,Patchell; Gregory David,20,0,30,10
1657003449051,MATH 10A,A03,083737,Patchell; Gregory David,16,0,30,14
1657003455073,MATH 10B,A01,083207,Lim; Seonhee,7,0,34,27
1657003455073,MATH 10B,A02,083208,Lim; Seonhee,9,0,35,26
1657003455073,MATH 10B,A03,093472,Lim; Seonhee,4,0,34,30
1657003455073,MATH 10B,B01,083739,Sinha; Shubham,9,0,30,21
1657003461098,MATH 18,A01,083743,Cinel; Cameron Alexander,6,0,30,24
1657003461098,MATH 18,A02,083744,Cinel; Cameron Alexander,15,0,30,15
1657003461098,MATH 18,A03,083745,Cinel; Cameron Alexander,8,0,30,22
1657003461098,MATH 18,B01,083748,Rideout; David Porter,4,0,37,33
1657003461098,MATH 18,B02,083749,Rideout; David Porter,3,0,36,33
1657003461098,MATH 18,B03,083750,Rideout; David Porter,2,0,37,35
1657003461098,MATH 18,B04,083751,Rideout; David Porter,5,0,36,31
1657003461098,MATH 18,B05,093473,Rideout; David Porter,4,0,36,32
1657003461098,MATH 18,B06,093474,Rideout; David Porter,5,0,36,31
1657003467125,MATH 20A,A01,083754,Zheng; Zequn,12,0,40,28
1657003473148,MATH 20B,A01,083756,Briones; Jor-el Thomas Caparas,1,0,36,35
1657003473148,MATH 20B,A02,083757,Briones; Jor-el Thomas Caparas,1,0,36,35
1657003473148,MATH 20B,A03,093475,Briones; Jor-el Thomas Caparas,0,0,36,36
1657003479177,MATH 20C,A01,083760,Briones; Jor-el Thomas Caparas,1,0,35,34
1657003479177,MATH 20C,A02,083761,Briones; Jor-el Thomas Caparas,8,0,35,27
1657003479177,MATH 20C,A03,093476,Briones; Jor-el Thomas Caparas,0,1,36,36
1657003479177,MATH 20C,B01,083762,Bach; Quang Tran,0,0,30,30
1657003485206,MATH 20D,A01,083765,Tran; Brian Kha,4,0,30,26
1657003485206,MATH 20D,A02,083766,Tran; Brian Kha,5,0,30,25
1657003485206,MATH 20D,A03,083767,Tran; Brian Kha,3,0,30,27
1657003491233,MATH 20E,A01,083771,Ganguly; Soumya,5,0,32,27
1657003491233,MATH 20E,A02,083772,Ganguly; Soumya,6,0,32,26
1657003491233,MATH 20E,B01,083773,Ciotti; Benjamin,18,0,35,17
1657003491233,MATH 20E,B02,083774,Ciotti; Benjamin,17,0,35,18
1657003497258,MATH 103A,A01,083777,Greenfeld; Be'Eri,2,0,36,34
1657003497258,MATH 103A,A02,083778,Greenfeld; Be'Eri,5,0,36,31
1657003497258,MATH 103A,A03,093561,Greenfeld; Be'Eri,4,0,36,32
1657003497258,MATH 103A,B01,083779,Greenfeld; Be'Eri,6,0,36,30
1657003497258,MATH 103A,B02,083780,Greenfeld; Be'Eri,2,0,36,34
1657003497258,MATH 103A,B03,093562,Greenfeld; Be'Eri,2,0,36,34
1657003503288,MATH 105,A01,085443,Carter; Anne Toulson,14,0,35,21
1657003503288,MATH 105,A02,093477,Carter; Anne Toulson,20,0,35,15
1657003509314,MATH 109,A01,083213,Ganzberger; Geoffrey Michael,2,0,34,32
1657003509314,MATH 109,A02,083214,Ganzberger; Geoffrey Michael,2,0,34,32
1657003509314,MATH 109,A03,093478,Ganzberger; Geoffrey Michael,1,0,34,33
1657003509314,MATH 109,B01,083215,Ganzberger; Geoffrey Michael,1,0,32,31
1657003509314,MATH 109,B02,083216,Ganzberger; Geoffrey Michael,1,0,32,31
1657003509314,MATH 109,B03,093479,Ganzberger; Geoffrey Michael,6,0,32,26
1657003515341,MATH 142A,A01,083219,Chow; Bennett,6,0,32,26
1657003515341,MATH 142A,A02,083220,Chow; Bennett,10,0,32,22
1657003515341,MATH 142A,A03,093480,Chow; Bennett,7,0,32,25
1657003515341,MATH 142A,B03,093481,Chow; Bennett,7,0,32,25
1657003515341,MATH 142A,B04,093558,Chow; Bennett,11,0,32,21
1657003515341,MATH 142A,B05,093559,Chow; Bennett,6,0,32,26
1657003521365,MATH 193A,A01,083224,Rotar; Vladimir,7,0,34,27
1657003521365,MATH 193A,A02,083225,Rotar; Vladimir,4,0,34,30
1657003521365,MATH 193A,A03,083781,Rotar; Vladimir,1,0,34,33
1657003521365,MATH 193A,A04,083782,Rotar; Vladimir,6,0,34,28
1657003521365,MATH 193A,A05,093482,Rotar; Vladimir,6,0,34,28
1657003527398,MATH 197,001,091859,McAuley; Julian John,9999,0,9999,0
1657003527398,MATH 197,002,095566,Kedlaya; Kiran S.,9997,0,9999,2
1657003527398,MATH 197,003,095567,Xiao; Ming,9999,0,9999,0
1657003527398,MATH 197,004,095571,Perols; Johan Lars,9998,0,9999,1
1657003534451,COGS 9,A01,083615,Shannon; Kyle Michael,7,0,75,68
1657003540477,COGS 11,A01,083617,Boyle; Mary E. T.,20,0,48,28
1657003546504,COGS 13,A01,083071,Bastos; Amalia Pinkusfeld,9,0,71,62
1657003552529,COGS 14A,A01,092681,Semenuks; Arturs,0,1,100,100
1657003558560,COGS 14B,A01,083073,Cheng; Tzu-Han,5,0,63,58
1657003564587,COGS 17,A01,092677,Semenuks; Arturs,4,0,81,77
1657003570621,COGS 100,A01,083619,Allen; Michael Gordon,15,0,70,55
1657003576648,COGS 101A,A01,083621,Davis; Joshua Daniel,9,0,68,59
1657003582671,COGS 101B,A01,091572,Allen; Michael Gordon,8,0,65,57
1657003588692,COGS 101C,A01,083625,Delgado; Tania,17,0,35,18
1657003594717,COGS 107A,A01,083627,Boyle; Mary E. T.,13,0,60,47
1657003600745,COGS 118A,A01,083075,Gupta; Anjum,15,0,76,61
1657003606776,CSE 3,A50,083646,Miranda; Gregory Joseph,22,0,50,28
1657003612803,CSE 8A,A50,083650,Miranda; Gregory Joseph,17,1,56,39
1657003618826,CSE 11,A01,083080,Cao; Yingjun,4,15,40,36
1657003624852,CSE 12,A01,083652,Krause-Levy; Sophia Louisa,21,1,120,99
1657003630878,CSE 15L,A01,083654,Morris; Justin Loren,8,0,50,42
1657003630878,CSE 15L,A02,083655,Morris; Justin Loren,9,0,50,41
1657003636905,CSE 20,A01,083657,Tran; Khoa Dang,37,0,80,43
1657003642932,CSE 21,A01,095574,Bach; Quang Tran,21,0,48,27
1657003648958,CSE 30,A01,083084,Eldon; John,4,0,80,76
1657003648958,CSE 30,B01,095061,Bhaskar; Nishant,6,0,50,44
1657003654986,CSE 100,A01,083659,Cao; Yingjun,3,4,70,67
1657003661012,CSE 134B,A01,083661,Powell; Thomas Allan,19,0,100,81
1657003667034,CSE 140,A01,083663,Gungor; Onat,14,0,85,71
1657003673151,CSE 140L,A01,083088,Eldon; John,16,0,100,84
1657003679176,CSE 175,A01,083665,Kumar; Rakesh,3,0,25,22
1657003685200,CSE 190,A00,092507,Dubnov; Shlomo,7,0,20,13
1657003691226,ECE 45,A01,083139,Congero; Spencer William,5,0,75,70
1657003697250,ECE 65,A50,083695,Saad; Andrew S,12,0,30,18
1657003697250,ECE 65,A51,095125,Saad; Andrew S,25,0,26,1
1657003703273,ECE 109,A01,091882,Touri; Behrouz,16,0,70,54
1657003709301,ECE 180,A00,083140,Abi Samra; Nicholas Camill,1,0,30,29
1657003709301,ECE 180,B00,083141,Abi Samra; Nicholas Camill,0,0,30,30
1657003715324,MATH 10A,A01,083735,Patchell; Gregory David,1,0,30,29
1657003715324,MATH 10A,A02,083736,Patchell; Gregory David,20,0,30,10
1657003715324,MATH 10A,A03,083737,Patchell; Gregory David,16,0,30,14
1657003721347,MATH 10B,A01,083207,Lim; Seonhee,7,0,34,27
1657003721347,MATH 10B,A02,083208,Lim; Seonhee,9,0,35,26
1657003721347,MATH 10B,A03,093472,Lim; Seonhee,4,0,34,30
1657003721347,MATH 10B,B01,083739,Sinha; Shubham,9,0,30,21
1657003727378,MATH 18,A01,083743,Cinel; Cameron Alexander,6,0,30,24
1657003727378,MATH 18,A02,083744,Cinel; Cameron Alexander,15,0,30,15
1657003727378,MATH 18,A03,083745,Cinel; Cameron Alexander,8,0,30,22
1657003727378,MATH 18,B01,083748,Rideout; David Porter,4,0,37,33
1657003727378,MATH 18,B02,083749,Rideout; David Porter,3,0,36,33
1657003727378,MATH 18,B03,083750,Rideout; David Porter,2,0,37,35
1657003727378,MATH 18,B04,083751,Rideout; David Porter,5,0,36,31
1657003727378,MATH 18,B05,093473,Rideout; David Porter,4,0,36,32
1657003727378,MATH 18,B06,093474,Rideout; David Porter,5,0,36,31
1657003733401,MATH 20A,A01,083754,Zheng; Zequn,12,0,40,28
1657003739436,MATH 20B,A01,083756,Briones; Jor-el Thomas Caparas,1,0,36,35
1657003739436,MATH 20B,A02,083757,Briones; Jor-el Thomas Caparas,1,0,36,35
1657003739436,MATH 20B,A03,093475,Briones; Jor-el Thomas Caparas,0,0,36,36
1657003745465,MATH 20C,A01,083760,Briones; Jor-el Thomas Caparas,1,0,35,34
1657003745465,MATH 20C,A02,083761,Briones; Jor-el Thomas Caparas,8,0,35,27
1657003745465,MATH 20C,A03,093476,Briones; Jor-el Thomas Caparas,0,1,36,36
1657003745465,MATH 20C,B01,083762,Bach; Quang Tran,0,0,30,30
1657003751491,MATH 20D,A01,083765,Tran; Brian Kha,4,0,30,26
1657003751491,MATH 20D,A02,083766,Tran; Brian Kha,5,0,30,25
1657003751491,MATH 20D,A03,083767,Tran; Brian Kha,3,0,30,27
1657003757522,MATH 20E,A01,083771,Ganguly; Soumya,5,0,32,27
1657003757522,MATH 20E,A02,083772,Ganguly; Soumya,6,0,32,26
1657003757522,MATH 20E,B01,083773,Ciotti; Benjamin,18,0,35,17
1657003757522,MATH 20E,B02,083774,Ciotti; Benjamin,17,0,35,18
1657003763553,MATH 103A,A01,083777,Greenfeld; Be'Eri,2,0,36,34
1657003763553,MATH 103A,A02,083778,Greenfeld; Be'Eri,5,0,36,31
1657003763553,MATH 103A,A03,093561,Greenfeld; Be'Eri,4,0,36,32
1657003763553,MATH 103A,B01,083779,Greenfeld; Be'Eri,6,0,36,30
1657003763553,MATH 103A,B02,083780,Greenfeld; Be'Eri,2,0,36,34
1657003763553,MATH 103A,B03,093562,Greenfeld; Be'Eri,2,0,36,34
1657003769577,MATH 105,A01,085443,Carter; Anne Toulson,14,0,35,21
1657003769577,MATH 105,A02,093477,Carter; Anne Toulson,20,0,35,15
1657003775608,MATH 109,A01,083213,Ganzberger; Geoffrey Michael,2,0,34,32
1657003775608,MATH 109,A02,083214,Ganzberger; Geoffrey Michael,2,0,34,32
1657003775608,MATH 109,A03,093478,Ganzberger; Geoffrey Michael,1,0,34,33
1657003775608,MATH 109,B01,083215,Ganzberger; Geoffrey Michael,1,0,32,31
1657003775608,MATH 109,B02,083216,Ganzberger; Geoffrey Michael,1,0,32,31
1657003775608,MATH 109,B03,093479,Ganzberger; Geoffrey Michael,6,0,32,26
1657003781637,MATH 142A,A01,083219,Chow; Bennett,6,0,32,26
1657003781637,MATH 142A,A02,083220,Chow; Bennett,10,0,32,22
1657003781637,MATH 142A,A03,093480,Chow; Bennett,7,0,32,25
1657003781637,MATH 142A,B03,093481,Chow; Bennett,7,0,32,25
1657003781637,MATH 142A,B04,093558,Chow; Bennett,11,0,32,21
1657003781637,MATH 142A,B05,093559,Chow; Bennett,6,0,32,26
1657003787671,MATH 193A,A01,083224,Rotar; Vladimir,7,0,34,27
1657003787671,MATH 193A,A02,083225,Rotar; Vladimir,4,0,34,30
1657003787671,MATH 193A,A03,083781,Rotar; Vladimir,1,0,34,33
1657003787671,MATH 193A,A04,083782,Rotar; Vladimir,6,0,34,28
1657003787671,MATH 193A,A05,093482,Rotar; Vladimir,6,0,34,28
1657003793694,MATH 197,001,091859,McAuley; Julian John,9999,0,9999,0
1657003793694,MATH 197,002,095566,Kedlaya; Kiran S.,9997,0,9999,2
1657003793694,MATH 197,003,095567,Xiao; Ming,9999,0,9999,0
1657003793694,MATH 197,004,095571,Perols; Johan Lars,9998,0,9999,1
1657003800752,COGS 9,A01,083615,Shannon; Kyle Michael,7,0,75,68
1657003806775,COGS 11,A01,083617,Boyle; Mary E. T.,20,0,48,28
1657003812799,COGS 13,A01,083071,Bastos; Amalia Pinkusfeld,9,0,71,62
1657003818831,COGS 14A,A01,092681,Semenuks; Arturs,0,1,100,100
1657003824853,COGS 14B,A01,083073,Cheng; Tzu-Han,5,0,63,58
1657003830877,COGS 17,A01,092677,Semenuks; Arturs,4,0,81,77
1657003836900,COGS 100,A01,083619,Allen; Michael Gordon,15,0,70,55
1657003842929,COGS 101A,A01,083621,Davis; Joshua Daniel,9,0,68,59
1657003848964,COGS 101B,A01,091572,Allen; Michael Gordon,8,0,65,57
1657003854997,COGS 101C,A01,083625,Delgado; Tania,17,0,35,18
1657003861026,COGS 107A,A01,083627,Boyle; Mary E. T.,13,0,60,47
1657003867052,COGS 118A,A01,083075,Gupta; Anjum,15,0,76,61
1657003873080,CSE 3,A50,083646,Miranda; Gregory Joseph,22,0,50,28
1657003879104,CSE 8A,A50,083650,Miranda; Gregory Joseph,17,1,56,39
1657003885131,CSE 11,A01,083080,Cao; Yingjun,4,15,40,36
1657003891158,CSE 12,A01,083652,Krause-Levy; Sophia Louisa,21,1,120,99
1657003897182,CSE 15L,A01,083654,Morris; Justin Loren,8,0,50,42
1657003897182,CSE 15L,A02,083655,Morris; Justin Loren,9,0,50,41
1657003903209,CSE 20,A01,083657,Tran; Khoa Dang,37,0,80,43
1657003909235,CSE 21,A01,095574,Bach; Quang Tran,21,0,48,27
1657003915262,CSE 30,A01,083084,Eldon; John,4,0,80,76
1657003915262,CSE 30,B01,095061,Bhaskar; Nishant,6,0,50,44
1657003921289,CSE 100,A01,083659,Cao; Yingjun,3,4,70,67
1657003927317,CSE 134B,A01,083661,Powell; Thomas Allan,19,0,100,81
1657003933340,CSE 140,A01,083663,Gungor; Onat,14,0,85,71
1657003939364,CSE 140L,A01,083088,Eldon; John,16,0,100,84
1657003945390,CSE 175,A01,083665,Kumar; Rakesh,3,0,25,22
1657003951413,CSE 190,A00,092507,Dubnov; Shlomo,7,0,20,13
1657003957438,ECE 45,A01,083139,Congero; Spencer William,5,0,75,70
1657003963463,ECE 65,A50,083695,Saad; Andrew S,12,0,30,18
1657003963463,ECE 65,A51,095125,Saad; Andrew S,25,0,26,1
1657003969488,ECE 109,A01,091882,Touri; Behrouz,16,0,70,54
1657003975512,ECE 180,A00,083140,Abi Samra; Nicholas Camill,1,0,30,29
1657003975512,ECE 180,B00,083141,Abi Samra; Nicholas Camill,0,0,30,30
1657003981539,MATH 10A,A01,083735,Patchell; Gregory David,1,0,30,29
1657003981539,MATH 10A,A02,083736,Patchell; Gregory David,20,0,30,10
1657003981539,MATH 10A,A03,083737,Patchell; Gregory David,16,0,30,14
1657003987565,MATH 10B,A01,083207,Lim; Seonhee,7,0,34,27
1657003987565,MATH 10B,A02,083208,Lim; Seonhee,9,0,35,26
1657003987565,MATH 10B,A03,093472,Lim; Seonhee,4,0,34,30
1657003987565,MATH 10B,B01,083739,Sinha; Shubham,9,0,30,21
1657003993596,MATH 18,A01,083743,Cinel; Cameron Alexander,6,0,30,24
1657003993596,MATH 18,A02,083744,Cinel; Cameron Alexander,15,0,30,15
1657003993596,MATH 18,A03,083745,Cinel; Cameron Alexander,8,0,30,22
1657003993596,MATH 18,B01,083748,Rideout; David Porter,4,0,37,33
1657003993596,MATH 18,B02,083749,Rideout; David Porter,3,0,36,33
1657003993596,MATH 18,B03,083750,Rideout; David Porter,2,0,37,35
1657003993596,MATH 18,B04,083751,Rideout; David Porter,5,0,36,31
1657003993596,MATH 18,B05,093473,Rideout; David Porter,4,0,36,32
1657003993596,MATH 18,B06,093474,Rideout; David Porter,5,0,36,31
1657003999619,MATH 20A,A01,083754,Zheng; Zequn,12,0,40,28
1657004005644,MATH 20B,A01,083756,Briones; Jor-el Thomas Caparas,1,0,36,35
1657004005644,MATH 20B,A02,083757,Briones; Jor-el Thomas Caparas,1,0,36,35
1657004005644,MATH 20B,A03,093475,Briones; Jor-el Thomas Caparas,0,0,36,36
1657004011671,MATH 20C,A01,083760,Briones; Jor-el Thomas Caparas,1,0,35,34
1657004011671,MATH 20C,A02,083761,Briones; Jor-el Thomas Caparas,8,0,35,27
1657004011671,MATH 20C,A03,093476,Briones; Jor-el Thomas Caparas,0,1,36,36
1657004011671,MATH 20C,B01,083762,Bach; Quang Tran,0,0,30,30
1657004017693,MATH 20D,A01,083765,Tran; Brian Kha,4,0,30,26
1657004017693,MATH 20D,A02,083766,Tran; Brian Kha,5,0,30,25
1657004017693,MATH 20D,A03,083767,Tran; Brian Kha,3,0,30,27
1657004023730,MATH 20E,A01,083771,Ganguly; Soumya,5,0,32,27
1657004023730,MATH 20E,A02,083772,Ganguly; Soumya,6,0,32,26
1657004023730,MATH 20E,B01,083773,Ciotti; Benjamin,18,0,35,17
1657004023730,MATH 20E,B02,083774,Ciotti; Benjamin,17,0,35,18
1657004029755,MATH 103A,A01,083777,Greenfeld; Be'Eri,2,0,36,34
1657004029755,MATH 103A,A02,083778,Greenfeld; Be'Eri,5,0,36,31
1657004029755,MATH 103A,A03,093561,Greenfeld; Be'Eri,4,0,36,32
1657004029755,MATH 103A,B01,083779,Greenfeld; Be'Eri,6,0,36,30
1657004029755,MATH 103A,B02,083780,Greenfeld; Be'Eri,2,0,36,34
1657004029755,MATH 103A,B03,093562,Greenfeld; Be'Eri,2,0,36,34
1657004035792,MATH 105,A01,085443,Carter; Anne Toulson,14,0,35,21
1657004035792,MATH 105,A02,093477,Carter; Anne Toulson,20,0,35,15
1657004041816,MATH 109,A01,083213,Ganzberger; Geoffrey Michael,2,0,34,32
1657004041816,MATH 109,A02,083214,Ganzberger; Geoffrey Michael,2,0,34,32
1657004041816,MATH 109,A03,093478,Ganzberger; Geoffrey Michael,1,0,34,33
1657004041816,MATH 109,B01,083215,Ganzberger; Geoffrey Michael,1,0,32,31
1657004041816,MATH 109,B02,083216,Ganzberger; Geoffrey Michael,1,0,32,31
1657004041816,MATH 109,B03,093479,Ganzberger; Geoffrey Michael,6,0,32,26
1657004047845,MATH 142A,A01,083219,Chow; Bennett,6,0,32,26
1657004047845,MATH 142A,A02,083220,Chow; Bennett,10,0,32,22
1657004047845,MATH 142A,A03,093480,Chow; Bennett,7,0,32,25
1657004047845,MATH 142A,B03,093481,Chow; Bennett,7,0,32,25
1657004047845,MATH 142A,B04,093558,Chow; Bennett,11,0,32,21
1657004047845,MATH 142A,B05,093559,Chow; Bennett,6,0,32,26
1657004053869,MATH 193A,A01,083224,Rotar; Vladimir,7,0,34,27
1657004053869,MATH 193A,A02,083225,Rotar; Vladimir,4,0,34,30
1657004053869,MATH 193A,A03,083781,Rotar; Vladimir,1,0,34,33
1657004053869,MATH 193A,A04,083782,Rotar; Vladimir,6,0,34,28
1657004053869,MATH 193A,A05,093482,Rotar; Vladimir,6,0,34,28
1657004059895,MATH 197,001,091859,McAuley; Julian John,9999,0,9999,0
1657004059895,MATH 197,002,095566,Kedlaya; Kiran S.,9997,0,9999,2
1657004059895,MATH 197,003,095567,Xiao; Ming,9999,0,9999,0
1657004059895,MATH 197,004,095571,Perols; Johan Lars,9998,0,9999,1
1657004066960,COGS 9,A01,083615,Shannon; Kyle Michael,7,0,75,68
1657004072983,COGS 11,A01,083617,Boyle; Mary E. T.,20,0,48,28
1657004079007,COGS 13,A01,083071,Bastos; Amalia Pinkusfeld,9,0,71,62
1657004085030,COGS 14A,A01,092681,Semenuks; Arturs,0,1,100,100
1657004091057,COGS 14B,A01,083073,Cheng; Tzu-Han,5,0,63,58
1657004097084,COGS 17,A01,092677,Semenuks; Arturs,4,0,81,77
1657004103107,COGS 100,A01,083619,Allen; Michael Gordon,15,0,70,55
1657004109144,COGS 101A,A01,083621,Davis; Joshua Daniel,9,0,68,59
1657004115171,COGS 101B,A01,091572,Allen; Michael Gordon,8,0,65,57
1657004121195,COGS 101C,A01,083625,Delgado; Tania,17,0,35,18
1657004127222,COGS 107A,A01,083627,Boyle; Mary E. T.,13,0,60,47
1657004133247,COGS 118A,A01,083075,Gupta; Anjum,15,0,76,61
1657004139285,CSE 3,A50,083646,Miranda; Gregory Joseph,22,0,50,28
1657004145312,CSE 8A,A50,083650,Miranda; Gregory Joseph,17,1,56,39
1657004151337,CSE 11,A01,083080,Cao; Yingjun,4,15,40,36
1657004157360,CSE 12,A01,083652,Krause-Levy; Sophia Louisa,21,1,120,99
1657004163391,CSE 15L,A01,083654,Morris; Justin Loren,8,0,50,42
1657004163391,CSE 15L,A02,083655,Morris; Justin Loren,9,0,50,41
1657004169415,CSE 20,A01,083657,Tran; Khoa Dang,37,0,80,43
1657004175459,CSE 21,A01,095574,Bach; Quang Tran,21,0,48,27
1657004181482,CSE 30,A01,083084,Eldon; John,4,0,80,76
1657004181482,CSE 30,B01,095061,Bhaskar; Nishant,6,0,50,44
1657004187506,CSE 100,A01,083659,Cao; Yingjun,3,4,70,67
1657004193529,CSE 134B,A01,083661,Powell; Thomas Allan,19,0,100,81
1657004199553,CSE 140,A01,083663,Gungor; Onat,14,0,85,71
1657004205580,CSE 140L,A01,083088,Eldon; John,16,0,100,84
1657004211605,CSE 175,A01,083665,Kumar; Rakesh,3,0,25,22
1657004217632,CSE 190,A00,092507,Dubnov; Shlomo,7,0,20,13
1657004223656,ECE 45,A01,083139,Congero; Spencer William,5,0,75,70
1657004229682,ECE 65,A50,083695,Saad; Andrew S,12,0,30,18
1657004229682,ECE 65,A51,095125,Saad; Andrew S,25,0,26,1
1657004235714,ECE 109,A01,091882,Touri; Behrouz,16,0,70,54
1657004241742,ECE 180,A00,083140,Abi Samra; Nicholas Camill,1,0,30,29
1657004241742,ECE 180,B00,083141,Abi Samra; Nicholas Camill,0,0,30,30
1657004247766,MATH 10A,A01,083735,Patchell; Gregory David,1,0,30,29
1657004247766,MATH 10A,A02,083736,Patchell; Gregory David,20,0,30,10
1657004247766,MATH 10A,A03,083737,Patchell; Gregory David,16,0,30,14
1657004253791,MATH 10B,A01,083207,Lim; Seonhee,7,0,34,27
1657004253791,MATH 10B,A02,083208,Lim; Seonhee,9,0,35,26
1657004253791,MATH 10B,A03,093472,Lim; Seonhee,4,0,34,30
1657004253791,MATH 10B,B01,083739,Sinha; Shubham,9,0,30,21
1657004259815,MATH 18,A01,083743,Cinel; Cameron Alexander,6,0,30,24
1657004259815,MATH 18,A02,083744,Cinel; Cameron Alexander,15,0,30,15
1657004259815,MATH 18,A03,083745,Cinel; Cameron Alexander,8,0,30,22
1657004259815,MATH 18,B01,083748,Rideout; David Porter,4,0,37,33
1657004259815,MATH 18,B02,083749,Rideout; David Porter,3,0,36,33
1657004259815,MATH 18,B03,083750,Rideout; David Porter,2,0,37,35
1657004259815,MATH 18,B04,083751,Rideout; David Porter,5,0,36,31
1657004259815,MATH 18,B05,093473,Rideout; David Porter,4,0,36,32
1657004259815,MATH 18,B06,093474,Rideout; David Porter,5,0,36,31
1657004265856,MATH 20A,A01,083754,Zheng; Zequn,12,0,40,28
1657004271950,MATH 20B,A01,083756,Briones; Jor-el Thomas Caparas,1,0,36,35
1657004271950,MATH 20B,A02,083757,Briones; Jor-el Thomas Caparas,1,0,36,35
1657004271950,MATH 20B,A03,093475,Briones; Jor-el Thomas Caparas,0,0,36,36
1657004277973,MATH 20C,A01,083760,Briones; Jor-el Thomas Caparas,1,0,35,34
1657004277973,MATH 20C,A02,083761,Briones; Jor-el Thomas Caparas,8,0,35,27
1657004277973,MATH 20C,A03,093476,Briones; Jor-el Thomas Caparas,0,1,36,36
1657004277973,MATH 20C,B01,083762,Bach; Quang Tran,0,0,30,30
1657004283997,MATH 20D,A01,083765,Tran; Brian Kha,4,0,30,26
1657004283997,MATH 20D,A02,083766,Tran; Brian Kha,5,0,30,25
1657004283997,MATH 20D,A03,083767,Tran; Brian Kha,3,0,30,27
1657004290024,MATH 20E,A01,083771,Ganguly; Soumya,5,0,32,27
1657004290024,MATH 20E,A02,083772,Ganguly; Soumya,6,0,32,26
1657004290024,MATH 20E,B01,083773,Ciotti; Benjamin,18,0,35,17
1657004290024,MATH 20E,B02,083774,Ciotti; Benjamin,17,0,35,18
1657004296055,MATH 103A,A01,083777,Greenfeld; Be'Eri,2,0,36,34
1657004296055,MATH 103A,A02,083778,Greenfeld; Be'Eri,5,0,36,31
1657004296055,MATH 103A,A03,093561,Greenfeld; Be'Eri,4,0,36,32
1657004296055,MATH 103A,B01,083779,Greenfeld; Be'Eri,6,0,36,30
1657004296055,MATH 103A,B02,083780,Greenfeld; Be'Eri,2,0,36,34
1657004296055,MATH 103A,B03,093562,Greenfeld; Be'Eri,2,0,36,34
1657004302093,MATH 105,A01,085443,Carter; Anne Toulson,14,0,35,21
1657004302093,MATH 105,A02,093477,Carter; Anne Toulson,20,0,35,15
1657004308123,MATH 109,A01,083213,Ganzberger; Geoffrey Michael,2,0,34,32
1657004308123,MATH 109,A02,083214,Ganzberger; Geoffrey Michael,2,0,34,32
1657004308123,MATH 109,A03,093478,Ganzberger; Geoffrey Michael,1,0,34,33
1657004308123,MATH 109,B01,083215,Ganzberger; Geoffrey Michael,1,0,32,31
1657004308123,MATH 109,B02,083216,Ganzberger; Geoffrey Michael,1,0,32,31
1657004308123,MATH 109,B03,093479,Ganzberger; Geoffrey Michael,6,0,32,26
1657004314152,MATH 142A,A01,083219,Chow; Bennett,6,0,32,26
1657004314152,MATH 142A,A02,083220,Chow; Bennett,10,0,32,22
1657004314152,MATH 142A,A03,093480,Chow; Bennett,7,0,32,25
1657004314152,MATH 142A,B03,093481,Chow; Bennett,7,0,32,25
1657004314152,MATH 142A,B04,093558,Chow; Bennett,11,0,32,21
1657004314152,MATH 142A,B05,093559,Chow; Bennett,6,0,32,26
1657004320177,MATH 193A,A01,083224,Rotar; Vladimir,7,0,34,27
1657004320177,MATH 193A,A02,083225,Rotar; Vladimir,4,0,34,30
1657004320177,MATH 193A,A03,083781,Rotar; Vladimir,1,0,34,33
1657004320177,MATH 193A,A04,083782,Rotar; Vladimir,6,0,34,28
1657004320177,MATH 193A,A05,093482,Rotar; Vladimir,6,0,34,28
1657004326202,MATH 197,001,091859,McAuley; Julian John,9999,0,9999,0
1657004326202,MATH 197,002,095566,Kedlaya; Kiran S.,9997,0,9999,2
1657004326202,MATH 197,003,095567,Xiao; Ming,9999,0,9999,0
1657004326202,MATH 197,004,095571,Perols; Johan Lars,9998,0,9999,1
1657004333283,COGS 9,A01,083615,Shannon; Kyle Michael,7,0,75,68
1657004339311,COGS 11,A01,083617,Boyle; Mary E. T.,20,0,48,28
1657004345338,COGS 13,A01,083071,Bastos; Amalia Pinkusfeld,9,0,71,62
1657004351364,COGS 14A,A01,092681,Semenuks; Arturs,0,1,100,100
1657004357389,COGS 14B,A01,083073,Cheng; Tzu-Han,5,0,63,58
1657004363412,COGS 17,A01,092677,Semenuks; Arturs,4,0,81,77
1657004369434,COGS 100,A01,083619,Allen; Michael Gordon,15,0,70,55
1657004375456,COGS 101A,A01,083621,Davis; Joshua Daniel,9,0,68,59
1657004381481,COGS 101B,A01,091572,Allen; Michael Gordon,8,0,65,57
1657004387508,COGS 101C,A01,083625,Delgado; Tania,17,0,35,18
1657004393535,COGS 107A,A01,083627,Boyle; Mary E. T.,13,0,60,47
1657004399558,COGS 118A,A01,083075,Gupta; Anjum,15,0,76,61
1657004405580,CSE 3,A50,083646,Miranda; Gregory Joseph,22,0,50,28
1657004411604,CSE 8A,A50,083650,Miranda; Gregory Joseph,17,1,56,39
1657004417630,CSE 11,A01,083080,Cao; Yingjun,4,15,40,36
1657004423661,CSE 12,A01,083652,Krause-Levy; Sophia Louisa,21,1,120,99
1657004429684,CSE 15L,A01,083654,Morris; Justin Loren,8,0,50,42
1657004429684,CSE 15L,A02,083655,Morris; Justin Loren,9,0,50,41
1657004435708,CSE 20,A01,083657,Tran; Khoa Dang,37,0,80,43
1657004441732,CSE 21,A01,095574,Bach; Quang Tran,21,0,48,27
1657004447762,CSE 30,A01,083084,Eldon; John,4,0,80,76
1657004447762,CSE 30,B01,095061,Bhaskar; Nishant,6,0,50,44
1657004453788,CSE 100,A01,083659,Cao; Yingjun,3,4,70,67
1657004459815,CSE 134B,A01,083661,Powell; Thomas Allan,19,0,100,81
1657004465843,CSE 140,A01,083663,Gungor; Onat,14,0,85,71
1657004471874,CSE 140L,A01,083088,Eldon; John,16,0,100,84
1657004477896,CSE 175,A01,083665,Kumar; Rakesh,3,0,25,22
1657004483922,CSE 190,A00,092507,Dubnov; Shlomo,7,0,20,13
1657004489949,ECE 45,A01,083139,Congero; Spencer William,5,0,75,70
1657004495976,ECE 65,A50,083695,Saad; Andrew S,12,0,30,18
1657004495976,ECE 65,A51,095125,Saad; Andrew S,25,0,26,1
1657004502004,ECE 109,A01,091882,Touri; Behrouz,16,0,70,54
1657004508036,ECE 180,A00,083140,Abi Samra; Nicholas Camill,1,0,30,29
1657004508036,ECE 180,B00,083141,Abi Samra; Nicholas Camill,0,0,30,30
1657004514064,MATH 10A,A01,083735,Patchell; Gregory David,1,0,30,29
1657004514064,MATH 10A,A02,083736,Patchell; Gregory David,20,0,30,10
1657004514064,MATH 10A,A03,083737,Patchell; Gregory David,16,0,30,14
1657004520087,MATH 10B,A01,083207,Lim; Seonhee,7,0,34,27
1657004520087,MATH 10B,A02,083208,Lim; Seonhee,9,0,35,26
1657004520087,MATH 10B,A03,093472,Lim; Seonhee,4,0,34,30
1657004520087,MATH 10B,B01,083739,Sinha; Shubham,9,0,30,21
1657004526112,MATH 18,A01,083743,Cinel; Cameron Alexander,6,0,30,24
1657004526112,MATH 18,A02,083744,Cinel; Cameron Alexander,15,0,30,15
1657004526112,MATH 18,A03,083745,Cinel; Cameron Alexander,8,0,30,22
1657004526112,MATH 18,B01,083748,Rideout; David Porter,4,0,37,33
1657004526112,MATH 18,B02,083749,Rideout; David Porter,3,0,36,33
1657004526112,MATH 18,B03,083750,Rideout; David Porter,2,0,37,35
1657004526112,MATH 18,B04,083751,Rideout; David Porter,5,0,36,31
1657004526112,MATH 18,B05,093473,Rideout; David Porter,4,0,36,32
1657004526112,MATH 18,B06,093474,Rideout; David Porter,5,0,36,31
1657004532136,MATH 20A,A01,083754,Zheng; Zequn,12,0,40,28
1657004538160,MATH 20B,A01,083756,Briones; Jor-el Thomas Caparas,1,0,36,35
1657004538160,MATH 20B,A02,083757,Briones; Jor-el Thomas Caparas,1,0,36,35
1657004538160,MATH 20B,A03,093475,Briones; Jor-el Thomas Caparas,0,0,36,36
1657004544192,MATH 20C,A01,083760,Briones; Jor-el Thomas Caparas,1,0,35,34
1657004544192,MATH 20C,A02,083761,Briones; Jor-el Thomas Caparas,8,0,35,27
1657004544192,MATH 20C,A03,093476,Briones; Jor-el Thomas Caparas,0,1,36,36
1657004544192,MATH 20C,B01,083762,Bach; Quang Tran,0,0,30,30
1657004550225,MATH 20D,A01,083765,Tran; Brian Kha,4,0,30,26
1657004550225,MATH 20D,A02,083766,Tran; Brian Kha,5,0,30,25
1657004550225,MATH 20D,A03,083767,Tran; Brian Kha,3,0,30,27
1657004556249,MATH 20E,A01,083771,Ganguly; Soumya,5,0,32,27
1657004556249,MATH 20E,A02,083772,Ganguly; Soumya,6,0,32,26
1657004556249,MATH 20E,B01,083773,Ciotti; Benjamin,18,0,35,17
1657004556249,MATH 20E,B02,083774,Ciotti; Benjamin,17,0,35,18
1657004562278,MATH 103A,A01,083777,Greenfeld; Be'Eri,2,0,36,34
1657004562278,MATH 103A,A02,083778,Greenfeld; Be'Eri,5,0,36,31
1657004562278,MATH 103A,A03,093561,Greenfeld; Be'Eri,4,0,36,32
1657004562278,MATH 103A,B01,083779,Greenfeld; Be'Eri,6,0,36,30
1657004562278,MATH 103A,B02,083780,Greenfeld; Be'Eri,2,0,36,34
1657004562278,MATH 103A,B03,093562,Greenfeld; Be'Eri,2,0,36,34
1657004568306,MATH 105,A01,085443,Carter; Anne Toulson,14,0,35,21
1657004568306,MATH 105,A02,093477,Carter; Anne Toulson,20,0,35,15
1657004574334,MATH 109,A01,083213,Ganzberger; Geoffrey Michael,2,0,34,32
1657004574334,MATH 109,A02,083214,Ganzberger; Geoffrey Michael,2,0,34,32
1657004574334,MATH 109,A03,093478,Ganzberger; Geoffrey Michael,1,0,34,33
1657004574334,MATH 109,B01,083215,Ganzberger; Geoffrey Michael,1,0,32,31
1657004574334,MATH 109,B02,083216,Ganzberger; Geoffrey Michael,1,0,32,31
1657004574334,MATH 109,B03,093479,Ganzberger; Geoffrey Michael,6,0,32,26
1657004580358,MATH 142A,A01,083219,Chow; Bennett,6,0,32,26
1657004580358,MATH 142A,A02,083220,Chow; Bennett,10,0,32,22
1657004580358,MATH 142A,A03,093480,Chow; Bennett,7,0,32,25
1657004580358,MATH 142A,B03,093481,Chow; Bennett,7,0,32,25
1657004580358,MATH 142A,B04,093558,Chow; Bennett,11,0,32,21
1657004580358,MATH 142A,B05,093559,Chow; Bennett,6,0,32,26
1657004586383,MATH 193A,A01,083224,Rotar; Vladimir,7,0,34,27
1657004586383,MATH 193A,A02,083225,Rotar; Vladimir,4,0,34,30
1657004586383,MATH 193A,A03,083781,Rotar; Vladimir,1,0,34,33
1657004586383,MATH 193A,A04,083782,Rotar; Vladimir,6,0,34,28
1657004586383,MATH 193A,A05,093482,Rotar; Vladimir,6,0,34,28
1657004592412,MATH 197,001,091859,McAuley; Julian John,9999,0,9999,0
1657004592412,MATH 197,002,095566,Kedlaya; Kiran S.,9997,0,9999,2
1657004592412,MATH 197,003,095567,Xiao; Ming,9999,0,9999,0
1657004592412,MATH 197,004,095571,Perols; Johan Lars,9998,0,9999,1
1657004599474,COGS 9,A01,083615,Shannon; Kyle Michael,7,0,75,68
1657004605501,COGS 11,A01,083617,Boyle; Mary E. T.,20,0,48,28
1657004611523,COGS 13,A01,083071,Bastos; Amalia Pinkusfeld,9,0,71,62
1657004617549,COGS 14A,A01,092681,Semenuks; Arturs,0,1,100,100
1657004623578,COGS 14B,A01,083073,Cheng; Tzu-Han,5,0,63,58
1657004629601,COGS 17,A01,092677,Semenuks; Arturs,4,0,81,77
1657004635633,COGS 100,A01,083619,Allen; Michael Gordon,15,0,70,55
1657004641658,COGS 101A,A01,083621,Davis; Joshua Daniel,9,0,68,59
1657004647686,COGS 101B,A01,091572,Allen; Michael Gordon,8,0,65,57
1657004653726,COGS 101C,A01,083625,Delgado; Tania,17,0,35,18
1657004659749,COGS 107A,A01,083627,Boyle; Mary E. T.,13,0,60,47
1657004665774,COGS 118A,A01,083075,Gupta; Anjum,15,0,76,61
1657004671807,CSE 3,A50,083646,Miranda; Gregory Joseph,22,0,50,28
1657004677831,CSE 8A,A50,083650,Miranda; Gregory Joseph,17,1,56,39
1657004683854,CSE 11,A01,083080,Cao; Yingjun,4,15,40,36
1657004689877,CSE 12,A01,083652,Krause-Levy; Sophia Louisa,21,1,120,99
1657004695900,CSE 15L,A01,083654,Morris; Justin Loren,8,0,50,42
1657004695900,CSE 15L,A02,083655,Morris; Justin Loren,9,0,50,41
1657004701932,CSE 20,A01,083657,Tran; Khoa Dang,37,0,80,43
1657004707957,CSE 21,A01,095574,Bach; Quang Tran,21,0,48,27
1657004713982,CSE 30,A01,083084,Eldon; John,4,0,80,76
1657004713982,CSE 30,B01,095061,Bhaskar; Nishant,6,0,50,44
1657004720005,CSE 100,A01,083659,Cao; Yingjun,3,4,70,67
1657004726027,CSE 134B,A01,083661,Powell; Thomas Allan,19,0,100,81
1657004732051,CSE 140,A01,083663,Gungor; Onat,14,0,85,71
1657004738080,CSE 140L,A01,083088,Eldon; John,16,0,100,84
1657004744102,CSE 175,A01,083665,Kumar; Rakesh,3,0,25,22
1657004750125,CSE 190,A00,092507,Dubnov; Shlomo,7,0,20,13
1657004756148,ECE 45,A01,083139,Congero; Spencer William,5,0,75,70
1657004762176,ECE 65,A50,083695,Saad; Andrew S,12,0,30,18
1657004762176,ECE 65,A51,095125,Saad; Andrew S,25,0,26,1
1657004768200,ECE 109,A01,091882,Touri; Behrouz,16,0,70,54
1657004774227,ECE 180,A00,083140,Abi Samra; Nicholas Camill,1,0,30,29
1657004774227,ECE 180,B00,083141,Abi Samra; Nicholas Camill,0,0,30,30
1657004780252,MATH 10A,A01,083735,Patchell; Gregory David,1,0,30,29
1657004780252,MATH 10A,A02,083736,Patchell; Gregory David,20,0,30,10
1657004780252,MATH 10A,A03,083737,Patchell; Gregory David,16,0,30,14
1657004786278,MATH 10B,A01,083207,Lim; Seonhee,7,0,34,27
1657004786278,MATH 10B,A02,083208,Lim; Seonhee,9,0,35,26
1657004786278,MATH 10B,A03,093472,Lim; Seonhee,4,0,34,30
1657004786278,MATH 10B,B01,083739,Sinha; Shubham,9,0,30,21
1657004792304,MATH 18,A01,083743,Cinel; Cameron Alexander,6,0,30,24
1657004792304,MATH 18,A02,083744,Cinel; Cameron Alexander,15,0,30,15
1657004792304,MATH 18,A03,083745,Cinel; Cameron Alexander,8,0,30,22
1657004792304,MATH 18,B01,083748,Rideout; David Porter,4,0,37,33
1657004792304,MATH 18,B02,083749,Rideout; David Porter,3,0,36,33
1657004792304,MATH 18,B03,083750,Rideout; David Porter,2,0,37,35
1657004792304,MATH 18,B04,083751,Rideout; David Porter,5,0,36,31
1657004792304,MATH 18,B05,093473,Rideout; David Porter,4,0,36,32
1657004792304,MATH 18,B06,093474,Rideout; David Porter,5,0,36,31
1657004798332,MATH 20A,A01,083754,Zheng; Zequn,12,0,40,28
1657004804356,MATH 20B,A01,083756,Briones; Jor-el Thomas Caparas,1,0,36,35
1657004804356,MATH 20B,A02,083757,Briones; Jor-el Thomas Caparas,1,0,36,35
1657004804356,MATH 20B,A03,093475,Briones; Jor-el Thomas Caparas,0,0,36,36
1657004810392,MATH 20C,A01,083760,Briones; Jor-el Thomas Caparas,1,0,35,34
1657004810392,MATH 20C,A02,083761,Briones; Jor-el Thomas Caparas,8,0,35,27
1657004810392,MATH 20C,A03,093476,Briones; Jor-el Thomas Caparas,0,1,36,36
1657004810392,MATH 20C,B01,083762,Bach; Quang Tran,0,0,30,30
1657004816420,MATH 20D,A01,083765,Tran; Brian Kha,4,0,30,26
1657004816420,MATH 20D,A02,083766,Tran; Brian Kha,5,0,30,25
1657004816420,MATH 20D,A03,083767,Tran; Brian Kha,3,0,30,27
1657004822454,MATH 20E,A01,083771,Ganguly; Soumya,5,0,32,27
1657004822454,MATH 20E,A02,083772,Ganguly; Soumya,6,0,32,26
1657004822454,MATH 20E,B01,083773,Ciotti; Benjamin,18,0,35,17
1657004822454,MATH 20E,B02,083774,Ciotti; Benjamin,17,0,35,18
1657004828478,MATH 103A,A01,083777,Greenfeld; Be'Eri,2,0,36,34
1657004828478,MATH 103A,A02,083778,Greenfeld; Be'Eri,5,0,36,31
1657004828478,MATH 103A,A03,093561,Greenfeld; Be'Eri,4,0,36,32
1657004828478,MATH 103A,B01,083779,Greenfeld; Be'Eri,6,0,36,30
1657004828478,MATH 103A,B02,083780,Greenfeld; Be'Eri,2,0,36,34
1657004828478,MATH 103A,B03,093562,Greenfeld; Be'Eri,2,0,36,34
1657004834505,MATH 105,A01,085443,Carter; Anne Toulson,14,0,35,21
1657004834505,MATH 105,A02,093477,Carter; Anne Toulson,20,0,35,15
1657004840537,MATH 109,A01,083213,Ganzberger; Geoffrey Michael,2,0,34,32
1657004840537,MATH 109,A02,083214,Ganzberger; Geoffrey Michael,2,0,34,32
1657004840537,MATH 109,A03,093478,Ganzberger; Geoffrey Michael,1,0,34,33
1657004840537,MATH 109,B01,083215,Ganzberger; Geoffrey Michael,1,0,32,31
1657004840537,MATH 109,B02,083216,Ganzberger; Geoffrey Michael,1,0,32,31
1657004840537,MATH 109,B03,093479,Ganzberger; Geoffrey Michael,6,0,32,26
1657004846568,MATH 142A,A01,083219,Chow; Bennett,6,0,32,26
1657004846568,MATH 142A,A02,083220,Chow; Bennett,10,0,32,22
1657004846568,MATH 142A,A03,093480,Chow; Bennett,7,0,32,25
1657004846568,MATH 142A,B03,093481,Chow; Bennett,7,0,32,25
1657004846568,MATH 142A,B04,093558,Chow; Bennett,11,0,32,21
1657004846568,MATH 142A,B05,093559,Chow; Bennett,6,0,32,26
1657004852592,MATH 193A,A01,083224,Rotar; Vladimir,7,0,34,27
1657004852592,MATH 193A,A02,083225,Rotar; Vladimir,4,0,34,30
1657004852592,MATH 193A,A03,083781,Rotar; Vladimir,1,0,34,33
1657004852592,MATH 193A,A04,083782,Rotar; Vladimir,6,0,34,28
1657004852592,MATH 193A,A05,093482,Rotar; Vladimir,6,0,34,28
1657004858619,MATH 197,001,091859,McAuley; Julian John,9999,0,9999,0
1657004858619,MATH 197,002,095566,Kedlaya; Kiran S.,9997,0,9999,2
1657004858619,MATH 197,003,095567,Xiao; Ming,9999,0,9999,0
1657004858619,MATH 197,004,095571,Perols; Johan Lars,9998,0,9999,1
1657004865752,COGS 9,A01,083615,Shannon; Kyle Michael,7,0,75,68
1657004871782,COGS 11,A01,083617,Boyle; Mary E. T.,20,0,48,28
1657004877806,COGS 13,A01,083071,Bastos; Amalia Pinkusfeld,9,0,71,62
1657004883830,COGS 14A,A01,092681,Semenuks; Arturs,0,1,100,100
1657004889857,COGS 14B,A01,083073,Cheng; Tzu-Han,5,0,63,58
1657004895890,COGS 17,A01,092677,Semenuks; Arturs,4,0,81,77
1657004901914,COGS 100,A01,083619,Allen; Michael Gordon,15,0,70,55
1657004907948,COGS 101A,A01,083621,Davis; Joshua Daniel,9,0,68,59
1657004913972,COGS 101B,A01,091572,Allen; Michael Gordon,8,0,65,57
1657004919996,COGS 101C,A01,083625,Delgado; Tania,17,0,35,18
1657004926062,COGS 107A,A01,083627,Boyle; Mary E. T.,13,0,60,47
1657004932090,COGS 118A,A01,083075,Gupta; Anjum,15,0,76,61
1657004938120,CSE 3,A50,083646,Miranda; Gregory Joseph,22,0,50,28
1657004944149,CSE 8A,A50,083650,Miranda; Gregory Joseph,17,1,56,39
1657004950175,CSE 11,A01,083080,Cao; Yingjun,4,15,40,36
1657004956205,CSE 12,A01,083652,Krause-Levy; Sophia Louisa,21,1,120,99
1657004962232,CSE 15L,A01,083654,Morris; Justin Loren,8,0,50,42
1657004962232,CSE 15L,A02,083655,Morris; Justin Loren,9,0,50,41
1657004968258,CSE 20,A01,083657,Tran; Khoa Dang,37,0,80,43
1657004974294,CSE 21,A01,095574,Bach; Quang Tran,21,0,48,27
1657004980322,CSE 30,A01,083084,Eldon; John,4,0,80,76
1657004980322,CSE 30,B01,095061,Bhaskar; Nishant,6,0,50,44
1657004986346,CSE 100,A01,083659,Cao; Yingjun,3,4,70,67
1657004992369,CSE 134B,A01,083661,Powell; Thomas Allan,19,0,100,81
1657004998391,CSE 140,A01,083663,Gungor; Onat,14,0,85,71
1657005004414,CSE 140L,A01,083088,Eldon; John,16,0,100,84
1657005010437,CSE 175,A01,083665,Kumar; Rakesh,3,0,25,22
1657005016465,CSE 190,A00,092507,Dubnov; Shlomo,7,0,20,13
1657005022488,ECE 45,A01,083139,Congero; Spencer William,5,0,75,70
1657005028511,ECE 65,A50,083695,Saad; Andrew S,12,0,30,18
1657005028511,ECE 65,A51,095125,Saad; Andrew S,25,0,26,1
1657005034534,ECE 109,A01,091882,Touri; Behrouz,16,0,70,54
1657005040559,ECE 180,A00,083140,Abi Samra; Nicholas Camill,1,0,30,29
1657005040559,ECE 180,B00,083141,Abi Samra; Nicholas Camill,0,0,30,30
1657005046582,MATH 10A,A01,083735,Patchell; Gregory David,1,0,30,29
1657005046582,MATH 10A,A02,083736,Patchell; Gregory David,20,0,30,10
1657005046582,MATH 10A,A03,083737,Patchell; Gregory David,16,0,30,14
1657005052608,MATH 10B,A01,083207,Lim; Seonhee,7,0,34,27
1657005052608,MATH 10B,A02,083208,Lim; Seonhee,9,0,35,26
1657005052608,MATH 10B,A03,093472,Lim; Seonhee,4,0,34,30
1657005052608,MATH 10B,B01,083739,Sinha; Shubham,9,0,30,21
1657005058637,MATH 18,A01,083743,Cinel; Cameron Alexander,6,0,30,24
1657005058637,MATH 18,A02,083744,Cinel; Cameron Alexander,15,0,30,15
1657005058637,MATH 18,A03,083745,Cinel; Cameron Alexander,8,0,30,22
1657005058637,MATH 18,B01,083748,Rideout; David Porter,4,0,37,33
1657005058637,MATH 18,B02,083749,Rideout; David Porter,3,0,36,33
1657005058637,MATH 18,B03,083750,Rideout; David Porter,2,0,37,35
1657005058637,MATH 18,B04,083751,Rideout; David Porter,5,0,36,31
1657005058637,MATH 18,B05,093473,Rideout; David Porter,4,0,36,32
1657005058637,MATH 18,B06,093474,Rideout; David Porter,5,0,36,31
1657005064665,MATH 20A,A01,083754,Zheng; Zequn,12,0,40,28
1657005070698,MATH 20B,A01,083756,Briones; Jor-el Thomas Caparas,1,0,36,35
1657005070698,MATH 20B,A02,083757,Briones; Jor-el Thomas Caparas,1,0,36,35
1657005070698,MATH 20B,A03,093475,Briones; Jor-el Thomas Caparas,0,0,36,36
1657005076723,MATH 20C,A01,083760,Briones; Jor-el Thomas Caparas,1,0,35,34
1657005076723,MATH 20C,A02,083761,Briones; Jor-el Thomas Caparas,8,0,35,27
1657005076723,MATH 20C,A03,093476,Briones; Jor-el Thomas Caparas,0,1,36,36
1657005076723,MATH 20C,B01,083762,Bach; Quang Tran,0,0,30,30
1657005082748,MATH 20D,A01,083765,Tran; Brian Kha,4,0,30,26
1657005082748,MATH 20D,A02,083766,Tran; Brian Kha,5,0,30,25
1657005082748,MATH 20D,A03,083767,Tran; Brian Kha,3,0,30,27
1657005088771,MATH 20E,A01,083771,Ganguly; Soumya,5,0,32,27
1657005088771,MATH 20E,A02,083772,Ganguly; Soumya,6,0,32,26
1657005088771,MATH 20E,B01,083773,Ciotti; Benjamin,18,0,35,17
1657005088771,MATH 20E,B02,083774,Ciotti; Benjamin,17,0,35,18
1657005094805,MATH 103A,A01,083777,Greenfeld; Be'Eri,2,0,36,34
1657005094805,MATH 103A,A02,083778,Greenfeld; Be'Eri,5,0,36,31
1657005094805,MATH 103A,A03,093561,Greenfeld; Be'Eri,4,0,36,32
1657005094805,MATH 103A,B01,083779,Greenfeld; Be'Eri,6,0,36,30
1657005094805,MATH 103A,B02,083780,Greenfeld; Be'Eri,2,0,36,34
1657005094805,MATH 103A,B03,093562,Greenfeld; Be'Eri,2,0,36,34
1657005100831,MATH 105,A01,085443,Carter; Anne Toulson,14,0,35,21
1657005100831,MATH 105,A02,093477,Carter; Anne Toulson,20,0,35,15
1657005106862,MATH 109,A01,083213,Ganzberger; Geoffrey Michael,2,0,34,32
1657005106862,MATH 109,A02,083214,Ganzberger; Geoffrey Michael,2,0,34,32
1657005106862,MATH 109,A03,093478,Ganzberger; Geoffrey Michael,1,0,34,33
1657005106862,MATH 109,B01,083215,Ganzberger; Geoffrey Michael,1,0,32,31
1657005106862,MATH 109,B02,083216,Ganzberger; Geoffrey Michael,1,0,32,31
1657005106862,MATH 109,B03,093479,Ganzberger; Geoffrey Michael,6,0,32,26
1657005112889,MATH 142A,A01,083219,Chow; Bennett,6,0,32,26
1657005112889,MATH 142A,A02,083220,Chow; Bennett,10,0,32,22
1657005112889,MATH 142A,A03,093480,Chow; Bennett,7,0,32,25
1657005112889,MATH 142A,B03,093481,Chow; Bennett,7,0,32,25
1657005112889,MATH 142A,B04,093558,Chow; Bennett,11,0,32,21
1657005112889,MATH 142A,B05,093559,Chow; Bennett,6,0,32,26
1657005118920,MATH 193A,A01,083224,Rotar; Vladimir,7,0,34,27
1657005118920,MATH 193A,A02,083225,Rotar; Vladimir,4,0,34,30
1657005118920,MATH 193A,A03,083781,Rotar; Vladimir,1,0,34,33
1657005118920,MATH 193A,A04,083782,Rotar; Vladimir,6,0,34,28
1657005118920,MATH 193A,A05,093482,Rotar; Vladimir,6,0,34,28
1657005124945,MATH 197,001,091859,McAuley; Julian John,9999,0,9999,0
1657005124945,MATH 197,002,095566,Kedlaya; Kiran S.,9997,0,9999,2
1657005124945,MATH 197,003,095567,Xiao; Ming,9999,0,9999,0
1657005124945,MATH 197,004,095571,Perols; Johan Lars,9998,0,9999,1
1657005132007,COGS 9,A01,083615,Shannon; Kyle Michael,7,0,75,68
1657005138033,COGS 11,A01,083617,Boyle; Mary E. T.,20,0,48,28
1657005144058,COGS 13,A01,083071,Bastos; Amalia Pinkusfeld,9,0,71,62
1657005150082,COGS 14A,A01,092681,Semenuks; Arturs,0,1,100,100
1657005156106,COGS 14B,A01,083073,Cheng; Tzu-Han,5,0,63,58
1657005162131,COGS 17,A01,092677,Semenuks; Arturs,4,0,81,77
1657005168159,COGS 100,A01,083619,Allen; Michael Gordon,15,0,70,55
1657005174182,COGS 101A,A01,083621,Davis; Joshua Daniel,9,0,68,59
1657005180211,COGS 101B,A01,091572,Allen; Michael Gordon,8,0,65,57
1657005186235,COGS 101C,A01,083625,Delgado; Tania,17,0,35,18
1657005192262,COGS 107A,A01,083627,Boyle; Mary E. T.,13,0,60,47
1657005198290,COGS 118A,A01,083075,Gupta; Anjum,15,0,76,61
1657005204314,CSE 3,A50,083646,Miranda; Gregory Joseph,22,0,50,28
1657005210343,CSE 8A,A50,083650,Miranda; Gregory Joseph,17,1,56,39
1657005216375,CSE 11,A01,083080,Cao; Yingjun,4,15,40,36
1657005222402,CSE 12,A01,083652,Krause-Levy; Sophia Louisa,21,1,120,99
1657005228427,CSE 15L,A01,083654,Morris; Justin Loren,8,0,50,42
1657005228427,CSE 15L,A02,083655,Morris; Justin Loren,9,0,50,41
1657005234450,CSE 20,A01,083657,Tran; Khoa Dang,37,0,80,43
1657005240473,CSE 21,A01,095574,Bach; Quang Tran,21,0,48,27
1657005246499,CSE 30,A01,083084,Eldon; John,4,0,80,76
1657005246499,CSE 30,B01,095061,Bhaskar; Nishant,6,0,50,44
1657005252530,CSE 100,A01,083659,Cao; Yingjun,3,4,70,67
1657005258555,CSE 134B,A01,083661,Powell; Thomas Allan,19,0,100,81
1657005264581,CSE 140,A01,083663,Gungor; Onat,14,0,85,71
1657005270610,CSE 140L,A01,083088,Eldon; John,16,0,100,84
1657005276641,CSE 175,A01,083665,Kumar; Rakesh,3,0,25,22
1657005282686,CSE 190,A00,092507,Dubnov; Shlomo,7,0,20,13
1657005288709,ECE 45,A01,083139,Congero; Spencer William,5,0,75,70
1657005294735,ECE 65,A50,083695,Saad; Andrew S,12,0,30,18
1657005294735,ECE 65,A51,095125,Saad; Andrew S,25,0,26,1
1657005300764,ECE 109,A01,091882,Touri; Behrouz,16,0,70,54
1657005306790,ECE 180,A00,083140,Abi Samra; Nicholas Camill,1,0,30,29
1657005306790,ECE 180,B00,083141,Abi Samra; Nicholas Camill,0,0,30,30
1657005312819,MATH 10A,A01,083735,Patchell; Gregory David,1,0,30,29
1657005312819,MATH 10A,A02,083736,Patchell; Gregory David,20,0,30,10
1657005312819,MATH 10A,A03,083737,Patchell; Gregory David,16,0,30,14
1657005318856,MATH 10B,A01,083207,Lim; Seonhee,7,0,34,27
1657005318856,MATH 10B,A02,083208,Lim; Seonhee,9,0,35,26
1657005318856,MATH 10B,A03,093472,Lim; Seonhee,4,0,34,30
1657005318856,MATH 10B,B01,083739,Sinha; Shubham,9,0,30,21
1657005324925,MATH 18,A01,083743,Cinel; Cameron Alexander,6,0,30,24
1657005324925,MATH 18,A02,083744,Cinel; Cameron Alexander,15,0,30,15
1657005324925,MATH 18,A03,083745,Cinel; Cameron Alexander,8,0,30,22
1657005324925,MATH 18,B01,083748,Rideout; David Porter,4,0,37,33
1657005324925,MATH 18,B02,083749,Rideout; David Porter,3,0,36,33
1657005324925,MATH 18,B03,083750,Rideout; David Porter,2,0,37,35
1657005324925,MATH 18,B04,083751,Rideout; David Porter,5,0,36,31
1657005324925,MATH 18,B05,093473,Rideout; David Porter,4,0,36,32
1657005324925,MATH 18,B06,093474,Rideout; David Porter,5,0,36,31
1657005330950,MATH 20A,A01,083754,Zheng; Zequn,12,0,40,28
1657005336983,MATH 20B,A01,083756,Briones; Jor-el Thomas Caparas,1,0,36,35
1657005336983,MATH 20B,A02,083757,Briones; Jor-el Thomas Caparas,1,0,36,35
1657005336983,MATH 20B,A03,093475,Briones; Jor-el Thomas Caparas,0,0,36,36
1657005343007,MATH 20C,A01,083760,Briones; Jor-el Thomas Caparas,1,0,35,34
1657005343007,MATH 20C,A02,083761,Briones; Jor-el Thomas Caparas,8,0,35,27
1657005343007,MATH 20C,A03,093476,Briones; Jor-el Thomas Caparas,0,1,36,36
1657005343007,MATH 20C,B01,083762,Bach; Quang Tran,0,0,30,30
1657005349037,MATH 20D,A01,083765,Tran; Brian Kha,4,0,30,26
1657005349037,MATH 20D,A02,083766,Tran; Brian Kha,5,0,30,25
1657005349037,MATH 20D,A03,083767,Tran; Brian Kha,3,0,30,27
1657005355061,MATH 20E,A01,083771,Ganguly; Soumya,5,0,32,27
1657005355061,MATH 20E,A02,083772,Ganguly; Soumya,6,0,32,26
1657005355061,MATH 20E,B01,083773,Ciotti; Benjamin,18,0,35,17
1657005355061,MATH 20E,B02,083774,Ciotti; Benjamin,17,0,35,18
1657005361097,MATH 103A,A01,083777,Greenfeld; Be'Eri,2,0,36,34
1657005361097,MATH 103A,A02,083778,Greenfeld; Be'Eri,5,0,36,31
1657005361097,MATH 103A,A03,093561,Greenfeld; Be'Eri,4,0,36,32
1657005361097,MATH 103A,B01,083779,Greenfeld; Be'Eri,6,0,36,30
1657005361097,MATH 103A,B02,083780,Greenfeld; Be'Eri,2,0,36,34
1657005361097,MATH 103A,B03,093562,Greenfeld; Be'Eri,2,0,36,34
1657005367205,MATH 105,A01,085443,Carter; Anne Toulson,14,0,35,21
1657005367205,MATH 105,A02,093477,Carter; Anne Toulson,20,0,35,15
1657005373230,MATH 109,A01,083213,Ganzberger; Geoffrey Michael,2,0,34,32
1657005373230,MATH 109,A02,083214,Ganzberger; Geoffrey Michael,2,0,34,32
1657005373230,MATH 109,A03,093478,Ganzberger; Geoffrey Michael,1,0,34,33
1657005373230,MATH 109,B01,083215,Ganzberger; Geoffrey Michael,1,0,32,31
1657005373230,MATH 109,B02,083216,Ganzberger; Geoffrey Michael,1,0,32,31
1657005373230,MATH 109,B03,093479,Ganzberger; Geoffrey Michael,6,0,32,26
1657005379261,MATH 142A,A01,083219,Chow; Bennett,6,0,32,26
1657005379261,MATH 142A,A02,083220,Chow; Bennett,10,0,32,22
1657005379261,MATH 142A,A03,093480,Chow; Bennett,7,0,32,25
1657005379261,MATH 142A,B03,093481,Chow; Bennett,7,0,32,25
1657005379261,MATH 142A,B04,093558,Chow; Bennett,11,0,32,21
1657005379261,MATH 142A,B05,093559,Chow; Bennett,6,0,32,26
1657005385285,MATH 193A,A01,083224,Rotar; Vladimir,7,0,34,27
1657005385285,MATH 193A,A02,083225,Rotar; Vladimir,4,0,34,30
1657005385285,MATH 193A,A03,083781,Rotar; Vladimir,1,0,34,33
1657005385285,MATH 193A,A04,083782,Rotar; Vladimir,6,0,34,28
1657005385285,MATH 193A,A05,093482,Rotar; Vladimir,6,0,34,28
1657005391311,MATH 197,001,091859,McAuley; Julian John,9999,0,9999,0
1657005391311,MATH 197,002,095566,Kedlaya; Kiran S.,9997,0,9999,2
1657005391311,MATH 197,003,095567,Xiao; Ming,9999,0,9999,0
1657005391311,MATH 197,004,095571,Perols; Johan Lars,9998,0,9999,1
1657005398365,COGS 9,A01,083615,Shannon; Kyle Michael,7,0,75,68
1657005404388,COGS 11,A01,083617,Boyle; Mary E. T.,20,0,48,28
1657005410417,COGS 13,A01,083071,Bastos; Amalia Pinkusfeld,9,0,71,62
1657005416442,COGS 14A,A01,092681,Semenuks; Arturs,0,1,100,100
1657005422488,COGS 14B,A01,083073,Cheng; Tzu-Han,5,0,63,58
1657005428511,COGS 17,A01,092677,Semenuks; Arturs,4,0,81,77
1657005434543,COGS 100,A01,083619,Allen; Michael Gordon,15,0,70,55
1657005440567,COGS 101A,A01,083621,Davis; Joshua Daniel,9,0,68,59
1657005446598,COGS 101B,A01,091572,Allen; Michael Gordon,8,0,65,57
1657005452628,COGS 101C,A01,083625,Delgado; Tania,17,0,35,18
1657005458658,COGS 107A,A01,083627,Boyle; Mary E. T.,13,0,60,47
1657005464753,COGS 118A,A01,083075,Gupta; Anjum,15,0,76,61
1657005470779,CSE 3,A50,083646,Miranda; Gregory Joseph,22,0,50,28
1657005476803,CSE 8A,A50,083650,Miranda; Gregory Joseph,17,1,56,39
1657005482826,CSE 11,A01,083080,Cao; Yingjun,4,15,40,36
1657005488855,CSE 12,A01,083652,Krause-Levy; Sophia Louisa,21,1,120,99
1657005494884,CSE 15L,A01,083654,Morris; Justin Loren,8,0,50,42
1657005494884,CSE 15L,A02,083655,Morris; Justin Loren,9,0,50,41
1657005500943,CSE 20,A01,083657,Tran; Khoa Dang,37,0,80,43
1657005506974,CSE 21,A01,095574,Bach; Quang Tran,21,0,48,27
1657005512998,CSE 30,A01,083084,Eldon; John,4,0,80,76
1657005512998,CSE 30,B01,095061,Bhaskar; Nishant,6,0,50,44
1657005519025,CSE 100,A01,083659,Cao; Yingjun,3,4,70,67
1657005525052,CSE 134B,A01,083661,Powell; Thomas Allan,19,0,100,81
1657005531075,CSE 140,A01,083663,Gungor; Onat,14,0,85,71
1657005537101,CSE 140L,A01,083088,Eldon; John,16,0,100,84
1657005543126,CSE 175,A01,083665,Kumar; Rakesh,3,0,25,22
1657005549164,CSE 190,A00,092507,Dubnov; Shlomo,7,0,20,13
1657005555189,ECE 45,A01,083139,Congero; Spencer William,5,0,75,70
1657005561214,ECE 65,A50,083695,Saad; Andrew S,12,0,30,18
1657005561214,ECE 65,A51,095125,Saad; Andrew S,25,0,26,1
1657005567244,ECE 109,A01,091882,Touri; Behrouz,16,0,70,54
1657005573269,ECE 180,A00,083140,Abi Samra; Nicholas Camill,1,0,30,29
1657005573269,ECE 180,B00,083141,Abi Samra; Nicholas Camill,0,0,30,30
1657005579296,MATH 10A,A01,083735,Patchell; Gregory David,1,0,30,29
1657005579296,MATH 10A,A02,083736,Patchell; Gregory David,20,0,30,10
1657005579296,MATH 10A,A03,083737,Patchell; Gregory David,16,0,30,14
1657005585326,MATH 10B,A01,083207,Lim; Seonhee,7,0,34,27
1657005585326,MATH 10B,A02,083208,Lim; Seonhee,9,0,35,26
1657005585326,MATH 10B,A03,093472,Lim; Seonhee,4,0,34,30
1657005585326,MATH 10B,B01,083739,Sinha; Shubham,9,0,30,21
1657005591360,MATH 18,A01,083743,Cinel; Cameron Alexander,6,0,30,24
1657005591360,MATH 18,A02,083744,Cinel; Cameron Alexander,15,0,30,15
1657005591360,MATH 18,A03,083745,Cinel; Cameron Alexander,8,0,30,22
1657005591360,MATH 18,B01,083748,Rideout; David Porter,4,0,37,33
1657005591360,MATH 18,B02,083749,Rideout; David Porter,3,0,36,33
1657005591360,MATH 18,B03,083750,Rideout; David Porter,2,0,37,35
1657005591360,MATH 18,B04,083751,Rideout; David Porter,5,0,36,31
1657005591360,MATH 18,B05,093473,Rideout; David Porter,4,0,36,32
1657005591360,MATH 18,B06,093474,Rideout; David Porter,5,0,36,31
1657005597383,MATH 20A,A01,083754,Zheng; Zequn,12,0,40,28
1657005603413,MATH 20B,A01,083756,Briones; Jor-el Thomas Caparas,1,0,36,35
1657005603413,MATH 20B,A02,083757,Briones; Jor-el Thomas Caparas,1,0,36,35
1657005603413,MATH 20B,A03,093475,Briones; Jor-el Thomas Caparas,0,0,36,36
1657005609438,MATH 20C,A01,083760,Briones; Jor-el Thomas Caparas,1,0,35,34
1657005609438,MATH 20C,A02,083761,Briones; Jor-el Thomas Caparas,8,0,35,27
1657005609438,MATH 20C,A03,093476,Briones; Jor-el Thomas Caparas,0,1,36,36
1657005609438,MATH 20C,B01,083762,Bach; Quang Tran,0,0,30,30
1657005615468,MATH 20D,A01,083765,Tran; Brian Kha,4,0,30,26
1657005615468,MATH 20D,A02,083766,Tran; Brian Kha,5,0,30,25
1657005615468,MATH 20D,A03,083767,Tran; Brian Kha,3,0,30,27
1657005621493,MATH 20E,A01,083771,Ganguly; Soumya,5,0,32,27
1657005621493,MATH 20E,A02,083772,Ganguly; Soumya,6,0,32,26
1657005621493,MATH 20E,B01,083773,Ciotti; Benjamin,18,0,35,17
1657005621493,MATH 20E,B02,083774,Ciotti; Benjamin,17,0,35,18
1657005627516,MATH 103A,A01,083777,Greenfeld; Be'Eri,2,0,36,34
1657005627516,MATH 103A,A02,083778,Greenfeld; Be'Eri,5,0,36,31
1657005627516,MATH 103A,A03,093561,Greenfeld; Be'Eri,4,0,36,32
1657005627516,MATH 103A,B01,083779,Greenfeld; Be'Eri,6,0,36,30
1657005627516,MATH 103A,B02,083780,Greenfeld; Be'Eri,2,0,36,34
1657005627516,MATH 103A,B03,093562,Greenfeld; Be'Eri,2,0,36,34
1657005633541,MATH 105,A01,085443,Carter; Anne Toulson,14,0,35,21
1657005633541,MATH 105,A02,093477,Carter; Anne Toulson,20,0,35,15
1657005639579,MATH 109,A01,083213,Ganzberger; Geoffrey Michael,2,0,34,32
1657005639579,MATH 109,A02,083214,Ganzberger; Geoffrey Michael,2,0,34,32
1657005639579,MATH 109,A03,093478,Ganzberger; Geoffrey Michael,1,0,34,33
1657005639579,MATH 109,B01,083215,Ganzberger; Geoffrey Michael,1,0,32,31
1657005639579,MATH 109,B02,083216,Ganzberger; Geoffrey Michael,1,0,32,31
1657005639579,MATH 109,B03,093479,Ganzberger; Geoffrey Michael,6,0,32,26
1657005645609,MATH 142A,A01,083219,Chow; Bennett,6,0,32,26
1657005645609,MATH 142A,A02,083220,Chow; Bennett,10,0,32,22
1657005645609,MATH 142A,A03,093480,Chow; Bennett,7,0,32,25
1657005645609,MATH 142A,B03,093481,Chow; Bennett,7,0,32,25
1657005645609,MATH 142A,B04,093558,Chow; Bennett,11,0,32,21
1657005645609,MATH 142A,B05,093559,Chow; Bennett,6,0,32,26
1657005651642,MATH 193A,A01,083224,Rotar; Vladimir,7,0,34,27
1657005651642,MATH 193A,A02,083225,Rotar; Vladimir,4,0,34,30
1657005651642,MATH 193A,A03,083781,Rotar; Vladimir,1,0,34,33
1657005651642,MATH 193A,A04,083782,Rotar; Vladimir,6,0,34,28
1657005651642,MATH 193A,A05,093482,Rotar; Vladimir,6,0,34,28
1657005657666,MATH 197,001,091859,McAuley; Julian John,9999,0,9999,0
1657005657666,MATH 197,002,095566,Kedlaya; Kiran S.,9997,0,9999,2
1657005657666,MATH 197,003,095567,Xiao; Ming,9999,0,9999,0
1657005657666,MATH 197,004,095571,Perols; Johan Lars,9998,0,9999,1
1657005664722,COGS 9,A01,083615,Shannon; Kyle Michael,7,0,75,68
1657005670755,COGS 11,A01,083617,Boyle; Mary E. T.,20,0,48,28
1657005676778,COGS 13,A01,083071,Bastos; Amalia Pinkusfeld,9,0,71,62
1657005682806,COGS 14A,A01,092681,Semenuks; Arturs,0,1,100,100
1657005688834,COGS 14B,A01,083073,Cheng; Tzu-Han,5,0,63,58
1657005694861,COGS 17,A01,092677,Semenuks; Arturs,4,0,81,77
1657005700892,COGS 100,A01,083619,Allen; Michael Gordon,15,0,70,55
1657005706915,COGS 101A,A01,083621,Davis; Joshua Daniel,9,0,68,59
1657005712939,COGS 101B,A01,091572,Allen; Michael Gordon,8,0,65,57
1657005718965,COGS 101C,A01,083625,Delgado; Tania,17,0,35,18
1657005724988,COGS 107A,A01,083627,Boyle; Mary E. T.,13,0,60,47
1657005731012,COGS 118A,A01,083075,Gupta; Anjum,15,0,76,61
1657005737036,CSE 3,A50,083646,Miranda; Gregory Joseph,22,0,50,28
1657005743063,CSE 8A,A50,083650,Miranda; Gregory Joseph,17,1,56,39
1657005749087,CSE 11,A01,083080,Cao; Yingjun,4,15,40,36
1657005755112,CSE 12,A01,083652,Krause-Levy; Sophia Louisa,21,1,120,99
1657005761138,CSE 15L,A01,083654,Morris; Justin Loren,8,0,50,42
1657005761138,CSE 15L,A02,083655,Morris; Justin Loren,9,0,50,41
1657005767163,CSE 20,A01,083657,Tran; Khoa Dang,37,0,80,43
1657005773191,CSE 21,A01,095574,Bach; Quang Tran,21,0,48,27
1657005779216,CSE 30,A01,083084,Eldon; John,4,0,80,76
1657005779216,CSE 30,B01,095061,Bhaskar; Nishant,6,0,50,44
1657005785241,CSE 100,A01,083659,Cao; Yingjun,3,4,70,67
1657005791267,CSE 134B,A01,083661,Powell; Thomas Allan,19,0,100,81
1657005797296,CSE 140,A01,083663,Gungor; Onat,14,0,85,71
1657005803318,CSE 140L,A01,083088,Eldon; John,16,0,100,84
1657005809346,CSE 175,A01,083665,Kumar; Rakesh,3,0,25,22
1657005815375,CSE 190,A00,092507,Dubnov; Shlomo,7,0,20,13
1657005821399,ECE 45,A01,083139,Congero; Spencer William,5,0,75,70
1657005827427,ECE 65,A50,083695,Saad; Andrew S,12,0,30,18
1657005827427,ECE 65,A51,095125,Saad; Andrew S,25,0,26,1
1657005833450,ECE 109,A01,091882,Touri; Behrouz,16,0,70,54
1657005839475,ECE 180,A00,083140,Abi Samra; Nicholas Camill,1,0,30,29
1657005839475,ECE 180,B00,083141,Abi Samra; Nicholas Camill,0,0,30,30
1657005845504,MATH 10A,A01,083735,Patchell; Gregory David,1,0,30,29
1657005845504,MATH 10A,A02,083736,Patchell; Gregory David,20,0,30,10
1657005845504,MATH 10A,A03,083737,Patchell; Gregory David,16,0,30,14
1657005851531,MATH 10B,A01,083207,Lim; Seonhee,7,0,34,27
1657005851531,MATH 10B,A02,083208,Lim; Seonhee,9,0,35,26
1657005851531,MATH 10B,A03,093472,Lim; Seonhee,4,0,34,30
1657005851531,MATH 10B,B01,083739,Sinha; Shubham,9,0,30,21
1657005857563,MATH 18,A01,083743,Cinel; Cameron Alexander,6,0,30,24
1657005857563,MATH 18,A02,083744,Cinel; Cameron Alexander,15,0,30,15
1657005857563,MATH 18,A03,083745,Cinel; Cameron Alexander,8,0,30,22
1657005857563,MATH 18,B01,083748,Rideout; David Porter,4,0,37,33
1657005857563,MATH 18,B02,083749,Rideout; David Porter,3,0,36,33
1657005857563,MATH 18,B03,083750,Rideout; David Porter,2,0,37,35
1657005857563,MATH 18,B04,083751,Rideout; David Porter,5,0,36,31
1657005857563,MATH 18,B05,093473,Rideout; David Porter,4,0,36,32
1657005857563,MATH 18,B06,093474,Rideout; David Porter,5,0,36,31
1657005863587,MATH 20A,A01,083754,Zheng; Zequn,12,0,40,28
1657005869611,MATH 20B,A01,083756,Briones; Jor-el Thomas Caparas,1,0,36,35
1657005869611,MATH 20B,A02,083757,Briones; Jor-el Thomas Caparas,1,0,36,35
1657005869611,MATH 20B,A03,093475,Briones; Jor-el Thomas Caparas,0,0,36,36
1657005875635,MATH 20C,A01,083760,Briones; Jor-el Thomas Caparas,1,0,35,34
1657005875635,MATH 20C,A02,083761,Briones; Jor-el Thomas Caparas,8,0,35,27
1657005875635,MATH 20C,A03,093476,Briones; Jor-el Thomas Caparas,0,1,36,36
1657005875635,MATH 20C,B01,083762,Bach; Quang Tran,0,0,30,30
1657005881663,MATH 20D,A01,083765,Tran; Brian Kha,4,0,30,26
1657005881663,MATH 20D,A02,083766,Tran; Brian Kha,5,0,30,25
1657005881663,MATH 20D,A03,083767,Tran; Brian Kha,3,0,30,27
1657005887694,MATH 20E,A01,083771,Ganguly; Soumya,5,0,32,27
1657005887694,MATH 20E,A02,083772,Ganguly; Soumya,6,0,32,26
1657005887694,MATH 20E,B01,083773,Ciotti; Benjamin,18,0,35,17
1657005887694,MATH 20E,B02,083774,Ciotti; Benjamin,17,0,35,18
1657005893717,MATH 103A,A01,083777,Greenfeld; Be'Eri,2,0,36,34
1657005893717,MATH 103A,A02,083778,Greenfeld; Be'Eri,5,0,36,31
1657005893717,MATH 103A,A03,093561,Greenfeld; Be'Eri,4,0,36,32
1657005893717,MATH 103A,B01,083779,Greenfeld; Be'Eri,6,0,36,30
1657005893717,MATH 103A,B02,083780,Greenfeld; Be'Eri,2,0,36,34
1657005893717,MATH 103A,B03,093562,Greenfeld; Be'Eri,2,0,36,34
1657005899746,MATH 105,A01,085443,Carter; Anne Toulson,14,0,35,21
1657005899746,MATH 105,A02,093477,Carter; Anne Toulson,20,0,35,15
1657005905769,MATH 109,A01,083213,Ganzberger; Geoffrey Michael,2,0,34,32
1657005905769,MATH 109,A02,083214,Ganzberger; Geoffrey Michael,2,0,34,32
1657005905769,MATH 109,A03,093478,Ganzberger; Geoffrey Michael,1,0,34,33
1657005905769,MATH 109,B01,083215,Ganzberger; Geoffrey Michael,1,0,32,31
1657005905769,MATH 109,B02,083216,Ganzberger; Geoffrey Michael,1,0,32,31
1657005905769,MATH 109,B03,093479,Ganzberger; Geoffrey Michael,6,0,32,26
1657005911798,MATH 142A,A01,083219,Chow; Bennett,6,0,32,26
1657005911798,MATH 142A,A02,083220,Chow; Bennett,10,0,32,22
1657005911798,MATH 142A,A03,093480,Chow; Bennett,7,0,32,25
1657005911798,MATH 142A,B03,093481,Chow; Bennett,7,0,32,25
1657005911798,MATH 142A,B04,093558,Chow; Bennett,11,0,32,21
1657005911798,MATH 142A,B05,093559,Chow; Bennett,6,0,32,26
1657005917825,MATH 193A,A01,083224,Rotar; Vladimir,7,0,34,27
1657005917825,MATH 193A,A02,083225,Rotar; Vladimir,4,0,34,30
1657005917825,MATH 193A,A03,083781,Rotar; Vladimir,1,0,34,33
1657005917825,MATH 193A,A04,083782,Rotar; Vladimir,6,0,34,28
1657005917825,MATH 193A,A05,093482,Rotar; Vladimir,6,0,34,28
1657005923860,MATH 197,001,091859,McAuley; Julian John,9999,0,9999,0
1657005923860,MATH 197,002,095566,Kedlaya; Kiran S.,9997,0,9999,2
1657005923860,MATH 197,003,095567,Xiao; Ming,9999,0,9999,0
1657005923860,MATH 197,004,095571,Perols; Johan Lars,9998,0,9999,1
1657005930917,COGS 9,A01,083615,Shannon; Kyle Michael,7,0,75,68
1657005936944,COGS 11,A01,083617,Boyle; Mary E. T.,20,0,48,28
1657005942968,COGS 13,A01,083071,Bastos; Amalia Pinkusfeld,9,0,71,62
1657005948990,COGS 14A,A01,092681,Semenuks; Arturs,0,1,100,100
1657005955014,COGS 14B,A01,083073,Cheng; Tzu-Han,5,0,63,58
1657005961040,COGS 17,A01,092677,Semenuks; Arturs,4,0,81,77
1657005967062,COGS 100,A01,083619,Allen; Michael Gordon,15,0,70,55
1657005973086,COGS 101A,A01,083621,Davis; Joshua Daniel,9,0,68,59
1657005979110,COGS 101B,A01,091572,Allen; Michael Gordon,8,0,65,57
1657005985134,COGS 101C,A01,083625,Delgado; Tania,17,0,35,18
1657005991160,COGS 107A,A01,083627,Boyle; Mary E. T.,13,0,60,47
1657005997184,COGS 118A,A01,083075,Gupta; Anjum,15,0,76,61
1657006003211,CSE 3,A50,083646,Miranda; Gregory Joseph,22,0,50,28
1657006009235,CSE 8A,A50,083650,Miranda; Gregory Joseph,17,1,56,39
1657006015263,CSE 11,A01,083080,Cao; Yingjun,4,15,40,36
1657006021286,CSE 12,A01,083652,Krause-Levy; Sophia Louisa,21,1,120,99
1657006027310,CSE 15L,A01,083654,Morris; Justin Loren,8,0,50,42
1657006027310,CSE 15L,A02,083655,Morris; Justin Loren,9,0,50,41
1657006033338,CSE 20,A01,083657,Tran; Khoa Dang,37,0,80,43
1657006039361,CSE 21,A01,095574,Bach; Quang Tran,21,0,48,27
1657006045384,CSE 30,A01,083084,Eldon; John,4,0,80,76
1657006045384,CSE 30,B01,095061,Bhaskar; Nishant,6,0,50,44
1657006051412,CSE 100,A01,083659,Cao; Yingjun,3,4,70,67
1657006057435,CSE 134B,A01,083661,Powell; Thomas Allan,19,0,100,81
1657006063531,CSE 140,A01,083663,Gungor; Onat,14,0,85,71
1657006069555,CSE 140L,A01,083088,Eldon; John,16,0,100,84
1657006075577,CSE 175,A01,083665,Kumar; Rakesh,3,0,25,22
1657006081603,CSE 190,A00,092507,Dubnov; Shlomo,7,0,20,13
1657006087629,ECE 45,A01,083139,Congero; Spencer William,5,0,75,70
1657006093654,ECE 65,A50,083695,Saad; Andrew S,12,0,30,18
1657006093654,ECE 65,A51,095125,Saad; Andrew S,25,0,26,1
1657006099680,ECE 109,A01,091882,Touri; Behrouz,16,0,70,54
1657006105707,ECE 180,A00,083140,Abi Samra; Nicholas Camill,1,0,30,29
1657006105707,ECE 180,B00,083141,Abi Samra; Nicholas Camill,0,0,30,30
1657006111729,MATH 10A,A01,083735,Patchell; Gregory David,1,0,30,29
1657006111729,MATH 10A,A02,083736,Patchell; Gregory David,20,0,30,10
1657006111729,MATH 10A,A03,083737,Patchell; Gregory David,16,0,30,14
1657006117759,MATH 10B,A01,083207,Lim; Seonhee,7,0,34,27
1657006117759,MATH 10B,A02,083208,Lim; Seonhee,9,0,35,26
1657006117759,MATH 10B,A03,093472,Lim; Seonhee,4,0,34,30
1657006117759,MATH 10B,B01,083739,Sinha; Shubham,9,0,30,21
1657006123788,MATH 18,A01,083743,Cinel; Cameron Alexander,6,0,30,24
1657006123788,MATH 18,A02,083744,Cinel; Cameron Alexander,15,0,30,15
1657006123788,MATH 18,A03,083745,Cinel; Cameron Alexander,8,0,30,22
1657006123788,MATH 18,B01,083748,Rideout; David Porter,4,0,37,33
1657006123788,MATH 18,B02,083749,Rideout; David Porter,3,0,36,33
1657006123788,MATH 18,B03,083750,Rideout; David Porter,2,0,37,35
1657006123788,MATH 18,B04,083751,Rideout; David Porter,5,0,36,31
1657006123788,MATH 18,B05,093473,Rideout; David Porter,4,0,36,32
1657006123788,MATH 18,B06,093474,Rideout; David Porter,5,0,36,31
1657006129810,MATH 20A,A01,083754,Zheng; Zequn,12,0,40,28
1657006135838,MATH 20B,A01,083756,Briones; Jor-el Thomas Caparas,1,0,36,35
1657006135838,MATH 20B,A02,083757,Briones; Jor-el Thomas Caparas,1,0,36,35
1657006135838,MATH 20B,A03,093475,Briones; Jor-el Thomas Caparas,0,0,36,36
1657006141866,MATH 20C,A01,083760,Briones; Jor-el Thomas Caparas,1,0,35,34
1657006141866,MATH 20C,A02,083761,Briones; Jor-el Thomas Caparas,8,0,35,27
1657006141866,MATH 20C,A03,093476,Briones; Jor-el Thomas Caparas,0,1,36,36
1657006141866,MATH 20C,B01,083762,Bach; Quang Tran,0,0,30,30
1657006147893,MATH 20D,A01,083765,Tran; Brian Kha,4,0,30,26
1657006147893,MATH 20D,A02,083766,Tran; Brian Kha,5,0,30,25
1657006147893,MATH 20D,A03,083767,Tran; Brian Kha,3,0,30,27
1657006153921,MATH 20E,A01,083771,Ganguly; Soumya,5,0,32,27
1657006153921,MATH 20E,A02,083772,Ganguly; Soumya,6,0,32,26
1657006153921,MATH 20E,B01,083773,Ciotti; Benjamin,18,0,35,17
1657006153921,MATH 20E,B02,083774,Ciotti; Benjamin,17,0,35,18
1657006159952,MATH 103A,A01,083777,Greenfeld; Be'Eri,2,0,36,34
1657006159952,MATH 103A,A02,083778,Greenfeld; Be'Eri,5,0,36,31
1657006159952,MATH 103A,A03,093561,Greenfeld; Be'Eri,4,0,36,32
1657006159952,MATH 103A,B01,083779,Greenfeld; Be'Eri,6,0,36,30
1657006159952,MATH 103A,B02,083780,Greenfeld; Be'Eri,2,0,36,34
1657006159952,MATH 103A,B03,093562,Greenfeld; Be'Eri,2,0,36,34
1657006165976,MATH 105,A01,085443,Carter; Anne Toulson,14,0,35,21
1657006165976,MATH 105,A02,093477,Carter; Anne Toulson,20,0,35,15
1657006172004,MATH 109,A01,083213,Ganzberger; Geoffrey Michael,2,0,34,32
1657006172004,MATH 109,A02,083214,Ganzberger; Geoffrey Michael,2,0,34,32
1657006172004,MATH 109,A03,093478,Ganzberger; Geoffrey Michael,1,0,34,33
1657006172004,MATH 109,B01,083215,Ganzberger; Geoffrey Michael,1,0,32,31
1657006172004,MATH 109,B02,083216,Ganzberger; Geoffrey Michael,1,0,32,31
1657006172004,MATH 109,B03,093479,Ganzberger; Geoffrey Michael,6,0,32,26
1657006178029,MATH 142A,A01,083219,Chow; Bennett,6,0,32,26
1657006178029,MATH 142A,A02,083220,Chow; Bennett,10,0,32,22
1657006178029,MATH 142A,A03,093480,Chow; Bennett,7,0,32,25
1657006178029,MATH 142A,B03,093481,Chow; Bennett,7,0,32,25
1657006178029,MATH 142A,B04,093558,Chow; Bennett,11,0,32,21
1657006178029,MATH 142A,B05,093559,Chow; Bennett,6,0,32,26
1657006184057,MATH 193A,A01,083224,Rotar; Vladimir,7,0,34,27
1657006184057,MATH 193A,A02,083225,Rotar; Vladimir,4,0,34,30
1657006184057,MATH 193A,A03,083781,Rotar; Vladimir,1,0,34,33
1657006184057,MATH 193A,A04,083782,Rotar; Vladimir,6,0,34,28
1657006184057,MATH 193A,A05,093482,Rotar; Vladimir,6,0,34,28
1657006190081,MATH 197,001,091859,McAuley; Julian John,9999,0,9999,0
1657006190081,MATH 197,002,095566,Kedlaya; Kiran S.,9997,0,9999,2
1657006190081,MATH 197,003,095567,Xiao; Ming,9999,0,9999,0
1657006190081,MATH 197,004,095571,Perols; Johan Lars,9998,0,9999,1
1657006197142,COGS 9,A01,083615,Shannon; Kyle Michael,7,0,75,68
1657006203166,COGS 11,A01,083617,Boyle; Mary E. T.,20,0,48,28
1657006209190,COGS 13,A01,083071,Bastos; Amalia Pinkusfeld,9,0,71,62
1657006215214,COGS 14A,A01,092681,Semenuks; Arturs,0,1,100,100
1657006221237,COGS 14B,A01,083073,Cheng; Tzu-Han,5,0,63,58
1657006227263,COGS 17,A01,092677,Semenuks; Arturs,4,0,81,77
1657006233289,COGS 100,A01,083619,Allen; Michael Gordon,15,0,70,55
1657006239315,COGS 101A,A01,083621,Davis; Joshua Daniel,9,0,68,59
1657006245342,COGS 101B,A01,091572,Allen; Michael Gordon,8,0,65,57
1657006251367,COGS 101C,A01,083625,Delgado; Tania,17,0,35,18
1657006257390,COGS 107A,A01,083627,Boyle; Mary E. T.,13,0,60,47
1657006263414,COGS 118A,A01,083075,Gupta; Anjum,15,0,76,61
1657006269437,CSE 3,A50,083646,Miranda; Gregory Joseph,22,0,50,28
1657006275461,CSE 8A,A50,083650,Miranda; Gregory Joseph,17,1,56,39
1657006281492,CSE 11,A01,083080,Cao; Yingjun,4,15,40,36
1657006287520,CSE 12,A01,083652,Krause-Levy; Sophia Louisa,21,1,120,99
1657006293546,CSE 15L,A01,083654,Morris; Justin Loren,8,0,50,42
1657006293546,CSE 15L,A02,083655,Morris; Justin Loren,9,0,50,41
1657006299572,CSE 20,A01,083657,Tran; Khoa Dang,37,0,80,43
1657006305596,CSE 21,A01,095574,Bach; Quang Tran,21,0,48,27
1657006311621,CSE 30,A01,083084,Eldon; John,4,0,80,76
1657006311621,CSE 30,B01,095061,Bhaskar; Nishant,6,0,50,44
1657006317650,CSE 100,A01,083659,Cao; Yingjun,3,4,70,67
1657006323682,CSE 134B,A01,083661,Powell; Thomas Allan,19,0,100,81
1657006329708,CSE 140,A01,083663,Gungor; Onat,14,0,85,71
1657006335732,CSE 140L,A01,083088,Eldon; John,16,0,100,84
1657006341762,CSE 175,A01,083665,Kumar; Rakesh,3,0,25,22
1657006347787,CSE 190,A00,092507,Dubnov; Shlomo,7,0,20,13
1657006353817,ECE 45,A01,083139,Congero; Spencer William,5,0,75,70
1657006359850,ECE 65,A50,083695,Saad; Andrew S,12,0,30,18
1657006359850,ECE 65,A51,095125,Saad; Andrew S,25,0,26,1
1657006365879,ECE 109,A01,091882,Touri; Behrouz,16,0,70,54
1657006371912,ECE 180,A00,083140,Abi Samra; Nicholas Camill,1,0,30,29
1657006371912,ECE 180,B00,083141,Abi Samra; Nicholas Camill,0,0,30,30
1657006377936,MATH 10A,A01,083735,Patchell; Gregory David,1,0,30,29
1657006377936,MATH 10A,A02,083736,Patchell; Gregory David,20,0,30,10
1657006377936,MATH 10A,A03,083737,Patchell; Gregory David,16,0,30,14
1657006383975,MATH 10B,A01,083207,Lim; Seonhee,7,0,34,27
1657006383975,MATH 10B,A02,083208,Lim; Seonhee,9,0,35,26
1657006383975,MATH 10B,A03,093472,Lim; Seonhee,4,0,34,30
1657006383975,MATH 10B,B01,083739,Sinha; Shubham,9,0,30,21
1657006390004,MATH 18,A01,083743,Cinel; Cameron Alexander,6,0,30,24
1657006390004,MATH 18,A02,083744,Cinel; Cameron Alexander,15,0,30,15
1657006390004,MATH 18,A03,083745,Cinel; Cameron Alexander,8,0,30,22
1657006390004,MATH 18,B01,083748,Rideout; David Porter,4,0,37,33
1657006390004,MATH 18,B02,083749,Rideout; David Porter,3,0,36,33
1657006390004,MATH 18,B03,083750,Rideout; David Porter,2,0,37,35
1657006390004,MATH 18,B04,083751,Rideout; David Porter,5,0,36,31
1657006390004,MATH 18,B05,093473,Rideout; David Porter,4,0,36,32
1657006390004,MATH 18,B06,093474,Rideout; David Porter,5,0,36,31
1657006396027,MATH 20A,A01,083754,Zheng; Zequn,12,0,40,28
1657006402060,MATH 20B,A01,083756,Briones; Jor-el Thomas Caparas,1,0,36,35
1657006402060,MATH 20B,A02,083757,Briones; Jor-el Thomas Caparas,1,0,36,35
1657006402060,MATH 20B,A03,093475,Briones; Jor-el Thomas Caparas,0,0,36,36
1657006408096,MATH 20C,A01,083760,Briones; Jor-el Thomas Caparas,1,0,35,34
1657006408096,MATH 20C,A02,083761,Briones; Jor-el Thomas Caparas,8,0,35,27
1657006408096,MATH 20C,A03,093476,Briones; Jor-el Thomas Caparas,0,1,36,36
1657006408096,MATH 20C,B01,083762,Bach; Quang Tran,0,0,30,30
1657006414127,MATH 20D,A01,083765,Tran; Brian Kha,4,0,30,26
1657006414127,MATH 20D,A02,083766,Tran; Brian Kha,5,0,30,25
1657006414127,MATH 20D,A03,083767,Tran; Brian Kha,3,0,30,27
1657006420164,MATH 20E,A01,083771,Ganguly; Soumya,5,0,32,27
1657006420164,MATH 20E,A02,083772,Ganguly; Soumya,6,0,32,26
1657006420164,MATH 20E,B01,083773,Ciotti; Benjamin,18,0,35,17
1657006420164,MATH 20E,B02,083774,Ciotti; Benjamin,17,0,35,18
1657006426190,MATH 103A,A01,083777,Greenfeld; Be'Eri,2,0,36,34
1657006426190,MATH 103A,A02,083778,Greenfeld; Be'Eri,5,0,36,31
1657006426190,MATH 103A,A03,093561,Greenfeld; Be'Eri,4,0,36,32
1657006426190,MATH 103A,B01,083779,Greenfeld; Be'Eri,6,0,36,30
1657006426190,MATH 103A,B02,083780,Greenfeld; Be'Eri,2,0,36,34
1657006426190,MATH 103A,B03,093562,Greenfeld; Be'Eri,2,0,36,34
1657006432215,MATH 105,A01,085443,Carter; Anne Toulson,14,0,35,21
1657006432215,MATH 105,A02,093477,Carter; Anne Toulson,20,0,35,15
1657006438238,MATH 109,A01,083213,Ganzberger; Geoffrey Michael,2,0,34,32
1657006438238,MATH 109,A02,083214,Ganzberger; Geoffrey Michael,2,0,34,32
1657006438238,MATH 109,A03,093478,Ganzberger; Geoffrey Michael,1,0,34,33
1657006438238,MATH 109,B01,083215,Ganzberger; Geoffrey Michael,1,0,32,31
1657006438238,MATH 109,B02,083216,Ganzberger; Geoffrey Michael,1,0,32,31
1657006438238,MATH 109,B03,093479,Ganzberger; Geoffrey Michael,6,0,32,26
1657006444267,MATH 142A,A01,083219,Chow; Bennett,6,0,32,26
1657006444267,MATH 142A,A02,083220,Chow; Bennett,10,0,32,22
1657006444267,MATH 142A,A03,093480,Chow; Bennett,7,0,32,25
1657006444267,MATH 142A,B03,093481,Chow; Bennett,7,0,32,25
1657006444267,MATH 142A,B04,093558,Chow; Bennett,11,0,32,21
1657006444267,MATH 142A,B05,093559,Chow; Bennett,6,0,32,26
1657006450293,MATH 193A,A01,083224,Rotar; Vladimir,7,0,34,27
1657006450293,MATH 193A,A02,083225,Rotar; Vladimir,4,0,34,30
1657006450293,MATH 193A,A03,083781,Rotar; Vladimir,1,0,34,33
1657006450293,MATH 193A,A04,083782,Rotar; Vladimir,6,0,34,28
1657006450293,MATH 193A,A05,093482,Rotar; Vladimir,6,0,34,28
1657006456321,MATH 197,001,091859,McAuley; Julian John,9999,0,9999,0
1657006456321,MATH 197,002,095566,Kedlaya; Kiran S.,9997,0,9999,2
1657006456321,MATH 197,003,095567,Xiao; Ming,9999,0,9999,0
1657006456321,MATH 197,004,095571,Perols; Johan Lars,9998,0,9999,1
1657006463380,COGS 9,A01,083615,Shannon; Kyle Michael,7,0,75,68
1657006469409,COGS 11,A01,083617,Boyle; Mary E. T.,20,0,48,28
1657006475436,COGS 13,A01,083071,Bastos; Amalia Pinkusfeld,9,0,71,62
1657006481463,COGS 14A,A01,092681,Semenuks; Arturs,0,1,100,100
1657006487494,COGS 14B,A01,083073,Cheng; Tzu-Han,5,0,63,58
1657006493522,COGS 17,A01,092677,Semenuks; Arturs,4,0,81,77
1657006499543,COGS 100,A01,083619,Allen; Michael Gordon,15,0,70,55
1657006505567,COGS 101A,A01,083621,Davis; Joshua Daniel,9,0,68,59
1657006511591,COGS 101B,A01,091572,Allen; Michael Gordon,8,0,65,57
1657006517618,COGS 101C,A01,083625,Delgado; Tania,17,0,35,18
1657006523643,COGS 107A,A01,083627,Boyle; Mary E. T.,13,0,60,47
1657006529666,COGS 118A,A01,083075,Gupta; Anjum,15,0,76,61
1657006535692,CSE 3,A50,083646,Miranda; Gregory Joseph,22,0,50,28
1657006541719,CSE 8A,A50,083650,Miranda; Gregory Joseph,17,1,56,39
1657006547748,CSE 11,A01,083080,Cao; Yingjun,4,15,40,36
1657006553777,CSE 12,A01,083652,Krause-Levy; Sophia Louisa,21,1,120,99
1657006559806,CSE 15L,A01,083654,Morris; Justin Loren,8,0,50,42
1657006559806,CSE 15L,A02,083655,Morris; Justin Loren,9,0,50,41
1657006565834,CSE 20,A01,083657,Tran; Khoa Dang,37,0,80,43
1657006571862,CSE 21,A01,095574,Bach; Quang Tran,21,0,48,27
1657006577905,CSE 30,A01,083084,Eldon; John,4,0,80,76
1657006577905,CSE 30,B01,095061,Bhaskar; Nishant,6,0,50,44
1657006583930,CSE 100,A01,083659,Cao; Yingjun,3,4,70,67
1657006589953,CSE 134B,A01,083661,Powell; Thomas Allan,19,0,100,81
1657006595982,CSE 140,A01,083663,Gungor; Onat,14,0,85,71
1657006602011,CSE 140L,A01,083088,Eldon; John,16,0,100,84
1657006608038,CSE 175,A01,083665,Kumar; Rakesh,3,0,25,22
1657006614065,CSE 190,A00,092507,Dubnov; Shlomo,7,0,20,13
1657006620098,ECE 45,A01,083139,Congero; Spencer William,5,0,75,70
1657006626124,ECE 65,A50,083695,Saad; Andrew S,12,0,30,18
1657006626124,ECE 65,A51,095125,Saad; Andrew S,25,0,26,1
1657006632150,ECE 109,A01,091882,Touri; Behrouz,16,0,70,54
1657006638178,ECE 180,A00,083140,Abi Samra; Nicholas Camill,1,0,30,29
1657006638178,ECE 180,B00,083141,Abi Samra; Nicholas Camill,0,0,30,30
1657006644209,MATH 10A,A01,083735,Patchell; Gregory David,1,0,30,29
1657006644209,MATH 10A,A02,083736,Patchell; Gregory David,20,0,30,10
1657006644209,MATH 10A,A03,083737,Patchell; Gregory David,16,0,30,14
1657006650239,MATH 10B,A01,083207,Lim; Seonhee,7,0,34,27
1657006650239,MATH 10B,A02,083208,Lim; Seonhee,9,0,35,26
1657006650239,MATH 10B,A03,093472,Lim; Seonhee,4,0,34,30
1657006650239,MATH 10B,B01,083739,Sinha; Shubham,9,0,30,21
1657006656265,MATH 18,A01,083743,Cinel; Cameron Alexander,6,0,30,24
1657006656265,MATH 18,A02,083744,Cinel; Cameron Alexander,15,0,30,15
1657006656265,MATH 18,A03,083745,Cinel; Cameron Alexander,8,0,30,22
1657006656265,MATH 18,B01,083748,Rideout; David Porter,4,0,37,33
1657006656265,MATH 18,B02,083749,Rideout; David Porter,3,0,36,33
1657006656265,MATH 18,B03,083750,Rideout; David Porter,2,0,37,35
1657006656265,MATH 18,B04,083751,Rideout; David Porter,5,0,36,31
1657006656265,MATH 18,B05,093473,Rideout; David Porter,4,0,36,32
1657006656265,MATH 18,B06,093474,Rideout; David Porter,5,0,36,31
1657006662362,MATH 20A,A01,083754,Zheng; Zequn,12,0,40,28
1657006668387,MATH 20B,A01,083756,Briones; Jor-el Thomas Caparas,1,0,36,35
1657006668387,MATH 20B,A02,083757,Briones; Jor-el Thomas Caparas,1,0,36,35
1657006668387,MATH 20B,A03,093475,Briones; Jor-el Thomas Caparas,0,0,36,36
1657006674417,MATH 20C,A01,083760,Briones; Jor-el Thomas Caparas,1,0,35,34
1657006674417,MATH 20C,A02,083761,Briones; Jor-el Thomas Caparas,8,0,35,27
1657006674417,MATH 20C,A03,093476,Briones; Jor-el Thomas Caparas,0,1,36,36
1657006674417,MATH 20C,B01,083762,Bach; Quang Tran,0,0,30,30
1657006680446,MATH 20D,A01,083765,Tran; Brian Kha,4,0,30,26
1657006680446,MATH 20D,A02,083766,Tran; Brian Kha,5,0,30,25
1657006680446,MATH 20D,A03,083767,Tran; Brian Kha,3,0,30,27
1657006686477,MATH 20E,A01,083771,Ganguly; Soumya,5,0,32,27
1657006686477,MATH 20E,A02,083772,Ganguly; Soumya,6,0,32,26
1657006686477,MATH 20E,B01,083773,Ciotti; Benjamin,18,0,35,17
1657006686477,MATH 20E,B02,083774,Ciotti; Benjamin,17,0,35,18
1657006692502,MATH 103A,A01,083777,Greenfeld; Be'Eri,2,0,36,34
1657006692502,MATH 103A,A02,083778,Greenfeld; Be'Eri,5,0,36,31
1657006692502,MATH 103A,A03,093561,Greenfeld; Be'Eri,4,0,36,32
1657006692502,MATH 103A,B01,083779,Greenfeld; Be'Eri,6,0,36,30
1657006692502,MATH 103A,B02,083780,Greenfeld; Be'Eri,2,0,36,34
1657006692502,MATH 103A,B03,093562,Greenfeld; Be'Eri,2,0,36,34
1657006698526,MATH 105,A01,085443,Carter; Anne Toulson,14,0,35,21
1657006698526,MATH 105,A02,093477,Carter; Anne Toulson,20,0,35,15
1657006704550,MATH 109,A01,083213,Ganzberger; Geoffrey Michael,2,0,34,32
1657006704550,MATH 109,A02,083214,Ganzberger; Geoffrey Michael,2,0,34,32
1657006704550,MATH 109,A03,093478,Ganzberger; Geoffrey Michael,1,0,34,33
1657006704550,MATH 109,B01,083215,Ganzberger; Geoffrey Michael,1,0,32,31
1657006704550,MATH 109,B02,083216,Ganzberger; Geoffrey Michael,1,0,32,31
1657006704550,MATH 109,B03,093479,Ganzberger; Geoffrey Michael,6,0,32,26
1657006710576,MATH 142A,A01,083219,Chow; Bennett,6,0,32,26
1657006710576,MATH 142A,A02,083220,Chow; Bennett,10,0,32,22
1657006710576,MATH 142A,A03,093480,Chow; Bennett,7,0,32,25
1657006710576,MATH 142A,B03,093481,Chow; Bennett,7,0,32,25
1657006710576,MATH 142A,B04,093558,Chow; Bennett,11,0,32,21
1657006710576,MATH 142A,B05,093559,Chow; Bennett,6,0,32,26
1657006716601,MATH 193A,A01,083224,Rotar; Vladimir,7,0,34,27
1657006716601,MATH 193A,A02,083225,Rotar; Vladimir,4,0,34,30
1657006716601,MATH 193A,A03,083781,Rotar; Vladimir,1,0,34,33
1657006716601,MATH 193A,A04,083782,Rotar; Vladimir,6,0,34,28
1657006716601,MATH 193A,A05,093482,Rotar; Vladimir,6,0,34,28
1657006722625,MATH 197,001,091859,McAuley; Julian John,9999,0,9999,0
1657006722625,MATH 197,002,095566,Kedlaya; Kiran S.,9997,0,9999,2
1657006722625,MATH 197,003,095567,Xiao; Ming,9999,0,9999,0
1657006722625,MATH 197,004,095571,Perols; Johan Lars,9998,0,9999,1
1657006729685,COGS 9,A01,083615,Shannon; Kyle Michael,7,0,75,68
1657006735713,COGS 11,A01,083617,Boyle; Mary E. T.,20,0,48,28
1657006741737,COGS 13,A01,083071,Bastos; Amalia Pinkusfeld,9,0,71,62
1657006747765,COGS 14A,A01,092681,Semenuks; Arturs,0,1,100,100
1657006753789,COGS 14B,A01,083073,Cheng; Tzu-Han,5,0,63,58
1657006759822,COGS 17,A01,092677,Semenuks; Arturs,4,0,81,77
1657006765852,COGS 100,A01,083619,Allen; Michael Gordon,15,0,70,55
1657006771880,COGS 101A,A01,083621,Davis; Joshua Daniel,9,0,68,59
1657006777911,COGS 101B,A01,091572,Allen; Michael Gordon,8,0,65,57
1657006783936,COGS 101C,A01,083625,Delgado; Tania,17,0,35,18
1657006789963,COGS 107A,A01,083627,Boyle; Mary E. T.,13,0,60,47
1657006795986,COGS 118A,A01,083075,Gupta; Anjum,15,0,76,61
1657006802015,CSE 3,A50,083646,Miranda; Gregory Joseph,22,0,50,28
1657006808043,CSE 8A,A50,083650,Miranda; Gregory Joseph,17,1,56,39
1657006814069,CSE 11,A01,083080,Cao; Yingjun,4,15,40,36
1657006820097,CSE 12,A01,083652,Krause-Levy; Sophia Louisa,21,1,120,99
1657006826121,CSE 15L,A01,083654,Morris; Justin Loren,8,0,50,42
1657006826121,CSE 15L,A02,083655,Morris; Justin Loren,9,0,50,41
1657006832146,CSE 20,A01,083657,Tran; Khoa Dang,37,0,80,43
1657006838181,CSE 21,A01,095574,Bach; Quang Tran,21,0,48,27
1657006844206,CSE 30,A01,083084,Eldon; John,4,0,80,76
1657006844206,CSE 30,B01,095061,Bhaskar; Nishant,6,0,50,44
1657006850229,CSE 100,A01,083659,Cao; Yingjun,3,4,70,67
1657006856253,CSE 134B,A01,083661,Powell; Thomas Allan,19,0,100,81
1657006862278,CSE 140,A01,083663,Gungor; Onat,14,0,85,71
1657006868316,CSE 140L,A01,083088,Eldon; John,16,0,100,84
1657006874342,CSE 175,A01,083665,Kumar; Rakesh,3,0,25,22
1657006880371,CSE 190,A00,092507,Dubnov; Shlomo,7,0,20,13
1657006886396,ECE 45,A01,083139,Congero; Spencer William,5,0,75,70
1657006892419,ECE 65,A50,083695,Saad; Andrew S,12,0,30,18
1657006892419,ECE 65,A51,095125,Saad; Andrew S,25,0,26,1
1657006898448,ECE 109,A01,091882,Touri; Behrouz,16,0,70,54
1657006904478,ECE 180,A00,083140,Abi Samra; Nicholas Camill,1,0,30,29
1657006904478,ECE 180,B00,083141,Abi Samra; Nicholas Camill,0,0,30,30
1657006910507,MATH 10A,A01,083735,Patchell; Gregory David,1,0,30,29
1657006910507,MATH 10A,A02,083736,Patchell; Gregory David,20,0,30,10
1657006910507,MATH 10A,A03,083737,Patchell; Gregory David,16,0,30,14
1657006916532,MATH 10B,A01,083207,Lim; Seonhee,7,0,34,27
1657006916532,MATH 10B,A02,083208,Lim; Seonhee,9,0,35,26
1657006916532,MATH 10B,A03,093472,Lim; Seonhee,4,0,34,30
1657006916532,MATH 10B,B01,083739,Sinha; Shubham,9,0,30,21
1657006922558,MATH 18,A01,083743,Cinel; Cameron Alexander,6,0,30,24
1657006922558,MATH 18,A02,083744,Cinel; Cameron Alexander,15,0,30,15
1657006922558,MATH 18,A03,083745,Cinel; Cameron Alexander,8,0,30,22
1657006922558,MATH 18,B01,083748,Rideout; David Porter,4,0,37,33
1657006922558,MATH 18,B02,083749,Rideout; David Porter,3,0,36,33
1657006922558,MATH 18,B03,083750,Rideout; David Porter,2,0,37,35
1657006922558,MATH 18,B04,083751,Rideout; David Porter,5,0,36,31
1657006922558,MATH 18,B05,093473,Rideout; David Porter,4,0,36,32
1657006922558,MATH 18,B06,093474,Rideout; David Porter,5,0,36,31
1657006928582,MATH 20A,A01,083754,Zheng; Zequn,12,0,40,28
1657006934607,MATH 20B,A01,083756,Briones; Jor-el Thomas Caparas,1,0,36,35
1657006934607,MATH 20B,A02,083757,Briones; Jor-el Thomas Caparas,1,0,36,35
1657006934607,MATH 20B,A03,093475,Briones; Jor-el Thomas Caparas,0,0,36,36
1657006940630,MATH 20C,A01,083760,Briones; Jor-el Thomas Caparas,1,0,35,34
1657006940630,MATH 20C,A02,083761,Briones; Jor-el Thomas Caparas,8,0,35,27
1657006940630,MATH 20C,A03,093476,Briones; Jor-el Thomas Caparas,0,1,36,36
1657006940630,MATH 20C,B01,083762,Bach; Quang Tran,0,0,30,30
1657006946653,MATH 20D,A01,083765,Tran; Brian Kha,4,0,30,26
1657006946653,MATH 20D,A02,083766,Tran; Brian Kha,5,0,30,25
1657006946653,MATH 20D,A03,083767,Tran; Brian Kha,3,0,30,27
1657006952679,MATH 20E,A01,083771,Ganguly; Soumya,5,0,32,27
1657006952679,MATH 20E,A02,083772,Ganguly; Soumya,6,0,32,26
1657006952679,MATH 20E,B01,083773,Ciotti; Benjamin,18,0,35,17
1657006952679,MATH 20E,B02,083774,Ciotti; Benjamin,17,0,35,18
1657006958707,MATH 103A,A01,083777,Greenfeld; Be'Eri,2,0,36,34
1657006958707,MATH 103A,A02,083778,Greenfeld; Be'Eri,5,0,36,31
1657006958707,MATH 103A,A03,093561,Greenfeld; Be'Eri,4,0,36,32
1657006958707,MATH 103A,B01,083779,Greenfeld; Be'Eri,6,0,36,30
1657006958707,MATH 103A,B02,083780,Greenfeld; Be'Eri,2,0,36,34
1657006958707,MATH 103A,B03,093562,Greenfeld; Be'Eri,2,0,36,34
1657006964736,MATH 105,A01,085443,Carter; Anne Toulson,14,0,35,21
1657006964736,MATH 105,A02,093477,Carter; Anne Toulson,20,0,35,15
1657006970761,MATH 109,A01,083213,Ganzberger; Geoffrey Michael,2,0,34,32
1657006970761,MATH 109,A02,083214,Ganzberger; Geoffrey Michael,2,0,34,32
1657006970761,MATH 109,A03,093478,Ganzberger; Geoffrey Michael,1,0,34,33
1657006970761,MATH 109,B01,083215,Ganzberger; Geoffrey Michael,1,0,32,31
1657006970761,MATH 109,B02,083216,Ganzberger; Geoffrey Michael,1,0,32,31
1657006970761,MATH 109,B03,093479,Ganzberger; Geoffrey Michael,6,0,32,26
1657006976796,MATH 142A,A01,083219,Chow; Bennett,6,0,32,26
1657006976796,MATH 142A,A02,083220,Chow; Bennett,10,0,32,22
1657006976796,MATH 142A,A03,093480,Chow; Bennett,7,0,32,25
1657006976796,MATH 142A,B03,093481,Chow; Bennett,7,0,32,25
1657006976796,MATH 142A,B04,093558,Chow; Bennett,11,0,32,21
1657006976796,MATH 142A,B05,093559,Chow; Bennett,6,0,32,26
1657006982821,MATH 193A,A01,083224,Rotar; Vladimir,7,0,34,27
1657006982821,MATH 193A,A02,083225,Rotar; Vladimir,4,0,34,30
1657006982821,MATH 193A,A03,083781,Rotar; Vladimir,1,0,34,33
1657006982821,MATH 193A,A04,083782,Rotar; Vladimir,6,0,34,28
1657006982821,MATH 193A,A05,093482,Rotar; Vladimir,6,0,34,28
1657006988851,MATH 197,001,091859,McAuley; Julian John,9999,0,9999,0
1657006988851,MATH 197,002,095566,Kedlaya; Kiran S.,9997,0,9999,2
1657006988851,MATH 197,003,095567,Xiao; Ming,9999,0,9999,0
1657006988851,MATH 197,004,095571,Perols; Johan Lars,9998,0,9999,1
1657006995929,COGS 9,A01,083615,Shannon; Kyle Michael,7,0,75,68
1657007001952,COGS 11,A01,083617,Boyle; Mary E. T.,20,0,48,28
1657007008180,COGS 13,A01,083071,Bastos; Amalia Pinkusfeld,9,0,71,62
1657007014208,COGS 14A,A01,092681,Semenuks; Arturs,0,1,100,100
1657007020233,COGS 14B,A01,083073,Cheng; Tzu-Han,5,0,63,58
1657007026265,COGS 17,A01,092677,Semenuks; Arturs,4,0,81,77
1657007032290,COGS 100,A01,083619,Allen; Michael Gordon,15,0,70,55
1657007038312,COGS 101A,A01,083621,Davis; Joshua Daniel,9,0,68,59
1657007044338,COGS 101B,A01,091572,Allen; Michael Gordon,8,0,65,57
1657007050370,COGS 101C,A01,083625,Delgado; Tania,17,0,35,18
1657007056395,COGS 107A,A01,083627,Boyle; Mary E. T.,13,0,60,47
1657007062422,COGS 118A,A01,083075,Gupta; Anjum,15,0,76,61
1657007068454,CSE 3,A50,083646,Miranda; Gregory Joseph,22,0,50,28
1657007074478,CSE 8A,A50,083650,Miranda; Gregory Joseph,17,1,56,39
1657007080505,CSE 11,A01,083080,Cao; Yingjun,4,15,40,36
1657007086528,CSE 12,A01,083652,Krause-Levy; Sophia Louisa,21,1,120,99
1657007092558,CSE 15L,A01,083654,Morris; Justin Loren,8,0,50,42
1657007092558,CSE 15L,A02,083655,Morris; Justin Loren,9,0,50,41
1657007098584,CSE 20,A01,083657,Tran; Khoa Dang,37,0,80,43
1657007104608,CSE 21,A01,095574,Bach; Quang Tran,21,0,48,27
1657007110643,CSE 30,A01,083084,Eldon; John,4,0,80,76
1657007110643,CSE 30,B01,095061,Bhaskar; Nishant,6,0,50,44
1657007116667,CSE 100,A01,083659,Cao; Yingjun,3,4,70,67
1657007122710,CSE 134B,A01,083661,Powell; Thomas Allan,19,0,100,81
1657007128747,CSE 140,A01,083663,Gungor; Onat,14,0,85,71
1657007134770,CSE 140L,A01,083088,Eldon; John,16,0,100,84
1657007140795,CSE 175,A01,083665,Kumar; Rakesh,3,0,25,22
1657007146817,CSE 190,A00,092507,Dubnov; Shlomo,7,0,20,13
1657007152841,ECE 45,A01,083139,Congero; Spencer William,5,0,75,70
1657007158873,ECE 65,A50,083695,Saad; Andrew S,12,0,30,18
1657007158873,ECE 65,A51,095125,Saad; Andrew S,25,0,26,1
1657007164898,ECE 109,A01,091882,Touri; Behrouz,16,0,70,54
1657007170928,ECE 180,A00,083140,Abi Samra; Nicholas Camill,1,0,30,29
1657007170928,ECE 180,B00,083141,Abi Samra; Nicholas Camill,0,0,30,30
1657007176954,MATH 10A,A01,083735,Patchell; Gregory David,1,0,30,29
1657007176954,MATH 10A,A02,083736,Patchell; Gregory David,20,0,30,10
1657007176954,MATH 10A,A03,083737,Patchell; Gregory David,16,0,30,14
1657007182981,MATH 10B,A01,083207,Lim; Seonhee,7,0,34,27
1657007182981,MATH 10B,A02,083208,Lim; Seonhee,9,0,35,26
1657007182981,MATH 10B,A03,093472,Lim; Seonhee,4,0,34,30
1657007182981,MATH 10B,B01,083739,Sinha; Shubham,9,0,30,21
1657007189009,MATH 18,A01,083743,Cinel; Cameron Alexander,6,0,30,24
1657007189009,MATH 18,A02,083744,Cinel; Cameron Alexander,15,0,30,15
1657007189009,MATH 18,A03,083745,Cinel; Cameron Alexander,8,0,30,22
1657007189009,MATH 18,B01,083748,Rideout; David Porter,4,0,37,33
1657007189009,MATH 18,B02,083749,Rideout; David Porter,3,0,36,33
1657007189009,MATH 18,B03,083750,Rideout; David Porter,2,0,37,35
1657007189009,MATH 18,B04,083751,Rideout; David Porter,5,0,36,31
1657007189009,MATH 18,B05,093473,Rideout; David Porter,4,0,36,32
1657007189009,MATH 18,B06,093474,Rideout; David Porter,5,0,36,31
1657007195033,MATH 20A,A01,083754,Zheng; Zequn,12,0,40,28
1657007201059,MATH 20B,A01,083756,Briones; Jor-el Thomas Caparas,1,0,36,35
1657007201059,MATH 20B,A02,083757,Briones; Jor-el Thomas Caparas,1,0,36,35
1657007201059,MATH 20B,A03,093475,Briones; Jor-el Thomas Caparas,0,0,36,36
1657007207089,MATH 20C,A01,083760,Briones; Jor-el Thomas Caparas,1,0,35,34
1657007207089,MATH 20C,A02,083761,Briones; Jor-el Thomas Caparas,8,0,35,27
1657007207089,MATH 20C,A03,093476,Briones; Jor-el Thomas Caparas,0,1,36,36
1657007207089,MATH 20C,B01,083762,Bach; Quang Tran,0,0,30,30
1657007213124,MATH 20D,A01,083765,Tran; Brian Kha,4,0,30,26
1657007213124,MATH 20D,A02,083766,Tran; Brian Kha,5,0,30,25
1657007213124,MATH 20D,A03,083767,Tran; Brian Kha,3,0,30,27
1657007219155,MATH 20E,A01,083771,Ganguly; Soumya,5,0,32,27
1657007219155,MATH 20E,A02,083772,Ganguly; Soumya,6,0,32,26
1657007219155,MATH 20E,B01,083773,Ciotti; Benjamin,18,0,35,17
1657007219155,MATH 20E,B02,083774,Ciotti; Benjamin,17,0,35,18
1657007225188,MATH 103A,A01,083777,Greenfeld; Be'Eri,2,0,36,34
1657007225188,MATH 103A,A02,083778,Greenfeld; Be'Eri,5,0,36,31
1657007225188,MATH 103A,A03,093561,Greenfeld; Be'Eri,4,0,36,32
1657007225188,MATH 103A,B01,083779,Greenfeld; Be'Eri,6,0,36,30
1657007225188,MATH 103A,B02,083780,Greenfeld; Be'Eri,2,0,36,34
1657007225188,MATH 103A,B03,093562,Greenfeld; Be'Eri,2,0,36,34
1657007231221,MATH 105,A01,085443,Carter; Anne Toulson,14,0,35,21
1657007231221,MATH 105,A02,093477,Carter; Anne Toulson,20,0,35,15
1657007237245,MATH 109,A01,083213,Ganzberger; Geoffrey Michael,2,0,34,32
1657007237245,MATH 109,A02,083214,Ganzberger; Geoffrey Michael,2,0,34,32
1657007237245,MATH 109,A03,093478,Ganzberger; Geoffrey Michael,1,0,34,33
1657007237245,MATH 109,B01,083215,Ganzberger; Geoffrey Michael,1,0,32,31
1657007237245,MATH 109,B02,083216,Ganzberger; Geoffrey Michael,1,0,32,31
1657007237245,MATH 109,B03,093479,Ganzberger; Geoffrey Michael,6,0,32,26
1657007243280,MATH 142A,A01,083219,Chow; Bennett,6,0,32,26
1657007243280,MATH 142A,A02,083220,Chow; Bennett,10,0,32,22
1657007243280,MATH 142A,A03,093480,Chow; Bennett,7,0,32,25
1657007243280,MATH 142A,B03,093481,Chow; Bennett,7,0,32,25
1657007243280,MATH 142A,B04,093558,Chow; Bennett,11,0,32,21
1657007243280,MATH 142A,B05,093559,Chow; Bennett,6,0,32,26
1657007249306,MATH 193A,A01,083224,Rotar; Vladimir,7,0,34,27
1657007249306,MATH 193A,A02,083225,Rotar; Vladimir,4,0,34,30
1657007249306,MATH 193A,A03,083781,Rotar; Vladimir,1,0,34,33
1657007249306,MATH 193A,A04,083782,Rotar; Vladimir,6,0,34,28
1657007249306,MATH 193A,A05,093482,Rotar; Vladimir,6,0,34,28
1657007255331,MATH 197,001,091859,McAuley; Julian John,9999,0,9999,0
1657007255331,MATH 197,002,095566,Kedlaya; Kiran S.,9997,0,9999,2
1657007255331,MATH 197,003,095567,Xiao; Ming,9999,0,9999,0
1657007255331,MATH 197,004,095571,Perols; Johan Lars,9998,0,9999,1
1657007262497,COGS 9,A01,083615,Shannon; Kyle Michael,7,0,75,68
1657007268527,COGS 11,A01,083617,Boyle; Mary E. T.,20,0,48,28
1657007274553,COGS 13,A01,083071,Bastos; Amalia Pinkusfeld,9,0,71,62
1657007280582,COGS 14A,A01,092681,Semenuks; Arturs,0,1,100,100
1657007286610,COGS 14B,A01,083073,Cheng; Tzu-Han,5,0,63,58
1657007292632,COGS 17,A01,092677,Semenuks; Arturs,4,0,81,77
1657007298660,COGS 100,A01,083619,Allen; Michael Gordon,15,0,70,55
1657007304685,COGS 101A,A01,083621,Davis; Joshua Daniel,9,0,68,59
1657007310709,COGS 101B,A01,091572,Allen; Michael Gordon,8,0,65,57
1657007316736,COGS 101C,A01,083625,Delgado; Tania,17,0,35,18
1657007322764,COGS 107A,A01,083627,Boyle; Mary E. T.,13,0,60,47
1657007328787,COGS 118A,A01,083075,Gupta; Anjum,15,0,76,61
1657007334817,CSE 3,A50,083646,Miranda; Gregory Joseph,22,0,50,28
1657007340843,CSE 8A,A50,083650,Miranda; Gregory Joseph,17,1,56,39
1657007346871,CSE 11,A01,083080,Cao; Yingjun,4,15,40,36
1657007352901,CSE 12,A01,083652,Krause-Levy; Sophia Louisa,21,1,120,99
1657007358925,CSE 15L,A01,083654,Morris; Justin Loren,8,0,50,42
1657007358925,CSE 15L,A02,083655,Morris; Justin Loren,9,0,50,41
1657007364969,CSE 20,A01,083657,Tran; Khoa Dang,37,0,80,43
1657007370992,CSE 21,A01,095574,Bach; Quang Tran,21,0,48,27
1657007377021,CSE 30,A01,083084,Eldon; John,4,0,80,76
1657007377021,CSE 30,B01,095061,Bhaskar; Nishant,6,0,50,44
1657007383048,CSE 100,A01,083659,Cao; Yingjun,3,4,70,67
1657007389079,CSE 134B,A01,083661,Powell; Thomas Allan,19,0,100,81
1657007395105,CSE 140,A01,083663,Gungor; Onat,14,0,85,71
1657007401130,CSE 140L,A01,083088,Eldon; John,16,0,100,84
1657007407155,CSE 175,A01,083665,Kumar; Rakesh,3,0,25,22
1657007413178,CSE 190,A00,092507,Dubnov; Shlomo,7,0,20,13
1657007419203,ECE 45,A01,083139,Congero; Spencer William,5,0,75,70
1657007425231,ECE 65,A50,083695,Saad; Andrew S,12,0,30,18
1657007425231,ECE 65,A51,095125,Saad; Andrew S,25,0,26,1
1657007431253,ECE 109,A01,091882,Touri; Behrouz,16,0,70,54
1657007437277,ECE 180,A00,083140,Abi Samra; Nicholas Camill,1,0,30,29
1657007437277,ECE 180,B00,083141,Abi Samra; Nicholas Camill,0,0,30,30
1657007443300,MATH 10A,A01,083735,Patchell; Gregory David,1,0,30,29
1657007443300,MATH 10A,A02,083736,Patchell; Gregory David,20,0,30,10
1657007443300,MATH 10A,A03,083737,Patchell; Gregory David,16,0,30,14
1657007449325,MATH 10B,A01,083207,Lim; Seonhee,7,0,34,27
1657007449325,MATH 10B,A02,083208,Lim; Seonhee,9,0,35,26
1657007449325,MATH 10B,A03,093472,Lim; Seonhee,4,0,34,30
1657007449325,MATH 10B,B01,083739,Sinha; Shubham,9,0,30,21
1657007455350,MATH 18,A01,083743,Cinel; Cameron Alexander,6,0,30,24
1657007455350,MATH 18,A02,083744,Cinel; Cameron Alexander,15,0,30,15
1657007455350,MATH 18,A03,083745,Cinel; Cameron Alexander,8,0,30,22
1657007455350,MATH 18,B01,083748,Rideout; David Porter,4,0,37,33
1657007455350,MATH 18,B02,083749,Rideout; David Porter,3,0,36,33
1657007455350,MATH 18,B03,083750,Rideout; David Porter,2,0,37,35
1657007455350,MATH 18,B04,083751,Rideout; David Porter,5,0,36,31
1657007455350,MATH 18,B05,093473,Rideout; David Porter,4,0,36,32
1657007455350,MATH 18,B06,093474,Rideout; David Porter,5,0,36,31
1657007461375,MATH 20A,A01,083754,Zheng; Zequn,12,0,40,28
1657007467399,MATH 20B,A01,083756,Briones; Jor-el Thomas Caparas,1,0,36,35
1657007467399,MATH 20B,A02,083757,Briones; Jor-el Thomas Caparas,1,0,36,35
1657007467399,MATH 20B,A03,093475,Briones; Jor-el Thomas Caparas,0,0,36,36
1657007473426,MATH 20C,A01,083760,Briones; Jor-el Thomas Caparas,1,0,35,34
1657007473426,MATH 20C,A02,083761,Briones; Jor-el Thomas Caparas,8,0,35,27
1657007473426,MATH 20C,A03,093476,Briones; Jor-el Thomas Caparas,0,1,36,36
1657007473426,MATH 20C,B01,083762,Bach; Quang Tran,0,0,30,30
1657007479450,MATH 20D,A01,083765,Tran; Brian Kha,4,0,30,26
1657007479450,MATH 20D,A02,083766,Tran; Brian Kha,5,0,30,25
1657007479450,MATH 20D,A03,083767,Tran; Brian Kha,3,0,30,27
1657007485475,MATH 20E,A01,083771,Ganguly; Soumya,5,0,32,27
1657007485475,MATH 20E,A02,083772,Ganguly; Soumya,6,0,32,26
1657007485475,MATH 20E,B01,083773,Ciotti; Benjamin,18,0,35,17
1657007485475,MATH 20E,B02,083774,Ciotti; Benjamin,17,0,35,18
1657007491506,MATH 103A,A01,083777,Greenfeld; Be'Eri,2,0,36,34
1657007491506,MATH 103A,A02,083778,Greenfeld; Be'Eri,5,0,36,31
1657007491506,MATH 103A,A03,093561,Greenfeld; Be'Eri,4,0,36,32
1657007491506,MATH 103A,B01,083779,Greenfeld; Be'Eri,6,0,36,30
1657007491506,MATH 103A,B02,083780,Greenfeld; Be'Eri,2,0,36,34
1657007491506,MATH 103A,B03,093562,Greenfeld; Be'Eri,2,0,36,34
1657007497529,MATH 105,A01,085443,Carter; Anne Toulson,14,0,35,21
1657007497529,MATH 105,A02,093477,Carter; Anne Toulson,20,0,35,15
1657007503555,MATH 109,A01,083213,Ganzberger; Geoffrey Michael,2,0,34,32
1657007503555,MATH 109,A02,083214,Ganzberger; Geoffrey Michael,2,0,34,32
1657007503555,MATH 109,A03,093478,Ganzberger; Geoffrey Michael,1,0,34,33
1657007503555,MATH 109,B01,083215,Ganzberger; Geoffrey Michael,1,0,32,31
1657007503555,MATH 109,B02,083216,Ganzberger; Geoffrey Michael,1,0,32,31
1657007503555,MATH 109,B03,093479,Ganzberger; Geoffrey Michael,6,0,32,26
1657007509581,MATH 142A,A01,083219,Chow; Bennett,6,0,32,26
1657007509581,MATH 142A,A02,083220,Chow; Bennett,10,0,32,22
1657007509581,MATH 142A,A03,093480,Chow; Bennett,7,0,32,25
1657007509581,MATH 142A,B03,093481,Chow; Bennett,7,0,32,25
1657007509581,MATH 142A,B04,093558,Chow; Bennett,11,0,32,21
1657007509581,MATH 142A,B05,093559,Chow; Bennett,6,0,32,26
1657007515605,MATH 193A,A01,083224,Rotar; Vladimir,7,0,34,27
1657007515605,MATH 193A,A02,083225,Rotar; Vladimir,4,0,34,30
1657007515605,MATH 193A,A03,083781,Rotar; Vladimir,1,0,34,33
1657007515605,MATH 193A,A04,083782,Rotar; Vladimir,6,0,34,28
1657007515605,MATH 193A,A05,093482,Rotar; Vladimir,6,0,34,28
1657007521627,MATH 197,001,091859,McAuley; Julian John,9999,0,9999,0
1657007521627,MATH 197,002,095566,Kedlaya; Kiran S.,9997,0,9999,2
1657007521627,MATH 197,003,095567,Xiao; Ming,9999,0,9999,0
1657007521627,MATH 197,004,095571,Perols; Johan Lars,9998,0,9999,1
1657007528681,COGS 9,A01,083615,Shannon; Kyle Michael,7,0,75,68
1657007534703,COGS 11,A01,083617,Boyle; Mary E. T.,20,0,48,28
1657007540729,COGS 13,A01,083071,Bastos; Amalia Pinkusfeld,9,0,71,62
1657007546754,COGS 14A,A01,092681,Semenuks; Arturs,0,1,100,100
1657007552784,COGS 14B,A01,083073,Cheng; Tzu-Han,5,0,63,58
1657007558812,COGS 17,A01,092677,Semenuks; Arturs,4,0,81,77
1657007564839,COGS 100,A01,083619,Allen; Michael Gordon,15,0,70,55
1657007570866,COGS 101A,A01,083621,Davis; Joshua Daniel,9,0,68,59
1657007576889,COGS 101B,A01,091572,Allen; Michael Gordon,8,0,65,57
1657007582916,COGS 101C,A01,083625,Delgado; Tania,17,0,35,18
1657007588940,COGS 107A,A01,083627,Boyle; Mary E. T.,13,0,60,47
1657007594964,COGS 118A,A01,083075,Gupta; Anjum,15,0,76,61
1657007600995,CSE 3,A50,083646,Miranda; Gregory Joseph,22,0,50,28
1657007607017,CSE 8A,A50,083650,Miranda; Gregory Joseph,17,1,56,39
1657007613040,CSE 11,A01,083080,Cao; Yingjun,4,15,40,36
1657007619067,CSE 12,A01,083652,Krause-Levy; Sophia Louisa,21,1,120,99
1657007625095,CSE 15L,A01,083654,Morris; Justin Loren,8,0,50,42
1657007625095,CSE 15L,A02,083655,Morris; Justin Loren,9,0,50,41
1657007631122,CSE 20,A01,083657,Tran; Khoa Dang,37,0,80,43
1657007637145,CSE 21,A01,095574,Bach; Quang Tran,21,0,48,27
1657007643169,CSE 30,A01,083084,Eldon; John,4,0,80,76
1657007643169,CSE 30,B01,095061,Bhaskar; Nishant,6,0,50,44
1657007649193,CSE 100,A01,083659,Cao; Yingjun,3,4,70,67
1657007655216,CSE 134B,A01,083661,Powell; Thomas Allan,19,0,100,81
1657007661241,CSE 140,A01,083663,Gungor; Onat,14,0,85,71
1657007667265,CSE 140L,A01,083088,Eldon; John,16,0,100,84
1657007673289,CSE 175,A01,083665,Kumar; Rakesh,3,0,25,22
1657007679312,CSE 190,A00,092507,Dubnov; Shlomo,7,0,20,13
1657007685336,ECE 45,A01,083139,Congero; Spencer William,5,0,75,70
1657007691363,ECE 65,A50,083695,Saad; Andrew S,12,0,30,18
1657007691363,ECE 65,A51,095125,Saad; Andrew S,25,0,26,1
1657007697390,ECE 109,A01,091882,Touri; Behrouz,16,0,70,54
1657007703413,ECE 180,A00,083140,Abi Samra; Nicholas Camill,1,0,30,29
1657007703413,ECE 180,B00,083141,Abi Samra; Nicholas Camill,0,0,30,30
1657007709434,MATH 10A,A01,083735,Patchell; Gregory David,1,0,30,29
1657007709434,MATH 10A,A02,083736,Patchell; Gregory David,20,0,30,10
1657007709434,MATH 10A,A03,083737,Patchell; Gregory David,16,0,30,14
1657007715468,MATH 10B,A01,083207,Lim; Seonhee,7,0,34,27
1657007715468,MATH 10B,A02,083208,Lim; Seonhee,9,0,35,26
1657007715468,MATH 10B,A03,093472,Lim; Seonhee,4,0,34,30
1657007715468,MATH 10B,B01,083739,Sinha; Shubham,9,0,30,21
1657007721498,MATH 18,A01,083743,Cinel; Cameron Alexander,6,0,30,24
1657007721498,MATH 18,A02,083744,Cinel; Cameron Alexander,15,0,30,15
1657007721498,MATH 18,A03,083745,Cinel; Cameron Alexander,8,0,30,22
1657007721498,MATH 18,B01,083748,Rideout; David Porter,4,0,37,33
1657007721498,MATH 18,B02,083749,Rideout; David Porter,3,0,36,33
1657007721498,MATH 18,B03,083750,Rideout; David Porter,2,0,37,35
1657007721498,MATH 18,B04,083751,Rideout; David Porter,5,0,36,31
1657007721498,MATH 18,B05,093473,Rideout; David Porter,4,0,36,32
1657007721498,MATH 18,B06,093474,Rideout; David Porter,5,0,36,31
1657007727525,MATH 20A,A01,083754,Zheng; Zequn,12,0,40,28
1657007733548,MATH 20B,A01,083756,Briones; Jor-el Thomas Caparas,1,0,36,35
1657007733548,MATH 20B,A02,083757,Briones; Jor-el Thomas Caparas,1,0,36,35
1657007733548,MATH 20B,A03,093475,Briones; Jor-el Thomas Caparas,0,0,36,36
1657007739571,MATH 20C,A01,083760,Briones; Jor-el Thomas Caparas,1,0,35,34
1657007739571,MATH 20C,A02,083761,Briones; Jor-el Thomas Caparas,8,0,35,27
1657007739571,MATH 20C,A03,093476,Briones; Jor-el Thomas Caparas,0,1,36,36
1657007739571,MATH 20C,B01,083762,Bach; Quang Tran,0,0,30,30
1657007745595,MATH 20D,A01,083765,Tran; Brian Kha,4,0,30,26
1657007745595,MATH 20D,A02,083766,Tran; Brian Kha,5,0,30,25
1657007745595,MATH 20D,A03,083767,Tran; Brian Kha,3,0,30,27
1657007751625,MATH 20E,A01,083771,Ganguly; Soumya,5,0,32,27
1657007751625,MATH 20E,A02,083772,Ganguly; Soumya,6,0,32,26
1657007751625,MATH 20E,B01,083773,Ciotti; Benjamin,18,0,35,17
1657007751625,MATH 20E,B02,083774,Ciotti; Benjamin,17,0,35,18
1657007757649,MATH 103A,A01,083777,Greenfeld; Be'Eri,2,0,36,34
1657007757649,MATH 103A,A02,083778,Greenfeld; Be'Eri,5,0,36,31
1657007757649,MATH 103A,A03,093561,Greenfeld; Be'Eri,4,0,36,32
1657007757649,MATH 103A,B01,083779,Greenfeld; Be'Eri,6,0,36,30
1657007757649,MATH 103A,B02,083780,Greenfeld; Be'Eri,2,0,36,34
1657007757649,MATH 103A,B03,093562,Greenfeld; Be'Eri,2,0,36,34
1657007763671,MATH 105,A01,085443,Carter; Anne Toulson,14,0,35,21
1657007763671,MATH 105,A02,093477,Carter; Anne Toulson,20,0,35,15
1657007769696,MATH 109,A01,083213,Ganzberger; Geoffrey Michael,2,0,34,32
1657007769696,MATH 109,A02,083214,Ganzberger; Geoffrey Michael,2,0,34,32
1657007769696,MATH 109,A03,093478,Ganzberger; Geoffrey Michael,1,0,34,33
1657007769696,MATH 109,B01,083215,Ganzberger; Geoffrey Michael,1,0,32,31
1657007769696,MATH 109,B02,083216,Ganzberger; Geoffrey Michael,1,0,32,31
1657007769696,MATH 109,B03,093479,Ganzberger; Geoffrey Michael,6,0,32,26
1657007775726,MATH 142A,A01,083219,Chow; Bennett,6,0,32,26
1657007775726,MATH 142A,A02,083220,Chow; Bennett,10,0,32,22
1657007775726,MATH 142A,A03,093480,Chow; Bennett,7,0,32,25
1657007775726,MATH 142A,B03,093481,Chow; Bennett,7,0,32,25
1657007775726,MATH 142A,B04,093558,Chow; Bennett,11,0,32,21
1657007775726,MATH 142A,B05,093559,Chow; Bennett,6,0,32,26
1657007781755,MATH 193A,A01,083224,Rotar; Vladimir,7,0,34,27
1657007781755,MATH 193A,A02,083225,Rotar; Vladimir,4,0,34,30
1657007781755,MATH 193A,A03,083781,Rotar; Vladimir,1,0,34,33
1657007781755,MATH 193A,A04,083782,Rotar; Vladimir,6,0,34,28
1657007781755,MATH 193A,A05,093482,Rotar; Vladimir,6,0,34,28
1657007787779,MATH 197,001,091859,McAuley; Julian John,9999,0,9999,0
1657007787779,MATH 197,002,095566,Kedlaya; Kiran S.,9997,0,9999,2
1657007787779,MATH 197,003,095567,Xiao; Ming,9999,0,9999,0
1657007787779,MATH 197,004,095571,Perols; Johan Lars,9998,0,9999,1
1657007794848,COGS 9,A01,083615,Shannon; Kyle Michael,7,0,75,68
1657007800876,COGS 11,A01,083617,Boyle; Mary E. T.,20,0,48,28
1657007806904,COGS 13,A01,083071,Bastos; Amalia Pinkusfeld,9,0,71,62
1657007812928,COGS 14A,A01,092681,Semenuks; Arturs,0,1,100,100
1657007818955,COGS 14B,A01,083073,Cheng; Tzu-Han,5,0,63,58
1657007824983,COGS 17,A01,092677,Semenuks; Arturs,4,0,81,77
1657007831009,COGS 100,A01,083619,Allen; Michael Gordon,15,0,70,55
1657007837037,COGS 101A,A01,083621,Davis; Joshua Daniel,9,0,68,59
1657007843069,COGS 101B,A01,091572,Allen; Michael Gordon,8,0,65,57
1657007849098,COGS 101C,A01,083625,Delgado; Tania,17,0,35,18
1657007855198,COGS 107A,A01,083627,Boyle; Mary E. T.,13,0,60,47
1657007861223,COGS 118A,A01,083075,Gupta; Anjum,15,0,76,61
1657007867248,CSE 3,A50,083646,Miranda; Gregory Joseph,22,0,50,28
1657007873271,CSE 8A,A50,083650,Miranda; Gregory Joseph,17,1,56,39
1657007879299,CSE 11,A01,083080,Cao; Yingjun,4,15,40,36
1657007885325,CSE 12,A01,083652,Krause-Levy; Sophia Louisa,21,1,120,99
1657007891353,CSE 15L,A01,083654,Morris; Justin Loren,8,0,50,42
1657007891353,CSE 15L,A02,083655,Morris; Justin Loren,9,0,50,41
1657007897377,CSE 20,A01,083657,Tran; Khoa Dang,37,0,80,43
1657007903403,CSE 21,A01,095574,Bach; Quang Tran,21,0,48,27
1657007909426,CSE 30,A01,083084,Eldon; John,4,0,80,76
1657007909426,CSE 30,B01,095061,Bhaskar; Nishant,6,0,50,44
1657007915450,CSE 100,A01,083659,Cao; Yingjun,3,4,70,67
1657007921473,CSE 134B,A01,083661,Powell; Thomas Allan,19,0,100,81
1657007927497,CSE 140,A01,083663,Gungor; Onat,14,0,85,71
1657007933525,CSE 140L,A01,083088,Eldon; John,16,0,100,84
1657007939554,CSE 175,A01,083665,Kumar; Rakesh,3,0,25,22
1657007945578,CSE 190,A00,092507,Dubnov; Shlomo,7,0,20,13
1657007951609,ECE 45,A01,083139,Congero; Spencer William,5,0,75,70
1657007957636,ECE 65,A50,083695,Saad; Andrew S,12,0,30,18
1657007957636,ECE 65,A51,095125,Saad; Andrew S,25,0,26,1
1657007963660,ECE 109,A01,091882,Touri; Behrouz,16,0,70,54
1657007969685,ECE 180,A00,083140,Abi Samra; Nicholas Camill,1,0,30,29
1657007969685,ECE 180,B00,083141,Abi Samra; Nicholas Camill,0,0,30,30
1657007975710,MATH 10A,A01,083735,Patchell; Gregory David,1,0,30,29
1657007975710,MATH 10A,A02,083736,Patchell; Gregory David,20,0,30,10
1657007975710,MATH 10A,A03,083737,Patchell; Gregory David,16,0,30,14
1657007981757,MATH 10B,A01,083207,Lim; Seonhee,7,0,34,27
1657007981757,MATH 10B,A02,083208,Lim; Seonhee,9,0,35,26
1657007981757,MATH 10B,A03,093472,Lim; Seonhee,4,0,34,30
1657007981757,MATH 10B,B01,083739,Sinha; Shubham,9,0,30,21
1657007987789,MATH 18,A01,083743,Cinel; Cameron Alexander,6,0,30,24
1657007987789,MATH 18,A02,083744,Cinel; Cameron Alexander,15,0,30,15
1657007987789,MATH 18,A03,083745,Cinel; Cameron Alexander,8,0,30,22
1657007987789,MATH 18,B01,083748,Rideout; David Porter,4,0,37,33
1657007987789,MATH 18,B02,083749,Rideout; David Porter,3,0,36,33
1657007987789,MATH 18,B03,083750,Rideout; David Porter,2,0,37,35
1657007987789,MATH 18,B04,083751,Rideout; David Porter,5,0,36,31
1657007987789,MATH 18,B05,093473,Rideout; David Porter,4,0,36,32
1657007987789,MATH 18,B06,093474,Rideout; David Porter,5,0,36,31
1657007993813,MATH 20A,A01,083754,Zheng; Zequn,12,0,40,28
1657007999836,MATH 20B,A01,083756,Briones; Jor-el Thomas Caparas,1,0,36,35
1657007999836,MATH 20B,A02,083757,Briones; Jor-el Thomas Caparas,1,0,36,35
1657007999836,MATH 20B,A03,093475,Briones; Jor-el Thomas Caparas,0,0,36,36
1657008005860,MATH 20C,A01,083760,Briones; Jor-el Thomas Caparas,1,0,35,34
1657008005860,MATH 20C,A02,083761,Briones; Jor-el Thomas Caparas,8,0,35,27
1657008005860,MATH 20C,A03,093476,Briones; Jor-el Thomas Caparas,0,1,36,36
1657008005860,MATH 20C,B01,083762,Bach; Quang Tran,0,0,30,30
1657008011890,MATH 20D,A01,083765,Tran; Brian Kha,4,0,30,26
1657008011890,MATH 20D,A02,083766,Tran; Brian Kha,5,0,30,25
1657008011890,MATH 20D,A03,083767,Tran; Brian Kha,3,0,30,27
1657008017915,MATH 20E,A01,083771,Ganguly; Soumya,5,0,32,27
1657008017915,MATH 20E,A02,083772,Ganguly; Soumya,6,0,32,26
1657008017915,MATH 20E,B01,083773,Ciotti; Benjamin,18,0,35,17
1657008017915,MATH 20E,B02,083774,Ciotti; Benjamin,17,0,35,18
1657008023944,MATH 103A,A01,083777,Greenfeld; Be'Eri,2,0,36,34
1657008023944,MATH 103A,A02,083778,Greenfeld; Be'Eri,5,0,36,31
1657008023944,MATH 103A,A03,093561,Greenfeld; Be'Eri,4,0,36,32
1657008023944,MATH 103A,B01,083779,Greenfeld; Be'Eri,6,0,36,30
1657008023944,MATH 103A,B02,083780,Greenfeld; Be'Eri,2,0,36,34
1657008023944,MATH 103A,B03,093562,Greenfeld; Be'Eri,2,0,36,34
1657008029970,MATH 105,A01,085443,Carter; Anne Toulson,14,0,35,21
1657008029970,MATH 105,A02,093477,Carter; Anne Toulson,20,0,35,15
1657008035996,MATH 109,A01,083213,Ganzberger; Geoffrey Michael,2,0,34,32
1657008035996,MATH 109,A02,083214,Ganzberger; Geoffrey Michael,2,0,34,32
1657008035996,MATH 109,A03,093478,Ganzberger; Geoffrey Michael,1,0,34,33
1657008035996,MATH 109,B01,083215,Ganzberger; Geoffrey Michael,1,0,32,31
1657008035996,MATH 109,B02,083216,Ganzberger; Geoffrey Michael,1,0,32,31
1657008035996,MATH 109,B03,093479,Ganzberger; Geoffrey Michael,6,0,32,26
1657008042018,MATH 142A,A01,083219,Chow; Bennett,6,0,32,26
1657008042018,MATH 142A,A02,083220,Chow; Bennett,10,0,32,22
1657008042018,MATH 142A,A03,093480,Chow; Bennett,7,0,32,25
1657008042018,MATH 142A,B03,093481,Chow; Bennett,7,0,32,25
1657008042018,MATH 142A,B04,093558,Chow; Bennett,11,0,32,21
1657008042018,MATH 142A,B05,093559,Chow; Bennett,6,0,32,26
1657008048053,MATH 193A,A01,083224,Rotar; Vladimir,7,0,34,27
1657008048053,MATH 193A,A02,083225,Rotar; Vladimir,4,0,34,30
1657008048053,MATH 193A,A03,083781,Rotar; Vladimir,1,0,34,33
1657008048053,MATH 193A,A04,083782,Rotar; Vladimir,6,0,34,28
1657008048053,MATH 193A,A05,093482,Rotar; Vladimir,6,0,34,28
1657008054103,MATH 197,001,091859,McAuley; Julian John,9999,0,9999,0
1657008054103,MATH 197,002,095566,Kedlaya; Kiran S.,9997,0,9999,2
1657008054103,MATH 197,003,095567,Xiao; Ming,9999,0,9999,0
1657008054103,MATH 197,004,095571,Perols; Johan Lars,9998,0,9999,1
1657008061172,COGS 9,A01,083615,Shannon; Kyle Michael,7,0,75,68
1657008067198,COGS 11,A01,083617,Boyle; Mary E. T.,20,0,48,28
1657008073221,COGS 13,A01,083071,Bastos; Amalia Pinkusfeld,9,0,71,62
1657008079251,COGS 14A,A01,092681,Semenuks; Arturs,0,1,100,100
1657008085274,COGS 14B,A01,083073,Cheng; Tzu-Han,5,0,63,58
1657008091304,COGS 17,A01,092677,Semenuks; Arturs,4,0,81,77
1657008097328,COGS 100,A01,083619,Allen; Michael Gordon,15,0,70,55
1657008103352,COGS 101A,A01,083621,Davis; Joshua Daniel,9,0,68,59
1657008109383,COGS 101B,A01,091572,Allen; Michael Gordon,8,0,65,57
1657008115408,COGS 101C,A01,083625,Delgado; Tania,17,0,35,18
1657008121433,COGS 107A,A01,083627,Boyle; Mary E. T.,13,0,60,47
1657008127463,COGS 118A,A01,083075,Gupta; Anjum,15,0,76,61
1657008133495,CSE 3,A50,083646,Miranda; Gregory Joseph,22,0,50,28
1657008139519,CSE 8A,A50,083650,Miranda; Gregory Joseph,17,1,56,39
1657008145542,CSE 11,A01,083080,Cao; Yingjun,4,15,40,36
1657008151566,CSE 12,A01,083652,Krause-Levy; Sophia Louisa,21,1,120,99
1657008157588,CSE 15L,A01,083654,Morris; Justin Loren,8,0,50,42
1657008157588,CSE 15L,A02,083655,Morris; Justin Loren,9,0,50,41
1657008163615,CSE 20,A01,083657,Tran; Khoa Dang,37,0,80,43
1657008169643,CSE 21,A01,095574,Bach; Quang Tran,21,0,48,27
1657008175669,CSE 30,A01,083084,Eldon; John,4,0,80,76
1657008175669,CSE 30,B01,095061,Bhaskar; Nishant,6,0,50,44
1657008181702,CSE 100,A01,083659,Cao; Yingjun,3,4,70,67
1657008187725,CSE 134B,A01,083661,Powell; Thomas Allan,19,0,100,81
1657008193765,CSE 140,A01,083663,Gungor; Onat,14,0,85,71
1657008199800,CSE 140L,A01,083088,Eldon; John,16,0,100,84
1657008205824,CSE 175,A01,083665,Kumar; Rakesh,3,0,25,22
1657008211848,CSE 190,A00,092507,Dubnov; Shlomo,7,0,20,13
1657008217871,ECE 45,A01,083139,Congero; Spencer William,5,0,75,70
1657008223896,ECE 65,A50,083695,Saad; Andrew S,12,0,30,18
1657008223896,ECE 65,A51,095125,Saad; Andrew S,25,0,26,1
1657008229924,ECE 109,A01,091882,Touri; Behrouz,16,0,70,54
1657008235953,ECE 180,A00,083140,Abi Samra; Nicholas Camill,1,0,30,29
1657008235953,ECE 180,B00,083141,Abi Samra; Nicholas Camill,0,0,30,30
1657008241978,MATH 10A,A01,083735,Patchell; Gregory David,1,0,30,29
1657008241978,MATH 10A,A02,083736,Patchell; Gregory David,20,0,30,10
1657008241978,MATH 10A,A03,083737,Patchell; Gregory David,16,0,30,14
1657008248007,MATH 10B,A01,083207,Lim; Seonhee,7,0,34,27
1657008248007,MATH 10B,A02,083208,Lim; Seonhee,9,0,35,26
1657008248007,MATH 10B,A03,093472,Lim; Seonhee,4,0,34,30
1657008248007,MATH 10B,B01,083739,Sinha; Shubham,9,0,30,21
1657008254047,MATH 18,A01,083743,Cinel; Cameron Alexander,6,0,30,24
1657008254047,MATH 18,A02,083744,Cinel; Cameron Alexander,15,0,30,15
1657008254047,MATH 18,A03,083745,Cinel; Cameron Alexander,8,0,30,22
1657008254047,MATH 18,B01,083748,Rideout; David Porter,4,0,37,33
1657008254047,MATH 18,B02,083749,Rideout; David Porter,3,0,36,33
1657008254047,MATH 18,B03,083750,Rideout; David Porter,2,0,37,35
1657008254047,MATH 18,B04,083751,Rideout; David Porter,5,0,36,31
1657008254047,MATH 18,B05,093473,Rideout; David Porter,4,0,36,32
1657008254047,MATH 18,B06,093474,Rideout; David Porter,5,0,36,31
1657008260070,MATH 20A,A01,083754,Zheng; Zequn,12,0,40,28
1657008266110,MATH 20B,A01,083756,Briones; Jor-el Thomas Caparas,1,0,36,35
1657008266110,MATH 20B,A02,083757,Briones; Jor-el Thomas Caparas,1,0,36,35
1657008266110,MATH 20B,A03,093475,Briones; Jor-el Thomas Caparas,0,0,36,36
1657008272135,MATH 20C,A01,083760,Briones; Jor-el Thomas Caparas,1,0,35,34
1657008272135,MATH 20C,A02,083761,Briones; Jor-el Thomas Caparas,8,0,35,27
1657008272135,MATH 20C,A03,093476,Briones; Jor-el Thomas Caparas,0,1,36,36
1657008272135,MATH 20C,B01,083762,Bach; Quang Tran,0,0,30,30
1657008278165,MATH 20D,A01,083765,Tran; Brian Kha,4,0,30,26
1657008278165,MATH 20D,A02,083766,Tran; Brian Kha,5,0,30,25
1657008278165,MATH 20D,A03,083767,Tran; Brian Kha,3,0,30,27
1657008284191,MATH 20E,A01,083771,Ganguly; Soumya,5,0,32,27
1657008284191,MATH 20E,A02,083772,Ganguly; Soumya,6,0,32,26
1657008284191,MATH 20E,B01,083773,Ciotti; Benjamin,18,0,35,17
1657008284191,MATH 20E,B02,083774,Ciotti; Benjamin,17,0,35,18
1657008290234,MATH 103A,A01,083777,Greenfeld; Be'Eri,2,0,36,34
1657008290234,MATH 103A,A02,083778,Greenfeld; Be'Eri,5,0,36,31
1657008290234,MATH 103A,A03,093561,Greenfeld; Be'Eri,4,0,36,32
1657008290234,MATH 103A,B01,083779,Greenfeld; Be'Eri,6,0,36,30
1657008290234,MATH 103A,B02,083780,Greenfeld; Be'Eri,2,0,36,34
1657008290234,MATH 103A,B03,093562,Greenfeld; Be'Eri,2,0,36,34
1657008296269,MATH 105,A01,085443,Carter; Anne Toulson,14,0,35,21
1657008296269,MATH 105,A02,093477,Carter; Anne Toulson,20,0,35,15
1657008302303,MATH 109,A01,083213,Ganzberger; Geoffrey Michael,2,0,34,32
1657008302303,MATH 109,A02,083214,Ganzberger; Geoffrey Michael,2,0,34,32
1657008302303,MATH 109,A03,093478,Ganzberger; Geoffrey Michael,1,0,34,33
1657008302303,MATH 109,B01,083215,Ganzberger; Geoffrey Michael,1,0,32,31
1657008302303,MATH 109,B02,083216,Ganzberger; Geoffrey Michael,1,0,32,31
1657008302303,MATH 109,B03,093479,Ganzberger; Geoffrey Michael,6,0,32,26
1657008308328,MATH 142A,A01,083219,Chow; Bennett,6,0,32,26
1657008308328,MATH 142A,A02,083220,Chow; Bennett,10,0,32,22
1657008308328,MATH 142A,A03,093480,Chow; Bennett,7,0,32,25
1657008308328,MATH 142A,B03,093481,Chow; Bennett,7,0,32,25
1657008308328,MATH 142A,B04,093558,Chow; Bennett,11,0,32,21
1657008308328,MATH 142A,B05,093559,Chow; Bennett,6,0,32,26
1657008314373,MATH 193A,A01,083224,Rotar; Vladimir,7,0,34,27
1657008314373,MATH 193A,A02,083225,Rotar; Vladimir,4,0,34,30
1657008314373,MATH 193A,A03,083781,Rotar; Vladimir,1,0,34,33
1657008314373,MATH 193A,A04,083782,Rotar; Vladimir,6,0,34,28
1657008314373,MATH 193A,A05,093482,Rotar; Vladimir,6,0,34,28
1657008320406,MATH 197,001,091859,McAuley; Julian John,9999,0,9999,0
1657008320406,MATH 197,002,095566,Kedlaya; Kiran S.,9997,0,9999,2
1657008320406,MATH 197,003,095567,Xiao; Ming,9999,0,9999,0
1657008320406,MATH 197,004,095571,Perols; Johan Lars,9998,0,9999,1
1657008327481,COGS 9,A01,083615,Shannon; Kyle Michael,7,0,75,68
1657008333513,COGS 11,A01,083617,Boyle; Mary E. T.,20,0,48,28
1657008339551,COGS 13,A01,083071,Bastos; Amalia Pinkusfeld,9,0,71,62
1657008345577,COGS 14A,A01,092681,Semenuks; Arturs,0,1,100,100
1657008351600,COGS 14B,A01,083073,Cheng; Tzu-Han,5,0,63,58
1657008357625,COGS 17,A01,092677,Semenuks; Arturs,4,0,81,77
1657008363648,COGS 100,A01,083619,Allen; Michael Gordon,15,0,70,55
1657008369672,COGS 101A,A01,083621,Davis; Joshua Daniel,9,0,68,59
1657008375699,COGS 101B,A01,091572,Allen; Michael Gordon,8,0,65,57
1657008381725,COGS 101C,A01,083625,Delgado; Tania,17,0,35,18
1657008387751,COGS 107A,A01,083627,Boyle; Mary E. T.,13,0,60,47
1657008393784,COGS 118A,A01,083075,Gupta; Anjum,15,0,76,61
1657008399809,CSE 3,A50,083646,Miranda; Gregory Joseph,22,0,50,28
1657008405837,CSE 8A,A50,083650,Miranda; Gregory Joseph,17,1,56,39
1657008411863,CSE 11,A01,083080,Cao; Yingjun,4,15,40,36
1657008417887,CSE 12,A01,083652,Krause-Levy; Sophia Louisa,21,1,120,99
1657008423914,CSE 15L,A01,083654,Morris; Justin Loren,8,0,50,42
1657008423914,CSE 15L,A02,083655,Morris; Justin Loren,9,0,50,41
1657008429943,CSE 20,A01,083657,Tran; Khoa Dang,37,0,80,43
1657008435970,CSE 21,A01,095574,Bach; Quang Tran,21,0,48,27
1657008441996,CSE 30,A01,083084,Eldon; John,4,0,80,76
1657008441996,CSE 30,B01,095061,Bhaskar; Nishant,6,0,50,44
1657008448025,CSE 100,A01,083659,Cao; Yingjun,3,4,70,67
1657008454121,CSE 134B,A01,083661,Powell; Thomas Allan,19,0,100,81
1657008460146,CSE 140,A01,083663,Gungor; Onat,14,0,85,71
1657008466182,CSE 140L,A01,083088,Eldon; John,16,0,100,84
1657008472218,CSE 175,A01,083665,Kumar; Rakesh,3,0,25,22
1657008478248,CSE 190,A00,092507,Dubnov; Shlomo,7,0,20,13
1657008484274,ECE 45,A01,083139,Congero; Spencer William,5,0,75,70
1657008490300,ECE 65,A50,083695,Saad; Andrew S,12,0,30,18
1657008490300,ECE 65,A51,095125,Saad; Andrew S,25,0,26,1
1657008496323,ECE 109,A01,091882,Touri; Behrouz,16,0,70,54
1657008502354,ECE 180,A00,083140,Abi Samra; Nicholas Camill,1,0,30,29
1657008502354,ECE 180,B00,083141,Abi Samra; Nicholas Camill,0,0,30,30
1657008508381,MATH 10A,A01,083735,Patchell; Gregory David,1,0,30,29
1657008508381,MATH 10A,A02,083736,Patchell; Gregory David,20,0,30,10
1657008508381,MATH 10A,A03,083737,Patchell; Gregory David,16,0,30,14
1657008514407,MATH 10B,A01,083207,Lim; Seonhee,7,0,34,27
1657008514407,MATH 10B,A02,083208,Lim; Seonhee,9,0,35,26
1657008514407,MATH 10B,A03,093472,Lim; Seonhee,4,0,34,30
1657008514407,MATH 10B,B01,083739,Sinha; Shubham,9,0,30,21
1657008520435,MATH 18,A01,083743,Cinel; Cameron Alexander,6,0,30,24
1657008520435,MATH 18,A02,083744,Cinel; Cameron Alexander,15,0,30,15
1657008520435,MATH 18,A03,083745,Cinel; Cameron Alexander,8,0,30,22
1657008520435,MATH 18,B01,083748,Rideout; David Porter,4,0,37,33
1657008520435,MATH 18,B02,083749,Rideout; David Porter,3,0,36,33
1657008520435,MATH 18,B03,083750,Rideout; David Porter,2,0,37,35
1657008520435,MATH 18,B04,083751,Rideout; David Porter,5,0,36,31
1657008520435,MATH 18,B05,093473,Rideout; David Porter,4,0,36,32
1657008520435,MATH 18,B06,093474,Rideout; David Porter,5,0,36,31
1657008526463,MATH 20A,A01,083754,Zheng; Zequn,12,0,40,28
1657008532490,MATH 20B,A01,083756,Briones; Jor-el Thomas Caparas,1,0,36,35
1657008532490,MATH 20B,A02,083757,Briones; Jor-el Thomas Caparas,1,0,36,35
1657008532490,MATH 20B,A03,093475,Briones; Jor-el Thomas Caparas,0,0,36,36
1657008538513,MATH 20C,A01,083760,Briones; Jor-el Thomas Caparas,1,0,35,34
1657008538513,MATH 20C,A02,083761,Briones; Jor-el Thomas Caparas,8,0,35,27
1657008538513,MATH 20C,A03,093476,Briones; Jor-el Thomas Caparas,0,1,36,36
1657008538513,MATH 20C,B01,083762,Bach; Quang Tran,0,0,30,30
1657008544545,MATH 20D,A01,083765,Tran; Brian Kha,4,0,30,26
1657008544545,MATH 20D,A02,083766,Tran; Brian Kha,5,0,30,25
1657008544545,MATH 20D,A03,083767,Tran; Brian Kha,3,0,30,27
1657008550573,MATH 20E,A01,083771,Ganguly; Soumya,5,0,32,27
1657008550573,MATH 20E,A02,083772,Ganguly; Soumya,6,0,32,26
1657008550573,MATH 20E,B01,083773,Ciotti; Benjamin,18,0,35,17
1657008550573,MATH 20E,B02,083774,Ciotti; Benjamin,17,0,35,18
1657008556607,MATH 103A,A01,083777,Greenfeld; Be'Eri,2,0,36,34
1657008556607,MATH 103A,A02,083778,Greenfeld; Be'Eri,5,0,36,31
1657008556607,MATH 103A,A03,093561,Greenfeld; Be'Eri,4,0,36,32
1657008556607,MATH 103A,B01,083779,Greenfeld; Be'Eri,6,0,36,30
1657008556607,MATH 103A,B02,083780,Greenfeld; Be'Eri,2,0,36,34
1657008556607,MATH 103A,B03,093562,Greenfeld; Be'Eri,2,0,36,34
1657008562631,MATH 105,A01,085443,Carter; Anne Toulson,14,0,35,21
1657008562631,MATH 105,A02,093477,Carter; Anne Toulson,20,0,35,15
1657008568662,MATH 109,A01,083213,Ganzberger; Geoffrey Michael,2,0,34,32
1657008568662,MATH 109,A02,083214,Ganzberger; Geoffrey Michael,2,0,34,32
1657008568662,MATH 109,A03,093478,Ganzberger; Geoffrey Michael,1,0,34,33
1657008568662,MATH 109,B01,083215,Ganzberger; Geoffrey Michael,1,0,32,31
1657008568662,MATH 109,B02,083216,Ganzberger; Geoffrey Michael,1,0,32,31
1657008568662,MATH 109,B03,093479,Ganzberger; Geoffrey Michael,6,0,32,26
1657008574695,MATH 142A,A01,083219,Chow; Bennett,6,0,32,26
1657008574695,MATH 142A,A02,083220,Chow; Bennett,10,0,32,22
1657008574695,MATH 142A,A03,093480,Chow; Bennett,7,0,32,25
1657008574695,MATH 142A,B03,093481,Chow; Bennett,7,0,32,25
1657008574695,MATH 142A,B04,093558,Chow; Bennett,11,0,32,21
1657008574695,MATH 142A,B05,093559,Chow; Bennett,6,0,32,26
1657008580726,MATH 193A,A01,083224,Rotar; Vladimir,7,0,34,27
1657008580726,MATH 193A,A02,083225,Rotar; Vladimir,4,0,34,30
1657008580726,MATH 193A,A03,083781,Rotar; Vladimir,1,0,34,33
1657008580726,MATH 193A,A04,083782,Rotar; Vladimir,6,0,34,28
1657008580726,MATH 193A,A05,093482,Rotar; Vladimir,6,0,34,28
1657008586750,MATH 197,001,091859,McAuley; Julian John,9999,0,9999,0
1657008586750,MATH 197,002,095566,Kedlaya; Kiran S.,9997,0,9999,2
1657008586750,MATH 197,003,095567,Xiao; Ming,9999,0,9999,0
1657008586750,MATH 197,004,095571,Perols; Johan Lars,9998,0,9999,1
1657008593828,COGS 9,A01,083615,Shannon; Kyle Michael,7,0,75,68
1657008599852,COGS 11,A01,083617,Boyle; Mary E. T.,20,0,48,28
1657008605875,COGS 13,A01,083071,Bastos; Amalia Pinkusfeld,9,0,71,62
1657008611904,COGS 14A,A01,092681,Semenuks; Arturs,0,1,100,100
1657008617927,COGS 14B,A01,083073,Cheng; Tzu-Han,5,0,63,58
1657008623953,COGS 17,A01,092677,Semenuks; Arturs,4,0,81,77
1657008629977,COGS 100,A01,083619,Allen; Michael Gordon,15,0,70,55
1657008636005,COGS 101A,A01,083621,Davis; Joshua Daniel,9,0,68,59
1657008642038,COGS 101B,A01,091572,Allen; Michael Gordon,8,0,65,57
1657008648062,COGS 101C,A01,083625,Delgado; Tania,17,0,35,18
1657008654084,COGS 107A,A01,083627,Boyle; Mary E. T.,13,0,60,47
1657008660114,COGS 118A,A01,083075,Gupta; Anjum,15,0,76,61
1657008666138,CSE 3,A50,083646,Miranda; Gregory Joseph,22,0,50,28
1657008672159,CSE 8A,A50,083650,Miranda; Gregory Joseph,17,1,56,39
1657008678186,CSE 11,A01,083080,Cao; Yingjun,4,15,40,36
1657008684211,CSE 12,A01,083652,Krause-Levy; Sophia Louisa,21,1,120,99
1657008690238,CSE 15L,A01,083654,Morris; Justin Loren,8,0,50,42
1657008690238,CSE 15L,A02,083655,Morris; Justin Loren,9,0,50,41
1657008696266,CSE 20,A01,083657,Tran; Khoa Dang,37,0,80,43
1657008702294,CSE 21,A01,095574,Bach; Quang Tran,21,0,48,27
1657008708323,CSE 30,A01,083084,Eldon; John,4,0,80,76
1657008708323,CSE 30,B01,095061,Bhaskar; Nishant,6,0,50,44
1657008714349,CSE 100,A01,083659,Cao; Yingjun,3,4,70,67
1657008720373,CSE 134B,A01,083661,Powell; Thomas Allan,19,0,100,81
1657008726401,CSE 140,A01,083663,Gungor; Onat,14,0,85,71
1657008732428,CSE 140L,A01,083088,Eldon; John,16,0,100,84
1657008738451,CSE 175,A01,083665,Kumar; Rakesh,3,0,25,22
1657008744475,CSE 190,A00,092507,Dubnov; Shlomo,7,0,20,13
1657008750503,ECE 45,A01,083139,Congero; Spencer William,5,0,75,70
1657008756533,ECE 65,A50,083695,Saad; Andrew S,12,0,30,18
1657008756533,ECE 65,A51,095125,Saad; Andrew S,25,0,26,1
1657008762558,ECE 109,A01,091882,Touri; Behrouz,16,0,70,54
1657008768581,ECE 180,A00,083140,Abi Samra; Nicholas Camill,1,0,30,29
1657008768581,ECE 180,B00,083141,Abi Samra; Nicholas Camill,0,0,30,30
1657008774617,MATH 10A,A01,083735,Patchell; Gregory David,1,0,30,29
1657008774617,MATH 10A,A02,083736,Patchell; Gregory David,20,0,30,10
1657008774617,MATH 10A,A03,083737,Patchell; Gregory David,16,0,30,14
1657008780643,MATH 10B,A01,083207,Lim; Seonhee,7,0,34,27
1657008780643,MATH 10B,A02,083208,Lim; Seonhee,9,0,35,26
1657008780643,MATH 10B,A03,093472,Lim; Seonhee,4,0,34,30
1657008780643,MATH 10B,B01,083739,Sinha; Shubham,9,0,30,21
1657008786668,MATH 18,A01,083743,Cinel; Cameron Alexander,6,0,30,24
1657008786668,MATH 18,A02,083744,Cinel; Cameron Alexander,15,0,30,15
1657008786668,MATH 18,A03,083745,Cinel; Cameron Alexander,8,0,30,22
1657008786668,MATH 18,B01,083748,Rideout; David Porter,4,0,37,33
1657008786668,MATH 18,B02,083749,Rideout; David Porter,3,0,36,33
1657008786668,MATH 18,B03,083750,Rideout; David Porter,2,0,37,35
1657008786668,MATH 18,B04,083751,Rideout; David Porter,5,0,36,31
1657008786668,MATH 18,B05,093473,Rideout; David Porter,4,0,36,32
1657008786668,MATH 18,B06,093474,Rideout; David Porter,5,0,36,31
1657008792692,MATH 20A,A01,083754,Zheng; Zequn,12,0,40,28
1657008798718,MATH 20B,A01,083756,Briones; Jor-el Thomas Caparas,1,0,36,35
1657008798718,MATH 20B,A02,083757,Briones; Jor-el Thomas Caparas,1,0,36,35
1657008798718,MATH 20B,A03,093475,Briones; Jor-el Thomas Caparas,0,0,36,36
1657008804741,MATH 20C,A01,083760,Briones; Jor-el Thomas Caparas,1,0,35,34
1657008804741,MATH 20C,A02,083761,Briones; Jor-el Thomas Caparas,8,0,35,27
1657008804741,MATH 20C,A03,093476,Briones; Jor-el Thomas Caparas,0,1,36,36
1657008804741,MATH 20C,B01,083762,Bach; Quang Tran,0,0,30,30
1657008810768,MATH 20D,A01,083765,Tran; Brian Kha,4,0,30,26
1657008810768,MATH 20D,A02,083766,Tran; Brian Kha,5,0,30,25
1657008810768,MATH 20D,A03,083767,Tran; Brian Kha,3,0,30,27
1657008816792,MATH 20E,A01,083771,Ganguly; Soumya,5,0,32,27
1657008816792,MATH 20E,A02,083772,Ganguly; Soumya,6,0,32,26
1657008816792,MATH 20E,B01,083773,Ciotti; Benjamin,18,0,35,17
1657008816792,MATH 20E,B02,083774,Ciotti; Benjamin,17,0,35,18
1657008822824,MATH 103A,A01,083777,Greenfeld; Be'Eri,2,0,36,34
1657008822824,MATH 103A,A02,083778,Greenfeld; Be'Eri,5,0,36,31
1657008822824,MATH 103A,A03,093561,Greenfeld; Be'Eri,4,0,36,32
1657008822824,MATH 103A,B01,083779,Greenfeld; Be'Eri,6,0,36,30
1657008822824,MATH 103A,B02,083780,Greenfeld; Be'Eri,2,0,36,34
1657008822824,MATH 103A,B03,093562,Greenfeld; Be'Eri,2,0,36,34
1657008828850,MATH 105,A01,085443,Carter; Anne Toulson,14,0,35,21
1657008828850,MATH 105,A02,093477,Carter; Anne Toulson,20,0,35,15
1657008834875,MATH 109,A01,083213,Ganzberger; Geoffrey Michael,2,0,34,32
1657008834875,MATH 109,A02,083214,Ganzberger; Geoffrey Michael,2,0,34,32
1657008834875,MATH 109,A03,093478,Ganzberger; Geoffrey Michael,1,0,34,33
1657008834875,MATH 109,B01,083215,Ganzberger; Geoffrey Michael,1,0,32,31
1657008834875,MATH 109,B02,083216,Ganzberger; Geoffrey Michael,1,0,32,31
1657008834875,MATH 109,B03,093479,Ganzberger; Geoffrey Michael,6,0,32,26
1657008840899,MATH 142A,A01,083219,Chow; Bennett,6,0,32,26
1657008840899,MATH 142A,A02,083220,Chow; Bennett,10,0,32,22
1657008840899,MATH 142A,A03,093480,Chow; Bennett,7,0,32,25
1657008840899,MATH 142A,B03,093481,Chow; Bennett,7,0,32,25
1657008840899,MATH 142A,B04,093558,Chow; Bennett,11,0,32,21
1657008840899,MATH 142A,B05,093559,Chow; Bennett,6,0,32,26
1657008846937,MATH 193A,A01,083224,Rotar; Vladimir,7,0,34,27
1657008846937,MATH 193A,A02,083225,Rotar; Vladimir,4,0,34,30
1657008846937,MATH 193A,A03,083781,Rotar; Vladimir,1,0,34,33
1657008846937,MATH 193A,A04,083782,Rotar; Vladimir,6,0,34,28
1657008846937,MATH 193A,A05,093482,Rotar; Vladimir,6,0,34,28
1657008852960,MATH 197,001,091859,McAuley; Julian John,9999,0,9999,0
1657008852960,MATH 197,002,095566,Kedlaya; Kiran S.,9997,0,9999,2
1657008852960,MATH 197,003,095567,Xiao; Ming,9999,0,9999,0
1657008852960,MATH 197,004,095571,Perols; Johan Lars,9998,0,9999,1
1657008860019,COGS 9,A01,083615,Shannon; Kyle Michael,7,0,75,68
1657008866045,COGS 11,A01,083617,Boyle; Mary E. T.,20,0,48,28
1657008872072,COGS 13,A01,083071,Bastos; Amalia Pinkusfeld,9,0,71,62
1657008878099,COGS 14A,A01,092681,Semenuks; Arturs,0,1,100,100
1657008884123,COGS 14B,A01,083073,Cheng; Tzu-Han,5,0,63,58
1657008890145,COGS 17,A01,092677,Semenuks; Arturs,4,0,81,77
1657008896181,COGS 100,A01,083619,Allen; Michael Gordon,15,0,70,55
1657008902213,COGS 101A,A01,083621,Davis; Joshua Daniel,9,0,68,59
1657008908236,COGS 101B,A01,091572,Allen; Michael Gordon,8,0,65,57
1657008914270,COGS 101C,A01,083625,Delgado; Tania,17,0,35,18
1657008920300,COGS 107A,A01,083627,Boyle; Mary E. T.,13,0,60,47
1657008926327,COGS 118A,A01,083075,Gupta; Anjum,15,0,76,61
1657008932357,CSE 3,A50,083646,Miranda; Gregory Joseph,22,0,50,28
1657008938385,CSE 8A,A50,083650,Miranda; Gregory Joseph,17,1,56,39
1657008944410,CSE 11,A01,083080,Cao; Yingjun,4,15,40,36
1657008950434,CSE 12,A01,083652,Krause-Levy; Sophia Louisa,21,1,120,99
1657008956458,CSE 15L,A01,083654,Morris; Justin Loren,8,0,50,42
1657008956458,CSE 15L,A02,083655,Morris; Justin Loren,9,0,50,41
1657008962486,CSE 20,A01,083657,Tran; Khoa Dang,37,0,80,43
1657008968513,CSE 21,A01,095574,Bach; Quang Tran,21,0,48,27
1657008974541,CSE 30,A01,083084,Eldon; John,4,0,80,76
1657008974541,CSE 30,B01,095061,Bhaskar; Nishant,6,0,50,44
1657008980566,CSE 100,A01,083659,Cao; Yingjun,3,4,70,67
1657008986588,CSE 134B,A01,083661,Powell; Thomas Allan,19,0,100,81
1657008992612,CSE 140,A01,083663,Gungor; Onat,14,0,85,71
1657008998636,CSE 140L,A01,083088,Eldon; John,16,0,100,84
1657009004658,CSE 175,A01,083665,Kumar; Rakesh,3,0,25,22
1657009010683,CSE 190,A00,092507,Dubnov; Shlomo,7,0,20,13
1657009016713,ECE 45,A01,083139,Congero; Spencer William,5,0,75,70
1657009022740,ECE 65,A50,083695,Saad; Andrew S,12,0,30,18
1657009022740,ECE 65,A51,095125,Saad; Andrew S,25,0,26,1
1657009028766,ECE 109,A01,091882,Touri; Behrouz,16,0,70,54
1657009034792,ECE 180,A00,083140,Abi Samra; Nicholas Camill,1,0,30,29
1657009034792,ECE 180,B00,083141,Abi Samra; Nicholas Camill,0,0,30,30
1657009040820,MATH 10A,A01,083735,Patchell; Gregory David,1,0,30,29
1657009040820,MATH 10A,A02,083736,Patchell; Gregory David,20,0,30,10
1657009040820,MATH 10A,A03,083737,Patchell; Gregory David,16,0,30,14
1657009046851,MATH 10B,A01,083207,Lim; Seonhee,7,0,34,27
1657009046851,MATH 10B,A02,083208,Lim; Seonhee,9,0,35,26
1657009046851,MATH 10B,A03,093472,Lim; Seonhee,4,0,34,30
1657009046851,MATH 10B,B01,083739,Sinha; Shubham,9,0,30,21
1657009052980,MATH 18,A01,083743,Cinel; Cameron Alexander,6,0,30,24
1657009052980,MATH 18,A02,083744,Cinel; Cameron Alexander,15,0,30,15
1657009052980,MATH 18,A03,083745,Cinel; Cameron Alexander,8,0,30,22
1657009052980,MATH 18,B01,083748,Rideout; David Porter,4,0,37,33
1657009052980,MATH 18,B02,083749,Rideout; David Porter,3,0,36,33
1657009052980,MATH 18,B03,083750,Rideout; David Porter,2,0,37,35
1657009052980,MATH 18,B04,083751,Rideout; David Porter,5,0,36,31
1657009052980,MATH 18,B05,093473,Rideout; David Porter,4,0,36,32
1657009052980,MATH 18,B06,093474,Rideout; David Porter,5,0,36,31
1657009059003,MATH 20A,A01,083754,Zheng; Zequn,12,0,40,28
1657009065031,MATH 20B,A01,083756,Briones; Jor-el Thomas Caparas,1,0,36,35
1657009065031,MATH 20B,A02,083757,Briones; Jor-el Thomas Caparas,1,0,36,35
1657009065031,MATH 20B,A03,093475,Briones; Jor-el Thomas Caparas,0,0,36,36
1657009071054,MATH 20C,A01,083760,Briones; Jor-el Thomas Caparas,1,0,35,34
1657009071054,MATH 20C,A02,083761,Briones; Jor-el Thomas Caparas,8,0,35,27
1657009071054,MATH 20C,A03,093476,Briones; Jor-el Thomas Caparas,0,1,36,36
1657009071054,MATH 20C,B01,083762,Bach; Quang Tran,0,0,30,30
1657009077083,MATH 20D,A01,083765,Tran; Brian Kha,4,0,30,26
1657009077083,MATH 20D,A02,083766,Tran; Brian Kha,5,0,30,25
1657009077083,MATH 20D,A03,083767,Tran; Brian Kha,3,0,30,27
1657009083131,MATH 20E,A01,083771,Ganguly; Soumya,5,0,32,27
1657009083131,MATH 20E,A02,083772,Ganguly; Soumya,6,0,32,26
1657009083131,MATH 20E,B01,083773,Ciotti; Benjamin,18,0,35,17
1657009083131,MATH 20E,B02,083774,Ciotti; Benjamin,17,0,35,18
1657009089161,MATH 103A,A01,083777,Greenfeld; Be'Eri,2,0,36,34
1657009089161,MATH 103A,A02,083778,Greenfeld; Be'Eri,5,0,36,31
1657009089161,MATH 103A,A03,093561,Greenfeld; Be'Eri,4,0,36,32
1657009089161,MATH 103A,B01,083779,Greenfeld; Be'Eri,6,0,36,30
1657009089161,MATH 103A,B02,083780,Greenfeld; Be'Eri,2,0,36,34
1657009089161,MATH 103A,B03,093562,Greenfeld; Be'Eri,2,0,36,34
1657009095187,MATH 105,A01,085443,Carter; Anne Toulson,14,0,35,21
1657009095187,MATH 105,A02,093477,Carter; Anne Toulson,20,0,35,15
1657009101215,MATH 109,A01,083213,Ganzberger; Geoffrey Michael,2,0,34,32
1657009101215,MATH 109,A02,083214,Ganzberger; Geoffrey Michael,2,0,34,32
1657009101215,MATH 109,A03,093478,Ganzberger; Geoffrey Michael,1,0,34,33
1657009101215,MATH 109,B01,083215,Ganzberger; Geoffrey Michael,1,0,32,31
1657009101215,MATH 109,B02,083216,Ganzberger; Geoffrey Michael,1,0,32,31
1657009101215,MATH 109,B03,093479,Ganzberger; Geoffrey Michael,6,0,32,26
1657009107239,MATH 142A,A01,083219,Chow; Bennett,6,0,32,26
1657009107239,MATH 142A,A02,083220,Chow; Bennett,10,0,32,22
1657009107239,MATH 142A,A03,093480,Chow; Bennett,7,0,32,25
1657009107239,MATH 142A,B03,093481,Chow; Bennett,7,0,32,25
1657009107239,MATH 142A,B04,093558,Chow; Bennett,11,0,32,21
1657009107239,MATH 142A,B05,093559,Chow; Bennett,6,0,32,26
1657009113267,MATH 193A,A01,083224,Rotar; Vladimir,7,0,34,27
1657009113267,MATH 193A,A02,083225,Rotar; Vladimir,4,0,34,30
1657009113267,MATH 193A,A03,083781,Rotar; Vladimir,1,0,34,33
1657009113267,MATH 193A,A04,083782,Rotar; Vladimir,6,0,34,28
1657009113267,MATH 193A,A05,093482,Rotar; Vladimir,6,0,34,28
1657009119290,MATH 197,001,091859,McAuley; Julian John,9999,0,9999,0
1657009119290,MATH 197,002,095566,Kedlaya; Kiran S.,9997,0,9999,2
1657009119290,MATH 197,003,095567,Xiao; Ming,9999,0,9999,0
1657009119290,MATH 197,004,095571,Perols; Johan Lars,9998,0,9999,1
1657009126359,COGS 9,A01,083615,Shannon; Kyle Michael,7,0,75,68
1657009132391,COGS 11,A01,083617,Boyle; Mary E. T.,20,0,48,28
1657009138416,COGS 13,A01,083071,Bastos; Amalia Pinkusfeld,9,0,71,62
1657009144440,COGS 14A,A01,092681,Semenuks; Arturs,0,1,100,100
1657009150468,COGS 14B,A01,083073,Cheng; Tzu-Han,5,0,63,58
1657009156496,COGS 17,A01,092677,Semenuks; Arturs,4,0,81,77
1657009162523,COGS 100,A01,083619,Allen; Michael Gordon,15,0,70,55
1657009168551,COGS 101A,A01,083621,Davis; Joshua Daniel,9,0,68,59
1657009174576,COGS 101B,A01,091572,Allen; Michael Gordon,8,0,65,57
1657009180599,COGS 101C,A01,083625,Delgado; Tania,17,0,35,18
1657009186624,COGS 107A,A01,083627,Boyle; Mary E. T.,13,0,60,47
1657009192646,COGS 118A,A01,083075,Gupta; Anjum,15,0,76,61
1657009198671,CSE 3,A50,083646,Miranda; Gregory Joseph,22,0,50,28
1657009204703,CSE 8A,A50,083650,Miranda; Gregory Joseph,17,1,56,39
1657009210730,CSE 11,A01,083080,Cao; Yingjun,4,15,40,36
1657009216761,CSE 12,A01,083652,Krause-Levy; Sophia Louisa,21,1,120,99
1657009222788,CSE 15L,A01,083654,Morris; Justin Loren,8,0,50,42
1657009222788,CSE 15L,A02,083655,Morris; Justin Loren,9,0,50,41
1657009228811,CSE 20,A01,083657,Tran; Khoa Dang,37,0,80,43
1657009234835,CSE 21,A01,095574,Bach; Quang Tran,21,0,48,27
1657009240863,CSE 30,A01,083084,Eldon; John,4,0,80,76
1657009240863,CSE 30,B01,095061,Bhaskar; Nishant,6,0,50,44
1657009246886,CSE 100,A01,083659,Cao; Yingjun,3,4,70,67
1657009252911,CSE 134B,A01,083661,Powell; Thomas Allan,19,0,100,81
1657009258933,CSE 140,A01,083663,Gungor; Onat,14,0,85,71
1657009264957,CSE 140L,A01,083088,Eldon; John,16,0,100,84
1657009270981,CSE 175,A01,083665,Kumar; Rakesh,3,0,25,22
1657009277004,CSE 190,A00,092507,Dubnov; Shlomo,7,0,20,13
1657009283028,ECE 45,A01,083139,Congero; Spencer William,5,0,75,70
1657009289064,ECE 65,A50,083695,Saad; Andrew S,12,0,30,18
1657009289064,ECE 65,A51,095125,Saad; Andrew S,25,0,26,1
1657009295092,ECE 109,A01,091882,Touri; Behrouz,16,0,70,54
1657009301122,ECE 180,A00,083140,Abi Samra; Nicholas Camill,1,0,30,29
1657009301122,ECE 180,B00,083141,Abi Samra; Nicholas Camill,0,0,30,30
1657009307157,MATH 10A,A01,083735,Patchell; Gregory David,1,0,30,29
1657009307157,MATH 10A,A02,083736,Patchell; Gregory David,20,0,30,10
1657009307157,MATH 10A,A03,083737,Patchell; Gregory David,16,0,30,14
1657009313187,MATH 10B,A01,083207,Lim; Seonhee,7,0,34,27
1657009313187,MATH 10B,A02,083208,Lim; Seonhee,9,0,35,26
1657009313187,MATH 10B,A03,093472,Lim; Seonhee,4,0,34,30
1657009313187,MATH 10B,B01,083739,Sinha; Shubham,9,0,30,21
1657009319223,MATH 18,A01,083743,Cinel; Cameron Alexander,6,0,30,24
1657009319223,MATH 18,A02,083744,Cinel; Cameron Alexander,15,0,30,15
1657009319223,MATH 18,A03,083745,Cinel; Cameron Alexander,8,0,30,22
1657009319223,MATH 18,B01,083748,Rideout; David Porter,4,0,37,33
1657009319223,MATH 18,B02,083749,Rideout; David Porter,3,0,36,33
1657009319223,MATH 18,B03,083750,Rideout; David Porter,2,0,37,35
1657009319223,MATH 18,B04,083751,Rideout; David Porter,5,0,36,31
1657009319223,MATH 18,B05,093473,Rideout; David Porter,4,0,36,32
1657009319223,MATH 18,B06,093474,Rideout; David Porter,5,0,36,31
1657009325248,MATH 20A,A01,083754,Zheng; Zequn,12,0,40,28
1657009331277,MATH 20B,A01,083756,Briones; Jor-el Thomas Caparas,1,0,36,35
1657009331277,MATH 20B,A02,083757,Briones; Jor-el Thomas Caparas,1,0,36,35
1657009331277,MATH 20B,A03,093475,Briones; Jor-el Thomas Caparas,0,0,36,36
1657009337310,MATH 20C,A01,083760,Briones; Jor-el Thomas Caparas,1,0,35,34
1657009337310,MATH 20C,A02,083761,Briones; Jor-el Thomas Caparas,8,0,35,27
1657009337310,MATH 20C,A03,093476,Briones; Jor-el Thomas Caparas,0,1,36,36
1657009337310,MATH 20C,B01,083762,Bach; Quang Tran,0,0,30,30
1657009343343,MATH 20D,A01,083765,Tran; Brian Kha,4,0,30,26
1657009343343,MATH 20D,A02,083766,Tran; Brian Kha,5,0,30,25
1657009343343,MATH 20D,A03,083767,Tran; Brian Kha,3,0,30,27
1657009349377,MATH 20E,A01,083771,Ganguly; Soumya,5,0,32,27
1657009349377,MATH 20E,A02,083772,Ganguly; Soumya,6,0,32,26
1657009349377,MATH 20E,B01,083773,Ciotti; Benjamin,18,0,35,17
1657009349377,MATH 20E,B02,083774,Ciotti; Benjamin,17,0,35,18
1657009355413,MATH 103A,A01,083777,Greenfeld; Be'Eri,2,0,36,34
1657009355413,MATH 103A,A02,083778,Greenfeld; Be'Eri,5,0,36,31
1657009355413,MATH 103A,A03,093561,Greenfeld; Be'Eri,4,0,36,32
1657009355413,MATH 103A,B01,083779,Greenfeld; Be'Eri,6,0,36,30
1657009355413,MATH 103A,B02,083780,Greenfeld; Be'Eri,2,0,36,34
1657009355413,MATH 103A,B03,093562,Greenfeld; Be'Eri,2,0,36,34
1657009361445,MATH 105,A01,085443,Carter; Anne Toulson,14,0,35,21
1657009361445,MATH 105,A02,093477,Carter; Anne Toulson,20,0,35,15
1657009367473,MATH 109,A01,083213,Ganzberger; Geoffrey Michael,2,0,34,32
1657009367473,MATH 109,A02,083214,Ganzberger; Geoffrey Michael,2,0,34,32
1657009367473,MATH 109,A03,093478,Ganzberger; Geoffrey Michael,1,0,34,33
1657009367473,MATH 109,B01,083215,Ganzberger; Geoffrey Michael,1,0,32,31
1657009367473,MATH 109,B02,083216,Ganzberger; Geoffrey Michael,1,0,32,31
1657009367473,MATH 109,B03,093479,Ganzberger; Geoffrey Michael,6,0,32,26
1657009373506,MATH 142A,A01,083219,Chow; Bennett,6,0,32,26
1657009373506,MATH 142A,A02,083220,Chow; Bennett,10,0,32,22
1657009373506,MATH 142A,A03,093480,Chow; Bennett,7,0,32,25
1657009373506,MATH 142A,B03,093481,Chow; Bennett,7,0,32,25
1657009373506,MATH 142A,B04,093558,Chow; Bennett,11,0,32,21
1657009373506,MATH 142A,B05,093559,Chow; Bennett,6,0,32,26
1657009379546,MATH 193A,A01,083224,Rotar; Vladimir,7,0,34,27
1657009379546,MATH 193A,A02,083225,Rotar; Vladimir,4,0,34,30
1657009379546,MATH 193A,A03,083781,Rotar; Vladimir,1,0,34,33
1657009379546,MATH 193A,A04,083782,Rotar; Vladimir,6,0,34,28
1657009379546,MATH 193A,A05,093482,Rotar; Vladimir,6,0,34,28
1657009385574,MATH 197,001,091859,McAuley; Julian John,9999,0,9999,0
1657009385574,MATH 197,002,095566,Kedlaya; Kiran S.,9997,0,9999,2
1657009385574,MATH 197,003,095567,Xiao; Ming,9999,0,9999,0
1657009385574,MATH 197,004,095571,Perols; Johan Lars,9998,0,9999,1
1657009392658,COGS 9,A01,083615,Shannon; Kyle Michael,7,0,75,68
1657009398690,COGS 11,A01,083617,Boyle; Mary E. T.,20,0,48,28
1657009404720,COGS 13,A01,083071,Bastos; Amalia Pinkusfeld,9,0,71,62
1657009410749,COGS 14A,A01,092681,Semenuks; Arturs,0,1,100,100
1657009416776,COGS 14B,A01,083073,Cheng; Tzu-Han,5,0,63,58
1657009422800,COGS 17,A01,092677,Semenuks; Arturs,4,0,81,77
1657009428826,COGS 100,A01,083619,Allen; Michael Gordon,15,0,70,55
1657009434861,COGS 101A,A01,083621,Davis; Joshua Daniel,9,0,68,59
1657009440885,COGS 101B,A01,091572,Allen; Michael Gordon,8,0,65,57
1657009446931,COGS 101C,A01,083625,Delgado; Tania,17,0,35,18
1657009452954,COGS 107A,A01,083627,Boyle; Mary E. T.,13,0,60,47
1657009458979,COGS 118A,A01,083075,Gupta; Anjum,15,0,76,61
1657009465010,CSE 3,A50,083646,Miranda; Gregory Joseph,22,0,50,28
1657009471033,CSE 8A,A50,083650,Miranda; Gregory Joseph,17,1,56,39
1657009477062,CSE 11,A01,083080,Cao; Yingjun,4,15,40,36
1657009483096,CSE 12,A01,083652,Krause-Levy; Sophia Louisa,21,1,120,99
1657009489131,CSE 15L,A01,083654,Morris; Justin Loren,8,0,50,42
1657009489131,CSE 15L,A02,083655,Morris; Justin Loren,9,0,50,41
1657009495159,CSE 20,A01,083657,Tran; Khoa Dang,37,0,80,43
1657009501197,CSE 21,A01,095574,Bach; Quang Tran,21,0,48,27
1657009507222,CSE 30,A01,083084,Eldon; John,4,0,80,76
1657009507222,CSE 30,B01,095061,Bhaskar; Nishant,6,0,50,44
1657009513255,CSE 100,A01,083659,Cao; Yingjun,3,4,70,67
1657009519279,CSE 134B,A01,083661,Powell; Thomas Allan,19,0,100,81
1657009525306,CSE 140,A01,083663,Gungor; Onat,14,0,85,71
1657009531334,CSE 140L,A01,083088,Eldon; John,16,0,100,84
1657009537362,CSE 175,A01,083665,Kumar; Rakesh,3,0,25,22
1657009543391,CSE 190,A00,092507,Dubnov; Shlomo,7,0,20,13
1657009549425,ECE 45,A01,083139,Congero; Spencer William,5,0,75,70
1657009555456,ECE 65,A50,083695,Saad; Andrew S,12,0,30,18
1657009555456,ECE 65,A51,095125,Saad; Andrew S,25,0,26,1
1657009561485,ECE 109,A01,091882,Touri; Behrouz,16,0,70,54
1657009567511,ECE 180,A00,083140,Abi Samra; Nicholas Camill,1,0,30,29
1657009567511,ECE 180,B00,083141,Abi Samra; Nicholas Camill,0,0,30,30
1657009573538,MATH 10A,A01,083735,Patchell; Gregory David,1,0,30,29
1657009573538,MATH 10A,A02,083736,Patchell; Gregory David,20,0,30,10
1657009573538,MATH 10A,A03,083737,Patchell; Gregory David,16,0,30,14
1657009579567,MATH 10B,A01,083207,Lim; Seonhee,7,0,34,27
1657009579567,MATH 10B,A02,083208,Lim; Seonhee,9,0,35,26
1657009579567,MATH 10B,A03,093472,Lim; Seonhee,4,0,34,30
1657009579567,MATH 10B,B01,083739,Sinha; Shubham,9,0,30,21
1657009585596,MATH 18,A01,083743,Cinel; Cameron Alexander,6,0,30,24
1657009585596,MATH 18,A02,083744,Cinel; Cameron Alexander,15,0,30,15
1657009585596,MATH 18,A03,083745,Cinel; Cameron Alexander,8,0,30,22
1657009585596,MATH 18,B01,083748,Rideout; David Porter,4,0,37,33
1657009585596,MATH 18,B02,083749,Rideout; David Porter,3,0,36,33
1657009585596,MATH 18,B03,083750,Rideout; David Porter,2,0,37,35
1657009585596,MATH 18,B04,083751,Rideout; David Porter,5,0,36,31
1657009585596,MATH 18,B05,093473,Rideout; David Porter,4,0,36,32
1657009585596,MATH 18,B06,093474,Rideout; David Porter,5,0,36,31
1657009591625,MATH 20A,A01,083754,Zheng; Zequn,12,0,40,28
1657009597657,MATH 20B,A01,083756,Briones; Jor-el Thomas Caparas,1,0,36,35
1657009597657,MATH 20B,A02,083757,Briones; Jor-el Thomas Caparas,1,0,36,35
1657009597657,MATH 20B,A03,093475,Briones; Jor-el Thomas Caparas,0,0,36,36
1657009603681,MATH 20C,A01,083760,Briones; Jor-el Thomas Caparas,1,0,35,34
1657009603681,MATH 20C,A02,083761,Briones; Jor-el Thomas Caparas,8,0,35,27
1657009603681,MATH 20C,A03,093476,Briones; Jor-el Thomas Caparas,0,1,36,36
1657009603681,MATH 20C,B01,083762,Bach; Quang Tran,0,0,30,30
1657009609713,MATH 20D,A01,083765,Tran; Brian Kha,4,0,30,26
1657009609713,MATH 20D,A02,083766,Tran; Brian Kha,5,0,30,25
1657009609713,MATH 20D,A03,083767,Tran; Brian Kha,3,0,30,27
1657009615743,MATH 20E,A01,083771,Ganguly; Soumya,5,0,32,27
1657009615743,MATH 20E,A02,083772,Ganguly; Soumya,6,0,32,26
1657009615743,MATH 20E,B01,083773,Ciotti; Benjamin,18,0,35,17
1657009615743,MATH 20E,B02,083774,Ciotti; Benjamin,17,0,35,18
1657009621767,MATH 103A,A01,083777,Greenfeld; Be'Eri,2,0,36,34
1657009621767,MATH 103A,A02,083778,Greenfeld; Be'Eri,5,0,36,31
1657009621767,MATH 103A,A03,093561,Greenfeld; Be'Eri,4,0,36,32
1657009621767,MATH 103A,B01,083779,Greenfeld; Be'Eri,6,0,36,30
1657009621767,MATH 103A,B02,083780,Greenfeld; Be'Eri,2,0,36,34
1657009621767,MATH 103A,B03,093562,Greenfeld; Be'Eri,2,0,36,34
1657009627792,MATH 105,A01,085443,Carter; Anne Toulson,14,0,35,21
1657009627792,MATH 105,A02,093477,Carter; Anne Toulson,20,0,35,15
1657009633817,MATH 109,A01,083213,Ganzberger; Geoffrey Michael,2,0,34,32
1657009633817,MATH 109,A02,083214,Ganzberger; Geoffrey Michael,2,0,34,32
1657009633817,MATH 109,A03,093478,Ganzberger; Geoffrey Michael,1,0,34,33
1657009633817,MATH 109,B01,083215,Ganzberger; Geoffrey Michael,1,0,32,31
1657009633817,MATH 109,B02,083216,Ganzberger; Geoffrey Michael,1,0,32,31
1657009633817,MATH 109,B03,093479,Ganzberger; Geoffrey Michael,6,0,32,26
1657009639842,MATH 142A,A01,083219,Chow; Bennett,6,0,32,26
1657009639842,MATH 142A,A02,083220,Chow; Bennett,10,0,32,22
1657009639842,MATH 142A,A03,093480,Chow; Bennett,7,0,32,25
1657009639842,MATH 142A,B03,093481,Chow; Bennett,7,0,32,25
1657009639842,MATH 142A,B04,093558,Chow; Bennett,11,0,32,21
1657009639842,MATH 142A,B05,093559,Chow; Bennett,6,0,32,26
1657009645867,MATH 193A,A01,083224,Rotar; Vladimir,7,0,34,27
1657009645867,MATH 193A,A02,083225,Rotar; Vladimir,4,0,34,30
1657009645867,MATH 193A,A03,083781,Rotar; Vladimir,1,0,34,33
1657009645867,MATH 193A,A04,083782,Rotar; Vladimir,6,0,34,28
1657009645867,MATH 193A,A05,093482,Rotar; Vladimir,6,0,34,28
1657009651966,MATH 197,001,091859,McAuley; Julian John,9999,0,9999,0
1657009651966,MATH 197,002,095566,Kedlaya; Kiran S.,9997,0,9999,2
1657009651966,MATH 197,003,095567,Xiao; Ming,9999,0,9999,0
1657009651966,MATH 197,004,095571,Perols; Johan Lars,9998,0,9999,1
1657009659035,COGS 9,A01,083615,Shannon; Kyle Michael,7,0,75,68
1657009665059,COGS 11,A01,083617,Boyle; Mary E. T.,20,0,48,28
1657009671089,COGS 13,A01,083071,Bastos; Amalia Pinkusfeld,9,0,71,62
1657009677115,COGS 14A,A01,092681,Semenuks; Arturs,0,1,100,100
1657009683144,COGS 14B,A01,083073,Cheng; Tzu-Han,5,0,63,58
1657009689177,COGS 17,A01,092677,Semenuks; Arturs,4,0,81,77
1657009695201,COGS 100,A01,083619,Allen; Michael Gordon,15,0,70,55
1657009701226,COGS 101A,A01,083621,Davis; Joshua Daniel,9,0,68,59
1657009707250,COGS 101B,A01,091572,Allen; Michael Gordon,8,0,65,57
1657009713272,COGS 101C,A01,083625,Delgado; Tania,17,0,35,18
1657009719300,COGS 107A,A01,083627,Boyle; Mary E. T.,13,0,60,47
1657009725327,COGS 118A,A01,083075,Gupta; Anjum,15,0,76,61
1657009731356,CSE 3,A50,083646,Miranda; Gregory Joseph,22,0,50,28
1657009737380,CSE 8A,A50,083650,Miranda; Gregory Joseph,17,1,56,39
1657009743404,CSE 11,A01,083080,Cao; Yingjun,4,15,40,36
1657009749428,CSE 12,A01,083652,Krause-Levy; Sophia Louisa,21,1,120,99
1657009755452,CSE 15L,A01,083654,Morris; Justin Loren,8,0,50,42
1657009755452,CSE 15L,A02,083655,Morris; Justin Loren,9,0,50,41
1657009761480,CSE 20,A01,083657,Tran; Khoa Dang,37,0,80,43
1657009767507,CSE 21,A01,095574,Bach; Quang Tran,21,0,48,27
1657009773536,CSE 30,A01,083084,Eldon; John,4,0,80,76
1657009773536,CSE 30,B01,095061,Bhaskar; Nishant,6,0,50,44
1657009779560,CSE 100,A01,083659,Cao; Yingjun,3,4,70,67
1657009785588,CSE 134B,A01,083661,Powell; Thomas Allan,19,0,100,81
1657009791619,CSE 140,A01,083663,Gungor; Onat,14,0,85,71
1657009797655,CSE 140L,A01,083088,Eldon; John,16,0,100,84
1657009803678,CSE 175,A01,083665,Kumar; Rakesh,3,0,25,22
1657009809707,CSE 190,A00,092507,Dubnov; Shlomo,7,0,20,13
1657009815734,ECE 45,A01,083139,Congero; Spencer William,5,0,75,70
1657009821759,ECE 65,A50,083695,Saad; Andrew S,12,0,30,18
1657009821759,ECE 65,A51,095125,Saad; Andrew S,25,0,26,1
1657009827782,ECE 109,A01,091882,Touri; Behrouz,16,0,70,54
1657009833808,ECE 180,A00,083140,Abi Samra; Nicholas Camill,1,0,30,29
1657009833808,ECE 180,B00,083141,Abi Samra; Nicholas Camill,0,0,30,30
1657009839834,MATH 10A,A01,083735,Patchell; Gregory David,1,0,30,29
1657009839834,MATH 10A,A02,083736,Patchell; Gregory David,20,0,30,10
1657009839834,MATH 10A,A03,083737,Patchell; Gregory David,16,0,30,14
1657009845865,MATH 10B,A01,083207,Lim; Seonhee,7,0,34,27
1657009845865,MATH 10B,A02,083208,Lim; Seonhee,9,0,35,26
1657009845865,MATH 10B,A03,093472,Lim; Seonhee,4,0,34,30
1657009845865,MATH 10B,B01,083739,Sinha; Shubham,9,0,30,21
1657009851893,MATH 18,A01,083743,Cinel; Cameron Alexander,6,0,30,24
1657009851893,MATH 18,A02,083744,Cinel; Cameron Alexander,15,0,30,15
1657009851893,MATH 18,A03,083745,Cinel; Cameron Alexander,8,0,30,22
1657009851893,MATH 18,B01,083748,Rideout; David Porter,4,0,37,33
1657009851893,MATH 18,B02,083749,Rideout; David Porter,3,0,36,33
1657009851893,MATH 18,B03,083750,Rideout; David Porter,2,0,37,35
1657009851893,MATH 18,B04,083751,Rideout; David Porter,5,0,36,31
1657009851893,MATH 18,B05,093473,Rideout; David Porter,4,0,36,32
1657009851893,MATH 18,B06,093474,Rideout; David Porter,5,0,36,31
1657009857918,MATH 20A,A01,083754,Zheng; Zequn,12,0,40,28
1657009863946,MATH 20B,A01,083756,Briones; Jor-el Thomas Caparas,1,0,36,35
1657009863946,MATH 20B,A02,083757,Briones; Jor-el Thomas Caparas,1,0,36,35
1657009863946,MATH 20B,A03,093475,Briones; Jor-el Thomas Caparas,0,0,36,36
1657009869970,MATH 20C,A01,083760,Briones; Jor-el Thomas Caparas,1,0,35,34
1657009869970,MATH 20C,A02,083761,Briones; Jor-el Thomas Caparas,8,0,35,27
1657009869970,MATH 20C,A03,093476,Briones; Jor-el Thomas Caparas,0,1,36,36
1657009869970,MATH 20C,B01,083762,Bach; Quang Tran,0,0,30,30
1657009875996,MATH 20D,A01,083765,Tran; Brian Kha,4,0,30,26
1657009875996,MATH 20D,A02,083766,Tran; Brian Kha,5,0,30,25
1657009875996,MATH 20D,A03,083767,Tran; Brian Kha,3,0,30,27
1657009882021,MATH 20E,A01,083771,Ganguly; Soumya,5,0,32,27
1657009882021,MATH 20E,A02,083772,Ganguly; Soumya,6,0,32,26
1657009882021,MATH 20E,B01,083773,Ciotti; Benjamin,18,0,35,17
1657009882021,MATH 20E,B02,083774,Ciotti; Benjamin,17,0,35,18
1657009888044,MATH 103A,A01,083777,Greenfeld; Be'Eri,2,0,36,34
1657009888044,MATH 103A,A02,083778,Greenfeld; Be'Eri,5,0,36,31
1657009888044,MATH 103A,A03,093561,Greenfeld; Be'Eri,4,0,36,32
1657009888044,MATH 103A,B01,083779,Greenfeld; Be'Eri,6,0,36,30
1657009888044,MATH 103A,B02,083780,Greenfeld; Be'Eri,2,0,36,34
1657009888044,MATH 103A,B03,093562,Greenfeld; Be'Eri,2,0,36,34
1657009894069,MATH 105,A01,085443,Carter; Anne Toulson,14,0,35,21
1657009894069,MATH 105,A02,093477,Carter; Anne Toulson,20,0,35,15
1657009900093,MATH 109,A01,083213,Ganzberger; Geoffrey Michael,2,0,34,32
1657009900093,MATH 109,A02,083214,Ganzberger; Geoffrey Michael,2,0,34,32
1657009900093,MATH 109,A03,093478,Ganzberger; Geoffrey Michael,1,0,34,33
1657009900093,MATH 109,B01,083215,Ganzberger; Geoffrey Michael,1,0,32,31
1657009900093,MATH 109,B02,083216,Ganzberger; Geoffrey Michael,1,0,32,31
1657009900093,MATH 109,B03,093479,Ganzberger; Geoffrey Michael,6,0,32,26
1657009906120,MATH 142A,A01,083219,Chow; Bennett,6,0,32,26
1657009906120,MATH 142A,A02,083220,Chow; Bennett,10,0,32,22
1657009906120,MATH 142A,A03,093480,Chow; Bennett,7,0,32,25
1657009906120,MATH 142A,B03,093481,Chow; Bennett,7,0,32,25
1657009906120,MATH 142A,B04,093558,Chow; Bennett,11,0,32,21
1657009906120,MATH 142A,B05,093559,Chow; Bennett,6,0,32,26
1657009912143,MATH 193A,A01,083224,Rotar; Vladimir,7,0,34,27
1657009912143,MATH 193A,A02,083225,Rotar; Vladimir,4,0,34,30
1657009912143,MATH 193A,A03,083781,Rotar; Vladimir,1,0,34,33
1657009912143,MATH 193A,A04,083782,Rotar; Vladimir,6,0,34,28
1657009912143,MATH 193A,A05,093482,Rotar; Vladimir,6,0,34,28
1657009918171,MATH 197,001,091859,McAuley; Julian John,9999,0,9999,0
1657009918171,MATH 197,002,095566,Kedlaya; Kiran S.,9997,0,9999,2
1657009918171,MATH 197,003,095567,Xiao; Ming,9999,0,9999,0
1657009918171,MATH 197,004,095571,Perols; Johan Lars,9998,0,9999,1
1657009925246,COGS 9,A01,083615,Shannon; Kyle Michael,7,0,75,68
1657009931272,COGS 11,A01,083617,Boyle; Mary E. T.,20,0,48,28
1657009937295,COGS 13,A01,083071,Bastos; Amalia Pinkusfeld,9,0,71,62
1657009943322,COGS 14A,A01,092681,Semenuks; Arturs,0,1,100,100
1657009949351,COGS 14B,A01,083073,Cheng; Tzu-Han,5,0,63,58
1657009955375,COGS 17,A01,092677,Semenuks; Arturs,4,0,81,77
1657009961398,COGS 100,A01,083619,Allen; Michael Gordon,15,0,70,55
1657009967421,COGS 101A,A01,083621,Davis; Joshua Daniel,9,0,68,59
1657009973452,COGS 101B,A01,091572,Allen; Michael Gordon,8,0,65,57
1657009979481,COGS 101C,A01,083625,Delgado; Tania,17,0,35,18
1657009985504,COGS 107A,A01,083627,Boyle; Mary E. T.,13,0,60,47
1657009991526,COGS 118A,A01,083075,Gupta; Anjum,15,0,76,61
1657009997548,CSE 3,A50,083646,Miranda; Gregory Joseph,22,0,50,28
1657010003576,CSE 8A,A50,083650,Miranda; Gregory Joseph,17,1,56,39
1657010009599,CSE 11,A01,083080,Cao; Yingjun,4,15,40,36
1657010015621,CSE 12,A01,083652,Krause-Levy; Sophia Louisa,21,1,120,99
1657010021648,CSE 15L,A01,083654,Morris; Justin Loren,8,0,50,42
1657010021648,CSE 15L,A02,083655,Morris; Justin Loren,9,0,50,41
1657010027670,CSE 20,A01,083657,Tran; Khoa Dang,37,0,80,43
1657010033696,CSE 21,A01,095574,Bach; Quang Tran,21,0,48,27
1657010039728,CSE 30,A01,083084,Eldon; John,4,0,80,76
1657010039728,CSE 30,B01,095061,Bhaskar; Nishant,6,0,50,44
1657010045752,CSE 100,A01,083659,Cao; Yingjun,3,4,70,67
1657010051777,CSE 134B,A01,083661,Powell; Thomas Allan,19,0,100,81
1657010057803,CSE 140,A01,083663,Gungor; Onat,14,0,85,71
1657010063829,CSE 140L,A01,083088,Eldon; John,16,0,100,84
1657010069856,CSE 175,A01,083665,Kumar; Rakesh,3,0,25,22
1657010075879,CSE 190,A00,092507,Dubnov; Shlomo,7,0,20,13
1657010081906,ECE 45,A01,083139,Congero; Spencer William,5,0,75,70
1657010087927,ECE 65,A50,083695,Saad; Andrew S,12,0,30,18
1657010087927,ECE 65,A51,095125,Saad; Andrew S,25,0,26,1
1657010093951,ECE 109,A01,091882,Touri; Behrouz,16,0,70,54
1657010099974,ECE 180,A00,083140,Abi Samra; Nicholas Camill,1,0,30,29
1657010099974,ECE 180,B00,083141,Abi Samra; Nicholas Camill,0,0,30,30
1657010105996,MATH 10A,A01,083735,Patchell; Gregory David,1,0,30,29
1657010105996,MATH 10A,A02,083736,Patchell; Gregory David,20,0,30,10
1657010105996,MATH 10A,A03,083737,Patchell; Gregory David,16,0,30,14
1657010112019,MATH 10B,A01,083207,Lim; Seonhee,7,0,34,27
1657010112019,MATH 10B,A02,083208,Lim; Seonhee,9,0,35,26
1657010112019,MATH 10B,A03,093472,Lim; Seonhee,4,0,34,30
1657010112019,MATH 10B,B01,083739,Sinha; Shubham,9,0,30,21
1657010118048,MATH 18,A01,083743,Cinel; Cameron Alexander,6,0,30,24
1657010118048,MATH 18,A02,083744,Cinel; Cameron Alexander,15,0,30,15
1657010118048,MATH 18,A03,083745,Cinel; Cameron Alexander,8,0,30,22
1657010118048,MATH 18,B01,083748,Rideout; David Porter,4,0,37,33
1657010118048,MATH 18,B02,083749,Rideout; David Porter,3,0,36,33
1657010118048,MATH 18,B03,083750,Rideout; David Porter,2,0,37,35
1657010118048,MATH 18,B04,083751,Rideout; David Porter,5,0,36,31
1657010118048,MATH 18,B05,093473,Rideout; David Porter,4,0,36,32
1657010118048,MATH 18,B06,093474,Rideout; David Porter,5,0,36,31
1657010124073,MATH 20A,A01,083754,Zheng; Zequn,12,0,40,28
1657010130097,MATH 20B,A01,083756,Briones; Jor-el Thomas Caparas,1,0,36,35
1657010130097,MATH 20B,A02,083757,Briones; Jor-el Thomas Caparas,1,0,36,35
1657010130097,MATH 20B,A03,093475,Briones; Jor-el Thomas Caparas,0,0,36,36
1657010136124,MATH 20C,A01,083760,Briones; Jor-el Thomas Caparas,1,0,35,34
1657010136124,MATH 20C,A02,083761,Briones; Jor-el Thomas Caparas,8,0,35,27
1657010136124,MATH 20C,A03,093476,Briones; Jor-el Thomas Caparas,0,1,36,36
1657010136124,MATH 20C,B01,083762,Bach; Quang Tran,0,0,30,30
1657010142149,MATH 20D,A01,083765,Tran; Brian Kha,4,0,30,26
1657010142149,MATH 20D,A02,083766,Tran; Brian Kha,5,0,30,25
1657010142149,MATH 20D,A03,083767,Tran; Brian Kha,3,0,30,27
1657010148173,MATH 20E,A01,083771,Ganguly; Soumya,5,0,32,27
1657010148173,MATH 20E,A02,083772,Ganguly; Soumya,6,0,32,26
1657010148173,MATH 20E,B01,083773,Ciotti; Benjamin,18,0,35,17
1657010148173,MATH 20E,B02,083774,Ciotti; Benjamin,17,0,35,18
1657010154202,MATH 103A,A01,083777,Greenfeld; Be'Eri,2,0,36,34
1657010154202,MATH 103A,A02,083778,Greenfeld; Be'Eri,5,0,36,31
1657010154202,MATH 103A,A03,093561,Greenfeld; Be'Eri,4,0,36,32
1657010154202,MATH 103A,B01,083779,Greenfeld; Be'Eri,6,0,36,30
1657010154202,MATH 103A,B02,083780,Greenfeld; Be'Eri,2,0,36,34
1657010154202,MATH 103A,B03,093562,Greenfeld; Be'Eri,2,0,36,34
1657010160223,MATH 105,A01,085443,Carter; Anne Toulson,14,0,35,21
1657010160223,MATH 105,A02,093477,Carter; Anne Toulson,20,0,35,15
1657010166252,MATH 109,A01,083213,Ganzberger; Geoffrey Michael,2,0,34,32
1657010166252,MATH 109,A02,083214,Ganzberger; Geoffrey Michael,2,0,34,32
1657010166252,MATH 109,A03,093478,Ganzberger; Geoffrey Michael,1,0,34,33
1657010166252,MATH 109,B01,083215,Ganzberger; Geoffrey Michael,1,0,32,31
1657010166252,MATH 109,B02,083216,Ganzberger; Geoffrey Michael,1,0,32,31
1657010166252,MATH 109,B03,093479,Ganzberger; Geoffrey Michael,6,0,32,26
1657010172280,MATH 142A,A01,083219,Chow; Bennett,6,0,32,26
1657010172280,MATH 142A,A02,083220,Chow; Bennett,10,0,32,22
1657010172280,MATH 142A,A03,093480,Chow; Bennett,7,0,32,25
1657010172280,MATH 142A,B03,093481,Chow; Bennett,7,0,32,25
1657010172280,MATH 142A,B04,093558,Chow; Bennett,11,0,32,21
1657010172280,MATH 142A,B05,093559,Chow; Bennett,6,0,32,26
1657010178303,MATH 193A,A01,083224,Rotar; Vladimir,7,0,34,27
1657010178303,MATH 193A,A02,083225,Rotar; Vladimir,4,0,34,30
1657010178303,MATH 193A,A03,083781,Rotar; Vladimir,1,0,34,33
1657010178303,MATH 193A,A04,083782,Rotar; Vladimir,6,0,34,28
1657010178303,MATH 193A,A05,093482,Rotar; Vladimir,6,0,34,28
1657010184329,MATH 197,001,091859,McAuley; Julian John,9999,0,9999,0
1657010184329,MATH 197,002,095566,Kedlaya; Kiran S.,9997,0,9999,2
1657010184329,MATH 197,003,095567,Xiao; Ming,9999,0,9999,0
1657010184329,MATH 197,004,095571,Perols; Johan Lars,9998,0,9999,1
1657010191382,COGS 9,A01,083615,Shannon; Kyle Michael,7,0,75,68
1657010197409,COGS 11,A01,083617,Boyle; Mary E. T.,20,0,48,28
1657010203432,COGS 13,A01,083071,Bastos; Amalia Pinkusfeld,9,0,71,62
1657010209470,COGS 14A,A01,092681,Semenuks; Arturs,0,1,100,100
1657010215497,COGS 14B,A01,083073,Cheng; Tzu-Han,5,0,63,58
1657010221528,COGS 17,A01,092677,Semenuks; Arturs,4,0,81,77
1657010227551,COGS 100,A01,083619,Allen; Michael Gordon,15,0,70,55
1657010233573,COGS 101A,A01,083621,Davis; Joshua Daniel,9,0,68,59
1657010239597,COGS 101B,A01,091572,Allen; Michael Gordon,8,0,65,57
1657010245695,COGS 101C,A01,083625,Delgado; Tania,17,0,35,18
1657010251717,COGS 107A,A01,083627,Boyle; Mary E. T.,13,0,60,47
1657010257739,COGS 118A,A01,083075,Gupta; Anjum,15,0,76,61
1657010263764,CSE 3,A50,083646,Miranda; Gregory Joseph,22,0,50,28
1657010269786,CSE 8A,A50,083650,Miranda; Gregory Joseph,17,1,56,39
1657010275809,CSE 11,A01,083080,Cao; Yingjun,4,15,40,36
1657010281836,CSE 12,A01,083652,Krause-Levy; Sophia Louisa,21,1,120,99
1657010287862,CSE 15L,A01,083654,Morris; Justin Loren,8,0,50,42
1657010287862,CSE 15L,A02,083655,Morris; Justin Loren,9,0,50,41
1657010293906,CSE 20,A01,083657,Tran; Khoa Dang,37,0,80,43
1657010299930,CSE 21,A01,095574,Bach; Quang Tran,21,0,48,27
1657010305964,CSE 30,A01,083084,Eldon; John,4,0,80,76
1657010305964,CSE 30,B01,095061,Bhaskar; Nishant,6,0,50,44
1657010311987,CSE 100,A01,083659,Cao; Yingjun,3,4,70,67
1657010318014,CSE 134B,A01,083661,Powell; Thomas Allan,19,0,100,81
1657010324038,CSE 140,A01,083663,Gungor; Onat,14,0,85,71
1657010330065,CSE 140L,A01,083088,Eldon; John,16,0,100,84
1657010336092,CSE 175,A01,083665,Kumar; Rakesh,3,0,25,22
1657010342117,CSE 190,A00,092507,Dubnov; Shlomo,7,0,20,13
1657010348145,ECE 45,A01,083139,Congero; Spencer William,5,0,75,70
1657010354172,ECE 65,A50,083695,Saad; Andrew S,12,0,30,18
1657010354172,ECE 65,A51,095125,Saad; Andrew S,25,0,26,1
1657010360198,ECE 109,A01,091882,Touri; Behrouz,16,0,70,54
1657010366224,ECE 180,A00,083140,Abi Samra; Nicholas Camill,1,0,30,29
1657010366224,ECE 180,B00,083141,Abi Samra; Nicholas Camill,0,0,30,30
1657010372252,MATH 10A,A01,083735,Patchell; Gregory David,1,0,30,29
1657010372252,MATH 10A,A02,083736,Patchell; Gregory David,20,0,30,10
1657010372252,MATH 10A,A03,083737,Patchell; Gregory David,16,0,30,14
1657010378279,MATH 10B,A01,083207,Lim; Seonhee,7,0,34,27
1657010378279,MATH 10B,A02,083208,Lim; Seonhee,9,0,35,26
1657010378279,MATH 10B,A03,093472,Lim; Seonhee,4,0,34,30
1657010378279,MATH 10B,B01,083739,Sinha; Shubham,9,0,30,21
1657010384311,MATH 18,A01,083743,Cinel; Cameron Alexander,6,0,30,24
1657010384311,MATH 18,A02,083744,Cinel; Cameron Alexander,15,0,30,15
1657010384311,MATH 18,A03,083745,Cinel; Cameron Alexander,8,0,30,22
1657010384311,MATH 18,B01,083748,Rideout; David Porter,4,0,37,33
1657010384311,MATH 18,B02,083749,Rideout; David Porter,3,0,36,33
1657010384311,MATH 18,B03,083750,Rideout; David Porter,2,0,37,35
1657010384311,MATH 18,B04,083751,Rideout; David Porter,5,0,36,31
1657010384311,MATH 18,B05,093473,Rideout; David Porter,4,0,36,32
1657010384311,MATH 18,B06,093474,Rideout; David Porter,5,0,36,31
1657010390340,MATH 20A,A01,083754,Zheng; Zequn,12,0,40,28
1657010396368,MATH 20B,A01,083756,Briones; Jor-el Thomas Caparas,1,0,36,35
1657010396368,MATH 20B,A02,083757,Briones; Jor-el Thomas Caparas,1,0,36,35
1657010396368,MATH 20B,A03,093475,Briones; Jor-el Thomas Caparas,0,0,36,36
1657010402391,MATH 20C,A01,083760,Briones; Jor-el Thomas Caparas,1,0,35,34
1657010402391,MATH 20C,A02,083761,Briones; Jor-el Thomas Caparas,8,0,35,27
1657010402391,MATH 20C,A03,093476,Briones; Jor-el Thomas Caparas,0,1,36,36
1657010402391,MATH 20C,B01,083762,Bach; Quang Tran,0,0,30,30
1657010408414,MATH 20D,A01,083765,Tran; Brian Kha,4,0,30,26
1657010408414,MATH 20D,A02,083766,Tran; Brian Kha,5,0,30,25
1657010408414,MATH 20D,A03,083767,Tran; Brian Kha,3,0,30,27
1657010414437,MATH 20E,A01,083771,Ganguly; Soumya,5,0,32,27
1657010414437,MATH 20E,A02,083772,Ganguly; Soumya,6,0,32,26
1657010414437,MATH 20E,B01,083773,Ciotti; Benjamin,18,0,35,17
1657010414437,MATH 20E,B02,083774,Ciotti; Benjamin,17,0,35,18
1657010420465,MATH 103A,A01,083777,Greenfeld; Be'Eri,2,0,36,34
1657010420465,MATH 103A,A02,083778,Greenfeld; Be'Eri,5,0,36,31
1657010420465,MATH 103A,A03,093561,Greenfeld; Be'Eri,4,0,36,32
1657010420465,MATH 103A,B01,083779,Greenfeld; Be'Eri,6,0,36,30
1657010420465,MATH 103A,B02,083780,Greenfeld; Be'Eri,2,0,36,34
1657010420465,MATH 103A,B03,093562,Greenfeld; Be'Eri,2,0,36,34
1657010426492,MATH 105,A01,085443,Carter; Anne Toulson,14,0,35,21
1657010426492,MATH 105,A02,093477,Carter; Anne Toulson,20,0,35,15
1657010432520,MATH 109,A01,083213,Ganzberger; Geoffrey Michael,2,0,34,32
1657010432520,MATH 109,A02,083214,Ganzberger; Geoffrey Michael,2,0,34,32
1657010432520,MATH 109,A03,093478,Ganzberger; Geoffrey Michael,1,0,34,33
1657010432520,MATH 109,B01,083215,Ganzberger; Geoffrey Michael,1,0,32,31
1657010432520,MATH 109,B02,083216,Ganzberger; Geoffrey Michael,1,0,32,31
1657010432520,MATH 109,B03,093479,Ganzberger; Geoffrey Michael,6,0,32,26
1657010438549,MATH 142A,A01,083219,Chow; Bennett,6,0,32,26
1657010438549,MATH 142A,A02,083220,Chow; Bennett,10,0,32,22
1657010438549,MATH 142A,A03,093480,Chow; Bennett,7,0,32,25
1657010438549,MATH 142A,B03,093481,Chow; Bennett,7,0,32,25
1657010438549,MATH 142A,B04,093558,Chow; Bennett,11,0,32,21
1657010438549,MATH 142A,B05,093559,Chow; Bennett,6,0,32,26
1657010444572,MATH 193A,A01,083224,Rotar; Vladimir,7,0,34,27
1657010444572,MATH 193A,A02,083225,Rotar; Vladimir,4,0,34,30
1657010444572,MATH 193A,A03,083781,Rotar; Vladimir,1,0,34,33
1657010444572,MATH 193A,A04,083782,Rotar; Vladimir,6,0,34,28
1657010444572,MATH 193A,A05,093482,Rotar; Vladimir,6,0,34,28
1657010450595,MATH 197,001,091859,McAuley; Julian John,9999,0,9999,0
1657010450595,MATH 197,002,095566,Kedlaya; Kiran S.,9997,0,9999,2
1657010450595,MATH 197,003,095567,Xiao; Ming,9999,0,9999,0
1657010450595,MATH 197,004,095571,Perols; Johan Lars,9998,0,9999,1
1657010457659,COGS 9,A01,083615,Shannon; Kyle Michael,7,0,75,68
1657010463684,COGS 11,A01,083617,Boyle; Mary E. T.,20,0,48,28
1657010469708,COGS 13,A01,083071,Bastos; Amalia Pinkusfeld,9,0,71,62
1657010475732,COGS 14A,A01,092681,Semenuks; Arturs,0,1,100,100
1657010481755,COGS 14B,A01,083073,Cheng; Tzu-Han,5,0,63,58
1657010487781,COGS 17,A01,092677,Semenuks; Arturs,4,0,81,77
1657010493805,COGS 100,A01,083619,Allen; Michael Gordon,15,0,70,55
1657010499828,COGS 101A,A01,083621,Davis; Joshua Daniel,9,0,68,59
1657010505854,COGS 101B,A01,091572,Allen; Michael Gordon,8,0,65,57
1657010511880,COGS 101C,A01,083625,Delgado; Tania,17,0,35,18
1657010517905,COGS 107A,A01,083627,Boyle; Mary E. T.,13,0,60,47
1657010523931,COGS 118A,A01,083075,Gupta; Anjum,15,0,76,61
1657010529960,CSE 3,A50,083646,Miranda; Gregory Joseph,22,0,50,28
1657010535999,CSE 8A,A50,083650,Miranda; Gregory Joseph,17,1,56,39
1657010542025,CSE 11,A01,083080,Cao; Yingjun,4,15,40,36
1657010548048,CSE 12,A01,083652,Krause-Levy; Sophia Louisa,21,1,120,99
1657010554071,CSE 15L,A01,083654,Morris; Justin Loren,8,0,50,42
1657010554071,CSE 15L,A02,083655,Morris; Justin Loren,9,0,50,41
1657010560095,CSE 20,A01,083657,Tran; Khoa Dang,37,0,80,43
1657010566119,CSE 21,A01,095574,Bach; Quang Tran,21,0,48,27
1657010572147,CSE 30,A01,083084,Eldon; John,4,0,80,76
1657010572147,CSE 30,B01,095061,Bhaskar; Nishant,6,0,50,44
1657010578172,CSE 100,A01,083659,Cao; Yingjun,3,4,70,67
1657010584202,CSE 134B,A01,083661,Powell; Thomas Allan,19,0,100,81
1657010590231,CSE 140,A01,083663,Gungor; Onat,14,0,85,71
1657010596257,CSE 140L,A01,083088,Eldon; John,16,0,100,84
1657010602281,CSE 175,A01,083665,Kumar; Rakesh,3,0,25,22
1657010608311,CSE 190,A00,092507,Dubnov; Shlomo,7,0,20,13
1657010614333,ECE 45,A01,083139,Congero; Spencer William,5,0,75,70
1657010620361,ECE 65,A50,083695,Saad; Andrew S,12,0,30,18
1657010620361,ECE 65,A51,095125,Saad; Andrew S,25,0,26,1
1657010626386,ECE 109,A01,091882,Touri; Behrouz,16,0,70,54
1657010632409,ECE 180,A00,083140,Abi Samra; Nicholas Camill,1,0,30,29
1657010632409,ECE 180,B00,083141,Abi Samra; Nicholas Camill,0,0,30,30
1657010638434,MATH 10A,A01,083735,Patchell; Gregory David,1,0,30,29
1657010638434,MATH 10A,A02,083736,Patchell; Gregory David,20,0,30,10
1657010638434,MATH 10A,A03,083737,Patchell; Gregory David,16,0,30,14
1657010644470,MATH 10B,A01,083207,Lim; Seonhee,7,0,34,27
1657010644470,MATH 10B,A02,083208,Lim; Seonhee,9,0,35,26
1657010644470,MATH 10B,A03,093472,Lim; Seonhee,4,0,34,30
1657010644470,MATH 10B,B01,083739,Sinha; Shubham,9,0,30,21
1657010650503,MATH 18,A01,083743,Cinel; Cameron Alexander,6,0,30,24
1657010650503,MATH 18,A02,083744,Cinel; Cameron Alexander,15,0,30,15
1657010650503,MATH 18,A03,083745,Cinel; Cameron Alexander,8,0,30,22
1657010650503,MATH 18,B01,083748,Rideout; David Porter,4,0,37,33
1657010650503,MATH 18,B02,083749,Rideout; David Porter,3,0,36,33
1657010650503,MATH 18,B03,083750,Rideout; David Porter,2,0,37,35
1657010650503,MATH 18,B04,083751,Rideout; David Porter,5,0,36,31
1657010650503,MATH 18,B05,093473,Rideout; David Porter,4,0,36,32
1657010650503,MATH 18,B06,093474,Rideout; David Porter,5,0,36,31
1657010656529,MATH 20A,A01,083754,Zheng; Zequn,12,0,40,28
1657010662557,MATH 20B,A01,083756,Briones; Jor-el Thomas Caparas,1,0,36,35
1657010662557,MATH 20B,A02,083757,Briones; Jor-el Thomas Caparas,1,0,36,35
1657010662557,MATH 20B,A03,093475,Briones; Jor-el Thomas Caparas,0,0,36,36
1657010668581,MATH 20C,A01,083760,Briones; Jor-el Thomas Caparas,1,0,35,34
1657010668581,MATH 20C,A02,083761,Briones; Jor-el Thomas Caparas,8,0,35,27
1657010668581,MATH 20C,A03,093476,Briones; Jor-el Thomas Caparas,0,1,36,36
1657010668581,MATH 20C,B01,083762,Bach; Quang Tran,0,0,30,30
1657010674603,MATH 20D,A01,083765,Tran; Brian Kha,4,0,30,26
1657010674603,MATH 20D,A02,083766,Tran; Brian Kha,5,0,30,25
1657010674603,MATH 20D,A03,083767,Tran; Brian Kha,3,0,30,27
1657010680639,MATH 20E,A01,083771,Ganguly; Soumya,5,0,32,27
1657010680639,MATH 20E,A02,083772,Ganguly; Soumya,6,0,32,26
1657010680639,MATH 20E,B01,083773,Ciotti; Benjamin,18,0,35,17
1657010680639,MATH 20E,B02,083774,Ciotti; Benjamin,17,0,35,18
1657010686665,MATH 103A,A01,083777,Greenfeld; Be'Eri,2,0,36,34
1657010686665,MATH 103A,A02,083778,Greenfeld; Be'Eri,5,0,36,31
1657010686665,MATH 103A,A03,093561,Greenfeld; Be'Eri,4,0,36,32
1657010686665,MATH 103A,B01,083779,Greenfeld; Be'Eri,6,0,36,30
1657010686665,MATH 103A,B02,083780,Greenfeld; Be'Eri,2,0,36,34
1657010686665,MATH 103A,B03,093562,Greenfeld; Be'Eri,2,0,36,34
1657010692691,MATH 105,A01,085443,Carter; Anne Toulson,14,0,35,21
1657010692691,MATH 105,A02,093477,Carter; Anne Toulson,20,0,35,15
1657010698719,MATH 109,A01,083213,Ganzberger; Geoffrey Michael,2,0,34,32
1657010698719,MATH 109,A02,083214,Ganzberger; Geoffrey Michael,2,0,34,32
1657010698719,MATH 109,A03,093478,Ganzberger; Geoffrey Michael,1,0,34,33
1657010698719,MATH 109,B01,083215,Ganzberger; Geoffrey Michael,1,0,32,31
1657010698719,MATH 109,B02,083216,Ganzberger; Geoffrey Michael,1,0,32,31
1657010698719,MATH 109,B03,093479,Ganzberger; Geoffrey Michael,6,0,32,26
1657010704742,MATH 142A,A01,083219,Chow; Bennett,6,0,32,26
1657010704742,MATH 142A,A02,083220,Chow; Bennett,10,0,32,22
1657010704742,MATH 142A,A03,093480,Chow; Bennett,7,0,32,25
1657010704742,MATH 142A,B03,093481,Chow; Bennett,7,0,32,25
1657010704742,MATH 142A,B04,093558,Chow; Bennett,11,0,32,21
1657010704742,MATH 142A,B05,093559,Chow; Bennett,6,0,32,26
1657010710769,MATH 193A,A01,083224,Rotar; Vladimir,7,0,34,27
1657010710769,MATH 193A,A02,083225,Rotar; Vladimir,4,0,34,30
1657010710769,MATH 193A,A03,083781,Rotar; Vladimir,1,0,34,33
1657010710769,MATH 193A,A04,083782,Rotar; Vladimir,6,0,34,28
1657010710769,MATH 193A,A05,093482,Rotar; Vladimir,6,0,34,28
1657010716796,MATH 197,001,091859,McAuley; Julian John,9999,0,9999,0
1657010716796,MATH 197,002,095566,Kedlaya; Kiran S.,9997,0,9999,2
1657010716796,MATH 197,003,095567,Xiao; Ming,9999,0,9999,0
1657010716796,MATH 197,004,095571,Perols; Johan Lars,9998,0,9999,1
1657010723864,COGS 9,A01,083615,Shannon; Kyle Michael,7,0,75,68
1657010729889,COGS 11,A01,083617,Boyle; Mary E. T.,20,0,48,28
1657010735912,COGS 13,A01,083071,Bastos; Amalia Pinkusfeld,9,0,71,62
1657010741935,COGS 14A,A01,092681,Semenuks; Arturs,0,1,100,100
1657010747964,COGS 14B,A01,083073,Cheng; Tzu-Han,5,0,63,58
1657010753988,COGS 17,A01,092677,Semenuks; Arturs,4,0,81,77
1657010760017,COGS 100,A01,083619,Allen; Michael Gordon,15,0,70,55
1657010766049,COGS 101A,A01,083621,Davis; Joshua Daniel,9,0,68,59
1657010772076,COGS 101B,A01,091572,Allen; Michael Gordon,8,0,65,57
1657010778109,COGS 101C,A01,083625,Delgado; Tania,17,0,35,18
1657010784137,COGS 107A,A01,083627,Boyle; Mary E. T.,13,0,60,47
1657010790169,COGS 118A,A01,083075,Gupta; Anjum,15,0,76,61
1657010796199,CSE 3,A50,083646,Miranda; Gregory Joseph,22,0,50,28
1657010802223,CSE 8A,A50,083650,Miranda; Gregory Joseph,17,1,56,39
1657010808247,CSE 11,A01,083080,Cao; Yingjun,4,15,40,36
1657010814272,CSE 12,A01,083652,Krause-Levy; Sophia Louisa,21,1,120,99
1657010820296,CSE 15L,A01,083654,Morris; Justin Loren,8,0,50,42
1657010820296,CSE 15L,A02,083655,Morris; Justin Loren,9,0,50,41
1657010826320,CSE 20,A01,083657,Tran; Khoa Dang,37,0,80,43
1657010832350,CSE 21,A01,095574,Bach; Quang Tran,21,0,48,27
1657010838387,CSE 30,A01,083084,Eldon; John,4,0,80,76
1657010838387,CSE 30,B01,095061,Bhaskar; Nishant,6,0,50,44
1657010844482,CSE 100,A01,083659,Cao; Yingjun,3,4,70,67
1657010850510,CSE 134B,A01,083661,Powell; Thomas Allan,19,0,100,81
1657010856536,CSE 140,A01,083663,Gungor; Onat,14,0,85,71
1657010862561,CSE 140L,A01,083088,Eldon; John,16,0,100,84
1657010868590,CSE 175,A01,083665,Kumar; Rakesh,3,0,25,22
1657010874621,CSE 190,A00,092507,Dubnov; Shlomo,7,0,20,13
1657010880647,ECE 45,A01,083139,Congero; Spencer William,5,0,75,70
1657010886672,ECE 65,A50,083695,Saad; Andrew S,12,0,30,18
1657010886672,ECE 65,A51,095125,Saad; Andrew S,25,0,26,1
1657010892697,ECE 109,A01,091882,Touri; Behrouz,16,0,70,54
1657010898724,ECE 180,A00,083140,Abi Samra; Nicholas Camill,1,0,30,29
1657010898724,ECE 180,B00,083141,Abi Samra; Nicholas Camill,0,0,30,30
1657010904750,MATH 10A,A01,083735,Patchell; Gregory David,1,0,30,29
1657010904750,MATH 10A,A02,083736,Patchell; Gregory David,20,0,30,10
1657010904750,MATH 10A,A03,083737,Patchell; Gregory David,16,0,30,14
1657010910777,MATH 10B,A01,083207,Lim; Seonhee,7,0,34,27
1657010910777,MATH 10B,A02,083208,Lim; Seonhee,9,0,35,26
1657010910777,MATH 10B,A03,093472,Lim; Seonhee,4,0,34,30
1657010910777,MATH 10B,B01,083739,Sinha; Shubham,9,0,30,21
1657010916803,MATH 18,A01,083743,Cinel; Cameron Alexander,6,0,30,24
1657010916803,MATH 18,A02,083744,Cinel; Cameron Alexander,15,0,30,15
1657010916803,MATH 18,A03,083745,Cinel; Cameron Alexander,8,0,30,22
1657010916803,MATH 18,B01,083748,Rideout; David Porter,4,0,37,33
1657010916803,MATH 18,B02,083749,Rideout; David Porter,3,0,36,33
1657010916803,MATH 18,B03,083750,Rideout; David Porter,2,0,37,35
1657010916803,MATH 18,B04,083751,Rideout; David Porter,5,0,36,31
1657010916803,MATH 18,B05,093473,Rideout; David Porter,4,0,36,32
1657010916803,MATH 18,B06,093474,Rideout; David Porter,5,0,36,31
1657010922830,MATH 20A,A01,083754,Zheng; Zequn,12,0,40,28
1657010928859,MATH 20B,A01,083756,Briones; Jor-el Thomas Caparas,1,0,36,35
1657010928859,MATH 20B,A02,083757,Briones; Jor-el Thomas Caparas,1,0,36,35
1657010928859,MATH 20B,A03,093475,Briones; Jor-el Thomas Caparas,0,0,36,36
1657010934883,MATH 20C,A01,083760,Briones; Jor-el Thomas Caparas,1,0,35,34
1657010934883,MATH 20C,A02,083761,Briones; Jor-el Thomas Caparas,8,0,35,27
1657010934883,MATH 20C,A03,093476,Briones; Jor-el Thomas Caparas,0,1,36,36
1657010934883,MATH 20C,B01,083762,Bach; Quang Tran,0,0,30,30
1657010940915,MATH 20D,A01,083765,Tran; Brian Kha,4,0,30,26
1657010940915,MATH 20D,A02,083766,Tran; Brian Kha,5,0,30,25
1657010940915,MATH 20D,A03,083767,Tran; Brian Kha,3,0,30,27
1657010946940,MATH 20E,A01,083771,Ganguly; Soumya,5,0,32,27
1657010946940,MATH 20E,A02,083772,Ganguly; Soumya,6,0,32,26
1657010946940,MATH 20E,B01,083773,Ciotti; Benjamin,18,0,35,17
1657010946940,MATH 20E,B02,083774,Ciotti; Benjamin,17,0,35,18
1657010952967,MATH 103A,A01,083777,Greenfeld; Be'Eri,2,0,36,34
1657010952967,MATH 103A,A02,083778,Greenfeld; Be'Eri,5,0,36,31
1657010952967,MATH 103A,A03,093561,Greenfeld; Be'Eri,4,0,36,32
1657010952967,MATH 103A,B01,083779,Greenfeld; Be'Eri,6,0,36,30
1657010952967,MATH 103A,B02,083780,Greenfeld; Be'Eri,2,0,36,34
1657010952967,MATH 103A,B03,093562,Greenfeld; Be'Eri,2,0,36,34
1657010958990,MATH 105,A01,085443,Carter; Anne Toulson,14,0,35,21
1657010958990,MATH 105,A02,093477,Carter; Anne Toulson,20,0,35,15
1657010965019,MATH 109,A01,083213,Ganzberger; Geoffrey Michael,2,0,34,32
1657010965019,MATH 109,A02,083214,Ganzberger; Geoffrey Michael,2,0,34,32
1657010965019,MATH 109,A03,093478,Ganzberger; Geoffrey Michael,1,0,34,33
1657010965019,MATH 109,B01,083215,Ganzberger; Geoffrey Michael,1,0,32,31
1657010965019,MATH 109,B02,083216,Ganzberger; Geoffrey Michael,1,0,32,31
1657010965019,MATH 109,B03,093479,Ganzberger; Geoffrey Michael,6,0,32,26
1657010971045,MATH 142A,A01,083219,Chow; Bennett,6,0,32,26
1657010971045,MATH 142A,A02,083220,Chow; Bennett,10,0,32,22
1657010971045,MATH 142A,A03,093480,Chow; Bennett,7,0,32,25
1657010971045,MATH 142A,B03,093481,Chow; Bennett,7,0,32,25
1657010971045,MATH 142A,B04,093558,Chow; Bennett,11,0,32,21
1657010971045,MATH 142A,B05,093559,Chow; Bennett,6,0,32,26
1657010977071,MATH 193A,A01,083224,Rotar; Vladimir,7,0,34,27
1657010977071,MATH 193A,A02,083225,Rotar; Vladimir,4,0,34,30
1657010977071,MATH 193A,A03,083781,Rotar; Vladimir,1,0,34,33
1657010977071,MATH 193A,A04,083782,Rotar; Vladimir,6,0,34,28
1657010977071,MATH 193A,A05,093482,Rotar; Vladimir,6,0,34,28
1657010983094,MATH 197,001,091859,McAuley; Julian John,9999,0,9999,0
1657010983094,MATH 197,002,095566,Kedlaya; Kiran S.,9997,0,9999,2
1657010983094,MATH 197,003,095567,Xiao; Ming,9999,0,9999,0
1657010983094,MATH 197,004,095571,Perols; Johan Lars,9998,0,9999,1
1657010990159,COGS 9,A01,083615,Shannon; Kyle Michael,7,0,75,68
1657010996185,COGS 11,A01,083617,Boyle; Mary E. T.,20,0,48,28
1657011002214,COGS 13,A01,083071,Bastos; Amalia Pinkusfeld,9,0,71,62
1657011008242,COGS 14A,A01,092681,Semenuks; Arturs,0,1,100,100
1657011014269,COGS 14B,A01,083073,Cheng; Tzu-Han,5,0,63,58
1657011020305,COGS 17,A01,092677,Semenuks; Arturs,4,0,81,77
1657011026334,COGS 100,A01,083619,Allen; Michael Gordon,15,0,70,55
1657011032358,COGS 101A,A01,083621,Davis; Joshua Daniel,9,0,68,59
1657011038380,COGS 101B,A01,091572,Allen; Michael Gordon,8,0,65,57
1657011044423,COGS 101C,A01,083625,Delgado; Tania,17,0,35,18
1657011050447,COGS 107A,A01,083627,Boyle; Mary E. T.,13,0,60,47
1657011056473,COGS 118A,A01,083075,Gupta; Anjum,15,0,76,61
1657011062503,CSE 3,A50,083646,Miranda; Gregory Joseph,22,0,50,28
1657011068533,CSE 8A,A50,083650,Miranda; Gregory Joseph,17,1,56,39
1657011074557,CSE 11,A01,083080,Cao; Yingjun,4,15,40,36
1657011080586,CSE 12,A01,083652,Krause-Levy; Sophia Louisa,21,1,120,99
1657011086611,CSE 15L,A01,083654,Morris; Justin Loren,8,0,50,42
1657011086611,CSE 15L,A02,083655,Morris; Justin Loren,9,0,50,41
1657011092634,CSE 20,A01,083657,Tran; Khoa Dang,37,0,80,43
1657011098660,CSE 21,A01,095574,Bach; Quang Tran,21,0,48,27
1657011104690,CSE 30,A01,083084,Eldon; John,4,0,80,76
1657011104690,CSE 30,B01,095061,Bhaskar; Nishant,6,0,50,44
1657011110719,CSE 100,A01,083659,Cao; Yingjun,3,4,70,67
1657011116743,CSE 134B,A01,083661,Powell; Thomas Allan,19,0,100,81
1657011122767,CSE 140,A01,083663,Gungor; Onat,14,0,85,71
1657011128791,CSE 140L,A01,083088,Eldon; John,16,0,100,84
1657011134820,CSE 175,A01,083665,Kumar; Rakesh,3,0,25,22
1657011140845,CSE 190,A00,092507,Dubnov; Shlomo,7,0,20,13
1657011146872,ECE 45,A01,083139,Congero; Spencer William,5,0,75,70
1657011152899,ECE 65,A50,083695,Saad; Andrew S,12,0,30,18
1657011152899,ECE 65,A51,095125,Saad; Andrew S,25,0,26,1
1657011158937,ECE 109,A01,091882,Touri; Behrouz,16,0,70,54
1657011164965,ECE 180,A00,083140,Abi Samra; Nicholas Camill,1,0,30,29
1657011164965,ECE 180,B00,083141,Abi Samra; Nicholas Camill,0,0,30,30
1657011170997,MATH 10A,A01,083735,Patchell; Gregory David,1,0,30,29
1657011170997,MATH 10A,A02,083736,Patchell; Gregory David,20,0,30,10
1657011170997,MATH 10A,A03,083737,Patchell; Gregory David,16,0,30,14
1657011177028,MATH 10B,A01,083207,Lim; Seonhee,7,0,34,27
1657011177028,MATH 10B,A02,083208,Lim; Seonhee,9,0,35,26
1657011177028,MATH 10B,A03,093472,Lim; Seonhee,4,0,34,30
1657011177028,MATH 10B,B01,083739,Sinha; Shubham,9,0,30,21
1657011183057,MATH 18,A01,083743,Cinel; Cameron Alexander,6,0,30,24
1657011183057,MATH 18,A02,083744,Cinel; Cameron Alexander,15,0,30,15
1657011183057,MATH 18,A03,083745,Cinel; Cameron Alexander,8,0,30,22
1657011183057,MATH 18,B01,083748,Rideout; David Porter,4,0,37,33
1657011183057,MATH 18,B02,083749,Rideout; David Porter,3,0,36,33
1657011183057,MATH 18,B03,083750,Rideout; David Porter,2,0,37,35
1657011183057,MATH 18,B04,083751,Rideout; David Porter,5,0,36,31
1657011183057,MATH 18,B05,093473,Rideout; David Porter,4,0,36,32
1657011183057,MATH 18,B06,093474,Rideout; David Porter,5,0,36,31
1657011189085,MATH 20A,A01,083754,Zheng; Zequn,12,0,40,28
1657011195114,MATH 20B,A01,083756,Briones; Jor-el Thomas Caparas,1,0,36,35
1657011195114,MATH 20B,A02,083757,Briones; Jor-el Thomas Caparas,1,0,36,35
1657011195114,MATH 20B,A03,093475,Briones; Jor-el Thomas Caparas,0,0,36,36
1657011201140,MATH 20C,A01,083760,Briones; Jor-el Thomas Caparas,1,0,35,34
1657011201140,MATH 20C,A02,083761,Briones; Jor-el Thomas Caparas,8,0,35,27
1657011201140,MATH 20C,A03,093476,Briones; Jor-el Thomas Caparas,0,1,36,36
1657011201140,MATH 20C,B01,083762,Bach; Quang Tran,0,0,30,30
1657011207174,MATH 20D,A01,083765,Tran; Brian Kha,4,0,30,26
1657011207174,MATH 20D,A02,083766,Tran; Brian Kha,5,0,30,25
1657011207174,MATH 20D,A03,083767,Tran; Brian Kha,3,0,30,27
1657011213200,MATH 20E,A01,083771,Ganguly; Soumya,5,0,32,27
1657011213200,MATH 20E,A02,083772,Ganguly; Soumya,6,0,32,26
1657011213200,MATH 20E,B01,083773,Ciotti; Benjamin,18,0,35,17
1657011213200,MATH 20E,B02,083774,Ciotti; Benjamin,17,0,35,18
1657011219235,MATH 103A,A01,083777,Greenfeld; Be'Eri,2,0,36,34
1657011219235,MATH 103A,A02,083778,Greenfeld; Be'Eri,5,0,36,31
1657011219235,MATH 103A,A03,093561,Greenfeld; Be'Eri,4,0,36,32
1657011219235,MATH 103A,B01,083779,Greenfeld; Be'Eri,6,0,36,30
1657011219235,MATH 103A,B02,083780,Greenfeld; Be'Eri,2,0,36,34
1657011219235,MATH 103A,B03,093562,Greenfeld; Be'Eri,2,0,36,34
1657011225260,MATH 105,A01,085443,Carter; Anne Toulson,14,0,35,21
1657011225260,MATH 105,A02,093477,Carter; Anne Toulson,20,0,35,15
1657011231293,MATH 109,A01,083213,Ganzberger; Geoffrey Michael,2,0,34,32
1657011231293,MATH 109,A02,083214,Ganzberger; Geoffrey Michael,2,0,34,32
1657011231293,MATH 109,A03,093478,Ganzberger; Geoffrey Michael,1,0,34,33
1657011231293,MATH 109,B01,083215,Ganzberger; Geoffrey Michael,1,0,32,31
1657011231293,MATH 109,B02,083216,Ganzberger; Geoffrey Michael,1,0,32,31
1657011231293,MATH 109,B03,093479,Ganzberger; Geoffrey Michael,6,0,32,26
1657011237325,MATH 142A,A01,083219,Chow; Bennett,6,0,32,26
1657011237325,MATH 142A,A02,083220,Chow; Bennett,10,0,32,22
1657011237325,MATH 142A,A03,093480,Chow; Bennett,7,0,32,25
1657011237325,MATH 142A,B03,093481,Chow; Bennett,7,0,32,25
1657011237325,MATH 142A,B04,093558,Chow; Bennett,11,0,32,21
1657011237325,MATH 142A,B05,093559,Chow; Bennett,6,0,32,26
1657011243352,MATH 193A,A01,083224,Rotar; Vladimir,7,0,34,27
1657011243352,MATH 193A,A02,083225,Rotar; Vladimir,4,0,34,30
1657011243352,MATH 193A,A03,083781,Rotar; Vladimir,1,0,34,33
1657011243352,MATH 193A,A04,083782,Rotar; Vladimir,6,0,34,28
1657011243352,MATH 193A,A05,093482,Rotar; Vladimir,6,0,34,28
1657011249383,MATH 197,001,091859,McAuley; Julian John,9999,0,9999,0
1657011249383,MATH 197,002,095566,Kedlaya; Kiran S.,9997,0,9999,2
1657011249383,MATH 197,003,095567,Xiao; Ming,9999,0,9999,0
1657011249383,MATH 197,004,095571,Perols; Johan Lars,9998,0,9999,1
1657011256482,COGS 9,A01,083615,Shannon; Kyle Michael,7,0,75,68
1657011262507,COGS 11,A01,083617,Boyle; Mary E. T.,20,0,48,28
1657011268540,COGS 13,A01,083071,Bastos; Amalia Pinkusfeld,9,0,71,62
1657011274569,COGS 14A,A01,092681,Semenuks; Arturs,0,1,100,100
1657011280597,COGS 14B,A01,083073,Cheng; Tzu-Han,5,0,63,58
1657011286623,COGS 17,A01,092677,Semenuks; Arturs,4,0,81,77
1657011292648,COGS 100,A01,083619,Allen; Michael Gordon,15,0,70,55
1657011298677,COGS 101A,A01,083621,Davis; Joshua Daniel,9,0,68,59
1657011304709,COGS 101B,A01,091572,Allen; Michael Gordon,8,0,65,57
1657011310734,COGS 101C,A01,083625,Delgado; Tania,17,0,35,18
1657011316758,COGS 107A,A01,083627,Boyle; Mary E. T.,13,0,60,47
1657011322787,COGS 118A,A01,083075,Gupta; Anjum,15,0,76,61
1657011328821,CSE 3,A50,083646,Miranda; Gregory Joseph,22,0,50,28
1657011334845,CSE 8A,A50,083650,Miranda; Gregory Joseph,17,1,56,39
1657011340869,CSE 11,A01,083080,Cao; Yingjun,4,15,40,36
1657011346893,CSE 12,A01,083652,Krause-Levy; Sophia Louisa,21,1,120,99
1657011352924,CSE 15L,A01,083654,Morris; Justin Loren,8,0,50,42
1657011352924,CSE 15L,A02,083655,Morris; Justin Loren,9,0,50,41
1657011358953,CSE 20,A01,083657,Tran; Khoa Dang,37,0,80,43
1657011364983,CSE 21,A01,095574,Bach; Quang Tran,21,0,48,27
1657011371023,CSE 30,A01,083084,Eldon; John,4,0,80,76
1657011371023,CSE 30,B01,095061,Bhaskar; Nishant,6,0,50,44
1657011377047,CSE 100,A01,083659,Cao; Yingjun,3,4,70,67
1657011383071,CSE 134B,A01,083661,Powell; Thomas Allan,19,0,100,81
1657011389100,CSE 140,A01,083663,Gungor; Onat,14,0,85,71
1657011395138,CSE 140L,A01,083088,Eldon; John,16,0,100,84
1657011401169,CSE 175,A01,083665,Kumar; Rakesh,3,0,25,22
1657011407195,CSE 190,A00,092507,Dubnov; Shlomo,7,0,20,13
1657011413223,ECE 45,A01,083139,Congero; Spencer William,5,0,75,70
1657011419252,ECE 65,A50,083695,Saad; Andrew S,12,0,30,18
1657011419252,ECE 65,A51,095125,Saad; Andrew S,25,0,26,1
1657011425291,ECE 109,A01,091882,Touri; Behrouz,16,0,70,54
1657011431314,ECE 180,A00,083140,Abi Samra; Nicholas Camill,1,0,30,29
1657011431314,ECE 180,B00,083141,Abi Samra; Nicholas Camill,0,0,30,30
1657011437351,MATH 10A,A01,083735,Patchell; Gregory David,1,0,30,29
1657011437351,MATH 10A,A02,083736,Patchell; Gregory David,20,0,30,10
1657011437351,MATH 10A,A03,083737,Patchell; Gregory David,16,0,30,14
1657011443449,MATH 10B,A01,083207,Lim; Seonhee,7,0,34,27
1657011443449,MATH 10B,A02,083208,Lim; Seonhee,9,0,35,26
1657011443449,MATH 10B,A03,093472,Lim; Seonhee,4,0,34,30
1657011443449,MATH 10B,B01,083739,Sinha; Shubham,9,0,30,21
1657011449489,MATH 18,A01,083743,Cinel; Cameron Alexander,6,0,30,24
1657011449489,MATH 18,A02,083744,Cinel; Cameron Alexander,15,0,30,15
1657011449489,MATH 18,A03,083745,Cinel; Cameron Alexander,8,0,30,22
1657011449489,MATH 18,B01,083748,Rideout; David Porter,4,0,37,33
1657011449489,MATH 18,B02,083749,Rideout; David Porter,3,0,36,33
1657011449489,MATH 18,B03,083750,Rideout; David Porter,2,0,37,35
1657011449489,MATH 18,B04,083751,Rideout; David Porter,5,0,36,31
1657011449489,MATH 18,B05,093473,Rideout; David Porter,4,0,36,32
1657011449489,MATH 18,B06,093474,Rideout; David Porter,5,0,36,31
1657011455519,MATH 20A,A01,083754,Zheng; Zequn,12,0,40,28
1657011461553,MATH 20B,A01,083756,Briones; Jor-el Thomas Caparas,1,0,36,35
1657011461553,MATH 20B,A02,083757,Briones; Jor-el Thomas Caparas,1,0,36,35
1657011461553,MATH 20B,A03,093475,Briones; Jor-el Thomas Caparas,0,0,36,36
1657011467580,MATH 20C,A01,083760,Briones; Jor-el Thomas Caparas,1,0,35,34
1657011467580,MATH 20C,A02,083761,Briones; Jor-el Thomas Caparas,8,0,35,27
1657011467580,MATH 20C,A03,093476,Briones; Jor-el Thomas Caparas,0,1,36,36
1657011467580,MATH 20C,B01,083762,Bach; Quang Tran,0,0,30,30
1657011473616,MATH 20D,A01,083765,Tran; Brian Kha,4,0,30,26
1657011473616,MATH 20D,A02,083766,Tran; Brian Kha,5,0,30,25
1657011473616,MATH 20D,A03,083767,Tran; Brian Kha,3,0,30,27
1657011479642,MATH 20E,A01,083771,Ganguly; Soumya,5,0,32,27
1657011479642,MATH 20E,A02,083772,Ganguly; Soumya,6,0,32,26
1657011479642,MATH 20E,B01,083773,Ciotti; Benjamin,18,0,35,17
1657011479642,MATH 20E,B02,083774,Ciotti; Benjamin,17,0,35,18
1657011485670,MATH 103A,A01,083777,Greenfeld; Be'Eri,2,0,36,34
1657011485670,MATH 103A,A02,083778,Greenfeld; Be'Eri,5,0,36,31
1657011485670,MATH 103A,A03,093561,Greenfeld; Be'Eri,4,0,36,32
1657011485670,MATH 103A,B01,083779,Greenfeld; Be'Eri,6,0,36,30
1657011485670,MATH 103A,B02,083780,Greenfeld; Be'Eri,2,0,36,34
1657011485670,MATH 103A,B03,093562,Greenfeld; Be'Eri,2,0,36,34
1657011491697,MATH 105,A01,085443,Carter; Anne Toulson,14,0,35,21
1657011491697,MATH 105,A02,093477,Carter; Anne Toulson,20,0,35,15
1657011497730,MATH 109,A01,083213,Ganzberger; Geoffrey Michael,2,0,34,32
1657011497730,MATH 109,A02,083214,Ganzberger; Geoffrey Michael,2,0,34,32
1657011497730,MATH 109,A03,093478,Ganzberger; Geoffrey Michael,1,0,34,33
1657011497730,MATH 109,B01,083215,Ganzberger; Geoffrey Michael,1,0,32,31
1657011497730,MATH 109,B02,083216,Ganzberger; Geoffrey Michael,1,0,32,31
1657011497730,MATH 109,B03,093479,Ganzberger; Geoffrey Michael,6,0,32,26
1657011503756,MATH 142A,A01,083219,Chow; Bennett,6,0,32,26
1657011503756,MATH 142A,A02,083220,Chow; Bennett,10,0,32,22
1657011503756,MATH 142A,A03,093480,Chow; Bennett,7,0,32,25
1657011503756,MATH 142A,B03,093481,Chow; Bennett,7,0,32,25
1657011503756,MATH 142A,B04,093558,Chow; Bennett,11,0,32,21
1657011503756,MATH 142A,B05,093559,Chow; Bennett,6,0,32,26
1657011509781,MATH 193A,A01,083224,Rotar; Vladimir,7,0,34,27
1657011509781,MATH 193A,A02,083225,Rotar; Vladimir,4,0,34,30
1657011509781,MATH 193A,A03,083781,Rotar; Vladimir,1,0,34,33
1657011509781,MATH 193A,A04,083782,Rotar; Vladimir,6,0,34,28
1657011509781,MATH 193A,A05,093482,Rotar; Vladimir,6,0,34,28
1657011515813,MATH 197,001,091859,McAuley; Julian John,9999,0,9999,0
1657011515813,MATH 197,002,095566,Kedlaya; Kiran S.,9997,0,9999,2
1657011515813,MATH 197,003,095567,Xiao; Ming,9999,0,9999,0
1657011515813,MATH 197,004,095571,Perols; Johan Lars,9998,0,9999,1
1657011522917,COGS 9,A01,083615,Shannon; Kyle Michael,7,0,75,68
1657011528952,COGS 11,A01,083617,Boyle; Mary E. T.,20,0,48,28
1657011534979,COGS 13,A01,083071,Bastos; Amalia Pinkusfeld,9,0,71,62
1657011541004,COGS 14A,A01,092681,Semenuks; Arturs,0,1,100,100
1657011547031,COGS 14B,A01,083073,Cheng; Tzu-Han,5,0,63,58
1657011553055,COGS 17,A01,092677,Semenuks; Arturs,4,0,81,77
1657011559082,COGS 100,A01,083619,Allen; Michael Gordon,15,0,70,55
1657011565112,COGS 101A,A01,083621,Davis; Joshua Daniel,9,0,68,59
1657011571137,COGS 101B,A01,091572,Allen; Michael Gordon,8,0,65,57
1657011577173,COGS 101C,A01,083625,Delgado; Tania,17,0,35,18
1657011583202,COGS 107A,A01,083627,Boyle; Mary E. T.,13,0,60,47
1657011589227,COGS 118A,A01,083075,Gupta; Anjum,15,0,76,61
1657011595254,CSE 3,A50,083646,Miranda; Gregory Joseph,22,0,50,28
1657011601283,CSE 8A,A50,083650,Miranda; Gregory Joseph,17,1,56,39
1657011607312,CSE 11,A01,083080,Cao; Yingjun,4,15,40,36
1657011613337,CSE 12,A01,083652,Krause-Levy; Sophia Louisa,21,1,120,99
1657011619369,CSE 15L,A01,083654,Morris; Justin Loren,8,0,50,42
1657011619369,CSE 15L,A02,083655,Morris; Justin Loren,9,0,50,41
1657011625405,CSE 20,A01,083657,Tran; Khoa Dang,37,0,80,43
1657011631431,CSE 21,A01,095574,Bach; Quang Tran,21,0,48,27
1657011637465,CSE 30,A01,083084,Eldon; John,4,0,80,76
1657011637465,CSE 30,B01,095061,Bhaskar; Nishant,6,0,50,44
1657011643495,CSE 100,A01,083659,Cao; Yingjun,3,4,70,67
1657011649521,CSE 134B,A01,083661,Powell; Thomas Allan,19,0,100,81
1657011655546,CSE 140,A01,083663,Gungor; Onat,14,0,85,71
1657011661570,CSE 140L,A01,083088,Eldon; John,16,0,100,84
1657011667595,CSE 175,A01,083665,Kumar; Rakesh,3,0,25,22
1657011673625,CSE 190,A00,092507,Dubnov; Shlomo,7,0,20,13
1657011679652,ECE 45,A01,083139,Congero; Spencer William,5,0,75,70
1657011685681,ECE 65,A50,083695,Saad; Andrew S,12,0,30,18
1657011685681,ECE 65,A51,095125,Saad; Andrew S,25,0,26,1
1657011691705,ECE 109,A01,091882,Touri; Behrouz,16,0,70,54
1657011697733,ECE 180,A00,083140,Abi Samra; Nicholas Camill,1,0,30,29
1657011697733,ECE 180,B00,083141,Abi Samra; Nicholas Camill,0,0,30,30
1657011703763,MATH 10A,A01,083735,Patchell; Gregory David,1,0,30,29
1657011703763,MATH 10A,A02,083736,Patchell; Gregory David,20,0,30,10
1657011703763,MATH 10A,A03,083737,Patchell; Gregory David,16,0,30,14
1657011709800,MATH 10B,A01,083207,Lim; Seonhee,7,0,34,27
1657011709800,MATH 10B,A02,083208,Lim; Seonhee,9,0,35,26
1657011709800,MATH 10B,A03,093472,Lim; Seonhee,4,0,34,30
1657011709800,MATH 10B,B01,083739,Sinha; Shubham,9,0,30,21
1657011715826,MATH 18,A01,083743,Cinel; Cameron Alexander,6,0,30,24
1657011715826,MATH 18,A02,083744,Cinel; Cameron Alexander,15,0,30,15
1657011715826,MATH 18,A03,083745,Cinel; Cameron Alexander,8,0,30,22
1657011715826,MATH 18,B01,083748,Rideout; David Porter,4,0,37,33
1657011715826,MATH 18,B02,083749,Rideout; David Porter,3,0,36,33
1657011715826,MATH 18,B03,083750,Rideout; David Porter,2,0,37,35
1657011715826,MATH 18,B04,083751,Rideout; David Porter,5,0,36,31
1657011715826,MATH 18,B05,093473,Rideout; David Porter,4,0,36,32
1657011715826,MATH 18,B06,093474,Rideout; David Porter,5,0,36,31
1657011721851,MATH 20A,A01,083754,Zheng; Zequn,12,0,40,28
1657011727874,MATH 20B,A01,083756,Briones; Jor-el Thomas Caparas,1,0,36,35
1657011727874,MATH 20B,A02,083757,Briones; Jor-el Thomas Caparas,1,0,36,35
1657011727874,MATH 20B,A03,093475,Briones; Jor-el Thomas Caparas,0,0,36,36
1657011733900,MATH 20C,A01,083760,Briones; Jor-el Thomas Caparas,1,0,35,34
1657011733900,MATH 20C,A02,083761,Briones; Jor-el Thomas Caparas,8,0,35,27
1657011733900,MATH 20C,A03,093476,Briones; Jor-el Thomas Caparas,0,1,36,36
1657011733900,MATH 20C,B01,083762,Bach; Quang Tran,0,0,30,30
1657011739927,MATH 20D,A01,083765,Tran; Brian Kha,4,0,30,26
1657011739927,MATH 20D,A02,083766,Tran; Brian Kha,5,0,30,25
1657011739927,MATH 20D,A03,083767,Tran; Brian Kha,3,0,30,27
1657011745953,MATH 20E,A01,083771,Ganguly; Soumya,5,0,32,27
1657011745953,MATH 20E,A02,083772,Ganguly; Soumya,6,0,32,26
1657011745953,MATH 20E,B01,083773,Ciotti; Benjamin,18,0,35,17
1657011745953,MATH 20E,B02,083774,Ciotti; Benjamin,17,0,35,18
1657011751980,MATH 103A,A01,083777,Greenfeld; Be'Eri,2,0,36,34
1657011751980,MATH 103A,A02,083778,Greenfeld; Be'Eri,5,0,36,31
1657011751980,MATH 103A,A03,093561,Greenfeld; Be'Eri,4,0,36,32
1657011751980,MATH 103A,B01,083779,Greenfeld; Be'Eri,6,0,36,30
1657011751980,MATH 103A,B02,083780,Greenfeld; Be'Eri,2,0,36,34
1657011751980,MATH 103A,B03,093562,Greenfeld; Be'Eri,2,0,36,34
1657011762024,MATH 105,A01,085443,Carter; Anne Toulson,14,0,35,21
1657011762024,MATH 105,A02,093477,Carter; Anne Toulson,20,0,35,15
1657011768049,MATH 109,A01,083213,Ganzberger; Geoffrey Michael,2,0,34,32
1657011768049,MATH 109,A02,083214,Ganzberger; Geoffrey Michael,2,0,34,32
1657011768049,MATH 109,A03,093478,Ganzberger; Geoffrey Michael,1,0,34,33
1657011768049,MATH 109,B01,083215,Ganzberger; Geoffrey Michael,1,0,32,31
1657011768049,MATH 109,B02,083216,Ganzberger; Geoffrey Michael,1,0,32,31
1657011768049,MATH 109,B03,093479,Ganzberger; Geoffrey Michael,6,0,32,26
1657011774076,MATH 142A,A01,083219,Chow; Bennett,6,0,32,26
1657011774076,MATH 142A,A02,083220,Chow; Bennett,10,0,32,22
1657011774076,MATH 142A,A03,093480,Chow; Bennett,7,0,32,25
1657011774076,MATH 142A,B03,093481,Chow; Bennett,7,0,32,25
1657011774076,MATH 142A,B04,093558,Chow; Bennett,11,0,32,21
1657011774076,MATH 142A,B05,093559,Chow; Bennett,6,0,32,26
1657011780100,MATH 193A,A01,083224,Rotar; Vladimir,7,0,34,27
1657011780100,MATH 193A,A02,083225,Rotar; Vladimir,4,0,34,30
1657011780100,MATH 193A,A03,083781,Rotar; Vladimir,1,0,34,33
1657011780100,MATH 193A,A04,083782,Rotar; Vladimir,6,0,34,28
1657011780100,MATH 193A,A05,093482,Rotar; Vladimir,6,0,34,28
1657011786129,MATH 197,001,091859,McAuley; Julian John,9999,0,9999,0
1657011786129,MATH 197,002,095566,Kedlaya; Kiran S.,9997,0,9999,2
1657011786129,MATH 197,003,095567,Xiao; Ming,9999,0,9999,0
1657011786129,MATH 197,004,095571,Perols; Johan Lars,9998,0,9999,1
1657011793198,COGS 9,A01,083615,Shannon; Kyle Michael,7,0,75,68
1657011799222,COGS 11,A01,083617,Boyle; Mary E. T.,20,0,48,28
1657011805245,COGS 13,A01,083071,Bastos; Amalia Pinkusfeld,9,0,71,62
1657011811276,COGS 14A,A01,092681,Semenuks; Arturs,0,1,100,100
1657011817299,COGS 14B,A01,083073,Cheng; Tzu-Han,5,0,63,58
1657011823322,COGS 17,A01,092677,Semenuks; Arturs,4,0,81,77
1657011829356,COGS 100,A01,083619,Allen; Michael Gordon,15,0,70,55
1657011835385,COGS 101A,A01,083621,Davis; Joshua Daniel,9,0,68,59
1657011841409,COGS 101B,A01,091572,Allen; Michael Gordon,8,0,65,57
1657011847433,COGS 101C,A01,083625,Delgado; Tania,17,0,35,18
1657011853456,COGS 107A,A01,083627,Boyle; Mary E. T.,13,0,60,47
1657011859485,COGS 118A,A01,083075,Gupta; Anjum,15,0,76,61
1657011865510,CSE 3,A50,083646,Miranda; Gregory Joseph,22,0,50,28
1657011871533,CSE 8A,A50,083650,Miranda; Gregory Joseph,17,1,56,39
1657011877556,CSE 11,A01,083080,Cao; Yingjun,4,15,40,36
1657011883581,CSE 12,A01,083652,Krause-Levy; Sophia Louisa,21,1,120,99
1657011889605,CSE 15L,A01,083654,Morris; Justin Loren,8,0,50,42
1657011889605,CSE 15L,A02,083655,Morris; Justin Loren,9,0,50,41
1657011895633,CSE 20,A01,083657,Tran; Khoa Dang,37,0,80,43
1657011901661,CSE 21,A01,095574,Bach; Quang Tran,21,0,48,27
1657011907692,CSE 30,A01,083084,Eldon; John,4,0,80,76
1657011907692,CSE 30,B01,095061,Bhaskar; Nishant,6,0,50,44
1657011913718,CSE 100,A01,083659,Cao; Yingjun,3,4,70,67
1657011919742,CSE 134B,A01,083661,Powell; Thomas Allan,19,0,100,81
1657011925765,CSE 140,A01,083663,Gungor; Onat,14,0,85,71
1657011931793,CSE 140L,A01,083088,Eldon; John,16,0,100,84
1657011937816,CSE 175,A01,083665,Kumar; Rakesh,3,0,25,22
1657011943844,CSE 190,A00,092507,Dubnov; Shlomo,7,0,20,13
1657011949868,ECE 45,A01,083139,Congero; Spencer William,5,0,75,70
1657011955900,ECE 65,A50,083695,Saad; Andrew S,12,0,30,18
1657011955900,ECE 65,A51,095125,Saad; Andrew S,25,0,26,1
1657011961924,ECE 109,A01,091882,Touri; Behrouz,16,0,70,54
1657011967952,ECE 180,A00,083140,Abi Samra; Nicholas Camill,1,0,30,29
1657011967952,ECE 180,B00,083141,Abi Samra; Nicholas Camill,0,0,30,30
1657011973987,MATH 10A,A01,083735,Patchell; Gregory David,1,0,30,29
1657011973987,MATH 10A,A02,083736,Patchell; Gregory David,20,0,30,10
1657011973987,MATH 10A,A03,083737,Patchell; Gregory David,16,0,30,14
1657011980023,MATH 10B,A01,083207,Lim; Seonhee,7,0,34,27
1657011980023,MATH 10B,A02,083208,Lim; Seonhee,9,0,35,26
1657011980023,MATH 10B,A03,093472,Lim; Seonhee,4,0,34,30
1657011980023,MATH 10B,B01,083739,Sinha; Shubham,9,0,30,21
1657011986052,MATH 18,A01,083743,Cinel; Cameron Alexander,6,0,30,24
1657011986052,MATH 18,A02,083744,Cinel; Cameron Alexander,15,0,30,15
1657011986052,MATH 18,A03,083745,Cinel; Cameron Alexander,8,0,30,22
1657011986052,MATH 18,B01,083748,Rideout; David Porter,4,0,37,33
1657011986052,MATH 18,B02,083749,Rideout; David Porter,3,0,36,33
1657011986052,MATH 18,B03,083750,Rideout; David Porter,2,0,37,35
1657011986052,MATH 18,B04,083751,Rideout; David Porter,5,0,36,31
1657011986052,MATH 18,B05,093473,Rideout; David Porter,4,0,36,32
1657011986052,MATH 18,B06,093474,Rideout; David Porter,5,0,36,31
1657011992083,MATH 20A,A01,083754,Zheng; Zequn,12,0,40,28
1657011998120,MATH 20B,A01,083756,Briones; Jor-el Thomas Caparas,1,0,36,35
1657011998120,MATH 20B,A02,083757,Briones; Jor-el Thomas Caparas,1,0,36,35
1657011998120,MATH 20B,A03,093475,Briones; Jor-el Thomas Caparas,0,0,36,36
1657012004150,MATH 20C,A01,083760,Briones; Jor-el Thomas Caparas,1,0,35,34
1657012004150,MATH 20C,A02,083761,Briones; Jor-el Thomas Caparas,8,0,35,27
1657012004150,MATH 20C,A03,093476,Briones; Jor-el Thomas Caparas,0,1,36,36
1657012004150,MATH 20C,B01,083762,Bach; Quang Tran,0,0,30,30
1657012010182,MATH 20D,A01,083765,Tran; Brian Kha,4,0,30,26
1657012010182,MATH 20D,A02,083766,Tran; Brian Kha,5,0,30,25
1657012010182,MATH 20D,A03,083767,Tran; Brian Kha,3,0,30,27
1657012016209,MATH 20E,A01,083771,Ganguly; Soumya,5,0,32,27
1657012016209,MATH 20E,A02,083772,Ganguly; Soumya,6,0,32,26
1657012016209,MATH 20E,B01,083773,Ciotti; Benjamin,18,0,35,17
1657012016209,MATH 20E,B02,083774,Ciotti; Benjamin,17,0,35,18
1657012022235,MATH 103A,A01,083777,Greenfeld; Be'Eri,2,0,36,34
1657012022235,MATH 103A,A02,083778,Greenfeld; Be'Eri,5,0,36,31
1657012022235,MATH 103A,A03,093561,Greenfeld; Be'Eri,4,0,36,32
1657012022235,MATH 103A,B01,083779,Greenfeld; Be'Eri,6,0,36,30
1657012022235,MATH 103A,B02,083780,Greenfeld; Be'Eri,2,0,36,34
1657012022235,MATH 103A,B03,093562,Greenfeld; Be'Eri,2,0,36,34
1657012028268,MATH 105,A01,085443,Carter; Anne Toulson,14,0,35,21
1657012028268,MATH 105,A02,093477,Carter; Anne Toulson,20,0,35,15
1657012034302,MATH 109,A01,083213,Ganzberger; Geoffrey Michael,2,0,34,32
1657012034302,MATH 109,A02,083214,Ganzberger; Geoffrey Michael,2,0,34,32
1657012034302,MATH 109,A03,093478,Ganzberger; Geoffrey Michael,1,0,34,33
1657012034302,MATH 109,B01,083215,Ganzberger; Geoffrey Michael,1,0,32,31
1657012034302,MATH 109,B02,083216,Ganzberger; Geoffrey Michael,1,0,32,31
1657012034302,MATH 109,B03,093479,Ganzberger; Geoffrey Michael,6,0,32,26
1657012040328,MATH 142A,A01,083219,Chow; Bennett,6,0,32,26
1657012040328,MATH 142A,A02,083220,Chow; Bennett,10,0,32,22
1657012040328,MATH 142A,A03,093480,Chow; Bennett,7,0,32,25
1657012040328,MATH 142A,B03,093481,Chow; Bennett,7,0,32,25
1657012040328,MATH 142A,B04,093558,Chow; Bennett,11,0,32,21
1657012040328,MATH 142A,B05,093559,Chow; Bennett,6,0,32,26
1657012046425,MATH 193A,A01,083224,Rotar; Vladimir,7,0,34,27
1657012046425,MATH 193A,A02,083225,Rotar; Vladimir,4,0,34,30
1657012046425,MATH 193A,A03,083781,Rotar; Vladimir,1,0,34,33
1657012046425,MATH 193A,A04,083782,Rotar; Vladimir,6,0,34,28
1657012046425,MATH 193A,A05,093482,Rotar; Vladimir,6,0,34,28
1657012052453,MATH 197,001,091859,McAuley; Julian John,9999,0,9999,0
1657012052453,MATH 197,002,095566,Kedlaya; Kiran S.,9997,0,9999,2
1657012052453,MATH 197,003,095567,Xiao; Ming,9999,0,9999,0
1657012052453,MATH 197,004,095571,Perols; Johan Lars,9998,0,9999,1
1657012059557,COGS 9,A01,083615,Shannon; Kyle Michael,7,0,75,68
1657012065588,COGS 11,A01,083617,Boyle; Mary E. T.,20,0,48,28
1657012071621,COGS 13,A01,083071,Bastos; Amalia Pinkusfeld,9,0,71,62
1657012077648,COGS 14A,A01,092681,Semenuks; Arturs,0,1,100,100
1657012083677,COGS 14B,A01,083073,Cheng; Tzu-Han,5,0,63,58
1657012089702,COGS 17,A01,092677,Semenuks; Arturs,4,0,81,77
1657012095732,COGS 100,A01,083619,Allen; Michael Gordon,15,0,70,55
1657012101758,COGS 101A,A01,083621,Davis; Joshua Daniel,9,0,68,59
1657012107790,COGS 101B,A01,091572,Allen; Michael Gordon,8,0,65,57
1657012113813,COGS 101C,A01,083625,Delgado; Tania,17,0,35,18
1657012119844,COGS 107A,A01,083627,Boyle; Mary E. T.,13,0,60,47
1657012125873,COGS 118A,A01,083075,Gupta; Anjum,15,0,76,61
1657012131900,CSE 3,A50,083646,Miranda; Gregory Joseph,22,0,50,28
1657012137927,CSE 8A,A50,083650,Miranda; Gregory Joseph,17,1,56,39
1657012143951,CSE 11,A01,083080,Cao; Yingjun,4,15,40,36
1657012149980,CSE 12,A01,083652,Krause-Levy; Sophia Louisa,21,1,120,99
1657012156004,CSE 15L,A01,083654,Morris; Justin Loren,8,0,50,42
1657012156004,CSE 15L,A02,083655,Morris; Justin Loren,9,0,50,41
1657012162031,CSE 20,A01,083657,Tran; Khoa Dang,37,0,80,43
1657012168057,CSE 21,A01,095574,Bach; Quang Tran,21,0,48,27
1657012174096,CSE 30,A01,083084,Eldon; John,4,0,80,76
1657012174096,CSE 30,B01,095061,Bhaskar; Nishant,6,0,50,44
1657012180123,CSE 100,A01,083659,Cao; Yingjun,3,4,70,67
1657012186150,CSE 134B,A01,083661,Powell; Thomas Allan,19,0,100,81
1657012192179,CSE 140,A01,083663,Gungor; Onat,14,0,85,71
1657012198203,CSE 140L,A01,083088,Eldon; John,16,0,100,84
1657012204227,CSE 175,A01,083665,Kumar; Rakesh,3,0,25,22
1657012210250,CSE 190,A00,092507,Dubnov; Shlomo,7,0,20,13
1657012216276,ECE 45,A01,083139,Congero; Spencer William,5,0,75,70
1657012222301,ECE 65,A50,083695,Saad; Andrew S,12,0,30,18
1657012222301,ECE 65,A51,095125,Saad; Andrew S,25,0,26,1
1657012228331,ECE 109,A01,091882,Touri; Behrouz,16,0,70,54
1657012234361,ECE 180,A00,083140,Abi Samra; Nicholas Camill,1,0,30,29
1657012234361,ECE 180,B00,083141,Abi Samra; Nicholas Camill,0,0,30,30
1657012240384,MATH 10A,A01,083735,Patchell; Gregory David,1,0,30,29
1657012240384,MATH 10A,A02,083736,Patchell; Gregory David,20,0,30,10
1657012240384,MATH 10A,A03,083737,Patchell; Gregory David,16,0,30,14
1657012246419,MATH 10B,A01,083207,Lim; Seonhee,7,0,34,27
1657012246419,MATH 10B,A02,083208,Lim; Seonhee,9,0,35,26
1657012246419,MATH 10B,A03,093472,Lim; Seonhee,4,0,34,30
1657012246419,MATH 10B,B01,083739,Sinha; Shubham,9,0,30,21
1657012252454,MATH 18,A01,083743,Cinel; Cameron Alexander,6,0,30,24
1657012252454,MATH 18,A02,083744,Cinel; Cameron Alexander,15,0,30,15
1657012252454,MATH 18,A03,083745,Cinel; Cameron Alexander,8,0,30,22
1657012252454,MATH 18,B01,083748,Rideout; David Porter,4,0,37,33
1657012252454,MATH 18,B02,083749,Rideout; David Porter,3,0,36,33
1657012252454,MATH 18,B03,083750,Rideout; David Porter,2,0,37,35
1657012252454,MATH 18,B04,083751,Rideout; David Porter,5,0,36,31
1657012252454,MATH 18,B05,093473,Rideout; David Porter,4,0,36,32
1657012252454,MATH 18,B06,093474,Rideout; David Porter,5,0,36,31
1657012258485,MATH 20A,A01,083754,Zheng; Zequn,12,0,40,28
1657012264510,MATH 20B,A01,083756,Briones; Jor-el Thomas Caparas,1,0,36,35
1657012264510,MATH 20B,A02,083757,Briones; Jor-el Thomas Caparas,1,0,36,35
1657012264510,MATH 20B,A03,093475,Briones; Jor-el Thomas Caparas,0,0,36,36
1657012270535,MATH 20C,A01,083760,Briones; Jor-el Thomas Caparas,1,0,35,34
1657012270535,MATH 20C,A02,083761,Briones; Jor-el Thomas Caparas,8,0,35,27
1657012270535,MATH 20C,A03,093476,Briones; Jor-el Thomas Caparas,0,1,36,36
1657012270535,MATH 20C,B01,083762,Bach; Quang Tran,0,0,30,30
1657012276567,MATH 20D,A01,083765,Tran; Brian Kha,4,0,30,26
1657012276567,MATH 20D,A02,083766,Tran; Brian Kha,5,0,30,25
1657012276567,MATH 20D,A03,083767,Tran; Brian Kha,3,0,30,27
1657012282592,MATH 20E,A01,083771,Ganguly; Soumya,5,0,32,27
1657012282592,MATH 20E,A02,083772,Ganguly; Soumya,6,0,32,26
1657012282592,MATH 20E,B01,083773,Ciotti; Benjamin,18,0,35,17
1657012282592,MATH 20E,B02,083774,Ciotti; Benjamin,17,0,35,18
1657012288617,MATH 103A,A01,083777,Greenfeld; Be'Eri,2,0,36,34
1657012288617,MATH 103A,A02,083778,Greenfeld; Be'Eri,5,0,36,31
1657012288617,MATH 103A,A03,093561,Greenfeld; Be'Eri,4,0,36,32
1657012288617,MATH 103A,B01,083779,Greenfeld; Be'Eri,6,0,36,30
1657012288617,MATH 103A,B02,083780,Greenfeld; Be'Eri,2,0,36,34
1657012288617,MATH 103A,B03,093562,Greenfeld; Be'Eri,2,0,36,34
1657012294652,MATH 105,A01,085443,Carter; Anne Toulson,14,0,35,21
1657012294652,MATH 105,A02,093477,Carter; Anne Toulson,20,0,35,15
1657012300687,MATH 109,A01,083213,Ganzberger; Geoffrey Michael,2,0,34,32
1657012300687,MATH 109,A02,083214,Ganzberger; Geoffrey Michael,2,0,34,32
1657012300687,MATH 109,A03,093478,Ganzberger; Geoffrey Michael,1,0,34,33
1657012300687,MATH 109,B01,083215,Ganzberger; Geoffrey Michael,1,0,32,31
1657012300687,MATH 109,B02,083216,Ganzberger; Geoffrey Michael,1,0,32,31
1657012300687,MATH 109,B03,093479,Ganzberger; Geoffrey Michael,6,0,32,26
1657012306720,MATH 142A,A01,083219,Chow; Bennett,6,0,32,26
1657012306720,MATH 142A,A02,083220,Chow; Bennett,10,0,32,22
1657012306720,MATH 142A,A03,093480,Chow; Bennett,7,0,32,25
1657012306720,MATH 142A,B03,093481,Chow; Bennett,7,0,32,25
1657012306720,MATH 142A,B04,093558,Chow; Bennett,11,0,32,21
1657012306720,MATH 142A,B05,093559,Chow; Bennett,6,0,32,26
1657012312745,MATH 193A,A01,083224,Rotar; Vladimir,7,0,34,27
1657012312745,MATH 193A,A02,083225,Rotar; Vladimir,4,0,34,30
1657012312745,MATH 193A,A03,083781,Rotar; Vladimir,1,0,34,33
1657012312745,MATH 193A,A04,083782,Rotar; Vladimir,6,0,34,28
1657012312745,MATH 193A,A05,093482,Rotar; Vladimir,6,0,34,28
1657012318769,MATH 197,001,091859,McAuley; Julian John,9999,0,9999,0
1657012318769,MATH 197,002,095566,Kedlaya; Kiran S.,9997,0,9999,2
1657012318769,MATH 197,003,095567,Xiao; Ming,9999,0,9999,0
1657012318769,MATH 197,004,095571,Perols; Johan Lars,9998,0,9999,1
1657012325853,COGS 9,A01,083615,Shannon; Kyle Michael,7,0,75,68
1657012331881,COGS 11,A01,083617,Boyle; Mary E. T.,20,0,48,28
1657012337915,COGS 13,A01,083071,Bastos; Amalia Pinkusfeld,9,0,71,62
1657012343947,COGS 14A,A01,092681,Semenuks; Arturs,0,1,100,100
1657012349976,COGS 14B,A01,083073,Cheng; Tzu-Han,5,0,63,58
1657012355999,COGS 17,A01,092677,Semenuks; Arturs,4,0,81,77
1657012362023,COGS 100,A01,083619,Allen; Michael Gordon,15,0,70,55
1657012368046,COGS 101A,A01,083621,Davis; Joshua Daniel,9,0,68,59
1657012374071,COGS 101B,A01,091572,Allen; Michael Gordon,8,0,65,57
1657012380096,COGS 101C,A01,083625,Delgado; Tania,17,0,35,18
1657012386125,COGS 107A,A01,083627,Boyle; Mary E. T.,13,0,60,47
1657012392154,COGS 118A,A01,083075,Gupta; Anjum,15,0,76,61
1657012398180,CSE 3,A50,083646,Miranda; Gregory Joseph,22,0,50,28
1657012404207,CSE 8A,A50,083650,Miranda; Gregory Joseph,17,1,56,39
1657012410232,CSE 11,A01,083080,Cao; Yingjun,4,15,40,36
1657012416259,CSE 12,A01,083652,Krause-Levy; Sophia Louisa,21,1,120,99
1657012422283,CSE 15L,A01,083654,Morris; Justin Loren,8,0,50,42
1657012422283,CSE 15L,A02,083655,Morris; Justin Loren,9,0,50,41
1657012428311,CSE 20,A01,083657,Tran; Khoa Dang,37,0,80,43
1657012434336,CSE 21,A01,095574,Bach; Quang Tran,21,0,48,27
1657012440359,CSE 30,A01,083084,Eldon; John,4,0,80,76
1657012440359,CSE 30,B01,095061,Bhaskar; Nishant,6,0,50,44
1657012446387,CSE 100,A01,083659,Cao; Yingjun,3,4,70,67
1657012452410,CSE 134B,A01,083661,Powell; Thomas Allan,19,0,100,81
1657012458435,CSE 140,A01,083663,Gungor; Onat,14,0,85,71
1657012464460,CSE 140L,A01,083088,Eldon; John,16,0,100,84
1657012470497,CSE 175,A01,083665,Kumar; Rakesh,3,0,25,22
1657012476525,CSE 190,A00,092507,Dubnov; Shlomo,7,0,20,13
1657012482550,ECE 45,A01,083139,Congero; Spencer William,5,0,75,70
1657012488580,ECE 65,A50,083695,Saad; Andrew S,12,0,30,18
1657012488580,ECE 65,A51,095125,Saad; Andrew S,25,0,26,1
1657012494604,ECE 109,A01,091882,Touri; Behrouz,16,0,70,54
1657012500630,ECE 180,A00,083140,Abi Samra; Nicholas Camill,1,0,30,29
1657012500630,ECE 180,B00,083141,Abi Samra; Nicholas Camill,0,0,30,30
1657012506661,MATH 10A,A01,083735,Patchell; Gregory David,1,0,30,29
1657012506661,MATH 10A,A02,083736,Patchell; Gregory David,20,0,30,10
1657012506661,MATH 10A,A03,083737,Patchell; Gregory David,16,0,30,14
1657012512687,MATH 10B,A01,083207,Lim; Seonhee,7,0,34,27
1657012512687,MATH 10B,A02,083208,Lim; Seonhee,9,0,35,26
1657012512687,MATH 10B,A03,093472,Lim; Seonhee,4,0,34,30
1657012512687,MATH 10B,B01,083739,Sinha; Shubham,9,0,30,21
1657012518711,MATH 18,A01,083743,Cinel; Cameron Alexander,6,0,30,24
1657012518711,MATH 18,A02,083744,Cinel; Cameron Alexander,15,0,30,15
1657012518711,MATH 18,A03,083745,Cinel; Cameron Alexander,8,0,30,22
1657012518711,MATH 18,B01,083748,Rideout; David Porter,4,0,37,33
1657012518711,MATH 18,B02,083749,Rideout; David Porter,3,0,36,33
1657012518711,MATH 18,B03,083750,Rideout; David Porter,2,0,37,35
1657012518711,MATH 18,B04,083751,Rideout; David Porter,5,0,36,31
1657012518711,MATH 18,B05,093473,Rideout; David Porter,4,0,36,32
1657012518711,MATH 18,B06,093474,Rideout; David Porter,5,0,36,31
1657012524735,MATH 20A,A01,083754,Zheng; Zequn,12,0,40,28
1657012530767,MATH 20B,A01,083756,Briones; Jor-el Thomas Caparas,1,0,36,35
1657012530767,MATH 20B,A02,083757,Briones; Jor-el Thomas Caparas,1,0,36,35
1657012530767,MATH 20B,A03,093475,Briones; Jor-el Thomas Caparas,0,0,36,36
1657012536792,MATH 20C,A01,083760,Briones; Jor-el Thomas Caparas,1,0,35,34
1657012536792,MATH 20C,A02,083761,Briones; Jor-el Thomas Caparas,8,0,35,27
1657012536792,MATH 20C,A03,093476,Briones; Jor-el Thomas Caparas,0,1,36,36
1657012536792,MATH 20C,B01,083762,Bach; Quang Tran,0,0,30,30
1657012542817,MATH 20D,A01,083765,Tran; Brian Kha,4,0,30,26
1657012542817,MATH 20D,A02,083766,Tran; Brian Kha,5,0,30,25
1657012542817,MATH 20D,A03,083767,Tran; Brian Kha,3,0,30,27
1657012548848,MATH 20E,A01,083771,Ganguly; Soumya,5,0,32,27
1657012548848,MATH 20E,A02,083772,Ganguly; Soumya,6,0,32,26
1657012548848,MATH 20E,B01,083773,Ciotti; Benjamin,18,0,35,17
1657012548848,MATH 20E,B02,083774,Ciotti; Benjamin,17,0,35,18
1657012554889,MATH 103A,A01,083777,Greenfeld; Be'Eri,2,0,36,34
1657012554889,MATH 103A,A02,083778,Greenfeld; Be'Eri,5,0,36,31
1657012554889,MATH 103A,A03,093561,Greenfeld; Be'Eri,4,0,36,32
1657012554889,MATH 103A,B01,083779,Greenfeld; Be'Eri,6,0,36,30
1657012554889,MATH 103A,B02,083780,Greenfeld; Be'Eri,2,0,36,34
1657012554889,MATH 103A,B03,093562,Greenfeld; Be'Eri,2,0,36,34
1657012560919,MATH 105,A01,085443,Carter; Anne Toulson,14,0,35,21
1657012560919,MATH 105,A02,093477,Carter; Anne Toulson,20,0,35,15
1657012566943,MATH 109,A01,083213,Ganzberger; Geoffrey Michael,2,0,34,32
1657012566943,MATH 109,A02,083214,Ganzberger; Geoffrey Michael,2,0,34,32
1657012566943,MATH 109,A03,093478,Ganzberger; Geoffrey Michael,1,0,34,33
1657012566943,MATH 109,B01,083215,Ganzberger; Geoffrey Michael,1,0,32,31
1657012566943,MATH 109,B02,083216,Ganzberger; Geoffrey Michael,1,0,32,31
1657012566943,MATH 109,B03,093479,Ganzberger; Geoffrey Michael,6,0,32,26
1657012572970,MATH 142A,A01,083219,Chow; Bennett,6,0,32,26
1657012572970,MATH 142A,A02,083220,Chow; Bennett,10,0,32,22
1657012572970,MATH 142A,A03,093480,Chow; Bennett,7,0,32,25
1657012572970,MATH 142A,B03,093481,Chow; Bennett,7,0,32,25
1657012572970,MATH 142A,B04,093558,Chow; Bennett,11,0,32,21
1657012572970,MATH 142A,B05,093559,Chow; Bennett,6,0,32,26
1657012579003,MATH 193A,A01,083224,Rotar; Vladimir,7,0,34,27
1657012579003,MATH 193A,A02,083225,Rotar; Vladimir,4,0,34,30
1657012579003,MATH 193A,A03,083781,Rotar; Vladimir,1,0,34,33
1657012579003,MATH 193A,A04,083782,Rotar; Vladimir,6,0,34,28
1657012579003,MATH 193A,A05,093482,Rotar; Vladimir,6,0,34,28
1657012585030,MATH 197,001,091859,McAuley; Julian John,9999,0,9999,0
1657012585030,MATH 197,002,095566,Kedlaya; Kiran S.,9997,0,9999,2
1657012585030,MATH 197,003,095567,Xiao; Ming,9999,0,9999,0
1657012585030,MATH 197,004,095571,Perols; Johan Lars,9998,0,9999,1
1657012592089,COGS 9,A01,083615,Shannon; Kyle Michael,7,0,75,68
1657012598116,COGS 11,A01,083617,Boyle; Mary E. T.,20,0,48,28
1657012604139,COGS 13,A01,083071,Bastos; Amalia Pinkusfeld,9,0,71,62
1657012610166,COGS 14A,A01,092681,Semenuks; Arturs,0,1,100,100
1657012616196,COGS 14B,A01,083073,Cheng; Tzu-Han,5,0,63,58
1657012622219,COGS 17,A01,092677,Semenuks; Arturs,4,0,81,77
1657012628243,COGS 100,A01,083619,Allen; Michael Gordon,15,0,70,55
1657012634268,COGS 101A,A01,083621,Davis; Joshua Daniel,9,0,68,59
1657012640396,COGS 101B,A01,091572,Allen; Michael Gordon,8,0,65,57
1657012646421,COGS 101C,A01,083625,Delgado; Tania,17,0,35,18
1657012652448,COGS 107A,A01,083627,Boyle; Mary E. T.,13,0,60,47
1657012658472,COGS 118A,A01,083075,Gupta; Anjum,15,0,76,61
1657012664497,CSE 3,A50,083646,Miranda; Gregory Joseph,22,0,50,28
1657012670528,CSE 8A,A50,083650,Miranda; Gregory Joseph,17,1,56,39
1657012676554,CSE 11,A01,083080,Cao; Yingjun,4,15,40,36
1657012682579,CSE 12,A01,083652,Krause-Levy; Sophia Louisa,21,1,120,99
1657012688603,CSE 15L,A01,083654,Morris; Justin Loren,8,0,50,42
1657012688603,CSE 15L,A02,083655,Morris; Justin Loren,9,0,50,41
1657012694628,CSE 20,A01,083657,Tran; Khoa Dang,37,0,80,43
1657012700654,CSE 21,A01,095574,Bach; Quang Tran,21,0,48,27
1657012706680,CSE 30,A01,083084,Eldon; John,4,0,80,76
1657012706680,CSE 30,B01,095061,Bhaskar; Nishant,6,0,50,44
1657012712710,CSE 100,A01,083659,Cao; Yingjun,3,4,70,67
1657012718738,CSE 134B,A01,083661,Powell; Thomas Allan,19,0,100,81
1657012724766,CSE 140,A01,083663,Gungor; Onat,14,0,85,71
1657012730794,CSE 140L,A01,083088,Eldon; John,16,0,100,84
1657012736821,CSE 175,A01,083665,Kumar; Rakesh,3,0,25,22
1657012742845,CSE 190,A00,092507,Dubnov; Shlomo,7,0,20,13
1657012748876,ECE 45,A01,083139,Congero; Spencer William,5,0,75,70
1657012754899,ECE 65,A50,083695,Saad; Andrew S,12,0,30,18
1657012754899,ECE 65,A51,095125,Saad; Andrew S,25,0,26,1
1657012760928,ECE 109,A01,091882,Touri; Behrouz,16,0,70,54
1657012766958,ECE 180,A00,083140,Abi Samra; Nicholas Camill,1,0,30,29
1657012766958,ECE 180,B00,083141,Abi Samra; Nicholas Camill,0,0,30,30
1657012772983,MATH 10A,A01,083735,Patchell; Gregory David,1,0,30,29
1657012772983,MATH 10A,A02,083736,Patchell; Gregory David,20,0,30,10
1657012772983,MATH 10A,A03,083737,Patchell; Gregory David,16,0,30,14
1657012779030,MATH 10B,A01,083207,Lim; Seonhee,7,0,34,27
1657012779030,MATH 10B,A02,083208,Lim; Seonhee,9,0,35,26
1657012779030,MATH 10B,A03,093472,Lim; Seonhee,4,0,34,30
1657012779030,MATH 10B,B01,083739,Sinha; Shubham,9,0,30,21
1657012785055,MATH 18,A01,083743,Cinel; Cameron Alexander,6,0,30,24
1657012785055,MATH 18,A02,083744,Cinel; Cameron Alexander,15,0,30,15
1657012785055,MATH 18,A03,083745,Cinel; Cameron Alexander,8,0,30,22
1657012785055,MATH 18,B01,083748,Rideout; David Porter,4,0,37,33
1657012785055,MATH 18,B02,083749,Rideout; David Porter,3,0,36,33
1657012785055,MATH 18,B03,083750,Rideout; David Porter,2,0,37,35
1657012785055,MATH 18,B04,083751,Rideout; David Porter,5,0,36,31
1657012785055,MATH 18,B05,093473,Rideout; David Porter,4,0,36,32
1657012785055,MATH 18,B06,093474,Rideout; David Porter,5,0,36,31
1657012791083,MATH 20A,A01,083754,Zheng; Zequn,12,0,40,28
1657012797111,MATH 20B,A01,083756,Briones; Jor-el Thomas Caparas,1,0,36,35
1657012797111,MATH 20B,A02,083757,Briones; Jor-el Thomas Caparas,1,0,36,35
1657012797111,MATH 20B,A03,093475,Briones; Jor-el Thomas Caparas,0,0,36,36
1657012803144,MATH 20C,A01,083760,Briones; Jor-el Thomas Caparas,1,0,35,34
1657012803144,MATH 20C,A02,083761,Briones; Jor-el Thomas Caparas,8,0,35,27
1657012803144,MATH 20C,A03,093476,Briones; Jor-el Thomas Caparas,0,1,36,36
1657012803144,MATH 20C,B01,083762,Bach; Quang Tran,0,0,30,30
1657012809167,MATH 20D,A01,083765,Tran; Brian Kha,4,0,30,26
1657012809167,MATH 20D,A02,083766,Tran; Brian Kha,5,0,30,25
1657012809167,MATH 20D,A03,083767,Tran; Brian Kha,3,0,30,27
1657012815197,MATH 20E,A01,083771,Ganguly; Soumya,5,0,32,27
1657012815197,MATH 20E,A02,083772,Ganguly; Soumya,6,0,32,26
1657012815197,MATH 20E,B01,083773,Ciotti; Benjamin,18,0,35,17
1657012815197,MATH 20E,B02,083774,Ciotti; Benjamin,17,0,35,18
1657012821220,MATH 103A,A01,083777,Greenfeld; Be'Eri,2,0,36,34
1657012821220,MATH 103A,A02,083778,Greenfeld; Be'Eri,5,0,36,31
1657012821220,MATH 103A,A03,093561,Greenfeld; Be'Eri,4,0,36,32
1657012821220,MATH 103A,B01,083779,Greenfeld; Be'Eri,6,0,36,30
1657012821220,MATH 103A,B02,083780,Greenfeld; Be'Eri,2,0,36,34
1657012821220,MATH 103A,B03,093562,Greenfeld; Be'Eri,2,0,36,34
1657012827245,MATH 105,A01,085443,Carter; Anne Toulson,14,0,35,21
1657012827245,MATH 105,A02,093477,Carter; Anne Toulson,20,0,35,15
1657012833273,MATH 109,A01,083213,Ganzberger; Geoffrey Michael,2,0,34,32
1657012833273,MATH 109,A02,083214,Ganzberger; Geoffrey Michael,2,0,34,32
1657012833273,MATH 109,A03,093478,Ganzberger; Geoffrey Michael,1,0,34,33
1657012833273,MATH 109,B01,083215,Ganzberger; Geoffrey Michael,1,0,32,31
1657012833273,MATH 109,B02,083216,Ganzberger; Geoffrey Michael,1,0,32,31
1657012833273,MATH 109,B03,093479,Ganzberger; Geoffrey Michael,6,0,32,26
1657012839299,MATH 142A,A01,083219,Chow; Bennett,6,0,32,26
1657012839299,MATH 142A,A02,083220,Chow; Bennett,10,0,32,22
1657012839299,MATH 142A,A03,093480,Chow; Bennett,7,0,32,25
1657012839299,MATH 142A,B03,093481,Chow; Bennett,7,0,32,25
1657012839299,MATH 142A,B04,093558,Chow; Bennett,11,0,32,21
1657012839299,MATH 142A,B05,093559,Chow; Bennett,6,0,32,26
1657012845327,MATH 193A,A01,083224,Rotar; Vladimir,7,0,34,27
1657012845327,MATH 193A,A02,083225,Rotar; Vladimir,4,0,34,30
1657012845327,MATH 193A,A03,083781,Rotar; Vladimir,1,0,34,33
1657012845327,MATH 193A,A04,083782,Rotar; Vladimir,6,0,34,28
1657012845327,MATH 193A,A05,093482,Rotar; Vladimir,6,0,34,28
1657012851354,MATH 197,001,091859,McAuley; Julian John,9999,0,9999,0
1657012851354,MATH 197,002,095566,Kedlaya; Kiran S.,9997,0,9999,2
1657012851354,MATH 197,003,095567,Xiao; Ming,9999,0,9999,0
1657012851354,MATH 197,004,095571,Perols; Johan Lars,9998,0,9999,1
1657012858412,COGS 9,A01,083615,Shannon; Kyle Michael,7,0,75,68
1657012864440,COGS 11,A01,083617,Boyle; Mary E. T.,20,0,48,28
1657012870465,COGS 13,A01,083071,Bastos; Amalia Pinkusfeld,9,0,71,62
1657012876490,COGS 14A,A01,092681,Semenuks; Arturs,0,1,100,100
1657012882517,COGS 14B,A01,083073,Cheng; Tzu-Han,5,0,63,58
1657012888543,COGS 17,A01,092677,Semenuks; Arturs,4,0,81,77
1657012894575,COGS 100,A01,083619,Allen; Michael Gordon,15,0,70,55
1657012900601,COGS 101A,A01,083621,Davis; Joshua Daniel,9,0,68,59
1657012906623,COGS 101B,A01,091572,Allen; Michael Gordon,8,0,65,57
1657012912645,COGS 101C,A01,083625,Delgado; Tania,17,0,35,18
1657012918672,COGS 107A,A01,083627,Boyle; Mary E. T.,13,0,60,47
1657012924698,COGS 118A,A01,083075,Gupta; Anjum,15,0,76,61
1657012930729,CSE 3,A50,083646,Miranda; Gregory Joseph,22,0,50,28
1657012936753,CSE 8A,A50,083650,Miranda; Gregory Joseph,17,1,56,39
1657012942777,CSE 11,A01,083080,Cao; Yingjun,4,15,40,36
1657012948800,CSE 12,A01,083652,Krause-Levy; Sophia Louisa,21,1,120,99
1657012954828,CSE 15L,A01,083654,Morris; Justin Loren,8,0,50,42
1657012954828,CSE 15L,A02,083655,Morris; Justin Loren,9,0,50,41
1657012960857,CSE 20,A01,083657,Tran; Khoa Dang,37,0,80,43
1657012966886,CSE 21,A01,095574,Bach; Quang Tran,21,0,48,27
1657012972915,CSE 30,A01,083084,Eldon; John,4,0,80,76
1657012972915,CSE 30,B01,095061,Bhaskar; Nishant,6,0,50,44
1657012978942,CSE 100,A01,083659,Cao; Yingjun,3,4,70,67
1657012984971,CSE 134B,A01,083661,Powell; Thomas Allan,19,0,100,81
1657012990999,CSE 140,A01,083663,Gungor; Onat,14,0,85,71
1657012997021,CSE 140L,A01,083088,Eldon; John,16,0,100,84
1657013003049,CSE 175,A01,083665,Kumar; Rakesh,3,0,25,22
1657013009076,CSE 190,A00,092507,Dubnov; Shlomo,7,0,20,13
1657013015105,ECE 45,A01,083139,Congero; Spencer William,5,0,75,70
1657013021130,ECE 65,A50,083695,Saad; Andrew S,12,0,30,18
1657013021130,ECE 65,A51,095125,Saad; Andrew S,25,0,26,1
1657013027154,ECE 109,A01,091882,Touri; Behrouz,16,0,70,54
1657013033179,ECE 180,A00,083140,Abi Samra; Nicholas Camill,1,0,30,29
1657013033179,ECE 180,B00,083141,Abi Samra; Nicholas Camill,0,0,30,30
1657013039203,MATH 10A,A01,083735,Patchell; Gregory David,1,0,30,29
1657013039203,MATH 10A,A02,083736,Patchell; Gregory David,20,0,30,10
1657013039203,MATH 10A,A03,083737,Patchell; Gregory David,16,0,30,14
1657013045229,MATH 10B,A01,083207,Lim; Seonhee,7,0,34,27
1657013045229,MATH 10B,A02,083208,Lim; Seonhee,9,0,35,26
1657013045229,MATH 10B,A03,093472,Lim; Seonhee,4,0,34,30
1657013045229,MATH 10B,B01,083739,Sinha; Shubham,9,0,30,21
1657013051253,MATH 18,A01,083743,Cinel; Cameron Alexander,6,0,30,24
1657013051253,MATH 18,A02,083744,Cinel; Cameron Alexander,15,0,30,15
1657013051253,MATH 18,A03,083745,Cinel; Cameron Alexander,8,0,30,22
1657013051253,MATH 18,B01,083748,Rideout; David Porter,4,0,37,33
1657013051253,MATH 18,B02,083749,Rideout; David Porter,3,0,36,33
1657013051253,MATH 18,B03,083750,Rideout; David Porter,2,0,37,35
1657013051253,MATH 18,B04,083751,Rideout; David Porter,5,0,36,31
1657013051253,MATH 18,B05,093473,Rideout; David Porter,4,0,36,32
1657013051253,MATH 18,B06,093474,Rideout; David Porter,5,0,36,31
1657013057277,MATH 20A,A01,083754,Zheng; Zequn,12,0,40,28
1657013063307,MATH 20B,A01,083756,Briones; Jor-el Thomas Caparas,1,0,36,35
1657013063307,MATH 20B,A02,083757,Briones; Jor-el Thomas Caparas,1,0,36,35
1657013063307,MATH 20B,A03,093475,Briones; Jor-el Thomas Caparas,0,0,36,36
1657013069331,MATH 20C,A01,083760,Briones; Jor-el Thomas Caparas,1,0,35,34
1657013069331,MATH 20C,A02,083761,Briones; Jor-el Thomas Caparas,8,0,35,27
1657013069331,MATH 20C,A03,093476,Briones; Jor-el Thomas Caparas,0,1,36,36
1657013069331,MATH 20C,B01,083762,Bach; Quang Tran,0,0,30,30
1657013075356,MATH 20D,A01,083765,Tran; Brian Kha,4,0,30,26
1657013075356,MATH 20D,A02,083766,Tran; Brian Kha,5,0,30,25
1657013075356,MATH 20D,A03,083767,Tran; Brian Kha,3,0,30,27
1657013081382,MATH 20E,A01,083771,Ganguly; Soumya,5,0,32,27
1657013081382,MATH 20E,A02,083772,Ganguly; Soumya,6,0,32,26
1657013081382,MATH 20E,B01,083773,Ciotti; Benjamin,18,0,35,17
1657013081382,MATH 20E,B02,083774,Ciotti; Benjamin,17,0,35,18
1657013087408,MATH 103A,A01,083777,Greenfeld; Be'Eri,2,0,36,34
1657013087408,MATH 103A,A02,083778,Greenfeld; Be'Eri,5,0,36,31
1657013087408,MATH 103A,A03,093561,Greenfeld; Be'Eri,4,0,36,32
1657013087408,MATH 103A,B01,083779,Greenfeld; Be'Eri,6,0,36,30
1657013087408,MATH 103A,B02,083780,Greenfeld; Be'Eri,2,0,36,34
1657013087408,MATH 103A,B03,093562,Greenfeld; Be'Eri,2,0,36,34
1657013093438,MATH 105,A01,085443,Carter; Anne Toulson,14,0,35,21
1657013093438,MATH 105,A02,093477,Carter; Anne Toulson,20,0,35,15
1657013099468,MATH 109,A01,083213,Ganzberger; Geoffrey Michael,2,0,34,32
1657013099468,MATH 109,A02,083214,Ganzberger; Geoffrey Michael,2,0,34,32
1657013099468,MATH 109,A03,093478,Ganzberger; Geoffrey Michael,1,0,34,33
1657013099468,MATH 109,B01,083215,Ganzberger; Geoffrey Michael,1,0,32,31
1657013099468,MATH 109,B02,083216,Ganzberger; Geoffrey Michael,1,0,32,31
1657013099468,MATH 109,B03,093479,Ganzberger; Geoffrey Michael,6,0,32,26
1657013105492,MATH 142A,A01,083219,Chow; Bennett,6,0,32,26
1657013105492,MATH 142A,A02,083220,Chow; Bennett,10,0,32,22
1657013105492,MATH 142A,A03,093480,Chow; Bennett,7,0,32,25
1657013105492,MATH 142A,B03,093481,Chow; Bennett,7,0,32,25
1657013105492,MATH 142A,B04,093558,Chow; Bennett,11,0,32,21
1657013105492,MATH 142A,B05,093559,Chow; Bennett,6,0,32,26
1657013111523,MATH 193A,A01,083224,Rotar; Vladimir,7,0,34,27
1657013111523,MATH 193A,A02,083225,Rotar; Vladimir,4,0,34,30
1657013111523,MATH 193A,A03,083781,Rotar; Vladimir,1,0,34,33
1657013111523,MATH 193A,A04,083782,Rotar; Vladimir,6,0,34,28
1657013111523,MATH 193A,A05,093482,Rotar; Vladimir,6,0,34,28
1657013117547,MATH 197,001,091859,McAuley; Julian John,9999,0,9999,0
1657013117547,MATH 197,002,095566,Kedlaya; Kiran S.,9997,0,9999,2
1657013117547,MATH 197,003,095567,Xiao; Ming,9999,0,9999,0
1657013117547,MATH 197,004,095571,Perols; Johan Lars,9998,0,9999,1
1657013124606,COGS 9,A01,083615,Shannon; Kyle Michael,7,0,75,68
1657013130630,COGS 11,A01,083617,Boyle; Mary E. T.,20,0,48,28
1657013136655,COGS 13,A01,083071,Bastos; Amalia Pinkusfeld,9,0,71,62
1657013142679,COGS 14A,A01,092681,Semenuks; Arturs,0,1,100,100
1657013148703,COGS 14B,A01,083073,Cheng; Tzu-Han,5,0,63,58
1657013154727,COGS 17,A01,092677,Semenuks; Arturs,4,0,81,77
1657013160754,COGS 100,A01,083619,Allen; Michael Gordon,15,0,70,55
1657013166789,COGS 101A,A01,083621,Davis; Joshua Daniel,9,0,68,59
1657013172818,COGS 101B,A01,091572,Allen; Michael Gordon,8,0,65,57
1657013178840,COGS 101C,A01,083625,Delgado; Tania,17,0,35,18
1657013184868,COGS 107A,A01,083627,Boyle; Mary E. T.,13,0,60,47
1657013190892,COGS 118A,A01,083075,Gupta; Anjum,15,0,76,61
1657013196921,CSE 3,A50,083646,Miranda; Gregory Joseph,22,0,50,28
1657013202951,CSE 8A,A50,083650,Miranda; Gregory Joseph,17,1,56,39
1657013208976,CSE 11,A01,083080,Cao; Yingjun,4,15,40,36
1657013215000,CSE 12,A01,083652,Krause-Levy; Sophia Louisa,21,1,120,99
1657013221029,CSE 15L,A01,083654,Morris; Justin Loren,8,0,50,42
1657013221029,CSE 15L,A02,083655,Morris; Justin Loren,9,0,50,41
1657013227052,CSE 20,A01,083657,Tran; Khoa Dang,37,0,80,43
1657013233077,CSE 21,A01,095574,Bach; Quang Tran,21,0,48,27
1657013239195,CSE 30,A01,083084,Eldon; John,4,0,80,76
1657013239195,CSE 30,B01,095061,Bhaskar; Nishant,6,0,50,44
1657013245217,CSE 100,A01,083659,Cao; Yingjun,3,4,70,67
1657013251251,CSE 134B,A01,083661,Powell; Thomas Allan,19,0,100,81
1657013257278,CSE 140,A01,083663,Gungor; Onat,14,0,85,71
1657013263301,CSE 140L,A01,083088,Eldon; John,16,0,100,84
1657013269326,CSE 175,A01,083665,Kumar; Rakesh,3,0,25,22
1657013275355,CSE 190,A00,092507,Dubnov; Shlomo,7,0,20,13
1657013281378,ECE 45,A01,083139,Congero; Spencer William,5,0,75,70
1657013287405,ECE 65,A50,083695,Saad; Andrew S,12,0,30,18
1657013287405,ECE 65,A51,095125,Saad; Andrew S,25,0,26,1
1657013293435,ECE 109,A01,091882,Touri; Behrouz,16,0,70,54
1657013299463,ECE 180,A00,083140,Abi Samra; Nicholas Camill,1,0,30,29
1657013299463,ECE 180,B00,083141,Abi Samra; Nicholas Camill,0,0,30,30
1657013305487,MATH 10A,A01,083735,Patchell; Gregory David,1,0,30,29
1657013305487,MATH 10A,A02,083736,Patchell; Gregory David,20,0,30,10
1657013305487,MATH 10A,A03,083737,Patchell; Gregory David,16,0,30,14
1657013311513,MATH 10B,A01,083207,Lim; Seonhee,7,0,34,27
1657013311513,MATH 10B,A02,083208,Lim; Seonhee,9,0,35,26
1657013311513,MATH 10B,A03,093472,Lim; Seonhee,4,0,34,30
1657013311513,MATH 10B,B01,083739,Sinha; Shubham,9,0,30,21
1657013317539,MATH 18,A01,083743,Cinel; Cameron Alexander,6,0,30,24
1657013317539,MATH 18,A02,083744,Cinel; Cameron Alexander,15,0,30,15
1657013317539,MATH 18,A03,083745,Cinel; Cameron Alexander,8,0,30,22
1657013317539,MATH 18,B01,083748,Rideout; David Porter,4,0,37,33
1657013317539,MATH 18,B02,083749,Rideout; David Porter,3,0,36,33
1657013317539,MATH 18,B03,083750,Rideout; David Porter,2,0,37,35
1657013317539,MATH 18,B04,083751,Rideout; David Porter,5,0,36,31
1657013317539,MATH 18,B05,093473,Rideout; David Porter,4,0,36,32
1657013317539,MATH 18,B06,093474,Rideout; David Porter,5,0,36,31
1657013323567,MATH 20A,A01,083754,Zheng; Zequn,12,0,40,28
1657013329594,MATH 20B,A01,083756,Briones; Jor-el Thomas Caparas,1,0,36,35
1657013329594,MATH 20B,A02,083757,Briones; Jor-el Thomas Caparas,1,0,36,35
1657013329594,MATH 20B,A03,093475,Briones; Jor-el Thomas Caparas,0,0,36,36
1657013335622,MATH 20C,A01,083760,Briones; Jor-el Thomas Caparas,1,0,35,34
1657013335622,MATH 20C,A02,083761,Briones; Jor-el Thomas Caparas,8,0,35,27
1657013335622,MATH 20C,A03,093476,Briones; Jor-el Thomas Caparas,0,1,36,36
1657013335622,MATH 20C,B01,083762,Bach; Quang Tran,0,0,30,30
1657013341647,MATH 20D,A01,083765,Tran; Brian Kha,4,0,30,26
1657013341647,MATH 20D,A02,083766,Tran; Brian Kha,5,0,30,25
1657013341647,MATH 20D,A03,083767,Tran; Brian Kha,3,0,30,27
1657013347669,MATH 20E,A01,083771,Ganguly; Soumya,5,0,32,27
1657013347669,MATH 20E,A02,083772,Ganguly; Soumya,6,0,32,26
1657013347669,MATH 20E,B01,083773,Ciotti; Benjamin,18,0,35,17
1657013347669,MATH 20E,B02,083774,Ciotti; Benjamin,17,0,35,18
1657013353694,MATH 103A,A01,083777,Greenfeld; Be'Eri,2,0,36,34
1657013353694,MATH 103A,A02,083778,Greenfeld; Be'Eri,5,0,36,31
1657013353694,MATH 103A,A03,093561,Greenfeld; Be'Eri,4,0,36,32
1657013353694,MATH 103A,B01,083779,Greenfeld; Be'Eri,6,0,36,30
1657013353694,MATH 103A,B02,083780,Greenfeld; Be'Eri,2,0,36,34
1657013353694,MATH 103A,B03,093562,Greenfeld; Be'Eri,2,0,36,34
1657013359717,MATH 105,A01,085443,Carter; Anne Toulson,14,0,35,21
1657013359717,MATH 105,A02,093477,Carter; Anne Toulson,20,0,35,15
1657013365741,MATH 109,A01,083213,Ganzberger; Geoffrey Michael,2,0,34,32
1657013365741,MATH 109,A02,083214,Ganzberger; Geoffrey Michael,2,0,34,32
1657013365741,MATH 109,A03,093478,Ganzberger; Geoffrey Michael,1,0,34,33
1657013365741,MATH 109,B01,083215,Ganzberger; Geoffrey Michael,1,0,32,31
1657013365741,MATH 109,B02,083216,Ganzberger; Geoffrey Michael,1,0,32,31
1657013365741,MATH 109,B03,093479,Ganzberger; Geoffrey Michael,6,0,32,26
1657013371765,MATH 142A,A01,083219,Chow; Bennett,6,0,32,26
1657013371765,MATH 142A,A02,083220,Chow; Bennett,10,0,32,22
1657013371765,MATH 142A,A03,093480,Chow; Bennett,7,0,32,25
1657013371765,MATH 142A,B03,093481,Chow; Bennett,7,0,32,25
1657013371765,MATH 142A,B04,093558,Chow; Bennett,11,0,32,21
1657013371765,MATH 142A,B05,093559,Chow; Bennett,6,0,32,26
1657013377789,MATH 193A,A01,083224,Rotar; Vladimir,7,0,34,27
1657013377789,MATH 193A,A02,083225,Rotar; Vladimir,4,0,34,30
1657013377789,MATH 193A,A03,083781,Rotar; Vladimir,1,0,34,33
1657013377789,MATH 193A,A04,083782,Rotar; Vladimir,6,0,34,28
1657013377789,MATH 193A,A05,093482,Rotar; Vladimir,6,0,34,28
1657013383813,MATH 197,001,091859,McAuley; Julian John,9999,0,9999,0
1657013383813,MATH 197,002,095566,Kedlaya; Kiran S.,9997,0,9999,2
1657013383813,MATH 197,003,095567,Xiao; Ming,9999,0,9999,0
1657013383813,MATH 197,004,095571,Perols; Johan Lars,9998,0,9999,1
1657013390876,COGS 9,A01,083615,Shannon; Kyle Michael,7,0,75,68
1657013396899,COGS 11,A01,083617,Boyle; Mary E. T.,20,0,48,28
1657013402922,COGS 13,A01,083071,Bastos; Amalia Pinkusfeld,9,0,71,62
1657013408950,COGS 14A,A01,092681,Semenuks; Arturs,0,1,100,100
1657013414974,COGS 14B,A01,083073,Cheng; Tzu-Han,5,0,63,58
1657013421000,COGS 17,A01,092677,Semenuks; Arturs,4,0,81,77
1657013427024,COGS 100,A01,083619,Allen; Michael Gordon,15,0,70,55
1657013433049,COGS 101A,A01,083621,Davis; Joshua Daniel,9,0,68,59
1657013439077,COGS 101B,A01,091572,Allen; Michael Gordon,8,0,65,57
1657013445102,COGS 101C,A01,083625,Delgado; Tania,17,0,35,18
1657013451126,COGS 107A,A01,083627,Boyle; Mary E. T.,13,0,60,47
1657013457151,COGS 118A,A01,083075,Gupta; Anjum,15,0,76,61
1657013463176,CSE 3,A50,083646,Miranda; Gregory Joseph,22,0,50,28
1657013469200,CSE 8A,A50,083650,Miranda; Gregory Joseph,17,1,56,39
1657013475229,CSE 11,A01,083080,Cao; Yingjun,4,15,40,36
1657013481254,CSE 12,A01,083652,Krause-Levy; Sophia Louisa,21,1,120,99
1657013487282,CSE 15L,A01,083654,Morris; Justin Loren,8,0,50,42
1657013487282,CSE 15L,A02,083655,Morris; Justin Loren,9,0,50,41
1657013493307,CSE 20,A01,083657,Tran; Khoa Dang,37,0,80,43
1657013499332,CSE 21,A01,095574,Bach; Quang Tran,21,0,48,27
1657013505358,CSE 30,A01,083084,Eldon; John,4,0,80,76
1657013505358,CSE 30,B01,095061,Bhaskar; Nishant,6,0,50,44
1657013511384,CSE 100,A01,083659,Cao; Yingjun,3,4,70,67
1657013517408,CSE 134B,A01,083661,Powell; Thomas Allan,19,0,100,81
1657013523437,CSE 140,A01,083663,Gungor; Onat,14,0,85,71
1657013529461,CSE 140L,A01,083088,Eldon; John,16,0,100,84
1657013535491,CSE 175,A01,083665,Kumar; Rakesh,3,0,25,22
1657013541515,CSE 190,A00,092507,Dubnov; Shlomo,7,0,20,13
1657013547552,ECE 45,A01,083139,Congero; Spencer William,5,0,75,70
1657013553585,ECE 65,A50,083695,Saad; Andrew S,12,0,30,18
1657013553585,ECE 65,A51,095125,Saad; Andrew S,25,0,26,1
1657013559611,ECE 109,A01,091882,Touri; Behrouz,16,0,70,54
1657013565642,ECE 180,A00,083140,Abi Samra; Nicholas Camill,1,0,30,29
1657013565642,ECE 180,B00,083141,Abi Samra; Nicholas Camill,0,0,30,30
1657013571676,MATH 10A,A01,083735,Patchell; Gregory David,1,0,30,29
1657013571676,MATH 10A,A02,083736,Patchell; Gregory David,20,0,30,10
1657013571676,MATH 10A,A03,083737,Patchell; Gregory David,16,0,30,14
1657013577701,MATH 10B,A01,083207,Lim; Seonhee,7,0,34,27
1657013577701,MATH 10B,A02,083208,Lim; Seonhee,9,0,35,26
1657013577701,MATH 10B,A03,093472,Lim; Seonhee,4,0,34,30
1657013577701,MATH 10B,B01,083739,Sinha; Shubham,9,0,30,21
1657013583729,MATH 18,A01,083743,Cinel; Cameron Alexander,6,0,30,24
1657013583729,MATH 18,A02,083744,Cinel; Cameron Alexander,15,0,30,15
1657013583729,MATH 18,A03,083745,Cinel; Cameron Alexander,8,0,30,22
1657013583729,MATH 18,B01,083748,Rideout; David Porter,4,0,37,33
1657013583729,MATH 18,B02,083749,Rideout; David Porter,3,0,36,33
1657013583729,MATH 18,B03,083750,Rideout; David Porter,2,0,37,35
1657013583729,MATH 18,B04,083751,Rideout; David Porter,5,0,36,31
1657013583729,MATH 18,B05,093473,Rideout; David Porter,4,0,36,32
1657013583729,MATH 18,B06,093474,Rideout; David Porter,5,0,36,31
1657013589756,MATH 20A,A01,083754,Zheng; Zequn,12,0,40,28
1657013595786,MATH 20B,A01,083756,Briones; Jor-el Thomas Caparas,1,0,36,35
1657013595786,MATH 20B,A02,083757,Briones; Jor-el Thomas Caparas,1,0,36,35
1657013595786,MATH 20B,A03,093475,Briones; Jor-el Thomas Caparas,0,0,36,36
1657013601810,MATH 20C,A01,083760,Briones; Jor-el Thomas Caparas,1,0,35,34
1657013601810,MATH 20C,A02,083761,Briones; Jor-el Thomas Caparas,8,0,35,27
1657013601810,MATH 20C,A03,093476,Briones; Jor-el Thomas Caparas,0,1,36,36
1657013601810,MATH 20C,B01,083762,Bach; Quang Tran,0,0,30,30
1657013607835,MATH 20D,A01,083765,Tran; Brian Kha,4,0,30,26
1657013607835,MATH 20D,A02,083766,Tran; Brian Kha,5,0,30,25
1657013607835,MATH 20D,A03,083767,Tran; Brian Kha,3,0,30,27
1657013613861,MATH 20E,A01,083771,Ganguly; Soumya,5,0,32,27
1657013613861,MATH 20E,A02,083772,Ganguly; Soumya,6,0,32,26
1657013613861,MATH 20E,B01,083773,Ciotti; Benjamin,18,0,35,17
1657013613861,MATH 20E,B02,083774,Ciotti; Benjamin,17,0,35,18
1657013619889,MATH 103A,A01,083777,Greenfeld; Be'Eri,2,0,36,34
1657013619889,MATH 103A,A02,083778,Greenfeld; Be'Eri,5,0,36,31
1657013619889,MATH 103A,A03,093561,Greenfeld; Be'Eri,4,0,36,32
1657013619889,MATH 103A,B01,083779,Greenfeld; Be'Eri,6,0,36,30
1657013619889,MATH 103A,B02,083780,Greenfeld; Be'Eri,2,0,36,34
1657013619889,MATH 103A,B03,093562,Greenfeld; Be'Eri,2,0,36,34
1657013625918,MATH 105,A01,085443,Carter; Anne Toulson,14,0,35,21
1657013625918,MATH 105,A02,093477,Carter; Anne Toulson,20,0,35,15
1657013631941,MATH 109,A01,083213,Ganzberger; Geoffrey Michael,2,0,34,32
1657013631941,MATH 109,A02,083214,Ganzberger; Geoffrey Michael,2,0,34,32
1657013631941,MATH 109,A03,093478,Ganzberger; Geoffrey Michael,1,0,34,33
1657013631941,MATH 109,B01,083215,Ganzberger; Geoffrey Michael,1,0,32,31
1657013631941,MATH 109,B02,083216,Ganzberger; Geoffrey Michael,1,0,32,31
1657013631941,MATH 109,B03,093479,Ganzberger; Geoffrey Michael,6,0,32,26
1657013637969,MATH 142A,A01,083219,Chow; Bennett,6,0,32,26
1657013637969,MATH 142A,A02,083220,Chow; Bennett,10,0,32,22
1657013637969,MATH 142A,A03,093480,Chow; Bennett,7,0,32,25
1657013637969,MATH 142A,B03,093481,Chow; Bennett,7,0,32,25
1657013637969,MATH 142A,B04,093558,Chow; Bennett,11,0,32,21
1657013637969,MATH 142A,B05,093559,Chow; Bennett,6,0,32,26
1657013643996,MATH 193A,A01,083224,Rotar; Vladimir,7,0,34,27
1657013643996,MATH 193A,A02,083225,Rotar; Vladimir,4,0,34,30
1657013643996,MATH 193A,A03,083781,Rotar; Vladimir,1,0,34,33
1657013643996,MATH 193A,A04,083782,Rotar; Vladimir,6,0,34,28
1657013643996,MATH 193A,A05,093482,Rotar; Vladimir,6,0,34,28
1657013650018,MATH 197,001,091859,McAuley; Julian John,9999,0,9999,0
1657013650018,MATH 197,002,095566,Kedlaya; Kiran S.,9997,0,9999,2
1657013650018,MATH 197,003,095567,Xiao; Ming,9999,0,9999,0
1657013650018,MATH 197,004,095571,Perols; Johan Lars,9998,0,9999,1
1657013657088,COGS 9,A01,083615,Shannon; Kyle Michael,7,0,75,68
1657013663112,COGS 11,A01,083617,Boyle; Mary E. T.,20,0,48,28
1657013669135,COGS 13,A01,083071,Bastos; Amalia Pinkusfeld,9,0,71,62
1657013675159,COGS 14A,A01,092681,Semenuks; Arturs,0,1,100,100
1657013681183,COGS 14B,A01,083073,Cheng; Tzu-Han,5,0,63,58
1657013687211,COGS 17,A01,092677,Semenuks; Arturs,4,0,81,77
1657013693235,COGS 100,A01,083619,Allen; Michael Gordon,15,0,70,55
1657013699265,COGS 101A,A01,083621,Davis; Joshua Daniel,9,0,68,59
1657013705288,COGS 101B,A01,091572,Allen; Michael Gordon,8,0,65,57
1657013711313,COGS 101C,A01,083625,Delgado; Tania,17,0,35,18
1657013717337,COGS 107A,A01,083627,Boyle; Mary E. T.,13,0,60,47
1657013723363,COGS 118A,A01,083075,Gupta; Anjum,15,0,76,61
1657013729387,CSE 3,A50,083646,Miranda; Gregory Joseph,22,0,50,28
1657013735413,CSE 8A,A50,083650,Miranda; Gregory Joseph,17,1,56,39
1657013741436,CSE 11,A01,083080,Cao; Yingjun,4,15,40,36
1657013747469,CSE 12,A01,083652,Krause-Levy; Sophia Louisa,21,1,120,99
1657013753494,CSE 15L,A01,083654,Morris; Justin Loren,8,0,50,42
1657013753494,CSE 15L,A02,083655,Morris; Justin Loren,9,0,50,41
1657013759517,CSE 20,A01,083657,Tran; Khoa Dang,37,0,80,43
1657013765545,CSE 21,A01,095574,Bach; Quang Tran,21,0,48,27
1657013771573,CSE 30,A01,083084,Eldon; John,4,0,80,76
1657013771573,CSE 30,B01,095061,Bhaskar; Nishant,6,0,50,44
1657013777597,CSE 100,A01,083659,Cao; Yingjun,3,4,70,67
1657013783624,CSE 134B,A01,083661,Powell; Thomas Allan,19,0,100,81
1657013789649,CSE 140,A01,083663,Gungor; Onat,14,0,85,71
1657013795673,CSE 140L,A01,083088,Eldon; John,16,0,100,84
1657013801697,CSE 175,A01,083665,Kumar; Rakesh,3,0,25,22
1657013807721,CSE 190,A00,092507,Dubnov; Shlomo,7,0,20,13
1657013813746,ECE 45,A01,083139,Congero; Spencer William,5,0,75,70
1657013819776,ECE 65,A50,083695,Saad; Andrew S,12,0,30,18
1657013819776,ECE 65,A51,095125,Saad; Andrew S,25,0,26,1
1657013825801,ECE 109,A01,091882,Touri; Behrouz,16,0,70,54
1657013831827,ECE 180,A00,083140,Abi Samra; Nicholas Camill,1,0,30,29
1657013831827,ECE 180,B00,083141,Abi Samra; Nicholas Camill,0,0,30,30
1657013837944,MATH 10A,A01,083735,Patchell; Gregory David,1,0,30,29
1657013837944,MATH 10A,A02,083736,Patchell; Gregory David,20,0,30,10
1657013837944,MATH 10A,A03,083737,Patchell; Gregory David,16,0,30,14
1657013843968,MATH 10B,A01,083207,Lim; Seonhee,7,0,34,27
1657013843968,MATH 10B,A02,083208,Lim; Seonhee,9,0,35,26
1657013843968,MATH 10B,A03,093472,Lim; Seonhee,4,0,34,30
1657013843968,MATH 10B,B01,083739,Sinha; Shubham,9,0,30,21
1657013849992,MATH 18,A01,083743,Cinel; Cameron Alexander,6,0,30,24
1657013849992,MATH 18,A02,083744,Cinel; Cameron Alexander,15,0,30,15
1657013849992,MATH 18,A03,083745,Cinel; Cameron Alexander,8,0,30,22
1657013849992,MATH 18,B01,083748,Rideout; David Porter,4,0,37,33
1657013849992,MATH 18,B02,083749,Rideout; David Porter,3,0,36,33
1657013849992,MATH 18,B03,083750,Rideout; David Porter,2,0,37,35
1657013849992,MATH 18,B04,083751,Rideout; David Porter,5,0,36,31
1657013849992,MATH 18,B05,093473,Rideout; David Porter,4,0,36,32
1657013849992,MATH 18,B06,093474,Rideout; David Porter,5,0,36,31
1657013856018,MATH 20A,A01,083754,Zheng; Zequn,12,0,40,28
1657013862042,MATH 20B,A01,083756,Briones; Jor-el Thomas Caparas,1,0,36,35
1657013862042,MATH 20B,A02,083757,Briones; Jor-el Thomas Caparas,1,0,36,35
1657013862042,MATH 20B,A03,093475,Briones; Jor-el Thomas Caparas,0,0,36,36
1657013868088,MATH 20C,A01,083760,Briones; Jor-el Thomas Caparas,1,0,35,34
1657013868088,MATH 20C,A02,083761,Briones; Jor-el Thomas Caparas,8,0,35,27
1657013868088,MATH 20C,A03,093476,Briones; Jor-el Thomas Caparas,0,1,36,36
1657013868088,MATH 20C,B01,083762,Bach; Quang Tran,0,0,30,30
1657013874113,MATH 20D,A01,083765,Tran; Brian Kha,4,0,30,26
1657013874113,MATH 20D,A02,083766,Tran; Brian Kha,5,0,30,25
1657013874113,MATH 20D,A03,083767,Tran; Brian Kha,3,0,30,27
1657013880145,MATH 20E,A01,083771,Ganguly; Soumya,5,0,32,27
1657013880145,MATH 20E,A02,083772,Ganguly; Soumya,6,0,32,26
1657013880145,MATH 20E,B01,083773,Ciotti; Benjamin,18,0,35,17
1657013880145,MATH 20E,B02,083774,Ciotti; Benjamin,17,0,35,18
1657013886168,MATH 103A,A01,083777,Greenfeld; Be'Eri,2,0,36,34
1657013886168,MATH 103A,A02,083778,Greenfeld; Be'Eri,5,0,36,31
1657013886168,MATH 103A,A03,093561,Greenfeld; Be'Eri,4,0,36,32
1657013886168,MATH 103A,B01,083779,Greenfeld; Be'Eri,6,0,36,30
1657013886168,MATH 103A,B02,083780,Greenfeld; Be'Eri,2,0,36,34
1657013886168,MATH 103A,B03,093562,Greenfeld; Be'Eri,2,0,36,34
1657013892192,MATH 105,A01,085443,Carter; Anne Toulson,14,0,35,21
1657013892192,MATH 105,A02,093477,Carter; Anne Toulson,20,0,35,15
1657013898227,MATH 109,A01,083213,Ganzberger; Geoffrey Michael,2,0,34,32
1657013898227,MATH 109,A02,083214,Ganzberger; Geoffrey Michael,2,0,34,32
1657013898227,MATH 109,A03,093478,Ganzberger; Geoffrey Michael,1,0,34,33
1657013898227,MATH 109,B01,083215,Ganzberger; Geoffrey Michael,1,0,32,31
1657013898227,MATH 109,B02,083216,Ganzberger; Geoffrey Michael,1,0,32,31
1657013898227,MATH 109,B03,093479,Ganzberger; Geoffrey Michael,6,0,32,26
1657013904256,MATH 142A,A01,083219,Chow; Bennett,6,0,32,26
1657013904256,MATH 142A,A02,083220,Chow; Bennett,10,0,32,22
1657013904256,MATH 142A,A03,093480,Chow; Bennett,7,0,32,25
1657013904256,MATH 142A,B03,093481,Chow; Bennett,7,0,32,25
1657013904256,MATH 142A,B04,093558,Chow; Bennett,11,0,32,21
1657013904256,MATH 142A,B05,093559,Chow; Bennett,6,0,32,26
1657013910283,MATH 193A,A01,083224,Rotar; Vladimir,7,0,34,27
1657013910283,MATH 193A,A02,083225,Rotar; Vladimir,4,0,34,30
1657013910283,MATH 193A,A03,083781,Rotar; Vladimir,1,0,34,33
1657013910283,MATH 193A,A04,083782,Rotar; Vladimir,6,0,34,28
1657013910283,MATH 193A,A05,093482,Rotar; Vladimir,6,0,34,28
1657013916308,MATH 197,001,091859,McAuley; Julian John,9999,0,9999,0
1657013916308,MATH 197,002,095566,Kedlaya; Kiran S.,9997,0,9999,2
1657013916308,MATH 197,003,095567,Xiao; Ming,9999,0,9999,0
1657013916308,MATH 197,004,095571,Perols; Johan Lars,9998,0,9999,1
1657013923370,COGS 9,A01,083615,Shannon; Kyle Michael,7,0,75,68
1657013929398,COGS 11,A01,083617,Boyle; Mary E. T.,20,0,48,28
1657013935422,COGS 13,A01,083071,Bastos; Amalia Pinkusfeld,9,0,71,62
1657013941451,COGS 14A,A01,092681,Semenuks; Arturs,0,1,100,100
1657013947475,COGS 14B,A01,083073,Cheng; Tzu-Han,5,0,63,58
1657013953504,COGS 17,A01,092677,Semenuks; Arturs,4,0,81,77
1657013959535,COGS 100,A01,083619,Allen; Michael Gordon,15,0,70,55
1657013965564,COGS 101A,A01,083621,Davis; Joshua Daniel,9,0,68,59
1657013971589,COGS 101B,A01,091572,Allen; Michael Gordon,8,0,65,57
1657013977611,COGS 101C,A01,083625,Delgado; Tania,17,0,35,18
1657013983634,COGS 107A,A01,083627,Boyle; Mary E. T.,13,0,60,47
1657013989659,COGS 118A,A01,083075,Gupta; Anjum,15,0,76,61
1657013995683,CSE 3,A50,083646,Miranda; Gregory Joseph,22,0,50,28
1657014001708,CSE 8A,A50,083650,Miranda; Gregory Joseph,17,1,56,39
1657014007736,CSE 11,A01,083080,Cao; Yingjun,4,15,40,36
1657014013764,CSE 12,A01,083652,Krause-Levy; Sophia Louisa,21,1,120,99
1657014019790,CSE 15L,A01,083654,Morris; Justin Loren,8,0,50,42
1657014019790,CSE 15L,A02,083655,Morris; Justin Loren,9,0,50,41
1657014025816,CSE 20,A01,083657,Tran; Khoa Dang,37,0,80,43
1657014031840,CSE 21,A01,095574,Bach; Quang Tran,21,0,48,27
1657014037865,CSE 30,A01,083084,Eldon; John,4,0,80,76
1657014037865,CSE 30,B01,095061,Bhaskar; Nishant,6,0,50,44
1657014043892,CSE 100,A01,083659,Cao; Yingjun,3,4,70,67
1657014049915,CSE 134B,A01,083661,Powell; Thomas Allan,19,0,100,81
1657014055939,CSE 140,A01,083663,Gungor; Onat,14,0,85,71
1657014061967,CSE 140L,A01,083088,Eldon; John,16,0,100,84
1657014067993,CSE 175,A01,083665,Kumar; Rakesh,3,0,25,22
1657014074016,CSE 190,A00,092507,Dubnov; Shlomo,7,0,20,13
1657014080040,ECE 45,A01,083139,Congero; Spencer William,5,0,75,70
1657014086084,ECE 65,A50,083695,Saad; Andrew S,12,0,30,18
1657014086084,ECE 65,A51,095125,Saad; Andrew S,25,0,26,1
1657014092112,ECE 109,A01,091882,Touri; Behrouz,16,0,70,54
1657014098135,ECE 180,A00,083140,Abi Samra; Nicholas Camill,1,0,30,29
1657014098135,ECE 180,B00,083141,Abi Samra; Nicholas Camill,0,0,30,30
1657014104161,MATH 10A,A01,083735,Patchell; Gregory David,1,0,30,29
1657014104161,MATH 10A,A02,083736,Patchell; Gregory David,20,0,30,10
1657014104161,MATH 10A,A03,083737,Patchell; Gregory David,16,0,30,14
1657014110185,MATH 10B,A01,083207,Lim; Seonhee,7,0,34,27
1657014110185,MATH 10B,A02,083208,Lim; Seonhee,9,0,35,26
1657014110185,MATH 10B,A03,093472,Lim; Seonhee,4,0,34,30
1657014110185,MATH 10B,B01,083739,Sinha; Shubham,9,0,30,21
1657014116211,MATH 18,A01,083743,Cinel; Cameron Alexander,6,0,30,24
1657014116211,MATH 18,A02,083744,Cinel; Cameron Alexander,15,0,30,15
1657014116211,MATH 18,A03,083745,Cinel; Cameron Alexander,8,0,30,22
1657014116211,MATH 18,B01,083748,Rideout; David Porter,4,0,37,33
1657014116211,MATH 18,B02,083749,Rideout; David Porter,3,0,36,33
1657014116211,MATH 18,B03,083750,Rideout; David Porter,2,0,37,35
1657014116211,MATH 18,B04,083751,Rideout; David Porter,5,0,36,31
1657014116211,MATH 18,B05,093473,Rideout; David Porter,4,0,36,32
1657014116211,MATH 18,B06,093474,Rideout; David Porter,5,0,36,31
1657014122235,MATH 20A,A01,083754,Zheng; Zequn,12,0,40,28
1657014128265,MATH 20B,A01,083756,Briones; Jor-el Thomas Caparas,1,0,36,35
1657014128265,MATH 20B,A02,083757,Briones; Jor-el Thomas Caparas,1,0,36,35
1657014128265,MATH 20B,A03,093475,Briones; Jor-el Thomas Caparas,0,0,36,36
1657014134288,MATH 20C,A01,083760,Briones; Jor-el Thomas Caparas,1,0,35,34
1657014134288,MATH 20C,A02,083761,Briones; Jor-el Thomas Caparas,8,0,35,27
1657014134288,MATH 20C,A03,093476,Briones; Jor-el Thomas Caparas,0,1,36,36
1657014134288,MATH 20C,B01,083762,Bach; Quang Tran,0,0,30,30
1657014140312,MATH 20D,A01,083765,Tran; Brian Kha,4,0,30,26
1657014140312,MATH 20D,A02,083766,Tran; Brian Kha,5,0,30,25
1657014140312,MATH 20D,A03,083767,Tran; Brian Kha,3,0,30,27
1657014146335,MATH 20E,A01,083771,Ganguly; Soumya,5,0,32,27
1657014146335,MATH 20E,A02,083772,Ganguly; Soumya,6,0,32,26
1657014146335,MATH 20E,B01,083773,Ciotti; Benjamin,18,0,35,17
1657014146335,MATH 20E,B02,083774,Ciotti; Benjamin,17,0,35,18
1657014152362,MATH 103A,A01,083777,Greenfeld; Be'Eri,2,0,36,34
1657014152362,MATH 103A,A02,083778,Greenfeld; Be'Eri,5,0,36,31
1657014152362,MATH 103A,A03,093561,Greenfeld; Be'Eri,4,0,36,32
1657014152362,MATH 103A,B01,083779,Greenfeld; Be'Eri,6,0,36,30
1657014152362,MATH 103A,B02,083780,Greenfeld; Be'Eri,2,0,36,34
1657014152362,MATH 103A,B03,093562,Greenfeld; Be'Eri,2,0,36,34
1657014158387,MATH 105,A01,085443,Carter; Anne Toulson,14,0,35,21
1657014158387,MATH 105,A02,093477,Carter; Anne Toulson,20,0,35,15
1657014164412,MATH 109,A01,083213,Ganzberger; Geoffrey Michael,2,0,34,32
1657014164412,MATH 109,A02,083214,Ganzberger; Geoffrey Michael,2,0,34,32
1657014164412,MATH 109,A03,093478,Ganzberger; Geoffrey Michael,1,0,34,33
1657014164412,MATH 109,B01,083215,Ganzberger; Geoffrey Michael,1,0,32,31
1657014164412,MATH 109,B02,083216,Ganzberger; Geoffrey Michael,1,0,32,31
1657014164412,MATH 109,B03,093479,Ganzberger; Geoffrey Michael,6,0,32,26
1657014170443,MATH 142A,A01,083219,Chow; Bennett,6,0,32,26
1657014170443,MATH 142A,A02,083220,Chow; Bennett,10,0,32,22
1657014170443,MATH 142A,A03,093480,Chow; Bennett,7,0,32,25
1657014170443,MATH 142A,B03,093481,Chow; Bennett,7,0,32,25
1657014170443,MATH 142A,B04,093558,Chow; Bennett,11,0,32,21
1657014170443,MATH 142A,B05,093559,Chow; Bennett,6,0,32,26
1657014176468,MATH 193A,A01,083224,Rotar; Vladimir,7,0,34,27
1657014176468,MATH 193A,A02,083225,Rotar; Vladimir,4,0,34,30
1657014176468,MATH 193A,A03,083781,Rotar; Vladimir,1,0,34,33
1657014176468,MATH 193A,A04,083782,Rotar; Vladimir,6,0,34,28
1657014176468,MATH 193A,A05,093482,Rotar; Vladimir,6,0,34,28
1657014182492,MATH 197,001,091859,McAuley; Julian John,9999,0,9999,0
1657014182492,MATH 197,002,095566,Kedlaya; Kiran S.,9997,0,9999,2
1657014182492,MATH 197,003,095567,Xiao; Ming,9999,0,9999,0
1657014182492,MATH 197,004,095571,Perols; Johan Lars,9998,0,9999,1
1657014189566,COGS 9,A01,083615,Shannon; Kyle Michael,7,0,75,68
1657014195594,COGS 11,A01,083617,Boyle; Mary E. T.,20,0,48,28
1657014201617,COGS 13,A01,083071,Bastos; Amalia Pinkusfeld,9,0,71,62
1657014207640,COGS 14A,A01,092681,Semenuks; Arturs,0,1,100,100
1657014213668,COGS 14B,A01,083073,Cheng; Tzu-Han,5,0,63,58
1657014219691,COGS 17,A01,092677,Semenuks; Arturs,4,0,81,77
1657014225715,COGS 100,A01,083619,Allen; Michael Gordon,15,0,70,55
1657014231738,COGS 101A,A01,083621,Davis; Joshua Daniel,9,0,68,59
1657014237762,COGS 101B,A01,091572,Allen; Michael Gordon,8,0,65,57
1657014243789,COGS 101C,A01,083625,Delgado; Tania,17,0,35,18
1657014249810,COGS 107A,A01,083627,Boyle; Mary E. T.,13,0,60,47
1657014255833,COGS 118A,A01,083075,Gupta; Anjum,15,0,76,61
1657014261857,CSE 3,A50,083646,Miranda; Gregory Joseph,22,0,50,28
1657014267881,CSE 8A,A50,083650,Miranda; Gregory Joseph,17,1,56,39
1657014273904,CSE 11,A01,083080,Cao; Yingjun,4,15,40,36
1657014279928,CSE 12,A01,083652,Krause-Levy; Sophia Louisa,21,1,120,99
1657014285954,CSE 15L,A01,083654,Morris; Justin Loren,8,0,50,42
1657014285954,CSE 15L,A02,083655,Morris; Justin Loren,9,0,50,41
1657014291982,CSE 20,A01,083657,Tran; Khoa Dang,37,0,80,43
1657014298006,CSE 21,A01,095574,Bach; Quang Tran,21,0,48,27
1657014304030,CSE 30,A01,083084,Eldon; John,4,0,80,76
1657014304030,CSE 30,B01,095061,Bhaskar; Nishant,6,0,50,44
1657014310053,CSE 100,A01,083659,Cao; Yingjun,3,4,70,67
1657014316080,CSE 134B,A01,083661,Powell; Thomas Allan,19,0,100,81
1657014322104,CSE 140,A01,083663,Gungor; Onat,14,0,85,71
1657014328128,CSE 140L,A01,083088,Eldon; John,16,0,100,84
1657014334152,CSE 175,A01,083665,Kumar; Rakesh,3,0,25,22
1657014340179,CSE 190,A00,092507,Dubnov; Shlomo,7,0,20,13
1657014346207,ECE 45,A01,083139,Congero; Spencer William,5,0,75,70
1657014352231,ECE 65,A50,083695,Saad; Andrew S,12,0,30,18
1657014352231,ECE 65,A51,095125,Saad; Andrew S,25,0,26,1
1657014358254,ECE 109,A01,091882,Touri; Behrouz,16,0,70,54
1657014364282,ECE 180,A00,083140,Abi Samra; Nicholas Camill,1,0,30,29
1657014364282,ECE 180,B00,083141,Abi Samra; Nicholas Camill,0,0,30,30
1657014370310,MATH 10A,A01,083735,Patchell; Gregory David,1,0,30,29
1657014370310,MATH 10A,A02,083736,Patchell; Gregory David,20,0,30,10
1657014370310,MATH 10A,A03,083737,Patchell; Gregory David,16,0,30,14
1657014376333,MATH 10B,A01,083207,Lim; Seonhee,7,0,34,27
1657014376333,MATH 10B,A02,083208,Lim; Seonhee,9,0,35,26
1657014376333,MATH 10B,A03,093472,Lim; Seonhee,4,0,34,30
1657014376333,MATH 10B,B01,083739,Sinha; Shubham,9,0,30,21
1657014382358,MATH 18,A01,083743,Cinel; Cameron Alexander,6,0,30,24
1657014382358,MATH 18,A02,083744,Cinel; Cameron Alexander,15,0,30,15
1657014382358,MATH 18,A03,083745,Cinel; Cameron Alexander,8,0,30,22
1657014382358,MATH 18,B01,083748,Rideout; David Porter,4,0,37,33
1657014382358,MATH 18,B02,083749,Rideout; David Porter,3,0,36,33
1657014382358,MATH 18,B03,083750,Rideout; David Porter,2,0,37,35
1657014382358,MATH 18,B04,083751,Rideout; David Porter,5,0,36,31
1657014382358,MATH 18,B05,093473,Rideout; David Porter,4,0,36,32
1657014382358,MATH 18,B06,093474,Rideout; David Porter,5,0,36,31
1657014388384,MATH 20A,A01,083754,Zheng; Zequn,12,0,40,28
1657014394414,MATH 20B,A01,083756,Briones; Jor-el Thomas Caparas,1,0,36,35
1657014394414,MATH 20B,A02,083757,Briones; Jor-el Thomas Caparas,1,0,36,35
1657014394414,MATH 20B,A03,093475,Briones; Jor-el Thomas Caparas,0,0,36,36
1657014400441,MATH 20C,A01,083760,Briones; Jor-el Thomas Caparas,1,0,35,34
1657014400441,MATH 20C,A02,083761,Briones; Jor-el Thomas Caparas,8,0,35,27
1657014400441,MATH 20C,A03,093476,Briones; Jor-el Thomas Caparas,0,1,36,36
1657014400441,MATH 20C,B01,083762,Bach; Quang Tran,0,0,30,30
1657014406469,MATH 20D,A01,083765,Tran; Brian Kha,4,0,30,26
1657014406469,MATH 20D,A02,083766,Tran; Brian Kha,5,0,30,25
1657014406469,MATH 20D,A03,083767,Tran; Brian Kha,3,0,30,27
1657014412494,MATH 20E,A01,083771,Ganguly; Soumya,5,0,32,27
1657014412494,MATH 20E,A02,083772,Ganguly; Soumya,6,0,32,26
1657014412494,MATH 20E,B01,083773,Ciotti; Benjamin,18,0,35,17
1657014412494,MATH 20E,B02,083774,Ciotti; Benjamin,17,0,35,18
1657014418523,MATH 103A,A01,083777,Greenfeld; Be'Eri,2,0,36,34
1657014418523,MATH 103A,A02,083778,Greenfeld; Be'Eri,5,0,36,31
1657014418523,MATH 103A,A03,093561,Greenfeld; Be'Eri,4,0,36,32
1657014418523,MATH 103A,B01,083779,Greenfeld; Be'Eri,6,0,36,30
1657014418523,MATH 103A,B02,083780,Greenfeld; Be'Eri,2,0,36,34
1657014418523,MATH 103A,B03,093562,Greenfeld; Be'Eri,2,0,36,34
1657014424546,MATH 105,A01,085443,Carter; Anne Toulson,14,0,35,21
1657014424546,MATH 105,A02,093477,Carter; Anne Toulson,20,0,35,15
1657014430576,MATH 109,A01,083213,Ganzberger; Geoffrey Michael,2,0,34,32
1657014430576,MATH 109,A02,083214,Ganzberger; Geoffrey Michael,2,0,34,32
1657014430576,MATH 109,A03,093478,Ganzberger; Geoffrey Michael,1,0,34,33
1657014430576,MATH 109,B01,083215,Ganzberger; Geoffrey Michael,1,0,32,31
1657014430576,MATH 109,B02,083216,Ganzberger; Geoffrey Michael,1,0,32,31
1657014430576,MATH 109,B03,093479,Ganzberger; Geoffrey Michael,6,0,32,26
1657014436675,MATH 142A,A01,083219,Chow; Bennett,6,0,32,26
1657014436675,MATH 142A,A02,083220,Chow; Bennett,10,0,32,22
1657014436675,MATH 142A,A03,093480,Chow; Bennett,7,0,32,25
1657014436675,MATH 142A,B03,093481,Chow; Bennett,7,0,32,25
1657014436675,MATH 142A,B04,093558,Chow; Bennett,11,0,32,21
1657014436675,MATH 142A,B05,093559,Chow; Bennett,6,0,32,26
1657014442703,MATH 193A,A01,083224,Rotar; Vladimir,7,0,34,27
1657014442703,MATH 193A,A02,083225,Rotar; Vladimir,4,0,34,30
1657014442703,MATH 193A,A03,083781,Rotar; Vladimir,1,0,34,33
1657014442703,MATH 193A,A04,083782,Rotar; Vladimir,6,0,34,28
1657014442703,MATH 193A,A05,093482,Rotar; Vladimir,6,0,34,28
1657014448730,MATH 197,001,091859,McAuley; Julian John,9999,0,9999,0
1657014448730,MATH 197,002,095566,Kedlaya; Kiran S.,9997,0,9999,2
1657014448730,MATH 197,003,095567,Xiao; Ming,9999,0,9999,0
1657014448730,MATH 197,004,095571,Perols; Johan Lars,9998,0,9999,1
1657014455783,COGS 9,A01,083615,Shannon; Kyle Michael,7,0,75,68
1657014461808,COGS 11,A01,083617,Boyle; Mary E. T.,20,0,48,28
1657014467836,COGS 13,A01,083071,Bastos; Amalia Pinkusfeld,9,0,71,62
1657014473863,COGS 14A,A01,092681,Semenuks; Arturs,0,1,100,100
1657014479887,COGS 14B,A01,083073,Cheng; Tzu-Han,5,0,63,58
1657014485915,COGS 17,A01,092677,Semenuks; Arturs,4,0,81,77
1657014491942,COGS 100,A01,083619,Allen; Michael Gordon,15,0,70,55
1657014497966,COGS 101A,A01,083621,Davis; Joshua Daniel,9,0,68,59
1657014503992,COGS 101B,A01,091572,Allen; Michael Gordon,8,0,65,57
1657014510015,COGS 101C,A01,083625,Delgado; Tania,17,0,35,18
1657014516039,COGS 107A,A01,083627,Boyle; Mary E. T.,13,0,60,47
1657014522064,COGS 118A,A01,083075,Gupta; Anjum,15,0,76,61
1657014528087,CSE 3,A50,083646,Miranda; Gregory Joseph,22,0,50,28
1657014534113,CSE 8A,A50,083650,Miranda; Gregory Joseph,17,1,56,39
1657014540136,CSE 11,A01,083080,Cao; Yingjun,4,15,40,36
1657014546161,CSE 12,A01,083652,Krause-Levy; Sophia Louisa,21,1,120,99
1657014552188,CSE 15L,A01,083654,Morris; Justin Loren,8,0,50,42
1657014552188,CSE 15L,A02,083655,Morris; Justin Loren,9,0,50,41
1657014558217,CSE 20,A01,083657,Tran; Khoa Dang,37,0,80,43
1657014564241,CSE 21,A01,095574,Bach; Quang Tran,21,0,48,27
1657014570265,CSE 30,A01,083084,Eldon; John,4,0,80,76
1657014570265,CSE 30,B01,095061,Bhaskar; Nishant,6,0,50,44
1657014576290,CSE 100,A01,083659,Cao; Yingjun,3,4,70,67
1657014582313,CSE 134B,A01,083661,Powell; Thomas Allan,19,0,100,81
1657014588338,CSE 140,A01,083663,Gungor; Onat,14,0,85,71
1657014594361,CSE 140L,A01,083088,Eldon; John,16,0,100,84
1657014600390,CSE 175,A01,083665,Kumar; Rakesh,3,0,25,22
1657014606424,CSE 190,A00,092507,Dubnov; Shlomo,7,0,20,13
1657014612450,ECE 45,A01,083139,Congero; Spencer William,5,0,75,70
1657014618477,ECE 65,A50,083695,Saad; Andrew S,12,0,30,18
1657014618477,ECE 65,A51,095125,Saad; Andrew S,25,0,26,1
1657014624510,ECE 109,A01,091882,Touri; Behrouz,16,0,70,54
1657014630534,ECE 180,A00,083140,Abi Samra; Nicholas Camill,1,0,30,29
1657014630534,ECE 180,B00,083141,Abi Samra; Nicholas Camill,0,0,30,30
1657014636558,MATH 10A,A01,083735,Patchell; Gregory David,1,0,30,29
1657014636558,MATH 10A,A02,083736,Patchell; Gregory David,20,0,30,10
1657014636558,MATH 10A,A03,083737,Patchell; Gregory David,16,0,30,14
1657014642582,MATH 10B,A01,083207,Lim; Seonhee,7,0,34,27
1657014642582,MATH 10B,A02,083208,Lim; Seonhee,9,0,35,26
1657014642582,MATH 10B,A03,093472,Lim; Seonhee,4,0,34,30
1657014642582,MATH 10B,B01,083739,Sinha; Shubham,9,0,30,21
1657014648644,MATH 18,A01,083743,Cinel; Cameron Alexander,6,0,30,24
1657014648644,MATH 18,A02,083744,Cinel; Cameron Alexander,15,0,30,15
1657014648644,MATH 18,A03,083745,Cinel; Cameron Alexander,8,0,30,22
1657014648644,MATH 18,B01,083748,Rideout; David Porter,4,0,37,33
1657014648644,MATH 18,B02,083749,Rideout; David Porter,3,0,36,33
1657014648644,MATH 18,B03,083750,Rideout; David Porter,2,0,37,35
1657014648644,MATH 18,B04,083751,Rideout; David Porter,5,0,36,31
1657014648644,MATH 18,B05,093473,Rideout; David Porter,4,0,36,32
1657014648644,MATH 18,B06,093474,Rideout; David Porter,5,0,36,31
1657014654667,MATH 20A,A01,083754,Zheng; Zequn,12,0,40,28
1657014660692,MATH 20B,A01,083756,Briones; Jor-el Thomas Caparas,1,0,36,35
1657014660692,MATH 20B,A02,083757,Briones; Jor-el Thomas Caparas,1,0,36,35
1657014660692,MATH 20B,A03,093475,Briones; Jor-el Thomas Caparas,0,0,36,36
1657014666720,MATH 20C,A01,083760,Briones; Jor-el Thomas Caparas,1,0,35,34
1657014666720,MATH 20C,A02,083761,Briones; Jor-el Thomas Caparas,8,0,35,27
1657014666720,MATH 20C,A03,093476,Briones; Jor-el Thomas Caparas,0,1,36,36
1657014666720,MATH 20C,B01,083762,Bach; Quang Tran,0,0,30,30
1657014672743,MATH 20D,A01,083765,Tran; Brian Kha,4,0,30,26
1657014672743,MATH 20D,A02,083766,Tran; Brian Kha,5,0,30,25
1657014672743,MATH 20D,A03,083767,Tran; Brian Kha,3,0,30,27
1657014678767,MATH 20E,A01,083771,Ganguly; Soumya,5,0,32,27
1657014678767,MATH 20E,A02,083772,Ganguly; Soumya,6,0,32,26
1657014678767,MATH 20E,B01,083773,Ciotti; Benjamin,18,0,35,17
1657014678767,MATH 20E,B02,083774,Ciotti; Benjamin,17,0,35,18
1657014684792,MATH 103A,A01,083777,Greenfeld; Be'Eri,2,0,36,34
1657014684792,MATH 103A,A02,083778,Greenfeld; Be'Eri,5,0,36,31
1657014684792,MATH 103A,A03,093561,Greenfeld; Be'Eri,4,0,36,32
1657014684792,MATH 103A,B01,083779,Greenfeld; Be'Eri,6,0,36,30
1657014684792,MATH 103A,B02,083780,Greenfeld; Be'Eri,2,0,36,34
1657014684792,MATH 103A,B03,093562,Greenfeld; Be'Eri,2,0,36,34
1657014690816,MATH 105,A01,085443,Carter; Anne Toulson,14,0,35,21
1657014690816,MATH 105,A02,093477,Carter; Anne Toulson,20,0,35,15
1657014696845,MATH 109,A01,083213,Ganzberger; Geoffrey Michael,2,0,34,32
1657014696845,MATH 109,A02,083214,Ganzberger; Geoffrey Michael,2,0,34,32
1657014696845,MATH 109,A03,093478,Ganzberger; Geoffrey Michael,1,0,34,33
1657014696845,MATH 109,B01,083215,Ganzberger; Geoffrey Michael,1,0,32,31
1657014696845,MATH 109,B02,083216,Ganzberger; Geoffrey Michael,1,0,32,31
1657014696845,MATH 109,B03,093479,Ganzberger; Geoffrey Michael,6,0,32,26
1657014702870,MATH 142A,A01,083219,Chow; Bennett,6,0,32,26
1657014702870,MATH 142A,A02,083220,Chow; Bennett,10,0,32,22
1657014702870,MATH 142A,A03,093480,Chow; Bennett,7,0,32,25
1657014702870,MATH 142A,B03,093481,Chow; Bennett,7,0,32,25
1657014702870,MATH 142A,B04,093558,Chow; Bennett,11,0,32,21
1657014702870,MATH 142A,B05,093559,Chow; Bennett,6,0,32,26
1657014708894,MATH 193A,A01,083224,Rotar; Vladimir,7,0,34,27
1657014708894,MATH 193A,A02,083225,Rotar; Vladimir,4,0,34,30
1657014708894,MATH 193A,A03,083781,Rotar; Vladimir,1,0,34,33
1657014708894,MATH 193A,A04,083782,Rotar; Vladimir,6,0,34,28
1657014708894,MATH 193A,A05,093482,Rotar; Vladimir,6,0,34,28
1657014714918,MATH 197,001,091859,McAuley; Julian John,9999,0,9999,0
1657014714918,MATH 197,002,095566,Kedlaya; Kiran S.,9997,0,9999,2
1657014714918,MATH 197,003,095567,Xiao; Ming,9999,0,9999,0
1657014714918,MATH 197,004,095571,Perols; Johan Lars,9998,0,9999,1
1657014721983,COGS 9,A01,083615,Shannon; Kyle Michael,7,0,75,68
1657014728005,COGS 11,A01,083617,Boyle; Mary E. T.,20,0,48,28
1657014734028,COGS 13,A01,083071,Bastos; Amalia Pinkusfeld,9,0,71,62
1657014740055,COGS 14A,A01,092681,Semenuks; Arturs,0,1,100,100
1657014746079,COGS 14B,A01,083073,Cheng; Tzu-Han,5,0,63,58
1657014752108,COGS 17,A01,092677,Semenuks; Arturs,4,0,81,77
1657014758132,COGS 100,A01,083619,Allen; Michael Gordon,15,0,70,55
1657014764156,COGS 101A,A01,083621,Davis; Joshua Daniel,9,0,68,59
1657014770183,COGS 101B,A01,091572,Allen; Michael Gordon,8,0,65,57
1657014776208,COGS 101C,A01,083625,Delgado; Tania,17,0,35,18
1657014782232,COGS 107A,A01,083627,Boyle; Mary E. T.,13,0,60,47
1657014788259,COGS 118A,A01,083075,Gupta; Anjum,15,0,76,61
1657014794282,CSE 3,A50,083646,Miranda; Gregory Joseph,22,0,50,28
1657014800305,CSE 8A,A50,083650,Miranda; Gregory Joseph,17,1,56,39
1657014806327,CSE 11,A01,083080,Cao; Yingjun,4,15,40,36
1657014812356,CSE 12,A01,083652,Krause-Levy; Sophia Louisa,21,1,120,99
1657014818380,CSE 15L,A01,083654,Morris; Justin Loren,8,0,50,42
1657014818380,CSE 15L,A02,083655,Morris; Justin Loren,9,0,50,41
1657014824407,CSE 20,A01,083657,Tran; Khoa Dang,37,0,80,43
1657014830429,CSE 21,A01,095574,Bach; Quang Tran,21,0,48,27
1657014836452,CSE 30,A01,083084,Eldon; John,4,0,80,76
1657014836452,CSE 30,B01,095061,Bhaskar; Nishant,6,0,50,44
1657014842479,CSE 100,A01,083659,Cao; Yingjun,3,4,70,67
1657014848503,CSE 134B,A01,083661,Powell; Thomas Allan,19,0,100,81
1657014854532,CSE 140,A01,083663,Gungor; Onat,14,0,85,71
1657014860558,CSE 140L,A01,083088,Eldon; John,16,0,100,84
1657014866586,CSE 175,A01,083665,Kumar; Rakesh,3,0,25,22
1657014872611,CSE 190,A00,092507,Dubnov; Shlomo,7,0,20,13
1657014878634,ECE 45,A01,083139,Congero; Spencer William,5,0,75,70
1657014884658,ECE 65,A50,083695,Saad; Andrew S,12,0,30,18
1657014884658,ECE 65,A51,095125,Saad; Andrew S,25,0,26,1
1657014890681,ECE 109,A01,091882,Touri; Behrouz,16,0,70,54
1657014896706,ECE 180,A00,083140,Abi Samra; Nicholas Camill,1,0,30,29
1657014896706,ECE 180,B00,083141,Abi Samra; Nicholas Camill,0,0,30,30
1657014902729,MATH 10A,A01,083735,Patchell; Gregory David,1,0,30,29
1657014902729,MATH 10A,A02,083736,Patchell; Gregory David,20,0,30,10
1657014902729,MATH 10A,A03,083737,Patchell; Gregory David,16,0,30,14
1657014908753,MATH 10B,A01,083207,Lim; Seonhee,7,0,34,27
1657014908753,MATH 10B,A02,083208,Lim; Seonhee,9,0,35,26
1657014908753,MATH 10B,A03,093472,Lim; Seonhee,4,0,34,30
1657014908753,MATH 10B,B01,083739,Sinha; Shubham,9,0,30,21
1657014914780,MATH 18,A01,083743,Cinel; Cameron Alexander,6,0,30,24
1657014914780,MATH 18,A02,083744,Cinel; Cameron Alexander,15,0,30,15
1657014914780,MATH 18,A03,083745,Cinel; Cameron Alexander,8,0,30,22
1657014914780,MATH 18,B01,083748,Rideout; David Porter,4,0,37,33
1657014914780,MATH 18,B02,083749,Rideout; David Porter,3,0,36,33
1657014914780,MATH 18,B03,083750,Rideout; David Porter,2,0,37,35
1657014914780,MATH 18,B04,083751,Rideout; David Porter,5,0,36,31
1657014914780,MATH 18,B05,093473,Rideout; David Porter,4,0,36,32
1657014914780,MATH 18,B06,093474,Rideout; David Porter,5,0,36,31
1657014920804,MATH 20A,A01,083754,Zheng; Zequn,12,0,40,28
1657014926834,MATH 20B,A01,083756,Briones; Jor-el Thomas Caparas,1,0,36,35
1657014926834,MATH 20B,A02,083757,Briones; Jor-el Thomas Caparas,1,0,36,35
1657014926834,MATH 20B,A03,093475,Briones; Jor-el Thomas Caparas,0,0,36,36
1657014932858,MATH 20C,A01,083760,Briones; Jor-el Thomas Caparas,1,0,35,34
1657014932858,MATH 20C,A02,083761,Briones; Jor-el Thomas Caparas,8,0,35,27
1657014932858,MATH 20C,A03,093476,Briones; Jor-el Thomas Caparas,0,1,36,36
1657014932858,MATH 20C,B01,083762,Bach; Quang Tran,0,0,30,30
1657014938883,MATH 20D,A01,083765,Tran; Brian Kha,4,0,30,26
1657014938883,MATH 20D,A02,083766,Tran; Brian Kha,5,0,30,25
1657014938883,MATH 20D,A03,083767,Tran; Brian Kha,3,0,30,27
1657014944913,MATH 20E,A01,083771,Ganguly; Soumya,5,0,32,27
1657014944913,MATH 20E,A02,083772,Ganguly; Soumya,6,0,32,26
1657014944913,MATH 20E,B01,083773,Ciotti; Benjamin,18,0,35,17
1657014944913,MATH 20E,B02,083774,Ciotti; Benjamin,17,0,35,18
1657014950943,MATH 103A,A01,083777,Greenfeld; Be'Eri,2,0,36,34
1657014950943,MATH 103A,A02,083778,Greenfeld; Be'Eri,5,0,36,31
1657014950943,MATH 103A,A03,093561,Greenfeld; Be'Eri,4,0,36,32
1657014950943,MATH 103A,B01,083779,Greenfeld; Be'Eri,6,0,36,30
1657014950943,MATH 103A,B02,083780,Greenfeld; Be'Eri,2,0,36,34
1657014950943,MATH 103A,B03,093562,Greenfeld; Be'Eri,2,0,36,34
1657014956973,MATH 105,A01,085443,Carter; Anne Toulson,14,0,35,21
1657014956973,MATH 105,A02,093477,Carter; Anne Toulson,20,0,35,15
1657014962998,MATH 109,A01,083213,Ganzberger; Geoffrey Michael,2,0,34,32
1657014962998,MATH 109,A02,083214,Ganzberger; Geoffrey Michael,2,0,34,32
1657014962998,MATH 109,A03,093478,Ganzberger; Geoffrey Michael,1,0,34,33
1657014962998,MATH 109,B01,083215,Ganzberger; Geoffrey Michael,1,0,32,31
1657014962998,MATH 109,B02,083216,Ganzberger; Geoffrey Michael,1,0,32,31
1657014962998,MATH 109,B03,093479,Ganzberger; Geoffrey Michael,6,0,32,26
1657014969021,MATH 142A,A01,083219,Chow; Bennett,6,0,32,26
1657014969021,MATH 142A,A02,083220,Chow; Bennett,10,0,32,22
1657014969021,MATH 142A,A03,093480,Chow; Bennett,7,0,32,25
1657014969021,MATH 142A,B03,093481,Chow; Bennett,7,0,32,25
1657014969021,MATH 142A,B04,093558,Chow; Bennett,11,0,32,21
1657014969021,MATH 142A,B05,093559,Chow; Bennett,6,0,32,26
1657014975044,MATH 193A,A01,083224,Rotar; Vladimir,7,0,34,27
1657014975044,MATH 193A,A02,083225,Rotar; Vladimir,4,0,34,30
1657014975044,MATH 193A,A03,083781,Rotar; Vladimir,1,0,34,33
1657014975044,MATH 193A,A04,083782,Rotar; Vladimir,6,0,34,28
1657014975044,MATH 193A,A05,093482,Rotar; Vladimir,6,0,34,28
1657014981069,MATH 197,001,091859,McAuley; Julian John,9999,0,9999,0
1657014981069,MATH 197,002,095566,Kedlaya; Kiran S.,9997,0,9999,2
1657014981069,MATH 197,003,095567,Xiao; Ming,9999,0,9999,0
1657014981069,MATH 197,004,095571,Perols; Johan Lars,9998,0,9999,1
1657014988122,COGS 9,A01,083615,Shannon; Kyle Michael,7,0,75,68
1657014994151,COGS 11,A01,083617,Boyle; Mary E. T.,20,0,48,28
1657015000175,COGS 13,A01,083071,Bastos; Amalia Pinkusfeld,9,0,71,62
1657015006198,COGS 14A,A01,092681,Semenuks; Arturs,0,1,100,100
1657015012222,COGS 14B,A01,083073,Cheng; Tzu-Han,5,0,63,58
1657015018246,COGS 17,A01,092677,Semenuks; Arturs,4,0,81,77
1657015024272,COGS 100,A01,083619,Allen; Michael Gordon,15,0,70,55
1657015030365,COGS 101A,A01,083621,Davis; Joshua Daniel,9,0,68,59
1657015036389,COGS 101B,A01,091572,Allen; Michael Gordon,8,0,65,57
1657015042413,COGS 101C,A01,083625,Delgado; Tania,17,0,35,18
1657015048436,COGS 107A,A01,083627,Boyle; Mary E. T.,13,0,60,47
1657015054459,COGS 118A,A01,083075,Gupta; Anjum,15,0,76,61
1657015060482,CSE 3,A50,083646,Miranda; Gregory Joseph,22,0,50,28
1657015066506,CSE 8A,A50,083650,Miranda; Gregory Joseph,17,1,56,39
1657015072529,CSE 11,A01,083080,Cao; Yingjun,4,15,40,36
1657015078552,CSE 12,A01,083652,Krause-Levy; Sophia Louisa,21,1,120,99
1657015084579,CSE 15L,A01,083654,Morris; Justin Loren,8,0,50,42
1657015084579,CSE 15L,A02,083655,Morris; Justin Loren,9,0,50,41
1657015090607,CSE 20,A01,083657,Tran; Khoa Dang,37,0,80,43
1657015096635,CSE 21,A01,095574,Bach; Quang Tran,21,0,48,27
1657015102659,CSE 30,A01,083084,Eldon; John,4,0,80,76
1657015102659,CSE 30,B01,095061,Bhaskar; Nishant,6,0,50,44
1657015108685,CSE 100,A01,083659,Cao; Yingjun,3,4,70,67
1657015114709,CSE 134B,A01,083661,Powell; Thomas Allan,19,0,100,81
1657015120736,CSE 140,A01,083663,Gungor; Onat,14,0,85,71
1657015126758,CSE 140L,A01,083088,Eldon; John,16,0,100,84
1657015132804,CSE 175,A01,083665,Kumar; Rakesh,3,0,25,22
1657015138826,CSE 190,A00,092507,Dubnov; Shlomo,7,0,20,13
1657015144851,ECE 45,A01,083139,Congero; Spencer William,5,0,75,70
1657015150875,ECE 65,A50,083695,Saad; Andrew S,12,0,30,18
1657015150875,ECE 65,A51,095125,Saad; Andrew S,25,0,26,1
1657015156909,ECE 109,A01,091882,Touri; Behrouz,16,0,70,54
1657015162959,ECE 180,A00,083140,Abi Samra; Nicholas Camill,1,0,30,29
1657015162959,ECE 180,B00,083141,Abi Samra; Nicholas Camill,0,0,30,30
1657015168985,MATH 10A,A01,083735,Patchell; Gregory David,1,0,30,29
1657015168985,MATH 10A,A02,083736,Patchell; Gregory David,20,0,30,10
1657015168985,MATH 10A,A03,083737,Patchell; Gregory David,16,0,30,14
1657015175014,MATH 10B,A01,083207,Lim; Seonhee,7,0,34,27
1657015175014,MATH 10B,A02,083208,Lim; Seonhee,9,0,35,26
1657015175014,MATH 10B,A03,093472,Lim; Seonhee,4,0,34,30
1657015175014,MATH 10B,B01,083739,Sinha; Shubham,9,0,30,21
1657015181040,MATH 18,A01,083743,Cinel; Cameron Alexander,6,0,30,24
1657015181040,MATH 18,A02,083744,Cinel; Cameron Alexander,15,0,30,15
1657015181040,MATH 18,A03,083745,Cinel; Cameron Alexander,8,0,30,22
1657015181040,MATH 18,B01,083748,Rideout; David Porter,4,0,37,33
1657015181040,MATH 18,B02,083749,Rideout; David Porter,3,0,36,33
1657015181040,MATH 18,B03,083750,Rideout; David Porter,2,0,37,35
1657015181040,MATH 18,B04,083751,Rideout; David Porter,5,0,36,31
1657015181040,MATH 18,B05,093473,Rideout; David Porter,4,0,36,32
1657015181040,MATH 18,B06,093474,Rideout; David Porter,5,0,36,31
1657015187066,MATH 20A,A01,083754,Zheng; Zequn,12,0,40,28
1657015193095,MATH 20B,A01,083756,Briones; Jor-el Thomas Caparas,1,0,36,35
1657015193095,MATH 20B,A02,083757,Briones; Jor-el Thomas Caparas,1,0,36,35
1657015193095,MATH 20B,A03,093475,Briones; Jor-el Thomas Caparas,0,0,36,36
1657015199121,MATH 20C,A01,083760,Briones; Jor-el Thomas Caparas,1,0,35,34
1657015199121,MATH 20C,A02,083761,Briones; Jor-el Thomas Caparas,8,0,35,27
1657015199121,MATH 20C,A03,093476,Briones; Jor-el Thomas Caparas,0,1,36,36
1657015199121,MATH 20C,B01,083762,Bach; Quang Tran,0,0,30,30
1657015205153,MATH 20D,A01,083765,Tran; Brian Kha,4,0,30,26
1657015205153,MATH 20D,A02,083766,Tran; Brian Kha,5,0,30,25
1657015205153,MATH 20D,A03,083767,Tran; Brian Kha,3,0,30,27
1657015211182,MATH 20E,A01,083771,Ganguly; Soumya,5,0,32,27
1657015211182,MATH 20E,A02,083772,Ganguly; Soumya,6,0,32,26
1657015211182,MATH 20E,B01,083773,Ciotti; Benjamin,18,0,35,17
1657015211182,MATH 20E,B02,083774,Ciotti; Benjamin,17,0,35,18
1657015217206,MATH 103A,A01,083777,Greenfeld; Be'Eri,2,0,36,34
1657015217206,MATH 103A,A02,083778,Greenfeld; Be'Eri,5,0,36,31
1657015217206,MATH 103A,A03,093561,Greenfeld; Be'Eri,4,0,36,32
1657015217206,MATH 103A,B01,083779,Greenfeld; Be'Eri,6,0,36,30
1657015217206,MATH 103A,B02,083780,Greenfeld; Be'Eri,2,0,36,34
1657015217206,MATH 103A,B03,093562,Greenfeld; Be'Eri,2,0,36,34
1657015223229,MATH 105,A01,085443,Carter; Anne Toulson,14,0,35,21
1657015223229,MATH 105,A02,093477,Carter; Anne Toulson,20,0,35,15
1657015229257,MATH 109,A01,083213,Ganzberger; Geoffrey Michael,2,0,34,32
1657015229257,MATH 109,A02,083214,Ganzberger; Geoffrey Michael,2,0,34,32
1657015229257,MATH 109,A03,093478,Ganzberger; Geoffrey Michael,1,0,34,33
1657015229257,MATH 109,B01,083215,Ganzberger; Geoffrey Michael,1,0,32,31
1657015229257,MATH 109,B02,083216,Ganzberger; Geoffrey Michael,1,0,32,31
1657015229257,MATH 109,B03,093479,Ganzberger; Geoffrey Michael,6,0,32,26
1657015235281,MATH 142A,A01,083219,Chow; Bennett,6,0,32,26
1657015235281,MATH 142A,A02,083220,Chow; Bennett,10,0,32,22
1657015235281,MATH 142A,A03,093480,Chow; Bennett,7,0,32,25
1657015235281,MATH 142A,B03,093481,Chow; Bennett,7,0,32,25
1657015235281,MATH 142A,B04,093558,Chow; Bennett,11,0,32,21
1657015235281,MATH 142A,B05,093559,Chow; Bennett,6,0,32,26
1657015241311,MATH 193A,A01,083224,Rotar; Vladimir,7,0,34,27
1657015241311,MATH 193A,A02,083225,Rotar; Vladimir,4,0,34,30
1657015241311,MATH 193A,A03,083781,Rotar; Vladimir,1,0,34,33
1657015241311,MATH 193A,A04,083782,Rotar; Vladimir,6,0,34,28
1657015241311,MATH 193A,A05,093482,Rotar; Vladimir,6,0,34,28
1657015247338,MATH 197,001,091859,McAuley; Julian John,9999,0,9999,0
1657015247338,MATH 197,002,095566,Kedlaya; Kiran S.,9997,0,9999,2
1657015247338,MATH 197,003,095567,Xiao; Ming,9999,0,9999,0
1657015247338,MATH 197,004,095571,Perols; Johan Lars,9998,0,9999,1
1657015254409,COGS 9,A01,083615,Shannon; Kyle Michael,7,0,75,68
1657015260446,COGS 11,A01,083617,Boyle; Mary E. T.,20,0,48,28
1657015266469,COGS 13,A01,083071,Bastos; Amalia Pinkusfeld,9,0,71,62
1657015272492,COGS 14A,A01,092681,Semenuks; Arturs,0,1,100,100
1657015278542,COGS 14B,A01,083073,Cheng; Tzu-Han,5,0,63,58
1657015284579,COGS 17,A01,092677,Semenuks; Arturs,4,0,81,77
1657015290607,COGS 100,A01,083619,Allen; Michael Gordon,15,0,70,55
1657015296634,COGS 101A,A01,083621,Davis; Joshua Daniel,9,0,68,59
1657015302694,COGS 101B,A01,091572,Allen; Michael Gordon,8,0,65,57
1657015308730,COGS 101C,A01,083625,Delgado; Tania,17,0,35,18
1657015314753,COGS 107A,A01,083627,Boyle; Mary E. T.,13,0,60,47
1657015320775,COGS 118A,A01,083075,Gupta; Anjum,15,0,76,61
1657015326800,CSE 3,A50,083646,Miranda; Gregory Joseph,22,0,50,28
1657015332822,CSE 8A,A50,083650,Miranda; Gregory Joseph,17,1,56,39
1657015338844,CSE 11,A01,083080,Cao; Yingjun,4,15,40,36
1657015344872,CSE 12,A01,083652,Krause-Levy; Sophia Louisa,21,1,120,99
1657015350894,CSE 15L,A01,083654,Morris; Justin Loren,8,0,50,42
1657015350894,CSE 15L,A02,083655,Morris; Justin Loren,9,0,50,41
1657015356935,CSE 20,A01,083657,Tran; Khoa Dang,37,0,80,43
1657015362958,CSE 21,A01,095574,Bach; Quang Tran,21,0,48,27
1657015368992,CSE 30,A01,083084,Eldon; John,4,0,80,76
1657015368992,CSE 30,B01,095061,Bhaskar; Nishant,6,0,50,44
1657015375019,CSE 100,A01,083659,Cao; Yingjun,3,4,70,67
1657015381054,CSE 134B,A01,083661,Powell; Thomas Allan,19,0,100,81
1657015387082,CSE 140,A01,083663,Gungor; Onat,14,0,85,71
1657015393116,CSE 140L,A01,083088,Eldon; John,16,0,100,84
1657015399138,CSE 175,A01,083665,Kumar; Rakesh,3,0,25,22
1657015405161,CSE 190,A00,092507,Dubnov; Shlomo,7,0,20,13
1657015411185,ECE 45,A01,083139,Congero; Spencer William,5,0,75,70
1657015417209,ECE 65,A50,083695,Saad; Andrew S,12,0,30,18
1657015417209,ECE 65,A51,095125,Saad; Andrew S,25,0,26,1
1657015423234,ECE 109,A01,091882,Touri; Behrouz,16,0,70,54
1657015429257,ECE 180,A00,083140,Abi Samra; Nicholas Camill,1,0,30,29
1657015429257,ECE 180,B00,083141,Abi Samra; Nicholas Camill,0,0,30,30
1657015435287,MATH 10A,A01,083735,Patchell; Gregory David,1,0,30,29
1657015435287,MATH 10A,A02,083736,Patchell; Gregory David,20,0,30,10
1657015435287,MATH 10A,A03,083737,Patchell; Gregory David,16,0,30,14
1657015441315,MATH 10B,A01,083207,Lim; Seonhee,7,0,34,27
1657015441315,MATH 10B,A02,083208,Lim; Seonhee,9,0,35,26
1657015441315,MATH 10B,A03,093472,Lim; Seonhee,4,0,34,30
1657015441315,MATH 10B,B01,083739,Sinha; Shubham,9,0,30,21
1657015447351,MATH 18,A01,083743,Cinel; Cameron Alexander,6,0,30,24
1657015447351,MATH 18,A02,083744,Cinel; Cameron Alexander,15,0,30,15
1657015447351,MATH 18,A03,083745,Cinel; Cameron Alexander,8,0,30,22
1657015447351,MATH 18,B01,083748,Rideout; David Porter,4,0,37,33
1657015447351,MATH 18,B02,083749,Rideout; David Porter,3,0,36,33
1657015447351,MATH 18,B03,083750,Rideout; David Porter,2,0,37,35
1657015447351,MATH 18,B04,083751,Rideout; David Porter,5,0,36,31
1657015447351,MATH 18,B05,093473,Rideout; David Porter,4,0,36,32
1657015447351,MATH 18,B06,093474,Rideout; David Porter,5,0,36,31
1657015453385,MATH 20A,A01,083754,Zheng; Zequn,12,0,40,28
1657015459422,MATH 20B,A01,083756,Briones; Jor-el Thomas Caparas,1,0,36,35
1657015459422,MATH 20B,A02,083757,Briones; Jor-el Thomas Caparas,1,0,36,35
1657015459422,MATH 20B,A03,093475,Briones; Jor-el Thomas Caparas,0,0,36,36
1657015465445,MATH 20C,A01,083760,Briones; Jor-el Thomas Caparas,1,0,35,34
1657015465445,MATH 20C,A02,083761,Briones; Jor-el Thomas Caparas,8,0,35,27
1657015465445,MATH 20C,A03,093476,Briones; Jor-el Thomas Caparas,0,1,36,36
1657015465445,MATH 20C,B01,083762,Bach; Quang Tran,0,0,30,30
1657015471474,MATH 20D,A01,083765,Tran; Brian Kha,4,0,30,26
1657015471474,MATH 20D,A02,083766,Tran; Brian Kha,5,0,30,25
1657015471474,MATH 20D,A03,083767,Tran; Brian Kha,3,0,30,27
1657015477498,MATH 20E,A01,083771,Ganguly; Soumya,5,0,32,27
1657015477498,MATH 20E,A02,083772,Ganguly; Soumya,6,0,32,26
1657015477498,MATH 20E,B01,083773,Ciotti; Benjamin,18,0,35,17
1657015477498,MATH 20E,B02,083774,Ciotti; Benjamin,17,0,35,18
1657015483529,MATH 103A,A01,083777,Greenfeld; Be'Eri,2,0,36,34
1657015483529,MATH 103A,A02,083778,Greenfeld; Be'Eri,5,0,36,31
1657015483529,MATH 103A,A03,093561,Greenfeld; Be'Eri,4,0,36,32
1657015483529,MATH 103A,B01,083779,Greenfeld; Be'Eri,6,0,36,30
1657015483529,MATH 103A,B02,083780,Greenfeld; Be'Eri,2,0,36,34
1657015483529,MATH 103A,B03,093562,Greenfeld; Be'Eri,2,0,36,34
1657015489557,MATH 105,A01,085443,Carter; Anne Toulson,14,0,35,21
1657015489557,MATH 105,A02,093477,Carter; Anne Toulson,20,0,35,15
1657015495581,MATH 109,A01,083213,Ganzberger; Geoffrey Michael,2,0,34,32
1657015495581,MATH 109,A02,083214,Ganzberger; Geoffrey Michael,2,0,34,32
1657015495581,MATH 109,A03,093478,Ganzberger; Geoffrey Michael,1,0,34,33
1657015495581,MATH 109,B01,083215,Ganzberger; Geoffrey Michael,1,0,32,31
1657015495581,MATH 109,B02,083216,Ganzberger; Geoffrey Michael,1,0,32,31
1657015495581,MATH 109,B03,093479,Ganzberger; Geoffrey Michael,6,0,32,26
1657015501611,MATH 142A,A01,083219,Chow; Bennett,6,0,32,26
1657015501611,MATH 142A,A02,083220,Chow; Bennett,10,0,32,22
1657015501611,MATH 142A,A03,093480,Chow; Bennett,7,0,32,25
1657015501611,MATH 142A,B03,093481,Chow; Bennett,7,0,32,25
1657015501611,MATH 142A,B04,093558,Chow; Bennett,11,0,32,21
1657015501611,MATH 142A,B05,093559,Chow; Bennett,6,0,32,26
1657015507644,MATH 193A,A01,083224,Rotar; Vladimir,7,0,34,27
1657015507644,MATH 193A,A02,083225,Rotar; Vladimir,4,0,34,30
1657015507644,MATH 193A,A03,083781,Rotar; Vladimir,1,0,34,33
1657015507644,MATH 193A,A04,083782,Rotar; Vladimir,6,0,34,28
1657015507644,MATH 193A,A05,093482,Rotar; Vladimir,6,0,34,28
1657015513671,MATH 197,001,091859,McAuley; Julian John,9999,0,9999,0
1657015513671,MATH 197,002,095566,Kedlaya; Kiran S.,9997,0,9999,2
1657015513671,MATH 197,003,095567,Xiao; Ming,9999,0,9999,0
1657015513671,MATH 197,004,095571,Perols; Johan Lars,9998,0,9999,1
1657015520728,COGS 9,A01,083615,Shannon; Kyle Michael,7,0,75,68
1657015526755,COGS 11,A01,083617,Boyle; Mary E. T.,20,0,48,28
1657015532780,COGS 13,A01,083071,Bastos; Amalia Pinkusfeld,9,0,71,62
1657015538803,COGS 14A,A01,092681,Semenuks; Arturs,0,1,100,100
1657015544831,COGS 14B,A01,083073,Cheng; Tzu-Han,5,0,63,58
1657015550867,COGS 17,A01,092677,Semenuks; Arturs,4,0,81,77
1657015556889,COGS 100,A01,083619,Allen; Michael Gordon,15,0,70,55
1657015562911,COGS 101A,A01,083621,Davis; Joshua Daniel,9,0,68,59
1657015568942,COGS 101B,A01,091572,Allen; Michael Gordon,8,0,65,57
1657015574965,COGS 101C,A01,083625,Delgado; Tania,17,0,35,18
1657015580990,COGS 107A,A01,083627,Boyle; Mary E. T.,13,0,60,47
1657015587013,COGS 118A,A01,083075,Gupta; Anjum,15,0,76,61
1657015593038,CSE 3,A50,083646,Miranda; Gregory Joseph,22,0,50,28
1657015599066,CSE 8A,A50,083650,Miranda; Gregory Joseph,17,1,56,39
1657015605089,CSE 11,A01,083080,Cao; Yingjun,4,15,40,36
1657015611127,CSE 12,A01,083652,Krause-Levy; Sophia Louisa,21,1,120,99
1657015617155,CSE 15L,A01,083654,Morris; Justin Loren,8,0,50,42
1657015617155,CSE 15L,A02,083655,Morris; Justin Loren,9,0,50,41
1657015623178,CSE 20,A01,083657,Tran; Khoa Dang,37,0,80,43
1657015629300,CSE 21,A01,095574,Bach; Quang Tran,21,0,48,27
1657015635322,CSE 30,A01,083084,Eldon; John,4,0,80,76
1657015635322,CSE 30,B01,095061,Bhaskar; Nishant,6,0,50,44
1657015641343,CSE 100,A01,083659,Cao; Yingjun,3,4,70,67
1657015647372,CSE 134B,A01,083661,Powell; Thomas Allan,19,0,100,81
1657015653396,CSE 140,A01,083663,Gungor; Onat,14,0,85,71
1657015659424,CSE 140L,A01,083088,Eldon; John,16,0,100,84
1657015665451,CSE 175,A01,083665,Kumar; Rakesh,3,0,25,22
1657015671478,CSE 190,A00,092507,Dubnov; Shlomo,7,0,20,13
1657015677502,ECE 45,A01,083139,Congero; Spencer William,5,0,75,70
1657015683526,ECE 65,A50,083695,Saad; Andrew S,12,0,30,18
1657015683526,ECE 65,A51,095125,Saad; Andrew S,25,0,26,1
1657015689549,ECE 109,A01,091882,Touri; Behrouz,16,0,70,54
1657015695578,ECE 180,A00,083140,Abi Samra; Nicholas Camill,1,0,30,29
1657015695578,ECE 180,B00,083141,Abi Samra; Nicholas Camill,0,0,30,30
1657015701601,MATH 10A,A01,083735,Patchell; Gregory David,1,0,30,29
1657015701601,MATH 10A,A02,083736,Patchell; Gregory David,20,0,30,10
1657015701601,MATH 10A,A03,083737,Patchell; Gregory David,16,0,30,14
1657015707639,MATH 10B,A01,083207,Lim; Seonhee,7,0,34,27
1657015707639,MATH 10B,A02,083208,Lim; Seonhee,9,0,35,26
1657015707639,MATH 10B,A03,093472,Lim; Seonhee,4,0,34,30
1657015707639,MATH 10B,B01,083739,Sinha; Shubham,9,0,30,21
1657015713671,MATH 18,A01,083743,Cinel; Cameron Alexander,6,0,30,24
1657015713671,MATH 18,A02,083744,Cinel; Cameron Alexander,15,0,30,15
1657015713671,MATH 18,A03,083745,Cinel; Cameron Alexander,8,0,30,22
1657015713671,MATH 18,B01,083748,Rideout; David Porter,4,0,37,33
1657015713671,MATH 18,B02,083749,Rideout; David Porter,3,0,36,33
1657015713671,MATH 18,B03,083750,Rideout; David Porter,2,0,37,35
1657015713671,MATH 18,B04,083751,Rideout; David Porter,5,0,36,31
1657015713671,MATH 18,B05,093473,Rideout; David Porter,4,0,36,32
1657015713671,MATH 18,B06,093474,Rideout; David Porter,5,0,36,31
1657015719695,MATH 20A,A01,083754,Zheng; Zequn,12,0,40,28
1657015725718,MATH 20B,A01,083756,Briones; Jor-el Thomas Caparas,1,0,36,35
1657015725718,MATH 20B,A02,083757,Briones; Jor-el Thomas Caparas,1,0,36,35
1657015725718,MATH 20B,A03,093475,Briones; Jor-el Thomas Caparas,0,0,36,36
1657015731749,MATH 20C,A01,083760,Briones; Jor-el Thomas Caparas,1,0,35,34
1657015731749,MATH 20C,A02,083761,Briones; Jor-el Thomas Caparas,8,0,35,27
1657015731749,MATH 20C,A03,093476,Briones; Jor-el Thomas Caparas,0,1,36,36
1657015731749,MATH 20C,B01,083762,Bach; Quang Tran,0,0,30,30
1657015737774,MATH 20D,A01,083765,Tran; Brian Kha,4,0,30,26
1657015737774,MATH 20D,A02,083766,Tran; Brian Kha,5,0,30,25
1657015737774,MATH 20D,A03,083767,Tran; Brian Kha,3,0,30,27
1657015743797,MATH 20E,A01,083771,Ganguly; Soumya,5,0,32,27
1657015743797,MATH 20E,A02,083772,Ganguly; Soumya,6,0,32,26
1657015743797,MATH 20E,B01,083773,Ciotti; Benjamin,18,0,35,17
1657015743797,MATH 20E,B02,083774,Ciotti; Benjamin,17,0,35,18
1657015749821,MATH 103A,A01,083777,Greenfeld; Be'Eri,2,0,36,34
1657015749821,MATH 103A,A02,083778,Greenfeld; Be'Eri,5,0,36,31
1657015749821,MATH 103A,A03,093561,Greenfeld; Be'Eri,4,0,36,32
1657015749821,MATH 103A,B01,083779,Greenfeld; Be'Eri,6,0,36,30
1657015749821,MATH 103A,B02,083780,Greenfeld; Be'Eri,2,0,36,34
1657015749821,MATH 103A,B03,093562,Greenfeld; Be'Eri,2,0,36,34
1657015755845,MATH 105,A01,085443,Carter; Anne Toulson,14,0,35,21
1657015755845,MATH 105,A02,093477,Carter; Anne Toulson,20,0,35,15
1657015761875,MATH 109,A01,083213,Ganzberger; Geoffrey Michael,2,0,34,32
1657015761875,MATH 109,A02,083214,Ganzberger; Geoffrey Michael,2,0,34,32
1657015761875,MATH 109,A03,093478,Ganzberger; Geoffrey Michael,1,0,34,33
1657015761875,MATH 109,B01,083215,Ganzberger; Geoffrey Michael,1,0,32,31
1657015761875,MATH 109,B02,083216,Ganzberger; Geoffrey Michael,1,0,32,31
1657015761875,MATH 109,B03,093479,Ganzberger; Geoffrey Michael,6,0,32,26
1657015767905,MATH 142A,A01,083219,Chow; Bennett,6,0,32,26
1657015767905,MATH 142A,A02,083220,Chow; Bennett,10,0,32,22
1657015767905,MATH 142A,A03,093480,Chow; Bennett,7,0,32,25
1657015767905,MATH 142A,B03,093481,Chow; Bennett,7,0,32,25
1657015767905,MATH 142A,B04,093558,Chow; Bennett,11,0,32,21
1657015767905,MATH 142A,B05,093559,Chow; Bennett,6,0,32,26
1657015773927,MATH 193A,A01,083224,Rotar; Vladimir,7,0,34,27
1657015773927,MATH 193A,A02,083225,Rotar; Vladimir,4,0,34,30
1657015773927,MATH 193A,A03,083781,Rotar; Vladimir,1,0,34,33
1657015773927,MATH 193A,A04,083782,Rotar; Vladimir,6,0,34,28
1657015773927,MATH 193A,A05,093482,Rotar; Vladimir,6,0,34,28
1657015779954,MATH 197,001,091859,McAuley; Julian John,9999,0,9999,0
1657015779954,MATH 197,002,095566,Kedlaya; Kiran S.,9997,0,9999,2
1657015779954,MATH 197,003,095567,Xiao; Ming,9999,0,9999,0
1657015779954,MATH 197,004,095571,Perols; Johan Lars,9998,0,9999,1
1657015787024,COGS 9,A01,083615,Shannon; Kyle Michael,7,0,75,68
1657015793047,COGS 11,A01,083617,Boyle; Mary E. T.,20,0,48,28
1657015799069,COGS 13,A01,083071,Bastos; Amalia Pinkusfeld,9,0,71,62
1657015805098,COGS 14A,A01,092681,Semenuks; Arturs,0,1,100,100
1657015811123,COGS 14B,A01,083073,Cheng; Tzu-Han,5,0,63,58
1657015817150,COGS 17,A01,092677,Semenuks; Arturs,4,0,81,77
1657015823173,COGS 100,A01,083619,Allen; Michael Gordon,15,0,70,55
1657015829198,COGS 101A,A01,083621,Davis; Joshua Daniel,9,0,68,59
1657015835221,COGS 101B,A01,091572,Allen; Michael Gordon,8,0,65,57
1657015841244,COGS 101C,A01,083625,Delgado; Tania,17,0,35,18
1657015847270,COGS 107A,A01,083627,Boyle; Mary E. T.,13,0,60,47
1657015853294,COGS 118A,A01,083075,Gupta; Anjum,15,0,76,61
1657015859317,CSE 3,A50,083646,Miranda; Gregory Joseph,22,0,50,28
1657015865347,CSE 8A,A50,083650,Miranda; Gregory Joseph,17,1,56,39
1657015871373,CSE 11,A01,083080,Cao; Yingjun,4,15,40,36
1657015877396,CSE 12,A01,083652,Krause-Levy; Sophia Louisa,21,1,120,99
1657015883421,CSE 15L,A01,083654,Morris; Justin Loren,8,0,50,42
1657015883421,CSE 15L,A02,083655,Morris; Justin Loren,9,0,50,41
1657015889446,CSE 20,A01,083657,Tran; Khoa Dang,37,0,80,43
1657015895476,CSE 21,A01,095574,Bach; Quang Tran,21,0,48,27
1657015901499,CSE 30,A01,083084,Eldon; John,4,0,80,76
1657015901499,CSE 30,B01,095061,Bhaskar; Nishant,6,0,50,44
1657015907527,CSE 100,A01,083659,Cao; Yingjun,3,4,70,67
1657015913558,CSE 134B,A01,083661,Powell; Thomas Allan,19,0,100,81
1657015919582,CSE 140,A01,083663,Gungor; Onat,14,0,85,71
1657015925607,CSE 140L,A01,083088,Eldon; John,16,0,100,84
1657015931633,CSE 175,A01,083665,Kumar; Rakesh,3,0,25,22
1657015937663,CSE 190,A00,092507,Dubnov; Shlomo,7,0,20,13
1657015943691,ECE 45,A01,083139,Congero; Spencer William,5,0,75,70
1657015949715,ECE 65,A50,083695,Saad; Andrew S,12,0,30,18
1657015949715,ECE 65,A51,095125,Saad; Andrew S,25,0,26,1
1657015955739,ECE 109,A01,091882,Touri; Behrouz,16,0,70,54
1657015961774,ECE 180,A00,083140,Abi Samra; Nicholas Camill,1,0,30,29
1657015961774,ECE 180,B00,083141,Abi Samra; Nicholas Camill,0,0,30,30
1657015967799,MATH 10A,A01,083735,Patchell; Gregory David,1,0,30,29
1657015967799,MATH 10A,A02,083736,Patchell; Gregory David,20,0,30,10
1657015967799,MATH 10A,A03,083737,Patchell; Gregory David,16,0,30,14
1657015973825,MATH 10B,A01,083207,Lim; Seonhee,7,0,34,27
1657015973825,MATH 10B,A02,083208,Lim; Seonhee,9,0,35,26
1657015973825,MATH 10B,A03,093472,Lim; Seonhee,4,0,34,30
1657015973825,MATH 10B,B01,083739,Sinha; Shubham,9,0,30,21
1657015979851,MATH 18,A01,083743,Cinel; Cameron Alexander,6,0,30,24
1657015979851,MATH 18,A02,083744,Cinel; Cameron Alexander,15,0,30,15
1657015979851,MATH 18,A03,083745,Cinel; Cameron Alexander,8,0,30,22
1657015979851,MATH 18,B01,083748,Rideout; David Porter,4,0,37,33
1657015979851,MATH 18,B02,083749,Rideout; David Porter,3,0,36,33
1657015979851,MATH 18,B03,083750,Rideout; David Porter,2,0,37,35
1657015979851,MATH 18,B04,083751,Rideout; David Porter,5,0,36,31
1657015979851,MATH 18,B05,093473,Rideout; David Porter,4,0,36,32
1657015979851,MATH 18,B06,093474,Rideout; David Porter,5,0,36,31
1657015985876,MATH 20A,A01,083754,Zheng; Zequn,12,0,40,28
1657015991899,MATH 20B,A01,083756,Briones; Jor-el Thomas Caparas,1,0,36,35
1657015991899,MATH 20B,A02,083757,Briones; Jor-el Thomas Caparas,1,0,36,35
1657015991899,MATH 20B,A03,093475,Briones; Jor-el Thomas Caparas,0,0,36,36
1657015997927,MATH 20C,A01,083760,Briones; Jor-el Thomas Caparas,1,0,35,34
1657015997927,MATH 20C,A02,083761,Briones; Jor-el Thomas Caparas,8,0,35,27
1657015997927,MATH 20C,A03,093476,Briones; Jor-el Thomas Caparas,0,1,36,36
1657015997927,MATH 20C,B01,083762,Bach; Quang Tran,0,0,30,30
1657016003956,MATH 20D,A01,083765,Tran; Brian Kha,4,0,30,26
1657016003956,MATH 20D,A02,083766,Tran; Brian Kha,5,0,30,25
1657016003956,MATH 20D,A03,083767,Tran; Brian Kha,3,0,30,27
1657016009986,MATH 20E,A01,083771,Ganguly; Soumya,5,0,32,27
1657016009986,MATH 20E,A02,083772,Ganguly; Soumya,6,0,32,26
1657016009986,MATH 20E,B01,083773,Ciotti; Benjamin,18,0,35,17
1657016009986,MATH 20E,B02,083774,Ciotti; Benjamin,17,0,35,18
1657016016014,MATH 103A,A01,083777,Greenfeld; Be'Eri,2,0,36,34
1657016016014,MATH 103A,A02,083778,Greenfeld; Be'Eri,5,0,36,31
1657016016014,MATH 103A,A03,093561,Greenfeld; Be'Eri,4,0,36,32
1657016016014,MATH 103A,B01,083779,Greenfeld; Be'Eri,6,0,36,30
1657016016014,MATH 103A,B02,083780,Greenfeld; Be'Eri,2,0,36,34
1657016016014,MATH 103A,B03,093562,Greenfeld; Be'Eri,2,0,36,34
1657016022037,MATH 105,A01,085443,Carter; Anne Toulson,14,0,35,21
1657016022037,MATH 105,A02,093477,Carter; Anne Toulson,20,0,35,15
1657016028064,MATH 109,A01,083213,Ganzberger; Geoffrey Michael,2,0,34,32
1657016028064,MATH 109,A02,083214,Ganzberger; Geoffrey Michael,2,0,34,32
1657016028064,MATH 109,A03,093478,Ganzberger; Geoffrey Michael,1,0,34,33
1657016028064,MATH 109,B01,083215,Ganzberger; Geoffrey Michael,1,0,32,31
1657016028064,MATH 109,B02,083216,Ganzberger; Geoffrey Michael,1,0,32,31
1657016028064,MATH 109,B03,093479,Ganzberger; Geoffrey Michael,6,0,32,26
1657016034094,MATH 142A,A01,083219,Chow; Bennett,6,0,32,26
1657016034094,MATH 142A,A02,083220,Chow; Bennett,10,0,32,22
1657016034094,MATH 142A,A03,093480,Chow; Bennett,7,0,32,25
1657016034094,MATH 142A,B03,093481,Chow; Bennett,7,0,32,25
1657016034094,MATH 142A,B04,093558,Chow; Bennett,11,0,32,21
1657016034094,MATH 142A,B05,093559,Chow; Bennett,6,0,32,26
1657016040122,MATH 193A,A01,083224,Rotar; Vladimir,7,0,34,27
1657016040122,MATH 193A,A02,083225,Rotar; Vladimir,4,0,34,30
1657016040122,MATH 193A,A03,083781,Rotar; Vladimir,1,0,34,33
1657016040122,MATH 193A,A04,083782,Rotar; Vladimir,6,0,34,28
1657016040122,MATH 193A,A05,093482,Rotar; Vladimir,6,0,34,28
1657016046147,MATH 197,001,091859,McAuley; Julian John,9999,0,9999,0
1657016046147,MATH 197,002,095566,Kedlaya; Kiran S.,9997,0,9999,2
1657016046147,MATH 197,003,095567,Xiao; Ming,9999,0,9999,0
1657016046147,MATH 197,004,095571,Perols; Johan Lars,9998,0,9999,1
1657016053204,COGS 9,A01,083615,Shannon; Kyle Michael,7,0,75,68
1657016059226,COGS 11,A01,083617,Boyle; Mary E. T.,20,0,48,28
1657016065258,COGS 13,A01,083071,Bastos; Amalia Pinkusfeld,9,0,71,62
1657016071281,COGS 14A,A01,092681,Semenuks; Arturs,0,1,100,100
1657016077309,COGS 14B,A01,083073,Cheng; Tzu-Han,5,0,63,58
1657016083333,COGS 17,A01,092677,Semenuks; Arturs,4,0,81,77
1657016089357,COGS 100,A01,083619,Allen; Michael Gordon,15,0,70,55
1657016095380,COGS 101A,A01,083621,Davis; Joshua Daniel,9,0,68,59
1657016101409,COGS 101B,A01,091572,Allen; Michael Gordon,8,0,65,57
1657016107437,COGS 101C,A01,083625,Delgado; Tania,17,0,35,18
1657016113463,COGS 107A,A01,083627,Boyle; Mary E. T.,13,0,60,47
1657016119487,COGS 118A,A01,083075,Gupta; Anjum,15,0,76,61
1657016125518,CSE 3,A50,083646,Miranda; Gregory Joseph,22,0,50,28
1657016131545,CSE 8A,A50,083650,Miranda; Gregory Joseph,17,1,56,39
1657016137568,CSE 11,A01,083080,Cao; Yingjun,4,15,40,36
1657016143592,CSE 12,A01,083652,Krause-Levy; Sophia Louisa,21,1,120,99
1657016149623,CSE 15L,A01,083654,Morris; Justin Loren,8,0,50,42
1657016149623,CSE 15L,A02,083655,Morris; Justin Loren,9,0,50,41
1657016155645,CSE 20,A01,083657,Tran; Khoa Dang,37,0,80,43
1657016161671,CSE 21,A01,095574,Bach; Quang Tran,21,0,48,27
1657016167695,CSE 30,A01,083084,Eldon; John,4,0,80,76
1657016167695,CSE 30,B01,095061,Bhaskar; Nishant,6,0,50,44
1657016173720,CSE 100,A01,083659,Cao; Yingjun,3,4,70,67
1657016179744,CSE 134B,A01,083661,Powell; Thomas Allan,19,0,100,81
1657016185770,CSE 140,A01,083663,Gungor; Onat,14,0,85,71
1657016191793,CSE 140L,A01,083088,Eldon; John,16,0,100,84
1657016197818,CSE 175,A01,083665,Kumar; Rakesh,3,0,25,22
1657016203841,CSE 190,A00,092507,Dubnov; Shlomo,7,0,20,13
1657016209865,ECE 45,A01,083139,Congero; Spencer William,5,0,75,70
1657016215888,ECE 65,A50,083695,Saad; Andrew S,12,0,30,18
1657016215888,ECE 65,A51,095125,Saad; Andrew S,25,0,26,1
1657016221914,ECE 109,A01,091882,Touri; Behrouz,16,0,70,54
1657016228008,ECE 180,A00,083140,Abi Samra; Nicholas Camill,1,0,30,29
1657016228008,ECE 180,B00,083141,Abi Samra; Nicholas Camill,0,0,30,30
1657016234035,MATH 10A,A01,083735,Patchell; Gregory David,1,0,30,29
1657016234035,MATH 10A,A02,083736,Patchell; Gregory David,20,0,30,10
1657016234035,MATH 10A,A03,083737,Patchell; Gregory David,16,0,30,14
1657016240075,MATH 10B,A01,083207,Lim; Seonhee,7,0,34,27
1657016240075,MATH 10B,A02,083208,Lim; Seonhee,9,0,35,26
1657016240075,MATH 10B,A03,093472,Lim; Seonhee,4,0,34,30
1657016240075,MATH 10B,B01,083739,Sinha; Shubham,9,0,30,21
1657016246103,MATH 18,A01,083743,Cinel; Cameron Alexander,6,0,30,24
1657016246103,MATH 18,A02,083744,Cinel; Cameron Alexander,15,0,30,15
1657016246103,MATH 18,A03,083745,Cinel; Cameron Alexander,8,0,30,22
1657016246103,MATH 18,B01,083748,Rideout; David Porter,4,0,37,33
1657016246103,MATH 18,B02,083749,Rideout; David Porter,3,0,36,33
1657016246103,MATH 18,B03,083750,Rideout; David Porter,2,0,37,35
1657016246103,MATH 18,B04,083751,Rideout; David Porter,5,0,36,31
1657016246103,MATH 18,B05,093473,Rideout; David Porter,4,0,36,32
1657016246103,MATH 18,B06,093474,Rideout; David Porter,5,0,36,31
1657016252126,MATH 20A,A01,083754,Zheng; Zequn,12,0,40,28
1657016258151,MATH 20B,A01,083756,Briones; Jor-el Thomas Caparas,1,0,36,35
1657016258151,MATH 20B,A02,083757,Briones; Jor-el Thomas Caparas,1,0,36,35
1657016258151,MATH 20B,A03,093475,Briones; Jor-el Thomas Caparas,0,0,36,36
1657016264176,MATH 20C,A01,083760,Briones; Jor-el Thomas Caparas,1,0,35,34
1657016264176,MATH 20C,A02,083761,Briones; Jor-el Thomas Caparas,8,0,35,27
1657016264176,MATH 20C,A03,093476,Briones; Jor-el Thomas Caparas,0,1,36,36
1657016264176,MATH 20C,B01,083762,Bach; Quang Tran,0,0,30,30
1657016270201,MATH 20D,A01,083765,Tran; Brian Kha,4,0,30,26
1657016270201,MATH 20D,A02,083766,Tran; Brian Kha,5,0,30,25
1657016270201,MATH 20D,A03,083767,Tran; Brian Kha,3,0,30,27
1657016276230,MATH 20E,A01,083771,Ganguly; Soumya,5,0,32,27
1657016276230,MATH 20E,A02,083772,Ganguly; Soumya,6,0,32,26
1657016276230,MATH 20E,B01,083773,Ciotti; Benjamin,18,0,35,17
1657016276230,MATH 20E,B02,083774,Ciotti; Benjamin,17,0,35,18
1657016282256,MATH 103A,A01,083777,Greenfeld; Be'Eri,2,0,36,34
1657016282256,MATH 103A,A02,083778,Greenfeld; Be'Eri,5,0,36,31
1657016282256,MATH 103A,A03,093561,Greenfeld; Be'Eri,4,0,36,32
1657016282256,MATH 103A,B01,083779,Greenfeld; Be'Eri,6,0,36,30
1657016282256,MATH 103A,B02,083780,Greenfeld; Be'Eri,2,0,36,34
1657016282256,MATH 103A,B03,093562,Greenfeld; Be'Eri,2,0,36,34
1657016288282,MATH 105,A01,085443,Carter; Anne Toulson,14,0,35,21
1657016288282,MATH 105,A02,093477,Carter; Anne Toulson,20,0,35,15
1657016294306,MATH 109,A01,083213,Ganzberger; Geoffrey Michael,2,0,34,32
1657016294306,MATH 109,A02,083214,Ganzberger; Geoffrey Michael,2,0,34,32
1657016294306,MATH 109,A03,093478,Ganzberger; Geoffrey Michael,1,0,34,33
1657016294306,MATH 109,B01,083215,Ganzberger; Geoffrey Michael,1,0,32,31
1657016294306,MATH 109,B02,083216,Ganzberger; Geoffrey Michael,1,0,32,31
1657016294306,MATH 109,B03,093479,Ganzberger; Geoffrey Michael,6,0,32,26
1657016300330,MATH 142A,A01,083219,Chow; Bennett,6,0,32,26
1657016300330,MATH 142A,A02,083220,Chow; Bennett,10,0,32,22
1657016300330,MATH 142A,A03,093480,Chow; Bennett,7,0,32,25
1657016300330,MATH 142A,B03,093481,Chow; Bennett,7,0,32,25
1657016300330,MATH 142A,B04,093558,Chow; Bennett,11,0,32,21
1657016300330,MATH 142A,B05,093559,Chow; Bennett,6,0,32,26
1657016306358,MATH 193A,A01,083224,Rotar; Vladimir,7,0,34,27
1657016306358,MATH 193A,A02,083225,Rotar; Vladimir,4,0,34,30
1657016306358,MATH 193A,A03,083781,Rotar; Vladimir,1,0,34,33
1657016306358,MATH 193A,A04,083782,Rotar; Vladimir,6,0,34,28
1657016306358,MATH 193A,A05,093482,Rotar; Vladimir,6,0,34,28
1657016312387,MATH 197,001,091859,McAuley; Julian John,9999,0,9999,0
1657016312387,MATH 197,002,095566,Kedlaya; Kiran S.,9997,0,9999,2
1657016312387,MATH 197,003,095567,Xiao; Ming,9999,0,9999,0
1657016312387,MATH 197,004,095571,Perols; Johan Lars,9998,0,9999,1
1657016319470,COGS 9,A01,083615,Shannon; Kyle Michael,7,0,75,68
1657016325493,COGS 11,A01,083617,Boyle; Mary E. T.,20,0,48,28
1657016331521,COGS 13,A01,083071,Bastos; Amalia Pinkusfeld,9,0,71,62
1657016337548,COGS 14A,A01,092681,Semenuks; Arturs,0,1,100,100
1657016343575,COGS 14B,A01,083073,Cheng; Tzu-Han,5,0,63,58
1657016349601,COGS 17,A01,092677,Semenuks; Arturs,4,0,81,77
1657016355628,COGS 100,A01,083619,Allen; Michael Gordon,15,0,70,55
1657016361655,COGS 101A,A01,083621,Davis; Joshua Daniel,9,0,68,59
1657016367683,COGS 101B,A01,091572,Allen; Michael Gordon,8,0,65,57
1657016373707,COGS 101C,A01,083625,Delgado; Tania,17,0,35,18
1657016379730,COGS 107A,A01,083627,Boyle; Mary E. T.,13,0,60,47
1657016385758,COGS 118A,A01,083075,Gupta; Anjum,15,0,76,61
1657016391785,CSE 3,A50,083646,Miranda; Gregory Joseph,22,0,50,28
1657016397813,CSE 8A,A50,083650,Miranda; Gregory Joseph,17,1,56,39
1657016403838,CSE 11,A01,083080,Cao; Yingjun,4,15,40,36
1657016409862,CSE 12,A01,083652,Krause-Levy; Sophia Louisa,21,1,120,99
1657016415887,CSE 15L,A01,083654,Morris; Justin Loren,8,0,50,42
1657016415887,CSE 15L,A02,083655,Morris; Justin Loren,9,0,50,41
1657016421924,CSE 20,A01,083657,Tran; Khoa Dang,37,0,80,43
1657016427947,CSE 21,A01,095574,Bach; Quang Tran,21,0,48,27
1657016435969,CSE 30,A01,083084,Eldon; John,4,0,80,76
1657016435969,CSE 30,B01,095061,Bhaskar; Nishant,6,0,50,44
1657016442027,CSE 100,A01,083659,Cao; Yingjun,3,4,70,67
1657016448059,CSE 134B,A01,083661,Powell; Thomas Allan,19,0,100,81
1657016454083,CSE 140,A01,083663,Gungor; Onat,14,0,85,71
1657016460114,CSE 140L,A01,083088,Eldon; John,16,0,100,84
1657016466143,CSE 175,A01,083665,Kumar; Rakesh,3,0,25,22
1657016472170,CSE 190,A00,092507,Dubnov; Shlomo,7,0,20,13
1657016478198,ECE 45,A01,083139,Congero; Spencer William,5,0,75,70
1657016484223,ECE 65,A50,083695,Saad; Andrew S,12,0,30,18
1657016484223,ECE 65,A51,095125,Saad; Andrew S,25,0,26,1
1657016490257,ECE 109,A01,091882,Touri; Behrouz,16,0,70,54
1657016496285,ECE 180,A00,083140,Abi Samra; Nicholas Camill,1,0,30,29
1657016496285,ECE 180,B00,083141,Abi Samra; Nicholas Camill,0,0,30,30
1657016502321,MATH 10A,A01,083735,Patchell; Gregory David,1,0,30,29
1657016502321,MATH 10A,A02,083736,Patchell; Gregory David,20,0,30,10
1657016502321,MATH 10A,A03,083737,Patchell; Gregory David,16,0,30,14
1657016508347,MATH 10B,A01,083207,Lim; Seonhee,7,0,34,27
1657016508347,MATH 10B,A02,083208,Lim; Seonhee,9,0,35,26
1657016508347,MATH 10B,A03,093472,Lim; Seonhee,4,0,34,30
1657016508347,MATH 10B,B01,083739,Sinha; Shubham,9,0,30,21
1657016514382,MATH 18,A01,083743,Cinel; Cameron Alexander,6,0,30,24
1657016514382,MATH 18,A02,083744,Cinel; Cameron Alexander,15,0,30,15
1657016514382,MATH 18,A03,083745,Cinel; Cameron Alexander,8,0,30,22
1657016514382,MATH 18,B01,083748,Rideout; David Porter,4,0,37,33
1657016514382,MATH 18,B02,083749,Rideout; David Porter,3,0,36,33
1657016514382,MATH 18,B03,083750,Rideout; David Porter,2,0,37,35
1657016514382,MATH 18,B04,083751,Rideout; David Porter,5,0,36,31
1657016514382,MATH 18,B05,093473,Rideout; David Porter,4,0,36,32
1657016514382,MATH 18,B06,093474,Rideout; David Porter,5,0,36,31
1657016520406,MATH 20A,A01,083754,Zheng; Zequn,12,0,40,28
1657016526429,MATH 20B,A01,083756,Briones; Jor-el Thomas Caparas,1,0,36,35
1657016526429,MATH 20B,A02,083757,Briones; Jor-el Thomas Caparas,1,0,36,35
1657016526429,MATH 20B,A03,093475,Briones; Jor-el Thomas Caparas,0,0,36,36
1657016532453,MATH 20C,A01,083760,Briones; Jor-el Thomas Caparas,1,0,35,34
1657016532453,MATH 20C,A02,083761,Briones; Jor-el Thomas Caparas,8,0,35,27
1657016532453,MATH 20C,A03,093476,Briones; Jor-el Thomas Caparas,0,1,36,36
1657016532453,MATH 20C,B01,083762,Bach; Quang Tran,0,0,30,30
1657016538478,MATH 20D,A01,083765,Tran; Brian Kha,4,0,30,26
1657016538478,MATH 20D,A02,083766,Tran; Brian Kha,5,0,30,25
1657016538478,MATH 20D,A03,083767,Tran; Brian Kha,3,0,30,27
1657016544506,MATH 20E,A01,083771,Ganguly; Soumya,5,0,32,27
1657016544506,MATH 20E,A02,083772,Ganguly; Soumya,6,0,32,26
1657016544506,MATH 20E,B01,083773,Ciotti; Benjamin,18,0,35,17
1657016544506,MATH 20E,B02,083774,Ciotti; Benjamin,17,0,35,18
1657016550532,MATH 103A,A01,083777,Greenfeld; Be'Eri,2,0,36,34
1657016550532,MATH 103A,A02,083778,Greenfeld; Be'Eri,5,0,36,31
1657016550532,MATH 103A,A03,093561,Greenfeld; Be'Eri,4,0,36,32
1657016550532,MATH 103A,B01,083779,Greenfeld; Be'Eri,6,0,36,30
1657016550532,MATH 103A,B02,083780,Greenfeld; Be'Eri,2,0,36,34
1657016550532,MATH 103A,B03,093562,Greenfeld; Be'Eri,2,0,36,34
1657016556556,MATH 105,A01,085443,Carter; Anne Toulson,14,0,35,21
1657016556556,MATH 105,A02,093477,Carter; Anne Toulson,20,0,35,15
1657016562581,MATH 109,A01,083213,Ganzberger; Geoffrey Michael,2,0,34,32
1657016562581,MATH 109,A02,083214,Ganzberger; Geoffrey Michael,2,0,34,32
1657016562581,MATH 109,A03,093478,Ganzberger; Geoffrey Michael,1,0,34,33
1657016562581,MATH 109,B01,083215,Ganzberger; Geoffrey Michael,1,0,32,31
1657016562581,MATH 109,B02,083216,Ganzberger; Geoffrey Michael,1,0,32,31
1657016562581,MATH 109,B03,093479,Ganzberger; Geoffrey Michael,6,0,32,26
1657016568612,MATH 142A,A01,083219,Chow; Bennett,6,0,32,26
1657016568612,MATH 142A,A02,083220,Chow; Bennett,10,0,32,22
1657016568612,MATH 142A,A03,093480,Chow; Bennett,7,0,32,25
1657016568612,MATH 142A,B03,093481,Chow; Bennett,7,0,32,25
1657016568612,MATH 142A,B04,093558,Chow; Bennett,11,0,32,21
1657016568612,MATH 142A,B05,093559,Chow; Bennett,6,0,32,26
1657016574635,MATH 193A,A01,083224,Rotar; Vladimir,7,0,34,27
1657016574635,MATH 193A,A02,083225,Rotar; Vladimir,4,0,34,30
1657016574635,MATH 193A,A03,083781,Rotar; Vladimir,1,0,34,33
1657016574635,MATH 193A,A04,083782,Rotar; Vladimir,6,0,34,28
1657016574635,MATH 193A,A05,093482,Rotar; Vladimir,6,0,34,28
1657016580664,MATH 197,001,091859,McAuley; Julian John,9999,0,9999,0
1657016580664,MATH 197,002,095566,Kedlaya; Kiran S.,9997,0,9999,2
1657016580664,MATH 197,003,095567,Xiao; Ming,9999,0,9999,0
1657016580664,MATH 197,004,095571,Perols; Johan Lars,9998,0,9999,1
1657016587724,COGS 9,A01,083615,Shannon; Kyle Michael,7,0,75,68
1657016593750,COGS 11,A01,083617,Boyle; Mary E. T.,20,0,48,28
1657016599773,COGS 13,A01,083071,Bastos; Amalia Pinkusfeld,9,0,71,62
1657016605796,COGS 14A,A01,092681,Semenuks; Arturs,0,1,100,100
1657016611820,COGS 14B,A01,083073,Cheng; Tzu-Han,5,0,63,58
1657016617841,COGS 17,A01,092677,Semenuks; Arturs,4,0,81,77
1657016623865,COGS 100,A01,083619,Allen; Michael Gordon,15,0,70,55
1657016629893,COGS 101A,A01,083621,Davis; Joshua Daniel,9,0,68,59
1657016635918,COGS 101B,A01,091572,Allen; Michael Gordon,8,0,65,57
1657016641951,COGS 101C,A01,083625,Delgado; Tania,17,0,35,18
1657016647978,COGS 107A,A01,083627,Boyle; Mary E. T.,13,0,60,47
1657016654002,COGS 118A,A01,083075,Gupta; Anjum,15,0,76,61
1657016660031,CSE 3,A50,083646,Miranda; Gregory Joseph,22,0,50,28
1657016666054,CSE 8A,A50,083650,Miranda; Gregory Joseph,17,1,56,39
1657016672078,CSE 11,A01,083080,Cao; Yingjun,4,15,40,36
1657016678108,CSE 12,A01,083652,Krause-Levy; Sophia Louisa,21,1,120,99
1657016684132,CSE 15L,A01,083654,Morris; Justin Loren,8,0,50,42
1657016684132,CSE 15L,A02,083655,Morris; Justin Loren,9,0,50,41
1657016690155,CSE 20,A01,083657,Tran; Khoa Dang,37,0,80,43
1657016696184,CSE 21,A01,095574,Bach; Quang Tran,21,0,48,27
1657016702208,CSE 30,A01,083084,Eldon; John,4,0,80,76
1657016702208,CSE 30,B01,095061,Bhaskar; Nishant,6,0,50,44
1657016708235,CSE 100,A01,083659,Cao; Yingjun,3,4,70,67
1657016714264,CSE 134B,A01,083661,Powell; Thomas Allan,19,0,100,81
1657016720291,CSE 140,A01,083663,Gungor; Onat,14,0,85,71
1657016726315,CSE 140L,A01,083088,Eldon; John,16,0,100,84
1657016732338,CSE 175,A01,083665,Kumar; Rakesh,3,0,25,22
1657016738365,CSE 190,A00,092507,Dubnov; Shlomo,7,0,20,13
1657016744390,ECE 45,A01,083139,Congero; Spencer William,5,0,75,70
1657016750419,ECE 65,A50,083695,Saad; Andrew S,12,0,30,18
1657016750419,ECE 65,A51,095125,Saad; Andrew S,25,0,26,1
1657016756442,ECE 109,A01,091882,Touri; Behrouz,16,0,70,54
1657016762469,ECE 180,A00,083140,Abi Samra; Nicholas Camill,1,0,30,29
1657016762469,ECE 180,B00,083141,Abi Samra; Nicholas Camill,0,0,30,30
1657016768493,MATH 10A,A01,083735,Patchell; Gregory David,1,0,30,29
1657016768493,MATH 10A,A02,083736,Patchell; Gregory David,20,0,30,10
1657016768493,MATH 10A,A03,083737,Patchell; Gregory David,16,0,30,14
1657016774518,MATH 10B,A01,083207,Lim; Seonhee,7,0,34,27
1657016774518,MATH 10B,A02,083208,Lim; Seonhee,9,0,35,26
1657016774518,MATH 10B,A03,093472,Lim; Seonhee,4,0,34,30
1657016774518,MATH 10B,B01,083739,Sinha; Shubham,9,0,30,21
1657016780544,MATH 18,A01,083743,Cinel; Cameron Alexander,6,0,30,24
1657016780544,MATH 18,A02,083744,Cinel; Cameron Alexander,15,0,30,15
1657016780544,MATH 18,A03,083745,Cinel; Cameron Alexander,8,0,30,22
1657016780544,MATH 18,B01,083748,Rideout; David Porter,4,0,37,33
1657016780544,MATH 18,B02,083749,Rideout; David Porter,3,0,36,33
1657016780544,MATH 18,B03,083750,Rideout; David Porter,2,0,37,35
1657016780544,MATH 18,B04,083751,Rideout; David Porter,5,0,36,31
1657016780544,MATH 18,B05,093473,Rideout; David Porter,4,0,36,32
1657016780544,MATH 18,B06,093474,Rideout; David Porter,5,0,36,31
1657016786571,MATH 20A,A01,083754,Zheng; Zequn,12,0,40,28
1657016792595,MATH 20B,A01,083756,Briones; Jor-el Thomas Caparas,1,0,36,35
1657016792595,MATH 20B,A02,083757,Briones; Jor-el Thomas Caparas,1,0,36,35
1657016792595,MATH 20B,A03,093475,Briones; Jor-el Thomas Caparas,0,0,36,36
1657016798625,MATH 20C,A01,083760,Briones; Jor-el Thomas Caparas,1,0,35,34
1657016798625,MATH 20C,A02,083761,Briones; Jor-el Thomas Caparas,8,0,35,27
1657016798625,MATH 20C,A03,093476,Briones; Jor-el Thomas Caparas,0,1,36,36
1657016798625,MATH 20C,B01,083762,Bach; Quang Tran,0,0,30,30
1657016804655,MATH 20D,A01,083765,Tran; Brian Kha,4,0,30,26
1657016804655,MATH 20D,A02,083766,Tran; Brian Kha,5,0,30,25
1657016804655,MATH 20D,A03,083767,Tran; Brian Kha,3,0,30,27
1657016810680,MATH 20E,A01,083771,Ganguly; Soumya,5,0,32,27
1657016810680,MATH 20E,A02,083772,Ganguly; Soumya,6,0,32,26
1657016810680,MATH 20E,B01,083773,Ciotti; Benjamin,18,0,35,17
1657016810680,MATH 20E,B02,083774,Ciotti; Benjamin,17,0,35,18
1657016816704,MATH 103A,A01,083777,Greenfeld; Be'Eri,2,0,36,34
1657016816704,MATH 103A,A02,083778,Greenfeld; Be'Eri,5,0,36,31
1657016816704,MATH 103A,A03,093561,Greenfeld; Be'Eri,4,0,36,32
1657016816704,MATH 103A,B01,083779,Greenfeld; Be'Eri,6,0,36,30
1657016816704,MATH 103A,B02,083780,Greenfeld; Be'Eri,2,0,36,34
1657016816704,MATH 103A,B03,093562,Greenfeld; Be'Eri,2,0,36,34
1657016822730,MATH 105,A01,085443,Carter; Anne Toulson,14,0,35,21
1657016822730,MATH 105,A02,093477,Carter; Anne Toulson,20,0,35,15
1657016828848,MATH 109,A01,083213,Ganzberger; Geoffrey Michael,2,0,34,32
1657016828848,MATH 109,A02,083214,Ganzberger; Geoffrey Michael,2,0,34,32
1657016828848,MATH 109,A03,093478,Ganzberger; Geoffrey Michael,1,0,34,33
1657016828848,MATH 109,B01,083215,Ganzberger; Geoffrey Michael,1,0,32,31
1657016828848,MATH 109,B02,083216,Ganzberger; Geoffrey Michael,1,0,32,31
1657016828848,MATH 109,B03,093479,Ganzberger; Geoffrey Michael,6,0,32,26
1657016834874,MATH 142A,A01,083219,Chow; Bennett,6,0,32,26
1657016834874,MATH 142A,A02,083220,Chow; Bennett,10,0,32,22
1657016834874,MATH 142A,A03,093480,Chow; Bennett,7,0,32,25
1657016834874,MATH 142A,B03,093481,Chow; Bennett,7,0,32,25
1657016834874,MATH 142A,B04,093558,Chow; Bennett,11,0,32,21
1657016834874,MATH 142A,B05,093559,Chow; Bennett,6,0,32,26
1657016840900,MATH 193A,A01,083224,Rotar; Vladimir,7,0,34,27
1657016840900,MATH 193A,A02,083225,Rotar; Vladimir,4,0,34,30
1657016840900,MATH 193A,A03,083781,Rotar; Vladimir,1,0,34,33
1657016840900,MATH 193A,A04,083782,Rotar; Vladimir,6,0,34,28
1657016840900,MATH 193A,A05,093482,Rotar; Vladimir,6,0,34,28
1657016846927,MATH 197,001,091859,McAuley; Julian John,9999,0,9999,0
1657016846927,MATH 197,002,095566,Kedlaya; Kiran S.,9997,0,9999,2
1657016846927,MATH 197,003,095567,Xiao; Ming,9999,0,9999,0
1657016846927,MATH 197,004,095571,Perols; Johan Lars,9998,0,9999,1
1657016853983,COGS 9,A01,083615,Shannon; Kyle Michael,7,0,75,68
1657016860004,COGS 11,A01,083617,Boyle; Mary E. T.,20,0,48,28
1657016866026,COGS 13,A01,083071,Bastos; Amalia Pinkusfeld,9,0,71,62
1657016872053,COGS 14A,A01,092681,Semenuks; Arturs,0,1,100,100
1657016878078,COGS 14B,A01,083073,Cheng; Tzu-Han,5,0,63,58
1657016884108,COGS 17,A01,092677,Semenuks; Arturs,4,0,81,77
1657016890135,COGS 100,A01,083619,Allen; Michael Gordon,15,0,70,55
1657016896162,COGS 101A,A01,083621,Davis; Joshua Daniel,9,0,68,59
1657016902185,COGS 101B,A01,091572,Allen; Michael Gordon,8,0,65,57
1657016908208,COGS 101C,A01,083625,Delgado; Tania,17,0,35,18
1657016914232,COGS 107A,A01,083627,Boyle; Mary E. T.,13,0,60,47
1657016920259,COGS 118A,A01,083075,Gupta; Anjum,15,0,76,61
1657016926282,CSE 3,A50,083646,Miranda; Gregory Joseph,22,0,50,28
1657016932311,CSE 8A,A50,083650,Miranda; Gregory Joseph,17,1,56,39
1657016938337,CSE 11,A01,083080,Cao; Yingjun,4,15,40,36
1657016944362,CSE 12,A01,083652,Krause-Levy; Sophia Louisa,21,1,120,99
1657016950401,CSE 15L,A01,083654,Morris; Justin Loren,8,0,50,42
1657016950401,CSE 15L,A02,083655,Morris; Justin Loren,9,0,50,41
1657016956434,CSE 20,A01,083657,Tran; Khoa Dang,37,0,80,43
1657016962458,CSE 21,A01,095574,Bach; Quang Tran,21,0,48,27
1657016968483,CSE 30,A01,083084,Eldon; John,4,0,80,76
1657016968483,CSE 30,B01,095061,Bhaskar; Nishant,6,0,50,44
1657016974508,CSE 100,A01,083659,Cao; Yingjun,3,4,70,67
1657016980532,CSE 134B,A01,083661,Powell; Thomas Allan,19,0,100,81
1657016986582,CSE 140,A01,083663,Gungor; Onat,14,0,85,71
1657016992604,CSE 140L,A01,083088,Eldon; John,16,0,100,84
1657016998627,CSE 175,A01,083665,Kumar; Rakesh,3,0,25,22
1657017004650,CSE 190,A00,092507,Dubnov; Shlomo,7,0,20,13
1657017010677,ECE 45,A01,083139,Congero; Spencer William,5,0,75,70
1657017016705,ECE 65,A50,083695,Saad; Andrew S,12,0,30,18
1657017016705,ECE 65,A51,095125,Saad; Andrew S,25,0,26,1
1657017022736,ECE 109,A01,091882,Touri; Behrouz,16,0,70,54
1657017028757,ECE 180,A00,083140,Abi Samra; Nicholas Camill,1,0,30,29
1657017028757,ECE 180,B00,083141,Abi Samra; Nicholas Camill,0,0,30,30
1657017034781,MATH 10A,A01,083735,Patchell; Gregory David,1,0,30,29
1657017034781,MATH 10A,A02,083736,Patchell; Gregory David,20,0,30,10
1657017034781,MATH 10A,A03,083737,Patchell; Gregory David,16,0,30,14
1657017040810,MATH 10B,A01,083207,Lim; Seonhee,7,0,34,27
1657017040810,MATH 10B,A02,083208,Lim; Seonhee,9,0,35,26
1657017040810,MATH 10B,A03,093472,Lim; Seonhee,4,0,34,30
1657017040810,MATH 10B,B01,083739,Sinha; Shubham,9,0,30,21
1657017046848,MATH 18,A01,083743,Cinel; Cameron Alexander,6,0,30,24
1657017046848,MATH 18,A02,083744,Cinel; Cameron Alexander,15,0,30,15
1657017046848,MATH 18,A03,083745,Cinel; Cameron Alexander,8,0,30,22
1657017046848,MATH 18,B01,083748,Rideout; David Porter,4,0,37,33
1657017046848,MATH 18,B02,083749,Rideout; David Porter,3,0,36,33
1657017046848,MATH 18,B03,083750,Rideout; David Porter,2,0,37,35
1657017046848,MATH 18,B04,083751,Rideout; David Porter,5,0,36,31
1657017046848,MATH 18,B05,093473,Rideout; David Porter,4,0,36,32
1657017046848,MATH 18,B06,093474,Rideout; David Porter,5,0,36,31
1657017052872,MATH 20A,A01,083754,Zheng; Zequn,12,0,40,28
1657017058897,MATH 20B,A01,083756,Briones; Jor-el Thomas Caparas,1,0,36,35
1657017058897,MATH 20B,A02,083757,Briones; Jor-el Thomas Caparas,1,0,36,35
1657017058897,MATH 20B,A03,093475,Briones; Jor-el Thomas Caparas,0,0,36,36
1657017064926,MATH 20C,A01,083760,Briones; Jor-el Thomas Caparas,1,0,35,34
1657017064926,MATH 20C,A02,083761,Briones; Jor-el Thomas Caparas,8,0,35,27
1657017064926,MATH 20C,A03,093476,Briones; Jor-el Thomas Caparas,0,1,36,36
1657017064926,MATH 20C,B01,083762,Bach; Quang Tran,0,0,30,30
1657017070949,MATH 20D,A01,083765,Tran; Brian Kha,4,0,30,26
1657017070949,MATH 20D,A02,083766,Tran; Brian Kha,5,0,30,25
1657017070949,MATH 20D,A03,083767,Tran; Brian Kha,3,0,30,27
1657017076980,MATH 20E,A01,083771,Ganguly; Soumya,5,0,32,27
1657017076980,MATH 20E,A02,083772,Ganguly; Soumya,6,0,32,26
1657017076980,MATH 20E,B01,083773,Ciotti; Benjamin,18,0,35,17
1657017076980,MATH 20E,B02,083774,Ciotti; Benjamin,17,0,35,18
1657017083005,MATH 103A,A01,083777,Greenfeld; Be'Eri,2,0,36,34
1657017083005,MATH 103A,A02,083778,Greenfeld; Be'Eri,5,0,36,31
1657017083005,MATH 103A,A03,093561,Greenfeld; Be'Eri,4,0,36,32
1657017083005,MATH 103A,B01,083779,Greenfeld; Be'Eri,6,0,36,30
1657017083005,MATH 103A,B02,083780,Greenfeld; Be'Eri,2,0,36,34
1657017083005,MATH 103A,B03,093562,Greenfeld; Be'Eri,2,0,36,34
1657017089037,MATH 105,A01,085443,Carter; Anne Toulson,14,0,35,21
1657017089037,MATH 105,A02,093477,Carter; Anne Toulson,20,0,35,15
1657017095061,MATH 109,A01,083213,Ganzberger; Geoffrey Michael,2,0,34,32
1657017095061,MATH 109,A02,083214,Ganzberger; Geoffrey Michael,2,0,34,32
1657017095061,MATH 109,A03,093478,Ganzberger; Geoffrey Michael,1,0,34,33
1657017095061,MATH 109,B01,083215,Ganzberger; Geoffrey Michael,1,0,32,31
1657017095061,MATH 109,B02,083216,Ganzberger; Geoffrey Michael,1,0,32,31
1657017095061,MATH 109,B03,093479,Ganzberger; Geoffrey Michael,6,0,32,26
1657017101099,MATH 142A,A01,083219,Chow; Bennett,6,0,32,26
1657017101099,MATH 142A,A02,083220,Chow; Bennett,10,0,32,22
1657017101099,MATH 142A,A03,093480,Chow; Bennett,7,0,32,25
1657017101099,MATH 142A,B03,093481,Chow; Bennett,7,0,32,25
1657017101099,MATH 142A,B04,093558,Chow; Bennett,11,0,32,21
1657017101099,MATH 142A,B05,093559,Chow; Bennett,6,0,32,26
1657017107123,MATH 193A,A01,083224,Rotar; Vladimir,7,0,34,27
1657017107123,MATH 193A,A02,083225,Rotar; Vladimir,4,0,34,30
1657017107123,MATH 193A,A03,083781,Rotar; Vladimir,1,0,34,33
1657017107123,MATH 193A,A04,083782,Rotar; Vladimir,6,0,34,28
1657017107123,MATH 193A,A05,093482,Rotar; Vladimir,6,0,34,28
1657017113154,MATH 197,001,091859,McAuley; Julian John,9999,0,9999,0
1657017113154,MATH 197,002,095566,Kedlaya; Kiran S.,9997,0,9999,2
1657017113154,MATH 197,003,095567,Xiao; Ming,9999,0,9999,0
1657017113154,MATH 197,004,095571,Perols; Johan Lars,9998,0,9999,1
1657017120221,COGS 9,A01,083615,Shannon; Kyle Michael,7,0,75,68
1657017126248,COGS 11,A01,083617,Boyle; Mary E. T.,20,0,48,28
1657017132274,COGS 13,A01,083071,Bastos; Amalia Pinkusfeld,9,0,71,62
1657017138302,COGS 14A,A01,092681,Semenuks; Arturs,0,1,100,100
1657017144326,COGS 14B,A01,083073,Cheng; Tzu-Han,5,0,63,58
1657017150359,COGS 17,A01,092677,Semenuks; Arturs,4,0,81,77
1657017156383,COGS 100,A01,083619,Allen; Michael Gordon,15,0,70,55
1657017162423,COGS 101A,A01,083621,Davis; Joshua Daniel,9,0,68,59
1657017168446,COGS 101B,A01,091572,Allen; Michael Gordon,8,0,65,57
1657017174475,COGS 101C,A01,083625,Delgado; Tania,17,0,35,18
1657017180505,COGS 107A,A01,083627,Boyle; Mary E. T.,13,0,60,47
1657017186532,COGS 118A,A01,083075,Gupta; Anjum,15,0,76,61
1657017192555,CSE 3,A50,083646,Miranda; Gregory Joseph,22,0,50,28
1657017198584,CSE 8A,A50,083650,Miranda; Gregory Joseph,17,1,56,39
1657017204607,CSE 11,A01,083080,Cao; Yingjun,4,15,40,36
1657017210655,CSE 12,A01,083652,Krause-Levy; Sophia Louisa,21,1,120,99
1657017216681,CSE 15L,A01,083654,Morris; Justin Loren,8,0,50,42
1657017216681,CSE 15L,A02,083655,Morris; Justin Loren,9,0,50,41
1657017222708,CSE 20,A01,083657,Tran; Khoa Dang,37,0,80,43
1657017228756,CSE 21,A01,095574,Bach; Quang Tran,21,0,48,27
1657017234784,CSE 30,A01,083084,Eldon; John,4,0,80,76
1657017234784,CSE 30,B01,095061,Bhaskar; Nishant,6,0,50,44
1657017240809,CSE 100,A01,083659,Cao; Yingjun,3,4,70,67
1657017246839,CSE 134B,A01,083661,Powell; Thomas Allan,19,0,100,81
1657017252862,CSE 140,A01,083663,Gungor; Onat,14,0,85,71
1657017258903,CSE 140L,A01,083088,Eldon; John,16,0,100,84
1657017264929,CSE 175,A01,083665,Kumar; Rakesh,3,0,25,22
1657017270969,CSE 190,A00,092507,Dubnov; Shlomo,7,0,20,13
1657017276998,ECE 45,A01,083139,Congero; Spencer William,5,0,75,70
1657017283019,ECE 65,A50,083695,Saad; Andrew S,12,0,30,18
1657017283019,ECE 65,A51,095125,Saad; Andrew S,25,0,26,1
1657017289047,ECE 109,A01,091882,Touri; Behrouz,16,0,70,54
1657017295071,ECE 180,A00,083140,Abi Samra; Nicholas Camill,1,0,30,29
1657017295071,ECE 180,B00,083141,Abi Samra; Nicholas Camill,0,0,30,30
1657017301115,MATH 10A,A01,083735,Patchell; Gregory David,1,0,30,29
1657017301115,MATH 10A,A02,083736,Patchell; Gregory David,20,0,30,10
1657017301115,MATH 10A,A03,083737,Patchell; Gregory David,16,0,30,14
1657017307150,MATH 10B,A01,083207,Lim; Seonhee,7,0,34,27
1657017307150,MATH 10B,A02,083208,Lim; Seonhee,9,0,35,26
1657017307150,MATH 10B,A03,093472,Lim; Seonhee,4,0,34,30
1657017307150,MATH 10B,B01,083739,Sinha; Shubham,9,0,30,21
1657017313194,MATH 18,A01,083743,Cinel; Cameron Alexander,6,0,30,24
1657017313194,MATH 18,A02,083744,Cinel; Cameron Alexander,15,0,30,15
1657017313194,MATH 18,A03,083745,Cinel; Cameron Alexander,8,0,30,22
1657017313194,MATH 18,B01,083748,Rideout; David Porter,4,0,37,33
1657017313194,MATH 18,B02,083749,Rideout; David Porter,3,0,36,33
1657017313194,MATH 18,B03,083750,Rideout; David Porter,2,0,37,35
1657017313194,MATH 18,B04,083751,Rideout; David Porter,5,0,36,31
1657017313194,MATH 18,B05,093473,Rideout; David Porter,4,0,36,32
1657017313194,MATH 18,B06,093474,Rideout; David Porter,5,0,36,31
1657017319227,MATH 20A,A01,083754,Zheng; Zequn,12,0,40,28
1657017325273,MATH 20B,A01,083756,Briones; Jor-el Thomas Caparas,1,0,36,35
1657017325273,MATH 20B,A02,083757,Briones; Jor-el Thomas Caparas,1,0,36,35
1657017325273,MATH 20B,A03,093475,Briones; Jor-el Thomas Caparas,0,0,36,36
1657017331299,MATH 20C,A01,083760,Briones; Jor-el Thomas Caparas,1,0,35,34
1657017331299,MATH 20C,A02,083761,Briones; Jor-el Thomas Caparas,8,0,35,27
1657017331299,MATH 20C,A03,093476,Briones; Jor-el Thomas Caparas,0,1,36,36
1657017331299,MATH 20C,B01,083762,Bach; Quang Tran,0,0,30,30
1657017337344,MATH 20D,A01,083765,Tran; Brian Kha,4,0,30,26
1657017337344,MATH 20D,A02,083766,Tran; Brian Kha,5,0,30,25
1657017337344,MATH 20D,A03,083767,Tran; Brian Kha,3,0,30,27
1657017343392,MATH 20E,A01,083771,Ganguly; Soumya,5,0,32,27
1657017343392,MATH 20E,A02,083772,Ganguly; Soumya,6,0,32,26
1657017343392,MATH 20E,B01,083773,Ciotti; Benjamin,18,0,35,17
1657017343392,MATH 20E,B02,083774,Ciotti; Benjamin,17,0,35,18
1657017349416,MATH 103A,A01,083777,Greenfeld; Be'Eri,2,0,36,34
1657017349416,MATH 103A,A02,083778,Greenfeld; Be'Eri,5,0,36,31
1657017349416,MATH 103A,A03,093561,Greenfeld; Be'Eri,4,0,36,32
1657017349416,MATH 103A,B01,083779,Greenfeld; Be'Eri,6,0,36,30
1657017349416,MATH 103A,B02,083780,Greenfeld; Be'Eri,2,0,36,34
1657017349416,MATH 103A,B03,093562,Greenfeld; Be'Eri,2,0,36,34
1657017355445,MATH 105,A01,085443,Carter; Anne Toulson,14,0,35,21
1657017355445,MATH 105,A02,093477,Carter; Anne Toulson,20,0,35,15
1657017361474,MATH 109,A01,083213,Ganzberger; Geoffrey Michael,2,0,34,32
1657017361474,MATH 109,A02,083214,Ganzberger; Geoffrey Michael,2,0,34,32
1657017361474,MATH 109,A03,093478,Ganzberger; Geoffrey Michael,1,0,34,33
1657017361474,MATH 109,B01,083215,Ganzberger; Geoffrey Michael,1,0,32,31
1657017361474,MATH 109,B02,083216,Ganzberger; Geoffrey Michael,1,0,32,31
1657017361474,MATH 109,B03,093479,Ganzberger; Geoffrey Michael,6,0,32,26
1657017367501,MATH 142A,A01,083219,Chow; Bennett,6,0,32,26
1657017367501,MATH 142A,A02,083220,Chow; Bennett,10,0,32,22
1657017367501,MATH 142A,A03,093480,Chow; Bennett,7,0,32,25
1657017367501,MATH 142A,B03,093481,Chow; Bennett,7,0,32,25
1657017367501,MATH 142A,B04,093558,Chow; Bennett,11,0,32,21
1657017367501,MATH 142A,B05,093559,Chow; Bennett,6,0,32,26
1657017373530,MATH 193A,A01,083224,Rotar; Vladimir,7,0,34,27
1657017373530,MATH 193A,A02,083225,Rotar; Vladimir,4,0,34,30
1657017373530,MATH 193A,A03,083781,Rotar; Vladimir,1,0,34,33
1657017373530,MATH 193A,A04,083782,Rotar; Vladimir,6,0,34,28
1657017373530,MATH 193A,A05,093482,Rotar; Vladimir,6,0,34,28
1657017379567,MATH 197,001,091859,McAuley; Julian John,9999,0,9999,0
1657017379567,MATH 197,002,095566,Kedlaya; Kiran S.,9997,0,9999,2
1657017379567,MATH 197,003,095567,Xiao; Ming,9999,0,9999,0
1657017379567,MATH 197,004,095571,Perols; Johan Lars,9998,0,9999,1
1657017386719,COGS 9,A01,083615,Shannon; Kyle Michael,7,0,75,68
1657017392764,COGS 11,A01,083617,Boyle; Mary E. T.,20,0,48,28
1657017398788,COGS 13,A01,083071,Bastos; Amalia Pinkusfeld,9,0,71,62
1657017404827,COGS 14A,A01,092681,Semenuks; Arturs,0,1,100,100
1657017410864,COGS 14B,A01,083073,Cheng; Tzu-Han,5,0,63,58
1657017416894,COGS 17,A01,092677,Semenuks; Arturs,4,0,81,77
1657017423041,COGS 100,A01,083619,Allen; Michael Gordon,15,0,70,55
1657017429064,COGS 101A,A01,083621,Davis; Joshua Daniel,9,0,68,59
1657017435090,COGS 101B,A01,091572,Allen; Michael Gordon,8,0,65,57
1657017441133,COGS 101C,A01,083625,Delgado; Tania,17,0,35,18
1657017447159,COGS 107A,A01,083627,Boyle; Mary E. T.,13,0,60,47
1657017453235,COGS 118A,A01,083075,Gupta; Anjum,15,0,76,61
1657017459309,CSE 3,A50,083646,Miranda; Gregory Joseph,22,0,50,28
1657017465337,CSE 8A,A50,083650,Miranda; Gregory Joseph,17,1,56,39
1657017471365,CSE 11,A01,083080,Cao; Yingjun,4,15,40,36
1657017477426,CSE 12,A01,083652,Krause-Levy; Sophia Louisa,21,1,120,99
1657017483451,CSE 15L,A01,083654,Morris; Justin Loren,8,0,50,42
1657017483451,CSE 15L,A02,083655,Morris; Justin Loren,9,0,50,41
1657017489476,CSE 20,A01,083657,Tran; Khoa Dang,37,0,80,43
1657017495498,CSE 21,A01,095574,Bach; Quang Tran,21,0,48,27
1657017501542,CSE 30,A01,083084,Eldon; John,4,0,80,76
1657017501542,CSE 30,B01,095061,Bhaskar; Nishant,6,0,50,44
1657017507570,CSE 100,A01,083659,Cao; Yingjun,3,4,70,67
1657017513613,CSE 134B,A01,083661,Powell; Thomas Allan,19,0,100,81
1657017519658,CSE 140,A01,083663,Gungor; Onat,14,0,85,71
1657017525692,CSE 140L,A01,083088,Eldon; John,16,0,100,84
1657017531731,CSE 175,A01,083665,Kumar; Rakesh,3,0,25,22
1657017537776,CSE 190,A00,092507,Dubnov; Shlomo,7,0,20,13
1657017543844,ECE 45,A01,083139,Congero; Spencer William,5,0,75,70
1657017549880,ECE 65,A50,083695,Saad; Andrew S,12,0,30,18
1657017549880,ECE 65,A51,095125,Saad; Andrew S,25,0,26,1
1657017555916,ECE 109,A01,091882,Touri; Behrouz,16,0,70,54
1657017561964,ECE 180,A00,083140,Abi Samra; Nicholas Camill,1,0,30,29
1657017561964,ECE 180,B00,083141,Abi Samra; Nicholas Camill,0,0,30,30
1657017567997,MATH 10A,A01,083735,Patchell; Gregory David,1,0,30,29
1657017567997,MATH 10A,A02,083736,Patchell; Gregory David,20,0,30,10
1657017567997,MATH 10A,A03,083737,Patchell; Gregory David,16,0,30,14
1657017574024,MATH 10B,A01,083207,Lim; Seonhee,7,0,34,27
1657017574024,MATH 10B,A02,083208,Lim; Seonhee,9,0,35,26
1657017574024,MATH 10B,A03,093472,Lim; Seonhee,4,0,34,30
1657017574024,MATH 10B,B01,083739,Sinha; Shubham,9,0,30,21
1657017580057,MATH 18,A01,083743,Cinel; Cameron Alexander,6,0,30,24
1657017580057,MATH 18,A02,083744,Cinel; Cameron Alexander,15,0,30,15
1657017580057,MATH 18,A03,083745,Cinel; Cameron Alexander,8,0,30,22
1657017580057,MATH 18,B01,083748,Rideout; David Porter,4,0,37,33
1657017580057,MATH 18,B02,083749,Rideout; David Porter,3,0,36,33
1657017580057,MATH 18,B03,083750,Rideout; David Porter,2,0,37,35
1657017580057,MATH 18,B04,083751,Rideout; David Porter,5,0,36,31
1657017580057,MATH 18,B05,093473,Rideout; David Porter,4,0,36,32
1657017580057,MATH 18,B06,093474,Rideout; David Porter,5,0,36,31
1657017586099,MATH 20A,A01,083754,Zheng; Zequn,12,0,40,28
1657017592136,MATH 20B,A01,083756,Briones; Jor-el Thomas Caparas,1,0,36,35
1657017592136,MATH 20B,A02,083757,Briones; Jor-el Thomas Caparas,1,0,36,35
1657017592136,MATH 20B,A03,093475,Briones; Jor-el Thomas Caparas,0,0,36,36
1657017598176,MATH 20C,A01,083760,Briones; Jor-el Thomas Caparas,1,0,35,34
1657017598176,MATH 20C,A02,083761,Briones; Jor-el Thomas Caparas,8,0,35,27
1657017598176,MATH 20C,A03,093476,Briones; Jor-el Thomas Caparas,0,1,36,36
1657017598176,MATH 20C,B01,083762,Bach; Quang Tran,0,0,30,30
1657017604223,MATH 20D,A01,083765,Tran; Brian Kha,4,0,30,26
1657017604223,MATH 20D,A02,083766,Tran; Brian Kha,5,0,30,25
1657017604223,MATH 20D,A03,083767,Tran; Brian Kha,3,0,30,27
1657017610266,MATH 20E,A01,083771,Ganguly; Soumya,5,0,32,27
1657017610266,MATH 20E,A02,083772,Ganguly; Soumya,6,0,32,26
1657017610266,MATH 20E,B01,083773,Ciotti; Benjamin,18,0,35,17
1657017610266,MATH 20E,B02,083774,Ciotti; Benjamin,17,0,35,18
1657017616306,MATH 103A,A01,083777,Greenfeld; Be'Eri,2,0,36,34
1657017616306,MATH 103A,A02,083778,Greenfeld; Be'Eri,5,0,36,31
1657017616306,MATH 103A,A03,093561,Greenfeld; Be'Eri,4,0,36,32
1657017616306,MATH 103A,B01,083779,Greenfeld; Be'Eri,6,0,36,30
1657017616306,MATH 103A,B02,083780,Greenfeld; Be'Eri,2,0,36,34
1657017616306,MATH 103A,B03,093562,Greenfeld; Be'Eri,2,0,36,34
1657017622341,MATH 105,A01,085443,Carter; Anne Toulson,14,0,35,21
1657017622341,MATH 105,A02,093477,Carter; Anne Toulson,20,0,35,15
1657017628373,MATH 109,A01,083213,Ganzberger; Geoffrey Michael,2,0,34,32
1657017628373,MATH 109,A02,083214,Ganzberger; Geoffrey Michael,2,0,34,32
1657017628373,MATH 109,A03,093478,Ganzberger; Geoffrey Michael,1,0,34,33
1657017628373,MATH 109,B01,083215,Ganzberger; Geoffrey Michael,1,0,32,31
1657017628373,MATH 109,B02,083216,Ganzberger; Geoffrey Michael,1,0,32,31
1657017628373,MATH 109,B03,093479,Ganzberger; Geoffrey Michael,6,0,32,26
1657017634408,MATH 142A,A01,083219,Chow; Bennett,6,0,32,26
1657017634408,MATH 142A,A02,083220,Chow; Bennett,10,0,32,22
1657017634408,MATH 142A,A03,093480,Chow; Bennett,7,0,32,25
1657017634408,MATH 142A,B03,093481,Chow; Bennett,7,0,32,25
1657017634408,MATH 142A,B04,093558,Chow; Bennett,11,0,32,21
1657017634408,MATH 142A,B05,093559,Chow; Bennett,6,0,32,26
1657017640431,MATH 193A,A01,083224,Rotar; Vladimir,7,0,34,27
1657017640431,MATH 193A,A02,083225,Rotar; Vladimir,4,0,34,30
1657017640431,MATH 193A,A03,083781,Rotar; Vladimir,1,0,34,33
1657017640431,MATH 193A,A04,083782,Rotar; Vladimir,6,0,34,28
1657017640431,MATH 193A,A05,093482,Rotar; Vladimir,6,0,34,28
1657017646456,MATH 197,001,091859,McAuley; Julian John,9999,0,9999,0
1657017646456,MATH 197,002,095566,Kedlaya; Kiran S.,9997,0,9999,2
1657017646456,MATH 197,003,095567,Xiao; Ming,9999,0,9999,0
1657017646456,MATH 197,004,095571,Perols; Johan Lars,9998,0,9999,1
1657017653526,COGS 9,A01,083615,Shannon; Kyle Michael,7,0,75,68
1657017659551,COGS 11,A01,083617,Boyle; Mary E. T.,20,0,48,28
1657017665575,COGS 13,A01,083071,Bastos; Amalia Pinkusfeld,9,0,71,62
1657017671601,COGS 14A,A01,092681,Semenuks; Arturs,0,1,100,100
1657017677699,COGS 14B,A01,083073,Cheng; Tzu-Han,5,0,63,58
1657017683728,COGS 17,A01,092677,Semenuks; Arturs,4,0,81,77
1657017689758,COGS 100,A01,083619,Allen; Michael Gordon,15,0,70,55
1657017695787,COGS 101A,A01,083621,Davis; Joshua Daniel,9,0,68,59
1657017701813,COGS 101B,A01,091572,Allen; Michael Gordon,8,0,65,57
1657017707850,COGS 101C,A01,083625,Delgado; Tania,17,0,35,18
1657017713891,COGS 107A,A01,083627,Boyle; Mary E. T.,13,0,60,47
1657017719921,COGS 118A,A01,083075,Gupta; Anjum,15,0,76,61
1657017725960,CSE 3,A50,083646,Miranda; Gregory Joseph,22,0,50,28
1657017732006,CSE 8A,A50,083650,Miranda; Gregory Joseph,17,1,56,39
1657017738049,CSE 11,A01,083080,Cao; Yingjun,4,15,40,36
1657017744092,CSE 12,A01,083652,Krause-Levy; Sophia Louisa,21,1,120,99
1657017750126,CSE 15L,A01,083654,Morris; Justin Loren,8,0,50,42
1657017750126,CSE 15L,A02,083655,Morris; Justin Loren,9,0,50,41
1657017756148,CSE 20,A01,083657,Tran; Khoa Dang,37,0,80,43
1657017762177,CSE 21,A01,095574,Bach; Quang Tran,21,0,48,27
1657017768225,CSE 30,A01,083084,Eldon; John,4,0,80,76
1657017768225,CSE 30,B01,095061,Bhaskar; Nishant,6,0,50,44
1657017774251,CSE 100,A01,083659,Cao; Yingjun,3,4,70,67
1657017780283,CSE 134B,A01,083661,Powell; Thomas Allan,19,0,100,81
1657017786310,CSE 140,A01,083663,Gungor; Onat,14,0,85,71
1657017792341,CSE 140L,A01,083088,Eldon; John,16,0,100,84
1657017798381,CSE 175,A01,083665,Kumar; Rakesh,3,0,25,22
1657017804434,CSE 190,A00,092507,Dubnov; Shlomo,7,0,20,13
1657017810482,ECE 45,A01,083139,Congero; Spencer William,5,0,75,70
1657017816516,ECE 65,A50,083695,Saad; Andrew S,12,0,30,18
1657017816516,ECE 65,A51,095125,Saad; Andrew S,25,0,26,1
1657017822551,ECE 109,A01,091882,Touri; Behrouz,16,0,70,54
1657017828576,ECE 180,A00,083140,Abi Samra; Nicholas Camill,1,0,30,29
1657017828576,ECE 180,B00,083141,Abi Samra; Nicholas Camill,0,0,30,30
1657017834613,MATH 10A,A01,083735,Patchell; Gregory David,1,0,30,29
1657017834613,MATH 10A,A02,083736,Patchell; Gregory David,20,0,30,10
1657017834613,MATH 10A,A03,083737,Patchell; Gregory David,16,0,30,14
1657017840649,MATH 10B,A01,083207,Lim; Seonhee,7,0,34,27
1657017840649,MATH 10B,A02,083208,Lim; Seonhee,9,0,35,26
1657017840649,MATH 10B,A03,093472,Lim; Seonhee,4,0,34,30
1657017840649,MATH 10B,B01,083739,Sinha; Shubham,9,0,30,21
1657017846700,MATH 18,A01,083743,Cinel; Cameron Alexander,6,0,30,24
1657017846700,MATH 18,A02,083744,Cinel; Cameron Alexander,15,0,30,15
1657017846700,MATH 18,A03,083745,Cinel; Cameron Alexander,8,0,30,22
1657017846700,MATH 18,B01,083748,Rideout; David Porter,4,0,37,33
1657017846700,MATH 18,B02,083749,Rideout; David Porter,3,0,36,33
1657017846700,MATH 18,B03,083750,Rideout; David Porter,2,0,37,35
1657017846700,MATH 18,B04,083751,Rideout; David Porter,5,0,36,31
1657017846700,MATH 18,B05,093473,Rideout; David Porter,4,0,36,32
1657017846700,MATH 18,B06,093474,Rideout; David Porter,5,0,36,31
1657017852739,MATH 20A,A01,083754,Zheng; Zequn,12,0,40,28
1657017858790,MATH 20B,A01,083756,Briones; Jor-el Thomas Caparas,1,0,36,35
1657017858790,MATH 20B,A02,083757,Briones; Jor-el Thomas Caparas,1,0,36,35
1657017858790,MATH 20B,A03,093475,Briones; Jor-el Thomas Caparas,0,0,36,36
1657017864835,MATH 20C,A01,083760,Briones; Jor-el Thomas Caparas,1,0,35,34
1657017864835,MATH 20C,A02,083761,Briones; Jor-el Thomas Caparas,8,0,35,27
1657017864835,MATH 20C,A03,093476,Briones; Jor-el Thomas Caparas,0,1,36,36
1657017864835,MATH 20C,B01,083762,Bach; Quang Tran,0,0,30,30
1657017870860,MATH 20D,A01,083765,Tran; Brian Kha,4,0,30,26
1657017870860,MATH 20D,A02,083766,Tran; Brian Kha,5,0,30,25
1657017870860,MATH 20D,A03,083767,Tran; Brian Kha,3,0,30,27
1657017876889,MATH 20E,A01,083771,Ganguly; Soumya,5,0,32,27
1657017876889,MATH 20E,A02,083772,Ganguly; Soumya,6,0,32,26
1657017876889,MATH 20E,B01,083773,Ciotti; Benjamin,18,0,35,17
1657017876889,MATH 20E,B02,083774,Ciotti; Benjamin,17,0,35,18
1657017882915,MATH 103A,A01,083777,Greenfeld; Be'Eri,2,0,36,34
1657017882915,MATH 103A,A02,083778,Greenfeld; Be'Eri,5,0,36,31
1657017882915,MATH 103A,A03,093561,Greenfeld; Be'Eri,4,0,36,32
1657017882915,MATH 103A,B01,083779,Greenfeld; Be'Eri,6,0,36,30
1657017882915,MATH 103A,B02,083780,Greenfeld; Be'Eri,2,0,36,34
1657017882915,MATH 103A,B03,093562,Greenfeld; Be'Eri,2,0,36,34
1657017888939,MATH 105,A01,085443,Carter; Anne Toulson,14,0,35,21
1657017888939,MATH 105,A02,093477,Carter; Anne Toulson,20,0,35,15
1657017894986,MATH 109,A01,083213,Ganzberger; Geoffrey Michael,2,0,34,32
1657017894986,MATH 109,A02,083214,Ganzberger; Geoffrey Michael,2,0,34,32
1657017894986,MATH 109,A03,093478,Ganzberger; Geoffrey Michael,1,0,34,33
1657017894986,MATH 109,B01,083215,Ganzberger; Geoffrey Michael,1,0,32,31
1657017894986,MATH 109,B02,083216,Ganzberger; Geoffrey Michael,1,0,32,31
1657017894986,MATH 109,B03,093479,Ganzberger; Geoffrey Michael,6,0,32,26
1657017901016,MATH 142A,A01,083219,Chow; Bennett,6,0,32,26
1657017901016,MATH 142A,A02,083220,Chow; Bennett,10,0,32,22
1657017901016,MATH 142A,A03,093480,Chow; Bennett,7,0,32,25
1657017901016,MATH 142A,B03,093481,Chow; Bennett,7,0,32,25
1657017901016,MATH 142A,B04,093558,Chow; Bennett,11,0,32,21
1657017901016,MATH 142A,B05,093559,Chow; Bennett,6,0,32,26
1657017907066,MATH 193A,A01,083224,Rotar; Vladimir,7,0,34,27
1657017907066,MATH 193A,A02,083225,Rotar; Vladimir,4,0,34,30
1657017907066,MATH 193A,A03,083781,Rotar; Vladimir,1,0,34,33
1657017907066,MATH 193A,A04,083782,Rotar; Vladimir,6,0,34,28
1657017907066,MATH 193A,A05,093482,Rotar; Vladimir,6,0,34,28
1657017913093,MATH 197,001,091859,McAuley; Julian John,9999,0,9999,0
1657017913093,MATH 197,002,095566,Kedlaya; Kiran S.,9997,0,9999,2
1657017913093,MATH 197,003,095567,Xiao; Ming,9999,0,9999,0
1657017913093,MATH 197,004,095571,Perols; Johan Lars,9998,0,9999,1
1657017920167,COGS 9,A01,083615,Shannon; Kyle Michael,7,0,75,68
1657017926211,COGS 11,A01,083617,Boyle; Mary E. T.,20,0,48,28
1657017932237,COGS 13,A01,083071,Bastos; Amalia Pinkusfeld,9,0,71,62
1657017938265,COGS 14A,A01,092681,Semenuks; Arturs,0,1,100,100
1657017944296,COGS 14B,A01,083073,Cheng; Tzu-Han,5,0,63,58
1657017950345,COGS 17,A01,092677,Semenuks; Arturs,4,0,81,77
1657017956370,COGS 100,A01,083619,Allen; Michael Gordon,15,0,70,55
1657017962394,COGS 101A,A01,083621,Davis; Joshua Daniel,9,0,68,59
1657017968420,COGS 101B,A01,091572,Allen; Michael Gordon,8,0,65,57
1657017974449,COGS 101C,A01,083625,Delgado; Tania,17,0,35,18
1657017980475,COGS 107A,A01,083627,Boyle; Mary E. T.,13,0,60,47
1657017986501,COGS 118A,A01,083075,Gupta; Anjum,15,0,76,61
1657017992528,CSE 3,A50,083646,Miranda; Gregory Joseph,22,0,50,28
1657017998552,CSE 8A,A50,083650,Miranda; Gregory Joseph,17,1,56,39
1657018004584,CSE 11,A01,083080,Cao; Yingjun,4,15,40,36
1657018010613,CSE 12,A01,083652,Krause-Levy; Sophia Louisa,21,1,120,99
1657018016643,CSE 15L,A01,083654,Morris; Justin Loren,8,0,50,42
1657018016643,CSE 15L,A02,083655,Morris; Justin Loren,9,0,50,41
1657018022749,CSE 20,A01,083657,Tran; Khoa Dang,37,0,80,43
1657018028781,CSE 21,A01,095574,Bach; Quang Tran,21,0,48,27
1657018034830,CSE 30,A01,083084,Eldon; John,4,0,80,76
1657018034830,CSE 30,B01,095061,Bhaskar; Nishant,6,0,50,44
1657018040875,CSE 100,A01,083659,Cao; Yingjun,3,4,70,67
1657018046902,CSE 134B,A01,083661,Powell; Thomas Allan,19,0,100,81
1657018052936,CSE 140,A01,083663,Gungor; Onat,14,0,85,71
1657018058983,CSE 140L,A01,083088,Eldon; John,16,0,100,84
1657018065007,CSE 175,A01,083665,Kumar; Rakesh,3,0,25,22
1657018071038,CSE 190,A00,092507,Dubnov; Shlomo,7,0,20,13
1657018077064,ECE 45,A01,083139,Congero; Spencer William,5,0,75,70
1657018083089,ECE 65,A50,083695,Saad; Andrew S,12,0,30,18
1657018083089,ECE 65,A51,095125,Saad; Andrew S,25,0,26,1
1657018089114,ECE 109,A01,091882,Touri; Behrouz,16,0,70,54
1657018095138,ECE 180,A00,083140,Abi Samra; Nicholas Camill,1,0,30,29
1657018095138,ECE 180,B00,083141,Abi Samra; Nicholas Camill,0,0,30,30
1657018101169,MATH 10A,A01,083735,Patchell; Gregory David,1,0,30,29
1657018101169,MATH 10A,A02,083736,Patchell; Gregory David,20,0,30,10
1657018101169,MATH 10A,A03,083737,Patchell; Gregory David,16,0,30,14
1657018107196,MATH 10B,A01,083207,Lim; Seonhee,7,0,34,27
1657018107196,MATH 10B,A02,083208,Lim; Seonhee,9,0,35,26
1657018107196,MATH 10B,A03,093472,Lim; Seonhee,4,0,34,30
1657018107196,MATH 10B,B01,083739,Sinha; Shubham,9,0,30,21
1657018113224,MATH 18,A01,083743,Cinel; Cameron Alexander,6,0,30,24
1657018113224,MATH 18,A02,083744,Cinel; Cameron Alexander,15,0,30,15
1657018113224,MATH 18,A03,083745,Cinel; Cameron Alexander,8,0,30,22
1657018113224,MATH 18,B01,083748,Rideout; David Porter,4,0,37,33
1657018113224,MATH 18,B02,083749,Rideout; David Porter,3,0,36,33
1657018113224,MATH 18,B03,083750,Rideout; David Porter,2,0,37,35
1657018113224,MATH 18,B04,083751,Rideout; David Porter,5,0,36,31
1657018113224,MATH 18,B05,093473,Rideout; David Porter,4,0,36,32
1657018113224,MATH 18,B06,093474,Rideout; David Porter,5,0,36,31
1657018119247,MATH 20A,A01,083754,Zheng; Zequn,12,0,40,28
1657018125272,MATH 20B,A01,083756,Briones; Jor-el Thomas Caparas,1,0,36,35
1657018125272,MATH 20B,A02,083757,Briones; Jor-el Thomas Caparas,1,0,36,35
1657018125272,MATH 20B,A03,093475,Briones; Jor-el Thomas Caparas,0,0,36,36
1657018131302,MATH 20C,A01,083760,Briones; Jor-el Thomas Caparas,1,0,35,34
1657018131302,MATH 20C,A02,083761,Briones; Jor-el Thomas Caparas,8,0,35,27
1657018131302,MATH 20C,A03,093476,Briones; Jor-el Thomas Caparas,0,1,36,36
1657018131302,MATH 20C,B01,083762,Bach; Quang Tran,0,0,30,30
1657018137327,MATH 20D,A01,083765,Tran; Brian Kha,4,0,30,26
1657018137327,MATH 20D,A02,083766,Tran; Brian Kha,5,0,30,25
1657018137327,MATH 20D,A03,083767,Tran; Brian Kha,3,0,30,27
1657018143361,MATH 20E,A01,083771,Ganguly; Soumya,5,0,32,27
1657018143361,MATH 20E,A02,083772,Ganguly; Soumya,6,0,32,26
1657018143361,MATH 20E,B01,083773,Ciotti; Benjamin,18,0,35,17
1657018143361,MATH 20E,B02,083774,Ciotti; Benjamin,17,0,35,18
1657018149388,MATH 103A,A01,083777,Greenfeld; Be'Eri,2,0,36,34
1657018149388,MATH 103A,A02,083778,Greenfeld; Be'Eri,5,0,36,31
1657018149388,MATH 103A,A03,093561,Greenfeld; Be'Eri,4,0,36,32
1657018149388,MATH 103A,B01,083779,Greenfeld; Be'Eri,6,0,36,30
1657018149388,MATH 103A,B02,083780,Greenfeld; Be'Eri,2,0,36,34
1657018149388,MATH 103A,B03,093562,Greenfeld; Be'Eri,2,0,36,34
1657018155440,MATH 105,A01,085443,Carter; Anne Toulson,14,0,35,21
1657018155440,MATH 105,A02,093477,Carter; Anne Toulson,20,0,35,15
1657018161463,MATH 109,A01,083213,Ganzberger; Geoffrey Michael,2,0,34,32
1657018161463,MATH 109,A02,083214,Ganzberger; Geoffrey Michael,2,0,34,32
1657018161463,MATH 109,A03,093478,Ganzberger; Geoffrey Michael,1,0,34,33
1657018161463,MATH 109,B01,083215,Ganzberger; Geoffrey Michael,1,0,32,31
1657018161463,MATH 109,B02,083216,Ganzberger; Geoffrey Michael,1,0,32,31
1657018161463,MATH 109,B03,093479,Ganzberger; Geoffrey Michael,6,0,32,26
1657018167494,MATH 142A,A01,083219,Chow; Bennett,6,0,32,26
1657018167494,MATH 142A,A02,083220,Chow; Bennett,10,0,32,22
1657018167494,MATH 142A,A03,093480,Chow; Bennett,7,0,32,25
1657018167494,MATH 142A,B03,093481,Chow; Bennett,7,0,32,25
1657018167494,MATH 142A,B04,093558,Chow; Bennett,11,0,32,21
1657018167494,MATH 142A,B05,093559,Chow; Bennett,6,0,32,26
1657018173524,MATH 193A,A01,083224,Rotar; Vladimir,7,0,34,27
1657018173524,MATH 193A,A02,083225,Rotar; Vladimir,4,0,34,30
1657018173524,MATH 193A,A03,083781,Rotar; Vladimir,1,0,34,33
1657018173524,MATH 193A,A04,083782,Rotar; Vladimir,6,0,34,28
1657018173524,MATH 193A,A05,093482,Rotar; Vladimir,6,0,34,28
1657018179554,MATH 197,001,091859,McAuley; Julian John,9999,0,9999,0
1657018179554,MATH 197,002,095566,Kedlaya; Kiran S.,9997,0,9999,2
1657018179554,MATH 197,003,095567,Xiao; Ming,9999,0,9999,0
1657018179554,MATH 197,004,095571,Perols; Johan Lars,9998,0,9999,1
1657018186622,COGS 9,A01,083615,Shannon; Kyle Michael,7,0,75,68
1657018192655,COGS 11,A01,083617,Boyle; Mary E. T.,20,0,48,28
1657018198679,COGS 13,A01,083071,Bastos; Amalia Pinkusfeld,9,0,71,62
1657018204707,COGS 14A,A01,092681,Semenuks; Arturs,0,1,100,100
1657018210738,COGS 14B,A01,083073,Cheng; Tzu-Han,5,0,63,58
1657018216774,COGS 17,A01,092677,Semenuks; Arturs,4,0,81,77
1657018222798,COGS 100,A01,083619,Allen; Michael Gordon,15,0,70,55
1657018228820,COGS 101A,A01,083621,Davis; Joshua Daniel,9,0,68,59
1657018234875,COGS 101B,A01,091572,Allen; Michael Gordon,8,0,65,57
1657018240909,COGS 101C,A01,083625,Delgado; Tania,17,0,35,18
1657018246937,COGS 107A,A01,083627,Boyle; Mary E. T.,13,0,60,47
1657018252966,COGS 118A,A01,083075,Gupta; Anjum,15,0,76,61
1657018258997,CSE 3,A50,083646,Miranda; Gregory Joseph,22,0,50,28
1657018265031,CSE 8A,A50,083650,Miranda; Gregory Joseph,17,1,56,39
1657018271064,CSE 11,A01,083080,Cao; Yingjun,4,15,40,36
1657018277105,CSE 12,A01,083652,Krause-Levy; Sophia Louisa,21,1,120,99
1657018283127,CSE 15L,A01,083654,Morris; Justin Loren,8,0,50,42
1657018283127,CSE 15L,A02,083655,Morris; Justin Loren,9,0,50,41
1657018289157,CSE 20,A01,083657,Tran; Khoa Dang,37,0,80,43
1657018295186,CSE 21,A01,095574,Bach; Quang Tran,21,0,48,27
1657018301230,CSE 30,A01,083084,Eldon; John,4,0,80,76
1657018301230,CSE 30,B01,095061,Bhaskar; Nishant,6,0,50,44
1657018307255,CSE 100,A01,083659,Cao; Yingjun,3,4,70,67
1657018313281,CSE 134B,A01,083661,Powell; Thomas Allan,19,0,100,81
1657018319311,CSE 140,A01,083663,Gungor; Onat,14,0,85,71
1657018325349,CSE 140L,A01,083088,Eldon; John,16,0,100,84
1657018331382,CSE 175,A01,083665,Kumar; Rakesh,3,0,25,22
1657018337411,CSE 190,A00,092507,Dubnov; Shlomo,7,0,20,13
1657018343447,ECE 45,A01,083139,Congero; Spencer William,5,0,75,70
1657018349473,ECE 65,A50,083695,Saad; Andrew S,12,0,30,18
1657018349473,ECE 65,A51,095125,Saad; Andrew S,25,0,26,1
1657018355498,ECE 109,A01,091882,Touri; Behrouz,16,0,70,54
1657018361524,ECE 180,A00,083140,Abi Samra; Nicholas Camill,1,0,30,29
1657018361524,ECE 180,B00,083141,Abi Samra; Nicholas Camill,0,0,30,30
1657018367550,MATH 10A,A01,083735,Patchell; Gregory David,1,0,30,29
1657018367550,MATH 10A,A02,083736,Patchell; Gregory David,20,0,30,10
1657018367550,MATH 10A,A03,083737,Patchell; Gregory David,16,0,30,14
1657018373584,MATH 10B,A01,083207,Lim; Seonhee,7,0,34,27
1657018373584,MATH 10B,A02,083208,Lim; Seonhee,9,0,35,26
1657018373584,MATH 10B,A03,093472,Lim; Seonhee,4,0,34,30
1657018373584,MATH 10B,B01,083739,Sinha; Shubham,9,0,30,21
1657018379625,MATH 18,A01,083743,Cinel; Cameron Alexander,6,0,30,24
1657018379625,MATH 18,A02,083744,Cinel; Cameron Alexander,15,0,30,15
1657018379625,MATH 18,A03,083745,Cinel; Cameron Alexander,8,0,30,22
1657018379625,MATH 18,B01,083748,Rideout; David Porter,4,0,37,33
1657018379625,MATH 18,B02,083749,Rideout; David Porter,3,0,36,33
1657018379625,MATH 18,B03,083750,Rideout; David Porter,2,0,37,35
1657018379625,MATH 18,B04,083751,Rideout; David Porter,5,0,36,31
1657018379625,MATH 18,B05,093473,Rideout; David Porter,4,0,36,32
1657018379625,MATH 18,B06,093474,Rideout; David Porter,5,0,36,31
1657018385656,MATH 20A,A01,083754,Zheng; Zequn,12,0,40,28
1657018391682,MATH 20B,A01,083756,Briones; Jor-el Thomas Caparas,1,0,36,35
1657018391682,MATH 20B,A02,083757,Briones; Jor-el Thomas Caparas,1,0,36,35
1657018391682,MATH 20B,A03,093475,Briones; Jor-el Thomas Caparas,0,0,36,36
1657018397708,MATH 20C,A01,083760,Briones; Jor-el Thomas Caparas,1,0,35,34
1657018397708,MATH 20C,A02,083761,Briones; Jor-el Thomas Caparas,8,0,35,27
1657018397708,MATH 20C,A03,093476,Briones; Jor-el Thomas Caparas,0,1,36,36
1657018397708,MATH 20C,B01,083762,Bach; Quang Tran,0,0,30,30
1657018403739,MATH 20D,A01,083765,Tran; Brian Kha,4,0,30,26
1657018403739,MATH 20D,A02,083766,Tran; Brian Kha,5,0,30,25
1657018403739,MATH 20D,A03,083767,Tran; Brian Kha,3,0,30,27
1657018409789,MATH 20E,A01,083771,Ganguly; Soumya,5,0,32,27
1657018409789,MATH 20E,A02,083772,Ganguly; Soumya,6,0,32,26
1657018409789,MATH 20E,B01,083773,Ciotti; Benjamin,18,0,35,17
1657018409789,MATH 20E,B02,083774,Ciotti; Benjamin,17,0,35,18
1657018415822,MATH 103A,A01,083777,Greenfeld; Be'Eri,2,0,36,34
1657018415822,MATH 103A,A02,083778,Greenfeld; Be'Eri,5,0,36,31
1657018415822,MATH 103A,A03,093561,Greenfeld; Be'Eri,4,0,36,32
1657018415822,MATH 103A,B01,083779,Greenfeld; Be'Eri,6,0,36,30
1657018415822,MATH 103A,B02,083780,Greenfeld; Be'Eri,2,0,36,34
1657018415822,MATH 103A,B03,093562,Greenfeld; Be'Eri,2,0,36,34
1657018421846,MATH 105,A01,085443,Carter; Anne Toulson,14,0,35,21
1657018421846,MATH 105,A02,093477,Carter; Anne Toulson,20,0,35,15
1657018427878,MATH 109,A01,083213,Ganzberger; Geoffrey Michael,2,0,34,32
1657018427878,MATH 109,A02,083214,Ganzberger; Geoffrey Michael,2,0,34,32
1657018427878,MATH 109,A03,093478,Ganzberger; Geoffrey Michael,1,0,34,33
1657018427878,MATH 109,B01,083215,Ganzberger; Geoffrey Michael,1,0,32,31
1657018427878,MATH 109,B02,083216,Ganzberger; Geoffrey Michael,1,0,32,31
1657018427878,MATH 109,B03,093479,Ganzberger; Geoffrey Michael,6,0,32,26
1657018433903,MATH 142A,A01,083219,Chow; Bennett,6,0,32,26
1657018433903,MATH 142A,A02,083220,Chow; Bennett,10,0,32,22
1657018433903,MATH 142A,A03,093480,Chow; Bennett,7,0,32,25
1657018433903,MATH 142A,B03,093481,Chow; Bennett,7,0,32,25
1657018433903,MATH 142A,B04,093558,Chow; Bennett,11,0,32,21
1657018433903,MATH 142A,B05,093559,Chow; Bennett,6,0,32,26
1657018439936,MATH 193A,A01,083224,Rotar; Vladimir,7,0,34,27
1657018439936,MATH 193A,A02,083225,Rotar; Vladimir,4,0,34,30
1657018439936,MATH 193A,A03,083781,Rotar; Vladimir,1,0,34,33
1657018439936,MATH 193A,A04,083782,Rotar; Vladimir,6,0,34,28
1657018439936,MATH 193A,A05,093482,Rotar; Vladimir,6,0,34,28
1657018445970,MATH 197,001,091859,McAuley; Julian John,9999,0,9999,0
1657018445970,MATH 197,002,095566,Kedlaya; Kiran S.,9997,0,9999,2
1657018445970,MATH 197,003,095567,Xiao; Ming,9999,0,9999,0
1657018445970,MATH 197,004,095571,Perols; Johan Lars,9998,0,9999,1
1657018453045,COGS 9,A01,083615,Shannon; Kyle Michael,7,0,75,68
1657018459072,COGS 11,A01,083617,Boyle; Mary E. T.,20,0,48,28
1657018465108,COGS 13,A01,083071,Bastos; Amalia Pinkusfeld,9,0,71,62
1657018471143,COGS 14A,A01,092681,Semenuks; Arturs,0,1,100,100
1657018477168,COGS 14B,A01,083073,Cheng; Tzu-Han,5,0,63,58
1657018483196,COGS 17,A01,092677,Semenuks; Arturs,4,0,81,77
1657018489232,COGS 100,A01,083619,Allen; Michael Gordon,15,0,70,55
1657018495271,COGS 101A,A01,083621,Davis; Joshua Daniel,9,0,68,59
1657018501306,COGS 101B,A01,091572,Allen; Michael Gordon,8,0,65,57
1657018507331,COGS 101C,A01,083625,Delgado; Tania,17,0,35,18
1657018513359,COGS 107A,A01,083627,Boyle; Mary E. T.,13,0,60,47
1657018519396,COGS 118A,A01,083075,Gupta; Anjum,15,0,76,61
1657018525421,CSE 3,A50,083646,Miranda; Gregory Joseph,22,0,50,28
1657018531444,CSE 8A,A50,083650,Miranda; Gregory Joseph,17,1,56,39
1657018537481,CSE 11,A01,083080,Cao; Yingjun,4,15,40,36
1657018543505,CSE 12,A01,083652,Krause-Levy; Sophia Louisa,21,1,120,99
1657018549529,CSE 15L,A01,083654,Morris; Justin Loren,8,0,50,42
1657018549529,CSE 15L,A02,083655,Morris; Justin Loren,9,0,50,41
1657018555555,CSE 20,A01,083657,Tran; Khoa Dang,37,0,80,43
1657018561589,CSE 21,A01,095574,Bach; Quang Tran,21,0,48,27
1657018567627,CSE 30,A01,083084,Eldon; John,4,0,80,76
1657018567627,CSE 30,B01,095061,Bhaskar; Nishant,6,0,50,44
1657018573650,CSE 100,A01,083659,Cao; Yingjun,3,4,70,67
1657018579676,CSE 134B,A01,083661,Powell; Thomas Allan,19,0,100,81
1657018585701,CSE 140,A01,083663,Gungor; Onat,14,0,85,71
1657018591724,CSE 140L,A01,083088,Eldon; John,16,0,100,84
1657018597748,CSE 175,A01,083665,Kumar; Rakesh,3,0,25,22
1657018603787,CSE 190,A00,092507,Dubnov; Shlomo,7,0,20,13
1657018609825,ECE 45,A01,083139,Congero; Spencer William,5,0,75,70
1657018615859,ECE 65,A50,083695,Saad; Andrew S,12,0,30,18
1657018615859,ECE 65,A51,095125,Saad; Andrew S,25,0,26,1
1657018621985,ECE 109,A01,091882,Touri; Behrouz,16,0,70,54
1657018628013,ECE 180,A00,083140,Abi Samra; Nicholas Camill,1,0,30,29
1657018628013,ECE 180,B00,083141,Abi Samra; Nicholas Camill,0,0,30,30
1657018634051,MATH 10A,A01,083735,Patchell; Gregory David,1,0,30,29
1657018634051,MATH 10A,A02,083736,Patchell; Gregory David,20,0,30,10
1657018634051,MATH 10A,A03,083737,Patchell; Gregory David,16,0,30,14
1657018640078,MATH 10B,A01,083207,Lim; Seonhee,7,0,34,27
1657018640078,MATH 10B,A02,083208,Lim; Seonhee,9,0,35,26
1657018640078,MATH 10B,A03,093472,Lim; Seonhee,4,0,34,30
1657018640078,MATH 10B,B01,083739,Sinha; Shubham,9,0,30,21
1657018646126,MATH 18,A01,083743,Cinel; Cameron Alexander,6,0,30,24
1657018646126,MATH 18,A02,083744,Cinel; Cameron Alexander,15,0,30,15
1657018646126,MATH 18,A03,083745,Cinel; Cameron Alexander,8,0,30,22
1657018646126,MATH 18,B01,083748,Rideout; David Porter,4,0,37,33
1657018646126,MATH 18,B02,083749,Rideout; David Porter,3,0,36,33
1657018646126,MATH 18,B03,083750,Rideout; David Porter,2,0,37,35
1657018646126,MATH 18,B04,083751,Rideout; David Porter,5,0,36,31
1657018646126,MATH 18,B05,093473,Rideout; David Porter,4,0,36,32
1657018646126,MATH 18,B06,093474,Rideout; David Porter,5,0,36,31
1657018652161,MATH 20A,A01,083754,Zheng; Zequn,12,0,40,28
1657018658209,MATH 20B,A01,083756,Briones; Jor-el Thomas Caparas,1,0,36,35
1657018658209,MATH 20B,A02,083757,Briones; Jor-el Thomas Caparas,1,0,36,35
1657018658209,MATH 20B,A03,093475,Briones; Jor-el Thomas Caparas,0,0,36,36
1657018664242,MATH 20C,A01,083760,Briones; Jor-el Thomas Caparas,1,0,35,34
1657018664242,MATH 20C,A02,083761,Briones; Jor-el Thomas Caparas,8,0,35,27
1657018664242,MATH 20C,A03,093476,Briones; Jor-el Thomas Caparas,0,1,36,36
1657018664242,MATH 20C,B01,083762,Bach; Quang Tran,0,0,30,30
1657018670277,MATH 20D,A01,083765,Tran; Brian Kha,4,0,30,26
1657018670277,MATH 20D,A02,083766,Tran; Brian Kha,5,0,30,25
1657018670277,MATH 20D,A03,083767,Tran; Brian Kha,3,0,30,27
1657018676341,MATH 20E,A01,083771,Ganguly; Soumya,5,0,32,27
1657018676341,MATH 20E,A02,083772,Ganguly; Soumya,6,0,32,26
1657018676341,MATH 20E,B01,083773,Ciotti; Benjamin,18,0,35,17
1657018676341,MATH 20E,B02,083774,Ciotti; Benjamin,17,0,35,18
1657018682401,MATH 103A,A01,083777,Greenfeld; Be'Eri,2,0,36,34
1657018682401,MATH 103A,A02,083778,Greenfeld; Be'Eri,5,0,36,31
1657018682401,MATH 103A,A03,093561,Greenfeld; Be'Eri,4,0,36,32
1657018682401,MATH 103A,B01,083779,Greenfeld; Be'Eri,6,0,36,30
1657018682401,MATH 103A,B02,083780,Greenfeld; Be'Eri,2,0,36,34
1657018682401,MATH 103A,B03,093562,Greenfeld; Be'Eri,2,0,36,34
1657018688433,MATH 105,A01,085443,Carter; Anne Toulson,14,0,35,21
1657018688433,MATH 105,A02,093477,Carter; Anne Toulson,20,0,35,15
1657018694477,MATH 109,A01,083213,Ganzberger; Geoffrey Michael,2,0,34,32
1657018694477,MATH 109,A02,083214,Ganzberger; Geoffrey Michael,2,0,34,32
1657018694477,MATH 109,A03,093478,Ganzberger; Geoffrey Michael,1,0,34,33
1657018694477,MATH 109,B01,083215,Ganzberger; Geoffrey Michael,1,0,32,31
1657018694477,MATH 109,B02,083216,Ganzberger; Geoffrey Michael,1,0,32,31
1657018694477,MATH 109,B03,093479,Ganzberger; Geoffrey Michael,6,0,32,26
1657018700504,MATH 142A,A01,083219,Chow; Bennett,6,0,32,26
1657018700504,MATH 142A,A02,083220,Chow; Bennett,10,0,32,22
1657018700504,MATH 142A,A03,093480,Chow; Bennett,7,0,32,25
1657018700504,MATH 142A,B03,093481,Chow; Bennett,7,0,32,25
1657018700504,MATH 142A,B04,093558,Chow; Bennett,11,0,32,21
1657018700504,MATH 142A,B05,093559,Chow; Bennett,6,0,32,26
1657018706530,MATH 193A,A01,083224,Rotar; Vladimir,7,0,34,27
1657018706530,MATH 193A,A02,083225,Rotar; Vladimir,4,0,34,30
1657018706530,MATH 193A,A03,083781,Rotar; Vladimir,1,0,34,33
1657018706530,MATH 193A,A04,083782,Rotar; Vladimir,6,0,34,28
1657018706530,MATH 193A,A05,093482,Rotar; Vladimir,6,0,34,28
1657018712553,MATH 197,001,091859,McAuley; Julian John,9999,0,9999,0
1657018712553,MATH 197,002,095566,Kedlaya; Kiran S.,9997,0,9999,2
1657018712553,MATH 197,003,095567,Xiao; Ming,9999,0,9999,0
1657018712553,MATH 197,004,095571,Perols; Johan Lars,9998,0,9999,1
1657018719635,COGS 9,A01,083615,Shannon; Kyle Michael,7,0,75,68
1657018725683,COGS 11,A01,083617,Boyle; Mary E. T.,20,0,48,28
1657018731714,COGS 13,A01,083071,Bastos; Amalia Pinkusfeld,9,0,71,62
1657018737748,COGS 14A,A01,092681,Semenuks; Arturs,0,1,100,100
1657018743774,COGS 14B,A01,083073,Cheng; Tzu-Han,5,0,63,58
1657018749813,COGS 17,A01,092677,Semenuks; Arturs,4,0,81,77
1657018755846,COGS 100,A01,083619,Allen; Michael Gordon,15,0,70,55
1657018761877,COGS 101A,A01,083621,Davis; Joshua Daniel,9,0,68,59
1657018767910,COGS 101B,A01,091572,Allen; Michael Gordon,8,0,65,57
1657018773938,COGS 101C,A01,083625,Delgado; Tania,17,0,35,18
1657018779977,COGS 107A,A01,083627,Boyle; Mary E. T.,13,0,60,47
1657018786016,COGS 118A,A01,083075,Gupta; Anjum,15,0,76,61
1657018792060,CSE 3,A50,083646,Miranda; Gregory Joseph,22,0,50,28
1657018798087,CSE 8A,A50,083650,Miranda; Gregory Joseph,17,1,56,39
1657018804110,CSE 11,A01,083080,Cao; Yingjun,4,15,40,36
1657018810133,CSE 12,A01,083652,Krause-Levy; Sophia Louisa,21,1,120,99
1657018816161,CSE 15L,A01,083654,Morris; Justin Loren,8,0,50,42
1657018816161,CSE 15L,A02,083655,Morris; Justin Loren,9,0,50,41
1657018822188,CSE 20,A01,083657,Tran; Khoa Dang,37,0,80,43
1657018828213,CSE 21,A01,095574,Bach; Quang Tran,21,0,48,27
1657018834242,CSE 30,A01,083084,Eldon; John,4,0,80,76
1657018834242,CSE 30,B01,095061,Bhaskar; Nishant,6,0,50,44
1657018840286,CSE 100,A01,083659,Cao; Yingjun,3,4,70,67
1657018846312,CSE 134B,A01,083661,Powell; Thomas Allan,19,0,100,81
1657018852337,CSE 140,A01,083663,Gungor; Onat,14,0,85,71
1657018858393,CSE 140L,A01,083088,Eldon; John,16,0,100,84
1657018864418,CSE 175,A01,083665,Kumar; Rakesh,3,0,25,22
1657018870455,CSE 190,A00,092507,Dubnov; Shlomo,7,0,20,13
1657018876505,ECE 45,A01,083139,Congero; Spencer William,5,0,75,70
1657018882531,ECE 65,A50,083695,Saad; Andrew S,12,0,30,18
1657018882531,ECE 65,A51,095125,Saad; Andrew S,25,0,26,1
1657018888576,ECE 109,A01,091882,Touri; Behrouz,16,0,70,54
1657018894607,ECE 180,A00,083140,Abi Samra; Nicholas Camill,1,0,30,29
1657018894607,ECE 180,B00,083141,Abi Samra; Nicholas Camill,0,0,30,30
1657018900636,MATH 10A,A01,083735,Patchell; Gregory David,1,0,30,29
1657018900636,MATH 10A,A02,083736,Patchell; Gregory David,20,0,30,10
1657018900636,MATH 10A,A03,083737,Patchell; Gregory David,16,0,30,14
1657018906666,MATH 10B,A01,083207,Lim; Seonhee,7,0,34,27
1657018906666,MATH 10B,A02,083208,Lim; Seonhee,9,0,35,26
1657018906666,MATH 10B,A03,093472,Lim; Seonhee,4,0,34,30
1657018906666,MATH 10B,B01,083739,Sinha; Shubham,9,0,30,21
1657018912694,MATH 18,A01,083743,Cinel; Cameron Alexander,6,0,30,24
1657018912694,MATH 18,A02,083744,Cinel; Cameron Alexander,15,0,30,15
1657018912694,MATH 18,A03,083745,Cinel; Cameron Alexander,8,0,30,22
1657018912694,MATH 18,B01,083748,Rideout; David Porter,4,0,37,33
1657018912694,MATH 18,B02,083749,Rideout; David Porter,3,0,36,33
1657018912694,MATH 18,B03,083750,Rideout; David Porter,2,0,37,35
1657018912694,MATH 18,B04,083751,Rideout; David Porter,5,0,36,31
1657018912694,MATH 18,B05,093473,Rideout; David Porter,4,0,36,32
1657018912694,MATH 18,B06,093474,Rideout; David Porter,5,0,36,31
1657018929848,MATH 20A,A01,083754,Zheng; Zequn,12,0,40,28
1657018935879,MATH 20B,A01,083756,Briones; Jor-el Thomas Caparas,1,0,36,35
1657018935879,MATH 20B,A02,083757,Briones; Jor-el Thomas Caparas,1,0,36,35
1657018935879,MATH 20B,A03,093475,Briones; Jor-el Thomas Caparas,0,0,36,36
1657018954887,MATH 20C,A01,083760,Briones; Jor-el Thomas Caparas,1,0,35,34
1657018954887,MATH 20C,A02,083761,Briones; Jor-el Thomas Caparas,8,0,35,27
1657018954887,MATH 20C,A03,093476,Briones; Jor-el Thomas Caparas,0,1,36,36
1657018954887,MATH 20C,B01,083762,Bach; Quang Tran,0,0,30,30
1657018960918,MATH 20D,A01,083765,Tran; Brian Kha,4,0,30,26
1657018960918,MATH 20D,A02,083766,Tran; Brian Kha,5,0,30,25
1657018960918,MATH 20D,A03,083767,Tran; Brian Kha,3,0,30,27
1657018981215,MATH 103A,A01,083777,Greenfeld; Be'Eri,2,0,36,34
1657018981215,MATH 103A,A02,083778,Greenfeld; Be'Eri,5,0,36,31
1657018981215,MATH 103A,A03,093561,Greenfeld; Be'Eri,4,0,36,32
1657018981215,MATH 103A,B01,083779,Greenfeld; Be'Eri,6,0,36,30
1657018981215,MATH 103A,B02,083780,Greenfeld; Be'Eri,2,0,36,34
1657018981215,MATH 103A,B03,093562,Greenfeld; Be'Eri,2,0,36,34
1657018987252,MATH 105,A01,085443,Carter; Anne Toulson,14,0,35,21
1657018987252,MATH 105,A02,093477,Carter; Anne Toulson,20,0,35,15
1657019007192,MATH 109,A01,083213,Ganzberger; Geoffrey Michael,2,0,34,32
1657019007192,MATH 109,A02,083214,Ganzberger; Geoffrey Michael,2,0,34,32
1657019007192,MATH 109,A03,093478,Ganzberger; Geoffrey Michael,1,0,34,33
1657019007192,MATH 109,B01,083215,Ganzberger; Geoffrey Michael,1,0,32,31
1657019007192,MATH 109,B02,083216,Ganzberger; Geoffrey Michael,1,0,32,31
1657019007192,MATH 109,B03,093479,Ganzberger; Geoffrey Michael,6,0,32,26
1657019013231,MATH 142A,A01,083219,Chow; Bennett,6,0,32,26
1657019013231,MATH 142A,A02,083220,Chow; Bennett,10,0,32,22
1657019013231,MATH 142A,A03,093480,Chow; Bennett,7,0,32,25
1657019013231,MATH 142A,B03,093481,Chow; Bennett,7,0,32,25
1657019013231,MATH 142A,B04,093558,Chow; Bennett,11,0,32,21
1657019013231,MATH 142A,B05,093559,Chow; Bennett,6,0,32,26
1657019032976,MATH 193A,A01,083224,Rotar; Vladimir,7,0,34,27
1657019032976,MATH 193A,A02,083225,Rotar; Vladimir,4,0,34,30
1657019032976,MATH 193A,A03,083781,Rotar; Vladimir,1,0,34,33
1657019032976,MATH 193A,A04,083782,Rotar; Vladimir,6,0,34,28
1657019032976,MATH 193A,A05,093482,Rotar; Vladimir,6,0,34,28
1657019039009,MATH 197,001,091859,McAuley; Julian John,9999,0,9999,0
1657019039009,MATH 197,002,095566,Kedlaya; Kiran S.,9997,0,9999,2
1657019039009,MATH 197,003,095567,Xiao; Ming,9999,0,9999,0
1657019039009,MATH 197,004,095571,Perols; Johan Lars,9998,0,9999,1
1657019059194,COGS 9,A01,083615,Shannon; Kyle Michael,7,0,75,68
1657019065218,COGS 11,A01,083617,Boyle; Mary E. T.,20,0,48,28
1657019084209,COGS 13,A01,083071,Bastos; Amalia Pinkusfeld,9,0,71,62
1657019090241,COGS 14A,A01,092681,Semenuks; Arturs,0,1,100,100
1657019110391,COGS 14B,A01,083073,Cheng; Tzu-Han,5,0,63,58
1657019116421,COGS 17,A01,092677,Semenuks; Arturs,4,0,81,77
1657019135080,COGS 100,A01,083619,Allen; Michael Gordon,15,0,70,55
1657019141115,COGS 101A,A01,083621,Davis; Joshua Daniel,9,0,68,59
1657019148177,COGS 101B,A01,091572,Allen; Michael Gordon,8,0,65,57
1657019154210,COGS 101C,A01,083625,Delgado; Tania,17,0,35,18
1657019160239,COGS 107A,A01,083627,Boyle; Mary E. T.,13,0,60,47
1657019166277,COGS 118A,A01,083075,Gupta; Anjum,15,0,76,61
1657019172337,CSE 3,A50,083646,Miranda; Gregory Joseph,22,0,50,28
1657019178376,CSE 8A,A50,083650,Miranda; Gregory Joseph,17,1,56,39
1657019184403,CSE 11,A01,083080,Cao; Yingjun,4,15,40,36
1657019190435,CSE 12,A01,083652,Krause-Levy; Sophia Louisa,21,1,120,99
1657019196468,CSE 15L,A01,083654,Morris; Justin Loren,8,0,50,42
1657019196468,CSE 15L,A02,083655,Morris; Justin Loren,9,0,50,41
1657019202494,CSE 20,A01,083657,Tran; Khoa Dang,37,0,80,43
1657019208539,CSE 21,A01,095574,Bach; Quang Tran,21,0,48,27
1657019214587,CSE 30,A01,083084,Eldon; John,4,0,80,76
1657019214587,CSE 30,B01,095061,Bhaskar; Nishant,6,0,50,44
1657019220631,CSE 100,A01,083659,Cao; Yingjun,3,4,70,67
1657019226668,CSE 134B,A01,083661,Powell; Thomas Allan,19,0,100,81
1657019232697,CSE 140,A01,083663,Gungor; Onat,14,0,85,71
1657019238724,CSE 140L,A01,083088,Eldon; John,16,0,100,84
1657019244749,CSE 175,A01,083665,Kumar; Rakesh,3,0,25,22
1657019250791,CSE 190,A00,092507,Dubnov; Shlomo,7,0,20,13
1657019256823,ECE 45,A01,083139,Congero; Spencer William,5,0,75,70
1657019262847,ECE 65,A50,083695,Saad; Andrew S,12,0,30,18
1657019262847,ECE 65,A51,095125,Saad; Andrew S,25,0,26,1
1657019268876,ECE 109,A01,091882,Touri; Behrouz,16,0,70,54
1657019274922,ECE 180,A00,083140,Abi Samra; Nicholas Camill,1,0,30,29
1657019274922,ECE 180,B00,083141,Abi Samra; Nicholas Camill,0,0,30,30
1657019280988,MATH 10A,A01,083735,Patchell; Gregory David,1,0,30,29
1657019280988,MATH 10A,A02,083736,Patchell; Gregory David,20,0,30,10
1657019280988,MATH 10A,A03,083737,Patchell; Gregory David,16,0,30,14
1657019287041,MATH 10B,A01,083207,Lim; Seonhee,7,0,34,27
1657019287041,MATH 10B,A02,083208,Lim; Seonhee,9,0,35,26
1657019287041,MATH 10B,A03,093472,Lim; Seonhee,4,0,34,30
1657019287041,MATH 10B,B01,083739,Sinha; Shubham,9,0,30,21
1657019293079,MATH 18,A01,083743,Cinel; Cameron Alexander,6,0,30,24
1657019293079,MATH 18,A02,083744,Cinel; Cameron Alexander,15,0,30,15
1657019293079,MATH 18,A03,083745,Cinel; Cameron Alexander,8,0,30,22
1657019293079,MATH 18,B01,083748,Rideout; David Porter,4,0,37,33
1657019293079,MATH 18,B02,083749,Rideout; David Porter,3,0,36,33
1657019293079,MATH 18,B03,083750,Rideout; David Porter,2,0,37,35
1657019293079,MATH 18,B04,083751,Rideout; David Porter,5,0,36,31
1657019293079,MATH 18,B05,093473,Rideout; David Porter,4,0,36,32
1657019293079,MATH 18,B06,093474,Rideout; David Porter,5,0,36,31
1657019299134,MATH 20A,A01,083754,Zheng; Zequn,12,0,40,28
1657019305166,MATH 20B,A01,083756,Briones; Jor-el Thomas Caparas,1,0,36,35
1657019305166,MATH 20B,A02,083757,Briones; Jor-el Thomas Caparas,1,0,36,35
1657019305166,MATH 20B,A03,093475,Briones; Jor-el Thomas Caparas,0,0,36,36
1657019311207,MATH 20C,A01,083760,Briones; Jor-el Thomas Caparas,1,0,35,34
1657019311207,MATH 20C,A02,083761,Briones; Jor-el Thomas Caparas,8,0,35,27
1657019311207,MATH 20C,A03,093476,Briones; Jor-el Thomas Caparas,0,1,36,36
1657019311207,MATH 20C,B01,083762,Bach; Quang Tran,0,0,30,30
1657019317238,MATH 20D,A01,083765,Tran; Brian Kha,4,0,30,26
1657019317238,MATH 20D,A02,083766,Tran; Brian Kha,5,0,30,25
1657019317238,MATH 20D,A03,083767,Tran; Brian Kha,3,0,30,27
1657019323263,MATH 20E,A01,083771,Ganguly; Soumya,5,0,32,27
1657019323263,MATH 20E,A02,083772,Ganguly; Soumya,6,0,32,26
1657019323263,MATH 20E,B01,083773,Ciotti; Benjamin,18,0,35,17
1657019323263,MATH 20E,B02,083774,Ciotti; Benjamin,17,0,35,18
1657019329306,MATH 103A,A01,083777,Greenfeld; Be'Eri,2,0,36,34
1657019329306,MATH 103A,A02,083778,Greenfeld; Be'Eri,5,0,36,31
1657019329306,MATH 103A,A03,093561,Greenfeld; Be'Eri,4,0,36,32
1657019329306,MATH 103A,B01,083779,Greenfeld; Be'Eri,6,0,36,30
1657019329306,MATH 103A,B02,083780,Greenfeld; Be'Eri,2,0,36,34
1657019329306,MATH 103A,B03,093562,Greenfeld; Be'Eri,2,0,36,34
1657019335331,MATH 105,A01,085443,Carter; Anne Toulson,14,0,35,21
1657019335331,MATH 105,A02,093477,Carter; Anne Toulson,20,0,35,15
1657019341356,MATH 109,A01,083213,Ganzberger; Geoffrey Michael,2,0,34,32
1657019341356,MATH 109,A02,083214,Ganzberger; Geoffrey Michael,2,0,34,32
1657019341356,MATH 109,A03,093478,Ganzberger; Geoffrey Michael,1,0,34,33
1657019341356,MATH 109,B01,083215,Ganzberger; Geoffrey Michael,1,0,32,31
1657019341356,MATH 109,B02,083216,Ganzberger; Geoffrey Michael,1,0,32,31
1657019341356,MATH 109,B03,093479,Ganzberger; Geoffrey Michael,6,0,32,26
1657019347394,MATH 142A,A01,083219,Chow; Bennett,6,0,32,26
1657019347394,MATH 142A,A02,083220,Chow; Bennett,10,0,32,22
1657019347394,MATH 142A,A03,093480,Chow; Bennett,7,0,32,25
1657019347394,MATH 142A,B03,093481,Chow; Bennett,7,0,32,25
1657019347394,MATH 142A,B04,093558,Chow; Bennett,11,0,32,21
1657019347394,MATH 142A,B05,093559,Chow; Bennett,6,0,32,26
1657019353427,MATH 193A,A01,083224,Rotar; Vladimir,7,0,34,27
1657019353427,MATH 193A,A02,083225,Rotar; Vladimir,4,0,34,30
1657019353427,MATH 193A,A03,083781,Rotar; Vladimir,1,0,34,33
1657019353427,MATH 193A,A04,083782,Rotar; Vladimir,6,0,34,28
1657019353427,MATH 193A,A05,093482,Rotar; Vladimir,6,0,34,28
1657019359474,MATH 197,001,091859,McAuley; Julian John,9999,0,9999,0
1657019359474,MATH 197,002,095566,Kedlaya; Kiran S.,9997,0,9999,2
1657019359474,MATH 197,003,095567,Xiao; Ming,9999,0,9999,0
1657019359474,MATH 197,004,095571,Perols; Johan Lars,9998,0,9999,1
1657019379864,COGS 9,A01,083615,Shannon; Kyle Michael,7,0,75,68
1657019385890,COGS 11,A01,083617,Boyle; Mary E. T.,20,0,48,28
1657019393250,COGS 13,A01,083071,Bastos; Amalia Pinkusfeld,9,0,71,62
1657019399292,COGS 14A,A01,092681,Semenuks; Arturs,0,1,100,100
1657019405341,COGS 14B,A01,083073,Cheng; Tzu-Han,5,0,63,58
1657019411371,COGS 17,A01,092677,Semenuks; Arturs,4,0,81,77
1657019417405,COGS 100,A01,083619,Allen; Michael Gordon,15,0,70,55
1657019423436,COGS 101A,A01,083621,Davis; Joshua Daniel,9,0,68,59
1657019429462,COGS 101B,A01,091572,Allen; Michael Gordon,8,0,65,57
1657019435491,COGS 101C,A01,083625,Delgado; Tania,17,0,35,18
1657019441517,COGS 107A,A01,083627,Boyle; Mary E. T.,13,0,60,47
1657019447544,COGS 118A,A01,083075,Gupta; Anjum,15,0,76,61
1657019453590,CSE 3,A50,083646,Miranda; Gregory Joseph,22,0,50,28
1657019459618,CSE 8A,A50,083650,Miranda; Gregory Joseph,17,1,56,39
1657019465656,CSE 11,A01,083080,Cao; Yingjun,4,15,40,36
1657019471690,CSE 12,A01,083652,Krause-Levy; Sophia Louisa,21,1,120,99
1657019477719,CSE 15L,A01,083654,Morris; Justin Loren,8,0,50,42
1657019477719,CSE 15L,A02,083655,Morris; Justin Loren,9,0,50,41
1657019483743,CSE 20,A01,083657,Tran; Khoa Dang,37,0,80,43
1657019489776,CSE 21,A01,095574,Bach; Quang Tran,21,0,48,27
1657019495803,CSE 30,A01,083084,Eldon; John,4,0,80,76
1657019495803,CSE 30,B01,095061,Bhaskar; Nishant,6,0,50,44
1657019501831,CSE 100,A01,083659,Cao; Yingjun,3,4,70,67
1657019507891,CSE 134B,A01,083661,Powell; Thomas Allan,19,0,100,81
1657019513916,CSE 140,A01,083663,Gungor; Onat,14,0,85,71
1657019519947,CSE 140L,A01,083088,Eldon; John,16,0,100,84
1657019525978,CSE 175,A01,083665,Kumar; Rakesh,3,0,25,22
1657019532008,CSE 190,A00,092507,Dubnov; Shlomo,7,0,20,13
1657019538033,ECE 45,A01,083139,Congero; Spencer William,5,0,75,70
1657019544074,ECE 65,A50,083695,Saad; Andrew S,12,0,30,18
1657019544074,ECE 65,A51,095125,Saad; Andrew S,25,0,26,1
1657019550110,ECE 109,A01,091882,Touri; Behrouz,16,0,70,54
1657019556142,ECE 180,A00,083140,Abi Samra; Nicholas Camill,1,0,30,29
1657019556142,ECE 180,B00,083141,Abi Samra; Nicholas Camill,0,0,30,30
1657019562169,MATH 10A,A01,083735,Patchell; Gregory David,1,0,30,29
1657019562169,MATH 10A,A02,083736,Patchell; Gregory David,20,0,30,10
1657019562169,MATH 10A,A03,083737,Patchell; Gregory David,16,0,30,14
1657019568202,MATH 10B,A01,083207,Lim; Seonhee,7,0,34,27
1657019568202,MATH 10B,A02,083208,Lim; Seonhee,9,0,35,26
1657019568202,MATH 10B,A03,093472,Lim; Seonhee,4,0,34,30
1657019568202,MATH 10B,B01,083739,Sinha; Shubham,9,0,30,21
1657019574231,MATH 18,A01,083743,Cinel; Cameron Alexander,6,0,30,24
1657019574231,MATH 18,A02,083744,Cinel; Cameron Alexander,15,0,30,15
1657019574231,MATH 18,A03,083745,Cinel; Cameron Alexander,8,0,30,22
1657019574231,MATH 18,B01,083748,Rideout; David Porter,4,0,37,33
1657019574231,MATH 18,B02,083749,Rideout; David Porter,3,0,36,33
1657019574231,MATH 18,B03,083750,Rideout; David Porter,2,0,37,35
1657019574231,MATH 18,B04,083751,Rideout; David Porter,5,0,36,31
1657019574231,MATH 18,B05,093473,Rideout; David Porter,4,0,36,32
1657019574231,MATH 18,B06,093474,Rideout; David Porter,5,0,36,31
1657019580282,MATH 20A,A01,083754,Zheng; Zequn,12,0,40,28
1657019586307,MATH 20B,A01,083756,Briones; Jor-el Thomas Caparas,1,0,36,35
1657019586307,MATH 20B,A02,083757,Briones; Jor-el Thomas Caparas,1,0,36,35
1657019586307,MATH 20B,A03,093475,Briones; Jor-el Thomas Caparas,0,0,36,36
1657019594176,MATH 20C,A01,083760,Briones; Jor-el Thomas Caparas,1,0,35,34
1657019594176,MATH 20C,A02,083761,Briones; Jor-el Thomas Caparas,8,0,35,27
1657019594176,MATH 20C,A03,093476,Briones; Jor-el Thomas Caparas,0,1,36,36
1657019594176,MATH 20C,B01,083762,Bach; Quang Tran,0,0,30,30
1657019600208,MATH 20D,A01,083765,Tran; Brian Kha,4,0,30,26
1657019600208,MATH 20D,A02,083766,Tran; Brian Kha,5,0,30,25
1657019600208,MATH 20D,A03,083767,Tran; Brian Kha,3,0,30,27
1657019606237,MATH 20E,A01,083771,Ganguly; Soumya,5,0,32,27
1657019606237,MATH 20E,A02,083772,Ganguly; Soumya,6,0,32,26
1657019606237,MATH 20E,B01,083773,Ciotti; Benjamin,18,0,35,17
1657019606237,MATH 20E,B02,083774,Ciotti; Benjamin,17,0,35,18
