time,subj_course_id,sec_code,sec_id,prof,available,waitlist,total,enrolled_ct
1657365158030,COGS 9,A01,083615,Shannon; Kyle Michael,8,0,75,67
1657365164064,COGS 11,A01,083617,Boyle; Mary E. T.,22,0,48,26
1657365170104,COGS 13,A01,083071,Bastos; Amalia Pinkusfeld,11,0,71,60
1657365176135,COGS 14A,A01,092681,Semenuks; Arturs,4,1,100,96
1657365182178,COGS 14B,A01,083073,Cheng; Tzu-Han,6,0,63,57
1657365188207,COGS 17,A01,092677,Semenuks; Arturs,6,0,81,75
1657365194242,COGS 100,A01,083619,Allen; Michael Gordon,17,0,70,53
1657365200284,COGS 101A,A01,083621,Davis; Joshua Daniel,9,0,68,59
1657365206313,COGS 101B,A01,091572,Allen; Michael Gordon,11,0,65,54
1657365212350,COGS 101C,A01,083625,Delgado; Tania,17,0,35,18
1657365218388,COGS 107A,A01,083627,Boyle; Mary E. T.,13,0,60,47
1657365224417,COGS 118A,A01,083075,Gupta; Anjum,20,0,76,56
1657365230452,CSE 3,A50,083646,Miranda; Gregory Joseph,24,0,50,26
1657365236485,CSE 8A,A50,083650,Miranda; Gregory Joseph,17,1,56,39
1657365242517,CSE 11,A01,083080,Cao; Yingjun,6,15,40,34
1657365248548,CSE 12,A01,083652,Krause-Levy; Sophia Louisa,28,1,120,92
1657365254586,CSE 15L,A01,083654,Morris; Justin Loren,9,0,50,41
1657365254586,CSE 15L,A02,083655,Morris; Justin Loren,9,0,50,41
1657365260623,CSE 20,A01,083657,Tran; Khoa Dang,39,0,80,41
1657365266650,CSE 21,A01,095574,Bach; Quang Tran,22,0,48,26
1657365272684,CSE 30,A01,083084,Eldon; John,4,0,80,76
1657365272684,CSE 30,B01,095061,Bhaskar; Nishant,9,0,50,41
1657365278715,CSE 100,A01,083659,Cao; Yingjun,5,4,70,65
1657365284746,CSE 134B,A01,083661,Powell; Thomas Allan,22,0,100,78
1657365290778,CSE 140,A01,083663,Gungor; Onat,14,0,85,71
1657365296809,CSE 140L,A01,083088,Eldon; John,21,0,100,79
1657365302845,CSE 175,A01,083665,Kumar; Rakesh,3,0,25,22
1657365308874,CSE 190,A00,092507,Dubnov; Shlomo,7,0,20,13
1657365314916,ECE 45,A01,083139,Congero; Spencer William,6,0,75,69
1657365320948,ECE 65,A50,083695,Saad; Andrew S,12,0,30,18
1657365320948,ECE 65,A51,095125,Saad; Andrew S,24,0,26,2
1657365326977,ECE 109,A01,091882,Touri; Behrouz,19,0,70,51
1657365333012,ECE 180,A00,083140,Abi Samra; Nicholas Camill,1,0,30,29
1657365333012,ECE 180,B00,083141,Abi Samra; Nicholas Camill,0,0,30,30
1657365339048,MATH 10A,A01,083735,Patchell; Gregory David,2,0,30,28
1657365339048,MATH 10A,A02,083736,Patchell; Gregory David,20,0,30,10
1657365339048,MATH 10A,A03,083737,Patchell; Gregory David,16,0,30,14
1657365345081,MATH 10B,A01,083207,Lim; Seonhee,8,0,34,26
1657365345081,MATH 10B,A02,083208,Lim; Seonhee,9,0,35,26
1657365345081,MATH 10B,A03,093472,Lim; Seonhee,7,0,34,27
1657365345081,MATH 10B,B01,083739,Sinha; Shubham,12,0,30,18
1657365351120,MATH 18,A01,083743,Cinel; Cameron Alexander,7,0,30,23
1657365351120,MATH 18,A02,083744,Cinel; Cameron Alexander,17,0,30,13
1657365351120,MATH 18,A03,083745,Cinel; Cameron Alexander,9,0,30,21
1657365351120,MATH 18,B01,083748,Rideout; David Porter,5,0,37,32
1657365351120,MATH 18,B02,083749,Rideout; David Porter,5,0,36,31
1657365351120,MATH 18,B03,083750,Rideout; David Porter,3,0,37,34
1657365351120,MATH 18,B04,083751,Rideout; David Porter,6,0,36,30
1657365351120,MATH 18,B05,093473,Rideout; David Porter,6,0,36,30
1657365351120,MATH 18,B06,093474,Rideout; David Porter,6,0,36,30
1657365357160,MATH 20A,A01,083754,Zheng; Zequn,14,0,40,26
1657365363200,MATH 20B,A01,083756,Briones; Jor-el Thomas Caparas,4,0,36,32
1657365363200,MATH 20B,A02,083757,Briones; Jor-el Thomas Caparas,1,0,36,35
1657365363200,MATH 20B,A03,093475,Briones; Jor-el Thomas Caparas,2,0,36,34
1657365369322,MATH 20C,A01,083760,Briones; Jor-el Thomas Caparas,1,0,35,34
1657365369322,MATH 20C,A02,083761,Briones; Jor-el Thomas Caparas,8,0,35,27
1657365369322,MATH 20C,A03,093476,Briones; Jor-el Thomas Caparas,0,1,36,36
1657365369322,MATH 20C,B01,083762,Bach; Quang Tran,1,0,30,29
1657365379623,MATH 20D,A01,083765,Tran; Brian Kha,5,0,30,25
1657365379623,MATH 20D,A02,083766,Tran; Brian Kha,5,0,30,25
1657365379623,MATH 20D,A03,083767,Tran; Brian Kha,5,0,30,25
1657365385675,MATH 20E,A01,083771,Ganguly; Soumya,9,0,32,23
1657365385675,MATH 20E,A02,083772,Ganguly; Soumya,6,0,32,26
1657365385675,MATH 20E,B01,083773,Ciotti; Benjamin,20,0,35,15
1657365385675,MATH 20E,B02,083774,Ciotti; Benjamin,17,0,35,18
1657365399721,MATH 103A,A01,083777,Greenfeld; Be'Eri,3,0,36,33
1657365399721,MATH 103A,A02,083778,Greenfeld; Be'Eri,5,0,36,31
1657365399721,MATH 103A,A03,093561,Greenfeld; Be'Eri,5,0,36,31
1657365399721,MATH 103A,B01,083779,Greenfeld; Be'Eri,7,0,36,29
1657365399721,MATH 103A,B02,083780,Greenfeld; Be'Eri,4,0,36,32
1657365399721,MATH 103A,B03,093562,Greenfeld; Be'Eri,3,0,36,33
1657365405764,MATH 105,A01,085443,Carter; Anne Toulson,15,0,35,20
1657365405764,MATH 105,A02,093477,Carter; Anne Toulson,20,0,35,15
1657365419491,MATH 109,A01,083213,Ganzberger; Geoffrey Michael,2,0,34,32
1657365419491,MATH 109,A02,083214,Ganzberger; Geoffrey Michael,4,0,34,30
1657365419491,MATH 109,A03,093478,Ganzberger; Geoffrey Michael,2,0,34,32
1657365419491,MATH 109,B01,083215,Ganzberger; Geoffrey Michael,1,0,32,31
1657365419491,MATH 109,B02,083216,Ganzberger; Geoffrey Michael,2,0,32,30
1657365419491,MATH 109,B03,093479,Ganzberger; Geoffrey Michael,8,0,32,24
1657365425525,MATH 142A,A01,083219,Chow; Bennett,7,0,32,25
1657365425525,MATH 142A,A02,083220,Chow; Bennett,10,0,32,22
1657365425525,MATH 142A,A03,093480,Chow; Bennett,8,0,32,24
1657365425525,MATH 142A,B03,093481,Chow; Bennett,8,0,32,24
1657365425525,MATH 142A,B04,093558,Chow; Bennett,13,0,32,19
1657365425525,MATH 142A,B05,093559,Chow; Bennett,6,0,32,26
1657365439304,MATH 193A,A01,083224,Rotar; Vladimir,8,0,34,26
1657365439304,MATH 193A,A02,083225,Rotar; Vladimir,9,0,34,25
1657365439304,MATH 193A,A03,083781,Rotar; Vladimir,5,0,34,29
1657365439304,MATH 193A,A04,083782,Rotar; Vladimir,10,0,34,24
1657365439304,MATH 193A,A05,093482,Rotar; Vladimir,10,0,34,24
1657365445343,MATH 197,001,091859,McAuley; Julian John,9999,0,9999,0
1657365445343,MATH 197,002,095566,Kedlaya; Kiran S.,9997,0,9999,2
1657365445343,MATH 197,003,095567,Xiao; Ming,9999,0,9999,0
1657365445343,MATH 197,004,095571,Perols; Johan Lars,9998,0,9999,1
1657365460261,COGS 9,A01,083615,Shannon; Kyle Michael,8,0,75,67
1657365466293,COGS 11,A01,083617,Boyle; Mary E. T.,22,0,48,26
1657365479031,COGS 13,A01,083071,Bastos; Amalia Pinkusfeld,11,0,71,60
1657365485069,COGS 14A,A01,092681,Semenuks; Arturs,4,1,100,96
1657365492598,COGS 14B,A01,083073,Cheng; Tzu-Han,6,0,63,57
1657365498626,COGS 17,A01,092677,Semenuks; Arturs,6,0,81,75
1657365504664,COGS 100,A01,083619,Allen; Michael Gordon,17,0,70,53
1657365510699,COGS 101A,A01,083621,Davis; Joshua Daniel,9,0,68,59
1657365516738,COGS 101B,A01,091572,Allen; Michael Gordon,11,0,65,54
1657365522772,COGS 101C,A01,083625,Delgado; Tania,17,0,35,18
1657365528801,COGS 107A,A01,083627,Boyle; Mary E. T.,13,0,60,47
1657365534837,COGS 118A,A01,083075,Gupta; Anjum,20,0,76,56
1657365540880,CSE 3,A50,083646,Miranda; Gregory Joseph,24,0,50,26
1657365546916,CSE 8A,A50,083650,Miranda; Gregory Joseph,17,1,56,39
1657365552945,CSE 11,A01,083080,Cao; Yingjun,6,15,40,34
1657365558982,CSE 12,A01,083652,Krause-Levy; Sophia Louisa,28,1,120,92
1657365565013,CSE 15L,A01,083654,Morris; Justin Loren,9,0,50,41
1657365565013,CSE 15L,A02,083655,Morris; Justin Loren,9,0,50,41
1657365571049,CSE 20,A01,083657,Tran; Khoa Dang,39,0,80,41
1657365577082,CSE 21,A01,095574,Bach; Quang Tran,22,0,48,26
1657365583127,CSE 30,A01,083084,Eldon; John,4,0,80,76
1657365583127,CSE 30,B01,095061,Bhaskar; Nishant,9,0,50,41
1657365589163,CSE 100,A01,083659,Cao; Yingjun,5,4,70,65
1657365595201,CSE 134B,A01,083661,Powell; Thomas Allan,22,0,100,78
1657365601238,CSE 140,A01,083663,Gungor; Onat,14,0,85,71
1657365607266,CSE 140L,A01,083088,Eldon; John,21,0,100,79
1657365613308,CSE 175,A01,083665,Kumar; Rakesh,3,0,25,22
1657365619346,CSE 190,A00,092507,Dubnov; Shlomo,7,0,20,13
1657365625385,ECE 45,A01,083139,Congero; Spencer William,6,0,75,69
1657365631418,ECE 65,A50,083695,Saad; Andrew S,12,0,30,18
1657365631418,ECE 65,A51,095125,Saad; Andrew S,24,0,26,2
1657365637459,ECE 109,A01,091882,Touri; Behrouz,19,0,70,51
1657365643494,ECE 180,A00,083140,Abi Samra; Nicholas Camill,1,0,30,29
1657365643494,ECE 180,B00,083141,Abi Samra; Nicholas Camill,0,0,30,30
1657365649532,MATH 10A,A01,083735,Patchell; Gregory David,2,0,30,28
1657365649532,MATH 10A,A02,083736,Patchell; Gregory David,20,0,30,10
1657365649532,MATH 10A,A03,083737,Patchell; Gregory David,16,0,30,14
1657365655583,MATH 10B,A01,083207,Lim; Seonhee,8,0,34,26
1657365655583,MATH 10B,A02,083208,Lim; Seonhee,9,0,35,26
1657365655583,MATH 10B,A03,093472,Lim; Seonhee,7,0,34,27
1657365655583,MATH 10B,B01,083739,Sinha; Shubham,12,0,30,18
1657365661625,MATH 18,A01,083743,Cinel; Cameron Alexander,7,0,30,23
1657365661625,MATH 18,A02,083744,Cinel; Cameron Alexander,17,0,30,13
1657365661625,MATH 18,A03,083745,Cinel; Cameron Alexander,9,0,30,21
1657365661625,MATH 18,B01,083748,Rideout; David Porter,5,0,37,32
1657365661625,MATH 18,B02,083749,Rideout; David Porter,5,0,36,31
1657365661625,MATH 18,B03,083750,Rideout; David Porter,3,0,37,34
1657365661625,MATH 18,B04,083751,Rideout; David Porter,6,0,36,30
1657365661625,MATH 18,B05,093473,Rideout; David Porter,6,0,36,30
1657365661625,MATH 18,B06,093474,Rideout; David Porter,6,0,36,30
1657365667654,MATH 20A,A01,083754,Zheng; Zequn,14,0,40,26
1657365673693,MATH 20B,A01,083756,Briones; Jor-el Thomas Caparas,4,0,36,32
1657365673693,MATH 20B,A02,083757,Briones; Jor-el Thomas Caparas,1,0,36,35
1657365673693,MATH 20B,A03,093475,Briones; Jor-el Thomas Caparas,2,0,36,34
1657365679728,MATH 20C,A01,083760,Briones; Jor-el Thomas Caparas,1,0,35,34
1657365679728,MATH 20C,A02,083761,Briones; Jor-el Thomas Caparas,8,0,35,27
1657365679728,MATH 20C,A03,093476,Briones; Jor-el Thomas Caparas,0,1,36,36
1657365679728,MATH 20C,B01,083762,Bach; Quang Tran,1,0,30,29
1657365685763,MATH 20D,A01,083765,Tran; Brian Kha,5,0,30,25
1657365685763,MATH 20D,A02,083766,Tran; Brian Kha,5,0,30,25
1657365685763,MATH 20D,A03,083767,Tran; Brian Kha,5,0,30,25
1657365691795,MATH 20E,A01,083771,Ganguly; Soumya,9,0,32,23
1657365691795,MATH 20E,A02,083772,Ganguly; Soumya,6,0,32,26
1657365691795,MATH 20E,B01,083773,Ciotti; Benjamin,20,0,35,15
1657365691795,MATH 20E,B02,083774,Ciotti; Benjamin,17,0,35,18
1657365697832,MATH 103A,A01,083777,Greenfeld; Be'Eri,3,0,36,33
1657365697832,MATH 103A,A02,083778,Greenfeld; Be'Eri,5,0,36,31
1657365697832,MATH 103A,A03,093561,Greenfeld; Be'Eri,5,0,36,31
1657365697832,MATH 103A,B01,083779,Greenfeld; Be'Eri,7,0,36,29
1657365697832,MATH 103A,B02,083780,Greenfeld; Be'Eri,4,0,36,32
1657365697832,MATH 103A,B03,093562,Greenfeld; Be'Eri,3,0,36,33
1657365703861,MATH 105,A01,085443,Carter; Anne Toulson,15,0,35,20
1657365703861,MATH 105,A02,093477,Carter; Anne Toulson,20,0,35,15
1657365709894,MATH 109,A01,083213,Ganzberger; Geoffrey Michael,2,0,34,32
1657365709894,MATH 109,A02,083214,Ganzberger; Geoffrey Michael,4,0,34,30
1657365709894,MATH 109,A03,093478,Ganzberger; Geoffrey Michael,2,0,34,32
1657365709894,MATH 109,B01,083215,Ganzberger; Geoffrey Michael,1,0,32,31
1657365709894,MATH 109,B02,083216,Ganzberger; Geoffrey Michael,2,0,32,30
1657365709894,MATH 109,B03,093479,Ganzberger; Geoffrey Michael,8,0,32,24
1657365715933,MATH 142A,A01,083219,Chow; Bennett,7,0,32,25
1657365715933,MATH 142A,A02,083220,Chow; Bennett,10,0,32,22
1657365715933,MATH 142A,A03,093480,Chow; Bennett,8,0,32,24
1657365715933,MATH 142A,B03,093481,Chow; Bennett,8,0,32,24
1657365715933,MATH 142A,B04,093558,Chow; Bennett,13,0,32,19
1657365715933,MATH 142A,B05,093559,Chow; Bennett,6,0,32,26
1657365721969,MATH 193A,A01,083224,Rotar; Vladimir,8,0,34,26
1657365721969,MATH 193A,A02,083225,Rotar; Vladimir,9,0,34,25
1657365721969,MATH 193A,A03,083781,Rotar; Vladimir,5,0,34,29
1657365721969,MATH 193A,A04,083782,Rotar; Vladimir,10,0,34,24
1657365721969,MATH 193A,A05,093482,Rotar; Vladimir,10,0,34,24
1657365728002,MATH 197,001,091859,McAuley; Julian John,9999,0,9999,0
1657365728002,MATH 197,002,095566,Kedlaya; Kiran S.,9997,0,9999,2
1657365728002,MATH 197,003,095567,Xiao; Ming,9999,0,9999,0
1657365728002,MATH 197,004,095571,Perols; Johan Lars,9998,0,9999,1
1657365735095,COGS 9,A01,083615,Shannon; Kyle Michael,8,0,75,67
1657365741127,COGS 11,A01,083617,Boyle; Mary E. T.,22,0,48,26
1657365747158,COGS 13,A01,083071,Bastos; Amalia Pinkusfeld,11,0,71,60
1657365753190,COGS 14A,A01,092681,Semenuks; Arturs,4,1,100,96
1657365759217,COGS 14B,A01,083073,Cheng; Tzu-Han,6,0,63,57
1657365765247,COGS 17,A01,092677,Semenuks; Arturs,6,0,81,75
1657365771284,COGS 100,A01,083619,Allen; Michael Gordon,17,0,70,53
1657365777413,COGS 101A,A01,083621,Davis; Joshua Daniel,9,0,68,59
1657365783453,COGS 101B,A01,091572,Allen; Michael Gordon,11,0,65,54
1657365789483,COGS 101C,A01,083625,Delgado; Tania,17,0,35,18
1657365795512,COGS 107A,A01,083627,Boyle; Mary E. T.,13,0,60,47
1657365801539,COGS 118A,A01,083075,Gupta; Anjum,20,0,76,56
1657365807572,CSE 3,A50,083646,Miranda; Gregory Joseph,24,0,50,26
1657365813607,CSE 8A,A50,083650,Miranda; Gregory Joseph,17,1,56,39
1657365819634,CSE 11,A01,083080,Cao; Yingjun,6,15,40,34
1657365825670,CSE 12,A01,083652,Krause-Levy; Sophia Louisa,28,1,120,92
1657365831698,CSE 15L,A01,083654,Morris; Justin Loren,9,0,50,41
1657365831698,CSE 15L,A02,083655,Morris; Justin Loren,9,0,50,41
1657365837728,CSE 20,A01,083657,Tran; Khoa Dang,39,0,80,41
1657365843766,CSE 21,A01,095574,Bach; Quang Tran,22,0,48,26
1657365856431,CSE 30,A01,083084,Eldon; John,4,0,80,76
1657365856431,CSE 30,B01,095061,Bhaskar; Nishant,9,0,50,41
1657365862459,CSE 100,A01,083659,Cao; Yingjun,5,4,70,65
1657365871660,CSE 134B,A01,083661,Powell; Thomas Allan,22,0,100,78
1657365877695,CSE 140,A01,083663,Gungor; Onat,14,0,85,71
1657365883722,CSE 140L,A01,083088,Eldon; John,21,0,100,79
1657365889754,CSE 175,A01,083665,Kumar; Rakesh,3,0,25,22
1657365895783,CSE 190,A00,092507,Dubnov; Shlomo,7,0,20,13
1657365901815,ECE 45,A01,083139,Congero; Spencer William,6,0,75,69
1657365907845,ECE 65,A50,083695,Saad; Andrew S,12,0,30,18
1657365907845,ECE 65,A51,095125,Saad; Andrew S,24,0,26,2
1657365913878,ECE 109,A01,091882,Touri; Behrouz,19,0,70,51
1657365919913,ECE 180,A00,083140,Abi Samra; Nicholas Camill,1,0,30,29
1657365919913,ECE 180,B00,083141,Abi Samra; Nicholas Camill,0,0,30,30
1657365925942,MATH 10A,A01,083735,Patchell; Gregory David,2,0,30,28
1657365925942,MATH 10A,A02,083736,Patchell; Gregory David,20,0,30,10
1657365925942,MATH 10A,A03,083737,Patchell; Gregory David,16,0,30,14
1657365931974,MATH 10B,A01,083207,Lim; Seonhee,8,0,34,26
1657365931974,MATH 10B,A02,083208,Lim; Seonhee,9,0,35,26
1657365931974,MATH 10B,A03,093472,Lim; Seonhee,7,0,34,27
1657365931974,MATH 10B,B01,083739,Sinha; Shubham,12,0,30,18
1657365938027,MATH 18,A01,083743,Cinel; Cameron Alexander,7,0,30,23
1657365938027,MATH 18,A02,083744,Cinel; Cameron Alexander,17,0,30,13
1657365938027,MATH 18,A03,083745,Cinel; Cameron Alexander,9,0,30,21
1657365938027,MATH 18,B01,083748,Rideout; David Porter,5,0,37,32
1657365938027,MATH 18,B02,083749,Rideout; David Porter,5,0,36,31
1657365938027,MATH 18,B03,083750,Rideout; David Porter,3,0,37,34
1657365938027,MATH 18,B04,083751,Rideout; David Porter,6,0,36,30
1657365938027,MATH 18,B05,093473,Rideout; David Porter,6,0,36,30
1657365938027,MATH 18,B06,093474,Rideout; David Porter,6,0,36,30
1657365944058,MATH 20A,A01,083754,Zheng; Zequn,14,0,40,26
1657365950087,MATH 20B,A01,083756,Briones; Jor-el Thomas Caparas,4,0,36,32
1657365950087,MATH 20B,A02,083757,Briones; Jor-el Thomas Caparas,1,0,36,35
1657365950087,MATH 20B,A03,093475,Briones; Jor-el Thomas Caparas,2,0,36,34
1657365956123,MATH 20C,A01,083760,Briones; Jor-el Thomas Caparas,1,0,35,34
1657365956123,MATH 20C,A02,083761,Briones; Jor-el Thomas Caparas,8,0,35,27
1657365956123,MATH 20C,A03,093476,Briones; Jor-el Thomas Caparas,0,1,36,36
1657365956123,MATH 20C,B01,083762,Bach; Quang Tran,1,0,30,29
1657365962152,MATH 20D,A01,083765,Tran; Brian Kha,5,0,30,25
1657365962152,MATH 20D,A02,083766,Tran; Brian Kha,5,0,30,25
1657365962152,MATH 20D,A03,083767,Tran; Brian Kha,5,0,30,25
1657365968194,MATH 20E,A01,083771,Ganguly; Soumya,9,0,32,23
1657365968194,MATH 20E,A02,083772,Ganguly; Soumya,6,0,32,26
1657365968194,MATH 20E,B01,083773,Ciotti; Benjamin,20,0,35,15
1657365968194,MATH 20E,B02,083774,Ciotti; Benjamin,17,0,35,18
1657365974235,MATH 103A,A01,083777,Greenfeld; Be'Eri,3,0,36,33
1657365974235,MATH 103A,A02,083778,Greenfeld; Be'Eri,5,0,36,31
1657365974235,MATH 103A,A03,093561,Greenfeld; Be'Eri,5,0,36,31
1657365974235,MATH 103A,B01,083779,Greenfeld; Be'Eri,7,0,36,29
1657365974235,MATH 103A,B02,083780,Greenfeld; Be'Eri,4,0,36,32
1657365974235,MATH 103A,B03,093562,Greenfeld; Be'Eri,3,0,36,33
1657365980269,MATH 105,A01,085443,Carter; Anne Toulson,15,0,35,20
1657365980269,MATH 105,A02,093477,Carter; Anne Toulson,20,0,35,15
1657365986302,MATH 109,A01,083213,Ganzberger; Geoffrey Michael,2,0,34,32
1657365986302,MATH 109,A02,083214,Ganzberger; Geoffrey Michael,4,0,34,30
1657365986302,MATH 109,A03,093478,Ganzberger; Geoffrey Michael,2,0,34,32
1657365986302,MATH 109,B01,083215,Ganzberger; Geoffrey Michael,1,0,32,31
1657365986302,MATH 109,B02,083216,Ganzberger; Geoffrey Michael,2,0,32,30
1657365986302,MATH 109,B03,093479,Ganzberger; Geoffrey Michael,8,0,32,24
1657365992334,MATH 142A,A01,083219,Chow; Bennett,7,0,32,25
1657365992334,MATH 142A,A02,083220,Chow; Bennett,10,0,32,22
1657365992334,MATH 142A,A03,093480,Chow; Bennett,8,0,32,24
1657365992334,MATH 142A,B03,093481,Chow; Bennett,8,0,32,24
1657365992334,MATH 142A,B04,093558,Chow; Bennett,13,0,32,19
1657365992334,MATH 142A,B05,093559,Chow; Bennett,6,0,32,26
1657365998369,MATH 193A,A01,083224,Rotar; Vladimir,8,0,34,26
1657365998369,MATH 193A,A02,083225,Rotar; Vladimir,9,0,34,25
1657365998369,MATH 193A,A03,083781,Rotar; Vladimir,5,0,34,29
1657365998369,MATH 193A,A04,083782,Rotar; Vladimir,10,0,34,24
1657365998369,MATH 193A,A05,093482,Rotar; Vladimir,10,0,34,24
1657366004399,MATH 197,001,091859,McAuley; Julian John,9999,0,9999,0
1657366004399,MATH 197,002,095566,Kedlaya; Kiran S.,9997,0,9999,2
1657366004399,MATH 197,003,095567,Xiao; Ming,9999,0,9999,0
1657366004399,MATH 197,004,095571,Perols; Johan Lars,9998,0,9999,1
1657366011491,COGS 9,A01,083615,Shannon; Kyle Michael,8,0,75,67
1657366017517,COGS 11,A01,083617,Boyle; Mary E. T.,22,0,48,26
1657366023555,COGS 13,A01,083071,Bastos; Amalia Pinkusfeld,11,0,71,60
1657366029582,COGS 14A,A01,092681,Semenuks; Arturs,4,1,100,96
1657366035612,COGS 14B,A01,083073,Cheng; Tzu-Han,6,0,63,57
1657366041645,COGS 17,A01,092677,Semenuks; Arturs,6,0,81,75
1657366047678,COGS 100,A01,083619,Allen; Michael Gordon,17,0,70,53
1657366053706,COGS 101A,A01,083621,Davis; Joshua Daniel,9,0,68,59
1657366059734,COGS 101B,A01,091572,Allen; Michael Gordon,11,0,65,54
1657366065766,COGS 101C,A01,083625,Delgado; Tania,17,0,35,18
1657366071794,COGS 107A,A01,083627,Boyle; Mary E. T.,13,0,60,47
1657366077826,COGS 118A,A01,083075,Gupta; Anjum,20,0,76,56
1657366083856,CSE 3,A50,083646,Miranda; Gregory Joseph,24,0,50,26
1657366089882,CSE 8A,A50,083650,Miranda; Gregory Joseph,17,1,56,39
1657366095914,CSE 11,A01,083080,Cao; Yingjun,6,15,40,34
1657366101941,CSE 12,A01,083652,Krause-Levy; Sophia Louisa,28,1,120,92
1657366107969,CSE 15L,A01,083654,Morris; Justin Loren,9,0,50,41
1657366107969,CSE 15L,A02,083655,Morris; Justin Loren,9,0,50,41
1657366113998,CSE 20,A01,083657,Tran; Khoa Dang,39,0,80,41
1657366120030,CSE 21,A01,095574,Bach; Quang Tran,22,0,48,26
1657366126061,CSE 30,A01,083084,Eldon; John,4,0,80,76
1657366126061,CSE 30,B01,095061,Bhaskar; Nishant,9,0,50,41
1657366132090,CSE 100,A01,083659,Cao; Yingjun,5,4,70,65
1657366138115,CSE 134B,A01,083661,Powell; Thomas Allan,22,0,100,78
1657366144146,CSE 140,A01,083663,Gungor; Onat,14,0,85,71
1657366150171,CSE 140L,A01,083088,Eldon; John,21,0,100,79
1657366156200,CSE 175,A01,083665,Kumar; Rakesh,3,0,25,22
1657366162228,CSE 190,A00,092507,Dubnov; Shlomo,7,0,20,13
1657366168255,ECE 45,A01,083139,Congero; Spencer William,6,0,75,69
1657366174282,ECE 65,A50,083695,Saad; Andrew S,12,0,30,18
1657366174282,ECE 65,A51,095125,Saad; Andrew S,24,0,26,2
1657366180310,ECE 109,A01,091882,Touri; Behrouz,19,0,70,51
1657366186338,ECE 180,A00,083140,Abi Samra; Nicholas Camill,1,0,30,29
1657366186338,ECE 180,B00,083141,Abi Samra; Nicholas Camill,0,0,30,30
1657366192372,MATH 10A,A01,083735,Patchell; Gregory David,2,0,30,28
1657366192372,MATH 10A,A02,083736,Patchell; Gregory David,20,0,30,10
1657366192372,MATH 10A,A03,083737,Patchell; Gregory David,16,0,30,14
1657366198407,MATH 10B,A01,083207,Lim; Seonhee,8,0,34,26
1657366198407,MATH 10B,A02,083208,Lim; Seonhee,9,0,35,26
1657366198407,MATH 10B,A03,093472,Lim; Seonhee,7,0,34,27
1657366198407,MATH 10B,B01,083739,Sinha; Shubham,12,0,30,18
1657366204450,MATH 18,A01,083743,Cinel; Cameron Alexander,7,0,30,23
1657366204450,MATH 18,A02,083744,Cinel; Cameron Alexander,17,0,30,13
1657366204450,MATH 18,A03,083745,Cinel; Cameron Alexander,9,0,30,21
1657366204450,MATH 18,B01,083748,Rideout; David Porter,5,0,37,32
1657366204450,MATH 18,B02,083749,Rideout; David Porter,5,0,36,31
1657366204450,MATH 18,B03,083750,Rideout; David Porter,3,0,37,34
1657366204450,MATH 18,B04,083751,Rideout; David Porter,6,0,36,30
1657366204450,MATH 18,B05,093473,Rideout; David Porter,6,0,36,30
1657366204450,MATH 18,B06,093474,Rideout; David Porter,6,0,36,30
1657366210476,MATH 20A,A01,083754,Zheng; Zequn,14,0,40,26
1657366216517,MATH 20B,A01,083756,Briones; Jor-el Thomas Caparas,4,0,36,32
1657366216517,MATH 20B,A02,083757,Briones; Jor-el Thomas Caparas,1,0,36,35
1657366216517,MATH 20B,A03,093475,Briones; Jor-el Thomas Caparas,2,0,36,34
1657366222544,MATH 20C,A01,083760,Briones; Jor-el Thomas Caparas,1,0,35,34
1657366222544,MATH 20C,A02,083761,Briones; Jor-el Thomas Caparas,8,0,35,27
1657366222544,MATH 20C,A03,093476,Briones; Jor-el Thomas Caparas,0,1,36,36
1657366222544,MATH 20C,B01,083762,Bach; Quang Tran,1,0,30,29
1657366228572,MATH 20D,A01,083765,Tran; Brian Kha,5,0,30,25
1657366228572,MATH 20D,A02,083766,Tran; Brian Kha,5,0,30,25
1657366228572,MATH 20D,A03,083767,Tran; Brian Kha,5,0,30,25
1657366234606,MATH 20E,A01,083771,Ganguly; Soumya,9,0,32,23
1657366234606,MATH 20E,A02,083772,Ganguly; Soumya,6,0,32,26
1657366234606,MATH 20E,B01,083773,Ciotti; Benjamin,20,0,35,15
1657366234606,MATH 20E,B02,083774,Ciotti; Benjamin,17,0,35,18
1657366240643,MATH 103A,A01,083777,Greenfeld; Be'Eri,3,0,36,33
1657366240643,MATH 103A,A02,083778,Greenfeld; Be'Eri,5,0,36,31
1657366240643,MATH 103A,A03,093561,Greenfeld; Be'Eri,5,0,36,31
1657366240643,MATH 103A,B01,083779,Greenfeld; Be'Eri,7,0,36,29
1657366240643,MATH 103A,B02,083780,Greenfeld; Be'Eri,4,0,36,32
1657366240643,MATH 103A,B03,093562,Greenfeld; Be'Eri,3,0,36,33
1657366246674,MATH 105,A01,085443,Carter; Anne Toulson,15,0,35,20
1657366246674,MATH 105,A02,093477,Carter; Anne Toulson,20,0,35,15
1657366252710,MATH 109,A01,083213,Ganzberger; Geoffrey Michael,2,0,34,32
1657366252710,MATH 109,A02,083214,Ganzberger; Geoffrey Michael,4,0,34,30
1657366252710,MATH 109,A03,093478,Ganzberger; Geoffrey Michael,2,0,34,32
1657366252710,MATH 109,B01,083215,Ganzberger; Geoffrey Michael,1,0,32,31
1657366252710,MATH 109,B02,083216,Ganzberger; Geoffrey Michael,2,0,32,30
1657366252710,MATH 109,B03,093479,Ganzberger; Geoffrey Michael,8,0,32,24
1657366258738,MATH 142A,A01,083219,Chow; Bennett,7,0,32,25
1657366258738,MATH 142A,A02,083220,Chow; Bennett,10,0,32,22
1657366258738,MATH 142A,A03,093480,Chow; Bennett,8,0,32,24
1657366258738,MATH 142A,B03,093481,Chow; Bennett,8,0,32,24
1657366258738,MATH 142A,B04,093558,Chow; Bennett,13,0,32,19
1657366258738,MATH 142A,B05,093559,Chow; Bennett,6,0,32,26
1657366264780,MATH 193A,A01,083224,Rotar; Vladimir,8,0,34,26
1657366264780,MATH 193A,A02,083225,Rotar; Vladimir,9,0,34,25
1657366264780,MATH 193A,A03,083781,Rotar; Vladimir,5,0,34,29
1657366264780,MATH 193A,A04,083782,Rotar; Vladimir,10,0,34,24
1657366264780,MATH 193A,A05,093482,Rotar; Vladimir,10,0,34,24
1657366270809,MATH 197,001,091859,McAuley; Julian John,9999,0,9999,0
1657366270809,MATH 197,002,095566,Kedlaya; Kiran S.,9997,0,9999,2
1657366270809,MATH 197,003,095567,Xiao; Ming,9999,0,9999,0
1657366270809,MATH 197,004,095571,Perols; Johan Lars,9998,0,9999,1
1657366277883,COGS 9,A01,083615,Shannon; Kyle Michael,8,0,75,67
1657366283915,COGS 11,A01,083617,Boyle; Mary E. T.,22,0,48,26
1657366289951,COGS 13,A01,083071,Bastos; Amalia Pinkusfeld,11,0,71,60
1657366295979,COGS 14A,A01,092681,Semenuks; Arturs,4,1,100,96
1657366302007,COGS 14B,A01,083073,Cheng; Tzu-Han,6,0,63,57
1657366308042,COGS 17,A01,092677,Semenuks; Arturs,6,0,81,75
1657366314071,COGS 100,A01,083619,Allen; Michael Gordon,17,0,70,53
1657366320100,COGS 101A,A01,083621,Davis; Joshua Daniel,9,0,68,59
1657366326128,COGS 101B,A01,091572,Allen; Michael Gordon,11,0,65,54
1657366332159,COGS 101C,A01,083625,Delgado; Tania,17,0,35,18
1657366338196,COGS 107A,A01,083627,Boyle; Mary E. T.,13,0,60,47
1657366344225,COGS 118A,A01,083075,Gupta; Anjum,20,0,76,56
1657366350262,CSE 3,A50,083646,Miranda; Gregory Joseph,24,0,50,26
1657366356291,CSE 8A,A50,083650,Miranda; Gregory Joseph,17,1,56,39
1657366362318,CSE 11,A01,083080,Cao; Yingjun,6,15,40,34
1657366368344,CSE 12,A01,083652,Krause-Levy; Sophia Louisa,28,1,120,92
1657366374377,CSE 15L,A01,083654,Morris; Justin Loren,9,0,50,41
1657366374377,CSE 15L,A02,083655,Morris; Justin Loren,9,0,50,41
1657366380418,CSE 20,A01,083657,Tran; Khoa Dang,39,0,80,41
1657366386549,CSE 21,A01,095574,Bach; Quang Tran,22,0,48,26
1657366392577,CSE 30,A01,083084,Eldon; John,4,0,80,76
1657366392577,CSE 30,B01,095061,Bhaskar; Nishant,9,0,50,41
1657366398604,CSE 100,A01,083659,Cao; Yingjun,5,4,70,65
1657366404645,CSE 134B,A01,083661,Powell; Thomas Allan,22,0,100,78
1657366410672,CSE 140,A01,083663,Gungor; Onat,14,0,85,71
1657366416698,CSE 140L,A01,083088,Eldon; John,21,0,100,79
1657366422727,CSE 175,A01,083665,Kumar; Rakesh,3,0,25,22
1657366428770,CSE 190,A00,092507,Dubnov; Shlomo,7,0,20,13
1657366434802,ECE 45,A01,083139,Congero; Spencer William,6,0,75,69
1657366440845,ECE 65,A50,083695,Saad; Andrew S,12,0,30,18
1657366440845,ECE 65,A51,095125,Saad; Andrew S,24,0,26,2
1657366446881,ECE 109,A01,091882,Touri; Behrouz,19,0,70,51
1657366452907,ECE 180,A00,083140,Abi Samra; Nicholas Camill,1,0,30,29
1657366452907,ECE 180,B00,083141,Abi Samra; Nicholas Camill,0,0,30,30
1657366458942,MATH 10A,A01,083735,Patchell; Gregory David,2,0,30,28
1657366458942,MATH 10A,A02,083736,Patchell; Gregory David,20,0,30,10
1657366458942,MATH 10A,A03,083737,Patchell; Gregory David,16,0,30,14
1657366464974,MATH 10B,A01,083207,Lim; Seonhee,8,0,34,26
1657366464974,MATH 10B,A02,083208,Lim; Seonhee,9,0,35,26
1657366464974,MATH 10B,A03,093472,Lim; Seonhee,7,0,34,27
1657366464974,MATH 10B,B01,083739,Sinha; Shubham,12,0,30,18
1657366471003,MATH 18,A01,083743,Cinel; Cameron Alexander,7,0,30,23
1657366471003,MATH 18,A02,083744,Cinel; Cameron Alexander,17,0,30,13
1657366471003,MATH 18,A03,083745,Cinel; Cameron Alexander,9,0,30,21
1657366471003,MATH 18,B01,083748,Rideout; David Porter,5,0,37,32
1657366471003,MATH 18,B02,083749,Rideout; David Porter,5,0,36,31
1657366471003,MATH 18,B03,083750,Rideout; David Porter,3,0,37,34
1657366471003,MATH 18,B04,083751,Rideout; David Porter,6,0,36,30
1657366471003,MATH 18,B05,093473,Rideout; David Porter,6,0,36,30
1657366471003,MATH 18,B06,093474,Rideout; David Porter,6,0,36,30
1657366477031,MATH 20A,A01,083754,Zheng; Zequn,14,0,40,26
1657366483062,MATH 20B,A01,083756,Briones; Jor-el Thomas Caparas,4,0,36,32
1657366483062,MATH 20B,A02,083757,Briones; Jor-el Thomas Caparas,1,0,36,35
1657366483062,MATH 20B,A03,093475,Briones; Jor-el Thomas Caparas,2,0,36,34
1657366489102,MATH 20C,A01,083760,Briones; Jor-el Thomas Caparas,1,0,35,34
1657366489102,MATH 20C,A02,083761,Briones; Jor-el Thomas Caparas,8,0,35,27
1657366489102,MATH 20C,A03,093476,Briones; Jor-el Thomas Caparas,0,1,36,36
1657366489102,MATH 20C,B01,083762,Bach; Quang Tran,1,0,30,29
1657366495137,MATH 20D,A01,083765,Tran; Brian Kha,5,0,30,25
1657366495137,MATH 20D,A02,083766,Tran; Brian Kha,5,0,30,25
1657366495137,MATH 20D,A03,083767,Tran; Brian Kha,5,0,30,25
1657366501165,MATH 20E,A01,083771,Ganguly; Soumya,9,0,32,23
1657366501165,MATH 20E,A02,083772,Ganguly; Soumya,6,0,32,26
1657366501165,MATH 20E,B01,083773,Ciotti; Benjamin,20,0,35,15
1657366501165,MATH 20E,B02,083774,Ciotti; Benjamin,17,0,35,18
1657366507206,MATH 103A,A01,083777,Greenfeld; Be'Eri,3,0,36,33
1657366507206,MATH 103A,A02,083778,Greenfeld; Be'Eri,5,0,36,31
1657366507206,MATH 103A,A03,093561,Greenfeld; Be'Eri,5,0,36,31
1657366507206,MATH 103A,B01,083779,Greenfeld; Be'Eri,7,0,36,29
1657366507206,MATH 103A,B02,083780,Greenfeld; Be'Eri,4,0,36,32
1657366507206,MATH 103A,B03,093562,Greenfeld; Be'Eri,3,0,36,33
1657366513243,MATH 105,A01,085443,Carter; Anne Toulson,15,0,35,20
1657366513243,MATH 105,A02,093477,Carter; Anne Toulson,20,0,35,15
1657366519270,MATH 109,A01,083213,Ganzberger; Geoffrey Michael,2,0,34,32
1657366519270,MATH 109,A02,083214,Ganzberger; Geoffrey Michael,4,0,34,30
1657366519270,MATH 109,A03,093478,Ganzberger; Geoffrey Michael,2,0,34,32
1657366519270,MATH 109,B01,083215,Ganzberger; Geoffrey Michael,1,0,32,31
1657366519270,MATH 109,B02,083216,Ganzberger; Geoffrey Michael,2,0,32,30
1657366519270,MATH 109,B03,093479,Ganzberger; Geoffrey Michael,8,0,32,24
1657366525301,MATH 142A,A01,083219,Chow; Bennett,7,0,32,25
1657366525301,MATH 142A,A02,083220,Chow; Bennett,10,0,32,22
1657366525301,MATH 142A,A03,093480,Chow; Bennett,8,0,32,24
1657366525301,MATH 142A,B03,093481,Chow; Bennett,8,0,32,24
1657366525301,MATH 142A,B04,093558,Chow; Bennett,13,0,32,19
1657366525301,MATH 142A,B05,093559,Chow; Bennett,6,0,32,26
1657366531333,MATH 193A,A01,083224,Rotar; Vladimir,8,0,34,26
1657366531333,MATH 193A,A02,083225,Rotar; Vladimir,9,0,34,25
1657366531333,MATH 193A,A03,083781,Rotar; Vladimir,5,0,34,29
1657366531333,MATH 193A,A04,083782,Rotar; Vladimir,10,0,34,24
1657366531333,MATH 193A,A05,093482,Rotar; Vladimir,10,0,34,24
1657366537367,MATH 197,001,091859,McAuley; Julian John,9999,0,9999,0
1657366537367,MATH 197,002,095566,Kedlaya; Kiran S.,9997,0,9999,2
1657366537367,MATH 197,003,095567,Xiao; Ming,9999,0,9999,0
1657366537367,MATH 197,004,095571,Perols; Johan Lars,9998,0,9999,1
1657366544438,COGS 9,A01,083615,Shannon; Kyle Michael,8,0,75,67
1657366550477,COGS 11,A01,083617,Boyle; Mary E. T.,22,0,48,26
1657366556509,COGS 13,A01,083071,Bastos; Amalia Pinkusfeld,11,0,71,60
1657366562543,COGS 14A,A01,092681,Semenuks; Arturs,4,1,100,96
1657366568572,COGS 14B,A01,083073,Cheng; Tzu-Han,6,0,63,57
1657366574601,COGS 17,A01,092677,Semenuks; Arturs,6,0,81,75
1657366580633,COGS 100,A01,083619,Allen; Michael Gordon,17,0,70,53
1657366586664,COGS 101A,A01,083621,Davis; Joshua Daniel,9,0,68,59
1657366592690,COGS 101B,A01,091572,Allen; Michael Gordon,11,0,65,54
1657366598716,COGS 101C,A01,083625,Delgado; Tania,17,0,35,18
1657366604751,COGS 107A,A01,083627,Boyle; Mary E. T.,13,0,60,47
1657366610780,COGS 118A,A01,083075,Gupta; Anjum,20,0,76,56
1657366616825,CSE 3,A50,083646,Miranda; Gregory Joseph,24,0,50,26
1657366622859,CSE 8A,A50,083650,Miranda; Gregory Joseph,17,1,56,39
1657366628899,CSE 11,A01,083080,Cao; Yingjun,6,15,40,34
1657366634933,CSE 12,A01,083652,Krause-Levy; Sophia Louisa,28,1,120,92
1657366640962,CSE 15L,A01,083654,Morris; Justin Loren,9,0,50,41
1657366640962,CSE 15L,A02,083655,Morris; Justin Loren,9,0,50,41
1657366646995,CSE 20,A01,083657,Tran; Khoa Dang,39,0,80,41
1657366653030,CSE 21,A01,095574,Bach; Quang Tran,22,0,48,26
1657366659067,CSE 30,A01,083084,Eldon; John,4,0,80,76
1657366659067,CSE 30,B01,095061,Bhaskar; Nishant,9,0,50,41
1657366665098,CSE 100,A01,083659,Cao; Yingjun,5,4,70,65
1657366671146,CSE 134B,A01,083661,Powell; Thomas Allan,22,0,100,78
1657366677183,CSE 140,A01,083663,Gungor; Onat,14,0,85,71
1657366683210,CSE 140L,A01,083088,Eldon; John,21,0,100,79
1657366689242,CSE 175,A01,083665,Kumar; Rakesh,3,0,25,22
1657366695268,CSE 190,A00,092507,Dubnov; Shlomo,7,0,20,13
1657366701295,ECE 45,A01,083139,Congero; Spencer William,6,0,75,69
1657366707332,ECE 65,A50,083695,Saad; Andrew S,12,0,30,18
1657366707332,ECE 65,A51,095125,Saad; Andrew S,24,0,26,2
1657366713359,ECE 109,A01,091882,Touri; Behrouz,19,0,70,51
1657366719386,ECE 180,A00,083140,Abi Samra; Nicholas Camill,1,0,30,29
1657366719386,ECE 180,B00,083141,Abi Samra; Nicholas Camill,0,0,30,30
1657366725420,MATH 10A,A01,083735,Patchell; Gregory David,2,0,30,28
1657366725420,MATH 10A,A02,083736,Patchell; Gregory David,20,0,30,10
1657366725420,MATH 10A,A03,083737,Patchell; Gregory David,16,0,30,14
1657366731447,MATH 10B,A01,083207,Lim; Seonhee,8,0,34,26
1657366731447,MATH 10B,A02,083208,Lim; Seonhee,9,0,35,26
1657366731447,MATH 10B,A03,093472,Lim; Seonhee,7,0,34,27
1657366731447,MATH 10B,B01,083739,Sinha; Shubham,12,0,30,18
1657366737477,MATH 18,A01,083743,Cinel; Cameron Alexander,7,0,30,23
1657366737477,MATH 18,A02,083744,Cinel; Cameron Alexander,17,0,30,13
1657366737477,MATH 18,A03,083745,Cinel; Cameron Alexander,9,0,30,21
1657366737477,MATH 18,B01,083748,Rideout; David Porter,5,0,37,32
1657366737477,MATH 18,B02,083749,Rideout; David Porter,5,0,36,31
1657366737477,MATH 18,B03,083750,Rideout; David Porter,3,0,37,34
1657366737477,MATH 18,B04,083751,Rideout; David Porter,6,0,36,30
1657366737477,MATH 18,B05,093473,Rideout; David Porter,6,0,36,30
1657366737477,MATH 18,B06,093474,Rideout; David Porter,6,0,36,30
1657366743507,MATH 20A,A01,083754,Zheng; Zequn,14,0,40,26
1657366749541,MATH 20B,A01,083756,Briones; Jor-el Thomas Caparas,4,0,36,32
1657366749541,MATH 20B,A02,083757,Briones; Jor-el Thomas Caparas,1,0,36,35
1657366749541,MATH 20B,A03,093475,Briones; Jor-el Thomas Caparas,2,0,36,34
1657366755573,MATH 20C,A01,083760,Briones; Jor-el Thomas Caparas,1,0,35,34
1657366755573,MATH 20C,A02,083761,Briones; Jor-el Thomas Caparas,8,0,35,27
1657366755573,MATH 20C,A03,093476,Briones; Jor-el Thomas Caparas,0,1,36,36
1657366755573,MATH 20C,B01,083762,Bach; Quang Tran,1,0,30,29
1657366761605,MATH 20D,A01,083765,Tran; Brian Kha,5,0,30,25
1657366761605,MATH 20D,A02,083766,Tran; Brian Kha,5,0,30,25
1657366761605,MATH 20D,A03,083767,Tran; Brian Kha,5,0,30,25
1657366767636,MATH 20E,A01,083771,Ganguly; Soumya,9,0,32,23
1657366767636,MATH 20E,A02,083772,Ganguly; Soumya,6,0,32,26
1657366767636,MATH 20E,B01,083773,Ciotti; Benjamin,20,0,35,15
1657366767636,MATH 20E,B02,083774,Ciotti; Benjamin,17,0,35,18
1657366773667,MATH 103A,A01,083777,Greenfeld; Be'Eri,3,0,36,33
1657366773667,MATH 103A,A02,083778,Greenfeld; Be'Eri,5,0,36,31
1657366773667,MATH 103A,A03,093561,Greenfeld; Be'Eri,5,0,36,31
1657366773667,MATH 103A,B01,083779,Greenfeld; Be'Eri,7,0,36,29
1657366773667,MATH 103A,B02,083780,Greenfeld; Be'Eri,4,0,36,32
1657366773667,MATH 103A,B03,093562,Greenfeld; Be'Eri,3,0,36,33
1657366779696,MATH 105,A01,085443,Carter; Anne Toulson,15,0,35,20
1657366779696,MATH 105,A02,093477,Carter; Anne Toulson,20,0,35,15
1657366785730,MATH 109,A01,083213,Ganzberger; Geoffrey Michael,2,0,34,32
1657366785730,MATH 109,A02,083214,Ganzberger; Geoffrey Michael,4,0,34,30
1657366785730,MATH 109,A03,093478,Ganzberger; Geoffrey Michael,2,0,34,32
1657366785730,MATH 109,B01,083215,Ganzberger; Geoffrey Michael,1,0,32,31
1657366785730,MATH 109,B02,083216,Ganzberger; Geoffrey Michael,2,0,32,30
1657366785730,MATH 109,B03,093479,Ganzberger; Geoffrey Michael,8,0,32,24
1657366791765,MATH 142A,A01,083219,Chow; Bennett,7,0,32,25
1657366791765,MATH 142A,A02,083220,Chow; Bennett,10,0,32,22
1657366791765,MATH 142A,A03,093480,Chow; Bennett,8,0,32,24
1657366791765,MATH 142A,B03,093481,Chow; Bennett,8,0,32,24
1657366791765,MATH 142A,B04,093558,Chow; Bennett,13,0,32,19
1657366791765,MATH 142A,B05,093559,Chow; Bennett,6,0,32,26
1657366797795,MATH 193A,A01,083224,Rotar; Vladimir,8,0,34,26
1657366797795,MATH 193A,A02,083225,Rotar; Vladimir,9,0,34,25
1657366797795,MATH 193A,A03,083781,Rotar; Vladimir,5,0,34,29
1657366797795,MATH 193A,A04,083782,Rotar; Vladimir,10,0,34,24
1657366797795,MATH 193A,A05,093482,Rotar; Vladimir,10,0,34,24
1657366803826,MATH 197,001,091859,McAuley; Julian John,9999,0,9999,0
1657366803826,MATH 197,002,095566,Kedlaya; Kiran S.,9997,0,9999,2
1657366803826,MATH 197,003,095567,Xiao; Ming,9999,0,9999,0
1657366803826,MATH 197,004,095571,Perols; Johan Lars,9998,0,9999,1
1657366810893,COGS 9,A01,083615,Shannon; Kyle Michael,9,0,75,66
1657366816922,COGS 11,A01,083617,Boyle; Mary E. T.,22,0,48,26
1657366822950,COGS 13,A01,083071,Bastos; Amalia Pinkusfeld,11,0,71,60
1657366828982,COGS 14A,A01,092681,Semenuks; Arturs,4,1,100,96
1657366835014,COGS 14B,A01,083073,Cheng; Tzu-Han,6,0,63,57
1657366841043,COGS 17,A01,092677,Semenuks; Arturs,6,0,81,75
1657366847073,COGS 100,A01,083619,Allen; Michael Gordon,17,0,70,53
1657366853103,COGS 101A,A01,083621,Davis; Joshua Daniel,9,0,68,59
1657366859129,COGS 101B,A01,091572,Allen; Michael Gordon,11,0,65,54
1657366865162,COGS 101C,A01,083625,Delgado; Tania,17,0,35,18
1657366871191,COGS 107A,A01,083627,Boyle; Mary E. T.,13,0,60,47
1657366877217,COGS 118A,A01,083075,Gupta; Anjum,20,0,76,56
1657366883250,CSE 3,A50,083646,Miranda; Gregory Joseph,24,0,50,26
1657366889277,CSE 8A,A50,083650,Miranda; Gregory Joseph,17,1,56,39
1657366895312,CSE 11,A01,083080,Cao; Yingjun,6,15,40,34
1657366901343,CSE 12,A01,083652,Krause-Levy; Sophia Louisa,28,1,120,92
1657366907367,CSE 15L,A01,083654,Morris; Justin Loren,9,0,50,41
1657366907367,CSE 15L,A02,083655,Morris; Justin Loren,9,0,50,41
1657366913398,CSE 20,A01,083657,Tran; Khoa Dang,39,0,80,41
1657366919423,CSE 21,A01,095574,Bach; Quang Tran,22,0,48,26
1657366925451,CSE 30,A01,083084,Eldon; John,4,0,80,76
1657366925451,CSE 30,B01,095061,Bhaskar; Nishant,9,0,50,41
1657366931482,CSE 100,A01,083659,Cao; Yingjun,5,4,70,65
1657366937512,CSE 134B,A01,083661,Powell; Thomas Allan,22,0,100,78
1657366943543,CSE 140,A01,083663,Gungor; Onat,14,0,85,71
1657366949571,CSE 140L,A01,083088,Eldon; John,21,0,100,79
1657366955599,CSE 175,A01,083665,Kumar; Rakesh,3,0,25,22
1657366961629,CSE 190,A00,092507,Dubnov; Shlomo,7,0,20,13
1657366967658,ECE 45,A01,083139,Congero; Spencer William,6,0,75,69
1657366973693,ECE 65,A50,083695,Saad; Andrew S,12,0,30,18
1657366973693,ECE 65,A51,095125,Saad; Andrew S,24,0,26,2
1657366979721,ECE 109,A01,091882,Touri; Behrouz,19,0,70,51
1657366985824,ECE 180,A00,083140,Abi Samra; Nicholas Camill,1,0,30,29
1657366985824,ECE 180,B00,083141,Abi Samra; Nicholas Camill,0,0,30,30
1657366991852,MATH 10A,A01,083735,Patchell; Gregory David,2,0,30,28
1657366991852,MATH 10A,A02,083736,Patchell; Gregory David,20,0,30,10
1657366991852,MATH 10A,A03,083737,Patchell; Gregory David,16,0,30,14
1657366997884,MATH 10B,A01,083207,Lim; Seonhee,8,0,34,26
1657366997884,MATH 10B,A02,083208,Lim; Seonhee,9,0,35,26
1657366997884,MATH 10B,A03,093472,Lim; Seonhee,7,0,34,27
1657366997884,MATH 10B,B01,083739,Sinha; Shubham,12,0,30,18
1657367003923,MATH 18,A01,083743,Cinel; Cameron Alexander,7,0,30,23
1657367003923,MATH 18,A02,083744,Cinel; Cameron Alexander,17,0,30,13
1657367003923,MATH 18,A03,083745,Cinel; Cameron Alexander,9,0,30,21
1657367003923,MATH 18,B01,083748,Rideout; David Porter,5,0,37,32
1657367003923,MATH 18,B02,083749,Rideout; David Porter,5,0,36,31
1657367003923,MATH 18,B03,083750,Rideout; David Porter,3,0,37,34
1657367003923,MATH 18,B04,083751,Rideout; David Porter,6,0,36,30
1657367003923,MATH 18,B05,093473,Rideout; David Porter,6,0,36,30
1657367003923,MATH 18,B06,093474,Rideout; David Porter,6,0,36,30
1657367009962,MATH 20A,A01,083754,Zheng; Zequn,14,0,40,26
1657367015997,MATH 20B,A01,083756,Briones; Jor-el Thomas Caparas,4,0,36,32
1657367015997,MATH 20B,A02,083757,Briones; Jor-el Thomas Caparas,1,0,36,35
1657367015997,MATH 20B,A03,093475,Briones; Jor-el Thomas Caparas,2,0,36,34
1657367022022,MATH 20C,A01,083760,Briones; Jor-el Thomas Caparas,1,0,35,34
1657367022022,MATH 20C,A02,083761,Briones; Jor-el Thomas Caparas,8,0,35,27
1657367022022,MATH 20C,A03,093476,Briones; Jor-el Thomas Caparas,0,1,36,36
1657367022022,MATH 20C,B01,083762,Bach; Quang Tran,1,0,30,29
1657367028048,MATH 20D,A01,083765,Tran; Brian Kha,5,0,30,25
1657367028048,MATH 20D,A02,083766,Tran; Brian Kha,5,0,30,25
1657367028048,MATH 20D,A03,083767,Tran; Brian Kha,5,0,30,25
1657367034084,MATH 20E,A01,083771,Ganguly; Soumya,9,0,32,23
1657367034084,MATH 20E,A02,083772,Ganguly; Soumya,6,0,32,26
1657367034084,MATH 20E,B01,083773,Ciotti; Benjamin,20,0,35,15
1657367034084,MATH 20E,B02,083774,Ciotti; Benjamin,17,0,35,18
1657367040116,MATH 103A,A01,083777,Greenfeld; Be'Eri,3,0,36,33
1657367040116,MATH 103A,A02,083778,Greenfeld; Be'Eri,5,0,36,31
1657367040116,MATH 103A,A03,093561,Greenfeld; Be'Eri,5,0,36,31
1657367040116,MATH 103A,B01,083779,Greenfeld; Be'Eri,7,0,36,29
1657367040116,MATH 103A,B02,083780,Greenfeld; Be'Eri,4,0,36,32
1657367040116,MATH 103A,B03,093562,Greenfeld; Be'Eri,3,0,36,33
1657367046157,MATH 105,A01,085443,Carter; Anne Toulson,15,0,35,20
1657367046157,MATH 105,A02,093477,Carter; Anne Toulson,20,0,35,15
1657367052199,MATH 109,A01,083213,Ganzberger; Geoffrey Michael,2,0,34,32
1657367052199,MATH 109,A02,083214,Ganzberger; Geoffrey Michael,4,0,34,30
1657367052199,MATH 109,A03,093478,Ganzberger; Geoffrey Michael,2,0,34,32
1657367052199,MATH 109,B01,083215,Ganzberger; Geoffrey Michael,1,0,32,31
1657367052199,MATH 109,B02,083216,Ganzberger; Geoffrey Michael,2,0,32,30
1657367052199,MATH 109,B03,093479,Ganzberger; Geoffrey Michael,8,0,32,24
1657367058230,MATH 142A,A01,083219,Chow; Bennett,7,0,32,25
1657367058230,MATH 142A,A02,083220,Chow; Bennett,10,0,32,22
1657367058230,MATH 142A,A03,093480,Chow; Bennett,8,0,32,24
1657367058230,MATH 142A,B03,093481,Chow; Bennett,8,0,32,24
1657367058230,MATH 142A,B04,093558,Chow; Bennett,13,0,32,19
1657367058230,MATH 142A,B05,093559,Chow; Bennett,6,0,32,26
1657367064261,MATH 193A,A01,083224,Rotar; Vladimir,8,0,34,26
1657367064261,MATH 193A,A02,083225,Rotar; Vladimir,9,0,34,25
1657367064261,MATH 193A,A03,083781,Rotar; Vladimir,5,0,34,29
1657367064261,MATH 193A,A04,083782,Rotar; Vladimir,10,0,34,24
1657367064261,MATH 193A,A05,093482,Rotar; Vladimir,10,0,34,24
1657367070290,MATH 197,001,091859,McAuley; Julian John,9999,0,9999,0
1657367070290,MATH 197,002,095566,Kedlaya; Kiran S.,9997,0,9999,2
1657367070290,MATH 197,003,095567,Xiao; Ming,9999,0,9999,0
1657367070290,MATH 197,004,095571,Perols; Johan Lars,9998,0,9999,1
1657367077387,COGS 9,A01,083615,Shannon; Kyle Michael,9,0,75,66
1657367083421,COGS 11,A01,083617,Boyle; Mary E. T.,22,0,48,26
1657367089450,COGS 13,A01,083071,Bastos; Amalia Pinkusfeld,11,0,71,60
1657367095479,COGS 14A,A01,092681,Semenuks; Arturs,4,1,100,96
1657367101512,COGS 14B,A01,083073,Cheng; Tzu-Han,6,0,63,57
1657367107541,COGS 17,A01,092677,Semenuks; Arturs,6,0,81,75
1657367113577,COGS 100,A01,083619,Allen; Michael Gordon,17,0,70,53
1657367119610,COGS 101A,A01,083621,Davis; Joshua Daniel,9,0,68,59
1657367125638,COGS 101B,A01,091572,Allen; Michael Gordon,11,0,65,54
1657367131668,COGS 101C,A01,083625,Delgado; Tania,17,0,35,18
1657367137694,COGS 107A,A01,083627,Boyle; Mary E. T.,13,0,60,47
1657367143719,COGS 118A,A01,083075,Gupta; Anjum,20,0,76,56
1657367149754,CSE 3,A50,083646,Miranda; Gregory Joseph,24,0,50,26
1657367155781,CSE 8A,A50,083650,Miranda; Gregory Joseph,17,1,56,39
1657367161804,CSE 11,A01,083080,Cao; Yingjun,6,15,40,34
1657367167837,CSE 12,A01,083652,Krause-Levy; Sophia Louisa,28,1,120,92
1657367173867,CSE 15L,A01,083654,Morris; Justin Loren,9,0,50,41
1657367173867,CSE 15L,A02,083655,Morris; Justin Loren,9,0,50,41
1657367179892,CSE 20,A01,083657,Tran; Khoa Dang,39,0,80,41
1657367185919,CSE 21,A01,095574,Bach; Quang Tran,22,0,48,26
1657367191949,CSE 30,A01,083084,Eldon; John,4,0,80,76
1657367191949,CSE 30,B01,095061,Bhaskar; Nishant,9,0,50,41
1657367197982,CSE 100,A01,083659,Cao; Yingjun,5,4,70,65
1657367204015,CSE 134B,A01,083661,Powell; Thomas Allan,22,0,100,78
1657367210048,CSE 140,A01,083663,Gungor; Onat,14,0,85,71
1657367216082,CSE 140L,A01,083088,Eldon; John,21,0,100,79
1657367222116,CSE 175,A01,083665,Kumar; Rakesh,3,0,25,22
1657367228157,CSE 190,A00,092507,Dubnov; Shlomo,7,0,20,13
1657367234186,ECE 45,A01,083139,Congero; Spencer William,6,0,75,69
1657367240218,ECE 65,A50,083695,Saad; Andrew S,12,0,30,18
1657367240218,ECE 65,A51,095125,Saad; Andrew S,24,0,26,2
1657367246246,ECE 109,A01,091882,Touri; Behrouz,19,0,70,51
1657367252272,ECE 180,A00,083140,Abi Samra; Nicholas Camill,1,0,30,29
1657367252272,ECE 180,B00,083141,Abi Samra; Nicholas Camill,0,0,30,30
1657367258309,MATH 10A,A01,083735,Patchell; Gregory David,2,0,30,28
1657367258309,MATH 10A,A02,083736,Patchell; Gregory David,20,0,30,10
1657367258309,MATH 10A,A03,083737,Patchell; Gregory David,16,0,30,14
1657367264346,MATH 10B,A01,083207,Lim; Seonhee,8,0,34,26
1657367264346,MATH 10B,A02,083208,Lim; Seonhee,9,0,35,26
1657367264346,MATH 10B,A03,093472,Lim; Seonhee,7,0,34,27
1657367264346,MATH 10B,B01,083739,Sinha; Shubham,12,0,30,18
1657367270384,MATH 18,A01,083743,Cinel; Cameron Alexander,7,0,30,23
1657367270384,MATH 18,A02,083744,Cinel; Cameron Alexander,17,0,30,13
1657367270384,MATH 18,A03,083745,Cinel; Cameron Alexander,9,0,30,21
1657367270384,MATH 18,B01,083748,Rideout; David Porter,5,0,37,32
1657367270384,MATH 18,B02,083749,Rideout; David Porter,5,0,36,31
1657367270384,MATH 18,B03,083750,Rideout; David Porter,3,0,37,34
1657367270384,MATH 18,B04,083751,Rideout; David Porter,6,0,36,30
1657367270384,MATH 18,B05,093473,Rideout; David Porter,6,0,36,30
1657367270384,MATH 18,B06,093474,Rideout; David Porter,6,0,36,30
1657367276409,MATH 20A,A01,083754,Zheng; Zequn,14,0,40,26
1657367282438,MATH 20B,A01,083756,Briones; Jor-el Thomas Caparas,4,0,36,32
1657367282438,MATH 20B,A02,083757,Briones; Jor-el Thomas Caparas,1,0,36,35
1657367282438,MATH 20B,A03,093475,Briones; Jor-el Thomas Caparas,2,0,36,34
1657367288471,MATH 20C,A01,083760,Briones; Jor-el Thomas Caparas,1,0,35,34
1657367288471,MATH 20C,A02,083761,Briones; Jor-el Thomas Caparas,8,0,35,27
1657367288471,MATH 20C,A03,093476,Briones; Jor-el Thomas Caparas,0,1,36,36
1657367288471,MATH 20C,B01,083762,Bach; Quang Tran,1,0,30,29
1657367294500,MATH 20D,A01,083765,Tran; Brian Kha,5,0,30,25
1657367294500,MATH 20D,A02,083766,Tran; Brian Kha,5,0,30,25
1657367294500,MATH 20D,A03,083767,Tran; Brian Kha,5,0,30,25
1657367300535,MATH 20E,A01,083771,Ganguly; Soumya,9,0,32,23
1657367300535,MATH 20E,A02,083772,Ganguly; Soumya,6,0,32,26
1657367300535,MATH 20E,B01,083773,Ciotti; Benjamin,20,0,35,15
1657367300535,MATH 20E,B02,083774,Ciotti; Benjamin,17,0,35,18
1657367306571,MATH 103A,A01,083777,Greenfeld; Be'Eri,3,0,36,33
1657367306571,MATH 103A,A02,083778,Greenfeld; Be'Eri,5,0,36,31
1657367306571,MATH 103A,A03,093561,Greenfeld; Be'Eri,5,0,36,31
1657367306571,MATH 103A,B01,083779,Greenfeld; Be'Eri,7,0,36,29
1657367306571,MATH 103A,B02,083780,Greenfeld; Be'Eri,4,0,36,32
1657367306571,MATH 103A,B03,093562,Greenfeld; Be'Eri,3,0,36,33
1657367312605,MATH 105,A01,085443,Carter; Anne Toulson,15,0,35,20
1657367312605,MATH 105,A02,093477,Carter; Anne Toulson,20,0,35,15
1657367318637,MATH 109,A01,083213,Ganzberger; Geoffrey Michael,2,0,34,32
1657367318637,MATH 109,A02,083214,Ganzberger; Geoffrey Michael,4,0,34,30
1657367318637,MATH 109,A03,093478,Ganzberger; Geoffrey Michael,2,0,34,32
1657367318637,MATH 109,B01,083215,Ganzberger; Geoffrey Michael,1,0,32,31
1657367318637,MATH 109,B02,083216,Ganzberger; Geoffrey Michael,2,0,32,30
1657367318637,MATH 109,B03,093479,Ganzberger; Geoffrey Michael,8,0,32,24
1657367324679,MATH 142A,A01,083219,Chow; Bennett,7,0,32,25
1657367324679,MATH 142A,A02,083220,Chow; Bennett,10,0,32,22
1657367324679,MATH 142A,A03,093480,Chow; Bennett,8,0,32,24
1657367324679,MATH 142A,B03,093481,Chow; Bennett,8,0,32,24
1657367324679,MATH 142A,B04,093558,Chow; Bennett,13,0,32,19
1657367324679,MATH 142A,B05,093559,Chow; Bennett,6,0,32,26
1657367330707,MATH 193A,A01,083224,Rotar; Vladimir,8,0,34,26
1657367330707,MATH 193A,A02,083225,Rotar; Vladimir,9,0,34,25
1657367330707,MATH 193A,A03,083781,Rotar; Vladimir,5,0,34,29
1657367330707,MATH 193A,A04,083782,Rotar; Vladimir,10,0,34,24
1657367330707,MATH 193A,A05,093482,Rotar; Vladimir,10,0,34,24
1657367336738,MATH 197,001,091859,McAuley; Julian John,9999,0,9999,0
1657367336738,MATH 197,002,095566,Kedlaya; Kiran S.,9997,0,9999,2
1657367336738,MATH 197,003,095567,Xiao; Ming,9999,0,9999,0
1657367336738,MATH 197,004,095571,Perols; Johan Lars,9998,0,9999,1
1657367343832,COGS 9,A01,083615,Shannon; Kyle Michael,9,0,75,66
1657367349862,COGS 11,A01,083617,Boyle; Mary E. T.,22,0,48,26
1657367355890,COGS 13,A01,083071,Bastos; Amalia Pinkusfeld,11,0,71,60
1657367361917,COGS 14A,A01,092681,Semenuks; Arturs,4,1,100,96
1657367367943,COGS 14B,A01,083073,Cheng; Tzu-Han,6,0,63,57
1657367373977,COGS 17,A01,092677,Semenuks; Arturs,6,0,81,75
1657367380007,COGS 100,A01,083619,Allen; Michael Gordon,17,0,70,53
1657367386038,COGS 101A,A01,083621,Davis; Joshua Daniel,9,0,68,59
1657367392065,COGS 101B,A01,091572,Allen; Michael Gordon,11,0,65,54
1657367398096,COGS 101C,A01,083625,Delgado; Tania,17,0,35,18
1657367404124,COGS 107A,A01,083627,Boyle; Mary E. T.,13,0,60,47
1657367410162,COGS 118A,A01,083075,Gupta; Anjum,20,0,76,56
1657367416210,CSE 3,A50,083646,Miranda; Gregory Joseph,24,0,50,26
1657367422240,CSE 8A,A50,083650,Miranda; Gregory Joseph,17,1,56,39
1657367428264,CSE 11,A01,083080,Cao; Yingjun,6,15,40,34
1657367434293,CSE 12,A01,083652,Krause-Levy; Sophia Louisa,28,1,120,92
1657367440324,CSE 15L,A01,083654,Morris; Justin Loren,9,0,50,41
1657367440324,CSE 15L,A02,083655,Morris; Justin Loren,9,0,50,41
1657367446351,CSE 20,A01,083657,Tran; Khoa Dang,39,0,80,41
1657367452381,CSE 21,A01,095574,Bach; Quang Tran,22,0,48,26
1657367458410,CSE 30,A01,083084,Eldon; John,4,0,80,76
1657367458410,CSE 30,B01,095061,Bhaskar; Nishant,9,0,50,41
1657367464442,CSE 100,A01,083659,Cao; Yingjun,5,4,70,65
1657367470472,CSE 134B,A01,083661,Powell; Thomas Allan,22,0,100,78
1657367476500,CSE 140,A01,083663,Gungor; Onat,14,0,85,71
1657367482525,CSE 140L,A01,083088,Eldon; John,21,0,100,79
1657367488551,CSE 175,A01,083665,Kumar; Rakesh,3,0,25,22
1657367494579,CSE 190,A00,092507,Dubnov; Shlomo,7,0,20,13
1657367500614,ECE 45,A01,083139,Congero; Spencer William,6,0,75,69
1657367506641,ECE 65,A50,083695,Saad; Andrew S,12,0,30,18
1657367506641,ECE 65,A51,095125,Saad; Andrew S,24,0,26,2
1657367512667,ECE 109,A01,091882,Touri; Behrouz,19,0,70,51
1657367518699,ECE 180,A00,083140,Abi Samra; Nicholas Camill,1,0,30,29
1657367518699,ECE 180,B00,083141,Abi Samra; Nicholas Camill,0,0,30,30
1657367524728,MATH 10A,A01,083735,Patchell; Gregory David,2,0,30,28
1657367524728,MATH 10A,A02,083736,Patchell; Gregory David,20,0,30,10
1657367524728,MATH 10A,A03,083737,Patchell; Gregory David,16,0,30,14
1657367530768,MATH 10B,A01,083207,Lim; Seonhee,8,0,34,26
1657367530768,MATH 10B,A02,083208,Lim; Seonhee,9,0,35,26
1657367530768,MATH 10B,A03,093472,Lim; Seonhee,7,0,34,27
1657367530768,MATH 10B,B01,083739,Sinha; Shubham,12,0,30,18
1657367536798,MATH 18,A01,083743,Cinel; Cameron Alexander,7,0,30,23
1657367536798,MATH 18,A02,083744,Cinel; Cameron Alexander,17,0,30,13
1657367536798,MATH 18,A03,083745,Cinel; Cameron Alexander,9,0,30,21
1657367536798,MATH 18,B01,083748,Rideout; David Porter,5,0,37,32
1657367536798,MATH 18,B02,083749,Rideout; David Porter,5,0,36,31
1657367536798,MATH 18,B03,083750,Rideout; David Porter,3,0,37,34
1657367536798,MATH 18,B04,083751,Rideout; David Porter,6,0,36,30
1657367536798,MATH 18,B05,093473,Rideout; David Porter,6,0,36,30
1657367536798,MATH 18,B06,093474,Rideout; David Porter,6,0,36,30
1657367542827,MATH 20A,A01,083754,Zheng; Zequn,14,0,40,26
1657367548855,MATH 20B,A01,083756,Briones; Jor-el Thomas Caparas,4,0,36,32
1657367548855,MATH 20B,A02,083757,Briones; Jor-el Thomas Caparas,1,0,36,35
1657367548855,MATH 20B,A03,093475,Briones; Jor-el Thomas Caparas,2,0,36,34
1657367554887,MATH 20C,A01,083760,Briones; Jor-el Thomas Caparas,1,0,35,34
1657367554887,MATH 20C,A02,083761,Briones; Jor-el Thomas Caparas,8,0,35,27
1657367554887,MATH 20C,A03,093476,Briones; Jor-el Thomas Caparas,0,1,36,36
1657367554887,MATH 20C,B01,083762,Bach; Quang Tran,1,0,30,29
1657367560915,MATH 20D,A01,083765,Tran; Brian Kha,5,0,30,25
1657367560915,MATH 20D,A02,083766,Tran; Brian Kha,5,0,30,25
1657367560915,MATH 20D,A03,083767,Tran; Brian Kha,5,0,30,25
1657367566943,MATH 20E,A01,083771,Ganguly; Soumya,9,0,32,23
1657367566943,MATH 20E,A02,083772,Ganguly; Soumya,6,0,32,26
1657367566943,MATH 20E,B01,083773,Ciotti; Benjamin,20,0,35,15
1657367566943,MATH 20E,B02,083774,Ciotti; Benjamin,17,0,35,18
1657367572981,MATH 103A,A01,083777,Greenfeld; Be'Eri,3,0,36,33
1657367572981,MATH 103A,A02,083778,Greenfeld; Be'Eri,5,0,36,31
1657367572981,MATH 103A,A03,093561,Greenfeld; Be'Eri,5,0,36,31
1657367572981,MATH 103A,B01,083779,Greenfeld; Be'Eri,7,0,36,29
1657367572981,MATH 103A,B02,083780,Greenfeld; Be'Eri,4,0,36,32
1657367572981,MATH 103A,B03,093562,Greenfeld; Be'Eri,3,0,36,33
1657367579010,MATH 105,A01,085443,Carter; Anne Toulson,15,0,35,20
1657367579010,MATH 105,A02,093477,Carter; Anne Toulson,20,0,35,15
1657367585110,MATH 109,A01,083213,Ganzberger; Geoffrey Michael,2,0,34,32
1657367585110,MATH 109,A02,083214,Ganzberger; Geoffrey Michael,4,0,34,30
1657367585110,MATH 109,A03,093478,Ganzberger; Geoffrey Michael,2,0,34,32
1657367585110,MATH 109,B01,083215,Ganzberger; Geoffrey Michael,1,0,32,31
1657367585110,MATH 109,B02,083216,Ganzberger; Geoffrey Michael,2,0,32,30
1657367585110,MATH 109,B03,093479,Ganzberger; Geoffrey Michael,8,0,32,24
1657367591141,MATH 142A,A01,083219,Chow; Bennett,7,0,32,25
1657367591141,MATH 142A,A02,083220,Chow; Bennett,10,0,32,22
1657367591141,MATH 142A,A03,093480,Chow; Bennett,8,0,32,24
1657367591141,MATH 142A,B03,093481,Chow; Bennett,8,0,32,24
1657367591141,MATH 142A,B04,093558,Chow; Bennett,13,0,32,19
1657367591141,MATH 142A,B05,093559,Chow; Bennett,6,0,32,26
1657367597172,MATH 193A,A01,083224,Rotar; Vladimir,8,0,34,26
1657367597172,MATH 193A,A02,083225,Rotar; Vladimir,9,0,34,25
1657367597172,MATH 193A,A03,083781,Rotar; Vladimir,5,0,34,29
1657367597172,MATH 193A,A04,083782,Rotar; Vladimir,10,0,34,24
1657367597172,MATH 193A,A05,093482,Rotar; Vladimir,10,0,34,24
1657367603202,MATH 197,001,091859,McAuley; Julian John,9999,0,9999,0
1657367603202,MATH 197,002,095566,Kedlaya; Kiran S.,9997,0,9999,2
1657367603202,MATH 197,003,095567,Xiao; Ming,9999,0,9999,0
1657367603202,MATH 197,004,095571,Perols; Johan Lars,9998,0,9999,1
1657367610277,COGS 9,A01,083615,Shannon; Kyle Michael,9,0,75,66
1657367616307,COGS 11,A01,083617,Boyle; Mary E. T.,22,0,48,26
1657367622337,COGS 13,A01,083071,Bastos; Amalia Pinkusfeld,11,0,71,60
1657367628362,COGS 14A,A01,092681,Semenuks; Arturs,4,1,100,96
1657367634394,COGS 14B,A01,083073,Cheng; Tzu-Han,6,0,63,57
1657367640418,COGS 17,A01,092677,Semenuks; Arturs,6,0,81,75
1657367646443,COGS 100,A01,083619,Allen; Michael Gordon,17,0,70,53
1657367652471,COGS 101A,A01,083621,Davis; Joshua Daniel,9,0,68,59
1657367658497,COGS 101B,A01,091572,Allen; Michael Gordon,11,0,65,54
1657367664543,COGS 101C,A01,083625,Delgado; Tania,17,0,35,18
1657367670567,COGS 107A,A01,083627,Boyle; Mary E. T.,13,0,60,47
1657367676593,COGS 118A,A01,083075,Gupta; Anjum,20,0,76,56
1657367682622,CSE 3,A50,083646,Miranda; Gregory Joseph,24,0,50,26
1657367688656,CSE 8A,A50,083650,Miranda; Gregory Joseph,17,1,56,39
1657367694691,CSE 11,A01,083080,Cao; Yingjun,6,15,40,34
1657367700718,CSE 12,A01,083652,Krause-Levy; Sophia Louisa,28,1,120,92
1657367706748,CSE 15L,A01,083654,Morris; Justin Loren,9,0,50,41
1657367706748,CSE 15L,A02,083655,Morris; Justin Loren,9,0,50,41
1657367712773,CSE 20,A01,083657,Tran; Khoa Dang,39,0,80,41
1657367718804,CSE 21,A01,095574,Bach; Quang Tran,22,0,48,26
1657367724829,CSE 30,A01,083084,Eldon; John,4,0,80,76
1657367724829,CSE 30,B01,095061,Bhaskar; Nishant,9,0,50,41
1657367730856,CSE 100,A01,083659,Cao; Yingjun,5,4,70,65
1657367736883,CSE 134B,A01,083661,Powell; Thomas Allan,22,0,100,78
1657367742911,CSE 140,A01,083663,Gungor; Onat,14,0,85,71
1657367748940,CSE 140L,A01,083088,Eldon; John,21,0,100,79
1657367754968,CSE 175,A01,083665,Kumar; Rakesh,3,0,25,22
1657367760990,CSE 190,A00,092507,Dubnov; Shlomo,7,0,20,13
1657367767016,ECE 45,A01,083139,Congero; Spencer William,6,0,75,69
1657367773041,ECE 65,A50,083695,Saad; Andrew S,12,0,30,18
1657367773041,ECE 65,A51,095125,Saad; Andrew S,24,0,26,2
1657367779066,ECE 109,A01,091882,Touri; Behrouz,19,0,70,51
1657367785105,ECE 180,A00,083140,Abi Samra; Nicholas Camill,1,0,30,29
1657367785105,ECE 180,B00,083141,Abi Samra; Nicholas Camill,0,0,30,30
1657367791130,MATH 10A,A01,083735,Patchell; Gregory David,2,0,30,28
1657367791130,MATH 10A,A02,083736,Patchell; Gregory David,20,0,30,10
1657367791130,MATH 10A,A03,083737,Patchell; Gregory David,16,0,30,14
1657367797163,MATH 10B,A01,083207,Lim; Seonhee,8,0,34,26
1657367797163,MATH 10B,A02,083208,Lim; Seonhee,9,0,35,26
1657367797163,MATH 10B,A03,093472,Lim; Seonhee,7,0,34,27
1657367797163,MATH 10B,B01,083739,Sinha; Shubham,12,0,30,18
1657367803187,MATH 18,A01,083743,Cinel; Cameron Alexander,7,0,30,23
1657367803187,MATH 18,A02,083744,Cinel; Cameron Alexander,17,0,30,13
1657367803187,MATH 18,A03,083745,Cinel; Cameron Alexander,9,0,30,21
1657367803187,MATH 18,B01,083748,Rideout; David Porter,5,0,37,32
1657367803187,MATH 18,B02,083749,Rideout; David Porter,5,0,36,31
1657367803187,MATH 18,B03,083750,Rideout; David Porter,3,0,37,34
1657367803187,MATH 18,B04,083751,Rideout; David Porter,6,0,36,30
1657367803187,MATH 18,B05,093473,Rideout; David Porter,6,0,36,30
1657367803187,MATH 18,B06,093474,Rideout; David Porter,6,0,36,30
1657367809220,MATH 20A,A01,083754,Zheng; Zequn,14,0,40,26
1657367815244,MATH 20B,A01,083756,Briones; Jor-el Thomas Caparas,4,0,36,32
1657367815244,MATH 20B,A02,083757,Briones; Jor-el Thomas Caparas,1,0,36,35
1657367815244,MATH 20B,A03,093475,Briones; Jor-el Thomas Caparas,2,0,36,34
1657367821272,MATH 20C,A01,083760,Briones; Jor-el Thomas Caparas,1,0,35,34
1657367821272,MATH 20C,A02,083761,Briones; Jor-el Thomas Caparas,8,0,35,27
1657367821272,MATH 20C,A03,093476,Briones; Jor-el Thomas Caparas,0,1,36,36
1657367821272,MATH 20C,B01,083762,Bach; Quang Tran,1,0,30,29
1657367827302,MATH 20D,A01,083765,Tran; Brian Kha,5,0,30,25
1657367827302,MATH 20D,A02,083766,Tran; Brian Kha,5,0,30,25
1657367827302,MATH 20D,A03,083767,Tran; Brian Kha,5,0,30,25
1657367833335,MATH 20E,A01,083771,Ganguly; Soumya,9,0,32,23
1657367833335,MATH 20E,A02,083772,Ganguly; Soumya,6,0,32,26
1657367833335,MATH 20E,B01,083773,Ciotti; Benjamin,20,0,35,15
1657367833335,MATH 20E,B02,083774,Ciotti; Benjamin,17,0,35,18
1657367839371,MATH 103A,A01,083777,Greenfeld; Be'Eri,3,0,36,33
1657367839371,MATH 103A,A02,083778,Greenfeld; Be'Eri,5,0,36,31
1657367839371,MATH 103A,A03,093561,Greenfeld; Be'Eri,5,0,36,31
1657367839371,MATH 103A,B01,083779,Greenfeld; Be'Eri,7,0,36,29
1657367839371,MATH 103A,B02,083780,Greenfeld; Be'Eri,4,0,36,32
1657367839371,MATH 103A,B03,093562,Greenfeld; Be'Eri,3,0,36,33
1657367845399,MATH 105,A01,085443,Carter; Anne Toulson,15,0,35,20
1657367845399,MATH 105,A02,093477,Carter; Anne Toulson,20,0,35,15
1657367851427,MATH 109,A01,083213,Ganzberger; Geoffrey Michael,2,0,34,32
1657367851427,MATH 109,A02,083214,Ganzberger; Geoffrey Michael,4,0,34,30
1657367851427,MATH 109,A03,093478,Ganzberger; Geoffrey Michael,2,0,34,32
1657367851427,MATH 109,B01,083215,Ganzberger; Geoffrey Michael,1,0,32,31
1657367851427,MATH 109,B02,083216,Ganzberger; Geoffrey Michael,2,0,32,30
1657367851427,MATH 109,B03,093479,Ganzberger; Geoffrey Michael,8,0,32,24
1657367857453,MATH 142A,A01,083219,Chow; Bennett,7,0,32,25
1657367857453,MATH 142A,A02,083220,Chow; Bennett,10,0,32,22
1657367857453,MATH 142A,A03,093480,Chow; Bennett,8,0,32,24
1657367857453,MATH 142A,B03,093481,Chow; Bennett,8,0,32,24
1657367857453,MATH 142A,B04,093558,Chow; Bennett,13,0,32,19
1657367857453,MATH 142A,B05,093559,Chow; Bennett,6,0,32,26
1657367863477,MATH 193A,A01,083224,Rotar; Vladimir,8,0,34,26
1657367863477,MATH 193A,A02,083225,Rotar; Vladimir,9,0,34,25
1657367863477,MATH 193A,A03,083781,Rotar; Vladimir,5,0,34,29
1657367863477,MATH 193A,A04,083782,Rotar; Vladimir,10,0,34,24
1657367863477,MATH 193A,A05,093482,Rotar; Vladimir,10,0,34,24
1657367869501,MATH 197,001,091859,McAuley; Julian John,9999,0,9999,0
1657367869501,MATH 197,002,095566,Kedlaya; Kiran S.,9997,0,9999,2
1657367869501,MATH 197,003,095567,Xiao; Ming,9999,0,9999,0
1657367869501,MATH 197,004,095571,Perols; Johan Lars,9998,0,9999,1
1657367876579,COGS 9,A01,083615,Shannon; Kyle Michael,9,0,75,66
1657367882607,COGS 11,A01,083617,Boyle; Mary E. T.,22,0,48,26
1657367888648,COGS 13,A01,083071,Bastos; Amalia Pinkusfeld,11,0,71,60
1657367894678,COGS 14A,A01,092681,Semenuks; Arturs,4,1,100,96
1657367900704,COGS 14B,A01,083073,Cheng; Tzu-Han,6,0,63,57
1657367906733,COGS 17,A01,092677,Semenuks; Arturs,6,0,81,75
1657367912758,COGS 100,A01,083619,Allen; Michael Gordon,17,0,70,53
1657367918784,COGS 101A,A01,083621,Davis; Joshua Daniel,9,0,68,59
1657367924814,COGS 101B,A01,091572,Allen; Michael Gordon,11,0,65,54
1657367930842,COGS 101C,A01,083625,Delgado; Tania,17,0,35,18
1657367936871,COGS 107A,A01,083627,Boyle; Mary E. T.,13,0,60,47
1657367942897,COGS 118A,A01,083075,Gupta; Anjum,20,0,76,56
1657367948934,CSE 3,A50,083646,Miranda; Gregory Joseph,24,0,50,26
1657367954966,CSE 8A,A50,083650,Miranda; Gregory Joseph,17,1,56,39
1657367960991,CSE 11,A01,083080,Cao; Yingjun,6,15,40,34
1657367967020,CSE 12,A01,083652,Krause-Levy; Sophia Louisa,28,1,120,92
1657367973051,CSE 15L,A01,083654,Morris; Justin Loren,9,0,50,41
1657367973051,CSE 15L,A02,083655,Morris; Justin Loren,9,0,50,41
1657367979083,CSE 20,A01,083657,Tran; Khoa Dang,39,0,80,41
1657367985111,CSE 21,A01,095574,Bach; Quang Tran,22,0,48,26
1657367991142,CSE 30,A01,083084,Eldon; John,4,0,80,76
1657367991142,CSE 30,B01,095061,Bhaskar; Nishant,9,0,50,41
1657367997168,CSE 100,A01,083659,Cao; Yingjun,5,4,70,65
1657368003195,CSE 134B,A01,083661,Powell; Thomas Allan,22,0,100,78
1657368009242,CSE 140,A01,083663,Gungor; Onat,14,0,85,71
1657368015292,CSE 140L,A01,083088,Eldon; John,21,0,100,79
1657368021319,CSE 175,A01,083665,Kumar; Rakesh,3,0,25,22
1657368027348,CSE 190,A00,092507,Dubnov; Shlomo,7,0,20,13
1657368033380,ECE 45,A01,083139,Congero; Spencer William,6,0,75,69
1657368039404,ECE 65,A50,083695,Saad; Andrew S,12,0,30,18
1657368039404,ECE 65,A51,095125,Saad; Andrew S,24,0,26,2
1657368045431,ECE 109,A01,091882,Touri; Behrouz,19,0,70,51
1657368051459,ECE 180,A00,083140,Abi Samra; Nicholas Camill,1,0,30,29
1657368051459,ECE 180,B00,083141,Abi Samra; Nicholas Camill,0,0,30,30
1657368057495,MATH 10A,A01,083735,Patchell; Gregory David,2,0,30,28
1657368057495,MATH 10A,A02,083736,Patchell; Gregory David,20,0,30,10
1657368057495,MATH 10A,A03,083737,Patchell; Gregory David,16,0,30,14
1657368063529,MATH 10B,A01,083207,Lim; Seonhee,8,0,34,26
1657368063529,MATH 10B,A02,083208,Lim; Seonhee,9,0,35,26
1657368063529,MATH 10B,A03,093472,Lim; Seonhee,7,0,34,27
1657368063529,MATH 10B,B01,083739,Sinha; Shubham,12,0,30,18
1657368069567,MATH 18,A01,083743,Cinel; Cameron Alexander,7,0,30,23
1657368069567,MATH 18,A02,083744,Cinel; Cameron Alexander,17,0,30,13
1657368069567,MATH 18,A03,083745,Cinel; Cameron Alexander,9,0,30,21
1657368069567,MATH 18,B01,083748,Rideout; David Porter,5,0,37,32
1657368069567,MATH 18,B02,083749,Rideout; David Porter,5,0,36,31
1657368069567,MATH 18,B03,083750,Rideout; David Porter,3,0,37,34
1657368069567,MATH 18,B04,083751,Rideout; David Porter,6,0,36,30
1657368069567,MATH 18,B05,093473,Rideout; David Porter,6,0,36,30
1657368069567,MATH 18,B06,093474,Rideout; David Porter,6,0,36,30
1657368075596,MATH 20A,A01,083754,Zheng; Zequn,14,0,40,26
1657368081621,MATH 20B,A01,083756,Briones; Jor-el Thomas Caparas,4,0,36,32
1657368081621,MATH 20B,A02,083757,Briones; Jor-el Thomas Caparas,1,0,36,35
1657368081621,MATH 20B,A03,093475,Briones; Jor-el Thomas Caparas,2,0,36,34
1657368087659,MATH 20C,A01,083760,Briones; Jor-el Thomas Caparas,1,0,35,34
1657368087659,MATH 20C,A02,083761,Briones; Jor-el Thomas Caparas,8,0,35,27
1657368087659,MATH 20C,A03,093476,Briones; Jor-el Thomas Caparas,0,1,36,36
1657368087659,MATH 20C,B01,083762,Bach; Quang Tran,1,0,30,29
1657368093693,MATH 20D,A01,083765,Tran; Brian Kha,5,0,30,25
1657368093693,MATH 20D,A02,083766,Tran; Brian Kha,5,0,30,25
1657368093693,MATH 20D,A03,083767,Tran; Brian Kha,5,0,30,25
1657368099720,MATH 20E,A01,083771,Ganguly; Soumya,9,0,32,23
1657368099720,MATH 20E,A02,083772,Ganguly; Soumya,6,0,32,26
1657368099720,MATH 20E,B01,083773,Ciotti; Benjamin,20,0,35,15
1657368099720,MATH 20E,B02,083774,Ciotti; Benjamin,17,0,35,18
1657368105753,MATH 103A,A01,083777,Greenfeld; Be'Eri,3,0,36,33
1657368105753,MATH 103A,A02,083778,Greenfeld; Be'Eri,5,0,36,31
1657368105753,MATH 103A,A03,093561,Greenfeld; Be'Eri,5,0,36,31
1657368105753,MATH 103A,B01,083779,Greenfeld; Be'Eri,7,0,36,29
1657368105753,MATH 103A,B02,083780,Greenfeld; Be'Eri,4,0,36,32
1657368105753,MATH 103A,B03,093562,Greenfeld; Be'Eri,3,0,36,33
1657368111793,MATH 105,A01,085443,Carter; Anne Toulson,15,0,35,20
1657368111793,MATH 105,A02,093477,Carter; Anne Toulson,20,0,35,15
1657368117822,MATH 109,A01,083213,Ganzberger; Geoffrey Michael,2,0,34,32
1657368117822,MATH 109,A02,083214,Ganzberger; Geoffrey Michael,4,0,34,30
1657368117822,MATH 109,A03,093478,Ganzberger; Geoffrey Michael,2,0,34,32
1657368117822,MATH 109,B01,083215,Ganzberger; Geoffrey Michael,1,0,32,31
1657368117822,MATH 109,B02,083216,Ganzberger; Geoffrey Michael,2,0,32,30
1657368117822,MATH 109,B03,093479,Ganzberger; Geoffrey Michael,8,0,32,24
1657368123852,MATH 142A,A01,083219,Chow; Bennett,7,0,32,25
1657368123852,MATH 142A,A02,083220,Chow; Bennett,10,0,32,22
1657368123852,MATH 142A,A03,093480,Chow; Bennett,8,0,32,24
1657368123852,MATH 142A,B03,093481,Chow; Bennett,8,0,32,24
1657368123852,MATH 142A,B04,093558,Chow; Bennett,13,0,32,19
1657368123852,MATH 142A,B05,093559,Chow; Bennett,6,0,32,26
1657368129887,MATH 193A,A01,083224,Rotar; Vladimir,8,0,34,26
1657368129887,MATH 193A,A02,083225,Rotar; Vladimir,9,0,34,25
1657368129887,MATH 193A,A03,083781,Rotar; Vladimir,5,0,34,29
1657368129887,MATH 193A,A04,083782,Rotar; Vladimir,10,0,34,24
1657368129887,MATH 193A,A05,093482,Rotar; Vladimir,10,0,34,24
1657368135916,MATH 197,001,091859,McAuley; Julian John,9999,0,9999,0
1657368135916,MATH 197,002,095566,Kedlaya; Kiran S.,9997,0,9999,2
1657368135916,MATH 197,003,095567,Xiao; Ming,9999,0,9999,0
1657368135916,MATH 197,004,095571,Perols; Johan Lars,9998,0,9999,1
1657368142994,COGS 9,A01,083615,Shannon; Kyle Michael,9,0,75,66
1657368149034,COGS 11,A01,083617,Boyle; Mary E. T.,22,0,48,26
1657368155062,COGS 13,A01,083071,Bastos; Amalia Pinkusfeld,11,0,71,60
1657368161092,COGS 14A,A01,092681,Semenuks; Arturs,4,1,100,96
1657368167121,COGS 14B,A01,083073,Cheng; Tzu-Han,6,0,63,57
1657368173151,COGS 17,A01,092677,Semenuks; Arturs,6,0,81,75
1657368179246,COGS 100,A01,083619,Allen; Michael Gordon,17,0,70,53
1657368185290,COGS 101A,A01,083621,Davis; Joshua Daniel,9,0,68,59
1657368191317,COGS 101B,A01,091572,Allen; Michael Gordon,11,0,65,54
1657368197345,COGS 101C,A01,083625,Delgado; Tania,17,0,35,18
1657368203375,COGS 107A,A01,083627,Boyle; Mary E. T.,13,0,60,47
1657368209401,COGS 118A,A01,083075,Gupta; Anjum,20,0,76,56
1657368215427,CSE 3,A50,083646,Miranda; Gregory Joseph,24,0,50,26
1657368221455,CSE 8A,A50,083650,Miranda; Gregory Joseph,17,1,56,39
1657368227480,CSE 11,A01,083080,Cao; Yingjun,6,15,40,34
1657368233511,CSE 12,A01,083652,Krause-Levy; Sophia Louisa,28,1,120,92
1657368239537,CSE 15L,A01,083654,Morris; Justin Loren,9,0,50,41
1657368239537,CSE 15L,A02,083655,Morris; Justin Loren,9,0,50,41
1657368245575,CSE 20,A01,083657,Tran; Khoa Dang,39,0,80,41
1657368251601,CSE 21,A01,095574,Bach; Quang Tran,22,0,48,26
1657368257650,CSE 30,A01,083084,Eldon; John,4,0,80,76
1657368257650,CSE 30,B01,095061,Bhaskar; Nishant,9,0,50,41
1657368263682,CSE 100,A01,083659,Cao; Yingjun,5,4,70,65
1657368269715,CSE 134B,A01,083661,Powell; Thomas Allan,22,0,100,78
1657368275752,CSE 140,A01,083663,Gungor; Onat,14,0,85,71
1657368281790,CSE 140L,A01,083088,Eldon; John,21,0,100,79
1657368287818,CSE 175,A01,083665,Kumar; Rakesh,3,0,25,22
1657368293845,CSE 190,A00,092507,Dubnov; Shlomo,7,0,20,13
1657368299873,ECE 45,A01,083139,Congero; Spencer William,6,0,75,69
1657368305901,ECE 65,A50,083695,Saad; Andrew S,12,0,30,18
1657368305901,ECE 65,A51,095125,Saad; Andrew S,24,0,26,2
1657368311928,ECE 109,A01,091882,Touri; Behrouz,19,0,70,51
1657368317956,ECE 180,A00,083140,Abi Samra; Nicholas Camill,1,0,30,29
1657368317956,ECE 180,B00,083141,Abi Samra; Nicholas Camill,0,0,30,30
1657368323997,MATH 10A,A01,083735,Patchell; Gregory David,2,0,30,28
1657368323997,MATH 10A,A02,083736,Patchell; Gregory David,20,0,30,10
1657368323997,MATH 10A,A03,083737,Patchell; Gregory David,16,0,30,14
1657368330047,MATH 10B,A01,083207,Lim; Seonhee,8,0,34,26
1657368330047,MATH 10B,A02,083208,Lim; Seonhee,9,0,35,26
1657368330047,MATH 10B,A03,093472,Lim; Seonhee,7,0,34,27
1657368330047,MATH 10B,B01,083739,Sinha; Shubham,12,0,30,18
1657368336099,MATH 18,A01,083743,Cinel; Cameron Alexander,7,0,30,23
1657368336099,MATH 18,A02,083744,Cinel; Cameron Alexander,17,0,30,13
1657368336099,MATH 18,A03,083745,Cinel; Cameron Alexander,9,0,30,21
1657368336099,MATH 18,B01,083748,Rideout; David Porter,5,0,37,32
1657368336099,MATH 18,B02,083749,Rideout; David Porter,5,0,36,31
1657368336099,MATH 18,B03,083750,Rideout; David Porter,3,0,37,34
1657368336099,MATH 18,B04,083751,Rideout; David Porter,6,0,36,30
1657368336099,MATH 18,B05,093473,Rideout; David Porter,6,0,36,30
1657368336099,MATH 18,B06,093474,Rideout; David Porter,6,0,36,30
1657368342129,MATH 20A,A01,083754,Zheng; Zequn,14,0,40,26
1657368348180,MATH 20B,A01,083756,Briones; Jor-el Thomas Caparas,4,0,36,32
1657368348180,MATH 20B,A02,083757,Briones; Jor-el Thomas Caparas,1,0,36,35
1657368348180,MATH 20B,A03,093475,Briones; Jor-el Thomas Caparas,2,0,36,34
1657368354207,MATH 20C,A01,083760,Briones; Jor-el Thomas Caparas,1,0,35,34
1657368354207,MATH 20C,A02,083761,Briones; Jor-el Thomas Caparas,8,0,35,27
1657368354207,MATH 20C,A03,093476,Briones; Jor-el Thomas Caparas,0,1,36,36
1657368354207,MATH 20C,B01,083762,Bach; Quang Tran,1,0,30,29
1657368360233,MATH 20D,A01,083765,Tran; Brian Kha,5,0,30,25
1657368360233,MATH 20D,A02,083766,Tran; Brian Kha,5,0,30,25
1657368360233,MATH 20D,A03,083767,Tran; Brian Kha,5,0,30,25
1657368366262,MATH 20E,A01,083771,Ganguly; Soumya,9,0,32,23
1657368366262,MATH 20E,A02,083772,Ganguly; Soumya,6,0,32,26
1657368366262,MATH 20E,B01,083773,Ciotti; Benjamin,20,0,35,15
1657368366262,MATH 20E,B02,083774,Ciotti; Benjamin,17,0,35,18
1657368372315,MATH 103A,A01,083777,Greenfeld; Be'Eri,3,0,36,33
1657368372315,MATH 103A,A02,083778,Greenfeld; Be'Eri,5,0,36,31
1657368372315,MATH 103A,A03,093561,Greenfeld; Be'Eri,5,0,36,31
1657368372315,MATH 103A,B01,083779,Greenfeld; Be'Eri,7,0,36,29
1657368372315,MATH 103A,B02,083780,Greenfeld; Be'Eri,4,0,36,32
1657368372315,MATH 103A,B03,093562,Greenfeld; Be'Eri,3,0,36,33
1657368378351,MATH 105,A01,085443,Carter; Anne Toulson,15,0,35,20
1657368378351,MATH 105,A02,093477,Carter; Anne Toulson,20,0,35,15
1657368384383,MATH 109,A01,083213,Ganzberger; Geoffrey Michael,2,0,34,32
1657368384383,MATH 109,A02,083214,Ganzberger; Geoffrey Michael,4,0,34,30
1657368384383,MATH 109,A03,093478,Ganzberger; Geoffrey Michael,2,0,34,32
1657368384383,MATH 109,B01,083215,Ganzberger; Geoffrey Michael,1,0,32,31
1657368384383,MATH 109,B02,083216,Ganzberger; Geoffrey Michael,2,0,32,30
1657368384383,MATH 109,B03,093479,Ganzberger; Geoffrey Michael,8,0,32,24
1657368390440,MATH 142A,A01,083219,Chow; Bennett,7,0,32,25
1657368390440,MATH 142A,A02,083220,Chow; Bennett,10,0,32,22
1657368390440,MATH 142A,A03,093480,Chow; Bennett,8,0,32,24
1657368390440,MATH 142A,B03,093481,Chow; Bennett,8,0,32,24
1657368390440,MATH 142A,B04,093558,Chow; Bennett,13,0,32,19
1657368390440,MATH 142A,B05,093559,Chow; Bennett,6,0,32,26
1657368396474,MATH 193A,A01,083224,Rotar; Vladimir,8,0,34,26
1657368396474,MATH 193A,A02,083225,Rotar; Vladimir,9,0,34,25
1657368396474,MATH 193A,A03,083781,Rotar; Vladimir,5,0,34,29
1657368396474,MATH 193A,A04,083782,Rotar; Vladimir,10,0,34,24
1657368396474,MATH 193A,A05,093482,Rotar; Vladimir,10,0,34,24
1657368402505,MATH 197,001,091859,McAuley; Julian John,9999,0,9999,0
1657368402505,MATH 197,002,095566,Kedlaya; Kiran S.,9997,0,9999,2
1657368402505,MATH 197,003,095567,Xiao; Ming,9999,0,9999,0
1657368402505,MATH 197,004,095571,Perols; Johan Lars,9998,0,9999,1
1657368409606,COGS 9,A01,083615,Shannon; Kyle Michael,9,0,75,66
1657368415632,COGS 11,A01,083617,Boyle; Mary E. T.,22,0,48,26
1657368421666,COGS 13,A01,083071,Bastos; Amalia Pinkusfeld,11,0,71,60
1657368427695,COGS 14A,A01,092681,Semenuks; Arturs,4,1,100,96
1657368433725,COGS 14B,A01,083073,Cheng; Tzu-Han,6,0,63,57
1657368439750,COGS 17,A01,092677,Semenuks; Arturs,6,0,81,75
1657368445777,COGS 100,A01,083619,Allen; Michael Gordon,17,0,70,53
1657368451806,COGS 101A,A01,083621,Davis; Joshua Daniel,9,0,68,59
1657368457836,COGS 101B,A01,091572,Allen; Michael Gordon,11,0,65,54
1657368463867,COGS 101C,A01,083625,Delgado; Tania,17,0,35,18
1657368469899,COGS 107A,A01,083627,Boyle; Mary E. T.,13,0,60,47
1657368475925,COGS 118A,A01,083075,Gupta; Anjum,20,0,76,56
1657368481960,CSE 3,A50,083646,Miranda; Gregory Joseph,24,0,50,26
1657368487990,CSE 8A,A50,083650,Miranda; Gregory Joseph,17,1,56,39
1657368494021,CSE 11,A01,083080,Cao; Yingjun,6,15,40,34
1657368500048,CSE 12,A01,083652,Krause-Levy; Sophia Louisa,28,1,120,92
1657368506073,CSE 15L,A01,083654,Morris; Justin Loren,9,0,50,41
1657368506073,CSE 15L,A02,083655,Morris; Justin Loren,9,0,50,41
1657368512116,CSE 20,A01,083657,Tran; Khoa Dang,39,0,80,41
1657368518144,CSE 21,A01,095574,Bach; Quang Tran,22,0,48,26
1657368524171,CSE 30,A01,083084,Eldon; John,4,0,80,76
1657368524171,CSE 30,B01,095061,Bhaskar; Nishant,9,0,50,41
1657368530199,CSE 100,A01,083659,Cao; Yingjun,5,4,70,65
1657368536232,CSE 134B,A01,083661,Powell; Thomas Allan,22,0,100,78
1657368542260,CSE 140,A01,083663,Gungor; Onat,14,0,85,71
1657368548290,CSE 140L,A01,083088,Eldon; John,21,0,100,79
1657368554322,CSE 175,A01,083665,Kumar; Rakesh,3,0,25,22
1657368560364,CSE 190,A00,092507,Dubnov; Shlomo,7,0,20,13
1657368566392,ECE 45,A01,083139,Congero; Spencer William,6,0,75,69
1657368572424,ECE 65,A50,083695,Saad; Andrew S,12,0,30,18
1657368572424,ECE 65,A51,095125,Saad; Andrew S,24,0,26,2
1657368578455,ECE 109,A01,091882,Touri; Behrouz,19,0,70,51
1657368584483,ECE 180,A00,083140,Abi Samra; Nicholas Camill,1,0,30,29
1657368584483,ECE 180,B00,083141,Abi Samra; Nicholas Camill,0,0,30,30
1657368590517,MATH 10A,A01,083735,Patchell; Gregory David,2,0,30,28
1657368590517,MATH 10A,A02,083736,Patchell; Gregory David,20,0,30,10
1657368590517,MATH 10A,A03,083737,Patchell; Gregory David,16,0,30,14
1657368596552,MATH 10B,A01,083207,Lim; Seonhee,8,0,34,26
1657368596552,MATH 10B,A02,083208,Lim; Seonhee,9,0,35,26
1657368596552,MATH 10B,A03,093472,Lim; Seonhee,7,0,34,27
1657368596552,MATH 10B,B01,083739,Sinha; Shubham,12,0,30,18
1657368602590,MATH 18,A01,083743,Cinel; Cameron Alexander,7,0,30,23
1657368602590,MATH 18,A02,083744,Cinel; Cameron Alexander,17,0,30,13
1657368602590,MATH 18,A03,083745,Cinel; Cameron Alexander,9,0,30,21
1657368602590,MATH 18,B01,083748,Rideout; David Porter,5,0,37,32
1657368602590,MATH 18,B02,083749,Rideout; David Porter,5,0,36,31
1657368602590,MATH 18,B03,083750,Rideout; David Porter,3,0,37,34
1657368602590,MATH 18,B04,083751,Rideout; David Porter,6,0,36,30
1657368602590,MATH 18,B05,093473,Rideout; David Porter,6,0,36,30
1657368602590,MATH 18,B06,093474,Rideout; David Porter,6,0,36,30
1657368608621,MATH 20A,A01,083754,Zheng; Zequn,14,0,40,26
1657368614648,MATH 20B,A01,083756,Briones; Jor-el Thomas Caparas,4,0,36,32
1657368614648,MATH 20B,A02,083757,Briones; Jor-el Thomas Caparas,1,0,36,35
1657368614648,MATH 20B,A03,093475,Briones; Jor-el Thomas Caparas,2,0,36,34
1657368620683,MATH 20C,A01,083760,Briones; Jor-el Thomas Caparas,1,0,35,34
1657368620683,MATH 20C,A02,083761,Briones; Jor-el Thomas Caparas,8,0,35,27
1657368620683,MATH 20C,A03,093476,Briones; Jor-el Thomas Caparas,0,1,36,36
1657368620683,MATH 20C,B01,083762,Bach; Quang Tran,1,0,30,29
1657368626714,MATH 20D,A01,083765,Tran; Brian Kha,5,0,30,25
1657368626714,MATH 20D,A02,083766,Tran; Brian Kha,5,0,30,25
1657368626714,MATH 20D,A03,083767,Tran; Brian Kha,5,0,30,25
1657368632748,MATH 20E,A01,083771,Ganguly; Soumya,9,0,32,23
1657368632748,MATH 20E,A02,083772,Ganguly; Soumya,6,0,32,26
1657368632748,MATH 20E,B01,083773,Ciotti; Benjamin,20,0,35,15
1657368632748,MATH 20E,B02,083774,Ciotti; Benjamin,17,0,35,18
1657368638781,MATH 103A,A01,083777,Greenfeld; Be'Eri,3,0,36,33
1657368638781,MATH 103A,A02,083778,Greenfeld; Be'Eri,5,0,36,31
1657368638781,MATH 103A,A03,093561,Greenfeld; Be'Eri,5,0,36,31
1657368638781,MATH 103A,B01,083779,Greenfeld; Be'Eri,7,0,36,29
1657368638781,MATH 103A,B02,083780,Greenfeld; Be'Eri,4,0,36,32
1657368638781,MATH 103A,B03,093562,Greenfeld; Be'Eri,3,0,36,33
1657368644807,MATH 105,A01,085443,Carter; Anne Toulson,15,0,35,20
1657368644807,MATH 105,A02,093477,Carter; Anne Toulson,20,0,35,15
1657368650844,MATH 109,A01,083213,Ganzberger; Geoffrey Michael,2,0,34,32
1657368650844,MATH 109,A02,083214,Ganzberger; Geoffrey Michael,4,0,34,30
1657368650844,MATH 109,A03,093478,Ganzberger; Geoffrey Michael,2,0,34,32
1657368650844,MATH 109,B01,083215,Ganzberger; Geoffrey Michael,1,0,32,31
1657368650844,MATH 109,B02,083216,Ganzberger; Geoffrey Michael,2,0,32,30
1657368650844,MATH 109,B03,093479,Ganzberger; Geoffrey Michael,8,0,32,24
1657368656890,MATH 142A,A01,083219,Chow; Bennett,7,0,32,25
1657368656890,MATH 142A,A02,083220,Chow; Bennett,10,0,32,22
1657368656890,MATH 142A,A03,093480,Chow; Bennett,8,0,32,24
1657368656890,MATH 142A,B03,093481,Chow; Bennett,8,0,32,24
1657368656890,MATH 142A,B04,093558,Chow; Bennett,13,0,32,19
1657368656890,MATH 142A,B05,093559,Chow; Bennett,6,0,32,26
1657368662921,MATH 193A,A01,083224,Rotar; Vladimir,8,0,34,26
1657368662921,MATH 193A,A02,083225,Rotar; Vladimir,9,0,34,25
1657368662921,MATH 193A,A03,083781,Rotar; Vladimir,5,0,34,29
1657368662921,MATH 193A,A04,083782,Rotar; Vladimir,10,0,34,24
1657368662921,MATH 193A,A05,093482,Rotar; Vladimir,10,0,34,24
1657368668949,MATH 197,001,091859,McAuley; Julian John,9999,0,9999,0
1657368668949,MATH 197,002,095566,Kedlaya; Kiran S.,9997,0,9999,2
1657368668949,MATH 197,003,095567,Xiao; Ming,9999,0,9999,0
1657368668949,MATH 197,004,095571,Perols; Johan Lars,9998,0,9999,1
1657368676030,COGS 9,A01,083615,Shannon; Kyle Michael,9,0,75,66
1657368682054,COGS 11,A01,083617,Boyle; Mary E. T.,22,0,48,26
1657368688087,COGS 13,A01,083071,Bastos; Amalia Pinkusfeld,11,0,71,60
1657368694120,COGS 14A,A01,092681,Semenuks; Arturs,4,1,100,96
1657368700152,COGS 14B,A01,083073,Cheng; Tzu-Han,6,0,63,57
1657368706179,COGS 17,A01,092677,Semenuks; Arturs,6,0,81,75
1657368712206,COGS 100,A01,083619,Allen; Michael Gordon,17,0,70,53
1657368718236,COGS 101A,A01,083621,Davis; Joshua Daniel,9,0,68,59
1657368724270,COGS 101B,A01,091572,Allen; Michael Gordon,11,0,65,54
1657368730303,COGS 101C,A01,083625,Delgado; Tania,17,0,35,18
1657368736344,COGS 107A,A01,083627,Boyle; Mary E. T.,13,0,60,47
1657368743120,COGS 118A,A01,083075,Gupta; Anjum,20,0,76,56
1657368749151,CSE 3,A50,083646,Miranda; Gregory Joseph,24,0,50,26
1657368758127,CSE 8A,A50,083650,Miranda; Gregory Joseph,17,1,56,39
1657368764168,CSE 11,A01,083080,Cao; Yingjun,6,15,40,34
1657368770203,CSE 12,A01,083652,Krause-Levy; Sophia Louisa,28,1,120,92
1657368776228,CSE 15L,A01,083654,Morris; Justin Loren,9,0,50,41
1657368776228,CSE 15L,A02,083655,Morris; Justin Loren,9,0,50,41
1657368782351,CSE 20,A01,083657,Tran; Khoa Dang,39,0,80,41
1657368788386,CSE 21,A01,095574,Bach; Quang Tran,22,0,48,26
1657368794416,CSE 30,A01,083084,Eldon; John,4,0,80,76
1657368794416,CSE 30,B01,095061,Bhaskar; Nishant,9,0,50,41
1657368800441,CSE 100,A01,083659,Cao; Yingjun,5,4,70,65
1657368806467,CSE 134B,A01,083661,Powell; Thomas Allan,22,0,100,78
1657368812501,CSE 140,A01,083663,Gungor; Onat,14,0,85,71
1657368818549,CSE 140L,A01,083088,Eldon; John,21,0,100,79
1657368824584,CSE 175,A01,083665,Kumar; Rakesh,3,0,25,22
1657368830620,CSE 190,A00,092507,Dubnov; Shlomo,7,0,20,13
1657368836648,ECE 45,A01,083139,Congero; Spencer William,6,0,75,69
1657368842681,ECE 65,A50,083695,Saad; Andrew S,12,0,30,18
1657368842681,ECE 65,A51,095125,Saad; Andrew S,24,0,26,2
1657368848708,ECE 109,A01,091882,Touri; Behrouz,19,0,70,51
1657368854739,ECE 180,A00,083140,Abi Samra; Nicholas Camill,1,0,30,29
1657368854739,ECE 180,B00,083141,Abi Samra; Nicholas Camill,0,0,30,30
1657368860785,MATH 10A,A01,083735,Patchell; Gregory David,2,0,30,28
1657368860785,MATH 10A,A02,083736,Patchell; Gregory David,20,0,30,10
1657368860785,MATH 10A,A03,083737,Patchell; Gregory David,16,0,30,14
1657368876955,MATH 10B,A01,083207,Lim; Seonhee,8,0,34,26
1657368876955,MATH 10B,A02,083208,Lim; Seonhee,9,0,35,26
1657368876955,MATH 10B,A03,093472,Lim; Seonhee,7,0,34,27
1657368876955,MATH 10B,B01,083739,Sinha; Shubham,12,0,30,18
1657368883002,MATH 18,A01,083743,Cinel; Cameron Alexander,7,0,30,23
1657368883002,MATH 18,A02,083744,Cinel; Cameron Alexander,17,0,30,13
1657368883002,MATH 18,A03,083745,Cinel; Cameron Alexander,9,0,30,21
1657368883002,MATH 18,B01,083748,Rideout; David Porter,5,0,37,32
1657368883002,MATH 18,B02,083749,Rideout; David Porter,5,0,36,31
1657368883002,MATH 18,B03,083750,Rideout; David Porter,3,0,37,34
1657368883002,MATH 18,B04,083751,Rideout; David Porter,6,0,36,30
1657368883002,MATH 18,B05,093473,Rideout; David Porter,6,0,36,30
1657368883002,MATH 18,B06,093474,Rideout; David Porter,6,0,36,30
1657368889034,MATH 20A,A01,083754,Zheng; Zequn,14,0,40,26
1657368895073,MATH 20B,A01,083756,Briones; Jor-el Thomas Caparas,4,0,36,32
1657368895073,MATH 20B,A02,083757,Briones; Jor-el Thomas Caparas,1,0,36,35
1657368895073,MATH 20B,A03,093475,Briones; Jor-el Thomas Caparas,2,0,36,34
1657368901102,MATH 20C,A01,083760,Briones; Jor-el Thomas Caparas,1,0,35,34
1657368901102,MATH 20C,A02,083761,Briones; Jor-el Thomas Caparas,8,0,35,27
1657368901102,MATH 20C,A03,093476,Briones; Jor-el Thomas Caparas,0,1,36,36
1657368901102,MATH 20C,B01,083762,Bach; Quang Tran,1,0,30,29
1657368907135,MATH 20D,A01,083765,Tran; Brian Kha,5,0,30,25
1657368907135,MATH 20D,A02,083766,Tran; Brian Kha,5,0,30,25
1657368907135,MATH 20D,A03,083767,Tran; Brian Kha,5,0,30,25
1657368913171,MATH 20E,A01,083771,Ganguly; Soumya,9,0,32,23
1657368913171,MATH 20E,A02,083772,Ganguly; Soumya,6,0,32,26
1657368913171,MATH 20E,B01,083773,Ciotti; Benjamin,20,0,35,15
1657368913171,MATH 20E,B02,083774,Ciotti; Benjamin,17,0,35,18
1657368919215,MATH 103A,A01,083777,Greenfeld; Be'Eri,3,0,36,33
1657368919215,MATH 103A,A02,083778,Greenfeld; Be'Eri,5,0,36,31
1657368919215,MATH 103A,A03,093561,Greenfeld; Be'Eri,5,0,36,31
1657368919215,MATH 103A,B01,083779,Greenfeld; Be'Eri,7,0,36,29
1657368919215,MATH 103A,B02,083780,Greenfeld; Be'Eri,4,0,36,32
1657368919215,MATH 103A,B03,093562,Greenfeld; Be'Eri,3,0,36,33
1657368925259,MATH 105,A01,085443,Carter; Anne Toulson,15,0,35,20
1657368925259,MATH 105,A02,093477,Carter; Anne Toulson,20,0,35,15
1657368931295,MATH 109,A01,083213,Ganzberger; Geoffrey Michael,2,0,34,32
1657368931295,MATH 109,A02,083214,Ganzberger; Geoffrey Michael,4,0,34,30
1657368931295,MATH 109,A03,093478,Ganzberger; Geoffrey Michael,2,0,34,32
1657368931295,MATH 109,B01,083215,Ganzberger; Geoffrey Michael,1,0,32,31
1657368931295,MATH 109,B02,083216,Ganzberger; Geoffrey Michael,2,0,32,30
1657368931295,MATH 109,B03,093479,Ganzberger; Geoffrey Michael,8,0,32,24
1657368937331,MATH 142A,A01,083219,Chow; Bennett,7,0,32,25
1657368937331,MATH 142A,A02,083220,Chow; Bennett,10,0,32,22
1657368937331,MATH 142A,A03,093480,Chow; Bennett,8,0,32,24
1657368937331,MATH 142A,B03,093481,Chow; Bennett,8,0,32,24
1657368937331,MATH 142A,B04,093558,Chow; Bennett,13,0,32,19
1657368937331,MATH 142A,B05,093559,Chow; Bennett,6,0,32,26
1657368943358,MATH 193A,A01,083224,Rotar; Vladimir,8,0,34,26
1657368943358,MATH 193A,A02,083225,Rotar; Vladimir,9,0,34,25
1657368943358,MATH 193A,A03,083781,Rotar; Vladimir,5,0,34,29
1657368943358,MATH 193A,A04,083782,Rotar; Vladimir,10,0,34,24
1657368943358,MATH 193A,A05,093482,Rotar; Vladimir,10,0,34,24
1657368949391,MATH 197,001,091859,McAuley; Julian John,9999,0,9999,0
1657368949391,MATH 197,002,095566,Kedlaya; Kiran S.,9997,0,9999,2
1657368949391,MATH 197,003,095567,Xiao; Ming,9999,0,9999,0
1657368949391,MATH 197,004,095571,Perols; Johan Lars,9998,0,9999,1
1657368956503,COGS 9,A01,083615,Shannon; Kyle Michael,9,0,75,66
1657368962535,COGS 11,A01,083617,Boyle; Mary E. T.,22,0,48,26
1657368968572,COGS 13,A01,083071,Bastos; Amalia Pinkusfeld,11,0,71,60
1657368974598,COGS 14A,A01,092681,Semenuks; Arturs,4,1,100,96
1657368980630,COGS 14B,A01,083073,Cheng; Tzu-Han,6,0,63,57
1657368986656,COGS 17,A01,092677,Semenuks; Arturs,6,0,81,75
1657368992684,COGS 100,A01,083619,Allen; Michael Gordon,17,0,70,53
1657368998721,COGS 101A,A01,083621,Davis; Joshua Daniel,9,0,68,59
1657369004755,COGS 101B,A01,091572,Allen; Michael Gordon,11,0,65,54
1657369010782,COGS 101C,A01,083625,Delgado; Tania,17,0,35,18
1657369016806,COGS 107A,A01,083627,Boyle; Mary E. T.,13,0,60,47
1657369022839,COGS 118A,A01,083075,Gupta; Anjum,20,0,76,56
1657369028877,CSE 3,A50,083646,Miranda; Gregory Joseph,24,0,50,26
1657369034912,CSE 8A,A50,083650,Miranda; Gregory Joseph,17,1,56,39
1657369040940,CSE 11,A01,083080,Cao; Yingjun,6,15,40,34
1657369046967,CSE 12,A01,083652,Krause-Levy; Sophia Louisa,28,1,120,92
1657369053002,CSE 15L,A01,083654,Morris; Justin Loren,9,0,50,41
1657369053002,CSE 15L,A02,083655,Morris; Justin Loren,9,0,50,41
1657369059037,CSE 20,A01,083657,Tran; Khoa Dang,39,0,80,41
1657369065071,CSE 21,A01,095574,Bach; Quang Tran,22,0,48,26
1657369071114,CSE 30,A01,083084,Eldon; John,4,0,80,76
1657369071114,CSE 30,B01,095061,Bhaskar; Nishant,9,0,50,41
1657369077140,CSE 100,A01,083659,Cao; Yingjun,5,4,70,65
1657369083165,CSE 134B,A01,083661,Powell; Thomas Allan,22,0,100,78
1657369089192,CSE 140,A01,083663,Gungor; Onat,14,0,85,71
1657369095220,CSE 140L,A01,083088,Eldon; John,21,0,100,79
1657369101251,CSE 175,A01,083665,Kumar; Rakesh,3,0,25,22
1657369107284,CSE 190,A00,092507,Dubnov; Shlomo,7,0,20,13
1657369113315,ECE 45,A01,083139,Congero; Spencer William,6,0,75,69
1657369119352,ECE 65,A50,083695,Saad; Andrew S,12,0,30,18
1657369119352,ECE 65,A51,095125,Saad; Andrew S,24,0,26,2
1657369125383,ECE 109,A01,091882,Touri; Behrouz,19,0,70,51
1657369131408,ECE 180,A00,083140,Abi Samra; Nicholas Camill,1,0,30,29
1657369131408,ECE 180,B00,083141,Abi Samra; Nicholas Camill,0,0,30,30
1657369137436,MATH 10A,A01,083735,Patchell; Gregory David,2,0,30,28
1657369137436,MATH 10A,A02,083736,Patchell; Gregory David,20,0,30,10
1657369137436,MATH 10A,A03,083737,Patchell; Gregory David,16,0,30,14
1657369143468,MATH 10B,A01,083207,Lim; Seonhee,8,0,34,26
1657369143468,MATH 10B,A02,083208,Lim; Seonhee,9,0,35,26
1657369143468,MATH 10B,A03,093472,Lim; Seonhee,7,0,34,27
1657369143468,MATH 10B,B01,083739,Sinha; Shubham,12,0,30,18
1657369149501,MATH 18,A01,083743,Cinel; Cameron Alexander,7,0,30,23
1657369149501,MATH 18,A02,083744,Cinel; Cameron Alexander,17,0,30,13
1657369149501,MATH 18,A03,083745,Cinel; Cameron Alexander,9,0,30,21
1657369149501,MATH 18,B01,083748,Rideout; David Porter,5,0,37,32
1657369149501,MATH 18,B02,083749,Rideout; David Porter,5,0,36,31
1657369149501,MATH 18,B03,083750,Rideout; David Porter,3,0,37,34
1657369149501,MATH 18,B04,083751,Rideout; David Porter,6,0,36,30
1657369149501,MATH 18,B05,093473,Rideout; David Porter,6,0,36,30
1657369149501,MATH 18,B06,093474,Rideout; David Porter,6,0,36,30
1657369155530,MATH 20A,A01,083754,Zheng; Zequn,14,0,40,26
1657369161556,MATH 20B,A01,083756,Briones; Jor-el Thomas Caparas,4,0,36,32
1657369161556,MATH 20B,A02,083757,Briones; Jor-el Thomas Caparas,1,0,36,35
1657369161556,MATH 20B,A03,093475,Briones; Jor-el Thomas Caparas,2,0,36,34
1657369167582,MATH 20C,A01,083760,Briones; Jor-el Thomas Caparas,1,0,35,34
1657369167582,MATH 20C,A02,083761,Briones; Jor-el Thomas Caparas,8,0,35,27
1657369167582,MATH 20C,A03,093476,Briones; Jor-el Thomas Caparas,0,1,36,36
1657369167582,MATH 20C,B01,083762,Bach; Quang Tran,1,0,30,29
1657369173627,MATH 20D,A01,083765,Tran; Brian Kha,5,0,30,25
1657369173627,MATH 20D,A02,083766,Tran; Brian Kha,5,0,30,25
1657369173627,MATH 20D,A03,083767,Tran; Brian Kha,5,0,30,25
1657369179657,MATH 20E,A01,083771,Ganguly; Soumya,9,0,32,23
1657369179657,MATH 20E,A02,083772,Ganguly; Soumya,6,0,32,26
1657369179657,MATH 20E,B01,083773,Ciotti; Benjamin,20,0,35,15
1657369179657,MATH 20E,B02,083774,Ciotti; Benjamin,17,0,35,18
1657369185687,MATH 103A,A01,083777,Greenfeld; Be'Eri,3,0,36,33
1657369185687,MATH 103A,A02,083778,Greenfeld; Be'Eri,5,0,36,31
1657369185687,MATH 103A,A03,093561,Greenfeld; Be'Eri,5,0,36,31
1657369185687,MATH 103A,B01,083779,Greenfeld; Be'Eri,7,0,36,29
1657369185687,MATH 103A,B02,083780,Greenfeld; Be'Eri,4,0,36,32
1657369185687,MATH 103A,B03,093562,Greenfeld; Be'Eri,3,0,36,33
1657369191714,MATH 105,A01,085443,Carter; Anne Toulson,15,0,35,20
1657369191714,MATH 105,A02,093477,Carter; Anne Toulson,20,0,35,15
1657369197742,MATH 109,A01,083213,Ganzberger; Geoffrey Michael,2,0,34,32
1657369197742,MATH 109,A02,083214,Ganzberger; Geoffrey Michael,4,0,34,30
1657369197742,MATH 109,A03,093478,Ganzberger; Geoffrey Michael,2,0,34,32
1657369197742,MATH 109,B01,083215,Ganzberger; Geoffrey Michael,1,0,32,31
1657369197742,MATH 109,B02,083216,Ganzberger; Geoffrey Michael,2,0,32,30
1657369197742,MATH 109,B03,093479,Ganzberger; Geoffrey Michael,8,0,32,24
1657369203782,MATH 142A,A01,083219,Chow; Bennett,7,0,32,25
1657369203782,MATH 142A,A02,083220,Chow; Bennett,10,0,32,22
1657369203782,MATH 142A,A03,093480,Chow; Bennett,8,0,32,24
1657369203782,MATH 142A,B03,093481,Chow; Bennett,8,0,32,24
1657369203782,MATH 142A,B04,093558,Chow; Bennett,13,0,32,19
1657369203782,MATH 142A,B05,093559,Chow; Bennett,6,0,32,26
1657369209815,MATH 193A,A01,083224,Rotar; Vladimir,8,0,34,26
1657369209815,MATH 193A,A02,083225,Rotar; Vladimir,9,0,34,25
1657369209815,MATH 193A,A03,083781,Rotar; Vladimir,5,0,34,29
1657369209815,MATH 193A,A04,083782,Rotar; Vladimir,10,0,34,24
1657369209815,MATH 193A,A05,093482,Rotar; Vladimir,10,0,34,24
1657369215841,MATH 197,001,091859,McAuley; Julian John,9999,0,9999,0
1657369215841,MATH 197,002,095566,Kedlaya; Kiran S.,9997,0,9999,2
1657369215841,MATH 197,003,095567,Xiao; Ming,9999,0,9999,0
1657369215841,MATH 197,004,095571,Perols; Johan Lars,9998,0,9999,1
1657369222946,COGS 9,A01,083615,Shannon; Kyle Michael,9,0,75,66
1657369228977,COGS 11,A01,083617,Boyle; Mary E. T.,22,0,48,26
1657369235011,COGS 13,A01,083071,Bastos; Amalia Pinkusfeld,11,0,71,60
1657369241037,COGS 14A,A01,092681,Semenuks; Arturs,4,1,100,96
1657369247071,COGS 14B,A01,083073,Cheng; Tzu-Han,6,0,63,57
1657369253102,COGS 17,A01,092677,Semenuks; Arturs,6,0,81,75
1657369259135,COGS 100,A01,083619,Allen; Michael Gordon,17,0,70,53
1657369265168,COGS 101A,A01,083621,Davis; Joshua Daniel,9,0,68,59
1657369271203,COGS 101B,A01,091572,Allen; Michael Gordon,11,0,65,54
1657369277232,COGS 101C,A01,083625,Delgado; Tania,17,0,35,18
1657369283258,COGS 107A,A01,083627,Boyle; Mary E. T.,13,0,60,47
1657369289285,COGS 118A,A01,083075,Gupta; Anjum,20,0,76,56
1657369295312,CSE 3,A50,083646,Miranda; Gregory Joseph,24,0,50,26
1657369301346,CSE 8A,A50,083650,Miranda; Gregory Joseph,17,1,56,39
1657369307377,CSE 11,A01,083080,Cao; Yingjun,6,15,40,34
1657369313402,CSE 12,A01,083652,Krause-Levy; Sophia Louisa,28,1,120,92
1657369319428,CSE 15L,A01,083654,Morris; Justin Loren,9,0,50,41
1657369319428,CSE 15L,A02,083655,Morris; Justin Loren,9,0,50,41
1657369325456,CSE 20,A01,083657,Tran; Khoa Dang,39,0,80,41
1657369331481,CSE 21,A01,095574,Bach; Quang Tran,22,0,48,26
1657369337522,CSE 30,A01,083084,Eldon; John,4,0,80,76
1657369337522,CSE 30,B01,095061,Bhaskar; Nishant,9,0,50,41
1657369343547,CSE 100,A01,083659,Cao; Yingjun,5,4,70,65
1657369349577,CSE 134B,A01,083661,Powell; Thomas Allan,22,0,100,78
1657369355606,CSE 140,A01,083663,Gungor; Onat,14,0,85,71
1657369361636,CSE 140L,A01,083088,Eldon; John,21,0,100,79
1657369367662,CSE 175,A01,083665,Kumar; Rakesh,3,0,25,22
1657369373700,CSE 190,A00,092507,Dubnov; Shlomo,7,0,20,13
1657369379736,ECE 45,A01,083139,Congero; Spencer William,6,0,75,69
1657369385769,ECE 65,A50,083695,Saad; Andrew S,12,0,30,18
1657369385769,ECE 65,A51,095125,Saad; Andrew S,24,0,26,2
1657369391884,ECE 109,A01,091882,Touri; Behrouz,19,0,70,51
1657369397914,ECE 180,A00,083140,Abi Samra; Nicholas Camill,1,0,30,29
1657369397914,ECE 180,B00,083141,Abi Samra; Nicholas Camill,0,0,30,30
1657369403940,MATH 10A,A01,083735,Patchell; Gregory David,2,0,30,28
1657369403940,MATH 10A,A02,083736,Patchell; Gregory David,20,0,30,10
1657369403940,MATH 10A,A03,083737,Patchell; Gregory David,16,0,30,14
1657369409970,MATH 10B,A01,083207,Lim; Seonhee,8,0,34,26
1657369409970,MATH 10B,A02,083208,Lim; Seonhee,9,0,35,26
1657369409970,MATH 10B,A03,093472,Lim; Seonhee,7,0,34,27
1657369409970,MATH 10B,B01,083739,Sinha; Shubham,12,0,30,18
1657369416006,MATH 18,A01,083743,Cinel; Cameron Alexander,7,0,30,23
1657369416006,MATH 18,A02,083744,Cinel; Cameron Alexander,17,0,30,13
1657369416006,MATH 18,A03,083745,Cinel; Cameron Alexander,9,0,30,21
1657369416006,MATH 18,B01,083748,Rideout; David Porter,5,0,37,32
1657369416006,MATH 18,B02,083749,Rideout; David Porter,5,0,36,31
1657369416006,MATH 18,B03,083750,Rideout; David Porter,3,0,37,34
1657369416006,MATH 18,B04,083751,Rideout; David Porter,6,0,36,30
1657369416006,MATH 18,B05,093473,Rideout; David Porter,6,0,36,30
1657369416006,MATH 18,B06,093474,Rideout; David Porter,6,0,36,30
1657369422034,MATH 20A,A01,083754,Zheng; Zequn,14,0,40,26
1657369428083,MATH 20B,A01,083756,Briones; Jor-el Thomas Caparas,4,0,36,32
1657369428083,MATH 20B,A02,083757,Briones; Jor-el Thomas Caparas,1,0,36,35
1657369428083,MATH 20B,A03,093475,Briones; Jor-el Thomas Caparas,2,0,36,34
1657369434110,MATH 20C,A01,083760,Briones; Jor-el Thomas Caparas,1,0,35,34
1657369434110,MATH 20C,A02,083761,Briones; Jor-el Thomas Caparas,8,0,35,27
1657369434110,MATH 20C,A03,093476,Briones; Jor-el Thomas Caparas,0,1,36,36
1657369434110,MATH 20C,B01,083762,Bach; Quang Tran,1,0,30,29
1657369440146,MATH 20D,A01,083765,Tran; Brian Kha,5,0,30,25
1657369440146,MATH 20D,A02,083766,Tran; Brian Kha,5,0,30,25
1657369440146,MATH 20D,A03,083767,Tran; Brian Kha,5,0,30,25
1657369446178,MATH 20E,A01,083771,Ganguly; Soumya,9,0,32,23
1657369446178,MATH 20E,A02,083772,Ganguly; Soumya,6,0,32,26
1657369446178,MATH 20E,B01,083773,Ciotti; Benjamin,20,0,35,15
1657369446178,MATH 20E,B02,083774,Ciotti; Benjamin,17,0,35,18
1657369452220,MATH 103A,A01,083777,Greenfeld; Be'Eri,3,0,36,33
1657369452220,MATH 103A,A02,083778,Greenfeld; Be'Eri,5,0,36,31
1657369452220,MATH 103A,A03,093561,Greenfeld; Be'Eri,5,0,36,31
1657369452220,MATH 103A,B01,083779,Greenfeld; Be'Eri,7,0,36,29
1657369452220,MATH 103A,B02,083780,Greenfeld; Be'Eri,4,0,36,32
1657369452220,MATH 103A,B03,093562,Greenfeld; Be'Eri,3,0,36,33
1657369458246,MATH 105,A01,085443,Carter; Anne Toulson,15,0,35,20
1657369458246,MATH 105,A02,093477,Carter; Anne Toulson,20,0,35,15
1657369464275,MATH 109,A01,083213,Ganzberger; Geoffrey Michael,2,0,34,32
1657369464275,MATH 109,A02,083214,Ganzberger; Geoffrey Michael,4,0,34,30
1657369464275,MATH 109,A03,093478,Ganzberger; Geoffrey Michael,2,0,34,32
1657369464275,MATH 109,B01,083215,Ganzberger; Geoffrey Michael,1,0,32,31
1657369464275,MATH 109,B02,083216,Ganzberger; Geoffrey Michael,2,0,32,30
1657369464275,MATH 109,B03,093479,Ganzberger; Geoffrey Michael,8,0,32,24
1657369470306,MATH 142A,A01,083219,Chow; Bennett,7,0,32,25
1657369470306,MATH 142A,A02,083220,Chow; Bennett,10,0,32,22
1657369470306,MATH 142A,A03,093480,Chow; Bennett,8,0,32,24
1657369470306,MATH 142A,B03,093481,Chow; Bennett,8,0,32,24
1657369470306,MATH 142A,B04,093558,Chow; Bennett,13,0,32,19
1657369470306,MATH 142A,B05,093559,Chow; Bennett,6,0,32,26
1657369476333,MATH 193A,A01,083224,Rotar; Vladimir,8,0,34,26
1657369476333,MATH 193A,A02,083225,Rotar; Vladimir,9,0,34,25
1657369476333,MATH 193A,A03,083781,Rotar; Vladimir,5,0,34,29
1657369476333,MATH 193A,A04,083782,Rotar; Vladimir,10,0,34,24
1657369476333,MATH 193A,A05,093482,Rotar; Vladimir,10,0,34,24
1657369482365,MATH 197,001,091859,McAuley; Julian John,9999,0,9999,0
1657369482365,MATH 197,002,095566,Kedlaya; Kiran S.,9997,0,9999,2
1657369482365,MATH 197,003,095567,Xiao; Ming,9999,0,9999,0
1657369482365,MATH 197,004,095571,Perols; Johan Lars,9998,0,9999,1
1657369489462,COGS 9,A01,083615,Shannon; Kyle Michael,9,0,75,66
1657369495489,COGS 11,A01,083617,Boyle; Mary E. T.,22,0,48,26
1657369501519,COGS 13,A01,083071,Bastos; Amalia Pinkusfeld,11,0,71,60
1657369507545,COGS 14A,A01,092681,Semenuks; Arturs,4,1,100,96
1657369513574,COGS 14B,A01,083073,Cheng; Tzu-Han,6,0,63,57
1657369519600,COGS 17,A01,092677,Semenuks; Arturs,6,0,81,75
1657369525627,COGS 100,A01,083619,Allen; Michael Gordon,17,0,70,53
1657369531661,COGS 101A,A01,083621,Davis; Joshua Daniel,9,0,68,59
1657369537689,COGS 101B,A01,091572,Allen; Michael Gordon,11,0,65,54
1657369543719,COGS 101C,A01,083625,Delgado; Tania,17,0,35,18
1657369549745,COGS 107A,A01,083627,Boyle; Mary E. T.,13,0,60,47
1657369555775,COGS 118A,A01,083075,Gupta; Anjum,20,0,76,56
1657369561804,CSE 3,A50,083646,Miranda; Gregory Joseph,24,0,50,26
1657369567831,CSE 8A,A50,083650,Miranda; Gregory Joseph,17,1,56,39
1657369573858,CSE 11,A01,083080,Cao; Yingjun,6,15,40,34
1657369579890,CSE 12,A01,083652,Krause-Levy; Sophia Louisa,28,1,120,92
1657369585922,CSE 15L,A01,083654,Morris; Justin Loren,9,0,50,41
1657369585922,CSE 15L,A02,083655,Morris; Justin Loren,9,0,50,41
1657369591951,CSE 20,A01,083657,Tran; Khoa Dang,39,0,80,41
1657369597983,CSE 21,A01,095574,Bach; Quang Tran,22,0,48,26
1657369604018,CSE 30,A01,083084,Eldon; John,4,0,80,76
1657369604018,CSE 30,B01,095061,Bhaskar; Nishant,9,0,50,41
1657369610050,CSE 100,A01,083659,Cao; Yingjun,5,4,70,65
1657369616076,CSE 134B,A01,083661,Powell; Thomas Allan,22,0,100,78
1657369622105,CSE 140,A01,083663,Gungor; Onat,14,0,85,71
1657369628130,CSE 140L,A01,083088,Eldon; John,21,0,100,79
1657369634156,CSE 175,A01,083665,Kumar; Rakesh,3,0,25,22
1657369640184,CSE 190,A00,092507,Dubnov; Shlomo,7,0,20,13
1657369646221,ECE 45,A01,083139,Congero; Spencer William,6,0,75,69
1657369652260,ECE 65,A50,083695,Saad; Andrew S,12,0,30,18
1657369652260,ECE 65,A51,095125,Saad; Andrew S,24,0,26,2
1657369658293,ECE 109,A01,091882,Touri; Behrouz,19,0,70,51
1657369664322,ECE 180,A00,083140,Abi Samra; Nicholas Camill,1,0,30,29
1657369664322,ECE 180,B00,083141,Abi Samra; Nicholas Camill,0,0,30,30
1657369670359,MATH 10A,A01,083735,Patchell; Gregory David,2,0,30,28
1657369670359,MATH 10A,A02,083736,Patchell; Gregory David,20,0,30,10
1657369670359,MATH 10A,A03,083737,Patchell; Gregory David,16,0,30,14
1657369676399,MATH 10B,A01,083207,Lim; Seonhee,8,0,34,26
1657369676399,MATH 10B,A02,083208,Lim; Seonhee,9,0,35,26
1657369676399,MATH 10B,A03,093472,Lim; Seonhee,7,0,34,27
1657369676399,MATH 10B,B01,083739,Sinha; Shubham,12,0,30,18
1657369682446,MATH 18,A01,083743,Cinel; Cameron Alexander,7,0,30,23
1657369682446,MATH 18,A02,083744,Cinel; Cameron Alexander,17,0,30,13
1657369682446,MATH 18,A03,083745,Cinel; Cameron Alexander,9,0,30,21
1657369682446,MATH 18,B01,083748,Rideout; David Porter,5,0,37,32
1657369682446,MATH 18,B02,083749,Rideout; David Porter,5,0,36,31
1657369682446,MATH 18,B03,083750,Rideout; David Porter,3,0,37,34
1657369682446,MATH 18,B04,083751,Rideout; David Porter,6,0,36,30
1657369682446,MATH 18,B05,093473,Rideout; David Porter,6,0,36,30
1657369682446,MATH 18,B06,093474,Rideout; David Porter,6,0,36,30
1657369688472,MATH 20A,A01,083754,Zheng; Zequn,14,0,40,26
1657369694506,MATH 20B,A01,083756,Briones; Jor-el Thomas Caparas,4,0,36,32
1657369694506,MATH 20B,A02,083757,Briones; Jor-el Thomas Caparas,1,0,36,35
1657369694506,MATH 20B,A03,093475,Briones; Jor-el Thomas Caparas,2,0,36,34
1657369700542,MATH 20C,A01,083760,Briones; Jor-el Thomas Caparas,1,0,35,34
1657369700542,MATH 20C,A02,083761,Briones; Jor-el Thomas Caparas,8,0,35,27
1657369700542,MATH 20C,A03,093476,Briones; Jor-el Thomas Caparas,0,1,36,36
1657369700542,MATH 20C,B01,083762,Bach; Quang Tran,1,0,30,29
1657369706576,MATH 20D,A01,083765,Tran; Brian Kha,5,0,30,25
1657369706576,MATH 20D,A02,083766,Tran; Brian Kha,5,0,30,25
1657369706576,MATH 20D,A03,083767,Tran; Brian Kha,5,0,30,25
1657369712610,MATH 20E,A01,083771,Ganguly; Soumya,9,0,32,23
1657369712610,MATH 20E,A02,083772,Ganguly; Soumya,6,0,32,26
1657369712610,MATH 20E,B01,083773,Ciotti; Benjamin,20,0,35,15
1657369712610,MATH 20E,B02,083774,Ciotti; Benjamin,17,0,35,18
1657369718658,MATH 103A,A01,083777,Greenfeld; Be'Eri,3,0,36,33
1657369718658,MATH 103A,A02,083778,Greenfeld; Be'Eri,5,0,36,31
1657369718658,MATH 103A,A03,093561,Greenfeld; Be'Eri,5,0,36,31
1657369718658,MATH 103A,B01,083779,Greenfeld; Be'Eri,7,0,36,29
1657369718658,MATH 103A,B02,083780,Greenfeld; Be'Eri,4,0,36,32
1657369718658,MATH 103A,B03,093562,Greenfeld; Be'Eri,3,0,36,33
1657369724685,MATH 105,A01,085443,Carter; Anne Toulson,15,0,35,20
1657369724685,MATH 105,A02,093477,Carter; Anne Toulson,20,0,35,15
1657369730711,MATH 109,A01,083213,Ganzberger; Geoffrey Michael,2,0,34,32
1657369730711,MATH 109,A02,083214,Ganzberger; Geoffrey Michael,4,0,34,30
1657369730711,MATH 109,A03,093478,Ganzberger; Geoffrey Michael,2,0,34,32
1657369730711,MATH 109,B01,083215,Ganzberger; Geoffrey Michael,1,0,32,31
1657369730711,MATH 109,B02,083216,Ganzberger; Geoffrey Michael,2,0,32,30
1657369730711,MATH 109,B03,093479,Ganzberger; Geoffrey Michael,8,0,32,24
1657369736744,MATH 142A,A01,083219,Chow; Bennett,7,0,32,25
1657369736744,MATH 142A,A02,083220,Chow; Bennett,10,0,32,22
1657369736744,MATH 142A,A03,093480,Chow; Bennett,8,0,32,24
1657369736744,MATH 142A,B03,093481,Chow; Bennett,8,0,32,24
1657369736744,MATH 142A,B04,093558,Chow; Bennett,13,0,32,19
1657369736744,MATH 142A,B05,093559,Chow; Bennett,6,0,32,26
1657369742770,MATH 193A,A01,083224,Rotar; Vladimir,8,0,34,26
1657369742770,MATH 193A,A02,083225,Rotar; Vladimir,9,0,34,25
1657369742770,MATH 193A,A03,083781,Rotar; Vladimir,5,0,34,29
1657369742770,MATH 193A,A04,083782,Rotar; Vladimir,10,0,34,24
1657369742770,MATH 193A,A05,093482,Rotar; Vladimir,10,0,34,24
1657369748805,MATH 197,001,091859,McAuley; Julian John,9999,0,9999,0
1657369748805,MATH 197,002,095566,Kedlaya; Kiran S.,9997,0,9999,2
1657369748805,MATH 197,003,095567,Xiao; Ming,9999,0,9999,0
1657369748805,MATH 197,004,095571,Perols; Johan Lars,9998,0,9999,1
1657369755906,COGS 9,A01,083615,Shannon; Kyle Michael,9,0,75,66
1657369761936,COGS 11,A01,083617,Boyle; Mary E. T.,22,0,48,26
1657369767962,COGS 13,A01,083071,Bastos; Amalia Pinkusfeld,11,0,71,60
1657369773990,COGS 14A,A01,092681,Semenuks; Arturs,4,1,100,96
1657369780014,COGS 14B,A01,083073,Cheng; Tzu-Han,6,0,63,57
1657369786046,COGS 17,A01,092677,Semenuks; Arturs,6,0,81,75
1657369792078,COGS 100,A01,083619,Allen; Michael Gordon,17,0,70,53
1657369798110,COGS 101A,A01,083621,Davis; Joshua Daniel,9,0,68,59
1657369804144,COGS 101B,A01,091572,Allen; Michael Gordon,11,0,65,54
1657369810169,COGS 101C,A01,083625,Delgado; Tania,17,0,35,18
1657369816204,COGS 107A,A01,083627,Boyle; Mary E. T.,13,0,60,47
1657369822232,COGS 118A,A01,083075,Gupta; Anjum,20,0,76,56
1657369828265,CSE 3,A50,083646,Miranda; Gregory Joseph,24,0,50,26
1657369834292,CSE 8A,A50,083650,Miranda; Gregory Joseph,17,1,56,39
1657369840326,CSE 11,A01,083080,Cao; Yingjun,6,15,40,34
1657369846353,CSE 12,A01,083652,Krause-Levy; Sophia Louisa,28,1,120,92
1657369852401,CSE 15L,A01,083654,Morris; Justin Loren,9,0,50,41
1657369852401,CSE 15L,A02,083655,Morris; Justin Loren,9,0,50,41
1657369858427,CSE 20,A01,083657,Tran; Khoa Dang,39,0,80,41
1657369864459,CSE 21,A01,095574,Bach; Quang Tran,22,0,48,26
1657369870499,CSE 30,A01,083084,Eldon; John,4,0,80,76
1657369870499,CSE 30,B01,095061,Bhaskar; Nishant,9,0,50,41
1657369876537,CSE 100,A01,083659,Cao; Yingjun,5,4,70,65
1657369882563,CSE 134B,A01,083661,Powell; Thomas Allan,22,0,100,78
1657369888592,CSE 140,A01,083663,Gungor; Onat,14,0,85,71
1657369894616,CSE 140L,A01,083088,Eldon; John,21,0,100,79
1657369900644,CSE 175,A01,083665,Kumar; Rakesh,3,0,25,22
1657369906670,CSE 190,A00,092507,Dubnov; Shlomo,7,0,20,13
1657369912704,ECE 45,A01,083139,Congero; Spencer William,6,0,75,69
1657369918729,ECE 65,A50,083695,Saad; Andrew S,12,0,30,18
1657369918729,ECE 65,A51,095125,Saad; Andrew S,24,0,26,2
1657369924763,ECE 109,A01,091882,Touri; Behrouz,19,0,70,51
1657369930788,ECE 180,A00,083140,Abi Samra; Nicholas Camill,1,0,30,29
1657369930788,ECE 180,B00,083141,Abi Samra; Nicholas Camill,0,0,30,30
1657369936827,MATH 10A,A01,083735,Patchell; Gregory David,2,0,30,28
1657369936827,MATH 10A,A02,083736,Patchell; Gregory David,20,0,30,10
1657369936827,MATH 10A,A03,083737,Patchell; Gregory David,16,0,30,14
1657369942859,MATH 10B,A01,083207,Lim; Seonhee,8,0,34,26
1657369942859,MATH 10B,A02,083208,Lim; Seonhee,9,0,35,26
1657369942859,MATH 10B,A03,093472,Lim; Seonhee,7,0,34,27
1657369942859,MATH 10B,B01,083739,Sinha; Shubham,12,0,30,18
1657369948898,MATH 18,A01,083743,Cinel; Cameron Alexander,7,0,30,23
1657369948898,MATH 18,A02,083744,Cinel; Cameron Alexander,17,0,30,13
1657369948898,MATH 18,A03,083745,Cinel; Cameron Alexander,9,0,30,21
1657369948898,MATH 18,B01,083748,Rideout; David Porter,5,0,37,32
1657369948898,MATH 18,B02,083749,Rideout; David Porter,5,0,36,31
1657369948898,MATH 18,B03,083750,Rideout; David Porter,3,0,37,34
1657369948898,MATH 18,B04,083751,Rideout; David Porter,6,0,36,30
1657369948898,MATH 18,B05,093473,Rideout; David Porter,6,0,36,30
1657369948898,MATH 18,B06,093474,Rideout; David Porter,6,0,36,30
1657369954925,MATH 20A,A01,083754,Zheng; Zequn,14,0,40,26
1657369960961,MATH 20B,A01,083756,Briones; Jor-el Thomas Caparas,4,0,36,32
1657369960961,MATH 20B,A02,083757,Briones; Jor-el Thomas Caparas,1,0,36,35
1657369960961,MATH 20B,A03,093475,Briones; Jor-el Thomas Caparas,2,0,36,34
1657369966989,MATH 20C,A01,083760,Briones; Jor-el Thomas Caparas,1,0,35,34
1657369966989,MATH 20C,A02,083761,Briones; Jor-el Thomas Caparas,8,0,35,27
1657369966989,MATH 20C,A03,093476,Briones; Jor-el Thomas Caparas,0,1,36,36
1657369966989,MATH 20C,B01,083762,Bach; Quang Tran,1,0,30,29
1657369973017,MATH 20D,A01,083765,Tran; Brian Kha,5,0,30,25
1657369973017,MATH 20D,A02,083766,Tran; Brian Kha,5,0,30,25
1657369973017,MATH 20D,A03,083767,Tran; Brian Kha,5,0,30,25
1657369979044,MATH 20E,A01,083771,Ganguly; Soumya,9,0,32,23
1657369979044,MATH 20E,A02,083772,Ganguly; Soumya,6,0,32,26
1657369979044,MATH 20E,B01,083773,Ciotti; Benjamin,20,0,35,15
1657369979044,MATH 20E,B02,083774,Ciotti; Benjamin,17,0,35,18
1657369985072,MATH 103A,A01,083777,Greenfeld; Be'Eri,3,0,36,33
1657369985072,MATH 103A,A02,083778,Greenfeld; Be'Eri,5,0,36,31
1657369985072,MATH 103A,A03,093561,Greenfeld; Be'Eri,5,0,36,31
1657369985072,MATH 103A,B01,083779,Greenfeld; Be'Eri,7,0,36,29
1657369985072,MATH 103A,B02,083780,Greenfeld; Be'Eri,4,0,36,32
1657369985072,MATH 103A,B03,093562,Greenfeld; Be'Eri,3,0,36,33
1657369991168,MATH 105,A01,085443,Carter; Anne Toulson,15,0,35,20
1657369991168,MATH 105,A02,093477,Carter; Anne Toulson,20,0,35,15
1657369997196,MATH 109,A01,083213,Ganzberger; Geoffrey Michael,2,0,34,32
1657369997196,MATH 109,A02,083214,Ganzberger; Geoffrey Michael,4,0,34,30
1657369997196,MATH 109,A03,093478,Ganzberger; Geoffrey Michael,2,0,34,32
1657369997196,MATH 109,B01,083215,Ganzberger; Geoffrey Michael,1,0,32,31
1657369997196,MATH 109,B02,083216,Ganzberger; Geoffrey Michael,2,0,32,30
1657369997196,MATH 109,B03,093479,Ganzberger; Geoffrey Michael,8,0,32,24
1657370003231,MATH 142A,A01,083219,Chow; Bennett,7,0,32,25
1657370003231,MATH 142A,A02,083220,Chow; Bennett,10,0,32,22
1657370003231,MATH 142A,A03,093480,Chow; Bennett,8,0,32,24
1657370003231,MATH 142A,B03,093481,Chow; Bennett,8,0,32,24
1657370003231,MATH 142A,B04,093558,Chow; Bennett,13,0,32,19
1657370003231,MATH 142A,B05,093559,Chow; Bennett,6,0,32,26
1657370009261,MATH 193A,A01,083224,Rotar; Vladimir,8,0,34,26
1657370009261,MATH 193A,A02,083225,Rotar; Vladimir,9,0,34,25
1657370009261,MATH 193A,A03,083781,Rotar; Vladimir,5,0,34,29
1657370009261,MATH 193A,A04,083782,Rotar; Vladimir,10,0,34,24
1657370009261,MATH 193A,A05,093482,Rotar; Vladimir,10,0,34,24
1657370015295,MATH 197,001,091859,McAuley; Julian John,9999,0,9999,0
1657370015295,MATH 197,002,095566,Kedlaya; Kiran S.,9997,0,9999,2
1657370015295,MATH 197,003,095567,Xiao; Ming,9999,0,9999,0
1657370015295,MATH 197,004,095571,Perols; Johan Lars,9998,0,9999,1
1657370022372,COGS 9,A01,083615,Shannon; Kyle Michael,9,0,75,66
1657370028408,COGS 11,A01,083617,Boyle; Mary E. T.,22,0,48,26
1657370034435,COGS 13,A01,083071,Bastos; Amalia Pinkusfeld,11,0,71,60
1657370040463,COGS 14A,A01,092681,Semenuks; Arturs,4,1,100,96
1657370046490,COGS 14B,A01,083073,Cheng; Tzu-Han,6,0,63,57
1657370052514,COGS 17,A01,092677,Semenuks; Arturs,6,0,81,75
1657370058540,COGS 100,A01,083619,Allen; Michael Gordon,17,0,70,53
1657370064565,COGS 101A,A01,083621,Davis; Joshua Daniel,9,0,68,59
1657370070599,COGS 101B,A01,091572,Allen; Michael Gordon,11,0,65,54
1657370076628,COGS 101C,A01,083625,Delgado; Tania,17,0,35,18
1657370082661,COGS 107A,A01,083627,Boyle; Mary E. T.,13,0,60,47
1657370088692,COGS 118A,A01,083075,Gupta; Anjum,20,0,76,56
1657370094721,CSE 3,A50,083646,Miranda; Gregory Joseph,24,0,50,26
1657370100745,CSE 8A,A50,083650,Miranda; Gregory Joseph,17,1,56,39
1657370106778,CSE 11,A01,083080,Cao; Yingjun,6,15,40,34
1657370112810,CSE 12,A01,083652,Krause-Levy; Sophia Louisa,28,1,120,92
1657370118839,CSE 15L,A01,083654,Morris; Justin Loren,9,0,50,41
1657370118839,CSE 15L,A02,083655,Morris; Justin Loren,9,0,50,41
1657370124875,CSE 20,A01,083657,Tran; Khoa Dang,39,0,80,41
1657370130912,CSE 21,A01,095574,Bach; Quang Tran,22,0,48,26
1657370136943,CSE 30,A01,083084,Eldon; John,4,0,80,76
1657370136943,CSE 30,B01,095061,Bhaskar; Nishant,9,0,50,41
1657370142974,CSE 100,A01,083659,Cao; Yingjun,5,4,70,65
1657370149012,CSE 134B,A01,083661,Powell; Thomas Allan,22,0,100,78
1657370155048,CSE 140,A01,083663,Gungor; Onat,14,0,85,71
1657370161078,CSE 140L,A01,083088,Eldon; John,21,0,100,79
1657370167104,CSE 175,A01,083665,Kumar; Rakesh,3,0,25,22
1657370173130,CSE 190,A00,092507,Dubnov; Shlomo,7,0,20,13
1657370179156,ECE 45,A01,083139,Congero; Spencer William,6,0,75,69
1657370185189,ECE 65,A50,083695,Saad; Andrew S,12,0,30,18
1657370185189,ECE 65,A51,095125,Saad; Andrew S,24,0,26,2
1657370191215,ECE 109,A01,091882,Touri; Behrouz,19,0,70,51
1657370197242,ECE 180,A00,083140,Abi Samra; Nicholas Camill,1,0,30,29
1657370197242,ECE 180,B00,083141,Abi Samra; Nicholas Camill,0,0,30,30
1657370203270,MATH 10A,A01,083735,Patchell; Gregory David,2,0,30,28
1657370203270,MATH 10A,A02,083736,Patchell; Gregory David,20,0,30,10
1657370203270,MATH 10A,A03,083737,Patchell; Gregory David,16,0,30,14
1657370209319,MATH 10B,A01,083207,Lim; Seonhee,8,0,34,26
1657370209319,MATH 10B,A02,083208,Lim; Seonhee,9,0,35,26
1657370209319,MATH 10B,A03,093472,Lim; Seonhee,7,0,34,27
1657370209319,MATH 10B,B01,083739,Sinha; Shubham,12,0,30,18
1657370215349,MATH 18,A01,083743,Cinel; Cameron Alexander,7,0,30,23
1657370215349,MATH 18,A02,083744,Cinel; Cameron Alexander,17,0,30,13
1657370215349,MATH 18,A03,083745,Cinel; Cameron Alexander,9,0,30,21
1657370215349,MATH 18,B01,083748,Rideout; David Porter,5,0,37,32
1657370215349,MATH 18,B02,083749,Rideout; David Porter,5,0,36,31
1657370215349,MATH 18,B03,083750,Rideout; David Porter,3,0,37,34
1657370215349,MATH 18,B04,083751,Rideout; David Porter,6,0,36,30
1657370215349,MATH 18,B05,093473,Rideout; David Porter,6,0,36,30
1657370215349,MATH 18,B06,093474,Rideout; David Porter,6,0,36,30
1657370221379,MATH 20A,A01,083754,Zheng; Zequn,14,0,40,26
1657370227406,MATH 20B,A01,083756,Briones; Jor-el Thomas Caparas,4,0,36,32
1657370227406,MATH 20B,A02,083757,Briones; Jor-el Thomas Caparas,1,0,36,35
1657370227406,MATH 20B,A03,093475,Briones; Jor-el Thomas Caparas,2,0,36,34
1657370233431,MATH 20C,A01,083760,Briones; Jor-el Thomas Caparas,1,0,35,34
1657370233431,MATH 20C,A02,083761,Briones; Jor-el Thomas Caparas,8,0,35,27
1657370233431,MATH 20C,A03,093476,Briones; Jor-el Thomas Caparas,0,1,36,36
1657370233431,MATH 20C,B01,083762,Bach; Quang Tran,1,0,30,29
1657370239464,MATH 20D,A01,083765,Tran; Brian Kha,5,0,30,25
1657370239464,MATH 20D,A02,083766,Tran; Brian Kha,5,0,30,25
1657370239464,MATH 20D,A03,083767,Tran; Brian Kha,5,0,30,25
1657370245500,MATH 20E,A01,083771,Ganguly; Soumya,9,0,32,23
1657370245500,MATH 20E,A02,083772,Ganguly; Soumya,6,0,32,26
1657370245500,MATH 20E,B01,083773,Ciotti; Benjamin,20,0,35,15
1657370245500,MATH 20E,B02,083774,Ciotti; Benjamin,17,0,35,18
1657370251529,MATH 103A,A01,083777,Greenfeld; Be'Eri,3,0,36,33
1657370251529,MATH 103A,A02,083778,Greenfeld; Be'Eri,5,0,36,31
1657370251529,MATH 103A,A03,093561,Greenfeld; Be'Eri,5,0,36,31
1657370251529,MATH 103A,B01,083779,Greenfeld; Be'Eri,7,0,36,29
1657370251529,MATH 103A,B02,083780,Greenfeld; Be'Eri,4,0,36,32
1657370251529,MATH 103A,B03,093562,Greenfeld; Be'Eri,3,0,36,33
1657370257558,MATH 105,A01,085443,Carter; Anne Toulson,15,0,35,20
1657370257558,MATH 105,A02,093477,Carter; Anne Toulson,20,0,35,15
1657370263584,MATH 109,A01,083213,Ganzberger; Geoffrey Michael,2,0,34,32
1657370263584,MATH 109,A02,083214,Ganzberger; Geoffrey Michael,4,0,34,30
1657370263584,MATH 109,A03,093478,Ganzberger; Geoffrey Michael,2,0,34,32
1657370263584,MATH 109,B01,083215,Ganzberger; Geoffrey Michael,1,0,32,31
1657370263584,MATH 109,B02,083216,Ganzberger; Geoffrey Michael,2,0,32,30
1657370263584,MATH 109,B03,093479,Ganzberger; Geoffrey Michael,8,0,32,24
1657370269620,MATH 142A,A01,083219,Chow; Bennett,7,0,32,25
1657370269620,MATH 142A,A02,083220,Chow; Bennett,10,0,32,22
1657370269620,MATH 142A,A03,093480,Chow; Bennett,8,0,32,24
1657370269620,MATH 142A,B03,093481,Chow; Bennett,8,0,32,24
1657370269620,MATH 142A,B04,093558,Chow; Bennett,13,0,32,19
1657370269620,MATH 142A,B05,093559,Chow; Bennett,6,0,32,26
1657370275647,MATH 193A,A01,083224,Rotar; Vladimir,8,0,34,26
1657370275647,MATH 193A,A02,083225,Rotar; Vladimir,9,0,34,25
1657370275647,MATH 193A,A03,083781,Rotar; Vladimir,5,0,34,29
1657370275647,MATH 193A,A04,083782,Rotar; Vladimir,10,0,34,24
1657370275647,MATH 193A,A05,093482,Rotar; Vladimir,10,0,34,24
1657370281673,MATH 197,001,091859,McAuley; Julian John,9999,0,9999,0
1657370281673,MATH 197,002,095566,Kedlaya; Kiran S.,9997,0,9999,2
1657370281673,MATH 197,003,095567,Xiao; Ming,9999,0,9999,0
1657370281673,MATH 197,004,095571,Perols; Johan Lars,9998,0,9999,1
1657370288753,COGS 9,A01,083615,Shannon; Kyle Michael,9,0,75,66
1657370294784,COGS 11,A01,083617,Boyle; Mary E. T.,22,0,48,26
1657370300811,COGS 13,A01,083071,Bastos; Amalia Pinkusfeld,11,0,71,60
1657370306840,COGS 14A,A01,092681,Semenuks; Arturs,4,1,100,96
1657370312868,COGS 14B,A01,083073,Cheng; Tzu-Han,6,0,63,57
1657370318897,COGS 17,A01,092677,Semenuks; Arturs,6,0,81,75
1657370324923,COGS 100,A01,083619,Allen; Michael Gordon,17,0,70,53
1657370330954,COGS 101A,A01,083621,Davis; Joshua Daniel,9,0,68,59
1657370336983,COGS 101B,A01,091572,Allen; Michael Gordon,11,0,65,54
1657370343013,COGS 101C,A01,083625,Delgado; Tania,17,0,35,18
1657370349039,COGS 107A,A01,083627,Boyle; Mary E. T.,13,0,60,47
1657370355071,COGS 118A,A01,083075,Gupta; Anjum,20,0,76,56
1657370361113,CSE 3,A50,083646,Miranda; Gregory Joseph,24,0,50,26
1657370367141,CSE 8A,A50,083650,Miranda; Gregory Joseph,17,1,56,39
1657370373170,CSE 11,A01,083080,Cao; Yingjun,6,15,40,34
1657370379205,CSE 12,A01,083652,Krause-Levy; Sophia Louisa,28,1,120,92
1657370385232,CSE 15L,A01,083654,Morris; Justin Loren,9,0,50,41
1657370385232,CSE 15L,A02,083655,Morris; Justin Loren,9,0,50,41
1657370391258,CSE 20,A01,083657,Tran; Khoa Dang,39,0,80,41
1657370397290,CSE 21,A01,095574,Bach; Quang Tran,22,0,48,26
1657370403315,CSE 30,A01,083084,Eldon; John,4,0,80,76
1657370403315,CSE 30,B01,095061,Bhaskar; Nishant,9,0,50,41
1657370409341,CSE 100,A01,083659,Cao; Yingjun,5,4,70,65
1657370415369,CSE 134B,A01,083661,Powell; Thomas Allan,22,0,100,78
1657370421395,CSE 140,A01,083663,Gungor; Onat,14,0,85,71
1657370427421,CSE 140L,A01,083088,Eldon; John,21,0,100,79
1657370433452,CSE 175,A01,083665,Kumar; Rakesh,3,0,25,22
1657370439503,CSE 190,A00,092507,Dubnov; Shlomo,7,0,20,13
1657370445528,ECE 45,A01,083139,Congero; Spencer William,6,0,75,69
1657370451562,ECE 65,A50,083695,Saad; Andrew S,12,0,30,18
1657370451562,ECE 65,A51,095125,Saad; Andrew S,24,0,26,2
1657370457589,ECE 109,A01,091882,Touri; Behrouz,19,0,70,51
1657370463614,ECE 180,A00,083140,Abi Samra; Nicholas Camill,1,0,30,29
1657370463614,ECE 180,B00,083141,Abi Samra; Nicholas Camill,0,0,30,30
1657370469644,MATH 10A,A01,083735,Patchell; Gregory David,2,0,30,28
1657370469644,MATH 10A,A02,083736,Patchell; Gregory David,20,0,30,10
1657370469644,MATH 10A,A03,083737,Patchell; Gregory David,16,0,30,14
1657370475680,MATH 10B,A01,083207,Lim; Seonhee,8,0,34,26
1657370475680,MATH 10B,A02,083208,Lim; Seonhee,9,0,35,26
1657370475680,MATH 10B,A03,093472,Lim; Seonhee,7,0,34,27
1657370475680,MATH 10B,B01,083739,Sinha; Shubham,12,0,30,18
1657370481712,MATH 18,A01,083743,Cinel; Cameron Alexander,7,0,30,23
1657370481712,MATH 18,A02,083744,Cinel; Cameron Alexander,17,0,30,13
1657370481712,MATH 18,A03,083745,Cinel; Cameron Alexander,9,0,30,21
1657370481712,MATH 18,B01,083748,Rideout; David Porter,5,0,37,32
1657370481712,MATH 18,B02,083749,Rideout; David Porter,5,0,36,31
1657370481712,MATH 18,B03,083750,Rideout; David Porter,3,0,37,34
1657370481712,MATH 18,B04,083751,Rideout; David Porter,6,0,36,30
1657370481712,MATH 18,B05,093473,Rideout; David Porter,6,0,36,30
1657370481712,MATH 18,B06,093474,Rideout; David Porter,6,0,36,30
1657370487743,MATH 20A,A01,083754,Zheng; Zequn,14,0,40,26
1657370493769,MATH 20B,A01,083756,Briones; Jor-el Thomas Caparas,4,0,36,32
1657370493769,MATH 20B,A02,083757,Briones; Jor-el Thomas Caparas,1,0,36,35
1657370493769,MATH 20B,A03,093475,Briones; Jor-el Thomas Caparas,2,0,36,34
1657370499800,MATH 20C,A01,083760,Briones; Jor-el Thomas Caparas,1,0,35,34
1657370499800,MATH 20C,A02,083761,Briones; Jor-el Thomas Caparas,8,0,35,27
1657370499800,MATH 20C,A03,093476,Briones; Jor-el Thomas Caparas,0,1,36,36
1657370499800,MATH 20C,B01,083762,Bach; Quang Tran,1,0,30,29
1657370505826,MATH 20D,A01,083765,Tran; Brian Kha,5,0,30,25
1657370505826,MATH 20D,A02,083766,Tran; Brian Kha,5,0,30,25
1657370505826,MATH 20D,A03,083767,Tran; Brian Kha,5,0,30,25
1657370511854,MATH 20E,A01,083771,Ganguly; Soumya,9,0,32,23
1657370511854,MATH 20E,A02,083772,Ganguly; Soumya,6,0,32,26
1657370511854,MATH 20E,B01,083773,Ciotti; Benjamin,20,0,35,15
1657370511854,MATH 20E,B02,083774,Ciotti; Benjamin,17,0,35,18
1657370517883,MATH 103A,A01,083777,Greenfeld; Be'Eri,3,0,36,33
1657370517883,MATH 103A,A02,083778,Greenfeld; Be'Eri,5,0,36,31
1657370517883,MATH 103A,A03,093561,Greenfeld; Be'Eri,5,0,36,31
1657370517883,MATH 103A,B01,083779,Greenfeld; Be'Eri,7,0,36,29
1657370517883,MATH 103A,B02,083780,Greenfeld; Be'Eri,4,0,36,32
1657370517883,MATH 103A,B03,093562,Greenfeld; Be'Eri,3,0,36,33
1657370523909,MATH 105,A01,085443,Carter; Anne Toulson,15,0,35,20
1657370523909,MATH 105,A02,093477,Carter; Anne Toulson,20,0,35,15
1657370529942,MATH 109,A01,083213,Ganzberger; Geoffrey Michael,2,0,34,32
1657370529942,MATH 109,A02,083214,Ganzberger; Geoffrey Michael,4,0,34,30
1657370529942,MATH 109,A03,093478,Ganzberger; Geoffrey Michael,2,0,34,32
1657370529942,MATH 109,B01,083215,Ganzberger; Geoffrey Michael,1,0,32,31
1657370529942,MATH 109,B02,083216,Ganzberger; Geoffrey Michael,2,0,32,30
1657370529942,MATH 109,B03,093479,Ganzberger; Geoffrey Michael,8,0,32,24
1657370535968,MATH 142A,A01,083219,Chow; Bennett,7,0,32,25
1657370535968,MATH 142A,A02,083220,Chow; Bennett,10,0,32,22
1657370535968,MATH 142A,A03,093480,Chow; Bennett,8,0,32,24
1657370535968,MATH 142A,B03,093481,Chow; Bennett,8,0,32,24
1657370535968,MATH 142A,B04,093558,Chow; Bennett,13,0,32,19
1657370535968,MATH 142A,B05,093559,Chow; Bennett,6,0,32,26
1657370541993,MATH 193A,A01,083224,Rotar; Vladimir,8,0,34,26
1657370541993,MATH 193A,A02,083225,Rotar; Vladimir,9,0,34,25
1657370541993,MATH 193A,A03,083781,Rotar; Vladimir,5,0,34,29
1657370541993,MATH 193A,A04,083782,Rotar; Vladimir,10,0,34,24
1657370541993,MATH 193A,A05,093482,Rotar; Vladimir,10,0,34,24
1657370548019,MATH 197,001,091859,McAuley; Julian John,9999,0,9999,0
1657370548019,MATH 197,002,095566,Kedlaya; Kiran S.,9997,0,9999,2
1657370548019,MATH 197,003,095567,Xiao; Ming,9999,0,9999,0
1657370548019,MATH 197,004,095571,Perols; Johan Lars,9998,0,9999,1
1657370555099,COGS 9,A01,083615,Shannon; Kyle Michael,9,0,75,66
1657370561128,COGS 11,A01,083617,Boyle; Mary E. T.,22,0,48,26
1657370567154,COGS 13,A01,083071,Bastos; Amalia Pinkusfeld,11,0,71,60
1657370573189,COGS 14A,A01,092681,Semenuks; Arturs,4,1,100,96
1657370579217,COGS 14B,A01,083073,Cheng; Tzu-Han,6,0,63,57
1657370585322,COGS 17,A01,092677,Semenuks; Arturs,6,0,81,75
1657370591348,COGS 100,A01,083619,Allen; Michael Gordon,17,0,70,53
1657370597378,COGS 101A,A01,083621,Davis; Joshua Daniel,9,0,68,59
1657370603406,COGS 101B,A01,091572,Allen; Michael Gordon,11,0,65,54
1657370609441,COGS 101C,A01,083625,Delgado; Tania,17,0,35,18
1657370615470,COGS 107A,A01,083627,Boyle; Mary E. T.,13,0,60,47
1657370621495,COGS 118A,A01,083075,Gupta; Anjum,20,0,76,56
1657370627519,CSE 3,A50,083646,Miranda; Gregory Joseph,24,0,50,26
1657370633546,CSE 8A,A50,083650,Miranda; Gregory Joseph,17,1,56,39
1657370639573,CSE 11,A01,083080,Cao; Yingjun,6,15,40,34
1657370645608,CSE 12,A01,083652,Krause-Levy; Sophia Louisa,28,1,120,92
1657370651638,CSE 15L,A01,083654,Morris; Justin Loren,9,0,50,41
1657370651638,CSE 15L,A02,083655,Morris; Justin Loren,9,0,50,41
1657370657664,CSE 20,A01,083657,Tran; Khoa Dang,39,0,80,41
1657370663689,CSE 21,A01,095574,Bach; Quang Tran,22,0,48,26
1657370669725,CSE 30,A01,083084,Eldon; John,4,0,80,76
1657370669725,CSE 30,B01,095061,Bhaskar; Nishant,9,0,50,41
1657370675756,CSE 100,A01,083659,Cao; Yingjun,5,4,70,65
1657370681781,CSE 134B,A01,083661,Powell; Thomas Allan,22,0,100,78
1657370687808,CSE 140,A01,083663,Gungor; Onat,14,0,85,71
1657370693835,CSE 140L,A01,083088,Eldon; John,21,0,100,79
1657370699863,CSE 175,A01,083665,Kumar; Rakesh,3,0,25,22
1657370705896,CSE 190,A00,092507,Dubnov; Shlomo,7,0,20,13
1657370711924,ECE 45,A01,083139,Congero; Spencer William,6,0,75,69
1657370717950,ECE 65,A50,083695,Saad; Andrew S,12,0,30,18
1657370717950,ECE 65,A51,095125,Saad; Andrew S,24,0,26,2
1657370723982,ECE 109,A01,091882,Touri; Behrouz,19,0,70,51
1657370730009,ECE 180,A00,083140,Abi Samra; Nicholas Camill,1,0,30,29
1657370730009,ECE 180,B00,083141,Abi Samra; Nicholas Camill,0,0,30,30
1657370736037,MATH 10A,A01,083735,Patchell; Gregory David,2,0,30,28
1657370736037,MATH 10A,A02,083736,Patchell; Gregory David,20,0,30,10
1657370736037,MATH 10A,A03,083737,Patchell; Gregory David,16,0,30,14
1657370742066,MATH 10B,A01,083207,Lim; Seonhee,8,0,34,26
1657370742066,MATH 10B,A02,083208,Lim; Seonhee,9,0,35,26
1657370742066,MATH 10B,A03,093472,Lim; Seonhee,7,0,34,27
1657370742066,MATH 10B,B01,083739,Sinha; Shubham,12,0,30,18
1657370748096,MATH 18,A01,083743,Cinel; Cameron Alexander,7,0,30,23
1657370748096,MATH 18,A02,083744,Cinel; Cameron Alexander,17,0,30,13
1657370748096,MATH 18,A03,083745,Cinel; Cameron Alexander,9,0,30,21
1657370748096,MATH 18,B01,083748,Rideout; David Porter,5,0,37,32
1657370748096,MATH 18,B02,083749,Rideout; David Porter,5,0,36,31
1657370748096,MATH 18,B03,083750,Rideout; David Porter,3,0,37,34
1657370748096,MATH 18,B04,083751,Rideout; David Porter,6,0,36,30
1657370748096,MATH 18,B05,093473,Rideout; David Porter,6,0,36,30
1657370748096,MATH 18,B06,093474,Rideout; David Porter,6,0,36,30
1657370754127,MATH 20A,A01,083754,Zheng; Zequn,14,0,40,26
1657370760153,MATH 20B,A01,083756,Briones; Jor-el Thomas Caparas,4,0,36,32
1657370760153,MATH 20B,A02,083757,Briones; Jor-el Thomas Caparas,1,0,36,35
1657370760153,MATH 20B,A03,093475,Briones; Jor-el Thomas Caparas,2,0,36,34
1657370766181,MATH 20C,A01,083760,Briones; Jor-el Thomas Caparas,1,0,35,34
1657370766181,MATH 20C,A02,083761,Briones; Jor-el Thomas Caparas,8,0,35,27
1657370766181,MATH 20C,A03,093476,Briones; Jor-el Thomas Caparas,0,1,36,36
1657370766181,MATH 20C,B01,083762,Bach; Quang Tran,1,0,30,29
1657370772209,MATH 20D,A01,083765,Tran; Brian Kha,5,0,30,25
1657370772209,MATH 20D,A02,083766,Tran; Brian Kha,5,0,30,25
1657370772209,MATH 20D,A03,083767,Tran; Brian Kha,5,0,30,25
1657370778237,MATH 20E,A01,083771,Ganguly; Soumya,9,0,32,23
1657370778237,MATH 20E,A02,083772,Ganguly; Soumya,6,0,32,26
1657370778237,MATH 20E,B01,083773,Ciotti; Benjamin,20,0,35,15
1657370778237,MATH 20E,B02,083774,Ciotti; Benjamin,17,0,35,18
1657370784273,MATH 103A,A01,083777,Greenfeld; Be'Eri,3,0,36,33
1657370784273,MATH 103A,A02,083778,Greenfeld; Be'Eri,5,0,36,31
1657370784273,MATH 103A,A03,093561,Greenfeld; Be'Eri,5,0,36,31
1657370784273,MATH 103A,B01,083779,Greenfeld; Be'Eri,7,0,36,29
1657370784273,MATH 103A,B02,083780,Greenfeld; Be'Eri,4,0,36,32
1657370784273,MATH 103A,B03,093562,Greenfeld; Be'Eri,3,0,36,33
1657370790306,MATH 105,A01,085443,Carter; Anne Toulson,15,0,35,20
1657370790306,MATH 105,A02,093477,Carter; Anne Toulson,20,0,35,15
1657370796333,MATH 109,A01,083213,Ganzberger; Geoffrey Michael,2,0,34,32
1657370796333,MATH 109,A02,083214,Ganzberger; Geoffrey Michael,4,0,34,30
1657370796333,MATH 109,A03,093478,Ganzberger; Geoffrey Michael,2,0,34,32
1657370796333,MATH 109,B01,083215,Ganzberger; Geoffrey Michael,1,0,32,31
1657370796333,MATH 109,B02,083216,Ganzberger; Geoffrey Michael,2,0,32,30
1657370796333,MATH 109,B03,093479,Ganzberger; Geoffrey Michael,8,0,32,24
1657370802361,MATH 142A,A01,083219,Chow; Bennett,7,0,32,25
1657370802361,MATH 142A,A02,083220,Chow; Bennett,10,0,32,22
1657370802361,MATH 142A,A03,093480,Chow; Bennett,8,0,32,24
1657370802361,MATH 142A,B03,093481,Chow; Bennett,8,0,32,24
1657370802361,MATH 142A,B04,093558,Chow; Bennett,13,0,32,19
1657370802361,MATH 142A,B05,093559,Chow; Bennett,6,0,32,26
1657370808401,MATH 193A,A01,083224,Rotar; Vladimir,8,0,34,26
1657370808401,MATH 193A,A02,083225,Rotar; Vladimir,9,0,34,25
1657370808401,MATH 193A,A03,083781,Rotar; Vladimir,5,0,34,29
1657370808401,MATH 193A,A04,083782,Rotar; Vladimir,10,0,34,24
1657370808401,MATH 193A,A05,093482,Rotar; Vladimir,10,0,34,24
1657370814433,MATH 197,001,091859,McAuley; Julian John,9999,0,9999,0
1657370814433,MATH 197,002,095566,Kedlaya; Kiran S.,9997,0,9999,2
1657370814433,MATH 197,003,095567,Xiao; Ming,9999,0,9999,0
1657370814433,MATH 197,004,095571,Perols; Johan Lars,9998,0,9999,1
1657370821512,COGS 9,A01,083615,Shannon; Kyle Michael,9,0,75,66
1657370827539,COGS 11,A01,083617,Boyle; Mary E. T.,22,0,48,26
1657370833571,COGS 13,A01,083071,Bastos; Amalia Pinkusfeld,11,0,71,60
1657370839606,COGS 14A,A01,092681,Semenuks; Arturs,4,1,100,96
1657370845634,COGS 14B,A01,083073,Cheng; Tzu-Han,6,0,63,57
1657370851659,COGS 17,A01,092677,Semenuks; Arturs,6,0,81,75
1657370857690,COGS 100,A01,083619,Allen; Michael Gordon,17,0,70,53
1657370863721,COGS 101A,A01,083621,Davis; Joshua Daniel,9,0,68,59
1657370869750,COGS 101B,A01,091572,Allen; Michael Gordon,11,0,65,54
1657370875776,COGS 101C,A01,083625,Delgado; Tania,17,0,35,18
1657370881800,COGS 107A,A01,083627,Boyle; Mary E. T.,13,0,60,47
1657370887824,COGS 118A,A01,083075,Gupta; Anjum,20,0,76,56
1657370893855,CSE 3,A50,083646,Miranda; Gregory Joseph,24,0,50,26
1657370899881,CSE 8A,A50,083650,Miranda; Gregory Joseph,17,1,56,39
1657370905905,CSE 11,A01,083080,Cao; Yingjun,6,15,40,34
1657370911932,CSE 12,A01,083652,Krause-Levy; Sophia Louisa,28,1,120,92
1657370917958,CSE 15L,A01,083654,Morris; Justin Loren,9,0,50,41
1657370917958,CSE 15L,A02,083655,Morris; Justin Loren,9,0,50,41
1657370923990,CSE 20,A01,083657,Tran; Khoa Dang,39,0,80,41
1657370930015,CSE 21,A01,095574,Bach; Quang Tran,22,0,48,26
1657370936053,CSE 30,A01,083084,Eldon; John,4,0,80,76
1657370936053,CSE 30,B01,095061,Bhaskar; Nishant,9,0,50,41
1657370942078,CSE 100,A01,083659,Cao; Yingjun,5,4,70,65
1657370948104,CSE 134B,A01,083661,Powell; Thomas Allan,22,0,100,78
1657370954132,CSE 140,A01,083663,Gungor; Onat,14,0,85,71
1657370960162,CSE 140L,A01,083088,Eldon; John,21,0,100,79
1657370966195,CSE 175,A01,083665,Kumar; Rakesh,3,0,25,22
1657370972224,CSE 190,A00,092507,Dubnov; Shlomo,7,0,20,13
1657370978259,ECE 45,A01,083139,Congero; Spencer William,6,0,75,69
1657370984296,ECE 65,A50,083695,Saad; Andrew S,12,0,30,18
1657370984296,ECE 65,A51,095125,Saad; Andrew S,24,0,26,2
1657370990322,ECE 109,A01,091882,Touri; Behrouz,19,0,70,51
1657370996361,ECE 180,A00,083140,Abi Samra; Nicholas Camill,1,0,30,29
1657370996361,ECE 180,B00,083141,Abi Samra; Nicholas Camill,0,0,30,30
1657371002398,MATH 10A,A01,083735,Patchell; Gregory David,2,0,30,28
1657371002398,MATH 10A,A02,083736,Patchell; Gregory David,20,0,30,10
1657371002398,MATH 10A,A03,083737,Patchell; Gregory David,16,0,30,14
1657371008436,MATH 10B,A01,083207,Lim; Seonhee,8,0,34,26
1657371008436,MATH 10B,A02,083208,Lim; Seonhee,9,0,35,26
1657371008436,MATH 10B,A03,093472,Lim; Seonhee,7,0,34,27
1657371008436,MATH 10B,B01,083739,Sinha; Shubham,12,0,30,18
1657371014476,MATH 18,A01,083743,Cinel; Cameron Alexander,7,0,30,23
1657371014476,MATH 18,A02,083744,Cinel; Cameron Alexander,17,0,30,13
1657371014476,MATH 18,A03,083745,Cinel; Cameron Alexander,9,0,30,21
1657371014476,MATH 18,B01,083748,Rideout; David Porter,5,0,37,32
1657371014476,MATH 18,B02,083749,Rideout; David Porter,5,0,36,31
1657371014476,MATH 18,B03,083750,Rideout; David Porter,3,0,37,34
1657371014476,MATH 18,B04,083751,Rideout; David Porter,6,0,36,30
1657371014476,MATH 18,B05,093473,Rideout; David Porter,6,0,36,30
1657371014476,MATH 18,B06,093474,Rideout; David Porter,6,0,36,30
1657371020503,MATH 20A,A01,083754,Zheng; Zequn,14,0,40,26
1657371026530,MATH 20B,A01,083756,Briones; Jor-el Thomas Caparas,4,0,36,32
1657371026530,MATH 20B,A02,083757,Briones; Jor-el Thomas Caparas,1,0,36,35
1657371026530,MATH 20B,A03,093475,Briones; Jor-el Thomas Caparas,2,0,36,34
1657371032562,MATH 20C,A01,083760,Briones; Jor-el Thomas Caparas,1,0,35,34
1657371032562,MATH 20C,A02,083761,Briones; Jor-el Thomas Caparas,8,0,35,27
1657371032562,MATH 20C,A03,093476,Briones; Jor-el Thomas Caparas,0,1,36,36
1657371032562,MATH 20C,B01,083762,Bach; Quang Tran,1,0,30,29
1657371038600,MATH 20D,A01,083765,Tran; Brian Kha,5,0,30,25
1657371038600,MATH 20D,A02,083766,Tran; Brian Kha,5,0,30,25
1657371038600,MATH 20D,A03,083767,Tran; Brian Kha,5,0,30,25
1657371044627,MATH 20E,A01,083771,Ganguly; Soumya,9,0,32,23
1657371044627,MATH 20E,A02,083772,Ganguly; Soumya,6,0,32,26
1657371044627,MATH 20E,B01,083773,Ciotti; Benjamin,20,0,35,15
1657371044627,MATH 20E,B02,083774,Ciotti; Benjamin,17,0,35,18
1657371050666,MATH 103A,A01,083777,Greenfeld; Be'Eri,3,0,36,33
1657371050666,MATH 103A,A02,083778,Greenfeld; Be'Eri,5,0,36,31
1657371050666,MATH 103A,A03,093561,Greenfeld; Be'Eri,5,0,36,31
1657371050666,MATH 103A,B01,083779,Greenfeld; Be'Eri,7,0,36,29
1657371050666,MATH 103A,B02,083780,Greenfeld; Be'Eri,4,0,36,32
1657371050666,MATH 103A,B03,093562,Greenfeld; Be'Eri,3,0,36,33
1657371056693,MATH 105,A01,085443,Carter; Anne Toulson,15,0,35,20
1657371056693,MATH 105,A02,093477,Carter; Anne Toulson,20,0,35,15
1657371062725,MATH 109,A01,083213,Ganzberger; Geoffrey Michael,2,0,34,32
1657371062725,MATH 109,A02,083214,Ganzberger; Geoffrey Michael,4,0,34,30
1657371062725,MATH 109,A03,093478,Ganzberger; Geoffrey Michael,2,0,34,32
1657371062725,MATH 109,B01,083215,Ganzberger; Geoffrey Michael,1,0,32,31
1657371062725,MATH 109,B02,083216,Ganzberger; Geoffrey Michael,2,0,32,30
1657371062725,MATH 109,B03,093479,Ganzberger; Geoffrey Michael,8,0,32,24
1657371068762,MATH 142A,A01,083219,Chow; Bennett,7,0,32,25
1657371068762,MATH 142A,A02,083220,Chow; Bennett,10,0,32,22
1657371068762,MATH 142A,A03,093480,Chow; Bennett,8,0,32,24
1657371068762,MATH 142A,B03,093481,Chow; Bennett,8,0,32,24
1657371068762,MATH 142A,B04,093558,Chow; Bennett,13,0,32,19
1657371068762,MATH 142A,B05,093559,Chow; Bennett,6,0,32,26
1657371074790,MATH 193A,A01,083224,Rotar; Vladimir,8,0,34,26
1657371074790,MATH 193A,A02,083225,Rotar; Vladimir,9,0,34,25
1657371074790,MATH 193A,A03,083781,Rotar; Vladimir,5,0,34,29
1657371074790,MATH 193A,A04,083782,Rotar; Vladimir,10,0,34,24
1657371074790,MATH 193A,A05,093482,Rotar; Vladimir,10,0,34,24
1657371080822,MATH 197,001,091859,McAuley; Julian John,9999,0,9999,0
1657371080822,MATH 197,002,095566,Kedlaya; Kiran S.,9997,0,9999,2
1657371080822,MATH 197,003,095567,Xiao; Ming,9999,0,9999,0
1657371080822,MATH 197,004,095571,Perols; Johan Lars,9998,0,9999,1
1657371087899,COGS 9,A01,083615,Shannon; Kyle Michael,9,0,75,66
1657371093924,COGS 11,A01,083617,Boyle; Mary E. T.,22,0,48,26
1657371099951,COGS 13,A01,083071,Bastos; Amalia Pinkusfeld,11,0,71,60
1657371105976,COGS 14A,A01,092681,Semenuks; Arturs,4,1,100,96
1657371112006,COGS 14B,A01,083073,Cheng; Tzu-Han,6,0,63,57
1657371118036,COGS 17,A01,092677,Semenuks; Arturs,6,0,81,75
1657371124063,COGS 100,A01,083619,Allen; Michael Gordon,17,0,70,53
1657371130088,COGS 101A,A01,083621,Davis; Joshua Daniel,9,0,68,59
1657371136116,COGS 101B,A01,091572,Allen; Michael Gordon,11,0,65,54
1657371142142,COGS 101C,A01,083625,Delgado; Tania,17,0,35,18
1657371148169,COGS 107A,A01,083627,Boyle; Mary E. T.,13,0,60,47
1657371154195,COGS 118A,A01,083075,Gupta; Anjum,20,0,76,56
1657371160223,CSE 3,A50,083646,Miranda; Gregory Joseph,24,0,50,26
1657371166250,CSE 8A,A50,083650,Miranda; Gregory Joseph,17,1,56,39
1657371172281,CSE 11,A01,083080,Cao; Yingjun,6,15,40,34
1657371178313,CSE 12,A01,083652,Krause-Levy; Sophia Louisa,28,1,120,92
1657371184415,CSE 15L,A01,083654,Morris; Justin Loren,9,0,50,41
1657371184415,CSE 15L,A02,083655,Morris; Justin Loren,9,0,50,41
1657371190442,CSE 20,A01,083657,Tran; Khoa Dang,39,0,80,41
1657371196468,CSE 21,A01,095574,Bach; Quang Tran,22,0,48,26
1657371202493,CSE 30,A01,083084,Eldon; John,4,0,80,76
1657371202493,CSE 30,B01,095061,Bhaskar; Nishant,9,0,50,41
1657371208518,CSE 100,A01,083659,Cao; Yingjun,5,4,70,65
1657371214547,CSE 134B,A01,083661,Powell; Thomas Allan,22,0,100,78
1657371220572,CSE 140,A01,083663,Gungor; Onat,14,0,85,71
1657371226595,CSE 140L,A01,083088,Eldon; John,21,0,100,79
1657371232623,CSE 175,A01,083665,Kumar; Rakesh,3,0,25,22
1657371238651,CSE 190,A00,092507,Dubnov; Shlomo,7,0,20,13
1657371244686,ECE 45,A01,083139,Congero; Spencer William,6,0,75,69
1657371250721,ECE 65,A50,083695,Saad; Andrew S,12,0,30,18
1657371250721,ECE 65,A51,095125,Saad; Andrew S,24,0,26,2
1657371256753,ECE 109,A01,091882,Touri; Behrouz,19,0,70,51
1657371262783,ECE 180,A00,083140,Abi Samra; Nicholas Camill,1,0,30,29
1657371262783,ECE 180,B00,083141,Abi Samra; Nicholas Camill,0,0,30,30
1657371268820,MATH 10A,A01,083735,Patchell; Gregory David,2,0,30,28
1657371268820,MATH 10A,A02,083736,Patchell; Gregory David,20,0,30,10
1657371268820,MATH 10A,A03,083737,Patchell; Gregory David,16,0,30,14
1657371274852,MATH 10B,A01,083207,Lim; Seonhee,8,0,34,26
1657371274852,MATH 10B,A02,083208,Lim; Seonhee,9,0,35,26
1657371274852,MATH 10B,A03,093472,Lim; Seonhee,7,0,34,27
1657371274852,MATH 10B,B01,083739,Sinha; Shubham,12,0,30,18
1657371280883,MATH 18,A01,083743,Cinel; Cameron Alexander,7,0,30,23
1657371280883,MATH 18,A02,083744,Cinel; Cameron Alexander,17,0,30,13
1657371280883,MATH 18,A03,083745,Cinel; Cameron Alexander,9,0,30,21
1657371280883,MATH 18,B01,083748,Rideout; David Porter,5,0,37,32
1657371280883,MATH 18,B02,083749,Rideout; David Porter,5,0,36,31
1657371280883,MATH 18,B03,083750,Rideout; David Porter,3,0,37,34
1657371280883,MATH 18,B04,083751,Rideout; David Porter,6,0,36,30
1657371280883,MATH 18,B05,093473,Rideout; David Porter,6,0,36,30
1657371280883,MATH 18,B06,093474,Rideout; David Porter,6,0,36,30
1657371286910,MATH 20A,A01,083754,Zheng; Zequn,14,0,40,26
1657371292945,MATH 20B,A01,083756,Briones; Jor-el Thomas Caparas,4,0,36,32
1657371292945,MATH 20B,A02,083757,Briones; Jor-el Thomas Caparas,1,0,36,35
1657371292945,MATH 20B,A03,093475,Briones; Jor-el Thomas Caparas,2,0,36,34
1657371298974,MATH 20C,A01,083760,Briones; Jor-el Thomas Caparas,1,0,35,34
1657371298974,MATH 20C,A02,083761,Briones; Jor-el Thomas Caparas,8,0,35,27
1657371298974,MATH 20C,A03,093476,Briones; Jor-el Thomas Caparas,0,1,36,36
1657371298974,MATH 20C,B01,083762,Bach; Quang Tran,1,0,30,29
1657371305008,MATH 20D,A01,083765,Tran; Brian Kha,5,0,30,25
1657371305008,MATH 20D,A02,083766,Tran; Brian Kha,5,0,30,25
1657371305008,MATH 20D,A03,083767,Tran; Brian Kha,5,0,30,25
1657371311037,MATH 20E,A01,083771,Ganguly; Soumya,9,0,32,23
1657371311037,MATH 20E,A02,083772,Ganguly; Soumya,6,0,32,26
1657371311037,MATH 20E,B01,083773,Ciotti; Benjamin,20,0,35,15
1657371311037,MATH 20E,B02,083774,Ciotti; Benjamin,17,0,35,18
1657371317077,MATH 103A,A01,083777,Greenfeld; Be'Eri,3,0,36,33
1657371317077,MATH 103A,A02,083778,Greenfeld; Be'Eri,5,0,36,31
1657371317077,MATH 103A,A03,093561,Greenfeld; Be'Eri,5,0,36,31
1657371317077,MATH 103A,B01,083779,Greenfeld; Be'Eri,7,0,36,29
1657371317077,MATH 103A,B02,083780,Greenfeld; Be'Eri,4,0,36,32
1657371317077,MATH 103A,B03,093562,Greenfeld; Be'Eri,3,0,36,33
1657371323114,MATH 105,A01,085443,Carter; Anne Toulson,15,0,35,20
1657371323114,MATH 105,A02,093477,Carter; Anne Toulson,20,0,35,15
1657371329140,MATH 109,A01,083213,Ganzberger; Geoffrey Michael,2,0,34,32
1657371329140,MATH 109,A02,083214,Ganzberger; Geoffrey Michael,4,0,34,30
1657371329140,MATH 109,A03,093478,Ganzberger; Geoffrey Michael,2,0,34,32
1657371329140,MATH 109,B01,083215,Ganzberger; Geoffrey Michael,1,0,32,31
1657371329140,MATH 109,B02,083216,Ganzberger; Geoffrey Michael,2,0,32,30
1657371329140,MATH 109,B03,093479,Ganzberger; Geoffrey Michael,8,0,32,24
1657371335173,MATH 142A,A01,083219,Chow; Bennett,7,0,32,25
1657371335173,MATH 142A,A02,083220,Chow; Bennett,10,0,32,22
1657371335173,MATH 142A,A03,093480,Chow; Bennett,8,0,32,24
1657371335173,MATH 142A,B03,093481,Chow; Bennett,8,0,32,24
1657371335173,MATH 142A,B04,093558,Chow; Bennett,13,0,32,19
1657371335173,MATH 142A,B05,093559,Chow; Bennett,6,0,32,26
1657371341199,MATH 193A,A01,083224,Rotar; Vladimir,8,0,34,26
1657371341199,MATH 193A,A02,083225,Rotar; Vladimir,9,0,34,25
1657371341199,MATH 193A,A03,083781,Rotar; Vladimir,5,0,34,29
1657371341199,MATH 193A,A04,083782,Rotar; Vladimir,10,0,34,24
1657371341199,MATH 193A,A05,093482,Rotar; Vladimir,10,0,34,24
1657371347226,MATH 197,001,091859,McAuley; Julian John,9999,0,9999,0
1657371347226,MATH 197,002,095566,Kedlaya; Kiran S.,9997,0,9999,2
1657371347226,MATH 197,003,095567,Xiao; Ming,9999,0,9999,0
1657371347226,MATH 197,004,095571,Perols; Johan Lars,9998,0,9999,1
1657371354293,COGS 9,A01,083615,Shannon; Kyle Michael,9,0,75,66
1657371360318,COGS 11,A01,083617,Boyle; Mary E. T.,22,0,48,26
1657371366343,COGS 13,A01,083071,Bastos; Amalia Pinkusfeld,11,0,71,60
1657371372368,COGS 14A,A01,092681,Semenuks; Arturs,4,1,100,96
1657371378392,COGS 14B,A01,083073,Cheng; Tzu-Han,6,0,63,57
1657371384417,COGS 17,A01,092677,Semenuks; Arturs,6,0,81,75
1657371390444,COGS 100,A01,083619,Allen; Michael Gordon,17,0,70,53
1657371396476,COGS 101A,A01,083621,Davis; Joshua Daniel,9,0,68,59
1657371402502,COGS 101B,A01,091572,Allen; Michael Gordon,11,0,65,54
1657371408531,COGS 101C,A01,083625,Delgado; Tania,17,0,35,18
1657371414560,COGS 107A,A01,083627,Boyle; Mary E. T.,13,0,60,47
1657371420585,COGS 118A,A01,083075,Gupta; Anjum,20,0,76,56
1657371426612,CSE 3,A50,083646,Miranda; Gregory Joseph,24,0,50,26
1657371432642,CSE 8A,A50,083650,Miranda; Gregory Joseph,17,1,56,39
1657371438668,CSE 11,A01,083080,Cao; Yingjun,6,15,40,34
1657371444696,CSE 12,A01,083652,Krause-Levy; Sophia Louisa,28,1,120,92
1657371450726,CSE 15L,A01,083654,Morris; Justin Loren,9,0,50,41
1657371450726,CSE 15L,A02,083655,Morris; Justin Loren,9,0,50,41
1657371456754,CSE 20,A01,083657,Tran; Khoa Dang,39,0,80,41
1657371462785,CSE 21,A01,095574,Bach; Quang Tran,22,0,48,26
1657371468817,CSE 30,A01,083084,Eldon; John,4,0,80,76
1657371468817,CSE 30,B01,095061,Bhaskar; Nishant,9,0,50,41
1657371474850,CSE 100,A01,083659,Cao; Yingjun,5,4,70,65
1657371480876,CSE 134B,A01,083661,Powell; Thomas Allan,22,0,100,78
1657371486909,CSE 140,A01,083663,Gungor; Onat,14,0,85,71
1657371492934,CSE 140L,A01,083088,Eldon; John,21,0,100,79
1657371498966,CSE 175,A01,083665,Kumar; Rakesh,3,0,25,22
1657371504997,CSE 190,A00,092507,Dubnov; Shlomo,7,0,20,13
1657371511024,ECE 45,A01,083139,Congero; Spencer William,6,0,75,69
1657371517051,ECE 65,A50,083695,Saad; Andrew S,12,0,30,18
1657371517051,ECE 65,A51,095125,Saad; Andrew S,24,0,26,2
1657371523082,ECE 109,A01,091882,Touri; Behrouz,19,0,70,51
1657371529113,ECE 180,A00,083140,Abi Samra; Nicholas Camill,1,0,30,29
1657371529113,ECE 180,B00,083141,Abi Samra; Nicholas Camill,0,0,30,30
1657371535148,MATH 10A,A01,083735,Patchell; Gregory David,2,0,30,28
1657371535148,MATH 10A,A02,083736,Patchell; Gregory David,20,0,30,10
1657371535148,MATH 10A,A03,083737,Patchell; Gregory David,16,0,30,14
1657371541190,MATH 10B,A01,083207,Lim; Seonhee,8,0,34,26
1657371541190,MATH 10B,A02,083208,Lim; Seonhee,9,0,35,26
1657371541190,MATH 10B,A03,093472,Lim; Seonhee,7,0,34,27
1657371541190,MATH 10B,B01,083739,Sinha; Shubham,12,0,30,18
1657371547222,MATH 18,A01,083743,Cinel; Cameron Alexander,7,0,30,23
1657371547222,MATH 18,A02,083744,Cinel; Cameron Alexander,17,0,30,13
1657371547222,MATH 18,A03,083745,Cinel; Cameron Alexander,9,0,30,21
1657371547222,MATH 18,B01,083748,Rideout; David Porter,5,0,37,32
1657371547222,MATH 18,B02,083749,Rideout; David Porter,5,0,36,31
1657371547222,MATH 18,B03,083750,Rideout; David Porter,3,0,37,34
1657371547222,MATH 18,B04,083751,Rideout; David Porter,6,0,36,30
1657371547222,MATH 18,B05,093473,Rideout; David Porter,6,0,36,30
1657371547222,MATH 18,B06,093474,Rideout; David Porter,6,0,36,30
1657371553247,MATH 20A,A01,083754,Zheng; Zequn,14,0,40,26
1657371559280,MATH 20B,A01,083756,Briones; Jor-el Thomas Caparas,4,0,36,32
1657371559280,MATH 20B,A02,083757,Briones; Jor-el Thomas Caparas,1,0,36,35
1657371559280,MATH 20B,A03,093475,Briones; Jor-el Thomas Caparas,2,0,36,34
1657371565309,MATH 20C,A01,083760,Briones; Jor-el Thomas Caparas,1,0,35,34
1657371565309,MATH 20C,A02,083761,Briones; Jor-el Thomas Caparas,8,0,35,27
1657371565309,MATH 20C,A03,093476,Briones; Jor-el Thomas Caparas,0,1,36,36
1657371565309,MATH 20C,B01,083762,Bach; Quang Tran,1,0,30,29
1657371571340,MATH 20D,A01,083765,Tran; Brian Kha,5,0,30,25
1657371571340,MATH 20D,A02,083766,Tran; Brian Kha,5,0,30,25
1657371571340,MATH 20D,A03,083767,Tran; Brian Kha,5,0,30,25
1657371577371,MATH 20E,A01,083771,Ganguly; Soumya,9,0,32,23
1657371577371,MATH 20E,A02,083772,Ganguly; Soumya,6,0,32,26
1657371577371,MATH 20E,B01,083773,Ciotti; Benjamin,20,0,35,15
1657371577371,MATH 20E,B02,083774,Ciotti; Benjamin,17,0,35,18
1657371583410,MATH 103A,A01,083777,Greenfeld; Be'Eri,3,0,36,33
1657371583410,MATH 103A,A02,083778,Greenfeld; Be'Eri,5,0,36,31
1657371583410,MATH 103A,A03,093561,Greenfeld; Be'Eri,5,0,36,31
1657371583410,MATH 103A,B01,083779,Greenfeld; Be'Eri,7,0,36,29
1657371583410,MATH 103A,B02,083780,Greenfeld; Be'Eri,4,0,36,32
1657371583410,MATH 103A,B03,093562,Greenfeld; Be'Eri,3,0,36,33
1657371589442,MATH 105,A01,085443,Carter; Anne Toulson,15,0,35,20
1657371589442,MATH 105,A02,093477,Carter; Anne Toulson,20,0,35,15
1657371595467,MATH 109,A01,083213,Ganzberger; Geoffrey Michael,2,0,34,32
1657371595467,MATH 109,A02,083214,Ganzberger; Geoffrey Michael,4,0,34,30
1657371595467,MATH 109,A03,093478,Ganzberger; Geoffrey Michael,2,0,34,32
1657371595467,MATH 109,B01,083215,Ganzberger; Geoffrey Michael,1,0,32,31
1657371595467,MATH 109,B02,083216,Ganzberger; Geoffrey Michael,2,0,32,30
1657371595467,MATH 109,B03,093479,Ganzberger; Geoffrey Michael,8,0,32,24
1657371601497,MATH 142A,A01,083219,Chow; Bennett,7,0,32,25
1657371601497,MATH 142A,A02,083220,Chow; Bennett,10,0,32,22
1657371601497,MATH 142A,A03,093480,Chow; Bennett,8,0,32,24
1657371601497,MATH 142A,B03,093481,Chow; Bennett,8,0,32,24
1657371601497,MATH 142A,B04,093558,Chow; Bennett,13,0,32,19
1657371601497,MATH 142A,B05,093559,Chow; Bennett,6,0,32,26
1657371607524,MATH 193A,A01,083224,Rotar; Vladimir,8,0,34,26
1657371607524,MATH 193A,A02,083225,Rotar; Vladimir,9,0,34,25
1657371607524,MATH 193A,A03,083781,Rotar; Vladimir,5,0,34,29
1657371607524,MATH 193A,A04,083782,Rotar; Vladimir,10,0,34,24
1657371607524,MATH 193A,A05,093482,Rotar; Vladimir,10,0,34,24
1657371613563,MATH 197,001,091859,McAuley; Julian John,9999,0,9999,0
1657371613563,MATH 197,002,095566,Kedlaya; Kiran S.,9997,0,9999,2
1657371613563,MATH 197,003,095567,Xiao; Ming,9999,0,9999,0
1657371613563,MATH 197,004,095571,Perols; Johan Lars,9998,0,9999,1
1657371620630,COGS 9,A01,083615,Shannon; Kyle Michael,9,0,75,66
1657371626654,COGS 11,A01,083617,Boyle; Mary E. T.,22,0,48,26
1657371632678,COGS 13,A01,083071,Bastos; Amalia Pinkusfeld,11,0,71,60
1657371638704,COGS 14A,A01,092681,Semenuks; Arturs,4,1,100,96
1657371644737,COGS 14B,A01,083073,Cheng; Tzu-Han,6,0,63,57
1657371650766,COGS 17,A01,092677,Semenuks; Arturs,6,0,81,75
1657371656796,COGS 100,A01,083619,Allen; Michael Gordon,17,0,70,53
1657371662823,COGS 101A,A01,083621,Davis; Joshua Daniel,9,0,68,59
1657371668847,COGS 101B,A01,091572,Allen; Michael Gordon,11,0,65,54
1657371674871,COGS 101C,A01,083625,Delgado; Tania,17,0,35,18
1657371680902,COGS 107A,A01,083627,Boyle; Mary E. T.,13,0,60,47
1657371686933,COGS 118A,A01,083075,Gupta; Anjum,20,0,76,56
1657371692969,CSE 3,A50,083646,Miranda; Gregory Joseph,24,0,50,26
1657371698994,CSE 8A,A50,083650,Miranda; Gregory Joseph,17,1,56,39
1657371705024,CSE 11,A01,083080,Cao; Yingjun,6,15,40,34
1657371711049,CSE 12,A01,083652,Krause-Levy; Sophia Louisa,28,1,120,92
1657371717075,CSE 15L,A01,083654,Morris; Justin Loren,9,0,50,41
1657371717075,CSE 15L,A02,083655,Morris; Justin Loren,9,0,50,41
1657371723104,CSE 20,A01,083657,Tran; Khoa Dang,39,0,80,41
1657371729132,CSE 21,A01,095574,Bach; Quang Tran,22,0,48,26
1657371735167,CSE 30,A01,083084,Eldon; John,4,0,80,76
1657371735167,CSE 30,B01,095061,Bhaskar; Nishant,9,0,50,41
1657371741194,CSE 100,A01,083659,Cao; Yingjun,5,4,70,65
1657371747222,CSE 134B,A01,083661,Powell; Thomas Allan,22,0,100,78
1657371753248,CSE 140,A01,083663,Gungor; Onat,14,0,85,71
1657371759273,CSE 140L,A01,083088,Eldon; John,21,0,100,79
1657371765301,CSE 175,A01,083665,Kumar; Rakesh,3,0,25,22
1657371771331,CSE 190,A00,092507,Dubnov; Shlomo,7,0,20,13
1657371777358,ECE 45,A01,083139,Congero; Spencer William,6,0,75,69
1657371783463,ECE 65,A50,083695,Saad; Andrew S,12,0,30,18
1657371783463,ECE 65,A51,095125,Saad; Andrew S,24,0,26,2
1657371789495,ECE 109,A01,091882,Touri; Behrouz,19,0,70,51
1657371795525,ECE 180,A00,083140,Abi Samra; Nicholas Camill,1,0,30,29
1657371795525,ECE 180,B00,083141,Abi Samra; Nicholas Camill,0,0,30,30
1657371801557,MATH 10A,A01,083735,Patchell; Gregory David,2,0,30,28
1657371801557,MATH 10A,A02,083736,Patchell; Gregory David,20,0,30,10
1657371801557,MATH 10A,A03,083737,Patchell; Gregory David,16,0,30,14
1657371807586,MATH 10B,A01,083207,Lim; Seonhee,8,0,34,26
1657371807586,MATH 10B,A02,083208,Lim; Seonhee,9,0,35,26
1657371807586,MATH 10B,A03,093472,Lim; Seonhee,7,0,34,27
1657371807586,MATH 10B,B01,083739,Sinha; Shubham,12,0,30,18
1657371813618,MATH 18,A01,083743,Cinel; Cameron Alexander,7,0,30,23
1657371813618,MATH 18,A02,083744,Cinel; Cameron Alexander,17,0,30,13
1657371813618,MATH 18,A03,083745,Cinel; Cameron Alexander,9,0,30,21
1657371813618,MATH 18,B01,083748,Rideout; David Porter,5,0,37,32
1657371813618,MATH 18,B02,083749,Rideout; David Porter,5,0,36,31
1657371813618,MATH 18,B03,083750,Rideout; David Porter,3,0,37,34
1657371813618,MATH 18,B04,083751,Rideout; David Porter,6,0,36,30
1657371813618,MATH 18,B05,093473,Rideout; David Porter,6,0,36,30
1657371813618,MATH 18,B06,093474,Rideout; David Porter,6,0,36,30
1657371819645,MATH 20A,A01,083754,Zheng; Zequn,14,0,40,26
1657371825678,MATH 20B,A01,083756,Briones; Jor-el Thomas Caparas,4,0,36,32
1657371825678,MATH 20B,A02,083757,Briones; Jor-el Thomas Caparas,1,0,36,35
1657371825678,MATH 20B,A03,093475,Briones; Jor-el Thomas Caparas,2,0,36,34
1657371831780,MATH 20C,A01,083760,Briones; Jor-el Thomas Caparas,1,0,35,34
1657371831780,MATH 20C,A02,083761,Briones; Jor-el Thomas Caparas,8,0,35,27
1657371831780,MATH 20C,A03,093476,Briones; Jor-el Thomas Caparas,0,1,36,36
1657371831780,MATH 20C,B01,083762,Bach; Quang Tran,1,0,30,29
1657371837805,MATH 20D,A01,083765,Tran; Brian Kha,5,0,30,25
1657371837805,MATH 20D,A02,083766,Tran; Brian Kha,5,0,30,25
1657371837805,MATH 20D,A03,083767,Tran; Brian Kha,5,0,30,25
1657371843832,MATH 20E,A01,083771,Ganguly; Soumya,9,0,32,23
1657371843832,MATH 20E,A02,083772,Ganguly; Soumya,6,0,32,26
1657371843832,MATH 20E,B01,083773,Ciotti; Benjamin,20,0,35,15
1657371843832,MATH 20E,B02,083774,Ciotti; Benjamin,17,0,35,18
1657371849872,MATH 103A,A01,083777,Greenfeld; Be'Eri,3,0,36,33
1657371849872,MATH 103A,A02,083778,Greenfeld; Be'Eri,5,0,36,31
1657371849872,MATH 103A,A03,093561,Greenfeld; Be'Eri,5,0,36,31
1657371849872,MATH 103A,B01,083779,Greenfeld; Be'Eri,7,0,36,29
1657371849872,MATH 103A,B02,083780,Greenfeld; Be'Eri,4,0,36,32
1657371849872,MATH 103A,B03,093562,Greenfeld; Be'Eri,3,0,36,33
1657371855896,MATH 105,A01,085443,Carter; Anne Toulson,15,0,35,20
1657371855896,MATH 105,A02,093477,Carter; Anne Toulson,20,0,35,15
1657371861923,MATH 109,A01,083213,Ganzberger; Geoffrey Michael,2,0,34,32
1657371861923,MATH 109,A02,083214,Ganzberger; Geoffrey Michael,4,0,34,30
1657371861923,MATH 109,A03,093478,Ganzberger; Geoffrey Michael,2,0,34,32
1657371861923,MATH 109,B01,083215,Ganzberger; Geoffrey Michael,1,0,32,31
1657371861923,MATH 109,B02,083216,Ganzberger; Geoffrey Michael,2,0,32,30
1657371861923,MATH 109,B03,093479,Ganzberger; Geoffrey Michael,8,0,32,24
1657371867957,MATH 142A,A01,083219,Chow; Bennett,7,0,32,25
1657371867957,MATH 142A,A02,083220,Chow; Bennett,10,0,32,22
1657371867957,MATH 142A,A03,093480,Chow; Bennett,8,0,32,24
1657371867957,MATH 142A,B03,093481,Chow; Bennett,8,0,32,24
1657371867957,MATH 142A,B04,093558,Chow; Bennett,13,0,32,19
1657371867957,MATH 142A,B05,093559,Chow; Bennett,6,0,32,26
1657371873989,MATH 193A,A01,083224,Rotar; Vladimir,8,0,34,26
1657371873989,MATH 193A,A02,083225,Rotar; Vladimir,9,0,34,25
1657371873989,MATH 193A,A03,083781,Rotar; Vladimir,5,0,34,29
1657371873989,MATH 193A,A04,083782,Rotar; Vladimir,10,0,34,24
1657371873989,MATH 193A,A05,093482,Rotar; Vladimir,10,0,34,24
1657371880022,MATH 197,001,091859,McAuley; Julian John,9999,0,9999,0
1657371880022,MATH 197,002,095566,Kedlaya; Kiran S.,9997,0,9999,2
1657371880022,MATH 197,003,095567,Xiao; Ming,9999,0,9999,0
1657371880022,MATH 197,004,095571,Perols; Johan Lars,9998,0,9999,1
1657371887095,COGS 9,A01,083615,Shannon; Kyle Michael,9,0,75,66
1657371893123,COGS 11,A01,083617,Boyle; Mary E. T.,22,0,48,26
1657371899148,COGS 13,A01,083071,Bastos; Amalia Pinkusfeld,11,0,71,60
1657371905173,COGS 14A,A01,092681,Semenuks; Arturs,4,1,100,96
1657371911198,COGS 14B,A01,083073,Cheng; Tzu-Han,6,0,63,57
1657371917222,COGS 17,A01,092677,Semenuks; Arturs,6,0,81,75
1657371923252,COGS 100,A01,083619,Allen; Michael Gordon,17,0,70,53
1657371929282,COGS 101A,A01,083621,Davis; Joshua Daniel,9,0,68,59
1657371935308,COGS 101B,A01,091572,Allen; Michael Gordon,11,0,65,54
1657371941339,COGS 101C,A01,083625,Delgado; Tania,17,0,35,18
1657371947373,COGS 107A,A01,083627,Boyle; Mary E. T.,13,0,60,47
1657371953398,COGS 118A,A01,083075,Gupta; Anjum,20,0,76,56
1657371959427,CSE 3,A50,083646,Miranda; Gregory Joseph,24,0,50,26
1657371965458,CSE 8A,A50,083650,Miranda; Gregory Joseph,17,1,56,39
1657371971483,CSE 11,A01,083080,Cao; Yingjun,6,15,40,34
1657371977513,CSE 12,A01,083652,Krause-Levy; Sophia Louisa,28,1,120,92
1657371983545,CSE 15L,A01,083654,Morris; Justin Loren,9,0,50,41
1657371983545,CSE 15L,A02,083655,Morris; Justin Loren,9,0,50,41
1657371989572,CSE 20,A01,083657,Tran; Khoa Dang,39,0,80,41
1657371995598,CSE 21,A01,095574,Bach; Quang Tran,22,0,48,26
1657372001624,CSE 30,A01,083084,Eldon; John,4,0,80,76
1657372001624,CSE 30,B01,095061,Bhaskar; Nishant,9,0,50,41
1657372007655,CSE 100,A01,083659,Cao; Yingjun,5,4,70,65
1657372013681,CSE 134B,A01,083661,Powell; Thomas Allan,22,0,100,78
1657372019708,CSE 140,A01,083663,Gungor; Onat,14,0,85,71
1657372025743,CSE 140L,A01,083088,Eldon; John,21,0,100,79
1657372031773,CSE 175,A01,083665,Kumar; Rakesh,3,0,25,22
1657372037799,CSE 190,A00,092507,Dubnov; Shlomo,7,0,20,13
1657372043824,ECE 45,A01,083139,Congero; Spencer William,6,0,75,69
1657372049859,ECE 65,A50,083695,Saad; Andrew S,12,0,30,18
1657372049859,ECE 65,A51,095125,Saad; Andrew S,24,0,26,2
1657372055885,ECE 109,A01,091882,Touri; Behrouz,19,0,70,51
1657372061912,ECE 180,A00,083140,Abi Samra; Nicholas Camill,1,0,30,29
1657372061912,ECE 180,B00,083141,Abi Samra; Nicholas Camill,0,0,30,30
1657372067941,MATH 10A,A01,083735,Patchell; Gregory David,2,0,30,28
1657372067941,MATH 10A,A02,083736,Patchell; Gregory David,20,0,30,10
1657372067941,MATH 10A,A03,083737,Patchell; Gregory David,16,0,30,14
1657372073973,MATH 10B,A01,083207,Lim; Seonhee,8,0,34,26
1657372073973,MATH 10B,A02,083208,Lim; Seonhee,9,0,35,26
1657372073973,MATH 10B,A03,093472,Lim; Seonhee,7,0,34,27
1657372073973,MATH 10B,B01,083739,Sinha; Shubham,12,0,30,18
1657372080003,MATH 18,A01,083743,Cinel; Cameron Alexander,7,0,30,23
1657372080003,MATH 18,A02,083744,Cinel; Cameron Alexander,17,0,30,13
1657372080003,MATH 18,A03,083745,Cinel; Cameron Alexander,9,0,30,21
1657372080003,MATH 18,B01,083748,Rideout; David Porter,5,0,37,32
1657372080003,MATH 18,B02,083749,Rideout; David Porter,5,0,36,31
1657372080003,MATH 18,B03,083750,Rideout; David Porter,3,0,37,34
1657372080003,MATH 18,B04,083751,Rideout; David Porter,6,0,36,30
1657372080003,MATH 18,B05,093473,Rideout; David Porter,6,0,36,30
1657372080003,MATH 18,B06,093474,Rideout; David Porter,6,0,36,30
1657372086027,MATH 20A,A01,083754,Zheng; Zequn,14,0,40,26
1657372092055,MATH 20B,A01,083756,Briones; Jor-el Thomas Caparas,4,0,36,32
1657372092055,MATH 20B,A02,083757,Briones; Jor-el Thomas Caparas,1,0,36,35
1657372092055,MATH 20B,A03,093475,Briones; Jor-el Thomas Caparas,2,0,36,34
1657372098080,MATH 20C,A01,083760,Briones; Jor-el Thomas Caparas,1,0,35,34
1657372098080,MATH 20C,A02,083761,Briones; Jor-el Thomas Caparas,8,0,35,27
1657372098080,MATH 20C,A03,093476,Briones; Jor-el Thomas Caparas,0,1,36,36
1657372098080,MATH 20C,B01,083762,Bach; Quang Tran,1,0,30,29
1657372104105,MATH 20D,A01,083765,Tran; Brian Kha,5,0,30,25
1657372104105,MATH 20D,A02,083766,Tran; Brian Kha,5,0,30,25
1657372104105,MATH 20D,A03,083767,Tran; Brian Kha,5,0,30,25
1657372110132,MATH 20E,A01,083771,Ganguly; Soumya,9,0,32,23
1657372110132,MATH 20E,A02,083772,Ganguly; Soumya,6,0,32,26
1657372110132,MATH 20E,B01,083773,Ciotti; Benjamin,20,0,35,15
1657372110132,MATH 20E,B02,083774,Ciotti; Benjamin,17,0,35,18
1657372116162,MATH 103A,A01,083777,Greenfeld; Be'Eri,3,0,36,33
1657372116162,MATH 103A,A02,083778,Greenfeld; Be'Eri,5,0,36,31
1657372116162,MATH 103A,A03,093561,Greenfeld; Be'Eri,5,0,36,31
1657372116162,MATH 103A,B01,083779,Greenfeld; Be'Eri,7,0,36,29
1657372116162,MATH 103A,B02,083780,Greenfeld; Be'Eri,4,0,36,32
1657372116162,MATH 103A,B03,093562,Greenfeld; Be'Eri,3,0,36,33
1657372122193,MATH 105,A01,085443,Carter; Anne Toulson,15,0,35,20
1657372122193,MATH 105,A02,093477,Carter; Anne Toulson,20,0,35,15
1657372128219,MATH 109,A01,083213,Ganzberger; Geoffrey Michael,2,0,34,32
1657372128219,MATH 109,A02,083214,Ganzberger; Geoffrey Michael,4,0,34,30
1657372128219,MATH 109,A03,093478,Ganzberger; Geoffrey Michael,2,0,34,32
1657372128219,MATH 109,B01,083215,Ganzberger; Geoffrey Michael,1,0,32,31
1657372128219,MATH 109,B02,083216,Ganzberger; Geoffrey Michael,2,0,32,30
1657372128219,MATH 109,B03,093479,Ganzberger; Geoffrey Michael,8,0,32,24
1657372134248,MATH 142A,A01,083219,Chow; Bennett,7,0,32,25
1657372134248,MATH 142A,A02,083220,Chow; Bennett,10,0,32,22
1657372134248,MATH 142A,A03,093480,Chow; Bennett,8,0,32,24
1657372134248,MATH 142A,B03,093481,Chow; Bennett,8,0,32,24
1657372134248,MATH 142A,B04,093558,Chow; Bennett,13,0,32,19
1657372134248,MATH 142A,B05,093559,Chow; Bennett,6,0,32,26
1657372140274,MATH 193A,A01,083224,Rotar; Vladimir,8,0,34,26
1657372140274,MATH 193A,A02,083225,Rotar; Vladimir,9,0,34,25
1657372140274,MATH 193A,A03,083781,Rotar; Vladimir,5,0,34,29
1657372140274,MATH 193A,A04,083782,Rotar; Vladimir,10,0,34,24
1657372140274,MATH 193A,A05,093482,Rotar; Vladimir,10,0,34,24
1657372146300,MATH 197,001,091859,McAuley; Julian John,9999,0,9999,0
1657372146300,MATH 197,002,095566,Kedlaya; Kiran S.,9997,0,9999,2
1657372146300,MATH 197,003,095567,Xiao; Ming,9999,0,9999,0
1657372146300,MATH 197,004,095571,Perols; Johan Lars,9998,0,9999,1
1657372153388,COGS 9,A01,083615,Shannon; Kyle Michael,9,0,75,66
1657372159429,COGS 11,A01,083617,Boyle; Mary E. T.,22,0,48,26
1657372165460,COGS 13,A01,083071,Bastos; Amalia Pinkusfeld,11,0,71,60
1657372171487,COGS 14A,A01,092681,Semenuks; Arturs,4,1,100,96
1657372177518,COGS 14B,A01,083073,Cheng; Tzu-Han,6,0,63,57
1657372183554,COGS 17,A01,092677,Semenuks; Arturs,6,0,81,75
1657372189584,COGS 100,A01,083619,Allen; Michael Gordon,17,0,70,53
1657372195618,COGS 101A,A01,083621,Davis; Joshua Daniel,9,0,68,59
1657372201651,COGS 101B,A01,091572,Allen; Michael Gordon,11,0,65,54
1657372207680,COGS 101C,A01,083625,Delgado; Tania,17,0,35,18
1657372213705,COGS 107A,A01,083627,Boyle; Mary E. T.,13,0,60,47
1657372219728,COGS 118A,A01,083075,Gupta; Anjum,20,0,76,56
1657372225769,CSE 3,A50,083646,Miranda; Gregory Joseph,24,0,50,26
1657372231794,CSE 8A,A50,083650,Miranda; Gregory Joseph,17,1,56,39
1657372237818,CSE 11,A01,083080,Cao; Yingjun,6,15,40,34
1657372243844,CSE 12,A01,083652,Krause-Levy; Sophia Louisa,28,1,120,92
1657372249868,CSE 15L,A01,083654,Morris; Justin Loren,9,0,50,41
1657372249868,CSE 15L,A02,083655,Morris; Justin Loren,9,0,50,41
1657372255894,CSE 20,A01,083657,Tran; Khoa Dang,39,0,80,41
1657372261920,CSE 21,A01,095574,Bach; Quang Tran,22,0,48,26
1657372267954,CSE 30,A01,083084,Eldon; John,4,0,80,76
1657372267954,CSE 30,B01,095061,Bhaskar; Nishant,9,0,50,41
1657372273984,CSE 100,A01,083659,Cao; Yingjun,5,4,70,65
1657372280012,CSE 134B,A01,083661,Powell; Thomas Allan,22,0,100,78
1657372286036,CSE 140,A01,083663,Gungor; Onat,14,0,85,71
1657372292061,CSE 140L,A01,083088,Eldon; John,21,0,100,79
1657372298098,CSE 175,A01,083665,Kumar; Rakesh,3,0,25,22
1657372304122,CSE 190,A00,092507,Dubnov; Shlomo,7,0,20,13
1657372310155,ECE 45,A01,083139,Congero; Spencer William,6,0,75,69
1657372316188,ECE 65,A50,083695,Saad; Andrew S,12,0,30,18
1657372316188,ECE 65,A51,095125,Saad; Andrew S,24,0,26,2
1657372322214,ECE 109,A01,091882,Touri; Behrouz,19,0,70,51
1657372328248,ECE 180,A00,083140,Abi Samra; Nicholas Camill,1,0,30,29
1657372328248,ECE 180,B00,083141,Abi Samra; Nicholas Camill,0,0,30,30
1657372334277,MATH 10A,A01,083735,Patchell; Gregory David,2,0,30,28
1657372334277,MATH 10A,A02,083736,Patchell; Gregory David,20,0,30,10
1657372334277,MATH 10A,A03,083737,Patchell; Gregory David,16,0,30,14
1657372340314,MATH 10B,A01,083207,Lim; Seonhee,8,0,34,26
1657372340314,MATH 10B,A02,083208,Lim; Seonhee,9,0,35,26
1657372340314,MATH 10B,A03,093472,Lim; Seonhee,7,0,34,27
1657372340314,MATH 10B,B01,083739,Sinha; Shubham,12,0,30,18
1657372346343,MATH 18,A01,083743,Cinel; Cameron Alexander,7,0,30,23
1657372346343,MATH 18,A02,083744,Cinel; Cameron Alexander,17,0,30,13
1657372346343,MATH 18,A03,083745,Cinel; Cameron Alexander,9,0,30,21
1657372346343,MATH 18,B01,083748,Rideout; David Porter,5,0,37,32
1657372346343,MATH 18,B02,083749,Rideout; David Porter,5,0,36,31
1657372346343,MATH 18,B03,083750,Rideout; David Porter,3,0,37,34
1657372346343,MATH 18,B04,083751,Rideout; David Porter,6,0,36,30
1657372346343,MATH 18,B05,093473,Rideout; David Porter,6,0,36,30
1657372346343,MATH 18,B06,093474,Rideout; David Porter,6,0,36,30
1657372352369,MATH 20A,A01,083754,Zheng; Zequn,14,0,40,26
1657372358395,MATH 20B,A01,083756,Briones; Jor-el Thomas Caparas,4,0,36,32
1657372358395,MATH 20B,A02,083757,Briones; Jor-el Thomas Caparas,1,0,36,35
1657372358395,MATH 20B,A03,093475,Briones; Jor-el Thomas Caparas,2,0,36,34
1657372364423,MATH 20C,A01,083760,Briones; Jor-el Thomas Caparas,1,0,35,34
1657372364423,MATH 20C,A02,083761,Briones; Jor-el Thomas Caparas,8,0,35,27
1657372364423,MATH 20C,A03,093476,Briones; Jor-el Thomas Caparas,0,1,36,36
1657372364423,MATH 20C,B01,083762,Bach; Quang Tran,1,0,30,29
1657372370452,MATH 20D,A01,083765,Tran; Brian Kha,5,0,30,25
1657372370452,MATH 20D,A02,083766,Tran; Brian Kha,5,0,30,25
1657372370452,MATH 20D,A03,083767,Tran; Brian Kha,5,0,30,25
1657372376487,MATH 20E,A01,083771,Ganguly; Soumya,9,0,32,23
1657372376487,MATH 20E,A02,083772,Ganguly; Soumya,6,0,32,26
1657372376487,MATH 20E,B01,083773,Ciotti; Benjamin,20,0,35,15
1657372376487,MATH 20E,B02,083774,Ciotti; Benjamin,17,0,35,18
1657372382621,MATH 103A,A01,083777,Greenfeld; Be'Eri,3,0,36,33
1657372382621,MATH 103A,A02,083778,Greenfeld; Be'Eri,5,0,36,31
1657372382621,MATH 103A,A03,093561,Greenfeld; Be'Eri,5,0,36,31
1657372382621,MATH 103A,B01,083779,Greenfeld; Be'Eri,7,0,36,29
1657372382621,MATH 103A,B02,083780,Greenfeld; Be'Eri,4,0,36,32
1657372382621,MATH 103A,B03,093562,Greenfeld; Be'Eri,3,0,36,33
1657372388649,MATH 105,A01,085443,Carter; Anne Toulson,15,0,35,20
1657372388649,MATH 105,A02,093477,Carter; Anne Toulson,20,0,35,15
1657372394680,MATH 109,A01,083213,Ganzberger; Geoffrey Michael,2,0,34,32
1657372394680,MATH 109,A02,083214,Ganzberger; Geoffrey Michael,4,0,34,30
1657372394680,MATH 109,A03,093478,Ganzberger; Geoffrey Michael,2,0,34,32
1657372394680,MATH 109,B01,083215,Ganzberger; Geoffrey Michael,1,0,32,31
1657372394680,MATH 109,B02,083216,Ganzberger; Geoffrey Michael,2,0,32,30
1657372394680,MATH 109,B03,093479,Ganzberger; Geoffrey Michael,8,0,32,24
1657372400706,MATH 142A,A01,083219,Chow; Bennett,7,0,32,25
1657372400706,MATH 142A,A02,083220,Chow; Bennett,10,0,32,22
1657372400706,MATH 142A,A03,093480,Chow; Bennett,8,0,32,24
1657372400706,MATH 142A,B03,093481,Chow; Bennett,8,0,32,24
1657372400706,MATH 142A,B04,093558,Chow; Bennett,13,0,32,19
1657372400706,MATH 142A,B05,093559,Chow; Bennett,6,0,32,26
1657372406738,MATH 193A,A01,083224,Rotar; Vladimir,8,0,34,26
1657372406738,MATH 193A,A02,083225,Rotar; Vladimir,9,0,34,25
1657372406738,MATH 193A,A03,083781,Rotar; Vladimir,5,0,34,29
1657372406738,MATH 193A,A04,083782,Rotar; Vladimir,10,0,34,24
1657372406738,MATH 193A,A05,093482,Rotar; Vladimir,10,0,34,24
1657372412764,MATH 197,001,091859,McAuley; Julian John,9999,0,9999,0
1657372412764,MATH 197,002,095566,Kedlaya; Kiran S.,9997,0,9999,2
1657372412764,MATH 197,003,095567,Xiao; Ming,9999,0,9999,0
1657372412764,MATH 197,004,095571,Perols; Johan Lars,9998,0,9999,1
1657372419844,COGS 9,A01,083615,Shannon; Kyle Michael,9,0,75,66
1657372425874,COGS 11,A01,083617,Boyle; Mary E. T.,22,0,48,26
1657372431900,COGS 13,A01,083071,Bastos; Amalia Pinkusfeld,11,0,71,60
1657372437929,COGS 14A,A01,092681,Semenuks; Arturs,4,1,100,96
1657372443958,COGS 14B,A01,083073,Cheng; Tzu-Han,6,0,63,57
1657372449990,COGS 17,A01,092677,Semenuks; Arturs,6,0,81,75
1657372456022,COGS 100,A01,083619,Allen; Michael Gordon,17,0,70,53
1657372462056,COGS 101A,A01,083621,Davis; Joshua Daniel,9,0,68,59
1657372468082,COGS 101B,A01,091572,Allen; Michael Gordon,11,0,65,54
1657372474108,COGS 101C,A01,083625,Delgado; Tania,17,0,35,18
1657372480140,COGS 107A,A01,083627,Boyle; Mary E. T.,13,0,60,47
1657372486167,COGS 118A,A01,083075,Gupta; Anjum,20,0,76,56
1657372492201,CSE 3,A50,083646,Miranda; Gregory Joseph,24,0,50,26
1657372498228,CSE 8A,A50,083650,Miranda; Gregory Joseph,17,1,56,39
1657372504257,CSE 11,A01,083080,Cao; Yingjun,6,15,40,34
1657372510288,CSE 12,A01,083652,Krause-Levy; Sophia Louisa,28,1,120,92
1657372516319,CSE 15L,A01,083654,Morris; Justin Loren,9,0,50,41
1657372516319,CSE 15L,A02,083655,Morris; Justin Loren,9,0,50,41
1657372522347,CSE 20,A01,083657,Tran; Khoa Dang,39,0,80,41
1657372528378,CSE 21,A01,095574,Bach; Quang Tran,22,0,48,26
1657372534410,CSE 30,A01,083084,Eldon; John,4,0,80,76
1657372534410,CSE 30,B01,095061,Bhaskar; Nishant,9,0,50,41
1657372540442,CSE 100,A01,083659,Cao; Yingjun,5,4,70,65
1657372546468,CSE 134B,A01,083661,Powell; Thomas Allan,22,0,100,78
1657372552494,CSE 140,A01,083663,Gungor; Onat,14,0,85,71
1657372558518,CSE 140L,A01,083088,Eldon; John,21,0,100,79
1657372564548,CSE 175,A01,083665,Kumar; Rakesh,3,0,25,22
1657372570578,CSE 190,A00,092507,Dubnov; Shlomo,7,0,20,13
1657372576605,ECE 45,A01,083139,Congero; Spencer William,6,0,75,69
1657372582638,ECE 65,A50,083695,Saad; Andrew S,12,0,30,18
1657372582638,ECE 65,A51,095125,Saad; Andrew S,24,0,26,2
1657372588668,ECE 109,A01,091882,Touri; Behrouz,19,0,70,51
1657372594695,ECE 180,A00,083140,Abi Samra; Nicholas Camill,1,0,30,29
1657372594695,ECE 180,B00,083141,Abi Samra; Nicholas Camill,0,0,30,30
1657372600721,MATH 10A,A01,083735,Patchell; Gregory David,2,0,30,28
1657372600721,MATH 10A,A02,083736,Patchell; Gregory David,20,0,30,10
1657372600721,MATH 10A,A03,083737,Patchell; Gregory David,16,0,30,14
1657372606757,MATH 10B,A01,083207,Lim; Seonhee,8,0,34,26
1657372606757,MATH 10B,A02,083208,Lim; Seonhee,9,0,35,26
1657372606757,MATH 10B,A03,093472,Lim; Seonhee,7,0,34,27
1657372606757,MATH 10B,B01,083739,Sinha; Shubham,12,0,30,18
1657372612803,MATH 18,A01,083743,Cinel; Cameron Alexander,7,0,30,23
1657372612803,MATH 18,A02,083744,Cinel; Cameron Alexander,17,0,30,13
1657372612803,MATH 18,A03,083745,Cinel; Cameron Alexander,9,0,30,21
1657372612803,MATH 18,B01,083748,Rideout; David Porter,5,0,37,32
1657372612803,MATH 18,B02,083749,Rideout; David Porter,5,0,36,31
1657372612803,MATH 18,B03,083750,Rideout; David Porter,3,0,37,34
1657372612803,MATH 18,B04,083751,Rideout; David Porter,6,0,36,30
1657372612803,MATH 18,B05,093473,Rideout; David Porter,6,0,36,30
1657372612803,MATH 18,B06,093474,Rideout; David Porter,6,0,36,30
1657372618829,MATH 20A,A01,083754,Zheng; Zequn,14,0,40,26
1657372624855,MATH 20B,A01,083756,Briones; Jor-el Thomas Caparas,4,0,36,32
1657372624855,MATH 20B,A02,083757,Briones; Jor-el Thomas Caparas,1,0,36,35
1657372624855,MATH 20B,A03,093475,Briones; Jor-el Thomas Caparas,2,0,36,34
1657372630883,MATH 20C,A01,083760,Briones; Jor-el Thomas Caparas,1,0,35,34
1657372630883,MATH 20C,A02,083761,Briones; Jor-el Thomas Caparas,8,0,35,27
1657372630883,MATH 20C,A03,093476,Briones; Jor-el Thomas Caparas,0,1,36,36
1657372630883,MATH 20C,B01,083762,Bach; Quang Tran,1,0,30,29
1657372636911,MATH 20D,A01,083765,Tran; Brian Kha,5,0,30,25
1657372636911,MATH 20D,A02,083766,Tran; Brian Kha,5,0,30,25
1657372636911,MATH 20D,A03,083767,Tran; Brian Kha,5,0,30,25
1657372642947,MATH 20E,A01,083771,Ganguly; Soumya,9,0,32,23
1657372642947,MATH 20E,A02,083772,Ganguly; Soumya,6,0,32,26
1657372642947,MATH 20E,B01,083773,Ciotti; Benjamin,20,0,35,15
1657372642947,MATH 20E,B02,083774,Ciotti; Benjamin,17,0,35,18
1657372648977,MATH 103A,A01,083777,Greenfeld; Be'Eri,3,0,36,33
1657372648977,MATH 103A,A02,083778,Greenfeld; Be'Eri,5,0,36,31
1657372648977,MATH 103A,A03,093561,Greenfeld; Be'Eri,5,0,36,31
1657372648977,MATH 103A,B01,083779,Greenfeld; Be'Eri,7,0,36,29
1657372648977,MATH 103A,B02,083780,Greenfeld; Be'Eri,4,0,36,32
1657372648977,MATH 103A,B03,093562,Greenfeld; Be'Eri,3,0,36,33
1657372655014,MATH 105,A01,085443,Carter; Anne Toulson,15,0,35,20
1657372655014,MATH 105,A02,093477,Carter; Anne Toulson,20,0,35,15
1657372661040,MATH 109,A01,083213,Ganzberger; Geoffrey Michael,2,0,34,32
1657372661040,MATH 109,A02,083214,Ganzberger; Geoffrey Michael,4,0,34,30
1657372661040,MATH 109,A03,093478,Ganzberger; Geoffrey Michael,2,0,34,32
1657372661040,MATH 109,B01,083215,Ganzberger; Geoffrey Michael,1,0,32,31
1657372661040,MATH 109,B02,083216,Ganzberger; Geoffrey Michael,2,0,32,30
1657372661040,MATH 109,B03,093479,Ganzberger; Geoffrey Michael,8,0,32,24
1657372667073,MATH 142A,A01,083219,Chow; Bennett,7,0,32,25
1657372667073,MATH 142A,A02,083220,Chow; Bennett,10,0,32,22
1657372667073,MATH 142A,A03,093480,Chow; Bennett,8,0,32,24
1657372667073,MATH 142A,B03,093481,Chow; Bennett,8,0,32,24
1657372667073,MATH 142A,B04,093558,Chow; Bennett,13,0,32,19
1657372667073,MATH 142A,B05,093559,Chow; Bennett,6,0,32,26
1657372673107,MATH 193A,A01,083224,Rotar; Vladimir,8,0,34,26
1657372673107,MATH 193A,A02,083225,Rotar; Vladimir,9,0,34,25
1657372673107,MATH 193A,A03,083781,Rotar; Vladimir,5,0,34,29
1657372673107,MATH 193A,A04,083782,Rotar; Vladimir,10,0,34,24
1657372673107,MATH 193A,A05,093482,Rotar; Vladimir,10,0,34,24
1657372679144,MATH 197,001,091859,McAuley; Julian John,9999,0,9999,0
1657372679144,MATH 197,002,095566,Kedlaya; Kiran S.,9997,0,9999,2
1657372679144,MATH 197,003,095567,Xiao; Ming,9999,0,9999,0
1657372679144,MATH 197,004,095571,Perols; Johan Lars,9998,0,9999,1
1657372686209,COGS 9,A01,083615,Shannon; Kyle Michael,9,0,75,66
1657372692239,COGS 11,A01,083617,Boyle; Mary E. T.,22,0,48,26
1657372698264,COGS 13,A01,083071,Bastos; Amalia Pinkusfeld,11,0,71,60
1657372704293,COGS 14A,A01,092681,Semenuks; Arturs,4,1,100,96
1657372710325,COGS 14B,A01,083073,Cheng; Tzu-Han,6,0,63,57
1657372716349,COGS 17,A01,092677,Semenuks; Arturs,6,0,81,75
1657372722379,COGS 100,A01,083619,Allen; Michael Gordon,17,0,70,53
1657372728404,COGS 101A,A01,083621,Davis; Joshua Daniel,9,0,68,59
1657372734435,COGS 101B,A01,091572,Allen; Michael Gordon,11,0,65,54
1657372740464,COGS 101C,A01,083625,Delgado; Tania,17,0,35,18
1657372746491,COGS 107A,A01,083627,Boyle; Mary E. T.,13,0,60,47
1657372752519,COGS 118A,A01,083075,Gupta; Anjum,20,0,76,56
1657372758548,CSE 3,A50,083646,Miranda; Gregory Joseph,24,0,50,26
1657372764577,CSE 8A,A50,083650,Miranda; Gregory Joseph,17,1,56,39
1657372770607,CSE 11,A01,083080,Cao; Yingjun,6,15,40,34
1657372776638,CSE 12,A01,083652,Krause-Levy; Sophia Louisa,28,1,120,92
1657372782666,CSE 15L,A01,083654,Morris; Justin Loren,9,0,50,41
1657372782666,CSE 15L,A02,083655,Morris; Justin Loren,9,0,50,41
1657372788693,CSE 20,A01,083657,Tran; Khoa Dang,39,0,80,41
1657372794720,CSE 21,A01,095574,Bach; Quang Tran,22,0,48,26
1657372800746,CSE 30,A01,083084,Eldon; John,4,0,80,76
1657372800746,CSE 30,B01,095061,Bhaskar; Nishant,9,0,50,41
1657372806777,CSE 100,A01,083659,Cao; Yingjun,5,4,70,65
1657372812802,CSE 134B,A01,083661,Powell; Thomas Allan,22,0,100,78
1657372818827,CSE 140,A01,083663,Gungor; Onat,14,0,85,71
1657372824850,CSE 140L,A01,083088,Eldon; John,21,0,100,79
1657372830877,CSE 175,A01,083665,Kumar; Rakesh,3,0,25,22
1657372836907,CSE 190,A00,092507,Dubnov; Shlomo,7,0,20,13
1657372842934,ECE 45,A01,083139,Congero; Spencer William,6,0,75,69
1657372848967,ECE 65,A50,083695,Saad; Andrew S,12,0,30,18
1657372848967,ECE 65,A51,095125,Saad; Andrew S,24,0,26,2
1657372854997,ECE 109,A01,091882,Touri; Behrouz,19,0,70,51
1657372861028,ECE 180,A00,083140,Abi Samra; Nicholas Camill,1,0,30,29
1657372861028,ECE 180,B00,083141,Abi Samra; Nicholas Camill,0,0,30,30
1657372867059,MATH 10A,A01,083735,Patchell; Gregory David,2,0,30,28
1657372867059,MATH 10A,A02,083736,Patchell; Gregory David,20,0,30,10
1657372867059,MATH 10A,A03,083737,Patchell; Gregory David,16,0,30,14
1657372873088,MATH 10B,A01,083207,Lim; Seonhee,8,0,34,26
1657372873088,MATH 10B,A02,083208,Lim; Seonhee,9,0,35,26
1657372873088,MATH 10B,A03,093472,Lim; Seonhee,7,0,34,27
1657372873088,MATH 10B,B01,083739,Sinha; Shubham,12,0,30,18
1657372879119,MATH 18,A01,083743,Cinel; Cameron Alexander,7,0,30,23
1657372879119,MATH 18,A02,083744,Cinel; Cameron Alexander,17,0,30,13
1657372879119,MATH 18,A03,083745,Cinel; Cameron Alexander,9,0,30,21
1657372879119,MATH 18,B01,083748,Rideout; David Porter,5,0,37,32
1657372879119,MATH 18,B02,083749,Rideout; David Porter,5,0,36,31
1657372879119,MATH 18,B03,083750,Rideout; David Porter,3,0,37,34
1657372879119,MATH 18,B04,083751,Rideout; David Porter,6,0,36,30
1657372879119,MATH 18,B05,093473,Rideout; David Porter,6,0,36,30
1657372879119,MATH 18,B06,093474,Rideout; David Porter,6,0,36,30
1657372885144,MATH 20A,A01,083754,Zheng; Zequn,14,0,40,26
1657372891181,MATH 20B,A01,083756,Briones; Jor-el Thomas Caparas,4,0,36,32
1657372891181,MATH 20B,A02,083757,Briones; Jor-el Thomas Caparas,1,0,36,35
1657372891181,MATH 20B,A03,093475,Briones; Jor-el Thomas Caparas,2,0,36,34
1657372897206,MATH 20C,A01,083760,Briones; Jor-el Thomas Caparas,1,0,35,34
1657372897206,MATH 20C,A02,083761,Briones; Jor-el Thomas Caparas,8,0,35,27
1657372897206,MATH 20C,A03,093476,Briones; Jor-el Thomas Caparas,0,1,36,36
1657372897206,MATH 20C,B01,083762,Bach; Quang Tran,1,0,30,29
1657372903235,MATH 20D,A01,083765,Tran; Brian Kha,5,0,30,25
1657372903235,MATH 20D,A02,083766,Tran; Brian Kha,5,0,30,25
1657372903235,MATH 20D,A03,083767,Tran; Brian Kha,5,0,30,25
1657372909272,MATH 20E,A01,083771,Ganguly; Soumya,9,0,32,23
1657372909272,MATH 20E,A02,083772,Ganguly; Soumya,6,0,32,26
1657372909272,MATH 20E,B01,083773,Ciotti; Benjamin,20,0,35,15
1657372909272,MATH 20E,B02,083774,Ciotti; Benjamin,17,0,35,18
1657372915302,MATH 103A,A01,083777,Greenfeld; Be'Eri,3,0,36,33
1657372915302,MATH 103A,A02,083778,Greenfeld; Be'Eri,5,0,36,31
1657372915302,MATH 103A,A03,093561,Greenfeld; Be'Eri,5,0,36,31
1657372915302,MATH 103A,B01,083779,Greenfeld; Be'Eri,7,0,36,29
1657372915302,MATH 103A,B02,083780,Greenfeld; Be'Eri,4,0,36,32
1657372915302,MATH 103A,B03,093562,Greenfeld; Be'Eri,3,0,36,33
1657372921338,MATH 105,A01,085443,Carter; Anne Toulson,15,0,35,20
1657372921338,MATH 105,A02,093477,Carter; Anne Toulson,20,0,35,15
1657372927369,MATH 109,A01,083213,Ganzberger; Geoffrey Michael,2,0,34,32
1657372927369,MATH 109,A02,083214,Ganzberger; Geoffrey Michael,4,0,34,30
1657372927369,MATH 109,A03,093478,Ganzberger; Geoffrey Michael,2,0,34,32
1657372927369,MATH 109,B01,083215,Ganzberger; Geoffrey Michael,1,0,32,31
1657372927369,MATH 109,B02,083216,Ganzberger; Geoffrey Michael,2,0,32,30
1657372927369,MATH 109,B03,093479,Ganzberger; Geoffrey Michael,8,0,32,24
1657372933394,MATH 142A,A01,083219,Chow; Bennett,7,0,32,25
1657372933394,MATH 142A,A02,083220,Chow; Bennett,10,0,32,22
1657372933394,MATH 142A,A03,093480,Chow; Bennett,8,0,32,24
1657372933394,MATH 142A,B03,093481,Chow; Bennett,8,0,32,24
1657372933394,MATH 142A,B04,093558,Chow; Bennett,13,0,32,19
1657372933394,MATH 142A,B05,093559,Chow; Bennett,6,0,32,26
1657372939422,MATH 193A,A01,083224,Rotar; Vladimir,8,0,34,26
1657372939422,MATH 193A,A02,083225,Rotar; Vladimir,9,0,34,25
1657372939422,MATH 193A,A03,083781,Rotar; Vladimir,5,0,34,29
1657372939422,MATH 193A,A04,083782,Rotar; Vladimir,10,0,34,24
1657372939422,MATH 193A,A05,093482,Rotar; Vladimir,10,0,34,24
1657372945468,MATH 197,001,091859,McAuley; Julian John,9999,0,9999,0
1657372945468,MATH 197,002,095566,Kedlaya; Kiran S.,9997,0,9999,2
1657372945468,MATH 197,003,095567,Xiao; Ming,9999,0,9999,0
1657372945468,MATH 197,004,095571,Perols; Johan Lars,9998,0,9999,1
1657372952534,COGS 9,A01,083615,Shannon; Kyle Michael,9,0,75,66
1657372958558,COGS 11,A01,083617,Boyle; Mary E. T.,22,0,48,26
1657372964586,COGS 13,A01,083071,Bastos; Amalia Pinkusfeld,11,0,71,60
1657372970616,COGS 14A,A01,092681,Semenuks; Arturs,4,1,100,96
1657372976745,COGS 14B,A01,083073,Cheng; Tzu-Han,6,0,63,57
1657372982772,COGS 17,A01,092677,Semenuks; Arturs,6,0,81,75
1657372988803,COGS 100,A01,083619,Allen; Michael Gordon,17,0,70,53
1657372994834,COGS 101A,A01,083621,Davis; Joshua Daniel,9,0,68,59
1657373000865,COGS 101B,A01,091572,Allen; Michael Gordon,11,0,65,54
1657373006898,COGS 101C,A01,083625,Delgado; Tania,17,0,35,18
1657373012928,COGS 107A,A01,083627,Boyle; Mary E. T.,13,0,60,47
1657373018959,COGS 118A,A01,083075,Gupta; Anjum,20,0,76,56
1657373024994,CSE 3,A50,083646,Miranda; Gregory Joseph,24,0,50,26
1657373031018,CSE 8A,A50,083650,Miranda; Gregory Joseph,17,1,56,39
1657373037048,CSE 11,A01,083080,Cao; Yingjun,6,15,40,34
1657373043073,CSE 12,A01,083652,Krause-Levy; Sophia Louisa,28,1,120,92
1657373049102,CSE 15L,A01,083654,Morris; Justin Loren,9,0,50,41
1657373049102,CSE 15L,A02,083655,Morris; Justin Loren,9,0,50,41
1657373055138,CSE 20,A01,083657,Tran; Khoa Dang,39,0,80,41
1657373061163,CSE 21,A01,095574,Bach; Quang Tran,22,0,48,26
1657373067190,CSE 30,A01,083084,Eldon; John,4,0,80,76
1657373067190,CSE 30,B01,095061,Bhaskar; Nishant,9,0,50,41
1657373073217,CSE 100,A01,083659,Cao; Yingjun,5,4,70,65
1657373079241,CSE 134B,A01,083661,Powell; Thomas Allan,22,0,100,78
1657373085278,CSE 140,A01,083663,Gungor; Onat,14,0,85,71
1657373091310,CSE 140L,A01,083088,Eldon; John,21,0,100,79
1657373097336,CSE 175,A01,083665,Kumar; Rakesh,3,0,25,22
1657373103366,CSE 190,A00,092507,Dubnov; Shlomo,7,0,20,13
1657373109394,ECE 45,A01,083139,Congero; Spencer William,6,0,75,69
1657373115427,ECE 65,A50,083695,Saad; Andrew S,12,0,30,18
1657373115427,ECE 65,A51,095125,Saad; Andrew S,24,0,26,2
1657373121456,ECE 109,A01,091882,Touri; Behrouz,19,0,70,51
1657373127482,ECE 180,A00,083140,Abi Samra; Nicholas Camill,1,0,30,29
1657373127482,ECE 180,B00,083141,Abi Samra; Nicholas Camill,0,0,30,30
1657373133518,MATH 10A,A01,083735,Patchell; Gregory David,2,0,30,28
1657373133518,MATH 10A,A02,083736,Patchell; Gregory David,20,0,30,10
1657373133518,MATH 10A,A03,083737,Patchell; Gregory David,16,0,30,14
1657373139556,MATH 10B,A01,083207,Lim; Seonhee,8,0,34,26
1657373139556,MATH 10B,A02,083208,Lim; Seonhee,9,0,35,26
1657373139556,MATH 10B,A03,093472,Lim; Seonhee,7,0,34,27
1657373139556,MATH 10B,B01,083739,Sinha; Shubham,12,0,30,18
1657373145584,MATH 18,A01,083743,Cinel; Cameron Alexander,7,0,30,23
1657373145584,MATH 18,A02,083744,Cinel; Cameron Alexander,17,0,30,13
1657373145584,MATH 18,A03,083745,Cinel; Cameron Alexander,9,0,30,21
1657373145584,MATH 18,B01,083748,Rideout; David Porter,5,0,37,32
1657373145584,MATH 18,B02,083749,Rideout; David Porter,5,0,36,31
1657373145584,MATH 18,B03,083750,Rideout; David Porter,3,0,37,34
1657373145584,MATH 18,B04,083751,Rideout; David Porter,6,0,36,30
1657373145584,MATH 18,B05,093473,Rideout; David Porter,6,0,36,30
1657373145584,MATH 18,B06,093474,Rideout; David Porter,6,0,36,30
1657373151610,MATH 20A,A01,083754,Zheng; Zequn,14,0,40,26
1657373157636,MATH 20B,A01,083756,Briones; Jor-el Thomas Caparas,4,0,36,32
1657373157636,MATH 20B,A02,083757,Briones; Jor-el Thomas Caparas,1,0,36,35
1657373157636,MATH 20B,A03,093475,Briones; Jor-el Thomas Caparas,2,0,36,34
1657373163664,MATH 20C,A01,083760,Briones; Jor-el Thomas Caparas,1,0,35,34
1657373163664,MATH 20C,A02,083761,Briones; Jor-el Thomas Caparas,8,0,35,27
1657373163664,MATH 20C,A03,093476,Briones; Jor-el Thomas Caparas,0,1,36,36
1657373163664,MATH 20C,B01,083762,Bach; Quang Tran,1,0,30,29
1657373169690,MATH 20D,A01,083765,Tran; Brian Kha,5,0,30,25
1657373169690,MATH 20D,A02,083766,Tran; Brian Kha,5,0,30,25
1657373169690,MATH 20D,A03,083767,Tran; Brian Kha,5,0,30,25
1657373175725,MATH 20E,A01,083771,Ganguly; Soumya,9,0,32,23
1657373175725,MATH 20E,A02,083772,Ganguly; Soumya,6,0,32,26
1657373175725,MATH 20E,B01,083773,Ciotti; Benjamin,20,0,35,15
1657373175725,MATH 20E,B02,083774,Ciotti; Benjamin,17,0,35,18
1657373181754,MATH 103A,A01,083777,Greenfeld; Be'Eri,3,0,36,33
1657373181754,MATH 103A,A02,083778,Greenfeld; Be'Eri,5,0,36,31
1657373181754,MATH 103A,A03,093561,Greenfeld; Be'Eri,5,0,36,31
1657373181754,MATH 103A,B01,083779,Greenfeld; Be'Eri,7,0,36,29
1657373181754,MATH 103A,B02,083780,Greenfeld; Be'Eri,4,0,36,32
1657373181754,MATH 103A,B03,093562,Greenfeld; Be'Eri,3,0,36,33
1657373187786,MATH 105,A01,085443,Carter; Anne Toulson,15,0,35,20
1657373187786,MATH 105,A02,093477,Carter; Anne Toulson,20,0,35,15
1657373193811,MATH 109,A01,083213,Ganzberger; Geoffrey Michael,2,0,34,32
1657373193811,MATH 109,A02,083214,Ganzberger; Geoffrey Michael,4,0,34,30
1657373193811,MATH 109,A03,093478,Ganzberger; Geoffrey Michael,2,0,34,32
1657373193811,MATH 109,B01,083215,Ganzberger; Geoffrey Michael,1,0,32,31
1657373193811,MATH 109,B02,083216,Ganzberger; Geoffrey Michael,2,0,32,30
1657373193811,MATH 109,B03,093479,Ganzberger; Geoffrey Michael,8,0,32,24
1657373199839,MATH 142A,A01,083219,Chow; Bennett,7,0,32,25
1657373199839,MATH 142A,A02,083220,Chow; Bennett,10,0,32,22
1657373199839,MATH 142A,A03,093480,Chow; Bennett,8,0,32,24
1657373199839,MATH 142A,B03,093481,Chow; Bennett,8,0,32,24
1657373199839,MATH 142A,B04,093558,Chow; Bennett,13,0,32,19
1657373199839,MATH 142A,B05,093559,Chow; Bennett,6,0,32,26
1657373205879,MATH 193A,A01,083224,Rotar; Vladimir,8,0,34,26
1657373205879,MATH 193A,A02,083225,Rotar; Vladimir,9,0,34,25
1657373205879,MATH 193A,A03,083781,Rotar; Vladimir,5,0,34,29
1657373205879,MATH 193A,A04,083782,Rotar; Vladimir,10,0,34,24
1657373205879,MATH 193A,A05,093482,Rotar; Vladimir,10,0,34,24
1657373211906,MATH 197,001,091859,McAuley; Julian John,9999,0,9999,0
1657373211906,MATH 197,002,095566,Kedlaya; Kiran S.,9997,0,9999,2
1657373211906,MATH 197,003,095567,Xiao; Ming,9999,0,9999,0
1657373211906,MATH 197,004,095571,Perols; Johan Lars,9998,0,9999,1
1657373218981,COGS 9,A01,083615,Shannon; Kyle Michael,9,0,75,66
1657373225011,COGS 11,A01,083617,Boyle; Mary E. T.,22,0,48,26
1657373231043,COGS 13,A01,083071,Bastos; Amalia Pinkusfeld,11,0,71,60
1657373237079,COGS 14A,A01,092681,Semenuks; Arturs,4,1,100,96
1657373243110,COGS 14B,A01,083073,Cheng; Tzu-Han,6,0,63,57
1657373249136,COGS 17,A01,092677,Semenuks; Arturs,6,0,81,75
1657373255169,COGS 100,A01,083619,Allen; Michael Gordon,17,0,70,53
1657373261200,COGS 101A,A01,083621,Davis; Joshua Daniel,9,0,68,59
1657373267225,COGS 101B,A01,091572,Allen; Michael Gordon,11,0,65,54
1657373273253,COGS 101C,A01,083625,Delgado; Tania,17,0,35,18
1657373279283,COGS 107A,A01,083627,Boyle; Mary E. T.,13,0,60,47
1657373285311,COGS 118A,A01,083075,Gupta; Anjum,20,0,76,56
1657373291337,CSE 3,A50,083646,Miranda; Gregory Joseph,24,0,50,26
1657373297364,CSE 8A,A50,083650,Miranda; Gregory Joseph,17,1,56,39
1657373303393,CSE 11,A01,083080,Cao; Yingjun,6,15,40,34
1657373309424,CSE 12,A01,083652,Krause-Levy; Sophia Louisa,28,1,120,92
1657373315479,CSE 15L,A01,083654,Morris; Justin Loren,9,0,50,41
1657373315479,CSE 15L,A02,083655,Morris; Justin Loren,9,0,50,41
1657373321502,CSE 20,A01,083657,Tran; Khoa Dang,39,0,80,41
1657373327529,CSE 21,A01,095574,Bach; Quang Tran,22,0,48,26
1657373333560,CSE 30,A01,083084,Eldon; John,4,0,80,76
1657373333560,CSE 30,B01,095061,Bhaskar; Nishant,9,0,50,41
1657373339597,CSE 100,A01,083659,Cao; Yingjun,5,4,70,65
1657373345626,CSE 134B,A01,083661,Powell; Thomas Allan,22,0,100,78
1657373351654,CSE 140,A01,083663,Gungor; Onat,14,0,85,71
1657373357680,CSE 140L,A01,083088,Eldon; John,21,0,100,79
1657373363712,CSE 175,A01,083665,Kumar; Rakesh,3,0,25,22
1657373369743,CSE 190,A00,092507,Dubnov; Shlomo,7,0,20,13
1657373375775,ECE 45,A01,083139,Congero; Spencer William,6,0,75,69
1657373381808,ECE 65,A50,083695,Saad; Andrew S,12,0,30,18
1657373381808,ECE 65,A51,095125,Saad; Andrew S,24,0,26,2
1657373387835,ECE 109,A01,091882,Touri; Behrouz,19,0,70,51
1657373393895,ECE 180,A00,083140,Abi Samra; Nicholas Camill,1,0,30,29
1657373393895,ECE 180,B00,083141,Abi Samra; Nicholas Camill,0,0,30,30
1657373399929,MATH 10A,A01,083735,Patchell; Gregory David,2,0,30,28
1657373399929,MATH 10A,A02,083736,Patchell; Gregory David,20,0,30,10
1657373399929,MATH 10A,A03,083737,Patchell; Gregory David,16,0,30,14
1657373405956,MATH 10B,A01,083207,Lim; Seonhee,8,0,34,26
1657373405956,MATH 10B,A02,083208,Lim; Seonhee,9,0,35,26
1657373405956,MATH 10B,A03,093472,Lim; Seonhee,7,0,34,27
1657373405956,MATH 10B,B01,083739,Sinha; Shubham,12,0,30,18
1657373411987,MATH 18,A01,083743,Cinel; Cameron Alexander,7,0,30,23
1657373411987,MATH 18,A02,083744,Cinel; Cameron Alexander,17,0,30,13
1657373411987,MATH 18,A03,083745,Cinel; Cameron Alexander,9,0,30,21
1657373411987,MATH 18,B01,083748,Rideout; David Porter,5,0,37,32
1657373411987,MATH 18,B02,083749,Rideout; David Porter,5,0,36,31
1657373411987,MATH 18,B03,083750,Rideout; David Porter,3,0,37,34
1657373411987,MATH 18,B04,083751,Rideout; David Porter,6,0,36,30
1657373411987,MATH 18,B05,093473,Rideout; David Porter,6,0,36,30
1657373411987,MATH 18,B06,093474,Rideout; David Porter,6,0,36,30
1657373418010,MATH 20A,A01,083754,Zheng; Zequn,14,0,40,26
1657373424040,MATH 20B,A01,083756,Briones; Jor-el Thomas Caparas,4,0,36,32
1657373424040,MATH 20B,A02,083757,Briones; Jor-el Thomas Caparas,1,0,36,35
1657373424040,MATH 20B,A03,093475,Briones; Jor-el Thomas Caparas,2,0,36,34
1657373430068,MATH 20C,A01,083760,Briones; Jor-el Thomas Caparas,1,0,35,34
1657373430068,MATH 20C,A02,083761,Briones; Jor-el Thomas Caparas,8,0,35,27
1657373430068,MATH 20C,A03,093476,Briones; Jor-el Thomas Caparas,0,1,36,36
1657373430068,MATH 20C,B01,083762,Bach; Quang Tran,1,0,30,29
1657373436093,MATH 20D,A01,083765,Tran; Brian Kha,5,0,30,25
1657373436093,MATH 20D,A02,083766,Tran; Brian Kha,5,0,30,25
1657373436093,MATH 20D,A03,083767,Tran; Brian Kha,5,0,30,25
1657373442123,MATH 20E,A01,083771,Ganguly; Soumya,9,0,32,23
1657373442123,MATH 20E,A02,083772,Ganguly; Soumya,6,0,32,26
1657373442123,MATH 20E,B01,083773,Ciotti; Benjamin,20,0,35,15
1657373442123,MATH 20E,B02,083774,Ciotti; Benjamin,17,0,35,18
1657373448149,MATH 103A,A01,083777,Greenfeld; Be'Eri,3,0,36,33
1657373448149,MATH 103A,A02,083778,Greenfeld; Be'Eri,5,0,36,31
1657373448149,MATH 103A,A03,093561,Greenfeld; Be'Eri,5,0,36,31
1657373448149,MATH 103A,B01,083779,Greenfeld; Be'Eri,7,0,36,29
1657373448149,MATH 103A,B02,083780,Greenfeld; Be'Eri,4,0,36,32
1657373448149,MATH 103A,B03,093562,Greenfeld; Be'Eri,3,0,36,33
1657373454180,MATH 105,A01,085443,Carter; Anne Toulson,15,0,35,20
1657373454180,MATH 105,A02,093477,Carter; Anne Toulson,20,0,35,15
1657373460206,MATH 109,A01,083213,Ganzberger; Geoffrey Michael,2,0,34,32
1657373460206,MATH 109,A02,083214,Ganzberger; Geoffrey Michael,4,0,34,30
1657373460206,MATH 109,A03,093478,Ganzberger; Geoffrey Michael,2,0,34,32
1657373460206,MATH 109,B01,083215,Ganzberger; Geoffrey Michael,1,0,32,31
1657373460206,MATH 109,B02,083216,Ganzberger; Geoffrey Michael,2,0,32,30
1657373460206,MATH 109,B03,093479,Ganzberger; Geoffrey Michael,8,0,32,24
1657373466232,MATH 142A,A01,083219,Chow; Bennett,7,0,32,25
1657373466232,MATH 142A,A02,083220,Chow; Bennett,10,0,32,22
1657373466232,MATH 142A,A03,093480,Chow; Bennett,8,0,32,24
1657373466232,MATH 142A,B03,093481,Chow; Bennett,8,0,32,24
1657373466232,MATH 142A,B04,093558,Chow; Bennett,13,0,32,19
1657373466232,MATH 142A,B05,093559,Chow; Bennett,6,0,32,26
1657373472265,MATH 193A,A01,083224,Rotar; Vladimir,8,0,34,26
1657373472265,MATH 193A,A02,083225,Rotar; Vladimir,9,0,34,25
1657373472265,MATH 193A,A03,083781,Rotar; Vladimir,5,0,34,29
1657373472265,MATH 193A,A04,083782,Rotar; Vladimir,10,0,34,24
1657373472265,MATH 193A,A05,093482,Rotar; Vladimir,10,0,34,24
1657373478290,MATH 197,001,091859,McAuley; Julian John,9999,0,9999,0
1657373478290,MATH 197,002,095566,Kedlaya; Kiran S.,9997,0,9999,2
1657373478290,MATH 197,003,095567,Xiao; Ming,9999,0,9999,0
1657373478290,MATH 197,004,095571,Perols; Johan Lars,9998,0,9999,1
1657373485356,COGS 9,A01,083615,Shannon; Kyle Michael,9,0,75,66
1657373491387,COGS 11,A01,083617,Boyle; Mary E. T.,22,0,48,26
1657373497420,COGS 13,A01,083071,Bastos; Amalia Pinkusfeld,11,0,71,60
1657373503454,COGS 14A,A01,092681,Semenuks; Arturs,4,1,100,96
1657373509483,COGS 14B,A01,083073,Cheng; Tzu-Han,6,0,63,57
1657373515508,COGS 17,A01,092677,Semenuks; Arturs,6,0,81,75
1657373521537,COGS 100,A01,083619,Allen; Michael Gordon,17,0,70,53
1657373527566,COGS 101A,A01,083621,Davis; Joshua Daniel,9,0,68,59
1657373533596,COGS 101B,A01,091572,Allen; Michael Gordon,11,0,65,54
1657373539624,COGS 101C,A01,083625,Delgado; Tania,17,0,35,18
1657373545649,COGS 107A,A01,083627,Boyle; Mary E. T.,13,0,60,47
1657373551689,COGS 118A,A01,083075,Gupta; Anjum,20,0,76,56
1657373557714,CSE 3,A50,083646,Miranda; Gregory Joseph,24,0,50,26
1657373563746,CSE 8A,A50,083650,Miranda; Gregory Joseph,17,1,56,39
1657373569770,CSE 11,A01,083080,Cao; Yingjun,6,15,40,34
1657373575872,CSE 12,A01,083652,Krause-Levy; Sophia Louisa,28,1,120,92
1657373581898,CSE 15L,A01,083654,Morris; Justin Loren,9,0,50,41
1657373581898,CSE 15L,A02,083655,Morris; Justin Loren,9,0,50,41
1657373587926,CSE 20,A01,083657,Tran; Khoa Dang,39,0,80,41
1657373593957,CSE 21,A01,095574,Bach; Quang Tran,22,0,48,26
1657373599990,CSE 30,A01,083084,Eldon; John,4,0,80,76
1657373599990,CSE 30,B01,095061,Bhaskar; Nishant,9,0,50,41
1657373606026,CSE 100,A01,083659,Cao; Yingjun,5,4,70,65
1657373612057,CSE 134B,A01,083661,Powell; Thomas Allan,22,0,100,78
1657373618087,CSE 140,A01,083663,Gungor; Onat,14,0,85,71
1657373624111,CSE 140L,A01,083088,Eldon; John,21,0,100,79
1657373630148,CSE 175,A01,083665,Kumar; Rakesh,3,0,25,22
1657373636181,CSE 190,A00,092507,Dubnov; Shlomo,7,0,20,13
1657373642208,ECE 45,A01,083139,Congero; Spencer William,6,0,75,69
1657373648235,ECE 65,A50,083695,Saad; Andrew S,12,0,30,18
1657373648235,ECE 65,A51,095125,Saad; Andrew S,24,0,26,2
1657373654268,ECE 109,A01,091882,Touri; Behrouz,19,0,70,51
1657373660299,ECE 180,A00,083140,Abi Samra; Nicholas Camill,1,0,30,29
1657373660299,ECE 180,B00,083141,Abi Samra; Nicholas Camill,0,0,30,30
1657373666337,MATH 10A,A01,083735,Patchell; Gregory David,2,0,30,28
1657373666337,MATH 10A,A02,083736,Patchell; Gregory David,20,0,30,10
1657373666337,MATH 10A,A03,083737,Patchell; Gregory David,16,0,30,14
1657373672375,MATH 10B,A01,083207,Lim; Seonhee,8,0,34,26
1657373672375,MATH 10B,A02,083208,Lim; Seonhee,9,0,35,26
1657373672375,MATH 10B,A03,093472,Lim; Seonhee,7,0,34,27
1657373672375,MATH 10B,B01,083739,Sinha; Shubham,12,0,30,18
1657373678428,MATH 18,A01,083743,Cinel; Cameron Alexander,7,0,30,23
1657373678428,MATH 18,A02,083744,Cinel; Cameron Alexander,17,0,30,13
1657373678428,MATH 18,A03,083745,Cinel; Cameron Alexander,9,0,30,21
1657373678428,MATH 18,B01,083748,Rideout; David Porter,5,0,37,32
1657373678428,MATH 18,B02,083749,Rideout; David Porter,5,0,36,31
1657373678428,MATH 18,B03,083750,Rideout; David Porter,3,0,37,34
1657373678428,MATH 18,B04,083751,Rideout; David Porter,6,0,36,30
1657373678428,MATH 18,B05,093473,Rideout; David Porter,6,0,36,30
1657373678428,MATH 18,B06,093474,Rideout; David Porter,6,0,36,30
1657373684467,MATH 20A,A01,083754,Zheng; Zequn,14,0,40,26
1657373690505,MATH 20B,A01,083756,Briones; Jor-el Thomas Caparas,4,0,36,32
1657373690505,MATH 20B,A02,083757,Briones; Jor-el Thomas Caparas,1,0,36,35
1657373690505,MATH 20B,A03,093475,Briones; Jor-el Thomas Caparas,2,0,36,34
1657373696539,MATH 20C,A01,083760,Briones; Jor-el Thomas Caparas,1,0,35,34
1657373696539,MATH 20C,A02,083761,Briones; Jor-el Thomas Caparas,8,0,35,27
1657373696539,MATH 20C,A03,093476,Briones; Jor-el Thomas Caparas,0,1,36,36
1657373696539,MATH 20C,B01,083762,Bach; Quang Tran,1,0,30,29
1657373702566,MATH 20D,A01,083765,Tran; Brian Kha,5,0,30,25
1657373702566,MATH 20D,A02,083766,Tran; Brian Kha,5,0,30,25
1657373702566,MATH 20D,A03,083767,Tran; Brian Kha,5,0,30,25
1657373710393,MATH 20E,A01,083771,Ganguly; Soumya,9,0,32,23
1657373710393,MATH 20E,A02,083772,Ganguly; Soumya,6,0,32,26
1657373710393,MATH 20E,B01,083773,Ciotti; Benjamin,20,0,35,15
1657373710393,MATH 20E,B02,083774,Ciotti; Benjamin,17,0,35,18
1657373716427,MATH 103A,A01,083777,Greenfeld; Be'Eri,3,0,36,33
1657373716427,MATH 103A,A02,083778,Greenfeld; Be'Eri,5,0,36,31
1657373716427,MATH 103A,A03,093561,Greenfeld; Be'Eri,5,0,36,31
1657373716427,MATH 103A,B01,083779,Greenfeld; Be'Eri,7,0,36,29
1657373716427,MATH 103A,B02,083780,Greenfeld; Be'Eri,4,0,36,32
1657373716427,MATH 103A,B03,093562,Greenfeld; Be'Eri,3,0,36,33
1657373722474,MATH 105,A01,085443,Carter; Anne Toulson,15,0,35,20
1657373722474,MATH 105,A02,093477,Carter; Anne Toulson,20,0,35,15
1657373728504,MATH 109,A01,083213,Ganzberger; Geoffrey Michael,2,0,34,32
1657373728504,MATH 109,A02,083214,Ganzberger; Geoffrey Michael,4,0,34,30
1657373728504,MATH 109,A03,093478,Ganzberger; Geoffrey Michael,2,0,34,32
1657373728504,MATH 109,B01,083215,Ganzberger; Geoffrey Michael,1,0,32,31
1657373728504,MATH 109,B02,083216,Ganzberger; Geoffrey Michael,2,0,32,30
1657373728504,MATH 109,B03,093479,Ganzberger; Geoffrey Michael,8,0,32,24
1657373734532,MATH 142A,A01,083219,Chow; Bennett,7,0,32,25
1657373734532,MATH 142A,A02,083220,Chow; Bennett,10,0,32,22
1657373734532,MATH 142A,A03,093480,Chow; Bennett,8,0,32,24
1657373734532,MATH 142A,B03,093481,Chow; Bennett,8,0,32,24
1657373734532,MATH 142A,B04,093558,Chow; Bennett,13,0,32,19
1657373734532,MATH 142A,B05,093559,Chow; Bennett,6,0,32,26
1657373740560,MATH 193A,A01,083224,Rotar; Vladimir,8,0,34,26
1657373740560,MATH 193A,A02,083225,Rotar; Vladimir,9,0,34,25
1657373740560,MATH 193A,A03,083781,Rotar; Vladimir,5,0,34,29
1657373740560,MATH 193A,A04,083782,Rotar; Vladimir,10,0,34,24
1657373740560,MATH 193A,A05,093482,Rotar; Vladimir,10,0,34,24
1657373746590,MATH 197,001,091859,McAuley; Julian John,9999,0,9999,0
1657373746590,MATH 197,002,095566,Kedlaya; Kiran S.,9997,0,9999,2
1657373746590,MATH 197,003,095567,Xiao; Ming,9999,0,9999,0
1657373746590,MATH 197,004,095571,Perols; Johan Lars,9998,0,9999,1
1657373753687,COGS 9,A01,083615,Shannon; Kyle Michael,9,0,75,66
1657373759713,COGS 11,A01,083617,Boyle; Mary E. T.,22,0,48,26
1657373765740,COGS 13,A01,083071,Bastos; Amalia Pinkusfeld,11,0,71,60
1657373771766,COGS 14A,A01,092681,Semenuks; Arturs,4,1,100,96
1657373777797,COGS 14B,A01,083073,Cheng; Tzu-Han,6,0,63,57
1657373783823,COGS 17,A01,092677,Semenuks; Arturs,6,0,81,75
1657373789853,COGS 100,A01,083619,Allen; Michael Gordon,17,0,70,53
1657373795886,COGS 101A,A01,083621,Davis; Joshua Daniel,9,0,68,59
1657373801925,COGS 101B,A01,091572,Allen; Michael Gordon,11,0,65,54
1657373807956,COGS 101C,A01,083625,Delgado; Tania,17,0,35,18
1657373813986,COGS 107A,A01,083627,Boyle; Mary E. T.,13,0,60,47
1657373820019,COGS 118A,A01,083075,Gupta; Anjum,20,0,76,56
1657373826059,CSE 3,A50,083646,Miranda; Gregory Joseph,24,0,50,26
1657373832096,CSE 8A,A50,083650,Miranda; Gregory Joseph,17,1,56,39
1657373838126,CSE 11,A01,083080,Cao; Yingjun,6,15,40,34
1657373844159,CSE 12,A01,083652,Krause-Levy; Sophia Louisa,28,1,120,92
1657373850185,CSE 15L,A01,083654,Morris; Justin Loren,9,0,50,41
1657373850185,CSE 15L,A02,083655,Morris; Justin Loren,9,0,50,41
1657373856209,CSE 20,A01,083657,Tran; Khoa Dang,39,0,80,41
1657373862240,CSE 21,A01,095574,Bach; Quang Tran,22,0,48,26
1657373868268,CSE 30,A01,083084,Eldon; John,4,0,80,76
1657373868268,CSE 30,B01,095061,Bhaskar; Nishant,9,0,50,41
1657373874296,CSE 100,A01,083659,Cao; Yingjun,5,4,70,65
1657373880330,CSE 134B,A01,083661,Powell; Thomas Allan,22,0,100,78
1657373886361,CSE 140,A01,083663,Gungor; Onat,14,0,85,71
1657373892393,CSE 140L,A01,083088,Eldon; John,21,0,100,79
1657373898419,CSE 175,A01,083665,Kumar; Rakesh,3,0,25,22
1657373904451,CSE 190,A00,092507,Dubnov; Shlomo,7,0,20,13
1657373910484,ECE 45,A01,083139,Congero; Spencer William,6,0,75,69
1657373916518,ECE 65,A50,083695,Saad; Andrew S,12,0,30,18
1657373916518,ECE 65,A51,095125,Saad; Andrew S,24,0,26,2
1657373922548,ECE 109,A01,091882,Touri; Behrouz,19,0,70,51
1657373928575,ECE 180,A00,083140,Abi Samra; Nicholas Camill,1,0,30,29
1657373928575,ECE 180,B00,083141,Abi Samra; Nicholas Camill,0,0,30,30
1657373934610,MATH 10A,A01,083735,Patchell; Gregory David,2,0,30,28
1657373934610,MATH 10A,A02,083736,Patchell; Gregory David,20,0,30,10
1657373934610,MATH 10A,A03,083737,Patchell; Gregory David,16,0,30,14
1657373940638,MATH 10B,A01,083207,Lim; Seonhee,8,0,34,26
1657373940638,MATH 10B,A02,083208,Lim; Seonhee,9,0,35,26
1657373940638,MATH 10B,A03,093472,Lim; Seonhee,7,0,34,27
1657373940638,MATH 10B,B01,083739,Sinha; Shubham,12,0,30,18
1657373946667,MATH 18,A01,083743,Cinel; Cameron Alexander,7,0,30,23
1657373946667,MATH 18,A02,083744,Cinel; Cameron Alexander,17,0,30,13
1657373946667,MATH 18,A03,083745,Cinel; Cameron Alexander,9,0,30,21
1657373946667,MATH 18,B01,083748,Rideout; David Porter,5,0,37,32
1657373946667,MATH 18,B02,083749,Rideout; David Porter,5,0,36,31
1657373946667,MATH 18,B03,083750,Rideout; David Porter,3,0,37,34
1657373946667,MATH 18,B04,083751,Rideout; David Porter,6,0,36,30
1657373946667,MATH 18,B05,093473,Rideout; David Porter,6,0,36,30
1657373946667,MATH 18,B06,093474,Rideout; David Porter,6,0,36,30
1657373952697,MATH 20A,A01,083754,Zheng; Zequn,14,0,40,26
1657373958726,MATH 20B,A01,083756,Briones; Jor-el Thomas Caparas,4,0,36,32
1657373958726,MATH 20B,A02,083757,Briones; Jor-el Thomas Caparas,1,0,36,35
1657373958726,MATH 20B,A03,093475,Briones; Jor-el Thomas Caparas,2,0,36,34
1657373964751,MATH 20C,A01,083760,Briones; Jor-el Thomas Caparas,1,0,35,34
1657373964751,MATH 20C,A02,083761,Briones; Jor-el Thomas Caparas,8,0,35,27
1657373964751,MATH 20C,A03,093476,Briones; Jor-el Thomas Caparas,0,1,36,36
1657373964751,MATH 20C,B01,083762,Bach; Quang Tran,1,0,30,29
1657373970778,MATH 20D,A01,083765,Tran; Brian Kha,5,0,30,25
1657373970778,MATH 20D,A02,083766,Tran; Brian Kha,5,0,30,25
1657373970778,MATH 20D,A03,083767,Tran; Brian Kha,5,0,30,25
1657373976815,MATH 20E,A01,083771,Ganguly; Soumya,9,0,32,23
1657373976815,MATH 20E,A02,083772,Ganguly; Soumya,6,0,32,26
1657373976815,MATH 20E,B01,083773,Ciotti; Benjamin,20,0,35,15
1657373976815,MATH 20E,B02,083774,Ciotti; Benjamin,17,0,35,18
1657373982845,MATH 103A,A01,083777,Greenfeld; Be'Eri,3,0,36,33
1657373982845,MATH 103A,A02,083778,Greenfeld; Be'Eri,5,0,36,31
1657373982845,MATH 103A,A03,093561,Greenfeld; Be'Eri,5,0,36,31
1657373982845,MATH 103A,B01,083779,Greenfeld; Be'Eri,7,0,36,29
1657373982845,MATH 103A,B02,083780,Greenfeld; Be'Eri,4,0,36,32
1657373982845,MATH 103A,B03,093562,Greenfeld; Be'Eri,3,0,36,33
1657373988899,MATH 105,A01,085443,Carter; Anne Toulson,15,0,35,20
1657373988899,MATH 105,A02,093477,Carter; Anne Toulson,20,0,35,15
1657373994931,MATH 109,A01,083213,Ganzberger; Geoffrey Michael,2,0,34,32
1657373994931,MATH 109,A02,083214,Ganzberger; Geoffrey Michael,4,0,34,30
1657373994931,MATH 109,A03,093478,Ganzberger; Geoffrey Michael,2,0,34,32
1657373994931,MATH 109,B01,083215,Ganzberger; Geoffrey Michael,1,0,32,31
1657373994931,MATH 109,B02,083216,Ganzberger; Geoffrey Michael,2,0,32,30
1657373994931,MATH 109,B03,093479,Ganzberger; Geoffrey Michael,8,0,32,24
1657374000968,MATH 142A,A01,083219,Chow; Bennett,7,0,32,25
1657374000968,MATH 142A,A02,083220,Chow; Bennett,10,0,32,22
1657374000968,MATH 142A,A03,093480,Chow; Bennett,8,0,32,24
1657374000968,MATH 142A,B03,093481,Chow; Bennett,8,0,32,24
1657374000968,MATH 142A,B04,093558,Chow; Bennett,13,0,32,19
1657374000968,MATH 142A,B05,093559,Chow; Bennett,6,0,32,26
1657374006999,MATH 193A,A01,083224,Rotar; Vladimir,8,0,34,26
1657374006999,MATH 193A,A02,083225,Rotar; Vladimir,9,0,34,25
1657374006999,MATH 193A,A03,083781,Rotar; Vladimir,5,0,34,29
1657374006999,MATH 193A,A04,083782,Rotar; Vladimir,10,0,34,24
1657374006999,MATH 193A,A05,093482,Rotar; Vladimir,10,0,34,24
1657374013036,MATH 197,001,091859,McAuley; Julian John,9999,0,9999,0
1657374013036,MATH 197,002,095566,Kedlaya; Kiran S.,9997,0,9999,2
1657374013036,MATH 197,003,095567,Xiao; Ming,9999,0,9999,0
1657374013036,MATH 197,004,095571,Perols; Johan Lars,9998,0,9999,1
1657374020115,COGS 9,A01,083615,Shannon; Kyle Michael,9,0,75,66
1657374026140,COGS 11,A01,083617,Boyle; Mary E. T.,22,0,48,26
1657374032168,COGS 13,A01,083071,Bastos; Amalia Pinkusfeld,11,0,71,60
1657374038207,COGS 14A,A01,092681,Semenuks; Arturs,4,1,100,96
1657374044234,COGS 14B,A01,083073,Cheng; Tzu-Han,6,0,63,57
1657374050262,COGS 17,A01,092677,Semenuks; Arturs,6,0,81,75
1657374056287,COGS 100,A01,083619,Allen; Michael Gordon,17,0,70,53
1657374062329,COGS 101A,A01,083621,Davis; Joshua Daniel,9,0,68,59
1657374068355,COGS 101B,A01,091572,Allen; Michael Gordon,11,0,65,54
1657374074379,COGS 101C,A01,083625,Delgado; Tania,17,0,35,18
1657374080411,COGS 107A,A01,083627,Boyle; Mary E. T.,13,0,60,47
1657374086437,COGS 118A,A01,083075,Gupta; Anjum,20,0,76,56
1657374092470,CSE 3,A50,083646,Miranda; Gregory Joseph,24,0,50,26
1657374098495,CSE 8A,A50,083650,Miranda; Gregory Joseph,17,1,56,39
1657374104525,CSE 11,A01,083080,Cao; Yingjun,6,15,40,34
1657374110553,CSE 12,A01,083652,Krause-Levy; Sophia Louisa,28,1,120,92
1657374116582,CSE 15L,A01,083654,Morris; Justin Loren,9,0,50,41
1657374116582,CSE 15L,A02,083655,Morris; Justin Loren,9,0,50,41
1657374122615,CSE 20,A01,083657,Tran; Khoa Dang,39,0,80,41
1657374128639,CSE 21,A01,095574,Bach; Quang Tran,22,0,48,26
1657374134666,CSE 30,A01,083084,Eldon; John,4,0,80,76
1657374134666,CSE 30,B01,095061,Bhaskar; Nishant,9,0,50,41
1657374140691,CSE 100,A01,083659,Cao; Yingjun,5,4,70,65
1657374146716,CSE 134B,A01,083661,Powell; Thomas Allan,22,0,100,78
1657374152742,CSE 140,A01,083663,Gungor; Onat,14,0,85,71
1657374158771,CSE 140L,A01,083088,Eldon; John,21,0,100,79
1657374164798,CSE 175,A01,083665,Kumar; Rakesh,3,0,25,22
1657374170825,CSE 190,A00,092507,Dubnov; Shlomo,7,0,20,13
1657374176946,ECE 45,A01,083139,Congero; Spencer William,6,0,75,69
1657374182973,ECE 65,A50,083695,Saad; Andrew S,12,0,30,18
1657374182973,ECE 65,A51,095125,Saad; Andrew S,24,0,26,2
1657374188998,ECE 109,A01,091882,Touri; Behrouz,19,0,70,51
1657374195029,ECE 180,A00,083140,Abi Samra; Nicholas Camill,1,0,30,29
1657374195029,ECE 180,B00,083141,Abi Samra; Nicholas Camill,0,0,30,30
1657374201056,MATH 10A,A01,083735,Patchell; Gregory David,2,0,30,28
1657374201056,MATH 10A,A02,083736,Patchell; Gregory David,20,0,30,10
1657374201056,MATH 10A,A03,083737,Patchell; Gregory David,16,0,30,14
1657374207091,MATH 10B,A01,083207,Lim; Seonhee,8,0,34,26
1657374207091,MATH 10B,A02,083208,Lim; Seonhee,9,0,35,26
1657374207091,MATH 10B,A03,093472,Lim; Seonhee,7,0,34,27
1657374207091,MATH 10B,B01,083739,Sinha; Shubham,12,0,30,18
1657374213128,MATH 18,A01,083743,Cinel; Cameron Alexander,7,0,30,23
1657374213128,MATH 18,A02,083744,Cinel; Cameron Alexander,17,0,30,13
1657374213128,MATH 18,A03,083745,Cinel; Cameron Alexander,9,0,30,21
1657374213128,MATH 18,B01,083748,Rideout; David Porter,5,0,37,32
1657374213128,MATH 18,B02,083749,Rideout; David Porter,5,0,36,31
1657374213128,MATH 18,B03,083750,Rideout; David Porter,3,0,37,34
1657374213128,MATH 18,B04,083751,Rideout; David Porter,6,0,36,30
1657374213128,MATH 18,B05,093473,Rideout; David Porter,6,0,36,30
1657374213128,MATH 18,B06,093474,Rideout; David Porter,6,0,36,30
1657374219156,MATH 20A,A01,083754,Zheng; Zequn,14,0,40,26
1657374225179,MATH 20B,A01,083756,Briones; Jor-el Thomas Caparas,4,0,36,32
1657374225179,MATH 20B,A02,083757,Briones; Jor-el Thomas Caparas,1,0,36,35
1657374225179,MATH 20B,A03,093475,Briones; Jor-el Thomas Caparas,2,0,36,34
1657374231218,MATH 20C,A01,083760,Briones; Jor-el Thomas Caparas,1,0,35,34
1657374231218,MATH 20C,A02,083761,Briones; Jor-el Thomas Caparas,8,0,35,27
1657374231218,MATH 20C,A03,093476,Briones; Jor-el Thomas Caparas,0,1,36,36
1657374231218,MATH 20C,B01,083762,Bach; Quang Tran,1,0,30,29
1657374237248,MATH 20D,A01,083765,Tran; Brian Kha,5,0,30,25
1657374237248,MATH 20D,A02,083766,Tran; Brian Kha,5,0,30,25
1657374237248,MATH 20D,A03,083767,Tran; Brian Kha,5,0,30,25
1657374243274,MATH 20E,A01,083771,Ganguly; Soumya,9,0,32,23
1657374243274,MATH 20E,A02,083772,Ganguly; Soumya,6,0,32,26
1657374243274,MATH 20E,B01,083773,Ciotti; Benjamin,20,0,35,15
1657374243274,MATH 20E,B02,083774,Ciotti; Benjamin,17,0,35,18
1657374249308,MATH 103A,A01,083777,Greenfeld; Be'Eri,3,0,36,33
1657374249308,MATH 103A,A02,083778,Greenfeld; Be'Eri,5,0,36,31
1657374249308,MATH 103A,A03,093561,Greenfeld; Be'Eri,5,0,36,31
1657374249308,MATH 103A,B01,083779,Greenfeld; Be'Eri,7,0,36,29
1657374249308,MATH 103A,B02,083780,Greenfeld; Be'Eri,4,0,36,32
1657374249308,MATH 103A,B03,093562,Greenfeld; Be'Eri,3,0,36,33
1657374255334,MATH 105,A01,085443,Carter; Anne Toulson,15,0,35,20
1657374255334,MATH 105,A02,093477,Carter; Anne Toulson,20,0,35,15
1657374261365,MATH 109,A01,083213,Ganzberger; Geoffrey Michael,2,0,34,32
1657374261365,MATH 109,A02,083214,Ganzberger; Geoffrey Michael,4,0,34,30
1657374261365,MATH 109,A03,093478,Ganzberger; Geoffrey Michael,2,0,34,32
1657374261365,MATH 109,B01,083215,Ganzberger; Geoffrey Michael,1,0,32,31
1657374261365,MATH 109,B02,083216,Ganzberger; Geoffrey Michael,2,0,32,30
1657374261365,MATH 109,B03,093479,Ganzberger; Geoffrey Michael,8,0,32,24
1657374267390,MATH 142A,A01,083219,Chow; Bennett,7,0,32,25
1657374267390,MATH 142A,A02,083220,Chow; Bennett,10,0,32,22
1657374267390,MATH 142A,A03,093480,Chow; Bennett,8,0,32,24
1657374267390,MATH 142A,B03,093481,Chow; Bennett,8,0,32,24
1657374267390,MATH 142A,B04,093558,Chow; Bennett,13,0,32,19
1657374267390,MATH 142A,B05,093559,Chow; Bennett,6,0,32,26
1657374273423,MATH 193A,A01,083224,Rotar; Vladimir,8,0,34,26
1657374273423,MATH 193A,A02,083225,Rotar; Vladimir,9,0,34,25
1657374273423,MATH 193A,A03,083781,Rotar; Vladimir,5,0,34,29
1657374273423,MATH 193A,A04,083782,Rotar; Vladimir,10,0,34,24
1657374273423,MATH 193A,A05,093482,Rotar; Vladimir,10,0,34,24
1657374279448,MATH 197,001,091859,McAuley; Julian John,9999,0,9999,0
1657374279448,MATH 197,002,095566,Kedlaya; Kiran S.,9997,0,9999,2
1657374279448,MATH 197,003,095567,Xiao; Ming,9999,0,9999,0
1657374279448,MATH 197,004,095571,Perols; Johan Lars,9998,0,9999,1
1657374286515,COGS 9,A01,083615,Shannon; Kyle Michael,9,0,75,66
1657374292538,COGS 11,A01,083617,Boyle; Mary E. T.,22,0,48,26
1657374298563,COGS 13,A01,083071,Bastos; Amalia Pinkusfeld,11,0,71,60
1657374304593,COGS 14A,A01,092681,Semenuks; Arturs,4,1,100,96
1657374310620,COGS 14B,A01,083073,Cheng; Tzu-Han,6,0,63,57
1657374316651,COGS 17,A01,092677,Semenuks; Arturs,6,0,81,75
1657374322681,COGS 100,A01,083619,Allen; Michael Gordon,17,0,70,53
1657374328711,COGS 101A,A01,083621,Davis; Joshua Daniel,9,0,68,59
1657374334736,COGS 101B,A01,091572,Allen; Michael Gordon,11,0,65,54
1657374340760,COGS 101C,A01,083625,Delgado; Tania,17,0,35,18
1657374346793,COGS 107A,A01,083627,Boyle; Mary E. T.,13,0,60,47
1657374352824,COGS 118A,A01,083075,Gupta; Anjum,20,0,76,56
1657374358855,CSE 3,A50,083646,Miranda; Gregory Joseph,24,0,50,26
1657374364879,CSE 8A,A50,083650,Miranda; Gregory Joseph,17,1,56,39
1657374370907,CSE 11,A01,083080,Cao; Yingjun,6,15,40,34
1657374376940,CSE 12,A01,083652,Krause-Levy; Sophia Louisa,28,1,120,92
1657374382963,CSE 15L,A01,083654,Morris; Justin Loren,9,0,50,41
1657374382963,CSE 15L,A02,083655,Morris; Justin Loren,9,0,50,41
1657374388995,CSE 20,A01,083657,Tran; Khoa Dang,39,0,80,41
1657374395033,CSE 21,A01,095574,Bach; Quang Tran,22,0,48,26
1657374401059,CSE 30,A01,083084,Eldon; John,4,0,80,76
1657374401059,CSE 30,B01,095061,Bhaskar; Nishant,9,0,50,41
1657374407084,CSE 100,A01,083659,Cao; Yingjun,5,4,70,65
1657374413109,CSE 134B,A01,083661,Powell; Thomas Allan,22,0,100,78
1657374419141,CSE 140,A01,083663,Gungor; Onat,14,0,85,71
1657374425167,CSE 140L,A01,083088,Eldon; John,21,0,100,79
1657374431194,CSE 175,A01,083665,Kumar; Rakesh,3,0,25,22
1657374437221,CSE 190,A00,092507,Dubnov; Shlomo,7,0,20,13
1657374443257,ECE 45,A01,083139,Congero; Spencer William,6,0,75,69
1657374449284,ECE 65,A50,083695,Saad; Andrew S,12,0,30,18
1657374449284,ECE 65,A51,095125,Saad; Andrew S,24,0,26,2
1657374455311,ECE 109,A01,091882,Touri; Behrouz,19,0,70,51
1657374461341,ECE 180,A00,083140,Abi Samra; Nicholas Camill,1,0,30,29
1657374461341,ECE 180,B00,083141,Abi Samra; Nicholas Camill,0,0,30,30
1657374467367,MATH 10A,A01,083735,Patchell; Gregory David,2,0,30,28
1657374467367,MATH 10A,A02,083736,Patchell; Gregory David,20,0,30,10
1657374467367,MATH 10A,A03,083737,Patchell; Gregory David,16,0,30,14
1657374473398,MATH 10B,A01,083207,Lim; Seonhee,8,0,34,26
1657374473398,MATH 10B,A02,083208,Lim; Seonhee,9,0,35,26
1657374473398,MATH 10B,A03,093472,Lim; Seonhee,7,0,34,27
1657374473398,MATH 10B,B01,083739,Sinha; Shubham,12,0,30,18
1657374479426,MATH 18,A01,083743,Cinel; Cameron Alexander,7,0,30,23
1657374479426,MATH 18,A02,083744,Cinel; Cameron Alexander,17,0,30,13
1657374479426,MATH 18,A03,083745,Cinel; Cameron Alexander,9,0,30,21
1657374479426,MATH 18,B01,083748,Rideout; David Porter,5,0,37,32
1657374479426,MATH 18,B02,083749,Rideout; David Porter,5,0,36,31
1657374479426,MATH 18,B03,083750,Rideout; David Porter,3,0,37,34
1657374479426,MATH 18,B04,083751,Rideout; David Porter,6,0,36,30
1657374479426,MATH 18,B05,093473,Rideout; David Porter,6,0,36,30
1657374479426,MATH 18,B06,093474,Rideout; David Porter,6,0,36,30
1657374485457,MATH 20A,A01,083754,Zheng; Zequn,14,0,40,26
1657374491485,MATH 20B,A01,083756,Briones; Jor-el Thomas Caparas,4,0,36,32
1657374491485,MATH 20B,A02,083757,Briones; Jor-el Thomas Caparas,1,0,36,35
1657374491485,MATH 20B,A03,093475,Briones; Jor-el Thomas Caparas,2,0,36,34
1657374497520,MATH 20C,A01,083760,Briones; Jor-el Thomas Caparas,1,0,35,34
1657374497520,MATH 20C,A02,083761,Briones; Jor-el Thomas Caparas,8,0,35,27
1657374497520,MATH 20C,A03,093476,Briones; Jor-el Thomas Caparas,0,1,36,36
1657374497520,MATH 20C,B01,083762,Bach; Quang Tran,1,0,30,29
1657374503551,MATH 20D,A01,083765,Tran; Brian Kha,5,0,30,25
1657374503551,MATH 20D,A02,083766,Tran; Brian Kha,5,0,30,25
1657374503551,MATH 20D,A03,083767,Tran; Brian Kha,5,0,30,25
1657374509579,MATH 20E,A01,083771,Ganguly; Soumya,9,0,32,23
1657374509579,MATH 20E,A02,083772,Ganguly; Soumya,6,0,32,26
1657374509579,MATH 20E,B01,083773,Ciotti; Benjamin,20,0,35,15
1657374509579,MATH 20E,B02,083774,Ciotti; Benjamin,17,0,35,18
1657374515604,MATH 103A,A01,083777,Greenfeld; Be'Eri,3,0,36,33
1657374515604,MATH 103A,A02,083778,Greenfeld; Be'Eri,5,0,36,31
1657374515604,MATH 103A,A03,093561,Greenfeld; Be'Eri,5,0,36,31
1657374515604,MATH 103A,B01,083779,Greenfeld; Be'Eri,7,0,36,29
1657374515604,MATH 103A,B02,083780,Greenfeld; Be'Eri,4,0,36,32
1657374515604,MATH 103A,B03,093562,Greenfeld; Be'Eri,3,0,36,33
1657374521632,MATH 105,A01,085443,Carter; Anne Toulson,15,0,35,20
1657374521632,MATH 105,A02,093477,Carter; Anne Toulson,20,0,35,15
1657374527658,MATH 109,A01,083213,Ganzberger; Geoffrey Michael,2,0,34,32
1657374527658,MATH 109,A02,083214,Ganzberger; Geoffrey Michael,4,0,34,30
1657374527658,MATH 109,A03,093478,Ganzberger; Geoffrey Michael,2,0,34,32
1657374527658,MATH 109,B01,083215,Ganzberger; Geoffrey Michael,1,0,32,31
1657374527658,MATH 109,B02,083216,Ganzberger; Geoffrey Michael,2,0,32,30
1657374527658,MATH 109,B03,093479,Ganzberger; Geoffrey Michael,8,0,32,24
1657374533693,MATH 142A,A01,083219,Chow; Bennett,7,0,32,25
1657374533693,MATH 142A,A02,083220,Chow; Bennett,10,0,32,22
1657374533693,MATH 142A,A03,093480,Chow; Bennett,8,0,32,24
1657374533693,MATH 142A,B03,093481,Chow; Bennett,8,0,32,24
1657374533693,MATH 142A,B04,093558,Chow; Bennett,13,0,32,19
1657374533693,MATH 142A,B05,093559,Chow; Bennett,6,0,32,26
1657374539725,MATH 193A,A01,083224,Rotar; Vladimir,8,0,34,26
1657374539725,MATH 193A,A02,083225,Rotar; Vladimir,9,0,34,25
1657374539725,MATH 193A,A03,083781,Rotar; Vladimir,5,0,34,29
1657374539725,MATH 193A,A04,083782,Rotar; Vladimir,10,0,34,24
1657374539725,MATH 193A,A05,093482,Rotar; Vladimir,10,0,34,24
1657374545753,MATH 197,001,091859,McAuley; Julian John,9999,0,9999,0
1657374545753,MATH 197,002,095566,Kedlaya; Kiran S.,9997,0,9999,2
1657374545753,MATH 197,003,095567,Xiao; Ming,9999,0,9999,0
1657374545753,MATH 197,004,095571,Perols; Johan Lars,9998,0,9999,1
1657374552845,COGS 9,A01,083615,Shannon; Kyle Michael,9,0,75,66
1657374558878,COGS 11,A01,083617,Boyle; Mary E. T.,22,0,48,26
1657374564906,COGS 13,A01,083071,Bastos; Amalia Pinkusfeld,11,0,71,60
1657374570937,COGS 14A,A01,092681,Semenuks; Arturs,4,1,100,96
1657374576964,COGS 14B,A01,083073,Cheng; Tzu-Han,6,0,63,57
1657374582992,COGS 17,A01,092677,Semenuks; Arturs,6,0,81,75
1657374589032,COGS 100,A01,083619,Allen; Michael Gordon,17,0,70,53
1657374595064,COGS 101A,A01,083621,Davis; Joshua Daniel,9,0,68,59
1657374601096,COGS 101B,A01,091572,Allen; Michael Gordon,11,0,65,54
1657374607134,COGS 101C,A01,083625,Delgado; Tania,17,0,35,18
1657374613159,COGS 107A,A01,083627,Boyle; Mary E. T.,13,0,60,47
1657374619193,COGS 118A,A01,083075,Gupta; Anjum,20,0,76,56
1657374625219,CSE 3,A50,083646,Miranda; Gregory Joseph,24,0,50,26
1657374631244,CSE 8A,A50,083650,Miranda; Gregory Joseph,17,1,56,39
1657374637277,CSE 11,A01,083080,Cao; Yingjun,6,15,40,34
1657374643303,CSE 12,A01,083652,Krause-Levy; Sophia Louisa,28,1,120,92
1657374649340,CSE 15L,A01,083654,Morris; Justin Loren,9,0,50,41
1657374649340,CSE 15L,A02,083655,Morris; Justin Loren,9,0,50,41
1657374655367,CSE 20,A01,083657,Tran; Khoa Dang,39,0,80,41
1657374661398,CSE 21,A01,095574,Bach; Quang Tran,22,0,48,26
1657374667425,CSE 30,A01,083084,Eldon; John,4,0,80,76
1657374667425,CSE 30,B01,095061,Bhaskar; Nishant,9,0,50,41
1657374673457,CSE 100,A01,083659,Cao; Yingjun,5,4,70,65
1657374679481,CSE 134B,A01,083661,Powell; Thomas Allan,22,0,100,78
1657374685512,CSE 140,A01,083663,Gungor; Onat,14,0,85,71
1657374691537,CSE 140L,A01,083088,Eldon; John,21,0,100,79
1657374697562,CSE 175,A01,083665,Kumar; Rakesh,3,0,25,22
1657374703592,CSE 190,A00,092507,Dubnov; Shlomo,7,0,20,13
1657374709625,ECE 45,A01,083139,Congero; Spencer William,6,0,75,69
1657374715658,ECE 65,A50,083695,Saad; Andrew S,12,0,30,18
1657374715658,ECE 65,A51,095125,Saad; Andrew S,24,0,26,2
1657374721685,ECE 109,A01,091882,Touri; Behrouz,19,0,70,51
1657374727709,ECE 180,A00,083140,Abi Samra; Nicholas Camill,1,0,30,29
1657374727709,ECE 180,B00,083141,Abi Samra; Nicholas Camill,0,0,30,30
1657374733752,MATH 10A,A01,083735,Patchell; Gregory David,2,0,30,28
1657374733752,MATH 10A,A02,083736,Patchell; Gregory David,20,0,30,10
1657374733752,MATH 10A,A03,083737,Patchell; Gregory David,16,0,30,14
1657374739792,MATH 10B,A01,083207,Lim; Seonhee,8,0,34,26
1657374739792,MATH 10B,A02,083208,Lim; Seonhee,9,0,35,26
1657374739792,MATH 10B,A03,093472,Lim; Seonhee,7,0,34,27
1657374739792,MATH 10B,B01,083739,Sinha; Shubham,12,0,30,18
1657374745820,MATH 18,A01,083743,Cinel; Cameron Alexander,7,0,30,23
1657374745820,MATH 18,A02,083744,Cinel; Cameron Alexander,17,0,30,13
1657374745820,MATH 18,A03,083745,Cinel; Cameron Alexander,9,0,30,21
1657374745820,MATH 18,B01,083748,Rideout; David Porter,5,0,37,32
1657374745820,MATH 18,B02,083749,Rideout; David Porter,5,0,36,31
1657374745820,MATH 18,B03,083750,Rideout; David Porter,3,0,37,34
1657374745820,MATH 18,B04,083751,Rideout; David Porter,6,0,36,30
1657374745820,MATH 18,B05,093473,Rideout; David Porter,6,0,36,30
1657374745820,MATH 18,B06,093474,Rideout; David Porter,6,0,36,30
1657374751951,MATH 20A,A01,083754,Zheng; Zequn,14,0,40,26
1657374757978,MATH 20B,A01,083756,Briones; Jor-el Thomas Caparas,4,0,36,32
1657374757978,MATH 20B,A02,083757,Briones; Jor-el Thomas Caparas,1,0,36,35
1657374757978,MATH 20B,A03,093475,Briones; Jor-el Thomas Caparas,2,0,36,34
1657374764013,MATH 20C,A01,083760,Briones; Jor-el Thomas Caparas,1,0,35,34
1657374764013,MATH 20C,A02,083761,Briones; Jor-el Thomas Caparas,8,0,35,27
1657374764013,MATH 20C,A03,093476,Briones; Jor-el Thomas Caparas,0,1,36,36
1657374764013,MATH 20C,B01,083762,Bach; Quang Tran,1,0,30,29
1657374770039,MATH 20D,A01,083765,Tran; Brian Kha,5,0,30,25
1657374770039,MATH 20D,A02,083766,Tran; Brian Kha,5,0,30,25
1657374770039,MATH 20D,A03,083767,Tran; Brian Kha,5,0,30,25
1657374776141,MATH 20E,A01,083771,Ganguly; Soumya,9,0,32,23
1657374776141,MATH 20E,A02,083772,Ganguly; Soumya,6,0,32,26
1657374776141,MATH 20E,B01,083773,Ciotti; Benjamin,20,0,35,15
1657374776141,MATH 20E,B02,083774,Ciotti; Benjamin,17,0,35,18
1657374782172,MATH 103A,A01,083777,Greenfeld; Be'Eri,3,0,36,33
1657374782172,MATH 103A,A02,083778,Greenfeld; Be'Eri,5,0,36,31
1657374782172,MATH 103A,A03,093561,Greenfeld; Be'Eri,5,0,36,31
1657374782172,MATH 103A,B01,083779,Greenfeld; Be'Eri,7,0,36,29
1657374782172,MATH 103A,B02,083780,Greenfeld; Be'Eri,4,0,36,32
1657374782172,MATH 103A,B03,093562,Greenfeld; Be'Eri,3,0,36,33
1657374788206,MATH 105,A01,085443,Carter; Anne Toulson,15,0,35,20
1657374788206,MATH 105,A02,093477,Carter; Anne Toulson,20,0,35,15
1657374794237,MATH 109,A01,083213,Ganzberger; Geoffrey Michael,2,0,34,32
1657374794237,MATH 109,A02,083214,Ganzberger; Geoffrey Michael,4,0,34,30
1657374794237,MATH 109,A03,093478,Ganzberger; Geoffrey Michael,2,0,34,32
1657374794237,MATH 109,B01,083215,Ganzberger; Geoffrey Michael,1,0,32,31
1657374794237,MATH 109,B02,083216,Ganzberger; Geoffrey Michael,2,0,32,30
1657374794237,MATH 109,B03,093479,Ganzberger; Geoffrey Michael,8,0,32,24
1657374800263,MATH 142A,A01,083219,Chow; Bennett,7,0,32,25
1657374800263,MATH 142A,A02,083220,Chow; Bennett,10,0,32,22
1657374800263,MATH 142A,A03,093480,Chow; Bennett,8,0,32,24
1657374800263,MATH 142A,B03,093481,Chow; Bennett,8,0,32,24
1657374800263,MATH 142A,B04,093558,Chow; Bennett,13,0,32,19
1657374800263,MATH 142A,B05,093559,Chow; Bennett,6,0,32,26
1657374806289,MATH 193A,A01,083224,Rotar; Vladimir,8,0,34,26
1657374806289,MATH 193A,A02,083225,Rotar; Vladimir,9,0,34,25
1657374806289,MATH 193A,A03,083781,Rotar; Vladimir,5,0,34,29
1657374806289,MATH 193A,A04,083782,Rotar; Vladimir,10,0,34,24
1657374806289,MATH 193A,A05,093482,Rotar; Vladimir,10,0,34,24
1657374812317,MATH 197,001,091859,McAuley; Julian John,9999,0,9999,0
1657374812317,MATH 197,002,095566,Kedlaya; Kiran S.,9997,0,9999,2
1657374812317,MATH 197,003,095567,Xiao; Ming,9999,0,9999,0
1657374812317,MATH 197,004,095571,Perols; Johan Lars,9998,0,9999,1
1657374819387,COGS 9,A01,083615,Shannon; Kyle Michael,9,0,75,66
1657374825417,COGS 11,A01,083617,Boyle; Mary E. T.,22,0,48,26
1657374831445,COGS 13,A01,083071,Bastos; Amalia Pinkusfeld,11,0,71,60
1657374837472,COGS 14A,A01,092681,Semenuks; Arturs,4,1,100,96
1657374843498,COGS 14B,A01,083073,Cheng; Tzu-Han,6,0,63,57
1657374849522,COGS 17,A01,092677,Semenuks; Arturs,6,0,81,75
1657374855548,COGS 100,A01,083619,Allen; Michael Gordon,17,0,70,53
1657374861578,COGS 101A,A01,083621,Davis; Joshua Daniel,9,0,68,59
1657374867610,COGS 101B,A01,091572,Allen; Michael Gordon,11,0,65,54
1657374873643,COGS 101C,A01,083625,Delgado; Tania,17,0,35,18
1657374879677,COGS 107A,A01,083627,Boyle; Mary E. T.,13,0,60,47
1657374885709,COGS 118A,A01,083075,Gupta; Anjum,20,0,76,56
1657374891736,CSE 3,A50,083646,Miranda; Gregory Joseph,24,0,50,26
1657374897760,CSE 8A,A50,083650,Miranda; Gregory Joseph,17,1,56,39
1657374903786,CSE 11,A01,083080,Cao; Yingjun,6,15,40,34
1657374909811,CSE 12,A01,083652,Krause-Levy; Sophia Louisa,28,1,120,92
1657374915855,CSE 15L,A01,083654,Morris; Justin Loren,9,0,50,41
1657374915855,CSE 15L,A02,083655,Morris; Justin Loren,9,0,50,41
1657374921881,CSE 20,A01,083657,Tran; Khoa Dang,39,0,80,41
1657374927913,CSE 21,A01,095574,Bach; Quang Tran,22,0,48,26
1657374933938,CSE 30,A01,083084,Eldon; John,4,0,80,76
1657374933938,CSE 30,B01,095061,Bhaskar; Nishant,9,0,50,41
1657374939964,CSE 100,A01,083659,Cao; Yingjun,5,4,70,65
1657374945999,CSE 134B,A01,083661,Powell; Thomas Allan,22,0,100,78
1657374952029,CSE 140,A01,083663,Gungor; Onat,14,0,85,71
1657374958055,CSE 140L,A01,083088,Eldon; John,21,0,100,79
1657374964083,CSE 175,A01,083665,Kumar; Rakesh,3,0,25,22
1657374970109,CSE 190,A00,092507,Dubnov; Shlomo,7,0,20,13
1657374976134,ECE 45,A01,083139,Congero; Spencer William,6,0,75,69
1657374982162,ECE 65,A50,083695,Saad; Andrew S,12,0,30,18
1657374982162,ECE 65,A51,095125,Saad; Andrew S,24,0,26,2
1657374988187,ECE 109,A01,091882,Touri; Behrouz,19,0,70,51
1657374994213,ECE 180,A00,083140,Abi Samra; Nicholas Camill,1,0,30,29
1657374994213,ECE 180,B00,083141,Abi Samra; Nicholas Camill,0,0,30,30
1657375000241,MATH 10A,A01,083735,Patchell; Gregory David,2,0,30,28
1657375000241,MATH 10A,A02,083736,Patchell; Gregory David,20,0,30,10
1657375000241,MATH 10A,A03,083737,Patchell; Gregory David,16,0,30,14
1657375006269,MATH 10B,A01,083207,Lim; Seonhee,8,0,34,26
1657375006269,MATH 10B,A02,083208,Lim; Seonhee,9,0,35,26
1657375006269,MATH 10B,A03,093472,Lim; Seonhee,7,0,34,27
1657375006269,MATH 10B,B01,083739,Sinha; Shubham,12,0,30,18
1657375012301,MATH 18,A01,083743,Cinel; Cameron Alexander,7,0,30,23
1657375012301,MATH 18,A02,083744,Cinel; Cameron Alexander,17,0,30,13
1657375012301,MATH 18,A03,083745,Cinel; Cameron Alexander,9,0,30,21
1657375012301,MATH 18,B01,083748,Rideout; David Porter,5,0,37,32
1657375012301,MATH 18,B02,083749,Rideout; David Porter,5,0,36,31
1657375012301,MATH 18,B03,083750,Rideout; David Porter,3,0,37,34
1657375012301,MATH 18,B04,083751,Rideout; David Porter,6,0,36,30
1657375012301,MATH 18,B05,093473,Rideout; David Porter,6,0,36,30
1657375012301,MATH 18,B06,093474,Rideout; David Porter,6,0,36,30
1657375018326,MATH 20A,A01,083754,Zheng; Zequn,14,0,40,26
1657375024358,MATH 20B,A01,083756,Briones; Jor-el Thomas Caparas,4,0,36,32
1657375024358,MATH 20B,A02,083757,Briones; Jor-el Thomas Caparas,1,0,36,35
1657375024358,MATH 20B,A03,093475,Briones; Jor-el Thomas Caparas,2,0,36,34
1657375030383,MATH 20C,A01,083760,Briones; Jor-el Thomas Caparas,1,0,35,34
1657375030383,MATH 20C,A02,083761,Briones; Jor-el Thomas Caparas,8,0,35,27
1657375030383,MATH 20C,A03,093476,Briones; Jor-el Thomas Caparas,0,1,36,36
1657375030383,MATH 20C,B01,083762,Bach; Quang Tran,1,0,30,29
1657375036408,MATH 20D,A01,083765,Tran; Brian Kha,5,0,30,25
1657375036408,MATH 20D,A02,083766,Tran; Brian Kha,5,0,30,25
1657375036408,MATH 20D,A03,083767,Tran; Brian Kha,5,0,30,25
1657375042436,MATH 20E,A01,083771,Ganguly; Soumya,9,0,32,23
1657375042436,MATH 20E,A02,083772,Ganguly; Soumya,6,0,32,26
1657375042436,MATH 20E,B01,083773,Ciotti; Benjamin,20,0,35,15
1657375042436,MATH 20E,B02,083774,Ciotti; Benjamin,17,0,35,18
1657375048463,MATH 103A,A01,083777,Greenfeld; Be'Eri,3,0,36,33
1657375048463,MATH 103A,A02,083778,Greenfeld; Be'Eri,5,0,36,31
1657375048463,MATH 103A,A03,093561,Greenfeld; Be'Eri,5,0,36,31
1657375048463,MATH 103A,B01,083779,Greenfeld; Be'Eri,7,0,36,29
1657375048463,MATH 103A,B02,083780,Greenfeld; Be'Eri,4,0,36,32
1657375048463,MATH 103A,B03,093562,Greenfeld; Be'Eri,3,0,36,33
1657375054497,MATH 105,A01,085443,Carter; Anne Toulson,15,0,35,20
1657375054497,MATH 105,A02,093477,Carter; Anne Toulson,20,0,35,15
1657375060530,MATH 109,A01,083213,Ganzberger; Geoffrey Michael,2,0,34,32
1657375060530,MATH 109,A02,083214,Ganzberger; Geoffrey Michael,4,0,34,30
1657375060530,MATH 109,A03,093478,Ganzberger; Geoffrey Michael,2,0,34,32
1657375060530,MATH 109,B01,083215,Ganzberger; Geoffrey Michael,1,0,32,31
1657375060530,MATH 109,B02,083216,Ganzberger; Geoffrey Michael,2,0,32,30
1657375060530,MATH 109,B03,093479,Ganzberger; Geoffrey Michael,8,0,32,24
1657375066564,MATH 142A,A01,083219,Chow; Bennett,7,0,32,25
1657375066564,MATH 142A,A02,083220,Chow; Bennett,10,0,32,22
1657375066564,MATH 142A,A03,093480,Chow; Bennett,8,0,32,24
1657375066564,MATH 142A,B03,093481,Chow; Bennett,8,0,32,24
1657375066564,MATH 142A,B04,093558,Chow; Bennett,13,0,32,19
1657375066564,MATH 142A,B05,093559,Chow; Bennett,6,0,32,26
1657375072592,MATH 193A,A01,083224,Rotar; Vladimir,8,0,34,26
1657375072592,MATH 193A,A02,083225,Rotar; Vladimir,9,0,34,25
1657375072592,MATH 193A,A03,083781,Rotar; Vladimir,5,0,34,29
1657375072592,MATH 193A,A04,083782,Rotar; Vladimir,10,0,34,24
1657375072592,MATH 193A,A05,093482,Rotar; Vladimir,10,0,34,24
1657375078624,MATH 197,001,091859,McAuley; Julian John,9999,0,9999,0
1657375078624,MATH 197,002,095566,Kedlaya; Kiran S.,9997,0,9999,2
1657375078624,MATH 197,003,095567,Xiao; Ming,9999,0,9999,0
1657375078624,MATH 197,004,095571,Perols; Johan Lars,9998,0,9999,1
1657375085708,COGS 9,A01,083615,Shannon; Kyle Michael,9,0,75,66
1657375091734,COGS 11,A01,083617,Boyle; Mary E. T.,22,0,48,26
1657375097764,COGS 13,A01,083071,Bastos; Amalia Pinkusfeld,11,0,71,60
1657375103796,COGS 14A,A01,092681,Semenuks; Arturs,4,1,100,96
1657375109821,COGS 14B,A01,083073,Cheng; Tzu-Han,6,0,63,57
1657375115849,COGS 17,A01,092677,Semenuks; Arturs,6,0,81,75
1657375121873,COGS 100,A01,083619,Allen; Michael Gordon,17,0,70,53
1657375127899,COGS 101A,A01,083621,Davis; Joshua Daniel,9,0,68,59
1657375133927,COGS 101B,A01,091572,Allen; Michael Gordon,11,0,65,54
1657375139955,COGS 101C,A01,083625,Delgado; Tania,17,0,35,18
1657375145982,COGS 107A,A01,083627,Boyle; Mary E. T.,13,0,60,47
1657375152008,COGS 118A,A01,083075,Gupta; Anjum,20,0,76,56
1657375158040,CSE 3,A50,083646,Miranda; Gregory Joseph,24,0,50,26
1657375164069,CSE 8A,A50,083650,Miranda; Gregory Joseph,17,1,56,39
1657375170094,CSE 11,A01,083080,Cao; Yingjun,6,15,40,34
1657375176121,CSE 12,A01,083652,Krause-Levy; Sophia Louisa,28,1,120,92
1657375182149,CSE 15L,A01,083654,Morris; Justin Loren,9,0,50,41
1657375182149,CSE 15L,A02,083655,Morris; Justin Loren,9,0,50,41
1657375188180,CSE 20,A01,083657,Tran; Khoa Dang,39,0,80,41
1657375194209,CSE 21,A01,095574,Bach; Quang Tran,22,0,48,26
1657375200241,CSE 30,A01,083084,Eldon; John,4,0,80,76
1657375200241,CSE 30,B01,095061,Bhaskar; Nishant,9,0,50,41
1657375206278,CSE 100,A01,083659,Cao; Yingjun,5,4,70,65
1657375212310,CSE 134B,A01,083661,Powell; Thomas Allan,22,0,100,78
1657375218334,CSE 140,A01,083663,Gungor; Onat,14,0,85,71
1657375224359,CSE 140L,A01,083088,Eldon; John,21,0,100,79
1657375230385,CSE 175,A01,083665,Kumar; Rakesh,3,0,25,22
1657375236414,CSE 190,A00,092507,Dubnov; Shlomo,7,0,20,13
1657375242447,ECE 45,A01,083139,Congero; Spencer William,6,0,75,69
1657375248479,ECE 65,A50,083695,Saad; Andrew S,12,0,30,18
1657375248479,ECE 65,A51,095125,Saad; Andrew S,24,0,26,2
1657375254505,ECE 109,A01,091882,Touri; Behrouz,19,0,70,51
1657375260534,ECE 180,A00,083140,Abi Samra; Nicholas Camill,1,0,30,29
1657375260534,ECE 180,B00,083141,Abi Samra; Nicholas Camill,0,0,30,30
1657375266560,MATH 10A,A01,083735,Patchell; Gregory David,2,0,30,28
1657375266560,MATH 10A,A02,083736,Patchell; Gregory David,20,0,30,10
1657375266560,MATH 10A,A03,083737,Patchell; Gregory David,16,0,30,14
1657375272596,MATH 10B,A01,083207,Lim; Seonhee,8,0,34,26
1657375272596,MATH 10B,A02,083208,Lim; Seonhee,9,0,35,26
1657375272596,MATH 10B,A03,093472,Lim; Seonhee,7,0,34,27
1657375272596,MATH 10B,B01,083739,Sinha; Shubham,12,0,30,18
1657375278631,MATH 18,A01,083743,Cinel; Cameron Alexander,7,0,30,23
1657375278631,MATH 18,A02,083744,Cinel; Cameron Alexander,17,0,30,13
1657375278631,MATH 18,A03,083745,Cinel; Cameron Alexander,9,0,30,21
1657375278631,MATH 18,B01,083748,Rideout; David Porter,5,0,37,32
1657375278631,MATH 18,B02,083749,Rideout; David Porter,5,0,36,31
1657375278631,MATH 18,B03,083750,Rideout; David Porter,3,0,37,34
1657375278631,MATH 18,B04,083751,Rideout; David Porter,6,0,36,30
1657375278631,MATH 18,B05,093473,Rideout; David Porter,6,0,36,30
1657375278631,MATH 18,B06,093474,Rideout; David Porter,6,0,36,30
1657375284661,MATH 20A,A01,083754,Zheng; Zequn,14,0,40,26
1657375290694,MATH 20B,A01,083756,Briones; Jor-el Thomas Caparas,4,0,36,32
1657375290694,MATH 20B,A02,083757,Briones; Jor-el Thomas Caparas,1,0,36,35
1657375290694,MATH 20B,A03,093475,Briones; Jor-el Thomas Caparas,2,0,36,34
1657375296721,MATH 20C,A01,083760,Briones; Jor-el Thomas Caparas,1,0,35,34
1657375296721,MATH 20C,A02,083761,Briones; Jor-el Thomas Caparas,8,0,35,27
1657375296721,MATH 20C,A03,093476,Briones; Jor-el Thomas Caparas,0,1,36,36
1657375296721,MATH 20C,B01,083762,Bach; Quang Tran,1,0,30,29
1657375302754,MATH 20D,A01,083765,Tran; Brian Kha,5,0,30,25
1657375302754,MATH 20D,A02,083766,Tran; Brian Kha,5,0,30,25
1657375302754,MATH 20D,A03,083767,Tran; Brian Kha,5,0,30,25
1657375308782,MATH 20E,A01,083771,Ganguly; Soumya,9,0,32,23
1657375308782,MATH 20E,A02,083772,Ganguly; Soumya,6,0,32,26
1657375308782,MATH 20E,B01,083773,Ciotti; Benjamin,20,0,35,15
1657375308782,MATH 20E,B02,083774,Ciotti; Benjamin,17,0,35,18
1657375314811,MATH 103A,A01,083777,Greenfeld; Be'Eri,3,0,36,33
1657375314811,MATH 103A,A02,083778,Greenfeld; Be'Eri,5,0,36,31
1657375314811,MATH 103A,A03,093561,Greenfeld; Be'Eri,5,0,36,31
1657375314811,MATH 103A,B01,083779,Greenfeld; Be'Eri,7,0,36,29
1657375314811,MATH 103A,B02,083780,Greenfeld; Be'Eri,4,0,36,32
1657375314811,MATH 103A,B03,093562,Greenfeld; Be'Eri,3,0,36,33
1657375320837,MATH 105,A01,085443,Carter; Anne Toulson,15,0,35,20
1657375320837,MATH 105,A02,093477,Carter; Anne Toulson,20,0,35,15
1657375326871,MATH 109,A01,083213,Ganzberger; Geoffrey Michael,2,0,34,32
1657375326871,MATH 109,A02,083214,Ganzberger; Geoffrey Michael,4,0,34,30
1657375326871,MATH 109,A03,093478,Ganzberger; Geoffrey Michael,2,0,34,32
1657375326871,MATH 109,B01,083215,Ganzberger; Geoffrey Michael,1,0,32,31
1657375326871,MATH 109,B02,083216,Ganzberger; Geoffrey Michael,2,0,32,30
1657375326871,MATH 109,B03,093479,Ganzberger; Geoffrey Michael,8,0,32,24
1657375332904,MATH 142A,A01,083219,Chow; Bennett,7,0,32,25
1657375332904,MATH 142A,A02,083220,Chow; Bennett,10,0,32,22
1657375332904,MATH 142A,A03,093480,Chow; Bennett,8,0,32,24
1657375332904,MATH 142A,B03,093481,Chow; Bennett,8,0,32,24
1657375332904,MATH 142A,B04,093558,Chow; Bennett,13,0,32,19
1657375332904,MATH 142A,B05,093559,Chow; Bennett,6,0,32,26
1657375338930,MATH 193A,A01,083224,Rotar; Vladimir,8,0,34,26
1657375338930,MATH 193A,A02,083225,Rotar; Vladimir,9,0,34,25
1657375338930,MATH 193A,A03,083781,Rotar; Vladimir,5,0,34,29
1657375338930,MATH 193A,A04,083782,Rotar; Vladimir,10,0,34,24
1657375338930,MATH 193A,A05,093482,Rotar; Vladimir,10,0,34,24
1657375344962,MATH 197,001,091859,McAuley; Julian John,9999,0,9999,0
1657375344962,MATH 197,002,095566,Kedlaya; Kiran S.,9997,0,9999,2
1657375344962,MATH 197,003,095567,Xiao; Ming,9999,0,9999,0
1657375344962,MATH 197,004,095571,Perols; Johan Lars,9998,0,9999,1
1657375352026,COGS 9,A01,083615,Shannon; Kyle Michael,9,0,75,66
1657375358057,COGS 11,A01,083617,Boyle; Mary E. T.,22,0,48,26
1657375364086,COGS 13,A01,083071,Bastos; Amalia Pinkusfeld,11,0,71,60
1657375370195,COGS 14A,A01,092681,Semenuks; Arturs,4,1,100,96
1657375376227,COGS 14B,A01,083073,Cheng; Tzu-Han,6,0,63,57
1657375382256,COGS 17,A01,092677,Semenuks; Arturs,6,0,81,75
1657375388285,COGS 100,A01,083619,Allen; Michael Gordon,17,0,70,53
1657375394314,COGS 101A,A01,083621,Davis; Joshua Daniel,9,0,68,59
1657375400343,COGS 101B,A01,091572,Allen; Michael Gordon,11,0,65,54
1657375406381,COGS 101C,A01,083625,Delgado; Tania,17,0,35,18
1657375412409,COGS 107A,A01,083627,Boyle; Mary E. T.,13,0,60,47
1657375418440,COGS 118A,A01,083075,Gupta; Anjum,20,0,76,56
1657375424471,CSE 3,A50,083646,Miranda; Gregory Joseph,24,0,50,26
1657375430506,CSE 8A,A50,083650,Miranda; Gregory Joseph,17,1,56,39
1657375436541,CSE 11,A01,083080,Cao; Yingjun,6,15,40,34
1657375442577,CSE 12,A01,083652,Krause-Levy; Sophia Louisa,28,1,120,92
1657375448610,CSE 15L,A01,083654,Morris; Justin Loren,9,0,50,41
1657375448610,CSE 15L,A02,083655,Morris; Justin Loren,9,0,50,41
1657375454643,CSE 20,A01,083657,Tran; Khoa Dang,39,0,80,41
1657375460696,CSE 21,A01,095574,Bach; Quang Tran,22,0,48,26
1657375466723,CSE 30,A01,083084,Eldon; John,4,0,80,76
1657375466723,CSE 30,B01,095061,Bhaskar; Nishant,9,0,50,41
1657375472755,CSE 100,A01,083659,Cao; Yingjun,5,4,70,65
1657375478780,CSE 134B,A01,083661,Powell; Thomas Allan,22,0,100,78
1657375484811,CSE 140,A01,083663,Gungor; Onat,14,0,85,71
1657375490844,CSE 140L,A01,083088,Eldon; John,21,0,100,79
1657375496873,CSE 175,A01,083665,Kumar; Rakesh,3,0,25,22
1657375502905,CSE 190,A00,092507,Dubnov; Shlomo,7,0,20,13
1657375508934,ECE 45,A01,083139,Congero; Spencer William,6,0,75,69
1657375514968,ECE 65,A50,083695,Saad; Andrew S,12,0,30,18
1657375514968,ECE 65,A51,095125,Saad; Andrew S,24,0,26,2
1657375520994,ECE 109,A01,091882,Touri; Behrouz,19,0,70,51
1657375527025,ECE 180,A00,083140,Abi Samra; Nicholas Camill,1,0,30,29
1657375527025,ECE 180,B00,083141,Abi Samra; Nicholas Camill,0,0,30,30
1657375533059,MATH 10A,A01,083735,Patchell; Gregory David,2,0,30,28
1657375533059,MATH 10A,A02,083736,Patchell; Gregory David,20,0,30,10
1657375533059,MATH 10A,A03,083737,Patchell; Gregory David,16,0,30,14
1657375539089,MATH 10B,A01,083207,Lim; Seonhee,8,0,34,26
1657375539089,MATH 10B,A02,083208,Lim; Seonhee,9,0,35,26
1657375539089,MATH 10B,A03,093472,Lim; Seonhee,7,0,34,27
1657375539089,MATH 10B,B01,083739,Sinha; Shubham,12,0,30,18
1657375545120,MATH 18,A01,083743,Cinel; Cameron Alexander,7,0,30,23
1657375545120,MATH 18,A02,083744,Cinel; Cameron Alexander,17,0,30,13
1657375545120,MATH 18,A03,083745,Cinel; Cameron Alexander,9,0,30,21
1657375545120,MATH 18,B01,083748,Rideout; David Porter,5,0,37,32
1657375545120,MATH 18,B02,083749,Rideout; David Porter,5,0,36,31
1657375545120,MATH 18,B03,083750,Rideout; David Porter,3,0,37,34
1657375545120,MATH 18,B04,083751,Rideout; David Porter,6,0,36,30
1657375545120,MATH 18,B05,093473,Rideout; David Porter,6,0,36,30
1657375545120,MATH 18,B06,093474,Rideout; David Porter,6,0,36,30
1657375551151,MATH 20A,A01,083754,Zheng; Zequn,14,0,40,26
1657375557182,MATH 20B,A01,083756,Briones; Jor-el Thomas Caparas,4,0,36,32
1657375557182,MATH 20B,A02,083757,Briones; Jor-el Thomas Caparas,1,0,36,35
1657375557182,MATH 20B,A03,093475,Briones; Jor-el Thomas Caparas,2,0,36,34
1657375563209,MATH 20C,A01,083760,Briones; Jor-el Thomas Caparas,1,0,35,34
1657375563209,MATH 20C,A02,083761,Briones; Jor-el Thomas Caparas,8,0,35,27
1657375563209,MATH 20C,A03,093476,Briones; Jor-el Thomas Caparas,0,1,36,36
1657375563209,MATH 20C,B01,083762,Bach; Quang Tran,1,0,30,29
1657375569241,MATH 20D,A01,083765,Tran; Brian Kha,5,0,30,25
1657375569241,MATH 20D,A02,083766,Tran; Brian Kha,5,0,30,25
1657375569241,MATH 20D,A03,083767,Tran; Brian Kha,5,0,30,25
1657375575278,MATH 20E,A01,083771,Ganguly; Soumya,9,0,32,23
1657375575278,MATH 20E,A02,083772,Ganguly; Soumya,6,0,32,26
1657375575278,MATH 20E,B01,083773,Ciotti; Benjamin,20,0,35,15
1657375575278,MATH 20E,B02,083774,Ciotti; Benjamin,17,0,35,18
1657375581307,MATH 103A,A01,083777,Greenfeld; Be'Eri,3,0,36,33
1657375581307,MATH 103A,A02,083778,Greenfeld; Be'Eri,5,0,36,31
1657375581307,MATH 103A,A03,093561,Greenfeld; Be'Eri,5,0,36,31
1657375581307,MATH 103A,B01,083779,Greenfeld; Be'Eri,7,0,36,29
1657375581307,MATH 103A,B02,083780,Greenfeld; Be'Eri,4,0,36,32
1657375581307,MATH 103A,B03,093562,Greenfeld; Be'Eri,3,0,36,33
1657375587331,MATH 105,A01,085443,Carter; Anne Toulson,15,0,35,20
1657375587331,MATH 105,A02,093477,Carter; Anne Toulson,20,0,35,15
1657375593360,MATH 109,A01,083213,Ganzberger; Geoffrey Michael,2,0,34,32
1657375593360,MATH 109,A02,083214,Ganzberger; Geoffrey Michael,4,0,34,30
1657375593360,MATH 109,A03,093478,Ganzberger; Geoffrey Michael,2,0,34,32
1657375593360,MATH 109,B01,083215,Ganzberger; Geoffrey Michael,1,0,32,31
1657375593360,MATH 109,B02,083216,Ganzberger; Geoffrey Michael,2,0,32,30
1657375593360,MATH 109,B03,093479,Ganzberger; Geoffrey Michael,8,0,32,24
1657375599388,MATH 142A,A01,083219,Chow; Bennett,7,0,32,25
1657375599388,MATH 142A,A02,083220,Chow; Bennett,10,0,32,22
1657375599388,MATH 142A,A03,093480,Chow; Bennett,8,0,32,24
1657375599388,MATH 142A,B03,093481,Chow; Bennett,8,0,32,24
1657375599388,MATH 142A,B04,093558,Chow; Bennett,13,0,32,19
1657375599388,MATH 142A,B05,093559,Chow; Bennett,6,0,32,26
1657375605429,MATH 193A,A01,083224,Rotar; Vladimir,8,0,34,26
1657375605429,MATH 193A,A02,083225,Rotar; Vladimir,9,0,34,25
1657375605429,MATH 193A,A03,083781,Rotar; Vladimir,5,0,34,29
1657375605429,MATH 193A,A04,083782,Rotar; Vladimir,10,0,34,24
1657375605429,MATH 193A,A05,093482,Rotar; Vladimir,10,0,34,24
1657375611457,MATH 197,001,091859,McAuley; Julian John,9999,0,9999,0
1657375611457,MATH 197,002,095566,Kedlaya; Kiran S.,9997,0,9999,2
1657375611457,MATH 197,003,095567,Xiao; Ming,9999,0,9999,0
1657375611457,MATH 197,004,095571,Perols; Johan Lars,9998,0,9999,1
1657375618523,COGS 9,A01,083615,Shannon; Kyle Michael,9,0,75,66
1657375624548,COGS 11,A01,083617,Boyle; Mary E. T.,22,0,48,26
1657375630572,COGS 13,A01,083071,Bastos; Amalia Pinkusfeld,11,0,71,60
1657375636600,COGS 14A,A01,092681,Semenuks; Arturs,4,1,100,96
1657375642627,COGS 14B,A01,083073,Cheng; Tzu-Han,6,0,63,57
1657375648651,COGS 17,A01,092677,Semenuks; Arturs,6,0,81,75
1657375654681,COGS 100,A01,083619,Allen; Michael Gordon,17,0,70,53
1657375660710,COGS 101A,A01,083621,Davis; Joshua Daniel,9,0,68,59
1657375666741,COGS 101B,A01,091572,Allen; Michael Gordon,11,0,65,54
1657375672766,COGS 101C,A01,083625,Delgado; Tania,17,0,35,18
1657375678795,COGS 107A,A01,083627,Boyle; Mary E. T.,13,0,60,47
1657375684819,COGS 118A,A01,083075,Gupta; Anjum,20,0,76,56
1657375690854,CSE 3,A50,083646,Miranda; Gregory Joseph,24,0,50,26
1657375696877,CSE 8A,A50,083650,Miranda; Gregory Joseph,17,1,56,39
1657375702902,CSE 11,A01,083080,Cao; Yingjun,6,15,40,34
1657375708949,CSE 12,A01,083652,Krause-Levy; Sophia Louisa,28,1,120,92
1657375714976,CSE 15L,A01,083654,Morris; Justin Loren,9,0,50,41
1657375714976,CSE 15L,A02,083655,Morris; Justin Loren,9,0,50,41
1657375721003,CSE 20,A01,083657,Tran; Khoa Dang,39,0,80,41
1657375727036,CSE 21,A01,095574,Bach; Quang Tran,22,0,48,26
1657375733063,CSE 30,A01,083084,Eldon; John,4,0,80,76
1657375733063,CSE 30,B01,095061,Bhaskar; Nishant,9,0,50,41
1657375739094,CSE 100,A01,083659,Cao; Yingjun,5,4,70,65
1657375745125,CSE 134B,A01,083661,Powell; Thomas Allan,22,0,100,78
1657375751151,CSE 140,A01,083663,Gungor; Onat,14,0,85,71
1657375757180,CSE 140L,A01,083088,Eldon; John,21,0,100,79
1657375763212,CSE 175,A01,083665,Kumar; Rakesh,3,0,25,22
1657375769244,CSE 190,A00,092507,Dubnov; Shlomo,7,0,20,13
1657375775271,ECE 45,A01,083139,Congero; Spencer William,6,0,75,69
1657375781306,ECE 65,A50,083695,Saad; Andrew S,12,0,30,18
1657375781306,ECE 65,A51,095125,Saad; Andrew S,24,0,26,2
1657375787338,ECE 109,A01,091882,Touri; Behrouz,19,0,70,51
1657375793364,ECE 180,A00,083140,Abi Samra; Nicholas Camill,1,0,30,29
1657375793364,ECE 180,B00,083141,Abi Samra; Nicholas Camill,0,0,30,30
1657375799398,MATH 10A,A01,083735,Patchell; Gregory David,2,0,30,28
1657375799398,MATH 10A,A02,083736,Patchell; Gregory David,20,0,30,10
1657375799398,MATH 10A,A03,083737,Patchell; Gregory David,16,0,30,14
1657375805445,MATH 10B,A01,083207,Lim; Seonhee,8,0,34,26
1657375805445,MATH 10B,A02,083208,Lim; Seonhee,9,0,35,26
1657375805445,MATH 10B,A03,093472,Lim; Seonhee,7,0,34,27
1657375805445,MATH 10B,B01,083739,Sinha; Shubham,12,0,30,18
1657375811499,MATH 18,A01,083743,Cinel; Cameron Alexander,7,0,30,23
1657375811499,MATH 18,A02,083744,Cinel; Cameron Alexander,17,0,30,13
1657375811499,MATH 18,A03,083745,Cinel; Cameron Alexander,9,0,30,21
1657375811499,MATH 18,B01,083748,Rideout; David Porter,5,0,37,32
1657375811499,MATH 18,B02,083749,Rideout; David Porter,5,0,36,31
1657375811499,MATH 18,B03,083750,Rideout; David Porter,3,0,37,34
1657375811499,MATH 18,B04,083751,Rideout; David Porter,6,0,36,30
1657375811499,MATH 18,B05,093473,Rideout; David Porter,6,0,36,30
1657375811499,MATH 18,B06,093474,Rideout; David Porter,6,0,36,30
1657375817534,MATH 20A,A01,083754,Zheng; Zequn,14,0,40,26
1657375823569,MATH 20B,A01,083756,Briones; Jor-el Thomas Caparas,4,0,36,32
1657375823569,MATH 20B,A02,083757,Briones; Jor-el Thomas Caparas,1,0,36,35
1657375823569,MATH 20B,A03,093475,Briones; Jor-el Thomas Caparas,2,0,36,34
1657375829612,MATH 20C,A01,083760,Briones; Jor-el Thomas Caparas,1,0,35,34
1657375829612,MATH 20C,A02,083761,Briones; Jor-el Thomas Caparas,8,0,35,27
1657375829612,MATH 20C,A03,093476,Briones; Jor-el Thomas Caparas,0,1,36,36
1657375829612,MATH 20C,B01,083762,Bach; Quang Tran,1,0,30,29
1657375835647,MATH 20D,A01,083765,Tran; Brian Kha,5,0,30,25
1657375835647,MATH 20D,A02,083766,Tran; Brian Kha,5,0,30,25
1657375835647,MATH 20D,A03,083767,Tran; Brian Kha,5,0,30,25
1657375841683,MATH 20E,A01,083771,Ganguly; Soumya,9,0,32,23
1657375841683,MATH 20E,A02,083772,Ganguly; Soumya,6,0,32,26
1657375841683,MATH 20E,B01,083773,Ciotti; Benjamin,20,0,35,15
1657375841683,MATH 20E,B02,083774,Ciotti; Benjamin,17,0,35,18
1657375847718,MATH 103A,A01,083777,Greenfeld; Be'Eri,3,0,36,33
1657375847718,MATH 103A,A02,083778,Greenfeld; Be'Eri,5,0,36,31
1657375847718,MATH 103A,A03,093561,Greenfeld; Be'Eri,5,0,36,31
1657375847718,MATH 103A,B01,083779,Greenfeld; Be'Eri,7,0,36,29
1657375847718,MATH 103A,B02,083780,Greenfeld; Be'Eri,4,0,36,32
1657375847718,MATH 103A,B03,093562,Greenfeld; Be'Eri,3,0,36,33
1657375853745,MATH 105,A01,085443,Carter; Anne Toulson,15,0,35,20
1657375853745,MATH 105,A02,093477,Carter; Anne Toulson,20,0,35,15
1657375859770,MATH 109,A01,083213,Ganzberger; Geoffrey Michael,2,0,34,32
1657375859770,MATH 109,A02,083214,Ganzberger; Geoffrey Michael,4,0,34,30
1657375859770,MATH 109,A03,093478,Ganzberger; Geoffrey Michael,2,0,34,32
1657375859770,MATH 109,B01,083215,Ganzberger; Geoffrey Michael,1,0,32,31
1657375859770,MATH 109,B02,083216,Ganzberger; Geoffrey Michael,2,0,32,30
1657375859770,MATH 109,B03,093479,Ganzberger; Geoffrey Michael,8,0,32,24
1657375865797,MATH 142A,A01,083219,Chow; Bennett,7,0,32,25
1657375865797,MATH 142A,A02,083220,Chow; Bennett,10,0,32,22
1657375865797,MATH 142A,A03,093480,Chow; Bennett,8,0,32,24
1657375865797,MATH 142A,B03,093481,Chow; Bennett,8,0,32,24
1657375865797,MATH 142A,B04,093558,Chow; Bennett,13,0,32,19
1657375865797,MATH 142A,B05,093559,Chow; Bennett,6,0,32,26
1657375871824,MATH 193A,A01,083224,Rotar; Vladimir,8,0,34,26
1657375871824,MATH 193A,A02,083225,Rotar; Vladimir,9,0,34,25
1657375871824,MATH 193A,A03,083781,Rotar; Vladimir,5,0,34,29
1657375871824,MATH 193A,A04,083782,Rotar; Vladimir,10,0,34,24
1657375871824,MATH 193A,A05,093482,Rotar; Vladimir,10,0,34,24
1657375877852,MATH 197,001,091859,McAuley; Julian John,9999,0,9999,0
1657375877852,MATH 197,002,095566,Kedlaya; Kiran S.,9997,0,9999,2
1657375877852,MATH 197,003,095567,Xiao; Ming,9999,0,9999,0
1657375877852,MATH 197,004,095571,Perols; Johan Lars,9998,0,9999,1
1657375884937,COGS 9,A01,083615,Shannon; Kyle Michael,9,0,75,66
1657375890967,COGS 11,A01,083617,Boyle; Mary E. T.,22,0,48,26
1657375896990,COGS 13,A01,083071,Bastos; Amalia Pinkusfeld,11,0,71,60
1657375903023,COGS 14A,A01,092681,Semenuks; Arturs,4,1,100,96
1657375909050,COGS 14B,A01,083073,Cheng; Tzu-Han,6,0,63,57
1657375915079,COGS 17,A01,092677,Semenuks; Arturs,6,0,81,75
1657375921109,COGS 100,A01,083619,Allen; Michael Gordon,17,0,70,53
1657375927140,COGS 101A,A01,083621,Davis; Joshua Daniel,9,0,68,59
1657375933171,COGS 101B,A01,091572,Allen; Michael Gordon,11,0,65,54
1657375939198,COGS 101C,A01,083625,Delgado; Tania,17,0,35,18
1657375945228,COGS 107A,A01,083627,Boyle; Mary E. T.,13,0,60,47
1657375951254,COGS 118A,A01,083075,Gupta; Anjum,20,0,76,56
1657375957281,CSE 3,A50,083646,Miranda; Gregory Joseph,24,0,50,26
1657375963308,CSE 8A,A50,083650,Miranda; Gregory Joseph,17,1,56,39
1657375969405,CSE 11,A01,083080,Cao; Yingjun,6,15,40,34
1657375975436,CSE 12,A01,083652,Krause-Levy; Sophia Louisa,28,1,120,92
1657375981465,CSE 15L,A01,083654,Morris; Justin Loren,9,0,50,41
1657375981465,CSE 15L,A02,083655,Morris; Justin Loren,9,0,50,41
1657375987489,CSE 20,A01,083657,Tran; Khoa Dang,39,0,80,41
1657375993515,CSE 21,A01,095574,Bach; Quang Tran,22,0,48,26
1657375999552,CSE 30,A01,083084,Eldon; John,4,0,80,76
1657375999552,CSE 30,B01,095061,Bhaskar; Nishant,9,0,50,41
1657376005585,CSE 100,A01,083659,Cao; Yingjun,5,4,70,65
1657376011612,CSE 134B,A01,083661,Powell; Thomas Allan,22,0,100,78
1657376017640,CSE 140,A01,083663,Gungor; Onat,14,0,85,71
1657376023665,CSE 140L,A01,083088,Eldon; John,21,0,100,79
1657376029692,CSE 175,A01,083665,Kumar; Rakesh,3,0,25,22
1657376035715,CSE 190,A00,092507,Dubnov; Shlomo,7,0,20,13
1657376041743,ECE 45,A01,083139,Congero; Spencer William,6,0,75,69
1657376047769,ECE 65,A50,083695,Saad; Andrew S,12,0,30,18
1657376047769,ECE 65,A51,095125,Saad; Andrew S,24,0,26,2
1657376053798,ECE 109,A01,091882,Touri; Behrouz,19,0,70,51
1657376059824,ECE 180,A00,083140,Abi Samra; Nicholas Camill,1,0,30,29
1657376059824,ECE 180,B00,083141,Abi Samra; Nicholas Camill,0,0,30,30
1657376065862,MATH 10A,A01,083735,Patchell; Gregory David,2,0,30,28
1657376065862,MATH 10A,A02,083736,Patchell; Gregory David,20,0,30,10
1657376065862,MATH 10A,A03,083737,Patchell; Gregory David,16,0,30,14
1657376071898,MATH 10B,A01,083207,Lim; Seonhee,8,0,34,26
1657376071898,MATH 10B,A02,083208,Lim; Seonhee,9,0,35,26
1657376071898,MATH 10B,A03,093472,Lim; Seonhee,7,0,34,27
1657376071898,MATH 10B,B01,083739,Sinha; Shubham,12,0,30,18
1657376077943,MATH 18,A01,083743,Cinel; Cameron Alexander,7,0,30,23
1657376077943,MATH 18,A02,083744,Cinel; Cameron Alexander,17,0,30,13
1657376077943,MATH 18,A03,083745,Cinel; Cameron Alexander,9,0,30,21
1657376077943,MATH 18,B01,083748,Rideout; David Porter,5,0,37,32
1657376077943,MATH 18,B02,083749,Rideout; David Porter,5,0,36,31
1657376077943,MATH 18,B03,083750,Rideout; David Porter,3,0,37,34
1657376077943,MATH 18,B04,083751,Rideout; David Porter,6,0,36,30
1657376077943,MATH 18,B05,093473,Rideout; David Porter,6,0,36,30
1657376077943,MATH 18,B06,093474,Rideout; David Porter,6,0,36,30
1657376083974,MATH 20A,A01,083754,Zheng; Zequn,14,0,40,26
1657376089999,MATH 20B,A01,083756,Briones; Jor-el Thomas Caparas,4,0,36,32
1657376089999,MATH 20B,A02,083757,Briones; Jor-el Thomas Caparas,1,0,36,35
1657376089999,MATH 20B,A03,093475,Briones; Jor-el Thomas Caparas,2,0,36,34
1657376096029,MATH 20C,A01,083760,Briones; Jor-el Thomas Caparas,1,0,35,34
1657376096029,MATH 20C,A02,083761,Briones; Jor-el Thomas Caparas,8,0,35,27
1657376096029,MATH 20C,A03,093476,Briones; Jor-el Thomas Caparas,0,1,36,36
1657376096029,MATH 20C,B01,083762,Bach; Quang Tran,1,0,30,29
1657376102063,MATH 20D,A01,083765,Tran; Brian Kha,5,0,30,25
1657376102063,MATH 20D,A02,083766,Tran; Brian Kha,5,0,30,25
1657376102063,MATH 20D,A03,083767,Tran; Brian Kha,5,0,30,25
1657376108092,MATH 20E,A01,083771,Ganguly; Soumya,9,0,32,23
1657376108092,MATH 20E,A02,083772,Ganguly; Soumya,6,0,32,26
1657376108092,MATH 20E,B01,083773,Ciotti; Benjamin,20,0,35,15
1657376108092,MATH 20E,B02,083774,Ciotti; Benjamin,17,0,35,18
1657376114128,MATH 103A,A01,083777,Greenfeld; Be'Eri,3,0,36,33
1657376114128,MATH 103A,A02,083778,Greenfeld; Be'Eri,5,0,36,31
1657376114128,MATH 103A,A03,093561,Greenfeld; Be'Eri,5,0,36,31
1657376114128,MATH 103A,B01,083779,Greenfeld; Be'Eri,7,0,36,29
1657376114128,MATH 103A,B02,083780,Greenfeld; Be'Eri,4,0,36,32
1657376114128,MATH 103A,B03,093562,Greenfeld; Be'Eri,3,0,36,33
1657376120152,MATH 105,A01,085443,Carter; Anne Toulson,15,0,35,20
1657376120152,MATH 105,A02,093477,Carter; Anne Toulson,20,0,35,15
1657376126176,MATH 109,A01,083213,Ganzberger; Geoffrey Michael,2,0,34,32
1657376126176,MATH 109,A02,083214,Ganzberger; Geoffrey Michael,4,0,34,30
1657376126176,MATH 109,A03,093478,Ganzberger; Geoffrey Michael,2,0,34,32
1657376126176,MATH 109,B01,083215,Ganzberger; Geoffrey Michael,1,0,32,31
1657376126176,MATH 109,B02,083216,Ganzberger; Geoffrey Michael,2,0,32,30
1657376126176,MATH 109,B03,093479,Ganzberger; Geoffrey Michael,8,0,32,24
1657376132204,MATH 142A,A01,083219,Chow; Bennett,7,0,32,25
1657376132204,MATH 142A,A02,083220,Chow; Bennett,10,0,32,22
1657376132204,MATH 142A,A03,093480,Chow; Bennett,8,0,32,24
1657376132204,MATH 142A,B03,093481,Chow; Bennett,8,0,32,24
1657376132204,MATH 142A,B04,093558,Chow; Bennett,13,0,32,19
1657376132204,MATH 142A,B05,093559,Chow; Bennett,6,0,32,26
1657376138238,MATH 193A,A01,083224,Rotar; Vladimir,8,0,34,26
1657376138238,MATH 193A,A02,083225,Rotar; Vladimir,9,0,34,25
1657376138238,MATH 193A,A03,083781,Rotar; Vladimir,5,0,34,29
1657376138238,MATH 193A,A04,083782,Rotar; Vladimir,10,0,34,24
1657376138238,MATH 193A,A05,093482,Rotar; Vladimir,10,0,34,24
1657376144265,MATH 197,001,091859,McAuley; Julian John,9999,0,9999,0
1657376144265,MATH 197,002,095566,Kedlaya; Kiran S.,9997,0,9999,2
1657376144265,MATH 197,003,095567,Xiao; Ming,9999,0,9999,0
1657376144265,MATH 197,004,095571,Perols; Johan Lars,9998,0,9999,1
1657376151337,COGS 9,A01,083615,Shannon; Kyle Michael,9,0,75,66
1657376157363,COGS 11,A01,083617,Boyle; Mary E. T.,22,0,48,26
1657376163391,COGS 13,A01,083071,Bastos; Amalia Pinkusfeld,11,0,71,60
1657376169431,COGS 14A,A01,092681,Semenuks; Arturs,4,1,100,96
1657376175459,COGS 14B,A01,083073,Cheng; Tzu-Han,6,0,63,57
1657376181486,COGS 17,A01,092677,Semenuks; Arturs,6,0,81,75
1657376187521,COGS 100,A01,083619,Allen; Michael Gordon,17,0,70,53
1657376193550,COGS 101A,A01,083621,Davis; Joshua Daniel,9,0,68,59
1657376199576,COGS 101B,A01,091572,Allen; Michael Gordon,11,0,65,54
1657376205608,COGS 101C,A01,083625,Delgado; Tania,17,0,35,18
1657376211633,COGS 107A,A01,083627,Boyle; Mary E. T.,13,0,60,47
1657376217661,COGS 118A,A01,083075,Gupta; Anjum,20,0,76,56
1657376223689,CSE 3,A50,083646,Miranda; Gregory Joseph,24,0,50,26
1657376229721,CSE 8A,A50,083650,Miranda; Gregory Joseph,17,1,56,39
1657376235752,CSE 11,A01,083080,Cao; Yingjun,6,15,40,34
1657376241776,CSE 12,A01,083652,Krause-Levy; Sophia Louisa,28,1,120,92
1657376247807,CSE 15L,A01,083654,Morris; Justin Loren,9,0,50,41
1657376247807,CSE 15L,A02,083655,Morris; Justin Loren,9,0,50,41
1657376253834,CSE 20,A01,083657,Tran; Khoa Dang,39,0,80,41
1657376259866,CSE 21,A01,095574,Bach; Quang Tran,22,0,48,26
1657376265893,CSE 30,A01,083084,Eldon; John,4,0,80,76
1657376265893,CSE 30,B01,095061,Bhaskar; Nishant,9,0,50,41
1657376271920,CSE 100,A01,083659,Cao; Yingjun,5,4,70,65
1657376277944,CSE 134B,A01,083661,Powell; Thomas Allan,22,0,100,78
1657376283970,CSE 140,A01,083663,Gungor; Onat,14,0,85,71
1657376289999,CSE 140L,A01,083088,Eldon; John,21,0,100,79
1657376296032,CSE 175,A01,083665,Kumar; Rakesh,3,0,25,22
1657376302059,CSE 190,A00,092507,Dubnov; Shlomo,7,0,20,13
1657376308091,ECE 45,A01,083139,Congero; Spencer William,6,0,75,69
1657376314118,ECE 65,A50,083695,Saad; Andrew S,12,0,30,18
1657376314118,ECE 65,A51,095125,Saad; Andrew S,24,0,26,2
1657376320150,ECE 109,A01,091882,Touri; Behrouz,19,0,70,51
1657376326177,ECE 180,A00,083140,Abi Samra; Nicholas Camill,1,0,30,29
1657376326177,ECE 180,B00,083141,Abi Samra; Nicholas Camill,0,0,30,30
1657376332203,MATH 10A,A01,083735,Patchell; Gregory David,2,0,30,28
1657376332203,MATH 10A,A02,083736,Patchell; Gregory David,20,0,30,10
1657376332203,MATH 10A,A03,083737,Patchell; Gregory David,16,0,30,14
1657376338233,MATH 10B,A01,083207,Lim; Seonhee,8,0,34,26
1657376338233,MATH 10B,A02,083208,Lim; Seonhee,9,0,35,26
1657376338233,MATH 10B,A03,093472,Lim; Seonhee,7,0,34,27
1657376338233,MATH 10B,B01,083739,Sinha; Shubham,12,0,30,18
1657376344262,MATH 18,A01,083743,Cinel; Cameron Alexander,7,0,30,23
1657376344262,MATH 18,A02,083744,Cinel; Cameron Alexander,17,0,30,13
1657376344262,MATH 18,A03,083745,Cinel; Cameron Alexander,9,0,30,21
1657376344262,MATH 18,B01,083748,Rideout; David Porter,5,0,37,32
1657376344262,MATH 18,B02,083749,Rideout; David Porter,5,0,36,31
1657376344262,MATH 18,B03,083750,Rideout; David Porter,3,0,37,34
1657376344262,MATH 18,B04,083751,Rideout; David Porter,6,0,36,30
1657376344262,MATH 18,B05,093473,Rideout; David Porter,6,0,36,30
1657376344262,MATH 18,B06,093474,Rideout; David Porter,6,0,36,30
1657376350291,MATH 20A,A01,083754,Zheng; Zequn,14,0,40,26
1657376356325,MATH 20B,A01,083756,Briones; Jor-el Thomas Caparas,4,0,36,32
1657376356325,MATH 20B,A02,083757,Briones; Jor-el Thomas Caparas,1,0,36,35
1657376356325,MATH 20B,A03,093475,Briones; Jor-el Thomas Caparas,2,0,36,34
1657376362360,MATH 20C,A01,083760,Briones; Jor-el Thomas Caparas,1,0,35,34
1657376362360,MATH 20C,A02,083761,Briones; Jor-el Thomas Caparas,8,0,35,27
1657376362360,MATH 20C,A03,093476,Briones; Jor-el Thomas Caparas,0,1,36,36
1657376362360,MATH 20C,B01,083762,Bach; Quang Tran,1,0,30,29
1657376368387,MATH 20D,A01,083765,Tran; Brian Kha,5,0,30,25
1657376368387,MATH 20D,A02,083766,Tran; Brian Kha,5,0,30,25
1657376368387,MATH 20D,A03,083767,Tran; Brian Kha,5,0,30,25
1657376374422,MATH 20E,A01,083771,Ganguly; Soumya,9,0,32,23
1657376374422,MATH 20E,A02,083772,Ganguly; Soumya,6,0,32,26
1657376374422,MATH 20E,B01,083773,Ciotti; Benjamin,20,0,35,15
1657376374422,MATH 20E,B02,083774,Ciotti; Benjamin,17,0,35,18
1657376380457,MATH 103A,A01,083777,Greenfeld; Be'Eri,3,0,36,33
1657376380457,MATH 103A,A02,083778,Greenfeld; Be'Eri,5,0,36,31
1657376380457,MATH 103A,A03,093561,Greenfeld; Be'Eri,5,0,36,31
1657376380457,MATH 103A,B01,083779,Greenfeld; Be'Eri,7,0,36,29
1657376380457,MATH 103A,B02,083780,Greenfeld; Be'Eri,4,0,36,32
1657376380457,MATH 103A,B03,093562,Greenfeld; Be'Eri,3,0,36,33
1657376386484,MATH 105,A01,085443,Carter; Anne Toulson,15,0,35,20
1657376386484,MATH 105,A02,093477,Carter; Anne Toulson,20,0,35,15
1657376392519,MATH 109,A01,083213,Ganzberger; Geoffrey Michael,2,0,34,32
1657376392519,MATH 109,A02,083214,Ganzberger; Geoffrey Michael,4,0,34,30
1657376392519,MATH 109,A03,093478,Ganzberger; Geoffrey Michael,2,0,34,32
1657376392519,MATH 109,B01,083215,Ganzberger; Geoffrey Michael,1,0,32,31
1657376392519,MATH 109,B02,083216,Ganzberger; Geoffrey Michael,2,0,32,30
1657376392519,MATH 109,B03,093479,Ganzberger; Geoffrey Michael,8,0,32,24
1657376398554,MATH 142A,A01,083219,Chow; Bennett,7,0,32,25
1657376398554,MATH 142A,A02,083220,Chow; Bennett,10,0,32,22
1657376398554,MATH 142A,A03,093480,Chow; Bennett,8,0,32,24
1657376398554,MATH 142A,B03,093481,Chow; Bennett,8,0,32,24
1657376398554,MATH 142A,B04,093558,Chow; Bennett,13,0,32,19
1657376398554,MATH 142A,B05,093559,Chow; Bennett,6,0,32,26
1657376404582,MATH 193A,A01,083224,Rotar; Vladimir,8,0,34,26
1657376404582,MATH 193A,A02,083225,Rotar; Vladimir,9,0,34,25
1657376404582,MATH 193A,A03,083781,Rotar; Vladimir,5,0,34,29
1657376404582,MATH 193A,A04,083782,Rotar; Vladimir,10,0,34,24
1657376404582,MATH 193A,A05,093482,Rotar; Vladimir,10,0,34,24
1657376410606,MATH 197,001,091859,McAuley; Julian John,9999,0,9999,0
1657376410606,MATH 197,002,095566,Kedlaya; Kiran S.,9997,0,9999,2
1657376410606,MATH 197,003,095567,Xiao; Ming,9999,0,9999,0
1657376410606,MATH 197,004,095571,Perols; Johan Lars,9998,0,9999,1
1657376417684,COGS 9,A01,083615,Shannon; Kyle Michael,9,0,75,66
1657376423711,COGS 11,A01,083617,Boyle; Mary E. T.,22,0,48,26
1657376429745,COGS 13,A01,083071,Bastos; Amalia Pinkusfeld,11,0,71,60
1657376435808,COGS 14A,A01,092681,Semenuks; Arturs,4,1,100,96
1657376441841,COGS 14B,A01,083073,Cheng; Tzu-Han,6,0,63,57
1657376447874,COGS 17,A01,092677,Semenuks; Arturs,6,0,81,75
1657376453927,COGS 100,A01,083619,Allen; Michael Gordon,17,0,70,53
1657376459958,COGS 101A,A01,083621,Davis; Joshua Daniel,9,0,68,59
1657376465988,COGS 101B,A01,091572,Allen; Michael Gordon,11,0,65,54
1657376472015,COGS 101C,A01,083625,Delgado; Tania,17,0,35,18
1657376478048,COGS 107A,A01,083627,Boyle; Mary E. T.,13,0,60,47
1657376484080,COGS 118A,A01,083075,Gupta; Anjum,20,0,76,56
1657376490109,CSE 3,A50,083646,Miranda; Gregory Joseph,24,0,50,26
1657376496134,CSE 8A,A50,083650,Miranda; Gregory Joseph,17,1,56,39
1657376502159,CSE 11,A01,083080,Cao; Yingjun,6,15,40,34
1657376508206,CSE 12,A01,083652,Krause-Levy; Sophia Louisa,28,1,120,92
1657376514231,CSE 15L,A01,083654,Morris; Justin Loren,9,0,50,41
1657376514231,CSE 15L,A02,083655,Morris; Justin Loren,9,0,50,41
1657376520263,CSE 20,A01,083657,Tran; Khoa Dang,39,0,80,41
1657376526288,CSE 21,A01,095574,Bach; Quang Tran,22,0,48,26
1657376532318,CSE 30,A01,083084,Eldon; John,4,0,80,76
1657376532318,CSE 30,B01,095061,Bhaskar; Nishant,9,0,50,41
1657376538343,CSE 100,A01,083659,Cao; Yingjun,5,4,70,65
1657376544368,CSE 134B,A01,083661,Powell; Thomas Allan,22,0,100,78
1657376550399,CSE 140,A01,083663,Gungor; Onat,14,0,85,71
1657376556431,CSE 140L,A01,083088,Eldon; John,21,0,100,79
1657376562457,CSE 175,A01,083665,Kumar; Rakesh,3,0,25,22
1657376568579,CSE 190,A00,092507,Dubnov; Shlomo,7,0,20,13
1657376574605,ECE 45,A01,083139,Congero; Spencer William,6,0,75,69
1657376580631,ECE 65,A50,083695,Saad; Andrew S,12,0,30,18
1657376580631,ECE 65,A51,095125,Saad; Andrew S,24,0,26,2
1657376586654,ECE 109,A01,091882,Touri; Behrouz,19,0,70,51
1657376592684,ECE 180,A00,083140,Abi Samra; Nicholas Camill,1,0,30,29
1657376592684,ECE 180,B00,083141,Abi Samra; Nicholas Camill,0,0,30,30
1657376598710,MATH 10A,A01,083735,Patchell; Gregory David,2,0,30,28
1657376598710,MATH 10A,A02,083736,Patchell; Gregory David,20,0,30,10
1657376598710,MATH 10A,A03,083737,Patchell; Gregory David,16,0,30,14
1657376604741,MATH 10B,A01,083207,Lim; Seonhee,8,0,34,26
1657376604741,MATH 10B,A02,083208,Lim; Seonhee,9,0,35,26
1657376604741,MATH 10B,A03,093472,Lim; Seonhee,7,0,34,27
1657376604741,MATH 10B,B01,083739,Sinha; Shubham,12,0,30,18
1657376610773,MATH 18,A01,083743,Cinel; Cameron Alexander,7,0,30,23
1657376610773,MATH 18,A02,083744,Cinel; Cameron Alexander,17,0,30,13
1657376610773,MATH 18,A03,083745,Cinel; Cameron Alexander,9,0,30,21
1657376610773,MATH 18,B01,083748,Rideout; David Porter,5,0,37,32
1657376610773,MATH 18,B02,083749,Rideout; David Porter,5,0,36,31
1657376610773,MATH 18,B03,083750,Rideout; David Porter,3,0,37,34
1657376610773,MATH 18,B04,083751,Rideout; David Porter,6,0,36,30
1657376610773,MATH 18,B05,093473,Rideout; David Porter,6,0,36,30
1657376610773,MATH 18,B06,093474,Rideout; David Porter,6,0,36,30
1657376616802,MATH 20A,A01,083754,Zheng; Zequn,14,0,40,26
1657376622829,MATH 20B,A01,083756,Briones; Jor-el Thomas Caparas,4,0,36,32
1657376622829,MATH 20B,A02,083757,Briones; Jor-el Thomas Caparas,1,0,36,35
1657376622829,MATH 20B,A03,093475,Briones; Jor-el Thomas Caparas,2,0,36,34
1657376628855,MATH 20C,A01,083760,Briones; Jor-el Thomas Caparas,1,0,35,34
1657376628855,MATH 20C,A02,083761,Briones; Jor-el Thomas Caparas,8,0,35,27
1657376628855,MATH 20C,A03,093476,Briones; Jor-el Thomas Caparas,0,1,36,36
1657376628855,MATH 20C,B01,083762,Bach; Quang Tran,1,0,30,29
1657376634881,MATH 20D,A01,083765,Tran; Brian Kha,5,0,30,25
1657376634881,MATH 20D,A02,083766,Tran; Brian Kha,5,0,30,25
1657376634881,MATH 20D,A03,083767,Tran; Brian Kha,5,0,30,25
1657376640910,MATH 20E,A01,083771,Ganguly; Soumya,9,0,32,23
1657376640910,MATH 20E,A02,083772,Ganguly; Soumya,6,0,32,26
1657376640910,MATH 20E,B01,083773,Ciotti; Benjamin,20,0,35,15
1657376640910,MATH 20E,B02,083774,Ciotti; Benjamin,17,0,35,18
1657376646946,MATH 103A,A01,083777,Greenfeld; Be'Eri,3,0,36,33
1657376646946,MATH 103A,A02,083778,Greenfeld; Be'Eri,5,0,36,31
1657376646946,MATH 103A,A03,093561,Greenfeld; Be'Eri,5,0,36,31
1657376646946,MATH 103A,B01,083779,Greenfeld; Be'Eri,7,0,36,29
1657376646946,MATH 103A,B02,083780,Greenfeld; Be'Eri,4,0,36,32
1657376646946,MATH 103A,B03,093562,Greenfeld; Be'Eri,3,0,36,33
1657376652973,MATH 105,A01,085443,Carter; Anne Toulson,15,0,35,20
1657376652973,MATH 105,A02,093477,Carter; Anne Toulson,20,0,35,15
1657376659008,MATH 109,A01,083213,Ganzberger; Geoffrey Michael,2,0,34,32
1657376659008,MATH 109,A02,083214,Ganzberger; Geoffrey Michael,4,0,34,30
1657376659008,MATH 109,A03,093478,Ganzberger; Geoffrey Michael,2,0,34,32
1657376659008,MATH 109,B01,083215,Ganzberger; Geoffrey Michael,1,0,32,31
1657376659008,MATH 109,B02,083216,Ganzberger; Geoffrey Michael,2,0,32,30
1657376659008,MATH 109,B03,093479,Ganzberger; Geoffrey Michael,8,0,32,24
1657376665037,MATH 142A,A01,083219,Chow; Bennett,7,0,32,25
1657376665037,MATH 142A,A02,083220,Chow; Bennett,10,0,32,22
1657376665037,MATH 142A,A03,093480,Chow; Bennett,8,0,32,24
1657376665037,MATH 142A,B03,093481,Chow; Bennett,8,0,32,24
1657376665037,MATH 142A,B04,093558,Chow; Bennett,13,0,32,19
1657376665037,MATH 142A,B05,093559,Chow; Bennett,6,0,32,26
1657376671065,MATH 193A,A01,083224,Rotar; Vladimir,8,0,34,26
1657376671065,MATH 193A,A02,083225,Rotar; Vladimir,9,0,34,25
1657376671065,MATH 193A,A03,083781,Rotar; Vladimir,5,0,34,29
1657376671065,MATH 193A,A04,083782,Rotar; Vladimir,10,0,34,24
1657376671065,MATH 193A,A05,093482,Rotar; Vladimir,10,0,34,24
1657376677093,MATH 197,001,091859,McAuley; Julian John,9999,0,9999,0
1657376677093,MATH 197,002,095566,Kedlaya; Kiran S.,9997,0,9999,2
1657376677093,MATH 197,003,095567,Xiao; Ming,9999,0,9999,0
1657376677093,MATH 197,004,095571,Perols; Johan Lars,9998,0,9999,1
1657376684168,COGS 9,A01,083615,Shannon; Kyle Michael,9,0,75,66
1657376690194,COGS 11,A01,083617,Boyle; Mary E. T.,22,0,48,26
1657376696221,COGS 13,A01,083071,Bastos; Amalia Pinkusfeld,11,0,71,60
1657376702262,COGS 14A,A01,092681,Semenuks; Arturs,4,1,100,96
1657376708294,COGS 14B,A01,083073,Cheng; Tzu-Han,6,0,63,57
1657376714320,COGS 17,A01,092677,Semenuks; Arturs,6,0,81,75
1657376720346,COGS 100,A01,083619,Allen; Michael Gordon,17,0,70,53
1657376726371,COGS 101A,A01,083621,Davis; Joshua Daniel,9,0,68,59
1657376732404,COGS 101B,A01,091572,Allen; Michael Gordon,11,0,65,54
1657376738429,COGS 101C,A01,083625,Delgado; Tania,17,0,35,18
1657376744464,COGS 107A,A01,083627,Boyle; Mary E. T.,13,0,60,47
1657376750493,COGS 118A,A01,083075,Gupta; Anjum,20,0,76,56
1657376756520,CSE 3,A50,083646,Miranda; Gregory Joseph,24,0,50,26
1657376762550,CSE 8A,A50,083650,Miranda; Gregory Joseph,17,1,56,39
1657376768573,CSE 11,A01,083080,Cao; Yingjun,6,15,40,34
1657376774597,CSE 12,A01,083652,Krause-Levy; Sophia Louisa,28,1,120,92
1657376780626,CSE 15L,A01,083654,Morris; Justin Loren,9,0,50,41
1657376780626,CSE 15L,A02,083655,Morris; Justin Loren,9,0,50,41
1657376786650,CSE 20,A01,083657,Tran; Khoa Dang,39,0,80,41
1657376792677,CSE 21,A01,095574,Bach; Quang Tran,22,0,48,26
1657376798703,CSE 30,A01,083084,Eldon; John,4,0,80,76
1657376798703,CSE 30,B01,095061,Bhaskar; Nishant,9,0,50,41
1657376804728,CSE 100,A01,083659,Cao; Yingjun,5,4,70,65
1657376810753,CSE 134B,A01,083661,Powell; Thomas Allan,22,0,100,78
1657376816783,CSE 140,A01,083663,Gungor; Onat,14,0,85,71
1657376822807,CSE 140L,A01,083088,Eldon; John,21,0,100,79
1657376828839,CSE 175,A01,083665,Kumar; Rakesh,3,0,25,22
1657376834870,CSE 190,A00,092507,Dubnov; Shlomo,7,0,20,13
1657376840896,ECE 45,A01,083139,Congero; Spencer William,6,0,75,69
1657376846930,ECE 65,A50,083695,Saad; Andrew S,12,0,30,18
1657376846930,ECE 65,A51,095125,Saad; Andrew S,24,0,26,2
1657376852958,ECE 109,A01,091882,Touri; Behrouz,19,0,70,51
1657376858990,ECE 180,A00,083140,Abi Samra; Nicholas Camill,1,0,30,29
1657376858990,ECE 180,B00,083141,Abi Samra; Nicholas Camill,0,0,30,30
1657376865016,MATH 10A,A01,083735,Patchell; Gregory David,2,0,30,28
1657376865016,MATH 10A,A02,083736,Patchell; Gregory David,20,0,30,10
1657376865016,MATH 10A,A03,083737,Patchell; Gregory David,16,0,30,14
1657376871044,MATH 10B,A01,083207,Lim; Seonhee,8,0,34,26
1657376871044,MATH 10B,A02,083208,Lim; Seonhee,9,0,35,26
1657376871044,MATH 10B,A03,093472,Lim; Seonhee,7,0,34,27
1657376871044,MATH 10B,B01,083739,Sinha; Shubham,12,0,30,18
1657376877089,MATH 18,A01,083743,Cinel; Cameron Alexander,7,0,30,23
1657376877089,MATH 18,A02,083744,Cinel; Cameron Alexander,17,0,30,13
1657376877089,MATH 18,A03,083745,Cinel; Cameron Alexander,9,0,30,21
1657376877089,MATH 18,B01,083748,Rideout; David Porter,5,0,37,32
1657376877089,MATH 18,B02,083749,Rideout; David Porter,5,0,36,31
1657376877089,MATH 18,B03,083750,Rideout; David Porter,3,0,37,34
1657376877089,MATH 18,B04,083751,Rideout; David Porter,6,0,36,30
1657376877089,MATH 18,B05,093473,Rideout; David Porter,6,0,36,30
1657376877089,MATH 18,B06,093474,Rideout; David Porter,6,0,36,30
1657376883115,MATH 20A,A01,083754,Zheng; Zequn,14,0,40,26
1657376889140,MATH 20B,A01,083756,Briones; Jor-el Thomas Caparas,4,0,36,32
1657376889140,MATH 20B,A02,083757,Briones; Jor-el Thomas Caparas,1,0,36,35
1657376889140,MATH 20B,A03,093475,Briones; Jor-el Thomas Caparas,2,0,36,34
1657376895186,MATH 20C,A01,083760,Briones; Jor-el Thomas Caparas,1,0,35,34
1657376895186,MATH 20C,A02,083761,Briones; Jor-el Thomas Caparas,8,0,35,27
1657376895186,MATH 20C,A03,093476,Briones; Jor-el Thomas Caparas,0,1,36,36
1657376895186,MATH 20C,B01,083762,Bach; Quang Tran,1,0,30,29
1657376901210,MATH 20D,A01,083765,Tran; Brian Kha,5,0,30,25
1657376901210,MATH 20D,A02,083766,Tran; Brian Kha,5,0,30,25
1657376901210,MATH 20D,A03,083767,Tran; Brian Kha,5,0,30,25
1657376907238,MATH 20E,A01,083771,Ganguly; Soumya,9,0,32,23
1657376907238,MATH 20E,A02,083772,Ganguly; Soumya,6,0,32,26
1657376907238,MATH 20E,B01,083773,Ciotti; Benjamin,20,0,35,15
1657376907238,MATH 20E,B02,083774,Ciotti; Benjamin,17,0,35,18
1657376913264,MATH 103A,A01,083777,Greenfeld; Be'Eri,3,0,36,33
1657376913264,MATH 103A,A02,083778,Greenfeld; Be'Eri,5,0,36,31
1657376913264,MATH 103A,A03,093561,Greenfeld; Be'Eri,5,0,36,31
1657376913264,MATH 103A,B01,083779,Greenfeld; Be'Eri,7,0,36,29
1657376913264,MATH 103A,B02,083780,Greenfeld; Be'Eri,4,0,36,32
1657376913264,MATH 103A,B03,093562,Greenfeld; Be'Eri,3,0,36,33
1657376919295,MATH 105,A01,085443,Carter; Anne Toulson,15,0,35,20
1657376919295,MATH 105,A02,093477,Carter; Anne Toulson,20,0,35,15
1657376925322,MATH 109,A01,083213,Ganzberger; Geoffrey Michael,2,0,34,32
1657376925322,MATH 109,A02,083214,Ganzberger; Geoffrey Michael,4,0,34,30
1657376925322,MATH 109,A03,093478,Ganzberger; Geoffrey Michael,2,0,34,32
1657376925322,MATH 109,B01,083215,Ganzberger; Geoffrey Michael,1,0,32,31
1657376925322,MATH 109,B02,083216,Ganzberger; Geoffrey Michael,2,0,32,30
1657376925322,MATH 109,B03,093479,Ganzberger; Geoffrey Michael,8,0,32,24
1657376931349,MATH 142A,A01,083219,Chow; Bennett,7,0,32,25
1657376931349,MATH 142A,A02,083220,Chow; Bennett,10,0,32,22
1657376931349,MATH 142A,A03,093480,Chow; Bennett,8,0,32,24
1657376931349,MATH 142A,B03,093481,Chow; Bennett,8,0,32,24
1657376931349,MATH 142A,B04,093558,Chow; Bennett,13,0,32,19
1657376931349,MATH 142A,B05,093559,Chow; Bennett,6,0,32,26
1657376937388,MATH 193A,A01,083224,Rotar; Vladimir,8,0,34,26
1657376937388,MATH 193A,A02,083225,Rotar; Vladimir,9,0,34,25
1657376937388,MATH 193A,A03,083781,Rotar; Vladimir,5,0,34,29
1657376937388,MATH 193A,A04,083782,Rotar; Vladimir,10,0,34,24
1657376937388,MATH 193A,A05,093482,Rotar; Vladimir,10,0,34,24
1657376943413,MATH 197,001,091859,McAuley; Julian John,9999,0,9999,0
1657376943413,MATH 197,002,095566,Kedlaya; Kiran S.,9997,0,9999,2
1657376943413,MATH 197,003,095567,Xiao; Ming,9999,0,9999,0
1657376943413,MATH 197,004,095571,Perols; Johan Lars,9998,0,9999,1
1657376950479,COGS 9,A01,083615,Shannon; Kyle Michael,9,0,75,66
1657376956506,COGS 11,A01,083617,Boyle; Mary E. T.,22,0,48,26
1657376962530,COGS 13,A01,083071,Bastos; Amalia Pinkusfeld,11,0,71,60
1657376968556,COGS 14A,A01,092681,Semenuks; Arturs,4,1,100,96
1657376974580,COGS 14B,A01,083073,Cheng; Tzu-Han,6,0,63,57
1657376980608,COGS 17,A01,092677,Semenuks; Arturs,6,0,81,75
1657376986652,COGS 100,A01,083619,Allen; Michael Gordon,17,0,70,53
1657376992688,COGS 101A,A01,083621,Davis; Joshua Daniel,9,0,68,59
1657376998717,COGS 101B,A01,091572,Allen; Michael Gordon,11,0,65,54
1657377004748,COGS 101C,A01,083625,Delgado; Tania,17,0,35,18
1657377010772,COGS 107A,A01,083627,Boyle; Mary E. T.,13,0,60,47
1657377016800,COGS 118A,A01,083075,Gupta; Anjum,20,0,76,56
1657377022824,CSE 3,A50,083646,Miranda; Gregory Joseph,24,0,50,26
1657377028849,CSE 8A,A50,083650,Miranda; Gregory Joseph,17,1,56,39
1657377034880,CSE 11,A01,083080,Cao; Yingjun,6,15,40,34
1657377040904,CSE 12,A01,083652,Krause-Levy; Sophia Louisa,28,1,120,92
1657377046929,CSE 15L,A01,083654,Morris; Justin Loren,9,0,50,41
1657377046929,CSE 15L,A02,083655,Morris; Justin Loren,9,0,50,41
1657377052954,CSE 20,A01,083657,Tran; Khoa Dang,39,0,80,41
1657377058994,CSE 21,A01,095574,Bach; Quang Tran,22,0,48,26
1657377065019,CSE 30,A01,083084,Eldon; John,4,0,80,76
1657377065019,CSE 30,B01,095061,Bhaskar; Nishant,9,0,50,41
1657377071043,CSE 100,A01,083659,Cao; Yingjun,5,4,70,65
1657377077068,CSE 134B,A01,083661,Powell; Thomas Allan,22,0,100,78
1657377083098,CSE 140,A01,083663,Gungor; Onat,14,0,85,71
1657377089123,CSE 140L,A01,083088,Eldon; John,21,0,100,79
1657377095151,CSE 175,A01,083665,Kumar; Rakesh,3,0,25,22
1657377101174,CSE 190,A00,092507,Dubnov; Shlomo,7,0,20,13
1657377107207,ECE 45,A01,083139,Congero; Spencer William,6,0,75,69
1657377113239,ECE 65,A50,083695,Saad; Andrew S,12,0,30,18
1657377113239,ECE 65,A51,095125,Saad; Andrew S,24,0,26,2
1657377119265,ECE 109,A01,091882,Touri; Behrouz,19,0,70,51
1657377125300,ECE 180,A00,083140,Abi Samra; Nicholas Camill,1,0,30,29
1657377125300,ECE 180,B00,083141,Abi Samra; Nicholas Camill,0,0,30,30
1657377131330,MATH 10A,A01,083735,Patchell; Gregory David,2,0,30,28
1657377131330,MATH 10A,A02,083736,Patchell; Gregory David,20,0,30,10
1657377131330,MATH 10A,A03,083737,Patchell; Gregory David,16,0,30,14
1657377137366,MATH 10B,A01,083207,Lim; Seonhee,8,0,34,26
1657377137366,MATH 10B,A02,083208,Lim; Seonhee,9,0,35,26
1657377137366,MATH 10B,A03,093472,Lim; Seonhee,7,0,34,27
1657377137366,MATH 10B,B01,083739,Sinha; Shubham,12,0,30,18
1657377143394,MATH 18,A01,083743,Cinel; Cameron Alexander,7,0,30,23
1657377143394,MATH 18,A02,083744,Cinel; Cameron Alexander,17,0,30,13
1657377143394,MATH 18,A03,083745,Cinel; Cameron Alexander,9,0,30,21
1657377143394,MATH 18,B01,083748,Rideout; David Porter,5,0,37,32
1657377143394,MATH 18,B02,083749,Rideout; David Porter,5,0,36,31
1657377143394,MATH 18,B03,083750,Rideout; David Porter,3,0,37,34
1657377143394,MATH 18,B04,083751,Rideout; David Porter,6,0,36,30
1657377143394,MATH 18,B05,093473,Rideout; David Porter,6,0,36,30
1657377143394,MATH 18,B06,093474,Rideout; David Porter,6,0,36,30
1657377149438,MATH 20A,A01,083754,Zheng; Zequn,14,0,40,26
1657377155471,MATH 20B,A01,083756,Briones; Jor-el Thomas Caparas,4,0,36,32
1657377155471,MATH 20B,A02,083757,Briones; Jor-el Thomas Caparas,1,0,36,35
1657377155471,MATH 20B,A03,093475,Briones; Jor-el Thomas Caparas,2,0,36,34
1657377161498,MATH 20C,A01,083760,Briones; Jor-el Thomas Caparas,1,0,35,34
1657377161498,MATH 20C,A02,083761,Briones; Jor-el Thomas Caparas,8,0,35,27
1657377161498,MATH 20C,A03,093476,Briones; Jor-el Thomas Caparas,0,1,36,36
1657377161498,MATH 20C,B01,083762,Bach; Quang Tran,1,0,30,29
1657377167595,MATH 20D,A01,083765,Tran; Brian Kha,5,0,30,25
1657377167595,MATH 20D,A02,083766,Tran; Brian Kha,5,0,30,25
1657377167595,MATH 20D,A03,083767,Tran; Brian Kha,5,0,30,25
1657377173627,MATH 20E,A01,083771,Ganguly; Soumya,9,0,32,23
1657377173627,MATH 20E,A02,083772,Ganguly; Soumya,6,0,32,26
1657377173627,MATH 20E,B01,083773,Ciotti; Benjamin,20,0,35,15
1657377173627,MATH 20E,B02,083774,Ciotti; Benjamin,17,0,35,18
1657377179662,MATH 103A,A01,083777,Greenfeld; Be'Eri,3,0,36,33
1657377179662,MATH 103A,A02,083778,Greenfeld; Be'Eri,5,0,36,31
1657377179662,MATH 103A,A03,093561,Greenfeld; Be'Eri,5,0,36,31
1657377179662,MATH 103A,B01,083779,Greenfeld; Be'Eri,7,0,36,29
1657377179662,MATH 103A,B02,083780,Greenfeld; Be'Eri,4,0,36,32
1657377179662,MATH 103A,B03,093562,Greenfeld; Be'Eri,3,0,36,33
1657377185689,MATH 105,A01,085443,Carter; Anne Toulson,15,0,35,20
1657377185689,MATH 105,A02,093477,Carter; Anne Toulson,20,0,35,15
1657377191719,MATH 109,A01,083213,Ganzberger; Geoffrey Michael,2,0,34,32
1657377191719,MATH 109,A02,083214,Ganzberger; Geoffrey Michael,4,0,34,30
1657377191719,MATH 109,A03,093478,Ganzberger; Geoffrey Michael,2,0,34,32
1657377191719,MATH 109,B01,083215,Ganzberger; Geoffrey Michael,1,0,32,31
1657377191719,MATH 109,B02,083216,Ganzberger; Geoffrey Michael,2,0,32,30
1657377191719,MATH 109,B03,093479,Ganzberger; Geoffrey Michael,8,0,32,24
1657377197752,MATH 142A,A01,083219,Chow; Bennett,7,0,32,25
1657377197752,MATH 142A,A02,083220,Chow; Bennett,10,0,32,22
1657377197752,MATH 142A,A03,093480,Chow; Bennett,8,0,32,24
1657377197752,MATH 142A,B03,093481,Chow; Bennett,8,0,32,24
1657377197752,MATH 142A,B04,093558,Chow; Bennett,13,0,32,19
1657377197752,MATH 142A,B05,093559,Chow; Bennett,6,0,32,26
1657377203784,MATH 193A,A01,083224,Rotar; Vladimir,8,0,34,26
1657377203784,MATH 193A,A02,083225,Rotar; Vladimir,9,0,34,25
1657377203784,MATH 193A,A03,083781,Rotar; Vladimir,5,0,34,29
1657377203784,MATH 193A,A04,083782,Rotar; Vladimir,10,0,34,24
1657377203784,MATH 193A,A05,093482,Rotar; Vladimir,10,0,34,24
1657377209810,MATH 197,001,091859,McAuley; Julian John,9999,0,9999,0
1657377209810,MATH 197,002,095566,Kedlaya; Kiran S.,9997,0,9999,2
1657377209810,MATH 197,003,095567,Xiao; Ming,9999,0,9999,0
1657377209810,MATH 197,004,095571,Perols; Johan Lars,9998,0,9999,1
1657377216891,COGS 9,A01,083615,Shannon; Kyle Michael,9,0,75,66
1657377222916,COGS 11,A01,083617,Boyle; Mary E. T.,22,0,48,26
1657377228940,COGS 13,A01,083071,Bastos; Amalia Pinkusfeld,11,0,71,60
1657377234962,COGS 14A,A01,092681,Semenuks; Arturs,4,1,100,96
1657377240988,COGS 14B,A01,083073,Cheng; Tzu-Han,6,0,63,57
1657377247017,COGS 17,A01,092677,Semenuks; Arturs,6,0,81,75
1657377253050,COGS 100,A01,083619,Allen; Michael Gordon,17,0,70,53
1657377259078,COGS 101A,A01,083621,Davis; Joshua Daniel,9,0,68,59
1657377265103,COGS 101B,A01,091572,Allen; Michael Gordon,11,0,65,54
1657377271130,COGS 101C,A01,083625,Delgado; Tania,17,0,35,18
1657377277157,COGS 107A,A01,083627,Boyle; Mary E. T.,13,0,60,47
1657377283182,COGS 118A,A01,083075,Gupta; Anjum,20,0,76,56
1657377289213,CSE 3,A50,083646,Miranda; Gregory Joseph,24,0,50,26
1657377295243,CSE 8A,A50,083650,Miranda; Gregory Joseph,17,1,56,39
1657377301273,CSE 11,A01,083080,Cao; Yingjun,6,15,40,34
1657377307298,CSE 12,A01,083652,Krause-Levy; Sophia Louisa,28,1,120,92
1657377313322,CSE 15L,A01,083654,Morris; Justin Loren,9,0,50,41
1657377313322,CSE 15L,A02,083655,Morris; Justin Loren,9,0,50,41
1657377319353,CSE 20,A01,083657,Tran; Khoa Dang,39,0,80,41
1657377325376,CSE 21,A01,095574,Bach; Quang Tran,22,0,48,26
1657377331407,CSE 30,A01,083084,Eldon; John,4,0,80,76
1657377331407,CSE 30,B01,095061,Bhaskar; Nishant,9,0,50,41
1657377337432,CSE 100,A01,083659,Cao; Yingjun,5,4,70,65
1657377343460,CSE 134B,A01,083661,Powell; Thomas Allan,22,0,100,78
1657377349487,CSE 140,A01,083663,Gungor; Onat,14,0,85,71
1657377355519,CSE 140L,A01,083088,Eldon; John,21,0,100,79
1657377361544,CSE 175,A01,083665,Kumar; Rakesh,3,0,25,22
1657377367578,CSE 190,A00,092507,Dubnov; Shlomo,7,0,20,13
1657377373604,ECE 45,A01,083139,Congero; Spencer William,6,0,75,69
1657377379632,ECE 65,A50,083695,Saad; Andrew S,12,0,30,18
1657377379632,ECE 65,A51,095125,Saad; Andrew S,24,0,26,2
1657377385660,ECE 109,A01,091882,Touri; Behrouz,19,0,70,51
1657377391692,ECE 180,A00,083140,Abi Samra; Nicholas Camill,1,0,30,29
1657377391692,ECE 180,B00,083141,Abi Samra; Nicholas Camill,0,0,30,30
1657377397723,MATH 10A,A01,083735,Patchell; Gregory David,2,0,30,28
1657377397723,MATH 10A,A02,083736,Patchell; Gregory David,20,0,30,10
1657377397723,MATH 10A,A03,083737,Patchell; Gregory David,16,0,30,14
1657377403761,MATH 10B,A01,083207,Lim; Seonhee,8,0,34,26
1657377403761,MATH 10B,A02,083208,Lim; Seonhee,9,0,35,26
1657377403761,MATH 10B,A03,093472,Lim; Seonhee,7,0,34,27
1657377403761,MATH 10B,B01,083739,Sinha; Shubham,12,0,30,18
1657377409790,MATH 18,A01,083743,Cinel; Cameron Alexander,7,0,30,23
1657377409790,MATH 18,A02,083744,Cinel; Cameron Alexander,17,0,30,13
1657377409790,MATH 18,A03,083745,Cinel; Cameron Alexander,9,0,30,21
1657377409790,MATH 18,B01,083748,Rideout; David Porter,5,0,37,32
1657377409790,MATH 18,B02,083749,Rideout; David Porter,5,0,36,31
1657377409790,MATH 18,B03,083750,Rideout; David Porter,3,0,37,34
1657377409790,MATH 18,B04,083751,Rideout; David Porter,6,0,36,30
1657377409790,MATH 18,B05,093473,Rideout; David Porter,6,0,36,30
1657377409790,MATH 18,B06,093474,Rideout; David Porter,6,0,36,30
1657377415818,MATH 20A,A01,083754,Zheng; Zequn,14,0,40,26
1657377421849,MATH 20B,A01,083756,Briones; Jor-el Thomas Caparas,4,0,36,32
1657377421849,MATH 20B,A02,083757,Briones; Jor-el Thomas Caparas,1,0,36,35
1657377421849,MATH 20B,A03,093475,Briones; Jor-el Thomas Caparas,2,0,36,34
1657377427879,MATH 20C,A01,083760,Briones; Jor-el Thomas Caparas,1,0,35,34
1657377427879,MATH 20C,A02,083761,Briones; Jor-el Thomas Caparas,8,0,35,27
1657377427879,MATH 20C,A03,093476,Briones; Jor-el Thomas Caparas,0,1,36,36
1657377427879,MATH 20C,B01,083762,Bach; Quang Tran,1,0,30,29
1657377433907,MATH 20D,A01,083765,Tran; Brian Kha,5,0,30,25
1657377433907,MATH 20D,A02,083766,Tran; Brian Kha,5,0,30,25
1657377433907,MATH 20D,A03,083767,Tran; Brian Kha,5,0,30,25
1657377439933,MATH 20E,A01,083771,Ganguly; Soumya,9,0,32,23
1657377439933,MATH 20E,A02,083772,Ganguly; Soumya,6,0,32,26
1657377439933,MATH 20E,B01,083773,Ciotti; Benjamin,20,0,35,15
1657377439933,MATH 20E,B02,083774,Ciotti; Benjamin,17,0,35,18
1657377445968,MATH 103A,A01,083777,Greenfeld; Be'Eri,3,0,36,33
1657377445968,MATH 103A,A02,083778,Greenfeld; Be'Eri,5,0,36,31
1657377445968,MATH 103A,A03,093561,Greenfeld; Be'Eri,5,0,36,31
1657377445968,MATH 103A,B01,083779,Greenfeld; Be'Eri,7,0,36,29
1657377445968,MATH 103A,B02,083780,Greenfeld; Be'Eri,4,0,36,32
1657377445968,MATH 103A,B03,093562,Greenfeld; Be'Eri,3,0,36,33
1657377451993,MATH 105,A01,085443,Carter; Anne Toulson,15,0,35,20
1657377451993,MATH 105,A02,093477,Carter; Anne Toulson,20,0,35,15
1657377458027,MATH 109,A01,083213,Ganzberger; Geoffrey Michael,2,0,34,32
1657377458027,MATH 109,A02,083214,Ganzberger; Geoffrey Michael,4,0,34,30
1657377458027,MATH 109,A03,093478,Ganzberger; Geoffrey Michael,2,0,34,32
1657377458027,MATH 109,B01,083215,Ganzberger; Geoffrey Michael,1,0,32,31
1657377458027,MATH 109,B02,083216,Ganzberger; Geoffrey Michael,2,0,32,30
1657377458027,MATH 109,B03,093479,Ganzberger; Geoffrey Michael,8,0,32,24
1657377464063,MATH 142A,A01,083219,Chow; Bennett,7,0,32,25
1657377464063,MATH 142A,A02,083220,Chow; Bennett,10,0,32,22
1657377464063,MATH 142A,A03,093480,Chow; Bennett,8,0,32,24
1657377464063,MATH 142A,B03,093481,Chow; Bennett,8,0,32,24
1657377464063,MATH 142A,B04,093558,Chow; Bennett,13,0,32,19
1657377464063,MATH 142A,B05,093559,Chow; Bennett,6,0,32,26
1657377470089,MATH 193A,A01,083224,Rotar; Vladimir,8,0,34,26
1657377470089,MATH 193A,A02,083225,Rotar; Vladimir,9,0,34,25
1657377470089,MATH 193A,A03,083781,Rotar; Vladimir,5,0,34,29
1657377470089,MATH 193A,A04,083782,Rotar; Vladimir,10,0,34,24
1657377470089,MATH 193A,A05,093482,Rotar; Vladimir,10,0,34,24
1657377476117,MATH 197,001,091859,McAuley; Julian John,9999,0,9999,0
1657377476117,MATH 197,002,095566,Kedlaya; Kiran S.,9997,0,9999,2
1657377476117,MATH 197,003,095567,Xiao; Ming,9999,0,9999,0
1657377476117,MATH 197,004,095571,Perols; Johan Lars,9998,0,9999,1
1657377483188,COGS 9,A01,083615,Shannon; Kyle Michael,9,0,75,66
1657377489219,COGS 11,A01,083617,Boyle; Mary E. T.,22,0,48,26
1657377495243,COGS 13,A01,083071,Bastos; Amalia Pinkusfeld,11,0,71,60
1657377501269,COGS 14A,A01,092681,Semenuks; Arturs,4,1,100,96
1657377507296,COGS 14B,A01,083073,Cheng; Tzu-Han,6,0,63,57
1657377513320,COGS 17,A01,092677,Semenuks; Arturs,6,0,81,75
1657377519348,COGS 100,A01,083619,Allen; Michael Gordon,17,0,70,53
1657377525376,COGS 101A,A01,083621,Davis; Joshua Daniel,9,0,68,59
1657377531405,COGS 101B,A01,091572,Allen; Michael Gordon,11,0,65,54
1657377537428,COGS 101C,A01,083625,Delgado; Tania,17,0,35,18
1657377543454,COGS 107A,A01,083627,Boyle; Mary E. T.,13,0,60,47
1657377549478,COGS 118A,A01,083075,Gupta; Anjum,20,0,76,56
1657377555505,CSE 3,A50,083646,Miranda; Gregory Joseph,24,0,50,26
1657377561530,CSE 8A,A50,083650,Miranda; Gregory Joseph,17,1,56,39
1657377567558,CSE 11,A01,083080,Cao; Yingjun,6,15,40,34
1657377573585,CSE 12,A01,083652,Krause-Levy; Sophia Louisa,28,1,120,92
1657377579614,CSE 15L,A01,083654,Morris; Justin Loren,9,0,50,41
1657377579614,CSE 15L,A02,083655,Morris; Justin Loren,9,0,50,41
1657377585640,CSE 20,A01,083657,Tran; Khoa Dang,39,0,80,41
1657377591666,CSE 21,A01,095574,Bach; Quang Tran,22,0,48,26
1657377597698,CSE 30,A01,083084,Eldon; John,4,0,80,76
1657377597698,CSE 30,B01,095061,Bhaskar; Nishant,9,0,50,41
1657377603728,CSE 100,A01,083659,Cao; Yingjun,5,4,70,65
1657377609763,CSE 134B,A01,083661,Powell; Thomas Allan,22,0,100,78
1657377615786,CSE 140,A01,083663,Gungor; Onat,14,0,85,71
1657377621809,CSE 140L,A01,083088,Eldon; John,21,0,100,79
1657377627832,CSE 175,A01,083665,Kumar; Rakesh,3,0,25,22
1657377633856,CSE 190,A00,092507,Dubnov; Shlomo,7,0,20,13
1657377639881,ECE 45,A01,083139,Congero; Spencer William,6,0,75,69
1657377645912,ECE 65,A50,083695,Saad; Andrew S,12,0,30,18
1657377645912,ECE 65,A51,095125,Saad; Andrew S,24,0,26,2
1657377651937,ECE 109,A01,091882,Touri; Behrouz,19,0,70,51
1657377657960,ECE 180,A00,083140,Abi Samra; Nicholas Camill,1,0,30,29
1657377657960,ECE 180,B00,083141,Abi Samra; Nicholas Camill,0,0,30,30
1657377663994,MATH 10A,A01,083735,Patchell; Gregory David,2,0,30,28
1657377663994,MATH 10A,A02,083736,Patchell; Gregory David,20,0,30,10
1657377663994,MATH 10A,A03,083737,Patchell; Gregory David,16,0,30,14
1657377670022,MATH 10B,A01,083207,Lim; Seonhee,8,0,34,26
1657377670022,MATH 10B,A02,083208,Lim; Seonhee,9,0,35,26
1657377670022,MATH 10B,A03,093472,Lim; Seonhee,7,0,34,27
1657377670022,MATH 10B,B01,083739,Sinha; Shubham,12,0,30,18
1657377676051,MATH 18,A01,083743,Cinel; Cameron Alexander,7,0,30,23
1657377676051,MATH 18,A02,083744,Cinel; Cameron Alexander,17,0,30,13
1657377676051,MATH 18,A03,083745,Cinel; Cameron Alexander,9,0,30,21
1657377676051,MATH 18,B01,083748,Rideout; David Porter,5,0,37,32
1657377676051,MATH 18,B02,083749,Rideout; David Porter,5,0,36,31
1657377676051,MATH 18,B03,083750,Rideout; David Porter,3,0,37,34
1657377676051,MATH 18,B04,083751,Rideout; David Porter,6,0,36,30
1657377676051,MATH 18,B05,093473,Rideout; David Porter,6,0,36,30
1657377676051,MATH 18,B06,093474,Rideout; David Porter,6,0,36,30
1657377682077,MATH 20A,A01,083754,Zheng; Zequn,14,0,40,26
1657377688112,MATH 20B,A01,083756,Briones; Jor-el Thomas Caparas,4,0,36,32
1657377688112,MATH 20B,A02,083757,Briones; Jor-el Thomas Caparas,1,0,36,35
1657377688112,MATH 20B,A03,093475,Briones; Jor-el Thomas Caparas,2,0,36,34
1657377694138,MATH 20C,A01,083760,Briones; Jor-el Thomas Caparas,1,0,35,34
1657377694138,MATH 20C,A02,083761,Briones; Jor-el Thomas Caparas,8,0,35,27
1657377694138,MATH 20C,A03,093476,Briones; Jor-el Thomas Caparas,0,1,36,36
1657377694138,MATH 20C,B01,083762,Bach; Quang Tran,1,0,30,29
1657377700168,MATH 20D,A01,083765,Tran; Brian Kha,5,0,30,25
1657377700168,MATH 20D,A02,083766,Tran; Brian Kha,5,0,30,25
1657377700168,MATH 20D,A03,083767,Tran; Brian Kha,5,0,30,25
1657377706206,MATH 20E,A01,083771,Ganguly; Soumya,9,0,32,23
1657377706206,MATH 20E,A02,083772,Ganguly; Soumya,6,0,32,26
1657377706206,MATH 20E,B01,083773,Ciotti; Benjamin,20,0,35,15
1657377706206,MATH 20E,B02,083774,Ciotti; Benjamin,17,0,35,18
1657377712231,MATH 103A,A01,083777,Greenfeld; Be'Eri,3,0,36,33
1657377712231,MATH 103A,A02,083778,Greenfeld; Be'Eri,5,0,36,31
1657377712231,MATH 103A,A03,093561,Greenfeld; Be'Eri,5,0,36,31
1657377712231,MATH 103A,B01,083779,Greenfeld; Be'Eri,7,0,36,29
1657377712231,MATH 103A,B02,083780,Greenfeld; Be'Eri,4,0,36,32
1657377712231,MATH 103A,B03,093562,Greenfeld; Be'Eri,3,0,36,33
1657377718256,MATH 105,A01,085443,Carter; Anne Toulson,15,0,35,20
1657377718256,MATH 105,A02,093477,Carter; Anne Toulson,20,0,35,15
1657377724282,MATH 109,A01,083213,Ganzberger; Geoffrey Michael,2,0,34,32
1657377724282,MATH 109,A02,083214,Ganzberger; Geoffrey Michael,4,0,34,30
1657377724282,MATH 109,A03,093478,Ganzberger; Geoffrey Michael,2,0,34,32
1657377724282,MATH 109,B01,083215,Ganzberger; Geoffrey Michael,1,0,32,31
1657377724282,MATH 109,B02,083216,Ganzberger; Geoffrey Michael,2,0,32,30
1657377724282,MATH 109,B03,093479,Ganzberger; Geoffrey Michael,8,0,32,24
1657377730413,MATH 142A,A01,083219,Chow; Bennett,7,0,32,25
1657377730413,MATH 142A,A02,083220,Chow; Bennett,10,0,32,22
1657377730413,MATH 142A,A03,093480,Chow; Bennett,8,0,32,24
1657377730413,MATH 142A,B03,093481,Chow; Bennett,8,0,32,24
1657377730413,MATH 142A,B04,093558,Chow; Bennett,13,0,32,19
1657377730413,MATH 142A,B05,093559,Chow; Bennett,6,0,32,26
1657377736444,MATH 193A,A01,083224,Rotar; Vladimir,8,0,34,26
1657377736444,MATH 193A,A02,083225,Rotar; Vladimir,9,0,34,25
1657377736444,MATH 193A,A03,083781,Rotar; Vladimir,5,0,34,29
1657377736444,MATH 193A,A04,083782,Rotar; Vladimir,10,0,34,24
1657377736444,MATH 193A,A05,093482,Rotar; Vladimir,10,0,34,24
1657377742476,MATH 197,001,091859,McAuley; Julian John,9999,0,9999,0
1657377742476,MATH 197,002,095566,Kedlaya; Kiran S.,9997,0,9999,2
1657377742476,MATH 197,003,095567,Xiao; Ming,9999,0,9999,0
1657377742476,MATH 197,004,095571,Perols; Johan Lars,9998,0,9999,1
1657377749557,COGS 9,A01,083615,Shannon; Kyle Michael,9,0,75,66
1657377755583,COGS 11,A01,083617,Boyle; Mary E. T.,22,0,48,26
1657377761682,COGS 13,A01,083071,Bastos; Amalia Pinkusfeld,11,0,71,60
1657377767723,COGS 14A,A01,092681,Semenuks; Arturs,4,1,100,96
1657377773755,COGS 14B,A01,083073,Cheng; Tzu-Han,6,0,63,57
1657377779787,COGS 17,A01,092677,Semenuks; Arturs,6,0,81,75
1657377785813,COGS 100,A01,083619,Allen; Michael Gordon,17,0,70,53
1657377791838,COGS 101A,A01,083621,Davis; Joshua Daniel,9,0,68,59
1657377797872,COGS 101B,A01,091572,Allen; Michael Gordon,11,0,65,54
1657377803902,COGS 101C,A01,083625,Delgado; Tania,17,0,35,18
1657377809931,COGS 107A,A01,083627,Boyle; Mary E. T.,13,0,60,47
1657377815956,COGS 118A,A01,083075,Gupta; Anjum,20,0,76,56
1657377821983,CSE 3,A50,083646,Miranda; Gregory Joseph,24,0,50,26
1657377828015,CSE 8A,A50,083650,Miranda; Gregory Joseph,17,1,56,39
1657377834042,CSE 11,A01,083080,Cao; Yingjun,6,15,40,34
1657377840073,CSE 12,A01,083652,Krause-Levy; Sophia Louisa,28,1,120,92
1657377846099,CSE 15L,A01,083654,Morris; Justin Loren,9,0,50,41
1657377846099,CSE 15L,A02,083655,Morris; Justin Loren,9,0,50,41
1657377852124,CSE 20,A01,083657,Tran; Khoa Dang,39,0,80,41
1657377858156,CSE 21,A01,095574,Bach; Quang Tran,22,0,48,26
1657377864194,CSE 30,A01,083084,Eldon; John,4,0,80,76
1657377864194,CSE 30,B01,095061,Bhaskar; Nishant,9,0,50,41
1657377870228,CSE 100,A01,083659,Cao; Yingjun,5,4,70,65
1657377876253,CSE 134B,A01,083661,Powell; Thomas Allan,22,0,100,78
1657377882281,CSE 140,A01,083663,Gungor; Onat,14,0,85,71
1657377888310,CSE 140L,A01,083088,Eldon; John,21,0,100,79
1657377894342,CSE 175,A01,083665,Kumar; Rakesh,3,0,25,22
1657377900371,CSE 190,A00,092507,Dubnov; Shlomo,7,0,20,13
1657377906402,ECE 45,A01,083139,Congero; Spencer William,6,0,75,69
1657377912428,ECE 65,A50,083695,Saad; Andrew S,12,0,30,18
1657377912428,ECE 65,A51,095125,Saad; Andrew S,24,0,26,2
1657377918455,ECE 109,A01,091882,Touri; Behrouz,19,0,70,51
1657377924484,ECE 180,A00,083140,Abi Samra; Nicholas Camill,1,0,30,29
1657377924484,ECE 180,B00,083141,Abi Samra; Nicholas Camill,0,0,30,30
1657377930512,MATH 10A,A01,083735,Patchell; Gregory David,2,0,30,28
1657377930512,MATH 10A,A02,083736,Patchell; Gregory David,20,0,30,10
1657377930512,MATH 10A,A03,083737,Patchell; Gregory David,16,0,30,14
1657377936541,MATH 10B,A01,083207,Lim; Seonhee,8,0,34,26
1657377936541,MATH 10B,A02,083208,Lim; Seonhee,9,0,35,26
1657377936541,MATH 10B,A03,093472,Lim; Seonhee,7,0,34,27
1657377936541,MATH 10B,B01,083739,Sinha; Shubham,12,0,30,18
1657377942568,MATH 18,A01,083743,Cinel; Cameron Alexander,7,0,30,23
1657377942568,MATH 18,A02,083744,Cinel; Cameron Alexander,17,0,30,13
1657377942568,MATH 18,A03,083745,Cinel; Cameron Alexander,9,0,30,21
1657377942568,MATH 18,B01,083748,Rideout; David Porter,5,0,37,32
1657377942568,MATH 18,B02,083749,Rideout; David Porter,5,0,36,31
1657377942568,MATH 18,B03,083750,Rideout; David Porter,3,0,37,34
1657377942568,MATH 18,B04,083751,Rideout; David Porter,6,0,36,30
1657377942568,MATH 18,B05,093473,Rideout; David Porter,6,0,36,30
1657377942568,MATH 18,B06,093474,Rideout; David Porter,6,0,36,30
1657377948598,MATH 20A,A01,083754,Zheng; Zequn,14,0,40,26
1657377954625,MATH 20B,A01,083756,Briones; Jor-el Thomas Caparas,4,0,36,32
1657377954625,MATH 20B,A02,083757,Briones; Jor-el Thomas Caparas,1,0,36,35
1657377954625,MATH 20B,A03,093475,Briones; Jor-el Thomas Caparas,2,0,36,34
1657377960649,MATH 20C,A01,083760,Briones; Jor-el Thomas Caparas,1,0,35,34
1657377960649,MATH 20C,A02,083761,Briones; Jor-el Thomas Caparas,8,0,35,27
1657377960649,MATH 20C,A03,093476,Briones; Jor-el Thomas Caparas,0,1,36,36
1657377960649,MATH 20C,B01,083762,Bach; Quang Tran,1,0,30,29
1657377966707,MATH 20D,A01,083765,Tran; Brian Kha,5,0,30,25
1657377966707,MATH 20D,A02,083766,Tran; Brian Kha,5,0,30,25
1657377966707,MATH 20D,A03,083767,Tran; Brian Kha,5,0,30,25
1657377972743,MATH 20E,A01,083771,Ganguly; Soumya,9,0,32,23
1657377972743,MATH 20E,A02,083772,Ganguly; Soumya,6,0,32,26
1657377972743,MATH 20E,B01,083773,Ciotti; Benjamin,20,0,35,15
1657377972743,MATH 20E,B02,083774,Ciotti; Benjamin,17,0,35,18
1657377978786,MATH 103A,A01,083777,Greenfeld; Be'Eri,3,0,36,33
1657377978786,MATH 103A,A02,083778,Greenfeld; Be'Eri,5,0,36,31
1657377978786,MATH 103A,A03,093561,Greenfeld; Be'Eri,5,0,36,31
1657377978786,MATH 103A,B01,083779,Greenfeld; Be'Eri,7,0,36,29
1657377978786,MATH 103A,B02,083780,Greenfeld; Be'Eri,4,0,36,32
1657377978786,MATH 103A,B03,093562,Greenfeld; Be'Eri,3,0,36,33
1657377984817,MATH 105,A01,085443,Carter; Anne Toulson,15,0,35,20
1657377984817,MATH 105,A02,093477,Carter; Anne Toulson,20,0,35,15
1657377990848,MATH 109,A01,083213,Ganzberger; Geoffrey Michael,2,0,34,32
1657377990848,MATH 109,A02,083214,Ganzberger; Geoffrey Michael,4,0,34,30
1657377990848,MATH 109,A03,093478,Ganzberger; Geoffrey Michael,2,0,34,32
1657377990848,MATH 109,B01,083215,Ganzberger; Geoffrey Michael,1,0,32,31
1657377990848,MATH 109,B02,083216,Ganzberger; Geoffrey Michael,2,0,32,30
1657377990848,MATH 109,B03,093479,Ganzberger; Geoffrey Michael,8,0,32,24
1657377996879,MATH 142A,A01,083219,Chow; Bennett,7,0,32,25
1657377996879,MATH 142A,A02,083220,Chow; Bennett,10,0,32,22
1657377996879,MATH 142A,A03,093480,Chow; Bennett,8,0,32,24
1657377996879,MATH 142A,B03,093481,Chow; Bennett,8,0,32,24
1657377996879,MATH 142A,B04,093558,Chow; Bennett,13,0,32,19
1657377996879,MATH 142A,B05,093559,Chow; Bennett,6,0,32,26
1657378002905,MATH 193A,A01,083224,Rotar; Vladimir,8,0,34,26
1657378002905,MATH 193A,A02,083225,Rotar; Vladimir,9,0,34,25
1657378002905,MATH 193A,A03,083781,Rotar; Vladimir,5,0,34,29
1657378002905,MATH 193A,A04,083782,Rotar; Vladimir,10,0,34,24
1657378002905,MATH 193A,A05,093482,Rotar; Vladimir,10,0,34,24
1657378008930,MATH 197,001,091859,McAuley; Julian John,9999,0,9999,0
1657378008930,MATH 197,002,095566,Kedlaya; Kiran S.,9997,0,9999,2
1657378008930,MATH 197,003,095567,Xiao; Ming,9999,0,9999,0
1657378008930,MATH 197,004,095571,Perols; Johan Lars,9998,0,9999,1
1657378016007,COGS 9,A01,083615,Shannon; Kyle Michael,9,0,75,66
1657378022031,COGS 11,A01,083617,Boyle; Mary E. T.,22,0,48,26
1657378028058,COGS 13,A01,083071,Bastos; Amalia Pinkusfeld,11,0,71,60
1657378034083,COGS 14A,A01,092681,Semenuks; Arturs,4,1,100,96
1657378040107,COGS 14B,A01,083073,Cheng; Tzu-Han,6,0,63,57
1657378046133,COGS 17,A01,092677,Semenuks; Arturs,6,0,81,75
1657378052174,COGS 100,A01,083619,Allen; Michael Gordon,17,0,70,53
1657378058201,COGS 101A,A01,083621,Davis; Joshua Daniel,9,0,68,59
1657378064227,COGS 101B,A01,091572,Allen; Michael Gordon,11,0,65,54
1657378070255,COGS 101C,A01,083625,Delgado; Tania,17,0,35,18
1657378076280,COGS 107A,A01,083627,Boyle; Mary E. T.,13,0,60,47
1657378082317,COGS 118A,A01,083075,Gupta; Anjum,20,0,76,56
1657378088343,CSE 3,A50,083646,Miranda; Gregory Joseph,24,0,50,26
1657378094386,CSE 8A,A50,083650,Miranda; Gregory Joseph,17,1,56,39
1657378100412,CSE 11,A01,083080,Cao; Yingjun,6,15,40,34
1657378106438,CSE 12,A01,083652,Krause-Levy; Sophia Louisa,28,1,120,92
1657378112470,CSE 15L,A01,083654,Morris; Justin Loren,9,0,50,41
1657378112470,CSE 15L,A02,083655,Morris; Justin Loren,9,0,50,41
1657378118505,CSE 20,A01,083657,Tran; Khoa Dang,39,0,80,41
1657378124532,CSE 21,A01,095574,Bach; Quang Tran,22,0,48,26
1657378130561,CSE 30,A01,083084,Eldon; John,4,0,80,76
1657378130561,CSE 30,B01,095061,Bhaskar; Nishant,9,0,50,41
1657378136587,CSE 100,A01,083659,Cao; Yingjun,5,4,70,65
1657378142614,CSE 134B,A01,083661,Powell; Thomas Allan,22,0,100,78
1657378148652,CSE 140,A01,083663,Gungor; Onat,14,0,85,71
1657378154682,CSE 140L,A01,083088,Eldon; John,21,0,100,79
1657378160709,CSE 175,A01,083665,Kumar; Rakesh,3,0,25,22
1657378166741,CSE 190,A00,092507,Dubnov; Shlomo,7,0,20,13
1657378172776,ECE 45,A01,083139,Congero; Spencer William,6,0,75,69
1657378178814,ECE 65,A50,083695,Saad; Andrew S,12,0,30,18
1657378178814,ECE 65,A51,095125,Saad; Andrew S,24,0,26,2
1657378184841,ECE 109,A01,091882,Touri; Behrouz,19,0,70,51
1657378190875,ECE 180,A00,083140,Abi Samra; Nicholas Camill,1,0,30,29
1657378190875,ECE 180,B00,083141,Abi Samra; Nicholas Camill,0,0,30,30
1657378196913,MATH 10A,A01,083735,Patchell; Gregory David,2,0,30,28
1657378196913,MATH 10A,A02,083736,Patchell; Gregory David,20,0,30,10
1657378196913,MATH 10A,A03,083737,Patchell; Gregory David,16,0,30,14
1657378202946,MATH 10B,A01,083207,Lim; Seonhee,8,0,34,26
1657378202946,MATH 10B,A02,083208,Lim; Seonhee,9,0,35,26
1657378202946,MATH 10B,A03,093472,Lim; Seonhee,7,0,34,27
1657378202946,MATH 10B,B01,083739,Sinha; Shubham,12,0,30,18
1657378208977,MATH 18,A01,083743,Cinel; Cameron Alexander,7,0,30,23
1657378208977,MATH 18,A02,083744,Cinel; Cameron Alexander,17,0,30,13
1657378208977,MATH 18,A03,083745,Cinel; Cameron Alexander,9,0,30,21
1657378208977,MATH 18,B01,083748,Rideout; David Porter,5,0,37,32
1657378208977,MATH 18,B02,083749,Rideout; David Porter,5,0,36,31
1657378208977,MATH 18,B03,083750,Rideout; David Porter,3,0,37,34
1657378208977,MATH 18,B04,083751,Rideout; David Porter,6,0,36,30
1657378208977,MATH 18,B05,093473,Rideout; David Porter,6,0,36,30
1657378208977,MATH 18,B06,093474,Rideout; David Porter,6,0,36,30
1657378215003,MATH 20A,A01,083754,Zheng; Zequn,14,0,40,26
1657378221032,MATH 20B,A01,083756,Briones; Jor-el Thomas Caparas,4,0,36,32
1657378221032,MATH 20B,A02,083757,Briones; Jor-el Thomas Caparas,1,0,36,35
1657378221032,MATH 20B,A03,093475,Briones; Jor-el Thomas Caparas,2,0,36,34
1657378227058,MATH 20C,A01,083760,Briones; Jor-el Thomas Caparas,1,0,35,34
1657378227058,MATH 20C,A02,083761,Briones; Jor-el Thomas Caparas,8,0,35,27
1657378227058,MATH 20C,A03,093476,Briones; Jor-el Thomas Caparas,0,1,36,36
1657378227058,MATH 20C,B01,083762,Bach; Quang Tran,1,0,30,29
1657378233093,MATH 20D,A01,083765,Tran; Brian Kha,5,0,30,25
1657378233093,MATH 20D,A02,083766,Tran; Brian Kha,5,0,30,25
1657378233093,MATH 20D,A03,083767,Tran; Brian Kha,5,0,30,25
1657378239128,MATH 20E,A01,083771,Ganguly; Soumya,9,0,32,23
1657378239128,MATH 20E,A02,083772,Ganguly; Soumya,6,0,32,26
1657378239128,MATH 20E,B01,083773,Ciotti; Benjamin,20,0,35,15
1657378239128,MATH 20E,B02,083774,Ciotti; Benjamin,17,0,35,18
1657378245155,MATH 103A,A01,083777,Greenfeld; Be'Eri,3,0,36,33
1657378245155,MATH 103A,A02,083778,Greenfeld; Be'Eri,5,0,36,31
1657378245155,MATH 103A,A03,093561,Greenfeld; Be'Eri,5,0,36,31
1657378245155,MATH 103A,B01,083779,Greenfeld; Be'Eri,7,0,36,29
1657378245155,MATH 103A,B02,083780,Greenfeld; Be'Eri,4,0,36,32
1657378245155,MATH 103A,B03,093562,Greenfeld; Be'Eri,3,0,36,33
1657378251182,MATH 105,A01,085443,Carter; Anne Toulson,15,0,35,20
1657378251182,MATH 105,A02,093477,Carter; Anne Toulson,20,0,35,15
1657378257208,MATH 109,A01,083213,Ganzberger; Geoffrey Michael,2,0,34,32
1657378257208,MATH 109,A02,083214,Ganzberger; Geoffrey Michael,4,0,34,30
1657378257208,MATH 109,A03,093478,Ganzberger; Geoffrey Michael,2,0,34,32
1657378257208,MATH 109,B01,083215,Ganzberger; Geoffrey Michael,1,0,32,31
1657378257208,MATH 109,B02,083216,Ganzberger; Geoffrey Michael,2,0,32,30
1657378257208,MATH 109,B03,093479,Ganzberger; Geoffrey Michael,8,0,32,24
1657378263243,MATH 142A,A01,083219,Chow; Bennett,7,0,32,25
1657378263243,MATH 142A,A02,083220,Chow; Bennett,10,0,32,22
1657378263243,MATH 142A,A03,093480,Chow; Bennett,8,0,32,24
1657378263243,MATH 142A,B03,093481,Chow; Bennett,8,0,32,24
1657378263243,MATH 142A,B04,093558,Chow; Bennett,13,0,32,19
1657378263243,MATH 142A,B05,093559,Chow; Bennett,6,0,32,26
1657378269280,MATH 193A,A01,083224,Rotar; Vladimir,8,0,34,26
1657378269280,MATH 193A,A02,083225,Rotar; Vladimir,9,0,34,25
1657378269280,MATH 193A,A03,083781,Rotar; Vladimir,5,0,34,29
1657378269280,MATH 193A,A04,083782,Rotar; Vladimir,10,0,34,24
1657378269280,MATH 193A,A05,093482,Rotar; Vladimir,10,0,34,24
1657378275311,MATH 197,001,091859,McAuley; Julian John,9999,0,9999,0
1657378275311,MATH 197,002,095566,Kedlaya; Kiran S.,9997,0,9999,2
1657378275311,MATH 197,003,095567,Xiao; Ming,9999,0,9999,0
1657378275311,MATH 197,004,095571,Perols; Johan Lars,9998,0,9999,1
1657378282398,COGS 9,A01,083615,Shannon; Kyle Michael,9,0,75,66
1657378288423,COGS 11,A01,083617,Boyle; Mary E. T.,22,0,48,26
1657378294451,COGS 13,A01,083071,Bastos; Amalia Pinkusfeld,11,0,71,60
1657378300480,COGS 14A,A01,092681,Semenuks; Arturs,4,1,100,96
1657378306520,COGS 14B,A01,083073,Cheng; Tzu-Han,6,0,63,57
1657378312543,COGS 17,A01,092677,Semenuks; Arturs,6,0,81,75
1657378318569,COGS 100,A01,083619,Allen; Michael Gordon,17,0,70,53
1657378324595,COGS 101A,A01,083621,Davis; Joshua Daniel,9,0,68,59
1657378330624,COGS 101B,A01,091572,Allen; Michael Gordon,11,0,65,54
1657378336656,COGS 101C,A01,083625,Delgado; Tania,17,0,35,18
1657378342680,COGS 107A,A01,083627,Boyle; Mary E. T.,13,0,60,47
1657378348711,COGS 118A,A01,083075,Gupta; Anjum,20,0,76,56
1657378354747,CSE 3,A50,083646,Miranda; Gregory Joseph,24,0,50,26
1657378360845,CSE 8A,A50,083650,Miranda; Gregory Joseph,17,1,56,39
1657378366875,CSE 11,A01,083080,Cao; Yingjun,6,15,40,34
1657378372903,CSE 12,A01,083652,Krause-Levy; Sophia Louisa,28,1,120,92
1657378378930,CSE 15L,A01,083654,Morris; Justin Loren,9,0,50,41
1657378378930,CSE 15L,A02,083655,Morris; Justin Loren,9,0,50,41
1657378384955,CSE 20,A01,083657,Tran; Khoa Dang,39,0,80,41
1657378390988,CSE 21,A01,095574,Bach; Quang Tran,22,0,48,26
1657378397026,CSE 30,A01,083084,Eldon; John,4,0,80,76
1657378397026,CSE 30,B01,095061,Bhaskar; Nishant,9,0,50,41
1657378403051,CSE 100,A01,083659,Cao; Yingjun,5,4,70,65
1657378409095,CSE 134B,A01,083661,Powell; Thomas Allan,22,0,100,78
1657378415137,CSE 140,A01,083663,Gungor; Onat,14,0,85,71
1657378421168,CSE 140L,A01,083088,Eldon; John,21,0,100,79
1657378427197,CSE 175,A01,083665,Kumar; Rakesh,3,0,25,22
1657378433223,CSE 190,A00,092507,Dubnov; Shlomo,7,0,20,13
1657378439265,ECE 45,A01,083139,Congero; Spencer William,6,0,75,69
1657378445300,ECE 65,A50,083695,Saad; Andrew S,12,0,30,18
1657378445300,ECE 65,A51,095125,Saad; Andrew S,24,0,26,2
1657378451330,ECE 109,A01,091882,Touri; Behrouz,19,0,70,51
1657378457361,ECE 180,A00,083140,Abi Samra; Nicholas Camill,1,0,30,29
1657378457361,ECE 180,B00,083141,Abi Samra; Nicholas Camill,0,0,30,30
1657378463398,MATH 10A,A01,083735,Patchell; Gregory David,2,0,30,28
1657378463398,MATH 10A,A02,083736,Patchell; Gregory David,20,0,30,10
1657378463398,MATH 10A,A03,083737,Patchell; Gregory David,16,0,30,14
1657378469438,MATH 10B,A01,083207,Lim; Seonhee,8,0,34,26
1657378469438,MATH 10B,A02,083208,Lim; Seonhee,9,0,35,26
1657378469438,MATH 10B,A03,093472,Lim; Seonhee,7,0,34,27
1657378469438,MATH 10B,B01,083739,Sinha; Shubham,12,0,30,18
1657378475469,MATH 18,A01,083743,Cinel; Cameron Alexander,7,0,30,23
1657378475469,MATH 18,A02,083744,Cinel; Cameron Alexander,17,0,30,13
1657378475469,MATH 18,A03,083745,Cinel; Cameron Alexander,9,0,30,21
1657378475469,MATH 18,B01,083748,Rideout; David Porter,5,0,37,32
1657378475469,MATH 18,B02,083749,Rideout; David Porter,5,0,36,31
1657378475469,MATH 18,B03,083750,Rideout; David Porter,3,0,37,34
1657378475469,MATH 18,B04,083751,Rideout; David Porter,6,0,36,30
1657378475469,MATH 18,B05,093473,Rideout; David Porter,6,0,36,30
1657378475469,MATH 18,B06,093474,Rideout; David Porter,6,0,36,30
1657378481498,MATH 20A,A01,083754,Zheng; Zequn,14,0,40,26
1657378487533,MATH 20B,A01,083756,Briones; Jor-el Thomas Caparas,4,0,36,32
1657378487533,MATH 20B,A02,083757,Briones; Jor-el Thomas Caparas,1,0,36,35
1657378487533,MATH 20B,A03,093475,Briones; Jor-el Thomas Caparas,2,0,36,34
1657378493565,MATH 20C,A01,083760,Briones; Jor-el Thomas Caparas,1,0,35,34
1657378493565,MATH 20C,A02,083761,Briones; Jor-el Thomas Caparas,8,0,35,27
1657378493565,MATH 20C,A03,093476,Briones; Jor-el Thomas Caparas,0,1,36,36
1657378493565,MATH 20C,B01,083762,Bach; Quang Tran,1,0,30,29
1657378499597,MATH 20D,A01,083765,Tran; Brian Kha,5,0,30,25
1657378499597,MATH 20D,A02,083766,Tran; Brian Kha,5,0,30,25
1657378499597,MATH 20D,A03,083767,Tran; Brian Kha,5,0,30,25
1657378505646,MATH 20E,A01,083771,Ganguly; Soumya,9,0,32,23
1657378505646,MATH 20E,A02,083772,Ganguly; Soumya,6,0,32,26
1657378505646,MATH 20E,B01,083773,Ciotti; Benjamin,20,0,35,15
1657378505646,MATH 20E,B02,083774,Ciotti; Benjamin,17,0,35,18
1657378511692,MATH 103A,A01,083777,Greenfeld; Be'Eri,3,0,36,33
1657378511692,MATH 103A,A02,083778,Greenfeld; Be'Eri,5,0,36,31
1657378511692,MATH 103A,A03,093561,Greenfeld; Be'Eri,5,0,36,31
1657378511692,MATH 103A,B01,083779,Greenfeld; Be'Eri,7,0,36,29
1657378511692,MATH 103A,B02,083780,Greenfeld; Be'Eri,4,0,36,32
1657378511692,MATH 103A,B03,093562,Greenfeld; Be'Eri,3,0,36,33
1657378517722,MATH 105,A01,085443,Carter; Anne Toulson,15,0,35,20
1657378517722,MATH 105,A02,093477,Carter; Anne Toulson,20,0,35,15
1657378523756,MATH 109,A01,083213,Ganzberger; Geoffrey Michael,2,0,34,32
1657378523756,MATH 109,A02,083214,Ganzberger; Geoffrey Michael,4,0,34,30
1657378523756,MATH 109,A03,093478,Ganzberger; Geoffrey Michael,2,0,34,32
1657378523756,MATH 109,B01,083215,Ganzberger; Geoffrey Michael,1,0,32,31
1657378523756,MATH 109,B02,083216,Ganzberger; Geoffrey Michael,2,0,32,30
1657378523756,MATH 109,B03,093479,Ganzberger; Geoffrey Michael,8,0,32,24
1657378529792,MATH 142A,A01,083219,Chow; Bennett,7,0,32,25
1657378529792,MATH 142A,A02,083220,Chow; Bennett,10,0,32,22
1657378529792,MATH 142A,A03,093480,Chow; Bennett,8,0,32,24
1657378529792,MATH 142A,B03,093481,Chow; Bennett,8,0,32,24
1657378529792,MATH 142A,B04,093558,Chow; Bennett,13,0,32,19
1657378529792,MATH 142A,B05,093559,Chow; Bennett,6,0,32,26
1657378535826,MATH 193A,A01,083224,Rotar; Vladimir,8,0,34,26
1657378535826,MATH 193A,A02,083225,Rotar; Vladimir,9,0,34,25
1657378535826,MATH 193A,A03,083781,Rotar; Vladimir,5,0,34,29
1657378535826,MATH 193A,A04,083782,Rotar; Vladimir,10,0,34,24
1657378535826,MATH 193A,A05,093482,Rotar; Vladimir,10,0,34,24
1657378541861,MATH 197,001,091859,McAuley; Julian John,9999,0,9999,0
1657378541861,MATH 197,002,095566,Kedlaya; Kiran S.,9997,0,9999,2
1657378541861,MATH 197,003,095567,Xiao; Ming,9999,0,9999,0
1657378541861,MATH 197,004,095571,Perols; Johan Lars,9998,0,9999,1
1657378548942,COGS 9,A01,083615,Shannon; Kyle Michael,9,0,75,66
1657378554965,COGS 11,A01,083617,Boyle; Mary E. T.,22,0,48,26
1657378560991,COGS 13,A01,083071,Bastos; Amalia Pinkusfeld,11,0,71,60
1657378567017,COGS 14A,A01,092681,Semenuks; Arturs,4,1,100,96
1657378573052,COGS 14B,A01,083073,Cheng; Tzu-Han,6,0,63,57
1657378579082,COGS 17,A01,092677,Semenuks; Arturs,6,0,81,75
1657378585127,COGS 100,A01,083619,Allen; Michael Gordon,17,0,70,53
1657378591158,COGS 101A,A01,083621,Davis; Joshua Daniel,9,0,68,59
1657378597183,COGS 101B,A01,091572,Allen; Michael Gordon,11,0,65,54
1657378603212,COGS 101C,A01,083625,Delgado; Tania,17,0,35,18
1657378609248,COGS 107A,A01,083627,Boyle; Mary E. T.,13,0,60,47
1657378615278,COGS 118A,A01,083075,Gupta; Anjum,20,0,76,56
1657378621314,CSE 3,A50,083646,Miranda; Gregory Joseph,24,0,50,26
1657378627341,CSE 8A,A50,083650,Miranda; Gregory Joseph,17,1,56,39
1657378633369,CSE 11,A01,083080,Cao; Yingjun,6,15,40,34
1657378639401,CSE 12,A01,083652,Krause-Levy; Sophia Louisa,28,1,120,92
1657378645436,CSE 15L,A01,083654,Morris; Justin Loren,9,0,50,41
1657378645436,CSE 15L,A02,083655,Morris; Justin Loren,9,0,50,41
1657378651469,CSE 20,A01,083657,Tran; Khoa Dang,39,0,80,41
1657378657496,CSE 21,A01,095574,Bach; Quang Tran,22,0,48,26
1657378663537,CSE 30,A01,083084,Eldon; John,4,0,80,76
1657378663537,CSE 30,B01,095061,Bhaskar; Nishant,9,0,50,41
1657378669567,CSE 100,A01,083659,Cao; Yingjun,5,4,70,65
1657378675593,CSE 134B,A01,083661,Powell; Thomas Allan,22,0,100,78
1657378681624,CSE 140,A01,083663,Gungor; Onat,14,0,85,71
1657378687651,CSE 140L,A01,083088,Eldon; John,21,0,100,79
1657378693688,CSE 175,A01,083665,Kumar; Rakesh,3,0,25,22
1657378699725,CSE 190,A00,092507,Dubnov; Shlomo,7,0,20,13
1657378705759,ECE 45,A01,083139,Congero; Spencer William,6,0,75,69
1657378711784,ECE 65,A50,083695,Saad; Andrew S,12,0,30,18
1657378711784,ECE 65,A51,095125,Saad; Andrew S,24,0,26,2
1657378717811,ECE 109,A01,091882,Touri; Behrouz,19,0,70,51
1657378723842,ECE 180,A00,083140,Abi Samra; Nicholas Camill,1,0,30,29
1657378723842,ECE 180,B00,083141,Abi Samra; Nicholas Camill,0,0,30,30
1657378729875,MATH 10A,A01,083735,Patchell; Gregory David,2,0,30,28
1657378729875,MATH 10A,A02,083736,Patchell; Gregory David,20,0,30,10
1657378729875,MATH 10A,A03,083737,Patchell; Gregory David,16,0,30,14
1657378735939,MATH 10B,A01,083207,Lim; Seonhee,8,0,34,26
1657378735939,MATH 10B,A02,083208,Lim; Seonhee,9,0,35,26
1657378735939,MATH 10B,A03,093472,Lim; Seonhee,7,0,34,27
1657378735939,MATH 10B,B01,083739,Sinha; Shubham,12,0,30,18
1657378741977,MATH 18,A01,083743,Cinel; Cameron Alexander,7,0,30,23
1657378741977,MATH 18,A02,083744,Cinel; Cameron Alexander,17,0,30,13
1657378741977,MATH 18,A03,083745,Cinel; Cameron Alexander,9,0,30,21
1657378741977,MATH 18,B01,083748,Rideout; David Porter,5,0,37,32
1657378741977,MATH 18,B02,083749,Rideout; David Porter,5,0,36,31
1657378741977,MATH 18,B03,083750,Rideout; David Porter,3,0,37,34
1657378741977,MATH 18,B04,083751,Rideout; David Porter,6,0,36,30
1657378741977,MATH 18,B05,093473,Rideout; David Porter,6,0,36,30
1657378741977,MATH 18,B06,093474,Rideout; David Porter,6,0,36,30
1657378748003,MATH 20A,A01,083754,Zheng; Zequn,14,0,40,26
1657378754030,MATH 20B,A01,083756,Briones; Jor-el Thomas Caparas,4,0,36,32
1657378754030,MATH 20B,A02,083757,Briones; Jor-el Thomas Caparas,1,0,36,35
1657378754030,MATH 20B,A03,093475,Briones; Jor-el Thomas Caparas,2,0,36,34
1657378760061,MATH 20C,A01,083760,Briones; Jor-el Thomas Caparas,1,0,35,34
1657378760061,MATH 20C,A02,083761,Briones; Jor-el Thomas Caparas,8,0,35,27
1657378760061,MATH 20C,A03,093476,Briones; Jor-el Thomas Caparas,0,1,36,36
1657378760061,MATH 20C,B01,083762,Bach; Quang Tran,1,0,30,29
1657378766086,MATH 20D,A01,083765,Tran; Brian Kha,5,0,30,25
1657378766086,MATH 20D,A02,083766,Tran; Brian Kha,5,0,30,25
1657378766086,MATH 20D,A03,083767,Tran; Brian Kha,5,0,30,25
1657378772114,MATH 20E,A01,083771,Ganguly; Soumya,9,0,32,23
1657378772114,MATH 20E,A02,083772,Ganguly; Soumya,6,0,32,26
1657378772114,MATH 20E,B01,083773,Ciotti; Benjamin,20,0,35,15
1657378772114,MATH 20E,B02,083774,Ciotti; Benjamin,17,0,35,18
1657378778142,MATH 103A,A01,083777,Greenfeld; Be'Eri,3,0,36,33
1657378778142,MATH 103A,A02,083778,Greenfeld; Be'Eri,5,0,36,31
1657378778142,MATH 103A,A03,093561,Greenfeld; Be'Eri,5,0,36,31
1657378778142,MATH 103A,B01,083779,Greenfeld; Be'Eri,7,0,36,29
1657378778142,MATH 103A,B02,083780,Greenfeld; Be'Eri,4,0,36,32
1657378778142,MATH 103A,B03,093562,Greenfeld; Be'Eri,3,0,36,33
1657378784169,MATH 105,A01,085443,Carter; Anne Toulson,15,0,35,20
1657378784169,MATH 105,A02,093477,Carter; Anne Toulson,20,0,35,15
1657378790202,MATH 109,A01,083213,Ganzberger; Geoffrey Michael,2,0,34,32
1657378790202,MATH 109,A02,083214,Ganzberger; Geoffrey Michael,4,0,34,30
1657378790202,MATH 109,A03,093478,Ganzberger; Geoffrey Michael,2,0,34,32
1657378790202,MATH 109,B01,083215,Ganzberger; Geoffrey Michael,1,0,32,31
1657378790202,MATH 109,B02,083216,Ganzberger; Geoffrey Michael,2,0,32,30
1657378790202,MATH 109,B03,093479,Ganzberger; Geoffrey Michael,8,0,32,24
1657378796231,MATH 142A,A01,083219,Chow; Bennett,7,0,32,25
1657378796231,MATH 142A,A02,083220,Chow; Bennett,10,0,32,22
1657378796231,MATH 142A,A03,093480,Chow; Bennett,8,0,32,24
1657378796231,MATH 142A,B03,093481,Chow; Bennett,8,0,32,24
1657378796231,MATH 142A,B04,093558,Chow; Bennett,13,0,32,19
1657378796231,MATH 142A,B05,093559,Chow; Bennett,6,0,32,26
1657378802258,MATH 193A,A01,083224,Rotar; Vladimir,8,0,34,26
1657378802258,MATH 193A,A02,083225,Rotar; Vladimir,9,0,34,25
1657378802258,MATH 193A,A03,083781,Rotar; Vladimir,5,0,34,29
1657378802258,MATH 193A,A04,083782,Rotar; Vladimir,10,0,34,24
1657378802258,MATH 193A,A05,093482,Rotar; Vladimir,10,0,34,24
1657378808291,MATH 197,001,091859,McAuley; Julian John,9999,0,9999,0
1657378808291,MATH 197,002,095566,Kedlaya; Kiran S.,9997,0,9999,2
1657378808291,MATH 197,003,095567,Xiao; Ming,9999,0,9999,0
1657378808291,MATH 197,004,095571,Perols; Johan Lars,9998,0,9999,1
1657378815357,COGS 9,A01,083615,Shannon; Kyle Michael,9,0,75,66
1657378821388,COGS 11,A01,083617,Boyle; Mary E. T.,22,0,48,26
1657378827421,COGS 13,A01,083071,Bastos; Amalia Pinkusfeld,11,0,71,60
1657378833447,COGS 14A,A01,092681,Semenuks; Arturs,4,1,100,96
1657378839477,COGS 14B,A01,083073,Cheng; Tzu-Han,6,0,63,57
1657378845509,COGS 17,A01,092677,Semenuks; Arturs,6,0,81,75
1657378851545,COGS 100,A01,083619,Allen; Michael Gordon,17,0,70,53
1657378857575,COGS 101A,A01,083621,Davis; Joshua Daniel,9,0,68,59
1657378863609,COGS 101B,A01,091572,Allen; Michael Gordon,11,0,65,54
1657378869640,COGS 101C,A01,083625,Delgado; Tania,17,0,35,18
1657378875663,COGS 107A,A01,083627,Boyle; Mary E. T.,13,0,60,47
1657378881688,COGS 118A,A01,083075,Gupta; Anjum,20,0,76,56
1657378887724,CSE 3,A50,083646,Miranda; Gregory Joseph,24,0,50,26
1657378893750,CSE 8A,A50,083650,Miranda; Gregory Joseph,17,1,56,39
1657378899778,CSE 11,A01,083080,Cao; Yingjun,6,15,40,34
1657378905802,CSE 12,A01,083652,Krause-Levy; Sophia Louisa,28,1,120,92
1657378911839,CSE 15L,A01,083654,Morris; Justin Loren,9,0,50,41
1657378911839,CSE 15L,A02,083655,Morris; Justin Loren,9,0,50,41
1657378917880,CSE 20,A01,083657,Tran; Khoa Dang,39,0,80,41
1657378923914,CSE 21,A01,095574,Bach; Quang Tran,22,0,48,26
1657378929941,CSE 30,A01,083084,Eldon; John,4,0,80,76
1657378929941,CSE 30,B01,095061,Bhaskar; Nishant,9,0,50,41
1657378935970,CSE 100,A01,083659,Cao; Yingjun,5,4,70,65
1657378942007,CSE 134B,A01,083661,Powell; Thomas Allan,22,0,100,78
1657378948038,CSE 140,A01,083663,Gungor; Onat,14,0,85,71
1657378954074,CSE 140L,A01,083088,Eldon; John,21,0,100,79
1657378960195,CSE 175,A01,083665,Kumar; Rakesh,3,0,25,22
1657378966227,CSE 190,A00,092507,Dubnov; Shlomo,7,0,20,13
1657378972255,ECE 45,A01,083139,Congero; Spencer William,6,0,75,69
1657378978289,ECE 65,A50,083695,Saad; Andrew S,12,0,30,18
1657378978289,ECE 65,A51,095125,Saad; Andrew S,24,0,26,2
1657378984315,ECE 109,A01,091882,Touri; Behrouz,19,0,70,51
1657378990346,ECE 180,A00,083140,Abi Samra; Nicholas Camill,1,0,30,29
1657378990346,ECE 180,B00,083141,Abi Samra; Nicholas Camill,0,0,30,30
1657378996379,MATH 10A,A01,083735,Patchell; Gregory David,2,0,30,28
1657378996379,MATH 10A,A02,083736,Patchell; Gregory David,20,0,30,10
1657378996379,MATH 10A,A03,083737,Patchell; Gregory David,16,0,30,14
1657379002414,MATH 10B,A01,083207,Lim; Seonhee,8,0,34,26
1657379002414,MATH 10B,A02,083208,Lim; Seonhee,9,0,35,26
1657379002414,MATH 10B,A03,093472,Lim; Seonhee,7,0,34,27
1657379002414,MATH 10B,B01,083739,Sinha; Shubham,12,0,30,18
1657379008462,MATH 18,A01,083743,Cinel; Cameron Alexander,7,0,30,23
1657379008462,MATH 18,A02,083744,Cinel; Cameron Alexander,17,0,30,13
1657379008462,MATH 18,A03,083745,Cinel; Cameron Alexander,9,0,30,21
1657379008462,MATH 18,B01,083748,Rideout; David Porter,5,0,37,32
1657379008462,MATH 18,B02,083749,Rideout; David Porter,5,0,36,31
1657379008462,MATH 18,B03,083750,Rideout; David Porter,3,0,37,34
1657379008462,MATH 18,B04,083751,Rideout; David Porter,6,0,36,30
1657379008462,MATH 18,B05,093473,Rideout; David Porter,6,0,36,30
1657379008462,MATH 18,B06,093474,Rideout; David Porter,6,0,36,30
1657379014490,MATH 20A,A01,083754,Zheng; Zequn,14,0,40,26
1657379020518,MATH 20B,A01,083756,Briones; Jor-el Thomas Caparas,4,0,36,32
1657379020518,MATH 20B,A02,083757,Briones; Jor-el Thomas Caparas,1,0,36,35
1657379020518,MATH 20B,A03,093475,Briones; Jor-el Thomas Caparas,2,0,36,34
1657379026551,MATH 20C,A01,083760,Briones; Jor-el Thomas Caparas,1,0,35,34
1657379026551,MATH 20C,A02,083761,Briones; Jor-el Thomas Caparas,8,0,35,27
1657379026551,MATH 20C,A03,093476,Briones; Jor-el Thomas Caparas,0,1,36,36
1657379026551,MATH 20C,B01,083762,Bach; Quang Tran,1,0,30,29
1657379032582,MATH 20D,A01,083765,Tran; Brian Kha,5,0,30,25
1657379032582,MATH 20D,A02,083766,Tran; Brian Kha,5,0,30,25
1657379032582,MATH 20D,A03,083767,Tran; Brian Kha,5,0,30,25
1657379038608,MATH 20E,A01,083771,Ganguly; Soumya,9,0,32,23
1657379038608,MATH 20E,A02,083772,Ganguly; Soumya,6,0,32,26
1657379038608,MATH 20E,B01,083773,Ciotti; Benjamin,20,0,35,15
1657379038608,MATH 20E,B02,083774,Ciotti; Benjamin,17,0,35,18
1657379044645,MATH 103A,A01,083777,Greenfeld; Be'Eri,3,0,36,33
1657379044645,MATH 103A,A02,083778,Greenfeld; Be'Eri,5,0,36,31
1657379044645,MATH 103A,A03,093561,Greenfeld; Be'Eri,5,0,36,31
1657379044645,MATH 103A,B01,083779,Greenfeld; Be'Eri,7,0,36,29
1657379044645,MATH 103A,B02,083780,Greenfeld; Be'Eri,4,0,36,32
1657379044645,MATH 103A,B03,093562,Greenfeld; Be'Eri,3,0,36,33
1657379050670,MATH 105,A01,085443,Carter; Anne Toulson,15,0,35,20
1657379050670,MATH 105,A02,093477,Carter; Anne Toulson,20,0,35,15
1657379056696,MATH 109,A01,083213,Ganzberger; Geoffrey Michael,2,0,34,32
1657379056696,MATH 109,A02,083214,Ganzberger; Geoffrey Michael,4,0,34,30
1657379056696,MATH 109,A03,093478,Ganzberger; Geoffrey Michael,2,0,34,32
1657379056696,MATH 109,B01,083215,Ganzberger; Geoffrey Michael,1,0,32,31
1657379056696,MATH 109,B02,083216,Ganzberger; Geoffrey Michael,2,0,32,30
1657379056696,MATH 109,B03,093479,Ganzberger; Geoffrey Michael,8,0,32,24
1657379062741,MATH 142A,A01,083219,Chow; Bennett,7,0,32,25
1657379062741,MATH 142A,A02,083220,Chow; Bennett,10,0,32,22
1657379062741,MATH 142A,A03,093480,Chow; Bennett,8,0,32,24
1657379062741,MATH 142A,B03,093481,Chow; Bennett,8,0,32,24
1657379062741,MATH 142A,B04,093558,Chow; Bennett,13,0,32,19
1657379062741,MATH 142A,B05,093559,Chow; Bennett,6,0,32,26
1657379068774,MATH 193A,A01,083224,Rotar; Vladimir,8,0,34,26
1657379068774,MATH 193A,A02,083225,Rotar; Vladimir,9,0,34,25
1657379068774,MATH 193A,A03,083781,Rotar; Vladimir,5,0,34,29
1657379068774,MATH 193A,A04,083782,Rotar; Vladimir,10,0,34,24
1657379068774,MATH 193A,A05,093482,Rotar; Vladimir,10,0,34,24
1657379074803,MATH 197,001,091859,McAuley; Julian John,9999,0,9999,0
1657379074803,MATH 197,002,095566,Kedlaya; Kiran S.,9997,0,9999,2
1657379074803,MATH 197,003,095567,Xiao; Ming,9999,0,9999,0
1657379074803,MATH 197,004,095571,Perols; Johan Lars,9998,0,9999,1
1657379081884,COGS 9,A01,083615,Shannon; Kyle Michael,9,0,75,66
1657379087910,COGS 11,A01,083617,Boyle; Mary E. T.,22,0,48,26
1657379093942,COGS 13,A01,083071,Bastos; Amalia Pinkusfeld,11,0,71,60
1657379099973,COGS 14A,A01,092681,Semenuks; Arturs,4,1,100,96
1657379106005,COGS 14B,A01,083073,Cheng; Tzu-Han,6,0,63,57
1657379112040,COGS 17,A01,092677,Semenuks; Arturs,6,0,81,75
1657379118072,COGS 100,A01,083619,Allen; Michael Gordon,17,0,70,53
1657379124101,COGS 101A,A01,083621,Davis; Joshua Daniel,9,0,68,59
1657379130140,COGS 101B,A01,091572,Allen; Michael Gordon,11,0,65,54
1657379136176,COGS 101C,A01,083625,Delgado; Tania,17,0,35,18
1657379142205,COGS 107A,A01,083627,Boyle; Mary E. T.,13,0,60,47
1657379148232,COGS 118A,A01,083075,Gupta; Anjum,20,0,76,56
1657379154263,CSE 3,A50,083646,Miranda; Gregory Joseph,24,0,50,26
1657379160292,CSE 8A,A50,083650,Miranda; Gregory Joseph,17,1,56,39
1657379166320,CSE 11,A01,083080,Cao; Yingjun,6,15,40,34
1657379172352,CSE 12,A01,083652,Krause-Levy; Sophia Louisa,28,1,120,92
1657379178382,CSE 15L,A01,083654,Morris; Justin Loren,9,0,50,41
1657379178382,CSE 15L,A02,083655,Morris; Justin Loren,9,0,50,41
1657379184418,CSE 20,A01,083657,Tran; Khoa Dang,39,0,80,41
1657379190443,CSE 21,A01,095574,Bach; Quang Tran,22,0,48,26
1657379196468,CSE 30,A01,083084,Eldon; John,4,0,80,76
1657379196468,CSE 30,B01,095061,Bhaskar; Nishant,9,0,50,41
1657379202499,CSE 100,A01,083659,Cao; Yingjun,5,4,70,65
1657379208530,CSE 134B,A01,083661,Powell; Thomas Allan,22,0,100,78
1657379214557,CSE 140,A01,083663,Gungor; Onat,14,0,85,71
1657379220581,CSE 140L,A01,083088,Eldon; John,21,0,100,79
1657379226607,CSE 175,A01,083665,Kumar; Rakesh,3,0,25,22
1657379232639,CSE 190,A00,092507,Dubnov; Shlomo,7,0,20,13
1657379238666,ECE 45,A01,083139,Congero; Spencer William,6,0,75,69
1657379244693,ECE 65,A50,083695,Saad; Andrew S,12,0,30,18
1657379244693,ECE 65,A51,095125,Saad; Andrew S,24,0,26,2
1657379250721,ECE 109,A01,091882,Touri; Behrouz,19,0,70,51
1657379256752,ECE 180,A00,083140,Abi Samra; Nicholas Camill,1,0,30,29
1657379256752,ECE 180,B00,083141,Abi Samra; Nicholas Camill,0,0,30,30
1657379262780,MATH 10A,A01,083735,Patchell; Gregory David,2,0,30,28
1657379262780,MATH 10A,A02,083736,Patchell; Gregory David,20,0,30,10
1657379262780,MATH 10A,A03,083737,Patchell; Gregory David,16,0,30,14
1657379268811,MATH 10B,A01,083207,Lim; Seonhee,8,0,34,26
1657379268811,MATH 10B,A02,083208,Lim; Seonhee,9,0,35,26
1657379268811,MATH 10B,A03,093472,Lim; Seonhee,7,0,34,27
1657379268811,MATH 10B,B01,083739,Sinha; Shubham,12,0,30,18
1657379274851,MATH 18,A01,083743,Cinel; Cameron Alexander,7,0,30,23
1657379274851,MATH 18,A02,083744,Cinel; Cameron Alexander,17,0,30,13
1657379274851,MATH 18,A03,083745,Cinel; Cameron Alexander,9,0,30,21
1657379274851,MATH 18,B01,083748,Rideout; David Porter,5,0,37,32
1657379274851,MATH 18,B02,083749,Rideout; David Porter,5,0,36,31
1657379274851,MATH 18,B03,083750,Rideout; David Porter,3,0,37,34
1657379274851,MATH 18,B04,083751,Rideout; David Porter,6,0,36,30
1657379274851,MATH 18,B05,093473,Rideout; David Porter,6,0,36,30
1657379274851,MATH 18,B06,093474,Rideout; David Porter,6,0,36,30
1657379280877,MATH 20A,A01,083754,Zheng; Zequn,14,0,40,26
1657379286914,MATH 20B,A01,083756,Briones; Jor-el Thomas Caparas,4,0,36,32
1657379286914,MATH 20B,A02,083757,Briones; Jor-el Thomas Caparas,1,0,36,35
1657379286914,MATH 20B,A03,093475,Briones; Jor-el Thomas Caparas,2,0,36,34
1657379292939,MATH 20C,A01,083760,Briones; Jor-el Thomas Caparas,1,0,35,34
1657379292939,MATH 20C,A02,083761,Briones; Jor-el Thomas Caparas,8,0,35,27
1657379292939,MATH 20C,A03,093476,Briones; Jor-el Thomas Caparas,0,1,36,36
1657379292939,MATH 20C,B01,083762,Bach; Quang Tran,1,0,30,29
1657379298971,MATH 20D,A01,083765,Tran; Brian Kha,5,0,30,25
1657379298971,MATH 20D,A02,083766,Tran; Brian Kha,5,0,30,25
1657379298971,MATH 20D,A03,083767,Tran; Brian Kha,5,0,30,25
1657379305008,MATH 20E,A01,083771,Ganguly; Soumya,9,0,32,23
1657379305008,MATH 20E,A02,083772,Ganguly; Soumya,6,0,32,26
1657379305008,MATH 20E,B01,083773,Ciotti; Benjamin,20,0,35,15
1657379305008,MATH 20E,B02,083774,Ciotti; Benjamin,17,0,35,18
1657379311037,MATH 103A,A01,083777,Greenfeld; Be'Eri,3,0,36,33
1657379311037,MATH 103A,A02,083778,Greenfeld; Be'Eri,5,0,36,31
1657379311037,MATH 103A,A03,093561,Greenfeld; Be'Eri,5,0,36,31
1657379311037,MATH 103A,B01,083779,Greenfeld; Be'Eri,7,0,36,29
1657379311037,MATH 103A,B02,083780,Greenfeld; Be'Eri,4,0,36,32
1657379311037,MATH 103A,B03,093562,Greenfeld; Be'Eri,3,0,36,33
1657379317063,MATH 105,A01,085443,Carter; Anne Toulson,15,0,35,20
1657379317063,MATH 105,A02,093477,Carter; Anne Toulson,20,0,35,15
1657379323089,MATH 109,A01,083213,Ganzberger; Geoffrey Michael,2,0,34,32
1657379323089,MATH 109,A02,083214,Ganzberger; Geoffrey Michael,4,0,34,30
1657379323089,MATH 109,A03,093478,Ganzberger; Geoffrey Michael,2,0,34,32
1657379323089,MATH 109,B01,083215,Ganzberger; Geoffrey Michael,1,0,32,31
1657379323089,MATH 109,B02,083216,Ganzberger; Geoffrey Michael,2,0,32,30
1657379323089,MATH 109,B03,093479,Ganzberger; Geoffrey Michael,8,0,32,24
1657379329125,MATH 142A,A01,083219,Chow; Bennett,7,0,32,25
1657379329125,MATH 142A,A02,083220,Chow; Bennett,10,0,32,22
1657379329125,MATH 142A,A03,093480,Chow; Bennett,8,0,32,24
1657379329125,MATH 142A,B03,093481,Chow; Bennett,8,0,32,24
1657379329125,MATH 142A,B04,093558,Chow; Bennett,13,0,32,19
1657379329125,MATH 142A,B05,093559,Chow; Bennett,6,0,32,26
1657379335180,MATH 193A,A01,083224,Rotar; Vladimir,8,0,34,26
1657379335180,MATH 193A,A02,083225,Rotar; Vladimir,9,0,34,25
1657379335180,MATH 193A,A03,083781,Rotar; Vladimir,5,0,34,29
1657379335180,MATH 193A,A04,083782,Rotar; Vladimir,10,0,34,24
1657379335180,MATH 193A,A05,093482,Rotar; Vladimir,10,0,34,24
1657379341206,MATH 197,001,091859,McAuley; Julian John,9999,0,9999,0
1657379341206,MATH 197,002,095566,Kedlaya; Kiran S.,9997,0,9999,2
1657379341206,MATH 197,003,095567,Xiao; Ming,9999,0,9999,0
1657379341206,MATH 197,004,095571,Perols; Johan Lars,9998,0,9999,1
1657379348276,COGS 9,A01,083615,Shannon; Kyle Michael,9,0,75,66
1657379354301,COGS 11,A01,083617,Boyle; Mary E. T.,22,0,48,26
1657379360330,COGS 13,A01,083071,Bastos; Amalia Pinkusfeld,11,0,71,60
1657379366356,COGS 14A,A01,092681,Semenuks; Arturs,4,1,100,96
1657379372390,COGS 14B,A01,083073,Cheng; Tzu-Han,6,0,63,57
1657379378414,COGS 17,A01,092677,Semenuks; Arturs,6,0,81,75
1657379384452,COGS 100,A01,083619,Allen; Michael Gordon,17,0,70,53
1657379390478,COGS 101A,A01,083621,Davis; Joshua Daniel,9,0,68,59
1657379396507,COGS 101B,A01,091572,Allen; Michael Gordon,11,0,65,54
1657379402539,COGS 101C,A01,083625,Delgado; Tania,17,0,35,18
1657379408573,COGS 107A,A01,083627,Boyle; Mary E. T.,13,0,60,47
1657379414602,COGS 118A,A01,083075,Gupta; Anjum,20,0,76,56
1657379420628,CSE 3,A50,083646,Miranda; Gregory Joseph,24,0,50,26
1657379426673,CSE 8A,A50,083650,Miranda; Gregory Joseph,17,1,56,39
1657379432697,CSE 11,A01,083080,Cao; Yingjun,6,15,40,34
1657379438723,CSE 12,A01,083652,Krause-Levy; Sophia Louisa,28,1,120,92
1657379444748,CSE 15L,A01,083654,Morris; Justin Loren,9,0,50,41
1657379444748,CSE 15L,A02,083655,Morris; Justin Loren,9,0,50,41
1657379450773,CSE 20,A01,083657,Tran; Khoa Dang,39,0,80,41
1657379456805,CSE 21,A01,095574,Bach; Quang Tran,22,0,48,26
1657379462838,CSE 30,A01,083084,Eldon; John,4,0,80,76
1657379462838,CSE 30,B01,095061,Bhaskar; Nishant,9,0,50,41
1657379468862,CSE 100,A01,083659,Cao; Yingjun,5,4,70,65
1657379474888,CSE 134B,A01,083661,Powell; Thomas Allan,22,0,100,78
1657379480933,CSE 140,A01,083663,Gungor; Onat,14,0,85,71
1657379486964,CSE 140L,A01,083088,Eldon; John,21,0,100,79
1657379492995,CSE 175,A01,083665,Kumar; Rakesh,3,0,25,22
1657379499019,CSE 190,A00,092507,Dubnov; Shlomo,7,0,20,13
1657379505061,ECE 45,A01,083139,Congero; Spencer William,6,0,75,69
1657379511088,ECE 65,A50,083695,Saad; Andrew S,12,0,30,18
1657379511088,ECE 65,A51,095125,Saad; Andrew S,24,0,26,2
1657379517115,ECE 109,A01,091882,Touri; Behrouz,19,0,70,51
1657379523141,ECE 180,A00,083140,Abi Samra; Nicholas Camill,1,0,30,29
1657379523141,ECE 180,B00,083141,Abi Samra; Nicholas Camill,0,0,30,30
1657379529170,MATH 10A,A01,083735,Patchell; Gregory David,2,0,30,28
1657379529170,MATH 10A,A02,083736,Patchell; Gregory David,20,0,30,10
1657379529170,MATH 10A,A03,083737,Patchell; Gregory David,16,0,30,14
1657379535199,MATH 10B,A01,083207,Lim; Seonhee,8,0,34,26
1657379535199,MATH 10B,A02,083208,Lim; Seonhee,9,0,35,26
1657379535199,MATH 10B,A03,093472,Lim; Seonhee,7,0,34,27
1657379535199,MATH 10B,B01,083739,Sinha; Shubham,12,0,30,18
1657379541231,MATH 18,A01,083743,Cinel; Cameron Alexander,7,0,30,23
1657379541231,MATH 18,A02,083744,Cinel; Cameron Alexander,17,0,30,13
1657379541231,MATH 18,A03,083745,Cinel; Cameron Alexander,9,0,30,21
1657379541231,MATH 18,B01,083748,Rideout; David Porter,5,0,37,32
1657379541231,MATH 18,B02,083749,Rideout; David Porter,5,0,36,31
1657379541231,MATH 18,B03,083750,Rideout; David Porter,3,0,37,34
1657379541231,MATH 18,B04,083751,Rideout; David Porter,6,0,36,30
1657379541231,MATH 18,B05,093473,Rideout; David Porter,6,0,36,30
1657379541231,MATH 18,B06,093474,Rideout; David Porter,6,0,36,30
1657379547261,MATH 20A,A01,083754,Zheng; Zequn,14,0,40,26
1657379553294,MATH 20B,A01,083756,Briones; Jor-el Thomas Caparas,4,0,36,32
1657379553294,MATH 20B,A02,083757,Briones; Jor-el Thomas Caparas,1,0,36,35
1657379553294,MATH 20B,A03,093475,Briones; Jor-el Thomas Caparas,2,0,36,34
1657379559393,MATH 20C,A01,083760,Briones; Jor-el Thomas Caparas,1,0,35,34
1657379559393,MATH 20C,A02,083761,Briones; Jor-el Thomas Caparas,8,0,35,27
1657379559393,MATH 20C,A03,093476,Briones; Jor-el Thomas Caparas,0,1,36,36
1657379559393,MATH 20C,B01,083762,Bach; Quang Tran,1,0,30,29
1657379565420,MATH 20D,A01,083765,Tran; Brian Kha,5,0,30,25
1657379565420,MATH 20D,A02,083766,Tran; Brian Kha,5,0,30,25
1657379565420,MATH 20D,A03,083767,Tran; Brian Kha,5,0,30,25
1657379571446,MATH 20E,A01,083771,Ganguly; Soumya,9,0,32,23
1657379571446,MATH 20E,A02,083772,Ganguly; Soumya,6,0,32,26
1657379571446,MATH 20E,B01,083773,Ciotti; Benjamin,20,0,35,15
1657379571446,MATH 20E,B02,083774,Ciotti; Benjamin,17,0,35,18
1657379577482,MATH 103A,A01,083777,Greenfeld; Be'Eri,3,0,36,33
1657379577482,MATH 103A,A02,083778,Greenfeld; Be'Eri,5,0,36,31
1657379577482,MATH 103A,A03,093561,Greenfeld; Be'Eri,5,0,36,31
1657379577482,MATH 103A,B01,083779,Greenfeld; Be'Eri,7,0,36,29
1657379577482,MATH 103A,B02,083780,Greenfeld; Be'Eri,4,0,36,32
1657379577482,MATH 103A,B03,093562,Greenfeld; Be'Eri,3,0,36,33
1657379583514,MATH 105,A01,085443,Carter; Anne Toulson,15,0,35,20
1657379583514,MATH 105,A02,093477,Carter; Anne Toulson,20,0,35,15
1657379589545,MATH 109,A01,083213,Ganzberger; Geoffrey Michael,2,0,34,32
1657379589545,MATH 109,A02,083214,Ganzberger; Geoffrey Michael,4,0,34,30
1657379589545,MATH 109,A03,093478,Ganzberger; Geoffrey Michael,2,0,34,32
1657379589545,MATH 109,B01,083215,Ganzberger; Geoffrey Michael,1,0,32,31
1657379589545,MATH 109,B02,083216,Ganzberger; Geoffrey Michael,2,0,32,30
1657379589545,MATH 109,B03,093479,Ganzberger; Geoffrey Michael,8,0,32,24
1657379595572,MATH 142A,A01,083219,Chow; Bennett,7,0,32,25
1657379595572,MATH 142A,A02,083220,Chow; Bennett,10,0,32,22
1657379595572,MATH 142A,A03,093480,Chow; Bennett,8,0,32,24
1657379595572,MATH 142A,B03,093481,Chow; Bennett,8,0,32,24
1657379595572,MATH 142A,B04,093558,Chow; Bennett,13,0,32,19
1657379595572,MATH 142A,B05,093559,Chow; Bennett,6,0,32,26
1657379601609,MATH 193A,A01,083224,Rotar; Vladimir,8,0,34,26
1657379601609,MATH 193A,A02,083225,Rotar; Vladimir,9,0,34,25
1657379601609,MATH 193A,A03,083781,Rotar; Vladimir,5,0,34,29
1657379601609,MATH 193A,A04,083782,Rotar; Vladimir,10,0,34,24
1657379601609,MATH 193A,A05,093482,Rotar; Vladimir,10,0,34,24
1657379607635,MATH 197,001,091859,McAuley; Julian John,9999,0,9999,0
1657379607635,MATH 197,002,095566,Kedlaya; Kiran S.,9997,0,9999,2
1657379607635,MATH 197,003,095567,Xiao; Ming,9999,0,9999,0
1657379607635,MATH 197,004,095571,Perols; Johan Lars,9998,0,9999,1
1657379614705,COGS 9,A01,083615,Shannon; Kyle Michael,9,0,75,66
1657379620730,COGS 11,A01,083617,Boyle; Mary E. T.,22,0,48,26
1657379626754,COGS 13,A01,083071,Bastos; Amalia Pinkusfeld,11,0,71,60
1657379632778,COGS 14A,A01,092681,Semenuks; Arturs,4,1,100,96
1657379638804,COGS 14B,A01,083073,Cheng; Tzu-Han,6,0,63,57
1657379644829,COGS 17,A01,092677,Semenuks; Arturs,6,0,81,75
1657379650853,COGS 100,A01,083619,Allen; Michael Gordon,17,0,70,53
1657379656878,COGS 101A,A01,083621,Davis; Joshua Daniel,9,0,68,59
1657379662904,COGS 101B,A01,091572,Allen; Michael Gordon,11,0,65,54
1657379668931,COGS 101C,A01,083625,Delgado; Tania,17,0,35,18
1657379674956,COGS 107A,A01,083627,Boyle; Mary E. T.,13,0,60,47
1657379680980,COGS 118A,A01,083075,Gupta; Anjum,20,0,76,56
1657379687028,CSE 3,A50,083646,Miranda; Gregory Joseph,24,0,50,26
1657379693057,CSE 8A,A50,083650,Miranda; Gregory Joseph,17,1,56,39
1657379699081,CSE 11,A01,083080,Cao; Yingjun,6,15,40,34
1657379705112,CSE 12,A01,083652,Krause-Levy; Sophia Louisa,28,1,120,92
1657379711141,CSE 15L,A01,083654,Morris; Justin Loren,9,0,50,41
1657379711141,CSE 15L,A02,083655,Morris; Justin Loren,9,0,50,41
1657379717173,CSE 20,A01,083657,Tran; Khoa Dang,39,0,80,41
1657379723203,CSE 21,A01,095574,Bach; Quang Tran,22,0,48,26
1657379729230,CSE 30,A01,083084,Eldon; John,4,0,80,76
1657379729230,CSE 30,B01,095061,Bhaskar; Nishant,9,0,50,41
1657379735257,CSE 100,A01,083659,Cao; Yingjun,5,4,70,65
1657379741284,CSE 134B,A01,083661,Powell; Thomas Allan,22,0,100,78
1657379747314,CSE 140,A01,083663,Gungor; Onat,14,0,85,71
1657379753343,CSE 140L,A01,083088,Eldon; John,21,0,100,79
1657379759367,CSE 175,A01,083665,Kumar; Rakesh,3,0,25,22
1657379765398,CSE 190,A00,092507,Dubnov; Shlomo,7,0,20,13
1657379771436,ECE 45,A01,083139,Congero; Spencer William,6,0,75,69
1657379777461,ECE 65,A50,083695,Saad; Andrew S,12,0,30,18
1657379777461,ECE 65,A51,095125,Saad; Andrew S,24,0,26,2
1657379783488,ECE 109,A01,091882,Touri; Behrouz,19,0,70,51
1657379789514,ECE 180,A00,083140,Abi Samra; Nicholas Camill,1,0,30,29
1657379789514,ECE 180,B00,083141,Abi Samra; Nicholas Camill,0,0,30,30
1657379795543,MATH 10A,A01,083735,Patchell; Gregory David,2,0,30,28
1657379795543,MATH 10A,A02,083736,Patchell; Gregory David,20,0,30,10
1657379795543,MATH 10A,A03,083737,Patchell; Gregory David,16,0,30,14
1657379801569,MATH 10B,A01,083207,Lim; Seonhee,8,0,34,26
1657379801569,MATH 10B,A02,083208,Lim; Seonhee,9,0,35,26
1657379801569,MATH 10B,A03,093472,Lim; Seonhee,7,0,34,27
1657379801569,MATH 10B,B01,083739,Sinha; Shubham,12,0,30,18
1657379807596,MATH 18,A01,083743,Cinel; Cameron Alexander,7,0,30,23
1657379807596,MATH 18,A02,083744,Cinel; Cameron Alexander,17,0,30,13
1657379807596,MATH 18,A03,083745,Cinel; Cameron Alexander,9,0,30,21
1657379807596,MATH 18,B01,083748,Rideout; David Porter,5,0,37,32
1657379807596,MATH 18,B02,083749,Rideout; David Porter,5,0,36,31
1657379807596,MATH 18,B03,083750,Rideout; David Porter,3,0,37,34
1657379807596,MATH 18,B04,083751,Rideout; David Porter,6,0,36,30
1657379807596,MATH 18,B05,093473,Rideout; David Porter,6,0,36,30
1657379807596,MATH 18,B06,093474,Rideout; David Porter,6,0,36,30
1657379813625,MATH 20A,A01,083754,Zheng; Zequn,14,0,40,26
1657379819649,MATH 20B,A01,083756,Briones; Jor-el Thomas Caparas,4,0,36,32
1657379819649,MATH 20B,A02,083757,Briones; Jor-el Thomas Caparas,1,0,36,35
1657379819649,MATH 20B,A03,093475,Briones; Jor-el Thomas Caparas,2,0,36,34
1657379825682,MATH 20C,A01,083760,Briones; Jor-el Thomas Caparas,1,0,35,34
1657379825682,MATH 20C,A02,083761,Briones; Jor-el Thomas Caparas,8,0,35,27
1657379825682,MATH 20C,A03,093476,Briones; Jor-el Thomas Caparas,0,1,36,36
1657379825682,MATH 20C,B01,083762,Bach; Quang Tran,1,0,30,29
1657379831717,MATH 20D,A01,083765,Tran; Brian Kha,5,0,30,25
1657379831717,MATH 20D,A02,083766,Tran; Brian Kha,5,0,30,25
1657379831717,MATH 20D,A03,083767,Tran; Brian Kha,5,0,30,25
1657379837753,MATH 20E,A01,083771,Ganguly; Soumya,9,0,32,23
1657379837753,MATH 20E,A02,083772,Ganguly; Soumya,6,0,32,26
1657379837753,MATH 20E,B01,083773,Ciotti; Benjamin,20,0,35,15
1657379837753,MATH 20E,B02,083774,Ciotti; Benjamin,17,0,35,18
1657379843783,MATH 103A,A01,083777,Greenfeld; Be'Eri,3,0,36,33
1657379843783,MATH 103A,A02,083778,Greenfeld; Be'Eri,5,0,36,31
1657379843783,MATH 103A,A03,093561,Greenfeld; Be'Eri,5,0,36,31
1657379843783,MATH 103A,B01,083779,Greenfeld; Be'Eri,7,0,36,29
1657379843783,MATH 103A,B02,083780,Greenfeld; Be'Eri,4,0,36,32
1657379843783,MATH 103A,B03,093562,Greenfeld; Be'Eri,3,0,36,33
1657379849815,MATH 105,A01,085443,Carter; Anne Toulson,15,0,35,20
1657379849815,MATH 105,A02,093477,Carter; Anne Toulson,20,0,35,15
1657379855841,MATH 109,A01,083213,Ganzberger; Geoffrey Michael,2,0,34,32
1657379855841,MATH 109,A02,083214,Ganzberger; Geoffrey Michael,4,0,34,30
1657379855841,MATH 109,A03,093478,Ganzberger; Geoffrey Michael,2,0,34,32
1657379855841,MATH 109,B01,083215,Ganzberger; Geoffrey Michael,1,0,32,31
1657379855841,MATH 109,B02,083216,Ganzberger; Geoffrey Michael,2,0,32,30
1657379855841,MATH 109,B03,093479,Ganzberger; Geoffrey Michael,8,0,32,24
1657379861869,MATH 142A,A01,083219,Chow; Bennett,7,0,32,25
1657379861869,MATH 142A,A02,083220,Chow; Bennett,10,0,32,22
1657379861869,MATH 142A,A03,093480,Chow; Bennett,8,0,32,24
1657379861869,MATH 142A,B03,093481,Chow; Bennett,8,0,32,24
1657379861869,MATH 142A,B04,093558,Chow; Bennett,13,0,32,19
1657379861869,MATH 142A,B05,093559,Chow; Bennett,6,0,32,26
1657379867896,MATH 193A,A01,083224,Rotar; Vladimir,8,0,34,26
1657379867896,MATH 193A,A02,083225,Rotar; Vladimir,9,0,34,25
1657379867896,MATH 193A,A03,083781,Rotar; Vladimir,5,0,34,29
1657379867896,MATH 193A,A04,083782,Rotar; Vladimir,10,0,34,24
1657379867896,MATH 193A,A05,093482,Rotar; Vladimir,10,0,34,24
1657379873927,MATH 197,001,091859,McAuley; Julian John,9999,0,9999,0
1657379873927,MATH 197,002,095566,Kedlaya; Kiran S.,9997,0,9999,2
1657379873927,MATH 197,003,095567,Xiao; Ming,9999,0,9999,0
1657379873927,MATH 197,004,095571,Perols; Johan Lars,9998,0,9999,1
1657379880985,COGS 9,A01,083615,Shannon; Kyle Michael,9,0,75,66
1657379887008,COGS 11,A01,083617,Boyle; Mary E. T.,22,0,48,26
1657379893036,COGS 13,A01,083071,Bastos; Amalia Pinkusfeld,11,0,71,60
1657379899060,COGS 14A,A01,092681,Semenuks; Arturs,4,1,100,96
1657379905088,COGS 14B,A01,083073,Cheng; Tzu-Han,6,0,63,57
1657379911113,COGS 17,A01,092677,Semenuks; Arturs,6,0,81,75
1657379917137,COGS 100,A01,083619,Allen; Michael Gordon,17,0,70,53
1657379923166,COGS 101A,A01,083621,Davis; Joshua Daniel,9,0,68,59
1657379929192,COGS 101B,A01,091572,Allen; Michael Gordon,11,0,65,54
1657379935216,COGS 101C,A01,083625,Delgado; Tania,17,0,35,18
1657379941242,COGS 107A,A01,083627,Boyle; Mary E. T.,13,0,60,47
1657379947267,COGS 118A,A01,083075,Gupta; Anjum,20,0,76,56
1657379953302,CSE 3,A50,083646,Miranda; Gregory Joseph,24,0,50,26
1657379959327,CSE 8A,A50,083650,Miranda; Gregory Joseph,17,1,56,39
1657379965353,CSE 11,A01,083080,Cao; Yingjun,6,15,40,34
1657379971382,CSE 12,A01,083652,Krause-Levy; Sophia Louisa,28,1,120,92
1657379977408,CSE 15L,A01,083654,Morris; Justin Loren,9,0,50,41
1657379977408,CSE 15L,A02,083655,Morris; Justin Loren,9,0,50,41
1657379983434,CSE 20,A01,083657,Tran; Khoa Dang,39,0,80,41
1657379989461,CSE 21,A01,095574,Bach; Quang Tran,22,0,48,26
1657379995493,CSE 30,A01,083084,Eldon; John,4,0,80,76
1657379995493,CSE 30,B01,095061,Bhaskar; Nishant,9,0,50,41
1657380001519,CSE 100,A01,083659,Cao; Yingjun,5,4,70,65
1657380007546,CSE 134B,A01,083661,Powell; Thomas Allan,22,0,100,78
1657380013574,CSE 140,A01,083663,Gungor; Onat,14,0,85,71
1657380019603,CSE 140L,A01,083088,Eldon; John,21,0,100,79
1657380025628,CSE 175,A01,083665,Kumar; Rakesh,3,0,25,22
1657380031654,CSE 190,A00,092507,Dubnov; Shlomo,7,0,20,13
1657380037685,ECE 45,A01,083139,Congero; Spencer William,6,0,75,69
1657380043710,ECE 65,A50,083695,Saad; Andrew S,12,0,30,18
1657380043710,ECE 65,A51,095125,Saad; Andrew S,24,0,26,2
1657380049733,ECE 109,A01,091882,Touri; Behrouz,19,0,70,51
1657380055758,ECE 180,A00,083140,Abi Samra; Nicholas Camill,1,0,30,29
1657380055758,ECE 180,B00,083141,Abi Samra; Nicholas Camill,0,0,30,30
1657380061790,MATH 10A,A01,083735,Patchell; Gregory David,2,0,30,28
1657380061790,MATH 10A,A02,083736,Patchell; Gregory David,20,0,30,10
1657380061790,MATH 10A,A03,083737,Patchell; Gregory David,16,0,30,14
1657380067816,MATH 10B,A01,083207,Lim; Seonhee,8,0,34,26
1657380067816,MATH 10B,A02,083208,Lim; Seonhee,9,0,35,26
1657380067816,MATH 10B,A03,093472,Lim; Seonhee,7,0,34,27
1657380067816,MATH 10B,B01,083739,Sinha; Shubham,12,0,30,18
1657380073843,MATH 18,A01,083743,Cinel; Cameron Alexander,7,0,30,23
1657380073843,MATH 18,A02,083744,Cinel; Cameron Alexander,17,0,30,13
1657380073843,MATH 18,A03,083745,Cinel; Cameron Alexander,9,0,30,21
1657380073843,MATH 18,B01,083748,Rideout; David Porter,5,0,37,32
1657380073843,MATH 18,B02,083749,Rideout; David Porter,5,0,36,31
1657380073843,MATH 18,B03,083750,Rideout; David Porter,3,0,37,34
1657380073843,MATH 18,B04,083751,Rideout; David Porter,6,0,36,30
1657380073843,MATH 18,B05,093473,Rideout; David Porter,6,0,36,30
1657380073843,MATH 18,B06,093474,Rideout; David Porter,6,0,36,30
1657380079869,MATH 20A,A01,083754,Zheng; Zequn,14,0,40,26
1657380085896,MATH 20B,A01,083756,Briones; Jor-el Thomas Caparas,4,0,36,32
1657380085896,MATH 20B,A02,083757,Briones; Jor-el Thomas Caparas,1,0,36,35
1657380085896,MATH 20B,A03,093475,Briones; Jor-el Thomas Caparas,2,0,36,34
1657380091922,MATH 20C,A01,083760,Briones; Jor-el Thomas Caparas,1,0,35,34
1657380091922,MATH 20C,A02,083761,Briones; Jor-el Thomas Caparas,8,0,35,27
1657380091922,MATH 20C,A03,093476,Briones; Jor-el Thomas Caparas,0,1,36,36
1657380091922,MATH 20C,B01,083762,Bach; Quang Tran,1,0,30,29
1657380097945,MATH 20D,A01,083765,Tran; Brian Kha,5,0,30,25
1657380097945,MATH 20D,A02,083766,Tran; Brian Kha,5,0,30,25
1657380097945,MATH 20D,A03,083767,Tran; Brian Kha,5,0,30,25
1657380103980,MATH 20E,A01,083771,Ganguly; Soumya,9,0,32,23
1657380103980,MATH 20E,A02,083772,Ganguly; Soumya,6,0,32,26
1657380103980,MATH 20E,B01,083773,Ciotti; Benjamin,20,0,35,15
1657380103980,MATH 20E,B02,083774,Ciotti; Benjamin,17,0,35,18
1657380110008,MATH 103A,A01,083777,Greenfeld; Be'Eri,3,0,36,33
1657380110008,MATH 103A,A02,083778,Greenfeld; Be'Eri,5,0,36,31
1657380110008,MATH 103A,A03,093561,Greenfeld; Be'Eri,5,0,36,31
1657380110008,MATH 103A,B01,083779,Greenfeld; Be'Eri,7,0,36,29
1657380110008,MATH 103A,B02,083780,Greenfeld; Be'Eri,4,0,36,32
1657380110008,MATH 103A,B03,093562,Greenfeld; Be'Eri,3,0,36,33
1657380116043,MATH 105,A01,085443,Carter; Anne Toulson,15,0,35,20
1657380116043,MATH 105,A02,093477,Carter; Anne Toulson,20,0,35,15
1657380122070,MATH 109,A01,083213,Ganzberger; Geoffrey Michael,2,0,34,32
1657380122070,MATH 109,A02,083214,Ganzberger; Geoffrey Michael,4,0,34,30
1657380122070,MATH 109,A03,093478,Ganzberger; Geoffrey Michael,2,0,34,32
1657380122070,MATH 109,B01,083215,Ganzberger; Geoffrey Michael,1,0,32,31
1657380122070,MATH 109,B02,083216,Ganzberger; Geoffrey Michael,2,0,32,30
1657380122070,MATH 109,B03,093479,Ganzberger; Geoffrey Michael,8,0,32,24
1657380128098,MATH 142A,A01,083219,Chow; Bennett,7,0,32,25
1657380128098,MATH 142A,A02,083220,Chow; Bennett,10,0,32,22
1657380128098,MATH 142A,A03,093480,Chow; Bennett,8,0,32,24
1657380128098,MATH 142A,B03,093481,Chow; Bennett,8,0,32,24
1657380128098,MATH 142A,B04,093558,Chow; Bennett,13,0,32,19
1657380128098,MATH 142A,B05,093559,Chow; Bennett,6,0,32,26
1657380134131,MATH 193A,A01,083224,Rotar; Vladimir,8,0,34,26
1657380134131,MATH 193A,A02,083225,Rotar; Vladimir,9,0,34,25
1657380134131,MATH 193A,A03,083781,Rotar; Vladimir,5,0,34,29
1657380134131,MATH 193A,A04,083782,Rotar; Vladimir,10,0,34,24
1657380134131,MATH 193A,A05,093482,Rotar; Vladimir,10,0,34,24
1657380140158,MATH 197,001,091859,McAuley; Julian John,9999,0,9999,0
1657380140158,MATH 197,002,095566,Kedlaya; Kiran S.,9997,0,9999,2
1657380140158,MATH 197,003,095567,Xiao; Ming,9999,0,9999,0
1657380140158,MATH 197,004,095571,Perols; Johan Lars,9998,0,9999,1
1657380147224,COGS 9,A01,083615,Shannon; Kyle Michael,9,0,75,66
1657380153323,COGS 11,A01,083617,Boyle; Mary E. T.,22,0,48,26
1657380159350,COGS 13,A01,083071,Bastos; Amalia Pinkusfeld,11,0,71,60
1657380165380,COGS 14A,A01,092681,Semenuks; Arturs,4,1,100,96
1657380171415,COGS 14B,A01,083073,Cheng; Tzu-Han,6,0,63,57
1657380177439,COGS 17,A01,092677,Semenuks; Arturs,6,0,81,75
1657380183469,COGS 100,A01,083619,Allen; Michael Gordon,17,0,70,53
1657380189496,COGS 101A,A01,083621,Davis; Joshua Daniel,9,0,68,59
1657380195531,COGS 101B,A01,091572,Allen; Michael Gordon,11,0,65,54
1657380201556,COGS 101C,A01,083625,Delgado; Tania,17,0,35,18
1657380207581,COGS 107A,A01,083627,Boyle; Mary E. T.,13,0,60,47
1657380213612,COGS 118A,A01,083075,Gupta; Anjum,20,0,76,56
1657380219646,CSE 3,A50,083646,Miranda; Gregory Joseph,24,0,50,26
1657380225676,CSE 8A,A50,083650,Miranda; Gregory Joseph,17,1,56,39
1657380231704,CSE 11,A01,083080,Cao; Yingjun,6,15,40,34
1657380237735,CSE 12,A01,083652,Krause-Levy; Sophia Louisa,28,1,120,92
1657380243761,CSE 15L,A01,083654,Morris; Justin Loren,9,0,50,41
1657380243761,CSE 15L,A02,083655,Morris; Justin Loren,9,0,50,41
1657380249792,CSE 20,A01,083657,Tran; Khoa Dang,39,0,80,41
1657380255818,CSE 21,A01,095574,Bach; Quang Tran,22,0,48,26
1657380261845,CSE 30,A01,083084,Eldon; John,4,0,80,76
1657380261845,CSE 30,B01,095061,Bhaskar; Nishant,9,0,50,41
1657380267873,CSE 100,A01,083659,Cao; Yingjun,5,4,70,65
1657380273904,CSE 134B,A01,083661,Powell; Thomas Allan,22,0,100,78
1657380279946,CSE 140,A01,083663,Gungor; Onat,14,0,85,71
1657380285969,CSE 140L,A01,083088,Eldon; John,21,0,100,79
1657380291993,CSE 175,A01,083665,Kumar; Rakesh,3,0,25,22
1657380298018,CSE 190,A00,092507,Dubnov; Shlomo,7,0,20,13
1657380304050,ECE 45,A01,083139,Congero; Spencer William,6,0,75,69
1657380310079,ECE 65,A50,083695,Saad; Andrew S,12,0,30,18
1657380310079,ECE 65,A51,095125,Saad; Andrew S,24,0,26,2
1657380316105,ECE 109,A01,091882,Touri; Behrouz,19,0,70,51
1657380322131,ECE 180,A00,083140,Abi Samra; Nicholas Camill,1,0,30,29
1657380322131,ECE 180,B00,083141,Abi Samra; Nicholas Camill,0,0,30,30
1657380328157,MATH 10A,A01,083735,Patchell; Gregory David,2,0,30,28
1657380328157,MATH 10A,A02,083736,Patchell; Gregory David,20,0,30,10
1657380328157,MATH 10A,A03,083737,Patchell; Gregory David,16,0,30,14
1657380334184,MATH 10B,A01,083207,Lim; Seonhee,8,0,34,26
1657380334184,MATH 10B,A02,083208,Lim; Seonhee,9,0,35,26
1657380334184,MATH 10B,A03,093472,Lim; Seonhee,7,0,34,27
1657380334184,MATH 10B,B01,083739,Sinha; Shubham,12,0,30,18
1657380340214,MATH 18,A01,083743,Cinel; Cameron Alexander,7,0,30,23
1657380340214,MATH 18,A02,083744,Cinel; Cameron Alexander,17,0,30,13
1657380340214,MATH 18,A03,083745,Cinel; Cameron Alexander,9,0,30,21
1657380340214,MATH 18,B01,083748,Rideout; David Porter,5,0,37,32
1657380340214,MATH 18,B02,083749,Rideout; David Porter,5,0,36,31
1657380340214,MATH 18,B03,083750,Rideout; David Porter,3,0,37,34
1657380340214,MATH 18,B04,083751,Rideout; David Porter,6,0,36,30
1657380340214,MATH 18,B05,093473,Rideout; David Porter,6,0,36,30
1657380340214,MATH 18,B06,093474,Rideout; David Porter,6,0,36,30
1657380346238,MATH 20A,A01,083754,Zheng; Zequn,14,0,40,26
1657380352271,MATH 20B,A01,083756,Briones; Jor-el Thomas Caparas,4,0,36,32
1657380352271,MATH 20B,A02,083757,Briones; Jor-el Thomas Caparas,1,0,36,35
1657380352271,MATH 20B,A03,093475,Briones; Jor-el Thomas Caparas,2,0,36,34
1657380358303,MATH 20C,A01,083760,Briones; Jor-el Thomas Caparas,1,0,35,34
1657380358303,MATH 20C,A02,083761,Briones; Jor-el Thomas Caparas,8,0,35,27
1657380358303,MATH 20C,A03,093476,Briones; Jor-el Thomas Caparas,0,1,36,36
1657380358303,MATH 20C,B01,083762,Bach; Quang Tran,1,0,30,29
1657380364328,MATH 20D,A01,083765,Tran; Brian Kha,5,0,30,25
1657380364328,MATH 20D,A02,083766,Tran; Brian Kha,5,0,30,25
1657380364328,MATH 20D,A03,083767,Tran; Brian Kha,5,0,30,25
1657380370363,MATH 20E,A01,083771,Ganguly; Soumya,9,0,32,23
1657380370363,MATH 20E,A02,083772,Ganguly; Soumya,6,0,32,26
1657380370363,MATH 20E,B01,083773,Ciotti; Benjamin,20,0,35,15
1657380370363,MATH 20E,B02,083774,Ciotti; Benjamin,17,0,35,18
1657380376399,MATH 103A,A01,083777,Greenfeld; Be'Eri,3,0,36,33
1657380376399,MATH 103A,A02,083778,Greenfeld; Be'Eri,5,0,36,31
1657380376399,MATH 103A,A03,093561,Greenfeld; Be'Eri,5,0,36,31
1657380376399,MATH 103A,B01,083779,Greenfeld; Be'Eri,7,0,36,29
1657380376399,MATH 103A,B02,083780,Greenfeld; Be'Eri,4,0,36,32
1657380376399,MATH 103A,B03,093562,Greenfeld; Be'Eri,3,0,36,33
1657380382426,MATH 105,A01,085443,Carter; Anne Toulson,15,0,35,20
1657380382426,MATH 105,A02,093477,Carter; Anne Toulson,20,0,35,15
1657380388453,MATH 109,A01,083213,Ganzberger; Geoffrey Michael,2,0,34,32
1657380388453,MATH 109,A02,083214,Ganzberger; Geoffrey Michael,4,0,34,30
1657380388453,MATH 109,A03,093478,Ganzberger; Geoffrey Michael,2,0,34,32
1657380388453,MATH 109,B01,083215,Ganzberger; Geoffrey Michael,1,0,32,31
1657380388453,MATH 109,B02,083216,Ganzberger; Geoffrey Michael,2,0,32,30
1657380388453,MATH 109,B03,093479,Ganzberger; Geoffrey Michael,8,0,32,24
1657380394480,MATH 142A,A01,083219,Chow; Bennett,7,0,32,25
1657380394480,MATH 142A,A02,083220,Chow; Bennett,10,0,32,22
1657380394480,MATH 142A,A03,093480,Chow; Bennett,8,0,32,24
1657380394480,MATH 142A,B03,093481,Chow; Bennett,8,0,32,24
1657380394480,MATH 142A,B04,093558,Chow; Bennett,13,0,32,19
1657380394480,MATH 142A,B05,093559,Chow; Bennett,6,0,32,26
1657380400506,MATH 193A,A01,083224,Rotar; Vladimir,8,0,34,26
1657380400506,MATH 193A,A02,083225,Rotar; Vladimir,9,0,34,25
1657380400506,MATH 193A,A03,083781,Rotar; Vladimir,5,0,34,29
1657380400506,MATH 193A,A04,083782,Rotar; Vladimir,10,0,34,24
1657380400506,MATH 193A,A05,093482,Rotar; Vladimir,10,0,34,24
1657380406537,MATH 197,001,091859,McAuley; Julian John,9999,0,9999,0
1657380406537,MATH 197,002,095566,Kedlaya; Kiran S.,9997,0,9999,2
1657380406537,MATH 197,003,095567,Xiao; Ming,9999,0,9999,0
1657380406537,MATH 197,004,095571,Perols; Johan Lars,9998,0,9999,1
1657380413603,COGS 9,A01,083615,Shannon; Kyle Michael,9,0,75,66
1657380419627,COGS 11,A01,083617,Boyle; Mary E. T.,22,0,48,26
1657380425653,COGS 13,A01,083071,Bastos; Amalia Pinkusfeld,11,0,71,60
1657380431679,COGS 14A,A01,092681,Semenuks; Arturs,4,1,100,96
1657380437704,COGS 14B,A01,083073,Cheng; Tzu-Han,6,0,63,57
1657380443729,COGS 17,A01,092677,Semenuks; Arturs,6,0,81,75
1657380449757,COGS 100,A01,083619,Allen; Michael Gordon,17,0,70,53
1657380455781,COGS 101A,A01,083621,Davis; Joshua Daniel,9,0,68,59
1657380461807,COGS 101B,A01,091572,Allen; Michael Gordon,11,0,65,54
1657380467833,COGS 101C,A01,083625,Delgado; Tania,17,0,35,18
1657380473862,COGS 107A,A01,083627,Boyle; Mary E. T.,13,0,60,47
1657380479896,COGS 118A,A01,083075,Gupta; Anjum,20,0,76,56
1657380485924,CSE 3,A50,083646,Miranda; Gregory Joseph,24,0,50,26
1657380491956,CSE 8A,A50,083650,Miranda; Gregory Joseph,17,1,56,39
1657380497981,CSE 11,A01,083080,Cao; Yingjun,6,15,40,34
1657380504013,CSE 12,A01,083652,Krause-Levy; Sophia Louisa,28,1,120,92
1657380510043,CSE 15L,A01,083654,Morris; Justin Loren,9,0,50,41
1657380510043,CSE 15L,A02,083655,Morris; Justin Loren,9,0,50,41
1657380516073,CSE 20,A01,083657,Tran; Khoa Dang,39,0,80,41
1657380522099,CSE 21,A01,095574,Bach; Quang Tran,22,0,48,26
1657380528132,CSE 30,A01,083084,Eldon; John,4,0,80,76
1657380528132,CSE 30,B01,095061,Bhaskar; Nishant,9,0,50,41
1657380534163,CSE 100,A01,083659,Cao; Yingjun,5,4,70,65
1657380540188,CSE 134B,A01,083661,Powell; Thomas Allan,22,0,100,78
1657380546216,CSE 140,A01,083663,Gungor; Onat,14,0,85,71
1657380552241,CSE 140L,A01,083088,Eldon; John,21,0,100,79
1657380558266,CSE 175,A01,083665,Kumar; Rakesh,3,0,25,22
1657380564294,CSE 190,A00,092507,Dubnov; Shlomo,7,0,20,13
1657380570324,ECE 45,A01,083139,Congero; Spencer William,6,0,75,69
1657380576357,ECE 65,A50,083695,Saad; Andrew S,12,0,30,18
1657380576357,ECE 65,A51,095125,Saad; Andrew S,24,0,26,2
1657380582384,ECE 109,A01,091882,Touri; Behrouz,19,0,70,51
1657380588412,ECE 180,A00,083140,Abi Samra; Nicholas Camill,1,0,30,29
1657380588412,ECE 180,B00,083141,Abi Samra; Nicholas Camill,0,0,30,30
1657380594439,MATH 10A,A01,083735,Patchell; Gregory David,2,0,30,28
1657380594439,MATH 10A,A02,083736,Patchell; Gregory David,20,0,30,10
1657380594439,MATH 10A,A03,083737,Patchell; Gregory David,16,0,30,14
1657380600468,MATH 10B,A01,083207,Lim; Seonhee,8,0,34,26
1657380600468,MATH 10B,A02,083208,Lim; Seonhee,9,0,35,26
1657380600468,MATH 10B,A03,093472,Lim; Seonhee,7,0,34,27
1657380600468,MATH 10B,B01,083739,Sinha; Shubham,12,0,30,18
1657380606497,MATH 18,A01,083743,Cinel; Cameron Alexander,7,0,30,23
1657380606497,MATH 18,A02,083744,Cinel; Cameron Alexander,17,0,30,13
1657380606497,MATH 18,A03,083745,Cinel; Cameron Alexander,9,0,30,21
1657380606497,MATH 18,B01,083748,Rideout; David Porter,5,0,37,32
1657380606497,MATH 18,B02,083749,Rideout; David Porter,5,0,36,31
1657380606497,MATH 18,B03,083750,Rideout; David Porter,3,0,37,34
1657380606497,MATH 18,B04,083751,Rideout; David Porter,6,0,36,30
1657380606497,MATH 18,B05,093473,Rideout; David Porter,6,0,36,30
1657380606497,MATH 18,B06,093474,Rideout; David Porter,6,0,36,30
1657380612522,MATH 20A,A01,083754,Zheng; Zequn,14,0,40,26
1657380618548,MATH 20B,A01,083756,Briones; Jor-el Thomas Caparas,4,0,36,32
1657380618548,MATH 20B,A02,083757,Briones; Jor-el Thomas Caparas,1,0,36,35
1657380618548,MATH 20B,A03,093475,Briones; Jor-el Thomas Caparas,2,0,36,34
1657380624575,MATH 20C,A01,083760,Briones; Jor-el Thomas Caparas,1,0,35,34
1657380624575,MATH 20C,A02,083761,Briones; Jor-el Thomas Caparas,8,0,35,27
1657380624575,MATH 20C,A03,093476,Briones; Jor-el Thomas Caparas,0,1,36,36
1657380624575,MATH 20C,B01,083762,Bach; Quang Tran,1,0,30,29
1657380630609,MATH 20D,A01,083765,Tran; Brian Kha,5,0,30,25
1657380630609,MATH 20D,A02,083766,Tran; Brian Kha,5,0,30,25
1657380630609,MATH 20D,A03,083767,Tran; Brian Kha,5,0,30,25
1657380636637,MATH 20E,A01,083771,Ganguly; Soumya,9,0,32,23
1657380636637,MATH 20E,A02,083772,Ganguly; Soumya,6,0,32,26
1657380636637,MATH 20E,B01,083773,Ciotti; Benjamin,20,0,35,15
1657380636637,MATH 20E,B02,083774,Ciotti; Benjamin,17,0,35,18
1657380642667,MATH 103A,A01,083777,Greenfeld; Be'Eri,3,0,36,33
1657380642667,MATH 103A,A02,083778,Greenfeld; Be'Eri,5,0,36,31
1657380642667,MATH 103A,A03,093561,Greenfeld; Be'Eri,5,0,36,31
1657380642667,MATH 103A,B01,083779,Greenfeld; Be'Eri,7,0,36,29
1657380642667,MATH 103A,B02,083780,Greenfeld; Be'Eri,4,0,36,32
1657380642667,MATH 103A,B03,093562,Greenfeld; Be'Eri,3,0,36,33
1657380648698,MATH 105,A01,085443,Carter; Anne Toulson,15,0,35,20
1657380648698,MATH 105,A02,093477,Carter; Anne Toulson,20,0,35,15
1657380654732,MATH 109,A01,083213,Ganzberger; Geoffrey Michael,2,0,34,32
1657380654732,MATH 109,A02,083214,Ganzberger; Geoffrey Michael,4,0,34,30
1657380654732,MATH 109,A03,093478,Ganzberger; Geoffrey Michael,2,0,34,32
1657380654732,MATH 109,B01,083215,Ganzberger; Geoffrey Michael,1,0,32,31
1657380654732,MATH 109,B02,083216,Ganzberger; Geoffrey Michael,2,0,32,30
1657380654732,MATH 109,B03,093479,Ganzberger; Geoffrey Michael,8,0,32,24
1657380660773,MATH 142A,A01,083219,Chow; Bennett,7,0,32,25
1657380660773,MATH 142A,A02,083220,Chow; Bennett,10,0,32,22
1657380660773,MATH 142A,A03,093480,Chow; Bennett,8,0,32,24
1657380660773,MATH 142A,B03,093481,Chow; Bennett,8,0,32,24
1657380660773,MATH 142A,B04,093558,Chow; Bennett,13,0,32,19
1657380660773,MATH 142A,B05,093559,Chow; Bennett,6,0,32,26
1657380666807,MATH 193A,A01,083224,Rotar; Vladimir,8,0,34,26
1657380666807,MATH 193A,A02,083225,Rotar; Vladimir,9,0,34,25
1657380666807,MATH 193A,A03,083781,Rotar; Vladimir,5,0,34,29
1657380666807,MATH 193A,A04,083782,Rotar; Vladimir,10,0,34,24
1657380666807,MATH 193A,A05,093482,Rotar; Vladimir,10,0,34,24
1657380672832,MATH 197,001,091859,McAuley; Julian John,9999,0,9999,0
1657380672832,MATH 197,002,095566,Kedlaya; Kiran S.,9997,0,9999,2
1657380672832,MATH 197,003,095567,Xiao; Ming,9999,0,9999,0
1657380672832,MATH 197,004,095571,Perols; Johan Lars,9998,0,9999,1
1657380679923,COGS 9,A01,083615,Shannon; Kyle Michael,9,0,75,66
1657380685948,COGS 11,A01,083617,Boyle; Mary E. T.,22,0,48,26
1657380691976,COGS 13,A01,083071,Bastos; Amalia Pinkusfeld,11,0,71,60
1657380698008,COGS 14A,A01,092681,Semenuks; Arturs,4,1,100,96
1657380704042,COGS 14B,A01,083073,Cheng; Tzu-Han,6,0,63,57
1657380710068,COGS 17,A01,092677,Semenuks; Arturs,6,0,81,75
1657380716102,COGS 100,A01,083619,Allen; Michael Gordon,17,0,70,53
1657380722130,COGS 101A,A01,083621,Davis; Joshua Daniel,9,0,68,59
1657380728169,COGS 101B,A01,091572,Allen; Michael Gordon,11,0,65,54
1657380734198,COGS 101C,A01,083625,Delgado; Tania,17,0,35,18
1657380740223,COGS 107A,A01,083627,Boyle; Mary E. T.,13,0,60,47
1657380746254,COGS 118A,A01,083075,Gupta; Anjum,20,0,76,56
1657380752367,CSE 3,A50,083646,Miranda; Gregory Joseph,24,0,50,26
1657380758392,CSE 8A,A50,083650,Miranda; Gregory Joseph,17,1,56,39
1657380764437,CSE 11,A01,083080,Cao; Yingjun,6,15,40,34
1657380770468,CSE 12,A01,083652,Krause-Levy; Sophia Louisa,28,1,120,92
1657380776494,CSE 15L,A01,083654,Morris; Justin Loren,9,0,50,41
1657380776494,CSE 15L,A02,083655,Morris; Justin Loren,9,0,50,41
1657380782522,CSE 20,A01,083657,Tran; Khoa Dang,39,0,80,41
1657380788546,CSE 21,A01,095574,Bach; Quang Tran,22,0,48,26
1657380794581,CSE 30,A01,083084,Eldon; John,4,0,80,76
1657380794581,CSE 30,B01,095061,Bhaskar; Nishant,9,0,50,41
1657380800606,CSE 100,A01,083659,Cao; Yingjun,5,4,70,65
1657380806632,CSE 134B,A01,083661,Powell; Thomas Allan,22,0,100,78
1657380812659,CSE 140,A01,083663,Gungor; Onat,14,0,85,71
1657380818688,CSE 140L,A01,083088,Eldon; John,21,0,100,79
1657380824714,CSE 175,A01,083665,Kumar; Rakesh,3,0,25,22
1657380830745,CSE 190,A00,092507,Dubnov; Shlomo,7,0,20,13
1657380836780,ECE 45,A01,083139,Congero; Spencer William,6,0,75,69
1657380842814,ECE 65,A50,083695,Saad; Andrew S,12,0,30,18
1657380842814,ECE 65,A51,095125,Saad; Andrew S,24,0,26,2
1657380848841,ECE 109,A01,091882,Touri; Behrouz,19,0,70,51
1657380854873,ECE 180,A00,083140,Abi Samra; Nicholas Camill,1,0,30,29
1657380854873,ECE 180,B00,083141,Abi Samra; Nicholas Camill,0,0,30,30
1657380860905,MATH 10A,A01,083735,Patchell; Gregory David,2,0,30,28
1657380860905,MATH 10A,A02,083736,Patchell; Gregory David,20,0,30,10
1657380860905,MATH 10A,A03,083737,Patchell; Gregory David,16,0,30,14
1657380866939,MATH 10B,A01,083207,Lim; Seonhee,8,0,34,26
1657380866939,MATH 10B,A02,083208,Lim; Seonhee,9,0,35,26
1657380866939,MATH 10B,A03,093472,Lim; Seonhee,7,0,34,27
1657380866939,MATH 10B,B01,083739,Sinha; Shubham,12,0,30,18
1657380872970,MATH 18,A01,083743,Cinel; Cameron Alexander,7,0,30,23
1657380872970,MATH 18,A02,083744,Cinel; Cameron Alexander,17,0,30,13
1657380872970,MATH 18,A03,083745,Cinel; Cameron Alexander,9,0,30,21
1657380872970,MATH 18,B01,083748,Rideout; David Porter,5,0,37,32
1657380872970,MATH 18,B02,083749,Rideout; David Porter,5,0,36,31
1657380872970,MATH 18,B03,083750,Rideout; David Porter,3,0,37,34
1657380872970,MATH 18,B04,083751,Rideout; David Porter,6,0,36,30
1657380872970,MATH 18,B05,093473,Rideout; David Porter,6,0,36,30
1657380872970,MATH 18,B06,093474,Rideout; David Porter,6,0,36,30
1657380878999,MATH 20A,A01,083754,Zheng; Zequn,14,0,40,26
1657380885025,MATH 20B,A01,083756,Briones; Jor-el Thomas Caparas,4,0,36,32
1657380885025,MATH 20B,A02,083757,Briones; Jor-el Thomas Caparas,1,0,36,35
1657380885025,MATH 20B,A03,093475,Briones; Jor-el Thomas Caparas,2,0,36,34
1657380891059,MATH 20C,A01,083760,Briones; Jor-el Thomas Caparas,1,0,35,34
1657380891059,MATH 20C,A02,083761,Briones; Jor-el Thomas Caparas,8,0,35,27
1657380891059,MATH 20C,A03,093476,Briones; Jor-el Thomas Caparas,0,1,36,36
1657380891059,MATH 20C,B01,083762,Bach; Quang Tran,1,0,30,29
1657380897092,MATH 20D,A01,083765,Tran; Brian Kha,5,0,30,25
1657380897092,MATH 20D,A02,083766,Tran; Brian Kha,5,0,30,25
1657380897092,MATH 20D,A03,083767,Tran; Brian Kha,5,0,30,25
1657380903131,MATH 20E,A01,083771,Ganguly; Soumya,9,0,32,23
1657380903131,MATH 20E,A02,083772,Ganguly; Soumya,6,0,32,26
1657380903131,MATH 20E,B01,083773,Ciotti; Benjamin,20,0,35,15
1657380903131,MATH 20E,B02,083774,Ciotti; Benjamin,17,0,35,18
1657380909162,MATH 103A,A01,083777,Greenfeld; Be'Eri,3,0,36,33
1657380909162,MATH 103A,A02,083778,Greenfeld; Be'Eri,5,0,36,31
1657380909162,MATH 103A,A03,093561,Greenfeld; Be'Eri,5,0,36,31
1657380909162,MATH 103A,B01,083779,Greenfeld; Be'Eri,7,0,36,29
1657380909162,MATH 103A,B02,083780,Greenfeld; Be'Eri,4,0,36,32
1657380909162,MATH 103A,B03,093562,Greenfeld; Be'Eri,3,0,36,33
1657380915195,MATH 105,A01,085443,Carter; Anne Toulson,15,0,35,20
1657380915195,MATH 105,A02,093477,Carter; Anne Toulson,20,0,35,15
1657380921221,MATH 109,A01,083213,Ganzberger; Geoffrey Michael,2,0,34,32
1657380921221,MATH 109,A02,083214,Ganzberger; Geoffrey Michael,4,0,34,30
1657380921221,MATH 109,A03,093478,Ganzberger; Geoffrey Michael,2,0,34,32
1657380921221,MATH 109,B01,083215,Ganzberger; Geoffrey Michael,1,0,32,31
1657380921221,MATH 109,B02,083216,Ganzberger; Geoffrey Michael,2,0,32,30
1657380921221,MATH 109,B03,093479,Ganzberger; Geoffrey Michael,8,0,32,24
1657380927247,MATH 142A,A01,083219,Chow; Bennett,7,0,32,25
1657380927247,MATH 142A,A02,083220,Chow; Bennett,10,0,32,22
1657380927247,MATH 142A,A03,093480,Chow; Bennett,8,0,32,24
1657380927247,MATH 142A,B03,093481,Chow; Bennett,8,0,32,24
1657380927247,MATH 142A,B04,093558,Chow; Bennett,13,0,32,19
1657380927247,MATH 142A,B05,093559,Chow; Bennett,6,0,32,26
1657380933280,MATH 193A,A01,083224,Rotar; Vladimir,8,0,34,26
1657380933280,MATH 193A,A02,083225,Rotar; Vladimir,9,0,34,25
1657380933280,MATH 193A,A03,083781,Rotar; Vladimir,5,0,34,29
1657380933280,MATH 193A,A04,083782,Rotar; Vladimir,10,0,34,24
1657380933280,MATH 193A,A05,093482,Rotar; Vladimir,10,0,34,24
1657380939305,MATH 197,001,091859,McAuley; Julian John,9999,0,9999,0
1657380939305,MATH 197,002,095566,Kedlaya; Kiran S.,9997,0,9999,2
1657380939305,MATH 197,003,095567,Xiao; Ming,9999,0,9999,0
1657380939305,MATH 197,004,095571,Perols; Johan Lars,9998,0,9999,1
1657380946382,COGS 9,A01,083615,Shannon; Kyle Michael,9,0,75,66
1657380952408,COGS 11,A01,083617,Boyle; Mary E. T.,22,0,48,26
1657380958440,COGS 13,A01,083071,Bastos; Amalia Pinkusfeld,11,0,71,60
1657380964467,COGS 14A,A01,092681,Semenuks; Arturs,4,1,100,96
1657380970497,COGS 14B,A01,083073,Cheng; Tzu-Han,6,0,63,57
1657380976521,COGS 17,A01,092677,Semenuks; Arturs,6,0,81,75
1657380982546,COGS 100,A01,083619,Allen; Michael Gordon,17,0,70,53
1657380988577,COGS 101A,A01,083621,Davis; Joshua Daniel,9,0,68,59
1657380994604,COGS 101B,A01,091572,Allen; Michael Gordon,11,0,65,54
1657381000630,COGS 101C,A01,083625,Delgado; Tania,17,0,35,18
1657381006654,COGS 107A,A01,083627,Boyle; Mary E. T.,13,0,60,47
1657381012684,COGS 118A,A01,083075,Gupta; Anjum,20,0,76,56
1657381018710,CSE 3,A50,083646,Miranda; Gregory Joseph,24,0,50,26
1657381024745,CSE 8A,A50,083650,Miranda; Gregory Joseph,17,1,56,39
1657381030773,CSE 11,A01,083080,Cao; Yingjun,6,15,40,34
1657381036803,CSE 12,A01,083652,Krause-Levy; Sophia Louisa,28,1,120,92
1657381042833,CSE 15L,A01,083654,Morris; Justin Loren,9,0,50,41
1657381042833,CSE 15L,A02,083655,Morris; Justin Loren,9,0,50,41
1657381048860,CSE 20,A01,083657,Tran; Khoa Dang,39,0,80,41
1657381054890,CSE 21,A01,095574,Bach; Quang Tran,22,0,48,26
1657381060916,CSE 30,A01,083084,Eldon; John,4,0,80,76
1657381060916,CSE 30,B01,095061,Bhaskar; Nishant,9,0,50,41
1657381066944,CSE 100,A01,083659,Cao; Yingjun,5,4,70,65
1657381072969,CSE 134B,A01,083661,Powell; Thomas Allan,22,0,100,78
1657381078994,CSE 140,A01,083663,Gungor; Onat,14,0,85,71
1657381085020,CSE 140L,A01,083088,Eldon; John,21,0,100,79
1657381091047,CSE 175,A01,083665,Kumar; Rakesh,3,0,25,22
1657381097071,CSE 190,A00,092507,Dubnov; Shlomo,7,0,20,13
1657381103099,ECE 45,A01,083139,Congero; Spencer William,6,0,75,69
1657381109123,ECE 65,A50,083695,Saad; Andrew S,12,0,30,18
1657381109123,ECE 65,A51,095125,Saad; Andrew S,24,0,26,2
1657381115150,ECE 109,A01,091882,Touri; Behrouz,19,0,70,51
1657381121177,ECE 180,A00,083140,Abi Samra; Nicholas Camill,1,0,30,29
1657381121177,ECE 180,B00,083141,Abi Samra; Nicholas Camill,0,0,30,30
1657381127211,MATH 10A,A01,083735,Patchell; Gregory David,2,0,30,28
1657381127211,MATH 10A,A02,083736,Patchell; Gregory David,20,0,30,10
1657381127211,MATH 10A,A03,083737,Patchell; Gregory David,16,0,30,14
1657381133246,MATH 10B,A01,083207,Lim; Seonhee,8,0,34,26
1657381133246,MATH 10B,A02,083208,Lim; Seonhee,9,0,35,26
1657381133246,MATH 10B,A03,093472,Lim; Seonhee,7,0,34,27
1657381133246,MATH 10B,B01,083739,Sinha; Shubham,12,0,30,18
1657381139274,MATH 18,A01,083743,Cinel; Cameron Alexander,7,0,30,23
1657381139274,MATH 18,A02,083744,Cinel; Cameron Alexander,17,0,30,13
1657381139274,MATH 18,A03,083745,Cinel; Cameron Alexander,9,0,30,21
1657381139274,MATH 18,B01,083748,Rideout; David Porter,5,0,37,32
1657381139274,MATH 18,B02,083749,Rideout; David Porter,5,0,36,31
1657381139274,MATH 18,B03,083750,Rideout; David Porter,3,0,37,34
1657381139274,MATH 18,B04,083751,Rideout; David Porter,6,0,36,30
1657381139274,MATH 18,B05,093473,Rideout; David Porter,6,0,36,30
1657381139274,MATH 18,B06,093474,Rideout; David Porter,6,0,36,30
1657381145305,MATH 20A,A01,083754,Zheng; Zequn,14,0,40,26
1657381151337,MATH 20B,A01,083756,Briones; Jor-el Thomas Caparas,4,0,36,32
1657381151337,MATH 20B,A02,083757,Briones; Jor-el Thomas Caparas,1,0,36,35
1657381151337,MATH 20B,A03,093475,Briones; Jor-el Thomas Caparas,2,0,36,34
1657381157362,MATH 20C,A01,083760,Briones; Jor-el Thomas Caparas,1,0,35,34
1657381157362,MATH 20C,A02,083761,Briones; Jor-el Thomas Caparas,8,0,35,27
1657381157362,MATH 20C,A03,093476,Briones; Jor-el Thomas Caparas,0,1,36,36
1657381157362,MATH 20C,B01,083762,Bach; Quang Tran,1,0,30,29
1657381163390,MATH 20D,A01,083765,Tran; Brian Kha,5,0,30,25
1657381163390,MATH 20D,A02,083766,Tran; Brian Kha,5,0,30,25
1657381163390,MATH 20D,A03,083767,Tran; Brian Kha,5,0,30,25
1657381169434,MATH 20E,A01,083771,Ganguly; Soumya,9,0,32,23
1657381169434,MATH 20E,A02,083772,Ganguly; Soumya,6,0,32,26
1657381169434,MATH 20E,B01,083773,Ciotti; Benjamin,20,0,35,15
1657381169434,MATH 20E,B02,083774,Ciotti; Benjamin,17,0,35,18
1657381175462,MATH 103A,A01,083777,Greenfeld; Be'Eri,3,0,36,33
1657381175462,MATH 103A,A02,083778,Greenfeld; Be'Eri,5,0,36,31
1657381175462,MATH 103A,A03,093561,Greenfeld; Be'Eri,5,0,36,31
1657381175462,MATH 103A,B01,083779,Greenfeld; Be'Eri,7,0,36,29
1657381175462,MATH 103A,B02,083780,Greenfeld; Be'Eri,4,0,36,32
1657381175462,MATH 103A,B03,093562,Greenfeld; Be'Eri,3,0,36,33
1657381181493,MATH 105,A01,085443,Carter; Anne Toulson,15,0,35,20
1657381181493,MATH 105,A02,093477,Carter; Anne Toulson,20,0,35,15
1657381187519,MATH 109,A01,083213,Ganzberger; Geoffrey Michael,2,0,34,32
1657381187519,MATH 109,A02,083214,Ganzberger; Geoffrey Michael,4,0,34,30
1657381187519,MATH 109,A03,093478,Ganzberger; Geoffrey Michael,2,0,34,32
1657381187519,MATH 109,B01,083215,Ganzberger; Geoffrey Michael,1,0,32,31
1657381187519,MATH 109,B02,083216,Ganzberger; Geoffrey Michael,2,0,32,30
1657381187519,MATH 109,B03,093479,Ganzberger; Geoffrey Michael,8,0,32,24
1657381193545,MATH 142A,A01,083219,Chow; Bennett,7,0,32,25
1657381193545,MATH 142A,A02,083220,Chow; Bennett,10,0,32,22
1657381193545,MATH 142A,A03,093480,Chow; Bennett,8,0,32,24
1657381193545,MATH 142A,B03,093481,Chow; Bennett,8,0,32,24
1657381193545,MATH 142A,B04,093558,Chow; Bennett,13,0,32,19
1657381193545,MATH 142A,B05,093559,Chow; Bennett,6,0,32,26
1657381199577,MATH 193A,A01,083224,Rotar; Vladimir,8,0,34,26
1657381199577,MATH 193A,A02,083225,Rotar; Vladimir,9,0,34,25
1657381199577,MATH 193A,A03,083781,Rotar; Vladimir,5,0,34,29
1657381199577,MATH 193A,A04,083782,Rotar; Vladimir,10,0,34,24
1657381199577,MATH 193A,A05,093482,Rotar; Vladimir,10,0,34,24
1657381205607,MATH 197,001,091859,McAuley; Julian John,9999,0,9999,0
1657381205607,MATH 197,002,095566,Kedlaya; Kiran S.,9997,0,9999,2
1657381205607,MATH 197,003,095567,Xiao; Ming,9999,0,9999,0
1657381205607,MATH 197,004,095571,Perols; Johan Lars,9998,0,9999,1
1657381212670,COGS 9,A01,083615,Shannon; Kyle Michael,9,0,75,66
1657381218694,COGS 11,A01,083617,Boyle; Mary E. T.,22,0,48,26
1657381224718,COGS 13,A01,083071,Bastos; Amalia Pinkusfeld,11,0,71,60
1657381230794,COGS 14A,A01,092681,Semenuks; Arturs,4,1,100,96
1657381237032,COGS 14B,A01,083073,Cheng; Tzu-Han,6,0,63,57
1657381243585,COGS 17,A01,092677,Semenuks; Arturs,6,0,81,75
1657381250263,COGS 100,A01,083619,Allen; Michael Gordon,17,0,70,53
1657381256546,COGS 101A,A01,083621,Davis; Joshua Daniel,9,0,68,59
1657381262725,COGS 101B,A01,091572,Allen; Michael Gordon,11,0,65,54
1657381269530,COGS 101C,A01,083625,Delgado; Tania,17,0,35,18
1657381276442,COGS 107A,A01,083627,Boyle; Mary E. T.,13,0,60,47
1657381283036,COGS 118A,A01,083075,Gupta; Anjum,20,0,76,56
1657381290438,CSE 3,A50,083646,Miranda; Gregory Joseph,24,0,50,26
1657381297271,CSE 8A,A50,083650,Miranda; Gregory Joseph,17,1,56,39
1657381303778,CSE 11,A01,083080,Cao; Yingjun,6,15,40,34
1657381310527,CSE 12,A01,083652,Krause-Levy; Sophia Louisa,28,1,120,92
1657381317047,CSE 15L,A01,083654,Morris; Justin Loren,9,0,50,41
1657381317047,CSE 15L,A02,083655,Morris; Justin Loren,9,0,50,41
1657381323460,CSE 20,A01,083657,Tran; Khoa Dang,39,0,80,41
1657381330026,CSE 21,A01,095574,Bach; Quang Tran,22,0,48,26
1657381336679,CSE 30,A01,083084,Eldon; John,4,0,80,76
1657381336679,CSE 30,B01,095061,Bhaskar; Nishant,9,0,50,41
1657381343284,CSE 100,A01,083659,Cao; Yingjun,5,4,70,65
1657381349589,CSE 134B,A01,083661,Powell; Thomas Allan,22,0,100,78
1657381356323,CSE 140,A01,083663,Gungor; Onat,14,0,85,71
1657381363782,CSE 140L,A01,083088,Eldon; John,21,0,100,79
1657381370746,CSE 175,A01,083665,Kumar; Rakesh,3,0,25,22
1657381377229,CSE 190,A00,092507,Dubnov; Shlomo,7,0,20,13
1657381384613,ECE 45,A01,083139,Congero; Spencer William,6,0,75,69
1657381391312,ECE 65,A50,083695,Saad; Andrew S,12,0,30,18
1657381391312,ECE 65,A51,095125,Saad; Andrew S,24,0,26,2
1657381397626,ECE 109,A01,091882,Touri; Behrouz,19,0,70,51
1657381404303,ECE 180,A00,083140,Abi Samra; Nicholas Camill,1,0,30,29
1657381404303,ECE 180,B00,083141,Abi Samra; Nicholas Camill,0,0,30,30
1657381411075,MATH 10A,A01,083735,Patchell; Gregory David,2,0,30,28
1657381411075,MATH 10A,A02,083736,Patchell; Gregory David,20,0,30,10
1657381411075,MATH 10A,A03,083737,Patchell; Gregory David,16,0,30,14
1657381417925,MATH 10B,A01,083207,Lim; Seonhee,8,0,34,26
1657381417925,MATH 10B,A02,083208,Lim; Seonhee,9,0,35,26
1657381417925,MATH 10B,A03,093472,Lim; Seonhee,7,0,34,27
1657381417925,MATH 10B,B01,083739,Sinha; Shubham,12,0,30,18
1657381424223,MATH 18,A01,083743,Cinel; Cameron Alexander,7,0,30,23
1657381424223,MATH 18,A02,083744,Cinel; Cameron Alexander,17,0,30,13
1657381424223,MATH 18,A03,083745,Cinel; Cameron Alexander,9,0,30,21
1657381424223,MATH 18,B01,083748,Rideout; David Porter,5,0,37,32
1657381424223,MATH 18,B02,083749,Rideout; David Porter,5,0,36,31
1657381424223,MATH 18,B03,083750,Rideout; David Porter,3,0,37,34
1657381424223,MATH 18,B04,083751,Rideout; David Porter,6,0,36,30
1657381424223,MATH 18,B05,093473,Rideout; David Porter,6,0,36,30
1657381424223,MATH 18,B06,093474,Rideout; David Porter,6,0,36,30
1657381430717,MATH 20A,A01,083754,Zheng; Zequn,14,0,40,26
1657381436888,MATH 20B,A01,083756,Briones; Jor-el Thomas Caparas,4,0,36,32
1657381436888,MATH 20B,A02,083757,Briones; Jor-el Thomas Caparas,1,0,36,35
1657381436888,MATH 20B,A03,093475,Briones; Jor-el Thomas Caparas,2,0,36,34
1657381443030,MATH 20C,A01,083760,Briones; Jor-el Thomas Caparas,1,0,35,34
1657381443030,MATH 20C,A02,083761,Briones; Jor-el Thomas Caparas,8,0,35,27
1657381443030,MATH 20C,A03,093476,Briones; Jor-el Thomas Caparas,0,1,36,36
1657381443030,MATH 20C,B01,083762,Bach; Quang Tran,1,0,30,29
1657381449427,MATH 20D,A01,083765,Tran; Brian Kha,5,0,30,25
1657381449427,MATH 20D,A02,083766,Tran; Brian Kha,5,0,30,25
1657381449427,MATH 20D,A03,083767,Tran; Brian Kha,5,0,30,25
1657381456348,MATH 20E,A01,083771,Ganguly; Soumya,9,0,32,23
1657381456348,MATH 20E,A02,083772,Ganguly; Soumya,6,0,32,26
1657381456348,MATH 20E,B01,083773,Ciotti; Benjamin,20,0,35,15
1657381456348,MATH 20E,B02,083774,Ciotti; Benjamin,17,0,35,18
1657381462705,MATH 103A,A01,083777,Greenfeld; Be'Eri,3,0,36,33
1657381462705,MATH 103A,A02,083778,Greenfeld; Be'Eri,5,0,36,31
1657381462705,MATH 103A,A03,093561,Greenfeld; Be'Eri,5,0,36,31
1657381462705,MATH 103A,B01,083779,Greenfeld; Be'Eri,7,0,36,29
1657381462705,MATH 103A,B02,083780,Greenfeld; Be'Eri,4,0,36,32
1657381462705,MATH 103A,B03,093562,Greenfeld; Be'Eri,3,0,36,33
1657381469215,MATH 105,A01,085443,Carter; Anne Toulson,15,0,35,20
1657381469215,MATH 105,A02,093477,Carter; Anne Toulson,20,0,35,15
1657381476117,MATH 109,A01,083213,Ganzberger; Geoffrey Michael,2,0,34,32
1657381476117,MATH 109,A02,083214,Ganzberger; Geoffrey Michael,4,0,34,30
1657381476117,MATH 109,A03,093478,Ganzberger; Geoffrey Michael,2,0,34,32
1657381476117,MATH 109,B01,083215,Ganzberger; Geoffrey Michael,1,0,32,31
1657381476117,MATH 109,B02,083216,Ganzberger; Geoffrey Michael,2,0,32,30
1657381476117,MATH 109,B03,093479,Ganzberger; Geoffrey Michael,8,0,32,24
1657381482806,MATH 142A,A01,083219,Chow; Bennett,7,0,32,25
1657381482806,MATH 142A,A02,083220,Chow; Bennett,10,0,32,22
1657381482806,MATH 142A,A03,093480,Chow; Bennett,8,0,32,24
1657381482806,MATH 142A,B03,093481,Chow; Bennett,8,0,32,24
1657381482806,MATH 142A,B04,093558,Chow; Bennett,13,0,32,19
1657381482806,MATH 142A,B05,093559,Chow; Bennett,6,0,32,26
1657381489192,MATH 193A,A01,083224,Rotar; Vladimir,8,0,34,26
1657381489192,MATH 193A,A02,083225,Rotar; Vladimir,9,0,34,25
1657381489192,MATH 193A,A03,083781,Rotar; Vladimir,5,0,34,29
1657381489192,MATH 193A,A04,083782,Rotar; Vladimir,10,0,34,24
1657381489192,MATH 193A,A05,093482,Rotar; Vladimir,10,0,34,24
1657381495435,MATH 197,001,091859,McAuley; Julian John,9999,0,9999,0
1657381495435,MATH 197,002,095566,Kedlaya; Kiran S.,9997,0,9999,2
1657381495435,MATH 197,003,095567,Xiao; Ming,9999,0,9999,0
1657381495435,MATH 197,004,095571,Perols; Johan Lars,9998,0,9999,1
1657381504689,COGS 9,A01,083615,Shannon; Kyle Michael,9,0,75,66
1657381511688,COGS 11,A01,083617,Boyle; Mary E. T.,22,0,48,26
1657381519267,COGS 13,A01,083071,Bastos; Amalia Pinkusfeld,11,0,71,60
1657381526322,COGS 14A,A01,092681,Semenuks; Arturs,4,1,100,96
1657381532679,COGS 14B,A01,083073,Cheng; Tzu-Han,6,0,63,57
1657381539015,COGS 17,A01,092677,Semenuks; Arturs,6,0,81,75
1657381545316,COGS 100,A01,083619,Allen; Michael Gordon,17,0,70,53
1657381551952,COGS 101A,A01,083621,Davis; Joshua Daniel,9,0,68,59
1657381558158,COGS 101B,A01,091572,Allen; Michael Gordon,11,0,65,54
1657381564456,COGS 101C,A01,083625,Delgado; Tania,17,0,35,18
1657381570969,COGS 107A,A01,083627,Boyle; Mary E. T.,13,0,60,47
1657381577160,COGS 118A,A01,083075,Gupta; Anjum,20,0,76,56
1657381583766,CSE 3,A50,083646,Miranda; Gregory Joseph,24,0,50,26
1657381589975,CSE 8A,A50,083650,Miranda; Gregory Joseph,17,1,56,39
1657381596476,CSE 11,A01,083080,Cao; Yingjun,6,15,40,34
1657381602851,CSE 12,A01,083652,Krause-Levy; Sophia Louisa,28,1,120,92
1657381609355,CSE 15L,A01,083654,Morris; Justin Loren,9,0,50,41
1657381609355,CSE 15L,A02,083655,Morris; Justin Loren,9,0,50,41
1657381615515,CSE 20,A01,083657,Tran; Khoa Dang,39,0,80,41
1657381621818,CSE 21,A01,095574,Bach; Quang Tran,22,0,48,26
1657381627955,CSE 30,A01,083084,Eldon; John,4,0,80,76
1657381627955,CSE 30,B01,095061,Bhaskar; Nishant,9,0,50,41
1657381634189,CSE 100,A01,083659,Cao; Yingjun,5,4,70,65
1657381640723,CSE 134B,A01,083661,Powell; Thomas Allan,22,0,100,78
1657381647289,CSE 140,A01,083663,Gungor; Onat,14,0,85,71
1657381653622,CSE 140L,A01,083088,Eldon; John,21,0,100,79
1657381659740,CSE 175,A01,083665,Kumar; Rakesh,3,0,25,22
1657381665989,CSE 190,A00,092507,Dubnov; Shlomo,7,0,20,13
1657381672359,ECE 45,A01,083139,Congero; Spencer William,6,0,75,69
1657381678609,ECE 65,A50,083695,Saad; Andrew S,12,0,30,18
1657381678609,ECE 65,A51,095125,Saad; Andrew S,24,0,26,2
1657381684947,ECE 109,A01,091882,Touri; Behrouz,19,0,70,51
1657381691260,ECE 180,A00,083140,Abi Samra; Nicholas Camill,1,0,30,29
1657381691260,ECE 180,B00,083141,Abi Samra; Nicholas Camill,0,0,30,30
1657381697391,MATH 10A,A01,083735,Patchell; Gregory David,2,0,30,28
1657381697391,MATH 10A,A02,083736,Patchell; Gregory David,20,0,30,10
1657381697391,MATH 10A,A03,083737,Patchell; Gregory David,16,0,30,14
1657381703668,MATH 10B,A01,083207,Lim; Seonhee,8,0,34,26
1657381703668,MATH 10B,A02,083208,Lim; Seonhee,9,0,35,26
1657381703668,MATH 10B,A03,093472,Lim; Seonhee,7,0,34,27
1657381703668,MATH 10B,B01,083739,Sinha; Shubham,12,0,30,18
1657381709978,MATH 18,A01,083743,Cinel; Cameron Alexander,7,0,30,23
1657381709978,MATH 18,A02,083744,Cinel; Cameron Alexander,17,0,30,13
1657381709978,MATH 18,A03,083745,Cinel; Cameron Alexander,9,0,30,21
1657381709978,MATH 18,B01,083748,Rideout; David Porter,5,0,37,32
1657381709978,MATH 18,B02,083749,Rideout; David Porter,5,0,36,31
1657381709978,MATH 18,B03,083750,Rideout; David Porter,3,0,37,34
1657381709978,MATH 18,B04,083751,Rideout; David Porter,6,0,36,30
1657381709978,MATH 18,B05,093473,Rideout; David Porter,6,0,36,30
1657381709978,MATH 18,B06,093474,Rideout; David Porter,6,0,36,30
1657381716202,MATH 20A,A01,083754,Zheng; Zequn,14,0,40,26
1657381722725,MATH 20B,A01,083756,Briones; Jor-el Thomas Caparas,4,0,36,32
1657381722725,MATH 20B,A02,083757,Briones; Jor-el Thomas Caparas,1,0,36,35
1657381722725,MATH 20B,A03,093475,Briones; Jor-el Thomas Caparas,2,0,36,34
1657381729622,MATH 20C,A01,083760,Briones; Jor-el Thomas Caparas,1,0,35,34
1657381729622,MATH 20C,A02,083761,Briones; Jor-el Thomas Caparas,8,0,35,27
1657381729622,MATH 20C,A03,093476,Briones; Jor-el Thomas Caparas,0,1,36,36
1657381729622,MATH 20C,B01,083762,Bach; Quang Tran,1,0,30,29
1657381736582,MATH 20D,A01,083765,Tran; Brian Kha,5,0,30,25
1657381736582,MATH 20D,A02,083766,Tran; Brian Kha,5,0,30,25
1657381736582,MATH 20D,A03,083767,Tran; Brian Kha,5,0,30,25
1657381743097,MATH 20E,A01,083771,Ganguly; Soumya,9,0,32,23
1657381743097,MATH 20E,A02,083772,Ganguly; Soumya,6,0,32,26
1657381743097,MATH 20E,B01,083773,Ciotti; Benjamin,20,0,35,15
1657381743097,MATH 20E,B02,083774,Ciotti; Benjamin,17,0,35,18
1657381749771,MATH 103A,A01,083777,Greenfeld; Be'Eri,3,0,36,33
1657381749771,MATH 103A,A02,083778,Greenfeld; Be'Eri,5,0,36,31
1657381749771,MATH 103A,A03,093561,Greenfeld; Be'Eri,5,0,36,31
1657381749771,MATH 103A,B01,083779,Greenfeld; Be'Eri,7,0,36,29
1657381749771,MATH 103A,B02,083780,Greenfeld; Be'Eri,4,0,36,32
1657381749771,MATH 103A,B03,093562,Greenfeld; Be'Eri,3,0,36,33
1657381756269,MATH 105,A01,085443,Carter; Anne Toulson,15,0,35,20
1657381756269,MATH 105,A02,093477,Carter; Anne Toulson,20,0,35,15
1657381762917,MATH 109,A01,083213,Ganzberger; Geoffrey Michael,2,0,34,32
1657381762917,MATH 109,A02,083214,Ganzberger; Geoffrey Michael,4,0,34,30
1657381762917,MATH 109,A03,093478,Ganzberger; Geoffrey Michael,2,0,34,32
1657381762917,MATH 109,B01,083215,Ganzberger; Geoffrey Michael,1,0,32,31
1657381762917,MATH 109,B02,083216,Ganzberger; Geoffrey Michael,2,0,32,30
1657381762917,MATH 109,B03,093479,Ganzberger; Geoffrey Michael,8,0,32,24
1657381770116,MATH 142A,A01,083219,Chow; Bennett,7,0,32,25
1657381770116,MATH 142A,A02,083220,Chow; Bennett,10,0,32,22
1657381770116,MATH 142A,A03,093480,Chow; Bennett,8,0,32,24
1657381770116,MATH 142A,B03,093481,Chow; Bennett,8,0,32,24
1657381770116,MATH 142A,B04,093558,Chow; Bennett,13,0,32,19
1657381770116,MATH 142A,B05,093559,Chow; Bennett,6,0,32,26
1657381777816,MATH 193A,A01,083224,Rotar; Vladimir,8,0,34,26
1657381777816,MATH 193A,A02,083225,Rotar; Vladimir,9,0,34,25
1657381777816,MATH 193A,A03,083781,Rotar; Vladimir,5,0,34,29
1657381777816,MATH 193A,A04,083782,Rotar; Vladimir,10,0,34,24
1657381777816,MATH 193A,A05,093482,Rotar; Vladimir,10,0,34,24
1657381785489,MATH 197,001,091859,McAuley; Julian John,9999,0,9999,0
1657381785489,MATH 197,002,095566,Kedlaya; Kiran S.,9997,0,9999,2
1657381785489,MATH 197,003,095567,Xiao; Ming,9999,0,9999,0
1657381785489,MATH 197,004,095571,Perols; Johan Lars,9998,0,9999,1
1657381794406,COGS 9,A01,083615,Shannon; Kyle Michael,9,0,75,66
1657381801408,COGS 11,A01,083617,Boyle; Mary E. T.,22,0,48,26
1657381807775,COGS 13,A01,083071,Bastos; Amalia Pinkusfeld,11,0,71,60
1657381814423,COGS 14A,A01,092681,Semenuks; Arturs,4,1,100,96
1657381820914,COGS 14B,A01,083073,Cheng; Tzu-Han,6,0,63,57
1657381827282,COGS 17,A01,092677,Semenuks; Arturs,6,0,81,75
1657381833952,COGS 100,A01,083619,Allen; Michael Gordon,17,0,70,53
1657381840590,COGS 101A,A01,083621,Davis; Joshua Daniel,9,0,68,59
1657381847471,COGS 101B,A01,091572,Allen; Michael Gordon,11,0,65,54
1657381853571,COGS 101C,A01,083625,Delgado; Tania,17,0,35,18
1657381859958,COGS 107A,A01,083627,Boyle; Mary E. T.,13,0,60,47
1657381866090,COGS 118A,A01,083075,Gupta; Anjum,20,0,76,56
1657381872530,CSE 3,A50,083646,Miranda; Gregory Joseph,24,0,50,26
1657381879316,CSE 8A,A50,083650,Miranda; Gregory Joseph,17,1,56,39
1657381886443,CSE 11,A01,083080,Cao; Yingjun,6,15,40,34
1657381893032,CSE 12,A01,083652,Krause-Levy; Sophia Louisa,28,1,120,92
1657381900010,CSE 15L,A01,083654,Morris; Justin Loren,9,0,50,41
1657381900010,CSE 15L,A02,083655,Morris; Justin Loren,9,0,50,41
1657381906181,CSE 20,A01,083657,Tran; Khoa Dang,39,0,80,41
1657381912865,CSE 21,A01,095574,Bach; Quang Tran,22,0,48,26
1657381919640,CSE 30,A01,083084,Eldon; John,4,0,80,76
1657381919640,CSE 30,B01,095061,Bhaskar; Nishant,9,0,50,41
1657381926603,CSE 100,A01,083659,Cao; Yingjun,5,4,70,65
1657381932940,CSE 134B,A01,083661,Powell; Thomas Allan,22,0,100,78
1657381939450,CSE 140,A01,083663,Gungor; Onat,14,0,85,71
1657381945887,CSE 140L,A01,083088,Eldon; John,21,0,100,79
1657381952413,CSE 175,A01,083665,Kumar; Rakesh,3,0,25,22
1657381958516,CSE 190,A00,092507,Dubnov; Shlomo,7,0,20,13
1657381964907,ECE 45,A01,083139,Congero; Spencer William,6,0,75,69
1657381971690,ECE 65,A50,083695,Saad; Andrew S,12,0,30,18
1657381971690,ECE 65,A51,095125,Saad; Andrew S,24,0,26,2
1657381978116,ECE 109,A01,091882,Touri; Behrouz,19,0,70,51
1657381984734,ECE 180,A00,083140,Abi Samra; Nicholas Camill,1,0,30,29
1657381984734,ECE 180,B00,083141,Abi Samra; Nicholas Camill,0,0,30,30
1657381991761,MATH 10A,A01,083735,Patchell; Gregory David,2,0,30,28
1657381991761,MATH 10A,A02,083736,Patchell; Gregory David,20,0,30,10
1657381991761,MATH 10A,A03,083737,Patchell; Gregory David,16,0,30,14
1657381998677,MATH 10B,A01,083207,Lim; Seonhee,8,0,34,26
1657381998677,MATH 10B,A02,083208,Lim; Seonhee,9,0,35,26
1657381998677,MATH 10B,A03,093472,Lim; Seonhee,7,0,34,27
1657381998677,MATH 10B,B01,083739,Sinha; Shubham,12,0,30,18
1657382005529,MATH 18,A01,083743,Cinel; Cameron Alexander,7,0,30,23
1657382005529,MATH 18,A02,083744,Cinel; Cameron Alexander,17,0,30,13
1657382005529,MATH 18,A03,083745,Cinel; Cameron Alexander,9,0,30,21
1657382005529,MATH 18,B01,083748,Rideout; David Porter,5,0,37,32
1657382005529,MATH 18,B02,083749,Rideout; David Porter,5,0,36,31
1657382005529,MATH 18,B03,083750,Rideout; David Porter,3,0,37,34
1657382005529,MATH 18,B04,083751,Rideout; David Porter,6,0,36,30
1657382005529,MATH 18,B05,093473,Rideout; David Porter,6,0,36,30
1657382005529,MATH 18,B06,093474,Rideout; David Porter,6,0,36,30
1657382012216,MATH 20A,A01,083754,Zheng; Zequn,14,0,40,26
1657382021712,MATH 20B,A01,083756,Briones; Jor-el Thomas Caparas,4,0,36,32
1657382021712,MATH 20B,A02,083757,Briones; Jor-el Thomas Caparas,1,0,36,35
1657382021712,MATH 20B,A03,093475,Briones; Jor-el Thomas Caparas,2,0,36,34
1657382028069,MATH 20C,A01,083760,Briones; Jor-el Thomas Caparas,1,0,35,34
1657382028069,MATH 20C,A02,083761,Briones; Jor-el Thomas Caparas,8,0,35,27
1657382028069,MATH 20C,A03,093476,Briones; Jor-el Thomas Caparas,0,1,36,36
1657382028069,MATH 20C,B01,083762,Bach; Quang Tran,1,0,30,29
1657382035051,MATH 20D,A01,083765,Tran; Brian Kha,5,0,30,25
1657382035051,MATH 20D,A02,083766,Tran; Brian Kha,5,0,30,25
1657382035051,MATH 20D,A03,083767,Tran; Brian Kha,5,0,30,25
1657382041375,MATH 20E,A01,083771,Ganguly; Soumya,9,0,32,23
1657382041375,MATH 20E,A02,083772,Ganguly; Soumya,6,0,32,26
1657382041375,MATH 20E,B01,083773,Ciotti; Benjamin,20,0,35,15
1657382041375,MATH 20E,B02,083774,Ciotti; Benjamin,17,0,35,18
1657382047790,MATH 103A,A01,083777,Greenfeld; Be'Eri,3,0,36,33
1657382047790,MATH 103A,A02,083778,Greenfeld; Be'Eri,5,0,36,31
1657382047790,MATH 103A,A03,093561,Greenfeld; Be'Eri,5,0,36,31
1657382047790,MATH 103A,B01,083779,Greenfeld; Be'Eri,7,0,36,29
1657382047790,MATH 103A,B02,083780,Greenfeld; Be'Eri,4,0,36,32
1657382047790,MATH 103A,B03,093562,Greenfeld; Be'Eri,3,0,36,33
1657382054220,MATH 105,A01,085443,Carter; Anne Toulson,15,0,35,20
1657382054220,MATH 105,A02,093477,Carter; Anne Toulson,20,0,35,15
1657382061085,MATH 109,A01,083213,Ganzberger; Geoffrey Michael,2,0,34,32
1657382061085,MATH 109,A02,083214,Ganzberger; Geoffrey Michael,4,0,34,30
1657382061085,MATH 109,A03,093478,Ganzberger; Geoffrey Michael,2,0,34,32
1657382061085,MATH 109,B01,083215,Ganzberger; Geoffrey Michael,1,0,32,31
1657382061085,MATH 109,B02,083216,Ganzberger; Geoffrey Michael,2,0,32,30
1657382061085,MATH 109,B03,093479,Ganzberger; Geoffrey Michael,8,0,32,24
1657382067466,MATH 142A,A01,083219,Chow; Bennett,7,0,32,25
1657382067466,MATH 142A,A02,083220,Chow; Bennett,10,0,32,22
1657382067466,MATH 142A,A03,093480,Chow; Bennett,8,0,32,24
1657382067466,MATH 142A,B03,093481,Chow; Bennett,8,0,32,24
1657382067466,MATH 142A,B04,093558,Chow; Bennett,13,0,32,19
1657382067466,MATH 142A,B05,093559,Chow; Bennett,6,0,32,26
1657382073736,MATH 193A,A01,083224,Rotar; Vladimir,8,0,34,26
1657382073736,MATH 193A,A02,083225,Rotar; Vladimir,9,0,34,25
1657382073736,MATH 193A,A03,083781,Rotar; Vladimir,5,0,34,29
1657382073736,MATH 193A,A04,083782,Rotar; Vladimir,10,0,34,24
1657382073736,MATH 193A,A05,093482,Rotar; Vladimir,10,0,34,24
1657382080543,MATH 197,001,091859,McAuley; Julian John,9999,0,9999,0
1657382080543,MATH 197,002,095566,Kedlaya; Kiran S.,9997,0,9999,2
1657382080543,MATH 197,003,095567,Xiao; Ming,9999,0,9999,0
1657382080543,MATH 197,004,095571,Perols; Johan Lars,9998,0,9999,1
1657382088892,COGS 9,A01,083615,Shannon; Kyle Michael,9,0,75,66
1657382095494,COGS 11,A01,083617,Boyle; Mary E. T.,22,0,48,26
1657382101954,COGS 13,A01,083071,Bastos; Amalia Pinkusfeld,11,0,71,60
1657382108414,COGS 14A,A01,092681,Semenuks; Arturs,4,1,100,96
1657382114991,COGS 14B,A01,083073,Cheng; Tzu-Han,6,0,63,57
1657382121778,COGS 17,A01,092677,Semenuks; Arturs,6,0,81,75
1657382128210,COGS 100,A01,083619,Allen; Michael Gordon,17,0,70,53
1657382134883,COGS 101A,A01,083621,Davis; Joshua Daniel,9,0,68,59
1657382141284,COGS 101B,A01,091572,Allen; Michael Gordon,11,0,65,54
1657382147483,COGS 101C,A01,083625,Delgado; Tania,17,0,35,18
1657382153761,COGS 107A,A01,083627,Boyle; Mary E. T.,13,0,60,47
1657382160185,COGS 118A,A01,083075,Gupta; Anjum,20,0,76,56
1657382166706,CSE 3,A50,083646,Miranda; Gregory Joseph,24,0,50,26
1657382173188,CSE 8A,A50,083650,Miranda; Gregory Joseph,17,1,56,39
1657382179912,CSE 11,A01,083080,Cao; Yingjun,6,15,40,34
1657382186385,CSE 12,A01,083652,Krause-Levy; Sophia Louisa,28,1,120,92
1657382193604,CSE 15L,A01,083654,Morris; Justin Loren,9,0,50,41
1657382193604,CSE 15L,A02,083655,Morris; Justin Loren,9,0,50,41
1657382200080,CSE 20,A01,083657,Tran; Khoa Dang,39,0,80,41
1657382206699,CSE 21,A01,095574,Bach; Quang Tran,22,0,48,26
1657382213345,CSE 30,A01,083084,Eldon; John,4,0,80,76
1657382213345,CSE 30,B01,095061,Bhaskar; Nishant,9,0,50,41
1657382219640,CSE 100,A01,083659,Cao; Yingjun,5,4,70,65
1657382226457,CSE 134B,A01,083661,Powell; Thomas Allan,22,0,100,78
1657382232855,CSE 140,A01,083663,Gungor; Onat,14,0,85,71
1657382239051,CSE 140L,A01,083088,Eldon; John,21,0,100,79
1657382245516,CSE 175,A01,083665,Kumar; Rakesh,3,0,25,22
1657382252611,CSE 190,A00,092507,Dubnov; Shlomo,7,0,20,13
1657382260252,ECE 45,A01,083139,Congero; Spencer William,6,0,75,69
1657382267015,ECE 65,A50,083695,Saad; Andrew S,12,0,30,18
1657382267015,ECE 65,A51,095125,Saad; Andrew S,24,0,26,2
1657382273887,ECE 109,A01,091882,Touri; Behrouz,19,0,70,51
1657382280644,ECE 180,A00,083140,Abi Samra; Nicholas Camill,1,0,30,29
1657382280644,ECE 180,B00,083141,Abi Samra; Nicholas Camill,0,0,30,30
1657382287064,MATH 10A,A01,083735,Patchell; Gregory David,2,0,30,28
1657382287064,MATH 10A,A02,083736,Patchell; Gregory David,20,0,30,10
1657382287064,MATH 10A,A03,083737,Patchell; Gregory David,16,0,30,14
1657382293441,MATH 10B,A01,083207,Lim; Seonhee,8,0,34,26
1657382293441,MATH 10B,A02,083208,Lim; Seonhee,9,0,35,26
1657382293441,MATH 10B,A03,093472,Lim; Seonhee,7,0,34,27
1657382293441,MATH 10B,B01,083739,Sinha; Shubham,12,0,30,18
1657382300196,MATH 18,A01,083743,Cinel; Cameron Alexander,7,0,30,23
1657382300196,MATH 18,A02,083744,Cinel; Cameron Alexander,17,0,30,13
1657382300196,MATH 18,A03,083745,Cinel; Cameron Alexander,9,0,30,21
1657382300196,MATH 18,B01,083748,Rideout; David Porter,5,0,37,32
1657382300196,MATH 18,B02,083749,Rideout; David Porter,5,0,36,31
1657382300196,MATH 18,B03,083750,Rideout; David Porter,3,0,37,34
1657382300196,MATH 18,B04,083751,Rideout; David Porter,6,0,36,30
1657382300196,MATH 18,B05,093473,Rideout; David Porter,6,0,36,30
1657382300196,MATH 18,B06,093474,Rideout; David Porter,6,0,36,30
1657382306788,MATH 20A,A01,083754,Zheng; Zequn,14,0,40,26
1657382313342,MATH 20B,A01,083756,Briones; Jor-el Thomas Caparas,4,0,36,32
1657382313342,MATH 20B,A02,083757,Briones; Jor-el Thomas Caparas,1,0,36,35
1657382313342,MATH 20B,A03,093475,Briones; Jor-el Thomas Caparas,2,0,36,34
1657382319999,MATH 20C,A01,083760,Briones; Jor-el Thomas Caparas,1,0,35,34
1657382319999,MATH 20C,A02,083761,Briones; Jor-el Thomas Caparas,8,0,35,27
1657382319999,MATH 20C,A03,093476,Briones; Jor-el Thomas Caparas,0,1,36,36
1657382319999,MATH 20C,B01,083762,Bach; Quang Tran,1,0,30,29
1657382326296,MATH 20D,A01,083765,Tran; Brian Kha,5,0,30,25
1657382326296,MATH 20D,A02,083766,Tran; Brian Kha,5,0,30,25
1657382326296,MATH 20D,A03,083767,Tran; Brian Kha,5,0,30,25
1657382333756,MATH 20E,A01,083771,Ganguly; Soumya,9,0,32,23
1657382333756,MATH 20E,A02,083772,Ganguly; Soumya,6,0,32,26
1657382333756,MATH 20E,B01,083773,Ciotti; Benjamin,20,0,35,15
1657382333756,MATH 20E,B02,083774,Ciotti; Benjamin,17,0,35,18
1657382340061,MATH 103A,A01,083777,Greenfeld; Be'Eri,3,0,36,33
1657382340061,MATH 103A,A02,083778,Greenfeld; Be'Eri,5,0,36,31
1657382340061,MATH 103A,A03,093561,Greenfeld; Be'Eri,5,0,36,31
1657382340061,MATH 103A,B01,083779,Greenfeld; Be'Eri,7,0,36,29
1657382340061,MATH 103A,B02,083780,Greenfeld; Be'Eri,4,0,36,32
1657382340061,MATH 103A,B03,093562,Greenfeld; Be'Eri,3,0,36,33
1657382347164,MATH 105,A01,085443,Carter; Anne Toulson,15,0,35,20
1657382347164,MATH 105,A02,093477,Carter; Anne Toulson,20,0,35,15
1657382353568,MATH 109,A01,083213,Ganzberger; Geoffrey Michael,2,0,34,32
1657382353568,MATH 109,A02,083214,Ganzberger; Geoffrey Michael,4,0,34,30
1657382353568,MATH 109,A03,093478,Ganzberger; Geoffrey Michael,2,0,34,32
1657382353568,MATH 109,B01,083215,Ganzberger; Geoffrey Michael,1,0,32,31
1657382353568,MATH 109,B02,083216,Ganzberger; Geoffrey Michael,2,0,32,30
1657382353568,MATH 109,B03,093479,Ganzberger; Geoffrey Michael,8,0,32,24
1657382360512,MATH 142A,A01,083219,Chow; Bennett,7,0,32,25
1657382360512,MATH 142A,A02,083220,Chow; Bennett,10,0,32,22
1657382360512,MATH 142A,A03,093480,Chow; Bennett,8,0,32,24
1657382360512,MATH 142A,B03,093481,Chow; Bennett,8,0,32,24
1657382360512,MATH 142A,B04,093558,Chow; Bennett,13,0,32,19
1657382360512,MATH 142A,B05,093559,Chow; Bennett,6,0,32,26
1657382367676,MATH 193A,A01,083224,Rotar; Vladimir,8,0,34,26
1657382367676,MATH 193A,A02,083225,Rotar; Vladimir,9,0,34,25
1657382367676,MATH 193A,A03,083781,Rotar; Vladimir,5,0,34,29
1657382367676,MATH 193A,A04,083782,Rotar; Vladimir,10,0,34,24
1657382367676,MATH 193A,A05,093482,Rotar; Vladimir,10,0,34,24
1657382374930,MATH 197,001,091859,McAuley; Julian John,9999,0,9999,0
1657382374930,MATH 197,002,095566,Kedlaya; Kiran S.,9997,0,9999,2
1657382374930,MATH 197,003,095567,Xiao; Ming,9999,0,9999,0
1657382374930,MATH 197,004,095571,Perols; Johan Lars,9998,0,9999,1
1657382383212,COGS 9,A01,083615,Shannon; Kyle Michael,9,0,75,66
1657382390208,COGS 11,A01,083617,Boyle; Mary E. T.,22,0,48,26
1657382397689,COGS 13,A01,083071,Bastos; Amalia Pinkusfeld,11,0,71,60
1657382403907,COGS 14A,A01,092681,Semenuks; Arturs,4,1,100,96
1657382410715,COGS 14B,A01,083073,Cheng; Tzu-Han,6,0,63,57
1657382417755,COGS 17,A01,092677,Semenuks; Arturs,6,0,81,75
1657382425001,COGS 100,A01,083619,Allen; Michael Gordon,17,0,70,53
1657382431162,COGS 101A,A01,083621,Davis; Joshua Daniel,9,0,68,59
1657382437464,COGS 101B,A01,091572,Allen; Michael Gordon,11,0,65,54
1657382443653,COGS 101C,A01,083625,Delgado; Tania,17,0,35,18
1657382450209,COGS 107A,A01,083627,Boyle; Mary E. T.,13,0,60,47
1657382456478,COGS 118A,A01,083075,Gupta; Anjum,20,0,76,56
1657382463065,CSE 3,A50,083646,Miranda; Gregory Joseph,24,0,50,26
1657382469593,CSE 8A,A50,083650,Miranda; Gregory Joseph,17,1,56,39
1657382476030,CSE 11,A01,083080,Cao; Yingjun,6,15,40,34
1657382483093,CSE 12,A01,083652,Krause-Levy; Sophia Louisa,28,1,120,92
1657382489580,CSE 15L,A01,083654,Morris; Justin Loren,9,0,50,41
1657382489580,CSE 15L,A02,083655,Morris; Justin Loren,9,0,50,41
1657382496378,CSE 20,A01,083657,Tran; Khoa Dang,39,0,80,41
1657382503179,CSE 21,A01,095574,Bach; Quang Tran,22,0,48,26
1657382510281,CSE 30,A01,083084,Eldon; John,4,0,80,76
1657382510281,CSE 30,B01,095061,Bhaskar; Nishant,9,0,50,41
1657382516539,CSE 100,A01,083659,Cao; Yingjun,5,4,70,65
1657382522785,CSE 134B,A01,083661,Powell; Thomas Allan,22,0,100,78
1657382529239,CSE 140,A01,083663,Gungor; Onat,14,0,85,71
1657382535752,CSE 140L,A01,083088,Eldon; John,21,0,100,79
1657382542270,CSE 175,A01,083665,Kumar; Rakesh,3,0,25,22
1657382548991,CSE 190,A00,092507,Dubnov; Shlomo,7,0,20,13
1657382555472,ECE 45,A01,083139,Congero; Spencer William,6,0,75,69
1657382561772,ECE 65,A50,083695,Saad; Andrew S,12,0,30,18
1657382561772,ECE 65,A51,095125,Saad; Andrew S,24,0,26,2
1657382568229,ECE 109,A01,091882,Touri; Behrouz,19,0,70,51
1657382575216,ECE 180,A00,083140,Abi Samra; Nicholas Camill,1,0,30,29
1657382575216,ECE 180,B00,083141,Abi Samra; Nicholas Camill,0,0,30,30
1657382581760,MATH 10A,A01,083735,Patchell; Gregory David,2,0,30,28
1657382581760,MATH 10A,A02,083736,Patchell; Gregory David,20,0,30,10
1657382581760,MATH 10A,A03,083737,Patchell; Gregory David,16,0,30,14
1657382588716,MATH 10B,A01,083207,Lim; Seonhee,8,0,34,26
1657382588716,MATH 10B,A02,083208,Lim; Seonhee,9,0,35,26
1657382588716,MATH 10B,A03,093472,Lim; Seonhee,7,0,34,27
1657382588716,MATH 10B,B01,083739,Sinha; Shubham,12,0,30,18
1657382595859,MATH 18,A01,083743,Cinel; Cameron Alexander,7,0,30,23
1657382595859,MATH 18,A02,083744,Cinel; Cameron Alexander,17,0,30,13
1657382595859,MATH 18,A03,083745,Cinel; Cameron Alexander,9,0,30,21
1657382595859,MATH 18,B01,083748,Rideout; David Porter,5,0,37,32
1657382595859,MATH 18,B02,083749,Rideout; David Porter,5,0,36,31
1657382595859,MATH 18,B03,083750,Rideout; David Porter,3,0,37,34
1657382595859,MATH 18,B04,083751,Rideout; David Porter,6,0,36,30
1657382595859,MATH 18,B05,093473,Rideout; David Porter,6,0,36,30
1657382595859,MATH 18,B06,093474,Rideout; David Porter,6,0,36,30
1657382602494,MATH 20A,A01,083754,Zheng; Zequn,14,0,40,26
1657382608647,MATH 20B,A01,083756,Briones; Jor-el Thomas Caparas,4,0,36,32
1657382608647,MATH 20B,A02,083757,Briones; Jor-el Thomas Caparas,1,0,36,35
1657382608647,MATH 20B,A03,093475,Briones; Jor-el Thomas Caparas,2,0,36,34
1657382615386,MATH 20C,A01,083760,Briones; Jor-el Thomas Caparas,1,0,35,34
1657382615386,MATH 20C,A02,083761,Briones; Jor-el Thomas Caparas,8,0,35,27
1657382615386,MATH 20C,A03,093476,Briones; Jor-el Thomas Caparas,0,1,36,36
1657382615386,MATH 20C,B01,083762,Bach; Quang Tran,1,0,30,29
1657382621705,MATH 20D,A01,083765,Tran; Brian Kha,5,0,30,25
1657382621705,MATH 20D,A02,083766,Tran; Brian Kha,5,0,30,25
1657382621705,MATH 20D,A03,083767,Tran; Brian Kha,5,0,30,25
1657382627955,MATH 20E,A01,083771,Ganguly; Soumya,9,0,32,23
1657382627955,MATH 20E,A02,083772,Ganguly; Soumya,6,0,32,26
1657382627955,MATH 20E,B01,083773,Ciotti; Benjamin,20,0,35,15
1657382627955,MATH 20E,B02,083774,Ciotti; Benjamin,17,0,35,18
1657382634161,MATH 103A,A01,083777,Greenfeld; Be'Eri,3,0,36,33
1657382634161,MATH 103A,A02,083778,Greenfeld; Be'Eri,5,0,36,31
1657382634161,MATH 103A,A03,093561,Greenfeld; Be'Eri,5,0,36,31
1657382634161,MATH 103A,B01,083779,Greenfeld; Be'Eri,7,0,36,29
1657382634161,MATH 103A,B02,083780,Greenfeld; Be'Eri,4,0,36,32
1657382634161,MATH 103A,B03,093562,Greenfeld; Be'Eri,3,0,36,33
1657382640368,MATH 105,A01,085443,Carter; Anne Toulson,15,0,35,20
1657382640368,MATH 105,A02,093477,Carter; Anne Toulson,20,0,35,15
1657382646864,MATH 109,A01,083213,Ganzberger; Geoffrey Michael,2,0,34,32
1657382646864,MATH 109,A02,083214,Ganzberger; Geoffrey Michael,4,0,34,30
1657382646864,MATH 109,A03,093478,Ganzberger; Geoffrey Michael,2,0,34,32
1657382646864,MATH 109,B01,083215,Ganzberger; Geoffrey Michael,1,0,32,31
1657382646864,MATH 109,B02,083216,Ganzberger; Geoffrey Michael,2,0,32,30
1657382646864,MATH 109,B03,093479,Ganzberger; Geoffrey Michael,8,0,32,24
1657382653558,MATH 142A,A01,083219,Chow; Bennett,7,0,32,25
1657382653558,MATH 142A,A02,083220,Chow; Bennett,10,0,32,22
1657382653558,MATH 142A,A03,093480,Chow; Bennett,8,0,32,24
1657382653558,MATH 142A,B03,093481,Chow; Bennett,8,0,32,24
1657382653558,MATH 142A,B04,093558,Chow; Bennett,13,0,32,19
1657382653558,MATH 142A,B05,093559,Chow; Bennett,6,0,32,26
1657382660233,MATH 193A,A01,083224,Rotar; Vladimir,8,0,34,26
1657382660233,MATH 193A,A02,083225,Rotar; Vladimir,9,0,34,25
1657382660233,MATH 193A,A03,083781,Rotar; Vladimir,5,0,34,29
1657382660233,MATH 193A,A04,083782,Rotar; Vladimir,10,0,34,24
1657382660233,MATH 193A,A05,093482,Rotar; Vladimir,10,0,34,24
1657382666917,MATH 197,001,091859,McAuley; Julian John,9999,0,9999,0
1657382666917,MATH 197,002,095566,Kedlaya; Kiran S.,9997,0,9999,2
1657382666917,MATH 197,003,095567,Xiao; Ming,9999,0,9999,0
1657382666917,MATH 197,004,095571,Perols; Johan Lars,9998,0,9999,1
1657382675833,COGS 9,A01,083615,Shannon; Kyle Michael,9,0,75,66
1657382682021,COGS 11,A01,083617,Boyle; Mary E. T.,22,0,48,26
1657382688278,COGS 13,A01,083071,Bastos; Amalia Pinkusfeld,11,0,71,60
1657382694806,COGS 14A,A01,092681,Semenuks; Arturs,4,1,100,96
1657382701111,COGS 14B,A01,083073,Cheng; Tzu-Han,6,0,63,57
1657382707767,COGS 17,A01,092677,Semenuks; Arturs,6,0,81,75
1657382714456,COGS 100,A01,083619,Allen; Michael Gordon,17,0,70,53
1657382721082,COGS 101A,A01,083621,Davis; Joshua Daniel,9,0,68,59
1657382727482,COGS 101B,A01,091572,Allen; Michael Gordon,11,0,65,54
1657382734438,COGS 101C,A01,083625,Delgado; Tania,17,0,35,18
1657382741847,COGS 107A,A01,083627,Boyle; Mary E. T.,13,0,60,47
1657382748710,COGS 118A,A01,083075,Gupta; Anjum,20,0,76,56
1657382755413,CSE 3,A50,083646,Miranda; Gregory Joseph,24,0,50,26
1657382761929,CSE 8A,A50,083650,Miranda; Gregory Joseph,17,1,56,39
1657382769101,CSE 11,A01,083080,Cao; Yingjun,6,15,40,34
1657382775734,CSE 12,A01,083652,Krause-Levy; Sophia Louisa,28,1,120,92
1657382782588,CSE 15L,A01,083654,Morris; Justin Loren,9,0,50,41
1657382782588,CSE 15L,A02,083655,Morris; Justin Loren,9,0,50,41
1657382789035,CSE 20,A01,083657,Tran; Khoa Dang,39,0,80,41
1657382795166,CSE 21,A01,095574,Bach; Quang Tran,22,0,48,26
1657382801332,CSE 30,A01,083084,Eldon; John,4,0,80,76
1657382801332,CSE 30,B01,095061,Bhaskar; Nishant,9,0,50,41
1657382807559,CSE 100,A01,083659,Cao; Yingjun,5,4,70,65
1657382814092,CSE 134B,A01,083661,Powell; Thomas Allan,22,0,100,78
1657382820629,CSE 140,A01,083663,Gungor; Onat,14,0,85,71
1657382827147,CSE 140L,A01,083088,Eldon; John,21,0,100,79
1657382833691,CSE 175,A01,083665,Kumar; Rakesh,3,0,25,22
1657382840267,CSE 190,A00,092507,Dubnov; Shlomo,7,0,20,13
1657382847079,ECE 45,A01,083139,Congero; Spencer William,6,0,75,69
1657382854235,ECE 65,A50,083695,Saad; Andrew S,12,0,30,18
1657382854235,ECE 65,A51,095125,Saad; Andrew S,24,0,26,2
1657382861078,ECE 109,A01,091882,Touri; Behrouz,19,0,70,51
1657382867591,ECE 180,A00,083140,Abi Samra; Nicholas Camill,1,0,30,29
1657382867591,ECE 180,B00,083141,Abi Samra; Nicholas Camill,0,0,30,30
1657382874066,MATH 10A,A01,083735,Patchell; Gregory David,2,0,30,28
1657382874066,MATH 10A,A02,083736,Patchell; Gregory David,20,0,30,10
1657382874066,MATH 10A,A03,083737,Patchell; Gregory David,16,0,30,14
1657382880285,MATH 10B,A01,083207,Lim; Seonhee,8,0,34,26
1657382880285,MATH 10B,A02,083208,Lim; Seonhee,9,0,35,26
1657382880285,MATH 10B,A03,093472,Lim; Seonhee,7,0,34,27
1657382880285,MATH 10B,B01,083739,Sinha; Shubham,12,0,30,18
1657382886490,MATH 18,A01,083743,Cinel; Cameron Alexander,7,0,30,23
1657382886490,MATH 18,A02,083744,Cinel; Cameron Alexander,17,0,30,13
1657382886490,MATH 18,A03,083745,Cinel; Cameron Alexander,9,0,30,21
1657382886490,MATH 18,B01,083748,Rideout; David Porter,5,0,37,32
1657382886490,MATH 18,B02,083749,Rideout; David Porter,5,0,36,31
1657382886490,MATH 18,B03,083750,Rideout; David Porter,3,0,37,34
1657382886490,MATH 18,B04,083751,Rideout; David Porter,6,0,36,30
1657382886490,MATH 18,B05,093473,Rideout; David Porter,6,0,36,30
1657382886490,MATH 18,B06,093474,Rideout; David Porter,6,0,36,30
1657382892946,MATH 20A,A01,083754,Zheng; Zequn,14,0,40,26
1657382899900,MATH 20B,A01,083756,Briones; Jor-el Thomas Caparas,4,0,36,32
1657382899900,MATH 20B,A02,083757,Briones; Jor-el Thomas Caparas,1,0,36,35
1657382899900,MATH 20B,A03,093475,Briones; Jor-el Thomas Caparas,2,0,36,34
1657382907034,MATH 20C,A01,083760,Briones; Jor-el Thomas Caparas,1,0,35,34
1657382907034,MATH 20C,A02,083761,Briones; Jor-el Thomas Caparas,8,0,35,27
1657382907034,MATH 20C,A03,093476,Briones; Jor-el Thomas Caparas,0,1,36,36
1657382907034,MATH 20C,B01,083762,Bach; Quang Tran,1,0,30,29
1657382913459,MATH 20D,A01,083765,Tran; Brian Kha,5,0,30,25
1657382913459,MATH 20D,A02,083766,Tran; Brian Kha,5,0,30,25
1657382913459,MATH 20D,A03,083767,Tran; Brian Kha,5,0,30,25
1657382920107,MATH 20E,A01,083771,Ganguly; Soumya,9,0,32,23
1657382920107,MATH 20E,A02,083772,Ganguly; Soumya,6,0,32,26
1657382920107,MATH 20E,B01,083773,Ciotti; Benjamin,20,0,35,15
1657382920107,MATH 20E,B02,083774,Ciotti; Benjamin,17,0,35,18
1657382926630,MATH 103A,A01,083777,Greenfeld; Be'Eri,3,0,36,33
1657382926630,MATH 103A,A02,083778,Greenfeld; Be'Eri,5,0,36,31
1657382926630,MATH 103A,A03,093561,Greenfeld; Be'Eri,5,0,36,31
1657382926630,MATH 103A,B01,083779,Greenfeld; Be'Eri,7,0,36,29
1657382926630,MATH 103A,B02,083780,Greenfeld; Be'Eri,4,0,36,32
1657382926630,MATH 103A,B03,093562,Greenfeld; Be'Eri,3,0,36,33
1657382932939,MATH 105,A01,085443,Carter; Anne Toulson,15,0,35,20
1657382932939,MATH 105,A02,093477,Carter; Anne Toulson,20,0,35,15
1657382940035,MATH 109,A01,083213,Ganzberger; Geoffrey Michael,2,0,34,32
1657382940035,MATH 109,A02,083214,Ganzberger; Geoffrey Michael,4,0,34,30
1657382940035,MATH 109,A03,093478,Ganzberger; Geoffrey Michael,2,0,34,32
1657382940035,MATH 109,B01,083215,Ganzberger; Geoffrey Michael,1,0,32,31
1657382940035,MATH 109,B02,083216,Ganzberger; Geoffrey Michael,2,0,32,30
1657382940035,MATH 109,B03,093479,Ganzberger; Geoffrey Michael,8,0,32,24
1657382946564,MATH 142A,A01,083219,Chow; Bennett,7,0,32,25
1657382946564,MATH 142A,A02,083220,Chow; Bennett,10,0,32,22
1657382946564,MATH 142A,A03,093480,Chow; Bennett,8,0,32,24
1657382946564,MATH 142A,B03,093481,Chow; Bennett,8,0,32,24
1657382946564,MATH 142A,B04,093558,Chow; Bennett,13,0,32,19
1657382946564,MATH 142A,B05,093559,Chow; Bennett,6,0,32,26
1657382953013,MATH 193A,A01,083224,Rotar; Vladimir,8,0,34,26
1657382953013,MATH 193A,A02,083225,Rotar; Vladimir,9,0,34,25
1657382953013,MATH 193A,A03,083781,Rotar; Vladimir,5,0,34,29
1657382953013,MATH 193A,A04,083782,Rotar; Vladimir,10,0,34,24
1657382953013,MATH 193A,A05,093482,Rotar; Vladimir,10,0,34,24
1657382959574,MATH 197,001,091859,McAuley; Julian John,9999,0,9999,0
1657382959574,MATH 197,002,095566,Kedlaya; Kiran S.,9997,0,9999,2
1657382959574,MATH 197,003,095567,Xiao; Ming,9999,0,9999,0
1657382959574,MATH 197,004,095571,Perols; Johan Lars,9998,0,9999,1
1657382967225,COGS 9,A01,083615,Shannon; Kyle Michael,9,0,75,66
1657382973943,COGS 11,A01,083617,Boyle; Mary E. T.,22,0,48,26
1657382980354,COGS 13,A01,083071,Bastos; Amalia Pinkusfeld,11,0,71,60
1657382986716,COGS 14A,A01,092681,Semenuks; Arturs,4,1,100,96
1657382993105,COGS 14B,A01,083073,Cheng; Tzu-Han,6,0,63,57
1657382999677,COGS 17,A01,092677,Semenuks; Arturs,6,0,81,75
1657383005983,COGS 100,A01,083619,Allen; Michael Gordon,17,0,70,53
1657383012779,COGS 101A,A01,083621,Davis; Joshua Daniel,9,0,68,59
1657383020315,COGS 101B,A01,091572,Allen; Michael Gordon,11,0,65,54
1657383026932,COGS 101C,A01,083625,Delgado; Tania,17,0,35,18
1657383033683,COGS 107A,A01,083627,Boyle; Mary E. T.,13,0,60,47
1657383040240,COGS 118A,A01,083075,Gupta; Anjum,20,0,76,56
1657383046790,CSE 3,A50,083646,Miranda; Gregory Joseph,24,0,50,26
1657383053792,CSE 8A,A50,083650,Miranda; Gregory Joseph,17,1,56,39
1657383060981,CSE 11,A01,083080,Cao; Yingjun,6,15,40,34
1657383067177,CSE 12,A01,083652,Krause-Levy; Sophia Louisa,28,1,120,92
1657383073706,CSE 15L,A01,083654,Morris; Justin Loren,9,0,50,41
1657383073706,CSE 15L,A02,083655,Morris; Justin Loren,9,0,50,41
1657383080195,CSE 20,A01,083657,Tran; Khoa Dang,39,0,80,41
1657383086581,CSE 21,A01,095574,Bach; Quang Tran,22,0,48,26
1657383092988,CSE 30,A01,083084,Eldon; John,4,0,80,76
1657383092988,CSE 30,B01,095061,Bhaskar; Nishant,9,0,50,41
1657383099208,CSE 100,A01,083659,Cao; Yingjun,5,4,70,65
1657383105724,CSE 134B,A01,083661,Powell; Thomas Allan,22,0,100,78
1657383112708,CSE 140,A01,083663,Gungor; Onat,14,0,85,71
1657383119341,CSE 140L,A01,083088,Eldon; John,21,0,100,79
1657383125792,CSE 175,A01,083665,Kumar; Rakesh,3,0,25,22
1657383132708,CSE 190,A00,092507,Dubnov; Shlomo,7,0,20,13
1657383139066,ECE 45,A01,083139,Congero; Spencer William,6,0,75,69
1657383146366,ECE 65,A50,083695,Saad; Andrew S,12,0,30,18
1657383146366,ECE 65,A51,095125,Saad; Andrew S,24,0,26,2
1657383152755,ECE 109,A01,091882,Touri; Behrouz,19,0,70,51
1657383159039,ECE 180,A00,083140,Abi Samra; Nicholas Camill,1,0,30,29
1657383159039,ECE 180,B00,083141,Abi Samra; Nicholas Camill,0,0,30,30
1657383165830,MATH 10A,A01,083735,Patchell; Gregory David,2,0,30,28
1657383165830,MATH 10A,A02,083736,Patchell; Gregory David,20,0,30,10
1657383165830,MATH 10A,A03,083737,Patchell; Gregory David,16,0,30,14
1657383172228,MATH 10B,A01,083207,Lim; Seonhee,8,0,34,26
1657383172228,MATH 10B,A02,083208,Lim; Seonhee,9,0,35,26
1657383172228,MATH 10B,A03,093472,Lim; Seonhee,7,0,34,27
1657383172228,MATH 10B,B01,083739,Sinha; Shubham,12,0,30,18
1657383178801,MATH 18,A01,083743,Cinel; Cameron Alexander,7,0,30,23
1657383178801,MATH 18,A02,083744,Cinel; Cameron Alexander,17,0,30,13
1657383178801,MATH 18,A03,083745,Cinel; Cameron Alexander,9,0,30,21
1657383178801,MATH 18,B01,083748,Rideout; David Porter,5,0,37,32
1657383178801,MATH 18,B02,083749,Rideout; David Porter,5,0,36,31
1657383178801,MATH 18,B03,083750,Rideout; David Porter,3,0,37,34
1657383178801,MATH 18,B04,083751,Rideout; David Porter,6,0,36,30
1657383178801,MATH 18,B05,093473,Rideout; David Porter,6,0,36,30
1657383178801,MATH 18,B06,093474,Rideout; David Porter,6,0,36,30
1657383185802,MATH 20A,A01,083754,Zheng; Zequn,14,0,40,26
1657383193087,MATH 20B,A01,083756,Briones; Jor-el Thomas Caparas,4,0,36,32
1657383193087,MATH 20B,A02,083757,Briones; Jor-el Thomas Caparas,1,0,36,35
1657383193087,MATH 20B,A03,093475,Briones; Jor-el Thomas Caparas,2,0,36,34
1657383200338,MATH 20C,A01,083760,Briones; Jor-el Thomas Caparas,1,0,35,34
1657383200338,MATH 20C,A02,083761,Briones; Jor-el Thomas Caparas,8,0,35,27
1657383200338,MATH 20C,A03,093476,Briones; Jor-el Thomas Caparas,0,1,36,36
1657383200338,MATH 20C,B01,083762,Bach; Quang Tran,1,0,30,29
1657383207118,MATH 20D,A01,083765,Tran; Brian Kha,5,0,30,25
1657383207118,MATH 20D,A02,083766,Tran; Brian Kha,5,0,30,25
1657383207118,MATH 20D,A03,083767,Tran; Brian Kha,5,0,30,25
1657383213976,MATH 20E,A01,083771,Ganguly; Soumya,9,0,32,23
1657383213976,MATH 20E,A02,083772,Ganguly; Soumya,6,0,32,26
1657383213976,MATH 20E,B01,083773,Ciotti; Benjamin,20,0,35,15
1657383213976,MATH 20E,B02,083774,Ciotti; Benjamin,17,0,35,18
1657383221066,MATH 103A,A01,083777,Greenfeld; Be'Eri,3,0,36,33
1657383221066,MATH 103A,A02,083778,Greenfeld; Be'Eri,5,0,36,31
1657383221066,MATH 103A,A03,093561,Greenfeld; Be'Eri,5,0,36,31
1657383221066,MATH 103A,B01,083779,Greenfeld; Be'Eri,7,0,36,29
1657383221066,MATH 103A,B02,083780,Greenfeld; Be'Eri,4,0,36,32
1657383221066,MATH 103A,B03,093562,Greenfeld; Be'Eri,3,0,36,33
1657383228343,MATH 105,A01,085443,Carter; Anne Toulson,15,0,35,20
1657383228343,MATH 105,A02,093477,Carter; Anne Toulson,20,0,35,15
1657383235404,MATH 109,A01,083213,Ganzberger; Geoffrey Michael,2,0,34,32
1657383235404,MATH 109,A02,083214,Ganzberger; Geoffrey Michael,4,0,34,30
1657383235404,MATH 109,A03,093478,Ganzberger; Geoffrey Michael,2,0,34,32
1657383235404,MATH 109,B01,083215,Ganzberger; Geoffrey Michael,1,0,32,31
1657383235404,MATH 109,B02,083216,Ganzberger; Geoffrey Michael,2,0,32,30
1657383235404,MATH 109,B03,093479,Ganzberger; Geoffrey Michael,8,0,32,24
1657383242070,MATH 142A,A01,083219,Chow; Bennett,7,0,32,25
1657383242070,MATH 142A,A02,083220,Chow; Bennett,10,0,32,22
1657383242070,MATH 142A,A03,093480,Chow; Bennett,8,0,32,24
1657383242070,MATH 142A,B03,093481,Chow; Bennett,8,0,32,24
1657383242070,MATH 142A,B04,093558,Chow; Bennett,13,0,32,19
1657383242070,MATH 142A,B05,093559,Chow; Bennett,6,0,32,26
1657383248138,MATH 193A,A01,083224,Rotar; Vladimir,8,0,34,26
1657383248138,MATH 193A,A02,083225,Rotar; Vladimir,9,0,34,25
1657383248138,MATH 193A,A03,083781,Rotar; Vladimir,5,0,34,29
1657383248138,MATH 193A,A04,083782,Rotar; Vladimir,10,0,34,24
1657383248138,MATH 193A,A05,093482,Rotar; Vladimir,10,0,34,24
1657383254871,MATH 197,001,091859,McAuley; Julian John,9999,0,9999,0
1657383254871,MATH 197,002,095566,Kedlaya; Kiran S.,9997,0,9999,2
1657383254871,MATH 197,003,095567,Xiao; Ming,9999,0,9999,0
1657383254871,MATH 197,004,095571,Perols; Johan Lars,9998,0,9999,1
1657383264613,COGS 9,A01,083615,Shannon; Kyle Michael,9,0,75,66
1657383271588,COGS 11,A01,083617,Boyle; Mary E. T.,22,0,48,26
1657383277902,COGS 13,A01,083071,Bastos; Amalia Pinkusfeld,11,0,71,60
1657383284926,COGS 14A,A01,092681,Semenuks; Arturs,4,1,100,96
1657383291957,COGS 14B,A01,083073,Cheng; Tzu-Han,6,0,63,57
1657383298496,COGS 17,A01,092677,Semenuks; Arturs,6,0,81,75
1657383304631,COGS 100,A01,083619,Allen; Michael Gordon,17,0,70,53
1657383310900,COGS 101A,A01,083621,Davis; Joshua Daniel,9,0,68,59
1657383317969,COGS 101B,A01,091572,Allen; Michael Gordon,11,0,65,54
1657383324899,COGS 101C,A01,083625,Delgado; Tania,17,0,35,18
1657383332021,COGS 107A,A01,083627,Boyle; Mary E. T.,13,0,60,47
1657383341441,COGS 118A,A01,083075,Gupta; Anjum,20,0,76,56
1657383347641,CSE 3,A50,083646,Miranda; Gregory Joseph,24,0,50,26
1657383353904,CSE 8A,A50,083650,Miranda; Gregory Joseph,17,1,56,39
1657383360381,CSE 11,A01,083080,Cao; Yingjun,6,15,40,34
1657383366907,CSE 12,A01,083652,Krause-Levy; Sophia Louisa,28,1,120,92
1657383373165,CSE 15L,A01,083654,Morris; Justin Loren,9,0,50,41
1657383373165,CSE 15L,A02,083655,Morris; Justin Loren,9,0,50,41
1657383379346,CSE 20,A01,083657,Tran; Khoa Dang,39,0,80,41
1657383386199,CSE 21,A01,095574,Bach; Quang Tran,22,0,48,26
1657383393122,CSE 30,A01,083084,Eldon; John,4,0,80,76
1657383393122,CSE 30,B01,095061,Bhaskar; Nishant,9,0,50,41
1657383399703,CSE 100,A01,083659,Cao; Yingjun,5,4,70,65
1657383406256,CSE 134B,A01,083661,Powell; Thomas Allan,22,0,100,78
1657383412919,CSE 140,A01,083663,Gungor; Onat,14,0,85,71
1657383419243,CSE 140L,A01,083088,Eldon; John,21,0,100,79
1657383426191,CSE 175,A01,083665,Kumar; Rakesh,3,0,25,22
1657383432913,CSE 190,A00,092507,Dubnov; Shlomo,7,0,20,13
1657383439383,ECE 45,A01,083139,Congero; Spencer William,6,0,75,69
1657383446136,ECE 65,A50,083695,Saad; Andrew S,12,0,30,18
1657383446136,ECE 65,A51,095125,Saad; Andrew S,24,0,26,2
1657383452474,ECE 109,A01,091882,Touri; Behrouz,19,0,70,51
1657383458709,ECE 180,A00,083140,Abi Samra; Nicholas Camill,1,0,30,29
1657383458709,ECE 180,B00,083141,Abi Samra; Nicholas Camill,0,0,30,30
1657383465313,MATH 10A,A01,083735,Patchell; Gregory David,2,0,30,28
1657383465313,MATH 10A,A02,083736,Patchell; Gregory David,20,0,30,10
1657383465313,MATH 10A,A03,083737,Patchell; Gregory David,16,0,30,14
1657383471808,MATH 10B,A01,083207,Lim; Seonhee,8,0,34,26
1657383471808,MATH 10B,A02,083208,Lim; Seonhee,9,0,35,26
1657383471808,MATH 10B,A03,093472,Lim; Seonhee,7,0,34,27
1657383471808,MATH 10B,B01,083739,Sinha; Shubham,12,0,30,18
1657383478265,MATH 18,A01,083743,Cinel; Cameron Alexander,7,0,30,23
1657383478265,MATH 18,A02,083744,Cinel; Cameron Alexander,17,0,30,13
1657383478265,MATH 18,A03,083745,Cinel; Cameron Alexander,9,0,30,21
1657383478265,MATH 18,B01,083748,Rideout; David Porter,5,0,37,32
1657383478265,MATH 18,B02,083749,Rideout; David Porter,5,0,36,31
1657383478265,MATH 18,B03,083750,Rideout; David Porter,3,0,37,34
1657383478265,MATH 18,B04,083751,Rideout; David Porter,6,0,36,30
1657383478265,MATH 18,B05,093473,Rideout; David Porter,6,0,36,30
1657383478265,MATH 18,B06,093474,Rideout; David Porter,6,0,36,30
1657383484668,MATH 20A,A01,083754,Zheng; Zequn,14,0,40,26
1657383491515,MATH 20B,A01,083756,Briones; Jor-el Thomas Caparas,4,0,36,32
1657383491515,MATH 20B,A02,083757,Briones; Jor-el Thomas Caparas,1,0,36,35
1657383491515,MATH 20B,A03,093475,Briones; Jor-el Thomas Caparas,2,0,36,34
1657383498065,MATH 20C,A01,083760,Briones; Jor-el Thomas Caparas,1,0,35,34
1657383498065,MATH 20C,A02,083761,Briones; Jor-el Thomas Caparas,8,0,35,27
1657383498065,MATH 20C,A03,093476,Briones; Jor-el Thomas Caparas,0,1,36,36
1657383498065,MATH 20C,B01,083762,Bach; Quang Tran,1,0,30,29
1657383504812,MATH 20D,A01,083765,Tran; Brian Kha,5,0,30,25
1657383504812,MATH 20D,A02,083766,Tran; Brian Kha,5,0,30,25
1657383504812,MATH 20D,A03,083767,Tran; Brian Kha,5,0,30,25
1657383511302,MATH 20E,A01,083771,Ganguly; Soumya,9,0,32,23
1657383511302,MATH 20E,A02,083772,Ganguly; Soumya,6,0,32,26
1657383511302,MATH 20E,B01,083773,Ciotti; Benjamin,20,0,35,15
1657383511302,MATH 20E,B02,083774,Ciotti; Benjamin,17,0,35,18
1657383517690,MATH 103A,A01,083777,Greenfeld; Be'Eri,3,0,36,33
1657383517690,MATH 103A,A02,083778,Greenfeld; Be'Eri,5,0,36,31
1657383517690,MATH 103A,A03,093561,Greenfeld; Be'Eri,5,0,36,31
1657383517690,MATH 103A,B01,083779,Greenfeld; Be'Eri,7,0,36,29
1657383517690,MATH 103A,B02,083780,Greenfeld; Be'Eri,4,0,36,32
1657383517690,MATH 103A,B03,093562,Greenfeld; Be'Eri,3,0,36,33
1657383523780,MATH 105,A01,085443,Carter; Anne Toulson,15,0,35,20
1657383523780,MATH 105,A02,093477,Carter; Anne Toulson,20,0,35,15
1657383531700,MATH 109,A01,083213,Ganzberger; Geoffrey Michael,2,0,34,32
1657383531700,MATH 109,A02,083214,Ganzberger; Geoffrey Michael,4,0,34,30
1657383531700,MATH 109,A03,093478,Ganzberger; Geoffrey Michael,2,0,34,32
1657383531700,MATH 109,B01,083215,Ganzberger; Geoffrey Michael,1,0,32,31
1657383531700,MATH 109,B02,083216,Ganzberger; Geoffrey Michael,2,0,32,30
1657383531700,MATH 109,B03,093479,Ganzberger; Geoffrey Michael,8,0,32,24
1657383538461,MATH 142A,A01,083219,Chow; Bennett,7,0,32,25
1657383538461,MATH 142A,A02,083220,Chow; Bennett,10,0,32,22
1657383538461,MATH 142A,A03,093480,Chow; Bennett,8,0,32,24
1657383538461,MATH 142A,B03,093481,Chow; Bennett,8,0,32,24
1657383538461,MATH 142A,B04,093558,Chow; Bennett,13,0,32,19
1657383538461,MATH 142A,B05,093559,Chow; Bennett,6,0,32,26
1657383545296,MATH 193A,A01,083224,Rotar; Vladimir,8,0,34,26
1657383545296,MATH 193A,A02,083225,Rotar; Vladimir,9,0,34,25
1657383545296,MATH 193A,A03,083781,Rotar; Vladimir,5,0,34,29
1657383545296,MATH 193A,A04,083782,Rotar; Vladimir,10,0,34,24
1657383545296,MATH 193A,A05,093482,Rotar; Vladimir,10,0,34,24
1657383551633,MATH 197,001,091859,McAuley; Julian John,9999,0,9999,0
1657383551633,MATH 197,002,095566,Kedlaya; Kiran S.,9997,0,9999,2
1657383551633,MATH 197,003,095567,Xiao; Ming,9999,0,9999,0
1657383551633,MATH 197,004,095571,Perols; Johan Lars,9998,0,9999,1
1657383559494,COGS 9,A01,083615,Shannon; Kyle Michael,9,0,75,66
1657383566606,COGS 11,A01,083617,Boyle; Mary E. T.,22,0,48,26
1657383574134,COGS 13,A01,083071,Bastos; Amalia Pinkusfeld,11,0,71,60
1657383581160,COGS 14A,A01,092681,Semenuks; Arturs,4,1,100,96
1657383587705,COGS 14B,A01,083073,Cheng; Tzu-Han,6,0,63,57
1657383593989,COGS 17,A01,092677,Semenuks; Arturs,6,0,81,75
1657383600121,COGS 100,A01,083619,Allen; Michael Gordon,17,0,70,53
1657383606916,COGS 101A,A01,083621,Davis; Joshua Daniel,9,0,68,59
1657383613300,COGS 101B,A01,091572,Allen; Michael Gordon,11,0,65,54
1657383619421,COGS 101C,A01,083625,Delgado; Tania,17,0,35,18
1657383625709,COGS 107A,A01,083627,Boyle; Mary E. T.,13,0,60,47
1657383631755,COGS 118A,A01,083075,Gupta; Anjum,20,0,76,56
1657383638547,CSE 3,A50,083646,Miranda; Gregory Joseph,24,0,50,26
1657383645342,CSE 8A,A50,083650,Miranda; Gregory Joseph,17,1,56,39
1657383652391,CSE 11,A01,083080,Cao; Yingjun,6,15,40,34
1657383659028,CSE 12,A01,083652,Krause-Levy; Sophia Louisa,28,1,120,92
1657383665645,CSE 15L,A01,083654,Morris; Justin Loren,9,0,50,41
1657383665645,CSE 15L,A02,083655,Morris; Justin Loren,9,0,50,41
1657383672562,CSE 20,A01,083657,Tran; Khoa Dang,39,0,80,41
1657383679167,CSE 21,A01,095574,Bach; Quang Tran,22,0,48,26
1657383685767,CSE 30,A01,083084,Eldon; John,4,0,80,76
1657383685767,CSE 30,B01,095061,Bhaskar; Nishant,9,0,50,41
1657383692052,CSE 100,A01,083659,Cao; Yingjun,5,4,70,65
1657383698339,CSE 134B,A01,083661,Powell; Thomas Allan,22,0,100,78
1657383704805,CSE 140,A01,083663,Gungor; Onat,14,0,85,71
1657383711360,CSE 140L,A01,083088,Eldon; John,21,0,100,79
1657383718068,CSE 175,A01,083665,Kumar; Rakesh,3,0,25,22
1657383724440,CSE 190,A00,092507,Dubnov; Shlomo,7,0,20,13
1657383730782,ECE 45,A01,083139,Congero; Spencer William,6,0,75,69
1657383737131,ECE 65,A50,083695,Saad; Andrew S,12,0,30,18
1657383737131,ECE 65,A51,095125,Saad; Andrew S,24,0,26,2
1657383743481,ECE 109,A01,091882,Touri; Behrouz,19,0,70,51
1657383750169,ECE 180,A00,083140,Abi Samra; Nicholas Camill,1,0,30,29
1657383750169,ECE 180,B00,083141,Abi Samra; Nicholas Camill,0,0,30,30
1657383756802,MATH 10A,A01,083735,Patchell; Gregory David,2,0,30,28
1657383756802,MATH 10A,A02,083736,Patchell; Gregory David,20,0,30,10
1657383756802,MATH 10A,A03,083737,Patchell; Gregory David,16,0,30,14
1657383763569,MATH 10B,A01,083207,Lim; Seonhee,8,0,34,26
1657383763569,MATH 10B,A02,083208,Lim; Seonhee,9,0,35,26
1657383763569,MATH 10B,A03,093472,Lim; Seonhee,7,0,34,27
1657383763569,MATH 10B,B01,083739,Sinha; Shubham,12,0,30,18
1657383770103,MATH 18,A01,083743,Cinel; Cameron Alexander,7,0,30,23
1657383770103,MATH 18,A02,083744,Cinel; Cameron Alexander,17,0,30,13
1657383770103,MATH 18,A03,083745,Cinel; Cameron Alexander,9,0,30,21
1657383770103,MATH 18,B01,083748,Rideout; David Porter,5,0,37,32
1657383770103,MATH 18,B02,083749,Rideout; David Porter,5,0,36,31
1657383770103,MATH 18,B03,083750,Rideout; David Porter,3,0,37,34
1657383770103,MATH 18,B04,083751,Rideout; David Porter,6,0,36,30
1657383770103,MATH 18,B05,093473,Rideout; David Porter,6,0,36,30
1657383770103,MATH 18,B06,093474,Rideout; David Porter,6,0,36,30
1657383776851,MATH 20A,A01,083754,Zheng; Zequn,14,0,40,26
1657383783149,MATH 20B,A01,083756,Briones; Jor-el Thomas Caparas,4,0,36,32
1657383783149,MATH 20B,A02,083757,Briones; Jor-el Thomas Caparas,1,0,36,35
1657383783149,MATH 20B,A03,093475,Briones; Jor-el Thomas Caparas,2,0,36,34
1657383789602,MATH 20C,A01,083760,Briones; Jor-el Thomas Caparas,1,0,35,34
1657383789602,MATH 20C,A02,083761,Briones; Jor-el Thomas Caparas,8,0,35,27
1657383789602,MATH 20C,A03,093476,Briones; Jor-el Thomas Caparas,0,1,36,36
1657383789602,MATH 20C,B01,083762,Bach; Quang Tran,1,0,30,29
1657383795967,MATH 20D,A01,083765,Tran; Brian Kha,5,0,30,25
1657383795967,MATH 20D,A02,083766,Tran; Brian Kha,5,0,30,25
1657383795967,MATH 20D,A03,083767,Tran; Brian Kha,5,0,30,25
1657383802715,MATH 20E,A01,083771,Ganguly; Soumya,9,0,32,23
1657383802715,MATH 20E,A02,083772,Ganguly; Soumya,6,0,32,26
1657383802715,MATH 20E,B01,083773,Ciotti; Benjamin,20,0,35,15
1657383802715,MATH 20E,B02,083774,Ciotti; Benjamin,17,0,35,18
1657383809684,MATH 103A,A01,083777,Greenfeld; Be'Eri,3,0,36,33
1657383809684,MATH 103A,A02,083778,Greenfeld; Be'Eri,5,0,36,31
1657383809684,MATH 103A,A03,093561,Greenfeld; Be'Eri,5,0,36,31
1657383809684,MATH 103A,B01,083779,Greenfeld; Be'Eri,7,0,36,29
1657383809684,MATH 103A,B02,083780,Greenfeld; Be'Eri,4,0,36,32
1657383809684,MATH 103A,B03,093562,Greenfeld; Be'Eri,3,0,36,33
1657383816276,MATH 105,A01,085443,Carter; Anne Toulson,15,0,35,20
1657383816276,MATH 105,A02,093477,Carter; Anne Toulson,20,0,35,15
1657383822601,MATH 109,A01,083213,Ganzberger; Geoffrey Michael,2,0,34,32
1657383822601,MATH 109,A02,083214,Ganzberger; Geoffrey Michael,4,0,34,30
1657383822601,MATH 109,A03,093478,Ganzberger; Geoffrey Michael,2,0,34,32
1657383822601,MATH 109,B01,083215,Ganzberger; Geoffrey Michael,1,0,32,31
1657383822601,MATH 109,B02,083216,Ganzberger; Geoffrey Michael,2,0,32,30
1657383822601,MATH 109,B03,093479,Ganzberger; Geoffrey Michael,8,0,32,24
1657383829062,MATH 142A,A01,083219,Chow; Bennett,7,0,32,25
1657383829062,MATH 142A,A02,083220,Chow; Bennett,10,0,32,22
1657383829062,MATH 142A,A03,093480,Chow; Bennett,8,0,32,24
1657383829062,MATH 142A,B03,093481,Chow; Bennett,8,0,32,24
1657383829062,MATH 142A,B04,093558,Chow; Bennett,13,0,32,19
1657383829062,MATH 142A,B05,093559,Chow; Bennett,6,0,32,26
1657383835994,MATH 193A,A01,083224,Rotar; Vladimir,8,0,34,26
1657383835994,MATH 193A,A02,083225,Rotar; Vladimir,9,0,34,25
1657383835994,MATH 193A,A03,083781,Rotar; Vladimir,5,0,34,29
1657383835994,MATH 193A,A04,083782,Rotar; Vladimir,10,0,34,24
1657383835994,MATH 193A,A05,093482,Rotar; Vladimir,10,0,34,24
1657383842790,MATH 197,001,091859,McAuley; Julian John,9999,0,9999,0
1657383842790,MATH 197,002,095566,Kedlaya; Kiran S.,9997,0,9999,2
1657383842790,MATH 197,003,095567,Xiao; Ming,9999,0,9999,0
1657383842790,MATH 197,004,095571,Perols; Johan Lars,9998,0,9999,1
1657383851455,COGS 9,A01,083615,Shannon; Kyle Michael,9,0,75,66
1657383857641,COGS 11,A01,083617,Boyle; Mary E. T.,22,0,48,26
1657383864622,COGS 13,A01,083071,Bastos; Amalia Pinkusfeld,11,0,71,60
1657383871631,COGS 14A,A01,092681,Semenuks; Arturs,4,1,100,96
1657383878852,COGS 14B,A01,083073,Cheng; Tzu-Han,6,0,63,57
1657383885064,COGS 17,A01,092677,Semenuks; Arturs,6,0,81,75
1657383891643,COGS 100,A01,083619,Allen; Michael Gordon,17,0,70,53
1657383898534,COGS 101A,A01,083621,Davis; Joshua Daniel,9,0,68,59
1657383905764,COGS 101B,A01,091572,Allen; Michael Gordon,11,0,65,54
1657383912406,COGS 101C,A01,083625,Delgado; Tania,17,0,35,18
1657383918944,COGS 107A,A01,083627,Boyle; Mary E. T.,13,0,60,47
1657383925793,COGS 118A,A01,083075,Gupta; Anjum,20,0,76,56
1657383932017,CSE 3,A50,083646,Miranda; Gregory Joseph,24,0,50,26
1657383938946,CSE 8A,A50,083650,Miranda; Gregory Joseph,17,1,56,39
1657383945436,CSE 11,A01,083080,Cao; Yingjun,6,15,40,34
1657383952146,CSE 12,A01,083652,Krause-Levy; Sophia Louisa,28,1,120,92
1657383958757,CSE 15L,A01,083654,Morris; Justin Loren,9,0,50,41
1657383958757,CSE 15L,A02,083655,Morris; Justin Loren,9,0,50,41
1657383965358,CSE 20,A01,083657,Tran; Khoa Dang,39,0,80,41
1657383972288,CSE 21,A01,095574,Bach; Quang Tran,22,0,48,26
1657383978916,CSE 30,A01,083084,Eldon; John,4,0,80,76
1657383978916,CSE 30,B01,095061,Bhaskar; Nishant,9,0,50,41
1657383985287,CSE 100,A01,083659,Cao; Yingjun,5,4,70,65
1657383991908,CSE 134B,A01,083661,Powell; Thomas Allan,22,0,100,78
1657384001383,CSE 140,A01,083663,Gungor; Onat,14,0,85,71
1657384008989,CSE 140L,A01,083088,Eldon; John,21,0,100,79
1657384015627,CSE 175,A01,083665,Kumar; Rakesh,3,0,25,22
1657384021734,CSE 190,A00,092507,Dubnov; Shlomo,7,0,20,13
1657384029461,ECE 45,A01,083139,Congero; Spencer William,6,0,75,69
1657384036869,ECE 65,A50,083695,Saad; Andrew S,12,0,30,18
1657384036869,ECE 65,A51,095125,Saad; Andrew S,24,0,26,2
1657384043844,ECE 109,A01,091882,Touri; Behrouz,19,0,70,51
1657384050433,ECE 180,A00,083140,Abi Samra; Nicholas Camill,1,0,30,29
1657384050433,ECE 180,B00,083141,Abi Samra; Nicholas Camill,0,0,30,30
1657384057128,MATH 10A,A01,083735,Patchell; Gregory David,2,0,30,28
1657384057128,MATH 10A,A02,083736,Patchell; Gregory David,20,0,30,10
1657384057128,MATH 10A,A03,083737,Patchell; Gregory David,16,0,30,14
1657384064000,MATH 10B,A01,083207,Lim; Seonhee,8,0,34,26
1657384064000,MATH 10B,A02,083208,Lim; Seonhee,9,0,35,26
1657384064000,MATH 10B,A03,093472,Lim; Seonhee,7,0,34,27
1657384064000,MATH 10B,B01,083739,Sinha; Shubham,12,0,30,18
1657384070814,MATH 18,A01,083743,Cinel; Cameron Alexander,7,0,30,23
1657384070814,MATH 18,A02,083744,Cinel; Cameron Alexander,17,0,30,13
1657384070814,MATH 18,A03,083745,Cinel; Cameron Alexander,9,0,30,21
1657384070814,MATH 18,B01,083748,Rideout; David Porter,5,0,37,32
1657384070814,MATH 18,B02,083749,Rideout; David Porter,5,0,36,31
1657384070814,MATH 18,B03,083750,Rideout; David Porter,3,0,37,34
1657384070814,MATH 18,B04,083751,Rideout; David Porter,6,0,36,30
1657384070814,MATH 18,B05,093473,Rideout; David Porter,6,0,36,30
1657384070814,MATH 18,B06,093474,Rideout; David Porter,6,0,36,30
1657384077128,MATH 20A,A01,083754,Zheng; Zequn,14,0,40,26
1657384083961,MATH 20B,A01,083756,Briones; Jor-el Thomas Caparas,4,0,36,32
1657384083961,MATH 20B,A02,083757,Briones; Jor-el Thomas Caparas,1,0,36,35
1657384083961,MATH 20B,A03,093475,Briones; Jor-el Thomas Caparas,2,0,36,34
1657384090317,MATH 20C,A01,083760,Briones; Jor-el Thomas Caparas,1,0,35,34
1657384090317,MATH 20C,A02,083761,Briones; Jor-el Thomas Caparas,8,0,35,27
1657384090317,MATH 20C,A03,093476,Briones; Jor-el Thomas Caparas,0,1,36,36
1657384090317,MATH 20C,B01,083762,Bach; Quang Tran,1,0,30,29
1657384097600,MATH 20D,A01,083765,Tran; Brian Kha,5,0,30,25
1657384097600,MATH 20D,A02,083766,Tran; Brian Kha,5,0,30,25
1657384097600,MATH 20D,A03,083767,Tran; Brian Kha,5,0,30,25
1657384104337,MATH 20E,A01,083771,Ganguly; Soumya,9,0,32,23
1657384104337,MATH 20E,A02,083772,Ganguly; Soumya,6,0,32,26
1657384104337,MATH 20E,B01,083773,Ciotti; Benjamin,20,0,35,15
1657384104337,MATH 20E,B02,083774,Ciotti; Benjamin,17,0,35,18
1657384110680,MATH 103A,A01,083777,Greenfeld; Be'Eri,3,0,36,33
1657384110680,MATH 103A,A02,083778,Greenfeld; Be'Eri,5,0,36,31
1657384110680,MATH 103A,A03,093561,Greenfeld; Be'Eri,5,0,36,31
1657384110680,MATH 103A,B01,083779,Greenfeld; Be'Eri,7,0,36,29
1657384110680,MATH 103A,B02,083780,Greenfeld; Be'Eri,4,0,36,32
1657384110680,MATH 103A,B03,093562,Greenfeld; Be'Eri,3,0,36,33
1657384117616,MATH 105,A01,085443,Carter; Anne Toulson,15,0,35,20
1657384117616,MATH 105,A02,093477,Carter; Anne Toulson,20,0,35,15
1657384124426,MATH 109,A01,083213,Ganzberger; Geoffrey Michael,2,0,34,32
1657384124426,MATH 109,A02,083214,Ganzberger; Geoffrey Michael,4,0,34,30
1657384124426,MATH 109,A03,093478,Ganzberger; Geoffrey Michael,2,0,34,32
1657384124426,MATH 109,B01,083215,Ganzberger; Geoffrey Michael,1,0,32,31
1657384124426,MATH 109,B02,083216,Ganzberger; Geoffrey Michael,2,0,32,30
1657384124426,MATH 109,B03,093479,Ganzberger; Geoffrey Michael,8,0,32,24
1657384130598,MATH 142A,A01,083219,Chow; Bennett,7,0,32,25
1657384130598,MATH 142A,A02,083220,Chow; Bennett,10,0,32,22
1657384130598,MATH 142A,A03,093480,Chow; Bennett,8,0,32,24
1657384130598,MATH 142A,B03,093481,Chow; Bennett,8,0,32,24
1657384130598,MATH 142A,B04,093558,Chow; Bennett,13,0,32,19
1657384130598,MATH 142A,B05,093559,Chow; Bennett,6,0,32,26
1657384137976,MATH 193A,A01,083224,Rotar; Vladimir,8,0,34,26
1657384137976,MATH 193A,A02,083225,Rotar; Vladimir,9,0,34,25
1657384137976,MATH 193A,A03,083781,Rotar; Vladimir,5,0,34,29
1657384137976,MATH 193A,A04,083782,Rotar; Vladimir,10,0,34,24
1657384137976,MATH 193A,A05,093482,Rotar; Vladimir,10,0,34,24
1657384144745,MATH 197,001,091859,McAuley; Julian John,9999,0,9999,0
1657384144745,MATH 197,002,095566,Kedlaya; Kiran S.,9997,0,9999,2
1657384144745,MATH 197,003,095567,Xiao; Ming,9999,0,9999,0
1657384144745,MATH 197,004,095571,Perols; Johan Lars,9998,0,9999,1
1657384154111,COGS 9,A01,083615,Shannon; Kyle Michael,9,0,75,66
1657384160935,COGS 11,A01,083617,Boyle; Mary E. T.,22,0,48,26
1657384168111,COGS 13,A01,083071,Bastos; Amalia Pinkusfeld,11,0,71,60
1657384175966,COGS 14A,A01,092681,Semenuks; Arturs,4,1,100,96
1657384183029,COGS 14B,A01,083073,Cheng; Tzu-Han,6,0,63,57
1657384190074,COGS 17,A01,092677,Semenuks; Arturs,6,0,81,75
1657384198581,COGS 100,A01,083619,Allen; Michael Gordon,17,0,70,53
1657384204636,COGS 101A,A01,083621,Davis; Joshua Daniel,9,0,68,59
1657384211455,COGS 101B,A01,091572,Allen; Michael Gordon,11,0,65,54
1657384217868,COGS 101C,A01,083625,Delgado; Tania,17,0,35,18
1657384224715,COGS 107A,A01,083627,Boyle; Mary E. T.,13,0,60,47
1657384231335,COGS 118A,A01,083075,Gupta; Anjum,20,0,76,56
1657384237762,CSE 3,A50,083646,Miranda; Gregory Joseph,24,0,50,26
1657384244645,CSE 8A,A50,083650,Miranda; Gregory Joseph,17,1,56,39
1657384251240,CSE 11,A01,083080,Cao; Yingjun,6,15,40,34
1657384257964,CSE 12,A01,083652,Krause-Levy; Sophia Louisa,28,1,120,92
1657384264883,CSE 15L,A01,083654,Morris; Justin Loren,9,0,50,41
1657384264883,CSE 15L,A02,083655,Morris; Justin Loren,9,0,50,41
1657384271591,CSE 20,A01,083657,Tran; Khoa Dang,39,0,80,41
1657384277717,CSE 21,A01,095574,Bach; Quang Tran,22,0,48,26
1657384283860,CSE 30,A01,083084,Eldon; John,4,0,80,76
1657384283860,CSE 30,B01,095061,Bhaskar; Nishant,9,0,50,41
1657384290021,CSE 100,A01,083659,Cao; Yingjun,5,4,70,65
1657384296998,CSE 134B,A01,083661,Powell; Thomas Allan,22,0,100,78
1657384303541,CSE 140,A01,083663,Gungor; Onat,14,0,85,71
1657384310182,CSE 140L,A01,083088,Eldon; John,21,0,100,79
1657384316795,CSE 175,A01,083665,Kumar; Rakesh,3,0,25,22
1657384323270,CSE 190,A00,092507,Dubnov; Shlomo,7,0,20,13
1657384329661,ECE 45,A01,083139,Congero; Spencer William,6,0,75,69
1657384335979,ECE 65,A50,083695,Saad; Andrew S,12,0,30,18
1657384335979,ECE 65,A51,095125,Saad; Andrew S,24,0,26,2
1657384342612,ECE 109,A01,091882,Touri; Behrouz,19,0,70,51
1657384348995,ECE 180,A00,083140,Abi Samra; Nicholas Camill,1,0,30,29
1657384348995,ECE 180,B00,083141,Abi Samra; Nicholas Camill,0,0,30,30
1657384355222,MATH 10A,A01,083735,Patchell; Gregory David,2,0,30,28
1657384355222,MATH 10A,A02,083736,Patchell; Gregory David,20,0,30,10
1657384355222,MATH 10A,A03,083737,Patchell; Gregory David,16,0,30,14
1657384362245,MATH 10B,A01,083207,Lim; Seonhee,8,0,34,26
1657384362245,MATH 10B,A02,083208,Lim; Seonhee,9,0,35,26
1657384362245,MATH 10B,A03,093472,Lim; Seonhee,7,0,34,27
1657384362245,MATH 10B,B01,083739,Sinha; Shubham,12,0,30,18
1657384369575,MATH 18,A01,083743,Cinel; Cameron Alexander,7,0,30,23
1657384369575,MATH 18,A02,083744,Cinel; Cameron Alexander,17,0,30,13
1657384369575,MATH 18,A03,083745,Cinel; Cameron Alexander,9,0,30,21
1657384369575,MATH 18,B01,083748,Rideout; David Porter,5,0,37,32
1657384369575,MATH 18,B02,083749,Rideout; David Porter,5,0,36,31
1657384369575,MATH 18,B03,083750,Rideout; David Porter,3,0,37,34
1657384369575,MATH 18,B04,083751,Rideout; David Porter,6,0,36,30
1657384369575,MATH 18,B05,093473,Rideout; David Porter,6,0,36,30
1657384369575,MATH 18,B06,093474,Rideout; David Porter,6,0,36,30
1657384376194,MATH 20A,A01,083754,Zheng; Zequn,14,0,40,26
1657384382682,MATH 20B,A01,083756,Briones; Jor-el Thomas Caparas,4,0,36,32
1657384382682,MATH 20B,A02,083757,Briones; Jor-el Thomas Caparas,1,0,36,35
1657384382682,MATH 20B,A03,093475,Briones; Jor-el Thomas Caparas,2,0,36,34
1657384390014,MATH 20C,A01,083760,Briones; Jor-el Thomas Caparas,1,0,35,34
1657384390014,MATH 20C,A02,083761,Briones; Jor-el Thomas Caparas,8,0,35,27
1657384390014,MATH 20C,A03,093476,Briones; Jor-el Thomas Caparas,0,1,36,36
1657384390014,MATH 20C,B01,083762,Bach; Quang Tran,1,0,30,29
1657384396829,MATH 20D,A01,083765,Tran; Brian Kha,5,0,30,25
1657384396829,MATH 20D,A02,083766,Tran; Brian Kha,5,0,30,25
1657384396829,MATH 20D,A03,083767,Tran; Brian Kha,5,0,30,25
1657384403429,MATH 20E,A01,083771,Ganguly; Soumya,9,0,32,23
1657384403429,MATH 20E,A02,083772,Ganguly; Soumya,6,0,32,26
1657384403429,MATH 20E,B01,083773,Ciotti; Benjamin,20,0,35,15
1657384403429,MATH 20E,B02,083774,Ciotti; Benjamin,17,0,35,18
1657384410565,MATH 103A,A01,083777,Greenfeld; Be'Eri,3,0,36,33
1657384410565,MATH 103A,A02,083778,Greenfeld; Be'Eri,5,0,36,31
1657384410565,MATH 103A,A03,093561,Greenfeld; Be'Eri,5,0,36,31
1657384410565,MATH 103A,B01,083779,Greenfeld; Be'Eri,7,0,36,29
1657384410565,MATH 103A,B02,083780,Greenfeld; Be'Eri,4,0,36,32
1657384410565,MATH 103A,B03,093562,Greenfeld; Be'Eri,3,0,36,33
1657384417239,MATH 105,A01,085443,Carter; Anne Toulson,15,0,35,20
1657384417239,MATH 105,A02,093477,Carter; Anne Toulson,20,0,35,15
1657384423679,MATH 109,A01,083213,Ganzberger; Geoffrey Michael,2,0,34,32
1657384423679,MATH 109,A02,083214,Ganzberger; Geoffrey Michael,4,0,34,30
1657384423679,MATH 109,A03,093478,Ganzberger; Geoffrey Michael,2,0,34,32
1657384423679,MATH 109,B01,083215,Ganzberger; Geoffrey Michael,1,0,32,31
1657384423679,MATH 109,B02,083216,Ganzberger; Geoffrey Michael,2,0,32,30
1657384423679,MATH 109,B03,093479,Ganzberger; Geoffrey Michael,8,0,32,24
1657384430281,MATH 142A,A01,083219,Chow; Bennett,7,0,32,25
1657384430281,MATH 142A,A02,083220,Chow; Bennett,10,0,32,22
1657384430281,MATH 142A,A03,093480,Chow; Bennett,8,0,32,24
1657384430281,MATH 142A,B03,093481,Chow; Bennett,8,0,32,24
1657384430281,MATH 142A,B04,093558,Chow; Bennett,13,0,32,19
1657384430281,MATH 142A,B05,093559,Chow; Bennett,6,0,32,26
1657384436794,MATH 193A,A01,083224,Rotar; Vladimir,8,0,34,26
1657384436794,MATH 193A,A02,083225,Rotar; Vladimir,9,0,34,25
1657384436794,MATH 193A,A03,083781,Rotar; Vladimir,5,0,34,29
1657384436794,MATH 193A,A04,083782,Rotar; Vladimir,10,0,34,24
1657384436794,MATH 193A,A05,093482,Rotar; Vladimir,10,0,34,24
1657384443208,MATH 197,001,091859,McAuley; Julian John,9999,0,9999,0
1657384443208,MATH 197,002,095566,Kedlaya; Kiran S.,9997,0,9999,2
1657384443208,MATH 197,003,095567,Xiao; Ming,9999,0,9999,0
1657384443208,MATH 197,004,095571,Perols; Johan Lars,9998,0,9999,1
1657384452010,COGS 9,A01,083615,Shannon; Kyle Michael,9,0,75,66
1657384458121,COGS 11,A01,083617,Boyle; Mary E. T.,22,0,48,26
1657384464518,COGS 13,A01,083071,Bastos; Amalia Pinkusfeld,11,0,71,60
1657384470777,COGS 14A,A01,092681,Semenuks; Arturs,4,1,100,96
1657384477064,COGS 14B,A01,083073,Cheng; Tzu-Han,6,0,63,57
1657384483184,COGS 17,A01,092677,Semenuks; Arturs,6,0,81,75
1657384489395,COGS 100,A01,083619,Allen; Michael Gordon,17,0,70,53
1657384496022,COGS 101A,A01,083621,Davis; Joshua Daniel,9,0,68,59
1657384503558,COGS 101B,A01,091572,Allen; Michael Gordon,11,0,65,54
1657384510083,COGS 101C,A01,083625,Delgado; Tania,17,0,35,18
1657384516875,COGS 107A,A01,083627,Boyle; Mary E. T.,13,0,60,47
1657384523665,COGS 118A,A01,083075,Gupta; Anjum,20,0,76,56
1657384530413,CSE 3,A50,083646,Miranda; Gregory Joseph,24,0,50,26
1657384537140,CSE 8A,A50,083650,Miranda; Gregory Joseph,17,1,56,39
1657384543581,CSE 11,A01,083080,Cao; Yingjun,6,15,40,34
1657384549709,CSE 12,A01,083652,Krause-Levy; Sophia Louisa,28,1,120,92
1657384556566,CSE 15L,A01,083654,Morris; Justin Loren,9,0,50,41
1657384556566,CSE 15L,A02,083655,Morris; Justin Loren,9,0,50,41
1657384563260,CSE 20,A01,083657,Tran; Khoa Dang,39,0,80,41
1657384571043,CSE 21,A01,095574,Bach; Quang Tran,22,0,48,26
1657384578594,CSE 30,A01,083084,Eldon; John,4,0,80,76
1657384578594,CSE 30,B01,095061,Bhaskar; Nishant,9,0,50,41
1657384587162,CSE 100,A01,083659,Cao; Yingjun,5,4,70,65
1657384593463,CSE 134B,A01,083661,Powell; Thomas Allan,22,0,100,78
1657384600106,CSE 140,A01,083663,Gungor; Onat,14,0,85,71
1657384606631,CSE 140L,A01,083088,Eldon; John,21,0,100,79
1657384613441,CSE 175,A01,083665,Kumar; Rakesh,3,0,25,22
1657384620292,CSE 190,A00,092507,Dubnov; Shlomo,7,0,20,13
1657384627120,ECE 45,A01,083139,Congero; Spencer William,6,0,75,69
1657384633630,ECE 65,A50,083695,Saad; Andrew S,12,0,30,18
1657384633630,ECE 65,A51,095125,Saad; Andrew S,24,0,26,2
1657384640286,ECE 109,A01,091882,Touri; Behrouz,19,0,70,51
1657384647657,ECE 180,A00,083140,Abi Samra; Nicholas Camill,1,0,30,29
1657384647657,ECE 180,B00,083141,Abi Samra; Nicholas Camill,0,0,30,30
1657384654300,MATH 10A,A01,083735,Patchell; Gregory David,2,0,30,28
1657384654300,MATH 10A,A02,083736,Patchell; Gregory David,20,0,30,10
1657384654300,MATH 10A,A03,083737,Patchell; Gregory David,16,0,30,14
1657384660992,MATH 10B,A01,083207,Lim; Seonhee,8,0,34,26
1657384660992,MATH 10B,A02,083208,Lim; Seonhee,9,0,35,26
1657384660992,MATH 10B,A03,093472,Lim; Seonhee,7,0,34,27
1657384660992,MATH 10B,B01,083739,Sinha; Shubham,12,0,30,18
1657384667770,MATH 18,A01,083743,Cinel; Cameron Alexander,7,0,30,23
1657384667770,MATH 18,A02,083744,Cinel; Cameron Alexander,17,0,30,13
1657384667770,MATH 18,A03,083745,Cinel; Cameron Alexander,9,0,30,21
1657384667770,MATH 18,B01,083748,Rideout; David Porter,5,0,37,32
1657384667770,MATH 18,B02,083749,Rideout; David Porter,5,0,36,31
1657384667770,MATH 18,B03,083750,Rideout; David Porter,3,0,37,34
1657384667770,MATH 18,B04,083751,Rideout; David Porter,6,0,36,30
1657384667770,MATH 18,B05,093473,Rideout; David Porter,6,0,36,30
1657384667770,MATH 18,B06,093474,Rideout; David Porter,6,0,36,30
1657384677114,MATH 20A,A01,083754,Zheng; Zequn,14,0,40,26
1657384683693,MATH 20B,A01,083756,Briones; Jor-el Thomas Caparas,4,0,36,32
1657384683693,MATH 20B,A02,083757,Briones; Jor-el Thomas Caparas,1,0,36,35
1657384683693,MATH 20B,A03,093475,Briones; Jor-el Thomas Caparas,2,0,36,34
1657384690626,MATH 20C,A01,083760,Briones; Jor-el Thomas Caparas,1,0,35,34
1657384690626,MATH 20C,A02,083761,Briones; Jor-el Thomas Caparas,8,0,35,27
1657384690626,MATH 20C,A03,093476,Briones; Jor-el Thomas Caparas,0,1,36,36
1657384690626,MATH 20C,B01,083762,Bach; Quang Tran,1,0,30,29
1657384697623,MATH 20D,A01,083765,Tran; Brian Kha,5,0,30,25
1657384697623,MATH 20D,A02,083766,Tran; Brian Kha,5,0,30,25
1657384697623,MATH 20D,A03,083767,Tran; Brian Kha,5,0,30,25
1657384704549,MATH 20E,A01,083771,Ganguly; Soumya,9,0,32,23
1657384704549,MATH 20E,A02,083772,Ganguly; Soumya,6,0,32,26
1657384704549,MATH 20E,B01,083773,Ciotti; Benjamin,20,0,35,15
1657384704549,MATH 20E,B02,083774,Ciotti; Benjamin,17,0,35,18
1657384710942,MATH 103A,A01,083777,Greenfeld; Be'Eri,3,0,36,33
1657384710942,MATH 103A,A02,083778,Greenfeld; Be'Eri,5,0,36,31
1657384710942,MATH 103A,A03,093561,Greenfeld; Be'Eri,5,0,36,31
1657384710942,MATH 103A,B01,083779,Greenfeld; Be'Eri,7,0,36,29
1657384710942,MATH 103A,B02,083780,Greenfeld; Be'Eri,4,0,36,32
1657384710942,MATH 103A,B03,093562,Greenfeld; Be'Eri,3,0,36,33
1657384717760,MATH 105,A01,085443,Carter; Anne Toulson,15,0,35,20
1657384717760,MATH 105,A02,093477,Carter; Anne Toulson,20,0,35,15
1657384724191,MATH 109,A01,083213,Ganzberger; Geoffrey Michael,2,0,34,32
1657384724191,MATH 109,A02,083214,Ganzberger; Geoffrey Michael,4,0,34,30
1657384724191,MATH 109,A03,093478,Ganzberger; Geoffrey Michael,2,0,34,32
1657384724191,MATH 109,B01,083215,Ganzberger; Geoffrey Michael,1,0,32,31
1657384724191,MATH 109,B02,083216,Ganzberger; Geoffrey Michael,2,0,32,30
1657384724191,MATH 109,B03,093479,Ganzberger; Geoffrey Michael,8,0,32,24
1657384730671,MATH 142A,A01,083219,Chow; Bennett,7,0,32,25
1657384730671,MATH 142A,A02,083220,Chow; Bennett,10,0,32,22
1657384730671,MATH 142A,A03,093480,Chow; Bennett,8,0,32,24
1657384730671,MATH 142A,B03,093481,Chow; Bennett,8,0,32,24
1657384730671,MATH 142A,B04,093558,Chow; Bennett,13,0,32,19
1657384730671,MATH 142A,B05,093559,Chow; Bennett,6,0,32,26
1657384737224,MATH 193A,A01,083224,Rotar; Vladimir,8,0,34,26
1657384737224,MATH 193A,A02,083225,Rotar; Vladimir,9,0,34,25
1657384737224,MATH 193A,A03,083781,Rotar; Vladimir,5,0,34,29
1657384737224,MATH 193A,A04,083782,Rotar; Vladimir,10,0,34,24
1657384737224,MATH 193A,A05,093482,Rotar; Vladimir,10,0,34,24
1657384743592,MATH 197,001,091859,McAuley; Julian John,9999,0,9999,0
1657384743592,MATH 197,002,095566,Kedlaya; Kiran S.,9997,0,9999,2
1657384743592,MATH 197,003,095567,Xiao; Ming,9999,0,9999,0
1657384743592,MATH 197,004,095571,Perols; Johan Lars,9998,0,9999,1
1657384751959,COGS 9,A01,083615,Shannon; Kyle Michael,9,0,75,66
1657384758423,COGS 11,A01,083617,Boyle; Mary E. T.,22,0,48,26
1657384764882,COGS 13,A01,083071,Bastos; Amalia Pinkusfeld,11,0,71,60
1657384771500,COGS 14A,A01,092681,Semenuks; Arturs,4,1,100,96
1657384778453,COGS 14B,A01,083073,Cheng; Tzu-Han,6,0,63,57
1657384785040,COGS 17,A01,092677,Semenuks; Arturs,6,0,81,75
1657384791444,COGS 100,A01,083619,Allen; Michael Gordon,17,0,70,53
1657384797895,COGS 101A,A01,083621,Davis; Joshua Daniel,9,0,68,59
1657384804446,COGS 101B,A01,091572,Allen; Michael Gordon,11,0,65,54
1657384811654,COGS 101C,A01,083625,Delgado; Tania,17,0,35,18
1657384818352,COGS 107A,A01,083627,Boyle; Mary E. T.,13,0,60,47
1657384825476,COGS 118A,A01,083075,Gupta; Anjum,20,0,76,56
1657384831991,CSE 3,A50,083646,Miranda; Gregory Joseph,24,0,50,26
1657384838173,CSE 8A,A50,083650,Miranda; Gregory Joseph,17,1,56,39
1657384844428,CSE 11,A01,083080,Cao; Yingjun,6,15,40,34
1657384851958,CSE 12,A01,083652,Krause-Levy; Sophia Louisa,28,1,120,92
1657384858941,CSE 15L,A01,083654,Morris; Justin Loren,9,0,50,41
1657384858941,CSE 15L,A02,083655,Morris; Justin Loren,9,0,50,41
1657384865538,CSE 20,A01,083657,Tran; Khoa Dang,39,0,80,41
1657384872873,CSE 21,A01,095574,Bach; Quang Tran,22,0,48,26
1657384879418,CSE 30,A01,083084,Eldon; John,4,0,80,76
1657384879418,CSE 30,B01,095061,Bhaskar; Nishant,9,0,50,41
1657384886130,CSE 100,A01,083659,Cao; Yingjun,5,4,70,65
1657384892759,CSE 134B,A01,083661,Powell; Thomas Allan,22,0,100,78
1657384899655,CSE 140,A01,083663,Gungor; Onat,14,0,85,71
1657384906334,CSE 140L,A01,083088,Eldon; John,21,0,100,79
1657384912830,CSE 175,A01,083665,Kumar; Rakesh,3,0,25,22
1657384919490,CSE 190,A00,092507,Dubnov; Shlomo,7,0,20,13
1657384926288,ECE 45,A01,083139,Congero; Spencer William,6,0,75,69
1657384933163,ECE 65,A50,083695,Saad; Andrew S,12,0,30,18
1657384933163,ECE 65,A51,095125,Saad; Andrew S,24,0,26,2
1657384940077,ECE 109,A01,091882,Touri; Behrouz,19,0,70,51
1657384946525,ECE 180,A00,083140,Abi Samra; Nicholas Camill,1,0,30,29
1657384946525,ECE 180,B00,083141,Abi Samra; Nicholas Camill,0,0,30,30
1657384953502,MATH 10A,A01,083735,Patchell; Gregory David,2,0,30,28
1657384953502,MATH 10A,A02,083736,Patchell; Gregory David,20,0,30,10
1657384953502,MATH 10A,A03,083737,Patchell; Gregory David,16,0,30,14
1657384961229,MATH 10B,A01,083207,Lim; Seonhee,8,0,34,26
1657384961229,MATH 10B,A02,083208,Lim; Seonhee,9,0,35,26
1657384961229,MATH 10B,A03,093472,Lim; Seonhee,7,0,34,27
1657384961229,MATH 10B,B01,083739,Sinha; Shubham,12,0,30,18
1657384968299,MATH 18,A01,083743,Cinel; Cameron Alexander,7,0,30,23
1657384968299,MATH 18,A02,083744,Cinel; Cameron Alexander,17,0,30,13
1657384968299,MATH 18,A03,083745,Cinel; Cameron Alexander,9,0,30,21
1657384968299,MATH 18,B01,083748,Rideout; David Porter,5,0,37,32
1657384968299,MATH 18,B02,083749,Rideout; David Porter,5,0,36,31
1657384968299,MATH 18,B03,083750,Rideout; David Porter,3,0,37,34
1657384968299,MATH 18,B04,083751,Rideout; David Porter,6,0,36,30
1657384968299,MATH 18,B05,093473,Rideout; David Porter,6,0,36,30
1657384968299,MATH 18,B06,093474,Rideout; David Porter,6,0,36,30
1657384974939,MATH 20A,A01,083754,Zheng; Zequn,14,0,40,26
1657384981107,MATH 20B,A01,083756,Briones; Jor-el Thomas Caparas,4,0,36,32
1657384981107,MATH 20B,A02,083757,Briones; Jor-el Thomas Caparas,1,0,36,35
1657384981107,MATH 20B,A03,093475,Briones; Jor-el Thomas Caparas,2,0,36,34
1657384987428,MATH 20C,A01,083760,Briones; Jor-el Thomas Caparas,1,0,35,34
1657384987428,MATH 20C,A02,083761,Briones; Jor-el Thomas Caparas,8,0,35,27
1657384987428,MATH 20C,A03,093476,Briones; Jor-el Thomas Caparas,0,1,36,36
1657384987428,MATH 20C,B01,083762,Bach; Quang Tran,1,0,30,29
1657384995069,MATH 20D,A01,083765,Tran; Brian Kha,5,0,30,25
1657384995069,MATH 20D,A02,083766,Tran; Brian Kha,5,0,30,25
1657384995069,MATH 20D,A03,083767,Tran; Brian Kha,5,0,30,25
1657385001516,MATH 20E,A01,083771,Ganguly; Soumya,9,0,32,23
1657385001516,MATH 20E,A02,083772,Ganguly; Soumya,6,0,32,26
1657385001516,MATH 20E,B01,083773,Ciotti; Benjamin,20,0,35,15
1657385001516,MATH 20E,B02,083774,Ciotti; Benjamin,17,0,35,18
1657385008777,MATH 103A,A01,083777,Greenfeld; Be'Eri,3,0,36,33
1657385008777,MATH 103A,A02,083778,Greenfeld; Be'Eri,5,0,36,31
1657385008777,MATH 103A,A03,093561,Greenfeld; Be'Eri,5,0,36,31
1657385008777,MATH 103A,B01,083779,Greenfeld; Be'Eri,7,0,36,29
1657385008777,MATH 103A,B02,083780,Greenfeld; Be'Eri,4,0,36,32
1657385008777,MATH 103A,B03,093562,Greenfeld; Be'Eri,3,0,36,33
1657385015673,MATH 105,A01,085443,Carter; Anne Toulson,15,0,35,20
1657385015673,MATH 105,A02,093477,Carter; Anne Toulson,20,0,35,15
1657385022950,MATH 109,A01,083213,Ganzberger; Geoffrey Michael,2,0,34,32
1657385022950,MATH 109,A02,083214,Ganzberger; Geoffrey Michael,4,0,34,30
1657385022950,MATH 109,A03,093478,Ganzberger; Geoffrey Michael,2,0,34,32
1657385022950,MATH 109,B01,083215,Ganzberger; Geoffrey Michael,1,0,32,31
1657385022950,MATH 109,B02,083216,Ganzberger; Geoffrey Michael,2,0,32,30
1657385022950,MATH 109,B03,093479,Ganzberger; Geoffrey Michael,8,0,32,24
1657385030222,MATH 142A,A01,083219,Chow; Bennett,7,0,32,25
1657385030222,MATH 142A,A02,083220,Chow; Bennett,10,0,32,22
1657385030222,MATH 142A,A03,093480,Chow; Bennett,8,0,32,24
1657385030222,MATH 142A,B03,093481,Chow; Bennett,8,0,32,24
1657385030222,MATH 142A,B04,093558,Chow; Bennett,13,0,32,19
1657385030222,MATH 142A,B05,093559,Chow; Bennett,6,0,32,26
1657385036689,MATH 193A,A01,083224,Rotar; Vladimir,8,0,34,26
1657385036689,MATH 193A,A02,083225,Rotar; Vladimir,9,0,34,25
1657385036689,MATH 193A,A03,083781,Rotar; Vladimir,5,0,34,29
1657385036689,MATH 193A,A04,083782,Rotar; Vladimir,10,0,34,24
1657385036689,MATH 193A,A05,093482,Rotar; Vladimir,10,0,34,24
1657385043457,MATH 197,001,091859,McAuley; Julian John,9999,0,9999,0
1657385043457,MATH 197,002,095566,Kedlaya; Kiran S.,9997,0,9999,2
1657385043457,MATH 197,003,095567,Xiao; Ming,9999,0,9999,0
1657385043457,MATH 197,004,095571,Perols; Johan Lars,9998,0,9999,1
1657385052588,COGS 9,A01,083615,Shannon; Kyle Michael,9,0,75,66
1657385060938,COGS 11,A01,083617,Boyle; Mary E. T.,22,0,48,26
1657385068334,COGS 13,A01,083071,Bastos; Amalia Pinkusfeld,11,0,71,60
1657385075390,COGS 14A,A01,092681,Semenuks; Arturs,4,1,100,96
1657385082011,COGS 14B,A01,083073,Cheng; Tzu-Han,6,0,63,57
1657385088929,COGS 17,A01,092677,Semenuks; Arturs,6,0,81,75
1657385095780,COGS 100,A01,083619,Allen; Michael Gordon,17,0,70,53
1657385102134,COGS 101A,A01,083621,Davis; Joshua Daniel,9,0,68,59
1657385108163,COGS 101B,A01,091572,Allen; Michael Gordon,11,0,65,54
1657385114607,COGS 101C,A01,083625,Delgado; Tania,17,0,35,18
1657385121065,COGS 107A,A01,083627,Boyle; Mary E. T.,13,0,60,47
1657385127832,COGS 118A,A01,083075,Gupta; Anjum,20,0,76,56
1657385134046,CSE 3,A50,083646,Miranda; Gregory Joseph,24,0,50,26
1657385140287,CSE 8A,A50,083650,Miranda; Gregory Joseph,17,1,56,39
1657385146843,CSE 11,A01,083080,Cao; Yingjun,6,15,40,34
1657385153435,CSE 12,A01,083652,Krause-Levy; Sophia Louisa,28,1,120,92
1657385160392,CSE 15L,A01,083654,Morris; Justin Loren,9,0,50,41
1657385160392,CSE 15L,A02,083655,Morris; Justin Loren,9,0,50,41
1657385167289,CSE 20,A01,083657,Tran; Khoa Dang,39,0,80,41
1657385173825,CSE 21,A01,095574,Bach; Quang Tran,22,0,48,26
1657385180439,CSE 30,A01,083084,Eldon; John,4,0,80,76
1657385180439,CSE 30,B01,095061,Bhaskar; Nishant,9,0,50,41
1657385186969,CSE 100,A01,083659,Cao; Yingjun,5,4,70,65
1657385193747,CSE 134B,A01,083661,Powell; Thomas Allan,22,0,100,78
1657385199910,CSE 140,A01,083663,Gungor; Onat,14,0,85,71
1657385206433,CSE 140L,A01,083088,Eldon; John,21,0,100,79
1657385213050,CSE 175,A01,083665,Kumar; Rakesh,3,0,25,22
1657385219562,CSE 190,A00,092507,Dubnov; Shlomo,7,0,20,13
1657385226296,ECE 45,A01,083139,Congero; Spencer William,6,0,75,69
1657385232981,ECE 65,A50,083695,Saad; Andrew S,12,0,30,18
1657385232981,ECE 65,A51,095125,Saad; Andrew S,24,0,26,2
1657385239782,ECE 109,A01,091882,Touri; Behrouz,19,0,70,51
1657385246988,ECE 180,A00,083140,Abi Samra; Nicholas Camill,1,0,30,29
1657385246988,ECE 180,B00,083141,Abi Samra; Nicholas Camill,0,0,30,30
1657385254247,MATH 10A,A01,083735,Patchell; Gregory David,2,0,30,28
1657385254247,MATH 10A,A02,083736,Patchell; Gregory David,20,0,30,10
1657385254247,MATH 10A,A03,083737,Patchell; Gregory David,16,0,30,14
1657385261503,MATH 10B,A01,083207,Lim; Seonhee,8,0,34,26
1657385261503,MATH 10B,A02,083208,Lim; Seonhee,9,0,35,26
1657385261503,MATH 10B,A03,093472,Lim; Seonhee,7,0,34,27
1657385261503,MATH 10B,B01,083739,Sinha; Shubham,12,0,30,18
1657385268896,MATH 18,A01,083743,Cinel; Cameron Alexander,7,0,30,23
1657385268896,MATH 18,A02,083744,Cinel; Cameron Alexander,17,0,30,13
1657385268896,MATH 18,A03,083745,Cinel; Cameron Alexander,9,0,30,21
1657385268896,MATH 18,B01,083748,Rideout; David Porter,5,0,37,32
1657385268896,MATH 18,B02,083749,Rideout; David Porter,5,0,36,31
1657385268896,MATH 18,B03,083750,Rideout; David Porter,3,0,37,34
1657385268896,MATH 18,B04,083751,Rideout; David Porter,6,0,36,30
1657385268896,MATH 18,B05,093473,Rideout; David Porter,6,0,36,30
1657385268896,MATH 18,B06,093474,Rideout; David Porter,6,0,36,30
1657385275907,MATH 20A,A01,083754,Zheng; Zequn,14,0,40,26
1657385282629,MATH 20B,A01,083756,Briones; Jor-el Thomas Caparas,4,0,36,32
1657385282629,MATH 20B,A02,083757,Briones; Jor-el Thomas Caparas,1,0,36,35
1657385282629,MATH 20B,A03,093475,Briones; Jor-el Thomas Caparas,2,0,36,34
1657385289568,MATH 20C,A01,083760,Briones; Jor-el Thomas Caparas,1,0,35,34
1657385289568,MATH 20C,A02,083761,Briones; Jor-el Thomas Caparas,8,0,35,27
1657385289568,MATH 20C,A03,093476,Briones; Jor-el Thomas Caparas,0,1,36,36
1657385289568,MATH 20C,B01,083762,Bach; Quang Tran,1,0,30,29
1657385296755,MATH 20D,A01,083765,Tran; Brian Kha,5,0,30,25
1657385296755,MATH 20D,A02,083766,Tran; Brian Kha,5,0,30,25
1657385296755,MATH 20D,A03,083767,Tran; Brian Kha,5,0,30,25
1657385303404,MATH 20E,A01,083771,Ganguly; Soumya,9,0,32,23
1657385303404,MATH 20E,A02,083772,Ganguly; Soumya,6,0,32,26
1657385303404,MATH 20E,B01,083773,Ciotti; Benjamin,20,0,35,15
1657385303404,MATH 20E,B02,083774,Ciotti; Benjamin,17,0,35,18
1657385309947,MATH 103A,A01,083777,Greenfeld; Be'Eri,3,0,36,33
1657385309947,MATH 103A,A02,083778,Greenfeld; Be'Eri,5,0,36,31
1657385309947,MATH 103A,A03,093561,Greenfeld; Be'Eri,5,0,36,31
1657385309947,MATH 103A,B01,083779,Greenfeld; Be'Eri,7,0,36,29
1657385309947,MATH 103A,B02,083780,Greenfeld; Be'Eri,4,0,36,32
1657385309947,MATH 103A,B03,093562,Greenfeld; Be'Eri,3,0,36,33
1657385316642,MATH 105,A01,085443,Carter; Anne Toulson,15,0,35,20
1657385316642,MATH 105,A02,093477,Carter; Anne Toulson,20,0,35,15
1657385322917,MATH 109,A01,083213,Ganzberger; Geoffrey Michael,2,0,34,32
1657385322917,MATH 109,A02,083214,Ganzberger; Geoffrey Michael,4,0,34,30
1657385322917,MATH 109,A03,093478,Ganzberger; Geoffrey Michael,2,0,34,32
1657385322917,MATH 109,B01,083215,Ganzberger; Geoffrey Michael,1,0,32,31
1657385322917,MATH 109,B02,083216,Ganzberger; Geoffrey Michael,2,0,32,30
1657385322917,MATH 109,B03,093479,Ganzberger; Geoffrey Michael,8,0,32,24
1657385329537,MATH 142A,A01,083219,Chow; Bennett,7,0,32,25
1657385329537,MATH 142A,A02,083220,Chow; Bennett,10,0,32,22
1657385329537,MATH 142A,A03,093480,Chow; Bennett,8,0,32,24
1657385329537,MATH 142A,B03,093481,Chow; Bennett,8,0,32,24
1657385329537,MATH 142A,B04,093558,Chow; Bennett,13,0,32,19
1657385329537,MATH 142A,B05,093559,Chow; Bennett,6,0,32,26
1657385335983,MATH 193A,A01,083224,Rotar; Vladimir,8,0,34,26
1657385335983,MATH 193A,A02,083225,Rotar; Vladimir,9,0,34,25
1657385335983,MATH 193A,A03,083781,Rotar; Vladimir,5,0,34,29
1657385335983,MATH 193A,A04,083782,Rotar; Vladimir,10,0,34,24
1657385335983,MATH 193A,A05,093482,Rotar; Vladimir,10,0,34,24
1657385342497,MATH 197,001,091859,McAuley; Julian John,9999,0,9999,0
1657385342497,MATH 197,002,095566,Kedlaya; Kiran S.,9997,0,9999,2
1657385342497,MATH 197,003,095567,Xiao; Ming,9999,0,9999,0
1657385342497,MATH 197,004,095571,Perols; Johan Lars,9998,0,9999,1
1657385351120,COGS 9,A01,083615,Shannon; Kyle Michael,9,0,75,66
1657385357716,COGS 11,A01,083617,Boyle; Mary E. T.,22,0,48,26
1657385364209,COGS 13,A01,083071,Bastos; Amalia Pinkusfeld,11,0,71,60
1657385370797,COGS 14A,A01,092681,Semenuks; Arturs,4,1,100,96
1657385377449,COGS 14B,A01,083073,Cheng; Tzu-Han,6,0,63,57
1657385384496,COGS 17,A01,092677,Semenuks; Arturs,6,0,81,75
1657385391195,COGS 100,A01,083619,Allen; Michael Gordon,17,0,70,53
1657385397585,COGS 101A,A01,083621,Davis; Joshua Daniel,9,0,68,59
1657385404003,COGS 101B,A01,091572,Allen; Michael Gordon,11,0,65,54
1657385410420,COGS 101C,A01,083625,Delgado; Tania,17,0,35,18
1657385416582,COGS 107A,A01,083627,Boyle; Mary E. T.,13,0,60,47
1657385423389,COGS 118A,A01,083075,Gupta; Anjum,20,0,76,56
1657385430018,CSE 3,A50,083646,Miranda; Gregory Joseph,24,0,50,26
1657385436846,CSE 8A,A50,083650,Miranda; Gregory Joseph,17,1,56,39
1657385443437,CSE 11,A01,083080,Cao; Yingjun,6,15,40,34
1657385450093,CSE 12,A01,083652,Krause-Levy; Sophia Louisa,28,1,120,92
1657385456580,CSE 15L,A01,083654,Morris; Justin Loren,9,0,50,41
1657385456580,CSE 15L,A02,083655,Morris; Justin Loren,9,0,50,41
1657385462899,CSE 20,A01,083657,Tran; Khoa Dang,39,0,80,41
1657385470064,CSE 21,A01,095574,Bach; Quang Tran,22,0,48,26
1657385476535,CSE 30,A01,083084,Eldon; John,4,0,80,76
1657385476535,CSE 30,B01,095061,Bhaskar; Nishant,9,0,50,41
1657385482855,CSE 100,A01,083659,Cao; Yingjun,5,4,70,65
1657385489638,CSE 134B,A01,083661,Powell; Thomas Allan,22,0,100,78
1657385496239,CSE 140,A01,083663,Gungor; Onat,14,0,85,71
1657385503286,CSE 140L,A01,083088,Eldon; John,21,0,100,79
1657385509748,CSE 175,A01,083665,Kumar; Rakesh,3,0,25,22
1657385516307,CSE 190,A00,092507,Dubnov; Shlomo,7,0,20,13
1657385522670,ECE 45,A01,083139,Congero; Spencer William,6,0,75,69
1657385529789,ECE 65,A50,083695,Saad; Andrew S,12,0,30,18
1657385529789,ECE 65,A51,095125,Saad; Andrew S,24,0,26,2
1657385536534,ECE 109,A01,091882,Touri; Behrouz,19,0,70,51
1657385543311,ECE 180,A00,083140,Abi Samra; Nicholas Camill,1,0,30,29
1657385543311,ECE 180,B00,083141,Abi Samra; Nicholas Camill,0,0,30,30
1657385550790,MATH 10A,A01,083735,Patchell; Gregory David,2,0,30,28
1657385550790,MATH 10A,A02,083736,Patchell; Gregory David,20,0,30,10
1657385550790,MATH 10A,A03,083737,Patchell; Gregory David,16,0,30,14
1657385557652,MATH 10B,A01,083207,Lim; Seonhee,8,0,34,26
1657385557652,MATH 10B,A02,083208,Lim; Seonhee,9,0,35,26
1657385557652,MATH 10B,A03,093472,Lim; Seonhee,7,0,34,27
1657385557652,MATH 10B,B01,083739,Sinha; Shubham,12,0,30,18
1657385564612,MATH 18,A01,083743,Cinel; Cameron Alexander,7,0,30,23
1657385564612,MATH 18,A02,083744,Cinel; Cameron Alexander,17,0,30,13
1657385564612,MATH 18,A03,083745,Cinel; Cameron Alexander,9,0,30,21
1657385564612,MATH 18,B01,083748,Rideout; David Porter,5,0,37,32
1657385564612,MATH 18,B02,083749,Rideout; David Porter,5,0,36,31
1657385564612,MATH 18,B03,083750,Rideout; David Porter,3,0,37,34
1657385564612,MATH 18,B04,083751,Rideout; David Porter,6,0,36,30
1657385564612,MATH 18,B05,093473,Rideout; David Porter,6,0,36,30
1657385564612,MATH 18,B06,093474,Rideout; David Porter,6,0,36,30
1657385571400,MATH 20A,A01,083754,Zheng; Zequn,14,0,40,26
1657385577527,MATH 20B,A01,083756,Briones; Jor-el Thomas Caparas,4,0,36,32
1657385577527,MATH 20B,A02,083757,Briones; Jor-el Thomas Caparas,1,0,36,35
1657385577527,MATH 20B,A03,093475,Briones; Jor-el Thomas Caparas,2,0,36,34
1657385585018,MATH 20C,A01,083760,Briones; Jor-el Thomas Caparas,1,0,35,34
1657385585018,MATH 20C,A02,083761,Briones; Jor-el Thomas Caparas,8,0,35,27
1657385585018,MATH 20C,A03,093476,Briones; Jor-el Thomas Caparas,0,1,36,36
1657385585018,MATH 20C,B01,083762,Bach; Quang Tran,1,0,30,29
1657385592832,MATH 20D,A01,083765,Tran; Brian Kha,5,0,30,25
1657385592832,MATH 20D,A02,083766,Tran; Brian Kha,5,0,30,25
1657385592832,MATH 20D,A03,083767,Tran; Brian Kha,5,0,30,25
1657385599996,MATH 20E,A01,083771,Ganguly; Soumya,9,0,32,23
1657385599996,MATH 20E,A02,083772,Ganguly; Soumya,6,0,32,26
1657385599996,MATH 20E,B01,083773,Ciotti; Benjamin,20,0,35,15
1657385599996,MATH 20E,B02,083774,Ciotti; Benjamin,17,0,35,18
1657385606500,MATH 103A,A01,083777,Greenfeld; Be'Eri,3,0,36,33
1657385606500,MATH 103A,A02,083778,Greenfeld; Be'Eri,5,0,36,31
1657385606500,MATH 103A,A03,093561,Greenfeld; Be'Eri,5,0,36,31
1657385606500,MATH 103A,B01,083779,Greenfeld; Be'Eri,7,0,36,29
1657385606500,MATH 103A,B02,083780,Greenfeld; Be'Eri,4,0,36,32
1657385606500,MATH 103A,B03,093562,Greenfeld; Be'Eri,3,0,36,33
1657385614554,MATH 105,A01,085443,Carter; Anne Toulson,15,0,35,20
1657385614554,MATH 105,A02,093477,Carter; Anne Toulson,20,0,35,15
1657385622177,MATH 109,A01,083213,Ganzberger; Geoffrey Michael,2,0,34,32
1657385622177,MATH 109,A02,083214,Ganzberger; Geoffrey Michael,4,0,34,30
1657385622177,MATH 109,A03,093478,Ganzberger; Geoffrey Michael,2,0,34,32
1657385622177,MATH 109,B01,083215,Ganzberger; Geoffrey Michael,1,0,32,31
1657385622177,MATH 109,B02,083216,Ganzberger; Geoffrey Michael,2,0,32,30
1657385622177,MATH 109,B03,093479,Ganzberger; Geoffrey Michael,8,0,32,24
1657385629027,MATH 142A,A01,083219,Chow; Bennett,7,0,32,25
1657385629027,MATH 142A,A02,083220,Chow; Bennett,10,0,32,22
1657385629027,MATH 142A,A03,093480,Chow; Bennett,8,0,32,24
1657385629027,MATH 142A,B03,093481,Chow; Bennett,8,0,32,24
1657385629027,MATH 142A,B04,093558,Chow; Bennett,13,0,32,19
1657385629027,MATH 142A,B05,093559,Chow; Bennett,6,0,32,26
1657385635493,MATH 193A,A01,083224,Rotar; Vladimir,8,0,34,26
1657385635493,MATH 193A,A02,083225,Rotar; Vladimir,9,0,34,25
1657385635493,MATH 193A,A03,083781,Rotar; Vladimir,5,0,34,29
1657385635493,MATH 193A,A04,083782,Rotar; Vladimir,10,0,34,24
1657385635493,MATH 193A,A05,093482,Rotar; Vladimir,10,0,34,24
1657385642977,MATH 197,001,091859,McAuley; Julian John,9999,0,9999,0
1657385642977,MATH 197,002,095566,Kedlaya; Kiran S.,9997,0,9999,2
1657385642977,MATH 197,003,095567,Xiao; Ming,9999,0,9999,0
1657385642977,MATH 197,004,095571,Perols; Johan Lars,9998,0,9999,1
1657385651947,COGS 9,A01,083615,Shannon; Kyle Michael,9,0,75,66
1657385659292,COGS 11,A01,083617,Boyle; Mary E. T.,22,0,48,26
1657385666028,COGS 13,A01,083071,Bastos; Amalia Pinkusfeld,11,0,71,60
1657385673253,COGS 14A,A01,092681,Semenuks; Arturs,4,1,100,96
1657385679489,COGS 14B,A01,083073,Cheng; Tzu-Han,6,0,63,57
1657385687451,COGS 17,A01,092677,Semenuks; Arturs,6,0,81,75
1657385694031,COGS 100,A01,083619,Allen; Michael Gordon,17,0,70,53
1657385700691,COGS 101A,A01,083621,Davis; Joshua Daniel,9,0,68,59
1657385707291,COGS 101B,A01,091572,Allen; Michael Gordon,11,0,65,54
1657385713758,COGS 101C,A01,083625,Delgado; Tania,17,0,35,18
1657385720810,COGS 107A,A01,083627,Boyle; Mary E. T.,13,0,60,47
1657385727091,COGS 118A,A01,083075,Gupta; Anjum,20,0,76,56
1657385733459,CSE 3,A50,083646,Miranda; Gregory Joseph,24,0,50,26
1657385739943,CSE 8A,A50,083650,Miranda; Gregory Joseph,17,1,56,39
1657385746533,CSE 11,A01,083080,Cao; Yingjun,6,15,40,34
1657385753342,CSE 12,A01,083652,Krause-Levy; Sophia Louisa,28,1,120,92
1657385759937,CSE 15L,A01,083654,Morris; Justin Loren,9,0,50,41
1657385759937,CSE 15L,A02,083655,Morris; Justin Loren,9,0,50,41
1657385766024,CSE 20,A01,083657,Tran; Khoa Dang,39,0,80,41
1657385772186,CSE 21,A01,095574,Bach; Quang Tran,22,0,48,26
1657385779080,CSE 30,A01,083084,Eldon; John,4,0,80,76
1657385779080,CSE 30,B01,095061,Bhaskar; Nishant,9,0,50,41
1657385786265,CSE 100,A01,083659,Cao; Yingjun,5,4,70,65
1657385793286,CSE 134B,A01,083661,Powell; Thomas Allan,22,0,100,78
1657385799932,CSE 140,A01,083663,Gungor; Onat,14,0,85,71
1657385806797,CSE 140L,A01,083088,Eldon; John,21,0,100,79
1657385813260,CSE 175,A01,083665,Kumar; Rakesh,3,0,25,22
1657385819596,CSE 190,A00,092507,Dubnov; Shlomo,7,0,20,13
1657385826043,ECE 45,A01,083139,Congero; Spencer William,6,0,75,69
1657385833002,ECE 65,A50,083695,Saad; Andrew S,12,0,30,18
1657385833002,ECE 65,A51,095125,Saad; Andrew S,24,0,26,2
1657385840311,ECE 109,A01,091882,Touri; Behrouz,19,0,70,51
1657385847325,ECE 180,A00,083140,Abi Samra; Nicholas Camill,1,0,30,29
1657385847325,ECE 180,B00,083141,Abi Samra; Nicholas Camill,0,0,30,30
1657385854047,MATH 10A,A01,083735,Patchell; Gregory David,2,0,30,28
1657385854047,MATH 10A,A02,083736,Patchell; Gregory David,20,0,30,10
1657385854047,MATH 10A,A03,083737,Patchell; Gregory David,16,0,30,14
1657385861166,MATH 10B,A01,083207,Lim; Seonhee,8,0,34,26
1657385861166,MATH 10B,A02,083208,Lim; Seonhee,9,0,35,26
1657385861166,MATH 10B,A03,093472,Lim; Seonhee,7,0,34,27
1657385861166,MATH 10B,B01,083739,Sinha; Shubham,12,0,30,18
1657385867423,MATH 18,A01,083743,Cinel; Cameron Alexander,7,0,30,23
1657385867423,MATH 18,A02,083744,Cinel; Cameron Alexander,17,0,30,13
1657385867423,MATH 18,A03,083745,Cinel; Cameron Alexander,9,0,30,21
1657385867423,MATH 18,B01,083748,Rideout; David Porter,5,0,37,32
1657385867423,MATH 18,B02,083749,Rideout; David Porter,5,0,36,31
1657385867423,MATH 18,B03,083750,Rideout; David Porter,3,0,37,34
1657385867423,MATH 18,B04,083751,Rideout; David Porter,6,0,36,30
1657385867423,MATH 18,B05,093473,Rideout; David Porter,6,0,36,30
1657385867423,MATH 18,B06,093474,Rideout; David Porter,6,0,36,30
1657385873730,MATH 20A,A01,083754,Zheng; Zequn,14,0,40,26
1657385880217,MATH 20B,A01,083756,Briones; Jor-el Thomas Caparas,4,0,36,32
1657385880217,MATH 20B,A02,083757,Briones; Jor-el Thomas Caparas,1,0,36,35
1657385880217,MATH 20B,A03,093475,Briones; Jor-el Thomas Caparas,2,0,36,34
1657385886509,MATH 20C,A01,083760,Briones; Jor-el Thomas Caparas,1,0,35,34
1657385886509,MATH 20C,A02,083761,Briones; Jor-el Thomas Caparas,8,0,35,27
1657385886509,MATH 20C,A03,093476,Briones; Jor-el Thomas Caparas,0,1,36,36
1657385886509,MATH 20C,B01,083762,Bach; Quang Tran,1,0,30,29
1657385893080,MATH 20D,A01,083765,Tran; Brian Kha,5,0,30,25
1657385893080,MATH 20D,A02,083766,Tran; Brian Kha,5,0,30,25
1657385893080,MATH 20D,A03,083767,Tran; Brian Kha,5,0,30,25
1657385900070,MATH 20E,A01,083771,Ganguly; Soumya,9,0,32,23
1657385900070,MATH 20E,A02,083772,Ganguly; Soumya,6,0,32,26
1657385900070,MATH 20E,B01,083773,Ciotti; Benjamin,20,0,35,15
1657385900070,MATH 20E,B02,083774,Ciotti; Benjamin,17,0,35,18
1657385907184,MATH 103A,A01,083777,Greenfeld; Be'Eri,3,0,36,33
1657385907184,MATH 103A,A02,083778,Greenfeld; Be'Eri,5,0,36,31
1657385907184,MATH 103A,A03,093561,Greenfeld; Be'Eri,5,0,36,31
1657385907184,MATH 103A,B01,083779,Greenfeld; Be'Eri,7,0,36,29
1657385907184,MATH 103A,B02,083780,Greenfeld; Be'Eri,4,0,36,32
1657385907184,MATH 103A,B03,093562,Greenfeld; Be'Eri,3,0,36,33
1657385913488,MATH 105,A01,085443,Carter; Anne Toulson,15,0,35,20
1657385913488,MATH 105,A02,093477,Carter; Anne Toulson,20,0,35,15
1657385919894,MATH 109,A01,083213,Ganzberger; Geoffrey Michael,2,0,34,32
1657385919894,MATH 109,A02,083214,Ganzberger; Geoffrey Michael,4,0,34,30
1657385919894,MATH 109,A03,093478,Ganzberger; Geoffrey Michael,2,0,34,32
1657385919894,MATH 109,B01,083215,Ganzberger; Geoffrey Michael,1,0,32,31
1657385919894,MATH 109,B02,083216,Ganzberger; Geoffrey Michael,2,0,32,30
1657385919894,MATH 109,B03,093479,Ganzberger; Geoffrey Michael,8,0,32,24
1657385926400,MATH 142A,A01,083219,Chow; Bennett,7,0,32,25
1657385926400,MATH 142A,A02,083220,Chow; Bennett,10,0,32,22
1657385926400,MATH 142A,A03,093480,Chow; Bennett,8,0,32,24
1657385926400,MATH 142A,B03,093481,Chow; Bennett,8,0,32,24
1657385926400,MATH 142A,B04,093558,Chow; Bennett,13,0,32,19
1657385926400,MATH 142A,B05,093559,Chow; Bennett,6,0,32,26
1657385932894,MATH 193A,A01,083224,Rotar; Vladimir,8,0,34,26
1657385932894,MATH 193A,A02,083225,Rotar; Vladimir,9,0,34,25
1657385932894,MATH 193A,A03,083781,Rotar; Vladimir,5,0,34,29
1657385932894,MATH 193A,A04,083782,Rotar; Vladimir,10,0,34,24
1657385932894,MATH 193A,A05,093482,Rotar; Vladimir,10,0,34,24
1657385939425,MATH 197,001,091859,McAuley; Julian John,9999,0,9999,0
1657385939425,MATH 197,002,095566,Kedlaya; Kiran S.,9997,0,9999,2
1657385939425,MATH 197,003,095567,Xiao; Ming,9999,0,9999,0
1657385939425,MATH 197,004,095571,Perols; Johan Lars,9998,0,9999,1
1657385947296,COGS 9,A01,083615,Shannon; Kyle Michael,9,0,75,66
1657385953417,COGS 11,A01,083617,Boyle; Mary E. T.,22,0,48,26
1657385959678,COGS 13,A01,083071,Bastos; Amalia Pinkusfeld,11,0,71,60
1657385966199,COGS 14A,A01,092681,Semenuks; Arturs,4,1,100,96
1657385972840,COGS 14B,A01,083073,Cheng; Tzu-Han,6,0,63,57
1657385979349,COGS 17,A01,092677,Semenuks; Arturs,6,0,81,75
1657385985913,COGS 100,A01,083619,Allen; Michael Gordon,17,0,70,53
1657385992319,COGS 101A,A01,083621,Davis; Joshua Daniel,9,0,68,59
1657385998914,COGS 101B,A01,091572,Allen; Michael Gordon,11,0,65,54
1657386005100,COGS 101C,A01,083625,Delgado; Tania,17,0,35,18
1657386012815,COGS 107A,A01,083627,Boyle; Mary E. T.,13,0,60,47
1657386019607,COGS 118A,A01,083075,Gupta; Anjum,20,0,76,56
1657386026060,CSE 3,A50,083646,Miranda; Gregory Joseph,24,0,50,26
1657386032729,CSE 8A,A50,083650,Miranda; Gregory Joseph,17,1,56,39
1657386038869,CSE 11,A01,083080,Cao; Yingjun,6,15,40,34
1657386045865,CSE 12,A01,083652,Krause-Levy; Sophia Louisa,28,1,120,92
1657386052289,CSE 15L,A01,083654,Morris; Justin Loren,9,0,50,41
1657386052289,CSE 15L,A02,083655,Morris; Justin Loren,9,0,50,41
1657386059260,CSE 20,A01,083657,Tran; Khoa Dang,39,0,80,41
1657386065641,CSE 21,A01,095574,Bach; Quang Tran,22,0,48,26
1657386072578,CSE 30,A01,083084,Eldon; John,4,0,80,76
1657386072578,CSE 30,B01,095061,Bhaskar; Nishant,9,0,50,41
1657386080261,CSE 100,A01,083659,Cao; Yingjun,5,4,70,65
1657386086939,CSE 134B,A01,083661,Powell; Thomas Allan,22,0,100,78
1657386093250,CSE 140,A01,083663,Gungor; Onat,14,0,85,71
1657386099736,CSE 140L,A01,083088,Eldon; John,21,0,100,79
1657386106325,CSE 175,A01,083665,Kumar; Rakesh,3,0,25,22
1657386112638,CSE 190,A00,092507,Dubnov; Shlomo,7,0,20,13
1657386119289,ECE 45,A01,083139,Congero; Spencer William,6,0,75,69
1657386125711,ECE 65,A50,083695,Saad; Andrew S,12,0,30,18
1657386125711,ECE 65,A51,095125,Saad; Andrew S,24,0,26,2
1657386132003,ECE 109,A01,091882,Touri; Behrouz,19,0,70,51
1657386138286,ECE 180,A00,083140,Abi Samra; Nicholas Camill,1,0,30,29
1657386138286,ECE 180,B00,083141,Abi Samra; Nicholas Camill,0,0,30,30
1657386144406,MATH 10A,A01,083735,Patchell; Gregory David,2,0,30,28
1657386144406,MATH 10A,A02,083736,Patchell; Gregory David,20,0,30,10
1657386144406,MATH 10A,A03,083737,Patchell; Gregory David,16,0,30,14
1657386150671,MATH 10B,A01,083207,Lim; Seonhee,8,0,34,26
1657386150671,MATH 10B,A02,083208,Lim; Seonhee,9,0,35,26
1657386150671,MATH 10B,A03,093472,Lim; Seonhee,7,0,34,27
1657386150671,MATH 10B,B01,083739,Sinha; Shubham,12,0,30,18
1657386156890,MATH 18,A01,083743,Cinel; Cameron Alexander,7,0,30,23
1657386156890,MATH 18,A02,083744,Cinel; Cameron Alexander,17,0,30,13
1657386156890,MATH 18,A03,083745,Cinel; Cameron Alexander,9,0,30,21
1657386156890,MATH 18,B01,083748,Rideout; David Porter,5,0,37,32
1657386156890,MATH 18,B02,083749,Rideout; David Porter,5,0,36,31
1657386156890,MATH 18,B03,083750,Rideout; David Porter,3,0,37,34
1657386156890,MATH 18,B04,083751,Rideout; David Porter,6,0,36,30
1657386156890,MATH 18,B05,093473,Rideout; David Porter,6,0,36,30
1657386156890,MATH 18,B06,093474,Rideout; David Porter,6,0,36,30
1657386163305,MATH 20A,A01,083754,Zheng; Zequn,14,0,40,26
1657386169794,MATH 20B,A01,083756,Briones; Jor-el Thomas Caparas,4,0,36,32
1657386169794,MATH 20B,A02,083757,Briones; Jor-el Thomas Caparas,1,0,36,35
1657386169794,MATH 20B,A03,093475,Briones; Jor-el Thomas Caparas,2,0,36,34
1657386176950,MATH 20C,A01,083760,Briones; Jor-el Thomas Caparas,1,0,35,34
1657386176950,MATH 20C,A02,083761,Briones; Jor-el Thomas Caparas,8,0,35,27
1657386176950,MATH 20C,A03,093476,Briones; Jor-el Thomas Caparas,0,1,36,36
1657386176950,MATH 20C,B01,083762,Bach; Quang Tran,1,0,30,29
1657386183484,MATH 20D,A01,083765,Tran; Brian Kha,5,0,30,25
1657386183484,MATH 20D,A02,083766,Tran; Brian Kha,5,0,30,25
1657386183484,MATH 20D,A03,083767,Tran; Brian Kha,5,0,30,25
1657386190513,MATH 20E,A01,083771,Ganguly; Soumya,9,0,32,23
1657386190513,MATH 20E,A02,083772,Ganguly; Soumya,6,0,32,26
1657386190513,MATH 20E,B01,083773,Ciotti; Benjamin,20,0,35,15
1657386190513,MATH 20E,B02,083774,Ciotti; Benjamin,17,0,35,18
1657386196749,MATH 103A,A01,083777,Greenfeld; Be'Eri,3,0,36,33
1657386196749,MATH 103A,A02,083778,Greenfeld; Be'Eri,5,0,36,31
1657386196749,MATH 103A,A03,093561,Greenfeld; Be'Eri,5,0,36,31
1657386196749,MATH 103A,B01,083779,Greenfeld; Be'Eri,7,0,36,29
1657386196749,MATH 103A,B02,083780,Greenfeld; Be'Eri,4,0,36,32
1657386196749,MATH 103A,B03,093562,Greenfeld; Be'Eri,3,0,36,33
1657386202793,MATH 105,A01,085443,Carter; Anne Toulson,15,0,35,20
1657386202793,MATH 105,A02,093477,Carter; Anne Toulson,20,0,35,15
1657386209185,MATH 109,A01,083213,Ganzberger; Geoffrey Michael,2,0,34,32
1657386209185,MATH 109,A02,083214,Ganzberger; Geoffrey Michael,4,0,34,30
1657386209185,MATH 109,A03,093478,Ganzberger; Geoffrey Michael,2,0,34,32
1657386209185,MATH 109,B01,083215,Ganzberger; Geoffrey Michael,1,0,32,31
1657386209185,MATH 109,B02,083216,Ganzberger; Geoffrey Michael,2,0,32,30
1657386209185,MATH 109,B03,093479,Ganzberger; Geoffrey Michael,8,0,32,24
1657386215948,MATH 142A,A01,083219,Chow; Bennett,7,0,32,25
1657386215948,MATH 142A,A02,083220,Chow; Bennett,10,0,32,22
1657386215948,MATH 142A,A03,093480,Chow; Bennett,8,0,32,24
1657386215948,MATH 142A,B03,093481,Chow; Bennett,8,0,32,24
1657386215948,MATH 142A,B04,093558,Chow; Bennett,13,0,32,19
1657386215948,MATH 142A,B05,093559,Chow; Bennett,6,0,32,26
1657386223262,MATH 193A,A01,083224,Rotar; Vladimir,8,0,34,26
1657386223262,MATH 193A,A02,083225,Rotar; Vladimir,9,0,34,25
1657386223262,MATH 193A,A03,083781,Rotar; Vladimir,5,0,34,29
1657386223262,MATH 193A,A04,083782,Rotar; Vladimir,10,0,34,24
1657386223262,MATH 193A,A05,093482,Rotar; Vladimir,10,0,34,24
1657386230313,MATH 197,001,091859,McAuley; Julian John,9999,0,9999,0
1657386230313,MATH 197,002,095566,Kedlaya; Kiran S.,9997,0,9999,2
1657386230313,MATH 197,003,095567,Xiao; Ming,9999,0,9999,0
1657386230313,MATH 197,004,095571,Perols; Johan Lars,9998,0,9999,1
1657386239071,COGS 9,A01,083615,Shannon; Kyle Michael,9,0,75,66
1657386245551,COGS 11,A01,083617,Boyle; Mary E. T.,22,0,48,26
1657386251979,COGS 13,A01,083071,Bastos; Amalia Pinkusfeld,11,0,71,60
1657386258775,COGS 14A,A01,092681,Semenuks; Arturs,4,1,100,96
1657386265559,COGS 14B,A01,083073,Cheng; Tzu-Han,6,0,63,57
1657386271775,COGS 17,A01,092677,Semenuks; Arturs,6,0,81,75
1657386278154,COGS 100,A01,083619,Allen; Michael Gordon,17,0,70,53
1657386284691,COGS 101A,A01,083621,Davis; Joshua Daniel,9,0,68,59
1657386290908,COGS 101B,A01,091572,Allen; Michael Gordon,11,0,65,54
1657386297247,COGS 101C,A01,083625,Delgado; Tania,17,0,35,18
1657386303946,COGS 107A,A01,083627,Boyle; Mary E. T.,13,0,60,47
1657386310203,COGS 118A,A01,083075,Gupta; Anjum,20,0,76,56
1657386316724,CSE 3,A50,083646,Miranda; Gregory Joseph,24,0,50,26
1657386322870,CSE 8A,A50,083650,Miranda; Gregory Joseph,17,1,56,39
1657386328956,CSE 11,A01,083080,Cao; Yingjun,6,15,40,34
1657386336063,CSE 12,A01,083652,Krause-Levy; Sophia Louisa,28,1,120,92
1657386343315,CSE 15L,A01,083654,Morris; Justin Loren,9,0,50,41
1657386343315,CSE 15L,A02,083655,Morris; Justin Loren,9,0,50,41
1657386350445,CSE 20,A01,083657,Tran; Khoa Dang,39,0,80,41
1657386357270,CSE 21,A01,095574,Bach; Quang Tran,22,0,48,26
1657386363695,CSE 30,A01,083084,Eldon; John,4,0,80,76
1657386363695,CSE 30,B01,095061,Bhaskar; Nishant,9,0,50,41
1657386370766,CSE 100,A01,083659,Cao; Yingjun,5,4,70,65
1657386378175,CSE 134B,A01,083661,Powell; Thomas Allan,22,0,100,78
1657386384665,CSE 140,A01,083663,Gungor; Onat,14,0,85,71
1657386391565,CSE 140L,A01,083088,Eldon; John,21,0,100,79
1657386397788,CSE 175,A01,083665,Kumar; Rakesh,3,0,25,22
1657386404487,CSE 190,A00,092507,Dubnov; Shlomo,7,0,20,13
1657386410615,ECE 45,A01,083139,Congero; Spencer William,6,0,75,69
1657386416777,ECE 65,A50,083695,Saad; Andrew S,12,0,30,18
1657386416777,ECE 65,A51,095125,Saad; Andrew S,24,0,26,2
1657386423797,ECE 109,A01,091882,Touri; Behrouz,19,0,70,51
1657386430863,ECE 180,A00,083140,Abi Samra; Nicholas Camill,1,0,30,29
1657386430863,ECE 180,B00,083141,Abi Samra; Nicholas Camill,0,0,30,30
1657386437334,MATH 10A,A01,083735,Patchell; Gregory David,2,0,30,28
1657386437334,MATH 10A,A02,083736,Patchell; Gregory David,20,0,30,10
1657386437334,MATH 10A,A03,083737,Patchell; Gregory David,16,0,30,14
1657386444165,MATH 10B,A01,083207,Lim; Seonhee,8,0,34,26
1657386444165,MATH 10B,A02,083208,Lim; Seonhee,9,0,35,26
1657386444165,MATH 10B,A03,093472,Lim; Seonhee,7,0,34,27
1657386444165,MATH 10B,B01,083739,Sinha; Shubham,12,0,30,18
1657386450766,MATH 18,A01,083743,Cinel; Cameron Alexander,7,0,30,23
1657386450766,MATH 18,A02,083744,Cinel; Cameron Alexander,17,0,30,13
1657386450766,MATH 18,A03,083745,Cinel; Cameron Alexander,9,0,30,21
1657386450766,MATH 18,B01,083748,Rideout; David Porter,5,0,37,32
1657386450766,MATH 18,B02,083749,Rideout; David Porter,5,0,36,31
1657386450766,MATH 18,B03,083750,Rideout; David Porter,3,0,37,34
1657386450766,MATH 18,B04,083751,Rideout; David Porter,6,0,36,30
1657386450766,MATH 18,B05,093473,Rideout; David Porter,6,0,36,30
1657386450766,MATH 18,B06,093474,Rideout; David Porter,6,0,36,30
1657386457057,MATH 20A,A01,083754,Zheng; Zequn,14,0,40,26
1657386463517,MATH 20B,A01,083756,Briones; Jor-el Thomas Caparas,4,0,36,32
1657386463517,MATH 20B,A02,083757,Briones; Jor-el Thomas Caparas,1,0,36,35
1657386463517,MATH 20B,A03,093475,Briones; Jor-el Thomas Caparas,2,0,36,34
1657386470587,MATH 20C,A01,083760,Briones; Jor-el Thomas Caparas,1,0,35,34
1657386470587,MATH 20C,A02,083761,Briones; Jor-el Thomas Caparas,8,0,35,27
1657386470587,MATH 20C,A03,093476,Briones; Jor-el Thomas Caparas,0,1,36,36
1657386470587,MATH 20C,B01,083762,Bach; Quang Tran,1,0,30,29
1657386477838,MATH 20D,A01,083765,Tran; Brian Kha,5,0,30,25
1657386477838,MATH 20D,A02,083766,Tran; Brian Kha,5,0,30,25
1657386477838,MATH 20D,A03,083767,Tran; Brian Kha,5,0,30,25
1657386484249,MATH 20E,A01,083771,Ganguly; Soumya,9,0,32,23
1657386484249,MATH 20E,A02,083772,Ganguly; Soumya,6,0,32,26
1657386484249,MATH 20E,B01,083773,Ciotti; Benjamin,20,0,35,15
1657386484249,MATH 20E,B02,083774,Ciotti; Benjamin,17,0,35,18
1657386490966,MATH 103A,A01,083777,Greenfeld; Be'Eri,3,0,36,33
1657386490966,MATH 103A,A02,083778,Greenfeld; Be'Eri,5,0,36,31
1657386490966,MATH 103A,A03,093561,Greenfeld; Be'Eri,5,0,36,31
1657386490966,MATH 103A,B01,083779,Greenfeld; Be'Eri,7,0,36,29
1657386490966,MATH 103A,B02,083780,Greenfeld; Be'Eri,4,0,36,32
1657386490966,MATH 103A,B03,093562,Greenfeld; Be'Eri,3,0,36,33
1657386497472,MATH 105,A01,085443,Carter; Anne Toulson,15,0,35,20
1657386497472,MATH 105,A02,093477,Carter; Anne Toulson,20,0,35,15
1657386504303,MATH 109,A01,083213,Ganzberger; Geoffrey Michael,2,0,34,32
1657386504303,MATH 109,A02,083214,Ganzberger; Geoffrey Michael,4,0,34,30
1657386504303,MATH 109,A03,093478,Ganzberger; Geoffrey Michael,2,0,34,32
1657386504303,MATH 109,B01,083215,Ganzberger; Geoffrey Michael,1,0,32,31
1657386504303,MATH 109,B02,083216,Ganzberger; Geoffrey Michael,2,0,32,30
1657386504303,MATH 109,B03,093479,Ganzberger; Geoffrey Michael,8,0,32,24
1657386510515,MATH 142A,A01,083219,Chow; Bennett,7,0,32,25
1657386510515,MATH 142A,A02,083220,Chow; Bennett,10,0,32,22
1657386510515,MATH 142A,A03,093480,Chow; Bennett,8,0,32,24
1657386510515,MATH 142A,B03,093481,Chow; Bennett,8,0,32,24
1657386510515,MATH 142A,B04,093558,Chow; Bennett,13,0,32,19
1657386510515,MATH 142A,B05,093559,Chow; Bennett,6,0,32,26
1657386516761,MATH 193A,A01,083224,Rotar; Vladimir,8,0,34,26
1657386516761,MATH 193A,A02,083225,Rotar; Vladimir,9,0,34,25
1657386516761,MATH 193A,A03,083781,Rotar; Vladimir,5,0,34,29
1657386516761,MATH 193A,A04,083782,Rotar; Vladimir,10,0,34,24
1657386516761,MATH 193A,A05,093482,Rotar; Vladimir,10,0,34,24
1657386523353,MATH 197,001,091859,McAuley; Julian John,9999,0,9999,0
1657386523353,MATH 197,002,095566,Kedlaya; Kiran S.,9997,0,9999,2
1657386523353,MATH 197,003,095567,Xiao; Ming,9999,0,9999,0
1657386523353,MATH 197,004,095571,Perols; Johan Lars,9998,0,9999,1
1657386531175,COGS 9,A01,083615,Shannon; Kyle Michael,9,0,75,66
1657386537508,COGS 11,A01,083617,Boyle; Mary E. T.,22,0,48,26
1657386544074,COGS 13,A01,083071,Bastos; Amalia Pinkusfeld,11,0,71,60
1657386550645,COGS 14A,A01,092681,Semenuks; Arturs,4,1,100,96
1657386557278,COGS 14B,A01,083073,Cheng; Tzu-Han,6,0,63,57
1657386563779,COGS 17,A01,092677,Semenuks; Arturs,6,0,81,75
1657386570908,COGS 100,A01,083619,Allen; Michael Gordon,17,0,70,53
1657386578126,COGS 101A,A01,083621,Davis; Joshua Daniel,9,0,68,59
1657386584769,COGS 101B,A01,091572,Allen; Michael Gordon,11,0,65,54
1657386591653,COGS 101C,A01,083625,Delgado; Tania,17,0,35,18
1657386597770,COGS 107A,A01,083627,Boyle; Mary E. T.,13,0,60,47
1657386603868,COGS 118A,A01,083075,Gupta; Anjum,20,0,76,56
1657386611248,CSE 3,A50,083646,Miranda; Gregory Joseph,24,0,50,26
1657386617711,CSE 8A,A50,083650,Miranda; Gregory Joseph,17,1,56,39
1657386624216,CSE 11,A01,083080,Cao; Yingjun,6,15,40,34
1657386631119,CSE 12,A01,083652,Krause-Levy; Sophia Louisa,28,1,120,92
1657386637723,CSE 15L,A01,083654,Morris; Justin Loren,9,0,50,41
1657386637723,CSE 15L,A02,083655,Morris; Justin Loren,9,0,50,41
1657386644164,CSE 20,A01,083657,Tran; Khoa Dang,39,0,80,41
1657386651680,CSE 21,A01,095574,Bach; Quang Tran,22,0,48,26
1657386659041,CSE 30,A01,083084,Eldon; John,4,0,80,76
1657386659041,CSE 30,B01,095061,Bhaskar; Nishant,9,0,50,41
1657386665188,CSE 100,A01,083659,Cao; Yingjun,5,4,70,65
1657386672652,CSE 134B,A01,083661,Powell; Thomas Allan,22,0,100,78
1657386679782,CSE 140,A01,083663,Gungor; Onat,14,0,85,71
1657386686419,CSE 140L,A01,083088,Eldon; John,21,0,100,79
1657386693603,CSE 175,A01,083665,Kumar; Rakesh,3,0,25,22
1657386700580,CSE 190,A00,092507,Dubnov; Shlomo,7,0,20,13
1657386707746,ECE 45,A01,083139,Congero; Spencer William,6,0,75,69
1657386714803,ECE 65,A50,083695,Saad; Andrew S,12,0,30,18
1657386714803,ECE 65,A51,095125,Saad; Andrew S,24,0,26,2
1657386721192,ECE 109,A01,091882,Touri; Behrouz,19,0,70,51
1657386727706,ECE 180,A00,083140,Abi Samra; Nicholas Camill,1,0,30,29
1657386727706,ECE 180,B00,083141,Abi Samra; Nicholas Camill,0,0,30,30
1657386734542,MATH 10A,A01,083735,Patchell; Gregory David,2,0,30,28
1657386734542,MATH 10A,A02,083736,Patchell; Gregory David,20,0,30,10
1657386734542,MATH 10A,A03,083737,Patchell; Gregory David,16,0,30,14
1657386740889,MATH 10B,A01,083207,Lim; Seonhee,8,0,34,26
1657386740889,MATH 10B,A02,083208,Lim; Seonhee,9,0,35,26
1657386740889,MATH 10B,A03,093472,Lim; Seonhee,7,0,34,27
1657386740889,MATH 10B,B01,083739,Sinha; Shubham,12,0,30,18
1657386747685,MATH 18,A01,083743,Cinel; Cameron Alexander,7,0,30,23
1657386747685,MATH 18,A02,083744,Cinel; Cameron Alexander,17,0,30,13
1657386747685,MATH 18,A03,083745,Cinel; Cameron Alexander,9,0,30,21
1657386747685,MATH 18,B01,083748,Rideout; David Porter,5,0,37,32
1657386747685,MATH 18,B02,083749,Rideout; David Porter,5,0,36,31
1657386747685,MATH 18,B03,083750,Rideout; David Porter,3,0,37,34
1657386747685,MATH 18,B04,083751,Rideout; David Porter,6,0,36,30
1657386747685,MATH 18,B05,093473,Rideout; David Porter,6,0,36,30
1657386747685,MATH 18,B06,093474,Rideout; David Porter,6,0,36,30
1657386754711,MATH 20A,A01,083754,Zheng; Zequn,14,0,40,26
1657386761921,MATH 20B,A01,083756,Briones; Jor-el Thomas Caparas,4,0,36,32
1657386761921,MATH 20B,A02,083757,Briones; Jor-el Thomas Caparas,1,0,36,35
1657386761921,MATH 20B,A03,093475,Briones; Jor-el Thomas Caparas,2,0,36,34
1657386768618,MATH 20C,A01,083760,Briones; Jor-el Thomas Caparas,1,0,35,34
1657386768618,MATH 20C,A02,083761,Briones; Jor-el Thomas Caparas,8,0,35,27
1657386768618,MATH 20C,A03,093476,Briones; Jor-el Thomas Caparas,0,1,36,36
1657386768618,MATH 20C,B01,083762,Bach; Quang Tran,1,0,30,29
1657386775609,MATH 20D,A01,083765,Tran; Brian Kha,5,0,30,25
1657386775609,MATH 20D,A02,083766,Tran; Brian Kha,5,0,30,25
1657386775609,MATH 20D,A03,083767,Tran; Brian Kha,5,0,30,25
1657386782226,MATH 20E,A01,083771,Ganguly; Soumya,9,0,32,23
1657386782226,MATH 20E,A02,083772,Ganguly; Soumya,6,0,32,26
1657386782226,MATH 20E,B01,083773,Ciotti; Benjamin,20,0,35,15
1657386782226,MATH 20E,B02,083774,Ciotti; Benjamin,17,0,35,18
1657386788739,MATH 103A,A01,083777,Greenfeld; Be'Eri,3,0,36,33
1657386788739,MATH 103A,A02,083778,Greenfeld; Be'Eri,5,0,36,31
1657386788739,MATH 103A,A03,093561,Greenfeld; Be'Eri,5,0,36,31
1657386788739,MATH 103A,B01,083779,Greenfeld; Be'Eri,7,0,36,29
1657386788739,MATH 103A,B02,083780,Greenfeld; Be'Eri,4,0,36,32
1657386788739,MATH 103A,B03,093562,Greenfeld; Be'Eri,3,0,36,33
1657386794913,MATH 105,A01,085443,Carter; Anne Toulson,15,0,35,20
1657386794913,MATH 105,A02,093477,Carter; Anne Toulson,20,0,35,15
1657386801499,MATH 109,A01,083213,Ganzberger; Geoffrey Michael,2,0,34,32
1657386801499,MATH 109,A02,083214,Ganzberger; Geoffrey Michael,4,0,34,30
1657386801499,MATH 109,A03,093478,Ganzberger; Geoffrey Michael,2,0,34,32
1657386801499,MATH 109,B01,083215,Ganzberger; Geoffrey Michael,1,0,32,31
1657386801499,MATH 109,B02,083216,Ganzberger; Geoffrey Michael,2,0,32,30
1657386801499,MATH 109,B03,093479,Ganzberger; Geoffrey Michael,8,0,32,24
1657386808369,MATH 142A,A01,083219,Chow; Bennett,7,0,32,25
1657386808369,MATH 142A,A02,083220,Chow; Bennett,10,0,32,22
1657386808369,MATH 142A,A03,093480,Chow; Bennett,8,0,32,24
1657386808369,MATH 142A,B03,093481,Chow; Bennett,8,0,32,24
1657386808369,MATH 142A,B04,093558,Chow; Bennett,13,0,32,19
1657386808369,MATH 142A,B05,093559,Chow; Bennett,6,0,32,26
1657386815294,MATH 193A,A01,083224,Rotar; Vladimir,8,0,34,26
1657386815294,MATH 193A,A02,083225,Rotar; Vladimir,9,0,34,25
1657386815294,MATH 193A,A03,083781,Rotar; Vladimir,5,0,34,29
1657386815294,MATH 193A,A04,083782,Rotar; Vladimir,10,0,34,24
1657386815294,MATH 193A,A05,093482,Rotar; Vladimir,10,0,34,24
1657386822949,MATH 197,001,091859,McAuley; Julian John,9999,0,9999,0
1657386822949,MATH 197,002,095566,Kedlaya; Kiran S.,9997,0,9999,2
1657386822949,MATH 197,003,095567,Xiao; Ming,9999,0,9999,0
1657386822949,MATH 197,004,095571,Perols; Johan Lars,9998,0,9999,1
1657386831301,COGS 9,A01,083615,Shannon; Kyle Michael,9,0,75,66
1657386838541,COGS 11,A01,083617,Boyle; Mary E. T.,22,0,48,26
1657386845447,COGS 13,A01,083071,Bastos; Amalia Pinkusfeld,11,0,71,60
1657386852945,COGS 14A,A01,092681,Semenuks; Arturs,4,1,100,96
1657386859470,COGS 14B,A01,083073,Cheng; Tzu-Han,6,0,63,57
1657386866592,COGS 17,A01,092677,Semenuks; Arturs,6,0,81,75
1657386873532,COGS 100,A01,083619,Allen; Michael Gordon,17,0,70,53
1657386881508,COGS 101A,A01,083621,Davis; Joshua Daniel,9,0,68,59
1657386888309,COGS 101B,A01,091572,Allen; Michael Gordon,11,0,65,54
1657386894883,COGS 101C,A01,083625,Delgado; Tania,17,0,35,18
1657386901483,COGS 107A,A01,083627,Boyle; Mary E. T.,13,0,60,47
1657386908031,COGS 118A,A01,083075,Gupta; Anjum,20,0,76,56
1657386915375,CSE 3,A50,083646,Miranda; Gregory Joseph,24,0,50,26
1657386922761,CSE 8A,A50,083650,Miranda; Gregory Joseph,17,1,56,39
1657386929344,CSE 11,A01,083080,Cao; Yingjun,6,15,40,34
1657386935850,CSE 12,A01,083652,Krause-Levy; Sophia Louisa,28,1,120,92
1657386942550,CSE 15L,A01,083654,Morris; Justin Loren,9,0,50,41
1657386942550,CSE 15L,A02,083655,Morris; Justin Loren,9,0,50,41
1657386949871,CSE 20,A01,083657,Tran; Khoa Dang,39,0,80,41
1657386956417,CSE 21,A01,095574,Bach; Quang Tran,22,0,48,26
1657386962781,CSE 30,A01,083084,Eldon; John,4,0,80,76
1657386962781,CSE 30,B01,095061,Bhaskar; Nishant,9,0,50,41
1657386969704,CSE 100,A01,083659,Cao; Yingjun,5,4,70,65
1657386976210,CSE 134B,A01,083661,Powell; Thomas Allan,22,0,100,78
1657386982623,CSE 140,A01,083663,Gungor; Onat,14,0,85,71
1657386989041,CSE 140L,A01,083088,Eldon; John,21,0,100,79
1657386995350,CSE 175,A01,083665,Kumar; Rakesh,3,0,25,22
1657387001844,CSE 190,A00,092507,Dubnov; Shlomo,7,0,20,13
1657387008332,ECE 45,A01,083139,Congero; Spencer William,6,0,75,69
1657387015464,ECE 65,A50,083695,Saad; Andrew S,12,0,30,18
1657387015464,ECE 65,A51,095125,Saad; Andrew S,24,0,26,2
1657387021842,ECE 109,A01,091882,Touri; Behrouz,19,0,70,51
1657387028782,ECE 180,A00,083140,Abi Samra; Nicholas Camill,1,0,30,29
1657387028782,ECE 180,B00,083141,Abi Samra; Nicholas Camill,0,0,30,30
1657387035767,MATH 10A,A01,083735,Patchell; Gregory David,2,0,30,28
1657387035767,MATH 10A,A02,083736,Patchell; Gregory David,20,0,30,10
1657387035767,MATH 10A,A03,083737,Patchell; Gregory David,16,0,30,14
1657387043210,MATH 10B,A01,083207,Lim; Seonhee,8,0,34,26
1657387043210,MATH 10B,A02,083208,Lim; Seonhee,9,0,35,26
1657387043210,MATH 10B,A03,093472,Lim; Seonhee,7,0,34,27
1657387043210,MATH 10B,B01,083739,Sinha; Shubham,12,0,30,18
1657387050180,MATH 18,A01,083743,Cinel; Cameron Alexander,7,0,30,23
1657387050180,MATH 18,A02,083744,Cinel; Cameron Alexander,17,0,30,13
1657387050180,MATH 18,A03,083745,Cinel; Cameron Alexander,9,0,30,21
1657387050180,MATH 18,B01,083748,Rideout; David Porter,5,0,37,32
1657387050180,MATH 18,B02,083749,Rideout; David Porter,5,0,36,31
1657387050180,MATH 18,B03,083750,Rideout; David Porter,3,0,37,34
1657387050180,MATH 18,B04,083751,Rideout; David Porter,6,0,36,30
1657387050180,MATH 18,B05,093473,Rideout; David Porter,6,0,36,30
1657387050180,MATH 18,B06,093474,Rideout; David Porter,6,0,36,30
1657387056926,MATH 20A,A01,083754,Zheng; Zequn,14,0,40,26
1657387063441,MATH 20B,A01,083756,Briones; Jor-el Thomas Caparas,4,0,36,32
1657387063441,MATH 20B,A02,083757,Briones; Jor-el Thomas Caparas,1,0,36,35
1657387063441,MATH 20B,A03,093475,Briones; Jor-el Thomas Caparas,2,0,36,34
1657387070338,MATH 20C,A01,083760,Briones; Jor-el Thomas Caparas,1,0,35,34
1657387070338,MATH 20C,A02,083761,Briones; Jor-el Thomas Caparas,8,0,35,27
1657387070338,MATH 20C,A03,093476,Briones; Jor-el Thomas Caparas,0,1,36,36
1657387070338,MATH 20C,B01,083762,Bach; Quang Tran,1,0,30,29
1657387077232,MATH 20D,A01,083765,Tran; Brian Kha,5,0,30,25
1657387077232,MATH 20D,A02,083766,Tran; Brian Kha,5,0,30,25
1657387077232,MATH 20D,A03,083767,Tran; Brian Kha,5,0,30,25
1657387083465,MATH 20E,A01,083771,Ganguly; Soumya,9,0,32,23
1657387083465,MATH 20E,A02,083772,Ganguly; Soumya,6,0,32,26
1657387083465,MATH 20E,B01,083773,Ciotti; Benjamin,20,0,35,15
1657387083465,MATH 20E,B02,083774,Ciotti; Benjamin,17,0,35,18
1657387089880,MATH 103A,A01,083777,Greenfeld; Be'Eri,3,0,36,33
1657387089880,MATH 103A,A02,083778,Greenfeld; Be'Eri,5,0,36,31
1657387089880,MATH 103A,A03,093561,Greenfeld; Be'Eri,5,0,36,31
1657387089880,MATH 103A,B01,083779,Greenfeld; Be'Eri,7,0,36,29
1657387089880,MATH 103A,B02,083780,Greenfeld; Be'Eri,4,0,36,32
1657387089880,MATH 103A,B03,093562,Greenfeld; Be'Eri,3,0,36,33
1657387096397,MATH 105,A01,085443,Carter; Anne Toulson,15,0,35,20
1657387096397,MATH 105,A02,093477,Carter; Anne Toulson,20,0,35,15
1657387103076,MATH 109,A01,083213,Ganzberger; Geoffrey Michael,2,0,34,32
1657387103076,MATH 109,A02,083214,Ganzberger; Geoffrey Michael,4,0,34,30
1657387103076,MATH 109,A03,093478,Ganzberger; Geoffrey Michael,2,0,34,32
1657387103076,MATH 109,B01,083215,Ganzberger; Geoffrey Michael,1,0,32,31
1657387103076,MATH 109,B02,083216,Ganzberger; Geoffrey Michael,2,0,32,30
1657387103076,MATH 109,B03,093479,Ganzberger; Geoffrey Michael,8,0,32,24
1657387109700,MATH 142A,A01,083219,Chow; Bennett,7,0,32,25
1657387109700,MATH 142A,A02,083220,Chow; Bennett,10,0,32,22
1657387109700,MATH 142A,A03,093480,Chow; Bennett,8,0,32,24
1657387109700,MATH 142A,B03,093481,Chow; Bennett,8,0,32,24
1657387109700,MATH 142A,B04,093558,Chow; Bennett,13,0,32,19
1657387109700,MATH 142A,B05,093559,Chow; Bennett,6,0,32,26
1657387116386,MATH 193A,A01,083224,Rotar; Vladimir,8,0,34,26
1657387116386,MATH 193A,A02,083225,Rotar; Vladimir,9,0,34,25
1657387116386,MATH 193A,A03,083781,Rotar; Vladimir,5,0,34,29
1657387116386,MATH 193A,A04,083782,Rotar; Vladimir,10,0,34,24
1657387116386,MATH 193A,A05,093482,Rotar; Vladimir,10,0,34,24
1657387123439,MATH 197,001,091859,McAuley; Julian John,9999,0,9999,0
1657387123439,MATH 197,002,095566,Kedlaya; Kiran S.,9997,0,9999,2
1657387123439,MATH 197,003,095567,Xiao; Ming,9999,0,9999,0
1657387123439,MATH 197,004,095571,Perols; Johan Lars,9998,0,9999,1
1657387131816,COGS 9,A01,083615,Shannon; Kyle Michael,9,0,75,66
1657387138214,COGS 11,A01,083617,Boyle; Mary E. T.,22,0,48,26
1657387144508,COGS 13,A01,083071,Bastos; Amalia Pinkusfeld,11,0,71,60
1657387151139,COGS 14A,A01,092681,Semenuks; Arturs,4,1,100,96
1657387157601,COGS 14B,A01,083073,Cheng; Tzu-Han,6,0,63,57
1657387163983,COGS 17,A01,092677,Semenuks; Arturs,6,0,81,75
1657387170548,COGS 100,A01,083619,Allen; Michael Gordon,17,0,70,53
1657387176818,COGS 101A,A01,083621,Davis; Joshua Daniel,9,0,68,59
1657387183335,COGS 101B,A01,091572,Allen; Michael Gordon,11,0,65,54
1657387189776,COGS 101C,A01,083625,Delgado; Tania,17,0,35,18
1657387196475,COGS 107A,A01,083627,Boyle; Mary E. T.,13,0,60,47
1657387203390,COGS 118A,A01,083075,Gupta; Anjum,20,0,76,56
1657387210102,CSE 3,A50,083646,Miranda; Gregory Joseph,24,0,50,26
1657387217396,CSE 8A,A50,083650,Miranda; Gregory Joseph,17,1,56,39
1657387224167,CSE 11,A01,083080,Cao; Yingjun,6,15,40,34
1657387230510,CSE 12,A01,083652,Krause-Levy; Sophia Louisa,28,1,120,92
1657387237066,CSE 15L,A01,083654,Morris; Justin Loren,9,0,50,41
1657387237066,CSE 15L,A02,083655,Morris; Justin Loren,9,0,50,41
1657387243620,CSE 20,A01,083657,Tran; Khoa Dang,39,0,80,41
1657387249942,CSE 21,A01,095574,Bach; Quang Tran,22,0,48,26
1657387256385,CSE 30,A01,083084,Eldon; John,4,0,80,76
1657387256385,CSE 30,B01,095061,Bhaskar; Nishant,9,0,50,41
1657387262532,CSE 100,A01,083659,Cao; Yingjun,5,4,70,65
1657387269052,CSE 134B,A01,083661,Powell; Thomas Allan,22,0,100,78
1657387276212,CSE 140,A01,083663,Gungor; Onat,14,0,85,71
1657387282717,CSE 140L,A01,083088,Eldon; John,21,0,100,79
1657387289087,CSE 175,A01,083665,Kumar; Rakesh,3,0,25,22
1657387296516,CSE 190,A00,092507,Dubnov; Shlomo,7,0,20,13
1657387304865,ECE 45,A01,083139,Congero; Spencer William,6,0,75,69
1657387311852,ECE 65,A50,083695,Saad; Andrew S,12,0,30,18
1657387311852,ECE 65,A51,095125,Saad; Andrew S,24,0,26,2
1657387318745,ECE 109,A01,091882,Touri; Behrouz,19,0,70,51
1657387325192,ECE 180,A00,083140,Abi Samra; Nicholas Camill,1,0,30,29
1657387325192,ECE 180,B00,083141,Abi Samra; Nicholas Camill,0,0,30,30
1657387332785,MATH 10A,A01,083735,Patchell; Gregory David,2,0,30,28
1657387332785,MATH 10A,A02,083736,Patchell; Gregory David,20,0,30,10
1657387332785,MATH 10A,A03,083737,Patchell; Gregory David,16,0,30,14
1657387339964,MATH 10B,A01,083207,Lim; Seonhee,8,0,34,26
1657387339964,MATH 10B,A02,083208,Lim; Seonhee,9,0,35,26
1657387339964,MATH 10B,A03,093472,Lim; Seonhee,7,0,34,27
1657387339964,MATH 10B,B01,083739,Sinha; Shubham,12,0,30,18
1657387352301,MATH 18,A01,083743,Cinel; Cameron Alexander,7,0,30,23
1657387352301,MATH 18,A02,083744,Cinel; Cameron Alexander,17,0,30,13
1657387352301,MATH 18,A03,083745,Cinel; Cameron Alexander,9,0,30,21
1657387352301,MATH 18,B01,083748,Rideout; David Porter,5,0,37,32
1657387352301,MATH 18,B02,083749,Rideout; David Porter,5,0,36,31
1657387352301,MATH 18,B03,083750,Rideout; David Porter,3,0,37,34
1657387352301,MATH 18,B04,083751,Rideout; David Porter,6,0,36,30
1657387352301,MATH 18,B05,093473,Rideout; David Porter,6,0,36,30
1657387352301,MATH 18,B06,093474,Rideout; David Porter,6,0,36,30
1657387358724,MATH 20A,A01,083754,Zheng; Zequn,14,0,40,26
1657387366044,MATH 20B,A01,083756,Briones; Jor-el Thomas Caparas,4,0,36,32
1657387366044,MATH 20B,A02,083757,Briones; Jor-el Thomas Caparas,1,0,36,35
1657387366044,MATH 20B,A03,093475,Briones; Jor-el Thomas Caparas,2,0,36,34
1657387373366,MATH 20C,A01,083760,Briones; Jor-el Thomas Caparas,1,0,35,34
1657387373366,MATH 20C,A02,083761,Briones; Jor-el Thomas Caparas,8,0,35,27
1657387373366,MATH 20C,A03,093476,Briones; Jor-el Thomas Caparas,0,1,36,36
1657387373366,MATH 20C,B01,083762,Bach; Quang Tran,1,0,30,29
1657387379657,MATH 20D,A01,083765,Tran; Brian Kha,5,0,30,25
1657387379657,MATH 20D,A02,083766,Tran; Brian Kha,5,0,30,25
1657387379657,MATH 20D,A03,083767,Tran; Brian Kha,5,0,30,25
1657387386192,MATH 20E,A01,083771,Ganguly; Soumya,9,0,32,23
1657387386192,MATH 20E,A02,083772,Ganguly; Soumya,6,0,32,26
1657387386192,MATH 20E,B01,083773,Ciotti; Benjamin,20,0,35,15
1657387386192,MATH 20E,B02,083774,Ciotti; Benjamin,17,0,35,18
1657387392450,MATH 103A,A01,083777,Greenfeld; Be'Eri,3,0,36,33
1657387392450,MATH 103A,A02,083778,Greenfeld; Be'Eri,5,0,36,31
1657387392450,MATH 103A,A03,093561,Greenfeld; Be'Eri,5,0,36,31
1657387392450,MATH 103A,B01,083779,Greenfeld; Be'Eri,7,0,36,29
1657387392450,MATH 103A,B02,083780,Greenfeld; Be'Eri,4,0,36,32
1657387392450,MATH 103A,B03,093562,Greenfeld; Be'Eri,3,0,36,33
1657387399012,MATH 105,A01,085443,Carter; Anne Toulson,15,0,35,20
1657387399012,MATH 105,A02,093477,Carter; Anne Toulson,20,0,35,15
1657387405405,MATH 109,A01,083213,Ganzberger; Geoffrey Michael,2,0,34,32
1657387405405,MATH 109,A02,083214,Ganzberger; Geoffrey Michael,4,0,34,30
1657387405405,MATH 109,A03,093478,Ganzberger; Geoffrey Michael,2,0,34,32
1657387405405,MATH 109,B01,083215,Ganzberger; Geoffrey Michael,1,0,32,31
1657387405405,MATH 109,B02,083216,Ganzberger; Geoffrey Michael,2,0,32,30
1657387405405,MATH 109,B03,093479,Ganzberger; Geoffrey Michael,8,0,32,24
1657387411855,MATH 142A,A01,083219,Chow; Bennett,7,0,32,25
1657387411855,MATH 142A,A02,083220,Chow; Bennett,10,0,32,22
1657387411855,MATH 142A,A03,093480,Chow; Bennett,8,0,32,24
1657387411855,MATH 142A,B03,093481,Chow; Bennett,8,0,32,24
1657387411855,MATH 142A,B04,093558,Chow; Bennett,13,0,32,19
1657387411855,MATH 142A,B05,093559,Chow; Bennett,6,0,32,26
1657387418547,MATH 193A,A01,083224,Rotar; Vladimir,8,0,34,26
1657387418547,MATH 193A,A02,083225,Rotar; Vladimir,9,0,34,25
1657387418547,MATH 193A,A03,083781,Rotar; Vladimir,5,0,34,29
1657387418547,MATH 193A,A04,083782,Rotar; Vladimir,10,0,34,24
1657387418547,MATH 193A,A05,093482,Rotar; Vladimir,10,0,34,24
1657387425221,MATH 197,001,091859,McAuley; Julian John,9999,0,9999,0
1657387425221,MATH 197,002,095566,Kedlaya; Kiran S.,9997,0,9999,2
1657387425221,MATH 197,003,095567,Xiao; Ming,9999,0,9999,0
1657387425221,MATH 197,004,095571,Perols; Johan Lars,9998,0,9999,1
1657387433554,COGS 9,A01,083615,Shannon; Kyle Michael,9,0,75,66
1657387440182,COGS 11,A01,083617,Boyle; Mary E. T.,22,0,48,26
1657387446640,COGS 13,A01,083071,Bastos; Amalia Pinkusfeld,11,0,71,60
1657387453545,COGS 14A,A01,092681,Semenuks; Arturs,4,1,100,96
1657387459776,COGS 14B,A01,083073,Cheng; Tzu-Han,6,0,63,57
1657387466191,COGS 17,A01,092677,Semenuks; Arturs,6,0,81,75
1657387472453,COGS 100,A01,083619,Allen; Michael Gordon,17,0,70,53
1657387478938,COGS 101A,A01,083621,Davis; Joshua Daniel,9,0,68,59
1657387485398,COGS 101B,A01,091572,Allen; Michael Gordon,11,0,65,54
1657387492308,COGS 101C,A01,083625,Delgado; Tania,17,0,35,18
1657387498743,COGS 107A,A01,083627,Boyle; Mary E. T.,13,0,60,47
1657387505084,COGS 118A,A01,083075,Gupta; Anjum,20,0,76,56
1657387511407,CSE 3,A50,083646,Miranda; Gregory Joseph,24,0,50,26
1657387517513,CSE 8A,A50,083650,Miranda; Gregory Joseph,17,1,56,39
1657387523707,CSE 11,A01,083080,Cao; Yingjun,6,15,40,34
1657387530420,CSE 12,A01,083652,Krause-Levy; Sophia Louisa,28,1,120,92
1657387536691,CSE 15L,A01,083654,Morris; Justin Loren,9,0,50,41
1657387536691,CSE 15L,A02,083655,Morris; Justin Loren,9,0,50,41
1657387543232,CSE 20,A01,083657,Tran; Khoa Dang,39,0,80,41
1657387550565,CSE 21,A01,095574,Bach; Quang Tran,22,0,48,26
1657387556887,CSE 30,A01,083084,Eldon; John,4,0,80,76
1657387556887,CSE 30,B01,095061,Bhaskar; Nishant,9,0,50,41
1657387563264,CSE 100,A01,083659,Cao; Yingjun,5,4,70,65
1657387569830,CSE 134B,A01,083661,Powell; Thomas Allan,22,0,100,78
1657387576221,CSE 140,A01,083663,Gungor; Onat,14,0,85,71
1657387582786,CSE 140L,A01,083088,Eldon; John,21,0,100,79
1657387589434,CSE 175,A01,083665,Kumar; Rakesh,3,0,25,22
1657387595694,CSE 190,A00,092507,Dubnov; Shlomo,7,0,20,13
1657387602215,ECE 45,A01,083139,Congero; Spencer William,6,0,75,69
1657387608672,ECE 65,A50,083695,Saad; Andrew S,12,0,30,18
1657387608672,ECE 65,A51,095125,Saad; Andrew S,24,0,26,2
1657387614960,ECE 109,A01,091882,Touri; Behrouz,19,0,70,51
1657387621432,ECE 180,A00,083140,Abi Samra; Nicholas Camill,1,0,30,29
1657387621432,ECE 180,B00,083141,Abi Samra; Nicholas Camill,0,0,30,30
1657387627913,MATH 10A,A01,083735,Patchell; Gregory David,2,0,30,28
1657387627913,MATH 10A,A02,083736,Patchell; Gregory David,20,0,30,10
1657387627913,MATH 10A,A03,083737,Patchell; Gregory David,16,0,30,14
1657387634581,MATH 10B,A01,083207,Lim; Seonhee,8,0,34,26
1657387634581,MATH 10B,A02,083208,Lim; Seonhee,9,0,35,26
1657387634581,MATH 10B,A03,093472,Lim; Seonhee,7,0,34,27
1657387634581,MATH 10B,B01,083739,Sinha; Shubham,12,0,30,18
1657387641210,MATH 18,A01,083743,Cinel; Cameron Alexander,7,0,30,23
1657387641210,MATH 18,A02,083744,Cinel; Cameron Alexander,17,0,30,13
1657387641210,MATH 18,A03,083745,Cinel; Cameron Alexander,9,0,30,21
1657387641210,MATH 18,B01,083748,Rideout; David Porter,5,0,37,32
1657387641210,MATH 18,B02,083749,Rideout; David Porter,5,0,36,31
1657387641210,MATH 18,B03,083750,Rideout; David Porter,3,0,37,34
1657387641210,MATH 18,B04,083751,Rideout; David Porter,6,0,36,30
1657387641210,MATH 18,B05,093473,Rideout; David Porter,6,0,36,30
1657387641210,MATH 18,B06,093474,Rideout; David Porter,6,0,36,30
1657387647357,MATH 20A,A01,083754,Zheng; Zequn,14,0,40,26
1657387653587,MATH 20B,A01,083756,Briones; Jor-el Thomas Caparas,4,0,36,32
1657387653587,MATH 20B,A02,083757,Briones; Jor-el Thomas Caparas,1,0,36,35
1657387653587,MATH 20B,A03,093475,Briones; Jor-el Thomas Caparas,2,0,36,34
1657387659932,MATH 20C,A01,083760,Briones; Jor-el Thomas Caparas,1,0,35,34
1657387659932,MATH 20C,A02,083761,Briones; Jor-el Thomas Caparas,8,0,35,27
1657387659932,MATH 20C,A03,093476,Briones; Jor-el Thomas Caparas,0,1,36,36
1657387659932,MATH 20C,B01,083762,Bach; Quang Tran,1,0,30,29
1657387666407,MATH 20D,A01,083765,Tran; Brian Kha,5,0,30,25
1657387666407,MATH 20D,A02,083766,Tran; Brian Kha,5,0,30,25
1657387666407,MATH 20D,A03,083767,Tran; Brian Kha,5,0,30,25
1657387672689,MATH 20E,A01,083771,Ganguly; Soumya,9,0,32,23
1657387672689,MATH 20E,A02,083772,Ganguly; Soumya,6,0,32,26
1657387672689,MATH 20E,B01,083773,Ciotti; Benjamin,20,0,35,15
1657387672689,MATH 20E,B02,083774,Ciotti; Benjamin,17,0,35,18
1657387679219,MATH 103A,A01,083777,Greenfeld; Be'Eri,3,0,36,33
1657387679219,MATH 103A,A02,083778,Greenfeld; Be'Eri,5,0,36,31
1657387679219,MATH 103A,A03,093561,Greenfeld; Be'Eri,5,0,36,31
1657387679219,MATH 103A,B01,083779,Greenfeld; Be'Eri,7,0,36,29
1657387679219,MATH 103A,B02,083780,Greenfeld; Be'Eri,4,0,36,32
1657387679219,MATH 103A,B03,093562,Greenfeld; Be'Eri,3,0,36,33
1657387685607,MATH 105,A01,085443,Carter; Anne Toulson,15,0,35,20
1657387685607,MATH 105,A02,093477,Carter; Anne Toulson,20,0,35,15
1657387692138,MATH 109,A01,083213,Ganzberger; Geoffrey Michael,2,0,34,32
1657387692138,MATH 109,A02,083214,Ganzberger; Geoffrey Michael,4,0,34,30
1657387692138,MATH 109,A03,093478,Ganzberger; Geoffrey Michael,2,0,34,32
1657387692138,MATH 109,B01,083215,Ganzberger; Geoffrey Michael,1,0,32,31
1657387692138,MATH 109,B02,083216,Ganzberger; Geoffrey Michael,2,0,32,30
1657387692138,MATH 109,B03,093479,Ganzberger; Geoffrey Michael,8,0,32,24
1657387698344,MATH 142A,A01,083219,Chow; Bennett,7,0,32,25
1657387698344,MATH 142A,A02,083220,Chow; Bennett,10,0,32,22
1657387698344,MATH 142A,A03,093480,Chow; Bennett,8,0,32,24
1657387698344,MATH 142A,B03,093481,Chow; Bennett,8,0,32,24
1657387698344,MATH 142A,B04,093558,Chow; Bennett,13,0,32,19
1657387698344,MATH 142A,B05,093559,Chow; Bennett,6,0,32,26
1657387704765,MATH 193A,A01,083224,Rotar; Vladimir,8,0,34,26
1657387704765,MATH 193A,A02,083225,Rotar; Vladimir,9,0,34,25
1657387704765,MATH 193A,A03,083781,Rotar; Vladimir,5,0,34,29
1657387704765,MATH 193A,A04,083782,Rotar; Vladimir,10,0,34,24
1657387704765,MATH 193A,A05,093482,Rotar; Vladimir,10,0,34,24
1657387711234,MATH 197,001,091859,McAuley; Julian John,9999,0,9999,0
1657387711234,MATH 197,002,095566,Kedlaya; Kiran S.,9997,0,9999,2
1657387711234,MATH 197,003,095567,Xiao; Ming,9999,0,9999,0
1657387711234,MATH 197,004,095571,Perols; Johan Lars,9998,0,9999,1
1657387719756,COGS 9,A01,083615,Shannon; Kyle Michael,9,0,75,66
1657387726294,COGS 11,A01,083617,Boyle; Mary E. T.,22,0,48,26
1657387732757,COGS 13,A01,083071,Bastos; Amalia Pinkusfeld,11,0,71,60
1657387739110,COGS 14A,A01,092681,Semenuks; Arturs,4,1,100,96
1657387745651,COGS 14B,A01,083073,Cheng; Tzu-Han,6,0,63,57
1657387752485,COGS 17,A01,092677,Semenuks; Arturs,6,0,81,75
1657387759258,COGS 100,A01,083619,Allen; Michael Gordon,17,0,70,53
1657387765710,COGS 101A,A01,083621,Davis; Joshua Daniel,9,0,68,59
1657387772217,COGS 101B,A01,091572,Allen; Michael Gordon,11,0,65,54
1657387778674,COGS 101C,A01,083625,Delgado; Tania,17,0,35,18
1657387785050,COGS 107A,A01,083627,Boyle; Mary E. T.,13,0,60,47
1657387791610,COGS 118A,A01,083075,Gupta; Anjum,20,0,76,56
1657387798265,CSE 3,A50,083646,Miranda; Gregory Joseph,24,0,50,26
1657387804789,CSE 8A,A50,083650,Miranda; Gregory Joseph,17,1,56,39
1657387811047,CSE 11,A01,083080,Cao; Yingjun,6,15,40,34
1657387817452,CSE 12,A01,083652,Krause-Levy; Sophia Louisa,28,1,120,92
1657387824886,CSE 15L,A01,083654,Morris; Justin Loren,9,0,50,41
1657387824886,CSE 15L,A02,083655,Morris; Justin Loren,9,0,50,41
1657387831768,CSE 20,A01,083657,Tran; Khoa Dang,39,0,80,41
1657387837972,CSE 21,A01,095574,Bach; Quang Tran,22,0,48,26
1657387844787,CSE 30,A01,083084,Eldon; John,4,0,80,76
1657387844787,CSE 30,B01,095061,Bhaskar; Nishant,9,0,50,41
1657387851632,CSE 100,A01,083659,Cao; Yingjun,5,4,70,65
1657387858050,CSE 134B,A01,083661,Powell; Thomas Allan,22,0,100,78
1657387864382,CSE 140,A01,083663,Gungor; Onat,14,0,85,71
1657387870627,CSE 140L,A01,083088,Eldon; John,21,0,100,79
1657387876969,CSE 175,A01,083665,Kumar; Rakesh,3,0,25,22
1657387883384,CSE 190,A00,092507,Dubnov; Shlomo,7,0,20,13
1657387889881,ECE 45,A01,083139,Congero; Spencer William,6,0,75,69
1657387896454,ECE 65,A50,083695,Saad; Andrew S,12,0,30,18
1657387896454,ECE 65,A51,095125,Saad; Andrew S,24,0,26,2
1657387902930,ECE 109,A01,091882,Touri; Behrouz,19,0,70,51
1657387909248,ECE 180,A00,083140,Abi Samra; Nicholas Camill,1,0,30,29
1657387909248,ECE 180,B00,083141,Abi Samra; Nicholas Camill,0,0,30,30
1657387915725,MATH 10A,A01,083735,Patchell; Gregory David,2,0,30,28
1657387915725,MATH 10A,A02,083736,Patchell; Gregory David,20,0,30,10
1657387915725,MATH 10A,A03,083737,Patchell; Gregory David,16,0,30,14
1657387922145,MATH 10B,A01,083207,Lim; Seonhee,8,0,34,26
1657387922145,MATH 10B,A02,083208,Lim; Seonhee,9,0,35,26
1657387922145,MATH 10B,A03,093472,Lim; Seonhee,7,0,34,27
1657387922145,MATH 10B,B01,083739,Sinha; Shubham,12,0,30,18
1657387929870,MATH 18,A01,083743,Cinel; Cameron Alexander,7,0,30,23
1657387929870,MATH 18,A02,083744,Cinel; Cameron Alexander,17,0,30,13
1657387929870,MATH 18,A03,083745,Cinel; Cameron Alexander,9,0,30,21
1657387929870,MATH 18,B01,083748,Rideout; David Porter,5,0,37,32
1657387929870,MATH 18,B02,083749,Rideout; David Porter,5,0,36,31
1657387929870,MATH 18,B03,083750,Rideout; David Porter,3,0,37,34
1657387929870,MATH 18,B04,083751,Rideout; David Porter,6,0,36,30
1657387929870,MATH 18,B05,093473,Rideout; David Porter,6,0,36,30
1657387929870,MATH 18,B06,093474,Rideout; David Porter,6,0,36,30
1657387937200,MATH 20A,A01,083754,Zheng; Zequn,14,0,40,26
1657387944324,MATH 20B,A01,083756,Briones; Jor-el Thomas Caparas,4,0,36,32
1657387944324,MATH 20B,A02,083757,Briones; Jor-el Thomas Caparas,1,0,36,35
1657387944324,MATH 20B,A03,093475,Briones; Jor-el Thomas Caparas,2,0,36,34
1657387950426,MATH 20C,A01,083760,Briones; Jor-el Thomas Caparas,1,0,35,34
1657387950426,MATH 20C,A02,083761,Briones; Jor-el Thomas Caparas,8,0,35,27
1657387950426,MATH 20C,A03,093476,Briones; Jor-el Thomas Caparas,0,1,36,36
1657387950426,MATH 20C,B01,083762,Bach; Quang Tran,1,0,30,29
1657387956597,MATH 20D,A01,083765,Tran; Brian Kha,5,0,30,25
1657387956597,MATH 20D,A02,083766,Tran; Brian Kha,5,0,30,25
1657387956597,MATH 20D,A03,083767,Tran; Brian Kha,5,0,30,25
1657387963039,MATH 20E,A01,083771,Ganguly; Soumya,9,0,32,23
1657387963039,MATH 20E,A02,083772,Ganguly; Soumya,6,0,32,26
1657387963039,MATH 20E,B01,083773,Ciotti; Benjamin,20,0,35,15
1657387963039,MATH 20E,B02,083774,Ciotti; Benjamin,17,0,35,18
1657387969692,MATH 103A,A01,083777,Greenfeld; Be'Eri,3,0,36,33
1657387969692,MATH 103A,A02,083778,Greenfeld; Be'Eri,5,0,36,31
1657387969692,MATH 103A,A03,093561,Greenfeld; Be'Eri,5,0,36,31
1657387969692,MATH 103A,B01,083779,Greenfeld; Be'Eri,7,0,36,29
1657387969692,MATH 103A,B02,083780,Greenfeld; Be'Eri,4,0,36,32
1657387969692,MATH 103A,B03,093562,Greenfeld; Be'Eri,3,0,36,33
1657387977142,MATH 105,A01,085443,Carter; Anne Toulson,15,0,35,20
1657387977142,MATH 105,A02,093477,Carter; Anne Toulson,20,0,35,15
1657387984067,MATH 109,A01,083213,Ganzberger; Geoffrey Michael,2,0,34,32
1657387984067,MATH 109,A02,083214,Ganzberger; Geoffrey Michael,4,0,34,30
1657387984067,MATH 109,A03,093478,Ganzberger; Geoffrey Michael,2,0,34,32
1657387984067,MATH 109,B01,083215,Ganzberger; Geoffrey Michael,1,0,32,31
1657387984067,MATH 109,B02,083216,Ganzberger; Geoffrey Michael,2,0,32,30
1657387984067,MATH 109,B03,093479,Ganzberger; Geoffrey Michael,8,0,32,24
1657387991219,MATH 142A,A01,083219,Chow; Bennett,7,0,32,25
1657387991219,MATH 142A,A02,083220,Chow; Bennett,10,0,32,22
1657387991219,MATH 142A,A03,093480,Chow; Bennett,8,0,32,24
1657387991219,MATH 142A,B03,093481,Chow; Bennett,8,0,32,24
1657387991219,MATH 142A,B04,093558,Chow; Bennett,13,0,32,19
1657387991219,MATH 142A,B05,093559,Chow; Bennett,6,0,32,26
1657387997469,MATH 193A,A01,083224,Rotar; Vladimir,8,0,34,26
1657387997469,MATH 193A,A02,083225,Rotar; Vladimir,9,0,34,25
1657387997469,MATH 193A,A03,083781,Rotar; Vladimir,5,0,34,29
1657387997469,MATH 193A,A04,083782,Rotar; Vladimir,10,0,34,24
1657387997469,MATH 193A,A05,093482,Rotar; Vladimir,10,0,34,24
1657388011256,MATH 197,001,091859,McAuley; Julian John,9999,0,9999,0
1657388011256,MATH 197,002,095566,Kedlaya; Kiran S.,9997,0,9999,2
1657388011256,MATH 197,003,095567,Xiao; Ming,9999,0,9999,0
1657388011256,MATH 197,004,095571,Perols; Johan Lars,9998,0,9999,1
1657388020689,COGS 9,A01,083615,Shannon; Kyle Michael,9,0,75,66
1657388027327,COGS 11,A01,083617,Boyle; Mary E. T.,22,0,48,26
1657388033942,COGS 13,A01,083071,Bastos; Amalia Pinkusfeld,11,0,71,60
1657388040342,COGS 14A,A01,092681,Semenuks; Arturs,4,1,100,96
1657388046376,COGS 14B,A01,083073,Cheng; Tzu-Han,6,0,63,57
1657388052399,COGS 17,A01,092677,Semenuks; Arturs,6,0,81,75
1657388058425,COGS 100,A01,083619,Allen; Michael Gordon,17,0,70,53
1657388064454,COGS 101A,A01,083621,Davis; Joshua Daniel,9,0,68,59
1657388070480,COGS 101B,A01,091572,Allen; Michael Gordon,11,0,65,54
1657388076505,COGS 101C,A01,083625,Delgado; Tania,17,0,35,18
1657388082527,COGS 107A,A01,083627,Boyle; Mary E. T.,13,0,60,47
1657388088551,COGS 118A,A01,083075,Gupta; Anjum,20,0,76,56
1657388094581,CSE 3,A50,083646,Miranda; Gregory Joseph,24,0,50,26
1657388100611,CSE 8A,A50,083650,Miranda; Gregory Joseph,17,1,56,39
1657388106636,CSE 11,A01,083080,Cao; Yingjun,6,15,40,34
1657388112663,CSE 12,A01,083652,Krause-Levy; Sophia Louisa,28,1,120,92
1657388118692,CSE 15L,A01,083654,Morris; Justin Loren,9,0,50,41
1657388118692,CSE 15L,A02,083655,Morris; Justin Loren,9,0,50,41
1657388124728,CSE 20,A01,083657,Tran; Khoa Dang,39,0,80,41
1657388130757,CSE 21,A01,095574,Bach; Quang Tran,22,0,48,26
1657388136781,CSE 30,A01,083084,Eldon; John,4,0,80,76
1657388136781,CSE 30,B01,095061,Bhaskar; Nishant,9,0,50,41
1657388142809,CSE 100,A01,083659,Cao; Yingjun,5,4,70,65
1657388148833,CSE 134B,A01,083661,Powell; Thomas Allan,22,0,100,78
1657388154859,CSE 140,A01,083663,Gungor; Onat,14,0,85,71
1657388160887,CSE 140L,A01,083088,Eldon; John,21,0,100,79
1657388166911,CSE 175,A01,083665,Kumar; Rakesh,3,0,25,22
1657388172940,CSE 190,A00,092507,Dubnov; Shlomo,7,0,20,13
1657388178969,ECE 45,A01,083139,Congero; Spencer William,6,0,75,69
1657388185001,ECE 65,A50,083695,Saad; Andrew S,12,0,30,18
1657388185001,ECE 65,A51,095125,Saad; Andrew S,24,0,26,2
1657388191024,ECE 109,A01,091882,Touri; Behrouz,19,0,70,51
1657388197053,ECE 180,A00,083140,Abi Samra; Nicholas Camill,1,0,30,29
1657388197053,ECE 180,B00,083141,Abi Samra; Nicholas Camill,0,0,30,30
1657388203080,MATH 10A,A01,083735,Patchell; Gregory David,2,0,30,28
1657388203080,MATH 10A,A02,083736,Patchell; Gregory David,20,0,30,10
1657388203080,MATH 10A,A03,083737,Patchell; Gregory David,16,0,30,14
1657388209112,MATH 10B,A01,083207,Lim; Seonhee,8,0,34,26
1657388209112,MATH 10B,A02,083208,Lim; Seonhee,9,0,35,26
1657388209112,MATH 10B,A03,093472,Lim; Seonhee,7,0,34,27
1657388209112,MATH 10B,B01,083739,Sinha; Shubham,12,0,30,18
1657388215148,MATH 18,A01,083743,Cinel; Cameron Alexander,7,0,30,23
1657388215148,MATH 18,A02,083744,Cinel; Cameron Alexander,17,0,30,13
1657388215148,MATH 18,A03,083745,Cinel; Cameron Alexander,9,0,30,21
1657388215148,MATH 18,B01,083748,Rideout; David Porter,5,0,37,32
1657388215148,MATH 18,B02,083749,Rideout; David Porter,5,0,36,31
1657388215148,MATH 18,B03,083750,Rideout; David Porter,3,0,37,34
1657388215148,MATH 18,B04,083751,Rideout; David Porter,6,0,36,30
1657388215148,MATH 18,B05,093473,Rideout; David Porter,6,0,36,30
1657388215148,MATH 18,B06,093474,Rideout; David Porter,6,0,36,30
1657388221176,MATH 20A,A01,083754,Zheng; Zequn,14,0,40,26
1657388227205,MATH 20B,A01,083756,Briones; Jor-el Thomas Caparas,4,0,36,32
1657388227205,MATH 20B,A02,083757,Briones; Jor-el Thomas Caparas,1,0,36,35
1657388227205,MATH 20B,A03,093475,Briones; Jor-el Thomas Caparas,2,0,36,34
1657388233235,MATH 20C,A01,083760,Briones; Jor-el Thomas Caparas,1,0,35,34
1657388233235,MATH 20C,A02,083761,Briones; Jor-el Thomas Caparas,8,0,35,27
1657388233235,MATH 20C,A03,093476,Briones; Jor-el Thomas Caparas,0,1,36,36
1657388233235,MATH 20C,B01,083762,Bach; Quang Tran,1,0,30,29
1657388239267,MATH 20D,A01,083765,Tran; Brian Kha,5,0,30,25
1657388239267,MATH 20D,A02,083766,Tran; Brian Kha,5,0,30,25
1657388239267,MATH 20D,A03,083767,Tran; Brian Kha,5,0,30,25
1657388245292,MATH 20E,A01,083771,Ganguly; Soumya,9,0,32,23
1657388245292,MATH 20E,A02,083772,Ganguly; Soumya,6,0,32,26
1657388245292,MATH 20E,B01,083773,Ciotti; Benjamin,20,0,35,15
1657388245292,MATH 20E,B02,083774,Ciotti; Benjamin,17,0,35,18
1657388251316,MATH 103A,A01,083777,Greenfeld; Be'Eri,3,0,36,33
1657388251316,MATH 103A,A02,083778,Greenfeld; Be'Eri,5,0,36,31
1657388251316,MATH 103A,A03,093561,Greenfeld; Be'Eri,5,0,36,31
1657388251316,MATH 103A,B01,083779,Greenfeld; Be'Eri,7,0,36,29
1657388251316,MATH 103A,B02,083780,Greenfeld; Be'Eri,4,0,36,32
1657388251316,MATH 103A,B03,093562,Greenfeld; Be'Eri,3,0,36,33
1657388257346,MATH 105,A01,085443,Carter; Anne Toulson,15,0,35,20
1657388257346,MATH 105,A02,093477,Carter; Anne Toulson,20,0,35,15
1657388263371,MATH 109,A01,083213,Ganzberger; Geoffrey Michael,2,0,34,32
1657388263371,MATH 109,A02,083214,Ganzberger; Geoffrey Michael,4,0,34,30
1657388263371,MATH 109,A03,093478,Ganzberger; Geoffrey Michael,2,0,34,32
1657388263371,MATH 109,B01,083215,Ganzberger; Geoffrey Michael,1,0,32,31
1657388263371,MATH 109,B02,083216,Ganzberger; Geoffrey Michael,2,0,32,30
1657388263371,MATH 109,B03,093479,Ganzberger; Geoffrey Michael,8,0,32,24
1657388269397,MATH 142A,A01,083219,Chow; Bennett,7,0,32,25
1657388269397,MATH 142A,A02,083220,Chow; Bennett,10,0,32,22
1657388269397,MATH 142A,A03,093480,Chow; Bennett,8,0,32,24
1657388269397,MATH 142A,B03,093481,Chow; Bennett,8,0,32,24
1657388269397,MATH 142A,B04,093558,Chow; Bennett,13,0,32,19
1657388269397,MATH 142A,B05,093559,Chow; Bennett,6,0,32,26
1657388275422,MATH 193A,A01,083224,Rotar; Vladimir,8,0,34,26
1657388275422,MATH 193A,A02,083225,Rotar; Vladimir,9,0,34,25
1657388275422,MATH 193A,A03,083781,Rotar; Vladimir,5,0,34,29
1657388275422,MATH 193A,A04,083782,Rotar; Vladimir,10,0,34,24
1657388275422,MATH 193A,A05,093482,Rotar; Vladimir,10,0,34,24
1657388281450,MATH 197,001,091859,McAuley; Julian John,9999,0,9999,0
1657388281450,MATH 197,002,095566,Kedlaya; Kiran S.,9997,0,9999,2
1657388281450,MATH 197,003,095567,Xiao; Ming,9999,0,9999,0
1657388281450,MATH 197,004,095571,Perols; Johan Lars,9998,0,9999,1
1657388288520,COGS 9,A01,083615,Shannon; Kyle Michael,9,0,75,66
1657388294542,COGS 11,A01,083617,Boyle; Mary E. T.,22,0,48,26
1657388300575,COGS 13,A01,083071,Bastos; Amalia Pinkusfeld,11,0,71,60
1657388306602,COGS 14A,A01,092681,Semenuks; Arturs,4,1,100,96
1657388312627,COGS 14B,A01,083073,Cheng; Tzu-Han,6,0,63,57
1657388318654,COGS 17,A01,092677,Semenuks; Arturs,6,0,81,75
1657388324679,COGS 100,A01,083619,Allen; Michael Gordon,17,0,70,53
1657388330712,COGS 101A,A01,083621,Davis; Joshua Daniel,9,0,68,59
1657388336734,COGS 101B,A01,091572,Allen; Michael Gordon,11,0,65,54
1657388342765,COGS 101C,A01,083625,Delgado; Tania,17,0,35,18
1657388348790,COGS 107A,A01,083627,Boyle; Mary E. T.,13,0,60,47
1657388354819,COGS 118A,A01,083075,Gupta; Anjum,20,0,76,56
1657388360844,CSE 3,A50,083646,Miranda; Gregory Joseph,24,0,50,26
1657388366868,CSE 8A,A50,083650,Miranda; Gregory Joseph,17,1,56,39
1657388372891,CSE 11,A01,083080,Cao; Yingjun,6,15,40,34
1657388378932,CSE 12,A01,083652,Krause-Levy; Sophia Louisa,28,1,120,92
1657388384954,CSE 15L,A01,083654,Morris; Justin Loren,9,0,50,41
1657388384954,CSE 15L,A02,083655,Morris; Justin Loren,9,0,50,41
1657388390983,CSE 20,A01,083657,Tran; Khoa Dang,39,0,80,41
1657388397006,CSE 21,A01,095574,Bach; Quang Tran,22,0,48,26
1657388403036,CSE 30,A01,083084,Eldon; John,4,0,80,76
1657388403036,CSE 30,B01,095061,Bhaskar; Nishant,9,0,50,41
1657388409062,CSE 100,A01,083659,Cao; Yingjun,5,4,70,65
1657388415086,CSE 134B,A01,083661,Powell; Thomas Allan,22,0,100,78
1657388421110,CSE 140,A01,083663,Gungor; Onat,14,0,85,71
1657388427138,CSE 140L,A01,083088,Eldon; John,21,0,100,79
1657388433163,CSE 175,A01,083665,Kumar; Rakesh,3,0,25,22
1657388439193,CSE 190,A00,092507,Dubnov; Shlomo,7,0,20,13
1657388445221,ECE 45,A01,083139,Congero; Spencer William,6,0,75,69
1657388451246,ECE 65,A50,083695,Saad; Andrew S,12,0,30,18
1657388451246,ECE 65,A51,095125,Saad; Andrew S,24,0,26,2
1657388457271,ECE 109,A01,091882,Touri; Behrouz,19,0,70,51
1657388463297,ECE 180,A00,083140,Abi Samra; Nicholas Camill,1,0,30,29
1657388463297,ECE 180,B00,083141,Abi Samra; Nicholas Camill,0,0,30,30
1657388469327,MATH 10A,A01,083735,Patchell; Gregory David,2,0,30,28
1657388469327,MATH 10A,A02,083736,Patchell; Gregory David,20,0,30,10
1657388469327,MATH 10A,A03,083737,Patchell; Gregory David,16,0,30,14
1657388475352,MATH 10B,A01,083207,Lim; Seonhee,8,0,34,26
1657388475352,MATH 10B,A02,083208,Lim; Seonhee,9,0,35,26
1657388475352,MATH 10B,A03,093472,Lim; Seonhee,7,0,34,27
1657388475352,MATH 10B,B01,083739,Sinha; Shubham,12,0,30,18
1657388481385,MATH 18,A01,083743,Cinel; Cameron Alexander,7,0,30,23
1657388481385,MATH 18,A02,083744,Cinel; Cameron Alexander,17,0,30,13
1657388481385,MATH 18,A03,083745,Cinel; Cameron Alexander,9,0,30,21
1657388481385,MATH 18,B01,083748,Rideout; David Porter,5,0,37,32
1657388481385,MATH 18,B02,083749,Rideout; David Porter,5,0,36,31
1657388481385,MATH 18,B03,083750,Rideout; David Porter,3,0,37,34
1657388481385,MATH 18,B04,083751,Rideout; David Porter,6,0,36,30
1657388481385,MATH 18,B05,093473,Rideout; David Porter,6,0,36,30
1657388481385,MATH 18,B06,093474,Rideout; David Porter,6,0,36,30
1657388487414,MATH 20A,A01,083754,Zheng; Zequn,14,0,40,26
1657388493441,MATH 20B,A01,083756,Briones; Jor-el Thomas Caparas,4,0,36,32
1657388493441,MATH 20B,A02,083757,Briones; Jor-el Thomas Caparas,1,0,36,35
1657388493441,MATH 20B,A03,093475,Briones; Jor-el Thomas Caparas,2,0,36,34
1657388499465,MATH 20C,A01,083760,Briones; Jor-el Thomas Caparas,1,0,35,34
1657388499465,MATH 20C,A02,083761,Briones; Jor-el Thomas Caparas,8,0,35,27
1657388499465,MATH 20C,A03,093476,Briones; Jor-el Thomas Caparas,0,1,36,36
1657388499465,MATH 20C,B01,083762,Bach; Quang Tran,1,0,30,29
1657388505495,MATH 20D,A01,083765,Tran; Brian Kha,5,0,30,25
1657388505495,MATH 20D,A02,083766,Tran; Brian Kha,5,0,30,25
1657388505495,MATH 20D,A03,083767,Tran; Brian Kha,5,0,30,25
1657388511530,MATH 20E,A01,083771,Ganguly; Soumya,9,0,32,23
1657388511530,MATH 20E,A02,083772,Ganguly; Soumya,6,0,32,26
1657388511530,MATH 20E,B01,083773,Ciotti; Benjamin,20,0,35,15
1657388511530,MATH 20E,B02,083774,Ciotti; Benjamin,17,0,35,18
1657388517557,MATH 103A,A01,083777,Greenfeld; Be'Eri,3,0,36,33
1657388517557,MATH 103A,A02,083778,Greenfeld; Be'Eri,5,0,36,31
1657388517557,MATH 103A,A03,093561,Greenfeld; Be'Eri,5,0,36,31
1657388517557,MATH 103A,B01,083779,Greenfeld; Be'Eri,7,0,36,29
1657388517557,MATH 103A,B02,083780,Greenfeld; Be'Eri,4,0,36,32
1657388517557,MATH 103A,B03,093562,Greenfeld; Be'Eri,3,0,36,33
1657388523580,MATH 105,A01,085443,Carter; Anne Toulson,15,0,35,20
1657388523580,MATH 105,A02,093477,Carter; Anne Toulson,20,0,35,15
1657388529612,MATH 109,A01,083213,Ganzberger; Geoffrey Michael,2,0,34,32
1657388529612,MATH 109,A02,083214,Ganzberger; Geoffrey Michael,4,0,34,30
1657388529612,MATH 109,A03,093478,Ganzberger; Geoffrey Michael,2,0,34,32
1657388529612,MATH 109,B01,083215,Ganzberger; Geoffrey Michael,1,0,32,31
1657388529612,MATH 109,B02,083216,Ganzberger; Geoffrey Michael,2,0,32,30
1657388529612,MATH 109,B03,093479,Ganzberger; Geoffrey Michael,8,0,32,24
1657388535643,MATH 142A,A01,083219,Chow; Bennett,7,0,32,25
1657388535643,MATH 142A,A02,083220,Chow; Bennett,10,0,32,22
1657388535643,MATH 142A,A03,093480,Chow; Bennett,8,0,32,24
1657388535643,MATH 142A,B03,093481,Chow; Bennett,8,0,32,24
1657388535643,MATH 142A,B04,093558,Chow; Bennett,13,0,32,19
1657388535643,MATH 142A,B05,093559,Chow; Bennett,6,0,32,26
1657388541667,MATH 193A,A01,083224,Rotar; Vladimir,8,0,34,26
1657388541667,MATH 193A,A02,083225,Rotar; Vladimir,9,0,34,25
1657388541667,MATH 193A,A03,083781,Rotar; Vladimir,5,0,34,29
1657388541667,MATH 193A,A04,083782,Rotar; Vladimir,10,0,34,24
1657388541667,MATH 193A,A05,093482,Rotar; Vladimir,10,0,34,24
1657388547694,MATH 197,001,091859,McAuley; Julian John,9999,0,9999,0
1657388547694,MATH 197,002,095566,Kedlaya; Kiran S.,9997,0,9999,2
1657388547694,MATH 197,003,095567,Xiao; Ming,9999,0,9999,0
1657388547694,MATH 197,004,095571,Perols; Johan Lars,9998,0,9999,1
1657388554751,COGS 9,A01,083615,Shannon; Kyle Michael,9,0,75,66
1657388560778,COGS 11,A01,083617,Boyle; Mary E. T.,22,0,48,26
1657388566805,COGS 13,A01,083071,Bastos; Amalia Pinkusfeld,11,0,71,60
1657388572834,COGS 14A,A01,092681,Semenuks; Arturs,4,1,100,96
1657388578858,COGS 14B,A01,083073,Cheng; Tzu-Han,6,0,63,57
1657388584884,COGS 17,A01,092677,Semenuks; Arturs,6,0,81,75
1657388590911,COGS 100,A01,083619,Allen; Michael Gordon,17,0,70,53
1657388596944,COGS 101A,A01,083621,Davis; Joshua Daniel,9,0,68,59
1657388602969,COGS 101B,A01,091572,Allen; Michael Gordon,11,0,65,54
1657388609063,COGS 101C,A01,083625,Delgado; Tania,17,0,35,18
1657388615091,COGS 107A,A01,083627,Boyle; Mary E. T.,13,0,60,47
1657388621114,COGS 118A,A01,083075,Gupta; Anjum,20,0,76,56
1657388627139,CSE 3,A50,083646,Miranda; Gregory Joseph,24,0,50,26
1657388633176,CSE 8A,A50,083650,Miranda; Gregory Joseph,17,1,56,39
1657388639199,CSE 11,A01,083080,Cao; Yingjun,6,15,40,34
1657388645223,CSE 12,A01,083652,Krause-Levy; Sophia Louisa,28,1,120,92
1657388651249,CSE 15L,A01,083654,Morris; Justin Loren,9,0,50,41
1657388651249,CSE 15L,A02,083655,Morris; Justin Loren,9,0,50,41
1657388657276,CSE 20,A01,083657,Tran; Khoa Dang,39,0,80,41
1657388663305,CSE 21,A01,095574,Bach; Quang Tran,22,0,48,26
1657388669331,CSE 30,A01,083084,Eldon; John,4,0,80,76
1657388669331,CSE 30,B01,095061,Bhaskar; Nishant,9,0,50,41
1657388675359,CSE 100,A01,083659,Cao; Yingjun,5,4,70,65
1657388681383,CSE 134B,A01,083661,Powell; Thomas Allan,22,0,100,78
1657388687407,CSE 140,A01,083663,Gungor; Onat,14,0,85,71
1657388693433,CSE 140L,A01,083088,Eldon; John,21,0,100,79
1657388699457,CSE 175,A01,083665,Kumar; Rakesh,3,0,25,22
1657388705482,CSE 190,A00,092507,Dubnov; Shlomo,7,0,20,13
1657388711505,ECE 45,A01,083139,Congero; Spencer William,6,0,75,69
1657388717533,ECE 65,A50,083695,Saad; Andrew S,12,0,30,18
1657388717533,ECE 65,A51,095125,Saad; Andrew S,24,0,26,2
1657388723556,ECE 109,A01,091882,Touri; Behrouz,19,0,70,51
1657388729581,ECE 180,A00,083140,Abi Samra; Nicholas Camill,1,0,30,29
1657388729581,ECE 180,B00,083141,Abi Samra; Nicholas Camill,0,0,30,30
1657388735607,MATH 10A,A01,083735,Patchell; Gregory David,2,0,30,28
1657388735607,MATH 10A,A02,083736,Patchell; Gregory David,20,0,30,10
1657388735607,MATH 10A,A03,083737,Patchell; Gregory David,16,0,30,14
1657388741631,MATH 10B,A01,083207,Lim; Seonhee,8,0,34,26
1657388741631,MATH 10B,A02,083208,Lim; Seonhee,9,0,35,26
1657388741631,MATH 10B,A03,093472,Lim; Seonhee,7,0,34,27
1657388741631,MATH 10B,B01,083739,Sinha; Shubham,12,0,30,18
1657388747657,MATH 18,A01,083743,Cinel; Cameron Alexander,7,0,30,23
1657388747657,MATH 18,A02,083744,Cinel; Cameron Alexander,17,0,30,13
1657388747657,MATH 18,A03,083745,Cinel; Cameron Alexander,9,0,30,21
1657388747657,MATH 18,B01,083748,Rideout; David Porter,5,0,37,32
1657388747657,MATH 18,B02,083749,Rideout; David Porter,5,0,36,31
1657388747657,MATH 18,B03,083750,Rideout; David Porter,3,0,37,34
1657388747657,MATH 18,B04,083751,Rideout; David Porter,6,0,36,30
1657388747657,MATH 18,B05,093473,Rideout; David Porter,6,0,36,30
1657388747657,MATH 18,B06,093474,Rideout; David Porter,6,0,36,30
1657388753680,MATH 20A,A01,083754,Zheng; Zequn,14,0,40,26
1657388759712,MATH 20B,A01,083756,Briones; Jor-el Thomas Caparas,4,0,36,32
1657388759712,MATH 20B,A02,083757,Briones; Jor-el Thomas Caparas,1,0,36,35
1657388759712,MATH 20B,A03,093475,Briones; Jor-el Thomas Caparas,2,0,36,34
1657388765740,MATH 20C,A01,083760,Briones; Jor-el Thomas Caparas,1,0,35,34
1657388765740,MATH 20C,A02,083761,Briones; Jor-el Thomas Caparas,8,0,35,27
1657388765740,MATH 20C,A03,093476,Briones; Jor-el Thomas Caparas,0,1,36,36
1657388765740,MATH 20C,B01,083762,Bach; Quang Tran,1,0,30,29
1657388771772,MATH 20D,A01,083765,Tran; Brian Kha,5,0,30,25
1657388771772,MATH 20D,A02,083766,Tran; Brian Kha,5,0,30,25
1657388771772,MATH 20D,A03,083767,Tran; Brian Kha,5,0,30,25
1657388777869,MATH 20E,A01,083771,Ganguly; Soumya,9,0,32,23
1657388777869,MATH 20E,A02,083772,Ganguly; Soumya,6,0,32,26
1657388777869,MATH 20E,B01,083773,Ciotti; Benjamin,20,0,35,15
1657388777869,MATH 20E,B02,083774,Ciotti; Benjamin,17,0,35,18
1657388783896,MATH 103A,A01,083777,Greenfeld; Be'Eri,3,0,36,33
1657388783896,MATH 103A,A02,083778,Greenfeld; Be'Eri,5,0,36,31
1657388783896,MATH 103A,A03,093561,Greenfeld; Be'Eri,5,0,36,31
1657388783896,MATH 103A,B01,083779,Greenfeld; Be'Eri,7,0,36,29
1657388783896,MATH 103A,B02,083780,Greenfeld; Be'Eri,4,0,36,32
1657388783896,MATH 103A,B03,093562,Greenfeld; Be'Eri,3,0,36,33
1657388789923,MATH 105,A01,085443,Carter; Anne Toulson,15,0,35,20
1657388789923,MATH 105,A02,093477,Carter; Anne Toulson,20,0,35,15
1657388795955,MATH 109,A01,083213,Ganzberger; Geoffrey Michael,2,0,34,32
1657388795955,MATH 109,A02,083214,Ganzberger; Geoffrey Michael,4,0,34,30
1657388795955,MATH 109,A03,093478,Ganzberger; Geoffrey Michael,2,0,34,32
1657388795955,MATH 109,B01,083215,Ganzberger; Geoffrey Michael,1,0,32,31
1657388795955,MATH 109,B02,083216,Ganzberger; Geoffrey Michael,2,0,32,30
1657388795955,MATH 109,B03,093479,Ganzberger; Geoffrey Michael,8,0,32,24
1657388801982,MATH 142A,A01,083219,Chow; Bennett,7,0,32,25
1657388801982,MATH 142A,A02,083220,Chow; Bennett,10,0,32,22
1657388801982,MATH 142A,A03,093480,Chow; Bennett,8,0,32,24
1657388801982,MATH 142A,B03,093481,Chow; Bennett,8,0,32,24
1657388801982,MATH 142A,B04,093558,Chow; Bennett,13,0,32,19
1657388801982,MATH 142A,B05,093559,Chow; Bennett,6,0,32,26
1657388808007,MATH 193A,A01,083224,Rotar; Vladimir,8,0,34,26
1657388808007,MATH 193A,A02,083225,Rotar; Vladimir,9,0,34,25
1657388808007,MATH 193A,A03,083781,Rotar; Vladimir,5,0,34,29
1657388808007,MATH 193A,A04,083782,Rotar; Vladimir,10,0,34,24
1657388808007,MATH 193A,A05,093482,Rotar; Vladimir,10,0,34,24
1657388814034,MATH 197,001,091859,McAuley; Julian John,9999,0,9999,0
1657388814034,MATH 197,002,095566,Kedlaya; Kiran S.,9997,0,9999,2
1657388814034,MATH 197,003,095567,Xiao; Ming,9999,0,9999,0
1657388814034,MATH 197,004,095571,Perols; Johan Lars,9998,0,9999,1
1657388821092,COGS 9,A01,083615,Shannon; Kyle Michael,9,0,75,66
1657388827119,COGS 11,A01,083617,Boyle; Mary E. T.,22,0,48,26
1657388833143,COGS 13,A01,083071,Bastos; Amalia Pinkusfeld,11,0,71,60
1657388839166,COGS 14A,A01,092681,Semenuks; Arturs,4,1,100,96
1657388845195,COGS 14B,A01,083073,Cheng; Tzu-Han,6,0,63,57
1657388851230,COGS 17,A01,092677,Semenuks; Arturs,6,0,81,75
1657388857256,COGS 100,A01,083619,Allen; Michael Gordon,17,0,70,53
1657388863285,COGS 101A,A01,083621,Davis; Joshua Daniel,9,0,68,59
1657388869310,COGS 101B,A01,091572,Allen; Michael Gordon,11,0,65,54
1657388875336,COGS 101C,A01,083625,Delgado; Tania,17,0,35,18
1657388881359,COGS 107A,A01,083627,Boyle; Mary E. T.,13,0,60,47
1657388887384,COGS 118A,A01,083075,Gupta; Anjum,20,0,76,56
1657388893413,CSE 3,A50,083646,Miranda; Gregory Joseph,24,0,50,26
1657388899439,CSE 8A,A50,083650,Miranda; Gregory Joseph,17,1,56,39
1657388905466,CSE 11,A01,083080,Cao; Yingjun,6,15,40,34
1657388911493,CSE 12,A01,083652,Krause-Levy; Sophia Louisa,28,1,120,92
1657388917520,CSE 15L,A01,083654,Morris; Justin Loren,9,0,50,41
1657388917520,CSE 15L,A02,083655,Morris; Justin Loren,9,0,50,41
1657388923544,CSE 20,A01,083657,Tran; Khoa Dang,39,0,80,41
1657388929567,CSE 21,A01,095574,Bach; Quang Tran,22,0,48,26
1657388935598,CSE 30,A01,083084,Eldon; John,4,0,80,76
1657388935598,CSE 30,B01,095061,Bhaskar; Nishant,9,0,50,41
1657388941622,CSE 100,A01,083659,Cao; Yingjun,5,4,70,65
1657388947646,CSE 134B,A01,083661,Powell; Thomas Allan,22,0,100,78
1657388953669,CSE 140,A01,083663,Gungor; Onat,14,0,85,71
1657388959692,CSE 140L,A01,083088,Eldon; John,21,0,100,79
1657388965717,CSE 175,A01,083665,Kumar; Rakesh,3,0,25,22
1657388971745,CSE 190,A00,092507,Dubnov; Shlomo,7,0,20,13
1657388977775,ECE 45,A01,083139,Congero; Spencer William,6,0,75,69
1657388983800,ECE 65,A50,083695,Saad; Andrew S,12,0,30,18
1657388983800,ECE 65,A51,095125,Saad; Andrew S,24,0,26,2
1657388989825,ECE 109,A01,091882,Touri; Behrouz,19,0,70,51
1657388995851,ECE 180,A00,083140,Abi Samra; Nicholas Camill,1,0,30,29
1657388995851,ECE 180,B00,083141,Abi Samra; Nicholas Camill,0,0,30,30
1657389001881,MATH 10A,A01,083735,Patchell; Gregory David,2,0,30,28
1657389001881,MATH 10A,A02,083736,Patchell; Gregory David,20,0,30,10
1657389001881,MATH 10A,A03,083737,Patchell; Gregory David,16,0,30,14
1657389007907,MATH 10B,A01,083207,Lim; Seonhee,8,0,34,26
1657389007907,MATH 10B,A02,083208,Lim; Seonhee,9,0,35,26
1657389007907,MATH 10B,A03,093472,Lim; Seonhee,7,0,34,27
1657389007907,MATH 10B,B01,083739,Sinha; Shubham,12,0,30,18
1657389013943,MATH 18,A01,083743,Cinel; Cameron Alexander,7,0,30,23
1657389013943,MATH 18,A02,083744,Cinel; Cameron Alexander,17,0,30,13
1657389013943,MATH 18,A03,083745,Cinel; Cameron Alexander,9,0,30,21
1657389013943,MATH 18,B01,083748,Rideout; David Porter,5,0,37,32
1657389013943,MATH 18,B02,083749,Rideout; David Porter,5,0,36,31
1657389013943,MATH 18,B03,083750,Rideout; David Porter,3,0,37,34
1657389013943,MATH 18,B04,083751,Rideout; David Porter,6,0,36,30
1657389013943,MATH 18,B05,093473,Rideout; David Porter,6,0,36,30
1657389013943,MATH 18,B06,093474,Rideout; David Porter,6,0,36,30
1657389019972,MATH 20A,A01,083754,Zheng; Zequn,14,0,40,26
1657389025999,MATH 20B,A01,083756,Briones; Jor-el Thomas Caparas,4,0,36,32
1657389025999,MATH 20B,A02,083757,Briones; Jor-el Thomas Caparas,1,0,36,35
1657389025999,MATH 20B,A03,093475,Briones; Jor-el Thomas Caparas,2,0,36,34
1657389032024,MATH 20C,A01,083760,Briones; Jor-el Thomas Caparas,1,0,35,34
1657389032024,MATH 20C,A02,083761,Briones; Jor-el Thomas Caparas,8,0,35,27
1657389032024,MATH 20C,A03,093476,Briones; Jor-el Thomas Caparas,0,1,36,36
1657389032024,MATH 20C,B01,083762,Bach; Quang Tran,1,0,30,29
1657389038053,MATH 20D,A01,083765,Tran; Brian Kha,5,0,30,25
1657389038053,MATH 20D,A02,083766,Tran; Brian Kha,5,0,30,25
1657389038053,MATH 20D,A03,083767,Tran; Brian Kha,5,0,30,25
1657389044078,MATH 20E,A01,083771,Ganguly; Soumya,9,0,32,23
1657389044078,MATH 20E,A02,083772,Ganguly; Soumya,6,0,32,26
1657389044078,MATH 20E,B01,083773,Ciotti; Benjamin,20,0,35,15
1657389044078,MATH 20E,B02,083774,Ciotti; Benjamin,17,0,35,18
1657389050109,MATH 103A,A01,083777,Greenfeld; Be'Eri,3,0,36,33
1657389050109,MATH 103A,A02,083778,Greenfeld; Be'Eri,5,0,36,31
1657389050109,MATH 103A,A03,093561,Greenfeld; Be'Eri,5,0,36,31
1657389050109,MATH 103A,B01,083779,Greenfeld; Be'Eri,7,0,36,29
1657389050109,MATH 103A,B02,083780,Greenfeld; Be'Eri,4,0,36,32
1657389050109,MATH 103A,B03,093562,Greenfeld; Be'Eri,3,0,36,33
1657389056133,MATH 105,A01,085443,Carter; Anne Toulson,15,0,35,20
1657389056133,MATH 105,A02,093477,Carter; Anne Toulson,20,0,35,15
1657389062230,MATH 109,A01,083213,Ganzberger; Geoffrey Michael,2,0,34,32
1657389062230,MATH 109,A02,083214,Ganzberger; Geoffrey Michael,4,0,34,30
1657389062230,MATH 109,A03,093478,Ganzberger; Geoffrey Michael,2,0,34,32
1657389062230,MATH 109,B01,083215,Ganzberger; Geoffrey Michael,1,0,32,31
1657389062230,MATH 109,B02,083216,Ganzberger; Geoffrey Michael,2,0,32,30
1657389062230,MATH 109,B03,093479,Ganzberger; Geoffrey Michael,8,0,32,24
1657389068263,MATH 142A,A01,083219,Chow; Bennett,7,0,32,25
1657389068263,MATH 142A,A02,083220,Chow; Bennett,10,0,32,22
1657389068263,MATH 142A,A03,093480,Chow; Bennett,8,0,32,24
1657389068263,MATH 142A,B03,093481,Chow; Bennett,8,0,32,24
1657389068263,MATH 142A,B04,093558,Chow; Bennett,13,0,32,19
1657389068263,MATH 142A,B05,093559,Chow; Bennett,6,0,32,26
1657389074294,MATH 193A,A01,083224,Rotar; Vladimir,8,0,34,26
1657389074294,MATH 193A,A02,083225,Rotar; Vladimir,9,0,34,25
1657389074294,MATH 193A,A03,083781,Rotar; Vladimir,5,0,34,29
1657389074294,MATH 193A,A04,083782,Rotar; Vladimir,10,0,34,24
1657389074294,MATH 193A,A05,093482,Rotar; Vladimir,10,0,34,24
1657389080322,MATH 197,001,091859,McAuley; Julian John,9999,0,9999,0
1657389080322,MATH 197,002,095566,Kedlaya; Kiran S.,9997,0,9999,2
1657389080322,MATH 197,003,095567,Xiao; Ming,9999,0,9999,0
1657389080322,MATH 197,004,095571,Perols; Johan Lars,9998,0,9999,1
1657389087383,COGS 9,A01,083615,Shannon; Kyle Michael,9,0,75,66
1657389093415,COGS 11,A01,083617,Boyle; Mary E. T.,22,0,48,26
1657389099439,COGS 13,A01,083071,Bastos; Amalia Pinkusfeld,11,0,71,60
1657389105466,COGS 14A,A01,092681,Semenuks; Arturs,4,1,100,96
1657389111491,COGS 14B,A01,083073,Cheng; Tzu-Han,6,0,63,57
1657389117514,COGS 17,A01,092677,Semenuks; Arturs,6,0,81,75
1657389123539,COGS 100,A01,083619,Allen; Michael Gordon,17,0,70,53
1657389129563,COGS 101A,A01,083621,Davis; Joshua Daniel,9,0,68,59
1657389135587,COGS 101B,A01,091572,Allen; Michael Gordon,11,0,65,54
1657389141623,COGS 101C,A01,083625,Delgado; Tania,17,0,35,18
1657389147658,COGS 107A,A01,083627,Boyle; Mary E. T.,13,0,60,47
1657389153683,COGS 118A,A01,083075,Gupta; Anjum,20,0,76,56
1657389159710,CSE 3,A50,083646,Miranda; Gregory Joseph,24,0,50,26
1657389165737,CSE 8A,A50,083650,Miranda; Gregory Joseph,17,1,56,39
1657389171764,CSE 11,A01,083080,Cao; Yingjun,6,15,40,34
1657389177795,CSE 12,A01,083652,Krause-Levy; Sophia Louisa,28,1,120,92
1657389183819,CSE 15L,A01,083654,Morris; Justin Loren,9,0,50,41
1657389183819,CSE 15L,A02,083655,Morris; Justin Loren,9,0,50,41
1657389189845,CSE 20,A01,083657,Tran; Khoa Dang,39,0,80,41
1657389195876,CSE 21,A01,095574,Bach; Quang Tran,22,0,48,26
1657389201900,CSE 30,A01,083084,Eldon; John,4,0,80,76
1657389201900,CSE 30,B01,095061,Bhaskar; Nishant,9,0,50,41
1657389207996,CSE 100,A01,083659,Cao; Yingjun,5,4,70,65
1657389214019,CSE 134B,A01,083661,Powell; Thomas Allan,22,0,100,78
1657389220046,CSE 140,A01,083663,Gungor; Onat,14,0,85,71
1657389226069,CSE 140L,A01,083088,Eldon; John,21,0,100,79
1657389232093,CSE 175,A01,083665,Kumar; Rakesh,3,0,25,22
1657389238118,CSE 190,A00,092507,Dubnov; Shlomo,7,0,20,13
1657389244141,ECE 45,A01,083139,Congero; Spencer William,6,0,75,69
1657389250170,ECE 65,A50,083695,Saad; Andrew S,12,0,30,18
1657389250170,ECE 65,A51,095125,Saad; Andrew S,24,0,26,2
1657389256197,ECE 109,A01,091882,Touri; Behrouz,19,0,70,51
1657389262233,ECE 180,A00,083140,Abi Samra; Nicholas Camill,1,0,30,29
1657389262233,ECE 180,B00,083141,Abi Samra; Nicholas Camill,0,0,30,30
1657389268260,MATH 10A,A01,083735,Patchell; Gregory David,2,0,30,28
1657389268260,MATH 10A,A02,083736,Patchell; Gregory David,20,0,30,10
1657389268260,MATH 10A,A03,083737,Patchell; Gregory David,16,0,30,14
1657389274290,MATH 10B,A01,083207,Lim; Seonhee,8,0,34,26
1657389274290,MATH 10B,A02,083208,Lim; Seonhee,9,0,35,26
1657389274290,MATH 10B,A03,093472,Lim; Seonhee,7,0,34,27
1657389274290,MATH 10B,B01,083739,Sinha; Shubham,12,0,30,18
1657389280322,MATH 18,A01,083743,Cinel; Cameron Alexander,7,0,30,23
1657389280322,MATH 18,A02,083744,Cinel; Cameron Alexander,17,0,30,13
1657389280322,MATH 18,A03,083745,Cinel; Cameron Alexander,9,0,30,21
1657389280322,MATH 18,B01,083748,Rideout; David Porter,5,0,37,32
1657389280322,MATH 18,B02,083749,Rideout; David Porter,5,0,36,31
1657389280322,MATH 18,B03,083750,Rideout; David Porter,3,0,37,34
1657389280322,MATH 18,B04,083751,Rideout; David Porter,6,0,36,30
1657389280322,MATH 18,B05,093473,Rideout; David Porter,6,0,36,30
1657389280322,MATH 18,B06,093474,Rideout; David Porter,6,0,36,30
1657389286354,MATH 20A,A01,083754,Zheng; Zequn,14,0,40,26
1657389292377,MATH 20B,A01,083756,Briones; Jor-el Thomas Caparas,4,0,36,32
1657389292377,MATH 20B,A02,083757,Briones; Jor-el Thomas Caparas,1,0,36,35
1657389292377,MATH 20B,A03,093475,Briones; Jor-el Thomas Caparas,2,0,36,34
1657389298401,MATH 20C,A01,083760,Briones; Jor-el Thomas Caparas,1,0,35,34
1657389298401,MATH 20C,A02,083761,Briones; Jor-el Thomas Caparas,8,0,35,27
1657389298401,MATH 20C,A03,093476,Briones; Jor-el Thomas Caparas,0,1,36,36
1657389298401,MATH 20C,B01,083762,Bach; Quang Tran,1,0,30,29
1657389304425,MATH 20D,A01,083765,Tran; Brian Kha,5,0,30,25
1657389304425,MATH 20D,A02,083766,Tran; Brian Kha,5,0,30,25
1657389304425,MATH 20D,A03,083767,Tran; Brian Kha,5,0,30,25
1657389310450,MATH 20E,A01,083771,Ganguly; Soumya,9,0,32,23
1657389310450,MATH 20E,A02,083772,Ganguly; Soumya,6,0,32,26
1657389310450,MATH 20E,B01,083773,Ciotti; Benjamin,20,0,35,15
1657389310450,MATH 20E,B02,083774,Ciotti; Benjamin,17,0,35,18
1657389316471,MATH 103A,A01,083777,Greenfeld; Be'Eri,3,0,36,33
1657389316471,MATH 103A,A02,083778,Greenfeld; Be'Eri,5,0,36,31
1657389316471,MATH 103A,A03,093561,Greenfeld; Be'Eri,5,0,36,31
1657389316471,MATH 103A,B01,083779,Greenfeld; Be'Eri,7,0,36,29
1657389316471,MATH 103A,B02,083780,Greenfeld; Be'Eri,4,0,36,32
1657389316471,MATH 103A,B03,093562,Greenfeld; Be'Eri,3,0,36,33
1657389322517,MATH 105,A01,085443,Carter; Anne Toulson,15,0,35,20
1657389322517,MATH 105,A02,093477,Carter; Anne Toulson,20,0,35,15
1657389328545,MATH 109,A01,083213,Ganzberger; Geoffrey Michael,2,0,34,32
1657389328545,MATH 109,A02,083214,Ganzberger; Geoffrey Michael,4,0,34,30
1657389328545,MATH 109,A03,093478,Ganzberger; Geoffrey Michael,2,0,34,32
1657389328545,MATH 109,B01,083215,Ganzberger; Geoffrey Michael,1,0,32,31
1657389328545,MATH 109,B02,083216,Ganzberger; Geoffrey Michael,2,0,32,30
1657389328545,MATH 109,B03,093479,Ganzberger; Geoffrey Michael,8,0,32,24
1657389334567,MATH 142A,A01,083219,Chow; Bennett,7,0,32,25
1657389334567,MATH 142A,A02,083220,Chow; Bennett,10,0,32,22
1657389334567,MATH 142A,A03,093480,Chow; Bennett,8,0,32,24
1657389334567,MATH 142A,B03,093481,Chow; Bennett,8,0,32,24
1657389334567,MATH 142A,B04,093558,Chow; Bennett,13,0,32,19
1657389334567,MATH 142A,B05,093559,Chow; Bennett,6,0,32,26
1657389340591,MATH 193A,A01,083224,Rotar; Vladimir,8,0,34,26
1657389340591,MATH 193A,A02,083225,Rotar; Vladimir,9,0,34,25
1657389340591,MATH 193A,A03,083781,Rotar; Vladimir,5,0,34,29
1657389340591,MATH 193A,A04,083782,Rotar; Vladimir,10,0,34,24
1657389340591,MATH 193A,A05,093482,Rotar; Vladimir,10,0,34,24
1657389346615,MATH 197,001,091859,McAuley; Julian John,9999,0,9999,0
1657389346615,MATH 197,002,095566,Kedlaya; Kiran S.,9997,0,9999,2
1657389346615,MATH 197,003,095567,Xiao; Ming,9999,0,9999,0
1657389346615,MATH 197,004,095571,Perols; Johan Lars,9998,0,9999,1
1657389353674,COGS 9,A01,083615,Shannon; Kyle Michael,9,0,75,66
1657389359701,COGS 11,A01,083617,Boyle; Mary E. T.,22,0,48,26
1657389365724,COGS 13,A01,083071,Bastos; Amalia Pinkusfeld,11,0,71,60
1657389371760,COGS 14A,A01,092681,Semenuks; Arturs,4,1,100,96
1657389377800,COGS 14B,A01,083073,Cheng; Tzu-Han,6,0,63,57
1657389383825,COGS 17,A01,092677,Semenuks; Arturs,6,0,81,75
1657389389848,COGS 100,A01,083619,Allen; Michael Gordon,17,0,70,53
1657389395876,COGS 101A,A01,083621,Davis; Joshua Daniel,9,0,68,59
1657389401903,COGS 101B,A01,091572,Allen; Michael Gordon,11,0,65,54
1657389407926,COGS 101C,A01,083625,Delgado; Tania,17,0,35,18
1657389413954,COGS 107A,A01,083627,Boyle; Mary E. T.,13,0,60,47
1657389419989,COGS 118A,A01,083075,Gupta; Anjum,20,0,76,56
1657389426019,CSE 3,A50,083646,Miranda; Gregory Joseph,24,0,50,26
1657389432055,CSE 8A,A50,083650,Miranda; Gregory Joseph,17,1,56,39
1657389438082,CSE 11,A01,083080,Cao; Yingjun,6,15,40,34
1657389444115,CSE 12,A01,083652,Krause-Levy; Sophia Louisa,28,1,120,92
1657389450142,CSE 15L,A01,083654,Morris; Justin Loren,9,0,50,41
1657389450142,CSE 15L,A02,083655,Morris; Justin Loren,9,0,50,41
1657389456168,CSE 20,A01,083657,Tran; Khoa Dang,39,0,80,41
1657389462192,CSE 21,A01,095574,Bach; Quang Tran,22,0,48,26
1657389468220,CSE 30,A01,083084,Eldon; John,4,0,80,76
1657389468220,CSE 30,B01,095061,Bhaskar; Nishant,9,0,50,41
1657389474248,CSE 100,A01,083659,Cao; Yingjun,5,4,70,65
1657389480273,CSE 134B,A01,083661,Powell; Thomas Allan,22,0,100,78
1657389486297,CSE 140,A01,083663,Gungor; Onat,14,0,85,71
1657389492331,CSE 140L,A01,083088,Eldon; John,21,0,100,79
1657389498357,CSE 175,A01,083665,Kumar; Rakesh,3,0,25,22
1657389504384,CSE 190,A00,092507,Dubnov; Shlomo,7,0,20,13
1657389510408,ECE 45,A01,083139,Congero; Spencer William,6,0,75,69
1657389516430,ECE 65,A50,083695,Saad; Andrew S,12,0,30,18
1657389516430,ECE 65,A51,095125,Saad; Andrew S,24,0,26,2
1657389522465,ECE 109,A01,091882,Touri; Behrouz,19,0,70,51
1657389528491,ECE 180,A00,083140,Abi Samra; Nicholas Camill,1,0,30,29
1657389528491,ECE 180,B00,083141,Abi Samra; Nicholas Camill,0,0,30,30
1657389534518,MATH 10A,A01,083735,Patchell; Gregory David,2,0,30,28
1657389534518,MATH 10A,A02,083736,Patchell; Gregory David,20,0,30,10
1657389534518,MATH 10A,A03,083737,Patchell; Gregory David,16,0,30,14
1657389540542,MATH 10B,A01,083207,Lim; Seonhee,8,0,34,26
1657389540542,MATH 10B,A02,083208,Lim; Seonhee,9,0,35,26
1657389540542,MATH 10B,A03,093472,Lim; Seonhee,7,0,34,27
1657389540542,MATH 10B,B01,083739,Sinha; Shubham,12,0,30,18
1657389546567,MATH 18,A01,083743,Cinel; Cameron Alexander,7,0,30,23
1657389546567,MATH 18,A02,083744,Cinel; Cameron Alexander,17,0,30,13
1657389546567,MATH 18,A03,083745,Cinel; Cameron Alexander,9,0,30,21
1657389546567,MATH 18,B01,083748,Rideout; David Porter,5,0,37,32
1657389546567,MATH 18,B02,083749,Rideout; David Porter,5,0,36,31
1657389546567,MATH 18,B03,083750,Rideout; David Porter,3,0,37,34
1657389546567,MATH 18,B04,083751,Rideout; David Porter,6,0,36,30
1657389546567,MATH 18,B05,093473,Rideout; David Porter,6,0,36,30
1657389546567,MATH 18,B06,093474,Rideout; David Porter,6,0,36,30
1657389552593,MATH 20A,A01,083754,Zheng; Zequn,14,0,40,26
1657389558624,MATH 20B,A01,083756,Briones; Jor-el Thomas Caparas,4,0,36,32
1657389558624,MATH 20B,A02,083757,Briones; Jor-el Thomas Caparas,1,0,36,35
1657389558624,MATH 20B,A03,093475,Briones; Jor-el Thomas Caparas,2,0,36,34
1657389564651,MATH 20C,A01,083760,Briones; Jor-el Thomas Caparas,1,0,35,34
1657389564651,MATH 20C,A02,083761,Briones; Jor-el Thomas Caparas,8,0,35,27
1657389564651,MATH 20C,A03,093476,Briones; Jor-el Thomas Caparas,0,1,36,36
1657389564651,MATH 20C,B01,083762,Bach; Quang Tran,1,0,30,29
1657389570679,MATH 20D,A01,083765,Tran; Brian Kha,5,0,30,25
1657389570679,MATH 20D,A02,083766,Tran; Brian Kha,5,0,30,25
1657389570679,MATH 20D,A03,083767,Tran; Brian Kha,5,0,30,25
1657389576703,MATH 20E,A01,083771,Ganguly; Soumya,9,0,32,23
1657389576703,MATH 20E,A02,083772,Ganguly; Soumya,6,0,32,26
1657389576703,MATH 20E,B01,083773,Ciotti; Benjamin,20,0,35,15
1657389576703,MATH 20E,B02,083774,Ciotti; Benjamin,17,0,35,18
1657389582726,MATH 103A,A01,083777,Greenfeld; Be'Eri,3,0,36,33
1657389582726,MATH 103A,A02,083778,Greenfeld; Be'Eri,5,0,36,31
1657389582726,MATH 103A,A03,093561,Greenfeld; Be'Eri,5,0,36,31
1657389582726,MATH 103A,B01,083779,Greenfeld; Be'Eri,7,0,36,29
1657389582726,MATH 103A,B02,083780,Greenfeld; Be'Eri,4,0,36,32
1657389582726,MATH 103A,B03,093562,Greenfeld; Be'Eri,3,0,36,33
1657389588754,MATH 105,A01,085443,Carter; Anne Toulson,15,0,35,20
1657389588754,MATH 105,A02,093477,Carter; Anne Toulson,20,0,35,15
1657389594791,MATH 109,A01,083213,Ganzberger; Geoffrey Michael,2,0,34,32
1657389594791,MATH 109,A02,083214,Ganzberger; Geoffrey Michael,4,0,34,30
1657389594791,MATH 109,A03,093478,Ganzberger; Geoffrey Michael,2,0,34,32
1657389594791,MATH 109,B01,083215,Ganzberger; Geoffrey Michael,1,0,32,31
1657389594791,MATH 109,B02,083216,Ganzberger; Geoffrey Michael,2,0,32,30
1657389594791,MATH 109,B03,093479,Ganzberger; Geoffrey Michael,8,0,32,24
1657389600814,MATH 142A,A01,083219,Chow; Bennett,7,0,32,25
1657389600814,MATH 142A,A02,083220,Chow; Bennett,10,0,32,22
1657389600814,MATH 142A,A03,093480,Chow; Bennett,8,0,32,24
1657389600814,MATH 142A,B03,093481,Chow; Bennett,8,0,32,24
1657389600814,MATH 142A,B04,093558,Chow; Bennett,13,0,32,19
1657389600814,MATH 142A,B05,093559,Chow; Bennett,6,0,32,26
1657389606837,MATH 193A,A01,083224,Rotar; Vladimir,8,0,34,26
1657389606837,MATH 193A,A02,083225,Rotar; Vladimir,9,0,34,25
1657389606837,MATH 193A,A03,083781,Rotar; Vladimir,5,0,34,29
1657389606837,MATH 193A,A04,083782,Rotar; Vladimir,10,0,34,24
1657389606837,MATH 193A,A05,093482,Rotar; Vladimir,10,0,34,24
1657389612860,MATH 197,001,091859,McAuley; Julian John,9999,0,9999,0
1657389612860,MATH 197,002,095566,Kedlaya; Kiran S.,9997,0,9999,2
1657389612860,MATH 197,003,095567,Xiao; Ming,9999,0,9999,0
1657389612860,MATH 197,004,095571,Perols; Johan Lars,9998,0,9999,1
1657389619929,COGS 9,A01,083615,Shannon; Kyle Michael,9,0,75,66
1657389625959,COGS 11,A01,083617,Boyle; Mary E. T.,22,0,48,26
1657389631983,COGS 13,A01,083071,Bastos; Amalia Pinkusfeld,11,0,71,60
1657389638014,COGS 14A,A01,092681,Semenuks; Arturs,4,1,100,96
1657389644036,COGS 14B,A01,083073,Cheng; Tzu-Han,6,0,63,57
1657389650063,COGS 17,A01,092677,Semenuks; Arturs,6,0,81,75
1657389656086,COGS 100,A01,083619,Allen; Michael Gordon,17,0,70,53
1657389662151,COGS 101A,A01,083621,Davis; Joshua Daniel,9,0,68,59
1657389668182,COGS 101B,A01,091572,Allen; Michael Gordon,11,0,65,54
1657389674210,COGS 101C,A01,083625,Delgado; Tania,17,0,35,18
1657389680232,COGS 107A,A01,083627,Boyle; Mary E. T.,13,0,60,47
1657389686254,COGS 118A,A01,083075,Gupta; Anjum,20,0,76,56
1657389692282,CSE 3,A50,083646,Miranda; Gregory Joseph,24,0,50,26
1657389698306,CSE 8A,A50,083650,Miranda; Gregory Joseph,17,1,56,39
1657389704329,CSE 11,A01,083080,Cao; Yingjun,6,15,40,34
1657389710356,CSE 12,A01,083652,Krause-Levy; Sophia Louisa,28,1,120,92
1657389716381,CSE 15L,A01,083654,Morris; Justin Loren,9,0,50,41
1657389716381,CSE 15L,A02,083655,Morris; Justin Loren,9,0,50,41
1657389722406,CSE 20,A01,083657,Tran; Khoa Dang,39,0,80,41
1657389728430,CSE 21,A01,095574,Bach; Quang Tran,22,0,48,26
1657389734460,CSE 30,A01,083084,Eldon; John,4,0,80,76
1657389734460,CSE 30,B01,095061,Bhaskar; Nishant,9,0,50,41
1657389740487,CSE 100,A01,083659,Cao; Yingjun,5,4,70,65
1657389746509,CSE 134B,A01,083661,Powell; Thomas Allan,22,0,100,78
1657389752531,CSE 140,A01,083663,Gungor; Onat,14,0,85,71
1657389758553,CSE 140L,A01,083088,Eldon; John,21,0,100,79
1657389764577,CSE 175,A01,083665,Kumar; Rakesh,3,0,25,22
1657389770603,CSE 190,A00,092507,Dubnov; Shlomo,7,0,20,13
1657389776629,ECE 45,A01,083139,Congero; Spencer William,6,0,75,69
1657389782658,ECE 65,A50,083695,Saad; Andrew S,12,0,30,18
1657389782658,ECE 65,A51,095125,Saad; Andrew S,24,0,26,2
1657389788679,ECE 109,A01,091882,Touri; Behrouz,19,0,70,51
1657389794703,ECE 180,A00,083140,Abi Samra; Nicholas Camill,1,0,30,29
1657389794703,ECE 180,B00,083141,Abi Samra; Nicholas Camill,0,0,30,30
1657389800731,MATH 10A,A01,083735,Patchell; Gregory David,2,0,30,28
1657389800731,MATH 10A,A02,083736,Patchell; Gregory David,20,0,30,10
1657389800731,MATH 10A,A03,083737,Patchell; Gregory David,16,0,30,14
1657389806834,MATH 10B,A01,083207,Lim; Seonhee,8,0,34,26
1657389806834,MATH 10B,A02,083208,Lim; Seonhee,9,0,35,26
1657389806834,MATH 10B,A03,093472,Lim; Seonhee,7,0,34,27
1657389806834,MATH 10B,B01,083739,Sinha; Shubham,12,0,30,18
1657389812859,MATH 18,A01,083743,Cinel; Cameron Alexander,7,0,30,23
1657389812859,MATH 18,A02,083744,Cinel; Cameron Alexander,17,0,30,13
1657389812859,MATH 18,A03,083745,Cinel; Cameron Alexander,9,0,30,21
1657389812859,MATH 18,B01,083748,Rideout; David Porter,5,0,37,32
1657389812859,MATH 18,B02,083749,Rideout; David Porter,5,0,36,31
1657389812859,MATH 18,B03,083750,Rideout; David Porter,3,0,37,34
1657389812859,MATH 18,B04,083751,Rideout; David Porter,6,0,36,30
1657389812859,MATH 18,B05,093473,Rideout; David Porter,6,0,36,30
1657389812859,MATH 18,B06,093474,Rideout; David Porter,6,0,36,30
1657389818886,MATH 20A,A01,083754,Zheng; Zequn,14,0,40,26
1657389824910,MATH 20B,A01,083756,Briones; Jor-el Thomas Caparas,4,0,36,32
1657389824910,MATH 20B,A02,083757,Briones; Jor-el Thomas Caparas,1,0,36,35
1657389824910,MATH 20B,A03,093475,Briones; Jor-el Thomas Caparas,2,0,36,34
1657389830934,MATH 20C,A01,083760,Briones; Jor-el Thomas Caparas,1,0,35,34
1657389830934,MATH 20C,A02,083761,Briones; Jor-el Thomas Caparas,8,0,35,27
1657389830934,MATH 20C,A03,093476,Briones; Jor-el Thomas Caparas,0,1,36,36
1657389830934,MATH 20C,B01,083762,Bach; Quang Tran,1,0,30,29
1657389836971,MATH 20D,A01,083765,Tran; Brian Kha,5,0,30,25
1657389836971,MATH 20D,A02,083766,Tran; Brian Kha,5,0,30,25
1657389836971,MATH 20D,A03,083767,Tran; Brian Kha,5,0,30,25
1657389842994,MATH 20E,A01,083771,Ganguly; Soumya,9,0,32,23
1657389842994,MATH 20E,A02,083772,Ganguly; Soumya,6,0,32,26
1657389842994,MATH 20E,B01,083773,Ciotti; Benjamin,20,0,35,15
1657389842994,MATH 20E,B02,083774,Ciotti; Benjamin,17,0,35,18
1657389849027,MATH 103A,A01,083777,Greenfeld; Be'Eri,3,0,36,33
1657389849027,MATH 103A,A02,083778,Greenfeld; Be'Eri,5,0,36,31
1657389849027,MATH 103A,A03,093561,Greenfeld; Be'Eri,5,0,36,31
1657389849027,MATH 103A,B01,083779,Greenfeld; Be'Eri,7,0,36,29
1657389849027,MATH 103A,B02,083780,Greenfeld; Be'Eri,4,0,36,32
1657389849027,MATH 103A,B03,093562,Greenfeld; Be'Eri,3,0,36,33
1657389855054,MATH 105,A01,085443,Carter; Anne Toulson,15,0,35,20
1657389855054,MATH 105,A02,093477,Carter; Anne Toulson,20,0,35,15
1657389861077,MATH 109,A01,083213,Ganzberger; Geoffrey Michael,2,0,34,32
1657389861077,MATH 109,A02,083214,Ganzberger; Geoffrey Michael,4,0,34,30
1657389861077,MATH 109,A03,093478,Ganzberger; Geoffrey Michael,2,0,34,32
1657389861077,MATH 109,B01,083215,Ganzberger; Geoffrey Michael,1,0,32,31
1657389861077,MATH 109,B02,083216,Ganzberger; Geoffrey Michael,2,0,32,30
1657389861077,MATH 109,B03,093479,Ganzberger; Geoffrey Michael,8,0,32,24
1657389867108,MATH 142A,A01,083219,Chow; Bennett,7,0,32,25
1657389867108,MATH 142A,A02,083220,Chow; Bennett,10,0,32,22
1657389867108,MATH 142A,A03,093480,Chow; Bennett,8,0,32,24
1657389867108,MATH 142A,B03,093481,Chow; Bennett,8,0,32,24
1657389867108,MATH 142A,B04,093558,Chow; Bennett,13,0,32,19
1657389867108,MATH 142A,B05,093559,Chow; Bennett,6,0,32,26
1657389873133,MATH 193A,A01,083224,Rotar; Vladimir,8,0,34,26
1657389873133,MATH 193A,A02,083225,Rotar; Vladimir,9,0,34,25
1657389873133,MATH 193A,A03,083781,Rotar; Vladimir,5,0,34,29
1657389873133,MATH 193A,A04,083782,Rotar; Vladimir,10,0,34,24
1657389873133,MATH 193A,A05,093482,Rotar; Vladimir,10,0,34,24
1657389879158,MATH 197,001,091859,McAuley; Julian John,9999,0,9999,0
1657389879158,MATH 197,002,095566,Kedlaya; Kiran S.,9997,0,9999,2
1657389879158,MATH 197,003,095567,Xiao; Ming,9999,0,9999,0
1657389879158,MATH 197,004,095571,Perols; Johan Lars,9998,0,9999,1
1657389886228,COGS 9,A01,083615,Shannon; Kyle Michael,9,0,75,66
1657389892256,COGS 11,A01,083617,Boyle; Mary E. T.,22,0,48,26
1657389898281,COGS 13,A01,083071,Bastos; Amalia Pinkusfeld,11,0,71,60
1657389904308,COGS 14A,A01,092681,Semenuks; Arturs,4,1,100,96
1657389910335,COGS 14B,A01,083073,Cheng; Tzu-Han,6,0,63,57
1657389916361,COGS 17,A01,092677,Semenuks; Arturs,6,0,81,75
1657389922387,COGS 100,A01,083619,Allen; Michael Gordon,17,0,70,53
1657389928410,COGS 101A,A01,083621,Davis; Joshua Daniel,9,0,68,59
1657389934433,COGS 101B,A01,091572,Allen; Michael Gordon,11,0,65,54
1657389940457,COGS 101C,A01,083625,Delgado; Tania,17,0,35,18
1657389946481,COGS 107A,A01,083627,Boyle; Mary E. T.,13,0,60,47
1657389952508,COGS 118A,A01,083075,Gupta; Anjum,20,0,76,56
1657389958531,CSE 3,A50,083646,Miranda; Gregory Joseph,24,0,50,26
1657389964554,CSE 8A,A50,083650,Miranda; Gregory Joseph,17,1,56,39
1657389970577,CSE 11,A01,083080,Cao; Yingjun,6,15,40,34
1657389976600,CSE 12,A01,083652,Krause-Levy; Sophia Louisa,28,1,120,92
1657389982626,CSE 15L,A01,083654,Morris; Justin Loren,9,0,50,41
1657389982626,CSE 15L,A02,083655,Morris; Justin Loren,9,0,50,41
1657389988648,CSE 20,A01,083657,Tran; Khoa Dang,39,0,80,41
1657389994679,CSE 21,A01,095574,Bach; Quang Tran,22,0,48,26
1657390000708,CSE 30,A01,083084,Eldon; John,4,0,80,76
1657390000708,CSE 30,B01,095061,Bhaskar; Nishant,9,0,50,41
1657390006729,CSE 100,A01,083659,Cao; Yingjun,5,4,70,65
1657390012754,CSE 134B,A01,083661,Powell; Thomas Allan,22,0,100,78
1657390018787,CSE 140,A01,083663,Gungor; Onat,14,0,85,71
1657390024812,CSE 140L,A01,083088,Eldon; John,21,0,100,79
1657390030836,CSE 175,A01,083665,Kumar; Rakesh,3,0,25,22
1657390036859,CSE 190,A00,092507,Dubnov; Shlomo,7,0,20,13
1657390042885,ECE 45,A01,083139,Congero; Spencer William,6,0,75,69
1657390048912,ECE 65,A50,083695,Saad; Andrew S,12,0,30,18
1657390048912,ECE 65,A51,095125,Saad; Andrew S,24,0,26,2
1657390054935,ECE 109,A01,091882,Touri; Behrouz,19,0,70,51
1657390060959,ECE 180,A00,083140,Abi Samra; Nicholas Camill,1,0,30,29
1657390060959,ECE 180,B00,083141,Abi Samra; Nicholas Camill,0,0,30,30
1657390066988,MATH 10A,A01,083735,Patchell; Gregory David,2,0,30,28
1657390066988,MATH 10A,A02,083736,Patchell; Gregory David,20,0,30,10
1657390066988,MATH 10A,A03,083737,Patchell; Gregory David,16,0,30,14
1657390073023,MATH 10B,A01,083207,Lim; Seonhee,8,0,34,26
1657390073023,MATH 10B,A02,083208,Lim; Seonhee,9,0,35,26
1657390073023,MATH 10B,A03,093472,Lim; Seonhee,7,0,34,27
1657390073023,MATH 10B,B01,083739,Sinha; Shubham,12,0,30,18
1657390079049,MATH 18,A01,083743,Cinel; Cameron Alexander,7,0,30,23
1657390079049,MATH 18,A02,083744,Cinel; Cameron Alexander,17,0,30,13
1657390079049,MATH 18,A03,083745,Cinel; Cameron Alexander,9,0,30,21
1657390079049,MATH 18,B01,083748,Rideout; David Porter,5,0,37,32
1657390079049,MATH 18,B02,083749,Rideout; David Porter,5,0,36,31
1657390079049,MATH 18,B03,083750,Rideout; David Porter,3,0,37,34
1657390079049,MATH 18,B04,083751,Rideout; David Porter,6,0,36,30
1657390079049,MATH 18,B05,093473,Rideout; David Porter,6,0,36,30
1657390079049,MATH 18,B06,093474,Rideout; David Porter,6,0,36,30
1657390085078,MATH 20A,A01,083754,Zheng; Zequn,14,0,40,26
1657390091111,MATH 20B,A01,083756,Briones; Jor-el Thomas Caparas,4,0,36,32
1657390091111,MATH 20B,A02,083757,Briones; Jor-el Thomas Caparas,1,0,36,35
1657390091111,MATH 20B,A03,093475,Briones; Jor-el Thomas Caparas,2,0,36,34
1657390097133,MATH 20C,A01,083760,Briones; Jor-el Thomas Caparas,1,0,35,34
1657390097133,MATH 20C,A02,083761,Briones; Jor-el Thomas Caparas,8,0,35,27
1657390097133,MATH 20C,A03,093476,Briones; Jor-el Thomas Caparas,0,1,36,36
1657390097133,MATH 20C,B01,083762,Bach; Quang Tran,1,0,30,29
1657390103163,MATH 20D,A01,083765,Tran; Brian Kha,5,0,30,25
1657390103163,MATH 20D,A02,083766,Tran; Brian Kha,5,0,30,25
1657390103163,MATH 20D,A03,083767,Tran; Brian Kha,5,0,30,25
1657390109186,MATH 20E,A01,083771,Ganguly; Soumya,9,0,32,23
1657390109186,MATH 20E,A02,083772,Ganguly; Soumya,6,0,32,26
1657390109186,MATH 20E,B01,083773,Ciotti; Benjamin,20,0,35,15
1657390109186,MATH 20E,B02,083774,Ciotti; Benjamin,17,0,35,18
1657390115216,MATH 103A,A01,083777,Greenfeld; Be'Eri,3,0,36,33
1657390115216,MATH 103A,A02,083778,Greenfeld; Be'Eri,5,0,36,31
1657390115216,MATH 103A,A03,093561,Greenfeld; Be'Eri,5,0,36,31
1657390115216,MATH 103A,B01,083779,Greenfeld; Be'Eri,7,0,36,29
1657390115216,MATH 103A,B02,083780,Greenfeld; Be'Eri,4,0,36,32
1657390115216,MATH 103A,B03,093562,Greenfeld; Be'Eri,3,0,36,33
1657390121237,MATH 105,A01,085443,Carter; Anne Toulson,15,0,35,20
1657390121237,MATH 105,A02,093477,Carter; Anne Toulson,20,0,35,15
1657390127261,MATH 109,A01,083213,Ganzberger; Geoffrey Michael,2,0,34,32
1657390127261,MATH 109,A02,083214,Ganzberger; Geoffrey Michael,4,0,34,30
1657390127261,MATH 109,A03,093478,Ganzberger; Geoffrey Michael,2,0,34,32
1657390127261,MATH 109,B01,083215,Ganzberger; Geoffrey Michael,1,0,32,31
1657390127261,MATH 109,B02,083216,Ganzberger; Geoffrey Michael,2,0,32,30
1657390127261,MATH 109,B03,093479,Ganzberger; Geoffrey Michael,8,0,32,24
1657390133290,MATH 142A,A01,083219,Chow; Bennett,7,0,32,25
1657390133290,MATH 142A,A02,083220,Chow; Bennett,10,0,32,22
1657390133290,MATH 142A,A03,093480,Chow; Bennett,8,0,32,24
1657390133290,MATH 142A,B03,093481,Chow; Bennett,8,0,32,24
1657390133290,MATH 142A,B04,093558,Chow; Bennett,13,0,32,19
1657390133290,MATH 142A,B05,093559,Chow; Bennett,6,0,32,26
1657390139320,MATH 193A,A01,083224,Rotar; Vladimir,8,0,34,26
1657390139320,MATH 193A,A02,083225,Rotar; Vladimir,9,0,34,25
1657390139320,MATH 193A,A03,083781,Rotar; Vladimir,5,0,34,29
1657390139320,MATH 193A,A04,083782,Rotar; Vladimir,10,0,34,24
1657390139320,MATH 193A,A05,093482,Rotar; Vladimir,10,0,34,24
1657390145344,MATH 197,001,091859,McAuley; Julian John,9999,0,9999,0
1657390145344,MATH 197,002,095566,Kedlaya; Kiran S.,9997,0,9999,2
1657390145344,MATH 197,003,095567,Xiao; Ming,9999,0,9999,0
1657390145344,MATH 197,004,095571,Perols; Johan Lars,9998,0,9999,1
1657390152402,COGS 9,A01,083615,Shannon; Kyle Michael,9,0,75,66
1657390158429,COGS 11,A01,083617,Boyle; Mary E. T.,22,0,48,26
1657390164455,COGS 13,A01,083071,Bastos; Amalia Pinkusfeld,11,0,71,60
1657390170477,COGS 14A,A01,092681,Semenuks; Arturs,4,1,100,96
1657390176503,COGS 14B,A01,083073,Cheng; Tzu-Han,6,0,63,57
1657390182534,COGS 17,A01,092677,Semenuks; Arturs,6,0,81,75
1657390188559,COGS 100,A01,083619,Allen; Michael Gordon,17,0,70,53
1657390194587,COGS 101A,A01,083621,Davis; Joshua Daniel,9,0,68,59
1657390200615,COGS 101B,A01,091572,Allen; Michael Gordon,11,0,65,54
1657390206641,COGS 101C,A01,083625,Delgado; Tania,17,0,35,18
1657390212663,COGS 107A,A01,083627,Boyle; Mary E. T.,13,0,60,47
1657390218695,COGS 118A,A01,083075,Gupta; Anjum,20,0,76,56
1657390224721,CSE 3,A50,083646,Miranda; Gregory Joseph,24,0,50,26
1657390230742,CSE 8A,A50,083650,Miranda; Gregory Joseph,17,1,56,39
1657390236764,CSE 11,A01,083080,Cao; Yingjun,6,15,40,34
1657390242788,CSE 12,A01,083652,Krause-Levy; Sophia Louisa,28,1,120,92
1657390248814,CSE 15L,A01,083654,Morris; Justin Loren,9,0,50,41
1657390248814,CSE 15L,A02,083655,Morris; Justin Loren,9,0,50,41
1657390254840,CSE 20,A01,083657,Tran; Khoa Dang,39,0,80,41
1657390260874,CSE 21,A01,095574,Bach; Quang Tran,22,0,48,26
1657390266897,CSE 30,A01,083084,Eldon; John,4,0,80,76
1657390266897,CSE 30,B01,095061,Bhaskar; Nishant,9,0,50,41
1657390272921,CSE 100,A01,083659,Cao; Yingjun,5,4,70,65
1657390278945,CSE 134B,A01,083661,Powell; Thomas Allan,22,0,100,78
1657390284970,CSE 140,A01,083663,Gungor; Onat,14,0,85,71
1657390290998,CSE 140L,A01,083088,Eldon; John,21,0,100,79
1657390297020,CSE 175,A01,083665,Kumar; Rakesh,3,0,25,22
1657390303047,CSE 190,A00,092507,Dubnov; Shlomo,7,0,20,13
1657390309071,ECE 45,A01,083139,Congero; Spencer William,6,0,75,69
1657390315100,ECE 65,A50,083695,Saad; Andrew S,12,0,30,18
1657390315100,ECE 65,A51,095125,Saad; Andrew S,24,0,26,2
1657390321123,ECE 109,A01,091882,Touri; Behrouz,19,0,70,51
1657390327147,ECE 180,A00,083140,Abi Samra; Nicholas Camill,1,0,30,29
1657390327147,ECE 180,B00,083141,Abi Samra; Nicholas Camill,0,0,30,30
1657390333170,MATH 10A,A01,083735,Patchell; Gregory David,2,0,30,28
1657390333170,MATH 10A,A02,083736,Patchell; Gregory David,20,0,30,10
1657390333170,MATH 10A,A03,083737,Patchell; Gregory David,16,0,30,14
1657390339195,MATH 10B,A01,083207,Lim; Seonhee,8,0,34,26
1657390339195,MATH 10B,A02,083208,Lim; Seonhee,9,0,35,26
1657390339195,MATH 10B,A03,093472,Lim; Seonhee,7,0,34,27
1657390339195,MATH 10B,B01,083739,Sinha; Shubham,12,0,30,18
1657390345222,MATH 18,A01,083743,Cinel; Cameron Alexander,7,0,30,23
1657390345222,MATH 18,A02,083744,Cinel; Cameron Alexander,17,0,30,13
1657390345222,MATH 18,A03,083745,Cinel; Cameron Alexander,9,0,30,21
1657390345222,MATH 18,B01,083748,Rideout; David Porter,5,0,37,32
1657390345222,MATH 18,B02,083749,Rideout; David Porter,5,0,36,31
1657390345222,MATH 18,B03,083750,Rideout; David Porter,3,0,37,34
1657390345222,MATH 18,B04,083751,Rideout; David Porter,6,0,36,30
1657390345222,MATH 18,B05,093473,Rideout; David Porter,6,0,36,30
1657390345222,MATH 18,B06,093474,Rideout; David Porter,6,0,36,30
1657390351250,MATH 20A,A01,083754,Zheng; Zequn,14,0,40,26
1657390357277,MATH 20B,A01,083756,Briones; Jor-el Thomas Caparas,4,0,36,32
1657390357277,MATH 20B,A02,083757,Briones; Jor-el Thomas Caparas,1,0,36,35
1657390357277,MATH 20B,A03,093475,Briones; Jor-el Thomas Caparas,2,0,36,34
1657390363306,MATH 20C,A01,083760,Briones; Jor-el Thomas Caparas,1,0,35,34
1657390363306,MATH 20C,A02,083761,Briones; Jor-el Thomas Caparas,8,0,35,27
1657390363306,MATH 20C,A03,093476,Briones; Jor-el Thomas Caparas,0,1,36,36
1657390363306,MATH 20C,B01,083762,Bach; Quang Tran,1,0,30,29
1657390369328,MATH 20D,A01,083765,Tran; Brian Kha,5,0,30,25
1657390369328,MATH 20D,A02,083766,Tran; Brian Kha,5,0,30,25
1657390369328,MATH 20D,A03,083767,Tran; Brian Kha,5,0,30,25
1657390375353,MATH 20E,A01,083771,Ganguly; Soumya,9,0,32,23
1657390375353,MATH 20E,A02,083772,Ganguly; Soumya,6,0,32,26
1657390375353,MATH 20E,B01,083773,Ciotti; Benjamin,20,0,35,15
1657390375353,MATH 20E,B02,083774,Ciotti; Benjamin,17,0,35,18
1657390381376,MATH 103A,A01,083777,Greenfeld; Be'Eri,3,0,36,33
1657390381376,MATH 103A,A02,083778,Greenfeld; Be'Eri,5,0,36,31
1657390381376,MATH 103A,A03,093561,Greenfeld; Be'Eri,5,0,36,31
1657390381376,MATH 103A,B01,083779,Greenfeld; Be'Eri,7,0,36,29
1657390381376,MATH 103A,B02,083780,Greenfeld; Be'Eri,4,0,36,32
1657390381376,MATH 103A,B03,093562,Greenfeld; Be'Eri,3,0,36,33
1657390387399,MATH 105,A01,085443,Carter; Anne Toulson,15,0,35,20
1657390387399,MATH 105,A02,093477,Carter; Anne Toulson,20,0,35,15
1657390393424,MATH 109,A01,083213,Ganzberger; Geoffrey Michael,2,0,34,32
1657390393424,MATH 109,A02,083214,Ganzberger; Geoffrey Michael,4,0,34,30
1657390393424,MATH 109,A03,093478,Ganzberger; Geoffrey Michael,2,0,34,32
1657390393424,MATH 109,B01,083215,Ganzberger; Geoffrey Michael,1,0,32,31
1657390393424,MATH 109,B02,083216,Ganzberger; Geoffrey Michael,2,0,32,30
1657390393424,MATH 109,B03,093479,Ganzberger; Geoffrey Michael,8,0,32,24
1657390399451,MATH 142A,A01,083219,Chow; Bennett,7,0,32,25
1657390399451,MATH 142A,A02,083220,Chow; Bennett,10,0,32,22
1657390399451,MATH 142A,A03,093480,Chow; Bennett,8,0,32,24
1657390399451,MATH 142A,B03,093481,Chow; Bennett,8,0,32,24
1657390399451,MATH 142A,B04,093558,Chow; Bennett,13,0,32,19
1657390399451,MATH 142A,B05,093559,Chow; Bennett,6,0,32,26
1657390405568,MATH 193A,A01,083224,Rotar; Vladimir,8,0,34,26
1657390405568,MATH 193A,A02,083225,Rotar; Vladimir,9,0,34,25
1657390405568,MATH 193A,A03,083781,Rotar; Vladimir,5,0,34,29
1657390405568,MATH 193A,A04,083782,Rotar; Vladimir,10,0,34,24
1657390405568,MATH 193A,A05,093482,Rotar; Vladimir,10,0,34,24
1657390411599,MATH 197,001,091859,McAuley; Julian John,9999,0,9999,0
1657390411599,MATH 197,002,095566,Kedlaya; Kiran S.,9997,0,9999,2
1657390411599,MATH 197,003,095567,Xiao; Ming,9999,0,9999,0
1657390411599,MATH 197,004,095571,Perols; Johan Lars,9998,0,9999,1
1657390418653,COGS 9,A01,083615,Shannon; Kyle Michael,9,0,75,66
1657390424680,COGS 11,A01,083617,Boyle; Mary E. T.,22,0,48,26
1657390430707,COGS 13,A01,083071,Bastos; Amalia Pinkusfeld,11,0,71,60
1657390436729,COGS 14A,A01,092681,Semenuks; Arturs,4,1,100,96
1657390442761,COGS 14B,A01,083073,Cheng; Tzu-Han,6,0,63,57
1657390448788,COGS 17,A01,092677,Semenuks; Arturs,6,0,81,75
1657390454809,COGS 100,A01,083619,Allen; Michael Gordon,17,0,70,53
1657390460833,COGS 101A,A01,083621,Davis; Joshua Daniel,9,0,68,59
1657390466864,COGS 101B,A01,091572,Allen; Michael Gordon,11,0,65,54
1657390472891,COGS 101C,A01,083625,Delgado; Tania,17,0,35,18
1657390478914,COGS 107A,A01,083627,Boyle; Mary E. T.,13,0,60,47
1657390484941,COGS 118A,A01,083075,Gupta; Anjum,20,0,76,56
1657390490969,CSE 3,A50,083646,Miranda; Gregory Joseph,24,0,50,26
1657390496991,CSE 8A,A50,083650,Miranda; Gregory Joseph,17,1,56,39
1657390503016,CSE 11,A01,083080,Cao; Yingjun,6,15,40,34
1657390509043,CSE 12,A01,083652,Krause-Levy; Sophia Louisa,28,1,120,92
1657390515066,CSE 15L,A01,083654,Morris; Justin Loren,9,0,50,41
1657390515066,CSE 15L,A02,083655,Morris; Justin Loren,9,0,50,41
1657390521093,CSE 20,A01,083657,Tran; Khoa Dang,39,0,80,41
1657390527127,CSE 21,A01,095574,Bach; Quang Tran,22,0,48,26
1657390533150,CSE 30,A01,083084,Eldon; John,4,0,80,76
1657390533150,CSE 30,B01,095061,Bhaskar; Nishant,9,0,50,41
1657390539178,CSE 100,A01,083659,Cao; Yingjun,5,4,70,65
1657390545205,CSE 134B,A01,083661,Powell; Thomas Allan,22,0,100,78
1657390551228,CSE 140,A01,083663,Gungor; Onat,14,0,85,71
1657390557252,CSE 140L,A01,083088,Eldon; John,21,0,100,79
1657390563276,CSE 175,A01,083665,Kumar; Rakesh,3,0,25,22
1657390569300,CSE 190,A00,092507,Dubnov; Shlomo,7,0,20,13
1657390575328,ECE 45,A01,083139,Congero; Spencer William,6,0,75,69
1657390581355,ECE 65,A50,083695,Saad; Andrew S,12,0,30,18
1657390581355,ECE 65,A51,095125,Saad; Andrew S,24,0,26,2
1657390587379,ECE 109,A01,091882,Touri; Behrouz,19,0,70,51
1657390593403,ECE 180,A00,083140,Abi Samra; Nicholas Camill,1,0,30,29
1657390593403,ECE 180,B00,083141,Abi Samra; Nicholas Camill,0,0,30,30
1657390599430,MATH 10A,A01,083735,Patchell; Gregory David,2,0,30,28
1657390599430,MATH 10A,A02,083736,Patchell; Gregory David,20,0,30,10
1657390599430,MATH 10A,A03,083737,Patchell; Gregory David,16,0,30,14
1657390605460,MATH 10B,A01,083207,Lim; Seonhee,8,0,34,26
1657390605460,MATH 10B,A02,083208,Lim; Seonhee,9,0,35,26
1657390605460,MATH 10B,A03,093472,Lim; Seonhee,7,0,34,27
1657390605460,MATH 10B,B01,083739,Sinha; Shubham,12,0,30,18
1657390611492,MATH 18,A01,083743,Cinel; Cameron Alexander,7,0,30,23
1657390611492,MATH 18,A02,083744,Cinel; Cameron Alexander,17,0,30,13
1657390611492,MATH 18,A03,083745,Cinel; Cameron Alexander,9,0,30,21
1657390611492,MATH 18,B01,083748,Rideout; David Porter,5,0,37,32
1657390611492,MATH 18,B02,083749,Rideout; David Porter,5,0,36,31
1657390611492,MATH 18,B03,083750,Rideout; David Porter,3,0,37,34
1657390611492,MATH 18,B04,083751,Rideout; David Porter,6,0,36,30
1657390611492,MATH 18,B05,093473,Rideout; David Porter,6,0,36,30
1657390611492,MATH 18,B06,093474,Rideout; David Porter,6,0,36,30
1657390617518,MATH 20A,A01,083754,Zheng; Zequn,14,0,40,26
1657390623541,MATH 20B,A01,083756,Briones; Jor-el Thomas Caparas,4,0,36,32
1657390623541,MATH 20B,A02,083757,Briones; Jor-el Thomas Caparas,1,0,36,35
1657390623541,MATH 20B,A03,093475,Briones; Jor-el Thomas Caparas,2,0,36,34
1657390629568,MATH 20C,A01,083760,Briones; Jor-el Thomas Caparas,1,0,35,34
1657390629568,MATH 20C,A02,083761,Briones; Jor-el Thomas Caparas,8,0,35,27
1657390629568,MATH 20C,A03,093476,Briones; Jor-el Thomas Caparas,0,1,36,36
1657390629568,MATH 20C,B01,083762,Bach; Quang Tran,1,0,30,29
1657390635591,MATH 20D,A01,083765,Tran; Brian Kha,5,0,30,25
1657390635591,MATH 20D,A02,083766,Tran; Brian Kha,5,0,30,25
1657390635591,MATH 20D,A03,083767,Tran; Brian Kha,5,0,30,25
1657390641617,MATH 20E,A01,083771,Ganguly; Soumya,9,0,32,23
1657390641617,MATH 20E,A02,083772,Ganguly; Soumya,6,0,32,26
1657390641617,MATH 20E,B01,083773,Ciotti; Benjamin,20,0,35,15
1657390641617,MATH 20E,B02,083774,Ciotti; Benjamin,17,0,35,18
1657390647667,MATH 103A,A01,083777,Greenfeld; Be'Eri,3,0,36,33
1657390647667,MATH 103A,A02,083778,Greenfeld; Be'Eri,5,0,36,31
1657390647667,MATH 103A,A03,093561,Greenfeld; Be'Eri,5,0,36,31
1657390647667,MATH 103A,B01,083779,Greenfeld; Be'Eri,7,0,36,29
1657390647667,MATH 103A,B02,083780,Greenfeld; Be'Eri,4,0,36,32
1657390647667,MATH 103A,B03,093562,Greenfeld; Be'Eri,3,0,36,33
1657390653693,MATH 105,A01,085443,Carter; Anne Toulson,15,0,35,20
1657390653693,MATH 105,A02,093477,Carter; Anne Toulson,20,0,35,15
1657390659723,MATH 109,A01,083213,Ganzberger; Geoffrey Michael,2,0,34,32
1657390659723,MATH 109,A02,083214,Ganzberger; Geoffrey Michael,4,0,34,30
1657390659723,MATH 109,A03,093478,Ganzberger; Geoffrey Michael,2,0,34,32
1657390659723,MATH 109,B01,083215,Ganzberger; Geoffrey Michael,1,0,32,31
1657390659723,MATH 109,B02,083216,Ganzberger; Geoffrey Michael,2,0,32,30
1657390659723,MATH 109,B03,093479,Ganzberger; Geoffrey Michael,8,0,32,24
1657390665747,MATH 142A,A01,083219,Chow; Bennett,7,0,32,25
1657390665747,MATH 142A,A02,083220,Chow; Bennett,10,0,32,22
1657390665747,MATH 142A,A03,093480,Chow; Bennett,8,0,32,24
1657390665747,MATH 142A,B03,093481,Chow; Bennett,8,0,32,24
1657390665747,MATH 142A,B04,093558,Chow; Bennett,13,0,32,19
1657390665747,MATH 142A,B05,093559,Chow; Bennett,6,0,32,26
1657390671770,MATH 193A,A01,083224,Rotar; Vladimir,8,0,34,26
1657390671770,MATH 193A,A02,083225,Rotar; Vladimir,9,0,34,25
1657390671770,MATH 193A,A03,083781,Rotar; Vladimir,5,0,34,29
1657390671770,MATH 193A,A04,083782,Rotar; Vladimir,10,0,34,24
1657390671770,MATH 193A,A05,093482,Rotar; Vladimir,10,0,34,24
1657390677794,MATH 197,001,091859,McAuley; Julian John,9999,0,9999,0
1657390677794,MATH 197,002,095566,Kedlaya; Kiran S.,9997,0,9999,2
1657390677794,MATH 197,003,095567,Xiao; Ming,9999,0,9999,0
1657390677794,MATH 197,004,095571,Perols; Johan Lars,9998,0,9999,1
1657390684844,COGS 9,A01,083615,Shannon; Kyle Michael,9,0,75,66
1657390690868,COGS 11,A01,083617,Boyle; Mary E. T.,22,0,48,26
1657390696892,COGS 13,A01,083071,Bastos; Amalia Pinkusfeld,11,0,71,60
1657390702918,COGS 14A,A01,092681,Semenuks; Arturs,4,1,100,96
1657390708945,COGS 14B,A01,083073,Cheng; Tzu-Han,6,0,63,57
1657390714972,COGS 17,A01,092677,Semenuks; Arturs,6,0,81,75
1657390720994,COGS 100,A01,083619,Allen; Michael Gordon,17,0,70,53
1657390727021,COGS 101A,A01,083621,Davis; Joshua Daniel,9,0,68,59
1657390733045,COGS 101B,A01,091572,Allen; Michael Gordon,11,0,65,54
1657390739071,COGS 101C,A01,083625,Delgado; Tania,17,0,35,18
1657390745095,COGS 107A,A01,083627,Boyle; Mary E. T.,13,0,60,47
1657390751121,COGS 118A,A01,083075,Gupta; Anjum,20,0,76,56
1657390757144,CSE 3,A50,083646,Miranda; Gregory Joseph,24,0,50,26
1657390763172,CSE 8A,A50,083650,Miranda; Gregory Joseph,17,1,56,39
1657390769194,CSE 11,A01,083080,Cao; Yingjun,6,15,40,34
1657390775221,CSE 12,A01,083652,Krause-Levy; Sophia Louisa,28,1,120,92
1657390781246,CSE 15L,A01,083654,Morris; Justin Loren,9,0,50,41
1657390781246,CSE 15L,A02,083655,Morris; Justin Loren,9,0,50,41
1657390787279,CSE 20,A01,083657,Tran; Khoa Dang,39,0,80,41
1657390793305,CSE 21,A01,095574,Bach; Quang Tran,22,0,48,26
1657390799328,CSE 30,A01,083084,Eldon; John,4,0,80,76
1657390799328,CSE 30,B01,095061,Bhaskar; Nishant,9,0,50,41
1657390805356,CSE 100,A01,083659,Cao; Yingjun,5,4,70,65
1657390811380,CSE 134B,A01,083661,Powell; Thomas Allan,22,0,100,78
1657390817407,CSE 140,A01,083663,Gungor; Onat,14,0,85,71
1657390823431,CSE 140L,A01,083088,Eldon; John,21,0,100,79
1657390829455,CSE 175,A01,083665,Kumar; Rakesh,3,0,25,22
1657390835477,CSE 190,A00,092507,Dubnov; Shlomo,7,0,20,13
1657390841502,ECE 45,A01,083139,Congero; Spencer William,6,0,75,69
1657390847535,ECE 65,A50,083695,Saad; Andrew S,12,0,30,18
1657390847535,ECE 65,A51,095125,Saad; Andrew S,24,0,26,2
1657390853561,ECE 109,A01,091882,Touri; Behrouz,19,0,70,51
1657390859588,ECE 180,A00,083140,Abi Samra; Nicholas Camill,1,0,30,29
1657390859588,ECE 180,B00,083141,Abi Samra; Nicholas Camill,0,0,30,30
1657390865616,MATH 10A,A01,083735,Patchell; Gregory David,2,0,30,28
1657390865616,MATH 10A,A02,083736,Patchell; Gregory David,20,0,30,10
1657390865616,MATH 10A,A03,083737,Patchell; Gregory David,16,0,30,14
1657390871646,MATH 10B,A01,083207,Lim; Seonhee,8,0,34,26
1657390871646,MATH 10B,A02,083208,Lim; Seonhee,9,0,35,26
1657390871646,MATH 10B,A03,093472,Lim; Seonhee,7,0,34,27
1657390871646,MATH 10B,B01,083739,Sinha; Shubham,12,0,30,18
1657390877678,MATH 18,A01,083743,Cinel; Cameron Alexander,7,0,30,23
1657390877678,MATH 18,A02,083744,Cinel; Cameron Alexander,17,0,30,13
1657390877678,MATH 18,A03,083745,Cinel; Cameron Alexander,9,0,30,21
1657390877678,MATH 18,B01,083748,Rideout; David Porter,5,0,37,32
1657390877678,MATH 18,B02,083749,Rideout; David Porter,5,0,36,31
1657390877678,MATH 18,B03,083750,Rideout; David Porter,3,0,37,34
1657390877678,MATH 18,B04,083751,Rideout; David Porter,6,0,36,30
1657390877678,MATH 18,B05,093473,Rideout; David Porter,6,0,36,30
1657390877678,MATH 18,B06,093474,Rideout; David Porter,6,0,36,30
1657390883736,MATH 20A,A01,083754,Zheng; Zequn,14,0,40,26
1657390893637,MATH 20B,A01,083756,Briones; Jor-el Thomas Caparas,4,0,36,32
1657390893637,MATH 20B,A02,083757,Briones; Jor-el Thomas Caparas,1,0,36,35
1657390893637,MATH 20B,A03,093475,Briones; Jor-el Thomas Caparas,2,0,36,34
1657390899664,MATH 20C,A01,083760,Briones; Jor-el Thomas Caparas,1,0,35,34
1657390899664,MATH 20C,A02,083761,Briones; Jor-el Thomas Caparas,8,0,35,27
1657390899664,MATH 20C,A03,093476,Briones; Jor-el Thomas Caparas,0,1,36,36
1657390899664,MATH 20C,B01,083762,Bach; Quang Tran,1,0,30,29
1657390905692,MATH 20D,A01,083765,Tran; Brian Kha,5,0,30,25
1657390905692,MATH 20D,A02,083766,Tran; Brian Kha,5,0,30,25
1657390905692,MATH 20D,A03,083767,Tran; Brian Kha,5,0,30,25
1657390911728,MATH 20E,A01,083771,Ganguly; Soumya,9,0,32,23
1657390911728,MATH 20E,A02,083772,Ganguly; Soumya,6,0,32,26
1657390911728,MATH 20E,B01,083773,Ciotti; Benjamin,20,0,35,15
1657390911728,MATH 20E,B02,083774,Ciotti; Benjamin,17,0,35,18
1657390917762,MATH 103A,A01,083777,Greenfeld; Be'Eri,3,0,36,33
1657390917762,MATH 103A,A02,083778,Greenfeld; Be'Eri,5,0,36,31
1657390917762,MATH 103A,A03,093561,Greenfeld; Be'Eri,5,0,36,31
1657390917762,MATH 103A,B01,083779,Greenfeld; Be'Eri,7,0,36,29
1657390917762,MATH 103A,B02,083780,Greenfeld; Be'Eri,4,0,36,32
1657390917762,MATH 103A,B03,093562,Greenfeld; Be'Eri,3,0,36,33
1657390923789,MATH 105,A01,085443,Carter; Anne Toulson,15,0,35,20
1657390923789,MATH 105,A02,093477,Carter; Anne Toulson,20,0,35,15
1657390929813,MATH 109,A01,083213,Ganzberger; Geoffrey Michael,2,0,34,32
1657390929813,MATH 109,A02,083214,Ganzberger; Geoffrey Michael,4,0,34,30
1657390929813,MATH 109,A03,093478,Ganzberger; Geoffrey Michael,2,0,34,32
1657390929813,MATH 109,B01,083215,Ganzberger; Geoffrey Michael,1,0,32,31
1657390929813,MATH 109,B02,083216,Ganzberger; Geoffrey Michael,2,0,32,30
1657390929813,MATH 109,B03,093479,Ganzberger; Geoffrey Michael,8,0,32,24
1657390935844,MATH 142A,A01,083219,Chow; Bennett,7,0,32,25
1657390935844,MATH 142A,A02,083220,Chow; Bennett,10,0,32,22
1657390935844,MATH 142A,A03,093480,Chow; Bennett,8,0,32,24
1657390935844,MATH 142A,B03,093481,Chow; Bennett,8,0,32,24
1657390935844,MATH 142A,B04,093558,Chow; Bennett,13,0,32,19
1657390935844,MATH 142A,B05,093559,Chow; Bennett,6,0,32,26
1657390941869,MATH 193A,A01,083224,Rotar; Vladimir,8,0,34,26
1657390941869,MATH 193A,A02,083225,Rotar; Vladimir,9,0,34,25
1657390941869,MATH 193A,A03,083781,Rotar; Vladimir,5,0,34,29
1657390941869,MATH 193A,A04,083782,Rotar; Vladimir,10,0,34,24
1657390941869,MATH 193A,A05,093482,Rotar; Vladimir,10,0,34,24
1657390947894,MATH 197,001,091859,McAuley; Julian John,9999,0,9999,0
1657390947894,MATH 197,002,095566,Kedlaya; Kiran S.,9997,0,9999,2
1657390947894,MATH 197,003,095567,Xiao; Ming,9999,0,9999,0
1657390947894,MATH 197,004,095571,Perols; Johan Lars,9998,0,9999,1
1657390954955,COGS 9,A01,083615,Shannon; Kyle Michael,9,0,75,66
1657390960988,COGS 11,A01,083617,Boyle; Mary E. T.,22,0,48,26
1657390967018,COGS 13,A01,083071,Bastos; Amalia Pinkusfeld,11,0,71,60
1657390973042,COGS 14A,A01,092681,Semenuks; Arturs,4,1,100,96
1657390979075,COGS 14B,A01,083073,Cheng; Tzu-Han,6,0,63,57
1657390985102,COGS 17,A01,092677,Semenuks; Arturs,6,0,81,75
1657390991128,COGS 100,A01,083619,Allen; Michael Gordon,17,0,70,53
1657390997151,COGS 101A,A01,083621,Davis; Joshua Daniel,9,0,68,59
1657391003249,COGS 101B,A01,091572,Allen; Michael Gordon,11,0,65,54
1657391009274,COGS 101C,A01,083625,Delgado; Tania,17,0,35,18
1657391015300,COGS 107A,A01,083627,Boyle; Mary E. T.,13,0,60,47
1657391021324,COGS 118A,A01,083075,Gupta; Anjum,20,0,76,56
1657391027366,CSE 3,A50,083646,Miranda; Gregory Joseph,24,0,50,26
1657391033423,CSE 8A,A50,083650,Miranda; Gregory Joseph,17,1,56,39
1657391039447,CSE 11,A01,083080,Cao; Yingjun,6,15,40,34
1657391045470,CSE 12,A01,083652,Krause-Levy; Sophia Louisa,28,1,120,92
1657391051501,CSE 15L,A01,083654,Morris; Justin Loren,9,0,50,41
1657391051501,CSE 15L,A02,083655,Morris; Justin Loren,9,0,50,41
1657391057530,CSE 20,A01,083657,Tran; Khoa Dang,39,0,80,41
1657391063559,CSE 21,A01,095574,Bach; Quang Tran,22,0,48,26
1657391069587,CSE 30,A01,083084,Eldon; John,4,0,80,76
1657391069587,CSE 30,B01,095061,Bhaskar; Nishant,9,0,50,41
1657391075610,CSE 100,A01,083659,Cao; Yingjun,5,4,70,65
1657391081632,CSE 134B,A01,083661,Powell; Thomas Allan,22,0,100,78
1657391087652,CSE 140,A01,083663,Gungor; Onat,14,0,85,71
1657391093675,CSE 140L,A01,083088,Eldon; John,21,0,100,79
1657391099708,CSE 175,A01,083665,Kumar; Rakesh,3,0,25,22
1657391105733,CSE 190,A00,092507,Dubnov; Shlomo,7,0,20,13
1657391111760,ECE 45,A01,083139,Congero; Spencer William,6,0,75,69
1657391117788,ECE 65,A50,083695,Saad; Andrew S,12,0,30,18
1657391117788,ECE 65,A51,095125,Saad; Andrew S,24,0,26,2
1657391123813,ECE 109,A01,091882,Touri; Behrouz,19,0,70,51
1657391129836,ECE 180,A00,083140,Abi Samra; Nicholas Camill,1,0,30,29
1657391129836,ECE 180,B00,083141,Abi Samra; Nicholas Camill,0,0,30,30
1657391135859,MATH 10A,A01,083735,Patchell; Gregory David,2,0,30,28
1657391135859,MATH 10A,A02,083736,Patchell; Gregory David,20,0,30,10
1657391135859,MATH 10A,A03,083737,Patchell; Gregory David,16,0,30,14
1657391141881,MATH 10B,A01,083207,Lim; Seonhee,8,0,34,26
1657391141881,MATH 10B,A02,083208,Lim; Seonhee,9,0,35,26
1657391141881,MATH 10B,A03,093472,Lim; Seonhee,7,0,34,27
1657391141881,MATH 10B,B01,083739,Sinha; Shubham,12,0,30,18
1657391147911,MATH 18,A01,083743,Cinel; Cameron Alexander,7,0,30,23
1657391147911,MATH 18,A02,083744,Cinel; Cameron Alexander,17,0,30,13
1657391147911,MATH 18,A03,083745,Cinel; Cameron Alexander,9,0,30,21
1657391147911,MATH 18,B01,083748,Rideout; David Porter,5,0,37,32
1657391147911,MATH 18,B02,083749,Rideout; David Porter,5,0,36,31
1657391147911,MATH 18,B03,083750,Rideout; David Porter,3,0,37,34
1657391147911,MATH 18,B04,083751,Rideout; David Porter,6,0,36,30
1657391147911,MATH 18,B05,093473,Rideout; David Porter,6,0,36,30
1657391147911,MATH 18,B06,093474,Rideout; David Porter,6,0,36,30
1657391153933,MATH 20A,A01,083754,Zheng; Zequn,14,0,40,26
1657391159956,MATH 20B,A01,083756,Briones; Jor-el Thomas Caparas,4,0,36,32
1657391159956,MATH 20B,A02,083757,Briones; Jor-el Thomas Caparas,1,0,36,35
1657391159956,MATH 20B,A03,093475,Briones; Jor-el Thomas Caparas,2,0,36,34
1657391165978,MATH 20C,A01,083760,Briones; Jor-el Thomas Caparas,1,0,35,34
1657391165978,MATH 20C,A02,083761,Briones; Jor-el Thomas Caparas,8,0,35,27
1657391165978,MATH 20C,A03,093476,Briones; Jor-el Thomas Caparas,0,1,36,36
1657391165978,MATH 20C,B01,083762,Bach; Quang Tran,1,0,30,29
1657391172002,MATH 20D,A01,083765,Tran; Brian Kha,5,0,30,25
1657391172002,MATH 20D,A02,083766,Tran; Brian Kha,5,0,30,25
1657391172002,MATH 20D,A03,083767,Tran; Brian Kha,5,0,30,25
1657391178030,MATH 20E,A01,083771,Ganguly; Soumya,9,0,32,23
1657391178030,MATH 20E,A02,083772,Ganguly; Soumya,6,0,32,26
1657391178030,MATH 20E,B01,083773,Ciotti; Benjamin,20,0,35,15
1657391178030,MATH 20E,B02,083774,Ciotti; Benjamin,17,0,35,18
1657391184054,MATH 103A,A01,083777,Greenfeld; Be'Eri,3,0,36,33
1657391184054,MATH 103A,A02,083778,Greenfeld; Be'Eri,5,0,36,31
1657391184054,MATH 103A,A03,093561,Greenfeld; Be'Eri,5,0,36,31
1657391184054,MATH 103A,B01,083779,Greenfeld; Be'Eri,7,0,36,29
1657391184054,MATH 103A,B02,083780,Greenfeld; Be'Eri,4,0,36,32
1657391184054,MATH 103A,B03,093562,Greenfeld; Be'Eri,3,0,36,33
1657391190082,MATH 105,A01,085443,Carter; Anne Toulson,15,0,35,20
1657391190082,MATH 105,A02,093477,Carter; Anne Toulson,20,0,35,15
1657391196107,MATH 109,A01,083213,Ganzberger; Geoffrey Michael,2,0,34,32
1657391196107,MATH 109,A02,083214,Ganzberger; Geoffrey Michael,4,0,34,30
1657391196107,MATH 109,A03,093478,Ganzberger; Geoffrey Michael,2,0,34,32
1657391196107,MATH 109,B01,083215,Ganzberger; Geoffrey Michael,1,0,32,31
1657391196107,MATH 109,B02,083216,Ganzberger; Geoffrey Michael,2,0,32,30
1657391196107,MATH 109,B03,093479,Ganzberger; Geoffrey Michael,8,0,32,24
1657391202132,MATH 142A,A01,083219,Chow; Bennett,7,0,32,25
1657391202132,MATH 142A,A02,083220,Chow; Bennett,10,0,32,22
1657391202132,MATH 142A,A03,093480,Chow; Bennett,8,0,32,24
1657391202132,MATH 142A,B03,093481,Chow; Bennett,8,0,32,24
1657391202132,MATH 142A,B04,093558,Chow; Bennett,13,0,32,19
1657391202132,MATH 142A,B05,093559,Chow; Bennett,6,0,32,26
1657391208158,MATH 193A,A01,083224,Rotar; Vladimir,8,0,34,26
1657391208158,MATH 193A,A02,083225,Rotar; Vladimir,9,0,34,25
1657391208158,MATH 193A,A03,083781,Rotar; Vladimir,5,0,34,29
1657391208158,MATH 193A,A04,083782,Rotar; Vladimir,10,0,34,24
1657391208158,MATH 193A,A05,093482,Rotar; Vladimir,10,0,34,24
1657391214204,MATH 197,001,091859,McAuley; Julian John,9999,0,9999,0
1657391214204,MATH 197,002,095566,Kedlaya; Kiran S.,9997,0,9999,2
1657391214204,MATH 197,003,095567,Xiao; Ming,9999,0,9999,0
1657391214204,MATH 197,004,095571,Perols; Johan Lars,9998,0,9999,1
1657391221269,COGS 9,A01,083615,Shannon; Kyle Michael,9,0,75,66
1657391227292,COGS 11,A01,083617,Boyle; Mary E. T.,22,0,48,26
1657391233316,COGS 13,A01,083071,Bastos; Amalia Pinkusfeld,11,0,71,60
1657391239343,COGS 14A,A01,092681,Semenuks; Arturs,4,1,100,96
1657391245366,COGS 14B,A01,083073,Cheng; Tzu-Han,6,0,63,57
1657391251393,COGS 17,A01,092677,Semenuks; Arturs,6,0,81,75
1657391257415,COGS 100,A01,083619,Allen; Michael Gordon,17,0,70,53
1657391263439,COGS 101A,A01,083621,Davis; Joshua Daniel,9,0,68,59
1657391269465,COGS 101B,A01,091572,Allen; Michael Gordon,11,0,65,54
1657391275492,COGS 101C,A01,083625,Delgado; Tania,17,0,35,18
1657391281515,COGS 107A,A01,083627,Boyle; Mary E. T.,13,0,60,47
1657391287539,COGS 118A,A01,083075,Gupta; Anjum,20,0,76,56
1657391293561,CSE 3,A50,083646,Miranda; Gregory Joseph,24,0,50,26
1657391299583,CSE 8A,A50,083650,Miranda; Gregory Joseph,17,1,56,39
1657391305606,CSE 11,A01,083080,Cao; Yingjun,6,15,40,34
1657391311632,CSE 12,A01,083652,Krause-Levy; Sophia Louisa,28,1,120,92
1657391317660,CSE 15L,A01,083654,Morris; Justin Loren,9,0,50,41
1657391317660,CSE 15L,A02,083655,Morris; Justin Loren,9,0,50,41
1657391323686,CSE 20,A01,083657,Tran; Khoa Dang,39,0,80,41
1657391329711,CSE 21,A01,095574,Bach; Quang Tran,22,0,48,26
1657391335737,CSE 30,A01,083084,Eldon; John,4,0,80,76
1657391335737,CSE 30,B01,095061,Bhaskar; Nishant,9,0,50,41
1657391341759,CSE 100,A01,083659,Cao; Yingjun,5,4,70,65
1657391347781,CSE 134B,A01,083661,Powell; Thomas Allan,22,0,100,78
1657391353803,CSE 140,A01,083663,Gungor; Onat,14,0,85,71
1657391359830,CSE 140L,A01,083088,Eldon; John,21,0,100,79
1657391365853,CSE 175,A01,083665,Kumar; Rakesh,3,0,25,22
1657391371876,CSE 190,A00,092507,Dubnov; Shlomo,7,0,20,13
1657391377904,ECE 45,A01,083139,Congero; Spencer William,6,0,75,69
1657391383928,ECE 65,A50,083695,Saad; Andrew S,12,0,30,18
1657391383928,ECE 65,A51,095125,Saad; Andrew S,24,0,26,2
1657391389949,ECE 109,A01,091882,Touri; Behrouz,19,0,70,51
1657391395973,ECE 180,A00,083140,Abi Samra; Nicholas Camill,1,0,30,29
1657391395973,ECE 180,B00,083141,Abi Samra; Nicholas Camill,0,0,30,30
1657391402001,MATH 10A,A01,083735,Patchell; Gregory David,2,0,30,28
1657391402001,MATH 10A,A02,083736,Patchell; Gregory David,20,0,30,10
1657391402001,MATH 10A,A03,083737,Patchell; Gregory David,16,0,30,14
1657391408024,MATH 10B,A01,083207,Lim; Seonhee,8,0,34,26
1657391408024,MATH 10B,A02,083208,Lim; Seonhee,9,0,35,26
1657391408024,MATH 10B,A03,093472,Lim; Seonhee,7,0,34,27
1657391408024,MATH 10B,B01,083739,Sinha; Shubham,12,0,30,18
1657391414048,MATH 18,A01,083743,Cinel; Cameron Alexander,7,0,30,23
1657391414048,MATH 18,A02,083744,Cinel; Cameron Alexander,17,0,30,13
1657391414048,MATH 18,A03,083745,Cinel; Cameron Alexander,9,0,30,21
1657391414048,MATH 18,B01,083748,Rideout; David Porter,5,0,37,32
1657391414048,MATH 18,B02,083749,Rideout; David Porter,5,0,36,31
1657391414048,MATH 18,B03,083750,Rideout; David Porter,3,0,37,34
1657391414048,MATH 18,B04,083751,Rideout; David Porter,6,0,36,30
1657391414048,MATH 18,B05,093473,Rideout; David Porter,6,0,36,30
1657391414048,MATH 18,B06,093474,Rideout; David Porter,6,0,36,30
1657391420072,MATH 20A,A01,083754,Zheng; Zequn,14,0,40,26
1657391426096,MATH 20B,A01,083756,Briones; Jor-el Thomas Caparas,4,0,36,32
1657391426096,MATH 20B,A02,083757,Briones; Jor-el Thomas Caparas,1,0,36,35
1657391426096,MATH 20B,A03,093475,Briones; Jor-el Thomas Caparas,2,0,36,34
1657391432124,MATH 20C,A01,083760,Briones; Jor-el Thomas Caparas,1,0,35,34
1657391432124,MATH 20C,A02,083761,Briones; Jor-el Thomas Caparas,8,0,35,27
1657391432124,MATH 20C,A03,093476,Briones; Jor-el Thomas Caparas,0,1,36,36
1657391432124,MATH 20C,B01,083762,Bach; Quang Tran,1,0,30,29
1657391438148,MATH 20D,A01,083765,Tran; Brian Kha,5,0,30,25
1657391438148,MATH 20D,A02,083766,Tran; Brian Kha,5,0,30,25
1657391438148,MATH 20D,A03,083767,Tran; Brian Kha,5,0,30,25
1657391444173,MATH 20E,A01,083771,Ganguly; Soumya,9,0,32,23
1657391444173,MATH 20E,A02,083772,Ganguly; Soumya,6,0,32,26
1657391444173,MATH 20E,B01,083773,Ciotti; Benjamin,20,0,35,15
1657391444173,MATH 20E,B02,083774,Ciotti; Benjamin,17,0,35,18
1657391450210,MATH 103A,A01,083777,Greenfeld; Be'Eri,3,0,36,33
1657391450210,MATH 103A,A02,083778,Greenfeld; Be'Eri,5,0,36,31
1657391450210,MATH 103A,A03,093561,Greenfeld; Be'Eri,5,0,36,31
1657391450210,MATH 103A,B01,083779,Greenfeld; Be'Eri,7,0,36,29
1657391450210,MATH 103A,B02,083780,Greenfeld; Be'Eri,4,0,36,32
1657391450210,MATH 103A,B03,093562,Greenfeld; Be'Eri,3,0,36,33
1657391456234,MATH 105,A01,085443,Carter; Anne Toulson,15,0,35,20
1657391456234,MATH 105,A02,093477,Carter; Anne Toulson,20,0,35,15
1657391462256,MATH 109,A01,083213,Ganzberger; Geoffrey Michael,2,0,34,32
1657391462256,MATH 109,A02,083214,Ganzberger; Geoffrey Michael,4,0,34,30
1657391462256,MATH 109,A03,093478,Ganzberger; Geoffrey Michael,2,0,34,32
1657391462256,MATH 109,B01,083215,Ganzberger; Geoffrey Michael,1,0,32,31
1657391462256,MATH 109,B02,083216,Ganzberger; Geoffrey Michael,2,0,32,30
1657391462256,MATH 109,B03,093479,Ganzberger; Geoffrey Michael,8,0,32,24
1657391468284,MATH 142A,A01,083219,Chow; Bennett,7,0,32,25
1657391468284,MATH 142A,A02,083220,Chow; Bennett,10,0,32,22
1657391468284,MATH 142A,A03,093480,Chow; Bennett,8,0,32,24
1657391468284,MATH 142A,B03,093481,Chow; Bennett,8,0,32,24
1657391468284,MATH 142A,B04,093558,Chow; Bennett,13,0,32,19
1657391468284,MATH 142A,B05,093559,Chow; Bennett,6,0,32,26
1657391474313,MATH 193A,A01,083224,Rotar; Vladimir,8,0,34,26
1657391474313,MATH 193A,A02,083225,Rotar; Vladimir,9,0,34,25
1657391474313,MATH 193A,A03,083781,Rotar; Vladimir,5,0,34,29
1657391474313,MATH 193A,A04,083782,Rotar; Vladimir,10,0,34,24
1657391474313,MATH 193A,A05,093482,Rotar; Vladimir,10,0,34,24
1657391480338,MATH 197,001,091859,McAuley; Julian John,9999,0,9999,0
1657391480338,MATH 197,002,095566,Kedlaya; Kiran S.,9997,0,9999,2
1657391480338,MATH 197,003,095567,Xiao; Ming,9999,0,9999,0
1657391480338,MATH 197,004,095571,Perols; Johan Lars,9998,0,9999,1
1657391487392,COGS 9,A01,083615,Shannon; Kyle Michael,9,0,75,66
1657391493417,COGS 11,A01,083617,Boyle; Mary E. T.,22,0,48,26
1657391499441,COGS 13,A01,083071,Bastos; Amalia Pinkusfeld,11,0,71,60
1657391505464,COGS 14A,A01,092681,Semenuks; Arturs,4,1,100,96
1657391511491,COGS 14B,A01,083073,Cheng; Tzu-Han,6,0,63,57
1657391517512,COGS 17,A01,092677,Semenuks; Arturs,6,0,81,75
1657391523535,COGS 100,A01,083619,Allen; Michael Gordon,17,0,70,53
1657391529560,COGS 101A,A01,083621,Davis; Joshua Daniel,9,0,68,59
1657391535583,COGS 101B,A01,091572,Allen; Michael Gordon,11,0,65,54
1657391541609,COGS 101C,A01,083625,Delgado; Tania,17,0,35,18
1657391547630,COGS 107A,A01,083627,Boyle; Mary E. T.,13,0,60,47
1657391553658,COGS 118A,A01,083075,Gupta; Anjum,20,0,76,56
1657391559689,CSE 3,A50,083646,Miranda; Gregory Joseph,24,0,50,26
1657391565719,CSE 8A,A50,083650,Miranda; Gregory Joseph,17,1,56,39
1657391571743,CSE 11,A01,083080,Cao; Yingjun,6,15,40,34
1657391577771,CSE 12,A01,083652,Krause-Levy; Sophia Louisa,28,1,120,92
1657391583794,CSE 15L,A01,083654,Morris; Justin Loren,9,0,50,41
1657391583794,CSE 15L,A02,083655,Morris; Justin Loren,9,0,50,41
1657391589818,CSE 20,A01,083657,Tran; Khoa Dang,39,0,80,41
1657391595861,CSE 21,A01,095574,Bach; Quang Tran,22,0,48,26
1657391601959,CSE 30,A01,083084,Eldon; John,4,0,80,76
1657391601959,CSE 30,B01,095061,Bhaskar; Nishant,9,0,50,41
1657391607984,CSE 100,A01,083659,Cao; Yingjun,5,4,70,65
1657391614008,CSE 134B,A01,083661,Powell; Thomas Allan,22,0,100,78
1657391620035,CSE 140,A01,083663,Gungor; Onat,14,0,85,71
1657391626066,CSE 140L,A01,083088,Eldon; John,21,0,100,79
1657391632093,CSE 175,A01,083665,Kumar; Rakesh,3,0,25,22
1657391638123,CSE 190,A00,092507,Dubnov; Shlomo,7,0,20,13
1657391644153,ECE 45,A01,083139,Congero; Spencer William,6,0,75,69
1657391650180,ECE 65,A50,083695,Saad; Andrew S,12,0,30,18
1657391650180,ECE 65,A51,095125,Saad; Andrew S,24,0,26,2
1657391656206,ECE 109,A01,091882,Touri; Behrouz,19,0,70,51
1657391662229,ECE 180,A00,083140,Abi Samra; Nicholas Camill,1,0,30,29
1657391662229,ECE 180,B00,083141,Abi Samra; Nicholas Camill,0,0,30,30
1657391668253,MATH 10A,A01,083735,Patchell; Gregory David,2,0,30,28
1657391668253,MATH 10A,A02,083736,Patchell; Gregory David,20,0,30,10
1657391668253,MATH 10A,A03,083737,Patchell; Gregory David,16,0,30,14
1657391674276,MATH 10B,A01,083207,Lim; Seonhee,8,0,34,26
1657391674276,MATH 10B,A02,083208,Lim; Seonhee,9,0,35,26
1657391674276,MATH 10B,A03,093472,Lim; Seonhee,7,0,34,27
1657391674276,MATH 10B,B01,083739,Sinha; Shubham,12,0,30,18
1657391680301,MATH 18,A01,083743,Cinel; Cameron Alexander,7,0,30,23
1657391680301,MATH 18,A02,083744,Cinel; Cameron Alexander,17,0,30,13
1657391680301,MATH 18,A03,083745,Cinel; Cameron Alexander,9,0,30,21
1657391680301,MATH 18,B01,083748,Rideout; David Porter,5,0,37,32
1657391680301,MATH 18,B02,083749,Rideout; David Porter,5,0,36,31
1657391680301,MATH 18,B03,083750,Rideout; David Porter,3,0,37,34
1657391680301,MATH 18,B04,083751,Rideout; David Porter,6,0,36,30
1657391680301,MATH 18,B05,093473,Rideout; David Porter,6,0,36,30
1657391680301,MATH 18,B06,093474,Rideout; David Porter,6,0,36,30
1657391686324,MATH 20A,A01,083754,Zheng; Zequn,14,0,40,26
1657391692350,MATH 20B,A01,083756,Briones; Jor-el Thomas Caparas,4,0,36,32
1657391692350,MATH 20B,A02,083757,Briones; Jor-el Thomas Caparas,1,0,36,35
1657391692350,MATH 20B,A03,093475,Briones; Jor-el Thomas Caparas,2,0,36,34
1657391698374,MATH 20C,A01,083760,Briones; Jor-el Thomas Caparas,1,0,35,34
1657391698374,MATH 20C,A02,083761,Briones; Jor-el Thomas Caparas,8,0,35,27
1657391698374,MATH 20C,A03,093476,Briones; Jor-el Thomas Caparas,0,1,36,36
1657391698374,MATH 20C,B01,083762,Bach; Quang Tran,1,0,30,29
1657391704403,MATH 20D,A01,083765,Tran; Brian Kha,5,0,30,25
1657391704403,MATH 20D,A02,083766,Tran; Brian Kha,5,0,30,25
1657391704403,MATH 20D,A03,083767,Tran; Brian Kha,5,0,30,25
1657391710428,MATH 20E,A01,083771,Ganguly; Soumya,9,0,32,23
1657391710428,MATH 20E,A02,083772,Ganguly; Soumya,6,0,32,26
1657391710428,MATH 20E,B01,083773,Ciotti; Benjamin,20,0,35,15
1657391710428,MATH 20E,B02,083774,Ciotti; Benjamin,17,0,35,18
1657391716459,MATH 103A,A01,083777,Greenfeld; Be'Eri,3,0,36,33
1657391716459,MATH 103A,A02,083778,Greenfeld; Be'Eri,5,0,36,31
1657391716459,MATH 103A,A03,093561,Greenfeld; Be'Eri,5,0,36,31
1657391716459,MATH 103A,B01,083779,Greenfeld; Be'Eri,7,0,36,29
1657391716459,MATH 103A,B02,083780,Greenfeld; Be'Eri,4,0,36,32
1657391716459,MATH 103A,B03,093562,Greenfeld; Be'Eri,3,0,36,33
1657391722483,MATH 105,A01,085443,Carter; Anne Toulson,15,0,35,20
1657391722483,MATH 105,A02,093477,Carter; Anne Toulson,20,0,35,15
1657391728507,MATH 109,A01,083213,Ganzberger; Geoffrey Michael,2,0,34,32
1657391728507,MATH 109,A02,083214,Ganzberger; Geoffrey Michael,4,0,34,30
1657391728507,MATH 109,A03,093478,Ganzberger; Geoffrey Michael,2,0,34,32
1657391728507,MATH 109,B01,083215,Ganzberger; Geoffrey Michael,1,0,32,31
1657391728507,MATH 109,B02,083216,Ganzberger; Geoffrey Michael,2,0,32,30
1657391728507,MATH 109,B03,093479,Ganzberger; Geoffrey Michael,8,0,32,24
1657391734550,MATH 142A,A01,083219,Chow; Bennett,7,0,32,25
1657391734550,MATH 142A,A02,083220,Chow; Bennett,10,0,32,22
1657391734550,MATH 142A,A03,093480,Chow; Bennett,8,0,32,24
1657391734550,MATH 142A,B03,093481,Chow; Bennett,8,0,32,24
1657391734550,MATH 142A,B04,093558,Chow; Bennett,13,0,32,19
1657391734550,MATH 142A,B05,093559,Chow; Bennett,6,0,32,26
1657391740572,MATH 193A,A01,083224,Rotar; Vladimir,8,0,34,26
1657391740572,MATH 193A,A02,083225,Rotar; Vladimir,9,0,34,25
1657391740572,MATH 193A,A03,083781,Rotar; Vladimir,5,0,34,29
1657391740572,MATH 193A,A04,083782,Rotar; Vladimir,10,0,34,24
1657391740572,MATH 193A,A05,093482,Rotar; Vladimir,10,0,34,24
1657391746598,MATH 197,001,091859,McAuley; Julian John,9999,0,9999,0
1657391746598,MATH 197,002,095566,Kedlaya; Kiran S.,9997,0,9999,2
1657391746598,MATH 197,003,095567,Xiao; Ming,9999,0,9999,0
1657391746598,MATH 197,004,095571,Perols; Johan Lars,9998,0,9999,1
1657391753665,COGS 9,A01,083615,Shannon; Kyle Michael,9,0,75,66
1657391759691,COGS 11,A01,083617,Boyle; Mary E. T.,22,0,48,26
1657391765720,COGS 13,A01,083071,Bastos; Amalia Pinkusfeld,11,0,71,60
1657391771743,COGS 14A,A01,092681,Semenuks; Arturs,4,1,100,96
1657391777765,COGS 14B,A01,083073,Cheng; Tzu-Han,6,0,63,57
1657391783789,COGS 17,A01,092677,Semenuks; Arturs,6,0,81,75
1657391789819,COGS 100,A01,083619,Allen; Michael Gordon,17,0,70,53
1657391795842,COGS 101A,A01,083621,Davis; Joshua Daniel,9,0,68,59
1657391801865,COGS 101B,A01,091572,Allen; Michael Gordon,11,0,65,54
1657391807891,COGS 101C,A01,083625,Delgado; Tania,17,0,35,18
1657391813919,COGS 107A,A01,083627,Boyle; Mary E. T.,13,0,60,47
1657391819943,COGS 118A,A01,083075,Gupta; Anjum,20,0,76,56
1657391825967,CSE 3,A50,083646,Miranda; Gregory Joseph,24,0,50,26
1657391831995,CSE 8A,A50,083650,Miranda; Gregory Joseph,17,1,56,39
1657391838018,CSE 11,A01,083080,Cao; Yingjun,6,15,40,34
1657391844046,CSE 12,A01,083652,Krause-Levy; Sophia Louisa,28,1,120,92
1657391850070,CSE 15L,A01,083654,Morris; Justin Loren,9,0,50,41
1657391850070,CSE 15L,A02,083655,Morris; Justin Loren,9,0,50,41
1657391856098,CSE 20,A01,083657,Tran; Khoa Dang,39,0,80,41
1657391862123,CSE 21,A01,095574,Bach; Quang Tran,22,0,48,26
1657391868148,CSE 30,A01,083084,Eldon; John,4,0,80,76
1657391868148,CSE 30,B01,095061,Bhaskar; Nishant,9,0,50,41
1657391874170,CSE 100,A01,083659,Cao; Yingjun,5,4,70,65
1657391880195,CSE 134B,A01,083661,Powell; Thomas Allan,22,0,100,78
1657391886221,CSE 140,A01,083663,Gungor; Onat,14,0,85,71
1657391892250,CSE 140L,A01,083088,Eldon; John,21,0,100,79
1657391898275,CSE 175,A01,083665,Kumar; Rakesh,3,0,25,22
1657391904298,CSE 190,A00,092507,Dubnov; Shlomo,7,0,20,13
1657391910320,ECE 45,A01,083139,Congero; Spencer William,6,0,75,69
1657391916350,ECE 65,A50,083695,Saad; Andrew S,12,0,30,18
1657391916350,ECE 65,A51,095125,Saad; Andrew S,24,0,26,2
1657391922372,ECE 109,A01,091882,Touri; Behrouz,19,0,70,51
1657391928395,ECE 180,A00,083140,Abi Samra; Nicholas Camill,1,0,30,29
1657391928395,ECE 180,B00,083141,Abi Samra; Nicholas Camill,0,0,30,30
1657391934418,MATH 10A,A01,083735,Patchell; Gregory David,2,0,30,28
1657391934418,MATH 10A,A02,083736,Patchell; Gregory David,20,0,30,10
1657391934418,MATH 10A,A03,083737,Patchell; Gregory David,16,0,30,14
1657391940445,MATH 10B,A01,083207,Lim; Seonhee,8,0,34,26
1657391940445,MATH 10B,A02,083208,Lim; Seonhee,9,0,35,26
1657391940445,MATH 10B,A03,093472,Lim; Seonhee,7,0,34,27
1657391940445,MATH 10B,B01,083739,Sinha; Shubham,12,0,30,18
1657391946475,MATH 18,A01,083743,Cinel; Cameron Alexander,7,0,30,23
1657391946475,MATH 18,A02,083744,Cinel; Cameron Alexander,17,0,30,13
1657391946475,MATH 18,A03,083745,Cinel; Cameron Alexander,9,0,30,21
1657391946475,MATH 18,B01,083748,Rideout; David Porter,5,0,37,32
1657391946475,MATH 18,B02,083749,Rideout; David Porter,5,0,36,31
1657391946475,MATH 18,B03,083750,Rideout; David Porter,3,0,37,34
1657391946475,MATH 18,B04,083751,Rideout; David Porter,6,0,36,30
1657391946475,MATH 18,B05,093473,Rideout; David Porter,6,0,36,30
1657391946475,MATH 18,B06,093474,Rideout; David Porter,6,0,36,30
1657391952499,MATH 20A,A01,083754,Zheng; Zequn,14,0,40,26
1657391958526,MATH 20B,A01,083756,Briones; Jor-el Thomas Caparas,4,0,36,32
1657391958526,MATH 20B,A02,083757,Briones; Jor-el Thomas Caparas,1,0,36,35
1657391958526,MATH 20B,A03,093475,Briones; Jor-el Thomas Caparas,2,0,36,34
1657391964565,MATH 20C,A01,083760,Briones; Jor-el Thomas Caparas,1,0,35,34
1657391964565,MATH 20C,A02,083761,Briones; Jor-el Thomas Caparas,8,0,35,27
1657391964565,MATH 20C,A03,093476,Briones; Jor-el Thomas Caparas,0,1,36,36
1657391964565,MATH 20C,B01,083762,Bach; Quang Tran,1,0,30,29
1657391970587,MATH 20D,A01,083765,Tran; Brian Kha,5,0,30,25
1657391970587,MATH 20D,A02,083766,Tran; Brian Kha,5,0,30,25
1657391970587,MATH 20D,A03,083767,Tran; Brian Kha,5,0,30,25
1657391976611,MATH 20E,A01,083771,Ganguly; Soumya,9,0,32,23
1657391976611,MATH 20E,A02,083772,Ganguly; Soumya,6,0,32,26
1657391976611,MATH 20E,B01,083773,Ciotti; Benjamin,20,0,35,15
1657391976611,MATH 20E,B02,083774,Ciotti; Benjamin,17,0,35,18
1657391982633,MATH 103A,A01,083777,Greenfeld; Be'Eri,3,0,36,33
1657391982633,MATH 103A,A02,083778,Greenfeld; Be'Eri,5,0,36,31
1657391982633,MATH 103A,A03,093561,Greenfeld; Be'Eri,5,0,36,31
1657391982633,MATH 103A,B01,083779,Greenfeld; Be'Eri,7,0,36,29
1657391982633,MATH 103A,B02,083780,Greenfeld; Be'Eri,4,0,36,32
1657391982633,MATH 103A,B03,093562,Greenfeld; Be'Eri,3,0,36,33
1657391988658,MATH 105,A01,085443,Carter; Anne Toulson,15,0,35,20
1657391988658,MATH 105,A02,093477,Carter; Anne Toulson,20,0,35,15
1657391994687,MATH 109,A01,083213,Ganzberger; Geoffrey Michael,2,0,34,32
1657391994687,MATH 109,A02,083214,Ganzberger; Geoffrey Michael,4,0,34,30
1657391994687,MATH 109,A03,093478,Ganzberger; Geoffrey Michael,2,0,34,32
1657391994687,MATH 109,B01,083215,Ganzberger; Geoffrey Michael,1,0,32,31
1657391994687,MATH 109,B02,083216,Ganzberger; Geoffrey Michael,2,0,32,30
1657391994687,MATH 109,B03,093479,Ganzberger; Geoffrey Michael,8,0,32,24
1657392000716,MATH 142A,A01,083219,Chow; Bennett,7,0,32,25
1657392000716,MATH 142A,A02,083220,Chow; Bennett,10,0,32,22
1657392000716,MATH 142A,A03,093480,Chow; Bennett,8,0,32,24
1657392000716,MATH 142A,B03,093481,Chow; Bennett,8,0,32,24
1657392000716,MATH 142A,B04,093558,Chow; Bennett,13,0,32,19
1657392000716,MATH 142A,B05,093559,Chow; Bennett,6,0,32,26
1657392006739,MATH 193A,A01,083224,Rotar; Vladimir,8,0,34,26
1657392006739,MATH 193A,A02,083225,Rotar; Vladimir,9,0,34,25
1657392006739,MATH 193A,A03,083781,Rotar; Vladimir,5,0,34,29
1657392006739,MATH 193A,A04,083782,Rotar; Vladimir,10,0,34,24
1657392006739,MATH 193A,A05,093482,Rotar; Vladimir,10,0,34,24
1657392012762,MATH 197,001,091859,McAuley; Julian John,9999,0,9999,0
1657392012762,MATH 197,002,095566,Kedlaya; Kiran S.,9997,0,9999,2
1657392012762,MATH 197,003,095567,Xiao; Ming,9999,0,9999,0
1657392012762,MATH 197,004,095571,Perols; Johan Lars,9998,0,9999,1
1657392019830,COGS 9,A01,083615,Shannon; Kyle Michael,9,0,75,66
1657392025857,COGS 11,A01,083617,Boyle; Mary E. T.,22,0,48,26
1657392031884,COGS 13,A01,083071,Bastos; Amalia Pinkusfeld,11,0,71,60
1657392037906,COGS 14A,A01,092681,Semenuks; Arturs,4,1,100,96
1657392043929,COGS 14B,A01,083073,Cheng; Tzu-Han,6,0,63,57
1657392049952,COGS 17,A01,092677,Semenuks; Arturs,6,0,81,75
1657392055978,COGS 100,A01,083619,Allen; Michael Gordon,17,0,70,53
1657392062006,COGS 101A,A01,083621,Davis; Joshua Daniel,9,0,68,59
1657392068028,COGS 101B,A01,091572,Allen; Michael Gordon,11,0,65,54
1657392074052,COGS 101C,A01,083625,Delgado; Tania,17,0,35,18
1657392080084,COGS 107A,A01,083627,Boyle; Mary E. T.,13,0,60,47
1657392086106,COGS 118A,A01,083075,Gupta; Anjum,20,0,76,56
1657392092129,CSE 3,A50,083646,Miranda; Gregory Joseph,24,0,50,26
1657392098153,CSE 8A,A50,083650,Miranda; Gregory Joseph,17,1,56,39
1657392104179,CSE 11,A01,083080,Cao; Yingjun,6,15,40,34
1657392110202,CSE 12,A01,083652,Krause-Levy; Sophia Louisa,28,1,120,92
1657392116225,CSE 15L,A01,083654,Morris; Justin Loren,9,0,50,41
1657392116225,CSE 15L,A02,083655,Morris; Justin Loren,9,0,50,41
1657392122253,CSE 20,A01,083657,Tran; Khoa Dang,39,0,80,41
1657392128278,CSE 21,A01,095574,Bach; Quang Tran,22,0,48,26
1657392134306,CSE 30,A01,083084,Eldon; John,4,0,80,76
1657392134306,CSE 30,B01,095061,Bhaskar; Nishant,9,0,50,41
1657392140330,CSE 100,A01,083659,Cao; Yingjun,5,4,70,65
1657392146352,CSE 134B,A01,083661,Powell; Thomas Allan,22,0,100,78
1657392152375,CSE 140,A01,083663,Gungor; Onat,14,0,85,71
1657392158412,CSE 140L,A01,083088,Eldon; John,21,0,100,79
1657392164436,CSE 175,A01,083665,Kumar; Rakesh,3,0,25,22
1657392170459,CSE 190,A00,092507,Dubnov; Shlomo,7,0,20,13
1657392176491,ECE 45,A01,083139,Congero; Spencer William,6,0,75,69
1657392182513,ECE 65,A50,083695,Saad; Andrew S,12,0,30,18
1657392182513,ECE 65,A51,095125,Saad; Andrew S,24,0,26,2
1657392188536,ECE 109,A01,091882,Touri; Behrouz,19,0,70,51
1657392194558,ECE 180,A00,083140,Abi Samra; Nicholas Camill,1,0,30,29
1657392194558,ECE 180,B00,083141,Abi Samra; Nicholas Camill,0,0,30,30
1657392200677,MATH 10A,A01,083735,Patchell; Gregory David,2,0,30,28
1657392200677,MATH 10A,A02,083736,Patchell; Gregory David,20,0,30,10
1657392200677,MATH 10A,A03,083737,Patchell; Gregory David,16,0,30,14
1657392206700,MATH 10B,A01,083207,Lim; Seonhee,8,0,34,26
1657392206700,MATH 10B,A02,083208,Lim; Seonhee,9,0,35,26
1657392206700,MATH 10B,A03,093472,Lim; Seonhee,7,0,34,27
1657392206700,MATH 10B,B01,083739,Sinha; Shubham,12,0,30,18
1657392212733,MATH 18,A01,083743,Cinel; Cameron Alexander,7,0,30,23
1657392212733,MATH 18,A02,083744,Cinel; Cameron Alexander,17,0,30,13
1657392212733,MATH 18,A03,083745,Cinel; Cameron Alexander,9,0,30,21
1657392212733,MATH 18,B01,083748,Rideout; David Porter,5,0,37,32
1657392212733,MATH 18,B02,083749,Rideout; David Porter,5,0,36,31
1657392212733,MATH 18,B03,083750,Rideout; David Porter,3,0,37,34
1657392212733,MATH 18,B04,083751,Rideout; David Porter,6,0,36,30
1657392212733,MATH 18,B05,093473,Rideout; David Porter,6,0,36,30
1657392212733,MATH 18,B06,093474,Rideout; David Porter,6,0,36,30
1657392218761,MATH 20A,A01,083754,Zheng; Zequn,14,0,40,26
1657392224788,MATH 20B,A01,083756,Briones; Jor-el Thomas Caparas,4,0,36,32
1657392224788,MATH 20B,A02,083757,Briones; Jor-el Thomas Caparas,1,0,36,35
1657392224788,MATH 20B,A03,093475,Briones; Jor-el Thomas Caparas,2,0,36,34
1657392230812,MATH 20C,A01,083760,Briones; Jor-el Thomas Caparas,1,0,35,34
1657392230812,MATH 20C,A02,083761,Briones; Jor-el Thomas Caparas,8,0,35,27
1657392230812,MATH 20C,A03,093476,Briones; Jor-el Thomas Caparas,0,1,36,36
1657392230812,MATH 20C,B01,083762,Bach; Quang Tran,1,0,30,29
1657392236842,MATH 20D,A01,083765,Tran; Brian Kha,5,0,30,25
1657392236842,MATH 20D,A02,083766,Tran; Brian Kha,5,0,30,25
1657392236842,MATH 20D,A03,083767,Tran; Brian Kha,5,0,30,25
1657392242864,MATH 20E,A01,083771,Ganguly; Soumya,9,0,32,23
1657392242864,MATH 20E,A02,083772,Ganguly; Soumya,6,0,32,26
1657392242864,MATH 20E,B01,083773,Ciotti; Benjamin,20,0,35,15
1657392242864,MATH 20E,B02,083774,Ciotti; Benjamin,17,0,35,18
1657392248896,MATH 103A,A01,083777,Greenfeld; Be'Eri,3,0,36,33
1657392248896,MATH 103A,A02,083778,Greenfeld; Be'Eri,5,0,36,31
1657392248896,MATH 103A,A03,093561,Greenfeld; Be'Eri,5,0,36,31
1657392248896,MATH 103A,B01,083779,Greenfeld; Be'Eri,7,0,36,29
1657392248896,MATH 103A,B02,083780,Greenfeld; Be'Eri,4,0,36,32
1657392248896,MATH 103A,B03,093562,Greenfeld; Be'Eri,3,0,36,33
1657392254922,MATH 105,A01,085443,Carter; Anne Toulson,15,0,35,20
1657392254922,MATH 105,A02,093477,Carter; Anne Toulson,20,0,35,15
1657392260946,MATH 109,A01,083213,Ganzberger; Geoffrey Michael,2,0,34,32
1657392260946,MATH 109,A02,083214,Ganzberger; Geoffrey Michael,4,0,34,30
1657392260946,MATH 109,A03,093478,Ganzberger; Geoffrey Michael,2,0,34,32
1657392260946,MATH 109,B01,083215,Ganzberger; Geoffrey Michael,1,0,32,31
1657392260946,MATH 109,B02,083216,Ganzberger; Geoffrey Michael,2,0,32,30
1657392260946,MATH 109,B03,093479,Ganzberger; Geoffrey Michael,8,0,32,24
1657392266984,MATH 142A,A01,083219,Chow; Bennett,7,0,32,25
1657392266984,MATH 142A,A02,083220,Chow; Bennett,10,0,32,22
1657392266984,MATH 142A,A03,093480,Chow; Bennett,8,0,32,24
1657392266984,MATH 142A,B03,093481,Chow; Bennett,8,0,32,24
1657392266984,MATH 142A,B04,093558,Chow; Bennett,13,0,32,19
1657392266984,MATH 142A,B05,093559,Chow; Bennett,6,0,32,26
1657392273011,MATH 193A,A01,083224,Rotar; Vladimir,8,0,34,26
1657392273011,MATH 193A,A02,083225,Rotar; Vladimir,9,0,34,25
1657392273011,MATH 193A,A03,083781,Rotar; Vladimir,5,0,34,29
1657392273011,MATH 193A,A04,083782,Rotar; Vladimir,10,0,34,24
1657392273011,MATH 193A,A05,093482,Rotar; Vladimir,10,0,34,24
1657392279034,MATH 197,001,091859,McAuley; Julian John,9999,0,9999,0
1657392279034,MATH 197,002,095566,Kedlaya; Kiran S.,9997,0,9999,2
1657392279034,MATH 197,003,095567,Xiao; Ming,9999,0,9999,0
1657392279034,MATH 197,004,095571,Perols; Johan Lars,9998,0,9999,1
1657392286095,COGS 9,A01,083615,Shannon; Kyle Michael,9,0,75,66
1657392292117,COGS 11,A01,083617,Boyle; Mary E. T.,22,0,48,26
1657392298148,COGS 13,A01,083071,Bastos; Amalia Pinkusfeld,11,0,71,60
1657392304178,COGS 14A,A01,092681,Semenuks; Arturs,4,1,100,96
1657392310201,COGS 14B,A01,083073,Cheng; Tzu-Han,6,0,63,57
1657392316223,COGS 17,A01,092677,Semenuks; Arturs,6,0,81,75
1657392322251,COGS 100,A01,083619,Allen; Michael Gordon,17,0,70,53
1657392328273,COGS 101A,A01,083621,Davis; Joshua Daniel,9,0,68,59
1657392334295,COGS 101B,A01,091572,Allen; Michael Gordon,11,0,65,54
1657392340321,COGS 101C,A01,083625,Delgado; Tania,17,0,35,18
1657392346346,COGS 107A,A01,083627,Boyle; Mary E. T.,13,0,60,47
1657392352372,COGS 118A,A01,083075,Gupta; Anjum,20,0,76,56
1657392358397,CSE 3,A50,083646,Miranda; Gregory Joseph,24,0,50,26
1657392364421,CSE 8A,A50,083650,Miranda; Gregory Joseph,17,1,56,39
1657392370446,CSE 11,A01,083080,Cao; Yingjun,6,15,40,34
1657392376470,CSE 12,A01,083652,Krause-Levy; Sophia Louisa,28,1,120,92
1657392382494,CSE 15L,A01,083654,Morris; Justin Loren,9,0,50,41
1657392382494,CSE 15L,A02,083655,Morris; Justin Loren,9,0,50,41
1657392388521,CSE 20,A01,083657,Tran; Khoa Dang,39,0,80,41
1657392394545,CSE 21,A01,095574,Bach; Quang Tran,22,0,48,26
1657392400571,CSE 30,A01,083084,Eldon; John,4,0,80,76
1657392400571,CSE 30,B01,095061,Bhaskar; Nishant,9,0,50,41
1657392406594,CSE 100,A01,083659,Cao; Yingjun,5,4,70,65
1657392412615,CSE 134B,A01,083661,Powell; Thomas Allan,22,0,100,78
1657392418639,CSE 140,A01,083663,Gungor; Onat,14,0,85,71
1657392424664,CSE 140L,A01,083088,Eldon; John,21,0,100,79
1657392430687,CSE 175,A01,083665,Kumar; Rakesh,3,0,25,22
1657392436712,CSE 190,A00,092507,Dubnov; Shlomo,7,0,20,13
1657392442738,ECE 45,A01,083139,Congero; Spencer William,6,0,75,69
1657392448771,ECE 65,A50,083695,Saad; Andrew S,12,0,30,18
1657392448771,ECE 65,A51,095125,Saad; Andrew S,24,0,26,2
1657392454799,ECE 109,A01,091882,Touri; Behrouz,19,0,70,51
1657392460821,ECE 180,A00,083140,Abi Samra; Nicholas Camill,1,0,30,29
1657392460821,ECE 180,B00,083141,Abi Samra; Nicholas Camill,0,0,30,30
1657392466845,MATH 10A,A01,083735,Patchell; Gregory David,2,0,30,28
1657392466845,MATH 10A,A02,083736,Patchell; Gregory David,20,0,30,10
1657392466845,MATH 10A,A03,083737,Patchell; Gregory David,16,0,30,14
1657392472875,MATH 10B,A01,083207,Lim; Seonhee,8,0,34,26
1657392472875,MATH 10B,A02,083208,Lim; Seonhee,9,0,35,26
1657392472875,MATH 10B,A03,093472,Lim; Seonhee,7,0,34,27
1657392472875,MATH 10B,B01,083739,Sinha; Shubham,12,0,30,18
1657392478900,MATH 18,A01,083743,Cinel; Cameron Alexander,7,0,30,23
1657392478900,MATH 18,A02,083744,Cinel; Cameron Alexander,17,0,30,13
1657392478900,MATH 18,A03,083745,Cinel; Cameron Alexander,9,0,30,21
1657392478900,MATH 18,B01,083748,Rideout; David Porter,5,0,37,32
1657392478900,MATH 18,B02,083749,Rideout; David Porter,5,0,36,31
1657392478900,MATH 18,B03,083750,Rideout; David Porter,3,0,37,34
1657392478900,MATH 18,B04,083751,Rideout; David Porter,6,0,36,30
1657392478900,MATH 18,B05,093473,Rideout; David Porter,6,0,36,30
1657392478900,MATH 18,B06,093474,Rideout; David Porter,6,0,36,30
1657392484925,MATH 20A,A01,083754,Zheng; Zequn,14,0,40,26
1657392490952,MATH 20B,A01,083756,Briones; Jor-el Thomas Caparas,4,0,36,32
1657392490952,MATH 20B,A02,083757,Briones; Jor-el Thomas Caparas,1,0,36,35
1657392490952,MATH 20B,A03,093475,Briones; Jor-el Thomas Caparas,2,0,36,34
1657392496984,MATH 20C,A01,083760,Briones; Jor-el Thomas Caparas,1,0,35,34
1657392496984,MATH 20C,A02,083761,Briones; Jor-el Thomas Caparas,8,0,35,27
1657392496984,MATH 20C,A03,093476,Briones; Jor-el Thomas Caparas,0,1,36,36
1657392496984,MATH 20C,B01,083762,Bach; Quang Tran,1,0,30,29
1657392503017,MATH 20D,A01,083765,Tran; Brian Kha,5,0,30,25
1657392503017,MATH 20D,A02,083766,Tran; Brian Kha,5,0,30,25
1657392503017,MATH 20D,A03,083767,Tran; Brian Kha,5,0,30,25
1657392509047,MATH 20E,A01,083771,Ganguly; Soumya,9,0,32,23
1657392509047,MATH 20E,A02,083772,Ganguly; Soumya,6,0,32,26
1657392509047,MATH 20E,B01,083773,Ciotti; Benjamin,20,0,35,15
1657392509047,MATH 20E,B02,083774,Ciotti; Benjamin,17,0,35,18
1657392515070,MATH 103A,A01,083777,Greenfeld; Be'Eri,3,0,36,33
1657392515070,MATH 103A,A02,083778,Greenfeld; Be'Eri,5,0,36,31
1657392515070,MATH 103A,A03,093561,Greenfeld; Be'Eri,5,0,36,31
1657392515070,MATH 103A,B01,083779,Greenfeld; Be'Eri,7,0,36,29
1657392515070,MATH 103A,B02,083780,Greenfeld; Be'Eri,4,0,36,32
1657392515070,MATH 103A,B03,093562,Greenfeld; Be'Eri,3,0,36,33
1657392521094,MATH 105,A01,085443,Carter; Anne Toulson,15,0,35,20
1657392521094,MATH 105,A02,093477,Carter; Anne Toulson,20,0,35,15
1657392527124,MATH 109,A01,083213,Ganzberger; Geoffrey Michael,2,0,34,32
1657392527124,MATH 109,A02,083214,Ganzberger; Geoffrey Michael,4,0,34,30
1657392527124,MATH 109,A03,093478,Ganzberger; Geoffrey Michael,2,0,34,32
1657392527124,MATH 109,B01,083215,Ganzberger; Geoffrey Michael,1,0,32,31
1657392527124,MATH 109,B02,083216,Ganzberger; Geoffrey Michael,2,0,32,30
1657392527124,MATH 109,B03,093479,Ganzberger; Geoffrey Michael,8,0,32,24
1657392533154,MATH 142A,A01,083219,Chow; Bennett,7,0,32,25
1657392533154,MATH 142A,A02,083220,Chow; Bennett,10,0,32,22
1657392533154,MATH 142A,A03,093480,Chow; Bennett,8,0,32,24
1657392533154,MATH 142A,B03,093481,Chow; Bennett,8,0,32,24
1657392533154,MATH 142A,B04,093558,Chow; Bennett,13,0,32,19
1657392533154,MATH 142A,B05,093559,Chow; Bennett,6,0,32,26
1657392539177,MATH 193A,A01,083224,Rotar; Vladimir,8,0,34,26
1657392539177,MATH 193A,A02,083225,Rotar; Vladimir,9,0,34,25
1657392539177,MATH 193A,A03,083781,Rotar; Vladimir,5,0,34,29
1657392539177,MATH 193A,A04,083782,Rotar; Vladimir,10,0,34,24
1657392539177,MATH 193A,A05,093482,Rotar; Vladimir,10,0,34,24
1657392545203,MATH 197,001,091859,McAuley; Julian John,9999,0,9999,0
1657392545203,MATH 197,002,095566,Kedlaya; Kiran S.,9997,0,9999,2
1657392545203,MATH 197,003,095567,Xiao; Ming,9999,0,9999,0
1657392545203,MATH 197,004,095571,Perols; Johan Lars,9998,0,9999,1
1657392552260,COGS 9,A01,083615,Shannon; Kyle Michael,9,0,75,66
1657392558284,COGS 11,A01,083617,Boyle; Mary E. T.,22,0,48,26
1657392564312,COGS 13,A01,083071,Bastos; Amalia Pinkusfeld,11,0,71,60
1657392570335,COGS 14A,A01,092681,Semenuks; Arturs,4,1,100,96
1657392576359,COGS 14B,A01,083073,Cheng; Tzu-Han,6,0,63,57
1657392582381,COGS 17,A01,092677,Semenuks; Arturs,6,0,81,75
1657392588405,COGS 100,A01,083619,Allen; Michael Gordon,17,0,70,53
1657392594434,COGS 101A,A01,083621,Davis; Joshua Daniel,9,0,68,59
1657392600459,COGS 101B,A01,091572,Allen; Michael Gordon,11,0,65,54
1657392606482,COGS 101C,A01,083625,Delgado; Tania,17,0,35,18
1657392612506,COGS 107A,A01,083627,Boyle; Mary E. T.,13,0,60,47
1657392618531,COGS 118A,A01,083075,Gupta; Anjum,20,0,76,56
1657392624559,CSE 3,A50,083646,Miranda; Gregory Joseph,24,0,50,26
1657392630582,CSE 8A,A50,083650,Miranda; Gregory Joseph,17,1,56,39
1657392636604,CSE 11,A01,083080,Cao; Yingjun,6,15,40,34
1657392642628,CSE 12,A01,083652,Krause-Levy; Sophia Louisa,28,1,120,92
1657392648652,CSE 15L,A01,083654,Morris; Justin Loren,9,0,50,41
1657392648652,CSE 15L,A02,083655,Morris; Justin Loren,9,0,50,41
1657392654676,CSE 20,A01,083657,Tran; Khoa Dang,39,0,80,41
1657392660702,CSE 21,A01,095574,Bach; Quang Tran,22,0,48,26
1657392666742,CSE 30,A01,083084,Eldon; John,4,0,80,76
1657392666742,CSE 30,B01,095061,Bhaskar; Nishant,9,0,50,41
1657392672766,CSE 100,A01,083659,Cao; Yingjun,5,4,70,65
1657392678792,CSE 134B,A01,083661,Powell; Thomas Allan,22,0,100,78
1657392684818,CSE 140,A01,083663,Gungor; Onat,14,0,85,71
1657392690849,CSE 140L,A01,083088,Eldon; John,21,0,100,79
1657392696877,CSE 175,A01,083665,Kumar; Rakesh,3,0,25,22
1657392702904,CSE 190,A00,092507,Dubnov; Shlomo,7,0,20,13
1657392708932,ECE 45,A01,083139,Congero; Spencer William,6,0,75,69
1657392714956,ECE 65,A50,083695,Saad; Andrew S,12,0,30,18
1657392714956,ECE 65,A51,095125,Saad; Andrew S,24,0,26,2
1657392720978,ECE 109,A01,091882,Touri; Behrouz,19,0,70,51
1657392727006,ECE 180,A00,083140,Abi Samra; Nicholas Camill,1,0,30,29
1657392727006,ECE 180,B00,083141,Abi Samra; Nicholas Camill,0,0,30,30
1657392733029,MATH 10A,A01,083735,Patchell; Gregory David,2,0,30,28
1657392733029,MATH 10A,A02,083736,Patchell; Gregory David,20,0,30,10
1657392733029,MATH 10A,A03,083737,Patchell; Gregory David,16,0,30,14
1657392739058,MATH 10B,A01,083207,Lim; Seonhee,8,0,34,26
1657392739058,MATH 10B,A02,083208,Lim; Seonhee,9,0,35,26
1657392739058,MATH 10B,A03,093472,Lim; Seonhee,7,0,34,27
1657392739058,MATH 10B,B01,083739,Sinha; Shubham,12,0,30,18
1657392745081,MATH 18,A01,083743,Cinel; Cameron Alexander,7,0,30,23
1657392745081,MATH 18,A02,083744,Cinel; Cameron Alexander,17,0,30,13
1657392745081,MATH 18,A03,083745,Cinel; Cameron Alexander,9,0,30,21
1657392745081,MATH 18,B01,083748,Rideout; David Porter,5,0,37,32
1657392745081,MATH 18,B02,083749,Rideout; David Porter,5,0,36,31
1657392745081,MATH 18,B03,083750,Rideout; David Porter,3,0,37,34
1657392745081,MATH 18,B04,083751,Rideout; David Porter,6,0,36,30
1657392745081,MATH 18,B05,093473,Rideout; David Porter,6,0,36,30
1657392745081,MATH 18,B06,093474,Rideout; David Porter,6,0,36,30
1657392751104,MATH 20A,A01,083754,Zheng; Zequn,14,0,40,26
1657392757131,MATH 20B,A01,083756,Briones; Jor-el Thomas Caparas,4,0,36,32
1657392757131,MATH 20B,A02,083757,Briones; Jor-el Thomas Caparas,1,0,36,35
1657392757131,MATH 20B,A03,093475,Briones; Jor-el Thomas Caparas,2,0,36,34
1657392763157,MATH 20C,A01,083760,Briones; Jor-el Thomas Caparas,1,0,35,34
1657392763157,MATH 20C,A02,083761,Briones; Jor-el Thomas Caparas,8,0,35,27
1657392763157,MATH 20C,A03,093476,Briones; Jor-el Thomas Caparas,0,1,36,36
1657392763157,MATH 20C,B01,083762,Bach; Quang Tran,1,0,30,29
1657392769185,MATH 20D,A01,083765,Tran; Brian Kha,5,0,30,25
1657392769185,MATH 20D,A02,083766,Tran; Brian Kha,5,0,30,25
1657392769185,MATH 20D,A03,083767,Tran; Brian Kha,5,0,30,25
1657392775213,MATH 20E,A01,083771,Ganguly; Soumya,9,0,32,23
1657392775213,MATH 20E,A02,083772,Ganguly; Soumya,6,0,32,26
1657392775213,MATH 20E,B01,083773,Ciotti; Benjamin,20,0,35,15
1657392775213,MATH 20E,B02,083774,Ciotti; Benjamin,17,0,35,18
1657392781239,MATH 103A,A01,083777,Greenfeld; Be'Eri,3,0,36,33
1657392781239,MATH 103A,A02,083778,Greenfeld; Be'Eri,5,0,36,31
1657392781239,MATH 103A,A03,093561,Greenfeld; Be'Eri,5,0,36,31
1657392781239,MATH 103A,B01,083779,Greenfeld; Be'Eri,7,0,36,29
1657392781239,MATH 103A,B02,083780,Greenfeld; Be'Eri,4,0,36,32
1657392781239,MATH 103A,B03,093562,Greenfeld; Be'Eri,3,0,36,33
1657392787261,MATH 105,A01,085443,Carter; Anne Toulson,15,0,35,20
1657392787261,MATH 105,A02,093477,Carter; Anne Toulson,20,0,35,15
1657392793284,MATH 109,A01,083213,Ganzberger; Geoffrey Michael,2,0,34,32
1657392793284,MATH 109,A02,083214,Ganzberger; Geoffrey Michael,4,0,34,30
1657392793284,MATH 109,A03,093478,Ganzberger; Geoffrey Michael,2,0,34,32
1657392793284,MATH 109,B01,083215,Ganzberger; Geoffrey Michael,1,0,32,31
1657392793284,MATH 109,B02,083216,Ganzberger; Geoffrey Michael,2,0,32,30
1657392793284,MATH 109,B03,093479,Ganzberger; Geoffrey Michael,8,0,32,24
1657392799380,MATH 142A,A01,083219,Chow; Bennett,7,0,32,25
1657392799380,MATH 142A,A02,083220,Chow; Bennett,10,0,32,22
1657392799380,MATH 142A,A03,093480,Chow; Bennett,8,0,32,24
1657392799380,MATH 142A,B03,093481,Chow; Bennett,8,0,32,24
1657392799380,MATH 142A,B04,093558,Chow; Bennett,13,0,32,19
1657392799380,MATH 142A,B05,093559,Chow; Bennett,6,0,32,26
1657392805407,MATH 193A,A01,083224,Rotar; Vladimir,8,0,34,26
1657392805407,MATH 193A,A02,083225,Rotar; Vladimir,9,0,34,25
1657392805407,MATH 193A,A03,083781,Rotar; Vladimir,5,0,34,29
1657392805407,MATH 193A,A04,083782,Rotar; Vladimir,10,0,34,24
1657392805407,MATH 193A,A05,093482,Rotar; Vladimir,10,0,34,24
1657392811433,MATH 197,001,091859,McAuley; Julian John,9999,0,9999,0
1657392811433,MATH 197,002,095566,Kedlaya; Kiran S.,9997,0,9999,2
1657392811433,MATH 197,003,095567,Xiao; Ming,9999,0,9999,0
1657392811433,MATH 197,004,095571,Perols; Johan Lars,9998,0,9999,1
1657392818500,COGS 9,A01,083615,Shannon; Kyle Michael,9,0,75,66
1657392824522,COGS 11,A01,083617,Boyle; Mary E. T.,22,0,48,26
1657392830547,COGS 13,A01,083071,Bastos; Amalia Pinkusfeld,11,0,71,60
1657392836584,COGS 14A,A01,092681,Semenuks; Arturs,4,1,100,96
1657392842606,COGS 14B,A01,083073,Cheng; Tzu-Han,6,0,63,57
1657392848630,COGS 17,A01,092677,Semenuks; Arturs,6,0,81,75
1657392854654,COGS 100,A01,083619,Allen; Michael Gordon,17,0,70,53
1657392860681,COGS 101A,A01,083621,Davis; Joshua Daniel,9,0,68,59
1657392866708,COGS 101B,A01,091572,Allen; Michael Gordon,11,0,65,54
1657392872733,COGS 101C,A01,083625,Delgado; Tania,17,0,35,18
1657392878760,COGS 107A,A01,083627,Boyle; Mary E. T.,13,0,60,47
1657392884788,COGS 118A,A01,083075,Gupta; Anjum,20,0,76,56
1657392890811,CSE 3,A50,083646,Miranda; Gregory Joseph,24,0,50,26
1657392896833,CSE 8A,A50,083650,Miranda; Gregory Joseph,17,1,56,39
1657392902861,CSE 11,A01,083080,Cao; Yingjun,6,15,40,34
1657392908888,CSE 12,A01,083652,Krause-Levy; Sophia Louisa,28,1,120,92
1657392914911,CSE 15L,A01,083654,Morris; Justin Loren,9,0,50,41
1657392914911,CSE 15L,A02,083655,Morris; Justin Loren,9,0,50,41
1657392920939,CSE 20,A01,083657,Tran; Khoa Dang,39,0,80,41
1657392926966,CSE 21,A01,095574,Bach; Quang Tran,22,0,48,26
1657392932990,CSE 30,A01,083084,Eldon; John,4,0,80,76
1657392932990,CSE 30,B01,095061,Bhaskar; Nishant,9,0,50,41
1657392939016,CSE 100,A01,083659,Cao; Yingjun,5,4,70,65
1657392945039,CSE 134B,A01,083661,Powell; Thomas Allan,22,0,100,78
1657392951062,CSE 140,A01,083663,Gungor; Onat,14,0,85,71
1657392957089,CSE 140L,A01,083088,Eldon; John,21,0,100,79
1657392963112,CSE 175,A01,083665,Kumar; Rakesh,3,0,25,22
1657392969150,CSE 190,A00,092507,Dubnov; Shlomo,7,0,20,13
1657392975180,ECE 45,A01,083139,Congero; Spencer William,6,0,75,69
1657392981204,ECE 65,A50,083695,Saad; Andrew S,12,0,30,18
1657392981204,ECE 65,A51,095125,Saad; Andrew S,24,0,26,2
1657392987230,ECE 109,A01,091882,Touri; Behrouz,19,0,70,51
1657392993259,ECE 180,A00,083140,Abi Samra; Nicholas Camill,1,0,30,29
1657392993259,ECE 180,B00,083141,Abi Samra; Nicholas Camill,0,0,30,30
1657392999285,MATH 10A,A01,083735,Patchell; Gregory David,2,0,30,28
1657392999285,MATH 10A,A02,083736,Patchell; Gregory David,20,0,30,10
1657392999285,MATH 10A,A03,083737,Patchell; Gregory David,16,0,30,14
1657393005309,MATH 10B,A01,083207,Lim; Seonhee,8,0,34,26
1657393005309,MATH 10B,A02,083208,Lim; Seonhee,9,0,35,26
1657393005309,MATH 10B,A03,093472,Lim; Seonhee,7,0,34,27
1657393005309,MATH 10B,B01,083739,Sinha; Shubham,12,0,30,18
1657393011334,MATH 18,A01,083743,Cinel; Cameron Alexander,7,0,30,23
1657393011334,MATH 18,A02,083744,Cinel; Cameron Alexander,17,0,30,13
1657393011334,MATH 18,A03,083745,Cinel; Cameron Alexander,9,0,30,21
1657393011334,MATH 18,B01,083748,Rideout; David Porter,5,0,37,32
1657393011334,MATH 18,B02,083749,Rideout; David Porter,5,0,36,31
1657393011334,MATH 18,B03,083750,Rideout; David Porter,3,0,37,34
1657393011334,MATH 18,B04,083751,Rideout; David Porter,6,0,36,30
1657393011334,MATH 18,B05,093473,Rideout; David Porter,6,0,36,30
1657393011334,MATH 18,B06,093474,Rideout; David Porter,6,0,36,30
1657393017357,MATH 20A,A01,083754,Zheng; Zequn,14,0,40,26
1657393023381,MATH 20B,A01,083756,Briones; Jor-el Thomas Caparas,4,0,36,32
1657393023381,MATH 20B,A02,083757,Briones; Jor-el Thomas Caparas,1,0,36,35
1657393023381,MATH 20B,A03,093475,Briones; Jor-el Thomas Caparas,2,0,36,34
1657393029404,MATH 20C,A01,083760,Briones; Jor-el Thomas Caparas,1,0,35,34
1657393029404,MATH 20C,A02,083761,Briones; Jor-el Thomas Caparas,8,0,35,27
1657393029404,MATH 20C,A03,093476,Briones; Jor-el Thomas Caparas,0,1,36,36
1657393029404,MATH 20C,B01,083762,Bach; Quang Tran,1,0,30,29
1657393035426,MATH 20D,A01,083765,Tran; Brian Kha,5,0,30,25
1657393035426,MATH 20D,A02,083766,Tran; Brian Kha,5,0,30,25
1657393035426,MATH 20D,A03,083767,Tran; Brian Kha,5,0,30,25
1657393041450,MATH 20E,A01,083771,Ganguly; Soumya,9,0,32,23
1657393041450,MATH 20E,A02,083772,Ganguly; Soumya,6,0,32,26
1657393041450,MATH 20E,B01,083773,Ciotti; Benjamin,20,0,35,15
1657393041450,MATH 20E,B02,083774,Ciotti; Benjamin,17,0,35,18
1657393047473,MATH 103A,A01,083777,Greenfeld; Be'Eri,3,0,36,33
1657393047473,MATH 103A,A02,083778,Greenfeld; Be'Eri,5,0,36,31
1657393047473,MATH 103A,A03,093561,Greenfeld; Be'Eri,5,0,36,31
1657393047473,MATH 103A,B01,083779,Greenfeld; Be'Eri,7,0,36,29
1657393047473,MATH 103A,B02,083780,Greenfeld; Be'Eri,4,0,36,32
1657393047473,MATH 103A,B03,093562,Greenfeld; Be'Eri,3,0,36,33
1657393053501,MATH 105,A01,085443,Carter; Anne Toulson,15,0,35,20
1657393053501,MATH 105,A02,093477,Carter; Anne Toulson,20,0,35,15
1657393059524,MATH 109,A01,083213,Ganzberger; Geoffrey Michael,2,0,34,32
1657393059524,MATH 109,A02,083214,Ganzberger; Geoffrey Michael,4,0,34,30
1657393059524,MATH 109,A03,093478,Ganzberger; Geoffrey Michael,2,0,34,32
1657393059524,MATH 109,B01,083215,Ganzberger; Geoffrey Michael,1,0,32,31
1657393059524,MATH 109,B02,083216,Ganzberger; Geoffrey Michael,2,0,32,30
1657393059524,MATH 109,B03,093479,Ganzberger; Geoffrey Michael,8,0,32,24
1657393065562,MATH 142A,A01,083219,Chow; Bennett,7,0,32,25
1657393065562,MATH 142A,A02,083220,Chow; Bennett,10,0,32,22
1657393065562,MATH 142A,A03,093480,Chow; Bennett,8,0,32,24
1657393065562,MATH 142A,B03,093481,Chow; Bennett,8,0,32,24
1657393065562,MATH 142A,B04,093558,Chow; Bennett,13,0,32,19
1657393065562,MATH 142A,B05,093559,Chow; Bennett,6,0,32,26
1657393071589,MATH 193A,A01,083224,Rotar; Vladimir,8,0,34,26
1657393071589,MATH 193A,A02,083225,Rotar; Vladimir,9,0,34,25
1657393071589,MATH 193A,A03,083781,Rotar; Vladimir,5,0,34,29
1657393071589,MATH 193A,A04,083782,Rotar; Vladimir,10,0,34,24
1657393071589,MATH 193A,A05,093482,Rotar; Vladimir,10,0,34,24
1657393077631,MATH 197,001,091859,McAuley; Julian John,9999,0,9999,0
1657393077631,MATH 197,002,095566,Kedlaya; Kiran S.,9997,0,9999,2
1657393077631,MATH 197,003,095567,Xiao; Ming,9999,0,9999,0
1657393077631,MATH 197,004,095571,Perols; Johan Lars,9998,0,9999,1
1657393084695,COGS 9,A01,083615,Shannon; Kyle Michael,9,0,75,66
1657393090717,COGS 11,A01,083617,Boyle; Mary E. T.,22,0,48,26
1657393096750,COGS 13,A01,083071,Bastos; Amalia Pinkusfeld,11,0,71,60
1657393102779,COGS 14A,A01,092681,Semenuks; Arturs,4,1,100,96
1657393108801,COGS 14B,A01,083073,Cheng; Tzu-Han,6,0,63,57
1657393114825,COGS 17,A01,092677,Semenuks; Arturs,6,0,81,75
1657393120851,COGS 100,A01,083619,Allen; Michael Gordon,17,0,70,53
1657393126874,COGS 101A,A01,083621,Davis; Joshua Daniel,9,0,68,59
1657393132900,COGS 101B,A01,091572,Allen; Michael Gordon,11,0,65,54
1657393138923,COGS 101C,A01,083625,Delgado; Tania,17,0,35,18
1657393144946,COGS 107A,A01,083627,Boyle; Mary E. T.,13,0,60,47
1657393150973,COGS 118A,A01,083075,Gupta; Anjum,20,0,76,56
1657393156997,CSE 3,A50,083646,Miranda; Gregory Joseph,24,0,50,26
1657393163025,CSE 8A,A50,083650,Miranda; Gregory Joseph,17,1,56,39
1657393169049,CSE 11,A01,083080,Cao; Yingjun,6,15,40,34
1657393175076,CSE 12,A01,083652,Krause-Levy; Sophia Louisa,28,1,120,92
1657393181100,CSE 15L,A01,083654,Morris; Justin Loren,9,0,50,41
1657393181100,CSE 15L,A02,083655,Morris; Justin Loren,9,0,50,41
1657393187125,CSE 20,A01,083657,Tran; Khoa Dang,39,0,80,41
1657393193148,CSE 21,A01,095574,Bach; Quang Tran,22,0,48,26
1657393199174,CSE 30,A01,083084,Eldon; John,4,0,80,76
1657393199174,CSE 30,B01,095061,Bhaskar; Nishant,9,0,50,41
1657393205205,CSE 100,A01,083659,Cao; Yingjun,5,4,70,65
1657393211233,CSE 134B,A01,083661,Powell; Thomas Allan,22,0,100,78
1657393217256,CSE 140,A01,083663,Gungor; Onat,14,0,85,71
1657393223279,CSE 140L,A01,083088,Eldon; John,21,0,100,79
1657393229302,CSE 175,A01,083665,Kumar; Rakesh,3,0,25,22
1657393235327,CSE 190,A00,092507,Dubnov; Shlomo,7,0,20,13
1657393241348,ECE 45,A01,083139,Congero; Spencer William,6,0,75,69
1657393247372,ECE 65,A50,083695,Saad; Andrew S,12,0,30,18
1657393247372,ECE 65,A51,095125,Saad; Andrew S,24,0,26,2
1657393253395,ECE 109,A01,091882,Touri; Behrouz,19,0,70,51
1657393259419,ECE 180,A00,083140,Abi Samra; Nicholas Camill,1,0,30,29
1657393259419,ECE 180,B00,083141,Abi Samra; Nicholas Camill,0,0,30,30
1657393265463,MATH 10A,A01,083735,Patchell; Gregory David,2,0,30,28
1657393265463,MATH 10A,A02,083736,Patchell; Gregory David,20,0,30,10
1657393265463,MATH 10A,A03,083737,Patchell; Gregory David,16,0,30,14
1657393271487,MATH 10B,A01,083207,Lim; Seonhee,8,0,34,26
1657393271487,MATH 10B,A02,083208,Lim; Seonhee,9,0,35,26
1657393271487,MATH 10B,A03,093472,Lim; Seonhee,7,0,34,27
1657393271487,MATH 10B,B01,083739,Sinha; Shubham,12,0,30,18
1657393277518,MATH 18,A01,083743,Cinel; Cameron Alexander,7,0,30,23
1657393277518,MATH 18,A02,083744,Cinel; Cameron Alexander,17,0,30,13
1657393277518,MATH 18,A03,083745,Cinel; Cameron Alexander,9,0,30,21
1657393277518,MATH 18,B01,083748,Rideout; David Porter,5,0,37,32
1657393277518,MATH 18,B02,083749,Rideout; David Porter,5,0,36,31
1657393277518,MATH 18,B03,083750,Rideout; David Porter,3,0,37,34
1657393277518,MATH 18,B04,083751,Rideout; David Porter,6,0,36,30
1657393277518,MATH 18,B05,093473,Rideout; David Porter,6,0,36,30
1657393277518,MATH 18,B06,093474,Rideout; David Porter,6,0,36,30
1657393283541,MATH 20A,A01,083754,Zheng; Zequn,14,0,40,26
1657393289572,MATH 20B,A01,083756,Briones; Jor-el Thomas Caparas,4,0,36,32
1657393289572,MATH 20B,A02,083757,Briones; Jor-el Thomas Caparas,1,0,36,35
1657393289572,MATH 20B,A03,093475,Briones; Jor-el Thomas Caparas,2,0,36,34
1657393295596,MATH 20C,A01,083760,Briones; Jor-el Thomas Caparas,1,0,35,34
1657393295596,MATH 20C,A02,083761,Briones; Jor-el Thomas Caparas,8,0,35,27
1657393295596,MATH 20C,A03,093476,Briones; Jor-el Thomas Caparas,0,1,36,36
1657393295596,MATH 20C,B01,083762,Bach; Quang Tran,1,0,30,29
1657393301621,MATH 20D,A01,083765,Tran; Brian Kha,5,0,30,25
1657393301621,MATH 20D,A02,083766,Tran; Brian Kha,5,0,30,25
1657393301621,MATH 20D,A03,083767,Tran; Brian Kha,5,0,30,25
1657393307649,MATH 20E,A01,083771,Ganguly; Soumya,9,0,32,23
1657393307649,MATH 20E,A02,083772,Ganguly; Soumya,6,0,32,26
1657393307649,MATH 20E,B01,083773,Ciotti; Benjamin,20,0,35,15
1657393307649,MATH 20E,B02,083774,Ciotti; Benjamin,17,0,35,18
1657393313673,MATH 103A,A01,083777,Greenfeld; Be'Eri,3,0,36,33
1657393313673,MATH 103A,A02,083778,Greenfeld; Be'Eri,5,0,36,31
1657393313673,MATH 103A,A03,093561,Greenfeld; Be'Eri,5,0,36,31
1657393313673,MATH 103A,B01,083779,Greenfeld; Be'Eri,7,0,36,29
1657393313673,MATH 103A,B02,083780,Greenfeld; Be'Eri,4,0,36,32
1657393313673,MATH 103A,B03,093562,Greenfeld; Be'Eri,3,0,36,33
1657393319696,MATH 105,A01,085443,Carter; Anne Toulson,15,0,35,20
1657393319696,MATH 105,A02,093477,Carter; Anne Toulson,20,0,35,15
1657393325720,MATH 109,A01,083213,Ganzberger; Geoffrey Michael,2,0,34,32
1657393325720,MATH 109,A02,083214,Ganzberger; Geoffrey Michael,4,0,34,30
1657393325720,MATH 109,A03,093478,Ganzberger; Geoffrey Michael,2,0,34,32
1657393325720,MATH 109,B01,083215,Ganzberger; Geoffrey Michael,1,0,32,31
1657393325720,MATH 109,B02,083216,Ganzberger; Geoffrey Michael,2,0,32,30
1657393325720,MATH 109,B03,093479,Ganzberger; Geoffrey Michael,8,0,32,24
1657393331744,MATH 142A,A01,083219,Chow; Bennett,7,0,32,25
1657393331744,MATH 142A,A02,083220,Chow; Bennett,10,0,32,22
1657393331744,MATH 142A,A03,093480,Chow; Bennett,8,0,32,24
1657393331744,MATH 142A,B03,093481,Chow; Bennett,8,0,32,24
1657393331744,MATH 142A,B04,093558,Chow; Bennett,13,0,32,19
1657393331744,MATH 142A,B05,093559,Chow; Bennett,6,0,32,26
1657393337769,MATH 193A,A01,083224,Rotar; Vladimir,8,0,34,26
1657393337769,MATH 193A,A02,083225,Rotar; Vladimir,9,0,34,25
1657393337769,MATH 193A,A03,083781,Rotar; Vladimir,5,0,34,29
1657393337769,MATH 193A,A04,083782,Rotar; Vladimir,10,0,34,24
1657393337769,MATH 193A,A05,093482,Rotar; Vladimir,10,0,34,24
1657393343793,MATH 197,001,091859,McAuley; Julian John,9999,0,9999,0
1657393343793,MATH 197,002,095566,Kedlaya; Kiran S.,9997,0,9999,2
1657393343793,MATH 197,003,095567,Xiao; Ming,9999,0,9999,0
1657393343793,MATH 197,004,095571,Perols; Johan Lars,9998,0,9999,1
1657393350846,COGS 9,A01,083615,Shannon; Kyle Michael,9,0,75,66
1657393356869,COGS 11,A01,083617,Boyle; Mary E. T.,22,0,48,26
1657393362891,COGS 13,A01,083071,Bastos; Amalia Pinkusfeld,11,0,71,60
1657393368924,COGS 14A,A01,092681,Semenuks; Arturs,4,1,100,96
1657393374951,COGS 14B,A01,083073,Cheng; Tzu-Han,6,0,63,57
1657393380975,COGS 17,A01,092677,Semenuks; Arturs,6,0,81,75
1657393386998,COGS 100,A01,083619,Allen; Michael Gordon,17,0,70,53
1657393393110,COGS 101A,A01,083621,Davis; Joshua Daniel,9,0,68,59
1657393399134,COGS 101B,A01,091572,Allen; Michael Gordon,11,0,65,54
1657393405160,COGS 101C,A01,083625,Delgado; Tania,17,0,35,18
1657393411194,COGS 107A,A01,083627,Boyle; Mary E. T.,13,0,60,47
1657393417221,COGS 118A,A01,083075,Gupta; Anjum,20,0,76,56
1657393423248,CSE 3,A50,083646,Miranda; Gregory Joseph,24,0,50,26
1657393429276,CSE 8A,A50,083650,Miranda; Gregory Joseph,17,1,56,39
1657393435302,CSE 11,A01,083080,Cao; Yingjun,6,15,40,34
1657393441326,CSE 12,A01,083652,Krause-Levy; Sophia Louisa,28,1,120,92
1657393447353,CSE 15L,A01,083654,Morris; Justin Loren,9,0,50,41
1657393447353,CSE 15L,A02,083655,Morris; Justin Loren,9,0,50,41
1657393453377,CSE 20,A01,083657,Tran; Khoa Dang,39,0,80,41
1657393459402,CSE 21,A01,095574,Bach; Quang Tran,22,0,48,26
1657393465426,CSE 30,A01,083084,Eldon; John,4,0,80,76
1657393465426,CSE 30,B01,095061,Bhaskar; Nishant,9,0,50,41
1657393471451,CSE 100,A01,083659,Cao; Yingjun,5,4,70,65
1657393477476,CSE 134B,A01,083661,Powell; Thomas Allan,22,0,100,78
1657393483502,CSE 140,A01,083663,Gungor; Onat,14,0,85,71
1657393489524,CSE 140L,A01,083088,Eldon; John,21,0,100,79
1657393495549,CSE 175,A01,083665,Kumar; Rakesh,3,0,25,22
1657393501573,CSE 190,A00,092507,Dubnov; Shlomo,7,0,20,13
1657393507596,ECE 45,A01,083139,Congero; Spencer William,6,0,75,69
1657393513621,ECE 65,A50,083695,Saad; Andrew S,12,0,30,18
1657393513621,ECE 65,A51,095125,Saad; Andrew S,24,0,26,2
1657393519646,ECE 109,A01,091882,Touri; Behrouz,19,0,70,51
1657393525672,ECE 180,A00,083140,Abi Samra; Nicholas Camill,1,0,30,29
1657393525672,ECE 180,B00,083141,Abi Samra; Nicholas Camill,0,0,30,30
1657393531710,MATH 10A,A01,083735,Patchell; Gregory David,2,0,30,28
1657393531710,MATH 10A,A02,083736,Patchell; Gregory David,20,0,30,10
1657393531710,MATH 10A,A03,083737,Patchell; Gregory David,16,0,30,14
1657393537738,MATH 10B,A01,083207,Lim; Seonhee,8,0,34,26
1657393537738,MATH 10B,A02,083208,Lim; Seonhee,9,0,35,26
1657393537738,MATH 10B,A03,093472,Lim; Seonhee,7,0,34,27
1657393537738,MATH 10B,B01,083739,Sinha; Shubham,12,0,30,18
1657393543767,MATH 18,A01,083743,Cinel; Cameron Alexander,7,0,30,23
1657393543767,MATH 18,A02,083744,Cinel; Cameron Alexander,17,0,30,13
1657393543767,MATH 18,A03,083745,Cinel; Cameron Alexander,9,0,30,21
1657393543767,MATH 18,B01,083748,Rideout; David Porter,5,0,37,32
1657393543767,MATH 18,B02,083749,Rideout; David Porter,5,0,36,31
1657393543767,MATH 18,B03,083750,Rideout; David Porter,3,0,37,34
1657393543767,MATH 18,B04,083751,Rideout; David Porter,6,0,36,30
1657393543767,MATH 18,B05,093473,Rideout; David Porter,6,0,36,30
1657393543767,MATH 18,B06,093474,Rideout; David Porter,6,0,36,30
1657393549789,MATH 20A,A01,083754,Zheng; Zequn,14,0,40,26
1657393555816,MATH 20B,A01,083756,Briones; Jor-el Thomas Caparas,4,0,36,32
1657393555816,MATH 20B,A02,083757,Briones; Jor-el Thomas Caparas,1,0,36,35
1657393555816,MATH 20B,A03,093475,Briones; Jor-el Thomas Caparas,2,0,36,34
1657393561840,MATH 20C,A01,083760,Briones; Jor-el Thomas Caparas,1,0,35,34
1657393561840,MATH 20C,A02,083761,Briones; Jor-el Thomas Caparas,8,0,35,27
1657393561840,MATH 20C,A03,093476,Briones; Jor-el Thomas Caparas,0,1,36,36
1657393561840,MATH 20C,B01,083762,Bach; Quang Tran,1,0,30,29
1657393567866,MATH 20D,A01,083765,Tran; Brian Kha,5,0,30,25
1657393567866,MATH 20D,A02,083766,Tran; Brian Kha,5,0,30,25
1657393567866,MATH 20D,A03,083767,Tran; Brian Kha,5,0,30,25
1657393573890,MATH 20E,A01,083771,Ganguly; Soumya,9,0,32,23
1657393573890,MATH 20E,A02,083772,Ganguly; Soumya,6,0,32,26
1657393573890,MATH 20E,B01,083773,Ciotti; Benjamin,20,0,35,15
1657393573890,MATH 20E,B02,083774,Ciotti; Benjamin,17,0,35,18
1657393579918,MATH 103A,A01,083777,Greenfeld; Be'Eri,3,0,36,33
1657393579918,MATH 103A,A02,083778,Greenfeld; Be'Eri,5,0,36,31
1657393579918,MATH 103A,A03,093561,Greenfeld; Be'Eri,5,0,36,31
1657393579918,MATH 103A,B01,083779,Greenfeld; Be'Eri,7,0,36,29
1657393579918,MATH 103A,B02,083780,Greenfeld; Be'Eri,4,0,36,32
1657393579918,MATH 103A,B03,093562,Greenfeld; Be'Eri,3,0,36,33
1657393585940,MATH 105,A01,085443,Carter; Anne Toulson,15,0,35,20
1657393585940,MATH 105,A02,093477,Carter; Anne Toulson,20,0,35,15
1657393591969,MATH 109,A01,083213,Ganzberger; Geoffrey Michael,2,0,34,32
1657393591969,MATH 109,A02,083214,Ganzberger; Geoffrey Michael,4,0,34,30
1657393591969,MATH 109,A03,093478,Ganzberger; Geoffrey Michael,2,0,34,32
1657393591969,MATH 109,B01,083215,Ganzberger; Geoffrey Michael,1,0,32,31
1657393591969,MATH 109,B02,083216,Ganzberger; Geoffrey Michael,2,0,32,30
1657393591969,MATH 109,B03,093479,Ganzberger; Geoffrey Michael,8,0,32,24
1657393597997,MATH 142A,A01,083219,Chow; Bennett,7,0,32,25
1657393597997,MATH 142A,A02,083220,Chow; Bennett,10,0,32,22
1657393597997,MATH 142A,A03,093480,Chow; Bennett,8,0,32,24
1657393597997,MATH 142A,B03,093481,Chow; Bennett,8,0,32,24
1657393597997,MATH 142A,B04,093558,Chow; Bennett,13,0,32,19
1657393597997,MATH 142A,B05,093559,Chow; Bennett,6,0,32,26
1657393604026,MATH 193A,A01,083224,Rotar; Vladimir,8,0,34,26
1657393604026,MATH 193A,A02,083225,Rotar; Vladimir,9,0,34,25
1657393604026,MATH 193A,A03,083781,Rotar; Vladimir,5,0,34,29
1657393604026,MATH 193A,A04,083782,Rotar; Vladimir,10,0,34,24
1657393604026,MATH 193A,A05,093482,Rotar; Vladimir,10,0,34,24
1657393610052,MATH 197,001,091859,McAuley; Julian John,9999,0,9999,0
1657393610052,MATH 197,002,095566,Kedlaya; Kiran S.,9997,0,9999,2
1657393610052,MATH 197,003,095567,Xiao; Ming,9999,0,9999,0
1657393610052,MATH 197,004,095571,Perols; Johan Lars,9998,0,9999,1
1657393617104,COGS 9,A01,083615,Shannon; Kyle Michael,9,0,75,66
1657393623128,COGS 11,A01,083617,Boyle; Mary E. T.,22,0,48,26
1657393629155,COGS 13,A01,083071,Bastos; Amalia Pinkusfeld,11,0,71,60
1657393635181,COGS 14A,A01,092681,Semenuks; Arturs,4,1,100,96
1657393641204,COGS 14B,A01,083073,Cheng; Tzu-Han,6,0,63,57
1657393647237,COGS 17,A01,092677,Semenuks; Arturs,6,0,81,75
1657393653261,COGS 100,A01,083619,Allen; Michael Gordon,17,0,70,53
1657393659282,COGS 101A,A01,083621,Davis; Joshua Daniel,9,0,68,59
1657393665306,COGS 101B,A01,091572,Allen; Michael Gordon,11,0,65,54
1657393671333,COGS 101C,A01,083625,Delgado; Tania,17,0,35,18
1657393677357,COGS 107A,A01,083627,Boyle; Mary E. T.,13,0,60,47
1657393683380,COGS 118A,A01,083075,Gupta; Anjum,20,0,76,56
1657393689407,CSE 3,A50,083646,Miranda; Gregory Joseph,24,0,50,26
1657393695431,CSE 8A,A50,083650,Miranda; Gregory Joseph,17,1,56,39
1657393701458,CSE 11,A01,083080,Cao; Yingjun,6,15,40,34
1657393707482,CSE 12,A01,083652,Krause-Levy; Sophia Louisa,28,1,120,92
1657393713508,CSE 15L,A01,083654,Morris; Justin Loren,9,0,50,41
1657393713508,CSE 15L,A02,083655,Morris; Justin Loren,9,0,50,41
1657393719547,CSE 20,A01,083657,Tran; Khoa Dang,39,0,80,41
1657393725570,CSE 21,A01,095574,Bach; Quang Tran,22,0,48,26
1657393731592,CSE 30,A01,083084,Eldon; John,4,0,80,76
1657393731592,CSE 30,B01,095061,Bhaskar; Nishant,9,0,50,41
1657393737618,CSE 100,A01,083659,Cao; Yingjun,5,4,70,65
1657393743641,CSE 134B,A01,083661,Powell; Thomas Allan,22,0,100,78
1657393749667,CSE 140,A01,083663,Gungor; Onat,14,0,85,71
1657393755693,CSE 140L,A01,083088,Eldon; John,21,0,100,79
1657393761719,CSE 175,A01,083665,Kumar; Rakesh,3,0,25,22
1657393767747,CSE 190,A00,092507,Dubnov; Shlomo,7,0,20,13
1657393773777,ECE 45,A01,083139,Congero; Spencer William,6,0,75,69
1657393779801,ECE 65,A50,083695,Saad; Andrew S,12,0,30,18
1657393779801,ECE 65,A51,095125,Saad; Andrew S,24,0,26,2
1657393785824,ECE 109,A01,091882,Touri; Behrouz,19,0,70,51
1657393791847,ECE 180,A00,083140,Abi Samra; Nicholas Camill,1,0,30,29
1657393791847,ECE 180,B00,083141,Abi Samra; Nicholas Camill,0,0,30,30
1657393797871,MATH 10A,A01,083735,Patchell; Gregory David,2,0,30,28
1657393797871,MATH 10A,A02,083736,Patchell; Gregory David,20,0,30,10
1657393797871,MATH 10A,A03,083737,Patchell; Gregory David,16,0,30,14
1657393803897,MATH 10B,A01,083207,Lim; Seonhee,8,0,34,26
1657393803897,MATH 10B,A02,083208,Lim; Seonhee,9,0,35,26
1657393803897,MATH 10B,A03,093472,Lim; Seonhee,7,0,34,27
1657393803897,MATH 10B,B01,083739,Sinha; Shubham,12,0,30,18
1657393809920,MATH 18,A01,083743,Cinel; Cameron Alexander,7,0,30,23
1657393809920,MATH 18,A02,083744,Cinel; Cameron Alexander,17,0,30,13
1657393809920,MATH 18,A03,083745,Cinel; Cameron Alexander,9,0,30,21
1657393809920,MATH 18,B01,083748,Rideout; David Porter,5,0,37,32
1657393809920,MATH 18,B02,083749,Rideout; David Porter,5,0,36,31
1657393809920,MATH 18,B03,083750,Rideout; David Porter,3,0,37,34
1657393809920,MATH 18,B04,083751,Rideout; David Porter,6,0,36,30
1657393809920,MATH 18,B05,093473,Rideout; David Porter,6,0,36,30
1657393809920,MATH 18,B06,093474,Rideout; David Porter,6,0,36,30
1657393815948,MATH 20A,A01,083754,Zheng; Zequn,14,0,40,26
1657393821976,MATH 20B,A01,083756,Briones; Jor-el Thomas Caparas,4,0,36,32
1657393821976,MATH 20B,A02,083757,Briones; Jor-el Thomas Caparas,1,0,36,35
1657393821976,MATH 20B,A03,093475,Briones; Jor-el Thomas Caparas,2,0,36,34
1657393828000,MATH 20C,A01,083760,Briones; Jor-el Thomas Caparas,1,0,35,34
1657393828000,MATH 20C,A02,083761,Briones; Jor-el Thomas Caparas,8,0,35,27
1657393828000,MATH 20C,A03,093476,Briones; Jor-el Thomas Caparas,0,1,36,36
1657393828000,MATH 20C,B01,083762,Bach; Quang Tran,1,0,30,29
1657393834027,MATH 20D,A01,083765,Tran; Brian Kha,5,0,30,25
1657393834027,MATH 20D,A02,083766,Tran; Brian Kha,5,0,30,25
1657393834027,MATH 20D,A03,083767,Tran; Brian Kha,5,0,30,25
1657393840056,MATH 20E,A01,083771,Ganguly; Soumya,9,0,32,23
1657393840056,MATH 20E,A02,083772,Ganguly; Soumya,6,0,32,26
1657393840056,MATH 20E,B01,083773,Ciotti; Benjamin,20,0,35,15
1657393840056,MATH 20E,B02,083774,Ciotti; Benjamin,17,0,35,18
1657393846084,MATH 103A,A01,083777,Greenfeld; Be'Eri,3,0,36,33
1657393846084,MATH 103A,A02,083778,Greenfeld; Be'Eri,5,0,36,31
1657393846084,MATH 103A,A03,093561,Greenfeld; Be'Eri,5,0,36,31
1657393846084,MATH 103A,B01,083779,Greenfeld; Be'Eri,7,0,36,29
1657393846084,MATH 103A,B02,083780,Greenfeld; Be'Eri,4,0,36,32
1657393846084,MATH 103A,B03,093562,Greenfeld; Be'Eri,3,0,36,33
1657393852109,MATH 105,A01,085443,Carter; Anne Toulson,15,0,35,20
1657393852109,MATH 105,A02,093477,Carter; Anne Toulson,20,0,35,15
1657393858137,MATH 109,A01,083213,Ganzberger; Geoffrey Michael,2,0,34,32
1657393858137,MATH 109,A02,083214,Ganzberger; Geoffrey Michael,4,0,34,30
1657393858137,MATH 109,A03,093478,Ganzberger; Geoffrey Michael,2,0,34,32
1657393858137,MATH 109,B01,083215,Ganzberger; Geoffrey Michael,1,0,32,31
1657393858137,MATH 109,B02,083216,Ganzberger; Geoffrey Michael,2,0,32,30
1657393858137,MATH 109,B03,093479,Ganzberger; Geoffrey Michael,8,0,32,24
1657393864161,MATH 142A,A01,083219,Chow; Bennett,7,0,32,25
1657393864161,MATH 142A,A02,083220,Chow; Bennett,10,0,32,22
1657393864161,MATH 142A,A03,093480,Chow; Bennett,8,0,32,24
1657393864161,MATH 142A,B03,093481,Chow; Bennett,8,0,32,24
1657393864161,MATH 142A,B04,093558,Chow; Bennett,13,0,32,19
1657393864161,MATH 142A,B05,093559,Chow; Bennett,6,0,32,26
1657393870189,MATH 193A,A01,083224,Rotar; Vladimir,8,0,34,26
1657393870189,MATH 193A,A02,083225,Rotar; Vladimir,9,0,34,25
1657393870189,MATH 193A,A03,083781,Rotar; Vladimir,5,0,34,29
1657393870189,MATH 193A,A04,083782,Rotar; Vladimir,10,0,34,24
1657393870189,MATH 193A,A05,093482,Rotar; Vladimir,10,0,34,24
1657393876213,MATH 197,001,091859,McAuley; Julian John,9999,0,9999,0
1657393876213,MATH 197,002,095566,Kedlaya; Kiran S.,9997,0,9999,2
1657393876213,MATH 197,003,095567,Xiao; Ming,9999,0,9999,0
1657393876213,MATH 197,004,095571,Perols; Johan Lars,9998,0,9999,1
1657393883277,COGS 9,A01,083615,Shannon; Kyle Michael,9,0,75,66
1657393889302,COGS 11,A01,083617,Boyle; Mary E. T.,22,0,48,26
1657393895330,COGS 13,A01,083071,Bastos; Amalia Pinkusfeld,11,0,71,60
1657393901353,COGS 14A,A01,092681,Semenuks; Arturs,4,1,100,96
1657393907380,COGS 14B,A01,083073,Cheng; Tzu-Han,6,0,63,57
1657393913403,COGS 17,A01,092677,Semenuks; Arturs,6,0,81,75
1657393919427,COGS 100,A01,083619,Allen; Michael Gordon,17,0,70,53
1657393925450,COGS 101A,A01,083621,Davis; Joshua Daniel,9,0,68,59
1657393931474,COGS 101B,A01,091572,Allen; Michael Gordon,11,0,65,54
1657393937499,COGS 101C,A01,083625,Delgado; Tania,17,0,35,18
1657393943522,COGS 107A,A01,083627,Boyle; Mary E. T.,13,0,60,47
1657393949546,COGS 118A,A01,083075,Gupta; Anjum,20,0,76,56
1657393955585,CSE 3,A50,083646,Miranda; Gregory Joseph,24,0,50,26
1657393961609,CSE 8A,A50,083650,Miranda; Gregory Joseph,17,1,56,39
1657393967633,CSE 11,A01,083080,Cao; Yingjun,6,15,40,34
1657393973671,CSE 12,A01,083652,Krause-Levy; Sophia Louisa,28,1,120,92
1657393979697,CSE 15L,A01,083654,Morris; Justin Loren,9,0,50,41
1657393979697,CSE 15L,A02,083655,Morris; Justin Loren,9,0,50,41
1657393985723,CSE 20,A01,083657,Tran; Khoa Dang,39,0,80,41
1657393991846,CSE 21,A01,095574,Bach; Quang Tran,22,0,48,26
1657393997869,CSE 30,A01,083084,Eldon; John,4,0,80,76
1657393997869,CSE 30,B01,095061,Bhaskar; Nishant,9,0,50,41
1657394003892,CSE 100,A01,083659,Cao; Yingjun,5,4,70,65
1657394009914,CSE 134B,A01,083661,Powell; Thomas Allan,22,0,100,78
1657394015936,CSE 140,A01,083663,Gungor; Onat,14,0,85,71
1657394021963,CSE 140L,A01,083088,Eldon; John,21,0,100,79
1657394028000,CSE 175,A01,083665,Kumar; Rakesh,3,0,25,22
1657394034027,CSE 190,A00,092507,Dubnov; Shlomo,7,0,20,13
1657394040060,ECE 45,A01,083139,Congero; Spencer William,6,0,75,69
1657394046088,ECE 65,A50,083695,Saad; Andrew S,12,0,30,18
1657394046088,ECE 65,A51,095125,Saad; Andrew S,24,0,26,2
1657394052114,ECE 109,A01,091882,Touri; Behrouz,19,0,70,51
1657394058141,ECE 180,A00,083140,Abi Samra; Nicholas Camill,1,0,30,29
1657394058141,ECE 180,B00,083141,Abi Samra; Nicholas Camill,0,0,30,30
1657394064169,MATH 10A,A01,083735,Patchell; Gregory David,2,0,30,28
1657394064169,MATH 10A,A02,083736,Patchell; Gregory David,20,0,30,10
1657394064169,MATH 10A,A03,083737,Patchell; Gregory David,16,0,30,14
1657394070192,MATH 10B,A01,083207,Lim; Seonhee,8,0,34,26
1657394070192,MATH 10B,A02,083208,Lim; Seonhee,9,0,35,26
1657394070192,MATH 10B,A03,093472,Lim; Seonhee,7,0,34,27
1657394070192,MATH 10B,B01,083739,Sinha; Shubham,12,0,30,18
1657394076224,MATH 18,A01,083743,Cinel; Cameron Alexander,7,0,30,23
1657394076224,MATH 18,A02,083744,Cinel; Cameron Alexander,17,0,30,13
1657394076224,MATH 18,A03,083745,Cinel; Cameron Alexander,9,0,30,21
1657394076224,MATH 18,B01,083748,Rideout; David Porter,5,0,37,32
1657394076224,MATH 18,B02,083749,Rideout; David Porter,5,0,36,31
1657394076224,MATH 18,B03,083750,Rideout; David Porter,3,0,37,34
1657394076224,MATH 18,B04,083751,Rideout; David Porter,6,0,36,30
1657394076224,MATH 18,B05,093473,Rideout; David Porter,6,0,36,30
1657394076224,MATH 18,B06,093474,Rideout; David Porter,6,0,36,30
1657394082256,MATH 20A,A01,083754,Zheng; Zequn,14,0,40,26
1657394088284,MATH 20B,A01,083756,Briones; Jor-el Thomas Caparas,4,0,36,32
1657394088284,MATH 20B,A02,083757,Briones; Jor-el Thomas Caparas,1,0,36,35
1657394088284,MATH 20B,A03,093475,Briones; Jor-el Thomas Caparas,2,0,36,34
1657394094308,MATH 20C,A01,083760,Briones; Jor-el Thomas Caparas,1,0,35,34
1657394094308,MATH 20C,A02,083761,Briones; Jor-el Thomas Caparas,8,0,35,27
1657394094308,MATH 20C,A03,093476,Briones; Jor-el Thomas Caparas,0,1,36,36
1657394094308,MATH 20C,B01,083762,Bach; Quang Tran,1,0,30,29
1657394100335,MATH 20D,A01,083765,Tran; Brian Kha,5,0,30,25
1657394100335,MATH 20D,A02,083766,Tran; Brian Kha,5,0,30,25
1657394100335,MATH 20D,A03,083767,Tran; Brian Kha,5,0,30,25
1657394106364,MATH 20E,A01,083771,Ganguly; Soumya,9,0,32,23
1657394106364,MATH 20E,A02,083772,Ganguly; Soumya,6,0,32,26
1657394106364,MATH 20E,B01,083773,Ciotti; Benjamin,20,0,35,15
1657394106364,MATH 20E,B02,083774,Ciotti; Benjamin,17,0,35,18
1657394112393,MATH 103A,A01,083777,Greenfeld; Be'Eri,3,0,36,33
1657394112393,MATH 103A,A02,083778,Greenfeld; Be'Eri,5,0,36,31
1657394112393,MATH 103A,A03,093561,Greenfeld; Be'Eri,5,0,36,31
1657394112393,MATH 103A,B01,083779,Greenfeld; Be'Eri,7,0,36,29
1657394112393,MATH 103A,B02,083780,Greenfeld; Be'Eri,4,0,36,32
1657394112393,MATH 103A,B03,093562,Greenfeld; Be'Eri,3,0,36,33
1657394118420,MATH 105,A01,085443,Carter; Anne Toulson,15,0,35,20
1657394118420,MATH 105,A02,093477,Carter; Anne Toulson,20,0,35,15
1657394124443,MATH 109,A01,083213,Ganzberger; Geoffrey Michael,2,0,34,32
1657394124443,MATH 109,A02,083214,Ganzberger; Geoffrey Michael,4,0,34,30
1657394124443,MATH 109,A03,093478,Ganzberger; Geoffrey Michael,2,0,34,32
1657394124443,MATH 109,B01,083215,Ganzberger; Geoffrey Michael,1,0,32,31
1657394124443,MATH 109,B02,083216,Ganzberger; Geoffrey Michael,2,0,32,30
1657394124443,MATH 109,B03,093479,Ganzberger; Geoffrey Michael,8,0,32,24
1657394130471,MATH 142A,A01,083219,Chow; Bennett,7,0,32,25
1657394130471,MATH 142A,A02,083220,Chow; Bennett,10,0,32,22
1657394130471,MATH 142A,A03,093480,Chow; Bennett,8,0,32,24
1657394130471,MATH 142A,B03,093481,Chow; Bennett,8,0,32,24
1657394130471,MATH 142A,B04,093558,Chow; Bennett,13,0,32,19
1657394130471,MATH 142A,B05,093559,Chow; Bennett,6,0,32,26
1657394136496,MATH 193A,A01,083224,Rotar; Vladimir,8,0,34,26
1657394136496,MATH 193A,A02,083225,Rotar; Vladimir,9,0,34,25
1657394136496,MATH 193A,A03,083781,Rotar; Vladimir,5,0,34,29
1657394136496,MATH 193A,A04,083782,Rotar; Vladimir,10,0,34,24
1657394136496,MATH 193A,A05,093482,Rotar; Vladimir,10,0,34,24
1657394142524,MATH 197,001,091859,McAuley; Julian John,9999,0,9999,0
1657394142524,MATH 197,002,095566,Kedlaya; Kiran S.,9997,0,9999,2
1657394142524,MATH 197,003,095567,Xiao; Ming,9999,0,9999,0
1657394142524,MATH 197,004,095571,Perols; Johan Lars,9998,0,9999,1
1657394149584,COGS 9,A01,083615,Shannon; Kyle Michael,9,0,75,66
1657394155608,COGS 11,A01,083617,Boyle; Mary E. T.,22,0,48,26
1657394161634,COGS 13,A01,083071,Bastos; Amalia Pinkusfeld,11,0,71,60
1657394167660,COGS 14A,A01,092681,Semenuks; Arturs,4,1,100,96
1657394173697,COGS 14B,A01,083073,Cheng; Tzu-Han,6,0,63,57
1657394179724,COGS 17,A01,092677,Semenuks; Arturs,6,0,81,75
1657394185750,COGS 100,A01,083619,Allen; Michael Gordon,17,0,70,53
1657394191778,COGS 101A,A01,083621,Davis; Joshua Daniel,9,0,68,59
1657394197815,COGS 101B,A01,091572,Allen; Michael Gordon,11,0,65,54
1657394203837,COGS 101C,A01,083625,Delgado; Tania,17,0,35,18
1657394209863,COGS 107A,A01,083627,Boyle; Mary E. T.,13,0,60,47
1657394215887,COGS 118A,A01,083075,Gupta; Anjum,20,0,76,56
1657394221910,CSE 3,A50,083646,Miranda; Gregory Joseph,24,0,50,26
1657394227941,CSE 8A,A50,083650,Miranda; Gregory Joseph,17,1,56,39
1657394233966,CSE 11,A01,083080,Cao; Yingjun,6,15,40,34
1657394239989,CSE 12,A01,083652,Krause-Levy; Sophia Louisa,28,1,120,92
1657394246011,CSE 15L,A01,083654,Morris; Justin Loren,9,0,50,41
1657394246011,CSE 15L,A02,083655,Morris; Justin Loren,9,0,50,41
1657394252035,CSE 20,A01,083657,Tran; Khoa Dang,39,0,80,41
1657394258066,CSE 21,A01,095574,Bach; Quang Tran,22,0,48,26
1657394264094,CSE 30,A01,083084,Eldon; John,4,0,80,76
1657394264094,CSE 30,B01,095061,Bhaskar; Nishant,9,0,50,41
1657394270117,CSE 100,A01,083659,Cao; Yingjun,5,4,70,65
1657394276144,CSE 134B,A01,083661,Powell; Thomas Allan,22,0,100,78
1657394282165,CSE 140,A01,083663,Gungor; Onat,14,0,85,71
1657394288191,CSE 140L,A01,083088,Eldon; John,21,0,100,79
1657394294214,CSE 175,A01,083665,Kumar; Rakesh,3,0,25,22
1657394300240,CSE 190,A00,092507,Dubnov; Shlomo,7,0,20,13
1657394306262,ECE 45,A01,083139,Congero; Spencer William,6,0,75,69
1657394312285,ECE 65,A50,083695,Saad; Andrew S,12,0,30,18
1657394312285,ECE 65,A51,095125,Saad; Andrew S,24,0,26,2
1657394318321,ECE 109,A01,091882,Touri; Behrouz,19,0,70,51
1657394324345,ECE 180,A00,083140,Abi Samra; Nicholas Camill,1,0,30,29
1657394324345,ECE 180,B00,083141,Abi Samra; Nicholas Camill,0,0,30,30
1657394330375,MATH 10A,A01,083735,Patchell; Gregory David,2,0,30,28
1657394330375,MATH 10A,A02,083736,Patchell; Gregory David,20,0,30,10
1657394330375,MATH 10A,A03,083737,Patchell; Gregory David,16,0,30,14
1657394336397,MATH 10B,A01,083207,Lim; Seonhee,8,0,34,26
1657394336397,MATH 10B,A02,083208,Lim; Seonhee,9,0,35,26
1657394336397,MATH 10B,A03,093472,Lim; Seonhee,7,0,34,27
1657394336397,MATH 10B,B01,083739,Sinha; Shubham,12,0,30,18
1657394342421,MATH 18,A01,083743,Cinel; Cameron Alexander,7,0,30,23
1657394342421,MATH 18,A02,083744,Cinel; Cameron Alexander,17,0,30,13
1657394342421,MATH 18,A03,083745,Cinel; Cameron Alexander,9,0,30,21
1657394342421,MATH 18,B01,083748,Rideout; David Porter,5,0,37,32
1657394342421,MATH 18,B02,083749,Rideout; David Porter,5,0,36,31
1657394342421,MATH 18,B03,083750,Rideout; David Porter,3,0,37,34
1657394342421,MATH 18,B04,083751,Rideout; David Porter,6,0,36,30
1657394342421,MATH 18,B05,093473,Rideout; David Porter,6,0,36,30
1657394342421,MATH 18,B06,093474,Rideout; David Porter,6,0,36,30
1657394348447,MATH 20A,A01,083754,Zheng; Zequn,14,0,40,26
1657394354477,MATH 20B,A01,083756,Briones; Jor-el Thomas Caparas,4,0,36,32
1657394354477,MATH 20B,A02,083757,Briones; Jor-el Thomas Caparas,1,0,36,35
1657394354477,MATH 20B,A03,093475,Briones; Jor-el Thomas Caparas,2,0,36,34
1657394360504,MATH 20C,A01,083760,Briones; Jor-el Thomas Caparas,1,0,35,34
1657394360504,MATH 20C,A02,083761,Briones; Jor-el Thomas Caparas,8,0,35,27
1657394360504,MATH 20C,A03,093476,Briones; Jor-el Thomas Caparas,0,1,36,36
1657394360504,MATH 20C,B01,083762,Bach; Quang Tran,1,0,30,29
1657394366527,MATH 20D,A01,083765,Tran; Brian Kha,5,0,30,25
1657394366527,MATH 20D,A02,083766,Tran; Brian Kha,5,0,30,25
1657394366527,MATH 20D,A03,083767,Tran; Brian Kha,5,0,30,25
1657394372554,MATH 20E,A01,083771,Ganguly; Soumya,9,0,32,23
1657394372554,MATH 20E,A02,083772,Ganguly; Soumya,6,0,32,26
1657394372554,MATH 20E,B01,083773,Ciotti; Benjamin,20,0,35,15
1657394372554,MATH 20E,B02,083774,Ciotti; Benjamin,17,0,35,18
1657394378584,MATH 103A,A01,083777,Greenfeld; Be'Eri,3,0,36,33
1657394378584,MATH 103A,A02,083778,Greenfeld; Be'Eri,5,0,36,31
1657394378584,MATH 103A,A03,093561,Greenfeld; Be'Eri,5,0,36,31
1657394378584,MATH 103A,B01,083779,Greenfeld; Be'Eri,7,0,36,29
1657394378584,MATH 103A,B02,083780,Greenfeld; Be'Eri,4,0,36,32
1657394378584,MATH 103A,B03,093562,Greenfeld; Be'Eri,3,0,36,33
1657394384607,MATH 105,A01,085443,Carter; Anne Toulson,15,0,35,20
1657394384607,MATH 105,A02,093477,Carter; Anne Toulson,20,0,35,15
1657394390636,MATH 109,A01,083213,Ganzberger; Geoffrey Michael,2,0,34,32
1657394390636,MATH 109,A02,083214,Ganzberger; Geoffrey Michael,4,0,34,30
1657394390636,MATH 109,A03,093478,Ganzberger; Geoffrey Michael,2,0,34,32
1657394390636,MATH 109,B01,083215,Ganzberger; Geoffrey Michael,1,0,32,31
1657394390636,MATH 109,B02,083216,Ganzberger; Geoffrey Michael,2,0,32,30
1657394390636,MATH 109,B03,093479,Ganzberger; Geoffrey Michael,8,0,32,24
1657394396659,MATH 142A,A01,083219,Chow; Bennett,7,0,32,25
1657394396659,MATH 142A,A02,083220,Chow; Bennett,10,0,32,22
1657394396659,MATH 142A,A03,093480,Chow; Bennett,8,0,32,24
1657394396659,MATH 142A,B03,093481,Chow; Bennett,8,0,32,24
1657394396659,MATH 142A,B04,093558,Chow; Bennett,13,0,32,19
1657394396659,MATH 142A,B05,093559,Chow; Bennett,6,0,32,26
1657394402692,MATH 193A,A01,083224,Rotar; Vladimir,8,0,34,26
1657394402692,MATH 193A,A02,083225,Rotar; Vladimir,9,0,34,25
1657394402692,MATH 193A,A03,083781,Rotar; Vladimir,5,0,34,29
1657394402692,MATH 193A,A04,083782,Rotar; Vladimir,10,0,34,24
1657394402692,MATH 193A,A05,093482,Rotar; Vladimir,10,0,34,24
1657394408726,MATH 197,001,091859,McAuley; Julian John,9999,0,9999,0
1657394408726,MATH 197,002,095566,Kedlaya; Kiran S.,9997,0,9999,2
1657394408726,MATH 197,003,095567,Xiao; Ming,9999,0,9999,0
1657394408726,MATH 197,004,095571,Perols; Johan Lars,9998,0,9999,1
1657394415792,COGS 9,A01,083615,Shannon; Kyle Michael,9,0,75,66
1657394421825,COGS 11,A01,083617,Boyle; Mary E. T.,22,0,48,26
1657394427849,COGS 13,A01,083071,Bastos; Amalia Pinkusfeld,11,0,71,60
1657394433876,COGS 14A,A01,092681,Semenuks; Arturs,4,1,100,96
1657394439898,COGS 14B,A01,083073,Cheng; Tzu-Han,6,0,63,57
1657394445922,COGS 17,A01,092677,Semenuks; Arturs,6,0,81,75
1657394451945,COGS 100,A01,083619,Allen; Michael Gordon,17,0,70,53
1657394457967,COGS 101A,A01,083621,Davis; Joshua Daniel,9,0,68,59
1657394463992,COGS 101B,A01,091572,Allen; Michael Gordon,11,0,65,54
1657394470019,COGS 101C,A01,083625,Delgado; Tania,17,0,35,18
1657394476047,COGS 107A,A01,083627,Boyle; Mary E. T.,13,0,60,47
1657394482075,COGS 118A,A01,083075,Gupta; Anjum,20,0,76,56
1657394488097,CSE 3,A50,083646,Miranda; Gregory Joseph,24,0,50,26
1657394494121,CSE 8A,A50,083650,Miranda; Gregory Joseph,17,1,56,39
1657394500145,CSE 11,A01,083080,Cao; Yingjun,6,15,40,34
1657394506172,CSE 12,A01,083652,Krause-Levy; Sophia Louisa,28,1,120,92
1657394512198,CSE 15L,A01,083654,Morris; Justin Loren,9,0,50,41
1657394512198,CSE 15L,A02,083655,Morris; Justin Loren,9,0,50,41
1657394518225,CSE 20,A01,083657,Tran; Khoa Dang,39,0,80,41
1657394524253,CSE 21,A01,095574,Bach; Quang Tran,22,0,48,26
1657394530284,CSE 30,A01,083084,Eldon; John,4,0,80,76
1657394530284,CSE 30,B01,095061,Bhaskar; Nishant,9,0,50,41
1657394536310,CSE 100,A01,083659,Cao; Yingjun,5,4,70,65
1657394542332,CSE 134B,A01,083661,Powell; Thomas Allan,22,0,100,78
1657394548355,CSE 140,A01,083663,Gungor; Onat,14,0,85,71
1657394554377,CSE 140L,A01,083088,Eldon; John,21,0,100,79
1657394560404,CSE 175,A01,083665,Kumar; Rakesh,3,0,25,22
1657394566429,CSE 190,A00,092507,Dubnov; Shlomo,7,0,20,13
1657394572459,ECE 45,A01,083139,Congero; Spencer William,6,0,75,69
1657394578487,ECE 65,A50,083695,Saad; Andrew S,12,0,30,18
1657394578487,ECE 65,A51,095125,Saad; Andrew S,24,0,26,2
1657394584509,ECE 109,A01,091882,Touri; Behrouz,19,0,70,51
1657394590612,ECE 180,A00,083140,Abi Samra; Nicholas Camill,1,0,30,29
1657394590612,ECE 180,B00,083141,Abi Samra; Nicholas Camill,0,0,30,30
1657394596637,MATH 10A,A01,083735,Patchell; Gregory David,2,0,30,28
1657394596637,MATH 10A,A02,083736,Patchell; Gregory David,20,0,30,10
1657394596637,MATH 10A,A03,083737,Patchell; Gregory David,16,0,30,14
1657394602667,MATH 10B,A01,083207,Lim; Seonhee,8,0,34,26
1657394602667,MATH 10B,A02,083208,Lim; Seonhee,9,0,35,26
1657394602667,MATH 10B,A03,093472,Lim; Seonhee,7,0,34,27
1657394602667,MATH 10B,B01,083739,Sinha; Shubham,12,0,30,18
1657394608692,MATH 18,A01,083743,Cinel; Cameron Alexander,7,0,30,23
1657394608692,MATH 18,A02,083744,Cinel; Cameron Alexander,17,0,30,13
1657394608692,MATH 18,A03,083745,Cinel; Cameron Alexander,9,0,30,21
1657394608692,MATH 18,B01,083748,Rideout; David Porter,5,0,37,32
1657394608692,MATH 18,B02,083749,Rideout; David Porter,5,0,36,31
1657394608692,MATH 18,B03,083750,Rideout; David Porter,3,0,37,34
1657394608692,MATH 18,B04,083751,Rideout; David Porter,6,0,36,30
1657394608692,MATH 18,B05,093473,Rideout; David Porter,6,0,36,30
1657394608692,MATH 18,B06,093474,Rideout; David Porter,6,0,36,30
1657394614730,MATH 20A,A01,083754,Zheng; Zequn,14,0,40,26
1657394620760,MATH 20B,A01,083756,Briones; Jor-el Thomas Caparas,4,0,36,32
1657394620760,MATH 20B,A02,083757,Briones; Jor-el Thomas Caparas,1,0,36,35
1657394620760,MATH 20B,A03,093475,Briones; Jor-el Thomas Caparas,2,0,36,34
1657394626782,MATH 20C,A01,083760,Briones; Jor-el Thomas Caparas,1,0,35,34
1657394626782,MATH 20C,A02,083761,Briones; Jor-el Thomas Caparas,8,0,35,27
1657394626782,MATH 20C,A03,093476,Briones; Jor-el Thomas Caparas,0,1,36,36
1657394626782,MATH 20C,B01,083762,Bach; Quang Tran,1,0,30,29
1657394632806,MATH 20D,A01,083765,Tran; Brian Kha,5,0,30,25
1657394632806,MATH 20D,A02,083766,Tran; Brian Kha,5,0,30,25
1657394632806,MATH 20D,A03,083767,Tran; Brian Kha,5,0,30,25
1657394638829,MATH 20E,A01,083771,Ganguly; Soumya,9,0,32,23
1657394638829,MATH 20E,A02,083772,Ganguly; Soumya,6,0,32,26
1657394638829,MATH 20E,B01,083773,Ciotti; Benjamin,20,0,35,15
1657394638829,MATH 20E,B02,083774,Ciotti; Benjamin,17,0,35,18
1657394644853,MATH 103A,A01,083777,Greenfeld; Be'Eri,3,0,36,33
1657394644853,MATH 103A,A02,083778,Greenfeld; Be'Eri,5,0,36,31
1657394644853,MATH 103A,A03,093561,Greenfeld; Be'Eri,5,0,36,31
1657394644853,MATH 103A,B01,083779,Greenfeld; Be'Eri,7,0,36,29
1657394644853,MATH 103A,B02,083780,Greenfeld; Be'Eri,4,0,36,32
1657394644853,MATH 103A,B03,093562,Greenfeld; Be'Eri,3,0,36,33
1657394650879,MATH 105,A01,085443,Carter; Anne Toulson,15,0,35,20
1657394650879,MATH 105,A02,093477,Carter; Anne Toulson,20,0,35,15
1657394656903,MATH 109,A01,083213,Ganzberger; Geoffrey Michael,2,0,34,32
1657394656903,MATH 109,A02,083214,Ganzberger; Geoffrey Michael,4,0,34,30
1657394656903,MATH 109,A03,093478,Ganzberger; Geoffrey Michael,2,0,34,32
1657394656903,MATH 109,B01,083215,Ganzberger; Geoffrey Michael,1,0,32,31
1657394656903,MATH 109,B02,083216,Ganzberger; Geoffrey Michael,2,0,32,30
1657394656903,MATH 109,B03,093479,Ganzberger; Geoffrey Michael,8,0,32,24
1657394662930,MATH 142A,A01,083219,Chow; Bennett,7,0,32,25
1657394662930,MATH 142A,A02,083220,Chow; Bennett,10,0,32,22
1657394662930,MATH 142A,A03,093480,Chow; Bennett,8,0,32,24
1657394662930,MATH 142A,B03,093481,Chow; Bennett,8,0,32,24
1657394662930,MATH 142A,B04,093558,Chow; Bennett,13,0,32,19
1657394662930,MATH 142A,B05,093559,Chow; Bennett,6,0,32,26
1657394668955,MATH 193A,A01,083224,Rotar; Vladimir,8,0,34,26
1657394668955,MATH 193A,A02,083225,Rotar; Vladimir,9,0,34,25
1657394668955,MATH 193A,A03,083781,Rotar; Vladimir,5,0,34,29
1657394668955,MATH 193A,A04,083782,Rotar; Vladimir,10,0,34,24
1657394668955,MATH 193A,A05,093482,Rotar; Vladimir,10,0,34,24
1657394674979,MATH 197,001,091859,McAuley; Julian John,9999,0,9999,0
1657394674979,MATH 197,002,095566,Kedlaya; Kiran S.,9997,0,9999,2
1657394674979,MATH 197,003,095567,Xiao; Ming,9999,0,9999,0
1657394674979,MATH 197,004,095571,Perols; Johan Lars,9998,0,9999,1
1657394682046,COGS 9,A01,083615,Shannon; Kyle Michael,9,0,75,66
1657394688071,COGS 11,A01,083617,Boyle; Mary E. T.,22,0,48,26
1657394694098,COGS 13,A01,083071,Bastos; Amalia Pinkusfeld,11,0,71,60
1657394700124,COGS 14A,A01,092681,Semenuks; Arturs,4,1,100,96
1657394706148,COGS 14B,A01,083073,Cheng; Tzu-Han,6,0,63,57
1657394712178,COGS 17,A01,092677,Semenuks; Arturs,6,0,81,75
1657394718204,COGS 100,A01,083619,Allen; Michael Gordon,17,0,70,53
1657394724228,COGS 101A,A01,083621,Davis; Joshua Daniel,9,0,68,59
1657394730253,COGS 101B,A01,091572,Allen; Michael Gordon,11,0,65,54
1657394736280,COGS 101C,A01,083625,Delgado; Tania,17,0,35,18
1657394742309,COGS 107A,A01,083627,Boyle; Mary E. T.,13,0,60,47
1657394748344,COGS 118A,A01,083075,Gupta; Anjum,20,0,76,56
1657394754370,CSE 3,A50,083646,Miranda; Gregory Joseph,24,0,50,26
1657394760398,CSE 8A,A50,083650,Miranda; Gregory Joseph,17,1,56,39
1657394766422,CSE 11,A01,083080,Cao; Yingjun,6,15,40,34
1657394772446,CSE 12,A01,083652,Krause-Levy; Sophia Louisa,28,1,120,92
1657394778478,CSE 15L,A01,083654,Morris; Justin Loren,9,0,50,41
1657394778478,CSE 15L,A02,083655,Morris; Justin Loren,9,0,50,41
1657394784504,CSE 20,A01,083657,Tran; Khoa Dang,39,0,80,41
1657394790531,CSE 21,A01,095574,Bach; Quang Tran,22,0,48,26
1657394796554,CSE 30,A01,083084,Eldon; John,4,0,80,76
1657394796554,CSE 30,B01,095061,Bhaskar; Nishant,9,0,50,41
1657394802586,CSE 100,A01,083659,Cao; Yingjun,5,4,70,65
1657394808608,CSE 134B,A01,083661,Powell; Thomas Allan,22,0,100,78
1657394814632,CSE 140,A01,083663,Gungor; Onat,14,0,85,71
1657394820657,CSE 140L,A01,083088,Eldon; John,21,0,100,79
1657394826681,CSE 175,A01,083665,Kumar; Rakesh,3,0,25,22
1657394832706,CSE 190,A00,092507,Dubnov; Shlomo,7,0,20,13
1657394838730,ECE 45,A01,083139,Congero; Spencer William,6,0,75,69
1657394844755,ECE 65,A50,083695,Saad; Andrew S,12,0,30,18
1657394844755,ECE 65,A51,095125,Saad; Andrew S,24,0,26,2
1657394850777,ECE 109,A01,091882,Touri; Behrouz,19,0,70,51
1657394856804,ECE 180,A00,083140,Abi Samra; Nicholas Camill,1,0,30,29
1657394856804,ECE 180,B00,083141,Abi Samra; Nicholas Camill,0,0,30,30
1657394862828,MATH 10A,A01,083735,Patchell; Gregory David,2,0,30,28
1657394862828,MATH 10A,A02,083736,Patchell; Gregory David,20,0,30,10
1657394862828,MATH 10A,A03,083737,Patchell; Gregory David,16,0,30,14
1657394868856,MATH 10B,A01,083207,Lim; Seonhee,8,0,34,26
1657394868856,MATH 10B,A02,083208,Lim; Seonhee,9,0,35,26
1657394868856,MATH 10B,A03,093472,Lim; Seonhee,7,0,34,27
1657394868856,MATH 10B,B01,083739,Sinha; Shubham,12,0,30,18
1657394874879,MATH 18,A01,083743,Cinel; Cameron Alexander,7,0,30,23
1657394874879,MATH 18,A02,083744,Cinel; Cameron Alexander,17,0,30,13
1657394874879,MATH 18,A03,083745,Cinel; Cameron Alexander,9,0,30,21
1657394874879,MATH 18,B01,083748,Rideout; David Porter,5,0,37,32
1657394874879,MATH 18,B02,083749,Rideout; David Porter,5,0,36,31
1657394874879,MATH 18,B03,083750,Rideout; David Porter,3,0,37,34
1657394874879,MATH 18,B04,083751,Rideout; David Porter,6,0,36,30
1657394874879,MATH 18,B05,093473,Rideout; David Porter,6,0,36,30
1657394874879,MATH 18,B06,093474,Rideout; David Porter,6,0,36,30
1657394880905,MATH 20A,A01,083754,Zheng; Zequn,14,0,40,26
1657394886929,MATH 20B,A01,083756,Briones; Jor-el Thomas Caparas,4,0,36,32
1657394886929,MATH 20B,A02,083757,Briones; Jor-el Thomas Caparas,1,0,36,35
1657394886929,MATH 20B,A03,093475,Briones; Jor-el Thomas Caparas,2,0,36,34
1657394892952,MATH 20C,A01,083760,Briones; Jor-el Thomas Caparas,1,0,35,34
1657394892952,MATH 20C,A02,083761,Briones; Jor-el Thomas Caparas,8,0,35,27
1657394892952,MATH 20C,A03,093476,Briones; Jor-el Thomas Caparas,0,1,36,36
1657394892952,MATH 20C,B01,083762,Bach; Quang Tran,1,0,30,29
1657394898979,MATH 20D,A01,083765,Tran; Brian Kha,5,0,30,25
1657394898979,MATH 20D,A02,083766,Tran; Brian Kha,5,0,30,25
1657394898979,MATH 20D,A03,083767,Tran; Brian Kha,5,0,30,25
1657394905007,MATH 20E,A01,083771,Ganguly; Soumya,9,0,32,23
1657394905007,MATH 20E,A02,083772,Ganguly; Soumya,6,0,32,26
1657394905007,MATH 20E,B01,083773,Ciotti; Benjamin,20,0,35,15
1657394905007,MATH 20E,B02,083774,Ciotti; Benjamin,17,0,35,18
1657394911031,MATH 103A,A01,083777,Greenfeld; Be'Eri,3,0,36,33
1657394911031,MATH 103A,A02,083778,Greenfeld; Be'Eri,5,0,36,31
1657394911031,MATH 103A,A03,093561,Greenfeld; Be'Eri,5,0,36,31
1657394911031,MATH 103A,B01,083779,Greenfeld; Be'Eri,7,0,36,29
1657394911031,MATH 103A,B02,083780,Greenfeld; Be'Eri,4,0,36,32
1657394911031,MATH 103A,B03,093562,Greenfeld; Be'Eri,3,0,36,33
1657394917053,MATH 105,A01,085443,Carter; Anne Toulson,15,0,35,20
1657394917053,MATH 105,A02,093477,Carter; Anne Toulson,20,0,35,15
1657394923078,MATH 109,A01,083213,Ganzberger; Geoffrey Michael,2,0,34,32
1657394923078,MATH 109,A02,083214,Ganzberger; Geoffrey Michael,4,0,34,30
1657394923078,MATH 109,A03,093478,Ganzberger; Geoffrey Michael,2,0,34,32
1657394923078,MATH 109,B01,083215,Ganzberger; Geoffrey Michael,1,0,32,31
1657394923078,MATH 109,B02,083216,Ganzberger; Geoffrey Michael,2,0,32,30
1657394923078,MATH 109,B03,093479,Ganzberger; Geoffrey Michael,8,0,32,24
1657394929103,MATH 142A,A01,083219,Chow; Bennett,7,0,32,25
1657394929103,MATH 142A,A02,083220,Chow; Bennett,10,0,32,22
1657394929103,MATH 142A,A03,093480,Chow; Bennett,8,0,32,24
1657394929103,MATH 142A,B03,093481,Chow; Bennett,8,0,32,24
1657394929103,MATH 142A,B04,093558,Chow; Bennett,13,0,32,19
1657394929103,MATH 142A,B05,093559,Chow; Bennett,6,0,32,26
1657394935124,MATH 193A,A01,083224,Rotar; Vladimir,8,0,34,26
1657394935124,MATH 193A,A02,083225,Rotar; Vladimir,9,0,34,25
1657394935124,MATH 193A,A03,083781,Rotar; Vladimir,5,0,34,29
1657394935124,MATH 193A,A04,083782,Rotar; Vladimir,10,0,34,24
1657394935124,MATH 193A,A05,093482,Rotar; Vladimir,10,0,34,24
1657394941148,MATH 197,001,091859,McAuley; Julian John,9999,0,9999,0
1657394941148,MATH 197,002,095566,Kedlaya; Kiran S.,9997,0,9999,2
1657394941148,MATH 197,003,095567,Xiao; Ming,9999,0,9999,0
1657394941148,MATH 197,004,095571,Perols; Johan Lars,9998,0,9999,1
1657394948199,COGS 9,A01,083615,Shannon; Kyle Michael,9,0,75,66
1657394954221,COGS 11,A01,083617,Boyle; Mary E. T.,22,0,48,26
1657394960244,COGS 13,A01,083071,Bastos; Amalia Pinkusfeld,11,0,71,60
1657394966270,COGS 14A,A01,092681,Semenuks; Arturs,4,1,100,96
1657394972293,COGS 14B,A01,083073,Cheng; Tzu-Han,6,0,63,57
1657394978315,COGS 17,A01,092677,Semenuks; Arturs,6,0,81,75
1657394984341,COGS 100,A01,083619,Allen; Michael Gordon,17,0,70,53
1657394990365,COGS 101A,A01,083621,Davis; Joshua Daniel,9,0,68,59
1657394996387,COGS 101B,A01,091572,Allen; Michael Gordon,11,0,65,54
1657395002414,COGS 101C,A01,083625,Delgado; Tania,17,0,35,18
1657395008440,COGS 107A,A01,083627,Boyle; Mary E. T.,13,0,60,47
1657395014462,COGS 118A,A01,083075,Gupta; Anjum,20,0,76,56
1657395020485,CSE 3,A50,083646,Miranda; Gregory Joseph,24,0,50,26
1657395026508,CSE 8A,A50,083650,Miranda; Gregory Joseph,17,1,56,39
1657395032531,CSE 11,A01,083080,Cao; Yingjun,6,15,40,34
1657395038562,CSE 12,A01,083652,Krause-Levy; Sophia Louisa,28,1,120,92
1657395044585,CSE 15L,A01,083654,Morris; Justin Loren,9,0,50,41
1657395044585,CSE 15L,A02,083655,Morris; Justin Loren,9,0,50,41
1657395050612,CSE 20,A01,083657,Tran; Khoa Dang,39,0,80,41
1657395056639,CSE 21,A01,095574,Bach; Quang Tran,22,0,48,26
1657395062669,CSE 30,A01,083084,Eldon; John,4,0,80,76
1657395062669,CSE 30,B01,095061,Bhaskar; Nishant,9,0,50,41
1657395068693,CSE 100,A01,083659,Cao; Yingjun,5,4,70,65
1657395074719,CSE 134B,A01,083661,Powell; Thomas Allan,22,0,100,78
1657395080741,CSE 140,A01,083663,Gungor; Onat,14,0,85,71
1657395086765,CSE 140L,A01,083088,Eldon; John,21,0,100,79
1657395092790,CSE 175,A01,083665,Kumar; Rakesh,3,0,25,22
1657395098813,CSE 190,A00,092507,Dubnov; Shlomo,7,0,20,13
1657395104837,ECE 45,A01,083139,Congero; Spencer William,6,0,75,69
1657395110859,ECE 65,A50,083695,Saad; Andrew S,12,0,30,18
1657395110859,ECE 65,A51,095125,Saad; Andrew S,24,0,26,2
1657395116883,ECE 109,A01,091882,Touri; Behrouz,19,0,70,51
1657395122905,ECE 180,A00,083140,Abi Samra; Nicholas Camill,1,0,30,29
1657395122905,ECE 180,B00,083141,Abi Samra; Nicholas Camill,0,0,30,30
1657395128928,MATH 10A,A01,083735,Patchell; Gregory David,2,0,30,28
1657395128928,MATH 10A,A02,083736,Patchell; Gregory David,20,0,30,10
1657395128928,MATH 10A,A03,083737,Patchell; Gregory David,16,0,30,14
1657395134951,MATH 10B,A01,083207,Lim; Seonhee,8,0,34,26
1657395134951,MATH 10B,A02,083208,Lim; Seonhee,9,0,35,26
1657395134951,MATH 10B,A03,093472,Lim; Seonhee,7,0,34,27
1657395134951,MATH 10B,B01,083739,Sinha; Shubham,12,0,30,18
1657395140976,MATH 18,A01,083743,Cinel; Cameron Alexander,7,0,30,23
1657395140976,MATH 18,A02,083744,Cinel; Cameron Alexander,17,0,30,13
1657395140976,MATH 18,A03,083745,Cinel; Cameron Alexander,9,0,30,21
1657395140976,MATH 18,B01,083748,Rideout; David Porter,5,0,37,32
1657395140976,MATH 18,B02,083749,Rideout; David Porter,5,0,36,31
1657395140976,MATH 18,B03,083750,Rideout; David Porter,3,0,37,34
1657395140976,MATH 18,B04,083751,Rideout; David Porter,6,0,36,30
1657395140976,MATH 18,B05,093473,Rideout; David Porter,6,0,36,30
1657395140976,MATH 18,B06,093474,Rideout; David Porter,6,0,36,30
1657395147006,MATH 20A,A01,083754,Zheng; Zequn,14,0,40,26
1657395153030,MATH 20B,A01,083756,Briones; Jor-el Thomas Caparas,4,0,36,32
1657395153030,MATH 20B,A02,083757,Briones; Jor-el Thomas Caparas,1,0,36,35
1657395153030,MATH 20B,A03,093475,Briones; Jor-el Thomas Caparas,2,0,36,34
1657395159065,MATH 20C,A01,083760,Briones; Jor-el Thomas Caparas,1,0,35,34
1657395159065,MATH 20C,A02,083761,Briones; Jor-el Thomas Caparas,8,0,35,27
1657395159065,MATH 20C,A03,093476,Briones; Jor-el Thomas Caparas,0,1,36,36
1657395159065,MATH 20C,B01,083762,Bach; Quang Tran,1,0,30,29
1657395165093,MATH 20D,A01,083765,Tran; Brian Kha,5,0,30,25
1657395165093,MATH 20D,A02,083766,Tran; Brian Kha,5,0,30,25
1657395165093,MATH 20D,A03,083767,Tran; Brian Kha,5,0,30,25
1657395171116,MATH 20E,A01,083771,Ganguly; Soumya,9,0,32,23
1657395171116,MATH 20E,A02,083772,Ganguly; Soumya,6,0,32,26
1657395171116,MATH 20E,B01,083773,Ciotti; Benjamin,20,0,35,15
1657395171116,MATH 20E,B02,083774,Ciotti; Benjamin,17,0,35,18
1657395177145,MATH 103A,A01,083777,Greenfeld; Be'Eri,3,0,36,33
1657395177145,MATH 103A,A02,083778,Greenfeld; Be'Eri,5,0,36,31
1657395177145,MATH 103A,A03,093561,Greenfeld; Be'Eri,5,0,36,31
1657395177145,MATH 103A,B01,083779,Greenfeld; Be'Eri,7,0,36,29
1657395177145,MATH 103A,B02,083780,Greenfeld; Be'Eri,4,0,36,32
1657395177145,MATH 103A,B03,093562,Greenfeld; Be'Eri,3,0,36,33
1657395183168,MATH 105,A01,085443,Carter; Anne Toulson,15,0,35,20
1657395183168,MATH 105,A02,093477,Carter; Anne Toulson,20,0,35,15
1657395189272,MATH 109,A01,083213,Ganzberger; Geoffrey Michael,2,0,34,32
1657395189272,MATH 109,A02,083214,Ganzberger; Geoffrey Michael,4,0,34,30
1657395189272,MATH 109,A03,093478,Ganzberger; Geoffrey Michael,2,0,34,32
1657395189272,MATH 109,B01,083215,Ganzberger; Geoffrey Michael,1,0,32,31
1657395189272,MATH 109,B02,083216,Ganzberger; Geoffrey Michael,2,0,32,30
1657395189272,MATH 109,B03,093479,Ganzberger; Geoffrey Michael,8,0,32,24
1657395195304,MATH 142A,A01,083219,Chow; Bennett,7,0,32,25
1657395195304,MATH 142A,A02,083220,Chow; Bennett,10,0,32,22
1657395195304,MATH 142A,A03,093480,Chow; Bennett,8,0,32,24
1657395195304,MATH 142A,B03,093481,Chow; Bennett,8,0,32,24
1657395195304,MATH 142A,B04,093558,Chow; Bennett,13,0,32,19
1657395195304,MATH 142A,B05,093559,Chow; Bennett,6,0,32,26
1657395201331,MATH 193A,A01,083224,Rotar; Vladimir,8,0,34,26
1657395201331,MATH 193A,A02,083225,Rotar; Vladimir,9,0,34,25
1657395201331,MATH 193A,A03,083781,Rotar; Vladimir,5,0,34,29
1657395201331,MATH 193A,A04,083782,Rotar; Vladimir,10,0,34,24
1657395201331,MATH 193A,A05,093482,Rotar; Vladimir,10,0,34,24
1657395207354,MATH 197,001,091859,McAuley; Julian John,9999,0,9999,0
1657395207354,MATH 197,002,095566,Kedlaya; Kiran S.,9997,0,9999,2
1657395207354,MATH 197,003,095567,Xiao; Ming,9999,0,9999,0
1657395207354,MATH 197,004,095571,Perols; Johan Lars,9998,0,9999,1
1657395214414,COGS 9,A01,083615,Shannon; Kyle Michael,9,0,75,66
1657395220439,COGS 11,A01,083617,Boyle; Mary E. T.,22,0,48,26
1657395226462,COGS 13,A01,083071,Bastos; Amalia Pinkusfeld,11,0,71,60
1657395232489,COGS 14A,A01,092681,Semenuks; Arturs,4,1,100,96
1657395238515,COGS 14B,A01,083073,Cheng; Tzu-Han,6,0,63,57
1657395244537,COGS 17,A01,092677,Semenuks; Arturs,6,0,81,75
1657395250565,COGS 100,A01,083619,Allen; Michael Gordon,17,0,70,53
1657395256588,COGS 101A,A01,083621,Davis; Joshua Daniel,9,0,68,59
1657395262615,COGS 101B,A01,091572,Allen; Michael Gordon,11,0,65,54
1657395268640,COGS 101C,A01,083625,Delgado; Tania,17,0,35,18
1657395274663,COGS 107A,A01,083627,Boyle; Mary E. T.,13,0,60,47
1657395280690,COGS 118A,A01,083075,Gupta; Anjum,20,0,76,56
1657395286714,CSE 3,A50,083646,Miranda; Gregory Joseph,24,0,50,26
1657395292735,CSE 8A,A50,083650,Miranda; Gregory Joseph,17,1,56,39
1657395298759,CSE 11,A01,083080,Cao; Yingjun,6,15,40,34
1657395304784,CSE 12,A01,083652,Krause-Levy; Sophia Louisa,28,1,120,92
1657395310806,CSE 15L,A01,083654,Morris; Justin Loren,9,0,50,41
1657395310806,CSE 15L,A02,083655,Morris; Justin Loren,9,0,50,41
1657395316834,CSE 20,A01,083657,Tran; Khoa Dang,39,0,80,41
1657395322864,CSE 21,A01,095574,Bach; Quang Tran,22,0,48,26
1657395328896,CSE 30,A01,083084,Eldon; John,4,0,80,76
1657395328896,CSE 30,B01,095061,Bhaskar; Nishant,9,0,50,41
1657395334920,CSE 100,A01,083659,Cao; Yingjun,5,4,70,65
1657395340944,CSE 134B,A01,083661,Powell; Thomas Allan,22,0,100,78
1657395346979,CSE 140,A01,083663,Gungor; Onat,14,0,85,71
1657395353003,CSE 140L,A01,083088,Eldon; John,21,0,100,79
1657395359032,CSE 175,A01,083665,Kumar; Rakesh,3,0,25,22
1657395365054,CSE 190,A00,092507,Dubnov; Shlomo,7,0,20,13
1657395371082,ECE 45,A01,083139,Congero; Spencer William,6,0,75,69
1657395377112,ECE 65,A50,083695,Saad; Andrew S,12,0,30,18
1657395377112,ECE 65,A51,095125,Saad; Andrew S,24,0,26,2
1657395383135,ECE 109,A01,091882,Touri; Behrouz,19,0,70,51
1657395389159,ECE 180,A00,083140,Abi Samra; Nicholas Camill,1,0,30,29
1657395389159,ECE 180,B00,083141,Abi Samra; Nicholas Camill,0,0,30,30
1657395395184,MATH 10A,A01,083735,Patchell; Gregory David,2,0,30,28
1657395395184,MATH 10A,A02,083736,Patchell; Gregory David,20,0,30,10
1657395395184,MATH 10A,A03,083737,Patchell; Gregory David,16,0,30,14
1657395401208,MATH 10B,A01,083207,Lim; Seonhee,8,0,34,26
1657395401208,MATH 10B,A02,083208,Lim; Seonhee,9,0,35,26
1657395401208,MATH 10B,A03,093472,Lim; Seonhee,7,0,34,27
1657395401208,MATH 10B,B01,083739,Sinha; Shubham,12,0,30,18
1657395407232,MATH 18,A01,083743,Cinel; Cameron Alexander,7,0,30,23
1657395407232,MATH 18,A02,083744,Cinel; Cameron Alexander,17,0,30,13
1657395407232,MATH 18,A03,083745,Cinel; Cameron Alexander,9,0,30,21
1657395407232,MATH 18,B01,083748,Rideout; David Porter,5,0,37,32
1657395407232,MATH 18,B02,083749,Rideout; David Porter,5,0,36,31
1657395407232,MATH 18,B03,083750,Rideout; David Porter,3,0,37,34
1657395407232,MATH 18,B04,083751,Rideout; David Porter,6,0,36,30
1657395407232,MATH 18,B05,093473,Rideout; David Porter,6,0,36,30
1657395407232,MATH 18,B06,093474,Rideout; David Porter,6,0,36,30
1657395413259,MATH 20A,A01,083754,Zheng; Zequn,14,0,40,26
1657395419284,MATH 20B,A01,083756,Briones; Jor-el Thomas Caparas,4,0,36,32
1657395419284,MATH 20B,A02,083757,Briones; Jor-el Thomas Caparas,1,0,36,35
1657395419284,MATH 20B,A03,093475,Briones; Jor-el Thomas Caparas,2,0,36,34
1657395425317,MATH 20C,A01,083760,Briones; Jor-el Thomas Caparas,1,0,35,34
1657395425317,MATH 20C,A02,083761,Briones; Jor-el Thomas Caparas,8,0,35,27
1657395425317,MATH 20C,A03,093476,Briones; Jor-el Thomas Caparas,0,1,36,36
1657395425317,MATH 20C,B01,083762,Bach; Quang Tran,1,0,30,29
1657395431346,MATH 20D,A01,083765,Tran; Brian Kha,5,0,30,25
1657395431346,MATH 20D,A02,083766,Tran; Brian Kha,5,0,30,25
1657395431346,MATH 20D,A03,083767,Tran; Brian Kha,5,0,30,25
1657395437374,MATH 20E,A01,083771,Ganguly; Soumya,9,0,32,23
1657395437374,MATH 20E,A02,083772,Ganguly; Soumya,6,0,32,26
1657395437374,MATH 20E,B01,083773,Ciotti; Benjamin,20,0,35,15
1657395437374,MATH 20E,B02,083774,Ciotti; Benjamin,17,0,35,18
1657395443405,MATH 103A,A01,083777,Greenfeld; Be'Eri,3,0,36,33
1657395443405,MATH 103A,A02,083778,Greenfeld; Be'Eri,5,0,36,31
1657395443405,MATH 103A,A03,093561,Greenfeld; Be'Eri,5,0,36,31
1657395443405,MATH 103A,B01,083779,Greenfeld; Be'Eri,7,0,36,29
1657395443405,MATH 103A,B02,083780,Greenfeld; Be'Eri,4,0,36,32
1657395443405,MATH 103A,B03,093562,Greenfeld; Be'Eri,3,0,36,33
1657395449429,MATH 105,A01,085443,Carter; Anne Toulson,15,0,35,20
1657395449429,MATH 105,A02,093477,Carter; Anne Toulson,20,0,35,15
1657395455453,MATH 109,A01,083213,Ganzberger; Geoffrey Michael,2,0,34,32
1657395455453,MATH 109,A02,083214,Ganzberger; Geoffrey Michael,4,0,34,30
1657395455453,MATH 109,A03,093478,Ganzberger; Geoffrey Michael,2,0,34,32
1657395455453,MATH 109,B01,083215,Ganzberger; Geoffrey Michael,1,0,32,31
1657395455453,MATH 109,B02,083216,Ganzberger; Geoffrey Michael,2,0,32,30
1657395455453,MATH 109,B03,093479,Ganzberger; Geoffrey Michael,8,0,32,24
1657395461482,MATH 142A,A01,083219,Chow; Bennett,7,0,32,25
1657395461482,MATH 142A,A02,083220,Chow; Bennett,10,0,32,22
1657395461482,MATH 142A,A03,093480,Chow; Bennett,8,0,32,24
1657395461482,MATH 142A,B03,093481,Chow; Bennett,8,0,32,24
1657395461482,MATH 142A,B04,093558,Chow; Bennett,13,0,32,19
1657395461482,MATH 142A,B05,093559,Chow; Bennett,6,0,32,26
1657395467521,MATH 193A,A01,083224,Rotar; Vladimir,8,0,34,26
1657395467521,MATH 193A,A02,083225,Rotar; Vladimir,9,0,34,25
1657395467521,MATH 193A,A03,083781,Rotar; Vladimir,5,0,34,29
1657395467521,MATH 193A,A04,083782,Rotar; Vladimir,10,0,34,24
1657395467521,MATH 193A,A05,093482,Rotar; Vladimir,10,0,34,24
1657395473544,MATH 197,001,091859,McAuley; Julian John,9999,0,9999,0
1657395473544,MATH 197,002,095566,Kedlaya; Kiran S.,9997,0,9999,2
1657395473544,MATH 197,003,095567,Xiao; Ming,9999,0,9999,0
1657395473544,MATH 197,004,095571,Perols; Johan Lars,9998,0,9999,1
1657395480600,COGS 9,A01,083615,Shannon; Kyle Michael,9,0,75,66
1657395486630,COGS 11,A01,083617,Boyle; Mary E. T.,22,0,48,26
1657395492652,COGS 13,A01,083071,Bastos; Amalia Pinkusfeld,11,0,71,60
1657395498675,COGS 14A,A01,092681,Semenuks; Arturs,4,1,100,96
1657395504698,COGS 14B,A01,083073,Cheng; Tzu-Han,6,0,63,57
1657395510721,COGS 17,A01,092677,Semenuks; Arturs,6,0,81,75
1657395516745,COGS 100,A01,083619,Allen; Michael Gordon,17,0,70,53
1657395522768,COGS 101A,A01,083621,Davis; Joshua Daniel,9,0,68,59
1657395528791,COGS 101B,A01,091572,Allen; Michael Gordon,11,0,65,54
1657395534817,COGS 101C,A01,083625,Delgado; Tania,17,0,35,18
1657395540845,COGS 107A,A01,083627,Boyle; Mary E. T.,13,0,60,47
1657395546882,COGS 118A,A01,083075,Gupta; Anjum,20,0,76,56
1657395552909,CSE 3,A50,083646,Miranda; Gregory Joseph,24,0,50,26
1657395558933,CSE 8A,A50,083650,Miranda; Gregory Joseph,17,1,56,39
1657395564956,CSE 11,A01,083080,Cao; Yingjun,6,15,40,34
1657395570983,CSE 12,A01,083652,Krause-Levy; Sophia Louisa,28,1,120,92
1657395577007,CSE 15L,A01,083654,Morris; Justin Loren,9,0,50,41
1657395577007,CSE 15L,A02,083655,Morris; Justin Loren,9,0,50,41
1657395583036,CSE 20,A01,083657,Tran; Khoa Dang,39,0,80,41
1657395589063,CSE 21,A01,095574,Bach; Quang Tran,22,0,48,26
1657395595087,CSE 30,A01,083084,Eldon; John,4,0,80,76
1657395595087,CSE 30,B01,095061,Bhaskar; Nishant,9,0,50,41
1657395601115,CSE 100,A01,083659,Cao; Yingjun,5,4,70,65
1657395607138,CSE 134B,A01,083661,Powell; Thomas Allan,22,0,100,78
1657395613162,CSE 140,A01,083663,Gungor; Onat,14,0,85,71
1657395619186,CSE 140L,A01,083088,Eldon; John,21,0,100,79
1657395625228,CSE 175,A01,083665,Kumar; Rakesh,3,0,25,22
1657395631251,CSE 190,A00,092507,Dubnov; Shlomo,7,0,20,13
1657395637278,ECE 45,A01,083139,Congero; Spencer William,6,0,75,69
1657395643304,ECE 65,A50,083695,Saad; Andrew S,12,0,30,18
1657395643304,ECE 65,A51,095125,Saad; Andrew S,24,0,26,2
1657395649328,ECE 109,A01,091882,Touri; Behrouz,19,0,70,51
1657395655353,ECE 180,A00,083140,Abi Samra; Nicholas Camill,1,0,30,29
1657395655353,ECE 180,B00,083141,Abi Samra; Nicholas Camill,0,0,30,30
1657395661380,MATH 10A,A01,083735,Patchell; Gregory David,2,0,30,28
1657395661380,MATH 10A,A02,083736,Patchell; Gregory David,20,0,30,10
1657395661380,MATH 10A,A03,083737,Patchell; Gregory David,16,0,30,14
1657395667410,MATH 10B,A01,083207,Lim; Seonhee,8,0,34,26
1657395667410,MATH 10B,A02,083208,Lim; Seonhee,9,0,35,26
1657395667410,MATH 10B,A03,093472,Lim; Seonhee,7,0,34,27
1657395667410,MATH 10B,B01,083739,Sinha; Shubham,12,0,30,18
1657395673441,MATH 18,A01,083743,Cinel; Cameron Alexander,7,0,30,23
1657395673441,MATH 18,A02,083744,Cinel; Cameron Alexander,17,0,30,13
1657395673441,MATH 18,A03,083745,Cinel; Cameron Alexander,9,0,30,21
1657395673441,MATH 18,B01,083748,Rideout; David Porter,5,0,37,32
1657395673441,MATH 18,B02,083749,Rideout; David Porter,5,0,36,31
1657395673441,MATH 18,B03,083750,Rideout; David Porter,3,0,37,34
1657395673441,MATH 18,B04,083751,Rideout; David Porter,6,0,36,30
1657395673441,MATH 18,B05,093473,Rideout; David Porter,6,0,36,30
1657395673441,MATH 18,B06,093474,Rideout; David Porter,6,0,36,30
1657395679468,MATH 20A,A01,083754,Zheng; Zequn,14,0,40,26
1657395685502,MATH 20B,A01,083756,Briones; Jor-el Thomas Caparas,4,0,36,32
1657395685502,MATH 20B,A02,083757,Briones; Jor-el Thomas Caparas,1,0,36,35
1657395685502,MATH 20B,A03,093475,Briones; Jor-el Thomas Caparas,2,0,36,34
1657395691524,MATH 20C,A01,083760,Briones; Jor-el Thomas Caparas,1,0,35,34
1657395691524,MATH 20C,A02,083761,Briones; Jor-el Thomas Caparas,8,0,35,27
1657395691524,MATH 20C,A03,093476,Briones; Jor-el Thomas Caparas,0,1,36,36
1657395691524,MATH 20C,B01,083762,Bach; Quang Tran,1,0,30,29
1657395697549,MATH 20D,A01,083765,Tran; Brian Kha,5,0,30,25
1657395697549,MATH 20D,A02,083766,Tran; Brian Kha,5,0,30,25
1657395697549,MATH 20D,A03,083767,Tran; Brian Kha,5,0,30,25
1657395703582,MATH 20E,A01,083771,Ganguly; Soumya,9,0,32,23
1657395703582,MATH 20E,A02,083772,Ganguly; Soumya,6,0,32,26
1657395703582,MATH 20E,B01,083773,Ciotti; Benjamin,20,0,35,15
1657395703582,MATH 20E,B02,083774,Ciotti; Benjamin,17,0,35,18
1657395709605,MATH 103A,A01,083777,Greenfeld; Be'Eri,3,0,36,33
1657395709605,MATH 103A,A02,083778,Greenfeld; Be'Eri,5,0,36,31
1657395709605,MATH 103A,A03,093561,Greenfeld; Be'Eri,5,0,36,31
1657395709605,MATH 103A,B01,083779,Greenfeld; Be'Eri,7,0,36,29
1657395709605,MATH 103A,B02,083780,Greenfeld; Be'Eri,4,0,36,32
1657395709605,MATH 103A,B03,093562,Greenfeld; Be'Eri,3,0,36,33
1657395715629,MATH 105,A01,085443,Carter; Anne Toulson,15,0,35,20
1657395715629,MATH 105,A02,093477,Carter; Anne Toulson,20,0,35,15
1657395721658,MATH 109,A01,083213,Ganzberger; Geoffrey Michael,2,0,34,32
1657395721658,MATH 109,A02,083214,Ganzberger; Geoffrey Michael,4,0,34,30
1657395721658,MATH 109,A03,093478,Ganzberger; Geoffrey Michael,2,0,34,32
1657395721658,MATH 109,B01,083215,Ganzberger; Geoffrey Michael,1,0,32,31
1657395721658,MATH 109,B02,083216,Ganzberger; Geoffrey Michael,2,0,32,30
1657395721658,MATH 109,B03,093479,Ganzberger; Geoffrey Michael,8,0,32,24
1657395727685,MATH 142A,A01,083219,Chow; Bennett,7,0,32,25
1657395727685,MATH 142A,A02,083220,Chow; Bennett,10,0,32,22
1657395727685,MATH 142A,A03,093480,Chow; Bennett,8,0,32,24
1657395727685,MATH 142A,B03,093481,Chow; Bennett,8,0,32,24
1657395727685,MATH 142A,B04,093558,Chow; Bennett,13,0,32,19
1657395727685,MATH 142A,B05,093559,Chow; Bennett,6,0,32,26
1657395733714,MATH 193A,A01,083224,Rotar; Vladimir,8,0,34,26
1657395733714,MATH 193A,A02,083225,Rotar; Vladimir,9,0,34,25
1657395733714,MATH 193A,A03,083781,Rotar; Vladimir,5,0,34,29
1657395733714,MATH 193A,A04,083782,Rotar; Vladimir,10,0,34,24
1657395733714,MATH 193A,A05,093482,Rotar; Vladimir,10,0,34,24
1657395739739,MATH 197,001,091859,McAuley; Julian John,9999,0,9999,0
1657395739739,MATH 197,002,095566,Kedlaya; Kiran S.,9997,0,9999,2
1657395739739,MATH 197,003,095567,Xiao; Ming,9999,0,9999,0
1657395739739,MATH 197,004,095571,Perols; Johan Lars,9998,0,9999,1
1657395746791,COGS 9,A01,083615,Shannon; Kyle Michael,9,0,75,66
1657395752818,COGS 11,A01,083617,Boyle; Mary E. T.,22,0,48,26
1657395758842,COGS 13,A01,083071,Bastos; Amalia Pinkusfeld,11,0,71,60
1657395764870,COGS 14A,A01,092681,Semenuks; Arturs,4,1,100,96
1657395770893,COGS 14B,A01,083073,Cheng; Tzu-Han,6,0,63,57
1657395776921,COGS 17,A01,092677,Semenuks; Arturs,6,0,81,75
1657395783019,COGS 100,A01,083619,Allen; Michael Gordon,17,0,70,53
1657395789046,COGS 101A,A01,083621,Davis; Joshua Daniel,9,0,68,59
1657395795069,COGS 101B,A01,091572,Allen; Michael Gordon,11,0,65,54
1657395801092,COGS 101C,A01,083625,Delgado; Tania,17,0,35,18
1657395807116,COGS 107A,A01,083627,Boyle; Mary E. T.,13,0,60,47
1657395813143,COGS 118A,A01,083075,Gupta; Anjum,20,0,76,56
1657395819168,CSE 3,A50,083646,Miranda; Gregory Joseph,24,0,50,26
1657395825195,CSE 8A,A50,083650,Miranda; Gregory Joseph,17,1,56,39
1657395831219,CSE 11,A01,083080,Cao; Yingjun,6,15,40,34
1657395837246,CSE 12,A01,083652,Krause-Levy; Sophia Louisa,28,1,120,92
1657395843271,CSE 15L,A01,083654,Morris; Justin Loren,9,0,50,41
1657395843271,CSE 15L,A02,083655,Morris; Justin Loren,9,0,50,41
1657395849300,CSE 20,A01,083657,Tran; Khoa Dang,39,0,80,41
1657395855323,CSE 21,A01,095574,Bach; Quang Tran,22,0,48,26
1657395861346,CSE 30,A01,083084,Eldon; John,4,0,80,76
1657395861346,CSE 30,B01,095061,Bhaskar; Nishant,9,0,50,41
1657395867372,CSE 100,A01,083659,Cao; Yingjun,5,4,70,65
1657395873410,CSE 134B,A01,083661,Powell; Thomas Allan,22,0,100,78
1657395879433,CSE 140,A01,083663,Gungor; Onat,14,0,85,71
1657395885461,CSE 140L,A01,083088,Eldon; John,21,0,100,79
1657395891493,CSE 175,A01,083665,Kumar; Rakesh,3,0,25,22
1657395897515,CSE 190,A00,092507,Dubnov; Shlomo,7,0,20,13
1657395903539,ECE 45,A01,083139,Congero; Spencer William,6,0,75,69
1657395909566,ECE 65,A50,083695,Saad; Andrew S,12,0,30,18
1657395909566,ECE 65,A51,095125,Saad; Andrew S,24,0,26,2
1657395915589,ECE 109,A01,091882,Touri; Behrouz,19,0,70,51
1657395921625,ECE 180,A00,083140,Abi Samra; Nicholas Camill,1,0,30,29
1657395921625,ECE 180,B00,083141,Abi Samra; Nicholas Camill,0,0,30,30
1657395927649,MATH 10A,A01,083735,Patchell; Gregory David,2,0,30,28
1657395927649,MATH 10A,A02,083736,Patchell; Gregory David,20,0,30,10
1657395927649,MATH 10A,A03,083737,Patchell; Gregory David,16,0,30,14
1657395933677,MATH 10B,A01,083207,Lim; Seonhee,8,0,34,26
1657395933677,MATH 10B,A02,083208,Lim; Seonhee,9,0,35,26
1657395933677,MATH 10B,A03,093472,Lim; Seonhee,7,0,34,27
1657395933677,MATH 10B,B01,083739,Sinha; Shubham,12,0,30,18
1657395939708,MATH 18,A01,083743,Cinel; Cameron Alexander,7,0,30,23
1657395939708,MATH 18,A02,083744,Cinel; Cameron Alexander,17,0,30,13
1657395939708,MATH 18,A03,083745,Cinel; Cameron Alexander,9,0,30,21
1657395939708,MATH 18,B01,083748,Rideout; David Porter,5,0,37,32
1657395939708,MATH 18,B02,083749,Rideout; David Porter,5,0,36,31
1657395939708,MATH 18,B03,083750,Rideout; David Porter,3,0,37,34
1657395939708,MATH 18,B04,083751,Rideout; David Porter,6,0,36,30
1657395939708,MATH 18,B05,093473,Rideout; David Porter,6,0,36,30
1657395939708,MATH 18,B06,093474,Rideout; David Porter,6,0,36,30
1657395945731,MATH 20A,A01,083754,Zheng; Zequn,14,0,40,26
1657395951755,MATH 20B,A01,083756,Briones; Jor-el Thomas Caparas,4,0,36,32
1657395951755,MATH 20B,A02,083757,Briones; Jor-el Thomas Caparas,1,0,36,35
1657395951755,MATH 20B,A03,093475,Briones; Jor-el Thomas Caparas,2,0,36,34
1657395957794,MATH 20C,A01,083760,Briones; Jor-el Thomas Caparas,1,0,35,34
1657395957794,MATH 20C,A02,083761,Briones; Jor-el Thomas Caparas,8,0,35,27
1657395957794,MATH 20C,A03,093476,Briones; Jor-el Thomas Caparas,0,1,36,36
1657395957794,MATH 20C,B01,083762,Bach; Quang Tran,1,0,30,29
1657395963823,MATH 20D,A01,083765,Tran; Brian Kha,5,0,30,25
1657395963823,MATH 20D,A02,083766,Tran; Brian Kha,5,0,30,25
1657395963823,MATH 20D,A03,083767,Tran; Brian Kha,5,0,30,25
1657395969854,MATH 20E,A01,083771,Ganguly; Soumya,9,0,32,23
1657395969854,MATH 20E,A02,083772,Ganguly; Soumya,6,0,32,26
1657395969854,MATH 20E,B01,083773,Ciotti; Benjamin,20,0,35,15
1657395969854,MATH 20E,B02,083774,Ciotti; Benjamin,17,0,35,18
1657395975878,MATH 103A,A01,083777,Greenfeld; Be'Eri,3,0,36,33
1657395975878,MATH 103A,A02,083778,Greenfeld; Be'Eri,5,0,36,31
1657395975878,MATH 103A,A03,093561,Greenfeld; Be'Eri,5,0,36,31
1657395975878,MATH 103A,B01,083779,Greenfeld; Be'Eri,7,0,36,29
1657395975878,MATH 103A,B02,083780,Greenfeld; Be'Eri,4,0,36,32
1657395975878,MATH 103A,B03,093562,Greenfeld; Be'Eri,3,0,36,33
1657395981905,MATH 105,A01,085443,Carter; Anne Toulson,15,0,35,20
1657395981905,MATH 105,A02,093477,Carter; Anne Toulson,20,0,35,15
1657395987929,MATH 109,A01,083213,Ganzberger; Geoffrey Michael,2,0,34,32
1657395987929,MATH 109,A02,083214,Ganzberger; Geoffrey Michael,4,0,34,30
1657395987929,MATH 109,A03,093478,Ganzberger; Geoffrey Michael,2,0,34,32
1657395987929,MATH 109,B01,083215,Ganzberger; Geoffrey Michael,1,0,32,31
1657395987929,MATH 109,B02,083216,Ganzberger; Geoffrey Michael,2,0,32,30
1657395987929,MATH 109,B03,093479,Ganzberger; Geoffrey Michael,8,0,32,24
1657395993959,MATH 142A,A01,083219,Chow; Bennett,7,0,32,25
1657395993959,MATH 142A,A02,083220,Chow; Bennett,10,0,32,22
1657395993959,MATH 142A,A03,093480,Chow; Bennett,8,0,32,24
1657395993959,MATH 142A,B03,093481,Chow; Bennett,8,0,32,24
1657395993959,MATH 142A,B04,093558,Chow; Bennett,13,0,32,19
1657395993959,MATH 142A,B05,093559,Chow; Bennett,6,0,32,26
1657395999988,MATH 193A,A01,083224,Rotar; Vladimir,8,0,34,26
1657395999988,MATH 193A,A02,083225,Rotar; Vladimir,9,0,34,25
1657395999988,MATH 193A,A03,083781,Rotar; Vladimir,5,0,34,29
1657395999988,MATH 193A,A04,083782,Rotar; Vladimir,10,0,34,24
1657395999988,MATH 193A,A05,093482,Rotar; Vladimir,10,0,34,24
1657396006015,MATH 197,001,091859,McAuley; Julian John,9999,0,9999,0
1657396006015,MATH 197,002,095566,Kedlaya; Kiran S.,9997,0,9999,2
1657396006015,MATH 197,003,095567,Xiao; Ming,9999,0,9999,0
1657396006015,MATH 197,004,095571,Perols; Johan Lars,9998,0,9999,1
1657396013084,COGS 9,A01,083615,Shannon; Kyle Michael,9,0,75,66
1657396019111,COGS 11,A01,083617,Boyle; Mary E. T.,22,0,48,26
1657396025139,COGS 13,A01,083071,Bastos; Amalia Pinkusfeld,11,0,71,60
1657396031166,COGS 14A,A01,092681,Semenuks; Arturs,4,1,100,96
1657396037193,COGS 14B,A01,083073,Cheng; Tzu-Han,6,0,63,57
1657396043216,COGS 17,A01,092677,Semenuks; Arturs,6,0,81,75
1657396049240,COGS 100,A01,083619,Allen; Michael Gordon,17,0,70,53
1657396055268,COGS 101A,A01,083621,Davis; Joshua Daniel,9,0,68,59
1657396061291,COGS 101B,A01,091572,Allen; Michael Gordon,11,0,65,54
1657396067316,COGS 101C,A01,083625,Delgado; Tania,17,0,35,18
1657396073338,COGS 107A,A01,083627,Boyle; Mary E. T.,13,0,60,47
1657396079363,COGS 118A,A01,083075,Gupta; Anjum,20,0,76,56
1657396085391,CSE 3,A50,083646,Miranda; Gregory Joseph,24,0,50,26
1657396091421,CSE 8A,A50,083650,Miranda; Gregory Joseph,17,1,56,39
1657396097448,CSE 11,A01,083080,Cao; Yingjun,6,15,40,34
1657396103472,CSE 12,A01,083652,Krause-Levy; Sophia Louisa,28,1,120,92
1657396109499,CSE 15L,A01,083654,Morris; Justin Loren,9,0,50,41
1657396109499,CSE 15L,A02,083655,Morris; Justin Loren,9,0,50,41
1657396115522,CSE 20,A01,083657,Tran; Khoa Dang,39,0,80,41
1657396121549,CSE 21,A01,095574,Bach; Quang Tran,22,0,48,26
1657396127575,CSE 30,A01,083084,Eldon; John,4,0,80,76
1657396127575,CSE 30,B01,095061,Bhaskar; Nishant,9,0,50,41
1657396133600,CSE 100,A01,083659,Cao; Yingjun,5,4,70,65
1657396139628,CSE 134B,A01,083661,Powell; Thomas Allan,22,0,100,78
1657396145649,CSE 140,A01,083663,Gungor; Onat,14,0,85,71
1657396151677,CSE 140L,A01,083088,Eldon; John,21,0,100,79
1657396157704,CSE 175,A01,083665,Kumar; Rakesh,3,0,25,22
1657396163732,CSE 190,A00,092507,Dubnov; Shlomo,7,0,20,13
1657396169770,ECE 45,A01,083139,Congero; Spencer William,6,0,75,69
1657396175794,ECE 65,A50,083695,Saad; Andrew S,12,0,30,18
1657396175794,ECE 65,A51,095125,Saad; Andrew S,24,0,26,2
1657396181818,ECE 109,A01,091882,Touri; Behrouz,19,0,70,51
1657396187846,ECE 180,A00,083140,Abi Samra; Nicholas Camill,1,0,30,29
1657396187846,ECE 180,B00,083141,Abi Samra; Nicholas Camill,0,0,30,30
1657396193870,MATH 10A,A01,083735,Patchell; Gregory David,2,0,30,28
1657396193870,MATH 10A,A02,083736,Patchell; Gregory David,20,0,30,10
1657396193870,MATH 10A,A03,083737,Patchell; Gregory David,16,0,30,14
1657396199893,MATH 10B,A01,083207,Lim; Seonhee,8,0,34,26
1657396199893,MATH 10B,A02,083208,Lim; Seonhee,9,0,35,26
1657396199893,MATH 10B,A03,093472,Lim; Seonhee,7,0,34,27
1657396199893,MATH 10B,B01,083739,Sinha; Shubham,12,0,30,18
1657396205934,MATH 18,A01,083743,Cinel; Cameron Alexander,7,0,30,23
1657396205934,MATH 18,A02,083744,Cinel; Cameron Alexander,17,0,30,13
1657396205934,MATH 18,A03,083745,Cinel; Cameron Alexander,9,0,30,21
1657396205934,MATH 18,B01,083748,Rideout; David Porter,5,0,37,32
1657396205934,MATH 18,B02,083749,Rideout; David Porter,5,0,36,31
1657396205934,MATH 18,B03,083750,Rideout; David Porter,3,0,37,34
1657396205934,MATH 18,B04,083751,Rideout; David Porter,6,0,36,30
1657396205934,MATH 18,B05,093473,Rideout; David Porter,6,0,36,30
1657396205934,MATH 18,B06,093474,Rideout; David Porter,6,0,36,30
1657396211957,MATH 20A,A01,083754,Zheng; Zequn,14,0,40,26
1657396217982,MATH 20B,A01,083756,Briones; Jor-el Thomas Caparas,4,0,36,32
1657396217982,MATH 20B,A02,083757,Briones; Jor-el Thomas Caparas,1,0,36,35
1657396217982,MATH 20B,A03,093475,Briones; Jor-el Thomas Caparas,2,0,36,34
1657396224010,MATH 20C,A01,083760,Briones; Jor-el Thomas Caparas,1,0,35,34
1657396224010,MATH 20C,A02,083761,Briones; Jor-el Thomas Caparas,8,0,35,27
1657396224010,MATH 20C,A03,093476,Briones; Jor-el Thomas Caparas,0,1,36,36
1657396224010,MATH 20C,B01,083762,Bach; Quang Tran,1,0,30,29
1657396230037,MATH 20D,A01,083765,Tran; Brian Kha,5,0,30,25
1657396230037,MATH 20D,A02,083766,Tran; Brian Kha,5,0,30,25
1657396230037,MATH 20D,A03,083767,Tran; Brian Kha,5,0,30,25
1657396236067,MATH 20E,A01,083771,Ganguly; Soumya,9,0,32,23
1657396236067,MATH 20E,A02,083772,Ganguly; Soumya,6,0,32,26
1657396236067,MATH 20E,B01,083773,Ciotti; Benjamin,20,0,35,15
1657396236067,MATH 20E,B02,083774,Ciotti; Benjamin,17,0,35,18
1657396242096,MATH 103A,A01,083777,Greenfeld; Be'Eri,3,0,36,33
1657396242096,MATH 103A,A02,083778,Greenfeld; Be'Eri,5,0,36,31
1657396242096,MATH 103A,A03,093561,Greenfeld; Be'Eri,5,0,36,31
1657396242096,MATH 103A,B01,083779,Greenfeld; Be'Eri,7,0,36,29
1657396242096,MATH 103A,B02,083780,Greenfeld; Be'Eri,4,0,36,32
1657396242096,MATH 103A,B03,093562,Greenfeld; Be'Eri,3,0,36,33
1657396248120,MATH 105,A01,085443,Carter; Anne Toulson,15,0,35,20
1657396248120,MATH 105,A02,093477,Carter; Anne Toulson,20,0,35,15
1657396254142,MATH 109,A01,083213,Ganzberger; Geoffrey Michael,2,0,34,32
1657396254142,MATH 109,A02,083214,Ganzberger; Geoffrey Michael,4,0,34,30
1657396254142,MATH 109,A03,093478,Ganzberger; Geoffrey Michael,2,0,34,32
1657396254142,MATH 109,B01,083215,Ganzberger; Geoffrey Michael,1,0,32,31
1657396254142,MATH 109,B02,083216,Ganzberger; Geoffrey Michael,2,0,32,30
1657396254142,MATH 109,B03,093479,Ganzberger; Geoffrey Michael,8,0,32,24
1657396260166,MATH 142A,A01,083219,Chow; Bennett,7,0,32,25
1657396260166,MATH 142A,A02,083220,Chow; Bennett,10,0,32,22
1657396260166,MATH 142A,A03,093480,Chow; Bennett,8,0,32,24
1657396260166,MATH 142A,B03,093481,Chow; Bennett,8,0,32,24
1657396260166,MATH 142A,B04,093558,Chow; Bennett,13,0,32,19
1657396260166,MATH 142A,B05,093559,Chow; Bennett,6,0,32,26
1657396266195,MATH 193A,A01,083224,Rotar; Vladimir,8,0,34,26
1657396266195,MATH 193A,A02,083225,Rotar; Vladimir,9,0,34,25
1657396266195,MATH 193A,A03,083781,Rotar; Vladimir,5,0,34,29
1657396266195,MATH 193A,A04,083782,Rotar; Vladimir,10,0,34,24
1657396266195,MATH 193A,A05,093482,Rotar; Vladimir,10,0,34,24
1657396272220,MATH 197,001,091859,McAuley; Julian John,9999,0,9999,0
1657396272220,MATH 197,002,095566,Kedlaya; Kiran S.,9997,0,9999,2
1657396272220,MATH 197,003,095567,Xiao; Ming,9999,0,9999,0
1657396272220,MATH 197,004,095571,Perols; Johan Lars,9998,0,9999,1
1657396279273,COGS 9,A01,083615,Shannon; Kyle Michael,9,0,75,66
1657396285302,COGS 11,A01,083617,Boyle; Mary E. T.,22,0,48,26
1657396291330,COGS 13,A01,083071,Bastos; Amalia Pinkusfeld,11,0,71,60
1657396297353,COGS 14A,A01,092681,Semenuks; Arturs,4,1,100,96
1657396303376,COGS 14B,A01,083073,Cheng; Tzu-Han,6,0,63,57
1657396309410,COGS 17,A01,092677,Semenuks; Arturs,6,0,81,75
1657396315433,COGS 100,A01,083619,Allen; Michael Gordon,17,0,70,53
1657396321456,COGS 101A,A01,083621,Davis; Joshua Daniel,9,0,68,59
1657396327482,COGS 101B,A01,091572,Allen; Michael Gordon,11,0,65,54
1657396333508,COGS 101C,A01,083625,Delgado; Tania,17,0,35,18
1657396339531,COGS 107A,A01,083627,Boyle; Mary E. T.,13,0,60,47
1657396345558,COGS 118A,A01,083075,Gupta; Anjum,20,0,76,56
1657396351583,CSE 3,A50,083646,Miranda; Gregory Joseph,24,0,50,26
1657396357608,CSE 8A,A50,083650,Miranda; Gregory Joseph,17,1,56,39
1657396363634,CSE 11,A01,083080,Cao; Yingjun,6,15,40,34
1657396369658,CSE 12,A01,083652,Krause-Levy; Sophia Louisa,28,1,120,92
1657396375686,CSE 15L,A01,083654,Morris; Justin Loren,9,0,50,41
1657396375686,CSE 15L,A02,083655,Morris; Justin Loren,9,0,50,41
1657396381782,CSE 20,A01,083657,Tran; Khoa Dang,39,0,80,41
1657396387805,CSE 21,A01,095574,Bach; Quang Tran,22,0,48,26
1657396393828,CSE 30,A01,083084,Eldon; John,4,0,80,76
1657396393828,CSE 30,B01,095061,Bhaskar; Nishant,9,0,50,41
1657396399853,CSE 100,A01,083659,Cao; Yingjun,5,4,70,65
1657396405876,CSE 134B,A01,083661,Powell; Thomas Allan,22,0,100,78
1657396411899,CSE 140,A01,083663,Gungor; Onat,14,0,85,71
1657396417921,CSE 140L,A01,083088,Eldon; John,21,0,100,79
1657396423944,CSE 175,A01,083665,Kumar; Rakesh,3,0,25,22
1657396429968,CSE 190,A00,092507,Dubnov; Shlomo,7,0,20,13
1657396435996,ECE 45,A01,083139,Congero; Spencer William,6,0,75,69
1657396442019,ECE 65,A50,083695,Saad; Andrew S,12,0,30,18
1657396442019,ECE 65,A51,095125,Saad; Andrew S,24,0,26,2
1657396448048,ECE 109,A01,091882,Touri; Behrouz,19,0,70,51
1657396454076,ECE 180,A00,083140,Abi Samra; Nicholas Camill,1,0,30,29
1657396454076,ECE 180,B00,083141,Abi Samra; Nicholas Camill,0,0,30,30
1657396460101,MATH 10A,A01,083735,Patchell; Gregory David,2,0,30,28
1657396460101,MATH 10A,A02,083736,Patchell; Gregory David,20,0,30,10
1657396460101,MATH 10A,A03,083737,Patchell; Gregory David,16,0,30,14
1657396466126,MATH 10B,A01,083207,Lim; Seonhee,8,0,34,26
1657396466126,MATH 10B,A02,083208,Lim; Seonhee,9,0,35,26
1657396466126,MATH 10B,A03,093472,Lim; Seonhee,7,0,34,27
1657396466126,MATH 10B,B01,083739,Sinha; Shubham,12,0,30,18
1657396472158,MATH 18,A01,083743,Cinel; Cameron Alexander,7,0,30,23
1657396472158,MATH 18,A02,083744,Cinel; Cameron Alexander,17,0,30,13
1657396472158,MATH 18,A03,083745,Cinel; Cameron Alexander,9,0,30,21
1657396472158,MATH 18,B01,083748,Rideout; David Porter,5,0,37,32
1657396472158,MATH 18,B02,083749,Rideout; David Porter,5,0,36,31
1657396472158,MATH 18,B03,083750,Rideout; David Porter,3,0,37,34
1657396472158,MATH 18,B04,083751,Rideout; David Porter,6,0,36,30
1657396472158,MATH 18,B05,093473,Rideout; David Porter,6,0,36,30
1657396472158,MATH 18,B06,093474,Rideout; David Porter,6,0,36,30
1657396478186,MATH 20A,A01,083754,Zheng; Zequn,14,0,40,26
1657396484209,MATH 20B,A01,083756,Briones; Jor-el Thomas Caparas,4,0,36,32
1657396484209,MATH 20B,A02,083757,Briones; Jor-el Thomas Caparas,1,0,36,35
1657396484209,MATH 20B,A03,093475,Briones; Jor-el Thomas Caparas,2,0,36,34
1657396490233,MATH 20C,A01,083760,Briones; Jor-el Thomas Caparas,1,0,35,34
1657396490233,MATH 20C,A02,083761,Briones; Jor-el Thomas Caparas,8,0,35,27
1657396490233,MATH 20C,A03,093476,Briones; Jor-el Thomas Caparas,0,1,36,36
1657396490233,MATH 20C,B01,083762,Bach; Quang Tran,1,0,30,29
1657396496257,MATH 20D,A01,083765,Tran; Brian Kha,5,0,30,25
1657396496257,MATH 20D,A02,083766,Tran; Brian Kha,5,0,30,25
1657396496257,MATH 20D,A03,083767,Tran; Brian Kha,5,0,30,25
1657396502282,MATH 20E,A01,083771,Ganguly; Soumya,9,0,32,23
1657396502282,MATH 20E,A02,083772,Ganguly; Soumya,6,0,32,26
1657396502282,MATH 20E,B01,083773,Ciotti; Benjamin,20,0,35,15
1657396502282,MATH 20E,B02,083774,Ciotti; Benjamin,17,0,35,18
1657396508306,MATH 103A,A01,083777,Greenfeld; Be'Eri,3,0,36,33
1657396508306,MATH 103A,A02,083778,Greenfeld; Be'Eri,5,0,36,31
1657396508306,MATH 103A,A03,093561,Greenfeld; Be'Eri,5,0,36,31
1657396508306,MATH 103A,B01,083779,Greenfeld; Be'Eri,7,0,36,29
1657396508306,MATH 103A,B02,083780,Greenfeld; Be'Eri,4,0,36,32
1657396508306,MATH 103A,B03,093562,Greenfeld; Be'Eri,3,0,36,33
1657396514329,MATH 105,A01,085443,Carter; Anne Toulson,15,0,35,20
1657396514329,MATH 105,A02,093477,Carter; Anne Toulson,20,0,35,15
1657396520357,MATH 109,A01,083213,Ganzberger; Geoffrey Michael,2,0,34,32
1657396520357,MATH 109,A02,083214,Ganzberger; Geoffrey Michael,4,0,34,30
1657396520357,MATH 109,A03,093478,Ganzberger; Geoffrey Michael,2,0,34,32
1657396520357,MATH 109,B01,083215,Ganzberger; Geoffrey Michael,1,0,32,31
1657396520357,MATH 109,B02,083216,Ganzberger; Geoffrey Michael,2,0,32,30
1657396520357,MATH 109,B03,093479,Ganzberger; Geoffrey Michael,8,0,32,24
1657396526384,MATH 142A,A01,083219,Chow; Bennett,7,0,32,25
1657396526384,MATH 142A,A02,083220,Chow; Bennett,10,0,32,22
1657396526384,MATH 142A,A03,093480,Chow; Bennett,8,0,32,24
1657396526384,MATH 142A,B03,093481,Chow; Bennett,8,0,32,24
1657396526384,MATH 142A,B04,093558,Chow; Bennett,13,0,32,19
1657396526384,MATH 142A,B05,093559,Chow; Bennett,6,0,32,26
1657396532412,MATH 193A,A01,083224,Rotar; Vladimir,8,0,34,26
1657396532412,MATH 193A,A02,083225,Rotar; Vladimir,9,0,34,25
1657396532412,MATH 193A,A03,083781,Rotar; Vladimir,5,0,34,29
1657396532412,MATH 193A,A04,083782,Rotar; Vladimir,10,0,34,24
1657396532412,MATH 193A,A05,093482,Rotar; Vladimir,10,0,34,24
1657396538440,MATH 197,001,091859,McAuley; Julian John,9999,0,9999,0
1657396538440,MATH 197,002,095566,Kedlaya; Kiran S.,9997,0,9999,2
1657396538440,MATH 197,003,095567,Xiao; Ming,9999,0,9999,0
1657396538440,MATH 197,004,095571,Perols; Johan Lars,9998,0,9999,1
1657396545497,COGS 9,A01,083615,Shannon; Kyle Michael,9,0,75,66
1657396551523,COGS 11,A01,083617,Boyle; Mary E. T.,22,0,48,26
1657396557546,COGS 13,A01,083071,Bastos; Amalia Pinkusfeld,11,0,71,60
1657396563571,COGS 14A,A01,092681,Semenuks; Arturs,4,1,100,96
1657396569594,COGS 14B,A01,083073,Cheng; Tzu-Han,6,0,63,57
1657396575620,COGS 17,A01,092677,Semenuks; Arturs,6,0,81,75
1657396581643,COGS 100,A01,083619,Allen; Michael Gordon,17,0,70,53
1657396587666,COGS 101A,A01,083621,Davis; Joshua Daniel,9,0,68,59
1657396593689,COGS 101B,A01,091572,Allen; Michael Gordon,11,0,65,54
1657396599719,COGS 101C,A01,083625,Delgado; Tania,17,0,35,18
1657396605746,COGS 107A,A01,083627,Boyle; Mary E. T.,13,0,60,47
1657396611770,COGS 118A,A01,083075,Gupta; Anjum,20,0,76,56
1657396617795,CSE 3,A50,083646,Miranda; Gregory Joseph,24,0,50,26
1657396623820,CSE 8A,A50,083650,Miranda; Gregory Joseph,17,1,56,39
1657396629845,CSE 11,A01,083080,Cao; Yingjun,6,15,40,34
1657396635867,CSE 12,A01,083652,Krause-Levy; Sophia Louisa,28,1,120,92
1657396641891,CSE 15L,A01,083654,Morris; Justin Loren,9,0,50,41
1657396641891,CSE 15L,A02,083655,Morris; Justin Loren,9,0,50,41
1657396647916,CSE 20,A01,083657,Tran; Khoa Dang,39,0,80,41
1657396653944,CSE 21,A01,095574,Bach; Quang Tran,22,0,48,26
1657396659972,CSE 30,A01,083084,Eldon; John,4,0,80,76
1657396659972,CSE 30,B01,095061,Bhaskar; Nishant,9,0,50,41
1657396665998,CSE 100,A01,083659,Cao; Yingjun,5,4,70,65
1657396672026,CSE 134B,A01,083661,Powell; Thomas Allan,22,0,100,78
1657396678053,CSE 140,A01,083663,Gungor; Onat,14,0,85,71
1657396684078,CSE 140L,A01,083088,Eldon; John,21,0,100,79
1657396690104,CSE 175,A01,083665,Kumar; Rakesh,3,0,25,22
1657396696130,CSE 190,A00,092507,Dubnov; Shlomo,7,0,20,13
1657396702155,ECE 45,A01,083139,Congero; Spencer William,6,0,75,69
1657396708179,ECE 65,A50,083695,Saad; Andrew S,12,0,30,18
1657396708179,ECE 65,A51,095125,Saad; Andrew S,24,0,26,2
1657396714224,ECE 109,A01,091882,Touri; Behrouz,19,0,70,51
1657396720251,ECE 180,A00,083140,Abi Samra; Nicholas Camill,1,0,30,29
1657396720251,ECE 180,B00,083141,Abi Samra; Nicholas Camill,0,0,30,30
1657396726275,MATH 10A,A01,083735,Patchell; Gregory David,2,0,30,28
1657396726275,MATH 10A,A02,083736,Patchell; Gregory David,20,0,30,10
1657396726275,MATH 10A,A03,083737,Patchell; Gregory David,16,0,30,14
1657396732301,MATH 10B,A01,083207,Lim; Seonhee,8,0,34,26
1657396732301,MATH 10B,A02,083208,Lim; Seonhee,9,0,35,26
1657396732301,MATH 10B,A03,093472,Lim; Seonhee,7,0,34,27
1657396732301,MATH 10B,B01,083739,Sinha; Shubham,12,0,30,18
1657396738326,MATH 18,A01,083743,Cinel; Cameron Alexander,7,0,30,23
1657396738326,MATH 18,A02,083744,Cinel; Cameron Alexander,17,0,30,13
1657396738326,MATH 18,A03,083745,Cinel; Cameron Alexander,9,0,30,21
1657396738326,MATH 18,B01,083748,Rideout; David Porter,5,0,37,32
1657396738326,MATH 18,B02,083749,Rideout; David Porter,5,0,36,31
1657396738326,MATH 18,B03,083750,Rideout; David Porter,3,0,37,34
1657396738326,MATH 18,B04,083751,Rideout; David Porter,6,0,36,30
1657396738326,MATH 18,B05,093473,Rideout; David Porter,6,0,36,30
1657396738326,MATH 18,B06,093474,Rideout; David Porter,6,0,36,30
1657396744350,MATH 20A,A01,083754,Zheng; Zequn,14,0,40,26
1657396750377,MATH 20B,A01,083756,Briones; Jor-el Thomas Caparas,4,0,36,32
1657396750377,MATH 20B,A02,083757,Briones; Jor-el Thomas Caparas,1,0,36,35
1657396750377,MATH 20B,A03,093475,Briones; Jor-el Thomas Caparas,2,0,36,34
1657396756399,MATH 20C,A01,083760,Briones; Jor-el Thomas Caparas,1,0,35,34
1657396756399,MATH 20C,A02,083761,Briones; Jor-el Thomas Caparas,8,0,35,27
1657396756399,MATH 20C,A03,093476,Briones; Jor-el Thomas Caparas,0,1,36,36
1657396756399,MATH 20C,B01,083762,Bach; Quang Tran,1,0,30,29
1657396762423,MATH 20D,A01,083765,Tran; Brian Kha,5,0,30,25
1657396762423,MATH 20D,A02,083766,Tran; Brian Kha,5,0,30,25
1657396762423,MATH 20D,A03,083767,Tran; Brian Kha,5,0,30,25
1657396768445,MATH 20E,A01,083771,Ganguly; Soumya,9,0,32,23
1657396768445,MATH 20E,A02,083772,Ganguly; Soumya,6,0,32,26
1657396768445,MATH 20E,B01,083773,Ciotti; Benjamin,20,0,35,15
1657396768445,MATH 20E,B02,083774,Ciotti; Benjamin,17,0,35,18
1657396774475,MATH 103A,A01,083777,Greenfeld; Be'Eri,3,0,36,33
1657396774475,MATH 103A,A02,083778,Greenfeld; Be'Eri,5,0,36,31
1657396774475,MATH 103A,A03,093561,Greenfeld; Be'Eri,5,0,36,31
1657396774475,MATH 103A,B01,083779,Greenfeld; Be'Eri,7,0,36,29
1657396774475,MATH 103A,B02,083780,Greenfeld; Be'Eri,4,0,36,32
1657396774475,MATH 103A,B03,093562,Greenfeld; Be'Eri,3,0,36,33
1657396780500,MATH 105,A01,085443,Carter; Anne Toulson,15,0,35,20
1657396780500,MATH 105,A02,093477,Carter; Anne Toulson,20,0,35,15
1657396786529,MATH 109,A01,083213,Ganzberger; Geoffrey Michael,2,0,34,32
1657396786529,MATH 109,A02,083214,Ganzberger; Geoffrey Michael,4,0,34,30
1657396786529,MATH 109,A03,093478,Ganzberger; Geoffrey Michael,2,0,34,32
1657396786529,MATH 109,B01,083215,Ganzberger; Geoffrey Michael,1,0,32,31
1657396786529,MATH 109,B02,083216,Ganzberger; Geoffrey Michael,2,0,32,30
1657396786529,MATH 109,B03,093479,Ganzberger; Geoffrey Michael,8,0,32,24
1657396792553,MATH 142A,A01,083219,Chow; Bennett,7,0,32,25
1657396792553,MATH 142A,A02,083220,Chow; Bennett,10,0,32,22
1657396792553,MATH 142A,A03,093480,Chow; Bennett,8,0,32,24
1657396792553,MATH 142A,B03,093481,Chow; Bennett,8,0,32,24
1657396792553,MATH 142A,B04,093558,Chow; Bennett,13,0,32,19
1657396792553,MATH 142A,B05,093559,Chow; Bennett,6,0,32,26
1657396798585,MATH 193A,A01,083224,Rotar; Vladimir,8,0,34,26
1657396798585,MATH 193A,A02,083225,Rotar; Vladimir,9,0,34,25
1657396798585,MATH 193A,A03,083781,Rotar; Vladimir,5,0,34,29
1657396798585,MATH 193A,A04,083782,Rotar; Vladimir,10,0,34,24
1657396798585,MATH 193A,A05,093482,Rotar; Vladimir,10,0,34,24
1657396804611,MATH 197,001,091859,McAuley; Julian John,9999,0,9999,0
1657396804611,MATH 197,002,095566,Kedlaya; Kiran S.,9997,0,9999,2
1657396804611,MATH 197,003,095567,Xiao; Ming,9999,0,9999,0
1657396804611,MATH 197,004,095571,Perols; Johan Lars,9998,0,9999,1
1657396811677,COGS 9,A01,083615,Shannon; Kyle Michael,9,0,75,66
1657396817700,COGS 11,A01,083617,Boyle; Mary E. T.,22,0,48,26
1657396823723,COGS 13,A01,083071,Bastos; Amalia Pinkusfeld,11,0,71,60
1657396829750,COGS 14A,A01,092681,Semenuks; Arturs,4,1,100,96
1657396835777,COGS 14B,A01,083073,Cheng; Tzu-Han,6,0,63,57
1657396841800,COGS 17,A01,092677,Semenuks; Arturs,6,0,81,75
1657396847824,COGS 100,A01,083619,Allen; Michael Gordon,17,0,70,53
1657396853851,COGS 101A,A01,083621,Davis; Joshua Daniel,9,0,68,59
1657396859873,COGS 101B,A01,091572,Allen; Michael Gordon,11,0,65,54
1657396865901,COGS 101C,A01,083625,Delgado; Tania,17,0,35,18
1657396871924,COGS 107A,A01,083627,Boyle; Mary E. T.,13,0,60,47
1657396877954,COGS 118A,A01,083075,Gupta; Anjum,20,0,76,56
1657396883977,CSE 3,A50,083646,Miranda; Gregory Joseph,24,0,50,26
1657396890000,CSE 8A,A50,083650,Miranda; Gregory Joseph,17,1,56,39
1657396896027,CSE 11,A01,083080,Cao; Yingjun,6,15,40,34
1657396902050,CSE 12,A01,083652,Krause-Levy; Sophia Louisa,28,1,120,92
1657396908076,CSE 15L,A01,083654,Morris; Justin Loren,9,0,50,41
1657396908076,CSE 15L,A02,083655,Morris; Justin Loren,9,0,50,41
1657396914099,CSE 20,A01,083657,Tran; Khoa Dang,39,0,80,41
1657396920124,CSE 21,A01,095574,Bach; Quang Tran,22,0,48,26
1657396926147,CSE 30,A01,083084,Eldon; John,4,0,80,76
1657396926147,CSE 30,B01,095061,Bhaskar; Nishant,9,0,50,41
1657396932173,CSE 100,A01,083659,Cao; Yingjun,5,4,70,65
1657396938197,CSE 134B,A01,083661,Powell; Thomas Allan,22,0,100,78
1657396944221,CSE 140,A01,083663,Gungor; Onat,14,0,85,71
1657396950243,CSE 140L,A01,083088,Eldon; John,21,0,100,79
1657396956267,CSE 175,A01,083665,Kumar; Rakesh,3,0,25,22
1657396962289,CSE 190,A00,092507,Dubnov; Shlomo,7,0,20,13
1657396968311,ECE 45,A01,083139,Congero; Spencer William,6,0,75,69
1657396974342,ECE 65,A50,083695,Saad; Andrew S,12,0,30,18
1657396974342,ECE 65,A51,095125,Saad; Andrew S,24,0,26,2
1657396980440,ECE 109,A01,091882,Touri; Behrouz,19,0,70,51
1657396986463,ECE 180,A00,083140,Abi Samra; Nicholas Camill,1,0,30,29
1657396986463,ECE 180,B00,083141,Abi Samra; Nicholas Camill,0,0,30,30
1657396992494,MATH 10A,A01,083735,Patchell; Gregory David,2,0,30,28
1657396992494,MATH 10A,A02,083736,Patchell; Gregory David,20,0,30,10
1657396992494,MATH 10A,A03,083737,Patchell; Gregory David,16,0,30,14
1657396998516,MATH 10B,A01,083207,Lim; Seonhee,8,0,34,26
1657396998516,MATH 10B,A02,083208,Lim; Seonhee,9,0,35,26
1657396998516,MATH 10B,A03,093472,Lim; Seonhee,7,0,34,27
1657396998516,MATH 10B,B01,083739,Sinha; Shubham,12,0,30,18
1657397004542,MATH 18,A01,083743,Cinel; Cameron Alexander,7,0,30,23
1657397004542,MATH 18,A02,083744,Cinel; Cameron Alexander,17,0,30,13
1657397004542,MATH 18,A03,083745,Cinel; Cameron Alexander,9,0,30,21
1657397004542,MATH 18,B01,083748,Rideout; David Porter,5,0,37,32
1657397004542,MATH 18,B02,083749,Rideout; David Porter,5,0,36,31
1657397004542,MATH 18,B03,083750,Rideout; David Porter,3,0,37,34
1657397004542,MATH 18,B04,083751,Rideout; David Porter,6,0,36,30
1657397004542,MATH 18,B05,093473,Rideout; David Porter,6,0,36,30
1657397004542,MATH 18,B06,093474,Rideout; David Porter,6,0,36,30
1657397010568,MATH 20A,A01,083754,Zheng; Zequn,14,0,40,26
1657397016593,MATH 20B,A01,083756,Briones; Jor-el Thomas Caparas,4,0,36,32
1657397016593,MATH 20B,A02,083757,Briones; Jor-el Thomas Caparas,1,0,36,35
1657397016593,MATH 20B,A03,093475,Briones; Jor-el Thomas Caparas,2,0,36,34
1657397022620,MATH 20C,A01,083760,Briones; Jor-el Thomas Caparas,1,0,35,34
1657397022620,MATH 20C,A02,083761,Briones; Jor-el Thomas Caparas,8,0,35,27
1657397022620,MATH 20C,A03,093476,Briones; Jor-el Thomas Caparas,0,1,36,36
1657397022620,MATH 20C,B01,083762,Bach; Quang Tran,1,0,30,29
1657397028646,MATH 20D,A01,083765,Tran; Brian Kha,5,0,30,25
1657397028646,MATH 20D,A02,083766,Tran; Brian Kha,5,0,30,25
1657397028646,MATH 20D,A03,083767,Tran; Brian Kha,5,0,30,25
1657397034671,MATH 20E,A01,083771,Ganguly; Soumya,9,0,32,23
1657397034671,MATH 20E,A02,083772,Ganguly; Soumya,6,0,32,26
1657397034671,MATH 20E,B01,083773,Ciotti; Benjamin,20,0,35,15
1657397034671,MATH 20E,B02,083774,Ciotti; Benjamin,17,0,35,18
1657397040694,MATH 103A,A01,083777,Greenfeld; Be'Eri,3,0,36,33
1657397040694,MATH 103A,A02,083778,Greenfeld; Be'Eri,5,0,36,31
1657397040694,MATH 103A,A03,093561,Greenfeld; Be'Eri,5,0,36,31
1657397040694,MATH 103A,B01,083779,Greenfeld; Be'Eri,7,0,36,29
1657397040694,MATH 103A,B02,083780,Greenfeld; Be'Eri,4,0,36,32
1657397040694,MATH 103A,B03,093562,Greenfeld; Be'Eri,3,0,36,33
1657397046717,MATH 105,A01,085443,Carter; Anne Toulson,15,0,35,20
1657397046717,MATH 105,A02,093477,Carter; Anne Toulson,20,0,35,15
1657397052742,MATH 109,A01,083213,Ganzberger; Geoffrey Michael,2,0,34,32
1657397052742,MATH 109,A02,083214,Ganzberger; Geoffrey Michael,4,0,34,30
1657397052742,MATH 109,A03,093478,Ganzberger; Geoffrey Michael,2,0,34,32
1657397052742,MATH 109,B01,083215,Ganzberger; Geoffrey Michael,1,0,32,31
1657397052742,MATH 109,B02,083216,Ganzberger; Geoffrey Michael,2,0,32,30
1657397052742,MATH 109,B03,093479,Ganzberger; Geoffrey Michael,8,0,32,24
1657397058766,MATH 142A,A01,083219,Chow; Bennett,7,0,32,25
1657397058766,MATH 142A,A02,083220,Chow; Bennett,10,0,32,22
1657397058766,MATH 142A,A03,093480,Chow; Bennett,8,0,32,24
1657397058766,MATH 142A,B03,093481,Chow; Bennett,8,0,32,24
1657397058766,MATH 142A,B04,093558,Chow; Bennett,13,0,32,19
1657397058766,MATH 142A,B05,093559,Chow; Bennett,6,0,32,26
1657397064790,MATH 193A,A01,083224,Rotar; Vladimir,8,0,34,26
1657397064790,MATH 193A,A02,083225,Rotar; Vladimir,9,0,34,25
1657397064790,MATH 193A,A03,083781,Rotar; Vladimir,5,0,34,29
1657397064790,MATH 193A,A04,083782,Rotar; Vladimir,10,0,34,24
1657397064790,MATH 193A,A05,093482,Rotar; Vladimir,10,0,34,24
1657397070816,MATH 197,001,091859,McAuley; Julian John,9999,0,9999,0
1657397070816,MATH 197,002,095566,Kedlaya; Kiran S.,9997,0,9999,2
1657397070816,MATH 197,003,095567,Xiao; Ming,9999,0,9999,0
1657397070816,MATH 197,004,095571,Perols; Johan Lars,9998,0,9999,1
1657397077879,COGS 9,A01,083615,Shannon; Kyle Michael,9,0,75,66
1657397083902,COGS 11,A01,083617,Boyle; Mary E. T.,22,0,48,26
1657397089929,COGS 13,A01,083071,Bastos; Amalia Pinkusfeld,11,0,71,60
1657397095955,COGS 14A,A01,092681,Semenuks; Arturs,4,1,100,96
1657397101987,COGS 14B,A01,083073,Cheng; Tzu-Han,6,0,63,57
1657397108014,COGS 17,A01,092677,Semenuks; Arturs,6,0,81,75
1657397114041,COGS 100,A01,083619,Allen; Michael Gordon,17,0,70,53
1657397120064,COGS 101A,A01,083621,Davis; Joshua Daniel,9,0,68,59
1657397126089,COGS 101B,A01,091572,Allen; Michael Gordon,11,0,65,54
1657397132114,COGS 101C,A01,083625,Delgado; Tania,17,0,35,18
1657397138140,COGS 107A,A01,083627,Boyle; Mary E. T.,13,0,60,47
1657397144168,COGS 118A,A01,083075,Gupta; Anjum,20,0,76,56
1657397150190,CSE 3,A50,083646,Miranda; Gregory Joseph,24,0,50,26
1657397156213,CSE 8A,A50,083650,Miranda; Gregory Joseph,17,1,56,39
1657397162235,CSE 11,A01,083080,Cao; Yingjun,6,15,40,34
1657397168257,CSE 12,A01,083652,Krause-Levy; Sophia Louisa,28,1,120,92
1657397174284,CSE 15L,A01,083654,Morris; Justin Loren,9,0,50,41
1657397174284,CSE 15L,A02,083655,Morris; Justin Loren,9,0,50,41
1657397180308,CSE 20,A01,083657,Tran; Khoa Dang,39,0,80,41
1657397186331,CSE 21,A01,095574,Bach; Quang Tran,22,0,48,26
1657397192358,CSE 30,A01,083084,Eldon; John,4,0,80,76
1657397192358,CSE 30,B01,095061,Bhaskar; Nishant,9,0,50,41
1657397198385,CSE 100,A01,083659,Cao; Yingjun,5,4,70,65
1657397204412,CSE 134B,A01,083661,Powell; Thomas Allan,22,0,100,78
1657397210437,CSE 140,A01,083663,Gungor; Onat,14,0,85,71
1657397216464,CSE 140L,A01,083088,Eldon; John,21,0,100,79
1657397222487,CSE 175,A01,083665,Kumar; Rakesh,3,0,25,22
1657397228509,CSE 190,A00,092507,Dubnov; Shlomo,7,0,20,13
1657397234533,ECE 45,A01,083139,Congero; Spencer William,6,0,75,69
1657397240559,ECE 65,A50,083695,Saad; Andrew S,12,0,30,18
1657397240559,ECE 65,A51,095125,Saad; Andrew S,24,0,26,2
1657397246585,ECE 109,A01,091882,Touri; Behrouz,19,0,70,51
1657397252613,ECE 180,A00,083140,Abi Samra; Nicholas Camill,1,0,30,29
1657397252613,ECE 180,B00,083141,Abi Samra; Nicholas Camill,0,0,30,30
1657397258638,MATH 10A,A01,083735,Patchell; Gregory David,2,0,30,28
1657397258638,MATH 10A,A02,083736,Patchell; Gregory David,20,0,30,10
1657397258638,MATH 10A,A03,083737,Patchell; Gregory David,16,0,30,14
1657397264662,MATH 10B,A01,083207,Lim; Seonhee,8,0,34,26
1657397264662,MATH 10B,A02,083208,Lim; Seonhee,9,0,35,26
1657397264662,MATH 10B,A03,093472,Lim; Seonhee,7,0,34,27
1657397264662,MATH 10B,B01,083739,Sinha; Shubham,12,0,30,18
1657397270686,MATH 18,A01,083743,Cinel; Cameron Alexander,7,0,30,23
1657397270686,MATH 18,A02,083744,Cinel; Cameron Alexander,17,0,30,13
1657397270686,MATH 18,A03,083745,Cinel; Cameron Alexander,9,0,30,21
1657397270686,MATH 18,B01,083748,Rideout; David Porter,5,0,37,32
1657397270686,MATH 18,B02,083749,Rideout; David Porter,5,0,36,31
1657397270686,MATH 18,B03,083750,Rideout; David Porter,3,0,37,34
1657397270686,MATH 18,B04,083751,Rideout; David Porter,6,0,36,30
1657397270686,MATH 18,B05,093473,Rideout; David Porter,6,0,36,30
1657397270686,MATH 18,B06,093474,Rideout; David Porter,6,0,36,30
1657397276711,MATH 20A,A01,083754,Zheng; Zequn,14,0,40,26
1657397282735,MATH 20B,A01,083756,Briones; Jor-el Thomas Caparas,4,0,36,32
1657397282735,MATH 20B,A02,083757,Briones; Jor-el Thomas Caparas,1,0,36,35
1657397282735,MATH 20B,A03,093475,Briones; Jor-el Thomas Caparas,2,0,36,34
1657397288760,MATH 20C,A01,083760,Briones; Jor-el Thomas Caparas,1,0,35,34
1657397288760,MATH 20C,A02,083761,Briones; Jor-el Thomas Caparas,8,0,35,27
1657397288760,MATH 20C,A03,093476,Briones; Jor-el Thomas Caparas,0,1,36,36
1657397288760,MATH 20C,B01,083762,Bach; Quang Tran,1,0,30,29
1657397294789,MATH 20D,A01,083765,Tran; Brian Kha,5,0,30,25
1657397294789,MATH 20D,A02,083766,Tran; Brian Kha,5,0,30,25
1657397294789,MATH 20D,A03,083767,Tran; Brian Kha,5,0,30,25
1657397300814,MATH 20E,A01,083771,Ganguly; Soumya,9,0,32,23
1657397300814,MATH 20E,A02,083772,Ganguly; Soumya,6,0,32,26
1657397300814,MATH 20E,B01,083773,Ciotti; Benjamin,20,0,35,15
1657397300814,MATH 20E,B02,083774,Ciotti; Benjamin,17,0,35,18
1657397306850,MATH 103A,A01,083777,Greenfeld; Be'Eri,3,0,36,33
1657397306850,MATH 103A,A02,083778,Greenfeld; Be'Eri,5,0,36,31
1657397306850,MATH 103A,A03,093561,Greenfeld; Be'Eri,5,0,36,31
1657397306850,MATH 103A,B01,083779,Greenfeld; Be'Eri,7,0,36,29
1657397306850,MATH 103A,B02,083780,Greenfeld; Be'Eri,4,0,36,32
1657397306850,MATH 103A,B03,093562,Greenfeld; Be'Eri,3,0,36,33
1657397312874,MATH 105,A01,085443,Carter; Anne Toulson,15,0,35,20
1657397312874,MATH 105,A02,093477,Carter; Anne Toulson,20,0,35,15
1657397318904,MATH 109,A01,083213,Ganzberger; Geoffrey Michael,2,0,34,32
1657397318904,MATH 109,A02,083214,Ganzberger; Geoffrey Michael,4,0,34,30
1657397318904,MATH 109,A03,093478,Ganzberger; Geoffrey Michael,2,0,34,32
1657397318904,MATH 109,B01,083215,Ganzberger; Geoffrey Michael,1,0,32,31
1657397318904,MATH 109,B02,083216,Ganzberger; Geoffrey Michael,2,0,32,30
1657397318904,MATH 109,B03,093479,Ganzberger; Geoffrey Michael,8,0,32,24
1657397324932,MATH 142A,A01,083219,Chow; Bennett,7,0,32,25
1657397324932,MATH 142A,A02,083220,Chow; Bennett,10,0,32,22
1657397324932,MATH 142A,A03,093480,Chow; Bennett,8,0,32,24
1657397324932,MATH 142A,B03,093481,Chow; Bennett,8,0,32,24
1657397324932,MATH 142A,B04,093558,Chow; Bennett,13,0,32,19
1657397324932,MATH 142A,B05,093559,Chow; Bennett,6,0,32,26
1657397330956,MATH 193A,A01,083224,Rotar; Vladimir,8,0,34,26
1657397330956,MATH 193A,A02,083225,Rotar; Vladimir,9,0,34,25
1657397330956,MATH 193A,A03,083781,Rotar; Vladimir,5,0,34,29
1657397330956,MATH 193A,A04,083782,Rotar; Vladimir,10,0,34,24
1657397330956,MATH 193A,A05,093482,Rotar; Vladimir,10,0,34,24
1657397336990,MATH 197,001,091859,McAuley; Julian John,9999,0,9999,0
1657397336990,MATH 197,002,095566,Kedlaya; Kiran S.,9997,0,9999,2
1657397336990,MATH 197,003,095567,Xiao; Ming,9999,0,9999,0
1657397336990,MATH 197,004,095571,Perols; Johan Lars,9998,0,9999,1
1657397344056,COGS 9,A01,083615,Shannon; Kyle Michael,9,0,75,66
1657397350080,COGS 11,A01,083617,Boyle; Mary E. T.,22,0,48,26
1657397356106,COGS 13,A01,083071,Bastos; Amalia Pinkusfeld,11,0,71,60
1657397362130,COGS 14A,A01,092681,Semenuks; Arturs,4,1,100,96
1657397368155,COGS 14B,A01,083073,Cheng; Tzu-Han,6,0,63,57
1657397374182,COGS 17,A01,092677,Semenuks; Arturs,6,0,81,75
1657397380211,COGS 100,A01,083619,Allen; Michael Gordon,17,0,70,53
1657397386245,COGS 101A,A01,083621,Davis; Joshua Daniel,9,0,68,59
1657397392268,COGS 101B,A01,091572,Allen; Michael Gordon,11,0,65,54
1657397398293,COGS 101C,A01,083625,Delgado; Tania,17,0,35,18
1657397404321,COGS 107A,A01,083627,Boyle; Mary E. T.,13,0,60,47
1657397410348,COGS 118A,A01,083075,Gupta; Anjum,20,0,76,56
1657397416370,CSE 3,A50,083646,Miranda; Gregory Joseph,24,0,50,26
1657397422397,CSE 8A,A50,083650,Miranda; Gregory Joseph,17,1,56,39
1657397428422,CSE 11,A01,083080,Cao; Yingjun,6,15,40,34
1657397434445,CSE 12,A01,083652,Krause-Levy; Sophia Louisa,28,1,120,92
1657397440470,CSE 15L,A01,083654,Morris; Justin Loren,9,0,50,41
1657397440470,CSE 15L,A02,083655,Morris; Justin Loren,9,0,50,41
1657397446503,CSE 20,A01,083657,Tran; Khoa Dang,39,0,80,41
1657397452537,CSE 21,A01,095574,Bach; Quang Tran,22,0,48,26
1657397458565,CSE 30,A01,083084,Eldon; John,4,0,80,76
1657397458565,CSE 30,B01,095061,Bhaskar; Nishant,9,0,50,41
1657397464598,CSE 100,A01,083659,Cao; Yingjun,5,4,70,65
1657397470625,CSE 134B,A01,083661,Powell; Thomas Allan,22,0,100,78
1657397476649,CSE 140,A01,083663,Gungor; Onat,14,0,85,71
1657397482674,CSE 140L,A01,083088,Eldon; John,21,0,100,79
1657397488706,CSE 175,A01,083665,Kumar; Rakesh,3,0,25,22
1657397494731,CSE 190,A00,092507,Dubnov; Shlomo,7,0,20,13
1657397500754,ECE 45,A01,083139,Congero; Spencer William,6,0,75,69
1657397506776,ECE 65,A50,083695,Saad; Andrew S,12,0,30,18
1657397506776,ECE 65,A51,095125,Saad; Andrew S,24,0,26,2
1657397512799,ECE 109,A01,091882,Touri; Behrouz,19,0,70,51
1657397518823,ECE 180,A00,083140,Abi Samra; Nicholas Camill,1,0,30,29
1657397518823,ECE 180,B00,083141,Abi Samra; Nicholas Camill,0,0,30,30
1657397524846,MATH 10A,A01,083735,Patchell; Gregory David,2,0,30,28
1657397524846,MATH 10A,A02,083736,Patchell; Gregory David,20,0,30,10
1657397524846,MATH 10A,A03,083737,Patchell; Gregory David,16,0,30,14
1657397530875,MATH 10B,A01,083207,Lim; Seonhee,8,0,34,26
1657397530875,MATH 10B,A02,083208,Lim; Seonhee,9,0,35,26
1657397530875,MATH 10B,A03,093472,Lim; Seonhee,7,0,34,27
1657397530875,MATH 10B,B01,083739,Sinha; Shubham,12,0,30,18
1657397536915,MATH 18,A01,083743,Cinel; Cameron Alexander,7,0,30,23
1657397536915,MATH 18,A02,083744,Cinel; Cameron Alexander,17,0,30,13
1657397536915,MATH 18,A03,083745,Cinel; Cameron Alexander,9,0,30,21
1657397536915,MATH 18,B01,083748,Rideout; David Porter,5,0,37,32
1657397536915,MATH 18,B02,083749,Rideout; David Porter,5,0,36,31
1657397536915,MATH 18,B03,083750,Rideout; David Porter,3,0,37,34
1657397536915,MATH 18,B04,083751,Rideout; David Porter,6,0,36,30
1657397536915,MATH 18,B05,093473,Rideout; David Porter,6,0,36,30
1657397536915,MATH 18,B06,093474,Rideout; David Porter,6,0,36,30
1657397542938,MATH 20A,A01,083754,Zheng; Zequn,14,0,40,26
1657397548967,MATH 20B,A01,083756,Briones; Jor-el Thomas Caparas,4,0,36,32
1657397548967,MATH 20B,A02,083757,Briones; Jor-el Thomas Caparas,1,0,36,35
1657397548967,MATH 20B,A03,093475,Briones; Jor-el Thomas Caparas,2,0,36,34
1657397554992,MATH 20C,A01,083760,Briones; Jor-el Thomas Caparas,1,0,35,34
1657397554992,MATH 20C,A02,083761,Briones; Jor-el Thomas Caparas,8,0,35,27
1657397554992,MATH 20C,A03,093476,Briones; Jor-el Thomas Caparas,0,1,36,36
1657397554992,MATH 20C,B01,083762,Bach; Quang Tran,1,0,30,29
1657397561022,MATH 20D,A01,083765,Tran; Brian Kha,5,0,30,25
1657397561022,MATH 20D,A02,083766,Tran; Brian Kha,5,0,30,25
1657397561022,MATH 20D,A03,083767,Tran; Brian Kha,5,0,30,25
1657397567045,MATH 20E,A01,083771,Ganguly; Soumya,9,0,32,23
1657397567045,MATH 20E,A02,083772,Ganguly; Soumya,6,0,32,26
1657397567045,MATH 20E,B01,083773,Ciotti; Benjamin,20,0,35,15
1657397567045,MATH 20E,B02,083774,Ciotti; Benjamin,17,0,35,18
1657397573075,MATH 103A,A01,083777,Greenfeld; Be'Eri,3,0,36,33
1657397573075,MATH 103A,A02,083778,Greenfeld; Be'Eri,5,0,36,31
1657397573075,MATH 103A,A03,093561,Greenfeld; Be'Eri,5,0,36,31
1657397573075,MATH 103A,B01,083779,Greenfeld; Be'Eri,7,0,36,29
1657397573075,MATH 103A,B02,083780,Greenfeld; Be'Eri,4,0,36,32
1657397573075,MATH 103A,B03,093562,Greenfeld; Be'Eri,3,0,36,33
1657397579176,MATH 105,A01,085443,Carter; Anne Toulson,15,0,35,20
1657397579176,MATH 105,A02,093477,Carter; Anne Toulson,20,0,35,15
1657397585202,MATH 109,A01,083213,Ganzberger; Geoffrey Michael,2,0,34,32
1657397585202,MATH 109,A02,083214,Ganzberger; Geoffrey Michael,4,0,34,30
1657397585202,MATH 109,A03,093478,Ganzberger; Geoffrey Michael,2,0,34,32
1657397585202,MATH 109,B01,083215,Ganzberger; Geoffrey Michael,1,0,32,31
1657397585202,MATH 109,B02,083216,Ganzberger; Geoffrey Michael,2,0,32,30
1657397585202,MATH 109,B03,093479,Ganzberger; Geoffrey Michael,8,0,32,24
1657397591236,MATH 142A,A01,083219,Chow; Bennett,7,0,32,25
1657397591236,MATH 142A,A02,083220,Chow; Bennett,10,0,32,22
1657397591236,MATH 142A,A03,093480,Chow; Bennett,8,0,32,24
1657397591236,MATH 142A,B03,093481,Chow; Bennett,8,0,32,24
1657397591236,MATH 142A,B04,093558,Chow; Bennett,13,0,32,19
1657397591236,MATH 142A,B05,093559,Chow; Bennett,6,0,32,26
1657397597261,MATH 193A,A01,083224,Rotar; Vladimir,8,0,34,26
1657397597261,MATH 193A,A02,083225,Rotar; Vladimir,9,0,34,25
1657397597261,MATH 193A,A03,083781,Rotar; Vladimir,5,0,34,29
1657397597261,MATH 193A,A04,083782,Rotar; Vladimir,10,0,34,24
1657397597261,MATH 193A,A05,093482,Rotar; Vladimir,10,0,34,24
1657397603286,MATH 197,001,091859,McAuley; Julian John,9999,0,9999,0
1657397603286,MATH 197,002,095566,Kedlaya; Kiran S.,9997,0,9999,2
1657397603286,MATH 197,003,095567,Xiao; Ming,9999,0,9999,0
1657397603286,MATH 197,004,095571,Perols; Johan Lars,9998,0,9999,1
1657397610351,COGS 9,A01,083615,Shannon; Kyle Michael,9,0,75,66
1657397616374,COGS 11,A01,083617,Boyle; Mary E. T.,22,0,48,26
1657397622400,COGS 13,A01,083071,Bastos; Amalia Pinkusfeld,11,0,71,60
1657397628426,COGS 14A,A01,092681,Semenuks; Arturs,4,1,100,96
1657397634450,COGS 14B,A01,083073,Cheng; Tzu-Han,6,0,63,57
1657397640478,COGS 17,A01,092677,Semenuks; Arturs,6,0,81,75
1657397646503,COGS 100,A01,083619,Allen; Michael Gordon,17,0,70,53
1657397652529,COGS 101A,A01,083621,Davis; Joshua Daniel,9,0,68,59
1657397658557,COGS 101B,A01,091572,Allen; Michael Gordon,11,0,65,54
1657397664586,COGS 101C,A01,083625,Delgado; Tania,17,0,35,18
1657397670612,COGS 107A,A01,083627,Boyle; Mary E. T.,13,0,60,47
1657397676636,COGS 118A,A01,083075,Gupta; Anjum,20,0,76,56
1657397682665,CSE 3,A50,083646,Miranda; Gregory Joseph,24,0,50,26
1657397688690,CSE 8A,A50,083650,Miranda; Gregory Joseph,17,1,56,39
1657397694713,CSE 11,A01,083080,Cao; Yingjun,6,15,40,34
1657397700740,CSE 12,A01,083652,Krause-Levy; Sophia Louisa,28,1,120,92
1657397706764,CSE 15L,A01,083654,Morris; Justin Loren,9,0,50,41
1657397706764,CSE 15L,A02,083655,Morris; Justin Loren,9,0,50,41
1657397712787,CSE 20,A01,083657,Tran; Khoa Dang,39,0,80,41
1657397718812,CSE 21,A01,095574,Bach; Quang Tran,22,0,48,26
1657397724838,CSE 30,A01,083084,Eldon; John,4,0,80,76
1657397724838,CSE 30,B01,095061,Bhaskar; Nishant,9,0,50,41
1657397730861,CSE 100,A01,083659,Cao; Yingjun,5,4,70,65
1657397736893,CSE 134B,A01,083661,Powell; Thomas Allan,22,0,100,78
1657397742919,CSE 140,A01,083663,Gungor; Onat,14,0,85,71
1657397748942,CSE 140L,A01,083088,Eldon; John,21,0,100,79
1657397754965,CSE 175,A01,083665,Kumar; Rakesh,3,0,25,22
1657397760989,CSE 190,A00,092507,Dubnov; Shlomo,7,0,20,13
1657397767011,ECE 45,A01,083139,Congero; Spencer William,6,0,75,69
1657397773034,ECE 65,A50,083695,Saad; Andrew S,12,0,30,18
1657397773034,ECE 65,A51,095125,Saad; Andrew S,24,0,26,2
1657397779060,ECE 109,A01,091882,Touri; Behrouz,19,0,70,51
1657397785083,ECE 180,A00,083140,Abi Samra; Nicholas Camill,1,0,30,29
1657397785083,ECE 180,B00,083141,Abi Samra; Nicholas Camill,0,0,30,30
1657397791110,MATH 10A,A01,083735,Patchell; Gregory David,2,0,30,28
1657397791110,MATH 10A,A02,083736,Patchell; Gregory David,20,0,30,10
1657397791110,MATH 10A,A03,083737,Patchell; Gregory David,16,0,30,14
1657397797135,MATH 10B,A01,083207,Lim; Seonhee,8,0,34,26
1657397797135,MATH 10B,A02,083208,Lim; Seonhee,9,0,35,26
1657397797135,MATH 10B,A03,093472,Lim; Seonhee,7,0,34,27
1657397797135,MATH 10B,B01,083739,Sinha; Shubham,12,0,30,18
1657397803161,MATH 18,A01,083743,Cinel; Cameron Alexander,7,0,30,23
1657397803161,MATH 18,A02,083744,Cinel; Cameron Alexander,17,0,30,13
1657397803161,MATH 18,A03,083745,Cinel; Cameron Alexander,9,0,30,21
1657397803161,MATH 18,B01,083748,Rideout; David Porter,5,0,37,32
1657397803161,MATH 18,B02,083749,Rideout; David Porter,5,0,36,31
1657397803161,MATH 18,B03,083750,Rideout; David Porter,3,0,37,34
1657397803161,MATH 18,B04,083751,Rideout; David Porter,6,0,36,30
1657397803161,MATH 18,B05,093473,Rideout; David Porter,6,0,36,30
1657397803161,MATH 18,B06,093474,Rideout; David Porter,6,0,36,30
1657397809185,MATH 20A,A01,083754,Zheng; Zequn,14,0,40,26
1657397815213,MATH 20B,A01,083756,Briones; Jor-el Thomas Caparas,4,0,36,32
1657397815213,MATH 20B,A02,083757,Briones; Jor-el Thomas Caparas,1,0,36,35
1657397815213,MATH 20B,A03,093475,Briones; Jor-el Thomas Caparas,2,0,36,34
1657397821243,MATH 20C,A01,083760,Briones; Jor-el Thomas Caparas,1,0,35,34
1657397821243,MATH 20C,A02,083761,Briones; Jor-el Thomas Caparas,8,0,35,27
1657397821243,MATH 20C,A03,093476,Briones; Jor-el Thomas Caparas,0,1,36,36
1657397821243,MATH 20C,B01,083762,Bach; Quang Tran,1,0,30,29
1657397827273,MATH 20D,A01,083765,Tran; Brian Kha,5,0,30,25
1657397827273,MATH 20D,A02,083766,Tran; Brian Kha,5,0,30,25
1657397827273,MATH 20D,A03,083767,Tran; Brian Kha,5,0,30,25
1657397833303,MATH 20E,A01,083771,Ganguly; Soumya,9,0,32,23
1657397833303,MATH 20E,A02,083772,Ganguly; Soumya,6,0,32,26
1657397833303,MATH 20E,B01,083773,Ciotti; Benjamin,20,0,35,15
1657397833303,MATH 20E,B02,083774,Ciotti; Benjamin,17,0,35,18
1657397839332,MATH 103A,A01,083777,Greenfeld; Be'Eri,3,0,36,33
1657397839332,MATH 103A,A02,083778,Greenfeld; Be'Eri,5,0,36,31
1657397839332,MATH 103A,A03,093561,Greenfeld; Be'Eri,5,0,36,31
1657397839332,MATH 103A,B01,083779,Greenfeld; Be'Eri,7,0,36,29
1657397839332,MATH 103A,B02,083780,Greenfeld; Be'Eri,4,0,36,32
1657397839332,MATH 103A,B03,093562,Greenfeld; Be'Eri,3,0,36,33
1657397845360,MATH 105,A01,085443,Carter; Anne Toulson,15,0,35,20
1657397845360,MATH 105,A02,093477,Carter; Anne Toulson,20,0,35,15
1657397851383,MATH 109,A01,083213,Ganzberger; Geoffrey Michael,2,0,34,32
1657397851383,MATH 109,A02,083214,Ganzberger; Geoffrey Michael,4,0,34,30
1657397851383,MATH 109,A03,093478,Ganzberger; Geoffrey Michael,2,0,34,32
1657397851383,MATH 109,B01,083215,Ganzberger; Geoffrey Michael,1,0,32,31
1657397851383,MATH 109,B02,083216,Ganzberger; Geoffrey Michael,2,0,32,30
1657397851383,MATH 109,B03,093479,Ganzberger; Geoffrey Michael,8,0,32,24
1657397857416,MATH 142A,A01,083219,Chow; Bennett,7,0,32,25
1657397857416,MATH 142A,A02,083220,Chow; Bennett,10,0,32,22
1657397857416,MATH 142A,A03,093480,Chow; Bennett,8,0,32,24
1657397857416,MATH 142A,B03,093481,Chow; Bennett,8,0,32,24
1657397857416,MATH 142A,B04,093558,Chow; Bennett,13,0,32,19
1657397857416,MATH 142A,B05,093559,Chow; Bennett,6,0,32,26
1657397863444,MATH 193A,A01,083224,Rotar; Vladimir,8,0,34,26
1657397863444,MATH 193A,A02,083225,Rotar; Vladimir,9,0,34,25
1657397863444,MATH 193A,A03,083781,Rotar; Vladimir,5,0,34,29
1657397863444,MATH 193A,A04,083782,Rotar; Vladimir,10,0,34,24
1657397863444,MATH 193A,A05,093482,Rotar; Vladimir,10,0,34,24
1657397869468,MATH 197,001,091859,McAuley; Julian John,9999,0,9999,0
1657397869468,MATH 197,002,095566,Kedlaya; Kiran S.,9997,0,9999,2
1657397869468,MATH 197,003,095567,Xiao; Ming,9999,0,9999,0
1657397869468,MATH 197,004,095571,Perols; Johan Lars,9998,0,9999,1
1657397876526,COGS 9,A01,083615,Shannon; Kyle Michael,9,0,75,66
1657397882562,COGS 11,A01,083617,Boyle; Mary E. T.,22,0,48,26
1657397888588,COGS 13,A01,083071,Bastos; Amalia Pinkusfeld,11,0,71,60
1657397894621,COGS 14A,A01,092681,Semenuks; Arturs,4,1,100,96
1657397900657,COGS 14B,A01,083073,Cheng; Tzu-Han,6,0,63,57
1657397906692,COGS 17,A01,092677,Semenuks; Arturs,6,0,81,75
1657397912720,COGS 100,A01,083619,Allen; Michael Gordon,17,0,70,53
1657397918748,COGS 101A,A01,083621,Davis; Joshua Daniel,9,0,68,59
1657397924789,COGS 101B,A01,091572,Allen; Michael Gordon,11,0,65,54
1657397930815,COGS 101C,A01,083625,Delgado; Tania,17,0,35,18
1657397936848,COGS 107A,A01,083627,Boyle; Mary E. T.,13,0,60,47
1657397942870,COGS 118A,A01,083075,Gupta; Anjum,20,0,76,56
1657397948903,CSE 3,A50,083646,Miranda; Gregory Joseph,24,0,50,26
1657397954926,CSE 8A,A50,083650,Miranda; Gregory Joseph,17,1,56,39
1657397960966,CSE 11,A01,083080,Cao; Yingjun,6,15,40,34
1657397966989,CSE 12,A01,083652,Krause-Levy; Sophia Louisa,28,1,120,92
1657397973022,CSE 15L,A01,083654,Morris; Justin Loren,9,0,50,41
1657397973022,CSE 15L,A02,083655,Morris; Justin Loren,9,0,50,41
1657397979045,CSE 20,A01,083657,Tran; Khoa Dang,39,0,80,41
1657397985068,CSE 21,A01,095574,Bach; Quang Tran,22,0,48,26
1657397991114,CSE 30,A01,083084,Eldon; John,4,0,80,76
1657397991114,CSE 30,B01,095061,Bhaskar; Nishant,9,0,50,41
1657397997148,CSE 100,A01,083659,Cao; Yingjun,5,4,70,65
1657398003178,CSE 134B,A01,083661,Powell; Thomas Allan,22,0,100,78
1657398009201,CSE 140,A01,083663,Gungor; Onat,14,0,85,71
1657398015226,CSE 140L,A01,083088,Eldon; John,21,0,100,79
1657398021260,CSE 175,A01,083665,Kumar; Rakesh,3,0,25,22
1657398027289,CSE 190,A00,092507,Dubnov; Shlomo,7,0,20,13
1657398033317,ECE 45,A01,083139,Congero; Spencer William,6,0,75,69
1657398039358,ECE 65,A50,083695,Saad; Andrew S,12,0,30,18
1657398039358,ECE 65,A51,095125,Saad; Andrew S,24,0,26,2
1657398045382,ECE 109,A01,091882,Touri; Behrouz,19,0,70,51
1657398051409,ECE 180,A00,083140,Abi Samra; Nicholas Camill,1,0,30,29
1657398051409,ECE 180,B00,083141,Abi Samra; Nicholas Camill,0,0,30,30
1657398057435,MATH 10A,A01,083735,Patchell; Gregory David,2,0,30,28
1657398057435,MATH 10A,A02,083736,Patchell; Gregory David,20,0,30,10
1657398057435,MATH 10A,A03,083737,Patchell; Gregory David,16,0,30,14
1657398063464,MATH 10B,A01,083207,Lim; Seonhee,8,0,34,26
1657398063464,MATH 10B,A02,083208,Lim; Seonhee,9,0,35,26
1657398063464,MATH 10B,A03,093472,Lim; Seonhee,7,0,34,27
1657398063464,MATH 10B,B01,083739,Sinha; Shubham,12,0,30,18
1657398069489,MATH 18,A01,083743,Cinel; Cameron Alexander,7,0,30,23
1657398069489,MATH 18,A02,083744,Cinel; Cameron Alexander,17,0,30,13
1657398069489,MATH 18,A03,083745,Cinel; Cameron Alexander,9,0,30,21
1657398069489,MATH 18,B01,083748,Rideout; David Porter,5,0,37,32
1657398069489,MATH 18,B02,083749,Rideout; David Porter,5,0,36,31
1657398069489,MATH 18,B03,083750,Rideout; David Porter,3,0,37,34
1657398069489,MATH 18,B04,083751,Rideout; David Porter,6,0,36,30
1657398069489,MATH 18,B05,093473,Rideout; David Porter,6,0,36,30
1657398069489,MATH 18,B06,093474,Rideout; David Porter,6,0,36,30
1657398075517,MATH 20A,A01,083754,Zheng; Zequn,14,0,40,26
1657398081545,MATH 20B,A01,083756,Briones; Jor-el Thomas Caparas,4,0,36,32
1657398081545,MATH 20B,A02,083757,Briones; Jor-el Thomas Caparas,1,0,36,35
1657398081545,MATH 20B,A03,093475,Briones; Jor-el Thomas Caparas,2,0,36,34
1657398087568,MATH 20C,A01,083760,Briones; Jor-el Thomas Caparas,1,0,35,34
1657398087568,MATH 20C,A02,083761,Briones; Jor-el Thomas Caparas,8,0,35,27
1657398087568,MATH 20C,A03,093476,Briones; Jor-el Thomas Caparas,0,1,36,36
1657398087568,MATH 20C,B01,083762,Bach; Quang Tran,1,0,30,29
1657398093601,MATH 20D,A01,083765,Tran; Brian Kha,5,0,30,25
1657398093601,MATH 20D,A02,083766,Tran; Brian Kha,5,0,30,25
1657398093601,MATH 20D,A03,083767,Tran; Brian Kha,5,0,30,25
1657398099635,MATH 20E,A01,083771,Ganguly; Soumya,9,0,32,23
1657398099635,MATH 20E,A02,083772,Ganguly; Soumya,6,0,32,26
1657398099635,MATH 20E,B01,083773,Ciotti; Benjamin,20,0,35,15
1657398099635,MATH 20E,B02,083774,Ciotti; Benjamin,17,0,35,18
1657398105664,MATH 103A,A01,083777,Greenfeld; Be'Eri,3,0,36,33
1657398105664,MATH 103A,A02,083778,Greenfeld; Be'Eri,5,0,36,31
1657398105664,MATH 103A,A03,093561,Greenfeld; Be'Eri,5,0,36,31
1657398105664,MATH 103A,B01,083779,Greenfeld; Be'Eri,7,0,36,29
1657398105664,MATH 103A,B02,083780,Greenfeld; Be'Eri,4,0,36,32
1657398105664,MATH 103A,B03,093562,Greenfeld; Be'Eri,3,0,36,33
1657398111713,MATH 105,A01,085443,Carter; Anne Toulson,15,0,35,20
1657398111713,MATH 105,A02,093477,Carter; Anne Toulson,20,0,35,15
1657398117738,MATH 109,A01,083213,Ganzberger; Geoffrey Michael,2,0,34,32
1657398117738,MATH 109,A02,083214,Ganzberger; Geoffrey Michael,4,0,34,30
1657398117738,MATH 109,A03,093478,Ganzberger; Geoffrey Michael,2,0,34,32
1657398117738,MATH 109,B01,083215,Ganzberger; Geoffrey Michael,1,0,32,31
1657398117738,MATH 109,B02,083216,Ganzberger; Geoffrey Michael,2,0,32,30
1657398117738,MATH 109,B03,093479,Ganzberger; Geoffrey Michael,8,0,32,24
1657398123778,MATH 142A,A01,083219,Chow; Bennett,7,0,32,25
1657398123778,MATH 142A,A02,083220,Chow; Bennett,10,0,32,22
1657398123778,MATH 142A,A03,093480,Chow; Bennett,8,0,32,24
1657398123778,MATH 142A,B03,093481,Chow; Bennett,8,0,32,24
1657398123778,MATH 142A,B04,093558,Chow; Bennett,13,0,32,19
1657398123778,MATH 142A,B05,093559,Chow; Bennett,6,0,32,26
1657398129801,MATH 193A,A01,083224,Rotar; Vladimir,8,0,34,26
1657398129801,MATH 193A,A02,083225,Rotar; Vladimir,9,0,34,25
1657398129801,MATH 193A,A03,083781,Rotar; Vladimir,5,0,34,29
1657398129801,MATH 193A,A04,083782,Rotar; Vladimir,10,0,34,24
1657398129801,MATH 193A,A05,093482,Rotar; Vladimir,10,0,34,24
1657398135833,MATH 197,001,091859,McAuley; Julian John,9999,0,9999,0
1657398135833,MATH 197,002,095566,Kedlaya; Kiran S.,9997,0,9999,2
1657398135833,MATH 197,003,095567,Xiao; Ming,9999,0,9999,0
1657398135833,MATH 197,004,095571,Perols; Johan Lars,9998,0,9999,1
1657398142903,COGS 9,A01,083615,Shannon; Kyle Michael,9,0,75,66
1657398148927,COGS 11,A01,083617,Boyle; Mary E. T.,22,0,48,26
1657398154950,COGS 13,A01,083071,Bastos; Amalia Pinkusfeld,11,0,71,60
1657398160974,COGS 14A,A01,092681,Semenuks; Arturs,4,1,100,96
1657398167006,COGS 14B,A01,083073,Cheng; Tzu-Han,6,0,63,57
1657398173113,COGS 17,A01,092677,Semenuks; Arturs,6,0,81,75
1657398179140,COGS 100,A01,083619,Allen; Michael Gordon,17,0,70,53
1657398185163,COGS 101A,A01,083621,Davis; Joshua Daniel,9,0,68,59
1657398191191,COGS 101B,A01,091572,Allen; Michael Gordon,11,0,65,54
1657398197214,COGS 101C,A01,083625,Delgado; Tania,17,0,35,18
1657398203236,COGS 107A,A01,083627,Boyle; Mary E. T.,13,0,60,47
1657398209266,COGS 118A,A01,083075,Gupta; Anjum,20,0,76,56
1657398215293,CSE 3,A50,083646,Miranda; Gregory Joseph,24,0,50,26
1657398221319,CSE 8A,A50,083650,Miranda; Gregory Joseph,17,1,56,39
1657398227345,CSE 11,A01,083080,Cao; Yingjun,6,15,40,34
1657398233368,CSE 12,A01,083652,Krause-Levy; Sophia Louisa,28,1,120,92
1657398239406,CSE 15L,A01,083654,Morris; Justin Loren,9,0,50,41
1657398239406,CSE 15L,A02,083655,Morris; Justin Loren,9,0,50,41
1657398245433,CSE 20,A01,083657,Tran; Khoa Dang,39,0,80,41
1657398251457,CSE 21,A01,095574,Bach; Quang Tran,22,0,48,26
1657398257484,CSE 30,A01,083084,Eldon; John,4,0,80,76
1657398257484,CSE 30,B01,095061,Bhaskar; Nishant,9,0,50,41
1657398263509,CSE 100,A01,083659,Cao; Yingjun,5,4,70,65
1657398269542,CSE 134B,A01,083661,Powell; Thomas Allan,22,0,100,78
1657398275570,CSE 140,A01,083663,Gungor; Onat,14,0,85,71
1657398281594,CSE 140L,A01,083088,Eldon; John,21,0,100,79
1657398287623,CSE 175,A01,083665,Kumar; Rakesh,3,0,25,22
1657398293651,CSE 190,A00,092507,Dubnov; Shlomo,7,0,20,13
1657398299678,ECE 45,A01,083139,Congero; Spencer William,6,0,75,69
1657398305704,ECE 65,A50,083695,Saad; Andrew S,12,0,30,18
1657398305704,ECE 65,A51,095125,Saad; Andrew S,24,0,26,2
1657398311731,ECE 109,A01,091882,Touri; Behrouz,19,0,70,51
1657398317754,ECE 180,A00,083140,Abi Samra; Nicholas Camill,1,0,30,29
1657398317754,ECE 180,B00,083141,Abi Samra; Nicholas Camill,0,0,30,30
1657398323777,MATH 10A,A01,083735,Patchell; Gregory David,2,0,30,28
1657398323777,MATH 10A,A02,083736,Patchell; Gregory David,20,0,30,10
1657398323777,MATH 10A,A03,083737,Patchell; Gregory David,16,0,30,14
1657398329808,MATH 10B,A01,083207,Lim; Seonhee,8,0,34,26
1657398329808,MATH 10B,A02,083208,Lim; Seonhee,9,0,35,26
1657398329808,MATH 10B,A03,093472,Lim; Seonhee,7,0,34,27
1657398329808,MATH 10B,B01,083739,Sinha; Shubham,12,0,30,18
1657398335832,MATH 18,A01,083743,Cinel; Cameron Alexander,7,0,30,23
1657398335832,MATH 18,A02,083744,Cinel; Cameron Alexander,17,0,30,13
1657398335832,MATH 18,A03,083745,Cinel; Cameron Alexander,9,0,30,21
1657398335832,MATH 18,B01,083748,Rideout; David Porter,5,0,37,32
1657398335832,MATH 18,B02,083749,Rideout; David Porter,5,0,36,31
1657398335832,MATH 18,B03,083750,Rideout; David Porter,3,0,37,34
1657398335832,MATH 18,B04,083751,Rideout; David Porter,6,0,36,30
1657398335832,MATH 18,B05,093473,Rideout; David Porter,6,0,36,30
1657398335832,MATH 18,B06,093474,Rideout; David Porter,6,0,36,30
1657398341859,MATH 20A,A01,083754,Zheng; Zequn,14,0,40,26
1657398347882,MATH 20B,A01,083756,Briones; Jor-el Thomas Caparas,4,0,36,32
1657398347882,MATH 20B,A02,083757,Briones; Jor-el Thomas Caparas,1,0,36,35
1657398347882,MATH 20B,A03,093475,Briones; Jor-el Thomas Caparas,2,0,36,34
1657398353905,MATH 20C,A01,083760,Briones; Jor-el Thomas Caparas,1,0,35,34
1657398353905,MATH 20C,A02,083761,Briones; Jor-el Thomas Caparas,8,0,35,27
1657398353905,MATH 20C,A03,093476,Briones; Jor-el Thomas Caparas,0,1,36,36
1657398353905,MATH 20C,B01,083762,Bach; Quang Tran,1,0,30,29
1657398359930,MATH 20D,A01,083765,Tran; Brian Kha,5,0,30,25
1657398359930,MATH 20D,A02,083766,Tran; Brian Kha,5,0,30,25
1657398359930,MATH 20D,A03,083767,Tran; Brian Kha,5,0,30,25
1657398365959,MATH 20E,A01,083771,Ganguly; Soumya,9,0,32,23
1657398365959,MATH 20E,A02,083772,Ganguly; Soumya,6,0,32,26
1657398365959,MATH 20E,B01,083773,Ciotti; Benjamin,20,0,35,15
1657398365959,MATH 20E,B02,083774,Ciotti; Benjamin,17,0,35,18
1657398371997,MATH 103A,A01,083777,Greenfeld; Be'Eri,3,0,36,33
1657398371997,MATH 103A,A02,083778,Greenfeld; Be'Eri,5,0,36,31
1657398371997,MATH 103A,A03,093561,Greenfeld; Be'Eri,5,0,36,31
1657398371997,MATH 103A,B01,083779,Greenfeld; Be'Eri,7,0,36,29
1657398371997,MATH 103A,B02,083780,Greenfeld; Be'Eri,4,0,36,32
1657398371997,MATH 103A,B03,093562,Greenfeld; Be'Eri,3,0,36,33
1657398378030,MATH 105,A01,085443,Carter; Anne Toulson,15,0,35,20
1657398378030,MATH 105,A02,093477,Carter; Anne Toulson,20,0,35,15
1657398384062,MATH 109,A01,083213,Ganzberger; Geoffrey Michael,2,0,34,32
1657398384062,MATH 109,A02,083214,Ganzberger; Geoffrey Michael,4,0,34,30
1657398384062,MATH 109,A03,093478,Ganzberger; Geoffrey Michael,2,0,34,32
1657398384062,MATH 109,B01,083215,Ganzberger; Geoffrey Michael,1,0,32,31
1657398384062,MATH 109,B02,083216,Ganzberger; Geoffrey Michael,2,0,32,30
1657398384062,MATH 109,B03,093479,Ganzberger; Geoffrey Michael,8,0,32,24
1657398390086,MATH 142A,A01,083219,Chow; Bennett,7,0,32,25
1657398390086,MATH 142A,A02,083220,Chow; Bennett,10,0,32,22
1657398390086,MATH 142A,A03,093480,Chow; Bennett,8,0,32,24
1657398390086,MATH 142A,B03,093481,Chow; Bennett,8,0,32,24
1657398390086,MATH 142A,B04,093558,Chow; Bennett,13,0,32,19
1657398390086,MATH 142A,B05,093559,Chow; Bennett,6,0,32,26
1657398396112,MATH 193A,A01,083224,Rotar; Vladimir,8,0,34,26
1657398396112,MATH 193A,A02,083225,Rotar; Vladimir,9,0,34,25
1657398396112,MATH 193A,A03,083781,Rotar; Vladimir,5,0,34,29
1657398396112,MATH 193A,A04,083782,Rotar; Vladimir,10,0,34,24
1657398396112,MATH 193A,A05,093482,Rotar; Vladimir,10,0,34,24
1657398402138,MATH 197,001,091859,McAuley; Julian John,9999,0,9999,0
1657398402138,MATH 197,002,095566,Kedlaya; Kiran S.,9997,0,9999,2
1657398402138,MATH 197,003,095567,Xiao; Ming,9999,0,9999,0
1657398402138,MATH 197,004,095571,Perols; Johan Lars,9998,0,9999,1
1657398409216,COGS 9,A01,083615,Shannon; Kyle Michael,9,0,75,66
1657398415241,COGS 11,A01,083617,Boyle; Mary E. T.,22,0,48,26
1657398421262,COGS 13,A01,083071,Bastos; Amalia Pinkusfeld,11,0,71,60
1657398427290,COGS 14A,A01,092681,Semenuks; Arturs,4,1,100,96
1657398433313,COGS 14B,A01,083073,Cheng; Tzu-Han,6,0,63,57
1657398439341,COGS 17,A01,092677,Semenuks; Arturs,6,0,81,75
1657398445366,COGS 100,A01,083619,Allen; Michael Gordon,17,0,70,53
1657398451391,COGS 101A,A01,083621,Davis; Joshua Daniel,9,0,68,59
1657398457430,COGS 101B,A01,091572,Allen; Michael Gordon,11,0,65,54
1657398463457,COGS 101C,A01,083625,Delgado; Tania,17,0,35,18
1657398469480,COGS 107A,A01,083627,Boyle; Mary E. T.,13,0,60,47
1657398475503,COGS 118A,A01,083075,Gupta; Anjum,20,0,76,56
1657398481530,CSE 3,A50,083646,Miranda; Gregory Joseph,24,0,50,26
1657398487557,CSE 8A,A50,083650,Miranda; Gregory Joseph,17,1,56,39
1657398493591,CSE 11,A01,083080,Cao; Yingjun,6,15,40,34
1657398499624,CSE 12,A01,083652,Krause-Levy; Sophia Louisa,28,1,120,92
1657398505653,CSE 15L,A01,083654,Morris; Justin Loren,9,0,50,41
1657398505653,CSE 15L,A02,083655,Morris; Justin Loren,9,0,50,41
1657398511676,CSE 20,A01,083657,Tran; Khoa Dang,39,0,80,41
1657398517702,CSE 21,A01,095574,Bach; Quang Tran,22,0,48,26
1657398523726,CSE 30,A01,083084,Eldon; John,4,0,80,76
1657398523726,CSE 30,B01,095061,Bhaskar; Nishant,9,0,50,41
1657398529756,CSE 100,A01,083659,Cao; Yingjun,5,4,70,65
1657398535779,CSE 134B,A01,083661,Powell; Thomas Allan,22,0,100,78
1657398541805,CSE 140,A01,083663,Gungor; Onat,14,0,85,71
1657398547827,CSE 140L,A01,083088,Eldon; John,21,0,100,79
1657398553856,CSE 175,A01,083665,Kumar; Rakesh,3,0,25,22
1657398559882,CSE 190,A00,092507,Dubnov; Shlomo,7,0,20,13
1657398565910,ECE 45,A01,083139,Congero; Spencer William,6,0,75,69
1657398571934,ECE 65,A50,083695,Saad; Andrew S,12,0,30,18
1657398571934,ECE 65,A51,095125,Saad; Andrew S,24,0,26,2
1657398577985,ECE 109,A01,091882,Touri; Behrouz,19,0,70,51
1657398584008,ECE 180,A00,083140,Abi Samra; Nicholas Camill,1,0,30,29
1657398584008,ECE 180,B00,083141,Abi Samra; Nicholas Camill,0,0,30,30
1657398590031,MATH 10A,A01,083735,Patchell; Gregory David,2,0,30,28
1657398590031,MATH 10A,A02,083736,Patchell; Gregory David,20,0,30,10
1657398590031,MATH 10A,A03,083737,Patchell; Gregory David,16,0,30,14
1657398596055,MATH 10B,A01,083207,Lim; Seonhee,8,0,34,26
1657398596055,MATH 10B,A02,083208,Lim; Seonhee,9,0,35,26
1657398596055,MATH 10B,A03,093472,Lim; Seonhee,7,0,34,27
1657398596055,MATH 10B,B01,083739,Sinha; Shubham,12,0,30,18
1657398602087,MATH 18,A01,083743,Cinel; Cameron Alexander,7,0,30,23
1657398602087,MATH 18,A02,083744,Cinel; Cameron Alexander,17,0,30,13
1657398602087,MATH 18,A03,083745,Cinel; Cameron Alexander,9,0,30,21
1657398602087,MATH 18,B01,083748,Rideout; David Porter,5,0,37,32
1657398602087,MATH 18,B02,083749,Rideout; David Porter,5,0,36,31
1657398602087,MATH 18,B03,083750,Rideout; David Porter,3,0,37,34
1657398602087,MATH 18,B04,083751,Rideout; David Porter,6,0,36,30
1657398602087,MATH 18,B05,093473,Rideout; David Porter,6,0,36,30
1657398602087,MATH 18,B06,093474,Rideout; David Porter,6,0,36,30
1657398608117,MATH 20A,A01,083754,Zheng; Zequn,14,0,40,26
1657398614141,MATH 20B,A01,083756,Briones; Jor-el Thomas Caparas,4,0,36,32
1657398614141,MATH 20B,A02,083757,Briones; Jor-el Thomas Caparas,1,0,36,35
1657398614141,MATH 20B,A03,093475,Briones; Jor-el Thomas Caparas,2,0,36,34
1657398620186,MATH 20C,A01,083760,Briones; Jor-el Thomas Caparas,1,0,35,34
1657398620186,MATH 20C,A02,083761,Briones; Jor-el Thomas Caparas,8,0,35,27
1657398620186,MATH 20C,A03,093476,Briones; Jor-el Thomas Caparas,0,1,36,36
1657398620186,MATH 20C,B01,083762,Bach; Quang Tran,1,0,30,29
1657398626208,MATH 20D,A01,083765,Tran; Brian Kha,5,0,30,25
1657398626208,MATH 20D,A02,083766,Tran; Brian Kha,5,0,30,25
1657398626208,MATH 20D,A03,083767,Tran; Brian Kha,5,0,30,25
1657398632231,MATH 20E,A01,083771,Ganguly; Soumya,9,0,32,23
1657398632231,MATH 20E,A02,083772,Ganguly; Soumya,6,0,32,26
1657398632231,MATH 20E,B01,083773,Ciotti; Benjamin,20,0,35,15
1657398632231,MATH 20E,B02,083774,Ciotti; Benjamin,17,0,35,18
1657398638261,MATH 103A,A01,083777,Greenfeld; Be'Eri,3,0,36,33
1657398638261,MATH 103A,A02,083778,Greenfeld; Be'Eri,5,0,36,31
1657398638261,MATH 103A,A03,093561,Greenfeld; Be'Eri,5,0,36,31
1657398638261,MATH 103A,B01,083779,Greenfeld; Be'Eri,7,0,36,29
1657398638261,MATH 103A,B02,083780,Greenfeld; Be'Eri,4,0,36,32
1657398638261,MATH 103A,B03,093562,Greenfeld; Be'Eri,3,0,36,33
1657398644284,MATH 105,A01,085443,Carter; Anne Toulson,15,0,35,20
1657398644284,MATH 105,A02,093477,Carter; Anne Toulson,20,0,35,15
1657398650313,MATH 109,A01,083213,Ganzberger; Geoffrey Michael,2,0,34,32
1657398650313,MATH 109,A02,083214,Ganzberger; Geoffrey Michael,4,0,34,30
1657398650313,MATH 109,A03,093478,Ganzberger; Geoffrey Michael,2,0,34,32
1657398650313,MATH 109,B01,083215,Ganzberger; Geoffrey Michael,1,0,32,31
1657398650313,MATH 109,B02,083216,Ganzberger; Geoffrey Michael,2,0,32,30
1657398650313,MATH 109,B03,093479,Ganzberger; Geoffrey Michael,8,0,32,24
1657398656342,MATH 142A,A01,083219,Chow; Bennett,7,0,32,25
1657398656342,MATH 142A,A02,083220,Chow; Bennett,10,0,32,22
1657398656342,MATH 142A,A03,093480,Chow; Bennett,8,0,32,24
1657398656342,MATH 142A,B03,093481,Chow; Bennett,8,0,32,24
1657398656342,MATH 142A,B04,093558,Chow; Bennett,13,0,32,19
1657398656342,MATH 142A,B05,093559,Chow; Bennett,6,0,32,26
1657398662375,MATH 193A,A01,083224,Rotar; Vladimir,8,0,34,26
1657398662375,MATH 193A,A02,083225,Rotar; Vladimir,9,0,34,25
1657398662375,MATH 193A,A03,083781,Rotar; Vladimir,5,0,34,29
1657398662375,MATH 193A,A04,083782,Rotar; Vladimir,10,0,34,24
1657398662375,MATH 193A,A05,093482,Rotar; Vladimir,10,0,34,24
1657398668398,MATH 197,001,091859,McAuley; Julian John,9999,0,9999,0
1657398668398,MATH 197,002,095566,Kedlaya; Kiran S.,9997,0,9999,2
1657398668398,MATH 197,003,095567,Xiao; Ming,9999,0,9999,0
1657398668398,MATH 197,004,095571,Perols; Johan Lars,9998,0,9999,1
1657398675459,COGS 9,A01,083615,Shannon; Kyle Michael,9,0,75,66
1657398681481,COGS 11,A01,083617,Boyle; Mary E. T.,22,0,48,26
1657398687527,COGS 13,A01,083071,Bastos; Amalia Pinkusfeld,11,0,71,60
1657398693550,COGS 14A,A01,092681,Semenuks; Arturs,4,1,100,96
1657398699572,COGS 14B,A01,083073,Cheng; Tzu-Han,6,0,63,57
1657398705596,COGS 17,A01,092677,Semenuks; Arturs,6,0,81,75
1657398711621,COGS 100,A01,083619,Allen; Michael Gordon,17,0,70,53
1657398717663,COGS 101A,A01,083621,Davis; Joshua Daniel,9,0,68,59
1657398723691,COGS 101B,A01,091572,Allen; Michael Gordon,11,0,65,54
1657398729713,COGS 101C,A01,083625,Delgado; Tania,17,0,35,18
1657398735740,COGS 107A,A01,083627,Boyle; Mary E. T.,13,0,60,47
1657398741762,COGS 118A,A01,083075,Gupta; Anjum,20,0,76,56
1657398747785,CSE 3,A50,083646,Miranda; Gregory Joseph,24,0,50,26
1657398753808,CSE 8A,A50,083650,Miranda; Gregory Joseph,17,1,56,39
1657398759830,CSE 11,A01,083080,Cao; Yingjun,6,15,40,34
1657398765858,CSE 12,A01,083652,Krause-Levy; Sophia Louisa,28,1,120,92
1657398771953,CSE 15L,A01,083654,Morris; Justin Loren,9,0,50,41
1657398771953,CSE 15L,A02,083655,Morris; Justin Loren,9,0,50,41
1657398777977,CSE 20,A01,083657,Tran; Khoa Dang,39,0,80,41
1657398784002,CSE 21,A01,095574,Bach; Quang Tran,22,0,48,26
1657398790025,CSE 30,A01,083084,Eldon; John,4,0,80,76
1657398790025,CSE 30,B01,095061,Bhaskar; Nishant,9,0,50,41
1657398796056,CSE 100,A01,083659,Cao; Yingjun,5,4,70,65
1657398802079,CSE 134B,A01,083661,Powell; Thomas Allan,22,0,100,78
1657398808106,CSE 140,A01,083663,Gungor; Onat,14,0,85,71
1657398814133,CSE 140L,A01,083088,Eldon; John,21,0,100,79
1657398820160,CSE 175,A01,083665,Kumar; Rakesh,3,0,25,22
1657398826183,CSE 190,A00,092507,Dubnov; Shlomo,7,0,20,13
1657398832208,ECE 45,A01,083139,Congero; Spencer William,6,0,75,69
1657398838231,ECE 65,A50,083695,Saad; Andrew S,12,0,30,18
1657398838231,ECE 65,A51,095125,Saad; Andrew S,24,0,26,2
1657398844254,ECE 109,A01,091882,Touri; Behrouz,19,0,70,51
1657398850279,ECE 180,A00,083140,Abi Samra; Nicholas Camill,1,0,30,29
1657398850279,ECE 180,B00,083141,Abi Samra; Nicholas Camill,0,0,30,30
1657398856307,MATH 10A,A01,083735,Patchell; Gregory David,2,0,30,28
1657398856307,MATH 10A,A02,083736,Patchell; Gregory David,20,0,30,10
1657398856307,MATH 10A,A03,083737,Patchell; Gregory David,16,0,30,14
1657398862330,MATH 10B,A01,083207,Lim; Seonhee,8,0,34,26
1657398862330,MATH 10B,A02,083208,Lim; Seonhee,9,0,35,26
1657398862330,MATH 10B,A03,093472,Lim; Seonhee,7,0,34,27
1657398862330,MATH 10B,B01,083739,Sinha; Shubham,12,0,30,18
1657398868357,MATH 18,A01,083743,Cinel; Cameron Alexander,7,0,30,23
1657398868357,MATH 18,A02,083744,Cinel; Cameron Alexander,17,0,30,13
1657398868357,MATH 18,A03,083745,Cinel; Cameron Alexander,9,0,30,21
1657398868357,MATH 18,B01,083748,Rideout; David Porter,5,0,37,32
1657398868357,MATH 18,B02,083749,Rideout; David Porter,5,0,36,31
1657398868357,MATH 18,B03,083750,Rideout; David Porter,3,0,37,34
1657398868357,MATH 18,B04,083751,Rideout; David Porter,6,0,36,30
1657398868357,MATH 18,B05,093473,Rideout; David Porter,6,0,36,30
1657398868357,MATH 18,B06,093474,Rideout; David Porter,6,0,36,30
1657398874380,MATH 20A,A01,083754,Zheng; Zequn,14,0,40,26
1657398880403,MATH 20B,A01,083756,Briones; Jor-el Thomas Caparas,4,0,36,32
1657398880403,MATH 20B,A02,083757,Briones; Jor-el Thomas Caparas,1,0,36,35
1657398880403,MATH 20B,A03,093475,Briones; Jor-el Thomas Caparas,2,0,36,34
1657398886426,MATH 20C,A01,083760,Briones; Jor-el Thomas Caparas,1,0,35,34
1657398886426,MATH 20C,A02,083761,Briones; Jor-el Thomas Caparas,8,0,35,27
1657398886426,MATH 20C,A03,093476,Briones; Jor-el Thomas Caparas,0,1,36,36
1657398886426,MATH 20C,B01,083762,Bach; Quang Tran,1,0,30,29
1657398892455,MATH 20D,A01,083765,Tran; Brian Kha,5,0,30,25
1657398892455,MATH 20D,A02,083766,Tran; Brian Kha,5,0,30,25
1657398892455,MATH 20D,A03,083767,Tran; Brian Kha,5,0,30,25
1657398898479,MATH 20E,A01,083771,Ganguly; Soumya,9,0,32,23
1657398898479,MATH 20E,A02,083772,Ganguly; Soumya,6,0,32,26
1657398898479,MATH 20E,B01,083773,Ciotti; Benjamin,20,0,35,15
1657398898479,MATH 20E,B02,083774,Ciotti; Benjamin,17,0,35,18
1657398904504,MATH 103A,A01,083777,Greenfeld; Be'Eri,3,0,36,33
1657398904504,MATH 103A,A02,083778,Greenfeld; Be'Eri,5,0,36,31
1657398904504,MATH 103A,A03,093561,Greenfeld; Be'Eri,5,0,36,31
1657398904504,MATH 103A,B01,083779,Greenfeld; Be'Eri,7,0,36,29
1657398904504,MATH 103A,B02,083780,Greenfeld; Be'Eri,4,0,36,32
1657398904504,MATH 103A,B03,093562,Greenfeld; Be'Eri,3,0,36,33
1657398910531,MATH 105,A01,085443,Carter; Anne Toulson,15,0,35,20
1657398910531,MATH 105,A02,093477,Carter; Anne Toulson,20,0,35,15
1657398916555,MATH 109,A01,083213,Ganzberger; Geoffrey Michael,2,0,34,32
1657398916555,MATH 109,A02,083214,Ganzberger; Geoffrey Michael,4,0,34,30
1657398916555,MATH 109,A03,093478,Ganzberger; Geoffrey Michael,2,0,34,32
1657398916555,MATH 109,B01,083215,Ganzberger; Geoffrey Michael,1,0,32,31
1657398916555,MATH 109,B02,083216,Ganzberger; Geoffrey Michael,2,0,32,30
1657398916555,MATH 109,B03,093479,Ganzberger; Geoffrey Michael,8,0,32,24
1657398922580,MATH 142A,A01,083219,Chow; Bennett,7,0,32,25
1657398922580,MATH 142A,A02,083220,Chow; Bennett,10,0,32,22
1657398922580,MATH 142A,A03,093480,Chow; Bennett,8,0,32,24
1657398922580,MATH 142A,B03,093481,Chow; Bennett,8,0,32,24
1657398922580,MATH 142A,B04,093558,Chow; Bennett,13,0,32,19
1657398922580,MATH 142A,B05,093559,Chow; Bennett,6,0,32,26
1657398928602,MATH 193A,A01,083224,Rotar; Vladimir,8,0,34,26
1657398928602,MATH 193A,A02,083225,Rotar; Vladimir,9,0,34,25
1657398928602,MATH 193A,A03,083781,Rotar; Vladimir,5,0,34,29
1657398928602,MATH 193A,A04,083782,Rotar; Vladimir,10,0,34,24
1657398928602,MATH 193A,A05,093482,Rotar; Vladimir,10,0,34,24
1657398934628,MATH 197,001,091859,McAuley; Julian John,9999,0,9999,0
1657398934628,MATH 197,002,095566,Kedlaya; Kiran S.,9997,0,9999,2
1657398934628,MATH 197,003,095567,Xiao; Ming,9999,0,9999,0
1657398934628,MATH 197,004,095571,Perols; Johan Lars,9998,0,9999,1
1657398941692,COGS 9,A01,083615,Shannon; Kyle Michael,9,0,75,66
1657398947718,COGS 11,A01,083617,Boyle; Mary E. T.,22,0,48,26
1657398953742,COGS 13,A01,083071,Bastos; Amalia Pinkusfeld,11,0,71,60
1657398959765,COGS 14A,A01,092681,Semenuks; Arturs,4,1,100,96
1657398965793,COGS 14B,A01,083073,Cheng; Tzu-Han,6,0,63,57
1657398971819,COGS 17,A01,092677,Semenuks; Arturs,6,0,81,75
1657398977847,COGS 100,A01,083619,Allen; Michael Gordon,17,0,70,53
1657398983870,COGS 101A,A01,083621,Davis; Joshua Daniel,9,0,68,59
1657398989895,COGS 101B,A01,091572,Allen; Michael Gordon,11,0,65,54
1657398995918,COGS 101C,A01,083625,Delgado; Tania,17,0,35,18
1657399001944,COGS 107A,A01,083627,Boyle; Mary E. T.,13,0,60,47
1657399007967,COGS 118A,A01,083075,Gupta; Anjum,20,0,76,56
1657399013990,CSE 3,A50,083646,Miranda; Gregory Joseph,24,0,50,26
1657399020017,CSE 8A,A50,083650,Miranda; Gregory Joseph,17,1,56,39
1657399026040,CSE 11,A01,083080,Cao; Yingjun,6,15,40,34
1657399032062,CSE 12,A01,083652,Krause-Levy; Sophia Louisa,28,1,120,92
1657399038089,CSE 15L,A01,083654,Morris; Justin Loren,9,0,50,41
1657399038089,CSE 15L,A02,083655,Morris; Justin Loren,9,0,50,41
1657399044111,CSE 20,A01,083657,Tran; Khoa Dang,39,0,80,41
1657399050139,CSE 21,A01,095574,Bach; Quang Tran,22,0,48,26
1657399056165,CSE 30,A01,083084,Eldon; John,4,0,80,76
1657399056165,CSE 30,B01,095061,Bhaskar; Nishant,9,0,50,41
1657399062188,CSE 100,A01,083659,Cao; Yingjun,5,4,70,65
1657399068212,CSE 134B,A01,083661,Powell; Thomas Allan,22,0,100,78
1657399074235,CSE 140,A01,083663,Gungor; Onat,14,0,85,71
1657399080266,CSE 140L,A01,083088,Eldon; John,21,0,100,79
1657399086288,CSE 175,A01,083665,Kumar; Rakesh,3,0,25,22
1657399092315,CSE 190,A00,092507,Dubnov; Shlomo,7,0,20,13
1657399098338,ECE 45,A01,083139,Congero; Spencer William,6,0,75,69
1657399104366,ECE 65,A50,083695,Saad; Andrew S,12,0,30,18
1657399104366,ECE 65,A51,095125,Saad; Andrew S,24,0,26,2
1657399110390,ECE 109,A01,091882,Touri; Behrouz,19,0,70,51
1657399116414,ECE 180,A00,083140,Abi Samra; Nicholas Camill,1,0,30,29
1657399116414,ECE 180,B00,083141,Abi Samra; Nicholas Camill,0,0,30,30
1657399122436,MATH 10A,A01,083735,Patchell; Gregory David,2,0,30,28
1657399122436,MATH 10A,A02,083736,Patchell; Gregory David,20,0,30,10
1657399122436,MATH 10A,A03,083737,Patchell; Gregory David,16,0,30,14
1657399128460,MATH 10B,A01,083207,Lim; Seonhee,8,0,34,26
1657399128460,MATH 10B,A02,083208,Lim; Seonhee,9,0,35,26
1657399128460,MATH 10B,A03,093472,Lim; Seonhee,7,0,34,27
1657399128460,MATH 10B,B01,083739,Sinha; Shubham,12,0,30,18
1657399134484,MATH 18,A01,083743,Cinel; Cameron Alexander,7,0,30,23
1657399134484,MATH 18,A02,083744,Cinel; Cameron Alexander,17,0,30,13
1657399134484,MATH 18,A03,083745,Cinel; Cameron Alexander,9,0,30,21
1657399134484,MATH 18,B01,083748,Rideout; David Porter,5,0,37,32
1657399134484,MATH 18,B02,083749,Rideout; David Porter,5,0,36,31
1657399134484,MATH 18,B03,083750,Rideout; David Porter,3,0,37,34
1657399134484,MATH 18,B04,083751,Rideout; David Porter,6,0,36,30
1657399134484,MATH 18,B05,093473,Rideout; David Porter,6,0,36,30
1657399134484,MATH 18,B06,093474,Rideout; David Porter,6,0,36,30
1657399140507,MATH 20A,A01,083754,Zheng; Zequn,14,0,40,26
1657399146540,MATH 20B,A01,083756,Briones; Jor-el Thomas Caparas,4,0,36,32
1657399146540,MATH 20B,A02,083757,Briones; Jor-el Thomas Caparas,1,0,36,35
1657399146540,MATH 20B,A03,093475,Briones; Jor-el Thomas Caparas,2,0,36,34
1657399152568,MATH 20C,A01,083760,Briones; Jor-el Thomas Caparas,1,0,35,34
1657399152568,MATH 20C,A02,083761,Briones; Jor-el Thomas Caparas,8,0,35,27
1657399152568,MATH 20C,A03,093476,Briones; Jor-el Thomas Caparas,0,1,36,36
1657399152568,MATH 20C,B01,083762,Bach; Quang Tran,1,0,30,29
1657399158594,MATH 20D,A01,083765,Tran; Brian Kha,5,0,30,25
1657399158594,MATH 20D,A02,083766,Tran; Brian Kha,5,0,30,25
1657399158594,MATH 20D,A03,083767,Tran; Brian Kha,5,0,30,25
1657399164615,MATH 20E,A01,083771,Ganguly; Soumya,9,0,32,23
1657399164615,MATH 20E,A02,083772,Ganguly; Soumya,6,0,32,26
1657399164615,MATH 20E,B01,083773,Ciotti; Benjamin,20,0,35,15
1657399164615,MATH 20E,B02,083774,Ciotti; Benjamin,17,0,35,18
1657399170645,MATH 103A,A01,083777,Greenfeld; Be'Eri,3,0,36,33
1657399170645,MATH 103A,A02,083778,Greenfeld; Be'Eri,5,0,36,31
1657399170645,MATH 103A,A03,093561,Greenfeld; Be'Eri,5,0,36,31
1657399170645,MATH 103A,B01,083779,Greenfeld; Be'Eri,7,0,36,29
1657399170645,MATH 103A,B02,083780,Greenfeld; Be'Eri,4,0,36,32
1657399170645,MATH 103A,B03,093562,Greenfeld; Be'Eri,3,0,36,33
1657399176670,MATH 105,A01,085443,Carter; Anne Toulson,15,0,35,20
1657399176670,MATH 105,A02,093477,Carter; Anne Toulson,20,0,35,15
1657399182692,MATH 109,A01,083213,Ganzberger; Geoffrey Michael,2,0,34,32
1657399182692,MATH 109,A02,083214,Ganzberger; Geoffrey Michael,4,0,34,30
1657399182692,MATH 109,A03,093478,Ganzberger; Geoffrey Michael,2,0,34,32
1657399182692,MATH 109,B01,083215,Ganzberger; Geoffrey Michael,1,0,32,31
1657399182692,MATH 109,B02,083216,Ganzberger; Geoffrey Michael,2,0,32,30
1657399182692,MATH 109,B03,093479,Ganzberger; Geoffrey Michael,8,0,32,24
1657399188715,MATH 142A,A01,083219,Chow; Bennett,7,0,32,25
1657399188715,MATH 142A,A02,083220,Chow; Bennett,10,0,32,22
1657399188715,MATH 142A,A03,093480,Chow; Bennett,8,0,32,24
1657399188715,MATH 142A,B03,093481,Chow; Bennett,8,0,32,24
1657399188715,MATH 142A,B04,093558,Chow; Bennett,13,0,32,19
1657399188715,MATH 142A,B05,093559,Chow; Bennett,6,0,32,26
1657399194738,MATH 193A,A01,083224,Rotar; Vladimir,8,0,34,26
1657399194738,MATH 193A,A02,083225,Rotar; Vladimir,9,0,34,25
1657399194738,MATH 193A,A03,083781,Rotar; Vladimir,5,0,34,29
1657399194738,MATH 193A,A04,083782,Rotar; Vladimir,10,0,34,24
1657399194738,MATH 193A,A05,093482,Rotar; Vladimir,10,0,34,24
1657399200760,MATH 197,001,091859,McAuley; Julian John,9999,0,9999,0
1657399200760,MATH 197,002,095566,Kedlaya; Kiran S.,9997,0,9999,2
1657399200760,MATH 197,003,095567,Xiao; Ming,9999,0,9999,0
1657399200760,MATH 197,004,095571,Perols; Johan Lars,9998,0,9999,1
1657399207814,COGS 9,A01,083615,Shannon; Kyle Michael,9,0,75,66
1657399213840,COGS 11,A01,083617,Boyle; Mary E. T.,22,0,48,26
1657399219863,COGS 13,A01,083071,Bastos; Amalia Pinkusfeld,11,0,71,60
1657399225891,COGS 14A,A01,092681,Semenuks; Arturs,4,1,100,96
1657399231913,COGS 14B,A01,083073,Cheng; Tzu-Han,6,0,63,57
1657399237946,COGS 17,A01,092677,Semenuks; Arturs,6,0,81,75
1657399243969,COGS 100,A01,083619,Allen; Michael Gordon,17,0,70,53
1657399249996,COGS 101A,A01,083621,Davis; Joshua Daniel,9,0,68,59
1657399256023,COGS 101B,A01,091572,Allen; Michael Gordon,11,0,65,54
1657399262046,COGS 101C,A01,083625,Delgado; Tania,17,0,35,18
1657399268072,COGS 107A,A01,083627,Boyle; Mary E. T.,13,0,60,47
1657399274097,COGS 118A,A01,083075,Gupta; Anjum,20,0,76,56
1657399280124,CSE 3,A50,083646,Miranda; Gregory Joseph,24,0,50,26
1657399286146,CSE 8A,A50,083650,Miranda; Gregory Joseph,17,1,56,39
1657399292178,CSE 11,A01,083080,Cao; Yingjun,6,15,40,34
1657399298210,CSE 12,A01,083652,Krause-Levy; Sophia Louisa,28,1,120,92
1657399304237,CSE 15L,A01,083654,Morris; Justin Loren,9,0,50,41
1657399304237,CSE 15L,A02,083655,Morris; Justin Loren,9,0,50,41
1657399310262,CSE 20,A01,083657,Tran; Khoa Dang,39,0,80,41
1657399316289,CSE 21,A01,095574,Bach; Quang Tran,22,0,48,26
1657399322316,CSE 30,A01,083084,Eldon; John,4,0,80,76
1657399322316,CSE 30,B01,095061,Bhaskar; Nishant,9,0,50,41
1657399328341,CSE 100,A01,083659,Cao; Yingjun,5,4,70,65
1657399334363,CSE 134B,A01,083661,Powell; Thomas Allan,22,0,100,78
1657399340390,CSE 140,A01,083663,Gungor; Onat,14,0,85,71
1657399346417,CSE 140L,A01,083088,Eldon; John,21,0,100,79
1657399352449,CSE 175,A01,083665,Kumar; Rakesh,3,0,25,22
1657399358474,CSE 190,A00,092507,Dubnov; Shlomo,7,0,20,13
1657399364501,ECE 45,A01,083139,Congero; Spencer William,6,0,75,69
1657399370602,ECE 65,A50,083695,Saad; Andrew S,12,0,30,18
1657399370602,ECE 65,A51,095125,Saad; Andrew S,24,0,26,2
1657399376625,ECE 109,A01,091882,Touri; Behrouz,19,0,70,51
1657399382651,ECE 180,A00,083140,Abi Samra; Nicholas Camill,1,0,30,29
1657399382651,ECE 180,B00,083141,Abi Samra; Nicholas Camill,0,0,30,30
1657399388678,MATH 10A,A01,083735,Patchell; Gregory David,2,0,30,28
1657399388678,MATH 10A,A02,083736,Patchell; Gregory David,20,0,30,10
1657399388678,MATH 10A,A03,083737,Patchell; Gregory David,16,0,30,14
1657399394706,MATH 10B,A01,083207,Lim; Seonhee,8,0,34,26
1657399394706,MATH 10B,A02,083208,Lim; Seonhee,9,0,35,26
1657399394706,MATH 10B,A03,093472,Lim; Seonhee,7,0,34,27
1657399394706,MATH 10B,B01,083739,Sinha; Shubham,12,0,30,18
1657399400730,MATH 18,A01,083743,Cinel; Cameron Alexander,7,0,30,23
1657399400730,MATH 18,A02,083744,Cinel; Cameron Alexander,17,0,30,13
1657399400730,MATH 18,A03,083745,Cinel; Cameron Alexander,9,0,30,21
1657399400730,MATH 18,B01,083748,Rideout; David Porter,5,0,37,32
1657399400730,MATH 18,B02,083749,Rideout; David Porter,5,0,36,31
1657399400730,MATH 18,B03,083750,Rideout; David Porter,3,0,37,34
1657399400730,MATH 18,B04,083751,Rideout; David Porter,6,0,36,30
1657399400730,MATH 18,B05,093473,Rideout; David Porter,6,0,36,30
1657399400730,MATH 18,B06,093474,Rideout; David Porter,6,0,36,30
1657399406756,MATH 20A,A01,083754,Zheng; Zequn,14,0,40,26
1657399412779,MATH 20B,A01,083756,Briones; Jor-el Thomas Caparas,4,0,36,32
1657399412779,MATH 20B,A02,083757,Briones; Jor-el Thomas Caparas,1,0,36,35
1657399412779,MATH 20B,A03,093475,Briones; Jor-el Thomas Caparas,2,0,36,34
1657399418802,MATH 20C,A01,083760,Briones; Jor-el Thomas Caparas,1,0,35,34
1657399418802,MATH 20C,A02,083761,Briones; Jor-el Thomas Caparas,8,0,35,27
1657399418802,MATH 20C,A03,093476,Briones; Jor-el Thomas Caparas,0,1,36,36
1657399418802,MATH 20C,B01,083762,Bach; Quang Tran,1,0,30,29
1657399424825,MATH 20D,A01,083765,Tran; Brian Kha,5,0,30,25
1657399424825,MATH 20D,A02,083766,Tran; Brian Kha,5,0,30,25
1657399424825,MATH 20D,A03,083767,Tran; Brian Kha,5,0,30,25
1657399430849,MATH 20E,A01,083771,Ganguly; Soumya,9,0,32,23
1657399430849,MATH 20E,A02,083772,Ganguly; Soumya,6,0,32,26
1657399430849,MATH 20E,B01,083773,Ciotti; Benjamin,20,0,35,15
1657399430849,MATH 20E,B02,083774,Ciotti; Benjamin,17,0,35,18
1657399436874,MATH 103A,A01,083777,Greenfeld; Be'Eri,3,0,36,33
1657399436874,MATH 103A,A02,083778,Greenfeld; Be'Eri,5,0,36,31
1657399436874,MATH 103A,A03,093561,Greenfeld; Be'Eri,5,0,36,31
1657399436874,MATH 103A,B01,083779,Greenfeld; Be'Eri,7,0,36,29
1657399436874,MATH 103A,B02,083780,Greenfeld; Be'Eri,4,0,36,32
1657399436874,MATH 103A,B03,093562,Greenfeld; Be'Eri,3,0,36,33
1657399442902,MATH 105,A01,085443,Carter; Anne Toulson,15,0,35,20
1657399442902,MATH 105,A02,093477,Carter; Anne Toulson,20,0,35,15
1657399448931,MATH 109,A01,083213,Ganzberger; Geoffrey Michael,2,0,34,32
1657399448931,MATH 109,A02,083214,Ganzberger; Geoffrey Michael,4,0,34,30
1657399448931,MATH 109,A03,093478,Ganzberger; Geoffrey Michael,2,0,34,32
1657399448931,MATH 109,B01,083215,Ganzberger; Geoffrey Michael,1,0,32,31
1657399448931,MATH 109,B02,083216,Ganzberger; Geoffrey Michael,2,0,32,30
1657399448931,MATH 109,B03,093479,Ganzberger; Geoffrey Michael,8,0,32,24
1657399454962,MATH 142A,A01,083219,Chow; Bennett,7,0,32,25
1657399454962,MATH 142A,A02,083220,Chow; Bennett,10,0,32,22
1657399454962,MATH 142A,A03,093480,Chow; Bennett,8,0,32,24
1657399454962,MATH 142A,B03,093481,Chow; Bennett,8,0,32,24
1657399454962,MATH 142A,B04,093558,Chow; Bennett,13,0,32,19
1657399454962,MATH 142A,B05,093559,Chow; Bennett,6,0,32,26
1657399460989,MATH 193A,A01,083224,Rotar; Vladimir,8,0,34,26
1657399460989,MATH 193A,A02,083225,Rotar; Vladimir,9,0,34,25
1657399460989,MATH 193A,A03,083781,Rotar; Vladimir,5,0,34,29
1657399460989,MATH 193A,A04,083782,Rotar; Vladimir,10,0,34,24
1657399460989,MATH 193A,A05,093482,Rotar; Vladimir,10,0,34,24
1657399467015,MATH 197,001,091859,McAuley; Julian John,9999,0,9999,0
1657399467015,MATH 197,002,095566,Kedlaya; Kiran S.,9997,0,9999,2
1657399467015,MATH 197,003,095567,Xiao; Ming,9999,0,9999,0
1657399467015,MATH 197,004,095571,Perols; Johan Lars,9998,0,9999,1
1657399474068,COGS 9,A01,083615,Shannon; Kyle Michael,9,0,75,66
1657399480091,COGS 11,A01,083617,Boyle; Mary E. T.,22,0,48,26
1657399486114,COGS 13,A01,083071,Bastos; Amalia Pinkusfeld,11,0,71,60
1657399492137,COGS 14A,A01,092681,Semenuks; Arturs,4,1,100,96
1657399498161,COGS 14B,A01,083073,Cheng; Tzu-Han,6,0,63,57
1657399504192,COGS 17,A01,092677,Semenuks; Arturs,6,0,81,75
1657399510222,COGS 100,A01,083619,Allen; Michael Gordon,17,0,70,53
1657399516247,COGS 101A,A01,083621,Davis; Joshua Daniel,9,0,68,59
1657399522278,COGS 101B,A01,091572,Allen; Michael Gordon,11,0,65,54
1657399528301,COGS 101C,A01,083625,Delgado; Tania,17,0,35,18
1657399534326,COGS 107A,A01,083627,Boyle; Mary E. T.,13,0,60,47
1657399540350,COGS 118A,A01,083075,Gupta; Anjum,20,0,76,56
1657399546377,CSE 3,A50,083646,Miranda; Gregory Joseph,24,0,50,26
1657399552403,CSE 8A,A50,083650,Miranda; Gregory Joseph,17,1,56,39
1657399558424,CSE 11,A01,083080,Cao; Yingjun,6,15,40,34
1657399564449,CSE 12,A01,083652,Krause-Levy; Sophia Louisa,28,1,120,92
1657399570473,CSE 15L,A01,083654,Morris; Justin Loren,9,0,50,41
1657399570473,CSE 15L,A02,083655,Morris; Justin Loren,9,0,50,41
1657399576496,CSE 20,A01,083657,Tran; Khoa Dang,39,0,80,41
1657399582519,CSE 21,A01,095574,Bach; Quang Tran,22,0,48,26
1657399588546,CSE 30,A01,083084,Eldon; John,4,0,80,76
1657399588546,CSE 30,B01,095061,Bhaskar; Nishant,9,0,50,41
1657399594571,CSE 100,A01,083659,Cao; Yingjun,5,4,70,65
1657399600593,CSE 134B,A01,083661,Powell; Thomas Allan,22,0,100,78
1657399606616,CSE 140,A01,083663,Gungor; Onat,14,0,85,71
1657399612649,CSE 140L,A01,083088,Eldon; John,21,0,100,79
1657399618671,CSE 175,A01,083665,Kumar; Rakesh,3,0,25,22
1657399624696,CSE 190,A00,092507,Dubnov; Shlomo,7,0,20,13
1657399630717,ECE 45,A01,083139,Congero; Spencer William,6,0,75,69
1657399636741,ECE 65,A50,083695,Saad; Andrew S,12,0,30,18
1657399636741,ECE 65,A51,095125,Saad; Andrew S,24,0,26,2
1657399642764,ECE 109,A01,091882,Touri; Behrouz,19,0,70,51
1657399648786,ECE 180,A00,083140,Abi Samra; Nicholas Camill,1,0,30,29
1657399648786,ECE 180,B00,083141,Abi Samra; Nicholas Camill,0,0,30,30
1657399654813,MATH 10A,A01,083735,Patchell; Gregory David,2,0,30,28
1657399654813,MATH 10A,A02,083736,Patchell; Gregory David,20,0,30,10
1657399654813,MATH 10A,A03,083737,Patchell; Gregory David,16,0,30,14
1657399660850,MATH 10B,A01,083207,Lim; Seonhee,8,0,34,26
1657399660850,MATH 10B,A02,083208,Lim; Seonhee,9,0,35,26
1657399660850,MATH 10B,A03,093472,Lim; Seonhee,7,0,34,27
1657399660850,MATH 10B,B01,083739,Sinha; Shubham,12,0,30,18
1657399666880,MATH 18,A01,083743,Cinel; Cameron Alexander,7,0,30,23
1657399666880,MATH 18,A02,083744,Cinel; Cameron Alexander,17,0,30,13
1657399666880,MATH 18,A03,083745,Cinel; Cameron Alexander,9,0,30,21
1657399666880,MATH 18,B01,083748,Rideout; David Porter,5,0,37,32
1657399666880,MATH 18,B02,083749,Rideout; David Porter,5,0,36,31
1657399666880,MATH 18,B03,083750,Rideout; David Porter,3,0,37,34
1657399666880,MATH 18,B04,083751,Rideout; David Porter,6,0,36,30
1657399666880,MATH 18,B05,093473,Rideout; David Porter,6,0,36,30
1657399666880,MATH 18,B06,093474,Rideout; David Porter,6,0,36,30
1657399672905,MATH 20A,A01,083754,Zheng; Zequn,14,0,40,26
1657399678935,MATH 20B,A01,083756,Briones; Jor-el Thomas Caparas,4,0,36,32
1657399678935,MATH 20B,A02,083757,Briones; Jor-el Thomas Caparas,1,0,36,35
1657399678935,MATH 20B,A03,093475,Briones; Jor-el Thomas Caparas,2,0,36,34
1657399684962,MATH 20C,A01,083760,Briones; Jor-el Thomas Caparas,1,0,35,34
1657399684962,MATH 20C,A02,083761,Briones; Jor-el Thomas Caparas,8,0,35,27
1657399684962,MATH 20C,A03,093476,Briones; Jor-el Thomas Caparas,0,1,36,36
1657399684962,MATH 20C,B01,083762,Bach; Quang Tran,1,0,30,29
1657399690984,MATH 20D,A01,083765,Tran; Brian Kha,5,0,30,25
1657399690984,MATH 20D,A02,083766,Tran; Brian Kha,5,0,30,25
1657399690984,MATH 20D,A03,083767,Tran; Brian Kha,5,0,30,25
1657399697007,MATH 20E,A01,083771,Ganguly; Soumya,9,0,32,23
1657399697007,MATH 20E,A02,083772,Ganguly; Soumya,6,0,32,26
1657399697007,MATH 20E,B01,083773,Ciotti; Benjamin,20,0,35,15
1657399697007,MATH 20E,B02,083774,Ciotti; Benjamin,17,0,35,18
1657399703039,MATH 103A,A01,083777,Greenfeld; Be'Eri,3,0,36,33
1657399703039,MATH 103A,A02,083778,Greenfeld; Be'Eri,5,0,36,31
1657399703039,MATH 103A,A03,093561,Greenfeld; Be'Eri,5,0,36,31
1657399703039,MATH 103A,B01,083779,Greenfeld; Be'Eri,7,0,36,29
1657399703039,MATH 103A,B02,083780,Greenfeld; Be'Eri,4,0,36,32
1657399703039,MATH 103A,B03,093562,Greenfeld; Be'Eri,3,0,36,33
1657399709062,MATH 105,A01,085443,Carter; Anne Toulson,15,0,35,20
1657399709062,MATH 105,A02,093477,Carter; Anne Toulson,20,0,35,15
1657399715085,MATH 109,A01,083213,Ganzberger; Geoffrey Michael,2,0,34,32
1657399715085,MATH 109,A02,083214,Ganzberger; Geoffrey Michael,4,0,34,30
1657399715085,MATH 109,A03,093478,Ganzberger; Geoffrey Michael,2,0,34,32
1657399715085,MATH 109,B01,083215,Ganzberger; Geoffrey Michael,1,0,32,31
1657399715085,MATH 109,B02,083216,Ganzberger; Geoffrey Michael,2,0,32,30
1657399715085,MATH 109,B03,093479,Ganzberger; Geoffrey Michael,8,0,32,24
1657399721122,MATH 142A,A01,083219,Chow; Bennett,7,0,32,25
1657399721122,MATH 142A,A02,083220,Chow; Bennett,10,0,32,22
1657399721122,MATH 142A,A03,093480,Chow; Bennett,8,0,32,24
1657399721122,MATH 142A,B03,093481,Chow; Bennett,8,0,32,24
1657399721122,MATH 142A,B04,093558,Chow; Bennett,13,0,32,19
1657399721122,MATH 142A,B05,093559,Chow; Bennett,6,0,32,26
1657399727151,MATH 193A,A01,083224,Rotar; Vladimir,8,0,34,26
1657399727151,MATH 193A,A02,083225,Rotar; Vladimir,9,0,34,25
1657399727151,MATH 193A,A03,083781,Rotar; Vladimir,5,0,34,29
1657399727151,MATH 193A,A04,083782,Rotar; Vladimir,10,0,34,24
1657399727151,MATH 193A,A05,093482,Rotar; Vladimir,10,0,34,24
1657399733198,MATH 197,001,091859,McAuley; Julian John,9999,0,9999,0
1657399733198,MATH 197,002,095566,Kedlaya; Kiran S.,9997,0,9999,2
1657399733198,MATH 197,003,095567,Xiao; Ming,9999,0,9999,0
1657399733198,MATH 197,004,095571,Perols; Johan Lars,9998,0,9999,1
1657399740263,COGS 9,A01,083615,Shannon; Kyle Michael,9,0,75,66
1657399746285,COGS 11,A01,083617,Boyle; Mary E. T.,22,0,48,26
1657399752313,COGS 13,A01,083071,Bastos; Amalia Pinkusfeld,11,0,71,60
1657399758335,COGS 14A,A01,092681,Semenuks; Arturs,4,1,100,96
1657399764362,COGS 14B,A01,083073,Cheng; Tzu-Han,6,0,63,57
1657399770388,COGS 17,A01,092677,Semenuks; Arturs,6,0,81,75
1657399776415,COGS 100,A01,083619,Allen; Michael Gordon,17,0,70,53
1657399782443,COGS 101A,A01,083621,Davis; Joshua Daniel,9,0,68,59
1657399788466,COGS 101B,A01,091572,Allen; Michael Gordon,11,0,65,54
1657399794489,COGS 101C,A01,083625,Delgado; Tania,17,0,35,18
1657399800513,COGS 107A,A01,083627,Boyle; Mary E. T.,13,0,60,47
1657399806560,COGS 118A,A01,083075,Gupta; Anjum,20,0,76,56
1657399812584,CSE 3,A50,083646,Miranda; Gregory Joseph,24,0,50,26
1657399818622,CSE 8A,A50,083650,Miranda; Gregory Joseph,17,1,56,39
1657399824678,CSE 11,A01,083080,Cao; Yingjun,6,15,40,34
1657399830701,CSE 12,A01,083652,Krause-Levy; Sophia Louisa,28,1,120,92
1657399836728,CSE 15L,A01,083654,Morris; Justin Loren,9,0,50,41
1657399836728,CSE 15L,A02,083655,Morris; Justin Loren,9,0,50,41
1657399842768,CSE 20,A01,083657,Tran; Khoa Dang,39,0,80,41
1657399848801,CSE 21,A01,095574,Bach; Quang Tran,22,0,48,26
1657399854847,CSE 30,A01,083084,Eldon; John,4,0,80,76
1657399854847,CSE 30,B01,095061,Bhaskar; Nishant,9,0,50,41
1657399860903,CSE 100,A01,083659,Cao; Yingjun,5,4,70,65
1657399866926,CSE 134B,A01,083661,Powell; Thomas Allan,22,0,100,78
1657399872978,CSE 140,A01,083663,Gungor; Onat,14,0,85,71
1657399879028,CSE 140L,A01,083088,Eldon; John,21,0,100,79
1657399885050,CSE 175,A01,083665,Kumar; Rakesh,3,0,25,22
1657399891072,CSE 190,A00,092507,Dubnov; Shlomo,7,0,20,13
1657399897104,ECE 45,A01,083139,Congero; Spencer William,6,0,75,69
1657399903140,ECE 65,A50,083695,Saad; Andrew S,12,0,30,18
1657399903140,ECE 65,A51,095125,Saad; Andrew S,24,0,26,2
1657399909184,ECE 109,A01,091882,Touri; Behrouz,19,0,70,51
1657399915207,ECE 180,A00,083140,Abi Samra; Nicholas Camill,1,0,30,29
1657399915207,ECE 180,B00,083141,Abi Samra; Nicholas Camill,0,0,30,30
1657399921230,MATH 10A,A01,083735,Patchell; Gregory David,2,0,30,28
1657399921230,MATH 10A,A02,083736,Patchell; Gregory David,20,0,30,10
1657399921230,MATH 10A,A03,083737,Patchell; Gregory David,16,0,30,14
1657399927271,MATH 10B,A01,083207,Lim; Seonhee,8,0,34,26
1657399927271,MATH 10B,A02,083208,Lim; Seonhee,9,0,35,26
1657399927271,MATH 10B,A03,093472,Lim; Seonhee,7,0,34,27
1657399927271,MATH 10B,B01,083739,Sinha; Shubham,12,0,30,18
1657399933296,MATH 18,A01,083743,Cinel; Cameron Alexander,7,0,30,23
1657399933296,MATH 18,A02,083744,Cinel; Cameron Alexander,17,0,30,13
1657399933296,MATH 18,A03,083745,Cinel; Cameron Alexander,9,0,30,21
1657399933296,MATH 18,B01,083748,Rideout; David Porter,5,0,37,32
1657399933296,MATH 18,B02,083749,Rideout; David Porter,5,0,36,31
1657399933296,MATH 18,B03,083750,Rideout; David Porter,3,0,37,34
1657399933296,MATH 18,B04,083751,Rideout; David Porter,6,0,36,30
1657399933296,MATH 18,B05,093473,Rideout; David Porter,6,0,36,30
1657399933296,MATH 18,B06,093474,Rideout; David Porter,6,0,36,30
1657399939320,MATH 20A,A01,083754,Zheng; Zequn,14,0,40,26
1657399945344,MATH 20B,A01,083756,Briones; Jor-el Thomas Caparas,4,0,36,32
1657399945344,MATH 20B,A02,083757,Briones; Jor-el Thomas Caparas,1,0,36,35
1657399945344,MATH 20B,A03,093475,Briones; Jor-el Thomas Caparas,2,0,36,34
1657399951368,MATH 20C,A01,083760,Briones; Jor-el Thomas Caparas,1,0,35,34
1657399951368,MATH 20C,A02,083761,Briones; Jor-el Thomas Caparas,8,0,35,27
1657399951368,MATH 20C,A03,093476,Briones; Jor-el Thomas Caparas,0,1,36,36
1657399951368,MATH 20C,B01,083762,Bach; Quang Tran,1,0,30,29
1657399957413,MATH 20D,A01,083765,Tran; Brian Kha,5,0,30,25
1657399957413,MATH 20D,A02,083766,Tran; Brian Kha,5,0,30,25
1657399957413,MATH 20D,A03,083767,Tran; Brian Kha,5,0,30,25
1657399963459,MATH 20E,A01,083771,Ganguly; Soumya,9,0,32,23
1657399963459,MATH 20E,A02,083772,Ganguly; Soumya,6,0,32,26
1657399963459,MATH 20E,B01,083773,Ciotti; Benjamin,20,0,35,15
1657399963459,MATH 20E,B02,083774,Ciotti; Benjamin,17,0,35,18
1657399969580,MATH 103A,A01,083777,Greenfeld; Be'Eri,3,0,36,33
1657399969580,MATH 103A,A02,083778,Greenfeld; Be'Eri,5,0,36,31
1657399969580,MATH 103A,A03,093561,Greenfeld; Be'Eri,5,0,36,31
1657399969580,MATH 103A,B01,083779,Greenfeld; Be'Eri,7,0,36,29
1657399969580,MATH 103A,B02,083780,Greenfeld; Be'Eri,4,0,36,32
1657399969580,MATH 103A,B03,093562,Greenfeld; Be'Eri,3,0,36,33
1657399975620,MATH 105,A01,085443,Carter; Anne Toulson,15,0,35,20
1657399975620,MATH 105,A02,093477,Carter; Anne Toulson,20,0,35,15
1657399981665,MATH 109,A01,083213,Ganzberger; Geoffrey Michael,2,0,34,32
1657399981665,MATH 109,A02,083214,Ganzberger; Geoffrey Michael,4,0,34,30
1657399981665,MATH 109,A03,093478,Ganzberger; Geoffrey Michael,2,0,34,32
1657399981665,MATH 109,B01,083215,Ganzberger; Geoffrey Michael,1,0,32,31
1657399981665,MATH 109,B02,083216,Ganzberger; Geoffrey Michael,2,0,32,30
1657399981665,MATH 109,B03,093479,Ganzberger; Geoffrey Michael,8,0,32,24
1657399987709,MATH 142A,A01,083219,Chow; Bennett,7,0,32,25
1657399987709,MATH 142A,A02,083220,Chow; Bennett,10,0,32,22
1657399987709,MATH 142A,A03,093480,Chow; Bennett,8,0,32,24
1657399987709,MATH 142A,B03,093481,Chow; Bennett,8,0,32,24
1657399987709,MATH 142A,B04,093558,Chow; Bennett,13,0,32,19
1657399987709,MATH 142A,B05,093559,Chow; Bennett,6,0,32,26
1657399993730,MATH 193A,A01,083224,Rotar; Vladimir,8,0,34,26
1657399993730,MATH 193A,A02,083225,Rotar; Vladimir,9,0,34,25
1657399993730,MATH 193A,A03,083781,Rotar; Vladimir,5,0,34,29
1657399993730,MATH 193A,A04,083782,Rotar; Vladimir,10,0,34,24
1657399993730,MATH 193A,A05,093482,Rotar; Vladimir,10,0,34,24
1657399999772,MATH 197,001,091859,McAuley; Julian John,9999,0,9999,0
1657399999772,MATH 197,002,095566,Kedlaya; Kiran S.,9997,0,9999,2
1657399999772,MATH 197,003,095567,Xiao; Ming,9999,0,9999,0
1657399999772,MATH 197,004,095571,Perols; Johan Lars,9998,0,9999,1
1657400006872,COGS 9,A01,083615,Shannon; Kyle Michael,9,0,75,66
1657400012899,COGS 11,A01,083617,Boyle; Mary E. T.,22,0,48,26
1657400018925,COGS 13,A01,083071,Bastos; Amalia Pinkusfeld,11,0,71,60
1657400024959,COGS 14A,A01,092681,Semenuks; Arturs,4,1,100,96
1657400030993,COGS 14B,A01,083073,Cheng; Tzu-Han,6,0,63,57
1657400037015,COGS 17,A01,092677,Semenuks; Arturs,6,0,81,75
1657400043064,COGS 100,A01,083619,Allen; Michael Gordon,17,0,70,53
1657400049092,COGS 101A,A01,083621,Davis; Joshua Daniel,9,0,68,59
1657400055123,COGS 101B,A01,091572,Allen; Michael Gordon,11,0,65,54
1657400061147,COGS 101C,A01,083625,Delgado; Tania,17,0,35,18
1657400067185,COGS 107A,A01,083627,Boyle; Mary E. T.,13,0,60,47
1657400073223,COGS 118A,A01,083075,Gupta; Anjum,20,0,76,56
1657400079269,CSE 3,A50,083646,Miranda; Gregory Joseph,24,0,50,26
1657400085291,CSE 8A,A50,083650,Miranda; Gregory Joseph,17,1,56,39
1657400091318,CSE 11,A01,083080,Cao; Yingjun,6,15,40,34
1657400097358,CSE 12,A01,083652,Krause-Levy; Sophia Louisa,28,1,120,92
1657400103396,CSE 15L,A01,083654,Morris; Justin Loren,9,0,50,41
1657400103396,CSE 15L,A02,083655,Morris; Justin Loren,9,0,50,41
1657400109422,CSE 20,A01,083657,Tran; Khoa Dang,39,0,80,41
1657400115445,CSE 21,A01,095574,Bach; Quang Tran,22,0,48,26
1657400121477,CSE 30,A01,083084,Eldon; John,4,0,80,76
1657400121477,CSE 30,B01,095061,Bhaskar; Nishant,9,0,50,41
1657400127503,CSE 100,A01,083659,Cao; Yingjun,5,4,70,65
1657400133530,CSE 134B,A01,083661,Powell; Thomas Allan,22,0,100,78
1657400139562,CSE 140,A01,083663,Gungor; Onat,14,0,85,71
1657400145584,CSE 140L,A01,083088,Eldon; John,21,0,100,79
1657400151608,CSE 175,A01,083665,Kumar; Rakesh,3,0,25,22
1657400157638,CSE 190,A00,092507,Dubnov; Shlomo,7,0,20,13
1657400163668,ECE 45,A01,083139,Congero; Spencer William,6,0,75,69
1657400169690,ECE 65,A50,083695,Saad; Andrew S,12,0,30,18
1657400169690,ECE 65,A51,095125,Saad; Andrew S,24,0,26,2
1657400175722,ECE 109,A01,091882,Touri; Behrouz,19,0,70,51
1657400181749,ECE 180,A00,083140,Abi Samra; Nicholas Camill,1,0,30,29
1657400181749,ECE 180,B00,083141,Abi Samra; Nicholas Camill,0,0,30,30
1657400187774,MATH 10A,A01,083735,Patchell; Gregory David,2,0,30,28
1657400187774,MATH 10A,A02,083736,Patchell; Gregory David,20,0,30,10
1657400187774,MATH 10A,A03,083737,Patchell; Gregory David,16,0,30,14
1657400193799,MATH 10B,A01,083207,Lim; Seonhee,8,0,34,26
1657400193799,MATH 10B,A02,083208,Lim; Seonhee,9,0,35,26
1657400193799,MATH 10B,A03,093472,Lim; Seonhee,7,0,34,27
1657400193799,MATH 10B,B01,083739,Sinha; Shubham,12,0,30,18
1657400199824,MATH 18,A01,083743,Cinel; Cameron Alexander,7,0,30,23
1657400199824,MATH 18,A02,083744,Cinel; Cameron Alexander,17,0,30,13
1657400199824,MATH 18,A03,083745,Cinel; Cameron Alexander,9,0,30,21
1657400199824,MATH 18,B01,083748,Rideout; David Porter,5,0,37,32
1657400199824,MATH 18,B02,083749,Rideout; David Porter,5,0,36,31
1657400199824,MATH 18,B03,083750,Rideout; David Porter,3,0,37,34
1657400199824,MATH 18,B04,083751,Rideout; David Porter,6,0,36,30
1657400199824,MATH 18,B05,093473,Rideout; David Porter,6,0,36,30
1657400199824,MATH 18,B06,093474,Rideout; David Porter,6,0,36,30
1657400205850,MATH 20A,A01,083754,Zheng; Zequn,14,0,40,26
1657400211874,MATH 20B,A01,083756,Briones; Jor-el Thomas Caparas,4,0,36,32
1657400211874,MATH 20B,A02,083757,Briones; Jor-el Thomas Caparas,1,0,36,35
1657400211874,MATH 20B,A03,093475,Briones; Jor-el Thomas Caparas,2,0,36,34
1657400217930,MATH 20C,A01,083760,Briones; Jor-el Thomas Caparas,1,0,35,34
1657400217930,MATH 20C,A02,083761,Briones; Jor-el Thomas Caparas,8,0,35,27
1657400217930,MATH 20C,A03,093476,Briones; Jor-el Thomas Caparas,0,1,36,36
1657400217930,MATH 20C,B01,083762,Bach; Quang Tran,1,0,30,29
1657400223984,MATH 20D,A01,083765,Tran; Brian Kha,5,0,30,25
1657400223984,MATH 20D,A02,083766,Tran; Brian Kha,5,0,30,25
1657400223984,MATH 20D,A03,083767,Tran; Brian Kha,5,0,30,25
1657400230036,MATH 20E,A01,083771,Ganguly; Soumya,9,0,32,23
1657400230036,MATH 20E,A02,083772,Ganguly; Soumya,6,0,32,26
1657400230036,MATH 20E,B01,083773,Ciotti; Benjamin,20,0,35,15
1657400230036,MATH 20E,B02,083774,Ciotti; Benjamin,17,0,35,18
1657400236059,MATH 103A,A01,083777,Greenfeld; Be'Eri,3,0,36,33
1657400236059,MATH 103A,A02,083778,Greenfeld; Be'Eri,5,0,36,31
1657400236059,MATH 103A,A03,093561,Greenfeld; Be'Eri,5,0,36,31
1657400236059,MATH 103A,B01,083779,Greenfeld; Be'Eri,7,0,36,29
1657400236059,MATH 103A,B02,083780,Greenfeld; Be'Eri,4,0,36,32
1657400236059,MATH 103A,B03,093562,Greenfeld; Be'Eri,3,0,36,33
1657400242092,MATH 105,A01,085443,Carter; Anne Toulson,15,0,35,20
1657400242092,MATH 105,A02,093477,Carter; Anne Toulson,20,0,35,15
1657400248126,MATH 109,A01,083213,Ganzberger; Geoffrey Michael,2,0,34,32
1657400248126,MATH 109,A02,083214,Ganzberger; Geoffrey Michael,4,0,34,30
1657400248126,MATH 109,A03,093478,Ganzberger; Geoffrey Michael,2,0,34,32
1657400248126,MATH 109,B01,083215,Ganzberger; Geoffrey Michael,1,0,32,31
1657400248126,MATH 109,B02,083216,Ganzberger; Geoffrey Michael,2,0,32,30
1657400248126,MATH 109,B03,093479,Ganzberger; Geoffrey Michael,8,0,32,24
1657400254154,MATH 142A,A01,083219,Chow; Bennett,7,0,32,25
1657400254154,MATH 142A,A02,083220,Chow; Bennett,10,0,32,22
1657400254154,MATH 142A,A03,093480,Chow; Bennett,8,0,32,24
1657400254154,MATH 142A,B03,093481,Chow; Bennett,8,0,32,24
1657400254154,MATH 142A,B04,093558,Chow; Bennett,13,0,32,19
1657400254154,MATH 142A,B05,093559,Chow; Bennett,6,0,32,26
1657400260177,MATH 193A,A01,083224,Rotar; Vladimir,8,0,34,26
1657400260177,MATH 193A,A02,083225,Rotar; Vladimir,9,0,34,25
1657400260177,MATH 193A,A03,083781,Rotar; Vladimir,5,0,34,29
1657400260177,MATH 193A,A04,083782,Rotar; Vladimir,10,0,34,24
1657400260177,MATH 193A,A05,093482,Rotar; Vladimir,10,0,34,24
1657400266204,MATH 197,001,091859,McAuley; Julian John,9999,0,9999,0
1657400266204,MATH 197,002,095566,Kedlaya; Kiran S.,9997,0,9999,2
1657400266204,MATH 197,003,095567,Xiao; Ming,9999,0,9999,0
1657400266204,MATH 197,004,095571,Perols; Johan Lars,9998,0,9999,1
1657400273278,COGS 9,A01,083615,Shannon; Kyle Michael,9,0,75,66
1657400279302,COGS 11,A01,083617,Boyle; Mary E. T.,22,0,48,26
1657400285325,COGS 13,A01,083071,Bastos; Amalia Pinkusfeld,11,0,71,60
1657400291349,COGS 14A,A01,092681,Semenuks; Arturs,4,1,100,96
1657400297373,COGS 14B,A01,083073,Cheng; Tzu-Han,6,0,63,57
1657400303408,COGS 17,A01,092677,Semenuks; Arturs,6,0,81,75
1657400309432,COGS 100,A01,083619,Allen; Michael Gordon,17,0,70,53
1657400315465,COGS 101A,A01,083621,Davis; Joshua Daniel,9,0,68,59
1657400321495,COGS 101B,A01,091572,Allen; Michael Gordon,11,0,65,54
1657400327542,COGS 101C,A01,083625,Delgado; Tania,17,0,35,18
1657400333571,COGS 107A,A01,083627,Boyle; Mary E. T.,13,0,60,47
1657400339593,COGS 118A,A01,083075,Gupta; Anjum,20,0,76,56
1657400345617,CSE 3,A50,083646,Miranda; Gregory Joseph,24,0,50,26
1657400351657,CSE 8A,A50,083650,Miranda; Gregory Joseph,17,1,56,39
1657400357682,CSE 11,A01,083080,Cao; Yingjun,6,15,40,34
1657400363706,CSE 12,A01,083652,Krause-Levy; Sophia Louisa,28,1,120,92
1657400369738,CSE 15L,A01,083654,Morris; Justin Loren,9,0,50,41
1657400369738,CSE 15L,A02,083655,Morris; Justin Loren,9,0,50,41
1657400375785,CSE 20,A01,083657,Tran; Khoa Dang,39,0,80,41
1657400381815,CSE 21,A01,095574,Bach; Quang Tran,22,0,48,26
1657400387850,CSE 30,A01,083084,Eldon; John,4,0,80,76
1657400387850,CSE 30,B01,095061,Bhaskar; Nishant,9,0,50,41
1657400393876,CSE 100,A01,083659,Cao; Yingjun,5,4,70,65
1657400399911,CSE 134B,A01,083661,Powell; Thomas Allan,22,0,100,78
1657400405949,CSE 140,A01,083663,Gungor; Onat,14,0,85,71
1657400411971,CSE 140L,A01,083088,Eldon; John,21,0,100,79
1657400417993,CSE 175,A01,083665,Kumar; Rakesh,3,0,25,22
1657400424019,CSE 190,A00,092507,Dubnov; Shlomo,7,0,20,13
1657400430055,ECE 45,A01,083139,Congero; Spencer William,6,0,75,69
1657400436100,ECE 65,A50,083695,Saad; Andrew S,12,0,30,18
1657400436100,ECE 65,A51,095125,Saad; Andrew S,24,0,26,2
1657400442122,ECE 109,A01,091882,Touri; Behrouz,19,0,70,51
1657400448173,ECE 180,A00,083140,Abi Samra; Nicholas Camill,1,0,30,29
1657400448173,ECE 180,B00,083141,Abi Samra; Nicholas Camill,0,0,30,30
1657400454213,MATH 10A,A01,083735,Patchell; Gregory David,2,0,30,28
1657400454213,MATH 10A,A02,083736,Patchell; Gregory David,20,0,30,10
1657400454213,MATH 10A,A03,083737,Patchell; Gregory David,16,0,30,14
1657400460249,MATH 10B,A01,083207,Lim; Seonhee,8,0,34,26
1657400460249,MATH 10B,A02,083208,Lim; Seonhee,9,0,35,26
1657400460249,MATH 10B,A03,093472,Lim; Seonhee,7,0,34,27
1657400460249,MATH 10B,B01,083739,Sinha; Shubham,12,0,30,18
1657400466278,MATH 18,A01,083743,Cinel; Cameron Alexander,7,0,30,23
1657400466278,MATH 18,A02,083744,Cinel; Cameron Alexander,17,0,30,13
1657400466278,MATH 18,A03,083745,Cinel; Cameron Alexander,9,0,30,21
1657400466278,MATH 18,B01,083748,Rideout; David Porter,5,0,37,32
1657400466278,MATH 18,B02,083749,Rideout; David Porter,5,0,36,31
1657400466278,MATH 18,B03,083750,Rideout; David Porter,3,0,37,34
1657400466278,MATH 18,B04,083751,Rideout; David Porter,6,0,36,30
1657400466278,MATH 18,B05,093473,Rideout; David Porter,6,0,36,30
1657400466278,MATH 18,B06,093474,Rideout; David Porter,6,0,36,30
1657400472305,MATH 20A,A01,083754,Zheng; Zequn,14,0,40,26
1657400478340,MATH 20B,A01,083756,Briones; Jor-el Thomas Caparas,4,0,36,32
1657400478340,MATH 20B,A02,083757,Briones; Jor-el Thomas Caparas,1,0,36,35
1657400478340,MATH 20B,A03,093475,Briones; Jor-el Thomas Caparas,2,0,36,34
1657400484364,MATH 20C,A01,083760,Briones; Jor-el Thomas Caparas,1,0,35,34
1657400484364,MATH 20C,A02,083761,Briones; Jor-el Thomas Caparas,8,0,35,27
1657400484364,MATH 20C,A03,093476,Briones; Jor-el Thomas Caparas,0,1,36,36
1657400484364,MATH 20C,B01,083762,Bach; Quang Tran,1,0,30,29
1657400490403,MATH 20D,A01,083765,Tran; Brian Kha,5,0,30,25
1657400490403,MATH 20D,A02,083766,Tran; Brian Kha,5,0,30,25
1657400490403,MATH 20D,A03,083767,Tran; Brian Kha,5,0,30,25
1657400496453,MATH 20E,A01,083771,Ganguly; Soumya,9,0,32,23
1657400496453,MATH 20E,A02,083772,Ganguly; Soumya,6,0,32,26
1657400496453,MATH 20E,B01,083773,Ciotti; Benjamin,20,0,35,15
1657400496453,MATH 20E,B02,083774,Ciotti; Benjamin,17,0,35,18
1657400502478,MATH 103A,A01,083777,Greenfeld; Be'Eri,3,0,36,33
1657400502478,MATH 103A,A02,083778,Greenfeld; Be'Eri,5,0,36,31
1657400502478,MATH 103A,A03,093561,Greenfeld; Be'Eri,5,0,36,31
1657400502478,MATH 103A,B01,083779,Greenfeld; Be'Eri,7,0,36,29
1657400502478,MATH 103A,B02,083780,Greenfeld; Be'Eri,4,0,36,32
1657400502478,MATH 103A,B03,093562,Greenfeld; Be'Eri,3,0,36,33
1657400508505,MATH 105,A01,085443,Carter; Anne Toulson,15,0,35,20
1657400508505,MATH 105,A02,093477,Carter; Anne Toulson,20,0,35,15
1657400514541,MATH 109,A01,083213,Ganzberger; Geoffrey Michael,2,0,34,32
1657400514541,MATH 109,A02,083214,Ganzberger; Geoffrey Michael,4,0,34,30
1657400514541,MATH 109,A03,093478,Ganzberger; Geoffrey Michael,2,0,34,32
1657400514541,MATH 109,B01,083215,Ganzberger; Geoffrey Michael,1,0,32,31
1657400514541,MATH 109,B02,083216,Ganzberger; Geoffrey Michael,2,0,32,30
1657400514541,MATH 109,B03,093479,Ganzberger; Geoffrey Michael,8,0,32,24
1657400520593,MATH 142A,A01,083219,Chow; Bennett,7,0,32,25
1657400520593,MATH 142A,A02,083220,Chow; Bennett,10,0,32,22
1657400520593,MATH 142A,A03,093480,Chow; Bennett,8,0,32,24
1657400520593,MATH 142A,B03,093481,Chow; Bennett,8,0,32,24
1657400520593,MATH 142A,B04,093558,Chow; Bennett,13,0,32,19
1657400520593,MATH 142A,B05,093559,Chow; Bennett,6,0,32,26
1657400526623,MATH 193A,A01,083224,Rotar; Vladimir,8,0,34,26
1657400526623,MATH 193A,A02,083225,Rotar; Vladimir,9,0,34,25
1657400526623,MATH 193A,A03,083781,Rotar; Vladimir,5,0,34,29
1657400526623,MATH 193A,A04,083782,Rotar; Vladimir,10,0,34,24
1657400526623,MATH 193A,A05,093482,Rotar; Vladimir,10,0,34,24
1657400532658,MATH 197,001,091859,McAuley; Julian John,9999,0,9999,0
1657400532658,MATH 197,002,095566,Kedlaya; Kiran S.,9997,0,9999,2
1657400532658,MATH 197,003,095567,Xiao; Ming,9999,0,9999,0
1657400532658,MATH 197,004,095571,Perols; Johan Lars,9998,0,9999,1
1657400539727,COGS 9,A01,083615,Shannon; Kyle Michael,9,0,75,66
1657400545751,COGS 11,A01,083617,Boyle; Mary E. T.,22,0,48,26
1657400551790,COGS 13,A01,083071,Bastos; Amalia Pinkusfeld,11,0,71,60
1657400557831,COGS 14A,A01,092681,Semenuks; Arturs,4,1,100,96
1657400563954,COGS 14B,A01,083073,Cheng; Tzu-Han,6,0,63,57
1657400569981,COGS 17,A01,092677,Semenuks; Arturs,6,0,81,75
1657400576012,COGS 100,A01,083619,Allen; Michael Gordon,17,0,70,53
1657400582051,COGS 101A,A01,083621,Davis; Joshua Daniel,9,0,68,59
1657400588092,COGS 101B,A01,091572,Allen; Michael Gordon,11,0,65,54
1657400594116,COGS 101C,A01,083625,Delgado; Tania,17,0,35,18
1657400600151,COGS 107A,A01,083627,Boyle; Mary E. T.,13,0,60,47
1657400606195,COGS 118A,A01,083075,Gupta; Anjum,20,0,76,56
1657400612234,CSE 3,A50,083646,Miranda; Gregory Joseph,24,0,50,26
1657400618274,CSE 8A,A50,083650,Miranda; Gregory Joseph,17,1,56,39
1657400624306,CSE 11,A01,083080,Cao; Yingjun,6,15,40,34
1657400630328,CSE 12,A01,083652,Krause-Levy; Sophia Louisa,28,1,120,92
1657400636382,CSE 15L,A01,083654,Morris; Justin Loren,9,0,50,41
1657400636382,CSE 15L,A02,083655,Morris; Justin Loren,9,0,50,41
1657400642420,CSE 20,A01,083657,Tran; Khoa Dang,39,0,80,41
1657400648460,CSE 21,A01,095574,Bach; Quang Tran,22,0,48,26
1657400654500,CSE 30,A01,083084,Eldon; John,4,0,80,76
1657400654500,CSE 30,B01,095061,Bhaskar; Nishant,9,0,50,41
1657400660538,CSE 100,A01,083659,Cao; Yingjun,5,4,70,65
1657400666561,CSE 134B,A01,083661,Powell; Thomas Allan,22,0,100,78
1657400672584,CSE 140,A01,083663,Gungor; Onat,14,0,85,71
1657400678625,CSE 140L,A01,083088,Eldon; John,21,0,100,79
1657400684650,CSE 175,A01,083665,Kumar; Rakesh,3,0,25,22
1657400690674,CSE 190,A00,092507,Dubnov; Shlomo,7,0,20,13
1657400696701,ECE 45,A01,083139,Congero; Spencer William,6,0,75,69
1657400702731,ECE 65,A50,083695,Saad; Andrew S,12,0,30,18
1657400702731,ECE 65,A51,095125,Saad; Andrew S,24,0,26,2
1657400708757,ECE 109,A01,091882,Touri; Behrouz,19,0,70,51
1657400714784,ECE 180,A00,083140,Abi Samra; Nicholas Camill,1,0,30,29
1657400714784,ECE 180,B00,083141,Abi Samra; Nicholas Camill,0,0,30,30
1657400720831,MATH 10A,A01,083735,Patchell; Gregory David,2,0,30,28
1657400720831,MATH 10A,A02,083736,Patchell; Gregory David,20,0,30,10
1657400720831,MATH 10A,A03,083737,Patchell; Gregory David,16,0,30,14
1657400726858,MATH 10B,A01,083207,Lim; Seonhee,8,0,34,26
1657400726858,MATH 10B,A02,083208,Lim; Seonhee,9,0,35,26
1657400726858,MATH 10B,A03,093472,Lim; Seonhee,7,0,34,27
1657400726858,MATH 10B,B01,083739,Sinha; Shubham,12,0,30,18
1657400732882,MATH 18,A01,083743,Cinel; Cameron Alexander,7,0,30,23
1657400732882,MATH 18,A02,083744,Cinel; Cameron Alexander,17,0,30,13
1657400732882,MATH 18,A03,083745,Cinel; Cameron Alexander,9,0,30,21
1657400732882,MATH 18,B01,083748,Rideout; David Porter,5,0,37,32
1657400732882,MATH 18,B02,083749,Rideout; David Porter,5,0,36,31
1657400732882,MATH 18,B03,083750,Rideout; David Porter,3,0,37,34
1657400732882,MATH 18,B04,083751,Rideout; David Porter,6,0,36,30
1657400732882,MATH 18,B05,093473,Rideout; David Porter,6,0,36,30
1657400732882,MATH 18,B06,093474,Rideout; David Porter,6,0,36,30
1657400738906,MATH 20A,A01,083754,Zheng; Zequn,14,0,40,26
1657400744945,MATH 20B,A01,083756,Briones; Jor-el Thomas Caparas,4,0,36,32
1657400744945,MATH 20B,A02,083757,Briones; Jor-el Thomas Caparas,1,0,36,35
1657400744945,MATH 20B,A03,093475,Briones; Jor-el Thomas Caparas,2,0,36,34
1657400750997,MATH 20C,A01,083760,Briones; Jor-el Thomas Caparas,1,0,35,34
1657400750997,MATH 20C,A02,083761,Briones; Jor-el Thomas Caparas,8,0,35,27
1657400750997,MATH 20C,A03,093476,Briones; Jor-el Thomas Caparas,0,1,36,36
1657400750997,MATH 20C,B01,083762,Bach; Quang Tran,1,0,30,29
1657400757034,MATH 20D,A01,083765,Tran; Brian Kha,5,0,30,25
1657400757034,MATH 20D,A02,083766,Tran; Brian Kha,5,0,30,25
1657400757034,MATH 20D,A03,083767,Tran; Brian Kha,5,0,30,25
1657400763070,MATH 20E,A01,083771,Ganguly; Soumya,9,0,32,23
1657400763070,MATH 20E,A02,083772,Ganguly; Soumya,6,0,32,26
1657400763070,MATH 20E,B01,083773,Ciotti; Benjamin,20,0,35,15
1657400763070,MATH 20E,B02,083774,Ciotti; Benjamin,17,0,35,18
1657400769096,MATH 103A,A01,083777,Greenfeld; Be'Eri,3,0,36,33
1657400769096,MATH 103A,A02,083778,Greenfeld; Be'Eri,5,0,36,31
1657400769096,MATH 103A,A03,093561,Greenfeld; Be'Eri,5,0,36,31
1657400769096,MATH 103A,B01,083779,Greenfeld; Be'Eri,7,0,36,29
1657400769096,MATH 103A,B02,083780,Greenfeld; Be'Eri,4,0,36,32
1657400769096,MATH 103A,B03,093562,Greenfeld; Be'Eri,3,0,36,33
1657400775119,MATH 105,A01,085443,Carter; Anne Toulson,15,0,35,20
1657400775119,MATH 105,A02,093477,Carter; Anne Toulson,20,0,35,15
1657400781142,MATH 109,A01,083213,Ganzberger; Geoffrey Michael,2,0,34,32
1657400781142,MATH 109,A02,083214,Ganzberger; Geoffrey Michael,4,0,34,30
1657400781142,MATH 109,A03,093478,Ganzberger; Geoffrey Michael,2,0,34,32
1657400781142,MATH 109,B01,083215,Ganzberger; Geoffrey Michael,1,0,32,31
1657400781142,MATH 109,B02,083216,Ganzberger; Geoffrey Michael,2,0,32,30
1657400781142,MATH 109,B03,093479,Ganzberger; Geoffrey Michael,8,0,32,24
1657400787173,MATH 142A,A01,083219,Chow; Bennett,7,0,32,25
1657400787173,MATH 142A,A02,083220,Chow; Bennett,10,0,32,22
1657400787173,MATH 142A,A03,093480,Chow; Bennett,8,0,32,24
1657400787173,MATH 142A,B03,093481,Chow; Bennett,8,0,32,24
1657400787173,MATH 142A,B04,093558,Chow; Bennett,13,0,32,19
1657400787173,MATH 142A,B05,093559,Chow; Bennett,6,0,32,26
1657400793196,MATH 193A,A01,083224,Rotar; Vladimir,8,0,34,26
1657400793196,MATH 193A,A02,083225,Rotar; Vladimir,9,0,34,25
1657400793196,MATH 193A,A03,083781,Rotar; Vladimir,5,0,34,29
1657400793196,MATH 193A,A04,083782,Rotar; Vladimir,10,0,34,24
1657400793196,MATH 193A,A05,093482,Rotar; Vladimir,10,0,34,24
1657400799222,MATH 197,001,091859,McAuley; Julian John,9999,0,9999,0
1657400799222,MATH 197,002,095566,Kedlaya; Kiran S.,9997,0,9999,2
1657400799222,MATH 197,003,095567,Xiao; Ming,9999,0,9999,0
1657400799222,MATH 197,004,095571,Perols; Johan Lars,9998,0,9999,1
1657400806310,COGS 9,A01,083615,Shannon; Kyle Michael,9,0,75,66
1657400812347,COGS 11,A01,083617,Boyle; Mary E. T.,22,0,48,26
1657400818374,COGS 13,A01,083071,Bastos; Amalia Pinkusfeld,11,0,71,60
1657400824436,COGS 14A,A01,092681,Semenuks; Arturs,4,1,100,96
1657400830484,COGS 14B,A01,083073,Cheng; Tzu-Han,6,0,63,57
1657400836509,COGS 17,A01,092677,Semenuks; Arturs,6,0,81,75
1657400842534,COGS 100,A01,083619,Allen; Michael Gordon,17,0,70,53
1657400848572,COGS 101A,A01,083621,Davis; Joshua Daniel,9,0,68,59
1657400854628,COGS 101B,A01,091572,Allen; Michael Gordon,11,0,65,54
1657400860650,COGS 101C,A01,083625,Delgado; Tania,17,0,35,18
1657400866677,COGS 107A,A01,083627,Boyle; Mary E. T.,13,0,60,47
1657400872701,COGS 118A,A01,083075,Gupta; Anjum,20,0,76,56
1657400878738,CSE 3,A50,083646,Miranda; Gregory Joseph,24,0,50,26
1657400884776,CSE 8A,A50,083650,Miranda; Gregory Joseph,17,1,56,39
1657400890801,CSE 11,A01,083080,Cao; Yingjun,6,15,40,34
1657400896836,CSE 12,A01,083652,Krause-Levy; Sophia Louisa,28,1,120,92
1657400902883,CSE 15L,A01,083654,Morris; Justin Loren,9,0,50,41
1657400902883,CSE 15L,A02,083655,Morris; Justin Loren,9,0,50,41
1657400908905,CSE 20,A01,083657,Tran; Khoa Dang,39,0,80,41
1657400914928,CSE 21,A01,095574,Bach; Quang Tran,22,0,48,26
1657400920973,CSE 30,A01,083084,Eldon; John,4,0,80,76
1657400920973,CSE 30,B01,095061,Bhaskar; Nishant,9,0,50,41
1657400927022,CSE 100,A01,083659,Cao; Yingjun,5,4,70,65
1657400933044,CSE 134B,A01,083661,Powell; Thomas Allan,22,0,100,78
1657400939083,CSE 140,A01,083663,Gungor; Onat,14,0,85,71
1657400945110,CSE 140L,A01,083088,Eldon; John,21,0,100,79
1657400951165,CSE 175,A01,083665,Kumar; Rakesh,3,0,25,22
1657400957190,CSE 190,A00,092507,Dubnov; Shlomo,7,0,20,13
1657400963223,ECE 45,A01,083139,Congero; Spencer William,6,0,75,69
1657400969247,ECE 65,A50,083695,Saad; Andrew S,12,0,30,18
1657400969247,ECE 65,A51,095125,Saad; Andrew S,24,0,26,2
1657400975270,ECE 109,A01,091882,Touri; Behrouz,19,0,70,51
1657400981310,ECE 180,A00,083140,Abi Samra; Nicholas Camill,1,0,30,29
1657400981310,ECE 180,B00,083141,Abi Samra; Nicholas Camill,0,0,30,30
1657400987358,MATH 10A,A01,083735,Patchell; Gregory David,2,0,30,28
1657400987358,MATH 10A,A02,083736,Patchell; Gregory David,20,0,30,10
1657400987358,MATH 10A,A03,083737,Patchell; Gregory David,16,0,30,14
1657400993400,MATH 10B,A01,083207,Lim; Seonhee,8,0,34,26
1657400993400,MATH 10B,A02,083208,Lim; Seonhee,9,0,35,26
1657400993400,MATH 10B,A03,093472,Lim; Seonhee,7,0,34,27
1657400993400,MATH 10B,B01,083739,Sinha; Shubham,12,0,30,18
1657400999435,MATH 18,A01,083743,Cinel; Cameron Alexander,7,0,30,23
1657400999435,MATH 18,A02,083744,Cinel; Cameron Alexander,17,0,30,13
1657400999435,MATH 18,A03,083745,Cinel; Cameron Alexander,9,0,30,21
1657400999435,MATH 18,B01,083748,Rideout; David Porter,5,0,37,32
1657400999435,MATH 18,B02,083749,Rideout; David Porter,5,0,36,31
1657400999435,MATH 18,B03,083750,Rideout; David Porter,3,0,37,34
1657400999435,MATH 18,B04,083751,Rideout; David Porter,6,0,36,30
1657400999435,MATH 18,B05,093473,Rideout; David Porter,6,0,36,30
1657400999435,MATH 18,B06,093474,Rideout; David Porter,6,0,36,30
1657401005470,MATH 20A,A01,083754,Zheng; Zequn,14,0,40,26
1657401011505,MATH 20B,A01,083756,Briones; Jor-el Thomas Caparas,4,0,36,32
1657401011505,MATH 20B,A02,083757,Briones; Jor-el Thomas Caparas,1,0,36,35
1657401011505,MATH 20B,A03,093475,Briones; Jor-el Thomas Caparas,2,0,36,34
1657401017555,MATH 20C,A01,083760,Briones; Jor-el Thomas Caparas,1,0,35,34
1657401017555,MATH 20C,A02,083761,Briones; Jor-el Thomas Caparas,8,0,35,27
1657401017555,MATH 20C,A03,093476,Briones; Jor-el Thomas Caparas,0,1,36,36
1657401017555,MATH 20C,B01,083762,Bach; Quang Tran,1,0,30,29
1657401023599,MATH 20D,A01,083765,Tran; Brian Kha,5,0,30,25
1657401023599,MATH 20D,A02,083766,Tran; Brian Kha,5,0,30,25
1657401023599,MATH 20D,A03,083767,Tran; Brian Kha,5,0,30,25
1657401029627,MATH 20E,A01,083771,Ganguly; Soumya,9,0,32,23
1657401029627,MATH 20E,A02,083772,Ganguly; Soumya,6,0,32,26
1657401029627,MATH 20E,B01,083773,Ciotti; Benjamin,20,0,35,15
1657401029627,MATH 20E,B02,083774,Ciotti; Benjamin,17,0,35,18
1657401035658,MATH 103A,A01,083777,Greenfeld; Be'Eri,3,0,36,33
1657401035658,MATH 103A,A02,083778,Greenfeld; Be'Eri,5,0,36,31
1657401035658,MATH 103A,A03,093561,Greenfeld; Be'Eri,5,0,36,31
1657401035658,MATH 103A,B01,083779,Greenfeld; Be'Eri,7,0,36,29
1657401035658,MATH 103A,B02,083780,Greenfeld; Be'Eri,4,0,36,32
1657401035658,MATH 103A,B03,093562,Greenfeld; Be'Eri,3,0,36,33
1657401041700,MATH 105,A01,085443,Carter; Anne Toulson,15,0,35,20
1657401041700,MATH 105,A02,093477,Carter; Anne Toulson,20,0,35,15
1657401047745,MATH 109,A01,083213,Ganzberger; Geoffrey Michael,2,0,34,32
1657401047745,MATH 109,A02,083214,Ganzberger; Geoffrey Michael,4,0,34,30
1657401047745,MATH 109,A03,093478,Ganzberger; Geoffrey Michael,2,0,34,32
1657401047745,MATH 109,B01,083215,Ganzberger; Geoffrey Michael,1,0,32,31
1657401047745,MATH 109,B02,083216,Ganzberger; Geoffrey Michael,2,0,32,30
1657401047745,MATH 109,B03,093479,Ganzberger; Geoffrey Michael,8,0,32,24
1657401053784,MATH 142A,A01,083219,Chow; Bennett,7,0,32,25
1657401053784,MATH 142A,A02,083220,Chow; Bennett,10,0,32,22
1657401053784,MATH 142A,A03,093480,Chow; Bennett,8,0,32,24
1657401053784,MATH 142A,B03,093481,Chow; Bennett,8,0,32,24
1657401053784,MATH 142A,B04,093558,Chow; Bennett,13,0,32,19
1657401053784,MATH 142A,B05,093559,Chow; Bennett,6,0,32,26
1657401059820,MATH 193A,A01,083224,Rotar; Vladimir,8,0,34,26
1657401059820,MATH 193A,A02,083225,Rotar; Vladimir,9,0,34,25
1657401059820,MATH 193A,A03,083781,Rotar; Vladimir,5,0,34,29
1657401059820,MATH 193A,A04,083782,Rotar; Vladimir,10,0,34,24
1657401059820,MATH 193A,A05,093482,Rotar; Vladimir,10,0,34,24
1657401065843,MATH 197,001,091859,McAuley; Julian John,9999,0,9999,0
1657401065843,MATH 197,002,095566,Kedlaya; Kiran S.,9997,0,9999,2
1657401065843,MATH 197,003,095567,Xiao; Ming,9999,0,9999,0
1657401065843,MATH 197,004,095571,Perols; Johan Lars,9998,0,9999,1
1657401072928,COGS 9,A01,083615,Shannon; Kyle Michael,9,0,75,66
1657401078954,COGS 11,A01,083617,Boyle; Mary E. T.,22,0,48,26
1657401084979,COGS 13,A01,083071,Bastos; Amalia Pinkusfeld,11,0,71,60
1657401091006,COGS 14A,A01,092681,Semenuks; Arturs,4,1,100,96
1657401097030,COGS 14B,A01,083073,Cheng; Tzu-Han,6,0,63,57
1657401103070,COGS 17,A01,092677,Semenuks; Arturs,6,0,81,75
1657401109119,COGS 100,A01,083619,Allen; Michael Gordon,17,0,70,53
1657401115143,COGS 101A,A01,083621,Davis; Joshua Daniel,9,0,68,59
1657401121170,COGS 101B,A01,091572,Allen; Michael Gordon,12,0,65,53
1657401127198,COGS 101C,A01,083625,Delgado; Tania,17,0,35,18
1657401133220,COGS 107A,A01,083627,Boyle; Mary E. T.,13,0,60,47
1657401139258,COGS 118A,A01,083075,Gupta; Anjum,20,0,76,56
1657401145283,CSE 3,A50,083646,Miranda; Gregory Joseph,24,0,50,26
1657401151318,CSE 8A,A50,083650,Miranda; Gregory Joseph,17,1,56,39
1657401157344,CSE 11,A01,083080,Cao; Yingjun,6,15,40,34
1657401163458,CSE 12,A01,083652,Krause-Levy; Sophia Louisa,28,1,120,92
1657401169486,CSE 15L,A01,083654,Morris; Justin Loren,9,0,50,41
1657401169486,CSE 15L,A02,083655,Morris; Justin Loren,9,0,50,41
1657401175518,CSE 20,A01,083657,Tran; Khoa Dang,39,0,80,41
1657401181557,CSE 21,A01,095574,Bach; Quang Tran,22,0,48,26
1657401187588,CSE 30,A01,083084,Eldon; John,4,0,80,76
1657401187588,CSE 30,B01,095061,Bhaskar; Nishant,9,0,50,41
1657401193613,CSE 100,A01,083659,Cao; Yingjun,5,4,70,65
1657401199635,CSE 134B,A01,083661,Powell; Thomas Allan,22,0,100,78
1657401205668,CSE 140,A01,083663,Gungor; Onat,14,0,85,71
1657401211690,CSE 140L,A01,083088,Eldon; John,21,0,100,79
1657401217735,CSE 175,A01,083665,Kumar; Rakesh,3,0,25,22
1657401223762,CSE 190,A00,092507,Dubnov; Shlomo,7,0,20,13
1657401229784,ECE 45,A01,083139,Congero; Spencer William,6,0,75,69
1657401235823,ECE 65,A50,083695,Saad; Andrew S,12,0,30,18
1657401235823,ECE 65,A51,095125,Saad; Andrew S,24,0,26,2
1657401241850,ECE 109,A01,091882,Touri; Behrouz,19,0,70,51
1657401247876,ECE 180,A00,083140,Abi Samra; Nicholas Camill,1,0,30,29
1657401247876,ECE 180,B00,083141,Abi Samra; Nicholas Camill,0,0,30,30
1657401253921,MATH 10A,A01,083735,Patchell; Gregory David,2,0,30,28
1657401253921,MATH 10A,A02,083736,Patchell; Gregory David,20,0,30,10
1657401253921,MATH 10A,A03,083737,Patchell; Gregory David,16,0,30,14
1657401259968,MATH 10B,A01,083207,Lim; Seonhee,8,0,34,26
1657401259968,MATH 10B,A02,083208,Lim; Seonhee,9,0,35,26
1657401259968,MATH 10B,A03,093472,Lim; Seonhee,7,0,34,27
1657401259968,MATH 10B,B01,083739,Sinha; Shubham,12,0,30,18
1657401266000,MATH 18,A01,083743,Cinel; Cameron Alexander,7,0,30,23
1657401266000,MATH 18,A02,083744,Cinel; Cameron Alexander,17,0,30,13
1657401266000,MATH 18,A03,083745,Cinel; Cameron Alexander,9,0,30,21
1657401266000,MATH 18,B01,083748,Rideout; David Porter,5,0,37,32
1657401266000,MATH 18,B02,083749,Rideout; David Porter,5,0,36,31
1657401266000,MATH 18,B03,083750,Rideout; David Porter,3,0,37,34
1657401266000,MATH 18,B04,083751,Rideout; David Porter,6,0,36,30
1657401266000,MATH 18,B05,093473,Rideout; David Porter,6,0,36,30
1657401266000,MATH 18,B06,093474,Rideout; David Porter,6,0,36,30
1657401272049,MATH 20A,A01,083754,Zheng; Zequn,14,0,40,26
1657401278085,MATH 20B,A01,083756,Briones; Jor-el Thomas Caparas,4,0,36,32
1657401278085,MATH 20B,A02,083757,Briones; Jor-el Thomas Caparas,1,0,36,35
1657401278085,MATH 20B,A03,093475,Briones; Jor-el Thomas Caparas,2,0,36,34
1657401284125,MATH 20C,A01,083760,Briones; Jor-el Thomas Caparas,1,0,35,34
1657401284125,MATH 20C,A02,083761,Briones; Jor-el Thomas Caparas,8,0,35,27
1657401284125,MATH 20C,A03,093476,Briones; Jor-el Thomas Caparas,0,1,36,36
1657401284125,MATH 20C,B01,083762,Bach; Quang Tran,1,0,30,29
1657401290152,MATH 20D,A01,083765,Tran; Brian Kha,5,0,30,25
1657401290152,MATH 20D,A02,083766,Tran; Brian Kha,5,0,30,25
1657401290152,MATH 20D,A03,083767,Tran; Brian Kha,5,0,30,25
1657401296179,MATH 20E,A01,083771,Ganguly; Soumya,9,0,32,23
1657401296179,MATH 20E,A02,083772,Ganguly; Soumya,6,0,32,26
1657401296179,MATH 20E,B01,083773,Ciotti; Benjamin,20,0,35,15
1657401296179,MATH 20E,B02,083774,Ciotti; Benjamin,17,0,35,18
1657401302207,MATH 103A,A01,083777,Greenfeld; Be'Eri,3,0,36,33
1657401302207,MATH 103A,A02,083778,Greenfeld; Be'Eri,5,0,36,31
1657401302207,MATH 103A,A03,093561,Greenfeld; Be'Eri,5,0,36,31
1657401302207,MATH 103A,B01,083779,Greenfeld; Be'Eri,7,0,36,29
1657401302207,MATH 103A,B02,083780,Greenfeld; Be'Eri,4,0,36,32
1657401302207,MATH 103A,B03,093562,Greenfeld; Be'Eri,3,0,36,33
1657401308245,MATH 105,A01,085443,Carter; Anne Toulson,15,0,35,20
1657401308245,MATH 105,A02,093477,Carter; Anne Toulson,20,0,35,15
1657401314268,MATH 109,A01,083213,Ganzberger; Geoffrey Michael,2,0,34,32
1657401314268,MATH 109,A02,083214,Ganzberger; Geoffrey Michael,4,0,34,30
1657401314268,MATH 109,A03,093478,Ganzberger; Geoffrey Michael,2,0,34,32
1657401314268,MATH 109,B01,083215,Ganzberger; Geoffrey Michael,1,0,32,31
1657401314268,MATH 109,B02,083216,Ganzberger; Geoffrey Michael,2,0,32,30
1657401314268,MATH 109,B03,093479,Ganzberger; Geoffrey Michael,8,0,32,24
1657401320299,MATH 142A,A01,083219,Chow; Bennett,7,0,32,25
1657401320299,MATH 142A,A02,083220,Chow; Bennett,10,0,32,22
1657401320299,MATH 142A,A03,093480,Chow; Bennett,8,0,32,24
1657401320299,MATH 142A,B03,093481,Chow; Bennett,8,0,32,24
1657401320299,MATH 142A,B04,093558,Chow; Bennett,13,0,32,19
1657401320299,MATH 142A,B05,093559,Chow; Bennett,6,0,32,26
1657401326345,MATH 193A,A01,083224,Rotar; Vladimir,8,0,34,26
1657401326345,MATH 193A,A02,083225,Rotar; Vladimir,9,0,34,25
1657401326345,MATH 193A,A03,083781,Rotar; Vladimir,5,0,34,29
1657401326345,MATH 193A,A04,083782,Rotar; Vladimir,10,0,34,24
1657401326345,MATH 193A,A05,093482,Rotar; Vladimir,10,0,34,24
1657401332374,MATH 197,001,091859,McAuley; Julian John,9999,0,9999,0
1657401332374,MATH 197,002,095566,Kedlaya; Kiran S.,9997,0,9999,2
1657401332374,MATH 197,003,095567,Xiao; Ming,9999,0,9999,0
1657401332374,MATH 197,004,095571,Perols; Johan Lars,9998,0,9999,1
1657401339480,COGS 9,A01,083615,Shannon; Kyle Michael,9,0,75,66
1657401345508,COGS 11,A01,083617,Boyle; Mary E. T.,22,0,48,26
1657401351544,COGS 13,A01,083071,Bastos; Amalia Pinkusfeld,11,0,71,60
1657401357569,COGS 14A,A01,092681,Semenuks; Arturs,4,1,100,96
1657401363596,COGS 14B,A01,083073,Cheng; Tzu-Han,6,0,63,57
1657401369652,COGS 17,A01,092677,Semenuks; Arturs,6,0,81,75
1657401375695,COGS 100,A01,083619,Allen; Michael Gordon,17,0,70,53
1657401381718,COGS 101A,A01,083621,Davis; Joshua Daniel,9,0,68,59
1657401387756,COGS 101B,A01,091572,Allen; Michael Gordon,12,0,65,53
1657401393784,COGS 101C,A01,083625,Delgado; Tania,17,0,35,18
1657401399808,COGS 107A,A01,083627,Boyle; Mary E. T.,13,0,60,47
1657401405831,COGS 118A,A01,083075,Gupta; Anjum,20,0,76,56
1657401411858,CSE 3,A50,083646,Miranda; Gregory Joseph,24,0,50,26
1657401417900,CSE 8A,A50,083650,Miranda; Gregory Joseph,17,1,56,39
1657401423923,CSE 11,A01,083080,Cao; Yingjun,6,15,40,34
1657401429946,CSE 12,A01,083652,Krause-Levy; Sophia Louisa,28,1,120,92
1657401435978,CSE 15L,A01,083654,Morris; Justin Loren,9,0,50,41
1657401435978,CSE 15L,A02,083655,Morris; Justin Loren,9,0,50,41
1657401442003,CSE 20,A01,083657,Tran; Khoa Dang,39,0,80,41
1657401448037,CSE 21,A01,095574,Bach; Quang Tran,22,0,48,26
1657401454061,CSE 30,A01,083084,Eldon; John,4,0,80,76
1657401454061,CSE 30,B01,095061,Bhaskar; Nishant,9,0,50,41
1657401460108,CSE 100,A01,083659,Cao; Yingjun,5,4,70,65
1657401466137,CSE 134B,A01,083661,Powell; Thomas Allan,22,0,100,78
1657401472161,CSE 140,A01,083663,Gungor; Onat,14,0,85,71
1657401478206,CSE 140L,A01,083088,Eldon; John,21,0,100,79
1657401484228,CSE 175,A01,083665,Kumar; Rakesh,3,0,25,22
1657401490251,CSE 190,A00,092507,Dubnov; Shlomo,7,0,20,13
1657401496285,ECE 45,A01,083139,Congero; Spencer William,6,0,75,69
1657401502312,ECE 65,A50,083695,Saad; Andrew S,12,0,30,18
1657401502312,ECE 65,A51,095125,Saad; Andrew S,24,0,26,2
1657401508338,ECE 109,A01,091882,Touri; Behrouz,19,0,70,51
1657401514383,ECE 180,A00,083140,Abi Samra; Nicholas Camill,1,0,30,29
1657401514383,ECE 180,B00,083141,Abi Samra; Nicholas Camill,0,0,30,30
1657401520405,MATH 10A,A01,083735,Patchell; Gregory David,2,0,30,28
1657401520405,MATH 10A,A02,083736,Patchell; Gregory David,20,0,30,10
1657401520405,MATH 10A,A03,083737,Patchell; Gregory David,16,0,30,14
1657401526446,MATH 10B,A01,083207,Lim; Seonhee,8,0,34,26
1657401526446,MATH 10B,A02,083208,Lim; Seonhee,9,0,35,26
1657401526446,MATH 10B,A03,093472,Lim; Seonhee,7,0,34,27
1657401526446,MATH 10B,B01,083739,Sinha; Shubham,12,0,30,18
1657401532485,MATH 18,A01,083743,Cinel; Cameron Alexander,7,0,30,23
1657401532485,MATH 18,A02,083744,Cinel; Cameron Alexander,17,0,30,13
1657401532485,MATH 18,A03,083745,Cinel; Cameron Alexander,9,0,30,21
1657401532485,MATH 18,B01,083748,Rideout; David Porter,5,0,37,32
1657401532485,MATH 18,B02,083749,Rideout; David Porter,5,0,36,31
1657401532485,MATH 18,B03,083750,Rideout; David Porter,3,0,37,34
1657401532485,MATH 18,B04,083751,Rideout; David Porter,6,0,36,30
1657401532485,MATH 18,B05,093473,Rideout; David Porter,6,0,36,30
1657401532485,MATH 18,B06,093474,Rideout; David Porter,6,0,36,30
1657401538527,MATH 20A,A01,083754,Zheng; Zequn,14,0,40,26
1657401544549,MATH 20B,A01,083756,Briones; Jor-el Thomas Caparas,4,0,36,32
1657401544549,MATH 20B,A02,083757,Briones; Jor-el Thomas Caparas,1,0,36,35
1657401544549,MATH 20B,A03,093475,Briones; Jor-el Thomas Caparas,2,0,36,34
1657401550581,MATH 20C,A01,083760,Briones; Jor-el Thomas Caparas,1,0,35,34
1657401550581,MATH 20C,A02,083761,Briones; Jor-el Thomas Caparas,8,0,35,27
1657401550581,MATH 20C,A03,093476,Briones; Jor-el Thomas Caparas,0,1,36,36
1657401550581,MATH 20C,B01,083762,Bach; Quang Tran,1,0,30,29
1657401556628,MATH 20D,A01,083765,Tran; Brian Kha,5,0,30,25
1657401556628,MATH 20D,A02,083766,Tran; Brian Kha,5,0,30,25
1657401556628,MATH 20D,A03,083767,Tran; Brian Kha,5,0,30,25
1657401562650,MATH 20E,A01,083771,Ganguly; Soumya,9,0,32,23
1657401562650,MATH 20E,A02,083772,Ganguly; Soumya,6,0,32,26
1657401562650,MATH 20E,B01,083773,Ciotti; Benjamin,20,0,35,15
1657401562650,MATH 20E,B02,083774,Ciotti; Benjamin,17,0,35,18
1657401568687,MATH 103A,A01,083777,Greenfeld; Be'Eri,3,0,36,33
1657401568687,MATH 103A,A02,083778,Greenfeld; Be'Eri,5,0,36,31
1657401568687,MATH 103A,A03,093561,Greenfeld; Be'Eri,5,0,36,31
1657401568687,MATH 103A,B01,083779,Greenfeld; Be'Eri,7,0,36,29
1657401568687,MATH 103A,B02,083780,Greenfeld; Be'Eri,4,0,36,32
1657401568687,MATH 103A,B03,093562,Greenfeld; Be'Eri,3,0,36,33
1657401574713,MATH 105,A01,085443,Carter; Anne Toulson,15,0,35,20
1657401574713,MATH 105,A02,093477,Carter; Anne Toulson,20,0,35,15
1657401580735,MATH 109,A01,083213,Ganzberger; Geoffrey Michael,2,0,34,32
1657401580735,MATH 109,A02,083214,Ganzberger; Geoffrey Michael,4,0,34,30
1657401580735,MATH 109,A03,093478,Ganzberger; Geoffrey Michael,2,0,34,32
1657401580735,MATH 109,B01,083215,Ganzberger; Geoffrey Michael,1,0,32,31
1657401580735,MATH 109,B02,083216,Ganzberger; Geoffrey Michael,2,0,32,30
1657401580735,MATH 109,B03,093479,Ganzberger; Geoffrey Michael,8,0,32,24
1657401586790,MATH 142A,A01,083219,Chow; Bennett,7,0,32,25
1657401586790,MATH 142A,A02,083220,Chow; Bennett,10,0,32,22
1657401586790,MATH 142A,A03,093480,Chow; Bennett,8,0,32,24
1657401586790,MATH 142A,B03,093481,Chow; Bennett,8,0,32,24
1657401586790,MATH 142A,B04,093558,Chow; Bennett,13,0,32,19
1657401586790,MATH 142A,B05,093559,Chow; Bennett,6,0,32,26
1657401592814,MATH 193A,A01,083224,Rotar; Vladimir,8,0,34,26
1657401592814,MATH 193A,A02,083225,Rotar; Vladimir,9,0,34,25
1657401592814,MATH 193A,A03,083781,Rotar; Vladimir,5,0,34,29
1657401592814,MATH 193A,A04,083782,Rotar; Vladimir,10,0,34,24
1657401592814,MATH 193A,A05,093482,Rotar; Vladimir,10,0,34,24
1657401598839,MATH 197,001,091859,McAuley; Julian John,9999,0,9999,0
1657401598839,MATH 197,002,095566,Kedlaya; Kiran S.,9997,0,9999,2
1657401598839,MATH 197,003,095567,Xiao; Ming,9999,0,9999,0
1657401598839,MATH 197,004,095571,Perols; Johan Lars,9998,0,9999,1
1657401605905,COGS 9,A01,083615,Shannon; Kyle Michael,9,0,75,66
1657401611930,COGS 11,A01,083617,Boyle; Mary E. T.,22,0,48,26
1657401617954,COGS 13,A01,083071,Bastos; Amalia Pinkusfeld,11,0,71,60
1657401623981,COGS 14A,A01,092681,Semenuks; Arturs,4,1,100,96
1657401630004,COGS 14B,A01,083073,Cheng; Tzu-Han,6,0,63,57
1657401636028,COGS 17,A01,092677,Semenuks; Arturs,6,0,81,75
1657401642053,COGS 100,A01,083619,Allen; Michael Gordon,17,0,70,53
1657401648090,COGS 101A,A01,083621,Davis; Joshua Daniel,9,0,68,59
1657401654147,COGS 101B,A01,091572,Allen; Michael Gordon,12,0,65,53
1657401660187,COGS 101C,A01,083625,Delgado; Tania,17,0,35,18
1657401666230,COGS 107A,A01,083627,Boyle; Mary E. T.,13,0,60,47
1657401672252,COGS 118A,A01,083075,Gupta; Anjum,20,0,76,56
1657401678279,CSE 3,A50,083646,Miranda; Gregory Joseph,24,0,50,26
1657401684323,CSE 8A,A50,083650,Miranda; Gregory Joseph,17,1,56,39
1657401690361,CSE 11,A01,083080,Cao; Yingjun,6,15,40,34
1657401696385,CSE 12,A01,083652,Krause-Levy; Sophia Louisa,28,1,120,92
1657401702439,CSE 15L,A01,083654,Morris; Justin Loren,9,0,50,41
1657401702439,CSE 15L,A02,083655,Morris; Justin Loren,9,0,50,41
1657401708497,CSE 20,A01,083657,Tran; Khoa Dang,39,0,80,41
1657401714520,CSE 21,A01,095574,Bach; Quang Tran,22,0,48,26
1657401720559,CSE 30,A01,083084,Eldon; John,4,0,80,76
1657401720559,CSE 30,B01,095061,Bhaskar; Nishant,9,0,50,41
1657401726583,CSE 100,A01,083659,Cao; Yingjun,5,4,70,65
1657401732618,CSE 134B,A01,083661,Powell; Thomas Allan,22,0,100,78
1657401738653,CSE 140,A01,083663,Gungor; Onat,14,0,85,71
1657401744677,CSE 140L,A01,083088,Eldon; John,21,0,100,79
1657401750698,CSE 175,A01,083665,Kumar; Rakesh,3,0,25,22
1657401756720,CSE 190,A00,092507,Dubnov; Shlomo,7,0,20,13
1657401762822,ECE 45,A01,083139,Congero; Spencer William,6,0,75,69
1657401768844,ECE 65,A50,083695,Saad; Andrew S,12,0,30,18
1657401768844,ECE 65,A51,095125,Saad; Andrew S,24,0,26,2
1657401774872,ECE 109,A01,091882,Touri; Behrouz,19,0,70,51
1657401780900,ECE 180,A00,083140,Abi Samra; Nicholas Camill,1,0,30,29
1657401780900,ECE 180,B00,083141,Abi Samra; Nicholas Camill,0,0,30,30
1657401786934,MATH 10A,A01,083735,Patchell; Gregory David,2,0,30,28
1657401786934,MATH 10A,A02,083736,Patchell; Gregory David,20,0,30,10
1657401786934,MATH 10A,A03,083737,Patchell; Gregory David,16,0,30,14
1657401792962,MATH 10B,A01,083207,Lim; Seonhee,8,0,34,26
1657401792962,MATH 10B,A02,083208,Lim; Seonhee,9,0,35,26
1657401792962,MATH 10B,A03,093472,Lim; Seonhee,7,0,34,27
1657401792962,MATH 10B,B01,083739,Sinha; Shubham,12,0,30,18
1657401798996,MATH 18,A01,083743,Cinel; Cameron Alexander,7,0,30,23
1657401798996,MATH 18,A02,083744,Cinel; Cameron Alexander,17,0,30,13
1657401798996,MATH 18,A03,083745,Cinel; Cameron Alexander,9,0,30,21
1657401798996,MATH 18,B01,083748,Rideout; David Porter,5,0,37,32
1657401798996,MATH 18,B02,083749,Rideout; David Porter,5,0,36,31
1657401798996,MATH 18,B03,083750,Rideout; David Porter,3,0,37,34
1657401798996,MATH 18,B04,083751,Rideout; David Porter,6,0,36,30
1657401798996,MATH 18,B05,093473,Rideout; David Porter,6,0,36,30
1657401798996,MATH 18,B06,093474,Rideout; David Porter,6,0,36,30
1657401805023,MATH 20A,A01,083754,Zheng; Zequn,14,0,40,26
1657401811049,MATH 20B,A01,083756,Briones; Jor-el Thomas Caparas,4,0,36,32
1657401811049,MATH 20B,A02,083757,Briones; Jor-el Thomas Caparas,1,0,36,35
1657401811049,MATH 20B,A03,093475,Briones; Jor-el Thomas Caparas,2,0,36,34
1657401817073,MATH 20C,A01,083760,Briones; Jor-el Thomas Caparas,1,0,35,34
1657401817073,MATH 20C,A02,083761,Briones; Jor-el Thomas Caparas,8,0,35,27
1657401817073,MATH 20C,A03,093476,Briones; Jor-el Thomas Caparas,0,1,36,36
1657401817073,MATH 20C,B01,083762,Bach; Quang Tran,1,0,30,29
1657401823102,MATH 20D,A01,083765,Tran; Brian Kha,5,0,30,25
1657401823102,MATH 20D,A02,083766,Tran; Brian Kha,5,0,30,25
1657401823102,MATH 20D,A03,083767,Tran; Brian Kha,5,0,30,25
1657401829124,MATH 20E,A01,083771,Ganguly; Soumya,9,0,32,23
1657401829124,MATH 20E,A02,083772,Ganguly; Soumya,6,0,32,26
1657401829124,MATH 20E,B01,083773,Ciotti; Benjamin,20,0,35,15
1657401829124,MATH 20E,B02,083774,Ciotti; Benjamin,17,0,35,18
1657401835163,MATH 103A,A01,083777,Greenfeld; Be'Eri,3,0,36,33
1657401835163,MATH 103A,A02,083778,Greenfeld; Be'Eri,5,0,36,31
1657401835163,MATH 103A,A03,093561,Greenfeld; Be'Eri,5,0,36,31
1657401835163,MATH 103A,B01,083779,Greenfeld; Be'Eri,7,0,36,29
1657401835163,MATH 103A,B02,083780,Greenfeld; Be'Eri,4,0,36,32
1657401835163,MATH 103A,B03,093562,Greenfeld; Be'Eri,3,0,36,33
1657401841186,MATH 105,A01,085443,Carter; Anne Toulson,15,0,35,20
1657401841186,MATH 105,A02,093477,Carter; Anne Toulson,20,0,35,15
1657401847209,MATH 109,A01,083213,Ganzberger; Geoffrey Michael,2,0,34,32
1657401847209,MATH 109,A02,083214,Ganzberger; Geoffrey Michael,4,0,34,30
1657401847209,MATH 109,A03,093478,Ganzberger; Geoffrey Michael,2,0,34,32
1657401847209,MATH 109,B01,083215,Ganzberger; Geoffrey Michael,1,0,32,31
1657401847209,MATH 109,B02,083216,Ganzberger; Geoffrey Michael,2,0,32,30
1657401847209,MATH 109,B03,093479,Ganzberger; Geoffrey Michael,8,0,32,24
1657401853251,MATH 142A,A01,083219,Chow; Bennett,7,0,32,25
1657401853251,MATH 142A,A02,083220,Chow; Bennett,10,0,32,22
1657401853251,MATH 142A,A03,093480,Chow; Bennett,8,0,32,24
1657401853251,MATH 142A,B03,093481,Chow; Bennett,8,0,32,24
1657401853251,MATH 142A,B04,093558,Chow; Bennett,13,0,32,19
1657401853251,MATH 142A,B05,093559,Chow; Bennett,6,0,32,26
1657401859279,MATH 193A,A01,083224,Rotar; Vladimir,8,0,34,26
1657401859279,MATH 193A,A02,083225,Rotar; Vladimir,9,0,34,25
1657401859279,MATH 193A,A03,083781,Rotar; Vladimir,5,0,34,29
1657401859279,MATH 193A,A04,083782,Rotar; Vladimir,10,0,34,24
1657401859279,MATH 193A,A05,093482,Rotar; Vladimir,10,0,34,24
1657401865301,MATH 197,001,091859,McAuley; Julian John,9999,0,9999,0
1657401865301,MATH 197,002,095566,Kedlaya; Kiran S.,9997,0,9999,2
1657401865301,MATH 197,003,095567,Xiao; Ming,9999,0,9999,0
1657401865301,MATH 197,004,095571,Perols; Johan Lars,9998,0,9999,1
1657401872356,COGS 9,A01,083615,Shannon; Kyle Michael,9,0,75,66
1657401878386,COGS 11,A01,083617,Boyle; Mary E. T.,22,0,48,26
1657401884420,COGS 13,A01,083071,Bastos; Amalia Pinkusfeld,11,0,71,60
1657401890449,COGS 14A,A01,092681,Semenuks; Arturs,4,1,100,96
1657401896482,COGS 14B,A01,083073,Cheng; Tzu-Han,6,0,63,57
1657401902541,COGS 17,A01,092677,Semenuks; Arturs,6,0,81,75
1657401908567,COGS 100,A01,083619,Allen; Michael Gordon,17,0,70,53
1657401914590,COGS 101A,A01,083621,Davis; Joshua Daniel,9,0,68,59
1657401920622,COGS 101B,A01,091572,Allen; Michael Gordon,12,0,65,53
1657401926646,COGS 101C,A01,083625,Delgado; Tania,17,0,35,18
1657401932668,COGS 107A,A01,083627,Boyle; Mary E. T.,13,0,60,47
1657401938694,COGS 118A,A01,083075,Gupta; Anjum,20,0,76,56
1657401944732,CSE 3,A50,083646,Miranda; Gregory Joseph,24,0,50,26
1657401950756,CSE 8A,A50,083650,Miranda; Gregory Joseph,17,1,56,39
1657401956791,CSE 11,A01,083080,Cao; Yingjun,6,15,40,34
1657401962846,CSE 12,A01,083652,Krause-Levy; Sophia Louisa,28,1,120,92
1657401968879,CSE 15L,A01,083654,Morris; Justin Loren,9,0,50,41
1657401968879,CSE 15L,A02,083655,Morris; Justin Loren,9,0,50,41
1657401974915,CSE 20,A01,083657,Tran; Khoa Dang,39,0,80,41
1657401980938,CSE 21,A01,095574,Bach; Quang Tran,22,0,48,26
1657401986990,CSE 30,A01,083084,Eldon; John,4,0,80,76
1657401986990,CSE 30,B01,095061,Bhaskar; Nishant,9,0,50,41
1657401993027,CSE 100,A01,083659,Cao; Yingjun,5,4,70,65
1657401999066,CSE 134B,A01,083661,Powell; Thomas Allan,22,0,100,78
1657402005092,CSE 140,A01,083663,Gungor; Onat,14,0,85,71
1657402011131,CSE 140L,A01,083088,Eldon; John,21,0,100,79
1657402017155,CSE 175,A01,083665,Kumar; Rakesh,3,0,25,22
1657402023179,CSE 190,A00,092507,Dubnov; Shlomo,7,0,20,13
1657402029202,ECE 45,A01,083139,Congero; Spencer William,6,0,75,69
1657402035224,ECE 65,A50,083695,Saad; Andrew S,12,0,30,18
1657402035224,ECE 65,A51,095125,Saad; Andrew S,24,0,26,2
1657402041248,ECE 109,A01,091882,Touri; Behrouz,19,0,70,51
1657402047272,ECE 180,A00,083140,Abi Samra; Nicholas Camill,1,0,30,29
1657402047272,ECE 180,B00,083141,Abi Samra; Nicholas Camill,0,0,30,30
1657402053295,MATH 10A,A01,083735,Patchell; Gregory David,2,0,30,28
1657402053295,MATH 10A,A02,083736,Patchell; Gregory David,20,0,30,10
1657402053295,MATH 10A,A03,083737,Patchell; Gregory David,16,0,30,14
1657402059330,MATH 10B,A01,083207,Lim; Seonhee,8,0,34,26
1657402059330,MATH 10B,A02,083208,Lim; Seonhee,9,0,35,26
1657402059330,MATH 10B,A03,093472,Lim; Seonhee,7,0,34,27
1657402059330,MATH 10B,B01,083739,Sinha; Shubham,12,0,30,18
1657402065368,MATH 18,A01,083743,Cinel; Cameron Alexander,7,0,30,23
1657402065368,MATH 18,A02,083744,Cinel; Cameron Alexander,17,0,30,13
1657402065368,MATH 18,A03,083745,Cinel; Cameron Alexander,9,0,30,21
1657402065368,MATH 18,B01,083748,Rideout; David Porter,5,0,37,32
1657402065368,MATH 18,B02,083749,Rideout; David Porter,5,0,36,31
1657402065368,MATH 18,B03,083750,Rideout; David Porter,3,0,37,34
1657402065368,MATH 18,B04,083751,Rideout; David Porter,6,0,36,30
1657402065368,MATH 18,B05,093473,Rideout; David Porter,6,0,36,30
1657402065368,MATH 18,B06,093474,Rideout; David Porter,6,0,36,30
1657402071395,MATH 20A,A01,083754,Zheng; Zequn,14,0,40,26
1657402077419,MATH 20B,A01,083756,Briones; Jor-el Thomas Caparas,4,0,36,32
1657402077419,MATH 20B,A02,083757,Briones; Jor-el Thomas Caparas,1,0,36,35
1657402077419,MATH 20B,A03,093475,Briones; Jor-el Thomas Caparas,2,0,36,34
1657402083443,MATH 20C,A01,083760,Briones; Jor-el Thomas Caparas,1,0,35,34
1657402083443,MATH 20C,A02,083761,Briones; Jor-el Thomas Caparas,8,0,35,27
1657402083443,MATH 20C,A03,093476,Briones; Jor-el Thomas Caparas,0,1,36,36
1657402083443,MATH 20C,B01,083762,Bach; Quang Tran,1,0,30,29
1657402089469,MATH 20D,A01,083765,Tran; Brian Kha,5,0,30,25
1657402089469,MATH 20D,A02,083766,Tran; Brian Kha,5,0,30,25
1657402089469,MATH 20D,A03,083767,Tran; Brian Kha,5,0,30,25
1657402095498,MATH 20E,A01,083771,Ganguly; Soumya,9,0,32,23
1657402095498,MATH 20E,A02,083772,Ganguly; Soumya,6,0,32,26
1657402095498,MATH 20E,B01,083773,Ciotti; Benjamin,20,0,35,15
1657402095498,MATH 20E,B02,083774,Ciotti; Benjamin,17,0,35,18
1657402101539,MATH 103A,A01,083777,Greenfeld; Be'Eri,3,0,36,33
1657402101539,MATH 103A,A02,083778,Greenfeld; Be'Eri,5,0,36,31
1657402101539,MATH 103A,A03,093561,Greenfeld; Be'Eri,5,0,36,31
1657402101539,MATH 103A,B01,083779,Greenfeld; Be'Eri,7,0,36,29
1657402101539,MATH 103A,B02,083780,Greenfeld; Be'Eri,4,0,36,32
1657402101539,MATH 103A,B03,093562,Greenfeld; Be'Eri,3,0,36,33
1657402107581,MATH 105,A01,085443,Carter; Anne Toulson,15,0,35,20
1657402107581,MATH 105,A02,093477,Carter; Anne Toulson,20,0,35,15
1657402113611,MATH 109,A01,083213,Ganzberger; Geoffrey Michael,2,0,34,32
1657402113611,MATH 109,A02,083214,Ganzberger; Geoffrey Michael,4,0,34,30
1657402113611,MATH 109,A03,093478,Ganzberger; Geoffrey Michael,2,0,34,32
1657402113611,MATH 109,B01,083215,Ganzberger; Geoffrey Michael,1,0,32,31
1657402113611,MATH 109,B02,083216,Ganzberger; Geoffrey Michael,2,0,32,30
1657402113611,MATH 109,B03,093479,Ganzberger; Geoffrey Michael,8,0,32,24
1657402119644,MATH 142A,A01,083219,Chow; Bennett,7,0,32,25
1657402119644,MATH 142A,A02,083220,Chow; Bennett,10,0,32,22
1657402119644,MATH 142A,A03,093480,Chow; Bennett,8,0,32,24
1657402119644,MATH 142A,B03,093481,Chow; Bennett,8,0,32,24
1657402119644,MATH 142A,B04,093558,Chow; Bennett,13,0,32,19
1657402119644,MATH 142A,B05,093559,Chow; Bennett,6,0,32,26
1657402125671,MATH 193A,A01,083224,Rotar; Vladimir,8,0,34,26
1657402125671,MATH 193A,A02,083225,Rotar; Vladimir,9,0,34,25
1657402125671,MATH 193A,A03,083781,Rotar; Vladimir,5,0,34,29
1657402125671,MATH 193A,A04,083782,Rotar; Vladimir,10,0,34,24
1657402125671,MATH 193A,A05,093482,Rotar; Vladimir,10,0,34,24
1657402131709,MATH 197,001,091859,McAuley; Julian John,9999,0,9999,0
1657402131709,MATH 197,002,095566,Kedlaya; Kiran S.,9997,0,9999,2
1657402131709,MATH 197,003,095567,Xiao; Ming,9999,0,9999,0
1657402131709,MATH 197,004,095571,Perols; Johan Lars,9998,0,9999,1
1657402138769,COGS 9,A01,083615,Shannon; Kyle Michael,9,0,75,66
1657402144815,COGS 11,A01,083617,Boyle; Mary E. T.,22,0,48,26
1657402150849,COGS 13,A01,083071,Bastos; Amalia Pinkusfeld,11,0,71,60
1657402156885,COGS 14A,A01,092681,Semenuks; Arturs,4,1,100,96
1657402162926,COGS 14B,A01,083073,Cheng; Tzu-Han,6,0,63,57
1657402168948,COGS 17,A01,092677,Semenuks; Arturs,6,0,81,75
1657402174974,COGS 100,A01,083619,Allen; Michael Gordon,17,0,70,53
1657402181011,COGS 101A,A01,083621,Davis; Joshua Daniel,9,0,68,59
1657402187044,COGS 101B,A01,091572,Allen; Michael Gordon,12,0,65,53
1657402193074,COGS 101C,A01,083625,Delgado; Tania,17,0,35,18
1657402199096,COGS 107A,A01,083627,Boyle; Mary E. T.,13,0,60,47
1657402205121,COGS 118A,A01,083075,Gupta; Anjum,20,0,76,56
1657402211143,CSE 3,A50,083646,Miranda; Gregory Joseph,24,0,50,26
1657402217172,CSE 8A,A50,083650,Miranda; Gregory Joseph,17,1,56,39
1657402223195,CSE 11,A01,083080,Cao; Yingjun,6,15,40,34
1657402229223,CSE 12,A01,083652,Krause-Levy; Sophia Louisa,28,1,120,92
1657402235246,CSE 15L,A01,083654,Morris; Justin Loren,9,0,50,41
1657402235246,CSE 15L,A02,083655,Morris; Justin Loren,9,0,50,41
1657402241277,CSE 20,A01,083657,Tran; Khoa Dang,39,0,80,41
1657402247316,CSE 21,A01,095574,Bach; Quang Tran,22,0,48,26
1657402253342,CSE 30,A01,083084,Eldon; John,4,0,80,76
1657402253342,CSE 30,B01,095061,Bhaskar; Nishant,9,0,50,41
1657402259382,CSE 100,A01,083659,Cao; Yingjun,5,4,70,65
1657402265413,CSE 134B,A01,083661,Powell; Thomas Allan,22,0,100,78
1657402271436,CSE 140,A01,083663,Gungor; Onat,14,0,85,71
1657402277459,CSE 140L,A01,083088,Eldon; John,21,0,100,79
1657402283508,CSE 175,A01,083665,Kumar; Rakesh,3,0,25,22
1657402289542,CSE 190,A00,092507,Dubnov; Shlomo,7,0,20,13
1657402295585,ECE 45,A01,083139,Congero; Spencer William,6,0,75,69
1657402301607,ECE 65,A50,083695,Saad; Andrew S,12,0,30,18
1657402301607,ECE 65,A51,095125,Saad; Andrew S,24,0,26,2
1657402307635,ECE 109,A01,091882,Touri; Behrouz,19,0,70,51
1657402313663,ECE 180,A00,083140,Abi Samra; Nicholas Camill,1,0,30,29
1657402313663,ECE 180,B00,083141,Abi Samra; Nicholas Camill,0,0,30,30
1657402319713,MATH 10A,A01,083735,Patchell; Gregory David,2,0,30,28
1657402319713,MATH 10A,A02,083736,Patchell; Gregory David,20,0,30,10
1657402319713,MATH 10A,A03,083737,Patchell; Gregory David,16,0,30,14
1657402325751,MATH 10B,A01,083207,Lim; Seonhee,8,0,34,26
1657402325751,MATH 10B,A02,083208,Lim; Seonhee,9,0,35,26
1657402325751,MATH 10B,A03,093472,Lim; Seonhee,7,0,34,27
1657402325751,MATH 10B,B01,083739,Sinha; Shubham,12,0,30,18
1657402331789,MATH 18,A01,083743,Cinel; Cameron Alexander,7,0,30,23
1657402331789,MATH 18,A02,083744,Cinel; Cameron Alexander,17,0,30,13
1657402331789,MATH 18,A03,083745,Cinel; Cameron Alexander,9,0,30,21
1657402331789,MATH 18,B01,083748,Rideout; David Porter,5,0,37,32
1657402331789,MATH 18,B02,083749,Rideout; David Porter,5,0,36,31
1657402331789,MATH 18,B03,083750,Rideout; David Porter,3,0,37,34
1657402331789,MATH 18,B04,083751,Rideout; David Porter,6,0,36,30
1657402331789,MATH 18,B05,093473,Rideout; David Porter,6,0,36,30
1657402331789,MATH 18,B06,093474,Rideout; David Porter,6,0,36,30
1657402337813,MATH 20A,A01,083754,Zheng; Zequn,14,0,40,26
1657402343848,MATH 20B,A01,083756,Briones; Jor-el Thomas Caparas,4,0,36,32
1657402343848,MATH 20B,A02,083757,Briones; Jor-el Thomas Caparas,1,0,36,35
1657402343848,MATH 20B,A03,093475,Briones; Jor-el Thomas Caparas,2,0,36,34
1657402349881,MATH 20C,A01,083760,Briones; Jor-el Thomas Caparas,1,0,35,34
1657402349881,MATH 20C,A02,083761,Briones; Jor-el Thomas Caparas,8,0,35,27
1657402349881,MATH 20C,A03,093476,Briones; Jor-el Thomas Caparas,0,1,36,36
1657402349881,MATH 20C,B01,083762,Bach; Quang Tran,1,0,30,29
1657402355904,MATH 20D,A01,083765,Tran; Brian Kha,5,0,30,25
1657402355904,MATH 20D,A02,083766,Tran; Brian Kha,5,0,30,25
1657402355904,MATH 20D,A03,083767,Tran; Brian Kha,5,0,30,25
1657402362028,MATH 20E,A01,083771,Ganguly; Soumya,9,0,32,23
1657402362028,MATH 20E,A02,083772,Ganguly; Soumya,6,0,32,26
1657402362028,MATH 20E,B01,083773,Ciotti; Benjamin,20,0,35,15
1657402362028,MATH 20E,B02,083774,Ciotti; Benjamin,17,0,35,18
1657402368058,MATH 103A,A01,083777,Greenfeld; Be'Eri,3,0,36,33
1657402368058,MATH 103A,A02,083778,Greenfeld; Be'Eri,5,0,36,31
1657402368058,MATH 103A,A03,093561,Greenfeld; Be'Eri,5,0,36,31
1657402368058,MATH 103A,B01,083779,Greenfeld; Be'Eri,7,0,36,29
1657402368058,MATH 103A,B02,083780,Greenfeld; Be'Eri,4,0,36,32
1657402368058,MATH 103A,B03,093562,Greenfeld; Be'Eri,3,0,36,33
1657402374103,MATH 105,A01,085443,Carter; Anne Toulson,15,0,35,20
1657402374103,MATH 105,A02,093477,Carter; Anne Toulson,20,0,35,15
1657402380126,MATH 109,A01,083213,Ganzberger; Geoffrey Michael,2,0,34,32
1657402380126,MATH 109,A02,083214,Ganzberger; Geoffrey Michael,4,0,34,30
1657402380126,MATH 109,A03,093478,Ganzberger; Geoffrey Michael,2,0,34,32
1657402380126,MATH 109,B01,083215,Ganzberger; Geoffrey Michael,1,0,32,31
1657402380126,MATH 109,B02,083216,Ganzberger; Geoffrey Michael,2,0,32,30
1657402380126,MATH 109,B03,093479,Ganzberger; Geoffrey Michael,8,0,32,24
1657402386166,MATH 142A,A01,083219,Chow; Bennett,7,0,32,25
1657402386166,MATH 142A,A02,083220,Chow; Bennett,10,0,32,22
1657402386166,MATH 142A,A03,093480,Chow; Bennett,8,0,32,24
1657402386166,MATH 142A,B03,093481,Chow; Bennett,8,0,32,24
1657402386166,MATH 142A,B04,093558,Chow; Bennett,13,0,32,19
1657402386166,MATH 142A,B05,093559,Chow; Bennett,6,0,32,26
1657402392205,MATH 193A,A01,083224,Rotar; Vladimir,8,0,34,26
1657402392205,MATH 193A,A02,083225,Rotar; Vladimir,9,0,34,25
1657402392205,MATH 193A,A03,083781,Rotar; Vladimir,5,0,34,29
1657402392205,MATH 193A,A04,083782,Rotar; Vladimir,10,0,34,24
1657402392205,MATH 193A,A05,093482,Rotar; Vladimir,10,0,34,24
1657402398238,MATH 197,001,091859,McAuley; Julian John,9999,0,9999,0
1657402398238,MATH 197,002,095566,Kedlaya; Kiran S.,9997,0,9999,2
1657402398238,MATH 197,003,095567,Xiao; Ming,9999,0,9999,0
1657402398238,MATH 197,004,095571,Perols; Johan Lars,9998,0,9999,1
1657402405295,COGS 9,A01,083615,Shannon; Kyle Michael,9,0,75,66
1657402411350,COGS 11,A01,083617,Boyle; Mary E. T.,22,0,48,26
1657402417377,COGS 13,A01,083071,Bastos; Amalia Pinkusfeld,11,0,71,60
1657402423422,COGS 14A,A01,092681,Semenuks; Arturs,4,1,100,96
1657402429469,COGS 14B,A01,083073,Cheng; Tzu-Han,6,0,63,57
1657402435492,COGS 17,A01,092677,Semenuks; Arturs,6,0,81,75
1657402441516,COGS 100,A01,083619,Allen; Michael Gordon,17,0,70,53
1657402447540,COGS 101A,A01,083621,Davis; Joshua Daniel,9,0,68,59
1657402453567,COGS 101B,A01,091572,Allen; Michael Gordon,12,0,65,53
1657402459597,COGS 101C,A01,083625,Delgado; Tania,17,0,35,18
1657402465632,COGS 107A,A01,083627,Boyle; Mary E. T.,13,0,60,47
1657402471664,COGS 118A,A01,083075,Gupta; Anjum,20,0,76,56
1657402477688,CSE 3,A50,083646,Miranda; Gregory Joseph,24,0,50,26
1657402483716,CSE 8A,A50,083650,Miranda; Gregory Joseph,17,1,56,39
1657402489737,CSE 11,A01,083080,Cao; Yingjun,6,15,40,34
1657402495759,CSE 12,A01,083652,Krause-Levy; Sophia Louisa,28,1,120,92
1657402501786,CSE 15L,A01,083654,Morris; Justin Loren,9,0,50,41
1657402501786,CSE 15L,A02,083655,Morris; Justin Loren,9,0,50,41
1657402507830,CSE 20,A01,083657,Tran; Khoa Dang,39,0,80,41
1657402513868,CSE 21,A01,095574,Bach; Quang Tran,22,0,48,26
1657402519892,CSE 30,A01,083084,Eldon; John,4,0,80,76
1657402519892,CSE 30,B01,095061,Bhaskar; Nishant,9,0,50,41
1657402525915,CSE 100,A01,083659,Cao; Yingjun,5,4,70,65
1657402531944,CSE 134B,A01,083661,Powell; Thomas Allan,22,0,100,78
1657402537982,CSE 140,A01,083663,Gungor; Onat,14,0,85,71
1657402544005,CSE 140L,A01,083088,Eldon; John,21,0,100,79
1657402550045,CSE 175,A01,083665,Kumar; Rakesh,3,0,25,22
1657402556071,CSE 190,A00,092507,Dubnov; Shlomo,7,0,20,13
1657402562098,ECE 45,A01,083139,Congero; Spencer William,6,0,75,69
1657402568125,ECE 65,A50,083695,Saad; Andrew S,12,0,30,18
1657402568125,ECE 65,A51,095125,Saad; Andrew S,24,0,26,2
1657402574157,ECE 109,A01,091882,Touri; Behrouz,19,0,70,51
1657402580181,ECE 180,A00,083140,Abi Samra; Nicholas Camill,1,0,30,29
1657402580181,ECE 180,B00,083141,Abi Samra; Nicholas Camill,0,0,30,30
1657402586205,MATH 10A,A01,083735,Patchell; Gregory David,2,0,30,28
1657402586205,MATH 10A,A02,083736,Patchell; Gregory David,20,0,30,10
1657402586205,MATH 10A,A03,083737,Patchell; Gregory David,16,0,30,14
1657402592245,MATH 10B,A01,083207,Lim; Seonhee,8,0,34,26
1657402592245,MATH 10B,A02,083208,Lim; Seonhee,9,0,35,26
1657402592245,MATH 10B,A03,093472,Lim; Seonhee,7,0,34,27
1657402592245,MATH 10B,B01,083739,Sinha; Shubham,12,0,30,18
1657402598270,MATH 18,A01,083743,Cinel; Cameron Alexander,7,0,30,23
1657402598270,MATH 18,A02,083744,Cinel; Cameron Alexander,17,0,30,13
1657402598270,MATH 18,A03,083745,Cinel; Cameron Alexander,9,0,30,21
1657402598270,MATH 18,B01,083748,Rideout; David Porter,5,0,37,32
1657402598270,MATH 18,B02,083749,Rideout; David Porter,5,0,36,31
1657402598270,MATH 18,B03,083750,Rideout; David Porter,3,0,37,34
1657402598270,MATH 18,B04,083751,Rideout; David Porter,6,0,36,30
1657402598270,MATH 18,B05,093473,Rideout; David Porter,6,0,36,30
1657402598270,MATH 18,B06,093474,Rideout; David Porter,6,0,36,30
1657402604292,MATH 20A,A01,083754,Zheng; Zequn,14,0,40,26
1657402610335,MATH 20B,A01,083756,Briones; Jor-el Thomas Caparas,4,0,36,32
1657402610335,MATH 20B,A02,083757,Briones; Jor-el Thomas Caparas,1,0,36,35
1657402610335,MATH 20B,A03,093475,Briones; Jor-el Thomas Caparas,2,0,36,34
1657402616377,MATH 20C,A01,083760,Briones; Jor-el Thomas Caparas,1,0,35,34
1657402616377,MATH 20C,A02,083761,Briones; Jor-el Thomas Caparas,8,0,35,27
1657402616377,MATH 20C,A03,093476,Briones; Jor-el Thomas Caparas,0,1,36,36
1657402616377,MATH 20C,B01,083762,Bach; Quang Tran,1,0,30,29
1657402622400,MATH 20D,A01,083765,Tran; Brian Kha,5,0,30,25
1657402622400,MATH 20D,A02,083766,Tran; Brian Kha,5,0,30,25
1657402622400,MATH 20D,A03,083767,Tran; Brian Kha,5,0,30,25
1657402628444,MATH 20E,A01,083771,Ganguly; Soumya,9,0,32,23
1657402628444,MATH 20E,A02,083772,Ganguly; Soumya,6,0,32,26
1657402628444,MATH 20E,B01,083773,Ciotti; Benjamin,20,0,35,15
1657402628444,MATH 20E,B02,083774,Ciotti; Benjamin,17,0,35,18
1657402634475,MATH 103A,A01,083777,Greenfeld; Be'Eri,3,0,36,33
1657402634475,MATH 103A,A02,083778,Greenfeld; Be'Eri,5,0,36,31
1657402634475,MATH 103A,A03,093561,Greenfeld; Be'Eri,5,0,36,31
1657402634475,MATH 103A,B01,083779,Greenfeld; Be'Eri,7,0,36,29
1657402634475,MATH 103A,B02,083780,Greenfeld; Be'Eri,4,0,36,32
1657402634475,MATH 103A,B03,093562,Greenfeld; Be'Eri,3,0,36,33
1657402640498,MATH 105,A01,085443,Carter; Anne Toulson,15,0,35,20
1657402640498,MATH 105,A02,093477,Carter; Anne Toulson,20,0,35,15
1657402646521,MATH 109,A01,083213,Ganzberger; Geoffrey Michael,2,0,34,32
1657402646521,MATH 109,A02,083214,Ganzberger; Geoffrey Michael,4,0,34,30
1657402646521,MATH 109,A03,093478,Ganzberger; Geoffrey Michael,2,0,34,32
1657402646521,MATH 109,B01,083215,Ganzberger; Geoffrey Michael,1,0,32,31
1657402646521,MATH 109,B02,083216,Ganzberger; Geoffrey Michael,2,0,32,30
1657402646521,MATH 109,B03,093479,Ganzberger; Geoffrey Michael,8,0,32,24
1657402652549,MATH 142A,A01,083219,Chow; Bennett,7,0,32,25
1657402652549,MATH 142A,A02,083220,Chow; Bennett,10,0,32,22
1657402652549,MATH 142A,A03,093480,Chow; Bennett,8,0,32,24
1657402652549,MATH 142A,B03,093481,Chow; Bennett,8,0,32,24
1657402652549,MATH 142A,B04,093558,Chow; Bennett,13,0,32,19
1657402652549,MATH 142A,B05,093559,Chow; Bennett,6,0,32,26
1657402658572,MATH 193A,A01,083224,Rotar; Vladimir,8,0,34,26
1657402658572,MATH 193A,A02,083225,Rotar; Vladimir,9,0,34,25
1657402658572,MATH 193A,A03,083781,Rotar; Vladimir,5,0,34,29
1657402658572,MATH 193A,A04,083782,Rotar; Vladimir,10,0,34,24
1657402658572,MATH 193A,A05,093482,Rotar; Vladimir,10,0,34,24
1657402664606,MATH 197,001,091859,McAuley; Julian John,9999,0,9999,0
1657402664606,MATH 197,002,095566,Kedlaya; Kiran S.,9997,0,9999,2
1657402664606,MATH 197,003,095567,Xiao; Ming,9999,0,9999,0
1657402664606,MATH 197,004,095571,Perols; Johan Lars,9998,0,9999,1
1657402671700,COGS 9,A01,083615,Shannon; Kyle Michael,9,0,75,66
1657402677738,COGS 11,A01,083617,Boyle; Mary E. T.,22,0,48,26
1657402683764,COGS 13,A01,083071,Bastos; Amalia Pinkusfeld,11,0,71,60
1657402689809,COGS 14A,A01,092681,Semenuks; Arturs,4,1,100,96
1657402695840,COGS 14B,A01,083073,Cheng; Tzu-Han,6,0,63,57
1657402701878,COGS 17,A01,092677,Semenuks; Arturs,6,0,81,75
1657402707901,COGS 100,A01,083619,Allen; Michael Gordon,17,0,70,53
1657402713957,COGS 101A,A01,083621,Davis; Joshua Daniel,9,0,68,59
1657402719979,COGS 101B,A01,091572,Allen; Michael Gordon,12,0,65,53
1657402726002,COGS 101C,A01,083625,Delgado; Tania,17,0,35,18
1657402732047,COGS 107A,A01,083627,Boyle; Mary E. T.,13,0,60,47
1657402738096,COGS 118A,A01,083075,Gupta; Anjum,20,0,76,56
1657402744128,CSE 3,A50,083646,Miranda; Gregory Joseph,24,0,50,26
1657402750151,CSE 8A,A50,083650,Miranda; Gregory Joseph,17,1,56,39
1657402756175,CSE 11,A01,083080,Cao; Yingjun,6,15,40,34
1657402762198,CSE 12,A01,083652,Krause-Levy; Sophia Louisa,28,1,120,92
1657402768230,CSE 15L,A01,083654,Morris; Justin Loren,9,0,50,41
1657402768230,CSE 15L,A02,083655,Morris; Justin Loren,9,0,50,41
1657402774278,CSE 20,A01,083657,Tran; Khoa Dang,39,0,80,41
1657402780300,CSE 21,A01,095574,Bach; Quang Tran,22,0,48,26
1657402786324,CSE 30,A01,083084,Eldon; John,4,0,80,76
1657402786324,CSE 30,B01,095061,Bhaskar; Nishant,9,0,50,41
1657402792346,CSE 100,A01,083659,Cao; Yingjun,5,4,70,65
1657402798370,CSE 134B,A01,083661,Powell; Thomas Allan,22,0,100,78
1657402804400,CSE 140,A01,083663,Gungor; Onat,14,0,85,71
1657402810424,CSE 140L,A01,083088,Eldon; John,21,0,100,79
1657402816459,CSE 175,A01,083665,Kumar; Rakesh,3,0,25,22
1657402822483,CSE 190,A00,092507,Dubnov; Shlomo,7,0,20,13
1657402828528,ECE 45,A01,083139,Congero; Spencer William,6,0,75,69
1657402834579,ECE 65,A50,083695,Saad; Andrew S,12,0,30,18
1657402834579,ECE 65,A51,095125,Saad; Andrew S,24,0,26,2
1657402840601,ECE 109,A01,091882,Touri; Behrouz,19,0,70,51
1657402846660,ECE 180,A00,083140,Abi Samra; Nicholas Camill,1,0,30,29
1657402846660,ECE 180,B00,083141,Abi Samra; Nicholas Camill,0,0,30,30
1657402852694,MATH 10A,A01,083735,Patchell; Gregory David,2,0,30,28
1657402852694,MATH 10A,A02,083736,Patchell; Gregory David,20,0,30,10
1657402852694,MATH 10A,A03,083737,Patchell; Gregory David,16,0,30,14
1657402858716,MATH 10B,A01,083207,Lim; Seonhee,8,0,34,26
1657402858716,MATH 10B,A02,083208,Lim; Seonhee,9,0,35,26
1657402858716,MATH 10B,A03,093472,Lim; Seonhee,7,0,34,27
1657402858716,MATH 10B,B01,083739,Sinha; Shubham,12,0,30,18
1657402864751,MATH 18,A01,083743,Cinel; Cameron Alexander,7,0,30,23
1657402864751,MATH 18,A02,083744,Cinel; Cameron Alexander,17,0,30,13
1657402864751,MATH 18,A03,083745,Cinel; Cameron Alexander,9,0,30,21
1657402864751,MATH 18,B01,083748,Rideout; David Porter,5,0,37,32
1657402864751,MATH 18,B02,083749,Rideout; David Porter,5,0,36,31
1657402864751,MATH 18,B03,083750,Rideout; David Porter,3,0,37,34
1657402864751,MATH 18,B04,083751,Rideout; David Porter,6,0,36,30
1657402864751,MATH 18,B05,093473,Rideout; David Porter,6,0,36,30
1657402864751,MATH 18,B06,093474,Rideout; David Porter,6,0,36,30
1657402870787,MATH 20A,A01,083754,Zheng; Zequn,14,0,40,26
1657402876825,MATH 20B,A01,083756,Briones; Jor-el Thomas Caparas,4,0,36,32
1657402876825,MATH 20B,A02,083757,Briones; Jor-el Thomas Caparas,1,0,36,35
1657402876825,MATH 20B,A03,093475,Briones; Jor-el Thomas Caparas,2,0,36,34
1657402882871,MATH 20C,A01,083760,Briones; Jor-el Thomas Caparas,1,0,35,34
1657402882871,MATH 20C,A02,083761,Briones; Jor-el Thomas Caparas,8,0,35,27
1657402882871,MATH 20C,A03,093476,Briones; Jor-el Thomas Caparas,0,1,36,36
1657402882871,MATH 20C,B01,083762,Bach; Quang Tran,1,0,30,29
1657402888898,MATH 20D,A01,083765,Tran; Brian Kha,5,0,30,25
1657402888898,MATH 20D,A02,083766,Tran; Brian Kha,5,0,30,25
1657402888898,MATH 20D,A03,083767,Tran; Brian Kha,5,0,30,25
1657402894938,MATH 20E,A01,083771,Ganguly; Soumya,9,0,32,23
1657402894938,MATH 20E,A02,083772,Ganguly; Soumya,6,0,32,26
1657402894938,MATH 20E,B01,083773,Ciotti; Benjamin,20,0,35,15
1657402894938,MATH 20E,B02,083774,Ciotti; Benjamin,17,0,35,18
1657402900976,MATH 103A,A01,083777,Greenfeld; Be'Eri,3,0,36,33
1657402900976,MATH 103A,A02,083778,Greenfeld; Be'Eri,5,0,36,31
1657402900976,MATH 103A,A03,093561,Greenfeld; Be'Eri,5,0,36,31
1657402900976,MATH 103A,B01,083779,Greenfeld; Be'Eri,7,0,36,29
1657402900976,MATH 103A,B02,083780,Greenfeld; Be'Eri,4,0,36,32
1657402900976,MATH 103A,B03,093562,Greenfeld; Be'Eri,3,0,36,33
1657402907007,MATH 105,A01,085443,Carter; Anne Toulson,15,0,35,20
1657402907007,MATH 105,A02,093477,Carter; Anne Toulson,20,0,35,15
1657402913041,MATH 109,A01,083213,Ganzberger; Geoffrey Michael,2,0,34,32
1657402913041,MATH 109,A02,083214,Ganzberger; Geoffrey Michael,4,0,34,30
1657402913041,MATH 109,A03,093478,Ganzberger; Geoffrey Michael,2,0,34,32
1657402913041,MATH 109,B01,083215,Ganzberger; Geoffrey Michael,1,0,32,31
1657402913041,MATH 109,B02,083216,Ganzberger; Geoffrey Michael,2,0,32,30
1657402913041,MATH 109,B03,093479,Ganzberger; Geoffrey Michael,8,0,32,24
1657402919078,MATH 142A,A01,083219,Chow; Bennett,7,0,32,25
1657402919078,MATH 142A,A02,083220,Chow; Bennett,10,0,32,22
1657402919078,MATH 142A,A03,093480,Chow; Bennett,8,0,32,24
1657402919078,MATH 142A,B03,093481,Chow; Bennett,8,0,32,24
1657402919078,MATH 142A,B04,093558,Chow; Bennett,13,0,32,19
1657402919078,MATH 142A,B05,093559,Chow; Bennett,6,0,32,26
1657402925103,MATH 193A,A01,083224,Rotar; Vladimir,8,0,34,26
1657402925103,MATH 193A,A02,083225,Rotar; Vladimir,9,0,34,25
1657402925103,MATH 193A,A03,083781,Rotar; Vladimir,5,0,34,29
1657402925103,MATH 193A,A04,083782,Rotar; Vladimir,10,0,34,24
1657402925103,MATH 193A,A05,093482,Rotar; Vladimir,10,0,34,24
1657402931129,MATH 197,001,091859,McAuley; Julian John,9999,0,9999,0
1657402931129,MATH 197,002,095566,Kedlaya; Kiran S.,9997,0,9999,2
1657402931129,MATH 197,003,095567,Xiao; Ming,9999,0,9999,0
1657402931129,MATH 197,004,095571,Perols; Johan Lars,9998,0,9999,1
1657402938193,COGS 9,A01,083615,Shannon; Kyle Michael,9,0,75,66
1657402944219,COGS 11,A01,083617,Boyle; Mary E. T.,22,0,48,26
1657402950255,COGS 13,A01,083071,Bastos; Amalia Pinkusfeld,11,0,71,60
1657402956394,COGS 14A,A01,092681,Semenuks; Arturs,4,1,100,96
1657402962417,COGS 14B,A01,083073,Cheng; Tzu-Han,6,0,63,57
1657402968439,COGS 17,A01,092677,Semenuks; Arturs,6,0,81,75
1657402974465,COGS 100,A01,083619,Allen; Michael Gordon,17,0,70,53
1657402980503,COGS 101A,A01,083621,Davis; Joshua Daniel,9,0,68,59
1657402986544,COGS 101B,A01,091572,Allen; Michael Gordon,12,0,65,53
1657402992571,COGS 101C,A01,083625,Delgado; Tania,17,0,35,18
1657402998597,COGS 107A,A01,083627,Boyle; Mary E. T.,13,0,60,47
1657403004618,COGS 118A,A01,083075,Gupta; Anjum,20,0,76,56
1657403010641,CSE 3,A50,083646,Miranda; Gregory Joseph,24,0,50,26
1657403016669,CSE 8A,A50,083650,Miranda; Gregory Joseph,17,1,56,39
1657403022695,CSE 11,A01,083080,Cao; Yingjun,6,15,40,34
1657403028728,CSE 12,A01,083652,Krause-Levy; Sophia Louisa,28,1,120,92
1657403034756,CSE 15L,A01,083654,Morris; Justin Loren,9,0,50,41
1657403034756,CSE 15L,A02,083655,Morris; Justin Loren,9,0,50,41
1657403040811,CSE 20,A01,083657,Tran; Khoa Dang,39,0,80,41
1657403046838,CSE 21,A01,095574,Bach; Quang Tran,22,0,48,26
1657403052861,CSE 30,A01,083084,Eldon; John,4,0,80,76
1657403052861,CSE 30,B01,095061,Bhaskar; Nishant,9,0,50,41
1657403058888,CSE 100,A01,083659,Cao; Yingjun,5,4,70,65
1657403064941,CSE 134B,A01,083661,Powell; Thomas Allan,22,0,100,78
1657403070965,CSE 140,A01,083663,Gungor; Onat,14,0,85,71
1657403076997,CSE 140L,A01,083088,Eldon; John,21,0,100,79
1657403083020,CSE 175,A01,083665,Kumar; Rakesh,3,0,25,22
1657403089049,CSE 190,A00,092507,Dubnov; Shlomo,7,0,20,13
1657403095073,ECE 45,A01,083139,Congero; Spencer William,6,0,75,69
1657403101096,ECE 65,A50,083695,Saad; Andrew S,12,0,30,18
1657403101096,ECE 65,A51,095125,Saad; Andrew S,24,0,26,2
1657403107119,ECE 109,A01,091882,Touri; Behrouz,19,0,70,51
1657403113156,ECE 180,A00,083140,Abi Samra; Nicholas Camill,1,0,30,29
1657403113156,ECE 180,B00,083141,Abi Samra; Nicholas Camill,0,0,30,30
1657403119180,MATH 10A,A01,083735,Patchell; Gregory David,2,0,30,28
1657403119180,MATH 10A,A02,083736,Patchell; Gregory David,20,0,30,10
1657403119180,MATH 10A,A03,083737,Patchell; Gregory David,16,0,30,14
1657403125203,MATH 10B,A01,083207,Lim; Seonhee,8,0,34,26
1657403125203,MATH 10B,A02,083208,Lim; Seonhee,9,0,35,26
1657403125203,MATH 10B,A03,093472,Lim; Seonhee,7,0,34,27
1657403125203,MATH 10B,B01,083739,Sinha; Shubham,12,0,30,18
1657403131248,MATH 18,A01,083743,Cinel; Cameron Alexander,7,0,30,23
1657403131248,MATH 18,A02,083744,Cinel; Cameron Alexander,17,0,30,13
1657403131248,MATH 18,A03,083745,Cinel; Cameron Alexander,9,0,30,21
1657403131248,MATH 18,B01,083748,Rideout; David Porter,5,0,37,32
1657403131248,MATH 18,B02,083749,Rideout; David Porter,5,0,36,31
1657403131248,MATH 18,B03,083750,Rideout; David Porter,3,0,37,34
1657403131248,MATH 18,B04,083751,Rideout; David Porter,6,0,36,30
1657403131248,MATH 18,B05,093473,Rideout; David Porter,6,0,36,30
1657403131248,MATH 18,B06,093474,Rideout; David Porter,6,0,36,30
1657403137275,MATH 20A,A01,083754,Zheng; Zequn,14,0,40,26
1657403143303,MATH 20B,A01,083756,Briones; Jor-el Thomas Caparas,4,0,36,32
1657403143303,MATH 20B,A02,083757,Briones; Jor-el Thomas Caparas,1,0,36,35
1657403143303,MATH 20B,A03,093475,Briones; Jor-el Thomas Caparas,2,0,36,34
1657403149330,MATH 20C,A01,083760,Briones; Jor-el Thomas Caparas,1,0,35,34
1657403149330,MATH 20C,A02,083761,Briones; Jor-el Thomas Caparas,8,0,35,27
1657403149330,MATH 20C,A03,093476,Briones; Jor-el Thomas Caparas,0,1,36,36
1657403149330,MATH 20C,B01,083762,Bach; Quang Tran,1,0,30,29
1657403155359,MATH 20D,A01,083765,Tran; Brian Kha,5,0,30,25
1657403155359,MATH 20D,A02,083766,Tran; Brian Kha,5,0,30,25
1657403155359,MATH 20D,A03,083767,Tran; Brian Kha,5,0,30,25
1657403161398,MATH 20E,A01,083771,Ganguly; Soumya,9,0,32,23
1657403161398,MATH 20E,A02,083772,Ganguly; Soumya,6,0,32,26
1657403161398,MATH 20E,B01,083773,Ciotti; Benjamin,20,0,35,15
1657403161398,MATH 20E,B02,083774,Ciotti; Benjamin,17,0,35,18
1657403167423,MATH 103A,A01,083777,Greenfeld; Be'Eri,3,0,36,33
1657403167423,MATH 103A,A02,083778,Greenfeld; Be'Eri,5,0,36,31
1657403167423,MATH 103A,A03,093561,Greenfeld; Be'Eri,5,0,36,31
1657403167423,MATH 103A,B01,083779,Greenfeld; Be'Eri,7,0,36,29
1657403167423,MATH 103A,B02,083780,Greenfeld; Be'Eri,4,0,36,32
1657403167423,MATH 103A,B03,093562,Greenfeld; Be'Eri,3,0,36,33
1657403173459,MATH 105,A01,085443,Carter; Anne Toulson,15,0,35,20
1657403173459,MATH 105,A02,093477,Carter; Anne Toulson,20,0,35,15
1657403179499,MATH 109,A01,083213,Ganzberger; Geoffrey Michael,2,0,34,32
1657403179499,MATH 109,A02,083214,Ganzberger; Geoffrey Michael,4,0,34,30
1657403179499,MATH 109,A03,093478,Ganzberger; Geoffrey Michael,2,0,34,32
1657403179499,MATH 109,B01,083215,Ganzberger; Geoffrey Michael,1,0,32,31
1657403179499,MATH 109,B02,083216,Ganzberger; Geoffrey Michael,2,0,32,30
1657403179499,MATH 109,B03,093479,Ganzberger; Geoffrey Michael,8,0,32,24
1657403185527,MATH 142A,A01,083219,Chow; Bennett,7,0,32,25
1657403185527,MATH 142A,A02,083220,Chow; Bennett,10,0,32,22
1657403185527,MATH 142A,A03,093480,Chow; Bennett,8,0,32,24
1657403185527,MATH 142A,B03,093481,Chow; Bennett,8,0,32,24
1657403185527,MATH 142A,B04,093558,Chow; Bennett,13,0,32,19
1657403185527,MATH 142A,B05,093559,Chow; Bennett,6,0,32,26
1657403191569,MATH 193A,A01,083224,Rotar; Vladimir,8,0,34,26
1657403191569,MATH 193A,A02,083225,Rotar; Vladimir,9,0,34,25
1657403191569,MATH 193A,A03,083781,Rotar; Vladimir,5,0,34,29
1657403191569,MATH 193A,A04,083782,Rotar; Vladimir,10,0,34,24
1657403191569,MATH 193A,A05,093482,Rotar; Vladimir,10,0,34,24
1657403197609,MATH 197,001,091859,McAuley; Julian John,9999,0,9999,0
1657403197609,MATH 197,002,095566,Kedlaya; Kiran S.,9997,0,9999,2
1657403197609,MATH 197,003,095567,Xiao; Ming,9999,0,9999,0
1657403197609,MATH 197,004,095571,Perols; Johan Lars,9998,0,9999,1
1657403204673,COGS 9,A01,083615,Shannon; Kyle Michael,9,0,75,66
1657403210700,COGS 11,A01,083617,Boyle; Mary E. T.,22,0,48,26
1657403216742,COGS 13,A01,083071,Bastos; Amalia Pinkusfeld,11,0,71,60
1657403222769,COGS 14A,A01,092681,Semenuks; Arturs,4,1,100,96
1657403228798,COGS 14B,A01,083073,Cheng; Tzu-Han,6,0,63,57
1657403234835,COGS 17,A01,092677,Semenuks; Arturs,6,0,81,75
1657403240874,COGS 100,A01,083619,Allen; Michael Gordon,17,0,70,53
1657403246902,COGS 101A,A01,083621,Davis; Joshua Daniel,9,0,68,59
1657403252923,COGS 101B,A01,091572,Allen; Michael Gordon,12,0,65,53
1657403258947,COGS 101C,A01,083625,Delgado; Tania,17,0,35,18
1657403264970,COGS 107A,A01,083627,Boyle; Mary E. T.,13,0,60,47
1657403271007,COGS 118A,A01,083075,Gupta; Anjum,20,0,76,56
1657403277034,CSE 3,A50,083646,Miranda; Gregory Joseph,24,0,50,26
1657403283056,CSE 8A,A50,083650,Miranda; Gregory Joseph,17,1,56,39
1657403289107,CSE 11,A01,083080,Cao; Yingjun,6,15,40,34
1657403295139,CSE 12,A01,083652,Krause-Levy; Sophia Louisa,28,1,120,92
1657403301171,CSE 15L,A01,083654,Morris; Justin Loren,9,0,50,41
1657403301171,CSE 15L,A02,083655,Morris; Justin Loren,9,0,50,41
1657403307202,CSE 20,A01,083657,Tran; Khoa Dang,39,0,80,41
1657403313226,CSE 21,A01,095574,Bach; Quang Tran,22,0,48,26
1657403319249,CSE 30,A01,083084,Eldon; John,4,0,80,76
1657403319249,CSE 30,B01,095061,Bhaskar; Nishant,9,0,50,41
1657403325273,CSE 100,A01,083659,Cao; Yingjun,5,4,70,65
1657403331299,CSE 134B,A01,083661,Powell; Thomas Allan,22,0,100,78
1657403337322,CSE 140,A01,083663,Gungor; Onat,14,0,85,71
1657403343348,CSE 140L,A01,083088,Eldon; John,21,0,100,79
1657403349382,CSE 175,A01,083665,Kumar; Rakesh,3,0,25,22
1657403355418,CSE 190,A00,092507,Dubnov; Shlomo,7,0,20,13
1657403361450,ECE 45,A01,083139,Congero; Spencer William,6,0,75,69
1657403367477,ECE 65,A50,083695,Saad; Andrew S,12,0,30,18
1657403367477,ECE 65,A51,095125,Saad; Andrew S,24,0,26,2
1657403373500,ECE 109,A01,091882,Touri; Behrouz,19,0,70,51
1657403379524,ECE 180,A00,083140,Abi Samra; Nicholas Camill,1,0,30,29
1657403379524,ECE 180,B00,083141,Abi Samra; Nicholas Camill,0,0,30,30
1657403385546,MATH 10A,A01,083735,Patchell; Gregory David,2,0,30,28
1657403385546,MATH 10A,A02,083736,Patchell; Gregory David,20,0,30,10
1657403385546,MATH 10A,A03,083737,Patchell; Gregory David,16,0,30,14
1657403391583,MATH 10B,A01,083207,Lim; Seonhee,8,0,34,26
1657403391583,MATH 10B,A02,083208,Lim; Seonhee,9,0,35,26
1657403391583,MATH 10B,A03,093472,Lim; Seonhee,7,0,34,27
1657403391583,MATH 10B,B01,083739,Sinha; Shubham,12,0,30,18
1657403397617,MATH 18,A01,083743,Cinel; Cameron Alexander,7,0,30,23
1657403397617,MATH 18,A02,083744,Cinel; Cameron Alexander,17,0,30,13
1657403397617,MATH 18,A03,083745,Cinel; Cameron Alexander,9,0,30,21
1657403397617,MATH 18,B01,083748,Rideout; David Porter,5,0,37,32
1657403397617,MATH 18,B02,083749,Rideout; David Porter,5,0,36,31
1657403397617,MATH 18,B03,083750,Rideout; David Porter,3,0,37,34
1657403397617,MATH 18,B04,083751,Rideout; David Porter,6,0,36,30
1657403397617,MATH 18,B05,093473,Rideout; David Porter,6,0,36,30
1657403397617,MATH 18,B06,093474,Rideout; David Porter,6,0,36,30
1657403403641,MATH 20A,A01,083754,Zheng; Zequn,14,0,40,26
1657403409667,MATH 20B,A01,083756,Briones; Jor-el Thomas Caparas,4,0,36,32
1657403409667,MATH 20B,A02,083757,Briones; Jor-el Thomas Caparas,1,0,36,35
1657403409667,MATH 20B,A03,093475,Briones; Jor-el Thomas Caparas,2,0,36,34
1657403415707,MATH 20C,A01,083760,Briones; Jor-el Thomas Caparas,1,0,35,34
1657403415707,MATH 20C,A02,083761,Briones; Jor-el Thomas Caparas,8,0,35,27
1657403415707,MATH 20C,A03,093476,Briones; Jor-el Thomas Caparas,0,1,36,36
1657403415707,MATH 20C,B01,083762,Bach; Quang Tran,1,0,30,29
1657403421731,MATH 20D,A01,083765,Tran; Brian Kha,5,0,30,25
1657403421731,MATH 20D,A02,083766,Tran; Brian Kha,5,0,30,25
1657403421731,MATH 20D,A03,083767,Tran; Brian Kha,5,0,30,25
1657403427764,MATH 20E,A01,083771,Ganguly; Soumya,9,0,32,23
1657403427764,MATH 20E,A02,083772,Ganguly; Soumya,6,0,32,26
1657403427764,MATH 20E,B01,083773,Ciotti; Benjamin,20,0,35,15
1657403427764,MATH 20E,B02,083774,Ciotti; Benjamin,17,0,35,18
1657403433795,MATH 103A,A01,083777,Greenfeld; Be'Eri,3,0,36,33
1657403433795,MATH 103A,A02,083778,Greenfeld; Be'Eri,5,0,36,31
1657403433795,MATH 103A,A03,093561,Greenfeld; Be'Eri,5,0,36,31
1657403433795,MATH 103A,B01,083779,Greenfeld; Be'Eri,7,0,36,29
1657403433795,MATH 103A,B02,083780,Greenfeld; Be'Eri,4,0,36,32
1657403433795,MATH 103A,B03,093562,Greenfeld; Be'Eri,3,0,36,33
1657403439819,MATH 105,A01,085443,Carter; Anne Toulson,15,0,35,20
1657403439819,MATH 105,A02,093477,Carter; Anne Toulson,20,0,35,15
1657403445843,MATH 109,A01,083213,Ganzberger; Geoffrey Michael,2,0,34,32
1657403445843,MATH 109,A02,083214,Ganzberger; Geoffrey Michael,4,0,34,30
1657403445843,MATH 109,A03,093478,Ganzberger; Geoffrey Michael,2,0,34,32
1657403445843,MATH 109,B01,083215,Ganzberger; Geoffrey Michael,1,0,32,31
1657403445843,MATH 109,B02,083216,Ganzberger; Geoffrey Michael,2,0,32,30
1657403445843,MATH 109,B03,093479,Ganzberger; Geoffrey Michael,8,0,32,24
1657403451868,MATH 142A,A01,083219,Chow; Bennett,7,0,32,25
1657403451868,MATH 142A,A02,083220,Chow; Bennett,10,0,32,22
1657403451868,MATH 142A,A03,093480,Chow; Bennett,8,0,32,24
1657403451868,MATH 142A,B03,093481,Chow; Bennett,8,0,32,24
1657403451868,MATH 142A,B04,093558,Chow; Bennett,13,0,32,19
1657403451868,MATH 142A,B05,093559,Chow; Bennett,6,0,32,26
1657403457910,MATH 193A,A01,083224,Rotar; Vladimir,8,0,34,26
1657403457910,MATH 193A,A02,083225,Rotar; Vladimir,9,0,34,25
1657403457910,MATH 193A,A03,083781,Rotar; Vladimir,5,0,34,29
1657403457910,MATH 193A,A04,083782,Rotar; Vladimir,10,0,34,24
1657403457910,MATH 193A,A05,093482,Rotar; Vladimir,10,0,34,24
1657403463960,MATH 197,001,091859,McAuley; Julian John,9999,0,9999,0
1657403463960,MATH 197,002,095566,Kedlaya; Kiran S.,9997,0,9999,2
1657403463960,MATH 197,003,095567,Xiao; Ming,9999,0,9999,0
1657403463960,MATH 197,004,095571,Perols; Johan Lars,9998,0,9999,1
1657403471037,COGS 9,A01,083615,Shannon; Kyle Michael,9,0,75,66
1657403477067,COGS 11,A01,083617,Boyle; Mary E. T.,22,0,48,26
1657403483091,COGS 13,A01,083071,Bastos; Amalia Pinkusfeld,11,0,71,60
1657403489117,COGS 14A,A01,092681,Semenuks; Arturs,4,1,100,96
1657403495139,COGS 14B,A01,083073,Cheng; Tzu-Han,6,0,63,57
1657403501161,COGS 17,A01,092677,Semenuks; Arturs,6,0,81,75
1657403507187,COGS 100,A01,083619,Allen; Michael Gordon,17,0,70,53
1657403513213,COGS 101A,A01,083621,Davis; Joshua Daniel,9,0,68,59
1657403519247,COGS 101B,A01,091572,Allen; Michael Gordon,12,0,65,53
1657403525280,COGS 101C,A01,083625,Delgado; Tania,17,0,35,18
1657403531303,COGS 107A,A01,083627,Boyle; Mary E. T.,13,0,60,47
1657403537331,COGS 118A,A01,083075,Gupta; Anjum,20,0,76,56
1657403543368,CSE 3,A50,083646,Miranda; Gregory Joseph,24,0,50,26
1657403549409,CSE 8A,A50,083650,Miranda; Gregory Joseph,17,1,56,39
1657403555532,CSE 11,A01,083080,Cao; Yingjun,6,15,40,34
1657403561559,CSE 12,A01,083652,Krause-Levy; Sophia Louisa,28,1,120,92
1657403567600,CSE 15L,A01,083654,Morris; Justin Loren,9,0,50,41
1657403567600,CSE 15L,A02,083655,Morris; Justin Loren,9,0,50,41
1657403573626,CSE 20,A01,083657,Tran; Khoa Dang,39,0,80,41
1657403579650,CSE 21,A01,095574,Bach; Quang Tran,22,0,48,26
1657403585678,CSE 30,A01,083084,Eldon; John,4,0,80,76
1657403585678,CSE 30,B01,095061,Bhaskar; Nishant,9,0,50,41
1657403591700,CSE 100,A01,083659,Cao; Yingjun,5,4,70,65
1657403597730,CSE 134B,A01,083661,Powell; Thomas Allan,22,0,100,78
1657403603772,CSE 140,A01,083663,Gungor; Onat,14,0,85,71
1657403609798,CSE 140L,A01,083088,Eldon; John,21,0,100,79
1657403615822,CSE 175,A01,083665,Kumar; Rakesh,3,0,25,22
1657403621847,CSE 190,A00,092507,Dubnov; Shlomo,7,0,20,13
1657403627881,ECE 45,A01,083139,Congero; Spencer William,6,0,75,69
1657403633929,ECE 65,A50,083695,Saad; Andrew S,12,0,30,18
1657403633929,ECE 65,A51,095125,Saad; Andrew S,24,0,26,2
1657403639955,ECE 109,A01,091882,Touri; Behrouz,19,0,70,51
1657403645987,ECE 180,A00,083140,Abi Samra; Nicholas Camill,1,0,30,29
1657403645987,ECE 180,B00,083141,Abi Samra; Nicholas Camill,0,0,30,30
1657403652015,MATH 10A,A01,083735,Patchell; Gregory David,2,0,30,28
1657403652015,MATH 10A,A02,083736,Patchell; Gregory David,20,0,30,10
1657403652015,MATH 10A,A03,083737,Patchell; Gregory David,16,0,30,14
1657403658058,MATH 10B,A01,083207,Lim; Seonhee,8,0,34,26
1657403658058,MATH 10B,A02,083208,Lim; Seonhee,9,0,35,26
1657403658058,MATH 10B,A03,093472,Lim; Seonhee,7,0,34,27
1657403658058,MATH 10B,B01,083739,Sinha; Shubham,12,0,30,18
1657403664087,MATH 18,A01,083743,Cinel; Cameron Alexander,7,0,30,23
1657403664087,MATH 18,A02,083744,Cinel; Cameron Alexander,17,0,30,13
1657403664087,MATH 18,A03,083745,Cinel; Cameron Alexander,9,0,30,21
1657403664087,MATH 18,B01,083748,Rideout; David Porter,5,0,37,32
1657403664087,MATH 18,B02,083749,Rideout; David Porter,5,0,36,31
1657403664087,MATH 18,B03,083750,Rideout; David Porter,3,0,37,34
1657403664087,MATH 18,B04,083751,Rideout; David Porter,6,0,36,30
1657403664087,MATH 18,B05,093473,Rideout; David Porter,6,0,36,30
1657403664087,MATH 18,B06,093474,Rideout; David Porter,6,0,36,30
1657403670115,MATH 20A,A01,083754,Zheng; Zequn,14,0,40,26
1657403676142,MATH 20B,A01,083756,Briones; Jor-el Thomas Caparas,4,0,36,32
1657403676142,MATH 20B,A02,083757,Briones; Jor-el Thomas Caparas,1,0,36,35
1657403676142,MATH 20B,A03,093475,Briones; Jor-el Thomas Caparas,2,0,36,34
1657403682173,MATH 20C,A01,083760,Briones; Jor-el Thomas Caparas,1,0,35,34
1657403682173,MATH 20C,A02,083761,Briones; Jor-el Thomas Caparas,8,0,35,27
1657403682173,MATH 20C,A03,093476,Briones; Jor-el Thomas Caparas,0,1,36,36
1657403682173,MATH 20C,B01,083762,Bach; Quang Tran,1,0,30,29
1657403688200,MATH 20D,A01,083765,Tran; Brian Kha,5,0,30,25
1657403688200,MATH 20D,A02,083766,Tran; Brian Kha,5,0,30,25
1657403688200,MATH 20D,A03,083767,Tran; Brian Kha,5,0,30,25
1657403694236,MATH 20E,A01,083771,Ganguly; Soumya,9,0,32,23
1657403694236,MATH 20E,A02,083772,Ganguly; Soumya,6,0,32,26
1657403694236,MATH 20E,B01,083773,Ciotti; Benjamin,20,0,35,15
1657403694236,MATH 20E,B02,083774,Ciotti; Benjamin,17,0,35,18
1657403700280,MATH 103A,A01,083777,Greenfeld; Be'Eri,3,0,36,33
1657403700280,MATH 103A,A02,083778,Greenfeld; Be'Eri,5,0,36,31
1657403700280,MATH 103A,A03,093561,Greenfeld; Be'Eri,5,0,36,31
1657403700280,MATH 103A,B01,083779,Greenfeld; Be'Eri,7,0,36,29
1657403700280,MATH 103A,B02,083780,Greenfeld; Be'Eri,4,0,36,32
1657403700280,MATH 103A,B03,093562,Greenfeld; Be'Eri,3,0,36,33
1657403706306,MATH 105,A01,085443,Carter; Anne Toulson,15,0,35,20
1657403706306,MATH 105,A02,093477,Carter; Anne Toulson,20,0,35,15
1657403712340,MATH 109,A01,083213,Ganzberger; Geoffrey Michael,2,0,34,32
1657403712340,MATH 109,A02,083214,Ganzberger; Geoffrey Michael,4,0,34,30
1657403712340,MATH 109,A03,093478,Ganzberger; Geoffrey Michael,2,0,34,32
1657403712340,MATH 109,B01,083215,Ganzberger; Geoffrey Michael,1,0,32,31
1657403712340,MATH 109,B02,083216,Ganzberger; Geoffrey Michael,2,0,32,30
1657403712340,MATH 109,B03,093479,Ganzberger; Geoffrey Michael,8,0,32,24
1657403718380,MATH 142A,A01,083219,Chow; Bennett,7,0,32,25
1657403718380,MATH 142A,A02,083220,Chow; Bennett,10,0,32,22
1657403718380,MATH 142A,A03,093480,Chow; Bennett,8,0,32,24
1657403718380,MATH 142A,B03,093481,Chow; Bennett,8,0,32,24
1657403718380,MATH 142A,B04,093558,Chow; Bennett,13,0,32,19
1657403718380,MATH 142A,B05,093559,Chow; Bennett,6,0,32,26
1657403724401,MATH 193A,A01,083224,Rotar; Vladimir,8,0,34,26
1657403724401,MATH 193A,A02,083225,Rotar; Vladimir,9,0,34,25
1657403724401,MATH 193A,A03,083781,Rotar; Vladimir,5,0,34,29
1657403724401,MATH 193A,A04,083782,Rotar; Vladimir,10,0,34,24
1657403724401,MATH 193A,A05,093482,Rotar; Vladimir,10,0,34,24
1657403730429,MATH 197,001,091859,McAuley; Julian John,9999,0,9999,0
1657403730429,MATH 197,002,095566,Kedlaya; Kiran S.,9997,0,9999,2
1657403730429,MATH 197,003,095567,Xiao; Ming,9999,0,9999,0
1657403730429,MATH 197,004,095571,Perols; Johan Lars,9998,0,9999,1
1657403737483,COGS 9,A01,083615,Shannon; Kyle Michael,9,0,75,66
1657403743504,COGS 11,A01,083617,Boyle; Mary E. T.,22,0,48,26
1657403749531,COGS 13,A01,083071,Bastos; Amalia Pinkusfeld,11,0,71,60
1657403755574,COGS 14A,A01,092681,Semenuks; Arturs,4,1,100,96
1657403761606,COGS 14B,A01,083073,Cheng; Tzu-Han,6,0,63,57
1657403767627,COGS 17,A01,092677,Semenuks; Arturs,6,0,81,75
1657403773650,COGS 100,A01,083619,Allen; Michael Gordon,17,0,70,53
1657403779685,COGS 101A,A01,083621,Davis; Joshua Daniel,9,0,68,59
1657403785710,COGS 101B,A01,091572,Allen; Michael Gordon,12,0,65,53
1657403791765,COGS 101C,A01,083625,Delgado; Tania,17,0,35,18
1657403797786,COGS 107A,A01,083627,Boyle; Mary E. T.,13,0,60,47
1657403803820,COGS 118A,A01,083075,Gupta; Anjum,20,0,76,56
1657403809844,CSE 3,A50,083646,Miranda; Gregory Joseph,24,0,50,26
1657403815868,CSE 8A,A50,083650,Miranda; Gregory Joseph,17,1,56,39
1657403821902,CSE 11,A01,083080,Cao; Yingjun,6,15,40,34
1657403827938,CSE 12,A01,083652,Krause-Levy; Sophia Louisa,28,1,120,92
1657403833959,CSE 15L,A01,083654,Morris; Justin Loren,9,0,50,41
1657403833959,CSE 15L,A02,083655,Morris; Justin Loren,9,0,50,41
1657403839983,CSE 20,A01,083657,Tran; Khoa Dang,39,0,80,41
1657403846031,CSE 21,A01,095574,Bach; Quang Tran,22,0,48,26
1657403852052,CSE 30,A01,083084,Eldon; John,4,0,80,76
1657403852052,CSE 30,B01,095061,Bhaskar; Nishant,9,0,50,41
1657403858087,CSE 100,A01,083659,Cao; Yingjun,5,4,70,65
1657403864111,CSE 134B,A01,083661,Powell; Thomas Allan,22,0,100,78
1657403870135,CSE 140,A01,083663,Gungor; Onat,14,0,85,71
1657403876186,CSE 140L,A01,083088,Eldon; John,21,0,100,79
1657403882235,CSE 175,A01,083665,Kumar; Rakesh,3,0,25,22
1657403888260,CSE 190,A00,092507,Dubnov; Shlomo,7,0,20,13
1657403894282,ECE 45,A01,083139,Congero; Spencer William,6,0,75,69
1657403900317,ECE 65,A50,083695,Saad; Andrew S,12,0,30,18
1657403900317,ECE 65,A51,095125,Saad; Andrew S,24,0,26,2
1657403906344,ECE 109,A01,091882,Touri; Behrouz,19,0,70,51
1657403912371,ECE 180,A00,083140,Abi Samra; Nicholas Camill,1,0,30,29
1657403912371,ECE 180,B00,083141,Abi Samra; Nicholas Camill,0,0,30,30
1657403918394,MATH 10A,A01,083735,Patchell; Gregory David,2,0,30,28
1657403918394,MATH 10A,A02,083736,Patchell; Gregory David,20,0,30,10
1657403918394,MATH 10A,A03,083737,Patchell; Gregory David,16,0,30,14
1657403924418,MATH 10B,A01,083207,Lim; Seonhee,8,0,34,26
1657403924418,MATH 10B,A02,083208,Lim; Seonhee,9,0,35,26
1657403924418,MATH 10B,A03,093472,Lim; Seonhee,7,0,34,27
1657403924418,MATH 10B,B01,083739,Sinha; Shubham,12,0,30,18
1657403930480,MATH 18,A01,083743,Cinel; Cameron Alexander,7,0,30,23
1657403930480,MATH 18,A02,083744,Cinel; Cameron Alexander,17,0,30,13
1657403930480,MATH 18,A03,083745,Cinel; Cameron Alexander,9,0,30,21
1657403930480,MATH 18,B01,083748,Rideout; David Porter,5,0,37,32
1657403930480,MATH 18,B02,083749,Rideout; David Porter,5,0,36,31
1657403930480,MATH 18,B03,083750,Rideout; David Porter,3,0,37,34
1657403930480,MATH 18,B04,083751,Rideout; David Porter,6,0,36,30
1657403930480,MATH 18,B05,093473,Rideout; David Porter,6,0,36,30
1657403930480,MATH 18,B06,093474,Rideout; David Porter,6,0,36,30
1657403936532,MATH 20A,A01,083754,Zheng; Zequn,14,0,40,26
1657403942556,MATH 20B,A01,083756,Briones; Jor-el Thomas Caparas,4,0,36,32
1657403942556,MATH 20B,A02,083757,Briones; Jor-el Thomas Caparas,1,0,36,35
1657403942556,MATH 20B,A03,093475,Briones; Jor-el Thomas Caparas,2,0,36,34
1657403948588,MATH 20C,A01,083760,Briones; Jor-el Thomas Caparas,1,0,35,34
1657403948588,MATH 20C,A02,083761,Briones; Jor-el Thomas Caparas,8,0,35,27
1657403948588,MATH 20C,A03,093476,Briones; Jor-el Thomas Caparas,0,1,36,36
1657403948588,MATH 20C,B01,083762,Bach; Quang Tran,1,0,30,29
1657403954635,MATH 20D,A01,083765,Tran; Brian Kha,5,0,30,25
1657403954635,MATH 20D,A02,083766,Tran; Brian Kha,5,0,30,25
1657403954635,MATH 20D,A03,083767,Tran; Brian Kha,5,0,30,25
1657403960671,MATH 20E,A01,083771,Ganguly; Soumya,9,0,32,23
1657403960671,MATH 20E,A02,083772,Ganguly; Soumya,6,0,32,26
1657403960671,MATH 20E,B01,083773,Ciotti; Benjamin,20,0,35,15
1657403960671,MATH 20E,B02,083774,Ciotti; Benjamin,17,0,35,18
1657403966700,MATH 103A,A01,083777,Greenfeld; Be'Eri,3,0,36,33
1657403966700,MATH 103A,A02,083778,Greenfeld; Be'Eri,5,0,36,31
1657403966700,MATH 103A,A03,093561,Greenfeld; Be'Eri,5,0,36,31
1657403966700,MATH 103A,B01,083779,Greenfeld; Be'Eri,7,0,36,29
1657403966700,MATH 103A,B02,083780,Greenfeld; Be'Eri,4,0,36,32
1657403966700,MATH 103A,B03,093562,Greenfeld; Be'Eri,3,0,36,33
1657403972728,MATH 105,A01,085443,Carter; Anne Toulson,15,0,35,20
1657403972728,MATH 105,A02,093477,Carter; Anne Toulson,20,0,35,15
1657403978760,MATH 109,A01,083213,Ganzberger; Geoffrey Michael,2,0,34,32
1657403978760,MATH 109,A02,083214,Ganzberger; Geoffrey Michael,4,0,34,30
1657403978760,MATH 109,A03,093478,Ganzberger; Geoffrey Michael,2,0,34,32
1657403978760,MATH 109,B01,083215,Ganzberger; Geoffrey Michael,1,0,32,31
1657403978760,MATH 109,B02,083216,Ganzberger; Geoffrey Michael,2,0,32,30
1657403978760,MATH 109,B03,093479,Ganzberger; Geoffrey Michael,8,0,32,24
1657403984784,MATH 142A,A01,083219,Chow; Bennett,7,0,32,25
1657403984784,MATH 142A,A02,083220,Chow; Bennett,10,0,32,22
1657403984784,MATH 142A,A03,093480,Chow; Bennett,8,0,32,24
1657403984784,MATH 142A,B03,093481,Chow; Bennett,8,0,32,24
1657403984784,MATH 142A,B04,093558,Chow; Bennett,13,0,32,19
1657403984784,MATH 142A,B05,093559,Chow; Bennett,6,0,32,26
1657403990811,MATH 193A,A01,083224,Rotar; Vladimir,8,0,34,26
1657403990811,MATH 193A,A02,083225,Rotar; Vladimir,9,0,34,25
1657403990811,MATH 193A,A03,083781,Rotar; Vladimir,5,0,34,29
1657403990811,MATH 193A,A04,083782,Rotar; Vladimir,10,0,34,24
1657403990811,MATH 193A,A05,093482,Rotar; Vladimir,10,0,34,24
1657403996846,MATH 197,001,091859,McAuley; Julian John,9999,0,9999,0
1657403996846,MATH 197,002,095566,Kedlaya; Kiran S.,9997,0,9999,2
1657403996846,MATH 197,003,095567,Xiao; Ming,9999,0,9999,0
1657403996846,MATH 197,004,095571,Perols; Johan Lars,9998,0,9999,1
1657404003938,COGS 9,A01,083615,Shannon; Kyle Michael,9,0,75,66
1657404009980,COGS 11,A01,083617,Boyle; Mary E. T.,22,0,48,26
1657404016002,COGS 13,A01,083071,Bastos; Amalia Pinkusfeld,11,0,71,60
1657404022024,COGS 14A,A01,092681,Semenuks; Arturs,4,1,100,96
1657404028051,COGS 14B,A01,083073,Cheng; Tzu-Han,6,0,63,57
1657404034082,COGS 17,A01,092677,Semenuks; Arturs,6,0,81,75
1657404040104,COGS 100,A01,083619,Allen; Michael Gordon,17,0,70,53
1657404046128,COGS 101A,A01,083621,Davis; Joshua Daniel,9,0,68,59
1657404052162,COGS 101B,A01,091572,Allen; Michael Gordon,12,0,65,53
1657404058207,COGS 101C,A01,083625,Delgado; Tania,17,0,35,18
1657404064231,COGS 107A,A01,083627,Boyle; Mary E. T.,13,0,60,47
1657404070252,COGS 118A,A01,083075,Gupta; Anjum,20,0,76,56
1657404076280,CSE 3,A50,083646,Miranda; Gregory Joseph,24,0,50,26
1657404082305,CSE 8A,A50,083650,Miranda; Gregory Joseph,17,1,56,39
1657404088331,CSE 11,A01,083080,Cao; Yingjun,6,15,40,34
1657404094358,CSE 12,A01,083652,Krause-Levy; Sophia Louisa,28,1,120,92
1657404100399,CSE 15L,A01,083654,Morris; Justin Loren,9,0,50,41
1657404100399,CSE 15L,A02,083655,Morris; Justin Loren,9,0,50,41
1657404106434,CSE 20,A01,083657,Tran; Khoa Dang,39,0,80,41
1657404112460,CSE 21,A01,095574,Bach; Quang Tran,22,0,48,26
1657404118484,CSE 30,A01,083084,Eldon; John,4,0,80,76
1657404118484,CSE 30,B01,095061,Bhaskar; Nishant,9,0,50,41
1657404124507,CSE 100,A01,083659,Cao; Yingjun,5,4,70,65
1657404130531,CSE 134B,A01,083661,Powell; Thomas Allan,22,0,100,78
1657404136575,CSE 140,A01,083663,Gungor; Onat,14,0,85,71
1657404142597,CSE 140L,A01,083088,Eldon; John,21,0,100,79
1657404148624,CSE 175,A01,083665,Kumar; Rakesh,3,0,25,22
1657404154783,CSE 190,A00,092507,Dubnov; Shlomo,7,0,20,13
1657404160818,ECE 45,A01,083139,Congero; Spencer William,6,0,75,69
1657404166841,ECE 65,A50,083695,Saad; Andrew S,12,0,30,18
1657404166841,ECE 65,A51,095125,Saad; Andrew S,24,0,26,2
1657404172868,ECE 109,A01,091882,Touri; Behrouz,19,0,70,51
1657404178900,ECE 180,A00,083140,Abi Samra; Nicholas Camill,1,0,30,29
1657404178900,ECE 180,B00,083141,Abi Samra; Nicholas Camill,0,0,30,30
1657404184928,MATH 10A,A01,083735,Patchell; Gregory David,2,0,30,28
1657404184928,MATH 10A,A02,083736,Patchell; Gregory David,20,0,30,10
1657404184928,MATH 10A,A03,083737,Patchell; Gregory David,16,0,30,14
1657404190978,MATH 10B,A01,083207,Lim; Seonhee,8,0,34,26
1657404190978,MATH 10B,A02,083208,Lim; Seonhee,9,0,35,26
1657404190978,MATH 10B,A03,093472,Lim; Seonhee,7,0,34,27
1657404190978,MATH 10B,B01,083739,Sinha; Shubham,12,0,30,18
1657404197009,MATH 18,A01,083743,Cinel; Cameron Alexander,7,0,30,23
1657404197009,MATH 18,A02,083744,Cinel; Cameron Alexander,17,0,30,13
1657404197009,MATH 18,A03,083745,Cinel; Cameron Alexander,9,0,30,21
1657404197009,MATH 18,B01,083748,Rideout; David Porter,5,0,37,32
1657404197009,MATH 18,B02,083749,Rideout; David Porter,5,0,36,31
1657404197009,MATH 18,B03,083750,Rideout; David Porter,3,0,37,34
1657404197009,MATH 18,B04,083751,Rideout; David Porter,6,0,36,30
1657404197009,MATH 18,B05,093473,Rideout; David Porter,6,0,36,30
1657404197009,MATH 18,B06,093474,Rideout; David Porter,6,0,36,30
1657404203051,MATH 20A,A01,083754,Zheng; Zequn,14,0,40,26
1657404209099,MATH 20B,A01,083756,Briones; Jor-el Thomas Caparas,4,0,36,32
1657404209099,MATH 20B,A02,083757,Briones; Jor-el Thomas Caparas,1,0,36,35
1657404209099,MATH 20B,A03,093475,Briones; Jor-el Thomas Caparas,2,0,36,34
1657404215137,MATH 20C,A01,083760,Briones; Jor-el Thomas Caparas,1,0,35,34
1657404215137,MATH 20C,A02,083761,Briones; Jor-el Thomas Caparas,8,0,35,27
1657404215137,MATH 20C,A03,093476,Briones; Jor-el Thomas Caparas,0,1,36,36
1657404215137,MATH 20C,B01,083762,Bach; Quang Tran,1,0,30,29
1657404221170,MATH 20D,A01,083765,Tran; Brian Kha,5,0,30,25
1657404221170,MATH 20D,A02,083766,Tran; Brian Kha,5,0,30,25
1657404221170,MATH 20D,A03,083767,Tran; Brian Kha,5,0,30,25
1657404227196,MATH 20E,A01,083771,Ganguly; Soumya,9,0,32,23
1657404227196,MATH 20E,A02,083772,Ganguly; Soumya,6,0,32,26
1657404227196,MATH 20E,B01,083773,Ciotti; Benjamin,20,0,35,15
1657404227196,MATH 20E,B02,083774,Ciotti; Benjamin,17,0,35,18
1657404233219,MATH 103A,A01,083777,Greenfeld; Be'Eri,3,0,36,33
1657404233219,MATH 103A,A02,083778,Greenfeld; Be'Eri,5,0,36,31
1657404233219,MATH 103A,A03,093561,Greenfeld; Be'Eri,5,0,36,31
1657404233219,MATH 103A,B01,083779,Greenfeld; Be'Eri,7,0,36,29
1657404233219,MATH 103A,B02,083780,Greenfeld; Be'Eri,4,0,36,32
1657404233219,MATH 103A,B03,093562,Greenfeld; Be'Eri,3,0,36,33
1657404239243,MATH 105,A01,085443,Carter; Anne Toulson,15,0,35,20
1657404239243,MATH 105,A02,093477,Carter; Anne Toulson,20,0,35,15
1657404245267,MATH 109,A01,083213,Ganzberger; Geoffrey Michael,2,0,34,32
1657404245267,MATH 109,A02,083214,Ganzberger; Geoffrey Michael,4,0,34,30
1657404245267,MATH 109,A03,093478,Ganzberger; Geoffrey Michael,2,0,34,32
1657404245267,MATH 109,B01,083215,Ganzberger; Geoffrey Michael,1,0,32,31
1657404245267,MATH 109,B02,083216,Ganzberger; Geoffrey Michael,2,0,32,30
1657404245267,MATH 109,B03,093479,Ganzberger; Geoffrey Michael,8,0,32,24
1657404251309,MATH 142A,A01,083219,Chow; Bennett,7,0,32,25
1657404251309,MATH 142A,A02,083220,Chow; Bennett,10,0,32,22
1657404251309,MATH 142A,A03,093480,Chow; Bennett,8,0,32,24
1657404251309,MATH 142A,B03,093481,Chow; Bennett,8,0,32,24
1657404251309,MATH 142A,B04,093558,Chow; Bennett,13,0,32,19
1657404251309,MATH 142A,B05,093559,Chow; Bennett,6,0,32,26
1657404257333,MATH 193A,A01,083224,Rotar; Vladimir,8,0,34,26
1657404257333,MATH 193A,A02,083225,Rotar; Vladimir,9,0,34,25
1657404257333,MATH 193A,A03,083781,Rotar; Vladimir,5,0,34,29
1657404257333,MATH 193A,A04,083782,Rotar; Vladimir,10,0,34,24
1657404257333,MATH 193A,A05,093482,Rotar; Vladimir,10,0,34,24
1657404263356,MATH 197,001,091859,McAuley; Julian John,9999,0,9999,0
1657404263356,MATH 197,002,095566,Kedlaya; Kiran S.,9997,0,9999,2
1657404263356,MATH 197,003,095567,Xiao; Ming,9999,0,9999,0
1657404263356,MATH 197,004,095571,Perols; Johan Lars,9998,0,9999,1
1657404270408,COGS 9,A01,083615,Shannon; Kyle Michael,9,0,75,66
1657404276433,COGS 11,A01,083617,Boyle; Mary E. T.,22,0,48,26
1657404282460,COGS 13,A01,083071,Bastos; Amalia Pinkusfeld,11,0,71,60
1657404288488,COGS 14A,A01,092681,Semenuks; Arturs,4,1,100,96
1657404294512,COGS 14B,A01,083073,Cheng; Tzu-Han,6,0,63,57
1657404300536,COGS 17,A01,092677,Semenuks; Arturs,6,0,81,75
1657404306559,COGS 100,A01,083619,Allen; Michael Gordon,17,0,70,53
1657404312585,COGS 101A,A01,083621,Davis; Joshua Daniel,9,0,68,59
1657404318639,COGS 101B,A01,091572,Allen; Michael Gordon,12,0,65,53
1657404324672,COGS 101C,A01,083625,Delgado; Tania,17,0,35,18
1657404330723,COGS 107A,A01,083627,Boyle; Mary E. T.,13,0,60,47
1657404336754,COGS 118A,A01,083075,Gupta; Anjum,20,0,76,56
1657404342792,CSE 3,A50,083646,Miranda; Gregory Joseph,24,0,50,26
1657404348818,CSE 8A,A50,083650,Miranda; Gregory Joseph,17,1,56,39
1657404354843,CSE 11,A01,083080,Cao; Yingjun,6,15,40,34
1657404360894,CSE 12,A01,083652,Krause-Levy; Sophia Louisa,28,1,120,92
1657404366946,CSE 15L,A01,083654,Morris; Justin Loren,9,0,50,41
1657404366946,CSE 15L,A02,083655,Morris; Justin Loren,9,0,50,41
1657404372972,CSE 20,A01,083657,Tran; Khoa Dang,39,0,80,41
1657404378995,CSE 21,A01,095574,Bach; Quang Tran,22,0,48,26
1657404385022,CSE 30,A01,083084,Eldon; John,4,0,80,76
1657404385022,CSE 30,B01,095061,Bhaskar; Nishant,9,0,50,41
1657404391060,CSE 100,A01,083659,Cao; Yingjun,5,4,70,65
1657404397084,CSE 134B,A01,083661,Powell; Thomas Allan,22,0,100,78
1657404403120,CSE 140,A01,083663,Gungor; Onat,14,0,85,71
1657404409146,CSE 140L,A01,083088,Eldon; John,21,0,100,79
1657404415177,CSE 175,A01,083665,Kumar; Rakesh,3,0,25,22
1657404421202,CSE 190,A00,092507,Dubnov; Shlomo,7,0,20,13
1657404427249,ECE 45,A01,083139,Congero; Spencer William,6,0,75,69
1657404433271,ECE 65,A50,083695,Saad; Andrew S,12,0,30,18
1657404433271,ECE 65,A51,095125,Saad; Andrew S,24,0,26,2
1657404439302,ECE 109,A01,091882,Touri; Behrouz,19,0,70,51
1657404445329,ECE 180,A00,083140,Abi Samra; Nicholas Camill,1,0,30,29
1657404445329,ECE 180,B00,083141,Abi Samra; Nicholas Camill,0,0,30,30
1657404451355,MATH 10A,A01,083735,Patchell; Gregory David,2,0,30,28
1657404451355,MATH 10A,A02,083736,Patchell; Gregory David,20,0,30,10
1657404451355,MATH 10A,A03,083737,Patchell; Gregory David,16,0,30,14
1657404457378,MATH 10B,A01,083207,Lim; Seonhee,8,0,34,26
1657404457378,MATH 10B,A02,083208,Lim; Seonhee,9,0,35,26
1657404457378,MATH 10B,A03,093472,Lim; Seonhee,7,0,34,27
1657404457378,MATH 10B,B01,083739,Sinha; Shubham,12,0,30,18
1657404463423,MATH 18,A01,083743,Cinel; Cameron Alexander,7,0,30,23
1657404463423,MATH 18,A02,083744,Cinel; Cameron Alexander,17,0,30,13
1657404463423,MATH 18,A03,083745,Cinel; Cameron Alexander,9,0,30,21
1657404463423,MATH 18,B01,083748,Rideout; David Porter,5,0,37,32
1657404463423,MATH 18,B02,083749,Rideout; David Porter,5,0,36,31
1657404463423,MATH 18,B03,083750,Rideout; David Porter,3,0,37,34
1657404463423,MATH 18,B04,083751,Rideout; David Porter,6,0,36,30
1657404463423,MATH 18,B05,093473,Rideout; David Porter,6,0,36,30
1657404463423,MATH 18,B06,093474,Rideout; David Porter,6,0,36,30
1657404469445,MATH 20A,A01,083754,Zheng; Zequn,14,0,40,26
1657404475478,MATH 20B,A01,083756,Briones; Jor-el Thomas Caparas,4,0,36,32
1657404475478,MATH 20B,A02,083757,Briones; Jor-el Thomas Caparas,1,0,36,35
1657404475478,MATH 20B,A03,093475,Briones; Jor-el Thomas Caparas,2,0,36,34
1657404481516,MATH 20C,A01,083760,Briones; Jor-el Thomas Caparas,1,0,35,34
1657404481516,MATH 20C,A02,083761,Briones; Jor-el Thomas Caparas,8,0,35,27
1657404481516,MATH 20C,A03,093476,Briones; Jor-el Thomas Caparas,0,1,36,36
1657404481516,MATH 20C,B01,083762,Bach; Quang Tran,1,0,30,29
1657404487543,MATH 20D,A01,083765,Tran; Brian Kha,5,0,30,25
1657404487543,MATH 20D,A02,083766,Tran; Brian Kha,5,0,30,25
1657404487543,MATH 20D,A03,083767,Tran; Brian Kha,5,0,30,25
1657404493567,MATH 20E,A01,083771,Ganguly; Soumya,9,0,32,23
1657404493567,MATH 20E,A02,083772,Ganguly; Soumya,6,0,32,26
1657404493567,MATH 20E,B01,083773,Ciotti; Benjamin,20,0,35,15
1657404493567,MATH 20E,B02,083774,Ciotti; Benjamin,17,0,35,18
1657404499616,MATH 103A,A01,083777,Greenfeld; Be'Eri,3,0,36,33
1657404499616,MATH 103A,A02,083778,Greenfeld; Be'Eri,5,0,36,31
1657404499616,MATH 103A,A03,093561,Greenfeld; Be'Eri,5,0,36,31
1657404499616,MATH 103A,B01,083779,Greenfeld; Be'Eri,7,0,36,29
1657404499616,MATH 103A,B02,083780,Greenfeld; Be'Eri,4,0,36,32
1657404499616,MATH 103A,B03,093562,Greenfeld; Be'Eri,3,0,36,33
1657404505645,MATH 105,A01,085443,Carter; Anne Toulson,15,0,35,20
1657404505645,MATH 105,A02,093477,Carter; Anne Toulson,20,0,35,15
1657404511677,MATH 109,A01,083213,Ganzberger; Geoffrey Michael,2,0,34,32
1657404511677,MATH 109,A02,083214,Ganzberger; Geoffrey Michael,4,0,34,30
1657404511677,MATH 109,A03,093478,Ganzberger; Geoffrey Michael,2,0,34,32
1657404511677,MATH 109,B01,083215,Ganzberger; Geoffrey Michael,1,0,32,31
1657404511677,MATH 109,B02,083216,Ganzberger; Geoffrey Michael,2,0,32,30
1657404511677,MATH 109,B03,093479,Ganzberger; Geoffrey Michael,8,0,32,24
1657404517705,MATH 142A,A01,083219,Chow; Bennett,7,0,32,25
1657404517705,MATH 142A,A02,083220,Chow; Bennett,10,0,32,22
1657404517705,MATH 142A,A03,093480,Chow; Bennett,8,0,32,24
1657404517705,MATH 142A,B03,093481,Chow; Bennett,8,0,32,24
1657404517705,MATH 142A,B04,093558,Chow; Bennett,13,0,32,19
1657404517705,MATH 142A,B05,093559,Chow; Bennett,6,0,32,26
1657404523728,MATH 193A,A01,083224,Rotar; Vladimir,8,0,34,26
1657404523728,MATH 193A,A02,083225,Rotar; Vladimir,9,0,34,25
1657404523728,MATH 193A,A03,083781,Rotar; Vladimir,5,0,34,29
1657404523728,MATH 193A,A04,083782,Rotar; Vladimir,10,0,34,24
1657404523728,MATH 193A,A05,093482,Rotar; Vladimir,10,0,34,24
1657404529759,MATH 197,001,091859,McAuley; Julian John,9999,0,9999,0
1657404529759,MATH 197,002,095566,Kedlaya; Kiran S.,9997,0,9999,2
1657404529759,MATH 197,003,095567,Xiao; Ming,9999,0,9999,0
1657404529759,MATH 197,004,095571,Perols; Johan Lars,9998,0,9999,1
1657404536851,COGS 9,A01,083615,Shannon; Kyle Michael,9,0,75,66
1657404542876,COGS 11,A01,083617,Boyle; Mary E. T.,22,0,48,26
1657404548903,COGS 13,A01,083071,Bastos; Amalia Pinkusfeld,11,0,71,60
1657404554927,COGS 14A,A01,092681,Semenuks; Arturs,4,1,100,96
1657404560956,COGS 14B,A01,083073,Cheng; Tzu-Han,6,0,63,57
1657404566981,COGS 17,A01,092677,Semenuks; Arturs,6,0,81,75
1657404573011,COGS 100,A01,083619,Allen; Michael Gordon,17,0,70,53
1657404579037,COGS 101A,A01,083621,Davis; Joshua Daniel,9,0,68,59
1657404585060,COGS 101B,A01,091572,Allen; Michael Gordon,12,0,65,53
1657404591105,COGS 101C,A01,083625,Delgado; Tania,17,0,35,18
1657404597150,COGS 107A,A01,083627,Boyle; Mary E. T.,13,0,60,47
1657404603202,COGS 118A,A01,083075,Gupta; Anjum,20,0,76,56
1657404609225,CSE 3,A50,083646,Miranda; Gregory Joseph,24,0,50,26
1657404615267,CSE 8A,A50,083650,Miranda; Gregory Joseph,17,1,56,39
1657404621288,CSE 11,A01,083080,Cao; Yingjun,6,15,40,34
1657404627326,CSE 12,A01,083652,Krause-Levy; Sophia Louisa,28,1,120,92
1657404633349,CSE 15L,A01,083654,Morris; Justin Loren,9,0,50,41
1657404633349,CSE 15L,A02,083655,Morris; Justin Loren,9,0,50,41
1657404639377,CSE 20,A01,083657,Tran; Khoa Dang,39,0,80,41
1657404645401,CSE 21,A01,095574,Bach; Quang Tran,22,0,48,26
1657404651450,CSE 30,A01,083084,Eldon; John,4,0,80,76
1657404651450,CSE 30,B01,095061,Bhaskar; Nishant,9,0,50,41
1657404657497,CSE 100,A01,083659,Cao; Yingjun,5,4,70,65
1657404663520,CSE 134B,A01,083661,Powell; Thomas Allan,22,0,100,78
1657404669542,CSE 140,A01,083663,Gungor; Onat,14,0,85,71
1657404675575,CSE 140L,A01,083088,Eldon; John,21,0,100,79
1657404681600,CSE 175,A01,083665,Kumar; Rakesh,3,0,25,22
1657404687627,CSE 190,A00,092507,Dubnov; Shlomo,7,0,20,13
1657404693662,ECE 45,A01,083139,Congero; Spencer William,6,0,75,69
1657404699686,ECE 65,A50,083695,Saad; Andrew S,12,0,30,18
1657404699686,ECE 65,A51,095125,Saad; Andrew S,24,0,26,2
1657404705711,ECE 109,A01,091882,Touri; Behrouz,19,0,70,51
1657404711750,ECE 180,A00,083140,Abi Samra; Nicholas Camill,1,0,30,29
1657404711750,ECE 180,B00,083141,Abi Samra; Nicholas Camill,0,0,30,30
1657404717774,MATH 10A,A01,083735,Patchell; Gregory David,2,0,30,28
1657404717774,MATH 10A,A02,083736,Patchell; Gregory David,20,0,30,10
1657404717774,MATH 10A,A03,083737,Patchell; Gregory David,16,0,30,14
1657404723798,MATH 10B,A01,083207,Lim; Seonhee,8,0,34,26
1657404723798,MATH 10B,A02,083208,Lim; Seonhee,9,0,35,26
1657404723798,MATH 10B,A03,093472,Lim; Seonhee,7,0,34,27
1657404723798,MATH 10B,B01,083739,Sinha; Shubham,12,0,30,18
1657404729832,MATH 18,A01,083743,Cinel; Cameron Alexander,7,0,30,23
1657404729832,MATH 18,A02,083744,Cinel; Cameron Alexander,17,0,30,13
1657404729832,MATH 18,A03,083745,Cinel; Cameron Alexander,9,0,30,21
1657404729832,MATH 18,B01,083748,Rideout; David Porter,5,0,37,32
1657404729832,MATH 18,B02,083749,Rideout; David Porter,5,0,36,31
1657404729832,MATH 18,B03,083750,Rideout; David Porter,3,0,37,34
1657404729832,MATH 18,B04,083751,Rideout; David Porter,6,0,36,30
1657404729832,MATH 18,B05,093473,Rideout; David Porter,6,0,36,30
1657404729832,MATH 18,B06,093474,Rideout; David Porter,6,0,36,30
1657404735859,MATH 20A,A01,083754,Zheng; Zequn,14,0,40,26
1657404741908,MATH 20B,A01,083756,Briones; Jor-el Thomas Caparas,4,0,36,32
1657404741908,MATH 20B,A02,083757,Briones; Jor-el Thomas Caparas,1,0,36,35
1657404741908,MATH 20B,A03,093475,Briones; Jor-el Thomas Caparas,2,0,36,34
1657404747964,MATH 20C,A01,083760,Briones; Jor-el Thomas Caparas,1,0,35,34
1657404747964,MATH 20C,A02,083761,Briones; Jor-el Thomas Caparas,8,0,35,27
1657404747964,MATH 20C,A03,093476,Briones; Jor-el Thomas Caparas,0,1,36,36
1657404747964,MATH 20C,B01,083762,Bach; Quang Tran,1,0,30,29
1657404754093,MATH 20D,A01,083765,Tran; Brian Kha,5,0,30,25
1657404754093,MATH 20D,A02,083766,Tran; Brian Kha,5,0,30,25
1657404754093,MATH 20D,A03,083767,Tran; Brian Kha,5,0,30,25
1657404760129,MATH 20E,A01,083771,Ganguly; Soumya,9,0,32,23
1657404760129,MATH 20E,A02,083772,Ganguly; Soumya,6,0,32,26
1657404760129,MATH 20E,B01,083773,Ciotti; Benjamin,20,0,35,15
1657404760129,MATH 20E,B02,083774,Ciotti; Benjamin,17,0,35,18
1657404766165,MATH 103A,A01,083777,Greenfeld; Be'Eri,3,0,36,33
1657404766165,MATH 103A,A02,083778,Greenfeld; Be'Eri,5,0,36,31
1657404766165,MATH 103A,A03,093561,Greenfeld; Be'Eri,5,0,36,31
1657404766165,MATH 103A,B01,083779,Greenfeld; Be'Eri,7,0,36,29
1657404766165,MATH 103A,B02,083780,Greenfeld; Be'Eri,4,0,36,32
1657404766165,MATH 103A,B03,093562,Greenfeld; Be'Eri,3,0,36,33
1657404772189,MATH 105,A01,085443,Carter; Anne Toulson,15,0,35,20
1657404772189,MATH 105,A02,093477,Carter; Anne Toulson,20,0,35,15
1657404778217,MATH 109,A01,083213,Ganzberger; Geoffrey Michael,2,0,34,32
1657404778217,MATH 109,A02,083214,Ganzberger; Geoffrey Michael,4,0,34,30
1657404778217,MATH 109,A03,093478,Ganzberger; Geoffrey Michael,2,0,34,32
1657404778217,MATH 109,B01,083215,Ganzberger; Geoffrey Michael,1,0,32,31
1657404778217,MATH 109,B02,083216,Ganzberger; Geoffrey Michael,2,0,32,30
1657404778217,MATH 109,B03,093479,Ganzberger; Geoffrey Michael,8,0,32,24
1657404784271,MATH 142A,A01,083219,Chow; Bennett,7,0,32,25
1657404784271,MATH 142A,A02,083220,Chow; Bennett,10,0,32,22
1657404784271,MATH 142A,A03,093480,Chow; Bennett,8,0,32,24
1657404784271,MATH 142A,B03,093481,Chow; Bennett,8,0,32,24
1657404784271,MATH 142A,B04,093558,Chow; Bennett,13,0,32,19
1657404784271,MATH 142A,B05,093559,Chow; Bennett,6,0,32,26
1657404790309,MATH 193A,A01,083224,Rotar; Vladimir,8,0,34,26
1657404790309,MATH 193A,A02,083225,Rotar; Vladimir,9,0,34,25
1657404790309,MATH 193A,A03,083781,Rotar; Vladimir,5,0,34,29
1657404790309,MATH 193A,A04,083782,Rotar; Vladimir,10,0,34,24
1657404790309,MATH 193A,A05,093482,Rotar; Vladimir,10,0,34,24
1657404796334,MATH 197,001,091859,McAuley; Julian John,9999,0,9999,0
1657404796334,MATH 197,002,095566,Kedlaya; Kiran S.,9997,0,9999,2
1657404796334,MATH 197,003,095567,Xiao; Ming,9999,0,9999,0
1657404796334,MATH 197,004,095571,Perols; Johan Lars,9998,0,9999,1
1657404803388,COGS 9,A01,083615,Shannon; Kyle Michael,9,0,75,66
1657404809414,COGS 11,A01,083617,Boyle; Mary E. T.,22,0,48,26
1657404815462,COGS 13,A01,083071,Bastos; Amalia Pinkusfeld,11,0,71,60
1657404821508,COGS 14A,A01,092681,Semenuks; Arturs,4,1,100,96
1657404827550,COGS 14B,A01,083073,Cheng; Tzu-Han,6,0,63,57
1657404833595,COGS 17,A01,092677,Semenuks; Arturs,6,0,81,75
1657404839623,COGS 100,A01,083619,Allen; Michael Gordon,17,0,70,53
1657404845651,COGS 101A,A01,083621,Davis; Joshua Daniel,9,0,68,59
1657404851678,COGS 101B,A01,091572,Allen; Michael Gordon,12,0,65,53
1657404857714,COGS 101C,A01,083625,Delgado; Tania,17,0,35,18
1657404863761,COGS 107A,A01,083627,Boyle; Mary E. T.,13,0,60,47
1657404869790,COGS 118A,A01,083075,Gupta; Anjum,20,0,76,56
1657404875816,CSE 3,A50,083646,Miranda; Gregory Joseph,24,0,50,26
1657404881852,CSE 8A,A50,083650,Miranda; Gregory Joseph,17,1,56,39
1657404887877,CSE 11,A01,083080,Cao; Yingjun,6,15,40,34
1657404893900,CSE 12,A01,083652,Krause-Levy; Sophia Louisa,28,1,120,92
1657404899938,CSE 15L,A01,083654,Morris; Justin Loren,9,0,50,41
1657404899938,CSE 15L,A02,083655,Morris; Justin Loren,9,0,50,41
1657404905973,CSE 20,A01,083657,Tran; Khoa Dang,39,0,80,41
1657404912001,CSE 21,A01,095574,Bach; Quang Tran,22,0,48,26
1657404918026,CSE 30,A01,083084,Eldon; John,4,0,80,76
1657404918026,CSE 30,B01,095061,Bhaskar; Nishant,9,0,50,41
1657404924054,CSE 100,A01,083659,Cao; Yingjun,5,4,70,65
1657404930088,CSE 134B,A01,083661,Powell; Thomas Allan,22,0,100,78
1657404936120,CSE 140,A01,083663,Gungor; Onat,14,0,85,71
1657404942173,CSE 140L,A01,083088,Eldon; John,21,0,100,79
1657404948197,CSE 175,A01,083665,Kumar; Rakesh,3,0,25,22
1657404954220,CSE 190,A00,092507,Dubnov; Shlomo,7,0,20,13
1657404960246,ECE 45,A01,083139,Congero; Spencer William,6,0,75,69
1657404966301,ECE 65,A50,083695,Saad; Andrew S,12,0,30,18
1657404966301,ECE 65,A51,095125,Saad; Andrew S,24,0,26,2
1657404972324,ECE 109,A01,091882,Touri; Behrouz,19,0,70,51
1657404978355,ECE 180,A00,083140,Abi Samra; Nicholas Camill,1,0,30,29
1657404978355,ECE 180,B00,083141,Abi Samra; Nicholas Camill,0,0,30,30
1657404984378,MATH 10A,A01,083735,Patchell; Gregory David,2,0,30,28
1657404984378,MATH 10A,A02,083736,Patchell; Gregory David,20,0,30,10
1657404984378,MATH 10A,A03,083737,Patchell; Gregory David,16,0,30,14
1657404990406,MATH 10B,A01,083207,Lim; Seonhee,8,0,34,26
1657404990406,MATH 10B,A02,083208,Lim; Seonhee,9,0,35,26
1657404990406,MATH 10B,A03,093472,Lim; Seonhee,7,0,34,27
1657404990406,MATH 10B,B01,083739,Sinha; Shubham,12,0,30,18
1657404996445,MATH 18,A01,083743,Cinel; Cameron Alexander,7,0,30,23
1657404996445,MATH 18,A02,083744,Cinel; Cameron Alexander,17,0,30,13
1657404996445,MATH 18,A03,083745,Cinel; Cameron Alexander,9,0,30,21
1657404996445,MATH 18,B01,083748,Rideout; David Porter,5,0,37,32
1657404996445,MATH 18,B02,083749,Rideout; David Porter,5,0,36,31
1657404996445,MATH 18,B03,083750,Rideout; David Porter,3,0,37,34
1657404996445,MATH 18,B04,083751,Rideout; David Porter,6,0,36,30
1657404996445,MATH 18,B05,093473,Rideout; David Porter,6,0,36,30
1657404996445,MATH 18,B06,093474,Rideout; David Porter,6,0,36,30
1657405002468,MATH 20A,A01,083754,Zheng; Zequn,14,0,40,26
1657405008496,MATH 20B,A01,083756,Briones; Jor-el Thomas Caparas,4,0,36,32
1657405008496,MATH 20B,A02,083757,Briones; Jor-el Thomas Caparas,1,0,36,35
1657405008496,MATH 20B,A03,093475,Briones; Jor-el Thomas Caparas,2,0,36,34
1657405014519,MATH 20C,A01,083760,Briones; Jor-el Thomas Caparas,1,0,35,34
1657405014519,MATH 20C,A02,083761,Briones; Jor-el Thomas Caparas,8,0,35,27
1657405014519,MATH 20C,A03,093476,Briones; Jor-el Thomas Caparas,0,1,36,36
1657405014519,MATH 20C,B01,083762,Bach; Quang Tran,1,0,30,29
1657405020542,MATH 20D,A01,083765,Tran; Brian Kha,5,0,30,25
1657405020542,MATH 20D,A02,083766,Tran; Brian Kha,5,0,30,25
1657405020542,MATH 20D,A03,083767,Tran; Brian Kha,5,0,30,25
1657405026567,MATH 20E,A01,083771,Ganguly; Soumya,9,0,32,23
1657405026567,MATH 20E,A02,083772,Ganguly; Soumya,6,0,32,26
1657405026567,MATH 20E,B01,083773,Ciotti; Benjamin,20,0,35,15
1657405026567,MATH 20E,B02,083774,Ciotti; Benjamin,17,0,35,18
1657405032591,MATH 103A,A01,083777,Greenfeld; Be'Eri,3,0,36,33
1657405032591,MATH 103A,A02,083778,Greenfeld; Be'Eri,5,0,36,31
1657405032591,MATH 103A,A03,093561,Greenfeld; Be'Eri,5,0,36,31
1657405032591,MATH 103A,B01,083779,Greenfeld; Be'Eri,7,0,36,29
1657405032591,MATH 103A,B02,083780,Greenfeld; Be'Eri,4,0,36,32
1657405032591,MATH 103A,B03,093562,Greenfeld; Be'Eri,3,0,36,33
1657405038635,MATH 105,A01,085443,Carter; Anne Toulson,15,0,35,20
1657405038635,MATH 105,A02,093477,Carter; Anne Toulson,20,0,35,15
1657405044662,MATH 109,A01,083213,Ganzberger; Geoffrey Michael,2,0,34,32
1657405044662,MATH 109,A02,083214,Ganzberger; Geoffrey Michael,4,0,34,30
1657405044662,MATH 109,A03,093478,Ganzberger; Geoffrey Michael,2,0,34,32
1657405044662,MATH 109,B01,083215,Ganzberger; Geoffrey Michael,1,0,32,31
1657405044662,MATH 109,B02,083216,Ganzberger; Geoffrey Michael,2,0,32,30
1657405044662,MATH 109,B03,093479,Ganzberger; Geoffrey Michael,8,0,32,24
1657405050687,MATH 142A,A01,083219,Chow; Bennett,7,0,32,25
1657405050687,MATH 142A,A02,083220,Chow; Bennett,10,0,32,22
1657405050687,MATH 142A,A03,093480,Chow; Bennett,8,0,32,24
1657405050687,MATH 142A,B03,093481,Chow; Bennett,8,0,32,24
1657405050687,MATH 142A,B04,093558,Chow; Bennett,13,0,32,19
1657405050687,MATH 142A,B05,093559,Chow; Bennett,6,0,32,26
1657405056718,MATH 193A,A01,083224,Rotar; Vladimir,8,0,34,26
1657405056718,MATH 193A,A02,083225,Rotar; Vladimir,9,0,34,25
1657405056718,MATH 193A,A03,083781,Rotar; Vladimir,5,0,34,29
1657405056718,MATH 193A,A04,083782,Rotar; Vladimir,10,0,34,24
1657405056718,MATH 193A,A05,093482,Rotar; Vladimir,10,0,34,24
1657405062746,MATH 197,001,091859,McAuley; Julian John,9999,0,9999,0
1657405062746,MATH 197,002,095566,Kedlaya; Kiran S.,9997,0,9999,2
1657405062746,MATH 197,003,095567,Xiao; Ming,9999,0,9999,0
1657405062746,MATH 197,004,095571,Perols; Johan Lars,9998,0,9999,1
1657405069795,COGS 9,A01,083615,Shannon; Kyle Michael,9,0,75,66
1657405075847,COGS 11,A01,083617,Boyle; Mary E. T.,22,0,48,26
1657405081889,COGS 13,A01,083071,Bastos; Amalia Pinkusfeld,11,0,71,60
1657405087912,COGS 14A,A01,092681,Semenuks; Arturs,4,1,100,96
1657405093938,COGS 14B,A01,083073,Cheng; Tzu-Han,6,0,63,57
1657405099964,COGS 17,A01,092677,Semenuks; Arturs,6,0,81,75
1657405105998,COGS 100,A01,083619,Allen; Michael Gordon,17,0,70,53
1657405112034,COGS 101A,A01,083621,Davis; Joshua Daniel,9,0,68,59
1657405118059,COGS 101B,A01,091572,Allen; Michael Gordon,12,0,65,53
1657405124081,COGS 101C,A01,083625,Delgado; Tania,17,0,35,18
1657405130116,COGS 107A,A01,083627,Boyle; Mary E. T.,13,0,60,47
1657405136138,COGS 118A,A01,083075,Gupta; Anjum,20,0,76,56
1657405142171,CSE 3,A50,083646,Miranda; Gregory Joseph,24,0,50,26
1657405148194,CSE 8A,A50,083650,Miranda; Gregory Joseph,17,1,56,39
1657405154218,CSE 11,A01,083080,Cao; Yingjun,6,15,40,34
1657405160254,CSE 12,A01,083652,Krause-Levy; Sophia Louisa,28,1,120,92
1657405166289,CSE 15L,A01,083654,Morris; Justin Loren,9,0,50,41
1657405166289,CSE 15L,A02,083655,Morris; Justin Loren,9,0,50,41
1657405172315,CSE 20,A01,083657,Tran; Khoa Dang,39,0,80,41
1657405178353,CSE 21,A01,095574,Bach; Quang Tran,22,0,48,26
1657405184381,CSE 30,A01,083084,Eldon; John,4,0,80,76
1657405184381,CSE 30,B01,095061,Bhaskar; Nishant,9,0,50,41
1657405190402,CSE 100,A01,083659,Cao; Yingjun,5,4,70,65
1657405196434,CSE 134B,A01,083661,Powell; Thomas Allan,22,0,100,78
1657405202463,CSE 140,A01,083663,Gungor; Onat,14,0,85,71
1657405208489,CSE 140L,A01,083088,Eldon; John,21,0,100,79
1657405214512,CSE 175,A01,083665,Kumar; Rakesh,3,0,25,22
1657405220563,CSE 190,A00,092507,Dubnov; Shlomo,7,0,20,13
1657405226583,ECE 45,A01,083139,Congero; Spencer William,6,0,75,69
1657405232611,ECE 65,A50,083695,Saad; Andrew S,12,0,30,18
1657405232611,ECE 65,A51,095125,Saad; Andrew S,24,0,26,2
1657405238649,ECE 109,A01,091882,Touri; Behrouz,19,0,70,51
1657405244673,ECE 180,A00,083140,Abi Samra; Nicholas Camill,1,0,30,29
1657405244673,ECE 180,B00,083141,Abi Samra; Nicholas Camill,0,0,30,30
1657405250702,MATH 10A,A01,083735,Patchell; Gregory David,2,0,30,28
1657405250702,MATH 10A,A02,083736,Patchell; Gregory David,20,0,30,10
1657405250702,MATH 10A,A03,083737,Patchell; Gregory David,16,0,30,14
1657405256737,MATH 10B,A01,083207,Lim; Seonhee,8,0,34,26
1657405256737,MATH 10B,A02,083208,Lim; Seonhee,9,0,35,26
1657405256737,MATH 10B,A03,093472,Lim; Seonhee,7,0,34,27
1657405256737,MATH 10B,B01,083739,Sinha; Shubham,12,0,30,18
1657405262761,MATH 18,A01,083743,Cinel; Cameron Alexander,7,0,30,23
1657405262761,MATH 18,A02,083744,Cinel; Cameron Alexander,17,0,30,13
1657405262761,MATH 18,A03,083745,Cinel; Cameron Alexander,9,0,30,21
1657405262761,MATH 18,B01,083748,Rideout; David Porter,5,0,37,32
1657405262761,MATH 18,B02,083749,Rideout; David Porter,5,0,36,31
1657405262761,MATH 18,B03,083750,Rideout; David Porter,3,0,37,34
1657405262761,MATH 18,B04,083751,Rideout; David Porter,6,0,36,30
1657405262761,MATH 18,B05,093473,Rideout; David Porter,6,0,36,30
1657405262761,MATH 18,B06,093474,Rideout; David Porter,6,0,36,30
1657405268784,MATH 20A,A01,083754,Zheng; Zequn,14,0,40,26
1657405274812,MATH 20B,A01,083756,Briones; Jor-el Thomas Caparas,4,0,36,32
1657405274812,MATH 20B,A02,083757,Briones; Jor-el Thomas Caparas,1,0,36,35
1657405274812,MATH 20B,A03,093475,Briones; Jor-el Thomas Caparas,2,0,36,34
1657405280835,MATH 20C,A01,083760,Briones; Jor-el Thomas Caparas,1,0,35,34
1657405280835,MATH 20C,A02,083761,Briones; Jor-el Thomas Caparas,8,0,35,27
1657405280835,MATH 20C,A03,093476,Briones; Jor-el Thomas Caparas,0,1,36,36
1657405280835,MATH 20C,B01,083762,Bach; Quang Tran,1,0,30,29
1657405286857,MATH 20D,A01,083765,Tran; Brian Kha,5,0,30,25
1657405286857,MATH 20D,A02,083766,Tran; Brian Kha,5,0,30,25
1657405286857,MATH 20D,A03,083767,Tran; Brian Kha,5,0,30,25
1657405292888,MATH 20E,A01,083771,Ganguly; Soumya,9,0,32,23
1657405292888,MATH 20E,A02,083772,Ganguly; Soumya,6,0,32,26
1657405292888,MATH 20E,B01,083773,Ciotti; Benjamin,20,0,35,15
1657405292888,MATH 20E,B02,083774,Ciotti; Benjamin,17,0,35,18
1657405298911,MATH 103A,A01,083777,Greenfeld; Be'Eri,3,0,36,33
1657405298911,MATH 103A,A02,083778,Greenfeld; Be'Eri,5,0,36,31
1657405298911,MATH 103A,A03,093561,Greenfeld; Be'Eri,5,0,36,31
1657405298911,MATH 103A,B01,083779,Greenfeld; Be'Eri,7,0,36,29
1657405298911,MATH 103A,B02,083780,Greenfeld; Be'Eri,4,0,36,32
1657405298911,MATH 103A,B03,093562,Greenfeld; Be'Eri,3,0,36,33
1657405304941,MATH 105,A01,085443,Carter; Anne Toulson,15,0,35,20
1657405304941,MATH 105,A02,093477,Carter; Anne Toulson,20,0,35,15
1657405310974,MATH 109,A01,083213,Ganzberger; Geoffrey Michael,2,0,34,32
1657405310974,MATH 109,A02,083214,Ganzberger; Geoffrey Michael,4,0,34,30
1657405310974,MATH 109,A03,093478,Ganzberger; Geoffrey Michael,2,0,34,32
1657405310974,MATH 109,B01,083215,Ganzberger; Geoffrey Michael,1,0,32,31
1657405310974,MATH 109,B02,083216,Ganzberger; Geoffrey Michael,2,0,32,30
1657405310974,MATH 109,B03,093479,Ganzberger; Geoffrey Michael,8,0,32,24
1657405317003,MATH 142A,A01,083219,Chow; Bennett,7,0,32,25
1657405317003,MATH 142A,A02,083220,Chow; Bennett,10,0,32,22
1657405317003,MATH 142A,A03,093480,Chow; Bennett,8,0,32,24
1657405317003,MATH 142A,B03,093481,Chow; Bennett,8,0,32,24
1657405317003,MATH 142A,B04,093558,Chow; Bennett,13,0,32,19
1657405317003,MATH 142A,B05,093559,Chow; Bennett,6,0,32,26
1657405323029,MATH 193A,A01,083224,Rotar; Vladimir,8,0,34,26
1657405323029,MATH 193A,A02,083225,Rotar; Vladimir,9,0,34,25
1657405323029,MATH 193A,A03,083781,Rotar; Vladimir,5,0,34,29
1657405323029,MATH 193A,A04,083782,Rotar; Vladimir,10,0,34,24
1657405323029,MATH 193A,A05,093482,Rotar; Vladimir,10,0,34,24
1657405329052,MATH 197,001,091859,McAuley; Julian John,9999,0,9999,0
1657405329052,MATH 197,002,095566,Kedlaya; Kiran S.,9997,0,9999,2
1657405329052,MATH 197,003,095567,Xiao; Ming,9999,0,9999,0
1657405329052,MATH 197,004,095571,Perols; Johan Lars,9998,0,9999,1
1657405336102,COGS 9,A01,083615,Shannon; Kyle Michael,9,0,75,66
1657405342128,COGS 11,A01,083617,Boyle; Mary E. T.,22,0,48,26
1657405348224,COGS 13,A01,083071,Bastos; Amalia Pinkusfeld,11,0,71,60
1657405354251,COGS 14A,A01,092681,Semenuks; Arturs,4,1,100,96
1657405360284,COGS 14B,A01,083073,Cheng; Tzu-Han,6,0,63,57
1657405366312,COGS 17,A01,092677,Semenuks; Arturs,6,0,81,75
1657405372334,COGS 100,A01,083619,Allen; Michael Gordon,17,0,70,53
1657405378359,COGS 101A,A01,083621,Davis; Joshua Daniel,9,0,68,59
1657405384387,COGS 101B,A01,091572,Allen; Michael Gordon,12,0,65,53
1657405390414,COGS 101C,A01,083625,Delgado; Tania,17,0,35,18
1657405396450,COGS 107A,A01,083627,Boyle; Mary E. T.,13,0,60,47
1657405402476,COGS 118A,A01,083075,Gupta; Anjum,20,0,76,56
1657405408503,CSE 3,A50,083646,Miranda; Gregory Joseph,24,0,50,26
1657405414542,CSE 8A,A50,083650,Miranda; Gregory Joseph,17,1,56,39
1657405420567,CSE 11,A01,083080,Cao; Yingjun,6,15,40,34
1657405426595,CSE 12,A01,083652,Krause-Levy; Sophia Louisa,28,1,120,92
1657405432623,CSE 15L,A01,083654,Morris; Justin Loren,9,0,50,41
1657405432623,CSE 15L,A02,083655,Morris; Justin Loren,9,0,50,41
1657405438645,CSE 20,A01,083657,Tran; Khoa Dang,39,0,80,41
1657405444677,CSE 21,A01,095574,Bach; Quang Tran,22,0,48,26
1657405450712,CSE 30,A01,083084,Eldon; John,4,0,80,76
1657405450712,CSE 30,B01,095061,Bhaskar; Nishant,9,0,50,41
1657405456751,CSE 100,A01,083659,Cao; Yingjun,5,4,70,65
1657405462784,CSE 134B,A01,083661,Powell; Thomas Allan,22,0,100,78
1657405468813,CSE 140,A01,083663,Gungor; Onat,14,0,85,71
1657405474845,CSE 140L,A01,083088,Eldon; John,21,0,100,79
1657405480867,CSE 175,A01,083665,Kumar; Rakesh,3,0,25,22
1657405486898,CSE 190,A00,092507,Dubnov; Shlomo,7,0,20,13
1657405492921,ECE 45,A01,083139,Congero; Spencer William,6,0,75,69
1657405498950,ECE 65,A50,083695,Saad; Andrew S,12,0,30,18
1657405498950,ECE 65,A51,095125,Saad; Andrew S,24,0,26,2
1657405504979,ECE 109,A01,091882,Touri; Behrouz,19,0,70,51
1657405511006,ECE 180,A00,083140,Abi Samra; Nicholas Camill,1,0,30,29
1657405511006,ECE 180,B00,083141,Abi Samra; Nicholas Camill,0,0,30,30
1657405517031,MATH 10A,A01,083735,Patchell; Gregory David,2,0,30,28
1657405517031,MATH 10A,A02,083736,Patchell; Gregory David,20,0,30,10
1657405517031,MATH 10A,A03,083737,Patchell; Gregory David,16,0,30,14
1657405523076,MATH 10B,A01,083207,Lim; Seonhee,8,0,34,26
1657405523076,MATH 10B,A02,083208,Lim; Seonhee,9,0,35,26
1657405523076,MATH 10B,A03,093472,Lim; Seonhee,7,0,34,27
1657405523076,MATH 10B,B01,083739,Sinha; Shubham,12,0,30,18
1657405529108,MATH 18,A01,083743,Cinel; Cameron Alexander,7,0,30,23
1657405529108,MATH 18,A02,083744,Cinel; Cameron Alexander,17,0,30,13
1657405529108,MATH 18,A03,083745,Cinel; Cameron Alexander,9,0,30,21
1657405529108,MATH 18,B01,083748,Rideout; David Porter,5,0,37,32
1657405529108,MATH 18,B02,083749,Rideout; David Porter,5,0,36,31
1657405529108,MATH 18,B03,083750,Rideout; David Porter,3,0,37,34
1657405529108,MATH 18,B04,083751,Rideout; David Porter,6,0,36,30
1657405529108,MATH 18,B05,093473,Rideout; David Porter,6,0,36,30
1657405529108,MATH 18,B06,093474,Rideout; David Porter,6,0,36,30
1657405535133,MATH 20A,A01,083754,Zheng; Zequn,14,0,40,26
1657405541155,MATH 20B,A01,083756,Briones; Jor-el Thomas Caparas,4,0,36,32
1657405541155,MATH 20B,A02,083757,Briones; Jor-el Thomas Caparas,1,0,36,35
1657405541155,MATH 20B,A03,093475,Briones; Jor-el Thomas Caparas,2,0,36,34
1657405547178,MATH 20C,A01,083760,Briones; Jor-el Thomas Caparas,1,0,35,34
1657405547178,MATH 20C,A02,083761,Briones; Jor-el Thomas Caparas,8,0,35,27
1657405547178,MATH 20C,A03,093476,Briones; Jor-el Thomas Caparas,0,1,36,36
1657405547178,MATH 20C,B01,083762,Bach; Quang Tran,1,0,30,29
1657405553205,MATH 20D,A01,083765,Tran; Brian Kha,5,0,30,25
1657405553205,MATH 20D,A02,083766,Tran; Brian Kha,5,0,30,25
1657405553205,MATH 20D,A03,083767,Tran; Brian Kha,5,0,30,25
1657405559228,MATH 20E,A01,083771,Ganguly; Soumya,9,0,32,23
1657405559228,MATH 20E,A02,083772,Ganguly; Soumya,6,0,32,26
1657405559228,MATH 20E,B01,083773,Ciotti; Benjamin,20,0,35,15
1657405559228,MATH 20E,B02,083774,Ciotti; Benjamin,17,0,35,18
1657405565253,MATH 103A,A01,083777,Greenfeld; Be'Eri,3,0,36,33
1657405565253,MATH 103A,A02,083778,Greenfeld; Be'Eri,5,0,36,31
1657405565253,MATH 103A,A03,093561,Greenfeld; Be'Eri,5,0,36,31
1657405565253,MATH 103A,B01,083779,Greenfeld; Be'Eri,7,0,36,29
1657405565253,MATH 103A,B02,083780,Greenfeld; Be'Eri,4,0,36,32
1657405565253,MATH 103A,B03,093562,Greenfeld; Be'Eri,3,0,36,33
1657405571276,MATH 105,A01,085443,Carter; Anne Toulson,15,0,35,20
1657405571276,MATH 105,A02,093477,Carter; Anne Toulson,20,0,35,15
1657405577304,MATH 109,A01,083213,Ganzberger; Geoffrey Michael,2,0,34,32
1657405577304,MATH 109,A02,083214,Ganzberger; Geoffrey Michael,4,0,34,30
1657405577304,MATH 109,A03,093478,Ganzberger; Geoffrey Michael,2,0,34,32
1657405577304,MATH 109,B01,083215,Ganzberger; Geoffrey Michael,1,0,32,31
1657405577304,MATH 109,B02,083216,Ganzberger; Geoffrey Michael,2,0,32,30
1657405577304,MATH 109,B03,093479,Ganzberger; Geoffrey Michael,8,0,32,24
1657405583327,MATH 142A,A01,083219,Chow; Bennett,7,0,32,25
1657405583327,MATH 142A,A02,083220,Chow; Bennett,10,0,32,22
1657405583327,MATH 142A,A03,093480,Chow; Bennett,8,0,32,24
1657405583327,MATH 142A,B03,093481,Chow; Bennett,8,0,32,24
1657405583327,MATH 142A,B04,093558,Chow; Bennett,13,0,32,19
1657405583327,MATH 142A,B05,093559,Chow; Bennett,6,0,32,26
1657405589363,MATH 193A,A01,083224,Rotar; Vladimir,8,0,34,26
1657405589363,MATH 193A,A02,083225,Rotar; Vladimir,9,0,34,25
1657405589363,MATH 193A,A03,083781,Rotar; Vladimir,5,0,34,29
1657405589363,MATH 193A,A04,083782,Rotar; Vladimir,10,0,34,24
1657405589363,MATH 193A,A05,093482,Rotar; Vladimir,10,0,34,24
1657405595389,MATH 197,001,091859,McAuley; Julian John,9999,0,9999,0
1657405595389,MATH 197,002,095566,Kedlaya; Kiran S.,9997,0,9999,2
1657405595389,MATH 197,003,095567,Xiao; Ming,9999,0,9999,0
1657405595389,MATH 197,004,095571,Perols; Johan Lars,9998,0,9999,1
1657405602451,COGS 9,A01,083615,Shannon; Kyle Michael,9,0,75,66
1657405608475,COGS 11,A01,083617,Boyle; Mary E. T.,22,0,48,26
1657405614499,COGS 13,A01,083071,Bastos; Amalia Pinkusfeld,11,0,71,60
1657405620521,COGS 14A,A01,092681,Semenuks; Arturs,4,1,100,96
1657405626547,COGS 14B,A01,083073,Cheng; Tzu-Han,6,0,63,57
1657405632569,COGS 17,A01,092677,Semenuks; Arturs,6,0,81,75
1657405638592,COGS 100,A01,083619,Allen; Michael Gordon,17,0,70,53
1657405644619,COGS 101A,A01,083621,Davis; Joshua Daniel,9,0,68,59
1657405650643,COGS 101B,A01,091572,Allen; Michael Gordon,12,0,65,53
1657405656668,COGS 101C,A01,083625,Delgado; Tania,17,0,35,18
1657405662693,COGS 107A,A01,083627,Boyle; Mary E. T.,13,0,60,47
1657405668717,COGS 118A,A01,083075,Gupta; Anjum,20,0,76,56
1657405674741,CSE 3,A50,083646,Miranda; Gregory Joseph,24,0,50,26
1657405680781,CSE 8A,A50,083650,Miranda; Gregory Joseph,17,1,56,39
1657405686805,CSE 11,A01,083080,Cao; Yingjun,6,15,40,34
1657405692832,CSE 12,A01,083652,Krause-Levy; Sophia Louisa,28,1,120,92
1657405698854,CSE 15L,A01,083654,Morris; Justin Loren,9,0,50,41
1657405698854,CSE 15L,A02,083655,Morris; Justin Loren,9,0,50,41
1657405704881,CSE 20,A01,083657,Tran; Khoa Dang,39,0,80,41
1657405710905,CSE 21,A01,095574,Bach; Quang Tran,22,0,48,26
1657405716929,CSE 30,A01,083084,Eldon; John,4,0,80,76
1657405716929,CSE 30,B01,095061,Bhaskar; Nishant,9,0,50,41
1657405722954,CSE 100,A01,083659,Cao; Yingjun,5,4,70,65
1657405728976,CSE 134B,A01,083661,Powell; Thomas Allan,22,0,100,78
1657405734999,CSE 140,A01,083663,Gungor; Onat,14,0,85,71
1657405741023,CSE 140L,A01,083088,Eldon; John,21,0,100,79
1657405747046,CSE 175,A01,083665,Kumar; Rakesh,3,0,25,22
1657405753071,CSE 190,A00,092507,Dubnov; Shlomo,7,0,20,13
1657405759106,ECE 45,A01,083139,Congero; Spencer William,6,0,75,69
1657405765130,ECE 65,A50,083695,Saad; Andrew S,12,0,30,18
1657405765130,ECE 65,A51,095125,Saad; Andrew S,24,0,26,2
1657405771167,ECE 109,A01,091882,Touri; Behrouz,19,0,70,51
1657405777193,ECE 180,A00,083140,Abi Samra; Nicholas Camill,1,0,30,29
1657405777193,ECE 180,B00,083141,Abi Samra; Nicholas Camill,0,0,30,30
1657405783219,MATH 10A,A01,083735,Patchell; Gregory David,2,0,30,28
1657405783219,MATH 10A,A02,083736,Patchell; Gregory David,20,0,30,10
1657405783219,MATH 10A,A03,083737,Patchell; Gregory David,16,0,30,14
1657405789255,MATH 10B,A01,083207,Lim; Seonhee,8,0,34,26
1657405789255,MATH 10B,A02,083208,Lim; Seonhee,9,0,35,26
1657405789255,MATH 10B,A03,093472,Lim; Seonhee,7,0,34,27
1657405789255,MATH 10B,B01,083739,Sinha; Shubham,12,0,30,18
1657405795287,MATH 18,A01,083743,Cinel; Cameron Alexander,7,0,30,23
1657405795287,MATH 18,A02,083744,Cinel; Cameron Alexander,17,0,30,13
1657405795287,MATH 18,A03,083745,Cinel; Cameron Alexander,9,0,30,21
1657405795287,MATH 18,B01,083748,Rideout; David Porter,5,0,37,32
1657405795287,MATH 18,B02,083749,Rideout; David Porter,5,0,36,31
1657405795287,MATH 18,B03,083750,Rideout; David Porter,3,0,37,34
1657405795287,MATH 18,B04,083751,Rideout; David Porter,6,0,36,30
1657405795287,MATH 18,B05,093473,Rideout; David Porter,6,0,36,30
1657405795287,MATH 18,B06,093474,Rideout; David Porter,6,0,36,30
1657405801364,MATH 20A,A01,083754,Zheng; Zequn,14,0,40,26
1657405807389,MATH 20B,A01,083756,Briones; Jor-el Thomas Caparas,4,0,36,32
1657405807389,MATH 20B,A02,083757,Briones; Jor-el Thomas Caparas,1,0,36,35
1657405807389,MATH 20B,A03,093475,Briones; Jor-el Thomas Caparas,2,0,36,34
1657405813418,MATH 20C,A01,083760,Briones; Jor-el Thomas Caparas,1,0,35,34
1657405813418,MATH 20C,A02,083761,Briones; Jor-el Thomas Caparas,8,0,35,27
1657405813418,MATH 20C,A03,093476,Briones; Jor-el Thomas Caparas,0,1,36,36
1657405813418,MATH 20C,B01,083762,Bach; Quang Tran,1,0,30,29
1657405819442,MATH 20D,A01,083765,Tran; Brian Kha,5,0,30,25
1657405819442,MATH 20D,A02,083766,Tran; Brian Kha,5,0,30,25
1657405819442,MATH 20D,A03,083767,Tran; Brian Kha,5,0,30,25
1657405825470,MATH 20E,A01,083771,Ganguly; Soumya,9,0,32,23
1657405825470,MATH 20E,A02,083772,Ganguly; Soumya,6,0,32,26
1657405825470,MATH 20E,B01,083773,Ciotti; Benjamin,20,0,35,15
1657405825470,MATH 20E,B02,083774,Ciotti; Benjamin,17,0,35,18
1657405831521,MATH 103A,A01,083777,Greenfeld; Be'Eri,3,0,36,33
1657405831521,MATH 103A,A02,083778,Greenfeld; Be'Eri,5,0,36,31
1657405831521,MATH 103A,A03,093561,Greenfeld; Be'Eri,5,0,36,31
1657405831521,MATH 103A,B01,083779,Greenfeld; Be'Eri,7,0,36,29
1657405831521,MATH 103A,B02,083780,Greenfeld; Be'Eri,4,0,36,32
1657405831521,MATH 103A,B03,093562,Greenfeld; Be'Eri,3,0,36,33
1657405837549,MATH 105,A01,085443,Carter; Anne Toulson,15,0,35,20
1657405837549,MATH 105,A02,093477,Carter; Anne Toulson,20,0,35,15
1657405843573,MATH 109,A01,083213,Ganzberger; Geoffrey Michael,2,0,34,32
1657405843573,MATH 109,A02,083214,Ganzberger; Geoffrey Michael,4,0,34,30
1657405843573,MATH 109,A03,093478,Ganzberger; Geoffrey Michael,2,0,34,32
1657405843573,MATH 109,B01,083215,Ganzberger; Geoffrey Michael,1,0,32,31
1657405843573,MATH 109,B02,083216,Ganzberger; Geoffrey Michael,2,0,32,30
1657405843573,MATH 109,B03,093479,Ganzberger; Geoffrey Michael,8,0,32,24
1657405849610,MATH 142A,A01,083219,Chow; Bennett,7,0,32,25
1657405849610,MATH 142A,A02,083220,Chow; Bennett,10,0,32,22
1657405849610,MATH 142A,A03,093480,Chow; Bennett,8,0,32,24
1657405849610,MATH 142A,B03,093481,Chow; Bennett,8,0,32,24
1657405849610,MATH 142A,B04,093558,Chow; Bennett,13,0,32,19
1657405849610,MATH 142A,B05,093559,Chow; Bennett,6,0,32,26
1657405855640,MATH 193A,A01,083224,Rotar; Vladimir,8,0,34,26
1657405855640,MATH 193A,A02,083225,Rotar; Vladimir,9,0,34,25
1657405855640,MATH 193A,A03,083781,Rotar; Vladimir,5,0,34,29
1657405855640,MATH 193A,A04,083782,Rotar; Vladimir,10,0,34,24
1657405855640,MATH 193A,A05,093482,Rotar; Vladimir,10,0,34,24
1657405861667,MATH 197,001,091859,McAuley; Julian John,9999,0,9999,0
1657405861667,MATH 197,002,095566,Kedlaya; Kiran S.,9997,0,9999,2
1657405861667,MATH 197,003,095567,Xiao; Ming,9999,0,9999,0
1657405861667,MATH 197,004,095571,Perols; Johan Lars,9998,0,9999,1
1657405868723,COGS 9,A01,083615,Shannon; Kyle Michael,9,0,75,66
1657405874748,COGS 11,A01,083617,Boyle; Mary E. T.,22,0,48,26
1657405880788,COGS 13,A01,083071,Bastos; Amalia Pinkusfeld,11,0,71,60
1657405886814,COGS 14A,A01,092681,Semenuks; Arturs,4,1,100,96
1657405892837,COGS 14B,A01,083073,Cheng; Tzu-Han,6,0,63,57
1657405898863,COGS 17,A01,092677,Semenuks; Arturs,6,0,81,75
1657405904905,COGS 100,A01,083619,Allen; Michael Gordon,17,0,70,53
1657405910930,COGS 101A,A01,083621,Davis; Joshua Daniel,9,0,68,59
1657405916955,COGS 101B,A01,091572,Allen; Michael Gordon,12,0,65,53
1657405922978,COGS 101C,A01,083625,Delgado; Tania,17,0,35,18
1657405929002,COGS 107A,A01,083627,Boyle; Mary E. T.,13,0,60,47
1657405935030,COGS 118A,A01,083075,Gupta; Anjum,20,0,76,56
1657405941059,CSE 3,A50,083646,Miranda; Gregory Joseph,24,0,50,26
1657405947194,CSE 8A,A50,083650,Miranda; Gregory Joseph,17,1,56,39
1657405953221,CSE 11,A01,083080,Cao; Yingjun,6,15,40,34
1657405959250,CSE 12,A01,083652,Krause-Levy; Sophia Louisa,28,1,120,92
1657405965316,CSE 15L,A01,083654,Morris; Justin Loren,9,0,50,41
1657405965316,CSE 15L,A02,083655,Morris; Justin Loren,9,0,50,41
1657405971343,CSE 20,A01,083657,Tran; Khoa Dang,39,0,80,41
1657405977367,CSE 21,A01,095574,Bach; Quang Tran,22,0,48,26
1657405983396,CSE 30,A01,083084,Eldon; John,4,0,80,76
1657405983396,CSE 30,B01,095061,Bhaskar; Nishant,9,0,50,41
1657405989423,CSE 100,A01,083659,Cao; Yingjun,5,4,70,65
1657405995453,CSE 134B,A01,083661,Powell; Thomas Allan,22,0,100,78
1657406001479,CSE 140,A01,083663,Gungor; Onat,14,0,85,71
1657406007505,CSE 140L,A01,083088,Eldon; John,21,0,100,79
1657406013528,CSE 175,A01,083665,Kumar; Rakesh,3,0,25,22
1657406019565,CSE 190,A00,092507,Dubnov; Shlomo,7,0,20,13
1657406025587,ECE 45,A01,083139,Congero; Spencer William,6,0,75,69
1657406031612,ECE 65,A50,083695,Saad; Andrew S,12,0,30,18
1657406031612,ECE 65,A51,095125,Saad; Andrew S,24,0,26,2
1657406037637,ECE 109,A01,091882,Touri; Behrouz,19,0,70,51
1657406043671,ECE 180,A00,083140,Abi Samra; Nicholas Camill,1,0,30,29
1657406043671,ECE 180,B00,083141,Abi Samra; Nicholas Camill,0,0,30,30
1657406049708,MATH 10A,A01,083735,Patchell; Gregory David,2,0,30,28
1657406049708,MATH 10A,A02,083736,Patchell; Gregory David,20,0,30,10
1657406049708,MATH 10A,A03,083737,Patchell; Gregory David,16,0,30,14
1657406055737,MATH 10B,A01,083207,Lim; Seonhee,8,0,34,26
1657406055737,MATH 10B,A02,083208,Lim; Seonhee,9,0,35,26
1657406055737,MATH 10B,A03,093472,Lim; Seonhee,7,0,34,27
1657406055737,MATH 10B,B01,083739,Sinha; Shubham,12,0,30,18
1657406061788,MATH 18,A01,083743,Cinel; Cameron Alexander,7,0,30,23
1657406061788,MATH 18,A02,083744,Cinel; Cameron Alexander,17,0,30,13
1657406061788,MATH 18,A03,083745,Cinel; Cameron Alexander,9,0,30,21
1657406061788,MATH 18,B01,083748,Rideout; David Porter,5,0,37,32
1657406061788,MATH 18,B02,083749,Rideout; David Porter,5,0,36,31
1657406061788,MATH 18,B03,083750,Rideout; David Porter,3,0,37,34
1657406061788,MATH 18,B04,083751,Rideout; David Porter,6,0,36,30
1657406061788,MATH 18,B05,093473,Rideout; David Porter,6,0,36,30
1657406061788,MATH 18,B06,093474,Rideout; David Porter,6,0,36,30
1657406067813,MATH 20A,A01,083754,Zheng; Zequn,14,0,40,26
1657406073839,MATH 20B,A01,083756,Briones; Jor-el Thomas Caparas,4,0,36,32
1657406073839,MATH 20B,A02,083757,Briones; Jor-el Thomas Caparas,1,0,36,35
1657406073839,MATH 20B,A03,093475,Briones; Jor-el Thomas Caparas,2,0,36,34
1657406079868,MATH 20C,A01,083760,Briones; Jor-el Thomas Caparas,1,0,35,34
1657406079868,MATH 20C,A02,083761,Briones; Jor-el Thomas Caparas,8,0,35,27
1657406079868,MATH 20C,A03,093476,Briones; Jor-el Thomas Caparas,0,1,36,36
1657406079868,MATH 20C,B01,083762,Bach; Quang Tran,1,0,30,29
1657406085896,MATH 20D,A01,083765,Tran; Brian Kha,5,0,30,25
1657406085896,MATH 20D,A02,083766,Tran; Brian Kha,5,0,30,25
1657406085896,MATH 20D,A03,083767,Tran; Brian Kha,5,0,30,25
1657406091925,MATH 20E,A01,083771,Ganguly; Soumya,9,0,32,23
1657406091925,MATH 20E,A02,083772,Ganguly; Soumya,6,0,32,26
1657406091925,MATH 20E,B01,083773,Ciotti; Benjamin,20,0,35,15
1657406091925,MATH 20E,B02,083774,Ciotti; Benjamin,17,0,35,18
1657406097953,MATH 103A,A01,083777,Greenfeld; Be'Eri,3,0,36,33
1657406097953,MATH 103A,A02,083778,Greenfeld; Be'Eri,5,0,36,31
1657406097953,MATH 103A,A03,093561,Greenfeld; Be'Eri,5,0,36,31
1657406097953,MATH 103A,B01,083779,Greenfeld; Be'Eri,7,0,36,29
1657406097953,MATH 103A,B02,083780,Greenfeld; Be'Eri,4,0,36,32
1657406097953,MATH 103A,B03,093562,Greenfeld; Be'Eri,3,0,36,33
1657406103978,MATH 105,A01,085443,Carter; Anne Toulson,15,0,35,20
1657406103978,MATH 105,A02,093477,Carter; Anne Toulson,20,0,35,15
1657406110003,MATH 109,A01,083213,Ganzberger; Geoffrey Michael,2,0,34,32
1657406110003,MATH 109,A02,083214,Ganzberger; Geoffrey Michael,4,0,34,30
1657406110003,MATH 109,A03,093478,Ganzberger; Geoffrey Michael,2,0,34,32
1657406110003,MATH 109,B01,083215,Ganzberger; Geoffrey Michael,1,0,32,31
1657406110003,MATH 109,B02,083216,Ganzberger; Geoffrey Michael,2,0,32,30
1657406110003,MATH 109,B03,093479,Ganzberger; Geoffrey Michael,8,0,32,24
1657406116027,MATH 142A,A01,083219,Chow; Bennett,7,0,32,25
1657406116027,MATH 142A,A02,083220,Chow; Bennett,10,0,32,22
1657406116027,MATH 142A,A03,093480,Chow; Bennett,8,0,32,24
1657406116027,MATH 142A,B03,093481,Chow; Bennett,8,0,32,24
1657406116027,MATH 142A,B04,093558,Chow; Bennett,13,0,32,19
1657406116027,MATH 142A,B05,093559,Chow; Bennett,6,0,32,26
1657406122052,MATH 193A,A01,083224,Rotar; Vladimir,8,0,34,26
1657406122052,MATH 193A,A02,083225,Rotar; Vladimir,9,0,34,25
1657406122052,MATH 193A,A03,083781,Rotar; Vladimir,5,0,34,29
1657406122052,MATH 193A,A04,083782,Rotar; Vladimir,10,0,34,24
1657406122052,MATH 193A,A05,093482,Rotar; Vladimir,10,0,34,24
1657406128075,MATH 197,001,091859,McAuley; Julian John,9999,0,9999,0
1657406128075,MATH 197,002,095566,Kedlaya; Kiran S.,9997,0,9999,2
1657406128075,MATH 197,003,095567,Xiao; Ming,9999,0,9999,0
1657406128075,MATH 197,004,095571,Perols; Johan Lars,9998,0,9999,1
1657406147709,COGS 9,A01,083615,Shannon; Kyle Michael,9,0,75,66
1657406153732,COGS 11,A01,083617,Boyle; Mary E. T.,22,0,48,26
1657406159756,COGS 13,A01,083071,Bastos; Amalia Pinkusfeld,11,0,71,60
1657406165780,COGS 14A,A01,092681,Semenuks; Arturs,4,1,100,96
1657406171816,COGS 14B,A01,083073,Cheng; Tzu-Han,6,0,63,57
1657406177839,COGS 17,A01,092677,Semenuks; Arturs,6,0,81,75
1657406183890,COGS 100,A01,083619,Allen; Michael Gordon,17,0,70,53
1657406189913,COGS 101A,A01,083621,Davis; Joshua Daniel,9,0,68,59
1657406195936,COGS 101B,A01,091572,Allen; Michael Gordon,12,0,65,53
1657406201959,COGS 101C,A01,083625,Delgado; Tania,17,0,35,18
1657406207983,COGS 107A,A01,083627,Boyle; Mary E. T.,13,0,60,47
1657406214015,COGS 118A,A01,083075,Gupta; Anjum,20,0,76,56
1657406220044,CSE 3,A50,083646,Miranda; Gregory Joseph,24,0,50,26
1657406226068,CSE 8A,A50,083650,Miranda; Gregory Joseph,17,1,56,39
1657406232092,CSE 11,A01,083080,Cao; Yingjun,6,15,40,34
1657406238121,CSE 12,A01,083652,Krause-Levy; Sophia Louisa,28,1,120,92
1657406244148,CSE 15L,A01,083654,Morris; Justin Loren,9,0,50,41
1657406244148,CSE 15L,A02,083655,Morris; Justin Loren,9,0,50,41
1657406250177,CSE 20,A01,083657,Tran; Khoa Dang,39,0,80,41
1657406256201,CSE 21,A01,095574,Bach; Quang Tran,22,0,48,26
1657406262230,CSE 30,A01,083084,Eldon; John,4,0,80,76
1657406262230,CSE 30,B01,095061,Bhaskar; Nishant,9,0,50,41
1657406268255,CSE 100,A01,083659,Cao; Yingjun,5,4,70,65
1657406274289,CSE 134B,A01,083661,Powell; Thomas Allan,22,0,100,78
1657406280312,CSE 140,A01,083663,Gungor; Onat,14,0,85,71
1657406286335,CSE 140L,A01,083088,Eldon; John,21,0,100,79
1657406292366,CSE 175,A01,083665,Kumar; Rakesh,3,0,25,22
1657406298396,CSE 190,A00,092507,Dubnov; Shlomo,7,0,20,13
1657406304420,ECE 45,A01,083139,Congero; Spencer William,6,0,75,69
1657406310451,ECE 65,A50,083695,Saad; Andrew S,12,0,30,18
1657406310451,ECE 65,A51,095125,Saad; Andrew S,24,0,26,2
1657406316498,ECE 109,A01,091882,Touri; Behrouz,19,0,70,51
1657406322522,ECE 180,A00,083140,Abi Samra; Nicholas Camill,1,0,30,29
1657406322522,ECE 180,B00,083141,Abi Samra; Nicholas Camill,0,0,30,30
1657406328551,MATH 10A,A01,083735,Patchell; Gregory David,2,0,30,28
1657406328551,MATH 10A,A02,083736,Patchell; Gregory David,20,0,30,10
1657406328551,MATH 10A,A03,083737,Patchell; Gregory David,16,0,30,14
1657406334580,MATH 10B,A01,083207,Lim; Seonhee,8,0,34,26
1657406334580,MATH 10B,A02,083208,Lim; Seonhee,9,0,35,26
1657406334580,MATH 10B,A03,093472,Lim; Seonhee,7,0,34,27
1657406334580,MATH 10B,B01,083739,Sinha; Shubham,12,0,30,18
1657406340612,MATH 18,A01,083743,Cinel; Cameron Alexander,7,0,30,23
1657406340612,MATH 18,A02,083744,Cinel; Cameron Alexander,17,0,30,13
1657406340612,MATH 18,A03,083745,Cinel; Cameron Alexander,9,0,30,21
1657406340612,MATH 18,B01,083748,Rideout; David Porter,5,0,37,32
1657406340612,MATH 18,B02,083749,Rideout; David Porter,5,0,36,31
1657406340612,MATH 18,B03,083750,Rideout; David Porter,3,0,37,34
1657406340612,MATH 18,B04,083751,Rideout; David Porter,6,0,36,30
1657406340612,MATH 18,B05,093473,Rideout; David Porter,6,0,36,30
1657406340612,MATH 18,B06,093474,Rideout; David Porter,6,0,36,30
1657406346645,MATH 20A,A01,083754,Zheng; Zequn,14,0,40,26
1657406352685,MATH 20B,A01,083756,Briones; Jor-el Thomas Caparas,4,0,36,32
1657406352685,MATH 20B,A02,083757,Briones; Jor-el Thomas Caparas,1,0,36,35
1657406352685,MATH 20B,A03,093475,Briones; Jor-el Thomas Caparas,2,0,36,34
1657406358707,MATH 20C,A01,083760,Briones; Jor-el Thomas Caparas,1,0,35,34
1657406358707,MATH 20C,A02,083761,Briones; Jor-el Thomas Caparas,8,0,35,27
1657406358707,MATH 20C,A03,093476,Briones; Jor-el Thomas Caparas,0,1,36,36
1657406358707,MATH 20C,B01,083762,Bach; Quang Tran,1,0,30,29
1657406364739,MATH 20D,A01,083765,Tran; Brian Kha,5,0,30,25
1657406364739,MATH 20D,A02,083766,Tran; Brian Kha,5,0,30,25
1657406364739,MATH 20D,A03,083767,Tran; Brian Kha,5,0,30,25
1657406370764,MATH 20E,A01,083771,Ganguly; Soumya,9,0,32,23
1657406370764,MATH 20E,A02,083772,Ganguly; Soumya,6,0,32,26
1657406370764,MATH 20E,B01,083773,Ciotti; Benjamin,20,0,35,15
1657406370764,MATH 20E,B02,083774,Ciotti; Benjamin,17,0,35,18
1657406376804,MATH 103A,A01,083777,Greenfeld; Be'Eri,3,0,36,33
1657406376804,MATH 103A,A02,083778,Greenfeld; Be'Eri,5,0,36,31
1657406376804,MATH 103A,A03,093561,Greenfeld; Be'Eri,5,0,36,31
1657406376804,MATH 103A,B01,083779,Greenfeld; Be'Eri,7,0,36,29
1657406376804,MATH 103A,B02,083780,Greenfeld; Be'Eri,4,0,36,32
1657406376804,MATH 103A,B03,093562,Greenfeld; Be'Eri,3,0,36,33
1657406382826,MATH 105,A01,085443,Carter; Anne Toulson,15,0,35,20
1657406382826,MATH 105,A02,093477,Carter; Anne Toulson,20,0,35,15
1657406388850,MATH 109,A01,083213,Ganzberger; Geoffrey Michael,2,0,34,32
1657406388850,MATH 109,A02,083214,Ganzberger; Geoffrey Michael,4,0,34,30
1657406388850,MATH 109,A03,093478,Ganzberger; Geoffrey Michael,2,0,34,32
1657406388850,MATH 109,B01,083215,Ganzberger; Geoffrey Michael,1,0,32,31
1657406388850,MATH 109,B02,083216,Ganzberger; Geoffrey Michael,2,0,32,30
1657406388850,MATH 109,B03,093479,Ganzberger; Geoffrey Michael,8,0,32,24
1657406394885,MATH 142A,A01,083219,Chow; Bennett,7,0,32,25
1657406394885,MATH 142A,A02,083220,Chow; Bennett,10,0,32,22
1657406394885,MATH 142A,A03,093480,Chow; Bennett,8,0,32,24
1657406394885,MATH 142A,B03,093481,Chow; Bennett,8,0,32,24
1657406394885,MATH 142A,B04,093558,Chow; Bennett,13,0,32,19
1657406394885,MATH 142A,B05,093559,Chow; Bennett,6,0,32,26
1657406400906,MATH 193A,A01,083224,Rotar; Vladimir,8,0,34,26
1657406400906,MATH 193A,A02,083225,Rotar; Vladimir,9,0,34,25
1657406400906,MATH 193A,A03,083781,Rotar; Vladimir,5,0,34,29
1657406400906,MATH 193A,A04,083782,Rotar; Vladimir,10,0,34,24
1657406400906,MATH 193A,A05,093482,Rotar; Vladimir,10,0,34,24
1657406406928,MATH 197,001,091859,McAuley; Julian John,9999,0,9999,0
1657406406928,MATH 197,002,095566,Kedlaya; Kiran S.,9997,0,9999,2
1657406406928,MATH 197,003,095567,Xiao; Ming,9999,0,9999,0
1657406406928,MATH 197,004,095571,Perols; Johan Lars,9998,0,9999,1
1657406413984,COGS 9,A01,083615,Shannon; Kyle Michael,9,0,75,66
1657406420021,COGS 11,A01,083617,Boyle; Mary E. T.,22,0,48,26
1657406426047,COGS 13,A01,083071,Bastos; Amalia Pinkusfeld,11,0,71,60
1657406432075,COGS 14A,A01,092681,Semenuks; Arturs,4,1,100,96
1657406438109,COGS 14B,A01,083073,Cheng; Tzu-Han,6,0,63,57
1657406444146,COGS 17,A01,092677,Semenuks; Arturs,6,0,81,75
1657406450174,COGS 100,A01,083619,Allen; Michael Gordon,17,0,70,53
1657406456203,COGS 101A,A01,083621,Davis; Joshua Daniel,9,0,68,59
1657406462231,COGS 101B,A01,091572,Allen; Michael Gordon,12,0,65,53
1657406468258,COGS 101C,A01,083625,Delgado; Tania,17,0,35,18
1657406474280,COGS 107A,A01,083627,Boyle; Mary E. T.,13,0,60,47
1657406480315,COGS 118A,A01,083075,Gupta; Anjum,20,0,76,56
1657406486340,CSE 3,A50,083646,Miranda; Gregory Joseph,24,0,50,26
1657406492364,CSE 8A,A50,083650,Miranda; Gregory Joseph,17,1,56,39
1657406498387,CSE 11,A01,083080,Cao; Yingjun,6,15,40,34
1657406504410,CSE 12,A01,083652,Krause-Levy; Sophia Louisa,28,1,120,92
1657406510433,CSE 15L,A01,083654,Morris; Justin Loren,9,0,50,41
1657406510433,CSE 15L,A02,083655,Morris; Justin Loren,9,0,50,41
1657406516459,CSE 20,A01,083657,Tran; Khoa Dang,39,0,80,41
1657406522512,CSE 21,A01,095574,Bach; Quang Tran,22,0,48,26
1657406528538,CSE 30,A01,083084,Eldon; John,4,0,80,76
1657406528538,CSE 30,B01,095061,Bhaskar; Nishant,9,0,50,41
1657406534561,CSE 100,A01,083659,Cao; Yingjun,5,4,70,65
1657406540583,CSE 134B,A01,083661,Powell; Thomas Allan,22,0,100,78
1657406546609,CSE 140,A01,083663,Gungor; Onat,14,0,85,71
1657406552645,CSE 140L,A01,083088,Eldon; John,21,0,100,79
1657406558790,CSE 175,A01,083665,Kumar; Rakesh,3,0,25,22
1657406564820,CSE 190,A00,092507,Dubnov; Shlomo,7,0,20,13
1657406570842,ECE 45,A01,083139,Congero; Spencer William,6,0,75,69
1657406576893,ECE 65,A50,083695,Saad; Andrew S,12,0,30,18
1657406576893,ECE 65,A51,095125,Saad; Andrew S,24,0,26,2
1657406582919,ECE 109,A01,091882,Touri; Behrouz,19,0,70,51
1657406588946,ECE 180,A00,083140,Abi Samra; Nicholas Camill,1,0,30,29
1657406588946,ECE 180,B00,083141,Abi Samra; Nicholas Camill,0,0,30,30
1657406594976,MATH 10A,A01,083735,Patchell; Gregory David,2,0,30,28
1657406594976,MATH 10A,A02,083736,Patchell; Gregory David,20,0,30,10
1657406594976,MATH 10A,A03,083737,Patchell; Gregory David,16,0,30,14
1657406601005,MATH 10B,A01,083207,Lim; Seonhee,8,0,34,26
1657406601005,MATH 10B,A02,083208,Lim; Seonhee,9,0,35,26
1657406601005,MATH 10B,A03,093472,Lim; Seonhee,7,0,34,27
1657406601005,MATH 10B,B01,083739,Sinha; Shubham,12,0,30,18
1657406607039,MATH 18,A01,083743,Cinel; Cameron Alexander,7,0,30,23
1657406607039,MATH 18,A02,083744,Cinel; Cameron Alexander,17,0,30,13
1657406607039,MATH 18,A03,083745,Cinel; Cameron Alexander,9,0,30,21
1657406607039,MATH 18,B01,083748,Rideout; David Porter,5,0,37,32
1657406607039,MATH 18,B02,083749,Rideout; David Porter,5,0,36,31
1657406607039,MATH 18,B03,083750,Rideout; David Porter,3,0,37,34
1657406607039,MATH 18,B04,083751,Rideout; David Porter,6,0,36,30
1657406607039,MATH 18,B05,093473,Rideout; David Porter,6,0,36,30
1657406607039,MATH 18,B06,093474,Rideout; David Porter,6,0,36,30
1657406613061,MATH 20A,A01,083754,Zheng; Zequn,14,0,40,26
1657406619090,MATH 20B,A01,083756,Briones; Jor-el Thomas Caparas,4,0,36,32
1657406619090,MATH 20B,A02,083757,Briones; Jor-el Thomas Caparas,1,0,36,35
1657406619090,MATH 20B,A03,093475,Briones; Jor-el Thomas Caparas,2,0,36,34
1657406625114,MATH 20C,A01,083760,Briones; Jor-el Thomas Caparas,1,0,35,34
1657406625114,MATH 20C,A02,083761,Briones; Jor-el Thomas Caparas,8,0,35,27
1657406625114,MATH 20C,A03,093476,Briones; Jor-el Thomas Caparas,0,1,36,36
1657406625114,MATH 20C,B01,083762,Bach; Quang Tran,1,0,30,29
1657406631167,MATH 20D,A01,083765,Tran; Brian Kha,5,0,30,25
1657406631167,MATH 20D,A02,083766,Tran; Brian Kha,5,0,30,25
1657406631167,MATH 20D,A03,083767,Tran; Brian Kha,5,0,30,25
1657406637191,MATH 20E,A01,083771,Ganguly; Soumya,9,0,32,23
1657406637191,MATH 20E,A02,083772,Ganguly; Soumya,6,0,32,26
1657406637191,MATH 20E,B01,083773,Ciotti; Benjamin,20,0,35,15
1657406637191,MATH 20E,B02,083774,Ciotti; Benjamin,17,0,35,18
1657406643221,MATH 103A,A01,083777,Greenfeld; Be'Eri,3,0,36,33
1657406643221,MATH 103A,A02,083778,Greenfeld; Be'Eri,5,0,36,31
1657406643221,MATH 103A,A03,093561,Greenfeld; Be'Eri,5,0,36,31
1657406643221,MATH 103A,B01,083779,Greenfeld; Be'Eri,7,0,36,29
1657406643221,MATH 103A,B02,083780,Greenfeld; Be'Eri,4,0,36,32
1657406643221,MATH 103A,B03,093562,Greenfeld; Be'Eri,3,0,36,33
1657406649244,MATH 105,A01,085443,Carter; Anne Toulson,15,0,35,20
1657406649244,MATH 105,A02,093477,Carter; Anne Toulson,20,0,35,15
1657406655267,MATH 109,A01,083213,Ganzberger; Geoffrey Michael,2,0,34,32
1657406655267,MATH 109,A02,083214,Ganzberger; Geoffrey Michael,4,0,34,30
1657406655267,MATH 109,A03,093478,Ganzberger; Geoffrey Michael,2,0,34,32
1657406655267,MATH 109,B01,083215,Ganzberger; Geoffrey Michael,1,0,32,31
1657406655267,MATH 109,B02,083216,Ganzberger; Geoffrey Michael,2,0,32,30
1657406655267,MATH 109,B03,093479,Ganzberger; Geoffrey Michael,8,0,32,24
1657406661290,MATH 142A,A01,083219,Chow; Bennett,7,0,32,25
1657406661290,MATH 142A,A02,083220,Chow; Bennett,10,0,32,22
1657406661290,MATH 142A,A03,093480,Chow; Bennett,8,0,32,24
1657406661290,MATH 142A,B03,093481,Chow; Bennett,8,0,32,24
1657406661290,MATH 142A,B04,093558,Chow; Bennett,13,0,32,19
1657406661290,MATH 142A,B05,093559,Chow; Bennett,6,0,32,26
1657406667317,MATH 193A,A01,083224,Rotar; Vladimir,8,0,34,26
1657406667317,MATH 193A,A02,083225,Rotar; Vladimir,9,0,34,25
1657406667317,MATH 193A,A03,083781,Rotar; Vladimir,5,0,34,29
1657406667317,MATH 193A,A04,083782,Rotar; Vladimir,10,0,34,24
1657406667317,MATH 193A,A05,093482,Rotar; Vladimir,10,0,34,24
1657406673341,MATH 197,001,091859,McAuley; Julian John,9999,0,9999,0
1657406673341,MATH 197,002,095566,Kedlaya; Kiran S.,9997,0,9999,2
1657406673341,MATH 197,003,095567,Xiao; Ming,9999,0,9999,0
1657406673341,MATH 197,004,095571,Perols; Johan Lars,9998,0,9999,1
1657406680406,COGS 9,A01,083615,Shannon; Kyle Michael,9,0,75,66
1657406686429,COGS 11,A01,083617,Boyle; Mary E. T.,22,0,48,26
1657406692451,COGS 13,A01,083071,Bastos; Amalia Pinkusfeld,11,0,71,60
1657406698477,COGS 14A,A01,092681,Semenuks; Arturs,4,1,100,96
1657406704504,COGS 14B,A01,083073,Cheng; Tzu-Han,6,0,63,57
1657406710527,COGS 17,A01,092677,Semenuks; Arturs,6,0,81,75
1657406716549,COGS 100,A01,083619,Allen; Michael Gordon,17,0,70,53
1657406722571,COGS 101A,A01,083621,Davis; Joshua Daniel,9,0,68,59
1657406728596,COGS 101B,A01,091572,Allen; Michael Gordon,12,0,65,53
1657406734619,COGS 101C,A01,083625,Delgado; Tania,17,0,35,18
1657406740645,COGS 107A,A01,083627,Boyle; Mary E. T.,13,0,60,47
1657406746668,COGS 118A,A01,083075,Gupta; Anjum,20,0,76,56
1657406752691,CSE 3,A50,083646,Miranda; Gregory Joseph,24,0,50,26
1657406758713,CSE 8A,A50,083650,Miranda; Gregory Joseph,17,1,56,39
1657406764739,CSE 11,A01,083080,Cao; Yingjun,6,15,40,34
1657406770761,CSE 12,A01,083652,Krause-Levy; Sophia Louisa,28,1,120,92
1657406776787,CSE 15L,A01,083654,Morris; Justin Loren,9,0,50,41
1657406776787,CSE 15L,A02,083655,Morris; Justin Loren,9,0,50,41
1657406782816,CSE 20,A01,083657,Tran; Khoa Dang,39,0,80,41
1657406788840,CSE 21,A01,095574,Bach; Quang Tran,22,0,48,26
1657406794886,CSE 30,A01,083084,Eldon; John,4,0,80,76
1657406794886,CSE 30,B01,095061,Bhaskar; Nishant,9,0,50,41
1657406800918,CSE 100,A01,083659,Cao; Yingjun,5,4,70,65
1657406806945,CSE 134B,A01,083661,Powell; Thomas Allan,22,0,100,78
1657406812966,CSE 140,A01,083663,Gungor; Onat,14,0,85,71
1657406818990,CSE 140L,A01,083088,Eldon; John,21,0,100,79
1657406825016,CSE 175,A01,083665,Kumar; Rakesh,3,0,25,22
1657406831038,CSE 190,A00,092507,Dubnov; Shlomo,7,0,20,13
1657406837067,ECE 45,A01,083139,Congero; Spencer William,6,0,75,69
1657406843113,ECE 65,A50,083695,Saad; Andrew S,12,0,30,18
1657406843113,ECE 65,A51,095125,Saad; Andrew S,24,0,26,2
1657406849148,ECE 109,A01,091882,Touri; Behrouz,19,0,70,51
1657406855188,ECE 180,A00,083140,Abi Samra; Nicholas Camill,1,0,30,29
1657406855188,ECE 180,B00,083141,Abi Samra; Nicholas Camill,0,0,30,30
1657406861212,MATH 10A,A01,083735,Patchell; Gregory David,2,0,30,28
1657406861212,MATH 10A,A02,083736,Patchell; Gregory David,20,0,30,10
1657406861212,MATH 10A,A03,083737,Patchell; Gregory David,16,0,30,14
1657406867235,MATH 10B,A01,083207,Lim; Seonhee,8,0,34,26
1657406867235,MATH 10B,A02,083208,Lim; Seonhee,9,0,35,26
1657406867235,MATH 10B,A03,093472,Lim; Seonhee,7,0,34,27
1657406867235,MATH 10B,B01,083739,Sinha; Shubham,12,0,30,18
1657406873260,MATH 18,A01,083743,Cinel; Cameron Alexander,7,0,30,23
1657406873260,MATH 18,A02,083744,Cinel; Cameron Alexander,17,0,30,13
1657406873260,MATH 18,A03,083745,Cinel; Cameron Alexander,9,0,30,21
1657406873260,MATH 18,B01,083748,Rideout; David Porter,5,0,37,32
1657406873260,MATH 18,B02,083749,Rideout; David Porter,5,0,36,31
1657406873260,MATH 18,B03,083750,Rideout; David Porter,3,0,37,34
1657406873260,MATH 18,B04,083751,Rideout; David Porter,6,0,36,30
1657406873260,MATH 18,B05,093473,Rideout; David Porter,6,0,36,30
1657406873260,MATH 18,B06,093474,Rideout; David Porter,6,0,36,30
1657406879283,MATH 20A,A01,083754,Zheng; Zequn,14,0,40,26
1657406885324,MATH 20B,A01,083756,Briones; Jor-el Thomas Caparas,4,0,36,32
1657406885324,MATH 20B,A02,083757,Briones; Jor-el Thomas Caparas,1,0,36,35
1657406885324,MATH 20B,A03,093475,Briones; Jor-el Thomas Caparas,2,0,36,34
1657406891355,MATH 20C,A01,083760,Briones; Jor-el Thomas Caparas,1,0,35,34
1657406891355,MATH 20C,A02,083761,Briones; Jor-el Thomas Caparas,8,0,35,27
1657406891355,MATH 20C,A03,093476,Briones; Jor-el Thomas Caparas,0,1,36,36
1657406891355,MATH 20C,B01,083762,Bach; Quang Tran,1,0,30,29
1657406897390,MATH 20D,A01,083765,Tran; Brian Kha,5,0,30,25
1657406897390,MATH 20D,A02,083766,Tran; Brian Kha,5,0,30,25
1657406897390,MATH 20D,A03,083767,Tran; Brian Kha,5,0,30,25
1657406903413,MATH 20E,A01,083771,Ganguly; Soumya,9,0,32,23
1657406903413,MATH 20E,A02,083772,Ganguly; Soumya,6,0,32,26
1657406903413,MATH 20E,B01,083773,Ciotti; Benjamin,20,0,35,15
1657406903413,MATH 20E,B02,083774,Ciotti; Benjamin,17,0,35,18
1657406909436,MATH 103A,A01,083777,Greenfeld; Be'Eri,3,0,36,33
1657406909436,MATH 103A,A02,083778,Greenfeld; Be'Eri,5,0,36,31
1657406909436,MATH 103A,A03,093561,Greenfeld; Be'Eri,5,0,36,31
1657406909436,MATH 103A,B01,083779,Greenfeld; Be'Eri,7,0,36,29
1657406909436,MATH 103A,B02,083780,Greenfeld; Be'Eri,4,0,36,32
1657406909436,MATH 103A,B03,093562,Greenfeld; Be'Eri,3,0,36,33
1657406915462,MATH 105,A01,085443,Carter; Anne Toulson,15,0,35,20
1657406915462,MATH 105,A02,093477,Carter; Anne Toulson,20,0,35,15
1657406921493,MATH 109,A01,083213,Ganzberger; Geoffrey Michael,2,0,34,32
1657406921493,MATH 109,A02,083214,Ganzberger; Geoffrey Michael,4,0,34,30
1657406921493,MATH 109,A03,093478,Ganzberger; Geoffrey Michael,2,0,34,32
1657406921493,MATH 109,B01,083215,Ganzberger; Geoffrey Michael,1,0,32,31
1657406921493,MATH 109,B02,083216,Ganzberger; Geoffrey Michael,2,0,32,30
1657406921493,MATH 109,B03,093479,Ganzberger; Geoffrey Michael,8,0,32,24
1657406927545,MATH 142A,A01,083219,Chow; Bennett,7,0,32,25
1657406927545,MATH 142A,A02,083220,Chow; Bennett,10,0,32,22
1657406927545,MATH 142A,A03,093480,Chow; Bennett,8,0,32,24
1657406927545,MATH 142A,B03,093481,Chow; Bennett,8,0,32,24
1657406927545,MATH 142A,B04,093558,Chow; Bennett,13,0,32,19
1657406927545,MATH 142A,B05,093559,Chow; Bennett,6,0,32,26
1657406933572,MATH 193A,A01,083224,Rotar; Vladimir,8,0,34,26
1657406933572,MATH 193A,A02,083225,Rotar; Vladimir,9,0,34,25
1657406933572,MATH 193A,A03,083781,Rotar; Vladimir,5,0,34,29
1657406933572,MATH 193A,A04,083782,Rotar; Vladimir,10,0,34,24
1657406933572,MATH 193A,A05,093482,Rotar; Vladimir,10,0,34,24
1657406939596,MATH 197,001,091859,McAuley; Julian John,9999,0,9999,0
1657406939596,MATH 197,002,095566,Kedlaya; Kiran S.,9997,0,9999,2
1657406939596,MATH 197,003,095567,Xiao; Ming,9999,0,9999,0
1657406939596,MATH 197,004,095571,Perols; Johan Lars,9998,0,9999,1
1657406946651,COGS 9,A01,083615,Shannon; Kyle Michael,9,0,75,66
1657406952674,COGS 11,A01,083617,Boyle; Mary E. T.,22,0,48,26
1657406958696,COGS 13,A01,083071,Bastos; Amalia Pinkusfeld,11,0,71,60
1657406964718,COGS 14A,A01,092681,Semenuks; Arturs,4,1,100,96
1657406970744,COGS 14B,A01,083073,Cheng; Tzu-Han,6,0,63,57
1657406976765,COGS 17,A01,092677,Semenuks; Arturs,6,0,81,75
1657406982788,COGS 100,A01,083619,Allen; Michael Gordon,17,0,70,53
1657406988810,COGS 101A,A01,083621,Davis; Joshua Daniel,9,0,68,59
1657406994841,COGS 101B,A01,091572,Allen; Michael Gordon,12,0,65,53
1657407000868,COGS 101C,A01,083625,Delgado; Tania,17,0,35,18
1657407006890,COGS 107A,A01,083627,Boyle; Mary E. T.,13,0,60,47
1657407012912,COGS 118A,A01,083075,Gupta; Anjum,20,0,76,56
1657407018936,CSE 3,A50,083646,Miranda; Gregory Joseph,24,0,50,26
1657407024959,CSE 8A,A50,083650,Miranda; Gregory Joseph,17,1,56,39
1657407030982,CSE 11,A01,083080,Cao; Yingjun,6,15,40,34
1657407037015,CSE 12,A01,083652,Krause-Levy; Sophia Louisa,28,1,120,92
1657407043042,CSE 15L,A01,083654,Morris; Justin Loren,9,0,50,41
1657407043042,CSE 15L,A02,083655,Morris; Justin Loren,9,0,50,41
1657407049067,CSE 20,A01,083657,Tran; Khoa Dang,39,0,80,41
1657407055090,CSE 21,A01,095574,Bach; Quang Tran,22,0,48,26
1657407061114,CSE 30,A01,083084,Eldon; John,4,0,80,76
1657407061114,CSE 30,B01,095061,Bhaskar; Nishant,9,0,50,41
1657407067139,CSE 100,A01,083659,Cao; Yingjun,5,4,70,65
1657407073164,CSE 134B,A01,083661,Powell; Thomas Allan,22,0,100,78
1657407079190,CSE 140,A01,083663,Gungor; Onat,14,0,85,71
1657407085216,CSE 140L,A01,083088,Eldon; John,21,0,100,79
1657407091243,CSE 175,A01,083665,Kumar; Rakesh,3,0,25,22
1657407097271,CSE 190,A00,092507,Dubnov; Shlomo,7,0,20,13
1657407103294,ECE 45,A01,083139,Congero; Spencer William,6,0,75,69
1657407109317,ECE 65,A50,083695,Saad; Andrew S,12,0,30,18
1657407109317,ECE 65,A51,095125,Saad; Andrew S,24,0,26,2
1657407115342,ECE 109,A01,091882,Touri; Behrouz,19,0,70,51
1657407121367,ECE 180,A00,083140,Abi Samra; Nicholas Camill,1,0,30,29
1657407121367,ECE 180,B00,083141,Abi Samra; Nicholas Camill,0,0,30,30
1657407127391,MATH 10A,A01,083735,Patchell; Gregory David,2,0,30,28
1657407127391,MATH 10A,A02,083736,Patchell; Gregory David,20,0,30,10
1657407127391,MATH 10A,A03,083737,Patchell; Gregory David,16,0,30,14
1657407133416,MATH 10B,A01,083207,Lim; Seonhee,8,0,34,26
1657407133416,MATH 10B,A02,083208,Lim; Seonhee,9,0,35,26
1657407133416,MATH 10B,A03,093472,Lim; Seonhee,7,0,34,27
1657407133416,MATH 10B,B01,083739,Sinha; Shubham,12,0,30,18
1657407139449,MATH 18,A01,083743,Cinel; Cameron Alexander,7,0,30,23
1657407139449,MATH 18,A02,083744,Cinel; Cameron Alexander,17,0,30,13
1657407139449,MATH 18,A03,083745,Cinel; Cameron Alexander,9,0,30,21
1657407139449,MATH 18,B01,083748,Rideout; David Porter,5,0,37,32
1657407139449,MATH 18,B02,083749,Rideout; David Porter,5,0,36,31
1657407139449,MATH 18,B03,083750,Rideout; David Porter,3,0,37,34
1657407139449,MATH 18,B04,083751,Rideout; David Porter,6,0,36,30
1657407139449,MATH 18,B05,093473,Rideout; David Porter,6,0,36,30
1657407139449,MATH 18,B06,093474,Rideout; David Porter,6,0,36,30
1657407145473,MATH 20A,A01,083754,Zheng; Zequn,14,0,40,26
1657407151498,MATH 20B,A01,083756,Briones; Jor-el Thomas Caparas,4,0,36,32
1657407151498,MATH 20B,A02,083757,Briones; Jor-el Thomas Caparas,1,0,36,35
1657407151498,MATH 20B,A03,093475,Briones; Jor-el Thomas Caparas,2,0,36,34
1657407157624,MATH 20C,A01,083760,Briones; Jor-el Thomas Caparas,1,0,35,34
1657407157624,MATH 20C,A02,083761,Briones; Jor-el Thomas Caparas,8,0,35,27
1657407157624,MATH 20C,A03,093476,Briones; Jor-el Thomas Caparas,0,1,36,36
1657407157624,MATH 20C,B01,083762,Bach; Quang Tran,1,0,30,29
1657407163653,MATH 20D,A01,083765,Tran; Brian Kha,5,0,30,25
1657407163653,MATH 20D,A02,083766,Tran; Brian Kha,5,0,30,25
1657407163653,MATH 20D,A03,083767,Tran; Brian Kha,5,0,30,25
1657407169679,MATH 20E,A01,083771,Ganguly; Soumya,9,0,32,23
1657407169679,MATH 20E,A02,083772,Ganguly; Soumya,6,0,32,26
1657407169679,MATH 20E,B01,083773,Ciotti; Benjamin,20,0,35,15
1657407169679,MATH 20E,B02,083774,Ciotti; Benjamin,17,0,35,18
1657407175705,MATH 103A,A01,083777,Greenfeld; Be'Eri,3,0,36,33
1657407175705,MATH 103A,A02,083778,Greenfeld; Be'Eri,5,0,36,31
1657407175705,MATH 103A,A03,093561,Greenfeld; Be'Eri,5,0,36,31
1657407175705,MATH 103A,B01,083779,Greenfeld; Be'Eri,7,0,36,29
1657407175705,MATH 103A,B02,083780,Greenfeld; Be'Eri,4,0,36,32
1657407175705,MATH 103A,B03,093562,Greenfeld; Be'Eri,3,0,36,33
1657407181730,MATH 105,A01,085443,Carter; Anne Toulson,15,0,35,20
1657407181730,MATH 105,A02,093477,Carter; Anne Toulson,20,0,35,15
1657407187757,MATH 109,A01,083213,Ganzberger; Geoffrey Michael,2,0,34,32
1657407187757,MATH 109,A02,083214,Ganzberger; Geoffrey Michael,4,0,34,30
1657407187757,MATH 109,A03,093478,Ganzberger; Geoffrey Michael,2,0,34,32
1657407187757,MATH 109,B01,083215,Ganzberger; Geoffrey Michael,1,0,32,31
1657407187757,MATH 109,B02,083216,Ganzberger; Geoffrey Michael,2,0,32,30
1657407187757,MATH 109,B03,093479,Ganzberger; Geoffrey Michael,8,0,32,24
1657407193786,MATH 142A,A01,083219,Chow; Bennett,7,0,32,25
1657407193786,MATH 142A,A02,083220,Chow; Bennett,10,0,32,22
1657407193786,MATH 142A,A03,093480,Chow; Bennett,8,0,32,24
1657407193786,MATH 142A,B03,093481,Chow; Bennett,8,0,32,24
1657407193786,MATH 142A,B04,093558,Chow; Bennett,13,0,32,19
1657407193786,MATH 142A,B05,093559,Chow; Bennett,6,0,32,26
1657407199809,MATH 193A,A01,083224,Rotar; Vladimir,8,0,34,26
1657407199809,MATH 193A,A02,083225,Rotar; Vladimir,9,0,34,25
1657407199809,MATH 193A,A03,083781,Rotar; Vladimir,5,0,34,29
1657407199809,MATH 193A,A04,083782,Rotar; Vladimir,10,0,34,24
1657407199809,MATH 193A,A05,093482,Rotar; Vladimir,10,0,34,24
1657407205832,MATH 197,001,091859,McAuley; Julian John,9999,0,9999,0
1657407205832,MATH 197,002,095566,Kedlaya; Kiran S.,9997,0,9999,2
1657407205832,MATH 197,003,095567,Xiao; Ming,9999,0,9999,0
1657407205832,MATH 197,004,095571,Perols; Johan Lars,9998,0,9999,1
1657407212894,COGS 9,A01,083615,Shannon; Kyle Michael,9,0,75,66
1657407218916,COGS 11,A01,083617,Boyle; Mary E. T.,22,0,48,26
1657407224943,COGS 13,A01,083071,Bastos; Amalia Pinkusfeld,11,0,71,60
1657407230968,COGS 14A,A01,092681,Semenuks; Arturs,4,1,100,96
1657407236990,COGS 14B,A01,083073,Cheng; Tzu-Han,6,0,63,57
1657407243012,COGS 17,A01,092677,Semenuks; Arturs,6,0,81,75
1657407249035,COGS 100,A01,083619,Allen; Michael Gordon,17,0,70,53
1657407255060,COGS 101A,A01,083621,Davis; Joshua Daniel,9,0,68,59
1657407261085,COGS 101B,A01,091572,Allen; Michael Gordon,12,0,65,53
1657407267108,COGS 101C,A01,083625,Delgado; Tania,17,0,35,18
1657407273135,COGS 107A,A01,083627,Boyle; Mary E. T.,13,0,60,47
1657407279163,COGS 118A,A01,083075,Gupta; Anjum,20,0,76,56
1657407285193,CSE 3,A50,083646,Miranda; Gregory Joseph,24,0,50,26
1657407291220,CSE 8A,A50,083650,Miranda; Gregory Joseph,17,1,56,39
1657407297243,CSE 11,A01,083080,Cao; Yingjun,6,15,40,34
1657407303270,CSE 12,A01,083652,Krause-Levy; Sophia Louisa,28,1,120,92
1657407309297,CSE 15L,A01,083654,Morris; Justin Loren,9,0,50,41
1657407309297,CSE 15L,A02,083655,Morris; Justin Loren,9,0,50,41
1657407315322,CSE 20,A01,083657,Tran; Khoa Dang,39,0,80,41
1657407321346,CSE 21,A01,095574,Bach; Quang Tran,22,0,48,26
1657407327371,CSE 30,A01,083084,Eldon; John,4,0,80,76
1657407327371,CSE 30,B01,095061,Bhaskar; Nishant,9,0,50,41
1657407333399,CSE 100,A01,083659,Cao; Yingjun,5,4,70,65
1657407339422,CSE 134B,A01,083661,Powell; Thomas Allan,22,0,100,78
1657407345442,CSE 140,A01,083663,Gungor; Onat,14,0,85,71
1657407351466,CSE 140L,A01,083088,Eldon; John,21,0,100,79
1657407357492,CSE 175,A01,083665,Kumar; Rakesh,3,0,25,22
1657407363517,CSE 190,A00,092507,Dubnov; Shlomo,7,0,20,13
1657407369544,ECE 45,A01,083139,Congero; Spencer William,6,0,75,69
1657407375569,ECE 65,A50,083695,Saad; Andrew S,12,0,30,18
1657407375569,ECE 65,A51,095125,Saad; Andrew S,24,0,26,2
1657407381591,ECE 109,A01,091882,Touri; Behrouz,19,0,70,51
1657407387614,ECE 180,A00,083140,Abi Samra; Nicholas Camill,1,0,30,29
1657407387614,ECE 180,B00,083141,Abi Samra; Nicholas Camill,0,0,30,30
1657407393641,MATH 10A,A01,083735,Patchell; Gregory David,2,0,30,28
1657407393641,MATH 10A,A02,083736,Patchell; Gregory David,20,0,30,10
1657407393641,MATH 10A,A03,083737,Patchell; Gregory David,16,0,30,14
1657407399669,MATH 10B,A01,083207,Lim; Seonhee,8,0,34,26
1657407399669,MATH 10B,A02,083208,Lim; Seonhee,9,0,35,26
1657407399669,MATH 10B,A03,093472,Lim; Seonhee,7,0,34,27
1657407399669,MATH 10B,B01,083739,Sinha; Shubham,12,0,30,18
1657407405693,MATH 18,A01,083743,Cinel; Cameron Alexander,7,0,30,23
1657407405693,MATH 18,A02,083744,Cinel; Cameron Alexander,17,0,30,13
1657407405693,MATH 18,A03,083745,Cinel; Cameron Alexander,9,0,30,21
1657407405693,MATH 18,B01,083748,Rideout; David Porter,5,0,37,32
1657407405693,MATH 18,B02,083749,Rideout; David Porter,5,0,36,31
1657407405693,MATH 18,B03,083750,Rideout; David Porter,3,0,37,34
1657407405693,MATH 18,B04,083751,Rideout; David Porter,6,0,36,30
1657407405693,MATH 18,B05,093473,Rideout; David Porter,6,0,36,30
1657407405693,MATH 18,B06,093474,Rideout; David Porter,6,0,36,30
1657407411720,MATH 20A,A01,083754,Zheng; Zequn,14,0,40,26
1657407417746,MATH 20B,A01,083756,Briones; Jor-el Thomas Caparas,4,0,36,32
1657407417746,MATH 20B,A02,083757,Briones; Jor-el Thomas Caparas,1,0,36,35
1657407417746,MATH 20B,A03,093475,Briones; Jor-el Thomas Caparas,2,0,36,34
1657407423768,MATH 20C,A01,083760,Briones; Jor-el Thomas Caparas,1,0,35,34
1657407423768,MATH 20C,A02,083761,Briones; Jor-el Thomas Caparas,8,0,35,27
1657407423768,MATH 20C,A03,093476,Briones; Jor-el Thomas Caparas,0,1,36,36
1657407423768,MATH 20C,B01,083762,Bach; Quang Tran,1,0,30,29
1657407429798,MATH 20D,A01,083765,Tran; Brian Kha,5,0,30,25
1657407429798,MATH 20D,A02,083766,Tran; Brian Kha,5,0,30,25
1657407429798,MATH 20D,A03,083767,Tran; Brian Kha,5,0,30,25
1657407435827,MATH 20E,A01,083771,Ganguly; Soumya,9,0,32,23
1657407435827,MATH 20E,A02,083772,Ganguly; Soumya,6,0,32,26
1657407435827,MATH 20E,B01,083773,Ciotti; Benjamin,20,0,35,15
1657407435827,MATH 20E,B02,083774,Ciotti; Benjamin,17,0,35,18
1657407441860,MATH 103A,A01,083777,Greenfeld; Be'Eri,3,0,36,33
1657407441860,MATH 103A,A02,083778,Greenfeld; Be'Eri,5,0,36,31
1657407441860,MATH 103A,A03,093561,Greenfeld; Be'Eri,5,0,36,31
1657407441860,MATH 103A,B01,083779,Greenfeld; Be'Eri,7,0,36,29
1657407441860,MATH 103A,B02,083780,Greenfeld; Be'Eri,4,0,36,32
1657407441860,MATH 103A,B03,093562,Greenfeld; Be'Eri,3,0,36,33
1657407447884,MATH 105,A01,085443,Carter; Anne Toulson,15,0,35,20
1657407447884,MATH 105,A02,093477,Carter; Anne Toulson,20,0,35,15
1657407453914,MATH 109,A01,083213,Ganzberger; Geoffrey Michael,2,0,34,32
1657407453914,MATH 109,A02,083214,Ganzberger; Geoffrey Michael,4,0,34,30
1657407453914,MATH 109,A03,093478,Ganzberger; Geoffrey Michael,2,0,34,32
1657407453914,MATH 109,B01,083215,Ganzberger; Geoffrey Michael,1,0,32,31
1657407453914,MATH 109,B02,083216,Ganzberger; Geoffrey Michael,2,0,32,30
1657407453914,MATH 109,B03,093479,Ganzberger; Geoffrey Michael,8,0,32,24
1657407459944,MATH 142A,A01,083219,Chow; Bennett,7,0,32,25
1657407459944,MATH 142A,A02,083220,Chow; Bennett,10,0,32,22
1657407459944,MATH 142A,A03,093480,Chow; Bennett,8,0,32,24
1657407459944,MATH 142A,B03,093481,Chow; Bennett,8,0,32,24
1657407459944,MATH 142A,B04,093558,Chow; Bennett,13,0,32,19
1657407459944,MATH 142A,B05,093559,Chow; Bennett,6,0,32,26
1657407465983,MATH 193A,A01,083224,Rotar; Vladimir,8,0,34,26
1657407465983,MATH 193A,A02,083225,Rotar; Vladimir,9,0,34,25
1657407465983,MATH 193A,A03,083781,Rotar; Vladimir,5,0,34,29
1657407465983,MATH 193A,A04,083782,Rotar; Vladimir,10,0,34,24
1657407465983,MATH 193A,A05,093482,Rotar; Vladimir,10,0,34,24
1657407472006,MATH 197,001,091859,McAuley; Julian John,9999,0,9999,0
1657407472006,MATH 197,002,095566,Kedlaya; Kiran S.,9997,0,9999,2
1657407472006,MATH 197,003,095567,Xiao; Ming,9999,0,9999,0
1657407472006,MATH 197,004,095571,Perols; Johan Lars,9998,0,9999,1
1657407479073,COGS 9,A01,083615,Shannon; Kyle Michael,9,0,75,66
1657407485100,COGS 11,A01,083617,Boyle; Mary E. T.,22,0,48,26
1657407491122,COGS 13,A01,083071,Bastos; Amalia Pinkusfeld,11,0,71,60
1657407497154,COGS 14A,A01,092681,Semenuks; Arturs,4,1,100,96
1657407503178,COGS 14B,A01,083073,Cheng; Tzu-Han,6,0,63,57
1657407509202,COGS 17,A01,092677,Semenuks; Arturs,6,0,81,75
1657407515227,COGS 100,A01,083619,Allen; Michael Gordon,17,0,70,53
1657407521253,COGS 101A,A01,083621,Davis; Joshua Daniel,9,0,68,59
1657407527285,COGS 101B,A01,091572,Allen; Michael Gordon,12,0,65,53
1657407533308,COGS 101C,A01,083625,Delgado; Tania,17,0,35,18
1657407539331,COGS 107A,A01,083627,Boyle; Mary E. T.,13,0,60,47
1657407545355,COGS 118A,A01,083075,Gupta; Anjum,20,0,76,56
1657407551386,CSE 3,A50,083646,Miranda; Gregory Joseph,24,0,50,26
1657407557411,CSE 8A,A50,083650,Miranda; Gregory Joseph,17,1,56,39
1657407563445,CSE 11,A01,083080,Cao; Yingjun,6,15,40,34
1657407569469,CSE 12,A01,083652,Krause-Levy; Sophia Louisa,28,1,120,92
1657407575490,CSE 15L,A01,083654,Morris; Justin Loren,9,0,50,41
1657407575490,CSE 15L,A02,083655,Morris; Justin Loren,9,0,50,41
1657407581514,CSE 20,A01,083657,Tran; Khoa Dang,39,0,80,41
1657407587537,CSE 21,A01,095574,Bach; Quang Tran,22,0,48,26
1657407593563,CSE 30,A01,083084,Eldon; John,4,0,80,76
1657407593563,CSE 30,B01,095061,Bhaskar; Nishant,9,0,50,41
1657407599589,CSE 100,A01,083659,Cao; Yingjun,5,4,70,65
1657407605612,CSE 134B,A01,083661,Powell; Thomas Allan,22,0,100,78
1657407611638,CSE 140,A01,083663,Gungor; Onat,14,0,85,71
1657407617660,CSE 140L,A01,083088,Eldon; John,21,0,100,79
1657407623687,CSE 175,A01,083665,Kumar; Rakesh,3,0,25,22
1657407629713,CSE 190,A00,092507,Dubnov; Shlomo,7,0,20,13
1657407635740,ECE 45,A01,083139,Congero; Spencer William,6,0,75,69
1657407641769,ECE 65,A50,083695,Saad; Andrew S,12,0,30,18
1657407641769,ECE 65,A51,095125,Saad; Andrew S,24,0,26,2
1657407647791,ECE 109,A01,091882,Touri; Behrouz,19,0,70,51
1657407653818,ECE 180,A00,083140,Abi Samra; Nicholas Camill,1,0,30,29
1657407653818,ECE 180,B00,083141,Abi Samra; Nicholas Camill,0,0,30,30
1657407659844,MATH 10A,A01,083735,Patchell; Gregory David,2,0,30,28
1657407659844,MATH 10A,A02,083736,Patchell; Gregory David,20,0,30,10
1657407659844,MATH 10A,A03,083737,Patchell; Gregory David,16,0,30,14
1657407665871,MATH 10B,A01,083207,Lim; Seonhee,8,0,34,26
1657407665871,MATH 10B,A02,083208,Lim; Seonhee,9,0,35,26
1657407665871,MATH 10B,A03,093472,Lim; Seonhee,7,0,34,27
1657407665871,MATH 10B,B01,083739,Sinha; Shubham,12,0,30,18
1657407671897,MATH 18,A01,083743,Cinel; Cameron Alexander,7,0,30,23
1657407671897,MATH 18,A02,083744,Cinel; Cameron Alexander,17,0,30,13
1657407671897,MATH 18,A03,083745,Cinel; Cameron Alexander,9,0,30,21
1657407671897,MATH 18,B01,083748,Rideout; David Porter,5,0,37,32
1657407671897,MATH 18,B02,083749,Rideout; David Porter,5,0,36,31
1657407671897,MATH 18,B03,083750,Rideout; David Porter,3,0,37,34
1657407671897,MATH 18,B04,083751,Rideout; David Porter,6,0,36,30
1657407671897,MATH 18,B05,093473,Rideout; David Porter,6,0,36,30
1657407671897,MATH 18,B06,093474,Rideout; David Porter,6,0,36,30
1657407677922,MATH 20A,A01,083754,Zheng; Zequn,14,0,40,26
1657407683949,MATH 20B,A01,083756,Briones; Jor-el Thomas Caparas,4,0,36,32
1657407683949,MATH 20B,A02,083757,Briones; Jor-el Thomas Caparas,1,0,36,35
1657407683949,MATH 20B,A03,093475,Briones; Jor-el Thomas Caparas,2,0,36,34
1657407689971,MATH 20C,A01,083760,Briones; Jor-el Thomas Caparas,1,0,35,34
1657407689971,MATH 20C,A02,083761,Briones; Jor-el Thomas Caparas,8,0,35,27
1657407689971,MATH 20C,A03,093476,Briones; Jor-el Thomas Caparas,0,1,36,36
1657407689971,MATH 20C,B01,083762,Bach; Quang Tran,1,0,30,29
1657407695995,MATH 20D,A01,083765,Tran; Brian Kha,5,0,30,25
1657407695995,MATH 20D,A02,083766,Tran; Brian Kha,5,0,30,25
1657407695995,MATH 20D,A03,083767,Tran; Brian Kha,5,0,30,25
1657407702024,MATH 20E,A01,083771,Ganguly; Soumya,9,0,32,23
1657407702024,MATH 20E,A02,083772,Ganguly; Soumya,6,0,32,26
1657407702024,MATH 20E,B01,083773,Ciotti; Benjamin,20,0,35,15
1657407702024,MATH 20E,B02,083774,Ciotti; Benjamin,17,0,35,18
1657407708055,MATH 103A,A01,083777,Greenfeld; Be'Eri,3,0,36,33
1657407708055,MATH 103A,A02,083778,Greenfeld; Be'Eri,5,0,36,31
1657407708055,MATH 103A,A03,093561,Greenfeld; Be'Eri,5,0,36,31
1657407708055,MATH 103A,B01,083779,Greenfeld; Be'Eri,7,0,36,29
1657407708055,MATH 103A,B02,083780,Greenfeld; Be'Eri,4,0,36,32
1657407708055,MATH 103A,B03,093562,Greenfeld; Be'Eri,3,0,36,33
1657407714081,MATH 105,A01,085443,Carter; Anne Toulson,15,0,35,20
1657407714081,MATH 105,A02,093477,Carter; Anne Toulson,20,0,35,15
1657407720105,MATH 109,A01,083213,Ganzberger; Geoffrey Michael,2,0,34,32
1657407720105,MATH 109,A02,083214,Ganzberger; Geoffrey Michael,4,0,34,30
1657407720105,MATH 109,A03,093478,Ganzberger; Geoffrey Michael,2,0,34,32
1657407720105,MATH 109,B01,083215,Ganzberger; Geoffrey Michael,1,0,32,31
1657407720105,MATH 109,B02,083216,Ganzberger; Geoffrey Michael,2,0,32,30
1657407720105,MATH 109,B03,093479,Ganzberger; Geoffrey Michael,8,0,32,24
1657407726153,MATH 142A,A01,083219,Chow; Bennett,7,0,32,25
1657407726153,MATH 142A,A02,083220,Chow; Bennett,10,0,32,22
1657407726153,MATH 142A,A03,093480,Chow; Bennett,8,0,32,24
1657407726153,MATH 142A,B03,093481,Chow; Bennett,8,0,32,24
1657407726153,MATH 142A,B04,093558,Chow; Bennett,13,0,32,19
1657407726153,MATH 142A,B05,093559,Chow; Bennett,6,0,32,26
1657407732184,MATH 193A,A01,083224,Rotar; Vladimir,8,0,34,26
1657407732184,MATH 193A,A02,083225,Rotar; Vladimir,9,0,34,25
1657407732184,MATH 193A,A03,083781,Rotar; Vladimir,5,0,34,29
1657407732184,MATH 193A,A04,083782,Rotar; Vladimir,10,0,34,24
1657407732184,MATH 193A,A05,093482,Rotar; Vladimir,10,0,34,24
1657407738210,MATH 197,001,091859,McAuley; Julian John,9999,0,9999,0
1657407738210,MATH 197,002,095566,Kedlaya; Kiran S.,9997,0,9999,2
1657407738210,MATH 197,003,095567,Xiao; Ming,9999,0,9999,0
1657407738210,MATH 197,004,095571,Perols; Johan Lars,9998,0,9999,1
1657407745275,COGS 9,A01,083615,Shannon; Kyle Michael,9,0,75,66
1657407751389,COGS 11,A01,083617,Boyle; Mary E. T.,22,0,48,26
1657407757413,COGS 13,A01,083071,Bastos; Amalia Pinkusfeld,11,0,71,60
1657407763440,COGS 14A,A01,092681,Semenuks; Arturs,4,1,100,96
1657407769462,COGS 14B,A01,083073,Cheng; Tzu-Han,6,0,63,57
1657407775490,COGS 17,A01,092677,Semenuks; Arturs,6,0,81,75
1657407781515,COGS 100,A01,083619,Allen; Michael Gordon,17,0,70,53
1657407787538,COGS 101A,A01,083621,Davis; Joshua Daniel,9,0,68,59
1657407793560,COGS 101B,A01,091572,Allen; Michael Gordon,12,0,65,53
1657407799585,COGS 101C,A01,083625,Delgado; Tania,17,0,35,18
1657407805611,COGS 107A,A01,083627,Boyle; Mary E. T.,13,0,60,47
1657407811637,COGS 118A,A01,083075,Gupta; Anjum,20,0,76,56
1657407817665,CSE 3,A50,083646,Miranda; Gregory Joseph,24,0,50,26
1657407823691,CSE 8A,A50,083650,Miranda; Gregory Joseph,17,1,56,39
1657407829715,CSE 11,A01,083080,Cao; Yingjun,6,15,40,34
1657407835740,CSE 12,A01,083652,Krause-Levy; Sophia Louisa,28,1,120,92
1657407841765,CSE 15L,A01,083654,Morris; Justin Loren,9,0,50,41
1657407841765,CSE 15L,A02,083655,Morris; Justin Loren,9,0,50,41
1657407847788,CSE 20,A01,083657,Tran; Khoa Dang,39,0,80,41
1657407853820,CSE 21,A01,095574,Bach; Quang Tran,22,0,48,26
1657407859843,CSE 30,A01,083084,Eldon; John,4,0,80,76
1657407859843,CSE 30,B01,095061,Bhaskar; Nishant,9,0,50,41
1657407865865,CSE 100,A01,083659,Cao; Yingjun,5,4,70,65
1657407871895,CSE 134B,A01,083661,Powell; Thomas Allan,22,0,100,78
1657407877923,CSE 140,A01,083663,Gungor; Onat,14,0,85,71
1657407883951,CSE 140L,A01,083088,Eldon; John,21,0,100,79
1657407889981,CSE 175,A01,083665,Kumar; Rakesh,3,0,25,22
1657407896011,CSE 190,A00,092507,Dubnov; Shlomo,7,0,20,13
1657407902037,ECE 45,A01,083139,Congero; Spencer William,6,0,75,69
1657407908060,ECE 65,A50,083695,Saad; Andrew S,12,0,30,18
1657407908060,ECE 65,A51,095125,Saad; Andrew S,24,0,26,2
1657407914083,ECE 109,A01,091882,Touri; Behrouz,19,0,70,51
1657407920107,ECE 180,A00,083140,Abi Samra; Nicholas Camill,1,0,30,29
1657407920107,ECE 180,B00,083141,Abi Samra; Nicholas Camill,0,0,30,30
1657407926134,MATH 10A,A01,083735,Patchell; Gregory David,2,0,30,28
1657407926134,MATH 10A,A02,083736,Patchell; Gregory David,20,0,30,10
1657407926134,MATH 10A,A03,083737,Patchell; Gregory David,16,0,30,14
1657407932163,MATH 10B,A01,083207,Lim; Seonhee,8,0,34,26
1657407932163,MATH 10B,A02,083208,Lim; Seonhee,9,0,35,26
1657407932163,MATH 10B,A03,093472,Lim; Seonhee,7,0,34,27
1657407932163,MATH 10B,B01,083739,Sinha; Shubham,12,0,30,18
1657407938195,MATH 18,A01,083743,Cinel; Cameron Alexander,7,0,30,23
1657407938195,MATH 18,A02,083744,Cinel; Cameron Alexander,17,0,30,13
1657407938195,MATH 18,A03,083745,Cinel; Cameron Alexander,9,0,30,21
1657407938195,MATH 18,B01,083748,Rideout; David Porter,5,0,37,32
1657407938195,MATH 18,B02,083749,Rideout; David Porter,5,0,36,31
1657407938195,MATH 18,B03,083750,Rideout; David Porter,3,0,37,34
1657407938195,MATH 18,B04,083751,Rideout; David Porter,6,0,36,30
1657407938195,MATH 18,B05,093473,Rideout; David Porter,6,0,36,30
1657407938195,MATH 18,B06,093474,Rideout; David Porter,6,0,36,30
1657407944220,MATH 20A,A01,083754,Zheng; Zequn,14,0,40,26
1657407950248,MATH 20B,A01,083756,Briones; Jor-el Thomas Caparas,4,0,36,32
1657407950248,MATH 20B,A02,083757,Briones; Jor-el Thomas Caparas,1,0,36,35
1657407950248,MATH 20B,A03,093475,Briones; Jor-el Thomas Caparas,2,0,36,34
1657407956270,MATH 20C,A01,083760,Briones; Jor-el Thomas Caparas,1,0,35,34
1657407956270,MATH 20C,A02,083761,Briones; Jor-el Thomas Caparas,8,0,35,27
1657407956270,MATH 20C,A03,093476,Briones; Jor-el Thomas Caparas,0,1,36,36
1657407956270,MATH 20C,B01,083762,Bach; Quang Tran,1,0,30,29
1657407962297,MATH 20D,A01,083765,Tran; Brian Kha,5,0,30,25
1657407962297,MATH 20D,A02,083766,Tran; Brian Kha,5,0,30,25
1657407962297,MATH 20D,A03,083767,Tran; Brian Kha,5,0,30,25
1657407968321,MATH 20E,A01,083771,Ganguly; Soumya,9,0,32,23
1657407968321,MATH 20E,A02,083772,Ganguly; Soumya,6,0,32,26
1657407968321,MATH 20E,B01,083773,Ciotti; Benjamin,20,0,35,15
1657407968321,MATH 20E,B02,083774,Ciotti; Benjamin,17,0,35,18
1657407974346,MATH 103A,A01,083777,Greenfeld; Be'Eri,3,0,36,33
1657407974346,MATH 103A,A02,083778,Greenfeld; Be'Eri,5,0,36,31
1657407974346,MATH 103A,A03,093561,Greenfeld; Be'Eri,5,0,36,31
1657407974346,MATH 103A,B01,083779,Greenfeld; Be'Eri,7,0,36,29
1657407974346,MATH 103A,B02,083780,Greenfeld; Be'Eri,4,0,36,32
1657407974346,MATH 103A,B03,093562,Greenfeld; Be'Eri,3,0,36,33
1657407980375,MATH 105,A01,085443,Carter; Anne Toulson,15,0,35,20
1657407980375,MATH 105,A02,093477,Carter; Anne Toulson,20,0,35,15
1657407986403,MATH 109,A01,083213,Ganzberger; Geoffrey Michael,2,0,34,32
1657407986403,MATH 109,A02,083214,Ganzberger; Geoffrey Michael,4,0,34,30
1657407986403,MATH 109,A03,093478,Ganzberger; Geoffrey Michael,2,0,34,32
1657407986403,MATH 109,B01,083215,Ganzberger; Geoffrey Michael,1,0,32,31
1657407986403,MATH 109,B02,083216,Ganzberger; Geoffrey Michael,2,0,32,30
1657407986403,MATH 109,B03,093479,Ganzberger; Geoffrey Michael,8,0,32,24
1657407992427,MATH 142A,A01,083219,Chow; Bennett,7,0,32,25
1657407992427,MATH 142A,A02,083220,Chow; Bennett,10,0,32,22
1657407992427,MATH 142A,A03,093480,Chow; Bennett,8,0,32,24
1657407992427,MATH 142A,B03,093481,Chow; Bennett,8,0,32,24
1657407992427,MATH 142A,B04,093558,Chow; Bennett,13,0,32,19
1657407992427,MATH 142A,B05,093559,Chow; Bennett,6,0,32,26
1657407998456,MATH 193A,A01,083224,Rotar; Vladimir,8,0,34,26
1657407998456,MATH 193A,A02,083225,Rotar; Vladimir,9,0,34,25
1657407998456,MATH 193A,A03,083781,Rotar; Vladimir,5,0,34,29
1657407998456,MATH 193A,A04,083782,Rotar; Vladimir,10,0,34,24
1657407998456,MATH 193A,A05,093482,Rotar; Vladimir,10,0,34,24
1657408004483,MATH 197,001,091859,McAuley; Julian John,9999,0,9999,0
1657408004483,MATH 197,002,095566,Kedlaya; Kiran S.,9997,0,9999,2
1657408004483,MATH 197,003,095567,Xiao; Ming,9999,0,9999,0
1657408004483,MATH 197,004,095571,Perols; Johan Lars,9998,0,9999,1
1657408011537,COGS 9,A01,083615,Shannon; Kyle Michael,9,0,75,66
1657408017561,COGS 11,A01,083617,Boyle; Mary E. T.,22,0,48,26
1657408023588,COGS 13,A01,083071,Bastos; Amalia Pinkusfeld,11,0,71,60
1657408029616,COGS 14A,A01,092681,Semenuks; Arturs,4,1,100,96
1657408035639,COGS 14B,A01,083073,Cheng; Tzu-Han,6,0,63,57
1657408041665,COGS 17,A01,092677,Semenuks; Arturs,6,0,81,75
1657408047688,COGS 100,A01,083619,Allen; Michael Gordon,17,0,70,53
1657408053716,COGS 101A,A01,083621,Davis; Joshua Daniel,9,0,68,59
1657408059739,COGS 101B,A01,091572,Allen; Michael Gordon,12,0,65,53
1657408065767,COGS 101C,A01,083625,Delgado; Tania,17,0,35,18
1657408071789,COGS 107A,A01,083627,Boyle; Mary E. T.,13,0,60,47
1657408077822,COGS 118A,A01,083075,Gupta; Anjum,20,0,76,56
1657408083846,CSE 3,A50,083646,Miranda; Gregory Joseph,24,0,50,26
1657408089874,CSE 8A,A50,083650,Miranda; Gregory Joseph,17,1,56,39
1657408095908,CSE 11,A01,083080,Cao; Yingjun,6,15,40,34
1657408101931,CSE 12,A01,083652,Krause-Levy; Sophia Louisa,28,1,120,92
1657408107959,CSE 15L,A01,083654,Morris; Justin Loren,9,0,50,41
1657408107959,CSE 15L,A02,083655,Morris; Justin Loren,9,0,50,41
1657408113992,CSE 20,A01,083657,Tran; Khoa Dang,39,0,80,41
1657408120015,CSE 21,A01,095574,Bach; Quang Tran,22,0,48,26
1657408126042,CSE 30,A01,083084,Eldon; John,4,0,80,76
1657408126042,CSE 30,B01,095061,Bhaskar; Nishant,9,0,50,41
1657408132064,CSE 100,A01,083659,Cao; Yingjun,5,4,70,65
1657408138093,CSE 134B,A01,083661,Powell; Thomas Allan,22,0,100,78
1657408144116,CSE 140,A01,083663,Gungor; Onat,14,0,85,71
1657408150147,CSE 140L,A01,083088,Eldon; John,21,0,100,79
1657408156173,CSE 175,A01,083665,Kumar; Rakesh,3,0,25,22
1657408162200,CSE 190,A00,092507,Dubnov; Shlomo,7,0,20,13
1657408168225,ECE 45,A01,083139,Congero; Spencer William,6,0,75,69
1657408174249,ECE 65,A50,083695,Saad; Andrew S,12,0,30,18
1657408174249,ECE 65,A51,095125,Saad; Andrew S,24,0,26,2
1657408180272,ECE 109,A01,091882,Touri; Behrouz,19,0,70,51
1657408186296,ECE 180,A00,083140,Abi Samra; Nicholas Camill,1,0,30,29
1657408186296,ECE 180,B00,083141,Abi Samra; Nicholas Camill,0,0,30,30
1657408192322,MATH 10A,A01,083735,Patchell; Gregory David,2,0,30,28
1657408192322,MATH 10A,A02,083736,Patchell; Gregory David,20,0,30,10
1657408192322,MATH 10A,A03,083737,Patchell; Gregory David,16,0,30,14
1657408198346,MATH 10B,A01,083207,Lim; Seonhee,8,0,34,26
1657408198346,MATH 10B,A02,083208,Lim; Seonhee,9,0,35,26
1657408198346,MATH 10B,A03,093472,Lim; Seonhee,7,0,34,27
1657408198346,MATH 10B,B01,083739,Sinha; Shubham,12,0,30,18
1657408204386,MATH 18,A01,083743,Cinel; Cameron Alexander,7,0,30,23
1657408204386,MATH 18,A02,083744,Cinel; Cameron Alexander,17,0,30,13
1657408204386,MATH 18,A03,083745,Cinel; Cameron Alexander,9,0,30,21
1657408204386,MATH 18,B01,083748,Rideout; David Porter,5,0,37,32
1657408204386,MATH 18,B02,083749,Rideout; David Porter,5,0,36,31
1657408204386,MATH 18,B03,083750,Rideout; David Porter,3,0,37,34
1657408204386,MATH 18,B04,083751,Rideout; David Porter,6,0,36,30
1657408204386,MATH 18,B05,093473,Rideout; David Porter,6,0,36,30
1657408204386,MATH 18,B06,093474,Rideout; David Porter,6,0,36,30
1657408210411,MATH 20A,A01,083754,Zheng; Zequn,14,0,40,26
1657408216434,MATH 20B,A01,083756,Briones; Jor-el Thomas Caparas,4,0,36,32
1657408216434,MATH 20B,A02,083757,Briones; Jor-el Thomas Caparas,1,0,36,35
1657408216434,MATH 20B,A03,093475,Briones; Jor-el Thomas Caparas,2,0,36,34
1657408222462,MATH 20C,A01,083760,Briones; Jor-el Thomas Caparas,1,0,35,34
1657408222462,MATH 20C,A02,083761,Briones; Jor-el Thomas Caparas,8,0,35,27
1657408222462,MATH 20C,A03,093476,Briones; Jor-el Thomas Caparas,0,1,36,36
1657408222462,MATH 20C,B01,083762,Bach; Quang Tran,1,0,30,29
1657408228486,MATH 20D,A01,083765,Tran; Brian Kha,5,0,30,25
1657408228486,MATH 20D,A02,083766,Tran; Brian Kha,5,0,30,25
1657408228486,MATH 20D,A03,083767,Tran; Brian Kha,5,0,30,25
1657408234509,MATH 20E,A01,083771,Ganguly; Soumya,9,0,32,23
1657408234509,MATH 20E,A02,083772,Ganguly; Soumya,6,0,32,26
1657408234509,MATH 20E,B01,083773,Ciotti; Benjamin,20,0,35,15
1657408234509,MATH 20E,B02,083774,Ciotti; Benjamin,17,0,35,18
1657408240539,MATH 103A,A01,083777,Greenfeld; Be'Eri,3,0,36,33
1657408240539,MATH 103A,A02,083778,Greenfeld; Be'Eri,5,0,36,31
1657408240539,MATH 103A,A03,093561,Greenfeld; Be'Eri,5,0,36,31
1657408240539,MATH 103A,B01,083779,Greenfeld; Be'Eri,7,0,36,29
1657408240539,MATH 103A,B02,083780,Greenfeld; Be'Eri,4,0,36,32
1657408240539,MATH 103A,B03,093562,Greenfeld; Be'Eri,3,0,36,33
1657408246566,MATH 105,A01,085443,Carter; Anne Toulson,15,0,35,20
1657408246566,MATH 105,A02,093477,Carter; Anne Toulson,20,0,35,15
1657408252592,MATH 109,A01,083213,Ganzberger; Geoffrey Michael,2,0,34,32
1657408252592,MATH 109,A02,083214,Ganzberger; Geoffrey Michael,4,0,34,30
1657408252592,MATH 109,A03,093478,Ganzberger; Geoffrey Michael,2,0,34,32
1657408252592,MATH 109,B01,083215,Ganzberger; Geoffrey Michael,1,0,32,31
1657408252592,MATH 109,B02,083216,Ganzberger; Geoffrey Michael,2,0,32,30
1657408252592,MATH 109,B03,093479,Ganzberger; Geoffrey Michael,8,0,32,24
1657408258620,MATH 142A,A01,083219,Chow; Bennett,7,0,32,25
1657408258620,MATH 142A,A02,083220,Chow; Bennett,10,0,32,22
1657408258620,MATH 142A,A03,093480,Chow; Bennett,8,0,32,24
1657408258620,MATH 142A,B03,093481,Chow; Bennett,8,0,32,24
1657408258620,MATH 142A,B04,093558,Chow; Bennett,13,0,32,19
1657408258620,MATH 142A,B05,093559,Chow; Bennett,6,0,32,26
1657408264647,MATH 193A,A01,083224,Rotar; Vladimir,8,0,34,26
1657408264647,MATH 193A,A02,083225,Rotar; Vladimir,9,0,34,25
1657408264647,MATH 193A,A03,083781,Rotar; Vladimir,5,0,34,29
1657408264647,MATH 193A,A04,083782,Rotar; Vladimir,10,0,34,24
1657408264647,MATH 193A,A05,093482,Rotar; Vladimir,10,0,34,24
1657408270672,MATH 197,001,091859,McAuley; Julian John,9999,0,9999,0
1657408270672,MATH 197,002,095566,Kedlaya; Kiran S.,9997,0,9999,2
1657408270672,MATH 197,003,095567,Xiao; Ming,9999,0,9999,0
1657408270672,MATH 197,004,095571,Perols; Johan Lars,9998,0,9999,1
1657408277737,COGS 9,A01,083615,Shannon; Kyle Michael,9,0,75,66
1657408283762,COGS 11,A01,083617,Boyle; Mary E. T.,22,0,48,26
1657408289788,COGS 13,A01,083071,Bastos; Amalia Pinkusfeld,11,0,71,60
1657408295816,COGS 14A,A01,092681,Semenuks; Arturs,4,1,100,96
1657408301842,COGS 14B,A01,083073,Cheng; Tzu-Han,6,0,63,57
1657408307866,COGS 17,A01,092677,Semenuks; Arturs,6,0,81,75
1657408313890,COGS 100,A01,083619,Allen; Michael Gordon,17,0,70,53
1657408319913,COGS 101A,A01,083621,Davis; Joshua Daniel,9,0,68,59
1657408325936,COGS 101B,A01,091572,Allen; Michael Gordon,12,0,65,53
1657408331964,COGS 101C,A01,083625,Delgado; Tania,17,0,35,18
1657408337992,COGS 107A,A01,083627,Boyle; Mary E. T.,13,0,60,47
1657408344016,COGS 118A,A01,083075,Gupta; Anjum,20,0,76,56
1657408350134,CSE 3,A50,083646,Miranda; Gregory Joseph,24,0,50,26
1657408356161,CSE 8A,A50,083650,Miranda; Gregory Joseph,17,1,56,39
1657408362188,CSE 11,A01,083080,Cao; Yingjun,6,15,40,34
1657408368217,CSE 12,A01,083652,Krause-Levy; Sophia Louisa,28,1,120,92
1657408374240,CSE 15L,A01,083654,Morris; Justin Loren,9,0,50,41
1657408374240,CSE 15L,A02,083655,Morris; Justin Loren,9,0,50,41
1657408380273,CSE 20,A01,083657,Tran; Khoa Dang,39,0,80,41
1657408386301,CSE 21,A01,095574,Bach; Quang Tran,22,0,48,26
1657408392324,CSE 30,A01,083084,Eldon; John,4,0,80,76
1657408392324,CSE 30,B01,095061,Bhaskar; Nishant,9,0,50,41
1657408398350,CSE 100,A01,083659,Cao; Yingjun,5,4,70,65
1657408404380,CSE 134B,A01,083661,Powell; Thomas Allan,22,0,100,78
1657408410406,CSE 140,A01,083663,Gungor; Onat,14,0,85,71
1657408416433,CSE 140L,A01,083088,Eldon; John,21,0,100,79
1657408422455,CSE 175,A01,083665,Kumar; Rakesh,3,0,25,22
1657408428478,CSE 190,A00,092507,Dubnov; Shlomo,7,0,20,13
1657408434501,ECE 45,A01,083139,Congero; Spencer William,6,0,75,69
1657408440524,ECE 65,A50,083695,Saad; Andrew S,12,0,30,18
1657408440524,ECE 65,A51,095125,Saad; Andrew S,24,0,26,2
1657408446546,ECE 109,A01,091882,Touri; Behrouz,19,0,70,51
1657408452569,ECE 180,A00,083140,Abi Samra; Nicholas Camill,1,0,30,29
1657408452569,ECE 180,B00,083141,Abi Samra; Nicholas Camill,0,0,30,30
1657408458592,MATH 10A,A01,083735,Patchell; Gregory David,2,0,30,28
1657408458592,MATH 10A,A02,083736,Patchell; Gregory David,20,0,30,10
1657408458592,MATH 10A,A03,083737,Patchell; Gregory David,16,0,30,14
1657408464619,MATH 10B,A01,083207,Lim; Seonhee,8,0,34,26
1657408464619,MATH 10B,A02,083208,Lim; Seonhee,9,0,35,26
1657408464619,MATH 10B,A03,093472,Lim; Seonhee,7,0,34,27
1657408464619,MATH 10B,B01,083739,Sinha; Shubham,12,0,30,18
1657408470651,MATH 18,A01,083743,Cinel; Cameron Alexander,7,0,30,23
1657408470651,MATH 18,A02,083744,Cinel; Cameron Alexander,17,0,30,13
1657408470651,MATH 18,A03,083745,Cinel; Cameron Alexander,9,0,30,21
1657408470651,MATH 18,B01,083748,Rideout; David Porter,5,0,37,32
1657408470651,MATH 18,B02,083749,Rideout; David Porter,5,0,36,31
1657408470651,MATH 18,B03,083750,Rideout; David Porter,3,0,37,34
1657408470651,MATH 18,B04,083751,Rideout; David Porter,6,0,36,30
1657408470651,MATH 18,B05,093473,Rideout; David Porter,6,0,36,30
1657408470651,MATH 18,B06,093474,Rideout; David Porter,6,0,36,30
1657408476678,MATH 20A,A01,083754,Zheng; Zequn,14,0,40,26
1657408482736,MATH 20B,A01,083756,Briones; Jor-el Thomas Caparas,4,0,36,32
1657408482736,MATH 20B,A02,083757,Briones; Jor-el Thomas Caparas,1,0,36,35
1657408482736,MATH 20B,A03,093475,Briones; Jor-el Thomas Caparas,2,0,36,34
1657408488759,MATH 20C,A01,083760,Briones; Jor-el Thomas Caparas,1,0,35,34
1657408488759,MATH 20C,A02,083761,Briones; Jor-el Thomas Caparas,8,0,35,27
1657408488759,MATH 20C,A03,093476,Briones; Jor-el Thomas Caparas,0,1,36,36
1657408488759,MATH 20C,B01,083762,Bach; Quang Tran,1,0,30,29
1657408494783,MATH 20D,A01,083765,Tran; Brian Kha,5,0,30,25
1657408494783,MATH 20D,A02,083766,Tran; Brian Kha,5,0,30,25
1657408494783,MATH 20D,A03,083767,Tran; Brian Kha,5,0,30,25
1657408500812,MATH 20E,A01,083771,Ganguly; Soumya,9,0,32,23
1657408500812,MATH 20E,A02,083772,Ganguly; Soumya,6,0,32,26
1657408500812,MATH 20E,B01,083773,Ciotti; Benjamin,20,0,35,15
1657408500812,MATH 20E,B02,083774,Ciotti; Benjamin,17,0,35,18
1657408506834,MATH 103A,A01,083777,Greenfeld; Be'Eri,3,0,36,33
1657408506834,MATH 103A,A02,083778,Greenfeld; Be'Eri,5,0,36,31
1657408506834,MATH 103A,A03,093561,Greenfeld; Be'Eri,5,0,36,31
1657408506834,MATH 103A,B01,083779,Greenfeld; Be'Eri,7,0,36,29
1657408506834,MATH 103A,B02,083780,Greenfeld; Be'Eri,4,0,36,32
1657408506834,MATH 103A,B03,093562,Greenfeld; Be'Eri,3,0,36,33
1657408512858,MATH 105,A01,085443,Carter; Anne Toulson,15,0,35,20
1657408512858,MATH 105,A02,093477,Carter; Anne Toulson,20,0,35,15
1657408518881,MATH 109,A01,083213,Ganzberger; Geoffrey Michael,2,0,34,32
1657408518881,MATH 109,A02,083214,Ganzberger; Geoffrey Michael,4,0,34,30
1657408518881,MATH 109,A03,093478,Ganzberger; Geoffrey Michael,2,0,34,32
1657408518881,MATH 109,B01,083215,Ganzberger; Geoffrey Michael,1,0,32,31
1657408518881,MATH 109,B02,083216,Ganzberger; Geoffrey Michael,2,0,32,30
1657408518881,MATH 109,B03,093479,Ganzberger; Geoffrey Michael,8,0,32,24
1657408524912,MATH 142A,A01,083219,Chow; Bennett,7,0,32,25
1657408524912,MATH 142A,A02,083220,Chow; Bennett,10,0,32,22
1657408524912,MATH 142A,A03,093480,Chow; Bennett,8,0,32,24
1657408524912,MATH 142A,B03,093481,Chow; Bennett,8,0,32,24
1657408524912,MATH 142A,B04,093558,Chow; Bennett,13,0,32,19
1657408524912,MATH 142A,B05,093559,Chow; Bennett,6,0,32,26
1657408530935,MATH 193A,A01,083224,Rotar; Vladimir,8,0,34,26
1657408530935,MATH 193A,A02,083225,Rotar; Vladimir,9,0,34,25
1657408530935,MATH 193A,A03,083781,Rotar; Vladimir,5,0,34,29
1657408530935,MATH 193A,A04,083782,Rotar; Vladimir,10,0,34,24
1657408530935,MATH 193A,A05,093482,Rotar; Vladimir,10,0,34,24
1657408536972,MATH 197,001,091859,McAuley; Julian John,9999,0,9999,0
1657408536972,MATH 197,002,095566,Kedlaya; Kiran S.,9997,0,9999,2
1657408536972,MATH 197,003,095567,Xiao; Ming,9999,0,9999,0
1657408536972,MATH 197,004,095571,Perols; Johan Lars,9998,0,9999,1
1657408544029,COGS 9,A01,083615,Shannon; Kyle Michael,9,0,75,66
1657408550055,COGS 11,A01,083617,Boyle; Mary E. T.,22,0,48,26
1657408556082,COGS 13,A01,083071,Bastos; Amalia Pinkusfeld,11,0,71,60
1657408562127,COGS 14A,A01,092681,Semenuks; Arturs,4,1,100,96
1657408568151,COGS 14B,A01,083073,Cheng; Tzu-Han,6,0,63,57
1657408574174,COGS 17,A01,092677,Semenuks; Arturs,6,0,81,75
1657408580200,COGS 100,A01,083619,Allen; Michael Gordon,17,0,70,53
1657408586227,COGS 101A,A01,083621,Davis; Joshua Daniel,9,0,68,59
1657408592249,COGS 101B,A01,091572,Allen; Michael Gordon,12,0,65,53
1657408598273,COGS 101C,A01,083625,Delgado; Tania,17,0,35,18
1657408604297,COGS 107A,A01,083627,Boyle; Mary E. T.,13,0,60,47
1657408610320,COGS 118A,A01,083075,Gupta; Anjum,20,0,76,56
1657408616345,CSE 3,A50,083646,Miranda; Gregory Joseph,24,0,50,26
1657408622369,CSE 8A,A50,083650,Miranda; Gregory Joseph,17,1,56,39
1657408628391,CSE 11,A01,083080,Cao; Yingjun,6,15,40,34
1657408634413,CSE 12,A01,083652,Krause-Levy; Sophia Louisa,28,1,120,92
1657408640437,CSE 15L,A01,083654,Morris; Justin Loren,9,0,50,41
1657408640437,CSE 15L,A02,083655,Morris; Justin Loren,9,0,50,41
1657408646461,CSE 20,A01,083657,Tran; Khoa Dang,39,0,80,41
1657408652490,CSE 21,A01,095574,Bach; Quang Tran,22,0,48,26
1657408658513,CSE 30,A01,083084,Eldon; John,4,0,80,76
1657408658513,CSE 30,B01,095061,Bhaskar; Nishant,9,0,50,41
1657408664534,CSE 100,A01,083659,Cao; Yingjun,5,4,70,65
1657408670566,CSE 134B,A01,083661,Powell; Thomas Allan,22,0,100,78
1657408676592,CSE 140,A01,083663,Gungor; Onat,14,0,85,71
1657408682619,CSE 140L,A01,083088,Eldon; John,21,0,100,79
1657408688645,CSE 175,A01,083665,Kumar; Rakesh,3,0,25,22
1657408694676,CSE 190,A00,092507,Dubnov; Shlomo,7,0,20,13
1657408700699,ECE 45,A01,083139,Congero; Spencer William,6,0,75,69
1657408706721,ECE 65,A50,083695,Saad; Andrew S,12,0,30,18
1657408706721,ECE 65,A51,095125,Saad; Andrew S,24,0,26,2
1657408712745,ECE 109,A01,091882,Touri; Behrouz,19,0,70,51
1657408718772,ECE 180,A00,083140,Abi Samra; Nicholas Camill,1,0,30,29
1657408718772,ECE 180,B00,083141,Abi Samra; Nicholas Camill,0,0,30,30
1657408724795,MATH 10A,A01,083735,Patchell; Gregory David,2,0,30,28
1657408724795,MATH 10A,A02,083736,Patchell; Gregory David,20,0,30,10
1657408724795,MATH 10A,A03,083737,Patchell; Gregory David,16,0,30,14
1657408730819,MATH 10B,A01,083207,Lim; Seonhee,8,0,34,26
1657408730819,MATH 10B,A02,083208,Lim; Seonhee,9,0,35,26
1657408730819,MATH 10B,A03,093472,Lim; Seonhee,7,0,34,27
1657408730819,MATH 10B,B01,083739,Sinha; Shubham,12,0,30,18
1657408736859,MATH 18,A01,083743,Cinel; Cameron Alexander,7,0,30,23
1657408736859,MATH 18,A02,083744,Cinel; Cameron Alexander,17,0,30,13
1657408736859,MATH 18,A03,083745,Cinel; Cameron Alexander,9,0,30,21
1657408736859,MATH 18,B01,083748,Rideout; David Porter,5,0,37,32
1657408736859,MATH 18,B02,083749,Rideout; David Porter,5,0,36,31
1657408736859,MATH 18,B03,083750,Rideout; David Porter,3,0,37,34
1657408736859,MATH 18,B04,083751,Rideout; David Porter,6,0,36,30
1657408736859,MATH 18,B05,093473,Rideout; David Porter,6,0,36,30
1657408736859,MATH 18,B06,093474,Rideout; David Porter,6,0,36,30
1657408742882,MATH 20A,A01,083754,Zheng; Zequn,14,0,40,26
1657408748906,MATH 20B,A01,083756,Briones; Jor-el Thomas Caparas,4,0,36,32
1657408748906,MATH 20B,A02,083757,Briones; Jor-el Thomas Caparas,1,0,36,35
1657408748906,MATH 20B,A03,093475,Briones; Jor-el Thomas Caparas,2,0,36,34
1657408754930,MATH 20C,A01,083760,Briones; Jor-el Thomas Caparas,1,0,35,34
1657408754930,MATH 20C,A02,083761,Briones; Jor-el Thomas Caparas,8,0,35,27
1657408754930,MATH 20C,A03,093476,Briones; Jor-el Thomas Caparas,0,1,36,36
1657408754930,MATH 20C,B01,083762,Bach; Quang Tran,1,0,30,29
1657408760959,MATH 20D,A01,083765,Tran; Brian Kha,5,0,30,25
1657408760959,MATH 20D,A02,083766,Tran; Brian Kha,5,0,30,25
1657408760959,MATH 20D,A03,083767,Tran; Brian Kha,5,0,30,25
1657408766984,MATH 20E,A01,083771,Ganguly; Soumya,9,0,32,23
1657408766984,MATH 20E,A02,083772,Ganguly; Soumya,6,0,32,26
1657408766984,MATH 20E,B01,083773,Ciotti; Benjamin,20,0,35,15
1657408766984,MATH 20E,B02,083774,Ciotti; Benjamin,17,0,35,18
1657408773014,MATH 103A,A01,083777,Greenfeld; Be'Eri,3,0,36,33
1657408773014,MATH 103A,A02,083778,Greenfeld; Be'Eri,5,0,36,31
1657408773014,MATH 103A,A03,093561,Greenfeld; Be'Eri,5,0,36,31
1657408773014,MATH 103A,B01,083779,Greenfeld; Be'Eri,7,0,36,29
1657408773014,MATH 103A,B02,083780,Greenfeld; Be'Eri,4,0,36,32
1657408773014,MATH 103A,B03,093562,Greenfeld; Be'Eri,3,0,36,33
1657408779041,MATH 105,A01,085443,Carter; Anne Toulson,15,0,35,20
1657408779041,MATH 105,A02,093477,Carter; Anne Toulson,20,0,35,15
1657408785091,MATH 109,A01,083213,Ganzberger; Geoffrey Michael,2,0,34,32
1657408785091,MATH 109,A02,083214,Ganzberger; Geoffrey Michael,4,0,34,30
1657408785091,MATH 109,A03,093478,Ganzberger; Geoffrey Michael,2,0,34,32
1657408785091,MATH 109,B01,083215,Ganzberger; Geoffrey Michael,1,0,32,31
1657408785091,MATH 109,B02,083216,Ganzberger; Geoffrey Michael,2,0,32,30
1657408785091,MATH 109,B03,093479,Ganzberger; Geoffrey Michael,8,0,32,24
1657408791120,MATH 142A,A01,083219,Chow; Bennett,7,0,32,25
1657408791120,MATH 142A,A02,083220,Chow; Bennett,10,0,32,22
1657408791120,MATH 142A,A03,093480,Chow; Bennett,8,0,32,24
1657408791120,MATH 142A,B03,093481,Chow; Bennett,8,0,32,24
1657408791120,MATH 142A,B04,093558,Chow; Bennett,13,0,32,19
1657408791120,MATH 142A,B05,093559,Chow; Bennett,6,0,32,26
1657408797147,MATH 193A,A01,083224,Rotar; Vladimir,8,0,34,26
1657408797147,MATH 193A,A02,083225,Rotar; Vladimir,9,0,34,25
1657408797147,MATH 193A,A03,083781,Rotar; Vladimir,5,0,34,29
1657408797147,MATH 193A,A04,083782,Rotar; Vladimir,10,0,34,24
1657408797147,MATH 193A,A05,093482,Rotar; Vladimir,10,0,34,24
1657408803176,MATH 197,001,091859,McAuley; Julian John,9999,0,9999,0
1657408803176,MATH 197,002,095566,Kedlaya; Kiran S.,9997,0,9999,2
1657408803176,MATH 197,003,095567,Xiao; Ming,9999,0,9999,0
1657408803176,MATH 197,004,095571,Perols; Johan Lars,9998,0,9999,1
1657408810241,COGS 9,A01,083615,Shannon; Kyle Michael,9,0,75,66
1657408816268,COGS 11,A01,083617,Boyle; Mary E. T.,22,0,48,26
1657408822295,COGS 13,A01,083071,Bastos; Amalia Pinkusfeld,11,0,71,60
1657408828322,COGS 14A,A01,092681,Semenuks; Arturs,4,1,100,96
1657408834352,COGS 14B,A01,083073,Cheng; Tzu-Han,6,0,63,57
1657408840379,COGS 17,A01,092677,Semenuks; Arturs,6,0,81,75
1657408846402,COGS 100,A01,083619,Allen; Michael Gordon,17,0,70,53
1657408852428,COGS 101A,A01,083621,Davis; Joshua Daniel,9,0,68,59
1657408858452,COGS 101B,A01,091572,Allen; Michael Gordon,12,0,65,53
1657408864485,COGS 101C,A01,083625,Delgado; Tania,17,0,35,18
1657408870511,COGS 107A,A01,083627,Boyle; Mary E. T.,13,0,60,47
1657408876533,COGS 118A,A01,083075,Gupta; Anjum,20,0,76,56
1657408882559,CSE 3,A50,083646,Miranda; Gregory Joseph,24,0,50,26
1657408888586,CSE 8A,A50,083650,Miranda; Gregory Joseph,17,1,56,39
1657408894613,CSE 11,A01,083080,Cao; Yingjun,6,15,40,34
1657408900639,CSE 12,A01,083652,Krause-Levy; Sophia Louisa,28,1,120,92
1657408906665,CSE 15L,A01,083654,Morris; Justin Loren,9,0,50,41
1657408906665,CSE 15L,A02,083655,Morris; Justin Loren,9,0,50,41
1657408912688,CSE 20,A01,083657,Tran; Khoa Dang,39,0,80,41
1657408918718,CSE 21,A01,095574,Bach; Quang Tran,22,0,48,26
1657408924741,CSE 30,A01,083084,Eldon; John,4,0,80,76
1657408924741,CSE 30,B01,095061,Bhaskar; Nishant,9,0,50,41
1657408930766,CSE 100,A01,083659,Cao; Yingjun,5,4,70,65
1657408936797,CSE 134B,A01,083661,Powell; Thomas Allan,22,0,100,78
1657408942823,CSE 140,A01,083663,Gungor; Onat,14,0,85,71
1657408948921,CSE 140L,A01,083088,Eldon; John,21,0,100,79
1657408954942,CSE 175,A01,083665,Kumar; Rakesh,3,0,25,22
1657408960970,CSE 190,A00,092507,Dubnov; Shlomo,7,0,20,13
1657408966993,ECE 45,A01,083139,Congero; Spencer William,6,0,75,69
1657408973020,ECE 65,A50,083695,Saad; Andrew S,12,0,30,18
1657408973020,ECE 65,A51,095125,Saad; Andrew S,24,0,26,2
1657408979042,ECE 109,A01,091882,Touri; Behrouz,19,0,70,51
1657408985069,ECE 180,A00,083140,Abi Samra; Nicholas Camill,1,0,30,29
1657408985069,ECE 180,B00,083141,Abi Samra; Nicholas Camill,0,0,30,30
1657408991097,MATH 10A,A01,083735,Patchell; Gregory David,2,0,30,28
1657408991097,MATH 10A,A02,083736,Patchell; Gregory David,20,0,30,10
1657408991097,MATH 10A,A03,083737,Patchell; Gregory David,16,0,30,14
1657408997122,MATH 10B,A01,083207,Lim; Seonhee,8,0,34,26
1657408997122,MATH 10B,A02,083208,Lim; Seonhee,9,0,35,26
1657408997122,MATH 10B,A03,093472,Lim; Seonhee,7,0,34,27
1657408997122,MATH 10B,B01,083739,Sinha; Shubham,12,0,30,18
1657409003150,MATH 18,A01,083743,Cinel; Cameron Alexander,7,0,30,23
1657409003150,MATH 18,A02,083744,Cinel; Cameron Alexander,17,0,30,13
1657409003150,MATH 18,A03,083745,Cinel; Cameron Alexander,9,0,30,21
1657409003150,MATH 18,B01,083748,Rideout; David Porter,5,0,37,32
1657409003150,MATH 18,B02,083749,Rideout; David Porter,5,0,36,31
1657409003150,MATH 18,B03,083750,Rideout; David Porter,3,0,37,34
1657409003150,MATH 18,B04,083751,Rideout; David Porter,6,0,36,30
1657409003150,MATH 18,B05,093473,Rideout; David Porter,6,0,36,30
1657409003150,MATH 18,B06,093474,Rideout; David Porter,6,0,36,30
1657409009175,MATH 20A,A01,083754,Zheng; Zequn,14,0,40,26
1657409015202,MATH 20B,A01,083756,Briones; Jor-el Thomas Caparas,4,0,36,32
1657409015202,MATH 20B,A02,083757,Briones; Jor-el Thomas Caparas,1,0,36,35
1657409015202,MATH 20B,A03,093475,Briones; Jor-el Thomas Caparas,2,0,36,34
1657409021224,MATH 20C,A01,083760,Briones; Jor-el Thomas Caparas,1,0,35,34
1657409021224,MATH 20C,A02,083761,Briones; Jor-el Thomas Caparas,8,0,35,27
1657409021224,MATH 20C,A03,093476,Briones; Jor-el Thomas Caparas,0,1,36,36
1657409021224,MATH 20C,B01,083762,Bach; Quang Tran,1,0,30,29
1657409027252,MATH 20D,A01,083765,Tran; Brian Kha,5,0,30,25
1657409027252,MATH 20D,A02,083766,Tran; Brian Kha,5,0,30,25
1657409027252,MATH 20D,A03,083767,Tran; Brian Kha,5,0,30,25
1657409033280,MATH 20E,A01,083771,Ganguly; Soumya,9,0,32,23
1657409033280,MATH 20E,A02,083772,Ganguly; Soumya,6,0,32,26
1657409033280,MATH 20E,B01,083773,Ciotti; Benjamin,20,0,35,15
1657409033280,MATH 20E,B02,083774,Ciotti; Benjamin,17,0,35,18
1657409039317,MATH 103A,A01,083777,Greenfeld; Be'Eri,3,0,36,33
1657409039317,MATH 103A,A02,083778,Greenfeld; Be'Eri,5,0,36,31
1657409039317,MATH 103A,A03,093561,Greenfeld; Be'Eri,5,0,36,31
1657409039317,MATH 103A,B01,083779,Greenfeld; Be'Eri,7,0,36,29
1657409039317,MATH 103A,B02,083780,Greenfeld; Be'Eri,4,0,36,32
1657409039317,MATH 103A,B03,093562,Greenfeld; Be'Eri,3,0,36,33
1657409045343,MATH 105,A01,085443,Carter; Anne Toulson,15,0,35,20
1657409045343,MATH 105,A02,093477,Carter; Anne Toulson,20,0,35,15
1657409051372,MATH 109,A01,083213,Ganzberger; Geoffrey Michael,2,0,34,32
1657409051372,MATH 109,A02,083214,Ganzberger; Geoffrey Michael,4,0,34,30
1657409051372,MATH 109,A03,093478,Ganzberger; Geoffrey Michael,2,0,34,32
1657409051372,MATH 109,B01,083215,Ganzberger; Geoffrey Michael,1,0,32,31
1657409051372,MATH 109,B02,083216,Ganzberger; Geoffrey Michael,2,0,32,30
1657409051372,MATH 109,B03,093479,Ganzberger; Geoffrey Michael,8,0,32,24
1657409057394,MATH 142A,A01,083219,Chow; Bennett,7,0,32,25
1657409057394,MATH 142A,A02,083220,Chow; Bennett,10,0,32,22
1657409057394,MATH 142A,A03,093480,Chow; Bennett,8,0,32,24
1657409057394,MATH 142A,B03,093481,Chow; Bennett,8,0,32,24
1657409057394,MATH 142A,B04,093558,Chow; Bennett,13,0,32,19
1657409057394,MATH 142A,B05,093559,Chow; Bennett,6,0,32,26
1657409063417,MATH 193A,A01,083224,Rotar; Vladimir,8,0,34,26
1657409063417,MATH 193A,A02,083225,Rotar; Vladimir,9,0,34,25
1657409063417,MATH 193A,A03,083781,Rotar; Vladimir,5,0,34,29
1657409063417,MATH 193A,A04,083782,Rotar; Vladimir,10,0,34,24
1657409063417,MATH 193A,A05,093482,Rotar; Vladimir,10,0,34,24
1657409069445,MATH 197,001,091859,McAuley; Julian John,9999,0,9999,0
1657409069445,MATH 197,002,095566,Kedlaya; Kiran S.,9997,0,9999,2
1657409069445,MATH 197,003,095567,Xiao; Ming,9999,0,9999,0
1657409069445,MATH 197,004,095571,Perols; Johan Lars,9998,0,9999,1
1657409076505,COGS 9,A01,083615,Shannon; Kyle Michael,9,0,75,66
1657409082532,COGS 11,A01,083617,Boyle; Mary E. T.,22,0,48,26
1657409088554,COGS 13,A01,083071,Bastos; Amalia Pinkusfeld,11,0,71,60
1657409094578,COGS 14A,A01,092681,Semenuks; Arturs,4,1,100,96
1657409100606,COGS 14B,A01,083073,Cheng; Tzu-Han,6,0,63,57
1657409106633,COGS 17,A01,092677,Semenuks; Arturs,6,0,81,75
1657409112668,COGS 100,A01,083619,Allen; Michael Gordon,17,0,70,53
1657409118696,COGS 101A,A01,083621,Davis; Joshua Daniel,9,0,68,59
1657409124720,COGS 101B,A01,091572,Allen; Michael Gordon,12,0,65,53
1657409130746,COGS 101C,A01,083625,Delgado; Tania,17,0,35,18
1657409136776,COGS 107A,A01,083627,Boyle; Mary E. T.,13,0,60,47
1657409142799,COGS 118A,A01,083075,Gupta; Anjum,20,0,76,56
1657409148826,CSE 3,A50,083646,Miranda; Gregory Joseph,24,0,50,26
1657409154847,CSE 8A,A50,083650,Miranda; Gregory Joseph,17,1,56,39
1657409160872,CSE 11,A01,083080,Cao; Yingjun,6,15,40,34
1657409166900,CSE 12,A01,083652,Krause-Levy; Sophia Louisa,28,1,120,92
1657409172923,CSE 15L,A01,083654,Morris; Justin Loren,9,0,50,41
1657409172923,CSE 15L,A02,083655,Morris; Justin Loren,9,0,50,41
1657409178945,CSE 20,A01,083657,Tran; Khoa Dang,39,0,80,41
1657409184968,CSE 21,A01,095574,Bach; Quang Tran,22,0,48,26
1657409190989,CSE 30,A01,083084,Eldon; John,4,0,80,76
1657409190989,CSE 30,B01,095061,Bhaskar; Nishant,9,0,50,41
1657409197012,CSE 100,A01,083659,Cao; Yingjun,5,4,70,65
1657409203036,CSE 134B,A01,083661,Powell; Thomas Allan,22,0,100,78
1657409209058,CSE 140,A01,083663,Gungor; Onat,14,0,85,71
1657409215082,CSE 140L,A01,083088,Eldon; John,21,0,100,79
1657409221104,CSE 175,A01,083665,Kumar; Rakesh,3,0,25,22
1657409227127,CSE 190,A00,092507,Dubnov; Shlomo,7,0,20,13
1657409233154,ECE 45,A01,083139,Congero; Spencer William,6,0,75,69
1657409239182,ECE 65,A50,083695,Saad; Andrew S,12,0,30,18
1657409239182,ECE 65,A51,095125,Saad; Andrew S,24,0,26,2
1657409245205,ECE 109,A01,091882,Touri; Behrouz,19,0,70,51
1657409251228,ECE 180,A00,083140,Abi Samra; Nicholas Camill,1,0,30,29
1657409251228,ECE 180,B00,083141,Abi Samra; Nicholas Camill,0,0,30,30
1657409257256,MATH 10A,A01,083735,Patchell; Gregory David,2,0,30,28
1657409257256,MATH 10A,A02,083736,Patchell; Gregory David,20,0,30,10
1657409257256,MATH 10A,A03,083737,Patchell; Gregory David,16,0,30,14
1657409263286,MATH 10B,A01,083207,Lim; Seonhee,8,0,34,26
1657409263286,MATH 10B,A02,083208,Lim; Seonhee,9,0,35,26
1657409263286,MATH 10B,A03,093472,Lim; Seonhee,7,0,34,27
1657409263286,MATH 10B,B01,083739,Sinha; Shubham,12,0,30,18
1657409269317,MATH 18,A01,083743,Cinel; Cameron Alexander,7,0,30,23
1657409269317,MATH 18,A02,083744,Cinel; Cameron Alexander,17,0,30,13
1657409269317,MATH 18,A03,083745,Cinel; Cameron Alexander,9,0,30,21
1657409269317,MATH 18,B01,083748,Rideout; David Porter,5,0,37,32
1657409269317,MATH 18,B02,083749,Rideout; David Porter,5,0,36,31
1657409269317,MATH 18,B03,083750,Rideout; David Porter,3,0,37,34
1657409269317,MATH 18,B04,083751,Rideout; David Porter,6,0,36,30
1657409269317,MATH 18,B05,093473,Rideout; David Porter,6,0,36,30
1657409269317,MATH 18,B06,093474,Rideout; David Porter,6,0,36,30
1657409275346,MATH 20A,A01,083754,Zheng; Zequn,14,0,40,26
1657409281367,MATH 20B,A01,083756,Briones; Jor-el Thomas Caparas,4,0,36,32
1657409281367,MATH 20B,A02,083757,Briones; Jor-el Thomas Caparas,1,0,36,35
1657409281367,MATH 20B,A03,093475,Briones; Jor-el Thomas Caparas,2,0,36,34
1657409287391,MATH 20C,A01,083760,Briones; Jor-el Thomas Caparas,1,0,35,34
1657409287391,MATH 20C,A02,083761,Briones; Jor-el Thomas Caparas,8,0,35,27
1657409287391,MATH 20C,A03,093476,Briones; Jor-el Thomas Caparas,0,1,36,36
1657409287391,MATH 20C,B01,083762,Bach; Quang Tran,1,0,30,29
1657409293414,MATH 20D,A01,083765,Tran; Brian Kha,5,0,30,25
1657409293414,MATH 20D,A02,083766,Tran; Brian Kha,5,0,30,25
1657409293414,MATH 20D,A03,083767,Tran; Brian Kha,5,0,30,25
1657409299441,MATH 20E,A01,083771,Ganguly; Soumya,9,0,32,23
1657409299441,MATH 20E,A02,083772,Ganguly; Soumya,6,0,32,26
1657409299441,MATH 20E,B01,083773,Ciotti; Benjamin,20,0,35,15
1657409299441,MATH 20E,B02,083774,Ciotti; Benjamin,17,0,35,18
1657409305464,MATH 103A,A01,083777,Greenfeld; Be'Eri,3,0,36,33
1657409305464,MATH 103A,A02,083778,Greenfeld; Be'Eri,5,0,36,31
1657409305464,MATH 103A,A03,093561,Greenfeld; Be'Eri,5,0,36,31
1657409305464,MATH 103A,B01,083779,Greenfeld; Be'Eri,7,0,36,29
1657409305464,MATH 103A,B02,083780,Greenfeld; Be'Eri,4,0,36,32
1657409305464,MATH 103A,B03,093562,Greenfeld; Be'Eri,3,0,36,33
1657409311490,MATH 105,A01,085443,Carter; Anne Toulson,15,0,35,20
1657409311490,MATH 105,A02,093477,Carter; Anne Toulson,20,0,35,15
1657409317523,MATH 109,A01,083213,Ganzberger; Geoffrey Michael,2,0,34,32
1657409317523,MATH 109,A02,083214,Ganzberger; Geoffrey Michael,4,0,34,30
1657409317523,MATH 109,A03,093478,Ganzberger; Geoffrey Michael,2,0,34,32
1657409317523,MATH 109,B01,083215,Ganzberger; Geoffrey Michael,1,0,32,31
1657409317523,MATH 109,B02,083216,Ganzberger; Geoffrey Michael,2,0,32,30
1657409317523,MATH 109,B03,093479,Ganzberger; Geoffrey Michael,8,0,32,24
1657409323546,MATH 142A,A01,083219,Chow; Bennett,7,0,32,25
1657409323546,MATH 142A,A02,083220,Chow; Bennett,10,0,32,22
1657409323546,MATH 142A,A03,093480,Chow; Bennett,8,0,32,24
1657409323546,MATH 142A,B03,093481,Chow; Bennett,8,0,32,24
1657409323546,MATH 142A,B04,093558,Chow; Bennett,13,0,32,19
1657409323546,MATH 142A,B05,093559,Chow; Bennett,6,0,32,26
1657409329575,MATH 193A,A01,083224,Rotar; Vladimir,8,0,34,26
1657409329575,MATH 193A,A02,083225,Rotar; Vladimir,9,0,34,25
1657409329575,MATH 193A,A03,083781,Rotar; Vladimir,5,0,34,29
1657409329575,MATH 193A,A04,083782,Rotar; Vladimir,10,0,34,24
1657409329575,MATH 193A,A05,093482,Rotar; Vladimir,10,0,34,24
1657409335597,MATH 197,001,091859,McAuley; Julian John,9999,0,9999,0
1657409335597,MATH 197,002,095566,Kedlaya; Kiran S.,9997,0,9999,2
1657409335597,MATH 197,003,095567,Xiao; Ming,9999,0,9999,0
1657409335597,MATH 197,004,095571,Perols; Johan Lars,9998,0,9999,1
1657409342651,COGS 9,A01,083615,Shannon; Kyle Michael,9,0,75,66
1657409348674,COGS 11,A01,083617,Boyle; Mary E. T.,22,0,48,26
1657409354699,COGS 13,A01,083071,Bastos; Amalia Pinkusfeld,11,0,71,60
1657409360722,COGS 14A,A01,092681,Semenuks; Arturs,4,1,100,96
1657409366753,COGS 14B,A01,083073,Cheng; Tzu-Han,6,0,63,57
1657409372776,COGS 17,A01,092677,Semenuks; Arturs,6,0,81,75
1657409378800,COGS 100,A01,083619,Allen; Michael Gordon,17,0,70,53
1657409384822,COGS 101A,A01,083621,Davis; Joshua Daniel,9,0,68,59
1657409390849,COGS 101B,A01,091572,Allen; Michael Gordon,12,0,65,53
1657409396878,COGS 101C,A01,083625,Delgado; Tania,17,0,35,18
1657409402905,COGS 107A,A01,083627,Boyle; Mary E. T.,13,0,60,47
1657409408928,COGS 118A,A01,083075,Gupta; Anjum,20,0,76,56
1657409414951,CSE 3,A50,083646,Miranda; Gregory Joseph,24,0,50,26
1657409420974,CSE 8A,A50,083650,Miranda; Gregory Joseph,17,1,56,39
1657409427004,CSE 11,A01,083080,Cao; Yingjun,6,15,40,34
1657409433030,CSE 12,A01,083652,Krause-Levy; Sophia Louisa,28,1,120,92
1657409439051,CSE 15L,A01,083654,Morris; Justin Loren,9,0,50,41
1657409439051,CSE 15L,A02,083655,Morris; Justin Loren,9,0,50,41
1657409445073,CSE 20,A01,083657,Tran; Khoa Dang,39,0,80,41
1657409451100,CSE 21,A01,095574,Bach; Quang Tran,22,0,48,26
1657409457123,CSE 30,A01,083084,Eldon; John,4,0,80,76
1657409457123,CSE 30,B01,095061,Bhaskar; Nishant,9,0,50,41
1657409463150,CSE 100,A01,083659,Cao; Yingjun,5,4,70,65
1657409469177,CSE 134B,A01,083661,Powell; Thomas Allan,22,0,100,78
1657409475207,CSE 140,A01,083663,Gungor; Onat,14,0,85,71
1657409481229,CSE 140L,A01,083088,Eldon; John,21,0,100,79
1657409487256,CSE 175,A01,083665,Kumar; Rakesh,3,0,25,22
1657409493280,CSE 190,A00,092507,Dubnov; Shlomo,7,0,20,13
1657409499308,ECE 45,A01,083139,Congero; Spencer William,6,0,75,69
1657409505333,ECE 65,A50,083695,Saad; Andrew S,12,0,30,18
1657409505333,ECE 65,A51,095125,Saad; Andrew S,24,0,26,2
1657409511360,ECE 109,A01,091882,Touri; Behrouz,19,0,70,51
1657409517382,ECE 180,A00,083140,Abi Samra; Nicholas Camill,1,0,30,29
1657409517382,ECE 180,B00,083141,Abi Samra; Nicholas Camill,0,0,30,30
1657409523405,MATH 10A,A01,083735,Patchell; Gregory David,2,0,30,28
1657409523405,MATH 10A,A02,083736,Patchell; Gregory David,20,0,30,10
1657409523405,MATH 10A,A03,083737,Patchell; Gregory David,16,0,30,14
1657409529429,MATH 10B,A01,083207,Lim; Seonhee,8,0,34,26
1657409529429,MATH 10B,A02,083208,Lim; Seonhee,9,0,35,26
1657409529429,MATH 10B,A03,093472,Lim; Seonhee,7,0,34,27
1657409529429,MATH 10B,B01,083739,Sinha; Shubham,12,0,30,18
1657409535454,MATH 18,A01,083743,Cinel; Cameron Alexander,7,0,30,23
1657409535454,MATH 18,A02,083744,Cinel; Cameron Alexander,17,0,30,13
1657409535454,MATH 18,A03,083745,Cinel; Cameron Alexander,9,0,30,21
1657409535454,MATH 18,B01,083748,Rideout; David Porter,5,0,37,32
1657409535454,MATH 18,B02,083749,Rideout; David Porter,5,0,36,31
1657409535454,MATH 18,B03,083750,Rideout; David Porter,3,0,37,34
1657409535454,MATH 18,B04,083751,Rideout; David Porter,6,0,36,30
1657409535454,MATH 18,B05,093473,Rideout; David Porter,6,0,36,30
1657409535454,MATH 18,B06,093474,Rideout; David Porter,6,0,36,30
1657409541476,MATH 20A,A01,083754,Zheng; Zequn,14,0,40,26
1657409547587,MATH 20B,A01,083756,Briones; Jor-el Thomas Caparas,4,0,36,32
1657409547587,MATH 20B,A02,083757,Briones; Jor-el Thomas Caparas,1,0,36,35
1657409547587,MATH 20B,A03,093475,Briones; Jor-el Thomas Caparas,2,0,36,34
1657409553612,MATH 20C,A01,083760,Briones; Jor-el Thomas Caparas,1,0,35,34
1657409553612,MATH 20C,A02,083761,Briones; Jor-el Thomas Caparas,8,0,35,27
1657409553612,MATH 20C,A03,093476,Briones; Jor-el Thomas Caparas,0,1,36,36
1657409553612,MATH 20C,B01,083762,Bach; Quang Tran,1,0,30,29
1657409559640,MATH 20D,A01,083765,Tran; Brian Kha,5,0,30,25
1657409559640,MATH 20D,A02,083766,Tran; Brian Kha,5,0,30,25
1657409559640,MATH 20D,A03,083767,Tran; Brian Kha,5,0,30,25
1657409565663,MATH 20E,A01,083771,Ganguly; Soumya,9,0,32,23
1657409565663,MATH 20E,A02,083772,Ganguly; Soumya,6,0,32,26
1657409565663,MATH 20E,B01,083773,Ciotti; Benjamin,20,0,35,15
1657409565663,MATH 20E,B02,083774,Ciotti; Benjamin,17,0,35,18
1657409571700,MATH 103A,A01,083777,Greenfeld; Be'Eri,3,0,36,33
1657409571700,MATH 103A,A02,083778,Greenfeld; Be'Eri,5,0,36,31
1657409571700,MATH 103A,A03,093561,Greenfeld; Be'Eri,5,0,36,31
1657409571700,MATH 103A,B01,083779,Greenfeld; Be'Eri,7,0,36,29
1657409571700,MATH 103A,B02,083780,Greenfeld; Be'Eri,4,0,36,32
1657409571700,MATH 103A,B03,093562,Greenfeld; Be'Eri,3,0,36,33
1657409577724,MATH 105,A01,085443,Carter; Anne Toulson,15,0,35,20
1657409577724,MATH 105,A02,093477,Carter; Anne Toulson,20,0,35,15
1657409583747,MATH 109,A01,083213,Ganzberger; Geoffrey Michael,2,0,34,32
1657409583747,MATH 109,A02,083214,Ganzberger; Geoffrey Michael,4,0,34,30
1657409583747,MATH 109,A03,093478,Ganzberger; Geoffrey Michael,2,0,34,32
1657409583747,MATH 109,B01,083215,Ganzberger; Geoffrey Michael,1,0,32,31
1657409583747,MATH 109,B02,083216,Ganzberger; Geoffrey Michael,2,0,32,30
1657409583747,MATH 109,B03,093479,Ganzberger; Geoffrey Michael,8,0,32,24
1657409589775,MATH 142A,A01,083219,Chow; Bennett,7,0,32,25
1657409589775,MATH 142A,A02,083220,Chow; Bennett,10,0,32,22
1657409589775,MATH 142A,A03,093480,Chow; Bennett,8,0,32,24
1657409589775,MATH 142A,B03,093481,Chow; Bennett,8,0,32,24
1657409589775,MATH 142A,B04,093558,Chow; Bennett,13,0,32,19
1657409589775,MATH 142A,B05,093559,Chow; Bennett,6,0,32,26
1657409595797,MATH 193A,A01,083224,Rotar; Vladimir,8,0,34,26
1657409595797,MATH 193A,A02,083225,Rotar; Vladimir,9,0,34,25
1657409595797,MATH 193A,A03,083781,Rotar; Vladimir,5,0,34,29
1657409595797,MATH 193A,A04,083782,Rotar; Vladimir,10,0,34,24
1657409595797,MATH 193A,A05,093482,Rotar; Vladimir,10,0,34,24
1657409601824,MATH 197,001,091859,McAuley; Julian John,9999,0,9999,0
1657409601824,MATH 197,002,095566,Kedlaya; Kiran S.,9997,0,9999,2
1657409601824,MATH 197,003,095567,Xiao; Ming,9999,0,9999,0
1657409601824,MATH 197,004,095571,Perols; Johan Lars,9998,0,9999,1
1657409608886,COGS 9,A01,083615,Shannon; Kyle Michael,9,0,75,66
1657409614909,COGS 11,A01,083617,Boyle; Mary E. T.,22,0,48,26
1657409620935,COGS 13,A01,083071,Bastos; Amalia Pinkusfeld,11,0,71,60
1657409626960,COGS 14A,A01,092681,Semenuks; Arturs,4,1,100,96
1657409632987,COGS 14B,A01,083073,Cheng; Tzu-Han,6,0,63,57
1657409639014,COGS 17,A01,092677,Semenuks; Arturs,6,0,81,75
1657409645043,COGS 100,A01,083619,Allen; Michael Gordon,17,0,70,53
1657409651070,COGS 101A,A01,083621,Davis; Joshua Daniel,9,0,68,59
1657409657097,COGS 101B,A01,091572,Allen; Michael Gordon,12,0,65,53
1657409663124,COGS 101C,A01,083625,Delgado; Tania,17,0,35,18
1657409669146,COGS 107A,A01,083627,Boyle; Mary E. T.,13,0,60,47
1657409675170,COGS 118A,A01,083075,Gupta; Anjum,20,0,76,56
1657409681193,CSE 3,A50,083646,Miranda; Gregory Joseph,24,0,50,26
1657409687221,CSE 8A,A50,083650,Miranda; Gregory Joseph,17,1,56,39
1657409693244,CSE 11,A01,083080,Cao; Yingjun,6,15,40,34
1657409699266,CSE 12,A01,083652,Krause-Levy; Sophia Louisa,28,1,120,92
1657409705290,CSE 15L,A01,083654,Morris; Justin Loren,9,0,50,41
1657409705290,CSE 15L,A02,083655,Morris; Justin Loren,9,0,50,41
1657409711311,CSE 20,A01,083657,Tran; Khoa Dang,39,0,80,41
1657409717338,CSE 21,A01,095574,Bach; Quang Tran,22,0,48,26
1657409723362,CSE 30,A01,083084,Eldon; John,4,0,80,76
1657409723362,CSE 30,B01,095061,Bhaskar; Nishant,9,0,50,41
1657409729388,CSE 100,A01,083659,Cao; Yingjun,5,4,70,65
1657409735413,CSE 134B,A01,083661,Powell; Thomas Allan,22,0,100,78
1657409741435,CSE 140,A01,083663,Gungor; Onat,14,0,85,71
1657409747461,CSE 140L,A01,083088,Eldon; John,21,0,100,79
1657409753484,CSE 175,A01,083665,Kumar; Rakesh,3,0,25,22
1657409759506,CSE 190,A00,092507,Dubnov; Shlomo,7,0,20,13
1657409765532,ECE 45,A01,083139,Congero; Spencer William,6,0,75,69
1657409771563,ECE 65,A50,083695,Saad; Andrew S,12,0,30,18
1657409771563,ECE 65,A51,095125,Saad; Andrew S,24,0,26,2
1657409777585,ECE 109,A01,091882,Touri; Behrouz,19,0,70,51
1657409783611,ECE 180,A00,083140,Abi Samra; Nicholas Camill,1,0,30,29
1657409783611,ECE 180,B00,083141,Abi Samra; Nicholas Camill,0,0,30,30
1657409789638,MATH 10A,A01,083735,Patchell; Gregory David,2,0,30,28
1657409789638,MATH 10A,A02,083736,Patchell; Gregory David,20,0,30,10
1657409789638,MATH 10A,A03,083737,Patchell; Gregory David,16,0,30,14
1657409795672,MATH 10B,A01,083207,Lim; Seonhee,8,0,34,26
1657409795672,MATH 10B,A02,083208,Lim; Seonhee,9,0,35,26
1657409795672,MATH 10B,A03,093472,Lim; Seonhee,7,0,34,27
1657409795672,MATH 10B,B01,083739,Sinha; Shubham,12,0,30,18
1657409801703,MATH 18,A01,083743,Cinel; Cameron Alexander,7,0,30,23
1657409801703,MATH 18,A02,083744,Cinel; Cameron Alexander,17,0,30,13
1657409801703,MATH 18,A03,083745,Cinel; Cameron Alexander,9,0,30,21
1657409801703,MATH 18,B01,083748,Rideout; David Porter,5,0,37,32
1657409801703,MATH 18,B02,083749,Rideout; David Porter,5,0,36,31
1657409801703,MATH 18,B03,083750,Rideout; David Porter,3,0,37,34
1657409801703,MATH 18,B04,083751,Rideout; David Porter,6,0,36,30
1657409801703,MATH 18,B05,093473,Rideout; David Porter,6,0,36,30
1657409801703,MATH 18,B06,093474,Rideout; David Porter,6,0,36,30
1657409807728,MATH 20A,A01,083754,Zheng; Zequn,14,0,40,26
1657409813761,MATH 20B,A01,083756,Briones; Jor-el Thomas Caparas,4,0,36,32
1657409813761,MATH 20B,A02,083757,Briones; Jor-el Thomas Caparas,1,0,36,35
1657409813761,MATH 20B,A03,093475,Briones; Jor-el Thomas Caparas,2,0,36,34
1657409819786,MATH 20C,A01,083760,Briones; Jor-el Thomas Caparas,1,0,35,34
1657409819786,MATH 20C,A02,083761,Briones; Jor-el Thomas Caparas,8,0,35,27
1657409819786,MATH 20C,A03,093476,Briones; Jor-el Thomas Caparas,0,1,36,36
1657409819786,MATH 20C,B01,083762,Bach; Quang Tran,1,0,30,29
1657409825811,MATH 20D,A01,083765,Tran; Brian Kha,5,0,30,25
1657409825811,MATH 20D,A02,083766,Tran; Brian Kha,5,0,30,25
1657409825811,MATH 20D,A03,083767,Tran; Brian Kha,5,0,30,25
1657409831837,MATH 20E,A01,083771,Ganguly; Soumya,9,0,32,23
1657409831837,MATH 20E,A02,083772,Ganguly; Soumya,6,0,32,26
1657409831837,MATH 20E,B01,083773,Ciotti; Benjamin,20,0,35,15
1657409831837,MATH 20E,B02,083774,Ciotti; Benjamin,17,0,35,18
1657409837870,MATH 103A,A01,083777,Greenfeld; Be'Eri,3,0,36,33
1657409837870,MATH 103A,A02,083778,Greenfeld; Be'Eri,5,0,36,31
1657409837870,MATH 103A,A03,093561,Greenfeld; Be'Eri,5,0,36,31
1657409837870,MATH 103A,B01,083779,Greenfeld; Be'Eri,7,0,36,29
1657409837870,MATH 103A,B02,083780,Greenfeld; Be'Eri,4,0,36,32
1657409837870,MATH 103A,B03,093562,Greenfeld; Be'Eri,3,0,36,33
1657409843897,MATH 105,A01,085443,Carter; Anne Toulson,15,0,35,20
1657409843897,MATH 105,A02,093477,Carter; Anne Toulson,20,0,35,15
1657409849922,MATH 109,A01,083213,Ganzberger; Geoffrey Michael,2,0,34,32
1657409849922,MATH 109,A02,083214,Ganzberger; Geoffrey Michael,4,0,34,30
1657409849922,MATH 109,A03,093478,Ganzberger; Geoffrey Michael,2,0,34,32
1657409849922,MATH 109,B01,083215,Ganzberger; Geoffrey Michael,1,0,32,31
1657409849922,MATH 109,B02,083216,Ganzberger; Geoffrey Michael,2,0,32,30
1657409849922,MATH 109,B03,093479,Ganzberger; Geoffrey Michael,8,0,32,24
1657409855947,MATH 142A,A01,083219,Chow; Bennett,7,0,32,25
1657409855947,MATH 142A,A02,083220,Chow; Bennett,10,0,32,22
1657409855947,MATH 142A,A03,093480,Chow; Bennett,8,0,32,24
1657409855947,MATH 142A,B03,093481,Chow; Bennett,8,0,32,24
1657409855947,MATH 142A,B04,093558,Chow; Bennett,13,0,32,19
1657409855947,MATH 142A,B05,093559,Chow; Bennett,6,0,32,26
1657409861969,MATH 193A,A01,083224,Rotar; Vladimir,8,0,34,26
1657409861969,MATH 193A,A02,083225,Rotar; Vladimir,9,0,34,25
1657409861969,MATH 193A,A03,083781,Rotar; Vladimir,5,0,34,29
1657409861969,MATH 193A,A04,083782,Rotar; Vladimir,10,0,34,24
1657409861969,MATH 193A,A05,093482,Rotar; Vladimir,10,0,34,24
1657409867996,MATH 197,001,091859,McAuley; Julian John,9999,0,9999,0
1657409867996,MATH 197,002,095566,Kedlaya; Kiran S.,9997,0,9999,2
1657409867996,MATH 197,003,095567,Xiao; Ming,9999,0,9999,0
1657409867996,MATH 197,004,095571,Perols; Johan Lars,9998,0,9999,1
1657409875058,COGS 9,A01,083615,Shannon; Kyle Michael,9,0,75,66
1657409881085,COGS 11,A01,083617,Boyle; Mary E. T.,22,0,48,26
1657409887107,COGS 13,A01,083071,Bastos; Amalia Pinkusfeld,11,0,71,60
1657409893140,COGS 14A,A01,092681,Semenuks; Arturs,4,1,100,96
1657409899166,COGS 14B,A01,083073,Cheng; Tzu-Han,6,0,63,57
1657409905190,COGS 17,A01,092677,Semenuks; Arturs,6,0,81,75
1657409911216,COGS 100,A01,083619,Allen; Michael Gordon,17,0,70,53
1657409917239,COGS 101A,A01,083621,Davis; Joshua Daniel,9,0,68,59
1657409923261,COGS 101B,A01,091572,Allen; Michael Gordon,12,0,65,53
1657409929288,COGS 101C,A01,083625,Delgado; Tania,17,0,35,18
1657409935311,COGS 107A,A01,083627,Boyle; Mary E. T.,13,0,60,47
1657409941333,COGS 118A,A01,083075,Gupta; Anjum,20,0,76,56
1657409947372,CSE 3,A50,083646,Miranda; Gregory Joseph,24,0,50,26
1657409953399,CSE 8A,A50,083650,Miranda; Gregory Joseph,17,1,56,39
1657409959423,CSE 11,A01,083080,Cao; Yingjun,6,15,40,34
1657409965446,CSE 12,A01,083652,Krause-Levy; Sophia Louisa,28,1,120,92
1657409971477,CSE 15L,A01,083654,Morris; Justin Loren,9,0,50,41
1657409971477,CSE 15L,A02,083655,Morris; Justin Loren,9,0,50,41
1657409977501,CSE 20,A01,083657,Tran; Khoa Dang,39,0,80,41
1657409983527,CSE 21,A01,095574,Bach; Quang Tran,22,0,48,26
1657409989552,CSE 30,A01,083084,Eldon; John,4,0,80,76
1657409989552,CSE 30,B01,095061,Bhaskar; Nishant,9,0,50,41
1657409995577,CSE 100,A01,083659,Cao; Yingjun,5,4,70,65
1657410001602,CSE 134B,A01,083661,Powell; Thomas Allan,22,0,100,78
1657410007625,CSE 140,A01,083663,Gungor; Onat,14,0,85,71
1657410013647,CSE 140L,A01,083088,Eldon; John,21,0,100,79
1657410019670,CSE 175,A01,083665,Kumar; Rakesh,3,0,25,22
1657410025692,CSE 190,A00,092507,Dubnov; Shlomo,7,0,20,13
1657410031718,ECE 45,A01,083139,Congero; Spencer William,6,0,75,69
1657410037742,ECE 65,A50,083695,Saad; Andrew S,12,0,30,18
1657410037742,ECE 65,A51,095125,Saad; Andrew S,24,0,26,2
1657410043765,ECE 109,A01,091882,Touri; Behrouz,19,0,70,51
1657410049787,ECE 180,A00,083140,Abi Samra; Nicholas Camill,1,0,30,29
1657410049787,ECE 180,B00,083141,Abi Samra; Nicholas Camill,0,0,30,30
1657410055810,MATH 10A,A01,083735,Patchell; Gregory David,2,0,30,28
1657410055810,MATH 10A,A02,083736,Patchell; Gregory David,20,0,30,10
1657410055810,MATH 10A,A03,083737,Patchell; Gregory David,16,0,30,14
1657410061833,MATH 10B,A01,083207,Lim; Seonhee,8,0,34,26
1657410061833,MATH 10B,A02,083208,Lim; Seonhee,9,0,35,26
1657410061833,MATH 10B,A03,093472,Lim; Seonhee,7,0,34,27
1657410061833,MATH 10B,B01,083739,Sinha; Shubham,12,0,30,18
1657410067863,MATH 18,A01,083743,Cinel; Cameron Alexander,7,0,30,23
1657410067863,MATH 18,A02,083744,Cinel; Cameron Alexander,17,0,30,13
1657410067863,MATH 18,A03,083745,Cinel; Cameron Alexander,9,0,30,21
1657410067863,MATH 18,B01,083748,Rideout; David Porter,5,0,37,32
1657410067863,MATH 18,B02,083749,Rideout; David Porter,5,0,36,31
1657410067863,MATH 18,B03,083750,Rideout; David Porter,3,0,37,34
1657410067863,MATH 18,B04,083751,Rideout; David Porter,6,0,36,30
1657410067863,MATH 18,B05,093473,Rideout; David Porter,6,0,36,30
1657410067863,MATH 18,B06,093474,Rideout; David Porter,6,0,36,30
1657410073886,MATH 20A,A01,083754,Zheng; Zequn,14,0,40,26
1657410079913,MATH 20B,A01,083756,Briones; Jor-el Thomas Caparas,4,0,36,32
1657410079913,MATH 20B,A02,083757,Briones; Jor-el Thomas Caparas,1,0,36,35
1657410079913,MATH 20B,A03,093475,Briones; Jor-el Thomas Caparas,2,0,36,34
1657410085937,MATH 20C,A01,083760,Briones; Jor-el Thomas Caparas,1,0,35,34
1657410085937,MATH 20C,A02,083761,Briones; Jor-el Thomas Caparas,8,0,35,27
1657410085937,MATH 20C,A03,093476,Briones; Jor-el Thomas Caparas,0,1,36,36
1657410085937,MATH 20C,B01,083762,Bach; Quang Tran,1,0,30,29
1657410091960,MATH 20D,A01,083765,Tran; Brian Kha,5,0,30,25
1657410091960,MATH 20D,A02,083766,Tran; Brian Kha,5,0,30,25
1657410091960,MATH 20D,A03,083767,Tran; Brian Kha,5,0,30,25
1657410097987,MATH 20E,A01,083771,Ganguly; Soumya,9,0,32,23
1657410097987,MATH 20E,A02,083772,Ganguly; Soumya,6,0,32,26
1657410097987,MATH 20E,B01,083773,Ciotti; Benjamin,20,0,35,15
1657410097987,MATH 20E,B02,083774,Ciotti; Benjamin,17,0,35,18
1657410104010,MATH 103A,A01,083777,Greenfeld; Be'Eri,3,0,36,33
1657410104010,MATH 103A,A02,083778,Greenfeld; Be'Eri,5,0,36,31
1657410104010,MATH 103A,A03,093561,Greenfeld; Be'Eri,5,0,36,31
1657410104010,MATH 103A,B01,083779,Greenfeld; Be'Eri,7,0,36,29
1657410104010,MATH 103A,B02,083780,Greenfeld; Be'Eri,4,0,36,32
1657410104010,MATH 103A,B03,093562,Greenfeld; Be'Eri,3,0,36,33
1657410110036,MATH 105,A01,085443,Carter; Anne Toulson,15,0,35,20
1657410110036,MATH 105,A02,093477,Carter; Anne Toulson,20,0,35,15
1657410116065,MATH 109,A01,083213,Ganzberger; Geoffrey Michael,2,0,34,32
1657410116065,MATH 109,A02,083214,Ganzberger; Geoffrey Michael,4,0,34,30
1657410116065,MATH 109,A03,093478,Ganzberger; Geoffrey Michael,2,0,34,32
1657410116065,MATH 109,B01,083215,Ganzberger; Geoffrey Michael,1,0,32,31
1657410116065,MATH 109,B02,083216,Ganzberger; Geoffrey Michael,2,0,32,30
1657410116065,MATH 109,B03,093479,Ganzberger; Geoffrey Michael,8,0,32,24
1657410122095,MATH 142A,A01,083219,Chow; Bennett,7,0,32,25
1657410122095,MATH 142A,A02,083220,Chow; Bennett,10,0,32,22
1657410122095,MATH 142A,A03,093480,Chow; Bennett,8,0,32,24
1657410122095,MATH 142A,B03,093481,Chow; Bennett,8,0,32,24
1657410122095,MATH 142A,B04,093558,Chow; Bennett,13,0,32,19
1657410122095,MATH 142A,B05,093559,Chow; Bennett,6,0,32,26
1657410128119,MATH 193A,A01,083224,Rotar; Vladimir,8,0,34,26
1657410128119,MATH 193A,A02,083225,Rotar; Vladimir,9,0,34,25
1657410128119,MATH 193A,A03,083781,Rotar; Vladimir,5,0,34,29
1657410128119,MATH 193A,A04,083782,Rotar; Vladimir,10,0,34,24
1657410128119,MATH 193A,A05,093482,Rotar; Vladimir,10,0,34,24
1657410134152,MATH 197,001,091859,McAuley; Julian John,9999,0,9999,0
1657410134152,MATH 197,002,095566,Kedlaya; Kiran S.,9997,0,9999,2
1657410134152,MATH 197,003,095567,Xiao; Ming,9999,0,9999,0
1657410134152,MATH 197,004,095571,Perols; Johan Lars,9998,0,9999,1
1657410141300,COGS 9,A01,083615,Shannon; Kyle Michael,9,0,75,66
1657410147322,COGS 11,A01,083617,Boyle; Mary E. T.,22,0,48,26
1657410153346,COGS 13,A01,083071,Bastos; Amalia Pinkusfeld,11,0,71,60
1657410159369,COGS 14A,A01,092681,Semenuks; Arturs,4,1,100,96
1657410165397,COGS 14B,A01,083073,Cheng; Tzu-Han,6,0,63,57
1657410171425,COGS 17,A01,092677,Semenuks; Arturs,6,0,81,75
1657410177448,COGS 100,A01,083619,Allen; Michael Gordon,17,0,70,53
1657410183471,COGS 101A,A01,083621,Davis; Joshua Daniel,9,0,68,59
1657410189493,COGS 101B,A01,091572,Allen; Michael Gordon,12,0,65,53
1657410195531,COGS 101C,A01,083625,Delgado; Tania,17,0,35,18
1657410201556,COGS 107A,A01,083627,Boyle; Mary E. T.,13,0,60,47
1657410207579,COGS 118A,A01,083075,Gupta; Anjum,20,0,76,56
1657410213619,CSE 3,A50,083646,Miranda; Gregory Joseph,24,0,50,26
1657410219647,CSE 8A,A50,083650,Miranda; Gregory Joseph,17,1,56,39
1657410225670,CSE 11,A01,083080,Cao; Yingjun,6,15,40,34
1657410231692,CSE 12,A01,083652,Krause-Levy; Sophia Louisa,28,1,120,92
1657410237721,CSE 15L,A01,083654,Morris; Justin Loren,9,0,50,41
1657410237721,CSE 15L,A02,083655,Morris; Justin Loren,9,0,50,41
1657410243747,CSE 20,A01,083657,Tran; Khoa Dang,39,0,80,41
1657410249769,CSE 21,A01,095574,Bach; Quang Tran,22,0,48,26
1657410255792,CSE 30,A01,083084,Eldon; John,4,0,80,76
1657410255792,CSE 30,B01,095061,Bhaskar; Nishant,9,0,50,41
1657410261820,CSE 100,A01,083659,Cao; Yingjun,5,4,70,65
1657410267845,CSE 134B,A01,083661,Powell; Thomas Allan,22,0,100,78
1657410273869,CSE 140,A01,083663,Gungor; Onat,14,0,85,71
1657410279895,CSE 140L,A01,083088,Eldon; John,21,0,100,79
1657410285918,CSE 175,A01,083665,Kumar; Rakesh,3,0,25,22
1657410291945,CSE 190,A00,092507,Dubnov; Shlomo,7,0,20,13
1657410297969,ECE 45,A01,083139,Congero; Spencer William,6,0,75,69
1657410303995,ECE 65,A50,083695,Saad; Andrew S,12,0,30,18
1657410303995,ECE 65,A51,095125,Saad; Andrew S,24,0,26,2
1657410310017,ECE 109,A01,091882,Touri; Behrouz,19,0,70,51
1657410316040,ECE 180,A00,083140,Abi Samra; Nicholas Camill,1,0,30,29
1657410316040,ECE 180,B00,083141,Abi Samra; Nicholas Camill,0,0,30,30
1657410322062,MATH 10A,A01,083735,Patchell; Gregory David,2,0,30,28
1657410322062,MATH 10A,A02,083736,Patchell; Gregory David,20,0,30,10
1657410322062,MATH 10A,A03,083737,Patchell; Gregory David,16,0,30,14
1657410328087,MATH 10B,A01,083207,Lim; Seonhee,8,0,34,26
1657410328087,MATH 10B,A02,083208,Lim; Seonhee,9,0,35,26
1657410328087,MATH 10B,A03,093472,Lim; Seonhee,7,0,34,27
1657410328087,MATH 10B,B01,083739,Sinha; Shubham,12,0,30,18
1657410334113,MATH 18,A01,083743,Cinel; Cameron Alexander,7,0,30,23
1657410334113,MATH 18,A02,083744,Cinel; Cameron Alexander,17,0,30,13
1657410334113,MATH 18,A03,083745,Cinel; Cameron Alexander,9,0,30,21
1657410334113,MATH 18,B01,083748,Rideout; David Porter,5,0,37,32
1657410334113,MATH 18,B02,083749,Rideout; David Porter,5,0,36,31
1657410334113,MATH 18,B03,083750,Rideout; David Porter,3,0,37,34
1657410334113,MATH 18,B04,083751,Rideout; David Porter,6,0,36,30
1657410334113,MATH 18,B05,093473,Rideout; David Porter,6,0,36,30
1657410334113,MATH 18,B06,093474,Rideout; David Porter,6,0,36,30
1657410340138,MATH 20A,A01,083754,Zheng; Zequn,14,0,40,26
1657410346162,MATH 20B,A01,083756,Briones; Jor-el Thomas Caparas,4,0,36,32
1657410346162,MATH 20B,A02,083757,Briones; Jor-el Thomas Caparas,1,0,36,35
1657410346162,MATH 20B,A03,093475,Briones; Jor-el Thomas Caparas,2,0,36,34
1657410352185,MATH 20C,A01,083760,Briones; Jor-el Thomas Caparas,1,0,35,34
1657410352185,MATH 20C,A02,083761,Briones; Jor-el Thomas Caparas,8,0,35,27
1657410352185,MATH 20C,A03,093476,Briones; Jor-el Thomas Caparas,0,1,36,36
1657410352185,MATH 20C,B01,083762,Bach; Quang Tran,1,0,30,29
1657410358214,MATH 20D,A01,083765,Tran; Brian Kha,5,0,30,25
1657410358214,MATH 20D,A02,083766,Tran; Brian Kha,5,0,30,25
1657410358214,MATH 20D,A03,083767,Tran; Brian Kha,5,0,30,25
1657410364243,MATH 20E,A01,083771,Ganguly; Soumya,9,0,32,23
1657410364243,MATH 20E,A02,083772,Ganguly; Soumya,6,0,32,26
1657410364243,MATH 20E,B01,083773,Ciotti; Benjamin,20,0,35,15
1657410364243,MATH 20E,B02,083774,Ciotti; Benjamin,17,0,35,18
1657410370276,MATH 103A,A01,083777,Greenfeld; Be'Eri,3,0,36,33
1657410370276,MATH 103A,A02,083778,Greenfeld; Be'Eri,5,0,36,31
1657410370276,MATH 103A,A03,093561,Greenfeld; Be'Eri,5,0,36,31
1657410370276,MATH 103A,B01,083779,Greenfeld; Be'Eri,7,0,36,29
1657410370276,MATH 103A,B02,083780,Greenfeld; Be'Eri,4,0,36,32
1657410370276,MATH 103A,B03,093562,Greenfeld; Be'Eri,3,0,36,33
1657410376298,MATH 105,A01,085443,Carter; Anne Toulson,15,0,35,20
1657410376298,MATH 105,A02,093477,Carter; Anne Toulson,20,0,35,15
1657410382326,MATH 109,A01,083213,Ganzberger; Geoffrey Michael,2,0,34,32
1657410382326,MATH 109,A02,083214,Ganzberger; Geoffrey Michael,4,0,34,30
1657410382326,MATH 109,A03,093478,Ganzberger; Geoffrey Michael,2,0,34,32
1657410382326,MATH 109,B01,083215,Ganzberger; Geoffrey Michael,1,0,32,31
1657410382326,MATH 109,B02,083216,Ganzberger; Geoffrey Michael,2,0,32,30
1657410382326,MATH 109,B03,093479,Ganzberger; Geoffrey Michael,8,0,32,24
1657410388355,MATH 142A,A01,083219,Chow; Bennett,7,0,32,25
1657410388355,MATH 142A,A02,083220,Chow; Bennett,10,0,32,22
1657410388355,MATH 142A,A03,093480,Chow; Bennett,8,0,32,24
1657410388355,MATH 142A,B03,093481,Chow; Bennett,8,0,32,24
1657410388355,MATH 142A,B04,093558,Chow; Bennett,13,0,32,19
1657410388355,MATH 142A,B05,093559,Chow; Bennett,6,0,32,26
1657410394379,MATH 193A,A01,083224,Rotar; Vladimir,8,0,34,26
1657410394379,MATH 193A,A02,083225,Rotar; Vladimir,9,0,34,25
1657410394379,MATH 193A,A03,083781,Rotar; Vladimir,5,0,34,29
1657410394379,MATH 193A,A04,083782,Rotar; Vladimir,10,0,34,24
1657410394379,MATH 193A,A05,093482,Rotar; Vladimir,10,0,34,24
1657410400403,MATH 197,001,091859,McAuley; Julian John,9999,0,9999,0
1657410400403,MATH 197,002,095566,Kedlaya; Kiran S.,9997,0,9999,2
1657410400403,MATH 197,003,095567,Xiao; Ming,9999,0,9999,0
1657410400403,MATH 197,004,095571,Perols; Johan Lars,9998,0,9999,1
1657410407460,COGS 9,A01,083615,Shannon; Kyle Michael,9,0,75,66
1657410413483,COGS 11,A01,083617,Boyle; Mary E. T.,22,0,48,26
1657410419509,COGS 13,A01,083071,Bastos; Amalia Pinkusfeld,11,0,71,60
1657410425540,COGS 14A,A01,092681,Semenuks; Arturs,4,1,100,96
1657410431565,COGS 14B,A01,083073,Cheng; Tzu-Han,6,0,63,57
1657410437591,COGS 17,A01,092677,Semenuks; Arturs,6,0,81,75
1657410443615,COGS 100,A01,083619,Allen; Michael Gordon,17,0,70,53
1657410449642,COGS 101A,A01,083621,Davis; Joshua Daniel,9,0,68,59
1657410455664,COGS 101B,A01,091572,Allen; Michael Gordon,12,0,65,53
1657410461687,COGS 101C,A01,083625,Delgado; Tania,17,0,35,18
1657410467712,COGS 107A,A01,083627,Boyle; Mary E. T.,13,0,60,47
1657410473755,COGS 118A,A01,083075,Gupta; Anjum,20,0,76,56
1657410479784,CSE 3,A50,083646,Miranda; Gregory Joseph,24,0,50,26
1657410485811,CSE 8A,A50,083650,Miranda; Gregory Joseph,17,1,56,39
1657410491838,CSE 11,A01,083080,Cao; Yingjun,6,15,40,34
1657410497862,CSE 12,A01,083652,Krause-Levy; Sophia Louisa,28,1,120,92
1657410503884,CSE 15L,A01,083654,Morris; Justin Loren,9,0,50,41
1657410503884,CSE 15L,A02,083655,Morris; Justin Loren,9,0,50,41
1657410509906,CSE 20,A01,083657,Tran; Khoa Dang,39,0,80,41
1657410515930,CSE 21,A01,095574,Bach; Quang Tran,22,0,48,26
1657410521956,CSE 30,A01,083084,Eldon; John,4,0,80,76
1657410521956,CSE 30,B01,095061,Bhaskar; Nishant,9,0,50,41
1657410527978,CSE 100,A01,083659,Cao; Yingjun,5,4,70,65
1657410534005,CSE 134B,A01,083661,Powell; Thomas Allan,22,0,100,78
1657410540028,CSE 140,A01,083663,Gungor; Onat,14,0,85,71
1657410546065,CSE 140L,A01,083088,Eldon; John,21,0,100,79
1657410552091,CSE 175,A01,083665,Kumar; Rakesh,3,0,25,22
1657410558120,CSE 190,A00,092507,Dubnov; Shlomo,7,0,20,13
1657410564144,ECE 45,A01,083139,Congero; Spencer William,6,0,75,69
1657410570167,ECE 65,A50,083695,Saad; Andrew S,12,0,30,18
1657410570167,ECE 65,A51,095125,Saad; Andrew S,24,0,26,2
1657410576195,ECE 109,A01,091882,Touri; Behrouz,19,0,70,51
1657410582218,ECE 180,A00,083140,Abi Samra; Nicholas Camill,1,0,30,29
1657410582218,ECE 180,B00,083141,Abi Samra; Nicholas Camill,0,0,30,30
1657410588245,MATH 10A,A01,083735,Patchell; Gregory David,2,0,30,28
1657410588245,MATH 10A,A02,083736,Patchell; Gregory David,20,0,30,10
1657410588245,MATH 10A,A03,083737,Patchell; Gregory David,16,0,30,14
1657410594274,MATH 10B,A01,083207,Lim; Seonhee,8,0,34,26
1657410594274,MATH 10B,A02,083208,Lim; Seonhee,9,0,35,26
1657410594274,MATH 10B,A03,093472,Lim; Seonhee,7,0,34,27
1657410594274,MATH 10B,B01,083739,Sinha; Shubham,12,0,30,18
1657410600313,MATH 18,A01,083743,Cinel; Cameron Alexander,7,0,30,23
1657410600313,MATH 18,A02,083744,Cinel; Cameron Alexander,17,0,30,13
1657410600313,MATH 18,A03,083745,Cinel; Cameron Alexander,9,0,30,21
1657410600313,MATH 18,B01,083748,Rideout; David Porter,5,0,37,32
1657410600313,MATH 18,B02,083749,Rideout; David Porter,5,0,36,31
1657410600313,MATH 18,B03,083750,Rideout; David Porter,3,0,37,34
1657410600313,MATH 18,B04,083751,Rideout; David Porter,6,0,36,30
1657410600313,MATH 18,B05,093473,Rideout; David Porter,6,0,36,30
1657410600313,MATH 18,B06,093474,Rideout; David Porter,6,0,36,30
1657410606336,MATH 20A,A01,083754,Zheng; Zequn,14,0,40,26
1657410612365,MATH 20B,A01,083756,Briones; Jor-el Thomas Caparas,4,0,36,32
1657410612365,MATH 20B,A02,083757,Briones; Jor-el Thomas Caparas,1,0,36,35
1657410612365,MATH 20B,A03,093475,Briones; Jor-el Thomas Caparas,2,0,36,34
1657410618394,MATH 20C,A01,083760,Briones; Jor-el Thomas Caparas,1,0,35,34
1657410618394,MATH 20C,A02,083761,Briones; Jor-el Thomas Caparas,8,0,35,27
1657410618394,MATH 20C,A03,093476,Briones; Jor-el Thomas Caparas,0,1,36,36
1657410618394,MATH 20C,B01,083762,Bach; Quang Tran,1,0,30,29
1657410624422,MATH 20D,A01,083765,Tran; Brian Kha,5,0,30,25
1657410624422,MATH 20D,A02,083766,Tran; Brian Kha,5,0,30,25
1657410624422,MATH 20D,A03,083767,Tran; Brian Kha,5,0,30,25
1657410630450,MATH 20E,A01,083771,Ganguly; Soumya,9,0,32,23
1657410630450,MATH 20E,A02,083772,Ganguly; Soumya,6,0,32,26
1657410630450,MATH 20E,B01,083773,Ciotti; Benjamin,20,0,35,15
1657410630450,MATH 20E,B02,083774,Ciotti; Benjamin,17,0,35,18
1657410636481,MATH 103A,A01,083777,Greenfeld; Be'Eri,3,0,36,33
1657410636481,MATH 103A,A02,083778,Greenfeld; Be'Eri,5,0,36,31
1657410636481,MATH 103A,A03,093561,Greenfeld; Be'Eri,5,0,36,31
1657410636481,MATH 103A,B01,083779,Greenfeld; Be'Eri,7,0,36,29
1657410636481,MATH 103A,B02,083780,Greenfeld; Be'Eri,4,0,36,32
1657410636481,MATH 103A,B03,093562,Greenfeld; Be'Eri,3,0,36,33
1657410642509,MATH 105,A01,085443,Carter; Anne Toulson,15,0,35,20
1657410642509,MATH 105,A02,093477,Carter; Anne Toulson,20,0,35,15
1657410648532,MATH 109,A01,083213,Ganzberger; Geoffrey Michael,2,0,34,32
1657410648532,MATH 109,A02,083214,Ganzberger; Geoffrey Michael,4,0,34,30
1657410648532,MATH 109,A03,093478,Ganzberger; Geoffrey Michael,2,0,34,32
1657410648532,MATH 109,B01,083215,Ganzberger; Geoffrey Michael,1,0,32,31
1657410648532,MATH 109,B02,083216,Ganzberger; Geoffrey Michael,2,0,32,30
1657410648532,MATH 109,B03,093479,Ganzberger; Geoffrey Michael,8,0,32,24
1657410654554,MATH 142A,A01,083219,Chow; Bennett,7,0,32,25
1657410654554,MATH 142A,A02,083220,Chow; Bennett,10,0,32,22
1657410654554,MATH 142A,A03,093480,Chow; Bennett,8,0,32,24
1657410654554,MATH 142A,B03,093481,Chow; Bennett,8,0,32,24
1657410654554,MATH 142A,B04,093558,Chow; Bennett,13,0,32,19
1657410654554,MATH 142A,B05,093559,Chow; Bennett,6,0,32,26
1657410660577,MATH 193A,A01,083224,Rotar; Vladimir,8,0,34,26
1657410660577,MATH 193A,A02,083225,Rotar; Vladimir,9,0,34,25
1657410660577,MATH 193A,A03,083781,Rotar; Vladimir,5,0,34,29
1657410660577,MATH 193A,A04,083782,Rotar; Vladimir,10,0,34,24
1657410660577,MATH 193A,A05,093482,Rotar; Vladimir,10,0,34,24
1657410666604,MATH 197,001,091859,McAuley; Julian John,9999,0,9999,0
1657410666604,MATH 197,002,095566,Kedlaya; Kiran S.,9997,0,9999,2
1657410666604,MATH 197,003,095567,Xiao; Ming,9999,0,9999,0
1657410666604,MATH 197,004,095571,Perols; Johan Lars,9998,0,9999,1
1657410673665,COGS 9,A01,083615,Shannon; Kyle Michael,9,0,75,66
1657410679688,COGS 11,A01,083617,Boyle; Mary E. T.,22,0,48,26
1657410685716,COGS 13,A01,083071,Bastos; Amalia Pinkusfeld,11,0,71,60
1657410691744,COGS 14A,A01,092681,Semenuks; Arturs,4,1,100,96
1657410697768,COGS 14B,A01,083073,Cheng; Tzu-Han,6,0,63,57
1657410703792,COGS 17,A01,092677,Semenuks; Arturs,6,0,81,75
1657410709816,COGS 100,A01,083619,Allen; Michael Gordon,17,0,70,53
1657410715838,COGS 101A,A01,083621,Davis; Joshua Daniel,9,0,68,59
1657410721861,COGS 101B,A01,091572,Allen; Michael Gordon,12,0,65,53
1657410727885,COGS 101C,A01,083625,Delgado; Tania,17,0,35,18
1657410733908,COGS 107A,A01,083627,Boyle; Mary E. T.,13,0,60,47
1657410740014,COGS 118A,A01,083075,Gupta; Anjum,20,0,76,56
1657410746043,CSE 3,A50,083646,Miranda; Gregory Joseph,24,0,50,26
1657410752069,CSE 8A,A50,083650,Miranda; Gregory Joseph,17,1,56,39
1657410758094,CSE 11,A01,083080,Cao; Yingjun,6,15,40,34
1657410764120,CSE 12,A01,083652,Krause-Levy; Sophia Louisa,28,1,120,92
1657410770143,CSE 15L,A01,083654,Morris; Justin Loren,9,0,50,41
1657410770143,CSE 15L,A02,083655,Morris; Justin Loren,9,0,50,41
1657410776165,CSE 20,A01,083657,Tran; Khoa Dang,39,0,80,41
1657410782189,CSE 21,A01,095574,Bach; Quang Tran,22,0,48,26
1657410788213,CSE 30,A01,083084,Eldon; John,4,0,80,76
1657410788213,CSE 30,B01,095061,Bhaskar; Nishant,9,0,50,41
1657410794236,CSE 100,A01,083659,Cao; Yingjun,5,4,70,65
1657410800262,CSE 134B,A01,083661,Powell; Thomas Allan,22,0,100,78
1657410806286,CSE 140,A01,083663,Gungor; Onat,14,0,85,71
1657410812312,CSE 140L,A01,083088,Eldon; John,21,0,100,79
1657410818334,CSE 175,A01,083665,Kumar; Rakesh,3,0,25,22
1657410824360,CSE 190,A00,092507,Dubnov; Shlomo,7,0,20,13
1657410830383,ECE 45,A01,083139,Congero; Spencer William,6,0,75,69
1657410836405,ECE 65,A50,083695,Saad; Andrew S,12,0,30,18
1657410836405,ECE 65,A51,095125,Saad; Andrew S,24,0,26,2
1657410842432,ECE 109,A01,091882,Touri; Behrouz,19,0,70,51
1657410848456,ECE 180,A00,083140,Abi Samra; Nicholas Camill,1,0,30,29
1657410848456,ECE 180,B00,083141,Abi Samra; Nicholas Camill,0,0,30,30
1657410854479,MATH 10A,A01,083735,Patchell; Gregory David,2,0,30,28
1657410854479,MATH 10A,A02,083736,Patchell; Gregory David,20,0,30,10
1657410854479,MATH 10A,A03,083737,Patchell; Gregory David,16,0,30,14
1657410860507,MATH 10B,A01,083207,Lim; Seonhee,8,0,34,26
1657410860507,MATH 10B,A02,083208,Lim; Seonhee,9,0,35,26
1657410860507,MATH 10B,A03,093472,Lim; Seonhee,7,0,34,27
1657410860507,MATH 10B,B01,083739,Sinha; Shubham,12,0,30,18
1657410866532,MATH 18,A01,083743,Cinel; Cameron Alexander,7,0,30,23
1657410866532,MATH 18,A02,083744,Cinel; Cameron Alexander,17,0,30,13
1657410866532,MATH 18,A03,083745,Cinel; Cameron Alexander,9,0,30,21
1657410866532,MATH 18,B01,083748,Rideout; David Porter,5,0,37,32
1657410866532,MATH 18,B02,083749,Rideout; David Porter,5,0,36,31
1657410866532,MATH 18,B03,083750,Rideout; David Porter,3,0,37,34
1657410866532,MATH 18,B04,083751,Rideout; David Porter,6,0,36,30
1657410866532,MATH 18,B05,093473,Rideout; David Porter,6,0,36,30
1657410866532,MATH 18,B06,093474,Rideout; David Porter,6,0,36,30
1657410872556,MATH 20A,A01,083754,Zheng; Zequn,14,0,40,26
1657410878600,MATH 20B,A01,083756,Briones; Jor-el Thomas Caparas,4,0,36,32
1657410878600,MATH 20B,A02,083757,Briones; Jor-el Thomas Caparas,1,0,36,35
1657410878600,MATH 20B,A03,093475,Briones; Jor-el Thomas Caparas,2,0,36,34
1657410884623,MATH 20C,A01,083760,Briones; Jor-el Thomas Caparas,1,0,35,34
1657410884623,MATH 20C,A02,083761,Briones; Jor-el Thomas Caparas,8,0,35,27
1657410884623,MATH 20C,A03,093476,Briones; Jor-el Thomas Caparas,0,1,36,36
1657410884623,MATH 20C,B01,083762,Bach; Quang Tran,1,0,30,29
1657410890651,MATH 20D,A01,083765,Tran; Brian Kha,5,0,30,25
1657410890651,MATH 20D,A02,083766,Tran; Brian Kha,5,0,30,25
1657410890651,MATH 20D,A03,083767,Tran; Brian Kha,5,0,30,25
1657410896674,MATH 20E,A01,083771,Ganguly; Soumya,9,0,32,23
1657410896674,MATH 20E,A02,083772,Ganguly; Soumya,6,0,32,26
1657410896674,MATH 20E,B01,083773,Ciotti; Benjamin,20,0,35,15
1657410896674,MATH 20E,B02,083774,Ciotti; Benjamin,17,0,35,18
1657410902701,MATH 103A,A01,083777,Greenfeld; Be'Eri,3,0,36,33
1657410902701,MATH 103A,A02,083778,Greenfeld; Be'Eri,5,0,36,31
1657410902701,MATH 103A,A03,093561,Greenfeld; Be'Eri,5,0,36,31
1657410902701,MATH 103A,B01,083779,Greenfeld; Be'Eri,7,0,36,29
1657410902701,MATH 103A,B02,083780,Greenfeld; Be'Eri,4,0,36,32
1657410902701,MATH 103A,B03,093562,Greenfeld; Be'Eri,3,0,36,33
1657410908724,MATH 105,A01,085443,Carter; Anne Toulson,15,0,35,20
1657410908724,MATH 105,A02,093477,Carter; Anne Toulson,20,0,35,15
1657410914753,MATH 109,A01,083213,Ganzberger; Geoffrey Michael,2,0,34,32
1657410914753,MATH 109,A02,083214,Ganzberger; Geoffrey Michael,4,0,34,30
1657410914753,MATH 109,A03,093478,Ganzberger; Geoffrey Michael,2,0,34,32
1657410914753,MATH 109,B01,083215,Ganzberger; Geoffrey Michael,1,0,32,31
1657410914753,MATH 109,B02,083216,Ganzberger; Geoffrey Michael,2,0,32,30
1657410914753,MATH 109,B03,093479,Ganzberger; Geoffrey Michael,8,0,32,24
1657410920784,MATH 142A,A01,083219,Chow; Bennett,7,0,32,25
1657410920784,MATH 142A,A02,083220,Chow; Bennett,10,0,32,22
1657410920784,MATH 142A,A03,093480,Chow; Bennett,8,0,32,24
1657410920784,MATH 142A,B03,093481,Chow; Bennett,8,0,32,24
1657410920784,MATH 142A,B04,093558,Chow; Bennett,13,0,32,19
1657410920784,MATH 142A,B05,093559,Chow; Bennett,6,0,32,26
1657410926807,MATH 193A,A01,083224,Rotar; Vladimir,8,0,34,26
1657410926807,MATH 193A,A02,083225,Rotar; Vladimir,9,0,34,25
1657410926807,MATH 193A,A03,083781,Rotar; Vladimir,5,0,34,29
1657410926807,MATH 193A,A04,083782,Rotar; Vladimir,10,0,34,24
1657410926807,MATH 193A,A05,093482,Rotar; Vladimir,10,0,34,24
1657410932831,MATH 197,001,091859,McAuley; Julian John,9999,0,9999,0
1657410932831,MATH 197,002,095566,Kedlaya; Kiran S.,9997,0,9999,2
1657410932831,MATH 197,003,095567,Xiao; Ming,9999,0,9999,0
1657410932831,MATH 197,004,095571,Perols; Johan Lars,9998,0,9999,1
1657410939896,COGS 9,A01,083615,Shannon; Kyle Michael,9,0,75,66
1657410945919,COGS 11,A01,083617,Boyle; Mary E. T.,22,0,48,26
1657410951946,COGS 13,A01,083071,Bastos; Amalia Pinkusfeld,11,0,71,60
1657410957984,COGS 14A,A01,092681,Semenuks; Arturs,4,1,100,96
1657410964014,COGS 14B,A01,083073,Cheng; Tzu-Han,6,0,63,57
1657410970039,COGS 17,A01,092677,Semenuks; Arturs,6,0,81,75
1657410976063,COGS 100,A01,083619,Allen; Michael Gordon,17,0,70,53
1657410982087,COGS 101A,A01,083621,Davis; Joshua Daniel,9,0,68,59
1657410988111,COGS 101B,A01,091572,Allen; Michael Gordon,12,0,65,53
1657410994135,COGS 101C,A01,083625,Delgado; Tania,17,0,35,18
1657411000158,COGS 107A,A01,083627,Boyle; Mary E. T.,13,0,60,47
1657411006183,COGS 118A,A01,083075,Gupta; Anjum,20,0,76,56
1657411012209,CSE 3,A50,083646,Miranda; Gregory Joseph,24,0,50,26
1657411018233,CSE 8A,A50,083650,Miranda; Gregory Joseph,17,1,56,39
1657411024257,CSE 11,A01,083080,Cao; Yingjun,6,15,40,34
1657411030279,CSE 12,A01,083652,Krause-Levy; Sophia Louisa,28,1,120,92
1657411036302,CSE 15L,A01,083654,Morris; Justin Loren,9,0,50,41
1657411036302,CSE 15L,A02,083655,Morris; Justin Loren,9,0,50,41
1657411042328,CSE 20,A01,083657,Tran; Khoa Dang,39,0,80,41
1657411048353,CSE 21,A01,095574,Bach; Quang Tran,22,0,48,26
1657411054378,CSE 30,A01,083084,Eldon; John,4,0,80,76
1657411054378,CSE 30,B01,095061,Bhaskar; Nishant,9,0,50,41
1657411060402,CSE 100,A01,083659,Cao; Yingjun,5,4,70,65
1657411066425,CSE 134B,A01,083661,Powell; Thomas Allan,22,0,100,78
1657411072452,CSE 140,A01,083663,Gungor; Onat,14,0,85,71
1657411078477,CSE 140L,A01,083088,Eldon; John,21,0,100,79
1657411084499,CSE 175,A01,083665,Kumar; Rakesh,3,0,25,22
1657411090525,CSE 190,A00,092507,Dubnov; Shlomo,7,0,20,13
1657411096547,ECE 45,A01,083139,Congero; Spencer William,6,0,75,69
1657411102570,ECE 65,A50,083695,Saad; Andrew S,12,0,30,18
1657411102570,ECE 65,A51,095125,Saad; Andrew S,24,0,26,2
1657411108593,ECE 109,A01,091882,Touri; Behrouz,19,0,70,51
1657411114615,ECE 180,A00,083140,Abi Samra; Nicholas Camill,1,0,30,29
1657411114615,ECE 180,B00,083141,Abi Samra; Nicholas Camill,0,0,30,30
1657411120638,MATH 10A,A01,083735,Patchell; Gregory David,2,0,30,28
1657411120638,MATH 10A,A02,083736,Patchell; Gregory David,20,0,30,10
1657411120638,MATH 10A,A03,083737,Patchell; Gregory David,16,0,30,14
1657411126665,MATH 10B,A01,083207,Lim; Seonhee,8,0,34,26
1657411126665,MATH 10B,A02,083208,Lim; Seonhee,9,0,35,26
1657411126665,MATH 10B,A03,093472,Lim; Seonhee,7,0,34,27
1657411126665,MATH 10B,B01,083739,Sinha; Shubham,12,0,30,18
1657411132699,MATH 18,A01,083743,Cinel; Cameron Alexander,7,0,30,23
1657411132699,MATH 18,A02,083744,Cinel; Cameron Alexander,17,0,30,13
1657411132699,MATH 18,A03,083745,Cinel; Cameron Alexander,9,0,30,21
1657411132699,MATH 18,B01,083748,Rideout; David Porter,5,0,37,32
1657411132699,MATH 18,B02,083749,Rideout; David Porter,5,0,36,31
1657411132699,MATH 18,B03,083750,Rideout; David Porter,3,0,37,34
1657411132699,MATH 18,B04,083751,Rideout; David Porter,6,0,36,30
1657411132699,MATH 18,B05,093473,Rideout; David Porter,6,0,36,30
1657411132699,MATH 18,B06,093474,Rideout; David Porter,6,0,36,30
1657411138722,MATH 20A,A01,083754,Zheng; Zequn,14,0,40,26
1657411144744,MATH 20B,A01,083756,Briones; Jor-el Thomas Caparas,4,0,36,32
1657411144744,MATH 20B,A02,083757,Briones; Jor-el Thomas Caparas,1,0,36,35
1657411144744,MATH 20B,A03,093475,Briones; Jor-el Thomas Caparas,2,0,36,34
1657411150767,MATH 20C,A01,083760,Briones; Jor-el Thomas Caparas,1,0,35,34
1657411150767,MATH 20C,A02,083761,Briones; Jor-el Thomas Caparas,8,0,35,27
1657411150767,MATH 20C,A03,093476,Briones; Jor-el Thomas Caparas,0,1,36,36
1657411150767,MATH 20C,B01,083762,Bach; Quang Tran,1,0,30,29
1657411156793,MATH 20D,A01,083765,Tran; Brian Kha,5,0,30,25
1657411156793,MATH 20D,A02,083766,Tran; Brian Kha,5,0,30,25
1657411156793,MATH 20D,A03,083767,Tran; Brian Kha,5,0,30,25
1657411162822,MATH 20E,A01,083771,Ganguly; Soumya,9,0,32,23
1657411162822,MATH 20E,A02,083772,Ganguly; Soumya,6,0,32,26
1657411162822,MATH 20E,B01,083773,Ciotti; Benjamin,20,0,35,15
1657411162822,MATH 20E,B02,083774,Ciotti; Benjamin,17,0,35,18
1657411168845,MATH 103A,A01,083777,Greenfeld; Be'Eri,3,0,36,33
1657411168845,MATH 103A,A02,083778,Greenfeld; Be'Eri,5,0,36,31
1657411168845,MATH 103A,A03,093561,Greenfeld; Be'Eri,5,0,36,31
1657411168845,MATH 103A,B01,083779,Greenfeld; Be'Eri,7,0,36,29
1657411168845,MATH 103A,B02,083780,Greenfeld; Be'Eri,4,0,36,32
1657411168845,MATH 103A,B03,093562,Greenfeld; Be'Eri,3,0,36,33
1657411174868,MATH 105,A01,085443,Carter; Anne Toulson,15,0,35,20
1657411174868,MATH 105,A02,093477,Carter; Anne Toulson,20,0,35,15
1657411180895,MATH 109,A01,083213,Ganzberger; Geoffrey Michael,2,0,34,32
1657411180895,MATH 109,A02,083214,Ganzberger; Geoffrey Michael,4,0,34,30
1657411180895,MATH 109,A03,093478,Ganzberger; Geoffrey Michael,2,0,34,32
1657411180895,MATH 109,B01,083215,Ganzberger; Geoffrey Michael,1,0,32,31
1657411180895,MATH 109,B02,083216,Ganzberger; Geoffrey Michael,2,0,32,30
1657411180895,MATH 109,B03,093479,Ganzberger; Geoffrey Michael,8,0,32,24
1657411186924,MATH 142A,A01,083219,Chow; Bennett,7,0,32,25
1657411186924,MATH 142A,A02,083220,Chow; Bennett,10,0,32,22
1657411186924,MATH 142A,A03,093480,Chow; Bennett,8,0,32,24
1657411186924,MATH 142A,B03,093481,Chow; Bennett,8,0,32,24
1657411186924,MATH 142A,B04,093558,Chow; Bennett,13,0,32,19
1657411186924,MATH 142A,B05,093559,Chow; Bennett,6,0,32,26
1657411192953,MATH 193A,A01,083224,Rotar; Vladimir,8,0,34,26
1657411192953,MATH 193A,A02,083225,Rotar; Vladimir,9,0,34,25
1657411192953,MATH 193A,A03,083781,Rotar; Vladimir,5,0,34,29
1657411192953,MATH 193A,A04,083782,Rotar; Vladimir,10,0,34,24
1657411192953,MATH 193A,A05,093482,Rotar; Vladimir,10,0,34,24
1657411198977,MATH 197,001,091859,McAuley; Julian John,9999,0,9999,0
1657411198977,MATH 197,002,095566,Kedlaya; Kiran S.,9997,0,9999,2
1657411198977,MATH 197,003,095567,Xiao; Ming,9999,0,9999,0
1657411198977,MATH 197,004,095571,Perols; Johan Lars,9998,0,9999,1
1657411206075,COGS 9,A01,083615,Shannon; Kyle Michael,9,0,75,66
1657411212099,COGS 11,A01,083617,Boyle; Mary E. T.,22,0,48,26
1657411218122,COGS 13,A01,083071,Bastos; Amalia Pinkusfeld,11,0,71,60
1657411224165,COGS 14A,A01,092681,Semenuks; Arturs,4,1,100,96
1657411230187,COGS 14B,A01,083073,Cheng; Tzu-Han,6,0,63,57
1657411236209,COGS 17,A01,092677,Semenuks; Arturs,6,0,81,75
1657411242232,COGS 100,A01,083619,Allen; Michael Gordon,17,0,70,53
1657411248257,COGS 101A,A01,083621,Davis; Joshua Daniel,9,0,68,59
1657411254283,COGS 101B,A01,091572,Allen; Michael Gordon,12,0,65,53
1657411260309,COGS 101C,A01,083625,Delgado; Tania,17,0,35,18
1657411266332,COGS 107A,A01,083627,Boyle; Mary E. T.,13,0,60,47
1657411272355,COGS 118A,A01,083075,Gupta; Anjum,20,0,76,56
1657411278385,CSE 3,A50,083646,Miranda; Gregory Joseph,24,0,50,26
1657411284414,CSE 8A,A50,083650,Miranda; Gregory Joseph,17,1,56,39
1657411290440,CSE 11,A01,083080,Cao; Yingjun,6,15,40,34
1657411296464,CSE 12,A01,083652,Krause-Levy; Sophia Louisa,28,1,120,92
1657411302487,CSE 15L,A01,083654,Morris; Justin Loren,9,0,50,41
1657411302487,CSE 15L,A02,083655,Morris; Justin Loren,9,0,50,41
1657411308512,CSE 20,A01,083657,Tran; Khoa Dang,39,0,80,41
1657411314534,CSE 21,A01,095574,Bach; Quang Tran,22,0,48,26
1657411320559,CSE 30,A01,083084,Eldon; John,4,0,80,76
1657411320559,CSE 30,B01,095061,Bhaskar; Nishant,9,0,50,41
1657411326582,CSE 100,A01,083659,Cao; Yingjun,5,4,70,65
1657411332605,CSE 134B,A01,083661,Powell; Thomas Allan,22,0,100,78
1657411338702,CSE 140,A01,083663,Gungor; Onat,14,0,85,71
1657411344727,CSE 140L,A01,083088,Eldon; John,21,0,100,79
1657411350751,CSE 175,A01,083665,Kumar; Rakesh,3,0,25,22
1657411356774,CSE 190,A00,092507,Dubnov; Shlomo,7,0,20,13
1657411362798,ECE 45,A01,083139,Congero; Spencer William,6,0,75,69
1657411368820,ECE 65,A50,083695,Saad; Andrew S,12,0,30,18
1657411368820,ECE 65,A51,095125,Saad; Andrew S,24,0,26,2
1657411374844,ECE 109,A01,091882,Touri; Behrouz,19,0,70,51
1657411380871,ECE 180,A00,083140,Abi Samra; Nicholas Camill,1,0,30,29
1657411380871,ECE 180,B00,083141,Abi Samra; Nicholas Camill,0,0,30,30
1657411386894,MATH 10A,A01,083735,Patchell; Gregory David,2,0,30,28
1657411386894,MATH 10A,A02,083736,Patchell; Gregory David,20,0,30,10
1657411386894,MATH 10A,A03,083737,Patchell; Gregory David,16,0,30,14
1657411392922,MATH 10B,A01,083207,Lim; Seonhee,8,0,34,26
1657411392922,MATH 10B,A02,083208,Lim; Seonhee,9,0,35,26
1657411392922,MATH 10B,A03,093472,Lim; Seonhee,7,0,34,27
1657411392922,MATH 10B,B01,083739,Sinha; Shubham,12,0,30,18
1657411398954,MATH 18,A01,083743,Cinel; Cameron Alexander,7,0,30,23
1657411398954,MATH 18,A02,083744,Cinel; Cameron Alexander,17,0,30,13
1657411398954,MATH 18,A03,083745,Cinel; Cameron Alexander,9,0,30,21
1657411398954,MATH 18,B01,083748,Rideout; David Porter,5,0,37,32
1657411398954,MATH 18,B02,083749,Rideout; David Porter,5,0,36,31
1657411398954,MATH 18,B03,083750,Rideout; David Porter,3,0,37,34
1657411398954,MATH 18,B04,083751,Rideout; David Porter,6,0,36,30
1657411398954,MATH 18,B05,093473,Rideout; David Porter,6,0,36,30
1657411398954,MATH 18,B06,093474,Rideout; David Porter,6,0,36,30
1657411404982,MATH 20A,A01,083754,Zheng; Zequn,14,0,40,26
1657411411009,MATH 20B,A01,083756,Briones; Jor-el Thomas Caparas,4,0,36,32
1657411411009,MATH 20B,A02,083757,Briones; Jor-el Thomas Caparas,1,0,36,35
1657411411009,MATH 20B,A03,093475,Briones; Jor-el Thomas Caparas,2,0,36,34
1657411417047,MATH 20C,A01,083760,Briones; Jor-el Thomas Caparas,1,0,35,34
1657411417047,MATH 20C,A02,083761,Briones; Jor-el Thomas Caparas,8,0,35,27
1657411417047,MATH 20C,A03,093476,Briones; Jor-el Thomas Caparas,0,1,36,36
1657411417047,MATH 20C,B01,083762,Bach; Quang Tran,1,0,30,29
1657411423072,MATH 20D,A01,083765,Tran; Brian Kha,5,0,30,25
1657411423072,MATH 20D,A02,083766,Tran; Brian Kha,5,0,30,25
1657411423072,MATH 20D,A03,083767,Tran; Brian Kha,5,0,30,25
1657411429097,MATH 20E,A01,083771,Ganguly; Soumya,9,0,32,23
1657411429097,MATH 20E,A02,083772,Ganguly; Soumya,6,0,32,26
1657411429097,MATH 20E,B01,083773,Ciotti; Benjamin,20,0,35,15
1657411429097,MATH 20E,B02,083774,Ciotti; Benjamin,17,0,35,18
1657411435126,MATH 103A,A01,083777,Greenfeld; Be'Eri,3,0,36,33
1657411435126,MATH 103A,A02,083778,Greenfeld; Be'Eri,5,0,36,31
1657411435126,MATH 103A,A03,093561,Greenfeld; Be'Eri,5,0,36,31
1657411435126,MATH 103A,B01,083779,Greenfeld; Be'Eri,7,0,36,29
1657411435126,MATH 103A,B02,083780,Greenfeld; Be'Eri,4,0,36,32
1657411435126,MATH 103A,B03,093562,Greenfeld; Be'Eri,3,0,36,33
1657411441148,MATH 105,A01,085443,Carter; Anne Toulson,15,0,35,20
1657411441148,MATH 105,A02,093477,Carter; Anne Toulson,20,0,35,15
1657411447176,MATH 109,A01,083213,Ganzberger; Geoffrey Michael,2,0,34,32
1657411447176,MATH 109,A02,083214,Ganzberger; Geoffrey Michael,4,0,34,30
1657411447176,MATH 109,A03,093478,Ganzberger; Geoffrey Michael,2,0,34,32
1657411447176,MATH 109,B01,083215,Ganzberger; Geoffrey Michael,1,0,32,31
1657411447176,MATH 109,B02,083216,Ganzberger; Geoffrey Michael,2,0,32,30
1657411447176,MATH 109,B03,093479,Ganzberger; Geoffrey Michael,8,0,32,24
1657411453200,MATH 142A,A01,083219,Chow; Bennett,7,0,32,25
1657411453200,MATH 142A,A02,083220,Chow; Bennett,10,0,32,22
1657411453200,MATH 142A,A03,093480,Chow; Bennett,8,0,32,24
1657411453200,MATH 142A,B03,093481,Chow; Bennett,8,0,32,24
1657411453200,MATH 142A,B04,093558,Chow; Bennett,13,0,32,19
1657411453200,MATH 142A,B05,093559,Chow; Bennett,6,0,32,26
1657411459229,MATH 193A,A01,083224,Rotar; Vladimir,8,0,34,26
1657411459229,MATH 193A,A02,083225,Rotar; Vladimir,9,0,34,25
1657411459229,MATH 193A,A03,083781,Rotar; Vladimir,5,0,34,29
1657411459229,MATH 193A,A04,083782,Rotar; Vladimir,10,0,34,24
1657411459229,MATH 193A,A05,093482,Rotar; Vladimir,10,0,34,24
1657411465263,MATH 197,001,091859,McAuley; Julian John,9999,0,9999,0
1657411465263,MATH 197,002,095566,Kedlaya; Kiran S.,9997,0,9999,2
1657411465263,MATH 197,003,095567,Xiao; Ming,9999,0,9999,0
1657411465263,MATH 197,004,095571,Perols; Johan Lars,9998,0,9999,1
1657411472334,COGS 9,A01,083615,Shannon; Kyle Michael,9,0,75,66
1657411478358,COGS 11,A01,083617,Boyle; Mary E. T.,22,0,48,26
1657411484389,COGS 13,A01,083071,Bastos; Amalia Pinkusfeld,11,0,71,60
1657411490421,COGS 14A,A01,092681,Semenuks; Arturs,4,1,100,96
1657411496446,COGS 14B,A01,083073,Cheng; Tzu-Han,6,0,63,57
1657411502474,COGS 17,A01,092677,Semenuks; Arturs,6,0,81,75
1657411508498,COGS 100,A01,083619,Allen; Michael Gordon,17,0,70,53
1657411514521,COGS 101A,A01,083621,Davis; Joshua Daniel,9,0,68,59
1657411520546,COGS 101B,A01,091572,Allen; Michael Gordon,12,0,65,53
1657411526570,COGS 101C,A01,083625,Delgado; Tania,17,0,35,18
1657411532591,COGS 107A,A01,083627,Boyle; Mary E. T.,13,0,60,47
1657411538613,COGS 118A,A01,083075,Gupta; Anjum,20,0,76,56
1657411544638,CSE 3,A50,083646,Miranda; Gregory Joseph,24,0,50,26
1657411550667,CSE 8A,A50,083650,Miranda; Gregory Joseph,17,1,56,39
1657411556689,CSE 11,A01,083080,Cao; Yingjun,6,15,40,34
1657411562722,CSE 12,A01,083652,Krause-Levy; Sophia Louisa,28,1,120,92
1657411568749,CSE 15L,A01,083654,Morris; Justin Loren,9,0,50,41
1657411568749,CSE 15L,A02,083655,Morris; Justin Loren,9,0,50,41
1657411574772,CSE 20,A01,083657,Tran; Khoa Dang,39,0,80,41
1657411580795,CSE 21,A01,095574,Bach; Quang Tran,22,0,48,26
1657411586818,CSE 30,A01,083084,Eldon; John,4,0,80,76
1657411586818,CSE 30,B01,095061,Bhaskar; Nishant,9,0,50,41
1657411592841,CSE 100,A01,083659,Cao; Yingjun,5,4,70,65
1657411598866,CSE 134B,A01,083661,Powell; Thomas Allan,22,0,100,78
1657411604891,CSE 140,A01,083663,Gungor; Onat,14,0,85,71
1657411610919,CSE 140L,A01,083088,Eldon; John,21,0,100,79
1657411616942,CSE 175,A01,083665,Kumar; Rakesh,3,0,25,22
1657411622965,CSE 190,A00,092507,Dubnov; Shlomo,7,0,20,13
1657411628992,ECE 45,A01,083139,Congero; Spencer William,6,0,75,69
1657411635017,ECE 65,A50,083695,Saad; Andrew S,12,0,30,18
1657411635017,ECE 65,A51,095125,Saad; Andrew S,24,0,26,2
1657411641050,ECE 109,A01,091882,Touri; Behrouz,19,0,70,51
1657411647077,ECE 180,A00,083140,Abi Samra; Nicholas Camill,1,0,30,29
1657411647077,ECE 180,B00,083141,Abi Samra; Nicholas Camill,0,0,30,30
1657411653102,MATH 10A,A01,083735,Patchell; Gregory David,2,0,30,28
1657411653102,MATH 10A,A02,083736,Patchell; Gregory David,20,0,30,10
1657411653102,MATH 10A,A03,083737,Patchell; Gregory David,16,0,30,14
1657411659126,MATH 10B,A01,083207,Lim; Seonhee,8,0,34,26
1657411659126,MATH 10B,A02,083208,Lim; Seonhee,9,0,35,26
1657411659126,MATH 10B,A03,093472,Lim; Seonhee,7,0,34,27
1657411659126,MATH 10B,B01,083739,Sinha; Shubham,12,0,30,18
1657411665157,MATH 18,A01,083743,Cinel; Cameron Alexander,7,0,30,23
1657411665157,MATH 18,A02,083744,Cinel; Cameron Alexander,17,0,30,13
1657411665157,MATH 18,A03,083745,Cinel; Cameron Alexander,9,0,30,21
1657411665157,MATH 18,B01,083748,Rideout; David Porter,5,0,37,32
1657411665157,MATH 18,B02,083749,Rideout; David Porter,5,0,36,31
1657411665157,MATH 18,B03,083750,Rideout; David Porter,3,0,37,34
1657411665157,MATH 18,B04,083751,Rideout; David Porter,6,0,36,30
1657411665157,MATH 18,B05,093473,Rideout; David Porter,6,0,36,30
1657411665157,MATH 18,B06,093474,Rideout; David Porter,6,0,36,30
1657411671184,MATH 20A,A01,083754,Zheng; Zequn,14,0,40,26
1657411677207,MATH 20B,A01,083756,Briones; Jor-el Thomas Caparas,4,0,36,32
1657411677207,MATH 20B,A02,083757,Briones; Jor-el Thomas Caparas,1,0,36,35
1657411677207,MATH 20B,A03,093475,Briones; Jor-el Thomas Caparas,2,0,36,34
1657411683229,MATH 20C,A01,083760,Briones; Jor-el Thomas Caparas,1,0,35,34
1657411683229,MATH 20C,A02,083761,Briones; Jor-el Thomas Caparas,8,0,35,27
1657411683229,MATH 20C,A03,093476,Briones; Jor-el Thomas Caparas,0,1,36,36
1657411683229,MATH 20C,B01,083762,Bach; Quang Tran,1,0,30,29
1657411689254,MATH 20D,A01,083765,Tran; Brian Kha,5,0,30,25
1657411689254,MATH 20D,A02,083766,Tran; Brian Kha,5,0,30,25
1657411689254,MATH 20D,A03,083767,Tran; Brian Kha,5,0,30,25
1657411695283,MATH 20E,A01,083771,Ganguly; Soumya,9,0,32,23
1657411695283,MATH 20E,A02,083772,Ganguly; Soumya,6,0,32,26
1657411695283,MATH 20E,B01,083773,Ciotti; Benjamin,20,0,35,15
1657411695283,MATH 20E,B02,083774,Ciotti; Benjamin,17,0,35,18
1657411701306,MATH 103A,A01,083777,Greenfeld; Be'Eri,3,0,36,33
1657411701306,MATH 103A,A02,083778,Greenfeld; Be'Eri,5,0,36,31
1657411701306,MATH 103A,A03,093561,Greenfeld; Be'Eri,5,0,36,31
1657411701306,MATH 103A,B01,083779,Greenfeld; Be'Eri,7,0,36,29
1657411701306,MATH 103A,B02,083780,Greenfeld; Be'Eri,4,0,36,32
1657411701306,MATH 103A,B03,093562,Greenfeld; Be'Eri,3,0,36,33
1657411707334,MATH 105,A01,085443,Carter; Anne Toulson,15,0,35,20
1657411707334,MATH 105,A02,093477,Carter; Anne Toulson,20,0,35,15
1657411713358,MATH 109,A01,083213,Ganzberger; Geoffrey Michael,2,0,34,32
1657411713358,MATH 109,A02,083214,Ganzberger; Geoffrey Michael,4,0,34,30
1657411713358,MATH 109,A03,093478,Ganzberger; Geoffrey Michael,2,0,34,32
1657411713358,MATH 109,B01,083215,Ganzberger; Geoffrey Michael,1,0,32,31
1657411713358,MATH 109,B02,083216,Ganzberger; Geoffrey Michael,2,0,32,30
1657411713358,MATH 109,B03,093479,Ganzberger; Geoffrey Michael,8,0,32,24
1657411719383,MATH 142A,A01,083219,Chow; Bennett,7,0,32,25
1657411719383,MATH 142A,A02,083220,Chow; Bennett,10,0,32,22
1657411719383,MATH 142A,A03,093480,Chow; Bennett,8,0,32,24
1657411719383,MATH 142A,B03,093481,Chow; Bennett,8,0,32,24
1657411719383,MATH 142A,B04,093558,Chow; Bennett,13,0,32,19
1657411719383,MATH 142A,B05,093559,Chow; Bennett,6,0,32,26
1657411725413,MATH 193A,A01,083224,Rotar; Vladimir,8,0,34,26
1657411725413,MATH 193A,A02,083225,Rotar; Vladimir,9,0,34,25
1657411725413,MATH 193A,A03,083781,Rotar; Vladimir,5,0,34,29
1657411725413,MATH 193A,A04,083782,Rotar; Vladimir,10,0,34,24
1657411725413,MATH 193A,A05,093482,Rotar; Vladimir,10,0,34,24
1657411731435,MATH 197,001,091859,McAuley; Julian John,9999,0,9999,0
1657411731435,MATH 197,002,095566,Kedlaya; Kiran S.,9997,0,9999,2
1657411731435,MATH 197,003,095567,Xiao; Ming,9999,0,9999,0
1657411731435,MATH 197,004,095571,Perols; Johan Lars,9998,0,9999,1
1657411738505,COGS 9,A01,083615,Shannon; Kyle Michael,9,0,75,66
1657411744536,COGS 11,A01,083617,Boyle; Mary E. T.,22,0,48,26
1657411750712,COGS 13,A01,083071,Bastos; Amalia Pinkusfeld,11,0,71,60
1657411756734,COGS 14A,A01,092681,Semenuks; Arturs,5,1,100,95
1657411762758,COGS 14B,A01,083073,Cheng; Tzu-Han,6,0,63,57
1657411768779,COGS 17,A01,092677,Semenuks; Arturs,6,0,81,75
1657411774802,COGS 100,A01,083619,Allen; Michael Gordon,17,0,70,53
1657411780826,COGS 101A,A01,083621,Davis; Joshua Daniel,9,0,68,59
1657411786853,COGS 101B,A01,091572,Allen; Michael Gordon,12,0,65,53
1657411792881,COGS 101C,A01,083625,Delgado; Tania,17,0,35,18
1657411798917,COGS 107A,A01,083627,Boyle; Mary E. T.,13,0,60,47
1657411804941,COGS 118A,A01,083075,Gupta; Anjum,20,0,76,56
1657411810965,CSE 3,A50,083646,Miranda; Gregory Joseph,24,0,50,26
1657411816992,CSE 8A,A50,083650,Miranda; Gregory Joseph,17,1,56,39
1657411823016,CSE 11,A01,083080,Cao; Yingjun,6,15,40,34
1657411829040,CSE 12,A01,083652,Krause-Levy; Sophia Louisa,28,1,120,92
1657411835066,CSE 15L,A01,083654,Morris; Justin Loren,9,0,50,41
1657411835066,CSE 15L,A02,083655,Morris; Justin Loren,9,0,50,41
1657411841108,CSE 20,A01,083657,Tran; Khoa Dang,39,0,80,41
1657411847135,CSE 21,A01,095574,Bach; Quang Tran,22,0,48,26
1657411853158,CSE 30,A01,083084,Eldon; John,4,0,80,76
1657411853158,CSE 30,B01,095061,Bhaskar; Nishant,9,0,50,41
1657411859181,CSE 100,A01,083659,Cao; Yingjun,5,4,70,65
1657411865205,CSE 134B,A01,083661,Powell; Thomas Allan,22,0,100,78
1657411871231,CSE 140,A01,083663,Gungor; Onat,14,0,85,71
1657411877258,CSE 140L,A01,083088,Eldon; John,21,0,100,79
1657411883282,CSE 175,A01,083665,Kumar; Rakesh,3,0,25,22
1657411889305,CSE 190,A00,092507,Dubnov; Shlomo,7,0,20,13
1657411895329,ECE 45,A01,083139,Congero; Spencer William,6,0,75,69
1657411901356,ECE 65,A50,083695,Saad; Andrew S,12,0,30,18
1657411901356,ECE 65,A51,095125,Saad; Andrew S,24,0,26,2
1657411907386,ECE 109,A01,091882,Touri; Behrouz,19,0,70,51
1657411913413,ECE 180,A00,083140,Abi Samra; Nicholas Camill,1,0,30,29
1657411913413,ECE 180,B00,083141,Abi Samra; Nicholas Camill,0,0,30,30
1657411919438,MATH 10A,A01,083735,Patchell; Gregory David,2,0,30,28
1657411919438,MATH 10A,A02,083736,Patchell; Gregory David,20,0,30,10
1657411919438,MATH 10A,A03,083737,Patchell; Gregory David,16,0,30,14
1657411925464,MATH 10B,A01,083207,Lim; Seonhee,8,0,34,26
1657411925464,MATH 10B,A02,083208,Lim; Seonhee,9,0,35,26
1657411925464,MATH 10B,A03,093472,Lim; Seonhee,7,0,34,27
1657411925464,MATH 10B,B01,083739,Sinha; Shubham,12,0,30,18
1657411931488,MATH 18,A01,083743,Cinel; Cameron Alexander,7,0,30,23
1657411931488,MATH 18,A02,083744,Cinel; Cameron Alexander,17,0,30,13
1657411931488,MATH 18,A03,083745,Cinel; Cameron Alexander,9,0,30,21
1657411931488,MATH 18,B01,083748,Rideout; David Porter,5,0,37,32
1657411931488,MATH 18,B02,083749,Rideout; David Porter,5,0,36,31
1657411931488,MATH 18,B03,083750,Rideout; David Porter,3,0,37,34
1657411931488,MATH 18,B04,083751,Rideout; David Porter,6,0,36,30
1657411931488,MATH 18,B05,093473,Rideout; David Porter,6,0,36,30
1657411931488,MATH 18,B06,093474,Rideout; David Porter,6,0,36,30
1657411937609,MATH 20A,A01,083754,Zheng; Zequn,14,0,40,26
1657411943636,MATH 20B,A01,083756,Briones; Jor-el Thomas Caparas,4,0,36,32
1657411943636,MATH 20B,A02,083757,Briones; Jor-el Thomas Caparas,1,0,36,35
1657411943636,MATH 20B,A03,093475,Briones; Jor-el Thomas Caparas,2,0,36,34
1657411949666,MATH 20C,A01,083760,Briones; Jor-el Thomas Caparas,1,0,35,34
1657411949666,MATH 20C,A02,083761,Briones; Jor-el Thomas Caparas,8,0,35,27
1657411949666,MATH 20C,A03,093476,Briones; Jor-el Thomas Caparas,0,1,36,36
1657411949666,MATH 20C,B01,083762,Bach; Quang Tran,1,0,30,29
1657411955689,MATH 20D,A01,083765,Tran; Brian Kha,5,0,30,25
1657411955689,MATH 20D,A02,083766,Tran; Brian Kha,5,0,30,25
1657411955689,MATH 20D,A03,083767,Tran; Brian Kha,5,0,30,25
1657411961716,MATH 20E,A01,083771,Ganguly; Soumya,9,0,32,23
1657411961716,MATH 20E,A02,083772,Ganguly; Soumya,6,0,32,26
1657411961716,MATH 20E,B01,083773,Ciotti; Benjamin,20,0,35,15
1657411961716,MATH 20E,B02,083774,Ciotti; Benjamin,17,0,35,18
1657411967749,MATH 103A,A01,083777,Greenfeld; Be'Eri,3,0,36,33
1657411967749,MATH 103A,A02,083778,Greenfeld; Be'Eri,5,0,36,31
1657411967749,MATH 103A,A03,093561,Greenfeld; Be'Eri,5,0,36,31
1657411967749,MATH 103A,B01,083779,Greenfeld; Be'Eri,7,0,36,29
1657411967749,MATH 103A,B02,083780,Greenfeld; Be'Eri,4,0,36,32
1657411967749,MATH 103A,B03,093562,Greenfeld; Be'Eri,3,0,36,33
1657411973773,MATH 105,A01,085443,Carter; Anne Toulson,15,0,35,20
1657411973773,MATH 105,A02,093477,Carter; Anne Toulson,20,0,35,15
1657411979796,MATH 109,A01,083213,Ganzberger; Geoffrey Michael,2,0,34,32
1657411979796,MATH 109,A02,083214,Ganzberger; Geoffrey Michael,4,0,34,30
1657411979796,MATH 109,A03,093478,Ganzberger; Geoffrey Michael,2,0,34,32
1657411979796,MATH 109,B01,083215,Ganzberger; Geoffrey Michael,1,0,32,31
1657411979796,MATH 109,B02,083216,Ganzberger; Geoffrey Michael,2,0,32,30
1657411979796,MATH 109,B03,093479,Ganzberger; Geoffrey Michael,8,0,32,24
1657411985827,MATH 142A,A01,083219,Chow; Bennett,7,0,32,25
1657411985827,MATH 142A,A02,083220,Chow; Bennett,10,0,32,22
1657411985827,MATH 142A,A03,093480,Chow; Bennett,8,0,32,24
1657411985827,MATH 142A,B03,093481,Chow; Bennett,8,0,32,24
1657411985827,MATH 142A,B04,093558,Chow; Bennett,13,0,32,19
1657411985827,MATH 142A,B05,093559,Chow; Bennett,6,0,32,26
1657411991855,MATH 193A,A01,083224,Rotar; Vladimir,8,0,34,26
1657411991855,MATH 193A,A02,083225,Rotar; Vladimir,9,0,34,25
1657411991855,MATH 193A,A03,083781,Rotar; Vladimir,5,0,34,29
1657411991855,MATH 193A,A04,083782,Rotar; Vladimir,10,0,34,24
1657411991855,MATH 193A,A05,093482,Rotar; Vladimir,10,0,34,24
1657411997878,MATH 197,001,091859,McAuley; Julian John,9999,0,9999,0
1657411997878,MATH 197,002,095566,Kedlaya; Kiran S.,9997,0,9999,2
1657411997878,MATH 197,003,095567,Xiao; Ming,9999,0,9999,0
1657411997878,MATH 197,004,095571,Perols; Johan Lars,9998,0,9999,1
1657412004931,COGS 9,A01,083615,Shannon; Kyle Michael,9,0,75,66
1657412010955,COGS 11,A01,083617,Boyle; Mary E. T.,22,0,48,26
1657412016980,COGS 13,A01,083071,Bastos; Amalia Pinkusfeld,11,0,71,60
1657412023002,COGS 14A,A01,092681,Semenuks; Arturs,5,1,100,95
1657412029028,COGS 14B,A01,083073,Cheng; Tzu-Han,6,0,63,57
1657412035056,COGS 17,A01,092677,Semenuks; Arturs,6,0,81,75
1657412041079,COGS 100,A01,083619,Allen; Michael Gordon,17,0,70,53
1657412047105,COGS 101A,A01,083621,Davis; Joshua Daniel,9,0,68,59
1657412053129,COGS 101B,A01,091572,Allen; Michael Gordon,12,0,65,53
1657412059154,COGS 101C,A01,083625,Delgado; Tania,17,0,35,18
1657412065178,COGS 107A,A01,083627,Boyle; Mary E. T.,13,0,60,47
1657412071200,COGS 118A,A01,083075,Gupta; Anjum,20,0,76,56
1657412077227,CSE 3,A50,083646,Miranda; Gregory Joseph,24,0,50,26
1657412083254,CSE 8A,A50,083650,Miranda; Gregory Joseph,17,1,56,39
1657412089276,CSE 11,A01,083080,Cao; Yingjun,6,15,40,34
1657412095303,CSE 12,A01,083652,Krause-Levy; Sophia Louisa,28,1,120,92
1657412101337,CSE 15L,A01,083654,Morris; Justin Loren,9,0,50,41
1657412101337,CSE 15L,A02,083655,Morris; Justin Loren,9,0,50,41
1657412107367,CSE 20,A01,083657,Tran; Khoa Dang,39,0,80,41
1657412113394,CSE 21,A01,095574,Bach; Quang Tran,22,0,48,26
1657412119422,CSE 30,A01,083084,Eldon; John,4,0,80,76
1657412119422,CSE 30,B01,095061,Bhaskar; Nishant,9,0,50,41
1657412125446,CSE 100,A01,083659,Cao; Yingjun,5,4,70,65
1657412131469,CSE 134B,A01,083661,Powell; Thomas Allan,22,0,100,78
1657412137493,CSE 140,A01,083663,Gungor; Onat,14,0,85,71
1657412143516,CSE 140L,A01,083088,Eldon; John,21,0,100,79
1657412149542,CSE 175,A01,083665,Kumar; Rakesh,3,0,25,22
1657412155565,CSE 190,A00,092507,Dubnov; Shlomo,7,0,20,13
1657412161589,ECE 45,A01,083139,Congero; Spencer William,6,0,75,69
1657412167612,ECE 65,A50,083695,Saad; Andrew S,12,0,30,18
1657412167612,ECE 65,A51,095125,Saad; Andrew S,24,0,26,2
1657412173638,ECE 109,A01,091882,Touri; Behrouz,19,0,70,51
1657412179678,ECE 180,A00,083140,Abi Samra; Nicholas Camill,1,0,30,29
1657412179678,ECE 180,B00,083141,Abi Samra; Nicholas Camill,0,0,30,30
1657412185702,MATH 10A,A01,083735,Patchell; Gregory David,2,0,30,28
1657412185702,MATH 10A,A02,083736,Patchell; Gregory David,20,0,30,10
1657412185702,MATH 10A,A03,083737,Patchell; Gregory David,16,0,30,14
1657412191732,MATH 10B,A01,083207,Lim; Seonhee,8,0,34,26
1657412191732,MATH 10B,A02,083208,Lim; Seonhee,9,0,35,26
1657412191732,MATH 10B,A03,093472,Lim; Seonhee,7,0,34,27
1657412191732,MATH 10B,B01,083739,Sinha; Shubham,12,0,30,18
1657412197755,MATH 18,A01,083743,Cinel; Cameron Alexander,7,0,30,23
1657412197755,MATH 18,A02,083744,Cinel; Cameron Alexander,17,0,30,13
1657412197755,MATH 18,A03,083745,Cinel; Cameron Alexander,9,0,30,21
1657412197755,MATH 18,B01,083748,Rideout; David Porter,5,0,37,32
1657412197755,MATH 18,B02,083749,Rideout; David Porter,5,0,36,31
1657412197755,MATH 18,B03,083750,Rideout; David Porter,3,0,37,34
1657412197755,MATH 18,B04,083751,Rideout; David Porter,6,0,36,30
1657412197755,MATH 18,B05,093473,Rideout; David Porter,6,0,36,30
1657412197755,MATH 18,B06,093474,Rideout; David Porter,6,0,36,30
1657412203778,MATH 20A,A01,083754,Zheng; Zequn,14,0,40,26
1657412209804,MATH 20B,A01,083756,Briones; Jor-el Thomas Caparas,4,0,36,32
1657412209804,MATH 20B,A02,083757,Briones; Jor-el Thomas Caparas,1,0,36,35
1657412209804,MATH 20B,A03,093475,Briones; Jor-el Thomas Caparas,2,0,36,34
1657412215830,MATH 20C,A01,083760,Briones; Jor-el Thomas Caparas,1,0,35,34
1657412215830,MATH 20C,A02,083761,Briones; Jor-el Thomas Caparas,8,0,35,27
1657412215830,MATH 20C,A03,093476,Briones; Jor-el Thomas Caparas,0,1,36,36
1657412215830,MATH 20C,B01,083762,Bach; Quang Tran,1,0,30,29
1657412221861,MATH 20D,A01,083765,Tran; Brian Kha,5,0,30,25
1657412221861,MATH 20D,A02,083766,Tran; Brian Kha,5,0,30,25
1657412221861,MATH 20D,A03,083767,Tran; Brian Kha,5,0,30,25
1657412227884,MATH 20E,A01,083771,Ganguly; Soumya,9,0,32,23
1657412227884,MATH 20E,A02,083772,Ganguly; Soumya,6,0,32,26
1657412227884,MATH 20E,B01,083773,Ciotti; Benjamin,20,0,35,15
1657412227884,MATH 20E,B02,083774,Ciotti; Benjamin,17,0,35,18
1657412233908,MATH 103A,A01,083777,Greenfeld; Be'Eri,3,0,36,33
1657412233908,MATH 103A,A02,083778,Greenfeld; Be'Eri,5,0,36,31
1657412233908,MATH 103A,A03,093561,Greenfeld; Be'Eri,5,0,36,31
1657412233908,MATH 103A,B01,083779,Greenfeld; Be'Eri,7,0,36,29
1657412233908,MATH 103A,B02,083780,Greenfeld; Be'Eri,4,0,36,32
1657412233908,MATH 103A,B03,093562,Greenfeld; Be'Eri,3,0,36,33
1657412239931,MATH 105,A01,085443,Carter; Anne Toulson,15,0,35,20
1657412239931,MATH 105,A02,093477,Carter; Anne Toulson,20,0,35,15
1657412245953,MATH 109,A01,083213,Ganzberger; Geoffrey Michael,2,0,34,32
1657412245953,MATH 109,A02,083214,Ganzberger; Geoffrey Michael,4,0,34,30
1657412245953,MATH 109,A03,093478,Ganzberger; Geoffrey Michael,2,0,34,32
1657412245953,MATH 109,B01,083215,Ganzberger; Geoffrey Michael,1,0,32,31
1657412245953,MATH 109,B02,083216,Ganzberger; Geoffrey Michael,2,0,32,30
1657412245953,MATH 109,B03,093479,Ganzberger; Geoffrey Michael,8,0,32,24
1657412251978,MATH 142A,A01,083219,Chow; Bennett,7,0,32,25
1657412251978,MATH 142A,A02,083220,Chow; Bennett,10,0,32,22
1657412251978,MATH 142A,A03,093480,Chow; Bennett,8,0,32,24
1657412251978,MATH 142A,B03,093481,Chow; Bennett,8,0,32,24
1657412251978,MATH 142A,B04,093558,Chow; Bennett,13,0,32,19
1657412251978,MATH 142A,B05,093559,Chow; Bennett,6,0,32,26
1657412258002,MATH 193A,A01,083224,Rotar; Vladimir,8,0,34,26
1657412258002,MATH 193A,A02,083225,Rotar; Vladimir,9,0,34,25
1657412258002,MATH 193A,A03,083781,Rotar; Vladimir,5,0,34,29
1657412258002,MATH 193A,A04,083782,Rotar; Vladimir,10,0,34,24
1657412258002,MATH 193A,A05,093482,Rotar; Vladimir,10,0,34,24
1657412264024,MATH 197,001,091859,McAuley; Julian John,9999,0,9999,0
1657412264024,MATH 197,002,095566,Kedlaya; Kiran S.,9997,0,9999,2
1657412264024,MATH 197,003,095567,Xiao; Ming,9999,0,9999,0
1657412264024,MATH 197,004,095571,Perols; Johan Lars,9998,0,9999,1
1657412271095,COGS 9,A01,083615,Shannon; Kyle Michael,9,0,75,66
1657412277121,COGS 11,A01,083617,Boyle; Mary E. T.,22,0,48,26
1657412283146,COGS 13,A01,083071,Bastos; Amalia Pinkusfeld,11,0,71,60
1657412289168,COGS 14A,A01,092681,Semenuks; Arturs,5,1,100,95
1657412295195,COGS 14B,A01,083073,Cheng; Tzu-Han,6,0,63,57
1657412301217,COGS 17,A01,092677,Semenuks; Arturs,6,0,81,75
1657412307252,COGS 100,A01,083619,Allen; Michael Gordon,17,0,70,53
1657412313276,COGS 101A,A01,083621,Davis; Joshua Daniel,9,0,68,59
1657412319298,COGS 101B,A01,091572,Allen; Michael Gordon,12,0,65,53
1657412325321,COGS 101C,A01,083625,Delgado; Tania,17,0,35,18
1657412331347,COGS 107A,A01,083627,Boyle; Mary E. T.,13,0,60,47
1657412337368,COGS 118A,A01,083075,Gupta; Anjum,20,0,76,56
1657412343390,CSE 3,A50,083646,Miranda; Gregory Joseph,24,0,50,26
1657412349413,CSE 8A,A50,083650,Miranda; Gregory Joseph,17,1,56,39
1657412355435,CSE 11,A01,083080,Cao; Yingjun,6,15,40,34
1657412361458,CSE 12,A01,083652,Krause-Levy; Sophia Louisa,28,1,120,92
1657412367480,CSE 15L,A01,083654,Morris; Justin Loren,9,0,50,41
1657412367480,CSE 15L,A02,083655,Morris; Justin Loren,9,0,50,41
1657412373503,CSE 20,A01,083657,Tran; Khoa Dang,39,0,80,41
1657412379529,CSE 21,A01,095574,Bach; Quang Tran,22,0,48,26
1657412385553,CSE 30,A01,083084,Eldon; John,4,0,80,76
1657412385553,CSE 30,B01,095061,Bhaskar; Nishant,9,0,50,41
1657412391580,CSE 100,A01,083659,Cao; Yingjun,5,4,70,65
1657412397603,CSE 134B,A01,083661,Powell; Thomas Allan,22,0,100,78
1657412403629,CSE 140,A01,083663,Gungor; Onat,14,0,85,71
1657412409652,CSE 140L,A01,083088,Eldon; John,21,0,100,79
1657412415675,CSE 175,A01,083665,Kumar; Rakesh,3,0,25,22
1657412421698,CSE 190,A00,092507,Dubnov; Shlomo,7,0,20,13
1657412427732,ECE 45,A01,083139,Congero; Spencer William,6,0,75,69
1657412433765,ECE 65,A50,083695,Saad; Andrew S,12,0,30,18
1657412433765,ECE 65,A51,095125,Saad; Andrew S,24,0,26,2
1657412439789,ECE 109,A01,091882,Touri; Behrouz,19,0,70,51
1657412445816,ECE 180,A00,083140,Abi Samra; Nicholas Camill,1,0,30,29
1657412445816,ECE 180,B00,083141,Abi Samra; Nicholas Camill,0,0,30,30
1657412451840,MATH 10A,A01,083735,Patchell; Gregory David,2,0,30,28
1657412451840,MATH 10A,A02,083736,Patchell; Gregory David,20,0,30,10
1657412451840,MATH 10A,A03,083737,Patchell; Gregory David,16,0,30,14
1657412457866,MATH 10B,A01,083207,Lim; Seonhee,8,0,34,26
1657412457866,MATH 10B,A02,083208,Lim; Seonhee,9,0,35,26
1657412457866,MATH 10B,A03,093472,Lim; Seonhee,7,0,34,27
1657412457866,MATH 10B,B01,083739,Sinha; Shubham,12,0,30,18
1657412463902,MATH 18,A01,083743,Cinel; Cameron Alexander,7,0,30,23
1657412463902,MATH 18,A02,083744,Cinel; Cameron Alexander,17,0,30,13
1657412463902,MATH 18,A03,083745,Cinel; Cameron Alexander,9,0,30,21
1657412463902,MATH 18,B01,083748,Rideout; David Porter,5,0,37,32
1657412463902,MATH 18,B02,083749,Rideout; David Porter,5,0,36,31
1657412463902,MATH 18,B03,083750,Rideout; David Porter,3,0,37,34
1657412463902,MATH 18,B04,083751,Rideout; David Porter,6,0,36,30
1657412463902,MATH 18,B05,093473,Rideout; David Porter,6,0,36,30
1657412463902,MATH 18,B06,093474,Rideout; David Porter,6,0,36,30
1657412469926,MATH 20A,A01,083754,Zheng; Zequn,14,0,40,26
1657412475954,MATH 20B,A01,083756,Briones; Jor-el Thomas Caparas,4,0,36,32
1657412475954,MATH 20B,A02,083757,Briones; Jor-el Thomas Caparas,1,0,36,35
1657412475954,MATH 20B,A03,093475,Briones; Jor-el Thomas Caparas,2,0,36,34
1657412481984,MATH 20C,A01,083760,Briones; Jor-el Thomas Caparas,1,0,35,34
1657412481984,MATH 20C,A02,083761,Briones; Jor-el Thomas Caparas,8,0,35,27
1657412481984,MATH 20C,A03,093476,Briones; Jor-el Thomas Caparas,0,1,36,36
1657412481984,MATH 20C,B01,083762,Bach; Quang Tran,1,0,30,29
1657412488009,MATH 20D,A01,083765,Tran; Brian Kha,5,0,30,25
1657412488009,MATH 20D,A02,083766,Tran; Brian Kha,5,0,30,25
1657412488009,MATH 20D,A03,083767,Tran; Brian Kha,5,0,30,25
1657412494035,MATH 20E,A01,083771,Ganguly; Soumya,9,0,32,23
1657412494035,MATH 20E,A02,083772,Ganguly; Soumya,6,0,32,26
1657412494035,MATH 20E,B01,083773,Ciotti; Benjamin,20,0,35,15
1657412494035,MATH 20E,B02,083774,Ciotti; Benjamin,17,0,35,18
1657412500059,MATH 103A,A01,083777,Greenfeld; Be'Eri,3,0,36,33
1657412500059,MATH 103A,A02,083778,Greenfeld; Be'Eri,5,0,36,31
1657412500059,MATH 103A,A03,093561,Greenfeld; Be'Eri,5,0,36,31
1657412500059,MATH 103A,B01,083779,Greenfeld; Be'Eri,7,0,36,29
1657412500059,MATH 103A,B02,083780,Greenfeld; Be'Eri,4,0,36,32
1657412500059,MATH 103A,B03,093562,Greenfeld; Be'Eri,3,0,36,33
1657412506085,MATH 105,A01,085443,Carter; Anne Toulson,15,0,35,20
1657412506085,MATH 105,A02,093477,Carter; Anne Toulson,20,0,35,15
1657412512119,MATH 109,A01,083213,Ganzberger; Geoffrey Michael,2,0,34,32
1657412512119,MATH 109,A02,083214,Ganzberger; Geoffrey Michael,4,0,34,30
1657412512119,MATH 109,A03,093478,Ganzberger; Geoffrey Michael,2,0,34,32
1657412512119,MATH 109,B01,083215,Ganzberger; Geoffrey Michael,1,0,32,31
1657412512119,MATH 109,B02,083216,Ganzberger; Geoffrey Michael,2,0,32,30
1657412512119,MATH 109,B03,093479,Ganzberger; Geoffrey Michael,8,0,32,24
1657412518148,MATH 142A,A01,083219,Chow; Bennett,7,0,32,25
1657412518148,MATH 142A,A02,083220,Chow; Bennett,10,0,32,22
1657412518148,MATH 142A,A03,093480,Chow; Bennett,8,0,32,24
1657412518148,MATH 142A,B03,093481,Chow; Bennett,8,0,32,24
1657412518148,MATH 142A,B04,093558,Chow; Bennett,13,0,32,19
1657412518148,MATH 142A,B05,093559,Chow; Bennett,6,0,32,26
1657412524174,MATH 193A,A01,083224,Rotar; Vladimir,8,0,34,26
1657412524174,MATH 193A,A02,083225,Rotar; Vladimir,9,0,34,25
1657412524174,MATH 193A,A03,083781,Rotar; Vladimir,5,0,34,29
1657412524174,MATH 193A,A04,083782,Rotar; Vladimir,10,0,34,24
1657412524174,MATH 193A,A05,093482,Rotar; Vladimir,10,0,34,24
1657412530200,MATH 197,001,091859,McAuley; Julian John,9999,0,9999,0
1657412530200,MATH 197,002,095566,Kedlaya; Kiran S.,9997,0,9999,2
1657412530200,MATH 197,003,095567,Xiao; Ming,9999,0,9999,0
1657412530200,MATH 197,004,095571,Perols; Johan Lars,9998,0,9999,1
1657412537349,COGS 9,A01,083615,Shannon; Kyle Michael,9,0,75,66
1657412543376,COGS 11,A01,083617,Boyle; Mary E. T.,22,0,48,26
1657412549411,COGS 13,A01,083071,Bastos; Amalia Pinkusfeld,11,0,71,60
1657412555434,COGS 14A,A01,092681,Semenuks; Arturs,5,1,100,95
1657412561467,COGS 14B,A01,083073,Cheng; Tzu-Han,6,0,63,57
1657412567494,COGS 17,A01,092677,Semenuks; Arturs,6,0,81,75
1657412573517,COGS 100,A01,083619,Allen; Michael Gordon,17,0,70,53
1657412579540,COGS 101A,A01,083621,Davis; Joshua Daniel,9,0,68,59
1657412585562,COGS 101B,A01,091572,Allen; Michael Gordon,12,0,65,53
1657412591586,COGS 101C,A01,083625,Delgado; Tania,17,0,35,18
1657412597609,COGS 107A,A01,083627,Boyle; Mary E. T.,13,0,60,47
1657412603632,COGS 118A,A01,083075,Gupta; Anjum,20,0,76,56
1657412609662,CSE 3,A50,083646,Miranda; Gregory Joseph,24,0,50,26
1657412615689,CSE 8A,A50,083650,Miranda; Gregory Joseph,17,1,56,39
1657412621716,CSE 11,A01,083080,Cao; Yingjun,6,15,40,34
1657412627739,CSE 12,A01,083652,Krause-Levy; Sophia Louisa,28,1,120,92
1657412633766,CSE 15L,A01,083654,Morris; Justin Loren,9,0,50,41
1657412633766,CSE 15L,A02,083655,Morris; Justin Loren,9,0,50,41
1657412639792,CSE 20,A01,083657,Tran; Khoa Dang,39,0,80,41
1657412645820,CSE 21,A01,095574,Bach; Quang Tran,22,0,48,26
1657412651846,CSE 30,A01,083084,Eldon; John,4,0,80,76
1657412651846,CSE 30,B01,095061,Bhaskar; Nishant,9,0,50,41
1657412657872,CSE 100,A01,083659,Cao; Yingjun,5,4,70,65
1657412663895,CSE 134B,A01,083661,Powell; Thomas Allan,22,0,100,78
1657412669920,CSE 140,A01,083663,Gungor; Onat,14,0,85,71
1657412675943,CSE 140L,A01,083088,Eldon; John,21,0,100,79
1657412681968,CSE 175,A01,083665,Kumar; Rakesh,3,0,25,22
1657412687993,CSE 190,A00,092507,Dubnov; Shlomo,7,0,20,13
1657412694016,ECE 45,A01,083139,Congero; Spencer William,6,0,75,69
1657412700045,ECE 65,A50,083695,Saad; Andrew S,12,0,30,18
1657412700045,ECE 65,A51,095125,Saad; Andrew S,24,0,26,2
1657412706068,ECE 109,A01,091882,Touri; Behrouz,19,0,70,51
1657412712091,ECE 180,A00,083140,Abi Samra; Nicholas Camill,1,0,30,29
1657412712091,ECE 180,B00,083141,Abi Samra; Nicholas Camill,0,0,30,30
1657412718114,MATH 10A,A01,083735,Patchell; Gregory David,2,0,30,28
1657412718114,MATH 10A,A02,083736,Patchell; Gregory David,20,0,30,10
1657412718114,MATH 10A,A03,083737,Patchell; Gregory David,16,0,30,14
1657412724142,MATH 10B,A01,083207,Lim; Seonhee,8,0,34,26
1657412724142,MATH 10B,A02,083208,Lim; Seonhee,9,0,35,26
1657412724142,MATH 10B,A03,093472,Lim; Seonhee,7,0,34,27
1657412724142,MATH 10B,B01,083739,Sinha; Shubham,12,0,30,18
1657412730171,MATH 18,A01,083743,Cinel; Cameron Alexander,7,0,30,23
1657412730171,MATH 18,A02,083744,Cinel; Cameron Alexander,17,0,30,13
1657412730171,MATH 18,A03,083745,Cinel; Cameron Alexander,9,0,30,21
1657412730171,MATH 18,B01,083748,Rideout; David Porter,5,0,37,32
1657412730171,MATH 18,B02,083749,Rideout; David Porter,5,0,36,31
1657412730171,MATH 18,B03,083750,Rideout; David Porter,3,0,37,34
1657412730171,MATH 18,B04,083751,Rideout; David Porter,6,0,36,30
1657412730171,MATH 18,B05,093473,Rideout; David Porter,6,0,36,30
1657412730171,MATH 18,B06,093474,Rideout; David Porter,6,0,36,30
1657412736194,MATH 20A,A01,083754,Zheng; Zequn,14,0,40,26
1657412742218,MATH 20B,A01,083756,Briones; Jor-el Thomas Caparas,4,0,36,32
1657412742218,MATH 20B,A02,083757,Briones; Jor-el Thomas Caparas,1,0,36,35
1657412742218,MATH 20B,A03,093475,Briones; Jor-el Thomas Caparas,2,0,36,34
1657412748247,MATH 20C,A01,083760,Briones; Jor-el Thomas Caparas,1,0,35,34
1657412748247,MATH 20C,A02,083761,Briones; Jor-el Thomas Caparas,8,0,35,27
1657412748247,MATH 20C,A03,093476,Briones; Jor-el Thomas Caparas,0,1,36,36
1657412748247,MATH 20C,B01,083762,Bach; Quang Tran,1,0,30,29
1657412754275,MATH 20D,A01,083765,Tran; Brian Kha,5,0,30,25
1657412754275,MATH 20D,A02,083766,Tran; Brian Kha,5,0,30,25
1657412754275,MATH 20D,A03,083767,Tran; Brian Kha,5,0,30,25
1657412760299,MATH 20E,A01,083771,Ganguly; Soumya,9,0,32,23
1657412760299,MATH 20E,A02,083772,Ganguly; Soumya,6,0,32,26
1657412760299,MATH 20E,B01,083773,Ciotti; Benjamin,20,0,35,15
1657412760299,MATH 20E,B02,083774,Ciotti; Benjamin,17,0,35,18
1657412766327,MATH 103A,A01,083777,Greenfeld; Be'Eri,3,0,36,33
1657412766327,MATH 103A,A02,083778,Greenfeld; Be'Eri,5,0,36,31
1657412766327,MATH 103A,A03,093561,Greenfeld; Be'Eri,5,0,36,31
1657412766327,MATH 103A,B01,083779,Greenfeld; Be'Eri,7,0,36,29
1657412766327,MATH 103A,B02,083780,Greenfeld; Be'Eri,4,0,36,32
1657412766327,MATH 103A,B03,093562,Greenfeld; Be'Eri,3,0,36,33
1657412772355,MATH 105,A01,085443,Carter; Anne Toulson,15,0,35,20
1657412772355,MATH 105,A02,093477,Carter; Anne Toulson,20,0,35,15
1657412778383,MATH 109,A01,083213,Ganzberger; Geoffrey Michael,2,0,34,32
1657412778383,MATH 109,A02,083214,Ganzberger; Geoffrey Michael,4,0,34,30
1657412778383,MATH 109,A03,093478,Ganzberger; Geoffrey Michael,2,0,34,32
1657412778383,MATH 109,B01,083215,Ganzberger; Geoffrey Michael,1,0,32,31
1657412778383,MATH 109,B02,083216,Ganzberger; Geoffrey Michael,2,0,32,30
1657412778383,MATH 109,B03,093479,Ganzberger; Geoffrey Michael,8,0,32,24
1657412784406,MATH 142A,A01,083219,Chow; Bennett,7,0,32,25
1657412784406,MATH 142A,A02,083220,Chow; Bennett,10,0,32,22
1657412784406,MATH 142A,A03,093480,Chow; Bennett,8,0,32,24
1657412784406,MATH 142A,B03,093481,Chow; Bennett,8,0,32,24
1657412784406,MATH 142A,B04,093558,Chow; Bennett,13,0,32,19
1657412784406,MATH 142A,B05,093559,Chow; Bennett,6,0,32,26
1657412790434,MATH 193A,A01,083224,Rotar; Vladimir,8,0,34,26
1657412790434,MATH 193A,A02,083225,Rotar; Vladimir,9,0,34,25
1657412790434,MATH 193A,A03,083781,Rotar; Vladimir,5,0,34,29
1657412790434,MATH 193A,A04,083782,Rotar; Vladimir,10,0,34,24
1657412790434,MATH 193A,A05,093482,Rotar; Vladimir,10,0,34,24
1657412796457,MATH 197,001,091859,McAuley; Julian John,9999,0,9999,0
1657412796457,MATH 197,002,095566,Kedlaya; Kiran S.,9997,0,9999,2
1657412796457,MATH 197,003,095567,Xiao; Ming,9999,0,9999,0
1657412796457,MATH 197,004,095571,Perols; Johan Lars,9998,0,9999,1
1657412803510,COGS 9,A01,083615,Shannon; Kyle Michael,9,0,75,66
1657412809536,COGS 11,A01,083617,Boyle; Mary E. T.,22,0,48,26
1657412815568,COGS 13,A01,083071,Bastos; Amalia Pinkusfeld,11,0,71,60
1657412821594,COGS 14A,A01,092681,Semenuks; Arturs,5,1,100,95
1657412827617,COGS 14B,A01,083073,Cheng; Tzu-Han,6,0,63,57
1657412833645,COGS 17,A01,092677,Semenuks; Arturs,6,0,81,75
1657412839673,COGS 100,A01,083619,Allen; Michael Gordon,17,0,70,53
1657412845696,COGS 101A,A01,083621,Davis; Joshua Daniel,9,0,68,59
1657412851722,COGS 101B,A01,091572,Allen; Michael Gordon,12,0,65,53
1657412857743,COGS 101C,A01,083625,Delgado; Tania,17,0,35,18
1657412863769,COGS 107A,A01,083627,Boyle; Mary E. T.,13,0,60,47
1657412869794,COGS 118A,A01,083075,Gupta; Anjum,20,0,76,56
1657412875820,CSE 3,A50,083646,Miranda; Gregory Joseph,24,0,50,26
1657412881845,CSE 8A,A50,083650,Miranda; Gregory Joseph,17,1,56,39
1657412887868,CSE 11,A01,083080,Cao; Yingjun,6,15,40,34
1657412893891,CSE 12,A01,083652,Krause-Levy; Sophia Louisa,28,1,120,92
1657412899917,CSE 15L,A01,083654,Morris; Justin Loren,9,0,50,41
1657412899917,CSE 15L,A02,083655,Morris; Justin Loren,9,0,50,41
1657412905942,CSE 20,A01,083657,Tran; Khoa Dang,39,0,80,41
1657412911965,CSE 21,A01,095574,Bach; Quang Tran,22,0,48,26
1657412917987,CSE 30,A01,083084,Eldon; John,4,0,80,76
1657412917987,CSE 30,B01,095061,Bhaskar; Nishant,9,0,50,41
1657412924011,CSE 100,A01,083659,Cao; Yingjun,5,4,70,65
1657412930032,CSE 134B,A01,083661,Powell; Thomas Allan,22,0,100,78
1657412936056,CSE 140,A01,083663,Gungor; Onat,14,0,85,71
1657412942079,CSE 140L,A01,083088,Eldon; John,21,0,100,79
1657412948105,CSE 175,A01,083665,Kumar; Rakesh,3,0,25,22
1657412954128,CSE 190,A00,092507,Dubnov; Shlomo,7,0,20,13
1657412960151,ECE 45,A01,083139,Congero; Spencer William,6,0,75,69
1657412966173,ECE 65,A50,083695,Saad; Andrew S,12,0,30,18
1657412966173,ECE 65,A51,095125,Saad; Andrew S,24,0,26,2
1657412972202,ECE 109,A01,091882,Touri; Behrouz,19,0,70,51
1657412978227,ECE 180,A00,083140,Abi Samra; Nicholas Camill,1,0,30,29
1657412978227,ECE 180,B00,083141,Abi Samra; Nicholas Camill,0,0,30,30
1657412984251,MATH 10A,A01,083735,Patchell; Gregory David,2,0,30,28
1657412984251,MATH 10A,A02,083736,Patchell; Gregory David,20,0,30,10
1657412984251,MATH 10A,A03,083737,Patchell; Gregory David,16,0,30,14
1657412990279,MATH 10B,A01,083207,Lim; Seonhee,8,0,34,26
1657412990279,MATH 10B,A02,083208,Lim; Seonhee,9,0,35,26
1657412990279,MATH 10B,A03,093472,Lim; Seonhee,7,0,34,27
1657412990279,MATH 10B,B01,083739,Sinha; Shubham,12,0,30,18
1657412996313,MATH 18,A01,083743,Cinel; Cameron Alexander,7,0,30,23
1657412996313,MATH 18,A02,083744,Cinel; Cameron Alexander,17,0,30,13
1657412996313,MATH 18,A03,083745,Cinel; Cameron Alexander,9,0,30,21
1657412996313,MATH 18,B01,083748,Rideout; David Porter,5,0,37,32
1657412996313,MATH 18,B02,083749,Rideout; David Porter,5,0,36,31
1657412996313,MATH 18,B03,083750,Rideout; David Porter,3,0,37,34
1657412996313,MATH 18,B04,083751,Rideout; David Porter,6,0,36,30
1657412996313,MATH 18,B05,093473,Rideout; David Porter,6,0,36,30
1657412996313,MATH 18,B06,093474,Rideout; David Porter,6,0,36,30
1657413002336,MATH 20A,A01,083754,Zheng; Zequn,14,0,40,26
1657413008358,MATH 20B,A01,083756,Briones; Jor-el Thomas Caparas,4,0,36,32
1657413008358,MATH 20B,A02,083757,Briones; Jor-el Thomas Caparas,1,0,36,35
1657413008358,MATH 20B,A03,093475,Briones; Jor-el Thomas Caparas,2,0,36,34
1657413014382,MATH 20C,A01,083760,Briones; Jor-el Thomas Caparas,1,0,35,34
1657413014382,MATH 20C,A02,083761,Briones; Jor-el Thomas Caparas,8,0,35,27
1657413014382,MATH 20C,A03,093476,Briones; Jor-el Thomas Caparas,0,1,36,36
1657413014382,MATH 20C,B01,083762,Bach; Quang Tran,1,0,30,29
1657413020411,MATH 20D,A01,083765,Tran; Brian Kha,5,0,30,25
1657413020411,MATH 20D,A02,083766,Tran; Brian Kha,5,0,30,25
1657413020411,MATH 20D,A03,083767,Tran; Brian Kha,5,0,30,25
1657413026440,MATH 20E,A01,083771,Ganguly; Soumya,9,0,32,23
1657413026440,MATH 20E,A02,083772,Ganguly; Soumya,6,0,32,26
1657413026440,MATH 20E,B01,083773,Ciotti; Benjamin,20,0,35,15
1657413026440,MATH 20E,B02,083774,Ciotti; Benjamin,17,0,35,18
1657413032469,MATH 103A,A01,083777,Greenfeld; Be'Eri,3,0,36,33
1657413032469,MATH 103A,A02,083778,Greenfeld; Be'Eri,5,0,36,31
1657413032469,MATH 103A,A03,093561,Greenfeld; Be'Eri,5,0,36,31
1657413032469,MATH 103A,B01,083779,Greenfeld; Be'Eri,7,0,36,29
1657413032469,MATH 103A,B02,083780,Greenfeld; Be'Eri,4,0,36,32
1657413032469,MATH 103A,B03,093562,Greenfeld; Be'Eri,3,0,36,33
1657413038498,MATH 105,A01,085443,Carter; Anne Toulson,15,0,35,20
1657413038498,MATH 105,A02,093477,Carter; Anne Toulson,20,0,35,15
1657413044522,MATH 109,A01,083213,Ganzberger; Geoffrey Michael,2,0,34,32
1657413044522,MATH 109,A02,083214,Ganzberger; Geoffrey Michael,4,0,34,30
1657413044522,MATH 109,A03,093478,Ganzberger; Geoffrey Michael,2,0,34,32
1657413044522,MATH 109,B01,083215,Ganzberger; Geoffrey Michael,1,0,32,31
1657413044522,MATH 109,B02,083216,Ganzberger; Geoffrey Michael,2,0,32,30
1657413044522,MATH 109,B03,093479,Ganzberger; Geoffrey Michael,8,0,32,24
1657413050551,MATH 142A,A01,083219,Chow; Bennett,7,0,32,25
1657413050551,MATH 142A,A02,083220,Chow; Bennett,10,0,32,22
1657413050551,MATH 142A,A03,093480,Chow; Bennett,8,0,32,24
1657413050551,MATH 142A,B03,093481,Chow; Bennett,8,0,32,24
1657413050551,MATH 142A,B04,093558,Chow; Bennett,13,0,32,19
1657413050551,MATH 142A,B05,093559,Chow; Bennett,6,0,32,26
1657413056575,MATH 193A,A01,083224,Rotar; Vladimir,8,0,34,26
1657413056575,MATH 193A,A02,083225,Rotar; Vladimir,9,0,34,25
1657413056575,MATH 193A,A03,083781,Rotar; Vladimir,5,0,34,29
1657413056575,MATH 193A,A04,083782,Rotar; Vladimir,10,0,34,24
1657413056575,MATH 193A,A05,093482,Rotar; Vladimir,10,0,34,24
1657413062603,MATH 197,001,091859,McAuley; Julian John,9999,0,9999,0
1657413062603,MATH 197,002,095566,Kedlaya; Kiran S.,9997,0,9999,2
1657413062603,MATH 197,003,095567,Xiao; Ming,9999,0,9999,0
1657413062603,MATH 197,004,095571,Perols; Johan Lars,9998,0,9999,1
1657413069658,COGS 9,A01,083615,Shannon; Kyle Michael,9,0,75,66
1657413075682,COGS 11,A01,083617,Boyle; Mary E. T.,22,0,48,26
1657413081706,COGS 13,A01,083071,Bastos; Amalia Pinkusfeld,11,0,71,60
1657413087729,COGS 14A,A01,092681,Semenuks; Arturs,5,1,100,95
1657413093753,COGS 14B,A01,083073,Cheng; Tzu-Han,6,0,63,57
1657413099780,COGS 17,A01,092677,Semenuks; Arturs,6,0,81,75
1657413105804,COGS 100,A01,083619,Allen; Michael Gordon,17,0,70,53
1657413111829,COGS 101A,A01,083621,Davis; Joshua Daniel,9,0,68,59
1657413117854,COGS 101B,A01,091572,Allen; Michael Gordon,12,0,65,53
1657413123882,COGS 101C,A01,083625,Delgado; Tania,17,0,35,18
1657413129982,COGS 107A,A01,083627,Boyle; Mary E. T.,13,0,60,47
1657413136014,COGS 118A,A01,083075,Gupta; Anjum,20,0,76,56
1657413142040,CSE 3,A50,083646,Miranda; Gregory Joseph,24,0,50,26
1657413148064,CSE 8A,A50,083650,Miranda; Gregory Joseph,17,1,56,39
1657413154104,CSE 11,A01,083080,Cao; Yingjun,6,15,40,34
1657413160126,CSE 12,A01,083652,Krause-Levy; Sophia Louisa,28,1,120,92
1657413166149,CSE 15L,A01,083654,Morris; Justin Loren,9,0,50,41
1657413166149,CSE 15L,A02,083655,Morris; Justin Loren,9,0,50,41
1657413172176,CSE 20,A01,083657,Tran; Khoa Dang,39,0,80,41
1657413178201,CSE 21,A01,095574,Bach; Quang Tran,22,0,48,26
1657413184224,CSE 30,A01,083084,Eldon; John,4,0,80,76
1657413184224,CSE 30,B01,095061,Bhaskar; Nishant,9,0,50,41
1657413190246,CSE 100,A01,083659,Cao; Yingjun,5,4,70,65
1657413196269,CSE 134B,A01,083661,Powell; Thomas Allan,22,0,100,78
1657413202295,CSE 140,A01,083663,Gungor; Onat,14,0,85,71
1657413208318,CSE 140L,A01,083088,Eldon; John,21,0,100,79
1657413214339,CSE 175,A01,083665,Kumar; Rakesh,3,0,25,22
1657413220366,CSE 190,A00,092507,Dubnov; Shlomo,7,0,20,13
1657413226395,ECE 45,A01,083139,Congero; Spencer William,6,0,75,69
1657413232429,ECE 65,A50,083695,Saad; Andrew S,12,0,30,18
1657413232429,ECE 65,A51,095125,Saad; Andrew S,24,0,26,2
1657413238450,ECE 109,A01,091882,Touri; Behrouz,19,0,70,51
1657413244474,ECE 180,A00,083140,Abi Samra; Nicholas Camill,1,0,30,29
1657413244474,ECE 180,B00,083141,Abi Samra; Nicholas Camill,0,0,30,30
1657413250501,MATH 10A,A01,083735,Patchell; Gregory David,2,0,30,28
1657413250501,MATH 10A,A02,083736,Patchell; Gregory David,20,0,30,10
1657413250501,MATH 10A,A03,083737,Patchell; Gregory David,16,0,30,14
1657413256528,MATH 10B,A01,083207,Lim; Seonhee,8,0,34,26
1657413256528,MATH 10B,A02,083208,Lim; Seonhee,9,0,35,26
1657413256528,MATH 10B,A03,093472,Lim; Seonhee,7,0,34,27
1657413256528,MATH 10B,B01,083739,Sinha; Shubham,12,0,30,18
1657413262558,MATH 18,A01,083743,Cinel; Cameron Alexander,7,0,30,23
1657413262558,MATH 18,A02,083744,Cinel; Cameron Alexander,17,0,30,13
1657413262558,MATH 18,A03,083745,Cinel; Cameron Alexander,9,0,30,21
1657413262558,MATH 18,B01,083748,Rideout; David Porter,5,0,37,32
1657413262558,MATH 18,B02,083749,Rideout; David Porter,5,0,36,31
1657413262558,MATH 18,B03,083750,Rideout; David Porter,3,0,37,34
1657413262558,MATH 18,B04,083751,Rideout; David Porter,6,0,36,30
1657413262558,MATH 18,B05,093473,Rideout; David Porter,6,0,36,30
1657413262558,MATH 18,B06,093474,Rideout; David Porter,6,0,36,30
1657413268584,MATH 20A,A01,083754,Zheng; Zequn,14,0,40,26
1657413274611,MATH 20B,A01,083756,Briones; Jor-el Thomas Caparas,4,0,36,32
1657413274611,MATH 20B,A02,083757,Briones; Jor-el Thomas Caparas,1,0,36,35
1657413274611,MATH 20B,A03,093475,Briones; Jor-el Thomas Caparas,2,0,36,34
1657413280634,MATH 20C,A01,083760,Briones; Jor-el Thomas Caparas,1,0,35,34
1657413280634,MATH 20C,A02,083761,Briones; Jor-el Thomas Caparas,8,0,35,27
1657413280634,MATH 20C,A03,093476,Briones; Jor-el Thomas Caparas,0,1,36,36
1657413280634,MATH 20C,B01,083762,Bach; Quang Tran,1,0,30,29
1657413286661,MATH 20D,A01,083765,Tran; Brian Kha,5,0,30,25
1657413286661,MATH 20D,A02,083766,Tran; Brian Kha,5,0,30,25
1657413286661,MATH 20D,A03,083767,Tran; Brian Kha,5,0,30,25
1657413292685,MATH 20E,A01,083771,Ganguly; Soumya,9,0,32,23
1657413292685,MATH 20E,A02,083772,Ganguly; Soumya,6,0,32,26
1657413292685,MATH 20E,B01,083773,Ciotti; Benjamin,20,0,35,15
1657413292685,MATH 20E,B02,083774,Ciotti; Benjamin,17,0,35,18
1657413298713,MATH 103A,A01,083777,Greenfeld; Be'Eri,3,0,36,33
1657413298713,MATH 103A,A02,083778,Greenfeld; Be'Eri,5,0,36,31
1657413298713,MATH 103A,A03,093561,Greenfeld; Be'Eri,5,0,36,31
1657413298713,MATH 103A,B01,083779,Greenfeld; Be'Eri,7,0,36,29
1657413298713,MATH 103A,B02,083780,Greenfeld; Be'Eri,4,0,36,32
1657413298713,MATH 103A,B03,093562,Greenfeld; Be'Eri,3,0,36,33
1657413304735,MATH 105,A01,085443,Carter; Anne Toulson,15,0,35,20
1657413304735,MATH 105,A02,093477,Carter; Anne Toulson,20,0,35,15
1657413310764,MATH 109,A01,083213,Ganzberger; Geoffrey Michael,2,0,34,32
1657413310764,MATH 109,A02,083214,Ganzberger; Geoffrey Michael,4,0,34,30
1657413310764,MATH 109,A03,093478,Ganzberger; Geoffrey Michael,2,0,34,32
1657413310764,MATH 109,B01,083215,Ganzberger; Geoffrey Michael,1,0,32,31
1657413310764,MATH 109,B02,083216,Ganzberger; Geoffrey Michael,2,0,32,30
1657413310764,MATH 109,B03,093479,Ganzberger; Geoffrey Michael,8,0,32,24
1657413316787,MATH 142A,A01,083219,Chow; Bennett,7,0,32,25
1657413316787,MATH 142A,A02,083220,Chow; Bennett,10,0,32,22
1657413316787,MATH 142A,A03,093480,Chow; Bennett,8,0,32,24
1657413316787,MATH 142A,B03,093481,Chow; Bennett,8,0,32,24
1657413316787,MATH 142A,B04,093558,Chow; Bennett,13,0,32,19
1657413316787,MATH 142A,B05,093559,Chow; Bennett,6,0,32,26
1657413322819,MATH 193A,A01,083224,Rotar; Vladimir,8,0,34,26
1657413322819,MATH 193A,A02,083225,Rotar; Vladimir,9,0,34,25
1657413322819,MATH 193A,A03,083781,Rotar; Vladimir,5,0,34,29
1657413322819,MATH 193A,A04,083782,Rotar; Vladimir,10,0,34,24
1657413322819,MATH 193A,A05,093482,Rotar; Vladimir,10,0,34,24
1657413328840,MATH 197,001,091859,McAuley; Julian John,9999,0,9999,0
1657413328840,MATH 197,002,095566,Kedlaya; Kiran S.,9997,0,9999,2
1657413328840,MATH 197,003,095567,Xiao; Ming,9999,0,9999,0
1657413328840,MATH 197,004,095571,Perols; Johan Lars,9998,0,9999,1
1657413335907,COGS 9,A01,083615,Shannon; Kyle Michael,9,0,75,66
1657413341930,COGS 11,A01,083617,Boyle; Mary E. T.,22,0,48,26
1657413347956,COGS 13,A01,083071,Bastos; Amalia Pinkusfeld,11,0,71,60
1657413353980,COGS 14A,A01,092681,Semenuks; Arturs,5,1,100,95
1657413360005,COGS 14B,A01,083073,Cheng; Tzu-Han,6,0,63,57
1657413366028,COGS 17,A01,092677,Semenuks; Arturs,6,0,81,75
1657413372052,COGS 100,A01,083619,Allen; Michael Gordon,17,0,70,53
1657413378079,COGS 101A,A01,083621,Davis; Joshua Daniel,9,0,68,59
1657413384102,COGS 101B,A01,091572,Allen; Michael Gordon,12,0,65,53
1657413390125,COGS 101C,A01,083625,Delgado; Tania,17,0,35,18
1657413396146,COGS 107A,A01,083627,Boyle; Mary E. T.,13,0,60,47
1657413402169,COGS 118A,A01,083075,Gupta; Anjum,20,0,76,56
1657413408193,CSE 3,A50,083646,Miranda; Gregory Joseph,24,0,50,26
1657413414220,CSE 8A,A50,083650,Miranda; Gregory Joseph,17,1,56,39
1657413420258,CSE 11,A01,083080,Cao; Yingjun,6,15,40,34
1657413426282,CSE 12,A01,083652,Krause-Levy; Sophia Louisa,28,1,120,92
1657413432308,CSE 15L,A01,083654,Morris; Justin Loren,9,0,50,41
1657413432308,CSE 15L,A02,083655,Morris; Justin Loren,9,0,50,41
1657413438333,CSE 20,A01,083657,Tran; Khoa Dang,39,0,80,41
1657413444356,CSE 21,A01,095574,Bach; Quang Tran,22,0,48,26
1657413450380,CSE 30,A01,083084,Eldon; John,4,0,80,76
1657413450380,CSE 30,B01,095061,Bhaskar; Nishant,9,0,50,41
1657413456404,CSE 100,A01,083659,Cao; Yingjun,5,4,70,65
1657413462426,CSE 134B,A01,083661,Powell; Thomas Allan,22,0,100,78
1657413468452,CSE 140,A01,083663,Gungor; Onat,14,0,85,71
1657413474474,CSE 140L,A01,083088,Eldon; John,21,0,100,79
1657413480499,CSE 175,A01,083665,Kumar; Rakesh,3,0,25,22
1657413486521,CSE 190,A00,092507,Dubnov; Shlomo,7,0,20,13
1657413492546,ECE 45,A01,083139,Congero; Spencer William,6,0,75,69
1657413498573,ECE 65,A50,083695,Saad; Andrew S,12,0,30,18
1657413498573,ECE 65,A51,095125,Saad; Andrew S,24,0,26,2
1657413504597,ECE 109,A01,091882,Touri; Behrouz,19,0,70,51
1657413510622,ECE 180,A00,083140,Abi Samra; Nicholas Camill,1,0,30,29
1657413510622,ECE 180,B00,083141,Abi Samra; Nicholas Camill,0,0,30,30
1657413516650,MATH 10A,A01,083735,Patchell; Gregory David,2,0,30,28
1657413516650,MATH 10A,A02,083736,Patchell; Gregory David,20,0,30,10
1657413516650,MATH 10A,A03,083737,Patchell; Gregory David,16,0,30,14
1657413522673,MATH 10B,A01,083207,Lim; Seonhee,8,0,34,26
1657413522673,MATH 10B,A02,083208,Lim; Seonhee,9,0,35,26
1657413522673,MATH 10B,A03,093472,Lim; Seonhee,7,0,34,27
1657413522673,MATH 10B,B01,083739,Sinha; Shubham,12,0,30,18
1657413528699,MATH 18,A01,083743,Cinel; Cameron Alexander,7,0,30,23
1657413528699,MATH 18,A02,083744,Cinel; Cameron Alexander,17,0,30,13
1657413528699,MATH 18,A03,083745,Cinel; Cameron Alexander,9,0,30,21
1657413528699,MATH 18,B01,083748,Rideout; David Porter,5,0,37,32
1657413528699,MATH 18,B02,083749,Rideout; David Porter,5,0,36,31
1657413528699,MATH 18,B03,083750,Rideout; David Porter,3,0,37,34
1657413528699,MATH 18,B04,083751,Rideout; David Porter,6,0,36,30
1657413528699,MATH 18,B05,093473,Rideout; David Porter,6,0,36,30
1657413528699,MATH 18,B06,093474,Rideout; David Porter,6,0,36,30
1657413534721,MATH 20A,A01,083754,Zheng; Zequn,14,0,40,26
1657413540747,MATH 20B,A01,083756,Briones; Jor-el Thomas Caparas,4,0,36,32
1657413540747,MATH 20B,A02,083757,Briones; Jor-el Thomas Caparas,1,0,36,35
1657413540747,MATH 20B,A03,093475,Briones; Jor-el Thomas Caparas,2,0,36,34
1657413546771,MATH 20C,A01,083760,Briones; Jor-el Thomas Caparas,1,0,35,34
1657413546771,MATH 20C,A02,083761,Briones; Jor-el Thomas Caparas,8,0,35,27
1657413546771,MATH 20C,A03,093476,Briones; Jor-el Thomas Caparas,0,1,36,36
1657413546771,MATH 20C,B01,083762,Bach; Quang Tran,1,0,30,29
1657413552799,MATH 20D,A01,083765,Tran; Brian Kha,5,0,30,25
1657413552799,MATH 20D,A02,083766,Tran; Brian Kha,5,0,30,25
1657413552799,MATH 20D,A03,083767,Tran; Brian Kha,5,0,30,25
1657413558826,MATH 20E,A01,083771,Ganguly; Soumya,9,0,32,23
1657413558826,MATH 20E,A02,083772,Ganguly; Soumya,6,0,32,26
1657413558826,MATH 20E,B01,083773,Ciotti; Benjamin,20,0,35,15
1657413558826,MATH 20E,B02,083774,Ciotti; Benjamin,17,0,35,18
1657413564862,MATH 103A,A01,083777,Greenfeld; Be'Eri,3,0,36,33
1657413564862,MATH 103A,A02,083778,Greenfeld; Be'Eri,5,0,36,31
1657413564862,MATH 103A,A03,093561,Greenfeld; Be'Eri,5,0,36,31
1657413564862,MATH 103A,B01,083779,Greenfeld; Be'Eri,7,0,36,29
1657413564862,MATH 103A,B02,083780,Greenfeld; Be'Eri,4,0,36,32
1657413564862,MATH 103A,B03,093562,Greenfeld; Be'Eri,3,0,36,33
1657413570886,MATH 105,A01,085443,Carter; Anne Toulson,15,0,35,20
1657413570886,MATH 105,A02,093477,Carter; Anne Toulson,20,0,35,15
1657413576911,MATH 109,A01,083213,Ganzberger; Geoffrey Michael,2,0,34,32
1657413576911,MATH 109,A02,083214,Ganzberger; Geoffrey Michael,4,0,34,30
1657413576911,MATH 109,A03,093478,Ganzberger; Geoffrey Michael,2,0,34,32
1657413576911,MATH 109,B01,083215,Ganzberger; Geoffrey Michael,1,0,32,31
1657413576911,MATH 109,B02,083216,Ganzberger; Geoffrey Michael,2,0,32,30
1657413576911,MATH 109,B03,093479,Ganzberger; Geoffrey Michael,8,0,32,24
1657413582935,MATH 142A,A01,083219,Chow; Bennett,7,0,32,25
1657413582935,MATH 142A,A02,083220,Chow; Bennett,10,0,32,22
1657413582935,MATH 142A,A03,093480,Chow; Bennett,8,0,32,24
1657413582935,MATH 142A,B03,093481,Chow; Bennett,8,0,32,24
1657413582935,MATH 142A,B04,093558,Chow; Bennett,13,0,32,19
1657413582935,MATH 142A,B05,093559,Chow; Bennett,6,0,32,26
1657413588962,MATH 193A,A01,083224,Rotar; Vladimir,8,0,34,26
1657413588962,MATH 193A,A02,083225,Rotar; Vladimir,9,0,34,25
1657413588962,MATH 193A,A03,083781,Rotar; Vladimir,5,0,34,29
1657413588962,MATH 193A,A04,083782,Rotar; Vladimir,10,0,34,24
1657413588962,MATH 193A,A05,093482,Rotar; Vladimir,10,0,34,24
1657413595020,MATH 197,001,091859,McAuley; Julian John,9999,0,9999,0
1657413595020,MATH 197,002,095566,Kedlaya; Kiran S.,9997,0,9999,2
1657413595020,MATH 197,003,095567,Xiao; Ming,9999,0,9999,0
1657413595020,MATH 197,004,095571,Perols; Johan Lars,9998,0,9999,1
1657413602105,COGS 9,A01,083615,Shannon; Kyle Michael,9,0,75,66
1657413608128,COGS 11,A01,083617,Boyle; Mary E. T.,22,0,48,26
1657413614175,COGS 13,A01,083071,Bastos; Amalia Pinkusfeld,11,0,71,60
1657413620203,COGS 14A,A01,092681,Semenuks; Arturs,5,1,100,95
1657413626230,COGS 14B,A01,083073,Cheng; Tzu-Han,6,0,63,57
1657413632253,COGS 17,A01,092677,Semenuks; Arturs,6,0,81,75
1657413638274,COGS 100,A01,083619,Allen; Michael Gordon,17,0,70,53
1657413644297,COGS 101A,A01,083621,Davis; Joshua Daniel,9,0,68,59
1657413650322,COGS 101B,A01,091572,Allen; Michael Gordon,12,0,65,53
1657413656346,COGS 101C,A01,083625,Delgado; Tania,17,0,35,18
1657413662372,COGS 107A,A01,083627,Boyle; Mary E. T.,13,0,60,47
1657413668395,COGS 118A,A01,083075,Gupta; Anjum,20,0,76,56
1657413674418,CSE 3,A50,083646,Miranda; Gregory Joseph,24,0,50,26
1657413680441,CSE 8A,A50,083650,Miranda; Gregory Joseph,17,1,56,39
1657413686464,CSE 11,A01,083080,Cao; Yingjun,6,15,40,34
1657413692489,CSE 12,A01,083652,Krause-Levy; Sophia Louisa,28,1,120,92
1657413698513,CSE 15L,A01,083654,Morris; Justin Loren,9,0,50,41
1657413698513,CSE 15L,A02,083655,Morris; Justin Loren,9,0,50,41
1657413704536,CSE 20,A01,083657,Tran; Khoa Dang,39,0,80,41
1657413710558,CSE 21,A01,095574,Bach; Quang Tran,22,0,48,26
1657413716581,CSE 30,A01,083084,Eldon; John,4,0,80,76
1657413716581,CSE 30,B01,095061,Bhaskar; Nishant,9,0,50,41
1657413722605,CSE 100,A01,083659,Cao; Yingjun,5,4,70,65
1657413728717,CSE 134B,A01,083661,Powell; Thomas Allan,22,0,100,78
1657413734743,CSE 140,A01,083663,Gungor; Onat,14,0,85,71
1657413740770,CSE 140L,A01,083088,Eldon; John,21,0,100,79
1657413746796,CSE 175,A01,083665,Kumar; Rakesh,3,0,25,22
1657413752819,CSE 190,A00,092507,Dubnov; Shlomo,7,0,20,13
1657413758842,ECE 45,A01,083139,Congero; Spencer William,6,0,75,69
1657413764866,ECE 65,A50,083695,Saad; Andrew S,12,0,30,18
1657413764866,ECE 65,A51,095125,Saad; Andrew S,24,0,26,2
1657413770890,ECE 109,A01,091882,Touri; Behrouz,19,0,70,51
1657413776920,ECE 180,A00,083140,Abi Samra; Nicholas Camill,1,0,30,29
1657413776920,ECE 180,B00,083141,Abi Samra; Nicholas Camill,0,0,30,30
1657413782944,MATH 10A,A01,083735,Patchell; Gregory David,2,0,30,28
1657413782944,MATH 10A,A02,083736,Patchell; Gregory David,20,0,30,10
1657413782944,MATH 10A,A03,083737,Patchell; Gregory David,16,0,30,14
1657413788971,MATH 10B,A01,083207,Lim; Seonhee,8,0,34,26
1657413788971,MATH 10B,A02,083208,Lim; Seonhee,9,0,35,26
1657413788971,MATH 10B,A03,093472,Lim; Seonhee,7,0,34,27
1657413788971,MATH 10B,B01,083739,Sinha; Shubham,12,0,30,18
1657413795001,MATH 18,A01,083743,Cinel; Cameron Alexander,7,0,30,23
1657413795001,MATH 18,A02,083744,Cinel; Cameron Alexander,17,0,30,13
1657413795001,MATH 18,A03,083745,Cinel; Cameron Alexander,9,0,30,21
1657413795001,MATH 18,B01,083748,Rideout; David Porter,5,0,37,32
1657413795001,MATH 18,B02,083749,Rideout; David Porter,5,0,36,31
1657413795001,MATH 18,B03,083750,Rideout; David Porter,3,0,37,34
1657413795001,MATH 18,B04,083751,Rideout; David Porter,6,0,36,30
1657413795001,MATH 18,B05,093473,Rideout; David Porter,6,0,36,30
1657413795001,MATH 18,B06,093474,Rideout; David Porter,6,0,36,30
1657413801033,MATH 20A,A01,083754,Zheng; Zequn,14,0,40,26
1657413807058,MATH 20B,A01,083756,Briones; Jor-el Thomas Caparas,4,0,36,32
1657413807058,MATH 20B,A02,083757,Briones; Jor-el Thomas Caparas,1,0,36,35
1657413807058,MATH 20B,A03,093475,Briones; Jor-el Thomas Caparas,2,0,36,34
1657413813087,MATH 20C,A01,083760,Briones; Jor-el Thomas Caparas,1,0,35,34
1657413813087,MATH 20C,A02,083761,Briones; Jor-el Thomas Caparas,8,0,35,27
1657413813087,MATH 20C,A03,093476,Briones; Jor-el Thomas Caparas,0,1,36,36
1657413813087,MATH 20C,B01,083762,Bach; Quang Tran,1,0,30,29
1657413819111,MATH 20D,A01,083765,Tran; Brian Kha,5,0,30,25
1657413819111,MATH 20D,A02,083766,Tran; Brian Kha,5,0,30,25
1657413819111,MATH 20D,A03,083767,Tran; Brian Kha,5,0,30,25
1657413825139,MATH 20E,A01,083771,Ganguly; Soumya,9,0,32,23
1657413825139,MATH 20E,A02,083772,Ganguly; Soumya,6,0,32,26
1657413825139,MATH 20E,B01,083773,Ciotti; Benjamin,20,0,35,15
1657413825139,MATH 20E,B02,083774,Ciotti; Benjamin,17,0,35,18
1657413831161,MATH 103A,A01,083777,Greenfeld; Be'Eri,3,0,36,33
1657413831161,MATH 103A,A02,083778,Greenfeld; Be'Eri,5,0,36,31
1657413831161,MATH 103A,A03,093561,Greenfeld; Be'Eri,5,0,36,31
1657413831161,MATH 103A,B01,083779,Greenfeld; Be'Eri,7,0,36,29
1657413831161,MATH 103A,B02,083780,Greenfeld; Be'Eri,4,0,36,32
1657413831161,MATH 103A,B03,093562,Greenfeld; Be'Eri,3,0,36,33
1657413837186,MATH 105,A01,085443,Carter; Anne Toulson,15,0,35,20
1657413837186,MATH 105,A02,093477,Carter; Anne Toulson,20,0,35,15
1657413843215,MATH 109,A01,083213,Ganzberger; Geoffrey Michael,2,0,34,32
1657413843215,MATH 109,A02,083214,Ganzberger; Geoffrey Michael,4,0,34,30
1657413843215,MATH 109,A03,093478,Ganzberger; Geoffrey Michael,2,0,34,32
1657413843215,MATH 109,B01,083215,Ganzberger; Geoffrey Michael,1,0,32,31
1657413843215,MATH 109,B02,083216,Ganzberger; Geoffrey Michael,2,0,32,30
1657413843215,MATH 109,B03,093479,Ganzberger; Geoffrey Michael,8,0,32,24
1657413849238,MATH 142A,A01,083219,Chow; Bennett,7,0,32,25
1657413849238,MATH 142A,A02,083220,Chow; Bennett,10,0,32,22
1657413849238,MATH 142A,A03,093480,Chow; Bennett,8,0,32,24
1657413849238,MATH 142A,B03,093481,Chow; Bennett,8,0,32,24
1657413849238,MATH 142A,B04,093558,Chow; Bennett,13,0,32,19
1657413849238,MATH 142A,B05,093559,Chow; Bennett,6,0,32,26
1657413855265,MATH 193A,A01,083224,Rotar; Vladimir,8,0,34,26
1657413855265,MATH 193A,A02,083225,Rotar; Vladimir,9,0,34,25
1657413855265,MATH 193A,A03,083781,Rotar; Vladimir,5,0,34,29
1657413855265,MATH 193A,A04,083782,Rotar; Vladimir,10,0,34,24
1657413855265,MATH 193A,A05,093482,Rotar; Vladimir,10,0,34,24
1657413861290,MATH 197,001,091859,McAuley; Julian John,9999,0,9999,0
1657413861290,MATH 197,002,095566,Kedlaya; Kiran S.,9997,0,9999,2
1657413861290,MATH 197,003,095567,Xiao; Ming,9999,0,9999,0
1657413861290,MATH 197,004,095571,Perols; Johan Lars,9998,0,9999,1
1657413868346,COGS 9,A01,083615,Shannon; Kyle Michael,9,0,75,66
1657413874372,COGS 11,A01,083617,Boyle; Mary E. T.,22,0,48,26
1657413880399,COGS 13,A01,083071,Bastos; Amalia Pinkusfeld,11,0,71,60
1657413886422,COGS 14A,A01,092681,Semenuks; Arturs,5,1,100,95
1657413892448,COGS 14B,A01,083073,Cheng; Tzu-Han,6,0,63,57
1657413898472,COGS 17,A01,092677,Semenuks; Arturs,6,0,81,75
1657413904499,COGS 100,A01,083619,Allen; Michael Gordon,17,0,70,53
1657413910526,COGS 101A,A01,083621,Davis; Joshua Daniel,9,0,68,59
1657413916558,COGS 101B,A01,091572,Allen; Michael Gordon,12,0,65,53
1657413922581,COGS 101C,A01,083625,Delgado; Tania,17,0,35,18
1657413928605,COGS 107A,A01,083627,Boyle; Mary E. T.,13,0,60,47
1657413934628,COGS 118A,A01,083075,Gupta; Anjum,20,0,76,56
1657413940652,CSE 3,A50,083646,Miranda; Gregory Joseph,24,0,50,26
1657413946674,CSE 8A,A50,083650,Miranda; Gregory Joseph,17,1,56,39
1657413952695,CSE 11,A01,083080,Cao; Yingjun,6,15,40,34
1657413958717,CSE 12,A01,083652,Krause-Levy; Sophia Louisa,28,1,120,92
1657413964744,CSE 15L,A01,083654,Morris; Justin Loren,9,0,50,41
1657413964744,CSE 15L,A02,083655,Morris; Justin Loren,9,0,50,41
1657413970770,CSE 20,A01,083657,Tran; Khoa Dang,39,0,80,41
1657413976792,CSE 21,A01,095574,Bach; Quang Tran,22,0,48,26
1657413982815,CSE 30,A01,083084,Eldon; John,4,0,80,76
1657413982815,CSE 30,B01,095061,Bhaskar; Nishant,9,0,50,41
1657413988837,CSE 100,A01,083659,Cao; Yingjun,5,4,70,65
1657413994862,CSE 134B,A01,083661,Powell; Thomas Allan,22,0,100,78
1657414000888,CSE 140,A01,083663,Gungor; Onat,14,0,85,71
1657414006912,CSE 140L,A01,083088,Eldon; John,21,0,100,79
1657414012941,CSE 175,A01,083665,Kumar; Rakesh,3,0,25,22
1657414018967,CSE 190,A00,092507,Dubnov; Shlomo,7,0,20,13
1657414024990,ECE 45,A01,083139,Congero; Spencer William,6,0,75,69
1657414031021,ECE 65,A50,083695,Saad; Andrew S,12,0,30,18
1657414031021,ECE 65,A51,095125,Saad; Andrew S,24,0,26,2
1657414037046,ECE 109,A01,091882,Touri; Behrouz,19,0,70,51
1657414043071,ECE 180,A00,083140,Abi Samra; Nicholas Camill,1,0,30,29
1657414043071,ECE 180,B00,083141,Abi Samra; Nicholas Camill,0,0,30,30
1657414049094,MATH 10A,A01,083735,Patchell; Gregory David,2,0,30,28
1657414049094,MATH 10A,A02,083736,Patchell; Gregory David,20,0,30,10
1657414049094,MATH 10A,A03,083737,Patchell; Gregory David,16,0,30,14
1657414055119,MATH 10B,A01,083207,Lim; Seonhee,8,0,34,26
1657414055119,MATH 10B,A02,083208,Lim; Seonhee,9,0,35,26
1657414055119,MATH 10B,A03,093472,Lim; Seonhee,7,0,34,27
1657414055119,MATH 10B,B01,083739,Sinha; Shubham,12,0,30,18
1657414061143,MATH 18,A01,083743,Cinel; Cameron Alexander,7,0,30,23
1657414061143,MATH 18,A02,083744,Cinel; Cameron Alexander,17,0,30,13
1657414061143,MATH 18,A03,083745,Cinel; Cameron Alexander,9,0,30,21
1657414061143,MATH 18,B01,083748,Rideout; David Porter,5,0,37,32
1657414061143,MATH 18,B02,083749,Rideout; David Porter,5,0,36,31
1657414061143,MATH 18,B03,083750,Rideout; David Porter,3,0,37,34
1657414061143,MATH 18,B04,083751,Rideout; David Porter,6,0,36,30
1657414061143,MATH 18,B05,093473,Rideout; David Porter,6,0,36,30
1657414061143,MATH 18,B06,093474,Rideout; David Porter,6,0,36,30
1657414067167,MATH 20A,A01,083754,Zheng; Zequn,14,0,40,26
1657414073191,MATH 20B,A01,083756,Briones; Jor-el Thomas Caparas,4,0,36,32
1657414073191,MATH 20B,A02,083757,Briones; Jor-el Thomas Caparas,1,0,36,35
1657414073191,MATH 20B,A03,093475,Briones; Jor-el Thomas Caparas,2,0,36,34
1657414079214,MATH 20C,A01,083760,Briones; Jor-el Thomas Caparas,1,0,35,34
1657414079214,MATH 20C,A02,083761,Briones; Jor-el Thomas Caparas,8,0,35,27
1657414079214,MATH 20C,A03,093476,Briones; Jor-el Thomas Caparas,0,1,36,36
1657414079214,MATH 20C,B01,083762,Bach; Quang Tran,1,0,30,29
1657414085245,MATH 20D,A01,083765,Tran; Brian Kha,5,0,30,25
1657414085245,MATH 20D,A02,083766,Tran; Brian Kha,5,0,30,25
1657414085245,MATH 20D,A03,083767,Tran; Brian Kha,5,0,30,25
1657414091273,MATH 20E,A01,083771,Ganguly; Soumya,9,0,32,23
1657414091273,MATH 20E,A02,083772,Ganguly; Soumya,6,0,32,26
1657414091273,MATH 20E,B01,083773,Ciotti; Benjamin,20,0,35,15
1657414091273,MATH 20E,B02,083774,Ciotti; Benjamin,17,0,35,18
1657414097302,MATH 103A,A01,083777,Greenfeld; Be'Eri,3,0,36,33
1657414097302,MATH 103A,A02,083778,Greenfeld; Be'Eri,5,0,36,31
1657414097302,MATH 103A,A03,093561,Greenfeld; Be'Eri,5,0,36,31
1657414097302,MATH 103A,B01,083779,Greenfeld; Be'Eri,7,0,36,29
1657414097302,MATH 103A,B02,083780,Greenfeld; Be'Eri,4,0,36,32
1657414097302,MATH 103A,B03,093562,Greenfeld; Be'Eri,3,0,36,33
1657414103325,MATH 105,A01,085443,Carter; Anne Toulson,15,0,35,20
1657414103325,MATH 105,A02,093477,Carter; Anne Toulson,20,0,35,15
1657414109355,MATH 109,A01,083213,Ganzberger; Geoffrey Michael,2,0,34,32
1657414109355,MATH 109,A02,083214,Ganzberger; Geoffrey Michael,4,0,34,30
1657414109355,MATH 109,A03,093478,Ganzberger; Geoffrey Michael,2,0,34,32
1657414109355,MATH 109,B01,083215,Ganzberger; Geoffrey Michael,1,0,32,31
1657414109355,MATH 109,B02,083216,Ganzberger; Geoffrey Michael,2,0,32,30
1657414109355,MATH 109,B03,093479,Ganzberger; Geoffrey Michael,8,0,32,24
1657414115379,MATH 142A,A01,083219,Chow; Bennett,7,0,32,25
1657414115379,MATH 142A,A02,083220,Chow; Bennett,10,0,32,22
1657414115379,MATH 142A,A03,093480,Chow; Bennett,8,0,32,24
1657414115379,MATH 142A,B03,093481,Chow; Bennett,8,0,32,24
1657414115379,MATH 142A,B04,093558,Chow; Bennett,13,0,32,19
1657414115379,MATH 142A,B05,093559,Chow; Bennett,6,0,32,26
1657414121403,MATH 193A,A01,083224,Rotar; Vladimir,8,0,34,26
1657414121403,MATH 193A,A02,083225,Rotar; Vladimir,9,0,34,25
1657414121403,MATH 193A,A03,083781,Rotar; Vladimir,5,0,34,29
1657414121403,MATH 193A,A04,083782,Rotar; Vladimir,10,0,34,24
1657414121403,MATH 193A,A05,093482,Rotar; Vladimir,10,0,34,24
1657414127429,MATH 197,001,091859,McAuley; Julian John,9999,0,9999,0
1657414127429,MATH 197,002,095566,Kedlaya; Kiran S.,9997,0,9999,2
1657414127429,MATH 197,003,095567,Xiao; Ming,9999,0,9999,0
1657414127429,MATH 197,004,095571,Perols; Johan Lars,9998,0,9999,1
1657414134479,COGS 9,A01,083615,Shannon; Kyle Michael,9,0,75,66
1657414140502,COGS 11,A01,083617,Boyle; Mary E. T.,22,0,48,26
1657414146525,COGS 13,A01,083071,Bastos; Amalia Pinkusfeld,11,0,71,60
1657414152553,COGS 14A,A01,092681,Semenuks; Arturs,5,1,100,95
1657414158574,COGS 14B,A01,083073,Cheng; Tzu-Han,6,0,63,57
1657414164599,COGS 17,A01,092677,Semenuks; Arturs,6,0,81,75
1657414170627,COGS 100,A01,083619,Allen; Michael Gordon,17,0,70,53
1657414176653,COGS 101A,A01,083621,Davis; Joshua Daniel,9,0,68,59
1657414182680,COGS 101B,A01,091572,Allen; Michael Gordon,12,0,65,53
1657414188704,COGS 101C,A01,083625,Delgado; Tania,17,0,35,18
1657414194725,COGS 107A,A01,083627,Boyle; Mary E. T.,13,0,60,47
1657414200752,COGS 118A,A01,083075,Gupta; Anjum,20,0,76,56
1657414206777,CSE 3,A50,083646,Miranda; Gregory Joseph,24,0,50,26
1657414212803,CSE 8A,A50,083650,Miranda; Gregory Joseph,17,1,56,39
1657414218828,CSE 11,A01,083080,Cao; Yingjun,6,15,40,34
1657414224852,CSE 12,A01,083652,Krause-Levy; Sophia Louisa,28,1,120,92
1657414230880,CSE 15L,A01,083654,Morris; Justin Loren,9,0,50,41
1657414230880,CSE 15L,A02,083655,Morris; Justin Loren,9,0,50,41
1657414236906,CSE 20,A01,083657,Tran; Khoa Dang,39,0,80,41
1657414242930,CSE 21,A01,095574,Bach; Quang Tran,22,0,48,26
1657414248954,CSE 30,A01,083084,Eldon; John,4,0,80,76
1657414248954,CSE 30,B01,095061,Bhaskar; Nishant,9,0,50,41
1657414254977,CSE 100,A01,083659,Cao; Yingjun,5,4,70,65
1657414260999,CSE 134B,A01,083661,Powell; Thomas Allan,22,0,100,78
1657414267025,CSE 140,A01,083663,Gungor; Onat,14,0,85,71
1657414273047,CSE 140L,A01,083088,Eldon; John,21,0,100,79
1657414279070,CSE 175,A01,083665,Kumar; Rakesh,3,0,25,22
1657414285096,CSE 190,A00,092507,Dubnov; Shlomo,7,0,20,13
1657414291120,ECE 45,A01,083139,Congero; Spencer William,6,0,75,69
1657414297143,ECE 65,A50,083695,Saad; Andrew S,12,0,30,18
1657414297143,ECE 65,A51,095125,Saad; Andrew S,24,0,26,2
1657414303167,ECE 109,A01,091882,Touri; Behrouz,19,0,70,51
1657414309195,ECE 180,A00,083140,Abi Samra; Nicholas Camill,1,0,30,29
1657414309195,ECE 180,B00,083141,Abi Samra; Nicholas Camill,0,0,30,30
1657414315222,MATH 10A,A01,083735,Patchell; Gregory David,2,0,30,28
1657414315222,MATH 10A,A02,083736,Patchell; Gregory David,20,0,30,10
1657414315222,MATH 10A,A03,083737,Patchell; Gregory David,16,0,30,14
1657414321252,MATH 10B,A01,083207,Lim; Seonhee,8,0,34,26
1657414321252,MATH 10B,A02,083208,Lim; Seonhee,9,0,35,26
1657414321252,MATH 10B,A03,093472,Lim; Seonhee,7,0,34,27
1657414321252,MATH 10B,B01,083739,Sinha; Shubham,12,0,30,18
1657414327351,MATH 18,A01,083743,Cinel; Cameron Alexander,7,0,30,23
1657414327351,MATH 18,A02,083744,Cinel; Cameron Alexander,17,0,30,13
1657414327351,MATH 18,A03,083745,Cinel; Cameron Alexander,9,0,30,21
1657414327351,MATH 18,B01,083748,Rideout; David Porter,5,0,37,32
1657414327351,MATH 18,B02,083749,Rideout; David Porter,5,0,36,31
1657414327351,MATH 18,B03,083750,Rideout; David Porter,3,0,37,34
1657414327351,MATH 18,B04,083751,Rideout; David Porter,6,0,36,30
1657414327351,MATH 18,B05,093473,Rideout; David Porter,6,0,36,30
1657414327351,MATH 18,B06,093474,Rideout; David Porter,6,0,36,30
1657414333372,MATH 20A,A01,083754,Zheng; Zequn,14,0,40,26
1657414339396,MATH 20B,A01,083756,Briones; Jor-el Thomas Caparas,4,0,36,32
1657414339396,MATH 20B,A02,083757,Briones; Jor-el Thomas Caparas,1,0,36,35
1657414339396,MATH 20B,A03,093475,Briones; Jor-el Thomas Caparas,2,0,36,34
1657414345419,MATH 20C,A01,083760,Briones; Jor-el Thomas Caparas,1,0,35,34
1657414345419,MATH 20C,A02,083761,Briones; Jor-el Thomas Caparas,8,0,35,27
1657414345419,MATH 20C,A03,093476,Briones; Jor-el Thomas Caparas,0,1,36,36
1657414345419,MATH 20C,B01,083762,Bach; Quang Tran,1,0,30,29
1657414351443,MATH 20D,A01,083765,Tran; Brian Kha,5,0,30,25
1657414351443,MATH 20D,A02,083766,Tran; Brian Kha,5,0,30,25
1657414351443,MATH 20D,A03,083767,Tran; Brian Kha,5,0,30,25
1657414357473,MATH 20E,A01,083771,Ganguly; Soumya,9,0,32,23
1657414357473,MATH 20E,A02,083772,Ganguly; Soumya,6,0,32,26
1657414357473,MATH 20E,B01,083773,Ciotti; Benjamin,20,0,35,15
1657414357473,MATH 20E,B02,083774,Ciotti; Benjamin,17,0,35,18
1657414363504,MATH 103A,A01,083777,Greenfeld; Be'Eri,3,0,36,33
1657414363504,MATH 103A,A02,083778,Greenfeld; Be'Eri,5,0,36,31
1657414363504,MATH 103A,A03,093561,Greenfeld; Be'Eri,5,0,36,31
1657414363504,MATH 103A,B01,083779,Greenfeld; Be'Eri,7,0,36,29
1657414363504,MATH 103A,B02,083780,Greenfeld; Be'Eri,4,0,36,32
1657414363504,MATH 103A,B03,093562,Greenfeld; Be'Eri,3,0,36,33
1657414369526,MATH 105,A01,085443,Carter; Anne Toulson,15,0,35,20
1657414369526,MATH 105,A02,093477,Carter; Anne Toulson,20,0,35,15
1657414375561,MATH 109,A01,083213,Ganzberger; Geoffrey Michael,2,0,34,32
1657414375561,MATH 109,A02,083214,Ganzberger; Geoffrey Michael,4,0,34,30
1657414375561,MATH 109,A03,093478,Ganzberger; Geoffrey Michael,2,0,34,32
1657414375561,MATH 109,B01,083215,Ganzberger; Geoffrey Michael,1,0,32,31
1657414375561,MATH 109,B02,083216,Ganzberger; Geoffrey Michael,2,0,32,30
1657414375561,MATH 109,B03,093479,Ganzberger; Geoffrey Michael,8,0,32,24
1657414381583,MATH 142A,A01,083219,Chow; Bennett,7,0,32,25
1657414381583,MATH 142A,A02,083220,Chow; Bennett,10,0,32,22
1657414381583,MATH 142A,A03,093480,Chow; Bennett,8,0,32,24
1657414381583,MATH 142A,B03,093481,Chow; Bennett,8,0,32,24
1657414381583,MATH 142A,B04,093558,Chow; Bennett,13,0,32,19
1657414381583,MATH 142A,B05,093559,Chow; Bennett,6,0,32,26
1657414387609,MATH 193A,A01,083224,Rotar; Vladimir,8,0,34,26
1657414387609,MATH 193A,A02,083225,Rotar; Vladimir,9,0,34,25
1657414387609,MATH 193A,A03,083781,Rotar; Vladimir,5,0,34,29
1657414387609,MATH 193A,A04,083782,Rotar; Vladimir,10,0,34,24
1657414387609,MATH 193A,A05,093482,Rotar; Vladimir,10,0,34,24
1657414393631,MATH 197,001,091859,McAuley; Julian John,9999,0,9999,0
1657414393631,MATH 197,002,095566,Kedlaya; Kiran S.,9997,0,9999,2
1657414393631,MATH 197,003,095567,Xiao; Ming,9999,0,9999,0
1657414393631,MATH 197,004,095571,Perols; Johan Lars,9998,0,9999,1
1657414400686,COGS 9,A01,083615,Shannon; Kyle Michael,9,0,75,66
1657414406712,COGS 11,A01,083617,Boyle; Mary E. T.,22,0,48,26
1657414412736,COGS 13,A01,083071,Bastos; Amalia Pinkusfeld,11,0,71,60
1657414418764,COGS 14A,A01,092681,Semenuks; Arturs,5,1,100,95
1657414424806,COGS 14B,A01,083073,Cheng; Tzu-Han,6,0,63,57
1657414430831,COGS 17,A01,092677,Semenuks; Arturs,6,0,81,75
1657414436857,COGS 100,A01,083619,Allen; Michael Gordon,17,0,70,53
1657414442883,COGS 101A,A01,083621,Davis; Joshua Daniel,9,0,68,59
1657414448905,COGS 101B,A01,091572,Allen; Michael Gordon,12,0,65,53
1657414454932,COGS 101C,A01,083625,Delgado; Tania,17,0,35,18
1657414460953,COGS 107A,A01,083627,Boyle; Mary E. T.,13,0,60,47
1657414466986,COGS 118A,A01,083075,Gupta; Anjum,20,0,76,56
1657414473010,CSE 3,A50,083646,Miranda; Gregory Joseph,24,0,50,26
1657414479038,CSE 8A,A50,083650,Miranda; Gregory Joseph,17,1,56,39
1657414485061,CSE 11,A01,083080,Cao; Yingjun,6,15,40,34
1657414491084,CSE 12,A01,083652,Krause-Levy; Sophia Louisa,28,1,120,92
1657414497112,CSE 15L,A01,083654,Morris; Justin Loren,9,0,50,41
1657414497112,CSE 15L,A02,083655,Morris; Justin Loren,9,0,50,41
1657414503137,CSE 20,A01,083657,Tran; Khoa Dang,39,0,80,41
1657414509163,CSE 21,A01,095574,Bach; Quang Tran,22,0,48,26
1657414515190,CSE 30,A01,083084,Eldon; John,4,0,80,76
1657414515190,CSE 30,B01,095061,Bhaskar; Nishant,9,0,50,41
1657414521213,CSE 100,A01,083659,Cao; Yingjun,5,4,70,65
1657414527240,CSE 134B,A01,083661,Powell; Thomas Allan,22,0,100,78
1657414533264,CSE 140,A01,083663,Gungor; Onat,14,0,85,71
1657414539286,CSE 140L,A01,083088,Eldon; John,21,0,100,79
1657414545311,CSE 175,A01,083665,Kumar; Rakesh,3,0,25,22
1657414551336,CSE 190,A00,092507,Dubnov; Shlomo,7,0,20,13
1657414557364,ECE 45,A01,083139,Congero; Spencer William,6,0,75,69
1657414563392,ECE 65,A50,083695,Saad; Andrew S,12,0,30,18
1657414563392,ECE 65,A51,095125,Saad; Andrew S,24,0,26,2
1657414569417,ECE 109,A01,091882,Touri; Behrouz,19,0,70,51
1657414575440,ECE 180,A00,083140,Abi Samra; Nicholas Camill,1,0,30,29
1657414575440,ECE 180,B00,083141,Abi Samra; Nicholas Camill,0,0,30,30
1657414581464,MATH 10A,A01,083735,Patchell; Gregory David,2,0,30,28
1657414581464,MATH 10A,A02,083736,Patchell; Gregory David,20,0,30,10
1657414581464,MATH 10A,A03,083737,Patchell; Gregory David,16,0,30,14
1657414587495,MATH 10B,A01,083207,Lim; Seonhee,8,0,34,26
1657414587495,MATH 10B,A02,083208,Lim; Seonhee,9,0,35,26
1657414587495,MATH 10B,A03,093472,Lim; Seonhee,7,0,34,27
1657414587495,MATH 10B,B01,083739,Sinha; Shubham,12,0,30,18
1657414593519,MATH 18,A01,083743,Cinel; Cameron Alexander,7,0,30,23
1657414593519,MATH 18,A02,083744,Cinel; Cameron Alexander,17,0,30,13
1657414593519,MATH 18,A03,083745,Cinel; Cameron Alexander,9,0,30,21
1657414593519,MATH 18,B01,083748,Rideout; David Porter,5,0,37,32
1657414593519,MATH 18,B02,083749,Rideout; David Porter,5,0,36,31
1657414593519,MATH 18,B03,083750,Rideout; David Porter,3,0,37,34
1657414593519,MATH 18,B04,083751,Rideout; David Porter,6,0,36,30
1657414593519,MATH 18,B05,093473,Rideout; David Porter,6,0,36,30
1657414593519,MATH 18,B06,093474,Rideout; David Porter,6,0,36,30
1657414599551,MATH 20A,A01,083754,Zheng; Zequn,14,0,40,26
1657414605575,MATH 20B,A01,083756,Briones; Jor-el Thomas Caparas,4,0,36,32
1657414605575,MATH 20B,A02,083757,Briones; Jor-el Thomas Caparas,1,0,36,35
1657414605575,MATH 20B,A03,093475,Briones; Jor-el Thomas Caparas,2,0,36,34
1657414611603,MATH 20C,A01,083760,Briones; Jor-el Thomas Caparas,1,0,35,34
1657414611603,MATH 20C,A02,083761,Briones; Jor-el Thomas Caparas,8,0,35,27
1657414611603,MATH 20C,A03,093476,Briones; Jor-el Thomas Caparas,0,1,36,36
1657414611603,MATH 20C,B01,083762,Bach; Quang Tran,1,0,30,29
1657414617632,MATH 20D,A01,083765,Tran; Brian Kha,5,0,30,25
1657414617632,MATH 20D,A02,083766,Tran; Brian Kha,5,0,30,25
1657414617632,MATH 20D,A03,083767,Tran; Brian Kha,5,0,30,25
1657414623655,MATH 20E,A01,083771,Ganguly; Soumya,9,0,32,23
1657414623655,MATH 20E,A02,083772,Ganguly; Soumya,6,0,32,26
1657414623655,MATH 20E,B01,083773,Ciotti; Benjamin,20,0,35,15
1657414623655,MATH 20E,B02,083774,Ciotti; Benjamin,17,0,35,18
1657414629679,MATH 103A,A01,083777,Greenfeld; Be'Eri,3,0,36,33
1657414629679,MATH 103A,A02,083778,Greenfeld; Be'Eri,5,0,36,31
1657414629679,MATH 103A,A03,093561,Greenfeld; Be'Eri,5,0,36,31
1657414629679,MATH 103A,B01,083779,Greenfeld; Be'Eri,7,0,36,29
1657414629679,MATH 103A,B02,083780,Greenfeld; Be'Eri,4,0,36,32
1657414629679,MATH 103A,B03,093562,Greenfeld; Be'Eri,3,0,36,33
1657414635707,MATH 105,A01,085443,Carter; Anne Toulson,15,0,35,20
1657414635707,MATH 105,A02,093477,Carter; Anne Toulson,20,0,35,15
1657414641731,MATH 109,A01,083213,Ganzberger; Geoffrey Michael,2,0,34,32
1657414641731,MATH 109,A02,083214,Ganzberger; Geoffrey Michael,4,0,34,30
1657414641731,MATH 109,A03,093478,Ganzberger; Geoffrey Michael,2,0,34,32
1657414641731,MATH 109,B01,083215,Ganzberger; Geoffrey Michael,1,0,32,31
1657414641731,MATH 109,B02,083216,Ganzberger; Geoffrey Michael,2,0,32,30
1657414641731,MATH 109,B03,093479,Ganzberger; Geoffrey Michael,8,0,32,24
1657414647756,MATH 142A,A01,083219,Chow; Bennett,7,0,32,25
1657414647756,MATH 142A,A02,083220,Chow; Bennett,10,0,32,22
1657414647756,MATH 142A,A03,093480,Chow; Bennett,8,0,32,24
1657414647756,MATH 142A,B03,093481,Chow; Bennett,8,0,32,24
1657414647756,MATH 142A,B04,093558,Chow; Bennett,13,0,32,19
1657414647756,MATH 142A,B05,093559,Chow; Bennett,6,0,32,26
1657414653780,MATH 193A,A01,083224,Rotar; Vladimir,8,0,34,26
1657414653780,MATH 193A,A02,083225,Rotar; Vladimir,9,0,34,25
1657414653780,MATH 193A,A03,083781,Rotar; Vladimir,5,0,34,29
1657414653780,MATH 193A,A04,083782,Rotar; Vladimir,10,0,34,24
1657414653780,MATH 193A,A05,093482,Rotar; Vladimir,10,0,34,24
1657414659807,MATH 197,001,091859,McAuley; Julian John,9999,0,9999,0
1657414659807,MATH 197,002,095566,Kedlaya; Kiran S.,9997,0,9999,2
1657414659807,MATH 197,003,095567,Xiao; Ming,9999,0,9999,0
1657414659807,MATH 197,004,095571,Perols; Johan Lars,9998,0,9999,1
1657414666873,COGS 9,A01,083615,Shannon; Kyle Michael,9,0,75,66
1657414672900,COGS 11,A01,083617,Boyle; Mary E. T.,22,0,48,26
1657414678928,COGS 13,A01,083071,Bastos; Amalia Pinkusfeld,11,0,71,60
1657414684957,COGS 14A,A01,092681,Semenuks; Arturs,5,1,100,95
1657414690980,COGS 14B,A01,083073,Cheng; Tzu-Han,6,0,63,57
1657414697002,COGS 17,A01,092677,Semenuks; Arturs,6,0,81,75
1657414703025,COGS 100,A01,083619,Allen; Michael Gordon,17,0,70,53
1657414709048,COGS 101A,A01,083621,Davis; Joshua Daniel,9,0,68,59
1657414715071,COGS 101B,A01,091572,Allen; Michael Gordon,12,0,65,53
1657414721096,COGS 101C,A01,083625,Delgado; Tania,17,0,35,18
1657414727124,COGS 107A,A01,083627,Boyle; Mary E. T.,13,0,60,47
1657414733148,COGS 118A,A01,083075,Gupta; Anjum,20,0,76,56
1657414739175,CSE 3,A50,083646,Miranda; Gregory Joseph,24,0,50,26
1657414745203,CSE 8A,A50,083650,Miranda; Gregory Joseph,17,1,56,39
1657414751229,CSE 11,A01,083080,Cao; Yingjun,6,15,40,34
1657414757251,CSE 12,A01,083652,Krause-Levy; Sophia Louisa,28,1,120,92
1657414763280,CSE 15L,A01,083654,Morris; Justin Loren,9,0,50,41
1657414763280,CSE 15L,A02,083655,Morris; Justin Loren,9,0,50,41
1657414769308,CSE 20,A01,083657,Tran; Khoa Dang,39,0,80,41
1657414775333,CSE 21,A01,095574,Bach; Quang Tran,22,0,48,26
1657414781365,CSE 30,A01,083084,Eldon; John,4,0,80,76
1657414781365,CSE 30,B01,095061,Bhaskar; Nishant,9,0,50,41
1657414787390,CSE 100,A01,083659,Cao; Yingjun,5,4,70,65
1657414793418,CSE 134B,A01,083661,Powell; Thomas Allan,22,0,100,78
1657414799443,CSE 140,A01,083663,Gungor; Onat,14,0,85,71
1657414805468,CSE 140L,A01,083088,Eldon; John,21,0,100,79
1657414811494,CSE 175,A01,083665,Kumar; Rakesh,3,0,25,22
1657414817519,CSE 190,A00,092507,Dubnov; Shlomo,7,0,20,13
1657414823546,ECE 45,A01,083139,Congero; Spencer William,6,0,75,69
1657414829570,ECE 65,A50,083695,Saad; Andrew S,12,0,30,18
1657414829570,ECE 65,A51,095125,Saad; Andrew S,24,0,26,2
1657414835600,ECE 109,A01,091882,Touri; Behrouz,19,0,70,51
1657414841622,ECE 180,A00,083140,Abi Samra; Nicholas Camill,1,0,30,29
1657414841622,ECE 180,B00,083141,Abi Samra; Nicholas Camill,0,0,30,30
1657414847646,MATH 10A,A01,083735,Patchell; Gregory David,2,0,30,28
1657414847646,MATH 10A,A02,083736,Patchell; Gregory David,20,0,30,10
1657414847646,MATH 10A,A03,083737,Patchell; Gregory David,16,0,30,14
1657414853668,MATH 10B,A01,083207,Lim; Seonhee,8,0,34,26
1657414853668,MATH 10B,A02,083208,Lim; Seonhee,9,0,35,26
1657414853668,MATH 10B,A03,093472,Lim; Seonhee,7,0,34,27
1657414853668,MATH 10B,B01,083739,Sinha; Shubham,12,0,30,18
1657414859698,MATH 18,A01,083743,Cinel; Cameron Alexander,7,0,30,23
1657414859698,MATH 18,A02,083744,Cinel; Cameron Alexander,17,0,30,13
1657414859698,MATH 18,A03,083745,Cinel; Cameron Alexander,9,0,30,21
1657414859698,MATH 18,B01,083748,Rideout; David Porter,5,0,37,32
1657414859698,MATH 18,B02,083749,Rideout; David Porter,5,0,36,31
1657414859698,MATH 18,B03,083750,Rideout; David Porter,3,0,37,34
1657414859698,MATH 18,B04,083751,Rideout; David Porter,6,0,36,30
1657414859698,MATH 18,B05,093473,Rideout; David Porter,6,0,36,30
1657414859698,MATH 18,B06,093474,Rideout; David Porter,6,0,36,30
1657414865723,MATH 20A,A01,083754,Zheng; Zequn,14,0,40,26
1657414871746,MATH 20B,A01,083756,Briones; Jor-el Thomas Caparas,4,0,36,32
1657414871746,MATH 20B,A02,083757,Briones; Jor-el Thomas Caparas,1,0,36,35
1657414871746,MATH 20B,A03,093475,Briones; Jor-el Thomas Caparas,2,0,36,34
1657414877774,MATH 20C,A01,083760,Briones; Jor-el Thomas Caparas,1,0,35,34
1657414877774,MATH 20C,A02,083761,Briones; Jor-el Thomas Caparas,8,0,35,27
1657414877774,MATH 20C,A03,093476,Briones; Jor-el Thomas Caparas,0,1,36,36
1657414877774,MATH 20C,B01,083762,Bach; Quang Tran,1,0,30,29
1657414883802,MATH 20D,A01,083765,Tran; Brian Kha,5,0,30,25
1657414883802,MATH 20D,A02,083766,Tran; Brian Kha,5,0,30,25
1657414883802,MATH 20D,A03,083767,Tran; Brian Kha,5,0,30,25
1657414889830,MATH 20E,A01,083771,Ganguly; Soumya,9,0,32,23
1657414889830,MATH 20E,A02,083772,Ganguly; Soumya,6,0,32,26
1657414889830,MATH 20E,B01,083773,Ciotti; Benjamin,20,0,35,15
1657414889830,MATH 20E,B02,083774,Ciotti; Benjamin,17,0,35,18
1657414895876,MATH 103A,A01,083777,Greenfeld; Be'Eri,3,0,36,33
1657414895876,MATH 103A,A02,083778,Greenfeld; Be'Eri,5,0,36,31
1657414895876,MATH 103A,A03,093561,Greenfeld; Be'Eri,5,0,36,31
1657414895876,MATH 103A,B01,083779,Greenfeld; Be'Eri,7,0,36,29
1657414895876,MATH 103A,B02,083780,Greenfeld; Be'Eri,4,0,36,32
1657414895876,MATH 103A,B03,093562,Greenfeld; Be'Eri,3,0,36,33
1657414901897,MATH 105,A01,085443,Carter; Anne Toulson,15,0,35,20
1657414901897,MATH 105,A02,093477,Carter; Anne Toulson,20,0,35,15
1657414907921,MATH 109,A01,083213,Ganzberger; Geoffrey Michael,2,0,34,32
1657414907921,MATH 109,A02,083214,Ganzberger; Geoffrey Michael,4,0,34,30
1657414907921,MATH 109,A03,093478,Ganzberger; Geoffrey Michael,2,0,34,32
1657414907921,MATH 109,B01,083215,Ganzberger; Geoffrey Michael,1,0,32,31
1657414907921,MATH 109,B02,083216,Ganzberger; Geoffrey Michael,2,0,32,30
1657414907921,MATH 109,B03,093479,Ganzberger; Geoffrey Michael,8,0,32,24
1657414913945,MATH 142A,A01,083219,Chow; Bennett,7,0,32,25
1657414913945,MATH 142A,A02,083220,Chow; Bennett,10,0,32,22
1657414913945,MATH 142A,A03,093480,Chow; Bennett,8,0,32,24
1657414913945,MATH 142A,B03,093481,Chow; Bennett,8,0,32,24
1657414913945,MATH 142A,B04,093558,Chow; Bennett,13,0,32,19
1657414913945,MATH 142A,B05,093559,Chow; Bennett,6,0,32,26
1657414919968,MATH 193A,A01,083224,Rotar; Vladimir,8,0,34,26
1657414919968,MATH 193A,A02,083225,Rotar; Vladimir,9,0,34,25
1657414919968,MATH 193A,A03,083781,Rotar; Vladimir,5,0,34,29
1657414919968,MATH 193A,A04,083782,Rotar; Vladimir,10,0,34,24
1657414919968,MATH 193A,A05,093482,Rotar; Vladimir,10,0,34,24
1657414926129,MATH 197,001,091859,McAuley; Julian John,9999,0,9999,0
1657414926129,MATH 197,002,095566,Kedlaya; Kiran S.,9997,0,9999,2
1657414926129,MATH 197,003,095567,Xiao; Ming,9999,0,9999,0
1657414926129,MATH 197,004,095571,Perols; Johan Lars,9998,0,9999,1
1657414933190,COGS 9,A01,083615,Shannon; Kyle Michael,9,0,75,66
1657414939214,COGS 11,A01,083617,Boyle; Mary E. T.,22,0,48,26
1657414945241,COGS 13,A01,083071,Bastos; Amalia Pinkusfeld,11,0,71,60
1657414951263,COGS 14A,A01,092681,Semenuks; Arturs,5,1,100,95
1657414957290,COGS 14B,A01,083073,Cheng; Tzu-Han,6,0,63,57
1657414963316,COGS 17,A01,092677,Semenuks; Arturs,6,0,81,75
1657414969340,COGS 100,A01,083619,Allen; Michael Gordon,17,0,70,53
1657414975366,COGS 101A,A01,083621,Davis; Joshua Daniel,9,0,68,59
1657414981391,COGS 101B,A01,091572,Allen; Michael Gordon,12,0,65,53
1657414987417,COGS 101C,A01,083625,Delgado; Tania,17,0,35,18
1657414993443,COGS 107A,A01,083627,Boyle; Mary E. T.,13,0,60,47
1657414999466,COGS 118A,A01,083075,Gupta; Anjum,20,0,76,56
1657415005494,CSE 3,A50,083646,Miranda; Gregory Joseph,24,0,50,26
1657415011516,CSE 8A,A50,083650,Miranda; Gregory Joseph,17,1,56,39
1657415017542,CSE 11,A01,083080,Cao; Yingjun,6,15,40,34
1657415023564,CSE 12,A01,083652,Krause-Levy; Sophia Louisa,28,1,120,92
1657415029586,CSE 15L,A01,083654,Morris; Justin Loren,9,0,50,41
1657415029586,CSE 15L,A02,083655,Morris; Justin Loren,9,0,50,41
1657415035610,CSE 20,A01,083657,Tran; Khoa Dang,39,0,80,41
1657415041637,CSE 21,A01,095574,Bach; Quang Tran,22,0,48,26
1657415047658,CSE 30,A01,083084,Eldon; John,4,0,80,76
1657415047658,CSE 30,B01,095061,Bhaskar; Nishant,9,0,50,41
1657415053682,CSE 100,A01,083659,Cao; Yingjun,5,4,70,65
1657415059706,CSE 134B,A01,083661,Powell; Thomas Allan,22,0,100,78
1657415065733,CSE 140,A01,083663,Gungor; Onat,14,0,85,71
1657415071754,CSE 140L,A01,083088,Eldon; John,21,0,100,79
1657415077777,CSE 175,A01,083665,Kumar; Rakesh,3,0,25,22
1657415083800,CSE 190,A00,092507,Dubnov; Shlomo,7,0,20,13
1657415089826,ECE 45,A01,083139,Congero; Spencer William,6,0,75,69
1657415095849,ECE 65,A50,083695,Saad; Andrew S,12,0,30,18
1657415095849,ECE 65,A51,095125,Saad; Andrew S,24,0,26,2
1657415101872,ECE 109,A01,091882,Touri; Behrouz,19,0,70,51
1657415107900,ECE 180,A00,083140,Abi Samra; Nicholas Camill,1,0,30,29
1657415107900,ECE 180,B00,083141,Abi Samra; Nicholas Camill,0,0,30,30
1657415113931,MATH 10A,A01,083735,Patchell; Gregory David,2,0,30,28
1657415113931,MATH 10A,A02,083736,Patchell; Gregory David,20,0,30,10
1657415113931,MATH 10A,A03,083737,Patchell; Gregory David,16,0,30,14
1657415119956,MATH 10B,A01,083207,Lim; Seonhee,8,0,34,26
1657415119956,MATH 10B,A02,083208,Lim; Seonhee,9,0,35,26
1657415119956,MATH 10B,A03,093472,Lim; Seonhee,7,0,34,27
1657415119956,MATH 10B,B01,083739,Sinha; Shubham,12,0,30,18
1657415125984,MATH 18,A01,083743,Cinel; Cameron Alexander,7,0,30,23
1657415125984,MATH 18,A02,083744,Cinel; Cameron Alexander,17,0,30,13
1657415125984,MATH 18,A03,083745,Cinel; Cameron Alexander,9,0,30,21
1657415125984,MATH 18,B01,083748,Rideout; David Porter,5,0,37,32
1657415125984,MATH 18,B02,083749,Rideout; David Porter,5,0,36,31
1657415125984,MATH 18,B03,083750,Rideout; David Porter,3,0,37,34
1657415125984,MATH 18,B04,083751,Rideout; David Porter,6,0,36,30
1657415125984,MATH 18,B05,093473,Rideout; David Porter,6,0,36,30
1657415125984,MATH 18,B06,093474,Rideout; David Porter,6,0,36,30
1657415132007,MATH 20A,A01,083754,Zheng; Zequn,14,0,40,26
1657415138032,MATH 20B,A01,083756,Briones; Jor-el Thomas Caparas,4,0,36,32
1657415138032,MATH 20B,A02,083757,Briones; Jor-el Thomas Caparas,1,0,36,35
1657415138032,MATH 20B,A03,093475,Briones; Jor-el Thomas Caparas,2,0,36,34
1657415144056,MATH 20C,A01,083760,Briones; Jor-el Thomas Caparas,1,0,35,34
1657415144056,MATH 20C,A02,083761,Briones; Jor-el Thomas Caparas,8,0,35,27
1657415144056,MATH 20C,A03,093476,Briones; Jor-el Thomas Caparas,0,1,36,36
1657415144056,MATH 20C,B01,083762,Bach; Quang Tran,1,0,30,29
1657415150080,MATH 20D,A01,083765,Tran; Brian Kha,5,0,30,25
1657415150080,MATH 20D,A02,083766,Tran; Brian Kha,5,0,30,25
1657415150080,MATH 20D,A03,083767,Tran; Brian Kha,5,0,30,25
1657415156105,MATH 20E,A01,083771,Ganguly; Soumya,9,0,32,23
1657415156105,MATH 20E,A02,083772,Ganguly; Soumya,6,0,32,26
1657415156105,MATH 20E,B01,083773,Ciotti; Benjamin,20,0,35,15
1657415156105,MATH 20E,B02,083774,Ciotti; Benjamin,17,0,35,18
1657415162149,MATH 103A,A01,083777,Greenfeld; Be'Eri,3,0,36,33
1657415162149,MATH 103A,A02,083778,Greenfeld; Be'Eri,5,0,36,31
1657415162149,MATH 103A,A03,093561,Greenfeld; Be'Eri,5,0,36,31
1657415162149,MATH 103A,B01,083779,Greenfeld; Be'Eri,7,0,36,29
1657415162149,MATH 103A,B02,083780,Greenfeld; Be'Eri,4,0,36,32
1657415162149,MATH 103A,B03,093562,Greenfeld; Be'Eri,3,0,36,33
1657415168173,MATH 105,A01,085443,Carter; Anne Toulson,15,0,35,20
1657415168173,MATH 105,A02,093477,Carter; Anne Toulson,20,0,35,15
1657415174196,MATH 109,A01,083213,Ganzberger; Geoffrey Michael,2,0,34,32
1657415174196,MATH 109,A02,083214,Ganzberger; Geoffrey Michael,4,0,34,30
1657415174196,MATH 109,A03,093478,Ganzberger; Geoffrey Michael,2,0,34,32
1657415174196,MATH 109,B01,083215,Ganzberger; Geoffrey Michael,1,0,32,31
1657415174196,MATH 109,B02,083216,Ganzberger; Geoffrey Michael,2,0,32,30
1657415174196,MATH 109,B03,093479,Ganzberger; Geoffrey Michael,8,0,32,24
1657415180219,MATH 142A,A01,083219,Chow; Bennett,7,0,32,25
1657415180219,MATH 142A,A02,083220,Chow; Bennett,10,0,32,22
1657415180219,MATH 142A,A03,093480,Chow; Bennett,8,0,32,24
1657415180219,MATH 142A,B03,093481,Chow; Bennett,8,0,32,24
1657415180219,MATH 142A,B04,093558,Chow; Bennett,13,0,32,19
1657415180219,MATH 142A,B05,093559,Chow; Bennett,6,0,32,26
1657415186242,MATH 193A,A01,083224,Rotar; Vladimir,8,0,34,26
1657415186242,MATH 193A,A02,083225,Rotar; Vladimir,9,0,34,25
1657415186242,MATH 193A,A03,083781,Rotar; Vladimir,5,0,34,29
1657415186242,MATH 193A,A04,083782,Rotar; Vladimir,10,0,34,24
1657415186242,MATH 193A,A05,093482,Rotar; Vladimir,10,0,34,24
1657415192267,MATH 197,001,091859,McAuley; Julian John,9999,0,9999,0
1657415192267,MATH 197,002,095566,Kedlaya; Kiran S.,9997,0,9999,2
1657415192267,MATH 197,003,095567,Xiao; Ming,9999,0,9999,0
1657415192267,MATH 197,004,095571,Perols; Johan Lars,9998,0,9999,1
1657415199331,COGS 9,A01,083615,Shannon; Kyle Michael,9,0,75,66
1657415205356,COGS 11,A01,083617,Boyle; Mary E. T.,22,0,48,26
1657415211380,COGS 13,A01,083071,Bastos; Amalia Pinkusfeld,11,0,71,60
1657415217402,COGS 14A,A01,092681,Semenuks; Arturs,5,1,100,95
1657415223426,COGS 14B,A01,083073,Cheng; Tzu-Han,6,0,63,57
1657415229448,COGS 17,A01,092677,Semenuks; Arturs,6,0,81,75
1657415235475,COGS 100,A01,083619,Allen; Michael Gordon,17,0,70,53
1657415241509,COGS 101A,A01,083621,Davis; Joshua Daniel,9,0,68,59
1657415247534,COGS 101B,A01,091572,Allen; Michael Gordon,12,0,65,53
1657415253555,COGS 101C,A01,083625,Delgado; Tania,17,0,35,18
1657415259582,COGS 107A,A01,083627,Boyle; Mary E. T.,13,0,60,47
1657415265604,COGS 118A,A01,083075,Gupta; Anjum,20,0,76,56
1657415271626,CSE 3,A50,083646,Miranda; Gregory Joseph,24,0,50,26
1657415277653,CSE 8A,A50,083650,Miranda; Gregory Joseph,17,1,56,39
1657415283676,CSE 11,A01,083080,Cao; Yingjun,6,15,40,34
1657415289704,CSE 12,A01,083652,Krause-Levy; Sophia Louisa,28,1,120,92
1657415295728,CSE 15L,A01,083654,Morris; Justin Loren,9,0,50,41
1657415295728,CSE 15L,A02,083655,Morris; Justin Loren,9,0,50,41
1657415301750,CSE 20,A01,083657,Tran; Khoa Dang,39,0,80,41
1657415307777,CSE 21,A01,095574,Bach; Quang Tran,22,0,48,26
1657415313803,CSE 30,A01,083084,Eldon; John,4,0,80,76
1657415313803,CSE 30,B01,095061,Bhaskar; Nishant,9,0,50,41
1657415319833,CSE 100,A01,083659,Cao; Yingjun,5,4,70,65
1657415325858,CSE 134B,A01,083661,Powell; Thomas Allan,22,0,100,78
1657415331882,CSE 140,A01,083663,Gungor; Onat,14,0,85,71
1657415337905,CSE 140L,A01,083088,Eldon; John,21,0,100,79
1657415343932,CSE 175,A01,083665,Kumar; Rakesh,3,0,25,22
1657415349955,CSE 190,A00,092507,Dubnov; Shlomo,7,0,20,13
1657415355978,ECE 45,A01,083139,Congero; Spencer William,6,0,75,69
1657415362003,ECE 65,A50,083695,Saad; Andrew S,12,0,30,18
1657415362003,ECE 65,A51,095125,Saad; Andrew S,24,0,26,2
1657415368026,ECE 109,A01,091882,Touri; Behrouz,19,0,70,51
1657415374050,ECE 180,A00,083140,Abi Samra; Nicholas Camill,1,0,30,29
1657415374050,ECE 180,B00,083141,Abi Samra; Nicholas Camill,0,0,30,30
1657415380074,MATH 10A,A01,083735,Patchell; Gregory David,2,0,30,28
1657415380074,MATH 10A,A02,083736,Patchell; Gregory David,20,0,30,10
1657415380074,MATH 10A,A03,083737,Patchell; Gregory David,16,0,30,14
1657415386099,MATH 10B,A01,083207,Lim; Seonhee,8,0,34,26
1657415386099,MATH 10B,A02,083208,Lim; Seonhee,9,0,35,26
1657415386099,MATH 10B,A03,093472,Lim; Seonhee,7,0,34,27
1657415386099,MATH 10B,B01,083739,Sinha; Shubham,12,0,30,18
1657415392129,MATH 18,A01,083743,Cinel; Cameron Alexander,7,0,30,23
1657415392129,MATH 18,A02,083744,Cinel; Cameron Alexander,17,0,30,13
1657415392129,MATH 18,A03,083745,Cinel; Cameron Alexander,9,0,30,21
1657415392129,MATH 18,B01,083748,Rideout; David Porter,5,0,37,32
1657415392129,MATH 18,B02,083749,Rideout; David Porter,5,0,36,31
1657415392129,MATH 18,B03,083750,Rideout; David Porter,3,0,37,34
1657415392129,MATH 18,B04,083751,Rideout; David Porter,6,0,36,30
1657415392129,MATH 18,B05,093473,Rideout; David Porter,6,0,36,30
1657415392129,MATH 18,B06,093474,Rideout; David Porter,6,0,36,30
1657415398154,MATH 20A,A01,083754,Zheng; Zequn,14,0,40,26
1657415404181,MATH 20B,A01,083756,Briones; Jor-el Thomas Caparas,4,0,36,32
1657415404181,MATH 20B,A02,083757,Briones; Jor-el Thomas Caparas,1,0,36,35
1657415404181,MATH 20B,A03,093475,Briones; Jor-el Thomas Caparas,2,0,36,34
1657415410210,MATH 20C,A01,083760,Briones; Jor-el Thomas Caparas,1,0,35,34
1657415410210,MATH 20C,A02,083761,Briones; Jor-el Thomas Caparas,8,0,35,27
1657415410210,MATH 20C,A03,093476,Briones; Jor-el Thomas Caparas,0,1,36,36
1657415410210,MATH 20C,B01,083762,Bach; Quang Tran,1,0,30,29
1657415416238,MATH 20D,A01,083765,Tran; Brian Kha,5,0,30,25
1657415416238,MATH 20D,A02,083766,Tran; Brian Kha,5,0,30,25
1657415416238,MATH 20D,A03,083767,Tran; Brian Kha,5,0,30,25
1657415422267,MATH 20E,A01,083771,Ganguly; Soumya,9,0,32,23
1657415422267,MATH 20E,A02,083772,Ganguly; Soumya,6,0,32,26
1657415422267,MATH 20E,B01,083773,Ciotti; Benjamin,20,0,35,15
1657415422267,MATH 20E,B02,083774,Ciotti; Benjamin,17,0,35,18
1657415428291,MATH 103A,A01,083777,Greenfeld; Be'Eri,3,0,36,33
1657415428291,MATH 103A,A02,083778,Greenfeld; Be'Eri,5,0,36,31
1657415428291,MATH 103A,A03,093561,Greenfeld; Be'Eri,5,0,36,31
1657415428291,MATH 103A,B01,083779,Greenfeld; Be'Eri,7,0,36,29
1657415428291,MATH 103A,B02,083780,Greenfeld; Be'Eri,4,0,36,32
1657415428291,MATH 103A,B03,093562,Greenfeld; Be'Eri,3,0,36,33
1657415434318,MATH 105,A01,085443,Carter; Anne Toulson,15,0,35,20
1657415434318,MATH 105,A02,093477,Carter; Anne Toulson,20,0,35,15
1657415440345,MATH 109,A01,083213,Ganzberger; Geoffrey Michael,2,0,34,32
1657415440345,MATH 109,A02,083214,Ganzberger; Geoffrey Michael,4,0,34,30
1657415440345,MATH 109,A03,093478,Ganzberger; Geoffrey Michael,2,0,34,32
1657415440345,MATH 109,B01,083215,Ganzberger; Geoffrey Michael,1,0,32,31
1657415440345,MATH 109,B02,083216,Ganzberger; Geoffrey Michael,2,0,32,30
1657415440345,MATH 109,B03,093479,Ganzberger; Geoffrey Michael,8,0,32,24
1657415446371,MATH 142A,A01,083219,Chow; Bennett,7,0,32,25
1657415446371,MATH 142A,A02,083220,Chow; Bennett,10,0,32,22
1657415446371,MATH 142A,A03,093480,Chow; Bennett,8,0,32,24
1657415446371,MATH 142A,B03,093481,Chow; Bennett,8,0,32,24
1657415446371,MATH 142A,B04,093558,Chow; Bennett,13,0,32,19
1657415446371,MATH 142A,B05,093559,Chow; Bennett,6,0,32,26
1657415452394,MATH 193A,A01,083224,Rotar; Vladimir,8,0,34,26
1657415452394,MATH 193A,A02,083225,Rotar; Vladimir,9,0,34,25
1657415452394,MATH 193A,A03,083781,Rotar; Vladimir,5,0,34,29
1657415452394,MATH 193A,A04,083782,Rotar; Vladimir,10,0,34,24
1657415452394,MATH 193A,A05,093482,Rotar; Vladimir,10,0,34,24
1657415458418,MATH 197,001,091859,McAuley; Julian John,9999,0,9999,0
1657415458418,MATH 197,002,095566,Kedlaya; Kiran S.,9997,0,9999,2
1657415458418,MATH 197,003,095567,Xiao; Ming,9999,0,9999,0
1657415458418,MATH 197,004,095571,Perols; Johan Lars,9998,0,9999,1
1657415465479,COGS 9,A01,083615,Shannon; Kyle Michael,9,0,75,66
1657415471506,COGS 11,A01,083617,Boyle; Mary E. T.,22,0,48,26
1657415477532,COGS 13,A01,083071,Bastos; Amalia Pinkusfeld,11,0,71,60
1657415483555,COGS 14A,A01,092681,Semenuks; Arturs,5,1,100,95
1657415489581,COGS 14B,A01,083073,Cheng; Tzu-Han,6,0,63,57
1657415495603,COGS 17,A01,092677,Semenuks; Arturs,6,0,81,75
1657415501634,COGS 100,A01,083619,Allen; Michael Gordon,17,0,70,53
1657415507659,COGS 101A,A01,083621,Davis; Joshua Daniel,9,0,68,59
1657415513682,COGS 101B,A01,091572,Allen; Michael Gordon,12,0,65,53
1657415519791,COGS 101C,A01,083625,Delgado; Tania,17,0,35,18
1657415525817,COGS 107A,A01,083627,Boyle; Mary E. T.,13,0,60,47
1657415531840,COGS 118A,A01,083075,Gupta; Anjum,20,0,76,56
1657415537868,CSE 3,A50,083646,Miranda; Gregory Joseph,24,0,50,26
1657415543897,CSE 8A,A50,083650,Miranda; Gregory Joseph,17,1,56,39
1657415549924,CSE 11,A01,083080,Cao; Yingjun,6,15,40,34
1657415555948,CSE 12,A01,083652,Krause-Levy; Sophia Louisa,28,1,120,92
1657415561976,CSE 15L,A01,083654,Morris; Justin Loren,9,0,50,41
1657415561976,CSE 15L,A02,083655,Morris; Justin Loren,9,0,50,41
1657415568000,CSE 20,A01,083657,Tran; Khoa Dang,39,0,80,41
1657415574029,CSE 21,A01,095574,Bach; Quang Tran,22,0,48,26
1657415580056,CSE 30,A01,083084,Eldon; John,4,0,80,76
1657415580056,CSE 30,B01,095061,Bhaskar; Nishant,9,0,50,41
1657415586081,CSE 100,A01,083659,Cao; Yingjun,5,4,70,65
1657415592104,CSE 134B,A01,083661,Powell; Thomas Allan,22,0,100,78
1657415598127,CSE 140,A01,083663,Gungor; Onat,14,0,85,71
1657415604154,CSE 140L,A01,083088,Eldon; John,21,0,100,79
1657415610176,CSE 175,A01,083665,Kumar; Rakesh,3,0,25,22
1657415616198,CSE 190,A00,092507,Dubnov; Shlomo,7,0,20,13
1657415622225,ECE 45,A01,083139,Congero; Spencer William,6,0,75,69
1657415628248,ECE 65,A50,083695,Saad; Andrew S,12,0,30,18
1657415628248,ECE 65,A51,095125,Saad; Andrew S,24,0,26,2
1657415634271,ECE 109,A01,091882,Touri; Behrouz,19,0,70,51
1657415640306,ECE 180,A00,083140,Abi Samra; Nicholas Camill,1,0,30,29
1657415640306,ECE 180,B00,083141,Abi Samra; Nicholas Camill,0,0,30,30
1657415646334,MATH 10A,A01,083735,Patchell; Gregory David,2,0,30,28
1657415646334,MATH 10A,A02,083736,Patchell; Gregory David,20,0,30,10
1657415646334,MATH 10A,A03,083737,Patchell; Gregory David,16,0,30,14
1657415652358,MATH 10B,A01,083207,Lim; Seonhee,8,0,34,26
1657415652358,MATH 10B,A02,083208,Lim; Seonhee,9,0,35,26
1657415652358,MATH 10B,A03,093472,Lim; Seonhee,7,0,34,27
1657415652358,MATH 10B,B01,083739,Sinha; Shubham,12,0,30,18
1657415658383,MATH 18,A01,083743,Cinel; Cameron Alexander,7,0,30,23
1657415658383,MATH 18,A02,083744,Cinel; Cameron Alexander,17,0,30,13
1657415658383,MATH 18,A03,083745,Cinel; Cameron Alexander,9,0,30,21
1657415658383,MATH 18,B01,083748,Rideout; David Porter,5,0,37,32
1657415658383,MATH 18,B02,083749,Rideout; David Porter,5,0,36,31
1657415658383,MATH 18,B03,083750,Rideout; David Porter,3,0,37,34
1657415658383,MATH 18,B04,083751,Rideout; David Porter,6,0,36,30
1657415658383,MATH 18,B05,093473,Rideout; David Porter,6,0,36,30
1657415658383,MATH 18,B06,093474,Rideout; David Porter,6,0,36,30
1657415664409,MATH 20A,A01,083754,Zheng; Zequn,14,0,40,26
1657415670437,MATH 20B,A01,083756,Briones; Jor-el Thomas Caparas,4,0,36,32
1657415670437,MATH 20B,A02,083757,Briones; Jor-el Thomas Caparas,1,0,36,35
1657415670437,MATH 20B,A03,093475,Briones; Jor-el Thomas Caparas,2,0,36,34
1657415676461,MATH 20C,A01,083760,Briones; Jor-el Thomas Caparas,1,0,35,34
1657415676461,MATH 20C,A02,083761,Briones; Jor-el Thomas Caparas,8,0,35,27
1657415676461,MATH 20C,A03,093476,Briones; Jor-el Thomas Caparas,0,1,36,36
1657415676461,MATH 20C,B01,083762,Bach; Quang Tran,1,0,30,29
1657415682486,MATH 20D,A01,083765,Tran; Brian Kha,5,0,30,25
1657415682486,MATH 20D,A02,083766,Tran; Brian Kha,5,0,30,25
1657415682486,MATH 20D,A03,083767,Tran; Brian Kha,5,0,30,25
1657415688514,MATH 20E,A01,083771,Ganguly; Soumya,9,0,32,23
1657415688514,MATH 20E,A02,083772,Ganguly; Soumya,6,0,32,26
1657415688514,MATH 20E,B01,083773,Ciotti; Benjamin,20,0,35,15
1657415688514,MATH 20E,B02,083774,Ciotti; Benjamin,17,0,35,18
1657415694541,MATH 103A,A01,083777,Greenfeld; Be'Eri,3,0,36,33
1657415694541,MATH 103A,A02,083778,Greenfeld; Be'Eri,5,0,36,31
1657415694541,MATH 103A,A03,093561,Greenfeld; Be'Eri,5,0,36,31
1657415694541,MATH 103A,B01,083779,Greenfeld; Be'Eri,7,0,36,29
1657415694541,MATH 103A,B02,083780,Greenfeld; Be'Eri,4,0,36,32
1657415694541,MATH 103A,B03,093562,Greenfeld; Be'Eri,3,0,36,33
1657415700567,MATH 105,A01,085443,Carter; Anne Toulson,15,0,35,20
1657415700567,MATH 105,A02,093477,Carter; Anne Toulson,20,0,35,15
1657415706590,MATH 109,A01,083213,Ganzberger; Geoffrey Michael,2,0,34,32
1657415706590,MATH 109,A02,083214,Ganzberger; Geoffrey Michael,4,0,34,30
1657415706590,MATH 109,A03,093478,Ganzberger; Geoffrey Michael,2,0,34,32
1657415706590,MATH 109,B01,083215,Ganzberger; Geoffrey Michael,1,0,32,31
1657415706590,MATH 109,B02,083216,Ganzberger; Geoffrey Michael,2,0,32,30
1657415706590,MATH 109,B03,093479,Ganzberger; Geoffrey Michael,8,0,32,24
1657415712615,MATH 142A,A01,083219,Chow; Bennett,7,0,32,25
1657415712615,MATH 142A,A02,083220,Chow; Bennett,10,0,32,22
1657415712615,MATH 142A,A03,093480,Chow; Bennett,8,0,32,24
1657415712615,MATH 142A,B03,093481,Chow; Bennett,8,0,32,24
1657415712615,MATH 142A,B04,093558,Chow; Bennett,13,0,32,19
1657415712615,MATH 142A,B05,093559,Chow; Bennett,6,0,32,26
1657415718640,MATH 193A,A01,083224,Rotar; Vladimir,8,0,34,26
1657415718640,MATH 193A,A02,083225,Rotar; Vladimir,9,0,34,25
1657415718640,MATH 193A,A03,083781,Rotar; Vladimir,5,0,34,29
1657415718640,MATH 193A,A04,083782,Rotar; Vladimir,10,0,34,24
1657415718640,MATH 193A,A05,093482,Rotar; Vladimir,10,0,34,24
1657415724667,MATH 197,001,091859,McAuley; Julian John,9999,0,9999,0
1657415724667,MATH 197,002,095566,Kedlaya; Kiran S.,9997,0,9999,2
1657415724667,MATH 197,003,095567,Xiao; Ming,9999,0,9999,0
1657415724667,MATH 197,004,095571,Perols; Johan Lars,9998,0,9999,1
1657415731719,COGS 9,A01,083615,Shannon; Kyle Michael,9,0,75,66
1657415737740,COGS 11,A01,083617,Boyle; Mary E. T.,22,0,48,26
1657415743763,COGS 13,A01,083071,Bastos; Amalia Pinkusfeld,11,0,71,60
1657415749789,COGS 14A,A01,092681,Semenuks; Arturs,5,1,100,95
1657415755811,COGS 14B,A01,083073,Cheng; Tzu-Han,6,0,63,57
1657415761832,COGS 17,A01,092677,Semenuks; Arturs,6,0,81,75
1657415767858,COGS 100,A01,083619,Allen; Michael Gordon,17,0,70,53
1657415773882,COGS 101A,A01,083621,Davis; Joshua Daniel,9,0,68,59
1657415779908,COGS 101B,A01,091572,Allen; Michael Gordon,12,0,65,53
1657415785932,COGS 101C,A01,083625,Delgado; Tania,17,0,35,18
1657415791955,COGS 107A,A01,083627,Boyle; Mary E. T.,13,0,60,47
1657415797977,COGS 118A,A01,083075,Gupta; Anjum,21,0,76,55
1657415804004,CSE 3,A50,083646,Miranda; Gregory Joseph,24,0,50,26
1657415810031,CSE 8A,A50,083650,Miranda; Gregory Joseph,17,1,56,39
1657415816058,CSE 11,A01,083080,Cao; Yingjun,6,15,40,34
1657415822087,CSE 12,A01,083652,Krause-Levy; Sophia Louisa,28,1,120,92
1657415828110,CSE 15L,A01,083654,Morris; Justin Loren,9,0,50,41
1657415828110,CSE 15L,A02,083655,Morris; Justin Loren,9,0,50,41
1657415834134,CSE 20,A01,083657,Tran; Khoa Dang,39,0,80,41
1657415840157,CSE 21,A01,095574,Bach; Quang Tran,22,0,48,26
1657415846189,CSE 30,A01,083084,Eldon; John,4,0,80,76
1657415846189,CSE 30,B01,095061,Bhaskar; Nishant,9,0,50,41
1657415852213,CSE 100,A01,083659,Cao; Yingjun,5,4,70,65
1657415858241,CSE 134B,A01,083661,Powell; Thomas Allan,22,0,100,78
1657415864264,CSE 140,A01,083663,Gungor; Onat,14,0,85,71
1657415870292,CSE 140L,A01,083088,Eldon; John,21,0,100,79
1657415876314,CSE 175,A01,083665,Kumar; Rakesh,3,0,25,22
1657415882338,CSE 190,A00,092507,Dubnov; Shlomo,7,0,20,13
1657415888364,ECE 45,A01,083139,Congero; Spencer William,6,0,75,69
1657415894392,ECE 65,A50,083695,Saad; Andrew S,12,0,30,18
1657415894392,ECE 65,A51,095125,Saad; Andrew S,24,0,26,2
1657415900416,ECE 109,A01,091882,Touri; Behrouz,19,0,70,51
1657415906442,ECE 180,A00,083140,Abi Samra; Nicholas Camill,1,0,30,29
1657415906442,ECE 180,B00,083141,Abi Samra; Nicholas Camill,0,0,30,30
1657415912474,MATH 10A,A01,083735,Patchell; Gregory David,2,0,30,28
1657415912474,MATH 10A,A02,083736,Patchell; Gregory David,20,0,30,10
1657415912474,MATH 10A,A03,083737,Patchell; Gregory David,16,0,30,14
1657415918501,MATH 10B,A01,083207,Lim; Seonhee,8,0,34,26
1657415918501,MATH 10B,A02,083208,Lim; Seonhee,9,0,35,26
1657415918501,MATH 10B,A03,093472,Lim; Seonhee,7,0,34,27
1657415918501,MATH 10B,B01,083739,Sinha; Shubham,12,0,30,18
1657415924530,MATH 18,A01,083743,Cinel; Cameron Alexander,7,0,30,23
1657415924530,MATH 18,A02,083744,Cinel; Cameron Alexander,17,0,30,13
1657415924530,MATH 18,A03,083745,Cinel; Cameron Alexander,9,0,30,21
1657415924530,MATH 18,B01,083748,Rideout; David Porter,5,0,37,32
1657415924530,MATH 18,B02,083749,Rideout; David Porter,5,0,36,31
1657415924530,MATH 18,B03,083750,Rideout; David Porter,3,0,37,34
1657415924530,MATH 18,B04,083751,Rideout; David Porter,6,0,36,30
1657415924530,MATH 18,B05,093473,Rideout; David Porter,6,0,36,30
1657415924530,MATH 18,B06,093474,Rideout; David Porter,6,0,36,30
1657415930560,MATH 20A,A01,083754,Zheng; Zequn,14,0,40,26
1657415936583,MATH 20B,A01,083756,Briones; Jor-el Thomas Caparas,4,0,36,32
1657415936583,MATH 20B,A02,083757,Briones; Jor-el Thomas Caparas,1,0,36,35
1657415936583,MATH 20B,A03,093475,Briones; Jor-el Thomas Caparas,2,0,36,34
1657415942613,MATH 20C,A01,083760,Briones; Jor-el Thomas Caparas,1,0,35,34
1657415942613,MATH 20C,A02,083761,Briones; Jor-el Thomas Caparas,8,0,35,27
1657415942613,MATH 20C,A03,093476,Briones; Jor-el Thomas Caparas,0,1,36,36
1657415942613,MATH 20C,B01,083762,Bach; Quang Tran,1,0,30,29
1657415948637,MATH 20D,A01,083765,Tran; Brian Kha,5,0,30,25
1657415948637,MATH 20D,A02,083766,Tran; Brian Kha,5,0,30,25
1657415948637,MATH 20D,A03,083767,Tran; Brian Kha,5,0,30,25
1657415954661,MATH 20E,A01,083771,Ganguly; Soumya,9,0,32,23
1657415954661,MATH 20E,A02,083772,Ganguly; Soumya,6,0,32,26
1657415954661,MATH 20E,B01,083773,Ciotti; Benjamin,20,0,35,15
1657415954661,MATH 20E,B02,083774,Ciotti; Benjamin,17,0,35,18
1657415960692,MATH 103A,A01,083777,Greenfeld; Be'Eri,3,0,36,33
1657415960692,MATH 103A,A02,083778,Greenfeld; Be'Eri,5,0,36,31
1657415960692,MATH 103A,A03,093561,Greenfeld; Be'Eri,5,0,36,31
1657415960692,MATH 103A,B01,083779,Greenfeld; Be'Eri,7,0,36,29
1657415960692,MATH 103A,B02,083780,Greenfeld; Be'Eri,4,0,36,32
1657415960692,MATH 103A,B03,093562,Greenfeld; Be'Eri,3,0,36,33
1657415966717,MATH 105,A01,085443,Carter; Anne Toulson,15,0,35,20
1657415966717,MATH 105,A02,093477,Carter; Anne Toulson,20,0,35,15
1657415972746,MATH 109,A01,083213,Ganzberger; Geoffrey Michael,2,0,34,32
1657415972746,MATH 109,A02,083214,Ganzberger; Geoffrey Michael,4,0,34,30
1657415972746,MATH 109,A03,093478,Ganzberger; Geoffrey Michael,2,0,34,32
1657415972746,MATH 109,B01,083215,Ganzberger; Geoffrey Michael,1,0,32,31
1657415972746,MATH 109,B02,083216,Ganzberger; Geoffrey Michael,2,0,32,30
1657415972746,MATH 109,B03,093479,Ganzberger; Geoffrey Michael,8,0,32,24
1657415978771,MATH 142A,A01,083219,Chow; Bennett,7,0,32,25
1657415978771,MATH 142A,A02,083220,Chow; Bennett,10,0,32,22
1657415978771,MATH 142A,A03,093480,Chow; Bennett,8,0,32,24
1657415978771,MATH 142A,B03,093481,Chow; Bennett,8,0,32,24
1657415978771,MATH 142A,B04,093558,Chow; Bennett,13,0,32,19
1657415978771,MATH 142A,B05,093559,Chow; Bennett,6,0,32,26
1657415984795,MATH 193A,A01,083224,Rotar; Vladimir,8,0,34,26
1657415984795,MATH 193A,A02,083225,Rotar; Vladimir,9,0,34,25
1657415984795,MATH 193A,A03,083781,Rotar; Vladimir,5,0,34,29
1657415984795,MATH 193A,A04,083782,Rotar; Vladimir,10,0,34,24
1657415984795,MATH 193A,A05,093482,Rotar; Vladimir,10,0,34,24
1657415990818,MATH 197,001,091859,McAuley; Julian John,9999,0,9999,0
1657415990818,MATH 197,002,095566,Kedlaya; Kiran S.,9997,0,9999,2
1657415990818,MATH 197,003,095567,Xiao; Ming,9999,0,9999,0
1657415990818,MATH 197,004,095571,Perols; Johan Lars,9998,0,9999,1
1657415997874,COGS 9,A01,083615,Shannon; Kyle Michael,9,0,75,66
1657416003897,COGS 11,A01,083617,Boyle; Mary E. T.,22,0,48,26
1657416009920,COGS 13,A01,083071,Bastos; Amalia Pinkusfeld,11,0,71,60
1657416015955,COGS 14A,A01,092681,Semenuks; Arturs,5,1,100,95
1657416021979,COGS 14B,A01,083073,Cheng; Tzu-Han,6,0,63,57
1657416028001,COGS 17,A01,092677,Semenuks; Arturs,6,0,81,75
1657416034025,COGS 100,A01,083619,Allen; Michael Gordon,17,0,70,53
1657416040050,COGS 101A,A01,083621,Davis; Joshua Daniel,9,0,68,59
1657416046073,COGS 101B,A01,091572,Allen; Michael Gordon,12,0,65,53
1657416052097,COGS 101C,A01,083625,Delgado; Tania,17,0,35,18
1657416058128,COGS 107A,A01,083627,Boyle; Mary E. T.,13,0,60,47
1657416064162,COGS 118A,A01,083075,Gupta; Anjum,21,0,76,55
1657416070185,CSE 3,A50,083646,Miranda; Gregory Joseph,24,0,50,26
1657416076208,CSE 8A,A50,083650,Miranda; Gregory Joseph,17,1,56,39
1657416082235,CSE 11,A01,083080,Cao; Yingjun,6,15,40,34
1657416088262,CSE 12,A01,083652,Krause-Levy; Sophia Louisa,28,1,120,92
1657416094289,CSE 15L,A01,083654,Morris; Justin Loren,9,0,50,41
1657416094289,CSE 15L,A02,083655,Morris; Justin Loren,9,0,50,41
1657416100313,CSE 20,A01,083657,Tran; Khoa Dang,39,0,80,41
1657416106340,CSE 21,A01,095574,Bach; Quang Tran,22,0,48,26
1657416112382,CSE 30,A01,083084,Eldon; John,4,0,80,76
1657416112382,CSE 30,B01,095061,Bhaskar; Nishant,9,0,50,41
1657416118499,CSE 100,A01,083659,Cao; Yingjun,5,4,70,65
1657416124527,CSE 134B,A01,083661,Powell; Thomas Allan,22,0,100,78
1657416130553,CSE 140,A01,083663,Gungor; Onat,14,0,85,71
1657416136583,CSE 140L,A01,083088,Eldon; John,21,0,100,79
1657416142607,CSE 175,A01,083665,Kumar; Rakesh,3,0,25,22
1657416148630,CSE 190,A00,092507,Dubnov; Shlomo,7,0,20,13
1657416154651,ECE 45,A01,083139,Congero; Spencer William,6,0,75,69
1657416160677,ECE 65,A50,083695,Saad; Andrew S,12,0,30,18
1657416160677,ECE 65,A51,095125,Saad; Andrew S,24,0,26,2
1657416166698,ECE 109,A01,091882,Touri; Behrouz,19,0,70,51
1657416172719,ECE 180,A00,083140,Abi Samra; Nicholas Camill,1,0,30,29
1657416172719,ECE 180,B00,083141,Abi Samra; Nicholas Camill,0,0,30,30
1657416178742,MATH 10A,A01,083735,Patchell; Gregory David,2,0,30,28
1657416178742,MATH 10A,A02,083736,Patchell; Gregory David,20,0,30,10
1657416178742,MATH 10A,A03,083737,Patchell; Gregory David,16,0,30,14
1657416184765,MATH 10B,A01,083207,Lim; Seonhee,8,0,34,26
1657416184765,MATH 10B,A02,083208,Lim; Seonhee,9,0,35,26
1657416184765,MATH 10B,A03,093472,Lim; Seonhee,7,0,34,27
1657416184765,MATH 10B,B01,083739,Sinha; Shubham,12,0,30,18
1657416190787,MATH 18,A01,083743,Cinel; Cameron Alexander,7,0,30,23
1657416190787,MATH 18,A02,083744,Cinel; Cameron Alexander,17,0,30,13
1657416190787,MATH 18,A03,083745,Cinel; Cameron Alexander,9,0,30,21
1657416190787,MATH 18,B01,083748,Rideout; David Porter,5,0,37,32
1657416190787,MATH 18,B02,083749,Rideout; David Porter,5,0,36,31
1657416190787,MATH 18,B03,083750,Rideout; David Porter,3,0,37,34
1657416190787,MATH 18,B04,083751,Rideout; David Porter,6,0,36,30
1657416190787,MATH 18,B05,093473,Rideout; David Porter,6,0,36,30
1657416190787,MATH 18,B06,093474,Rideout; David Porter,6,0,36,30
1657416196814,MATH 20A,A01,083754,Zheng; Zequn,14,0,40,26
1657416202840,MATH 20B,A01,083756,Briones; Jor-el Thomas Caparas,4,0,36,32
1657416202840,MATH 20B,A02,083757,Briones; Jor-el Thomas Caparas,1,0,36,35
1657416202840,MATH 20B,A03,093475,Briones; Jor-el Thomas Caparas,2,0,36,34
1657416208868,MATH 20C,A01,083760,Briones; Jor-el Thomas Caparas,1,0,35,34
1657416208868,MATH 20C,A02,083761,Briones; Jor-el Thomas Caparas,8,0,35,27
1657416208868,MATH 20C,A03,093476,Briones; Jor-el Thomas Caparas,0,1,36,36
1657416208868,MATH 20C,B01,083762,Bach; Quang Tran,1,0,30,29
1657416214899,MATH 20D,A01,083765,Tran; Brian Kha,5,0,30,25
1657416214899,MATH 20D,A02,083766,Tran; Brian Kha,5,0,30,25
1657416214899,MATH 20D,A03,083767,Tran; Brian Kha,5,0,30,25
1657416220922,MATH 20E,A01,083771,Ganguly; Soumya,9,0,32,23
1657416220922,MATH 20E,A02,083772,Ganguly; Soumya,6,0,32,26
1657416220922,MATH 20E,B01,083773,Ciotti; Benjamin,20,0,35,15
1657416220922,MATH 20E,B02,083774,Ciotti; Benjamin,17,0,35,18
1657416226951,MATH 103A,A01,083777,Greenfeld; Be'Eri,3,0,36,33
1657416226951,MATH 103A,A02,083778,Greenfeld; Be'Eri,5,0,36,31
1657416226951,MATH 103A,A03,093561,Greenfeld; Be'Eri,5,0,36,31
1657416226951,MATH 103A,B01,083779,Greenfeld; Be'Eri,7,0,36,29
1657416226951,MATH 103A,B02,083780,Greenfeld; Be'Eri,4,0,36,32
1657416226951,MATH 103A,B03,093562,Greenfeld; Be'Eri,3,0,36,33
1657416232974,MATH 105,A01,085443,Carter; Anne Toulson,15,0,35,20
1657416232974,MATH 105,A02,093477,Carter; Anne Toulson,20,0,35,15
1657416239004,MATH 109,A01,083213,Ganzberger; Geoffrey Michael,2,0,34,32
1657416239004,MATH 109,A02,083214,Ganzberger; Geoffrey Michael,4,0,34,30
1657416239004,MATH 109,A03,093478,Ganzberger; Geoffrey Michael,2,0,34,32
1657416239004,MATH 109,B01,083215,Ganzberger; Geoffrey Michael,1,0,32,31
1657416239004,MATH 109,B02,083216,Ganzberger; Geoffrey Michael,2,0,32,30
1657416239004,MATH 109,B03,093479,Ganzberger; Geoffrey Michael,8,0,32,24
1657416245028,MATH 142A,A01,083219,Chow; Bennett,7,0,32,25
1657416245028,MATH 142A,A02,083220,Chow; Bennett,10,0,32,22
1657416245028,MATH 142A,A03,093480,Chow; Bennett,8,0,32,24
1657416245028,MATH 142A,B03,093481,Chow; Bennett,8,0,32,24
1657416245028,MATH 142A,B04,093558,Chow; Bennett,13,0,32,19
1657416245028,MATH 142A,B05,093559,Chow; Bennett,6,0,32,26
1657416251052,MATH 193A,A01,083224,Rotar; Vladimir,8,0,34,26
1657416251052,MATH 193A,A02,083225,Rotar; Vladimir,9,0,34,25
1657416251052,MATH 193A,A03,083781,Rotar; Vladimir,5,0,34,29
1657416251052,MATH 193A,A04,083782,Rotar; Vladimir,10,0,34,24
1657416251052,MATH 193A,A05,093482,Rotar; Vladimir,10,0,34,24
1657416257079,MATH 197,001,091859,McAuley; Julian John,9999,0,9999,0
1657416257079,MATH 197,002,095566,Kedlaya; Kiran S.,9997,0,9999,2
1657416257079,MATH 197,003,095567,Xiao; Ming,9999,0,9999,0
1657416257079,MATH 197,004,095571,Perols; Johan Lars,9998,0,9999,1
1657416264162,COGS 9,A01,083615,Shannon; Kyle Michael,9,0,75,66
1657416270190,COGS 11,A01,083617,Boyle; Mary E. T.,22,0,48,26
1657416276217,COGS 13,A01,083071,Bastos; Amalia Pinkusfeld,11,0,71,60
1657416282241,COGS 14A,A01,092681,Semenuks; Arturs,5,1,100,95
1657416288268,COGS 14B,A01,083073,Cheng; Tzu-Han,6,0,63,57
1657416294291,COGS 17,A01,092677,Semenuks; Arturs,6,0,81,75
1657416300319,COGS 100,A01,083619,Allen; Michael Gordon,17,0,70,53
1657416306341,COGS 101A,A01,083621,Davis; Joshua Daniel,9,0,68,59
1657416312364,COGS 101B,A01,091572,Allen; Michael Gordon,12,0,65,53
1657416318391,COGS 101C,A01,083625,Delgado; Tania,17,0,35,18
1657416324418,COGS 107A,A01,083627,Boyle; Mary E. T.,13,0,60,47
1657416330440,COGS 118A,A01,083075,Gupta; Anjum,21,0,76,55
1657416336469,CSE 3,A50,083646,Miranda; Gregory Joseph,24,0,50,26
1657416342492,CSE 8A,A50,083650,Miranda; Gregory Joseph,17,1,56,39
1657416348515,CSE 11,A01,083080,Cao; Yingjun,6,15,40,34
1657416354538,CSE 12,A01,083652,Krause-Levy; Sophia Louisa,28,1,120,92
1657416360561,CSE 15L,A01,083654,Morris; Justin Loren,9,0,50,41
1657416360561,CSE 15L,A02,083655,Morris; Justin Loren,9,0,50,41
1657416366594,CSE 20,A01,083657,Tran; Khoa Dang,39,0,80,41
1657416372621,CSE 21,A01,095574,Bach; Quang Tran,22,0,48,26
1657416378659,CSE 30,A01,083084,Eldon; John,4,0,80,76
1657416378659,CSE 30,B01,095061,Bhaskar; Nishant,9,0,50,41
1657416384695,CSE 100,A01,083659,Cao; Yingjun,5,4,70,65
1657416390721,CSE 134B,A01,083661,Powell; Thomas Allan,22,0,100,78
1657416396743,CSE 140,A01,083663,Gungor; Onat,14,0,85,71
1657416402768,CSE 140L,A01,083088,Eldon; John,21,0,100,79
1657416408795,CSE 175,A01,083665,Kumar; Rakesh,3,0,25,22
1657416414822,CSE 190,A00,092507,Dubnov; Shlomo,7,0,20,13
1657416420849,ECE 45,A01,083139,Congero; Spencer William,6,0,75,69
1657416426876,ECE 65,A50,083695,Saad; Andrew S,12,0,30,18
1657416426876,ECE 65,A51,095125,Saad; Andrew S,24,0,26,2
1657416432904,ECE 109,A01,091882,Touri; Behrouz,19,0,70,51
1657416438927,ECE 180,A00,083140,Abi Samra; Nicholas Camill,1,0,30,29
1657416438927,ECE 180,B00,083141,Abi Samra; Nicholas Camill,0,0,30,30
1657416444952,MATH 10A,A01,083735,Patchell; Gregory David,2,0,30,28
1657416444952,MATH 10A,A02,083736,Patchell; Gregory David,20,0,30,10
1657416444952,MATH 10A,A03,083737,Patchell; Gregory David,16,0,30,14
1657416450977,MATH 10B,A01,083207,Lim; Seonhee,8,0,34,26
1657416450977,MATH 10B,A02,083208,Lim; Seonhee,9,0,35,26
1657416450977,MATH 10B,A03,093472,Lim; Seonhee,7,0,34,27
1657416450977,MATH 10B,B01,083739,Sinha; Shubham,12,0,30,18
1657416457010,MATH 18,A01,083743,Cinel; Cameron Alexander,7,0,30,23
1657416457010,MATH 18,A02,083744,Cinel; Cameron Alexander,17,0,30,13
1657416457010,MATH 18,A03,083745,Cinel; Cameron Alexander,9,0,30,21
1657416457010,MATH 18,B01,083748,Rideout; David Porter,5,0,37,32
1657416457010,MATH 18,B02,083749,Rideout; David Porter,5,0,36,31
1657416457010,MATH 18,B03,083750,Rideout; David Porter,3,0,37,34
1657416457010,MATH 18,B04,083751,Rideout; David Porter,6,0,36,30
1657416457010,MATH 18,B05,093473,Rideout; David Porter,6,0,36,30
1657416457010,MATH 18,B06,093474,Rideout; David Porter,6,0,36,30
1657416463038,MATH 20A,A01,083754,Zheng; Zequn,14,0,40,26
1657416469064,MATH 20B,A01,083756,Briones; Jor-el Thomas Caparas,4,0,36,32
1657416469064,MATH 20B,A02,083757,Briones; Jor-el Thomas Caparas,1,0,36,35
1657416469064,MATH 20B,A03,093475,Briones; Jor-el Thomas Caparas,2,0,36,34
1657416475092,MATH 20C,A01,083760,Briones; Jor-el Thomas Caparas,1,0,35,34
1657416475092,MATH 20C,A02,083761,Briones; Jor-el Thomas Caparas,8,0,35,27
1657416475092,MATH 20C,A03,093476,Briones; Jor-el Thomas Caparas,0,1,36,36
1657416475092,MATH 20C,B01,083762,Bach; Quang Tran,1,0,30,29
1657416481119,MATH 20D,A01,083765,Tran; Brian Kha,5,0,30,25
1657416481119,MATH 20D,A02,083766,Tran; Brian Kha,5,0,30,25
1657416481119,MATH 20D,A03,083767,Tran; Brian Kha,5,0,30,25
1657416487149,MATH 20E,A01,083771,Ganguly; Soumya,9,0,32,23
1657416487149,MATH 20E,A02,083772,Ganguly; Soumya,6,0,32,26
1657416487149,MATH 20E,B01,083773,Ciotti; Benjamin,20,0,35,15
1657416487149,MATH 20E,B02,083774,Ciotti; Benjamin,17,0,35,18
1657416493180,MATH 103A,A01,083777,Greenfeld; Be'Eri,3,0,36,33
1657416493180,MATH 103A,A02,083778,Greenfeld; Be'Eri,5,0,36,31
1657416493180,MATH 103A,A03,093561,Greenfeld; Be'Eri,5,0,36,31
1657416493180,MATH 103A,B01,083779,Greenfeld; Be'Eri,7,0,36,29
1657416493180,MATH 103A,B02,083780,Greenfeld; Be'Eri,4,0,36,32
1657416493180,MATH 103A,B03,093562,Greenfeld; Be'Eri,3,0,36,33
1657416499203,MATH 105,A01,085443,Carter; Anne Toulson,15,0,35,20
1657416499203,MATH 105,A02,093477,Carter; Anne Toulson,20,0,35,15
1657416505230,MATH 109,A01,083213,Ganzberger; Geoffrey Michael,2,0,34,32
1657416505230,MATH 109,A02,083214,Ganzberger; Geoffrey Michael,4,0,34,30
1657416505230,MATH 109,A03,093478,Ganzberger; Geoffrey Michael,2,0,34,32
1657416505230,MATH 109,B01,083215,Ganzberger; Geoffrey Michael,1,0,32,31
1657416505230,MATH 109,B02,083216,Ganzberger; Geoffrey Michael,2,0,32,30
1657416505230,MATH 109,B03,093479,Ganzberger; Geoffrey Michael,8,0,32,24
1657416511260,MATH 142A,A01,083219,Chow; Bennett,7,0,32,25
1657416511260,MATH 142A,A02,083220,Chow; Bennett,10,0,32,22
1657416511260,MATH 142A,A03,093480,Chow; Bennett,8,0,32,24
1657416511260,MATH 142A,B03,093481,Chow; Bennett,8,0,32,24
1657416511260,MATH 142A,B04,093558,Chow; Bennett,13,0,32,19
1657416511260,MATH 142A,B05,093559,Chow; Bennett,6,0,32,26
1657416517286,MATH 193A,A01,083224,Rotar; Vladimir,8,0,34,26
1657416517286,MATH 193A,A02,083225,Rotar; Vladimir,9,0,34,25
1657416517286,MATH 193A,A03,083781,Rotar; Vladimir,5,0,34,29
1657416517286,MATH 193A,A04,083782,Rotar; Vladimir,10,0,34,24
1657416517286,MATH 193A,A05,093482,Rotar; Vladimir,10,0,34,24
1657416523310,MATH 197,001,091859,McAuley; Julian John,9999,0,9999,0
1657416523310,MATH 197,002,095566,Kedlaya; Kiran S.,9997,0,9999,2
1657416523310,MATH 197,003,095567,Xiao; Ming,9999,0,9999,0
1657416523310,MATH 197,004,095571,Perols; Johan Lars,9998,0,9999,1
1657416530376,COGS 9,A01,083615,Shannon; Kyle Michael,9,0,75,66
1657416536402,COGS 11,A01,083617,Boyle; Mary E. T.,22,0,48,26
1657416542425,COGS 13,A01,083071,Bastos; Amalia Pinkusfeld,11,0,71,60
1657416548451,COGS 14A,A01,092681,Semenuks; Arturs,5,1,100,95
1657416554478,COGS 14B,A01,083073,Cheng; Tzu-Han,6,0,63,57
1657416560502,COGS 17,A01,092677,Semenuks; Arturs,6,0,81,75
1657416566528,COGS 100,A01,083619,Allen; Michael Gordon,17,0,70,53
1657416572552,COGS 101A,A01,083621,Davis; Joshua Daniel,9,0,68,59
1657416578580,COGS 101B,A01,091572,Allen; Michael Gordon,12,0,65,53
1657416584603,COGS 101C,A01,083625,Delgado; Tania,17,0,35,18
1657416590628,COGS 107A,A01,083627,Boyle; Mary E. T.,13,0,60,47
1657416596658,COGS 118A,A01,083075,Gupta; Anjum,21,0,76,55
1657416602685,CSE 3,A50,083646,Miranda; Gregory Joseph,24,0,50,26
1657416608709,CSE 8A,A50,083650,Miranda; Gregory Joseph,17,1,56,39
1657416614736,CSE 11,A01,083080,Cao; Yingjun,6,15,40,34
1657416620764,CSE 12,A01,083652,Krause-Levy; Sophia Louisa,28,1,120,92
1657416626788,CSE 15L,A01,083654,Morris; Justin Loren,9,0,50,41
1657416626788,CSE 15L,A02,083655,Morris; Justin Loren,9,0,50,41
1657416632811,CSE 20,A01,083657,Tran; Khoa Dang,39,0,80,41
1657416638836,CSE 21,A01,095574,Bach; Quang Tran,22,0,48,26
1657416644865,CSE 30,A01,083084,Eldon; John,4,0,80,76
1657416644865,CSE 30,B01,095061,Bhaskar; Nishant,9,0,50,41
1657416650894,CSE 100,A01,083659,Cao; Yingjun,5,4,70,65
1657416656917,CSE 134B,A01,083661,Powell; Thomas Allan,22,0,100,78
1657416662940,CSE 140,A01,083663,Gungor; Onat,14,0,85,71
1657416668964,CSE 140L,A01,083088,Eldon; John,21,0,100,79
1657416674986,CSE 175,A01,083665,Kumar; Rakesh,3,0,25,22
1657416681011,CSE 190,A00,092507,Dubnov; Shlomo,7,0,20,13
1657416687034,ECE 45,A01,083139,Congero; Spencer William,6,0,75,69
1657416693057,ECE 65,A50,083695,Saad; Andrew S,12,0,30,18
1657416693057,ECE 65,A51,095125,Saad; Andrew S,24,0,26,2
1657416699080,ECE 109,A01,091882,Touri; Behrouz,19,0,70,51
1657416705104,ECE 180,A00,083140,Abi Samra; Nicholas Camill,1,0,30,29
1657416705104,ECE 180,B00,083141,Abi Samra; Nicholas Camill,0,0,30,30
1657416711127,MATH 10A,A01,083735,Patchell; Gregory David,2,0,30,28
1657416711127,MATH 10A,A02,083736,Patchell; Gregory David,20,0,30,10
1657416711127,MATH 10A,A03,083737,Patchell; Gregory David,16,0,30,14
1657416717224,MATH 10B,A01,083207,Lim; Seonhee,8,0,34,26
1657416717224,MATH 10B,A02,083208,Lim; Seonhee,9,0,35,26
1657416717224,MATH 10B,A03,093472,Lim; Seonhee,7,0,34,27
1657416717224,MATH 10B,B01,083739,Sinha; Shubham,12,0,30,18
1657416723255,MATH 18,A01,083743,Cinel; Cameron Alexander,7,0,30,23
1657416723255,MATH 18,A02,083744,Cinel; Cameron Alexander,17,0,30,13
1657416723255,MATH 18,A03,083745,Cinel; Cameron Alexander,9,0,30,21
1657416723255,MATH 18,B01,083748,Rideout; David Porter,5,0,37,32
1657416723255,MATH 18,B02,083749,Rideout; David Porter,5,0,36,31
1657416723255,MATH 18,B03,083750,Rideout; David Porter,3,0,37,34
1657416723255,MATH 18,B04,083751,Rideout; David Porter,6,0,36,30
1657416723255,MATH 18,B05,093473,Rideout; David Porter,6,0,36,30
1657416723255,MATH 18,B06,093474,Rideout; David Porter,6,0,36,30
1657416729282,MATH 20A,A01,083754,Zheng; Zequn,14,0,40,26
1657416735306,MATH 20B,A01,083756,Briones; Jor-el Thomas Caparas,4,0,36,32
1657416735306,MATH 20B,A02,083757,Briones; Jor-el Thomas Caparas,1,0,36,35
1657416735306,MATH 20B,A03,093475,Briones; Jor-el Thomas Caparas,2,0,36,34
1657416741329,MATH 20C,A01,083760,Briones; Jor-el Thomas Caparas,1,0,35,34
1657416741329,MATH 20C,A02,083761,Briones; Jor-el Thomas Caparas,8,0,35,27
1657416741329,MATH 20C,A03,093476,Briones; Jor-el Thomas Caparas,0,1,36,36
1657416741329,MATH 20C,B01,083762,Bach; Quang Tran,1,0,30,29
1657416747359,MATH 20D,A01,083765,Tran; Brian Kha,5,0,30,25
1657416747359,MATH 20D,A02,083766,Tran; Brian Kha,5,0,30,25
1657416747359,MATH 20D,A03,083767,Tran; Brian Kha,5,0,30,25
1657416753384,MATH 20E,A01,083771,Ganguly; Soumya,9,0,32,23
1657416753384,MATH 20E,A02,083772,Ganguly; Soumya,6,0,32,26
1657416753384,MATH 20E,B01,083773,Ciotti; Benjamin,20,0,35,15
1657416753384,MATH 20E,B02,083774,Ciotti; Benjamin,17,0,35,18
1657416759413,MATH 103A,A01,083777,Greenfeld; Be'Eri,3,0,36,33
1657416759413,MATH 103A,A02,083778,Greenfeld; Be'Eri,5,0,36,31
1657416759413,MATH 103A,A03,093561,Greenfeld; Be'Eri,5,0,36,31
1657416759413,MATH 103A,B01,083779,Greenfeld; Be'Eri,7,0,36,29
1657416759413,MATH 103A,B02,083780,Greenfeld; Be'Eri,4,0,36,32
1657416759413,MATH 103A,B03,093562,Greenfeld; Be'Eri,3,0,36,33
1657416765441,MATH 105,A01,085443,Carter; Anne Toulson,15,0,35,20
1657416765441,MATH 105,A02,093477,Carter; Anne Toulson,20,0,35,15
1657416771463,MATH 109,A01,083213,Ganzberger; Geoffrey Michael,2,0,34,32
1657416771463,MATH 109,A02,083214,Ganzberger; Geoffrey Michael,4,0,34,30
1657416771463,MATH 109,A03,093478,Ganzberger; Geoffrey Michael,2,0,34,32
1657416771463,MATH 109,B01,083215,Ganzberger; Geoffrey Michael,1,0,32,31
1657416771463,MATH 109,B02,083216,Ganzberger; Geoffrey Michael,2,0,32,30
1657416771463,MATH 109,B03,093479,Ganzberger; Geoffrey Michael,8,0,32,24
1657416777496,MATH 142A,A01,083219,Chow; Bennett,7,0,32,25
1657416777496,MATH 142A,A02,083220,Chow; Bennett,10,0,32,22
1657416777496,MATH 142A,A03,093480,Chow; Bennett,8,0,32,24
1657416777496,MATH 142A,B03,093481,Chow; Bennett,8,0,32,24
1657416777496,MATH 142A,B04,093558,Chow; Bennett,13,0,32,19
1657416777496,MATH 142A,B05,093559,Chow; Bennett,6,0,32,26
1657416783519,MATH 193A,A01,083224,Rotar; Vladimir,8,0,34,26
1657416783519,MATH 193A,A02,083225,Rotar; Vladimir,9,0,34,25
1657416783519,MATH 193A,A03,083781,Rotar; Vladimir,5,0,34,29
1657416783519,MATH 193A,A04,083782,Rotar; Vladimir,10,0,34,24
1657416783519,MATH 193A,A05,093482,Rotar; Vladimir,10,0,34,24
1657416789541,MATH 197,001,091859,McAuley; Julian John,9999,0,9999,0
1657416789541,MATH 197,002,095566,Kedlaya; Kiran S.,9997,0,9999,2
1657416789541,MATH 197,003,095567,Xiao; Ming,9999,0,9999,0
1657416789541,MATH 197,004,095571,Perols; Johan Lars,9998,0,9999,1
1657416796597,COGS 9,A01,083615,Shannon; Kyle Michael,9,0,75,66
1657416802618,COGS 11,A01,083617,Boyle; Mary E. T.,22,0,48,26
1657416808644,COGS 13,A01,083071,Bastos; Amalia Pinkusfeld,11,0,71,60
1657416814669,COGS 14A,A01,092681,Semenuks; Arturs,5,1,100,95
1657416820692,COGS 14B,A01,083073,Cheng; Tzu-Han,6,0,63,57
1657416826719,COGS 17,A01,092677,Semenuks; Arturs,6,0,81,75
1657416832741,COGS 100,A01,083619,Allen; Michael Gordon,17,0,70,53
1657416838766,COGS 101A,A01,083621,Davis; Joshua Daniel,9,0,68,59
1657416844791,COGS 101B,A01,091572,Allen; Michael Gordon,12,0,65,53
1657416850814,COGS 101C,A01,083625,Delgado; Tania,17,0,35,18
1657416856837,COGS 107A,A01,083627,Boyle; Mary E. T.,13,0,60,47
1657416862865,COGS 118A,A01,083075,Gupta; Anjum,21,0,76,55
1657416868892,CSE 3,A50,083646,Miranda; Gregory Joseph,24,0,50,26
1657416874922,CSE 8A,A50,083650,Miranda; Gregory Joseph,17,1,56,39
1657416880948,CSE 11,A01,083080,Cao; Yingjun,6,15,40,34
1657416886976,CSE 12,A01,083652,Krause-Levy; Sophia Louisa,28,1,120,92
1657416893000,CSE 15L,A01,083654,Morris; Justin Loren,9,0,50,41
1657416893000,CSE 15L,A02,083655,Morris; Justin Loren,9,0,50,41
1657416899023,CSE 20,A01,083657,Tran; Khoa Dang,39,0,80,41
1657416905046,CSE 21,A01,095574,Bach; Quang Tran,22,0,48,26
1657416911068,CSE 30,A01,083084,Eldon; John,4,0,80,76
1657416911068,CSE 30,B01,095061,Bhaskar; Nishant,9,0,50,41
1657416917091,CSE 100,A01,083659,Cao; Yingjun,5,4,70,65
1657416923113,CSE 134B,A01,083661,Powell; Thomas Allan,22,0,100,78
1657416929135,CSE 140,A01,083663,Gungor; Onat,14,0,85,71
1657416935158,CSE 140L,A01,083088,Eldon; John,21,0,100,79
1657416941185,CSE 175,A01,083665,Kumar; Rakesh,3,0,25,22
1657416947207,CSE 190,A00,092507,Dubnov; Shlomo,7,0,20,13
1657416953234,ECE 45,A01,083139,Congero; Spencer William,6,0,75,69
1657416959262,ECE 65,A50,083695,Saad; Andrew S,12,0,30,18
1657416959262,ECE 65,A51,095125,Saad; Andrew S,24,0,26,2
1657416965290,ECE 109,A01,091882,Touri; Behrouz,19,0,70,51
1657416971313,ECE 180,A00,083140,Abi Samra; Nicholas Camill,1,0,30,29
1657416971313,ECE 180,B00,083141,Abi Samra; Nicholas Camill,0,0,30,30
1657416977337,MATH 10A,A01,083735,Patchell; Gregory David,2,0,30,28
1657416977337,MATH 10A,A02,083736,Patchell; Gregory David,20,0,30,10
1657416977337,MATH 10A,A03,083737,Patchell; Gregory David,16,0,30,14
1657416983362,MATH 10B,A01,083207,Lim; Seonhee,8,0,34,26
1657416983362,MATH 10B,A02,083208,Lim; Seonhee,9,0,35,26
1657416983362,MATH 10B,A03,093472,Lim; Seonhee,7,0,34,27
1657416983362,MATH 10B,B01,083739,Sinha; Shubham,12,0,30,18
1657416989386,MATH 18,A01,083743,Cinel; Cameron Alexander,7,0,30,23
1657416989386,MATH 18,A02,083744,Cinel; Cameron Alexander,17,0,30,13
1657416989386,MATH 18,A03,083745,Cinel; Cameron Alexander,9,0,30,21
1657416989386,MATH 18,B01,083748,Rideout; David Porter,5,0,37,32
1657416989386,MATH 18,B02,083749,Rideout; David Porter,5,0,36,31
1657416989386,MATH 18,B03,083750,Rideout; David Porter,3,0,37,34
1657416989386,MATH 18,B04,083751,Rideout; David Porter,6,0,36,30
1657416989386,MATH 18,B05,093473,Rideout; David Porter,6,0,36,30
1657416989386,MATH 18,B06,093474,Rideout; David Porter,6,0,36,30
1657416995412,MATH 20A,A01,083754,Zheng; Zequn,14,0,40,26
1657417001434,MATH 20B,A01,083756,Briones; Jor-el Thomas Caparas,4,0,36,32
1657417001434,MATH 20B,A02,083757,Briones; Jor-el Thomas Caparas,1,0,36,35
1657417001434,MATH 20B,A03,093475,Briones; Jor-el Thomas Caparas,2,0,36,34
1657417007457,MATH 20C,A01,083760,Briones; Jor-el Thomas Caparas,1,0,35,34
1657417007457,MATH 20C,A02,083761,Briones; Jor-el Thomas Caparas,8,0,35,27
1657417007457,MATH 20C,A03,093476,Briones; Jor-el Thomas Caparas,0,1,36,36
1657417007457,MATH 20C,B01,083762,Bach; Quang Tran,1,0,30,29
1657417013485,MATH 20D,A01,083765,Tran; Brian Kha,5,0,30,25
1657417013485,MATH 20D,A02,083766,Tran; Brian Kha,5,0,30,25
1657417013485,MATH 20D,A03,083767,Tran; Brian Kha,5,0,30,25
1657417019513,MATH 20E,A01,083771,Ganguly; Soumya,9,0,32,23
1657417019513,MATH 20E,A02,083772,Ganguly; Soumya,6,0,32,26
1657417019513,MATH 20E,B01,083773,Ciotti; Benjamin,20,0,35,15
1657417019513,MATH 20E,B02,083774,Ciotti; Benjamin,17,0,35,18
1657417025542,MATH 103A,A01,083777,Greenfeld; Be'Eri,3,0,36,33
1657417025542,MATH 103A,A02,083778,Greenfeld; Be'Eri,5,0,36,31
1657417025542,MATH 103A,A03,093561,Greenfeld; Be'Eri,5,0,36,31
1657417025542,MATH 103A,B01,083779,Greenfeld; Be'Eri,7,0,36,29
1657417025542,MATH 103A,B02,083780,Greenfeld; Be'Eri,4,0,36,32
1657417025542,MATH 103A,B03,093562,Greenfeld; Be'Eri,3,0,36,33
1657417031566,MATH 105,A01,085443,Carter; Anne Toulson,15,0,35,20
1657417031566,MATH 105,A02,093477,Carter; Anne Toulson,20,0,35,15
1657417037594,MATH 109,A01,083213,Ganzberger; Geoffrey Michael,2,0,34,32
1657417037594,MATH 109,A02,083214,Ganzberger; Geoffrey Michael,4,0,34,30
1657417037594,MATH 109,A03,093478,Ganzberger; Geoffrey Michael,2,0,34,32
1657417037594,MATH 109,B01,083215,Ganzberger; Geoffrey Michael,1,0,32,31
1657417037594,MATH 109,B02,083216,Ganzberger; Geoffrey Michael,2,0,32,30
1657417037594,MATH 109,B03,093479,Ganzberger; Geoffrey Michael,8,0,32,24
1657417043623,MATH 142A,A01,083219,Chow; Bennett,7,0,32,25
1657417043623,MATH 142A,A02,083220,Chow; Bennett,10,0,32,22
1657417043623,MATH 142A,A03,093480,Chow; Bennett,8,0,32,24
1657417043623,MATH 142A,B03,093481,Chow; Bennett,8,0,32,24
1657417043623,MATH 142A,B04,093558,Chow; Bennett,13,0,32,19
1657417043623,MATH 142A,B05,093559,Chow; Bennett,6,0,32,26
1657417049648,MATH 193A,A01,083224,Rotar; Vladimir,8,0,34,26
1657417049648,MATH 193A,A02,083225,Rotar; Vladimir,9,0,34,25
1657417049648,MATH 193A,A03,083781,Rotar; Vladimir,5,0,34,29
1657417049648,MATH 193A,A04,083782,Rotar; Vladimir,10,0,34,24
1657417049648,MATH 193A,A05,093482,Rotar; Vladimir,10,0,34,24
1657417055670,MATH 197,001,091859,McAuley; Julian John,9999,0,9999,0
1657417055670,MATH 197,002,095566,Kedlaya; Kiran S.,9997,0,9999,2
1657417055670,MATH 197,003,095567,Xiao; Ming,9999,0,9999,0
1657417055670,MATH 197,004,095571,Perols; Johan Lars,9998,0,9999,1
1657417062736,COGS 9,A01,083615,Shannon; Kyle Michael,9,0,75,66
1657417068762,COGS 11,A01,083617,Boyle; Mary E. T.,22,0,48,26
1657417074785,COGS 13,A01,083071,Bastos; Amalia Pinkusfeld,11,0,71,60
1657417080813,COGS 14A,A01,092681,Semenuks; Arturs,5,1,100,95
1657417086840,COGS 14B,A01,083073,Cheng; Tzu-Han,6,0,63,57
1657417092864,COGS 17,A01,092677,Semenuks; Arturs,6,0,81,75
1657417098887,COGS 100,A01,083619,Allen; Michael Gordon,17,0,70,53
1657417104915,COGS 101A,A01,083621,Davis; Joshua Daniel,9,0,68,59
1657417110940,COGS 101B,A01,091572,Allen; Michael Gordon,12,0,65,53
1657417116965,COGS 101C,A01,083625,Delgado; Tania,17,0,35,18
1657417122994,COGS 107A,A01,083627,Boyle; Mary E. T.,13,0,60,47
1657417129018,COGS 118A,A01,083075,Gupta; Anjum,21,0,76,55
1657417135041,CSE 3,A50,083646,Miranda; Gregory Joseph,24,0,50,26
1657417141069,CSE 8A,A50,083650,Miranda; Gregory Joseph,17,1,56,39
1657417147091,CSE 11,A01,083080,Cao; Yingjun,6,15,40,34
1657417153115,CSE 12,A01,083652,Krause-Levy; Sophia Louisa,28,1,120,92
1657417159140,CSE 15L,A01,083654,Morris; Justin Loren,9,0,50,41
1657417159140,CSE 15L,A02,083655,Morris; Justin Loren,9,0,50,41
1657417165168,CSE 20,A01,083657,Tran; Khoa Dang,39,0,80,41
1657417171195,CSE 21,A01,095574,Bach; Quang Tran,22,0,48,26
1657417177218,CSE 30,A01,083084,Eldon; John,4,0,80,76
1657417177218,CSE 30,B01,095061,Bhaskar; Nishant,9,0,50,41
1657417183241,CSE 100,A01,083659,Cao; Yingjun,5,4,70,65
1657417189267,CSE 134B,A01,083661,Powell; Thomas Allan,22,0,100,78
1657417195294,CSE 140,A01,083663,Gungor; Onat,14,0,85,71
1657417201335,CSE 140L,A01,083088,Eldon; John,21,0,100,79
1657417207364,CSE 175,A01,083665,Kumar; Rakesh,3,0,25,22
1657417213390,CSE 190,A00,092507,Dubnov; Shlomo,7,0,20,13
1657417219413,ECE 45,A01,083139,Congero; Spencer William,6,0,75,69
1657417225439,ECE 65,A50,083695,Saad; Andrew S,12,0,30,18
1657417225439,ECE 65,A51,095125,Saad; Andrew S,24,0,26,2
1657417231463,ECE 109,A01,091882,Touri; Behrouz,19,0,70,51
1657417237496,ECE 180,A00,083140,Abi Samra; Nicholas Camill,1,0,30,29
1657417237496,ECE 180,B00,083141,Abi Samra; Nicholas Camill,0,0,30,30
1657417243519,MATH 10A,A01,083735,Patchell; Gregory David,2,0,30,28
1657417243519,MATH 10A,A02,083736,Patchell; Gregory David,20,0,30,10
1657417243519,MATH 10A,A03,083737,Patchell; Gregory David,16,0,30,14
1657417249543,MATH 10B,A01,083207,Lim; Seonhee,8,0,34,26
1657417249543,MATH 10B,A02,083208,Lim; Seonhee,9,0,35,26
1657417249543,MATH 10B,A03,093472,Lim; Seonhee,7,0,34,27
1657417249543,MATH 10B,B01,083739,Sinha; Shubham,12,0,30,18
1657417255573,MATH 18,A01,083743,Cinel; Cameron Alexander,7,0,30,23
1657417255573,MATH 18,A02,083744,Cinel; Cameron Alexander,17,0,30,13
1657417255573,MATH 18,A03,083745,Cinel; Cameron Alexander,9,0,30,21
1657417255573,MATH 18,B01,083748,Rideout; David Porter,5,0,37,32
1657417255573,MATH 18,B02,083749,Rideout; David Porter,5,0,36,31
1657417255573,MATH 18,B03,083750,Rideout; David Porter,3,0,37,34
1657417255573,MATH 18,B04,083751,Rideout; David Porter,6,0,36,30
1657417255573,MATH 18,B05,093473,Rideout; David Porter,6,0,36,30
1657417255573,MATH 18,B06,093474,Rideout; David Porter,6,0,36,30
1657417261599,MATH 20A,A01,083754,Zheng; Zequn,14,0,40,26
1657417267622,MATH 20B,A01,083756,Briones; Jor-el Thomas Caparas,4,0,36,32
1657417267622,MATH 20B,A02,083757,Briones; Jor-el Thomas Caparas,1,0,36,35
1657417267622,MATH 20B,A03,093475,Briones; Jor-el Thomas Caparas,2,0,36,34
1657417273645,MATH 20C,A01,083760,Briones; Jor-el Thomas Caparas,1,0,35,34
1657417273645,MATH 20C,A02,083761,Briones; Jor-el Thomas Caparas,8,0,35,27
1657417273645,MATH 20C,A03,093476,Briones; Jor-el Thomas Caparas,0,1,36,36
1657417273645,MATH 20C,B01,083762,Bach; Quang Tran,1,0,30,29
1657417279667,MATH 20D,A01,083765,Tran; Brian Kha,5,0,30,25
1657417279667,MATH 20D,A02,083766,Tran; Brian Kha,5,0,30,25
1657417279667,MATH 20D,A03,083767,Tran; Brian Kha,5,0,30,25
1657417285695,MATH 20E,A01,083771,Ganguly; Soumya,9,0,32,23
1657417285695,MATH 20E,A02,083772,Ganguly; Soumya,6,0,32,26
1657417285695,MATH 20E,B01,083773,Ciotti; Benjamin,20,0,35,15
1657417285695,MATH 20E,B02,083774,Ciotti; Benjamin,17,0,35,18
1657417291726,MATH 103A,A01,083777,Greenfeld; Be'Eri,3,0,36,33
1657417291726,MATH 103A,A02,083778,Greenfeld; Be'Eri,5,0,36,31
1657417291726,MATH 103A,A03,093561,Greenfeld; Be'Eri,5,0,36,31
1657417291726,MATH 103A,B01,083779,Greenfeld; Be'Eri,7,0,36,29
1657417291726,MATH 103A,B02,083780,Greenfeld; Be'Eri,4,0,36,32
1657417291726,MATH 103A,B03,093562,Greenfeld; Be'Eri,3,0,36,33
1657417297755,MATH 105,A01,085443,Carter; Anne Toulson,15,0,35,20
1657417297755,MATH 105,A02,093477,Carter; Anne Toulson,20,0,35,15
1657417303781,MATH 109,A01,083213,Ganzberger; Geoffrey Michael,2,0,34,32
1657417303781,MATH 109,A02,083214,Ganzberger; Geoffrey Michael,4,0,34,30
1657417303781,MATH 109,A03,093478,Ganzberger; Geoffrey Michael,2,0,34,32
1657417303781,MATH 109,B01,083215,Ganzberger; Geoffrey Michael,1,0,32,31
1657417303781,MATH 109,B02,083216,Ganzberger; Geoffrey Michael,2,0,32,30
1657417303781,MATH 109,B03,093479,Ganzberger; Geoffrey Michael,8,0,32,24
1657417309823,MATH 142A,A01,083219,Chow; Bennett,7,0,32,25
1657417309823,MATH 142A,A02,083220,Chow; Bennett,10,0,32,22
1657417309823,MATH 142A,A03,093480,Chow; Bennett,8,0,32,24
1657417309823,MATH 142A,B03,093481,Chow; Bennett,8,0,32,24
1657417309823,MATH 142A,B04,093558,Chow; Bennett,13,0,32,19
1657417309823,MATH 142A,B05,093559,Chow; Bennett,6,0,32,26
1657417315918,MATH 193A,A01,083224,Rotar; Vladimir,8,0,34,26
1657417315918,MATH 193A,A02,083225,Rotar; Vladimir,9,0,34,25
1657417315918,MATH 193A,A03,083781,Rotar; Vladimir,5,0,34,29
1657417315918,MATH 193A,A04,083782,Rotar; Vladimir,10,0,34,24
1657417315918,MATH 193A,A05,093482,Rotar; Vladimir,10,0,34,24
1657417321945,MATH 197,001,091859,McAuley; Julian John,9999,0,9999,0
1657417321945,MATH 197,002,095566,Kedlaya; Kiran S.,9997,0,9999,2
1657417321945,MATH 197,003,095567,Xiao; Ming,9999,0,9999,0
1657417321945,MATH 197,004,095571,Perols; Johan Lars,9998,0,9999,1
1657417329014,COGS 9,A01,083615,Shannon; Kyle Michael,9,0,75,66
1657417335042,COGS 11,A01,083617,Boyle; Mary E. T.,22,0,48,26
1657417341064,COGS 13,A01,083071,Bastos; Amalia Pinkusfeld,11,0,71,60
1657417347086,COGS 14A,A01,092681,Semenuks; Arturs,5,1,100,95
1657417353113,COGS 14B,A01,083073,Cheng; Tzu-Han,6,0,63,57
1657417359136,COGS 17,A01,092677,Semenuks; Arturs,6,0,81,75
1657417365162,COGS 100,A01,083619,Allen; Michael Gordon,17,0,70,53
1657417371187,COGS 101A,A01,083621,Davis; Joshua Daniel,9,0,68,59
1657417377210,COGS 101B,A01,091572,Allen; Michael Gordon,12,0,65,53
1657417383237,COGS 101C,A01,083625,Delgado; Tania,17,0,35,18
1657417389260,COGS 107A,A01,083627,Boyle; Mary E. T.,13,0,60,47
1657417395304,COGS 118A,A01,083075,Gupta; Anjum,21,0,76,55
1657417401328,CSE 3,A50,083646,Miranda; Gregory Joseph,24,0,50,26
1657417407355,CSE 8A,A50,083650,Miranda; Gregory Joseph,17,1,56,39
1657417413377,CSE 11,A01,083080,Cao; Yingjun,6,15,40,34
1657417419399,CSE 12,A01,083652,Krause-Levy; Sophia Louisa,28,1,120,92
1657417425420,CSE 15L,A01,083654,Morris; Justin Loren,9,0,50,41
1657417425420,CSE 15L,A02,083655,Morris; Justin Loren,9,0,50,41
1657417431447,CSE 20,A01,083657,Tran; Khoa Dang,39,0,80,41
1657417437472,CSE 21,A01,095574,Bach; Quang Tran,22,0,48,26
1657417443494,CSE 30,A01,083084,Eldon; John,4,0,80,76
1657417443494,CSE 30,B01,095061,Bhaskar; Nishant,9,0,50,41
1657417449518,CSE 100,A01,083659,Cao; Yingjun,5,4,70,65
1657417455545,CSE 134B,A01,083661,Powell; Thomas Allan,22,0,100,78
1657417461569,CSE 140,A01,083663,Gungor; Onat,14,0,85,71
1657417467652,CSE 140L,A01,083088,Eldon; John,21,0,100,79
1657417473675,CSE 175,A01,083665,Kumar; Rakesh,3,0,25,22
1657417479702,CSE 190,A00,092507,Dubnov; Shlomo,7,0,20,13
1657417485730,ECE 45,A01,083139,Congero; Spencer William,6,0,75,69
1657417491761,ECE 65,A50,083695,Saad; Andrew S,12,0,30,18
1657417491761,ECE 65,A51,095125,Saad; Andrew S,24,0,26,2
1657417497788,ECE 109,A01,091882,Touri; Behrouz,19,0,70,51
1657417503814,ECE 180,A00,083140,Abi Samra; Nicholas Camill,1,0,30,29
1657417503814,ECE 180,B00,083141,Abi Samra; Nicholas Camill,0,0,30,30
1657417509840,MATH 10A,A01,083735,Patchell; Gregory David,2,0,30,28
1657417509840,MATH 10A,A02,083736,Patchell; Gregory David,20,0,30,10
1657417509840,MATH 10A,A03,083737,Patchell; Gregory David,16,0,30,14
1657417515863,MATH 10B,A01,083207,Lim; Seonhee,8,0,34,26
1657417515863,MATH 10B,A02,083208,Lim; Seonhee,9,0,35,26
1657417515863,MATH 10B,A03,093472,Lim; Seonhee,7,0,34,27
1657417515863,MATH 10B,B01,083739,Sinha; Shubham,12,0,30,18
1657417521888,MATH 18,A01,083743,Cinel; Cameron Alexander,7,0,30,23
1657417521888,MATH 18,A02,083744,Cinel; Cameron Alexander,17,0,30,13
1657417521888,MATH 18,A03,083745,Cinel; Cameron Alexander,9,0,30,21
1657417521888,MATH 18,B01,083748,Rideout; David Porter,5,0,37,32
1657417521888,MATH 18,B02,083749,Rideout; David Porter,5,0,36,31
1657417521888,MATH 18,B03,083750,Rideout; David Porter,3,0,37,34
1657417521888,MATH 18,B04,083751,Rideout; David Porter,6,0,36,30
1657417521888,MATH 18,B05,093473,Rideout; David Porter,6,0,36,30
1657417521888,MATH 18,B06,093474,Rideout; David Porter,6,0,36,30
1657417527917,MATH 20A,A01,083754,Zheng; Zequn,14,0,40,26
1657417533940,MATH 20B,A01,083756,Briones; Jor-el Thomas Caparas,4,0,36,32
1657417533940,MATH 20B,A02,083757,Briones; Jor-el Thomas Caparas,1,0,36,35
1657417533940,MATH 20B,A03,093475,Briones; Jor-el Thomas Caparas,2,0,36,34
1657417539969,MATH 20C,A01,083760,Briones; Jor-el Thomas Caparas,1,0,35,34
1657417539969,MATH 20C,A02,083761,Briones; Jor-el Thomas Caparas,8,0,35,27
1657417539969,MATH 20C,A03,093476,Briones; Jor-el Thomas Caparas,0,1,36,36
1657417539969,MATH 20C,B01,083762,Bach; Quang Tran,1,0,30,29
1657417545995,MATH 20D,A01,083765,Tran; Brian Kha,5,0,30,25
1657417545995,MATH 20D,A02,083766,Tran; Brian Kha,5,0,30,25
1657417545995,MATH 20D,A03,083767,Tran; Brian Kha,5,0,30,25
1657417552025,MATH 20E,A01,083771,Ganguly; Soumya,9,0,32,23
1657417552025,MATH 20E,A02,083772,Ganguly; Soumya,6,0,32,26
1657417552025,MATH 20E,B01,083773,Ciotti; Benjamin,20,0,35,15
1657417552025,MATH 20E,B02,083774,Ciotti; Benjamin,17,0,35,18
1657417558048,MATH 103A,A01,083777,Greenfeld; Be'Eri,3,0,36,33
1657417558048,MATH 103A,A02,083778,Greenfeld; Be'Eri,5,0,36,31
1657417558048,MATH 103A,A03,093561,Greenfeld; Be'Eri,5,0,36,31
1657417558048,MATH 103A,B01,083779,Greenfeld; Be'Eri,7,0,36,29
1657417558048,MATH 103A,B02,083780,Greenfeld; Be'Eri,4,0,36,32
1657417558048,MATH 103A,B03,093562,Greenfeld; Be'Eri,3,0,36,33
1657417564071,MATH 105,A01,085443,Carter; Anne Toulson,15,0,35,20
1657417564071,MATH 105,A02,093477,Carter; Anne Toulson,20,0,35,15
1657417570100,MATH 109,A01,083213,Ganzberger; Geoffrey Michael,2,0,34,32
1657417570100,MATH 109,A02,083214,Ganzberger; Geoffrey Michael,4,0,34,30
1657417570100,MATH 109,A03,093478,Ganzberger; Geoffrey Michael,2,0,34,32
1657417570100,MATH 109,B01,083215,Ganzberger; Geoffrey Michael,1,0,32,31
1657417570100,MATH 109,B02,083216,Ganzberger; Geoffrey Michael,2,0,32,30
1657417570100,MATH 109,B03,093479,Ganzberger; Geoffrey Michael,8,0,32,24
1657417576125,MATH 142A,A01,083219,Chow; Bennett,7,0,32,25
1657417576125,MATH 142A,A02,083220,Chow; Bennett,10,0,32,22
1657417576125,MATH 142A,A03,093480,Chow; Bennett,8,0,32,24
1657417576125,MATH 142A,B03,093481,Chow; Bennett,8,0,32,24
1657417576125,MATH 142A,B04,093558,Chow; Bennett,13,0,32,19
1657417576125,MATH 142A,B05,093559,Chow; Bennett,6,0,32,26
1657417582148,MATH 193A,A01,083224,Rotar; Vladimir,8,0,34,26
1657417582148,MATH 193A,A02,083225,Rotar; Vladimir,9,0,34,25
1657417582148,MATH 193A,A03,083781,Rotar; Vladimir,5,0,34,29
1657417582148,MATH 193A,A04,083782,Rotar; Vladimir,10,0,34,24
1657417582148,MATH 193A,A05,093482,Rotar; Vladimir,10,0,34,24
1657417588169,MATH 197,001,091859,McAuley; Julian John,9999,0,9999,0
1657417588169,MATH 197,002,095566,Kedlaya; Kiran S.,9997,0,9999,2
1657417588169,MATH 197,003,095567,Xiao; Ming,9999,0,9999,0
1657417588169,MATH 197,004,095571,Perols; Johan Lars,9998,0,9999,1
1657417595220,COGS 9,A01,083615,Shannon; Kyle Michael,9,0,75,66
1657417601247,COGS 11,A01,083617,Boyle; Mary E. T.,22,0,48,26
1657417607270,COGS 13,A01,083071,Bastos; Amalia Pinkusfeld,11,0,71,60
1657417613294,COGS 14A,A01,092681,Semenuks; Arturs,5,1,100,95
1657417619317,COGS 14B,A01,083073,Cheng; Tzu-Han,6,0,63,57
1657417625342,COGS 17,A01,092677,Semenuks; Arturs,6,0,81,75
1657417631368,COGS 100,A01,083619,Allen; Michael Gordon,17,0,70,53
1657417637391,COGS 101A,A01,083621,Davis; Joshua Daniel,9,0,68,59
1657417643413,COGS 101B,A01,091572,Allen; Michael Gordon,12,0,65,53
1657417649439,COGS 101C,A01,083625,Delgado; Tania,17,0,35,18
1657417655465,COGS 107A,A01,083627,Boyle; Mary E. T.,13,0,60,47
1657417661490,COGS 118A,A01,083075,Gupta; Anjum,21,0,76,55
1657417667513,CSE 3,A50,083646,Miranda; Gregory Joseph,24,0,50,26
1657417673536,CSE 8A,A50,083650,Miranda; Gregory Joseph,17,1,56,39
1657417679564,CSE 11,A01,083080,Cao; Yingjun,6,15,40,34
1657417685589,CSE 12,A01,083652,Krause-Levy; Sophia Louisa,28,1,120,92
1657417691615,CSE 15L,A01,083654,Morris; Justin Loren,9,0,50,41
1657417691615,CSE 15L,A02,083655,Morris; Justin Loren,9,0,50,41
1657417697641,CSE 20,A01,083657,Tran; Khoa Dang,39,0,80,41
1657417703666,CSE 21,A01,095574,Bach; Quang Tran,22,0,48,26
1657417709699,CSE 30,A01,083084,Eldon; John,4,0,80,76
1657417709699,CSE 30,B01,095061,Bhaskar; Nishant,9,0,50,41
1657417715725,CSE 100,A01,083659,Cao; Yingjun,5,4,70,65
1657417721747,CSE 134B,A01,083661,Powell; Thomas Allan,22,0,100,78
1657417727772,CSE 140,A01,083663,Gungor; Onat,14,0,85,71
1657417733796,CSE 140L,A01,083088,Eldon; John,21,0,100,79
1657417739817,CSE 175,A01,083665,Kumar; Rakesh,3,0,25,22
1657417745839,CSE 190,A00,092507,Dubnov; Shlomo,7,0,20,13
1657417751866,ECE 45,A01,083139,Congero; Spencer William,6,0,75,69
1657417757893,ECE 65,A50,083695,Saad; Andrew S,12,0,30,18
1657417757893,ECE 65,A51,095125,Saad; Andrew S,24,0,26,2
1657417763920,ECE 109,A01,091882,Touri; Behrouz,19,0,70,51
1657417769948,ECE 180,A00,083140,Abi Samra; Nicholas Camill,1,0,30,29
1657417769948,ECE 180,B00,083141,Abi Samra; Nicholas Camill,0,0,30,30
1657417775972,MATH 10A,A01,083735,Patchell; Gregory David,2,0,30,28
1657417775972,MATH 10A,A02,083736,Patchell; Gregory David,20,0,30,10
1657417775972,MATH 10A,A03,083737,Patchell; Gregory David,16,0,30,14
1657417782001,MATH 10B,A01,083207,Lim; Seonhee,8,0,34,26
1657417782001,MATH 10B,A02,083208,Lim; Seonhee,9,0,35,26
1657417782001,MATH 10B,A03,093472,Lim; Seonhee,7,0,34,27
1657417782001,MATH 10B,B01,083739,Sinha; Shubham,12,0,30,18
1657417788026,MATH 18,A01,083743,Cinel; Cameron Alexander,7,0,30,23
1657417788026,MATH 18,A02,083744,Cinel; Cameron Alexander,17,0,30,13
1657417788026,MATH 18,A03,083745,Cinel; Cameron Alexander,9,0,30,21
1657417788026,MATH 18,B01,083748,Rideout; David Porter,5,0,37,32
1657417788026,MATH 18,B02,083749,Rideout; David Porter,5,0,36,31
1657417788026,MATH 18,B03,083750,Rideout; David Porter,3,0,37,34
1657417788026,MATH 18,B04,083751,Rideout; David Porter,6,0,36,30
1657417788026,MATH 18,B05,093473,Rideout; David Porter,6,0,36,30
1657417788026,MATH 18,B06,093474,Rideout; David Porter,6,0,36,30
1657417794050,MATH 20A,A01,083754,Zheng; Zequn,14,0,40,26
1657417800082,MATH 20B,A01,083756,Briones; Jor-el Thomas Caparas,4,0,36,32
1657417800082,MATH 20B,A02,083757,Briones; Jor-el Thomas Caparas,1,0,36,35
1657417800082,MATH 20B,A03,093475,Briones; Jor-el Thomas Caparas,2,0,36,34
1657417806106,MATH 20C,A01,083760,Briones; Jor-el Thomas Caparas,1,0,35,34
1657417806106,MATH 20C,A02,083761,Briones; Jor-el Thomas Caparas,8,0,35,27
1657417806106,MATH 20C,A03,093476,Briones; Jor-el Thomas Caparas,0,1,36,36
1657417806106,MATH 20C,B01,083762,Bach; Quang Tran,1,0,30,29
1657417812128,MATH 20D,A01,083765,Tran; Brian Kha,5,0,30,25
1657417812128,MATH 20D,A02,083766,Tran; Brian Kha,5,0,30,25
1657417812128,MATH 20D,A03,083767,Tran; Brian Kha,5,0,30,25
1657417818151,MATH 20E,A01,083771,Ganguly; Soumya,9,0,32,23
1657417818151,MATH 20E,A02,083772,Ganguly; Soumya,6,0,32,26
1657417818151,MATH 20E,B01,083773,Ciotti; Benjamin,20,0,35,15
1657417818151,MATH 20E,B02,083774,Ciotti; Benjamin,17,0,35,18
1657417824176,MATH 103A,A01,083777,Greenfeld; Be'Eri,3,0,36,33
1657417824176,MATH 103A,A02,083778,Greenfeld; Be'Eri,5,0,36,31
1657417824176,MATH 103A,A03,093561,Greenfeld; Be'Eri,5,0,36,31
1657417824176,MATH 103A,B01,083779,Greenfeld; Be'Eri,7,0,36,29
1657417824176,MATH 103A,B02,083780,Greenfeld; Be'Eri,4,0,36,32
1657417824176,MATH 103A,B03,093562,Greenfeld; Be'Eri,3,0,36,33
1657417830202,MATH 105,A01,085443,Carter; Anne Toulson,15,0,35,20
1657417830202,MATH 105,A02,093477,Carter; Anne Toulson,20,0,35,15
1657417836226,MATH 109,A01,083213,Ganzberger; Geoffrey Michael,2,0,34,32
1657417836226,MATH 109,A02,083214,Ganzberger; Geoffrey Michael,4,0,34,30
1657417836226,MATH 109,A03,093478,Ganzberger; Geoffrey Michael,2,0,34,32
1657417836226,MATH 109,B01,083215,Ganzberger; Geoffrey Michael,1,0,32,31
1657417836226,MATH 109,B02,083216,Ganzberger; Geoffrey Michael,2,0,32,30
1657417836226,MATH 109,B03,093479,Ganzberger; Geoffrey Michael,8,0,32,24
1657417842251,MATH 142A,A01,083219,Chow; Bennett,7,0,32,25
1657417842251,MATH 142A,A02,083220,Chow; Bennett,10,0,32,22
1657417842251,MATH 142A,A03,093480,Chow; Bennett,8,0,32,24
1657417842251,MATH 142A,B03,093481,Chow; Bennett,8,0,32,24
1657417842251,MATH 142A,B04,093558,Chow; Bennett,13,0,32,19
1657417842251,MATH 142A,B05,093559,Chow; Bennett,6,0,32,26
1657417848274,MATH 193A,A01,083224,Rotar; Vladimir,8,0,34,26
1657417848274,MATH 193A,A02,083225,Rotar; Vladimir,9,0,34,25
1657417848274,MATH 193A,A03,083781,Rotar; Vladimir,5,0,34,29
1657417848274,MATH 193A,A04,083782,Rotar; Vladimir,10,0,34,24
1657417848274,MATH 193A,A05,093482,Rotar; Vladimir,10,0,34,24
1657417854298,MATH 197,001,091859,McAuley; Julian John,9999,0,9999,0
1657417854298,MATH 197,002,095566,Kedlaya; Kiran S.,9997,0,9999,2
1657417854298,MATH 197,003,095567,Xiao; Ming,9999,0,9999,0
1657417854298,MATH 197,004,095571,Perols; Johan Lars,9998,0,9999,1
1657417861361,COGS 9,A01,083615,Shannon; Kyle Michael,9,0,75,66
1657417867387,COGS 11,A01,083617,Boyle; Mary E. T.,22,0,48,26
1657417873412,COGS 13,A01,083071,Bastos; Amalia Pinkusfeld,11,0,71,60
1657417879439,COGS 14A,A01,092681,Semenuks; Arturs,5,1,100,95
1657417885461,COGS 14B,A01,083073,Cheng; Tzu-Han,6,0,63,57
1657417891485,COGS 17,A01,092677,Semenuks; Arturs,6,0,81,75
1657417897512,COGS 100,A01,083619,Allen; Michael Gordon,17,0,70,53
1657417903535,COGS 101A,A01,083621,Davis; Joshua Daniel,9,0,68,59
1657417909634,COGS 101B,A01,091572,Allen; Michael Gordon,12,0,65,53
1657417915664,COGS 101C,A01,083625,Delgado; Tania,17,0,35,18
1657417921704,COGS 107A,A01,083627,Boyle; Mary E. T.,13,0,60,47
1657417927726,COGS 118A,A01,083075,Gupta; Anjum,21,0,76,55
1657417933749,CSE 3,A50,083646,Miranda; Gregory Joseph,24,0,50,26
1657417939773,CSE 8A,A50,083650,Miranda; Gregory Joseph,17,1,56,39
1657417945796,CSE 11,A01,083080,Cao; Yingjun,6,15,40,34
1657417951818,CSE 12,A01,083652,Krause-Levy; Sophia Louisa,28,1,120,92
1657417957840,CSE 15L,A01,083654,Morris; Justin Loren,9,0,50,41
1657417957840,CSE 15L,A02,083655,Morris; Justin Loren,9,0,50,41
1657417963865,CSE 20,A01,083657,Tran; Khoa Dang,39,0,80,41
1657417969889,CSE 21,A01,095574,Bach; Quang Tran,22,0,48,26
1657417975914,CSE 30,A01,083084,Eldon; John,4,0,80,76
1657417975914,CSE 30,B01,095061,Bhaskar; Nishant,9,0,50,41
1657417981941,CSE 100,A01,083659,Cao; Yingjun,5,4,70,65
1657417987963,CSE 134B,A01,083661,Powell; Thomas Allan,22,0,100,78
1657417993993,CSE 140,A01,083663,Gungor; Onat,14,0,85,71
1657418000015,CSE 140L,A01,083088,Eldon; John,21,0,100,79
1657418006041,CSE 175,A01,083665,Kumar; Rakesh,3,0,25,22
1657418012072,CSE 190,A00,092507,Dubnov; Shlomo,7,0,20,13
1657418018096,ECE 45,A01,083139,Congero; Spencer William,6,0,75,69
1657418024123,ECE 65,A50,083695,Saad; Andrew S,12,0,30,18
1657418024123,ECE 65,A51,095125,Saad; Andrew S,24,0,26,2
1657418030145,ECE 109,A01,091882,Touri; Behrouz,19,0,70,51
1657418036168,ECE 180,A00,083140,Abi Samra; Nicholas Camill,1,0,30,29
1657418036168,ECE 180,B00,083141,Abi Samra; Nicholas Camill,0,0,30,30
1657418042192,MATH 10A,A01,083735,Patchell; Gregory David,2,0,30,28
1657418042192,MATH 10A,A02,083736,Patchell; Gregory David,20,0,30,10
1657418042192,MATH 10A,A03,083737,Patchell; Gregory David,16,0,30,14
1657418048214,MATH 10B,A01,083207,Lim; Seonhee,8,0,34,26
1657418048214,MATH 10B,A02,083208,Lim; Seonhee,9,0,35,26
1657418048214,MATH 10B,A03,093472,Lim; Seonhee,7,0,34,27
1657418048214,MATH 10B,B01,083739,Sinha; Shubham,12,0,30,18
1657418054239,MATH 18,A01,083743,Cinel; Cameron Alexander,7,0,30,23
1657418054239,MATH 18,A02,083744,Cinel; Cameron Alexander,17,0,30,13
1657418054239,MATH 18,A03,083745,Cinel; Cameron Alexander,9,0,30,21
1657418054239,MATH 18,B01,083748,Rideout; David Porter,5,0,37,32
1657418054239,MATH 18,B02,083749,Rideout; David Porter,5,0,36,31
1657418054239,MATH 18,B03,083750,Rideout; David Porter,3,0,37,34
1657418054239,MATH 18,B04,083751,Rideout; David Porter,6,0,36,30
1657418054239,MATH 18,B05,093473,Rideout; David Porter,6,0,36,30
1657418054239,MATH 18,B06,093474,Rideout; David Porter,6,0,36,30
1657418060274,MATH 20A,A01,083754,Zheng; Zequn,14,0,40,26
1657418066307,MATH 20B,A01,083756,Briones; Jor-el Thomas Caparas,4,0,36,32
1657418066307,MATH 20B,A02,083757,Briones; Jor-el Thomas Caparas,1,0,36,35
1657418066307,MATH 20B,A03,093475,Briones; Jor-el Thomas Caparas,2,0,36,34
1657418072329,MATH 20C,A01,083760,Briones; Jor-el Thomas Caparas,1,0,35,34
1657418072329,MATH 20C,A02,083761,Briones; Jor-el Thomas Caparas,8,0,35,27
1657418072329,MATH 20C,A03,093476,Briones; Jor-el Thomas Caparas,0,1,36,36
1657418072329,MATH 20C,B01,083762,Bach; Quang Tran,1,0,30,29
1657418078352,MATH 20D,A01,083765,Tran; Brian Kha,5,0,30,25
1657418078352,MATH 20D,A02,083766,Tran; Brian Kha,5,0,30,25
1657418078352,MATH 20D,A03,083767,Tran; Brian Kha,5,0,30,25
1657418084381,MATH 20E,A01,083771,Ganguly; Soumya,9,0,32,23
1657418084381,MATH 20E,A02,083772,Ganguly; Soumya,6,0,32,26
1657418084381,MATH 20E,B01,083773,Ciotti; Benjamin,20,0,35,15
1657418084381,MATH 20E,B02,083774,Ciotti; Benjamin,17,0,35,18
1657418090406,MATH 103A,A01,083777,Greenfeld; Be'Eri,3,0,36,33
1657418090406,MATH 103A,A02,083778,Greenfeld; Be'Eri,5,0,36,31
1657418090406,MATH 103A,A03,093561,Greenfeld; Be'Eri,5,0,36,31
1657418090406,MATH 103A,B01,083779,Greenfeld; Be'Eri,7,0,36,29
1657418090406,MATH 103A,B02,083780,Greenfeld; Be'Eri,4,0,36,32
1657418090406,MATH 103A,B03,093562,Greenfeld; Be'Eri,3,0,36,33
1657418096428,MATH 105,A01,085443,Carter; Anne Toulson,15,0,35,20
1657418096428,MATH 105,A02,093477,Carter; Anne Toulson,20,0,35,15
1657418102451,MATH 109,A01,083213,Ganzberger; Geoffrey Michael,2,0,34,32
1657418102451,MATH 109,A02,083214,Ganzberger; Geoffrey Michael,4,0,34,30
1657418102451,MATH 109,A03,093478,Ganzberger; Geoffrey Michael,2,0,34,32
1657418102451,MATH 109,B01,083215,Ganzberger; Geoffrey Michael,1,0,32,31
1657418102451,MATH 109,B02,083216,Ganzberger; Geoffrey Michael,2,0,32,30
1657418102451,MATH 109,B03,093479,Ganzberger; Geoffrey Michael,8,0,32,24
1657418108482,MATH 142A,A01,083219,Chow; Bennett,7,0,32,25
1657418108482,MATH 142A,A02,083220,Chow; Bennett,10,0,32,22
1657418108482,MATH 142A,A03,093480,Chow; Bennett,8,0,32,24
1657418108482,MATH 142A,B03,093481,Chow; Bennett,8,0,32,24
1657418108482,MATH 142A,B04,093558,Chow; Bennett,13,0,32,19
1657418108482,MATH 142A,B05,093559,Chow; Bennett,6,0,32,26
1657418114505,MATH 193A,A01,083224,Rotar; Vladimir,8,0,34,26
1657418114505,MATH 193A,A02,083225,Rotar; Vladimir,9,0,34,25
1657418114505,MATH 193A,A03,083781,Rotar; Vladimir,5,0,34,29
1657418114505,MATH 193A,A04,083782,Rotar; Vladimir,10,0,34,24
1657418114505,MATH 193A,A05,093482,Rotar; Vladimir,10,0,34,24
1657418120527,MATH 197,001,091859,McAuley; Julian John,9999,0,9999,0
1657418120527,MATH 197,002,095566,Kedlaya; Kiran S.,9997,0,9999,2
1657418120527,MATH 197,003,095567,Xiao; Ming,9999,0,9999,0
1657418120527,MATH 197,004,095571,Perols; Johan Lars,9998,0,9999,1
1657418127585,COGS 9,A01,083615,Shannon; Kyle Michael,9,0,75,66
1657418133611,COGS 11,A01,083617,Boyle; Mary E. T.,22,0,48,26
1657418139638,COGS 13,A01,083071,Bastos; Amalia Pinkusfeld,11,0,71,60
1657418145664,COGS 14A,A01,092681,Semenuks; Arturs,5,1,100,95
1657418151691,COGS 14B,A01,083073,Cheng; Tzu-Han,6,0,63,57
1657418157719,COGS 17,A01,092677,Semenuks; Arturs,6,0,81,75
1657418163744,COGS 100,A01,083619,Allen; Michael Gordon,17,0,70,53
1657418169767,COGS 101A,A01,083621,Davis; Joshua Daniel,9,0,68,59
1657418175789,COGS 101B,A01,091572,Allen; Michael Gordon,12,0,65,53
1657418181815,COGS 101C,A01,083625,Delgado; Tania,17,0,35,18
1657418187838,COGS 107A,A01,083627,Boyle; Mary E. T.,13,0,60,47
1657418193862,COGS 118A,A01,083075,Gupta; Anjum,21,0,76,55
1657418199888,CSE 3,A50,083646,Miranda; Gregory Joseph,24,0,50,26
1657418205910,CSE 8A,A50,083650,Miranda; Gregory Joseph,17,1,56,39
1657418211932,CSE 11,A01,083080,Cao; Yingjun,6,15,40,34
1657418217959,CSE 12,A01,083652,Krause-Levy; Sophia Louisa,28,1,120,92
1657418223982,CSE 15L,A01,083654,Morris; Justin Loren,9,0,50,41
1657418223982,CSE 15L,A02,083655,Morris; Justin Loren,9,0,50,41
1657418230005,CSE 20,A01,083657,Tran; Khoa Dang,39,0,80,41
1657418236032,CSE 21,A01,095574,Bach; Quang Tran,22,0,48,26
1657418242056,CSE 30,A01,083084,Eldon; John,4,0,80,76
1657418242056,CSE 30,B01,095061,Bhaskar; Nishant,9,0,50,41
1657418248080,CSE 100,A01,083659,Cao; Yingjun,5,4,70,65
1657418254103,CSE 134B,A01,083661,Powell; Thomas Allan,22,0,100,78
1657418260126,CSE 140,A01,083663,Gungor; Onat,14,0,85,71
1657418266149,CSE 140L,A01,083088,Eldon; John,21,0,100,79
1657418272175,CSE 175,A01,083665,Kumar; Rakesh,3,0,25,22
1657418278199,CSE 190,A00,092507,Dubnov; Shlomo,7,0,20,13
1657418284226,ECE 45,A01,083139,Congero; Spencer William,6,0,75,69
1657418290253,ECE 65,A50,083695,Saad; Andrew S,12,0,30,18
1657418290253,ECE 65,A51,095125,Saad; Andrew S,24,0,26,2
1657418296275,ECE 109,A01,091882,Touri; Behrouz,19,0,70,51
1657418302298,ECE 180,A00,083140,Abi Samra; Nicholas Camill,1,0,30,29
1657418302298,ECE 180,B00,083141,Abi Samra; Nicholas Camill,0,0,30,30
1657418308328,MATH 10A,A01,083735,Patchell; Gregory David,2,0,30,28
1657418308328,MATH 10A,A02,083736,Patchell; Gregory David,20,0,30,10
1657418308328,MATH 10A,A03,083737,Patchell; Gregory David,16,0,30,14
1657418314357,MATH 10B,A01,083207,Lim; Seonhee,8,0,34,26
1657418314357,MATH 10B,A02,083208,Lim; Seonhee,9,0,35,26
1657418314357,MATH 10B,A03,093472,Lim; Seonhee,7,0,34,27
1657418314357,MATH 10B,B01,083739,Sinha; Shubham,12,0,30,18
1657418320385,MATH 18,A01,083743,Cinel; Cameron Alexander,7,0,30,23
1657418320385,MATH 18,A02,083744,Cinel; Cameron Alexander,17,0,30,13
1657418320385,MATH 18,A03,083745,Cinel; Cameron Alexander,9,0,30,21
1657418320385,MATH 18,B01,083748,Rideout; David Porter,5,0,37,32
1657418320385,MATH 18,B02,083749,Rideout; David Porter,5,0,36,31
1657418320385,MATH 18,B03,083750,Rideout; David Porter,3,0,37,34
1657418320385,MATH 18,B04,083751,Rideout; David Porter,6,0,36,30
1657418320385,MATH 18,B05,093473,Rideout; David Porter,6,0,36,30
1657418320385,MATH 18,B06,093474,Rideout; David Porter,6,0,36,30
1657418326408,MATH 20A,A01,083754,Zheng; Zequn,14,0,40,26
1657418332435,MATH 20B,A01,083756,Briones; Jor-el Thomas Caparas,4,0,36,32
1657418332435,MATH 20B,A02,083757,Briones; Jor-el Thomas Caparas,1,0,36,35
1657418332435,MATH 20B,A03,093475,Briones; Jor-el Thomas Caparas,2,0,36,34
1657418338457,MATH 20C,A01,083760,Briones; Jor-el Thomas Caparas,1,0,35,34
1657418338457,MATH 20C,A02,083761,Briones; Jor-el Thomas Caparas,8,0,35,27
1657418338457,MATH 20C,A03,093476,Briones; Jor-el Thomas Caparas,0,1,36,36
1657418338457,MATH 20C,B01,083762,Bach; Quang Tran,1,0,30,29
1657418344487,MATH 20D,A01,083765,Tran; Brian Kha,5,0,30,25
1657418344487,MATH 20D,A02,083766,Tran; Brian Kha,5,0,30,25
1657418344487,MATH 20D,A03,083767,Tran; Brian Kha,5,0,30,25
1657418350521,MATH 20E,A01,083771,Ganguly; Soumya,9,0,32,23
1657418350521,MATH 20E,A02,083772,Ganguly; Soumya,6,0,32,26
1657418350521,MATH 20E,B01,083773,Ciotti; Benjamin,20,0,35,15
1657418350521,MATH 20E,B02,083774,Ciotti; Benjamin,17,0,35,18
1657418356545,MATH 103A,A01,083777,Greenfeld; Be'Eri,3,0,36,33
1657418356545,MATH 103A,A02,083778,Greenfeld; Be'Eri,5,0,36,31
1657418356545,MATH 103A,A03,093561,Greenfeld; Be'Eri,5,0,36,31
1657418356545,MATH 103A,B01,083779,Greenfeld; Be'Eri,7,0,36,29
1657418356545,MATH 103A,B02,083780,Greenfeld; Be'Eri,4,0,36,32
1657418356545,MATH 103A,B03,093562,Greenfeld; Be'Eri,3,0,36,33
1657418362566,MATH 105,A01,085443,Carter; Anne Toulson,15,0,35,20
1657418362566,MATH 105,A02,093477,Carter; Anne Toulson,20,0,35,15
1657418368595,MATH 109,A01,083213,Ganzberger; Geoffrey Michael,2,0,34,32
1657418368595,MATH 109,A02,083214,Ganzberger; Geoffrey Michael,4,0,34,30
1657418368595,MATH 109,A03,093478,Ganzberger; Geoffrey Michael,2,0,34,32
1657418368595,MATH 109,B01,083215,Ganzberger; Geoffrey Michael,1,0,32,31
1657418368595,MATH 109,B02,083216,Ganzberger; Geoffrey Michael,2,0,32,30
1657418368595,MATH 109,B03,093479,Ganzberger; Geoffrey Michael,8,0,32,24
1657418374619,MATH 142A,A01,083219,Chow; Bennett,7,0,32,25
1657418374619,MATH 142A,A02,083220,Chow; Bennett,10,0,32,22
1657418374619,MATH 142A,A03,093480,Chow; Bennett,8,0,32,24
1657418374619,MATH 142A,B03,093481,Chow; Bennett,8,0,32,24
1657418374619,MATH 142A,B04,093558,Chow; Bennett,13,0,32,19
1657418374619,MATH 142A,B05,093559,Chow; Bennett,6,0,32,26
1657418380643,MATH 193A,A01,083224,Rotar; Vladimir,8,0,34,26
1657418380643,MATH 193A,A02,083225,Rotar; Vladimir,9,0,34,25
1657418380643,MATH 193A,A03,083781,Rotar; Vladimir,5,0,34,29
1657418380643,MATH 193A,A04,083782,Rotar; Vladimir,10,0,34,24
1657418380643,MATH 193A,A05,093482,Rotar; Vladimir,10,0,34,24
1657418386670,MATH 197,001,091859,McAuley; Julian John,9999,0,9999,0
1657418386670,MATH 197,002,095566,Kedlaya; Kiran S.,9997,0,9999,2
1657418386670,MATH 197,003,095567,Xiao; Ming,9999,0,9999,0
1657418386670,MATH 197,004,095571,Perols; Johan Lars,9998,0,9999,1
1657418393733,COGS 9,A01,083615,Shannon; Kyle Michael,9,0,75,66
1657418399755,COGS 11,A01,083617,Boyle; Mary E. T.,22,0,48,26
1657418405779,COGS 13,A01,083071,Bastos; Amalia Pinkusfeld,11,0,71,60
1657418411804,COGS 14A,A01,092681,Semenuks; Arturs,5,1,100,95
1657418417831,COGS 14B,A01,083073,Cheng; Tzu-Han,6,0,63,57
1657418423853,COGS 17,A01,092677,Semenuks; Arturs,6,0,81,75
1657418429876,COGS 100,A01,083619,Allen; Michael Gordon,17,0,70,53
1657418435903,COGS 101A,A01,083621,Davis; Joshua Daniel,9,0,68,59
1657418441929,COGS 101B,A01,091572,Allen; Michael Gordon,12,0,65,53
1657418447962,COGS 101C,A01,083625,Delgado; Tania,17,0,35,18
1657418453985,COGS 107A,A01,083627,Boyle; Mary E. T.,13,0,60,47
1657418460010,COGS 118A,A01,083075,Gupta; Anjum,21,0,76,55
1657418466039,CSE 3,A50,083646,Miranda; Gregory Joseph,24,0,50,26
1657418472063,CSE 8A,A50,083650,Miranda; Gregory Joseph,17,1,56,39
1657418478099,CSE 11,A01,083080,Cao; Yingjun,6,15,40,34
1657418484129,CSE 12,A01,083652,Krause-Levy; Sophia Louisa,28,1,120,92
1657418490156,CSE 15L,A01,083654,Morris; Justin Loren,9,0,50,41
1657418490156,CSE 15L,A02,083655,Morris; Justin Loren,9,0,50,41
1657418496178,CSE 20,A01,083657,Tran; Khoa Dang,39,0,80,41
1657418502200,CSE 21,A01,095574,Bach; Quang Tran,22,0,48,26
1657418508295,CSE 30,A01,083084,Eldon; John,4,0,80,76
1657418508295,CSE 30,B01,095061,Bhaskar; Nishant,9,0,50,41
1657418514321,CSE 100,A01,083659,Cao; Yingjun,5,4,70,65
1657418520346,CSE 134B,A01,083661,Powell; Thomas Allan,22,0,100,78
1657418526369,CSE 140,A01,083663,Gungor; Onat,14,0,85,71
1657418532392,CSE 140L,A01,083088,Eldon; John,21,0,100,79
1657418538415,CSE 175,A01,083665,Kumar; Rakesh,3,0,25,22
1657418544441,CSE 190,A00,092507,Dubnov; Shlomo,7,0,20,13
1657418550465,ECE 45,A01,083139,Congero; Spencer William,6,0,75,69
1657418556493,ECE 65,A50,083695,Saad; Andrew S,12,0,30,18
1657418556493,ECE 65,A51,095125,Saad; Andrew S,24,0,26,2
1657418562519,ECE 109,A01,091882,Touri; Behrouz,19,0,70,51
1657418568543,ECE 180,A00,083140,Abi Samra; Nicholas Camill,1,0,30,29
1657418568543,ECE 180,B00,083141,Abi Samra; Nicholas Camill,0,0,30,30
1657418574571,MATH 10A,A01,083735,Patchell; Gregory David,2,0,30,28
1657418574571,MATH 10A,A02,083736,Patchell; Gregory David,20,0,30,10
1657418574571,MATH 10A,A03,083737,Patchell; Gregory David,16,0,30,14
1657418580594,MATH 10B,A01,083207,Lim; Seonhee,8,0,34,26
1657418580594,MATH 10B,A02,083208,Lim; Seonhee,9,0,35,26
1657418580594,MATH 10B,A03,093472,Lim; Seonhee,7,0,34,27
1657418580594,MATH 10B,B01,083739,Sinha; Shubham,12,0,30,18
1657418586626,MATH 18,A01,083743,Cinel; Cameron Alexander,7,0,30,23
1657418586626,MATH 18,A02,083744,Cinel; Cameron Alexander,17,0,30,13
1657418586626,MATH 18,A03,083745,Cinel; Cameron Alexander,9,0,30,21
1657418586626,MATH 18,B01,083748,Rideout; David Porter,5,0,37,32
1657418586626,MATH 18,B02,083749,Rideout; David Porter,5,0,36,31
1657418586626,MATH 18,B03,083750,Rideout; David Porter,3,0,37,34
1657418586626,MATH 18,B04,083751,Rideout; David Porter,6,0,36,30
1657418586626,MATH 18,B05,093473,Rideout; David Porter,6,0,36,30
1657418586626,MATH 18,B06,093474,Rideout; David Porter,6,0,36,30
1657418592649,MATH 20A,A01,083754,Zheng; Zequn,14,0,40,26
1657418598675,MATH 20B,A01,083756,Briones; Jor-el Thomas Caparas,4,0,36,32
1657418598675,MATH 20B,A02,083757,Briones; Jor-el Thomas Caparas,1,0,36,35
1657418598675,MATH 20B,A03,093475,Briones; Jor-el Thomas Caparas,2,0,36,34
1657418604700,MATH 20C,A01,083760,Briones; Jor-el Thomas Caparas,1,0,35,34
1657418604700,MATH 20C,A02,083761,Briones; Jor-el Thomas Caparas,8,0,35,27
1657418604700,MATH 20C,A03,093476,Briones; Jor-el Thomas Caparas,0,1,36,36
1657418604700,MATH 20C,B01,083762,Bach; Quang Tran,1,0,30,29
1657418610725,MATH 20D,A01,083765,Tran; Brian Kha,5,0,30,25
1657418610725,MATH 20D,A02,083766,Tran; Brian Kha,5,0,30,25
1657418610725,MATH 20D,A03,083767,Tran; Brian Kha,5,0,30,25
1657418616754,MATH 20E,A01,083771,Ganguly; Soumya,9,0,32,23
1657418616754,MATH 20E,A02,083772,Ganguly; Soumya,6,0,32,26
1657418616754,MATH 20E,B01,083773,Ciotti; Benjamin,20,0,35,15
1657418616754,MATH 20E,B02,083774,Ciotti; Benjamin,17,0,35,18
1657418622779,MATH 103A,A01,083777,Greenfeld; Be'Eri,3,0,36,33
1657418622779,MATH 103A,A02,083778,Greenfeld; Be'Eri,5,0,36,31
1657418622779,MATH 103A,A03,093561,Greenfeld; Be'Eri,5,0,36,31
1657418622779,MATH 103A,B01,083779,Greenfeld; Be'Eri,7,0,36,29
1657418622779,MATH 103A,B02,083780,Greenfeld; Be'Eri,4,0,36,32
1657418622779,MATH 103A,B03,093562,Greenfeld; Be'Eri,3,0,36,33
1657418628803,MATH 105,A01,085443,Carter; Anne Toulson,15,0,35,20
1657418628803,MATH 105,A02,093477,Carter; Anne Toulson,20,0,35,15
1657418634826,MATH 109,A01,083213,Ganzberger; Geoffrey Michael,2,0,34,32
1657418634826,MATH 109,A02,083214,Ganzberger; Geoffrey Michael,4,0,34,30
1657418634826,MATH 109,A03,093478,Ganzberger; Geoffrey Michael,2,0,34,32
1657418634826,MATH 109,B01,083215,Ganzberger; Geoffrey Michael,1,0,32,31
1657418634826,MATH 109,B02,083216,Ganzberger; Geoffrey Michael,2,0,32,30
1657418634826,MATH 109,B03,093479,Ganzberger; Geoffrey Michael,8,0,32,24
1657418640850,MATH 142A,A01,083219,Chow; Bennett,7,0,32,25
1657418640850,MATH 142A,A02,083220,Chow; Bennett,10,0,32,22
1657418640850,MATH 142A,A03,093480,Chow; Bennett,8,0,32,24
1657418640850,MATH 142A,B03,093481,Chow; Bennett,8,0,32,24
1657418640850,MATH 142A,B04,093558,Chow; Bennett,13,0,32,19
1657418640850,MATH 142A,B05,093559,Chow; Bennett,6,0,32,26
1657418646877,MATH 193A,A01,083224,Rotar; Vladimir,8,0,34,26
1657418646877,MATH 193A,A02,083225,Rotar; Vladimir,9,0,34,25
1657418646877,MATH 193A,A03,083781,Rotar; Vladimir,5,0,34,29
1657418646877,MATH 193A,A04,083782,Rotar; Vladimir,10,0,34,24
1657418646877,MATH 193A,A05,093482,Rotar; Vladimir,10,0,34,24
1657418652899,MATH 197,001,091859,McAuley; Julian John,9999,0,9999,0
1657418652899,MATH 197,002,095566,Kedlaya; Kiran S.,9997,0,9999,2
1657418652899,MATH 197,003,095567,Xiao; Ming,9999,0,9999,0
1657418652899,MATH 197,004,095571,Perols; Johan Lars,9998,0,9999,1
1657418659970,COGS 9,A01,083615,Shannon; Kyle Michael,9,0,75,66
1657418665994,COGS 11,A01,083617,Boyle; Mary E. T.,22,0,48,26
1657418672017,COGS 13,A01,083071,Bastos; Amalia Pinkusfeld,11,0,71,60
1657418678042,COGS 14A,A01,092681,Semenuks; Arturs,5,1,100,95
1657418684066,COGS 14B,A01,083073,Cheng; Tzu-Han,6,0,63,57
1657418690092,COGS 17,A01,092677,Semenuks; Arturs,6,0,81,75
1657418696115,COGS 100,A01,083619,Allen; Michael Gordon,17,0,70,53
1657418702138,COGS 101A,A01,083621,Davis; Joshua Daniel,9,0,68,59
1657418708161,COGS 101B,A01,091572,Allen; Michael Gordon,12,0,65,53
1657418714184,COGS 101C,A01,083625,Delgado; Tania,17,0,35,18
1657418720208,COGS 107A,A01,083627,Boyle; Mary E. T.,13,0,60,47
1657418726231,COGS 118A,A01,083075,Gupta; Anjum,21,0,76,55
1657418732254,CSE 3,A50,083646,Miranda; Gregory Joseph,24,0,50,26
1657418738280,CSE 8A,A50,083650,Miranda; Gregory Joseph,17,1,56,39
1657418744304,CSE 11,A01,083080,Cao; Yingjun,6,15,40,34
1657418750325,CSE 12,A01,083652,Krause-Levy; Sophia Louisa,28,1,120,92
1657418756351,CSE 15L,A01,083654,Morris; Justin Loren,9,0,50,41
1657418756351,CSE 15L,A02,083655,Morris; Justin Loren,9,0,50,41
1657418762375,CSE 20,A01,083657,Tran; Khoa Dang,39,0,80,41
1657418768403,CSE 21,A01,095574,Bach; Quang Tran,22,0,48,26
1657418774427,CSE 30,A01,083084,Eldon; John,4,0,80,76
1657418774427,CSE 30,B01,095061,Bhaskar; Nishant,9,0,50,41
1657418780454,CSE 100,A01,083659,Cao; Yingjun,5,4,70,65
1657418786481,CSE 134B,A01,083661,Powell; Thomas Allan,22,0,100,78
1657418792505,CSE 140,A01,083663,Gungor; Onat,14,0,85,71
1657418798527,CSE 140L,A01,083088,Eldon; John,21,0,100,79
1657418804552,CSE 175,A01,083665,Kumar; Rakesh,3,0,25,22
1657418810577,CSE 190,A00,092507,Dubnov; Shlomo,7,0,20,13
1657418816602,ECE 45,A01,083139,Congero; Spencer William,6,0,75,69
1657418822630,ECE 65,A50,083695,Saad; Andrew S,12,0,30,18
1657418822630,ECE 65,A51,095125,Saad; Andrew S,24,0,26,2
1657418828657,ECE 109,A01,091882,Touri; Behrouz,19,0,70,51
1657418834679,ECE 180,A00,083140,Abi Samra; Nicholas Camill,1,0,30,29
1657418834679,ECE 180,B00,083141,Abi Samra; Nicholas Camill,0,0,30,30
1657418840712,MATH 10A,A01,083735,Patchell; Gregory David,2,0,30,28
1657418840712,MATH 10A,A02,083736,Patchell; Gregory David,20,0,30,10
1657418840712,MATH 10A,A03,083737,Patchell; Gregory David,16,0,30,14
1657418846736,MATH 10B,A01,083207,Lim; Seonhee,8,0,34,26
1657418846736,MATH 10B,A02,083208,Lim; Seonhee,9,0,35,26
1657418846736,MATH 10B,A03,093472,Lim; Seonhee,7,0,34,27
1657418846736,MATH 10B,B01,083739,Sinha; Shubham,12,0,30,18
1657418852761,MATH 18,A01,083743,Cinel; Cameron Alexander,7,0,30,23
1657418852761,MATH 18,A02,083744,Cinel; Cameron Alexander,17,0,30,13
1657418852761,MATH 18,A03,083745,Cinel; Cameron Alexander,9,0,30,21
1657418852761,MATH 18,B01,083748,Rideout; David Porter,5,0,37,32
1657418852761,MATH 18,B02,083749,Rideout; David Porter,5,0,36,31
1657418852761,MATH 18,B03,083750,Rideout; David Porter,3,0,37,34
1657418852761,MATH 18,B04,083751,Rideout; David Porter,6,0,36,30
1657418852761,MATH 18,B05,093473,Rideout; David Porter,6,0,36,30
1657418852761,MATH 18,B06,093474,Rideout; David Porter,6,0,36,30
1657418858788,MATH 20A,A01,083754,Zheng; Zequn,14,0,40,26
1657418864823,MATH 20B,A01,083756,Briones; Jor-el Thomas Caparas,4,0,36,32
1657418864823,MATH 20B,A02,083757,Briones; Jor-el Thomas Caparas,1,0,36,35
1657418864823,MATH 20B,A03,093475,Briones; Jor-el Thomas Caparas,2,0,36,34
1657418870847,MATH 20C,A01,083760,Briones; Jor-el Thomas Caparas,1,0,35,34
1657418870847,MATH 20C,A02,083761,Briones; Jor-el Thomas Caparas,8,0,35,27
1657418870847,MATH 20C,A03,093476,Briones; Jor-el Thomas Caparas,0,1,36,36
1657418870847,MATH 20C,B01,083762,Bach; Quang Tran,1,0,30,29
1657418876876,MATH 20D,A01,083765,Tran; Brian Kha,5,0,30,25
1657418876876,MATH 20D,A02,083766,Tran; Brian Kha,5,0,30,25
1657418876876,MATH 20D,A03,083767,Tran; Brian Kha,5,0,30,25
1657418882911,MATH 20E,A01,083771,Ganguly; Soumya,9,0,32,23
1657418882911,MATH 20E,A02,083772,Ganguly; Soumya,6,0,32,26
1657418882911,MATH 20E,B01,083773,Ciotti; Benjamin,20,0,35,15
1657418882911,MATH 20E,B02,083774,Ciotti; Benjamin,17,0,35,18
1657418888935,MATH 103A,A01,083777,Greenfeld; Be'Eri,3,0,36,33
1657418888935,MATH 103A,A02,083778,Greenfeld; Be'Eri,5,0,36,31
1657418888935,MATH 103A,A03,093561,Greenfeld; Be'Eri,5,0,36,31
1657418888935,MATH 103A,B01,083779,Greenfeld; Be'Eri,7,0,36,29
1657418888935,MATH 103A,B02,083780,Greenfeld; Be'Eri,4,0,36,32
1657418888935,MATH 103A,B03,093562,Greenfeld; Be'Eri,3,0,36,33
1657418894962,MATH 105,A01,085443,Carter; Anne Toulson,15,0,35,20
1657418894962,MATH 105,A02,093477,Carter; Anne Toulson,20,0,35,15
1657418900990,MATH 109,A01,083213,Ganzberger; Geoffrey Michael,2,0,34,32
1657418900990,MATH 109,A02,083214,Ganzberger; Geoffrey Michael,4,0,34,30
1657418900990,MATH 109,A03,093478,Ganzberger; Geoffrey Michael,2,0,34,32
1657418900990,MATH 109,B01,083215,Ganzberger; Geoffrey Michael,1,0,32,31
1657418900990,MATH 109,B02,083216,Ganzberger; Geoffrey Michael,2,0,32,30
1657418900990,MATH 109,B03,093479,Ganzberger; Geoffrey Michael,8,0,32,24
1657418907019,MATH 142A,A01,083219,Chow; Bennett,7,0,32,25
1657418907019,MATH 142A,A02,083220,Chow; Bennett,10,0,32,22
1657418907019,MATH 142A,A03,093480,Chow; Bennett,8,0,32,24
1657418907019,MATH 142A,B03,093481,Chow; Bennett,8,0,32,24
1657418907019,MATH 142A,B04,093558,Chow; Bennett,13,0,32,19
1657418907019,MATH 142A,B05,093559,Chow; Bennett,6,0,32,26
1657418913048,MATH 193A,A01,083224,Rotar; Vladimir,8,0,34,26
1657418913048,MATH 193A,A02,083225,Rotar; Vladimir,9,0,34,25
1657418913048,MATH 193A,A03,083781,Rotar; Vladimir,5,0,34,29
1657418913048,MATH 193A,A04,083782,Rotar; Vladimir,10,0,34,24
1657418913048,MATH 193A,A05,093482,Rotar; Vladimir,10,0,34,24
1657418919083,MATH 197,001,091859,McAuley; Julian John,9999,0,9999,0
1657418919083,MATH 197,002,095566,Kedlaya; Kiran S.,9997,0,9999,2
1657418919083,MATH 197,003,095567,Xiao; Ming,9999,0,9999,0
1657418919083,MATH 197,004,095571,Perols; Johan Lars,9998,0,9999,1
1657418926142,COGS 9,A01,083615,Shannon; Kyle Michael,9,0,75,66
1657418932165,COGS 11,A01,083617,Boyle; Mary E. T.,22,0,48,26
1657418938189,COGS 13,A01,083071,Bastos; Amalia Pinkusfeld,11,0,71,60
1657418944212,COGS 14A,A01,092681,Semenuks; Arturs,5,1,100,95
1657418950238,COGS 14B,A01,083073,Cheng; Tzu-Han,6,0,63,57
1657418956265,COGS 17,A01,092677,Semenuks; Arturs,6,0,81,75
1657418962291,COGS 100,A01,083619,Allen; Michael Gordon,17,0,70,53
1657418968343,COGS 101A,A01,083621,Davis; Joshua Daniel,9,0,68,59
1657418974366,COGS 101B,A01,091572,Allen; Michael Gordon,12,0,65,53
1657418980390,COGS 101C,A01,083625,Delgado; Tania,17,0,35,18
1657418986418,COGS 107A,A01,083627,Boyle; Mary E. T.,13,0,60,47
1657418992445,COGS 118A,A01,083075,Gupta; Anjum,21,0,76,55
1657418998473,CSE 3,A50,083646,Miranda; Gregory Joseph,24,0,50,26
1657419004499,CSE 8A,A50,083650,Miranda; Gregory Joseph,17,1,56,39
1657419010521,CSE 11,A01,083080,Cao; Yingjun,6,15,40,34
1657419016543,CSE 12,A01,083652,Krause-Levy; Sophia Louisa,28,1,120,92
1657419022570,CSE 15L,A01,083654,Morris; Justin Loren,9,0,50,41
1657419022570,CSE 15L,A02,083655,Morris; Justin Loren,9,0,50,41
1657419028598,CSE 20,A01,083657,Tran; Khoa Dang,39,0,80,41
1657419034624,CSE 21,A01,095574,Bach; Quang Tran,22,0,48,26
1657419040647,CSE 30,A01,083084,Eldon; John,4,0,80,76
1657419040647,CSE 30,B01,095061,Bhaskar; Nishant,9,0,50,41
1657419046670,CSE 100,A01,083659,Cao; Yingjun,5,4,70,65
1657419052693,CSE 134B,A01,083661,Powell; Thomas Allan,22,0,100,78
1657419058719,CSE 140,A01,083663,Gungor; Onat,14,0,85,71
1657419064743,CSE 140L,A01,083088,Eldon; John,21,0,100,79
1657419070768,CSE 175,A01,083665,Kumar; Rakesh,3,0,25,22
1657419076790,CSE 190,A00,092507,Dubnov; Shlomo,7,0,20,13
1657419082813,ECE 45,A01,083139,Congero; Spencer William,6,0,75,69
1657419088839,ECE 65,A50,083695,Saad; Andrew S,12,0,30,18
1657419088839,ECE 65,A51,095125,Saad; Andrew S,24,0,26,2
1657419094868,ECE 109,A01,091882,Touri; Behrouz,19,0,70,51
1657419100895,ECE 180,A00,083140,Abi Samra; Nicholas Camill,1,0,30,29
1657419100895,ECE 180,B00,083141,Abi Samra; Nicholas Camill,0,0,30,30
1657419107009,MATH 10A,A01,083735,Patchell; Gregory David,2,0,30,28
1657419107009,MATH 10A,A02,083736,Patchell; Gregory David,20,0,30,10
1657419107009,MATH 10A,A03,083737,Patchell; Gregory David,16,0,30,14
1657419113038,MATH 10B,A01,083207,Lim; Seonhee,8,0,34,26
1657419113038,MATH 10B,A02,083208,Lim; Seonhee,9,0,35,26
1657419113038,MATH 10B,A03,093472,Lim; Seonhee,7,0,34,27
1657419113038,MATH 10B,B01,083739,Sinha; Shubham,12,0,30,18
1657419119062,MATH 18,A01,083743,Cinel; Cameron Alexander,7,0,30,23
1657419119062,MATH 18,A02,083744,Cinel; Cameron Alexander,17,0,30,13
1657419119062,MATH 18,A03,083745,Cinel; Cameron Alexander,9,0,30,21
1657419119062,MATH 18,B01,083748,Rideout; David Porter,5,0,37,32
1657419119062,MATH 18,B02,083749,Rideout; David Porter,5,0,36,31
1657419119062,MATH 18,B03,083750,Rideout; David Porter,3,0,37,34
1657419119062,MATH 18,B04,083751,Rideout; David Porter,6,0,36,30
1657419119062,MATH 18,B05,093473,Rideout; David Porter,6,0,36,30
1657419119062,MATH 18,B06,093474,Rideout; David Porter,6,0,36,30
1657419125085,MATH 20A,A01,083754,Zheng; Zequn,14,0,40,26
1657419131108,MATH 20B,A01,083756,Briones; Jor-el Thomas Caparas,4,0,36,32
1657419131108,MATH 20B,A02,083757,Briones; Jor-el Thomas Caparas,1,0,36,35
1657419131108,MATH 20B,A03,093475,Briones; Jor-el Thomas Caparas,2,0,36,34
1657419137133,MATH 20C,A01,083760,Briones; Jor-el Thomas Caparas,1,0,35,34
1657419137133,MATH 20C,A02,083761,Briones; Jor-el Thomas Caparas,8,0,35,27
1657419137133,MATH 20C,A03,093476,Briones; Jor-el Thomas Caparas,0,1,36,36
1657419137133,MATH 20C,B01,083762,Bach; Quang Tran,1,0,30,29
1657419143156,MATH 20D,A01,083765,Tran; Brian Kha,5,0,30,25
1657419143156,MATH 20D,A02,083766,Tran; Brian Kha,5,0,30,25
1657419143156,MATH 20D,A03,083767,Tran; Brian Kha,5,0,30,25
1657419149178,MATH 20E,A01,083771,Ganguly; Soumya,9,0,32,23
1657419149178,MATH 20E,A02,083772,Ganguly; Soumya,6,0,32,26
1657419149178,MATH 20E,B01,083773,Ciotti; Benjamin,20,0,35,15
1657419149178,MATH 20E,B02,083774,Ciotti; Benjamin,17,0,35,18
1657419155203,MATH 103A,A01,083777,Greenfeld; Be'Eri,3,0,36,33
1657419155203,MATH 103A,A02,083778,Greenfeld; Be'Eri,5,0,36,31
1657419155203,MATH 103A,A03,093561,Greenfeld; Be'Eri,5,0,36,31
1657419155203,MATH 103A,B01,083779,Greenfeld; Be'Eri,7,0,36,29
1657419155203,MATH 103A,B02,083780,Greenfeld; Be'Eri,4,0,36,32
1657419155203,MATH 103A,B03,093562,Greenfeld; Be'Eri,3,0,36,33
1657419161233,MATH 105,A01,085443,Carter; Anne Toulson,15,0,35,20
1657419161233,MATH 105,A02,093477,Carter; Anne Toulson,20,0,35,15
1657419167262,MATH 109,A01,083213,Ganzberger; Geoffrey Michael,2,0,34,32
1657419167262,MATH 109,A02,083214,Ganzberger; Geoffrey Michael,4,0,34,30
1657419167262,MATH 109,A03,093478,Ganzberger; Geoffrey Michael,2,0,34,32
1657419167262,MATH 109,B01,083215,Ganzberger; Geoffrey Michael,1,0,32,31
1657419167262,MATH 109,B02,083216,Ganzberger; Geoffrey Michael,2,0,32,30
1657419167262,MATH 109,B03,093479,Ganzberger; Geoffrey Michael,8,0,32,24
1657419173292,MATH 142A,A01,083219,Chow; Bennett,7,0,32,25
1657419173292,MATH 142A,A02,083220,Chow; Bennett,10,0,32,22
1657419173292,MATH 142A,A03,093480,Chow; Bennett,8,0,32,24
1657419173292,MATH 142A,B03,093481,Chow; Bennett,8,0,32,24
1657419173292,MATH 142A,B04,093558,Chow; Bennett,13,0,32,19
1657419173292,MATH 142A,B05,093559,Chow; Bennett,6,0,32,26
1657419179321,MATH 193A,A01,083224,Rotar; Vladimir,8,0,34,26
1657419179321,MATH 193A,A02,083225,Rotar; Vladimir,9,0,34,25
1657419179321,MATH 193A,A03,083781,Rotar; Vladimir,5,0,34,29
1657419179321,MATH 193A,A04,083782,Rotar; Vladimir,10,0,34,24
1657419179321,MATH 193A,A05,093482,Rotar; Vladimir,10,0,34,24
1657419185343,MATH 197,001,091859,McAuley; Julian John,9999,0,9999,0
1657419185343,MATH 197,002,095566,Kedlaya; Kiran S.,9997,0,9999,2
1657419185343,MATH 197,003,095567,Xiao; Ming,9999,0,9999,0
1657419185343,MATH 197,004,095571,Perols; Johan Lars,9998,0,9999,1
1657419192396,COGS 9,A01,083615,Shannon; Kyle Michael,9,0,75,66
1657419198418,COGS 11,A01,083617,Boyle; Mary E. T.,22,0,48,26
1657419204444,COGS 13,A01,083071,Bastos; Amalia Pinkusfeld,11,0,71,60
1657419210470,COGS 14A,A01,092681,Semenuks; Arturs,5,1,100,95
1657419216491,COGS 14B,A01,083073,Cheng; Tzu-Han,6,0,63,57
1657419222514,COGS 17,A01,092677,Semenuks; Arturs,6,0,81,75
1657419228539,COGS 100,A01,083619,Allen; Michael Gordon,17,0,70,53
1657419234567,COGS 101A,A01,083621,Davis; Joshua Daniel,9,0,68,59
1657419240594,COGS 101B,A01,091572,Allen; Michael Gordon,12,0,65,53
1657419246616,COGS 101C,A01,083625,Delgado; Tania,17,0,35,18
1657419252639,COGS 107A,A01,083627,Boyle; Mary E. T.,13,0,60,47
1657419258662,COGS 118A,A01,083075,Gupta; Anjum,21,0,76,55
1657419264690,CSE 3,A50,083646,Miranda; Gregory Joseph,24,0,50,26
1657419270718,CSE 8A,A50,083650,Miranda; Gregory Joseph,17,1,56,39
1657419276741,CSE 11,A01,083080,Cao; Yingjun,6,15,40,34
1657419282768,CSE 12,A01,083652,Krause-Levy; Sophia Louisa,28,1,120,92
1657419288794,CSE 15L,A01,083654,Morris; Justin Loren,9,0,50,41
1657419288794,CSE 15L,A02,083655,Morris; Justin Loren,9,0,50,41
1657419294815,CSE 20,A01,083657,Tran; Khoa Dang,39,0,80,41
1657419300839,CSE 21,A01,095574,Bach; Quang Tran,22,0,48,26
1657419306871,CSE 30,A01,083084,Eldon; John,4,0,80,76
1657419306871,CSE 30,B01,095061,Bhaskar; Nishant,9,0,50,41
1657419312896,CSE 100,A01,083659,Cao; Yingjun,5,4,70,65
1657419318923,CSE 134B,A01,083661,Powell; Thomas Allan,22,0,100,78
1657419324952,CSE 140,A01,083663,Gungor; Onat,14,0,85,71
1657419330980,CSE 140L,A01,083088,Eldon; John,21,0,100,79
1657419337004,CSE 175,A01,083665,Kumar; Rakesh,3,0,25,22
1657419343029,CSE 190,A00,092507,Dubnov; Shlomo,7,0,20,13
1657419349055,ECE 45,A01,083139,Congero; Spencer William,6,0,75,69
1657419355081,ECE 65,A50,083695,Saad; Andrew S,12,0,30,18
1657419355081,ECE 65,A51,095125,Saad; Andrew S,24,0,26,2
1657419361105,ECE 109,A01,091882,Touri; Behrouz,19,0,70,51
1657419367130,ECE 180,A00,083140,Abi Samra; Nicholas Camill,1,0,30,29
1657419367130,ECE 180,B00,083141,Abi Samra; Nicholas Camill,0,0,30,30
1657419373161,MATH 10A,A01,083735,Patchell; Gregory David,2,0,30,28
1657419373161,MATH 10A,A02,083736,Patchell; Gregory David,20,0,30,10
1657419373161,MATH 10A,A03,083737,Patchell; Gregory David,16,0,30,14
1657419379185,MATH 10B,A01,083207,Lim; Seonhee,8,0,34,26
1657419379185,MATH 10B,A02,083208,Lim; Seonhee,9,0,35,26
1657419379185,MATH 10B,A03,093472,Lim; Seonhee,7,0,34,27
1657419379185,MATH 10B,B01,083739,Sinha; Shubham,12,0,30,18
1657419385209,MATH 18,A01,083743,Cinel; Cameron Alexander,7,0,30,23
1657419385209,MATH 18,A02,083744,Cinel; Cameron Alexander,17,0,30,13
1657419385209,MATH 18,A03,083745,Cinel; Cameron Alexander,9,0,30,21
1657419385209,MATH 18,B01,083748,Rideout; David Porter,5,0,37,32
1657419385209,MATH 18,B02,083749,Rideout; David Porter,5,0,36,31
1657419385209,MATH 18,B03,083750,Rideout; David Porter,3,0,37,34
1657419385209,MATH 18,B04,083751,Rideout; David Porter,6,0,36,30
1657419385209,MATH 18,B05,093473,Rideout; David Porter,6,0,36,30
1657419385209,MATH 18,B06,093474,Rideout; David Porter,6,0,36,30
1657419391233,MATH 20A,A01,083754,Zheng; Zequn,14,0,40,26
1657419397259,MATH 20B,A01,083756,Briones; Jor-el Thomas Caparas,4,0,36,32
1657419397259,MATH 20B,A02,083757,Briones; Jor-el Thomas Caparas,1,0,36,35
1657419397259,MATH 20B,A03,093475,Briones; Jor-el Thomas Caparas,2,0,36,34
1657419403288,MATH 20C,A01,083760,Briones; Jor-el Thomas Caparas,1,0,35,34
1657419403288,MATH 20C,A02,083761,Briones; Jor-el Thomas Caparas,8,0,35,27
1657419403288,MATH 20C,A03,093476,Briones; Jor-el Thomas Caparas,0,1,36,36
1657419403288,MATH 20C,B01,083762,Bach; Quang Tran,1,0,30,29
1657419409311,MATH 20D,A01,083765,Tran; Brian Kha,5,0,30,25
1657419409311,MATH 20D,A02,083766,Tran; Brian Kha,5,0,30,25
1657419409311,MATH 20D,A03,083767,Tran; Brian Kha,5,0,30,25
1657419415339,MATH 20E,A01,083771,Ganguly; Soumya,9,0,32,23
1657419415339,MATH 20E,A02,083772,Ganguly; Soumya,6,0,32,26
1657419415339,MATH 20E,B01,083773,Ciotti; Benjamin,20,0,35,15
1657419415339,MATH 20E,B02,083774,Ciotti; Benjamin,17,0,35,18
1657419421362,MATH 103A,A01,083777,Greenfeld; Be'Eri,3,0,36,33
1657419421362,MATH 103A,A02,083778,Greenfeld; Be'Eri,5,0,36,31
1657419421362,MATH 103A,A03,093561,Greenfeld; Be'Eri,5,0,36,31
1657419421362,MATH 103A,B01,083779,Greenfeld; Be'Eri,7,0,36,29
1657419421362,MATH 103A,B02,083780,Greenfeld; Be'Eri,4,0,36,32
1657419421362,MATH 103A,B03,093562,Greenfeld; Be'Eri,3,0,36,33
1657419427390,MATH 105,A01,085443,Carter; Anne Toulson,15,0,35,20
1657419427390,MATH 105,A02,093477,Carter; Anne Toulson,20,0,35,15
1657419433412,MATH 109,A01,083213,Ganzberger; Geoffrey Michael,2,0,34,32
1657419433412,MATH 109,A02,083214,Ganzberger; Geoffrey Michael,4,0,34,30
1657419433412,MATH 109,A03,093478,Ganzberger; Geoffrey Michael,2,0,34,32
1657419433412,MATH 109,B01,083215,Ganzberger; Geoffrey Michael,1,0,32,31
1657419433412,MATH 109,B02,083216,Ganzberger; Geoffrey Michael,2,0,32,30
1657419433412,MATH 109,B03,093479,Ganzberger; Geoffrey Michael,8,0,32,24
1657419439437,MATH 142A,A01,083219,Chow; Bennett,7,0,32,25
1657419439437,MATH 142A,A02,083220,Chow; Bennett,10,0,32,22
1657419439437,MATH 142A,A03,093480,Chow; Bennett,8,0,32,24
1657419439437,MATH 142A,B03,093481,Chow; Bennett,8,0,32,24
1657419439437,MATH 142A,B04,093558,Chow; Bennett,13,0,32,19
1657419439437,MATH 142A,B05,093559,Chow; Bennett,6,0,32,26
1657419445461,MATH 193A,A01,083224,Rotar; Vladimir,8,0,34,26
1657419445461,MATH 193A,A02,083225,Rotar; Vladimir,9,0,34,25
1657419445461,MATH 193A,A03,083781,Rotar; Vladimir,5,0,34,29
1657419445461,MATH 193A,A04,083782,Rotar; Vladimir,10,0,34,24
1657419445461,MATH 193A,A05,093482,Rotar; Vladimir,10,0,34,24
1657419451505,MATH 197,001,091859,McAuley; Julian John,9999,0,9999,0
1657419451505,MATH 197,002,095566,Kedlaya; Kiran S.,9997,0,9999,2
1657419451505,MATH 197,003,095567,Xiao; Ming,9999,0,9999,0
1657419451505,MATH 197,004,095571,Perols; Johan Lars,9998,0,9999,1
1657419458573,COGS 9,A01,083615,Shannon; Kyle Michael,9,0,75,66
1657419464597,COGS 11,A01,083617,Boyle; Mary E. T.,22,0,48,26
1657419470626,COGS 13,A01,083071,Bastos; Amalia Pinkusfeld,11,0,71,60
1657419476649,COGS 14A,A01,092681,Semenuks; Arturs,5,1,100,95
1657419482672,COGS 14B,A01,083073,Cheng; Tzu-Han,6,0,63,57
1657419488699,COGS 17,A01,092677,Semenuks; Arturs,6,0,81,75
1657419494720,COGS 100,A01,083619,Allen; Michael Gordon,17,0,70,53
1657419500746,COGS 101A,A01,083621,Davis; Joshua Daniel,9,0,68,59
1657419506780,COGS 101B,A01,091572,Allen; Michael Gordon,12,0,65,53
1657419512809,COGS 101C,A01,083625,Delgado; Tania,17,0,35,18
1657419518834,COGS 107A,A01,083627,Boyle; Mary E. T.,13,0,60,47
1657419524860,COGS 118A,A01,083075,Gupta; Anjum,21,0,76,55
1657419530885,CSE 3,A50,083646,Miranda; Gregory Joseph,24,0,50,26
1657419536909,CSE 8A,A50,083650,Miranda; Gregory Joseph,17,1,56,39
1657419542930,CSE 11,A01,083080,Cao; Yingjun,6,15,40,34
1657419548954,CSE 12,A01,083652,Krause-Levy; Sophia Louisa,28,1,120,92
1657419554977,CSE 15L,A01,083654,Morris; Justin Loren,9,0,50,41
1657419554977,CSE 15L,A02,083655,Morris; Justin Loren,9,0,50,41
1657419561000,CSE 20,A01,083657,Tran; Khoa Dang,39,0,80,41
1657419567023,CSE 21,A01,095574,Bach; Quang Tran,22,0,48,26
1657419573055,CSE 30,A01,083084,Eldon; John,4,0,80,76
1657419573055,CSE 30,B01,095061,Bhaskar; Nishant,9,0,50,41
1657419579083,CSE 100,A01,083659,Cao; Yingjun,5,4,70,65
1657419585106,CSE 134B,A01,083661,Powell; Thomas Allan,22,0,100,78
1657419591132,CSE 140,A01,083663,Gungor; Onat,14,0,85,71
1657419597155,CSE 140L,A01,083088,Eldon; John,21,0,100,79
1657419603178,CSE 175,A01,083665,Kumar; Rakesh,3,0,25,22
1657419609203,CSE 190,A00,092507,Dubnov; Shlomo,7,0,20,13
1657419615230,ECE 45,A01,083139,Congero; Spencer William,6,0,75,69
1657419621256,ECE 65,A50,083695,Saad; Andrew S,12,0,30,18
1657419621256,ECE 65,A51,095125,Saad; Andrew S,24,0,26,2
1657419627279,ECE 109,A01,091882,Touri; Behrouz,19,0,70,51
1657419633311,ECE 180,A00,083140,Abi Samra; Nicholas Camill,1,0,30,29
1657419633311,ECE 180,B00,083141,Abi Samra; Nicholas Camill,0,0,30,30
1657419639338,MATH 10A,A01,083735,Patchell; Gregory David,2,0,30,28
1657419639338,MATH 10A,A02,083736,Patchell; Gregory David,20,0,30,10
1657419639338,MATH 10A,A03,083737,Patchell; Gregory David,16,0,30,14
1657419645369,MATH 10B,A01,083207,Lim; Seonhee,8,0,34,26
1657419645369,MATH 10B,A02,083208,Lim; Seonhee,9,0,35,26
1657419645369,MATH 10B,A03,093472,Lim; Seonhee,7,0,34,27
1657419645369,MATH 10B,B01,083739,Sinha; Shubham,12,0,30,18
1657419651400,MATH 18,A01,083743,Cinel; Cameron Alexander,7,0,30,23
1657419651400,MATH 18,A02,083744,Cinel; Cameron Alexander,17,0,30,13
1657419651400,MATH 18,A03,083745,Cinel; Cameron Alexander,9,0,30,21
1657419651400,MATH 18,B01,083748,Rideout; David Porter,5,0,37,32
1657419651400,MATH 18,B02,083749,Rideout; David Porter,5,0,36,31
1657419651400,MATH 18,B03,083750,Rideout; David Porter,3,0,37,34
1657419651400,MATH 18,B04,083751,Rideout; David Porter,6,0,36,30
1657419651400,MATH 18,B05,093473,Rideout; David Porter,6,0,36,30
1657419651400,MATH 18,B06,093474,Rideout; David Porter,6,0,36,30
1657419657431,MATH 20A,A01,083754,Zheng; Zequn,14,0,40,26
1657419663454,MATH 20B,A01,083756,Briones; Jor-el Thomas Caparas,4,0,36,32
1657419663454,MATH 20B,A02,083757,Briones; Jor-el Thomas Caparas,1,0,36,35
1657419663454,MATH 20B,A03,093475,Briones; Jor-el Thomas Caparas,2,0,36,34
1657419669480,MATH 20C,A01,083760,Briones; Jor-el Thomas Caparas,1,0,35,34
1657419669480,MATH 20C,A02,083761,Briones; Jor-el Thomas Caparas,8,0,35,27
1657419669480,MATH 20C,A03,093476,Briones; Jor-el Thomas Caparas,0,1,36,36
1657419669480,MATH 20C,B01,083762,Bach; Quang Tran,1,0,30,29
1657419675503,MATH 20D,A01,083765,Tran; Brian Kha,5,0,30,25
1657419675503,MATH 20D,A02,083766,Tran; Brian Kha,5,0,30,25
1657419675503,MATH 20D,A03,083767,Tran; Brian Kha,5,0,30,25
1657419681527,MATH 20E,A01,083771,Ganguly; Soumya,9,0,32,23
1657419681527,MATH 20E,A02,083772,Ganguly; Soumya,6,0,32,26
1657419681527,MATH 20E,B01,083773,Ciotti; Benjamin,20,0,35,15
1657419681527,MATH 20E,B02,083774,Ciotti; Benjamin,17,0,35,18
1657419687554,MATH 103A,A01,083777,Greenfeld; Be'Eri,3,0,36,33
1657419687554,MATH 103A,A02,083778,Greenfeld; Be'Eri,5,0,36,31
1657419687554,MATH 103A,A03,093561,Greenfeld; Be'Eri,5,0,36,31
1657419687554,MATH 103A,B01,083779,Greenfeld; Be'Eri,7,0,36,29
1657419687554,MATH 103A,B02,083780,Greenfeld; Be'Eri,4,0,36,32
1657419687554,MATH 103A,B03,093562,Greenfeld; Be'Eri,3,0,36,33
1657419693589,MATH 105,A01,085443,Carter; Anne Toulson,15,0,35,20
1657419693589,MATH 105,A02,093477,Carter; Anne Toulson,20,0,35,15
1657419699617,MATH 109,A01,083213,Ganzberger; Geoffrey Michael,2,0,34,32
1657419699617,MATH 109,A02,083214,Ganzberger; Geoffrey Michael,4,0,34,30
1657419699617,MATH 109,A03,093478,Ganzberger; Geoffrey Michael,2,0,34,32
1657419699617,MATH 109,B01,083215,Ganzberger; Geoffrey Michael,1,0,32,31
1657419699617,MATH 109,B02,083216,Ganzberger; Geoffrey Michael,2,0,32,30
1657419699617,MATH 109,B03,093479,Ganzberger; Geoffrey Michael,8,0,32,24
1657419705717,MATH 142A,A01,083219,Chow; Bennett,7,0,32,25
1657419705717,MATH 142A,A02,083220,Chow; Bennett,10,0,32,22
1657419705717,MATH 142A,A03,093480,Chow; Bennett,8,0,32,24
1657419705717,MATH 142A,B03,093481,Chow; Bennett,8,0,32,24
1657419705717,MATH 142A,B04,093558,Chow; Bennett,13,0,32,19
1657419705717,MATH 142A,B05,093559,Chow; Bennett,6,0,32,26
1657419711741,MATH 193A,A01,083224,Rotar; Vladimir,8,0,34,26
1657419711741,MATH 193A,A02,083225,Rotar; Vladimir,9,0,34,25
1657419711741,MATH 193A,A03,083781,Rotar; Vladimir,5,0,34,29
1657419711741,MATH 193A,A04,083782,Rotar; Vladimir,10,0,34,24
1657419711741,MATH 193A,A05,093482,Rotar; Vladimir,10,0,34,24
1657419717763,MATH 197,001,091859,McAuley; Julian John,9999,0,9999,0
1657419717763,MATH 197,002,095566,Kedlaya; Kiran S.,9997,0,9999,2
1657419717763,MATH 197,003,095567,Xiao; Ming,9999,0,9999,0
1657419717763,MATH 197,004,095571,Perols; Johan Lars,9998,0,9999,1
1657419724829,COGS 9,A01,083615,Shannon; Kyle Michael,9,0,75,66
1657419730851,COGS 11,A01,083617,Boyle; Mary E. T.,22,0,48,26
1657419736875,COGS 13,A01,083071,Bastos; Amalia Pinkusfeld,11,0,71,60
1657419742899,COGS 14A,A01,092681,Semenuks; Arturs,5,1,100,95
1657419748921,COGS 14B,A01,083073,Cheng; Tzu-Han,6,0,63,57
1657419754946,COGS 17,A01,092677,Semenuks; Arturs,6,0,81,75
1657419760968,COGS 100,A01,083619,Allen; Michael Gordon,17,0,70,53
1657419766997,COGS 101A,A01,083621,Davis; Joshua Daniel,9,0,68,59
1657419773019,COGS 101B,A01,091572,Allen; Michael Gordon,12,0,65,53
1657419779042,COGS 101C,A01,083625,Delgado; Tania,17,0,35,18
1657419785070,COGS 107A,A01,083627,Boyle; Mary E. T.,13,0,60,47
1657419791096,COGS 118A,A01,083075,Gupta; Anjum,21,0,76,55
1657419797117,CSE 3,A50,083646,Miranda; Gregory Joseph,24,0,50,26
1657419803147,CSE 8A,A50,083650,Miranda; Gregory Joseph,17,1,56,39
1657419809172,CSE 11,A01,083080,Cao; Yingjun,6,15,40,34
1657419815210,CSE 12,A01,083652,Krause-Levy; Sophia Louisa,28,1,120,92
1657419821237,CSE 15L,A01,083654,Morris; Justin Loren,9,0,50,41
1657419821237,CSE 15L,A02,083655,Morris; Justin Loren,9,0,50,41
1657419827260,CSE 20,A01,083657,Tran; Khoa Dang,39,0,80,41
1657419833287,CSE 21,A01,095574,Bach; Quang Tran,22,0,48,26
1657419839315,CSE 30,A01,083084,Eldon; John,4,0,80,76
1657419839315,CSE 30,B01,095061,Bhaskar; Nishant,9,0,50,41
1657419845343,CSE 100,A01,083659,Cao; Yingjun,5,4,70,65
1657419851367,CSE 134B,A01,083661,Powell; Thomas Allan,22,0,100,78
1657419857392,CSE 140,A01,083663,Gungor; Onat,14,0,85,71
1657419863419,CSE 140L,A01,083088,Eldon; John,21,0,100,79
1657419869445,CSE 175,A01,083665,Kumar; Rakesh,3,0,25,22
1657419875472,CSE 190,A00,092507,Dubnov; Shlomo,7,0,20,13
1657419881495,ECE 45,A01,083139,Congero; Spencer William,6,0,75,69
1657419887518,ECE 65,A50,083695,Saad; Andrew S,12,0,30,18
1657419887518,ECE 65,A51,095125,Saad; Andrew S,24,0,26,2
1657419893543,ECE 109,A01,091882,Touri; Behrouz,19,0,70,51
1657419899565,ECE 180,A00,083140,Abi Samra; Nicholas Camill,1,0,30,29
1657419899565,ECE 180,B00,083141,Abi Samra; Nicholas Camill,0,0,30,30
1657419905592,MATH 10A,A01,083735,Patchell; Gregory David,2,0,30,28
1657419905592,MATH 10A,A02,083736,Patchell; Gregory David,20,0,30,10
1657419905592,MATH 10A,A03,083737,Patchell; Gregory David,16,0,30,14
1657419911622,MATH 10B,A01,083207,Lim; Seonhee,8,0,34,26
1657419911622,MATH 10B,A02,083208,Lim; Seonhee,9,0,35,26
1657419911622,MATH 10B,A03,093472,Lim; Seonhee,7,0,34,27
1657419911622,MATH 10B,B01,083739,Sinha; Shubham,12,0,30,18
1657419917645,MATH 18,A01,083743,Cinel; Cameron Alexander,7,0,30,23
1657419917645,MATH 18,A02,083744,Cinel; Cameron Alexander,17,0,30,13
1657419917645,MATH 18,A03,083745,Cinel; Cameron Alexander,9,0,30,21
1657419917645,MATH 18,B01,083748,Rideout; David Porter,5,0,37,32
1657419917645,MATH 18,B02,083749,Rideout; David Porter,5,0,36,31
1657419917645,MATH 18,B03,083750,Rideout; David Porter,3,0,37,34
1657419917645,MATH 18,B04,083751,Rideout; David Porter,6,0,36,30
1657419917645,MATH 18,B05,093473,Rideout; David Porter,6,0,36,30
1657419917645,MATH 18,B06,093474,Rideout; David Porter,6,0,36,30
1657419923671,MATH 20A,A01,083754,Zheng; Zequn,14,0,40,26
1657419929697,MATH 20B,A01,083756,Briones; Jor-el Thomas Caparas,4,0,36,32
1657419929697,MATH 20B,A02,083757,Briones; Jor-el Thomas Caparas,1,0,36,35
1657419929697,MATH 20B,A03,093475,Briones; Jor-el Thomas Caparas,2,0,36,34
1657419935722,MATH 20C,A01,083760,Briones; Jor-el Thomas Caparas,1,0,35,34
1657419935722,MATH 20C,A02,083761,Briones; Jor-el Thomas Caparas,8,0,35,27
1657419935722,MATH 20C,A03,093476,Briones; Jor-el Thomas Caparas,0,1,36,36
1657419935722,MATH 20C,B01,083762,Bach; Quang Tran,1,0,30,29
1657419941750,MATH 20D,A01,083765,Tran; Brian Kha,5,0,30,25
1657419941750,MATH 20D,A02,083766,Tran; Brian Kha,5,0,30,25
1657419941750,MATH 20D,A03,083767,Tran; Brian Kha,5,0,30,25
1657419947779,MATH 20E,A01,083771,Ganguly; Soumya,9,0,32,23
1657419947779,MATH 20E,A02,083772,Ganguly; Soumya,6,0,32,26
1657419947779,MATH 20E,B01,083773,Ciotti; Benjamin,20,0,35,15
1657419947779,MATH 20E,B02,083774,Ciotti; Benjamin,17,0,35,18
1657419953807,MATH 103A,A01,083777,Greenfeld; Be'Eri,3,0,36,33
1657419953807,MATH 103A,A02,083778,Greenfeld; Be'Eri,5,0,36,31
1657419953807,MATH 103A,A03,093561,Greenfeld; Be'Eri,5,0,36,31
1657419953807,MATH 103A,B01,083779,Greenfeld; Be'Eri,7,0,36,29
1657419953807,MATH 103A,B02,083780,Greenfeld; Be'Eri,4,0,36,32
1657419953807,MATH 103A,B03,093562,Greenfeld; Be'Eri,3,0,36,33
1657419959831,MATH 105,A01,085443,Carter; Anne Toulson,15,0,35,20
1657419959831,MATH 105,A02,093477,Carter; Anne Toulson,20,0,35,15
1657419965860,MATH 109,A01,083213,Ganzberger; Geoffrey Michael,2,0,34,32
1657419965860,MATH 109,A02,083214,Ganzberger; Geoffrey Michael,4,0,34,30
1657419965860,MATH 109,A03,093478,Ganzberger; Geoffrey Michael,2,0,34,32
1657419965860,MATH 109,B01,083215,Ganzberger; Geoffrey Michael,1,0,32,31
1657419965860,MATH 109,B02,083216,Ganzberger; Geoffrey Michael,2,0,32,30
1657419965860,MATH 109,B03,093479,Ganzberger; Geoffrey Michael,8,0,32,24
1657419971889,MATH 142A,A01,083219,Chow; Bennett,7,0,32,25
1657419971889,MATH 142A,A02,083220,Chow; Bennett,10,0,32,22
1657419971889,MATH 142A,A03,093480,Chow; Bennett,8,0,32,24
1657419971889,MATH 142A,B03,093481,Chow; Bennett,8,0,32,24
1657419971889,MATH 142A,B04,093558,Chow; Bennett,13,0,32,19
1657419971889,MATH 142A,B05,093559,Chow; Bennett,6,0,32,26
1657419977913,MATH 193A,A01,083224,Rotar; Vladimir,8,0,34,26
1657419977913,MATH 193A,A02,083225,Rotar; Vladimir,9,0,34,25
1657419977913,MATH 193A,A03,083781,Rotar; Vladimir,5,0,34,29
1657419977913,MATH 193A,A04,083782,Rotar; Vladimir,10,0,34,24
1657419977913,MATH 193A,A05,093482,Rotar; Vladimir,10,0,34,24
1657419983940,MATH 197,001,091859,McAuley; Julian John,9999,0,9999,0
1657419983940,MATH 197,002,095566,Kedlaya; Kiran S.,9997,0,9999,2
1657419983940,MATH 197,003,095567,Xiao; Ming,9999,0,9999,0
1657419983940,MATH 197,004,095571,Perols; Johan Lars,9998,0,9999,1
1657419990998,COGS 9,A01,083615,Shannon; Kyle Michael,9,0,75,66
1657419997024,COGS 11,A01,083617,Boyle; Mary E. T.,22,0,48,26
1657420003049,COGS 13,A01,083071,Bastos; Amalia Pinkusfeld,11,0,71,60
1657420009074,COGS 14A,A01,092681,Semenuks; Arturs,5,1,100,95
1657420015101,COGS 14B,A01,083073,Cheng; Tzu-Han,6,0,63,57
1657420021123,COGS 17,A01,092677,Semenuks; Arturs,6,0,81,75
1657420027146,COGS 100,A01,083619,Allen; Michael Gordon,17,0,70,53
1657420033172,COGS 101A,A01,083621,Davis; Joshua Daniel,9,0,68,59
1657420039199,COGS 101B,A01,091572,Allen; Michael Gordon,12,0,65,53
1657420045222,COGS 101C,A01,083625,Delgado; Tania,17,0,35,18
1657420051244,COGS 107A,A01,083627,Boyle; Mary E. T.,13,0,60,47
1657420057266,COGS 118A,A01,083075,Gupta; Anjum,21,0,76,55
1657420063294,CSE 3,A50,083646,Miranda; Gregory Joseph,24,0,50,26
1657420069329,CSE 8A,A50,083650,Miranda; Gregory Joseph,17,1,56,39
1657420075355,CSE 11,A01,083080,Cao; Yingjun,6,15,40,34
1657420081382,CSE 12,A01,083652,Krause-Levy; Sophia Louisa,28,1,120,92
1657420087404,CSE 15L,A01,083654,Morris; Justin Loren,9,0,50,41
1657420087404,CSE 15L,A02,083655,Morris; Justin Loren,9,0,50,41
1657420093427,CSE 20,A01,083657,Tran; Khoa Dang,39,0,80,41
1657420099449,CSE 21,A01,095574,Bach; Quang Tran,22,0,48,26
1657420105475,CSE 30,A01,083084,Eldon; John,4,0,80,76
1657420105475,CSE 30,B01,095061,Bhaskar; Nishant,9,0,50,41
1657420111500,CSE 100,A01,083659,Cao; Yingjun,5,4,70,65
1657420117523,CSE 134B,A01,083661,Powell; Thomas Allan,22,0,100,78
1657420123546,CSE 140,A01,083663,Gungor; Onat,14,0,85,71
1657420129570,CSE 140L,A01,083088,Eldon; John,21,0,100,79
1657420135594,CSE 175,A01,083665,Kumar; Rakesh,3,0,25,22
1657420141620,CSE 190,A00,092507,Dubnov; Shlomo,7,0,20,13
1657420147642,ECE 45,A01,083139,Congero; Spencer William,6,0,75,69
1657420153668,ECE 65,A50,083695,Saad; Andrew S,12,0,30,18
1657420153668,ECE 65,A51,095125,Saad; Andrew S,24,0,26,2
1657420159690,ECE 109,A01,091882,Touri; Behrouz,19,0,70,51
1657420165715,ECE 180,A00,083140,Abi Samra; Nicholas Camill,1,0,30,29
1657420165715,ECE 180,B00,083141,Abi Samra; Nicholas Camill,0,0,30,30
1657420171737,MATH 10A,A01,083735,Patchell; Gregory David,2,0,30,28
1657420171737,MATH 10A,A02,083736,Patchell; Gregory David,20,0,30,10
1657420171737,MATH 10A,A03,083737,Patchell; Gregory David,16,0,30,14
1657420177760,MATH 10B,A01,083207,Lim; Seonhee,8,0,34,26
1657420177760,MATH 10B,A02,083208,Lim; Seonhee,9,0,35,26
1657420177760,MATH 10B,A03,093472,Lim; Seonhee,7,0,34,27
1657420177760,MATH 10B,B01,083739,Sinha; Shubham,12,0,30,18
1657420183790,MATH 18,A01,083743,Cinel; Cameron Alexander,7,0,30,23
1657420183790,MATH 18,A02,083744,Cinel; Cameron Alexander,17,0,30,13
1657420183790,MATH 18,A03,083745,Cinel; Cameron Alexander,9,0,30,21
1657420183790,MATH 18,B01,083748,Rideout; David Porter,5,0,37,32
1657420183790,MATH 18,B02,083749,Rideout; David Porter,5,0,36,31
1657420183790,MATH 18,B03,083750,Rideout; David Porter,3,0,37,34
1657420183790,MATH 18,B04,083751,Rideout; David Porter,6,0,36,30
1657420183790,MATH 18,B05,093473,Rideout; David Porter,6,0,36,30
1657420183790,MATH 18,B06,093474,Rideout; David Porter,6,0,36,30
1657420189813,MATH 20A,A01,083754,Zheng; Zequn,14,0,40,26
1657420195836,MATH 20B,A01,083756,Briones; Jor-el Thomas Caparas,4,0,36,32
1657420195836,MATH 20B,A02,083757,Briones; Jor-el Thomas Caparas,1,0,36,35
1657420195836,MATH 20B,A03,093475,Briones; Jor-el Thomas Caparas,2,0,36,34
1657420201859,MATH 20C,A01,083760,Briones; Jor-el Thomas Caparas,1,0,35,34
1657420201859,MATH 20C,A02,083761,Briones; Jor-el Thomas Caparas,8,0,35,27
1657420201859,MATH 20C,A03,093476,Briones; Jor-el Thomas Caparas,0,1,36,36
1657420201859,MATH 20C,B01,083762,Bach; Quang Tran,1,0,30,29
1657420207887,MATH 20D,A01,083765,Tran; Brian Kha,5,0,30,25
1657420207887,MATH 20D,A02,083766,Tran; Brian Kha,5,0,30,25
1657420207887,MATH 20D,A03,083767,Tran; Brian Kha,5,0,30,25
1657420213912,MATH 20E,A01,083771,Ganguly; Soumya,9,0,32,23
1657420213912,MATH 20E,A02,083772,Ganguly; Soumya,6,0,32,26
1657420213912,MATH 20E,B01,083773,Ciotti; Benjamin,20,0,35,15
1657420213912,MATH 20E,B02,083774,Ciotti; Benjamin,17,0,35,18
1657420219943,MATH 103A,A01,083777,Greenfeld; Be'Eri,3,0,36,33
1657420219943,MATH 103A,A02,083778,Greenfeld; Be'Eri,5,0,36,31
1657420219943,MATH 103A,A03,093561,Greenfeld; Be'Eri,5,0,36,31
1657420219943,MATH 103A,B01,083779,Greenfeld; Be'Eri,7,0,36,29
1657420219943,MATH 103A,B02,083780,Greenfeld; Be'Eri,4,0,36,32
1657420219943,MATH 103A,B03,093562,Greenfeld; Be'Eri,3,0,36,33
1657420225966,MATH 105,A01,085443,Carter; Anne Toulson,15,0,35,20
1657420225966,MATH 105,A02,093477,Carter; Anne Toulson,20,0,35,15
1657420231991,MATH 109,A01,083213,Ganzberger; Geoffrey Michael,2,0,34,32
1657420231991,MATH 109,A02,083214,Ganzberger; Geoffrey Michael,4,0,34,30
1657420231991,MATH 109,A03,093478,Ganzberger; Geoffrey Michael,2,0,34,32
1657420231991,MATH 109,B01,083215,Ganzberger; Geoffrey Michael,1,0,32,31
1657420231991,MATH 109,B02,083216,Ganzberger; Geoffrey Michael,2,0,32,30
1657420231991,MATH 109,B03,093479,Ganzberger; Geoffrey Michael,8,0,32,24
1657420238015,MATH 142A,A01,083219,Chow; Bennett,7,0,32,25
1657420238015,MATH 142A,A02,083220,Chow; Bennett,10,0,32,22
1657420238015,MATH 142A,A03,093480,Chow; Bennett,8,0,32,24
1657420238015,MATH 142A,B03,093481,Chow; Bennett,8,0,32,24
1657420238015,MATH 142A,B04,093558,Chow; Bennett,13,0,32,19
1657420238015,MATH 142A,B05,093559,Chow; Bennett,6,0,32,26
1657420244040,MATH 193A,A01,083224,Rotar; Vladimir,8,0,34,26
1657420244040,MATH 193A,A02,083225,Rotar; Vladimir,9,0,34,25
1657420244040,MATH 193A,A03,083781,Rotar; Vladimir,5,0,34,29
1657420244040,MATH 193A,A04,083782,Rotar; Vladimir,10,0,34,24
1657420244040,MATH 193A,A05,093482,Rotar; Vladimir,10,0,34,24
1657420250065,MATH 197,001,091859,McAuley; Julian John,9999,0,9999,0
1657420250065,MATH 197,002,095566,Kedlaya; Kiran S.,9997,0,9999,2
1657420250065,MATH 197,003,095567,Xiao; Ming,9999,0,9999,0
1657420250065,MATH 197,004,095571,Perols; Johan Lars,9998,0,9999,1
1657420257129,COGS 9,A01,083615,Shannon; Kyle Michael,9,0,75,66
1657420263156,COGS 11,A01,083617,Boyle; Mary E. T.,22,0,48,26
1657420269179,COGS 13,A01,083071,Bastos; Amalia Pinkusfeld,11,0,71,60
1657420275204,COGS 14A,A01,092681,Semenuks; Arturs,5,1,100,95
1657420281227,COGS 14B,A01,083073,Cheng; Tzu-Han,6,0,63,57
1657420287250,COGS 17,A01,092677,Semenuks; Arturs,6,0,81,75
1657420293273,COGS 100,A01,083619,Allen; Michael Gordon,17,0,70,53
1657420299400,COGS 101A,A01,083621,Davis; Joshua Daniel,9,0,68,59
1657420305433,COGS 101B,A01,091572,Allen; Michael Gordon,12,0,65,53
1657420311460,COGS 101C,A01,083625,Delgado; Tania,17,0,35,18
1657420317488,COGS 107A,A01,083627,Boyle; Mary E. T.,13,0,60,47
1657420323515,COGS 118A,A01,083075,Gupta; Anjum,21,0,76,55
1657420329541,CSE 3,A50,083646,Miranda; Gregory Joseph,24,0,50,26
1657420335564,CSE 8A,A50,083650,Miranda; Gregory Joseph,17,1,56,39
1657420341595,CSE 11,A01,083080,Cao; Yingjun,6,15,40,34
1657420347627,CSE 12,A01,083652,Krause-Levy; Sophia Louisa,28,1,120,92
1657420353653,CSE 15L,A01,083654,Morris; Justin Loren,9,0,50,41
1657420353653,CSE 15L,A02,083655,Morris; Justin Loren,9,0,50,41
1657420359678,CSE 20,A01,083657,Tran; Khoa Dang,39,0,80,41
1657420365701,CSE 21,A01,095574,Bach; Quang Tran,22,0,48,26
1657420371727,CSE 30,A01,083084,Eldon; John,4,0,80,76
1657420371727,CSE 30,B01,095061,Bhaskar; Nishant,9,0,50,41
1657420377754,CSE 100,A01,083659,Cao; Yingjun,5,4,70,65
1657420383778,CSE 134B,A01,083661,Powell; Thomas Allan,22,0,100,78
1657420389801,CSE 140,A01,083663,Gungor; Onat,14,0,85,71
1657420395823,CSE 140L,A01,083088,Eldon; John,21,0,100,79
1657420401845,CSE 175,A01,083665,Kumar; Rakesh,3,0,25,22
1657420407871,CSE 190,A00,092507,Dubnov; Shlomo,7,0,20,13
1657420413896,ECE 45,A01,083139,Congero; Spencer William,6,0,75,69
1657420419920,ECE 65,A50,083695,Saad; Andrew S,12,0,30,18
1657420419920,ECE 65,A51,095125,Saad; Andrew S,24,0,26,2
1657420425943,ECE 109,A01,091882,Touri; Behrouz,19,0,70,51
1657420431966,ECE 180,A00,083140,Abi Samra; Nicholas Camill,1,0,30,29
1657420431966,ECE 180,B00,083141,Abi Samra; Nicholas Camill,0,0,30,30
1657420437988,MATH 10A,A01,083735,Patchell; Gregory David,2,0,30,28
1657420437988,MATH 10A,A02,083736,Patchell; Gregory David,20,0,30,10
1657420437988,MATH 10A,A03,083737,Patchell; Gregory David,16,0,30,14
1657420444011,MATH 10B,A01,083207,Lim; Seonhee,8,0,34,26
1657420444011,MATH 10B,A02,083208,Lim; Seonhee,9,0,35,26
1657420444011,MATH 10B,A03,093472,Lim; Seonhee,7,0,34,27
1657420444011,MATH 10B,B01,083739,Sinha; Shubham,12,0,30,18
1657420450036,MATH 18,A01,083743,Cinel; Cameron Alexander,7,0,30,23
1657420450036,MATH 18,A02,083744,Cinel; Cameron Alexander,17,0,30,13
1657420450036,MATH 18,A03,083745,Cinel; Cameron Alexander,9,0,30,21
1657420450036,MATH 18,B01,083748,Rideout; David Porter,5,0,37,32
1657420450036,MATH 18,B02,083749,Rideout; David Porter,5,0,36,31
1657420450036,MATH 18,B03,083750,Rideout; David Porter,3,0,37,34
1657420450036,MATH 18,B04,083751,Rideout; David Porter,6,0,36,30
1657420450036,MATH 18,B05,093473,Rideout; David Porter,6,0,36,30
1657420450036,MATH 18,B06,093474,Rideout; David Porter,6,0,36,30
1657420456064,MATH 20A,A01,083754,Zheng; Zequn,14,0,40,26
1657420462087,MATH 20B,A01,083756,Briones; Jor-el Thomas Caparas,4,0,36,32
1657420462087,MATH 20B,A02,083757,Briones; Jor-el Thomas Caparas,1,0,36,35
1657420462087,MATH 20B,A03,093475,Briones; Jor-el Thomas Caparas,2,0,36,34
1657420468112,MATH 20C,A01,083760,Briones; Jor-el Thomas Caparas,1,0,35,34
1657420468112,MATH 20C,A02,083761,Briones; Jor-el Thomas Caparas,8,0,35,27
1657420468112,MATH 20C,A03,093476,Briones; Jor-el Thomas Caparas,0,1,36,36
1657420468112,MATH 20C,B01,083762,Bach; Quang Tran,1,0,30,29
1657420474134,MATH 20D,A01,083765,Tran; Brian Kha,5,0,30,25
1657420474134,MATH 20D,A02,083766,Tran; Brian Kha,5,0,30,25
1657420474134,MATH 20D,A03,083767,Tran; Brian Kha,5,0,30,25
1657420480159,MATH 20E,A01,083771,Ganguly; Soumya,9,0,32,23
1657420480159,MATH 20E,A02,083772,Ganguly; Soumya,6,0,32,26
1657420480159,MATH 20E,B01,083773,Ciotti; Benjamin,20,0,35,15
1657420480159,MATH 20E,B02,083774,Ciotti; Benjamin,17,0,35,18
1657420486182,MATH 103A,A01,083777,Greenfeld; Be'Eri,3,0,36,33
1657420486182,MATH 103A,A02,083778,Greenfeld; Be'Eri,5,0,36,31
1657420486182,MATH 103A,A03,093561,Greenfeld; Be'Eri,5,0,36,31
1657420486182,MATH 103A,B01,083779,Greenfeld; Be'Eri,7,0,36,29
1657420486182,MATH 103A,B02,083780,Greenfeld; Be'Eri,4,0,36,32
1657420486182,MATH 103A,B03,093562,Greenfeld; Be'Eri,3,0,36,33
1657420492208,MATH 105,A01,085443,Carter; Anne Toulson,15,0,35,20
1657420492208,MATH 105,A02,093477,Carter; Anne Toulson,20,0,35,15
1657420498234,MATH 109,A01,083213,Ganzberger; Geoffrey Michael,2,0,34,32
1657420498234,MATH 109,A02,083214,Ganzberger; Geoffrey Michael,4,0,34,30
1657420498234,MATH 109,A03,093478,Ganzberger; Geoffrey Michael,2,0,34,32
1657420498234,MATH 109,B01,083215,Ganzberger; Geoffrey Michael,1,0,32,31
1657420498234,MATH 109,B02,083216,Ganzberger; Geoffrey Michael,2,0,32,30
1657420498234,MATH 109,B03,093479,Ganzberger; Geoffrey Michael,8,0,32,24
1657420504258,MATH 142A,A01,083219,Chow; Bennett,7,0,32,25
1657420504258,MATH 142A,A02,083220,Chow; Bennett,10,0,32,22
1657420504258,MATH 142A,A03,093480,Chow; Bennett,8,0,32,24
1657420504258,MATH 142A,B03,093481,Chow; Bennett,8,0,32,24
1657420504258,MATH 142A,B04,093558,Chow; Bennett,13,0,32,19
1657420504258,MATH 142A,B05,093559,Chow; Bennett,6,0,32,26
1657420510282,MATH 193A,A01,083224,Rotar; Vladimir,8,0,34,26
1657420510282,MATH 193A,A02,083225,Rotar; Vladimir,9,0,34,25
1657420510282,MATH 193A,A03,083781,Rotar; Vladimir,5,0,34,29
1657420510282,MATH 193A,A04,083782,Rotar; Vladimir,10,0,34,24
1657420510282,MATH 193A,A05,093482,Rotar; Vladimir,10,0,34,24
1657420516304,MATH 197,001,091859,McAuley; Julian John,9999,0,9999,0
1657420516304,MATH 197,002,095566,Kedlaya; Kiran S.,9997,0,9999,2
1657420516304,MATH 197,003,095567,Xiao; Ming,9999,0,9999,0
1657420516304,MATH 197,004,095571,Perols; Johan Lars,9998,0,9999,1
1657420523365,COGS 9,A01,083615,Shannon; Kyle Michael,9,0,75,66
1657420529388,COGS 11,A01,083617,Boyle; Mary E. T.,22,0,48,26
1657420535414,COGS 13,A01,083071,Bastos; Amalia Pinkusfeld,11,0,71,60
1657420541439,COGS 14A,A01,092681,Semenuks; Arturs,5,1,100,95
1657420547473,COGS 14B,A01,083073,Cheng; Tzu-Han,6,0,63,57
1657420553495,COGS 17,A01,092677,Semenuks; Arturs,6,0,81,75
1657420559519,COGS 100,A01,083619,Allen; Michael Gordon,17,0,70,53
1657420565542,COGS 101A,A01,083621,Davis; Joshua Daniel,9,0,68,59
1657420571569,COGS 101B,A01,091572,Allen; Michael Gordon,12,0,65,53
1657420577595,COGS 101C,A01,083625,Delgado; Tania,17,0,35,18
1657420583627,COGS 107A,A01,083627,Boyle; Mary E. T.,13,0,60,47
1657420589649,COGS 118A,A01,083075,Gupta; Anjum,21,0,76,55
1657420595678,CSE 3,A50,083646,Miranda; Gregory Joseph,24,0,50,26
1657420601707,CSE 8A,A50,083650,Miranda; Gregory Joseph,17,1,56,39
1657420607730,CSE 11,A01,083080,Cao; Yingjun,6,15,40,34
1657420613753,CSE 12,A01,083652,Krause-Levy; Sophia Louisa,28,1,120,92
1657420619779,CSE 15L,A01,083654,Morris; Justin Loren,9,0,50,41
1657420619779,CSE 15L,A02,083655,Morris; Justin Loren,9,0,50,41
1657420625807,CSE 20,A01,083657,Tran; Khoa Dang,39,0,80,41
1657420631833,CSE 21,A01,095574,Bach; Quang Tran,22,0,48,26
1657420637860,CSE 30,A01,083084,Eldon; John,4,0,80,76
1657420637860,CSE 30,B01,095061,Bhaskar; Nishant,9,0,50,41
1657420643883,CSE 100,A01,083659,Cao; Yingjun,5,4,70,65
1657420649906,CSE 134B,A01,083661,Powell; Thomas Allan,22,0,100,78
1657420655937,CSE 140,A01,083663,Gungor; Onat,14,0,85,71
1657420661959,CSE 140L,A01,083088,Eldon; John,21,0,100,79
1657420667985,CSE 175,A01,083665,Kumar; Rakesh,3,0,25,22
1657420674009,CSE 190,A00,092507,Dubnov; Shlomo,7,0,20,13
1657420680033,ECE 45,A01,083139,Congero; Spencer William,6,0,75,69
1657420686061,ECE 65,A50,083695,Saad; Andrew S,12,0,30,18
1657420686061,ECE 65,A51,095125,Saad; Andrew S,24,0,26,2
1657420692091,ECE 109,A01,091882,Touri; Behrouz,19,0,70,51
1657420698116,ECE 180,A00,083140,Abi Samra; Nicholas Camill,1,0,30,29
1657420698116,ECE 180,B00,083141,Abi Samra; Nicholas Camill,0,0,30,30
1657420704143,MATH 10A,A01,083735,Patchell; Gregory David,2,0,30,28
1657420704143,MATH 10A,A02,083736,Patchell; Gregory David,20,0,30,10
1657420704143,MATH 10A,A03,083737,Patchell; Gregory David,16,0,30,14
1657420710167,MATH 10B,A01,083207,Lim; Seonhee,8,0,34,26
1657420710167,MATH 10B,A02,083208,Lim; Seonhee,9,0,35,26
1657420710167,MATH 10B,A03,093472,Lim; Seonhee,7,0,34,27
1657420710167,MATH 10B,B01,083739,Sinha; Shubham,12,0,30,18
1657420716197,MATH 18,A01,083743,Cinel; Cameron Alexander,7,0,30,23
1657420716197,MATH 18,A02,083744,Cinel; Cameron Alexander,17,0,30,13
1657420716197,MATH 18,A03,083745,Cinel; Cameron Alexander,9,0,30,21
1657420716197,MATH 18,B01,083748,Rideout; David Porter,5,0,37,32
1657420716197,MATH 18,B02,083749,Rideout; David Porter,5,0,36,31
1657420716197,MATH 18,B03,083750,Rideout; David Porter,3,0,37,34
1657420716197,MATH 18,B04,083751,Rideout; David Porter,6,0,36,30
1657420716197,MATH 18,B05,093473,Rideout; David Porter,6,0,36,30
1657420716197,MATH 18,B06,093474,Rideout; David Porter,6,0,36,30
1657420722218,MATH 20A,A01,083754,Zheng; Zequn,14,0,40,26
1657420728246,MATH 20B,A01,083756,Briones; Jor-el Thomas Caparas,4,0,36,32
1657420728246,MATH 20B,A02,083757,Briones; Jor-el Thomas Caparas,1,0,36,35
1657420728246,MATH 20B,A03,093475,Briones; Jor-el Thomas Caparas,2,0,36,34
1657420734269,MATH 20C,A01,083760,Briones; Jor-el Thomas Caparas,1,0,35,34
1657420734269,MATH 20C,A02,083761,Briones; Jor-el Thomas Caparas,8,0,35,27
1657420734269,MATH 20C,A03,093476,Briones; Jor-el Thomas Caparas,0,1,36,36
1657420734269,MATH 20C,B01,083762,Bach; Quang Tran,1,0,30,29
1657420740298,MATH 20D,A01,083765,Tran; Brian Kha,5,0,30,25
1657420740298,MATH 20D,A02,083766,Tran; Brian Kha,5,0,30,25
1657420740298,MATH 20D,A03,083767,Tran; Brian Kha,5,0,30,25
1657420746325,MATH 20E,A01,083771,Ganguly; Soumya,9,0,32,23
1657420746325,MATH 20E,A02,083772,Ganguly; Soumya,6,0,32,26
1657420746325,MATH 20E,B01,083773,Ciotti; Benjamin,20,0,35,15
1657420746325,MATH 20E,B02,083774,Ciotti; Benjamin,17,0,35,18
1657420752355,MATH 103A,A01,083777,Greenfeld; Be'Eri,3,0,36,33
1657420752355,MATH 103A,A02,083778,Greenfeld; Be'Eri,5,0,36,31
1657420752355,MATH 103A,A03,093561,Greenfeld; Be'Eri,5,0,36,31
1657420752355,MATH 103A,B01,083779,Greenfeld; Be'Eri,7,0,36,29
1657420752355,MATH 103A,B02,083780,Greenfeld; Be'Eri,4,0,36,32
1657420752355,MATH 103A,B03,093562,Greenfeld; Be'Eri,3,0,36,33
1657420758379,MATH 105,A01,085443,Carter; Anne Toulson,15,0,35,20
1657420758379,MATH 105,A02,093477,Carter; Anne Toulson,20,0,35,15
1657420764407,MATH 109,A01,083213,Ganzberger; Geoffrey Michael,2,0,34,32
1657420764407,MATH 109,A02,083214,Ganzberger; Geoffrey Michael,4,0,34,30
1657420764407,MATH 109,A03,093478,Ganzberger; Geoffrey Michael,2,0,34,32
1657420764407,MATH 109,B01,083215,Ganzberger; Geoffrey Michael,1,0,32,31
1657420764407,MATH 109,B02,083216,Ganzberger; Geoffrey Michael,2,0,32,30
1657420764407,MATH 109,B03,093479,Ganzberger; Geoffrey Michael,8,0,32,24
1657420770437,MATH 142A,A01,083219,Chow; Bennett,7,0,32,25
1657420770437,MATH 142A,A02,083220,Chow; Bennett,10,0,32,22
1657420770437,MATH 142A,A03,093480,Chow; Bennett,8,0,32,24
1657420770437,MATH 142A,B03,093481,Chow; Bennett,8,0,32,24
1657420770437,MATH 142A,B04,093558,Chow; Bennett,13,0,32,19
1657420770437,MATH 142A,B05,093559,Chow; Bennett,6,0,32,26
1657420776463,MATH 193A,A01,083224,Rotar; Vladimir,8,0,34,26
1657420776463,MATH 193A,A02,083225,Rotar; Vladimir,9,0,34,25
1657420776463,MATH 193A,A03,083781,Rotar; Vladimir,5,0,34,29
1657420776463,MATH 193A,A04,083782,Rotar; Vladimir,10,0,34,24
1657420776463,MATH 193A,A05,093482,Rotar; Vladimir,10,0,34,24
1657420782488,MATH 197,001,091859,McAuley; Julian John,9999,0,9999,0
1657420782488,MATH 197,002,095566,Kedlaya; Kiran S.,9997,0,9999,2
1657420782488,MATH 197,003,095567,Xiao; Ming,9999,0,9999,0
1657420782488,MATH 197,004,095571,Perols; Johan Lars,9998,0,9999,1
1657420789546,COGS 9,A01,083615,Shannon; Kyle Michael,9,0,75,66
1657420795570,COGS 11,A01,083617,Boyle; Mary E. T.,22,0,48,26
1657420801593,COGS 13,A01,083071,Bastos; Amalia Pinkusfeld,11,0,71,60
1657420807615,COGS 14A,A01,092681,Semenuks; Arturs,5,1,100,95
1657420813637,COGS 14B,A01,083073,Cheng; Tzu-Han,6,0,63,57
1657420819663,COGS 17,A01,092677,Semenuks; Arturs,6,0,81,75
1657420825689,COGS 100,A01,083619,Allen; Michael Gordon,17,0,70,53
1657420831715,COGS 101A,A01,083621,Davis; Joshua Daniel,9,0,68,59
1657420837738,COGS 101B,A01,091572,Allen; Michael Gordon,12,0,65,53
1657420843762,COGS 101C,A01,083625,Delgado; Tania,17,0,35,18
1657420849785,COGS 107A,A01,083627,Boyle; Mary E. T.,13,0,60,47
1657420855808,COGS 118A,A01,083075,Gupta; Anjum,21,0,76,55
1657420861833,CSE 3,A50,083646,Miranda; Gregory Joseph,24,0,50,26
1657420867867,CSE 8A,A50,083650,Miranda; Gregory Joseph,17,1,56,39
1657420873890,CSE 11,A01,083080,Cao; Yingjun,6,15,40,34
1657420879915,CSE 12,A01,083652,Krause-Levy; Sophia Louisa,28,1,120,92
1657420885941,CSE 15L,A01,083654,Morris; Justin Loren,9,0,50,41
1657420885941,CSE 15L,A02,083655,Morris; Justin Loren,9,0,50,41
1657420891964,CSE 20,A01,083657,Tran; Khoa Dang,39,0,80,41
1657420898063,CSE 21,A01,095574,Bach; Quang Tran,22,0,48,26
1657420904091,CSE 30,A01,083084,Eldon; John,4,0,80,76
1657420904091,CSE 30,B01,095061,Bhaskar; Nishant,9,0,50,41
1657420910117,CSE 100,A01,083659,Cao; Yingjun,5,4,70,65
1657420916145,CSE 134B,A01,083661,Powell; Thomas Allan,22,0,100,78
1657420922172,CSE 140,A01,083663,Gungor; Onat,14,0,85,71
1657420928199,CSE 140L,A01,083088,Eldon; John,21,0,100,79
1657420934225,CSE 175,A01,083665,Kumar; Rakesh,3,0,25,22
1657420940250,CSE 190,A00,092507,Dubnov; Shlomo,7,0,20,13
1657420946276,ECE 45,A01,083139,Congero; Spencer William,6,0,75,69
1657420952300,ECE 65,A50,083695,Saad; Andrew S,12,0,30,18
1657420952300,ECE 65,A51,095125,Saad; Andrew S,24,0,26,2
1657420958330,ECE 109,A01,091882,Touri; Behrouz,19,0,70,51
1657420964356,ECE 180,A00,083140,Abi Samra; Nicholas Camill,1,0,30,29
1657420964356,ECE 180,B00,083141,Abi Samra; Nicholas Camill,0,0,30,30
1657420970379,MATH 10A,A01,083735,Patchell; Gregory David,2,0,30,28
1657420970379,MATH 10A,A02,083736,Patchell; Gregory David,20,0,30,10
1657420970379,MATH 10A,A03,083737,Patchell; Gregory David,16,0,30,14
1657420976402,MATH 10B,A01,083207,Lim; Seonhee,8,0,34,26
1657420976402,MATH 10B,A02,083208,Lim; Seonhee,9,0,35,26
1657420976402,MATH 10B,A03,093472,Lim; Seonhee,7,0,34,27
1657420976402,MATH 10B,B01,083739,Sinha; Shubham,12,0,30,18
1657420982428,MATH 18,A01,083743,Cinel; Cameron Alexander,7,0,30,23
1657420982428,MATH 18,A02,083744,Cinel; Cameron Alexander,17,0,30,13
1657420982428,MATH 18,A03,083745,Cinel; Cameron Alexander,9,0,30,21
1657420982428,MATH 18,B01,083748,Rideout; David Porter,5,0,37,32
1657420982428,MATH 18,B02,083749,Rideout; David Porter,5,0,36,31
1657420982428,MATH 18,B03,083750,Rideout; David Porter,3,0,37,34
1657420982428,MATH 18,B04,083751,Rideout; David Porter,6,0,36,30
1657420982428,MATH 18,B05,093473,Rideout; David Porter,6,0,36,30
1657420982428,MATH 18,B06,093474,Rideout; David Porter,6,0,36,30
1657420988452,MATH 20A,A01,083754,Zheng; Zequn,14,0,40,26
1657420994478,MATH 20B,A01,083756,Briones; Jor-el Thomas Caparas,4,0,36,32
1657420994478,MATH 20B,A02,083757,Briones; Jor-el Thomas Caparas,1,0,36,35
1657420994478,MATH 20B,A03,093475,Briones; Jor-el Thomas Caparas,2,0,36,34
1657421000502,MATH 20C,A01,083760,Briones; Jor-el Thomas Caparas,1,0,35,34
1657421000502,MATH 20C,A02,083761,Briones; Jor-el Thomas Caparas,8,0,35,27
1657421000502,MATH 20C,A03,093476,Briones; Jor-el Thomas Caparas,0,1,36,36
1657421000502,MATH 20C,B01,083762,Bach; Quang Tran,1,0,30,29
1657421006524,MATH 20D,A01,083765,Tran; Brian Kha,5,0,30,25
1657421006524,MATH 20D,A02,083766,Tran; Brian Kha,5,0,30,25
1657421006524,MATH 20D,A03,083767,Tran; Brian Kha,5,0,30,25
1657421012552,MATH 20E,A01,083771,Ganguly; Soumya,9,0,32,23
1657421012552,MATH 20E,A02,083772,Ganguly; Soumya,6,0,32,26
1657421012552,MATH 20E,B01,083773,Ciotti; Benjamin,20,0,35,15
1657421012552,MATH 20E,B02,083774,Ciotti; Benjamin,17,0,35,18
1657421018575,MATH 103A,A01,083777,Greenfeld; Be'Eri,3,0,36,33
1657421018575,MATH 103A,A02,083778,Greenfeld; Be'Eri,5,0,36,31
1657421018575,MATH 103A,A03,093561,Greenfeld; Be'Eri,5,0,36,31
1657421018575,MATH 103A,B01,083779,Greenfeld; Be'Eri,7,0,36,29
1657421018575,MATH 103A,B02,083780,Greenfeld; Be'Eri,4,0,36,32
1657421018575,MATH 103A,B03,093562,Greenfeld; Be'Eri,3,0,36,33
1657421024603,MATH 105,A01,085443,Carter; Anne Toulson,15,0,35,20
1657421024603,MATH 105,A02,093477,Carter; Anne Toulson,20,0,35,15
1657421030627,MATH 109,A01,083213,Ganzberger; Geoffrey Michael,2,0,34,32
1657421030627,MATH 109,A02,083214,Ganzberger; Geoffrey Michael,4,0,34,30
1657421030627,MATH 109,A03,093478,Ganzberger; Geoffrey Michael,2,0,34,32
1657421030627,MATH 109,B01,083215,Ganzberger; Geoffrey Michael,1,0,32,31
1657421030627,MATH 109,B02,083216,Ganzberger; Geoffrey Michael,2,0,32,30
1657421030627,MATH 109,B03,093479,Ganzberger; Geoffrey Michael,8,0,32,24
1657421036655,MATH 142A,A01,083219,Chow; Bennett,7,0,32,25
1657421036655,MATH 142A,A02,083220,Chow; Bennett,10,0,32,22
1657421036655,MATH 142A,A03,093480,Chow; Bennett,8,0,32,24
1657421036655,MATH 142A,B03,093481,Chow; Bennett,8,0,32,24
1657421036655,MATH 142A,B04,093558,Chow; Bennett,13,0,32,19
1657421036655,MATH 142A,B05,093559,Chow; Bennett,6,0,32,26
1657421042683,MATH 193A,A01,083224,Rotar; Vladimir,8,0,34,26
1657421042683,MATH 193A,A02,083225,Rotar; Vladimir,9,0,34,25
1657421042683,MATH 193A,A03,083781,Rotar; Vladimir,5,0,34,29
1657421042683,MATH 193A,A04,083782,Rotar; Vladimir,10,0,34,24
1657421042683,MATH 193A,A05,093482,Rotar; Vladimir,10,0,34,24
1657421048705,MATH 197,001,091859,McAuley; Julian John,9999,0,9999,0
1657421048705,MATH 197,002,095566,Kedlaya; Kiran S.,9997,0,9999,2
1657421048705,MATH 197,003,095567,Xiao; Ming,9999,0,9999,0
1657421048705,MATH 197,004,095571,Perols; Johan Lars,9998,0,9999,1
1657421055759,COGS 9,A01,083615,Shannon; Kyle Michael,9,0,75,66
1657421061785,COGS 11,A01,083617,Boyle; Mary E. T.,22,0,48,26
1657421067810,COGS 13,A01,083071,Bastos; Amalia Pinkusfeld,11,0,71,60
1657421073834,COGS 14A,A01,092681,Semenuks; Arturs,5,1,100,95
1657421079862,COGS 14B,A01,083073,Cheng; Tzu-Han,6,0,63,57
1657421085888,COGS 17,A01,092677,Semenuks; Arturs,6,0,81,75
1657421091909,COGS 100,A01,083619,Allen; Michael Gordon,17,0,70,53
1657421097936,COGS 101A,A01,083621,Davis; Joshua Daniel,9,0,68,59
1657421103959,COGS 101B,A01,091572,Allen; Michael Gordon,12,0,65,53
1657421109982,COGS 101C,A01,083625,Delgado; Tania,17,0,35,18
1657421116003,COGS 107A,A01,083627,Boyle; Mary E. T.,13,0,60,47
1657421122025,COGS 118A,A01,083075,Gupta; Anjum,21,0,76,55
1657421128047,CSE 3,A50,083646,Miranda; Gregory Joseph,24,0,50,26
1657421134071,CSE 8A,A50,083650,Miranda; Gregory Joseph,17,1,56,39
1657421140098,CSE 11,A01,083080,Cao; Yingjun,6,15,40,34
1657421146125,CSE 12,A01,083652,Krause-Levy; Sophia Louisa,28,1,120,92
1657421152152,CSE 15L,A01,083654,Morris; Justin Loren,9,0,50,41
1657421152152,CSE 15L,A02,083655,Morris; Justin Loren,9,0,50,41
1657421158178,CSE 20,A01,083657,Tran; Khoa Dang,39,0,80,41
1657421164202,CSE 21,A01,095574,Bach; Quang Tran,22,0,48,26
1657421170224,CSE 30,A01,083084,Eldon; John,4,0,80,76
1657421170224,CSE 30,B01,095061,Bhaskar; Nishant,9,0,50,41
1657421176247,CSE 100,A01,083659,Cao; Yingjun,5,4,70,65
1657421182273,CSE 134B,A01,083661,Powell; Thomas Allan,22,0,100,78
1657421188297,CSE 140,A01,083663,Gungor; Onat,14,0,85,71
1657421194323,CSE 140L,A01,083088,Eldon; John,21,0,100,79
1657421200347,CSE 175,A01,083665,Kumar; Rakesh,3,0,25,22
1657421206372,CSE 190,A00,092507,Dubnov; Shlomo,7,0,20,13
1657421212399,ECE 45,A01,083139,Congero; Spencer William,6,0,75,69
1657421218425,ECE 65,A50,083695,Saad; Andrew S,12,0,30,18
1657421218425,ECE 65,A51,095125,Saad; Andrew S,24,0,26,2
1657421224451,ECE 109,A01,091882,Touri; Behrouz,19,0,70,51
1657421230474,ECE 180,A00,083140,Abi Samra; Nicholas Camill,1,0,30,29
1657421230474,ECE 180,B00,083141,Abi Samra; Nicholas Camill,0,0,30,30
1657421236506,MATH 10A,A01,083735,Patchell; Gregory David,2,0,30,28
1657421236506,MATH 10A,A02,083736,Patchell; Gregory David,20,0,30,10
1657421236506,MATH 10A,A03,083737,Patchell; Gregory David,16,0,30,14
1657421242535,MATH 10B,A01,083207,Lim; Seonhee,8,0,34,26
1657421242535,MATH 10B,A02,083208,Lim; Seonhee,9,0,35,26
1657421242535,MATH 10B,A03,093472,Lim; Seonhee,7,0,34,27
1657421242535,MATH 10B,B01,083739,Sinha; Shubham,12,0,30,18
1657421248565,MATH 18,A01,083743,Cinel; Cameron Alexander,7,0,30,23
1657421248565,MATH 18,A02,083744,Cinel; Cameron Alexander,17,0,30,13
1657421248565,MATH 18,A03,083745,Cinel; Cameron Alexander,9,0,30,21
1657421248565,MATH 18,B01,083748,Rideout; David Porter,5,0,37,32
1657421248565,MATH 18,B02,083749,Rideout; David Porter,5,0,36,31
1657421248565,MATH 18,B03,083750,Rideout; David Porter,3,0,37,34
1657421248565,MATH 18,B04,083751,Rideout; David Porter,6,0,36,30
1657421248565,MATH 18,B05,093473,Rideout; David Porter,6,0,36,30
1657421248565,MATH 18,B06,093474,Rideout; David Porter,6,0,36,30
1657421254591,MATH 20A,A01,083754,Zheng; Zequn,14,0,40,26
1657421260615,MATH 20B,A01,083756,Briones; Jor-el Thomas Caparas,4,0,36,32
1657421260615,MATH 20B,A02,083757,Briones; Jor-el Thomas Caparas,1,0,36,35
1657421260615,MATH 20B,A03,093475,Briones; Jor-el Thomas Caparas,2,0,36,34
1657421266643,MATH 20C,A01,083760,Briones; Jor-el Thomas Caparas,1,0,35,34
1657421266643,MATH 20C,A02,083761,Briones; Jor-el Thomas Caparas,8,0,35,27
1657421266643,MATH 20C,A03,093476,Briones; Jor-el Thomas Caparas,0,1,36,36
1657421266643,MATH 20C,B01,083762,Bach; Quang Tran,1,0,30,29
1657421272673,MATH 20D,A01,083765,Tran; Brian Kha,5,0,30,25
1657421272673,MATH 20D,A02,083766,Tran; Brian Kha,5,0,30,25
1657421272673,MATH 20D,A03,083767,Tran; Brian Kha,5,0,30,25
1657421278696,MATH 20E,A01,083771,Ganguly; Soumya,9,0,32,23
1657421278696,MATH 20E,A02,083772,Ganguly; Soumya,6,0,32,26
1657421278696,MATH 20E,B01,083773,Ciotti; Benjamin,20,0,35,15
1657421278696,MATH 20E,B02,083774,Ciotti; Benjamin,17,0,35,18
1657421284725,MATH 103A,A01,083777,Greenfeld; Be'Eri,3,0,36,33
1657421284725,MATH 103A,A02,083778,Greenfeld; Be'Eri,5,0,36,31
1657421284725,MATH 103A,A03,093561,Greenfeld; Be'Eri,5,0,36,31
1657421284725,MATH 103A,B01,083779,Greenfeld; Be'Eri,7,0,36,29
1657421284725,MATH 103A,B02,083780,Greenfeld; Be'Eri,4,0,36,32
1657421284725,MATH 103A,B03,093562,Greenfeld; Be'Eri,3,0,36,33
1657421290746,MATH 105,A01,085443,Carter; Anne Toulson,15,0,35,20
1657421290746,MATH 105,A02,093477,Carter; Anne Toulson,20,0,35,15
1657421296769,MATH 109,A01,083213,Ganzberger; Geoffrey Michael,2,0,34,32
1657421296769,MATH 109,A02,083214,Ganzberger; Geoffrey Michael,4,0,34,30
1657421296769,MATH 109,A03,093478,Ganzberger; Geoffrey Michael,2,0,34,32
1657421296769,MATH 109,B01,083215,Ganzberger; Geoffrey Michael,1,0,32,31
1657421296769,MATH 109,B02,083216,Ganzberger; Geoffrey Michael,2,0,32,30
1657421296769,MATH 109,B03,093479,Ganzberger; Geoffrey Michael,8,0,32,24
1657421302792,MATH 142A,A01,083219,Chow; Bennett,7,0,32,25
1657421302792,MATH 142A,A02,083220,Chow; Bennett,10,0,32,22
1657421302792,MATH 142A,A03,093480,Chow; Bennett,8,0,32,24
1657421302792,MATH 142A,B03,093481,Chow; Bennett,8,0,32,24
1657421302792,MATH 142A,B04,093558,Chow; Bennett,13,0,32,19
1657421302792,MATH 142A,B05,093559,Chow; Bennett,6,0,32,26
1657421308821,MATH 193A,A01,083224,Rotar; Vladimir,8,0,34,26
1657421308821,MATH 193A,A02,083225,Rotar; Vladimir,9,0,34,25
1657421308821,MATH 193A,A03,083781,Rotar; Vladimir,5,0,34,29
1657421308821,MATH 193A,A04,083782,Rotar; Vladimir,10,0,34,24
1657421308821,MATH 193A,A05,093482,Rotar; Vladimir,10,0,34,24
1657421314846,MATH 197,001,091859,McAuley; Julian John,9999,0,9999,0
1657421314846,MATH 197,002,095566,Kedlaya; Kiran S.,9997,0,9999,2
1657421314846,MATH 197,003,095567,Xiao; Ming,9999,0,9999,0
1657421314846,MATH 197,004,095571,Perols; Johan Lars,9998,0,9999,1
1657421321912,COGS 9,A01,083615,Shannon; Kyle Michael,9,0,75,66
1657421327940,COGS 11,A01,083617,Boyle; Mary E. T.,22,0,48,26
1657421333978,COGS 13,A01,083071,Bastos; Amalia Pinkusfeld,11,0,71,60
1657421340000,COGS 14A,A01,092681,Semenuks; Arturs,5,1,100,95
1657421346022,COGS 14B,A01,083073,Cheng; Tzu-Han,6,0,63,57
1657421352046,COGS 17,A01,092677,Semenuks; Arturs,6,0,81,75
1657421358073,COGS 100,A01,083619,Allen; Michael Gordon,17,0,70,53
1657421364097,COGS 101A,A01,083621,Davis; Joshua Daniel,9,0,68,59
1657421370121,COGS 101B,A01,091572,Allen; Michael Gordon,12,0,65,53
1657421376148,COGS 101C,A01,083625,Delgado; Tania,17,0,35,18
1657421382176,COGS 107A,A01,083627,Boyle; Mary E. T.,13,0,60,47
1657421388205,COGS 118A,A01,083075,Gupta; Anjum,21,0,76,55
1657421394229,CSE 3,A50,083646,Miranda; Gregory Joseph,24,0,50,26
1657421400253,CSE 8A,A50,083650,Miranda; Gregory Joseph,17,1,56,39
1657421406276,CSE 11,A01,083080,Cao; Yingjun,6,15,40,34
1657421412298,CSE 12,A01,083652,Krause-Levy; Sophia Louisa,28,1,120,92
1657421418320,CSE 15L,A01,083654,Morris; Justin Loren,9,0,50,41
1657421418320,CSE 15L,A02,083655,Morris; Justin Loren,9,0,50,41
1657421424348,CSE 20,A01,083657,Tran; Khoa Dang,39,0,80,41
1657421430377,CSE 21,A01,095574,Bach; Quang Tran,22,0,48,26
1657421436400,CSE 30,A01,083084,Eldon; John,4,0,80,76
1657421436400,CSE 30,B01,095061,Bhaskar; Nishant,9,0,50,41
1657421442441,CSE 100,A01,083659,Cao; Yingjun,5,4,70,65
1657421448464,CSE 134B,A01,083661,Powell; Thomas Allan,22,0,100,78
1657421454490,CSE 140,A01,083663,Gungor; Onat,14,0,85,71
1657421460513,CSE 140L,A01,083088,Eldon; John,21,0,100,79
1657421466536,CSE 175,A01,083665,Kumar; Rakesh,3,0,25,22
1657421472560,CSE 190,A00,092507,Dubnov; Shlomo,7,0,20,13
1657421478582,ECE 45,A01,083139,Congero; Spencer William,6,0,75,69
1657421484621,ECE 65,A50,083695,Saad; Andrew S,12,0,30,18
1657421484621,ECE 65,A51,095125,Saad; Andrew S,24,0,26,2
1657421490648,ECE 109,A01,091882,Touri; Behrouz,19,0,70,51
1657421496756,ECE 180,A00,083140,Abi Samra; Nicholas Camill,1,0,30,29
1657421496756,ECE 180,B00,083141,Abi Samra; Nicholas Camill,0,0,30,30
1657421502785,MATH 10A,A01,083735,Patchell; Gregory David,2,0,30,28
1657421502785,MATH 10A,A02,083736,Patchell; Gregory David,20,0,30,10
1657421502785,MATH 10A,A03,083737,Patchell; Gregory David,16,0,30,14
1657421508810,MATH 10B,A01,083207,Lim; Seonhee,8,0,34,26
1657421508810,MATH 10B,A02,083208,Lim; Seonhee,9,0,35,26
1657421508810,MATH 10B,A03,093472,Lim; Seonhee,7,0,34,27
1657421508810,MATH 10B,B01,083739,Sinha; Shubham,12,0,30,18
1657421514841,MATH 18,A01,083743,Cinel; Cameron Alexander,7,0,30,23
1657421514841,MATH 18,A02,083744,Cinel; Cameron Alexander,17,0,30,13
1657421514841,MATH 18,A03,083745,Cinel; Cameron Alexander,9,0,30,21
1657421514841,MATH 18,B01,083748,Rideout; David Porter,5,0,37,32
1657421514841,MATH 18,B02,083749,Rideout; David Porter,5,0,36,31
1657421514841,MATH 18,B03,083750,Rideout; David Porter,3,0,37,34
1657421514841,MATH 18,B04,083751,Rideout; David Porter,6,0,36,30
1657421514841,MATH 18,B05,093473,Rideout; David Porter,6,0,36,30
1657421514841,MATH 18,B06,093474,Rideout; David Porter,6,0,36,30
1657421520865,MATH 20A,A01,083754,Zheng; Zequn,14,0,40,26
1657421526893,MATH 20B,A01,083756,Briones; Jor-el Thomas Caparas,4,0,36,32
1657421526893,MATH 20B,A02,083757,Briones; Jor-el Thomas Caparas,1,0,36,35
1657421526893,MATH 20B,A03,093475,Briones; Jor-el Thomas Caparas,2,0,36,34
1657421532923,MATH 20C,A01,083760,Briones; Jor-el Thomas Caparas,1,0,35,34
1657421532923,MATH 20C,A02,083761,Briones; Jor-el Thomas Caparas,8,0,35,27
1657421532923,MATH 20C,A03,093476,Briones; Jor-el Thomas Caparas,0,1,36,36
1657421532923,MATH 20C,B01,083762,Bach; Quang Tran,1,0,30,29
1657421538951,MATH 20D,A01,083765,Tran; Brian Kha,5,0,30,25
1657421538951,MATH 20D,A02,083766,Tran; Brian Kha,5,0,30,25
1657421538951,MATH 20D,A03,083767,Tran; Brian Kha,5,0,30,25
1657421544979,MATH 20E,A01,083771,Ganguly; Soumya,9,0,32,23
1657421544979,MATH 20E,A02,083772,Ganguly; Soumya,6,0,32,26
1657421544979,MATH 20E,B01,083773,Ciotti; Benjamin,20,0,35,15
1657421544979,MATH 20E,B02,083774,Ciotti; Benjamin,17,0,35,18
1657421551008,MATH 103A,A01,083777,Greenfeld; Be'Eri,3,0,36,33
1657421551008,MATH 103A,A02,083778,Greenfeld; Be'Eri,5,0,36,31
1657421551008,MATH 103A,A03,093561,Greenfeld; Be'Eri,5,0,36,31
1657421551008,MATH 103A,B01,083779,Greenfeld; Be'Eri,7,0,36,29
1657421551008,MATH 103A,B02,083780,Greenfeld; Be'Eri,4,0,36,32
1657421551008,MATH 103A,B03,093562,Greenfeld; Be'Eri,3,0,36,33
1657421557035,MATH 105,A01,085443,Carter; Anne Toulson,15,0,35,20
1657421557035,MATH 105,A02,093477,Carter; Anne Toulson,20,0,35,15
1657421563058,MATH 109,A01,083213,Ganzberger; Geoffrey Michael,2,0,34,32
1657421563058,MATH 109,A02,083214,Ganzberger; Geoffrey Michael,4,0,34,30
1657421563058,MATH 109,A03,093478,Ganzberger; Geoffrey Michael,2,0,34,32
1657421563058,MATH 109,B01,083215,Ganzberger; Geoffrey Michael,1,0,32,31
1657421563058,MATH 109,B02,083216,Ganzberger; Geoffrey Michael,2,0,32,30
1657421563058,MATH 109,B03,093479,Ganzberger; Geoffrey Michael,8,0,32,24
1657421569083,MATH 142A,A01,083219,Chow; Bennett,7,0,32,25
1657421569083,MATH 142A,A02,083220,Chow; Bennett,10,0,32,22
1657421569083,MATH 142A,A03,093480,Chow; Bennett,8,0,32,24
1657421569083,MATH 142A,B03,093481,Chow; Bennett,8,0,32,24
1657421569083,MATH 142A,B04,093558,Chow; Bennett,13,0,32,19
1657421569083,MATH 142A,B05,093559,Chow; Bennett,6,0,32,26
1657421575106,MATH 193A,A01,083224,Rotar; Vladimir,8,0,34,26
1657421575106,MATH 193A,A02,083225,Rotar; Vladimir,9,0,34,25
1657421575106,MATH 193A,A03,083781,Rotar; Vladimir,5,0,34,29
1657421575106,MATH 193A,A04,083782,Rotar; Vladimir,10,0,34,24
1657421575106,MATH 193A,A05,093482,Rotar; Vladimir,10,0,34,24
1657421581130,MATH 197,001,091859,McAuley; Julian John,9999,0,9999,0
1657421581130,MATH 197,002,095566,Kedlaya; Kiran S.,9997,0,9999,2
1657421581130,MATH 197,003,095567,Xiao; Ming,9999,0,9999,0
1657421581130,MATH 197,004,095571,Perols; Johan Lars,9998,0,9999,1
1657421588182,COGS 9,A01,083615,Shannon; Kyle Michael,9,0,75,66
1657421594211,COGS 11,A01,083617,Boyle; Mary E. T.,22,0,48,26
1657421600242,COGS 13,A01,083071,Bastos; Amalia Pinkusfeld,11,0,71,60
1657421606264,COGS 14A,A01,092681,Semenuks; Arturs,5,1,100,95
1657421612287,COGS 14B,A01,083073,Cheng; Tzu-Han,6,0,63,57
1657421618323,COGS 17,A01,092677,Semenuks; Arturs,6,0,81,75
1657421624346,COGS 100,A01,083619,Allen; Michael Gordon,17,0,70,53
1657421630369,COGS 101A,A01,083621,Davis; Joshua Daniel,9,0,68,59
1657421636393,COGS 101B,A01,091572,Allen; Michael Gordon,12,0,65,53
1657421642416,COGS 101C,A01,083625,Delgado; Tania,17,0,35,18
1657421648442,COGS 107A,A01,083627,Boyle; Mary E. T.,13,0,60,47
1657421654466,COGS 118A,A01,083075,Gupta; Anjum,21,0,76,55
1657421660492,CSE 3,A50,083646,Miranda; Gregory Joseph,24,0,50,26
1657421666530,CSE 8A,A50,083650,Miranda; Gregory Joseph,17,1,56,39
1657421672553,CSE 11,A01,083080,Cao; Yingjun,6,15,40,34
1657421678575,CSE 12,A01,083652,Krause-Levy; Sophia Louisa,28,1,120,92
1657421684601,CSE 15L,A01,083654,Morris; Justin Loren,9,0,50,41
1657421684601,CSE 15L,A02,083655,Morris; Justin Loren,9,0,50,41
1657421690624,CSE 20,A01,083657,Tran; Khoa Dang,39,0,80,41
1657421696645,CSE 21,A01,095574,Bach; Quang Tran,22,0,48,26
1657421702675,CSE 30,A01,083084,Eldon; John,4,0,80,76
1657421702675,CSE 30,B01,095061,Bhaskar; Nishant,9,0,50,41
1657421708697,CSE 100,A01,083659,Cao; Yingjun,5,4,70,65
1657421714723,CSE 134B,A01,083661,Powell; Thomas Allan,22,0,100,78
1657421720747,CSE 140,A01,083663,Gungor; Onat,14,0,85,71
1657421726768,CSE 140L,A01,083088,Eldon; John,21,0,100,79
1657421732792,CSE 175,A01,083665,Kumar; Rakesh,3,0,25,22
1657421738817,CSE 190,A00,092507,Dubnov; Shlomo,7,0,20,13
1657421744844,ECE 45,A01,083139,Congero; Spencer William,6,0,75,69
1657421750868,ECE 65,A50,083695,Saad; Andrew S,12,0,30,18
1657421750868,ECE 65,A51,095125,Saad; Andrew S,24,0,26,2
1657421756893,ECE 109,A01,091882,Touri; Behrouz,19,0,70,51
1657421762921,ECE 180,A00,083140,Abi Samra; Nicholas Camill,1,0,30,29
1657421762921,ECE 180,B00,083141,Abi Samra; Nicholas Camill,0,0,30,30
1657421768943,MATH 10A,A01,083735,Patchell; Gregory David,2,0,30,28
1657421768943,MATH 10A,A02,083736,Patchell; Gregory David,20,0,30,10
1657421768943,MATH 10A,A03,083737,Patchell; Gregory David,16,0,30,14
1657421774966,MATH 10B,A01,083207,Lim; Seonhee,8,0,34,26
1657421774966,MATH 10B,A02,083208,Lim; Seonhee,9,0,35,26
1657421774966,MATH 10B,A03,093472,Lim; Seonhee,7,0,34,27
1657421774966,MATH 10B,B01,083739,Sinha; Shubham,12,0,30,18
1657421780991,MATH 18,A01,083743,Cinel; Cameron Alexander,7,0,30,23
1657421780991,MATH 18,A02,083744,Cinel; Cameron Alexander,17,0,30,13
1657421780991,MATH 18,A03,083745,Cinel; Cameron Alexander,9,0,30,21
1657421780991,MATH 18,B01,083748,Rideout; David Porter,5,0,37,32
1657421780991,MATH 18,B02,083749,Rideout; David Porter,5,0,36,31
1657421780991,MATH 18,B03,083750,Rideout; David Porter,3,0,37,34
1657421780991,MATH 18,B04,083751,Rideout; David Porter,6,0,36,30
1657421780991,MATH 18,B05,093473,Rideout; David Porter,6,0,36,30
1657421780991,MATH 18,B06,093474,Rideout; David Porter,6,0,36,30
1657421787014,MATH 20A,A01,083754,Zheng; Zequn,14,0,40,26
1657421793042,MATH 20B,A01,083756,Briones; Jor-el Thomas Caparas,4,0,36,32
1657421793042,MATH 20B,A02,083757,Briones; Jor-el Thomas Caparas,1,0,36,35
1657421793042,MATH 20B,A03,093475,Briones; Jor-el Thomas Caparas,2,0,36,34
1657421799066,MATH 20C,A01,083760,Briones; Jor-el Thomas Caparas,1,0,35,34
1657421799066,MATH 20C,A02,083761,Briones; Jor-el Thomas Caparas,8,0,35,27
1657421799066,MATH 20C,A03,093476,Briones; Jor-el Thomas Caparas,0,1,36,36
1657421799066,MATH 20C,B01,083762,Bach; Quang Tran,1,0,30,29
1657421805090,MATH 20D,A01,083765,Tran; Brian Kha,5,0,30,25
1657421805090,MATH 20D,A02,083766,Tran; Brian Kha,5,0,30,25
1657421805090,MATH 20D,A03,083767,Tran; Brian Kha,5,0,30,25
1657421811114,MATH 20E,A01,083771,Ganguly; Soumya,9,0,32,23
1657421811114,MATH 20E,A02,083772,Ganguly; Soumya,6,0,32,26
1657421811114,MATH 20E,B01,083773,Ciotti; Benjamin,20,0,35,15
1657421811114,MATH 20E,B02,083774,Ciotti; Benjamin,17,0,35,18
1657421817138,MATH 103A,A01,083777,Greenfeld; Be'Eri,3,0,36,33
1657421817138,MATH 103A,A02,083778,Greenfeld; Be'Eri,5,0,36,31
1657421817138,MATH 103A,A03,093561,Greenfeld; Be'Eri,5,0,36,31
1657421817138,MATH 103A,B01,083779,Greenfeld; Be'Eri,7,0,36,29
1657421817138,MATH 103A,B02,083780,Greenfeld; Be'Eri,4,0,36,32
1657421817138,MATH 103A,B03,093562,Greenfeld; Be'Eri,3,0,36,33
1657421823167,MATH 105,A01,085443,Carter; Anne Toulson,15,0,35,20
1657421823167,MATH 105,A02,093477,Carter; Anne Toulson,20,0,35,15
1657421829190,MATH 109,A01,083213,Ganzberger; Geoffrey Michael,2,0,34,32
1657421829190,MATH 109,A02,083214,Ganzberger; Geoffrey Michael,4,0,34,30
1657421829190,MATH 109,A03,093478,Ganzberger; Geoffrey Michael,2,0,34,32
1657421829190,MATH 109,B01,083215,Ganzberger; Geoffrey Michael,1,0,32,31
1657421829190,MATH 109,B02,083216,Ganzberger; Geoffrey Michael,2,0,32,30
1657421829190,MATH 109,B03,093479,Ganzberger; Geoffrey Michael,8,0,32,24
1657421835214,MATH 142A,A01,083219,Chow; Bennett,7,0,32,25
1657421835214,MATH 142A,A02,083220,Chow; Bennett,10,0,32,22
1657421835214,MATH 142A,A03,093480,Chow; Bennett,8,0,32,24
1657421835214,MATH 142A,B03,093481,Chow; Bennett,8,0,32,24
1657421835214,MATH 142A,B04,093558,Chow; Bennett,13,0,32,19
1657421835214,MATH 142A,B05,093559,Chow; Bennett,6,0,32,26
1657421841238,MATH 193A,A01,083224,Rotar; Vladimir,8,0,34,26
1657421841238,MATH 193A,A02,083225,Rotar; Vladimir,9,0,34,25
1657421841238,MATH 193A,A03,083781,Rotar; Vladimir,5,0,34,29
1657421841238,MATH 193A,A04,083782,Rotar; Vladimir,10,0,34,24
1657421841238,MATH 193A,A05,093482,Rotar; Vladimir,10,0,34,24
1657421847262,MATH 197,001,091859,McAuley; Julian John,9999,0,9999,0
1657421847262,MATH 197,002,095566,Kedlaya; Kiran S.,9997,0,9999,2
1657421847262,MATH 197,003,095567,Xiao; Ming,9999,0,9999,0
1657421847262,MATH 197,004,095571,Perols; Johan Lars,9998,0,9999,1
1657421854319,COGS 9,A01,083615,Shannon; Kyle Michael,9,0,75,66
1657421860343,COGS 11,A01,083617,Boyle; Mary E. T.,22,0,48,26
1657421866367,COGS 13,A01,083071,Bastos; Amalia Pinkusfeld,11,0,71,60
1657421872392,COGS 14A,A01,092681,Semenuks; Arturs,5,1,100,95
1657421878416,COGS 14B,A01,083073,Cheng; Tzu-Han,6,0,63,57
1657421884439,COGS 17,A01,092677,Semenuks; Arturs,6,0,81,75
1657421890464,COGS 100,A01,083619,Allen; Michael Gordon,17,0,70,53
1657421896488,COGS 101A,A01,083621,Davis; Joshua Daniel,9,0,68,59
1657421902517,COGS 101B,A01,091572,Allen; Michael Gordon,12,0,65,53
1657421908538,COGS 101C,A01,083625,Delgado; Tania,17,0,35,18
1657421914564,COGS 107A,A01,083627,Boyle; Mary E. T.,13,0,60,47
1657421920589,COGS 118A,A01,083075,Gupta; Anjum,21,0,76,55
1657421926613,CSE 3,A50,083646,Miranda; Gregory Joseph,24,0,50,26
1657421932635,CSE 8A,A50,083650,Miranda; Gregory Joseph,17,1,56,39
1657421938661,CSE 11,A01,083080,Cao; Yingjun,6,15,40,34
1657421944685,CSE 12,A01,083652,Krause-Levy; Sophia Louisa,28,1,120,92
1657421950712,CSE 15L,A01,083654,Morris; Justin Loren,9,0,50,41
1657421950712,CSE 15L,A02,083655,Morris; Justin Loren,9,0,50,41
1657421956737,CSE 20,A01,083657,Tran; Khoa Dang,39,0,80,41
1657421962763,CSE 21,A01,095574,Bach; Quang Tran,22,0,48,26
1657421968788,CSE 30,A01,083084,Eldon; John,4,0,80,76
1657421968788,CSE 30,B01,095061,Bhaskar; Nishant,9,0,50,41
1657421974810,CSE 100,A01,083659,Cao; Yingjun,5,4,70,65
1657421980838,CSE 134B,A01,083661,Powell; Thomas Allan,22,0,100,78
1657421986861,CSE 140,A01,083663,Gungor; Onat,15,0,85,70
1657421992884,CSE 140L,A01,083088,Eldon; John,21,0,100,79
1657421998910,CSE 175,A01,083665,Kumar; Rakesh,3,0,25,22
1657422004931,CSE 190,A00,092507,Dubnov; Shlomo,7,0,20,13
1657422010958,ECE 45,A01,083139,Congero; Spencer William,6,0,75,69
1657422016986,ECE 65,A50,083695,Saad; Andrew S,12,0,30,18
1657422016986,ECE 65,A51,095125,Saad; Andrew S,24,0,26,2
1657422023009,ECE 109,A01,091882,Touri; Behrouz,19,0,70,51
1657422029030,ECE 180,A00,083140,Abi Samra; Nicholas Camill,1,0,30,29
1657422029030,ECE 180,B00,083141,Abi Samra; Nicholas Camill,0,0,30,30
1657422035054,MATH 10A,A01,083735,Patchell; Gregory David,2,0,30,28
1657422035054,MATH 10A,A02,083736,Patchell; Gregory David,20,0,30,10
1657422035054,MATH 10A,A03,083737,Patchell; Gregory David,16,0,30,14
1657422041083,MATH 10B,A01,083207,Lim; Seonhee,8,0,34,26
1657422041083,MATH 10B,A02,083208,Lim; Seonhee,9,0,35,26
1657422041083,MATH 10B,A03,093472,Lim; Seonhee,7,0,34,27
1657422041083,MATH 10B,B01,083739,Sinha; Shubham,12,0,30,18
1657422047108,MATH 18,A01,083743,Cinel; Cameron Alexander,7,0,30,23
1657422047108,MATH 18,A02,083744,Cinel; Cameron Alexander,17,0,30,13
1657422047108,MATH 18,A03,083745,Cinel; Cameron Alexander,9,0,30,21
1657422047108,MATH 18,B01,083748,Rideout; David Porter,5,0,37,32
1657422047108,MATH 18,B02,083749,Rideout; David Porter,5,0,36,31
1657422047108,MATH 18,B03,083750,Rideout; David Porter,3,0,37,34
1657422047108,MATH 18,B04,083751,Rideout; David Porter,6,0,36,30
1657422047108,MATH 18,B05,093473,Rideout; David Porter,6,0,36,30
1657422047108,MATH 18,B06,093474,Rideout; David Porter,6,0,36,30
1657422053132,MATH 20A,A01,083754,Zheng; Zequn,14,0,40,26
1657422059154,MATH 20B,A01,083756,Briones; Jor-el Thomas Caparas,4,0,36,32
1657422059154,MATH 20B,A02,083757,Briones; Jor-el Thomas Caparas,1,0,36,35
1657422059154,MATH 20B,A03,093475,Briones; Jor-el Thomas Caparas,2,0,36,34
1657422065182,MATH 20C,A01,083760,Briones; Jor-el Thomas Caparas,1,0,35,34
1657422065182,MATH 20C,A02,083761,Briones; Jor-el Thomas Caparas,8,0,35,27
1657422065182,MATH 20C,A03,093476,Briones; Jor-el Thomas Caparas,0,1,36,36
1657422065182,MATH 20C,B01,083762,Bach; Quang Tran,1,0,30,29
1657422071211,MATH 20D,A01,083765,Tran; Brian Kha,5,0,30,25
1657422071211,MATH 20D,A02,083766,Tran; Brian Kha,5,0,30,25
1657422071211,MATH 20D,A03,083767,Tran; Brian Kha,5,0,30,25
1657422077239,MATH 20E,A01,083771,Ganguly; Soumya,9,0,32,23
1657422077239,MATH 20E,A02,083772,Ganguly; Soumya,6,0,32,26
1657422077239,MATH 20E,B01,083773,Ciotti; Benjamin,20,0,35,15
1657422077239,MATH 20E,B02,083774,Ciotti; Benjamin,17,0,35,18
1657422083261,MATH 103A,A01,083777,Greenfeld; Be'Eri,3,0,36,33
1657422083261,MATH 103A,A02,083778,Greenfeld; Be'Eri,5,0,36,31
1657422083261,MATH 103A,A03,093561,Greenfeld; Be'Eri,5,0,36,31
1657422083261,MATH 103A,B01,083779,Greenfeld; Be'Eri,7,0,36,29
1657422083261,MATH 103A,B02,083780,Greenfeld; Be'Eri,4,0,36,32
1657422083261,MATH 103A,B03,093562,Greenfeld; Be'Eri,3,0,36,33
1657422089284,MATH 105,A01,085443,Carter; Anne Toulson,15,0,35,20
1657422089284,MATH 105,A02,093477,Carter; Anne Toulson,20,0,35,15
1657422095384,MATH 109,A01,083213,Ganzberger; Geoffrey Michael,2,0,34,32
1657422095384,MATH 109,A02,083214,Ganzberger; Geoffrey Michael,4,0,34,30
1657422095384,MATH 109,A03,093478,Ganzberger; Geoffrey Michael,2,0,34,32
1657422095384,MATH 109,B01,083215,Ganzberger; Geoffrey Michael,1,0,32,31
1657422095384,MATH 109,B02,083216,Ganzberger; Geoffrey Michael,2,0,32,30
1657422095384,MATH 109,B03,093479,Ganzberger; Geoffrey Michael,8,0,32,24
1657422101408,MATH 142A,A01,083219,Chow; Bennett,7,0,32,25
1657422101408,MATH 142A,A02,083220,Chow; Bennett,10,0,32,22
1657422101408,MATH 142A,A03,093480,Chow; Bennett,8,0,32,24
1657422101408,MATH 142A,B03,093481,Chow; Bennett,8,0,32,24
1657422101408,MATH 142A,B04,093558,Chow; Bennett,13,0,32,19
1657422101408,MATH 142A,B05,093559,Chow; Bennett,6,0,32,26
1657422107436,MATH 193A,A01,083224,Rotar; Vladimir,8,0,34,26
1657422107436,MATH 193A,A02,083225,Rotar; Vladimir,9,0,34,25
1657422107436,MATH 193A,A03,083781,Rotar; Vladimir,5,0,34,29
1657422107436,MATH 193A,A04,083782,Rotar; Vladimir,10,0,34,24
1657422107436,MATH 193A,A05,093482,Rotar; Vladimir,10,0,34,24
1657422113460,MATH 197,001,091859,McAuley; Julian John,9999,0,9999,0
1657422113460,MATH 197,002,095566,Kedlaya; Kiran S.,9997,0,9999,2
1657422113460,MATH 197,003,095567,Xiao; Ming,9999,0,9999,0
1657422113460,MATH 197,004,095571,Perols; Johan Lars,9998,0,9999,1
1657422120523,COGS 9,A01,083615,Shannon; Kyle Michael,9,0,75,66
1657422126545,COGS 11,A01,083617,Boyle; Mary E. T.,22,0,48,26
1657422132571,COGS 13,A01,083071,Bastos; Amalia Pinkusfeld,11,0,71,60
1657422138594,COGS 14A,A01,092681,Semenuks; Arturs,5,1,100,95
1657422144619,COGS 14B,A01,083073,Cheng; Tzu-Han,6,0,63,57
1657422150646,COGS 17,A01,092677,Semenuks; Arturs,6,0,81,75
1657422156669,COGS 100,A01,083619,Allen; Michael Gordon,17,0,70,53
1657422162695,COGS 101A,A01,083621,Davis; Joshua Daniel,9,0,68,59
1657422168721,COGS 101B,A01,091572,Allen; Michael Gordon,12,0,65,53
1657422174744,COGS 101C,A01,083625,Delgado; Tania,17,0,35,18
1657422180767,COGS 107A,A01,083627,Boyle; Mary E. T.,13,0,60,47
1657422186789,COGS 118A,A01,083075,Gupta; Anjum,21,0,76,55
1657422192812,CSE 3,A50,083646,Miranda; Gregory Joseph,24,0,50,26
1657422198836,CSE 8A,A50,083650,Miranda; Gregory Joseph,17,1,56,39
1657422204859,CSE 11,A01,083080,Cao; Yingjun,6,15,40,34
1657422210881,CSE 12,A01,083652,Krause-Levy; Sophia Louisa,28,1,120,92
1657422216907,CSE 15L,A01,083654,Morris; Justin Loren,9,0,50,41
1657422216907,CSE 15L,A02,083655,Morris; Justin Loren,9,0,50,41
1657422222936,CSE 20,A01,083657,Tran; Khoa Dang,39,0,80,41
1657422228961,CSE 21,A01,095574,Bach; Quang Tran,22,0,48,26
1657422234989,CSE 30,A01,083084,Eldon; John,4,0,80,76
1657422234989,CSE 30,B01,095061,Bhaskar; Nishant,9,0,50,41
1657422241015,CSE 100,A01,083659,Cao; Yingjun,5,4,70,65
1657422247038,CSE 134B,A01,083661,Powell; Thomas Allan,22,0,100,78
1657422253071,CSE 140,A01,083663,Gungor; Onat,15,0,85,70
1657422259098,CSE 140L,A01,083088,Eldon; John,21,0,100,79
1657422265124,CSE 175,A01,083665,Kumar; Rakesh,3,0,25,22
1657422271148,CSE 190,A00,092507,Dubnov; Shlomo,7,0,20,13
1657422277170,ECE 45,A01,083139,Congero; Spencer William,6,0,75,69
1657422283199,ECE 65,A50,083695,Saad; Andrew S,12,0,30,18
1657422283199,ECE 65,A51,095125,Saad; Andrew S,24,0,26,2
1657422289223,ECE 109,A01,091882,Touri; Behrouz,19,0,70,51
1657422295246,ECE 180,A00,083140,Abi Samra; Nicholas Camill,1,0,30,29
1657422295246,ECE 180,B00,083141,Abi Samra; Nicholas Camill,0,0,30,30
1657422301270,MATH 10A,A01,083735,Patchell; Gregory David,2,0,30,28
1657422301270,MATH 10A,A02,083736,Patchell; Gregory David,20,0,30,10
1657422301270,MATH 10A,A03,083737,Patchell; Gregory David,16,0,30,14
1657422307293,MATH 10B,A01,083207,Lim; Seonhee,8,0,34,26
1657422307293,MATH 10B,A02,083208,Lim; Seonhee,9,0,35,26
1657422307293,MATH 10B,A03,093472,Lim; Seonhee,7,0,34,27
1657422307293,MATH 10B,B01,083739,Sinha; Shubham,12,0,30,18
1657422313317,MATH 18,A01,083743,Cinel; Cameron Alexander,7,0,30,23
1657422313317,MATH 18,A02,083744,Cinel; Cameron Alexander,17,0,30,13
1657422313317,MATH 18,A03,083745,Cinel; Cameron Alexander,9,0,30,21
1657422313317,MATH 18,B01,083748,Rideout; David Porter,5,0,37,32
1657422313317,MATH 18,B02,083749,Rideout; David Porter,5,0,36,31
1657422313317,MATH 18,B03,083750,Rideout; David Porter,3,0,37,34
1657422313317,MATH 18,B04,083751,Rideout; David Porter,6,0,36,30
1657422313317,MATH 18,B05,093473,Rideout; David Porter,6,0,36,30
1657422313317,MATH 18,B06,093474,Rideout; David Porter,6,0,36,30
1657422319340,MATH 20A,A01,083754,Zheng; Zequn,14,0,40,26
1657422325367,MATH 20B,A01,083756,Briones; Jor-el Thomas Caparas,4,0,36,32
1657422325367,MATH 20B,A02,083757,Briones; Jor-el Thomas Caparas,1,0,36,35
1657422325367,MATH 20B,A03,093475,Briones; Jor-el Thomas Caparas,2,0,36,34
1657422331392,MATH 20C,A01,083760,Briones; Jor-el Thomas Caparas,1,0,35,34
1657422331392,MATH 20C,A02,083761,Briones; Jor-el Thomas Caparas,8,0,35,27
1657422331392,MATH 20C,A03,093476,Briones; Jor-el Thomas Caparas,0,1,36,36
1657422331392,MATH 20C,B01,083762,Bach; Quang Tran,1,0,30,29
1657422337414,MATH 20D,A01,083765,Tran; Brian Kha,5,0,30,25
1657422337414,MATH 20D,A02,083766,Tran; Brian Kha,5,0,30,25
1657422337414,MATH 20D,A03,083767,Tran; Brian Kha,5,0,30,25
1657422343437,MATH 20E,A01,083771,Ganguly; Soumya,9,0,32,23
1657422343437,MATH 20E,A02,083772,Ganguly; Soumya,6,0,32,26
1657422343437,MATH 20E,B01,083773,Ciotti; Benjamin,20,0,35,15
1657422343437,MATH 20E,B02,083774,Ciotti; Benjamin,17,0,35,18
1657422349460,MATH 103A,A01,083777,Greenfeld; Be'Eri,3,0,36,33
1657422349460,MATH 103A,A02,083778,Greenfeld; Be'Eri,5,0,36,31
1657422349460,MATH 103A,A03,093561,Greenfeld; Be'Eri,5,0,36,31
1657422349460,MATH 103A,B01,083779,Greenfeld; Be'Eri,7,0,36,29
1657422349460,MATH 103A,B02,083780,Greenfeld; Be'Eri,4,0,36,32
1657422349460,MATH 103A,B03,093562,Greenfeld; Be'Eri,3,0,36,33
1657422355483,MATH 105,A01,085443,Carter; Anne Toulson,15,0,35,20
1657422355483,MATH 105,A02,093477,Carter; Anne Toulson,20,0,35,15
1657422361507,MATH 109,A01,083213,Ganzberger; Geoffrey Michael,2,0,34,32
1657422361507,MATH 109,A02,083214,Ganzberger; Geoffrey Michael,4,0,34,30
1657422361507,MATH 109,A03,093478,Ganzberger; Geoffrey Michael,2,0,34,32
1657422361507,MATH 109,B01,083215,Ganzberger; Geoffrey Michael,1,0,32,31
1657422361507,MATH 109,B02,083216,Ganzberger; Geoffrey Michael,2,0,32,30
1657422361507,MATH 109,B03,093479,Ganzberger; Geoffrey Michael,8,0,32,24
1657422367531,MATH 142A,A01,083219,Chow; Bennett,7,0,32,25
1657422367531,MATH 142A,A02,083220,Chow; Bennett,10,0,32,22
1657422367531,MATH 142A,A03,093480,Chow; Bennett,8,0,32,24
1657422367531,MATH 142A,B03,093481,Chow; Bennett,8,0,32,24
1657422367531,MATH 142A,B04,093558,Chow; Bennett,13,0,32,19
1657422367531,MATH 142A,B05,093559,Chow; Bennett,6,0,32,26
1657422373566,MATH 193A,A01,083224,Rotar; Vladimir,8,0,34,26
1657422373566,MATH 193A,A02,083225,Rotar; Vladimir,9,0,34,25
1657422373566,MATH 193A,A03,083781,Rotar; Vladimir,5,0,34,29
1657422373566,MATH 193A,A04,083782,Rotar; Vladimir,10,0,34,24
1657422373566,MATH 193A,A05,093482,Rotar; Vladimir,10,0,34,24
1657422379591,MATH 197,001,091859,McAuley; Julian John,9999,0,9999,0
1657422379591,MATH 197,002,095566,Kedlaya; Kiran S.,9997,0,9999,2
1657422379591,MATH 197,003,095567,Xiao; Ming,9999,0,9999,0
1657422379591,MATH 197,004,095571,Perols; Johan Lars,9998,0,9999,1
1657422386651,COGS 9,A01,083615,Shannon; Kyle Michael,9,0,75,66
1657422392678,COGS 11,A01,083617,Boyle; Mary E. T.,22,0,48,26
1657422398700,COGS 13,A01,083071,Bastos; Amalia Pinkusfeld,11,0,71,60
1657422404727,COGS 14A,A01,092681,Semenuks; Arturs,5,1,100,95
1657422410753,COGS 14B,A01,083073,Cheng; Tzu-Han,6,0,63,57
1657422416776,COGS 17,A01,092677,Semenuks; Arturs,6,0,81,75
1657422422800,COGS 100,A01,083619,Allen; Michael Gordon,17,0,70,53
1657422428823,COGS 101A,A01,083621,Davis; Joshua Daniel,9,0,68,59
1657422434850,COGS 101B,A01,091572,Allen; Michael Gordon,12,0,65,53
1657422440872,COGS 101C,A01,083625,Delgado; Tania,17,0,35,18
1657422446895,COGS 107A,A01,083627,Boyle; Mary E. T.,13,0,60,47
1657422452934,COGS 118A,A01,083075,Gupta; Anjum,21,0,76,55
1657422458958,CSE 3,A50,083646,Miranda; Gregory Joseph,24,0,50,26
1657422464987,CSE 8A,A50,083650,Miranda; Gregory Joseph,17,1,56,39
1657422471009,CSE 11,A01,083080,Cao; Yingjun,6,15,40,34
1657422477033,CSE 12,A01,083652,Krause-Levy; Sophia Louisa,28,1,120,92
1657422483055,CSE 15L,A01,083654,Morris; Justin Loren,9,0,50,41
1657422483055,CSE 15L,A02,083655,Morris; Justin Loren,9,0,50,41
1657422489080,CSE 20,A01,083657,Tran; Khoa Dang,39,0,80,41
1657422495103,CSE 21,A01,095574,Bach; Quang Tran,22,0,48,26
1657422501130,CSE 30,A01,083084,Eldon; John,4,0,80,76
1657422501130,CSE 30,B01,095061,Bhaskar; Nishant,9,0,50,41
1657422507153,CSE 100,A01,083659,Cao; Yingjun,5,4,70,65
1657422513175,CSE 134B,A01,083661,Powell; Thomas Allan,22,0,100,78
1657422519198,CSE 140,A01,083663,Gungor; Onat,15,0,85,70
1657422525220,CSE 140L,A01,083088,Eldon; John,21,0,100,79
1657422531248,CSE 175,A01,083665,Kumar; Rakesh,3,0,25,22
1657422537272,CSE 190,A00,092507,Dubnov; Shlomo,7,0,20,13
1657422543304,ECE 45,A01,083139,Congero; Spencer William,6,0,75,69
1657422549331,ECE 65,A50,083695,Saad; Andrew S,12,0,30,18
1657422549331,ECE 65,A51,095125,Saad; Andrew S,24,0,26,2
1657422555354,ECE 109,A01,091882,Touri; Behrouz,19,0,70,51
1657422561381,ECE 180,A00,083140,Abi Samra; Nicholas Camill,1,0,30,29
1657422561381,ECE 180,B00,083141,Abi Samra; Nicholas Camill,0,0,30,30
1657422567408,MATH 10A,A01,083735,Patchell; Gregory David,2,0,30,28
1657422567408,MATH 10A,A02,083736,Patchell; Gregory David,20,0,30,10
1657422567408,MATH 10A,A03,083737,Patchell; Gregory David,16,0,30,14
1657422573433,MATH 10B,A01,083207,Lim; Seonhee,8,0,34,26
1657422573433,MATH 10B,A02,083208,Lim; Seonhee,9,0,35,26
1657422573433,MATH 10B,A03,093472,Lim; Seonhee,7,0,34,27
1657422573433,MATH 10B,B01,083739,Sinha; Shubham,12,0,30,18
1657422579460,MATH 18,A01,083743,Cinel; Cameron Alexander,7,0,30,23
1657422579460,MATH 18,A02,083744,Cinel; Cameron Alexander,17,0,30,13
1657422579460,MATH 18,A03,083745,Cinel; Cameron Alexander,9,0,30,21
1657422579460,MATH 18,B01,083748,Rideout; David Porter,5,0,37,32
1657422579460,MATH 18,B02,083749,Rideout; David Porter,5,0,36,31
1657422579460,MATH 18,B03,083750,Rideout; David Porter,3,0,37,34
1657422579460,MATH 18,B04,083751,Rideout; David Porter,6,0,36,30
1657422579460,MATH 18,B05,093473,Rideout; David Porter,6,0,36,30
1657422579460,MATH 18,B06,093474,Rideout; David Porter,6,0,36,30
1657422585484,MATH 20A,A01,083754,Zheng; Zequn,14,0,40,26
1657422591508,MATH 20B,A01,083756,Briones; Jor-el Thomas Caparas,4,0,36,32
1657422591508,MATH 20B,A02,083757,Briones; Jor-el Thomas Caparas,1,0,36,35
1657422591508,MATH 20B,A03,093475,Briones; Jor-el Thomas Caparas,2,0,36,34
1657422597531,MATH 20C,A01,083760,Briones; Jor-el Thomas Caparas,1,0,35,34
1657422597531,MATH 20C,A02,083761,Briones; Jor-el Thomas Caparas,8,0,35,27
1657422597531,MATH 20C,A03,093476,Briones; Jor-el Thomas Caparas,0,1,36,36
1657422597531,MATH 20C,B01,083762,Bach; Quang Tran,1,0,30,29
1657422603564,MATH 20D,A01,083765,Tran; Brian Kha,5,0,30,25
1657422603564,MATH 20D,A02,083766,Tran; Brian Kha,5,0,30,25
1657422603564,MATH 20D,A03,083767,Tran; Brian Kha,5,0,30,25
1657422609586,MATH 20E,A01,083771,Ganguly; Soumya,9,0,32,23
1657422609586,MATH 20E,A02,083772,Ganguly; Soumya,6,0,32,26
1657422609586,MATH 20E,B01,083773,Ciotti; Benjamin,20,0,35,15
1657422609586,MATH 20E,B02,083774,Ciotti; Benjamin,17,0,35,18
1657422615611,MATH 103A,A01,083777,Greenfeld; Be'Eri,3,0,36,33
1657422615611,MATH 103A,A02,083778,Greenfeld; Be'Eri,5,0,36,31
1657422615611,MATH 103A,A03,093561,Greenfeld; Be'Eri,5,0,36,31
1657422615611,MATH 103A,B01,083779,Greenfeld; Be'Eri,7,0,36,29
1657422615611,MATH 103A,B02,083780,Greenfeld; Be'Eri,4,0,36,32
1657422615611,MATH 103A,B03,093562,Greenfeld; Be'Eri,3,0,36,33
1657422621641,MATH 105,A01,085443,Carter; Anne Toulson,15,0,35,20
1657422621641,MATH 105,A02,093477,Carter; Anne Toulson,20,0,35,15
1657422627664,MATH 109,A01,083213,Ganzberger; Geoffrey Michael,2,0,34,32
1657422627664,MATH 109,A02,083214,Ganzberger; Geoffrey Michael,4,0,34,30
1657422627664,MATH 109,A03,093478,Ganzberger; Geoffrey Michael,2,0,34,32
1657422627664,MATH 109,B01,083215,Ganzberger; Geoffrey Michael,1,0,32,31
1657422627664,MATH 109,B02,083216,Ganzberger; Geoffrey Michael,2,0,32,30
1657422627664,MATH 109,B03,093479,Ganzberger; Geoffrey Michael,8,0,32,24
1657422633688,MATH 142A,A01,083219,Chow; Bennett,7,0,32,25
1657422633688,MATH 142A,A02,083220,Chow; Bennett,10,0,32,22
1657422633688,MATH 142A,A03,093480,Chow; Bennett,8,0,32,24
1657422633688,MATH 142A,B03,093481,Chow; Bennett,8,0,32,24
1657422633688,MATH 142A,B04,093558,Chow; Bennett,13,0,32,19
1657422633688,MATH 142A,B05,093559,Chow; Bennett,6,0,32,26
1657422639716,MATH 193A,A01,083224,Rotar; Vladimir,8,0,34,26
1657422639716,MATH 193A,A02,083225,Rotar; Vladimir,9,0,34,25
1657422639716,MATH 193A,A03,083781,Rotar; Vladimir,5,0,34,29
1657422639716,MATH 193A,A04,083782,Rotar; Vladimir,10,0,34,24
1657422639716,MATH 193A,A05,093482,Rotar; Vladimir,10,0,34,24
1657422645739,MATH 197,001,091859,McAuley; Julian John,9999,0,9999,0
1657422645739,MATH 197,002,095566,Kedlaya; Kiran S.,9997,0,9999,2
1657422645739,MATH 197,003,095567,Xiao; Ming,9999,0,9999,0
1657422645739,MATH 197,004,095571,Perols; Johan Lars,9998,0,9999,1
1657422652791,COGS 9,A01,083615,Shannon; Kyle Michael,9,0,75,66
1657422658817,COGS 11,A01,083617,Boyle; Mary E. T.,22,0,48,26
1657422664843,COGS 13,A01,083071,Bastos; Amalia Pinkusfeld,11,0,71,60
1657422670865,COGS 14A,A01,092681,Semenuks; Arturs,5,1,100,95
1657422676891,COGS 14B,A01,083073,Cheng; Tzu-Han,6,0,63,57
1657422682913,COGS 17,A01,092677,Semenuks; Arturs,6,0,81,75
1657422689012,COGS 100,A01,083619,Allen; Michael Gordon,17,0,70,53
1657422695038,COGS 101A,A01,083621,Davis; Joshua Daniel,9,0,68,59
1657422701065,COGS 101B,A01,091572,Allen; Michael Gordon,12,0,65,53
1657422707093,COGS 101C,A01,083625,Delgado; Tania,17,0,35,18
1657422713119,COGS 107A,A01,083627,Boyle; Mary E. T.,13,0,60,47
1657422719153,COGS 118A,A01,083075,Gupta; Anjum,21,0,76,55
1657422725177,CSE 3,A50,083646,Miranda; Gregory Joseph,24,0,50,26
1657422731199,CSE 8A,A50,083650,Miranda; Gregory Joseph,17,1,56,39
1657422737227,CSE 11,A01,083080,Cao; Yingjun,6,15,40,34
1657422743250,CSE 12,A01,083652,Krause-Levy; Sophia Louisa,28,1,120,92
1657422749274,CSE 15L,A01,083654,Morris; Justin Loren,9,0,50,41
1657422749274,CSE 15L,A02,083655,Morris; Justin Loren,9,0,50,41
1657422755301,CSE 20,A01,083657,Tran; Khoa Dang,39,0,80,41
1657422761324,CSE 21,A01,095574,Bach; Quang Tran,22,0,48,26
1657422767351,CSE 30,A01,083084,Eldon; John,4,0,80,76
1657422767351,CSE 30,B01,095061,Bhaskar; Nishant,9,0,50,41
1657422773378,CSE 100,A01,083659,Cao; Yingjun,5,4,70,65
1657422779404,CSE 134B,A01,083661,Powell; Thomas Allan,22,0,100,78
1657422785427,CSE 140,A01,083663,Gungor; Onat,15,0,85,70
1657422791452,CSE 140L,A01,083088,Eldon; John,21,0,100,79
1657422797476,CSE 175,A01,083665,Kumar; Rakesh,3,0,25,22
1657422803499,CSE 190,A00,092507,Dubnov; Shlomo,7,0,20,13
1657422809531,ECE 45,A01,083139,Congero; Spencer William,6,0,75,69
1657422815564,ECE 65,A50,083695,Saad; Andrew S,12,0,30,18
1657422815564,ECE 65,A51,095125,Saad; Andrew S,24,0,26,2
1657422821588,ECE 109,A01,091882,Touri; Behrouz,19,0,70,51
1657422827615,ECE 180,A00,083140,Abi Samra; Nicholas Camill,1,0,30,29
1657422827615,ECE 180,B00,083141,Abi Samra; Nicholas Camill,0,0,30,30
1657422833643,MATH 10A,A01,083735,Patchell; Gregory David,2,0,30,28
1657422833643,MATH 10A,A02,083736,Patchell; Gregory David,20,0,30,10
1657422833643,MATH 10A,A03,083737,Patchell; Gregory David,16,0,30,14
1657422839672,MATH 10B,A01,083207,Lim; Seonhee,8,0,34,26
1657422839672,MATH 10B,A02,083208,Lim; Seonhee,9,0,35,26
1657422839672,MATH 10B,A03,093472,Lim; Seonhee,7,0,34,27
1657422839672,MATH 10B,B01,083739,Sinha; Shubham,12,0,30,18
1657422845695,MATH 18,A01,083743,Cinel; Cameron Alexander,7,0,30,23
1657422845695,MATH 18,A02,083744,Cinel; Cameron Alexander,17,0,30,13
1657422845695,MATH 18,A03,083745,Cinel; Cameron Alexander,9,0,30,21
1657422845695,MATH 18,B01,083748,Rideout; David Porter,5,0,37,32
1657422845695,MATH 18,B02,083749,Rideout; David Porter,5,0,36,31
1657422845695,MATH 18,B03,083750,Rideout; David Porter,3,0,37,34
1657422845695,MATH 18,B04,083751,Rideout; David Porter,6,0,36,30
1657422845695,MATH 18,B05,093473,Rideout; David Porter,6,0,36,30
1657422845695,MATH 18,B06,093474,Rideout; David Porter,6,0,36,30
1657422851719,MATH 20A,A01,083754,Zheng; Zequn,14,0,40,26
1657422857745,MATH 20B,A01,083756,Briones; Jor-el Thomas Caparas,4,0,36,32
1657422857745,MATH 20B,A02,083757,Briones; Jor-el Thomas Caparas,1,0,36,35
1657422857745,MATH 20B,A03,093475,Briones; Jor-el Thomas Caparas,2,0,36,34
1657422863775,MATH 20C,A01,083760,Briones; Jor-el Thomas Caparas,1,0,35,34
1657422863775,MATH 20C,A02,083761,Briones; Jor-el Thomas Caparas,8,0,35,27
1657422863775,MATH 20C,A03,093476,Briones; Jor-el Thomas Caparas,0,1,36,36
1657422863775,MATH 20C,B01,083762,Bach; Quang Tran,1,0,30,29
1657422869799,MATH 20D,A01,083765,Tran; Brian Kha,5,0,30,25
1657422869799,MATH 20D,A02,083766,Tran; Brian Kha,5,0,30,25
1657422869799,MATH 20D,A03,083767,Tran; Brian Kha,5,0,30,25
1657422875821,MATH 20E,A01,083771,Ganguly; Soumya,9,0,32,23
1657422875821,MATH 20E,A02,083772,Ganguly; Soumya,6,0,32,26
1657422875821,MATH 20E,B01,083773,Ciotti; Benjamin,20,0,35,15
1657422875821,MATH 20E,B02,083774,Ciotti; Benjamin,17,0,35,18
1657422881846,MATH 103A,A01,083777,Greenfeld; Be'Eri,3,0,36,33
1657422881846,MATH 103A,A02,083778,Greenfeld; Be'Eri,5,0,36,31
1657422881846,MATH 103A,A03,093561,Greenfeld; Be'Eri,5,0,36,31
1657422881846,MATH 103A,B01,083779,Greenfeld; Be'Eri,7,0,36,29
1657422881846,MATH 103A,B02,083780,Greenfeld; Be'Eri,4,0,36,32
1657422881846,MATH 103A,B03,093562,Greenfeld; Be'Eri,3,0,36,33
1657422887872,MATH 105,A01,085443,Carter; Anne Toulson,15,0,35,20
1657422887872,MATH 105,A02,093477,Carter; Anne Toulson,20,0,35,15
1657422893897,MATH 109,A01,083213,Ganzberger; Geoffrey Michael,2,0,34,32
1657422893897,MATH 109,A02,083214,Ganzberger; Geoffrey Michael,4,0,34,30
1657422893897,MATH 109,A03,093478,Ganzberger; Geoffrey Michael,2,0,34,32
1657422893897,MATH 109,B01,083215,Ganzberger; Geoffrey Michael,1,0,32,31
1657422893897,MATH 109,B02,083216,Ganzberger; Geoffrey Michael,2,0,32,30
1657422893897,MATH 109,B03,093479,Ganzberger; Geoffrey Michael,8,0,32,24
1657422899926,MATH 142A,A01,083219,Chow; Bennett,7,0,32,25
1657422899926,MATH 142A,A02,083220,Chow; Bennett,10,0,32,22
1657422899926,MATH 142A,A03,093480,Chow; Bennett,8,0,32,24
1657422899926,MATH 142A,B03,093481,Chow; Bennett,8,0,32,24
1657422899926,MATH 142A,B04,093558,Chow; Bennett,13,0,32,19
1657422899926,MATH 142A,B05,093559,Chow; Bennett,6,0,32,26
1657422905949,MATH 193A,A01,083224,Rotar; Vladimir,8,0,34,26
1657422905949,MATH 193A,A02,083225,Rotar; Vladimir,9,0,34,25
1657422905949,MATH 193A,A03,083781,Rotar; Vladimir,5,0,34,29
1657422905949,MATH 193A,A04,083782,Rotar; Vladimir,10,0,34,24
1657422905949,MATH 193A,A05,093482,Rotar; Vladimir,10,0,34,24
1657422911971,MATH 197,001,091859,McAuley; Julian John,9999,0,9999,0
1657422911971,MATH 197,002,095566,Kedlaya; Kiran S.,9997,0,9999,2
1657422911971,MATH 197,003,095567,Xiao; Ming,9999,0,9999,0
1657422911971,MATH 197,004,095571,Perols; Johan Lars,9998,0,9999,1
1657422919040,COGS 9,A01,083615,Shannon; Kyle Michael,9,0,75,66
1657422925064,COGS 11,A01,083617,Boyle; Mary E. T.,22,0,48,26
1657422931089,COGS 13,A01,083071,Bastos; Amalia Pinkusfeld,11,0,71,60
1657422937112,COGS 14A,A01,092681,Semenuks; Arturs,5,1,100,95
1657422943136,COGS 14B,A01,083073,Cheng; Tzu-Han,6,0,63,57
1657422949161,COGS 17,A01,092677,Semenuks; Arturs,6,0,81,75
1657422955185,COGS 100,A01,083619,Allen; Michael Gordon,17,0,70,53
1657422961210,COGS 101A,A01,083621,Davis; Joshua Daniel,9,0,68,59
1657422967232,COGS 101B,A01,091572,Allen; Michael Gordon,12,0,65,53
1657422973268,COGS 101C,A01,083625,Delgado; Tania,17,0,35,18
1657422979293,COGS 107A,A01,083627,Boyle; Mary E. T.,13,0,60,47
1657422985317,COGS 118A,A01,083075,Gupta; Anjum,21,0,76,55
1657422991340,CSE 3,A50,083646,Miranda; Gregory Joseph,24,0,50,26
1657422997368,CSE 8A,A50,083650,Miranda; Gregory Joseph,17,1,56,39
1657423003392,CSE 11,A01,083080,Cao; Yingjun,6,15,40,34
1657423009423,CSE 12,A01,083652,Krause-Levy; Sophia Louisa,28,1,120,92
1657423015449,CSE 15L,A01,083654,Morris; Justin Loren,9,0,50,41
1657423015449,CSE 15L,A02,083655,Morris; Justin Loren,9,0,50,41
1657423021487,CSE 20,A01,083657,Tran; Khoa Dang,39,0,80,41
1657423027514,CSE 21,A01,095574,Bach; Quang Tran,22,0,48,26
1657423033537,CSE 30,A01,083084,Eldon; John,4,0,80,76
1657423033537,CSE 30,B01,095061,Bhaskar; Nishant,9,0,50,41
1657423039564,CSE 100,A01,083659,Cao; Yingjun,5,4,70,65
1657423045589,CSE 134B,A01,083661,Powell; Thomas Allan,22,0,100,78
1657423051611,CSE 140,A01,083663,Gungor; Onat,15,0,85,70
1657423057635,CSE 140L,A01,083088,Eldon; John,21,0,100,79
1657423063659,CSE 175,A01,083665,Kumar; Rakesh,3,0,25,22
1657423069684,CSE 190,A00,092507,Dubnov; Shlomo,7,0,20,13
1657423075707,ECE 45,A01,083139,Congero; Spencer William,6,0,75,69
1657423081733,ECE 65,A50,083695,Saad; Andrew S,12,0,30,18
1657423081733,ECE 65,A51,095125,Saad; Andrew S,24,0,26,2
1657423087757,ECE 109,A01,091882,Touri; Behrouz,19,0,70,51
1657423093781,ECE 180,A00,083140,Abi Samra; Nicholas Camill,1,0,30,29
1657423093781,ECE 180,B00,083141,Abi Samra; Nicholas Camill,0,0,30,30
1657423099810,MATH 10A,A01,083735,Patchell; Gregory David,2,0,30,28
1657423099810,MATH 10A,A02,083736,Patchell; Gregory David,20,0,30,10
1657423099810,MATH 10A,A03,083737,Patchell; Gregory David,16,0,30,14
1657423105835,MATH 10B,A01,083207,Lim; Seonhee,8,0,34,26
1657423105835,MATH 10B,A02,083208,Lim; Seonhee,9,0,35,26
1657423105835,MATH 10B,A03,093472,Lim; Seonhee,7,0,34,27
1657423105835,MATH 10B,B01,083739,Sinha; Shubham,12,0,30,18
1657423111863,MATH 18,A01,083743,Cinel; Cameron Alexander,7,0,30,23
1657423111863,MATH 18,A02,083744,Cinel; Cameron Alexander,17,0,30,13
1657423111863,MATH 18,A03,083745,Cinel; Cameron Alexander,9,0,30,21
1657423111863,MATH 18,B01,083748,Rideout; David Porter,5,0,37,32
1657423111863,MATH 18,B02,083749,Rideout; David Porter,5,0,36,31
1657423111863,MATH 18,B03,083750,Rideout; David Porter,3,0,37,34
1657423111863,MATH 18,B04,083751,Rideout; David Porter,6,0,36,30
1657423111863,MATH 18,B05,093473,Rideout; David Porter,6,0,36,30
1657423111863,MATH 18,B06,093474,Rideout; David Porter,6,0,36,30
1657423117889,MATH 20A,A01,083754,Zheng; Zequn,14,0,40,26
1657423123911,MATH 20B,A01,083756,Briones; Jor-el Thomas Caparas,4,0,36,32
1657423123911,MATH 20B,A02,083757,Briones; Jor-el Thomas Caparas,1,0,36,35
1657423123911,MATH 20B,A03,093475,Briones; Jor-el Thomas Caparas,2,0,36,34
1657423129935,MATH 20C,A01,083760,Briones; Jor-el Thomas Caparas,1,0,35,34
1657423129935,MATH 20C,A02,083761,Briones; Jor-el Thomas Caparas,8,0,35,27
1657423129935,MATH 20C,A03,093476,Briones; Jor-el Thomas Caparas,0,1,36,36
1657423129935,MATH 20C,B01,083762,Bach; Quang Tran,1,0,30,29
1657423135962,MATH 20D,A01,083765,Tran; Brian Kha,5,0,30,25
1657423135962,MATH 20D,A02,083766,Tran; Brian Kha,5,0,30,25
1657423135962,MATH 20D,A03,083767,Tran; Brian Kha,5,0,30,25
1657423141986,MATH 20E,A01,083771,Ganguly; Soumya,9,0,32,23
1657423141986,MATH 20E,A02,083772,Ganguly; Soumya,6,0,32,26
1657423141986,MATH 20E,B01,083773,Ciotti; Benjamin,20,0,35,15
1657423141986,MATH 20E,B02,083774,Ciotti; Benjamin,17,0,35,18
1657423148012,MATH 103A,A01,083777,Greenfeld; Be'Eri,3,0,36,33
1657423148012,MATH 103A,A02,083778,Greenfeld; Be'Eri,5,0,36,31
1657423148012,MATH 103A,A03,093561,Greenfeld; Be'Eri,5,0,36,31
1657423148012,MATH 103A,B01,083779,Greenfeld; Be'Eri,7,0,36,29
1657423148012,MATH 103A,B02,083780,Greenfeld; Be'Eri,4,0,36,32
1657423148012,MATH 103A,B03,093562,Greenfeld; Be'Eri,3,0,36,33
1657423154039,MATH 105,A01,085443,Carter; Anne Toulson,15,0,35,20
1657423154039,MATH 105,A02,093477,Carter; Anne Toulson,20,0,35,15
1657423160066,MATH 109,A01,083213,Ganzberger; Geoffrey Michael,2,0,34,32
1657423160066,MATH 109,A02,083214,Ganzberger; Geoffrey Michael,4,0,34,30
1657423160066,MATH 109,A03,093478,Ganzberger; Geoffrey Michael,2,0,34,32
1657423160066,MATH 109,B01,083215,Ganzberger; Geoffrey Michael,1,0,32,31
1657423160066,MATH 109,B02,083216,Ganzberger; Geoffrey Michael,2,0,32,30
1657423160066,MATH 109,B03,093479,Ganzberger; Geoffrey Michael,8,0,32,24
1657423166094,MATH 142A,A01,083219,Chow; Bennett,7,0,32,25
1657423166094,MATH 142A,A02,083220,Chow; Bennett,10,0,32,22
1657423166094,MATH 142A,A03,093480,Chow; Bennett,8,0,32,24
1657423166094,MATH 142A,B03,093481,Chow; Bennett,8,0,32,24
1657423166094,MATH 142A,B04,093558,Chow; Bennett,13,0,32,19
1657423166094,MATH 142A,B05,093559,Chow; Bennett,6,0,32,26
1657423172117,MATH 193A,A01,083224,Rotar; Vladimir,8,0,34,26
1657423172117,MATH 193A,A02,083225,Rotar; Vladimir,9,0,34,25
1657423172117,MATH 193A,A03,083781,Rotar; Vladimir,5,0,34,29
1657423172117,MATH 193A,A04,083782,Rotar; Vladimir,10,0,34,24
1657423172117,MATH 193A,A05,093482,Rotar; Vladimir,10,0,34,24
1657423178140,MATH 197,001,091859,McAuley; Julian John,9999,0,9999,0
1657423178140,MATH 197,002,095566,Kedlaya; Kiran S.,9997,0,9999,2
1657423178140,MATH 197,003,095567,Xiao; Ming,9999,0,9999,0
1657423178140,MATH 197,004,095571,Perols; Johan Lars,9998,0,9999,1
1657423185206,COGS 9,A01,083615,Shannon; Kyle Michael,9,0,75,66
1657423191230,COGS 11,A01,083617,Boyle; Mary E. T.,22,0,48,26
1657423197258,COGS 13,A01,083071,Bastos; Amalia Pinkusfeld,11,0,71,60
1657423203287,COGS 14A,A01,092681,Semenuks; Arturs,5,1,100,95
1657423209309,COGS 14B,A01,083073,Cheng; Tzu-Han,6,0,63,57
1657423215342,COGS 17,A01,092677,Semenuks; Arturs,6,0,81,75
1657423221364,COGS 100,A01,083619,Allen; Michael Gordon,17,0,70,53
1657423227387,COGS 101A,A01,083621,Davis; Joshua Daniel,9,0,68,59
1657423233410,COGS 101B,A01,091572,Allen; Michael Gordon,12,0,65,53
1657423239438,COGS 101C,A01,083625,Delgado; Tania,17,0,35,18
1657423245464,COGS 107A,A01,083627,Boyle; Mary E. T.,13,0,60,47
1657423251493,COGS 118A,A01,083075,Gupta; Anjum,21,0,76,55
1657423257517,CSE 3,A50,083646,Miranda; Gregory Joseph,24,0,50,26
1657423263543,CSE 8A,A50,083650,Miranda; Gregory Joseph,17,1,56,39
1657423269566,CSE 11,A01,083080,Cao; Yingjun,6,15,40,34
1657423275587,CSE 12,A01,083652,Krause-Levy; Sophia Louisa,28,1,120,92
1657423281610,CSE 15L,A01,083654,Morris; Justin Loren,9,0,50,41
1657423281610,CSE 15L,A02,083655,Morris; Justin Loren,9,0,50,41
1657423287723,CSE 20,A01,083657,Tran; Khoa Dang,39,0,80,41
1657423293745,CSE 21,A01,095574,Bach; Quang Tran,22,0,48,26
1657423299768,CSE 30,A01,083084,Eldon; John,4,0,80,76
1657423299768,CSE 30,B01,095061,Bhaskar; Nishant,9,0,50,41
1657423305794,CSE 100,A01,083659,Cao; Yingjun,5,4,70,65
1657423311818,CSE 134B,A01,083661,Powell; Thomas Allan,22,0,100,78
1657423317841,CSE 140,A01,083663,Gungor; Onat,15,0,85,70
1657423323867,CSE 140L,A01,083088,Eldon; John,21,0,100,79
1657423329896,CSE 175,A01,083665,Kumar; Rakesh,3,0,25,22
1657423335921,CSE 190,A00,092507,Dubnov; Shlomo,7,0,20,13
1657423341945,ECE 45,A01,083139,Congero; Spencer William,6,0,75,69
1657423347973,ECE 65,A50,083695,Saad; Andrew S,12,0,30,18
1657423347973,ECE 65,A51,095125,Saad; Andrew S,24,0,26,2
1657423353996,ECE 109,A01,091882,Touri; Behrouz,19,0,70,51
1657423360022,ECE 180,A00,083140,Abi Samra; Nicholas Camill,1,0,30,29
1657423360022,ECE 180,B00,083141,Abi Samra; Nicholas Camill,0,0,30,30
1657423366049,MATH 10A,A01,083735,Patchell; Gregory David,2,0,30,28
1657423366049,MATH 10A,A02,083736,Patchell; Gregory David,20,0,30,10
1657423366049,MATH 10A,A03,083737,Patchell; Gregory David,16,0,30,14
1657423372073,MATH 10B,A01,083207,Lim; Seonhee,8,0,34,26
1657423372073,MATH 10B,A02,083208,Lim; Seonhee,9,0,35,26
1657423372073,MATH 10B,A03,093472,Lim; Seonhee,7,0,34,27
1657423372073,MATH 10B,B01,083739,Sinha; Shubham,12,0,30,18
1657423378099,MATH 18,A01,083743,Cinel; Cameron Alexander,7,0,30,23
1657423378099,MATH 18,A02,083744,Cinel; Cameron Alexander,17,0,30,13
1657423378099,MATH 18,A03,083745,Cinel; Cameron Alexander,9,0,30,21
1657423378099,MATH 18,B01,083748,Rideout; David Porter,5,0,37,32
1657423378099,MATH 18,B02,083749,Rideout; David Porter,5,0,36,31
1657423378099,MATH 18,B03,083750,Rideout; David Porter,3,0,37,34
1657423378099,MATH 18,B04,083751,Rideout; David Porter,6,0,36,30
1657423378099,MATH 18,B05,093473,Rideout; David Porter,6,0,36,30
1657423378099,MATH 18,B06,093474,Rideout; David Porter,6,0,36,30
1657423384123,MATH 20A,A01,083754,Zheng; Zequn,14,0,40,26
1657423390149,MATH 20B,A01,083756,Briones; Jor-el Thomas Caparas,4,0,36,32
1657423390149,MATH 20B,A02,083757,Briones; Jor-el Thomas Caparas,1,0,36,35
1657423390149,MATH 20B,A03,093475,Briones; Jor-el Thomas Caparas,2,0,36,34
1657423396176,MATH 20C,A01,083760,Briones; Jor-el Thomas Caparas,1,0,35,34
1657423396176,MATH 20C,A02,083761,Briones; Jor-el Thomas Caparas,8,0,35,27
1657423396176,MATH 20C,A03,093476,Briones; Jor-el Thomas Caparas,0,1,36,36
1657423396176,MATH 20C,B01,083762,Bach; Quang Tran,1,0,30,29
1657423402206,MATH 20D,A01,083765,Tran; Brian Kha,5,0,30,25
1657423402206,MATH 20D,A02,083766,Tran; Brian Kha,5,0,30,25
1657423402206,MATH 20D,A03,083767,Tran; Brian Kha,5,0,30,25
1657423408229,MATH 20E,A01,083771,Ganguly; Soumya,9,0,32,23
1657423408229,MATH 20E,A02,083772,Ganguly; Soumya,6,0,32,26
1657423408229,MATH 20E,B01,083773,Ciotti; Benjamin,20,0,35,15
1657423408229,MATH 20E,B02,083774,Ciotti; Benjamin,17,0,35,18
1657423414257,MATH 103A,A01,083777,Greenfeld; Be'Eri,3,0,36,33
1657423414257,MATH 103A,A02,083778,Greenfeld; Be'Eri,5,0,36,31
1657423414257,MATH 103A,A03,093561,Greenfeld; Be'Eri,5,0,36,31
1657423414257,MATH 103A,B01,083779,Greenfeld; Be'Eri,7,0,36,29
1657423414257,MATH 103A,B02,083780,Greenfeld; Be'Eri,4,0,36,32
1657423414257,MATH 103A,B03,093562,Greenfeld; Be'Eri,3,0,36,33
1657423420280,MATH 105,A01,085443,Carter; Anne Toulson,15,0,35,20
1657423420280,MATH 105,A02,093477,Carter; Anne Toulson,20,0,35,15
1657423426308,MATH 109,A01,083213,Ganzberger; Geoffrey Michael,2,0,34,32
1657423426308,MATH 109,A02,083214,Ganzberger; Geoffrey Michael,4,0,34,30
1657423426308,MATH 109,A03,093478,Ganzberger; Geoffrey Michael,2,0,34,32
1657423426308,MATH 109,B01,083215,Ganzberger; Geoffrey Michael,1,0,32,31
1657423426308,MATH 109,B02,083216,Ganzberger; Geoffrey Michael,2,0,32,30
1657423426308,MATH 109,B03,093479,Ganzberger; Geoffrey Michael,8,0,32,24
1657423432335,MATH 142A,A01,083219,Chow; Bennett,7,0,32,25
1657423432335,MATH 142A,A02,083220,Chow; Bennett,10,0,32,22
1657423432335,MATH 142A,A03,093480,Chow; Bennett,8,0,32,24
1657423432335,MATH 142A,B03,093481,Chow; Bennett,8,0,32,24
1657423432335,MATH 142A,B04,093558,Chow; Bennett,13,0,32,19
1657423432335,MATH 142A,B05,093559,Chow; Bennett,6,0,32,26
1657423438367,MATH 193A,A01,083224,Rotar; Vladimir,8,0,34,26
1657423438367,MATH 193A,A02,083225,Rotar; Vladimir,9,0,34,25
1657423438367,MATH 193A,A03,083781,Rotar; Vladimir,5,0,34,29
1657423438367,MATH 193A,A04,083782,Rotar; Vladimir,10,0,34,24
1657423438367,MATH 193A,A05,093482,Rotar; Vladimir,10,0,34,24
1657423444392,MATH 197,001,091859,McAuley; Julian John,9999,0,9999,0
1657423444392,MATH 197,002,095566,Kedlaya; Kiran S.,9997,0,9999,2
1657423444392,MATH 197,003,095567,Xiao; Ming,9999,0,9999,0
1657423444392,MATH 197,004,095571,Perols; Johan Lars,9998,0,9999,1
1657423451454,COGS 9,A01,083615,Shannon; Kyle Michael,9,0,75,66
1657423457476,COGS 11,A01,083617,Boyle; Mary E. T.,22,0,48,26
1657423463502,COGS 13,A01,083071,Bastos; Amalia Pinkusfeld,11,0,71,60
1657423469525,COGS 14A,A01,092681,Semenuks; Arturs,5,1,100,95
1657423475550,COGS 14B,A01,083073,Cheng; Tzu-Han,6,0,63,57
1657423481574,COGS 17,A01,092677,Semenuks; Arturs,6,0,81,75
1657423487600,COGS 100,A01,083619,Allen; Michael Gordon,17,0,70,53
1657423493626,COGS 101A,A01,083621,Davis; Joshua Daniel,9,0,68,59
1657423499650,COGS 101B,A01,091572,Allen; Michael Gordon,12,0,65,53
1657423505675,COGS 101C,A01,083625,Delgado; Tania,17,0,35,18
1657423511703,COGS 107A,A01,083627,Boyle; Mary E. T.,13,0,60,47
1657423517727,COGS 118A,A01,083075,Gupta; Anjum,21,0,76,55
1657423523761,CSE 3,A50,083646,Miranda; Gregory Joseph,24,0,50,26
1657423529785,CSE 8A,A50,083650,Miranda; Gregory Joseph,17,1,56,39
1657423535813,CSE 11,A01,083080,Cao; Yingjun,6,15,40,34
1657423541839,CSE 12,A01,083652,Krause-Levy; Sophia Louisa,28,1,120,92
1657423547869,CSE 15L,A01,083654,Morris; Justin Loren,9,0,50,41
1657423547869,CSE 15L,A02,083655,Morris; Justin Loren,9,0,50,41
1657423553893,CSE 20,A01,083657,Tran; Khoa Dang,39,0,80,41
1657423559917,CSE 21,A01,095574,Bach; Quang Tran,22,0,48,26
1657423565944,CSE 30,A01,083084,Eldon; John,4,0,80,76
1657423565944,CSE 30,B01,095061,Bhaskar; Nishant,9,0,50,41
1657423571971,CSE 100,A01,083659,Cao; Yingjun,5,4,70,65
1657423577996,CSE 134B,A01,083661,Powell; Thomas Allan,22,0,100,78
1657423584020,CSE 140,A01,083663,Gungor; Onat,15,0,85,70
1657423590043,CSE 140L,A01,083088,Eldon; John,21,0,100,79
1657423596064,CSE 175,A01,083665,Kumar; Rakesh,3,0,25,22
1657423602090,CSE 190,A00,092507,Dubnov; Shlomo,7,0,20,13
1657423608113,ECE 45,A01,083139,Congero; Spencer William,6,0,75,69
1657423614137,ECE 65,A50,083695,Saad; Andrew S,12,0,30,18
1657423614137,ECE 65,A51,095125,Saad; Andrew S,24,0,26,2
1657423620162,ECE 109,A01,091882,Touri; Behrouz,19,0,70,51
1657423626185,ECE 180,A00,083140,Abi Samra; Nicholas Camill,1,0,30,29
1657423626185,ECE 180,B00,083141,Abi Samra; Nicholas Camill,0,0,30,30
1657423632212,MATH 10A,A01,083735,Patchell; Gregory David,2,0,30,28
1657423632212,MATH 10A,A02,083736,Patchell; Gregory David,20,0,30,10
1657423632212,MATH 10A,A03,083737,Patchell; Gregory David,16,0,30,14
1657423638235,MATH 10B,A01,083207,Lim; Seonhee,8,0,34,26
1657423638235,MATH 10B,A02,083208,Lim; Seonhee,9,0,35,26
1657423638235,MATH 10B,A03,093472,Lim; Seonhee,7,0,34,27
1657423638235,MATH 10B,B01,083739,Sinha; Shubham,12,0,30,18
1657423644259,MATH 18,A01,083743,Cinel; Cameron Alexander,7,0,30,23
1657423644259,MATH 18,A02,083744,Cinel; Cameron Alexander,17,0,30,13
1657423644259,MATH 18,A03,083745,Cinel; Cameron Alexander,9,0,30,21
1657423644259,MATH 18,B01,083748,Rideout; David Porter,5,0,37,32
1657423644259,MATH 18,B02,083749,Rideout; David Porter,5,0,36,31
1657423644259,MATH 18,B03,083750,Rideout; David Porter,3,0,37,34
1657423644259,MATH 18,B04,083751,Rideout; David Porter,6,0,36,30
1657423644259,MATH 18,B05,093473,Rideout; David Porter,6,0,36,30
1657423644259,MATH 18,B06,093474,Rideout; David Porter,6,0,36,30
1657423650285,MATH 20A,A01,083754,Zheng; Zequn,14,0,40,26
1657423656318,MATH 20B,A01,083756,Briones; Jor-el Thomas Caparas,4,0,36,32
1657423656318,MATH 20B,A02,083757,Briones; Jor-el Thomas Caparas,1,0,36,35
1657423656318,MATH 20B,A03,093475,Briones; Jor-el Thomas Caparas,2,0,36,34
1657423662342,MATH 20C,A01,083760,Briones; Jor-el Thomas Caparas,1,0,35,34
1657423662342,MATH 20C,A02,083761,Briones; Jor-el Thomas Caparas,8,0,35,27
1657423662342,MATH 20C,A03,093476,Briones; Jor-el Thomas Caparas,0,1,36,36
1657423662342,MATH 20C,B01,083762,Bach; Quang Tran,1,0,30,29
1657423668370,MATH 20D,A01,083765,Tran; Brian Kha,5,0,30,25
1657423668370,MATH 20D,A02,083766,Tran; Brian Kha,5,0,30,25
1657423668370,MATH 20D,A03,083767,Tran; Brian Kha,5,0,30,25
1657423674401,MATH 20E,A01,083771,Ganguly; Soumya,9,0,32,23
1657423674401,MATH 20E,A02,083772,Ganguly; Soumya,6,0,32,26
1657423674401,MATH 20E,B01,083773,Ciotti; Benjamin,20,0,35,15
1657423674401,MATH 20E,B02,083774,Ciotti; Benjamin,17,0,35,18
1657423680444,MATH 103A,A01,083777,Greenfeld; Be'Eri,3,0,36,33
1657423680444,MATH 103A,A02,083778,Greenfeld; Be'Eri,5,0,36,31
1657423680444,MATH 103A,A03,093561,Greenfeld; Be'Eri,5,0,36,31
1657423680444,MATH 103A,B01,083779,Greenfeld; Be'Eri,7,0,36,29
1657423680444,MATH 103A,B02,083780,Greenfeld; Be'Eri,4,0,36,32
1657423680444,MATH 103A,B03,093562,Greenfeld; Be'Eri,3,0,36,33
1657423686466,MATH 105,A01,085443,Carter; Anne Toulson,15,0,35,20
1657423686466,MATH 105,A02,093477,Carter; Anne Toulson,20,0,35,15
1657423692494,MATH 109,A01,083213,Ganzberger; Geoffrey Michael,2,0,34,32
1657423692494,MATH 109,A02,083214,Ganzberger; Geoffrey Michael,4,0,34,30
1657423692494,MATH 109,A03,093478,Ganzberger; Geoffrey Michael,2,0,34,32
1657423692494,MATH 109,B01,083215,Ganzberger; Geoffrey Michael,1,0,32,31
1657423692494,MATH 109,B02,083216,Ganzberger; Geoffrey Michael,2,0,32,30
1657423692494,MATH 109,B03,093479,Ganzberger; Geoffrey Michael,8,0,32,24
1657423698523,MATH 142A,A01,083219,Chow; Bennett,7,0,32,25
1657423698523,MATH 142A,A02,083220,Chow; Bennett,10,0,32,22
1657423698523,MATH 142A,A03,093480,Chow; Bennett,8,0,32,24
1657423698523,MATH 142A,B03,093481,Chow; Bennett,8,0,32,24
1657423698523,MATH 142A,B04,093558,Chow; Bennett,13,0,32,19
1657423698523,MATH 142A,B05,093559,Chow; Bennett,6,0,32,26
1657423704547,MATH 193A,A01,083224,Rotar; Vladimir,8,0,34,26
1657423704547,MATH 193A,A02,083225,Rotar; Vladimir,9,0,34,25
1657423704547,MATH 193A,A03,083781,Rotar; Vladimir,5,0,34,29
1657423704547,MATH 193A,A04,083782,Rotar; Vladimir,10,0,34,24
1657423704547,MATH 193A,A05,093482,Rotar; Vladimir,10,0,34,24
1657423710579,MATH 197,001,091859,McAuley; Julian John,9999,0,9999,0
1657423710579,MATH 197,002,095566,Kedlaya; Kiran S.,9997,0,9999,2
1657423710579,MATH 197,003,095567,Xiao; Ming,9999,0,9999,0
1657423710579,MATH 197,004,095571,Perols; Johan Lars,9998,0,9999,1
1657423717630,COGS 9,A01,083615,Shannon; Kyle Michael,9,0,75,66
1657423723657,COGS 11,A01,083617,Boyle; Mary E. T.,22,0,48,26
1657423729685,COGS 13,A01,083071,Bastos; Amalia Pinkusfeld,11,0,71,60
1657423735709,COGS 14A,A01,092681,Semenuks; Arturs,5,1,100,95
1657423741735,COGS 14B,A01,083073,Cheng; Tzu-Han,6,0,63,57
1657423747759,COGS 17,A01,092677,Semenuks; Arturs,6,0,81,75
1657423753785,COGS 100,A01,083619,Allen; Michael Gordon,17,0,70,53
1657423759810,COGS 101A,A01,083621,Davis; Joshua Daniel,9,0,68,59
1657423765832,COGS 101B,A01,091572,Allen; Michael Gordon,12,0,65,53
1657423771863,COGS 101C,A01,083625,Delgado; Tania,17,0,35,18
1657423777885,COGS 107A,A01,083627,Boyle; Mary E. T.,13,0,60,47
1657423783908,COGS 118A,A01,083075,Gupta; Anjum,21,0,76,55
1657423789937,CSE 3,A50,083646,Miranda; Gregory Joseph,24,0,50,26
1657423795966,CSE 8A,A50,083650,Miranda; Gregory Joseph,17,1,56,39
1657423801991,CSE 11,A01,083080,Cao; Yingjun,6,15,40,34
1657423808013,CSE 12,A01,083652,Krause-Levy; Sophia Louisa,28,1,120,92
1657423814036,CSE 15L,A01,083654,Morris; Justin Loren,9,0,50,41
1657423814036,CSE 15L,A02,083655,Morris; Justin Loren,9,0,50,41
1657423820059,CSE 20,A01,083657,Tran; Khoa Dang,39,0,80,41
1657423826086,CSE 21,A01,095574,Bach; Quang Tran,22,0,48,26
1657423832113,CSE 30,A01,083084,Eldon; John,4,0,80,76
1657423832113,CSE 30,B01,095061,Bhaskar; Nishant,9,0,50,41
1657423838140,CSE 100,A01,083659,Cao; Yingjun,5,4,70,65
1657423844165,CSE 134B,A01,083661,Powell; Thomas Allan,22,0,100,78
1657423850189,CSE 140,A01,083663,Gungor; Onat,15,0,85,70
1657423856212,CSE 140L,A01,083088,Eldon; John,21,0,100,79
1657423862241,CSE 175,A01,083665,Kumar; Rakesh,3,0,25,22
1657423868267,CSE 190,A00,092507,Dubnov; Shlomo,7,0,20,13
1657423874290,ECE 45,A01,083139,Congero; Spencer William,6,0,75,69
1657423880318,ECE 65,A50,083695,Saad; Andrew S,12,0,30,18
1657423880318,ECE 65,A51,095125,Saad; Andrew S,24,0,26,2
1657423886418,ECE 109,A01,091882,Touri; Behrouz,19,0,70,51
1657423892446,ECE 180,A00,083140,Abi Samra; Nicholas Camill,1,0,30,29
1657423892446,ECE 180,B00,083141,Abi Samra; Nicholas Camill,0,0,30,30
1657423898473,MATH 10A,A01,083735,Patchell; Gregory David,2,0,30,28
1657423898473,MATH 10A,A02,083736,Patchell; Gregory David,20,0,30,10
1657423898473,MATH 10A,A03,083737,Patchell; Gregory David,16,0,30,14
1657423904498,MATH 10B,A01,083207,Lim; Seonhee,8,0,34,26
1657423904498,MATH 10B,A02,083208,Lim; Seonhee,9,0,35,26
1657423904498,MATH 10B,A03,093472,Lim; Seonhee,7,0,34,27
1657423904498,MATH 10B,B01,083739,Sinha; Shubham,12,0,30,18
1657423910528,MATH 18,A01,083743,Cinel; Cameron Alexander,7,0,30,23
1657423910528,MATH 18,A02,083744,Cinel; Cameron Alexander,17,0,30,13
1657423910528,MATH 18,A03,083745,Cinel; Cameron Alexander,9,0,30,21
1657423910528,MATH 18,B01,083748,Rideout; David Porter,5,0,37,32
1657423910528,MATH 18,B02,083749,Rideout; David Porter,5,0,36,31
1657423910528,MATH 18,B03,083750,Rideout; David Porter,3,0,37,34
1657423910528,MATH 18,B04,083751,Rideout; David Porter,6,0,36,30
1657423910528,MATH 18,B05,093473,Rideout; David Porter,6,0,36,30
1657423910528,MATH 18,B06,093474,Rideout; David Porter,6,0,36,30
1657423916551,MATH 20A,A01,083754,Zheng; Zequn,14,0,40,26
1657423922578,MATH 20B,A01,083756,Briones; Jor-el Thomas Caparas,4,0,36,32
1657423922578,MATH 20B,A02,083757,Briones; Jor-el Thomas Caparas,1,0,36,35
1657423922578,MATH 20B,A03,093475,Briones; Jor-el Thomas Caparas,2,0,36,34
1657423928602,MATH 20C,A01,083760,Briones; Jor-el Thomas Caparas,1,0,35,34
1657423928602,MATH 20C,A02,083761,Briones; Jor-el Thomas Caparas,8,0,35,27
1657423928602,MATH 20C,A03,093476,Briones; Jor-el Thomas Caparas,0,1,36,36
1657423928602,MATH 20C,B01,083762,Bach; Quang Tran,1,0,30,29
1657423934625,MATH 20D,A01,083765,Tran; Brian Kha,5,0,30,25
1657423934625,MATH 20D,A02,083766,Tran; Brian Kha,5,0,30,25
1657423934625,MATH 20D,A03,083767,Tran; Brian Kha,5,0,30,25
1657423940660,MATH 20E,A01,083771,Ganguly; Soumya,9,0,32,23
1657423940660,MATH 20E,A02,083772,Ganguly; Soumya,6,0,32,26
1657423940660,MATH 20E,B01,083773,Ciotti; Benjamin,20,0,35,15
1657423940660,MATH 20E,B02,083774,Ciotti; Benjamin,17,0,35,18
1657423946688,MATH 103A,A01,083777,Greenfeld; Be'Eri,3,0,36,33
1657423946688,MATH 103A,A02,083778,Greenfeld; Be'Eri,5,0,36,31
1657423946688,MATH 103A,A03,093561,Greenfeld; Be'Eri,5,0,36,31
1657423946688,MATH 103A,B01,083779,Greenfeld; Be'Eri,7,0,36,29
1657423946688,MATH 103A,B02,083780,Greenfeld; Be'Eri,4,0,36,32
1657423946688,MATH 103A,B03,093562,Greenfeld; Be'Eri,3,0,36,33
1657423952715,MATH 105,A01,085443,Carter; Anne Toulson,15,0,35,20
1657423952715,MATH 105,A02,093477,Carter; Anne Toulson,20,0,35,15
1657423958740,MATH 109,A01,083213,Ganzberger; Geoffrey Michael,2,0,34,32
1657423958740,MATH 109,A02,083214,Ganzberger; Geoffrey Michael,4,0,34,30
1657423958740,MATH 109,A03,093478,Ganzberger; Geoffrey Michael,2,0,34,32
1657423958740,MATH 109,B01,083215,Ganzberger; Geoffrey Michael,1,0,32,31
1657423958740,MATH 109,B02,083216,Ganzberger; Geoffrey Michael,2,0,32,30
1657423958740,MATH 109,B03,093479,Ganzberger; Geoffrey Michael,8,0,32,24
1657423964769,MATH 142A,A01,083219,Chow; Bennett,7,0,32,25
1657423964769,MATH 142A,A02,083220,Chow; Bennett,10,0,32,22
1657423964769,MATH 142A,A03,093480,Chow; Bennett,8,0,32,24
1657423964769,MATH 142A,B03,093481,Chow; Bennett,8,0,32,24
1657423964769,MATH 142A,B04,093558,Chow; Bennett,13,0,32,19
1657423964769,MATH 142A,B05,093559,Chow; Bennett,6,0,32,26
1657423970793,MATH 193A,A01,083224,Rotar; Vladimir,8,0,34,26
1657423970793,MATH 193A,A02,083225,Rotar; Vladimir,9,0,34,25
1657423970793,MATH 193A,A03,083781,Rotar; Vladimir,5,0,34,29
1657423970793,MATH 193A,A04,083782,Rotar; Vladimir,10,0,34,24
1657423970793,MATH 193A,A05,093482,Rotar; Vladimir,10,0,34,24
1657423976819,MATH 197,001,091859,McAuley; Julian John,9999,0,9999,0
1657423976819,MATH 197,002,095566,Kedlaya; Kiran S.,9997,0,9999,2
1657423976819,MATH 197,003,095567,Xiao; Ming,9999,0,9999,0
1657423976819,MATH 197,004,095571,Perols; Johan Lars,9998,0,9999,1
1657423983890,COGS 9,A01,083615,Shannon; Kyle Michael,9,0,75,66
1657423989914,COGS 11,A01,083617,Boyle; Mary E. T.,22,0,48,26
1657423995936,COGS 13,A01,083071,Bastos; Amalia Pinkusfeld,11,0,71,60
1657424001959,COGS 14A,A01,092681,Semenuks; Arturs,5,1,100,95
1657424007984,COGS 14B,A01,083073,Cheng; Tzu-Han,6,0,63,57
1657424014011,COGS 17,A01,092677,Semenuks; Arturs,6,0,81,75
1657424020035,COGS 100,A01,083619,Allen; Michael Gordon,17,0,70,53
1657424026061,COGS 101A,A01,083621,Davis; Joshua Daniel,9,0,68,59
1657424032085,COGS 101B,A01,091572,Allen; Michael Gordon,12,0,65,53
1657424038107,COGS 101C,A01,083625,Delgado; Tania,17,0,35,18
1657424044131,COGS 107A,A01,083627,Boyle; Mary E. T.,13,0,60,47
1657424050156,COGS 118A,A01,083075,Gupta; Anjum,21,0,76,55
1657424056180,CSE 3,A50,083646,Miranda; Gregory Joseph,24,0,50,26
1657424062206,CSE 8A,A50,083650,Miranda; Gregory Joseph,17,1,56,39
1657424068230,CSE 11,A01,083080,Cao; Yingjun,6,15,40,34
1657424074255,CSE 12,A01,083652,Krause-Levy; Sophia Louisa,28,1,120,92
1657424080282,CSE 15L,A01,083654,Morris; Justin Loren,9,0,50,41
1657424080282,CSE 15L,A02,083655,Morris; Justin Loren,9,0,50,41
1657424086309,CSE 20,A01,083657,Tran; Khoa Dang,39,0,80,41
1657424092330,CSE 21,A01,095574,Bach; Quang Tran,22,0,48,26
1657424098358,CSE 30,A01,083084,Eldon; John,4,0,80,76
1657424098358,CSE 30,B01,095061,Bhaskar; Nishant,9,0,50,41
1657424104380,CSE 100,A01,083659,Cao; Yingjun,5,4,70,65
1657424110403,CSE 134B,A01,083661,Powell; Thomas Allan,22,0,100,78
1657424116427,CSE 140,A01,083663,Gungor; Onat,15,0,85,70
1657424122453,CSE 140L,A01,083088,Eldon; John,21,0,100,79
1657424128475,CSE 175,A01,083665,Kumar; Rakesh,3,0,25,22
1657424134498,CSE 190,A00,092507,Dubnov; Shlomo,7,0,20,13
1657424140521,ECE 45,A01,083139,Congero; Spencer William,6,0,75,69
1657424146547,ECE 65,A50,083695,Saad; Andrew S,12,0,30,18
1657424146547,ECE 65,A51,095125,Saad; Andrew S,24,0,26,2
1657424152571,ECE 109,A01,091882,Touri; Behrouz,19,0,70,51
1657424158596,ECE 180,A00,083140,Abi Samra; Nicholas Camill,1,0,30,29
1657424158596,ECE 180,B00,083141,Abi Samra; Nicholas Camill,0,0,30,30
1657424164620,MATH 10A,A01,083735,Patchell; Gregory David,2,0,30,28
1657424164620,MATH 10A,A02,083736,Patchell; Gregory David,20,0,30,10
1657424164620,MATH 10A,A03,083737,Patchell; Gregory David,16,0,30,14
1657424170645,MATH 10B,A01,083207,Lim; Seonhee,8,0,34,26
1657424170645,MATH 10B,A02,083208,Lim; Seonhee,9,0,35,26
1657424170645,MATH 10B,A03,093472,Lim; Seonhee,7,0,34,27
1657424170645,MATH 10B,B01,083739,Sinha; Shubham,12,0,30,18
1657424176676,MATH 18,A01,083743,Cinel; Cameron Alexander,7,0,30,23
1657424176676,MATH 18,A02,083744,Cinel; Cameron Alexander,17,0,30,13
1657424176676,MATH 18,A03,083745,Cinel; Cameron Alexander,9,0,30,21
1657424176676,MATH 18,B01,083748,Rideout; David Porter,5,0,37,32
1657424176676,MATH 18,B02,083749,Rideout; David Porter,5,0,36,31
1657424176676,MATH 18,B03,083750,Rideout; David Porter,3,0,37,34
1657424176676,MATH 18,B04,083751,Rideout; David Porter,6,0,36,30
1657424176676,MATH 18,B05,093473,Rideout; David Porter,6,0,36,30
1657424176676,MATH 18,B06,093474,Rideout; David Porter,6,0,36,30
1657424182700,MATH 20A,A01,083754,Zheng; Zequn,14,0,40,26
1657424188722,MATH 20B,A01,083756,Briones; Jor-el Thomas Caparas,4,0,36,32
1657424188722,MATH 20B,A02,083757,Briones; Jor-el Thomas Caparas,1,0,36,35
1657424188722,MATH 20B,A03,093475,Briones; Jor-el Thomas Caparas,2,0,36,34
1657424194744,MATH 20C,A01,083760,Briones; Jor-el Thomas Caparas,1,0,35,34
1657424194744,MATH 20C,A02,083761,Briones; Jor-el Thomas Caparas,8,0,35,27
1657424194744,MATH 20C,A03,093476,Briones; Jor-el Thomas Caparas,0,1,36,36
1657424194744,MATH 20C,B01,083762,Bach; Quang Tran,1,0,30,29
1657424200768,MATH 20D,A01,083765,Tran; Brian Kha,5,0,30,25
1657424200768,MATH 20D,A02,083766,Tran; Brian Kha,5,0,30,25
1657424200768,MATH 20D,A03,083767,Tran; Brian Kha,5,0,30,25
1657424206790,MATH 20E,A01,083771,Ganguly; Soumya,9,0,32,23
1657424206790,MATH 20E,A02,083772,Ganguly; Soumya,6,0,32,26
1657424206790,MATH 20E,B01,083773,Ciotti; Benjamin,20,0,35,15
1657424206790,MATH 20E,B02,083774,Ciotti; Benjamin,17,0,35,18
1657424212817,MATH 103A,A01,083777,Greenfeld; Be'Eri,3,0,36,33
1657424212817,MATH 103A,A02,083778,Greenfeld; Be'Eri,5,0,36,31
1657424212817,MATH 103A,A03,093561,Greenfeld; Be'Eri,5,0,36,31
1657424212817,MATH 103A,B01,083779,Greenfeld; Be'Eri,7,0,36,29
1657424212817,MATH 103A,B02,083780,Greenfeld; Be'Eri,4,0,36,32
1657424212817,MATH 103A,B03,093562,Greenfeld; Be'Eri,3,0,36,33
1657424218840,MATH 105,A01,085443,Carter; Anne Toulson,15,0,35,20
1657424218840,MATH 105,A02,093477,Carter; Anne Toulson,20,0,35,15
1657424224870,MATH 109,A01,083213,Ganzberger; Geoffrey Michael,2,0,34,32
1657424224870,MATH 109,A02,083214,Ganzberger; Geoffrey Michael,4,0,34,30
1657424224870,MATH 109,A03,093478,Ganzberger; Geoffrey Michael,2,0,34,32
1657424224870,MATH 109,B01,083215,Ganzberger; Geoffrey Michael,1,0,32,31
1657424224870,MATH 109,B02,083216,Ganzberger; Geoffrey Michael,2,0,32,30
1657424224870,MATH 109,B03,093479,Ganzberger; Geoffrey Michael,8,0,32,24
1657424230899,MATH 142A,A01,083219,Chow; Bennett,7,0,32,25
1657424230899,MATH 142A,A02,083220,Chow; Bennett,10,0,32,22
1657424230899,MATH 142A,A03,093480,Chow; Bennett,8,0,32,24
1657424230899,MATH 142A,B03,093481,Chow; Bennett,8,0,32,24
1657424230899,MATH 142A,B04,093558,Chow; Bennett,13,0,32,19
1657424230899,MATH 142A,B05,093559,Chow; Bennett,6,0,32,26
1657424236927,MATH 193A,A01,083224,Rotar; Vladimir,8,0,34,26
1657424236927,MATH 193A,A02,083225,Rotar; Vladimir,9,0,34,25
1657424236927,MATH 193A,A03,083781,Rotar; Vladimir,5,0,34,29
1657424236927,MATH 193A,A04,083782,Rotar; Vladimir,10,0,34,24
1657424236927,MATH 193A,A05,093482,Rotar; Vladimir,10,0,34,24
1657424242954,MATH 197,001,091859,McAuley; Julian John,9999,0,9999,0
1657424242954,MATH 197,002,095566,Kedlaya; Kiran S.,9997,0,9999,2
1657424242954,MATH 197,003,095567,Xiao; Ming,9999,0,9999,0
1657424242954,MATH 197,004,095571,Perols; Johan Lars,9998,0,9999,1
1657424250016,COGS 9,A01,083615,Shannon; Kyle Michael,9,0,75,66
1657424256044,COGS 11,A01,083617,Boyle; Mary E. T.,22,0,48,26
1657424262066,COGS 13,A01,083071,Bastos; Amalia Pinkusfeld,11,0,71,60
1657424268093,COGS 14A,A01,092681,Semenuks; Arturs,5,1,100,95
1657424274116,COGS 14B,A01,083073,Cheng; Tzu-Han,6,0,63,57
1657424280145,COGS 17,A01,092677,Semenuks; Arturs,6,0,81,75
1657424286179,COGS 100,A01,083619,Allen; Michael Gordon,17,0,70,53
1657424292203,COGS 101A,A01,083621,Davis; Joshua Daniel,9,0,68,59
1657424298228,COGS 101B,A01,091572,Allen; Michael Gordon,12,0,65,53
1657424304256,COGS 101C,A01,083625,Delgado; Tania,17,0,35,18
1657424310284,COGS 107A,A01,083627,Boyle; Mary E. T.,13,0,60,47
1657424316310,COGS 118A,A01,083075,Gupta; Anjum,21,0,76,55
1657424322334,CSE 3,A50,083646,Miranda; Gregory Joseph,24,0,50,26
1657424328356,CSE 8A,A50,083650,Miranda; Gregory Joseph,17,1,56,39
1657424334378,CSE 11,A01,083080,Cao; Yingjun,6,15,40,34
1657424340404,CSE 12,A01,083652,Krause-Levy; Sophia Louisa,28,1,120,92
1657424346433,CSE 15L,A01,083654,Morris; Justin Loren,9,0,50,41
1657424346433,CSE 15L,A02,083655,Morris; Justin Loren,9,0,50,41
1657424352461,CSE 20,A01,083657,Tran; Khoa Dang,39,0,80,41
1657424358487,CSE 21,A01,095574,Bach; Quang Tran,22,0,48,26
1657424364511,CSE 30,A01,083084,Eldon; John,4,0,80,76
1657424364511,CSE 30,B01,095061,Bhaskar; Nishant,9,0,50,41
1657424370537,CSE 100,A01,083659,Cao; Yingjun,5,4,70,65
1657424376564,CSE 134B,A01,083661,Powell; Thomas Allan,22,0,100,78
1657424382589,CSE 140,A01,083663,Gungor; Onat,15,0,85,70
1657424388614,CSE 140L,A01,083088,Eldon; John,21,0,100,79
1657424394638,CSE 175,A01,083665,Kumar; Rakesh,3,0,25,22
1657424400661,CSE 190,A00,092507,Dubnov; Shlomo,7,0,20,13
1657424406686,ECE 45,A01,083139,Congero; Spencer William,6,0,75,69
1657424412720,ECE 65,A50,083695,Saad; Andrew S,12,0,30,18
1657424412720,ECE 65,A51,095125,Saad; Andrew S,24,0,26,2
1657424418744,ECE 109,A01,091882,Touri; Behrouz,19,0,70,51
1657424424768,ECE 180,A00,083140,Abi Samra; Nicholas Camill,1,0,30,29
1657424424768,ECE 180,B00,083141,Abi Samra; Nicholas Camill,0,0,30,30
1657424430790,MATH 10A,A01,083735,Patchell; Gregory David,2,0,30,28
1657424430790,MATH 10A,A02,083736,Patchell; Gregory David,20,0,30,10
1657424430790,MATH 10A,A03,083737,Patchell; Gregory David,16,0,30,14
1657424436818,MATH 10B,A01,083207,Lim; Seonhee,8,0,34,26
1657424436818,MATH 10B,A02,083208,Lim; Seonhee,9,0,35,26
1657424436818,MATH 10B,A03,093472,Lim; Seonhee,7,0,34,27
1657424436818,MATH 10B,B01,083739,Sinha; Shubham,12,0,30,18
1657424442849,MATH 18,A01,083743,Cinel; Cameron Alexander,7,0,30,23
1657424442849,MATH 18,A02,083744,Cinel; Cameron Alexander,17,0,30,13
1657424442849,MATH 18,A03,083745,Cinel; Cameron Alexander,9,0,30,21
1657424442849,MATH 18,B01,083748,Rideout; David Porter,5,0,37,32
1657424442849,MATH 18,B02,083749,Rideout; David Porter,5,0,36,31
1657424442849,MATH 18,B03,083750,Rideout; David Porter,3,0,37,34
1657424442849,MATH 18,B04,083751,Rideout; David Porter,6,0,36,30
1657424442849,MATH 18,B05,093473,Rideout; David Porter,6,0,36,30
1657424442849,MATH 18,B06,093474,Rideout; David Porter,6,0,36,30
1657424448871,MATH 20A,A01,083754,Zheng; Zequn,14,0,40,26
1657424454898,MATH 20B,A01,083756,Briones; Jor-el Thomas Caparas,4,0,36,32
1657424454898,MATH 20B,A02,083757,Briones; Jor-el Thomas Caparas,1,0,36,35
1657424454898,MATH 20B,A03,093475,Briones; Jor-el Thomas Caparas,2,0,36,34
1657424460925,MATH 20C,A01,083760,Briones; Jor-el Thomas Caparas,1,0,35,34
1657424460925,MATH 20C,A02,083761,Briones; Jor-el Thomas Caparas,8,0,35,27
1657424460925,MATH 20C,A03,093476,Briones; Jor-el Thomas Caparas,0,1,36,36
1657424460925,MATH 20C,B01,083762,Bach; Quang Tran,1,0,30,29
1657424466954,MATH 20D,A01,083765,Tran; Brian Kha,5,0,30,25
1657424466954,MATH 20D,A02,083766,Tran; Brian Kha,5,0,30,25
1657424466954,MATH 20D,A03,083767,Tran; Brian Kha,5,0,30,25
1657424472976,MATH 20E,A01,083771,Ganguly; Soumya,9,0,32,23
1657424472976,MATH 20E,A02,083772,Ganguly; Soumya,6,0,32,26
1657424472976,MATH 20E,B01,083773,Ciotti; Benjamin,20,0,35,15
1657424472976,MATH 20E,B02,083774,Ciotti; Benjamin,17,0,35,18
1657424479008,MATH 103A,A01,083777,Greenfeld; Be'Eri,3,0,36,33
1657424479008,MATH 103A,A02,083778,Greenfeld; Be'Eri,5,0,36,31
1657424479008,MATH 103A,A03,093561,Greenfeld; Be'Eri,5,0,36,31
1657424479008,MATH 103A,B01,083779,Greenfeld; Be'Eri,7,0,36,29
1657424479008,MATH 103A,B02,083780,Greenfeld; Be'Eri,4,0,36,32
1657424479008,MATH 103A,B03,093562,Greenfeld; Be'Eri,3,0,36,33
1657424485107,MATH 105,A01,085443,Carter; Anne Toulson,15,0,35,20
1657424485107,MATH 105,A02,093477,Carter; Anne Toulson,20,0,35,15
1657424491133,MATH 109,A01,083213,Ganzberger; Geoffrey Michael,2,0,34,32
1657424491133,MATH 109,A02,083214,Ganzberger; Geoffrey Michael,4,0,34,30
1657424491133,MATH 109,A03,093478,Ganzberger; Geoffrey Michael,2,0,34,32
1657424491133,MATH 109,B01,083215,Ganzberger; Geoffrey Michael,1,0,32,31
1657424491133,MATH 109,B02,083216,Ganzberger; Geoffrey Michael,2,0,32,30
1657424491133,MATH 109,B03,093479,Ganzberger; Geoffrey Michael,8,0,32,24
1657424497157,MATH 142A,A01,083219,Chow; Bennett,7,0,32,25
1657424497157,MATH 142A,A02,083220,Chow; Bennett,10,0,32,22
1657424497157,MATH 142A,A03,093480,Chow; Bennett,8,0,32,24
1657424497157,MATH 142A,B03,093481,Chow; Bennett,8,0,32,24
1657424497157,MATH 142A,B04,093558,Chow; Bennett,13,0,32,19
1657424497157,MATH 142A,B05,093559,Chow; Bennett,6,0,32,26
1657424503186,MATH 193A,A01,083224,Rotar; Vladimir,8,0,34,26
1657424503186,MATH 193A,A02,083225,Rotar; Vladimir,9,0,34,25
1657424503186,MATH 193A,A03,083781,Rotar; Vladimir,5,0,34,29
1657424503186,MATH 193A,A04,083782,Rotar; Vladimir,10,0,34,24
1657424503186,MATH 193A,A05,093482,Rotar; Vladimir,10,0,34,24
1657424509207,MATH 197,001,091859,McAuley; Julian John,9999,0,9999,0
1657424509207,MATH 197,002,095566,Kedlaya; Kiran S.,9997,0,9999,2
1657424509207,MATH 197,003,095567,Xiao; Ming,9999,0,9999,0
1657424509207,MATH 197,004,095571,Perols; Johan Lars,9998,0,9999,1
1657424516291,COGS 9,A01,083615,Shannon; Kyle Michael,9,0,75,66
1657424522326,COGS 11,A01,083617,Boyle; Mary E. T.,22,0,48,26
1657424528355,COGS 13,A01,083071,Bastos; Amalia Pinkusfeld,11,0,71,60
1657424534385,COGS 14A,A01,092681,Semenuks; Arturs,5,1,100,95
1657424540409,COGS 14B,A01,083073,Cheng; Tzu-Han,6,0,63,57
1657424546443,COGS 17,A01,092677,Semenuks; Arturs,6,0,81,75
1657424552466,COGS 100,A01,083619,Allen; Michael Gordon,17,0,70,53
1657424558490,COGS 101A,A01,083621,Davis; Joshua Daniel,9,0,68,59
1657424564525,COGS 101B,A01,091572,Allen; Michael Gordon,12,0,65,53
1657424570549,COGS 101C,A01,083625,Delgado; Tania,17,0,35,18
1657424576575,COGS 107A,A01,083627,Boyle; Mary E. T.,13,0,60,47
1657424582600,COGS 118A,A01,083075,Gupta; Anjum,21,0,76,55
1657424588628,CSE 3,A50,083646,Miranda; Gregory Joseph,24,0,50,26
1657424594659,CSE 8A,A50,083650,Miranda; Gregory Joseph,17,1,56,39
1657424600683,CSE 11,A01,083080,Cao; Yingjun,6,15,40,34
1657424606706,CSE 12,A01,083652,Krause-Levy; Sophia Louisa,28,1,120,92
1657424612735,CSE 15L,A01,083654,Morris; Justin Loren,9,0,50,41
1657424612735,CSE 15L,A02,083655,Morris; Justin Loren,9,0,50,41
1657424618762,CSE 20,A01,083657,Tran; Khoa Dang,39,0,80,41
1657424624788,CSE 21,A01,095574,Bach; Quang Tran,22,0,48,26
1657424630812,CSE 30,A01,083084,Eldon; John,4,0,80,76
1657424630812,CSE 30,B01,095061,Bhaskar; Nishant,9,0,50,41
1657424636835,CSE 100,A01,083659,Cao; Yingjun,5,4,70,65
1657424642857,CSE 134B,A01,083661,Powell; Thomas Allan,22,0,100,78
1657424648878,CSE 140,A01,083663,Gungor; Onat,15,0,85,70
1657424654905,CSE 140L,A01,083088,Eldon; John,21,0,100,79
1657424660930,CSE 175,A01,083665,Kumar; Rakesh,3,0,25,22
1657424666957,CSE 190,A00,092507,Dubnov; Shlomo,7,0,20,13
1657424672984,ECE 45,A01,083139,Congero; Spencer William,6,0,75,69
1657424679006,ECE 65,A50,083695,Saad; Andrew S,12,0,30,18
1657424679006,ECE 65,A51,095125,Saad; Andrew S,24,0,26,2
1657424685029,ECE 109,A01,091882,Touri; Behrouz,19,0,70,51
1657424691055,ECE 180,A00,083140,Abi Samra; Nicholas Camill,1,0,30,29
1657424691055,ECE 180,B00,083141,Abi Samra; Nicholas Camill,0,0,30,30
1657424697079,MATH 10A,A01,083735,Patchell; Gregory David,2,0,30,28
1657424697079,MATH 10A,A02,083736,Patchell; Gregory David,20,0,30,10
1657424697079,MATH 10A,A03,083737,Patchell; Gregory David,16,0,30,14
1657424703102,MATH 10B,A01,083207,Lim; Seonhee,8,0,34,26
1657424703102,MATH 10B,A02,083208,Lim; Seonhee,9,0,35,26
1657424703102,MATH 10B,A03,093472,Lim; Seonhee,7,0,34,27
1657424703102,MATH 10B,B01,083739,Sinha; Shubham,12,0,30,18
1657424709132,MATH 18,A01,083743,Cinel; Cameron Alexander,7,0,30,23
1657424709132,MATH 18,A02,083744,Cinel; Cameron Alexander,17,0,30,13
1657424709132,MATH 18,A03,083745,Cinel; Cameron Alexander,9,0,30,21
1657424709132,MATH 18,B01,083748,Rideout; David Porter,5,0,37,32
1657424709132,MATH 18,B02,083749,Rideout; David Porter,5,0,36,31
1657424709132,MATH 18,B03,083750,Rideout; David Porter,3,0,37,34
1657424709132,MATH 18,B04,083751,Rideout; David Porter,6,0,36,30
1657424709132,MATH 18,B05,093473,Rideout; David Porter,6,0,36,30
1657424709132,MATH 18,B06,093474,Rideout; David Porter,6,0,36,30
1657424715176,MATH 20A,A01,083754,Zheng; Zequn,14,0,40,26
1657424721209,MATH 20B,A01,083756,Briones; Jor-el Thomas Caparas,4,0,36,32
1657424721209,MATH 20B,A02,083757,Briones; Jor-el Thomas Caparas,1,0,36,35
1657424721209,MATH 20B,A03,093475,Briones; Jor-el Thomas Caparas,2,0,36,34
1657424727238,MATH 20C,A01,083760,Briones; Jor-el Thomas Caparas,1,0,35,34
1657424727238,MATH 20C,A02,083761,Briones; Jor-el Thomas Caparas,8,0,35,27
1657424727238,MATH 20C,A03,093476,Briones; Jor-el Thomas Caparas,0,1,36,36
1657424727238,MATH 20C,B01,083762,Bach; Quang Tran,1,0,30,29
1657424733259,MATH 20D,A01,083765,Tran; Brian Kha,5,0,30,25
1657424733259,MATH 20D,A02,083766,Tran; Brian Kha,5,0,30,25
1657424733259,MATH 20D,A03,083767,Tran; Brian Kha,5,0,30,25
1657424739284,MATH 20E,A01,083771,Ganguly; Soumya,9,0,32,23
1657424739284,MATH 20E,A02,083772,Ganguly; Soumya,6,0,32,26
1657424739284,MATH 20E,B01,083773,Ciotti; Benjamin,20,0,35,15
1657424739284,MATH 20E,B02,083774,Ciotti; Benjamin,17,0,35,18
1657424745315,MATH 103A,A01,083777,Greenfeld; Be'Eri,3,0,36,33
1657424745315,MATH 103A,A02,083778,Greenfeld; Be'Eri,5,0,36,31
1657424745315,MATH 103A,A03,093561,Greenfeld; Be'Eri,5,0,36,31
1657424745315,MATH 103A,B01,083779,Greenfeld; Be'Eri,7,0,36,29
1657424745315,MATH 103A,B02,083780,Greenfeld; Be'Eri,4,0,36,32
1657424745315,MATH 103A,B03,093562,Greenfeld; Be'Eri,3,0,36,33
1657424751342,MATH 105,A01,085443,Carter; Anne Toulson,15,0,35,20
1657424751342,MATH 105,A02,093477,Carter; Anne Toulson,20,0,35,15
1657424757366,MATH 109,A01,083213,Ganzberger; Geoffrey Michael,2,0,34,32
1657424757366,MATH 109,A02,083214,Ganzberger; Geoffrey Michael,4,0,34,30
1657424757366,MATH 109,A03,093478,Ganzberger; Geoffrey Michael,2,0,34,32
1657424757366,MATH 109,B01,083215,Ganzberger; Geoffrey Michael,1,0,32,31
1657424757366,MATH 109,B02,083216,Ganzberger; Geoffrey Michael,2,0,32,30
1657424757366,MATH 109,B03,093479,Ganzberger; Geoffrey Michael,8,0,32,24
1657424763395,MATH 142A,A01,083219,Chow; Bennett,7,0,32,25
1657424763395,MATH 142A,A02,083220,Chow; Bennett,10,0,32,22
1657424763395,MATH 142A,A03,093480,Chow; Bennett,8,0,32,24
1657424763395,MATH 142A,B03,093481,Chow; Bennett,8,0,32,24
1657424763395,MATH 142A,B04,093558,Chow; Bennett,13,0,32,19
1657424763395,MATH 142A,B05,093559,Chow; Bennett,6,0,32,26
1657424769424,MATH 193A,A01,083224,Rotar; Vladimir,8,0,34,26
1657424769424,MATH 193A,A02,083225,Rotar; Vladimir,9,0,34,25
1657424769424,MATH 193A,A03,083781,Rotar; Vladimir,5,0,34,29
1657424769424,MATH 193A,A04,083782,Rotar; Vladimir,10,0,34,24
1657424769424,MATH 193A,A05,093482,Rotar; Vladimir,10,0,34,24
1657424775446,MATH 197,001,091859,McAuley; Julian John,9999,0,9999,0
1657424775446,MATH 197,002,095566,Kedlaya; Kiran S.,9997,0,9999,2
1657424775446,MATH 197,003,095567,Xiao; Ming,9999,0,9999,0
1657424775446,MATH 197,004,095571,Perols; Johan Lars,9998,0,9999,1
1657424782511,COGS 9,A01,083615,Shannon; Kyle Michael,9,0,75,66
1657424788533,COGS 11,A01,083617,Boyle; Mary E. T.,22,0,48,26
1657424794559,COGS 13,A01,083071,Bastos; Amalia Pinkusfeld,11,0,71,60
1657424800582,COGS 14A,A01,092681,Semenuks; Arturs,5,1,100,95
1657424806606,COGS 14B,A01,083073,Cheng; Tzu-Han,6,0,63,57
1657424812630,COGS 17,A01,092677,Semenuks; Arturs,6,0,81,75
1657424818657,COGS 100,A01,083619,Allen; Michael Gordon,17,0,70,53
1657424824679,COGS 101A,A01,083621,Davis; Joshua Daniel,9,0,68,59
1657424830703,COGS 101B,A01,091572,Allen; Michael Gordon,12,0,65,53
1657424836725,COGS 101C,A01,083625,Delgado; Tania,17,0,35,18
1657424842747,COGS 107A,A01,083627,Boyle; Mary E. T.,13,0,60,47
1657424848771,COGS 118A,A01,083075,Gupta; Anjum,21,0,76,55
1657424854793,CSE 3,A50,083646,Miranda; Gregory Joseph,24,0,50,26
1657424860816,CSE 8A,A50,083650,Miranda; Gregory Joseph,17,1,56,39
1657424866842,CSE 11,A01,083080,Cao; Yingjun,6,15,40,34
1657424872866,CSE 12,A01,083652,Krause-Levy; Sophia Louisa,28,1,120,92
1657424878896,CSE 15L,A01,083654,Morris; Justin Loren,9,0,50,41
1657424878896,CSE 15L,A02,083655,Morris; Justin Loren,9,0,50,41
1657424884932,CSE 20,A01,083657,Tran; Khoa Dang,39,0,80,41
1657424890955,CSE 21,A01,095574,Bach; Quang Tran,22,0,48,26
1657424896993,CSE 30,A01,083084,Eldon; John,4,0,80,76
1657424896993,CSE 30,B01,095061,Bhaskar; Nishant,9,0,50,41
1657424903018,CSE 100,A01,083659,Cao; Yingjun,5,4,70,65
1657424909044,CSE 134B,A01,083661,Powell; Thomas Allan,22,0,100,78
1657424915071,CSE 140,A01,083663,Gungor; Onat,15,0,85,70
1657424921097,CSE 140L,A01,083088,Eldon; John,21,0,100,79
1657424927120,CSE 175,A01,083665,Kumar; Rakesh,3,0,25,22
1657424933149,CSE 190,A00,092507,Dubnov; Shlomo,7,0,20,13
1657424939177,ECE 45,A01,083139,Congero; Spencer William,6,0,75,69
1657424945200,ECE 65,A50,083695,Saad; Andrew S,12,0,30,18
1657424945200,ECE 65,A51,095125,Saad; Andrew S,24,0,26,2
1657424951226,ECE 109,A01,091882,Touri; Behrouz,19,0,70,51
1657424957249,ECE 180,A00,083140,Abi Samra; Nicholas Camill,1,0,30,29
1657424957249,ECE 180,B00,083141,Abi Samra; Nicholas Camill,0,0,30,30
1657424963276,MATH 10A,A01,083735,Patchell; Gregory David,2,0,30,28
1657424963276,MATH 10A,A02,083736,Patchell; Gregory David,20,0,30,10
1657424963276,MATH 10A,A03,083737,Patchell; Gregory David,16,0,30,14
1657424969304,MATH 10B,A01,083207,Lim; Seonhee,8,0,34,26
1657424969304,MATH 10B,A02,083208,Lim; Seonhee,9,0,35,26
1657424969304,MATH 10B,A03,093472,Lim; Seonhee,7,0,34,27
1657424969304,MATH 10B,B01,083739,Sinha; Shubham,12,0,30,18
1657424975336,MATH 18,A01,083743,Cinel; Cameron Alexander,7,0,30,23
1657424975336,MATH 18,A02,083744,Cinel; Cameron Alexander,17,0,30,13
1657424975336,MATH 18,A03,083745,Cinel; Cameron Alexander,9,0,30,21
1657424975336,MATH 18,B01,083748,Rideout; David Porter,5,0,37,32
1657424975336,MATH 18,B02,083749,Rideout; David Porter,5,0,36,31
1657424975336,MATH 18,B03,083750,Rideout; David Porter,3,0,37,34
1657424975336,MATH 18,B04,083751,Rideout; David Porter,6,0,36,30
1657424975336,MATH 18,B05,093473,Rideout; David Porter,6,0,36,30
1657424975336,MATH 18,B06,093474,Rideout; David Porter,6,0,36,30
1657424981358,MATH 20A,A01,083754,Zheng; Zequn,14,0,40,26
1657424987382,MATH 20B,A01,083756,Briones; Jor-el Thomas Caparas,4,0,36,32
1657424987382,MATH 20B,A02,083757,Briones; Jor-el Thomas Caparas,1,0,36,35
1657424987382,MATH 20B,A03,093475,Briones; Jor-el Thomas Caparas,2,0,36,34
1657424993405,MATH 20C,A01,083760,Briones; Jor-el Thomas Caparas,1,0,35,34
1657424993405,MATH 20C,A02,083761,Briones; Jor-el Thomas Caparas,8,0,35,27
1657424993405,MATH 20C,A03,093476,Briones; Jor-el Thomas Caparas,0,1,36,36
1657424993405,MATH 20C,B01,083762,Bach; Quang Tran,1,0,30,29
1657424999432,MATH 20D,A01,083765,Tran; Brian Kha,5,0,30,25
1657424999432,MATH 20D,A02,083766,Tran; Brian Kha,5,0,30,25
1657424999432,MATH 20D,A03,083767,Tran; Brian Kha,5,0,30,25
1657425005468,MATH 20E,A01,083771,Ganguly; Soumya,9,0,32,23
1657425005468,MATH 20E,A02,083772,Ganguly; Soumya,6,0,32,26
1657425005468,MATH 20E,B01,083773,Ciotti; Benjamin,20,0,35,15
1657425005468,MATH 20E,B02,083774,Ciotti; Benjamin,17,0,35,18
1657425011491,MATH 103A,A01,083777,Greenfeld; Be'Eri,3,0,36,33
1657425011491,MATH 103A,A02,083778,Greenfeld; Be'Eri,5,0,36,31
1657425011491,MATH 103A,A03,093561,Greenfeld; Be'Eri,5,0,36,31
1657425011491,MATH 103A,B01,083779,Greenfeld; Be'Eri,7,0,36,29
1657425011491,MATH 103A,B02,083780,Greenfeld; Be'Eri,4,0,36,32
1657425011491,MATH 103A,B03,093562,Greenfeld; Be'Eri,3,0,36,33
1657425017514,MATH 105,A01,085443,Carter; Anne Toulson,15,0,35,20
1657425017514,MATH 105,A02,093477,Carter; Anne Toulson,20,0,35,15
1657425023537,MATH 109,A01,083213,Ganzberger; Geoffrey Michael,2,0,34,32
1657425023537,MATH 109,A02,083214,Ganzberger; Geoffrey Michael,4,0,34,30
1657425023537,MATH 109,A03,093478,Ganzberger; Geoffrey Michael,2,0,34,32
1657425023537,MATH 109,B01,083215,Ganzberger; Geoffrey Michael,1,0,32,31
1657425023537,MATH 109,B02,083216,Ganzberger; Geoffrey Michael,2,0,32,30
1657425023537,MATH 109,B03,093479,Ganzberger; Geoffrey Michael,8,0,32,24
1657425029567,MATH 142A,A01,083219,Chow; Bennett,7,0,32,25
1657425029567,MATH 142A,A02,083220,Chow; Bennett,10,0,32,22
1657425029567,MATH 142A,A03,093480,Chow; Bennett,8,0,32,24
1657425029567,MATH 142A,B03,093481,Chow; Bennett,8,0,32,24
1657425029567,MATH 142A,B04,093558,Chow; Bennett,13,0,32,19
1657425029567,MATH 142A,B05,093559,Chow; Bennett,6,0,32,26
1657425035608,MATH 193A,A01,083224,Rotar; Vladimir,8,0,34,26
1657425035608,MATH 193A,A02,083225,Rotar; Vladimir,9,0,34,25
1657425035608,MATH 193A,A03,083781,Rotar; Vladimir,5,0,34,29
1657425035608,MATH 193A,A04,083782,Rotar; Vladimir,10,0,34,24
1657425035608,MATH 193A,A05,093482,Rotar; Vladimir,10,0,34,24
1657425041635,MATH 197,001,091859,McAuley; Julian John,9999,0,9999,0
1657425041635,MATH 197,002,095566,Kedlaya; Kiran S.,9997,0,9999,2
1657425041635,MATH 197,003,095567,Xiao; Ming,9999,0,9999,0
1657425041635,MATH 197,004,095571,Perols; Johan Lars,9998,0,9999,1
1657425048700,COGS 9,A01,083615,Shannon; Kyle Michael,9,0,75,66
1657425054726,COGS 11,A01,083617,Boyle; Mary E. T.,22,0,48,26
1657425060753,COGS 13,A01,083071,Bastos; Amalia Pinkusfeld,11,0,71,60
1657425066783,COGS 14A,A01,092681,Semenuks; Arturs,5,1,100,95
1657425072806,COGS 14B,A01,083073,Cheng; Tzu-Han,6,0,63,57
1657425078908,COGS 17,A01,092677,Semenuks; Arturs,6,0,81,75
1657425084930,COGS 100,A01,083619,Allen; Michael Gordon,17,0,70,53
1657425090955,COGS 101A,A01,083621,Davis; Joshua Daniel,9,0,68,59
1657425096978,COGS 101B,A01,091572,Allen; Michael Gordon,12,0,65,53
1657425103000,COGS 101C,A01,083625,Delgado; Tania,17,0,35,18
1657425109022,COGS 107A,A01,083627,Boyle; Mary E. T.,13,0,60,47
1657425115043,COGS 118A,A01,083075,Gupta; Anjum,21,0,76,55
1657425121066,CSE 3,A50,083646,Miranda; Gregory Joseph,24,0,50,26
1657425127090,CSE 8A,A50,083650,Miranda; Gregory Joseph,17,1,56,39
1657425133117,CSE 11,A01,083080,Cao; Yingjun,6,15,40,34
1657425139144,CSE 12,A01,083652,Krause-Levy; Sophia Louisa,28,1,120,92
1657425145167,CSE 15L,A01,083654,Morris; Justin Loren,9,0,50,41
1657425145167,CSE 15L,A02,083655,Morris; Justin Loren,9,0,50,41
1657425151190,CSE 20,A01,083657,Tran; Khoa Dang,39,0,80,41
1657425157215,CSE 21,A01,095574,Bach; Quang Tran,22,0,48,26
1657425163237,CSE 30,A01,083084,Eldon; John,4,0,80,76
1657425163237,CSE 30,B01,095061,Bhaskar; Nishant,9,0,50,41
1657425169262,CSE 100,A01,083659,Cao; Yingjun,5,4,70,65
1657425175285,CSE 134B,A01,083661,Powell; Thomas Allan,22,0,100,78
1657425181321,CSE 140,A01,083663,Gungor; Onat,15,0,85,70
1657425187343,CSE 140L,A01,083088,Eldon; John,21,0,100,79
1657425193366,CSE 175,A01,083665,Kumar; Rakesh,3,0,25,22
1657425199388,CSE 190,A00,092507,Dubnov; Shlomo,7,0,20,13
1657425205412,ECE 45,A01,083139,Congero; Spencer William,6,0,75,69
1657425211436,ECE 65,A50,083695,Saad; Andrew S,12,0,30,18
1657425211436,ECE 65,A51,095125,Saad; Andrew S,24,0,26,2
1657425217460,ECE 109,A01,091882,Touri; Behrouz,19,0,70,51
1657425223483,ECE 180,A00,083140,Abi Samra; Nicholas Camill,1,0,30,29
1657425223483,ECE 180,B00,083141,Abi Samra; Nicholas Camill,0,0,30,30
1657425229505,MATH 10A,A01,083735,Patchell; Gregory David,2,0,30,28
1657425229505,MATH 10A,A02,083736,Patchell; Gregory David,20,0,30,10
1657425229505,MATH 10A,A03,083737,Patchell; Gregory David,16,0,30,14
1657425235527,MATH 10B,A01,083207,Lim; Seonhee,8,0,34,26
1657425235527,MATH 10B,A02,083208,Lim; Seonhee,9,0,35,26
1657425235527,MATH 10B,A03,093472,Lim; Seonhee,7,0,34,27
1657425235527,MATH 10B,B01,083739,Sinha; Shubham,12,0,30,18
1657425241554,MATH 18,A01,083743,Cinel; Cameron Alexander,7,0,30,23
1657425241554,MATH 18,A02,083744,Cinel; Cameron Alexander,17,0,30,13
1657425241554,MATH 18,A03,083745,Cinel; Cameron Alexander,9,0,30,21
1657425241554,MATH 18,B01,083748,Rideout; David Porter,5,0,37,32
1657425241554,MATH 18,B02,083749,Rideout; David Porter,5,0,36,31
1657425241554,MATH 18,B03,083750,Rideout; David Porter,3,0,37,34
1657425241554,MATH 18,B04,083751,Rideout; David Porter,6,0,36,30
1657425241554,MATH 18,B05,093473,Rideout; David Porter,6,0,36,30
1657425241554,MATH 18,B06,093474,Rideout; David Porter,6,0,36,30
1657425247581,MATH 20A,A01,083754,Zheng; Zequn,14,0,40,26
1657425253611,MATH 20B,A01,083756,Briones; Jor-el Thomas Caparas,4,0,36,32
1657425253611,MATH 20B,A02,083757,Briones; Jor-el Thomas Caparas,1,0,36,35
1657425253611,MATH 20B,A03,093475,Briones; Jor-el Thomas Caparas,2,0,36,34
1657425259636,MATH 20C,A01,083760,Briones; Jor-el Thomas Caparas,1,0,35,34
1657425259636,MATH 20C,A02,083761,Briones; Jor-el Thomas Caparas,8,0,35,27
1657425259636,MATH 20C,A03,093476,Briones; Jor-el Thomas Caparas,0,1,36,36
1657425259636,MATH 20C,B01,083762,Bach; Quang Tran,1,0,30,29
1657425265657,MATH 20D,A01,083765,Tran; Brian Kha,5,0,30,25
1657425265657,MATH 20D,A02,083766,Tran; Brian Kha,5,0,30,25
1657425265657,MATH 20D,A03,083767,Tran; Brian Kha,5,0,30,25
1657425271679,MATH 20E,A01,083771,Ganguly; Soumya,9,0,32,23
1657425271679,MATH 20E,A02,083772,Ganguly; Soumya,6,0,32,26
1657425271679,MATH 20E,B01,083773,Ciotti; Benjamin,20,0,35,15
1657425271679,MATH 20E,B02,083774,Ciotti; Benjamin,17,0,35,18
1657425277711,MATH 103A,A01,083777,Greenfeld; Be'Eri,3,0,36,33
1657425277711,MATH 103A,A02,083778,Greenfeld; Be'Eri,5,0,36,31
1657425277711,MATH 103A,A03,093561,Greenfeld; Be'Eri,5,0,36,31
1657425277711,MATH 103A,B01,083779,Greenfeld; Be'Eri,7,0,36,29
1657425277711,MATH 103A,B02,083780,Greenfeld; Be'Eri,4,0,36,32
1657425277711,MATH 103A,B03,093562,Greenfeld; Be'Eri,3,0,36,33
1657425283734,MATH 105,A01,085443,Carter; Anne Toulson,15,0,35,20
1657425283734,MATH 105,A02,093477,Carter; Anne Toulson,20,0,35,15
1657425289761,MATH 109,A01,083213,Ganzberger; Geoffrey Michael,2,0,34,32
1657425289761,MATH 109,A02,083214,Ganzberger; Geoffrey Michael,4,0,34,30
1657425289761,MATH 109,A03,093478,Ganzberger; Geoffrey Michael,2,0,34,32
1657425289761,MATH 109,B01,083215,Ganzberger; Geoffrey Michael,1,0,32,31
1657425289761,MATH 109,B02,083216,Ganzberger; Geoffrey Michael,2,0,32,30
1657425289761,MATH 109,B03,093479,Ganzberger; Geoffrey Michael,8,0,32,24
1657425295784,MATH 142A,A01,083219,Chow; Bennett,7,0,32,25
1657425295784,MATH 142A,A02,083220,Chow; Bennett,10,0,32,22
1657425295784,MATH 142A,A03,093480,Chow; Bennett,8,0,32,24
1657425295784,MATH 142A,B03,093481,Chow; Bennett,8,0,32,24
1657425295784,MATH 142A,B04,093558,Chow; Bennett,13,0,32,19
1657425295784,MATH 142A,B05,093559,Chow; Bennett,6,0,32,26
1657425301807,MATH 193A,A01,083224,Rotar; Vladimir,8,0,34,26
1657425301807,MATH 193A,A02,083225,Rotar; Vladimir,9,0,34,25
1657425301807,MATH 193A,A03,083781,Rotar; Vladimir,5,0,34,29
1657425301807,MATH 193A,A04,083782,Rotar; Vladimir,10,0,34,24
1657425301807,MATH 193A,A05,093482,Rotar; Vladimir,10,0,34,24
1657425307829,MATH 197,001,091859,McAuley; Julian John,9999,0,9999,0
1657425307829,MATH 197,002,095566,Kedlaya; Kiran S.,9997,0,9999,2
1657425307829,MATH 197,003,095567,Xiao; Ming,9999,0,9999,0
1657425307829,MATH 197,004,095571,Perols; Johan Lars,9998,0,9999,1
1657425314883,COGS 9,A01,083615,Shannon; Kyle Michael,9,0,75,66
1657425320906,COGS 11,A01,083617,Boyle; Mary E. T.,22,0,48,26
1657425326932,COGS 13,A01,083071,Bastos; Amalia Pinkusfeld,11,0,71,60
1657425332955,COGS 14A,A01,092681,Semenuks; Arturs,5,1,100,95
1657425338976,COGS 14B,A01,083073,Cheng; Tzu-Han,6,0,63,57
1657425345002,COGS 17,A01,092677,Semenuks; Arturs,6,0,81,75
1657425351029,COGS 100,A01,083619,Allen; Michael Gordon,17,0,70,53
1657425357052,COGS 101A,A01,083621,Davis; Joshua Daniel,9,0,68,59
1657425363088,COGS 101B,A01,091572,Allen; Michael Gordon,12,0,65,53
1657425369116,COGS 101C,A01,083625,Delgado; Tania,17,0,35,18
1657425375144,COGS 107A,A01,083627,Boyle; Mary E. T.,13,0,60,47
1657425381173,COGS 118A,A01,083075,Gupta; Anjum,21,0,76,55
1657425387206,CSE 3,A50,083646,Miranda; Gregory Joseph,24,0,50,26
1657425393228,CSE 8A,A50,083650,Miranda; Gregory Joseph,17,1,56,39
1657425399250,CSE 11,A01,083080,Cao; Yingjun,6,15,40,34
1657425405274,CSE 12,A01,083652,Krause-Levy; Sophia Louisa,28,1,120,92
1657425411297,CSE 15L,A01,083654,Morris; Justin Loren,9,0,50,41
1657425411297,CSE 15L,A02,083655,Morris; Justin Loren,9,0,50,41
1657425417323,CSE 20,A01,083657,Tran; Khoa Dang,39,0,80,41
1657425423344,CSE 21,A01,095574,Bach; Quang Tran,22,0,48,26
1657425429372,CSE 30,A01,083084,Eldon; John,4,0,80,76
1657425429372,CSE 30,B01,095061,Bhaskar; Nishant,9,0,50,41
1657425435400,CSE 100,A01,083659,Cao; Yingjun,5,4,70,65
1657425441427,CSE 134B,A01,083661,Powell; Thomas Allan,22,0,100,78
1657425447456,CSE 140,A01,083663,Gungor; Onat,15,0,85,70
1657425453488,CSE 140L,A01,083088,Eldon; John,21,0,100,79
1657425459517,CSE 175,A01,083665,Kumar; Rakesh,3,0,25,22
1657425465539,CSE 190,A00,092507,Dubnov; Shlomo,7,0,20,13
1657425471564,ECE 45,A01,083139,Congero; Spencer William,6,0,75,69
1657425477587,ECE 65,A50,083695,Saad; Andrew S,12,0,30,18
1657425477587,ECE 65,A51,095125,Saad; Andrew S,24,0,26,2
1657425483616,ECE 109,A01,091882,Touri; Behrouz,19,0,70,51
1657425489646,ECE 180,A00,083140,Abi Samra; Nicholas Camill,1,0,30,29
1657425489646,ECE 180,B00,083141,Abi Samra; Nicholas Camill,0,0,30,30
1657425495674,MATH 10A,A01,083735,Patchell; Gregory David,2,0,30,28
1657425495674,MATH 10A,A02,083736,Patchell; Gregory David,20,0,30,10
1657425495674,MATH 10A,A03,083737,Patchell; Gregory David,16,0,30,14
1657425501697,MATH 10B,A01,083207,Lim; Seonhee,8,0,34,26
1657425501697,MATH 10B,A02,083208,Lim; Seonhee,9,0,35,26
1657425501697,MATH 10B,A03,093472,Lim; Seonhee,7,0,34,27
1657425501697,MATH 10B,B01,083739,Sinha; Shubham,12,0,30,18
1657425507734,MATH 18,A01,083743,Cinel; Cameron Alexander,7,0,30,23
1657425507734,MATH 18,A02,083744,Cinel; Cameron Alexander,17,0,30,13
1657425507734,MATH 18,A03,083745,Cinel; Cameron Alexander,9,0,30,21
1657425507734,MATH 18,B01,083748,Rideout; David Porter,5,0,37,32
1657425507734,MATH 18,B02,083749,Rideout; David Porter,5,0,36,31
1657425507734,MATH 18,B03,083750,Rideout; David Porter,3,0,37,34
1657425507734,MATH 18,B04,083751,Rideout; David Porter,6,0,36,30
1657425507734,MATH 18,B05,093473,Rideout; David Porter,6,0,36,30
1657425507734,MATH 18,B06,093474,Rideout; David Porter,6,0,36,30
1657425513757,MATH 20A,A01,083754,Zheng; Zequn,14,0,40,26
1657425519787,MATH 20B,A01,083756,Briones; Jor-el Thomas Caparas,4,0,36,32
1657425519787,MATH 20B,A02,083757,Briones; Jor-el Thomas Caparas,1,0,36,35
1657425519787,MATH 20B,A03,093475,Briones; Jor-el Thomas Caparas,2,0,36,34
1657425525818,MATH 20C,A01,083760,Briones; Jor-el Thomas Caparas,1,0,35,34
1657425525818,MATH 20C,A02,083761,Briones; Jor-el Thomas Caparas,8,0,35,27
1657425525818,MATH 20C,A03,093476,Briones; Jor-el Thomas Caparas,0,1,36,36
1657425525818,MATH 20C,B01,083762,Bach; Quang Tran,1,0,30,29
1657425531851,MATH 20D,A01,083765,Tran; Brian Kha,5,0,30,25
1657425531851,MATH 20D,A02,083766,Tran; Brian Kha,5,0,30,25
1657425531851,MATH 20D,A03,083767,Tran; Brian Kha,5,0,30,25
1657425537878,MATH 20E,A01,083771,Ganguly; Soumya,9,0,32,23
1657425537878,MATH 20E,A02,083772,Ganguly; Soumya,6,0,32,26
1657425537878,MATH 20E,B01,083773,Ciotti; Benjamin,20,0,35,15
1657425537878,MATH 20E,B02,083774,Ciotti; Benjamin,17,0,35,18
1657425543908,MATH 103A,A01,083777,Greenfeld; Be'Eri,3,0,36,33
1657425543908,MATH 103A,A02,083778,Greenfeld; Be'Eri,5,0,36,31
1657425543908,MATH 103A,A03,093561,Greenfeld; Be'Eri,5,0,36,31
1657425543908,MATH 103A,B01,083779,Greenfeld; Be'Eri,7,0,36,29
1657425543908,MATH 103A,B02,083780,Greenfeld; Be'Eri,4,0,36,32
1657425543908,MATH 103A,B03,093562,Greenfeld; Be'Eri,3,0,36,33
1657425549933,MATH 105,A01,085443,Carter; Anne Toulson,15,0,35,20
1657425549933,MATH 105,A02,093477,Carter; Anne Toulson,20,0,35,15
1657425555956,MATH 109,A01,083213,Ganzberger; Geoffrey Michael,2,0,34,32
1657425555956,MATH 109,A02,083214,Ganzberger; Geoffrey Michael,4,0,34,30
1657425555956,MATH 109,A03,093478,Ganzberger; Geoffrey Michael,2,0,34,32
1657425555956,MATH 109,B01,083215,Ganzberger; Geoffrey Michael,1,0,32,31
1657425555956,MATH 109,B02,083216,Ganzberger; Geoffrey Michael,2,0,32,30
1657425555956,MATH 109,B03,093479,Ganzberger; Geoffrey Michael,8,0,32,24
1657425561981,MATH 142A,A01,083219,Chow; Bennett,7,0,32,25
1657425561981,MATH 142A,A02,083220,Chow; Bennett,10,0,32,22
1657425561981,MATH 142A,A03,093480,Chow; Bennett,8,0,32,24
1657425561981,MATH 142A,B03,093481,Chow; Bennett,8,0,32,24
1657425561981,MATH 142A,B04,093558,Chow; Bennett,13,0,32,19
1657425561981,MATH 142A,B05,093559,Chow; Bennett,6,0,32,26
1657425568005,MATH 193A,A01,083224,Rotar; Vladimir,8,0,34,26
1657425568005,MATH 193A,A02,083225,Rotar; Vladimir,9,0,34,25
1657425568005,MATH 193A,A03,083781,Rotar; Vladimir,5,0,34,29
1657425568005,MATH 193A,A04,083782,Rotar; Vladimir,10,0,34,24
1657425568005,MATH 193A,A05,093482,Rotar; Vladimir,10,0,34,24
1657425574032,MATH 197,001,091859,McAuley; Julian John,9999,0,9999,0
1657425574032,MATH 197,002,095566,Kedlaya; Kiran S.,9997,0,9999,2
1657425574032,MATH 197,003,095567,Xiao; Ming,9999,0,9999,0
1657425574032,MATH 197,004,095571,Perols; Johan Lars,9998,0,9999,1
1657425581088,COGS 9,A01,083615,Shannon; Kyle Michael,9,0,75,66
1657425587112,COGS 11,A01,083617,Boyle; Mary E. T.,22,0,48,26
1657425593136,COGS 13,A01,083071,Bastos; Amalia Pinkusfeld,11,0,71,60
1657425599160,COGS 14A,A01,092681,Semenuks; Arturs,5,1,100,95
1657425605182,COGS 14B,A01,083073,Cheng; Tzu-Han,6,0,63,57
1657425611206,COGS 17,A01,092677,Semenuks; Arturs,6,0,81,75
1657425617229,COGS 100,A01,083619,Allen; Michael Gordon,17,0,70,53
1657425623255,COGS 101A,A01,083621,Davis; Joshua Daniel,9,0,68,59
1657425629280,COGS 101B,A01,091572,Allen; Michael Gordon,12,0,65,53
1657425635309,COGS 101C,A01,083625,Delgado; Tania,17,0,35,18
1657425641331,COGS 107A,A01,083627,Boyle; Mary E. T.,13,0,60,47
1657425647353,COGS 118A,A01,083075,Gupta; Anjum,21,0,76,55
1657425653377,CSE 3,A50,083646,Miranda; Gregory Joseph,24,0,50,26
1657425659400,CSE 8A,A50,083650,Miranda; Gregory Joseph,17,1,56,39
1657425665428,CSE 11,A01,083080,Cao; Yingjun,6,15,40,34
1657425671450,CSE 12,A01,083652,Krause-Levy; Sophia Louisa,28,1,120,92
1657425677566,CSE 15L,A01,083654,Morris; Justin Loren,9,0,50,41
1657425677566,CSE 15L,A02,083655,Morris; Justin Loren,9,0,50,41
1657425683587,CSE 20,A01,083657,Tran; Khoa Dang,39,0,80,41
1657425689613,CSE 21,A01,095574,Bach; Quang Tran,22,0,48,26
1657425695635,CSE 30,A01,083084,Eldon; John,4,0,80,76
1657425695635,CSE 30,B01,095061,Bhaskar; Nishant,9,0,50,41
1657425701660,CSE 100,A01,083659,Cao; Yingjun,5,4,70,65
1657425707683,CSE 134B,A01,083661,Powell; Thomas Allan,22,0,100,78
1657425713706,CSE 140,A01,083663,Gungor; Onat,15,0,85,70
1657425719730,CSE 140L,A01,083088,Eldon; John,21,0,100,79
1657425725753,CSE 175,A01,083665,Kumar; Rakesh,3,0,25,22
1657425731775,CSE 190,A00,092507,Dubnov; Shlomo,7,0,20,13
1657425737800,ECE 45,A01,083139,Congero; Spencer William,6,0,75,69
1657425743822,ECE 65,A50,083695,Saad; Andrew S,12,0,30,18
1657425743822,ECE 65,A51,095125,Saad; Andrew S,24,0,26,2
1657425749848,ECE 109,A01,091882,Touri; Behrouz,19,0,70,51
1657425755872,ECE 180,A00,083140,Abi Samra; Nicholas Camill,1,0,30,29
1657425755872,ECE 180,B00,083141,Abi Samra; Nicholas Camill,0,0,30,30
1657425761895,MATH 10A,A01,083735,Patchell; Gregory David,2,0,30,28
1657425761895,MATH 10A,A02,083736,Patchell; Gregory David,20,0,30,10
1657425761895,MATH 10A,A03,083737,Patchell; Gregory David,16,0,30,14
1657425767924,MATH 10B,A01,083207,Lim; Seonhee,8,0,34,26
1657425767924,MATH 10B,A02,083208,Lim; Seonhee,9,0,35,26
1657425767924,MATH 10B,A03,093472,Lim; Seonhee,7,0,34,27
1657425767924,MATH 10B,B01,083739,Sinha; Shubham,12,0,30,18
1657425773947,MATH 18,A01,083743,Cinel; Cameron Alexander,7,0,30,23
1657425773947,MATH 18,A02,083744,Cinel; Cameron Alexander,17,0,30,13
1657425773947,MATH 18,A03,083745,Cinel; Cameron Alexander,9,0,30,21
1657425773947,MATH 18,B01,083748,Rideout; David Porter,5,0,37,32
1657425773947,MATH 18,B02,083749,Rideout; David Porter,5,0,36,31
1657425773947,MATH 18,B03,083750,Rideout; David Porter,3,0,37,34
1657425773947,MATH 18,B04,083751,Rideout; David Porter,6,0,36,30
1657425773947,MATH 18,B05,093473,Rideout; David Porter,6,0,36,30
1657425773947,MATH 18,B06,093474,Rideout; David Porter,6,0,36,30
1657425779971,MATH 20A,A01,083754,Zheng; Zequn,14,0,40,26
1657425785996,MATH 20B,A01,083756,Briones; Jor-el Thomas Caparas,4,0,36,32
1657425785996,MATH 20B,A02,083757,Briones; Jor-el Thomas Caparas,1,0,36,35
1657425785996,MATH 20B,A03,093475,Briones; Jor-el Thomas Caparas,2,0,36,34
1657425792025,MATH 20C,A01,083760,Briones; Jor-el Thomas Caparas,1,0,35,34
1657425792025,MATH 20C,A02,083761,Briones; Jor-el Thomas Caparas,8,0,35,27
1657425792025,MATH 20C,A03,093476,Briones; Jor-el Thomas Caparas,0,1,36,36
1657425792025,MATH 20C,B01,083762,Bach; Quang Tran,1,0,30,29
1657425798047,MATH 20D,A01,083765,Tran; Brian Kha,5,0,30,25
1657425798047,MATH 20D,A02,083766,Tran; Brian Kha,5,0,30,25
1657425798047,MATH 20D,A03,083767,Tran; Brian Kha,5,0,30,25
1657425804070,MATH 20E,A01,083771,Ganguly; Soumya,9,0,32,23
1657425804070,MATH 20E,A02,083772,Ganguly; Soumya,6,0,32,26
1657425804070,MATH 20E,B01,083773,Ciotti; Benjamin,20,0,35,15
1657425804070,MATH 20E,B02,083774,Ciotti; Benjamin,17,0,35,18
1657425810099,MATH 103A,A01,083777,Greenfeld; Be'Eri,3,0,36,33
1657425810099,MATH 103A,A02,083778,Greenfeld; Be'Eri,5,0,36,31
1657425810099,MATH 103A,A03,093561,Greenfeld; Be'Eri,5,0,36,31
1657425810099,MATH 103A,B01,083779,Greenfeld; Be'Eri,7,0,36,29
1657425810099,MATH 103A,B02,083780,Greenfeld; Be'Eri,4,0,36,32
1657425810099,MATH 103A,B03,093562,Greenfeld; Be'Eri,3,0,36,33
1657425816122,MATH 105,A01,085443,Carter; Anne Toulson,15,0,35,20
1657425816122,MATH 105,A02,093477,Carter; Anne Toulson,20,0,35,15
1657425822151,MATH 109,A01,083213,Ganzberger; Geoffrey Michael,2,0,34,32
1657425822151,MATH 109,A02,083214,Ganzberger; Geoffrey Michael,4,0,34,30
1657425822151,MATH 109,A03,093478,Ganzberger; Geoffrey Michael,2,0,34,32
1657425822151,MATH 109,B01,083215,Ganzberger; Geoffrey Michael,1,0,32,31
1657425822151,MATH 109,B02,083216,Ganzberger; Geoffrey Michael,2,0,32,30
1657425822151,MATH 109,B03,093479,Ganzberger; Geoffrey Michael,8,0,32,24
1657425828174,MATH 142A,A01,083219,Chow; Bennett,7,0,32,25
1657425828174,MATH 142A,A02,083220,Chow; Bennett,10,0,32,22
1657425828174,MATH 142A,A03,093480,Chow; Bennett,8,0,32,24
1657425828174,MATH 142A,B03,093481,Chow; Bennett,8,0,32,24
1657425828174,MATH 142A,B04,093558,Chow; Bennett,13,0,32,19
1657425828174,MATH 142A,B05,093559,Chow; Bennett,6,0,32,26
1657425834197,MATH 193A,A01,083224,Rotar; Vladimir,8,0,34,26
1657425834197,MATH 193A,A02,083225,Rotar; Vladimir,9,0,34,25
1657425834197,MATH 193A,A03,083781,Rotar; Vladimir,5,0,34,29
1657425834197,MATH 193A,A04,083782,Rotar; Vladimir,10,0,34,24
1657425834197,MATH 193A,A05,093482,Rotar; Vladimir,10,0,34,24
1657425840221,MATH 197,001,091859,McAuley; Julian John,9999,0,9999,0
1657425840221,MATH 197,002,095566,Kedlaya; Kiran S.,9997,0,9999,2
1657425840221,MATH 197,003,095567,Xiao; Ming,9999,0,9999,0
1657425840221,MATH 197,004,095571,Perols; Johan Lars,9998,0,9999,1
1657425847292,COGS 9,A01,083615,Shannon; Kyle Michael,9,0,75,66
1657425853316,COGS 11,A01,083617,Boyle; Mary E. T.,22,0,48,26
1657425859344,COGS 13,A01,083071,Bastos; Amalia Pinkusfeld,11,0,71,60
1657425865366,COGS 14A,A01,092681,Semenuks; Arturs,5,1,100,95
1657425871393,COGS 14B,A01,083073,Cheng; Tzu-Han,6,0,63,57
1657425877421,COGS 17,A01,092677,Semenuks; Arturs,6,0,81,75
1657425883442,COGS 100,A01,083619,Allen; Michael Gordon,17,0,70,53
1657425889465,COGS 101A,A01,083621,Davis; Joshua Daniel,9,0,68,59
1657425895504,COGS 101B,A01,091572,Allen; Michael Gordon,12,0,65,53
1657425901527,COGS 101C,A01,083625,Delgado; Tania,17,0,35,18
1657425907550,COGS 107A,A01,083627,Boyle; Mary E. T.,13,0,60,47
1657425913573,COGS 118A,A01,083075,Gupta; Anjum,21,0,76,55
1657425919600,CSE 3,A50,083646,Miranda; Gregory Joseph,24,0,50,26
1657425925634,CSE 8A,A50,083650,Miranda; Gregory Joseph,17,1,56,39
1657425931663,CSE 11,A01,083080,Cao; Yingjun,6,15,40,34
1657425937694,CSE 12,A01,083652,Krause-Levy; Sophia Louisa,28,1,120,92
1657425943717,CSE 15L,A01,083654,Morris; Justin Loren,9,0,50,41
1657425943717,CSE 15L,A02,083655,Morris; Justin Loren,9,0,50,41
1657425949740,CSE 20,A01,083657,Tran; Khoa Dang,39,0,80,41
1657425955761,CSE 21,A01,095574,Bach; Quang Tran,22,0,48,26
1657425961789,CSE 30,A01,083084,Eldon; John,4,0,80,76
1657425961789,CSE 30,B01,095061,Bhaskar; Nishant,9,0,50,41
1657425967811,CSE 100,A01,083659,Cao; Yingjun,5,4,70,65
1657425973833,CSE 134B,A01,083661,Powell; Thomas Allan,22,0,100,78
1657425979860,CSE 140,A01,083663,Gungor; Onat,15,0,85,70
1657425985883,CSE 140L,A01,083088,Eldon; John,21,0,100,79
1657425991946,CSE 175,A01,083665,Kumar; Rakesh,3,0,25,22
1657425997969,CSE 190,A00,092507,Dubnov; Shlomo,7,0,20,13
1657426003998,ECE 45,A01,083139,Congero; Spencer William,6,0,75,69
1657426010023,ECE 65,A50,083695,Saad; Andrew S,12,0,30,18
1657426010023,ECE 65,A51,095125,Saad; Andrew S,24,0,26,2
1657426016046,ECE 109,A01,091882,Touri; Behrouz,19,0,70,51
1657426022073,ECE 180,A00,083140,Abi Samra; Nicholas Camill,1,0,30,29
1657426022073,ECE 180,B00,083141,Abi Samra; Nicholas Camill,0,0,30,30
1657426028103,MATH 10A,A01,083735,Patchell; Gregory David,2,0,30,28
1657426028103,MATH 10A,A02,083736,Patchell; Gregory David,20,0,30,10
1657426028103,MATH 10A,A03,083737,Patchell; Gregory David,16,0,30,14
1657426034132,MATH 10B,A01,083207,Lim; Seonhee,8,0,34,26
1657426034132,MATH 10B,A02,083208,Lim; Seonhee,9,0,35,26
1657426034132,MATH 10B,A03,093472,Lim; Seonhee,7,0,34,27
1657426034132,MATH 10B,B01,083739,Sinha; Shubham,12,0,30,18
1657426040159,MATH 18,A01,083743,Cinel; Cameron Alexander,7,0,30,23
1657426040159,MATH 18,A02,083744,Cinel; Cameron Alexander,17,0,30,13
1657426040159,MATH 18,A03,083745,Cinel; Cameron Alexander,9,0,30,21
1657426040159,MATH 18,B01,083748,Rideout; David Porter,5,0,37,32
1657426040159,MATH 18,B02,083749,Rideout; David Porter,5,0,36,31
1657426040159,MATH 18,B03,083750,Rideout; David Porter,3,0,37,34
1657426040159,MATH 18,B04,083751,Rideout; David Porter,6,0,36,30
1657426040159,MATH 18,B05,093473,Rideout; David Porter,6,0,36,30
1657426040159,MATH 18,B06,093474,Rideout; David Porter,6,0,36,30
1657426046183,MATH 20A,A01,083754,Zheng; Zequn,14,0,40,26
1657426052209,MATH 20B,A01,083756,Briones; Jor-el Thomas Caparas,4,0,36,32
1657426052209,MATH 20B,A02,083757,Briones; Jor-el Thomas Caparas,1,0,36,35
1657426052209,MATH 20B,A03,093475,Briones; Jor-el Thomas Caparas,2,0,36,34
1657426058233,MATH 20C,A01,083760,Briones; Jor-el Thomas Caparas,1,0,35,34
1657426058233,MATH 20C,A02,083761,Briones; Jor-el Thomas Caparas,8,0,35,27
1657426058233,MATH 20C,A03,093476,Briones; Jor-el Thomas Caparas,0,1,36,36
1657426058233,MATH 20C,B01,083762,Bach; Quang Tran,1,0,30,29
1657426064256,MATH 20D,A01,083765,Tran; Brian Kha,5,0,30,25
1657426064256,MATH 20D,A02,083766,Tran; Brian Kha,5,0,30,25
1657426064256,MATH 20D,A03,083767,Tran; Brian Kha,5,0,30,25
1657426070284,MATH 20E,A01,083771,Ganguly; Soumya,9,0,32,23
1657426070284,MATH 20E,A02,083772,Ganguly; Soumya,6,0,32,26
1657426070284,MATH 20E,B01,083773,Ciotti; Benjamin,20,0,35,15
1657426070284,MATH 20E,B02,083774,Ciotti; Benjamin,17,0,35,18
1657426076313,MATH 103A,A01,083777,Greenfeld; Be'Eri,3,0,36,33
1657426076313,MATH 103A,A02,083778,Greenfeld; Be'Eri,5,0,36,31
1657426076313,MATH 103A,A03,093561,Greenfeld; Be'Eri,5,0,36,31
1657426076313,MATH 103A,B01,083779,Greenfeld; Be'Eri,7,0,36,29
1657426076313,MATH 103A,B02,083780,Greenfeld; Be'Eri,4,0,36,32
1657426076313,MATH 103A,B03,093562,Greenfeld; Be'Eri,3,0,36,33
1657426082336,MATH 105,A01,085443,Carter; Anne Toulson,15,0,35,20
1657426082336,MATH 105,A02,093477,Carter; Anne Toulson,20,0,35,15
1657426088363,MATH 109,A01,083213,Ganzberger; Geoffrey Michael,2,0,34,32
1657426088363,MATH 109,A02,083214,Ganzberger; Geoffrey Michael,4,0,34,30
1657426088363,MATH 109,A03,093478,Ganzberger; Geoffrey Michael,2,0,34,32
1657426088363,MATH 109,B01,083215,Ganzberger; Geoffrey Michael,1,0,32,31
1657426088363,MATH 109,B02,083216,Ganzberger; Geoffrey Michael,2,0,32,30
1657426088363,MATH 109,B03,093479,Ganzberger; Geoffrey Michael,8,0,32,24
1657426094387,MATH 142A,A01,083219,Chow; Bennett,7,0,32,25
1657426094387,MATH 142A,A02,083220,Chow; Bennett,10,0,32,22
1657426094387,MATH 142A,A03,093480,Chow; Bennett,8,0,32,24
1657426094387,MATH 142A,B03,093481,Chow; Bennett,8,0,32,24
1657426094387,MATH 142A,B04,093558,Chow; Bennett,13,0,32,19
1657426094387,MATH 142A,B05,093559,Chow; Bennett,6,0,32,26
1657426100415,MATH 193A,A01,083224,Rotar; Vladimir,8,0,34,26
1657426100415,MATH 193A,A02,083225,Rotar; Vladimir,9,0,34,25
1657426100415,MATH 193A,A03,083781,Rotar; Vladimir,5,0,34,29
1657426100415,MATH 193A,A04,083782,Rotar; Vladimir,10,0,34,24
1657426100415,MATH 193A,A05,093482,Rotar; Vladimir,10,0,34,24
1657426106439,MATH 197,001,091859,McAuley; Julian John,9999,0,9999,0
1657426106439,MATH 197,002,095566,Kedlaya; Kiran S.,9997,0,9999,2
1657426106439,MATH 197,003,095567,Xiao; Ming,9999,0,9999,0
1657426106439,MATH 197,004,095571,Perols; Johan Lars,9998,0,9999,1
1657426113491,COGS 9,A01,083615,Shannon; Kyle Michael,9,0,75,66
1657426119520,COGS 11,A01,083617,Boyle; Mary E. T.,22,0,48,26
1657426125551,COGS 13,A01,083071,Bastos; Amalia Pinkusfeld,11,0,71,60
1657426131577,COGS 14A,A01,092681,Semenuks; Arturs,5,1,100,95
1657426137602,COGS 14B,A01,083073,Cheng; Tzu-Han,6,0,63,57
1657426143624,COGS 17,A01,092677,Semenuks; Arturs,6,0,81,75
1657426149652,COGS 100,A01,083619,Allen; Michael Gordon,17,0,70,53
1657426155675,COGS 101A,A01,083621,Davis; Joshua Daniel,9,0,68,59
1657426161696,COGS 101B,A01,091572,Allen; Michael Gordon,12,0,65,53
1657426167719,COGS 101C,A01,083625,Delgado; Tania,17,0,35,18
1657426173745,COGS 107A,A01,083627,Boyle; Mary E. T.,13,0,60,47
1657426179768,COGS 118A,A01,083075,Gupta; Anjum,21,0,76,55
1657426185796,CSE 3,A50,083646,Miranda; Gregory Joseph,24,0,50,26
1657426191820,CSE 8A,A50,083650,Miranda; Gregory Joseph,17,1,56,39
1657426197848,CSE 11,A01,083080,Cao; Yingjun,6,15,40,34
1657426203872,CSE 12,A01,083652,Krause-Levy; Sophia Louisa,28,1,120,92
1657426209895,CSE 15L,A01,083654,Morris; Justin Loren,9,0,50,41
1657426209895,CSE 15L,A02,083655,Morris; Justin Loren,9,0,50,41
1657426215921,CSE 20,A01,083657,Tran; Khoa Dang,39,0,80,41
1657426221949,CSE 21,A01,095574,Bach; Quang Tran,22,0,48,26
1657426227970,CSE 30,A01,083084,Eldon; John,4,0,80,76
1657426227970,CSE 30,B01,095061,Bhaskar; Nishant,9,0,50,41
1657426233996,CSE 100,A01,083659,Cao; Yingjun,5,4,70,65
1657426240018,CSE 134B,A01,083661,Powell; Thomas Allan,22,0,100,78
1657426246041,CSE 140,A01,083663,Gungor; Onat,15,0,85,70
1657426252068,CSE 140L,A01,083088,Eldon; John,21,0,100,79
1657426258095,CSE 175,A01,083665,Kumar; Rakesh,3,0,25,22
1657426264118,CSE 190,A00,092507,Dubnov; Shlomo,7,0,20,13
1657426270140,ECE 45,A01,083139,Congero; Spencer William,6,0,75,69
1657426276236,ECE 65,A50,083695,Saad; Andrew S,12,0,30,18
1657426276236,ECE 65,A51,095125,Saad; Andrew S,24,0,26,2
1657426282262,ECE 109,A01,091882,Touri; Behrouz,19,0,70,51
1657426288286,ECE 180,A00,083140,Abi Samra; Nicholas Camill,1,0,30,29
1657426288286,ECE 180,B00,083141,Abi Samra; Nicholas Camill,0,0,30,30
1657426294314,MATH 10A,A01,083735,Patchell; Gregory David,2,0,30,28
1657426294314,MATH 10A,A02,083736,Patchell; Gregory David,20,0,30,10
1657426294314,MATH 10A,A03,083737,Patchell; Gregory David,16,0,30,14
1657426300341,MATH 10B,A01,083207,Lim; Seonhee,8,0,34,26
1657426300341,MATH 10B,A02,083208,Lim; Seonhee,9,0,35,26
1657426300341,MATH 10B,A03,093472,Lim; Seonhee,7,0,34,27
1657426300341,MATH 10B,B01,083739,Sinha; Shubham,12,0,30,18
1657426306373,MATH 18,A01,083743,Cinel; Cameron Alexander,7,0,30,23
1657426306373,MATH 18,A02,083744,Cinel; Cameron Alexander,17,0,30,13
1657426306373,MATH 18,A03,083745,Cinel; Cameron Alexander,9,0,30,21
1657426306373,MATH 18,B01,083748,Rideout; David Porter,5,0,37,32
1657426306373,MATH 18,B02,083749,Rideout; David Porter,5,0,36,31
1657426306373,MATH 18,B03,083750,Rideout; David Porter,3,0,37,34
1657426306373,MATH 18,B04,083751,Rideout; David Porter,6,0,36,30
1657426306373,MATH 18,B05,093473,Rideout; David Porter,6,0,36,30
1657426306373,MATH 18,B06,093474,Rideout; David Porter,6,0,36,30
1657426312402,MATH 20A,A01,083754,Zheng; Zequn,14,0,40,26
1657426318430,MATH 20B,A01,083756,Briones; Jor-el Thomas Caparas,4,0,36,32
1657426318430,MATH 20B,A02,083757,Briones; Jor-el Thomas Caparas,1,0,36,35
1657426318430,MATH 20B,A03,093475,Briones; Jor-el Thomas Caparas,2,0,36,34
1657426324455,MATH 20C,A01,083760,Briones; Jor-el Thomas Caparas,1,0,35,34
1657426324455,MATH 20C,A02,083761,Briones; Jor-el Thomas Caparas,8,0,35,27
1657426324455,MATH 20C,A03,093476,Briones; Jor-el Thomas Caparas,0,1,36,36
1657426324455,MATH 20C,B01,083762,Bach; Quang Tran,1,0,30,29
1657426330480,MATH 20D,A01,083765,Tran; Brian Kha,5,0,30,25
1657426330480,MATH 20D,A02,083766,Tran; Brian Kha,5,0,30,25
1657426330480,MATH 20D,A03,083767,Tran; Brian Kha,5,0,30,25
1657426336503,MATH 20E,A01,083771,Ganguly; Soumya,9,0,32,23
1657426336503,MATH 20E,A02,083772,Ganguly; Soumya,6,0,32,26
1657426336503,MATH 20E,B01,083773,Ciotti; Benjamin,20,0,35,15
1657426336503,MATH 20E,B02,083774,Ciotti; Benjamin,17,0,35,18
1657426342527,MATH 103A,A01,083777,Greenfeld; Be'Eri,3,0,36,33
1657426342527,MATH 103A,A02,083778,Greenfeld; Be'Eri,5,0,36,31
1657426342527,MATH 103A,A03,093561,Greenfeld; Be'Eri,5,0,36,31
1657426342527,MATH 103A,B01,083779,Greenfeld; Be'Eri,7,0,36,29
1657426342527,MATH 103A,B02,083780,Greenfeld; Be'Eri,4,0,36,32
1657426342527,MATH 103A,B03,093562,Greenfeld; Be'Eri,3,0,36,33
1657426348554,MATH 105,A01,085443,Carter; Anne Toulson,15,0,35,20
1657426348554,MATH 105,A02,093477,Carter; Anne Toulson,20,0,35,15
1657426354583,MATH 109,A01,083213,Ganzberger; Geoffrey Michael,2,0,34,32
1657426354583,MATH 109,A02,083214,Ganzberger; Geoffrey Michael,4,0,34,30
1657426354583,MATH 109,A03,093478,Ganzberger; Geoffrey Michael,2,0,34,32
1657426354583,MATH 109,B01,083215,Ganzberger; Geoffrey Michael,1,0,32,31
1657426354583,MATH 109,B02,083216,Ganzberger; Geoffrey Michael,2,0,32,30
1657426354583,MATH 109,B03,093479,Ganzberger; Geoffrey Michael,8,0,32,24
1657426360612,MATH 142A,A01,083219,Chow; Bennett,7,0,32,25
1657426360612,MATH 142A,A02,083220,Chow; Bennett,10,0,32,22
1657426360612,MATH 142A,A03,093480,Chow; Bennett,8,0,32,24
1657426360612,MATH 142A,B03,093481,Chow; Bennett,8,0,32,24
1657426360612,MATH 142A,B04,093558,Chow; Bennett,13,0,32,19
1657426360612,MATH 142A,B05,093559,Chow; Bennett,6,0,32,26
1657426366640,MATH 193A,A01,083224,Rotar; Vladimir,8,0,34,26
1657426366640,MATH 193A,A02,083225,Rotar; Vladimir,9,0,34,25
1657426366640,MATH 193A,A03,083781,Rotar; Vladimir,5,0,34,29
1657426366640,MATH 193A,A04,083782,Rotar; Vladimir,10,0,34,24
1657426366640,MATH 193A,A05,093482,Rotar; Vladimir,10,0,34,24
1657426372662,MATH 197,001,091859,McAuley; Julian John,9999,0,9999,0
1657426372662,MATH 197,002,095566,Kedlaya; Kiran S.,9997,0,9999,2
1657426372662,MATH 197,003,095567,Xiao; Ming,9999,0,9999,0
1657426372662,MATH 197,004,095571,Perols; Johan Lars,9998,0,9999,1
1657426379733,COGS 9,A01,083615,Shannon; Kyle Michael,9,0,75,66
1657426385759,COGS 11,A01,083617,Boyle; Mary E. T.,22,0,48,26
1657426391783,COGS 13,A01,083071,Bastos; Amalia Pinkusfeld,11,0,71,60
1657426397805,COGS 14A,A01,092681,Semenuks; Arturs,5,1,100,95
1657426403828,COGS 14B,A01,083073,Cheng; Tzu-Han,6,0,63,57
1657426409851,COGS 17,A01,092677,Semenuks; Arturs,6,0,81,75
1657426415877,COGS 100,A01,083619,Allen; Michael Gordon,17,0,70,53
1657426421902,COGS 101A,A01,083621,Davis; Joshua Daniel,9,0,68,59
1657426427927,COGS 101B,A01,091572,Allen; Michael Gordon,12,0,65,53
1657426433952,COGS 101C,A01,083625,Delgado; Tania,17,0,35,18
1657426439976,COGS 107A,A01,083627,Boyle; Mary E. T.,13,0,60,47
1657426445999,COGS 118A,A01,083075,Gupta; Anjum,21,0,76,55
1657426452025,CSE 3,A50,083646,Miranda; Gregory Joseph,24,0,50,26
1657426458053,CSE 8A,A50,083650,Miranda; Gregory Joseph,17,1,56,39
1657426464076,CSE 11,A01,083080,Cao; Yingjun,6,15,40,34
1657426470098,CSE 12,A01,083652,Krause-Levy; Sophia Louisa,28,1,120,92
1657426476125,CSE 15L,A01,083654,Morris; Justin Loren,9,0,50,41
1657426476125,CSE 15L,A02,083655,Morris; Justin Loren,9,0,50,41
1657426482150,CSE 20,A01,083657,Tran; Khoa Dang,39,0,80,41
1657426488177,CSE 21,A01,095574,Bach; Quang Tran,22,0,48,26
1657426494202,CSE 30,A01,083084,Eldon; John,4,0,80,76
1657426494202,CSE 30,B01,095061,Bhaskar; Nishant,9,0,50,41
1657426500228,CSE 100,A01,083659,Cao; Yingjun,5,4,70,65
1657426506253,CSE 134B,A01,083661,Powell; Thomas Allan,22,0,100,78
1657426512276,CSE 140,A01,083663,Gungor; Onat,15,0,85,70
1657426518302,CSE 140L,A01,083088,Eldon; John,21,0,100,79
1657426524329,CSE 175,A01,083665,Kumar; Rakesh,3,0,25,22
1657426530355,CSE 190,A00,092507,Dubnov; Shlomo,7,0,20,13
1657426536379,ECE 45,A01,083139,Congero; Spencer William,6,0,75,69
1657426542400,ECE 65,A50,083695,Saad; Andrew S,12,0,30,18
1657426542400,ECE 65,A51,095125,Saad; Andrew S,24,0,26,2
1657426548425,ECE 109,A01,091882,Touri; Behrouz,19,0,70,51
1657426554447,ECE 180,A00,083140,Abi Samra; Nicholas Camill,1,0,30,29
1657426554447,ECE 180,B00,083141,Abi Samra; Nicholas Camill,0,0,30,30
1657426560473,MATH 10A,A01,083735,Patchell; Gregory David,2,0,30,28
1657426560473,MATH 10A,A02,083736,Patchell; Gregory David,20,0,30,10
1657426560473,MATH 10A,A03,083737,Patchell; Gregory David,16,0,30,14
1657426566496,MATH 10B,A01,083207,Lim; Seonhee,8,0,34,26
1657426566496,MATH 10B,A02,083208,Lim; Seonhee,9,0,35,26
1657426566496,MATH 10B,A03,093472,Lim; Seonhee,7,0,34,27
1657426566496,MATH 10B,B01,083739,Sinha; Shubham,12,0,30,18
1657426572525,MATH 18,A01,083743,Cinel; Cameron Alexander,7,0,30,23
1657426572525,MATH 18,A02,083744,Cinel; Cameron Alexander,17,0,30,13
1657426572525,MATH 18,A03,083745,Cinel; Cameron Alexander,9,0,30,21
1657426572525,MATH 18,B01,083748,Rideout; David Porter,5,0,37,32
1657426572525,MATH 18,B02,083749,Rideout; David Porter,5,0,36,31
1657426572525,MATH 18,B03,083750,Rideout; David Porter,3,0,37,34
1657426572525,MATH 18,B04,083751,Rideout; David Porter,6,0,36,30
1657426572525,MATH 18,B05,093473,Rideout; David Porter,6,0,36,30
1657426572525,MATH 18,B06,093474,Rideout; David Porter,6,0,36,30
1657426578546,MATH 20A,A01,083754,Zheng; Zequn,14,0,40,26
1657426584569,MATH 20B,A01,083756,Briones; Jor-el Thomas Caparas,4,0,36,32
1657426584569,MATH 20B,A02,083757,Briones; Jor-el Thomas Caparas,1,0,36,35
1657426584569,MATH 20B,A03,093475,Briones; Jor-el Thomas Caparas,2,0,36,34
1657426590594,MATH 20C,A01,083760,Briones; Jor-el Thomas Caparas,1,0,35,34
1657426590594,MATH 20C,A02,083761,Briones; Jor-el Thomas Caparas,8,0,35,27
1657426590594,MATH 20C,A03,093476,Briones; Jor-el Thomas Caparas,0,1,36,36
1657426590594,MATH 20C,B01,083762,Bach; Quang Tran,1,0,30,29
1657426596619,MATH 20D,A01,083765,Tran; Brian Kha,5,0,30,25
1657426596619,MATH 20D,A02,083766,Tran; Brian Kha,5,0,30,25
1657426596619,MATH 20D,A03,083767,Tran; Brian Kha,5,0,30,25
1657426602642,MATH 20E,A01,083771,Ganguly; Soumya,9,0,32,23
1657426602642,MATH 20E,A02,083772,Ganguly; Soumya,6,0,32,26
1657426602642,MATH 20E,B01,083773,Ciotti; Benjamin,20,0,35,15
1657426602642,MATH 20E,B02,083774,Ciotti; Benjamin,17,0,35,18
1657426608665,MATH 103A,A01,083777,Greenfeld; Be'Eri,3,0,36,33
1657426608665,MATH 103A,A02,083778,Greenfeld; Be'Eri,5,0,36,31
1657426608665,MATH 103A,A03,093561,Greenfeld; Be'Eri,5,0,36,31
1657426608665,MATH 103A,B01,083779,Greenfeld; Be'Eri,7,0,36,29
1657426608665,MATH 103A,B02,083780,Greenfeld; Be'Eri,4,0,36,32
1657426608665,MATH 103A,B03,093562,Greenfeld; Be'Eri,3,0,36,33
1657426614687,MATH 105,A01,085443,Carter; Anne Toulson,15,0,35,20
1657426614687,MATH 105,A02,093477,Carter; Anne Toulson,20,0,35,15
1657426620712,MATH 109,A01,083213,Ganzberger; Geoffrey Michael,2,0,34,32
1657426620712,MATH 109,A02,083214,Ganzberger; Geoffrey Michael,4,0,34,30
1657426620712,MATH 109,A03,093478,Ganzberger; Geoffrey Michael,2,0,34,32
1657426620712,MATH 109,B01,083215,Ganzberger; Geoffrey Michael,1,0,32,31
1657426620712,MATH 109,B02,083216,Ganzberger; Geoffrey Michael,2,0,32,30
1657426620712,MATH 109,B03,093479,Ganzberger; Geoffrey Michael,8,0,32,24
1657426626742,MATH 142A,A01,083219,Chow; Bennett,7,0,32,25
1657426626742,MATH 142A,A02,083220,Chow; Bennett,10,0,32,22
1657426626742,MATH 142A,A03,093480,Chow; Bennett,8,0,32,24
1657426626742,MATH 142A,B03,093481,Chow; Bennett,8,0,32,24
1657426626742,MATH 142A,B04,093558,Chow; Bennett,13,0,32,19
1657426626742,MATH 142A,B05,093559,Chow; Bennett,6,0,32,26
1657426632771,MATH 193A,A01,083224,Rotar; Vladimir,8,0,34,26
1657426632771,MATH 193A,A02,083225,Rotar; Vladimir,9,0,34,25
1657426632771,MATH 193A,A03,083781,Rotar; Vladimir,5,0,34,29
1657426632771,MATH 193A,A04,083782,Rotar; Vladimir,10,0,34,24
1657426632771,MATH 193A,A05,093482,Rotar; Vladimir,10,0,34,24
1657426638794,MATH 197,001,091859,McAuley; Julian John,9999,0,9999,0
1657426638794,MATH 197,002,095566,Kedlaya; Kiran S.,9997,0,9999,2
1657426638794,MATH 197,003,095567,Xiao; Ming,9999,0,9999,0
1657426638794,MATH 197,004,095571,Perols; Johan Lars,9998,0,9999,1
1657426645846,COGS 9,A01,083615,Shannon; Kyle Michael,9,0,75,66
1657426651874,COGS 11,A01,083617,Boyle; Mary E. T.,22,0,48,26
1657426657897,COGS 13,A01,083071,Bastos; Amalia Pinkusfeld,11,0,71,60
1657426663921,COGS 14A,A01,092681,Semenuks; Arturs,5,1,100,95
1657426669942,COGS 14B,A01,083073,Cheng; Tzu-Han,6,0,63,57
1657426675965,COGS 17,A01,092677,Semenuks; Arturs,6,0,81,75
1657426681995,COGS 100,A01,083619,Allen; Michael Gordon,17,0,70,53
1657426688018,COGS 101A,A01,083621,Davis; Joshua Daniel,9,0,68,59
1657426694043,COGS 101B,A01,091572,Allen; Michael Gordon,12,0,65,53
1657426700066,COGS 101C,A01,083625,Delgado; Tania,17,0,35,18
1657426706088,COGS 107A,A01,083627,Boyle; Mary E. T.,13,0,60,47
1657426712114,COGS 118A,A01,083075,Gupta; Anjum,21,0,76,55
1657426718137,CSE 3,A50,083646,Miranda; Gregory Joseph,24,0,50,26
1657426724163,CSE 8A,A50,083650,Miranda; Gregory Joseph,17,1,56,39
1657426730185,CSE 11,A01,083080,Cao; Yingjun,6,15,40,34
1657426736208,CSE 12,A01,083652,Krause-Levy; Sophia Louisa,28,1,120,92
1657426742232,CSE 15L,A01,083654,Morris; Justin Loren,9,0,50,41
1657426742232,CSE 15L,A02,083655,Morris; Justin Loren,9,0,50,41
1657426748254,CSE 20,A01,083657,Tran; Khoa Dang,39,0,80,41
1657426754281,CSE 21,A01,095574,Bach; Quang Tran,22,0,48,26
1657426760303,CSE 30,A01,083084,Eldon; John,4,0,80,76
1657426760303,CSE 30,B01,095061,Bhaskar; Nishant,9,0,50,41
1657426766325,CSE 100,A01,083659,Cao; Yingjun,5,4,70,65
1657426772358,CSE 134B,A01,083661,Powell; Thomas Allan,22,0,100,78
1657426778382,CSE 140,A01,083663,Gungor; Onat,15,0,85,70
1657426784412,CSE 140L,A01,083088,Eldon; John,21,0,100,79
1657426790435,CSE 175,A01,083665,Kumar; Rakesh,3,0,25,22
1657426796466,CSE 190,A00,092507,Dubnov; Shlomo,7,0,20,13
1657426802494,ECE 45,A01,083139,Congero; Spencer William,6,0,75,69
1657426808517,ECE 65,A50,083695,Saad; Andrew S,12,0,30,18
1657426808517,ECE 65,A51,095125,Saad; Andrew S,24,0,26,2
1657426814543,ECE 109,A01,091882,Touri; Behrouz,19,0,70,51
1657426820566,ECE 180,A00,083140,Abi Samra; Nicholas Camill,1,0,30,29
1657426820566,ECE 180,B00,083141,Abi Samra; Nicholas Camill,0,0,30,30
1657426826594,MATH 10A,A01,083735,Patchell; Gregory David,2,0,30,28
1657426826594,MATH 10A,A02,083736,Patchell; Gregory David,20,0,30,10
1657426826594,MATH 10A,A03,083737,Patchell; Gregory David,16,0,30,14
1657426832624,MATH 10B,A01,083207,Lim; Seonhee,8,0,34,26
1657426832624,MATH 10B,A02,083208,Lim; Seonhee,9,0,35,26
1657426832624,MATH 10B,A03,093472,Lim; Seonhee,7,0,34,27
1657426832624,MATH 10B,B01,083739,Sinha; Shubham,12,0,30,18
1657426838649,MATH 18,A01,083743,Cinel; Cameron Alexander,7,0,30,23
1657426838649,MATH 18,A02,083744,Cinel; Cameron Alexander,17,0,30,13
1657426838649,MATH 18,A03,083745,Cinel; Cameron Alexander,9,0,30,21
1657426838649,MATH 18,B01,083748,Rideout; David Porter,5,0,37,32
1657426838649,MATH 18,B02,083749,Rideout; David Porter,5,0,36,31
1657426838649,MATH 18,B03,083750,Rideout; David Porter,3,0,37,34
1657426838649,MATH 18,B04,083751,Rideout; David Porter,6,0,36,30
1657426838649,MATH 18,B05,093473,Rideout; David Porter,6,0,36,30
1657426838649,MATH 18,B06,093474,Rideout; David Porter,6,0,36,30
1657426844679,MATH 20A,A01,083754,Zheng; Zequn,14,0,40,26
1657426850705,MATH 20B,A01,083756,Briones; Jor-el Thomas Caparas,4,0,36,32
1657426850705,MATH 20B,A02,083757,Briones; Jor-el Thomas Caparas,1,0,36,35
1657426850705,MATH 20B,A03,093475,Briones; Jor-el Thomas Caparas,2,0,36,34
1657426856734,MATH 20C,A01,083760,Briones; Jor-el Thomas Caparas,1,0,35,34
1657426856734,MATH 20C,A02,083761,Briones; Jor-el Thomas Caparas,8,0,35,27
1657426856734,MATH 20C,A03,093476,Briones; Jor-el Thomas Caparas,0,1,36,36
1657426856734,MATH 20C,B01,083762,Bach; Quang Tran,1,0,30,29
1657426862759,MATH 20D,A01,083765,Tran; Brian Kha,5,0,30,25
1657426862759,MATH 20D,A02,083766,Tran; Brian Kha,5,0,30,25
1657426862759,MATH 20D,A03,083767,Tran; Brian Kha,5,0,30,25
1657426868784,MATH 20E,A01,083771,Ganguly; Soumya,9,0,32,23
1657426868784,MATH 20E,A02,083772,Ganguly; Soumya,6,0,32,26
1657426868784,MATH 20E,B01,083773,Ciotti; Benjamin,20,0,35,15
1657426868784,MATH 20E,B02,083774,Ciotti; Benjamin,17,0,35,18
1657426874885,MATH 103A,A01,083777,Greenfeld; Be'Eri,3,0,36,33
1657426874885,MATH 103A,A02,083778,Greenfeld; Be'Eri,5,0,36,31
1657426874885,MATH 103A,A03,093561,Greenfeld; Be'Eri,5,0,36,31
1657426874885,MATH 103A,B01,083779,Greenfeld; Be'Eri,7,0,36,29
1657426874885,MATH 103A,B02,083780,Greenfeld; Be'Eri,4,0,36,32
1657426874885,MATH 103A,B03,093562,Greenfeld; Be'Eri,3,0,36,33
1657426880906,MATH 105,A01,085443,Carter; Anne Toulson,15,0,35,20
1657426880906,MATH 105,A02,093477,Carter; Anne Toulson,20,0,35,15
1657426886929,MATH 109,A01,083213,Ganzberger; Geoffrey Michael,2,0,34,32
1657426886929,MATH 109,A02,083214,Ganzberger; Geoffrey Michael,4,0,34,30
1657426886929,MATH 109,A03,093478,Ganzberger; Geoffrey Michael,2,0,34,32
1657426886929,MATH 109,B01,083215,Ganzberger; Geoffrey Michael,1,0,32,31
1657426886929,MATH 109,B02,083216,Ganzberger; Geoffrey Michael,2,0,32,30
1657426886929,MATH 109,B03,093479,Ganzberger; Geoffrey Michael,8,0,32,24
1657426892958,MATH 142A,A01,083219,Chow; Bennett,7,0,32,25
1657426892958,MATH 142A,A02,083220,Chow; Bennett,10,0,32,22
1657426892958,MATH 142A,A03,093480,Chow; Bennett,8,0,32,24
1657426892958,MATH 142A,B03,093481,Chow; Bennett,8,0,32,24
1657426892958,MATH 142A,B04,093558,Chow; Bennett,13,0,32,19
1657426892958,MATH 142A,B05,093559,Chow; Bennett,6,0,32,26
1657426898988,MATH 193A,A01,083224,Rotar; Vladimir,8,0,34,26
1657426898988,MATH 193A,A02,083225,Rotar; Vladimir,9,0,34,25
1657426898988,MATH 193A,A03,083781,Rotar; Vladimir,5,0,34,29
1657426898988,MATH 193A,A04,083782,Rotar; Vladimir,10,0,34,24
1657426898988,MATH 193A,A05,093482,Rotar; Vladimir,10,0,34,24
1657426905009,MATH 197,001,091859,McAuley; Julian John,9999,0,9999,0
1657426905009,MATH 197,002,095566,Kedlaya; Kiran S.,9997,0,9999,2
1657426905009,MATH 197,003,095567,Xiao; Ming,9999,0,9999,0
1657426905009,MATH 197,004,095571,Perols; Johan Lars,9998,0,9999,1
1657426912068,COGS 9,A01,083615,Shannon; Kyle Michael,9,0,75,66
1657426918090,COGS 11,A01,083617,Boyle; Mary E. T.,22,0,48,26
1657426924119,COGS 13,A01,083071,Bastos; Amalia Pinkusfeld,11,0,71,60
1657426930140,COGS 14A,A01,092681,Semenuks; Arturs,5,1,100,95
1657426936165,COGS 14B,A01,083073,Cheng; Tzu-Han,6,0,63,57
1657426942189,COGS 17,A01,092677,Semenuks; Arturs,6,0,81,75
1657426948214,COGS 100,A01,083619,Allen; Michael Gordon,17,0,70,53
1657426954235,COGS 101A,A01,083621,Davis; Joshua Daniel,9,0,68,59
1657426960259,COGS 101B,A01,091572,Allen; Michael Gordon,12,0,65,53
1657426966287,COGS 101C,A01,083625,Delgado; Tania,17,0,35,18
1657426972312,COGS 107A,A01,083627,Boyle; Mary E. T.,13,0,60,47
1657426978345,COGS 118A,A01,083075,Gupta; Anjum,21,0,76,55
1657426984370,CSE 3,A50,083646,Miranda; Gregory Joseph,24,0,50,26
1657426990397,CSE 8A,A50,083650,Miranda; Gregory Joseph,17,1,56,39
1657426996420,CSE 11,A01,083080,Cao; Yingjun,6,15,40,34
1657427002445,CSE 12,A01,083652,Krause-Levy; Sophia Louisa,28,1,120,92
1657427008470,CSE 15L,A01,083654,Morris; Justin Loren,9,0,50,41
1657427008470,CSE 15L,A02,083655,Morris; Justin Loren,9,0,50,41
1657427014493,CSE 20,A01,083657,Tran; Khoa Dang,39,0,80,41
1657427020516,CSE 21,A01,095574,Bach; Quang Tran,22,0,48,26
1657427026542,CSE 30,A01,083084,Eldon; John,4,0,80,76
1657427026542,CSE 30,B01,095061,Bhaskar; Nishant,9,0,50,41
1657427032566,CSE 100,A01,083659,Cao; Yingjun,5,4,70,65
1657427038592,CSE 134B,A01,083661,Powell; Thomas Allan,22,0,100,78
1657427044615,CSE 140,A01,083663,Gungor; Onat,15,0,85,70
1657427050636,CSE 140L,A01,083088,Eldon; John,21,0,100,79
1657427056661,CSE 175,A01,083665,Kumar; Rakesh,3,0,25,22
1657427062683,CSE 190,A00,092507,Dubnov; Shlomo,7,0,20,13
1657427068711,ECE 45,A01,083139,Congero; Spencer William,6,0,75,69
1657427074741,ECE 65,A50,083695,Saad; Andrew S,12,0,30,18
1657427074741,ECE 65,A51,095125,Saad; Andrew S,24,0,26,2
1657427080764,ECE 109,A01,091882,Touri; Behrouz,19,0,70,51
1657427086789,ECE 180,A00,083140,Abi Samra; Nicholas Camill,1,0,30,29
1657427086789,ECE 180,B00,083141,Abi Samra; Nicholas Camill,0,0,30,30
1657427092815,MATH 10A,A01,083735,Patchell; Gregory David,2,0,30,28
1657427092815,MATH 10A,A02,083736,Patchell; Gregory David,20,0,30,10
1657427092815,MATH 10A,A03,083737,Patchell; Gregory David,16,0,30,14
1657427098844,MATH 10B,A01,083207,Lim; Seonhee,8,0,34,26
1657427098844,MATH 10B,A02,083208,Lim; Seonhee,9,0,35,26
1657427098844,MATH 10B,A03,093472,Lim; Seonhee,7,0,34,27
1657427098844,MATH 10B,B01,083739,Sinha; Shubham,12,0,30,18
1657427104876,MATH 18,A01,083743,Cinel; Cameron Alexander,7,0,30,23
1657427104876,MATH 18,A02,083744,Cinel; Cameron Alexander,17,0,30,13
1657427104876,MATH 18,A03,083745,Cinel; Cameron Alexander,9,0,30,21
1657427104876,MATH 18,B01,083748,Rideout; David Porter,5,0,37,32
1657427104876,MATH 18,B02,083749,Rideout; David Porter,5,0,36,31
1657427104876,MATH 18,B03,083750,Rideout; David Porter,3,0,37,34
1657427104876,MATH 18,B04,083751,Rideout; David Porter,6,0,36,30
1657427104876,MATH 18,B05,093473,Rideout; David Porter,6,0,36,30
1657427104876,MATH 18,B06,093474,Rideout; David Porter,6,0,36,30
1657427110900,MATH 20A,A01,083754,Zheng; Zequn,14,0,40,26
1657427116926,MATH 20B,A01,083756,Briones; Jor-el Thomas Caparas,4,0,36,32
1657427116926,MATH 20B,A02,083757,Briones; Jor-el Thomas Caparas,1,0,36,35
1657427116926,MATH 20B,A03,093475,Briones; Jor-el Thomas Caparas,2,0,36,34
1657427122954,MATH 20C,A01,083760,Briones; Jor-el Thomas Caparas,1,0,35,34
1657427122954,MATH 20C,A02,083761,Briones; Jor-el Thomas Caparas,8,0,35,27
1657427122954,MATH 20C,A03,093476,Briones; Jor-el Thomas Caparas,0,1,36,36
1657427122954,MATH 20C,B01,083762,Bach; Quang Tran,1,0,30,29
1657427128978,MATH 20D,A01,083765,Tran; Brian Kha,5,0,30,25
1657427128978,MATH 20D,A02,083766,Tran; Brian Kha,5,0,30,25
1657427128978,MATH 20D,A03,083767,Tran; Brian Kha,5,0,30,25
1657427135007,MATH 20E,A01,083771,Ganguly; Soumya,9,0,32,23
1657427135007,MATH 20E,A02,083772,Ganguly; Soumya,6,0,32,26
1657427135007,MATH 20E,B01,083773,Ciotti; Benjamin,20,0,35,15
1657427135007,MATH 20E,B02,083774,Ciotti; Benjamin,17,0,35,18
1657427141034,MATH 103A,A01,083777,Greenfeld; Be'Eri,3,0,36,33
1657427141034,MATH 103A,A02,083778,Greenfeld; Be'Eri,5,0,36,31
1657427141034,MATH 103A,A03,093561,Greenfeld; Be'Eri,5,0,36,31
1657427141034,MATH 103A,B01,083779,Greenfeld; Be'Eri,7,0,36,29
1657427141034,MATH 103A,B02,083780,Greenfeld; Be'Eri,4,0,36,32
1657427141034,MATH 103A,B03,093562,Greenfeld; Be'Eri,3,0,36,33
1657427147057,MATH 105,A01,085443,Carter; Anne Toulson,15,0,35,20
1657427147057,MATH 105,A02,093477,Carter; Anne Toulson,20,0,35,15
1657427153087,MATH 109,A01,083213,Ganzberger; Geoffrey Michael,2,0,34,32
1657427153087,MATH 109,A02,083214,Ganzberger; Geoffrey Michael,4,0,34,30
1657427153087,MATH 109,A03,093478,Ganzberger; Geoffrey Michael,2,0,34,32
1657427153087,MATH 109,B01,083215,Ganzberger; Geoffrey Michael,1,0,32,31
1657427153087,MATH 109,B02,083216,Ganzberger; Geoffrey Michael,2,0,32,30
1657427153087,MATH 109,B03,093479,Ganzberger; Geoffrey Michael,8,0,32,24
1657427159113,MATH 142A,A01,083219,Chow; Bennett,7,0,32,25
1657427159113,MATH 142A,A02,083220,Chow; Bennett,10,0,32,22
1657427159113,MATH 142A,A03,093480,Chow; Bennett,8,0,32,24
1657427159113,MATH 142A,B03,093481,Chow; Bennett,8,0,32,24
1657427159113,MATH 142A,B04,093558,Chow; Bennett,13,0,32,19
1657427159113,MATH 142A,B05,093559,Chow; Bennett,6,0,32,26
1657427165135,MATH 193A,A01,083224,Rotar; Vladimir,8,0,34,26
1657427165135,MATH 193A,A02,083225,Rotar; Vladimir,9,0,34,25
1657427165135,MATH 193A,A03,083781,Rotar; Vladimir,5,0,34,29
1657427165135,MATH 193A,A04,083782,Rotar; Vladimir,10,0,34,24
1657427165135,MATH 193A,A05,093482,Rotar; Vladimir,10,0,34,24
1657427171161,MATH 197,001,091859,McAuley; Julian John,9999,0,9999,0
1657427171161,MATH 197,002,095566,Kedlaya; Kiran S.,9997,0,9999,2
1657427171161,MATH 197,003,095567,Xiao; Ming,9999,0,9999,0
1657427171161,MATH 197,004,095571,Perols; Johan Lars,9998,0,9999,1
1657427178222,COGS 9,A01,083615,Shannon; Kyle Michael,9,0,75,66
1657427184245,COGS 11,A01,083617,Boyle; Mary E. T.,22,0,48,26
1657427190271,COGS 13,A01,083071,Bastos; Amalia Pinkusfeld,11,0,71,60
1657427196293,COGS 14A,A01,092681,Semenuks; Arturs,5,1,100,95
1657427202314,COGS 14B,A01,083073,Cheng; Tzu-Han,6,0,63,57
1657427208336,COGS 17,A01,092677,Semenuks; Arturs,6,0,81,75
1657427214362,COGS 100,A01,083619,Allen; Michael Gordon,17,0,70,53
1657427220385,COGS 101A,A01,083621,Davis; Joshua Daniel,9,0,68,59
1657427226408,COGS 101B,A01,091572,Allen; Michael Gordon,12,0,65,53
1657427232434,COGS 101C,A01,083625,Delgado; Tania,17,0,35,18
1657427238457,COGS 107A,A01,083627,Boyle; Mary E. T.,13,0,60,47
1657427244480,COGS 118A,A01,083075,Gupta; Anjum,21,0,76,55
1657427250509,CSE 3,A50,083646,Miranda; Gregory Joseph,24,0,50,26
1657427256536,CSE 8A,A50,083650,Miranda; Gregory Joseph,17,1,56,39
1657427262579,CSE 11,A01,083080,Cao; Yingjun,6,15,40,34
1657427268603,CSE 12,A01,083652,Krause-Levy; Sophia Louisa,28,1,120,92
1657427274631,CSE 15L,A01,083654,Morris; Justin Loren,9,0,50,41
1657427274631,CSE 15L,A02,083655,Morris; Justin Loren,9,0,50,41
1657427280654,CSE 20,A01,083657,Tran; Khoa Dang,39,0,80,41
1657427286677,CSE 21,A01,095574,Bach; Quang Tran,22,0,48,26
1657427292701,CSE 30,A01,083084,Eldon; John,4,0,80,76
1657427292701,CSE 30,B01,095061,Bhaskar; Nishant,9,0,50,41
1657427298728,CSE 100,A01,083659,Cao; Yingjun,5,4,70,65
1657427304759,CSE 134B,A01,083661,Powell; Thomas Allan,22,0,100,78
1657427310780,CSE 140,A01,083663,Gungor; Onat,15,0,85,70
1657427316804,CSE 140L,A01,083088,Eldon; John,21,0,100,79
1657427322828,CSE 175,A01,083665,Kumar; Rakesh,3,0,25,22
1657427328855,CSE 190,A00,092507,Dubnov; Shlomo,7,0,20,13
1657427334879,ECE 45,A01,083139,Congero; Spencer William,6,0,75,69
1657427340907,ECE 65,A50,083695,Saad; Andrew S,12,0,30,18
1657427340907,ECE 65,A51,095125,Saad; Andrew S,24,0,26,2
1657427346934,ECE 109,A01,091882,Touri; Behrouz,19,0,70,51
1657427352956,ECE 180,A00,083140,Abi Samra; Nicholas Camill,1,0,30,29
1657427352956,ECE 180,B00,083141,Abi Samra; Nicholas Camill,0,0,30,30
1657427358979,MATH 10A,A01,083735,Patchell; Gregory David,2,0,30,28
1657427358979,MATH 10A,A02,083736,Patchell; Gregory David,20,0,30,10
1657427358979,MATH 10A,A03,083737,Patchell; Gregory David,16,0,30,14
1657427365003,MATH 10B,A01,083207,Lim; Seonhee,8,0,34,26
1657427365003,MATH 10B,A02,083208,Lim; Seonhee,9,0,35,26
1657427365003,MATH 10B,A03,093472,Lim; Seonhee,7,0,34,27
1657427365003,MATH 10B,B01,083739,Sinha; Shubham,12,0,30,18
1657427371036,MATH 18,A01,083743,Cinel; Cameron Alexander,7,0,30,23
1657427371036,MATH 18,A02,083744,Cinel; Cameron Alexander,17,0,30,13
1657427371036,MATH 18,A03,083745,Cinel; Cameron Alexander,9,0,30,21
1657427371036,MATH 18,B01,083748,Rideout; David Porter,5,0,37,32
1657427371036,MATH 18,B02,083749,Rideout; David Porter,5,0,36,31
1657427371036,MATH 18,B03,083750,Rideout; David Porter,3,0,37,34
1657427371036,MATH 18,B04,083751,Rideout; David Porter,6,0,36,30
1657427371036,MATH 18,B05,093473,Rideout; David Porter,6,0,36,30
1657427371036,MATH 18,B06,093474,Rideout; David Porter,6,0,36,30
1657427377061,MATH 20A,A01,083754,Zheng; Zequn,14,0,40,26
1657427383086,MATH 20B,A01,083756,Briones; Jor-el Thomas Caparas,4,0,36,32
1657427383086,MATH 20B,A02,083757,Briones; Jor-el Thomas Caparas,1,0,36,35
1657427383086,MATH 20B,A03,093475,Briones; Jor-el Thomas Caparas,2,0,36,34
1657427389110,MATH 20C,A01,083760,Briones; Jor-el Thomas Caparas,1,0,35,34
1657427389110,MATH 20C,A02,083761,Briones; Jor-el Thomas Caparas,8,0,35,27
1657427389110,MATH 20C,A03,093476,Briones; Jor-el Thomas Caparas,0,1,36,36
1657427389110,MATH 20C,B01,083762,Bach; Quang Tran,1,0,30,29
1657427395136,MATH 20D,A01,083765,Tran; Brian Kha,5,0,30,25
1657427395136,MATH 20D,A02,083766,Tran; Brian Kha,5,0,30,25
1657427395136,MATH 20D,A03,083767,Tran; Brian Kha,5,0,30,25
1657427401164,MATH 20E,A01,083771,Ganguly; Soumya,9,0,32,23
1657427401164,MATH 20E,A02,083772,Ganguly; Soumya,6,0,32,26
1657427401164,MATH 20E,B01,083773,Ciotti; Benjamin,20,0,35,15
1657427401164,MATH 20E,B02,083774,Ciotti; Benjamin,17,0,35,18
1657427407188,MATH 103A,A01,083777,Greenfeld; Be'Eri,3,0,36,33
1657427407188,MATH 103A,A02,083778,Greenfeld; Be'Eri,5,0,36,31
1657427407188,MATH 103A,A03,093561,Greenfeld; Be'Eri,5,0,36,31
1657427407188,MATH 103A,B01,083779,Greenfeld; Be'Eri,7,0,36,29
1657427407188,MATH 103A,B02,083780,Greenfeld; Be'Eri,4,0,36,32
1657427407188,MATH 103A,B03,093562,Greenfeld; Be'Eri,3,0,36,33
1657427413211,MATH 105,A01,085443,Carter; Anne Toulson,15,0,35,20
1657427413211,MATH 105,A02,093477,Carter; Anne Toulson,20,0,35,15
1657427419234,MATH 109,A01,083213,Ganzberger; Geoffrey Michael,2,0,34,32
1657427419234,MATH 109,A02,083214,Ganzberger; Geoffrey Michael,4,0,34,30
1657427419234,MATH 109,A03,093478,Ganzberger; Geoffrey Michael,2,0,34,32
1657427419234,MATH 109,B01,083215,Ganzberger; Geoffrey Michael,1,0,32,31
1657427419234,MATH 109,B02,083216,Ganzberger; Geoffrey Michael,2,0,32,30
1657427419234,MATH 109,B03,093479,Ganzberger; Geoffrey Michael,8,0,32,24
1657427425264,MATH 142A,A01,083219,Chow; Bennett,7,0,32,25
1657427425264,MATH 142A,A02,083220,Chow; Bennett,10,0,32,22
1657427425264,MATH 142A,A03,093480,Chow; Bennett,8,0,32,24
1657427425264,MATH 142A,B03,093481,Chow; Bennett,8,0,32,24
1657427425264,MATH 142A,B04,093558,Chow; Bennett,13,0,32,19
1657427425264,MATH 142A,B05,093559,Chow; Bennett,6,0,32,26
1657427431293,MATH 193A,A01,083224,Rotar; Vladimir,8,0,34,26
1657427431293,MATH 193A,A02,083225,Rotar; Vladimir,9,0,34,25
1657427431293,MATH 193A,A03,083781,Rotar; Vladimir,5,0,34,29
1657427431293,MATH 193A,A04,083782,Rotar; Vladimir,10,0,34,24
1657427431293,MATH 193A,A05,093482,Rotar; Vladimir,10,0,34,24
1657427437314,MATH 197,001,091859,McAuley; Julian John,9999,0,9999,0
1657427437314,MATH 197,002,095566,Kedlaya; Kiran S.,9997,0,9999,2
1657427437314,MATH 197,003,095567,Xiao; Ming,9999,0,9999,0
1657427437314,MATH 197,004,095571,Perols; Johan Lars,9998,0,9999,1
1657427444381,COGS 9,A01,083615,Shannon; Kyle Michael,9,0,75,66
1657427450406,COGS 11,A01,083617,Boyle; Mary E. T.,22,0,48,26
1657427456434,COGS 13,A01,083071,Bastos; Amalia Pinkusfeld,11,0,71,60
1657427462458,COGS 14A,A01,092681,Semenuks; Arturs,5,1,100,95
1657427468554,COGS 14B,A01,083073,Cheng; Tzu-Han,6,0,63,57
1657427474579,COGS 17,A01,092677,Semenuks; Arturs,6,0,81,75
1657427480603,COGS 100,A01,083619,Allen; Michael Gordon,17,0,70,53
1657427486631,COGS 101A,A01,083621,Davis; Joshua Daniel,9,0,68,59
1657427492656,COGS 101B,A01,091572,Allen; Michael Gordon,12,0,65,53
1657427498678,COGS 101C,A01,083625,Delgado; Tania,17,0,35,18
1657427504702,COGS 107A,A01,083627,Boyle; Mary E. T.,13,0,60,47
1657427510730,COGS 118A,A01,083075,Gupta; Anjum,21,0,76,55
1657427516758,CSE 3,A50,083646,Miranda; Gregory Joseph,24,0,50,26
1657427522793,CSE 8A,A50,083650,Miranda; Gregory Joseph,17,1,56,39
1657427528817,CSE 11,A01,083080,Cao; Yingjun,6,15,40,34
1657427534844,CSE 12,A01,083652,Krause-Levy; Sophia Louisa,28,1,120,92
1657427540867,CSE 15L,A01,083654,Morris; Justin Loren,9,0,50,41
1657427540867,CSE 15L,A02,083655,Morris; Justin Loren,9,0,50,41
1657427546895,CSE 20,A01,083657,Tran; Khoa Dang,39,0,80,41
1657427552923,CSE 21,A01,095574,Bach; Quang Tran,22,0,48,26
1657427558948,CSE 30,A01,083084,Eldon; John,4,0,80,76
1657427558948,CSE 30,B01,095061,Bhaskar; Nishant,9,0,50,41
1657427564972,CSE 100,A01,083659,Cao; Yingjun,5,4,70,65
1657427570995,CSE 134B,A01,083661,Powell; Thomas Allan,22,0,100,78
1657427577017,CSE 140,A01,083663,Gungor; Onat,15,0,85,70
1657427583044,CSE 140L,A01,083088,Eldon; John,21,0,100,79
1657427589069,CSE 175,A01,083665,Kumar; Rakesh,3,0,25,22
1657427595095,CSE 190,A00,092507,Dubnov; Shlomo,7,0,20,13
1657427601118,ECE 45,A01,083139,Congero; Spencer William,6,0,75,69
1657427607145,ECE 65,A50,083695,Saad; Andrew S,12,0,30,18
1657427607145,ECE 65,A51,095125,Saad; Andrew S,24,0,26,2
1657427613170,ECE 109,A01,091882,Touri; Behrouz,19,0,70,51
1657427619193,ECE 180,A00,083140,Abi Samra; Nicholas Camill,1,0,30,29
1657427619193,ECE 180,B00,083141,Abi Samra; Nicholas Camill,0,0,30,30
1657427625216,MATH 10A,A01,083735,Patchell; Gregory David,2,0,30,28
1657427625216,MATH 10A,A02,083736,Patchell; Gregory David,20,0,30,10
1657427625216,MATH 10A,A03,083737,Patchell; Gregory David,16,0,30,14
1657427631244,MATH 10B,A01,083207,Lim; Seonhee,8,0,34,26
1657427631244,MATH 10B,A02,083208,Lim; Seonhee,9,0,35,26
1657427631244,MATH 10B,A03,093472,Lim; Seonhee,7,0,34,27
1657427631244,MATH 10B,B01,083739,Sinha; Shubham,12,0,30,18
1657427637273,MATH 18,A01,083743,Cinel; Cameron Alexander,7,0,30,23
1657427637273,MATH 18,A02,083744,Cinel; Cameron Alexander,17,0,30,13
1657427637273,MATH 18,A03,083745,Cinel; Cameron Alexander,9,0,30,21
1657427637273,MATH 18,B01,083748,Rideout; David Porter,5,0,37,32
1657427637273,MATH 18,B02,083749,Rideout; David Porter,5,0,36,31
1657427637273,MATH 18,B03,083750,Rideout; David Porter,3,0,37,34
1657427637273,MATH 18,B04,083751,Rideout; David Porter,6,0,36,30
1657427637273,MATH 18,B05,093473,Rideout; David Porter,6,0,36,30
1657427637273,MATH 18,B06,093474,Rideout; David Porter,6,0,36,30
1657427643295,MATH 20A,A01,083754,Zheng; Zequn,14,0,40,26
1657427649319,MATH 20B,A01,083756,Briones; Jor-el Thomas Caparas,4,0,36,32
1657427649319,MATH 20B,A02,083757,Briones; Jor-el Thomas Caparas,1,0,36,35
1657427649319,MATH 20B,A03,093475,Briones; Jor-el Thomas Caparas,2,0,36,34
1657427655342,MATH 20C,A01,083760,Briones; Jor-el Thomas Caparas,1,0,35,34
1657427655342,MATH 20C,A02,083761,Briones; Jor-el Thomas Caparas,8,0,35,27
1657427655342,MATH 20C,A03,093476,Briones; Jor-el Thomas Caparas,0,1,36,36
1657427655342,MATH 20C,B01,083762,Bach; Quang Tran,1,0,30,29
1657427661374,MATH 20D,A01,083765,Tran; Brian Kha,5,0,30,25
1657427661374,MATH 20D,A02,083766,Tran; Brian Kha,5,0,30,25
1657427661374,MATH 20D,A03,083767,Tran; Brian Kha,5,0,30,25
1657427667402,MATH 20E,A01,083771,Ganguly; Soumya,9,0,32,23
1657427667402,MATH 20E,A02,083772,Ganguly; Soumya,6,0,32,26
1657427667402,MATH 20E,B01,083773,Ciotti; Benjamin,20,0,35,15
1657427667402,MATH 20E,B02,083774,Ciotti; Benjamin,17,0,35,18
1657427673425,MATH 103A,A01,083777,Greenfeld; Be'Eri,3,0,36,33
1657427673425,MATH 103A,A02,083778,Greenfeld; Be'Eri,5,0,36,31
1657427673425,MATH 103A,A03,093561,Greenfeld; Be'Eri,5,0,36,31
1657427673425,MATH 103A,B01,083779,Greenfeld; Be'Eri,7,0,36,29
1657427673425,MATH 103A,B02,083780,Greenfeld; Be'Eri,4,0,36,32
1657427673425,MATH 103A,B03,093562,Greenfeld; Be'Eri,3,0,36,33
1657427679448,MATH 105,A01,085443,Carter; Anne Toulson,15,0,35,20
1657427679448,MATH 105,A02,093477,Carter; Anne Toulson,20,0,35,15
1657427685477,MATH 109,A01,083213,Ganzberger; Geoffrey Michael,2,0,34,32
1657427685477,MATH 109,A02,083214,Ganzberger; Geoffrey Michael,4,0,34,30
1657427685477,MATH 109,A03,093478,Ganzberger; Geoffrey Michael,2,0,34,32
1657427685477,MATH 109,B01,083215,Ganzberger; Geoffrey Michael,1,0,32,31
1657427685477,MATH 109,B02,083216,Ganzberger; Geoffrey Michael,2,0,32,30
1657427685477,MATH 109,B03,093479,Ganzberger; Geoffrey Michael,8,0,32,24
1657427691506,MATH 142A,A01,083219,Chow; Bennett,7,0,32,25
1657427691506,MATH 142A,A02,083220,Chow; Bennett,10,0,32,22
1657427691506,MATH 142A,A03,093480,Chow; Bennett,8,0,32,24
1657427691506,MATH 142A,B03,093481,Chow; Bennett,8,0,32,24
1657427691506,MATH 142A,B04,093558,Chow; Bennett,13,0,32,19
1657427691506,MATH 142A,B05,093559,Chow; Bennett,6,0,32,26
1657427697534,MATH 193A,A01,083224,Rotar; Vladimir,8,0,34,26
1657427697534,MATH 193A,A02,083225,Rotar; Vladimir,9,0,34,25
1657427697534,MATH 193A,A03,083781,Rotar; Vladimir,5,0,34,29
1657427697534,MATH 193A,A04,083782,Rotar; Vladimir,10,0,34,24
1657427697534,MATH 193A,A05,093482,Rotar; Vladimir,10,0,34,24
1657427703560,MATH 197,001,091859,McAuley; Julian John,9999,0,9999,0
1657427703560,MATH 197,002,095566,Kedlaya; Kiran S.,9997,0,9999,2
1657427703560,MATH 197,003,095567,Xiao; Ming,9999,0,9999,0
1657427703560,MATH 197,004,095571,Perols; Johan Lars,9998,0,9999,1
1657427710615,COGS 9,A01,083615,Shannon; Kyle Michael,9,0,75,66
1657427716654,COGS 11,A01,083617,Boyle; Mary E. T.,22,0,48,26
1657427722678,COGS 13,A01,083071,Bastos; Amalia Pinkusfeld,11,0,71,60
1657427728699,COGS 14A,A01,092681,Semenuks; Arturs,5,1,100,95
1657427734722,COGS 14B,A01,083073,Cheng; Tzu-Han,6,0,63,57
1657427740744,COGS 17,A01,092677,Semenuks; Arturs,6,0,81,75
1657427746772,COGS 100,A01,083619,Allen; Michael Gordon,17,0,70,53
1657427752797,COGS 101A,A01,083621,Davis; Joshua Daniel,9,0,68,59
1657427758820,COGS 101B,A01,091572,Allen; Michael Gordon,12,0,65,53
1657427764846,COGS 101C,A01,083625,Delgado; Tania,17,0,35,18
1657427770873,COGS 107A,A01,083627,Boyle; Mary E. T.,13,0,60,47
1657427776899,COGS 118A,A01,083075,Gupta; Anjum,21,0,76,55
1657427782926,CSE 3,A50,083646,Miranda; Gregory Joseph,24,0,50,26
1657427788949,CSE 8A,A50,083650,Miranda; Gregory Joseph,17,1,56,39
1657427794973,CSE 11,A01,083080,Cao; Yingjun,6,15,40,34
1657427800995,CSE 12,A01,083652,Krause-Levy; Sophia Louisa,28,1,120,92
1657427807030,CSE 15L,A01,083654,Morris; Justin Loren,9,0,50,41
1657427807030,CSE 15L,A02,083655,Morris; Justin Loren,9,0,50,41
1657427813053,CSE 20,A01,083657,Tran; Khoa Dang,39,0,80,41
1657427819078,CSE 21,A01,095574,Bach; Quang Tran,22,0,48,26
1657427825100,CSE 30,A01,083084,Eldon; John,4,0,80,76
1657427825100,CSE 30,B01,095061,Bhaskar; Nishant,9,0,50,41
1657427831125,CSE 100,A01,083659,Cao; Yingjun,5,4,70,65
1657427837146,CSE 134B,A01,083661,Powell; Thomas Allan,22,0,100,78
1657427843174,CSE 140,A01,083663,Gungor; Onat,15,0,85,70
1657427849197,CSE 140L,A01,083088,Eldon; John,21,0,100,79
1657427855222,CSE 175,A01,083665,Kumar; Rakesh,3,0,25,22
1657427861249,CSE 190,A00,092507,Dubnov; Shlomo,7,0,20,13
1657427867271,ECE 45,A01,083139,Congero; Spencer William,6,0,75,69
1657427873294,ECE 65,A50,083695,Saad; Andrew S,12,0,30,18
1657427873294,ECE 65,A51,095125,Saad; Andrew S,24,0,26,2
1657427879317,ECE 109,A01,091882,Touri; Behrouz,19,0,70,51
1657427885341,ECE 180,A00,083140,Abi Samra; Nicholas Camill,1,0,30,29
1657427885341,ECE 180,B00,083141,Abi Samra; Nicholas Camill,0,0,30,30
1657427891379,MATH 10A,A01,083735,Patchell; Gregory David,2,0,30,28
1657427891379,MATH 10A,A02,083736,Patchell; Gregory David,20,0,30,10
1657427891379,MATH 10A,A03,083737,Patchell; Gregory David,16,0,30,14
1657427897402,MATH 10B,A01,083207,Lim; Seonhee,8,0,34,26
1657427897402,MATH 10B,A02,083208,Lim; Seonhee,9,0,35,26
1657427897402,MATH 10B,A03,093472,Lim; Seonhee,7,0,34,27
1657427897402,MATH 10B,B01,083739,Sinha; Shubham,12,0,30,18
1657427903432,MATH 18,A01,083743,Cinel; Cameron Alexander,7,0,30,23
1657427903432,MATH 18,A02,083744,Cinel; Cameron Alexander,17,0,30,13
1657427903432,MATH 18,A03,083745,Cinel; Cameron Alexander,9,0,30,21
1657427903432,MATH 18,B01,083748,Rideout; David Porter,5,0,37,32
1657427903432,MATH 18,B02,083749,Rideout; David Porter,5,0,36,31
1657427903432,MATH 18,B03,083750,Rideout; David Porter,3,0,37,34
1657427903432,MATH 18,B04,083751,Rideout; David Porter,6,0,36,30
1657427903432,MATH 18,B05,093473,Rideout; David Porter,6,0,36,30
1657427903432,MATH 18,B06,093474,Rideout; David Porter,6,0,36,30
1657427909457,MATH 20A,A01,083754,Zheng; Zequn,14,0,40,26
1657427915493,MATH 20B,A01,083756,Briones; Jor-el Thomas Caparas,4,0,36,32
1657427915493,MATH 20B,A02,083757,Briones; Jor-el Thomas Caparas,1,0,36,35
1657427915493,MATH 20B,A03,093475,Briones; Jor-el Thomas Caparas,2,0,36,34
1657427921520,MATH 20C,A01,083760,Briones; Jor-el Thomas Caparas,1,0,35,34
1657427921520,MATH 20C,A02,083761,Briones; Jor-el Thomas Caparas,8,0,35,27
1657427921520,MATH 20C,A03,093476,Briones; Jor-el Thomas Caparas,0,1,36,36
1657427921520,MATH 20C,B01,083762,Bach; Quang Tran,1,0,30,29
1657427927547,MATH 20D,A01,083765,Tran; Brian Kha,5,0,30,25
1657427927547,MATH 20D,A02,083766,Tran; Brian Kha,5,0,30,25
1657427927547,MATH 20D,A03,083767,Tran; Brian Kha,5,0,30,25
1657427933572,MATH 20E,A01,083771,Ganguly; Soumya,9,0,32,23
1657427933572,MATH 20E,A02,083772,Ganguly; Soumya,6,0,32,26
1657427933572,MATH 20E,B01,083773,Ciotti; Benjamin,20,0,35,15
1657427933572,MATH 20E,B02,083774,Ciotti; Benjamin,17,0,35,18
1657427939601,MATH 103A,A01,083777,Greenfeld; Be'Eri,3,0,36,33
1657427939601,MATH 103A,A02,083778,Greenfeld; Be'Eri,5,0,36,31
1657427939601,MATH 103A,A03,093561,Greenfeld; Be'Eri,5,0,36,31
1657427939601,MATH 103A,B01,083779,Greenfeld; Be'Eri,7,0,36,29
1657427939601,MATH 103A,B02,083780,Greenfeld; Be'Eri,4,0,36,32
1657427939601,MATH 103A,B03,093562,Greenfeld; Be'Eri,3,0,36,33
1657427945628,MATH 105,A01,085443,Carter; Anne Toulson,15,0,35,20
1657427945628,MATH 105,A02,093477,Carter; Anne Toulson,20,0,35,15
1657427951652,MATH 109,A01,083213,Ganzberger; Geoffrey Michael,2,0,34,32
1657427951652,MATH 109,A02,083214,Ganzberger; Geoffrey Michael,4,0,34,30
1657427951652,MATH 109,A03,093478,Ganzberger; Geoffrey Michael,2,0,34,32
1657427951652,MATH 109,B01,083215,Ganzberger; Geoffrey Michael,1,0,32,31
1657427951652,MATH 109,B02,083216,Ganzberger; Geoffrey Michael,2,0,32,30
1657427951652,MATH 109,B03,093479,Ganzberger; Geoffrey Michael,8,0,32,24
1657427957680,MATH 142A,A01,083219,Chow; Bennett,7,0,32,25
1657427957680,MATH 142A,A02,083220,Chow; Bennett,10,0,32,22
1657427957680,MATH 142A,A03,093480,Chow; Bennett,8,0,32,24
1657427957680,MATH 142A,B03,093481,Chow; Bennett,8,0,32,24
1657427957680,MATH 142A,B04,093558,Chow; Bennett,13,0,32,19
1657427957680,MATH 142A,B05,093559,Chow; Bennett,6,0,32,26
1657427963703,MATH 193A,A01,083224,Rotar; Vladimir,8,0,34,26
1657427963703,MATH 193A,A02,083225,Rotar; Vladimir,9,0,34,25
1657427963703,MATH 193A,A03,083781,Rotar; Vladimir,5,0,34,29
1657427963703,MATH 193A,A04,083782,Rotar; Vladimir,10,0,34,24
1657427963703,MATH 193A,A05,093482,Rotar; Vladimir,10,0,34,24
1657427969726,MATH 197,001,091859,McAuley; Julian John,9999,0,9999,0
1657427969726,MATH 197,002,095566,Kedlaya; Kiran S.,9997,0,9999,2
1657427969726,MATH 197,003,095567,Xiao; Ming,9999,0,9999,0
1657427969726,MATH 197,004,095571,Perols; Johan Lars,9998,0,9999,1
1657427976790,COGS 9,A01,083615,Shannon; Kyle Michael,9,0,75,66
1657427982813,COGS 11,A01,083617,Boyle; Mary E. T.,22,0,48,26
1657427988840,COGS 13,A01,083071,Bastos; Amalia Pinkusfeld,11,0,71,60
1657427994866,COGS 14A,A01,092681,Semenuks; Arturs,5,1,100,95
1657428000897,COGS 14B,A01,083073,Cheng; Tzu-Han,6,0,63,57
1657428006922,COGS 17,A01,092677,Semenuks; Arturs,6,0,81,75
1657428012947,COGS 100,A01,083619,Allen; Michael Gordon,17,0,70,53
1657428018970,COGS 101A,A01,083621,Davis; Joshua Daniel,9,0,68,59
1657428024995,COGS 101B,A01,091572,Allen; Michael Gordon,12,0,65,53
1657428031027,COGS 101C,A01,083625,Delgado; Tania,17,0,35,18
1657428037053,COGS 107A,A01,083627,Boyle; Mary E. T.,13,0,60,47
1657428043079,COGS 118A,A01,083075,Gupta; Anjum,21,0,76,55
1657428049102,CSE 3,A50,083646,Miranda; Gregory Joseph,24,0,50,26
1657428055126,CSE 8A,A50,083650,Miranda; Gregory Joseph,17,1,56,39
1657428061148,CSE 11,A01,083080,Cao; Yingjun,6,15,40,34
1657428067250,CSE 12,A01,083652,Krause-Levy; Sophia Louisa,28,1,120,92
1657428073274,CSE 15L,A01,083654,Morris; Justin Loren,9,0,50,41
1657428073274,CSE 15L,A02,083655,Morris; Justin Loren,9,0,50,41
1657428079300,CSE 20,A01,083657,Tran; Khoa Dang,39,0,80,41
1657428085323,CSE 21,A01,095574,Bach; Quang Tran,22,0,48,26
1657428091350,CSE 30,A01,083084,Eldon; John,4,0,80,76
1657428091350,CSE 30,B01,095061,Bhaskar; Nishant,9,0,50,41
1657428097372,CSE 100,A01,083659,Cao; Yingjun,5,4,70,65
1657428103396,CSE 134B,A01,083661,Powell; Thomas Allan,22,0,100,78
1657428109419,CSE 140,A01,083663,Gungor; Onat,15,0,85,70
1657428115443,CSE 140L,A01,083088,Eldon; John,21,0,100,79
1657428121466,CSE 175,A01,083665,Kumar; Rakesh,3,0,25,22
1657428127499,CSE 190,A00,092507,Dubnov; Shlomo,7,0,20,13
1657428133525,ECE 45,A01,083139,Congero; Spencer William,6,0,75,69
1657428139555,ECE 65,A50,083695,Saad; Andrew S,12,0,30,18
1657428139555,ECE 65,A51,095125,Saad; Andrew S,24,0,26,2
1657428145585,ECE 109,A01,091882,Touri; Behrouz,19,0,70,51
1657428151609,ECE 180,A00,083140,Abi Samra; Nicholas Camill,1,0,30,29
1657428151609,ECE 180,B00,083141,Abi Samra; Nicholas Camill,0,0,30,30
1657428157634,MATH 10A,A01,083735,Patchell; Gregory David,2,0,30,28
1657428157634,MATH 10A,A02,083736,Patchell; Gregory David,20,0,30,10
1657428157634,MATH 10A,A03,083737,Patchell; Gregory David,16,0,30,14
1657428163662,MATH 10B,A01,083207,Lim; Seonhee,8,0,34,26
1657428163662,MATH 10B,A02,083208,Lim; Seonhee,9,0,35,26
1657428163662,MATH 10B,A03,093472,Lim; Seonhee,7,0,34,27
1657428163662,MATH 10B,B01,083739,Sinha; Shubham,12,0,30,18
1657428169692,MATH 18,A01,083743,Cinel; Cameron Alexander,7,0,30,23
1657428169692,MATH 18,A02,083744,Cinel; Cameron Alexander,17,0,30,13
1657428169692,MATH 18,A03,083745,Cinel; Cameron Alexander,9,0,30,21
1657428169692,MATH 18,B01,083748,Rideout; David Porter,5,0,37,32
1657428169692,MATH 18,B02,083749,Rideout; David Porter,5,0,36,31
1657428169692,MATH 18,B03,083750,Rideout; David Porter,3,0,37,34
1657428169692,MATH 18,B04,083751,Rideout; David Porter,6,0,36,30
1657428169692,MATH 18,B05,093473,Rideout; David Porter,6,0,36,30
1657428169692,MATH 18,B06,093474,Rideout; David Porter,6,0,36,30
1657428175717,MATH 20A,A01,083754,Zheng; Zequn,14,0,40,26
1657428181755,MATH 20B,A01,083756,Briones; Jor-el Thomas Caparas,4,0,36,32
1657428181755,MATH 20B,A02,083757,Briones; Jor-el Thomas Caparas,1,0,36,35
1657428181755,MATH 20B,A03,093475,Briones; Jor-el Thomas Caparas,2,0,36,34
1657428187781,MATH 20C,A01,083760,Briones; Jor-el Thomas Caparas,1,0,35,34
1657428187781,MATH 20C,A02,083761,Briones; Jor-el Thomas Caparas,8,0,35,27
1657428187781,MATH 20C,A03,093476,Briones; Jor-el Thomas Caparas,0,1,36,36
1657428187781,MATH 20C,B01,083762,Bach; Quang Tran,1,0,30,29
1657428193803,MATH 20D,A01,083765,Tran; Brian Kha,5,0,30,25
1657428193803,MATH 20D,A02,083766,Tran; Brian Kha,5,0,30,25
1657428193803,MATH 20D,A03,083767,Tran; Brian Kha,5,0,30,25
1657428199831,MATH 20E,A01,083771,Ganguly; Soumya,9,0,32,23
1657428199831,MATH 20E,A02,083772,Ganguly; Soumya,6,0,32,26
1657428199831,MATH 20E,B01,083773,Ciotti; Benjamin,20,0,35,15
1657428199831,MATH 20E,B02,083774,Ciotti; Benjamin,17,0,35,18
1657428205859,MATH 103A,A01,083777,Greenfeld; Be'Eri,3,0,36,33
1657428205859,MATH 103A,A02,083778,Greenfeld; Be'Eri,5,0,36,31
1657428205859,MATH 103A,A03,093561,Greenfeld; Be'Eri,5,0,36,31
1657428205859,MATH 103A,B01,083779,Greenfeld; Be'Eri,7,0,36,29
1657428205859,MATH 103A,B02,083780,Greenfeld; Be'Eri,4,0,36,32
1657428205859,MATH 103A,B03,093562,Greenfeld; Be'Eri,3,0,36,33
1657428211886,MATH 105,A01,085443,Carter; Anne Toulson,15,0,35,20
1657428211886,MATH 105,A02,093477,Carter; Anne Toulson,20,0,35,15
1657428217908,MATH 109,A01,083213,Ganzberger; Geoffrey Michael,2,0,34,32
1657428217908,MATH 109,A02,083214,Ganzberger; Geoffrey Michael,4,0,34,30
1657428217908,MATH 109,A03,093478,Ganzberger; Geoffrey Michael,2,0,34,32
1657428217908,MATH 109,B01,083215,Ganzberger; Geoffrey Michael,1,0,32,31
1657428217908,MATH 109,B02,083216,Ganzberger; Geoffrey Michael,2,0,32,30
1657428217908,MATH 109,B03,093479,Ganzberger; Geoffrey Michael,8,0,32,24
1657428223936,MATH 142A,A01,083219,Chow; Bennett,7,0,32,25
1657428223936,MATH 142A,A02,083220,Chow; Bennett,10,0,32,22
1657428223936,MATH 142A,A03,093480,Chow; Bennett,8,0,32,24
1657428223936,MATH 142A,B03,093481,Chow; Bennett,8,0,32,24
1657428223936,MATH 142A,B04,093558,Chow; Bennett,13,0,32,19
1657428223936,MATH 142A,B05,093559,Chow; Bennett,6,0,32,26
1657428229959,MATH 193A,A01,083224,Rotar; Vladimir,8,0,34,26
1657428229959,MATH 193A,A02,083225,Rotar; Vladimir,9,0,34,25
1657428229959,MATH 193A,A03,083781,Rotar; Vladimir,5,0,34,29
1657428229959,MATH 193A,A04,083782,Rotar; Vladimir,10,0,34,24
1657428229959,MATH 193A,A05,093482,Rotar; Vladimir,10,0,34,24
1657428235982,MATH 197,001,091859,McAuley; Julian John,9999,0,9999,0
1657428235982,MATH 197,002,095566,Kedlaya; Kiran S.,9997,0,9999,2
1657428235982,MATH 197,003,095567,Xiao; Ming,9999,0,9999,0
1657428235982,MATH 197,004,095571,Perols; Johan Lars,9998,0,9999,1
1657428243053,COGS 9,A01,083615,Shannon; Kyle Michael,9,0,75,66
1657428249076,COGS 11,A01,083617,Boyle; Mary E. T.,22,0,48,26
1657428255103,COGS 13,A01,083071,Bastos; Amalia Pinkusfeld,11,0,71,60
1657428261146,COGS 14A,A01,092681,Semenuks; Arturs,5,1,100,95
1657428267169,COGS 14B,A01,083073,Cheng; Tzu-Han,6,0,63,57
1657428273192,COGS 17,A01,092677,Semenuks; Arturs,6,0,81,75
1657428279216,COGS 100,A01,083619,Allen; Michael Gordon,17,0,70,53
1657428285240,COGS 101A,A01,083621,Davis; Joshua Daniel,9,0,68,59
1657428291265,COGS 101B,A01,091572,Allen; Michael Gordon,12,0,65,53
1657428297286,COGS 101C,A01,083625,Delgado; Tania,17,0,35,18
1657428303313,COGS 107A,A01,083627,Boyle; Mary E. T.,13,0,60,47
1657428309351,COGS 118A,A01,083075,Gupta; Anjum,21,0,76,55
1657428315375,CSE 3,A50,083646,Miranda; Gregory Joseph,24,0,50,26
1657428321399,CSE 8A,A50,083650,Miranda; Gregory Joseph,17,1,56,39
1657428327421,CSE 11,A01,083080,Cao; Yingjun,6,15,40,34
1657428333467,CSE 12,A01,083652,Krause-Levy; Sophia Louisa,28,1,120,92
1657428339490,CSE 15L,A01,083654,Morris; Justin Loren,9,0,50,41
1657428339490,CSE 15L,A02,083655,Morris; Justin Loren,9,0,50,41
1657428345519,CSE 20,A01,083657,Tran; Khoa Dang,39,0,80,41
1657428351544,CSE 21,A01,095574,Bach; Quang Tran,22,0,48,26
1657428357573,CSE 30,A01,083084,Eldon; John,4,0,80,76
1657428357573,CSE 30,B01,095061,Bhaskar; Nishant,9,0,50,41
1657428363595,CSE 100,A01,083659,Cao; Yingjun,5,4,70,65
1657428369622,CSE 134B,A01,083661,Powell; Thomas Allan,22,0,100,78
1657428375644,CSE 140,A01,083663,Gungor; Onat,15,0,85,70
1657428381674,CSE 140L,A01,083088,Eldon; John,21,0,100,79
1657428387698,CSE 175,A01,083665,Kumar; Rakesh,3,0,25,22
1657428393724,CSE 190,A00,092507,Dubnov; Shlomo,7,0,20,13
1657428399751,ECE 45,A01,083139,Congero; Spencer William,6,0,75,69
1657428405778,ECE 65,A50,083695,Saad; Andrew S,12,0,30,18
1657428405778,ECE 65,A51,095125,Saad; Andrew S,24,0,26,2
1657428411805,ECE 109,A01,091882,Touri; Behrouz,19,0,70,51
1657428417827,ECE 180,A00,083140,Abi Samra; Nicholas Camill,1,0,30,29
1657428417827,ECE 180,B00,083141,Abi Samra; Nicholas Camill,0,0,30,30
1657428423852,MATH 10A,A01,083735,Patchell; Gregory David,2,0,30,28
1657428423852,MATH 10A,A02,083736,Patchell; Gregory David,20,0,30,10
1657428423852,MATH 10A,A03,083737,Patchell; Gregory David,16,0,30,14
1657428429880,MATH 10B,A01,083207,Lim; Seonhee,8,0,34,26
1657428429880,MATH 10B,A02,083208,Lim; Seonhee,9,0,35,26
1657428429880,MATH 10B,A03,093472,Lim; Seonhee,7,0,34,27
1657428429880,MATH 10B,B01,083739,Sinha; Shubham,12,0,30,18
1657428435912,MATH 18,A01,083743,Cinel; Cameron Alexander,7,0,30,23
1657428435912,MATH 18,A02,083744,Cinel; Cameron Alexander,17,0,30,13
1657428435912,MATH 18,A03,083745,Cinel; Cameron Alexander,9,0,30,21
1657428435912,MATH 18,B01,083748,Rideout; David Porter,5,0,37,32
1657428435912,MATH 18,B02,083749,Rideout; David Porter,5,0,36,31
1657428435912,MATH 18,B03,083750,Rideout; David Porter,3,0,37,34
1657428435912,MATH 18,B04,083751,Rideout; David Porter,6,0,36,30
1657428435912,MATH 18,B05,093473,Rideout; David Porter,6,0,36,30
1657428435912,MATH 18,B06,093474,Rideout; David Porter,6,0,36,30
1657428441939,MATH 20A,A01,083754,Zheng; Zequn,14,0,40,26
1657428447967,MATH 20B,A01,083756,Briones; Jor-el Thomas Caparas,4,0,36,32
1657428447967,MATH 20B,A02,083757,Briones; Jor-el Thomas Caparas,1,0,36,35
1657428447967,MATH 20B,A03,093475,Briones; Jor-el Thomas Caparas,2,0,36,34
1657428453995,MATH 20C,A01,083760,Briones; Jor-el Thomas Caparas,1,0,35,34
1657428453995,MATH 20C,A02,083761,Briones; Jor-el Thomas Caparas,8,0,35,27
1657428453995,MATH 20C,A03,093476,Briones; Jor-el Thomas Caparas,0,1,36,36
1657428453995,MATH 20C,B01,083762,Bach; Quang Tran,1,0,30,29
1657428460027,MATH 20D,A01,083765,Tran; Brian Kha,5,0,30,25
1657428460027,MATH 20D,A02,083766,Tran; Brian Kha,5,0,30,25
1657428460027,MATH 20D,A03,083767,Tran; Brian Kha,5,0,30,25
1657428466058,MATH 20E,A01,083771,Ganguly; Soumya,9,0,32,23
1657428466058,MATH 20E,A02,083772,Ganguly; Soumya,6,0,32,26
1657428466058,MATH 20E,B01,083773,Ciotti; Benjamin,20,0,35,15
1657428466058,MATH 20E,B02,083774,Ciotti; Benjamin,17,0,35,18
1657428472084,MATH 103A,A01,083777,Greenfeld; Be'Eri,3,0,36,33
1657428472084,MATH 103A,A02,083778,Greenfeld; Be'Eri,5,0,36,31
1657428472084,MATH 103A,A03,093561,Greenfeld; Be'Eri,5,0,36,31
1657428472084,MATH 103A,B01,083779,Greenfeld; Be'Eri,7,0,36,29
1657428472084,MATH 103A,B02,083780,Greenfeld; Be'Eri,4,0,36,32
1657428472084,MATH 103A,B03,093562,Greenfeld; Be'Eri,3,0,36,33
1657428478106,MATH 105,A01,085443,Carter; Anne Toulson,15,0,35,20
1657428478106,MATH 105,A02,093477,Carter; Anne Toulson,20,0,35,15
1657428484129,MATH 109,A01,083213,Ganzberger; Geoffrey Michael,2,0,34,32
1657428484129,MATH 109,A02,083214,Ganzberger; Geoffrey Michael,4,0,34,30
1657428484129,MATH 109,A03,093478,Ganzberger; Geoffrey Michael,2,0,34,32
1657428484129,MATH 109,B01,083215,Ganzberger; Geoffrey Michael,1,0,32,31
1657428484129,MATH 109,B02,083216,Ganzberger; Geoffrey Michael,2,0,32,30
1657428484129,MATH 109,B03,093479,Ganzberger; Geoffrey Michael,8,0,32,24
1657428490158,MATH 142A,A01,083219,Chow; Bennett,7,0,32,25
1657428490158,MATH 142A,A02,083220,Chow; Bennett,10,0,32,22
1657428490158,MATH 142A,A03,093480,Chow; Bennett,8,0,32,24
1657428490158,MATH 142A,B03,093481,Chow; Bennett,8,0,32,24
1657428490158,MATH 142A,B04,093558,Chow; Bennett,13,0,32,19
1657428490158,MATH 142A,B05,093559,Chow; Bennett,6,0,32,26
1657428496181,MATH 193A,A01,083224,Rotar; Vladimir,8,0,34,26
1657428496181,MATH 193A,A02,083225,Rotar; Vladimir,9,0,34,25
1657428496181,MATH 193A,A03,083781,Rotar; Vladimir,5,0,34,29
1657428496181,MATH 193A,A04,083782,Rotar; Vladimir,10,0,34,24
1657428496181,MATH 193A,A05,093482,Rotar; Vladimir,10,0,34,24
1657428502213,MATH 197,001,091859,McAuley; Julian John,9999,0,9999,0
1657428502213,MATH 197,002,095566,Kedlaya; Kiran S.,9997,0,9999,2
1657428502213,MATH 197,003,095567,Xiao; Ming,9999,0,9999,0
1657428502213,MATH 197,004,095571,Perols; Johan Lars,9998,0,9999,1
1657428509276,COGS 9,A01,083615,Shannon; Kyle Michael,9,0,75,66
1657428515298,COGS 11,A01,083617,Boyle; Mary E. T.,22,0,48,26
1657428521321,COGS 13,A01,083071,Bastos; Amalia Pinkusfeld,11,0,71,60
1657428527349,COGS 14A,A01,092681,Semenuks; Arturs,5,1,100,95
1657428533376,COGS 14B,A01,083073,Cheng; Tzu-Han,6,0,63,57
1657428539399,COGS 17,A01,092677,Semenuks; Arturs,6,0,81,75
1657428545433,COGS 100,A01,083619,Allen; Michael Gordon,17,0,70,53
1657428551456,COGS 101A,A01,083621,Davis; Joshua Daniel,9,0,68,59
1657428557479,COGS 101B,A01,091572,Allen; Michael Gordon,12,0,65,53
1657428563501,COGS 101C,A01,083625,Delgado; Tania,17,0,35,18
1657428569523,COGS 107A,A01,083627,Boyle; Mary E. T.,13,0,60,47
1657428575549,COGS 118A,A01,083075,Gupta; Anjum,21,0,76,55
1657428581572,CSE 3,A50,083646,Miranda; Gregory Joseph,24,0,50,26
1657428587600,CSE 8A,A50,083650,Miranda; Gregory Joseph,17,1,56,39
1657428593623,CSE 11,A01,083080,Cao; Yingjun,6,15,40,34
1657428599647,CSE 12,A01,083652,Krause-Levy; Sophia Louisa,28,1,120,92
1657428605671,CSE 15L,A01,083654,Morris; Justin Loren,9,0,50,41
1657428605671,CSE 15L,A02,083655,Morris; Justin Loren,9,0,50,41
1657428611696,CSE 20,A01,083657,Tran; Khoa Dang,39,0,80,41
1657428617719,CSE 21,A01,095574,Bach; Quang Tran,22,0,48,26
1657428623743,CSE 30,A01,083084,Eldon; John,5,0,80,75
1657428623743,CSE 30,B01,095061,Bhaskar; Nishant,9,0,50,41
1657428629766,CSE 100,A01,083659,Cao; Yingjun,5,4,70,65
1657428635790,CSE 134B,A01,083661,Powell; Thomas Allan,22,0,100,78
1657428641812,CSE 140,A01,083663,Gungor; Onat,15,0,85,70
1657428647840,CSE 140L,A01,083088,Eldon; John,21,0,100,79
1657428653864,CSE 175,A01,083665,Kumar; Rakesh,3,0,25,22
1657428659889,CSE 190,A00,092507,Dubnov; Shlomo,7,0,20,13
1657428665990,ECE 45,A01,083139,Congero; Spencer William,6,0,75,69
1657428672024,ECE 65,A50,083695,Saad; Andrew S,12,0,30,18
1657428672024,ECE 65,A51,095125,Saad; Andrew S,24,0,26,2
1657428678047,ECE 109,A01,091882,Touri; Behrouz,19,0,70,51
1657428684082,ECE 180,A00,083140,Abi Samra; Nicholas Camill,1,0,30,29
1657428684082,ECE 180,B00,083141,Abi Samra; Nicholas Camill,0,0,30,30
1657428690106,MATH 10A,A01,083735,Patchell; Gregory David,2,0,30,28
1657428690106,MATH 10A,A02,083736,Patchell; Gregory David,20,0,30,10
1657428690106,MATH 10A,A03,083737,Patchell; Gregory David,16,0,30,14
1657428696131,MATH 10B,A01,083207,Lim; Seonhee,8,0,34,26
1657428696131,MATH 10B,A02,083208,Lim; Seonhee,9,0,35,26
1657428696131,MATH 10B,A03,093472,Lim; Seonhee,7,0,34,27
1657428696131,MATH 10B,B01,083739,Sinha; Shubham,12,0,30,18
1657428702156,MATH 18,A01,083743,Cinel; Cameron Alexander,7,0,30,23
1657428702156,MATH 18,A02,083744,Cinel; Cameron Alexander,17,0,30,13
1657428702156,MATH 18,A03,083745,Cinel; Cameron Alexander,9,0,30,21
1657428702156,MATH 18,B01,083748,Rideout; David Porter,5,0,37,32
1657428702156,MATH 18,B02,083749,Rideout; David Porter,5,0,36,31
1657428702156,MATH 18,B03,083750,Rideout; David Porter,3,0,37,34
1657428702156,MATH 18,B04,083751,Rideout; David Porter,6,0,36,30
1657428702156,MATH 18,B05,093473,Rideout; David Porter,6,0,36,30
1657428702156,MATH 18,B06,093474,Rideout; David Porter,6,0,36,30
1657428708184,MATH 20A,A01,083754,Zheng; Zequn,14,0,40,26
1657428714211,MATH 20B,A01,083756,Briones; Jor-el Thomas Caparas,4,0,36,32
1657428714211,MATH 20B,A02,083757,Briones; Jor-el Thomas Caparas,1,0,36,35
1657428714211,MATH 20B,A03,093475,Briones; Jor-el Thomas Caparas,2,0,36,34
1657428720234,MATH 20C,A01,083760,Briones; Jor-el Thomas Caparas,1,0,35,34
1657428720234,MATH 20C,A02,083761,Briones; Jor-el Thomas Caparas,8,0,35,27
1657428720234,MATH 20C,A03,093476,Briones; Jor-el Thomas Caparas,0,1,36,36
1657428720234,MATH 20C,B01,083762,Bach; Quang Tran,1,0,30,29
1657428726258,MATH 20D,A01,083765,Tran; Brian Kha,5,0,30,25
1657428726258,MATH 20D,A02,083766,Tran; Brian Kha,5,0,30,25
1657428726258,MATH 20D,A03,083767,Tran; Brian Kha,5,0,30,25
1657428732282,MATH 20E,A01,083771,Ganguly; Soumya,9,0,32,23
1657428732282,MATH 20E,A02,083772,Ganguly; Soumya,6,0,32,26
1657428732282,MATH 20E,B01,083773,Ciotti; Benjamin,20,0,35,15
1657428732282,MATH 20E,B02,083774,Ciotti; Benjamin,17,0,35,18
1657428738312,MATH 103A,A01,083777,Greenfeld; Be'Eri,3,0,36,33
1657428738312,MATH 103A,A02,083778,Greenfeld; Be'Eri,5,0,36,31
1657428738312,MATH 103A,A03,093561,Greenfeld; Be'Eri,5,0,36,31
1657428738312,MATH 103A,B01,083779,Greenfeld; Be'Eri,7,0,36,29
1657428738312,MATH 103A,B02,083780,Greenfeld; Be'Eri,4,0,36,32
1657428738312,MATH 103A,B03,093562,Greenfeld; Be'Eri,3,0,36,33
1657428744335,MATH 105,A01,085443,Carter; Anne Toulson,15,0,35,20
1657428744335,MATH 105,A02,093477,Carter; Anne Toulson,20,0,35,15
1657428750364,MATH 109,A01,083213,Ganzberger; Geoffrey Michael,2,0,34,32
1657428750364,MATH 109,A02,083214,Ganzberger; Geoffrey Michael,4,0,34,30
1657428750364,MATH 109,A03,093478,Ganzberger; Geoffrey Michael,2,0,34,32
1657428750364,MATH 109,B01,083215,Ganzberger; Geoffrey Michael,1,0,32,31
1657428750364,MATH 109,B02,083216,Ganzberger; Geoffrey Michael,2,0,32,30
1657428750364,MATH 109,B03,093479,Ganzberger; Geoffrey Michael,8,0,32,24
1657428756392,MATH 142A,A01,083219,Chow; Bennett,7,0,32,25
1657428756392,MATH 142A,A02,083220,Chow; Bennett,10,0,32,22
1657428756392,MATH 142A,A03,093480,Chow; Bennett,8,0,32,24
1657428756392,MATH 142A,B03,093481,Chow; Bennett,8,0,32,24
1657428756392,MATH 142A,B04,093558,Chow; Bennett,13,0,32,19
1657428756392,MATH 142A,B05,093559,Chow; Bennett,6,0,32,26
1657428762416,MATH 193A,A01,083224,Rotar; Vladimir,8,0,34,26
1657428762416,MATH 193A,A02,083225,Rotar; Vladimir,9,0,34,25
1657428762416,MATH 193A,A03,083781,Rotar; Vladimir,5,0,34,29
1657428762416,MATH 193A,A04,083782,Rotar; Vladimir,10,0,34,24
1657428762416,MATH 193A,A05,093482,Rotar; Vladimir,10,0,34,24
1657428768442,MATH 197,001,091859,McAuley; Julian John,9999,0,9999,0
1657428768442,MATH 197,002,095566,Kedlaya; Kiran S.,9997,0,9999,2
1657428768442,MATH 197,003,095567,Xiao; Ming,9999,0,9999,0
1657428768442,MATH 197,004,095571,Perols; Johan Lars,9998,0,9999,1
1657428775505,COGS 9,A01,083615,Shannon; Kyle Michael,9,0,75,66
1657428781527,COGS 11,A01,083617,Boyle; Mary E. T.,22,0,48,26
1657428787553,COGS 13,A01,083071,Bastos; Amalia Pinkusfeld,11,0,71,60
1657428793579,COGS 14A,A01,092681,Semenuks; Arturs,5,1,100,95
1657428799602,COGS 14B,A01,083073,Cheng; Tzu-Han,6,0,63,57
1657428805629,COGS 17,A01,092677,Semenuks; Arturs,6,0,81,75
1657428811655,COGS 100,A01,083619,Allen; Michael Gordon,17,0,70,53
1657428817680,COGS 101A,A01,083621,Davis; Joshua Daniel,9,0,68,59
1657428823703,COGS 101B,A01,091572,Allen; Michael Gordon,12,0,65,53
1657428829728,COGS 101C,A01,083625,Delgado; Tania,17,0,35,18
1657428835751,COGS 107A,A01,083627,Boyle; Mary E. T.,13,0,60,47
1657428841773,COGS 118A,A01,083075,Gupta; Anjum,21,0,76,55
1657428847800,CSE 3,A50,083646,Miranda; Gregory Joseph,24,0,50,26
1657428853827,CSE 8A,A50,083650,Miranda; Gregory Joseph,17,1,56,39
1657428859856,CSE 11,A01,083080,Cao; Yingjun,6,15,40,34
1657428865878,CSE 12,A01,083652,Krause-Levy; Sophia Louisa,28,1,120,92
1657428871902,CSE 15L,A01,083654,Morris; Justin Loren,9,0,50,41
1657428871902,CSE 15L,A02,083655,Morris; Justin Loren,9,0,50,41
1657428877928,CSE 20,A01,083657,Tran; Khoa Dang,39,0,80,41
1657428883952,CSE 21,A01,095574,Bach; Quang Tran,22,0,48,26
1657428889975,CSE 30,A01,083084,Eldon; John,5,0,80,75
1657428889975,CSE 30,B01,095061,Bhaskar; Nishant,9,0,50,41
1657428895998,CSE 100,A01,083659,Cao; Yingjun,5,4,70,65
1657428902029,CSE 134B,A01,083661,Powell; Thomas Allan,22,0,100,78
1657428908054,CSE 140,A01,083663,Gungor; Onat,15,0,85,70
1657428914082,CSE 140L,A01,083088,Eldon; John,21,0,100,79
1657428920106,CSE 175,A01,083665,Kumar; Rakesh,3,0,25,22
1657428926130,CSE 190,A00,092507,Dubnov; Shlomo,7,0,20,13
1657428932153,ECE 45,A01,083139,Congero; Spencer William,6,0,75,69
1657428938176,ECE 65,A50,083695,Saad; Andrew S,12,0,30,18
1657428938176,ECE 65,A51,095125,Saad; Andrew S,24,0,26,2
1657428944202,ECE 109,A01,091882,Touri; Behrouz,19,0,70,51
1657428950237,ECE 180,A00,083140,Abi Samra; Nicholas Camill,1,0,30,29
1657428950237,ECE 180,B00,083141,Abi Samra; Nicholas Camill,0,0,30,30
1657428956268,MATH 10A,A01,083735,Patchell; Gregory David,2,0,30,28
1657428956268,MATH 10A,A02,083736,Patchell; Gregory David,20,0,30,10
1657428956268,MATH 10A,A03,083737,Patchell; Gregory David,16,0,30,14
1657428962292,MATH 10B,A01,083207,Lim; Seonhee,8,0,34,26
1657428962292,MATH 10B,A02,083208,Lim; Seonhee,9,0,35,26
1657428962292,MATH 10B,A03,093472,Lim; Seonhee,7,0,34,27
1657428962292,MATH 10B,B01,083739,Sinha; Shubham,12,0,30,18
1657428968329,MATH 18,A01,083743,Cinel; Cameron Alexander,7,0,30,23
1657428968329,MATH 18,A02,083744,Cinel; Cameron Alexander,17,0,30,13
1657428968329,MATH 18,A03,083745,Cinel; Cameron Alexander,9,0,30,21
1657428968329,MATH 18,B01,083748,Rideout; David Porter,5,0,37,32
1657428968329,MATH 18,B02,083749,Rideout; David Porter,5,0,36,31
1657428968329,MATH 18,B03,083750,Rideout; David Porter,3,0,37,34
1657428968329,MATH 18,B04,083751,Rideout; David Porter,6,0,36,30
1657428968329,MATH 18,B05,093473,Rideout; David Porter,6,0,36,30
1657428968329,MATH 18,B06,093474,Rideout; David Porter,6,0,36,30
1657428974350,MATH 20A,A01,083754,Zheng; Zequn,14,0,40,26
1657428980373,MATH 20B,A01,083756,Briones; Jor-el Thomas Caparas,4,0,36,32
1657428980373,MATH 20B,A02,083757,Briones; Jor-el Thomas Caparas,1,0,36,35
1657428980373,MATH 20B,A03,093475,Briones; Jor-el Thomas Caparas,2,0,36,34
1657428986400,MATH 20C,A01,083760,Briones; Jor-el Thomas Caparas,1,0,35,34
1657428986400,MATH 20C,A02,083761,Briones; Jor-el Thomas Caparas,8,0,35,27
1657428986400,MATH 20C,A03,093476,Briones; Jor-el Thomas Caparas,0,1,36,36
1657428986400,MATH 20C,B01,083762,Bach; Quang Tran,1,0,30,29
1657428992427,MATH 20D,A01,083765,Tran; Brian Kha,5,0,30,25
1657428992427,MATH 20D,A02,083766,Tran; Brian Kha,5,0,30,25
1657428992427,MATH 20D,A03,083767,Tran; Brian Kha,5,0,30,25
1657428998455,MATH 20E,A01,083771,Ganguly; Soumya,9,0,32,23
1657428998455,MATH 20E,A02,083772,Ganguly; Soumya,6,0,32,26
1657428998455,MATH 20E,B01,083773,Ciotti; Benjamin,20,0,35,15
1657428998455,MATH 20E,B02,083774,Ciotti; Benjamin,17,0,35,18
1657429004480,MATH 103A,A01,083777,Greenfeld; Be'Eri,3,0,36,33
1657429004480,MATH 103A,A02,083778,Greenfeld; Be'Eri,5,0,36,31
1657429004480,MATH 103A,A03,093561,Greenfeld; Be'Eri,5,0,36,31
1657429004480,MATH 103A,B01,083779,Greenfeld; Be'Eri,7,0,36,29
1657429004480,MATH 103A,B02,083780,Greenfeld; Be'Eri,4,0,36,32
1657429004480,MATH 103A,B03,093562,Greenfeld; Be'Eri,3,0,36,33
1657429010504,MATH 105,A01,085443,Carter; Anne Toulson,15,0,35,20
1657429010504,MATH 105,A02,093477,Carter; Anne Toulson,20,0,35,15
1657429016526,MATH 109,A01,083213,Ganzberger; Geoffrey Michael,2,0,34,32
1657429016526,MATH 109,A02,083214,Ganzberger; Geoffrey Michael,4,0,34,30
1657429016526,MATH 109,A03,093478,Ganzberger; Geoffrey Michael,2,0,34,32
1657429016526,MATH 109,B01,083215,Ganzberger; Geoffrey Michael,1,0,32,31
1657429016526,MATH 109,B02,083216,Ganzberger; Geoffrey Michael,2,0,32,30
1657429016526,MATH 109,B03,093479,Ganzberger; Geoffrey Michael,8,0,32,24
1657429022550,MATH 142A,A01,083219,Chow; Bennett,7,0,32,25
1657429022550,MATH 142A,A02,083220,Chow; Bennett,10,0,32,22
1657429022550,MATH 142A,A03,093480,Chow; Bennett,8,0,32,24
1657429022550,MATH 142A,B03,093481,Chow; Bennett,8,0,32,24
1657429022550,MATH 142A,B04,093558,Chow; Bennett,13,0,32,19
1657429022550,MATH 142A,B05,093559,Chow; Bennett,6,0,32,26
1657429028577,MATH 193A,A01,083224,Rotar; Vladimir,8,0,34,26
1657429028577,MATH 193A,A02,083225,Rotar; Vladimir,9,0,34,25
1657429028577,MATH 193A,A03,083781,Rotar; Vladimir,5,0,34,29
1657429028577,MATH 193A,A04,083782,Rotar; Vladimir,10,0,34,24
1657429028577,MATH 193A,A05,093482,Rotar; Vladimir,10,0,34,24
1657429034604,MATH 197,001,091859,McAuley; Julian John,9999,0,9999,0
1657429034604,MATH 197,002,095566,Kedlaya; Kiran S.,9997,0,9999,2
1657429034604,MATH 197,003,095567,Xiao; Ming,9999,0,9999,0
1657429034604,MATH 197,004,095571,Perols; Johan Lars,9998,0,9999,1
1657429041661,COGS 9,A01,083615,Shannon; Kyle Michael,9,0,75,66
1657429047682,COGS 11,A01,083617,Boyle; Mary E. T.,22,0,48,26
1657429053709,COGS 13,A01,083071,Bastos; Amalia Pinkusfeld,11,0,71,60
1657429059732,COGS 14A,A01,092681,Semenuks; Arturs,5,1,100,95
1657429065767,COGS 14B,A01,083073,Cheng; Tzu-Han,6,0,63,57
1657429071794,COGS 17,A01,092677,Semenuks; Arturs,6,0,81,75
1657429077820,COGS 100,A01,083619,Allen; Michael Gordon,17,0,70,53
1657429083844,COGS 101A,A01,083621,Davis; Joshua Daniel,9,0,68,59
1657429089870,COGS 101B,A01,091572,Allen; Michael Gordon,12,0,65,53
1657429095894,COGS 101C,A01,083625,Delgado; Tania,17,0,35,18
1657429101916,COGS 107A,A01,083627,Boyle; Mary E. T.,13,0,60,47
1657429107937,COGS 118A,A01,083075,Gupta; Anjum,21,0,76,55
1657429113998,CSE 3,A50,083646,Miranda; Gregory Joseph,24,0,50,26
1657429120019,CSE 8A,A50,083650,Miranda; Gregory Joseph,17,1,56,39
1657429126042,CSE 11,A01,083080,Cao; Yingjun,6,15,40,34
1657429132067,CSE 12,A01,083652,Krause-Levy; Sophia Louisa,28,1,120,92
1657429138089,CSE 15L,A01,083654,Morris; Justin Loren,9,0,50,41
1657429138089,CSE 15L,A02,083655,Morris; Justin Loren,9,0,50,41
1657429144116,CSE 20,A01,083657,Tran; Khoa Dang,39,0,80,41
1657429150140,CSE 21,A01,095574,Bach; Quang Tran,22,0,48,26
1657429156162,CSE 30,A01,083084,Eldon; John,5,0,80,75
1657429156162,CSE 30,B01,095061,Bhaskar; Nishant,9,0,50,41
1657429162186,CSE 100,A01,083659,Cao; Yingjun,5,4,70,65
1657429168213,CSE 134B,A01,083661,Powell; Thomas Allan,22,0,100,78
1657429174245,CSE 140,A01,083663,Gungor; Onat,15,0,85,70
1657429180267,CSE 140L,A01,083088,Eldon; John,21,0,100,79
1657429186299,CSE 175,A01,083665,Kumar; Rakesh,3,0,25,22
1657429192322,CSE 190,A00,092507,Dubnov; Shlomo,7,0,20,13
1657429198350,ECE 45,A01,083139,Congero; Spencer William,6,0,75,69
1657429204377,ECE 65,A50,083695,Saad; Andrew S,12,0,30,18
1657429204377,ECE 65,A51,095125,Saad; Andrew S,24,0,26,2
1657429210400,ECE 109,A01,091882,Touri; Behrouz,19,0,70,51
1657429216423,ECE 180,A00,083140,Abi Samra; Nicholas Camill,1,0,30,29
1657429216423,ECE 180,B00,083141,Abi Samra; Nicholas Camill,0,0,30,30
1657429222446,MATH 10A,A01,083735,Patchell; Gregory David,2,0,30,28
1657429222446,MATH 10A,A02,083736,Patchell; Gregory David,20,0,30,10
1657429222446,MATH 10A,A03,083737,Patchell; Gregory David,16,0,30,14
1657429228473,MATH 10B,A01,083207,Lim; Seonhee,8,0,34,26
1657429228473,MATH 10B,A02,083208,Lim; Seonhee,9,0,35,26
1657429228473,MATH 10B,A03,093472,Lim; Seonhee,7,0,34,27
1657429228473,MATH 10B,B01,083739,Sinha; Shubham,12,0,30,18
1657429234496,MATH 18,A01,083743,Cinel; Cameron Alexander,7,0,30,23
1657429234496,MATH 18,A02,083744,Cinel; Cameron Alexander,17,0,30,13
1657429234496,MATH 18,A03,083745,Cinel; Cameron Alexander,9,0,30,21
1657429234496,MATH 18,B01,083748,Rideout; David Porter,5,0,37,32
1657429234496,MATH 18,B02,083749,Rideout; David Porter,5,0,36,31
1657429234496,MATH 18,B03,083750,Rideout; David Porter,3,0,37,34
1657429234496,MATH 18,B04,083751,Rideout; David Porter,6,0,36,30
1657429234496,MATH 18,B05,093473,Rideout; David Porter,6,0,36,30
1657429234496,MATH 18,B06,093474,Rideout; David Porter,6,0,36,30
1657429240521,MATH 20A,A01,083754,Zheng; Zequn,14,0,40,26
1657429246544,MATH 20B,A01,083756,Briones; Jor-el Thomas Caparas,4,0,36,32
1657429246544,MATH 20B,A02,083757,Briones; Jor-el Thomas Caparas,1,0,36,35
1657429246544,MATH 20B,A03,093475,Briones; Jor-el Thomas Caparas,2,0,36,34
1657429252566,MATH 20C,A01,083760,Briones; Jor-el Thomas Caparas,1,0,35,34
1657429252566,MATH 20C,A02,083761,Briones; Jor-el Thomas Caparas,8,0,35,27
1657429252566,MATH 20C,A03,093476,Briones; Jor-el Thomas Caparas,0,1,36,36
1657429252566,MATH 20C,B01,083762,Bach; Quang Tran,1,0,30,29
1657429258589,MATH 20D,A01,083765,Tran; Brian Kha,5,0,30,25
1657429258589,MATH 20D,A02,083766,Tran; Brian Kha,5,0,30,25
1657429258589,MATH 20D,A03,083767,Tran; Brian Kha,5,0,30,25
1657429264695,MATH 20E,A01,083771,Ganguly; Soumya,9,0,32,23
1657429264695,MATH 20E,A02,083772,Ganguly; Soumya,6,0,32,26
1657429264695,MATH 20E,B01,083773,Ciotti; Benjamin,20,0,35,15
1657429264695,MATH 20E,B02,083774,Ciotti; Benjamin,17,0,35,18
1657429270717,MATH 103A,A01,083777,Greenfeld; Be'Eri,3,0,36,33
1657429270717,MATH 103A,A02,083778,Greenfeld; Be'Eri,5,0,36,31
1657429270717,MATH 103A,A03,093561,Greenfeld; Be'Eri,5,0,36,31
1657429270717,MATH 103A,B01,083779,Greenfeld; Be'Eri,7,0,36,29
1657429270717,MATH 103A,B02,083780,Greenfeld; Be'Eri,4,0,36,32
1657429270717,MATH 103A,B03,093562,Greenfeld; Be'Eri,3,0,36,33
1657429276740,MATH 105,A01,085443,Carter; Anne Toulson,15,0,35,20
1657429276740,MATH 105,A02,093477,Carter; Anne Toulson,20,0,35,15
1657429282769,MATH 109,A01,083213,Ganzberger; Geoffrey Michael,2,0,34,32
1657429282769,MATH 109,A02,083214,Ganzberger; Geoffrey Michael,4,0,34,30
1657429282769,MATH 109,A03,093478,Ganzberger; Geoffrey Michael,2,0,34,32
1657429282769,MATH 109,B01,083215,Ganzberger; Geoffrey Michael,1,0,32,31
1657429282769,MATH 109,B02,083216,Ganzberger; Geoffrey Michael,2,0,32,30
1657429282769,MATH 109,B03,093479,Ganzberger; Geoffrey Michael,8,0,32,24
1657429288792,MATH 142A,A01,083219,Chow; Bennett,7,0,32,25
1657429288792,MATH 142A,A02,083220,Chow; Bennett,10,0,32,22
1657429288792,MATH 142A,A03,093480,Chow; Bennett,8,0,32,24
1657429288792,MATH 142A,B03,093481,Chow; Bennett,8,0,32,24
1657429288792,MATH 142A,B04,093558,Chow; Bennett,13,0,32,19
1657429288792,MATH 142A,B05,093559,Chow; Bennett,6,0,32,26
1657429294822,MATH 193A,A01,083224,Rotar; Vladimir,8,0,34,26
1657429294822,MATH 193A,A02,083225,Rotar; Vladimir,9,0,34,25
1657429294822,MATH 193A,A03,083781,Rotar; Vladimir,5,0,34,29
1657429294822,MATH 193A,A04,083782,Rotar; Vladimir,10,0,34,24
1657429294822,MATH 193A,A05,093482,Rotar; Vladimir,10,0,34,24
1657429300849,MATH 197,001,091859,McAuley; Julian John,9999,0,9999,0
1657429300849,MATH 197,002,095566,Kedlaya; Kiran S.,9997,0,9999,2
1657429300849,MATH 197,003,095567,Xiao; Ming,9999,0,9999,0
1657429300849,MATH 197,004,095571,Perols; Johan Lars,9998,0,9999,1
1657429307911,COGS 9,A01,083615,Shannon; Kyle Michael,9,0,75,66
1657429313935,COGS 11,A01,083617,Boyle; Mary E. T.,22,0,48,26
1657429319961,COGS 13,A01,083071,Bastos; Amalia Pinkusfeld,11,0,71,60
1657429325987,COGS 14A,A01,092681,Semenuks; Arturs,5,1,100,95
1657429332011,COGS 14B,A01,083073,Cheng; Tzu-Han,6,0,63,57
1657429338036,COGS 17,A01,092677,Semenuks; Arturs,6,0,81,75
1657429344063,COGS 100,A01,083619,Allen; Michael Gordon,17,0,70,53
1657429350087,COGS 101A,A01,083621,Davis; Joshua Daniel,9,0,68,59
1657429356118,COGS 101B,A01,091572,Allen; Michael Gordon,12,0,65,53
1657429362145,COGS 101C,A01,083625,Delgado; Tania,17,0,35,18
1657429368171,COGS 107A,A01,083627,Boyle; Mary E. T.,13,0,60,47
1657429374194,COGS 118A,A01,083075,Gupta; Anjum,21,0,76,55
1657429380221,CSE 3,A50,083646,Miranda; Gregory Joseph,24,0,50,26
1657429386244,CSE 8A,A50,083650,Miranda; Gregory Joseph,17,1,56,39
1657429392267,CSE 11,A01,083080,Cao; Yingjun,6,15,40,34
1657429398291,CSE 12,A01,083652,Krause-Levy; Sophia Louisa,28,1,120,92
1657429404317,CSE 15L,A01,083654,Morris; Justin Loren,9,0,50,41
1657429404317,CSE 15L,A02,083655,Morris; Justin Loren,9,0,50,41
1657429410344,CSE 20,A01,083657,Tran; Khoa Dang,39,0,80,41
1657429416367,CSE 21,A01,095574,Bach; Quang Tran,22,0,48,26
1657429422389,CSE 30,A01,083084,Eldon; John,5,0,80,75
1657429422389,CSE 30,B01,095061,Bhaskar; Nishant,9,0,50,41
1657429428416,CSE 100,A01,083659,Cao; Yingjun,5,4,70,65
1657429434438,CSE 134B,A01,083661,Powell; Thomas Allan,22,0,100,78
1657429440460,CSE 140,A01,083663,Gungor; Onat,15,0,85,70
1657429446483,CSE 140L,A01,083088,Eldon; John,21,0,100,79
1657429452505,CSE 175,A01,083665,Kumar; Rakesh,3,0,25,22
1657429458529,CSE 190,A00,092507,Dubnov; Shlomo,7,0,20,13
1657429464551,ECE 45,A01,083139,Congero; Spencer William,6,0,75,69
1657429470579,ECE 65,A50,083695,Saad; Andrew S,12,0,30,18
1657429470579,ECE 65,A51,095125,Saad; Andrew S,24,0,26,2
1657429476602,ECE 109,A01,091882,Touri; Behrouz,19,0,70,51
1657429482625,ECE 180,A00,083140,Abi Samra; Nicholas Camill,1,0,30,29
1657429482625,ECE 180,B00,083141,Abi Samra; Nicholas Camill,0,0,30,30
1657429488651,MATH 10A,A01,083735,Patchell; Gregory David,2,0,30,28
1657429488651,MATH 10A,A02,083736,Patchell; Gregory David,20,0,30,10
1657429488651,MATH 10A,A03,083737,Patchell; Gregory David,16,0,30,14
1657429500166,MATH 10B,A01,083207,Lim; Seonhee,8,0,34,26
1657429500166,MATH 10B,A02,083208,Lim; Seonhee,9,0,35,26
1657429500166,MATH 10B,A03,093472,Lim; Seonhee,7,0,34,27
1657429500166,MATH 10B,B01,083739,Sinha; Shubham,12,0,30,18
1657429506190,MATH 18,A01,083743,Cinel; Cameron Alexander,7,0,30,23
1657429506190,MATH 18,A02,083744,Cinel; Cameron Alexander,17,0,30,13
1657429506190,MATH 18,A03,083745,Cinel; Cameron Alexander,9,0,30,21
1657429506190,MATH 18,B01,083748,Rideout; David Porter,5,0,37,32
1657429506190,MATH 18,B02,083749,Rideout; David Porter,5,0,36,31
1657429506190,MATH 18,B03,083750,Rideout; David Porter,3,0,37,34
1657429506190,MATH 18,B04,083751,Rideout; David Porter,6,0,36,30
1657429506190,MATH 18,B05,093473,Rideout; David Porter,6,0,36,30
1657429506190,MATH 18,B06,093474,Rideout; David Porter,6,0,36,30
1657429512213,MATH 20A,A01,083754,Zheng; Zequn,14,0,40,26
1657429518236,MATH 20B,A01,083756,Briones; Jor-el Thomas Caparas,4,0,36,32
1657429518236,MATH 20B,A02,083757,Briones; Jor-el Thomas Caparas,1,0,36,35
1657429518236,MATH 20B,A03,093475,Briones; Jor-el Thomas Caparas,2,0,36,34
1657429524263,MATH 20C,A01,083760,Briones; Jor-el Thomas Caparas,1,0,35,34
1657429524263,MATH 20C,A02,083761,Briones; Jor-el Thomas Caparas,8,0,35,27
1657429524263,MATH 20C,A03,093476,Briones; Jor-el Thomas Caparas,0,1,36,36
1657429524263,MATH 20C,B01,083762,Bach; Quang Tran,1,0,30,29
1657429530287,MATH 20D,A01,083765,Tran; Brian Kha,5,0,30,25
1657429530287,MATH 20D,A02,083766,Tran; Brian Kha,5,0,30,25
1657429530287,MATH 20D,A03,083767,Tran; Brian Kha,5,0,30,25
1657429536310,MATH 20E,A01,083771,Ganguly; Soumya,9,0,32,23
1657429536310,MATH 20E,A02,083772,Ganguly; Soumya,6,0,32,26
1657429536310,MATH 20E,B01,083773,Ciotti; Benjamin,20,0,35,15
1657429536310,MATH 20E,B02,083774,Ciotti; Benjamin,17,0,35,18
1657429542335,MATH 103A,A01,083777,Greenfeld; Be'Eri,3,0,36,33
1657429542335,MATH 103A,A02,083778,Greenfeld; Be'Eri,5,0,36,31
1657429542335,MATH 103A,A03,093561,Greenfeld; Be'Eri,5,0,36,31
1657429542335,MATH 103A,B01,083779,Greenfeld; Be'Eri,7,0,36,29
1657429542335,MATH 103A,B02,083780,Greenfeld; Be'Eri,4,0,36,32
1657429542335,MATH 103A,B03,093562,Greenfeld; Be'Eri,3,0,36,33
1657429548360,MATH 105,A01,085443,Carter; Anne Toulson,15,0,35,20
1657429548360,MATH 105,A02,093477,Carter; Anne Toulson,20,0,35,15
1657429554389,MATH 109,A01,083213,Ganzberger; Geoffrey Michael,2,0,34,32
1657429554389,MATH 109,A02,083214,Ganzberger; Geoffrey Michael,4,0,34,30
1657429554389,MATH 109,A03,093478,Ganzberger; Geoffrey Michael,2,0,34,32
1657429554389,MATH 109,B01,083215,Ganzberger; Geoffrey Michael,1,0,32,31
1657429554389,MATH 109,B02,083216,Ganzberger; Geoffrey Michael,2,0,32,30
1657429554389,MATH 109,B03,093479,Ganzberger; Geoffrey Michael,8,0,32,24
1657429560414,MATH 142A,A01,083219,Chow; Bennett,7,0,32,25
1657429560414,MATH 142A,A02,083220,Chow; Bennett,10,0,32,22
1657429560414,MATH 142A,A03,093480,Chow; Bennett,8,0,32,24
1657429560414,MATH 142A,B03,093481,Chow; Bennett,8,0,32,24
1657429560414,MATH 142A,B04,093558,Chow; Bennett,13,0,32,19
1657429560414,MATH 142A,B05,093559,Chow; Bennett,6,0,32,26
1657429566443,MATH 193A,A01,083224,Rotar; Vladimir,8,0,34,26
1657429566443,MATH 193A,A02,083225,Rotar; Vladimir,9,0,34,25
1657429566443,MATH 193A,A03,083781,Rotar; Vladimir,5,0,34,29
1657429566443,MATH 193A,A04,083782,Rotar; Vladimir,10,0,34,24
1657429566443,MATH 193A,A05,093482,Rotar; Vladimir,10,0,34,24
1657429572469,MATH 197,001,091859,McAuley; Julian John,9999,0,9999,0
1657429572469,MATH 197,002,095566,Kedlaya; Kiran S.,9997,0,9999,2
1657429572469,MATH 197,003,095567,Xiao; Ming,9999,0,9999,0
1657429572469,MATH 197,004,095571,Perols; Johan Lars,9998,0,9999,1
1657429579521,COGS 9,A01,083615,Shannon; Kyle Michael,9,0,75,66
1657429585545,COGS 11,A01,083617,Boyle; Mary E. T.,22,0,48,26
1657429591569,COGS 13,A01,083071,Bastos; Amalia Pinkusfeld,11,0,71,60
1657429597606,COGS 14A,A01,092681,Semenuks; Arturs,5,1,100,95
1657429603631,COGS 14B,A01,083073,Cheng; Tzu-Han,6,0,63,57
1657429609652,COGS 17,A01,092677,Semenuks; Arturs,6,0,81,75
1657429615675,COGS 100,A01,083619,Allen; Michael Gordon,17,0,70,53
1657429621699,COGS 101A,A01,083621,Davis; Joshua Daniel,9,0,68,59
1657429627721,COGS 101B,A01,091572,Allen; Michael Gordon,12,0,65,53
1657429633747,COGS 101C,A01,083625,Delgado; Tania,17,0,35,18
1657429639769,COGS 107A,A01,083627,Boyle; Mary E. T.,13,0,60,47
1657429645796,COGS 118A,A01,083075,Gupta; Anjum,21,0,76,55
1657429651826,CSE 3,A50,083646,Miranda; Gregory Joseph,24,0,50,26
1657429657852,CSE 8A,A50,083650,Miranda; Gregory Joseph,17,1,56,39
1657429663879,CSE 11,A01,083080,Cao; Yingjun,6,15,40,34
1657429669905,CSE 12,A01,083652,Krause-Levy; Sophia Louisa,28,1,120,92
1657429675933,CSE 15L,A01,083654,Morris; Justin Loren,9,0,50,41
1657429675933,CSE 15L,A02,083655,Morris; Justin Loren,9,0,50,41
1657429681981,CSE 20,A01,083657,Tran; Khoa Dang,39,0,80,41
1657429688003,CSE 21,A01,095574,Bach; Quang Tran,22,0,48,26
1657429694025,CSE 30,A01,083084,Eldon; John,5,0,80,75
1657429694025,CSE 30,B01,095061,Bhaskar; Nishant,9,0,50,41
1657429700047,CSE 100,A01,083659,Cao; Yingjun,5,4,70,65
1657429706070,CSE 134B,A01,083661,Powell; Thomas Allan,22,0,100,78
1657429712095,CSE 140,A01,083663,Gungor; Onat,15,0,85,70
1657429718122,CSE 140L,A01,083088,Eldon; John,21,0,100,79
1657429724144,CSE 175,A01,083665,Kumar; Rakesh,3,0,25,22
1657429730167,CSE 190,A00,092507,Dubnov; Shlomo,7,0,20,13
1657429736195,ECE 45,A01,083139,Congero; Spencer William,6,0,75,69
1657429742219,ECE 65,A50,083695,Saad; Andrew S,12,0,30,18
1657429742219,ECE 65,A51,095125,Saad; Andrew S,24,0,26,2
1657429748246,ECE 109,A01,091882,Touri; Behrouz,19,0,70,51
1657429754270,ECE 180,A00,083140,Abi Samra; Nicholas Camill,1,0,30,29
1657429754270,ECE 180,B00,083141,Abi Samra; Nicholas Camill,0,0,30,30
1657429760294,MATH 10A,A01,083735,Patchell; Gregory David,2,0,30,28
1657429760294,MATH 10A,A02,083736,Patchell; Gregory David,20,0,30,10
1657429760294,MATH 10A,A03,083737,Patchell; Gregory David,16,0,30,14
1657429766324,MATH 10B,A01,083207,Lim; Seonhee,8,0,34,26
1657429766324,MATH 10B,A02,083208,Lim; Seonhee,9,0,35,26
1657429766324,MATH 10B,A03,093472,Lim; Seonhee,7,0,34,27
1657429766324,MATH 10B,B01,083739,Sinha; Shubham,12,0,30,18
1657429772355,MATH 18,A01,083743,Cinel; Cameron Alexander,7,0,30,23
1657429772355,MATH 18,A02,083744,Cinel; Cameron Alexander,17,0,30,13
1657429772355,MATH 18,A03,083745,Cinel; Cameron Alexander,9,0,30,21
1657429772355,MATH 18,B01,083748,Rideout; David Porter,5,0,37,32
1657429772355,MATH 18,B02,083749,Rideout; David Porter,5,0,36,31
1657429772355,MATH 18,B03,083750,Rideout; David Porter,3,0,37,34
1657429772355,MATH 18,B04,083751,Rideout; David Porter,6,0,36,30
1657429772355,MATH 18,B05,093473,Rideout; David Porter,6,0,36,30
1657429772355,MATH 18,B06,093474,Rideout; David Porter,6,0,36,30
1657429778378,MATH 20A,A01,083754,Zheng; Zequn,14,0,40,26
1657429784402,MATH 20B,A01,083756,Briones; Jor-el Thomas Caparas,4,0,36,32
1657429784402,MATH 20B,A02,083757,Briones; Jor-el Thomas Caparas,1,0,36,35
1657429784402,MATH 20B,A03,093475,Briones; Jor-el Thomas Caparas,2,0,36,34
1657429790426,MATH 20C,A01,083760,Briones; Jor-el Thomas Caparas,1,0,35,34
1657429790426,MATH 20C,A02,083761,Briones; Jor-el Thomas Caparas,8,0,35,27
1657429790426,MATH 20C,A03,093476,Briones; Jor-el Thomas Caparas,0,1,36,36
1657429790426,MATH 20C,B01,083762,Bach; Quang Tran,1,0,30,29
1657429796457,MATH 20D,A01,083765,Tran; Brian Kha,5,0,30,25
1657429796457,MATH 20D,A02,083766,Tran; Brian Kha,5,0,30,25
1657429796457,MATH 20D,A03,083767,Tran; Brian Kha,5,0,30,25
1657429802483,MATH 20E,A01,083771,Ganguly; Soumya,9,0,32,23
1657429802483,MATH 20E,A02,083772,Ganguly; Soumya,6,0,32,26
1657429802483,MATH 20E,B01,083773,Ciotti; Benjamin,20,0,35,15
1657429802483,MATH 20E,B02,083774,Ciotti; Benjamin,17,0,35,18
1657429808511,MATH 103A,A01,083777,Greenfeld; Be'Eri,3,0,36,33
1657429808511,MATH 103A,A02,083778,Greenfeld; Be'Eri,5,0,36,31
1657429808511,MATH 103A,A03,093561,Greenfeld; Be'Eri,5,0,36,31
1657429808511,MATH 103A,B01,083779,Greenfeld; Be'Eri,7,0,36,29
1657429808511,MATH 103A,B02,083780,Greenfeld; Be'Eri,4,0,36,32
1657429808511,MATH 103A,B03,093562,Greenfeld; Be'Eri,3,0,36,33
1657429814538,MATH 105,A01,085443,Carter; Anne Toulson,15,0,35,20
1657429814538,MATH 105,A02,093477,Carter; Anne Toulson,20,0,35,15
1657429820561,MATH 109,A01,083213,Ganzberger; Geoffrey Michael,2,0,34,32
1657429820561,MATH 109,A02,083214,Ganzberger; Geoffrey Michael,4,0,34,30
1657429820561,MATH 109,A03,093478,Ganzberger; Geoffrey Michael,2,0,34,32
1657429820561,MATH 109,B01,083215,Ganzberger; Geoffrey Michael,1,0,32,31
1657429820561,MATH 109,B02,083216,Ganzberger; Geoffrey Michael,2,0,32,30
1657429820561,MATH 109,B03,093479,Ganzberger; Geoffrey Michael,8,0,32,24
1657429826588,MATH 142A,A01,083219,Chow; Bennett,7,0,32,25
1657429826588,MATH 142A,A02,083220,Chow; Bennett,10,0,32,22
1657429826588,MATH 142A,A03,093480,Chow; Bennett,8,0,32,24
1657429826588,MATH 142A,B03,093481,Chow; Bennett,8,0,32,24
1657429826588,MATH 142A,B04,093558,Chow; Bennett,13,0,32,19
1657429826588,MATH 142A,B05,093559,Chow; Bennett,6,0,32,26
1657429832613,MATH 193A,A01,083224,Rotar; Vladimir,8,0,34,26
1657429832613,MATH 193A,A02,083225,Rotar; Vladimir,9,0,34,25
1657429832613,MATH 193A,A03,083781,Rotar; Vladimir,5,0,34,29
1657429832613,MATH 193A,A04,083782,Rotar; Vladimir,10,0,34,24
1657429832613,MATH 193A,A05,093482,Rotar; Vladimir,10,0,34,24
1657429838637,MATH 197,001,091859,McAuley; Julian John,9999,0,9999,0
1657429838637,MATH 197,002,095566,Kedlaya; Kiran S.,9997,0,9999,2
1657429838637,MATH 197,003,095567,Xiao; Ming,9999,0,9999,0
1657429838637,MATH 197,004,095571,Perols; Johan Lars,9998,0,9999,1
1657429845690,COGS 9,A01,083615,Shannon; Kyle Michael,9,0,75,66
1657429851718,COGS 11,A01,083617,Boyle; Mary E. T.,22,0,48,26
1657429857745,COGS 13,A01,083071,Bastos; Amalia Pinkusfeld,11,0,71,60
1657429863840,COGS 14A,A01,092681,Semenuks; Arturs,5,1,100,95
1657429869863,COGS 14B,A01,083073,Cheng; Tzu-Han,6,0,63,57
1657429875891,COGS 17,A01,092677,Semenuks; Arturs,6,0,81,75
1657429881914,COGS 100,A01,083619,Allen; Michael Gordon,17,0,70,53
1657429887938,COGS 101A,A01,083621,Davis; Joshua Daniel,9,0,68,59
1657429893962,COGS 101B,A01,091572,Allen; Michael Gordon,12,0,65,53
1657429899986,COGS 101C,A01,083625,Delgado; Tania,17,0,35,18
1657429906013,COGS 107A,A01,083627,Boyle; Mary E. T.,13,0,60,47
1657429912035,COGS 118A,A01,083075,Gupta; Anjum,21,0,76,55
1657429918062,CSE 3,A50,083646,Miranda; Gregory Joseph,24,0,50,26
1657429924089,CSE 8A,A50,083650,Miranda; Gregory Joseph,17,1,56,39
1657429930112,CSE 11,A01,083080,Cao; Yingjun,6,15,40,34
1657429936143,CSE 12,A01,083652,Krause-Levy; Sophia Louisa,28,1,120,92
1657429942167,CSE 15L,A01,083654,Morris; Justin Loren,9,0,50,41
1657429942167,CSE 15L,A02,083655,Morris; Justin Loren,9,0,50,41
1657429948192,CSE 20,A01,083657,Tran; Khoa Dang,39,0,80,41
1657429954217,CSE 21,A01,095574,Bach; Quang Tran,22,0,48,26
1657429960244,CSE 30,A01,083084,Eldon; John,5,0,80,75
1657429960244,CSE 30,B01,095061,Bhaskar; Nishant,9,0,50,41
1657429966267,CSE 100,A01,083659,Cao; Yingjun,5,4,70,65
1657429972296,CSE 134B,A01,083661,Powell; Thomas Allan,22,0,100,78
1657429978320,CSE 140,A01,083663,Gungor; Onat,15,0,85,70
1657429984349,CSE 140L,A01,083088,Eldon; John,21,0,100,79
1657429990381,CSE 175,A01,083665,Kumar; Rakesh,3,0,25,22
1657429996403,CSE 190,A00,092507,Dubnov; Shlomo,7,0,20,13
1657430002429,ECE 45,A01,083139,Congero; Spencer William,6,0,75,69
1657430008452,ECE 65,A50,083695,Saad; Andrew S,12,0,30,18
1657430008452,ECE 65,A51,095125,Saad; Andrew S,24,0,26,2
1657430014473,ECE 109,A01,091882,Touri; Behrouz,19,0,70,51
1657430020499,ECE 180,A00,083140,Abi Samra; Nicholas Camill,1,0,30,29
1657430020499,ECE 180,B00,083141,Abi Samra; Nicholas Camill,0,0,30,30
1657430026524,MATH 10A,A01,083735,Patchell; Gregory David,2,0,30,28
1657430026524,MATH 10A,A02,083736,Patchell; Gregory David,20,0,30,10
1657430026524,MATH 10A,A03,083737,Patchell; Gregory David,16,0,30,14
1657430032552,MATH 10B,A01,083207,Lim; Seonhee,8,0,34,26
1657430032552,MATH 10B,A02,083208,Lim; Seonhee,9,0,35,26
1657430032552,MATH 10B,A03,093472,Lim; Seonhee,7,0,34,27
1657430032552,MATH 10B,B01,083739,Sinha; Shubham,12,0,30,18
1657430038576,MATH 18,A01,083743,Cinel; Cameron Alexander,7,0,30,23
1657430038576,MATH 18,A02,083744,Cinel; Cameron Alexander,17,0,30,13
1657430038576,MATH 18,A03,083745,Cinel; Cameron Alexander,9,0,30,21
1657430038576,MATH 18,B01,083748,Rideout; David Porter,5,0,37,32
1657430038576,MATH 18,B02,083749,Rideout; David Porter,5,0,36,31
1657430038576,MATH 18,B03,083750,Rideout; David Porter,3,0,37,34
1657430038576,MATH 18,B04,083751,Rideout; David Porter,6,0,36,30
1657430038576,MATH 18,B05,093473,Rideout; David Porter,6,0,36,30
1657430038576,MATH 18,B06,093474,Rideout; David Porter,6,0,36,30
1657430044600,MATH 20A,A01,083754,Zheng; Zequn,14,0,40,26
1657430050627,MATH 20B,A01,083756,Briones; Jor-el Thomas Caparas,4,0,36,32
1657430050627,MATH 20B,A02,083757,Briones; Jor-el Thomas Caparas,1,0,36,35
1657430050627,MATH 20B,A03,093475,Briones; Jor-el Thomas Caparas,2,0,36,34
1657430056657,MATH 20C,A01,083760,Briones; Jor-el Thomas Caparas,1,0,35,34
1657430056657,MATH 20C,A02,083761,Briones; Jor-el Thomas Caparas,8,0,35,27
1657430056657,MATH 20C,A03,093476,Briones; Jor-el Thomas Caparas,0,1,36,36
1657430056657,MATH 20C,B01,083762,Bach; Quang Tran,1,0,30,29
1657430062685,MATH 20D,A01,083765,Tran; Brian Kha,5,0,30,25
1657430062685,MATH 20D,A02,083766,Tran; Brian Kha,5,0,30,25
1657430062685,MATH 20D,A03,083767,Tran; Brian Kha,5,0,30,25
1657430068709,MATH 20E,A01,083771,Ganguly; Soumya,9,0,32,23
1657430068709,MATH 20E,A02,083772,Ganguly; Soumya,6,0,32,26
1657430068709,MATH 20E,B01,083773,Ciotti; Benjamin,20,0,35,15
1657430068709,MATH 20E,B02,083774,Ciotti; Benjamin,17,0,35,18
1657430074733,MATH 103A,A01,083777,Greenfeld; Be'Eri,3,0,36,33
1657430074733,MATH 103A,A02,083778,Greenfeld; Be'Eri,5,0,36,31
1657430074733,MATH 103A,A03,093561,Greenfeld; Be'Eri,5,0,36,31
1657430074733,MATH 103A,B01,083779,Greenfeld; Be'Eri,7,0,36,29
1657430074733,MATH 103A,B02,083780,Greenfeld; Be'Eri,4,0,36,32
1657430074733,MATH 103A,B03,093562,Greenfeld; Be'Eri,3,0,36,33
1657430080755,MATH 105,A01,085443,Carter; Anne Toulson,15,0,35,20
1657430080755,MATH 105,A02,093477,Carter; Anne Toulson,20,0,35,15
1657430086778,MATH 109,A01,083213,Ganzberger; Geoffrey Michael,2,0,34,32
1657430086778,MATH 109,A02,083214,Ganzberger; Geoffrey Michael,4,0,34,30
1657430086778,MATH 109,A03,093478,Ganzberger; Geoffrey Michael,2,0,34,32
1657430086778,MATH 109,B01,083215,Ganzberger; Geoffrey Michael,1,0,32,31
1657430086778,MATH 109,B02,083216,Ganzberger; Geoffrey Michael,2,0,32,30
1657430086778,MATH 109,B03,093479,Ganzberger; Geoffrey Michael,8,0,32,24
1657430092802,MATH 142A,A01,083219,Chow; Bennett,7,0,32,25
1657430092802,MATH 142A,A02,083220,Chow; Bennett,10,0,32,22
1657430092802,MATH 142A,A03,093480,Chow; Bennett,8,0,32,24
1657430092802,MATH 142A,B03,093481,Chow; Bennett,8,0,32,24
1657430092802,MATH 142A,B04,093558,Chow; Bennett,13,0,32,19
1657430092802,MATH 142A,B05,093559,Chow; Bennett,6,0,32,26
1657430098824,MATH 193A,A01,083224,Rotar; Vladimir,8,0,34,26
1657430098824,MATH 193A,A02,083225,Rotar; Vladimir,9,0,34,25
1657430098824,MATH 193A,A03,083781,Rotar; Vladimir,5,0,34,29
1657430098824,MATH 193A,A04,083782,Rotar; Vladimir,10,0,34,24
1657430098824,MATH 193A,A05,093482,Rotar; Vladimir,10,0,34,24
1657430104851,MATH 197,001,091859,McAuley; Julian John,9999,0,9999,0
1657430104851,MATH 197,002,095566,Kedlaya; Kiran S.,9997,0,9999,2
1657430104851,MATH 197,003,095567,Xiao; Ming,9999,0,9999,0
1657430104851,MATH 197,004,095571,Perols; Johan Lars,9998,0,9999,1
1657430111908,COGS 9,A01,083615,Shannon; Kyle Michael,9,0,75,66
1657430117937,COGS 11,A01,083617,Boyle; Mary E. T.,22,0,48,26
1657430123960,COGS 13,A01,083071,Bastos; Amalia Pinkusfeld,11,0,71,60
1657430129985,COGS 14A,A01,092681,Semenuks; Arturs,5,1,100,95
1657430136009,COGS 14B,A01,083073,Cheng; Tzu-Han,6,0,63,57
1657430142035,COGS 17,A01,092677,Semenuks; Arturs,6,0,81,75
1657430148062,COGS 100,A01,083619,Allen; Michael Gordon,17,0,70,53
1657430154090,COGS 101A,A01,083621,Davis; Joshua Daniel,9,0,68,59
1657430160113,COGS 101B,A01,091572,Allen; Michael Gordon,12,0,65,53
1657430166140,COGS 101C,A01,083625,Delgado; Tania,17,0,35,18
1657430172166,COGS 107A,A01,083627,Boyle; Mary E. T.,13,0,60,47
1657430178201,COGS 118A,A01,083075,Gupta; Anjum,21,0,76,55
1657430184226,CSE 3,A50,083646,Miranda; Gregory Joseph,24,0,50,26
1657430190248,CSE 8A,A50,083650,Miranda; Gregory Joseph,17,1,56,39
1657430196271,CSE 11,A01,083080,Cao; Yingjun,6,15,40,34
1657430202294,CSE 12,A01,083652,Krause-Levy; Sophia Louisa,28,1,120,92
1657430208318,CSE 15L,A01,083654,Morris; Justin Loren,9,0,50,41
1657430208318,CSE 15L,A02,083655,Morris; Justin Loren,9,0,50,41
1657430214352,CSE 20,A01,083657,Tran; Khoa Dang,39,0,80,41
1657430220379,CSE 21,A01,095574,Bach; Quang Tran,22,0,48,26
1657430226402,CSE 30,A01,083084,Eldon; John,5,0,80,75
1657430226402,CSE 30,B01,095061,Bhaskar; Nishant,9,0,50,41
1657430232425,CSE 100,A01,083659,Cao; Yingjun,5,4,70,65
1657430238457,CSE 134B,A01,083661,Powell; Thomas Allan,22,0,100,78
1657430244480,CSE 140,A01,083663,Gungor; Onat,15,0,85,70
1657430250502,CSE 140L,A01,083088,Eldon; John,21,0,100,79
1657430256524,CSE 175,A01,083665,Kumar; Rakesh,3,0,25,22
1657430262546,CSE 190,A00,092507,Dubnov; Shlomo,7,0,20,13
1657430268573,ECE 45,A01,083139,Congero; Spencer William,6,0,75,69
1657430274600,ECE 65,A50,083695,Saad; Andrew S,12,0,30,18
1657430274600,ECE 65,A51,095125,Saad; Andrew S,24,0,26,2
1657430280627,ECE 109,A01,091882,Touri; Behrouz,19,0,70,51
1657430286650,ECE 180,A00,083140,Abi Samra; Nicholas Camill,1,0,30,29
1657430286650,ECE 180,B00,083141,Abi Samra; Nicholas Camill,0,0,30,30
1657430292676,MATH 10A,A01,083735,Patchell; Gregory David,2,0,30,28
1657430292676,MATH 10A,A02,083736,Patchell; Gregory David,20,0,30,10
1657430292676,MATH 10A,A03,083737,Patchell; Gregory David,16,0,30,14
1657430298700,MATH 10B,A01,083207,Lim; Seonhee,8,0,34,26
1657430298700,MATH 10B,A02,083208,Lim; Seonhee,9,0,35,26
1657430298700,MATH 10B,A03,093472,Lim; Seonhee,7,0,34,27
1657430298700,MATH 10B,B01,083739,Sinha; Shubham,12,0,30,18
1657430304726,MATH 18,A01,083743,Cinel; Cameron Alexander,7,0,30,23
1657430304726,MATH 18,A02,083744,Cinel; Cameron Alexander,17,0,30,13
1657430304726,MATH 18,A03,083745,Cinel; Cameron Alexander,9,0,30,21
1657430304726,MATH 18,B01,083748,Rideout; David Porter,5,0,37,32
1657430304726,MATH 18,B02,083749,Rideout; David Porter,5,0,36,31
1657430304726,MATH 18,B03,083750,Rideout; David Porter,3,0,37,34
1657430304726,MATH 18,B04,083751,Rideout; David Porter,6,0,36,30
1657430304726,MATH 18,B05,093473,Rideout; David Porter,6,0,36,30
1657430304726,MATH 18,B06,093474,Rideout; David Porter,6,0,36,30
1657430310748,MATH 20A,A01,083754,Zheng; Zequn,14,0,40,26
1657430316772,MATH 20B,A01,083756,Briones; Jor-el Thomas Caparas,4,0,36,32
1657430316772,MATH 20B,A02,083757,Briones; Jor-el Thomas Caparas,1,0,36,35
1657430316772,MATH 20B,A03,093475,Briones; Jor-el Thomas Caparas,2,0,36,34
1657430322801,MATH 20C,A01,083760,Briones; Jor-el Thomas Caparas,1,0,35,34
1657430322801,MATH 20C,A02,083761,Briones; Jor-el Thomas Caparas,8,0,35,27
1657430322801,MATH 20C,A03,093476,Briones; Jor-el Thomas Caparas,0,1,36,36
1657430322801,MATH 20C,B01,083762,Bach; Quang Tran,1,0,30,29
1657430328823,MATH 20D,A01,083765,Tran; Brian Kha,5,0,30,25
1657430328823,MATH 20D,A02,083766,Tran; Brian Kha,5,0,30,25
1657430328823,MATH 20D,A03,083767,Tran; Brian Kha,5,0,30,25
1657430334845,MATH 20E,A01,083771,Ganguly; Soumya,9,0,32,23
1657430334845,MATH 20E,A02,083772,Ganguly; Soumya,6,0,32,26
1657430334845,MATH 20E,B01,083773,Ciotti; Benjamin,20,0,35,15
1657430334845,MATH 20E,B02,083774,Ciotti; Benjamin,17,0,35,18
1657430340870,MATH 103A,A01,083777,Greenfeld; Be'Eri,3,0,36,33
1657430340870,MATH 103A,A02,083778,Greenfeld; Be'Eri,5,0,36,31
1657430340870,MATH 103A,A03,093561,Greenfeld; Be'Eri,5,0,36,31
1657430340870,MATH 103A,B01,083779,Greenfeld; Be'Eri,7,0,36,29
1657430340870,MATH 103A,B02,083780,Greenfeld; Be'Eri,4,0,36,32
1657430340870,MATH 103A,B03,093562,Greenfeld; Be'Eri,3,0,36,33
1657430346892,MATH 105,A01,085443,Carter; Anne Toulson,15,0,35,20
1657430346892,MATH 105,A02,093477,Carter; Anne Toulson,20,0,35,15
1657430352918,MATH 109,A01,083213,Ganzberger; Geoffrey Michael,2,0,34,32
1657430352918,MATH 109,A02,083214,Ganzberger; Geoffrey Michael,4,0,34,30
1657430352918,MATH 109,A03,093478,Ganzberger; Geoffrey Michael,2,0,34,32
1657430352918,MATH 109,B01,083215,Ganzberger; Geoffrey Michael,1,0,32,31
1657430352918,MATH 109,B02,083216,Ganzberger; Geoffrey Michael,2,0,32,30
1657430352918,MATH 109,B03,093479,Ganzberger; Geoffrey Michael,8,0,32,24
1657430358942,MATH 142A,A01,083219,Chow; Bennett,7,0,32,25
1657430358942,MATH 142A,A02,083220,Chow; Bennett,10,0,32,22
1657430358942,MATH 142A,A03,093480,Chow; Bennett,8,0,32,24
1657430358942,MATH 142A,B03,093481,Chow; Bennett,8,0,32,24
1657430358942,MATH 142A,B04,093558,Chow; Bennett,13,0,32,19
1657430358942,MATH 142A,B05,093559,Chow; Bennett,6,0,32,26
1657430364972,MATH 193A,A01,083224,Rotar; Vladimir,8,0,34,26
1657430364972,MATH 193A,A02,083225,Rotar; Vladimir,9,0,34,25
1657430364972,MATH 193A,A03,083781,Rotar; Vladimir,5,0,34,29
1657430364972,MATH 193A,A04,083782,Rotar; Vladimir,10,0,34,24
1657430364972,MATH 193A,A05,093482,Rotar; Vladimir,10,0,34,24
1657430370997,MATH 197,001,091859,McAuley; Julian John,9999,0,9999,0
1657430370997,MATH 197,002,095566,Kedlaya; Kiran S.,9997,0,9999,2
1657430370997,MATH 197,003,095567,Xiao; Ming,9999,0,9999,0
1657430370997,MATH 197,004,095571,Perols; Johan Lars,9998,0,9999,1
1657430378060,COGS 9,A01,083615,Shannon; Kyle Michael,9,0,75,66
1657430384084,COGS 11,A01,083617,Boyle; Mary E. T.,22,0,48,26
1657430390106,COGS 13,A01,083071,Bastos; Amalia Pinkusfeld,11,0,71,60
1657430396131,COGS 14A,A01,092681,Semenuks; Arturs,5,1,100,95
1657430402157,COGS 14B,A01,083073,Cheng; Tzu-Han,6,0,63,57
1657430408179,COGS 17,A01,092677,Semenuks; Arturs,6,0,81,75
1657430414203,COGS 100,A01,083619,Allen; Michael Gordon,17,0,70,53
1657430420226,COGS 101A,A01,083621,Davis; Joshua Daniel,9,0,68,59
1657430426249,COGS 101B,A01,091572,Allen; Michael Gordon,12,0,65,53
1657430432272,COGS 101C,A01,083625,Delgado; Tania,17,0,35,18
1657430438295,COGS 107A,A01,083627,Boyle; Mary E. T.,13,0,60,47
1657430444318,COGS 118A,A01,083075,Gupta; Anjum,21,0,76,55
1657430450342,CSE 3,A50,083646,Miranda; Gregory Joseph,24,0,50,26
1657430456367,CSE 8A,A50,083650,Miranda; Gregory Joseph,17,1,56,39
1657430462461,CSE 11,A01,083080,Cao; Yingjun,6,15,40,34
1657430468484,CSE 12,A01,083652,Krause-Levy; Sophia Louisa,28,1,120,92
1657430474511,CSE 15L,A01,083654,Morris; Justin Loren,9,0,50,41
1657430474511,CSE 15L,A02,083655,Morris; Justin Loren,9,0,50,41
1657430480534,CSE 20,A01,083657,Tran; Khoa Dang,39,0,80,41
1657430486558,CSE 21,A01,095574,Bach; Quang Tran,22,0,48,26
1657430492586,CSE 30,A01,083084,Eldon; John,5,0,80,75
1657430492586,CSE 30,B01,095061,Bhaskar; Nishant,9,0,50,41
1657430498614,CSE 100,A01,083659,Cao; Yingjun,5,4,70,65
1657430504636,CSE 134B,A01,083661,Powell; Thomas Allan,22,0,100,78
1657430510663,CSE 140,A01,083663,Gungor; Onat,15,0,85,70
1657430516687,CSE 140L,A01,083088,Eldon; John,21,0,100,79
1657430522710,CSE 175,A01,083665,Kumar; Rakesh,3,0,25,22
1657430528738,CSE 190,A00,092507,Dubnov; Shlomo,7,0,20,13
1657430534761,ECE 45,A01,083139,Congero; Spencer William,6,0,75,69
1657430540789,ECE 65,A50,083695,Saad; Andrew S,12,0,30,18
1657430540789,ECE 65,A51,095125,Saad; Andrew S,24,0,26,2
1657430546819,ECE 109,A01,091882,Touri; Behrouz,19,0,70,51
1657430552854,ECE 180,A00,083140,Abi Samra; Nicholas Camill,1,0,30,29
1657430552854,ECE 180,B00,083141,Abi Samra; Nicholas Camill,0,0,30,30
1657430558886,MATH 10A,A01,083735,Patchell; Gregory David,2,0,30,28
1657430558886,MATH 10A,A02,083736,Patchell; Gregory David,20,0,30,10
1657430558886,MATH 10A,A03,083737,Patchell; Gregory David,16,0,30,14
1657430564911,MATH 10B,A01,083207,Lim; Seonhee,8,0,34,26
1657430564911,MATH 10B,A02,083208,Lim; Seonhee,9,0,35,26
1657430564911,MATH 10B,A03,093472,Lim; Seonhee,7,0,34,27
1657430564911,MATH 10B,B01,083739,Sinha; Shubham,12,0,30,18
1657430570942,MATH 18,A01,083743,Cinel; Cameron Alexander,7,0,30,23
1657430570942,MATH 18,A02,083744,Cinel; Cameron Alexander,17,0,30,13
1657430570942,MATH 18,A03,083745,Cinel; Cameron Alexander,9,0,30,21
1657430570942,MATH 18,B01,083748,Rideout; David Porter,5,0,37,32
1657430570942,MATH 18,B02,083749,Rideout; David Porter,5,0,36,31
1657430570942,MATH 18,B03,083750,Rideout; David Porter,3,0,37,34
1657430570942,MATH 18,B04,083751,Rideout; David Porter,6,0,36,30
1657430570942,MATH 18,B05,093473,Rideout; David Porter,6,0,36,30
1657430570942,MATH 18,B06,093474,Rideout; David Porter,6,0,36,30
1657430576964,MATH 20A,A01,083754,Zheng; Zequn,14,0,40,26
1657430582987,MATH 20B,A01,083756,Briones; Jor-el Thomas Caparas,4,0,36,32
1657430582987,MATH 20B,A02,083757,Briones; Jor-el Thomas Caparas,1,0,36,35
1657430582987,MATH 20B,A03,093475,Briones; Jor-el Thomas Caparas,2,0,36,34
1657430589012,MATH 20C,A01,083760,Briones; Jor-el Thomas Caparas,1,0,35,34
1657430589012,MATH 20C,A02,083761,Briones; Jor-el Thomas Caparas,8,0,35,27
1657430589012,MATH 20C,A03,093476,Briones; Jor-el Thomas Caparas,0,1,36,36
1657430589012,MATH 20C,B01,083762,Bach; Quang Tran,1,0,30,29
1657430595044,MATH 20D,A01,083765,Tran; Brian Kha,5,0,30,25
1657430595044,MATH 20D,A02,083766,Tran; Brian Kha,5,0,30,25
1657430595044,MATH 20D,A03,083767,Tran; Brian Kha,5,0,30,25
1657430601071,MATH 20E,A01,083771,Ganguly; Soumya,9,0,32,23
1657430601071,MATH 20E,A02,083772,Ganguly; Soumya,6,0,32,26
1657430601071,MATH 20E,B01,083773,Ciotti; Benjamin,20,0,35,15
1657430601071,MATH 20E,B02,083774,Ciotti; Benjamin,17,0,35,18
1657430607100,MATH 103A,A01,083777,Greenfeld; Be'Eri,3,0,36,33
1657430607100,MATH 103A,A02,083778,Greenfeld; Be'Eri,5,0,36,31
1657430607100,MATH 103A,A03,093561,Greenfeld; Be'Eri,5,0,36,31
1657430607100,MATH 103A,B01,083779,Greenfeld; Be'Eri,7,0,36,29
1657430607100,MATH 103A,B02,083780,Greenfeld; Be'Eri,4,0,36,32
1657430607100,MATH 103A,B03,093562,Greenfeld; Be'Eri,3,0,36,33
1657430613126,MATH 105,A01,085443,Carter; Anne Toulson,15,0,35,20
1657430613126,MATH 105,A02,093477,Carter; Anne Toulson,20,0,35,15
1657430619155,MATH 109,A01,083213,Ganzberger; Geoffrey Michael,2,0,34,32
1657430619155,MATH 109,A02,083214,Ganzberger; Geoffrey Michael,4,0,34,30
1657430619155,MATH 109,A03,093478,Ganzberger; Geoffrey Michael,2,0,34,32
1657430619155,MATH 109,B01,083215,Ganzberger; Geoffrey Michael,1,0,32,31
1657430619155,MATH 109,B02,083216,Ganzberger; Geoffrey Michael,2,0,32,30
1657430619155,MATH 109,B03,093479,Ganzberger; Geoffrey Michael,8,0,32,24
1657430625180,MATH 142A,A01,083219,Chow; Bennett,7,0,32,25
1657430625180,MATH 142A,A02,083220,Chow; Bennett,10,0,32,22
1657430625180,MATH 142A,A03,093480,Chow; Bennett,8,0,32,24
1657430625180,MATH 142A,B03,093481,Chow; Bennett,8,0,32,24
1657430625180,MATH 142A,B04,093558,Chow; Bennett,13,0,32,19
1657430625180,MATH 142A,B05,093559,Chow; Bennett,6,0,32,26
1657430631208,MATH 193A,A01,083224,Rotar; Vladimir,8,0,34,26
1657430631208,MATH 193A,A02,083225,Rotar; Vladimir,9,0,34,25
1657430631208,MATH 193A,A03,083781,Rotar; Vladimir,5,0,34,29
1657430631208,MATH 193A,A04,083782,Rotar; Vladimir,10,0,34,24
1657430631208,MATH 193A,A05,093482,Rotar; Vladimir,10,0,34,24
1657430637231,MATH 197,001,091859,McAuley; Julian John,9999,0,9999,0
1657430637231,MATH 197,002,095566,Kedlaya; Kiran S.,9997,0,9999,2
1657430637231,MATH 197,003,095567,Xiao; Ming,9999,0,9999,0
1657430637231,MATH 197,004,095571,Perols; Johan Lars,9998,0,9999,1
1657430644285,COGS 9,A01,083615,Shannon; Kyle Michael,9,0,75,66
1657430650308,COGS 11,A01,083617,Boyle; Mary E. T.,22,0,48,26
1657430656334,COGS 13,A01,083071,Bastos; Amalia Pinkusfeld,11,0,71,60
1657430662359,COGS 14A,A01,092681,Semenuks; Arturs,5,1,100,95
1657430668384,COGS 14B,A01,083073,Cheng; Tzu-Han,6,0,63,57
1657430674411,COGS 17,A01,092677,Semenuks; Arturs,6,0,81,75
1657430680434,COGS 100,A01,083619,Allen; Michael Gordon,17,0,70,53
1657430686458,COGS 101A,A01,083621,Davis; Joshua Daniel,9,0,68,59
1657430692481,COGS 101B,A01,091572,Allen; Michael Gordon,12,0,65,53
1657430698508,COGS 101C,A01,083625,Delgado; Tania,17,0,35,18
1657430704534,COGS 107A,A01,083627,Boyle; Mary E. T.,13,0,60,47
1657430710560,COGS 118A,A01,083075,Gupta; Anjum,21,0,76,55
1657430716589,CSE 3,A50,083646,Miranda; Gregory Joseph,24,0,50,26
1657430722611,CSE 8A,A50,083650,Miranda; Gregory Joseph,17,1,56,39
1657430728637,CSE 11,A01,083080,Cao; Yingjun,6,15,40,34
1657430734661,CSE 12,A01,083652,Krause-Levy; Sophia Louisa,28,1,120,92
1657430740683,CSE 15L,A01,083654,Morris; Justin Loren,9,0,50,41
1657430740683,CSE 15L,A02,083655,Morris; Justin Loren,9,0,50,41
1657430746709,CSE 20,A01,083657,Tran; Khoa Dang,39,0,80,41
1657430752735,CSE 21,A01,095574,Bach; Quang Tran,22,0,48,26
1657430758764,CSE 30,A01,083084,Eldon; John,5,0,80,75
1657430758764,CSE 30,B01,095061,Bhaskar; Nishant,9,0,50,41
1657430764787,CSE 100,A01,083659,Cao; Yingjun,5,4,70,65
1657430770815,CSE 134B,A01,083661,Powell; Thomas Allan,22,0,100,78
1657430776837,CSE 140,A01,083663,Gungor; Onat,15,0,85,70
1657430782860,CSE 140L,A01,083088,Eldon; John,21,0,100,79
1657430788885,CSE 175,A01,083665,Kumar; Rakesh,3,0,25,22
1657430794909,CSE 190,A00,092507,Dubnov; Shlomo,7,0,20,13
1657430800938,ECE 45,A01,083139,Congero; Spencer William,6,0,75,69
1657430806961,ECE 65,A50,083695,Saad; Andrew S,12,0,30,18
1657430806961,ECE 65,A51,095125,Saad; Andrew S,24,0,26,2
1657430812984,ECE 109,A01,091882,Touri; Behrouz,19,0,70,51
1657430819010,ECE 180,A00,083140,Abi Samra; Nicholas Camill,1,0,30,29
1657430819010,ECE 180,B00,083141,Abi Samra; Nicholas Camill,0,0,30,30
1657430825034,MATH 10A,A01,083735,Patchell; Gregory David,2,0,30,28
1657430825034,MATH 10A,A02,083736,Patchell; Gregory David,20,0,30,10
1657430825034,MATH 10A,A03,083737,Patchell; Gregory David,16,0,30,14
1657430831058,MATH 10B,A01,083207,Lim; Seonhee,8,0,34,26
1657430831058,MATH 10B,A02,083208,Lim; Seonhee,9,0,35,26
1657430831058,MATH 10B,A03,093472,Lim; Seonhee,7,0,34,27
1657430831058,MATH 10B,B01,083739,Sinha; Shubham,12,0,30,18
1657430837082,MATH 18,A01,083743,Cinel; Cameron Alexander,7,0,30,23
1657430837082,MATH 18,A02,083744,Cinel; Cameron Alexander,17,0,30,13
1657430837082,MATH 18,A03,083745,Cinel; Cameron Alexander,9,0,30,21
1657430837082,MATH 18,B01,083748,Rideout; David Porter,5,0,37,32
1657430837082,MATH 18,B02,083749,Rideout; David Porter,5,0,36,31
1657430837082,MATH 18,B03,083750,Rideout; David Porter,3,0,37,34
1657430837082,MATH 18,B04,083751,Rideout; David Porter,6,0,36,30
1657430837082,MATH 18,B05,093473,Rideout; David Porter,6,0,36,30
1657430837082,MATH 18,B06,093474,Rideout; David Porter,6,0,36,30
1657430843109,MATH 20A,A01,083754,Zheng; Zequn,14,0,40,26
1657430849132,MATH 20B,A01,083756,Briones; Jor-el Thomas Caparas,4,0,36,32
1657430849132,MATH 20B,A02,083757,Briones; Jor-el Thomas Caparas,1,0,36,35
1657430849132,MATH 20B,A03,093475,Briones; Jor-el Thomas Caparas,2,0,36,34
1657430855160,MATH 20C,A01,083760,Briones; Jor-el Thomas Caparas,1,0,35,34
1657430855160,MATH 20C,A02,083761,Briones; Jor-el Thomas Caparas,8,0,35,27
1657430855160,MATH 20C,A03,093476,Briones; Jor-el Thomas Caparas,0,1,36,36
1657430855160,MATH 20C,B01,083762,Bach; Quang Tran,1,0,30,29
1657430861189,MATH 20D,A01,083765,Tran; Brian Kha,5,0,30,25
1657430861189,MATH 20D,A02,083766,Tran; Brian Kha,5,0,30,25
1657430861189,MATH 20D,A03,083767,Tran; Brian Kha,5,0,30,25
1657430867238,MATH 20E,A01,083771,Ganguly; Soumya,9,0,32,23
1657430867238,MATH 20E,A02,083772,Ganguly; Soumya,6,0,32,26
1657430867238,MATH 20E,B01,083773,Ciotti; Benjamin,20,0,35,15
1657430867238,MATH 20E,B02,083774,Ciotti; Benjamin,17,0,35,18
1657430873261,MATH 103A,A01,083777,Greenfeld; Be'Eri,3,0,36,33
1657430873261,MATH 103A,A02,083778,Greenfeld; Be'Eri,5,0,36,31
1657430873261,MATH 103A,A03,093561,Greenfeld; Be'Eri,5,0,36,31
1657430873261,MATH 103A,B01,083779,Greenfeld; Be'Eri,7,0,36,29
1657430873261,MATH 103A,B02,083780,Greenfeld; Be'Eri,4,0,36,32
1657430873261,MATH 103A,B03,093562,Greenfeld; Be'Eri,3,0,36,33
1657430879287,MATH 105,A01,085443,Carter; Anne Toulson,15,0,35,20
1657430879287,MATH 105,A02,093477,Carter; Anne Toulson,20,0,35,15
1657430885312,MATH 109,A01,083213,Ganzberger; Geoffrey Michael,2,0,34,32
1657430885312,MATH 109,A02,083214,Ganzberger; Geoffrey Michael,4,0,34,30
1657430885312,MATH 109,A03,093478,Ganzberger; Geoffrey Michael,2,0,34,32
1657430885312,MATH 109,B01,083215,Ganzberger; Geoffrey Michael,1,0,32,31
1657430885312,MATH 109,B02,083216,Ganzberger; Geoffrey Michael,2,0,32,30
1657430885312,MATH 109,B03,093479,Ganzberger; Geoffrey Michael,8,0,32,24
1657430891337,MATH 142A,A01,083219,Chow; Bennett,7,0,32,25
1657430891337,MATH 142A,A02,083220,Chow; Bennett,10,0,32,22
1657430891337,MATH 142A,A03,093480,Chow; Bennett,8,0,32,24
1657430891337,MATH 142A,B03,093481,Chow; Bennett,8,0,32,24
1657430891337,MATH 142A,B04,093558,Chow; Bennett,13,0,32,19
1657430891337,MATH 142A,B05,093559,Chow; Bennett,6,0,32,26
1657430897365,MATH 193A,A01,083224,Rotar; Vladimir,8,0,34,26
1657430897365,MATH 193A,A02,083225,Rotar; Vladimir,9,0,34,25
1657430897365,MATH 193A,A03,083781,Rotar; Vladimir,5,0,34,29
1657430897365,MATH 193A,A04,083782,Rotar; Vladimir,10,0,34,24
1657430897365,MATH 193A,A05,093482,Rotar; Vladimir,10,0,34,24
1657430903387,MATH 197,001,091859,McAuley; Julian John,9999,0,9999,0
1657430903387,MATH 197,002,095566,Kedlaya; Kiran S.,9997,0,9999,2
1657430903387,MATH 197,003,095567,Xiao; Ming,9999,0,9999,0
1657430903387,MATH 197,004,095571,Perols; Johan Lars,9998,0,9999,1
1657430910446,COGS 9,A01,083615,Shannon; Kyle Michael,9,0,75,66
1657430916478,COGS 11,A01,083617,Boyle; Mary E. T.,22,0,48,26
1657430922500,COGS 13,A01,083071,Bastos; Amalia Pinkusfeld,11,0,71,60
1657430928525,COGS 14A,A01,092681,Semenuks; Arturs,5,1,100,95
1657430934549,COGS 14B,A01,083073,Cheng; Tzu-Han,6,0,63,57
1657430940577,COGS 17,A01,092677,Semenuks; Arturs,6,0,81,75
1657430946601,COGS 100,A01,083619,Allen; Michael Gordon,17,0,70,53
1657430952635,COGS 101A,A01,083621,Davis; Joshua Daniel,9,0,68,59
1657430958663,COGS 101B,A01,091572,Allen; Michael Gordon,12,0,65,53
1657430964687,COGS 101C,A01,083625,Delgado; Tania,17,0,35,18
1657430970713,COGS 107A,A01,083627,Boyle; Mary E. T.,13,0,60,47
1657430976737,COGS 118A,A01,083075,Gupta; Anjum,21,0,76,55
1657430982760,CSE 3,A50,083646,Miranda; Gregory Joseph,24,0,50,26
1657430988790,CSE 8A,A50,083650,Miranda; Gregory Joseph,17,1,56,39
1657430994813,CSE 11,A01,083080,Cao; Yingjun,6,15,40,34
1657431000836,CSE 12,A01,083652,Krause-Levy; Sophia Louisa,28,1,120,92
1657431006858,CSE 15L,A01,083654,Morris; Justin Loren,9,0,50,41
1657431006858,CSE 15L,A02,083655,Morris; Justin Loren,9,0,50,41
1657431012880,CSE 20,A01,083657,Tran; Khoa Dang,39,0,80,41
1657431018906,CSE 21,A01,095574,Bach; Quang Tran,22,0,48,26
1657431024928,CSE 30,A01,083084,Eldon; John,5,0,80,75
1657431024928,CSE 30,B01,095061,Bhaskar; Nishant,9,0,50,41
1657431030955,CSE 100,A01,083659,Cao; Yingjun,5,4,70,65
1657431036986,CSE 134B,A01,083661,Powell; Thomas Allan,22,0,100,78
1657431043008,CSE 140,A01,083663,Gungor; Onat,15,0,85,70
1657431049032,CSE 140L,A01,083088,Eldon; John,21,0,100,79
1657431055058,CSE 175,A01,083665,Kumar; Rakesh,3,0,25,22
1657431061176,CSE 190,A00,092507,Dubnov; Shlomo,7,0,20,13
1657431067202,ECE 45,A01,083139,Congero; Spencer William,6,0,75,69
1657431073232,ECE 65,A50,083695,Saad; Andrew S,12,0,30,18
1657431073232,ECE 65,A51,095125,Saad; Andrew S,24,0,26,2
1657431079254,ECE 109,A01,091882,Touri; Behrouz,19,0,70,51
1657431085281,ECE 180,A00,083140,Abi Samra; Nicholas Camill,1,0,30,29
1657431085281,ECE 180,B00,083141,Abi Samra; Nicholas Camill,0,0,30,30
1657431091304,MATH 10A,A01,083735,Patchell; Gregory David,2,0,30,28
1657431091304,MATH 10A,A02,083736,Patchell; Gregory David,20,0,30,10
1657431091304,MATH 10A,A03,083737,Patchell; Gregory David,16,0,30,14
1657431097328,MATH 10B,A01,083207,Lim; Seonhee,8,0,34,26
1657431097328,MATH 10B,A02,083208,Lim; Seonhee,9,0,35,26
1657431097328,MATH 10B,A03,093472,Lim; Seonhee,7,0,34,27
1657431097328,MATH 10B,B01,083739,Sinha; Shubham,12,0,30,18
1657431103354,MATH 18,A01,083743,Cinel; Cameron Alexander,7,0,30,23
1657431103354,MATH 18,A02,083744,Cinel; Cameron Alexander,17,0,30,13
1657431103354,MATH 18,A03,083745,Cinel; Cameron Alexander,9,0,30,21
1657431103354,MATH 18,B01,083748,Rideout; David Porter,5,0,37,32
1657431103354,MATH 18,B02,083749,Rideout; David Porter,5,0,36,31
1657431103354,MATH 18,B03,083750,Rideout; David Porter,3,0,37,34
1657431103354,MATH 18,B04,083751,Rideout; David Porter,6,0,36,30
1657431103354,MATH 18,B05,093473,Rideout; David Porter,6,0,36,30
1657431103354,MATH 18,B06,093474,Rideout; David Porter,6,0,36,30
1657431109380,MATH 20A,A01,083754,Zheng; Zequn,14,0,40,26
1657431115403,MATH 20B,A01,083756,Briones; Jor-el Thomas Caparas,4,0,36,32
1657431115403,MATH 20B,A02,083757,Briones; Jor-el Thomas Caparas,1,0,36,35
1657431115403,MATH 20B,A03,093475,Briones; Jor-el Thomas Caparas,2,0,36,34
1657431121429,MATH 20C,A01,083760,Briones; Jor-el Thomas Caparas,1,0,35,34
1657431121429,MATH 20C,A02,083761,Briones; Jor-el Thomas Caparas,8,0,35,27
1657431121429,MATH 20C,A03,093476,Briones; Jor-el Thomas Caparas,0,1,36,36
1657431121429,MATH 20C,B01,083762,Bach; Quang Tran,1,0,30,29
1657431127463,MATH 20D,A01,083765,Tran; Brian Kha,5,0,30,25
1657431127463,MATH 20D,A02,083766,Tran; Brian Kha,5,0,30,25
1657431127463,MATH 20D,A03,083767,Tran; Brian Kha,5,0,30,25
1657431133485,MATH 20E,A01,083771,Ganguly; Soumya,9,0,32,23
1657431133485,MATH 20E,A02,083772,Ganguly; Soumya,6,0,32,26
1657431133485,MATH 20E,B01,083773,Ciotti; Benjamin,20,0,35,15
1657431133485,MATH 20E,B02,083774,Ciotti; Benjamin,17,0,35,18
1657431139511,MATH 103A,A01,083777,Greenfeld; Be'Eri,3,0,36,33
1657431139511,MATH 103A,A02,083778,Greenfeld; Be'Eri,5,0,36,31
1657431139511,MATH 103A,A03,093561,Greenfeld; Be'Eri,5,0,36,31
1657431139511,MATH 103A,B01,083779,Greenfeld; Be'Eri,7,0,36,29
1657431139511,MATH 103A,B02,083780,Greenfeld; Be'Eri,4,0,36,32
1657431139511,MATH 103A,B03,093562,Greenfeld; Be'Eri,3,0,36,33
1657431145533,MATH 105,A01,085443,Carter; Anne Toulson,15,0,35,20
1657431145533,MATH 105,A02,093477,Carter; Anne Toulson,20,0,35,15
1657431151555,MATH 109,A01,083213,Ganzberger; Geoffrey Michael,2,0,34,32
1657431151555,MATH 109,A02,083214,Ganzberger; Geoffrey Michael,4,0,34,30
1657431151555,MATH 109,A03,093478,Ganzberger; Geoffrey Michael,2,0,34,32
1657431151555,MATH 109,B01,083215,Ganzberger; Geoffrey Michael,1,0,32,31
1657431151555,MATH 109,B02,083216,Ganzberger; Geoffrey Michael,2,0,32,30
1657431151555,MATH 109,B03,093479,Ganzberger; Geoffrey Michael,8,0,32,24
1657431157584,MATH 142A,A01,083219,Chow; Bennett,7,0,32,25
1657431157584,MATH 142A,A02,083220,Chow; Bennett,10,0,32,22
1657431157584,MATH 142A,A03,093480,Chow; Bennett,8,0,32,24
1657431157584,MATH 142A,B03,093481,Chow; Bennett,8,0,32,24
1657431157584,MATH 142A,B04,093558,Chow; Bennett,13,0,32,19
1657431157584,MATH 142A,B05,093559,Chow; Bennett,6,0,32,26
1657431163606,MATH 193A,A01,083224,Rotar; Vladimir,8,0,34,26
1657431163606,MATH 193A,A02,083225,Rotar; Vladimir,9,0,34,25
1657431163606,MATH 193A,A03,083781,Rotar; Vladimir,5,0,34,29
1657431163606,MATH 193A,A04,083782,Rotar; Vladimir,10,0,34,24
1657431163606,MATH 193A,A05,093482,Rotar; Vladimir,10,0,34,24
1657431169631,MATH 197,001,091859,McAuley; Julian John,9999,0,9999,0
1657431169631,MATH 197,002,095566,Kedlaya; Kiran S.,9997,0,9999,2
1657431169631,MATH 197,003,095567,Xiao; Ming,9999,0,9999,0
1657431169631,MATH 197,004,095571,Perols; Johan Lars,9998,0,9999,1
1657431176689,COGS 9,A01,083615,Shannon; Kyle Michael,9,0,75,66
1657431182713,COGS 11,A01,083617,Boyle; Mary E. T.,22,0,48,26
1657431188735,COGS 13,A01,083071,Bastos; Amalia Pinkusfeld,11,0,71,60
1657431194761,COGS 14A,A01,092681,Semenuks; Arturs,5,1,100,95
1657431200789,COGS 14B,A01,083073,Cheng; Tzu-Han,6,0,63,57
1657431206813,COGS 17,A01,092677,Semenuks; Arturs,6,0,81,75
1657431212838,COGS 100,A01,083619,Allen; Michael Gordon,17,0,70,53
1657431218862,COGS 101A,A01,083621,Davis; Joshua Daniel,9,0,68,59
1657431224886,COGS 101B,A01,091572,Allen; Michael Gordon,12,0,65,53
1657431230909,COGS 101C,A01,083625,Delgado; Tania,17,0,35,18
1657431236930,COGS 107A,A01,083627,Boyle; Mary E. T.,13,0,60,47
1657431242955,COGS 118A,A01,083075,Gupta; Anjum,21,0,76,55
1657431248981,CSE 3,A50,083646,Miranda; Gregory Joseph,24,0,50,26
1657431255006,CSE 8A,A50,083650,Miranda; Gregory Joseph,17,1,56,39
1657431261031,CSE 11,A01,083080,Cao; Yingjun,6,15,40,34
1657431267057,CSE 12,A01,083652,Krause-Levy; Sophia Louisa,28,1,120,92
1657431273079,CSE 15L,A01,083654,Morris; Justin Loren,9,0,50,41
1657431273079,CSE 15L,A02,083655,Morris; Justin Loren,9,0,50,41
1657431279102,CSE 20,A01,083657,Tran; Khoa Dang,39,0,80,41
1657431285126,CSE 21,A01,095574,Bach; Quang Tran,22,0,48,26
1657431291149,CSE 30,A01,083084,Eldon; John,5,0,80,75
1657431291149,CSE 30,B01,095061,Bhaskar; Nishant,9,0,50,41
1657431297175,CSE 100,A01,083659,Cao; Yingjun,5,4,70,65
1657431303203,CSE 134B,A01,083661,Powell; Thomas Allan,22,0,100,78
1657431309226,CSE 140,A01,083663,Gungor; Onat,15,0,85,70
1657431315253,CSE 140L,A01,083088,Eldon; John,21,0,100,79
1657431321278,CSE 175,A01,083665,Kumar; Rakesh,3,0,25,22
1657431327301,CSE 190,A00,092507,Dubnov; Shlomo,7,0,20,13
1657431333328,ECE 45,A01,083139,Congero; Spencer William,6,0,75,69
1657431339353,ECE 65,A50,083695,Saad; Andrew S,12,0,30,18
1657431339353,ECE 65,A51,095125,Saad; Andrew S,24,0,26,2
1657431345374,ECE 109,A01,091882,Touri; Behrouz,19,0,70,51
1657431351405,ECE 180,A00,083140,Abi Samra; Nicholas Camill,1,0,30,29
1657431351405,ECE 180,B00,083141,Abi Samra; Nicholas Camill,0,0,30,30
1657431357428,MATH 10A,A01,083735,Patchell; Gregory David,2,0,30,28
1657431357428,MATH 10A,A02,083736,Patchell; Gregory David,20,0,30,10
1657431357428,MATH 10A,A03,083737,Patchell; Gregory David,16,0,30,14
1657431363455,MATH 10B,A01,083207,Lim; Seonhee,8,0,34,26
1657431363455,MATH 10B,A02,083208,Lim; Seonhee,9,0,35,26
1657431363455,MATH 10B,A03,093472,Lim; Seonhee,7,0,34,27
1657431363455,MATH 10B,B01,083739,Sinha; Shubham,12,0,30,18
1657431369479,MATH 18,A01,083743,Cinel; Cameron Alexander,7,0,30,23
1657431369479,MATH 18,A02,083744,Cinel; Cameron Alexander,17,0,30,13
1657431369479,MATH 18,A03,083745,Cinel; Cameron Alexander,9,0,30,21
1657431369479,MATH 18,B01,083748,Rideout; David Porter,5,0,37,32
1657431369479,MATH 18,B02,083749,Rideout; David Porter,5,0,36,31
1657431369479,MATH 18,B03,083750,Rideout; David Porter,3,0,37,34
1657431369479,MATH 18,B04,083751,Rideout; David Porter,6,0,36,30
1657431369479,MATH 18,B05,093473,Rideout; David Porter,6,0,36,30
1657431369479,MATH 18,B06,093474,Rideout; David Porter,6,0,36,30
1657431375502,MATH 20A,A01,083754,Zheng; Zequn,14,0,40,26
1657431381529,MATH 20B,A01,083756,Briones; Jor-el Thomas Caparas,4,0,36,32
1657431381529,MATH 20B,A02,083757,Briones; Jor-el Thomas Caparas,1,0,36,35
1657431381529,MATH 20B,A03,093475,Briones; Jor-el Thomas Caparas,2,0,36,34
1657431387555,MATH 20C,A01,083760,Briones; Jor-el Thomas Caparas,1,0,35,34
1657431387555,MATH 20C,A02,083761,Briones; Jor-el Thomas Caparas,8,0,35,27
1657431387555,MATH 20C,A03,093476,Briones; Jor-el Thomas Caparas,0,1,36,36
1657431387555,MATH 20C,B01,083762,Bach; Quang Tran,1,0,30,29
1657431393583,MATH 20D,A01,083765,Tran; Brian Kha,5,0,30,25
1657431393583,MATH 20D,A02,083766,Tran; Brian Kha,5,0,30,25
1657431393583,MATH 20D,A03,083767,Tran; Brian Kha,5,0,30,25
1657431399608,MATH 20E,A01,083771,Ganguly; Soumya,9,0,32,23
1657431399608,MATH 20E,A02,083772,Ganguly; Soumya,6,0,32,26
1657431399608,MATH 20E,B01,083773,Ciotti; Benjamin,20,0,35,15
1657431399608,MATH 20E,B02,083774,Ciotti; Benjamin,17,0,35,18
1657431405637,MATH 103A,A01,083777,Greenfeld; Be'Eri,3,0,36,33
1657431405637,MATH 103A,A02,083778,Greenfeld; Be'Eri,5,0,36,31
1657431405637,MATH 103A,A03,093561,Greenfeld; Be'Eri,5,0,36,31
1657431405637,MATH 103A,B01,083779,Greenfeld; Be'Eri,7,0,36,29
1657431405637,MATH 103A,B02,083780,Greenfeld; Be'Eri,4,0,36,32
1657431405637,MATH 103A,B03,093562,Greenfeld; Be'Eri,3,0,36,33
1657431411665,MATH 105,A01,085443,Carter; Anne Toulson,15,0,35,20
1657431411665,MATH 105,A02,093477,Carter; Anne Toulson,20,0,35,15
1657431417692,MATH 109,A01,083213,Ganzberger; Geoffrey Michael,2,0,34,32
1657431417692,MATH 109,A02,083214,Ganzberger; Geoffrey Michael,4,0,34,30
1657431417692,MATH 109,A03,093478,Ganzberger; Geoffrey Michael,2,0,34,32
1657431417692,MATH 109,B01,083215,Ganzberger; Geoffrey Michael,1,0,32,31
1657431417692,MATH 109,B02,083216,Ganzberger; Geoffrey Michael,2,0,32,30
1657431417692,MATH 109,B03,093479,Ganzberger; Geoffrey Michael,8,0,32,24
1657431423715,MATH 142A,A01,083219,Chow; Bennett,7,0,32,25
1657431423715,MATH 142A,A02,083220,Chow; Bennett,10,0,32,22
1657431423715,MATH 142A,A03,093480,Chow; Bennett,8,0,32,24
1657431423715,MATH 142A,B03,093481,Chow; Bennett,8,0,32,24
1657431423715,MATH 142A,B04,093558,Chow; Bennett,13,0,32,19
1657431423715,MATH 142A,B05,093559,Chow; Bennett,6,0,32,26
1657431429739,MATH 193A,A01,083224,Rotar; Vladimir,8,0,34,26
1657431429739,MATH 193A,A02,083225,Rotar; Vladimir,9,0,34,25
1657431429739,MATH 193A,A03,083781,Rotar; Vladimir,5,0,34,29
1657431429739,MATH 193A,A04,083782,Rotar; Vladimir,10,0,34,24
1657431429739,MATH 193A,A05,093482,Rotar; Vladimir,10,0,34,24
1657431435770,MATH 197,001,091859,McAuley; Julian John,9999,0,9999,0
1657431435770,MATH 197,002,095566,Kedlaya; Kiran S.,9997,0,9999,2
1657431435770,MATH 197,003,095567,Xiao; Ming,9999,0,9999,0
1657431435770,MATH 197,004,095571,Perols; Johan Lars,9998,0,9999,1
1657431442833,COGS 9,A01,083615,Shannon; Kyle Michael,9,0,75,66
1657431448860,COGS 11,A01,083617,Boyle; Mary E. T.,22,0,48,26
1657431454883,COGS 13,A01,083071,Bastos; Amalia Pinkusfeld,11,0,71,60
1657431460925,COGS 14A,A01,092681,Semenuks; Arturs,5,1,100,95
1657431466947,COGS 14B,A01,083073,Cheng; Tzu-Han,6,0,63,57
1657431472981,COGS 17,A01,092677,Semenuks; Arturs,6,0,81,75
1657431479008,COGS 100,A01,083619,Allen; Michael Gordon,17,0,70,53
1657431485033,COGS 101A,A01,083621,Davis; Joshua Daniel,9,0,68,59
1657431491062,COGS 101B,A01,091572,Allen; Michael Gordon,12,0,65,53
1657431497095,COGS 101C,A01,083625,Delgado; Tania,17,0,35,18
1657431503121,COGS 107A,A01,083627,Boyle; Mary E. T.,13,0,60,47
1657431509148,COGS 118A,A01,083075,Gupta; Anjum,21,0,76,55
1657431515173,CSE 3,A50,083646,Miranda; Gregory Joseph,24,0,50,26
1657431521199,CSE 8A,A50,083650,Miranda; Gregory Joseph,17,1,56,39
1657431527223,CSE 11,A01,083080,Cao; Yingjun,6,15,40,34
1657431533249,CSE 12,A01,083652,Krause-Levy; Sophia Louisa,28,1,120,92
1657431539273,CSE 15L,A01,083654,Morris; Justin Loren,9,0,50,41
1657431539273,CSE 15L,A02,083655,Morris; Justin Loren,9,0,50,41
1657431545297,CSE 20,A01,083657,Tran; Khoa Dang,39,0,80,41
1657431551325,CSE 21,A01,095574,Bach; Quang Tran,22,0,48,26
1657431557349,CSE 30,A01,083084,Eldon; John,5,0,80,75
1657431557349,CSE 30,B01,095061,Bhaskar; Nishant,9,0,50,41
1657431563372,CSE 100,A01,083659,Cao; Yingjun,5,4,70,65
1657431569395,CSE 134B,A01,083661,Powell; Thomas Allan,22,0,100,78
1657431575431,CSE 140,A01,083663,Gungor; Onat,15,0,85,70
1657431581457,CSE 140L,A01,083088,Eldon; John,21,0,100,79
1657431587483,CSE 175,A01,083665,Kumar; Rakesh,3,0,25,22
1657431593506,CSE 190,A00,092507,Dubnov; Shlomo,7,0,20,13
1657431599529,ECE 45,A01,083139,Congero; Spencer William,6,0,75,69
1657431605552,ECE 65,A50,083695,Saad; Andrew S,12,0,30,18
1657431605552,ECE 65,A51,095125,Saad; Andrew S,24,0,26,2
1657431611578,ECE 109,A01,091882,Touri; Behrouz,19,0,70,51
1657431617599,ECE 180,A00,083140,Abi Samra; Nicholas Camill,1,0,30,29
1657431617599,ECE 180,B00,083141,Abi Samra; Nicholas Camill,0,0,30,30
1657431623623,MATH 10A,A01,083735,Patchell; Gregory David,2,0,30,28
1657431623623,MATH 10A,A02,083736,Patchell; Gregory David,20,0,30,10
1657431623623,MATH 10A,A03,083737,Patchell; Gregory David,16,0,30,14
1657431629647,MATH 10B,A01,083207,Lim; Seonhee,8,0,34,26
1657431629647,MATH 10B,A02,083208,Lim; Seonhee,9,0,35,26
1657431629647,MATH 10B,A03,093472,Lim; Seonhee,7,0,34,27
1657431629647,MATH 10B,B01,083739,Sinha; Shubham,12,0,30,18
1657431635671,MATH 18,A01,083743,Cinel; Cameron Alexander,7,0,30,23
1657431635671,MATH 18,A02,083744,Cinel; Cameron Alexander,17,0,30,13
1657431635671,MATH 18,A03,083745,Cinel; Cameron Alexander,9,0,30,21
1657431635671,MATH 18,B01,083748,Rideout; David Porter,5,0,37,32
1657431635671,MATH 18,B02,083749,Rideout; David Porter,5,0,36,31
1657431635671,MATH 18,B03,083750,Rideout; David Porter,3,0,37,34
1657431635671,MATH 18,B04,083751,Rideout; David Porter,6,0,36,30
1657431635671,MATH 18,B05,093473,Rideout; David Porter,6,0,36,30
1657431635671,MATH 18,B06,093474,Rideout; David Porter,6,0,36,30
1657431641696,MATH 20A,A01,083754,Zheng; Zequn,14,0,40,26
1657431647718,MATH 20B,A01,083756,Briones; Jor-el Thomas Caparas,4,0,36,32
1657431647718,MATH 20B,A02,083757,Briones; Jor-el Thomas Caparas,1,0,36,35
1657431647718,MATH 20B,A03,093475,Briones; Jor-el Thomas Caparas,2,0,36,34
1657431653741,MATH 20C,A01,083760,Briones; Jor-el Thomas Caparas,1,0,35,34
1657431653741,MATH 20C,A02,083761,Briones; Jor-el Thomas Caparas,8,0,35,27
1657431653741,MATH 20C,A03,093476,Briones; Jor-el Thomas Caparas,0,1,36,36
1657431653741,MATH 20C,B01,083762,Bach; Quang Tran,1,0,30,29
1657431659861,MATH 20D,A01,083765,Tran; Brian Kha,5,0,30,25
1657431659861,MATH 20D,A02,083766,Tran; Brian Kha,5,0,30,25
1657431659861,MATH 20D,A03,083767,Tran; Brian Kha,5,0,30,25
1657431665888,MATH 20E,A01,083771,Ganguly; Soumya,9,0,32,23
1657431665888,MATH 20E,A02,083772,Ganguly; Soumya,6,0,32,26
1657431665888,MATH 20E,B01,083773,Ciotti; Benjamin,20,0,35,15
1657431665888,MATH 20E,B02,083774,Ciotti; Benjamin,17,0,35,18
1657431671910,MATH 103A,A01,083777,Greenfeld; Be'Eri,3,0,36,33
1657431671910,MATH 103A,A02,083778,Greenfeld; Be'Eri,5,0,36,31
1657431671910,MATH 103A,A03,093561,Greenfeld; Be'Eri,5,0,36,31
1657431671910,MATH 103A,B01,083779,Greenfeld; Be'Eri,7,0,36,29
1657431671910,MATH 103A,B02,083780,Greenfeld; Be'Eri,4,0,36,32
1657431671910,MATH 103A,B03,093562,Greenfeld; Be'Eri,3,0,36,33
1657431677935,MATH 105,A01,085443,Carter; Anne Toulson,15,0,35,20
1657431677935,MATH 105,A02,093477,Carter; Anne Toulson,20,0,35,15
1657431683962,MATH 109,A01,083213,Ganzberger; Geoffrey Michael,2,0,34,32
1657431683962,MATH 109,A02,083214,Ganzberger; Geoffrey Michael,4,0,34,30
1657431683962,MATH 109,A03,093478,Ganzberger; Geoffrey Michael,2,0,34,32
1657431683962,MATH 109,B01,083215,Ganzberger; Geoffrey Michael,1,0,32,31
1657431683962,MATH 109,B02,083216,Ganzberger; Geoffrey Michael,2,0,32,30
1657431683962,MATH 109,B03,093479,Ganzberger; Geoffrey Michael,8,0,32,24
1657431689999,MATH 142A,A01,083219,Chow; Bennett,7,0,32,25
1657431689999,MATH 142A,A02,083220,Chow; Bennett,10,0,32,22
1657431689999,MATH 142A,A03,093480,Chow; Bennett,8,0,32,24
1657431689999,MATH 142A,B03,093481,Chow; Bennett,8,0,32,24
1657431689999,MATH 142A,B04,093558,Chow; Bennett,13,0,32,19
1657431689999,MATH 142A,B05,093559,Chow; Bennett,6,0,32,26
1657431696023,MATH 193A,A01,083224,Rotar; Vladimir,8,0,34,26
1657431696023,MATH 193A,A02,083225,Rotar; Vladimir,9,0,34,25
1657431696023,MATH 193A,A03,083781,Rotar; Vladimir,5,0,34,29
1657431696023,MATH 193A,A04,083782,Rotar; Vladimir,10,0,34,24
1657431696023,MATH 193A,A05,093482,Rotar; Vladimir,10,0,34,24
1657431702046,MATH 197,001,091859,McAuley; Julian John,9999,0,9999,0
1657431702046,MATH 197,002,095566,Kedlaya; Kiran S.,9997,0,9999,2
1657431702046,MATH 197,003,095567,Xiao; Ming,9999,0,9999,0
1657431702046,MATH 197,004,095571,Perols; Johan Lars,9998,0,9999,1
1657431709104,COGS 9,A01,083615,Shannon; Kyle Michael,9,0,75,66
1657431715127,COGS 11,A01,083617,Boyle; Mary E. T.,22,0,48,26
1657431721151,COGS 13,A01,083071,Bastos; Amalia Pinkusfeld,11,0,71,60
1657431727173,COGS 14A,A01,092681,Semenuks; Arturs,5,1,100,95
1657431733197,COGS 14B,A01,083073,Cheng; Tzu-Han,6,0,63,57
1657431739224,COGS 17,A01,092677,Semenuks; Arturs,6,0,81,75
1657431745251,COGS 100,A01,083619,Allen; Michael Gordon,17,0,70,53
1657431751280,COGS 101A,A01,083621,Davis; Joshua Daniel,9,0,68,59
1657431757306,COGS 101B,A01,091572,Allen; Michael Gordon,12,0,65,53
1657431763330,COGS 101C,A01,083625,Delgado; Tania,17,0,35,18
1657431769358,COGS 107A,A01,083627,Boyle; Mary E. T.,13,0,60,47
1657431775381,COGS 118A,A01,083075,Gupta; Anjum,21,0,76,55
1657431781411,CSE 3,A50,083646,Miranda; Gregory Joseph,24,0,50,26
1657431787438,CSE 8A,A50,083650,Miranda; Gregory Joseph,17,1,56,39
1657431793459,CSE 11,A01,083080,Cao; Yingjun,6,15,40,34
1657431799482,CSE 12,A01,083652,Krause-Levy; Sophia Louisa,28,1,120,92
1657431805503,CSE 15L,A01,083654,Morris; Justin Loren,9,0,50,41
1657431805503,CSE 15L,A02,083655,Morris; Justin Loren,9,0,50,41
1657431811530,CSE 20,A01,083657,Tran; Khoa Dang,39,0,80,41
1657431817557,CSE 21,A01,095574,Bach; Quang Tran,22,0,48,26
1657431823585,CSE 30,A01,083084,Eldon; John,5,0,80,75
1657431823585,CSE 30,B01,095061,Bhaskar; Nishant,9,0,50,41
1657431829607,CSE 100,A01,083659,Cao; Yingjun,5,4,70,65
1657431835632,CSE 134B,A01,083661,Powell; Thomas Allan,22,0,100,78
1657431841658,CSE 140,A01,083663,Gungor; Onat,15,0,85,70
1657431847680,CSE 140L,A01,083088,Eldon; John,21,0,100,79
1657431853701,CSE 175,A01,083665,Kumar; Rakesh,3,0,25,22
1657431859722,CSE 190,A00,092507,Dubnov; Shlomo,7,0,20,13
1657431865749,ECE 45,A01,083139,Congero; Spencer William,6,0,75,69
1657431871772,ECE 65,A50,083695,Saad; Andrew S,12,0,30,18
1657431871772,ECE 65,A51,095125,Saad; Andrew S,24,0,26,2
1657431877798,ECE 109,A01,091882,Touri; Behrouz,19,0,70,51
1657431883829,ECE 180,A00,083140,Abi Samra; Nicholas Camill,1,0,30,29
1657431883829,ECE 180,B00,083141,Abi Samra; Nicholas Camill,0,0,30,30
1657431889854,MATH 10A,A01,083735,Patchell; Gregory David,2,0,30,28
1657431889854,MATH 10A,A02,083736,Patchell; Gregory David,20,0,30,10
1657431889854,MATH 10A,A03,083737,Patchell; Gregory David,16,0,30,14
1657431895883,MATH 10B,A01,083207,Lim; Seonhee,8,0,34,26
1657431895883,MATH 10B,A02,083208,Lim; Seonhee,9,0,35,26
1657431895883,MATH 10B,A03,093472,Lim; Seonhee,7,0,34,27
1657431895883,MATH 10B,B01,083739,Sinha; Shubham,12,0,30,18
1657431901906,MATH 18,A01,083743,Cinel; Cameron Alexander,7,0,30,23
1657431901906,MATH 18,A02,083744,Cinel; Cameron Alexander,17,0,30,13
1657431901906,MATH 18,A03,083745,Cinel; Cameron Alexander,9,0,30,21
1657431901906,MATH 18,B01,083748,Rideout; David Porter,5,0,37,32
1657431901906,MATH 18,B02,083749,Rideout; David Porter,5,0,36,31
1657431901906,MATH 18,B03,083750,Rideout; David Porter,3,0,37,34
1657431901906,MATH 18,B04,083751,Rideout; David Porter,6,0,36,30
1657431901906,MATH 18,B05,093473,Rideout; David Porter,6,0,36,30
1657431901906,MATH 18,B06,093474,Rideout; David Porter,6,0,36,30
1657431907930,MATH 20A,A01,083754,Zheng; Zequn,14,0,40,26
1657431913956,MATH 20B,A01,083756,Briones; Jor-el Thomas Caparas,4,0,36,32
1657431913956,MATH 20B,A02,083757,Briones; Jor-el Thomas Caparas,1,0,36,35
1657431913956,MATH 20B,A03,093475,Briones; Jor-el Thomas Caparas,2,0,36,34
1657431919978,MATH 20C,A01,083760,Briones; Jor-el Thomas Caparas,1,0,35,34
1657431919978,MATH 20C,A02,083761,Briones; Jor-el Thomas Caparas,8,0,35,27
1657431919978,MATH 20C,A03,093476,Briones; Jor-el Thomas Caparas,0,1,36,36
1657431919978,MATH 20C,B01,083762,Bach; Quang Tran,1,0,30,29
1657431926009,MATH 20D,A01,083765,Tran; Brian Kha,5,0,30,25
1657431926009,MATH 20D,A02,083766,Tran; Brian Kha,5,0,30,25
1657431926009,MATH 20D,A03,083767,Tran; Brian Kha,5,0,30,25
1657431932032,MATH 20E,A01,083771,Ganguly; Soumya,9,0,32,23
1657431932032,MATH 20E,A02,083772,Ganguly; Soumya,6,0,32,26
1657431932032,MATH 20E,B01,083773,Ciotti; Benjamin,20,0,35,15
1657431932032,MATH 20E,B02,083774,Ciotti; Benjamin,17,0,35,18
1657431938063,MATH 103A,A01,083777,Greenfeld; Be'Eri,3,0,36,33
1657431938063,MATH 103A,A02,083778,Greenfeld; Be'Eri,5,0,36,31
1657431938063,MATH 103A,A03,093561,Greenfeld; Be'Eri,5,0,36,31
1657431938063,MATH 103A,B01,083779,Greenfeld; Be'Eri,7,0,36,29
1657431938063,MATH 103A,B02,083780,Greenfeld; Be'Eri,4,0,36,32
1657431938063,MATH 103A,B03,093562,Greenfeld; Be'Eri,3,0,36,33
1657431944085,MATH 105,A01,085443,Carter; Anne Toulson,15,0,35,20
1657431944085,MATH 105,A02,093477,Carter; Anne Toulson,20,0,35,15
1657431950111,MATH 109,A01,083213,Ganzberger; Geoffrey Michael,2,0,34,32
1657431950111,MATH 109,A02,083214,Ganzberger; Geoffrey Michael,4,0,34,30
1657431950111,MATH 109,A03,093478,Ganzberger; Geoffrey Michael,2,0,34,32
1657431950111,MATH 109,B01,083215,Ganzberger; Geoffrey Michael,1,0,32,31
1657431950111,MATH 109,B02,083216,Ganzberger; Geoffrey Michael,2,0,32,30
1657431950111,MATH 109,B03,093479,Ganzberger; Geoffrey Michael,8,0,32,24
1657431956135,MATH 142A,A01,083219,Chow; Bennett,7,0,32,25
1657431956135,MATH 142A,A02,083220,Chow; Bennett,10,0,32,22
1657431956135,MATH 142A,A03,093480,Chow; Bennett,8,0,32,24
1657431956135,MATH 142A,B03,093481,Chow; Bennett,8,0,32,24
1657431956135,MATH 142A,B04,093558,Chow; Bennett,13,0,32,19
1657431956135,MATH 142A,B05,093559,Chow; Bennett,6,0,32,26
1657431962162,MATH 193A,A01,083224,Rotar; Vladimir,8,0,34,26
1657431962162,MATH 193A,A02,083225,Rotar; Vladimir,9,0,34,25
1657431962162,MATH 193A,A03,083781,Rotar; Vladimir,5,0,34,29
1657431962162,MATH 193A,A04,083782,Rotar; Vladimir,10,0,34,24
1657431962162,MATH 193A,A05,093482,Rotar; Vladimir,10,0,34,24
1657431968188,MATH 197,001,091859,McAuley; Julian John,9999,0,9999,0
1657431968188,MATH 197,002,095566,Kedlaya; Kiran S.,9997,0,9999,2
1657431968188,MATH 197,003,095567,Xiao; Ming,9999,0,9999,0
1657431968188,MATH 197,004,095571,Perols; Johan Lars,9998,0,9999,1
1657431975282,COGS 9,A01,083615,Shannon; Kyle Michael,9,0,75,66
1657431981306,COGS 11,A01,083617,Boyle; Mary E. T.,22,0,48,26
1657431987333,COGS 13,A01,083071,Bastos; Amalia Pinkusfeld,11,0,71,60
1657431993358,COGS 14A,A01,092681,Semenuks; Arturs,5,1,100,95
1657431999381,COGS 14B,A01,083073,Cheng; Tzu-Han,6,0,63,57
1657432005407,COGS 17,A01,092677,Semenuks; Arturs,6,0,81,75
1657432011430,COGS 100,A01,083619,Allen; Michael Gordon,17,0,70,53
1657432017456,COGS 101A,A01,083621,Davis; Joshua Daniel,9,0,68,59
1657432023482,COGS 101B,A01,091572,Allen; Michael Gordon,12,0,65,53
1657432029505,COGS 101C,A01,083625,Delgado; Tania,17,0,35,18
1657432035528,COGS 107A,A01,083627,Boyle; Mary E. T.,13,0,60,47
1657432041552,COGS 118A,A01,083075,Gupta; Anjum,21,0,76,55
1657432047581,CSE 3,A50,083646,Miranda; Gregory Joseph,24,0,50,26
1657432053605,CSE 8A,A50,083650,Miranda; Gregory Joseph,17,1,56,39
1657432059634,CSE 11,A01,083080,Cao; Yingjun,6,15,40,34
1657432065658,CSE 12,A01,083652,Krause-Levy; Sophia Louisa,28,1,120,92
1657432071684,CSE 15L,A01,083654,Morris; Justin Loren,9,0,50,41
1657432071684,CSE 15L,A02,083655,Morris; Justin Loren,9,0,50,41
1657432077708,CSE 20,A01,083657,Tran; Khoa Dang,39,0,80,41
1657432083731,CSE 21,A01,095574,Bach; Quang Tran,22,0,48,26
1657432089758,CSE 30,A01,083084,Eldon; John,5,0,80,75
1657432089758,CSE 30,B01,095061,Bhaskar; Nishant,9,0,50,41
1657432095782,CSE 100,A01,083659,Cao; Yingjun,5,4,70,65
1657432101804,CSE 134B,A01,083661,Powell; Thomas Allan,22,0,100,78
1657432107827,CSE 140,A01,083663,Gungor; Onat,15,0,85,70
1657432113856,CSE 140L,A01,083088,Eldon; John,21,0,100,79
1657432119878,CSE 175,A01,083665,Kumar; Rakesh,3,0,25,22
1657432125900,CSE 190,A00,092507,Dubnov; Shlomo,7,0,20,13
1657432131924,ECE 45,A01,083139,Congero; Spencer William,6,0,75,69
1657432137946,ECE 65,A50,083695,Saad; Andrew S,12,0,30,18
1657432137946,ECE 65,A51,095125,Saad; Andrew S,24,0,26,2
1657432143975,ECE 109,A01,091882,Touri; Behrouz,19,0,70,51
1657432149998,ECE 180,A00,083140,Abi Samra; Nicholas Camill,1,0,30,29
1657432149998,ECE 180,B00,083141,Abi Samra; Nicholas Camill,0,0,30,30
1657432156022,MATH 10A,A01,083735,Patchell; Gregory David,2,0,30,28
1657432156022,MATH 10A,A02,083736,Patchell; Gregory David,20,0,30,10
1657432156022,MATH 10A,A03,083737,Patchell; Gregory David,16,0,30,14
1657432162049,MATH 10B,A01,083207,Lim; Seonhee,8,0,34,26
1657432162049,MATH 10B,A02,083208,Lim; Seonhee,9,0,35,26
1657432162049,MATH 10B,A03,093472,Lim; Seonhee,7,0,34,27
1657432162049,MATH 10B,B01,083739,Sinha; Shubham,12,0,30,18
1657432168080,MATH 18,A01,083743,Cinel; Cameron Alexander,7,0,30,23
1657432168080,MATH 18,A02,083744,Cinel; Cameron Alexander,17,0,30,13
1657432168080,MATH 18,A03,083745,Cinel; Cameron Alexander,9,0,30,21
1657432168080,MATH 18,B01,083748,Rideout; David Porter,5,0,37,32
1657432168080,MATH 18,B02,083749,Rideout; David Porter,5,0,36,31
1657432168080,MATH 18,B03,083750,Rideout; David Porter,3,0,37,34
1657432168080,MATH 18,B04,083751,Rideout; David Porter,6,0,36,30
1657432168080,MATH 18,B05,093473,Rideout; David Porter,6,0,36,30
1657432168080,MATH 18,B06,093474,Rideout; David Porter,6,0,36,30
1657432174104,MATH 20A,A01,083754,Zheng; Zequn,14,0,40,26
1657432180127,MATH 20B,A01,083756,Briones; Jor-el Thomas Caparas,4,0,36,32
1657432180127,MATH 20B,A02,083757,Briones; Jor-el Thomas Caparas,1,0,36,35
1657432180127,MATH 20B,A03,093475,Briones; Jor-el Thomas Caparas,2,0,36,34
1657432186154,MATH 20C,A01,083760,Briones; Jor-el Thomas Caparas,1,0,35,34
1657432186154,MATH 20C,A02,083761,Briones; Jor-el Thomas Caparas,8,0,35,27
1657432186154,MATH 20C,A03,093476,Briones; Jor-el Thomas Caparas,0,1,36,36
1657432186154,MATH 20C,B01,083762,Bach; Quang Tran,1,0,30,29
1657432192176,MATH 20D,A01,083765,Tran; Brian Kha,5,0,30,25
1657432192176,MATH 20D,A02,083766,Tran; Brian Kha,5,0,30,25
1657432192176,MATH 20D,A03,083767,Tran; Brian Kha,5,0,30,25
1657432198205,MATH 20E,A01,083771,Ganguly; Soumya,9,0,32,23
1657432198205,MATH 20E,A02,083772,Ganguly; Soumya,6,0,32,26
1657432198205,MATH 20E,B01,083773,Ciotti; Benjamin,20,0,35,15
1657432198205,MATH 20E,B02,083774,Ciotti; Benjamin,17,0,35,18
1657432204236,MATH 103A,A01,083777,Greenfeld; Be'Eri,3,0,36,33
1657432204236,MATH 103A,A02,083778,Greenfeld; Be'Eri,5,0,36,31
1657432204236,MATH 103A,A03,093561,Greenfeld; Be'Eri,5,0,36,31
1657432204236,MATH 103A,B01,083779,Greenfeld; Be'Eri,7,0,36,29
1657432204236,MATH 103A,B02,083780,Greenfeld; Be'Eri,4,0,36,32
1657432204236,MATH 103A,B03,093562,Greenfeld; Be'Eri,3,0,36,33
1657432210261,MATH 105,A01,085443,Carter; Anne Toulson,15,0,35,20
1657432210261,MATH 105,A02,093477,Carter; Anne Toulson,20,0,35,15
1657432216289,MATH 109,A01,083213,Ganzberger; Geoffrey Michael,2,0,34,32
1657432216289,MATH 109,A02,083214,Ganzberger; Geoffrey Michael,4,0,34,30
1657432216289,MATH 109,A03,093478,Ganzberger; Geoffrey Michael,2,0,34,32
1657432216289,MATH 109,B01,083215,Ganzberger; Geoffrey Michael,1,0,32,31
1657432216289,MATH 109,B02,083216,Ganzberger; Geoffrey Michael,2,0,32,30
1657432216289,MATH 109,B03,093479,Ganzberger; Geoffrey Michael,8,0,32,24
1657432222311,MATH 142A,A01,083219,Chow; Bennett,7,0,32,25
1657432222311,MATH 142A,A02,083220,Chow; Bennett,10,0,32,22
1657432222311,MATH 142A,A03,093480,Chow; Bennett,8,0,32,24
1657432222311,MATH 142A,B03,093481,Chow; Bennett,8,0,32,24
1657432222311,MATH 142A,B04,093558,Chow; Bennett,13,0,32,19
1657432222311,MATH 142A,B05,093559,Chow; Bennett,6,0,32,26
1657432228341,MATH 193A,A01,083224,Rotar; Vladimir,8,0,34,26
1657432228341,MATH 193A,A02,083225,Rotar; Vladimir,9,0,34,25
1657432228341,MATH 193A,A03,083781,Rotar; Vladimir,5,0,34,29
1657432228341,MATH 193A,A04,083782,Rotar; Vladimir,10,0,34,24
1657432228341,MATH 193A,A05,093482,Rotar; Vladimir,10,0,34,24
1657432234364,MATH 197,001,091859,McAuley; Julian John,9999,0,9999,0
1657432234364,MATH 197,002,095566,Kedlaya; Kiran S.,9997,0,9999,2
1657432234364,MATH 197,003,095567,Xiao; Ming,9999,0,9999,0
1657432234364,MATH 197,004,095571,Perols; Johan Lars,9998,0,9999,1
1657432241417,COGS 9,A01,083615,Shannon; Kyle Michael,9,0,75,66
1657432247440,COGS 11,A01,083617,Boyle; Mary E. T.,22,0,48,26
1657432253534,COGS 13,A01,083071,Bastos; Amalia Pinkusfeld,11,0,71,60
1657432259559,COGS 14A,A01,092681,Semenuks; Arturs,5,1,100,95
1657432265587,COGS 14B,A01,083073,Cheng; Tzu-Han,6,0,63,57
1657432271613,COGS 17,A01,092677,Semenuks; Arturs,6,0,81,75
1657432277639,COGS 100,A01,083619,Allen; Michael Gordon,17,0,70,53
1657432283663,COGS 101A,A01,083621,Davis; Joshua Daniel,9,0,68,59
1657432289686,COGS 101B,A01,091572,Allen; Michael Gordon,12,0,65,53
1657432295713,COGS 101C,A01,083625,Delgado; Tania,17,0,35,18
1657432301736,COGS 107A,A01,083627,Boyle; Mary E. T.,13,0,60,47
1657432307757,COGS 118A,A01,083075,Gupta; Anjum,21,0,76,55
1657432313782,CSE 3,A50,083646,Miranda; Gregory Joseph,24,0,50,26
1657432319807,CSE 8A,A50,083650,Miranda; Gregory Joseph,17,1,56,39
1657432325832,CSE 11,A01,083080,Cao; Yingjun,6,15,40,34
1657432331860,CSE 12,A01,083652,Krause-Levy; Sophia Louisa,28,1,120,92
1657432337883,CSE 15L,A01,083654,Morris; Justin Loren,9,0,50,41
1657432337883,CSE 15L,A02,083655,Morris; Justin Loren,9,0,50,41
1657432343906,CSE 20,A01,083657,Tran; Khoa Dang,39,0,80,41
1657432349930,CSE 21,A01,095574,Bach; Quang Tran,22,0,48,26
1657432355958,CSE 30,A01,083084,Eldon; John,5,0,80,75
1657432355958,CSE 30,B01,095061,Bhaskar; Nishant,9,0,50,41
1657432361989,CSE 100,A01,083659,Cao; Yingjun,5,4,70,65
1657432368019,CSE 134B,A01,083661,Powell; Thomas Allan,22,0,100,78
1657432374049,CSE 140,A01,083663,Gungor; Onat,15,0,85,70
1657432380078,CSE 140L,A01,083088,Eldon; John,21,0,100,79
1657432386102,CSE 175,A01,083665,Kumar; Rakesh,3,0,25,22
1657432392126,CSE 190,A00,092507,Dubnov; Shlomo,7,0,20,13
1657432398154,ECE 45,A01,083139,Congero; Spencer William,6,0,75,69
1657432404179,ECE 65,A50,083695,Saad; Andrew S,12,0,30,18
1657432404179,ECE 65,A51,095125,Saad; Andrew S,24,0,26,2
1657432410204,ECE 109,A01,091882,Touri; Behrouz,19,0,70,51
1657432416229,ECE 180,A00,083140,Abi Samra; Nicholas Camill,1,0,30,29
1657432416229,ECE 180,B00,083141,Abi Samra; Nicholas Camill,0,0,30,30
1657432422256,MATH 10A,A01,083735,Patchell; Gregory David,2,0,30,28
1657432422256,MATH 10A,A02,083736,Patchell; Gregory David,20,0,30,10
1657432422256,MATH 10A,A03,083737,Patchell; Gregory David,16,0,30,14
1657432428279,MATH 10B,A01,083207,Lim; Seonhee,8,0,34,26
1657432428279,MATH 10B,A02,083208,Lim; Seonhee,9,0,35,26
1657432428279,MATH 10B,A03,093472,Lim; Seonhee,7,0,34,27
1657432428279,MATH 10B,B01,083739,Sinha; Shubham,12,0,30,18
1657432434303,MATH 18,A01,083743,Cinel; Cameron Alexander,7,0,30,23
1657432434303,MATH 18,A02,083744,Cinel; Cameron Alexander,17,0,30,13
1657432434303,MATH 18,A03,083745,Cinel; Cameron Alexander,9,0,30,21
1657432434303,MATH 18,B01,083748,Rideout; David Porter,5,0,37,32
1657432434303,MATH 18,B02,083749,Rideout; David Porter,5,0,36,31
1657432434303,MATH 18,B03,083750,Rideout; David Porter,3,0,37,34
1657432434303,MATH 18,B04,083751,Rideout; David Porter,6,0,36,30
1657432434303,MATH 18,B05,093473,Rideout; David Porter,6,0,36,30
1657432434303,MATH 18,B06,093474,Rideout; David Porter,6,0,36,30
1657432440330,MATH 20A,A01,083754,Zheng; Zequn,14,0,40,26
1657432446357,MATH 20B,A01,083756,Briones; Jor-el Thomas Caparas,4,0,36,32
1657432446357,MATH 20B,A02,083757,Briones; Jor-el Thomas Caparas,1,0,36,35
1657432446357,MATH 20B,A03,093475,Briones; Jor-el Thomas Caparas,2,0,36,34
1657432452393,MATH 20C,A01,083760,Briones; Jor-el Thomas Caparas,1,0,35,34
1657432452393,MATH 20C,A02,083761,Briones; Jor-el Thomas Caparas,8,0,35,27
1657432452393,MATH 20C,A03,093476,Briones; Jor-el Thomas Caparas,0,1,36,36
1657432452393,MATH 20C,B01,083762,Bach; Quang Tran,1,0,30,29
1657432458417,MATH 20D,A01,083765,Tran; Brian Kha,5,0,30,25
1657432458417,MATH 20D,A02,083766,Tran; Brian Kha,5,0,30,25
1657432458417,MATH 20D,A03,083767,Tran; Brian Kha,5,0,30,25
1657432464442,MATH 20E,A01,083771,Ganguly; Soumya,9,0,32,23
1657432464442,MATH 20E,A02,083772,Ganguly; Soumya,6,0,32,26
1657432464442,MATH 20E,B01,083773,Ciotti; Benjamin,20,0,35,15
1657432464442,MATH 20E,B02,083774,Ciotti; Benjamin,17,0,35,18
1657432470465,MATH 103A,A01,083777,Greenfeld; Be'Eri,3,0,36,33
1657432470465,MATH 103A,A02,083778,Greenfeld; Be'Eri,5,0,36,31
1657432470465,MATH 103A,A03,093561,Greenfeld; Be'Eri,5,0,36,31
1657432470465,MATH 103A,B01,083779,Greenfeld; Be'Eri,7,0,36,29
1657432470465,MATH 103A,B02,083780,Greenfeld; Be'Eri,4,0,36,32
1657432470465,MATH 103A,B03,093562,Greenfeld; Be'Eri,3,0,36,33
1657432476493,MATH 105,A01,085443,Carter; Anne Toulson,15,0,35,20
1657432476493,MATH 105,A02,093477,Carter; Anne Toulson,20,0,35,15
1657432482518,MATH 109,A01,083213,Ganzberger; Geoffrey Michael,2,0,34,32
1657432482518,MATH 109,A02,083214,Ganzberger; Geoffrey Michael,4,0,34,30
1657432482518,MATH 109,A03,093478,Ganzberger; Geoffrey Michael,2,0,34,32
1657432482518,MATH 109,B01,083215,Ganzberger; Geoffrey Michael,1,0,32,31
1657432482518,MATH 109,B02,083216,Ganzberger; Geoffrey Michael,2,0,32,30
1657432482518,MATH 109,B03,093479,Ganzberger; Geoffrey Michael,8,0,32,24
1657432488541,MATH 142A,A01,083219,Chow; Bennett,7,0,32,25
1657432488541,MATH 142A,A02,083220,Chow; Bennett,10,0,32,22
1657432488541,MATH 142A,A03,093480,Chow; Bennett,8,0,32,24
1657432488541,MATH 142A,B03,093481,Chow; Bennett,8,0,32,24
1657432488541,MATH 142A,B04,093558,Chow; Bennett,13,0,32,19
1657432488541,MATH 142A,B05,093559,Chow; Bennett,6,0,32,26
1657432494565,MATH 193A,A01,083224,Rotar; Vladimir,8,0,34,26
1657432494565,MATH 193A,A02,083225,Rotar; Vladimir,9,0,34,25
1657432494565,MATH 193A,A03,083781,Rotar; Vladimir,5,0,34,29
1657432494565,MATH 193A,A04,083782,Rotar; Vladimir,10,0,34,24
1657432494565,MATH 193A,A05,093482,Rotar; Vladimir,10,0,34,24
1657432500589,MATH 197,001,091859,McAuley; Julian John,9999,0,9999,0
1657432500589,MATH 197,002,095566,Kedlaya; Kiran S.,9997,0,9999,2
1657432500589,MATH 197,003,095567,Xiao; Ming,9999,0,9999,0
1657432500589,MATH 197,004,095571,Perols; Johan Lars,9998,0,9999,1
1657432507651,COGS 9,A01,083615,Shannon; Kyle Michael,9,0,75,66
1657432513677,COGS 11,A01,083617,Boyle; Mary E. T.,22,0,48,26
1657432519701,COGS 13,A01,083071,Bastos; Amalia Pinkusfeld,11,0,71,60
1657432525726,COGS 14A,A01,092681,Semenuks; Arturs,5,1,100,95
1657432531751,COGS 14B,A01,083073,Cheng; Tzu-Han,6,0,63,57
1657432537776,COGS 17,A01,092677,Semenuks; Arturs,6,0,81,75
1657432543812,COGS 100,A01,083619,Allen; Michael Gordon,17,0,70,53
1657432549834,COGS 101A,A01,083621,Davis; Joshua Daniel,9,0,68,59
1657432555858,COGS 101B,A01,091572,Allen; Michael Gordon,12,0,65,53
1657432561881,COGS 101C,A01,083625,Delgado; Tania,17,0,35,18
1657432567908,COGS 107A,A01,083627,Boyle; Mary E. T.,13,0,60,47
1657432573934,COGS 118A,A01,083075,Gupta; Anjum,21,0,76,55
1657432579962,CSE 3,A50,083646,Miranda; Gregory Joseph,24,0,50,26
1657432585985,CSE 8A,A50,083650,Miranda; Gregory Joseph,17,1,56,39
1657432592011,CSE 11,A01,083080,Cao; Yingjun,6,15,40,34
1657432598035,CSE 12,A01,083652,Krause-Levy; Sophia Louisa,28,1,120,92
1657432604057,CSE 15L,A01,083654,Morris; Justin Loren,9,0,50,41
1657432604057,CSE 15L,A02,083655,Morris; Justin Loren,9,0,50,41
1657432610085,CSE 20,A01,083657,Tran; Khoa Dang,39,0,80,41
1657432616109,CSE 21,A01,095574,Bach; Quang Tran,22,0,48,26
1657432622133,CSE 30,A01,083084,Eldon; John,5,0,80,75
1657432622133,CSE 30,B01,095061,Bhaskar; Nishant,9,0,50,41
1657432628160,CSE 100,A01,083659,Cao; Yingjun,5,4,70,65
1657432634186,CSE 134B,A01,083661,Powell; Thomas Allan,22,0,100,78
1657432640214,CSE 140,A01,083663,Gungor; Onat,15,0,85,70
1657432646253,CSE 140L,A01,083088,Eldon; John,21,0,100,79
1657432652279,CSE 175,A01,083665,Kumar; Rakesh,3,0,25,22
1657432658301,CSE 190,A00,092507,Dubnov; Shlomo,7,0,20,13
1657432664326,ECE 45,A01,083139,Congero; Spencer William,6,0,75,69
1657432670355,ECE 65,A50,083695,Saad; Andrew S,12,0,30,18
1657432670355,ECE 65,A51,095125,Saad; Andrew S,24,0,26,2
1657432676376,ECE 109,A01,091882,Touri; Behrouz,19,0,70,51
1657432682404,ECE 180,A00,083140,Abi Samra; Nicholas Camill,1,0,30,29
1657432682404,ECE 180,B00,083141,Abi Samra; Nicholas Camill,0,0,30,30
1657432688428,MATH 10A,A01,083735,Patchell; Gregory David,2,0,30,28
1657432688428,MATH 10A,A02,083736,Patchell; Gregory David,20,0,30,10
1657432688428,MATH 10A,A03,083737,Patchell; Gregory David,16,0,30,14
1657432694455,MATH 10B,A01,083207,Lim; Seonhee,8,0,34,26
1657432694455,MATH 10B,A02,083208,Lim; Seonhee,9,0,35,26
1657432694455,MATH 10B,A03,093472,Lim; Seonhee,7,0,34,27
1657432694455,MATH 10B,B01,083739,Sinha; Shubham,12,0,30,18
1657432700479,MATH 18,A01,083743,Cinel; Cameron Alexander,7,0,30,23
1657432700479,MATH 18,A02,083744,Cinel; Cameron Alexander,17,0,30,13
1657432700479,MATH 18,A03,083745,Cinel; Cameron Alexander,9,0,30,21
1657432700479,MATH 18,B01,083748,Rideout; David Porter,5,0,37,32
1657432700479,MATH 18,B02,083749,Rideout; David Porter,5,0,36,31
1657432700479,MATH 18,B03,083750,Rideout; David Porter,3,0,37,34
1657432700479,MATH 18,B04,083751,Rideout; David Porter,6,0,36,30
1657432700479,MATH 18,B05,093473,Rideout; David Porter,6,0,36,30
1657432700479,MATH 18,B06,093474,Rideout; David Porter,6,0,36,30
1657432706503,MATH 20A,A01,083754,Zheng; Zequn,14,0,40,26
1657432712531,MATH 20B,A01,083756,Briones; Jor-el Thomas Caparas,4,0,36,32
1657432712531,MATH 20B,A02,083757,Briones; Jor-el Thomas Caparas,1,0,36,35
1657432712531,MATH 20B,A03,093475,Briones; Jor-el Thomas Caparas,2,0,36,34
1657432718560,MATH 20C,A01,083760,Briones; Jor-el Thomas Caparas,1,0,35,34
1657432718560,MATH 20C,A02,083761,Briones; Jor-el Thomas Caparas,8,0,35,27
1657432718560,MATH 20C,A03,093476,Briones; Jor-el Thomas Caparas,0,1,36,36
1657432718560,MATH 20C,B01,083762,Bach; Quang Tran,1,0,30,29
1657432724584,MATH 20D,A01,083765,Tran; Brian Kha,5,0,30,25
1657432724584,MATH 20D,A02,083766,Tran; Brian Kha,5,0,30,25
1657432724584,MATH 20D,A03,083767,Tran; Brian Kha,5,0,30,25
1657432730607,MATH 20E,A01,083771,Ganguly; Soumya,9,0,32,23
1657432730607,MATH 20E,A02,083772,Ganguly; Soumya,6,0,32,26
1657432730607,MATH 20E,B01,083773,Ciotti; Benjamin,20,0,35,15
1657432730607,MATH 20E,B02,083774,Ciotti; Benjamin,17,0,35,18
1657432736628,MATH 103A,A01,083777,Greenfeld; Be'Eri,3,0,36,33
1657432736628,MATH 103A,A02,083778,Greenfeld; Be'Eri,5,0,36,31
1657432736628,MATH 103A,A03,093561,Greenfeld; Be'Eri,5,0,36,31
1657432736628,MATH 103A,B01,083779,Greenfeld; Be'Eri,7,0,36,29
1657432736628,MATH 103A,B02,083780,Greenfeld; Be'Eri,4,0,36,32
1657432736628,MATH 103A,B03,093562,Greenfeld; Be'Eri,3,0,36,33
1657432742651,MATH 105,A01,085443,Carter; Anne Toulson,15,0,35,20
1657432742651,MATH 105,A02,093477,Carter; Anne Toulson,20,0,35,15
1657432748675,MATH 109,A01,083213,Ganzberger; Geoffrey Michael,2,0,34,32
1657432748675,MATH 109,A02,083214,Ganzberger; Geoffrey Michael,4,0,34,30
1657432748675,MATH 109,A03,093478,Ganzberger; Geoffrey Michael,2,0,34,32
1657432748675,MATH 109,B01,083215,Ganzberger; Geoffrey Michael,1,0,32,31
1657432748675,MATH 109,B02,083216,Ganzberger; Geoffrey Michael,2,0,32,30
1657432748675,MATH 109,B03,093479,Ganzberger; Geoffrey Michael,8,0,32,24
1657432754703,MATH 142A,A01,083219,Chow; Bennett,7,0,32,25
1657432754703,MATH 142A,A02,083220,Chow; Bennett,10,0,32,22
1657432754703,MATH 142A,A03,093480,Chow; Bennett,8,0,32,24
1657432754703,MATH 142A,B03,093481,Chow; Bennett,8,0,32,24
1657432754703,MATH 142A,B04,093558,Chow; Bennett,13,0,32,19
1657432754703,MATH 142A,B05,093559,Chow; Bennett,6,0,32,26
1657432760731,MATH 193A,A01,083224,Rotar; Vladimir,8,0,34,26
1657432760731,MATH 193A,A02,083225,Rotar; Vladimir,9,0,34,25
1657432760731,MATH 193A,A03,083781,Rotar; Vladimir,5,0,34,29
1657432760731,MATH 193A,A04,083782,Rotar; Vladimir,10,0,34,24
1657432760731,MATH 193A,A05,093482,Rotar; Vladimir,10,0,34,24
1657432766758,MATH 197,001,091859,McAuley; Julian John,9999,0,9999,0
1657432766758,MATH 197,002,095566,Kedlaya; Kiran S.,9997,0,9999,2
1657432766758,MATH 197,003,095567,Xiao; Ming,9999,0,9999,0
1657432766758,MATH 197,004,095571,Perols; Johan Lars,9998,0,9999,1
1657432773826,COGS 9,A01,083615,Shannon; Kyle Michael,9,0,75,66
1657432779850,COGS 11,A01,083617,Boyle; Mary E. T.,22,0,48,26
1657432785874,COGS 13,A01,083071,Bastos; Amalia Pinkusfeld,11,0,71,60
1657432791900,COGS 14A,A01,092681,Semenuks; Arturs,5,1,100,95
1657432797924,COGS 14B,A01,083073,Cheng; Tzu-Han,6,0,63,57
1657432803948,COGS 17,A01,092677,Semenuks; Arturs,6,0,81,75
1657432809974,COGS 100,A01,083619,Allen; Michael Gordon,17,0,70,53
1657432815997,COGS 101A,A01,083621,Davis; Joshua Daniel,9,0,68,59
1657432822020,COGS 101B,A01,091572,Allen; Michael Gordon,12,0,65,53
1657432828042,COGS 101C,A01,083625,Delgado; Tania,17,0,35,18
1657432834066,COGS 107A,A01,083627,Boyle; Mary E. T.,13,0,60,47
1657432840091,COGS 118A,A01,083075,Gupta; Anjum,21,0,76,55
1657432846123,CSE 3,A50,083646,Miranda; Gregory Joseph,24,0,50,26
1657432852226,CSE 8A,A50,083650,Miranda; Gregory Joseph,17,1,56,39
1657432858250,CSE 11,A01,083080,Cao; Yingjun,6,15,40,34
1657432864274,CSE 12,A01,083652,Krause-Levy; Sophia Louisa,28,1,120,92
1657432870297,CSE 15L,A01,083654,Morris; Justin Loren,9,0,50,41
1657432870297,CSE 15L,A02,083655,Morris; Justin Loren,9,0,50,41
1657432876320,CSE 20,A01,083657,Tran; Khoa Dang,39,0,80,41
1657432882345,CSE 21,A01,095574,Bach; Quang Tran,22,0,48,26
1657432888377,CSE 30,A01,083084,Eldon; John,5,0,80,75
1657432888377,CSE 30,B01,095061,Bhaskar; Nishant,9,0,50,41
1657432894400,CSE 100,A01,083659,Cao; Yingjun,5,4,70,65
1657432900432,CSE 134B,A01,083661,Powell; Thomas Allan,22,0,100,78
1657432906454,CSE 140,A01,083663,Gungor; Onat,15,0,85,70
1657432912477,CSE 140L,A01,083088,Eldon; John,21,0,100,79
1657432918504,CSE 175,A01,083665,Kumar; Rakesh,3,0,25,22
1657432924537,CSE 190,A00,092507,Dubnov; Shlomo,7,0,20,13
1657432930561,ECE 45,A01,083139,Congero; Spencer William,6,0,75,69
1657432936590,ECE 65,A50,083695,Saad; Andrew S,12,0,30,18
1657432936590,ECE 65,A51,095125,Saad; Andrew S,24,0,26,2
1657432942614,ECE 109,A01,091882,Touri; Behrouz,19,0,70,51
1657432948638,ECE 180,A00,083140,Abi Samra; Nicholas Camill,1,0,30,29
1657432948638,ECE 180,B00,083141,Abi Samra; Nicholas Camill,0,0,30,30
1657432954663,MATH 10A,A01,083735,Patchell; Gregory David,2,0,30,28
1657432954663,MATH 10A,A02,083736,Patchell; Gregory David,20,0,30,10
1657432954663,MATH 10A,A03,083737,Patchell; Gregory David,16,0,30,14
1657432960687,MATH 10B,A01,083207,Lim; Seonhee,8,0,34,26
1657432960687,MATH 10B,A02,083208,Lim; Seonhee,9,0,35,26
1657432960687,MATH 10B,A03,093472,Lim; Seonhee,7,0,34,27
1657432960687,MATH 10B,B01,083739,Sinha; Shubham,12,0,30,18
1657432966715,MATH 18,A01,083743,Cinel; Cameron Alexander,7,0,30,23
1657432966715,MATH 18,A02,083744,Cinel; Cameron Alexander,17,0,30,13
1657432966715,MATH 18,A03,083745,Cinel; Cameron Alexander,9,0,30,21
1657432966715,MATH 18,B01,083748,Rideout; David Porter,5,0,37,32
1657432966715,MATH 18,B02,083749,Rideout; David Porter,5,0,36,31
1657432966715,MATH 18,B03,083750,Rideout; David Porter,3,0,37,34
1657432966715,MATH 18,B04,083751,Rideout; David Porter,6,0,36,30
1657432966715,MATH 18,B05,093473,Rideout; David Porter,6,0,36,30
1657432966715,MATH 18,B06,093474,Rideout; David Porter,6,0,36,30
1657432972741,MATH 20A,A01,083754,Zheng; Zequn,14,0,40,26
1657432978775,MATH 20B,A01,083756,Briones; Jor-el Thomas Caparas,4,0,36,32
1657432978775,MATH 20B,A02,083757,Briones; Jor-el Thomas Caparas,1,0,36,35
1657432978775,MATH 20B,A03,093475,Briones; Jor-el Thomas Caparas,2,0,36,34
1657432984797,MATH 20C,A01,083760,Briones; Jor-el Thomas Caparas,1,0,35,34
1657432984797,MATH 20C,A02,083761,Briones; Jor-el Thomas Caparas,8,0,35,27
1657432984797,MATH 20C,A03,093476,Briones; Jor-el Thomas Caparas,0,1,36,36
1657432984797,MATH 20C,B01,083762,Bach; Quang Tran,1,0,30,29
1657432990826,MATH 20D,A01,083765,Tran; Brian Kha,5,0,30,25
1657432990826,MATH 20D,A02,083766,Tran; Brian Kha,5,0,30,25
1657432990826,MATH 20D,A03,083767,Tran; Brian Kha,5,0,30,25
1657432996850,MATH 20E,A01,083771,Ganguly; Soumya,9,0,32,23
1657432996850,MATH 20E,A02,083772,Ganguly; Soumya,6,0,32,26
1657432996850,MATH 20E,B01,083773,Ciotti; Benjamin,20,0,35,15
1657432996850,MATH 20E,B02,083774,Ciotti; Benjamin,17,0,35,18
1657433002873,MATH 103A,A01,083777,Greenfeld; Be'Eri,3,0,36,33
1657433002873,MATH 103A,A02,083778,Greenfeld; Be'Eri,5,0,36,31
1657433002873,MATH 103A,A03,093561,Greenfeld; Be'Eri,5,0,36,31
1657433002873,MATH 103A,B01,083779,Greenfeld; Be'Eri,7,0,36,29
1657433002873,MATH 103A,B02,083780,Greenfeld; Be'Eri,4,0,36,32
1657433002873,MATH 103A,B03,093562,Greenfeld; Be'Eri,3,0,36,33
1657433008896,MATH 105,A01,085443,Carter; Anne Toulson,15,0,35,20
1657433008896,MATH 105,A02,093477,Carter; Anne Toulson,20,0,35,15
1657433014925,MATH 109,A01,083213,Ganzberger; Geoffrey Michael,2,0,34,32
1657433014925,MATH 109,A02,083214,Ganzberger; Geoffrey Michael,4,0,34,30
1657433014925,MATH 109,A03,093478,Ganzberger; Geoffrey Michael,2,0,34,32
1657433014925,MATH 109,B01,083215,Ganzberger; Geoffrey Michael,1,0,32,31
1657433014925,MATH 109,B02,083216,Ganzberger; Geoffrey Michael,2,0,32,30
1657433014925,MATH 109,B03,093479,Ganzberger; Geoffrey Michael,8,0,32,24
1657433020950,MATH 142A,A01,083219,Chow; Bennett,7,0,32,25
1657433020950,MATH 142A,A02,083220,Chow; Bennett,10,0,32,22
1657433020950,MATH 142A,A03,093480,Chow; Bennett,8,0,32,24
1657433020950,MATH 142A,B03,093481,Chow; Bennett,8,0,32,24
1657433020950,MATH 142A,B04,093558,Chow; Bennett,13,0,32,19
1657433020950,MATH 142A,B05,093559,Chow; Bennett,6,0,32,26
1657433026990,MATH 193A,A01,083224,Rotar; Vladimir,8,0,34,26
1657433026990,MATH 193A,A02,083225,Rotar; Vladimir,9,0,34,25
1657433026990,MATH 193A,A03,083781,Rotar; Vladimir,5,0,34,29
1657433026990,MATH 193A,A04,083782,Rotar; Vladimir,10,0,34,24
1657433026990,MATH 193A,A05,093482,Rotar; Vladimir,10,0,34,24
1657433033016,MATH 197,001,091859,McAuley; Julian John,9999,0,9999,0
1657433033016,MATH 197,002,095566,Kedlaya; Kiran S.,9997,0,9999,2
1657433033016,MATH 197,003,095567,Xiao; Ming,9999,0,9999,0
1657433033016,MATH 197,004,095571,Perols; Johan Lars,9998,0,9999,1
1657433040083,COGS 9,A01,083615,Shannon; Kyle Michael,9,0,75,66
1657433046107,COGS 11,A01,083617,Boyle; Mary E. T.,22,0,48,26
1657433052132,COGS 13,A01,083071,Bastos; Amalia Pinkusfeld,11,0,71,60
1657433058158,COGS 14A,A01,092681,Semenuks; Arturs,5,1,100,95
1657433064185,COGS 14B,A01,083073,Cheng; Tzu-Han,6,0,63,57
1657433070211,COGS 17,A01,092677,Semenuks; Arturs,6,0,81,75
1657433076237,COGS 100,A01,083619,Allen; Michael Gordon,17,0,70,53
1657433082270,COGS 101A,A01,083621,Davis; Joshua Daniel,9,0,68,59
1657433088305,COGS 101B,A01,091572,Allen; Michael Gordon,12,0,65,53
1657433094329,COGS 101C,A01,083625,Delgado; Tania,17,0,35,18
1657433100352,COGS 107A,A01,083627,Boyle; Mary E. T.,13,0,60,47
1657433106375,COGS 118A,A01,083075,Gupta; Anjum,21,0,76,55
1657433112403,CSE 3,A50,083646,Miranda; Gregory Joseph,24,0,50,26
1657433118429,CSE 8A,A50,083650,Miranda; Gregory Joseph,17,1,56,39
1657433124461,CSE 11,A01,083080,Cao; Yingjun,6,15,40,34
1657433130495,CSE 12,A01,083652,Krause-Levy; Sophia Louisa,28,1,120,92
1657433136519,CSE 15L,A01,083654,Morris; Justin Loren,9,0,50,41
1657433136519,CSE 15L,A02,083655,Morris; Justin Loren,9,0,50,41
1657433142551,CSE 20,A01,083657,Tran; Khoa Dang,39,0,80,41
1657433148577,CSE 21,A01,095574,Bach; Quang Tran,22,0,48,26
1657433154606,CSE 30,A01,083084,Eldon; John,5,0,80,75
1657433154606,CSE 30,B01,095061,Bhaskar; Nishant,9,0,50,41
1657433160633,CSE 100,A01,083659,Cao; Yingjun,5,4,70,65
1657433166670,CSE 134B,A01,083661,Powell; Thomas Allan,22,0,100,78
1657433172699,CSE 140,A01,083663,Gungor; Onat,15,0,85,70
1657433178726,CSE 140L,A01,083088,Eldon; John,21,0,100,79
1657433184751,CSE 175,A01,083665,Kumar; Rakesh,3,0,25,22
1657433190774,CSE 190,A00,092507,Dubnov; Shlomo,7,0,20,13
1657433196798,ECE 45,A01,083139,Congero; Spencer William,6,0,75,69
1657433202823,ECE 65,A50,083695,Saad; Andrew S,12,0,30,18
1657433202823,ECE 65,A51,095125,Saad; Andrew S,24,0,26,2
1657433208849,ECE 109,A01,091882,Touri; Behrouz,19,0,70,51
1657433214879,ECE 180,A00,083140,Abi Samra; Nicholas Camill,1,0,30,29
1657433214879,ECE 180,B00,083141,Abi Samra; Nicholas Camill,0,0,30,30
1657433220902,MATH 10A,A01,083735,Patchell; Gregory David,2,0,30,28
1657433220902,MATH 10A,A02,083736,Patchell; Gregory David,20,0,30,10
1657433220902,MATH 10A,A03,083737,Patchell; Gregory David,16,0,30,14
1657433226925,MATH 10B,A01,083207,Lim; Seonhee,8,0,34,26
1657433226925,MATH 10B,A02,083208,Lim; Seonhee,9,0,35,26
1657433226925,MATH 10B,A03,093472,Lim; Seonhee,7,0,34,27
1657433226925,MATH 10B,B01,083739,Sinha; Shubham,12,0,30,18
1657433232957,MATH 18,A01,083743,Cinel; Cameron Alexander,7,0,30,23
1657433232957,MATH 18,A02,083744,Cinel; Cameron Alexander,17,0,30,13
1657433232957,MATH 18,A03,083745,Cinel; Cameron Alexander,9,0,30,21
1657433232957,MATH 18,B01,083748,Rideout; David Porter,5,0,37,32
1657433232957,MATH 18,B02,083749,Rideout; David Porter,5,0,36,31
1657433232957,MATH 18,B03,083750,Rideout; David Porter,3,0,37,34
1657433232957,MATH 18,B04,083751,Rideout; David Porter,6,0,36,30
1657433232957,MATH 18,B05,093473,Rideout; David Porter,6,0,36,30
1657433232957,MATH 18,B06,093474,Rideout; David Porter,6,0,36,30
1657433238984,MATH 20A,A01,083754,Zheng; Zequn,14,0,40,26
1657433245012,MATH 20B,A01,083756,Briones; Jor-el Thomas Caparas,4,0,36,32
1657433245012,MATH 20B,A02,083757,Briones; Jor-el Thomas Caparas,1,0,36,35
1657433245012,MATH 20B,A03,093475,Briones; Jor-el Thomas Caparas,2,0,36,34
1657433251040,MATH 20C,A01,083760,Briones; Jor-el Thomas Caparas,1,0,35,34
1657433251040,MATH 20C,A02,083761,Briones; Jor-el Thomas Caparas,8,0,35,27
1657433251040,MATH 20C,A03,093476,Briones; Jor-el Thomas Caparas,0,1,36,36
1657433251040,MATH 20C,B01,083762,Bach; Quang Tran,1,0,30,29
1657433257069,MATH 20D,A01,083765,Tran; Brian Kha,5,0,30,25
1657433257069,MATH 20D,A02,083766,Tran; Brian Kha,5,0,30,25
1657433257069,MATH 20D,A03,083767,Tran; Brian Kha,5,0,30,25
1657433263094,MATH 20E,A01,083771,Ganguly; Soumya,9,0,32,23
1657433263094,MATH 20E,A02,083772,Ganguly; Soumya,6,0,32,26
1657433263094,MATH 20E,B01,083773,Ciotti; Benjamin,20,0,35,15
1657433263094,MATH 20E,B02,083774,Ciotti; Benjamin,17,0,35,18
1657433269118,MATH 103A,A01,083777,Greenfeld; Be'Eri,3,0,36,33
1657433269118,MATH 103A,A02,083778,Greenfeld; Be'Eri,5,0,36,31
1657433269118,MATH 103A,A03,093561,Greenfeld; Be'Eri,5,0,36,31
1657433269118,MATH 103A,B01,083779,Greenfeld; Be'Eri,7,0,36,29
1657433269118,MATH 103A,B02,083780,Greenfeld; Be'Eri,4,0,36,32
1657433269118,MATH 103A,B03,093562,Greenfeld; Be'Eri,3,0,36,33
1657433275146,MATH 105,A01,085443,Carter; Anne Toulson,15,0,35,20
1657433275146,MATH 105,A02,093477,Carter; Anne Toulson,20,0,35,15
1657433281177,MATH 109,A01,083213,Ganzberger; Geoffrey Michael,2,0,34,32
1657433281177,MATH 109,A02,083214,Ganzberger; Geoffrey Michael,4,0,34,30
1657433281177,MATH 109,A03,093478,Ganzberger; Geoffrey Michael,2,0,34,32
1657433281177,MATH 109,B01,083215,Ganzberger; Geoffrey Michael,1,0,32,31
1657433281177,MATH 109,B02,083216,Ganzberger; Geoffrey Michael,2,0,32,30
1657433281177,MATH 109,B03,093479,Ganzberger; Geoffrey Michael,8,0,32,24
1657433287206,MATH 142A,A01,083219,Chow; Bennett,7,0,32,25
1657433287206,MATH 142A,A02,083220,Chow; Bennett,10,0,32,22
1657433287206,MATH 142A,A03,093480,Chow; Bennett,8,0,32,24
1657433287206,MATH 142A,B03,093481,Chow; Bennett,8,0,32,24
1657433287206,MATH 142A,B04,093558,Chow; Bennett,13,0,32,19
1657433287206,MATH 142A,B05,093559,Chow; Bennett,6,0,32,26
1657433293230,MATH 193A,A01,083224,Rotar; Vladimir,8,0,34,26
1657433293230,MATH 193A,A02,083225,Rotar; Vladimir,9,0,34,25
1657433293230,MATH 193A,A03,083781,Rotar; Vladimir,5,0,34,29
1657433293230,MATH 193A,A04,083782,Rotar; Vladimir,10,0,34,24
1657433293230,MATH 193A,A05,093482,Rotar; Vladimir,10,0,34,24
1657433299259,MATH 197,001,091859,McAuley; Julian John,9999,0,9999,0
1657433299259,MATH 197,002,095566,Kedlaya; Kiran S.,9997,0,9999,2
1657433299259,MATH 197,003,095567,Xiao; Ming,9999,0,9999,0
1657433299259,MATH 197,004,095571,Perols; Johan Lars,9998,0,9999,1
1657433306319,COGS 9,A01,083615,Shannon; Kyle Michael,9,0,75,66
1657433312362,COGS 11,A01,083617,Boyle; Mary E. T.,22,0,48,26
1657433318389,COGS 13,A01,083071,Bastos; Amalia Pinkusfeld,11,0,71,60
1657433324416,COGS 14A,A01,092681,Semenuks; Arturs,5,1,100,95
1657433330441,COGS 14B,A01,083073,Cheng; Tzu-Han,6,0,63,57
1657433336467,COGS 17,A01,092677,Semenuks; Arturs,6,0,81,75
1657433342512,COGS 100,A01,083619,Allen; Michael Gordon,17,0,70,53
1657433348539,COGS 101A,A01,083621,Davis; Joshua Daniel,9,0,68,59
1657433354567,COGS 101B,A01,091572,Allen; Michael Gordon,12,0,65,53
1657433360590,COGS 101C,A01,083625,Delgado; Tania,17,0,35,18
1657433366617,COGS 107A,A01,083627,Boyle; Mary E. T.,13,0,60,47
1657433372644,COGS 118A,A01,083075,Gupta; Anjum,21,0,76,55
1657433378679,CSE 3,A50,083646,Miranda; Gregory Joseph,24,0,50,26
1657433384713,CSE 8A,A50,083650,Miranda; Gregory Joseph,17,1,56,39
1657433390748,CSE 11,A01,083080,Cao; Yingjun,6,15,40,34
1657433396776,CSE 12,A01,083652,Krause-Levy; Sophia Louisa,28,1,120,92
1657433402804,CSE 15L,A01,083654,Morris; Justin Loren,9,0,50,41
1657433402804,CSE 15L,A02,083655,Morris; Justin Loren,9,0,50,41
1657433408837,CSE 20,A01,083657,Tran; Khoa Dang,39,0,80,41
1657433414864,CSE 21,A01,095574,Bach; Quang Tran,22,0,48,26
1657433420891,CSE 30,A01,083084,Eldon; John,5,0,80,75
1657433420891,CSE 30,B01,095061,Bhaskar; Nishant,9,0,50,41
1657433426915,CSE 100,A01,083659,Cao; Yingjun,5,4,70,65
1657433432942,CSE 134B,A01,083661,Powell; Thomas Allan,22,0,100,78
1657433438968,CSE 140,A01,083663,Gungor; Onat,15,0,85,70
1657433444994,CSE 140L,A01,083088,Eldon; John,21,0,100,79
1657433451096,CSE 175,A01,083665,Kumar; Rakesh,3,0,25,22
1657433457119,CSE 190,A00,092507,Dubnov; Shlomo,7,0,20,13
1657433463143,ECE 45,A01,083139,Congero; Spencer William,6,0,75,69
1657433469166,ECE 65,A50,083695,Saad; Andrew S,12,0,30,18
1657433469166,ECE 65,A51,095125,Saad; Andrew S,24,0,26,2
1657433475189,ECE 109,A01,091882,Touri; Behrouz,19,0,70,51
1657433481229,ECE 180,A00,083140,Abi Samra; Nicholas Camill,1,0,30,29
1657433481229,ECE 180,B00,083141,Abi Samra; Nicholas Camill,0,0,30,30
1657433487258,MATH 10A,A01,083735,Patchell; Gregory David,2,0,30,28
1657433487258,MATH 10A,A02,083736,Patchell; Gregory David,20,0,30,10
1657433487258,MATH 10A,A03,083737,Patchell; Gregory David,16,0,30,14
1657433493289,MATH 10B,A01,083207,Lim; Seonhee,8,0,34,26
1657433493289,MATH 10B,A02,083208,Lim; Seonhee,9,0,35,26
1657433493289,MATH 10B,A03,093472,Lim; Seonhee,7,0,34,27
1657433493289,MATH 10B,B01,083739,Sinha; Shubham,12,0,30,18
1657433499318,MATH 18,A01,083743,Cinel; Cameron Alexander,7,0,30,23
1657433499318,MATH 18,A02,083744,Cinel; Cameron Alexander,17,0,30,13
1657433499318,MATH 18,A03,083745,Cinel; Cameron Alexander,9,0,30,21
1657433499318,MATH 18,B01,083748,Rideout; David Porter,5,0,37,32
1657433499318,MATH 18,B02,083749,Rideout; David Porter,5,0,36,31
1657433499318,MATH 18,B03,083750,Rideout; David Porter,3,0,37,34
1657433499318,MATH 18,B04,083751,Rideout; David Porter,6,0,36,30
1657433499318,MATH 18,B05,093473,Rideout; David Porter,6,0,36,30
1657433499318,MATH 18,B06,093474,Rideout; David Porter,6,0,36,30
1657433505349,MATH 20A,A01,083754,Zheng; Zequn,14,0,40,26
1657433511372,MATH 20B,A01,083756,Briones; Jor-el Thomas Caparas,4,0,36,32
1657433511372,MATH 20B,A02,083757,Briones; Jor-el Thomas Caparas,1,0,36,35
1657433511372,MATH 20B,A03,093475,Briones; Jor-el Thomas Caparas,2,0,36,34
1657433517395,MATH 20C,A01,083760,Briones; Jor-el Thomas Caparas,1,0,35,34
1657433517395,MATH 20C,A02,083761,Briones; Jor-el Thomas Caparas,8,0,35,27
1657433517395,MATH 20C,A03,093476,Briones; Jor-el Thomas Caparas,0,1,36,36
1657433517395,MATH 20C,B01,083762,Bach; Quang Tran,1,0,30,29
1657433523424,MATH 20D,A01,083765,Tran; Brian Kha,5,0,30,25
1657433523424,MATH 20D,A02,083766,Tran; Brian Kha,5,0,30,25
1657433523424,MATH 20D,A03,083767,Tran; Brian Kha,5,0,30,25
1657433529462,MATH 20E,A01,083771,Ganguly; Soumya,9,0,32,23
1657433529462,MATH 20E,A02,083772,Ganguly; Soumya,6,0,32,26
1657433529462,MATH 20E,B01,083773,Ciotti; Benjamin,20,0,35,15
1657433529462,MATH 20E,B02,083774,Ciotti; Benjamin,17,0,35,18
1657433535497,MATH 103A,A01,083777,Greenfeld; Be'Eri,3,0,36,33
1657433535497,MATH 103A,A02,083778,Greenfeld; Be'Eri,5,0,36,31
1657433535497,MATH 103A,A03,093561,Greenfeld; Be'Eri,5,0,36,31
1657433535497,MATH 103A,B01,083779,Greenfeld; Be'Eri,7,0,36,29
1657433535497,MATH 103A,B02,083780,Greenfeld; Be'Eri,4,0,36,32
1657433535497,MATH 103A,B03,093562,Greenfeld; Be'Eri,3,0,36,33
1657433541525,MATH 105,A01,085443,Carter; Anne Toulson,15,0,35,20
1657433541525,MATH 105,A02,093477,Carter; Anne Toulson,20,0,35,15
1657433547548,MATH 109,A01,083213,Ganzberger; Geoffrey Michael,2,0,34,32
1657433547548,MATH 109,A02,083214,Ganzberger; Geoffrey Michael,4,0,34,30
1657433547548,MATH 109,A03,093478,Ganzberger; Geoffrey Michael,2,0,34,32
1657433547548,MATH 109,B01,083215,Ganzberger; Geoffrey Michael,1,0,32,31
1657433547548,MATH 109,B02,083216,Ganzberger; Geoffrey Michael,2,0,32,30
1657433547548,MATH 109,B03,093479,Ganzberger; Geoffrey Michael,8,0,32,24
1657433553572,MATH 142A,A01,083219,Chow; Bennett,7,0,32,25
1657433553572,MATH 142A,A02,083220,Chow; Bennett,10,0,32,22
1657433553572,MATH 142A,A03,093480,Chow; Bennett,8,0,32,24
1657433553572,MATH 142A,B03,093481,Chow; Bennett,8,0,32,24
1657433553572,MATH 142A,B04,093558,Chow; Bennett,13,0,32,19
1657433553572,MATH 142A,B05,093559,Chow; Bennett,6,0,32,26
1657433559596,MATH 193A,A01,083224,Rotar; Vladimir,8,0,34,26
1657433559596,MATH 193A,A02,083225,Rotar; Vladimir,9,0,34,25
1657433559596,MATH 193A,A03,083781,Rotar; Vladimir,5,0,34,29
1657433559596,MATH 193A,A04,083782,Rotar; Vladimir,10,0,34,24
1657433559596,MATH 193A,A05,093482,Rotar; Vladimir,10,0,34,24
1657433565619,MATH 197,001,091859,McAuley; Julian John,9999,0,9999,0
1657433565619,MATH 197,002,095566,Kedlaya; Kiran S.,9997,0,9999,2
1657433565619,MATH 197,003,095567,Xiao; Ming,9999,0,9999,0
1657433565619,MATH 197,004,095571,Perols; Johan Lars,9998,0,9999,1
1657433572689,COGS 9,A01,083615,Shannon; Kyle Michael,9,0,75,66
1657433578713,COGS 11,A01,083617,Boyle; Mary E. T.,22,0,48,26
1657433584746,COGS 13,A01,083071,Bastos; Amalia Pinkusfeld,11,0,71,60
1657433590769,COGS 14A,A01,092681,Semenuks; Arturs,5,1,100,95
1657433596791,COGS 14B,A01,083073,Cheng; Tzu-Han,6,0,63,57
1657433602814,COGS 17,A01,092677,Semenuks; Arturs,6,0,81,75
1657433608844,COGS 100,A01,083619,Allen; Michael Gordon,17,0,70,53
1657433614880,COGS 101A,A01,083621,Davis; Joshua Daniel,9,0,68,59
1657433620906,COGS 101B,A01,091572,Allen; Michael Gordon,12,0,65,53
1657433626930,COGS 101C,A01,083625,Delgado; Tania,17,0,35,18
1657433632960,COGS 107A,A01,083627,Boyle; Mary E. T.,13,0,60,47
1657433638983,COGS 118A,A01,083075,Gupta; Anjum,21,0,76,55
1657433645016,CSE 3,A50,083646,Miranda; Gregory Joseph,24,0,50,26
1657433651043,CSE 8A,A50,083650,Miranda; Gregory Joseph,17,1,56,39
1657433657066,CSE 11,A01,083080,Cao; Yingjun,6,15,40,34
1657433663095,CSE 12,A01,083652,Krause-Levy; Sophia Louisa,28,1,120,92
1657433669118,CSE 15L,A01,083654,Morris; Justin Loren,9,0,50,41
1657433669118,CSE 15L,A02,083655,Morris; Justin Loren,9,0,50,41
1657433675142,CSE 20,A01,083657,Tran; Khoa Dang,39,0,80,41
1657433681166,CSE 21,A01,095574,Bach; Quang Tran,22,0,48,26
1657433687195,CSE 30,A01,083084,Eldon; John,5,0,80,75
1657433687195,CSE 30,B01,095061,Bhaskar; Nishant,9,0,50,41
1657433693219,CSE 100,A01,083659,Cao; Yingjun,5,4,70,65
1657433699246,CSE 134B,A01,083661,Powell; Thomas Allan,22,0,100,78
1657433705274,CSE 140,A01,083663,Gungor; Onat,15,0,85,70
1657433711299,CSE 140L,A01,083088,Eldon; John,21,0,100,79
1657433717324,CSE 175,A01,083665,Kumar; Rakesh,3,0,25,22
1657433723350,CSE 190,A00,092507,Dubnov; Shlomo,7,0,20,13
1657433729373,ECE 45,A01,083139,Congero; Spencer William,6,0,75,69
1657433735399,ECE 65,A50,083695,Saad; Andrew S,12,0,30,18
1657433735399,ECE 65,A51,095125,Saad; Andrew S,24,0,26,2
1657433741422,ECE 109,A01,091882,Touri; Behrouz,19,0,70,51
1657433747443,ECE 180,A00,083140,Abi Samra; Nicholas Camill,1,0,30,29
1657433747443,ECE 180,B00,083141,Abi Samra; Nicholas Camill,0,0,30,30
1657433753470,MATH 10A,A01,083735,Patchell; Gregory David,2,0,30,28
1657433753470,MATH 10A,A02,083736,Patchell; Gregory David,20,0,30,10
1657433753470,MATH 10A,A03,083737,Patchell; Gregory David,16,0,30,14
1657433759494,MATH 10B,A01,083207,Lim; Seonhee,8,0,34,26
1657433759494,MATH 10B,A02,083208,Lim; Seonhee,9,0,35,26
1657433759494,MATH 10B,A03,093472,Lim; Seonhee,7,0,34,27
1657433759494,MATH 10B,B01,083739,Sinha; Shubham,12,0,30,18
1657433765520,MATH 18,A01,083743,Cinel; Cameron Alexander,7,0,30,23
1657433765520,MATH 18,A02,083744,Cinel; Cameron Alexander,17,0,30,13
1657433765520,MATH 18,A03,083745,Cinel; Cameron Alexander,9,0,30,21
1657433765520,MATH 18,B01,083748,Rideout; David Porter,5,0,37,32
1657433765520,MATH 18,B02,083749,Rideout; David Porter,5,0,36,31
1657433765520,MATH 18,B03,083750,Rideout; David Porter,3,0,37,34
1657433765520,MATH 18,B04,083751,Rideout; David Porter,6,0,36,30
1657433765520,MATH 18,B05,093473,Rideout; David Porter,6,0,36,30
1657433765520,MATH 18,B06,093474,Rideout; David Porter,6,0,36,30
1657433771544,MATH 20A,A01,083754,Zheng; Zequn,14,0,40,26
1657433777568,MATH 20B,A01,083756,Briones; Jor-el Thomas Caparas,4,0,36,32
1657433777568,MATH 20B,A02,083757,Briones; Jor-el Thomas Caparas,1,0,36,35
1657433777568,MATH 20B,A03,093475,Briones; Jor-el Thomas Caparas,2,0,36,34
1657433783591,MATH 20C,A01,083760,Briones; Jor-el Thomas Caparas,1,0,35,34
1657433783591,MATH 20C,A02,083761,Briones; Jor-el Thomas Caparas,8,0,35,27
1657433783591,MATH 20C,A03,093476,Briones; Jor-el Thomas Caparas,0,1,36,36
1657433783591,MATH 20C,B01,083762,Bach; Quang Tran,1,0,30,29
1657433789616,MATH 20D,A01,083765,Tran; Brian Kha,5,0,30,25
1657433789616,MATH 20D,A02,083766,Tran; Brian Kha,5,0,30,25
1657433789616,MATH 20D,A03,083767,Tran; Brian Kha,5,0,30,25
1657433795638,MATH 20E,A01,083771,Ganguly; Soumya,9,0,32,23
1657433795638,MATH 20E,A02,083772,Ganguly; Soumya,6,0,32,26
1657433795638,MATH 20E,B01,083773,Ciotti; Benjamin,20,0,35,15
1657433795638,MATH 20E,B02,083774,Ciotti; Benjamin,17,0,35,18
1657433801670,MATH 103A,A01,083777,Greenfeld; Be'Eri,3,0,36,33
1657433801670,MATH 103A,A02,083778,Greenfeld; Be'Eri,5,0,36,31
1657433801670,MATH 103A,A03,093561,Greenfeld; Be'Eri,5,0,36,31
1657433801670,MATH 103A,B01,083779,Greenfeld; Be'Eri,7,0,36,29
1657433801670,MATH 103A,B02,083780,Greenfeld; Be'Eri,4,0,36,32
1657433801670,MATH 103A,B03,093562,Greenfeld; Be'Eri,3,0,36,33
1657433807694,MATH 105,A01,085443,Carter; Anne Toulson,15,0,35,20
1657433807694,MATH 105,A02,093477,Carter; Anne Toulson,20,0,35,15
1657433813727,MATH 109,A01,083213,Ganzberger; Geoffrey Michael,2,0,34,32
1657433813727,MATH 109,A02,083214,Ganzberger; Geoffrey Michael,4,0,34,30
1657433813727,MATH 109,A03,093478,Ganzberger; Geoffrey Michael,2,0,34,32
1657433813727,MATH 109,B01,083215,Ganzberger; Geoffrey Michael,1,0,32,31
1657433813727,MATH 109,B02,083216,Ganzberger; Geoffrey Michael,2,0,32,30
1657433813727,MATH 109,B03,093479,Ganzberger; Geoffrey Michael,8,0,32,24
1657433819751,MATH 142A,A01,083219,Chow; Bennett,7,0,32,25
1657433819751,MATH 142A,A02,083220,Chow; Bennett,10,0,32,22
1657433819751,MATH 142A,A03,093480,Chow; Bennett,8,0,32,24
1657433819751,MATH 142A,B03,093481,Chow; Bennett,8,0,32,24
1657433819751,MATH 142A,B04,093558,Chow; Bennett,13,0,32,19
1657433819751,MATH 142A,B05,093559,Chow; Bennett,6,0,32,26
1657433825774,MATH 193A,A01,083224,Rotar; Vladimir,8,0,34,26
1657433825774,MATH 193A,A02,083225,Rotar; Vladimir,9,0,34,25
1657433825774,MATH 193A,A03,083781,Rotar; Vladimir,5,0,34,29
1657433825774,MATH 193A,A04,083782,Rotar; Vladimir,10,0,34,24
1657433825774,MATH 193A,A05,093482,Rotar; Vladimir,10,0,34,24
1657433831799,MATH 197,001,091859,McAuley; Julian John,9999,0,9999,0
1657433831799,MATH 197,002,095566,Kedlaya; Kiran S.,9997,0,9999,2
1657433831799,MATH 197,003,095567,Xiao; Ming,9999,0,9999,0
1657433831799,MATH 197,004,095571,Perols; Johan Lars,9998,0,9999,1
1657433838851,COGS 9,A01,083615,Shannon; Kyle Michael,9,0,75,66
1657433844878,COGS 11,A01,083617,Boyle; Mary E. T.,22,0,48,26
1657433850901,COGS 13,A01,083071,Bastos; Amalia Pinkusfeld,11,0,71,60
1657433856925,COGS 14A,A01,092681,Semenuks; Arturs,5,1,100,95
1657433862952,COGS 14B,A01,083073,Cheng; Tzu-Han,6,0,63,57
1657433868976,COGS 17,A01,092677,Semenuks; Arturs,6,0,81,75
1657433875004,COGS 100,A01,083619,Allen; Michael Gordon,17,0,70,53
1657433881032,COGS 101A,A01,083621,Davis; Joshua Daniel,9,0,68,59
1657433887058,COGS 101B,A01,091572,Allen; Michael Gordon,12,0,65,53
1657433893085,COGS 101C,A01,083625,Delgado; Tania,17,0,35,18
1657433899108,COGS 107A,A01,083627,Boyle; Mary E. T.,13,0,60,47
1657433905161,COGS 118A,A01,083075,Gupta; Anjum,21,0,76,55
1657433911191,CSE 3,A50,083646,Miranda; Gregory Joseph,24,0,50,26
1657433917220,CSE 8A,A50,083650,Miranda; Gregory Joseph,17,1,56,39
1657433923243,CSE 11,A01,083080,Cao; Yingjun,6,15,40,34
1657433929268,CSE 12,A01,083652,Krause-Levy; Sophia Louisa,28,1,120,92
1657433935291,CSE 15L,A01,083654,Morris; Justin Loren,9,0,50,41
1657433935291,CSE 15L,A02,083655,Morris; Justin Loren,9,0,50,41
1657433941315,CSE 20,A01,083657,Tran; Khoa Dang,39,0,80,41
1657433947342,CSE 21,A01,095574,Bach; Quang Tran,22,0,48,26
1657433953368,CSE 30,A01,083084,Eldon; John,5,0,80,75
1657433953368,CSE 30,B01,095061,Bhaskar; Nishant,9,0,50,41
1657433959395,CSE 100,A01,083659,Cao; Yingjun,5,4,70,65
1657433965422,CSE 134B,A01,083661,Powell; Thomas Allan,22,0,100,78
1657433971445,CSE 140,A01,083663,Gungor; Onat,15,0,85,70
1657433977466,CSE 140L,A01,083088,Eldon; John,21,0,100,79
1657433983488,CSE 175,A01,083665,Kumar; Rakesh,3,0,25,22
1657433989511,CSE 190,A00,092507,Dubnov; Shlomo,7,0,20,13
1657433995540,ECE 45,A01,083139,Congero; Spencer William,6,0,75,69
1657434001564,ECE 65,A50,083695,Saad; Andrew S,12,0,30,18
1657434001564,ECE 65,A51,095125,Saad; Andrew S,24,0,26,2
1657434007588,ECE 109,A01,091882,Touri; Behrouz,19,0,70,51
1657434013610,ECE 180,A00,083140,Abi Samra; Nicholas Camill,1,0,30,29
1657434013610,ECE 180,B00,083141,Abi Samra; Nicholas Camill,0,0,30,30
1657434019638,MATH 10A,A01,083735,Patchell; Gregory David,2,0,30,28
1657434019638,MATH 10A,A02,083736,Patchell; Gregory David,20,0,30,10
1657434019638,MATH 10A,A03,083737,Patchell; Gregory David,16,0,30,14
1657434025661,MATH 10B,A01,083207,Lim; Seonhee,8,0,34,26
1657434025661,MATH 10B,A02,083208,Lim; Seonhee,9,0,35,26
1657434025661,MATH 10B,A03,093472,Lim; Seonhee,7,0,34,27
1657434025661,MATH 10B,B01,083739,Sinha; Shubham,12,0,30,18
1657434031686,MATH 18,A01,083743,Cinel; Cameron Alexander,7,0,30,23
1657434031686,MATH 18,A02,083744,Cinel; Cameron Alexander,17,0,30,13
1657434031686,MATH 18,A03,083745,Cinel; Cameron Alexander,9,0,30,21
1657434031686,MATH 18,B01,083748,Rideout; David Porter,5,0,37,32
1657434031686,MATH 18,B02,083749,Rideout; David Porter,5,0,36,31
1657434031686,MATH 18,B03,083750,Rideout; David Porter,3,0,37,34
1657434031686,MATH 18,B04,083751,Rideout; David Porter,6,0,36,30
1657434031686,MATH 18,B05,093473,Rideout; David Porter,6,0,36,30
1657434031686,MATH 18,B06,093474,Rideout; David Porter,6,0,36,30
1657434037709,MATH 20A,A01,083754,Zheng; Zequn,14,0,40,26
1657434043732,MATH 20B,A01,083756,Briones; Jor-el Thomas Caparas,4,0,36,32
1657434043732,MATH 20B,A02,083757,Briones; Jor-el Thomas Caparas,1,0,36,35
1657434043732,MATH 20B,A03,093475,Briones; Jor-el Thomas Caparas,2,0,36,34
1657434049843,MATH 20C,A01,083760,Briones; Jor-el Thomas Caparas,1,0,35,34
1657434049843,MATH 20C,A02,083761,Briones; Jor-el Thomas Caparas,8,0,35,27
1657434049843,MATH 20C,A03,093476,Briones; Jor-el Thomas Caparas,0,1,36,36
1657434049843,MATH 20C,B01,083762,Bach; Quang Tran,1,0,30,29
1657434055870,MATH 20D,A01,083765,Tran; Brian Kha,5,0,30,25
1657434055870,MATH 20D,A02,083766,Tran; Brian Kha,5,0,30,25
1657434055870,MATH 20D,A03,083767,Tran; Brian Kha,5,0,30,25
1657434061892,MATH 20E,A01,083771,Ganguly; Soumya,9,0,32,23
1657434061892,MATH 20E,A02,083772,Ganguly; Soumya,6,0,32,26
1657434061892,MATH 20E,B01,083773,Ciotti; Benjamin,20,0,35,15
1657434061892,MATH 20E,B02,083774,Ciotti; Benjamin,17,0,35,18
1657434067915,MATH 103A,A01,083777,Greenfeld; Be'Eri,3,0,36,33
1657434067915,MATH 103A,A02,083778,Greenfeld; Be'Eri,5,0,36,31
1657434067915,MATH 103A,A03,093561,Greenfeld; Be'Eri,5,0,36,31
1657434067915,MATH 103A,B01,083779,Greenfeld; Be'Eri,7,0,36,29
1657434067915,MATH 103A,B02,083780,Greenfeld; Be'Eri,4,0,36,32
1657434067915,MATH 103A,B03,093562,Greenfeld; Be'Eri,3,0,36,33
1657434073937,MATH 105,A01,085443,Carter; Anne Toulson,15,0,35,20
1657434073937,MATH 105,A02,093477,Carter; Anne Toulson,20,0,35,15
1657434079959,MATH 109,A01,083213,Ganzberger; Geoffrey Michael,2,0,34,32
1657434079959,MATH 109,A02,083214,Ganzberger; Geoffrey Michael,4,0,34,30
1657434079959,MATH 109,A03,093478,Ganzberger; Geoffrey Michael,2,0,34,32
1657434079959,MATH 109,B01,083215,Ganzberger; Geoffrey Michael,1,0,32,31
1657434079959,MATH 109,B02,083216,Ganzberger; Geoffrey Michael,2,0,32,30
1657434079959,MATH 109,B03,093479,Ganzberger; Geoffrey Michael,8,0,32,24
1657434085987,MATH 142A,A01,083219,Chow; Bennett,7,0,32,25
1657434085987,MATH 142A,A02,083220,Chow; Bennett,10,0,32,22
1657434085987,MATH 142A,A03,093480,Chow; Bennett,8,0,32,24
1657434085987,MATH 142A,B03,093481,Chow; Bennett,8,0,32,24
1657434085987,MATH 142A,B04,093558,Chow; Bennett,13,0,32,19
1657434085987,MATH 142A,B05,093559,Chow; Bennett,6,0,32,26
1657434092010,MATH 193A,A01,083224,Rotar; Vladimir,8,0,34,26
1657434092010,MATH 193A,A02,083225,Rotar; Vladimir,9,0,34,25
1657434092010,MATH 193A,A03,083781,Rotar; Vladimir,5,0,34,29
1657434092010,MATH 193A,A04,083782,Rotar; Vladimir,10,0,34,24
1657434092010,MATH 193A,A05,093482,Rotar; Vladimir,10,0,34,24
1657434098049,MATH 197,001,091859,McAuley; Julian John,9999,0,9999,0
1657434098049,MATH 197,002,095566,Kedlaya; Kiran S.,9997,0,9999,2
1657434098049,MATH 197,003,095567,Xiao; Ming,9999,0,9999,0
1657434098049,MATH 197,004,095571,Perols; Johan Lars,9998,0,9999,1
1657434105112,COGS 9,A01,083615,Shannon; Kyle Michael,9,0,75,66
1657434111153,COGS 11,A01,083617,Boyle; Mary E. T.,22,0,48,26
1657434117177,COGS 13,A01,083071,Bastos; Amalia Pinkusfeld,11,0,71,60
1657434123201,COGS 14A,A01,092681,Semenuks; Arturs,5,1,100,95
1657434129224,COGS 14B,A01,083073,Cheng; Tzu-Han,6,0,63,57
1657434135258,COGS 17,A01,092677,Semenuks; Arturs,6,0,81,75
1657434141283,COGS 100,A01,083619,Allen; Michael Gordon,17,0,70,53
1657434147306,COGS 101A,A01,083621,Davis; Joshua Daniel,9,0,68,59
1657434153332,COGS 101B,A01,091572,Allen; Michael Gordon,12,0,65,53
1657434159356,COGS 101C,A01,083625,Delgado; Tania,17,0,35,18
1657434165379,COGS 107A,A01,083627,Boyle; Mary E. T.,13,0,60,47
1657434171405,COGS 118A,A01,083075,Gupta; Anjum,21,0,76,55
1657434177429,CSE 3,A50,083646,Miranda; Gregory Joseph,24,0,50,26
1657434183453,CSE 8A,A50,083650,Miranda; Gregory Joseph,17,1,56,39
1657434189476,CSE 11,A01,083080,Cao; Yingjun,6,15,40,34
1657434195499,CSE 12,A01,083652,Krause-Levy; Sophia Louisa,28,1,120,92
1657434201525,CSE 15L,A01,083654,Morris; Justin Loren,9,0,50,41
1657434201525,CSE 15L,A02,083655,Morris; Justin Loren,9,0,50,41
1657434207549,CSE 20,A01,083657,Tran; Khoa Dang,39,0,80,41
1657434213572,CSE 21,A01,095574,Bach; Quang Tran,22,0,48,26
1657434219597,CSE 30,A01,083084,Eldon; John,5,0,80,75
1657434219597,CSE 30,B01,095061,Bhaskar; Nishant,9,0,50,41
1657434225620,CSE 100,A01,083659,Cao; Yingjun,5,4,70,65
1657434231642,CSE 134B,A01,083661,Powell; Thomas Allan,22,0,100,78
1657434237670,CSE 140,A01,083663,Gungor; Onat,15,0,85,70
1657434243700,CSE 140L,A01,083088,Eldon; John,21,0,100,79
1657434249724,CSE 175,A01,083665,Kumar; Rakesh,3,0,25,22
1657434255751,CSE 190,A00,092507,Dubnov; Shlomo,7,0,20,13
1657434261775,ECE 45,A01,083139,Congero; Spencer William,6,0,75,69
1657434267801,ECE 65,A50,083695,Saad; Andrew S,12,0,30,18
1657434267801,ECE 65,A51,095125,Saad; Andrew S,24,0,26,2
1657434273825,ECE 109,A01,091882,Touri; Behrouz,19,0,70,51
1657434279849,ECE 180,A00,083140,Abi Samra; Nicholas Camill,1,0,30,29
1657434279849,ECE 180,B00,083141,Abi Samra; Nicholas Camill,0,0,30,30
1657434285875,MATH 10A,A01,083735,Patchell; Gregory David,2,0,30,28
1657434285875,MATH 10A,A02,083736,Patchell; Gregory David,20,0,30,10
1657434285875,MATH 10A,A03,083737,Patchell; Gregory David,16,0,30,14
1657434291904,MATH 10B,A01,083207,Lim; Seonhee,8,0,34,26
1657434291904,MATH 10B,A02,083208,Lim; Seonhee,9,0,35,26
1657434291904,MATH 10B,A03,093472,Lim; Seonhee,7,0,34,27
1657434291904,MATH 10B,B01,083739,Sinha; Shubham,12,0,30,18
1657434297936,MATH 18,A01,083743,Cinel; Cameron Alexander,7,0,30,23
1657434297936,MATH 18,A02,083744,Cinel; Cameron Alexander,17,0,30,13
1657434297936,MATH 18,A03,083745,Cinel; Cameron Alexander,9,0,30,21
1657434297936,MATH 18,B01,083748,Rideout; David Porter,5,0,37,32
1657434297936,MATH 18,B02,083749,Rideout; David Porter,5,0,36,31
1657434297936,MATH 18,B03,083750,Rideout; David Porter,3,0,37,34
1657434297936,MATH 18,B04,083751,Rideout; David Porter,6,0,36,30
1657434297936,MATH 18,B05,093473,Rideout; David Porter,6,0,36,30
1657434297936,MATH 18,B06,093474,Rideout; David Porter,6,0,36,30
1657434303960,MATH 20A,A01,083754,Zheng; Zequn,14,0,40,26
1657434309986,MATH 20B,A01,083756,Briones; Jor-el Thomas Caparas,4,0,36,32
1657434309986,MATH 20B,A02,083757,Briones; Jor-el Thomas Caparas,1,0,36,35
1657434309986,MATH 20B,A03,093475,Briones; Jor-el Thomas Caparas,2,0,36,34
1657434316010,MATH 20C,A01,083760,Briones; Jor-el Thomas Caparas,1,0,35,34
1657434316010,MATH 20C,A02,083761,Briones; Jor-el Thomas Caparas,8,0,35,27
1657434316010,MATH 20C,A03,093476,Briones; Jor-el Thomas Caparas,0,1,36,36
1657434316010,MATH 20C,B01,083762,Bach; Quang Tran,1,0,30,29
1657434322035,MATH 20D,A01,083765,Tran; Brian Kha,5,0,30,25
1657434322035,MATH 20D,A02,083766,Tran; Brian Kha,5,0,30,25
1657434322035,MATH 20D,A03,083767,Tran; Brian Kha,5,0,30,25
1657434328058,MATH 20E,A01,083771,Ganguly; Soumya,9,0,32,23
1657434328058,MATH 20E,A02,083772,Ganguly; Soumya,6,0,32,26
1657434328058,MATH 20E,B01,083773,Ciotti; Benjamin,20,0,35,15
1657434328058,MATH 20E,B02,083774,Ciotti; Benjamin,17,0,35,18
1657434334084,MATH 103A,A01,083777,Greenfeld; Be'Eri,3,0,36,33
1657434334084,MATH 103A,A02,083778,Greenfeld; Be'Eri,5,0,36,31
1657434334084,MATH 103A,A03,093561,Greenfeld; Be'Eri,5,0,36,31
1657434334084,MATH 103A,B01,083779,Greenfeld; Be'Eri,7,0,36,29
1657434334084,MATH 103A,B02,083780,Greenfeld; Be'Eri,4,0,36,32
1657434334084,MATH 103A,B03,093562,Greenfeld; Be'Eri,3,0,36,33
1657434340106,MATH 105,A01,085443,Carter; Anne Toulson,15,0,35,20
1657434340106,MATH 105,A02,093477,Carter; Anne Toulson,20,0,35,15
1657434346129,MATH 109,A01,083213,Ganzberger; Geoffrey Michael,2,0,34,32
1657434346129,MATH 109,A02,083214,Ganzberger; Geoffrey Michael,4,0,34,30
1657434346129,MATH 109,A03,093478,Ganzberger; Geoffrey Michael,2,0,34,32
1657434346129,MATH 109,B01,083215,Ganzberger; Geoffrey Michael,1,0,32,31
1657434346129,MATH 109,B02,083216,Ganzberger; Geoffrey Michael,2,0,32,30
1657434346129,MATH 109,B03,093479,Ganzberger; Geoffrey Michael,8,0,32,24
1657434352154,MATH 142A,A01,083219,Chow; Bennett,7,0,32,25
1657434352154,MATH 142A,A02,083220,Chow; Bennett,10,0,32,22
1657434352154,MATH 142A,A03,093480,Chow; Bennett,8,0,32,24
1657434352154,MATH 142A,B03,093481,Chow; Bennett,8,0,32,24
1657434352154,MATH 142A,B04,093558,Chow; Bennett,13,0,32,19
1657434352154,MATH 142A,B05,093559,Chow; Bennett,6,0,32,26
1657434358181,MATH 193A,A01,083224,Rotar; Vladimir,8,0,34,26
1657434358181,MATH 193A,A02,083225,Rotar; Vladimir,9,0,34,25
1657434358181,MATH 193A,A03,083781,Rotar; Vladimir,5,0,34,29
1657434358181,MATH 193A,A04,083782,Rotar; Vladimir,10,0,34,24
1657434358181,MATH 193A,A05,093482,Rotar; Vladimir,10,0,34,24
1657434364208,MATH 197,001,091859,McAuley; Julian John,9999,0,9999,0
1657434364208,MATH 197,002,095566,Kedlaya; Kiran S.,9997,0,9999,2
1657434364208,MATH 197,003,095567,Xiao; Ming,9999,0,9999,0
1657434364208,MATH 197,004,095571,Perols; Johan Lars,9998,0,9999,1
1657434371266,COGS 9,A01,083615,Shannon; Kyle Michael,9,0,75,66
1657434377288,COGS 11,A01,083617,Boyle; Mary E. T.,22,0,48,26
1657434383324,COGS 13,A01,083071,Bastos; Amalia Pinkusfeld,11,0,71,60
1657434389347,COGS 14A,A01,092681,Semenuks; Arturs,5,1,100,95
1657434395370,COGS 14B,A01,083073,Cheng; Tzu-Han,6,0,63,57
1657434401396,COGS 17,A01,092677,Semenuks; Arturs,6,0,81,75
1657434407425,COGS 100,A01,083619,Allen; Michael Gordon,17,0,70,53
1657434413450,COGS 101A,A01,083621,Davis; Joshua Daniel,9,0,68,59
1657434419475,COGS 101B,A01,091572,Allen; Michael Gordon,12,0,65,53
1657434425503,COGS 101C,A01,083625,Delgado; Tania,17,0,35,18
1657434431530,COGS 107A,A01,083627,Boyle; Mary E. T.,13,0,60,47
1657434437551,COGS 118A,A01,083075,Gupta; Anjum,21,0,76,55
1657434443573,CSE 3,A50,083646,Miranda; Gregory Joseph,24,0,50,26
1657434449598,CSE 8A,A50,083650,Miranda; Gregory Joseph,17,1,56,39
1657434455624,CSE 11,A01,083080,Cao; Yingjun,6,15,40,34
1657434461647,CSE 12,A01,083652,Krause-Levy; Sophia Louisa,28,1,120,92
1657434467682,CSE 15L,A01,083654,Morris; Justin Loren,9,0,50,41
1657434467682,CSE 15L,A02,083655,Morris; Justin Loren,9,0,50,41
1657434473706,CSE 20,A01,083657,Tran; Khoa Dang,39,0,80,41
1657434479728,CSE 21,A01,095574,Bach; Quang Tran,22,0,48,26
1657434485758,CSE 30,A01,083084,Eldon; John,5,0,80,75
1657434485758,CSE 30,B01,095061,Bhaskar; Nishant,9,0,50,41
1657434491781,CSE 100,A01,083659,Cao; Yingjun,5,4,70,65
1657434497816,CSE 134B,A01,083661,Powell; Thomas Allan,22,0,100,78
1657434503852,CSE 140,A01,083663,Gungor; Onat,15,0,85,70
1657434509880,CSE 140L,A01,083088,Eldon; John,21,0,100,79
1657434515905,CSE 175,A01,083665,Kumar; Rakesh,3,0,25,22
1657434521928,CSE 190,A00,092507,Dubnov; Shlomo,7,0,20,13
1657434527952,ECE 45,A01,083139,Congero; Spencer William,6,0,75,69
1657434533975,ECE 65,A50,083695,Saad; Andrew S,12,0,30,18
1657434533975,ECE 65,A51,095125,Saad; Andrew S,24,0,26,2
1657434540006,ECE 109,A01,091882,Touri; Behrouz,19,0,70,51
1657434546036,ECE 180,A00,083140,Abi Samra; Nicholas Camill,1,0,30,29
1657434546036,ECE 180,B00,083141,Abi Samra; Nicholas Camill,0,0,30,30
1657434552059,MATH 10A,A01,083735,Patchell; Gregory David,2,0,30,28
1657434552059,MATH 10A,A02,083736,Patchell; Gregory David,20,0,30,10
1657434552059,MATH 10A,A03,083737,Patchell; Gregory David,16,0,30,14
1657434558083,MATH 10B,A01,083207,Lim; Seonhee,8,0,34,26
1657434558083,MATH 10B,A02,083208,Lim; Seonhee,9,0,35,26
1657434558083,MATH 10B,A03,093472,Lim; Seonhee,7,0,34,27
1657434558083,MATH 10B,B01,083739,Sinha; Shubham,12,0,30,18
1657434564107,MATH 18,A01,083743,Cinel; Cameron Alexander,7,0,30,23
1657434564107,MATH 18,A02,083744,Cinel; Cameron Alexander,17,0,30,13
1657434564107,MATH 18,A03,083745,Cinel; Cameron Alexander,9,0,30,21
1657434564107,MATH 18,B01,083748,Rideout; David Porter,5,0,37,32
1657434564107,MATH 18,B02,083749,Rideout; David Porter,5,0,36,31
1657434564107,MATH 18,B03,083750,Rideout; David Porter,3,0,37,34
1657434564107,MATH 18,B04,083751,Rideout; David Porter,6,0,36,30
1657434564107,MATH 18,B05,093473,Rideout; David Porter,6,0,36,30
1657434564107,MATH 18,B06,093474,Rideout; David Porter,6,0,36,30
1657434570130,MATH 20A,A01,083754,Zheng; Zequn,14,0,40,26
1657434576154,MATH 20B,A01,083756,Briones; Jor-el Thomas Caparas,4,0,36,32
1657434576154,MATH 20B,A02,083757,Briones; Jor-el Thomas Caparas,1,0,36,35
1657434576154,MATH 20B,A03,093475,Briones; Jor-el Thomas Caparas,2,0,36,34
1657434582183,MATH 20C,A01,083760,Briones; Jor-el Thomas Caparas,1,0,35,34
1657434582183,MATH 20C,A02,083761,Briones; Jor-el Thomas Caparas,8,0,35,27
1657434582183,MATH 20C,A03,093476,Briones; Jor-el Thomas Caparas,0,1,36,36
1657434582183,MATH 20C,B01,083762,Bach; Quang Tran,1,0,30,29
1657434588208,MATH 20D,A01,083765,Tran; Brian Kha,5,0,30,25
1657434588208,MATH 20D,A02,083766,Tran; Brian Kha,5,0,30,25
1657434588208,MATH 20D,A03,083767,Tran; Brian Kha,5,0,30,25
1657434594236,MATH 20E,A01,083771,Ganguly; Soumya,9,0,32,23
1657434594236,MATH 20E,A02,083772,Ganguly; Soumya,6,0,32,26
1657434594236,MATH 20E,B01,083773,Ciotti; Benjamin,20,0,35,15
1657434594236,MATH 20E,B02,083774,Ciotti; Benjamin,17,0,35,18
1657434600266,MATH 103A,A01,083777,Greenfeld; Be'Eri,3,0,36,33
1657434600266,MATH 103A,A02,083778,Greenfeld; Be'Eri,5,0,36,31
1657434600266,MATH 103A,A03,093561,Greenfeld; Be'Eri,5,0,36,31
1657434600266,MATH 103A,B01,083779,Greenfeld; Be'Eri,7,0,36,29
1657434600266,MATH 103A,B02,083780,Greenfeld; Be'Eri,4,0,36,32
1657434600266,MATH 103A,B03,093562,Greenfeld; Be'Eri,3,0,36,33
1657434606288,MATH 105,A01,085443,Carter; Anne Toulson,15,0,35,20
1657434606288,MATH 105,A02,093477,Carter; Anne Toulson,20,0,35,15
1657434612317,MATH 109,A01,083213,Ganzberger; Geoffrey Michael,2,0,34,32
1657434612317,MATH 109,A02,083214,Ganzberger; Geoffrey Michael,4,0,34,30
1657434612317,MATH 109,A03,093478,Ganzberger; Geoffrey Michael,2,0,34,32
1657434612317,MATH 109,B01,083215,Ganzberger; Geoffrey Michael,1,0,32,31
1657434612317,MATH 109,B02,083216,Ganzberger; Geoffrey Michael,2,0,32,30
1657434612317,MATH 109,B03,093479,Ganzberger; Geoffrey Michael,8,0,32,24
1657434618341,MATH 142A,A01,083219,Chow; Bennett,7,0,32,25
1657434618341,MATH 142A,A02,083220,Chow; Bennett,10,0,32,22
1657434618341,MATH 142A,A03,093480,Chow; Bennett,8,0,32,24
1657434618341,MATH 142A,B03,093481,Chow; Bennett,8,0,32,24
1657434618341,MATH 142A,B04,093558,Chow; Bennett,13,0,32,19
1657434618341,MATH 142A,B05,093559,Chow; Bennett,6,0,32,26
1657434624362,MATH 193A,A01,083224,Rotar; Vladimir,8,0,34,26
1657434624362,MATH 193A,A02,083225,Rotar; Vladimir,9,0,34,25
1657434624362,MATH 193A,A03,083781,Rotar; Vladimir,5,0,34,29
1657434624362,MATH 193A,A04,083782,Rotar; Vladimir,10,0,34,24
1657434624362,MATH 193A,A05,093482,Rotar; Vladimir,10,0,34,24
1657434630386,MATH 197,001,091859,McAuley; Julian John,9999,0,9999,0
1657434630386,MATH 197,002,095566,Kedlaya; Kiran S.,9997,0,9999,2
1657434630386,MATH 197,003,095567,Xiao; Ming,9999,0,9999,0
1657434630386,MATH 197,004,095571,Perols; Johan Lars,9998,0,9999,1
1657434637441,COGS 9,A01,083615,Shannon; Kyle Michael,9,0,75,66
1657434643535,COGS 11,A01,083617,Boyle; Mary E. T.,22,0,48,26
1657434649563,COGS 13,A01,083071,Bastos; Amalia Pinkusfeld,11,0,71,60
1657434655588,COGS 14A,A01,092681,Semenuks; Arturs,5,1,100,95
1657434661612,COGS 14B,A01,083073,Cheng; Tzu-Han,6,0,63,57
1657434667635,COGS 17,A01,092677,Semenuks; Arturs,6,0,81,75
1657434673662,COGS 100,A01,083619,Allen; Michael Gordon,17,0,70,53
1657434679688,COGS 101A,A01,083621,Davis; Joshua Daniel,9,0,68,59
1657434685714,COGS 101B,A01,091572,Allen; Michael Gordon,12,0,65,53
1657434691739,COGS 101C,A01,083625,Delgado; Tania,17,0,35,18
1657434697761,COGS 107A,A01,083627,Boyle; Mary E. T.,13,0,60,47
1657434703784,COGS 118A,A01,083075,Gupta; Anjum,21,0,76,55
1657434709809,CSE 3,A50,083646,Miranda; Gregory Joseph,24,0,50,26
1657434715835,CSE 8A,A50,083650,Miranda; Gregory Joseph,17,1,56,39
1657434721861,CSE 11,A01,083080,Cao; Yingjun,6,15,40,34
1657434727886,CSE 12,A01,083652,Krause-Levy; Sophia Louisa,28,1,120,92
1657434733909,CSE 15L,A01,083654,Morris; Justin Loren,9,0,50,41
1657434733909,CSE 15L,A02,083655,Morris; Justin Loren,9,0,50,41
1657434739937,CSE 20,A01,083657,Tran; Khoa Dang,39,0,80,41
1657434745960,CSE 21,A01,095574,Bach; Quang Tran,22,0,48,26
1657434751986,CSE 30,A01,083084,Eldon; John,5,0,80,75
1657434751986,CSE 30,B01,095061,Bhaskar; Nishant,9,0,50,41
1657434758012,CSE 100,A01,083659,Cao; Yingjun,5,4,70,65
1657434764036,CSE 134B,A01,083661,Powell; Thomas Allan,22,0,100,78
1657434770064,CSE 140,A01,083663,Gungor; Onat,15,0,85,70
1657434776090,CSE 140L,A01,083088,Eldon; John,21,0,100,79
1657434782121,CSE 175,A01,083665,Kumar; Rakesh,3,0,25,22
1657434788144,CSE 190,A00,092507,Dubnov; Shlomo,7,0,20,13
1657434794170,ECE 45,A01,083139,Congero; Spencer William,6,0,75,69
1657434800197,ECE 65,A50,083695,Saad; Andrew S,12,0,30,18
1657434800197,ECE 65,A51,095125,Saad; Andrew S,24,0,26,2
1657434806221,ECE 109,A01,091882,Touri; Behrouz,19,0,70,51
1657434812248,ECE 180,A00,083140,Abi Samra; Nicholas Camill,1,0,30,29
1657434812248,ECE 180,B00,083141,Abi Samra; Nicholas Camill,0,0,30,30
1657434818272,MATH 10A,A01,083735,Patchell; Gregory David,2,0,30,28
1657434818272,MATH 10A,A02,083736,Patchell; Gregory David,20,0,30,10
1657434818272,MATH 10A,A03,083737,Patchell; Gregory David,16,0,30,14
1657434824297,MATH 10B,A01,083207,Lim; Seonhee,8,0,34,26
1657434824297,MATH 10B,A02,083208,Lim; Seonhee,9,0,35,26
1657434824297,MATH 10B,A03,093472,Lim; Seonhee,7,0,34,27
1657434824297,MATH 10B,B01,083739,Sinha; Shubham,12,0,30,18
1657434830329,MATH 18,A01,083743,Cinel; Cameron Alexander,7,0,30,23
1657434830329,MATH 18,A02,083744,Cinel; Cameron Alexander,17,0,30,13
1657434830329,MATH 18,A03,083745,Cinel; Cameron Alexander,9,0,30,21
1657434830329,MATH 18,B01,083748,Rideout; David Porter,5,0,37,32
1657434830329,MATH 18,B02,083749,Rideout; David Porter,5,0,36,31
1657434830329,MATH 18,B03,083750,Rideout; David Porter,3,0,37,34
1657434830329,MATH 18,B04,083751,Rideout; David Porter,6,0,36,30
1657434830329,MATH 18,B05,093473,Rideout; David Porter,6,0,36,30
1657434830329,MATH 18,B06,093474,Rideout; David Porter,6,0,36,30
1657434836352,MATH 20A,A01,083754,Zheng; Zequn,14,0,40,26
1657434842376,MATH 20B,A01,083756,Briones; Jor-el Thomas Caparas,4,0,36,32
1657434842376,MATH 20B,A02,083757,Briones; Jor-el Thomas Caparas,1,0,36,35
1657434842376,MATH 20B,A03,093475,Briones; Jor-el Thomas Caparas,2,0,36,34
1657434848400,MATH 20C,A01,083760,Briones; Jor-el Thomas Caparas,1,0,35,34
1657434848400,MATH 20C,A02,083761,Briones; Jor-el Thomas Caparas,8,0,35,27
1657434848400,MATH 20C,A03,093476,Briones; Jor-el Thomas Caparas,0,1,36,36
1657434848400,MATH 20C,B01,083762,Bach; Quang Tran,1,0,30,29
1657434854423,MATH 20D,A01,083765,Tran; Brian Kha,5,0,30,25
1657434854423,MATH 20D,A02,083766,Tran; Brian Kha,5,0,30,25
1657434854423,MATH 20D,A03,083767,Tran; Brian Kha,5,0,30,25
1657434860447,MATH 20E,A01,083771,Ganguly; Soumya,9,0,32,23
1657434860447,MATH 20E,A02,083772,Ganguly; Soumya,6,0,32,26
1657434860447,MATH 20E,B01,083773,Ciotti; Benjamin,20,0,35,15
1657434860447,MATH 20E,B02,083774,Ciotti; Benjamin,17,0,35,18
1657434866484,MATH 103A,A01,083777,Greenfeld; Be'Eri,3,0,36,33
1657434866484,MATH 103A,A02,083778,Greenfeld; Be'Eri,5,0,36,31
1657434866484,MATH 103A,A03,093561,Greenfeld; Be'Eri,5,0,36,31
1657434866484,MATH 103A,B01,083779,Greenfeld; Be'Eri,7,0,36,29
1657434866484,MATH 103A,B02,083780,Greenfeld; Be'Eri,4,0,36,32
1657434866484,MATH 103A,B03,093562,Greenfeld; Be'Eri,3,0,36,33
1657434872508,MATH 105,A01,085443,Carter; Anne Toulson,15,0,35,20
1657434872508,MATH 105,A02,093477,Carter; Anne Toulson,20,0,35,15
1657434878540,MATH 109,A01,083213,Ganzberger; Geoffrey Michael,2,0,34,32
1657434878540,MATH 109,A02,083214,Ganzberger; Geoffrey Michael,4,0,34,30
1657434878540,MATH 109,A03,093478,Ganzberger; Geoffrey Michael,2,0,34,32
1657434878540,MATH 109,B01,083215,Ganzberger; Geoffrey Michael,1,0,32,31
1657434878540,MATH 109,B02,083216,Ganzberger; Geoffrey Michael,2,0,32,30
1657434878540,MATH 109,B03,093479,Ganzberger; Geoffrey Michael,8,0,32,24
1657434884563,MATH 142A,A01,083219,Chow; Bennett,7,0,32,25
1657434884563,MATH 142A,A02,083220,Chow; Bennett,10,0,32,22
1657434884563,MATH 142A,A03,093480,Chow; Bennett,8,0,32,24
1657434884563,MATH 142A,B03,093481,Chow; Bennett,8,0,32,24
1657434884563,MATH 142A,B04,093558,Chow; Bennett,13,0,32,19
1657434884563,MATH 142A,B05,093559,Chow; Bennett,6,0,32,26
1657434890592,MATH 193A,A01,083224,Rotar; Vladimir,8,0,34,26
1657434890592,MATH 193A,A02,083225,Rotar; Vladimir,9,0,34,25
1657434890592,MATH 193A,A03,083781,Rotar; Vladimir,5,0,34,29
1657434890592,MATH 193A,A04,083782,Rotar; Vladimir,10,0,34,24
1657434890592,MATH 193A,A05,093482,Rotar; Vladimir,10,0,34,24
1657434896615,MATH 197,001,091859,McAuley; Julian John,9999,0,9999,0
1657434896615,MATH 197,002,095566,Kedlaya; Kiran S.,9997,0,9999,2
1657434896615,MATH 197,003,095567,Xiao; Ming,9999,0,9999,0
1657434896615,MATH 197,004,095571,Perols; Johan Lars,9998,0,9999,1
1657434903668,COGS 9,A01,083615,Shannon; Kyle Michael,9,0,75,66
1657434909691,COGS 11,A01,083617,Boyle; Mary E. T.,22,0,48,26
1657434915716,COGS 13,A01,083071,Bastos; Amalia Pinkusfeld,11,0,71,60
1657434921744,COGS 14A,A01,092681,Semenuks; Arturs,5,1,100,95
1657434927771,COGS 14B,A01,083073,Cheng; Tzu-Han,6,0,63,57
1657434933798,COGS 17,A01,092677,Semenuks; Arturs,6,0,81,75
1657434939825,COGS 100,A01,083619,Allen; Michael Gordon,17,0,70,53
1657434945848,COGS 101A,A01,083621,Davis; Joshua Daniel,9,0,68,59
1657434951871,COGS 101B,A01,091572,Allen; Michael Gordon,12,0,65,53
1657434957900,COGS 101C,A01,083625,Delgado; Tania,17,0,35,18
1657434963926,COGS 107A,A01,083627,Boyle; Mary E. T.,13,0,60,47
1657434969949,COGS 118A,A01,083075,Gupta; Anjum,21,0,76,55
1657434975973,CSE 3,A50,083646,Miranda; Gregory Joseph,24,0,50,26
1657434981996,CSE 8A,A50,083650,Miranda; Gregory Joseph,17,1,56,39
1657434988020,CSE 11,A01,083080,Cao; Yingjun,6,15,40,34
1657434994051,CSE 12,A01,083652,Krause-Levy; Sophia Louisa,28,1,120,92
1657435000075,CSE 15L,A01,083654,Morris; Justin Loren,9,0,50,41
1657435000075,CSE 15L,A02,083655,Morris; Justin Loren,9,0,50,41
1657435006099,CSE 20,A01,083657,Tran; Khoa Dang,39,0,80,41
1657435012123,CSE 21,A01,095574,Bach; Quang Tran,22,0,48,26
1657435018147,CSE 30,A01,083084,Eldon; John,5,0,80,75
1657435018147,CSE 30,B01,095061,Bhaskar; Nishant,9,0,50,41
1657435024178,CSE 100,A01,083659,Cao; Yingjun,5,4,70,65
1657435030202,CSE 134B,A01,083661,Powell; Thomas Allan,22,0,100,78
1657435036224,CSE 140,A01,083663,Gungor; Onat,15,0,85,70
1657435042247,CSE 140L,A01,083088,Eldon; John,21,0,100,79
1657435048269,CSE 175,A01,083665,Kumar; Rakesh,3,0,25,22
1657435054292,CSE 190,A00,092507,Dubnov; Shlomo,7,0,20,13
1657435060320,ECE 45,A01,083139,Congero; Spencer William,6,0,75,69
1657435066346,ECE 65,A50,083695,Saad; Andrew S,12,0,30,18
1657435066346,ECE 65,A51,095125,Saad; Andrew S,24,0,26,2
1657435072371,ECE 109,A01,091882,Touri; Behrouz,19,0,70,51
1657435078395,ECE 180,A00,083140,Abi Samra; Nicholas Camill,1,0,30,29
1657435078395,ECE 180,B00,083141,Abi Samra; Nicholas Camill,0,0,30,30
1657435084423,MATH 10A,A01,083735,Patchell; Gregory David,2,0,30,28
1657435084423,MATH 10A,A02,083736,Patchell; Gregory David,20,0,30,10
1657435084423,MATH 10A,A03,083737,Patchell; Gregory David,16,0,30,14
1657435090447,MATH 10B,A01,083207,Lim; Seonhee,8,0,34,26
1657435090447,MATH 10B,A02,083208,Lim; Seonhee,9,0,35,26
1657435090447,MATH 10B,A03,093472,Lim; Seonhee,7,0,34,27
1657435090447,MATH 10B,B01,083739,Sinha; Shubham,12,0,30,18
1657435096472,MATH 18,A01,083743,Cinel; Cameron Alexander,7,0,30,23
1657435096472,MATH 18,A02,083744,Cinel; Cameron Alexander,17,0,30,13
1657435096472,MATH 18,A03,083745,Cinel; Cameron Alexander,9,0,30,21
1657435096472,MATH 18,B01,083748,Rideout; David Porter,5,0,37,32
1657435096472,MATH 18,B02,083749,Rideout; David Porter,5,0,36,31
1657435096472,MATH 18,B03,083750,Rideout; David Porter,3,0,37,34
1657435096472,MATH 18,B04,083751,Rideout; David Porter,6,0,36,30
1657435096472,MATH 18,B05,093473,Rideout; David Porter,6,0,36,30
1657435096472,MATH 18,B06,093474,Rideout; David Porter,6,0,36,30
1657435102495,MATH 20A,A01,083754,Zheng; Zequn,14,0,40,26
1657435108517,MATH 20B,A01,083756,Briones; Jor-el Thomas Caparas,4,0,36,32
1657435108517,MATH 20B,A02,083757,Briones; Jor-el Thomas Caparas,1,0,36,35
1657435108517,MATH 20B,A03,093475,Briones; Jor-el Thomas Caparas,2,0,36,34
1657435114542,MATH 20C,A01,083760,Briones; Jor-el Thomas Caparas,1,0,35,34
1657435114542,MATH 20C,A02,083761,Briones; Jor-el Thomas Caparas,8,0,35,27
1657435114542,MATH 20C,A03,093476,Briones; Jor-el Thomas Caparas,0,1,36,36
1657435114542,MATH 20C,B01,083762,Bach; Quang Tran,1,0,30,29
1657435120565,MATH 20D,A01,083765,Tran; Brian Kha,5,0,30,25
1657435120565,MATH 20D,A02,083766,Tran; Brian Kha,5,0,30,25
1657435120565,MATH 20D,A03,083767,Tran; Brian Kha,5,0,30,25
1657435126592,MATH 20E,A01,083771,Ganguly; Soumya,9,0,32,23
1657435126592,MATH 20E,A02,083772,Ganguly; Soumya,6,0,32,26
1657435126592,MATH 20E,B01,083773,Ciotti; Benjamin,20,0,35,15
1657435126592,MATH 20E,B02,083774,Ciotti; Benjamin,17,0,35,18
1657435132617,MATH 103A,A01,083777,Greenfeld; Be'Eri,3,0,36,33
1657435132617,MATH 103A,A02,083778,Greenfeld; Be'Eri,5,0,36,31
1657435132617,MATH 103A,A03,093561,Greenfeld; Be'Eri,5,0,36,31
1657435132617,MATH 103A,B01,083779,Greenfeld; Be'Eri,7,0,36,29
1657435132617,MATH 103A,B02,083780,Greenfeld; Be'Eri,4,0,36,32
1657435132617,MATH 103A,B03,093562,Greenfeld; Be'Eri,3,0,36,33
1657435138642,MATH 105,A01,085443,Carter; Anne Toulson,15,0,35,20
1657435138642,MATH 105,A02,093477,Carter; Anne Toulson,20,0,35,15
1657435144671,MATH 109,A01,083213,Ganzberger; Geoffrey Michael,2,0,34,32
1657435144671,MATH 109,A02,083214,Ganzberger; Geoffrey Michael,4,0,34,30
1657435144671,MATH 109,A03,093478,Ganzberger; Geoffrey Michael,2,0,34,32
1657435144671,MATH 109,B01,083215,Ganzberger; Geoffrey Michael,1,0,32,31
1657435144671,MATH 109,B02,083216,Ganzberger; Geoffrey Michael,2,0,32,30
1657435144671,MATH 109,B03,093479,Ganzberger; Geoffrey Michael,8,0,32,24
1657435150694,MATH 142A,A01,083219,Chow; Bennett,7,0,32,25
1657435150694,MATH 142A,A02,083220,Chow; Bennett,10,0,32,22
1657435150694,MATH 142A,A03,093480,Chow; Bennett,8,0,32,24
1657435150694,MATH 142A,B03,093481,Chow; Bennett,8,0,32,24
1657435150694,MATH 142A,B04,093558,Chow; Bennett,13,0,32,19
1657435150694,MATH 142A,B05,093559,Chow; Bennett,6,0,32,26
1657435156718,MATH 193A,A01,083224,Rotar; Vladimir,8,0,34,26
1657435156718,MATH 193A,A02,083225,Rotar; Vladimir,9,0,34,25
1657435156718,MATH 193A,A03,083781,Rotar; Vladimir,5,0,34,29
1657435156718,MATH 193A,A04,083782,Rotar; Vladimir,10,0,34,24
1657435156718,MATH 193A,A05,093482,Rotar; Vladimir,10,0,34,24
1657435162743,MATH 197,001,091859,McAuley; Julian John,9999,0,9999,0
1657435162743,MATH 197,002,095566,Kedlaya; Kiran S.,9997,0,9999,2
1657435162743,MATH 197,003,095567,Xiao; Ming,9999,0,9999,0
1657435162743,MATH 197,004,095571,Perols; Johan Lars,9998,0,9999,1
1657435169802,COGS 9,A01,083615,Shannon; Kyle Michael,9,0,75,66
1657435175833,COGS 11,A01,083617,Boyle; Mary E. T.,22,0,48,26
1657435181866,COGS 13,A01,083071,Bastos; Amalia Pinkusfeld,11,0,71,60
1657435187891,COGS 14A,A01,092681,Semenuks; Arturs,5,1,100,95
1657435193913,COGS 14B,A01,083073,Cheng; Tzu-Han,6,0,63,57
1657435199937,COGS 17,A01,092677,Semenuks; Arturs,6,0,81,75
1657435205960,COGS 100,A01,083619,Allen; Michael Gordon,17,0,70,53
1657435211987,COGS 101A,A01,083621,Davis; Joshua Daniel,9,0,68,59
1657435218014,COGS 101B,A01,091572,Allen; Michael Gordon,12,0,65,53
1657435224041,COGS 101C,A01,083625,Delgado; Tania,17,0,35,18
1657435230068,COGS 107A,A01,083627,Boyle; Mary E. T.,13,0,60,47
1657435236092,COGS 118A,A01,083075,Gupta; Anjum,21,0,76,55
1657435242222,CSE 3,A50,083646,Miranda; Gregory Joseph,24,0,50,26
1657435248251,CSE 8A,A50,083650,Miranda; Gregory Joseph,17,1,56,39
1657435254292,CSE 11,A01,083080,Cao; Yingjun,6,15,40,34
1657435260319,CSE 12,A01,083652,Krause-Levy; Sophia Louisa,28,1,120,92
1657435266351,CSE 15L,A01,083654,Morris; Justin Loren,9,0,50,41
1657435266351,CSE 15L,A02,083655,Morris; Justin Loren,9,0,50,41
1657435272384,CSE 20,A01,083657,Tran; Khoa Dang,39,0,80,41
1657435278406,CSE 21,A01,095574,Bach; Quang Tran,22,0,48,26
1657435284440,CSE 30,A01,083084,Eldon; John,5,0,80,75
1657435284440,CSE 30,B01,095061,Bhaskar; Nishant,9,0,50,41
1657435290461,CSE 100,A01,083659,Cao; Yingjun,5,4,70,65
1657435296486,CSE 134B,A01,083661,Powell; Thomas Allan,22,0,100,78
1657435302512,CSE 140,A01,083663,Gungor; Onat,15,0,85,70
1657435308550,CSE 140L,A01,083088,Eldon; John,21,0,100,79
1657435314572,CSE 175,A01,083665,Kumar; Rakesh,3,0,25,22
1657435320601,CSE 190,A00,092507,Dubnov; Shlomo,7,0,20,13
1657435326624,ECE 45,A01,083139,Congero; Spencer William,6,0,75,69
1657435332647,ECE 65,A50,083695,Saad; Andrew S,12,0,30,18
1657435332647,ECE 65,A51,095125,Saad; Andrew S,24,0,26,2
1657435338675,ECE 109,A01,091882,Touri; Behrouz,19,0,70,51
1657435344699,ECE 180,A00,083140,Abi Samra; Nicholas Camill,1,0,30,29
1657435344699,ECE 180,B00,083141,Abi Samra; Nicholas Camill,0,0,30,30
1657435350723,MATH 10A,A01,083735,Patchell; Gregory David,2,0,30,28
1657435350723,MATH 10A,A02,083736,Patchell; Gregory David,20,0,30,10
1657435350723,MATH 10A,A03,083737,Patchell; Gregory David,16,0,30,14
1657435356752,MATH 10B,A01,083207,Lim; Seonhee,8,0,34,26
1657435356752,MATH 10B,A02,083208,Lim; Seonhee,9,0,35,26
1657435356752,MATH 10B,A03,093472,Lim; Seonhee,7,0,34,27
1657435356752,MATH 10B,B01,083739,Sinha; Shubham,12,0,30,18
1657435362777,MATH 18,A01,083743,Cinel; Cameron Alexander,7,0,30,23
1657435362777,MATH 18,A02,083744,Cinel; Cameron Alexander,17,0,30,13
1657435362777,MATH 18,A03,083745,Cinel; Cameron Alexander,9,0,30,21
1657435362777,MATH 18,B01,083748,Rideout; David Porter,5,0,37,32
1657435362777,MATH 18,B02,083749,Rideout; David Porter,5,0,36,31
1657435362777,MATH 18,B03,083750,Rideout; David Porter,3,0,37,34
1657435362777,MATH 18,B04,083751,Rideout; David Porter,6,0,36,30
1657435362777,MATH 18,B05,093473,Rideout; David Porter,6,0,36,30
1657435362777,MATH 18,B06,093474,Rideout; David Porter,6,0,36,30
1657435368801,MATH 20A,A01,083754,Zheng; Zequn,14,0,40,26
1657435374833,MATH 20B,A01,083756,Briones; Jor-el Thomas Caparas,4,0,36,32
1657435374833,MATH 20B,A02,083757,Briones; Jor-el Thomas Caparas,1,0,36,35
1657435374833,MATH 20B,A03,093475,Briones; Jor-el Thomas Caparas,2,0,36,34
1657435380856,MATH 20C,A01,083760,Briones; Jor-el Thomas Caparas,1,0,35,34
1657435380856,MATH 20C,A02,083761,Briones; Jor-el Thomas Caparas,8,0,35,27
1657435380856,MATH 20C,A03,093476,Briones; Jor-el Thomas Caparas,0,1,36,36
1657435380856,MATH 20C,B01,083762,Bach; Quang Tran,1,0,30,29
1657435386879,MATH 20D,A01,083765,Tran; Brian Kha,5,0,30,25
1657435386879,MATH 20D,A02,083766,Tran; Brian Kha,5,0,30,25
1657435386879,MATH 20D,A03,083767,Tran; Brian Kha,5,0,30,25
1657435392907,MATH 20E,A01,083771,Ganguly; Soumya,9,0,32,23
1657435392907,MATH 20E,A02,083772,Ganguly; Soumya,6,0,32,26
1657435392907,MATH 20E,B01,083773,Ciotti; Benjamin,20,0,35,15
1657435392907,MATH 20E,B02,083774,Ciotti; Benjamin,17,0,35,18
1657435398930,MATH 103A,A01,083777,Greenfeld; Be'Eri,3,0,36,33
1657435398930,MATH 103A,A02,083778,Greenfeld; Be'Eri,5,0,36,31
1657435398930,MATH 103A,A03,093561,Greenfeld; Be'Eri,5,0,36,31
1657435398930,MATH 103A,B01,083779,Greenfeld; Be'Eri,7,0,36,29
1657435398930,MATH 103A,B02,083780,Greenfeld; Be'Eri,4,0,36,32
1657435398930,MATH 103A,B03,093562,Greenfeld; Be'Eri,3,0,36,33
1657435404954,MATH 105,A01,085443,Carter; Anne Toulson,15,0,35,20
1657435404954,MATH 105,A02,093477,Carter; Anne Toulson,20,0,35,15
1657435410976,MATH 109,A01,083213,Ganzberger; Geoffrey Michael,2,0,34,32
1657435410976,MATH 109,A02,083214,Ganzberger; Geoffrey Michael,4,0,34,30
1657435410976,MATH 109,A03,093478,Ganzberger; Geoffrey Michael,2,0,34,32
1657435410976,MATH 109,B01,083215,Ganzberger; Geoffrey Michael,1,0,32,31
1657435410976,MATH 109,B02,083216,Ganzberger; Geoffrey Michael,2,0,32,30
1657435410976,MATH 109,B03,093479,Ganzberger; Geoffrey Michael,8,0,32,24
1657435417003,MATH 142A,A01,083219,Chow; Bennett,7,0,32,25
1657435417003,MATH 142A,A02,083220,Chow; Bennett,10,0,32,22
1657435417003,MATH 142A,A03,093480,Chow; Bennett,8,0,32,24
1657435417003,MATH 142A,B03,093481,Chow; Bennett,8,0,32,24
1657435417003,MATH 142A,B04,093558,Chow; Bennett,13,0,32,19
1657435417003,MATH 142A,B05,093559,Chow; Bennett,6,0,32,26
1657435423026,MATH 193A,A01,083224,Rotar; Vladimir,8,0,34,26
1657435423026,MATH 193A,A02,083225,Rotar; Vladimir,9,0,34,25
1657435423026,MATH 193A,A03,083781,Rotar; Vladimir,5,0,34,29
1657435423026,MATH 193A,A04,083782,Rotar; Vladimir,10,0,34,24
1657435423026,MATH 193A,A05,093482,Rotar; Vladimir,10,0,34,24
1657435429053,MATH 197,001,091859,McAuley; Julian John,9999,0,9999,0
1657435429053,MATH 197,002,095566,Kedlaya; Kiran S.,9997,0,9999,2
1657435429053,MATH 197,003,095567,Xiao; Ming,9999,0,9999,0
1657435429053,MATH 197,004,095571,Perols; Johan Lars,9998,0,9999,1
1657435436107,COGS 9,A01,083615,Shannon; Kyle Michael,9,0,75,66
1657435442133,COGS 11,A01,083617,Boyle; Mary E. T.,22,0,48,26
1657435448157,COGS 13,A01,083071,Bastos; Amalia Pinkusfeld,11,0,71,60
1657435454182,COGS 14A,A01,092681,Semenuks; Arturs,5,1,100,95
1657435460204,COGS 14B,A01,083073,Cheng; Tzu-Han,6,0,63,57
1657435466229,COGS 17,A01,092677,Semenuks; Arturs,6,0,81,75
1657435472256,COGS 100,A01,083619,Allen; Michael Gordon,17,0,70,53
1657435478280,COGS 101A,A01,083621,Davis; Joshua Daniel,9,0,68,59
1657435484304,COGS 101B,A01,091572,Allen; Michael Gordon,12,0,65,53
1657435490328,COGS 101C,A01,083625,Delgado; Tania,17,0,35,18
1657435496351,COGS 107A,A01,083627,Boyle; Mary E. T.,13,0,60,47
1657435502379,COGS 118A,A01,083075,Gupta; Anjum,21,0,76,55
1657435508401,CSE 3,A50,083646,Miranda; Gregory Joseph,24,0,50,26
1657435514424,CSE 8A,A50,083650,Miranda; Gregory Joseph,17,1,56,39
1657435520447,CSE 11,A01,083080,Cao; Yingjun,6,15,40,34
1657435526470,CSE 12,A01,083652,Krause-Levy; Sophia Louisa,28,1,120,92
1657435532492,CSE 15L,A01,083654,Morris; Justin Loren,9,0,50,41
1657435532492,CSE 15L,A02,083655,Morris; Justin Loren,9,0,50,41
1657435538515,CSE 20,A01,083657,Tran; Khoa Dang,39,0,80,41
1657435544539,CSE 21,A01,095574,Bach; Quang Tran,22,0,48,26
1657435550563,CSE 30,A01,083084,Eldon; John,5,0,80,75
1657435550563,CSE 30,B01,095061,Bhaskar; Nishant,9,0,50,41
1657435556590,CSE 100,A01,083659,Cao; Yingjun,5,4,70,65
1657435562629,CSE 134B,A01,083661,Powell; Thomas Allan,22,0,100,78
1657435568651,CSE 140,A01,083663,Gungor; Onat,15,0,85,70
1657435574678,CSE 140L,A01,083088,Eldon; John,21,0,100,79
1657435580701,CSE 175,A01,083665,Kumar; Rakesh,3,0,25,22
1657435586724,CSE 190,A00,092507,Dubnov; Shlomo,7,0,20,13
1657435592750,ECE 45,A01,083139,Congero; Spencer William,6,0,75,69
1657435598773,ECE 65,A50,083695,Saad; Andrew S,12,0,30,18
1657435598773,ECE 65,A51,095125,Saad; Andrew S,24,0,26,2
1657435604799,ECE 109,A01,091882,Touri; Behrouz,19,0,70,51
1657435610823,ECE 180,A00,083140,Abi Samra; Nicholas Camill,1,0,30,29
1657435610823,ECE 180,B00,083141,Abi Samra; Nicholas Camill,0,0,30,30
1657435616847,MATH 10A,A01,083735,Patchell; Gregory David,2,0,30,28
1657435616847,MATH 10A,A02,083736,Patchell; Gregory David,20,0,30,10
1657435616847,MATH 10A,A03,083737,Patchell; Gregory David,16,0,30,14
1657435622873,MATH 10B,A01,083207,Lim; Seonhee,8,0,34,26
1657435622873,MATH 10B,A02,083208,Lim; Seonhee,9,0,35,26
1657435622873,MATH 10B,A03,093472,Lim; Seonhee,7,0,34,27
1657435622873,MATH 10B,B01,083739,Sinha; Shubham,12,0,30,18
1657435628899,MATH 18,A01,083743,Cinel; Cameron Alexander,7,0,30,23
1657435628899,MATH 18,A02,083744,Cinel; Cameron Alexander,17,0,30,13
1657435628899,MATH 18,A03,083745,Cinel; Cameron Alexander,9,0,30,21
1657435628899,MATH 18,B01,083748,Rideout; David Porter,5,0,37,32
1657435628899,MATH 18,B02,083749,Rideout; David Porter,5,0,36,31
1657435628899,MATH 18,B03,083750,Rideout; David Porter,3,0,37,34
1657435628899,MATH 18,B04,083751,Rideout; David Porter,6,0,36,30
1657435628899,MATH 18,B05,093473,Rideout; David Porter,6,0,36,30
1657435628899,MATH 18,B06,093474,Rideout; David Porter,6,0,36,30
1657435634923,MATH 20A,A01,083754,Zheng; Zequn,14,0,40,26
1657435640950,MATH 20B,A01,083756,Briones; Jor-el Thomas Caparas,4,0,36,32
1657435640950,MATH 20B,A02,083757,Briones; Jor-el Thomas Caparas,1,0,36,35
1657435640950,MATH 20B,A03,093475,Briones; Jor-el Thomas Caparas,2,0,36,34
1657435646992,MATH 20C,A01,083760,Briones; Jor-el Thomas Caparas,1,0,35,34
1657435646992,MATH 20C,A02,083761,Briones; Jor-el Thomas Caparas,8,0,35,27
1657435646992,MATH 20C,A03,093476,Briones; Jor-el Thomas Caparas,0,1,36,36
1657435646992,MATH 20C,B01,083762,Bach; Quang Tran,1,0,30,29
1657435653018,MATH 20D,A01,083765,Tran; Brian Kha,5,0,30,25
1657435653018,MATH 20D,A02,083766,Tran; Brian Kha,5,0,30,25
1657435653018,MATH 20D,A03,083767,Tran; Brian Kha,5,0,30,25
1657435659043,MATH 20E,A01,083771,Ganguly; Soumya,9,0,32,23
1657435659043,MATH 20E,A02,083772,Ganguly; Soumya,6,0,32,26
1657435659043,MATH 20E,B01,083773,Ciotti; Benjamin,20,0,35,15
1657435659043,MATH 20E,B02,083774,Ciotti; Benjamin,17,0,35,18
1657435665065,MATH 103A,A01,083777,Greenfeld; Be'Eri,3,0,36,33
1657435665065,MATH 103A,A02,083778,Greenfeld; Be'Eri,5,0,36,31
1657435665065,MATH 103A,A03,093561,Greenfeld; Be'Eri,5,0,36,31
1657435665065,MATH 103A,B01,083779,Greenfeld; Be'Eri,7,0,36,29
1657435665065,MATH 103A,B02,083780,Greenfeld; Be'Eri,4,0,36,32
1657435665065,MATH 103A,B03,093562,Greenfeld; Be'Eri,3,0,36,33
1657435671093,MATH 105,A01,085443,Carter; Anne Toulson,15,0,35,20
1657435671093,MATH 105,A02,093477,Carter; Anne Toulson,20,0,35,15
1657435677122,MATH 109,A01,083213,Ganzberger; Geoffrey Michael,2,0,34,32
1657435677122,MATH 109,A02,083214,Ganzberger; Geoffrey Michael,4,0,34,30
1657435677122,MATH 109,A03,093478,Ganzberger; Geoffrey Michael,2,0,34,32
1657435677122,MATH 109,B01,083215,Ganzberger; Geoffrey Michael,1,0,32,31
1657435677122,MATH 109,B02,083216,Ganzberger; Geoffrey Michael,2,0,32,30
1657435677122,MATH 109,B03,093479,Ganzberger; Geoffrey Michael,8,0,32,24
1657435683146,MATH 142A,A01,083219,Chow; Bennett,7,0,32,25
1657435683146,MATH 142A,A02,083220,Chow; Bennett,10,0,32,22
1657435683146,MATH 142A,A03,093480,Chow; Bennett,8,0,32,24
1657435683146,MATH 142A,B03,093481,Chow; Bennett,8,0,32,24
1657435683146,MATH 142A,B04,093558,Chow; Bennett,13,0,32,19
1657435683146,MATH 142A,B05,093559,Chow; Bennett,6,0,32,26
1657435689170,MATH 193A,A01,083224,Rotar; Vladimir,8,0,34,26
1657435689170,MATH 193A,A02,083225,Rotar; Vladimir,9,0,34,25
1657435689170,MATH 193A,A03,083781,Rotar; Vladimir,5,0,34,29
1657435689170,MATH 193A,A04,083782,Rotar; Vladimir,10,0,34,24
1657435689170,MATH 193A,A05,093482,Rotar; Vladimir,10,0,34,24
1657435695192,MATH 197,001,091859,McAuley; Julian John,9999,0,9999,0
1657435695192,MATH 197,002,095566,Kedlaya; Kiran S.,9997,0,9999,2
1657435695192,MATH 197,003,095567,Xiao; Ming,9999,0,9999,0
1657435695192,MATH 197,004,095571,Perols; Johan Lars,9998,0,9999,1
1657435702246,COGS 9,A01,083615,Shannon; Kyle Michael,9,0,75,66
1657435708269,COGS 11,A01,083617,Boyle; Mary E. T.,22,0,48,26
1657435714295,COGS 13,A01,083071,Bastos; Amalia Pinkusfeld,11,0,71,60
1657435720320,COGS 14A,A01,092681,Semenuks; Arturs,5,1,100,95
1657435726349,COGS 14B,A01,083073,Cheng; Tzu-Han,6,0,63,57
1657435732371,COGS 17,A01,092677,Semenuks; Arturs,6,0,81,75
1657435738398,COGS 100,A01,083619,Allen; Michael Gordon,17,0,70,53
1657435744425,COGS 101A,A01,083621,Davis; Joshua Daniel,9,0,68,59
1657435750446,COGS 101B,A01,091572,Allen; Michael Gordon,12,0,65,53
1657435756472,COGS 101C,A01,083625,Delgado; Tania,17,0,35,18
1657435762496,COGS 107A,A01,083627,Boyle; Mary E. T.,13,0,60,47
1657435768523,COGS 118A,A01,083075,Gupta; Anjum,21,0,76,55
1657435774549,CSE 3,A50,083646,Miranda; Gregory Joseph,24,0,50,26
1657435780572,CSE 8A,A50,083650,Miranda; Gregory Joseph,17,1,56,39
1657435786599,CSE 11,A01,083080,Cao; Yingjun,6,15,40,34
1657435792626,CSE 12,A01,083652,Krause-Levy; Sophia Louisa,28,1,120,92
1657435798653,CSE 15L,A01,083654,Morris; Justin Loren,9,0,50,41
1657435798653,CSE 15L,A02,083655,Morris; Justin Loren,9,0,50,41
1657435804680,CSE 20,A01,083657,Tran; Khoa Dang,39,0,80,41
1657435810705,CSE 21,A01,095574,Bach; Quang Tran,22,0,48,26
1657435816728,CSE 30,A01,083084,Eldon; John,5,0,80,75
1657435816728,CSE 30,B01,095061,Bhaskar; Nishant,9,0,50,41
1657435822755,CSE 100,A01,083659,Cao; Yingjun,5,4,70,65
1657435828776,CSE 134B,A01,083661,Powell; Thomas Allan,22,0,100,78
1657435834801,CSE 140,A01,083663,Gungor; Onat,15,0,85,70
1657435840926,CSE 140L,A01,083088,Eldon; John,21,0,100,79
1657435846952,CSE 175,A01,083665,Kumar; Rakesh,3,0,25,22
1657435852975,CSE 190,A00,092507,Dubnov; Shlomo,7,0,20,13
1657435859004,ECE 45,A01,083139,Congero; Spencer William,6,0,75,69
1657435865028,ECE 65,A50,083695,Saad; Andrew S,12,0,30,18
1657435865028,ECE 65,A51,095125,Saad; Andrew S,24,0,26,2
1657435871051,ECE 109,A01,091882,Touri; Behrouz,19,0,70,51
1657435877076,ECE 180,A00,083140,Abi Samra; Nicholas Camill,1,0,30,29
1657435877076,ECE 180,B00,083141,Abi Samra; Nicholas Camill,0,0,30,30
1657435883100,MATH 10A,A01,083735,Patchell; Gregory David,2,0,30,28
1657435883100,MATH 10A,A02,083736,Patchell; Gregory David,20,0,30,10
1657435883100,MATH 10A,A03,083737,Patchell; Gregory David,16,0,30,14
1657435889125,MATH 10B,A01,083207,Lim; Seonhee,8,0,34,26
1657435889125,MATH 10B,A02,083208,Lim; Seonhee,9,0,35,26
1657435889125,MATH 10B,A03,093472,Lim; Seonhee,7,0,34,27
1657435889125,MATH 10B,B01,083739,Sinha; Shubham,12,0,30,18
1657435895149,MATH 18,A01,083743,Cinel; Cameron Alexander,7,0,30,23
1657435895149,MATH 18,A02,083744,Cinel; Cameron Alexander,17,0,30,13
1657435895149,MATH 18,A03,083745,Cinel; Cameron Alexander,9,0,30,21
1657435895149,MATH 18,B01,083748,Rideout; David Porter,5,0,37,32
1657435895149,MATH 18,B02,083749,Rideout; David Porter,5,0,36,31
1657435895149,MATH 18,B03,083750,Rideout; David Porter,3,0,37,34
1657435895149,MATH 18,B04,083751,Rideout; David Porter,6,0,36,30
1657435895149,MATH 18,B05,093473,Rideout; David Porter,6,0,36,30
1657435895149,MATH 18,B06,093474,Rideout; David Porter,6,0,36,30
1657435901173,MATH 20A,A01,083754,Zheng; Zequn,14,0,40,26
1657435907199,MATH 20B,A01,083756,Briones; Jor-el Thomas Caparas,4,0,36,32
1657435907199,MATH 20B,A02,083757,Briones; Jor-el Thomas Caparas,1,0,36,35
1657435907199,MATH 20B,A03,093475,Briones; Jor-el Thomas Caparas,2,0,36,34
1657435913229,MATH 20C,A01,083760,Briones; Jor-el Thomas Caparas,1,0,35,34
1657435913229,MATH 20C,A02,083761,Briones; Jor-el Thomas Caparas,8,0,35,27
1657435913229,MATH 20C,A03,093476,Briones; Jor-el Thomas Caparas,0,1,36,36
1657435913229,MATH 20C,B01,083762,Bach; Quang Tran,1,0,30,29
1657435919256,MATH 20D,A01,083765,Tran; Brian Kha,5,0,30,25
1657435919256,MATH 20D,A02,083766,Tran; Brian Kha,5,0,30,25
1657435919256,MATH 20D,A03,083767,Tran; Brian Kha,5,0,30,25
1657435925285,MATH 20E,A01,083771,Ganguly; Soumya,9,0,32,23
1657435925285,MATH 20E,A02,083772,Ganguly; Soumya,6,0,32,26
1657435925285,MATH 20E,B01,083773,Ciotti; Benjamin,20,0,35,15
1657435925285,MATH 20E,B02,083774,Ciotti; Benjamin,17,0,35,18
1657435931312,MATH 103A,A01,083777,Greenfeld; Be'Eri,3,0,36,33
1657435931312,MATH 103A,A02,083778,Greenfeld; Be'Eri,5,0,36,31
1657435931312,MATH 103A,A03,093561,Greenfeld; Be'Eri,5,0,36,31
1657435931312,MATH 103A,B01,083779,Greenfeld; Be'Eri,7,0,36,29
1657435931312,MATH 103A,B02,083780,Greenfeld; Be'Eri,4,0,36,32
1657435931312,MATH 103A,B03,093562,Greenfeld; Be'Eri,3,0,36,33
1657435937363,MATH 105,A01,085443,Carter; Anne Toulson,15,0,35,20
1657435937363,MATH 105,A02,093477,Carter; Anne Toulson,20,0,35,15
1657435943392,MATH 109,A01,083213,Ganzberger; Geoffrey Michael,2,0,34,32
1657435943392,MATH 109,A02,083214,Ganzberger; Geoffrey Michael,4,0,34,30
1657435943392,MATH 109,A03,093478,Ganzberger; Geoffrey Michael,2,0,34,32
1657435943392,MATH 109,B01,083215,Ganzberger; Geoffrey Michael,1,0,32,31
1657435943392,MATH 109,B02,083216,Ganzberger; Geoffrey Michael,2,0,32,30
1657435943392,MATH 109,B03,093479,Ganzberger; Geoffrey Michael,8,0,32,24
1657435949417,MATH 142A,A01,083219,Chow; Bennett,7,0,32,25
1657435949417,MATH 142A,A02,083220,Chow; Bennett,10,0,32,22
1657435949417,MATH 142A,A03,093480,Chow; Bennett,8,0,32,24
1657435949417,MATH 142A,B03,093481,Chow; Bennett,8,0,32,24
1657435949417,MATH 142A,B04,093558,Chow; Bennett,13,0,32,19
1657435949417,MATH 142A,B05,093559,Chow; Bennett,6,0,32,26
1657435955444,MATH 193A,A01,083224,Rotar; Vladimir,8,0,34,26
1657435955444,MATH 193A,A02,083225,Rotar; Vladimir,9,0,34,25
1657435955444,MATH 193A,A03,083781,Rotar; Vladimir,5,0,34,29
1657435955444,MATH 193A,A04,083782,Rotar; Vladimir,10,0,34,24
1657435955444,MATH 193A,A05,093482,Rotar; Vladimir,10,0,34,24
1657435961481,MATH 197,001,091859,McAuley; Julian John,9999,0,9999,0
1657435961481,MATH 197,002,095566,Kedlaya; Kiran S.,9997,0,9999,2
1657435961481,MATH 197,003,095567,Xiao; Ming,9999,0,9999,0
1657435961481,MATH 197,004,095571,Perols; Johan Lars,9998,0,9999,1
1657435968534,COGS 9,A01,083615,Shannon; Kyle Michael,9,0,75,66
1657435974556,COGS 11,A01,083617,Boyle; Mary E. T.,22,0,48,26
1657435980584,COGS 13,A01,083071,Bastos; Amalia Pinkusfeld,11,0,71,60
1657435986611,COGS 14A,A01,092681,Semenuks; Arturs,5,1,100,95
1657435992637,COGS 14B,A01,083073,Cheng; Tzu-Han,6,0,63,57
1657435998663,COGS 17,A01,092677,Semenuks; Arturs,6,0,81,75
1657436004689,COGS 100,A01,083619,Allen; Michael Gordon,17,0,70,53
1657436010713,COGS 101A,A01,083621,Davis; Joshua Daniel,9,0,68,59
1657436016738,COGS 101B,A01,091572,Allen; Michael Gordon,12,0,65,53
1657436022764,COGS 101C,A01,083625,Delgado; Tania,17,0,35,18
1657436028790,COGS 107A,A01,083627,Boyle; Mary E. T.,13,0,60,47
1657436034817,COGS 118A,A01,083075,Gupta; Anjum,21,0,76,55
1657436040844,CSE 3,A50,083646,Miranda; Gregory Joseph,24,0,50,26
1657436046870,CSE 8A,A50,083650,Miranda; Gregory Joseph,17,1,56,39
1657436052897,CSE 11,A01,083080,Cao; Yingjun,6,15,40,34
1657436058927,CSE 12,A01,083652,Krause-Levy; Sophia Louisa,28,1,120,92
1657436064964,CSE 15L,A01,083654,Morris; Justin Loren,9,0,50,41
1657436064964,CSE 15L,A02,083655,Morris; Justin Loren,9,0,50,41
1657436070987,CSE 20,A01,083657,Tran; Khoa Dang,39,0,80,41
1657436077024,CSE 21,A01,095574,Bach; Quang Tran,22,0,48,26
1657436083052,CSE 30,A01,083084,Eldon; John,5,0,80,75
1657436083052,CSE 30,B01,095061,Bhaskar; Nishant,9,0,50,41
1657436089075,CSE 100,A01,083659,Cao; Yingjun,5,4,70,65
1657436095104,CSE 134B,A01,083661,Powell; Thomas Allan,22,0,100,78
1657436101148,CSE 140,A01,083663,Gungor; Onat,15,0,85,70
1657436107175,CSE 140L,A01,083088,Eldon; John,21,0,100,79
1657436113200,CSE 175,A01,083665,Kumar; Rakesh,3,0,25,22
1657436119225,CSE 190,A00,092507,Dubnov; Shlomo,7,0,20,13
1657436125248,ECE 45,A01,083139,Congero; Spencer William,6,0,75,69
1657436131273,ECE 65,A50,083695,Saad; Andrew S,12,0,30,18
1657436131273,ECE 65,A51,095125,Saad; Andrew S,24,0,26,2
1657436137299,ECE 109,A01,091882,Touri; Behrouz,19,0,70,51
1657436143322,ECE 180,A00,083140,Abi Samra; Nicholas Camill,1,0,30,29
1657436143322,ECE 180,B00,083141,Abi Samra; Nicholas Camill,0,0,30,30
1657436149353,MATH 10A,A01,083735,Patchell; Gregory David,2,0,30,28
1657436149353,MATH 10A,A02,083736,Patchell; Gregory David,20,0,30,10
1657436149353,MATH 10A,A03,083737,Patchell; Gregory David,16,0,30,14
1657436155384,MATH 10B,A01,083207,Lim; Seonhee,8,0,34,26
1657436155384,MATH 10B,A02,083208,Lim; Seonhee,9,0,35,26
1657436155384,MATH 10B,A03,093472,Lim; Seonhee,7,0,34,27
1657436155384,MATH 10B,B01,083739,Sinha; Shubham,12,0,30,18
1657436161417,MATH 18,A01,083743,Cinel; Cameron Alexander,7,0,30,23
1657436161417,MATH 18,A02,083744,Cinel; Cameron Alexander,17,0,30,13
1657436161417,MATH 18,A03,083745,Cinel; Cameron Alexander,9,0,30,21
1657436161417,MATH 18,B01,083748,Rideout; David Porter,5,0,37,32
1657436161417,MATH 18,B02,083749,Rideout; David Porter,5,0,36,31
1657436161417,MATH 18,B03,083750,Rideout; David Porter,3,0,37,34
1657436161417,MATH 18,B04,083751,Rideout; David Porter,6,0,36,30
1657436161417,MATH 18,B05,093473,Rideout; David Porter,6,0,36,30
1657436161417,MATH 18,B06,093474,Rideout; David Porter,6,0,36,30
1657436167443,MATH 20A,A01,083754,Zheng; Zequn,14,0,40,26
1657436173466,MATH 20B,A01,083756,Briones; Jor-el Thomas Caparas,4,0,36,32
1657436173466,MATH 20B,A02,083757,Briones; Jor-el Thomas Caparas,1,0,36,35
1657436173466,MATH 20B,A03,093475,Briones; Jor-el Thomas Caparas,2,0,36,34
1657436179494,MATH 20C,A01,083760,Briones; Jor-el Thomas Caparas,1,0,35,34
1657436179494,MATH 20C,A02,083761,Briones; Jor-el Thomas Caparas,8,0,35,27
1657436179494,MATH 20C,A03,093476,Briones; Jor-el Thomas Caparas,0,1,36,36
1657436179494,MATH 20C,B01,083762,Bach; Quang Tran,1,0,30,29
1657436185517,MATH 20D,A01,083765,Tran; Brian Kha,5,0,30,25
1657436185517,MATH 20D,A02,083766,Tran; Brian Kha,5,0,30,25
1657436185517,MATH 20D,A03,083767,Tran; Brian Kha,5,0,30,25
1657436191542,MATH 20E,A01,083771,Ganguly; Soumya,9,0,32,23
1657436191542,MATH 20E,A02,083772,Ganguly; Soumya,6,0,32,26
1657436191542,MATH 20E,B01,083773,Ciotti; Benjamin,20,0,35,15
1657436191542,MATH 20E,B02,083774,Ciotti; Benjamin,17,0,35,18
1657436197565,MATH 103A,A01,083777,Greenfeld; Be'Eri,3,0,36,33
1657436197565,MATH 103A,A02,083778,Greenfeld; Be'Eri,5,0,36,31
1657436197565,MATH 103A,A03,093561,Greenfeld; Be'Eri,5,0,36,31
1657436197565,MATH 103A,B01,083779,Greenfeld; Be'Eri,7,0,36,29
1657436197565,MATH 103A,B02,083780,Greenfeld; Be'Eri,4,0,36,32
1657436197565,MATH 103A,B03,093562,Greenfeld; Be'Eri,3,0,36,33
1657436203586,MATH 105,A01,085443,Carter; Anne Toulson,15,0,35,20
1657436203586,MATH 105,A02,093477,Carter; Anne Toulson,20,0,35,15
1657436209608,MATH 109,A01,083213,Ganzberger; Geoffrey Michael,2,0,34,32
1657436209608,MATH 109,A02,083214,Ganzberger; Geoffrey Michael,4,0,34,30
1657436209608,MATH 109,A03,093478,Ganzberger; Geoffrey Michael,2,0,34,32
1657436209608,MATH 109,B01,083215,Ganzberger; Geoffrey Michael,1,0,32,31
1657436209608,MATH 109,B02,083216,Ganzberger; Geoffrey Michael,2,0,32,30
1657436209608,MATH 109,B03,093479,Ganzberger; Geoffrey Michael,8,0,32,24
1657436215636,MATH 142A,A01,083219,Chow; Bennett,7,0,32,25
1657436215636,MATH 142A,A02,083220,Chow; Bennett,10,0,32,22
1657436215636,MATH 142A,A03,093480,Chow; Bennett,8,0,32,24
1657436215636,MATH 142A,B03,093481,Chow; Bennett,8,0,32,24
1657436215636,MATH 142A,B04,093558,Chow; Bennett,13,0,32,19
1657436215636,MATH 142A,B05,093559,Chow; Bennett,6,0,32,26
1657436221671,MATH 193A,A01,083224,Rotar; Vladimir,8,0,34,26
1657436221671,MATH 193A,A02,083225,Rotar; Vladimir,9,0,34,25
1657436221671,MATH 193A,A03,083781,Rotar; Vladimir,5,0,34,29
1657436221671,MATH 193A,A04,083782,Rotar; Vladimir,10,0,34,24
1657436221671,MATH 193A,A05,093482,Rotar; Vladimir,10,0,34,24
1657436227695,MATH 197,001,091859,McAuley; Julian John,9999,0,9999,0
1657436227695,MATH 197,002,095566,Kedlaya; Kiran S.,9997,0,9999,2
1657436227695,MATH 197,003,095567,Xiao; Ming,9999,0,9999,0
1657436227695,MATH 197,004,095571,Perols; Johan Lars,9998,0,9999,1
1657436234763,COGS 9,A01,083615,Shannon; Kyle Michael,9,0,75,66
1657436240790,COGS 11,A01,083617,Boyle; Mary E. T.,22,0,48,26
1657436246817,COGS 13,A01,083071,Bastos; Amalia Pinkusfeld,11,0,71,60
1657436252838,COGS 14A,A01,092681,Semenuks; Arturs,5,1,100,95
1657436258868,COGS 14B,A01,083073,Cheng; Tzu-Han,6,0,63,57
1657436264892,COGS 17,A01,092677,Semenuks; Arturs,6,0,81,75
1657436270920,COGS 100,A01,083619,Allen; Michael Gordon,17,0,70,53
1657436276944,COGS 101A,A01,083621,Davis; Joshua Daniel,9,0,68,59
1657436282972,COGS 101B,A01,091572,Allen; Michael Gordon,12,0,65,53
1657436288995,COGS 101C,A01,083625,Delgado; Tania,17,0,35,18
1657436295017,COGS 107A,A01,083627,Boyle; Mary E. T.,13,0,60,47
1657436301043,COGS 118A,A01,083075,Gupta; Anjum,21,0,76,55
1657436307066,CSE 3,A50,083646,Miranda; Gregory Joseph,24,0,50,26
1657436313095,CSE 8A,A50,083650,Miranda; Gregory Joseph,17,1,56,39
1657436319117,CSE 11,A01,083080,Cao; Yingjun,6,15,40,34
1657436325142,CSE 12,A01,083652,Krause-Levy; Sophia Louisa,28,1,120,92
1657436331168,CSE 15L,A01,083654,Morris; Justin Loren,9,0,50,41
1657436331168,CSE 15L,A02,083655,Morris; Justin Loren,9,0,50,41
1657436337193,CSE 20,A01,083657,Tran; Khoa Dang,39,0,80,41
1657436343217,CSE 21,A01,095574,Bach; Quang Tran,22,0,48,26
1657436349239,CSE 30,A01,083084,Eldon; John,5,0,80,75
1657436349239,CSE 30,B01,095061,Bhaskar; Nishant,9,0,50,41
1657436355265,CSE 100,A01,083659,Cao; Yingjun,5,4,70,65
1657436361288,CSE 134B,A01,083661,Powell; Thomas Allan,22,0,100,78
1657436367313,CSE 140,A01,083663,Gungor; Onat,15,0,85,70
1657436373338,CSE 140L,A01,083088,Eldon; John,21,0,100,79
1657436379361,CSE 175,A01,083665,Kumar; Rakesh,3,0,25,22
1657436385385,CSE 190,A00,092507,Dubnov; Shlomo,7,0,20,13
1657436391408,ECE 45,A01,083139,Congero; Spencer William,6,0,75,69
1657436397431,ECE 65,A50,083695,Saad; Andrew S,12,0,30,18
1657436397431,ECE 65,A51,095125,Saad; Andrew S,24,0,26,2
1657436403460,ECE 109,A01,091882,Touri; Behrouz,19,0,70,51
1657436409484,ECE 180,A00,083140,Abi Samra; Nicholas Camill,1,0,30,29
1657436409484,ECE 180,B00,083141,Abi Samra; Nicholas Camill,0,0,30,30
1657436415509,MATH 10A,A01,083735,Patchell; Gregory David,2,0,30,28
1657436415509,MATH 10A,A02,083736,Patchell; Gregory David,20,0,30,10
1657436415509,MATH 10A,A03,083737,Patchell; Gregory David,16,0,30,14
1657436421537,MATH 10B,A01,083207,Lim; Seonhee,8,0,34,26
1657436421537,MATH 10B,A02,083208,Lim; Seonhee,9,0,35,26
1657436421537,MATH 10B,A03,093472,Lim; Seonhee,7,0,34,27
1657436421537,MATH 10B,B01,083739,Sinha; Shubham,12,0,30,18
1657436427569,MATH 18,A01,083743,Cinel; Cameron Alexander,7,0,30,23
1657436427569,MATH 18,A02,083744,Cinel; Cameron Alexander,17,0,30,13
1657436427569,MATH 18,A03,083745,Cinel; Cameron Alexander,9,0,30,21
1657436427569,MATH 18,B01,083748,Rideout; David Porter,5,0,37,32
1657436427569,MATH 18,B02,083749,Rideout; David Porter,5,0,36,31
1657436427569,MATH 18,B03,083750,Rideout; David Porter,3,0,37,34
1657436427569,MATH 18,B04,083751,Rideout; David Porter,6,0,36,30
1657436427569,MATH 18,B05,093473,Rideout; David Porter,6,0,36,30
1657436427569,MATH 18,B06,093474,Rideout; David Porter,6,0,36,30
1657436433596,MATH 20A,A01,083754,Zheng; Zequn,14,0,40,26
1657436439700,MATH 20B,A01,083756,Briones; Jor-el Thomas Caparas,4,0,36,32
1657436439700,MATH 20B,A02,083757,Briones; Jor-el Thomas Caparas,1,0,36,35
1657436439700,MATH 20B,A03,093475,Briones; Jor-el Thomas Caparas,2,0,36,34
1657436445725,MATH 20C,A01,083760,Briones; Jor-el Thomas Caparas,1,0,35,34
1657436445725,MATH 20C,A02,083761,Briones; Jor-el Thomas Caparas,8,0,35,27
1657436445725,MATH 20C,A03,093476,Briones; Jor-el Thomas Caparas,0,1,36,36
1657436445725,MATH 20C,B01,083762,Bach; Quang Tran,1,0,30,29
1657436451752,MATH 20D,A01,083765,Tran; Brian Kha,5,0,30,25
1657436451752,MATH 20D,A02,083766,Tran; Brian Kha,5,0,30,25
1657436451752,MATH 20D,A03,083767,Tran; Brian Kha,5,0,30,25
1657436457781,MATH 20E,A01,083771,Ganguly; Soumya,9,0,32,23
1657436457781,MATH 20E,A02,083772,Ganguly; Soumya,6,0,32,26
1657436457781,MATH 20E,B01,083773,Ciotti; Benjamin,20,0,35,15
1657436457781,MATH 20E,B02,083774,Ciotti; Benjamin,17,0,35,18
1657436463804,MATH 103A,A01,083777,Greenfeld; Be'Eri,3,0,36,33
1657436463804,MATH 103A,A02,083778,Greenfeld; Be'Eri,5,0,36,31
1657436463804,MATH 103A,A03,093561,Greenfeld; Be'Eri,5,0,36,31
1657436463804,MATH 103A,B01,083779,Greenfeld; Be'Eri,7,0,36,29
1657436463804,MATH 103A,B02,083780,Greenfeld; Be'Eri,4,0,36,32
1657436463804,MATH 103A,B03,093562,Greenfeld; Be'Eri,3,0,36,33
1657436469831,MATH 105,A01,085443,Carter; Anne Toulson,15,0,35,20
1657436469831,MATH 105,A02,093477,Carter; Anne Toulson,20,0,35,15
1657436475855,MATH 109,A01,083213,Ganzberger; Geoffrey Michael,2,0,34,32
1657436475855,MATH 109,A02,083214,Ganzberger; Geoffrey Michael,4,0,34,30
1657436475855,MATH 109,A03,093478,Ganzberger; Geoffrey Michael,2,0,34,32
1657436475855,MATH 109,B01,083215,Ganzberger; Geoffrey Michael,1,0,32,31
1657436475855,MATH 109,B02,083216,Ganzberger; Geoffrey Michael,2,0,32,30
1657436475855,MATH 109,B03,093479,Ganzberger; Geoffrey Michael,8,0,32,24
1657436481878,MATH 142A,A01,083219,Chow; Bennett,7,0,32,25
1657436481878,MATH 142A,A02,083220,Chow; Bennett,10,0,32,22
1657436481878,MATH 142A,A03,093480,Chow; Bennett,8,0,32,24
1657436481878,MATH 142A,B03,093481,Chow; Bennett,8,0,32,24
1657436481878,MATH 142A,B04,093558,Chow; Bennett,13,0,32,19
1657436481878,MATH 142A,B05,093559,Chow; Bennett,6,0,32,26
1657436487907,MATH 193A,A01,083224,Rotar; Vladimir,8,0,34,26
1657436487907,MATH 193A,A02,083225,Rotar; Vladimir,9,0,34,25
1657436487907,MATH 193A,A03,083781,Rotar; Vladimir,5,0,34,29
1657436487907,MATH 193A,A04,083782,Rotar; Vladimir,10,0,34,24
1657436487907,MATH 193A,A05,093482,Rotar; Vladimir,10,0,34,24
1657436493930,MATH 197,001,091859,McAuley; Julian John,9999,0,9999,0
1657436493930,MATH 197,002,095566,Kedlaya; Kiran S.,9997,0,9999,2
1657436493930,MATH 197,003,095567,Xiao; Ming,9999,0,9999,0
1657436493930,MATH 197,004,095571,Perols; Johan Lars,9998,0,9999,1
1657436500985,COGS 9,A01,083615,Shannon; Kyle Michael,9,0,75,66
1657436507030,COGS 11,A01,083617,Boyle; Mary E. T.,22,0,48,26
1657436513053,COGS 13,A01,083071,Bastos; Amalia Pinkusfeld,11,0,71,60
1657436519078,COGS 14A,A01,092681,Semenuks; Arturs,5,1,100,95
1657436525103,COGS 14B,A01,083073,Cheng; Tzu-Han,6,0,63,57
1657436531131,COGS 17,A01,092677,Semenuks; Arturs,6,0,81,75
1657436537159,COGS 100,A01,083619,Allen; Michael Gordon,17,0,70,53
1657436543183,COGS 101A,A01,083621,Davis; Joshua Daniel,9,0,68,59
1657436549205,COGS 101B,A01,091572,Allen; Michael Gordon,12,0,65,53
1657436555229,COGS 101C,A01,083625,Delgado; Tania,17,0,35,18
1657436561253,COGS 107A,A01,083627,Boyle; Mary E. T.,13,0,60,47
1657436567277,COGS 118A,A01,083075,Gupta; Anjum,21,0,76,55
1657436573315,CSE 3,A50,083646,Miranda; Gregory Joseph,24,0,50,26
1657436579344,CSE 8A,A50,083650,Miranda; Gregory Joseph,17,1,56,39
1657436585366,CSE 11,A01,083080,Cao; Yingjun,6,15,40,34
1657436591389,CSE 12,A01,083652,Krause-Levy; Sophia Louisa,28,1,120,92
1657436597411,CSE 15L,A01,083654,Morris; Justin Loren,9,0,50,41
1657436597411,CSE 15L,A02,083655,Morris; Justin Loren,9,0,50,41
1657436603435,CSE 20,A01,083657,Tran; Khoa Dang,39,0,80,41
1657436609457,CSE 21,A01,095574,Bach; Quang Tran,22,0,48,26
1657436615480,CSE 30,A01,083084,Eldon; John,5,0,80,75
1657436615480,CSE 30,B01,095061,Bhaskar; Nishant,9,0,50,41
1657436621509,CSE 100,A01,083659,Cao; Yingjun,5,4,70,65
1657436627539,CSE 134B,A01,083661,Powell; Thomas Allan,22,0,100,78
1657436633566,CSE 140,A01,083663,Gungor; Onat,15,0,85,70
1657436639593,CSE 140L,A01,083088,Eldon; John,21,0,100,79
1657436645619,CSE 175,A01,083665,Kumar; Rakesh,3,0,25,22
1657436651642,CSE 190,A00,092507,Dubnov; Shlomo,7,0,20,13
1657436657664,ECE 45,A01,083139,Congero; Spencer William,6,0,75,69
1657436663692,ECE 65,A50,083695,Saad; Andrew S,12,0,30,18
1657436663692,ECE 65,A51,095125,Saad; Andrew S,24,0,26,2
1657436669715,ECE 109,A01,091882,Touri; Behrouz,19,0,70,51
1657436675738,ECE 180,A00,083140,Abi Samra; Nicholas Camill,1,0,30,29
1657436675738,ECE 180,B00,083141,Abi Samra; Nicholas Camill,0,0,30,30
1657436681763,MATH 10A,A01,083735,Patchell; Gregory David,2,0,30,28
1657436681763,MATH 10A,A02,083736,Patchell; Gregory David,20,0,30,10
1657436681763,MATH 10A,A03,083737,Patchell; Gregory David,16,0,30,14
1657436687787,MATH 10B,A01,083207,Lim; Seonhee,8,0,34,26
1657436687787,MATH 10B,A02,083208,Lim; Seonhee,9,0,35,26
1657436687787,MATH 10B,A03,093472,Lim; Seonhee,7,0,34,27
1657436687787,MATH 10B,B01,083739,Sinha; Shubham,12,0,30,18
1657436693811,MATH 18,A01,083743,Cinel; Cameron Alexander,7,0,30,23
1657436693811,MATH 18,A02,083744,Cinel; Cameron Alexander,17,0,30,13
1657436693811,MATH 18,A03,083745,Cinel; Cameron Alexander,9,0,30,21
1657436693811,MATH 18,B01,083748,Rideout; David Porter,5,0,37,32
1657436693811,MATH 18,B02,083749,Rideout; David Porter,5,0,36,31
1657436693811,MATH 18,B03,083750,Rideout; David Porter,3,0,37,34
1657436693811,MATH 18,B04,083751,Rideout; David Porter,6,0,36,30
1657436693811,MATH 18,B05,093473,Rideout; David Porter,6,0,36,30
1657436693811,MATH 18,B06,093474,Rideout; David Porter,6,0,36,30
1657436699835,MATH 20A,A01,083754,Zheng; Zequn,14,0,40,26
1657436705864,MATH 20B,A01,083756,Briones; Jor-el Thomas Caparas,4,0,36,32
1657436705864,MATH 20B,A02,083757,Briones; Jor-el Thomas Caparas,1,0,36,35
1657436705864,MATH 20B,A03,093475,Briones; Jor-el Thomas Caparas,2,0,36,34
1657436711893,MATH 20C,A01,083760,Briones; Jor-el Thomas Caparas,1,0,35,34
1657436711893,MATH 20C,A02,083761,Briones; Jor-el Thomas Caparas,8,0,35,27
1657436711893,MATH 20C,A03,093476,Briones; Jor-el Thomas Caparas,0,1,36,36
1657436711893,MATH 20C,B01,083762,Bach; Quang Tran,1,0,30,29
1657436717917,MATH 20D,A01,083765,Tran; Brian Kha,5,0,30,25
1657436717917,MATH 20D,A02,083766,Tran; Brian Kha,5,0,30,25
1657436717917,MATH 20D,A03,083767,Tran; Brian Kha,5,0,30,25
1657436723947,MATH 20E,A01,083771,Ganguly; Soumya,9,0,32,23
1657436723947,MATH 20E,A02,083772,Ganguly; Soumya,6,0,32,26
1657436723947,MATH 20E,B01,083773,Ciotti; Benjamin,20,0,35,15
1657436723947,MATH 20E,B02,083774,Ciotti; Benjamin,17,0,35,18
1657436729976,MATH 103A,A01,083777,Greenfeld; Be'Eri,3,0,36,33
1657436729976,MATH 103A,A02,083778,Greenfeld; Be'Eri,5,0,36,31
1657436729976,MATH 103A,A03,093561,Greenfeld; Be'Eri,5,0,36,31
1657436729976,MATH 103A,B01,083779,Greenfeld; Be'Eri,7,0,36,29
1657436729976,MATH 103A,B02,083780,Greenfeld; Be'Eri,4,0,36,32
1657436729976,MATH 103A,B03,093562,Greenfeld; Be'Eri,3,0,36,33
1657436736006,MATH 105,A01,085443,Carter; Anne Toulson,15,0,35,20
1657436736006,MATH 105,A02,093477,Carter; Anne Toulson,20,0,35,15
1657436742030,MATH 109,A01,083213,Ganzberger; Geoffrey Michael,2,0,34,32
1657436742030,MATH 109,A02,083214,Ganzberger; Geoffrey Michael,4,0,34,30
1657436742030,MATH 109,A03,093478,Ganzberger; Geoffrey Michael,2,0,34,32
1657436742030,MATH 109,B01,083215,Ganzberger; Geoffrey Michael,1,0,32,31
1657436742030,MATH 109,B02,083216,Ganzberger; Geoffrey Michael,2,0,32,30
1657436742030,MATH 109,B03,093479,Ganzberger; Geoffrey Michael,8,0,32,24
1657436748060,MATH 142A,A01,083219,Chow; Bennett,7,0,32,25
1657436748060,MATH 142A,A02,083220,Chow; Bennett,10,0,32,22
1657436748060,MATH 142A,A03,093480,Chow; Bennett,8,0,32,24
1657436748060,MATH 142A,B03,093481,Chow; Bennett,8,0,32,24
1657436748060,MATH 142A,B04,093558,Chow; Bennett,13,0,32,19
1657436748060,MATH 142A,B05,093559,Chow; Bennett,6,0,32,26
1657436754086,MATH 193A,A01,083224,Rotar; Vladimir,8,0,34,26
1657436754086,MATH 193A,A02,083225,Rotar; Vladimir,9,0,34,25
1657436754086,MATH 193A,A03,083781,Rotar; Vladimir,5,0,34,29
1657436754086,MATH 193A,A04,083782,Rotar; Vladimir,10,0,34,24
1657436754086,MATH 193A,A05,093482,Rotar; Vladimir,10,0,34,24
1657436760108,MATH 197,001,091859,McAuley; Julian John,9999,0,9999,0
1657436760108,MATH 197,002,095566,Kedlaya; Kiran S.,9997,0,9999,2
1657436760108,MATH 197,003,095567,Xiao; Ming,9999,0,9999,0
1657436760108,MATH 197,004,095571,Perols; Johan Lars,9998,0,9999,1
1657436767183,COGS 9,A01,083615,Shannon; Kyle Michael,9,0,75,66
1657436773206,COGS 11,A01,083617,Boyle; Mary E. T.,22,0,48,26
1657436779232,COGS 13,A01,083071,Bastos; Amalia Pinkusfeld,11,0,71,60
1657436785259,COGS 14A,A01,092681,Semenuks; Arturs,5,1,100,95
1657436791287,COGS 14B,A01,083073,Cheng; Tzu-Han,6,0,63,57
1657436797316,COGS 17,A01,092677,Semenuks; Arturs,6,0,81,75
1657436803340,COGS 100,A01,083619,Allen; Michael Gordon,17,0,70,53
1657436809362,COGS 101A,A01,083621,Davis; Joshua Daniel,9,0,68,59
1657436815393,COGS 101B,A01,091572,Allen; Michael Gordon,12,0,65,53
1657436821422,COGS 101C,A01,083625,Delgado; Tania,17,0,35,18
1657436827448,COGS 107A,A01,083627,Boyle; Mary E. T.,13,0,60,47
1657436833477,COGS 118A,A01,083075,Gupta; Anjum,21,0,76,55
1657436839500,CSE 3,A50,083646,Miranda; Gregory Joseph,24,0,50,26
1657436845525,CSE 8A,A50,083650,Miranda; Gregory Joseph,17,1,56,39
1657436851548,CSE 11,A01,083080,Cao; Yingjun,6,15,40,34
1657436857574,CSE 12,A01,083652,Krause-Levy; Sophia Louisa,28,1,120,92
1657436863597,CSE 15L,A01,083654,Morris; Justin Loren,9,0,50,41
1657436863597,CSE 15L,A02,083655,Morris; Justin Loren,9,0,50,41
1657436869620,CSE 20,A01,083657,Tran; Khoa Dang,39,0,80,41
1657436875648,CSE 21,A01,095574,Bach; Quang Tran,22,0,48,26
1657436881676,CSE 30,A01,083084,Eldon; John,5,0,80,75
1657436881676,CSE 30,B01,095061,Bhaskar; Nishant,9,0,50,41
1657436887712,CSE 100,A01,083659,Cao; Yingjun,5,4,70,65
1657436893741,CSE 134B,A01,083661,Powell; Thomas Allan,22,0,100,78
1657436899763,CSE 140,A01,083663,Gungor; Onat,15,0,85,70
1657436905794,CSE 140L,A01,083088,Eldon; John,21,0,100,79
1657436911819,CSE 175,A01,083665,Kumar; Rakesh,3,0,25,22
1657436917845,CSE 190,A00,092507,Dubnov; Shlomo,7,0,20,13
1657436923872,ECE 45,A01,083139,Congero; Spencer William,6,0,75,69
1657436929901,ECE 65,A50,083695,Saad; Andrew S,12,0,30,18
1657436929901,ECE 65,A51,095125,Saad; Andrew S,24,0,26,2
1657436935930,ECE 109,A01,091882,Touri; Behrouz,19,0,70,51
1657436941966,ECE 180,A00,083140,Abi Samra; Nicholas Camill,1,0,30,29
1657436941966,ECE 180,B00,083141,Abi Samra; Nicholas Camill,0,0,30,30
1657436947991,MATH 10A,A01,083735,Patchell; Gregory David,2,0,30,28
1657436947991,MATH 10A,A02,083736,Patchell; Gregory David,20,0,30,10
1657436947991,MATH 10A,A03,083737,Patchell; Gregory David,16,0,30,14
1657436954020,MATH 10B,A01,083207,Lim; Seonhee,8,0,34,26
1657436954020,MATH 10B,A02,083208,Lim; Seonhee,9,0,35,26
1657436954020,MATH 10B,A03,093472,Lim; Seonhee,7,0,34,27
1657436954020,MATH 10B,B01,083739,Sinha; Shubham,12,0,30,18
1657436960053,MATH 18,A01,083743,Cinel; Cameron Alexander,7,0,30,23
1657436960053,MATH 18,A02,083744,Cinel; Cameron Alexander,17,0,30,13
1657436960053,MATH 18,A03,083745,Cinel; Cameron Alexander,9,0,30,21
1657436960053,MATH 18,B01,083748,Rideout; David Porter,5,0,37,32
1657436960053,MATH 18,B02,083749,Rideout; David Porter,5,0,36,31
1657436960053,MATH 18,B03,083750,Rideout; David Porter,3,0,37,34
1657436960053,MATH 18,B04,083751,Rideout; David Porter,6,0,36,30
1657436960053,MATH 18,B05,093473,Rideout; David Porter,6,0,36,30
1657436960053,MATH 18,B06,093474,Rideout; David Porter,6,0,36,30
1657436966076,MATH 20A,A01,083754,Zheng; Zequn,14,0,40,26
1657436972106,MATH 20B,A01,083756,Briones; Jor-el Thomas Caparas,4,0,36,32
1657436972106,MATH 20B,A02,083757,Briones; Jor-el Thomas Caparas,1,0,36,35
1657436972106,MATH 20B,A03,093475,Briones; Jor-el Thomas Caparas,2,0,36,34
1657436978130,MATH 20C,A01,083760,Briones; Jor-el Thomas Caparas,1,0,35,34
1657436978130,MATH 20C,A02,083761,Briones; Jor-el Thomas Caparas,8,0,35,27
1657436978130,MATH 20C,A03,093476,Briones; Jor-el Thomas Caparas,0,1,36,36
1657436978130,MATH 20C,B01,083762,Bach; Quang Tran,1,0,30,29
1657436984154,MATH 20D,A01,083765,Tran; Brian Kha,5,0,30,25
1657436984154,MATH 20D,A02,083766,Tran; Brian Kha,5,0,30,25
1657436984154,MATH 20D,A03,083767,Tran; Brian Kha,5,0,30,25
1657436990189,MATH 20E,A01,083771,Ganguly; Soumya,9,0,32,23
1657436990189,MATH 20E,A02,083772,Ganguly; Soumya,6,0,32,26
1657436990189,MATH 20E,B01,083773,Ciotti; Benjamin,20,0,35,15
1657436990189,MATH 20E,B02,083774,Ciotti; Benjamin,17,0,35,18
1657436996212,MATH 103A,A01,083777,Greenfeld; Be'Eri,3,0,36,33
1657436996212,MATH 103A,A02,083778,Greenfeld; Be'Eri,5,0,36,31
1657436996212,MATH 103A,A03,093561,Greenfeld; Be'Eri,5,0,36,31
1657436996212,MATH 103A,B01,083779,Greenfeld; Be'Eri,7,0,36,29
1657436996212,MATH 103A,B02,083780,Greenfeld; Be'Eri,4,0,36,32
1657436996212,MATH 103A,B03,093562,Greenfeld; Be'Eri,3,0,36,33
1657437002238,MATH 105,A01,085443,Carter; Anne Toulson,15,0,35,20
1657437002238,MATH 105,A02,093477,Carter; Anne Toulson,20,0,35,15
1657437008261,MATH 109,A01,083213,Ganzberger; Geoffrey Michael,2,0,34,32
1657437008261,MATH 109,A02,083214,Ganzberger; Geoffrey Michael,4,0,34,30
1657437008261,MATH 109,A03,093478,Ganzberger; Geoffrey Michael,2,0,34,32
1657437008261,MATH 109,B01,083215,Ganzberger; Geoffrey Michael,1,0,32,31
1657437008261,MATH 109,B02,083216,Ganzberger; Geoffrey Michael,2,0,32,30
1657437008261,MATH 109,B03,093479,Ganzberger; Geoffrey Michael,8,0,32,24
1657437014294,MATH 142A,A01,083219,Chow; Bennett,7,0,32,25
1657437014294,MATH 142A,A02,083220,Chow; Bennett,10,0,32,22
1657437014294,MATH 142A,A03,093480,Chow; Bennett,8,0,32,24
1657437014294,MATH 142A,B03,093481,Chow; Bennett,8,0,32,24
1657437014294,MATH 142A,B04,093558,Chow; Bennett,13,0,32,19
1657437014294,MATH 142A,B05,093559,Chow; Bennett,6,0,32,26
1657437020326,MATH 193A,A01,083224,Rotar; Vladimir,8,0,34,26
1657437020326,MATH 193A,A02,083225,Rotar; Vladimir,9,0,34,25
1657437020326,MATH 193A,A03,083781,Rotar; Vladimir,5,0,34,29
1657437020326,MATH 193A,A04,083782,Rotar; Vladimir,10,0,34,24
1657437020326,MATH 193A,A05,093482,Rotar; Vladimir,10,0,34,24
1657437026355,MATH 197,001,091859,McAuley; Julian John,9999,0,9999,0
1657437026355,MATH 197,002,095566,Kedlaya; Kiran S.,9997,0,9999,2
1657437026355,MATH 197,003,095567,Xiao; Ming,9999,0,9999,0
1657437026355,MATH 197,004,095571,Perols; Johan Lars,9998,0,9999,1
1657437033505,COGS 9,A01,083615,Shannon; Kyle Michael,9,0,75,66
1657437039529,COGS 11,A01,083617,Boyle; Mary E. T.,22,0,48,26
1657437045559,COGS 13,A01,083071,Bastos; Amalia Pinkusfeld,11,0,71,60
1657437051583,COGS 14A,A01,092681,Semenuks; Arturs,5,1,100,95
1657437057609,COGS 14B,A01,083073,Cheng; Tzu-Han,6,0,63,57
1657437063637,COGS 17,A01,092677,Semenuks; Arturs,6,0,81,75
1657437069670,COGS 100,A01,083619,Allen; Michael Gordon,17,0,70,53
1657437075702,COGS 101A,A01,083621,Davis; Joshua Daniel,9,0,68,59
1657437081734,COGS 101B,A01,091572,Allen; Michael Gordon,12,0,65,53
1657437087759,COGS 101C,A01,083625,Delgado; Tania,17,0,35,18
1657437093784,COGS 107A,A01,083627,Boyle; Mary E. T.,13,0,60,47
1657437099809,COGS 118A,A01,083075,Gupta; Anjum,21,0,76,55
1657437105842,CSE 3,A50,083646,Miranda; Gregory Joseph,24,0,50,26
1657437111872,CSE 8A,A50,083650,Miranda; Gregory Joseph,17,1,56,39
1657437117902,CSE 11,A01,083080,Cao; Yingjun,6,15,40,34
1657437123966,CSE 12,A01,083652,Krause-Levy; Sophia Louisa,28,1,120,92
1657437129990,CSE 15L,A01,083654,Morris; Justin Loren,9,0,50,41
1657437129990,CSE 15L,A02,083655,Morris; Justin Loren,9,0,50,41
1657437136017,CSE 20,A01,083657,Tran; Khoa Dang,39,0,80,41
1657437142048,CSE 21,A01,095574,Bach; Quang Tran,22,0,48,26
1657437148082,CSE 30,A01,083084,Eldon; John,5,0,80,75
1657437148082,CSE 30,B01,095061,Bhaskar; Nishant,9,0,50,41
1657437154116,CSE 100,A01,083659,Cao; Yingjun,5,4,70,65
1657437160142,CSE 134B,A01,083661,Powell; Thomas Allan,22,0,100,78
1657437166167,CSE 140,A01,083663,Gungor; Onat,15,0,85,70
1657437172191,CSE 140L,A01,083088,Eldon; John,21,0,100,79
1657437178223,CSE 175,A01,083665,Kumar; Rakesh,3,0,25,22
1657437184258,CSE 190,A00,092507,Dubnov; Shlomo,7,0,20,13
1657437190286,ECE 45,A01,083139,Congero; Spencer William,6,0,75,69
1657437196317,ECE 65,A50,083695,Saad; Andrew S,12,0,30,18
1657437196317,ECE 65,A51,095125,Saad; Andrew S,24,0,26,2
1657437202346,ECE 109,A01,091882,Touri; Behrouz,19,0,70,51
1657437208380,ECE 180,A00,083140,Abi Samra; Nicholas Camill,1,0,30,29
1657437208380,ECE 180,B00,083141,Abi Samra; Nicholas Camill,0,0,30,30
1657437214406,MATH 10A,A01,083735,Patchell; Gregory David,2,0,30,28
1657437214406,MATH 10A,A02,083736,Patchell; Gregory David,20,0,30,10
1657437214406,MATH 10A,A03,083737,Patchell; Gregory David,16,0,30,14
1657437220433,MATH 10B,A01,083207,Lim; Seonhee,8,0,34,26
1657437220433,MATH 10B,A02,083208,Lim; Seonhee,9,0,35,26
1657437220433,MATH 10B,A03,093472,Lim; Seonhee,7,0,34,27
1657437220433,MATH 10B,B01,083739,Sinha; Shubham,12,0,30,18
1657437226459,MATH 18,A01,083743,Cinel; Cameron Alexander,7,0,30,23
1657437226459,MATH 18,A02,083744,Cinel; Cameron Alexander,17,0,30,13
1657437226459,MATH 18,A03,083745,Cinel; Cameron Alexander,9,0,30,21
1657437226459,MATH 18,B01,083748,Rideout; David Porter,5,0,37,32
1657437226459,MATH 18,B02,083749,Rideout; David Porter,5,0,36,31
1657437226459,MATH 18,B03,083750,Rideout; David Porter,3,0,37,34
1657437226459,MATH 18,B04,083751,Rideout; David Porter,6,0,36,30
1657437226459,MATH 18,B05,093473,Rideout; David Porter,6,0,36,30
1657437226459,MATH 18,B06,093474,Rideout; David Porter,6,0,36,30
1657437232483,MATH 20A,A01,083754,Zheng; Zequn,14,0,40,26
1657437238565,MATH 20B,A01,083756,Briones; Jor-el Thomas Caparas,4,0,36,32
1657437238565,MATH 20B,A02,083757,Briones; Jor-el Thomas Caparas,1,0,36,35
1657437238565,MATH 20B,A03,093475,Briones; Jor-el Thomas Caparas,2,0,36,34
1657437244595,MATH 20C,A01,083760,Briones; Jor-el Thomas Caparas,1,0,35,34
1657437244595,MATH 20C,A02,083761,Briones; Jor-el Thomas Caparas,8,0,35,27
1657437244595,MATH 20C,A03,093476,Briones; Jor-el Thomas Caparas,0,1,36,36
1657437244595,MATH 20C,B01,083762,Bach; Quang Tran,1,0,30,29
1657437250628,MATH 20D,A01,083765,Tran; Brian Kha,5,0,30,25
1657437250628,MATH 20D,A02,083766,Tran; Brian Kha,5,0,30,25
1657437250628,MATH 20D,A03,083767,Tran; Brian Kha,5,0,30,25
1657437256667,MATH 20E,A01,083771,Ganguly; Soumya,9,0,32,23
1657437256667,MATH 20E,A02,083772,Ganguly; Soumya,6,0,32,26
1657437256667,MATH 20E,B01,083773,Ciotti; Benjamin,20,0,35,15
1657437256667,MATH 20E,B02,083774,Ciotti; Benjamin,17,0,35,18
1657437262692,MATH 103A,A01,083777,Greenfeld; Be'Eri,3,0,36,33
1657437262692,MATH 103A,A02,083778,Greenfeld; Be'Eri,5,0,36,31
1657437262692,MATH 103A,A03,093561,Greenfeld; Be'Eri,5,0,36,31
1657437262692,MATH 103A,B01,083779,Greenfeld; Be'Eri,7,0,36,29
1657437262692,MATH 103A,B02,083780,Greenfeld; Be'Eri,4,0,36,32
1657437262692,MATH 103A,B03,093562,Greenfeld; Be'Eri,3,0,36,33
1657437268741,MATH 105,A01,085443,Carter; Anne Toulson,15,0,35,20
1657437268741,MATH 105,A02,093477,Carter; Anne Toulson,20,0,35,15
1657437274785,MATH 109,A01,083213,Ganzberger; Geoffrey Michael,2,0,34,32
1657437274785,MATH 109,A02,083214,Ganzberger; Geoffrey Michael,4,0,34,30
1657437274785,MATH 109,A03,093478,Ganzberger; Geoffrey Michael,2,0,34,32
1657437274785,MATH 109,B01,083215,Ganzberger; Geoffrey Michael,1,0,32,31
1657437274785,MATH 109,B02,083216,Ganzberger; Geoffrey Michael,2,0,32,30
1657437274785,MATH 109,B03,093479,Ganzberger; Geoffrey Michael,8,0,32,24
1657437280816,MATH 142A,A01,083219,Chow; Bennett,7,0,32,25
1657437280816,MATH 142A,A02,083220,Chow; Bennett,10,0,32,22
1657437280816,MATH 142A,A03,093480,Chow; Bennett,8,0,32,24
1657437280816,MATH 142A,B03,093481,Chow; Bennett,8,0,32,24
1657437280816,MATH 142A,B04,093558,Chow; Bennett,13,0,32,19
1657437280816,MATH 142A,B05,093559,Chow; Bennett,6,0,32,26
1657437286887,MATH 193A,A01,083224,Rotar; Vladimir,8,0,34,26
1657437286887,MATH 193A,A02,083225,Rotar; Vladimir,9,0,34,25
1657437286887,MATH 193A,A03,083781,Rotar; Vladimir,5,0,34,29
1657437286887,MATH 193A,A04,083782,Rotar; Vladimir,10,0,34,24
1657437286887,MATH 193A,A05,093482,Rotar; Vladimir,10,0,34,24
1657437292913,MATH 197,001,091859,McAuley; Julian John,9999,0,9999,0
1657437292913,MATH 197,002,095566,Kedlaya; Kiran S.,9997,0,9999,2
1657437292913,MATH 197,003,095567,Xiao; Ming,9999,0,9999,0
1657437292913,MATH 197,004,095571,Perols; Johan Lars,9998,0,9999,1
1657437299993,COGS 9,A01,083615,Shannon; Kyle Michael,9,0,75,66
1657437306022,COGS 11,A01,083617,Boyle; Mary E. T.,22,0,48,26
1657437312050,COGS 13,A01,083071,Bastos; Amalia Pinkusfeld,11,0,71,60
1657437318074,COGS 14A,A01,092681,Semenuks; Arturs,5,1,100,95
1657437324111,COGS 14B,A01,083073,Cheng; Tzu-Han,6,0,63,57
1657437330156,COGS 17,A01,092677,Semenuks; Arturs,6,0,81,75
1657437336185,COGS 100,A01,083619,Allen; Michael Gordon,17,0,70,53
1657437342209,COGS 101A,A01,083621,Davis; Joshua Daniel,9,0,68,59
1657437348232,COGS 101B,A01,091572,Allen; Michael Gordon,12,0,65,53
1657437354266,COGS 101C,A01,083625,Delgado; Tania,17,0,35,18
1657437360290,COGS 107A,A01,083627,Boyle; Mary E. T.,13,0,60,47
1657437366374,COGS 118A,A01,083075,Gupta; Anjum,21,0,76,55
1657437372399,CSE 3,A50,083646,Miranda; Gregory Joseph,24,0,50,26
1657437378428,CSE 8A,A50,083650,Miranda; Gregory Joseph,17,1,56,39
1657437384456,CSE 11,A01,083080,Cao; Yingjun,6,15,40,34
1657437390479,CSE 12,A01,083652,Krause-Levy; Sophia Louisa,28,1,120,92
1657437396505,CSE 15L,A01,083654,Morris; Justin Loren,9,0,50,41
1657437396505,CSE 15L,A02,083655,Morris; Justin Loren,9,0,50,41
1657437402534,CSE 20,A01,083657,Tran; Khoa Dang,39,0,80,41
1657437408562,CSE 21,A01,095574,Bach; Quang Tran,22,0,48,26
1657437414593,CSE 30,A01,083084,Eldon; John,5,0,80,75
1657437414593,CSE 30,B01,095061,Bhaskar; Nishant,9,0,50,41
1657437420623,CSE 100,A01,083659,Cao; Yingjun,5,4,70,65
1657437426647,CSE 134B,A01,083661,Powell; Thomas Allan,22,0,100,78
1657437432680,CSE 140,A01,083663,Gungor; Onat,15,0,85,70
1657437438704,CSE 140L,A01,083088,Eldon; John,21,0,100,79
1657437444732,CSE 175,A01,083665,Kumar; Rakesh,3,0,25,22
1657437450759,CSE 190,A00,092507,Dubnov; Shlomo,7,0,20,13
1657437456783,ECE 45,A01,083139,Congero; Spencer William,6,0,75,69
1657437462809,ECE 65,A50,083695,Saad; Andrew S,12,0,30,18
1657437462809,ECE 65,A51,095125,Saad; Andrew S,24,0,26,2
1657437468837,ECE 109,A01,091882,Touri; Behrouz,19,0,70,51
1657437474864,ECE 180,A00,083140,Abi Samra; Nicholas Camill,1,0,30,29
1657437474864,ECE 180,B00,083141,Abi Samra; Nicholas Camill,0,0,30,30
1657437480892,MATH 10A,A01,083735,Patchell; Gregory David,2,0,30,28
1657437480892,MATH 10A,A02,083736,Patchell; Gregory David,20,0,30,10
1657437480892,MATH 10A,A03,083737,Patchell; Gregory David,16,0,30,14
1657437486926,MATH 10B,A01,083207,Lim; Seonhee,8,0,34,26
1657437486926,MATH 10B,A02,083208,Lim; Seonhee,9,0,35,26
1657437486926,MATH 10B,A03,093472,Lim; Seonhee,7,0,34,27
1657437486926,MATH 10B,B01,083739,Sinha; Shubham,12,0,30,18
1657437492959,MATH 18,A01,083743,Cinel; Cameron Alexander,7,0,30,23
1657437492959,MATH 18,A02,083744,Cinel; Cameron Alexander,17,0,30,13
1657437492959,MATH 18,A03,083745,Cinel; Cameron Alexander,9,0,30,21
1657437492959,MATH 18,B01,083748,Rideout; David Porter,5,0,37,32
1657437492959,MATH 18,B02,083749,Rideout; David Porter,5,0,36,31
1657437492959,MATH 18,B03,083750,Rideout; David Porter,3,0,37,34
1657437492959,MATH 18,B04,083751,Rideout; David Porter,6,0,36,30
1657437492959,MATH 18,B05,093473,Rideout; David Porter,6,0,36,30
1657437492959,MATH 18,B06,093474,Rideout; David Porter,6,0,36,30
1657437498987,MATH 20A,A01,083754,Zheng; Zequn,14,0,40,26
1657437505017,MATH 20B,A01,083756,Briones; Jor-el Thomas Caparas,4,0,36,32
1657437505017,MATH 20B,A02,083757,Briones; Jor-el Thomas Caparas,1,0,36,35
1657437505017,MATH 20B,A03,093475,Briones; Jor-el Thomas Caparas,2,0,36,34
1657437511057,MATH 20C,A01,083760,Briones; Jor-el Thomas Caparas,1,0,35,34
1657437511057,MATH 20C,A02,083761,Briones; Jor-el Thomas Caparas,8,0,35,27
1657437511057,MATH 20C,A03,093476,Briones; Jor-el Thomas Caparas,0,1,36,36
1657437511057,MATH 20C,B01,083762,Bach; Quang Tran,1,0,30,29
1657437517087,MATH 20D,A01,083765,Tran; Brian Kha,5,0,30,25
1657437517087,MATH 20D,A02,083766,Tran; Brian Kha,5,0,30,25
1657437517087,MATH 20D,A03,083767,Tran; Brian Kha,5,0,30,25
1657437523119,MATH 20E,A01,083771,Ganguly; Soumya,9,0,32,23
1657437523119,MATH 20E,A02,083772,Ganguly; Soumya,6,0,32,26
1657437523119,MATH 20E,B01,083773,Ciotti; Benjamin,20,0,35,15
1657437523119,MATH 20E,B02,083774,Ciotti; Benjamin,17,0,35,18
1657437529144,MATH 103A,A01,083777,Greenfeld; Be'Eri,3,0,36,33
1657437529144,MATH 103A,A02,083778,Greenfeld; Be'Eri,5,0,36,31
1657437529144,MATH 103A,A03,093561,Greenfeld; Be'Eri,5,0,36,31
1657437529144,MATH 103A,B01,083779,Greenfeld; Be'Eri,7,0,36,29
1657437529144,MATH 103A,B02,083780,Greenfeld; Be'Eri,4,0,36,32
1657437529144,MATH 103A,B03,093562,Greenfeld; Be'Eri,3,0,36,33
1657437535170,MATH 105,A01,085443,Carter; Anne Toulson,15,0,35,20
1657437535170,MATH 105,A02,093477,Carter; Anne Toulson,20,0,35,15
1657437541199,MATH 109,A01,083213,Ganzberger; Geoffrey Michael,2,0,34,32
1657437541199,MATH 109,A02,083214,Ganzberger; Geoffrey Michael,4,0,34,30
1657437541199,MATH 109,A03,093478,Ganzberger; Geoffrey Michael,2,0,34,32
1657437541199,MATH 109,B01,083215,Ganzberger; Geoffrey Michael,1,0,32,31
1657437541199,MATH 109,B02,083216,Ganzberger; Geoffrey Michael,2,0,32,30
1657437541199,MATH 109,B03,093479,Ganzberger; Geoffrey Michael,8,0,32,24
1657437547232,MATH 142A,A01,083219,Chow; Bennett,7,0,32,25
1657437547232,MATH 142A,A02,083220,Chow; Bennett,10,0,32,22
1657437547232,MATH 142A,A03,093480,Chow; Bennett,8,0,32,24
1657437547232,MATH 142A,B03,093481,Chow; Bennett,8,0,32,24
1657437547232,MATH 142A,B04,093558,Chow; Bennett,13,0,32,19
1657437547232,MATH 142A,B05,093559,Chow; Bennett,6,0,32,26
1657437553257,MATH 193A,A01,083224,Rotar; Vladimir,8,0,34,26
1657437553257,MATH 193A,A02,083225,Rotar; Vladimir,9,0,34,25
1657437553257,MATH 193A,A03,083781,Rotar; Vladimir,5,0,34,29
1657437553257,MATH 193A,A04,083782,Rotar; Vladimir,10,0,34,24
1657437553257,MATH 193A,A05,093482,Rotar; Vladimir,10,0,34,24
1657437559285,MATH 197,001,091859,McAuley; Julian John,9999,0,9999,0
1657437559285,MATH 197,002,095566,Kedlaya; Kiran S.,9997,0,9999,2
1657437559285,MATH 197,003,095567,Xiao; Ming,9999,0,9999,0
1657437559285,MATH 197,004,095571,Perols; Johan Lars,9998,0,9999,1
1657437566346,COGS 9,A01,083615,Shannon; Kyle Michael,9,0,75,66
1657437572373,COGS 11,A01,083617,Boyle; Mary E. T.,22,0,48,26
1657437578399,COGS 13,A01,083071,Bastos; Amalia Pinkusfeld,11,0,71,60
1657437584428,COGS 14A,A01,092681,Semenuks; Arturs,5,1,100,95
1657437590452,COGS 14B,A01,083073,Cheng; Tzu-Han,6,0,63,57
1657437596473,COGS 17,A01,092677,Semenuks; Arturs,6,0,81,75
1657437602500,COGS 100,A01,083619,Allen; Michael Gordon,17,0,70,53
1657437608528,COGS 101A,A01,083621,Davis; Joshua Daniel,9,0,68,59
1657437614555,COGS 101B,A01,091572,Allen; Michael Gordon,12,0,65,53
1657437620577,COGS 101C,A01,083625,Delgado; Tania,17,0,35,18
1657437626599,COGS 107A,A01,083627,Boyle; Mary E. T.,13,0,60,47
1657437632702,COGS 118A,A01,083075,Gupta; Anjum,21,0,76,55
1657437638726,CSE 3,A50,083646,Miranda; Gregory Joseph,24,0,50,26
1657437644754,CSE 8A,A50,083650,Miranda; Gregory Joseph,17,1,56,39
1657437650785,CSE 11,A01,083080,Cao; Yingjun,6,15,40,34
1657437656813,CSE 12,A01,083652,Krause-Levy; Sophia Louisa,28,1,120,92
1657437662836,CSE 15L,A01,083654,Morris; Justin Loren,9,0,50,41
1657437662836,CSE 15L,A02,083655,Morris; Justin Loren,9,0,50,41
1657437668863,CSE 20,A01,083657,Tran; Khoa Dang,39,0,80,41
1657437674886,CSE 21,A01,095574,Bach; Quang Tran,22,0,48,26
1657437680920,CSE 30,A01,083084,Eldon; John,5,0,80,75
1657437680920,CSE 30,B01,095061,Bhaskar; Nishant,9,0,50,41
1657437686944,CSE 100,A01,083659,Cao; Yingjun,5,4,70,65
1657437692974,CSE 134B,A01,083661,Powell; Thomas Allan,22,0,100,78
1657437698998,CSE 140,A01,083663,Gungor; Onat,15,0,85,70
1657437705022,CSE 140L,A01,083088,Eldon; John,21,0,100,79
1657437711049,CSE 175,A01,083665,Kumar; Rakesh,3,0,25,22
1657437717072,CSE 190,A00,092507,Dubnov; Shlomo,7,0,20,13
1657437723102,ECE 45,A01,083139,Congero; Spencer William,6,0,75,69
1657437729138,ECE 65,A50,083695,Saad; Andrew S,12,0,30,18
1657437729138,ECE 65,A51,095125,Saad; Andrew S,24,0,26,2
1657437735172,ECE 109,A01,091882,Touri; Behrouz,19,0,70,51
1657437741196,ECE 180,A00,083140,Abi Samra; Nicholas Camill,1,0,30,29
1657437741196,ECE 180,B00,083141,Abi Samra; Nicholas Camill,0,0,30,30
1657437747221,MATH 10A,A01,083735,Patchell; Gregory David,2,0,30,28
1657437747221,MATH 10A,A02,083736,Patchell; Gregory David,20,0,30,10
1657437747221,MATH 10A,A03,083737,Patchell; Gregory David,16,0,30,14
1657437753248,MATH 10B,A01,083207,Lim; Seonhee,8,0,34,26
1657437753248,MATH 10B,A02,083208,Lim; Seonhee,9,0,35,26
1657437753248,MATH 10B,A03,093472,Lim; Seonhee,7,0,34,27
1657437753248,MATH 10B,B01,083739,Sinha; Shubham,12,0,30,18
1657437759273,MATH 18,A01,083743,Cinel; Cameron Alexander,7,0,30,23
1657437759273,MATH 18,A02,083744,Cinel; Cameron Alexander,17,0,30,13
1657437759273,MATH 18,A03,083745,Cinel; Cameron Alexander,9,0,30,21
1657437759273,MATH 18,B01,083748,Rideout; David Porter,5,0,37,32
1657437759273,MATH 18,B02,083749,Rideout; David Porter,5,0,36,31
1657437759273,MATH 18,B03,083750,Rideout; David Porter,3,0,37,34
1657437759273,MATH 18,B04,083751,Rideout; David Porter,6,0,36,30
1657437759273,MATH 18,B05,093473,Rideout; David Porter,6,0,36,30
1657437759273,MATH 18,B06,093474,Rideout; David Porter,6,0,36,30
1657437765297,MATH 20A,A01,083754,Zheng; Zequn,14,0,40,26
1657437771325,MATH 20B,A01,083756,Briones; Jor-el Thomas Caparas,4,0,36,32
1657437771325,MATH 20B,A02,083757,Briones; Jor-el Thomas Caparas,1,0,36,35
1657437771325,MATH 20B,A03,093475,Briones; Jor-el Thomas Caparas,2,0,36,34
1657437777355,MATH 20C,A01,083760,Briones; Jor-el Thomas Caparas,1,0,35,34
1657437777355,MATH 20C,A02,083761,Briones; Jor-el Thomas Caparas,8,0,35,27
1657437777355,MATH 20C,A03,093476,Briones; Jor-el Thomas Caparas,0,1,36,36
1657437777355,MATH 20C,B01,083762,Bach; Quang Tran,1,0,30,29
1657437783379,MATH 20D,A01,083765,Tran; Brian Kha,5,0,30,25
1657437783379,MATH 20D,A02,083766,Tran; Brian Kha,5,0,30,25
1657437783379,MATH 20D,A03,083767,Tran; Brian Kha,5,0,30,25
1657437789408,MATH 20E,A01,083771,Ganguly; Soumya,9,0,32,23
1657437789408,MATH 20E,A02,083772,Ganguly; Soumya,6,0,32,26
1657437789408,MATH 20E,B01,083773,Ciotti; Benjamin,20,0,35,15
1657437789408,MATH 20E,B02,083774,Ciotti; Benjamin,17,0,35,18
1657437795437,MATH 103A,A01,083777,Greenfeld; Be'Eri,3,0,36,33
1657437795437,MATH 103A,A02,083778,Greenfeld; Be'Eri,5,0,36,31
1657437795437,MATH 103A,A03,093561,Greenfeld; Be'Eri,5,0,36,31
1657437795437,MATH 103A,B01,083779,Greenfeld; Be'Eri,7,0,36,29
1657437795437,MATH 103A,B02,083780,Greenfeld; Be'Eri,4,0,36,32
1657437795437,MATH 103A,B03,093562,Greenfeld; Be'Eri,3,0,36,33
1657437801465,MATH 105,A01,085443,Carter; Anne Toulson,15,0,35,20
1657437801465,MATH 105,A02,093477,Carter; Anne Toulson,20,0,35,15
1657437807490,MATH 109,A01,083213,Ganzberger; Geoffrey Michael,2,0,34,32
1657437807490,MATH 109,A02,083214,Ganzberger; Geoffrey Michael,4,0,34,30
1657437807490,MATH 109,A03,093478,Ganzberger; Geoffrey Michael,2,0,34,32
1657437807490,MATH 109,B01,083215,Ganzberger; Geoffrey Michael,1,0,32,31
1657437807490,MATH 109,B02,083216,Ganzberger; Geoffrey Michael,2,0,32,30
1657437807490,MATH 109,B03,093479,Ganzberger; Geoffrey Michael,8,0,32,24
1657437813519,MATH 142A,A01,083219,Chow; Bennett,7,0,32,25
1657437813519,MATH 142A,A02,083220,Chow; Bennett,10,0,32,22
1657437813519,MATH 142A,A03,093480,Chow; Bennett,8,0,32,24
1657437813519,MATH 142A,B03,093481,Chow; Bennett,8,0,32,24
1657437813519,MATH 142A,B04,093558,Chow; Bennett,13,0,32,19
1657437813519,MATH 142A,B05,093559,Chow; Bennett,6,0,32,26
1657437819543,MATH 193A,A01,083224,Rotar; Vladimir,8,0,34,26
1657437819543,MATH 193A,A02,083225,Rotar; Vladimir,9,0,34,25
1657437819543,MATH 193A,A03,083781,Rotar; Vladimir,5,0,34,29
1657437819543,MATH 193A,A04,083782,Rotar; Vladimir,10,0,34,24
1657437819543,MATH 193A,A05,093482,Rotar; Vladimir,10,0,34,24
1657437825567,MATH 197,001,091859,McAuley; Julian John,9999,0,9999,0
1657437825567,MATH 197,002,095566,Kedlaya; Kiran S.,9997,0,9999,2
1657437825567,MATH 197,003,095567,Xiao; Ming,9999,0,9999,0
1657437825567,MATH 197,004,095571,Perols; Johan Lars,9998,0,9999,1
1657437832623,COGS 9,A01,083615,Shannon; Kyle Michael,9,0,75,66
1657437838644,COGS 11,A01,083617,Boyle; Mary E. T.,22,0,48,26
1657437844666,COGS 13,A01,083071,Bastos; Amalia Pinkusfeld,11,0,71,60
1657437850691,COGS 14A,A01,092681,Semenuks; Arturs,5,1,100,95
1657437856713,COGS 14B,A01,083073,Cheng; Tzu-Han,6,0,63,57
1657437862739,COGS 17,A01,092677,Semenuks; Arturs,6,0,81,75
1657437868762,COGS 100,A01,083619,Allen; Michael Gordon,17,0,70,53
1657437874788,COGS 101A,A01,083621,Davis; Joshua Daniel,9,0,68,59
1657437880811,COGS 101B,A01,091572,Allen; Michael Gordon,12,0,65,53
1657437886839,COGS 101C,A01,083625,Delgado; Tania,17,0,35,18
1657437892862,COGS 107A,A01,083627,Boyle; Mary E. T.,13,0,60,47
1657437898889,COGS 118A,A01,083075,Gupta; Anjum,21,0,76,55
1657437904911,CSE 3,A50,083646,Miranda; Gregory Joseph,24,0,50,26
1657437910935,CSE 8A,A50,083650,Miranda; Gregory Joseph,17,1,56,39
1657437916961,CSE 11,A01,083080,Cao; Yingjun,6,15,40,34
1657437922985,CSE 12,A01,083652,Krause-Levy; Sophia Louisa,28,1,120,92
1657437929015,CSE 15L,A01,083654,Morris; Justin Loren,9,0,50,41
1657437929015,CSE 15L,A02,083655,Morris; Justin Loren,9,0,50,41
1657437935044,CSE 20,A01,083657,Tran; Khoa Dang,39,0,80,41
1657437941066,CSE 21,A01,095574,Bach; Quang Tran,22,0,48,26
1657437947089,CSE 30,A01,083084,Eldon; John,5,0,80,75
1657437947089,CSE 30,B01,095061,Bhaskar; Nishant,9,0,50,41
1657437953116,CSE 100,A01,083659,Cao; Yingjun,5,4,70,65
1657437959141,CSE 134B,A01,083661,Powell; Thomas Allan,22,0,100,78
1657437965163,CSE 140,A01,083663,Gungor; Onat,15,0,85,70
1657437971186,CSE 140L,A01,083088,Eldon; John,21,0,100,79
1657437977216,CSE 175,A01,083665,Kumar; Rakesh,3,0,25,22
1657437983239,CSE 190,A00,092507,Dubnov; Shlomo,7,0,20,13
1657437989281,ECE 45,A01,083139,Congero; Spencer William,6,0,75,69
1657437995305,ECE 65,A50,083695,Saad; Andrew S,12,0,30,18
1657437995305,ECE 65,A51,095125,Saad; Andrew S,24,0,26,2
1657438001328,ECE 109,A01,091882,Touri; Behrouz,19,0,70,51
1657438007353,ECE 180,A00,083140,Abi Samra; Nicholas Camill,1,0,30,29
1657438007353,ECE 180,B00,083141,Abi Samra; Nicholas Camill,0,0,30,30
1657438013376,MATH 10A,A01,083735,Patchell; Gregory David,2,0,30,28
1657438013376,MATH 10A,A02,083736,Patchell; Gregory David,20,0,30,10
1657438013376,MATH 10A,A03,083737,Patchell; Gregory David,16,0,30,14
1657438019402,MATH 10B,A01,083207,Lim; Seonhee,8,0,34,26
1657438019402,MATH 10B,A02,083208,Lim; Seonhee,9,0,35,26
1657438019402,MATH 10B,A03,093472,Lim; Seonhee,7,0,34,27
1657438019402,MATH 10B,B01,083739,Sinha; Shubham,12,0,30,18
1657438025427,MATH 18,A01,083743,Cinel; Cameron Alexander,7,0,30,23
1657438025427,MATH 18,A02,083744,Cinel; Cameron Alexander,17,0,30,13
1657438025427,MATH 18,A03,083745,Cinel; Cameron Alexander,9,0,30,21
1657438025427,MATH 18,B01,083748,Rideout; David Porter,5,0,37,32
1657438025427,MATH 18,B02,083749,Rideout; David Porter,5,0,36,31
1657438025427,MATH 18,B03,083750,Rideout; David Porter,3,0,37,34
1657438025427,MATH 18,B04,083751,Rideout; David Porter,6,0,36,30
1657438025427,MATH 18,B05,093473,Rideout; David Porter,6,0,36,30
1657438025427,MATH 18,B06,093474,Rideout; David Porter,6,0,36,30
1657438031454,MATH 20A,A01,083754,Zheng; Zequn,14,0,40,26
1657438037476,MATH 20B,A01,083756,Briones; Jor-el Thomas Caparas,4,0,36,32
1657438037476,MATH 20B,A02,083757,Briones; Jor-el Thomas Caparas,1,0,36,35
1657438037476,MATH 20B,A03,093475,Briones; Jor-el Thomas Caparas,2,0,36,34
1657438043500,MATH 20C,A01,083760,Briones; Jor-el Thomas Caparas,1,0,35,34
1657438043500,MATH 20C,A02,083761,Briones; Jor-el Thomas Caparas,8,0,35,27
1657438043500,MATH 20C,A03,093476,Briones; Jor-el Thomas Caparas,0,1,36,36
1657438043500,MATH 20C,B01,083762,Bach; Quang Tran,1,0,30,29
1657438049529,MATH 20D,A01,083765,Tran; Brian Kha,5,0,30,25
1657438049529,MATH 20D,A02,083766,Tran; Brian Kha,5,0,30,25
1657438049529,MATH 20D,A03,083767,Tran; Brian Kha,5,0,30,25
1657438055554,MATH 20E,A01,083771,Ganguly; Soumya,9,0,32,23
1657438055554,MATH 20E,A02,083772,Ganguly; Soumya,6,0,32,26
1657438055554,MATH 20E,B01,083773,Ciotti; Benjamin,20,0,35,15
1657438055554,MATH 20E,B02,083774,Ciotti; Benjamin,17,0,35,18
1657438061580,MATH 103A,A01,083777,Greenfeld; Be'Eri,3,0,36,33
1657438061580,MATH 103A,A02,083778,Greenfeld; Be'Eri,5,0,36,31
1657438061580,MATH 103A,A03,093561,Greenfeld; Be'Eri,5,0,36,31
1657438061580,MATH 103A,B01,083779,Greenfeld; Be'Eri,7,0,36,29
1657438061580,MATH 103A,B02,083780,Greenfeld; Be'Eri,4,0,36,32
1657438061580,MATH 103A,B03,093562,Greenfeld; Be'Eri,3,0,36,33
1657438067607,MATH 105,A01,085443,Carter; Anne Toulson,15,0,35,20
1657438067607,MATH 105,A02,093477,Carter; Anne Toulson,20,0,35,15
1657438073635,MATH 109,A01,083213,Ganzberger; Geoffrey Michael,2,0,34,32
1657438073635,MATH 109,A02,083214,Ganzberger; Geoffrey Michael,4,0,34,30
1657438073635,MATH 109,A03,093478,Ganzberger; Geoffrey Michael,2,0,34,32
1657438073635,MATH 109,B01,083215,Ganzberger; Geoffrey Michael,1,0,32,31
1657438073635,MATH 109,B02,083216,Ganzberger; Geoffrey Michael,2,0,32,30
1657438073635,MATH 109,B03,093479,Ganzberger; Geoffrey Michael,8,0,32,24
1657438079661,MATH 142A,A01,083219,Chow; Bennett,7,0,32,25
1657438079661,MATH 142A,A02,083220,Chow; Bennett,10,0,32,22
1657438079661,MATH 142A,A03,093480,Chow; Bennett,8,0,32,24
1657438079661,MATH 142A,B03,093481,Chow; Bennett,8,0,32,24
1657438079661,MATH 142A,B04,093558,Chow; Bennett,13,0,32,19
1657438079661,MATH 142A,B05,093559,Chow; Bennett,6,0,32,26
1657438085688,MATH 193A,A01,083224,Rotar; Vladimir,8,0,34,26
1657438085688,MATH 193A,A02,083225,Rotar; Vladimir,9,0,34,25
1657438085688,MATH 193A,A03,083781,Rotar; Vladimir,5,0,34,29
1657438085688,MATH 193A,A04,083782,Rotar; Vladimir,10,0,34,24
1657438085688,MATH 193A,A05,093482,Rotar; Vladimir,10,0,34,24
1657438091711,MATH 197,001,091859,McAuley; Julian John,9999,0,9999,0
1657438091711,MATH 197,002,095566,Kedlaya; Kiran S.,9997,0,9999,2
1657438091711,MATH 197,003,095567,Xiao; Ming,9999,0,9999,0
1657438091711,MATH 197,004,095571,Perols; Johan Lars,9998,0,9999,1
1657438098776,COGS 9,A01,083615,Shannon; Kyle Michael,9,0,75,66
1657438104805,COGS 11,A01,083617,Boyle; Mary E. T.,22,0,48,26
1657438110828,COGS 13,A01,083071,Bastos; Amalia Pinkusfeld,11,0,71,60
1657438116854,COGS 14A,A01,092681,Semenuks; Arturs,5,1,100,95
1657438122883,COGS 14B,A01,083073,Cheng; Tzu-Han,6,0,63,57
1657438128908,COGS 17,A01,092677,Semenuks; Arturs,6,0,81,75
1657438134935,COGS 100,A01,083619,Allen; Michael Gordon,17,0,70,53
1657438140968,COGS 101A,A01,083621,Davis; Joshua Daniel,9,0,68,59
1657438146991,COGS 101B,A01,091572,Allen; Michael Gordon,12,0,65,53
1657438153016,COGS 101C,A01,083625,Delgado; Tania,17,0,35,18
1657438159041,COGS 107A,A01,083627,Boyle; Mary E. T.,13,0,60,47
1657438165065,COGS 118A,A01,083075,Gupta; Anjum,21,0,76,55
1657438171087,CSE 3,A50,083646,Miranda; Gregory Joseph,24,0,50,26
1657438177115,CSE 8A,A50,083650,Miranda; Gregory Joseph,17,1,56,39
1657438183143,CSE 11,A01,083080,Cao; Yingjun,6,15,40,34
1657438189166,CSE 12,A01,083652,Krause-Levy; Sophia Louisa,28,1,120,92
1657438195190,CSE 15L,A01,083654,Morris; Justin Loren,9,0,50,41
1657438195190,CSE 15L,A02,083655,Morris; Justin Loren,9,0,50,41
1657438201219,CSE 20,A01,083657,Tran; Khoa Dang,39,0,80,41
1657438207245,CSE 21,A01,095574,Bach; Quang Tran,22,0,48,26
1657438213268,CSE 30,A01,083084,Eldon; John,5,0,80,75
1657438213268,CSE 30,B01,095061,Bhaskar; Nishant,9,0,50,41
1657438219295,CSE 100,A01,083659,Cao; Yingjun,5,4,70,65
1657438225318,CSE 134B,A01,083661,Powell; Thomas Allan,22,0,100,78
1657438231435,CSE 140,A01,083663,Gungor; Onat,15,0,85,70
1657438237458,CSE 140L,A01,083088,Eldon; John,21,0,100,79
1657438243485,CSE 175,A01,083665,Kumar; Rakesh,3,0,25,22
1657438249509,CSE 190,A00,092507,Dubnov; Shlomo,7,0,20,13
1657438255534,ECE 45,A01,083139,Congero; Spencer William,6,0,75,69
1657438261558,ECE 65,A50,083695,Saad; Andrew S,12,0,30,18
1657438261558,ECE 65,A51,095125,Saad; Andrew S,24,0,26,2
1657438267584,ECE 109,A01,091882,Touri; Behrouz,19,0,70,51
1657438273609,ECE 180,A00,083140,Abi Samra; Nicholas Camill,1,0,30,29
1657438273609,ECE 180,B00,083141,Abi Samra; Nicholas Camill,0,0,30,30
1657438279633,MATH 10A,A01,083735,Patchell; Gregory David,2,0,30,28
1657438279633,MATH 10A,A02,083736,Patchell; Gregory David,20,0,30,10
1657438279633,MATH 10A,A03,083737,Patchell; Gregory David,16,0,30,14
1657438285665,MATH 10B,A01,083207,Lim; Seonhee,8,0,34,26
1657438285665,MATH 10B,A02,083208,Lim; Seonhee,9,0,35,26
1657438285665,MATH 10B,A03,093472,Lim; Seonhee,7,0,34,27
1657438285665,MATH 10B,B01,083739,Sinha; Shubham,12,0,30,18
1657438291688,MATH 18,A01,083743,Cinel; Cameron Alexander,7,0,30,23
1657438291688,MATH 18,A02,083744,Cinel; Cameron Alexander,17,0,30,13
1657438291688,MATH 18,A03,083745,Cinel; Cameron Alexander,9,0,30,21
1657438291688,MATH 18,B01,083748,Rideout; David Porter,5,0,37,32
1657438291688,MATH 18,B02,083749,Rideout; David Porter,5,0,36,31
1657438291688,MATH 18,B03,083750,Rideout; David Porter,3,0,37,34
1657438291688,MATH 18,B04,083751,Rideout; David Porter,6,0,36,30
1657438291688,MATH 18,B05,093473,Rideout; David Porter,6,0,36,30
1657438291688,MATH 18,B06,093474,Rideout; David Porter,6,0,36,30
1657438297714,MATH 20A,A01,083754,Zheng; Zequn,14,0,40,26
1657438303741,MATH 20B,A01,083756,Briones; Jor-el Thomas Caparas,4,0,36,32
1657438303741,MATH 20B,A02,083757,Briones; Jor-el Thomas Caparas,1,0,36,35
1657438303741,MATH 20B,A03,093475,Briones; Jor-el Thomas Caparas,2,0,36,34
1657438309770,MATH 20C,A01,083760,Briones; Jor-el Thomas Caparas,1,0,35,34
1657438309770,MATH 20C,A02,083761,Briones; Jor-el Thomas Caparas,8,0,35,27
1657438309770,MATH 20C,A03,093476,Briones; Jor-el Thomas Caparas,0,1,36,36
1657438309770,MATH 20C,B01,083762,Bach; Quang Tran,1,0,30,29
1657438315797,MATH 20D,A01,083765,Tran; Brian Kha,5,0,30,25
1657438315797,MATH 20D,A02,083766,Tran; Brian Kha,5,0,30,25
1657438315797,MATH 20D,A03,083767,Tran; Brian Kha,5,0,30,25
1657438321820,MATH 20E,A01,083771,Ganguly; Soumya,9,0,32,23
1657438321820,MATH 20E,A02,083772,Ganguly; Soumya,6,0,32,26
1657438321820,MATH 20E,B01,083773,Ciotti; Benjamin,20,0,35,15
1657438321820,MATH 20E,B02,083774,Ciotti; Benjamin,17,0,35,18
1657438327843,MATH 103A,A01,083777,Greenfeld; Be'Eri,3,0,36,33
1657438327843,MATH 103A,A02,083778,Greenfeld; Be'Eri,5,0,36,31
1657438327843,MATH 103A,A03,093561,Greenfeld; Be'Eri,5,0,36,31
1657438327843,MATH 103A,B01,083779,Greenfeld; Be'Eri,7,0,36,29
1657438327843,MATH 103A,B02,083780,Greenfeld; Be'Eri,4,0,36,32
1657438327843,MATH 103A,B03,093562,Greenfeld; Be'Eri,3,0,36,33
1657438333867,MATH 105,A01,085443,Carter; Anne Toulson,15,0,35,20
1657438333867,MATH 105,A02,093477,Carter; Anne Toulson,20,0,35,15
1657438339892,MATH 109,A01,083213,Ganzberger; Geoffrey Michael,2,0,34,32
1657438339892,MATH 109,A02,083214,Ganzberger; Geoffrey Michael,4,0,34,30
1657438339892,MATH 109,A03,093478,Ganzberger; Geoffrey Michael,2,0,34,32
1657438339892,MATH 109,B01,083215,Ganzberger; Geoffrey Michael,1,0,32,31
1657438339892,MATH 109,B02,083216,Ganzberger; Geoffrey Michael,2,0,32,30
1657438339892,MATH 109,B03,093479,Ganzberger; Geoffrey Michael,8,0,32,24
1657438345920,MATH 142A,A01,083219,Chow; Bennett,7,0,32,25
1657438345920,MATH 142A,A02,083220,Chow; Bennett,10,0,32,22
1657438345920,MATH 142A,A03,093480,Chow; Bennett,8,0,32,24
1657438345920,MATH 142A,B03,093481,Chow; Bennett,8,0,32,24
1657438345920,MATH 142A,B04,093558,Chow; Bennett,13,0,32,19
1657438345920,MATH 142A,B05,093559,Chow; Bennett,6,0,32,26
1657438351952,MATH 193A,A01,083224,Rotar; Vladimir,8,0,34,26
1657438351952,MATH 193A,A02,083225,Rotar; Vladimir,9,0,34,25
1657438351952,MATH 193A,A03,083781,Rotar; Vladimir,5,0,34,29
1657438351952,MATH 193A,A04,083782,Rotar; Vladimir,10,0,34,24
1657438351952,MATH 193A,A05,093482,Rotar; Vladimir,10,0,34,24
1657438357989,MATH 197,001,091859,McAuley; Julian John,9999,0,9999,0
1657438357989,MATH 197,002,095566,Kedlaya; Kiran S.,9997,0,9999,2
1657438357989,MATH 197,003,095567,Xiao; Ming,9999,0,9999,0
1657438357989,MATH 197,004,095571,Perols; Johan Lars,9998,0,9999,1
1657438365042,COGS 9,A01,083615,Shannon; Kyle Michael,9,0,75,66
1657438371064,COGS 11,A01,083617,Boyle; Mary E. T.,22,0,48,26
1657438377092,COGS 13,A01,083071,Bastos; Amalia Pinkusfeld,11,0,71,60
1657438383123,COGS 14A,A01,092681,Semenuks; Arturs,5,1,100,95
1657438389148,COGS 14B,A01,083073,Cheng; Tzu-Han,6,0,63,57
1657438395171,COGS 17,A01,092677,Semenuks; Arturs,6,0,81,75
1657438401199,COGS 100,A01,083619,Allen; Michael Gordon,17,0,70,53
1657438407228,COGS 101A,A01,083621,Davis; Joshua Daniel,9,0,68,59
1657438413250,COGS 101B,A01,091572,Allen; Michael Gordon,12,0,65,53
1657438419277,COGS 101C,A01,083625,Delgado; Tania,17,0,35,18
1657438425301,COGS 107A,A01,083627,Boyle; Mary E. T.,13,0,60,47
1657438431328,COGS 118A,A01,083075,Gupta; Anjum,21,0,76,55
1657438437352,CSE 3,A50,083646,Miranda; Gregory Joseph,24,0,50,26
1657438443378,CSE 8A,A50,083650,Miranda; Gregory Joseph,17,1,56,39
1657438449404,CSE 11,A01,083080,Cao; Yingjun,6,15,40,34
1657438455427,CSE 12,A01,083652,Krause-Levy; Sophia Louisa,28,1,120,92
1657438461450,CSE 15L,A01,083654,Morris; Justin Loren,9,0,50,41
1657438461450,CSE 15L,A02,083655,Morris; Justin Loren,9,0,50,41
1657438467473,CSE 20,A01,083657,Tran; Khoa Dang,39,0,80,41
1657438473496,CSE 21,A01,095574,Bach; Quang Tran,22,0,48,26
1657438479524,CSE 30,A01,083084,Eldon; John,5,0,80,75
1657438479524,CSE 30,B01,095061,Bhaskar; Nishant,9,0,50,41
1657438485547,CSE 100,A01,083659,Cao; Yingjun,5,4,70,65
1657438491574,CSE 134B,A01,083661,Powell; Thomas Allan,22,0,100,78
1657438497598,CSE 140,A01,083663,Gungor; Onat,15,0,85,70
1657438503624,CSE 140L,A01,083088,Eldon; John,21,0,100,79
1657438509647,CSE 175,A01,083665,Kumar; Rakesh,3,0,25,22
1657438515670,CSE 190,A00,092507,Dubnov; Shlomo,7,0,20,13
1657438521692,ECE 45,A01,083139,Congero; Spencer William,6,0,75,69
1657438527720,ECE 65,A50,083695,Saad; Andrew S,12,0,30,18
1657438527720,ECE 65,A51,095125,Saad; Andrew S,24,0,26,2
1657438533742,ECE 109,A01,091882,Touri; Behrouz,19,0,70,51
1657438539766,ECE 180,A00,083140,Abi Samra; Nicholas Camill,1,0,30,29
1657438539766,ECE 180,B00,083141,Abi Samra; Nicholas Camill,0,0,30,30
1657438545788,MATH 10A,A01,083735,Patchell; Gregory David,2,0,30,28
1657438545788,MATH 10A,A02,083736,Patchell; Gregory David,20,0,30,10
1657438545788,MATH 10A,A03,083737,Patchell; Gregory David,16,0,30,14
1657438551811,MATH 10B,A01,083207,Lim; Seonhee,8,0,34,26
1657438551811,MATH 10B,A02,083208,Lim; Seonhee,9,0,35,26
1657438551811,MATH 10B,A03,093472,Lim; Seonhee,7,0,34,27
1657438551811,MATH 10B,B01,083739,Sinha; Shubham,12,0,30,18
1657438557837,MATH 18,A01,083743,Cinel; Cameron Alexander,7,0,30,23
1657438557837,MATH 18,A02,083744,Cinel; Cameron Alexander,17,0,30,13
1657438557837,MATH 18,A03,083745,Cinel; Cameron Alexander,9,0,30,21
1657438557837,MATH 18,B01,083748,Rideout; David Porter,5,0,37,32
1657438557837,MATH 18,B02,083749,Rideout; David Porter,5,0,36,31
1657438557837,MATH 18,B03,083750,Rideout; David Porter,3,0,37,34
1657438557837,MATH 18,B04,083751,Rideout; David Porter,6,0,36,30
1657438557837,MATH 18,B05,093473,Rideout; David Porter,6,0,36,30
1657438557837,MATH 18,B06,093474,Rideout; David Porter,6,0,36,30
1657438563863,MATH 20A,A01,083754,Zheng; Zequn,14,0,40,26
1657438569890,MATH 20B,A01,083756,Briones; Jor-el Thomas Caparas,4,0,36,32
1657438569890,MATH 20B,A02,083757,Briones; Jor-el Thomas Caparas,1,0,36,35
1657438569890,MATH 20B,A03,093475,Briones; Jor-el Thomas Caparas,2,0,36,34
1657438575918,MATH 20C,A01,083760,Briones; Jor-el Thomas Caparas,1,0,35,34
1657438575918,MATH 20C,A02,083761,Briones; Jor-el Thomas Caparas,8,0,35,27
1657438575918,MATH 20C,A03,093476,Briones; Jor-el Thomas Caparas,0,1,36,36
1657438575918,MATH 20C,B01,083762,Bach; Quang Tran,1,0,30,29
1657438581943,MATH 20D,A01,083765,Tran; Brian Kha,5,0,30,25
1657438581943,MATH 20D,A02,083766,Tran; Brian Kha,5,0,30,25
1657438581943,MATH 20D,A03,083767,Tran; Brian Kha,5,0,30,25
1657438587972,MATH 20E,A01,083771,Ganguly; Soumya,9,0,32,23
1657438587972,MATH 20E,A02,083772,Ganguly; Soumya,6,0,32,26
1657438587972,MATH 20E,B01,083773,Ciotti; Benjamin,20,0,35,15
1657438587972,MATH 20E,B02,083774,Ciotti; Benjamin,17,0,35,18
1657438593996,MATH 103A,A01,083777,Greenfeld; Be'Eri,3,0,36,33
1657438593996,MATH 103A,A02,083778,Greenfeld; Be'Eri,5,0,36,31
1657438593996,MATH 103A,A03,093561,Greenfeld; Be'Eri,5,0,36,31
1657438593996,MATH 103A,B01,083779,Greenfeld; Be'Eri,7,0,36,29
1657438593996,MATH 103A,B02,083780,Greenfeld; Be'Eri,4,0,36,32
1657438593996,MATH 103A,B03,093562,Greenfeld; Be'Eri,3,0,36,33
1657438600020,MATH 105,A01,085443,Carter; Anne Toulson,15,0,35,20
1657438600020,MATH 105,A02,093477,Carter; Anne Toulson,20,0,35,15
1657438606045,MATH 109,A01,083213,Ganzberger; Geoffrey Michael,2,0,34,32
1657438606045,MATH 109,A02,083214,Ganzberger; Geoffrey Michael,4,0,34,30
1657438606045,MATH 109,A03,093478,Ganzberger; Geoffrey Michael,2,0,34,32
1657438606045,MATH 109,B01,083215,Ganzberger; Geoffrey Michael,1,0,32,31
1657438606045,MATH 109,B02,083216,Ganzberger; Geoffrey Michael,2,0,32,30
1657438606045,MATH 109,B03,093479,Ganzberger; Geoffrey Michael,8,0,32,24
1657438612083,MATH 142A,A01,083219,Chow; Bennett,7,0,32,25
1657438612083,MATH 142A,A02,083220,Chow; Bennett,10,0,32,22
1657438612083,MATH 142A,A03,093480,Chow; Bennett,8,0,32,24
1657438612083,MATH 142A,B03,093481,Chow; Bennett,8,0,32,24
1657438612083,MATH 142A,B04,093558,Chow; Bennett,13,0,32,19
1657438612083,MATH 142A,B05,093559,Chow; Bennett,6,0,32,26
1657438618108,MATH 193A,A01,083224,Rotar; Vladimir,8,0,34,26
1657438618108,MATH 193A,A02,083225,Rotar; Vladimir,9,0,34,25
1657438618108,MATH 193A,A03,083781,Rotar; Vladimir,5,0,34,29
1657438618108,MATH 193A,A04,083782,Rotar; Vladimir,10,0,34,24
1657438618108,MATH 193A,A05,093482,Rotar; Vladimir,10,0,34,24
1657438624131,MATH 197,001,091859,McAuley; Julian John,9999,0,9999,0
1657438624131,MATH 197,002,095566,Kedlaya; Kiran S.,9997,0,9999,2
1657438624131,MATH 197,003,095567,Xiao; Ming,9999,0,9999,0
1657438624131,MATH 197,004,095571,Perols; Johan Lars,9998,0,9999,1
1657438631189,COGS 9,A01,083615,Shannon; Kyle Michael,9,0,75,66
1657438637225,COGS 11,A01,083617,Boyle; Mary E. T.,22,0,48,26
1657438643248,COGS 13,A01,083071,Bastos; Amalia Pinkusfeld,11,0,71,60
1657438649274,COGS 14A,A01,092681,Semenuks; Arturs,5,1,100,95
1657438655300,COGS 14B,A01,083073,Cheng; Tzu-Han,6,0,63,57
1657438661323,COGS 17,A01,092677,Semenuks; Arturs,6,0,81,75
1657438667346,COGS 100,A01,083619,Allen; Michael Gordon,17,0,70,53
1657438673371,COGS 101A,A01,083621,Davis; Joshua Daniel,9,0,68,59
1657438679394,COGS 101B,A01,091572,Allen; Michael Gordon,12,0,65,53
1657438685420,COGS 101C,A01,083625,Delgado; Tania,17,0,35,18
1657438691447,COGS 107A,A01,083627,Boyle; Mary E. T.,13,0,60,47
1657438697468,COGS 118A,A01,083075,Gupta; Anjum,21,0,76,55
1657438703501,CSE 3,A50,083646,Miranda; Gregory Joseph,24,0,50,26
1657438709536,CSE 8A,A50,083650,Miranda; Gregory Joseph,17,1,56,39
1657438715560,CSE 11,A01,083080,Cao; Yingjun,6,15,40,34
1657438721586,CSE 12,A01,083652,Krause-Levy; Sophia Louisa,28,1,120,92
1657438727608,CSE 15L,A01,083654,Morris; Justin Loren,9,0,50,41
1657438727608,CSE 15L,A02,083655,Morris; Justin Loren,9,0,50,41
1657438733635,CSE 20,A01,083657,Tran; Khoa Dang,39,0,80,41
1657438739657,CSE 21,A01,095574,Bach; Quang Tran,22,0,48,26
1657438745679,CSE 30,A01,083084,Eldon; John,5,0,80,75
1657438745679,CSE 30,B01,095061,Bhaskar; Nishant,9,0,50,41
1657438751702,CSE 100,A01,083659,Cao; Yingjun,5,4,70,65
1657438757725,CSE 134B,A01,083661,Powell; Thomas Allan,22,0,100,78
1657438763750,CSE 140,A01,083663,Gungor; Onat,15,0,85,70
1657438769772,CSE 140L,A01,083088,Eldon; John,21,0,100,79
1657438775794,CSE 175,A01,083665,Kumar; Rakesh,3,0,25,22
1657438781825,CSE 190,A00,092507,Dubnov; Shlomo,7,0,20,13
1657438787849,ECE 45,A01,083139,Congero; Spencer William,6,0,75,69
1657438793873,ECE 65,A50,083695,Saad; Andrew S,12,0,30,18
1657438793873,ECE 65,A51,095125,Saad; Andrew S,24,0,26,2
1657438799897,ECE 109,A01,091882,Touri; Behrouz,19,0,70,51
1657438805924,ECE 180,A00,083140,Abi Samra; Nicholas Camill,1,0,30,29
1657438805924,ECE 180,B00,083141,Abi Samra; Nicholas Camill,0,0,30,30
1657438811946,MATH 10A,A01,083735,Patchell; Gregory David,2,0,30,28
1657438811946,MATH 10A,A02,083736,Patchell; Gregory David,20,0,30,10
1657438811946,MATH 10A,A03,083737,Patchell; Gregory David,16,0,30,14
1657438817969,MATH 10B,A01,083207,Lim; Seonhee,8,0,34,26
1657438817969,MATH 10B,A02,083208,Lim; Seonhee,9,0,35,26
1657438817969,MATH 10B,A03,093472,Lim; Seonhee,7,0,34,27
1657438817969,MATH 10B,B01,083739,Sinha; Shubham,12,0,30,18
1657438824001,MATH 18,A01,083743,Cinel; Cameron Alexander,7,0,30,23
1657438824001,MATH 18,A02,083744,Cinel; Cameron Alexander,17,0,30,13
1657438824001,MATH 18,A03,083745,Cinel; Cameron Alexander,9,0,30,21
1657438824001,MATH 18,B01,083748,Rideout; David Porter,5,0,37,32
1657438824001,MATH 18,B02,083749,Rideout; David Porter,5,0,36,31
1657438824001,MATH 18,B03,083750,Rideout; David Porter,3,0,37,34
1657438824001,MATH 18,B04,083751,Rideout; David Porter,6,0,36,30
1657438824001,MATH 18,B05,093473,Rideout; David Porter,6,0,36,30
1657438824001,MATH 18,B06,093474,Rideout; David Porter,6,0,36,30
1657438830103,MATH 20A,A01,083754,Zheng; Zequn,14,0,40,26
1657438836134,MATH 20B,A01,083756,Briones; Jor-el Thomas Caparas,4,0,36,32
1657438836134,MATH 20B,A02,083757,Briones; Jor-el Thomas Caparas,1,0,36,35
1657438836134,MATH 20B,A03,093475,Briones; Jor-el Thomas Caparas,2,0,36,34
1657438842157,MATH 20C,A01,083760,Briones; Jor-el Thomas Caparas,1,0,35,34
1657438842157,MATH 20C,A02,083761,Briones; Jor-el Thomas Caparas,8,0,35,27
1657438842157,MATH 20C,A03,093476,Briones; Jor-el Thomas Caparas,0,1,36,36
1657438842157,MATH 20C,B01,083762,Bach; Quang Tran,1,0,30,29
1657438848185,MATH 20D,A01,083765,Tran; Brian Kha,5,0,30,25
1657438848185,MATH 20D,A02,083766,Tran; Brian Kha,5,0,30,25
1657438848185,MATH 20D,A03,083767,Tran; Brian Kha,5,0,30,25
1657438854209,MATH 20E,A01,083771,Ganguly; Soumya,9,0,32,23
1657438854209,MATH 20E,A02,083772,Ganguly; Soumya,6,0,32,26
1657438854209,MATH 20E,B01,083773,Ciotti; Benjamin,20,0,35,15
1657438854209,MATH 20E,B02,083774,Ciotti; Benjamin,17,0,35,18
1657438860233,MATH 103A,A01,083777,Greenfeld; Be'Eri,3,0,36,33
1657438860233,MATH 103A,A02,083778,Greenfeld; Be'Eri,5,0,36,31
1657438860233,MATH 103A,A03,093561,Greenfeld; Be'Eri,5,0,36,31
1657438860233,MATH 103A,B01,083779,Greenfeld; Be'Eri,7,0,36,29
1657438860233,MATH 103A,B02,083780,Greenfeld; Be'Eri,4,0,36,32
1657438860233,MATH 103A,B03,093562,Greenfeld; Be'Eri,3,0,36,33
1657438866259,MATH 105,A01,085443,Carter; Anne Toulson,15,0,35,20
1657438866259,MATH 105,A02,093477,Carter; Anne Toulson,20,0,35,15
1657438872289,MATH 109,A01,083213,Ganzberger; Geoffrey Michael,2,0,34,32
1657438872289,MATH 109,A02,083214,Ganzberger; Geoffrey Michael,4,0,34,30
1657438872289,MATH 109,A03,093478,Ganzberger; Geoffrey Michael,2,0,34,32
1657438872289,MATH 109,B01,083215,Ganzberger; Geoffrey Michael,1,0,32,31
1657438872289,MATH 109,B02,083216,Ganzberger; Geoffrey Michael,2,0,32,30
1657438872289,MATH 109,B03,093479,Ganzberger; Geoffrey Michael,8,0,32,24
1657438878321,MATH 142A,A01,083219,Chow; Bennett,7,0,32,25
1657438878321,MATH 142A,A02,083220,Chow; Bennett,10,0,32,22
1657438878321,MATH 142A,A03,093480,Chow; Bennett,8,0,32,24
1657438878321,MATH 142A,B03,093481,Chow; Bennett,8,0,32,24
1657438878321,MATH 142A,B04,093558,Chow; Bennett,13,0,32,19
1657438878321,MATH 142A,B05,093559,Chow; Bennett,6,0,32,26
1657438884349,MATH 193A,A01,083224,Rotar; Vladimir,8,0,34,26
1657438884349,MATH 193A,A02,083225,Rotar; Vladimir,9,0,34,25
1657438884349,MATH 193A,A03,083781,Rotar; Vladimir,5,0,34,29
1657438884349,MATH 193A,A04,083782,Rotar; Vladimir,10,0,34,24
1657438884349,MATH 193A,A05,093482,Rotar; Vladimir,10,0,34,24
1657438890373,MATH 197,001,091859,McAuley; Julian John,9999,0,9999,0
1657438890373,MATH 197,002,095566,Kedlaya; Kiran S.,9997,0,9999,2
1657438890373,MATH 197,003,095567,Xiao; Ming,9999,0,9999,0
1657438890373,MATH 197,004,095571,Perols; Johan Lars,9998,0,9999,1
1657438897421,COGS 9,A01,083615,Shannon; Kyle Michael,9,0,75,66
1657438903449,COGS 11,A01,083617,Boyle; Mary E. T.,22,0,48,26
1657438909470,COGS 13,A01,083071,Bastos; Amalia Pinkusfeld,11,0,71,60
1657438915492,COGS 14A,A01,092681,Semenuks; Arturs,5,1,100,95
1657438921515,COGS 14B,A01,083073,Cheng; Tzu-Han,6,0,63,57
1657438927545,COGS 17,A01,092677,Semenuks; Arturs,6,0,81,75
1657438933571,COGS 100,A01,083619,Allen; Michael Gordon,17,0,70,53
1657438939594,COGS 101A,A01,083621,Davis; Joshua Daniel,9,0,68,59
1657438945622,COGS 101B,A01,091572,Allen; Michael Gordon,12,0,65,53
1657438951652,COGS 101C,A01,083625,Delgado; Tania,17,0,35,18
1657438957675,COGS 107A,A01,083627,Boyle; Mary E. T.,13,0,60,47
1657438963696,COGS 118A,A01,083075,Gupta; Anjum,21,0,76,55
1657438969723,CSE 3,A50,083646,Miranda; Gregory Joseph,24,0,50,26
1657438975745,CSE 8A,A50,083650,Miranda; Gregory Joseph,17,1,56,39
1657438981768,CSE 11,A01,083080,Cao; Yingjun,6,15,40,34
1657438987792,CSE 12,A01,083652,Krause-Levy; Sophia Louisa,28,1,120,92
1657438993815,CSE 15L,A01,083654,Morris; Justin Loren,9,0,50,41
1657438993815,CSE 15L,A02,083655,Morris; Justin Loren,9,0,50,41
1657438999836,CSE 20,A01,083657,Tran; Khoa Dang,39,0,80,41
1657439005863,CSE 21,A01,095574,Bach; Quang Tran,22,0,48,26
1657439011890,CSE 30,A01,083084,Eldon; John,5,0,80,75
1657439011890,CSE 30,B01,095061,Bhaskar; Nishant,9,0,50,41
1657439017917,CSE 100,A01,083659,Cao; Yingjun,5,4,70,65
1657439023940,CSE 134B,A01,083661,Powell; Thomas Allan,22,0,100,78
1657439029967,CSE 140,A01,083663,Gungor; Onat,15,0,85,70
1657439035994,CSE 140L,A01,083088,Eldon; John,21,0,100,79
1657439042019,CSE 175,A01,083665,Kumar; Rakesh,3,0,25,22
1657439048043,CSE 190,A00,092507,Dubnov; Shlomo,7,0,20,13
1657439054072,ECE 45,A01,083139,Congero; Spencer William,6,0,75,69
1657439060095,ECE 65,A50,083695,Saad; Andrew S,12,0,30,18
1657439060095,ECE 65,A51,095125,Saad; Andrew S,24,0,26,2
1657439066116,ECE 109,A01,091882,Touri; Behrouz,19,0,70,51
1657439072143,ECE 180,A00,083140,Abi Samra; Nicholas Camill,1,0,30,29
1657439072143,ECE 180,B00,083141,Abi Samra; Nicholas Camill,0,0,30,30
1657439078170,MATH 10A,A01,083735,Patchell; Gregory David,2,0,30,28
1657439078170,MATH 10A,A02,083736,Patchell; Gregory David,20,0,30,10
1657439078170,MATH 10A,A03,083737,Patchell; Gregory David,16,0,30,14
1657439084195,MATH 10B,A01,083207,Lim; Seonhee,8,0,34,26
1657439084195,MATH 10B,A02,083208,Lim; Seonhee,9,0,35,26
1657439084195,MATH 10B,A03,093472,Lim; Seonhee,7,0,34,27
1657439084195,MATH 10B,B01,083739,Sinha; Shubham,12,0,30,18
1657439090220,MATH 18,A01,083743,Cinel; Cameron Alexander,7,0,30,23
1657439090220,MATH 18,A02,083744,Cinel; Cameron Alexander,17,0,30,13
1657439090220,MATH 18,A03,083745,Cinel; Cameron Alexander,9,0,30,21
1657439090220,MATH 18,B01,083748,Rideout; David Porter,5,0,37,32
1657439090220,MATH 18,B02,083749,Rideout; David Porter,5,0,36,31
1657439090220,MATH 18,B03,083750,Rideout; David Porter,3,0,37,34
1657439090220,MATH 18,B04,083751,Rideout; David Porter,6,0,36,30
1657439090220,MATH 18,B05,093473,Rideout; David Porter,6,0,36,30
1657439090220,MATH 18,B06,093474,Rideout; David Porter,6,0,36,30
1657439096243,MATH 20A,A01,083754,Zheng; Zequn,14,0,40,26
1657439102269,MATH 20B,A01,083756,Briones; Jor-el Thomas Caparas,4,0,36,32
1657439102269,MATH 20B,A02,083757,Briones; Jor-el Thomas Caparas,1,0,36,35
1657439102269,MATH 20B,A03,093475,Briones; Jor-el Thomas Caparas,2,0,36,34
1657439108292,MATH 20C,A01,083760,Briones; Jor-el Thomas Caparas,1,0,35,34
1657439108292,MATH 20C,A02,083761,Briones; Jor-el Thomas Caparas,8,0,35,27
1657439108292,MATH 20C,A03,093476,Briones; Jor-el Thomas Caparas,0,1,36,36
1657439108292,MATH 20C,B01,083762,Bach; Quang Tran,1,0,30,29
1657439114315,MATH 20D,A01,083765,Tran; Brian Kha,5,0,30,25
1657439114315,MATH 20D,A02,083766,Tran; Brian Kha,5,0,30,25
1657439114315,MATH 20D,A03,083767,Tran; Brian Kha,5,0,30,25
1657439120344,MATH 20E,A01,083771,Ganguly; Soumya,9,0,32,23
1657439120344,MATH 20E,A02,083772,Ganguly; Soumya,6,0,32,26
1657439120344,MATH 20E,B01,083773,Ciotti; Benjamin,20,0,35,15
1657439120344,MATH 20E,B02,083774,Ciotti; Benjamin,17,0,35,18
1657439126372,MATH 103A,A01,083777,Greenfeld; Be'Eri,3,0,36,33
1657439126372,MATH 103A,A02,083778,Greenfeld; Be'Eri,5,0,36,31
1657439126372,MATH 103A,A03,093561,Greenfeld; Be'Eri,5,0,36,31
1657439126372,MATH 103A,B01,083779,Greenfeld; Be'Eri,7,0,36,29
1657439126372,MATH 103A,B02,083780,Greenfeld; Be'Eri,4,0,36,32
1657439126372,MATH 103A,B03,093562,Greenfeld; Be'Eri,3,0,36,33
1657439132399,MATH 105,A01,085443,Carter; Anne Toulson,15,0,35,20
1657439132399,MATH 105,A02,093477,Carter; Anne Toulson,20,0,35,15
1657439138423,MATH 109,A01,083213,Ganzberger; Geoffrey Michael,2,0,34,32
1657439138423,MATH 109,A02,083214,Ganzberger; Geoffrey Michael,4,0,34,30
1657439138423,MATH 109,A03,093478,Ganzberger; Geoffrey Michael,2,0,34,32
1657439138423,MATH 109,B01,083215,Ganzberger; Geoffrey Michael,1,0,32,31
1657439138423,MATH 109,B02,083216,Ganzberger; Geoffrey Michael,2,0,32,30
1657439138423,MATH 109,B03,093479,Ganzberger; Geoffrey Michael,8,0,32,24
1657439144451,MATH 142A,A01,083219,Chow; Bennett,7,0,32,25
1657439144451,MATH 142A,A02,083220,Chow; Bennett,10,0,32,22
1657439144451,MATH 142A,A03,093480,Chow; Bennett,8,0,32,24
1657439144451,MATH 142A,B03,093481,Chow; Bennett,8,0,32,24
1657439144451,MATH 142A,B04,093558,Chow; Bennett,13,0,32,19
1657439144451,MATH 142A,B05,093559,Chow; Bennett,6,0,32,26
1657439150475,MATH 193A,A01,083224,Rotar; Vladimir,8,0,34,26
1657439150475,MATH 193A,A02,083225,Rotar; Vladimir,9,0,34,25
1657439150475,MATH 193A,A03,083781,Rotar; Vladimir,5,0,34,29
1657439150475,MATH 193A,A04,083782,Rotar; Vladimir,10,0,34,24
1657439150475,MATH 193A,A05,093482,Rotar; Vladimir,10,0,34,24
1657439156498,MATH 197,001,091859,McAuley; Julian John,9999,0,9999,0
1657439156498,MATH 197,002,095566,Kedlaya; Kiran S.,9997,0,9999,2
1657439156498,MATH 197,003,095567,Xiao; Ming,9999,0,9999,0
1657439156498,MATH 197,004,095571,Perols; Johan Lars,9998,0,9999,1
1657439163563,COGS 9,A01,083615,Shannon; Kyle Michael,9,0,75,66
1657439169593,COGS 11,A01,083617,Boyle; Mary E. T.,22,0,48,26
1657439175616,COGS 13,A01,083071,Bastos; Amalia Pinkusfeld,11,0,71,60
1657439181640,COGS 14A,A01,092681,Semenuks; Arturs,5,1,100,95
1657439187663,COGS 14B,A01,083073,Cheng; Tzu-Han,6,0,63,57
1657439193687,COGS 17,A01,092677,Semenuks; Arturs,6,0,81,75
1657439199723,COGS 100,A01,083619,Allen; Michael Gordon,17,0,70,53
1657439205751,COGS 101A,A01,083621,Davis; Joshua Daniel,9,0,68,59
1657439211773,COGS 101B,A01,091572,Allen; Michael Gordon,12,0,65,53
1657439217805,COGS 101C,A01,083625,Delgado; Tania,17,0,35,18
1657439223828,COGS 107A,A01,083627,Boyle; Mary E. T.,13,0,60,47
1657439229851,COGS 118A,A01,083075,Gupta; Anjum,21,0,76,55
1657439235879,CSE 3,A50,083646,Miranda; Gregory Joseph,24,0,50,26
1657439241903,CSE 8A,A50,083650,Miranda; Gregory Joseph,17,1,56,39
1657439247925,CSE 11,A01,083080,Cao; Yingjun,6,15,40,34
1657439253949,CSE 12,A01,083652,Krause-Levy; Sophia Louisa,28,1,120,92
1657439259971,CSE 15L,A01,083654,Morris; Justin Loren,9,0,50,41
1657439259971,CSE 15L,A02,083655,Morris; Justin Loren,9,0,50,41
1657439265999,CSE 20,A01,083657,Tran; Khoa Dang,39,0,80,41
1657439272023,CSE 21,A01,095574,Bach; Quang Tran,22,0,48,26
1657439278045,CSE 30,A01,083084,Eldon; John,5,0,80,75
1657439278045,CSE 30,B01,095061,Bhaskar; Nishant,9,0,50,41
1657439284072,CSE 100,A01,083659,Cao; Yingjun,5,4,70,65
1657439290099,CSE 134B,A01,083661,Powell; Thomas Allan,22,0,100,78
1657439296125,CSE 140,A01,083663,Gungor; Onat,15,0,85,70
1657439302148,CSE 140L,A01,083088,Eldon; John,21,0,100,79
1657439308181,CSE 175,A01,083665,Kumar; Rakesh,3,0,25,22
1657439314204,CSE 190,A00,092507,Dubnov; Shlomo,7,0,20,13
1657439320231,ECE 45,A01,083139,Congero; Spencer William,6,0,75,69
1657439326254,ECE 65,A50,083695,Saad; Andrew S,12,0,30,18
1657439326254,ECE 65,A51,095125,Saad; Andrew S,24,0,26,2
1657439332277,ECE 109,A01,091882,Touri; Behrouz,19,0,70,51
1657439338300,ECE 180,A00,083140,Abi Samra; Nicholas Camill,1,0,30,29
1657439338300,ECE 180,B00,083141,Abi Samra; Nicholas Camill,0,0,30,30
1657439344335,MATH 10A,A01,083735,Patchell; Gregory David,2,0,30,28
1657439344335,MATH 10A,A02,083736,Patchell; Gregory David,20,0,30,10
1657439344335,MATH 10A,A03,083737,Patchell; Gregory David,16,0,30,14
1657439350362,MATH 10B,A01,083207,Lim; Seonhee,8,0,34,26
1657439350362,MATH 10B,A02,083208,Lim; Seonhee,9,0,35,26
1657439350362,MATH 10B,A03,093472,Lim; Seonhee,7,0,34,27
1657439350362,MATH 10B,B01,083739,Sinha; Shubham,12,0,30,18
1657439356393,MATH 18,A01,083743,Cinel; Cameron Alexander,7,0,30,23
1657439356393,MATH 18,A02,083744,Cinel; Cameron Alexander,17,0,30,13
1657439356393,MATH 18,A03,083745,Cinel; Cameron Alexander,9,0,30,21
1657439356393,MATH 18,B01,083748,Rideout; David Porter,5,0,37,32
1657439356393,MATH 18,B02,083749,Rideout; David Porter,5,0,36,31
1657439356393,MATH 18,B03,083750,Rideout; David Porter,3,0,37,34
1657439356393,MATH 18,B04,083751,Rideout; David Porter,6,0,36,30
1657439356393,MATH 18,B05,093473,Rideout; David Porter,6,0,36,30
1657439356393,MATH 18,B06,093474,Rideout; David Porter,6,0,36,30
1657439362420,MATH 20A,A01,083754,Zheng; Zequn,14,0,40,26
1657439368443,MATH 20B,A01,083756,Briones; Jor-el Thomas Caparas,4,0,36,32
1657439368443,MATH 20B,A02,083757,Briones; Jor-el Thomas Caparas,1,0,36,35
1657439368443,MATH 20B,A03,093475,Briones; Jor-el Thomas Caparas,2,0,36,34
1657439374466,MATH 20C,A01,083760,Briones; Jor-el Thomas Caparas,1,0,35,34
1657439374466,MATH 20C,A02,083761,Briones; Jor-el Thomas Caparas,8,0,35,27
1657439374466,MATH 20C,A03,093476,Briones; Jor-el Thomas Caparas,0,1,36,36
1657439374466,MATH 20C,B01,083762,Bach; Quang Tran,1,0,30,29
1657439380490,MATH 20D,A01,083765,Tran; Brian Kha,5,0,30,25
1657439380490,MATH 20D,A02,083766,Tran; Brian Kha,5,0,30,25
1657439380490,MATH 20D,A03,083767,Tran; Brian Kha,5,0,30,25
1657439386519,MATH 20E,A01,083771,Ganguly; Soumya,9,0,32,23
1657439386519,MATH 20E,A02,083772,Ganguly; Soumya,6,0,32,26
1657439386519,MATH 20E,B01,083773,Ciotti; Benjamin,20,0,35,15
1657439386519,MATH 20E,B02,083774,Ciotti; Benjamin,17,0,35,18
1657439392544,MATH 103A,A01,083777,Greenfeld; Be'Eri,3,0,36,33
1657439392544,MATH 103A,A02,083778,Greenfeld; Be'Eri,5,0,36,31
1657439392544,MATH 103A,A03,093561,Greenfeld; Be'Eri,5,0,36,31
1657439392544,MATH 103A,B01,083779,Greenfeld; Be'Eri,7,0,36,29
1657439392544,MATH 103A,B02,083780,Greenfeld; Be'Eri,4,0,36,32
1657439392544,MATH 103A,B03,093562,Greenfeld; Be'Eri,3,0,36,33
1657439398572,MATH 105,A01,085443,Carter; Anne Toulson,15,0,35,20
1657439398572,MATH 105,A02,093477,Carter; Anne Toulson,20,0,35,15
1657439404596,MATH 109,A01,083213,Ganzberger; Geoffrey Michael,2,0,34,32
1657439404596,MATH 109,A02,083214,Ganzberger; Geoffrey Michael,4,0,34,30
1657439404596,MATH 109,A03,093478,Ganzberger; Geoffrey Michael,2,0,34,32
1657439404596,MATH 109,B01,083215,Ganzberger; Geoffrey Michael,1,0,32,31
1657439404596,MATH 109,B02,083216,Ganzberger; Geoffrey Michael,2,0,32,30
1657439404596,MATH 109,B03,093479,Ganzberger; Geoffrey Michael,8,0,32,24
1657439410619,MATH 142A,A01,083219,Chow; Bennett,7,0,32,25
1657439410619,MATH 142A,A02,083220,Chow; Bennett,10,0,32,22
1657439410619,MATH 142A,A03,093480,Chow; Bennett,8,0,32,24
1657439410619,MATH 142A,B03,093481,Chow; Bennett,8,0,32,24
1657439410619,MATH 142A,B04,093558,Chow; Bennett,13,0,32,19
1657439410619,MATH 142A,B05,093559,Chow; Bennett,6,0,32,26
1657439416642,MATH 193A,A01,083224,Rotar; Vladimir,8,0,34,26
1657439416642,MATH 193A,A02,083225,Rotar; Vladimir,9,0,34,25
1657439416642,MATH 193A,A03,083781,Rotar; Vladimir,5,0,34,29
1657439416642,MATH 193A,A04,083782,Rotar; Vladimir,10,0,34,24
1657439416642,MATH 193A,A05,093482,Rotar; Vladimir,10,0,34,24
1657439422666,MATH 197,001,091859,McAuley; Julian John,9999,0,9999,0
1657439422666,MATH 197,002,095566,Kedlaya; Kiran S.,9997,0,9999,2
1657439422666,MATH 197,003,095567,Xiao; Ming,9999,0,9999,0
1657439422666,MATH 197,004,095571,Perols; Johan Lars,9998,0,9999,1
1657439429809,COGS 9,A01,083615,Shannon; Kyle Michael,9,0,75,66
1657439435835,COGS 11,A01,083617,Boyle; Mary E. T.,22,0,48,26
1657439441867,COGS 13,A01,083071,Bastos; Amalia Pinkusfeld,11,0,71,60
1657439447894,COGS 14A,A01,092681,Semenuks; Arturs,5,1,100,95
1657439453921,COGS 14B,A01,083073,Cheng; Tzu-Han,6,0,63,57
1657439459943,COGS 17,A01,092677,Semenuks; Arturs,6,0,81,75
1657439465965,COGS 100,A01,083619,Allen; Michael Gordon,17,0,70,53
1657439471988,COGS 101A,A01,083621,Davis; Joshua Daniel,9,0,68,59
1657439478011,COGS 101B,A01,091572,Allen; Michael Gordon,12,0,65,53
1657439484037,COGS 101C,A01,083625,Delgado; Tania,17,0,35,18
1657439490060,COGS 107A,A01,083627,Boyle; Mary E. T.,13,0,60,47
1657439496092,COGS 118A,A01,083075,Gupta; Anjum,21,0,76,55
1657439502121,CSE 3,A50,083646,Miranda; Gregory Joseph,24,0,50,26
1657439508143,CSE 8A,A50,083650,Miranda; Gregory Joseph,17,1,56,39
1657439514177,CSE 11,A01,083080,Cao; Yingjun,6,15,40,34
1657439520203,CSE 12,A01,083652,Krause-Levy; Sophia Louisa,28,1,120,92
1657439526226,CSE 15L,A01,083654,Morris; Justin Loren,9,0,50,41
1657439526226,CSE 15L,A02,083655,Morris; Justin Loren,9,0,50,41
1657439532248,CSE 20,A01,083657,Tran; Khoa Dang,39,0,80,41
1657439538275,CSE 21,A01,095574,Bach; Quang Tran,22,0,48,26
1657439544299,CSE 30,A01,083084,Eldon; John,5,0,80,75
1657439544299,CSE 30,B01,095061,Bhaskar; Nishant,9,0,50,41
1657439550325,CSE 100,A01,083659,Cao; Yingjun,5,4,70,65
1657439556348,CSE 134B,A01,083661,Powell; Thomas Allan,22,0,100,78
1657439562371,CSE 140,A01,083663,Gungor; Onat,15,0,85,70
1657439568393,CSE 140L,A01,083088,Eldon; John,21,0,100,79
1657439574418,CSE 175,A01,083665,Kumar; Rakesh,3,0,25,22
1657439580440,CSE 190,A00,092507,Dubnov; Shlomo,7,0,20,13
1657439586464,ECE 45,A01,083139,Congero; Spencer William,6,0,75,69
1657439592491,ECE 65,A50,083695,Saad; Andrew S,12,0,30,18
1657439592491,ECE 65,A51,095125,Saad; Andrew S,24,0,26,2
1657439598516,ECE 109,A01,091882,Touri; Behrouz,19,0,70,51
1657439604541,ECE 180,A00,083140,Abi Samra; Nicholas Camill,1,0,30,29
1657439604541,ECE 180,B00,083141,Abi Samra; Nicholas Camill,0,0,30,30
1657439610564,MATH 10A,A01,083735,Patchell; Gregory David,2,0,30,28
1657439610564,MATH 10A,A02,083736,Patchell; Gregory David,20,0,30,10
1657439610564,MATH 10A,A03,083737,Patchell; Gregory David,16,0,30,14
1657439616594,MATH 10B,A01,083207,Lim; Seonhee,8,0,34,26
1657439616594,MATH 10B,A02,083208,Lim; Seonhee,9,0,35,26
1657439616594,MATH 10B,A03,093472,Lim; Seonhee,7,0,34,27
1657439616594,MATH 10B,B01,083739,Sinha; Shubham,12,0,30,18
1657439622625,MATH 18,A01,083743,Cinel; Cameron Alexander,7,0,30,23
1657439622625,MATH 18,A02,083744,Cinel; Cameron Alexander,17,0,30,13
1657439622625,MATH 18,A03,083745,Cinel; Cameron Alexander,9,0,30,21
1657439622625,MATH 18,B01,083748,Rideout; David Porter,5,0,37,32
1657439622625,MATH 18,B02,083749,Rideout; David Porter,5,0,36,31
1657439622625,MATH 18,B03,083750,Rideout; David Porter,3,0,37,34
1657439622625,MATH 18,B04,083751,Rideout; David Porter,6,0,36,30
1657439622625,MATH 18,B05,093473,Rideout; David Porter,6,0,36,30
1657439622625,MATH 18,B06,093474,Rideout; David Porter,6,0,36,30
1657439628646,MATH 20A,A01,083754,Zheng; Zequn,14,0,40,26
1657439634669,MATH 20B,A01,083756,Briones; Jor-el Thomas Caparas,4,0,36,32
1657439634669,MATH 20B,A02,083757,Briones; Jor-el Thomas Caparas,1,0,36,35
1657439634669,MATH 20B,A03,093475,Briones; Jor-el Thomas Caparas,2,0,36,34
1657439640702,MATH 20C,A01,083760,Briones; Jor-el Thomas Caparas,1,0,35,34
1657439640702,MATH 20C,A02,083761,Briones; Jor-el Thomas Caparas,8,0,35,27
1657439640702,MATH 20C,A03,093476,Briones; Jor-el Thomas Caparas,0,1,36,36
1657439640702,MATH 20C,B01,083762,Bach; Quang Tran,1,0,30,29
1657439646730,MATH 20D,A01,083765,Tran; Brian Kha,5,0,30,25
1657439646730,MATH 20D,A02,083766,Tran; Brian Kha,5,0,30,25
1657439646730,MATH 20D,A03,083767,Tran; Brian Kha,5,0,30,25
1657439652755,MATH 20E,A01,083771,Ganguly; Soumya,9,0,32,23
1657439652755,MATH 20E,A02,083772,Ganguly; Soumya,6,0,32,26
1657439652755,MATH 20E,B01,083773,Ciotti; Benjamin,20,0,35,15
1657439652755,MATH 20E,B02,083774,Ciotti; Benjamin,17,0,35,18
1657439658778,MATH 103A,A01,083777,Greenfeld; Be'Eri,3,0,36,33
1657439658778,MATH 103A,A02,083778,Greenfeld; Be'Eri,5,0,36,31
1657439658778,MATH 103A,A03,093561,Greenfeld; Be'Eri,5,0,36,31
1657439658778,MATH 103A,B01,083779,Greenfeld; Be'Eri,7,0,36,29
1657439658778,MATH 103A,B02,083780,Greenfeld; Be'Eri,4,0,36,32
1657439658778,MATH 103A,B03,093562,Greenfeld; Be'Eri,3,0,36,33
1657439664802,MATH 105,A01,085443,Carter; Anne Toulson,15,0,35,20
1657439664802,MATH 105,A02,093477,Carter; Anne Toulson,20,0,35,15
1657439670826,MATH 109,A01,083213,Ganzberger; Geoffrey Michael,2,0,34,32
1657439670826,MATH 109,A02,083214,Ganzberger; Geoffrey Michael,4,0,34,30
1657439670826,MATH 109,A03,093478,Ganzberger; Geoffrey Michael,2,0,34,32
1657439670826,MATH 109,B01,083215,Ganzberger; Geoffrey Michael,1,0,32,31
1657439670826,MATH 109,B02,083216,Ganzberger; Geoffrey Michael,2,0,32,30
1657439670826,MATH 109,B03,093479,Ganzberger; Geoffrey Michael,8,0,32,24
1657439676850,MATH 142A,A01,083219,Chow; Bennett,7,0,32,25
1657439676850,MATH 142A,A02,083220,Chow; Bennett,10,0,32,22
1657439676850,MATH 142A,A03,093480,Chow; Bennett,8,0,32,24
1657439676850,MATH 142A,B03,093481,Chow; Bennett,8,0,32,24
1657439676850,MATH 142A,B04,093558,Chow; Bennett,13,0,32,19
1657439676850,MATH 142A,B05,093559,Chow; Bennett,6,0,32,26
1657439682874,MATH 193A,A01,083224,Rotar; Vladimir,8,0,34,26
1657439682874,MATH 193A,A02,083225,Rotar; Vladimir,9,0,34,25
1657439682874,MATH 193A,A03,083781,Rotar; Vladimir,5,0,34,29
1657439682874,MATH 193A,A04,083782,Rotar; Vladimir,10,0,34,24
1657439682874,MATH 193A,A05,093482,Rotar; Vladimir,10,0,34,24
1657439688900,MATH 197,001,091859,McAuley; Julian John,9999,0,9999,0
1657439688900,MATH 197,002,095566,Kedlaya; Kiran S.,9997,0,9999,2
1657439688900,MATH 197,003,095567,Xiao; Ming,9999,0,9999,0
1657439688900,MATH 197,004,095571,Perols; Johan Lars,9998,0,9999,1
1657439695958,COGS 9,A01,083615,Shannon; Kyle Michael,9,0,75,66
1657439701985,COGS 11,A01,083617,Boyle; Mary E. T.,22,0,48,26
1657439708011,COGS 13,A01,083071,Bastos; Amalia Pinkusfeld,11,0,71,60
1657439714037,COGS 14A,A01,092681,Semenuks; Arturs,5,1,100,95
1657439720059,COGS 14B,A01,083073,Cheng; Tzu-Han,6,0,63,57
1657439726088,COGS 17,A01,092677,Semenuks; Arturs,6,0,81,75
1657439732111,COGS 100,A01,083619,Allen; Michael Gordon,17,0,70,53
1657439738135,COGS 101A,A01,083621,Davis; Joshua Daniel,9,0,68,59
1657439744158,COGS 101B,A01,091572,Allen; Michael Gordon,12,0,65,53
1657439750187,COGS 101C,A01,083625,Delgado; Tania,17,0,35,18
1657439756208,COGS 107A,A01,083627,Boyle; Mary E. T.,13,0,60,47
1657439762231,COGS 118A,A01,083075,Gupta; Anjum,21,0,76,55
1657439768259,CSE 3,A50,083646,Miranda; Gregory Joseph,24,0,50,26
1657439774281,CSE 8A,A50,083650,Miranda; Gregory Joseph,17,1,56,39
1657439780309,CSE 11,A01,083080,Cao; Yingjun,6,15,40,34
1657439786331,CSE 12,A01,083652,Krause-Levy; Sophia Louisa,28,1,120,92
1657439792355,CSE 15L,A01,083654,Morris; Justin Loren,9,0,50,41
1657439792355,CSE 15L,A02,083655,Morris; Justin Loren,9,0,50,41
1657439798381,CSE 20,A01,083657,Tran; Khoa Dang,39,0,80,41
1657439804415,CSE 21,A01,095574,Bach; Quang Tran,22,0,48,26
1657439810454,CSE 30,A01,083084,Eldon; John,5,0,80,75
1657439810454,CSE 30,B01,095061,Bhaskar; Nishant,9,0,50,41
1657439816476,CSE 100,A01,083659,Cao; Yingjun,5,4,70,65
1657439822498,CSE 134B,A01,083661,Powell; Thomas Allan,22,0,100,78
1657439828519,CSE 140,A01,083663,Gungor; Onat,15,0,85,70
1657439834543,CSE 140L,A01,083088,Eldon; John,21,0,100,79
1657439840569,CSE 175,A01,083665,Kumar; Rakesh,3,0,25,22
1657439846594,CSE 190,A00,092507,Dubnov; Shlomo,7,0,20,13
1657439852617,ECE 45,A01,083139,Congero; Spencer William,6,0,75,69
1657439858645,ECE 65,A50,083695,Saad; Andrew S,12,0,30,18
1657439858645,ECE 65,A51,095125,Saad; Andrew S,24,0,26,2
1657439864671,ECE 109,A01,091882,Touri; Behrouz,19,0,70,51
1657439870707,ECE 180,A00,083140,Abi Samra; Nicholas Camill,1,0,30,29
1657439870707,ECE 180,B00,083141,Abi Samra; Nicholas Camill,0,0,30,30
1657439876730,MATH 10A,A01,083735,Patchell; Gregory David,2,0,30,28
1657439876730,MATH 10A,A02,083736,Patchell; Gregory David,20,0,30,10
1657439876730,MATH 10A,A03,083737,Patchell; Gregory David,16,0,30,14
1657439882768,MATH 10B,A01,083207,Lim; Seonhee,8,0,34,26
1657439882768,MATH 10B,A02,083208,Lim; Seonhee,9,0,35,26
1657439882768,MATH 10B,A03,093472,Lim; Seonhee,7,0,34,27
1657439882768,MATH 10B,B01,083739,Sinha; Shubham,12,0,30,18
1657439888799,MATH 18,A01,083743,Cinel; Cameron Alexander,7,0,30,23
1657439888799,MATH 18,A02,083744,Cinel; Cameron Alexander,17,0,30,13
1657439888799,MATH 18,A03,083745,Cinel; Cameron Alexander,9,0,30,21
1657439888799,MATH 18,B01,083748,Rideout; David Porter,5,0,37,32
1657439888799,MATH 18,B02,083749,Rideout; David Porter,5,0,36,31
1657439888799,MATH 18,B03,083750,Rideout; David Porter,3,0,37,34
1657439888799,MATH 18,B04,083751,Rideout; David Porter,6,0,36,30
1657439888799,MATH 18,B05,093473,Rideout; David Porter,6,0,36,30
1657439888799,MATH 18,B06,093474,Rideout; David Porter,6,0,36,30
1657439894821,MATH 20A,A01,083754,Zheng; Zequn,14,0,40,26
1657439900849,MATH 20B,A01,083756,Briones; Jor-el Thomas Caparas,4,0,36,32
1657439900849,MATH 20B,A02,083757,Briones; Jor-el Thomas Caparas,1,0,36,35
1657439900849,MATH 20B,A03,093475,Briones; Jor-el Thomas Caparas,2,0,36,34
1657439906873,MATH 20C,A01,083760,Briones; Jor-el Thomas Caparas,1,0,35,34
1657439906873,MATH 20C,A02,083761,Briones; Jor-el Thomas Caparas,8,0,35,27
1657439906873,MATH 20C,A03,093476,Briones; Jor-el Thomas Caparas,0,1,36,36
1657439906873,MATH 20C,B01,083762,Bach; Quang Tran,1,0,30,29
1657439912897,MATH 20D,A01,083765,Tran; Brian Kha,5,0,30,25
1657439912897,MATH 20D,A02,083766,Tran; Brian Kha,5,0,30,25
1657439912897,MATH 20D,A03,083767,Tran; Brian Kha,5,0,30,25
1657439918924,MATH 20E,A01,083771,Ganguly; Soumya,9,0,32,23
1657439918924,MATH 20E,A02,083772,Ganguly; Soumya,6,0,32,26
1657439918924,MATH 20E,B01,083773,Ciotti; Benjamin,20,0,35,15
1657439918924,MATH 20E,B02,083774,Ciotti; Benjamin,17,0,35,18
1657439924949,MATH 103A,A01,083777,Greenfeld; Be'Eri,3,0,36,33
1657439924949,MATH 103A,A02,083778,Greenfeld; Be'Eri,5,0,36,31
1657439924949,MATH 103A,A03,093561,Greenfeld; Be'Eri,5,0,36,31
1657439924949,MATH 103A,B01,083779,Greenfeld; Be'Eri,7,0,36,29
1657439924949,MATH 103A,B02,083780,Greenfeld; Be'Eri,4,0,36,32
1657439924949,MATH 103A,B03,093562,Greenfeld; Be'Eri,3,0,36,33
1657439930971,MATH 105,A01,085443,Carter; Anne Toulson,15,0,35,20
1657439930971,MATH 105,A02,093477,Carter; Anne Toulson,20,0,35,15
1657439936998,MATH 109,A01,083213,Ganzberger; Geoffrey Michael,2,0,34,32
1657439936998,MATH 109,A02,083214,Ganzberger; Geoffrey Michael,4,0,34,30
1657439936998,MATH 109,A03,093478,Ganzberger; Geoffrey Michael,2,0,34,32
1657439936998,MATH 109,B01,083215,Ganzberger; Geoffrey Michael,1,0,32,31
1657439936998,MATH 109,B02,083216,Ganzberger; Geoffrey Michael,2,0,32,30
1657439936998,MATH 109,B03,093479,Ganzberger; Geoffrey Michael,8,0,32,24
1657439943020,MATH 142A,A01,083219,Chow; Bennett,7,0,32,25
1657439943020,MATH 142A,A02,083220,Chow; Bennett,10,0,32,22
1657439943020,MATH 142A,A03,093480,Chow; Bennett,8,0,32,24
1657439943020,MATH 142A,B03,093481,Chow; Bennett,8,0,32,24
1657439943020,MATH 142A,B04,093558,Chow; Bennett,13,0,32,19
1657439943020,MATH 142A,B05,093559,Chow; Bennett,6,0,32,26
1657439949046,MATH 193A,A01,083224,Rotar; Vladimir,8,0,34,26
1657439949046,MATH 193A,A02,083225,Rotar; Vladimir,9,0,34,25
1657439949046,MATH 193A,A03,083781,Rotar; Vladimir,5,0,34,29
1657439949046,MATH 193A,A04,083782,Rotar; Vladimir,10,0,34,24
1657439949046,MATH 193A,A05,093482,Rotar; Vladimir,10,0,34,24
1657439955070,MATH 197,001,091859,McAuley; Julian John,9999,0,9999,0
1657439955070,MATH 197,002,095566,Kedlaya; Kiran S.,9997,0,9999,2
1657439955070,MATH 197,003,095567,Xiao; Ming,9999,0,9999,0
1657439955070,MATH 197,004,095571,Perols; Johan Lars,9998,0,9999,1
1657439962138,COGS 9,A01,083615,Shannon; Kyle Michael,9,0,75,66
1657439968163,COGS 11,A01,083617,Boyle; Mary E. T.,22,0,48,26
1657439974187,COGS 13,A01,083071,Bastos; Amalia Pinkusfeld,11,0,71,60
1657439980216,COGS 14A,A01,092681,Semenuks; Arturs,5,1,100,95
1657439986243,COGS 14B,A01,083073,Cheng; Tzu-Han,6,0,63,57
1657439992272,COGS 17,A01,092677,Semenuks; Arturs,6,0,81,75
1657439998295,COGS 100,A01,083619,Allen; Michael Gordon,17,0,70,53
1657440004330,COGS 101A,A01,083621,Davis; Joshua Daniel,9,0,68,59
1657440010352,COGS 101B,A01,091572,Allen; Michael Gordon,12,0,65,53
1657440016378,COGS 101C,A01,083625,Delgado; Tania,17,0,35,18
1657440022476,COGS 107A,A01,083627,Boyle; Mary E. T.,13,0,60,47
1657440028499,COGS 118A,A01,083075,Gupta; Anjum,21,0,76,55
1657440034530,CSE 3,A50,083646,Miranda; Gregory Joseph,24,0,50,26
1657440040554,CSE 8A,A50,083650,Miranda; Gregory Joseph,17,1,56,39
1657440046574,CSE 11,A01,083080,Cao; Yingjun,6,15,40,34
1657440052597,CSE 12,A01,083652,Krause-Levy; Sophia Louisa,28,1,120,92
1657440058621,CSE 15L,A01,083654,Morris; Justin Loren,9,0,50,41
1657440058621,CSE 15L,A02,083655,Morris; Justin Loren,9,0,50,41
1657440064647,CSE 20,A01,083657,Tran; Khoa Dang,39,0,80,41
1657440070669,CSE 21,A01,095574,Bach; Quang Tran,22,0,48,26
1657440076690,CSE 30,A01,083084,Eldon; John,5,0,80,75
1657440076690,CSE 30,B01,095061,Bhaskar; Nishant,9,0,50,41
1657440082717,CSE 100,A01,083659,Cao; Yingjun,5,4,70,65
1657440088742,CSE 134B,A01,083661,Powell; Thomas Allan,22,0,100,78
1657440094764,CSE 140,A01,083663,Gungor; Onat,15,0,85,70
1657440100790,CSE 140L,A01,083088,Eldon; John,21,0,100,79
1657440106815,CSE 175,A01,083665,Kumar; Rakesh,3,0,25,22
1657440112838,CSE 190,A00,092507,Dubnov; Shlomo,7,0,20,13
1657440118865,ECE 45,A01,083139,Congero; Spencer William,6,0,75,69
1657440124892,ECE 65,A50,083695,Saad; Andrew S,12,0,30,18
1657440124892,ECE 65,A51,095125,Saad; Andrew S,24,0,26,2
1657440130913,ECE 109,A01,091882,Touri; Behrouz,19,0,70,51
1657440136940,ECE 180,A00,083140,Abi Samra; Nicholas Camill,1,0,30,29
1657440136940,ECE 180,B00,083141,Abi Samra; Nicholas Camill,0,0,30,30
1657440142966,MATH 10A,A01,083735,Patchell; Gregory David,2,0,30,28
1657440142966,MATH 10A,A02,083736,Patchell; Gregory David,20,0,30,10
1657440142966,MATH 10A,A03,083737,Patchell; Gregory David,16,0,30,14
1657440148995,MATH 10B,A01,083207,Lim; Seonhee,8,0,34,26
1657440148995,MATH 10B,A02,083208,Lim; Seonhee,9,0,35,26
1657440148995,MATH 10B,A03,093472,Lim; Seonhee,7,0,34,27
1657440148995,MATH 10B,B01,083739,Sinha; Shubham,12,0,30,18
1657440155030,MATH 18,A01,083743,Cinel; Cameron Alexander,7,0,30,23
1657440155030,MATH 18,A02,083744,Cinel; Cameron Alexander,17,0,30,13
1657440155030,MATH 18,A03,083745,Cinel; Cameron Alexander,9,0,30,21
1657440155030,MATH 18,B01,083748,Rideout; David Porter,5,0,37,32
1657440155030,MATH 18,B02,083749,Rideout; David Porter,5,0,36,31
1657440155030,MATH 18,B03,083750,Rideout; David Porter,3,0,37,34
1657440155030,MATH 18,B04,083751,Rideout; David Porter,6,0,36,30
1657440155030,MATH 18,B05,093473,Rideout; David Porter,6,0,36,30
1657440155030,MATH 18,B06,093474,Rideout; David Porter,6,0,36,30
1657440161055,MATH 20A,A01,083754,Zheng; Zequn,14,0,40,26
1657440167078,MATH 20B,A01,083756,Briones; Jor-el Thomas Caparas,4,0,36,32
1657440167078,MATH 20B,A02,083757,Briones; Jor-el Thomas Caparas,1,0,36,35
1657440167078,MATH 20B,A03,093475,Briones; Jor-el Thomas Caparas,2,0,36,34
1657440173102,MATH 20C,A01,083760,Briones; Jor-el Thomas Caparas,1,0,35,34
1657440173102,MATH 20C,A02,083761,Briones; Jor-el Thomas Caparas,8,0,35,27
1657440173102,MATH 20C,A03,093476,Briones; Jor-el Thomas Caparas,0,1,36,36
1657440173102,MATH 20C,B01,083762,Bach; Quang Tran,1,0,30,29
1657440179127,MATH 20D,A01,083765,Tran; Brian Kha,5,0,30,25
1657440179127,MATH 20D,A02,083766,Tran; Brian Kha,5,0,30,25
1657440179127,MATH 20D,A03,083767,Tran; Brian Kha,5,0,30,25
1657440185149,MATH 20E,A01,083771,Ganguly; Soumya,9,0,32,23
1657440185149,MATH 20E,A02,083772,Ganguly; Soumya,6,0,32,26
1657440185149,MATH 20E,B01,083773,Ciotti; Benjamin,20,0,35,15
1657440185149,MATH 20E,B02,083774,Ciotti; Benjamin,17,0,35,18
1657440191173,MATH 103A,A01,083777,Greenfeld; Be'Eri,3,0,36,33
1657440191173,MATH 103A,A02,083778,Greenfeld; Be'Eri,5,0,36,31
1657440191173,MATH 103A,A03,093561,Greenfeld; Be'Eri,5,0,36,31
1657440191173,MATH 103A,B01,083779,Greenfeld; Be'Eri,7,0,36,29
1657440191173,MATH 103A,B02,083780,Greenfeld; Be'Eri,4,0,36,32
1657440191173,MATH 103A,B03,093562,Greenfeld; Be'Eri,3,0,36,33
1657440197197,MATH 105,A01,085443,Carter; Anne Toulson,15,0,35,20
1657440197197,MATH 105,A02,093477,Carter; Anne Toulson,20,0,35,15
1657440203220,MATH 109,A01,083213,Ganzberger; Geoffrey Michael,2,0,34,32
1657440203220,MATH 109,A02,083214,Ganzberger; Geoffrey Michael,4,0,34,30
1657440203220,MATH 109,A03,093478,Ganzberger; Geoffrey Michael,2,0,34,32
1657440203220,MATH 109,B01,083215,Ganzberger; Geoffrey Michael,1,0,32,31
1657440203220,MATH 109,B02,083216,Ganzberger; Geoffrey Michael,2,0,32,30
1657440203220,MATH 109,B03,093479,Ganzberger; Geoffrey Michael,8,0,32,24
1657440209251,MATH 142A,A01,083219,Chow; Bennett,7,0,32,25
1657440209251,MATH 142A,A02,083220,Chow; Bennett,10,0,32,22
1657440209251,MATH 142A,A03,093480,Chow; Bennett,8,0,32,24
1657440209251,MATH 142A,B03,093481,Chow; Bennett,8,0,32,24
1657440209251,MATH 142A,B04,093558,Chow; Bennett,13,0,32,19
1657440209251,MATH 142A,B05,093559,Chow; Bennett,6,0,32,26
1657440215282,MATH 193A,A01,083224,Rotar; Vladimir,8,0,34,26
1657440215282,MATH 193A,A02,083225,Rotar; Vladimir,9,0,34,25
1657440215282,MATH 193A,A03,083781,Rotar; Vladimir,5,0,34,29
1657440215282,MATH 193A,A04,083782,Rotar; Vladimir,10,0,34,24
1657440215282,MATH 193A,A05,093482,Rotar; Vladimir,10,0,34,24
1657440221308,MATH 197,001,091859,McAuley; Julian John,9999,0,9999,0
1657440221308,MATH 197,002,095566,Kedlaya; Kiran S.,9997,0,9999,2
1657440221308,MATH 197,003,095567,Xiao; Ming,9999,0,9999,0
1657440221308,MATH 197,004,095571,Perols; Johan Lars,9998,0,9999,1
1657440228378,COGS 9,A01,083615,Shannon; Kyle Michael,9,0,75,66
1657440234405,COGS 11,A01,083617,Boyle; Mary E. T.,22,0,48,26
1657440240441,COGS 13,A01,083071,Bastos; Amalia Pinkusfeld,11,0,71,60
1657440246467,COGS 14A,A01,092681,Semenuks; Arturs,5,1,100,95
1657440252493,COGS 14B,A01,083073,Cheng; Tzu-Han,6,0,63,57
1657440258515,COGS 17,A01,092677,Semenuks; Arturs,6,0,81,75
1657440264538,COGS 100,A01,083619,Allen; Michael Gordon,17,0,70,53
1657440270569,COGS 101A,A01,083621,Davis; Joshua Daniel,9,0,68,59
1657440276591,COGS 101B,A01,091572,Allen; Michael Gordon,12,0,65,53
1657440282615,COGS 101C,A01,083625,Delgado; Tania,17,0,35,18
1657440288641,COGS 107A,A01,083627,Boyle; Mary E. T.,13,0,60,47
1657440294667,COGS 118A,A01,083075,Gupta; Anjum,21,0,76,55
1657440300703,CSE 3,A50,083646,Miranda; Gregory Joseph,24,0,50,26
1657440306730,CSE 8A,A50,083650,Miranda; Gregory Joseph,17,1,56,39
1657440312753,CSE 11,A01,083080,Cao; Yingjun,6,15,40,34
1657440318779,CSE 12,A01,083652,Krause-Levy; Sophia Louisa,28,1,120,92
1657440324801,CSE 15L,A01,083654,Morris; Justin Loren,9,0,50,41
1657440324801,CSE 15L,A02,083655,Morris; Justin Loren,9,0,50,41
1657440330824,CSE 20,A01,083657,Tran; Khoa Dang,39,0,80,41
1657440336851,CSE 21,A01,095574,Bach; Quang Tran,22,0,48,26
1657440342877,CSE 30,A01,083084,Eldon; John,5,0,80,75
1657440342877,CSE 30,B01,095061,Bhaskar; Nishant,9,0,50,41
1657440348904,CSE 100,A01,083659,Cao; Yingjun,5,4,70,65
1657440354927,CSE 134B,A01,083661,Powell; Thomas Allan,22,0,100,78
1657440360949,CSE 140,A01,083663,Gungor; Onat,15,0,85,70
1657440366977,CSE 140L,A01,083088,Eldon; John,21,0,100,79
1657440373001,CSE 175,A01,083665,Kumar; Rakesh,3,0,25,22
1657440379030,CSE 190,A00,092507,Dubnov; Shlomo,7,0,20,13
1657440385057,ECE 45,A01,083139,Congero; Spencer William,6,0,75,69
1657440391085,ECE 65,A50,083695,Saad; Andrew S,12,0,30,18
1657440391085,ECE 65,A51,095125,Saad; Andrew S,24,0,26,2
1657440397107,ECE 109,A01,091882,Touri; Behrouz,19,0,70,51
1657440403144,ECE 180,A00,083140,Abi Samra; Nicholas Camill,1,0,30,29
1657440403144,ECE 180,B00,083141,Abi Samra; Nicholas Camill,0,0,30,30
1657440409171,MATH 10A,A01,083735,Patchell; Gregory David,2,0,30,28
1657440409171,MATH 10A,A02,083736,Patchell; Gregory David,20,0,30,10
1657440409171,MATH 10A,A03,083737,Patchell; Gregory David,16,0,30,14
1657440415194,MATH 10B,A01,083207,Lim; Seonhee,8,0,34,26
1657440415194,MATH 10B,A02,083208,Lim; Seonhee,9,0,35,26
1657440415194,MATH 10B,A03,093472,Lim; Seonhee,7,0,34,27
1657440415194,MATH 10B,B01,083739,Sinha; Shubham,12,0,30,18
1657440421218,MATH 18,A01,083743,Cinel; Cameron Alexander,7,0,30,23
1657440421218,MATH 18,A02,083744,Cinel; Cameron Alexander,17,0,30,13
1657440421218,MATH 18,A03,083745,Cinel; Cameron Alexander,9,0,30,21
1657440421218,MATH 18,B01,083748,Rideout; David Porter,5,0,37,32
1657440421218,MATH 18,B02,083749,Rideout; David Porter,5,0,36,31
1657440421218,MATH 18,B03,083750,Rideout; David Porter,3,0,37,34
1657440421218,MATH 18,B04,083751,Rideout; David Porter,6,0,36,30
1657440421218,MATH 18,B05,093473,Rideout; David Porter,6,0,36,30
1657440421218,MATH 18,B06,093474,Rideout; David Porter,6,0,36,30
1657440427241,MATH 20A,A01,083754,Zheng; Zequn,14,0,40,26
1657440433263,MATH 20B,A01,083756,Briones; Jor-el Thomas Caparas,4,0,36,32
1657440433263,MATH 20B,A02,083757,Briones; Jor-el Thomas Caparas,1,0,36,35
1657440433263,MATH 20B,A03,093475,Briones; Jor-el Thomas Caparas,2,0,36,34
1657440439289,MATH 20C,A01,083760,Briones; Jor-el Thomas Caparas,1,0,35,34
1657440439289,MATH 20C,A02,083761,Briones; Jor-el Thomas Caparas,8,0,35,27
1657440439289,MATH 20C,A03,093476,Briones; Jor-el Thomas Caparas,0,1,36,36
1657440439289,MATH 20C,B01,083762,Bach; Quang Tran,1,0,30,29
1657440445313,MATH 20D,A01,083765,Tran; Brian Kha,5,0,30,25
1657440445313,MATH 20D,A02,083766,Tran; Brian Kha,5,0,30,25
1657440445313,MATH 20D,A03,083767,Tran; Brian Kha,5,0,30,25
1657440451335,MATH 20E,A01,083771,Ganguly; Soumya,9,0,32,23
1657440451335,MATH 20E,A02,083772,Ganguly; Soumya,6,0,32,26
1657440451335,MATH 20E,B01,083773,Ciotti; Benjamin,20,0,35,15
1657440451335,MATH 20E,B02,083774,Ciotti; Benjamin,17,0,35,18
1657440457359,MATH 103A,A01,083777,Greenfeld; Be'Eri,3,0,36,33
1657440457359,MATH 103A,A02,083778,Greenfeld; Be'Eri,5,0,36,31
1657440457359,MATH 103A,A03,093561,Greenfeld; Be'Eri,5,0,36,31
1657440457359,MATH 103A,B01,083779,Greenfeld; Be'Eri,7,0,36,29
1657440457359,MATH 103A,B02,083780,Greenfeld; Be'Eri,4,0,36,32
1657440457359,MATH 103A,B03,093562,Greenfeld; Be'Eri,3,0,36,33
1657440463386,MATH 105,A01,085443,Carter; Anne Toulson,15,0,35,20
1657440463386,MATH 105,A02,093477,Carter; Anne Toulson,20,0,35,15
1657440469414,MATH 109,A01,083213,Ganzberger; Geoffrey Michael,2,0,34,32
1657440469414,MATH 109,A02,083214,Ganzberger; Geoffrey Michael,4,0,34,30
1657440469414,MATH 109,A03,093478,Ganzberger; Geoffrey Michael,2,0,34,32
1657440469414,MATH 109,B01,083215,Ganzberger; Geoffrey Michael,1,0,32,31
1657440469414,MATH 109,B02,083216,Ganzberger; Geoffrey Michael,2,0,32,30
1657440469414,MATH 109,B03,093479,Ganzberger; Geoffrey Michael,8,0,32,24
1657440475442,MATH 142A,A01,083219,Chow; Bennett,7,0,32,25
1657440475442,MATH 142A,A02,083220,Chow; Bennett,10,0,32,22
1657440475442,MATH 142A,A03,093480,Chow; Bennett,8,0,32,24
1657440475442,MATH 142A,B03,093481,Chow; Bennett,8,0,32,24
1657440475442,MATH 142A,B04,093558,Chow; Bennett,13,0,32,19
1657440475442,MATH 142A,B05,093559,Chow; Bennett,6,0,32,26
1657440481465,MATH 193A,A01,083224,Rotar; Vladimir,8,0,34,26
1657440481465,MATH 193A,A02,083225,Rotar; Vladimir,9,0,34,25
1657440481465,MATH 193A,A03,083781,Rotar; Vladimir,5,0,34,29
1657440481465,MATH 193A,A04,083782,Rotar; Vladimir,10,0,34,24
1657440481465,MATH 193A,A05,093482,Rotar; Vladimir,10,0,34,24
1657440487488,MATH 197,001,091859,McAuley; Julian John,9999,0,9999,0
1657440487488,MATH 197,002,095566,Kedlaya; Kiran S.,9997,0,9999,2
1657440487488,MATH 197,003,095567,Xiao; Ming,9999,0,9999,0
1657440487488,MATH 197,004,095571,Perols; Johan Lars,9998,0,9999,1
1657440494551,COGS 9,A01,083615,Shannon; Kyle Michael,9,0,75,66
1657440500579,COGS 11,A01,083617,Boyle; Mary E. T.,22,0,48,26
1657440506606,COGS 13,A01,083071,Bastos; Amalia Pinkusfeld,11,0,71,60
1657440512628,COGS 14A,A01,092681,Semenuks; Arturs,5,1,100,95
1657440518654,COGS 14B,A01,083073,Cheng; Tzu-Han,6,0,63,57
1657440524681,COGS 17,A01,092677,Semenuks; Arturs,6,0,81,75
1657440530708,COGS 100,A01,083619,Allen; Michael Gordon,17,0,70,53
1657440536731,COGS 101A,A01,083621,Davis; Joshua Daniel,9,0,68,59
1657440542759,COGS 101B,A01,091572,Allen; Michael Gordon,12,0,65,53
1657440548782,COGS 101C,A01,083625,Delgado; Tania,17,0,35,18
1657440554808,COGS 107A,A01,083627,Boyle; Mary E. T.,13,0,60,47
1657440560830,COGS 118A,A01,083075,Gupta; Anjum,21,0,76,55
1657440566857,CSE 3,A50,083646,Miranda; Gregory Joseph,24,0,50,26
1657440572880,CSE 8A,A50,083650,Miranda; Gregory Joseph,17,1,56,39
1657440578906,CSE 11,A01,083080,Cao; Yingjun,6,15,40,34
1657440584929,CSE 12,A01,083652,Krause-Levy; Sophia Louisa,28,1,120,92
1657440590957,CSE 15L,A01,083654,Morris; Justin Loren,9,0,50,41
1657440590957,CSE 15L,A02,083655,Morris; Justin Loren,9,0,50,41
1657440596984,CSE 20,A01,083657,Tran; Khoa Dang,39,0,80,41
1657440603016,CSE 21,A01,095574,Bach; Quang Tran,22,0,48,26
1657440609038,CSE 30,A01,083084,Eldon; John,5,0,80,75
1657440609038,CSE 30,B01,095061,Bhaskar; Nishant,9,0,50,41
1657440615061,CSE 100,A01,083659,Cao; Yingjun,5,4,70,65
1657440621160,CSE 134B,A01,083661,Powell; Thomas Allan,22,0,100,78
1657440627185,CSE 140,A01,083663,Gungor; Onat,15,0,85,70
1657440633214,CSE 140L,A01,083088,Eldon; John,21,0,100,79
1657440639241,CSE 175,A01,083665,Kumar; Rakesh,3,0,25,22
1657440645263,CSE 190,A00,092507,Dubnov; Shlomo,8,0,20,12
1657440651284,ECE 45,A01,083139,Congero; Spencer William,6,0,75,69
1657440657310,ECE 65,A50,083695,Saad; Andrew S,12,0,30,18
1657440657310,ECE 65,A51,095125,Saad; Andrew S,24,0,26,2
1657440663338,ECE 109,A01,091882,Touri; Behrouz,19,0,70,51
1657440669360,ECE 180,A00,083140,Abi Samra; Nicholas Camill,1,0,30,29
1657440669360,ECE 180,B00,083141,Abi Samra; Nicholas Camill,0,0,30,30
1657440675385,MATH 10A,A01,083735,Patchell; Gregory David,2,0,30,28
1657440675385,MATH 10A,A02,083736,Patchell; Gregory David,20,0,30,10
1657440675385,MATH 10A,A03,083737,Patchell; Gregory David,16,0,30,14
1657440681408,MATH 10B,A01,083207,Lim; Seonhee,8,0,34,26
1657440681408,MATH 10B,A02,083208,Lim; Seonhee,9,0,35,26
1657440681408,MATH 10B,A03,093472,Lim; Seonhee,7,0,34,27
1657440681408,MATH 10B,B01,083739,Sinha; Shubham,12,0,30,18
1657440687433,MATH 18,A01,083743,Cinel; Cameron Alexander,7,0,30,23
1657440687433,MATH 18,A02,083744,Cinel; Cameron Alexander,17,0,30,13
1657440687433,MATH 18,A03,083745,Cinel; Cameron Alexander,9,0,30,21
1657440687433,MATH 18,B01,083748,Rideout; David Porter,5,0,37,32
1657440687433,MATH 18,B02,083749,Rideout; David Porter,5,0,36,31
1657440687433,MATH 18,B03,083750,Rideout; David Porter,3,0,37,34
1657440687433,MATH 18,B04,083751,Rideout; David Porter,6,0,36,30
1657440687433,MATH 18,B05,093473,Rideout; David Porter,6,0,36,30
1657440687433,MATH 18,B06,093474,Rideout; David Porter,6,0,36,30
1657440693454,MATH 20A,A01,083754,Zheng; Zequn,14,0,40,26
1657440699481,MATH 20B,A01,083756,Briones; Jor-el Thomas Caparas,4,0,36,32
1657440699481,MATH 20B,A02,083757,Briones; Jor-el Thomas Caparas,1,0,36,35
1657440699481,MATH 20B,A03,093475,Briones; Jor-el Thomas Caparas,2,0,36,34
1657440705505,MATH 20C,A01,083760,Briones; Jor-el Thomas Caparas,1,0,35,34
1657440705505,MATH 20C,A02,083761,Briones; Jor-el Thomas Caparas,8,0,35,27
1657440705505,MATH 20C,A03,093476,Briones; Jor-el Thomas Caparas,0,1,36,36
1657440705505,MATH 20C,B01,083762,Bach; Quang Tran,1,0,30,29
1657440711526,MATH 20D,A01,083765,Tran; Brian Kha,5,0,30,25
1657440711526,MATH 20D,A02,083766,Tran; Brian Kha,5,0,30,25
1657440711526,MATH 20D,A03,083767,Tran; Brian Kha,5,0,30,25
1657440717562,MATH 20E,A01,083771,Ganguly; Soumya,9,0,32,23
1657440717562,MATH 20E,A02,083772,Ganguly; Soumya,6,0,32,26
1657440717562,MATH 20E,B01,083773,Ciotti; Benjamin,20,0,35,15
1657440717562,MATH 20E,B02,083774,Ciotti; Benjamin,17,0,35,18
1657440723597,MATH 103A,A01,083777,Greenfeld; Be'Eri,3,0,36,33
1657440723597,MATH 103A,A02,083778,Greenfeld; Be'Eri,5,0,36,31
1657440723597,MATH 103A,A03,093561,Greenfeld; Be'Eri,5,0,36,31
1657440723597,MATH 103A,B01,083779,Greenfeld; Be'Eri,7,0,36,29
1657440723597,MATH 103A,B02,083780,Greenfeld; Be'Eri,4,0,36,32
1657440723597,MATH 103A,B03,093562,Greenfeld; Be'Eri,3,0,36,33
1657440729620,MATH 105,A01,085443,Carter; Anne Toulson,15,0,35,20
1657440729620,MATH 105,A02,093477,Carter; Anne Toulson,20,0,35,15
1657440735649,MATH 109,A01,083213,Ganzberger; Geoffrey Michael,2,0,34,32
1657440735649,MATH 109,A02,083214,Ganzberger; Geoffrey Michael,4,0,34,30
1657440735649,MATH 109,A03,093478,Ganzberger; Geoffrey Michael,2,0,34,32
1657440735649,MATH 109,B01,083215,Ganzberger; Geoffrey Michael,1,0,32,31
1657440735649,MATH 109,B02,083216,Ganzberger; Geoffrey Michael,2,0,32,30
1657440735649,MATH 109,B03,093479,Ganzberger; Geoffrey Michael,8,0,32,24
1657440741675,MATH 142A,A01,083219,Chow; Bennett,7,0,32,25
1657440741675,MATH 142A,A02,083220,Chow; Bennett,10,0,32,22
1657440741675,MATH 142A,A03,093480,Chow; Bennett,8,0,32,24
1657440741675,MATH 142A,B03,093481,Chow; Bennett,8,0,32,24
1657440741675,MATH 142A,B04,093558,Chow; Bennett,13,0,32,19
1657440741675,MATH 142A,B05,093559,Chow; Bennett,6,0,32,26
1657440747698,MATH 193A,A01,083224,Rotar; Vladimir,8,0,34,26
1657440747698,MATH 193A,A02,083225,Rotar; Vladimir,9,0,34,25
1657440747698,MATH 193A,A03,083781,Rotar; Vladimir,5,0,34,29
1657440747698,MATH 193A,A04,083782,Rotar; Vladimir,10,0,34,24
1657440747698,MATH 193A,A05,093482,Rotar; Vladimir,10,0,34,24
1657440753724,MATH 197,001,091859,McAuley; Julian John,9999,0,9999,0
1657440753724,MATH 197,002,095566,Kedlaya; Kiran S.,9997,0,9999,2
1657440753724,MATH 197,003,095567,Xiao; Ming,9999,0,9999,0
1657440753724,MATH 197,004,095571,Perols; Johan Lars,9998,0,9999,1
1657440760790,COGS 9,A01,083615,Shannon; Kyle Michael,9,0,75,66
1657440766813,COGS 11,A01,083617,Boyle; Mary E. T.,22,0,48,26
1657440772839,COGS 13,A01,083071,Bastos; Amalia Pinkusfeld,11,0,71,60
1657440778862,COGS 14A,A01,092681,Semenuks; Arturs,5,1,100,95
1657440784887,COGS 14B,A01,083073,Cheng; Tzu-Han,6,0,63,57
1657440790911,COGS 17,A01,092677,Semenuks; Arturs,6,0,81,75
1657440796934,COGS 100,A01,083619,Allen; Michael Gordon,17,0,70,53
1657440802961,COGS 101A,A01,083621,Davis; Joshua Daniel,9,0,68,59
1657440808995,COGS 101B,A01,091572,Allen; Michael Gordon,12,0,65,53
1657440815017,COGS 101C,A01,083625,Delgado; Tania,17,0,35,18
1657440821040,COGS 107A,A01,083627,Boyle; Mary E. T.,13,0,60,47
1657440827062,COGS 118A,A01,083075,Gupta; Anjum,21,0,76,55
1657440833090,CSE 3,A50,083646,Miranda; Gregory Joseph,24,0,50,26
1657440839118,CSE 8A,A50,083650,Miranda; Gregory Joseph,17,1,56,39
1657440845141,CSE 11,A01,083080,Cao; Yingjun,6,15,40,34
1657440851162,CSE 12,A01,083652,Krause-Levy; Sophia Louisa,28,1,120,92
1657440857187,CSE 15L,A01,083654,Morris; Justin Loren,9,0,50,41
1657440857187,CSE 15L,A02,083655,Morris; Justin Loren,9,0,50,41
1657440863215,CSE 20,A01,083657,Tran; Khoa Dang,39,0,80,41
1657440869242,CSE 21,A01,095574,Bach; Quang Tran,22,0,48,26
1657440875269,CSE 30,A01,083084,Eldon; John,5,0,80,75
1657440875269,CSE 30,B01,095061,Bhaskar; Nishant,9,0,50,41
1657440881292,CSE 100,A01,083659,Cao; Yingjun,5,4,70,65
1657440887316,CSE 134B,A01,083661,Powell; Thomas Allan,22,0,100,78
1657440893343,CSE 140,A01,083663,Gungor; Onat,15,0,85,70
1657440899371,CSE 140L,A01,083088,Eldon; John,21,0,100,79
1657440905397,CSE 175,A01,083665,Kumar; Rakesh,3,0,25,22
1657440911419,CSE 190,A00,092507,Dubnov; Shlomo,8,0,20,12
1657440917446,ECE 45,A01,083139,Congero; Spencer William,6,0,75,69
1657440923474,ECE 65,A50,083695,Saad; Andrew S,12,0,30,18
1657440923474,ECE 65,A51,095125,Saad; Andrew S,24,0,26,2
1657440929499,ECE 109,A01,091882,Touri; Behrouz,19,0,70,51
1657440935521,ECE 180,A00,083140,Abi Samra; Nicholas Camill,1,0,30,29
1657440935521,ECE 180,B00,083141,Abi Samra; Nicholas Camill,0,0,30,30
1657440941545,MATH 10A,A01,083735,Patchell; Gregory David,2,0,30,28
1657440941545,MATH 10A,A02,083736,Patchell; Gregory David,20,0,30,10
1657440941545,MATH 10A,A03,083737,Patchell; Gregory David,16,0,30,14
1657440947574,MATH 10B,A01,083207,Lim; Seonhee,8,0,34,26
1657440947574,MATH 10B,A02,083208,Lim; Seonhee,9,0,35,26
1657440947574,MATH 10B,A03,093472,Lim; Seonhee,7,0,34,27
1657440947574,MATH 10B,B01,083739,Sinha; Shubham,12,0,30,18
1657440953597,MATH 18,A01,083743,Cinel; Cameron Alexander,7,0,30,23
1657440953597,MATH 18,A02,083744,Cinel; Cameron Alexander,17,0,30,13
1657440953597,MATH 18,A03,083745,Cinel; Cameron Alexander,9,0,30,21
1657440953597,MATH 18,B01,083748,Rideout; David Porter,5,0,37,32
1657440953597,MATH 18,B02,083749,Rideout; David Porter,5,0,36,31
1657440953597,MATH 18,B03,083750,Rideout; David Porter,3,0,37,34
1657440953597,MATH 18,B04,083751,Rideout; David Porter,6,0,36,30
1657440953597,MATH 18,B05,093473,Rideout; David Porter,6,0,36,30
1657440953597,MATH 18,B06,093474,Rideout; David Porter,6,0,36,30
1657440959620,MATH 20A,A01,083754,Zheng; Zequn,14,0,40,26
1657440965647,MATH 20B,A01,083756,Briones; Jor-el Thomas Caparas,4,0,36,32
1657440965647,MATH 20B,A02,083757,Briones; Jor-el Thomas Caparas,1,0,36,35
1657440965647,MATH 20B,A03,093475,Briones; Jor-el Thomas Caparas,2,0,36,34
1657440971677,MATH 20C,A01,083760,Briones; Jor-el Thomas Caparas,1,0,35,34
1657440971677,MATH 20C,A02,083761,Briones; Jor-el Thomas Caparas,8,0,35,27
1657440971677,MATH 20C,A03,093476,Briones; Jor-el Thomas Caparas,0,1,36,36
1657440971677,MATH 20C,B01,083762,Bach; Quang Tran,1,0,30,29
1657440977705,MATH 20D,A01,083765,Tran; Brian Kha,5,0,30,25
1657440977705,MATH 20D,A02,083766,Tran; Brian Kha,5,0,30,25
1657440977705,MATH 20D,A03,083767,Tran; Brian Kha,5,0,30,25
1657440983733,MATH 20E,A01,083771,Ganguly; Soumya,9,0,32,23
1657440983733,MATH 20E,A02,083772,Ganguly; Soumya,6,0,32,26
1657440983733,MATH 20E,B01,083773,Ciotti; Benjamin,20,0,35,15
1657440983733,MATH 20E,B02,083774,Ciotti; Benjamin,17,0,35,18
1657440989762,MATH 103A,A01,083777,Greenfeld; Be'Eri,3,0,36,33
1657440989762,MATH 103A,A02,083778,Greenfeld; Be'Eri,5,0,36,31
1657440989762,MATH 103A,A03,093561,Greenfeld; Be'Eri,5,0,36,31
1657440989762,MATH 103A,B01,083779,Greenfeld; Be'Eri,7,0,36,29
1657440989762,MATH 103A,B02,083780,Greenfeld; Be'Eri,4,0,36,32
1657440989762,MATH 103A,B03,093562,Greenfeld; Be'Eri,3,0,36,33
1657440995790,MATH 105,A01,085443,Carter; Anne Toulson,15,0,35,20
1657440995790,MATH 105,A02,093477,Carter; Anne Toulson,20,0,35,15
1657441001817,MATH 109,A01,083213,Ganzberger; Geoffrey Michael,2,0,34,32
1657441001817,MATH 109,A02,083214,Ganzberger; Geoffrey Michael,4,0,34,30
1657441001817,MATH 109,A03,093478,Ganzberger; Geoffrey Michael,2,0,34,32
1657441001817,MATH 109,B01,083215,Ganzberger; Geoffrey Michael,1,0,32,31
1657441001817,MATH 109,B02,083216,Ganzberger; Geoffrey Michael,2,0,32,30
1657441001817,MATH 109,B03,093479,Ganzberger; Geoffrey Michael,8,0,32,24
1657441007839,MATH 142A,A01,083219,Chow; Bennett,7,0,32,25
1657441007839,MATH 142A,A02,083220,Chow; Bennett,10,0,32,22
1657441007839,MATH 142A,A03,093480,Chow; Bennett,8,0,32,24
1657441007839,MATH 142A,B03,093481,Chow; Bennett,8,0,32,24
1657441007839,MATH 142A,B04,093558,Chow; Bennett,13,0,32,19
1657441007839,MATH 142A,B05,093559,Chow; Bennett,6,0,32,26
1657441013868,MATH 193A,A01,083224,Rotar; Vladimir,8,0,34,26
1657441013868,MATH 193A,A02,083225,Rotar; Vladimir,9,0,34,25
1657441013868,MATH 193A,A03,083781,Rotar; Vladimir,5,0,34,29
1657441013868,MATH 193A,A04,083782,Rotar; Vladimir,10,0,34,24
1657441013868,MATH 193A,A05,093482,Rotar; Vladimir,10,0,34,24
1657441019892,MATH 197,001,091859,McAuley; Julian John,9999,0,9999,0
1657441019892,MATH 197,002,095566,Kedlaya; Kiran S.,9997,0,9999,2
1657441019892,MATH 197,003,095567,Xiao; Ming,9999,0,9999,0
1657441019892,MATH 197,004,095571,Perols; Johan Lars,9998,0,9999,1
1657441026960,COGS 9,A01,083615,Shannon; Kyle Michael,9,0,75,66
1657441032985,COGS 11,A01,083617,Boyle; Mary E. T.,22,0,48,26
1657441039009,COGS 13,A01,083071,Bastos; Amalia Pinkusfeld,11,0,71,60
1657441045035,COGS 14A,A01,092681,Semenuks; Arturs,5,1,100,95
1657441051059,COGS 14B,A01,083073,Cheng; Tzu-Han,6,0,63,57
1657441057083,COGS 17,A01,092677,Semenuks; Arturs,6,0,81,75
1657441063110,COGS 100,A01,083619,Allen; Michael Gordon,17,0,70,53
1657441069139,COGS 101A,A01,083621,Davis; Joshua Daniel,9,0,68,59
1657441075163,COGS 101B,A01,091572,Allen; Michael Gordon,12,0,65,53
1657441081186,COGS 101C,A01,083625,Delgado; Tania,17,0,35,18
1657441087209,COGS 107A,A01,083627,Boyle; Mary E. T.,13,0,60,47
1657441093231,COGS 118A,A01,083075,Gupta; Anjum,21,0,76,55
1657441099263,CSE 3,A50,083646,Miranda; Gregory Joseph,24,0,50,26
1657441105292,CSE 8A,A50,083650,Miranda; Gregory Joseph,17,1,56,39
1657441111319,CSE 11,A01,083080,Cao; Yingjun,6,15,40,34
1657441117341,CSE 12,A01,083652,Krause-Levy; Sophia Louisa,28,1,120,92
1657441123363,CSE 15L,A01,083654,Morris; Justin Loren,9,0,50,41
1657441123363,CSE 15L,A02,083655,Morris; Justin Loren,9,0,50,41
1657441129394,CSE 20,A01,083657,Tran; Khoa Dang,39,0,80,41
1657441135416,CSE 21,A01,095574,Bach; Quang Tran,22,0,48,26
1657441141443,CSE 30,A01,083084,Eldon; John,5,0,80,75
1657441141443,CSE 30,B01,095061,Bhaskar; Nishant,9,0,50,41
1657441147465,CSE 100,A01,083659,Cao; Yingjun,5,4,70,65
1657441153491,CSE 134B,A01,083661,Powell; Thomas Allan,22,0,100,78
1657441159515,CSE 140,A01,083663,Gungor; Onat,15,0,85,70
1657441165537,CSE 140L,A01,083088,Eldon; John,21,0,100,79
1657441171564,CSE 175,A01,083665,Kumar; Rakesh,3,0,25,22
1657441177587,CSE 190,A00,092507,Dubnov; Shlomo,8,0,20,12
1657441183608,ECE 45,A01,083139,Congero; Spencer William,6,0,75,69
1657441189633,ECE 65,A50,083695,Saad; Andrew S,12,0,30,18
1657441189633,ECE 65,A51,095125,Saad; Andrew S,24,0,26,2
1657441195658,ECE 109,A01,091882,Touri; Behrouz,19,0,70,51
1657441201681,ECE 180,A00,083140,Abi Samra; Nicholas Camill,1,0,30,29
1657441201681,ECE 180,B00,083141,Abi Samra; Nicholas Camill,0,0,30,30
1657441207708,MATH 10A,A01,083735,Patchell; Gregory David,2,0,30,28
1657441207708,MATH 10A,A02,083736,Patchell; Gregory David,20,0,30,10
1657441207708,MATH 10A,A03,083737,Patchell; Gregory David,16,0,30,14
1657441213735,MATH 10B,A01,083207,Lim; Seonhee,8,0,34,26
1657441213735,MATH 10B,A02,083208,Lim; Seonhee,9,0,35,26
1657441213735,MATH 10B,A03,093472,Lim; Seonhee,7,0,34,27
1657441213735,MATH 10B,B01,083739,Sinha; Shubham,12,0,30,18
1657441219853,MATH 18,A01,083743,Cinel; Cameron Alexander,7,0,30,23
1657441219853,MATH 18,A02,083744,Cinel; Cameron Alexander,17,0,30,13
1657441219853,MATH 18,A03,083745,Cinel; Cameron Alexander,9,0,30,21
1657441219853,MATH 18,B01,083748,Rideout; David Porter,5,0,37,32
1657441219853,MATH 18,B02,083749,Rideout; David Porter,5,0,36,31
1657441219853,MATH 18,B03,083750,Rideout; David Porter,3,0,37,34
1657441219853,MATH 18,B04,083751,Rideout; David Porter,6,0,36,30
1657441219853,MATH 18,B05,093473,Rideout; David Porter,6,0,36,30
1657441219853,MATH 18,B06,093474,Rideout; David Porter,6,0,36,30
1657441225878,MATH 20A,A01,083754,Zheng; Zequn,14,0,40,26
1657441231909,MATH 20B,A01,083756,Briones; Jor-el Thomas Caparas,4,0,36,32
1657441231909,MATH 20B,A02,083757,Briones; Jor-el Thomas Caparas,1,0,36,35
1657441231909,MATH 20B,A03,093475,Briones; Jor-el Thomas Caparas,2,0,36,34
1657441237933,MATH 20C,A01,083760,Briones; Jor-el Thomas Caparas,1,0,35,34
1657441237933,MATH 20C,A02,083761,Briones; Jor-el Thomas Caparas,8,0,35,27
1657441237933,MATH 20C,A03,093476,Briones; Jor-el Thomas Caparas,0,1,36,36
1657441237933,MATH 20C,B01,083762,Bach; Quang Tran,1,0,30,29
1657441243968,MATH 20D,A01,083765,Tran; Brian Kha,5,0,30,25
1657441243968,MATH 20D,A02,083766,Tran; Brian Kha,5,0,30,25
1657441243968,MATH 20D,A03,083767,Tran; Brian Kha,5,0,30,25
1657441249998,MATH 20E,A01,083771,Ganguly; Soumya,9,0,32,23
1657441249998,MATH 20E,A02,083772,Ganguly; Soumya,6,0,32,26
1657441249998,MATH 20E,B01,083773,Ciotti; Benjamin,20,0,35,15
1657441249998,MATH 20E,B02,083774,Ciotti; Benjamin,17,0,35,18
1657441256021,MATH 103A,A01,083777,Greenfeld; Be'Eri,3,0,36,33
1657441256021,MATH 103A,A02,083778,Greenfeld; Be'Eri,5,0,36,31
1657441256021,MATH 103A,A03,093561,Greenfeld; Be'Eri,5,0,36,31
1657441256021,MATH 103A,B01,083779,Greenfeld; Be'Eri,7,0,36,29
1657441256021,MATH 103A,B02,083780,Greenfeld; Be'Eri,4,0,36,32
1657441256021,MATH 103A,B03,093562,Greenfeld; Be'Eri,3,0,36,33
1657441262044,MATH 105,A01,085443,Carter; Anne Toulson,15,0,35,20
1657441262044,MATH 105,A02,093477,Carter; Anne Toulson,20,0,35,15
1657441268074,MATH 109,A01,083213,Ganzberger; Geoffrey Michael,2,0,34,32
1657441268074,MATH 109,A02,083214,Ganzberger; Geoffrey Michael,4,0,34,30
1657441268074,MATH 109,A03,093478,Ganzberger; Geoffrey Michael,2,0,34,32
1657441268074,MATH 109,B01,083215,Ganzberger; Geoffrey Michael,1,0,32,31
1657441268074,MATH 109,B02,083216,Ganzberger; Geoffrey Michael,2,0,32,30
1657441268074,MATH 109,B03,093479,Ganzberger; Geoffrey Michael,8,0,32,24
1657441274098,MATH 142A,A01,083219,Chow; Bennett,7,0,32,25
1657441274098,MATH 142A,A02,083220,Chow; Bennett,10,0,32,22
1657441274098,MATH 142A,A03,093480,Chow; Bennett,8,0,32,24
1657441274098,MATH 142A,B03,093481,Chow; Bennett,8,0,32,24
1657441274098,MATH 142A,B04,093558,Chow; Bennett,13,0,32,19
1657441274098,MATH 142A,B05,093559,Chow; Bennett,6,0,32,26
1657441280129,MATH 193A,A01,083224,Rotar; Vladimir,8,0,34,26
1657441280129,MATH 193A,A02,083225,Rotar; Vladimir,9,0,34,25
1657441280129,MATH 193A,A03,083781,Rotar; Vladimir,5,0,34,29
1657441280129,MATH 193A,A04,083782,Rotar; Vladimir,10,0,34,24
1657441280129,MATH 193A,A05,093482,Rotar; Vladimir,10,0,34,24
1657441286156,MATH 197,001,091859,McAuley; Julian John,9999,0,9999,0
1657441286156,MATH 197,002,095566,Kedlaya; Kiran S.,9997,0,9999,2
1657441286156,MATH 197,003,095567,Xiao; Ming,9999,0,9999,0
1657441286156,MATH 197,004,095571,Perols; Johan Lars,9998,0,9999,1
1657441293214,COGS 9,A01,083615,Shannon; Kyle Michael,9,0,75,66
1657441299241,COGS 11,A01,083617,Boyle; Mary E. T.,22,0,48,26
1657441305262,COGS 13,A01,083071,Bastos; Amalia Pinkusfeld,11,0,71,60
1657441311287,COGS 14A,A01,092681,Semenuks; Arturs,5,1,100,95
1657441317312,COGS 14B,A01,083073,Cheng; Tzu-Han,6,0,63,57
1657441323345,COGS 17,A01,092677,Semenuks; Arturs,6,0,81,75
1657441329369,COGS 100,A01,083619,Allen; Michael Gordon,17,0,70,53
1657441335391,COGS 101A,A01,083621,Davis; Joshua Daniel,9,0,68,59
1657441341418,COGS 101B,A01,091572,Allen; Michael Gordon,12,0,65,53
1657441347439,COGS 101C,A01,083625,Delgado; Tania,17,0,35,18
1657441353465,COGS 107A,A01,083627,Boyle; Mary E. T.,13,0,60,47
1657441359492,COGS 118A,A01,083075,Gupta; Anjum,21,0,76,55
1657441365521,CSE 3,A50,083646,Miranda; Gregory Joseph,24,0,50,26
1657441371548,CSE 8A,A50,083650,Miranda; Gregory Joseph,17,1,56,39
1657441377574,CSE 11,A01,083080,Cao; Yingjun,6,15,40,34
1657441383597,CSE 12,A01,083652,Krause-Levy; Sophia Louisa,28,1,120,92
1657441389620,CSE 15L,A01,083654,Morris; Justin Loren,9,0,50,41
1657441389620,CSE 15L,A02,083655,Morris; Justin Loren,9,0,50,41
1657441395642,CSE 20,A01,083657,Tran; Khoa Dang,39,0,80,41
1657441401668,CSE 21,A01,095574,Bach; Quang Tran,22,0,48,26
1657441407692,CSE 30,A01,083084,Eldon; John,5,0,80,75
1657441407692,CSE 30,B01,095061,Bhaskar; Nishant,9,0,50,41
1657441413718,CSE 100,A01,083659,Cao; Yingjun,5,4,70,65
1657441419745,CSE 134B,A01,083661,Powell; Thomas Allan,22,0,100,78
1657441425769,CSE 140,A01,083663,Gungor; Onat,15,0,85,70
1657441431792,CSE 140L,A01,083088,Eldon; John,21,0,100,79
1657441437820,CSE 175,A01,083665,Kumar; Rakesh,3,0,25,22
1657441443847,CSE 190,A00,092507,Dubnov; Shlomo,8,0,20,12
1657441449872,ECE 45,A01,083139,Congero; Spencer William,6,0,75,69
1657441455896,ECE 65,A50,083695,Saad; Andrew S,12,0,30,18
1657441455896,ECE 65,A51,095125,Saad; Andrew S,24,0,26,2
1657441461922,ECE 109,A01,091882,Touri; Behrouz,19,0,70,51
1657441467945,ECE 180,A00,083140,Abi Samra; Nicholas Camill,1,0,30,29
1657441467945,ECE 180,B00,083141,Abi Samra; Nicholas Camill,0,0,30,30
1657441473973,MATH 10A,A01,083735,Patchell; Gregory David,2,0,30,28
1657441473973,MATH 10A,A02,083736,Patchell; Gregory David,20,0,30,10
1657441473973,MATH 10A,A03,083737,Patchell; Gregory David,16,0,30,14
1657441479997,MATH 10B,A01,083207,Lim; Seonhee,8,0,34,26
1657441479997,MATH 10B,A02,083208,Lim; Seonhee,9,0,35,26
1657441479997,MATH 10B,A03,093472,Lim; Seonhee,7,0,34,27
1657441479997,MATH 10B,B01,083739,Sinha; Shubham,12,0,30,18
1657441486020,MATH 18,A01,083743,Cinel; Cameron Alexander,7,0,30,23
1657441486020,MATH 18,A02,083744,Cinel; Cameron Alexander,17,0,30,13
1657441486020,MATH 18,A03,083745,Cinel; Cameron Alexander,9,0,30,21
1657441486020,MATH 18,B01,083748,Rideout; David Porter,5,0,37,32
1657441486020,MATH 18,B02,083749,Rideout; David Porter,5,0,36,31
1657441486020,MATH 18,B03,083750,Rideout; David Porter,3,0,37,34
1657441486020,MATH 18,B04,083751,Rideout; David Porter,6,0,36,30
1657441486020,MATH 18,B05,093473,Rideout; David Porter,6,0,36,30
1657441486020,MATH 18,B06,093474,Rideout; David Porter,6,0,36,30
1657441492043,MATH 20A,A01,083754,Zheng; Zequn,14,0,40,26
1657441498068,MATH 20B,A01,083756,Briones; Jor-el Thomas Caparas,4,0,36,32
1657441498068,MATH 20B,A02,083757,Briones; Jor-el Thomas Caparas,1,0,36,35
1657441498068,MATH 20B,A03,093475,Briones; Jor-el Thomas Caparas,2,0,36,34
1657441504090,MATH 20C,A01,083760,Briones; Jor-el Thomas Caparas,1,0,35,34
1657441504090,MATH 20C,A02,083761,Briones; Jor-el Thomas Caparas,8,0,35,27
1657441504090,MATH 20C,A03,093476,Briones; Jor-el Thomas Caparas,0,1,36,36
1657441504090,MATH 20C,B01,083762,Bach; Quang Tran,1,0,30,29
1657441510114,MATH 20D,A01,083765,Tran; Brian Kha,5,0,30,25
1657441510114,MATH 20D,A02,083766,Tran; Brian Kha,5,0,30,25
1657441510114,MATH 20D,A03,083767,Tran; Brian Kha,5,0,30,25
1657441516142,MATH 20E,A01,083771,Ganguly; Soumya,9,0,32,23
1657441516142,MATH 20E,A02,083772,Ganguly; Soumya,6,0,32,26
1657441516142,MATH 20E,B01,083773,Ciotti; Benjamin,20,0,35,15
1657441516142,MATH 20E,B02,083774,Ciotti; Benjamin,17,0,35,18
1657441522164,MATH 103A,A01,083777,Greenfeld; Be'Eri,3,0,36,33
1657441522164,MATH 103A,A02,083778,Greenfeld; Be'Eri,5,0,36,31
1657441522164,MATH 103A,A03,093561,Greenfeld; Be'Eri,5,0,36,31
1657441522164,MATH 103A,B01,083779,Greenfeld; Be'Eri,7,0,36,29
1657441522164,MATH 103A,B02,083780,Greenfeld; Be'Eri,4,0,36,32
1657441522164,MATH 103A,B03,093562,Greenfeld; Be'Eri,3,0,36,33
1657441528187,MATH 105,A01,085443,Carter; Anne Toulson,15,0,35,20
1657441528187,MATH 105,A02,093477,Carter; Anne Toulson,20,0,35,15
1657441534210,MATH 109,A01,083213,Ganzberger; Geoffrey Michael,2,0,34,32
1657441534210,MATH 109,A02,083214,Ganzberger; Geoffrey Michael,4,0,34,30
1657441534210,MATH 109,A03,093478,Ganzberger; Geoffrey Michael,2,0,34,32
1657441534210,MATH 109,B01,083215,Ganzberger; Geoffrey Michael,1,0,32,31
1657441534210,MATH 109,B02,083216,Ganzberger; Geoffrey Michael,2,0,32,30
1657441534210,MATH 109,B03,093479,Ganzberger; Geoffrey Michael,8,0,32,24
1657441540235,MATH 142A,A01,083219,Chow; Bennett,7,0,32,25
1657441540235,MATH 142A,A02,083220,Chow; Bennett,10,0,32,22
1657441540235,MATH 142A,A03,093480,Chow; Bennett,8,0,32,24
1657441540235,MATH 142A,B03,093481,Chow; Bennett,8,0,32,24
1657441540235,MATH 142A,B04,093558,Chow; Bennett,13,0,32,19
1657441540235,MATH 142A,B05,093559,Chow; Bennett,6,0,32,26
1657441546259,MATH 193A,A01,083224,Rotar; Vladimir,8,0,34,26
1657441546259,MATH 193A,A02,083225,Rotar; Vladimir,9,0,34,25
1657441546259,MATH 193A,A03,083781,Rotar; Vladimir,5,0,34,29
1657441546259,MATH 193A,A04,083782,Rotar; Vladimir,10,0,34,24
1657441546259,MATH 193A,A05,093482,Rotar; Vladimir,10,0,34,24
1657441552285,MATH 197,001,091859,McAuley; Julian John,9999,0,9999,0
1657441552285,MATH 197,002,095566,Kedlaya; Kiran S.,9997,0,9999,2
1657441552285,MATH 197,003,095567,Xiao; Ming,9999,0,9999,0
1657441552285,MATH 197,004,095571,Perols; Johan Lars,9998,0,9999,1
1657441559351,COGS 9,A01,083615,Shannon; Kyle Michael,9,0,75,66
1657441565374,COGS 11,A01,083617,Boyle; Mary E. T.,22,0,48,26
1657441571397,COGS 13,A01,083071,Bastos; Amalia Pinkusfeld,11,0,71,60
1657441577424,COGS 14A,A01,092681,Semenuks; Arturs,5,1,100,95
1657441583451,COGS 14B,A01,083073,Cheng; Tzu-Han,6,0,63,57
1657441589472,COGS 17,A01,092677,Semenuks; Arturs,6,0,81,75
1657441595497,COGS 100,A01,083619,Allen; Michael Gordon,17,0,70,53
1657441601522,COGS 101A,A01,083621,Davis; Joshua Daniel,9,0,68,59
1657441607545,COGS 101B,A01,091572,Allen; Michael Gordon,12,0,65,53
1657441613567,COGS 101C,A01,083625,Delgado; Tania,17,0,35,18
1657441619594,COGS 107A,A01,083627,Boyle; Mary E. T.,13,0,60,47
1657441625619,COGS 118A,A01,083075,Gupta; Anjum,21,0,76,55
1657441631643,CSE 3,A50,083646,Miranda; Gregory Joseph,24,0,50,26
1657441637667,CSE 8A,A50,083650,Miranda; Gregory Joseph,17,1,56,39
1657441643695,CSE 11,A01,083080,Cao; Yingjun,6,15,40,34
1657441649717,CSE 12,A01,083652,Krause-Levy; Sophia Louisa,28,1,120,92
1657441655745,CSE 15L,A01,083654,Morris; Justin Loren,9,0,50,41
1657441655745,CSE 15L,A02,083655,Morris; Justin Loren,9,0,50,41
1657441661768,CSE 20,A01,083657,Tran; Khoa Dang,39,0,80,41
1657441667796,CSE 21,A01,095574,Bach; Quang Tran,22,0,48,26
1657441673822,CSE 30,A01,083084,Eldon; John,5,0,80,75
1657441673822,CSE 30,B01,095061,Bhaskar; Nishant,9,0,50,41
1657441679845,CSE 100,A01,083659,Cao; Yingjun,5,4,70,65
1657441685873,CSE 134B,A01,083661,Powell; Thomas Allan,22,0,100,78
1657441691896,CSE 140,A01,083663,Gungor; Onat,15,0,85,70
1657441697919,CSE 140L,A01,083088,Eldon; John,21,0,100,79
1657441703942,CSE 175,A01,083665,Kumar; Rakesh,3,0,25,22
1657441709968,CSE 190,A00,092507,Dubnov; Shlomo,8,0,20,12
1657441715996,ECE 45,A01,083139,Congero; Spencer William,6,0,75,69
1657441722018,ECE 65,A50,083695,Saad; Andrew S,12,0,30,18
1657441722018,ECE 65,A51,095125,Saad; Andrew S,24,0,26,2
1657441728040,ECE 109,A01,091882,Touri; Behrouz,19,0,70,51
1657441734067,ECE 180,A00,083140,Abi Samra; Nicholas Camill,1,0,30,29
1657441734067,ECE 180,B00,083141,Abi Samra; Nicholas Camill,0,0,30,30
1657441740090,MATH 10A,A01,083735,Patchell; Gregory David,2,0,30,28
1657441740090,MATH 10A,A02,083736,Patchell; Gregory David,20,0,30,10
1657441740090,MATH 10A,A03,083737,Patchell; Gregory David,16,0,30,14
1657441746120,MATH 10B,A01,083207,Lim; Seonhee,8,0,34,26
1657441746120,MATH 10B,A02,083208,Lim; Seonhee,9,0,35,26
1657441746120,MATH 10B,A03,093472,Lim; Seonhee,7,0,34,27
1657441746120,MATH 10B,B01,083739,Sinha; Shubham,12,0,30,18
1657441752148,MATH 18,A01,083743,Cinel; Cameron Alexander,7,0,30,23
1657441752148,MATH 18,A02,083744,Cinel; Cameron Alexander,17,0,30,13
1657441752148,MATH 18,A03,083745,Cinel; Cameron Alexander,9,0,30,21
1657441752148,MATH 18,B01,083748,Rideout; David Porter,5,0,37,32
1657441752148,MATH 18,B02,083749,Rideout; David Porter,5,0,36,31
1657441752148,MATH 18,B03,083750,Rideout; David Porter,3,0,37,34
1657441752148,MATH 18,B04,083751,Rideout; David Porter,6,0,36,30
1657441752148,MATH 18,B05,093473,Rideout; David Porter,6,0,36,30
1657441752148,MATH 18,B06,093474,Rideout; David Porter,6,0,36,30
1657441758175,MATH 20A,A01,083754,Zheng; Zequn,14,0,40,26
1657441764200,MATH 20B,A01,083756,Briones; Jor-el Thomas Caparas,4,0,36,32
1657441764200,MATH 20B,A02,083757,Briones; Jor-el Thomas Caparas,1,0,36,35
1657441764200,MATH 20B,A03,093475,Briones; Jor-el Thomas Caparas,2,0,36,34
1657441770226,MATH 20C,A01,083760,Briones; Jor-el Thomas Caparas,1,0,35,34
1657441770226,MATH 20C,A02,083761,Briones; Jor-el Thomas Caparas,8,0,35,27
1657441770226,MATH 20C,A03,093476,Briones; Jor-el Thomas Caparas,0,1,36,36
1657441770226,MATH 20C,B01,083762,Bach; Quang Tran,1,0,30,29
1657441776250,MATH 20D,A01,083765,Tran; Brian Kha,5,0,30,25
1657441776250,MATH 20D,A02,083766,Tran; Brian Kha,5,0,30,25
1657441776250,MATH 20D,A03,083767,Tran; Brian Kha,5,0,30,25
1657441782274,MATH 20E,A01,083771,Ganguly; Soumya,9,0,32,23
1657441782274,MATH 20E,A02,083772,Ganguly; Soumya,6,0,32,26
1657441782274,MATH 20E,B01,083773,Ciotti; Benjamin,20,0,35,15
1657441782274,MATH 20E,B02,083774,Ciotti; Benjamin,17,0,35,18
1657441788305,MATH 103A,A01,083777,Greenfeld; Be'Eri,3,0,36,33
1657441788305,MATH 103A,A02,083778,Greenfeld; Be'Eri,5,0,36,31
1657441788305,MATH 103A,A03,093561,Greenfeld; Be'Eri,5,0,36,31
1657441788305,MATH 103A,B01,083779,Greenfeld; Be'Eri,7,0,36,29
1657441788305,MATH 103A,B02,083780,Greenfeld; Be'Eri,4,0,36,32
1657441788305,MATH 103A,B03,093562,Greenfeld; Be'Eri,3,0,36,33
1657441794331,MATH 105,A01,085443,Carter; Anne Toulson,15,0,35,20
1657441794331,MATH 105,A02,093477,Carter; Anne Toulson,20,0,35,15
1657441800359,MATH 109,A01,083213,Ganzberger; Geoffrey Michael,2,0,34,32
1657441800359,MATH 109,A02,083214,Ganzberger; Geoffrey Michael,4,0,34,30
1657441800359,MATH 109,A03,093478,Ganzberger; Geoffrey Michael,2,0,34,32
1657441800359,MATH 109,B01,083215,Ganzberger; Geoffrey Michael,1,0,32,31
1657441800359,MATH 109,B02,083216,Ganzberger; Geoffrey Michael,2,0,32,30
1657441800359,MATH 109,B03,093479,Ganzberger; Geoffrey Michael,8,0,32,24
1657441806387,MATH 142A,A01,083219,Chow; Bennett,7,0,32,25
1657441806387,MATH 142A,A02,083220,Chow; Bennett,10,0,32,22
1657441806387,MATH 142A,A03,093480,Chow; Bennett,8,0,32,24
1657441806387,MATH 142A,B03,093481,Chow; Bennett,8,0,32,24
1657441806387,MATH 142A,B04,093558,Chow; Bennett,13,0,32,19
1657441806387,MATH 142A,B05,093559,Chow; Bennett,6,0,32,26
1657441812410,MATH 193A,A01,083224,Rotar; Vladimir,8,0,34,26
1657441812410,MATH 193A,A02,083225,Rotar; Vladimir,9,0,34,25
1657441812410,MATH 193A,A03,083781,Rotar; Vladimir,5,0,34,29
1657441812410,MATH 193A,A04,083782,Rotar; Vladimir,10,0,34,24
1657441812410,MATH 193A,A05,093482,Rotar; Vladimir,10,0,34,24
1657441818506,MATH 197,001,091859,McAuley; Julian John,9999,0,9999,0
1657441818506,MATH 197,002,095566,Kedlaya; Kiran S.,9997,0,9999,2
1657441818506,MATH 197,003,095567,Xiao; Ming,9999,0,9999,0
1657441818506,MATH 197,004,095571,Perols; Johan Lars,9998,0,9999,1
1657441825556,COGS 9,A01,083615,Shannon; Kyle Michael,9,0,75,66
1657441831577,COGS 11,A01,083617,Boyle; Mary E. T.,22,0,48,26
1657441837601,COGS 13,A01,083071,Bastos; Amalia Pinkusfeld,11,0,71,60
1657441843625,COGS 14A,A01,092681,Semenuks; Arturs,5,1,100,95
1657441849648,COGS 14B,A01,083073,Cheng; Tzu-Han,6,0,63,57
1657441855671,COGS 17,A01,092677,Semenuks; Arturs,6,0,81,75
1657441861693,COGS 100,A01,083619,Allen; Michael Gordon,17,0,70,53
1657441867717,COGS 101A,A01,083621,Davis; Joshua Daniel,9,0,68,59
1657441873740,COGS 101B,A01,091572,Allen; Michael Gordon,12,0,65,53
1657441879767,COGS 101C,A01,083625,Delgado; Tania,17,0,35,18
1657441885794,COGS 107A,A01,083627,Boyle; Mary E. T.,13,0,60,47
1657441891816,COGS 118A,A01,083075,Gupta; Anjum,21,0,76,55
1657441897837,CSE 3,A50,083646,Miranda; Gregory Joseph,24,0,50,26
1657441903864,CSE 8A,A50,083650,Miranda; Gregory Joseph,17,1,56,39
1657441909890,CSE 11,A01,083080,Cao; Yingjun,6,15,40,34
1657441915916,CSE 12,A01,083652,Krause-Levy; Sophia Louisa,28,1,120,92
1657441921943,CSE 15L,A01,083654,Morris; Justin Loren,9,0,50,41
1657441921943,CSE 15L,A02,083655,Morris; Justin Loren,9,0,50,41
1657441927973,CSE 20,A01,083657,Tran; Khoa Dang,39,0,80,41
1657441933998,CSE 21,A01,095574,Bach; Quang Tran,22,0,48,26
1657441940023,CSE 30,A01,083084,Eldon; John,5,0,80,75
1657441940023,CSE 30,B01,095061,Bhaskar; Nishant,9,0,50,41
1657441946054,CSE 100,A01,083659,Cao; Yingjun,5,4,70,65
1657441952078,CSE 134B,A01,083661,Powell; Thomas Allan,22,0,100,78
1657441958103,CSE 140,A01,083663,Gungor; Onat,15,0,85,70
1657441964127,CSE 140L,A01,083088,Eldon; John,21,0,100,79
1657441970149,CSE 175,A01,083665,Kumar; Rakesh,3,0,25,22
1657441976170,CSE 190,A00,092507,Dubnov; Shlomo,8,0,20,12
1657441982193,ECE 45,A01,083139,Congero; Spencer William,6,0,75,69
1657441988218,ECE 65,A50,083695,Saad; Andrew S,12,0,30,18
1657441988218,ECE 65,A51,095125,Saad; Andrew S,24,0,26,2
1657441994242,ECE 109,A01,091882,Touri; Behrouz,19,0,70,51
1657442000265,ECE 180,A00,083140,Abi Samra; Nicholas Camill,1,0,30,29
1657442000265,ECE 180,B00,083141,Abi Samra; Nicholas Camill,0,0,30,30
1657442006289,MATH 10A,A01,083735,Patchell; Gregory David,2,0,30,28
1657442006289,MATH 10A,A02,083736,Patchell; Gregory David,20,0,30,10
1657442006289,MATH 10A,A03,083737,Patchell; Gregory David,16,0,30,14
1657442012318,MATH 10B,A01,083207,Lim; Seonhee,8,0,34,26
1657442012318,MATH 10B,A02,083208,Lim; Seonhee,9,0,35,26
1657442012318,MATH 10B,A03,093472,Lim; Seonhee,7,0,34,27
1657442012318,MATH 10B,B01,083739,Sinha; Shubham,12,0,30,18
1657442018342,MATH 18,A01,083743,Cinel; Cameron Alexander,7,0,30,23
1657442018342,MATH 18,A02,083744,Cinel; Cameron Alexander,17,0,30,13
1657442018342,MATH 18,A03,083745,Cinel; Cameron Alexander,9,0,30,21
1657442018342,MATH 18,B01,083748,Rideout; David Porter,5,0,37,32
1657442018342,MATH 18,B02,083749,Rideout; David Porter,5,0,36,31
1657442018342,MATH 18,B03,083750,Rideout; David Porter,3,0,37,34
1657442018342,MATH 18,B04,083751,Rideout; David Porter,6,0,36,30
1657442018342,MATH 18,B05,093473,Rideout; David Porter,6,0,36,30
1657442018342,MATH 18,B06,093474,Rideout; David Porter,6,0,36,30
1657442024366,MATH 20A,A01,083754,Zheng; Zequn,14,0,40,26
1657442030397,MATH 20B,A01,083756,Briones; Jor-el Thomas Caparas,4,0,36,32
1657442030397,MATH 20B,A02,083757,Briones; Jor-el Thomas Caparas,1,0,36,35
1657442030397,MATH 20B,A03,093475,Briones; Jor-el Thomas Caparas,2,0,36,34
1657442036425,MATH 20C,A01,083760,Briones; Jor-el Thomas Caparas,1,0,35,34
1657442036425,MATH 20C,A02,083761,Briones; Jor-el Thomas Caparas,8,0,35,27
1657442036425,MATH 20C,A03,093476,Briones; Jor-el Thomas Caparas,0,1,36,36
1657442036425,MATH 20C,B01,083762,Bach; Quang Tran,1,0,30,29
1657442042452,MATH 20D,A01,083765,Tran; Brian Kha,5,0,30,25
1657442042452,MATH 20D,A02,083766,Tran; Brian Kha,5,0,30,25
1657442042452,MATH 20D,A03,083767,Tran; Brian Kha,5,0,30,25
1657442048477,MATH 20E,A01,083771,Ganguly; Soumya,9,0,32,23
1657442048477,MATH 20E,A02,083772,Ganguly; Soumya,6,0,32,26
1657442048477,MATH 20E,B01,083773,Ciotti; Benjamin,20,0,35,15
1657442048477,MATH 20E,B02,083774,Ciotti; Benjamin,17,0,35,18
1657442054502,MATH 103A,A01,083777,Greenfeld; Be'Eri,3,0,36,33
1657442054502,MATH 103A,A02,083778,Greenfeld; Be'Eri,5,0,36,31
1657442054502,MATH 103A,A03,093561,Greenfeld; Be'Eri,5,0,36,31
1657442054502,MATH 103A,B01,083779,Greenfeld; Be'Eri,7,0,36,29
1657442054502,MATH 103A,B02,083780,Greenfeld; Be'Eri,4,0,36,32
1657442054502,MATH 103A,B03,093562,Greenfeld; Be'Eri,3,0,36,33
1657442060528,MATH 105,A01,085443,Carter; Anne Toulson,15,0,35,20
1657442060528,MATH 105,A02,093477,Carter; Anne Toulson,20,0,35,15
1657442066555,MATH 109,A01,083213,Ganzberger; Geoffrey Michael,2,0,34,32
1657442066555,MATH 109,A02,083214,Ganzberger; Geoffrey Michael,4,0,34,30
1657442066555,MATH 109,A03,093478,Ganzberger; Geoffrey Michael,2,0,34,32
1657442066555,MATH 109,B01,083215,Ganzberger; Geoffrey Michael,1,0,32,31
1657442066555,MATH 109,B02,083216,Ganzberger; Geoffrey Michael,2,0,32,30
1657442066555,MATH 109,B03,093479,Ganzberger; Geoffrey Michael,8,0,32,24
1657442072580,MATH 142A,A01,083219,Chow; Bennett,7,0,32,25
1657442072580,MATH 142A,A02,083220,Chow; Bennett,10,0,32,22
1657442072580,MATH 142A,A03,093480,Chow; Bennett,8,0,32,24
1657442072580,MATH 142A,B03,093481,Chow; Bennett,8,0,32,24
1657442072580,MATH 142A,B04,093558,Chow; Bennett,13,0,32,19
1657442072580,MATH 142A,B05,093559,Chow; Bennett,6,0,32,26
1657442078602,MATH 193A,A01,083224,Rotar; Vladimir,8,0,34,26
1657442078602,MATH 193A,A02,083225,Rotar; Vladimir,9,0,34,25
1657442078602,MATH 193A,A03,083781,Rotar; Vladimir,5,0,34,29
1657442078602,MATH 193A,A04,083782,Rotar; Vladimir,10,0,34,24
1657442078602,MATH 193A,A05,093482,Rotar; Vladimir,10,0,34,24
1657442084628,MATH 197,001,091859,McAuley; Julian John,9999,0,9999,0
1657442084628,MATH 197,002,095566,Kedlaya; Kiran S.,9997,0,9999,2
1657442084628,MATH 197,003,095567,Xiao; Ming,9999,0,9999,0
1657442084628,MATH 197,004,095571,Perols; Johan Lars,9998,0,9999,1
1657442091694,COGS 9,A01,083615,Shannon; Kyle Michael,9,0,75,66
1657442097721,COGS 11,A01,083617,Boyle; Mary E. T.,22,0,48,26
1657442103744,COGS 13,A01,083071,Bastos; Amalia Pinkusfeld,11,0,71,60
1657442109767,COGS 14A,A01,092681,Semenuks; Arturs,5,1,100,95
1657442115789,COGS 14B,A01,083073,Cheng; Tzu-Han,6,0,63,57
1657442121817,COGS 17,A01,092677,Semenuks; Arturs,6,0,81,75
1657442127847,COGS 100,A01,083619,Allen; Michael Gordon,17,0,70,53
1657442133869,COGS 101A,A01,083621,Davis; Joshua Daniel,9,0,68,59
1657442139890,COGS 101B,A01,091572,Allen; Michael Gordon,12,0,65,53
1657442145913,COGS 101C,A01,083625,Delgado; Tania,17,0,35,18
1657442151935,COGS 107A,A01,083627,Boyle; Mary E. T.,13,0,60,47
1657442157966,COGS 118A,A01,083075,Gupta; Anjum,21,0,76,55
1657442163989,CSE 3,A50,083646,Miranda; Gregory Joseph,24,0,50,26
1657442170016,CSE 8A,A50,083650,Miranda; Gregory Joseph,17,1,56,39
1657442176039,CSE 11,A01,083080,Cao; Yingjun,6,15,40,34
1657442182065,CSE 12,A01,083652,Krause-Levy; Sophia Louisa,28,1,120,92
1657442188087,CSE 15L,A01,083654,Morris; Justin Loren,9,0,50,41
1657442188087,CSE 15L,A02,083655,Morris; Justin Loren,9,0,50,41
1657442194118,CSE 20,A01,083657,Tran; Khoa Dang,39,0,80,41
1657442200144,CSE 21,A01,095574,Bach; Quang Tran,22,0,48,26
1657442206170,CSE 30,A01,083084,Eldon; John,5,0,80,75
1657442206170,CSE 30,B01,095061,Bhaskar; Nishant,9,0,50,41
1657442212193,CSE 100,A01,083659,Cao; Yingjun,5,4,70,65
1657442218223,CSE 134B,A01,083661,Powell; Thomas Allan,22,0,100,78
1657442224245,CSE 140,A01,083663,Gungor; Onat,15,0,85,70
1657442230268,CSE 140L,A01,083088,Eldon; John,21,0,100,79
1657442236291,CSE 175,A01,083665,Kumar; Rakesh,3,0,25,22
1657442242316,CSE 190,A00,092507,Dubnov; Shlomo,8,0,20,12
1657442248342,ECE 45,A01,083139,Congero; Spencer William,6,0,75,69
1657442254374,ECE 65,A50,083695,Saad; Andrew S,12,0,30,18
1657442254374,ECE 65,A51,095125,Saad; Andrew S,24,0,26,2
1657442260399,ECE 109,A01,091882,Touri; Behrouz,19,0,70,51
1657442266426,ECE 180,A00,083140,Abi Samra; Nicholas Camill,1,0,30,29
1657442266426,ECE 180,B00,083141,Abi Samra; Nicholas Camill,0,0,30,30
1657442272454,MATH 10A,A01,083735,Patchell; Gregory David,2,0,30,28
1657442272454,MATH 10A,A02,083736,Patchell; Gregory David,20,0,30,10
1657442272454,MATH 10A,A03,083737,Patchell; Gregory David,16,0,30,14
1657442278476,MATH 10B,A01,083207,Lim; Seonhee,8,0,34,26
1657442278476,MATH 10B,A02,083208,Lim; Seonhee,9,0,35,26
1657442278476,MATH 10B,A03,093472,Lim; Seonhee,7,0,34,27
1657442278476,MATH 10B,B01,083739,Sinha; Shubham,12,0,30,18
1657442284507,MATH 18,A01,083743,Cinel; Cameron Alexander,7,0,30,23
1657442284507,MATH 18,A02,083744,Cinel; Cameron Alexander,17,0,30,13
1657442284507,MATH 18,A03,083745,Cinel; Cameron Alexander,9,0,30,21
1657442284507,MATH 18,B01,083748,Rideout; David Porter,5,0,37,32
1657442284507,MATH 18,B02,083749,Rideout; David Porter,5,0,36,31
1657442284507,MATH 18,B03,083750,Rideout; David Porter,3,0,37,34
1657442284507,MATH 18,B04,083751,Rideout; David Porter,6,0,36,30
1657442284507,MATH 18,B05,093473,Rideout; David Porter,6,0,36,30
1657442284507,MATH 18,B06,093474,Rideout; David Porter,6,0,36,30
1657442290532,MATH 20A,A01,083754,Zheng; Zequn,14,0,40,26
1657442296561,MATH 20B,A01,083756,Briones; Jor-el Thomas Caparas,4,0,36,32
1657442296561,MATH 20B,A02,083757,Briones; Jor-el Thomas Caparas,1,0,36,35
1657442296561,MATH 20B,A03,093475,Briones; Jor-el Thomas Caparas,2,0,36,34
1657442302589,MATH 20C,A01,083760,Briones; Jor-el Thomas Caparas,1,0,35,34
1657442302589,MATH 20C,A02,083761,Briones; Jor-el Thomas Caparas,8,0,35,27
1657442302589,MATH 20C,A03,093476,Briones; Jor-el Thomas Caparas,0,1,36,36
1657442302589,MATH 20C,B01,083762,Bach; Quang Tran,1,0,30,29
1657442308612,MATH 20D,A01,083765,Tran; Brian Kha,5,0,30,25
1657442308612,MATH 20D,A02,083766,Tran; Brian Kha,5,0,30,25
1657442308612,MATH 20D,A03,083767,Tran; Brian Kha,5,0,30,25
1657442314637,MATH 20E,A01,083771,Ganguly; Soumya,9,0,32,23
1657442314637,MATH 20E,A02,083772,Ganguly; Soumya,6,0,32,26
1657442314637,MATH 20E,B01,083773,Ciotti; Benjamin,20,0,35,15
1657442314637,MATH 20E,B02,083774,Ciotti; Benjamin,17,0,35,18
1657442320661,MATH 103A,A01,083777,Greenfeld; Be'Eri,3,0,36,33
1657442320661,MATH 103A,A02,083778,Greenfeld; Be'Eri,5,0,36,31
1657442320661,MATH 103A,A03,093561,Greenfeld; Be'Eri,5,0,36,31
1657442320661,MATH 103A,B01,083779,Greenfeld; Be'Eri,7,0,36,29
1657442320661,MATH 103A,B02,083780,Greenfeld; Be'Eri,4,0,36,32
1657442320661,MATH 103A,B03,093562,Greenfeld; Be'Eri,3,0,36,33
1657442326687,MATH 105,A01,085443,Carter; Anne Toulson,15,0,35,20
1657442326687,MATH 105,A02,093477,Carter; Anne Toulson,20,0,35,15
1657442332714,MATH 109,A01,083213,Ganzberger; Geoffrey Michael,2,0,34,32
1657442332714,MATH 109,A02,083214,Ganzberger; Geoffrey Michael,4,0,34,30
1657442332714,MATH 109,A03,093478,Ganzberger; Geoffrey Michael,2,0,34,32
1657442332714,MATH 109,B01,083215,Ganzberger; Geoffrey Michael,1,0,32,31
1657442332714,MATH 109,B02,083216,Ganzberger; Geoffrey Michael,2,0,32,30
1657442332714,MATH 109,B03,093479,Ganzberger; Geoffrey Michael,8,0,32,24
1657442338742,MATH 142A,A01,083219,Chow; Bennett,7,0,32,25
1657442338742,MATH 142A,A02,083220,Chow; Bennett,10,0,32,22
1657442338742,MATH 142A,A03,093480,Chow; Bennett,8,0,32,24
1657442338742,MATH 142A,B03,093481,Chow; Bennett,8,0,32,24
1657442338742,MATH 142A,B04,093558,Chow; Bennett,13,0,32,19
1657442338742,MATH 142A,B05,093559,Chow; Bennett,6,0,32,26
1657442344764,MATH 193A,A01,083224,Rotar; Vladimir,8,0,34,26
1657442344764,MATH 193A,A02,083225,Rotar; Vladimir,9,0,34,25
1657442344764,MATH 193A,A03,083781,Rotar; Vladimir,5,0,34,29
1657442344764,MATH 193A,A04,083782,Rotar; Vladimir,10,0,34,24
1657442344764,MATH 193A,A05,093482,Rotar; Vladimir,10,0,34,24
1657442350789,MATH 197,001,091859,McAuley; Julian John,9999,0,9999,0
1657442350789,MATH 197,002,095566,Kedlaya; Kiran S.,9997,0,9999,2
1657442350789,MATH 197,003,095567,Xiao; Ming,9999,0,9999,0
1657442350789,MATH 197,004,095571,Perols; Johan Lars,9998,0,9999,1
1657442357853,COGS 9,A01,083615,Shannon; Kyle Michael,9,0,75,66
1657442363875,COGS 11,A01,083617,Boyle; Mary E. T.,22,0,48,26
1657442369899,COGS 13,A01,083071,Bastos; Amalia Pinkusfeld,11,0,71,60
1657442375925,COGS 14A,A01,092681,Semenuks; Arturs,5,1,100,95
1657442381947,COGS 14B,A01,083073,Cheng; Tzu-Han,6,0,63,57
1657442387973,COGS 17,A01,092677,Semenuks; Arturs,6,0,81,75
1657442393995,COGS 100,A01,083619,Allen; Michael Gordon,17,0,70,53
1657442400022,COGS 101A,A01,083621,Davis; Joshua Daniel,9,0,68,59
1657442406044,COGS 101B,A01,091572,Allen; Michael Gordon,12,0,65,53
1657442412152,COGS 101C,A01,083625,Delgado; Tania,17,0,35,18
1657442418175,COGS 107A,A01,083627,Boyle; Mary E. T.,13,0,60,47
1657442424198,COGS 118A,A01,083075,Gupta; Anjum,21,0,76,55
1657442430222,CSE 3,A50,083646,Miranda; Gregory Joseph,24,0,50,26
1657442436245,CSE 8A,A50,083650,Miranda; Gregory Joseph,17,1,56,39
1657442442284,CSE 11,A01,083080,Cao; Yingjun,6,15,40,34
1657442448306,CSE 12,A01,083652,Krause-Levy; Sophia Louisa,28,1,120,92
1657442454333,CSE 15L,A01,083654,Morris; Justin Loren,9,0,50,41
1657442454333,CSE 15L,A02,083655,Morris; Justin Loren,9,0,50,41
1657442460356,CSE 20,A01,083657,Tran; Khoa Dang,39,0,80,41
1657442466378,CSE 21,A01,095574,Bach; Quang Tran,22,0,48,26
1657442472405,CSE 30,A01,083084,Eldon; John,5,0,80,75
1657442472405,CSE 30,B01,095061,Bhaskar; Nishant,9,0,50,41
1657442478429,CSE 100,A01,083659,Cao; Yingjun,5,4,70,65
1657442484451,CSE 134B,A01,083661,Powell; Thomas Allan,22,0,100,78
1657442490474,CSE 140,A01,083663,Gungor; Onat,15,0,85,70
1657442496497,CSE 140L,A01,083088,Eldon; John,21,0,100,79
1657442502520,CSE 175,A01,083665,Kumar; Rakesh,3,0,25,22
1657442508542,CSE 190,A00,092507,Dubnov; Shlomo,8,0,20,12
1657442514567,ECE 45,A01,083139,Congero; Spencer William,6,0,75,69
1657442520593,ECE 65,A50,083695,Saad; Andrew S,12,0,30,18
1657442520593,ECE 65,A51,095125,Saad; Andrew S,24,0,26,2
1657442526616,ECE 109,A01,091882,Touri; Behrouz,19,0,70,51
1657442532639,ECE 180,A00,083140,Abi Samra; Nicholas Camill,1,0,30,29
1657442532639,ECE 180,B00,083141,Abi Samra; Nicholas Camill,0,0,30,30
1657442538662,MATH 10A,A01,083735,Patchell; Gregory David,2,0,30,28
1657442538662,MATH 10A,A02,083736,Patchell; Gregory David,20,0,30,10
1657442538662,MATH 10A,A03,083737,Patchell; Gregory David,16,0,30,14
1657442544690,MATH 10B,A01,083207,Lim; Seonhee,8,0,34,26
1657442544690,MATH 10B,A02,083208,Lim; Seonhee,9,0,35,26
1657442544690,MATH 10B,A03,093472,Lim; Seonhee,7,0,34,27
1657442544690,MATH 10B,B01,083739,Sinha; Shubham,12,0,30,18
1657442550721,MATH 18,A01,083743,Cinel; Cameron Alexander,7,0,30,23
1657442550721,MATH 18,A02,083744,Cinel; Cameron Alexander,17,0,30,13
1657442550721,MATH 18,A03,083745,Cinel; Cameron Alexander,9,0,30,21
1657442550721,MATH 18,B01,083748,Rideout; David Porter,5,0,37,32
1657442550721,MATH 18,B02,083749,Rideout; David Porter,5,0,36,31
1657442550721,MATH 18,B03,083750,Rideout; David Porter,3,0,37,34
1657442550721,MATH 18,B04,083751,Rideout; David Porter,6,0,36,30
1657442550721,MATH 18,B05,093473,Rideout; David Porter,6,0,36,30
1657442550721,MATH 18,B06,093474,Rideout; David Porter,6,0,36,30
1657442556748,MATH 20A,A01,083754,Zheng; Zequn,14,0,40,26
1657442562772,MATH 20B,A01,083756,Briones; Jor-el Thomas Caparas,4,0,36,32
1657442562772,MATH 20B,A02,083757,Briones; Jor-el Thomas Caparas,1,0,36,35
1657442562772,MATH 20B,A03,093475,Briones; Jor-el Thomas Caparas,2,0,36,34
1657442568802,MATH 20C,A01,083760,Briones; Jor-el Thomas Caparas,1,0,35,34
1657442568802,MATH 20C,A02,083761,Briones; Jor-el Thomas Caparas,8,0,35,27
1657442568802,MATH 20C,A03,093476,Briones; Jor-el Thomas Caparas,0,1,36,36
1657442568802,MATH 20C,B01,083762,Bach; Quang Tran,1,0,30,29
1657442574838,MATH 20D,A01,083765,Tran; Brian Kha,5,0,30,25
1657442574838,MATH 20D,A02,083766,Tran; Brian Kha,5,0,30,25
1657442574838,MATH 20D,A03,083767,Tran; Brian Kha,5,0,30,25
1657442580867,MATH 20E,A01,083771,Ganguly; Soumya,9,0,32,23
1657442580867,MATH 20E,A02,083772,Ganguly; Soumya,6,0,32,26
1657442580867,MATH 20E,B01,083773,Ciotti; Benjamin,20,0,35,15
1657442580867,MATH 20E,B02,083774,Ciotti; Benjamin,17,0,35,18
1657442586896,MATH 103A,A01,083777,Greenfeld; Be'Eri,3,0,36,33
1657442586896,MATH 103A,A02,083778,Greenfeld; Be'Eri,5,0,36,31
1657442586896,MATH 103A,A03,093561,Greenfeld; Be'Eri,5,0,36,31
1657442586896,MATH 103A,B01,083779,Greenfeld; Be'Eri,7,0,36,29
1657442586896,MATH 103A,B02,083780,Greenfeld; Be'Eri,4,0,36,32
1657442586896,MATH 103A,B03,093562,Greenfeld; Be'Eri,3,0,36,33
1657442592918,MATH 105,A01,085443,Carter; Anne Toulson,15,0,35,20
1657442592918,MATH 105,A02,093477,Carter; Anne Toulson,20,0,35,15
1657442598947,MATH 109,A01,083213,Ganzberger; Geoffrey Michael,2,0,34,32
1657442598947,MATH 109,A02,083214,Ganzberger; Geoffrey Michael,4,0,34,30
1657442598947,MATH 109,A03,093478,Ganzberger; Geoffrey Michael,2,0,34,32
1657442598947,MATH 109,B01,083215,Ganzberger; Geoffrey Michael,1,0,32,31
1657442598947,MATH 109,B02,083216,Ganzberger; Geoffrey Michael,2,0,32,30
1657442598947,MATH 109,B03,093479,Ganzberger; Geoffrey Michael,8,0,32,24
1657442604975,MATH 142A,A01,083219,Chow; Bennett,7,0,32,25
1657442604975,MATH 142A,A02,083220,Chow; Bennett,10,0,32,22
1657442604975,MATH 142A,A03,093480,Chow; Bennett,8,0,32,24
1657442604975,MATH 142A,B03,093481,Chow; Bennett,8,0,32,24
1657442604975,MATH 142A,B04,093558,Chow; Bennett,13,0,32,19
1657442604975,MATH 142A,B05,093559,Chow; Bennett,6,0,32,26
1657442610998,MATH 193A,A01,083224,Rotar; Vladimir,8,0,34,26
1657442610998,MATH 193A,A02,083225,Rotar; Vladimir,9,0,34,25
1657442610998,MATH 193A,A03,083781,Rotar; Vladimir,5,0,34,29
1657442610998,MATH 193A,A04,083782,Rotar; Vladimir,10,0,34,24
1657442610998,MATH 193A,A05,093482,Rotar; Vladimir,10,0,34,24
1657442617022,MATH 197,001,091859,McAuley; Julian John,9999,0,9999,0
1657442617022,MATH 197,002,095566,Kedlaya; Kiran S.,9997,0,9999,2
1657442617022,MATH 197,003,095567,Xiao; Ming,9999,0,9999,0
1657442617022,MATH 197,004,095571,Perols; Johan Lars,9998,0,9999,1
1657442624086,COGS 9,A01,083615,Shannon; Kyle Michael,9,0,75,66
1657442630112,COGS 11,A01,083617,Boyle; Mary E. T.,22,0,48,26
1657442636135,COGS 13,A01,083071,Bastos; Amalia Pinkusfeld,11,0,71,60
1657442642160,COGS 14A,A01,092681,Semenuks; Arturs,5,1,100,95
1657442648187,COGS 14B,A01,083073,Cheng; Tzu-Han,6,0,63,57
1657442654209,COGS 17,A01,092677,Semenuks; Arturs,6,0,81,75
1657442660231,COGS 100,A01,083619,Allen; Michael Gordon,17,0,70,53
1657442666257,COGS 101A,A01,083621,Davis; Joshua Daniel,9,0,68,59
1657442672282,COGS 101B,A01,091572,Allen; Michael Gordon,12,0,65,53
1657442678304,COGS 101C,A01,083625,Delgado; Tania,17,0,35,18
1657442684333,COGS 107A,A01,083627,Boyle; Mary E. T.,13,0,60,47
1657442690358,COGS 118A,A01,083075,Gupta; Anjum,21,0,76,55
1657442696384,CSE 3,A50,083646,Miranda; Gregory Joseph,24,0,50,26
1657442702412,CSE 8A,A50,083650,Miranda; Gregory Joseph,17,1,56,39
1657442708451,CSE 11,A01,083080,Cao; Yingjun,6,15,40,34
1657442714474,CSE 12,A01,083652,Krause-Levy; Sophia Louisa,28,1,120,92
1657442720497,CSE 15L,A01,083654,Morris; Justin Loren,9,0,50,41
1657442720497,CSE 15L,A02,083655,Morris; Justin Loren,9,0,50,41
1657442726522,CSE 20,A01,083657,Tran; Khoa Dang,39,0,80,41
1657442732548,CSE 21,A01,095574,Bach; Quang Tran,22,0,48,26
1657442738572,CSE 30,A01,083084,Eldon; John,5,0,80,75
1657442738572,CSE 30,B01,095061,Bhaskar; Nishant,9,0,50,41
1657442744596,CSE 100,A01,083659,Cao; Yingjun,5,4,70,65
1657442750621,CSE 134B,A01,083661,Powell; Thomas Allan,22,0,100,78
1657442756649,CSE 140,A01,083663,Gungor; Onat,15,0,85,70
1657442762677,CSE 140L,A01,083088,Eldon; John,21,0,100,79
1657442768705,CSE 175,A01,083665,Kumar; Rakesh,3,0,25,22
1657442774732,CSE 190,A00,092507,Dubnov; Shlomo,8,0,20,12
1657442780755,ECE 45,A01,083139,Congero; Spencer William,6,0,75,69
1657442786784,ECE 65,A50,083695,Saad; Andrew S,12,0,30,18
1657442786784,ECE 65,A51,095125,Saad; Andrew S,24,0,26,2
1657442792814,ECE 109,A01,091882,Touri; Behrouz,19,0,70,51
1657442798839,ECE 180,A00,083140,Abi Samra; Nicholas Camill,1,0,30,29
1657442798839,ECE 180,B00,083141,Abi Samra; Nicholas Camill,0,0,30,30
1657442804864,MATH 10A,A01,083735,Patchell; Gregory David,2,0,30,28
1657442804864,MATH 10A,A02,083736,Patchell; Gregory David,20,0,30,10
1657442804864,MATH 10A,A03,083737,Patchell; Gregory David,16,0,30,14
1657442810894,MATH 10B,A01,083207,Lim; Seonhee,8,0,34,26
1657442810894,MATH 10B,A02,083208,Lim; Seonhee,9,0,35,26
1657442810894,MATH 10B,A03,093472,Lim; Seonhee,7,0,34,27
1657442810894,MATH 10B,B01,083739,Sinha; Shubham,12,0,30,18
1657442816927,MATH 18,A01,083743,Cinel; Cameron Alexander,7,0,30,23
1657442816927,MATH 18,A02,083744,Cinel; Cameron Alexander,17,0,30,13
1657442816927,MATH 18,A03,083745,Cinel; Cameron Alexander,9,0,30,21
1657442816927,MATH 18,B01,083748,Rideout; David Porter,5,0,37,32
1657442816927,MATH 18,B02,083749,Rideout; David Porter,5,0,36,31
1657442816927,MATH 18,B03,083750,Rideout; David Porter,3,0,37,34
1657442816927,MATH 18,B04,083751,Rideout; David Porter,6,0,36,30
1657442816927,MATH 18,B05,093473,Rideout; David Porter,6,0,36,30
1657442816927,MATH 18,B06,093474,Rideout; David Porter,6,0,36,30
1657442822949,MATH 20A,A01,083754,Zheng; Zequn,14,0,40,26
1657442828976,MATH 20B,A01,083756,Briones; Jor-el Thomas Caparas,4,0,36,32
1657442828976,MATH 20B,A02,083757,Briones; Jor-el Thomas Caparas,1,0,36,35
1657442828976,MATH 20B,A03,093475,Briones; Jor-el Thomas Caparas,2,0,36,34
1657442835000,MATH 20C,A01,083760,Briones; Jor-el Thomas Caparas,1,0,35,34
1657442835000,MATH 20C,A02,083761,Briones; Jor-el Thomas Caparas,8,0,35,27
1657442835000,MATH 20C,A03,093476,Briones; Jor-el Thomas Caparas,0,1,36,36
1657442835000,MATH 20C,B01,083762,Bach; Quang Tran,1,0,30,29
1657442841031,MATH 20D,A01,083765,Tran; Brian Kha,5,0,30,25
1657442841031,MATH 20D,A02,083766,Tran; Brian Kha,5,0,30,25
1657442841031,MATH 20D,A03,083767,Tran; Brian Kha,5,0,30,25
1657442847055,MATH 20E,A01,083771,Ganguly; Soumya,9,0,32,23
1657442847055,MATH 20E,A02,083772,Ganguly; Soumya,6,0,32,26
1657442847055,MATH 20E,B01,083773,Ciotti; Benjamin,20,0,35,15
1657442847055,MATH 20E,B02,083774,Ciotti; Benjamin,17,0,35,18
1657442853086,MATH 103A,A01,083777,Greenfeld; Be'Eri,3,0,36,33
1657442853086,MATH 103A,A02,083778,Greenfeld; Be'Eri,5,0,36,31
1657442853086,MATH 103A,A03,093561,Greenfeld; Be'Eri,5,0,36,31
1657442853086,MATH 103A,B01,083779,Greenfeld; Be'Eri,7,0,36,29
1657442853086,MATH 103A,B02,083780,Greenfeld; Be'Eri,4,0,36,32
1657442853086,MATH 103A,B03,093562,Greenfeld; Be'Eri,3,0,36,33
1657442859108,MATH 105,A01,085443,Carter; Anne Toulson,15,0,35,20
1657442859108,MATH 105,A02,093477,Carter; Anne Toulson,20,0,35,15
1657442865131,MATH 109,A01,083213,Ganzberger; Geoffrey Michael,2,0,34,32
1657442865131,MATH 109,A02,083214,Ganzberger; Geoffrey Michael,4,0,34,30
1657442865131,MATH 109,A03,093478,Ganzberger; Geoffrey Michael,2,0,34,32
1657442865131,MATH 109,B01,083215,Ganzberger; Geoffrey Michael,1,0,32,31
1657442865131,MATH 109,B02,083216,Ganzberger; Geoffrey Michael,2,0,32,30
1657442865131,MATH 109,B03,093479,Ganzberger; Geoffrey Michael,8,0,32,24
1657442871154,MATH 142A,A01,083219,Chow; Bennett,7,0,32,25
1657442871154,MATH 142A,A02,083220,Chow; Bennett,10,0,32,22
1657442871154,MATH 142A,A03,093480,Chow; Bennett,8,0,32,24
1657442871154,MATH 142A,B03,093481,Chow; Bennett,8,0,32,24
1657442871154,MATH 142A,B04,093558,Chow; Bennett,13,0,32,19
1657442871154,MATH 142A,B05,093559,Chow; Bennett,6,0,32,26
1657442877182,MATH 193A,A01,083224,Rotar; Vladimir,8,0,34,26
1657442877182,MATH 193A,A02,083225,Rotar; Vladimir,9,0,34,25
1657442877182,MATH 193A,A03,083781,Rotar; Vladimir,5,0,34,29
1657442877182,MATH 193A,A04,083782,Rotar; Vladimir,10,0,34,24
1657442877182,MATH 193A,A05,093482,Rotar; Vladimir,10,0,34,24
1657442883204,MATH 197,001,091859,McAuley; Julian John,9999,0,9999,0
1657442883204,MATH 197,002,095566,Kedlaya; Kiran S.,9997,0,9999,2
1657442883204,MATH 197,003,095567,Xiao; Ming,9999,0,9999,0
1657442883204,MATH 197,004,095571,Perols; Johan Lars,9998,0,9999,1
1657442890272,COGS 9,A01,083615,Shannon; Kyle Michael,9,0,75,66
1657442896294,COGS 11,A01,083617,Boyle; Mary E. T.,22,0,48,26
1657442902317,COGS 13,A01,083071,Bastos; Amalia Pinkusfeld,11,0,71,60
1657442908340,COGS 14A,A01,092681,Semenuks; Arturs,5,1,100,95
1657442914364,COGS 14B,A01,083073,Cheng; Tzu-Han,6,0,63,57
1657442920386,COGS 17,A01,092677,Semenuks; Arturs,6,0,81,75
1657442926413,COGS 100,A01,083619,Allen; Michael Gordon,17,0,70,53
1657442932440,COGS 101A,A01,083621,Davis; Joshua Daniel,9,0,68,59
1657442938466,COGS 101B,A01,091572,Allen; Michael Gordon,12,0,65,53
1657442944491,COGS 101C,A01,083625,Delgado; Tania,17,0,35,18
1657442950518,COGS 107A,A01,083627,Boyle; Mary E. T.,13,0,60,47
1657442956541,COGS 118A,A01,083075,Gupta; Anjum,21,0,76,55
1657442962570,CSE 3,A50,083646,Miranda; Gregory Joseph,24,0,50,26
1657442968592,CSE 8A,A50,083650,Miranda; Gregory Joseph,17,1,56,39
1657442974622,CSE 11,A01,083080,Cao; Yingjun,6,15,40,34
1657442980644,CSE 12,A01,083652,Krause-Levy; Sophia Louisa,28,1,120,92
1657442986665,CSE 15L,A01,083654,Morris; Justin Loren,9,0,50,41
1657442986665,CSE 15L,A02,083655,Morris; Justin Loren,9,0,50,41
1657442992692,CSE 20,A01,083657,Tran; Khoa Dang,39,0,80,41
1657442998719,CSE 21,A01,095574,Bach; Quang Tran,22,0,48,26
1657443004743,CSE 30,A01,083084,Eldon; John,5,0,80,75
1657443004743,CSE 30,B01,095061,Bhaskar; Nishant,9,0,50,41
1657443010853,CSE 100,A01,083659,Cao; Yingjun,5,4,70,65
1657443016876,CSE 134B,A01,083661,Powell; Thomas Allan,22,0,100,78
1657443022908,CSE 140,A01,083663,Gungor; Onat,15,0,85,70
1657443028935,CSE 140L,A01,083088,Eldon; John,21,0,100,79
1657443034958,CSE 175,A01,083665,Kumar; Rakesh,3,0,25,22
1657443040984,CSE 190,A00,092507,Dubnov; Shlomo,8,0,20,12
1657443047013,ECE 45,A01,083139,Congero; Spencer William,6,0,75,69
1657443053047,ECE 65,A50,083695,Saad; Andrew S,12,0,30,18
1657443053047,ECE 65,A51,095125,Saad; Andrew S,24,0,26,2
1657443059069,ECE 109,A01,091882,Touri; Behrouz,19,0,70,51
1657443065096,ECE 180,A00,083140,Abi Samra; Nicholas Camill,1,0,30,29
1657443065096,ECE 180,B00,083141,Abi Samra; Nicholas Camill,0,0,30,30
1657443071119,MATH 10A,A01,083735,Patchell; Gregory David,2,0,30,28
1657443071119,MATH 10A,A02,083736,Patchell; Gregory David,20,0,30,10
1657443071119,MATH 10A,A03,083737,Patchell; Gregory David,16,0,30,14
1657443077148,MATH 10B,A01,083207,Lim; Seonhee,8,0,34,26
1657443077148,MATH 10B,A02,083208,Lim; Seonhee,9,0,35,26
1657443077148,MATH 10B,A03,093472,Lim; Seonhee,7,0,34,27
1657443077148,MATH 10B,B01,083739,Sinha; Shubham,12,0,30,18
1657443083171,MATH 18,A01,083743,Cinel; Cameron Alexander,7,0,30,23
1657443083171,MATH 18,A02,083744,Cinel; Cameron Alexander,17,0,30,13
1657443083171,MATH 18,A03,083745,Cinel; Cameron Alexander,9,0,30,21
1657443083171,MATH 18,B01,083748,Rideout; David Porter,5,0,37,32
1657443083171,MATH 18,B02,083749,Rideout; David Porter,5,0,36,31
1657443083171,MATH 18,B03,083750,Rideout; David Porter,3,0,37,34
1657443083171,MATH 18,B04,083751,Rideout; David Porter,6,0,36,30
1657443083171,MATH 18,B05,093473,Rideout; David Porter,6,0,36,30
1657443083171,MATH 18,B06,093474,Rideout; David Porter,6,0,36,30
1657443089199,MATH 20A,A01,083754,Zheng; Zequn,14,0,40,26
1657443095221,MATH 20B,A01,083756,Briones; Jor-el Thomas Caparas,4,0,36,32
1657443095221,MATH 20B,A02,083757,Briones; Jor-el Thomas Caparas,1,0,36,35
1657443095221,MATH 20B,A03,093475,Briones; Jor-el Thomas Caparas,2,0,36,34
1657443101249,MATH 20C,A01,083760,Briones; Jor-el Thomas Caparas,1,0,35,34
1657443101249,MATH 20C,A02,083761,Briones; Jor-el Thomas Caparas,8,0,35,27
1657443101249,MATH 20C,A03,093476,Briones; Jor-el Thomas Caparas,0,1,36,36
1657443101249,MATH 20C,B01,083762,Bach; Quang Tran,1,0,30,29
1657443107278,MATH 20D,A01,083765,Tran; Brian Kha,5,0,30,25
1657443107278,MATH 20D,A02,083766,Tran; Brian Kha,5,0,30,25
1657443107278,MATH 20D,A03,083767,Tran; Brian Kha,5,0,30,25
1657443113306,MATH 20E,A01,083771,Ganguly; Soumya,9,0,32,23
1657443113306,MATH 20E,A02,083772,Ganguly; Soumya,6,0,32,26
1657443113306,MATH 20E,B01,083773,Ciotti; Benjamin,20,0,35,15
1657443113306,MATH 20E,B02,083774,Ciotti; Benjamin,17,0,35,18
1657443119331,MATH 103A,A01,083777,Greenfeld; Be'Eri,3,0,36,33
1657443119331,MATH 103A,A02,083778,Greenfeld; Be'Eri,5,0,36,31
1657443119331,MATH 103A,A03,093561,Greenfeld; Be'Eri,5,0,36,31
1657443119331,MATH 103A,B01,083779,Greenfeld; Be'Eri,7,0,36,29
1657443119331,MATH 103A,B02,083780,Greenfeld; Be'Eri,4,0,36,32
1657443119331,MATH 103A,B03,093562,Greenfeld; Be'Eri,3,0,36,33
1657443125354,MATH 105,A01,085443,Carter; Anne Toulson,15,0,35,20
1657443125354,MATH 105,A02,093477,Carter; Anne Toulson,20,0,35,15
1657443131376,MATH 109,A01,083213,Ganzberger; Geoffrey Michael,2,0,34,32
1657443131376,MATH 109,A02,083214,Ganzberger; Geoffrey Michael,4,0,34,30
1657443131376,MATH 109,A03,093478,Ganzberger; Geoffrey Michael,2,0,34,32
1657443131376,MATH 109,B01,083215,Ganzberger; Geoffrey Michael,1,0,32,31
1657443131376,MATH 109,B02,083216,Ganzberger; Geoffrey Michael,2,0,32,30
1657443131376,MATH 109,B03,093479,Ganzberger; Geoffrey Michael,8,0,32,24
1657443137405,MATH 142A,A01,083219,Chow; Bennett,7,0,32,25
1657443137405,MATH 142A,A02,083220,Chow; Bennett,10,0,32,22
1657443137405,MATH 142A,A03,093480,Chow; Bennett,8,0,32,24
1657443137405,MATH 142A,B03,093481,Chow; Bennett,8,0,32,24
1657443137405,MATH 142A,B04,093558,Chow; Bennett,13,0,32,19
1657443137405,MATH 142A,B05,093559,Chow; Bennett,6,0,32,26
1657443143433,MATH 193A,A01,083224,Rotar; Vladimir,8,0,34,26
1657443143433,MATH 193A,A02,083225,Rotar; Vladimir,9,0,34,25
1657443143433,MATH 193A,A03,083781,Rotar; Vladimir,5,0,34,29
1657443143433,MATH 193A,A04,083782,Rotar; Vladimir,10,0,34,24
1657443143433,MATH 193A,A05,093482,Rotar; Vladimir,10,0,34,24
1657443149457,MATH 197,001,091859,McAuley; Julian John,9999,0,9999,0
1657443149457,MATH 197,002,095566,Kedlaya; Kiran S.,9997,0,9999,2
1657443149457,MATH 197,003,095567,Xiao; Ming,9999,0,9999,0
1657443149457,MATH 197,004,095571,Perols; Johan Lars,9998,0,9999,1
1657443156520,COGS 9,A01,083615,Shannon; Kyle Michael,9,0,75,66
1657443162544,COGS 11,A01,083617,Boyle; Mary E. T.,22,0,48,26
1657443168568,COGS 13,A01,083071,Bastos; Amalia Pinkusfeld,11,0,71,60
1657443174591,COGS 14A,A01,092681,Semenuks; Arturs,5,1,100,95
1657443180616,COGS 14B,A01,083073,Cheng; Tzu-Han,6,0,63,57
1657443186638,COGS 17,A01,092677,Semenuks; Arturs,6,0,81,75
1657443192660,COGS 100,A01,083619,Allen; Michael Gordon,17,0,70,53
1657443198685,COGS 101A,A01,083621,Davis; Joshua Daniel,9,0,68,59
1657443204710,COGS 101B,A01,091572,Allen; Michael Gordon,12,0,65,53
1657443210733,COGS 101C,A01,083625,Delgado; Tania,17,0,35,18
1657443216759,COGS 107A,A01,083627,Boyle; Mary E. T.,13,0,60,47
1657443222781,COGS 118A,A01,083075,Gupta; Anjum,21,0,76,55
1657443228804,CSE 3,A50,083646,Miranda; Gregory Joseph,24,0,50,26
1657443234830,CSE 8A,A50,083650,Miranda; Gregory Joseph,17,1,56,39
1657443240854,CSE 11,A01,083080,Cao; Yingjun,6,15,40,34
1657443246880,CSE 12,A01,083652,Krause-Levy; Sophia Louisa,28,1,120,92
1657443252903,CSE 15L,A01,083654,Morris; Justin Loren,9,0,50,41
1657443252903,CSE 15L,A02,083655,Morris; Justin Loren,9,0,50,41
1657443258927,CSE 20,A01,083657,Tran; Khoa Dang,39,0,80,41
1657443264949,CSE 21,A01,095574,Bach; Quang Tran,22,0,48,26
1657443270974,CSE 30,A01,083084,Eldon; John,5,0,80,75
1657443270974,CSE 30,B01,095061,Bhaskar; Nishant,9,0,50,41
1657443277004,CSE 100,A01,083659,Cao; Yingjun,5,4,70,65
1657443283025,CSE 134B,A01,083661,Powell; Thomas Allan,22,0,100,78
1657443289058,CSE 140,A01,083663,Gungor; Onat,15,0,85,70
1657443295080,CSE 140L,A01,083088,Eldon; John,21,0,100,79
1657443301102,CSE 175,A01,083665,Kumar; Rakesh,3,0,25,22
1657443307125,CSE 190,A00,092507,Dubnov; Shlomo,8,0,20,12
1657443313149,ECE 45,A01,083139,Congero; Spencer William,6,0,75,69
1657443319172,ECE 65,A50,083695,Saad; Andrew S,12,0,30,18
1657443319172,ECE 65,A51,095125,Saad; Andrew S,24,0,26,2
1657443325198,ECE 109,A01,091882,Touri; Behrouz,19,0,70,51
1657443331219,ECE 180,A00,083140,Abi Samra; Nicholas Camill,1,0,30,29
1657443331219,ECE 180,B00,083141,Abi Samra; Nicholas Camill,0,0,30,30
1657443337241,MATH 10A,A01,083735,Patchell; Gregory David,2,0,30,28
1657443337241,MATH 10A,A02,083736,Patchell; Gregory David,20,0,30,10
1657443337241,MATH 10A,A03,083737,Patchell; Gregory David,16,0,30,14
1657443343265,MATH 10B,A01,083207,Lim; Seonhee,8,0,34,26
1657443343265,MATH 10B,A02,083208,Lim; Seonhee,9,0,35,26
1657443343265,MATH 10B,A03,093472,Lim; Seonhee,7,0,34,27
1657443343265,MATH 10B,B01,083739,Sinha; Shubham,12,0,30,18
1657443349296,MATH 18,A01,083743,Cinel; Cameron Alexander,7,0,30,23
1657443349296,MATH 18,A02,083744,Cinel; Cameron Alexander,17,0,30,13
1657443349296,MATH 18,A03,083745,Cinel; Cameron Alexander,9,0,30,21
1657443349296,MATH 18,B01,083748,Rideout; David Porter,5,0,37,32
1657443349296,MATH 18,B02,083749,Rideout; David Porter,5,0,36,31
1657443349296,MATH 18,B03,083750,Rideout; David Porter,3,0,37,34
1657443349296,MATH 18,B04,083751,Rideout; David Porter,6,0,36,30
1657443349296,MATH 18,B05,093473,Rideout; David Porter,6,0,36,30
1657443349296,MATH 18,B06,093474,Rideout; David Porter,6,0,36,30
1657443355317,MATH 20A,A01,083754,Zheng; Zequn,14,0,40,26
1657443361340,MATH 20B,A01,083756,Briones; Jor-el Thomas Caparas,4,0,36,32
1657443361340,MATH 20B,A02,083757,Briones; Jor-el Thomas Caparas,1,0,36,35
1657443361340,MATH 20B,A03,093475,Briones; Jor-el Thomas Caparas,2,0,36,34
1657443367367,MATH 20C,A01,083760,Briones; Jor-el Thomas Caparas,1,0,35,34
1657443367367,MATH 20C,A02,083761,Briones; Jor-el Thomas Caparas,8,0,35,27
1657443367367,MATH 20C,A03,093476,Briones; Jor-el Thomas Caparas,0,1,36,36
1657443367367,MATH 20C,B01,083762,Bach; Quang Tran,1,0,30,29
1657443373394,MATH 20D,A01,083765,Tran; Brian Kha,5,0,30,25
1657443373394,MATH 20D,A02,083766,Tran; Brian Kha,5,0,30,25
1657443373394,MATH 20D,A03,083767,Tran; Brian Kha,5,0,30,25
1657443379426,MATH 20E,A01,083771,Ganguly; Soumya,9,0,32,23
1657443379426,MATH 20E,A02,083772,Ganguly; Soumya,6,0,32,26
1657443379426,MATH 20E,B01,083773,Ciotti; Benjamin,20,0,35,15
1657443379426,MATH 20E,B02,083774,Ciotti; Benjamin,17,0,35,18
1657443385455,MATH 103A,A01,083777,Greenfeld; Be'Eri,3,0,36,33
1657443385455,MATH 103A,A02,083778,Greenfeld; Be'Eri,5,0,36,31
1657443385455,MATH 103A,A03,093561,Greenfeld; Be'Eri,5,0,36,31
1657443385455,MATH 103A,B01,083779,Greenfeld; Be'Eri,7,0,36,29
1657443385455,MATH 103A,B02,083780,Greenfeld; Be'Eri,4,0,36,32
1657443385455,MATH 103A,B03,093562,Greenfeld; Be'Eri,3,0,36,33
1657443391478,MATH 105,A01,085443,Carter; Anne Toulson,15,0,35,20
1657443391478,MATH 105,A02,093477,Carter; Anne Toulson,20,0,35,15
1657443397501,MATH 109,A01,083213,Ganzberger; Geoffrey Michael,2,0,34,32
1657443397501,MATH 109,A02,083214,Ganzberger; Geoffrey Michael,4,0,34,30
1657443397501,MATH 109,A03,093478,Ganzberger; Geoffrey Michael,2,0,34,32
1657443397501,MATH 109,B01,083215,Ganzberger; Geoffrey Michael,1,0,32,31
1657443397501,MATH 109,B02,083216,Ganzberger; Geoffrey Michael,2,0,32,30
1657443397501,MATH 109,B03,093479,Ganzberger; Geoffrey Michael,8,0,32,24
1657443403526,MATH 142A,A01,083219,Chow; Bennett,7,0,32,25
1657443403526,MATH 142A,A02,083220,Chow; Bennett,10,0,32,22
1657443403526,MATH 142A,A03,093480,Chow; Bennett,8,0,32,24
1657443403526,MATH 142A,B03,093481,Chow; Bennett,8,0,32,24
1657443403526,MATH 142A,B04,093558,Chow; Bennett,13,0,32,19
1657443403526,MATH 142A,B05,093559,Chow; Bennett,6,0,32,26
1657443409555,MATH 193A,A01,083224,Rotar; Vladimir,8,0,34,26
1657443409555,MATH 193A,A02,083225,Rotar; Vladimir,9,0,34,25
1657443409555,MATH 193A,A03,083781,Rotar; Vladimir,5,0,34,29
1657443409555,MATH 193A,A04,083782,Rotar; Vladimir,10,0,34,24
1657443409555,MATH 193A,A05,093482,Rotar; Vladimir,10,0,34,24
1657443415577,MATH 197,001,091859,McAuley; Julian John,9999,0,9999,0
1657443415577,MATH 197,002,095566,Kedlaya; Kiran S.,9997,0,9999,2
1657443415577,MATH 197,003,095567,Xiao; Ming,9999,0,9999,0
1657443415577,MATH 197,004,095571,Perols; Johan Lars,9998,0,9999,1
1657443422635,COGS 9,A01,083615,Shannon; Kyle Michael,9,0,75,66
1657443428661,COGS 11,A01,083617,Boyle; Mary E. T.,22,0,48,26
1657443434689,COGS 13,A01,083071,Bastos; Amalia Pinkusfeld,11,0,71,60
1657443440711,COGS 14A,A01,092681,Semenuks; Arturs,5,1,100,95
1657443446735,COGS 14B,A01,083073,Cheng; Tzu-Han,6,0,63,57
1657443452759,COGS 17,A01,092677,Semenuks; Arturs,6,0,81,75
1657443458788,COGS 100,A01,083619,Allen; Michael Gordon,17,0,70,53
1657443464811,COGS 101A,A01,083621,Davis; Joshua Daniel,9,0,68,59
1657443470839,COGS 101B,A01,091572,Allen; Michael Gordon,12,0,65,53
1657443476866,COGS 101C,A01,083625,Delgado; Tania,17,0,35,18
1657443482889,COGS 107A,A01,083627,Boyle; Mary E. T.,13,0,60,47
1657443488911,COGS 118A,A01,083075,Gupta; Anjum,21,0,76,55
1657443494935,CSE 3,A50,083646,Miranda; Gregory Joseph,24,0,50,26
1657443500962,CSE 8A,A50,083650,Miranda; Gregory Joseph,17,1,56,39
1657443506996,CSE 11,A01,083080,Cao; Yingjun,6,15,40,34
1657443513018,CSE 12,A01,083652,Krause-Levy; Sophia Louisa,28,1,120,92
1657443519065,CSE 15L,A01,083654,Morris; Justin Loren,9,0,50,41
1657443519065,CSE 15L,A02,083655,Morris; Justin Loren,9,0,50,41
1657443525092,CSE 20,A01,083657,Tran; Khoa Dang,39,0,80,41
1657443531114,CSE 21,A01,095574,Bach; Quang Tran,22,0,48,26
1657443537139,CSE 30,A01,083084,Eldon; John,5,0,80,75
1657443537139,CSE 30,B01,095061,Bhaskar; Nishant,9,0,50,41
1657443543162,CSE 100,A01,083659,Cao; Yingjun,5,4,70,65
1657443549184,CSE 134B,A01,083661,Powell; Thomas Allan,22,0,100,78
1657443555212,CSE 140,A01,083663,Gungor; Onat,15,0,85,70
1657443561236,CSE 140L,A01,083088,Eldon; John,21,0,100,79
1657443567260,CSE 175,A01,083665,Kumar; Rakesh,3,0,25,22
1657443573291,CSE 190,A00,092507,Dubnov; Shlomo,8,0,20,12
1657443579317,ECE 45,A01,083139,Congero; Spencer William,6,0,75,69
1657443585339,ECE 65,A50,083695,Saad; Andrew S,12,0,30,18
1657443585339,ECE 65,A51,095125,Saad; Andrew S,24,0,26,2
1657443591362,ECE 109,A01,091882,Touri; Behrouz,19,0,70,51
1657443597387,ECE 180,A00,083140,Abi Samra; Nicholas Camill,1,0,30,29
1657443597387,ECE 180,B00,083141,Abi Samra; Nicholas Camill,0,0,30,30
1657443603411,MATH 10A,A01,083735,Patchell; Gregory David,2,0,30,28
1657443603411,MATH 10A,A02,083736,Patchell; Gregory David,20,0,30,10
1657443603411,MATH 10A,A03,083737,Patchell; Gregory David,16,0,30,14
1657443609521,MATH 10B,A01,083207,Lim; Seonhee,8,0,34,26
1657443609521,MATH 10B,A02,083208,Lim; Seonhee,9,0,35,26
1657443609521,MATH 10B,A03,093472,Lim; Seonhee,7,0,34,27
1657443609521,MATH 10B,B01,083739,Sinha; Shubham,12,0,30,18
1657443615552,MATH 18,A01,083743,Cinel; Cameron Alexander,7,0,30,23
1657443615552,MATH 18,A02,083744,Cinel; Cameron Alexander,17,0,30,13
1657443615552,MATH 18,A03,083745,Cinel; Cameron Alexander,9,0,30,21
1657443615552,MATH 18,B01,083748,Rideout; David Porter,5,0,37,32
1657443615552,MATH 18,B02,083749,Rideout; David Porter,5,0,36,31
1657443615552,MATH 18,B03,083750,Rideout; David Porter,3,0,37,34
1657443615552,MATH 18,B04,083751,Rideout; David Porter,6,0,36,30
1657443615552,MATH 18,B05,093473,Rideout; David Porter,6,0,36,30
1657443615552,MATH 18,B06,093474,Rideout; David Porter,6,0,36,30
1657443621613,MATH 20A,A01,083754,Zheng; Zequn,14,0,40,26
1657443627635,MATH 20B,A01,083756,Briones; Jor-el Thomas Caparas,4,0,36,32
1657443627635,MATH 20B,A02,083757,Briones; Jor-el Thomas Caparas,1,0,36,35
1657443627635,MATH 20B,A03,093475,Briones; Jor-el Thomas Caparas,2,0,36,34
1657443633661,MATH 20C,A01,083760,Briones; Jor-el Thomas Caparas,1,0,35,34
1657443633661,MATH 20C,A02,083761,Briones; Jor-el Thomas Caparas,8,0,35,27
1657443633661,MATH 20C,A03,093476,Briones; Jor-el Thomas Caparas,0,1,36,36
1657443633661,MATH 20C,B01,083762,Bach; Quang Tran,1,0,30,29
1657443639683,MATH 20D,A01,083765,Tran; Brian Kha,5,0,30,25
1657443639683,MATH 20D,A02,083766,Tran; Brian Kha,5,0,30,25
1657443639683,MATH 20D,A03,083767,Tran; Brian Kha,5,0,30,25
1657443645707,MATH 20E,A01,083771,Ganguly; Soumya,9,0,32,23
1657443645707,MATH 20E,A02,083772,Ganguly; Soumya,6,0,32,26
1657443645707,MATH 20E,B01,083773,Ciotti; Benjamin,20,0,35,15
1657443645707,MATH 20E,B02,083774,Ciotti; Benjamin,17,0,35,18
1657443651730,MATH 103A,A01,083777,Greenfeld; Be'Eri,3,0,36,33
1657443651730,MATH 103A,A02,083778,Greenfeld; Be'Eri,5,0,36,31
1657443651730,MATH 103A,A03,093561,Greenfeld; Be'Eri,5,0,36,31
1657443651730,MATH 103A,B01,083779,Greenfeld; Be'Eri,7,0,36,29
1657443651730,MATH 103A,B02,083780,Greenfeld; Be'Eri,4,0,36,32
1657443651730,MATH 103A,B03,093562,Greenfeld; Be'Eri,3,0,36,33
1657443657752,MATH 105,A01,085443,Carter; Anne Toulson,15,0,35,20
1657443657752,MATH 105,A02,093477,Carter; Anne Toulson,20,0,35,15
1657443663782,MATH 109,A01,083213,Ganzberger; Geoffrey Michael,2,0,34,32
1657443663782,MATH 109,A02,083214,Ganzberger; Geoffrey Michael,4,0,34,30
1657443663782,MATH 109,A03,093478,Ganzberger; Geoffrey Michael,2,0,34,32
1657443663782,MATH 109,B01,083215,Ganzberger; Geoffrey Michael,1,0,32,31
1657443663782,MATH 109,B02,083216,Ganzberger; Geoffrey Michael,2,0,32,30
1657443663782,MATH 109,B03,093479,Ganzberger; Geoffrey Michael,8,0,32,24
1657443669805,MATH 142A,A01,083219,Chow; Bennett,7,0,32,25
1657443669805,MATH 142A,A02,083220,Chow; Bennett,10,0,32,22
1657443669805,MATH 142A,A03,093480,Chow; Bennett,8,0,32,24
1657443669805,MATH 142A,B03,093481,Chow; Bennett,8,0,32,24
1657443669805,MATH 142A,B04,093558,Chow; Bennett,13,0,32,19
1657443669805,MATH 142A,B05,093559,Chow; Bennett,6,0,32,26
1657443675840,MATH 193A,A01,083224,Rotar; Vladimir,8,0,34,26
1657443675840,MATH 193A,A02,083225,Rotar; Vladimir,9,0,34,25
1657443675840,MATH 193A,A03,083781,Rotar; Vladimir,5,0,34,29
1657443675840,MATH 193A,A04,083782,Rotar; Vladimir,10,0,34,24
1657443675840,MATH 193A,A05,093482,Rotar; Vladimir,10,0,34,24
1657443681868,MATH 197,001,091859,McAuley; Julian John,9999,0,9999,0
1657443681868,MATH 197,002,095566,Kedlaya; Kiran S.,9997,0,9999,2
1657443681868,MATH 197,003,095567,Xiao; Ming,9999,0,9999,0
1657443681868,MATH 197,004,095571,Perols; Johan Lars,9998,0,9999,1
1657443688922,COGS 9,A01,083615,Shannon; Kyle Michael,9,0,75,66
1657443694944,COGS 11,A01,083617,Boyle; Mary E. T.,22,0,48,26
1657443700968,COGS 13,A01,083071,Bastos; Amalia Pinkusfeld,11,0,71,60
1657443706990,COGS 14A,A01,092681,Semenuks; Arturs,5,1,100,95
1657443713014,COGS 14B,A01,083073,Cheng; Tzu-Han,6,0,63,57
1657443719037,COGS 17,A01,092677,Semenuks; Arturs,6,0,81,75
1657443725066,COGS 100,A01,083619,Allen; Michael Gordon,17,0,70,53
1657443731093,COGS 101A,A01,083621,Davis; Joshua Daniel,9,0,68,59
1657443737122,COGS 101B,A01,091572,Allen; Michael Gordon,12,0,65,53
1657443743144,COGS 101C,A01,083625,Delgado; Tania,17,0,35,18
1657443749170,COGS 107A,A01,083627,Boyle; Mary E. T.,13,0,60,47
1657443755197,COGS 118A,A01,083075,Gupta; Anjum,21,0,76,55
1657443761220,CSE 3,A50,083646,Miranda; Gregory Joseph,24,0,50,26
1657443767248,CSE 8A,A50,083650,Miranda; Gregory Joseph,17,1,56,39
1657443773271,CSE 11,A01,083080,Cao; Yingjun,6,15,40,34
1657443779294,CSE 12,A01,083652,Krause-Levy; Sophia Louisa,28,1,120,92
1657443785317,CSE 15L,A01,083654,Morris; Justin Loren,9,0,50,41
1657443785317,CSE 15L,A02,083655,Morris; Justin Loren,9,0,50,41
1657443791341,CSE 20,A01,083657,Tran; Khoa Dang,39,0,80,41
1657443797364,CSE 21,A01,095574,Bach; Quang Tran,22,0,48,26
1657443803395,CSE 30,A01,083084,Eldon; John,5,0,80,75
1657443803395,CSE 30,B01,095061,Bhaskar; Nishant,9,0,50,41
1657443809439,CSE 100,A01,083659,Cao; Yingjun,5,4,70,65
1657443815465,CSE 134B,A01,083661,Powell; Thomas Allan,22,0,100,78
1657443821490,CSE 140,A01,083663,Gungor; Onat,15,0,85,70
1657443827513,CSE 140L,A01,083088,Eldon; John,21,0,100,79
1657443833537,CSE 175,A01,083665,Kumar; Rakesh,3,0,25,22
1657443839560,CSE 190,A00,092507,Dubnov; Shlomo,8,0,20,12
1657443845583,ECE 45,A01,083139,Congero; Spencer William,6,0,75,69
1657443851614,ECE 65,A50,083695,Saad; Andrew S,12,0,30,18
1657443851614,ECE 65,A51,095125,Saad; Andrew S,24,0,26,2
1657443857636,ECE 109,A01,091882,Touri; Behrouz,19,0,70,51
1657443863659,ECE 180,A00,083140,Abi Samra; Nicholas Camill,1,0,30,29
1657443863659,ECE 180,B00,083141,Abi Samra; Nicholas Camill,0,0,30,30
1657443869682,MATH 10A,A01,083735,Patchell; Gregory David,2,0,30,28
1657443869682,MATH 10A,A02,083736,Patchell; Gregory David,20,0,30,10
1657443869682,MATH 10A,A03,083737,Patchell; Gregory David,16,0,30,14
1657443875705,MATH 10B,A01,083207,Lim; Seonhee,8,0,34,26
1657443875705,MATH 10B,A02,083208,Lim; Seonhee,9,0,35,26
1657443875705,MATH 10B,A03,093472,Lim; Seonhee,7,0,34,27
1657443875705,MATH 10B,B01,083739,Sinha; Shubham,12,0,30,18
1657443881751,MATH 18,A01,083743,Cinel; Cameron Alexander,7,0,30,23
1657443881751,MATH 18,A02,083744,Cinel; Cameron Alexander,17,0,30,13
1657443881751,MATH 18,A03,083745,Cinel; Cameron Alexander,9,0,30,21
1657443881751,MATH 18,B01,083748,Rideout; David Porter,5,0,37,32
1657443881751,MATH 18,B02,083749,Rideout; David Porter,5,0,36,31
1657443881751,MATH 18,B03,083750,Rideout; David Porter,3,0,37,34
1657443881751,MATH 18,B04,083751,Rideout; David Porter,6,0,36,30
1657443881751,MATH 18,B05,093473,Rideout; David Porter,6,0,36,30
1657443881751,MATH 18,B06,093474,Rideout; David Porter,6,0,36,30
1657443887777,MATH 20A,A01,083754,Zheng; Zequn,14,0,40,26
1657443893806,MATH 20B,A01,083756,Briones; Jor-el Thomas Caparas,4,0,36,32
1657443893806,MATH 20B,A02,083757,Briones; Jor-el Thomas Caparas,1,0,36,35
1657443893806,MATH 20B,A03,093475,Briones; Jor-el Thomas Caparas,2,0,36,34
1657443899830,MATH 20C,A01,083760,Briones; Jor-el Thomas Caparas,1,0,35,34
1657443899830,MATH 20C,A02,083761,Briones; Jor-el Thomas Caparas,8,0,35,27
1657443899830,MATH 20C,A03,093476,Briones; Jor-el Thomas Caparas,0,1,36,36
1657443899830,MATH 20C,B01,083762,Bach; Quang Tran,1,0,30,29
1657443905858,MATH 20D,A01,083765,Tran; Brian Kha,5,0,30,25
1657443905858,MATH 20D,A02,083766,Tran; Brian Kha,5,0,30,25
1657443905858,MATH 20D,A03,083767,Tran; Brian Kha,5,0,30,25
1657443911886,MATH 20E,A01,083771,Ganguly; Soumya,9,0,32,23
1657443911886,MATH 20E,A02,083772,Ganguly; Soumya,6,0,32,26
1657443911886,MATH 20E,B01,083773,Ciotti; Benjamin,20,0,35,15
1657443911886,MATH 20E,B02,083774,Ciotti; Benjamin,17,0,35,18
1657443917915,MATH 103A,A01,083777,Greenfeld; Be'Eri,3,0,36,33
1657443917915,MATH 103A,A02,083778,Greenfeld; Be'Eri,5,0,36,31
1657443917915,MATH 103A,A03,093561,Greenfeld; Be'Eri,5,0,36,31
1657443917915,MATH 103A,B01,083779,Greenfeld; Be'Eri,7,0,36,29
1657443917915,MATH 103A,B02,083780,Greenfeld; Be'Eri,4,0,36,32
1657443917915,MATH 103A,B03,093562,Greenfeld; Be'Eri,3,0,36,33
1657443923941,MATH 105,A01,085443,Carter; Anne Toulson,15,0,35,20
1657443923941,MATH 105,A02,093477,Carter; Anne Toulson,20,0,35,15
1657443929971,MATH 109,A01,083213,Ganzberger; Geoffrey Michael,2,0,34,32
1657443929971,MATH 109,A02,083214,Ganzberger; Geoffrey Michael,4,0,34,30
1657443929971,MATH 109,A03,093478,Ganzberger; Geoffrey Michael,2,0,34,32
1657443929971,MATH 109,B01,083215,Ganzberger; Geoffrey Michael,1,0,32,31
1657443929971,MATH 109,B02,083216,Ganzberger; Geoffrey Michael,2,0,32,30
1657443929971,MATH 109,B03,093479,Ganzberger; Geoffrey Michael,8,0,32,24
1657443936000,MATH 142A,A01,083219,Chow; Bennett,7,0,32,25
1657443936000,MATH 142A,A02,083220,Chow; Bennett,10,0,32,22
1657443936000,MATH 142A,A03,093480,Chow; Bennett,8,0,32,24
1657443936000,MATH 142A,B03,093481,Chow; Bennett,8,0,32,24
1657443936000,MATH 142A,B04,093558,Chow; Bennett,13,0,32,19
1657443936000,MATH 142A,B05,093559,Chow; Bennett,6,0,32,26
1657443942024,MATH 193A,A01,083224,Rotar; Vladimir,8,0,34,26
1657443942024,MATH 193A,A02,083225,Rotar; Vladimir,9,0,34,25
1657443942024,MATH 193A,A03,083781,Rotar; Vladimir,5,0,34,29
1657443942024,MATH 193A,A04,083782,Rotar; Vladimir,10,0,34,24
1657443942024,MATH 193A,A05,093482,Rotar; Vladimir,10,0,34,24
1657443948050,MATH 197,001,091859,McAuley; Julian John,9999,0,9999,0
1657443948050,MATH 197,002,095566,Kedlaya; Kiran S.,9997,0,9999,2
1657443948050,MATH 197,003,095567,Xiao; Ming,9999,0,9999,0
1657443948050,MATH 197,004,095571,Perols; Johan Lars,9998,0,9999,1
1657443955104,COGS 9,A01,083615,Shannon; Kyle Michael,9,0,75,66
1657443961129,COGS 11,A01,083617,Boyle; Mary E. T.,22,0,48,26
1657443967151,COGS 13,A01,083071,Bastos; Amalia Pinkusfeld,11,0,71,60
1657443973175,COGS 14A,A01,092681,Semenuks; Arturs,5,1,100,95
1657443979196,COGS 14B,A01,083073,Cheng; Tzu-Han,6,0,63,57
1657443985219,COGS 17,A01,092677,Semenuks; Arturs,6,0,81,75
1657443991241,COGS 100,A01,083619,Allen; Michael Gordon,17,0,70,53
1657443997264,COGS 101A,A01,083621,Davis; Joshua Daniel,9,0,68,59
1657444003288,COGS 101B,A01,091572,Allen; Michael Gordon,12,0,65,53
1657444009312,COGS 101C,A01,083625,Delgado; Tania,17,0,35,18
1657444015335,COGS 107A,A01,083627,Boyle; Mary E. T.,13,0,60,47
1657444021362,COGS 118A,A01,083075,Gupta; Anjum,21,0,76,55
1657444027384,CSE 3,A50,083646,Miranda; Gregory Joseph,24,0,50,26
1657444033407,CSE 8A,A50,083650,Miranda; Gregory Joseph,17,1,56,39
1657444039434,CSE 11,A01,083080,Cao; Yingjun,6,15,40,34
1657444045461,CSE 12,A01,083652,Krause-Levy; Sophia Louisa,28,1,120,92
1657444051484,CSE 15L,A01,083654,Morris; Justin Loren,9,0,50,41
1657444051484,CSE 15L,A02,083655,Morris; Justin Loren,9,0,50,41
1657444057512,CSE 20,A01,083657,Tran; Khoa Dang,39,0,80,41
1657444063534,CSE 21,A01,095574,Bach; Quang Tran,22,0,48,26
1657444069563,CSE 30,A01,083084,Eldon; John,5,0,80,75
1657444069563,CSE 30,B01,095061,Bhaskar; Nishant,9,0,50,41
1657444075586,CSE 100,A01,083659,Cao; Yingjun,5,4,70,65
1657444081615,CSE 134B,A01,083661,Powell; Thomas Allan,22,0,100,78
1657444087637,CSE 140,A01,083663,Gungor; Onat,15,0,85,70
1657444093658,CSE 140L,A01,083088,Eldon; John,21,0,100,79
1657444099681,CSE 175,A01,083665,Kumar; Rakesh,3,0,25,22
1657444105705,CSE 190,A00,092507,Dubnov; Shlomo,8,0,20,12
1657444111731,ECE 45,A01,083139,Congero; Spencer William,6,0,75,69
1657444117754,ECE 65,A50,083695,Saad; Andrew S,12,0,30,18
1657444117754,ECE 65,A51,095125,Saad; Andrew S,24,0,26,2
1657444123775,ECE 109,A01,091882,Touri; Behrouz,19,0,70,51
1657444129801,ECE 180,A00,083140,Abi Samra; Nicholas Camill,1,0,30,29
1657444129801,ECE 180,B00,083141,Abi Samra; Nicholas Camill,0,0,30,30
1657444135831,MATH 10A,A01,083735,Patchell; Gregory David,2,0,30,28
1657444135831,MATH 10A,A02,083736,Patchell; Gregory David,20,0,30,10
1657444135831,MATH 10A,A03,083737,Patchell; Gregory David,16,0,30,14
1657444141854,MATH 10B,A01,083207,Lim; Seonhee,8,0,34,26
1657444141854,MATH 10B,A02,083208,Lim; Seonhee,9,0,35,26
1657444141854,MATH 10B,A03,093472,Lim; Seonhee,7,0,34,27
1657444141854,MATH 10B,B01,083739,Sinha; Shubham,12,0,30,18
1657444147877,MATH 18,A01,083743,Cinel; Cameron Alexander,7,0,30,23
1657444147877,MATH 18,A02,083744,Cinel; Cameron Alexander,17,0,30,13
1657444147877,MATH 18,A03,083745,Cinel; Cameron Alexander,9,0,30,21
1657444147877,MATH 18,B01,083748,Rideout; David Porter,5,0,37,32
1657444147877,MATH 18,B02,083749,Rideout; David Porter,5,0,36,31
1657444147877,MATH 18,B03,083750,Rideout; David Porter,3,0,37,34
1657444147877,MATH 18,B04,083751,Rideout; David Porter,6,0,36,30
1657444147877,MATH 18,B05,093473,Rideout; David Porter,6,0,36,30
1657444147877,MATH 18,B06,093474,Rideout; David Porter,6,0,36,30
1657444153910,MATH 20A,A01,083754,Zheng; Zequn,14,0,40,26
1657444159939,MATH 20B,A01,083756,Briones; Jor-el Thomas Caparas,4,0,36,32
1657444159939,MATH 20B,A02,083757,Briones; Jor-el Thomas Caparas,1,0,36,35
1657444159939,MATH 20B,A03,093475,Briones; Jor-el Thomas Caparas,2,0,36,34
1657444165968,MATH 20C,A01,083760,Briones; Jor-el Thomas Caparas,1,0,35,34
1657444165968,MATH 20C,A02,083761,Briones; Jor-el Thomas Caparas,8,0,35,27
1657444165968,MATH 20C,A03,093476,Briones; Jor-el Thomas Caparas,0,1,36,36
1657444165968,MATH 20C,B01,083762,Bach; Quang Tran,1,0,30,29
1657444171992,MATH 20D,A01,083765,Tran; Brian Kha,5,0,30,25
1657444171992,MATH 20D,A02,083766,Tran; Brian Kha,5,0,30,25
1657444171992,MATH 20D,A03,083767,Tran; Brian Kha,5,0,30,25
1657444178019,MATH 20E,A01,083771,Ganguly; Soumya,9,0,32,23
1657444178019,MATH 20E,A02,083772,Ganguly; Soumya,6,0,32,26
1657444178019,MATH 20E,B01,083773,Ciotti; Benjamin,20,0,35,15
1657444178019,MATH 20E,B02,083774,Ciotti; Benjamin,17,0,35,18
1657444184047,MATH 103A,A01,083777,Greenfeld; Be'Eri,3,0,36,33
1657444184047,MATH 103A,A02,083778,Greenfeld; Be'Eri,5,0,36,31
1657444184047,MATH 103A,A03,093561,Greenfeld; Be'Eri,5,0,36,31
1657444184047,MATH 103A,B01,083779,Greenfeld; Be'Eri,7,0,36,29
1657444184047,MATH 103A,B02,083780,Greenfeld; Be'Eri,4,0,36,32
1657444184047,MATH 103A,B03,093562,Greenfeld; Be'Eri,3,0,36,33
1657444190075,MATH 105,A01,085443,Carter; Anne Toulson,15,0,35,20
1657444190075,MATH 105,A02,093477,Carter; Anne Toulson,20,0,35,15
1657444196101,MATH 109,A01,083213,Ganzberger; Geoffrey Michael,2,0,34,32
1657444196101,MATH 109,A02,083214,Ganzberger; Geoffrey Michael,4,0,34,30
1657444196101,MATH 109,A03,093478,Ganzberger; Geoffrey Michael,2,0,34,32
1657444196101,MATH 109,B01,083215,Ganzberger; Geoffrey Michael,1,0,32,31
1657444196101,MATH 109,B02,083216,Ganzberger; Geoffrey Michael,2,0,32,30
1657444196101,MATH 109,B03,093479,Ganzberger; Geoffrey Michael,8,0,32,24
1657444202128,MATH 142A,A01,083219,Chow; Bennett,7,0,32,25
1657444202128,MATH 142A,A02,083220,Chow; Bennett,10,0,32,22
1657444202128,MATH 142A,A03,093480,Chow; Bennett,8,0,32,24
1657444202128,MATH 142A,B03,093481,Chow; Bennett,8,0,32,24
1657444202128,MATH 142A,B04,093558,Chow; Bennett,13,0,32,19
1657444202128,MATH 142A,B05,093559,Chow; Bennett,6,0,32,26
1657444208249,MATH 193A,A01,083224,Rotar; Vladimir,8,0,34,26
1657444208249,MATH 193A,A02,083225,Rotar; Vladimir,9,0,34,25
1657444208249,MATH 193A,A03,083781,Rotar; Vladimir,5,0,34,29
1657444208249,MATH 193A,A04,083782,Rotar; Vladimir,10,0,34,24
1657444208249,MATH 193A,A05,093482,Rotar; Vladimir,10,0,34,24
1657444214272,MATH 197,001,091859,McAuley; Julian John,9999,0,9999,0
1657444214272,MATH 197,002,095566,Kedlaya; Kiran S.,9997,0,9999,2
1657444214272,MATH 197,003,095567,Xiao; Ming,9999,0,9999,0
1657444214272,MATH 197,004,095571,Perols; Johan Lars,9998,0,9999,1
1657444221324,COGS 9,A01,083615,Shannon; Kyle Michael,9,0,75,66
1657444227352,COGS 11,A01,083617,Boyle; Mary E. T.,22,0,48,26
1657444233379,COGS 13,A01,083071,Bastos; Amalia Pinkusfeld,11,0,71,60
1657444239406,COGS 14A,A01,092681,Semenuks; Arturs,5,1,100,95
1657444245436,COGS 14B,A01,083073,Cheng; Tzu-Han,6,0,63,57
1657444251458,COGS 17,A01,092677,Semenuks; Arturs,6,0,81,75
1657444257485,COGS 100,A01,083619,Allen; Michael Gordon,17,0,70,53
1657444263507,COGS 101A,A01,083621,Davis; Joshua Daniel,9,0,68,59
1657444269533,COGS 101B,A01,091572,Allen; Michael Gordon,12,0,65,53
1657444275560,COGS 101C,A01,083625,Delgado; Tania,17,0,35,18
1657444281587,COGS 107A,A01,083627,Boyle; Mary E. T.,13,0,60,47
1657444287610,COGS 118A,A01,083075,Gupta; Anjum,21,0,76,55
1657444293634,CSE 3,A50,083646,Miranda; Gregory Joseph,24,0,50,26
1657444299661,CSE 8A,A50,083650,Miranda; Gregory Joseph,17,1,56,39
1657444305684,CSE 11,A01,083080,Cao; Yingjun,6,15,40,34
1657444311710,CSE 12,A01,083652,Krause-Levy; Sophia Louisa,28,1,120,92
1657444317734,CSE 15L,A01,083654,Morris; Justin Loren,9,0,50,41
1657444317734,CSE 15L,A02,083655,Morris; Justin Loren,9,0,50,41
1657444323757,CSE 20,A01,083657,Tran; Khoa Dang,39,0,80,41
1657444329781,CSE 21,A01,095574,Bach; Quang Tran,22,0,48,26
1657444335804,CSE 30,A01,083084,Eldon; John,5,0,80,75
1657444335804,CSE 30,B01,095061,Bhaskar; Nishant,9,0,50,41
1657444341831,CSE 100,A01,083659,Cao; Yingjun,5,4,70,65
1657444347857,CSE 134B,A01,083661,Powell; Thomas Allan,22,0,100,78
1657444353884,CSE 140,A01,083663,Gungor; Onat,15,0,85,70
1657444359908,CSE 140L,A01,083088,Eldon; John,21,0,100,79
1657444365931,CSE 175,A01,083665,Kumar; Rakesh,3,0,25,22
1657444371957,CSE 190,A00,092507,Dubnov; Shlomo,8,0,20,12
1657444377983,ECE 45,A01,083139,Congero; Spencer William,6,0,75,69
1657444384006,ECE 65,A50,083695,Saad; Andrew S,12,0,30,18
1657444384006,ECE 65,A51,095125,Saad; Andrew S,24,0,26,2
1657444390029,ECE 109,A01,091882,Touri; Behrouz,19,0,70,51
1657444396052,ECE 180,A00,083140,Abi Samra; Nicholas Camill,1,0,30,29
1657444396052,ECE 180,B00,083141,Abi Samra; Nicholas Camill,0,0,30,30
1657444402099,MATH 10A,A01,083735,Patchell; Gregory David,2,0,30,28
1657444402099,MATH 10A,A02,083736,Patchell; Gregory David,20,0,30,10
1657444402099,MATH 10A,A03,083737,Patchell; Gregory David,16,0,30,14
1657444408123,MATH 10B,A01,083207,Lim; Seonhee,8,0,34,26
1657444408123,MATH 10B,A02,083208,Lim; Seonhee,9,0,35,26
1657444408123,MATH 10B,A03,093472,Lim; Seonhee,7,0,34,27
1657444408123,MATH 10B,B01,083739,Sinha; Shubham,12,0,30,18
1657444414155,MATH 18,A01,083743,Cinel; Cameron Alexander,7,0,30,23
1657444414155,MATH 18,A02,083744,Cinel; Cameron Alexander,17,0,30,13
1657444414155,MATH 18,A03,083745,Cinel; Cameron Alexander,9,0,30,21
1657444414155,MATH 18,B01,083748,Rideout; David Porter,5,0,37,32
1657444414155,MATH 18,B02,083749,Rideout; David Porter,5,0,36,31
1657444414155,MATH 18,B03,083750,Rideout; David Porter,3,0,37,34
1657444414155,MATH 18,B04,083751,Rideout; David Porter,6,0,36,30
1657444414155,MATH 18,B05,093473,Rideout; David Porter,6,0,36,30
1657444414155,MATH 18,B06,093474,Rideout; David Porter,6,0,36,30
1657444420183,MATH 20A,A01,083754,Zheng; Zequn,14,0,40,26
1657444426207,MATH 20B,A01,083756,Briones; Jor-el Thomas Caparas,4,0,36,32
1657444426207,MATH 20B,A02,083757,Briones; Jor-el Thomas Caparas,1,0,36,35
1657444426207,MATH 20B,A03,093475,Briones; Jor-el Thomas Caparas,2,0,36,34
1657444432230,MATH 20C,A01,083760,Briones; Jor-el Thomas Caparas,1,0,35,34
1657444432230,MATH 20C,A02,083761,Briones; Jor-el Thomas Caparas,8,0,35,27
1657444432230,MATH 20C,A03,093476,Briones; Jor-el Thomas Caparas,0,1,36,36
1657444432230,MATH 20C,B01,083762,Bach; Quang Tran,1,0,30,29
1657444438252,MATH 20D,A01,083765,Tran; Brian Kha,5,0,30,25
1657444438252,MATH 20D,A02,083766,Tran; Brian Kha,5,0,30,25
1657444438252,MATH 20D,A03,083767,Tran; Brian Kha,5,0,30,25
1657444444274,MATH 20E,A01,083771,Ganguly; Soumya,9,0,32,23
1657444444274,MATH 20E,A02,083772,Ganguly; Soumya,6,0,32,26
1657444444274,MATH 20E,B01,083773,Ciotti; Benjamin,20,0,35,15
1657444444274,MATH 20E,B02,083774,Ciotti; Benjamin,17,0,35,18
1657444450298,MATH 103A,A01,083777,Greenfeld; Be'Eri,3,0,36,33
1657444450298,MATH 103A,A02,083778,Greenfeld; Be'Eri,5,0,36,31
1657444450298,MATH 103A,A03,093561,Greenfeld; Be'Eri,5,0,36,31
1657444450298,MATH 103A,B01,083779,Greenfeld; Be'Eri,7,0,36,29
1657444450298,MATH 103A,B02,083780,Greenfeld; Be'Eri,4,0,36,32
1657444450298,MATH 103A,B03,093562,Greenfeld; Be'Eri,3,0,36,33
1657444456322,MATH 105,A01,085443,Carter; Anne Toulson,15,0,35,20
1657444456322,MATH 105,A02,093477,Carter; Anne Toulson,20,0,35,15
1657444462347,MATH 109,A01,083213,Ganzberger; Geoffrey Michael,2,0,34,32
1657444462347,MATH 109,A02,083214,Ganzberger; Geoffrey Michael,4,0,34,30
1657444462347,MATH 109,A03,093478,Ganzberger; Geoffrey Michael,2,0,34,32
1657444462347,MATH 109,B01,083215,Ganzberger; Geoffrey Michael,1,0,32,31
1657444462347,MATH 109,B02,083216,Ganzberger; Geoffrey Michael,2,0,32,30
1657444462347,MATH 109,B03,093479,Ganzberger; Geoffrey Michael,8,0,32,24
1657444468369,MATH 142A,A01,083219,Chow; Bennett,7,0,32,25
1657444468369,MATH 142A,A02,083220,Chow; Bennett,10,0,32,22
1657444468369,MATH 142A,A03,093480,Chow; Bennett,8,0,32,24
1657444468369,MATH 142A,B03,093481,Chow; Bennett,8,0,32,24
1657444468369,MATH 142A,B04,093558,Chow; Bennett,13,0,32,19
1657444468369,MATH 142A,B05,093559,Chow; Bennett,6,0,32,26
1657444474394,MATH 193A,A01,083224,Rotar; Vladimir,8,0,34,26
1657444474394,MATH 193A,A02,083225,Rotar; Vladimir,9,0,34,25
1657444474394,MATH 193A,A03,083781,Rotar; Vladimir,5,0,34,29
1657444474394,MATH 193A,A04,083782,Rotar; Vladimir,10,0,34,24
1657444474394,MATH 193A,A05,093482,Rotar; Vladimir,10,0,34,24
1657444480416,MATH 197,001,091859,McAuley; Julian John,9999,0,9999,0
1657444480416,MATH 197,002,095566,Kedlaya; Kiran S.,9997,0,9999,2
1657444480416,MATH 197,003,095567,Xiao; Ming,9999,0,9999,0
1657444480416,MATH 197,004,095571,Perols; Johan Lars,9998,0,9999,1
1657444487476,COGS 9,A01,083615,Shannon; Kyle Michael,9,0,75,66
1657444493506,COGS 11,A01,083617,Boyle; Mary E. T.,22,0,48,26
1657444499532,COGS 13,A01,083071,Bastos; Amalia Pinkusfeld,11,0,71,60
1657444505555,COGS 14A,A01,092681,Semenuks; Arturs,5,1,100,95
1657444511581,COGS 14B,A01,083073,Cheng; Tzu-Han,6,0,63,57
1657444517603,COGS 17,A01,092677,Semenuks; Arturs,6,0,81,75
1657444523633,COGS 100,A01,083619,Allen; Michael Gordon,17,0,70,53
1657444529656,COGS 101A,A01,083621,Davis; Joshua Daniel,9,0,68,59
1657444535680,COGS 101B,A01,091572,Allen; Michael Gordon,12,0,65,53
1657444541706,COGS 101C,A01,083625,Delgado; Tania,17,0,35,18
1657444547729,COGS 107A,A01,083627,Boyle; Mary E. T.,13,0,60,47
1657444553757,COGS 118A,A01,083075,Gupta; Anjum,21,0,76,55
1657444559786,CSE 3,A50,083646,Miranda; Gregory Joseph,24,0,50,26
1657444565809,CSE 8A,A50,083650,Miranda; Gregory Joseph,17,1,56,39
1657444571836,CSE 11,A01,083080,Cao; Yingjun,6,15,40,34
1657444577859,CSE 12,A01,083652,Krause-Levy; Sophia Louisa,28,1,120,92
1657444583886,CSE 15L,A01,083654,Morris; Justin Loren,9,0,50,41
1657444583886,CSE 15L,A02,083655,Morris; Justin Loren,9,0,50,41
1657444589909,CSE 20,A01,083657,Tran; Khoa Dang,39,0,80,41
1657444595933,CSE 21,A01,095574,Bach; Quang Tran,22,0,48,26
1657444601956,CSE 30,A01,083084,Eldon; John,5,0,80,75
1657444601956,CSE 30,B01,095061,Bhaskar; Nishant,9,0,50,41
1657444607986,CSE 100,A01,083659,Cao; Yingjun,5,4,70,65
1657444614011,CSE 134B,A01,083661,Powell; Thomas Allan,22,0,100,78
1657444620036,CSE 140,A01,083663,Gungor; Onat,15,0,85,70
1657444626060,CSE 140L,A01,083088,Eldon; John,21,0,100,79
1657444632087,CSE 175,A01,083665,Kumar; Rakesh,3,0,25,22
1657444638114,CSE 190,A00,092507,Dubnov; Shlomo,8,0,20,12
1657444644141,ECE 45,A01,083139,Congero; Spencer William,6,0,75,69
1657444650166,ECE 65,A50,083695,Saad; Andrew S,12,0,30,18
1657444650166,ECE 65,A51,095125,Saad; Andrew S,24,0,26,2
1657444656191,ECE 109,A01,091882,Touri; Behrouz,19,0,70,51
1657444662214,ECE 180,A00,083140,Abi Samra; Nicholas Camill,1,0,30,29
1657444662214,ECE 180,B00,083141,Abi Samra; Nicholas Camill,0,0,30,30
1657444668238,MATH 10A,A01,083735,Patchell; Gregory David,2,0,30,28
1657444668238,MATH 10A,A02,083736,Patchell; Gregory David,20,0,30,10
1657444668238,MATH 10A,A03,083737,Patchell; Gregory David,16,0,30,14
1657444674263,MATH 10B,A01,083207,Lim; Seonhee,8,0,34,26
1657444674263,MATH 10B,A02,083208,Lim; Seonhee,9,0,35,26
1657444674263,MATH 10B,A03,093472,Lim; Seonhee,7,0,34,27
1657444674263,MATH 10B,B01,083739,Sinha; Shubham,12,0,30,18
1657444680287,MATH 18,A01,083743,Cinel; Cameron Alexander,7,0,30,23
1657444680287,MATH 18,A02,083744,Cinel; Cameron Alexander,17,0,30,13
1657444680287,MATH 18,A03,083745,Cinel; Cameron Alexander,9,0,30,21
1657444680287,MATH 18,B01,083748,Rideout; David Porter,5,0,37,32
1657444680287,MATH 18,B02,083749,Rideout; David Porter,5,0,36,31
1657444680287,MATH 18,B03,083750,Rideout; David Porter,3,0,37,34
1657444680287,MATH 18,B04,083751,Rideout; David Porter,6,0,36,30
1657444680287,MATH 18,B05,093473,Rideout; David Porter,6,0,36,30
1657444680287,MATH 18,B06,093474,Rideout; David Porter,6,0,36,30
1657444686311,MATH 20A,A01,083754,Zheng; Zequn,14,0,40,26
1657444692333,MATH 20B,A01,083756,Briones; Jor-el Thomas Caparas,4,0,36,32
1657444692333,MATH 20B,A02,083757,Briones; Jor-el Thomas Caparas,1,0,36,35
1657444692333,MATH 20B,A03,093475,Briones; Jor-el Thomas Caparas,2,0,36,34
1657444698365,MATH 20C,A01,083760,Briones; Jor-el Thomas Caparas,1,0,35,34
1657444698365,MATH 20C,A02,083761,Briones; Jor-el Thomas Caparas,8,0,35,27
1657444698365,MATH 20C,A03,093476,Briones; Jor-el Thomas Caparas,0,1,36,36
1657444698365,MATH 20C,B01,083762,Bach; Quang Tran,1,0,30,29
1657444704402,MATH 20D,A01,083765,Tran; Brian Kha,5,0,30,25
1657444704402,MATH 20D,A02,083766,Tran; Brian Kha,5,0,30,25
1657444704402,MATH 20D,A03,083767,Tran; Brian Kha,5,0,30,25
1657444710426,MATH 20E,A01,083771,Ganguly; Soumya,9,0,32,23
1657444710426,MATH 20E,A02,083772,Ganguly; Soumya,6,0,32,26
1657444710426,MATH 20E,B01,083773,Ciotti; Benjamin,20,0,35,15
1657444710426,MATH 20E,B02,083774,Ciotti; Benjamin,17,0,35,18
1657444716448,MATH 103A,A01,083777,Greenfeld; Be'Eri,3,0,36,33
1657444716448,MATH 103A,A02,083778,Greenfeld; Be'Eri,5,0,36,31
1657444716448,MATH 103A,A03,093561,Greenfeld; Be'Eri,5,0,36,31
1657444716448,MATH 103A,B01,083779,Greenfeld; Be'Eri,7,0,36,29
1657444716448,MATH 103A,B02,083780,Greenfeld; Be'Eri,4,0,36,32
1657444716448,MATH 103A,B03,093562,Greenfeld; Be'Eri,3,0,36,33
1657444722470,MATH 105,A01,085443,Carter; Anne Toulson,15,0,35,20
1657444722470,MATH 105,A02,093477,Carter; Anne Toulson,20,0,35,15
1657444728499,MATH 109,A01,083213,Ganzberger; Geoffrey Michael,2,0,34,32
1657444728499,MATH 109,A02,083214,Ganzberger; Geoffrey Michael,4,0,34,30
1657444728499,MATH 109,A03,093478,Ganzberger; Geoffrey Michael,2,0,34,32
1657444728499,MATH 109,B01,083215,Ganzberger; Geoffrey Michael,1,0,32,31
1657444728499,MATH 109,B02,083216,Ganzberger; Geoffrey Michael,2,0,32,30
1657444728499,MATH 109,B03,093479,Ganzberger; Geoffrey Michael,8,0,32,24
1657444734522,MATH 142A,A01,083219,Chow; Bennett,7,0,32,25
1657444734522,MATH 142A,A02,083220,Chow; Bennett,10,0,32,22
1657444734522,MATH 142A,A03,093480,Chow; Bennett,8,0,32,24
1657444734522,MATH 142A,B03,093481,Chow; Bennett,8,0,32,24
1657444734522,MATH 142A,B04,093558,Chow; Bennett,13,0,32,19
1657444734522,MATH 142A,B05,093559,Chow; Bennett,6,0,32,26
1657444740553,MATH 193A,A01,083224,Rotar; Vladimir,8,0,34,26
1657444740553,MATH 193A,A02,083225,Rotar; Vladimir,9,0,34,25
1657444740553,MATH 193A,A03,083781,Rotar; Vladimir,5,0,34,29
1657444740553,MATH 193A,A04,083782,Rotar; Vladimir,10,0,34,24
1657444740553,MATH 193A,A05,093482,Rotar; Vladimir,10,0,34,24
1657444746578,MATH 197,001,091859,McAuley; Julian John,9999,0,9999,0
1657444746578,MATH 197,002,095566,Kedlaya; Kiran S.,9997,0,9999,2
1657444746578,MATH 197,003,095567,Xiao; Ming,9999,0,9999,0
1657444746578,MATH 197,004,095571,Perols; Johan Lars,9998,0,9999,1
1657444753642,COGS 9,A01,083615,Shannon; Kyle Michael,9,0,75,66
1657444759666,COGS 11,A01,083617,Boyle; Mary E. T.,22,0,48,26
1657444765691,COGS 13,A01,083071,Bastos; Amalia Pinkusfeld,11,0,71,60
1657444771714,COGS 14A,A01,092681,Semenuks; Arturs,5,1,100,95
1657444777736,COGS 14B,A01,083073,Cheng; Tzu-Han,6,0,63,57
1657444783758,COGS 17,A01,092677,Semenuks; Arturs,6,0,81,75
1657444789780,COGS 100,A01,083619,Allen; Michael Gordon,17,0,70,53
1657444795801,COGS 101A,A01,083621,Davis; Joshua Daniel,9,0,68,59
1657444801926,COGS 101B,A01,091572,Allen; Michael Gordon,12,0,65,53
1657444807953,COGS 101C,A01,083625,Delgado; Tania,17,0,35,18
1657444813975,COGS 107A,A01,083627,Boyle; Mary E. T.,13,0,60,47
1657444819998,COGS 118A,A01,083075,Gupta; Anjum,21,0,76,55
1657444826020,CSE 3,A50,083646,Miranda; Gregory Joseph,24,0,50,26
1657444832048,CSE 8A,A50,083650,Miranda; Gregory Joseph,17,1,56,39
1657444838071,CSE 11,A01,083080,Cao; Yingjun,6,15,40,34
1657444844094,CSE 12,A01,083652,Krause-Levy; Sophia Louisa,28,1,120,92
1657444850118,CSE 15L,A01,083654,Morris; Justin Loren,9,0,50,41
1657444850118,CSE 15L,A02,083655,Morris; Justin Loren,9,0,50,41
1657444856145,CSE 20,A01,083657,Tran; Khoa Dang,39,0,80,41
1657444862172,CSE 21,A01,095574,Bach; Quang Tran,22,0,48,26
1657444868198,CSE 30,A01,083084,Eldon; John,5,0,80,75
1657444868198,CSE 30,B01,095061,Bhaskar; Nishant,9,0,50,41
1657444874224,CSE 100,A01,083659,Cao; Yingjun,5,4,70,65
1657444880248,CSE 134B,A01,083661,Powell; Thomas Allan,22,0,100,78
1657444886270,CSE 140,A01,083663,Gungor; Onat,15,0,85,70
1657444892293,CSE 140L,A01,083088,Eldon; John,21,0,100,79
1657444898316,CSE 175,A01,083665,Kumar; Rakesh,3,0,25,22
1657444904343,CSE 190,A00,092507,Dubnov; Shlomo,8,0,20,12
1657444910371,ECE 45,A01,083139,Congero; Spencer William,6,0,75,69
1657444916393,ECE 65,A50,083695,Saad; Andrew S,12,0,30,18
1657444916393,ECE 65,A51,095125,Saad; Andrew S,24,0,26,2
1657444922427,ECE 109,A01,091882,Touri; Behrouz,19,0,70,51
1657444928450,ECE 180,A00,083140,Abi Samra; Nicholas Camill,1,0,30,29
1657444928450,ECE 180,B00,083141,Abi Samra; Nicholas Camill,0,0,30,30
1657444934474,MATH 10A,A01,083735,Patchell; Gregory David,2,0,30,28
1657444934474,MATH 10A,A02,083736,Patchell; Gregory David,20,0,30,10
1657444934474,MATH 10A,A03,083737,Patchell; Gregory David,16,0,30,14
1657444940499,MATH 10B,A01,083207,Lim; Seonhee,8,0,34,26
1657444940499,MATH 10B,A02,083208,Lim; Seonhee,9,0,35,26
1657444940499,MATH 10B,A03,093472,Lim; Seonhee,7,0,34,27
1657444940499,MATH 10B,B01,083739,Sinha; Shubham,12,0,30,18
1657444946524,MATH 18,A01,083743,Cinel; Cameron Alexander,7,0,30,23
1657444946524,MATH 18,A02,083744,Cinel; Cameron Alexander,17,0,30,13
1657444946524,MATH 18,A03,083745,Cinel; Cameron Alexander,9,0,30,21
1657444946524,MATH 18,B01,083748,Rideout; David Porter,5,0,37,32
1657444946524,MATH 18,B02,083749,Rideout; David Porter,5,0,36,31
1657444946524,MATH 18,B03,083750,Rideout; David Porter,3,0,37,34
1657444946524,MATH 18,B04,083751,Rideout; David Porter,6,0,36,30
1657444946524,MATH 18,B05,093473,Rideout; David Porter,6,0,36,30
1657444946524,MATH 18,B06,093474,Rideout; David Porter,6,0,36,30
1657444952551,MATH 20A,A01,083754,Zheng; Zequn,14,0,40,26
1657444958577,MATH 20B,A01,083756,Briones; Jor-el Thomas Caparas,4,0,36,32
1657444958577,MATH 20B,A02,083757,Briones; Jor-el Thomas Caparas,1,0,36,35
1657444958577,MATH 20B,A03,093475,Briones; Jor-el Thomas Caparas,2,0,36,34
1657444964620,MATH 20C,A01,083760,Briones; Jor-el Thomas Caparas,1,0,35,34
1657444964620,MATH 20C,A02,083761,Briones; Jor-el Thomas Caparas,8,0,35,27
1657444964620,MATH 20C,A03,093476,Briones; Jor-el Thomas Caparas,0,1,36,36
1657444964620,MATH 20C,B01,083762,Bach; Quang Tran,1,0,30,29
1657444970644,MATH 20D,A01,083765,Tran; Brian Kha,5,0,30,25
1657444970644,MATH 20D,A02,083766,Tran; Brian Kha,5,0,30,25
1657444970644,MATH 20D,A03,083767,Tran; Brian Kha,5,0,30,25
1657444976665,MATH 20E,A01,083771,Ganguly; Soumya,9,0,32,23
1657444976665,MATH 20E,A02,083772,Ganguly; Soumya,6,0,32,26
1657444976665,MATH 20E,B01,083773,Ciotti; Benjamin,20,0,35,15
1657444976665,MATH 20E,B02,083774,Ciotti; Benjamin,17,0,35,18
1657444982687,MATH 103A,A01,083777,Greenfeld; Be'Eri,3,0,36,33
1657444982687,MATH 103A,A02,083778,Greenfeld; Be'Eri,5,0,36,31
1657444982687,MATH 103A,A03,093561,Greenfeld; Be'Eri,5,0,36,31
1657444982687,MATH 103A,B01,083779,Greenfeld; Be'Eri,7,0,36,29
1657444982687,MATH 103A,B02,083780,Greenfeld; Be'Eri,4,0,36,32
1657444982687,MATH 103A,B03,093562,Greenfeld; Be'Eri,3,0,36,33
1657444988709,MATH 105,A01,085443,Carter; Anne Toulson,15,0,35,20
1657444988709,MATH 105,A02,093477,Carter; Anne Toulson,20,0,35,15
1657444994737,MATH 109,A01,083213,Ganzberger; Geoffrey Michael,2,0,34,32
1657444994737,MATH 109,A02,083214,Ganzberger; Geoffrey Michael,4,0,34,30
1657444994737,MATH 109,A03,093478,Ganzberger; Geoffrey Michael,2,0,34,32
1657444994737,MATH 109,B01,083215,Ganzberger; Geoffrey Michael,1,0,32,31
1657444994737,MATH 109,B02,083216,Ganzberger; Geoffrey Michael,2,0,32,30
1657444994737,MATH 109,B03,093479,Ganzberger; Geoffrey Michael,8,0,32,24
1657445000760,MATH 142A,A01,083219,Chow; Bennett,7,0,32,25
1657445000760,MATH 142A,A02,083220,Chow; Bennett,10,0,32,22
1657445000760,MATH 142A,A03,093480,Chow; Bennett,8,0,32,24
1657445000760,MATH 142A,B03,093481,Chow; Bennett,8,0,32,24
1657445000760,MATH 142A,B04,093558,Chow; Bennett,13,0,32,19
1657445000760,MATH 142A,B05,093559,Chow; Bennett,6,0,32,26
1657445006789,MATH 193A,A01,083224,Rotar; Vladimir,8,0,34,26
1657445006789,MATH 193A,A02,083225,Rotar; Vladimir,9,0,34,25
1657445006789,MATH 193A,A03,083781,Rotar; Vladimir,5,0,34,29
1657445006789,MATH 193A,A04,083782,Rotar; Vladimir,10,0,34,24
1657445006789,MATH 193A,A05,093482,Rotar; Vladimir,10,0,34,24
1657445012814,MATH 197,001,091859,McAuley; Julian John,9999,0,9999,0
1657445012814,MATH 197,002,095566,Kedlaya; Kiran S.,9997,0,9999,2
1657445012814,MATH 197,003,095567,Xiao; Ming,9999,0,9999,0
1657445012814,MATH 197,004,095571,Perols; Johan Lars,9998,0,9999,1
1657445019880,COGS 9,A01,083615,Shannon; Kyle Michael,9,0,75,66
1657445025904,COGS 11,A01,083617,Boyle; Mary E. T.,22,0,48,26
1657445031925,COGS 13,A01,083071,Bastos; Amalia Pinkusfeld,11,0,71,60
1657445037951,COGS 14A,A01,092681,Semenuks; Arturs,5,1,100,95
1657445043977,COGS 14B,A01,083073,Cheng; Tzu-Han,6,0,63,57
1657445050000,COGS 17,A01,092677,Semenuks; Arturs,6,0,81,75
1657445056024,COGS 100,A01,083619,Allen; Michael Gordon,17,0,70,53
1657445062048,COGS 101A,A01,083621,Davis; Joshua Daniel,9,0,68,59
1657445068072,COGS 101B,A01,091572,Allen; Michael Gordon,12,0,65,53
1657445074095,COGS 101C,A01,083625,Delgado; Tania,17,0,35,18
1657445080122,COGS 107A,A01,083627,Boyle; Mary E. T.,13,0,60,47
1657445086151,COGS 118A,A01,083075,Gupta; Anjum,21,0,76,55
1657445092178,CSE 3,A50,083646,Miranda; Gregory Joseph,24,0,50,26
1657445098206,CSE 8A,A50,083650,Miranda; Gregory Joseph,17,1,56,39
1657445104233,CSE 11,A01,083080,Cao; Yingjun,6,15,40,34
1657445110254,CSE 12,A01,083652,Krause-Levy; Sophia Louisa,28,1,120,92
1657445116281,CSE 15L,A01,083654,Morris; Justin Loren,9,0,50,41
1657445116281,CSE 15L,A02,083655,Morris; Justin Loren,9,0,50,41
1657445122308,CSE 20,A01,083657,Tran; Khoa Dang,39,0,80,41
1657445128332,CSE 21,A01,095574,Bach; Quang Tran,22,0,48,26
1657445134356,CSE 30,A01,083084,Eldon; John,5,0,80,75
1657445134356,CSE 30,B01,095061,Bhaskar; Nishant,9,0,50,41
1657445140383,CSE 100,A01,083659,Cao; Yingjun,5,4,70,65
1657445146412,CSE 134B,A01,083661,Powell; Thomas Allan,22,0,100,78
1657445152435,CSE 140,A01,083663,Gungor; Onat,15,0,85,70
1657445158457,CSE 140L,A01,083088,Eldon; John,21,0,100,79
1657445164480,CSE 175,A01,083665,Kumar; Rakesh,3,0,25,22
1657445170506,CSE 190,A00,092507,Dubnov; Shlomo,8,0,20,12
1657445176529,ECE 45,A01,083139,Congero; Spencer William,6,0,75,69
1657445182553,ECE 65,A50,083695,Saad; Andrew S,12,0,30,18
1657445182553,ECE 65,A51,095125,Saad; Andrew S,24,0,26,2
1657445188580,ECE 109,A01,091882,Touri; Behrouz,19,0,70,51
1657445194604,ECE 180,A00,083140,Abi Samra; Nicholas Camill,1,0,30,29
1657445194604,ECE 180,B00,083141,Abi Samra; Nicholas Camill,0,0,30,30
1657445200630,MATH 10A,A01,083735,Patchell; Gregory David,2,0,30,28
1657445200630,MATH 10A,A02,083736,Patchell; Gregory David,20,0,30,10
1657445200630,MATH 10A,A03,083737,Patchell; Gregory David,16,0,30,14
1657445206652,MATH 10B,A01,083207,Lim; Seonhee,8,0,34,26
1657445206652,MATH 10B,A02,083208,Lim; Seonhee,9,0,35,26
1657445206652,MATH 10B,A03,093472,Lim; Seonhee,7,0,34,27
1657445206652,MATH 10B,B01,083739,Sinha; Shubham,12,0,30,18
1657445212674,MATH 18,A01,083743,Cinel; Cameron Alexander,7,0,30,23
1657445212674,MATH 18,A02,083744,Cinel; Cameron Alexander,17,0,30,13
1657445212674,MATH 18,A03,083745,Cinel; Cameron Alexander,9,0,30,21
1657445212674,MATH 18,B01,083748,Rideout; David Porter,5,0,37,32
1657445212674,MATH 18,B02,083749,Rideout; David Porter,5,0,36,31
1657445212674,MATH 18,B03,083750,Rideout; David Porter,3,0,37,34
1657445212674,MATH 18,B04,083751,Rideout; David Porter,6,0,36,30
1657445212674,MATH 18,B05,093473,Rideout; David Porter,6,0,36,30
1657445212674,MATH 18,B06,093474,Rideout; David Porter,6,0,36,30
1657445218699,MATH 20A,A01,083754,Zheng; Zequn,14,0,40,26
1657445224734,MATH 20B,A01,083756,Briones; Jor-el Thomas Caparas,4,0,36,32
1657445224734,MATH 20B,A02,083757,Briones; Jor-el Thomas Caparas,1,0,36,35
1657445224734,MATH 20B,A03,093475,Briones; Jor-el Thomas Caparas,2,0,36,34
1657445230763,MATH 20C,A01,083760,Briones; Jor-el Thomas Caparas,1,0,35,34
1657445230763,MATH 20C,A02,083761,Briones; Jor-el Thomas Caparas,8,0,35,27
1657445230763,MATH 20C,A03,093476,Briones; Jor-el Thomas Caparas,0,1,36,36
1657445230763,MATH 20C,B01,083762,Bach; Quang Tran,1,0,30,29
1657445236785,MATH 20D,A01,083765,Tran; Brian Kha,5,0,30,25
1657445236785,MATH 20D,A02,083766,Tran; Brian Kha,5,0,30,25
1657445236785,MATH 20D,A03,083767,Tran; Brian Kha,5,0,30,25
1657445242807,MATH 20E,A01,083771,Ganguly; Soumya,9,0,32,23
1657445242807,MATH 20E,A02,083772,Ganguly; Soumya,6,0,32,26
1657445242807,MATH 20E,B01,083773,Ciotti; Benjamin,20,0,35,15
1657445242807,MATH 20E,B02,083774,Ciotti; Benjamin,17,0,35,18
1657445248835,MATH 103A,A01,083777,Greenfeld; Be'Eri,3,0,36,33
1657445248835,MATH 103A,A02,083778,Greenfeld; Be'Eri,5,0,36,31
1657445248835,MATH 103A,A03,093561,Greenfeld; Be'Eri,5,0,36,31
1657445248835,MATH 103A,B01,083779,Greenfeld; Be'Eri,7,0,36,29
1657445248835,MATH 103A,B02,083780,Greenfeld; Be'Eri,4,0,36,32
1657445248835,MATH 103A,B03,093562,Greenfeld; Be'Eri,3,0,36,33
1657445254866,MATH 105,A01,085443,Carter; Anne Toulson,15,0,35,20
1657445254866,MATH 105,A02,093477,Carter; Anne Toulson,20,0,35,15
1657445260891,MATH 109,A01,083213,Ganzberger; Geoffrey Michael,2,0,34,32
1657445260891,MATH 109,A02,083214,Ganzberger; Geoffrey Michael,4,0,34,30
1657445260891,MATH 109,A03,093478,Ganzberger; Geoffrey Michael,2,0,34,32
1657445260891,MATH 109,B01,083215,Ganzberger; Geoffrey Michael,1,0,32,31
1657445260891,MATH 109,B02,083216,Ganzberger; Geoffrey Michael,2,0,32,30
1657445260891,MATH 109,B03,093479,Ganzberger; Geoffrey Michael,8,0,32,24
1657445266915,MATH 142A,A01,083219,Chow; Bennett,7,0,32,25
1657445266915,MATH 142A,A02,083220,Chow; Bennett,10,0,32,22
1657445266915,MATH 142A,A03,093480,Chow; Bennett,8,0,32,24
1657445266915,MATH 142A,B03,093481,Chow; Bennett,8,0,32,24
1657445266915,MATH 142A,B04,093558,Chow; Bennett,13,0,32,19
1657445266915,MATH 142A,B05,093559,Chow; Bennett,6,0,32,26
1657445272942,MATH 193A,A01,083224,Rotar; Vladimir,8,0,34,26
1657445272942,MATH 193A,A02,083225,Rotar; Vladimir,9,0,34,25
1657445272942,MATH 193A,A03,083781,Rotar; Vladimir,5,0,34,29
1657445272942,MATH 193A,A04,083782,Rotar; Vladimir,10,0,34,24
1657445272942,MATH 193A,A05,093482,Rotar; Vladimir,10,0,34,24
1657445278964,MATH 197,001,091859,McAuley; Julian John,9999,0,9999,0
1657445278964,MATH 197,002,095566,Kedlaya; Kiran S.,9997,0,9999,2
1657445278964,MATH 197,003,095567,Xiao; Ming,9999,0,9999,0
1657445278964,MATH 197,004,095571,Perols; Johan Lars,9998,0,9999,1
1657445286051,COGS 9,A01,083615,Shannon; Kyle Michael,9,0,75,66
1657445292078,COGS 11,A01,083617,Boyle; Mary E. T.,22,0,48,26
1657445298106,COGS 13,A01,083071,Bastos; Amalia Pinkusfeld,11,0,71,60
1657445304128,COGS 14A,A01,092681,Semenuks; Arturs,5,1,100,95
1657445310156,COGS 14B,A01,083073,Cheng; Tzu-Han,6,0,63,57
1657445316182,COGS 17,A01,092677,Semenuks; Arturs,6,0,81,75
1657445322207,COGS 100,A01,083619,Allen; Michael Gordon,17,0,70,53
1657445328229,COGS 101A,A01,083621,Davis; Joshua Daniel,9,0,68,59
1657445334252,COGS 101B,A01,091572,Allen; Michael Gordon,12,0,65,53
1657445340289,COGS 101C,A01,083625,Delgado; Tania,17,0,35,18
1657445346312,COGS 107A,A01,083627,Boyle; Mary E. T.,13,0,60,47
1657445352337,COGS 118A,A01,083075,Gupta; Anjum,21,0,76,55
1657445358360,CSE 3,A50,083646,Miranda; Gregory Joseph,24,0,50,26
1657445364381,CSE 8A,A50,083650,Miranda; Gregory Joseph,17,1,56,39
1657445370409,CSE 11,A01,083080,Cao; Yingjun,6,15,40,34
1657445376435,CSE 12,A01,083652,Krause-Levy; Sophia Louisa,28,1,120,92
1657445382457,CSE 15L,A01,083654,Morris; Justin Loren,9,0,50,41
1657445382457,CSE 15L,A02,083655,Morris; Justin Loren,9,0,50,41
1657445388489,CSE 20,A01,083657,Tran; Khoa Dang,39,0,80,41
1657445394523,CSE 21,A01,095574,Bach; Quang Tran,22,0,48,26
1657445400621,CSE 30,A01,083084,Eldon; John,5,0,80,75
1657445400621,CSE 30,B01,095061,Bhaskar; Nishant,9,0,50,41
1657445406646,CSE 100,A01,083659,Cao; Yingjun,5,4,70,65
1657445412668,CSE 134B,A01,083661,Powell; Thomas Allan,22,0,100,78
1657445418695,CSE 140,A01,083663,Gungor; Onat,15,0,85,70
1657445424721,CSE 140L,A01,083088,Eldon; John,21,0,100,79
1657445430744,CSE 175,A01,083665,Kumar; Rakesh,3,0,25,22
1657445436768,CSE 190,A00,092507,Dubnov; Shlomo,8,0,20,12
1657445442807,ECE 45,A01,083139,Congero; Spencer William,6,0,75,69
1657445448838,ECE 65,A50,083695,Saad; Andrew S,12,0,30,18
1657445448838,ECE 65,A51,095125,Saad; Andrew S,24,0,26,2
1657445454872,ECE 109,A01,091882,Touri; Behrouz,19,0,70,51
1657445460899,ECE 180,A00,083140,Abi Samra; Nicholas Camill,1,0,30,29
1657445460899,ECE 180,B00,083141,Abi Samra; Nicholas Camill,0,0,30,30
1657445466931,MATH 10A,A01,083735,Patchell; Gregory David,2,0,30,28
1657445466931,MATH 10A,A02,083736,Patchell; Gregory David,20,0,30,10
1657445466931,MATH 10A,A03,083737,Patchell; Gregory David,16,0,30,14
1657445472972,MATH 10B,A01,083207,Lim; Seonhee,8,0,34,26
1657445472972,MATH 10B,A02,083208,Lim; Seonhee,9,0,35,26
1657445472972,MATH 10B,A03,093472,Lim; Seonhee,7,0,34,27
1657445472972,MATH 10B,B01,083739,Sinha; Shubham,12,0,30,18
1657445479062,MATH 18,A01,083743,Cinel; Cameron Alexander,7,0,30,23
1657445479062,MATH 18,A02,083744,Cinel; Cameron Alexander,17,0,30,13
1657445479062,MATH 18,A03,083745,Cinel; Cameron Alexander,9,0,30,21
1657445479062,MATH 18,B01,083748,Rideout; David Porter,5,0,37,32
1657445479062,MATH 18,B02,083749,Rideout; David Porter,5,0,36,31
1657445479062,MATH 18,B03,083750,Rideout; David Porter,3,0,37,34
1657445479062,MATH 18,B04,083751,Rideout; David Porter,6,0,36,30
1657445479062,MATH 18,B05,093473,Rideout; David Porter,6,0,36,30
1657445479062,MATH 18,B06,093474,Rideout; David Porter,6,0,36,30
1657445485098,MATH 20A,A01,083754,Zheng; Zequn,14,0,40,26
1657445491124,MATH 20B,A01,083756,Briones; Jor-el Thomas Caparas,4,0,36,32
1657445491124,MATH 20B,A02,083757,Briones; Jor-el Thomas Caparas,1,0,36,35
1657445491124,MATH 20B,A03,093475,Briones; Jor-el Thomas Caparas,2,0,36,34
1657445497148,MATH 20C,A01,083760,Briones; Jor-el Thomas Caparas,1,0,35,34
1657445497148,MATH 20C,A02,083761,Briones; Jor-el Thomas Caparas,8,0,35,27
1657445497148,MATH 20C,A03,093476,Briones; Jor-el Thomas Caparas,0,1,36,36
1657445497148,MATH 20C,B01,083762,Bach; Quang Tran,1,0,30,29
1657445503172,MATH 20D,A01,083765,Tran; Brian Kha,5,0,30,25
1657445503172,MATH 20D,A02,083766,Tran; Brian Kha,5,0,30,25
1657445503172,MATH 20D,A03,083767,Tran; Brian Kha,5,0,30,25
1657445509211,MATH 20E,A01,083771,Ganguly; Soumya,9,0,32,23
1657445509211,MATH 20E,A02,083772,Ganguly; Soumya,6,0,32,26
1657445509211,MATH 20E,B01,083773,Ciotti; Benjamin,20,0,35,15
1657445509211,MATH 20E,B02,083774,Ciotti; Benjamin,17,0,35,18
1657445515236,MATH 103A,A01,083777,Greenfeld; Be'Eri,3,0,36,33
1657445515236,MATH 103A,A02,083778,Greenfeld; Be'Eri,5,0,36,31
1657445515236,MATH 103A,A03,093561,Greenfeld; Be'Eri,5,0,36,31
1657445515236,MATH 103A,B01,083779,Greenfeld; Be'Eri,7,0,36,29
1657445515236,MATH 103A,B02,083780,Greenfeld; Be'Eri,4,0,36,32
1657445515236,MATH 103A,B03,093562,Greenfeld; Be'Eri,3,0,36,33
1657445521260,MATH 105,A01,085443,Carter; Anne Toulson,15,0,35,20
1657445521260,MATH 105,A02,093477,Carter; Anne Toulson,20,0,35,15
1657445527284,MATH 109,A01,083213,Ganzberger; Geoffrey Michael,2,0,34,32
1657445527284,MATH 109,A02,083214,Ganzberger; Geoffrey Michael,4,0,34,30
1657445527284,MATH 109,A03,093478,Ganzberger; Geoffrey Michael,2,0,34,32
1657445527284,MATH 109,B01,083215,Ganzberger; Geoffrey Michael,1,0,32,31
1657445527284,MATH 109,B02,083216,Ganzberger; Geoffrey Michael,2,0,32,30
1657445527284,MATH 109,B03,093479,Ganzberger; Geoffrey Michael,8,0,32,24
1657445533311,MATH 142A,A01,083219,Chow; Bennett,7,0,32,25
1657445533311,MATH 142A,A02,083220,Chow; Bennett,10,0,32,22
1657445533311,MATH 142A,A03,093480,Chow; Bennett,8,0,32,24
1657445533311,MATH 142A,B03,093481,Chow; Bennett,8,0,32,24
1657445533311,MATH 142A,B04,093558,Chow; Bennett,13,0,32,19
1657445533311,MATH 142A,B05,093559,Chow; Bennett,6,0,32,26
1657445539337,MATH 193A,A01,083224,Rotar; Vladimir,8,0,34,26
1657445539337,MATH 193A,A02,083225,Rotar; Vladimir,9,0,34,25
1657445539337,MATH 193A,A03,083781,Rotar; Vladimir,5,0,34,29
1657445539337,MATH 193A,A04,083782,Rotar; Vladimir,10,0,34,24
1657445539337,MATH 193A,A05,093482,Rotar; Vladimir,10,0,34,24
1657445545365,MATH 197,001,091859,McAuley; Julian John,9999,0,9999,0
1657445545365,MATH 197,002,095566,Kedlaya; Kiran S.,9997,0,9999,2
1657445545365,MATH 197,003,095567,Xiao; Ming,9999,0,9999,0
1657445545365,MATH 197,004,095571,Perols; Johan Lars,9998,0,9999,1
1657445552429,COGS 9,A01,083615,Shannon; Kyle Michael,9,0,75,66
1657445558453,COGS 11,A01,083617,Boyle; Mary E. T.,22,0,48,26
1657445564479,COGS 13,A01,083071,Bastos; Amalia Pinkusfeld,11,0,71,60
1657445570506,COGS 14A,A01,092681,Semenuks; Arturs,5,1,100,95
1657445576555,COGS 14B,A01,083073,Cheng; Tzu-Han,6,0,63,57
1657445582580,COGS 17,A01,092677,Semenuks; Arturs,6,0,81,75
1657445588604,COGS 100,A01,083619,Allen; Michael Gordon,17,0,70,53
1657445594630,COGS 101A,A01,083621,Davis; Joshua Daniel,9,0,68,59
1657445600663,COGS 101B,A01,091572,Allen; Michael Gordon,12,0,65,53
1657445606692,COGS 101C,A01,083625,Delgado; Tania,17,0,35,18
1657445612715,COGS 107A,A01,083627,Boyle; Mary E. T.,13,0,60,47
1657445618746,COGS 118A,A01,083075,Gupta; Anjum,21,0,76,55
1657445624778,CSE 3,A50,083646,Miranda; Gregory Joseph,24,0,50,26
1657445630800,CSE 8A,A50,083650,Miranda; Gregory Joseph,17,1,56,39
1657445636830,CSE 11,A01,083080,Cao; Yingjun,6,15,40,34
1657445642859,CSE 12,A01,083652,Krause-Levy; Sophia Louisa,28,1,120,92
1657445648910,CSE 15L,A01,083654,Morris; Justin Loren,9,0,50,41
1657445648910,CSE 15L,A02,083655,Morris; Justin Loren,9,0,50,41
1657445654940,CSE 20,A01,083657,Tran; Khoa Dang,39,0,80,41
1657445660985,CSE 21,A01,095574,Bach; Quang Tran,22,0,48,26
1657445667020,CSE 30,A01,083084,Eldon; John,5,0,80,75
1657445667020,CSE 30,B01,095061,Bhaskar; Nishant,9,0,50,41
1657445673056,CSE 100,A01,083659,Cao; Yingjun,5,4,70,65
1657445679094,CSE 134B,A01,083661,Powell; Thomas Allan,22,0,100,78
1657445685123,CSE 140,A01,083663,Gungor; Onat,15,0,85,70
1657445691146,CSE 140L,A01,083088,Eldon; John,21,0,100,79
1657445697178,CSE 175,A01,083665,Kumar; Rakesh,3,0,25,22
1657445703204,CSE 190,A00,092507,Dubnov; Shlomo,8,0,20,12
1657445709230,ECE 45,A01,083139,Congero; Spencer William,6,0,75,69
1657445715263,ECE 65,A50,083695,Saad; Andrew S,12,0,30,18
1657445715263,ECE 65,A51,095125,Saad; Andrew S,24,0,26,2
1657445721287,ECE 109,A01,091882,Touri; Behrouz,19,0,70,51
1657445727315,ECE 180,A00,083140,Abi Samra; Nicholas Camill,1,0,30,29
1657445727315,ECE 180,B00,083141,Abi Samra; Nicholas Camill,0,0,30,30
1657445733342,MATH 10A,A01,083735,Patchell; Gregory David,2,0,30,28
1657445733342,MATH 10A,A02,083736,Patchell; Gregory David,20,0,30,10
1657445733342,MATH 10A,A03,083737,Patchell; Gregory David,16,0,30,14
1657445739378,MATH 10B,A01,083207,Lim; Seonhee,8,0,34,26
1657445739378,MATH 10B,A02,083208,Lim; Seonhee,9,0,35,26
1657445739378,MATH 10B,A03,093472,Lim; Seonhee,7,0,34,27
1657445739378,MATH 10B,B01,083739,Sinha; Shubham,12,0,30,18
1657445745416,MATH 18,A01,083743,Cinel; Cameron Alexander,7,0,30,23
1657445745416,MATH 18,A02,083744,Cinel; Cameron Alexander,17,0,30,13
1657445745416,MATH 18,A03,083745,Cinel; Cameron Alexander,9,0,30,21
1657445745416,MATH 18,B01,083748,Rideout; David Porter,5,0,37,32
1657445745416,MATH 18,B02,083749,Rideout; David Porter,5,0,36,31
1657445745416,MATH 18,B03,083750,Rideout; David Porter,3,0,37,34
1657445745416,MATH 18,B04,083751,Rideout; David Porter,6,0,36,30
1657445745416,MATH 18,B05,093473,Rideout; David Porter,6,0,36,30
1657445745416,MATH 18,B06,093474,Rideout; David Porter,6,0,36,30
1657445751443,MATH 20A,A01,083754,Zheng; Zequn,14,0,40,26
1657445757485,MATH 20B,A01,083756,Briones; Jor-el Thomas Caparas,4,0,36,32
1657445757485,MATH 20B,A02,083757,Briones; Jor-el Thomas Caparas,1,0,36,35
1657445757485,MATH 20B,A03,093475,Briones; Jor-el Thomas Caparas,2,0,36,34
1657445763519,MATH 20C,A01,083760,Briones; Jor-el Thomas Caparas,1,0,35,34
1657445763519,MATH 20C,A02,083761,Briones; Jor-el Thomas Caparas,8,0,35,27
1657445763519,MATH 20C,A03,093476,Briones; Jor-el Thomas Caparas,0,1,36,36
1657445763519,MATH 20C,B01,083762,Bach; Quang Tran,1,0,30,29
1657445769549,MATH 20D,A01,083765,Tran; Brian Kha,5,0,30,25
1657445769549,MATH 20D,A02,083766,Tran; Brian Kha,5,0,30,25
1657445769549,MATH 20D,A03,083767,Tran; Brian Kha,5,0,30,25
1657445775584,MATH 20E,A01,083771,Ganguly; Soumya,9,0,32,23
1657445775584,MATH 20E,A02,083772,Ganguly; Soumya,6,0,32,26
1657445775584,MATH 20E,B01,083773,Ciotti; Benjamin,20,0,35,15
1657445775584,MATH 20E,B02,083774,Ciotti; Benjamin,17,0,35,18
1657445781624,MATH 103A,A01,083777,Greenfeld; Be'Eri,3,0,36,33
1657445781624,MATH 103A,A02,083778,Greenfeld; Be'Eri,5,0,36,31
1657445781624,MATH 103A,A03,093561,Greenfeld; Be'Eri,5,0,36,31
1657445781624,MATH 103A,B01,083779,Greenfeld; Be'Eri,7,0,36,29
1657445781624,MATH 103A,B02,083780,Greenfeld; Be'Eri,4,0,36,32
1657445781624,MATH 103A,B03,093562,Greenfeld; Be'Eri,3,0,36,33
1657445787652,MATH 105,A01,085443,Carter; Anne Toulson,15,0,35,20
1657445787652,MATH 105,A02,093477,Carter; Anne Toulson,20,0,35,15
1657445793679,MATH 109,A01,083213,Ganzberger; Geoffrey Michael,2,0,34,32
1657445793679,MATH 109,A02,083214,Ganzberger; Geoffrey Michael,4,0,34,30
1657445793679,MATH 109,A03,093478,Ganzberger; Geoffrey Michael,2,0,34,32
1657445793679,MATH 109,B01,083215,Ganzberger; Geoffrey Michael,1,0,32,31
1657445793679,MATH 109,B02,083216,Ganzberger; Geoffrey Michael,2,0,32,30
1657445793679,MATH 109,B03,093479,Ganzberger; Geoffrey Michael,8,0,32,24
1657445799709,MATH 142A,A01,083219,Chow; Bennett,7,0,32,25
1657445799709,MATH 142A,A02,083220,Chow; Bennett,10,0,32,22
1657445799709,MATH 142A,A03,093480,Chow; Bennett,8,0,32,24
1657445799709,MATH 142A,B03,093481,Chow; Bennett,8,0,32,24
1657445799709,MATH 142A,B04,093558,Chow; Bennett,13,0,32,19
1657445799709,MATH 142A,B05,093559,Chow; Bennett,6,0,32,26
1657445805743,MATH 193A,A01,083224,Rotar; Vladimir,8,0,34,26
1657445805743,MATH 193A,A02,083225,Rotar; Vladimir,9,0,34,25
1657445805743,MATH 193A,A03,083781,Rotar; Vladimir,5,0,34,29
1657445805743,MATH 193A,A04,083782,Rotar; Vladimir,10,0,34,24
1657445805743,MATH 193A,A05,093482,Rotar; Vladimir,10,0,34,24
1657445811773,MATH 197,001,091859,McAuley; Julian John,9999,0,9999,0
1657445811773,MATH 197,002,095566,Kedlaya; Kiran S.,9997,0,9999,2
1657445811773,MATH 197,003,095567,Xiao; Ming,9999,0,9999,0
1657445811773,MATH 197,004,095571,Perols; Johan Lars,9998,0,9999,1
1657445818858,COGS 9,A01,083615,Shannon; Kyle Michael,9,0,75,66
1657445824883,COGS 11,A01,083617,Boyle; Mary E. T.,22,0,48,26
1657445830909,COGS 13,A01,083071,Bastos; Amalia Pinkusfeld,11,0,71,60
1657445836935,COGS 14A,A01,092681,Semenuks; Arturs,5,1,100,95
1657445842960,COGS 14B,A01,083073,Cheng; Tzu-Han,6,0,63,57
1657445848987,COGS 17,A01,092677,Semenuks; Arturs,6,0,81,75
1657445855019,COGS 100,A01,083619,Allen; Michael Gordon,17,0,70,53
1657445861042,COGS 101A,A01,083621,Davis; Joshua Daniel,9,0,68,59
1657445867070,COGS 101B,A01,091572,Allen; Michael Gordon,12,0,65,53
1657445873104,COGS 101C,A01,083625,Delgado; Tania,17,0,35,18
1657445879133,COGS 107A,A01,083627,Boyle; Mary E. T.,13,0,60,47
1657445885158,COGS 118A,A01,083075,Gupta; Anjum,21,0,76,55
1657445891185,CSE 3,A50,083646,Miranda; Gregory Joseph,24,0,50,26
1657445897214,CSE 8A,A50,083650,Miranda; Gregory Joseph,17,1,56,39
1657445903245,CSE 11,A01,083080,Cao; Yingjun,6,15,40,34
1657445909274,CSE 12,A01,083652,Krause-Levy; Sophia Louisa,28,1,120,92
1657445915306,CSE 15L,A01,083654,Morris; Justin Loren,9,0,50,41
1657445915306,CSE 15L,A02,083655,Morris; Justin Loren,9,0,50,41
1657445921336,CSE 20,A01,083657,Tran; Khoa Dang,39,0,80,41
1657445927361,CSE 21,A01,095574,Bach; Quang Tran,22,0,48,26
1657445933392,CSE 30,A01,083084,Eldon; John,5,0,80,75
1657445933392,CSE 30,B01,095061,Bhaskar; Nishant,9,0,50,41
1657445939422,CSE 100,A01,083659,Cao; Yingjun,5,4,70,65
1657445945448,CSE 134B,A01,083661,Powell; Thomas Allan,22,0,100,78
1657445951476,CSE 140,A01,083663,Gungor; Onat,15,0,85,70
1657445957503,CSE 140L,A01,083088,Eldon; John,21,0,100,79
1657445963528,CSE 175,A01,083665,Kumar; Rakesh,3,0,25,22
1657445969553,CSE 190,A00,092507,Dubnov; Shlomo,8,0,20,12
1657445975579,ECE 45,A01,083139,Congero; Spencer William,6,0,75,69
1657445981613,ECE 65,A50,083695,Saad; Andrew S,12,0,30,18
1657445981613,ECE 65,A51,095125,Saad; Andrew S,24,0,26,2
1657445987639,ECE 109,A01,091882,Touri; Behrouz,19,0,70,51
1657445993675,ECE 180,A00,083140,Abi Samra; Nicholas Camill,1,0,30,29
1657445993675,ECE 180,B00,083141,Abi Samra; Nicholas Camill,0,0,30,30
1657445999799,MATH 10A,A01,083735,Patchell; Gregory David,2,0,30,28
1657445999799,MATH 10A,A02,083736,Patchell; Gregory David,20,0,30,10
1657445999799,MATH 10A,A03,083737,Patchell; Gregory David,16,0,30,14
1657446005837,MATH 10B,A01,083207,Lim; Seonhee,8,0,34,26
1657446005837,MATH 10B,A02,083208,Lim; Seonhee,9,0,35,26
1657446005837,MATH 10B,A03,093472,Lim; Seonhee,7,0,34,27
1657446005837,MATH 10B,B01,083739,Sinha; Shubham,12,0,30,18
1657446011866,MATH 18,A01,083743,Cinel; Cameron Alexander,7,0,30,23
1657446011866,MATH 18,A02,083744,Cinel; Cameron Alexander,17,0,30,13
1657446011866,MATH 18,A03,083745,Cinel; Cameron Alexander,9,0,30,21
1657446011866,MATH 18,B01,083748,Rideout; David Porter,5,0,37,32
1657446011866,MATH 18,B02,083749,Rideout; David Porter,5,0,36,31
1657446011866,MATH 18,B03,083750,Rideout; David Porter,3,0,37,34
1657446011866,MATH 18,B04,083751,Rideout; David Porter,6,0,36,30
1657446011866,MATH 18,B05,093473,Rideout; David Porter,6,0,36,30
1657446011866,MATH 18,B06,093474,Rideout; David Porter,6,0,36,30
1657446017891,MATH 20A,A01,083754,Zheng; Zequn,14,0,40,26
1657446023916,MATH 20B,A01,083756,Briones; Jor-el Thomas Caparas,4,0,36,32
1657446023916,MATH 20B,A02,083757,Briones; Jor-el Thomas Caparas,1,0,36,35
1657446023916,MATH 20B,A03,093475,Briones; Jor-el Thomas Caparas,2,0,36,34
1657446029947,MATH 20C,A01,083760,Briones; Jor-el Thomas Caparas,1,0,35,34
1657446029947,MATH 20C,A02,083761,Briones; Jor-el Thomas Caparas,8,0,35,27
1657446029947,MATH 20C,A03,093476,Briones; Jor-el Thomas Caparas,0,1,36,36
1657446029947,MATH 20C,B01,083762,Bach; Quang Tran,1,0,30,29
1657446035972,MATH 20D,A01,083765,Tran; Brian Kha,5,0,30,25
1657446035972,MATH 20D,A02,083766,Tran; Brian Kha,5,0,30,25
1657446035972,MATH 20D,A03,083767,Tran; Brian Kha,5,0,30,25
1657446042006,MATH 20E,A01,083771,Ganguly; Soumya,9,0,32,23
1657446042006,MATH 20E,A02,083772,Ganguly; Soumya,6,0,32,26
1657446042006,MATH 20E,B01,083773,Ciotti; Benjamin,20,0,35,15
1657446042006,MATH 20E,B02,083774,Ciotti; Benjamin,17,0,35,18
1657446048033,MATH 103A,A01,083777,Greenfeld; Be'Eri,3,0,36,33
1657446048033,MATH 103A,A02,083778,Greenfeld; Be'Eri,5,0,36,31
1657446048033,MATH 103A,A03,093561,Greenfeld; Be'Eri,5,0,36,31
1657446048033,MATH 103A,B01,083779,Greenfeld; Be'Eri,7,0,36,29
1657446048033,MATH 103A,B02,083780,Greenfeld; Be'Eri,4,0,36,32
1657446048033,MATH 103A,B03,093562,Greenfeld; Be'Eri,3,0,36,33
1657446054057,MATH 105,A01,085443,Carter; Anne Toulson,15,0,35,20
1657446054057,MATH 105,A02,093477,Carter; Anne Toulson,20,0,35,15
1657446060085,MATH 109,A01,083213,Ganzberger; Geoffrey Michael,2,0,34,32
1657446060085,MATH 109,A02,083214,Ganzberger; Geoffrey Michael,4,0,34,30
1657446060085,MATH 109,A03,093478,Ganzberger; Geoffrey Michael,2,0,34,32
1657446060085,MATH 109,B01,083215,Ganzberger; Geoffrey Michael,1,0,32,31
1657446060085,MATH 109,B02,083216,Ganzberger; Geoffrey Michael,2,0,32,30
1657446060085,MATH 109,B03,093479,Ganzberger; Geoffrey Michael,8,0,32,24
1657446066123,MATH 142A,A01,083219,Chow; Bennett,7,0,32,25
1657446066123,MATH 142A,A02,083220,Chow; Bennett,10,0,32,22
1657446066123,MATH 142A,A03,093480,Chow; Bennett,8,0,32,24
1657446066123,MATH 142A,B03,093481,Chow; Bennett,8,0,32,24
1657446066123,MATH 142A,B04,093558,Chow; Bennett,13,0,32,19
1657446066123,MATH 142A,B05,093559,Chow; Bennett,6,0,32,26
1657446072148,MATH 193A,A01,083224,Rotar; Vladimir,8,0,34,26
1657446072148,MATH 193A,A02,083225,Rotar; Vladimir,9,0,34,25
1657446072148,MATH 193A,A03,083781,Rotar; Vladimir,5,0,34,29
1657446072148,MATH 193A,A04,083782,Rotar; Vladimir,10,0,34,24
1657446072148,MATH 193A,A05,093482,Rotar; Vladimir,10,0,34,24
1657446078177,MATH 197,001,091859,McAuley; Julian John,9999,0,9999,0
1657446078177,MATH 197,002,095566,Kedlaya; Kiran S.,9997,0,9999,2
1657446078177,MATH 197,003,095567,Xiao; Ming,9999,0,9999,0
1657446078177,MATH 197,004,095571,Perols; Johan Lars,9998,0,9999,1
1657446085259,COGS 9,A01,083615,Shannon; Kyle Michael,9,0,75,66
1657446091284,COGS 11,A01,083617,Boyle; Mary E. T.,22,0,48,26
1657446097311,COGS 13,A01,083071,Bastos; Amalia Pinkusfeld,11,0,71,60
1657446103335,COGS 14A,A01,092681,Semenuks; Arturs,5,1,100,95
1657446109368,COGS 14B,A01,083073,Cheng; Tzu-Han,6,0,63,57
1657446115391,COGS 17,A01,092677,Semenuks; Arturs,6,0,81,75
1657446121422,COGS 100,A01,083619,Allen; Michael Gordon,17,0,70,53
1657446127446,COGS 101A,A01,083621,Davis; Joshua Daniel,9,0,68,59
1657446133478,COGS 101B,A01,091572,Allen; Michael Gordon,12,0,65,53
1657446139504,COGS 101C,A01,083625,Delgado; Tania,17,0,35,18
1657446145527,COGS 107A,A01,083627,Boyle; Mary E. T.,13,0,60,47
1657446151552,COGS 118A,A01,083075,Gupta; Anjum,21,0,76,55
1657446157579,CSE 3,A50,083646,Miranda; Gregory Joseph,24,0,50,26
1657446163610,CSE 8A,A50,083650,Miranda; Gregory Joseph,17,1,56,39
1657446169636,CSE 11,A01,083080,Cao; Yingjun,6,15,40,34
1657446175661,CSE 12,A01,083652,Krause-Levy; Sophia Louisa,28,1,120,92
1657446181691,CSE 15L,A01,083654,Morris; Justin Loren,9,0,50,41
1657446181691,CSE 15L,A02,083655,Morris; Justin Loren,9,0,50,41
1657446187720,CSE 20,A01,083657,Tran; Khoa Dang,39,0,80,41
1657446193745,CSE 21,A01,095574,Bach; Quang Tran,22,0,48,26
1657446199777,CSE 30,A01,083084,Eldon; John,5,0,80,75
1657446199777,CSE 30,B01,095061,Bhaskar; Nishant,9,0,50,41
1657446205801,CSE 100,A01,083659,Cao; Yingjun,5,4,70,65
1657446211830,CSE 134B,A01,083661,Powell; Thomas Allan,22,0,100,78
1657446217859,CSE 140,A01,083663,Gungor; Onat,15,0,85,70
1657446223890,CSE 140L,A01,083088,Eldon; John,21,0,100,79
1657446229916,CSE 175,A01,083665,Kumar; Rakesh,3,0,25,22
1657446235946,CSE 190,A00,092507,Dubnov; Shlomo,8,0,20,12
1657446241970,ECE 45,A01,083139,Congero; Spencer William,6,0,75,69
1657446247995,ECE 65,A50,083695,Saad; Andrew S,12,0,30,18
1657446247995,ECE 65,A51,095125,Saad; Andrew S,24,0,26,2
1657446254027,ECE 109,A01,091882,Touri; Behrouz,19,0,70,51
1657446260059,ECE 180,A00,083140,Abi Samra; Nicholas Camill,1,0,30,29
1657446260059,ECE 180,B00,083141,Abi Samra; Nicholas Camill,0,0,30,30
1657446266094,MATH 10A,A01,083735,Patchell; Gregory David,2,0,30,28
1657446266094,MATH 10A,A02,083736,Patchell; Gregory David,20,0,30,10
1657446266094,MATH 10A,A03,083737,Patchell; Gregory David,16,0,30,14
1657446272121,MATH 10B,A01,083207,Lim; Seonhee,8,0,34,26
1657446272121,MATH 10B,A02,083208,Lim; Seonhee,9,0,35,26
1657446272121,MATH 10B,A03,093472,Lim; Seonhee,7,0,34,27
1657446272121,MATH 10B,B01,083739,Sinha; Shubham,12,0,30,18
1657446278169,MATH 18,A01,083743,Cinel; Cameron Alexander,7,0,30,23
1657446278169,MATH 18,A02,083744,Cinel; Cameron Alexander,17,0,30,13
1657446278169,MATH 18,A03,083745,Cinel; Cameron Alexander,9,0,30,21
1657446278169,MATH 18,B01,083748,Rideout; David Porter,5,0,37,32
1657446278169,MATH 18,B02,083749,Rideout; David Porter,5,0,36,31
1657446278169,MATH 18,B03,083750,Rideout; David Porter,3,0,37,34
1657446278169,MATH 18,B04,083751,Rideout; David Porter,6,0,36,30
1657446278169,MATH 18,B05,093473,Rideout; David Porter,6,0,36,30
1657446278169,MATH 18,B06,093474,Rideout; David Porter,6,0,36,30
1657446284193,MATH 20A,A01,083754,Zheng; Zequn,14,0,40,26
1657446290230,MATH 20B,A01,083756,Briones; Jor-el Thomas Caparas,4,0,36,32
1657446290230,MATH 20B,A02,083757,Briones; Jor-el Thomas Caparas,1,0,36,35
1657446290230,MATH 20B,A03,093475,Briones; Jor-el Thomas Caparas,2,0,36,34
1657446296256,MATH 20C,A01,083760,Briones; Jor-el Thomas Caparas,1,0,35,34
1657446296256,MATH 20C,A02,083761,Briones; Jor-el Thomas Caparas,8,0,35,27
1657446296256,MATH 20C,A03,093476,Briones; Jor-el Thomas Caparas,0,1,36,36
1657446296256,MATH 20C,B01,083762,Bach; Quang Tran,1,0,30,29
1657446302293,MATH 20D,A01,083765,Tran; Brian Kha,5,0,30,25
1657446302293,MATH 20D,A02,083766,Tran; Brian Kha,5,0,30,25
1657446302293,MATH 20D,A03,083767,Tran; Brian Kha,5,0,30,25
1657446308321,MATH 20E,A01,083771,Ganguly; Soumya,9,0,32,23
1657446308321,MATH 20E,A02,083772,Ganguly; Soumya,6,0,32,26
1657446308321,MATH 20E,B01,083773,Ciotti; Benjamin,20,0,35,15
1657446308321,MATH 20E,B02,083774,Ciotti; Benjamin,17,0,35,18
1657446314362,MATH 103A,A01,083777,Greenfeld; Be'Eri,3,0,36,33
1657446314362,MATH 103A,A02,083778,Greenfeld; Be'Eri,5,0,36,31
1657446314362,MATH 103A,A03,093561,Greenfeld; Be'Eri,5,0,36,31
1657446314362,MATH 103A,B01,083779,Greenfeld; Be'Eri,7,0,36,29
1657446314362,MATH 103A,B02,083780,Greenfeld; Be'Eri,4,0,36,32
1657446314362,MATH 103A,B03,093562,Greenfeld; Be'Eri,3,0,36,33
1657446320397,MATH 105,A01,085443,Carter; Anne Toulson,15,0,35,20
1657446320397,MATH 105,A02,093477,Carter; Anne Toulson,20,0,35,15
1657446326426,MATH 109,A01,083213,Ganzberger; Geoffrey Michael,2,0,34,32
1657446326426,MATH 109,A02,083214,Ganzberger; Geoffrey Michael,4,0,34,30
1657446326426,MATH 109,A03,093478,Ganzberger; Geoffrey Michael,2,0,34,32
1657446326426,MATH 109,B01,083215,Ganzberger; Geoffrey Michael,1,0,32,31
1657446326426,MATH 109,B02,083216,Ganzberger; Geoffrey Michael,2,0,32,30
1657446326426,MATH 109,B03,093479,Ganzberger; Geoffrey Michael,8,0,32,24
1657446332463,MATH 142A,A01,083219,Chow; Bennett,7,0,32,25
1657446332463,MATH 142A,A02,083220,Chow; Bennett,10,0,32,22
1657446332463,MATH 142A,A03,093480,Chow; Bennett,8,0,32,24
1657446332463,MATH 142A,B03,093481,Chow; Bennett,8,0,32,24
1657446332463,MATH 142A,B04,093558,Chow; Bennett,13,0,32,19
1657446332463,MATH 142A,B05,093559,Chow; Bennett,6,0,32,26
1657446338489,MATH 193A,A01,083224,Rotar; Vladimir,8,0,34,26
1657446338489,MATH 193A,A02,083225,Rotar; Vladimir,9,0,34,25
1657446338489,MATH 193A,A03,083781,Rotar; Vladimir,5,0,34,29
1657446338489,MATH 193A,A04,083782,Rotar; Vladimir,10,0,34,24
1657446338489,MATH 193A,A05,093482,Rotar; Vladimir,10,0,34,24
1657446344519,MATH 197,001,091859,McAuley; Julian John,9999,0,9999,0
1657446344519,MATH 197,002,095566,Kedlaya; Kiran S.,9997,0,9999,2
1657446344519,MATH 197,003,095567,Xiao; Ming,9999,0,9999,0
1657446344519,MATH 197,004,095571,Perols; Johan Lars,9998,0,9999,1
1657446351605,COGS 9,A01,083615,Shannon; Kyle Michael,9,0,75,66
1657446357637,COGS 11,A01,083617,Boyle; Mary E. T.,22,0,48,26
1657446363665,COGS 13,A01,083071,Bastos; Amalia Pinkusfeld,11,0,71,60
1657446369696,COGS 14A,A01,092681,Semenuks; Arturs,5,1,100,95
1657446375720,COGS 14B,A01,083073,Cheng; Tzu-Han,6,0,63,57
1657446381750,COGS 17,A01,092677,Semenuks; Arturs,6,0,81,75
1657446387782,COGS 100,A01,083619,Allen; Michael Gordon,17,0,70,53
1657446393813,COGS 101A,A01,083621,Davis; Joshua Daniel,9,0,68,59
1657446399843,COGS 101B,A01,091572,Allen; Michael Gordon,12,0,65,53
1657446405873,COGS 101C,A01,083625,Delgado; Tania,17,0,35,18
1657446411910,COGS 107A,A01,083627,Boyle; Mary E. T.,13,0,60,47
1657446417935,COGS 118A,A01,083075,Gupta; Anjum,21,0,76,55
1657446423959,CSE 3,A50,083646,Miranda; Gregory Joseph,24,0,50,26
1657446429986,CSE 8A,A50,083650,Miranda; Gregory Joseph,17,1,56,39
1657446436013,CSE 11,A01,083080,Cao; Yingjun,6,15,40,34
1657446442053,CSE 12,A01,083652,Krause-Levy; Sophia Louisa,28,1,120,92
1657446448086,CSE 15L,A01,083654,Morris; Justin Loren,9,0,50,41
1657446448086,CSE 15L,A02,083655,Morris; Justin Loren,9,0,50,41
1657446454112,CSE 20,A01,083657,Tran; Khoa Dang,39,0,80,41
1657446460139,CSE 21,A01,095574,Bach; Quang Tran,22,0,48,26
1657446466168,CSE 30,A01,083084,Eldon; John,5,0,80,75
1657446466168,CSE 30,B01,095061,Bhaskar; Nishant,9,0,50,41
1657446472200,CSE 100,A01,083659,Cao; Yingjun,5,4,70,65
1657446478224,CSE 134B,A01,083661,Powell; Thomas Allan,22,0,100,78
1657446484256,CSE 140,A01,083663,Gungor; Onat,15,0,85,70
1657446490283,CSE 140L,A01,083088,Eldon; John,21,0,100,79
1657446496317,CSE 175,A01,083665,Kumar; Rakesh,3,0,25,22
1657446502350,CSE 190,A00,092507,Dubnov; Shlomo,8,0,20,12
1657446508386,ECE 45,A01,083139,Congero; Spencer William,6,0,75,69
1657446514420,ECE 65,A50,083695,Saad; Andrew S,12,0,30,18
1657446514420,ECE 65,A51,095125,Saad; Andrew S,24,0,26,2
1657446520444,ECE 109,A01,091882,Touri; Behrouz,19,0,70,51
1657446526474,ECE 180,A00,083140,Abi Samra; Nicholas Camill,1,0,30,29
1657446526474,ECE 180,B00,083141,Abi Samra; Nicholas Camill,0,0,30,30
1657446532510,MATH 10A,A01,083735,Patchell; Gregory David,2,0,30,28
1657446532510,MATH 10A,A02,083736,Patchell; Gregory David,20,0,30,10
1657446532510,MATH 10A,A03,083737,Patchell; Gregory David,16,0,30,14
1657446538538,MATH 10B,A01,083207,Lim; Seonhee,8,0,34,26
1657446538538,MATH 10B,A02,083208,Lim; Seonhee,9,0,35,26
1657446538538,MATH 10B,A03,093472,Lim; Seonhee,7,0,34,27
1657446538538,MATH 10B,B01,083739,Sinha; Shubham,12,0,30,18
1657446544584,MATH 18,A01,083743,Cinel; Cameron Alexander,7,0,30,23
1657446544584,MATH 18,A02,083744,Cinel; Cameron Alexander,17,0,30,13
1657446544584,MATH 18,A03,083745,Cinel; Cameron Alexander,9,0,30,21
1657446544584,MATH 18,B01,083748,Rideout; David Porter,5,0,37,32
1657446544584,MATH 18,B02,083749,Rideout; David Porter,5,0,36,31
1657446544584,MATH 18,B03,083750,Rideout; David Porter,3,0,37,34
1657446544584,MATH 18,B04,083751,Rideout; David Porter,6,0,36,30
1657446544584,MATH 18,B05,093473,Rideout; David Porter,6,0,36,30
1657446544584,MATH 18,B06,093474,Rideout; David Porter,6,0,36,30
1657446550616,MATH 20A,A01,083754,Zheng; Zequn,14,0,40,26
1657446556653,MATH 20B,A01,083756,Briones; Jor-el Thomas Caparas,4,0,36,32
1657446556653,MATH 20B,A02,083757,Briones; Jor-el Thomas Caparas,1,0,36,35
1657446556653,MATH 20B,A03,093475,Briones; Jor-el Thomas Caparas,2,0,36,34
1657446562679,MATH 20C,A01,083760,Briones; Jor-el Thomas Caparas,1,0,35,34
1657446562679,MATH 20C,A02,083761,Briones; Jor-el Thomas Caparas,8,0,35,27
1657446562679,MATH 20C,A03,093476,Briones; Jor-el Thomas Caparas,0,1,36,36
1657446562679,MATH 20C,B01,083762,Bach; Quang Tran,1,0,30,29
1657446568715,MATH 20D,A01,083765,Tran; Brian Kha,5,0,30,25
1657446568715,MATH 20D,A02,083766,Tran; Brian Kha,5,0,30,25
1657446568715,MATH 20D,A03,083767,Tran; Brian Kha,5,0,30,25
1657446574749,MATH 20E,A01,083771,Ganguly; Soumya,9,0,32,23
1657446574749,MATH 20E,A02,083772,Ganguly; Soumya,6,0,32,26
1657446574749,MATH 20E,B01,083773,Ciotti; Benjamin,20,0,35,15
1657446574749,MATH 20E,B02,083774,Ciotti; Benjamin,17,0,35,18
1657446580775,MATH 103A,A01,083777,Greenfeld; Be'Eri,3,0,36,33
1657446580775,MATH 103A,A02,083778,Greenfeld; Be'Eri,5,0,36,31
1657446580775,MATH 103A,A03,093561,Greenfeld; Be'Eri,5,0,36,31
1657446580775,MATH 103A,B01,083779,Greenfeld; Be'Eri,7,0,36,29
1657446580775,MATH 103A,B02,083780,Greenfeld; Be'Eri,4,0,36,32
1657446580775,MATH 103A,B03,093562,Greenfeld; Be'Eri,3,0,36,33
1657446586804,MATH 105,A01,085443,Carter; Anne Toulson,15,0,35,20
1657446586804,MATH 105,A02,093477,Carter; Anne Toulson,20,0,35,15
1657446592832,MATH 109,A01,083213,Ganzberger; Geoffrey Michael,2,0,34,32
1657446592832,MATH 109,A02,083214,Ganzberger; Geoffrey Michael,4,0,34,30
1657446592832,MATH 109,A03,093478,Ganzberger; Geoffrey Michael,2,0,34,32
1657446592832,MATH 109,B01,083215,Ganzberger; Geoffrey Michael,1,0,32,31
1657446592832,MATH 109,B02,083216,Ganzberger; Geoffrey Michael,2,0,32,30
1657446592832,MATH 109,B03,093479,Ganzberger; Geoffrey Michael,8,0,32,24
1657446598952,MATH 142A,A01,083219,Chow; Bennett,7,0,32,25
1657446598952,MATH 142A,A02,083220,Chow; Bennett,10,0,32,22
1657446598952,MATH 142A,A03,093480,Chow; Bennett,8,0,32,24
1657446598952,MATH 142A,B03,093481,Chow; Bennett,8,0,32,24
1657446598952,MATH 142A,B04,093558,Chow; Bennett,13,0,32,19
1657446598952,MATH 142A,B05,093559,Chow; Bennett,6,0,32,26
1657446604979,MATH 193A,A01,083224,Rotar; Vladimir,8,0,34,26
1657446604979,MATH 193A,A02,083225,Rotar; Vladimir,9,0,34,25
1657446604979,MATH 193A,A03,083781,Rotar; Vladimir,5,0,34,29
1657446604979,MATH 193A,A04,083782,Rotar; Vladimir,10,0,34,24
1657446604979,MATH 193A,A05,093482,Rotar; Vladimir,10,0,34,24
1657446611027,MATH 197,001,091859,McAuley; Julian John,9999,0,9999,0
1657446611027,MATH 197,002,095566,Kedlaya; Kiran S.,9997,0,9999,2
1657446611027,MATH 197,003,095567,Xiao; Ming,9999,0,9999,0
1657446611027,MATH 197,004,095571,Perols; Johan Lars,9998,0,9999,1
1657446618099,COGS 9,A01,083615,Shannon; Kyle Michael,9,0,75,66
1657446624132,COGS 11,A01,083617,Boyle; Mary E. T.,22,0,48,26
1657446630166,COGS 13,A01,083071,Bastos; Amalia Pinkusfeld,11,0,71,60
1657446636189,COGS 14A,A01,092681,Semenuks; Arturs,5,1,100,95
1657446642220,COGS 14B,A01,083073,Cheng; Tzu-Han,6,0,63,57
1657446648248,COGS 17,A01,092677,Semenuks; Arturs,6,0,81,75
1657446654281,COGS 100,A01,083619,Allen; Michael Gordon,17,0,70,53
1657446660313,COGS 101A,A01,083621,Davis; Joshua Daniel,9,0,68,59
1657446666354,COGS 101B,A01,091572,Allen; Michael Gordon,12,0,65,53
1657446672380,COGS 101C,A01,083625,Delgado; Tania,17,0,35,18
1657446678404,COGS 107A,A01,083627,Boyle; Mary E. T.,13,0,60,47
1657446684428,COGS 118A,A01,083075,Gupta; Anjum,21,0,76,55
1657446690454,CSE 3,A50,083646,Miranda; Gregory Joseph,24,0,50,26
1657446696483,CSE 8A,A50,083650,Miranda; Gregory Joseph,17,1,56,39
1657446702513,CSE 11,A01,083080,Cao; Yingjun,6,15,40,34
1657446708550,CSE 12,A01,083652,Krause-Levy; Sophia Louisa,28,1,120,92
1657446714582,CSE 15L,A01,083654,Morris; Justin Loren,9,0,50,41
1657446714582,CSE 15L,A02,083655,Morris; Justin Loren,9,0,50,41
1657446720614,CSE 20,A01,083657,Tran; Khoa Dang,39,0,80,41
1657446726653,CSE 21,A01,095574,Bach; Quang Tran,22,0,48,26
1657446732686,CSE 30,A01,083084,Eldon; John,5,0,80,75
1657446732686,CSE 30,B01,095061,Bhaskar; Nishant,9,0,50,41
1657446738719,CSE 100,A01,083659,Cao; Yingjun,5,4,70,65
1657446744753,CSE 134B,A01,083661,Powell; Thomas Allan,22,0,100,78
1657446750784,CSE 140,A01,083663,Gungor; Onat,15,0,85,70
1657446756813,CSE 140L,A01,083088,Eldon; John,21,0,100,79
1657446762843,CSE 175,A01,083665,Kumar; Rakesh,3,0,25,22
1657446768871,CSE 190,A00,092507,Dubnov; Shlomo,8,0,20,12
1657446774905,ECE 45,A01,083139,Congero; Spencer William,6,0,75,69
1657446780933,ECE 65,A50,083695,Saad; Andrew S,12,0,30,18
1657446780933,ECE 65,A51,095125,Saad; Andrew S,24,0,26,2
1657446786980,ECE 109,A01,091882,Touri; Behrouz,19,0,70,51
1657446793013,ECE 180,A00,083140,Abi Samra; Nicholas Camill,1,0,30,29
1657446793013,ECE 180,B00,083141,Abi Samra; Nicholas Camill,0,0,30,30
1657446799039,MATH 10A,A01,083735,Patchell; Gregory David,2,0,30,28
1657446799039,MATH 10A,A02,083736,Patchell; Gregory David,20,0,30,10
1657446799039,MATH 10A,A03,083737,Patchell; Gregory David,16,0,30,14
1657446805080,MATH 10B,A01,083207,Lim; Seonhee,8,0,34,26
1657446805080,MATH 10B,A02,083208,Lim; Seonhee,9,0,35,26
1657446805080,MATH 10B,A03,093472,Lim; Seonhee,7,0,34,27
1657446805080,MATH 10B,B01,083739,Sinha; Shubham,12,0,30,18
1657446811122,MATH 18,A01,083743,Cinel; Cameron Alexander,7,0,30,23
1657446811122,MATH 18,A02,083744,Cinel; Cameron Alexander,17,0,30,13
1657446811122,MATH 18,A03,083745,Cinel; Cameron Alexander,9,0,30,21
1657446811122,MATH 18,B01,083748,Rideout; David Porter,5,0,37,32
1657446811122,MATH 18,B02,083749,Rideout; David Porter,5,0,36,31
1657446811122,MATH 18,B03,083750,Rideout; David Porter,3,0,37,34
1657446811122,MATH 18,B04,083751,Rideout; David Porter,6,0,36,30
1657446811122,MATH 18,B05,093473,Rideout; David Porter,6,0,36,30
1657446811122,MATH 18,B06,093474,Rideout; David Porter,6,0,36,30
1657446817153,MATH 20A,A01,083754,Zheng; Zequn,14,0,40,26
1657446823187,MATH 20B,A01,083756,Briones; Jor-el Thomas Caparas,4,0,36,32
1657446823187,MATH 20B,A02,083757,Briones; Jor-el Thomas Caparas,1,0,36,35
1657446823187,MATH 20B,A03,093475,Briones; Jor-el Thomas Caparas,2,0,36,34
1657446829221,MATH 20C,A01,083760,Briones; Jor-el Thomas Caparas,1,0,35,34
1657446829221,MATH 20C,A02,083761,Briones; Jor-el Thomas Caparas,8,0,35,27
1657446829221,MATH 20C,A03,093476,Briones; Jor-el Thomas Caparas,0,1,36,36
1657446829221,MATH 20C,B01,083762,Bach; Quang Tran,1,0,30,29
1657446835260,MATH 20D,A01,083765,Tran; Brian Kha,5,0,30,25
1657446835260,MATH 20D,A02,083766,Tran; Brian Kha,5,0,30,25
1657446835260,MATH 20D,A03,083767,Tran; Brian Kha,5,0,30,25
1657446841289,MATH 20E,A01,083771,Ganguly; Soumya,9,0,32,23
1657446841289,MATH 20E,A02,083772,Ganguly; Soumya,6,0,32,26
1657446841289,MATH 20E,B01,083773,Ciotti; Benjamin,20,0,35,15
1657446841289,MATH 20E,B02,083774,Ciotti; Benjamin,17,0,35,18
1657446847318,MATH 103A,A01,083777,Greenfeld; Be'Eri,3,0,36,33
1657446847318,MATH 103A,A02,083778,Greenfeld; Be'Eri,5,0,36,31
1657446847318,MATH 103A,A03,093561,Greenfeld; Be'Eri,5,0,36,31
1657446847318,MATH 103A,B01,083779,Greenfeld; Be'Eri,7,0,36,29
1657446847318,MATH 103A,B02,083780,Greenfeld; Be'Eri,4,0,36,32
1657446847318,MATH 103A,B03,093562,Greenfeld; Be'Eri,3,0,36,33
1657446853344,MATH 105,A01,085443,Carter; Anne Toulson,15,0,35,20
1657446853344,MATH 105,A02,093477,Carter; Anne Toulson,20,0,35,15
1657446859371,MATH 109,A01,083213,Ganzberger; Geoffrey Michael,2,0,34,32
1657446859371,MATH 109,A02,083214,Ganzberger; Geoffrey Michael,4,0,34,30
1657446859371,MATH 109,A03,093478,Ganzberger; Geoffrey Michael,2,0,34,32
1657446859371,MATH 109,B01,083215,Ganzberger; Geoffrey Michael,1,0,32,31
1657446859371,MATH 109,B02,083216,Ganzberger; Geoffrey Michael,2,0,32,30
1657446859371,MATH 109,B03,093479,Ganzberger; Geoffrey Michael,8,0,32,24
1657446865410,MATH 142A,A01,083219,Chow; Bennett,7,0,32,25
1657446865410,MATH 142A,A02,083220,Chow; Bennett,10,0,32,22
1657446865410,MATH 142A,A03,093480,Chow; Bennett,8,0,32,24
1657446865410,MATH 142A,B03,093481,Chow; Bennett,8,0,32,24
1657446865410,MATH 142A,B04,093558,Chow; Bennett,13,0,32,19
1657446865410,MATH 142A,B05,093559,Chow; Bennett,6,0,32,26
1657446871434,MATH 193A,A01,083224,Rotar; Vladimir,8,0,34,26
1657446871434,MATH 193A,A02,083225,Rotar; Vladimir,9,0,34,25
1657446871434,MATH 193A,A03,083781,Rotar; Vladimir,5,0,34,29
1657446871434,MATH 193A,A04,083782,Rotar; Vladimir,10,0,34,24
1657446871434,MATH 193A,A05,093482,Rotar; Vladimir,10,0,34,24
1657446877459,MATH 197,001,091859,McAuley; Julian John,9999,0,9999,0
1657446877459,MATH 197,002,095566,Kedlaya; Kiran S.,9997,0,9999,2
1657446877459,MATH 197,003,095567,Xiao; Ming,9999,0,9999,0
1657446877459,MATH 197,004,095571,Perols; Johan Lars,9998,0,9999,1
1657446884543,COGS 9,A01,083615,Shannon; Kyle Michael,9,0,75,66
1657446890571,COGS 11,A01,083617,Boyle; Mary E. T.,22,0,48,26
1657446896598,COGS 13,A01,083071,Bastos; Amalia Pinkusfeld,11,0,71,60
1657446902623,COGS 14A,A01,092681,Semenuks; Arturs,5,1,100,95
1657446908655,COGS 14B,A01,083073,Cheng; Tzu-Han,6,0,63,57
1657446914679,COGS 17,A01,092677,Semenuks; Arturs,6,0,81,75
1657446920705,COGS 100,A01,083619,Allen; Michael Gordon,17,0,70,53
1657446926737,COGS 101A,A01,083621,Davis; Joshua Daniel,9,0,68,59
1657446932761,COGS 101B,A01,091572,Allen; Michael Gordon,12,0,65,53
1657446938787,COGS 101C,A01,083625,Delgado; Tania,17,0,35,18
1657446944819,COGS 107A,A01,083627,Boyle; Mary E. T.,13,0,60,47
1657446950844,COGS 118A,A01,083075,Gupta; Anjum,21,0,76,55
1657446956881,CSE 3,A50,083646,Miranda; Gregory Joseph,24,0,50,26
1657446962906,CSE 8A,A50,083650,Miranda; Gregory Joseph,17,1,56,39
1657446968934,CSE 11,A01,083080,Cao; Yingjun,6,15,40,34
1657446974960,CSE 12,A01,083652,Krause-Levy; Sophia Louisa,28,1,120,92
1657446980984,CSE 15L,A01,083654,Morris; Justin Loren,9,0,50,41
1657446980984,CSE 15L,A02,083655,Morris; Justin Loren,9,0,50,41
1657446987015,CSE 20,A01,083657,Tran; Khoa Dang,39,0,80,41
1657446993047,CSE 21,A01,095574,Bach; Quang Tran,22,0,48,26
1657446999073,CSE 30,A01,083084,Eldon; John,5,0,80,75
1657446999073,CSE 30,B01,095061,Bhaskar; Nishant,9,0,50,41
1657447005098,CSE 100,A01,083659,Cao; Yingjun,5,4,70,65
1657447011123,CSE 134B,A01,083661,Powell; Thomas Allan,22,0,100,78
1657447017151,CSE 140,A01,083663,Gungor; Onat,15,0,85,70
1657447023176,CSE 140L,A01,083088,Eldon; John,21,0,100,79
1657447029201,CSE 175,A01,083665,Kumar; Rakesh,3,0,25,22
1657447035227,CSE 190,A00,092507,Dubnov; Shlomo,8,0,20,12
1657447041263,ECE 45,A01,083139,Congero; Spencer William,6,0,75,69
1657447047290,ECE 65,A50,083695,Saad; Andrew S,12,0,30,18
1657447047290,ECE 65,A51,095125,Saad; Andrew S,24,0,26,2
1657447053319,ECE 109,A01,091882,Touri; Behrouz,19,0,70,51
1657447059351,ECE 180,A00,083140,Abi Samra; Nicholas Camill,1,0,30,29
1657447059351,ECE 180,B00,083141,Abi Samra; Nicholas Camill,0,0,30,30
1657447065380,MATH 10A,A01,083735,Patchell; Gregory David,2,0,30,28
1657447065380,MATH 10A,A02,083736,Patchell; Gregory David,20,0,30,10
1657447065380,MATH 10A,A03,083737,Patchell; Gregory David,16,0,30,14
1657447071422,MATH 10B,A01,083207,Lim; Seonhee,8,0,34,26
1657447071422,MATH 10B,A02,083208,Lim; Seonhee,9,0,35,26
1657447071422,MATH 10B,A03,093472,Lim; Seonhee,7,0,34,27
1657447071422,MATH 10B,B01,083739,Sinha; Shubham,12,0,30,18
1657447077450,MATH 18,A01,083743,Cinel; Cameron Alexander,7,0,30,23
1657447077450,MATH 18,A02,083744,Cinel; Cameron Alexander,17,0,30,13
1657447077450,MATH 18,A03,083745,Cinel; Cameron Alexander,9,0,30,21
1657447077450,MATH 18,B01,083748,Rideout; David Porter,5,0,37,32
1657447077450,MATH 18,B02,083749,Rideout; David Porter,5,0,36,31
1657447077450,MATH 18,B03,083750,Rideout; David Porter,3,0,37,34
1657447077450,MATH 18,B04,083751,Rideout; David Porter,6,0,36,30
1657447077450,MATH 18,B05,093473,Rideout; David Porter,6,0,36,30
1657447077450,MATH 18,B06,093474,Rideout; David Porter,6,0,36,30
1657447083474,MATH 20A,A01,083754,Zheng; Zequn,14,0,40,26
1657447089501,MATH 20B,A01,083756,Briones; Jor-el Thomas Caparas,4,0,36,32
1657447089501,MATH 20B,A02,083757,Briones; Jor-el Thomas Caparas,1,0,36,35
1657447089501,MATH 20B,A03,093475,Briones; Jor-el Thomas Caparas,2,0,36,34
1657447095528,MATH 20C,A01,083760,Briones; Jor-el Thomas Caparas,1,0,35,34
1657447095528,MATH 20C,A02,083761,Briones; Jor-el Thomas Caparas,8,0,35,27
1657447095528,MATH 20C,A03,093476,Briones; Jor-el Thomas Caparas,0,1,36,36
1657447095528,MATH 20C,B01,083762,Bach; Quang Tran,1,0,30,29
1657447101553,MATH 20D,A01,083765,Tran; Brian Kha,5,0,30,25
1657447101553,MATH 20D,A02,083766,Tran; Brian Kha,5,0,30,25
1657447101553,MATH 20D,A03,083767,Tran; Brian Kha,5,0,30,25
1657447107580,MATH 20E,A01,083771,Ganguly; Soumya,9,0,32,23
1657447107580,MATH 20E,A02,083772,Ganguly; Soumya,6,0,32,26
1657447107580,MATH 20E,B01,083773,Ciotti; Benjamin,20,0,35,15
1657447107580,MATH 20E,B02,083774,Ciotti; Benjamin,17,0,35,18
1657447113629,MATH 103A,A01,083777,Greenfeld; Be'Eri,3,0,36,33
1657447113629,MATH 103A,A02,083778,Greenfeld; Be'Eri,5,0,36,31
1657447113629,MATH 103A,A03,093561,Greenfeld; Be'Eri,5,0,36,31
1657447113629,MATH 103A,B01,083779,Greenfeld; Be'Eri,7,0,36,29
1657447113629,MATH 103A,B02,083780,Greenfeld; Be'Eri,4,0,36,32
1657447113629,MATH 103A,B03,093562,Greenfeld; Be'Eri,3,0,36,33
1657447119659,MATH 105,A01,085443,Carter; Anne Toulson,15,0,35,20
1657447119659,MATH 105,A02,093477,Carter; Anne Toulson,20,0,35,15
1657447125684,MATH 109,A01,083213,Ganzberger; Geoffrey Michael,2,0,34,32
1657447125684,MATH 109,A02,083214,Ganzberger; Geoffrey Michael,4,0,34,30
1657447125684,MATH 109,A03,093478,Ganzberger; Geoffrey Michael,2,0,34,32
1657447125684,MATH 109,B01,083215,Ganzberger; Geoffrey Michael,1,0,32,31
1657447125684,MATH 109,B02,083216,Ganzberger; Geoffrey Michael,2,0,32,30
1657447125684,MATH 109,B03,093479,Ganzberger; Geoffrey Michael,8,0,32,24
1657447131728,MATH 142A,A01,083219,Chow; Bennett,7,0,32,25
1657447131728,MATH 142A,A02,083220,Chow; Bennett,10,0,32,22
1657447131728,MATH 142A,A03,093480,Chow; Bennett,8,0,32,24
1657447131728,MATH 142A,B03,093481,Chow; Bennett,8,0,32,24
1657447131728,MATH 142A,B04,093558,Chow; Bennett,13,0,32,19
1657447131728,MATH 142A,B05,093559,Chow; Bennett,6,0,32,26
1657447137766,MATH 193A,A01,083224,Rotar; Vladimir,8,0,34,26
1657447137766,MATH 193A,A02,083225,Rotar; Vladimir,9,0,34,25
1657447137766,MATH 193A,A03,083781,Rotar; Vladimir,5,0,34,29
1657447137766,MATH 193A,A04,083782,Rotar; Vladimir,10,0,34,24
1657447137766,MATH 193A,A05,093482,Rotar; Vladimir,10,0,34,24
1657447143799,MATH 197,001,091859,McAuley; Julian John,9999,0,9999,0
1657447143799,MATH 197,002,095566,Kedlaya; Kiran S.,9997,0,9999,2
1657447143799,MATH 197,003,095567,Xiao; Ming,9999,0,9999,0
1657447143799,MATH 197,004,095571,Perols; Johan Lars,9998,0,9999,1
1657447150889,COGS 9,A01,083615,Shannon; Kyle Michael,9,0,75,66
1657447156922,COGS 11,A01,083617,Boyle; Mary E. T.,22,0,48,26
1657447162958,COGS 13,A01,083071,Bastos; Amalia Pinkusfeld,11,0,71,60
1657447168990,COGS 14A,A01,092681,Semenuks; Arturs,5,1,100,95
1657447175015,COGS 14B,A01,083073,Cheng; Tzu-Han,6,0,63,57
1657447181040,COGS 17,A01,092677,Semenuks; Arturs,6,0,81,75
1657447187073,COGS 100,A01,083619,Allen; Michael Gordon,17,0,70,53
1657447193202,COGS 101A,A01,083621,Davis; Joshua Daniel,9,0,68,59
1657447199237,COGS 101B,A01,091572,Allen; Michael Gordon,12,0,65,53
1657447205276,COGS 101C,A01,083625,Delgado; Tania,17,0,35,18
1657447211305,COGS 107A,A01,083627,Boyle; Mary E. T.,13,0,60,47
1657447217331,COGS 118A,A01,083075,Gupta; Anjum,21,0,76,55
1657447223357,CSE 3,A50,083646,Miranda; Gregory Joseph,24,0,50,26
1657447229381,CSE 8A,A50,083650,Miranda; Gregory Joseph,17,1,56,39
1657447235405,CSE 11,A01,083080,Cao; Yingjun,6,15,40,34
1657447241430,CSE 12,A01,083652,Krause-Levy; Sophia Louisa,28,1,120,92
1657447247453,CSE 15L,A01,083654,Morris; Justin Loren,9,0,50,41
1657447247453,CSE 15L,A02,083655,Morris; Justin Loren,9,0,50,41
1657447253478,CSE 20,A01,083657,Tran; Khoa Dang,39,0,80,41
1657447259503,CSE 21,A01,095574,Bach; Quang Tran,22,0,48,26
1657447265528,CSE 30,A01,083084,Eldon; John,5,0,80,75
1657447265528,CSE 30,B01,095061,Bhaskar; Nishant,9,0,50,41
1657447271551,CSE 100,A01,083659,Cao; Yingjun,5,4,70,65
1657447277575,CSE 134B,A01,083661,Powell; Thomas Allan,22,0,100,78
1657447283598,CSE 140,A01,083663,Gungor; Onat,15,0,85,70
1657447289624,CSE 140L,A01,083088,Eldon; John,21,0,100,79
1657447295648,CSE 175,A01,083665,Kumar; Rakesh,3,0,25,22
1657447301679,CSE 190,A00,092507,Dubnov; Shlomo,8,0,20,12
1657447307705,ECE 45,A01,083139,Congero; Spencer William,6,0,75,69
1657447313743,ECE 65,A50,083695,Saad; Andrew S,12,0,30,18
1657447313743,ECE 65,A51,095125,Saad; Andrew S,24,0,26,2
1657447319769,ECE 109,A01,091882,Touri; Behrouz,19,0,70,51
1657447325793,ECE 180,A00,083140,Abi Samra; Nicholas Camill,1,0,30,29
1657447325793,ECE 180,B00,083141,Abi Samra; Nicholas Camill,0,0,30,30
1657447331827,MATH 10A,A01,083735,Patchell; Gregory David,2,0,30,28
1657447331827,MATH 10A,A02,083736,Patchell; Gregory David,20,0,30,10
1657447331827,MATH 10A,A03,083737,Patchell; Gregory David,16,0,30,14
1657447337856,MATH 10B,A01,083207,Lim; Seonhee,8,0,34,26
1657447337856,MATH 10B,A02,083208,Lim; Seonhee,9,0,35,26
1657447337856,MATH 10B,A03,093472,Lim; Seonhee,7,0,34,27
1657447337856,MATH 10B,B01,083739,Sinha; Shubham,12,0,30,18
1657447343882,MATH 18,A01,083743,Cinel; Cameron Alexander,7,0,30,23
1657447343882,MATH 18,A02,083744,Cinel; Cameron Alexander,17,0,30,13
1657447343882,MATH 18,A03,083745,Cinel; Cameron Alexander,9,0,30,21
1657447343882,MATH 18,B01,083748,Rideout; David Porter,5,0,37,32
1657447343882,MATH 18,B02,083749,Rideout; David Porter,5,0,36,31
1657447343882,MATH 18,B03,083750,Rideout; David Porter,3,0,37,34
1657447343882,MATH 18,B04,083751,Rideout; David Porter,6,0,36,30
1657447343882,MATH 18,B05,093473,Rideout; David Porter,6,0,36,30
1657447343882,MATH 18,B06,093474,Rideout; David Porter,6,0,36,30
1657447349911,MATH 20A,A01,083754,Zheng; Zequn,14,0,40,26
1657447355938,MATH 20B,A01,083756,Briones; Jor-el Thomas Caparas,4,0,36,32
1657447355938,MATH 20B,A02,083757,Briones; Jor-el Thomas Caparas,1,0,36,35
1657447355938,MATH 20B,A03,093475,Briones; Jor-el Thomas Caparas,2,0,36,34
1657447361964,MATH 20C,A01,083760,Briones; Jor-el Thomas Caparas,1,0,35,34
1657447361964,MATH 20C,A02,083761,Briones; Jor-el Thomas Caparas,8,0,35,27
1657447361964,MATH 20C,A03,093476,Briones; Jor-el Thomas Caparas,0,1,36,36
1657447361964,MATH 20C,B01,083762,Bach; Quang Tran,1,0,30,29
1657447367998,MATH 20D,A01,083765,Tran; Brian Kha,5,0,30,25
1657447367998,MATH 20D,A02,083766,Tran; Brian Kha,5,0,30,25
1657447367998,MATH 20D,A03,083767,Tran; Brian Kha,5,0,30,25
1657447374024,MATH 20E,A01,083771,Ganguly; Soumya,9,0,32,23
1657447374024,MATH 20E,A02,083772,Ganguly; Soumya,6,0,32,26
1657447374024,MATH 20E,B01,083773,Ciotti; Benjamin,20,0,35,15
1657447374024,MATH 20E,B02,083774,Ciotti; Benjamin,17,0,35,18
1657447380067,MATH 103A,A01,083777,Greenfeld; Be'Eri,3,0,36,33
1657447380067,MATH 103A,A02,083778,Greenfeld; Be'Eri,5,0,36,31
1657447380067,MATH 103A,A03,093561,Greenfeld; Be'Eri,5,0,36,31
1657447380067,MATH 103A,B01,083779,Greenfeld; Be'Eri,7,0,36,29
1657447380067,MATH 103A,B02,083780,Greenfeld; Be'Eri,4,0,36,32
1657447380067,MATH 103A,B03,093562,Greenfeld; Be'Eri,3,0,36,33
1657447386101,MATH 105,A01,085443,Carter; Anne Toulson,15,0,35,20
1657447386101,MATH 105,A02,093477,Carter; Anne Toulson,20,0,35,15
1657447392126,MATH 109,A01,083213,Ganzberger; Geoffrey Michael,2,0,34,32
1657447392126,MATH 109,A02,083214,Ganzberger; Geoffrey Michael,4,0,34,30
1657447392126,MATH 109,A03,093478,Ganzberger; Geoffrey Michael,2,0,34,32
1657447392126,MATH 109,B01,083215,Ganzberger; Geoffrey Michael,1,0,32,31
1657447392126,MATH 109,B02,083216,Ganzberger; Geoffrey Michael,2,0,32,30
1657447392126,MATH 109,B03,093479,Ganzberger; Geoffrey Michael,8,0,32,24
1657447398161,MATH 142A,A01,083219,Chow; Bennett,7,0,32,25
1657447398161,MATH 142A,A02,083220,Chow; Bennett,10,0,32,22
1657447398161,MATH 142A,A03,093480,Chow; Bennett,8,0,32,24
1657447398161,MATH 142A,B03,093481,Chow; Bennett,8,0,32,24
1657447398161,MATH 142A,B04,093558,Chow; Bennett,13,0,32,19
1657447398161,MATH 142A,B05,093559,Chow; Bennett,6,0,32,26
1657447404195,MATH 193A,A01,083224,Rotar; Vladimir,8,0,34,26
1657447404195,MATH 193A,A02,083225,Rotar; Vladimir,9,0,34,25
1657447404195,MATH 193A,A03,083781,Rotar; Vladimir,5,0,34,29
1657447404195,MATH 193A,A04,083782,Rotar; Vladimir,10,0,34,24
1657447404195,MATH 193A,A05,093482,Rotar; Vladimir,10,0,34,24
1657447410218,MATH 197,001,091859,McAuley; Julian John,9999,0,9999,0
1657447410218,MATH 197,002,095566,Kedlaya; Kiran S.,9997,0,9999,2
1657447410218,MATH 197,003,095567,Xiao; Ming,9999,0,9999,0
1657447410218,MATH 197,004,095571,Perols; Johan Lars,9998,0,9999,1
1657447417316,COGS 9,A01,083615,Shannon; Kyle Michael,9,0,75,66
1657447423341,COGS 11,A01,083617,Boyle; Mary E. T.,22,0,48,26
1657447429368,COGS 13,A01,083071,Bastos; Amalia Pinkusfeld,11,0,71,60
1657447435400,COGS 14A,A01,092681,Semenuks; Arturs,5,1,100,95
1657447441434,COGS 14B,A01,083073,Cheng; Tzu-Han,6,0,63,57
1657447447463,COGS 17,A01,092677,Semenuks; Arturs,6,0,81,75
1657447453489,COGS 100,A01,083619,Allen; Michael Gordon,17,0,70,53
1657447459513,COGS 101A,A01,083621,Davis; Joshua Daniel,9,0,68,59
1657447465538,COGS 101B,A01,091572,Allen; Michael Gordon,12,0,65,53
1657447471570,COGS 101C,A01,083625,Delgado; Tania,17,0,35,18
1657447479019,COGS 107A,A01,083627,Boyle; Mary E. T.,13,0,60,47
1657447485062,COGS 118A,A01,083075,Gupta; Anjum,21,0,76,55
1657447491141,CSE 3,A50,083646,Miranda; Gregory Joseph,24,0,50,26
1657447497167,CSE 8A,A50,083650,Miranda; Gregory Joseph,17,1,56,39
1657447503211,CSE 11,A01,083080,Cao; Yingjun,6,15,40,34
1657447509255,CSE 12,A01,083652,Krause-Levy; Sophia Louisa,28,1,120,92
1657447515311,CSE 15L,A01,083654,Morris; Justin Loren,9,0,50,41
1657447515311,CSE 15L,A02,083655,Morris; Justin Loren,9,0,50,41
1657447521337,CSE 20,A01,083657,Tran; Khoa Dang,39,0,80,41
1657447527362,CSE 21,A01,095574,Bach; Quang Tran,22,0,48,26
1657447533412,CSE 30,A01,083084,Eldon; John,5,0,80,75
1657447533412,CSE 30,B01,095061,Bhaskar; Nishant,9,0,50,41
1657447539438,CSE 100,A01,083659,Cao; Yingjun,5,4,70,65
1657447545466,CSE 134B,A01,083661,Powell; Thomas Allan,22,0,100,78
1657447551500,CSE 140,A01,083663,Gungor; Onat,15,0,85,70
1657447557523,CSE 140L,A01,083088,Eldon; John,21,0,100,79
1657447563550,CSE 175,A01,083665,Kumar; Rakesh,3,0,25,22
1657447569577,CSE 190,A00,092507,Dubnov; Shlomo,8,0,20,12
1657447575607,ECE 45,A01,083139,Congero; Spencer William,6,0,75,69
1657447581631,ECE 65,A50,083695,Saad; Andrew S,12,0,30,18
1657447581631,ECE 65,A51,095125,Saad; Andrew S,24,0,26,2
1657447587655,ECE 109,A01,091882,Touri; Behrouz,19,0,70,51
1657447593695,ECE 180,A00,083140,Abi Samra; Nicholas Camill,1,0,30,29
1657447593695,ECE 180,B00,083141,Abi Samra; Nicholas Camill,0,0,30,30
1657447599724,MATH 10A,A01,083735,Patchell; Gregory David,2,0,30,28
1657447599724,MATH 10A,A02,083736,Patchell; Gregory David,20,0,30,10
1657447599724,MATH 10A,A03,083737,Patchell; Gregory David,16,0,30,14
1657447605750,MATH 10B,A01,083207,Lim; Seonhee,8,0,34,26
1657447605750,MATH 10B,A02,083208,Lim; Seonhee,9,0,35,26
1657447605750,MATH 10B,A03,093472,Lim; Seonhee,7,0,34,27
1657447605750,MATH 10B,B01,083739,Sinha; Shubham,12,0,30,18
1657447611789,MATH 18,A01,083743,Cinel; Cameron Alexander,7,0,30,23
1657447611789,MATH 18,A02,083744,Cinel; Cameron Alexander,17,0,30,13
1657447611789,MATH 18,A03,083745,Cinel; Cameron Alexander,9,0,30,21
1657447611789,MATH 18,B01,083748,Rideout; David Porter,5,0,37,32
1657447611789,MATH 18,B02,083749,Rideout; David Porter,5,0,36,31
1657447611789,MATH 18,B03,083750,Rideout; David Porter,3,0,37,34
1657447611789,MATH 18,B04,083751,Rideout; David Porter,6,0,36,30
1657447611789,MATH 18,B05,093473,Rideout; David Porter,6,0,36,30
1657447611789,MATH 18,B06,093474,Rideout; David Porter,6,0,36,30
1657447617813,MATH 20A,A01,083754,Zheng; Zequn,14,0,40,26
1657447623839,MATH 20B,A01,083756,Briones; Jor-el Thomas Caparas,4,0,36,32
1657447623839,MATH 20B,A02,083757,Briones; Jor-el Thomas Caparas,1,0,36,35
1657447623839,MATH 20B,A03,093475,Briones; Jor-el Thomas Caparas,2,0,36,34
1657447629865,MATH 20C,A01,083760,Briones; Jor-el Thomas Caparas,1,0,35,34
1657447629865,MATH 20C,A02,083761,Briones; Jor-el Thomas Caparas,8,0,35,27
1657447629865,MATH 20C,A03,093476,Briones; Jor-el Thomas Caparas,0,1,36,36
1657447629865,MATH 20C,B01,083762,Bach; Quang Tran,1,0,30,29
1657447635889,MATH 20D,A01,083765,Tran; Brian Kha,5,0,30,25
1657447635889,MATH 20D,A02,083766,Tran; Brian Kha,5,0,30,25
1657447635889,MATH 20D,A03,083767,Tran; Brian Kha,5,0,30,25
1657447641920,MATH 20E,A01,083771,Ganguly; Soumya,9,0,32,23
1657447641920,MATH 20E,A02,083772,Ganguly; Soumya,6,0,32,26
1657447641920,MATH 20E,B01,083773,Ciotti; Benjamin,20,0,35,15
1657447641920,MATH 20E,B02,083774,Ciotti; Benjamin,17,0,35,18
1657447647953,MATH 103A,A01,083777,Greenfeld; Be'Eri,3,0,36,33
1657447647953,MATH 103A,A02,083778,Greenfeld; Be'Eri,5,0,36,31
1657447647953,MATH 103A,A03,093561,Greenfeld; Be'Eri,5,0,36,31
1657447647953,MATH 103A,B01,083779,Greenfeld; Be'Eri,7,0,36,29
1657447647953,MATH 103A,B02,083780,Greenfeld; Be'Eri,4,0,36,32
1657447647953,MATH 103A,B03,093562,Greenfeld; Be'Eri,3,0,36,33
1657447653980,MATH 105,A01,085443,Carter; Anne Toulson,15,0,35,20
1657447653980,MATH 105,A02,093477,Carter; Anne Toulson,20,0,35,15
1657447660011,MATH 109,A01,083213,Ganzberger; Geoffrey Michael,2,0,34,32
1657447660011,MATH 109,A02,083214,Ganzberger; Geoffrey Michael,4,0,34,30
1657447660011,MATH 109,A03,093478,Ganzberger; Geoffrey Michael,2,0,34,32
1657447660011,MATH 109,B01,083215,Ganzberger; Geoffrey Michael,1,0,32,31
1657447660011,MATH 109,B02,083216,Ganzberger; Geoffrey Michael,2,0,32,30
1657447660011,MATH 109,B03,093479,Ganzberger; Geoffrey Michael,8,0,32,24
1657447666045,MATH 142A,A01,083219,Chow; Bennett,7,0,32,25
1657447666045,MATH 142A,A02,083220,Chow; Bennett,10,0,32,22
1657447666045,MATH 142A,A03,093480,Chow; Bennett,8,0,32,24
1657447666045,MATH 142A,B03,093481,Chow; Bennett,8,0,32,24
1657447666045,MATH 142A,B04,093558,Chow; Bennett,13,0,32,19
1657447666045,MATH 142A,B05,093559,Chow; Bennett,6,0,32,26
1657447672075,MATH 193A,A01,083224,Rotar; Vladimir,8,0,34,26
1657447672075,MATH 193A,A02,083225,Rotar; Vladimir,9,0,34,25
1657447672075,MATH 193A,A03,083781,Rotar; Vladimir,5,0,34,29
1657447672075,MATH 193A,A04,083782,Rotar; Vladimir,10,0,34,24
1657447672075,MATH 193A,A05,093482,Rotar; Vladimir,10,0,34,24
1657447678099,MATH 197,001,091859,McAuley; Julian John,9999,0,9999,0
1657447678099,MATH 197,002,095566,Kedlaya; Kiran S.,9997,0,9999,2
1657447678099,MATH 197,003,095567,Xiao; Ming,9999,0,9999,0
1657447678099,MATH 197,004,095571,Perols; Johan Lars,9998,0,9999,1
1657447685157,COGS 9,A01,083615,Shannon; Kyle Michael,9,0,75,66
1657447691184,COGS 11,A01,083617,Boyle; Mary E. T.,22,0,48,26
1657447697206,COGS 13,A01,083071,Bastos; Amalia Pinkusfeld,11,0,71,60
1657447703231,COGS 14A,A01,092681,Semenuks; Arturs,5,1,100,95
1657447709264,COGS 14B,A01,083073,Cheng; Tzu-Han,6,0,63,57
1657447715288,COGS 17,A01,092677,Semenuks; Arturs,6,0,81,75
1657447721318,COGS 100,A01,083619,Allen; Michael Gordon,17,0,70,53
1657447727346,COGS 101A,A01,083621,Davis; Joshua Daniel,9,0,68,59
1657447733374,COGS 101B,A01,091572,Allen; Michael Gordon,12,0,65,53
1657447739399,COGS 101C,A01,083625,Delgado; Tania,17,0,35,18
1657447745422,COGS 107A,A01,083627,Boyle; Mary E. T.,13,0,60,47
1657447751446,COGS 118A,A01,083075,Gupta; Anjum,21,0,76,55
1657447757474,CSE 3,A50,083646,Miranda; Gregory Joseph,24,0,50,26
1657447763497,CSE 8A,A50,083650,Miranda; Gregory Joseph,17,1,56,39
1657447769522,CSE 11,A01,083080,Cao; Yingjun,6,15,40,34
1657447775545,CSE 12,A01,083652,Krause-Levy; Sophia Louisa,28,1,120,92
1657447781575,CSE 15L,A01,083654,Morris; Justin Loren,9,0,50,41
1657447781575,CSE 15L,A02,083655,Morris; Justin Loren,9,0,50,41
1657447787599,CSE 20,A01,083657,Tran; Khoa Dang,39,0,80,41
1657447793716,CSE 21,A01,095574,Bach; Quang Tran,22,0,48,26
1657447799741,CSE 30,A01,083084,Eldon; John,5,0,80,75
1657447799741,CSE 30,B01,095061,Bhaskar; Nishant,9,0,50,41
1657447805765,CSE 100,A01,083659,Cao; Yingjun,5,4,70,65
1657447811789,CSE 134B,A01,083661,Powell; Thomas Allan,22,0,100,78
1657447817814,CSE 140,A01,083663,Gungor; Onat,15,0,85,70
1657447823838,CSE 140L,A01,083088,Eldon; John,21,0,100,79
1657447829862,CSE 175,A01,083665,Kumar; Rakesh,3,0,25,22
1657447835897,CSE 190,A00,092507,Dubnov; Shlomo,8,0,20,12
1657447841928,ECE 45,A01,083139,Congero; Spencer William,6,0,75,69
1657447847960,ECE 65,A50,083695,Saad; Andrew S,12,0,30,18
1657447847960,ECE 65,A51,095125,Saad; Andrew S,24,0,26,2
1657447853994,ECE 109,A01,091882,Touri; Behrouz,19,0,70,51
1657447860018,ECE 180,A00,083140,Abi Samra; Nicholas Camill,1,0,30,29
1657447860018,ECE 180,B00,083141,Abi Samra; Nicholas Camill,0,0,30,30
1657447866043,MATH 10A,A01,083735,Patchell; Gregory David,2,0,30,28
1657447866043,MATH 10A,A02,083736,Patchell; Gregory David,20,0,30,10
1657447866043,MATH 10A,A03,083737,Patchell; Gregory David,16,0,30,14
1657447872078,MATH 10B,A01,083207,Lim; Seonhee,8,0,34,26
1657447872078,MATH 10B,A02,083208,Lim; Seonhee,9,0,35,26
1657447872078,MATH 10B,A03,093472,Lim; Seonhee,7,0,34,27
1657447872078,MATH 10B,B01,083739,Sinha; Shubham,12,0,30,18
1657447878105,MATH 18,A01,083743,Cinel; Cameron Alexander,7,0,30,23
1657447878105,MATH 18,A02,083744,Cinel; Cameron Alexander,17,0,30,13
1657447878105,MATH 18,A03,083745,Cinel; Cameron Alexander,9,0,30,21
1657447878105,MATH 18,B01,083748,Rideout; David Porter,5,0,37,32
1657447878105,MATH 18,B02,083749,Rideout; David Porter,5,0,36,31
1657447878105,MATH 18,B03,083750,Rideout; David Porter,3,0,37,34
1657447878105,MATH 18,B04,083751,Rideout; David Porter,6,0,36,30
1657447878105,MATH 18,B05,093473,Rideout; David Porter,6,0,36,30
1657447878105,MATH 18,B06,093474,Rideout; David Porter,6,0,36,30
1657447884135,MATH 20A,A01,083754,Zheng; Zequn,14,0,40,26
1657447890159,MATH 20B,A01,083756,Briones; Jor-el Thomas Caparas,4,0,36,32
1657447890159,MATH 20B,A02,083757,Briones; Jor-el Thomas Caparas,1,0,36,35
1657447890159,MATH 20B,A03,093475,Briones; Jor-el Thomas Caparas,2,0,36,34
1657447896196,MATH 20C,A01,083760,Briones; Jor-el Thomas Caparas,1,0,35,34
1657447896196,MATH 20C,A02,083761,Briones; Jor-el Thomas Caparas,8,0,35,27
1657447896196,MATH 20C,A03,093476,Briones; Jor-el Thomas Caparas,0,1,36,36
1657447896196,MATH 20C,B01,083762,Bach; Quang Tran,1,0,30,29
1657447902223,MATH 20D,A01,083765,Tran; Brian Kha,5,0,30,25
1657447902223,MATH 20D,A02,083766,Tran; Brian Kha,5,0,30,25
1657447902223,MATH 20D,A03,083767,Tran; Brian Kha,5,0,30,25
1657447908255,MATH 20E,A01,083771,Ganguly; Soumya,9,0,32,23
1657447908255,MATH 20E,A02,083772,Ganguly; Soumya,6,0,32,26
1657447908255,MATH 20E,B01,083773,Ciotti; Benjamin,20,0,35,15
1657447908255,MATH 20E,B02,083774,Ciotti; Benjamin,17,0,35,18
1657447914279,MATH 103A,A01,083777,Greenfeld; Be'Eri,3,0,36,33
1657447914279,MATH 103A,A02,083778,Greenfeld; Be'Eri,5,0,36,31
1657447914279,MATH 103A,A03,093561,Greenfeld; Be'Eri,5,0,36,31
1657447914279,MATH 103A,B01,083779,Greenfeld; Be'Eri,7,0,36,29
1657447914279,MATH 103A,B02,083780,Greenfeld; Be'Eri,4,0,36,32
1657447914279,MATH 103A,B03,093562,Greenfeld; Be'Eri,3,0,36,33
1657447920307,MATH 105,A01,085443,Carter; Anne Toulson,15,0,35,20
1657447920307,MATH 105,A02,093477,Carter; Anne Toulson,20,0,35,15
1657447926332,MATH 109,A01,083213,Ganzberger; Geoffrey Michael,2,0,34,32
1657447926332,MATH 109,A02,083214,Ganzberger; Geoffrey Michael,4,0,34,30
1657447926332,MATH 109,A03,093478,Ganzberger; Geoffrey Michael,2,0,34,32
1657447926332,MATH 109,B01,083215,Ganzberger; Geoffrey Michael,1,0,32,31
1657447926332,MATH 109,B02,083216,Ganzberger; Geoffrey Michael,2,0,32,30
1657447926332,MATH 109,B03,093479,Ganzberger; Geoffrey Michael,8,0,32,24
1657447932368,MATH 142A,A01,083219,Chow; Bennett,7,0,32,25
1657447932368,MATH 142A,A02,083220,Chow; Bennett,10,0,32,22
1657447932368,MATH 142A,A03,093480,Chow; Bennett,8,0,32,24
1657447932368,MATH 142A,B03,093481,Chow; Bennett,8,0,32,24
1657447932368,MATH 142A,B04,093558,Chow; Bennett,13,0,32,19
1657447932368,MATH 142A,B05,093559,Chow; Bennett,6,0,32,26
1657447938400,MATH 193A,A01,083224,Rotar; Vladimir,8,0,34,26
1657447938400,MATH 193A,A02,083225,Rotar; Vladimir,9,0,34,25
1657447938400,MATH 193A,A03,083781,Rotar; Vladimir,5,0,34,29
1657447938400,MATH 193A,A04,083782,Rotar; Vladimir,10,0,34,24
1657447938400,MATH 193A,A05,093482,Rotar; Vladimir,10,0,34,24
1657447944425,MATH 197,001,091859,McAuley; Julian John,9999,0,9999,0
1657447944425,MATH 197,002,095566,Kedlaya; Kiran S.,9997,0,9999,2
1657447944425,MATH 197,003,095567,Xiao; Ming,9999,0,9999,0
1657447944425,MATH 197,004,095571,Perols; Johan Lars,9998,0,9999,1
1657447951488,COGS 9,A01,083615,Shannon; Kyle Michael,9,0,75,66
1657447957513,COGS 11,A01,083617,Boyle; Mary E. T.,22,0,48,26
1657447963547,COGS 13,A01,083071,Bastos; Amalia Pinkusfeld,11,0,71,60
1657447969575,COGS 14A,A01,092681,Semenuks; Arturs,5,1,100,95
1657447975606,COGS 14B,A01,083073,Cheng; Tzu-Han,6,0,63,57
1657447981631,COGS 17,A01,092677,Semenuks; Arturs,6,0,81,75
1657447987657,COGS 100,A01,083619,Allen; Michael Gordon,17,0,70,53
1657447993681,COGS 101A,A01,083621,Davis; Joshua Daniel,9,0,68,59
1657447999705,COGS 101B,A01,091572,Allen; Michael Gordon,12,0,65,53
1657448005729,COGS 101C,A01,083625,Delgado; Tania,17,0,35,18
1657448011753,COGS 107A,A01,083627,Boyle; Mary E. T.,13,0,60,47
1657448017777,COGS 118A,A01,083075,Gupta; Anjum,21,0,76,55
1657448023801,CSE 3,A50,083646,Miranda; Gregory Joseph,24,0,50,26
1657448029824,CSE 8A,A50,083650,Miranda; Gregory Joseph,17,1,56,39
1657448035858,CSE 11,A01,083080,Cao; Yingjun,6,15,40,34
1657448041888,CSE 12,A01,083652,Krause-Levy; Sophia Louisa,28,1,120,92
1657448047918,CSE 15L,A01,083654,Morris; Justin Loren,9,0,50,41
1657448047918,CSE 15L,A02,083655,Morris; Justin Loren,9,0,50,41
1657448053948,CSE 20,A01,083657,Tran; Khoa Dang,39,0,80,41
1657448059973,CSE 21,A01,095574,Bach; Quang Tran,22,0,48,26
1657448066000,CSE 30,A01,083084,Eldon; John,5,0,80,75
1657448066000,CSE 30,B01,095061,Bhaskar; Nishant,9,0,50,41
1657448072025,CSE 100,A01,083659,Cao; Yingjun,5,4,70,65
1657448078049,CSE 134B,A01,083661,Powell; Thomas Allan,22,0,100,78
1657448084072,CSE 140,A01,083663,Gungor; Onat,15,0,85,70
1657448090098,CSE 140L,A01,083088,Eldon; John,21,0,100,79
1657448096122,CSE 175,A01,083665,Kumar; Rakesh,3,0,25,22
1657448102174,CSE 190,A00,092507,Dubnov; Shlomo,8,0,20,12
1657448108199,ECE 45,A01,083139,Congero; Spencer William,6,0,75,69
1657448114228,ECE 65,A50,083695,Saad; Andrew S,12,0,30,18
1657448114228,ECE 65,A51,095125,Saad; Andrew S,24,0,26,2
1657448120253,ECE 109,A01,091882,Touri; Behrouz,19,0,70,51
1657448126278,ECE 180,A00,083140,Abi Samra; Nicholas Camill,1,0,30,29
1657448126278,ECE 180,B00,083141,Abi Samra; Nicholas Camill,0,0,30,30
1657448132305,MATH 10A,A01,083735,Patchell; Gregory David,2,0,30,28
1657448132305,MATH 10A,A02,083736,Patchell; Gregory David,20,0,30,10
1657448132305,MATH 10A,A03,083737,Patchell; Gregory David,16,0,30,14
1657448138331,MATH 10B,A01,083207,Lim; Seonhee,8,0,34,26
1657448138331,MATH 10B,A02,083208,Lim; Seonhee,9,0,35,26
1657448138331,MATH 10B,A03,093472,Lim; Seonhee,7,0,34,27
1657448138331,MATH 10B,B01,083739,Sinha; Shubham,12,0,30,18
1657448144370,MATH 18,A01,083743,Cinel; Cameron Alexander,7,0,30,23
1657448144370,MATH 18,A02,083744,Cinel; Cameron Alexander,17,0,30,13
1657448144370,MATH 18,A03,083745,Cinel; Cameron Alexander,9,0,30,21
1657448144370,MATH 18,B01,083748,Rideout; David Porter,5,0,37,32
1657448144370,MATH 18,B02,083749,Rideout; David Porter,5,0,36,31
1657448144370,MATH 18,B03,083750,Rideout; David Porter,3,0,37,34
1657448144370,MATH 18,B04,083751,Rideout; David Porter,6,0,36,30
1657448144370,MATH 18,B05,093473,Rideout; David Porter,6,0,36,30
1657448144370,MATH 18,B06,093474,Rideout; David Porter,6,0,36,30
1657448150394,MATH 20A,A01,083754,Zheng; Zequn,14,0,40,26
1657448156419,MATH 20B,A01,083756,Briones; Jor-el Thomas Caparas,4,0,36,32
1657448156419,MATH 20B,A02,083757,Briones; Jor-el Thomas Caparas,1,0,36,35
1657448156419,MATH 20B,A03,093475,Briones; Jor-el Thomas Caparas,2,0,36,34
1657448162444,MATH 20C,A01,083760,Briones; Jor-el Thomas Caparas,1,0,35,34
1657448162444,MATH 20C,A02,083761,Briones; Jor-el Thomas Caparas,8,0,35,27
1657448162444,MATH 20C,A03,093476,Briones; Jor-el Thomas Caparas,0,1,36,36
1657448162444,MATH 20C,B01,083762,Bach; Quang Tran,1,0,30,29
1657448168469,MATH 20D,A01,083765,Tran; Brian Kha,5,0,30,25
1657448168469,MATH 20D,A02,083766,Tran; Brian Kha,5,0,30,25
1657448168469,MATH 20D,A03,083767,Tran; Brian Kha,5,0,30,25
1657448174496,MATH 20E,A01,083771,Ganguly; Soumya,9,0,32,23
1657448174496,MATH 20E,A02,083772,Ganguly; Soumya,6,0,32,26
1657448174496,MATH 20E,B01,083773,Ciotti; Benjamin,20,0,35,15
1657448174496,MATH 20E,B02,083774,Ciotti; Benjamin,17,0,35,18
1657448180521,MATH 103A,A01,083777,Greenfeld; Be'Eri,3,0,36,33
1657448180521,MATH 103A,A02,083778,Greenfeld; Be'Eri,5,0,36,31
1657448180521,MATH 103A,A03,093561,Greenfeld; Be'Eri,5,0,36,31
1657448180521,MATH 103A,B01,083779,Greenfeld; Be'Eri,7,0,36,29
1657448180521,MATH 103A,B02,083780,Greenfeld; Be'Eri,4,0,36,32
1657448180521,MATH 103A,B03,093562,Greenfeld; Be'Eri,3,0,36,33
1657448186553,MATH 105,A01,085443,Carter; Anne Toulson,15,0,35,20
1657448186553,MATH 105,A02,093477,Carter; Anne Toulson,20,0,35,15
1657448192579,MATH 109,A01,083213,Ganzberger; Geoffrey Michael,2,0,34,32
1657448192579,MATH 109,A02,083214,Ganzberger; Geoffrey Michael,4,0,34,30
1657448192579,MATH 109,A03,093478,Ganzberger; Geoffrey Michael,2,0,34,32
1657448192579,MATH 109,B01,083215,Ganzberger; Geoffrey Michael,1,0,32,31
1657448192579,MATH 109,B02,083216,Ganzberger; Geoffrey Michael,2,0,32,30
1657448192579,MATH 109,B03,093479,Ganzberger; Geoffrey Michael,8,0,32,24
1657448198608,MATH 142A,A01,083219,Chow; Bennett,7,0,32,25
1657448198608,MATH 142A,A02,083220,Chow; Bennett,10,0,32,22
1657448198608,MATH 142A,A03,093480,Chow; Bennett,8,0,32,24
1657448198608,MATH 142A,B03,093481,Chow; Bennett,8,0,32,24
1657448198608,MATH 142A,B04,093558,Chow; Bennett,13,0,32,19
1657448198608,MATH 142A,B05,093559,Chow; Bennett,6,0,32,26
1657448204641,MATH 193A,A01,083224,Rotar; Vladimir,8,0,34,26
1657448204641,MATH 193A,A02,083225,Rotar; Vladimir,9,0,34,25
1657448204641,MATH 193A,A03,083781,Rotar; Vladimir,5,0,34,29
1657448204641,MATH 193A,A04,083782,Rotar; Vladimir,10,0,34,24
1657448204641,MATH 193A,A05,093482,Rotar; Vladimir,10,0,34,24
1657448210671,MATH 197,001,091859,McAuley; Julian John,9999,0,9999,0
1657448210671,MATH 197,002,095566,Kedlaya; Kiran S.,9997,0,9999,2
1657448210671,MATH 197,003,095567,Xiao; Ming,9999,0,9999,0
1657448210671,MATH 197,004,095571,Perols; Johan Lars,9998,0,9999,1
1657448217743,COGS 9,A01,083615,Shannon; Kyle Michael,9,0,75,66
1657448223775,COGS 11,A01,083617,Boyle; Mary E. T.,22,0,48,26
1657448229805,COGS 13,A01,083071,Bastos; Amalia Pinkusfeld,11,0,71,60
1657448235831,COGS 14A,A01,092681,Semenuks; Arturs,5,1,100,95
1657448241858,COGS 14B,A01,083073,Cheng; Tzu-Han,6,0,63,57
1657448247883,COGS 17,A01,092677,Semenuks; Arturs,6,0,81,75
1657448253920,COGS 100,A01,083619,Allen; Michael Gordon,17,0,70,53
1657448259944,COGS 101A,A01,083621,Davis; Joshua Daniel,9,0,68,59
1657448265974,COGS 101B,A01,091572,Allen; Michael Gordon,12,0,65,53
1657448272004,COGS 101C,A01,083625,Delgado; Tania,17,0,35,18
1657448278028,COGS 107A,A01,083627,Boyle; Mary E. T.,13,0,60,47
1657448284051,COGS 118A,A01,083075,Gupta; Anjum,21,0,76,55
1657448290084,CSE 3,A50,083646,Miranda; Gregory Joseph,24,0,50,26
1657448296110,CSE 8A,A50,083650,Miranda; Gregory Joseph,17,1,56,39
1657448302139,CSE 11,A01,083080,Cao; Yingjun,6,15,40,34
1657448308162,CSE 12,A01,083652,Krause-Levy; Sophia Louisa,28,1,120,92
1657448314186,CSE 15L,A01,083654,Morris; Justin Loren,9,0,50,41
1657448314186,CSE 15L,A02,083655,Morris; Justin Loren,9,0,50,41
1657448320216,CSE 20,A01,083657,Tran; Khoa Dang,39,0,80,41
1657448326240,CSE 21,A01,095574,Bach; Quang Tran,22,0,48,26
1657448332265,CSE 30,A01,083084,Eldon; John,5,0,80,75
1657448332265,CSE 30,B01,095061,Bhaskar; Nishant,9,0,50,41
1657448338290,CSE 100,A01,083659,Cao; Yingjun,5,4,70,65
1657448344312,CSE 134B,A01,083661,Powell; Thomas Allan,22,0,100,78
1657448350342,CSE 140,A01,083663,Gungor; Onat,15,0,85,70
1657448356372,CSE 140L,A01,083088,Eldon; John,21,0,100,79
1657448362403,CSE 175,A01,083665,Kumar; Rakesh,3,0,25,22
1657448368432,CSE 190,A00,092507,Dubnov; Shlomo,8,0,20,12
1657448374463,ECE 45,A01,083139,Congero; Spencer William,6,0,75,69
1657448380487,ECE 65,A50,083695,Saad; Andrew S,12,0,30,18
1657448380487,ECE 65,A51,095125,Saad; Andrew S,24,0,26,2
1657448386512,ECE 109,A01,091882,Touri; Behrouz,19,0,70,51
1657448392616,ECE 180,A00,083140,Abi Samra; Nicholas Camill,1,0,30,29
1657448392616,ECE 180,B00,083141,Abi Samra; Nicholas Camill,0,0,30,30
1657448398643,MATH 10A,A01,083735,Patchell; Gregory David,2,0,30,28
1657448398643,MATH 10A,A02,083736,Patchell; Gregory David,20,0,30,10
1657448398643,MATH 10A,A03,083737,Patchell; Gregory David,16,0,30,14
1657448404683,MATH 10B,A01,083207,Lim; Seonhee,8,0,34,26
1657448404683,MATH 10B,A02,083208,Lim; Seonhee,9,0,35,26
1657448404683,MATH 10B,A03,093472,Lim; Seonhee,7,0,34,27
1657448404683,MATH 10B,B01,083739,Sinha; Shubham,12,0,30,18
1657448410711,MATH 18,A01,083743,Cinel; Cameron Alexander,7,0,30,23
1657448410711,MATH 18,A02,083744,Cinel; Cameron Alexander,17,0,30,13
1657448410711,MATH 18,A03,083745,Cinel; Cameron Alexander,9,0,30,21
1657448410711,MATH 18,B01,083748,Rideout; David Porter,5,0,37,32
1657448410711,MATH 18,B02,083749,Rideout; David Porter,5,0,36,31
1657448410711,MATH 18,B03,083750,Rideout; David Porter,3,0,37,34
1657448410711,MATH 18,B04,083751,Rideout; David Porter,6,0,36,30
1657448410711,MATH 18,B05,093473,Rideout; David Porter,6,0,36,30
1657448410711,MATH 18,B06,093474,Rideout; David Porter,6,0,36,30
1657448416738,MATH 20A,A01,083754,Zheng; Zequn,14,0,40,26
1657448422765,MATH 20B,A01,083756,Briones; Jor-el Thomas Caparas,4,0,36,32
1657448422765,MATH 20B,A02,083757,Briones; Jor-el Thomas Caparas,1,0,36,35
1657448422765,MATH 20B,A03,093475,Briones; Jor-el Thomas Caparas,2,0,36,34
1657448428796,MATH 20C,A01,083760,Briones; Jor-el Thomas Caparas,1,0,35,34
1657448428796,MATH 20C,A02,083761,Briones; Jor-el Thomas Caparas,8,0,35,27
1657448428796,MATH 20C,A03,093476,Briones; Jor-el Thomas Caparas,0,1,36,36
1657448428796,MATH 20C,B01,083762,Bach; Quang Tran,1,0,30,29
1657448434822,MATH 20D,A01,083765,Tran; Brian Kha,5,0,30,25
1657448434822,MATH 20D,A02,083766,Tran; Brian Kha,5,0,30,25
1657448434822,MATH 20D,A03,083767,Tran; Brian Kha,5,0,30,25
1657448440855,MATH 20E,A01,083771,Ganguly; Soumya,9,0,32,23
1657448440855,MATH 20E,A02,083772,Ganguly; Soumya,6,0,32,26
1657448440855,MATH 20E,B01,083773,Ciotti; Benjamin,20,0,35,15
1657448440855,MATH 20E,B02,083774,Ciotti; Benjamin,17,0,35,18
1657448446882,MATH 103A,A01,083777,Greenfeld; Be'Eri,3,0,36,33
1657448446882,MATH 103A,A02,083778,Greenfeld; Be'Eri,5,0,36,31
1657448446882,MATH 103A,A03,093561,Greenfeld; Be'Eri,5,0,36,31
1657448446882,MATH 103A,B01,083779,Greenfeld; Be'Eri,7,0,36,29
1657448446882,MATH 103A,B02,083780,Greenfeld; Be'Eri,4,0,36,32
1657448446882,MATH 103A,B03,093562,Greenfeld; Be'Eri,3,0,36,33
1657448452913,MATH 105,A01,085443,Carter; Anne Toulson,15,0,35,20
1657448452913,MATH 105,A02,093477,Carter; Anne Toulson,20,0,35,15
1657448458938,MATH 109,A01,083213,Ganzberger; Geoffrey Michael,2,0,34,32
1657448458938,MATH 109,A02,083214,Ganzberger; Geoffrey Michael,4,0,34,30
1657448458938,MATH 109,A03,093478,Ganzberger; Geoffrey Michael,2,0,34,32
1657448458938,MATH 109,B01,083215,Ganzberger; Geoffrey Michael,1,0,32,31
1657448458938,MATH 109,B02,083216,Ganzberger; Geoffrey Michael,2,0,32,30
1657448458938,MATH 109,B03,093479,Ganzberger; Geoffrey Michael,8,0,32,24
1657448464974,MATH 142A,A01,083219,Chow; Bennett,7,0,32,25
1657448464974,MATH 142A,A02,083220,Chow; Bennett,10,0,32,22
1657448464974,MATH 142A,A03,093480,Chow; Bennett,8,0,32,24
1657448464974,MATH 142A,B03,093481,Chow; Bennett,8,0,32,24
1657448464974,MATH 142A,B04,093558,Chow; Bennett,13,0,32,19
1657448464974,MATH 142A,B05,093559,Chow; Bennett,6,0,32,26
1657448471139,MATH 193A,A01,083224,Rotar; Vladimir,8,0,34,26
1657448471139,MATH 193A,A02,083225,Rotar; Vladimir,9,0,34,25
1657448471139,MATH 193A,A03,083781,Rotar; Vladimir,5,0,34,29
1657448471139,MATH 193A,A04,083782,Rotar; Vladimir,10,0,34,24
1657448471139,MATH 193A,A05,093482,Rotar; Vladimir,10,0,34,24
1657448477163,MATH 197,001,091859,McAuley; Julian John,9999,0,9999,0
1657448477163,MATH 197,002,095566,Kedlaya; Kiran S.,9997,0,9999,2
1657448477163,MATH 197,003,095567,Xiao; Ming,9999,0,9999,0
1657448477163,MATH 197,004,095571,Perols; Johan Lars,9998,0,9999,1
1657448484244,COGS 9,A01,083615,Shannon; Kyle Michael,9,0,75,66
1657448490268,COGS 11,A01,083617,Boyle; Mary E. T.,22,0,48,26
1657448496320,COGS 13,A01,083071,Bastos; Amalia Pinkusfeld,11,0,71,60
1657448502345,COGS 14A,A01,092681,Semenuks; Arturs,5,1,100,95
1657448508375,COGS 14B,A01,083073,Cheng; Tzu-Han,6,0,63,57
1657448514402,COGS 17,A01,092677,Semenuks; Arturs,6,0,81,75
1657448520429,COGS 100,A01,083619,Allen; Michael Gordon,17,0,70,53
1657448526460,COGS 101A,A01,083621,Davis; Joshua Daniel,9,0,68,59
1657448532485,COGS 101B,A01,091572,Allen; Michael Gordon,12,0,65,53
1657448538514,COGS 101C,A01,083625,Delgado; Tania,17,0,35,18
1657448544540,COGS 107A,A01,083627,Boyle; Mary E. T.,13,0,60,47
1657448550569,COGS 118A,A01,083075,Gupta; Anjum,21,0,76,55
1657448556603,CSE 3,A50,083646,Miranda; Gregory Joseph,24,0,50,26
1657448562629,CSE 8A,A50,083650,Miranda; Gregory Joseph,17,1,56,39
1657448568654,CSE 11,A01,083080,Cao; Yingjun,6,15,40,34
1657448574678,CSE 12,A01,083652,Krause-Levy; Sophia Louisa,28,1,120,92
1657448580703,CSE 15L,A01,083654,Morris; Justin Loren,9,0,50,41
1657448580703,CSE 15L,A02,083655,Morris; Justin Loren,9,0,50,41
1657448586728,CSE 20,A01,083657,Tran; Khoa Dang,39,0,80,41
1657448592757,CSE 21,A01,095574,Bach; Quang Tran,22,0,48,26
1657448598783,CSE 30,A01,083084,Eldon; John,5,0,80,75
1657448598783,CSE 30,B01,095061,Bhaskar; Nishant,9,0,50,41
1657448604809,CSE 100,A01,083659,Cao; Yingjun,5,4,70,65
1657448610832,CSE 134B,A01,083661,Powell; Thomas Allan,22,0,100,78
1657448616860,CSE 140,A01,083663,Gungor; Onat,15,0,85,70
1657448622891,CSE 140L,A01,083088,Eldon; John,21,0,100,79
1657448628921,CSE 175,A01,083665,Kumar; Rakesh,3,0,25,22
1657448634959,CSE 190,A00,092507,Dubnov; Shlomo,8,0,20,12
1657448640987,ECE 45,A01,083139,Congero; Spencer William,6,0,75,69
1657448647035,ECE 65,A50,083695,Saad; Andrew S,12,0,30,18
1657448647035,ECE 65,A51,095125,Saad; Andrew S,24,0,26,2
1657448653065,ECE 109,A01,091882,Touri; Behrouz,19,0,70,51
1657448659089,ECE 180,A00,083140,Abi Samra; Nicholas Camill,1,0,30,29
1657448659089,ECE 180,B00,083141,Abi Samra; Nicholas Camill,0,0,30,30
1657448665121,MATH 10A,A01,083735,Patchell; Gregory David,2,0,30,28
1657448665121,MATH 10A,A02,083736,Patchell; Gregory David,20,0,30,10
1657448665121,MATH 10A,A03,083737,Patchell; Gregory David,16,0,30,14
1657448671161,MATH 10B,A01,083207,Lim; Seonhee,8,0,34,26
1657448671161,MATH 10B,A02,083208,Lim; Seonhee,9,0,35,26
1657448671161,MATH 10B,A03,093472,Lim; Seonhee,7,0,34,27
1657448671161,MATH 10B,B01,083739,Sinha; Shubham,12,0,30,18
1657448677190,MATH 18,A01,083743,Cinel; Cameron Alexander,7,0,30,23
1657448677190,MATH 18,A02,083744,Cinel; Cameron Alexander,17,0,30,13
1657448677190,MATH 18,A03,083745,Cinel; Cameron Alexander,9,0,30,21
1657448677190,MATH 18,B01,083748,Rideout; David Porter,5,0,37,32
1657448677190,MATH 18,B02,083749,Rideout; David Porter,5,0,36,31
1657448677190,MATH 18,B03,083750,Rideout; David Porter,3,0,37,34
1657448677190,MATH 18,B04,083751,Rideout; David Porter,6,0,36,30
1657448677190,MATH 18,B05,093473,Rideout; David Porter,6,0,36,30
1657448677190,MATH 18,B06,093474,Rideout; David Porter,6,0,36,30
1657448683215,MATH 20A,A01,083754,Zheng; Zequn,14,0,40,26
1657448689242,MATH 20B,A01,083756,Briones; Jor-el Thomas Caparas,4,0,36,32
1657448689242,MATH 20B,A02,083757,Briones; Jor-el Thomas Caparas,1,0,36,35
1657448689242,MATH 20B,A03,093475,Briones; Jor-el Thomas Caparas,2,0,36,34
1657448695268,MATH 20C,A01,083760,Briones; Jor-el Thomas Caparas,1,0,35,34
1657448695268,MATH 20C,A02,083761,Briones; Jor-el Thomas Caparas,8,0,35,27
1657448695268,MATH 20C,A03,093476,Briones; Jor-el Thomas Caparas,0,1,36,36
1657448695268,MATH 20C,B01,083762,Bach; Quang Tran,1,0,30,29
1657448701291,MATH 20D,A01,083765,Tran; Brian Kha,5,0,30,25
1657448701291,MATH 20D,A02,083766,Tran; Brian Kha,5,0,30,25
1657448701291,MATH 20D,A03,083767,Tran; Brian Kha,5,0,30,25
1657448707318,MATH 20E,A01,083771,Ganguly; Soumya,9,0,32,23
1657448707318,MATH 20E,A02,083772,Ganguly; Soumya,6,0,32,26
1657448707318,MATH 20E,B01,083773,Ciotti; Benjamin,20,0,35,15
1657448707318,MATH 20E,B02,083774,Ciotti; Benjamin,17,0,35,18
1657448713347,MATH 103A,A01,083777,Greenfeld; Be'Eri,3,0,36,33
1657448713347,MATH 103A,A02,083778,Greenfeld; Be'Eri,5,0,36,31
1657448713347,MATH 103A,A03,093561,Greenfeld; Be'Eri,5,0,36,31
1657448713347,MATH 103A,B01,083779,Greenfeld; Be'Eri,7,0,36,29
1657448713347,MATH 103A,B02,083780,Greenfeld; Be'Eri,4,0,36,32
1657448713347,MATH 103A,B03,093562,Greenfeld; Be'Eri,3,0,36,33
1657448719373,MATH 105,A01,085443,Carter; Anne Toulson,15,0,35,20
1657448719373,MATH 105,A02,093477,Carter; Anne Toulson,20,0,35,15
1657448725399,MATH 109,A01,083213,Ganzberger; Geoffrey Michael,2,0,34,32
1657448725399,MATH 109,A02,083214,Ganzberger; Geoffrey Michael,4,0,34,30
1657448725399,MATH 109,A03,093478,Ganzberger; Geoffrey Michael,2,0,34,32
1657448725399,MATH 109,B01,083215,Ganzberger; Geoffrey Michael,1,0,32,31
1657448725399,MATH 109,B02,083216,Ganzberger; Geoffrey Michael,2,0,32,30
1657448725399,MATH 109,B03,093479,Ganzberger; Geoffrey Michael,8,0,32,24
1657448731427,MATH 142A,A01,083219,Chow; Bennett,7,0,32,25
1657448731427,MATH 142A,A02,083220,Chow; Bennett,10,0,32,22
1657448731427,MATH 142A,A03,093480,Chow; Bennett,8,0,32,24
1657448731427,MATH 142A,B03,093481,Chow; Bennett,8,0,32,24
1657448731427,MATH 142A,B04,093558,Chow; Bennett,13,0,32,19
1657448731427,MATH 142A,B05,093559,Chow; Bennett,6,0,32,26
1657448737462,MATH 193A,A01,083224,Rotar; Vladimir,8,0,34,26
1657448737462,MATH 193A,A02,083225,Rotar; Vladimir,9,0,34,25
1657448737462,MATH 193A,A03,083781,Rotar; Vladimir,5,0,34,29
1657448737462,MATH 193A,A04,083782,Rotar; Vladimir,10,0,34,24
1657448737462,MATH 193A,A05,093482,Rotar; Vladimir,10,0,34,24
1657448743490,MATH 197,001,091859,McAuley; Julian John,9999,0,9999,0
1657448743490,MATH 197,002,095566,Kedlaya; Kiran S.,9997,0,9999,2
1657448743490,MATH 197,003,095567,Xiao; Ming,9999,0,9999,0
1657448743490,MATH 197,004,095571,Perols; Johan Lars,9998,0,9999,1
1657448750556,COGS 9,A01,083615,Shannon; Kyle Michael,9,0,75,66
1657448756581,COGS 11,A01,083617,Boyle; Mary E. T.,22,0,48,26
1657448762610,COGS 13,A01,083071,Bastos; Amalia Pinkusfeld,11,0,71,60
1657448768641,COGS 14A,A01,092681,Semenuks; Arturs,5,1,100,95
1657448774668,COGS 14B,A01,083073,Cheng; Tzu-Han,6,0,63,57
1657448780695,COGS 17,A01,092677,Semenuks; Arturs,6,0,81,75
1657448786733,COGS 100,A01,083619,Allen; Michael Gordon,17,0,70,53
1657448792762,COGS 101A,A01,083621,Davis; Joshua Daniel,9,0,68,59
1657448798792,COGS 101B,A01,091572,Allen; Michael Gordon,12,0,65,53
1657448804820,COGS 101C,A01,083625,Delgado; Tania,17,0,35,18
1657448810846,COGS 107A,A01,083627,Boyle; Mary E. T.,13,0,60,47
1657448816877,COGS 118A,A01,083075,Gupta; Anjum,21,0,76,55
1657448822904,CSE 3,A50,083646,Miranda; Gregory Joseph,24,0,50,26
1657448828939,CSE 8A,A50,083650,Miranda; Gregory Joseph,17,1,56,39
1657448834971,CSE 11,A01,083080,Cao; Yingjun,6,15,40,34
1657448841002,CSE 12,A01,083652,Krause-Levy; Sophia Louisa,28,1,120,92
1657448847031,CSE 15L,A01,083654,Morris; Justin Loren,9,0,50,41
1657448847031,CSE 15L,A02,083655,Morris; Justin Loren,9,0,50,41
1657448853060,CSE 20,A01,083657,Tran; Khoa Dang,39,0,80,41
1657448859091,CSE 21,A01,095574,Bach; Quang Tran,22,0,48,26
1657448865115,CSE 30,A01,083084,Eldon; John,5,0,80,75
1657448865115,CSE 30,B01,095061,Bhaskar; Nishant,9,0,50,41
1657448871157,CSE 100,A01,083659,Cao; Yingjun,5,4,70,65
1657448877180,CSE 134B,A01,083661,Powell; Thomas Allan,22,0,100,78
1657448883210,CSE 140,A01,083663,Gungor; Onat,15,0,85,70
1657448889235,CSE 140L,A01,083088,Eldon; John,21,0,100,79
1657448895260,CSE 175,A01,083665,Kumar; Rakesh,3,0,25,22
1657448901284,CSE 190,A00,092507,Dubnov; Shlomo,8,0,20,12
1657448907308,ECE 45,A01,083139,Congero; Spencer William,6,0,75,69
1657448913340,ECE 65,A50,083695,Saad; Andrew S,12,0,30,18
1657448913340,ECE 65,A51,095125,Saad; Andrew S,24,0,26,2
1657448919370,ECE 109,A01,091882,Touri; Behrouz,19,0,70,51
1657448925394,ECE 180,A00,083140,Abi Samra; Nicholas Camill,1,0,30,29
1657448925394,ECE 180,B00,083141,Abi Samra; Nicholas Camill,0,0,30,30
1657448931423,MATH 10A,A01,083735,Patchell; Gregory David,2,0,30,28
1657448931423,MATH 10A,A02,083736,Patchell; Gregory David,20,0,30,10
1657448931423,MATH 10A,A03,083737,Patchell; Gregory David,16,0,30,14
1657448937451,MATH 10B,A01,083207,Lim; Seonhee,8,0,34,26
1657448937451,MATH 10B,A02,083208,Lim; Seonhee,9,0,35,26
1657448937451,MATH 10B,A03,093472,Lim; Seonhee,7,0,34,27
1657448937451,MATH 10B,B01,083739,Sinha; Shubham,12,0,30,18
1657448943480,MATH 18,A01,083743,Cinel; Cameron Alexander,7,0,30,23
1657448943480,MATH 18,A02,083744,Cinel; Cameron Alexander,17,0,30,13
1657448943480,MATH 18,A03,083745,Cinel; Cameron Alexander,9,0,30,21
1657448943480,MATH 18,B01,083748,Rideout; David Porter,5,0,37,32
1657448943480,MATH 18,B02,083749,Rideout; David Porter,5,0,36,31
1657448943480,MATH 18,B03,083750,Rideout; David Porter,3,0,37,34
1657448943480,MATH 18,B04,083751,Rideout; David Porter,6,0,36,30
1657448943480,MATH 18,B05,093473,Rideout; David Porter,6,0,36,30
1657448943480,MATH 18,B06,093474,Rideout; David Porter,6,0,36,30
1657448949505,MATH 20A,A01,083754,Zheng; Zequn,14,0,40,26
1657448955530,MATH 20B,A01,083756,Briones; Jor-el Thomas Caparas,4,0,36,32
1657448955530,MATH 20B,A02,083757,Briones; Jor-el Thomas Caparas,1,0,36,35
1657448955530,MATH 20B,A03,093475,Briones; Jor-el Thomas Caparas,2,0,36,34
1657448961561,MATH 20C,A01,083760,Briones; Jor-el Thomas Caparas,1,0,35,34
1657448961561,MATH 20C,A02,083761,Briones; Jor-el Thomas Caparas,8,0,35,27
1657448961561,MATH 20C,A03,093476,Briones; Jor-el Thomas Caparas,0,1,36,36
1657448961561,MATH 20C,B01,083762,Bach; Quang Tran,1,0,30,29
1657448967592,MATH 20D,A01,083765,Tran; Brian Kha,5,0,30,25
1657448967592,MATH 20D,A02,083766,Tran; Brian Kha,5,0,30,25
1657448967592,MATH 20D,A03,083767,Tran; Brian Kha,5,0,30,25
1657448973628,MATH 20E,A01,083771,Ganguly; Soumya,9,0,32,23
1657448973628,MATH 20E,A02,083772,Ganguly; Soumya,6,0,32,26
1657448973628,MATH 20E,B01,083773,Ciotti; Benjamin,20,0,35,15
1657448973628,MATH 20E,B02,083774,Ciotti; Benjamin,17,0,35,18
1657448979655,MATH 103A,A01,083777,Greenfeld; Be'Eri,3,0,36,33
1657448979655,MATH 103A,A02,083778,Greenfeld; Be'Eri,5,0,36,31
1657448979655,MATH 103A,A03,093561,Greenfeld; Be'Eri,5,0,36,31
1657448979655,MATH 103A,B01,083779,Greenfeld; Be'Eri,7,0,36,29
1657448979655,MATH 103A,B02,083780,Greenfeld; Be'Eri,4,0,36,32
1657448979655,MATH 103A,B03,093562,Greenfeld; Be'Eri,3,0,36,33
1657448985680,MATH 105,A01,085443,Carter; Anne Toulson,15,0,35,20
1657448985680,MATH 105,A02,093477,Carter; Anne Toulson,20,0,35,15
1657448991779,MATH 109,A01,083213,Ganzberger; Geoffrey Michael,2,0,34,32
1657448991779,MATH 109,A02,083214,Ganzberger; Geoffrey Michael,4,0,34,30
1657448991779,MATH 109,A03,093478,Ganzberger; Geoffrey Michael,2,0,34,32
1657448991779,MATH 109,B01,083215,Ganzberger; Geoffrey Michael,1,0,32,31
1657448991779,MATH 109,B02,083216,Ganzberger; Geoffrey Michael,2,0,32,30
1657448991779,MATH 109,B03,093479,Ganzberger; Geoffrey Michael,8,0,32,24
1657448997815,MATH 142A,A01,083219,Chow; Bennett,7,0,32,25
1657448997815,MATH 142A,A02,083220,Chow; Bennett,10,0,32,22
1657448997815,MATH 142A,A03,093480,Chow; Bennett,8,0,32,24
1657448997815,MATH 142A,B03,093481,Chow; Bennett,8,0,32,24
1657448997815,MATH 142A,B04,093558,Chow; Bennett,13,0,32,19
1657448997815,MATH 142A,B05,093559,Chow; Bennett,6,0,32,26
1657449003847,MATH 193A,A01,083224,Rotar; Vladimir,8,0,34,26
1657449003847,MATH 193A,A02,083225,Rotar; Vladimir,9,0,34,25
1657449003847,MATH 193A,A03,083781,Rotar; Vladimir,5,0,34,29
1657449003847,MATH 193A,A04,083782,Rotar; Vladimir,10,0,34,24
1657449003847,MATH 193A,A05,093482,Rotar; Vladimir,10,0,34,24
1657449009880,MATH 197,001,091859,McAuley; Julian John,9999,0,9999,0
1657449009880,MATH 197,002,095566,Kedlaya; Kiran S.,9997,0,9999,2
1657449009880,MATH 197,003,095567,Xiao; Ming,9999,0,9999,0
1657449009880,MATH 197,004,095571,Perols; Johan Lars,9998,0,9999,1
1657449016968,COGS 9,A01,083615,Shannon; Kyle Michael,9,0,75,66
1657449022994,COGS 11,A01,083617,Boyle; Mary E. T.,22,0,48,26
1657449029021,COGS 13,A01,083071,Bastos; Amalia Pinkusfeld,11,0,71,60
1657449035045,COGS 14A,A01,092681,Semenuks; Arturs,5,1,100,95
1657449041069,COGS 14B,A01,083073,Cheng; Tzu-Han,6,0,63,57
1657449047097,COGS 17,A01,092677,Semenuks; Arturs,6,0,81,75
1657449053126,COGS 100,A01,083619,Allen; Michael Gordon,17,0,70,53
1657449059151,COGS 101A,A01,083621,Davis; Joshua Daniel,9,0,68,59
1657449065182,COGS 101B,A01,091572,Allen; Michael Gordon,12,0,65,53
1657449071213,COGS 101C,A01,083625,Delgado; Tania,17,0,35,18
1657449077240,COGS 107A,A01,083627,Boyle; Mary E. T.,13,0,60,47
1657449083264,COGS 118A,A01,083075,Gupta; Anjum,21,0,76,55
1657449089297,CSE 3,A50,083646,Miranda; Gregory Joseph,24,0,50,26
1657449095333,CSE 8A,A50,083650,Miranda; Gregory Joseph,17,1,56,39
1657449101357,CSE 11,A01,083080,Cao; Yingjun,6,15,40,34
1657449107389,CSE 12,A01,083652,Krause-Levy; Sophia Louisa,28,1,120,92
1657449113415,CSE 15L,A01,083654,Morris; Justin Loren,9,0,50,41
1657449113415,CSE 15L,A02,083655,Morris; Justin Loren,9,0,50,41
1657449119438,CSE 20,A01,083657,Tran; Khoa Dang,39,0,80,41
1657449125464,CSE 21,A01,095574,Bach; Quang Tran,22,0,48,26
1657449131502,CSE 30,A01,083084,Eldon; John,5,0,80,75
1657449131502,CSE 30,B01,095061,Bhaskar; Nishant,9,0,50,41
1657449137531,CSE 100,A01,083659,Cao; Yingjun,5,4,70,65
1657449143556,CSE 134B,A01,083661,Powell; Thomas Allan,22,0,100,78
1657449149581,CSE 140,A01,083663,Gungor; Onat,15,0,85,70
1657449155615,CSE 140L,A01,083088,Eldon; John,21,0,100,79
1657449161647,CSE 175,A01,083665,Kumar; Rakesh,3,0,25,22
1657449167673,CSE 190,A00,092507,Dubnov; Shlomo,8,0,20,12
1657449173707,ECE 45,A01,083139,Congero; Spencer William,6,0,75,69
1657449179740,ECE 65,A50,083695,Saad; Andrew S,12,0,30,18
1657449179740,ECE 65,A51,095125,Saad; Andrew S,24,0,26,2
1657449185771,ECE 109,A01,091882,Touri; Behrouz,19,0,70,51
1657449191805,ECE 180,A00,083140,Abi Samra; Nicholas Camill,1,0,30,29
1657449191805,ECE 180,B00,083141,Abi Samra; Nicholas Camill,0,0,30,30
1657449197840,MATH 10A,A01,083735,Patchell; Gregory David,2,0,30,28
1657449197840,MATH 10A,A02,083736,Patchell; Gregory David,20,0,30,10
1657449197840,MATH 10A,A03,083737,Patchell; Gregory David,16,0,30,14
1657449203881,MATH 10B,A01,083207,Lim; Seonhee,8,0,34,26
1657449203881,MATH 10B,A02,083208,Lim; Seonhee,9,0,35,26
1657449203881,MATH 10B,A03,093472,Lim; Seonhee,7,0,34,27
1657449203881,MATH 10B,B01,083739,Sinha; Shubham,12,0,30,18
1657449209909,MATH 18,A01,083743,Cinel; Cameron Alexander,7,0,30,23
1657449209909,MATH 18,A02,083744,Cinel; Cameron Alexander,17,0,30,13
1657449209909,MATH 18,A03,083745,Cinel; Cameron Alexander,9,0,30,21
1657449209909,MATH 18,B01,083748,Rideout; David Porter,5,0,37,32
1657449209909,MATH 18,B02,083749,Rideout; David Porter,5,0,36,31
1657449209909,MATH 18,B03,083750,Rideout; David Porter,3,0,37,34
1657449209909,MATH 18,B04,083751,Rideout; David Porter,6,0,36,30
1657449209909,MATH 18,B05,093473,Rideout; David Porter,6,0,36,30
1657449209909,MATH 18,B06,093474,Rideout; David Porter,6,0,36,30
1657449215934,MATH 20A,A01,083754,Zheng; Zequn,14,0,40,26
1657449221962,MATH 20B,A01,083756,Briones; Jor-el Thomas Caparas,4,0,36,32
1657449221962,MATH 20B,A02,083757,Briones; Jor-el Thomas Caparas,1,0,36,35
1657449221962,MATH 20B,A03,093475,Briones; Jor-el Thomas Caparas,2,0,36,34
1657449227990,MATH 20C,A01,083760,Briones; Jor-el Thomas Caparas,1,0,35,34
1657449227990,MATH 20C,A02,083761,Briones; Jor-el Thomas Caparas,8,0,35,27
1657449227990,MATH 20C,A03,093476,Briones; Jor-el Thomas Caparas,0,1,36,36
1657449227990,MATH 20C,B01,083762,Bach; Quang Tran,1,0,30,29
1657449234021,MATH 20D,A01,083765,Tran; Brian Kha,5,0,30,25
1657449234021,MATH 20D,A02,083766,Tran; Brian Kha,5,0,30,25
1657449234021,MATH 20D,A03,083767,Tran; Brian Kha,5,0,30,25
1657449240048,MATH 20E,A01,083771,Ganguly; Soumya,9,0,32,23
1657449240048,MATH 20E,A02,083772,Ganguly; Soumya,6,0,32,26
1657449240048,MATH 20E,B01,083773,Ciotti; Benjamin,20,0,35,15
1657449240048,MATH 20E,B02,083774,Ciotti; Benjamin,17,0,35,18
1657449246075,MATH 103A,A01,083777,Greenfeld; Be'Eri,3,0,36,33
1657449246075,MATH 103A,A02,083778,Greenfeld; Be'Eri,5,0,36,31
1657449246075,MATH 103A,A03,093561,Greenfeld; Be'Eri,5,0,36,31
1657449246075,MATH 103A,B01,083779,Greenfeld; Be'Eri,7,0,36,29
1657449246075,MATH 103A,B02,083780,Greenfeld; Be'Eri,4,0,36,32
1657449246075,MATH 103A,B03,093562,Greenfeld; Be'Eri,3,0,36,33
1657449252123,MATH 105,A01,085443,Carter; Anne Toulson,15,0,35,20
1657449252123,MATH 105,A02,093477,Carter; Anne Toulson,20,0,35,15
1657449258153,MATH 109,A01,083213,Ganzberger; Geoffrey Michael,2,0,34,32
1657449258153,MATH 109,A02,083214,Ganzberger; Geoffrey Michael,4,0,34,30
1657449258153,MATH 109,A03,093478,Ganzberger; Geoffrey Michael,2,0,34,32
1657449258153,MATH 109,B01,083215,Ganzberger; Geoffrey Michael,1,0,32,31
1657449258153,MATH 109,B02,083216,Ganzberger; Geoffrey Michael,2,0,32,30
1657449258153,MATH 109,B03,093479,Ganzberger; Geoffrey Michael,8,0,32,24
1657449264192,MATH 142A,A01,083219,Chow; Bennett,7,0,32,25
1657449264192,MATH 142A,A02,083220,Chow; Bennett,10,0,32,22
1657449264192,MATH 142A,A03,093480,Chow; Bennett,8,0,32,24
1657449264192,MATH 142A,B03,093481,Chow; Bennett,8,0,32,24
1657449264192,MATH 142A,B04,093558,Chow; Bennett,13,0,32,19
1657449264192,MATH 142A,B05,093559,Chow; Bennett,6,0,32,26
1657449270218,MATH 193A,A01,083224,Rotar; Vladimir,8,0,34,26
1657449270218,MATH 193A,A02,083225,Rotar; Vladimir,9,0,34,25
1657449270218,MATH 193A,A03,083781,Rotar; Vladimir,5,0,34,29
1657449270218,MATH 193A,A04,083782,Rotar; Vladimir,10,0,34,24
1657449270218,MATH 193A,A05,093482,Rotar; Vladimir,10,0,34,24
1657449276248,MATH 197,001,091859,McAuley; Julian John,9999,0,9999,0
1657449276248,MATH 197,002,095566,Kedlaya; Kiran S.,9997,0,9999,2
1657449276248,MATH 197,003,095567,Xiao; Ming,9999,0,9999,0
1657449276248,MATH 197,004,095571,Perols; Johan Lars,9998,0,9999,1
1657449283330,COGS 9,A01,083615,Shannon; Kyle Michael,9,0,75,66
1657449289360,COGS 11,A01,083617,Boyle; Mary E. T.,22,0,48,26
1657449295386,COGS 13,A01,083071,Bastos; Amalia Pinkusfeld,11,0,71,60
1657449301418,COGS 14A,A01,092681,Semenuks; Arturs,5,1,100,95
1657449307442,COGS 14B,A01,083073,Cheng; Tzu-Han,6,0,63,57
1657449313467,COGS 17,A01,092677,Semenuks; Arturs,6,0,81,75
1657449319490,COGS 100,A01,083619,Allen; Michael Gordon,17,0,70,53
1657449325515,COGS 101A,A01,083621,Davis; Joshua Daniel,9,0,68,59
1657449331544,COGS 101B,A01,091572,Allen; Michael Gordon,12,0,65,53
1657449337572,COGS 101C,A01,083625,Delgado; Tania,17,0,35,18
1657449343603,COGS 107A,A01,083627,Boyle; Mary E. T.,13,0,60,47
1657449349628,COGS 118A,A01,083075,Gupta; Anjum,21,0,76,55
1657449355661,CSE 3,A50,083646,Miranda; Gregory Joseph,24,0,50,26
1657449361698,CSE 8A,A50,083650,Miranda; Gregory Joseph,17,1,56,39
1657449367722,CSE 11,A01,083080,Cao; Yingjun,6,15,40,34
1657449373753,CSE 12,A01,083652,Krause-Levy; Sophia Louisa,28,1,120,92
1657449379781,CSE 15L,A01,083654,Morris; Justin Loren,9,0,50,41
1657449379781,CSE 15L,A02,083655,Morris; Justin Loren,9,0,50,41
1657449385810,CSE 20,A01,083657,Tran; Khoa Dang,39,0,80,41
1657449391857,CSE 21,A01,095574,Bach; Quang Tran,22,0,48,26
1657449397891,CSE 30,A01,083084,Eldon; John,5,0,80,75
1657449397891,CSE 30,B01,095061,Bhaskar; Nishant,9,0,50,41
1657449403915,CSE 100,A01,083659,Cao; Yingjun,5,4,70,65
1657449409943,CSE 134B,A01,083661,Powell; Thomas Allan,22,0,100,78
1657449415967,CSE 140,A01,083663,Gungor; Onat,15,0,85,70
1657449421996,CSE 140L,A01,083088,Eldon; John,21,0,100,79
1657449428029,CSE 175,A01,083665,Kumar; Rakesh,3,0,25,22
1657449434059,CSE 190,A00,092507,Dubnov; Shlomo,8,0,20,12
1657449440093,ECE 45,A01,083139,Congero; Spencer William,6,0,75,69
1657449446131,ECE 65,A50,083695,Saad; Andrew S,12,0,30,18
1657449446131,ECE 65,A51,095125,Saad; Andrew S,24,0,26,2
1657449452155,ECE 109,A01,091882,Touri; Behrouz,19,0,70,51
1657449458188,ECE 180,A00,083140,Abi Samra; Nicholas Camill,1,0,30,29
1657449458188,ECE 180,B00,083141,Abi Samra; Nicholas Camill,0,0,30,30
1657449464233,MATH 10A,A01,083735,Patchell; Gregory David,2,0,30,28
1657449464233,MATH 10A,A02,083736,Patchell; Gregory David,20,0,30,10
1657449464233,MATH 10A,A03,083737,Patchell; Gregory David,16,0,30,14
1657449470263,MATH 10B,A01,083207,Lim; Seonhee,8,0,34,26
1657449470263,MATH 10B,A02,083208,Lim; Seonhee,9,0,35,26
1657449470263,MATH 10B,A03,093472,Lim; Seonhee,7,0,34,27
1657449470263,MATH 10B,B01,083739,Sinha; Shubham,12,0,30,18
1657449476306,MATH 18,A01,083743,Cinel; Cameron Alexander,7,0,30,23
1657449476306,MATH 18,A02,083744,Cinel; Cameron Alexander,17,0,30,13
1657449476306,MATH 18,A03,083745,Cinel; Cameron Alexander,9,0,30,21
1657449476306,MATH 18,B01,083748,Rideout; David Porter,5,0,37,32
1657449476306,MATH 18,B02,083749,Rideout; David Porter,5,0,36,31
1657449476306,MATH 18,B03,083750,Rideout; David Porter,3,0,37,34
1657449476306,MATH 18,B04,083751,Rideout; David Porter,6,0,36,30
1657449476306,MATH 18,B05,093473,Rideout; David Porter,6,0,36,30
1657449476306,MATH 18,B06,093474,Rideout; David Porter,6,0,36,30
1657449482331,MATH 20A,A01,083754,Zheng; Zequn,14,0,40,26
1657449488365,MATH 20B,A01,083756,Briones; Jor-el Thomas Caparas,4,0,36,32
1657449488365,MATH 20B,A02,083757,Briones; Jor-el Thomas Caparas,1,0,36,35
1657449488365,MATH 20B,A03,093475,Briones; Jor-el Thomas Caparas,2,0,36,34
1657449494404,MATH 20C,A01,083760,Briones; Jor-el Thomas Caparas,1,0,35,34
1657449494404,MATH 20C,A02,083761,Briones; Jor-el Thomas Caparas,8,0,35,27
1657449494404,MATH 20C,A03,093476,Briones; Jor-el Thomas Caparas,0,1,36,36
1657449494404,MATH 20C,B01,083762,Bach; Quang Tran,1,0,30,29
1657449500430,MATH 20D,A01,083765,Tran; Brian Kha,5,0,30,25
1657449500430,MATH 20D,A02,083766,Tran; Brian Kha,5,0,30,25
1657449500430,MATH 20D,A03,083767,Tran; Brian Kha,5,0,30,25
1657449506460,MATH 20E,A01,083771,Ganguly; Soumya,9,0,32,23
1657449506460,MATH 20E,A02,083772,Ganguly; Soumya,6,0,32,26
1657449506460,MATH 20E,B01,083773,Ciotti; Benjamin,20,0,35,15
1657449506460,MATH 20E,B02,083774,Ciotti; Benjamin,17,0,35,18
1657449512495,MATH 103A,A01,083777,Greenfeld; Be'Eri,3,0,36,33
1657449512495,MATH 103A,A02,083778,Greenfeld; Be'Eri,5,0,36,31
1657449512495,MATH 103A,A03,093561,Greenfeld; Be'Eri,5,0,36,31
1657449512495,MATH 103A,B01,083779,Greenfeld; Be'Eri,7,0,36,29
1657449512495,MATH 103A,B02,083780,Greenfeld; Be'Eri,4,0,36,32
1657449512495,MATH 103A,B03,093562,Greenfeld; Be'Eri,3,0,36,33
1657449518535,MATH 105,A01,085443,Carter; Anne Toulson,15,0,35,20
1657449518535,MATH 105,A02,093477,Carter; Anne Toulson,20,0,35,15
1657449524576,MATH 109,A01,083213,Ganzberger; Geoffrey Michael,2,0,34,32
1657449524576,MATH 109,A02,083214,Ganzberger; Geoffrey Michael,4,0,34,30
1657449524576,MATH 109,A03,093478,Ganzberger; Geoffrey Michael,2,0,34,32
1657449524576,MATH 109,B01,083215,Ganzberger; Geoffrey Michael,1,0,32,31
1657449524576,MATH 109,B02,083216,Ganzberger; Geoffrey Michael,2,0,32,30
1657449524576,MATH 109,B03,093479,Ganzberger; Geoffrey Michael,8,0,32,24
1657449530613,MATH 142A,A01,083219,Chow; Bennett,7,0,32,25
1657449530613,MATH 142A,A02,083220,Chow; Bennett,10,0,32,22
1657449530613,MATH 142A,A03,093480,Chow; Bennett,8,0,32,24
1657449530613,MATH 142A,B03,093481,Chow; Bennett,8,0,32,24
1657449530613,MATH 142A,B04,093558,Chow; Bennett,13,0,32,19
1657449530613,MATH 142A,B05,093559,Chow; Bennett,6,0,32,26
1657449536645,MATH 193A,A01,083224,Rotar; Vladimir,8,0,34,26
1657449536645,MATH 193A,A02,083225,Rotar; Vladimir,9,0,34,25
1657449536645,MATH 193A,A03,083781,Rotar; Vladimir,5,0,34,29
1657449536645,MATH 193A,A04,083782,Rotar; Vladimir,10,0,34,24
1657449536645,MATH 193A,A05,093482,Rotar; Vladimir,10,0,34,24
1657449542678,MATH 197,001,091859,McAuley; Julian John,9999,0,9999,0
1657449542678,MATH 197,002,095566,Kedlaya; Kiran S.,9997,0,9999,2
1657449542678,MATH 197,003,095567,Xiao; Ming,9999,0,9999,0
1657449542678,MATH 197,004,095571,Perols; Johan Lars,9998,0,9999,1
1657449549758,COGS 9,A01,083615,Shannon; Kyle Michael,9,0,75,66
1657449555781,COGS 11,A01,083617,Boyle; Mary E. T.,22,0,48,26
1657449561810,COGS 13,A01,083071,Bastos; Amalia Pinkusfeld,11,0,71,60
1657449567839,COGS 14A,A01,092681,Semenuks; Arturs,5,1,100,95
1657449573869,COGS 14B,A01,083073,Cheng; Tzu-Han,6,0,63,57
1657449579895,COGS 17,A01,092677,Semenuks; Arturs,6,0,81,75
1657449585995,COGS 100,A01,083619,Allen; Michael Gordon,17,0,70,53
1657449592019,COGS 101A,A01,083621,Davis; Joshua Daniel,9,0,68,59
1657449598043,COGS 101B,A01,091572,Allen; Michael Gordon,12,0,65,53
1657449604068,COGS 101C,A01,083625,Delgado; Tania,17,0,35,18
1657449610097,COGS 107A,A01,083627,Boyle; Mary E. T.,13,0,60,47
1657449616121,COGS 118A,A01,083075,Gupta; Anjum,21,0,76,55
1657449622154,CSE 3,A50,083646,Miranda; Gregory Joseph,24,0,50,26
1657449628184,CSE 8A,A50,083650,Miranda; Gregory Joseph,17,1,56,39
1657449634212,CSE 11,A01,083080,Cao; Yingjun,6,15,40,34
1657449640244,CSE 12,A01,083652,Krause-Levy; Sophia Louisa,28,1,120,92
1657449646270,CSE 15L,A01,083654,Morris; Justin Loren,9,0,50,41
1657449646270,CSE 15L,A02,083655,Morris; Justin Loren,9,0,50,41
1657449652294,CSE 20,A01,083657,Tran; Khoa Dang,39,0,80,41
1657449658325,CSE 21,A01,095574,Bach; Quang Tran,22,0,48,26
1657449664359,CSE 30,A01,083084,Eldon; John,5,0,80,75
1657449664359,CSE 30,B01,095061,Bhaskar; Nishant,9,0,50,41
1657449670384,CSE 100,A01,083659,Cao; Yingjun,5,4,70,65
1657449676409,CSE 134B,A01,083661,Powell; Thomas Allan,22,0,100,78
1657449682435,CSE 140,A01,083663,Gungor; Onat,15,0,85,70
1657449688463,CSE 140L,A01,083088,Eldon; John,21,0,100,79
1657449694489,CSE 175,A01,083665,Kumar; Rakesh,3,0,25,22
1657449700514,CSE 190,A00,092507,Dubnov; Shlomo,8,0,20,12
1657449706547,ECE 45,A01,083139,Congero; Spencer William,6,0,75,69
1657449712585,ECE 65,A50,083695,Saad; Andrew S,12,0,30,18
1657449712585,ECE 65,A51,095125,Saad; Andrew S,24,0,26,2
1657449718623,ECE 109,A01,091882,Touri; Behrouz,19,0,70,51
1657449724661,ECE 180,A00,083140,Abi Samra; Nicholas Camill,1,0,30,29
1657449724661,ECE 180,B00,083141,Abi Samra; Nicholas Camill,0,0,30,30
1657449730696,MATH 10A,A01,083735,Patchell; Gregory David,2,0,30,28
1657449730696,MATH 10A,A02,083736,Patchell; Gregory David,20,0,30,10
1657449730696,MATH 10A,A03,083737,Patchell; Gregory David,16,0,30,14
1657449736750,MATH 10B,A01,083207,Lim; Seonhee,8,0,34,26
1657449736750,MATH 10B,A02,083208,Lim; Seonhee,9,0,35,26
1657449736750,MATH 10B,A03,093472,Lim; Seonhee,7,0,34,27
1657449736750,MATH 10B,B01,083739,Sinha; Shubham,12,0,30,18
1657449742778,MATH 18,A01,083743,Cinel; Cameron Alexander,7,0,30,23
1657449742778,MATH 18,A02,083744,Cinel; Cameron Alexander,17,0,30,13
1657449742778,MATH 18,A03,083745,Cinel; Cameron Alexander,9,0,30,21
1657449742778,MATH 18,B01,083748,Rideout; David Porter,5,0,37,32
1657449742778,MATH 18,B02,083749,Rideout; David Porter,5,0,36,31
1657449742778,MATH 18,B03,083750,Rideout; David Porter,3,0,37,34
1657449742778,MATH 18,B04,083751,Rideout; David Porter,6,0,36,30
1657449742778,MATH 18,B05,093473,Rideout; David Porter,6,0,36,30
1657449742778,MATH 18,B06,093474,Rideout; David Porter,6,0,36,30
1657449748802,MATH 20A,A01,083754,Zheng; Zequn,14,0,40,26
1657449754827,MATH 20B,A01,083756,Briones; Jor-el Thomas Caparas,4,0,36,32
1657449754827,MATH 20B,A02,083757,Briones; Jor-el Thomas Caparas,1,0,36,35
1657449754827,MATH 20B,A03,093475,Briones; Jor-el Thomas Caparas,2,0,36,34
1657449760865,MATH 20C,A01,083760,Briones; Jor-el Thomas Caparas,1,0,35,34
1657449760865,MATH 20C,A02,083761,Briones; Jor-el Thomas Caparas,8,0,35,27
1657449760865,MATH 20C,A03,093476,Briones; Jor-el Thomas Caparas,0,1,36,36
1657449760865,MATH 20C,B01,083762,Bach; Quang Tran,1,0,30,29
1657449766895,MATH 20D,A01,083765,Tran; Brian Kha,5,0,30,25
1657449766895,MATH 20D,A02,083766,Tran; Brian Kha,5,0,30,25
1657449766895,MATH 20D,A03,083767,Tran; Brian Kha,5,0,30,25
1657449772930,MATH 20E,A01,083771,Ganguly; Soumya,9,0,32,23
1657449772930,MATH 20E,A02,083772,Ganguly; Soumya,6,0,32,26
1657449772930,MATH 20E,B01,083773,Ciotti; Benjamin,20,0,35,15
1657449772930,MATH 20E,B02,083774,Ciotti; Benjamin,17,0,35,18
1657449778957,MATH 103A,A01,083777,Greenfeld; Be'Eri,3,0,36,33
1657449778957,MATH 103A,A02,083778,Greenfeld; Be'Eri,5,0,36,31
1657449778957,MATH 103A,A03,093561,Greenfeld; Be'Eri,5,0,36,31
1657449778957,MATH 103A,B01,083779,Greenfeld; Be'Eri,7,0,36,29
1657449778957,MATH 103A,B02,083780,Greenfeld; Be'Eri,4,0,36,32
1657449778957,MATH 103A,B03,093562,Greenfeld; Be'Eri,3,0,36,33
1657449784992,MATH 105,A01,085443,Carter; Anne Toulson,15,0,35,20
1657449784992,MATH 105,A02,093477,Carter; Anne Toulson,20,0,35,15
1657449791016,MATH 109,A01,083213,Ganzberger; Geoffrey Michael,2,0,34,32
1657449791016,MATH 109,A02,083214,Ganzberger; Geoffrey Michael,4,0,34,30
1657449791016,MATH 109,A03,093478,Ganzberger; Geoffrey Michael,2,0,34,32
1657449791016,MATH 109,B01,083215,Ganzberger; Geoffrey Michael,1,0,32,31
1657449791016,MATH 109,B02,083216,Ganzberger; Geoffrey Michael,2,0,32,30
1657449791016,MATH 109,B03,093479,Ganzberger; Geoffrey Michael,8,0,32,24
1657449797043,MATH 142A,A01,083219,Chow; Bennett,7,0,32,25
1657449797043,MATH 142A,A02,083220,Chow; Bennett,10,0,32,22
1657449797043,MATH 142A,A03,093480,Chow; Bennett,8,0,32,24
1657449797043,MATH 142A,B03,093481,Chow; Bennett,8,0,32,24
1657449797043,MATH 142A,B04,093558,Chow; Bennett,13,0,32,19
1657449797043,MATH 142A,B05,093559,Chow; Bennett,6,0,32,26
1657449803067,MATH 193A,A01,083224,Rotar; Vladimir,8,0,34,26
1657449803067,MATH 193A,A02,083225,Rotar; Vladimir,9,0,34,25
1657449803067,MATH 193A,A03,083781,Rotar; Vladimir,5,0,34,29
1657449803067,MATH 193A,A04,083782,Rotar; Vladimir,10,0,34,24
1657449803067,MATH 193A,A05,093482,Rotar; Vladimir,10,0,34,24
1657449809094,MATH 197,001,091859,McAuley; Julian John,9999,0,9999,0
1657449809094,MATH 197,002,095566,Kedlaya; Kiran S.,9997,0,9999,2
1657449809094,MATH 197,003,095567,Xiao; Ming,9999,0,9999,0
1657449809094,MATH 197,004,095571,Perols; Johan Lars,9998,0,9999,1
1657449816162,COGS 9,A01,083615,Shannon; Kyle Michael,9,0,75,66
1657449822188,COGS 11,A01,083617,Boyle; Mary E. T.,22,0,48,26
1657449828221,COGS 13,A01,083071,Bastos; Amalia Pinkusfeld,11,0,71,60
1657449834246,COGS 14A,A01,092681,Semenuks; Arturs,5,1,100,95
1657449840280,COGS 14B,A01,083073,Cheng; Tzu-Han,6,0,63,57
1657449846305,COGS 17,A01,092677,Semenuks; Arturs,6,0,81,75
1657449852337,COGS 100,A01,083619,Allen; Michael Gordon,17,0,70,53
1657449858362,COGS 101A,A01,083621,Davis; Joshua Daniel,9,0,68,59
1657449864389,COGS 101B,A01,091572,Allen; Michael Gordon,12,0,65,53
1657449870418,COGS 101C,A01,083625,Delgado; Tania,17,0,35,18
1657449876440,COGS 107A,A01,083627,Boyle; Mary E. T.,13,0,60,47
1657449882463,COGS 118A,A01,083075,Gupta; Anjum,21,0,76,55
1657449888500,CSE 3,A50,083646,Miranda; Gregory Joseph,24,0,50,26
1657449894529,CSE 8A,A50,083650,Miranda; Gregory Joseph,17,1,56,39
1657449900554,CSE 11,A01,083080,Cao; Yingjun,6,15,40,34
1657449906579,CSE 12,A01,083652,Krause-Levy; Sophia Louisa,28,1,120,92
1657449912603,CSE 15L,A01,083654,Morris; Justin Loren,9,0,50,41
1657449912603,CSE 15L,A02,083655,Morris; Justin Loren,9,0,50,41
1657449918628,CSE 20,A01,083657,Tran; Khoa Dang,39,0,80,41
1657449924655,CSE 21,A01,095574,Bach; Quang Tran,22,0,48,26
1657449930685,CSE 30,A01,083084,Eldon; John,5,0,80,75
1657449930685,CSE 30,B01,095061,Bhaskar; Nishant,9,0,50,41
1657449936716,CSE 100,A01,083659,Cao; Yingjun,5,4,70,65
1657449942745,CSE 134B,A01,083661,Powell; Thomas Allan,22,0,100,78
1657449948769,CSE 140,A01,083663,Gungor; Onat,15,0,85,70
1657449954792,CSE 140L,A01,083088,Eldon; John,21,0,100,79
1657449960828,CSE 175,A01,083665,Kumar; Rakesh,3,0,25,22
1657449966853,CSE 190,A00,092507,Dubnov; Shlomo,8,0,20,12
1657449972878,ECE 45,A01,083139,Congero; Spencer William,6,0,75,69
1657449978917,ECE 65,A50,083695,Saad; Andrew S,12,0,30,18
1657449978917,ECE 65,A51,095125,Saad; Andrew S,24,0,26,2
1657449984949,ECE 109,A01,091882,Touri; Behrouz,19,0,70,51
1657449990973,ECE 180,A00,083140,Abi Samra; Nicholas Camill,1,0,30,29
1657449990973,ECE 180,B00,083141,Abi Samra; Nicholas Camill,0,0,30,30
1657449996999,MATH 10A,A01,083735,Patchell; Gregory David,2,0,30,28
1657449996999,MATH 10A,A02,083736,Patchell; Gregory David,20,0,30,10
1657449996999,MATH 10A,A03,083737,Patchell; Gregory David,16,0,30,14
1657450003029,MATH 10B,A01,083207,Lim; Seonhee,8,0,34,26
1657450003029,MATH 10B,A02,083208,Lim; Seonhee,9,0,35,26
1657450003029,MATH 10B,A03,093472,Lim; Seonhee,7,0,34,27
1657450003029,MATH 10B,B01,083739,Sinha; Shubham,12,0,30,18
1657450009074,MATH 18,A01,083743,Cinel; Cameron Alexander,7,0,30,23
1657450009074,MATH 18,A02,083744,Cinel; Cameron Alexander,17,0,30,13
1657450009074,MATH 18,A03,083745,Cinel; Cameron Alexander,9,0,30,21
1657450009074,MATH 18,B01,083748,Rideout; David Porter,5,0,37,32
1657450009074,MATH 18,B02,083749,Rideout; David Porter,5,0,36,31
1657450009074,MATH 18,B03,083750,Rideout; David Porter,3,0,37,34
1657450009074,MATH 18,B04,083751,Rideout; David Porter,6,0,36,30
1657450009074,MATH 18,B05,093473,Rideout; David Porter,6,0,36,30
1657450009074,MATH 18,B06,093474,Rideout; David Porter,6,0,36,30
1657450015104,MATH 20A,A01,083754,Zheng; Zequn,14,0,40,26
1657450021135,MATH 20B,A01,083756,Briones; Jor-el Thomas Caparas,4,0,36,32
1657450021135,MATH 20B,A02,083757,Briones; Jor-el Thomas Caparas,1,0,36,35
1657450021135,MATH 20B,A03,093475,Briones; Jor-el Thomas Caparas,2,0,36,34
1657450027159,MATH 20C,A01,083760,Briones; Jor-el Thomas Caparas,1,0,35,34
1657450027159,MATH 20C,A02,083761,Briones; Jor-el Thomas Caparas,8,0,35,27
1657450027159,MATH 20C,A03,093476,Briones; Jor-el Thomas Caparas,0,1,36,36
1657450027159,MATH 20C,B01,083762,Bach; Quang Tran,1,0,30,29
1657450033184,MATH 20D,A01,083765,Tran; Brian Kha,5,0,30,25
1657450033184,MATH 20D,A02,083766,Tran; Brian Kha,5,0,30,25
1657450033184,MATH 20D,A03,083767,Tran; Brian Kha,5,0,30,25
1657450039213,MATH 20E,A01,083771,Ganguly; Soumya,9,0,32,23
1657450039213,MATH 20E,A02,083772,Ganguly; Soumya,6,0,32,26
1657450039213,MATH 20E,B01,083773,Ciotti; Benjamin,20,0,35,15
1657450039213,MATH 20E,B02,083774,Ciotti; Benjamin,17,0,35,18
1657450045243,MATH 103A,A01,083777,Greenfeld; Be'Eri,3,0,36,33
1657450045243,MATH 103A,A02,083778,Greenfeld; Be'Eri,5,0,36,31
1657450045243,MATH 103A,A03,093561,Greenfeld; Be'Eri,5,0,36,31
1657450045243,MATH 103A,B01,083779,Greenfeld; Be'Eri,7,0,36,29
1657450045243,MATH 103A,B02,083780,Greenfeld; Be'Eri,4,0,36,32
1657450045243,MATH 103A,B03,093562,Greenfeld; Be'Eri,3,0,36,33
1657450051276,MATH 105,A01,085443,Carter; Anne Toulson,15,0,35,20
1657450051276,MATH 105,A02,093477,Carter; Anne Toulson,20,0,35,15
1657450057302,MATH 109,A01,083213,Ganzberger; Geoffrey Michael,2,0,34,32
1657450057302,MATH 109,A02,083214,Ganzberger; Geoffrey Michael,4,0,34,30
1657450057302,MATH 109,A03,093478,Ganzberger; Geoffrey Michael,2,0,34,32
1657450057302,MATH 109,B01,083215,Ganzberger; Geoffrey Michael,1,0,32,31
1657450057302,MATH 109,B02,083216,Ganzberger; Geoffrey Michael,2,0,32,30
1657450057302,MATH 109,B03,093479,Ganzberger; Geoffrey Michael,8,0,32,24
1657450063330,MATH 142A,A01,083219,Chow; Bennett,7,0,32,25
1657450063330,MATH 142A,A02,083220,Chow; Bennett,10,0,32,22
1657450063330,MATH 142A,A03,093480,Chow; Bennett,8,0,32,24
1657450063330,MATH 142A,B03,093481,Chow; Bennett,8,0,32,24
1657450063330,MATH 142A,B04,093558,Chow; Bennett,13,0,32,19
1657450063330,MATH 142A,B05,093559,Chow; Bennett,6,0,32,26
1657450069354,MATH 193A,A01,083224,Rotar; Vladimir,8,0,34,26
1657450069354,MATH 193A,A02,083225,Rotar; Vladimir,9,0,34,25
1657450069354,MATH 193A,A03,083781,Rotar; Vladimir,5,0,34,29
1657450069354,MATH 193A,A04,083782,Rotar; Vladimir,10,0,34,24
1657450069354,MATH 193A,A05,093482,Rotar; Vladimir,10,0,34,24
1657450075389,MATH 197,001,091859,McAuley; Julian John,9999,0,9999,0
1657450075389,MATH 197,002,095566,Kedlaya; Kiran S.,9997,0,9999,2
1657450075389,MATH 197,003,095567,Xiao; Ming,9999,0,9999,0
1657450075389,MATH 197,004,095571,Perols; Johan Lars,9998,0,9999,1
1657450082466,COGS 9,A01,083615,Shannon; Kyle Michael,9,0,75,66
1657450088491,COGS 11,A01,083617,Boyle; Mary E. T.,22,0,48,26
1657450094516,COGS 13,A01,083071,Bastos; Amalia Pinkusfeld,11,0,71,60
1657450100546,COGS 14A,A01,092681,Semenuks; Arturs,5,1,100,95
1657450106571,COGS 14B,A01,083073,Cheng; Tzu-Han,6,0,63,57
1657450112595,COGS 17,A01,092677,Semenuks; Arturs,6,0,81,75
1657450118627,COGS 100,A01,083619,Allen; Michael Gordon,17,0,70,53
1657450124652,COGS 101A,A01,083621,Davis; Joshua Daniel,9,0,68,59
1657450130677,COGS 101B,A01,091572,Allen; Michael Gordon,12,0,65,53
1657450136703,COGS 101C,A01,083625,Delgado; Tania,17,0,35,18
1657450142730,COGS 107A,A01,083627,Boyle; Mary E. T.,13,0,60,47
1657450148759,COGS 118A,A01,083075,Gupta; Anjum,21,0,76,55
1657450154784,CSE 3,A50,083646,Miranda; Gregory Joseph,24,0,50,26
1657450160814,CSE 8A,A50,083650,Miranda; Gregory Joseph,17,1,56,39
1657450166838,CSE 11,A01,083080,Cao; Yingjun,6,15,40,34
1657450172873,CSE 12,A01,083652,Krause-Levy; Sophia Louisa,28,1,120,92
1657450178899,CSE 15L,A01,083654,Morris; Justin Loren,9,0,50,41
1657450178899,CSE 15L,A02,083655,Morris; Justin Loren,9,0,50,41
1657450185007,CSE 20,A01,083657,Tran; Khoa Dang,39,0,80,41
1657450191031,CSE 21,A01,095574,Bach; Quang Tran,22,0,48,26
1657450197064,CSE 30,A01,083084,Eldon; John,5,0,80,75
1657450197064,CSE 30,B01,095061,Bhaskar; Nishant,9,0,50,41
1657450203089,CSE 100,A01,083659,Cao; Yingjun,5,4,70,65
1657450209119,CSE 134B,A01,083661,Powell; Thomas Allan,22,0,100,78
1657450215147,CSE 140,A01,083663,Gungor; Onat,15,0,85,70
1657450221175,CSE 140L,A01,083088,Eldon; John,21,0,100,79
1657450227207,CSE 175,A01,083665,Kumar; Rakesh,3,0,25,22
1657450233236,CSE 190,A00,092507,Dubnov; Shlomo,8,0,20,12
1657450239266,ECE 45,A01,083139,Congero; Spencer William,6,0,75,69
1657450245291,ECE 65,A50,083695,Saad; Andrew S,12,0,30,18
1657450245291,ECE 65,A51,095125,Saad; Andrew S,24,0,26,2
1657450251315,ECE 109,A01,091882,Touri; Behrouz,19,0,70,51
1657450257343,ECE 180,A00,083140,Abi Samra; Nicholas Camill,1,0,30,29
1657450257343,ECE 180,B00,083141,Abi Samra; Nicholas Camill,0,0,30,30
1657450263372,MATH 10A,A01,083735,Patchell; Gregory David,2,0,30,28
1657450263372,MATH 10A,A02,083736,Patchell; Gregory David,20,0,30,10
1657450263372,MATH 10A,A03,083737,Patchell; Gregory David,16,0,30,14
1657450269410,MATH 10B,A01,083207,Lim; Seonhee,8,0,34,26
1657450269410,MATH 10B,A02,083208,Lim; Seonhee,9,0,35,26
1657450269410,MATH 10B,A03,093472,Lim; Seonhee,7,0,34,27
1657450269410,MATH 10B,B01,083739,Sinha; Shubham,12,0,30,18
1657450275454,MATH 18,A01,083743,Cinel; Cameron Alexander,7,0,30,23
1657450275454,MATH 18,A02,083744,Cinel; Cameron Alexander,17,0,30,13
1657450275454,MATH 18,A03,083745,Cinel; Cameron Alexander,9,0,30,21
1657450275454,MATH 18,B01,083748,Rideout; David Porter,5,0,37,32
1657450275454,MATH 18,B02,083749,Rideout; David Porter,5,0,36,31
1657450275454,MATH 18,B03,083750,Rideout; David Porter,3,0,37,34
1657450275454,MATH 18,B04,083751,Rideout; David Porter,6,0,36,30
1657450275454,MATH 18,B05,093473,Rideout; David Porter,6,0,36,30
1657450275454,MATH 18,B06,093474,Rideout; David Porter,6,0,36,30
1657450281479,MATH 20A,A01,083754,Zheng; Zequn,14,0,40,26
1657450287513,MATH 20B,A01,083756,Briones; Jor-el Thomas Caparas,4,0,36,32
1657450287513,MATH 20B,A02,083757,Briones; Jor-el Thomas Caparas,1,0,36,35
1657450287513,MATH 20B,A03,093475,Briones; Jor-el Thomas Caparas,2,0,36,34
1657450293541,MATH 20C,A01,083760,Briones; Jor-el Thomas Caparas,1,0,35,34
1657450293541,MATH 20C,A02,083761,Briones; Jor-el Thomas Caparas,8,0,35,27
1657450293541,MATH 20C,A03,093476,Briones; Jor-el Thomas Caparas,0,1,36,36
1657450293541,MATH 20C,B01,083762,Bach; Quang Tran,1,0,30,29
1657450299565,MATH 20D,A01,083765,Tran; Brian Kha,5,0,30,25
1657450299565,MATH 20D,A02,083766,Tran; Brian Kha,5,0,30,25
1657450299565,MATH 20D,A03,083767,Tran; Brian Kha,5,0,30,25
1657450305593,MATH 20E,A01,083771,Ganguly; Soumya,9,0,32,23
1657450305593,MATH 20E,A02,083772,Ganguly; Soumya,6,0,32,26
1657450305593,MATH 20E,B01,083773,Ciotti; Benjamin,20,0,35,15
1657450305593,MATH 20E,B02,083774,Ciotti; Benjamin,17,0,35,18
1657450311620,MATH 103A,A01,083777,Greenfeld; Be'Eri,3,0,36,33
1657450311620,MATH 103A,A02,083778,Greenfeld; Be'Eri,5,0,36,31
1657450311620,MATH 103A,A03,093561,Greenfeld; Be'Eri,5,0,36,31
1657450311620,MATH 103A,B01,083779,Greenfeld; Be'Eri,7,0,36,29
1657450311620,MATH 103A,B02,083780,Greenfeld; Be'Eri,4,0,36,32
1657450311620,MATH 103A,B03,093562,Greenfeld; Be'Eri,3,0,36,33
1657450317644,MATH 105,A01,085443,Carter; Anne Toulson,15,0,35,20
1657450317644,MATH 105,A02,093477,Carter; Anne Toulson,20,0,35,15
1657450323675,MATH 109,A01,083213,Ganzberger; Geoffrey Michael,2,0,34,32
1657450323675,MATH 109,A02,083214,Ganzberger; Geoffrey Michael,4,0,34,30
1657450323675,MATH 109,A03,093478,Ganzberger; Geoffrey Michael,2,0,34,32
1657450323675,MATH 109,B01,083215,Ganzberger; Geoffrey Michael,1,0,32,31
1657450323675,MATH 109,B02,083216,Ganzberger; Geoffrey Michael,2,0,32,30
1657450323675,MATH 109,B03,093479,Ganzberger; Geoffrey Michael,8,0,32,24
1657450329710,MATH 142A,A01,083219,Chow; Bennett,7,0,32,25
1657450329710,MATH 142A,A02,083220,Chow; Bennett,10,0,32,22
1657450329710,MATH 142A,A03,093480,Chow; Bennett,8,0,32,24
1657450329710,MATH 142A,B03,093481,Chow; Bennett,8,0,32,24
1657450329710,MATH 142A,B04,093558,Chow; Bennett,13,0,32,19
1657450329710,MATH 142A,B05,093559,Chow; Bennett,6,0,32,26
1657450335741,MATH 193A,A01,083224,Rotar; Vladimir,8,0,34,26
1657450335741,MATH 193A,A02,083225,Rotar; Vladimir,9,0,34,25
1657450335741,MATH 193A,A03,083781,Rotar; Vladimir,5,0,34,29
1657450335741,MATH 193A,A04,083782,Rotar; Vladimir,10,0,34,24
1657450335741,MATH 193A,A05,093482,Rotar; Vladimir,10,0,34,24
1657450341773,MATH 197,001,091859,McAuley; Julian John,9999,0,9999,0
1657450341773,MATH 197,002,095566,Kedlaya; Kiran S.,9997,0,9999,2
1657450341773,MATH 197,003,095567,Xiao; Ming,9999,0,9999,0
1657450341773,MATH 197,004,095571,Perols; Johan Lars,9998,0,9999,1
1657450348846,COGS 9,A01,083615,Shannon; Kyle Michael,9,0,75,66
1657450354876,COGS 11,A01,083617,Boyle; Mary E. T.,22,0,48,26
1657450360908,COGS 13,A01,083071,Bastos; Amalia Pinkusfeld,11,0,71,60
1657450366931,COGS 14A,A01,092681,Semenuks; Arturs,5,1,100,95
1657450372956,COGS 14B,A01,083073,Cheng; Tzu-Han,6,0,63,57
1657450378980,COGS 17,A01,092677,Semenuks; Arturs,6,0,81,75
1657450385012,COGS 100,A01,083619,Allen; Michael Gordon,17,0,70,53
1657450391034,COGS 101A,A01,083621,Davis; Joshua Daniel,9,0,68,59
1657450397059,COGS 101B,A01,091572,Allen; Michael Gordon,12,0,65,53
1657450403085,COGS 101C,A01,083625,Delgado; Tania,17,0,35,18
1657450409112,COGS 107A,A01,083627,Boyle; Mary E. T.,13,0,60,47
1657450415151,COGS 118A,A01,083075,Gupta; Anjum,21,0,76,55
1657450421177,CSE 3,A50,083646,Miranda; Gregory Joseph,24,0,50,26
1657450427204,CSE 8A,A50,083650,Miranda; Gregory Joseph,17,1,56,39
1657450433228,CSE 11,A01,083080,Cao; Yingjun,6,15,40,34
1657450439253,CSE 12,A01,083652,Krause-Levy; Sophia Louisa,28,1,120,92
1657450445286,CSE 15L,A01,083654,Morris; Justin Loren,9,0,50,41
1657450445286,CSE 15L,A02,083655,Morris; Justin Loren,9,0,50,41
1657450451325,CSE 20,A01,083657,Tran; Khoa Dang,39,0,80,41
1657450457351,CSE 21,A01,095574,Bach; Quang Tran,22,0,48,26
1657450463383,CSE 30,A01,083084,Eldon; John,5,0,80,75
1657450463383,CSE 30,B01,095061,Bhaskar; Nishant,9,0,50,41
1657450469410,CSE 100,A01,083659,Cao; Yingjun,5,4,70,65
1657450475438,CSE 134B,A01,083661,Powell; Thomas Allan,22,0,100,78
1657450481463,CSE 140,A01,083663,Gungor; Onat,15,0,85,70
1657450487486,CSE 140L,A01,083088,Eldon; John,21,0,100,79
1657450493517,CSE 175,A01,083665,Kumar; Rakesh,3,0,25,22
1657450499540,CSE 190,A00,092507,Dubnov; Shlomo,8,0,20,12
1657450505573,ECE 45,A01,083139,Congero; Spencer William,6,0,75,69
1657450511608,ECE 65,A50,083695,Saad; Andrew S,12,0,30,18
1657450511608,ECE 65,A51,095125,Saad; Andrew S,24,0,26,2
1657450517633,ECE 109,A01,091882,Touri; Behrouz,19,0,70,51
1657450523664,ECE 180,A00,083140,Abi Samra; Nicholas Camill,1,0,30,29
1657450523664,ECE 180,B00,083141,Abi Samra; Nicholas Camill,0,0,30,30
1657450529699,MATH 10A,A01,083735,Patchell; Gregory David,2,0,30,28
1657450529699,MATH 10A,A02,083736,Patchell; Gregory David,20,0,30,10
1657450529699,MATH 10A,A03,083737,Patchell; Gregory David,16,0,30,14
1657450535731,MATH 10B,A01,083207,Lim; Seonhee,8,0,34,26
1657450535731,MATH 10B,A02,083208,Lim; Seonhee,9,0,35,26
1657450535731,MATH 10B,A03,093472,Lim; Seonhee,7,0,34,27
1657450535731,MATH 10B,B01,083739,Sinha; Shubham,12,0,30,18
1657450541772,MATH 18,A01,083743,Cinel; Cameron Alexander,7,0,30,23
1657450541772,MATH 18,A02,083744,Cinel; Cameron Alexander,17,0,30,13
1657450541772,MATH 18,A03,083745,Cinel; Cameron Alexander,9,0,30,21
1657450541772,MATH 18,B01,083748,Rideout; David Porter,5,0,37,32
1657450541772,MATH 18,B02,083749,Rideout; David Porter,5,0,36,31
1657450541772,MATH 18,B03,083750,Rideout; David Porter,3,0,37,34
1657450541772,MATH 18,B04,083751,Rideout; David Porter,6,0,36,30
1657450541772,MATH 18,B05,093473,Rideout; David Porter,6,0,36,30
1657450541772,MATH 18,B06,093474,Rideout; David Porter,6,0,36,30
1657450547795,MATH 20A,A01,083754,Zheng; Zequn,14,0,40,26
1657450553822,MATH 20B,A01,083756,Briones; Jor-el Thomas Caparas,4,0,36,32
1657450553822,MATH 20B,A02,083757,Briones; Jor-el Thomas Caparas,1,0,36,35
1657450553822,MATH 20B,A03,093475,Briones; Jor-el Thomas Caparas,2,0,36,34
1657450559847,MATH 20C,A01,083760,Briones; Jor-el Thomas Caparas,1,0,35,34
1657450559847,MATH 20C,A02,083761,Briones; Jor-el Thomas Caparas,8,0,35,27
1657450559847,MATH 20C,A03,093476,Briones; Jor-el Thomas Caparas,0,1,36,36
1657450559847,MATH 20C,B01,083762,Bach; Quang Tran,1,0,30,29
1657450565872,MATH 20D,A01,083765,Tran; Brian Kha,5,0,30,25
1657450565872,MATH 20D,A02,083766,Tran; Brian Kha,5,0,30,25
1657450565872,MATH 20D,A03,083767,Tran; Brian Kha,5,0,30,25
1657450571904,MATH 20E,A01,083771,Ganguly; Soumya,9,0,32,23
1657450571904,MATH 20E,A02,083772,Ganguly; Soumya,6,0,32,26
1657450571904,MATH 20E,B01,083773,Ciotti; Benjamin,20,0,35,15
1657450571904,MATH 20E,B02,083774,Ciotti; Benjamin,17,0,35,18
1657450577930,MATH 103A,A01,083777,Greenfeld; Be'Eri,3,0,36,33
1657450577930,MATH 103A,A02,083778,Greenfeld; Be'Eri,5,0,36,31
1657450577930,MATH 103A,A03,093561,Greenfeld; Be'Eri,5,0,36,31
1657450577930,MATH 103A,B01,083779,Greenfeld; Be'Eri,7,0,36,29
1657450577930,MATH 103A,B02,083780,Greenfeld; Be'Eri,4,0,36,32
1657450577930,MATH 103A,B03,093562,Greenfeld; Be'Eri,3,0,36,33
1657450583955,MATH 105,A01,085443,Carter; Anne Toulson,15,0,35,20
1657450583955,MATH 105,A02,093477,Carter; Anne Toulson,20,0,35,15
1657450589986,MATH 109,A01,083213,Ganzberger; Geoffrey Michael,2,0,34,32
1657450589986,MATH 109,A02,083214,Ganzberger; Geoffrey Michael,4,0,34,30
1657450589986,MATH 109,A03,093478,Ganzberger; Geoffrey Michael,2,0,34,32
1657450589986,MATH 109,B01,083215,Ganzberger; Geoffrey Michael,1,0,32,31
1657450589986,MATH 109,B02,083216,Ganzberger; Geoffrey Michael,2,0,32,30
1657450589986,MATH 109,B03,093479,Ganzberger; Geoffrey Michael,8,0,32,24
1657450596010,MATH 142A,A01,083219,Chow; Bennett,7,0,32,25
1657450596010,MATH 142A,A02,083220,Chow; Bennett,10,0,32,22
1657450596010,MATH 142A,A03,093480,Chow; Bennett,8,0,32,24
1657450596010,MATH 142A,B03,093481,Chow; Bennett,8,0,32,24
1657450596010,MATH 142A,B04,093558,Chow; Bennett,13,0,32,19
1657450596010,MATH 142A,B05,093559,Chow; Bennett,6,0,32,26
1657450602036,MATH 193A,A01,083224,Rotar; Vladimir,8,0,34,26
1657450602036,MATH 193A,A02,083225,Rotar; Vladimir,9,0,34,25
1657450602036,MATH 193A,A03,083781,Rotar; Vladimir,5,0,34,29
1657450602036,MATH 193A,A04,083782,Rotar; Vladimir,10,0,34,24
1657450602036,MATH 193A,A05,093482,Rotar; Vladimir,10,0,34,24
1657450608062,MATH 197,001,091859,McAuley; Julian John,9999,0,9999,0
1657450608062,MATH 197,002,095566,Kedlaya; Kiran S.,9997,0,9999,2
1657450608062,MATH 197,003,095567,Xiao; Ming,9999,0,9999,0
1657450608062,MATH 197,004,095571,Perols; Johan Lars,9998,0,9999,1
1657450615125,COGS 9,A01,083615,Shannon; Kyle Michael,9,0,75,66
1657450621148,COGS 11,A01,083617,Boyle; Mary E. T.,22,0,48,26
1657450627179,COGS 13,A01,083071,Bastos; Amalia Pinkusfeld,11,0,71,60
1657450633204,COGS 14A,A01,092681,Semenuks; Arturs,5,1,100,95
1657450639229,COGS 14B,A01,083073,Cheng; Tzu-Han,6,0,63,57
1657450645253,COGS 17,A01,092677,Semenuks; Arturs,6,0,81,75
1657450651281,COGS 100,A01,083619,Allen; Michael Gordon,17,0,70,53
1657450657309,COGS 101A,A01,083621,Davis; Joshua Daniel,9,0,68,59
1657450663333,COGS 101B,A01,091572,Allen; Michael Gordon,12,0,65,53
1657450669364,COGS 101C,A01,083625,Delgado; Tania,17,0,35,18
1657450675388,COGS 107A,A01,083627,Boyle; Mary E. T.,13,0,60,47
1657450681413,COGS 118A,A01,083075,Gupta; Anjum,21,0,76,55
1657450687439,CSE 3,A50,083646,Miranda; Gregory Joseph,24,0,50,26
1657450693469,CSE 8A,A50,083650,Miranda; Gregory Joseph,17,1,56,39
1657450699495,CSE 11,A01,083080,Cao; Yingjun,6,15,40,34
1657450705522,CSE 12,A01,083652,Krause-Levy; Sophia Louisa,28,1,120,92
1657450711550,CSE 15L,A01,083654,Morris; Justin Loren,9,0,50,41
1657450711550,CSE 15L,A02,083655,Morris; Justin Loren,9,0,50,41
1657450717576,CSE 20,A01,083657,Tran; Khoa Dang,39,0,80,41
1657450723605,CSE 21,A01,095574,Bach; Quang Tran,22,0,48,26
1657450729632,CSE 30,A01,083084,Eldon; John,5,0,80,75
1657450729632,CSE 30,B01,095061,Bhaskar; Nishant,9,0,50,41
1657450735659,CSE 100,A01,083659,Cao; Yingjun,5,4,70,65
1657450741686,CSE 134B,A01,083661,Powell; Thomas Allan,22,0,100,78
1657450747709,CSE 140,A01,083663,Gungor; Onat,15,0,85,70
1657450753739,CSE 140L,A01,083088,Eldon; John,21,0,100,79
1657450759761,CSE 175,A01,083665,Kumar; Rakesh,3,0,25,22
1657450765787,CSE 190,A00,092507,Dubnov; Shlomo,8,0,20,12
1657450771812,ECE 45,A01,083139,Congero; Spencer William,6,0,75,69
1657450777850,ECE 65,A50,083695,Saad; Andrew S,12,0,30,18
1657450777850,ECE 65,A51,095125,Saad; Andrew S,24,0,26,2
1657450783969,ECE 109,A01,091882,Touri; Behrouz,19,0,70,51
1657450789992,ECE 180,A00,083140,Abi Samra; Nicholas Camill,1,0,30,29
1657450789992,ECE 180,B00,083141,Abi Samra; Nicholas Camill,0,0,30,30
1657450796029,MATH 10A,A01,083735,Patchell; Gregory David,2,0,30,28
1657450796029,MATH 10A,A02,083736,Patchell; Gregory David,20,0,30,10
1657450796029,MATH 10A,A03,083737,Patchell; Gregory David,16,0,30,14
1657450802057,MATH 10B,A01,083207,Lim; Seonhee,8,0,34,26
1657450802057,MATH 10B,A02,083208,Lim; Seonhee,9,0,35,26
1657450802057,MATH 10B,A03,093472,Lim; Seonhee,7,0,34,27
1657450802057,MATH 10B,B01,083739,Sinha; Shubham,12,0,30,18
1657450808085,MATH 18,A01,083743,Cinel; Cameron Alexander,7,0,30,23
1657450808085,MATH 18,A02,083744,Cinel; Cameron Alexander,17,0,30,13
1657450808085,MATH 18,A03,083745,Cinel; Cameron Alexander,9,0,30,21
1657450808085,MATH 18,B01,083748,Rideout; David Porter,5,0,37,32
1657450808085,MATH 18,B02,083749,Rideout; David Porter,5,0,36,31
1657450808085,MATH 18,B03,083750,Rideout; David Porter,3,0,37,34
1657450808085,MATH 18,B04,083751,Rideout; David Porter,6,0,36,30
1657450808085,MATH 18,B05,093473,Rideout; David Porter,6,0,36,30
1657450808085,MATH 18,B06,093474,Rideout; David Porter,6,0,36,30
1657450814117,MATH 20A,A01,083754,Zheng; Zequn,14,0,40,26
1657450820150,MATH 20B,A01,083756,Briones; Jor-el Thomas Caparas,4,0,36,32
1657450820150,MATH 20B,A02,083757,Briones; Jor-el Thomas Caparas,1,0,36,35
1657450820150,MATH 20B,A03,093475,Briones; Jor-el Thomas Caparas,2,0,36,34
1657450826176,MATH 20C,A01,083760,Briones; Jor-el Thomas Caparas,1,0,35,34
1657450826176,MATH 20C,A02,083761,Briones; Jor-el Thomas Caparas,8,0,35,27
1657450826176,MATH 20C,A03,093476,Briones; Jor-el Thomas Caparas,0,1,36,36
1657450826176,MATH 20C,B01,083762,Bach; Quang Tran,1,0,30,29
1657450832200,MATH 20D,A01,083765,Tran; Brian Kha,5,0,30,25
1657450832200,MATH 20D,A02,083766,Tran; Brian Kha,5,0,30,25
1657450832200,MATH 20D,A03,083767,Tran; Brian Kha,5,0,30,25
1657450838226,MATH 20E,A01,083771,Ganguly; Soumya,9,0,32,23
1657450838226,MATH 20E,A02,083772,Ganguly; Soumya,6,0,32,26
1657450838226,MATH 20E,B01,083773,Ciotti; Benjamin,20,0,35,15
1657450838226,MATH 20E,B02,083774,Ciotti; Benjamin,17,0,35,18
1657450844252,MATH 103A,A01,083777,Greenfeld; Be'Eri,3,0,36,33
1657450844252,MATH 103A,A02,083778,Greenfeld; Be'Eri,5,0,36,31
1657450844252,MATH 103A,A03,093561,Greenfeld; Be'Eri,5,0,36,31
1657450844252,MATH 103A,B01,083779,Greenfeld; Be'Eri,7,0,36,29
1657450844252,MATH 103A,B02,083780,Greenfeld; Be'Eri,4,0,36,32
1657450844252,MATH 103A,B03,093562,Greenfeld; Be'Eri,3,0,36,33
1657450850282,MATH 105,A01,085443,Carter; Anne Toulson,15,0,35,20
1657450850282,MATH 105,A02,093477,Carter; Anne Toulson,20,0,35,15
1657450856309,MATH 109,A01,083213,Ganzberger; Geoffrey Michael,2,0,34,32
1657450856309,MATH 109,A02,083214,Ganzberger; Geoffrey Michael,4,0,34,30
1657450856309,MATH 109,A03,093478,Ganzberger; Geoffrey Michael,2,0,34,32
1657450856309,MATH 109,B01,083215,Ganzberger; Geoffrey Michael,1,0,32,31
1657450856309,MATH 109,B02,083216,Ganzberger; Geoffrey Michael,2,0,32,30
1657450856309,MATH 109,B03,093479,Ganzberger; Geoffrey Michael,8,0,32,24
1657450862335,MATH 142A,A01,083219,Chow; Bennett,7,0,32,25
1657450862335,MATH 142A,A02,083220,Chow; Bennett,10,0,32,22
1657450862335,MATH 142A,A03,093480,Chow; Bennett,8,0,32,24
1657450862335,MATH 142A,B03,093481,Chow; Bennett,8,0,32,24
1657450862335,MATH 142A,B04,093558,Chow; Bennett,13,0,32,19
1657450862335,MATH 142A,B05,093559,Chow; Bennett,6,0,32,26
1657450868366,MATH 193A,A01,083224,Rotar; Vladimir,8,0,34,26
1657450868366,MATH 193A,A02,083225,Rotar; Vladimir,9,0,34,25
1657450868366,MATH 193A,A03,083781,Rotar; Vladimir,5,0,34,29
1657450868366,MATH 193A,A04,083782,Rotar; Vladimir,10,0,34,24
1657450868366,MATH 193A,A05,093482,Rotar; Vladimir,10,0,34,24
1657450874392,MATH 197,001,091859,McAuley; Julian John,9999,0,9999,0
1657450874392,MATH 197,002,095566,Kedlaya; Kiran S.,9997,0,9999,2
1657450874392,MATH 197,003,095567,Xiao; Ming,9999,0,9999,0
1657450874392,MATH 197,004,095571,Perols; Johan Lars,9998,0,9999,1
1657450881463,COGS 9,A01,083615,Shannon; Kyle Michael,9,0,75,66
1657450887487,COGS 11,A01,083617,Boyle; Mary E. T.,22,0,48,26
1657450893518,COGS 13,A01,083071,Bastos; Amalia Pinkusfeld,11,0,71,60
1657450899541,COGS 14A,A01,092681,Semenuks; Arturs,5,1,100,95
1657450905570,COGS 14B,A01,083073,Cheng; Tzu-Han,6,0,63,57
1657450911598,COGS 17,A01,092677,Semenuks; Arturs,6,0,81,75
1657450917623,COGS 100,A01,083619,Allen; Michael Gordon,17,0,70,53
1657450923650,COGS 101A,A01,083621,Davis; Joshua Daniel,9,0,68,59
1657450929674,COGS 101B,A01,091572,Allen; Michael Gordon,12,0,65,53
1657450935699,COGS 101C,A01,083625,Delgado; Tania,17,0,35,18
1657450941721,COGS 107A,A01,083627,Boyle; Mary E. T.,13,0,60,47
1657450947744,COGS 118A,A01,083075,Gupta; Anjum,21,0,76,55
1657450953772,CSE 3,A50,083646,Miranda; Gregory Joseph,24,0,50,26
1657450959795,CSE 8A,A50,083650,Miranda; Gregory Joseph,17,1,56,39
1657450965818,CSE 11,A01,083080,Cao; Yingjun,6,15,40,34
1657450971940,CSE 12,A01,083652,Krause-Levy; Sophia Louisa,28,1,120,92
1657450977971,CSE 15L,A01,083654,Morris; Justin Loren,9,0,50,41
1657450977971,CSE 15L,A02,083655,Morris; Justin Loren,9,0,50,41
1657450984004,CSE 20,A01,083657,Tran; Khoa Dang,39,0,80,41
1657450990035,CSE 21,A01,095574,Bach; Quang Tran,22,0,48,26
1657450996062,CSE 30,A01,083084,Eldon; John,5,0,80,75
1657450996062,CSE 30,B01,095061,Bhaskar; Nishant,9,0,50,41
1657451002094,CSE 100,A01,083659,Cao; Yingjun,5,4,70,65
1657451008125,CSE 134B,A01,083661,Powell; Thomas Allan,22,0,100,78
1657451014157,CSE 140,A01,083663,Gungor; Onat,15,0,85,70
1657451020188,CSE 140L,A01,083088,Eldon; John,21,0,100,79
1657451026217,CSE 175,A01,083665,Kumar; Rakesh,3,0,25,22
1657451032247,CSE 190,A00,092507,Dubnov; Shlomo,8,0,20,12
1657451038273,ECE 45,A01,083139,Congero; Spencer William,6,0,75,69
1657451044305,ECE 65,A50,083695,Saad; Andrew S,12,0,30,18
1657451044305,ECE 65,A51,095125,Saad; Andrew S,24,0,26,2
1657451050335,ECE 109,A01,091882,Touri; Behrouz,19,0,70,51
1657451056372,ECE 180,A00,083140,Abi Samra; Nicholas Camill,1,0,30,29
1657451056372,ECE 180,B00,083141,Abi Samra; Nicholas Camill,0,0,30,30
1657451062401,MATH 10A,A01,083735,Patchell; Gregory David,2,0,30,28
1657451062401,MATH 10A,A02,083736,Patchell; Gregory David,20,0,30,10
1657451062401,MATH 10A,A03,083737,Patchell; Gregory David,16,0,30,14
1657451068430,MATH 10B,A01,083207,Lim; Seonhee,8,0,34,26
1657451068430,MATH 10B,A02,083208,Lim; Seonhee,9,0,35,26
1657451068430,MATH 10B,A03,093472,Lim; Seonhee,7,0,34,27
1657451068430,MATH 10B,B01,083739,Sinha; Shubham,12,0,30,18
1657451074465,MATH 18,A01,083743,Cinel; Cameron Alexander,7,0,30,23
1657451074465,MATH 18,A02,083744,Cinel; Cameron Alexander,17,0,30,13
1657451074465,MATH 18,A03,083745,Cinel; Cameron Alexander,9,0,30,21
1657451074465,MATH 18,B01,083748,Rideout; David Porter,5,0,37,32
1657451074465,MATH 18,B02,083749,Rideout; David Porter,5,0,36,31
1657451074465,MATH 18,B03,083750,Rideout; David Porter,3,0,37,34
1657451074465,MATH 18,B04,083751,Rideout; David Porter,6,0,36,30
1657451074465,MATH 18,B05,093473,Rideout; David Porter,6,0,36,30
1657451074465,MATH 18,B06,093474,Rideout; David Porter,6,0,36,30
1657451080490,MATH 20A,A01,083754,Zheng; Zequn,14,0,40,26
1657451086526,MATH 20B,A01,083756,Briones; Jor-el Thomas Caparas,4,0,36,32
1657451086526,MATH 20B,A02,083757,Briones; Jor-el Thomas Caparas,1,0,36,35
1657451086526,MATH 20B,A03,093475,Briones; Jor-el Thomas Caparas,2,0,36,34
1657451092565,MATH 20C,A01,083760,Briones; Jor-el Thomas Caparas,1,0,35,34
1657451092565,MATH 20C,A02,083761,Briones; Jor-el Thomas Caparas,8,0,35,27
1657451092565,MATH 20C,A03,093476,Briones; Jor-el Thomas Caparas,0,1,36,36
1657451092565,MATH 20C,B01,083762,Bach; Quang Tran,1,0,30,29
1657451098589,MATH 20D,A01,083765,Tran; Brian Kha,5,0,30,25
1657451098589,MATH 20D,A02,083766,Tran; Brian Kha,5,0,30,25
1657451098589,MATH 20D,A03,083767,Tran; Brian Kha,5,0,30,25
1657451104617,MATH 20E,A01,083771,Ganguly; Soumya,9,0,32,23
1657451104617,MATH 20E,A02,083772,Ganguly; Soumya,6,0,32,26
1657451104617,MATH 20E,B01,083773,Ciotti; Benjamin,20,0,35,15
1657451104617,MATH 20E,B02,083774,Ciotti; Benjamin,17,0,35,18
1657451110645,MATH 103A,A01,083777,Greenfeld; Be'Eri,3,0,36,33
1657451110645,MATH 103A,A02,083778,Greenfeld; Be'Eri,5,0,36,31
1657451110645,MATH 103A,A03,093561,Greenfeld; Be'Eri,5,0,36,31
1657451110645,MATH 103A,B01,083779,Greenfeld; Be'Eri,7,0,36,29
1657451110645,MATH 103A,B02,083780,Greenfeld; Be'Eri,4,0,36,32
1657451110645,MATH 103A,B03,093562,Greenfeld; Be'Eri,3,0,36,33
1657451116677,MATH 105,A01,085443,Carter; Anne Toulson,15,0,35,20
1657451116677,MATH 105,A02,093477,Carter; Anne Toulson,20,0,35,15
1657451122701,MATH 109,A01,083213,Ganzberger; Geoffrey Michael,2,0,34,32
1657451122701,MATH 109,A02,083214,Ganzberger; Geoffrey Michael,4,0,34,30
1657451122701,MATH 109,A03,093478,Ganzberger; Geoffrey Michael,2,0,34,32
1657451122701,MATH 109,B01,083215,Ganzberger; Geoffrey Michael,1,0,32,31
1657451122701,MATH 109,B02,083216,Ganzberger; Geoffrey Michael,2,0,32,30
1657451122701,MATH 109,B03,093479,Ganzberger; Geoffrey Michael,8,0,32,24
1657451128727,MATH 142A,A01,083219,Chow; Bennett,7,0,32,25
1657451128727,MATH 142A,A02,083220,Chow; Bennett,10,0,32,22
1657451128727,MATH 142A,A03,093480,Chow; Bennett,8,0,32,24
1657451128727,MATH 142A,B03,093481,Chow; Bennett,8,0,32,24
1657451128727,MATH 142A,B04,093558,Chow; Bennett,13,0,32,19
1657451128727,MATH 142A,B05,093559,Chow; Bennett,6,0,32,26
1657451134751,MATH 193A,A01,083224,Rotar; Vladimir,8,0,34,26
1657451134751,MATH 193A,A02,083225,Rotar; Vladimir,9,0,34,25
1657451134751,MATH 193A,A03,083781,Rotar; Vladimir,5,0,34,29
1657451134751,MATH 193A,A04,083782,Rotar; Vladimir,10,0,34,24
1657451134751,MATH 193A,A05,093482,Rotar; Vladimir,10,0,34,24
1657451140775,MATH 197,001,091859,McAuley; Julian John,9999,0,9999,0
1657451140775,MATH 197,002,095566,Kedlaya; Kiran S.,9997,0,9999,2
1657451140775,MATH 197,003,095567,Xiao; Ming,9999,0,9999,0
1657451140775,MATH 197,004,095571,Perols; Johan Lars,9998,0,9999,1
1657451147851,COGS 9,A01,083615,Shannon; Kyle Michael,9,0,75,66
1657451153883,COGS 11,A01,083617,Boyle; Mary E. T.,22,0,48,26
1657451159914,COGS 13,A01,083071,Bastos; Amalia Pinkusfeld,11,0,71,60
1657451165939,COGS 14A,A01,092681,Semenuks; Arturs,5,1,100,95
1657451171964,COGS 14B,A01,083073,Cheng; Tzu-Han,6,0,63,57
1657451177991,COGS 17,A01,092677,Semenuks; Arturs,6,0,81,75
1657451184014,COGS 100,A01,083619,Allen; Michael Gordon,17,0,70,53
1657451190038,COGS 101A,A01,083621,Davis; Joshua Daniel,9,0,68,59
1657451196061,COGS 101B,A01,091572,Allen; Michael Gordon,12,0,65,53
1657451202087,COGS 101C,A01,083625,Delgado; Tania,17,0,35,18
1657451208111,COGS 107A,A01,083627,Boyle; Mary E. T.,13,0,60,47
1657451214140,COGS 118A,A01,083075,Gupta; Anjum,21,0,76,55
1657451220180,CSE 3,A50,083646,Miranda; Gregory Joseph,24,0,50,26
1657451226204,CSE 8A,A50,083650,Miranda; Gregory Joseph,17,1,56,39
1657451232229,CSE 11,A01,083080,Cao; Yingjun,6,15,40,34
1657451238257,CSE 12,A01,083652,Krause-Levy; Sophia Louisa,28,1,120,92
1657451244281,CSE 15L,A01,083654,Morris; Justin Loren,9,0,50,41
1657451244281,CSE 15L,A02,083655,Morris; Justin Loren,9,0,50,41
1657451250308,CSE 20,A01,083657,Tran; Khoa Dang,39,0,80,41
1657451256337,CSE 21,A01,095574,Bach; Quang Tran,22,0,48,26
1657451262370,CSE 30,A01,083084,Eldon; John,5,0,80,75
1657451262370,CSE 30,B01,095061,Bhaskar; Nishant,9,0,50,41
1657451268400,CSE 100,A01,083659,Cao; Yingjun,5,4,70,65
1657451274426,CSE 134B,A01,083661,Powell; Thomas Allan,22,0,100,78
1657451280453,CSE 140,A01,083663,Gungor; Onat,15,0,85,70
1657451286476,CSE 140L,A01,083088,Eldon; John,21,0,100,79
1657451292500,CSE 175,A01,083665,Kumar; Rakesh,3,0,25,22
1657451298529,CSE 190,A00,092507,Dubnov; Shlomo,8,0,20,12
1657451304554,ECE 45,A01,083139,Congero; Spencer William,6,0,75,69
1657451310580,ECE 65,A50,083695,Saad; Andrew S,12,0,30,18
1657451310580,ECE 65,A51,095125,Saad; Andrew S,24,0,26,2
1657451316605,ECE 109,A01,091882,Touri; Behrouz,19,0,70,51
1657451322628,ECE 180,A00,083140,Abi Samra; Nicholas Camill,1,0,30,29
1657451322628,ECE 180,B00,083141,Abi Samra; Nicholas Camill,0,0,30,30
1657451328662,MATH 10A,A01,083735,Patchell; Gregory David,2,0,30,28
1657451328662,MATH 10A,A02,083736,Patchell; Gregory David,20,0,30,10
1657451328662,MATH 10A,A03,083737,Patchell; Gregory David,16,0,30,14
1657451334689,MATH 10B,A01,083207,Lim; Seonhee,8,0,34,26
1657451334689,MATH 10B,A02,083208,Lim; Seonhee,9,0,35,26
1657451334689,MATH 10B,A03,093472,Lim; Seonhee,7,0,34,27
1657451334689,MATH 10B,B01,083739,Sinha; Shubham,12,0,30,18
1657451340724,MATH 18,A01,083743,Cinel; Cameron Alexander,7,0,30,23
1657451340724,MATH 18,A02,083744,Cinel; Cameron Alexander,17,0,30,13
1657451340724,MATH 18,A03,083745,Cinel; Cameron Alexander,9,0,30,21
1657451340724,MATH 18,B01,083748,Rideout; David Porter,5,0,37,32
1657451340724,MATH 18,B02,083749,Rideout; David Porter,5,0,36,31
1657451340724,MATH 18,B03,083750,Rideout; David Porter,3,0,37,34
1657451340724,MATH 18,B04,083751,Rideout; David Porter,6,0,36,30
1657451340724,MATH 18,B05,093473,Rideout; David Porter,6,0,36,30
1657451340724,MATH 18,B06,093474,Rideout; David Porter,6,0,36,30
1657451346754,MATH 20A,A01,083754,Zheng; Zequn,14,0,40,26
1657451352778,MATH 20B,A01,083756,Briones; Jor-el Thomas Caparas,4,0,36,32
1657451352778,MATH 20B,A02,083757,Briones; Jor-el Thomas Caparas,1,0,36,35
1657451352778,MATH 20B,A03,093475,Briones; Jor-el Thomas Caparas,2,0,36,34
1657451358804,MATH 20C,A01,083760,Briones; Jor-el Thomas Caparas,1,0,35,34
1657451358804,MATH 20C,A02,083761,Briones; Jor-el Thomas Caparas,8,0,35,27
1657451358804,MATH 20C,A03,093476,Briones; Jor-el Thomas Caparas,0,1,36,36
1657451358804,MATH 20C,B01,083762,Bach; Quang Tran,1,0,30,29
1657451364833,MATH 20D,A01,083765,Tran; Brian Kha,5,0,30,25
1657451364833,MATH 20D,A02,083766,Tran; Brian Kha,5,0,30,25
1657451364833,MATH 20D,A03,083767,Tran; Brian Kha,5,0,30,25
1657451370866,MATH 20E,A01,083771,Ganguly; Soumya,9,0,32,23
1657451370866,MATH 20E,A02,083772,Ganguly; Soumya,6,0,32,26
1657451370866,MATH 20E,B01,083773,Ciotti; Benjamin,20,0,35,15
1657451370866,MATH 20E,B02,083774,Ciotti; Benjamin,17,0,35,18
1657451376903,MATH 103A,A01,083777,Greenfeld; Be'Eri,3,0,36,33
1657451376903,MATH 103A,A02,083778,Greenfeld; Be'Eri,5,0,36,31
1657451376903,MATH 103A,A03,093561,Greenfeld; Be'Eri,5,0,36,31
1657451376903,MATH 103A,B01,083779,Greenfeld; Be'Eri,7,0,36,29
1657451376903,MATH 103A,B02,083780,Greenfeld; Be'Eri,4,0,36,32
1657451376903,MATH 103A,B03,093562,Greenfeld; Be'Eri,3,0,36,33
1657451382928,MATH 105,A01,085443,Carter; Anne Toulson,15,0,35,20
1657451382928,MATH 105,A02,093477,Carter; Anne Toulson,20,0,35,15
1657451388953,MATH 109,A01,083213,Ganzberger; Geoffrey Michael,2,0,34,32
1657451388953,MATH 109,A02,083214,Ganzberger; Geoffrey Michael,4,0,34,30
1657451388953,MATH 109,A03,093478,Ganzberger; Geoffrey Michael,2,0,34,32
1657451388953,MATH 109,B01,083215,Ganzberger; Geoffrey Michael,1,0,32,31
1657451388953,MATH 109,B02,083216,Ganzberger; Geoffrey Michael,2,0,32,30
1657451388953,MATH 109,B03,093479,Ganzberger; Geoffrey Michael,8,0,32,24
1657451394977,MATH 142A,A01,083219,Chow; Bennett,7,0,32,25
1657451394977,MATH 142A,A02,083220,Chow; Bennett,10,0,32,22
1657451394977,MATH 142A,A03,093480,Chow; Bennett,8,0,32,24
1657451394977,MATH 142A,B03,093481,Chow; Bennett,8,0,32,24
1657451394977,MATH 142A,B04,093558,Chow; Bennett,13,0,32,19
1657451394977,MATH 142A,B05,093559,Chow; Bennett,6,0,32,26
1657451401003,MATH 193A,A01,083224,Rotar; Vladimir,8,0,34,26
1657451401003,MATH 193A,A02,083225,Rotar; Vladimir,9,0,34,25
1657451401003,MATH 193A,A03,083781,Rotar; Vladimir,5,0,34,29
1657451401003,MATH 193A,A04,083782,Rotar; Vladimir,10,0,34,24
1657451401003,MATH 193A,A05,093482,Rotar; Vladimir,10,0,34,24
1657451407029,MATH 197,001,091859,McAuley; Julian John,9999,0,9999,0
1657451407029,MATH 197,002,095566,Kedlaya; Kiran S.,9997,0,9999,2
1657451407029,MATH 197,003,095567,Xiao; Ming,9999,0,9999,0
1657451407029,MATH 197,004,095571,Perols; Johan Lars,9998,0,9999,1
1657451414091,COGS 9,A01,083615,Shannon; Kyle Michael,9,0,75,66
1657451420122,COGS 11,A01,083617,Boyle; Mary E. T.,22,0,48,26
1657451426147,COGS 13,A01,083071,Bastos; Amalia Pinkusfeld,11,0,71,60
1657451432176,COGS 14A,A01,092681,Semenuks; Arturs,5,1,100,95
1657451438206,COGS 14B,A01,083073,Cheng; Tzu-Han,6,0,63,57
1657451444234,COGS 17,A01,092677,Semenuks; Arturs,6,0,81,75
1657451450260,COGS 100,A01,083619,Allen; Michael Gordon,17,0,70,53
1657451456285,COGS 101A,A01,083621,Davis; Joshua Daniel,9,0,68,59
1657451462316,COGS 101B,A01,091572,Allen; Michael Gordon,12,0,65,53
1657451468349,COGS 101C,A01,083625,Delgado; Tania,17,0,35,18
1657451474373,COGS 107A,A01,083627,Boyle; Mary E. T.,13,0,60,47
1657451480403,COGS 118A,A01,083075,Gupta; Anjum,21,0,76,55
1657451486445,CSE 3,A50,083646,Miranda; Gregory Joseph,24,0,50,26
1657451492473,CSE 8A,A50,083650,Miranda; Gregory Joseph,17,1,56,39
1657451498502,CSE 11,A01,083080,Cao; Yingjun,6,15,40,34
1657451504527,CSE 12,A01,083652,Krause-Levy; Sophia Louisa,28,1,120,92
1657451510552,CSE 15L,A01,083654,Morris; Justin Loren,9,0,50,41
1657451510552,CSE 15L,A02,083655,Morris; Justin Loren,9,0,50,41
1657451516581,CSE 20,A01,083657,Tran; Khoa Dang,39,0,80,41
1657451522613,CSE 21,A01,095574,Bach; Quang Tran,22,0,48,26
1657451528642,CSE 30,A01,083084,Eldon; John,5,0,80,75
1657451528642,CSE 30,B01,095061,Bhaskar; Nishant,9,0,50,41
1657451534667,CSE 100,A01,083659,Cao; Yingjun,5,4,70,65
1657451540700,CSE 134B,A01,083661,Powell; Thomas Allan,22,0,100,78
1657451546739,CSE 140,A01,083663,Gungor; Onat,15,0,85,70
1657451552765,CSE 140L,A01,083088,Eldon; John,21,0,100,79
1657451558789,CSE 175,A01,083665,Kumar; Rakesh,3,0,25,22
1657451564813,CSE 190,A00,092507,Dubnov; Shlomo,8,0,20,12
1657451570913,ECE 45,A01,083139,Congero; Spencer William,6,0,75,69
1657451576942,ECE 65,A50,083695,Saad; Andrew S,12,0,30,18
1657451576942,ECE 65,A51,095125,Saad; Andrew S,24,0,26,2
1657451582967,ECE 109,A01,091882,Touri; Behrouz,19,0,70,51
1657451588992,ECE 180,A00,083140,Abi Samra; Nicholas Camill,1,0,30,29
1657451588992,ECE 180,B00,083141,Abi Samra; Nicholas Camill,0,0,30,30
1657451595021,MATH 10A,A01,083735,Patchell; Gregory David,2,0,30,28
1657451595021,MATH 10A,A02,083736,Patchell; Gregory David,20,0,30,10
1657451595021,MATH 10A,A03,083737,Patchell; Gregory David,16,0,30,14
1657451601047,MATH 10B,A01,083207,Lim; Seonhee,8,0,34,26
1657451601047,MATH 10B,A02,083208,Lim; Seonhee,9,0,35,26
1657451601047,MATH 10B,A03,093472,Lim; Seonhee,7,0,34,27
1657451601047,MATH 10B,B01,083739,Sinha; Shubham,12,0,30,18
1657451607083,MATH 18,A01,083743,Cinel; Cameron Alexander,7,0,30,23
1657451607083,MATH 18,A02,083744,Cinel; Cameron Alexander,17,0,30,13
1657451607083,MATH 18,A03,083745,Cinel; Cameron Alexander,9,0,30,21
1657451607083,MATH 18,B01,083748,Rideout; David Porter,5,0,37,32
1657451607083,MATH 18,B02,083749,Rideout; David Porter,5,0,36,31
1657451607083,MATH 18,B03,083750,Rideout; David Porter,3,0,37,34
1657451607083,MATH 18,B04,083751,Rideout; David Porter,6,0,36,30
1657451607083,MATH 18,B05,093473,Rideout; David Porter,6,0,36,30
1657451607083,MATH 18,B06,093474,Rideout; David Porter,6,0,36,30
1657451613113,MATH 20A,A01,083754,Zheng; Zequn,14,0,40,26
1657451619152,MATH 20B,A01,083756,Briones; Jor-el Thomas Caparas,4,0,36,32
1657451619152,MATH 20B,A02,083757,Briones; Jor-el Thomas Caparas,1,0,36,35
1657451619152,MATH 20B,A03,093475,Briones; Jor-el Thomas Caparas,2,0,36,34
1657451625177,MATH 20C,A01,083760,Briones; Jor-el Thomas Caparas,1,0,35,34
1657451625177,MATH 20C,A02,083761,Briones; Jor-el Thomas Caparas,8,0,35,27
1657451625177,MATH 20C,A03,093476,Briones; Jor-el Thomas Caparas,0,1,36,36
1657451625177,MATH 20C,B01,083762,Bach; Quang Tran,1,0,30,29
1657451631202,MATH 20D,A01,083765,Tran; Brian Kha,5,0,30,25
1657451631202,MATH 20D,A02,083766,Tran; Brian Kha,5,0,30,25
1657451631202,MATH 20D,A03,083767,Tran; Brian Kha,5,0,30,25
1657451637240,MATH 20E,A01,083771,Ganguly; Soumya,9,0,32,23
1657451637240,MATH 20E,A02,083772,Ganguly; Soumya,6,0,32,26
1657451637240,MATH 20E,B01,083773,Ciotti; Benjamin,20,0,35,15
1657451637240,MATH 20E,B02,083774,Ciotti; Benjamin,17,0,35,18
1657451643268,MATH 103A,A01,083777,Greenfeld; Be'Eri,3,0,36,33
1657451643268,MATH 103A,A02,083778,Greenfeld; Be'Eri,5,0,36,31
1657451643268,MATH 103A,A03,093561,Greenfeld; Be'Eri,5,0,36,31
1657451643268,MATH 103A,B01,083779,Greenfeld; Be'Eri,7,0,36,29
1657451643268,MATH 103A,B02,083780,Greenfeld; Be'Eri,4,0,36,32
1657451643268,MATH 103A,B03,093562,Greenfeld; Be'Eri,3,0,36,33
1657451649311,MATH 105,A01,085443,Carter; Anne Toulson,15,0,35,20
1657451649311,MATH 105,A02,093477,Carter; Anne Toulson,20,0,35,15
1657451664238,MATH 109,A01,083213,Ganzberger; Geoffrey Michael,2,0,34,32
1657451664238,MATH 109,A02,083214,Ganzberger; Geoffrey Michael,4,0,34,30
1657451664238,MATH 109,A03,093478,Ganzberger; Geoffrey Michael,2,0,34,32
1657451664238,MATH 109,B01,083215,Ganzberger; Geoffrey Michael,1,0,32,31
1657451664238,MATH 109,B02,083216,Ganzberger; Geoffrey Michael,2,0,32,30
1657451664238,MATH 109,B03,093479,Ganzberger; Geoffrey Michael,8,0,32,24
1657451670276,MATH 142A,A01,083219,Chow; Bennett,7,0,32,25
1657451670276,MATH 142A,A02,083220,Chow; Bennett,10,0,32,22
1657451670276,MATH 142A,A03,093480,Chow; Bennett,8,0,32,24
1657451670276,MATH 142A,B03,093481,Chow; Bennett,8,0,32,24
1657451670276,MATH 142A,B04,093558,Chow; Bennett,13,0,32,19
1657451670276,MATH 142A,B05,093559,Chow; Bennett,6,0,32,26
1657451688182,MATH 193A,A01,083224,Rotar; Vladimir,8,0,34,26
1657451688182,MATH 193A,A02,083225,Rotar; Vladimir,9,0,34,25
1657451688182,MATH 193A,A03,083781,Rotar; Vladimir,5,0,34,29
1657451688182,MATH 193A,A04,083782,Rotar; Vladimir,10,0,34,24
1657451688182,MATH 193A,A05,093482,Rotar; Vladimir,10,0,34,24
1657451694209,MATH 197,001,091859,McAuley; Julian John,9999,0,9999,0
1657451694209,MATH 197,002,095566,Kedlaya; Kiran S.,9997,0,9999,2
1657451694209,MATH 197,003,095567,Xiao; Ming,9999,0,9999,0
1657451694209,MATH 197,004,095571,Perols; Johan Lars,9998,0,9999,1
1657451714191,COGS 9,A01,083615,Shannon; Kyle Michael,9,0,75,66
1657451720222,COGS 11,A01,083617,Boyle; Mary E. T.,22,0,48,26
1657451737532,COGS 13,A01,083071,Bastos; Amalia Pinkusfeld,11,0,71,60
1657451743558,COGS 14A,A01,092681,Semenuks; Arturs,5,1,100,95
1657451761666,COGS 14B,A01,083073,Cheng; Tzu-Han,6,0,63,57
1657451767689,COGS 17,A01,092677,Semenuks; Arturs,6,0,81,75
