time,subj_course_id,sec_code,sec_id,prof,available,waitlist,total,enrolled_ct
1657452350925,COGS 9,A01,083615,Shannon; Kyle Michael,9,0,75,66
1657452356963,COGS 11,A01,083617,Boyle; Mary E. T.,22,0,48,26
1657452363008,COGS 13,A01,083071,Bastos; Amalia Pinkusfeld,11,0,71,60
1657452369051,COGS 14A,A01,092681,Semenuks; Arturs,5,1,100,95
1657452375100,COGS 14B,A01,083073,Cheng; Tzu-Han,6,0,63,57
1657452381134,COGS 17,A01,092677,Semenuks; Arturs,6,0,81,75
1657452387169,COGS 100,A01,083619,Allen; Michael Gordon,17,0,70,53
1657452393205,COGS 101A,A01,083621,Davis; Joshua Daniel,9,0,68,59
1657452399237,COGS 101B,A01,091572,Allen; Michael Gordon,12,0,65,53
1657452405270,COGS 101C,A01,083625,Delgado; Tania,17,0,35,18
1657452411305,COGS 107A,A01,083627,Boyle; Mary E. T.,13,0,60,47
1657452417342,COGS 118A,A01,083075,Gupta; Anjum,21,0,76,55
1657452423386,CSE 3,A50,083646,Miranda; Gregory Joseph,24,0,50,26
1657452429418,CSE 8A,A50,083650,Miranda; Gregory Joseph,17,1,56,39
1657452435445,CSE 11,A01,083080,Cao; Yingjun,6,15,40,34
1657452441489,CSE 12,A01,083652,Krause-Levy; Sophia Louisa,28,1,120,92
1657452447534,CSE 15L,A01,083654,Morris; Justin Loren,9,0,50,41
1657452447534,CSE 15L,A02,083655,Morris; Justin Loren,9,0,50,41
1657452453569,CSE 20,A01,083657,Tran; Khoa Dang,39,0,80,41
1657452459605,CSE 21,A01,095574,Bach; Quang Tran,22,0,48,26
1657452465639,CSE 30,A01,083084,Eldon; John,5,0,80,75
1657452465639,CSE 30,B01,095061,Bhaskar; Nishant,9,0,50,41
1657452471676,CSE 100,A01,083659,Cao; Yingjun,5,4,70,65
1657452477712,CSE 134B,A01,083661,Powell; Thomas Allan,22,0,100,78
1657452483747,CSE 140,A01,083663,Gungor; Onat,15,0,85,70
1657452489785,CSE 140L,A01,083088,Eldon; John,21,0,100,79
1657452495819,CSE 175,A01,083665,Kumar; Rakesh,3,0,25,22
1657452501851,CSE 190,A00,092507,Dubnov; Shlomo,8,0,20,12
1657452507888,ECE 45,A01,083139,Congero; Spencer William,6,0,75,69
1657452513922,ECE 65,A50,083695,Saad; Andrew S,12,0,30,18
1657452513922,ECE 65,A51,095125,Saad; Andrew S,24,0,26,2
1657452519962,ECE 109,A01,091882,Touri; Behrouz,19,0,70,51
1657452526000,ECE 180,A00,083140,Abi Samra; Nicholas Camill,1,0,30,29
1657452526000,ECE 180,B00,083141,Abi Samra; Nicholas Camill,0,0,30,30
1657452532041,MATH 10A,A01,083735,Patchell; Gregory David,2,0,30,28
1657452532041,MATH 10A,A02,083736,Patchell; Gregory David,20,0,30,10
1657452532041,MATH 10A,A03,083737,Patchell; Gregory David,16,0,30,14
1657452538087,MATH 10B,A01,083207,Lim; Seonhee,8,0,34,26
1657452538087,MATH 10B,A02,083208,Lim; Seonhee,9,0,35,26
1657452538087,MATH 10B,A03,093472,Lim; Seonhee,7,0,34,27
1657452538087,MATH 10B,B01,083739,Sinha; Shubham,12,0,30,18
1657452544136,MATH 18,A01,083743,Cinel; Cameron Alexander,7,0,30,23
1657452544136,MATH 18,A02,083744,Cinel; Cameron Alexander,17,0,30,13
1657452544136,MATH 18,A03,083745,Cinel; Cameron Alexander,9,0,30,21
1657452544136,MATH 18,B01,083748,Rideout; David Porter,5,0,37,32
1657452544136,MATH 18,B02,083749,Rideout; David Porter,5,0,36,31
1657452544136,MATH 18,B03,083750,Rideout; David Porter,3,0,37,34
1657452544136,MATH 18,B04,083751,Rideout; David Porter,6,0,36,30
1657452544136,MATH 18,B05,093473,Rideout; David Porter,6,0,36,30
1657452544136,MATH 18,B06,093474,Rideout; David Porter,6,0,36,30
1657452550167,MATH 20A,A01,083754,Zheng; Zequn,14,0,40,26
1657452556198,MATH 20B,A01,083756,Briones; Jor-el Thomas Caparas,4,0,36,32
1657452556198,MATH 20B,A02,083757,Briones; Jor-el Thomas Caparas,1,0,36,35
1657452556198,MATH 20B,A03,093475,Briones; Jor-el Thomas Caparas,2,0,36,34
1657452562241,MATH 20C,A01,083760,Briones; Jor-el Thomas Caparas,1,0,35,34
1657452562241,MATH 20C,A02,083761,Briones; Jor-el Thomas Caparas,8,0,35,27
1657452562241,MATH 20C,A03,093476,Briones; Jor-el Thomas Caparas,0,1,36,36
1657452562241,MATH 20C,B01,083762,Bach; Quang Tran,1,0,30,29
1657452568274,MATH 20D,A01,083765,Tran; Brian Kha,5,0,30,25
1657452568274,MATH 20D,A02,083766,Tran; Brian Kha,5,0,30,25
1657452568274,MATH 20D,A03,083767,Tran; Brian Kha,5,0,30,25
1657452574305,MATH 20E,A01,083771,Ganguly; Soumya,9,0,32,23
1657452574305,MATH 20E,A02,083772,Ganguly; Soumya,6,0,32,26
1657452574305,MATH 20E,B01,083773,Ciotti; Benjamin,20,0,35,15
1657452574305,MATH 20E,B02,083774,Ciotti; Benjamin,17,0,35,18
1657452580334,MATH 103A,A01,083777,Greenfeld; Be'Eri,3,0,36,33
1657452580334,MATH 103A,A02,083778,Greenfeld; Be'Eri,5,0,36,31
1657452580334,MATH 103A,A03,093561,Greenfeld; Be'Eri,5,0,36,31
1657452580334,MATH 103A,B01,083779,Greenfeld; Be'Eri,7,0,36,29
1657452580334,MATH 103A,B02,083780,Greenfeld; Be'Eri,4,0,36,32
1657452580334,MATH 103A,B03,093562,Greenfeld; Be'Eri,3,0,36,33
1657452586376,MATH 105,A01,085443,Carter; Anne Toulson,15,0,35,20
1657452586376,MATH 105,A02,093477,Carter; Anne Toulson,20,0,35,15
1657452592418,MATH 109,A01,083213,Ganzberger; Geoffrey Michael,2,0,34,32
1657452592418,MATH 109,A02,083214,Ganzberger; Geoffrey Michael,4,0,34,30
1657452592418,MATH 109,A03,093478,Ganzberger; Geoffrey Michael,2,0,34,32
1657452592418,MATH 109,B01,083215,Ganzberger; Geoffrey Michael,1,0,32,31
1657452592418,MATH 109,B02,083216,Ganzberger; Geoffrey Michael,2,0,32,30
1657452592418,MATH 109,B03,093479,Ganzberger; Geoffrey Michael,8,0,32,24
1657452598451,MATH 142A,A01,083219,Chow; Bennett,7,0,32,25
1657452598451,MATH 142A,A02,083220,Chow; Bennett,10,0,32,22
1657452598451,MATH 142A,A03,093480,Chow; Bennett,8,0,32,24
1657452598451,MATH 142A,B03,093481,Chow; Bennett,8,0,32,24
1657452598451,MATH 142A,B04,093558,Chow; Bennett,13,0,32,19
1657452598451,MATH 142A,B05,093559,Chow; Bennett,6,0,32,26
1657452604488,MATH 193A,A01,083224,Rotar; Vladimir,8,0,34,26
1657452604488,MATH 193A,A02,083225,Rotar; Vladimir,9,0,34,25
1657452604488,MATH 193A,A03,083781,Rotar; Vladimir,5,0,34,29
1657452604488,MATH 193A,A04,083782,Rotar; Vladimir,10,0,34,24
1657452604488,MATH 193A,A05,093482,Rotar; Vladimir,10,0,34,24
1657452610540,MATH 197,001,091859,McAuley; Julian John,9999,0,9999,0
1657452610540,MATH 197,002,095566,Kedlaya; Kiran S.,9997,0,9999,2
1657452610540,MATH 197,003,095567,Xiao; Ming,9999,0,9999,0
1657452610540,MATH 197,004,095571,Perols; Johan Lars,9998,0,9999,1
1657452617620,COGS 9,A01,083615,Shannon; Kyle Michael,9,0,75,66
1657452623653,COGS 11,A01,083617,Boyle; Mary E. T.,22,0,48,26
1657452629681,COGS 13,A01,083071,Bastos; Amalia Pinkusfeld,11,0,71,60
1657452635713,COGS 14A,A01,092681,Semenuks; Arturs,5,1,100,95
1657452641752,COGS 14B,A01,083073,Cheng; Tzu-Han,6,0,63,57
1657452647783,COGS 17,A01,092677,Semenuks; Arturs,6,0,81,75
1657452653834,COGS 100,A01,083619,Allen; Michael Gordon,17,0,70,53
1657452659874,COGS 101A,A01,083621,Davis; Joshua Daniel,9,0,68,59
1657452665904,COGS 101B,A01,091572,Allen; Michael Gordon,12,0,65,53
1657452681801,COGS 101C,A01,083625,Delgado; Tania,17,0,35,18
1657452687843,COGS 107A,A01,083627,Boyle; Mary E. T.,13,0,60,47
1657452701721,COGS 118A,A01,083075,Gupta; Anjum,21,0,76,55
1657452707755,CSE 3,A50,083646,Miranda; Gregory Joseph,24,0,50,26
1657452713779,CSE 8A,A50,083650,Miranda; Gregory Joseph,17,1,56,39
1657452719816,CSE 11,A01,083080,Cao; Yingjun,6,15,40,34
1657452725846,CSE 12,A01,083652,Krause-Levy; Sophia Louisa,28,1,120,92
1657452731876,CSE 15L,A01,083654,Morris; Justin Loren,9,0,50,41
1657452731876,CSE 15L,A02,083655,Morris; Justin Loren,9,0,50,41
1657452737906,CSE 20,A01,083657,Tran; Khoa Dang,39,0,80,41
1657452743937,CSE 21,A01,095574,Bach; Quang Tran,22,0,48,26
1657452749971,CSE 30,A01,083084,Eldon; John,5,0,80,75
1657452749971,CSE 30,B01,095061,Bhaskar; Nishant,9,0,50,41
1657452755997,CSE 100,A01,083659,Cao; Yingjun,5,4,70,65
1657452762039,CSE 134B,A01,083661,Powell; Thomas Allan,22,0,100,78
1657452768069,CSE 140,A01,083663,Gungor; Onat,15,0,85,70
1657452774100,CSE 140L,A01,083088,Eldon; John,21,0,100,79
1657452780135,CSE 175,A01,083665,Kumar; Rakesh,3,0,25,22
1657452786164,CSE 190,A00,092507,Dubnov; Shlomo,8,0,20,12
1657452792199,ECE 45,A01,083139,Congero; Spencer William,6,0,75,69
1657452798229,ECE 65,A50,083695,Saad; Andrew S,12,0,30,18
1657452798229,ECE 65,A51,095125,Saad; Andrew S,24,0,26,2
1657452804256,ECE 109,A01,091882,Touri; Behrouz,19,0,70,51
1657452810284,ECE 180,A00,083140,Abi Samra; Nicholas Camill,1,0,30,29
1657452810284,ECE 180,B00,083141,Abi Samra; Nicholas Camill,0,0,30,30
1657452816316,MATH 10A,A01,083735,Patchell; Gregory David,2,0,30,28
1657452816316,MATH 10A,A02,083736,Patchell; Gregory David,20,0,30,10
1657452816316,MATH 10A,A03,083737,Patchell; Gregory David,16,0,30,14
1657452822345,MATH 10B,A01,083207,Lim; Seonhee,8,0,34,26
1657452822345,MATH 10B,A02,083208,Lim; Seonhee,9,0,35,26
1657452822345,MATH 10B,A03,093472,Lim; Seonhee,7,0,34,27
1657452822345,MATH 10B,B01,083739,Sinha; Shubham,12,0,30,18
1657452828380,MATH 18,A01,083743,Cinel; Cameron Alexander,7,0,30,23
1657452828380,MATH 18,A02,083744,Cinel; Cameron Alexander,17,0,30,13
1657452828380,MATH 18,A03,083745,Cinel; Cameron Alexander,9,0,30,21
1657452828380,MATH 18,B01,083748,Rideout; David Porter,5,0,37,32
1657452828380,MATH 18,B02,083749,Rideout; David Porter,5,0,36,31
1657452828380,MATH 18,B03,083750,Rideout; David Porter,3,0,37,34
1657452828380,MATH 18,B04,083751,Rideout; David Porter,6,0,36,30
1657452828380,MATH 18,B05,093473,Rideout; David Porter,6,0,36,30
1657452828380,MATH 18,B06,093474,Rideout; David Porter,6,0,36,30
1657452834408,MATH 20A,A01,083754,Zheng; Zequn,14,0,40,26
1657452840445,MATH 20B,A01,083756,Briones; Jor-el Thomas Caparas,4,0,36,32
1657452840445,MATH 20B,A02,083757,Briones; Jor-el Thomas Caparas,1,0,36,35
1657452840445,MATH 20B,A03,093475,Briones; Jor-el Thomas Caparas,2,0,36,34
1657452846474,MATH 20C,A01,083760,Briones; Jor-el Thomas Caparas,1,0,35,34
1657452846474,MATH 20C,A02,083761,Briones; Jor-el Thomas Caparas,8,0,35,27
1657452846474,MATH 20C,A03,093476,Briones; Jor-el Thomas Caparas,0,1,36,36
1657452846474,MATH 20C,B01,083762,Bach; Quang Tran,1,0,30,29
1657452852503,MATH 20D,A01,083765,Tran; Brian Kha,5,0,30,25
1657452852503,MATH 20D,A02,083766,Tran; Brian Kha,5,0,30,25
1657452852503,MATH 20D,A03,083767,Tran; Brian Kha,5,0,30,25
1657452858533,MATH 20E,A01,083771,Ganguly; Soumya,9,0,32,23
1657452858533,MATH 20E,A02,083772,Ganguly; Soumya,6,0,32,26
1657452858533,MATH 20E,B01,083773,Ciotti; Benjamin,20,0,35,15
1657452858533,MATH 20E,B02,083774,Ciotti; Benjamin,17,0,35,18
1657452864570,MATH 103A,A01,083777,Greenfeld; Be'Eri,3,0,36,33
1657452864570,MATH 103A,A02,083778,Greenfeld; Be'Eri,5,0,36,31
1657452864570,MATH 103A,A03,093561,Greenfeld; Be'Eri,5,0,36,31
1657452864570,MATH 103A,B01,083779,Greenfeld; Be'Eri,7,0,36,29
1657452864570,MATH 103A,B02,083780,Greenfeld; Be'Eri,4,0,36,32
1657452864570,MATH 103A,B03,093562,Greenfeld; Be'Eri,3,0,36,33
1657452870606,MATH 105,A01,085443,Carter; Anne Toulson,15,0,35,20
1657452870606,MATH 105,A02,093477,Carter; Anne Toulson,20,0,35,15
1657452876653,MATH 109,A01,083213,Ganzberger; Geoffrey Michael,2,0,34,32
1657452876653,MATH 109,A02,083214,Ganzberger; Geoffrey Michael,4,0,34,30
1657452876653,MATH 109,A03,093478,Ganzberger; Geoffrey Michael,2,0,34,32
1657452876653,MATH 109,B01,083215,Ganzberger; Geoffrey Michael,1,0,32,31
1657452876653,MATH 109,B02,083216,Ganzberger; Geoffrey Michael,2,0,32,30
1657452876653,MATH 109,B03,093479,Ganzberger; Geoffrey Michael,8,0,32,24
1657452882685,MATH 142A,A01,083219,Chow; Bennett,7,0,32,25
1657452882685,MATH 142A,A02,083220,Chow; Bennett,10,0,32,22
1657452882685,MATH 142A,A03,093480,Chow; Bennett,8,0,32,24
1657452882685,MATH 142A,B03,093481,Chow; Bennett,8,0,32,24
1657452882685,MATH 142A,B04,093558,Chow; Bennett,13,0,32,19
1657452882685,MATH 142A,B05,093559,Chow; Bennett,6,0,32,26
1657452888722,MATH 193A,A01,083224,Rotar; Vladimir,8,0,34,26
1657452888722,MATH 193A,A02,083225,Rotar; Vladimir,9,0,34,25
1657452888722,MATH 193A,A03,083781,Rotar; Vladimir,5,0,34,29
1657452888722,MATH 193A,A04,083782,Rotar; Vladimir,10,0,34,24
1657452888722,MATH 193A,A05,093482,Rotar; Vladimir,10,0,34,24
1657452894750,MATH 197,001,091859,McAuley; Julian John,9999,0,9999,0
1657452894750,MATH 197,002,095566,Kedlaya; Kiran S.,9997,0,9999,2
1657452894750,MATH 197,003,095567,Xiao; Ming,9999,0,9999,0
1657452894750,MATH 197,004,095571,Perols; Johan Lars,9998,0,9999,1
1657452901836,COGS 9,A01,083615,Shannon; Kyle Michael,9,0,75,66
1657452907864,COGS 11,A01,083617,Boyle; Mary E. T.,22,0,48,26
1657452913899,COGS 13,A01,083071,Bastos; Amalia Pinkusfeld,11,0,71,60
1657452919926,COGS 14A,A01,092681,Semenuks; Arturs,5,1,100,95
1657452925952,COGS 14B,A01,083073,Cheng; Tzu-Han,6,0,63,57
1657452931985,COGS 17,A01,092677,Semenuks; Arturs,6,0,81,75
1657452938018,COGS 100,A01,083619,Allen; Michael Gordon,17,0,70,53
1657452944121,COGS 101A,A01,083621,Davis; Joshua Daniel,9,0,68,59
1657452950152,COGS 101B,A01,091572,Allen; Michael Gordon,12,0,65,53
1657452956179,COGS 101C,A01,083625,Delgado; Tania,17,0,35,18
1657452962207,COGS 107A,A01,083627,Boyle; Mary E. T.,13,0,60,47
1657452968239,COGS 118A,A01,083075,Gupta; Anjum,21,0,76,55
1657452974276,CSE 3,A50,083646,Miranda; Gregory Joseph,24,0,50,26
1657452980304,CSE 8A,A50,083650,Miranda; Gregory Joseph,17,1,56,39
1657452986338,CSE 11,A01,083080,Cao; Yingjun,6,15,40,34
1657452992368,CSE 12,A01,083652,Krause-Levy; Sophia Louisa,28,1,120,92
1657452998397,CSE 15L,A01,083654,Morris; Justin Loren,9,0,50,41
1657452998397,CSE 15L,A02,083655,Morris; Justin Loren,9,0,50,41
1657453004424,CSE 20,A01,083657,Tran; Khoa Dang,39,0,80,41
1657453010453,CSE 21,A01,095574,Bach; Quang Tran,22,0,48,26
1657453016490,CSE 30,A01,083084,Eldon; John,5,0,80,75
1657453016490,CSE 30,B01,095061,Bhaskar; Nishant,9,0,50,41
1657453022520,CSE 100,A01,083659,Cao; Yingjun,5,4,70,65
1657453028549,CSE 134B,A01,083661,Powell; Thomas Allan,22,0,100,78
1657453034579,CSE 140,A01,083663,Gungor; Onat,15,0,85,70
1657453040612,CSE 140L,A01,083088,Eldon; John,21,0,100,79
1657453046642,CSE 175,A01,083665,Kumar; Rakesh,3,0,25,22
1657453052674,CSE 190,A00,092507,Dubnov; Shlomo,8,0,20,12
1657453058712,ECE 45,A01,083139,Congero; Spencer William,6,0,75,69
1657453064744,ECE 65,A50,083695,Saad; Andrew S,12,0,30,18
1657453064744,ECE 65,A51,095125,Saad; Andrew S,24,0,26,2
1657453070786,ECE 109,A01,091882,Touri; Behrouz,19,0,70,51
1657453076819,ECE 180,A00,083140,Abi Samra; Nicholas Camill,1,0,30,29
1657453076819,ECE 180,B00,083141,Abi Samra; Nicholas Camill,0,0,30,30
1657453082919,MATH 10A,A01,083735,Patchell; Gregory David,2,0,30,28
1657453082919,MATH 10A,A02,083736,Patchell; Gregory David,20,0,30,10
1657453082919,MATH 10A,A03,083737,Patchell; Gregory David,16,0,30,14
1657453088959,MATH 10B,A01,083207,Lim; Seonhee,8,0,34,26
1657453088959,MATH 10B,A02,083208,Lim; Seonhee,9,0,35,26
1657453088959,MATH 10B,A03,093472,Lim; Seonhee,7,0,34,27
1657453088959,MATH 10B,B01,083739,Sinha; Shubham,12,0,30,18
1657453094988,MATH 18,A01,083743,Cinel; Cameron Alexander,7,0,30,23
1657453094988,MATH 18,A02,083744,Cinel; Cameron Alexander,17,0,30,13
1657453094988,MATH 18,A03,083745,Cinel; Cameron Alexander,9,0,30,21
1657453094988,MATH 18,B01,083748,Rideout; David Porter,5,0,37,32
1657453094988,MATH 18,B02,083749,Rideout; David Porter,5,0,36,31
1657453094988,MATH 18,B03,083750,Rideout; David Porter,3,0,37,34
1657453094988,MATH 18,B04,083751,Rideout; David Porter,6,0,36,30
1657453094988,MATH 18,B05,093473,Rideout; David Porter,6,0,36,30
1657453094988,MATH 18,B06,093474,Rideout; David Porter,6,0,36,30
1657453101019,MATH 20A,A01,083754,Zheng; Zequn,14,0,40,26
1657453107048,MATH 20B,A01,083756,Briones; Jor-el Thomas Caparas,4,0,36,32
1657453107048,MATH 20B,A02,083757,Briones; Jor-el Thomas Caparas,1,0,36,35
1657453107048,MATH 20B,A03,093475,Briones; Jor-el Thomas Caparas,2,0,36,34
1657453113085,MATH 20C,A01,083760,Briones; Jor-el Thomas Caparas,1,0,35,34
1657453113085,MATH 20C,A02,083761,Briones; Jor-el Thomas Caparas,8,0,35,27
1657453113085,MATH 20C,A03,093476,Briones; Jor-el Thomas Caparas,0,1,36,36
1657453113085,MATH 20C,B01,083762,Bach; Quang Tran,1,0,30,29
1657453119112,MATH 20D,A01,083765,Tran; Brian Kha,5,0,30,25
1657453119112,MATH 20D,A02,083766,Tran; Brian Kha,5,0,30,25
1657453119112,MATH 20D,A03,083767,Tran; Brian Kha,5,0,30,25
1657453125154,MATH 20E,A01,083771,Ganguly; Soumya,9,0,32,23
1657453125154,MATH 20E,A02,083772,Ganguly; Soumya,6,0,32,26
1657453125154,MATH 20E,B01,083773,Ciotti; Benjamin,20,0,35,15
1657453125154,MATH 20E,B02,083774,Ciotti; Benjamin,17,0,35,18
1657453131184,MATH 103A,A01,083777,Greenfeld; Be'Eri,3,0,36,33
1657453131184,MATH 103A,A02,083778,Greenfeld; Be'Eri,5,0,36,31
1657453131184,MATH 103A,A03,093561,Greenfeld; Be'Eri,5,0,36,31
1657453131184,MATH 103A,B01,083779,Greenfeld; Be'Eri,7,0,36,29
1657453131184,MATH 103A,B02,083780,Greenfeld; Be'Eri,4,0,36,32
1657453131184,MATH 103A,B03,093562,Greenfeld; Be'Eri,3,0,36,33
1657453137213,MATH 105,A01,085443,Carter; Anne Toulson,15,0,35,20
1657453137213,MATH 105,A02,093477,Carter; Anne Toulson,20,0,35,15
1657453143243,MATH 109,A01,083213,Ganzberger; Geoffrey Michael,2,0,34,32
1657453143243,MATH 109,A02,083214,Ganzberger; Geoffrey Michael,4,0,34,30
1657453143243,MATH 109,A03,093478,Ganzberger; Geoffrey Michael,2,0,34,32
1657453143243,MATH 109,B01,083215,Ganzberger; Geoffrey Michael,1,0,32,31
1657453143243,MATH 109,B02,083216,Ganzberger; Geoffrey Michael,2,0,32,30
1657453143243,MATH 109,B03,093479,Ganzberger; Geoffrey Michael,8,0,32,24
1657453149274,MATH 142A,A01,083219,Chow; Bennett,7,0,32,25
1657453149274,MATH 142A,A02,083220,Chow; Bennett,10,0,32,22
1657453149274,MATH 142A,A03,093480,Chow; Bennett,8,0,32,24
1657453149274,MATH 142A,B03,093481,Chow; Bennett,8,0,32,24
1657453149274,MATH 142A,B04,093558,Chow; Bennett,13,0,32,19
1657453149274,MATH 142A,B05,093559,Chow; Bennett,6,0,32,26
1657453155305,MATH 193A,A01,083224,Rotar; Vladimir,8,0,34,26
1657453155305,MATH 193A,A02,083225,Rotar; Vladimir,9,0,34,25
1657453155305,MATH 193A,A03,083781,Rotar; Vladimir,5,0,34,29
1657453155305,MATH 193A,A04,083782,Rotar; Vladimir,10,0,34,24
1657453155305,MATH 193A,A05,093482,Rotar; Vladimir,10,0,34,24
1657453161339,MATH 197,001,091859,McAuley; Julian John,9999,0,9999,0
1657453161339,MATH 197,002,095566,Kedlaya; Kiran S.,9997,0,9999,2
1657453161339,MATH 197,003,095567,Xiao; Ming,9999,0,9999,0
1657453161339,MATH 197,004,095571,Perols; Johan Lars,9998,0,9999,1
1657453168408,COGS 9,A01,083615,Shannon; Kyle Michael,9,0,75,66
1657453174438,COGS 11,A01,083617,Boyle; Mary E. T.,22,0,48,26
1657453180470,COGS 13,A01,083071,Bastos; Amalia Pinkusfeld,11,0,71,60
1657453186497,COGS 14A,A01,092681,Semenuks; Arturs,5,1,100,95
1657453192530,COGS 14B,A01,083073,Cheng; Tzu-Han,6,0,63,57
1657453198563,COGS 17,A01,092677,Semenuks; Arturs,6,0,81,75
1657453204595,COGS 100,A01,083619,Allen; Michael Gordon,17,0,70,53
1657453210625,COGS 101A,A01,083621,Davis; Joshua Daniel,9,0,68,59
1657453216657,COGS 101B,A01,091572,Allen; Michael Gordon,12,0,65,53
1657453222682,COGS 101C,A01,083625,Delgado; Tania,17,0,35,18
1657453228712,COGS 107A,A01,083627,Boyle; Mary E. T.,13,0,60,47
1657453234741,COGS 118A,A01,083075,Gupta; Anjum,21,0,76,55
1657453240774,CSE 3,A50,083646,Miranda; Gregory Joseph,24,0,50,26
1657453246798,CSE 8A,A50,083650,Miranda; Gregory Joseph,17,1,56,39
1657453252823,CSE 11,A01,083080,Cao; Yingjun,6,15,40,34
1657453258857,CSE 12,A01,083652,Krause-Levy; Sophia Louisa,28,1,120,92
1657453264885,CSE 15L,A01,083654,Morris; Justin Loren,9,0,50,41
1657453264885,CSE 15L,A02,083655,Morris; Justin Loren,9,0,50,41
1657453270920,CSE 20,A01,083657,Tran; Khoa Dang,39,0,80,41
1657453276948,CSE 21,A01,095574,Bach; Quang Tran,22,0,48,26
1657453282984,CSE 30,A01,083084,Eldon; John,5,0,80,75
1657453282984,CSE 30,B01,095061,Bhaskar; Nishant,9,0,50,41
1657453289014,CSE 100,A01,083659,Cao; Yingjun,5,4,70,65
1657453295053,CSE 134B,A01,083661,Powell; Thomas Allan,22,0,100,78
1657453301088,CSE 140,A01,083663,Gungor; Onat,15,0,85,70
1657453307122,CSE 140L,A01,083088,Eldon; John,21,0,100,79
1657453313153,CSE 175,A01,083665,Kumar; Rakesh,3,0,25,22
1657453319183,CSE 190,A00,092507,Dubnov; Shlomo,8,0,20,12
1657453325212,ECE 45,A01,083139,Congero; Spencer William,6,0,75,69
1657453331243,ECE 65,A50,083695,Saad; Andrew S,12,0,30,18
1657453331243,ECE 65,A51,095125,Saad; Andrew S,24,0,26,2
1657453337278,ECE 109,A01,091882,Touri; Behrouz,19,0,70,51
1657453343313,ECE 180,A00,083140,Abi Samra; Nicholas Camill,1,0,30,29
1657453343313,ECE 180,B00,083141,Abi Samra; Nicholas Camill,0,0,30,30
1657453349342,MATH 10A,A01,083735,Patchell; Gregory David,2,0,30,28
1657453349342,MATH 10A,A02,083736,Patchell; Gregory David,20,0,30,10
1657453349342,MATH 10A,A03,083737,Patchell; Gregory David,16,0,30,14
1657453355374,MATH 10B,A01,083207,Lim; Seonhee,8,0,34,26
1657453355374,MATH 10B,A02,083208,Lim; Seonhee,9,0,35,26
1657453355374,MATH 10B,A03,093472,Lim; Seonhee,7,0,34,27
1657453355374,MATH 10B,B01,083739,Sinha; Shubham,12,0,30,18
1657453361419,MATH 18,A01,083743,Cinel; Cameron Alexander,7,0,30,23
1657453361419,MATH 18,A02,083744,Cinel; Cameron Alexander,17,0,30,13
1657453361419,MATH 18,A03,083745,Cinel; Cameron Alexander,9,0,30,21
1657453361419,MATH 18,B01,083748,Rideout; David Porter,5,0,37,32
1657453361419,MATH 18,B02,083749,Rideout; David Porter,5,0,36,31
1657453361419,MATH 18,B03,083750,Rideout; David Porter,3,0,37,34
1657453361419,MATH 18,B04,083751,Rideout; David Porter,6,0,36,30
1657453361419,MATH 18,B05,093473,Rideout; David Porter,6,0,36,30
1657453361419,MATH 18,B06,093474,Rideout; David Porter,6,0,36,30
1657453367448,MATH 20A,A01,083754,Zheng; Zequn,14,0,40,26
1657453373477,MATH 20B,A01,083756,Briones; Jor-el Thomas Caparas,4,0,36,32
1657453373477,MATH 20B,A02,083757,Briones; Jor-el Thomas Caparas,1,0,36,35
1657453373477,MATH 20B,A03,093475,Briones; Jor-el Thomas Caparas,2,0,36,34
1657453379507,MATH 20C,A01,083760,Briones; Jor-el Thomas Caparas,1,0,35,34
1657453379507,MATH 20C,A02,083761,Briones; Jor-el Thomas Caparas,8,0,35,27
1657453379507,MATH 20C,A03,093476,Briones; Jor-el Thomas Caparas,0,1,36,36
1657453379507,MATH 20C,B01,083762,Bach; Quang Tran,1,0,30,29
1657453385537,MATH 20D,A01,083765,Tran; Brian Kha,5,0,30,25
1657453385537,MATH 20D,A02,083766,Tran; Brian Kha,5,0,30,25
1657453385537,MATH 20D,A03,083767,Tran; Brian Kha,5,0,30,25
1657453391572,MATH 20E,A01,083771,Ganguly; Soumya,9,0,32,23
1657453391572,MATH 20E,A02,083772,Ganguly; Soumya,6,0,32,26
1657453391572,MATH 20E,B01,083773,Ciotti; Benjamin,20,0,35,15
1657453391572,MATH 20E,B02,083774,Ciotti; Benjamin,17,0,35,18
1657453397603,MATH 103A,A01,083777,Greenfeld; Be'Eri,3,0,36,33
1657453397603,MATH 103A,A02,083778,Greenfeld; Be'Eri,5,0,36,31
1657453397603,MATH 103A,A03,093561,Greenfeld; Be'Eri,5,0,36,31
1657453397603,MATH 103A,B01,083779,Greenfeld; Be'Eri,7,0,36,29
1657453397603,MATH 103A,B02,083780,Greenfeld; Be'Eri,4,0,36,32
1657453397603,MATH 103A,B03,093562,Greenfeld; Be'Eri,3,0,36,33
1657453403636,MATH 105,A01,085443,Carter; Anne Toulson,15,0,35,20
1657453403636,MATH 105,A02,093477,Carter; Anne Toulson,20,0,35,15
1657453409664,MATH 109,A01,083213,Ganzberger; Geoffrey Michael,2,0,34,32
1657453409664,MATH 109,A02,083214,Ganzberger; Geoffrey Michael,4,0,34,30
1657453409664,MATH 109,A03,093478,Ganzberger; Geoffrey Michael,2,0,34,32
1657453409664,MATH 109,B01,083215,Ganzberger; Geoffrey Michael,1,0,32,31
1657453409664,MATH 109,B02,083216,Ganzberger; Geoffrey Michael,2,0,32,30
1657453409664,MATH 109,B03,093479,Ganzberger; Geoffrey Michael,8,0,32,24
1657453415694,MATH 142A,A01,083219,Chow; Bennett,7,0,32,25
1657453415694,MATH 142A,A02,083220,Chow; Bennett,10,0,32,22
1657453415694,MATH 142A,A03,093480,Chow; Bennett,8,0,32,24
1657453415694,MATH 142A,B03,093481,Chow; Bennett,8,0,32,24
1657453415694,MATH 142A,B04,093558,Chow; Bennett,13,0,32,19
1657453415694,MATH 142A,B05,093559,Chow; Bennett,6,0,32,26
1657453421728,MATH 193A,A01,083224,Rotar; Vladimir,8,0,34,26
1657453421728,MATH 193A,A02,083225,Rotar; Vladimir,9,0,34,25
1657453421728,MATH 193A,A03,083781,Rotar; Vladimir,5,0,34,29
1657453421728,MATH 193A,A04,083782,Rotar; Vladimir,10,0,34,24
1657453421728,MATH 193A,A05,093482,Rotar; Vladimir,10,0,34,24
1657453427754,MATH 197,001,091859,McAuley; Julian John,9999,0,9999,0
1657453427754,MATH 197,002,095566,Kedlaya; Kiran S.,9997,0,9999,2
1657453427754,MATH 197,003,095567,Xiao; Ming,9999,0,9999,0
1657453427754,MATH 197,004,095571,Perols; Johan Lars,9998,0,9999,1
1657453434827,COGS 9,A01,083615,Shannon; Kyle Michael,9,0,75,66
1657453440859,COGS 11,A01,083617,Boyle; Mary E. T.,22,0,48,26
1657453446894,COGS 13,A01,083071,Bastos; Amalia Pinkusfeld,11,0,71,60
1657453452926,COGS 14A,A01,092681,Semenuks; Arturs,5,1,100,95
1657453458959,COGS 14B,A01,083073,Cheng; Tzu-Han,6,0,63,57
1657453464989,COGS 17,A01,092677,Semenuks; Arturs,6,0,81,75
1657453471023,COGS 100,A01,083619,Allen; Michael Gordon,17,0,70,53
1657453477058,COGS 101A,A01,083621,Davis; Joshua Daniel,9,0,68,59
1657453483088,COGS 101B,A01,091572,Allen; Michael Gordon,12,0,65,53
1657453489119,COGS 101C,A01,083625,Delgado; Tania,17,0,35,18
1657453495150,COGS 107A,A01,083627,Boyle; Mary E. T.,13,0,60,47
1657453501177,COGS 118A,A01,083075,Gupta; Anjum,21,0,76,55
1657453507202,CSE 3,A50,083646,Miranda; Gregory Joseph,24,0,50,26
1657453513226,CSE 8A,A50,083650,Miranda; Gregory Joseph,17,1,56,39
1657453519255,CSE 11,A01,083080,Cao; Yingjun,6,15,40,34
1657453525286,CSE 12,A01,083652,Krause-Levy; Sophia Louisa,28,1,120,92
1657453531313,CSE 15L,A01,083654,Morris; Justin Loren,9,0,50,41
1657453531313,CSE 15L,A02,083655,Morris; Justin Loren,9,0,50,41
1657453537344,CSE 20,A01,083657,Tran; Khoa Dang,39,0,80,41
1657453543446,CSE 21,A01,095574,Bach; Quang Tran,22,0,48,26
1657453549481,CSE 30,A01,083084,Eldon; John,5,0,80,75
1657453549481,CSE 30,B01,095061,Bhaskar; Nishant,9,0,50,41
1657453555513,CSE 100,A01,083659,Cao; Yingjun,5,4,70,65
1657453561547,CSE 134B,A01,083661,Powell; Thomas Allan,22,0,100,78
1657453567581,CSE 140,A01,083663,Gungor; Onat,15,0,85,70
1657453573610,CSE 140L,A01,083088,Eldon; John,21,0,100,79
1657453579637,CSE 175,A01,083665,Kumar; Rakesh,3,0,25,22
1657453585665,CSE 190,A00,092507,Dubnov; Shlomo,8,0,20,12
1657453591710,ECE 45,A01,083139,Congero; Spencer William,6,0,75,69
1657453597743,ECE 65,A50,083695,Saad; Andrew S,12,0,30,18
1657453597743,ECE 65,A51,095125,Saad; Andrew S,24,0,26,2
1657453603772,ECE 109,A01,091882,Touri; Behrouz,19,0,70,51
1657453609798,ECE 180,A00,083140,Abi Samra; Nicholas Camill,1,0,30,29
1657453609798,ECE 180,B00,083141,Abi Samra; Nicholas Camill,0,0,30,30
1657453615831,MATH 10A,A01,083735,Patchell; Gregory David,2,0,30,28
1657453615831,MATH 10A,A02,083736,Patchell; Gregory David,20,0,30,10
1657453615831,MATH 10A,A03,083737,Patchell; Gregory David,16,0,30,14
1657453621873,MATH 10B,A01,083207,Lim; Seonhee,8,0,34,26
1657453621873,MATH 10B,A02,083208,Lim; Seonhee,9,0,35,26
1657453621873,MATH 10B,A03,093472,Lim; Seonhee,7,0,34,27
1657453621873,MATH 10B,B01,083739,Sinha; Shubham,12,0,30,18
1657453627925,MATH 18,A01,083743,Cinel; Cameron Alexander,7,0,30,23
1657453627925,MATH 18,A02,083744,Cinel; Cameron Alexander,17,0,30,13
1657453627925,MATH 18,A03,083745,Cinel; Cameron Alexander,9,0,30,21
1657453627925,MATH 18,B01,083748,Rideout; David Porter,5,0,37,32
1657453627925,MATH 18,B02,083749,Rideout; David Porter,5,0,36,31
1657453627925,MATH 18,B03,083750,Rideout; David Porter,3,0,37,34
1657453627925,MATH 18,B04,083751,Rideout; David Porter,6,0,36,30
1657453627925,MATH 18,B05,093473,Rideout; David Porter,6,0,36,30
1657453627925,MATH 18,B06,093474,Rideout; David Porter,6,0,36,30
1657453633952,MATH 20A,A01,083754,Zheng; Zequn,14,0,40,26
1657453639985,MATH 20B,A01,083756,Briones; Jor-el Thomas Caparas,4,0,36,32
1657453639985,MATH 20B,A02,083757,Briones; Jor-el Thomas Caparas,1,0,36,35
1657453639985,MATH 20B,A03,093475,Briones; Jor-el Thomas Caparas,2,0,36,34
1657453646021,MATH 20C,A01,083760,Briones; Jor-el Thomas Caparas,1,0,35,34
1657453646021,MATH 20C,A02,083761,Briones; Jor-el Thomas Caparas,8,0,35,27
1657453646021,MATH 20C,A03,093476,Briones; Jor-el Thomas Caparas,0,1,36,36
1657453646021,MATH 20C,B01,083762,Bach; Quang Tran,1,0,30,29
1657453652054,MATH 20D,A01,083765,Tran; Brian Kha,5,0,30,25
1657453652054,MATH 20D,A02,083766,Tran; Brian Kha,5,0,30,25
1657453652054,MATH 20D,A03,083767,Tran; Brian Kha,5,0,30,25
1657453658083,MATH 20E,A01,083771,Ganguly; Soumya,9,0,32,23
1657453658083,MATH 20E,A02,083772,Ganguly; Soumya,6,0,32,26
1657453658083,MATH 20E,B01,083773,Ciotti; Benjamin,20,0,35,15
1657453658083,MATH 20E,B02,083774,Ciotti; Benjamin,17,0,35,18
1657453664120,MATH 103A,A01,083777,Greenfeld; Be'Eri,3,0,36,33
1657453664120,MATH 103A,A02,083778,Greenfeld; Be'Eri,5,0,36,31
1657453664120,MATH 103A,A03,093561,Greenfeld; Be'Eri,5,0,36,31
1657453664120,MATH 103A,B01,083779,Greenfeld; Be'Eri,7,0,36,29
1657453664120,MATH 103A,B02,083780,Greenfeld; Be'Eri,4,0,36,32
1657453664120,MATH 103A,B03,093562,Greenfeld; Be'Eri,3,0,36,33
1657453670144,MATH 105,A01,085443,Carter; Anne Toulson,15,0,35,20
1657453670144,MATH 105,A02,093477,Carter; Anne Toulson,20,0,35,15
1657453676180,MATH 109,A01,083213,Ganzberger; Geoffrey Michael,2,0,34,32
1657453676180,MATH 109,A02,083214,Ganzberger; Geoffrey Michael,4,0,34,30
1657453676180,MATH 109,A03,093478,Ganzberger; Geoffrey Michael,2,0,34,32
1657453676180,MATH 109,B01,083215,Ganzberger; Geoffrey Michael,1,0,32,31
1657453676180,MATH 109,B02,083216,Ganzberger; Geoffrey Michael,2,0,32,30
1657453676180,MATH 109,B03,093479,Ganzberger; Geoffrey Michael,8,0,32,24
1657453682211,MATH 142A,A01,083219,Chow; Bennett,7,0,32,25
1657453682211,MATH 142A,A02,083220,Chow; Bennett,10,0,32,22
1657453682211,MATH 142A,A03,093480,Chow; Bennett,8,0,32,24
1657453682211,MATH 142A,B03,093481,Chow; Bennett,8,0,32,24
1657453682211,MATH 142A,B04,093558,Chow; Bennett,13,0,32,19
1657453682211,MATH 142A,B05,093559,Chow; Bennett,6,0,32,26
1657453688237,MATH 193A,A01,083224,Rotar; Vladimir,8,0,34,26
1657453688237,MATH 193A,A02,083225,Rotar; Vladimir,9,0,34,25
1657453688237,MATH 193A,A03,083781,Rotar; Vladimir,5,0,34,29
1657453688237,MATH 193A,A04,083782,Rotar; Vladimir,10,0,34,24
1657453688237,MATH 193A,A05,093482,Rotar; Vladimir,10,0,34,24
1657453694266,MATH 197,001,091859,McAuley; Julian John,9999,0,9999,0
1657453694266,MATH 197,002,095566,Kedlaya; Kiran S.,9997,0,9999,2
1657453694266,MATH 197,003,095567,Xiao; Ming,9999,0,9999,0
1657453694266,MATH 197,004,095571,Perols; Johan Lars,9998,0,9999,1
1657453701336,COGS 9,A01,083615,Shannon; Kyle Michael,9,0,75,66
1657453707368,COGS 11,A01,083617,Boyle; Mary E. T.,22,0,48,26
1657453713396,COGS 13,A01,083071,Bastos; Amalia Pinkusfeld,11,0,71,60
1657453719454,COGS 14A,A01,092681,Semenuks; Arturs,5,1,100,95
1657453725485,COGS 14B,A01,083073,Cheng; Tzu-Han,6,0,63,57
1657453731515,COGS 17,A01,092677,Semenuks; Arturs,6,0,81,75
1657453737545,COGS 100,A01,083619,Allen; Michael Gordon,17,0,70,53
1657453743571,COGS 101A,A01,083621,Davis; Joshua Daniel,9,0,68,59
1657453749598,COGS 101B,A01,091572,Allen; Michael Gordon,12,0,65,53
1657453755632,COGS 101C,A01,083625,Delgado; Tania,17,0,35,18
1657453761668,COGS 107A,A01,083627,Boyle; Mary E. T.,13,0,60,47
1657453767695,COGS 118A,A01,083075,Gupta; Anjum,21,0,76,55
1657453773720,CSE 3,A50,083646,Miranda; Gregory Joseph,24,0,50,26
1657453779748,CSE 8A,A50,083650,Miranda; Gregory Joseph,17,1,56,39
1657453785776,CSE 11,A01,083080,Cao; Yingjun,6,15,40,34
1657453791803,CSE 12,A01,083652,Krause-Levy; Sophia Louisa,28,1,120,92
1657453797837,CSE 15L,A01,083654,Morris; Justin Loren,9,0,50,41
1657453797837,CSE 15L,A02,083655,Morris; Justin Loren,9,0,50,41
1657453803864,CSE 20,A01,083657,Tran; Khoa Dang,39,0,80,41
1657453809892,CSE 21,A01,095574,Bach; Quang Tran,22,0,48,26
1657453815921,CSE 30,A01,083084,Eldon; John,5,0,80,75
1657453815921,CSE 30,B01,095061,Bhaskar; Nishant,9,0,50,41
1657453821953,CSE 100,A01,083659,Cao; Yingjun,5,4,70,65
1657453827980,CSE 134B,A01,083661,Powell; Thomas Allan,22,0,100,78
1657453834010,CSE 140,A01,083663,Gungor; Onat,15,0,85,70
1657453840047,CSE 140L,A01,083088,Eldon; John,21,0,100,79
1657453846079,CSE 175,A01,083665,Kumar; Rakesh,3,0,25,22
1657453852119,CSE 190,A00,092507,Dubnov; Shlomo,8,0,20,12
1657453858155,ECE 45,A01,083139,Congero; Spencer William,6,0,75,69
1657453864188,ECE 65,A50,083695,Saad; Andrew S,12,0,30,18
1657453864188,ECE 65,A51,095125,Saad; Andrew S,24,0,26,2
1657453870213,ECE 109,A01,091882,Touri; Behrouz,19,0,70,51
1657453876240,ECE 180,A00,083140,Abi Samra; Nicholas Camill,1,0,30,29
1657453876240,ECE 180,B00,083141,Abi Samra; Nicholas Camill,0,0,30,30
1657453882271,MATH 10A,A01,083735,Patchell; Gregory David,2,0,30,28
1657453882271,MATH 10A,A02,083736,Patchell; Gregory David,20,0,30,10
1657453882271,MATH 10A,A03,083737,Patchell; Gregory David,16,0,30,14
1657453888304,MATH 10B,A01,083207,Lim; Seonhee,8,0,34,26
1657453888304,MATH 10B,A02,083208,Lim; Seonhee,9,0,35,26
1657453888304,MATH 10B,A03,093472,Lim; Seonhee,7,0,34,27
1657453888304,MATH 10B,B01,083739,Sinha; Shubham,12,0,30,18
1657453894343,MATH 18,A01,083743,Cinel; Cameron Alexander,7,0,30,23
1657453894343,MATH 18,A02,083744,Cinel; Cameron Alexander,17,0,30,13
1657453894343,MATH 18,A03,083745,Cinel; Cameron Alexander,9,0,30,21
1657453894343,MATH 18,B01,083748,Rideout; David Porter,5,0,37,32
1657453894343,MATH 18,B02,083749,Rideout; David Porter,5,0,36,31
1657453894343,MATH 18,B03,083750,Rideout; David Porter,3,0,37,34
1657453894343,MATH 18,B04,083751,Rideout; David Porter,6,0,36,30
1657453894343,MATH 18,B05,093473,Rideout; David Porter,6,0,36,30
1657453894343,MATH 18,B06,093474,Rideout; David Porter,6,0,36,30
1657453900369,MATH 20A,A01,083754,Zheng; Zequn,14,0,40,26
1657453906396,MATH 20B,A01,083756,Briones; Jor-el Thomas Caparas,4,0,36,32
1657453906396,MATH 20B,A02,083757,Briones; Jor-el Thomas Caparas,1,0,36,35
1657453906396,MATH 20B,A03,093475,Briones; Jor-el Thomas Caparas,2,0,36,34
1657453912425,MATH 20C,A01,083760,Briones; Jor-el Thomas Caparas,1,0,35,34
1657453912425,MATH 20C,A02,083761,Briones; Jor-el Thomas Caparas,8,0,35,27
1657453912425,MATH 20C,A03,093476,Briones; Jor-el Thomas Caparas,0,1,36,36
1657453912425,MATH 20C,B01,083762,Bach; Quang Tran,1,0,30,29
1657453918452,MATH 20D,A01,083765,Tran; Brian Kha,5,0,30,25
1657453918452,MATH 20D,A02,083766,Tran; Brian Kha,5,0,30,25
1657453918452,MATH 20D,A03,083767,Tran; Brian Kha,5,0,30,25
1657453924486,MATH 20E,A01,083771,Ganguly; Soumya,9,0,32,23
1657453924486,MATH 20E,A02,083772,Ganguly; Soumya,6,0,32,26
1657453924486,MATH 20E,B01,083773,Ciotti; Benjamin,20,0,35,15
1657453924486,MATH 20E,B02,083774,Ciotti; Benjamin,17,0,35,18
1657453930518,MATH 103A,A01,083777,Greenfeld; Be'Eri,3,0,36,33
1657453930518,MATH 103A,A02,083778,Greenfeld; Be'Eri,5,0,36,31
1657453930518,MATH 103A,A03,093561,Greenfeld; Be'Eri,5,0,36,31
1657453930518,MATH 103A,B01,083779,Greenfeld; Be'Eri,7,0,36,29
1657453930518,MATH 103A,B02,083780,Greenfeld; Be'Eri,4,0,36,32
1657453930518,MATH 103A,B03,093562,Greenfeld; Be'Eri,3,0,36,33
1657453936544,MATH 105,A01,085443,Carter; Anne Toulson,15,0,35,20
1657453936544,MATH 105,A02,093477,Carter; Anne Toulson,20,0,35,15
1657453942572,MATH 109,A01,083213,Ganzberger; Geoffrey Michael,2,0,34,32
1657453942572,MATH 109,A02,083214,Ganzberger; Geoffrey Michael,4,0,34,30
1657453942572,MATH 109,A03,093478,Ganzberger; Geoffrey Michael,2,0,34,32
1657453942572,MATH 109,B01,083215,Ganzberger; Geoffrey Michael,1,0,32,31
1657453942572,MATH 109,B02,083216,Ganzberger; Geoffrey Michael,2,0,32,30
1657453942572,MATH 109,B03,093479,Ganzberger; Geoffrey Michael,8,0,32,24
1657453948605,MATH 142A,A01,083219,Chow; Bennett,7,0,32,25
1657453948605,MATH 142A,A02,083220,Chow; Bennett,10,0,32,22
1657453948605,MATH 142A,A03,093480,Chow; Bennett,8,0,32,24
1657453948605,MATH 142A,B03,093481,Chow; Bennett,8,0,32,24
1657453948605,MATH 142A,B04,093558,Chow; Bennett,13,0,32,19
1657453948605,MATH 142A,B05,093559,Chow; Bennett,6,0,32,26
1657453954631,MATH 193A,A01,083224,Rotar; Vladimir,8,0,34,26
1657453954631,MATH 193A,A02,083225,Rotar; Vladimir,9,0,34,25
1657453954631,MATH 193A,A03,083781,Rotar; Vladimir,5,0,34,29
1657453954631,MATH 193A,A04,083782,Rotar; Vladimir,10,0,34,24
1657453954631,MATH 193A,A05,093482,Rotar; Vladimir,10,0,34,24
1657453960663,MATH 197,001,091859,McAuley; Julian John,9999,0,9999,0
1657453960663,MATH 197,002,095566,Kedlaya; Kiran S.,9997,0,9999,2
1657453960663,MATH 197,003,095567,Xiao; Ming,9999,0,9999,0
1657453960663,MATH 197,004,095571,Perols; Johan Lars,9998,0,9999,1
1657453967736,COGS 9,A01,083615,Shannon; Kyle Michael,9,0,75,66
1657453973770,COGS 11,A01,083617,Boyle; Mary E. T.,22,0,48,26
1657453979800,COGS 13,A01,083071,Bastos; Amalia Pinkusfeld,11,0,71,60
1657453985827,COGS 14A,A01,092681,Semenuks; Arturs,5,1,100,95
1657453991853,COGS 14B,A01,083073,Cheng; Tzu-Han,6,0,63,57
1657453997880,COGS 17,A01,092677,Semenuks; Arturs,6,0,81,75
1657454003908,COGS 100,A01,083619,Allen; Michael Gordon,17,0,70,53
1657454009933,COGS 101A,A01,083621,Davis; Joshua Daniel,9,0,68,59
1657454015962,COGS 101B,A01,091572,Allen; Michael Gordon,12,0,65,53
1657454021993,COGS 101C,A01,083625,Delgado; Tania,17,0,35,18
1657454028021,COGS 107A,A01,083627,Boyle; Mary E. T.,13,0,60,47
1657454034050,COGS 118A,A01,083075,Gupta; Anjum,21,0,76,55
1657454040077,CSE 3,A50,083646,Miranda; Gregory Joseph,24,0,50,26
1657454046108,CSE 8A,A50,083650,Miranda; Gregory Joseph,17,1,56,39
1657454052142,CSE 11,A01,083080,Cao; Yingjun,6,15,40,34
1657454058168,CSE 12,A01,083652,Krause-Levy; Sophia Louisa,28,1,120,92
1657454064194,CSE 15L,A01,083654,Morris; Justin Loren,9,0,50,41
1657454064194,CSE 15L,A02,083655,Morris; Justin Loren,9,0,50,41
1657454070220,CSE 20,A01,083657,Tran; Khoa Dang,39,0,80,41
1657454076250,CSE 21,A01,095574,Bach; Quang Tran,22,0,48,26
1657454082284,CSE 30,A01,083084,Eldon; John,5,0,80,75
1657454082284,CSE 30,B01,095061,Bhaskar; Nishant,9,0,50,41
1657454088310,CSE 100,A01,083659,Cao; Yingjun,5,4,70,65
1657454094340,CSE 134B,A01,083661,Powell; Thomas Allan,22,0,100,78
1657454100365,CSE 140,A01,083663,Gungor; Onat,15,0,85,70
1657454106394,CSE 140L,A01,083088,Eldon; John,21,0,100,79
1657454112426,CSE 175,A01,083665,Kumar; Rakesh,3,0,25,22
1657454118451,CSE 190,A00,092507,Dubnov; Shlomo,8,0,20,12
1657454124482,ECE 45,A01,083139,Congero; Spencer William,6,0,75,69
1657454130513,ECE 65,A50,083695,Saad; Andrew S,12,0,30,18
1657454130513,ECE 65,A51,095125,Saad; Andrew S,24,0,26,2
1657454136544,ECE 109,A01,091882,Touri; Behrouz,19,0,70,51
1657454142644,ECE 180,A00,083140,Abi Samra; Nicholas Camill,1,0,30,29
1657454142644,ECE 180,B00,083141,Abi Samra; Nicholas Camill,0,0,30,30
1657454148677,MATH 10A,A01,083735,Patchell; Gregory David,2,0,30,28
1657454148677,MATH 10A,A02,083736,Patchell; Gregory David,20,0,30,10
1657454148677,MATH 10A,A03,083737,Patchell; Gregory David,16,0,30,14
1657454154718,MATH 10B,A01,083207,Lim; Seonhee,8,0,34,26
1657454154718,MATH 10B,A02,083208,Lim; Seonhee,9,0,35,26
1657454154718,MATH 10B,A03,093472,Lim; Seonhee,7,0,34,27
1657454154718,MATH 10B,B01,083739,Sinha; Shubham,12,0,30,18
1657454160759,MATH 18,A01,083743,Cinel; Cameron Alexander,7,0,30,23
1657454160759,MATH 18,A02,083744,Cinel; Cameron Alexander,17,0,30,13
1657454160759,MATH 18,A03,083745,Cinel; Cameron Alexander,9,0,30,21
1657454160759,MATH 18,B01,083748,Rideout; David Porter,5,0,37,32
1657454160759,MATH 18,B02,083749,Rideout; David Porter,5,0,36,31
1657454160759,MATH 18,B03,083750,Rideout; David Porter,3,0,37,34
1657454160759,MATH 18,B04,083751,Rideout; David Porter,6,0,36,30
1657454160759,MATH 18,B05,093473,Rideout; David Porter,6,0,36,30
1657454160759,MATH 18,B06,093474,Rideout; David Porter,6,0,36,30
1657454166796,MATH 20A,A01,083754,Zheng; Zequn,14,0,40,26
1657454172825,MATH 20B,A01,083756,Briones; Jor-el Thomas Caparas,4,0,36,32
1657454172825,MATH 20B,A02,083757,Briones; Jor-el Thomas Caparas,1,0,36,35
1657454172825,MATH 20B,A03,093475,Briones; Jor-el Thomas Caparas,2,0,36,34
1657454178851,MATH 20C,A01,083760,Briones; Jor-el Thomas Caparas,1,0,35,34
1657454178851,MATH 20C,A02,083761,Briones; Jor-el Thomas Caparas,8,0,35,27
1657454178851,MATH 20C,A03,093476,Briones; Jor-el Thomas Caparas,0,1,36,36
1657454178851,MATH 20C,B01,083762,Bach; Quang Tran,1,0,30,29
1657454184880,MATH 20D,A01,083765,Tran; Brian Kha,5,0,30,25
1657454184880,MATH 20D,A02,083766,Tran; Brian Kha,5,0,30,25
1657454184880,MATH 20D,A03,083767,Tran; Brian Kha,5,0,30,25
1657454190916,MATH 20E,A01,083771,Ganguly; Soumya,9,0,32,23
1657454190916,MATH 20E,A02,083772,Ganguly; Soumya,6,0,32,26
1657454190916,MATH 20E,B01,083773,Ciotti; Benjamin,20,0,35,15
1657454190916,MATH 20E,B02,083774,Ciotti; Benjamin,17,0,35,18
1657454196945,MATH 103A,A01,083777,Greenfeld; Be'Eri,3,0,36,33
1657454196945,MATH 103A,A02,083778,Greenfeld; Be'Eri,5,0,36,31
1657454196945,MATH 103A,A03,093561,Greenfeld; Be'Eri,5,0,36,31
1657454196945,MATH 103A,B01,083779,Greenfeld; Be'Eri,7,0,36,29
1657454196945,MATH 103A,B02,083780,Greenfeld; Be'Eri,4,0,36,32
1657454196945,MATH 103A,B03,093562,Greenfeld; Be'Eri,3,0,36,33
1657454202983,MATH 105,A01,085443,Carter; Anne Toulson,15,0,35,20
1657454202983,MATH 105,A02,093477,Carter; Anne Toulson,20,0,35,15
1657454209009,MATH 109,A01,083213,Ganzberger; Geoffrey Michael,2,0,34,32
1657454209009,MATH 109,A02,083214,Ganzberger; Geoffrey Michael,4,0,34,30
1657454209009,MATH 109,A03,093478,Ganzberger; Geoffrey Michael,2,0,34,32
1657454209009,MATH 109,B01,083215,Ganzberger; Geoffrey Michael,1,0,32,31
1657454209009,MATH 109,B02,083216,Ganzberger; Geoffrey Michael,2,0,32,30
1657454209009,MATH 109,B03,093479,Ganzberger; Geoffrey Michael,8,0,32,24
1657454215036,MATH 142A,A01,083219,Chow; Bennett,7,0,32,25
1657454215036,MATH 142A,A02,083220,Chow; Bennett,10,0,32,22
1657454215036,MATH 142A,A03,093480,Chow; Bennett,8,0,32,24
1657454215036,MATH 142A,B03,093481,Chow; Bennett,8,0,32,24
1657454215036,MATH 142A,B04,093558,Chow; Bennett,13,0,32,19
1657454215036,MATH 142A,B05,093559,Chow; Bennett,6,0,32,26
1657454221069,MATH 193A,A01,083224,Rotar; Vladimir,8,0,34,26
1657454221069,MATH 193A,A02,083225,Rotar; Vladimir,9,0,34,25
1657454221069,MATH 193A,A03,083781,Rotar; Vladimir,5,0,34,29
1657454221069,MATH 193A,A04,083782,Rotar; Vladimir,10,0,34,24
1657454221069,MATH 193A,A05,093482,Rotar; Vladimir,10,0,34,24
1657454227099,MATH 197,001,091859,McAuley; Julian John,9999,0,9999,0
1657454227099,MATH 197,002,095566,Kedlaya; Kiran S.,9997,0,9999,2
1657454227099,MATH 197,003,095567,Xiao; Ming,9999,0,9999,0
1657454227099,MATH 197,004,095571,Perols; Johan Lars,9998,0,9999,1
1657454234169,COGS 9,A01,083615,Shannon; Kyle Michael,9,0,75,66
1657454240197,COGS 11,A01,083617,Boyle; Mary E. T.,22,0,48,26
1657454246226,COGS 13,A01,083071,Bastos; Amalia Pinkusfeld,11,0,71,60
1657454252253,COGS 14A,A01,092681,Semenuks; Arturs,5,1,100,95
1657454258277,COGS 14B,A01,083073,Cheng; Tzu-Han,6,0,63,57
1657454264306,COGS 17,A01,092677,Semenuks; Arturs,6,0,81,75
1657454270340,COGS 100,A01,083619,Allen; Michael Gordon,17,0,70,53
1657454276372,COGS 101A,A01,083621,Davis; Joshua Daniel,9,0,68,59
1657454282400,COGS 101B,A01,091572,Allen; Michael Gordon,12,0,65,53
1657454288427,COGS 101C,A01,083625,Delgado; Tania,17,0,35,18
1657454294455,COGS 107A,A01,083627,Boyle; Mary E. T.,13,0,60,47
1657454300484,COGS 118A,A01,083075,Gupta; Anjum,21,0,76,55
1657454306511,CSE 3,A50,083646,Miranda; Gregory Joseph,24,0,50,26
1657454312537,CSE 8A,A50,083650,Miranda; Gregory Joseph,17,1,56,39
1657454318563,CSE 11,A01,083080,Cao; Yingjun,6,15,40,34
1657454324588,CSE 12,A01,083652,Krause-Levy; Sophia Louisa,28,1,120,92
1657454330613,CSE 15L,A01,083654,Morris; Justin Loren,9,0,50,41
1657454330613,CSE 15L,A02,083655,Morris; Justin Loren,9,0,50,41
1657454336641,CSE 20,A01,083657,Tran; Khoa Dang,39,0,80,41
1657454342671,CSE 21,A01,095574,Bach; Quang Tran,22,0,48,26
1657454348700,CSE 30,A01,083084,Eldon; John,5,0,80,75
1657454348700,CSE 30,B01,095061,Bhaskar; Nishant,9,0,50,41
1657454354730,CSE 100,A01,083659,Cao; Yingjun,5,4,70,65
1657454360755,CSE 134B,A01,083661,Powell; Thomas Allan,22,0,100,78
1657454366786,CSE 140,A01,083663,Gungor; Onat,15,0,85,70
1657454372817,CSE 140L,A01,083088,Eldon; John,21,0,100,79
1657454378846,CSE 175,A01,083665,Kumar; Rakesh,3,0,25,22
1657454384877,CSE 190,A00,092507,Dubnov; Shlomo,8,0,20,12
1657454390908,ECE 45,A01,083139,Congero; Spencer William,6,0,75,69
1657454396937,ECE 65,A50,083695,Saad; Andrew S,12,0,30,18
1657454396937,ECE 65,A51,095125,Saad; Andrew S,24,0,26,2
1657454402967,ECE 109,A01,091882,Touri; Behrouz,19,0,70,51
1657454408993,ECE 180,A00,083140,Abi Samra; Nicholas Camill,1,0,30,29
1657454408993,ECE 180,B00,083141,Abi Samra; Nicholas Camill,0,0,30,30
1657454415023,MATH 10A,A01,083735,Patchell; Gregory David,2,0,30,28
1657454415023,MATH 10A,A02,083736,Patchell; Gregory David,20,0,30,10
1657454415023,MATH 10A,A03,083737,Patchell; Gregory David,16,0,30,14
1657454421049,MATH 10B,A01,083207,Lim; Seonhee,8,0,34,26
1657454421049,MATH 10B,A02,083208,Lim; Seonhee,9,0,35,26
1657454421049,MATH 10B,A03,093472,Lim; Seonhee,7,0,34,27
1657454421049,MATH 10B,B01,083739,Sinha; Shubham,12,0,30,18
1657454427082,MATH 18,A01,083743,Cinel; Cameron Alexander,7,0,30,23
1657454427082,MATH 18,A02,083744,Cinel; Cameron Alexander,17,0,30,13
1657454427082,MATH 18,A03,083745,Cinel; Cameron Alexander,9,0,30,21
1657454427082,MATH 18,B01,083748,Rideout; David Porter,5,0,37,32
1657454427082,MATH 18,B02,083749,Rideout; David Porter,5,0,36,31
1657454427082,MATH 18,B03,083750,Rideout; David Porter,3,0,37,34
1657454427082,MATH 18,B04,083751,Rideout; David Porter,6,0,36,30
1657454427082,MATH 18,B05,093473,Rideout; David Porter,6,0,36,30
1657454427082,MATH 18,B06,093474,Rideout; David Porter,6,0,36,30
1657454433108,MATH 20A,A01,083754,Zheng; Zequn,14,0,40,26
1657454439132,MATH 20B,A01,083756,Briones; Jor-el Thomas Caparas,4,0,36,32
1657454439132,MATH 20B,A02,083757,Briones; Jor-el Thomas Caparas,1,0,36,35
1657454439132,MATH 20B,A03,093475,Briones; Jor-el Thomas Caparas,2,0,36,34
1657454445164,MATH 20C,A01,083760,Briones; Jor-el Thomas Caparas,1,0,35,34
1657454445164,MATH 20C,A02,083761,Briones; Jor-el Thomas Caparas,8,0,35,27
1657454445164,MATH 20C,A03,093476,Briones; Jor-el Thomas Caparas,0,1,36,36
1657454445164,MATH 20C,B01,083762,Bach; Quang Tran,1,0,30,29
1657454451189,MATH 20D,A01,083765,Tran; Brian Kha,5,0,30,25
1657454451189,MATH 20D,A02,083766,Tran; Brian Kha,5,0,30,25
1657454451189,MATH 20D,A03,083767,Tran; Brian Kha,5,0,30,25
1657454457217,MATH 20E,A01,083771,Ganguly; Soumya,9,0,32,23
1657454457217,MATH 20E,A02,083772,Ganguly; Soumya,6,0,32,26
1657454457217,MATH 20E,B01,083773,Ciotti; Benjamin,20,0,35,15
1657454457217,MATH 20E,B02,083774,Ciotti; Benjamin,17,0,35,18
1657454463250,MATH 103A,A01,083777,Greenfeld; Be'Eri,3,0,36,33
1657454463250,MATH 103A,A02,083778,Greenfeld; Be'Eri,5,0,36,31
1657454463250,MATH 103A,A03,093561,Greenfeld; Be'Eri,5,0,36,31
1657454463250,MATH 103A,B01,083779,Greenfeld; Be'Eri,7,0,36,29
1657454463250,MATH 103A,B02,083780,Greenfeld; Be'Eri,4,0,36,32
1657454463250,MATH 103A,B03,093562,Greenfeld; Be'Eri,3,0,36,33
1657454469432,MATH 105,A01,085443,Carter; Anne Toulson,15,0,35,20
1657454469432,MATH 105,A02,093477,Carter; Anne Toulson,20,0,35,15
1657454475471,MATH 109,A01,083213,Ganzberger; Geoffrey Michael,2,0,34,32
1657454475471,MATH 109,A02,083214,Ganzberger; Geoffrey Michael,4,0,34,30
1657454475471,MATH 109,A03,093478,Ganzberger; Geoffrey Michael,2,0,34,32
1657454475471,MATH 109,B01,083215,Ganzberger; Geoffrey Michael,1,0,32,31
1657454475471,MATH 109,B02,083216,Ganzberger; Geoffrey Michael,2,0,32,30
1657454475471,MATH 109,B03,093479,Ganzberger; Geoffrey Michael,8,0,32,24
1657454481619,MATH 142A,A01,083219,Chow; Bennett,7,0,32,25
1657454481619,MATH 142A,A02,083220,Chow; Bennett,10,0,32,22
1657454481619,MATH 142A,A03,093480,Chow; Bennett,8,0,32,24
1657454481619,MATH 142A,B03,093481,Chow; Bennett,8,0,32,24
1657454481619,MATH 142A,B04,093558,Chow; Bennett,13,0,32,19
1657454481619,MATH 142A,B05,093559,Chow; Bennett,6,0,32,26
1657454487865,MATH 193A,A01,083224,Rotar; Vladimir,8,0,34,26
1657454487865,MATH 193A,A02,083225,Rotar; Vladimir,9,0,34,25
1657454487865,MATH 193A,A03,083781,Rotar; Vladimir,5,0,34,29
1657454487865,MATH 193A,A04,083782,Rotar; Vladimir,10,0,34,24
1657454487865,MATH 193A,A05,093482,Rotar; Vladimir,10,0,34,24
1657454493892,MATH 197,001,091859,McAuley; Julian John,9999,0,9999,0
1657454493892,MATH 197,002,095566,Kedlaya; Kiran S.,9997,0,9999,2
1657454493892,MATH 197,003,095567,Xiao; Ming,9999,0,9999,0
1657454493892,MATH 197,004,095571,Perols; Johan Lars,9998,0,9999,1
1657454501047,COGS 9,A01,083615,Shannon; Kyle Michael,9,0,75,66
1657454507083,COGS 11,A01,083617,Boyle; Mary E. T.,22,0,48,26
1657454513116,COGS 13,A01,083071,Bastos; Amalia Pinkusfeld,11,0,71,60
1657454519142,COGS 14A,A01,092681,Semenuks; Arturs,5,1,100,95
1657454525179,COGS 14B,A01,083073,Cheng; Tzu-Han,6,0,63,57
1657454531207,COGS 17,A01,092677,Semenuks; Arturs,6,0,81,75
1657454537234,COGS 100,A01,083619,Allen; Michael Gordon,17,0,70,53
1657454543264,COGS 101A,A01,083621,Davis; Joshua Daniel,9,0,68,59
1657454549297,COGS 101B,A01,091572,Allen; Michael Gordon,12,0,65,53
1657454555325,COGS 101C,A01,083625,Delgado; Tania,17,0,35,18
1657454561352,COGS 107A,A01,083627,Boyle; Mary E. T.,13,0,60,47
1657454567376,COGS 118A,A01,083075,Gupta; Anjum,21,0,76,55
1657454573404,CSE 3,A50,083646,Miranda; Gregory Joseph,24,0,50,26
1657454579435,CSE 8A,A50,083650,Miranda; Gregory Joseph,17,1,56,39
1657454585461,CSE 11,A01,083080,Cao; Yingjun,6,15,40,34
1657454591490,CSE 12,A01,083652,Krause-Levy; Sophia Louisa,28,1,120,92
1657454597517,CSE 15L,A01,083654,Morris; Justin Loren,9,0,50,41
1657454597517,CSE 15L,A02,083655,Morris; Justin Loren,9,0,50,41
1657454603544,CSE 20,A01,083657,Tran; Khoa Dang,39,0,80,41
1657454609571,CSE 21,A01,095574,Bach; Quang Tran,22,0,48,26
1657454615598,CSE 30,A01,083084,Eldon; John,5,0,80,75
1657454615598,CSE 30,B01,095061,Bhaskar; Nishant,9,0,50,41
1657454621624,CSE 100,A01,083659,Cao; Yingjun,5,4,70,65
1657454627652,CSE 134B,A01,083661,Powell; Thomas Allan,22,0,100,78
1657454633684,CSE 140,A01,083663,Gungor; Onat,15,0,85,70
1657454639716,CSE 140L,A01,083088,Eldon; John,21,0,100,79
1657454645742,CSE 175,A01,083665,Kumar; Rakesh,3,0,25,22
1657454651773,CSE 190,A00,092507,Dubnov; Shlomo,8,0,20,12
1657454657804,ECE 45,A01,083139,Congero; Spencer William,6,0,75,69
1657454663832,ECE 65,A50,083695,Saad; Andrew S,12,0,30,18
1657454663832,ECE 65,A51,095125,Saad; Andrew S,24,0,26,2
1657454669862,ECE 109,A01,091882,Touri; Behrouz,19,0,70,51
1657454675890,ECE 180,A00,083140,Abi Samra; Nicholas Camill,1,0,30,29
1657454675890,ECE 180,B00,083141,Abi Samra; Nicholas Camill,0,0,30,30
1657454681925,MATH 10A,A01,083735,Patchell; Gregory David,2,0,30,28
1657454681925,MATH 10A,A02,083736,Patchell; Gregory David,20,0,30,10
1657454681925,MATH 10A,A03,083737,Patchell; Gregory David,16,0,30,14
1657454687957,MATH 10B,A01,083207,Lim; Seonhee,8,0,34,26
1657454687957,MATH 10B,A02,083208,Lim; Seonhee,9,0,35,26
1657454687957,MATH 10B,A03,093472,Lim; Seonhee,7,0,34,27
1657454687957,MATH 10B,B01,083739,Sinha; Shubham,12,0,30,18
1657454693990,MATH 18,A01,083743,Cinel; Cameron Alexander,7,0,30,23
1657454693990,MATH 18,A02,083744,Cinel; Cameron Alexander,17,0,30,13
1657454693990,MATH 18,A03,083745,Cinel; Cameron Alexander,9,0,30,21
1657454693990,MATH 18,B01,083748,Rideout; David Porter,5,0,37,32
1657454693990,MATH 18,B02,083749,Rideout; David Porter,5,0,36,31
1657454693990,MATH 18,B03,083750,Rideout; David Porter,3,0,37,34
1657454693990,MATH 18,B04,083751,Rideout; David Porter,6,0,36,30
1657454693990,MATH 18,B05,093473,Rideout; David Porter,6,0,36,30
1657454693990,MATH 18,B06,093474,Rideout; David Porter,6,0,36,30
1657454700017,MATH 20A,A01,083754,Zheng; Zequn,14,0,40,26
1657454706046,MATH 20B,A01,083756,Briones; Jor-el Thomas Caparas,4,0,36,32
1657454706046,MATH 20B,A02,083757,Briones; Jor-el Thomas Caparas,1,0,36,35
1657454706046,MATH 20B,A03,093475,Briones; Jor-el Thomas Caparas,2,0,36,34
1657454712082,MATH 20C,A01,083760,Briones; Jor-el Thomas Caparas,1,0,35,34
1657454712082,MATH 20C,A02,083761,Briones; Jor-el Thomas Caparas,8,0,35,27
1657454712082,MATH 20C,A03,093476,Briones; Jor-el Thomas Caparas,0,1,36,36
1657454712082,MATH 20C,B01,083762,Bach; Quang Tran,1,0,30,29
1657454718108,MATH 20D,A01,083765,Tran; Brian Kha,5,0,30,25
1657454718108,MATH 20D,A02,083766,Tran; Brian Kha,5,0,30,25
1657454718108,MATH 20D,A03,083767,Tran; Brian Kha,5,0,30,25
1657454724150,MATH 20E,A01,083771,Ganguly; Soumya,9,0,32,23
1657454724150,MATH 20E,A02,083772,Ganguly; Soumya,6,0,32,26
1657454724150,MATH 20E,B01,083773,Ciotti; Benjamin,20,0,35,15
1657454724150,MATH 20E,B02,083774,Ciotti; Benjamin,17,0,35,18
1657454730183,MATH 103A,A01,083777,Greenfeld; Be'Eri,3,0,36,33
1657454730183,MATH 103A,A02,083778,Greenfeld; Be'Eri,5,0,36,31
1657454730183,MATH 103A,A03,093561,Greenfeld; Be'Eri,5,0,36,31
1657454730183,MATH 103A,B01,083779,Greenfeld; Be'Eri,7,0,36,29
1657454730183,MATH 103A,B02,083780,Greenfeld; Be'Eri,4,0,36,32
1657454730183,MATH 103A,B03,093562,Greenfeld; Be'Eri,3,0,36,33
1657454736221,MATH 105,A01,085443,Carter; Anne Toulson,15,0,35,20
1657454736221,MATH 105,A02,093477,Carter; Anne Toulson,20,0,35,15
1657454742340,MATH 109,A01,083213,Ganzberger; Geoffrey Michael,2,0,34,32
1657454742340,MATH 109,A02,083214,Ganzberger; Geoffrey Michael,4,0,34,30
1657454742340,MATH 109,A03,093478,Ganzberger; Geoffrey Michael,2,0,34,32
1657454742340,MATH 109,B01,083215,Ganzberger; Geoffrey Michael,1,0,32,31
1657454742340,MATH 109,B02,083216,Ganzberger; Geoffrey Michael,2,0,32,30
1657454742340,MATH 109,B03,093479,Ganzberger; Geoffrey Michael,8,0,32,24
1657454748369,MATH 142A,A01,083219,Chow; Bennett,7,0,32,25
1657454748369,MATH 142A,A02,083220,Chow; Bennett,10,0,32,22
1657454748369,MATH 142A,A03,093480,Chow; Bennett,8,0,32,24
1657454748369,MATH 142A,B03,093481,Chow; Bennett,8,0,32,24
1657454748369,MATH 142A,B04,093558,Chow; Bennett,13,0,32,19
1657454748369,MATH 142A,B05,093559,Chow; Bennett,6,0,32,26
1657454754398,MATH 193A,A01,083224,Rotar; Vladimir,8,0,34,26
1657454754398,MATH 193A,A02,083225,Rotar; Vladimir,9,0,34,25
1657454754398,MATH 193A,A03,083781,Rotar; Vladimir,5,0,34,29
1657454754398,MATH 193A,A04,083782,Rotar; Vladimir,10,0,34,24
1657454754398,MATH 193A,A05,093482,Rotar; Vladimir,10,0,34,24
1657454760434,MATH 197,001,091859,McAuley; Julian John,9999,0,9999,0
1657454760434,MATH 197,002,095566,Kedlaya; Kiran S.,9997,0,9999,2
1657454760434,MATH 197,003,095567,Xiao; Ming,9999,0,9999,0
1657454760434,MATH 197,004,095571,Perols; Johan Lars,9998,0,9999,1
1657454767506,COGS 9,A01,083615,Shannon; Kyle Michael,9,0,75,66
1657454773534,COGS 11,A01,083617,Boyle; Mary E. T.,22,0,48,26
1657454779569,COGS 13,A01,083071,Bastos; Amalia Pinkusfeld,11,0,71,60
1657454785601,COGS 14A,A01,092681,Semenuks; Arturs,5,1,100,95
1657454791630,COGS 14B,A01,083073,Cheng; Tzu-Han,6,0,63,57
1657454797656,COGS 17,A01,092677,Semenuks; Arturs,6,0,81,75
1657454803682,COGS 100,A01,083619,Allen; Michael Gordon,17,0,70,53
1657454809710,COGS 101A,A01,083621,Davis; Joshua Daniel,9,0,68,59
1657454815740,COGS 101B,A01,091572,Allen; Michael Gordon,12,0,65,53
1657454821775,COGS 101C,A01,083625,Delgado; Tania,17,0,35,18
1657454827799,COGS 107A,A01,083627,Boyle; Mary E. T.,13,0,60,47
1657454833826,COGS 118A,A01,083075,Gupta; Anjum,21,0,76,55
1657454839856,CSE 3,A50,083646,Miranda; Gregory Joseph,24,0,50,26
1657454845882,CSE 8A,A50,083650,Miranda; Gregory Joseph,17,1,56,39
1657454851920,CSE 11,A01,083080,Cao; Yingjun,6,15,40,34
1657454857946,CSE 12,A01,083652,Krause-Levy; Sophia Louisa,28,1,120,92
1657454863974,CSE 15L,A01,083654,Morris; Justin Loren,9,0,50,41
1657454863974,CSE 15L,A02,083655,Morris; Justin Loren,9,0,50,41
1657454870001,CSE 20,A01,083657,Tran; Khoa Dang,39,0,80,41
1657454876027,CSE 21,A01,095574,Bach; Quang Tran,22,0,48,26
1657454882057,CSE 30,A01,083084,Eldon; John,5,0,80,75
1657454882057,CSE 30,B01,095061,Bhaskar; Nishant,9,0,50,41
1657454888087,CSE 100,A01,083659,Cao; Yingjun,5,4,70,65
1657454894113,CSE 134B,A01,083661,Powell; Thomas Allan,22,0,100,78
1657454900137,CSE 140,A01,083663,Gungor; Onat,15,0,85,70
1657454906163,CSE 140L,A01,083088,Eldon; John,21,0,100,79
1657454912188,CSE 175,A01,083665,Kumar; Rakesh,3,0,25,22
1657454918219,CSE 190,A00,092507,Dubnov; Shlomo,8,0,20,12
1657454924257,ECE 45,A01,083139,Congero; Spencer William,6,0,75,69
1657454930287,ECE 65,A50,083695,Saad; Andrew S,12,0,30,18
1657454930287,ECE 65,A51,095125,Saad; Andrew S,24,0,26,2
1657454936314,ECE 109,A01,091882,Touri; Behrouz,19,0,70,51
1657454942342,ECE 180,A00,083140,Abi Samra; Nicholas Camill,1,0,30,29
1657454942342,ECE 180,B00,083141,Abi Samra; Nicholas Camill,0,0,30,30
1657454948369,MATH 10A,A01,083735,Patchell; Gregory David,2,0,30,28
1657454948369,MATH 10A,A02,083736,Patchell; Gregory David,20,0,30,10
1657454948369,MATH 10A,A03,083737,Patchell; Gregory David,16,0,30,14
1657454954398,MATH 10B,A01,083207,Lim; Seonhee,8,0,34,26
1657454954398,MATH 10B,A02,083208,Lim; Seonhee,9,0,35,26
1657454954398,MATH 10B,A03,093472,Lim; Seonhee,7,0,34,27
1657454954398,MATH 10B,B01,083739,Sinha; Shubham,12,0,30,18
1657454960437,MATH 18,A01,083743,Cinel; Cameron Alexander,7,0,30,23
1657454960437,MATH 18,A02,083744,Cinel; Cameron Alexander,17,0,30,13
1657454960437,MATH 18,A03,083745,Cinel; Cameron Alexander,9,0,30,21
1657454960437,MATH 18,B01,083748,Rideout; David Porter,5,0,37,32
1657454960437,MATH 18,B02,083749,Rideout; David Porter,5,0,36,31
1657454960437,MATH 18,B03,083750,Rideout; David Porter,3,0,37,34
1657454960437,MATH 18,B04,083751,Rideout; David Porter,6,0,36,30
1657454960437,MATH 18,B05,093473,Rideout; David Porter,6,0,36,30
1657454960437,MATH 18,B06,093474,Rideout; David Porter,6,0,36,30
1657454966463,MATH 20A,A01,083754,Zheng; Zequn,14,0,40,26
1657454972493,MATH 20B,A01,083756,Briones; Jor-el Thomas Caparas,4,0,36,32
1657454972493,MATH 20B,A02,083757,Briones; Jor-el Thomas Caparas,1,0,36,35
1657454972493,MATH 20B,A03,093475,Briones; Jor-el Thomas Caparas,2,0,36,34
1657454978521,MATH 20C,A01,083760,Briones; Jor-el Thomas Caparas,1,0,35,34
1657454978521,MATH 20C,A02,083761,Briones; Jor-el Thomas Caparas,8,0,35,27
1657454978521,MATH 20C,A03,093476,Briones; Jor-el Thomas Caparas,0,1,36,36
1657454978521,MATH 20C,B01,083762,Bach; Quang Tran,1,0,30,29
1657454984557,MATH 20D,A01,083765,Tran; Brian Kha,5,0,30,25
1657454984557,MATH 20D,A02,083766,Tran; Brian Kha,5,0,30,25
1657454984557,MATH 20D,A03,083767,Tran; Brian Kha,5,0,30,25
1657454990587,MATH 20E,A01,083771,Ganguly; Soumya,9,0,32,23
1657454990587,MATH 20E,A02,083772,Ganguly; Soumya,6,0,32,26
1657454990587,MATH 20E,B01,083773,Ciotti; Benjamin,20,0,35,15
1657454990587,MATH 20E,B02,083774,Ciotti; Benjamin,17,0,35,18
1657454996626,MATH 103A,A01,083777,Greenfeld; Be'Eri,3,0,36,33
1657454996626,MATH 103A,A02,083778,Greenfeld; Be'Eri,5,0,36,31
1657454996626,MATH 103A,A03,093561,Greenfeld; Be'Eri,5,0,36,31
1657454996626,MATH 103A,B01,083779,Greenfeld; Be'Eri,7,0,36,29
1657454996626,MATH 103A,B02,083780,Greenfeld; Be'Eri,4,0,36,32
1657454996626,MATH 103A,B03,093562,Greenfeld; Be'Eri,3,0,36,33
1657455002659,MATH 105,A01,085443,Carter; Anne Toulson,15,0,35,20
1657455002659,MATH 105,A02,093477,Carter; Anne Toulson,20,0,35,15
1657455008694,MATH 109,A01,083213,Ganzberger; Geoffrey Michael,2,0,34,32
1657455008694,MATH 109,A02,083214,Ganzberger; Geoffrey Michael,4,0,34,30
1657455008694,MATH 109,A03,093478,Ganzberger; Geoffrey Michael,2,0,34,32
1657455008694,MATH 109,B01,083215,Ganzberger; Geoffrey Michael,1,0,32,31
1657455008694,MATH 109,B02,083216,Ganzberger; Geoffrey Michael,2,0,32,30
1657455008694,MATH 109,B03,093479,Ganzberger; Geoffrey Michael,8,0,32,24
1657455014723,MATH 142A,A01,083219,Chow; Bennett,7,0,32,25
1657455014723,MATH 142A,A02,083220,Chow; Bennett,10,0,32,22
1657455014723,MATH 142A,A03,093480,Chow; Bennett,8,0,32,24
1657455014723,MATH 142A,B03,093481,Chow; Bennett,8,0,32,24
1657455014723,MATH 142A,B04,093558,Chow; Bennett,13,0,32,19
1657455014723,MATH 142A,B05,093559,Chow; Bennett,6,0,32,26
1657455020753,MATH 193A,A01,083224,Rotar; Vladimir,8,0,34,26
1657455020753,MATH 193A,A02,083225,Rotar; Vladimir,9,0,34,25
1657455020753,MATH 193A,A03,083781,Rotar; Vladimir,5,0,34,29
1657455020753,MATH 193A,A04,083782,Rotar; Vladimir,10,0,34,24
1657455020753,MATH 193A,A05,093482,Rotar; Vladimir,10,0,34,24
1657455026778,MATH 197,001,091859,McAuley; Julian John,9999,0,9999,0
1657455026778,MATH 197,002,095566,Kedlaya; Kiran S.,9997,0,9999,2
1657455026778,MATH 197,003,095567,Xiao; Ming,9999,0,9999,0
1657455026778,MATH 197,004,095571,Perols; Johan Lars,9998,0,9999,1
1657455033855,COGS 9,A01,083615,Shannon; Kyle Michael,9,0,75,66
1657455039880,COGS 11,A01,083617,Boyle; Mary E. T.,22,0,48,26
1657455045914,COGS 13,A01,083071,Bastos; Amalia Pinkusfeld,11,0,71,60
1657455051942,COGS 14A,A01,092681,Semenuks; Arturs,5,1,100,95
1657455057969,COGS 14B,A01,083073,Cheng; Tzu-Han,6,0,63,57
1657455063994,COGS 17,A01,092677,Semenuks; Arturs,6,0,81,75
1657455070054,COGS 100,A01,083619,Allen; Michael Gordon,17,0,70,53
1657455076079,COGS 101A,A01,083621,Davis; Joshua Daniel,9,0,68,59
1657455082110,COGS 101B,A01,091572,Allen; Michael Gordon,12,0,65,53
1657455088136,COGS 101C,A01,083625,Delgado; Tania,17,0,35,18
1657455094161,COGS 107A,A01,083627,Boyle; Mary E. T.,13,0,60,47
1657455100187,COGS 118A,A01,083075,Gupta; Anjum,21,0,76,55
1657455106222,CSE 3,A50,083646,Miranda; Gregory Joseph,24,0,50,26
1657455112252,CSE 8A,A50,083650,Miranda; Gregory Joseph,17,1,56,39
1657455118282,CSE 11,A01,083080,Cao; Yingjun,6,15,40,34
1657455124314,CSE 12,A01,083652,Krause-Levy; Sophia Louisa,28,1,120,92
1657455130339,CSE 15L,A01,083654,Morris; Justin Loren,9,0,50,41
1657455130339,CSE 15L,A02,083655,Morris; Justin Loren,9,0,50,41
1657455136368,CSE 20,A01,083657,Tran; Khoa Dang,39,0,80,41
1657455142396,CSE 21,A01,095574,Bach; Quang Tran,22,0,48,26
1657455148428,CSE 30,A01,083084,Eldon; John,5,0,80,75
1657455148428,CSE 30,B01,095061,Bhaskar; Nishant,9,0,50,41
1657455154459,CSE 100,A01,083659,Cao; Yingjun,5,4,70,65
1657455160493,CSE 134B,A01,083661,Powell; Thomas Allan,22,0,100,78
1657455166520,CSE 140,A01,083663,Gungor; Onat,15,0,85,70
1657455172547,CSE 140L,A01,083088,Eldon; John,21,0,100,79
1657455178578,CSE 175,A01,083665,Kumar; Rakesh,3,0,25,22
1657455184606,CSE 190,A00,092507,Dubnov; Shlomo,8,0,20,12
1657455190632,ECE 45,A01,083139,Congero; Spencer William,6,0,75,69
1657455196667,ECE 65,A50,083695,Saad; Andrew S,12,0,30,18
1657455196667,ECE 65,A51,095125,Saad; Andrew S,24,0,26,2
1657455202692,ECE 109,A01,091882,Touri; Behrouz,19,0,70,51
1657455208718,ECE 180,A00,083140,Abi Samra; Nicholas Camill,1,0,30,29
1657455208718,ECE 180,B00,083141,Abi Samra; Nicholas Camill,0,0,30,30
1657455214745,MATH 10A,A01,083735,Patchell; Gregory David,2,0,30,28
1657455214745,MATH 10A,A02,083736,Patchell; Gregory David,20,0,30,10
1657455214745,MATH 10A,A03,083737,Patchell; Gregory David,16,0,30,14
1657455220776,MATH 10B,A01,083207,Lim; Seonhee,8,0,34,26
1657455220776,MATH 10B,A02,083208,Lim; Seonhee,9,0,35,26
1657455220776,MATH 10B,A03,093472,Lim; Seonhee,7,0,34,27
1657455220776,MATH 10B,B01,083739,Sinha; Shubham,12,0,30,18
1657455226813,MATH 18,A01,083743,Cinel; Cameron Alexander,7,0,30,23
1657455226813,MATH 18,A02,083744,Cinel; Cameron Alexander,17,0,30,13
1657455226813,MATH 18,A03,083745,Cinel; Cameron Alexander,9,0,30,21
1657455226813,MATH 18,B01,083748,Rideout; David Porter,5,0,37,32
1657455226813,MATH 18,B02,083749,Rideout; David Porter,5,0,36,31
1657455226813,MATH 18,B03,083750,Rideout; David Porter,3,0,37,34
1657455226813,MATH 18,B04,083751,Rideout; David Porter,6,0,36,30
1657455226813,MATH 18,B05,093473,Rideout; David Porter,6,0,36,30
1657455226813,MATH 18,B06,093474,Rideout; David Porter,6,0,36,30
1657455232842,MATH 20A,A01,083754,Zheng; Zequn,14,0,40,26
1657455238874,MATH 20B,A01,083756,Briones; Jor-el Thomas Caparas,4,0,36,32
1657455238874,MATH 20B,A02,083757,Briones; Jor-el Thomas Caparas,1,0,36,35
1657455238874,MATH 20B,A03,093475,Briones; Jor-el Thomas Caparas,2,0,36,34
1657455244906,MATH 20C,A01,083760,Briones; Jor-el Thomas Caparas,1,0,35,34
1657455244906,MATH 20C,A02,083761,Briones; Jor-el Thomas Caparas,8,0,35,27
1657455244906,MATH 20C,A03,093476,Briones; Jor-el Thomas Caparas,0,1,36,36
1657455244906,MATH 20C,B01,083762,Bach; Quang Tran,1,0,30,29
1657455250938,MATH 20D,A01,083765,Tran; Brian Kha,5,0,30,25
1657455250938,MATH 20D,A02,083766,Tran; Brian Kha,5,0,30,25
1657455250938,MATH 20D,A03,083767,Tran; Brian Kha,5,0,30,25
1657455256966,MATH 20E,A01,083771,Ganguly; Soumya,9,0,32,23
1657455256966,MATH 20E,A02,083772,Ganguly; Soumya,6,0,32,26
1657455256966,MATH 20E,B01,083773,Ciotti; Benjamin,20,0,35,15
1657455256966,MATH 20E,B02,083774,Ciotti; Benjamin,17,0,35,18
1657455263004,MATH 103A,A01,083777,Greenfeld; Be'Eri,3,0,36,33
1657455263004,MATH 103A,A02,083778,Greenfeld; Be'Eri,5,0,36,31
1657455263004,MATH 103A,A03,093561,Greenfeld; Be'Eri,5,0,36,31
1657455263004,MATH 103A,B01,083779,Greenfeld; Be'Eri,7,0,36,29
1657455263004,MATH 103A,B02,083780,Greenfeld; Be'Eri,4,0,36,32
1657455263004,MATH 103A,B03,093562,Greenfeld; Be'Eri,3,0,36,33
1657455269038,MATH 105,A01,085443,Carter; Anne Toulson,15,0,35,20
1657455269038,MATH 105,A02,093477,Carter; Anne Toulson,20,0,35,15
1657455275073,MATH 109,A01,083213,Ganzberger; Geoffrey Michael,2,0,34,32
1657455275073,MATH 109,A02,083214,Ganzberger; Geoffrey Michael,4,0,34,30
1657455275073,MATH 109,A03,093478,Ganzberger; Geoffrey Michael,2,0,34,32
1657455275073,MATH 109,B01,083215,Ganzberger; Geoffrey Michael,1,0,32,31
1657455275073,MATH 109,B02,083216,Ganzberger; Geoffrey Michael,2,0,32,30
1657455275073,MATH 109,B03,093479,Ganzberger; Geoffrey Michael,8,0,32,24
1657455281108,MATH 142A,A01,083219,Chow; Bennett,7,0,32,25
1657455281108,MATH 142A,A02,083220,Chow; Bennett,10,0,32,22
1657455281108,MATH 142A,A03,093480,Chow; Bennett,8,0,32,24
1657455281108,MATH 142A,B03,093481,Chow; Bennett,8,0,32,24
1657455281108,MATH 142A,B04,093558,Chow; Bennett,13,0,32,19
1657455281108,MATH 142A,B05,093559,Chow; Bennett,6,0,32,26
1657455287142,MATH 193A,A01,083224,Rotar; Vladimir,8,0,34,26
1657455287142,MATH 193A,A02,083225,Rotar; Vladimir,9,0,34,25
1657455287142,MATH 193A,A03,083781,Rotar; Vladimir,5,0,34,29
1657455287142,MATH 193A,A04,083782,Rotar; Vladimir,10,0,34,24
1657455287142,MATH 193A,A05,093482,Rotar; Vladimir,10,0,34,24
1657455293175,MATH 197,001,091859,McAuley; Julian John,9999,0,9999,0
1657455293175,MATH 197,002,095566,Kedlaya; Kiran S.,9997,0,9999,2
1657455293175,MATH 197,003,095567,Xiao; Ming,9999,0,9999,0
1657455293175,MATH 197,004,095571,Perols; Johan Lars,9998,0,9999,1
1657455300257,COGS 9,A01,083615,Shannon; Kyle Michael,9,0,75,66
1657455306292,COGS 11,A01,083617,Boyle; Mary E. T.,22,0,48,26
1657455312319,COGS 13,A01,083071,Bastos; Amalia Pinkusfeld,11,0,71,60
1657455318344,COGS 14A,A01,092681,Semenuks; Arturs,5,1,100,95
1657455324370,COGS 14B,A01,083073,Cheng; Tzu-Han,6,0,63,57
1657455330399,COGS 17,A01,092677,Semenuks; Arturs,6,0,81,75
1657455336502,COGS 100,A01,083619,Allen; Michael Gordon,17,0,70,53
1657455342527,COGS 101A,A01,083621,Davis; Joshua Daniel,9,0,68,59
1657455348555,COGS 101B,A01,091572,Allen; Michael Gordon,12,0,65,53
1657455354584,COGS 101C,A01,083625,Delgado; Tania,17,0,35,18
1657455360612,COGS 107A,A01,083627,Boyle; Mary E. T.,13,0,60,47
1657455366646,COGS 118A,A01,083075,Gupta; Anjum,21,0,76,55
1657455372677,CSE 3,A50,083646,Miranda; Gregory Joseph,24,0,50,26
1657455378703,CSE 8A,A50,083650,Miranda; Gregory Joseph,17,1,56,39
1657455384732,CSE 11,A01,083080,Cao; Yingjun,6,15,40,34
1657455390767,CSE 12,A01,083652,Krause-Levy; Sophia Louisa,28,1,120,92
1657455396797,CSE 15L,A01,083654,Morris; Justin Loren,9,0,50,41
1657455396797,CSE 15L,A02,083655,Morris; Justin Loren,9,0,50,41
1657455402832,CSE 20,A01,083657,Tran; Khoa Dang,39,0,80,41
1657455408861,CSE 21,A01,095574,Bach; Quang Tran,22,0,48,26
1657455414889,CSE 30,A01,083084,Eldon; John,5,0,80,75
1657455414889,CSE 30,B01,095061,Bhaskar; Nishant,9,0,50,41
1657455420915,CSE 100,A01,083659,Cao; Yingjun,5,4,70,65
1657455426949,CSE 134B,A01,083661,Powell; Thomas Allan,22,0,100,78
1657455432980,CSE 140,A01,083663,Gungor; Onat,15,0,85,70
1657455439011,CSE 140L,A01,083088,Eldon; John,21,0,100,79
1657455445058,CSE 175,A01,083665,Kumar; Rakesh,3,0,25,22
1657455451084,CSE 190,A00,092507,Dubnov; Shlomo,8,0,20,12
1657455457120,ECE 45,A01,083139,Congero; Spencer William,6,0,75,69
1657455463161,ECE 65,A50,083695,Saad; Andrew S,12,0,30,18
1657455463161,ECE 65,A51,095125,Saad; Andrew S,24,0,26,2
1657455469186,ECE 109,A01,091882,Touri; Behrouz,19,0,70,51
1657455475211,ECE 180,A00,083140,Abi Samra; Nicholas Camill,1,0,30,29
1657455475211,ECE 180,B00,083141,Abi Samra; Nicholas Camill,0,0,30,30
1657455481249,MATH 10A,A01,083735,Patchell; Gregory David,2,0,30,28
1657455481249,MATH 10A,A02,083736,Patchell; Gregory David,20,0,30,10
1657455481249,MATH 10A,A03,083737,Patchell; Gregory David,16,0,30,14
1657455487278,MATH 10B,A01,083207,Lim; Seonhee,8,0,34,26
1657455487278,MATH 10B,A02,083208,Lim; Seonhee,9,0,35,26
1657455487278,MATH 10B,A03,093472,Lim; Seonhee,7,0,34,27
1657455487278,MATH 10B,B01,083739,Sinha; Shubham,12,0,30,18
1657455493307,MATH 18,A01,083743,Cinel; Cameron Alexander,7,0,30,23
1657455493307,MATH 18,A02,083744,Cinel; Cameron Alexander,17,0,30,13
1657455493307,MATH 18,A03,083745,Cinel; Cameron Alexander,9,0,30,21
1657455493307,MATH 18,B01,083748,Rideout; David Porter,5,0,37,32
1657455493307,MATH 18,B02,083749,Rideout; David Porter,5,0,36,31
1657455493307,MATH 18,B03,083750,Rideout; David Porter,3,0,37,34
1657455493307,MATH 18,B04,083751,Rideout; David Porter,6,0,36,30
1657455493307,MATH 18,B05,093473,Rideout; David Porter,6,0,36,30
1657455493307,MATH 18,B06,093474,Rideout; David Porter,6,0,36,30
1657455499335,MATH 20A,A01,083754,Zheng; Zequn,14,0,40,26
1657455505361,MATH 20B,A01,083756,Briones; Jor-el Thomas Caparas,4,0,36,32
1657455505361,MATH 20B,A02,083757,Briones; Jor-el Thomas Caparas,1,0,36,35
1657455505361,MATH 20B,A03,093475,Briones; Jor-el Thomas Caparas,2,0,36,34
1657455511396,MATH 20C,A01,083760,Briones; Jor-el Thomas Caparas,1,0,35,34
1657455511396,MATH 20C,A02,083761,Briones; Jor-el Thomas Caparas,8,0,35,27
1657455511396,MATH 20C,A03,093476,Briones; Jor-el Thomas Caparas,0,1,36,36
1657455511396,MATH 20C,B01,083762,Bach; Quang Tran,1,0,30,29
1657455517428,MATH 20D,A01,083765,Tran; Brian Kha,5,0,30,25
1657455517428,MATH 20D,A02,083766,Tran; Brian Kha,5,0,30,25
1657455517428,MATH 20D,A03,083767,Tran; Brian Kha,5,0,30,25
1657455523463,MATH 20E,A01,083771,Ganguly; Soumya,9,0,32,23
1657455523463,MATH 20E,A02,083772,Ganguly; Soumya,6,0,32,26
1657455523463,MATH 20E,B01,083773,Ciotti; Benjamin,20,0,35,15
1657455523463,MATH 20E,B02,083774,Ciotti; Benjamin,17,0,35,18
1657455529490,MATH 103A,A01,083777,Greenfeld; Be'Eri,3,0,36,33
1657455529490,MATH 103A,A02,083778,Greenfeld; Be'Eri,5,0,36,31
1657455529490,MATH 103A,A03,093561,Greenfeld; Be'Eri,5,0,36,31
1657455529490,MATH 103A,B01,083779,Greenfeld; Be'Eri,7,0,36,29
1657455529490,MATH 103A,B02,083780,Greenfeld; Be'Eri,4,0,36,32
1657455529490,MATH 103A,B03,093562,Greenfeld; Be'Eri,3,0,36,33
1657455535518,MATH 105,A01,085443,Carter; Anne Toulson,15,0,35,20
1657455535518,MATH 105,A02,093477,Carter; Anne Toulson,20,0,35,15
1657455541551,MATH 109,A01,083213,Ganzberger; Geoffrey Michael,2,0,34,32
1657455541551,MATH 109,A02,083214,Ganzberger; Geoffrey Michael,4,0,34,30
1657455541551,MATH 109,A03,093478,Ganzberger; Geoffrey Michael,2,0,34,32
1657455541551,MATH 109,B01,083215,Ganzberger; Geoffrey Michael,1,0,32,31
1657455541551,MATH 109,B02,083216,Ganzberger; Geoffrey Michael,2,0,32,30
1657455541551,MATH 109,B03,093479,Ganzberger; Geoffrey Michael,8,0,32,24
1657455547584,MATH 142A,A01,083219,Chow; Bennett,7,0,32,25
1657455547584,MATH 142A,A02,083220,Chow; Bennett,10,0,32,22
1657455547584,MATH 142A,A03,093480,Chow; Bennett,8,0,32,24
1657455547584,MATH 142A,B03,093481,Chow; Bennett,8,0,32,24
1657455547584,MATH 142A,B04,093558,Chow; Bennett,13,0,32,19
1657455547584,MATH 142A,B05,093559,Chow; Bennett,6,0,32,26
1657455553615,MATH 193A,A01,083224,Rotar; Vladimir,8,0,34,26
1657455553615,MATH 193A,A02,083225,Rotar; Vladimir,9,0,34,25
1657455553615,MATH 193A,A03,083781,Rotar; Vladimir,5,0,34,29
1657455553615,MATH 193A,A04,083782,Rotar; Vladimir,10,0,34,24
1657455553615,MATH 193A,A05,093482,Rotar; Vladimir,10,0,34,24
1657455559640,MATH 197,001,091859,McAuley; Julian John,9999,0,9999,0
1657455559640,MATH 197,002,095566,Kedlaya; Kiran S.,9997,0,9999,2
1657455559640,MATH 197,003,095567,Xiao; Ming,9999,0,9999,0
1657455559640,MATH 197,004,095571,Perols; Johan Lars,9998,0,9999,1
1657455566700,COGS 9,A01,083615,Shannon; Kyle Michael,9,0,75,66
1657455572726,COGS 11,A01,083617,Boyle; Mary E. T.,22,0,48,26
1657455578751,COGS 13,A01,083071,Bastos; Amalia Pinkusfeld,11,0,71,60
1657455584779,COGS 14A,A01,092681,Semenuks; Arturs,5,1,100,95
1657455590819,COGS 14B,A01,083073,Cheng; Tzu-Han,6,0,63,57
1657455596843,COGS 17,A01,092677,Semenuks; Arturs,6,0,81,75
1657455602886,COGS 100,A01,083619,Allen; Michael Gordon,17,0,70,53
1657455608911,COGS 101A,A01,083621,Davis; Joshua Daniel,9,0,68,59
1657455614941,COGS 101B,A01,091572,Allen; Michael Gordon,12,0,65,53
1657455620969,COGS 101C,A01,083625,Delgado; Tania,17,0,35,18
1657455627003,COGS 107A,A01,083627,Boyle; Mary E. T.,13,0,60,47
1657455633032,COGS 118A,A01,083075,Gupta; Anjum,21,0,76,55
1657455639066,CSE 3,A50,083646,Miranda; Gregory Joseph,24,0,50,26
1657455645095,CSE 8A,A50,083650,Miranda; Gregory Joseph,17,1,56,39
1657455651121,CSE 11,A01,083080,Cao; Yingjun,6,15,40,34
1657455657151,CSE 12,A01,083652,Krause-Levy; Sophia Louisa,28,1,120,92
1657455663182,CSE 15L,A01,083654,Morris; Justin Loren,9,0,50,41
1657455663182,CSE 15L,A02,083655,Morris; Justin Loren,9,0,50,41
1657455669208,CSE 20,A01,083657,Tran; Khoa Dang,39,0,80,41
1657455675246,CSE 21,A01,095574,Bach; Quang Tran,22,0,48,26
1657455681271,CSE 30,A01,083084,Eldon; John,5,0,80,75
1657455681271,CSE 30,B01,095061,Bhaskar; Nishant,9,0,50,41
1657455687300,CSE 100,A01,083659,Cao; Yingjun,5,4,70,65
1657455693326,CSE 134B,A01,083661,Powell; Thomas Allan,22,0,100,78
1657455699362,CSE 140,A01,083663,Gungor; Onat,15,0,85,70
1657455705388,CSE 140L,A01,083088,Eldon; John,21,0,100,79
1657455711417,CSE 175,A01,083665,Kumar; Rakesh,3,0,25,22
1657455717442,CSE 190,A00,092507,Dubnov; Shlomo,8,0,20,12
1657455723474,ECE 45,A01,083139,Congero; Spencer William,6,0,75,69
1657455729513,ECE 65,A50,083695,Saad; Andrew S,12,0,30,18
1657455729513,ECE 65,A51,095125,Saad; Andrew S,24,0,26,2
1657455735544,ECE 109,A01,091882,Touri; Behrouz,19,0,70,51
1657455741571,ECE 180,A00,083140,Abi Samra; Nicholas Camill,1,0,30,29
1657455741571,ECE 180,B00,083141,Abi Samra; Nicholas Camill,0,0,30,30
1657455747607,MATH 10A,A01,083735,Patchell; Gregory David,2,0,30,28
1657455747607,MATH 10A,A02,083736,Patchell; Gregory David,20,0,30,10
1657455747607,MATH 10A,A03,083737,Patchell; Gregory David,16,0,30,14
1657455753653,MATH 10B,A01,083207,Lim; Seonhee,8,0,34,26
1657455753653,MATH 10B,A02,083208,Lim; Seonhee,9,0,35,26
1657455753653,MATH 10B,A03,093472,Lim; Seonhee,7,0,34,27
1657455753653,MATH 10B,B01,083739,Sinha; Shubham,12,0,30,18
1657455759688,MATH 18,A01,083743,Cinel; Cameron Alexander,7,0,30,23
1657455759688,MATH 18,A02,083744,Cinel; Cameron Alexander,17,0,30,13
1657455759688,MATH 18,A03,083745,Cinel; Cameron Alexander,9,0,30,21
1657455759688,MATH 18,B01,083748,Rideout; David Porter,5,0,37,32
1657455759688,MATH 18,B02,083749,Rideout; David Porter,5,0,36,31
1657455759688,MATH 18,B03,083750,Rideout; David Porter,3,0,37,34
1657455759688,MATH 18,B04,083751,Rideout; David Porter,6,0,36,30
1657455759688,MATH 18,B05,093473,Rideout; David Porter,6,0,36,30
1657455759688,MATH 18,B06,093474,Rideout; David Porter,6,0,36,30
1657455765718,MATH 20A,A01,083754,Zheng; Zequn,14,0,40,26
1657455771753,MATH 20B,A01,083756,Briones; Jor-el Thomas Caparas,4,0,36,32
1657455771753,MATH 20B,A02,083757,Briones; Jor-el Thomas Caparas,1,0,36,35
1657455771753,MATH 20B,A03,093475,Briones; Jor-el Thomas Caparas,2,0,36,34
1657455777780,MATH 20C,A01,083760,Briones; Jor-el Thomas Caparas,1,0,35,34
1657455777780,MATH 20C,A02,083761,Briones; Jor-el Thomas Caparas,8,0,35,27
1657455777780,MATH 20C,A03,093476,Briones; Jor-el Thomas Caparas,0,1,36,36
1657455777780,MATH 20C,B01,083762,Bach; Quang Tran,1,0,30,29
1657455783810,MATH 20D,A01,083765,Tran; Brian Kha,5,0,30,25
1657455783810,MATH 20D,A02,083766,Tran; Brian Kha,5,0,30,25
1657455783810,MATH 20D,A03,083767,Tran; Brian Kha,5,0,30,25
1657455789848,MATH 20E,A01,083771,Ganguly; Soumya,9,0,32,23
1657455789848,MATH 20E,A02,083772,Ganguly; Soumya,6,0,32,26
1657455789848,MATH 20E,B01,083773,Ciotti; Benjamin,20,0,35,15
1657455789848,MATH 20E,B02,083774,Ciotti; Benjamin,17,0,35,18
1657455795879,MATH 103A,A01,083777,Greenfeld; Be'Eri,3,0,36,33
1657455795879,MATH 103A,A02,083778,Greenfeld; Be'Eri,5,0,36,31
1657455795879,MATH 103A,A03,093561,Greenfeld; Be'Eri,5,0,36,31
1657455795879,MATH 103A,B01,083779,Greenfeld; Be'Eri,7,0,36,29
1657455795879,MATH 103A,B02,083780,Greenfeld; Be'Eri,4,0,36,32
1657455795879,MATH 103A,B03,093562,Greenfeld; Be'Eri,3,0,36,33
1657455801902,MATH 105,A01,085443,Carter; Anne Toulson,15,0,35,20
1657455801902,MATH 105,A02,093477,Carter; Anne Toulson,20,0,35,15
1657455807949,MATH 109,A01,083213,Ganzberger; Geoffrey Michael,2,0,34,32
1657455807949,MATH 109,A02,083214,Ganzberger; Geoffrey Michael,4,0,34,30
1657455807949,MATH 109,A03,093478,Ganzberger; Geoffrey Michael,2,0,34,32
1657455807949,MATH 109,B01,083215,Ganzberger; Geoffrey Michael,1,0,32,31
1657455807949,MATH 109,B02,083216,Ganzberger; Geoffrey Michael,2,0,32,30
1657455807949,MATH 109,B03,093479,Ganzberger; Geoffrey Michael,8,0,32,24
1657455813973,MATH 142A,A01,083219,Chow; Bennett,7,0,32,25
1657455813973,MATH 142A,A02,083220,Chow; Bennett,10,0,32,22
1657455813973,MATH 142A,A03,093480,Chow; Bennett,8,0,32,24
1657455813973,MATH 142A,B03,093481,Chow; Bennett,8,0,32,24
1657455813973,MATH 142A,B04,093558,Chow; Bennett,13,0,32,19
1657455813973,MATH 142A,B05,093559,Chow; Bennett,6,0,32,26
1657455819998,MATH 193A,A01,083224,Rotar; Vladimir,8,0,34,26
1657455819998,MATH 193A,A02,083225,Rotar; Vladimir,9,0,34,25
1657455819998,MATH 193A,A03,083781,Rotar; Vladimir,5,0,34,29
1657455819998,MATH 193A,A04,083782,Rotar; Vladimir,10,0,34,24
1657455819998,MATH 193A,A05,093482,Rotar; Vladimir,10,0,34,24
1657455826026,MATH 197,001,091859,McAuley; Julian John,9999,0,9999,0
1657455826026,MATH 197,002,095566,Kedlaya; Kiran S.,9997,0,9999,2
1657455826026,MATH 197,003,095567,Xiao; Ming,9999,0,9999,0
1657455826026,MATH 197,004,095571,Perols; Johan Lars,9998,0,9999,1
1657455833092,COGS 9,A01,083615,Shannon; Kyle Michael,9,0,75,66
1657455839118,COGS 11,A01,083617,Boyle; Mary E. T.,22,0,48,26
1657455845142,COGS 13,A01,083071,Bastos; Amalia Pinkusfeld,11,0,71,60
1657455851166,COGS 14A,A01,092681,Semenuks; Arturs,5,1,100,95
1657455857192,COGS 14B,A01,083073,Cheng; Tzu-Han,6,0,63,57
1657455863220,COGS 17,A01,092677,Semenuks; Arturs,6,0,81,75
1657455869256,COGS 100,A01,083619,Allen; Michael Gordon,17,0,70,53
1657455875286,COGS 101A,A01,083621,Davis; Joshua Daniel,9,0,68,59
1657455881310,COGS 101B,A01,091572,Allen; Michael Gordon,12,0,65,53
1657455887337,COGS 101C,A01,083625,Delgado; Tania,17,0,35,18
1657455893365,COGS 107A,A01,083627,Boyle; Mary E. T.,13,0,60,47
1657455899390,COGS 118A,A01,083075,Gupta; Anjum,21,0,76,55
1657455905426,CSE 3,A50,083646,Miranda; Gregory Joseph,24,0,50,26
1657455911451,CSE 8A,A50,083650,Miranda; Gregory Joseph,17,1,56,39
1657455917473,CSE 11,A01,083080,Cao; Yingjun,6,15,40,34
1657455923504,CSE 12,A01,083652,Krause-Levy; Sophia Louisa,28,1,120,92
1657455929528,CSE 15L,A01,083654,Morris; Justin Loren,9,0,50,41
1657455929528,CSE 15L,A02,083655,Morris; Justin Loren,9,0,50,41
1657455935640,CSE 20,A01,083657,Tran; Khoa Dang,39,0,80,41
1657455941669,CSE 21,A01,095574,Bach; Quang Tran,22,0,48,26
1657455947705,CSE 30,A01,083084,Eldon; John,5,0,80,75
1657455947705,CSE 30,B01,095061,Bhaskar; Nishant,9,0,50,41
1657455953734,CSE 100,A01,083659,Cao; Yingjun,5,4,70,65
1657455959759,CSE 134B,A01,083661,Powell; Thomas Allan,22,0,100,78
1657455965783,CSE 140,A01,083663,Gungor; Onat,15,0,85,70
1657455971814,CSE 140L,A01,083088,Eldon; John,21,0,100,79
1657455977843,CSE 175,A01,083665,Kumar; Rakesh,3,0,25,22
1657455983868,CSE 190,A00,092507,Dubnov; Shlomo,8,0,20,12
1657455989895,ECE 45,A01,083139,Congero; Spencer William,6,0,75,69
1657455995928,ECE 65,A50,083695,Saad; Andrew S,12,0,30,18
1657455995928,ECE 65,A51,095125,Saad; Andrew S,24,0,26,2
1657456001955,ECE 109,A01,091882,Touri; Behrouz,19,0,70,51
1657456007981,ECE 180,A00,083140,Abi Samra; Nicholas Camill,1,0,30,29
1657456007981,ECE 180,B00,083141,Abi Samra; Nicholas Camill,0,0,30,30
1657456014008,MATH 10A,A01,083735,Patchell; Gregory David,2,0,30,28
1657456014008,MATH 10A,A02,083736,Patchell; Gregory David,20,0,30,10
1657456014008,MATH 10A,A03,083737,Patchell; Gregory David,16,0,30,14
1657456020039,MATH 10B,A01,083207,Lim; Seonhee,8,0,34,26
1657456020039,MATH 10B,A02,083208,Lim; Seonhee,9,0,35,26
1657456020039,MATH 10B,A03,093472,Lim; Seonhee,7,0,34,27
1657456020039,MATH 10B,B01,083739,Sinha; Shubham,12,0,30,18
1657456026074,MATH 18,A01,083743,Cinel; Cameron Alexander,7,0,30,23
1657456026074,MATH 18,A02,083744,Cinel; Cameron Alexander,17,0,30,13
1657456026074,MATH 18,A03,083745,Cinel; Cameron Alexander,9,0,30,21
1657456026074,MATH 18,B01,083748,Rideout; David Porter,5,0,37,32
1657456026074,MATH 18,B02,083749,Rideout; David Porter,5,0,36,31
1657456026074,MATH 18,B03,083750,Rideout; David Porter,3,0,37,34
1657456026074,MATH 18,B04,083751,Rideout; David Porter,6,0,36,30
1657456026074,MATH 18,B05,093473,Rideout; David Porter,6,0,36,30
1657456026074,MATH 18,B06,093474,Rideout; David Porter,6,0,36,30
1657456032102,MATH 20A,A01,083754,Zheng; Zequn,14,0,40,26
1657456038131,MATH 20B,A01,083756,Briones; Jor-el Thomas Caparas,4,0,36,32
1657456038131,MATH 20B,A02,083757,Briones; Jor-el Thomas Caparas,1,0,36,35
1657456038131,MATH 20B,A03,093475,Briones; Jor-el Thomas Caparas,2,0,36,34
1657456044158,MATH 20C,A01,083760,Briones; Jor-el Thomas Caparas,1,0,35,34
1657456044158,MATH 20C,A02,083761,Briones; Jor-el Thomas Caparas,8,0,35,27
1657456044158,MATH 20C,A03,093476,Briones; Jor-el Thomas Caparas,0,1,36,36
1657456044158,MATH 20C,B01,083762,Bach; Quang Tran,1,0,30,29
1657456050187,MATH 20D,A01,083765,Tran; Brian Kha,5,0,30,25
1657456050187,MATH 20D,A02,083766,Tran; Brian Kha,5,0,30,25
1657456050187,MATH 20D,A03,083767,Tran; Brian Kha,5,0,30,25
1657456056212,MATH 20E,A01,083771,Ganguly; Soumya,9,0,32,23
1657456056212,MATH 20E,A02,083772,Ganguly; Soumya,6,0,32,26
1657456056212,MATH 20E,B01,083773,Ciotti; Benjamin,20,0,35,15
1657456056212,MATH 20E,B02,083774,Ciotti; Benjamin,17,0,35,18
1657456062237,MATH 103A,A01,083777,Greenfeld; Be'Eri,3,0,36,33
1657456062237,MATH 103A,A02,083778,Greenfeld; Be'Eri,5,0,36,31
1657456062237,MATH 103A,A03,093561,Greenfeld; Be'Eri,5,0,36,31
1657456062237,MATH 103A,B01,083779,Greenfeld; Be'Eri,7,0,36,29
1657456062237,MATH 103A,B02,083780,Greenfeld; Be'Eri,4,0,36,32
1657456062237,MATH 103A,B03,093562,Greenfeld; Be'Eri,3,0,36,33
1657456068264,MATH 105,A01,085443,Carter; Anne Toulson,15,0,35,20
1657456068264,MATH 105,A02,093477,Carter; Anne Toulson,20,0,35,15
1657456074291,MATH 109,A01,083213,Ganzberger; Geoffrey Michael,2,0,34,32
1657456074291,MATH 109,A02,083214,Ganzberger; Geoffrey Michael,4,0,34,30
1657456074291,MATH 109,A03,093478,Ganzberger; Geoffrey Michael,2,0,34,32
1657456074291,MATH 109,B01,083215,Ganzberger; Geoffrey Michael,1,0,32,31
1657456074291,MATH 109,B02,083216,Ganzberger; Geoffrey Michael,2,0,32,30
1657456074291,MATH 109,B03,093479,Ganzberger; Geoffrey Michael,8,0,32,24
1657456080317,MATH 142A,A01,083219,Chow; Bennett,7,0,32,25
1657456080317,MATH 142A,A02,083220,Chow; Bennett,10,0,32,22
1657456080317,MATH 142A,A03,093480,Chow; Bennett,8,0,32,24
1657456080317,MATH 142A,B03,093481,Chow; Bennett,8,0,32,24
1657456080317,MATH 142A,B04,093558,Chow; Bennett,13,0,32,19
1657456080317,MATH 142A,B05,093559,Chow; Bennett,6,0,32,26
1657456086344,MATH 193A,A01,083224,Rotar; Vladimir,8,0,34,26
1657456086344,MATH 193A,A02,083225,Rotar; Vladimir,9,0,34,25
1657456086344,MATH 193A,A03,083781,Rotar; Vladimir,5,0,34,29
1657456086344,MATH 193A,A04,083782,Rotar; Vladimir,10,0,34,24
1657456086344,MATH 193A,A05,093482,Rotar; Vladimir,10,0,34,24
1657456092369,MATH 197,001,091859,McAuley; Julian John,9999,0,9999,0
1657456092369,MATH 197,002,095566,Kedlaya; Kiran S.,9997,0,9999,2
1657456092369,MATH 197,003,095567,Xiao; Ming,9999,0,9999,0
1657456092369,MATH 197,004,095571,Perols; Johan Lars,9998,0,9999,1
1657456099440,COGS 9,A01,083615,Shannon; Kyle Michael,9,0,75,66
1657456105474,COGS 11,A01,083617,Boyle; Mary E. T.,22,0,48,26
1657456111502,COGS 13,A01,083071,Bastos; Amalia Pinkusfeld,11,0,71,60
1657456117526,COGS 14A,A01,092681,Semenuks; Arturs,5,1,100,95
1657456123569,COGS 14B,A01,083073,Cheng; Tzu-Han,6,0,63,57
1657456129595,COGS 17,A01,092677,Semenuks; Arturs,6,0,81,75
1657456135618,COGS 100,A01,083619,Allen; Michael Gordon,17,0,70,53
1657456141648,COGS 101A,A01,083621,Davis; Joshua Daniel,9,0,68,59
1657456147673,COGS 101B,A01,091572,Allen; Michael Gordon,12,0,65,53
1657456153705,COGS 101C,A01,083625,Delgado; Tania,17,0,35,18
1657456159733,COGS 107A,A01,083627,Boyle; Mary E. T.,13,0,60,47
1657456165773,COGS 118A,A01,083075,Gupta; Anjum,21,0,76,55
1657456171796,CSE 3,A50,083646,Miranda; Gregory Joseph,24,0,50,26
1657456177832,CSE 8A,A50,083650,Miranda; Gregory Joseph,17,1,56,39
1657456183857,CSE 11,A01,083080,Cao; Yingjun,6,15,40,34
1657456189885,CSE 12,A01,083652,Krause-Levy; Sophia Louisa,28,1,120,92
1657456195909,CSE 15L,A01,083654,Morris; Justin Loren,9,0,50,41
1657456195909,CSE 15L,A02,083655,Morris; Justin Loren,9,0,50,41
1657456201936,CSE 20,A01,083657,Tran; Khoa Dang,39,0,80,41
1657456207960,CSE 21,A01,095574,Bach; Quang Tran,22,0,48,26
1657456213986,CSE 30,A01,083084,Eldon; John,5,0,80,75
1657456213986,CSE 30,B01,095061,Bhaskar; Nishant,9,0,50,41
1657456220013,CSE 100,A01,083659,Cao; Yingjun,5,4,70,65
1657456226040,CSE 134B,A01,083661,Powell; Thomas Allan,22,0,100,78
1657456232065,CSE 140,A01,083663,Gungor; Onat,15,0,85,70
1657456238092,CSE 140L,A01,083088,Eldon; John,21,0,100,79
1657456244118,CSE 175,A01,083665,Kumar; Rakesh,3,0,25,22
1657456250147,CSE 190,A00,092507,Dubnov; Shlomo,8,0,20,12
1657456256172,ECE 45,A01,083139,Congero; Spencer William,6,0,75,69
1657456262198,ECE 65,A50,083695,Saad; Andrew S,12,0,30,18
1657456262198,ECE 65,A51,095125,Saad; Andrew S,24,0,26,2
1657456268228,ECE 109,A01,091882,Touri; Behrouz,19,0,70,51
1657456274253,ECE 180,A00,083140,Abi Samra; Nicholas Camill,1,0,30,29
1657456274253,ECE 180,B00,083141,Abi Samra; Nicholas Camill,0,0,30,30
1657456280286,MATH 10A,A01,083735,Patchell; Gregory David,2,0,30,28
1657456280286,MATH 10A,A02,083736,Patchell; Gregory David,20,0,30,10
1657456280286,MATH 10A,A03,083737,Patchell; Gregory David,16,0,30,14
1657456286318,MATH 10B,A01,083207,Lim; Seonhee,8,0,34,26
1657456286318,MATH 10B,A02,083208,Lim; Seonhee,9,0,35,26
1657456286318,MATH 10B,A03,093472,Lim; Seonhee,7,0,34,27
1657456286318,MATH 10B,B01,083739,Sinha; Shubham,12,0,30,18
1657456292351,MATH 18,A01,083743,Cinel; Cameron Alexander,7,0,30,23
1657456292351,MATH 18,A02,083744,Cinel; Cameron Alexander,17,0,30,13
1657456292351,MATH 18,A03,083745,Cinel; Cameron Alexander,9,0,30,21
1657456292351,MATH 18,B01,083748,Rideout; David Porter,5,0,37,32
1657456292351,MATH 18,B02,083749,Rideout; David Porter,5,0,36,31
1657456292351,MATH 18,B03,083750,Rideout; David Porter,3,0,37,34
1657456292351,MATH 18,B04,083751,Rideout; David Porter,6,0,36,30
1657456292351,MATH 18,B05,093473,Rideout; David Porter,6,0,36,30
1657456292351,MATH 18,B06,093474,Rideout; David Porter,6,0,36,30
1657456298380,MATH 20A,A01,083754,Zheng; Zequn,14,0,40,26
1657456304410,MATH 20B,A01,083756,Briones; Jor-el Thomas Caparas,4,0,36,32
1657456304410,MATH 20B,A02,083757,Briones; Jor-el Thomas Caparas,1,0,36,35
1657456304410,MATH 20B,A03,093475,Briones; Jor-el Thomas Caparas,2,0,36,34
1657456310448,MATH 20C,A01,083760,Briones; Jor-el Thomas Caparas,1,0,35,34
1657456310448,MATH 20C,A02,083761,Briones; Jor-el Thomas Caparas,8,0,35,27
1657456310448,MATH 20C,A03,093476,Briones; Jor-el Thomas Caparas,0,1,36,36
1657456310448,MATH 20C,B01,083762,Bach; Quang Tran,1,0,30,29
1657456316482,MATH 20D,A01,083765,Tran; Brian Kha,5,0,30,25
1657456316482,MATH 20D,A02,083766,Tran; Brian Kha,5,0,30,25
1657456316482,MATH 20D,A03,083767,Tran; Brian Kha,5,0,30,25
1657456322517,MATH 20E,A01,083771,Ganguly; Soumya,9,0,32,23
1657456322517,MATH 20E,A02,083772,Ganguly; Soumya,6,0,32,26
1657456322517,MATH 20E,B01,083773,Ciotti; Benjamin,20,0,35,15
1657456322517,MATH 20E,B02,083774,Ciotti; Benjamin,17,0,35,18
1657456328544,MATH 103A,A01,083777,Greenfeld; Be'Eri,3,0,36,33
1657456328544,MATH 103A,A02,083778,Greenfeld; Be'Eri,5,0,36,31
1657456328544,MATH 103A,A03,093561,Greenfeld; Be'Eri,5,0,36,31
1657456328544,MATH 103A,B01,083779,Greenfeld; Be'Eri,7,0,36,29
1657456328544,MATH 103A,B02,083780,Greenfeld; Be'Eri,4,0,36,32
1657456328544,MATH 103A,B03,093562,Greenfeld; Be'Eri,3,0,36,33
1657456334575,MATH 105,A01,085443,Carter; Anne Toulson,15,0,35,20
1657456334575,MATH 105,A02,093477,Carter; Anne Toulson,20,0,35,15
1657456340613,MATH 109,A01,083213,Ganzberger; Geoffrey Michael,2,0,34,32
1657456340613,MATH 109,A02,083214,Ganzberger; Geoffrey Michael,4,0,34,30
1657456340613,MATH 109,A03,093478,Ganzberger; Geoffrey Michael,2,0,34,32
1657456340613,MATH 109,B01,083215,Ganzberger; Geoffrey Michael,1,0,32,31
1657456340613,MATH 109,B02,083216,Ganzberger; Geoffrey Michael,2,0,32,30
1657456340613,MATH 109,B03,093479,Ganzberger; Geoffrey Michael,8,0,32,24
1657456346647,MATH 142A,A01,083219,Chow; Bennett,7,0,32,25
1657456346647,MATH 142A,A02,083220,Chow; Bennett,10,0,32,22
1657456346647,MATH 142A,A03,093480,Chow; Bennett,8,0,32,24
1657456346647,MATH 142A,B03,093481,Chow; Bennett,8,0,32,24
1657456346647,MATH 142A,B04,093558,Chow; Bennett,13,0,32,19
1657456346647,MATH 142A,B05,093559,Chow; Bennett,6,0,32,26
1657456352683,MATH 193A,A01,083224,Rotar; Vladimir,8,0,34,26
1657456352683,MATH 193A,A02,083225,Rotar; Vladimir,9,0,34,25
1657456352683,MATH 193A,A03,083781,Rotar; Vladimir,5,0,34,29
1657456352683,MATH 193A,A04,083782,Rotar; Vladimir,10,0,34,24
1657456352683,MATH 193A,A05,093482,Rotar; Vladimir,10,0,34,24
1657456358708,MATH 197,001,091859,McAuley; Julian John,9999,0,9999,0
1657456358708,MATH 197,002,095566,Kedlaya; Kiran S.,9997,0,9999,2
1657456358708,MATH 197,003,095567,Xiao; Ming,9999,0,9999,0
1657456358708,MATH 197,004,095571,Perols; Johan Lars,9998,0,9999,1
1657456365767,COGS 9,A01,083615,Shannon; Kyle Michael,9,0,75,66
1657456371793,COGS 11,A01,083617,Boyle; Mary E. T.,22,0,48,26
1657456377824,COGS 13,A01,083071,Bastos; Amalia Pinkusfeld,11,0,71,60
1657456383848,COGS 14A,A01,092681,Semenuks; Arturs,5,1,100,95
1657456389879,COGS 14B,A01,083073,Cheng; Tzu-Han,6,0,63,57
1657456395904,COGS 17,A01,092677,Semenuks; Arturs,6,0,81,75
1657456401928,COGS 100,A01,083619,Allen; Michael Gordon,17,0,70,53
1657456407953,COGS 101A,A01,083621,Davis; Joshua Daniel,9,0,68,59
1657456413993,COGS 101B,A01,091572,Allen; Michael Gordon,12,0,65,53
1657456420021,COGS 101C,A01,083625,Delgado; Tania,17,0,35,18
1657456426044,COGS 107A,A01,083627,Boyle; Mary E. T.,13,0,60,47
1657456432071,COGS 118A,A01,083075,Gupta; Anjum,21,0,76,55
1657456438100,CSE 3,A50,083646,Miranda; Gregory Joseph,24,0,50,26
1657456444127,CSE 8A,A50,083650,Miranda; Gregory Joseph,17,1,56,39
1657456450154,CSE 11,A01,083080,Cao; Yingjun,6,15,40,34
1657456456183,CSE 12,A01,083652,Krause-Levy; Sophia Louisa,28,1,120,92
1657456462211,CSE 15L,A01,083654,Morris; Justin Loren,9,0,50,41
1657456462211,CSE 15L,A02,083655,Morris; Justin Loren,9,0,50,41
1657456468237,CSE 20,A01,083657,Tran; Khoa Dang,39,0,80,41
1657456474265,CSE 21,A01,095574,Bach; Quang Tran,22,0,48,26
1657456480295,CSE 30,A01,083084,Eldon; John,5,0,80,75
1657456480295,CSE 30,B01,095061,Bhaskar; Nishant,9,0,50,41
1657456486320,CSE 100,A01,083659,Cao; Yingjun,5,4,70,65
1657456492354,CSE 134B,A01,083661,Powell; Thomas Allan,22,0,100,78
1657456498380,CSE 140,A01,083663,Gungor; Onat,15,0,85,70
1657456504406,CSE 140L,A01,083088,Eldon; John,21,0,100,79
1657456510432,CSE 175,A01,083665,Kumar; Rakesh,3,0,25,22
1657456516458,CSE 190,A00,092507,Dubnov; Shlomo,8,0,20,12
1657456522486,ECE 45,A01,083139,Congero; Spencer William,6,0,75,69
1657456528514,ECE 65,A50,083695,Saad; Andrew S,12,0,30,18
1657456528514,ECE 65,A51,095125,Saad; Andrew S,24,0,26,2
1657456534630,ECE 109,A01,091882,Touri; Behrouz,19,0,70,51
1657456540664,ECE 180,A00,083140,Abi Samra; Nicholas Camill,1,0,30,29
1657456540664,ECE 180,B00,083141,Abi Samra; Nicholas Camill,0,0,30,30
1657456546700,MATH 10A,A01,083735,Patchell; Gregory David,2,0,30,28
1657456546700,MATH 10A,A02,083736,Patchell; Gregory David,20,0,30,10
1657456546700,MATH 10A,A03,083737,Patchell; Gregory David,16,0,30,14
1657456552743,MATH 10B,A01,083207,Lim; Seonhee,8,0,34,26
1657456552743,MATH 10B,A02,083208,Lim; Seonhee,9,0,35,26
1657456552743,MATH 10B,A03,093472,Lim; Seonhee,7,0,34,27
1657456552743,MATH 10B,B01,083739,Sinha; Shubham,12,0,30,18
1657456558787,MATH 18,A01,083743,Cinel; Cameron Alexander,7,0,30,23
1657456558787,MATH 18,A02,083744,Cinel; Cameron Alexander,17,0,30,13
1657456558787,MATH 18,A03,083745,Cinel; Cameron Alexander,9,0,30,21
1657456558787,MATH 18,B01,083748,Rideout; David Porter,5,0,37,32
1657456558787,MATH 18,B02,083749,Rideout; David Porter,5,0,36,31
1657456558787,MATH 18,B03,083750,Rideout; David Porter,3,0,37,34
1657456558787,MATH 18,B04,083751,Rideout; David Porter,6,0,36,30
1657456558787,MATH 18,B05,093473,Rideout; David Porter,6,0,36,30
1657456558787,MATH 18,B06,093474,Rideout; David Porter,6,0,36,30
1657456564813,MATH 20A,A01,083754,Zheng; Zequn,14,0,40,26
1657456570841,MATH 20B,A01,083756,Briones; Jor-el Thomas Caparas,4,0,36,32
1657456570841,MATH 20B,A02,083757,Briones; Jor-el Thomas Caparas,1,0,36,35
1657456570841,MATH 20B,A03,093475,Briones; Jor-el Thomas Caparas,2,0,36,34
1657456576869,MATH 20C,A01,083760,Briones; Jor-el Thomas Caparas,1,0,35,34
1657456576869,MATH 20C,A02,083761,Briones; Jor-el Thomas Caparas,8,0,35,27
1657456576869,MATH 20C,A03,093476,Briones; Jor-el Thomas Caparas,0,1,36,36
1657456576869,MATH 20C,B01,083762,Bach; Quang Tran,1,0,30,29
1657456582896,MATH 20D,A01,083765,Tran; Brian Kha,5,0,30,25
1657456582896,MATH 20D,A02,083766,Tran; Brian Kha,5,0,30,25
1657456582896,MATH 20D,A03,083767,Tran; Brian Kha,5,0,30,25
1657456588931,MATH 20E,A01,083771,Ganguly; Soumya,9,0,32,23
1657456588931,MATH 20E,A02,083772,Ganguly; Soumya,6,0,32,26
1657456588931,MATH 20E,B01,083773,Ciotti; Benjamin,20,0,35,15
1657456588931,MATH 20E,B02,083774,Ciotti; Benjamin,17,0,35,18
1657456594958,MATH 103A,A01,083777,Greenfeld; Be'Eri,3,0,36,33
1657456594958,MATH 103A,A02,083778,Greenfeld; Be'Eri,5,0,36,31
1657456594958,MATH 103A,A03,093561,Greenfeld; Be'Eri,5,0,36,31
1657456594958,MATH 103A,B01,083779,Greenfeld; Be'Eri,7,0,36,29
1657456594958,MATH 103A,B02,083780,Greenfeld; Be'Eri,4,0,36,32
1657456594958,MATH 103A,B03,093562,Greenfeld; Be'Eri,3,0,36,33
1657456600986,MATH 105,A01,085443,Carter; Anne Toulson,15,0,35,20
1657456600986,MATH 105,A02,093477,Carter; Anne Toulson,20,0,35,15
1657456607013,MATH 109,A01,083213,Ganzberger; Geoffrey Michael,2,0,34,32
1657456607013,MATH 109,A02,083214,Ganzberger; Geoffrey Michael,4,0,34,30
1657456607013,MATH 109,A03,093478,Ganzberger; Geoffrey Michael,2,0,34,32
1657456607013,MATH 109,B01,083215,Ganzberger; Geoffrey Michael,1,0,32,31
1657456607013,MATH 109,B02,083216,Ganzberger; Geoffrey Michael,2,0,32,30
1657456607013,MATH 109,B03,093479,Ganzberger; Geoffrey Michael,8,0,32,24
1657456613043,MATH 142A,A01,083219,Chow; Bennett,7,0,32,25
1657456613043,MATH 142A,A02,083220,Chow; Bennett,10,0,32,22
1657456613043,MATH 142A,A03,093480,Chow; Bennett,8,0,32,24
1657456613043,MATH 142A,B03,093481,Chow; Bennett,8,0,32,24
1657456613043,MATH 142A,B04,093558,Chow; Bennett,13,0,32,19
1657456613043,MATH 142A,B05,093559,Chow; Bennett,6,0,32,26
1657456619070,MATH 193A,A01,083224,Rotar; Vladimir,8,0,34,26
1657456619070,MATH 193A,A02,083225,Rotar; Vladimir,9,0,34,25
1657456619070,MATH 193A,A03,083781,Rotar; Vladimir,5,0,34,29
1657456619070,MATH 193A,A04,083782,Rotar; Vladimir,10,0,34,24
1657456619070,MATH 193A,A05,093482,Rotar; Vladimir,10,0,34,24
1657456625104,MATH 197,001,091859,McAuley; Julian John,9999,0,9999,0
1657456625104,MATH 197,002,095566,Kedlaya; Kiran S.,9997,0,9999,2
1657456625104,MATH 197,003,095567,Xiao; Ming,9999,0,9999,0
1657456625104,MATH 197,004,095571,Perols; Johan Lars,9998,0,9999,1
1657456632191,COGS 9,A01,083615,Shannon; Kyle Michael,9,0,75,66
1657456638216,COGS 11,A01,083617,Boyle; Mary E. T.,22,0,48,26
1657456644244,COGS 13,A01,083071,Bastos; Amalia Pinkusfeld,11,0,71,60
1657456650276,COGS 14A,A01,092681,Semenuks; Arturs,5,1,100,95
1657456656307,COGS 14B,A01,083073,Cheng; Tzu-Han,6,0,63,57
1657456662334,COGS 17,A01,092677,Semenuks; Arturs,6,0,81,75
1657456668361,COGS 100,A01,083619,Allen; Michael Gordon,17,0,70,53
1657456674389,COGS 101A,A01,083621,Davis; Joshua Daniel,9,0,68,59
1657456680416,COGS 101B,A01,091572,Allen; Michael Gordon,12,0,65,53
1657456686441,COGS 101C,A01,083625,Delgado; Tania,17,0,35,18
1657456692471,COGS 107A,A01,083627,Boyle; Mary E. T.,13,0,60,47
1657456698502,COGS 118A,A01,083075,Gupta; Anjum,21,0,76,55
1657456704530,CSE 3,A50,083646,Miranda; Gregory Joseph,24,0,50,26
1657456710563,CSE 8A,A50,083650,Miranda; Gregory Joseph,17,1,56,39
1657456716588,CSE 11,A01,083080,Cao; Yingjun,6,15,40,34
1657456722616,CSE 12,A01,083652,Krause-Levy; Sophia Louisa,28,1,120,92
1657456728643,CSE 15L,A01,083654,Morris; Justin Loren,9,0,50,41
1657456728643,CSE 15L,A02,083655,Morris; Justin Loren,9,0,50,41
1657456734674,CSE 20,A01,083657,Tran; Khoa Dang,39,0,80,41
1657456740706,CSE 21,A01,095574,Bach; Quang Tran,22,0,48,26
1657456746734,CSE 30,A01,083084,Eldon; John,5,0,80,75
1657456746734,CSE 30,B01,095061,Bhaskar; Nishant,9,0,50,41
1657456752764,CSE 100,A01,083659,Cao; Yingjun,5,4,70,65
1657456758795,CSE 134B,A01,083661,Powell; Thomas Allan,22,0,100,78
1657456764820,CSE 140,A01,083663,Gungor; Onat,15,0,85,70
1657456770846,CSE 140L,A01,083088,Eldon; John,21,0,100,79
1657456776879,CSE 175,A01,083665,Kumar; Rakesh,3,0,25,22
1657456782907,CSE 190,A00,092507,Dubnov; Shlomo,8,0,20,12
1657456788935,ECE 45,A01,083139,Congero; Spencer William,6,0,75,69
1657456794981,ECE 65,A50,083695,Saad; Andrew S,12,0,30,18
1657456794981,ECE 65,A51,095125,Saad; Andrew S,24,0,26,2
1657456801008,ECE 109,A01,091882,Touri; Behrouz,19,0,70,51
1657456807034,ECE 180,A00,083140,Abi Samra; Nicholas Camill,1,0,30,29
1657456807034,ECE 180,B00,083141,Abi Samra; Nicholas Camill,0,0,30,30
1657456813062,MATH 10A,A01,083735,Patchell; Gregory David,2,0,30,28
1657456813062,MATH 10A,A02,083736,Patchell; Gregory David,20,0,30,10
1657456813062,MATH 10A,A03,083737,Patchell; Gregory David,16,0,30,14
1657456819103,MATH 10B,A01,083207,Lim; Seonhee,8,0,34,26
1657456819103,MATH 10B,A02,083208,Lim; Seonhee,9,0,35,26
1657456819103,MATH 10B,A03,093472,Lim; Seonhee,7,0,34,27
1657456819103,MATH 10B,B01,083739,Sinha; Shubham,12,0,30,18
1657456825133,MATH 18,A01,083743,Cinel; Cameron Alexander,7,0,30,23
1657456825133,MATH 18,A02,083744,Cinel; Cameron Alexander,17,0,30,13
1657456825133,MATH 18,A03,083745,Cinel; Cameron Alexander,9,0,30,21
1657456825133,MATH 18,B01,083748,Rideout; David Porter,5,0,37,32
1657456825133,MATH 18,B02,083749,Rideout; David Porter,5,0,36,31
1657456825133,MATH 18,B03,083750,Rideout; David Porter,3,0,37,34
1657456825133,MATH 18,B04,083751,Rideout; David Porter,6,0,36,30
1657456825133,MATH 18,B05,093473,Rideout; David Porter,6,0,36,30
1657456825133,MATH 18,B06,093474,Rideout; David Porter,6,0,36,30
1657456831159,MATH 20A,A01,083754,Zheng; Zequn,14,0,40,26
1657456837193,MATH 20B,A01,083756,Briones; Jor-el Thomas Caparas,4,0,36,32
1657456837193,MATH 20B,A02,083757,Briones; Jor-el Thomas Caparas,1,0,36,35
1657456837193,MATH 20B,A03,093475,Briones; Jor-el Thomas Caparas,2,0,36,34
1657456843219,MATH 20C,A01,083760,Briones; Jor-el Thomas Caparas,1,0,35,34
1657456843219,MATH 20C,A02,083761,Briones; Jor-el Thomas Caparas,8,0,35,27
1657456843219,MATH 20C,A03,093476,Briones; Jor-el Thomas Caparas,0,1,36,36
1657456843219,MATH 20C,B01,083762,Bach; Quang Tran,1,0,30,29
1657456849244,MATH 20D,A01,083765,Tran; Brian Kha,5,0,30,25
1657456849244,MATH 20D,A02,083766,Tran; Brian Kha,5,0,30,25
1657456849244,MATH 20D,A03,083767,Tran; Brian Kha,5,0,30,25
1657456855278,MATH 20E,A01,083771,Ganguly; Soumya,9,0,32,23
1657456855278,MATH 20E,A02,083772,Ganguly; Soumya,6,0,32,26
1657456855278,MATH 20E,B01,083773,Ciotti; Benjamin,20,0,35,15
1657456855278,MATH 20E,B02,083774,Ciotti; Benjamin,17,0,35,18
1657456861304,MATH 103A,A01,083777,Greenfeld; Be'Eri,3,0,36,33
1657456861304,MATH 103A,A02,083778,Greenfeld; Be'Eri,5,0,36,31
1657456861304,MATH 103A,A03,093561,Greenfeld; Be'Eri,5,0,36,31
1657456861304,MATH 103A,B01,083779,Greenfeld; Be'Eri,7,0,36,29
1657456861304,MATH 103A,B02,083780,Greenfeld; Be'Eri,4,0,36,32
1657456861304,MATH 103A,B03,093562,Greenfeld; Be'Eri,3,0,36,33
1657456867335,MATH 105,A01,085443,Carter; Anne Toulson,15,0,35,20
1657456867335,MATH 105,A02,093477,Carter; Anne Toulson,20,0,35,15
1657456873361,MATH 109,A01,083213,Ganzberger; Geoffrey Michael,2,0,34,32
1657456873361,MATH 109,A02,083214,Ganzberger; Geoffrey Michael,4,0,34,30
1657456873361,MATH 109,A03,093478,Ganzberger; Geoffrey Michael,2,0,34,32
1657456873361,MATH 109,B01,083215,Ganzberger; Geoffrey Michael,1,0,32,31
1657456873361,MATH 109,B02,083216,Ganzberger; Geoffrey Michael,2,0,32,30
1657456873361,MATH 109,B03,093479,Ganzberger; Geoffrey Michael,8,0,32,24
1657456879392,MATH 142A,A01,083219,Chow; Bennett,7,0,32,25
1657456879392,MATH 142A,A02,083220,Chow; Bennett,10,0,32,22
1657456879392,MATH 142A,A03,093480,Chow; Bennett,8,0,32,24
1657456879392,MATH 142A,B03,093481,Chow; Bennett,8,0,32,24
1657456879392,MATH 142A,B04,093558,Chow; Bennett,13,0,32,19
1657456879392,MATH 142A,B05,093559,Chow; Bennett,6,0,32,26
1657456885419,MATH 193A,A01,083224,Rotar; Vladimir,8,0,34,26
1657456885419,MATH 193A,A02,083225,Rotar; Vladimir,9,0,34,25
1657456885419,MATH 193A,A03,083781,Rotar; Vladimir,5,0,34,29
1657456885419,MATH 193A,A04,083782,Rotar; Vladimir,10,0,34,24
1657456885419,MATH 193A,A05,093482,Rotar; Vladimir,10,0,34,24
1657456891443,MATH 197,001,091859,McAuley; Julian John,9999,0,9999,0
1657456891443,MATH 197,002,095566,Kedlaya; Kiran S.,9997,0,9999,2
1657456891443,MATH 197,003,095567,Xiao; Ming,9999,0,9999,0
1657456891443,MATH 197,004,095571,Perols; Johan Lars,9998,0,9999,1
1657456898516,COGS 9,A01,083615,Shannon; Kyle Michael,9,0,75,66
1657456904546,COGS 11,A01,083617,Boyle; Mary E. T.,22,0,48,26
1657456910575,COGS 13,A01,083071,Bastos; Amalia Pinkusfeld,11,0,71,60
1657456916602,COGS 14A,A01,092681,Semenuks; Arturs,5,1,100,95
1657456922632,COGS 14B,A01,083073,Cheng; Tzu-Han,6,0,63,57
1657456928657,COGS 17,A01,092677,Semenuks; Arturs,6,0,81,75
1657456934688,COGS 100,A01,083619,Allen; Michael Gordon,17,0,70,53
1657456940719,COGS 101A,A01,083621,Davis; Joshua Daniel,9,0,68,59
1657456946745,COGS 101B,A01,091572,Allen; Michael Gordon,12,0,65,53
1657456952775,COGS 101C,A01,083625,Delgado; Tania,17,0,35,18
1657456958800,COGS 107A,A01,083627,Boyle; Mary E. T.,13,0,60,47
1657456964828,COGS 118A,A01,083075,Gupta; Anjum,21,0,76,55
1657456970863,CSE 3,A50,083646,Miranda; Gregory Joseph,24,0,50,26
1657456976890,CSE 8A,A50,083650,Miranda; Gregory Joseph,17,1,56,39
1657456982917,CSE 11,A01,083080,Cao; Yingjun,6,15,40,34
1657456988944,CSE 12,A01,083652,Krause-Levy; Sophia Louisa,28,1,120,92
1657456994969,CSE 15L,A01,083654,Morris; Justin Loren,9,0,50,41
1657456994969,CSE 15L,A02,083655,Morris; Justin Loren,9,0,50,41
1657457000994,CSE 20,A01,083657,Tran; Khoa Dang,39,0,80,41
1657457007018,CSE 21,A01,095574,Bach; Quang Tran,22,0,48,26
1657457013045,CSE 30,A01,083084,Eldon; John,5,0,80,75
1657457013045,CSE 30,B01,095061,Bhaskar; Nishant,9,0,50,41
1657457019081,CSE 100,A01,083659,Cao; Yingjun,5,4,70,65
1657457025106,CSE 134B,A01,083661,Powell; Thomas Allan,22,0,100,78
1657457031138,CSE 140,A01,083663,Gungor; Onat,15,0,85,70
1657457037166,CSE 140L,A01,083088,Eldon; John,21,0,100,79
1657457043194,CSE 175,A01,083665,Kumar; Rakesh,3,0,25,22
1657457049221,CSE 190,A00,092507,Dubnov; Shlomo,8,0,20,12
1657457055254,ECE 45,A01,083139,Congero; Spencer William,6,0,75,69
1657457061283,ECE 65,A50,083695,Saad; Andrew S,12,0,30,18
1657457061283,ECE 65,A51,095125,Saad; Andrew S,24,0,26,2
1657457067318,ECE 109,A01,091882,Touri; Behrouz,19,0,70,51
1657457073348,ECE 180,A00,083140,Abi Samra; Nicholas Camill,1,0,30,29
1657457073348,ECE 180,B00,083141,Abi Samra; Nicholas Camill,0,0,30,30
1657457079381,MATH 10A,A01,083735,Patchell; Gregory David,2,0,30,28
1657457079381,MATH 10A,A02,083736,Patchell; Gregory David,20,0,30,10
1657457079381,MATH 10A,A03,083737,Patchell; Gregory David,16,0,30,14
1657457085410,MATH 10B,A01,083207,Lim; Seonhee,8,0,34,26
1657457085410,MATH 10B,A02,083208,Lim; Seonhee,9,0,35,26
1657457085410,MATH 10B,A03,093472,Lim; Seonhee,7,0,34,27
1657457085410,MATH 10B,B01,083739,Sinha; Shubham,12,0,30,18
1657457091437,MATH 18,A01,083743,Cinel; Cameron Alexander,7,0,30,23
1657457091437,MATH 18,A02,083744,Cinel; Cameron Alexander,17,0,30,13
1657457091437,MATH 18,A03,083745,Cinel; Cameron Alexander,9,0,30,21
1657457091437,MATH 18,B01,083748,Rideout; David Porter,5,0,37,32
1657457091437,MATH 18,B02,083749,Rideout; David Porter,5,0,36,31
1657457091437,MATH 18,B03,083750,Rideout; David Porter,3,0,37,34
1657457091437,MATH 18,B04,083751,Rideout; David Porter,6,0,36,30
1657457091437,MATH 18,B05,093473,Rideout; David Porter,6,0,36,30
1657457091437,MATH 18,B06,093474,Rideout; David Porter,6,0,36,30
1657457097461,MATH 20A,A01,083754,Zheng; Zequn,14,0,40,26
1657457103489,MATH 20B,A01,083756,Briones; Jor-el Thomas Caparas,4,0,36,32
1657457103489,MATH 20B,A02,083757,Briones; Jor-el Thomas Caparas,1,0,36,35
1657457103489,MATH 20B,A03,093475,Briones; Jor-el Thomas Caparas,2,0,36,34
1657457109514,MATH 20C,A01,083760,Briones; Jor-el Thomas Caparas,1,0,35,34
1657457109514,MATH 20C,A02,083761,Briones; Jor-el Thomas Caparas,8,0,35,27
1657457109514,MATH 20C,A03,093476,Briones; Jor-el Thomas Caparas,0,1,36,36
1657457109514,MATH 20C,B01,083762,Bach; Quang Tran,1,0,30,29
1657457115547,MATH 20D,A01,083765,Tran; Brian Kha,5,0,30,25
1657457115547,MATH 20D,A02,083766,Tran; Brian Kha,5,0,30,25
1657457115547,MATH 20D,A03,083767,Tran; Brian Kha,5,0,30,25
1657457121582,MATH 20E,A01,083771,Ganguly; Soumya,9,0,32,23
1657457121582,MATH 20E,A02,083772,Ganguly; Soumya,6,0,32,26
1657457121582,MATH 20E,B01,083773,Ciotti; Benjamin,20,0,35,15
1657457121582,MATH 20E,B02,083774,Ciotti; Benjamin,17,0,35,18
1657457127620,MATH 103A,A01,083777,Greenfeld; Be'Eri,3,0,36,33
1657457127620,MATH 103A,A02,083778,Greenfeld; Be'Eri,5,0,36,31
1657457127620,MATH 103A,A03,093561,Greenfeld; Be'Eri,5,0,36,31
1657457127620,MATH 103A,B01,083779,Greenfeld; Be'Eri,7,0,36,29
1657457127620,MATH 103A,B02,083780,Greenfeld; Be'Eri,4,0,36,32
1657457127620,MATH 103A,B03,093562,Greenfeld; Be'Eri,3,0,36,33
1657457133742,MATH 105,A01,085443,Carter; Anne Toulson,15,0,35,20
1657457133742,MATH 105,A02,093477,Carter; Anne Toulson,20,0,35,15
1657457139773,MATH 109,A01,083213,Ganzberger; Geoffrey Michael,2,0,34,32
1657457139773,MATH 109,A02,083214,Ganzberger; Geoffrey Michael,4,0,34,30
1657457139773,MATH 109,A03,093478,Ganzberger; Geoffrey Michael,2,0,34,32
1657457139773,MATH 109,B01,083215,Ganzberger; Geoffrey Michael,1,0,32,31
1657457139773,MATH 109,B02,083216,Ganzberger; Geoffrey Michael,2,0,32,30
1657457139773,MATH 109,B03,093479,Ganzberger; Geoffrey Michael,8,0,32,24
1657457145801,MATH 142A,A01,083219,Chow; Bennett,7,0,32,25
1657457145801,MATH 142A,A02,083220,Chow; Bennett,10,0,32,22
1657457145801,MATH 142A,A03,093480,Chow; Bennett,8,0,32,24
1657457145801,MATH 142A,B03,093481,Chow; Bennett,8,0,32,24
1657457145801,MATH 142A,B04,093558,Chow; Bennett,13,0,32,19
1657457145801,MATH 142A,B05,093559,Chow; Bennett,6,0,32,26
1657457151827,MATH 193A,A01,083224,Rotar; Vladimir,8,0,34,26
1657457151827,MATH 193A,A02,083225,Rotar; Vladimir,9,0,34,25
1657457151827,MATH 193A,A03,083781,Rotar; Vladimir,5,0,34,29
1657457151827,MATH 193A,A04,083782,Rotar; Vladimir,10,0,34,24
1657457151827,MATH 193A,A05,093482,Rotar; Vladimir,10,0,34,24
1657457157855,MATH 197,001,091859,McAuley; Julian John,9999,0,9999,0
1657457157855,MATH 197,002,095566,Kedlaya; Kiran S.,9997,0,9999,2
1657457157855,MATH 197,003,095567,Xiao; Ming,9999,0,9999,0
1657457157855,MATH 197,004,095571,Perols; Johan Lars,9998,0,9999,1
1657457164929,COGS 9,A01,083615,Shannon; Kyle Michael,9,0,75,66
1657457170955,COGS 11,A01,083617,Boyle; Mary E. T.,22,0,48,26
1657457176982,COGS 13,A01,083071,Bastos; Amalia Pinkusfeld,11,0,71,60
1657457183006,COGS 14A,A01,092681,Semenuks; Arturs,5,1,100,95
1657457189030,COGS 14B,A01,083073,Cheng; Tzu-Han,6,0,63,57
1657457195054,COGS 17,A01,092677,Semenuks; Arturs,6,0,81,75
1657457201081,COGS 100,A01,083619,Allen; Michael Gordon,17,0,70,53
1657457207113,COGS 101A,A01,083621,Davis; Joshua Daniel,9,0,68,59
1657457213144,COGS 101B,A01,091572,Allen; Michael Gordon,12,0,65,53
1657457219170,COGS 101C,A01,083625,Delgado; Tania,17,0,35,18
1657457225194,COGS 107A,A01,083627,Boyle; Mary E. T.,13,0,60,47
1657457231224,COGS 118A,A01,083075,Gupta; Anjum,21,0,76,55
1657457237253,CSE 3,A50,083646,Miranda; Gregory Joseph,24,0,50,26
1657457243280,CSE 8A,A50,083650,Miranda; Gregory Joseph,17,1,56,39
1657457249306,CSE 11,A01,083080,Cao; Yingjun,6,15,40,34
1657457255332,CSE 12,A01,083652,Krause-Levy; Sophia Louisa,28,1,120,92
1657457261362,CSE 15L,A01,083654,Morris; Justin Loren,9,0,50,41
1657457261362,CSE 15L,A02,083655,Morris; Justin Loren,9,0,50,41
1657457267390,CSE 20,A01,083657,Tran; Khoa Dang,39,0,80,41
1657457273422,CSE 21,A01,095574,Bach; Quang Tran,22,0,48,26
1657457279449,CSE 30,A01,083084,Eldon; John,5,0,80,75
1657457279449,CSE 30,B01,095061,Bhaskar; Nishant,9,0,50,41
1657457285476,CSE 100,A01,083659,Cao; Yingjun,5,4,70,65
1657457291500,CSE 134B,A01,083661,Powell; Thomas Allan,22,0,100,78
1657457297539,CSE 140,A01,083663,Gungor; Onat,15,0,85,70
1657457303565,CSE 140L,A01,083088,Eldon; John,21,0,100,79
1657457309596,CSE 175,A01,083665,Kumar; Rakesh,3,0,25,22
1657457315627,CSE 190,A00,092507,Dubnov; Shlomo,8,0,20,12
1657457321654,ECE 45,A01,083139,Congero; Spencer William,6,0,75,69
1657457327680,ECE 65,A50,083695,Saad; Andrew S,12,0,30,18
1657457327680,ECE 65,A51,095125,Saad; Andrew S,24,0,26,2
1657457333704,ECE 109,A01,091882,Touri; Behrouz,19,0,70,51
1657457339735,ECE 180,A00,083140,Abi Samra; Nicholas Camill,1,0,30,29
1657457339735,ECE 180,B00,083141,Abi Samra; Nicholas Camill,0,0,30,30
1657457345764,MATH 10A,A01,083735,Patchell; Gregory David,2,0,30,28
1657457345764,MATH 10A,A02,083736,Patchell; Gregory David,20,0,30,10
1657457345764,MATH 10A,A03,083737,Patchell; Gregory David,16,0,30,14
1657457351792,MATH 10B,A01,083207,Lim; Seonhee,8,0,34,26
1657457351792,MATH 10B,A02,083208,Lim; Seonhee,9,0,35,26
1657457351792,MATH 10B,A03,093472,Lim; Seonhee,7,0,34,27
1657457351792,MATH 10B,B01,083739,Sinha; Shubham,12,0,30,18
1657457357829,MATH 18,A01,083743,Cinel; Cameron Alexander,7,0,30,23
1657457357829,MATH 18,A02,083744,Cinel; Cameron Alexander,17,0,30,13
1657457357829,MATH 18,A03,083745,Cinel; Cameron Alexander,9,0,30,21
1657457357829,MATH 18,B01,083748,Rideout; David Porter,5,0,37,32
1657457357829,MATH 18,B02,083749,Rideout; David Porter,5,0,36,31
1657457357829,MATH 18,B03,083750,Rideout; David Porter,3,0,37,34
1657457357829,MATH 18,B04,083751,Rideout; David Porter,6,0,36,30
1657457357829,MATH 18,B05,093473,Rideout; David Porter,6,0,36,30
1657457357829,MATH 18,B06,093474,Rideout; David Porter,6,0,36,30
1657457363855,MATH 20A,A01,083754,Zheng; Zequn,14,0,40,26
1657457369891,MATH 20B,A01,083756,Briones; Jor-el Thomas Caparas,4,0,36,32
1657457369891,MATH 20B,A02,083757,Briones; Jor-el Thomas Caparas,1,0,36,35
1657457369891,MATH 20B,A03,093475,Briones; Jor-el Thomas Caparas,2,0,36,34
1657457375920,MATH 20C,A01,083760,Briones; Jor-el Thomas Caparas,1,0,35,34
1657457375920,MATH 20C,A02,083761,Briones; Jor-el Thomas Caparas,8,0,35,27
1657457375920,MATH 20C,A03,093476,Briones; Jor-el Thomas Caparas,0,1,36,36
1657457375920,MATH 20C,B01,083762,Bach; Quang Tran,1,0,30,29
1657457381950,MATH 20D,A01,083765,Tran; Brian Kha,5,0,30,25
1657457381950,MATH 20D,A02,083766,Tran; Brian Kha,5,0,30,25
1657457381950,MATH 20D,A03,083767,Tran; Brian Kha,5,0,30,25
1657457387979,MATH 20E,A01,083771,Ganguly; Soumya,9,0,32,23
1657457387979,MATH 20E,A02,083772,Ganguly; Soumya,6,0,32,26
1657457387979,MATH 20E,B01,083773,Ciotti; Benjamin,20,0,35,15
1657457387979,MATH 20E,B02,083774,Ciotti; Benjamin,17,0,35,18
1657457394004,MATH 103A,A01,083777,Greenfeld; Be'Eri,3,0,36,33
1657457394004,MATH 103A,A02,083778,Greenfeld; Be'Eri,5,0,36,31
1657457394004,MATH 103A,A03,093561,Greenfeld; Be'Eri,5,0,36,31
1657457394004,MATH 103A,B01,083779,Greenfeld; Be'Eri,7,0,36,29
1657457394004,MATH 103A,B02,083780,Greenfeld; Be'Eri,4,0,36,32
1657457394004,MATH 103A,B03,093562,Greenfeld; Be'Eri,3,0,36,33
1657457400031,MATH 105,A01,085443,Carter; Anne Toulson,15,0,35,20
1657457400031,MATH 105,A02,093477,Carter; Anne Toulson,20,0,35,15
1657457406062,MATH 109,A01,083213,Ganzberger; Geoffrey Michael,2,0,34,32
1657457406062,MATH 109,A02,083214,Ganzberger; Geoffrey Michael,4,0,34,30
1657457406062,MATH 109,A03,093478,Ganzberger; Geoffrey Michael,2,0,34,32
1657457406062,MATH 109,B01,083215,Ganzberger; Geoffrey Michael,1,0,32,31
1657457406062,MATH 109,B02,083216,Ganzberger; Geoffrey Michael,2,0,32,30
1657457406062,MATH 109,B03,093479,Ganzberger; Geoffrey Michael,8,0,32,24
1657457412090,MATH 142A,A01,083219,Chow; Bennett,7,0,32,25
1657457412090,MATH 142A,A02,083220,Chow; Bennett,10,0,32,22
1657457412090,MATH 142A,A03,093480,Chow; Bennett,8,0,32,24
1657457412090,MATH 142A,B03,093481,Chow; Bennett,8,0,32,24
1657457412090,MATH 142A,B04,093558,Chow; Bennett,13,0,32,19
1657457412090,MATH 142A,B05,093559,Chow; Bennett,6,0,32,26
1657457418118,MATH 193A,A01,083224,Rotar; Vladimir,8,0,34,26
1657457418118,MATH 193A,A02,083225,Rotar; Vladimir,9,0,34,25
1657457418118,MATH 193A,A03,083781,Rotar; Vladimir,5,0,34,29
1657457418118,MATH 193A,A04,083782,Rotar; Vladimir,10,0,34,24
1657457418118,MATH 193A,A05,093482,Rotar; Vladimir,10,0,34,24
1657457424146,MATH 197,001,091859,McAuley; Julian John,9999,0,9999,0
1657457424146,MATH 197,002,095566,Kedlaya; Kiran S.,9997,0,9999,2
1657457424146,MATH 197,003,095567,Xiao; Ming,9999,0,9999,0
1657457424146,MATH 197,004,095571,Perols; Johan Lars,9998,0,9999,1
1657457431214,COGS 9,A01,083615,Shannon; Kyle Michael,9,0,75,66
1657457437237,COGS 11,A01,083617,Boyle; Mary E. T.,22,0,48,26
1657457443263,COGS 13,A01,083071,Bastos; Amalia Pinkusfeld,11,0,71,60
1657457449290,COGS 14A,A01,092681,Semenuks; Arturs,5,1,100,95
1657457455314,COGS 14B,A01,083073,Cheng; Tzu-Han,6,0,63,57
1657457461339,COGS 17,A01,092677,Semenuks; Arturs,6,0,81,75
1657457467367,COGS 100,A01,083619,Allen; Michael Gordon,17,0,70,53
1657457473390,COGS 101A,A01,083621,Davis; Joshua Daniel,9,0,68,59
1657457479415,COGS 101B,A01,091572,Allen; Michael Gordon,12,0,65,53
1657457485442,COGS 101C,A01,083625,Delgado; Tania,17,0,35,18
1657457491467,COGS 107A,A01,083627,Boyle; Mary E. T.,13,0,60,47
1657457497491,COGS 118A,A01,083075,Gupta; Anjum,21,0,76,55
1657457503517,CSE 3,A50,083646,Miranda; Gregory Joseph,24,0,50,26
1657457509542,CSE 8A,A50,083650,Miranda; Gregory Joseph,17,1,56,39
1657457515575,CSE 11,A01,083080,Cao; Yingjun,6,15,40,34
1657457521600,CSE 12,A01,083652,Krause-Levy; Sophia Louisa,28,1,120,92
1657457527625,CSE 15L,A01,083654,Morris; Justin Loren,9,0,50,41
1657457527625,CSE 15L,A02,083655,Morris; Justin Loren,9,0,50,41
1657457533658,CSE 20,A01,083657,Tran; Khoa Dang,39,0,80,41
1657457539684,CSE 21,A01,095574,Bach; Quang Tran,22,0,48,26
1657457545710,CSE 30,A01,083084,Eldon; John,5,0,80,75
1657457545710,CSE 30,B01,095061,Bhaskar; Nishant,9,0,50,41
1657457551738,CSE 100,A01,083659,Cao; Yingjun,5,4,70,65
1657457557763,CSE 134B,A01,083661,Powell; Thomas Allan,22,0,100,78
1657457563794,CSE 140,A01,083663,Gungor; Onat,15,0,85,70
1657457569820,CSE 140L,A01,083088,Eldon; John,21,0,100,79
1657457575849,CSE 175,A01,083665,Kumar; Rakesh,3,0,25,22
1657457581874,CSE 190,A00,092507,Dubnov; Shlomo,8,0,20,12
1657457587899,ECE 45,A01,083139,Congero; Spencer William,6,0,75,69
1657457593925,ECE 65,A50,083695,Saad; Andrew S,12,0,30,18
1657457593925,ECE 65,A51,095125,Saad; Andrew S,24,0,26,2
1657457599954,ECE 109,A01,091882,Touri; Behrouz,19,0,70,51
1657457605978,ECE 180,A00,083140,Abi Samra; Nicholas Camill,1,0,30,29
1657457605978,ECE 180,B00,083141,Abi Samra; Nicholas Camill,0,0,30,30
1657457612011,MATH 10A,A01,083735,Patchell; Gregory David,2,0,30,28
1657457612011,MATH 10A,A02,083736,Patchell; Gregory David,20,0,30,10
1657457612011,MATH 10A,A03,083737,Patchell; Gregory David,16,0,30,14
1657457618039,MATH 10B,A01,083207,Lim; Seonhee,8,0,34,26
1657457618039,MATH 10B,A02,083208,Lim; Seonhee,9,0,35,26
1657457618039,MATH 10B,A03,093472,Lim; Seonhee,7,0,34,27
1657457618039,MATH 10B,B01,083739,Sinha; Shubham,12,0,30,18
1657457624081,MATH 18,A01,083743,Cinel; Cameron Alexander,7,0,30,23
1657457624081,MATH 18,A02,083744,Cinel; Cameron Alexander,17,0,30,13
1657457624081,MATH 18,A03,083745,Cinel; Cameron Alexander,9,0,30,21
1657457624081,MATH 18,B01,083748,Rideout; David Porter,5,0,37,32
1657457624081,MATH 18,B02,083749,Rideout; David Porter,5,0,36,31
1657457624081,MATH 18,B03,083750,Rideout; David Porter,3,0,37,34
1657457624081,MATH 18,B04,083751,Rideout; David Porter,6,0,36,30
1657457624081,MATH 18,B05,093473,Rideout; David Porter,6,0,36,30
1657457624081,MATH 18,B06,093474,Rideout; David Porter,6,0,36,30
1657457630107,MATH 20A,A01,083754,Zheng; Zequn,14,0,40,26
1657457636132,MATH 20B,A01,083756,Briones; Jor-el Thomas Caparas,4,0,36,32
1657457636132,MATH 20B,A02,083757,Briones; Jor-el Thomas Caparas,1,0,36,35
1657457636132,MATH 20B,A03,093475,Briones; Jor-el Thomas Caparas,2,0,36,34
1657457642158,MATH 20C,A01,083760,Briones; Jor-el Thomas Caparas,1,0,35,34
1657457642158,MATH 20C,A02,083761,Briones; Jor-el Thomas Caparas,8,0,35,27
1657457642158,MATH 20C,A03,093476,Briones; Jor-el Thomas Caparas,0,1,36,36
1657457642158,MATH 20C,B01,083762,Bach; Quang Tran,1,0,30,29
1657457648192,MATH 20D,A01,083765,Tran; Brian Kha,5,0,30,25
1657457648192,MATH 20D,A02,083766,Tran; Brian Kha,5,0,30,25
1657457648192,MATH 20D,A03,083767,Tran; Brian Kha,5,0,30,25
1657457654219,MATH 20E,A01,083771,Ganguly; Soumya,9,0,32,23
1657457654219,MATH 20E,A02,083772,Ganguly; Soumya,6,0,32,26
1657457654219,MATH 20E,B01,083773,Ciotti; Benjamin,20,0,35,15
1657457654219,MATH 20E,B02,083774,Ciotti; Benjamin,17,0,35,18
1657457660246,MATH 103A,A01,083777,Greenfeld; Be'Eri,3,0,36,33
1657457660246,MATH 103A,A02,083778,Greenfeld; Be'Eri,5,0,36,31
1657457660246,MATH 103A,A03,093561,Greenfeld; Be'Eri,5,0,36,31
1657457660246,MATH 103A,B01,083779,Greenfeld; Be'Eri,7,0,36,29
1657457660246,MATH 103A,B02,083780,Greenfeld; Be'Eri,4,0,36,32
1657457660246,MATH 103A,B03,093562,Greenfeld; Be'Eri,3,0,36,33
1657457666297,MATH 105,A01,085443,Carter; Anne Toulson,15,0,35,20
1657457666297,MATH 105,A02,093477,Carter; Anne Toulson,20,0,35,15
1657457672330,MATH 109,A01,083213,Ganzberger; Geoffrey Michael,2,0,34,32
1657457672330,MATH 109,A02,083214,Ganzberger; Geoffrey Michael,4,0,34,30
1657457672330,MATH 109,A03,093478,Ganzberger; Geoffrey Michael,2,0,34,32
1657457672330,MATH 109,B01,083215,Ganzberger; Geoffrey Michael,1,0,32,31
1657457672330,MATH 109,B02,083216,Ganzberger; Geoffrey Michael,2,0,32,30
1657457672330,MATH 109,B03,093479,Ganzberger; Geoffrey Michael,8,0,32,24
1657457678358,MATH 142A,A01,083219,Chow; Bennett,7,0,32,25
1657457678358,MATH 142A,A02,083220,Chow; Bennett,10,0,32,22
1657457678358,MATH 142A,A03,093480,Chow; Bennett,8,0,32,24
1657457678358,MATH 142A,B03,093481,Chow; Bennett,8,0,32,24
1657457678358,MATH 142A,B04,093558,Chow; Bennett,13,0,32,19
1657457678358,MATH 142A,B05,093559,Chow; Bennett,6,0,32,26
1657457684384,MATH 193A,A01,083224,Rotar; Vladimir,8,0,34,26
1657457684384,MATH 193A,A02,083225,Rotar; Vladimir,9,0,34,25
1657457684384,MATH 193A,A03,083781,Rotar; Vladimir,5,0,34,29
1657457684384,MATH 193A,A04,083782,Rotar; Vladimir,10,0,34,24
1657457684384,MATH 193A,A05,093482,Rotar; Vladimir,10,0,34,24
1657457690411,MATH 197,001,091859,McAuley; Julian John,9999,0,9999,0
1657457690411,MATH 197,002,095566,Kedlaya; Kiran S.,9997,0,9999,2
1657457690411,MATH 197,003,095567,Xiao; Ming,9999,0,9999,0
1657457690411,MATH 197,004,095571,Perols; Johan Lars,9998,0,9999,1
1657457697476,COGS 9,A01,083615,Shannon; Kyle Michael,9,0,75,66
1657457703503,COGS 11,A01,083617,Boyle; Mary E. T.,22,0,48,26
1657457709530,COGS 13,A01,083071,Bastos; Amalia Pinkusfeld,11,0,71,60
1657457715555,COGS 14A,A01,092681,Semenuks; Arturs,5,1,100,95
1657457721588,COGS 14B,A01,083073,Cheng; Tzu-Han,6,0,63,57
1657457727684,COGS 17,A01,092677,Semenuks; Arturs,6,0,81,75
1657457733713,COGS 100,A01,083619,Allen; Michael Gordon,17,0,70,53
1657457739742,COGS 101A,A01,083621,Davis; Joshua Daniel,9,0,68,59
1657457745771,COGS 101B,A01,091572,Allen; Michael Gordon,12,0,65,53
1657457751801,COGS 101C,A01,083625,Delgado; Tania,17,0,35,18
1657457757832,COGS 107A,A01,083627,Boyle; Mary E. T.,13,0,60,47
1657457763862,COGS 118A,A01,083075,Gupta; Anjum,21,0,76,55
1657457769902,CSE 3,A50,083646,Miranda; Gregory Joseph,24,0,50,26
1657457775927,CSE 8A,A50,083650,Miranda; Gregory Joseph,17,1,56,39
1657457781956,CSE 11,A01,083080,Cao; Yingjun,6,15,40,34
1657457787988,CSE 12,A01,083652,Krause-Levy; Sophia Louisa,28,1,120,92
1657457794015,CSE 15L,A01,083654,Morris; Justin Loren,9,0,50,41
1657457794015,CSE 15L,A02,083655,Morris; Justin Loren,9,0,50,41
1657457800042,CSE 20,A01,083657,Tran; Khoa Dang,39,0,80,41
1657457806068,CSE 21,A01,095574,Bach; Quang Tran,22,0,48,26
1657457812097,CSE 30,A01,083084,Eldon; John,5,0,80,75
1657457812097,CSE 30,B01,095061,Bhaskar; Nishant,9,0,50,41
1657457818122,CSE 100,A01,083659,Cao; Yingjun,5,4,70,65
1657457824147,CSE 134B,A01,083661,Powell; Thomas Allan,22,0,100,78
1657457830170,CSE 140,A01,083663,Gungor; Onat,15,0,85,70
1657457836195,CSE 140L,A01,083088,Eldon; John,21,0,100,79
1657457842224,CSE 175,A01,083665,Kumar; Rakesh,3,0,25,22
1657457848249,CSE 190,A00,092507,Dubnov; Shlomo,8,0,20,12
1657457854282,ECE 45,A01,083139,Congero; Spencer William,6,0,75,69
1657457860309,ECE 65,A50,083695,Saad; Andrew S,12,0,30,18
1657457860309,ECE 65,A51,095125,Saad; Andrew S,24,0,26,2
1657457866333,ECE 109,A01,091882,Touri; Behrouz,19,0,70,51
1657457872360,ECE 180,A00,083140,Abi Samra; Nicholas Camill,1,0,30,29
1657457872360,ECE 180,B00,083141,Abi Samra; Nicholas Camill,0,0,30,30
1657457878388,MATH 10A,A01,083735,Patchell; Gregory David,2,0,30,28
1657457878388,MATH 10A,A02,083736,Patchell; Gregory David,20,0,30,10
1657457878388,MATH 10A,A03,083737,Patchell; Gregory David,16,0,30,14
1657457884415,MATH 10B,A01,083207,Lim; Seonhee,8,0,34,26
1657457884415,MATH 10B,A02,083208,Lim; Seonhee,9,0,35,26
1657457884415,MATH 10B,A03,093472,Lim; Seonhee,7,0,34,27
1657457884415,MATH 10B,B01,083739,Sinha; Shubham,12,0,30,18
1657457890444,MATH 18,A01,083743,Cinel; Cameron Alexander,7,0,30,23
1657457890444,MATH 18,A02,083744,Cinel; Cameron Alexander,17,0,30,13
1657457890444,MATH 18,A03,083745,Cinel; Cameron Alexander,9,0,30,21
1657457890444,MATH 18,B01,083748,Rideout; David Porter,5,0,37,32
1657457890444,MATH 18,B02,083749,Rideout; David Porter,5,0,36,31
1657457890444,MATH 18,B03,083750,Rideout; David Porter,3,0,37,34
1657457890444,MATH 18,B04,083751,Rideout; David Porter,6,0,36,30
1657457890444,MATH 18,B05,093473,Rideout; David Porter,6,0,36,30
1657457890444,MATH 18,B06,093474,Rideout; David Porter,6,0,36,30
1657457896468,MATH 20A,A01,083754,Zheng; Zequn,14,0,40,26
1657457902495,MATH 20B,A01,083756,Briones; Jor-el Thomas Caparas,4,0,36,32
1657457902495,MATH 20B,A02,083757,Briones; Jor-el Thomas Caparas,1,0,36,35
1657457902495,MATH 20B,A03,093475,Briones; Jor-el Thomas Caparas,2,0,36,34
1657457908528,MATH 20C,A01,083760,Briones; Jor-el Thomas Caparas,1,0,35,34
1657457908528,MATH 20C,A02,083761,Briones; Jor-el Thomas Caparas,8,0,35,27
1657457908528,MATH 20C,A03,093476,Briones; Jor-el Thomas Caparas,0,1,36,36
1657457908528,MATH 20C,B01,083762,Bach; Quang Tran,1,0,30,29
1657457914553,MATH 20D,A01,083765,Tran; Brian Kha,5,0,30,25
1657457914553,MATH 20D,A02,083766,Tran; Brian Kha,5,0,30,25
1657457914553,MATH 20D,A03,083767,Tran; Brian Kha,5,0,30,25
1657457920582,MATH 20E,A01,083771,Ganguly; Soumya,9,0,32,23
1657457920582,MATH 20E,A02,083772,Ganguly; Soumya,6,0,32,26
1657457920582,MATH 20E,B01,083773,Ciotti; Benjamin,20,0,35,15
1657457920582,MATH 20E,B02,083774,Ciotti; Benjamin,17,0,35,18
1657457926616,MATH 103A,A01,083777,Greenfeld; Be'Eri,3,0,36,33
1657457926616,MATH 103A,A02,083778,Greenfeld; Be'Eri,5,0,36,31
1657457926616,MATH 103A,A03,093561,Greenfeld; Be'Eri,5,0,36,31
1657457926616,MATH 103A,B01,083779,Greenfeld; Be'Eri,7,0,36,29
1657457926616,MATH 103A,B02,083780,Greenfeld; Be'Eri,4,0,36,32
1657457926616,MATH 103A,B03,093562,Greenfeld; Be'Eri,3,0,36,33
1657457932641,MATH 105,A01,085443,Carter; Anne Toulson,15,0,35,20
1657457932641,MATH 105,A02,093477,Carter; Anne Toulson,20,0,35,15
1657457938672,MATH 109,A01,083213,Ganzberger; Geoffrey Michael,2,0,34,32
1657457938672,MATH 109,A02,083214,Ganzberger; Geoffrey Michael,4,0,34,30
1657457938672,MATH 109,A03,093478,Ganzberger; Geoffrey Michael,2,0,34,32
1657457938672,MATH 109,B01,083215,Ganzberger; Geoffrey Michael,1,0,32,31
1657457938672,MATH 109,B02,083216,Ganzberger; Geoffrey Michael,2,0,32,30
1657457938672,MATH 109,B03,093479,Ganzberger; Geoffrey Michael,8,0,32,24
1657457944698,MATH 142A,A01,083219,Chow; Bennett,7,0,32,25
1657457944698,MATH 142A,A02,083220,Chow; Bennett,10,0,32,22
1657457944698,MATH 142A,A03,093480,Chow; Bennett,8,0,32,24
1657457944698,MATH 142A,B03,093481,Chow; Bennett,8,0,32,24
1657457944698,MATH 142A,B04,093558,Chow; Bennett,13,0,32,19
1657457944698,MATH 142A,B05,093559,Chow; Bennett,6,0,32,26
1657457950732,MATH 193A,A01,083224,Rotar; Vladimir,8,0,34,26
1657457950732,MATH 193A,A02,083225,Rotar; Vladimir,9,0,34,25
1657457950732,MATH 193A,A03,083781,Rotar; Vladimir,5,0,34,29
1657457950732,MATH 193A,A04,083782,Rotar; Vladimir,10,0,34,24
1657457950732,MATH 193A,A05,093482,Rotar; Vladimir,10,0,34,24
1657457956755,MATH 197,001,091859,McAuley; Julian John,9999,0,9999,0
1657457956755,MATH 197,002,095566,Kedlaya; Kiran S.,9997,0,9999,2
1657457956755,MATH 197,003,095567,Xiao; Ming,9999,0,9999,0
1657457956755,MATH 197,004,095571,Perols; Johan Lars,9998,0,9999,1
1657457963827,COGS 9,A01,083615,Shannon; Kyle Michael,9,0,75,66
1657457969851,COGS 11,A01,083617,Boyle; Mary E. T.,22,0,48,26
1657457975883,COGS 13,A01,083071,Bastos; Amalia Pinkusfeld,11,0,71,60
1657457981915,COGS 14A,A01,092681,Semenuks; Arturs,5,1,100,95
1657457987941,COGS 14B,A01,083073,Cheng; Tzu-Han,6,0,63,57
1657457993967,COGS 17,A01,092677,Semenuks; Arturs,6,0,81,75
1657457999999,COGS 100,A01,083619,Allen; Michael Gordon,17,0,70,53
1657458006033,COGS 101A,A01,083621,Davis; Joshua Daniel,9,0,68,59
1657458012058,COGS 101B,A01,091572,Allen; Michael Gordon,12,0,65,53
1657458018086,COGS 101C,A01,083625,Delgado; Tania,17,0,35,18
1657458024113,COGS 107A,A01,083627,Boyle; Mary E. T.,13,0,60,47
1657458030157,COGS 118A,A01,083075,Gupta; Anjum,21,0,76,55
1657458036183,CSE 3,A50,083646,Miranda; Gregory Joseph,24,0,50,26
1657458042208,CSE 8A,A50,083650,Miranda; Gregory Joseph,17,1,56,39
1657458048233,CSE 11,A01,083080,Cao; Yingjun,6,15,40,34
1657458054259,CSE 12,A01,083652,Krause-Levy; Sophia Louisa,28,1,120,92
1657458060292,CSE 15L,A01,083654,Morris; Justin Loren,9,0,50,41
1657458060292,CSE 15L,A02,083655,Morris; Justin Loren,9,0,50,41
1657458066320,CSE 20,A01,083657,Tran; Khoa Dang,39,0,80,41
1657458072365,CSE 21,A01,095574,Bach; Quang Tran,22,0,48,26
1657458078391,CSE 30,A01,083084,Eldon; John,5,0,80,75
1657458078391,CSE 30,B01,095061,Bhaskar; Nishant,9,0,50,41
1657458084416,CSE 100,A01,083659,Cao; Yingjun,5,4,70,65
1657458090440,CSE 134B,A01,083661,Powell; Thomas Allan,22,0,100,78
1657458096465,CSE 140,A01,083663,Gungor; Onat,15,0,85,70
1657458102489,CSE 140L,A01,083088,Eldon; John,21,0,100,79
1657458108523,CSE 175,A01,083665,Kumar; Rakesh,3,0,25,22
1657458114551,CSE 190,A00,092507,Dubnov; Shlomo,8,0,20,12
1657458120589,ECE 45,A01,083139,Congero; Spencer William,6,0,75,69
1657458126623,ECE 65,A50,083695,Saad; Andrew S,12,0,30,18
1657458126623,ECE 65,A51,095125,Saad; Andrew S,24,0,26,2
1657458132655,ECE 109,A01,091882,Touri; Behrouz,19,0,70,51
1657458138684,ECE 180,A00,083140,Abi Samra; Nicholas Camill,1,0,30,29
1657458138684,ECE 180,B00,083141,Abi Samra; Nicholas Camill,0,0,30,30
1657458144718,MATH 10A,A01,083735,Patchell; Gregory David,2,0,30,28
1657458144718,MATH 10A,A02,083736,Patchell; Gregory David,20,0,30,10
1657458144718,MATH 10A,A03,083737,Patchell; Gregory David,16,0,30,14
1657458150747,MATH 10B,A01,083207,Lim; Seonhee,8,0,34,26
1657458150747,MATH 10B,A02,083208,Lim; Seonhee,9,0,35,26
1657458150747,MATH 10B,A03,093472,Lim; Seonhee,7,0,34,27
1657458150747,MATH 10B,B01,083739,Sinha; Shubham,12,0,30,18
1657458156785,MATH 18,A01,083743,Cinel; Cameron Alexander,7,0,30,23
1657458156785,MATH 18,A02,083744,Cinel; Cameron Alexander,17,0,30,13
1657458156785,MATH 18,A03,083745,Cinel; Cameron Alexander,9,0,30,21
1657458156785,MATH 18,B01,083748,Rideout; David Porter,5,0,37,32
1657458156785,MATH 18,B02,083749,Rideout; David Porter,5,0,36,31
1657458156785,MATH 18,B03,083750,Rideout; David Porter,3,0,37,34
1657458156785,MATH 18,B04,083751,Rideout; David Porter,6,0,36,30
1657458156785,MATH 18,B05,093473,Rideout; David Porter,6,0,36,30
1657458156785,MATH 18,B06,093474,Rideout; David Porter,6,0,36,30
1657458162810,MATH 20A,A01,083754,Zheng; Zequn,14,0,40,26
1657458168839,MATH 20B,A01,083756,Briones; Jor-el Thomas Caparas,4,0,36,32
1657458168839,MATH 20B,A02,083757,Briones; Jor-el Thomas Caparas,1,0,36,35
1657458168839,MATH 20B,A03,093475,Briones; Jor-el Thomas Caparas,2,0,36,34
1657458174873,MATH 20C,A01,083760,Briones; Jor-el Thomas Caparas,1,0,35,34
1657458174873,MATH 20C,A02,083761,Briones; Jor-el Thomas Caparas,8,0,35,27
1657458174873,MATH 20C,A03,093476,Briones; Jor-el Thomas Caparas,0,1,36,36
1657458174873,MATH 20C,B01,083762,Bach; Quang Tran,1,0,30,29
1657458180904,MATH 20D,A01,083765,Tran; Brian Kha,5,0,30,25
1657458180904,MATH 20D,A02,083766,Tran; Brian Kha,5,0,30,25
1657458180904,MATH 20D,A03,083767,Tran; Brian Kha,5,0,30,25
1657458186935,MATH 20E,A01,083771,Ganguly; Soumya,9,0,32,23
1657458186935,MATH 20E,A02,083772,Ganguly; Soumya,6,0,32,26
1657458186935,MATH 20E,B01,083773,Ciotti; Benjamin,20,0,35,15
1657458186935,MATH 20E,B02,083774,Ciotti; Benjamin,17,0,35,18
1657458192971,MATH 103A,A01,083777,Greenfeld; Be'Eri,3,0,36,33
1657458192971,MATH 103A,A02,083778,Greenfeld; Be'Eri,5,0,36,31
1657458192971,MATH 103A,A03,093561,Greenfeld; Be'Eri,5,0,36,31
1657458192971,MATH 103A,B01,083779,Greenfeld; Be'Eri,7,0,36,29
1657458192971,MATH 103A,B02,083780,Greenfeld; Be'Eri,4,0,36,32
1657458192971,MATH 103A,B03,093562,Greenfeld; Be'Eri,3,0,36,33
1657458199003,MATH 105,A01,085443,Carter; Anne Toulson,15,0,35,20
1657458199003,MATH 105,A02,093477,Carter; Anne Toulson,20,0,35,15
1657458205036,MATH 109,A01,083213,Ganzberger; Geoffrey Michael,2,0,34,32
1657458205036,MATH 109,A02,083214,Ganzberger; Geoffrey Michael,4,0,34,30
1657458205036,MATH 109,A03,093478,Ganzberger; Geoffrey Michael,2,0,34,32
1657458205036,MATH 109,B01,083215,Ganzberger; Geoffrey Michael,1,0,32,31
1657458205036,MATH 109,B02,083216,Ganzberger; Geoffrey Michael,2,0,32,30
1657458205036,MATH 109,B03,093479,Ganzberger; Geoffrey Michael,8,0,32,24
1657458211071,MATH 142A,A01,083219,Chow; Bennett,7,0,32,25
1657458211071,MATH 142A,A02,083220,Chow; Bennett,10,0,32,22
1657458211071,MATH 142A,A03,093480,Chow; Bennett,8,0,32,24
1657458211071,MATH 142A,B03,093481,Chow; Bennett,8,0,32,24
1657458211071,MATH 142A,B04,093558,Chow; Bennett,13,0,32,19
1657458211071,MATH 142A,B05,093559,Chow; Bennett,6,0,32,26
1657458217105,MATH 193A,A01,083224,Rotar; Vladimir,8,0,34,26
1657458217105,MATH 193A,A02,083225,Rotar; Vladimir,9,0,34,25
1657458217105,MATH 193A,A03,083781,Rotar; Vladimir,5,0,34,29
1657458217105,MATH 193A,A04,083782,Rotar; Vladimir,10,0,34,24
1657458217105,MATH 193A,A05,093482,Rotar; Vladimir,10,0,34,24
1657458223132,MATH 197,001,091859,McAuley; Julian John,9999,0,9999,0
1657458223132,MATH 197,002,095566,Kedlaya; Kiran S.,9997,0,9999,2
1657458223132,MATH 197,003,095567,Xiao; Ming,9999,0,9999,0
1657458223132,MATH 197,004,095571,Perols; Johan Lars,9998,0,9999,1
1657458230195,COGS 9,A01,083615,Shannon; Kyle Michael,9,0,75,66
1657458236221,COGS 11,A01,083617,Boyle; Mary E. T.,22,0,48,26
1657458242250,COGS 13,A01,083071,Bastos; Amalia Pinkusfeld,11,0,71,60
1657458248280,COGS 14A,A01,092681,Semenuks; Arturs,5,1,100,95
1657458254309,COGS 14B,A01,083073,Cheng; Tzu-Han,6,0,63,57
1657458260340,COGS 17,A01,092677,Semenuks; Arturs,6,0,81,75
1657458266366,COGS 100,A01,083619,Allen; Michael Gordon,17,0,70,53
1657458272392,COGS 101A,A01,083621,Davis; Joshua Daniel,9,0,68,59
1657458278418,COGS 101B,A01,091572,Allen; Michael Gordon,12,0,65,53
1657458284442,COGS 101C,A01,083625,Delgado; Tania,17,0,35,18
1657458290471,COGS 107A,A01,083627,Boyle; Mary E. T.,13,0,60,47
1657458296497,COGS 118A,A01,083075,Gupta; Anjum,21,0,76,55
1657458302552,CSE 3,A50,083646,Miranda; Gregory Joseph,24,0,50,26
1657458308580,CSE 8A,A50,083650,Miranda; Gregory Joseph,17,1,56,39
1657458314609,CSE 11,A01,083080,Cao; Yingjun,6,15,40,34
1657458320635,CSE 12,A01,083652,Krause-Levy; Sophia Louisa,28,1,120,92
1657458326750,CSE 15L,A01,083654,Morris; Justin Loren,9,0,50,41
1657458326750,CSE 15L,A02,083655,Morris; Justin Loren,9,0,50,41
1657458332777,CSE 20,A01,083657,Tran; Khoa Dang,39,0,80,41
1657458338806,CSE 21,A01,095574,Bach; Quang Tran,22,0,48,26
1657458344834,CSE 30,A01,083084,Eldon; John,5,0,80,75
1657458344834,CSE 30,B01,095061,Bhaskar; Nishant,9,0,50,41
1657458350861,CSE 100,A01,083659,Cao; Yingjun,5,4,70,65
1657458356888,CSE 134B,A01,083661,Powell; Thomas Allan,22,0,100,78
1657458362918,CSE 140,A01,083663,Gungor; Onat,15,0,85,70
1657458368944,CSE 140L,A01,083088,Eldon; John,21,0,100,79
1657458374969,CSE 175,A01,083665,Kumar; Rakesh,3,0,25,22
1657458380999,CSE 190,A00,092507,Dubnov; Shlomo,8,0,20,12
1657458387034,ECE 45,A01,083139,Congero; Spencer William,6,0,75,69
1657458393061,ECE 65,A50,083695,Saad; Andrew S,12,0,30,18
1657458393061,ECE 65,A51,095125,Saad; Andrew S,24,0,26,2
1657458399085,ECE 109,A01,091882,Touri; Behrouz,19,0,70,51
1657458405117,ECE 180,A00,083140,Abi Samra; Nicholas Camill,1,0,30,29
1657458405117,ECE 180,B00,083141,Abi Samra; Nicholas Camill,0,0,30,30
1657458411144,MATH 10A,A01,083735,Patchell; Gregory David,2,0,30,28
1657458411144,MATH 10A,A02,083736,Patchell; Gregory David,20,0,30,10
1657458411144,MATH 10A,A03,083737,Patchell; Gregory David,16,0,30,14
1657458417173,MATH 10B,A01,083207,Lim; Seonhee,8,0,34,26
1657458417173,MATH 10B,A02,083208,Lim; Seonhee,9,0,35,26
1657458417173,MATH 10B,A03,093472,Lim; Seonhee,7,0,34,27
1657458417173,MATH 10B,B01,083739,Sinha; Shubham,12,0,30,18
1657458423200,MATH 18,A01,083743,Cinel; Cameron Alexander,7,0,30,23
1657458423200,MATH 18,A02,083744,Cinel; Cameron Alexander,17,0,30,13
1657458423200,MATH 18,A03,083745,Cinel; Cameron Alexander,9,0,30,21
1657458423200,MATH 18,B01,083748,Rideout; David Porter,5,0,37,32
1657458423200,MATH 18,B02,083749,Rideout; David Porter,5,0,36,31
1657458423200,MATH 18,B03,083750,Rideout; David Porter,3,0,37,34
1657458423200,MATH 18,B04,083751,Rideout; David Porter,6,0,36,30
1657458423200,MATH 18,B05,093473,Rideout; David Porter,6,0,36,30
1657458423200,MATH 18,B06,093474,Rideout; David Porter,6,0,36,30
1657458429229,MATH 20A,A01,083754,Zheng; Zequn,14,0,40,26
1657458435255,MATH 20B,A01,083756,Briones; Jor-el Thomas Caparas,4,0,36,32
1657458435255,MATH 20B,A02,083757,Briones; Jor-el Thomas Caparas,1,0,36,35
1657458435255,MATH 20B,A03,093475,Briones; Jor-el Thomas Caparas,2,0,36,34
1657458441279,MATH 20C,A01,083760,Briones; Jor-el Thomas Caparas,1,0,35,34
1657458441279,MATH 20C,A02,083761,Briones; Jor-el Thomas Caparas,8,0,35,27
1657458441279,MATH 20C,A03,093476,Briones; Jor-el Thomas Caparas,0,1,36,36
1657458441279,MATH 20C,B01,083762,Bach; Quang Tran,1,0,30,29
1657458447310,MATH 20D,A01,083765,Tran; Brian Kha,5,0,30,25
1657458447310,MATH 20D,A02,083766,Tran; Brian Kha,5,0,30,25
1657458447310,MATH 20D,A03,083767,Tran; Brian Kha,5,0,30,25
1657458453338,MATH 20E,A01,083771,Ganguly; Soumya,9,0,32,23
1657458453338,MATH 20E,A02,083772,Ganguly; Soumya,6,0,32,26
1657458453338,MATH 20E,B01,083773,Ciotti; Benjamin,20,0,35,15
1657458453338,MATH 20E,B02,083774,Ciotti; Benjamin,17,0,35,18
1657458459372,MATH 103A,A01,083777,Greenfeld; Be'Eri,3,0,36,33
1657458459372,MATH 103A,A02,083778,Greenfeld; Be'Eri,5,0,36,31
1657458459372,MATH 103A,A03,093561,Greenfeld; Be'Eri,5,0,36,31
1657458459372,MATH 103A,B01,083779,Greenfeld; Be'Eri,7,0,36,29
1657458459372,MATH 103A,B02,083780,Greenfeld; Be'Eri,4,0,36,32
1657458459372,MATH 103A,B03,093562,Greenfeld; Be'Eri,3,0,36,33
1657458465402,MATH 105,A01,085443,Carter; Anne Toulson,15,0,35,20
1657458465402,MATH 105,A02,093477,Carter; Anne Toulson,20,0,35,15
1657458471437,MATH 109,A01,083213,Ganzberger; Geoffrey Michael,2,0,34,32
1657458471437,MATH 109,A02,083214,Ganzberger; Geoffrey Michael,4,0,34,30
1657458471437,MATH 109,A03,093478,Ganzberger; Geoffrey Michael,2,0,34,32
1657458471437,MATH 109,B01,083215,Ganzberger; Geoffrey Michael,1,0,32,31
1657458471437,MATH 109,B02,083216,Ganzberger; Geoffrey Michael,2,0,32,30
1657458471437,MATH 109,B03,093479,Ganzberger; Geoffrey Michael,8,0,32,24
1657458477472,MATH 142A,A01,083219,Chow; Bennett,7,0,32,25
1657458477472,MATH 142A,A02,083220,Chow; Bennett,10,0,32,22
1657458477472,MATH 142A,A03,093480,Chow; Bennett,8,0,32,24
1657458477472,MATH 142A,B03,093481,Chow; Bennett,8,0,32,24
1657458477472,MATH 142A,B04,093558,Chow; Bennett,13,0,32,19
1657458477472,MATH 142A,B05,093559,Chow; Bennett,6,0,32,26
1657458483507,MATH 193A,A01,083224,Rotar; Vladimir,8,0,34,26
1657458483507,MATH 193A,A02,083225,Rotar; Vladimir,9,0,34,25
1657458483507,MATH 193A,A03,083781,Rotar; Vladimir,5,0,34,29
1657458483507,MATH 193A,A04,083782,Rotar; Vladimir,10,0,34,24
1657458483507,MATH 193A,A05,093482,Rotar; Vladimir,10,0,34,24
1657458489537,MATH 197,001,091859,McAuley; Julian John,9999,0,9999,0
1657458489537,MATH 197,002,095566,Kedlaya; Kiran S.,9997,0,9999,2
1657458489537,MATH 197,003,095567,Xiao; Ming,9999,0,9999,0
1657458489537,MATH 197,004,095571,Perols; Johan Lars,9998,0,9999,1
1657458496610,COGS 9,A01,083615,Shannon; Kyle Michael,9,0,75,66
1657458502633,COGS 11,A01,083617,Boyle; Mary E. T.,22,0,48,26
1657458508658,COGS 13,A01,083071,Bastos; Amalia Pinkusfeld,11,0,71,60
1657458514699,COGS 14A,A01,092681,Semenuks; Arturs,5,1,100,95
1657458520728,COGS 14B,A01,083073,Cheng; Tzu-Han,6,0,63,57
1657458526762,COGS 17,A01,092677,Semenuks; Arturs,6,0,81,75
1657458532798,COGS 100,A01,083619,Allen; Michael Gordon,17,0,70,53
1657458538829,COGS 101A,A01,083621,Davis; Joshua Daniel,9,0,68,59
1657458544853,COGS 101B,A01,091572,Allen; Michael Gordon,12,0,65,53
1657458550878,COGS 101C,A01,083625,Delgado; Tania,17,0,35,18
1657458556906,COGS 107A,A01,083627,Boyle; Mary E. T.,13,0,60,47
1657458562930,COGS 118A,A01,083075,Gupta; Anjum,21,0,76,55
1657458568960,CSE 3,A50,083646,Miranda; Gregory Joseph,24,0,50,26
1657458574997,CSE 8A,A50,083650,Miranda; Gregory Joseph,17,1,56,39
1657458581028,CSE 11,A01,083080,Cao; Yingjun,6,15,40,34
1657458587055,CSE 12,A01,083652,Krause-Levy; Sophia Louisa,28,1,120,92
1657458593080,CSE 15L,A01,083654,Morris; Justin Loren,9,0,50,41
1657458593080,CSE 15L,A02,083655,Morris; Justin Loren,9,0,50,41
1657458599118,CSE 20,A01,083657,Tran; Khoa Dang,39,0,80,41
1657458605144,CSE 21,A01,095574,Bach; Quang Tran,22,0,48,26
1657458611178,CSE 30,A01,083084,Eldon; John,5,0,80,75
1657458611178,CSE 30,B01,095061,Bhaskar; Nishant,9,0,50,41
1657458617212,CSE 100,A01,083659,Cao; Yingjun,5,4,70,65
1657458623240,CSE 134B,A01,083661,Powell; Thomas Allan,22,0,100,78
1657458629275,CSE 140,A01,083663,Gungor; Onat,15,0,85,70
1657458635301,CSE 140L,A01,083088,Eldon; John,21,0,100,79
1657458641327,CSE 175,A01,083665,Kumar; Rakesh,3,0,25,22
1657458647355,CSE 190,A00,092507,Dubnov; Shlomo,8,0,20,12
1657458653381,ECE 45,A01,083139,Congero; Spencer William,6,0,75,69
1657458659410,ECE 65,A50,083695,Saad; Andrew S,12,0,30,18
1657458659410,ECE 65,A51,095125,Saad; Andrew S,24,0,26,2
1657458665436,ECE 109,A01,091882,Touri; Behrouz,19,0,70,51
1657458671474,ECE 180,A00,083140,Abi Samra; Nicholas Camill,1,0,30,29
1657458671474,ECE 180,B00,083141,Abi Samra; Nicholas Camill,0,0,30,30
1657458677507,MATH 10A,A01,083735,Patchell; Gregory David,2,0,30,28
1657458677507,MATH 10A,A02,083736,Patchell; Gregory David,20,0,30,10
1657458677507,MATH 10A,A03,083737,Patchell; Gregory David,16,0,30,14
1657458683537,MATH 10B,A01,083207,Lim; Seonhee,8,0,34,26
1657458683537,MATH 10B,A02,083208,Lim; Seonhee,9,0,35,26
1657458683537,MATH 10B,A03,093472,Lim; Seonhee,7,0,34,27
1657458683537,MATH 10B,B01,083739,Sinha; Shubham,12,0,30,18
1657458689563,MATH 18,A01,083743,Cinel; Cameron Alexander,7,0,30,23
1657458689563,MATH 18,A02,083744,Cinel; Cameron Alexander,17,0,30,13
1657458689563,MATH 18,A03,083745,Cinel; Cameron Alexander,9,0,30,21
1657458689563,MATH 18,B01,083748,Rideout; David Porter,5,0,37,32
1657458689563,MATH 18,B02,083749,Rideout; David Porter,5,0,36,31
1657458689563,MATH 18,B03,083750,Rideout; David Porter,3,0,37,34
1657458689563,MATH 18,B04,083751,Rideout; David Porter,6,0,36,30
1657458689563,MATH 18,B05,093473,Rideout; David Porter,6,0,36,30
1657458689563,MATH 18,B06,093474,Rideout; David Porter,6,0,36,30
1657458695589,MATH 20A,A01,083754,Zheng; Zequn,14,0,40,26
1657458701623,MATH 20B,A01,083756,Briones; Jor-el Thomas Caparas,4,0,36,32
1657458701623,MATH 20B,A02,083757,Briones; Jor-el Thomas Caparas,1,0,36,35
1657458701623,MATH 20B,A03,093475,Briones; Jor-el Thomas Caparas,2,0,36,34
1657458708170,MATH 20C,A01,083760,Briones; Jor-el Thomas Caparas,1,0,35,34
1657458708170,MATH 20C,A02,083761,Briones; Jor-el Thomas Caparas,8,0,35,27
1657458708170,MATH 20C,A03,093476,Briones; Jor-el Thomas Caparas,0,1,36,36
1657458708170,MATH 20C,B01,083762,Bach; Quang Tran,1,0,30,29
1657458714201,MATH 20D,A01,083765,Tran; Brian Kha,5,0,30,25
1657458714201,MATH 20D,A02,083766,Tran; Brian Kha,5,0,30,25
1657458714201,MATH 20D,A03,083767,Tran; Brian Kha,5,0,30,25
1657458720236,MATH 20E,A01,083771,Ganguly; Soumya,9,0,32,23
1657458720236,MATH 20E,A02,083772,Ganguly; Soumya,6,0,32,26
1657458720236,MATH 20E,B01,083773,Ciotti; Benjamin,20,0,35,15
1657458720236,MATH 20E,B02,083774,Ciotti; Benjamin,17,0,35,18
1657458726267,MATH 103A,A01,083777,Greenfeld; Be'Eri,3,0,36,33
1657458726267,MATH 103A,A02,083778,Greenfeld; Be'Eri,5,0,36,31
1657458726267,MATH 103A,A03,093561,Greenfeld; Be'Eri,5,0,36,31
1657458726267,MATH 103A,B01,083779,Greenfeld; Be'Eri,7,0,36,29
1657458726267,MATH 103A,B02,083780,Greenfeld; Be'Eri,4,0,36,32
1657458726267,MATH 103A,B03,093562,Greenfeld; Be'Eri,3,0,36,33
1657458732295,MATH 105,A01,085443,Carter; Anne Toulson,15,0,35,20
1657458732295,MATH 105,A02,093477,Carter; Anne Toulson,20,0,35,15
1657458738329,MATH 109,A01,083213,Ganzberger; Geoffrey Michael,2,0,34,32
1657458738329,MATH 109,A02,083214,Ganzberger; Geoffrey Michael,4,0,34,30
1657458738329,MATH 109,A03,093478,Ganzberger; Geoffrey Michael,2,0,34,32
1657458738329,MATH 109,B01,083215,Ganzberger; Geoffrey Michael,1,0,32,31
1657458738329,MATH 109,B02,083216,Ganzberger; Geoffrey Michael,2,0,32,30
1657458738329,MATH 109,B03,093479,Ganzberger; Geoffrey Michael,8,0,32,24
1657458744369,MATH 142A,A01,083219,Chow; Bennett,7,0,32,25
1657458744369,MATH 142A,A02,083220,Chow; Bennett,10,0,32,22
1657458744369,MATH 142A,A03,093480,Chow; Bennett,8,0,32,24
1657458744369,MATH 142A,B03,093481,Chow; Bennett,8,0,32,24
1657458744369,MATH 142A,B04,093558,Chow; Bennett,13,0,32,19
1657458744369,MATH 142A,B05,093559,Chow; Bennett,6,0,32,26
1657458750403,MATH 193A,A01,083224,Rotar; Vladimir,8,0,34,26
1657458750403,MATH 193A,A02,083225,Rotar; Vladimir,9,0,34,25
1657458750403,MATH 193A,A03,083781,Rotar; Vladimir,5,0,34,29
1657458750403,MATH 193A,A04,083782,Rotar; Vladimir,10,0,34,24
1657458750403,MATH 193A,A05,093482,Rotar; Vladimir,10,0,34,24
1657458756429,MATH 197,001,091859,McAuley; Julian John,9999,0,9999,0
1657458756429,MATH 197,002,095566,Kedlaya; Kiran S.,9997,0,9999,2
1657458756429,MATH 197,003,095567,Xiao; Ming,9999,0,9999,0
1657458756429,MATH 197,004,095571,Perols; Johan Lars,9998,0,9999,1
1657458763498,COGS 9,A01,083615,Shannon; Kyle Michael,9,0,75,66
1657458769524,COGS 11,A01,083617,Boyle; Mary E. T.,22,0,48,26
1657458775551,COGS 13,A01,083071,Bastos; Amalia Pinkusfeld,11,0,71,60
1657458781578,COGS 14A,A01,092681,Semenuks; Arturs,5,1,100,95
1657458787608,COGS 14B,A01,083073,Cheng; Tzu-Han,6,0,63,57
1657458793631,COGS 17,A01,092677,Semenuks; Arturs,6,0,81,75
1657458799656,COGS 100,A01,083619,Allen; Michael Gordon,17,0,70,53
1657458805681,COGS 101A,A01,083621,Davis; Joshua Daniel,9,0,68,59
1657458811712,COGS 101B,A01,091572,Allen; Michael Gordon,12,0,65,53
1657458817744,COGS 101C,A01,083625,Delgado; Tania,17,0,35,18
1657458823771,COGS 107A,A01,083627,Boyle; Mary E. T.,13,0,60,47
1657458829798,COGS 118A,A01,083075,Gupta; Anjum,21,0,76,55
1657458835824,CSE 3,A50,083646,Miranda; Gregory Joseph,24,0,50,26
1657458841852,CSE 8A,A50,083650,Miranda; Gregory Joseph,17,1,56,39
1657458847878,CSE 11,A01,083080,Cao; Yingjun,6,15,40,34
1657458853902,CSE 12,A01,083652,Krause-Levy; Sophia Louisa,28,1,120,92
1657458859925,CSE 15L,A01,083654,Morris; Justin Loren,9,0,50,41
1657458859925,CSE 15L,A02,083655,Morris; Justin Loren,9,0,50,41
1657458865952,CSE 20,A01,083657,Tran; Khoa Dang,39,0,80,41
1657458871976,CSE 21,A01,095574,Bach; Quang Tran,22,0,48,26
1657458878007,CSE 30,A01,083084,Eldon; John,5,0,80,75
1657458878007,CSE 30,B01,095061,Bhaskar; Nishant,9,0,50,41
1657458884034,CSE 100,A01,083659,Cao; Yingjun,5,4,70,65
1657458890061,CSE 134B,A01,083661,Powell; Thomas Allan,22,0,100,78
1657458896088,CSE 140,A01,083663,Gungor; Onat,15,0,85,70
1657458902114,CSE 140L,A01,083088,Eldon; John,21,0,100,79
1657458908145,CSE 175,A01,083665,Kumar; Rakesh,3,0,25,22
1657458914169,CSE 190,A00,092507,Dubnov; Shlomo,8,0,20,12
1657458920194,ECE 45,A01,083139,Congero; Spencer William,6,0,75,69
1657458926297,ECE 65,A50,083695,Saad; Andrew S,12,0,30,18
1657458926297,ECE 65,A51,095125,Saad; Andrew S,24,0,26,2
1657458932335,ECE 109,A01,091882,Touri; Behrouz,19,0,70,51
1657458938365,ECE 180,A00,083140,Abi Samra; Nicholas Camill,1,0,30,29
1657458938365,ECE 180,B00,083141,Abi Samra; Nicholas Camill,0,0,30,30
1657458944398,MATH 10A,A01,083735,Patchell; Gregory David,2,0,30,28
1657458944398,MATH 10A,A02,083736,Patchell; Gregory David,20,0,30,10
1657458944398,MATH 10A,A03,083737,Patchell; Gregory David,16,0,30,14
1657458950449,MATH 10B,A01,083207,Lim; Seonhee,8,0,34,26
1657458950449,MATH 10B,A02,083208,Lim; Seonhee,9,0,35,26
1657458950449,MATH 10B,A03,093472,Lim; Seonhee,7,0,34,27
1657458950449,MATH 10B,B01,083739,Sinha; Shubham,12,0,30,18
1657458956486,MATH 18,A01,083743,Cinel; Cameron Alexander,7,0,30,23
1657458956486,MATH 18,A02,083744,Cinel; Cameron Alexander,17,0,30,13
1657458956486,MATH 18,A03,083745,Cinel; Cameron Alexander,9,0,30,21
1657458956486,MATH 18,B01,083748,Rideout; David Porter,5,0,37,32
1657458956486,MATH 18,B02,083749,Rideout; David Porter,5,0,36,31
1657458956486,MATH 18,B03,083750,Rideout; David Porter,3,0,37,34
1657458956486,MATH 18,B04,083751,Rideout; David Porter,6,0,36,30
1657458956486,MATH 18,B05,093473,Rideout; David Porter,6,0,36,30
1657458956486,MATH 18,B06,093474,Rideout; David Porter,6,0,36,30
1657458962516,MATH 20A,A01,083754,Zheng; Zequn,14,0,40,26
1657458968541,MATH 20B,A01,083756,Briones; Jor-el Thomas Caparas,4,0,36,32
1657458968541,MATH 20B,A02,083757,Briones; Jor-el Thomas Caparas,1,0,36,35
1657458968541,MATH 20B,A03,093475,Briones; Jor-el Thomas Caparas,2,0,36,34
1657458974569,MATH 20C,A01,083760,Briones; Jor-el Thomas Caparas,1,0,35,34
1657458974569,MATH 20C,A02,083761,Briones; Jor-el Thomas Caparas,8,0,35,27
1657458974569,MATH 20C,A03,093476,Briones; Jor-el Thomas Caparas,0,1,36,36
1657458974569,MATH 20C,B01,083762,Bach; Quang Tran,1,0,30,29
1657458980605,MATH 20D,A01,083765,Tran; Brian Kha,5,0,30,25
1657458980605,MATH 20D,A02,083766,Tran; Brian Kha,5,0,30,25
1657458980605,MATH 20D,A03,083767,Tran; Brian Kha,5,0,30,25
1657458986632,MATH 20E,A01,083771,Ganguly; Soumya,9,0,32,23
1657458986632,MATH 20E,A02,083772,Ganguly; Soumya,6,0,32,26
1657458986632,MATH 20E,B01,083773,Ciotti; Benjamin,20,0,35,15
1657458986632,MATH 20E,B02,083774,Ciotti; Benjamin,17,0,35,18
1657458992658,MATH 103A,A01,083777,Greenfeld; Be'Eri,3,0,36,33
1657458992658,MATH 103A,A02,083778,Greenfeld; Be'Eri,5,0,36,31
1657458992658,MATH 103A,A03,093561,Greenfeld; Be'Eri,5,0,36,31
1657458992658,MATH 103A,B01,083779,Greenfeld; Be'Eri,7,0,36,29
1657458992658,MATH 103A,B02,083780,Greenfeld; Be'Eri,4,0,36,32
1657458992658,MATH 103A,B03,093562,Greenfeld; Be'Eri,3,0,36,33
1657458998684,MATH 105,A01,085443,Carter; Anne Toulson,15,0,35,20
1657458998684,MATH 105,A02,093477,Carter; Anne Toulson,20,0,35,15
1657459004718,MATH 109,A01,083213,Ganzberger; Geoffrey Michael,2,0,34,32
1657459004718,MATH 109,A02,083214,Ganzberger; Geoffrey Michael,4,0,34,30
1657459004718,MATH 109,A03,093478,Ganzberger; Geoffrey Michael,2,0,34,32
1657459004718,MATH 109,B01,083215,Ganzberger; Geoffrey Michael,1,0,32,31
1657459004718,MATH 109,B02,083216,Ganzberger; Geoffrey Michael,2,0,32,30
1657459004718,MATH 109,B03,093479,Ganzberger; Geoffrey Michael,8,0,32,24
1657459010745,MATH 142A,A01,083219,Chow; Bennett,7,0,32,25
1657459010745,MATH 142A,A02,083220,Chow; Bennett,10,0,32,22
1657459010745,MATH 142A,A03,093480,Chow; Bennett,8,0,32,24
1657459010745,MATH 142A,B03,093481,Chow; Bennett,8,0,32,24
1657459010745,MATH 142A,B04,093558,Chow; Bennett,13,0,32,19
1657459010745,MATH 142A,B05,093559,Chow; Bennett,6,0,32,26
1657459016772,MATH 193A,A01,083224,Rotar; Vladimir,8,0,34,26
1657459016772,MATH 193A,A02,083225,Rotar; Vladimir,9,0,34,25
1657459016772,MATH 193A,A03,083781,Rotar; Vladimir,5,0,34,29
1657459016772,MATH 193A,A04,083782,Rotar; Vladimir,10,0,34,24
1657459016772,MATH 193A,A05,093482,Rotar; Vladimir,10,0,34,24
1657459022798,MATH 197,001,091859,McAuley; Julian John,9999,0,9999,0
1657459022798,MATH 197,002,095566,Kedlaya; Kiran S.,9997,0,9999,2
1657459022798,MATH 197,003,095567,Xiao; Ming,9999,0,9999,0
1657459022798,MATH 197,004,095571,Perols; Johan Lars,9998,0,9999,1
1657459029882,COGS 9,A01,083615,Shannon; Kyle Michael,9,0,75,66
1657459035907,COGS 11,A01,083617,Boyle; Mary E. T.,22,0,48,26
1657459041941,COGS 13,A01,083071,Bastos; Amalia Pinkusfeld,11,0,71,60
1657459047973,COGS 14A,A01,092681,Semenuks; Arturs,5,1,100,95
1657459054008,COGS 14B,A01,083073,Cheng; Tzu-Han,6,0,63,57
1657459060038,COGS 17,A01,092677,Semenuks; Arturs,6,0,81,75
1657459066071,COGS 100,A01,083619,Allen; Michael Gordon,17,0,70,53
1657459072106,COGS 101A,A01,083621,Davis; Joshua Daniel,9,0,68,59
1657459078132,COGS 101B,A01,091572,Allen; Michael Gordon,12,0,65,53
1657459084157,COGS 101C,A01,083625,Delgado; Tania,17,0,35,18
1657459090187,COGS 107A,A01,083627,Boyle; Mary E. T.,13,0,60,47
1657459096222,COGS 118A,A01,083075,Gupta; Anjum,21,0,76,55
1657459102261,CSE 3,A50,083646,Miranda; Gregory Joseph,24,0,50,26
1657459108291,CSE 8A,A50,083650,Miranda; Gregory Joseph,17,1,56,39
1657459114324,CSE 11,A01,083080,Cao; Yingjun,6,15,40,34
1657459120353,CSE 12,A01,083652,Krause-Levy; Sophia Louisa,28,1,120,92
1657459126377,CSE 15L,A01,083654,Morris; Justin Loren,9,0,50,41
1657459126377,CSE 15L,A02,083655,Morris; Justin Loren,9,0,50,41
1657459132403,CSE 20,A01,083657,Tran; Khoa Dang,39,0,80,41
1657459138439,CSE 21,A01,095574,Bach; Quang Tran,22,0,48,26
1657459144467,CSE 30,A01,083084,Eldon; John,5,0,80,75
1657459144467,CSE 30,B01,095061,Bhaskar; Nishant,9,0,50,41
1657459150491,CSE 100,A01,083659,Cao; Yingjun,5,4,70,65
1657459156521,CSE 134B,A01,083661,Powell; Thomas Allan,22,0,100,78
1657459162549,CSE 140,A01,083663,Gungor; Onat,15,0,85,70
1657459168574,CSE 140L,A01,083088,Eldon; John,21,0,100,79
1657459174604,CSE 175,A01,083665,Kumar; Rakesh,3,0,25,22
1657459180632,CSE 190,A00,092507,Dubnov; Shlomo,8,0,20,12
1657459186659,ECE 45,A01,083139,Congero; Spencer William,6,0,75,69
1657459192698,ECE 65,A50,083695,Saad; Andrew S,12,0,30,18
1657459192698,ECE 65,A51,095125,Saad; Andrew S,24,0,26,2
1657459198722,ECE 109,A01,091882,Touri; Behrouz,19,0,70,51
1657459204748,ECE 180,A00,083140,Abi Samra; Nicholas Camill,1,0,30,29
1657459204748,ECE 180,B00,083141,Abi Samra; Nicholas Camill,0,0,30,30
1657459210782,MATH 10A,A01,083735,Patchell; Gregory David,2,0,30,28
1657459210782,MATH 10A,A02,083736,Patchell; Gregory David,20,0,30,10
1657459210782,MATH 10A,A03,083737,Patchell; Gregory David,16,0,30,14
1657459216811,MATH 10B,A01,083207,Lim; Seonhee,8,0,34,26
1657459216811,MATH 10B,A02,083208,Lim; Seonhee,9,0,35,26
1657459216811,MATH 10B,A03,093472,Lim; Seonhee,7,0,34,27
1657459216811,MATH 10B,B01,083739,Sinha; Shubham,12,0,30,18
1657459222838,MATH 18,A01,083743,Cinel; Cameron Alexander,7,0,30,23
1657459222838,MATH 18,A02,083744,Cinel; Cameron Alexander,17,0,30,13
1657459222838,MATH 18,A03,083745,Cinel; Cameron Alexander,9,0,30,21
1657459222838,MATH 18,B01,083748,Rideout; David Porter,5,0,37,32
1657459222838,MATH 18,B02,083749,Rideout; David Porter,5,0,36,31
1657459222838,MATH 18,B03,083750,Rideout; David Porter,3,0,37,34
1657459222838,MATH 18,B04,083751,Rideout; David Porter,6,0,36,30
1657459222838,MATH 18,B05,093473,Rideout; David Porter,6,0,36,30
1657459222838,MATH 18,B06,093474,Rideout; David Porter,6,0,36,30
1657459228867,MATH 20A,A01,083754,Zheng; Zequn,14,0,40,26
1657459234896,MATH 20B,A01,083756,Briones; Jor-el Thomas Caparas,4,0,36,32
1657459234896,MATH 20B,A02,083757,Briones; Jor-el Thomas Caparas,1,0,36,35
1657459234896,MATH 20B,A03,093475,Briones; Jor-el Thomas Caparas,2,0,36,34
1657459240924,MATH 20C,A01,083760,Briones; Jor-el Thomas Caparas,1,0,35,34
1657459240924,MATH 20C,A02,083761,Briones; Jor-el Thomas Caparas,8,0,35,27
1657459240924,MATH 20C,A03,093476,Briones; Jor-el Thomas Caparas,0,1,36,36
1657459240924,MATH 20C,B01,083762,Bach; Quang Tran,1,0,30,29
1657459246955,MATH 20D,A01,083765,Tran; Brian Kha,5,0,30,25
1657459246955,MATH 20D,A02,083766,Tran; Brian Kha,5,0,30,25
1657459246955,MATH 20D,A03,083767,Tran; Brian Kha,5,0,30,25
1657459252983,MATH 20E,A01,083771,Ganguly; Soumya,9,0,32,23
1657459252983,MATH 20E,A02,083772,Ganguly; Soumya,6,0,32,26
1657459252983,MATH 20E,B01,083773,Ciotti; Benjamin,20,0,35,15
1657459252983,MATH 20E,B02,083774,Ciotti; Benjamin,17,0,35,18
1657459259013,MATH 103A,A01,083777,Greenfeld; Be'Eri,3,0,36,33
1657459259013,MATH 103A,A02,083778,Greenfeld; Be'Eri,5,0,36,31
1657459259013,MATH 103A,A03,093561,Greenfeld; Be'Eri,5,0,36,31
1657459259013,MATH 103A,B01,083779,Greenfeld; Be'Eri,7,0,36,29
1657459259013,MATH 103A,B02,083780,Greenfeld; Be'Eri,4,0,36,32
1657459259013,MATH 103A,B03,093562,Greenfeld; Be'Eri,3,0,36,33
1657459265042,MATH 105,A01,085443,Carter; Anne Toulson,15,0,35,20
1657459265042,MATH 105,A02,093477,Carter; Anne Toulson,20,0,35,15
1657459271066,MATH 109,A01,083213,Ganzberger; Geoffrey Michael,2,0,34,32
1657459271066,MATH 109,A02,083214,Ganzberger; Geoffrey Michael,4,0,34,30
1657459271066,MATH 109,A03,093478,Ganzberger; Geoffrey Michael,2,0,34,32
1657459271066,MATH 109,B01,083215,Ganzberger; Geoffrey Michael,1,0,32,31
1657459271066,MATH 109,B02,083216,Ganzberger; Geoffrey Michael,2,0,32,30
1657459271066,MATH 109,B03,093479,Ganzberger; Geoffrey Michael,8,0,32,24
1657459277104,MATH 142A,A01,083219,Chow; Bennett,7,0,32,25
1657459277104,MATH 142A,A02,083220,Chow; Bennett,10,0,32,22
1657459277104,MATH 142A,A03,093480,Chow; Bennett,8,0,32,24
1657459277104,MATH 142A,B03,093481,Chow; Bennett,8,0,32,24
1657459277104,MATH 142A,B04,093558,Chow; Bennett,13,0,32,19
1657459277104,MATH 142A,B05,093559,Chow; Bennett,6,0,32,26
1657459283132,MATH 193A,A01,083224,Rotar; Vladimir,8,0,34,26
1657459283132,MATH 193A,A02,083225,Rotar; Vladimir,9,0,34,25
1657459283132,MATH 193A,A03,083781,Rotar; Vladimir,5,0,34,29
1657459283132,MATH 193A,A04,083782,Rotar; Vladimir,10,0,34,24
1657459283132,MATH 193A,A05,093482,Rotar; Vladimir,10,0,34,24
1657459289159,MATH 197,001,091859,McAuley; Julian John,9999,0,9999,0
1657459289159,MATH 197,002,095566,Kedlaya; Kiran S.,9997,0,9999,2
1657459289159,MATH 197,003,095567,Xiao; Ming,9999,0,9999,0
1657459289159,MATH 197,004,095571,Perols; Johan Lars,9998,0,9999,1
1657459296235,COGS 9,A01,083615,Shannon; Kyle Michael,9,0,75,66
1657459302261,COGS 11,A01,083617,Boyle; Mary E. T.,22,0,48,26
1657459308292,COGS 13,A01,083071,Bastos; Amalia Pinkusfeld,11,0,71,60
1657459314318,COGS 14A,A01,092681,Semenuks; Arturs,5,1,100,95
1657459320358,COGS 14B,A01,083073,Cheng; Tzu-Han,6,0,63,57
1657459326385,COGS 17,A01,092677,Semenuks; Arturs,6,0,81,75
1657459332411,COGS 100,A01,083619,Allen; Michael Gordon,17,0,70,53
1657459338437,COGS 101A,A01,083621,Davis; Joshua Daniel,9,0,68,59
1657459344467,COGS 101B,A01,091572,Allen; Michael Gordon,12,0,65,53
1657459350492,COGS 101C,A01,083625,Delgado; Tania,17,0,35,18
1657459356519,COGS 107A,A01,083627,Boyle; Mary E. T.,13,0,60,47
1657459362543,COGS 118A,A01,083075,Gupta; Anjum,21,0,76,55
1657459368571,CSE 3,A50,083646,Miranda; Gregory Joseph,24,0,50,26
1657459374601,CSE 8A,A50,083650,Miranda; Gregory Joseph,17,1,56,39
1657459380628,CSE 11,A01,083080,Cao; Yingjun,6,15,40,34
1657459386665,CSE 12,A01,083652,Krause-Levy; Sophia Louisa,28,1,120,92
1657459392693,CSE 15L,A01,083654,Morris; Justin Loren,9,0,50,41
1657459392693,CSE 15L,A02,083655,Morris; Justin Loren,9,0,50,41
1657459398724,CSE 20,A01,083657,Tran; Khoa Dang,39,0,80,41
1657459404749,CSE 21,A01,095574,Bach; Quang Tran,22,0,48,26
1657459410782,CSE 30,A01,083084,Eldon; John,5,0,80,75
1657459410782,CSE 30,B01,095061,Bhaskar; Nishant,9,0,50,41
1657459416811,CSE 100,A01,083659,Cao; Yingjun,5,4,70,65
1657459422841,CSE 134B,A01,083661,Powell; Thomas Allan,22,0,100,78
1657459428866,CSE 140,A01,083663,Gungor; Onat,15,0,85,70
1657459434901,CSE 140L,A01,083088,Eldon; John,21,0,100,79
1657459440931,CSE 175,A01,083665,Kumar; Rakesh,3,0,25,22
1657459446958,CSE 190,A00,092507,Dubnov; Shlomo,8,0,20,12
1657459452982,ECE 45,A01,083139,Congero; Spencer William,6,0,75,69
1657459459014,ECE 65,A50,083695,Saad; Andrew S,12,0,30,18
1657459459014,ECE 65,A51,095125,Saad; Andrew S,24,0,26,2
1657459465039,ECE 109,A01,091882,Touri; Behrouz,19,0,70,51
1657459471064,ECE 180,A00,083140,Abi Samra; Nicholas Camill,1,0,30,29
1657459471064,ECE 180,B00,083141,Abi Samra; Nicholas Camill,0,0,30,30
1657459477092,MATH 10A,A01,083735,Patchell; Gregory David,2,0,30,28
1657459477092,MATH 10A,A02,083736,Patchell; Gregory David,20,0,30,10
1657459477092,MATH 10A,A03,083737,Patchell; Gregory David,16,0,30,14
1657459483124,MATH 10B,A01,083207,Lim; Seonhee,8,0,34,26
1657459483124,MATH 10B,A02,083208,Lim; Seonhee,9,0,35,26
1657459483124,MATH 10B,A03,093472,Lim; Seonhee,7,0,34,27
1657459483124,MATH 10B,B01,083739,Sinha; Shubham,12,0,30,18
1657459489166,MATH 18,A01,083743,Cinel; Cameron Alexander,7,0,30,23
1657459489166,MATH 18,A02,083744,Cinel; Cameron Alexander,17,0,30,13
1657459489166,MATH 18,A03,083745,Cinel; Cameron Alexander,9,0,30,21
1657459489166,MATH 18,B01,083748,Rideout; David Porter,5,0,37,32
1657459489166,MATH 18,B02,083749,Rideout; David Porter,5,0,36,31
1657459489166,MATH 18,B03,083750,Rideout; David Porter,3,0,37,34
1657459489166,MATH 18,B04,083751,Rideout; David Porter,6,0,36,30
1657459489166,MATH 18,B05,093473,Rideout; David Porter,6,0,36,30
1657459489166,MATH 18,B06,093474,Rideout; David Porter,6,0,36,30
1657459495194,MATH 20A,A01,083754,Zheng; Zequn,14,0,40,26
1657459501220,MATH 20B,A01,083756,Briones; Jor-el Thomas Caparas,4,0,36,32
1657459501220,MATH 20B,A02,083757,Briones; Jor-el Thomas Caparas,1,0,36,35
1657459501220,MATH 20B,A03,093475,Briones; Jor-el Thomas Caparas,2,0,36,34
1657459507246,MATH 20C,A01,083760,Briones; Jor-el Thomas Caparas,1,0,35,34
1657459507246,MATH 20C,A02,083761,Briones; Jor-el Thomas Caparas,8,0,35,27
1657459507246,MATH 20C,A03,093476,Briones; Jor-el Thomas Caparas,0,1,36,36
1657459507246,MATH 20C,B01,083762,Bach; Quang Tran,1,0,30,29
1657459513274,MATH 20D,A01,083765,Tran; Brian Kha,5,0,30,25
1657459513274,MATH 20D,A02,083766,Tran; Brian Kha,5,0,30,25
1657459513274,MATH 20D,A03,083767,Tran; Brian Kha,5,0,30,25
1657459519305,MATH 20E,A01,083771,Ganguly; Soumya,9,0,32,23
1657459519305,MATH 20E,A02,083772,Ganguly; Soumya,6,0,32,26
1657459519305,MATH 20E,B01,083773,Ciotti; Benjamin,20,0,35,15
1657459519305,MATH 20E,B02,083774,Ciotti; Benjamin,17,0,35,18
1657459525414,MATH 103A,A01,083777,Greenfeld; Be'Eri,3,0,36,33
1657459525414,MATH 103A,A02,083778,Greenfeld; Be'Eri,5,0,36,31
1657459525414,MATH 103A,A03,093561,Greenfeld; Be'Eri,5,0,36,31
1657459525414,MATH 103A,B01,083779,Greenfeld; Be'Eri,7,0,36,29
1657459525414,MATH 103A,B02,083780,Greenfeld; Be'Eri,4,0,36,32
1657459525414,MATH 103A,B03,093562,Greenfeld; Be'Eri,3,0,36,33
1657459531445,MATH 105,A01,085443,Carter; Anne Toulson,15,0,35,20
1657459531445,MATH 105,A02,093477,Carter; Anne Toulson,20,0,35,15
1657459537470,MATH 109,A01,083213,Ganzberger; Geoffrey Michael,2,0,34,32
1657459537470,MATH 109,A02,083214,Ganzberger; Geoffrey Michael,4,0,34,30
1657459537470,MATH 109,A03,093478,Ganzberger; Geoffrey Michael,2,0,34,32
1657459537470,MATH 109,B01,083215,Ganzberger; Geoffrey Michael,1,0,32,31
1657459537470,MATH 109,B02,083216,Ganzberger; Geoffrey Michael,2,0,32,30
1657459537470,MATH 109,B03,093479,Ganzberger; Geoffrey Michael,8,0,32,24
1657459543496,MATH 142A,A01,083219,Chow; Bennett,7,0,32,25
1657459543496,MATH 142A,A02,083220,Chow; Bennett,10,0,32,22
1657459543496,MATH 142A,A03,093480,Chow; Bennett,8,0,32,24
1657459543496,MATH 142A,B03,093481,Chow; Bennett,8,0,32,24
1657459543496,MATH 142A,B04,093558,Chow; Bennett,13,0,32,19
1657459543496,MATH 142A,B05,093559,Chow; Bennett,6,0,32,26
1657459549523,MATH 193A,A01,083224,Rotar; Vladimir,8,0,34,26
1657459549523,MATH 193A,A02,083225,Rotar; Vladimir,9,0,34,25
1657459549523,MATH 193A,A03,083781,Rotar; Vladimir,5,0,34,29
1657459549523,MATH 193A,A04,083782,Rotar; Vladimir,10,0,34,24
1657459549523,MATH 193A,A05,093482,Rotar; Vladimir,10,0,34,24
1657459555547,MATH 197,001,091859,McAuley; Julian John,9999,0,9999,0
1657459555547,MATH 197,002,095566,Kedlaya; Kiran S.,9997,0,9999,2
1657459555547,MATH 197,003,095567,Xiao; Ming,9999,0,9999,0
1657459555547,MATH 197,004,095571,Perols; Johan Lars,9998,0,9999,1
1657459562612,COGS 9,A01,083615,Shannon; Kyle Michael,9,0,75,66
1657459568635,COGS 11,A01,083617,Boyle; Mary E. T.,22,0,48,26
1657459574660,COGS 13,A01,083071,Bastos; Amalia Pinkusfeld,11,0,71,60
1657459580692,COGS 14A,A01,092681,Semenuks; Arturs,5,1,100,95
1657459586718,COGS 14B,A01,083073,Cheng; Tzu-Han,6,0,63,57
1657459592742,COGS 17,A01,092677,Semenuks; Arturs,6,0,81,75
1657459598769,COGS 100,A01,083619,Allen; Michael Gordon,17,0,70,53
1657459604801,COGS 101A,A01,083621,Davis; Joshua Daniel,9,0,68,59
1657459610832,COGS 101B,A01,091572,Allen; Michael Gordon,12,0,65,53
1657459616856,COGS 101C,A01,083625,Delgado; Tania,17,0,35,18
1657459622882,COGS 107A,A01,083627,Boyle; Mary E. T.,13,0,60,47
1657459628909,COGS 118A,A01,083075,Gupta; Anjum,21,0,76,55
1657459634936,CSE 3,A50,083646,Miranda; Gregory Joseph,24,0,50,26
1657459640962,CSE 8A,A50,083650,Miranda; Gregory Joseph,17,1,56,39
1657459646988,CSE 11,A01,083080,Cao; Yingjun,6,15,40,34
1657459653019,CSE 12,A01,083652,Krause-Levy; Sophia Louisa,28,1,120,92
1657459659046,CSE 15L,A01,083654,Morris; Justin Loren,9,0,50,41
1657459659046,CSE 15L,A02,083655,Morris; Justin Loren,9,0,50,41
1657459665076,CSE 20,A01,083657,Tran; Khoa Dang,39,0,80,41
1657459671108,CSE 21,A01,095574,Bach; Quang Tran,22,0,48,26
1657459677137,CSE 30,A01,083084,Eldon; John,5,0,80,75
1657459677137,CSE 30,B01,095061,Bhaskar; Nishant,9,0,50,41
1657459683163,CSE 100,A01,083659,Cao; Yingjun,5,4,70,65
1657459689192,CSE 134B,A01,083661,Powell; Thomas Allan,22,0,100,78
1657459695218,CSE 140,A01,083663,Gungor; Onat,15,0,85,70
1657459701245,CSE 140L,A01,083088,Eldon; John,21,0,100,79
1657459707274,CSE 175,A01,083665,Kumar; Rakesh,3,0,25,22
1657459713302,CSE 190,A00,092507,Dubnov; Shlomo,8,0,20,12
1657459719327,ECE 45,A01,083139,Congero; Spencer William,6,0,75,69
1657459725358,ECE 65,A50,083695,Saad; Andrew S,12,0,30,18
1657459725358,ECE 65,A51,095125,Saad; Andrew S,24,0,26,2
1657459731383,ECE 109,A01,091882,Touri; Behrouz,19,0,70,51
1657459737407,ECE 180,A00,083140,Abi Samra; Nicholas Camill,1,0,30,29
1657459737407,ECE 180,B00,083141,Abi Samra; Nicholas Camill,0,0,30,30
1657459743442,MATH 10A,A01,083735,Patchell; Gregory David,2,0,30,28
1657459743442,MATH 10A,A02,083736,Patchell; Gregory David,20,0,30,10
1657459743442,MATH 10A,A03,083737,Patchell; Gregory David,16,0,30,14
1657459749469,MATH 10B,A01,083207,Lim; Seonhee,8,0,34,26
1657459749469,MATH 10B,A02,083208,Lim; Seonhee,9,0,35,26
1657459749469,MATH 10B,A03,093472,Lim; Seonhee,7,0,34,27
1657459749469,MATH 10B,B01,083739,Sinha; Shubham,12,0,30,18
1657459755497,MATH 18,A01,083743,Cinel; Cameron Alexander,7,0,30,23
1657459755497,MATH 18,A02,083744,Cinel; Cameron Alexander,17,0,30,13
1657459755497,MATH 18,A03,083745,Cinel; Cameron Alexander,9,0,30,21
1657459755497,MATH 18,B01,083748,Rideout; David Porter,5,0,37,32
1657459755497,MATH 18,B02,083749,Rideout; David Porter,5,0,36,31
1657459755497,MATH 18,B03,083750,Rideout; David Porter,3,0,37,34
1657459755497,MATH 18,B04,083751,Rideout; David Porter,6,0,36,30
1657459755497,MATH 18,B05,093473,Rideout; David Porter,6,0,36,30
1657459755497,MATH 18,B06,093474,Rideout; David Porter,6,0,36,30
1657459761529,MATH 20A,A01,083754,Zheng; Zequn,14,0,40,26
1657459767562,MATH 20B,A01,083756,Briones; Jor-el Thomas Caparas,4,0,36,32
1657459767562,MATH 20B,A02,083757,Briones; Jor-el Thomas Caparas,1,0,36,35
1657459767562,MATH 20B,A03,093475,Briones; Jor-el Thomas Caparas,2,0,36,34
1657459773600,MATH 20C,A01,083760,Briones; Jor-el Thomas Caparas,1,0,35,34
1657459773600,MATH 20C,A02,083761,Briones; Jor-el Thomas Caparas,8,0,35,27
1657459773600,MATH 20C,A03,093476,Briones; Jor-el Thomas Caparas,0,1,36,36
1657459773600,MATH 20C,B01,083762,Bach; Quang Tran,1,0,30,29
1657459779625,MATH 20D,A01,083765,Tran; Brian Kha,5,0,30,25
1657459779625,MATH 20D,A02,083766,Tran; Brian Kha,5,0,30,25
1657459779625,MATH 20D,A03,083767,Tran; Brian Kha,5,0,30,25
1657459785651,MATH 20E,A01,083771,Ganguly; Soumya,9,0,32,23
1657459785651,MATH 20E,A02,083772,Ganguly; Soumya,6,0,32,26
1657459785651,MATH 20E,B01,083773,Ciotti; Benjamin,20,0,35,15
1657459785651,MATH 20E,B02,083774,Ciotti; Benjamin,17,0,35,18
1657459791687,MATH 103A,A01,083777,Greenfeld; Be'Eri,3,0,36,33
1657459791687,MATH 103A,A02,083778,Greenfeld; Be'Eri,5,0,36,31
1657459791687,MATH 103A,A03,093561,Greenfeld; Be'Eri,5,0,36,31
1657459791687,MATH 103A,B01,083779,Greenfeld; Be'Eri,7,0,36,29
1657459791687,MATH 103A,B02,083780,Greenfeld; Be'Eri,4,0,36,32
1657459791687,MATH 103A,B03,093562,Greenfeld; Be'Eri,3,0,36,33
1657459797713,MATH 105,A01,085443,Carter; Anne Toulson,15,0,35,20
1657459797713,MATH 105,A02,093477,Carter; Anne Toulson,20,0,35,15
1657459803745,MATH 109,A01,083213,Ganzberger; Geoffrey Michael,2,0,34,32
1657459803745,MATH 109,A02,083214,Ganzberger; Geoffrey Michael,4,0,34,30
1657459803745,MATH 109,A03,093478,Ganzberger; Geoffrey Michael,2,0,34,32
1657459803745,MATH 109,B01,083215,Ganzberger; Geoffrey Michael,1,0,32,31
1657459803745,MATH 109,B02,083216,Ganzberger; Geoffrey Michael,2,0,32,30
1657459803745,MATH 109,B03,093479,Ganzberger; Geoffrey Michael,8,0,32,24
1657459809771,MATH 142A,A01,083219,Chow; Bennett,7,0,32,25
1657459809771,MATH 142A,A02,083220,Chow; Bennett,10,0,32,22
1657459809771,MATH 142A,A03,093480,Chow; Bennett,8,0,32,24
1657459809771,MATH 142A,B03,093481,Chow; Bennett,8,0,32,24
1657459809771,MATH 142A,B04,093558,Chow; Bennett,13,0,32,19
1657459809771,MATH 142A,B05,093559,Chow; Bennett,6,0,32,26
1657459815797,MATH 193A,A01,083224,Rotar; Vladimir,8,0,34,26
1657459815797,MATH 193A,A02,083225,Rotar; Vladimir,9,0,34,25
1657459815797,MATH 193A,A03,083781,Rotar; Vladimir,5,0,34,29
1657459815797,MATH 193A,A04,083782,Rotar; Vladimir,10,0,34,24
1657459815797,MATH 193A,A05,093482,Rotar; Vladimir,10,0,34,24
1657459821827,MATH 197,001,091859,McAuley; Julian John,9999,0,9999,0
1657459821827,MATH 197,002,095566,Kedlaya; Kiran S.,9997,0,9999,2
1657459821827,MATH 197,003,095567,Xiao; Ming,9999,0,9999,0
1657459821827,MATH 197,004,095571,Perols; Johan Lars,9998,0,9999,1
1657459828908,COGS 9,A01,083615,Shannon; Kyle Michael,9,0,75,66
1657459834934,COGS 11,A01,083617,Boyle; Mary E. T.,22,0,48,26
1657459840962,COGS 13,A01,083071,Bastos; Amalia Pinkusfeld,11,0,71,60
1657459846989,COGS 14A,A01,092681,Semenuks; Arturs,5,1,100,95
1657459853021,COGS 14B,A01,083073,Cheng; Tzu-Han,6,0,63,57
1657459859048,COGS 17,A01,092677,Semenuks; Arturs,6,0,81,75
1657459865077,COGS 100,A01,083619,Allen; Michael Gordon,17,0,70,53
1657459871110,COGS 101A,A01,083621,Davis; Joshua Daniel,9,0,68,59
1657459877137,COGS 101B,A01,091572,Allen; Michael Gordon,12,0,65,53
1657459883170,COGS 101C,A01,083625,Delgado; Tania,17,0,35,18
1657459889196,COGS 107A,A01,083627,Boyle; Mary E. T.,13,0,60,47
1657459895221,COGS 118A,A01,083075,Gupta; Anjum,21,0,76,55
1657459901248,CSE 3,A50,083646,Miranda; Gregory Joseph,24,0,50,26
1657459907274,CSE 8A,A50,083650,Miranda; Gregory Joseph,17,1,56,39
1657459913300,CSE 11,A01,083080,Cao; Yingjun,6,15,40,34
1657459919329,CSE 12,A01,083652,Krause-Levy; Sophia Louisa,28,1,120,92
1657459925354,CSE 15L,A01,083654,Morris; Justin Loren,9,0,50,41
1657459925354,CSE 15L,A02,083655,Morris; Justin Loren,9,0,50,41
1657459931384,CSE 20,A01,083657,Tran; Khoa Dang,39,0,80,41
1657459937415,CSE 21,A01,095574,Bach; Quang Tran,22,0,48,26
1657459943460,CSE 30,A01,083084,Eldon; John,5,0,80,75
1657459943460,CSE 30,B01,095061,Bhaskar; Nishant,9,0,50,41
1657459949485,CSE 100,A01,083659,Cao; Yingjun,5,4,70,65
1657459955512,CSE 134B,A01,083661,Powell; Thomas Allan,22,0,100,78
1657459961537,CSE 140,A01,083663,Gungor; Onat,15,0,85,70
1657459967566,CSE 140L,A01,083088,Eldon; John,21,0,100,79
1657459973594,CSE 175,A01,083665,Kumar; Rakesh,3,0,25,22
1657459979619,CSE 190,A00,092507,Dubnov; Shlomo,8,0,20,12
1657459985661,ECE 45,A01,083139,Congero; Spencer William,6,0,75,69
1657459991687,ECE 65,A50,083695,Saad; Andrew S,12,0,30,18
1657459991687,ECE 65,A51,095125,Saad; Andrew S,24,0,26,2
1657459997717,ECE 109,A01,091882,Touri; Behrouz,19,0,70,51
1657460003746,ECE 180,A00,083140,Abi Samra; Nicholas Camill,1,0,30,29
1657460003746,ECE 180,B00,083141,Abi Samra; Nicholas Camill,0,0,30,30
1657460009779,MATH 10A,A01,083735,Patchell; Gregory David,2,0,30,28
1657460009779,MATH 10A,A02,083736,Patchell; Gregory David,20,0,30,10
1657460009779,MATH 10A,A03,083737,Patchell; Gregory David,16,0,30,14
1657460015808,MATH 10B,A01,083207,Lim; Seonhee,8,0,34,26
1657460015808,MATH 10B,A02,083208,Lim; Seonhee,9,0,35,26
1657460015808,MATH 10B,A03,093472,Lim; Seonhee,7,0,34,27
1657460015808,MATH 10B,B01,083739,Sinha; Shubham,12,0,30,18
1657460021839,MATH 18,A01,083743,Cinel; Cameron Alexander,7,0,30,23
1657460021839,MATH 18,A02,083744,Cinel; Cameron Alexander,17,0,30,13
1657460021839,MATH 18,A03,083745,Cinel; Cameron Alexander,9,0,30,21
1657460021839,MATH 18,B01,083748,Rideout; David Porter,5,0,37,32
1657460021839,MATH 18,B02,083749,Rideout; David Porter,5,0,36,31
1657460021839,MATH 18,B03,083750,Rideout; David Porter,3,0,37,34
1657460021839,MATH 18,B04,083751,Rideout; David Porter,6,0,36,30
1657460021839,MATH 18,B05,093473,Rideout; David Porter,6,0,36,30
1657460021839,MATH 18,B06,093474,Rideout; David Porter,6,0,36,30
1657460027869,MATH 20A,A01,083754,Zheng; Zequn,14,0,40,26
1657460033897,MATH 20B,A01,083756,Briones; Jor-el Thomas Caparas,4,0,36,32
1657460033897,MATH 20B,A02,083757,Briones; Jor-el Thomas Caparas,1,0,36,35
1657460033897,MATH 20B,A03,093475,Briones; Jor-el Thomas Caparas,2,0,36,34
1657460039928,MATH 20C,A01,083760,Briones; Jor-el Thomas Caparas,1,0,35,34
1657460039928,MATH 20C,A02,083761,Briones; Jor-el Thomas Caparas,8,0,35,27
1657460039928,MATH 20C,A03,093476,Briones; Jor-el Thomas Caparas,0,1,36,36
1657460039928,MATH 20C,B01,083762,Bach; Quang Tran,1,0,30,29
1657460045960,MATH 20D,A01,083765,Tran; Brian Kha,5,0,30,25
1657460045960,MATH 20D,A02,083766,Tran; Brian Kha,5,0,30,25
1657460045960,MATH 20D,A03,083767,Tran; Brian Kha,5,0,30,25
1657460051987,MATH 20E,A01,083771,Ganguly; Soumya,9,0,32,23
1657460051987,MATH 20E,A02,083772,Ganguly; Soumya,6,0,32,26
1657460051987,MATH 20E,B01,083773,Ciotti; Benjamin,20,0,35,15
1657460051987,MATH 20E,B02,083774,Ciotti; Benjamin,17,0,35,18
1657460058021,MATH 103A,A01,083777,Greenfeld; Be'Eri,3,0,36,33
1657460058021,MATH 103A,A02,083778,Greenfeld; Be'Eri,5,0,36,31
1657460058021,MATH 103A,A03,093561,Greenfeld; Be'Eri,5,0,36,31
1657460058021,MATH 103A,B01,083779,Greenfeld; Be'Eri,7,0,36,29
1657460058021,MATH 103A,B02,083780,Greenfeld; Be'Eri,4,0,36,32
1657460058021,MATH 103A,B03,093562,Greenfeld; Be'Eri,3,0,36,33
1657460064048,MATH 105,A01,085443,Carter; Anne Toulson,15,0,35,20
1657460064048,MATH 105,A02,093477,Carter; Anne Toulson,20,0,35,15
1657460070079,MATH 109,A01,083213,Ganzberger; Geoffrey Michael,2,0,34,32
1657460070079,MATH 109,A02,083214,Ganzberger; Geoffrey Michael,4,0,34,30
1657460070079,MATH 109,A03,093478,Ganzberger; Geoffrey Michael,2,0,34,32
1657460070079,MATH 109,B01,083215,Ganzberger; Geoffrey Michael,1,0,32,31
1657460070079,MATH 109,B02,083216,Ganzberger; Geoffrey Michael,2,0,32,30
1657460070079,MATH 109,B03,093479,Ganzberger; Geoffrey Michael,8,0,32,24
1657460076107,MATH 142A,A01,083219,Chow; Bennett,7,0,32,25
1657460076107,MATH 142A,A02,083220,Chow; Bennett,10,0,32,22
1657460076107,MATH 142A,A03,093480,Chow; Bennett,8,0,32,24
1657460076107,MATH 142A,B03,093481,Chow; Bennett,8,0,32,24
1657460076107,MATH 142A,B04,093558,Chow; Bennett,13,0,32,19
1657460076107,MATH 142A,B05,093559,Chow; Bennett,6,0,32,26
1657460082134,MATH 193A,A01,083224,Rotar; Vladimir,8,0,34,26
1657460082134,MATH 193A,A02,083225,Rotar; Vladimir,9,0,34,25
1657460082134,MATH 193A,A03,083781,Rotar; Vladimir,5,0,34,29
1657460082134,MATH 193A,A04,083782,Rotar; Vladimir,10,0,34,24
1657460082134,MATH 193A,A05,093482,Rotar; Vladimir,10,0,34,24
1657460088159,MATH 197,001,091859,McAuley; Julian John,9999,0,9999,0
1657460088159,MATH 197,002,095566,Kedlaya; Kiran S.,9997,0,9999,2
1657460088159,MATH 197,003,095567,Xiao; Ming,9999,0,9999,0
1657460088159,MATH 197,004,095571,Perols; Johan Lars,9998,0,9999,1
1657460095219,COGS 9,A01,083615,Shannon; Kyle Michael,9,0,75,66
1657460101242,COGS 11,A01,083617,Boyle; Mary E. T.,22,0,48,26
1657460107267,COGS 13,A01,083071,Bastos; Amalia Pinkusfeld,11,0,71,60
1657460113296,COGS 14A,A01,092681,Semenuks; Arturs,5,1,100,95
1657460119393,COGS 14B,A01,083073,Cheng; Tzu-Han,6,0,63,57
1657460125423,COGS 17,A01,092677,Semenuks; Arturs,6,0,81,75
1657460131451,COGS 100,A01,083619,Allen; Michael Gordon,17,0,70,53
1657460137476,COGS 101A,A01,083621,Davis; Joshua Daniel,9,0,68,59
1657460143507,COGS 101B,A01,091572,Allen; Michael Gordon,12,0,65,53
1657460149536,COGS 101C,A01,083625,Delgado; Tania,17,0,35,18
1657460155565,COGS 107A,A01,083627,Boyle; Mary E. T.,13,0,60,47
1657460161591,COGS 118A,A01,083075,Gupta; Anjum,21,0,76,55
1657460167621,CSE 3,A50,083646,Miranda; Gregory Joseph,24,0,50,26
1657460173646,CSE 8A,A50,083650,Miranda; Gregory Joseph,17,1,56,39
1657460179673,CSE 11,A01,083080,Cao; Yingjun,6,15,40,34
1657460185704,CSE 12,A01,083652,Krause-Levy; Sophia Louisa,28,1,120,92
1657460191727,CSE 15L,A01,083654,Morris; Justin Loren,9,0,50,41
1657460191727,CSE 15L,A02,083655,Morris; Justin Loren,9,0,50,41
1657460197753,CSE 20,A01,083657,Tran; Khoa Dang,39,0,80,41
1657460203778,CSE 21,A01,095574,Bach; Quang Tran,22,0,48,26
1657460209811,CSE 30,A01,083084,Eldon; John,5,0,80,75
1657460209811,CSE 30,B01,095061,Bhaskar; Nishant,9,0,50,41
1657460215842,CSE 100,A01,083659,Cao; Yingjun,5,4,70,65
1657460221871,CSE 134B,A01,083661,Powell; Thomas Allan,22,0,100,78
1657460227899,CSE 140,A01,083663,Gungor; Onat,15,0,85,70
1657460233930,CSE 140L,A01,083088,Eldon; John,21,0,100,79
1657460239956,CSE 175,A01,083665,Kumar; Rakesh,3,0,25,22
1657460245985,CSE 190,A00,092507,Dubnov; Shlomo,8,0,20,12
1657460252012,ECE 45,A01,083139,Congero; Spencer William,6,0,75,69
1657460258054,ECE 65,A50,083695,Saad; Andrew S,12,0,30,18
1657460258054,ECE 65,A51,095125,Saad; Andrew S,24,0,26,2
1657460264090,ECE 109,A01,091882,Touri; Behrouz,19,0,70,51
1657460270123,ECE 180,A00,083140,Abi Samra; Nicholas Camill,1,0,30,29
1657460270123,ECE 180,B00,083141,Abi Samra; Nicholas Camill,0,0,30,30
1657460276150,MATH 10A,A01,083735,Patchell; Gregory David,2,0,30,28
1657460276150,MATH 10A,A02,083736,Patchell; Gregory David,20,0,30,10
1657460276150,MATH 10A,A03,083737,Patchell; Gregory David,16,0,30,14
1657460282186,MATH 10B,A01,083207,Lim; Seonhee,8,0,34,26
1657460282186,MATH 10B,A02,083208,Lim; Seonhee,9,0,35,26
1657460282186,MATH 10B,A03,093472,Lim; Seonhee,7,0,34,27
1657460282186,MATH 10B,B01,083739,Sinha; Shubham,12,0,30,18
1657460288217,MATH 18,A01,083743,Cinel; Cameron Alexander,7,0,30,23
1657460288217,MATH 18,A02,083744,Cinel; Cameron Alexander,17,0,30,13
1657460288217,MATH 18,A03,083745,Cinel; Cameron Alexander,9,0,30,21
1657460288217,MATH 18,B01,083748,Rideout; David Porter,5,0,37,32
1657460288217,MATH 18,B02,083749,Rideout; David Porter,5,0,36,31
1657460288217,MATH 18,B03,083750,Rideout; David Porter,3,0,37,34
1657460288217,MATH 18,B04,083751,Rideout; David Porter,6,0,36,30
1657460288217,MATH 18,B05,093473,Rideout; David Porter,6,0,36,30
1657460288217,MATH 18,B06,093474,Rideout; David Porter,6,0,36,30
1657460294246,MATH 20A,A01,083754,Zheng; Zequn,14,0,40,26
1657460300273,MATH 20B,A01,083756,Briones; Jor-el Thomas Caparas,4,0,36,32
1657460300273,MATH 20B,A02,083757,Briones; Jor-el Thomas Caparas,1,0,36,35
1657460300273,MATH 20B,A03,093475,Briones; Jor-el Thomas Caparas,2,0,36,34
1657460306303,MATH 20C,A01,083760,Briones; Jor-el Thomas Caparas,1,0,35,34
1657460306303,MATH 20C,A02,083761,Briones; Jor-el Thomas Caparas,8,0,35,27
1657460306303,MATH 20C,A03,093476,Briones; Jor-el Thomas Caparas,0,1,36,36
1657460306303,MATH 20C,B01,083762,Bach; Quang Tran,1,0,30,29
1657460312330,MATH 20D,A01,083765,Tran; Brian Kha,5,0,30,25
1657460312330,MATH 20D,A02,083766,Tran; Brian Kha,5,0,30,25
1657460312330,MATH 20D,A03,083767,Tran; Brian Kha,5,0,30,25
1657460318358,MATH 20E,A01,083771,Ganguly; Soumya,9,0,32,23
1657460318358,MATH 20E,A02,083772,Ganguly; Soumya,6,0,32,26
1657460318358,MATH 20E,B01,083773,Ciotti; Benjamin,20,0,35,15
1657460318358,MATH 20E,B02,083774,Ciotti; Benjamin,17,0,35,18
1657460324385,MATH 103A,A01,083777,Greenfeld; Be'Eri,3,0,36,33
1657460324385,MATH 103A,A02,083778,Greenfeld; Be'Eri,5,0,36,31
1657460324385,MATH 103A,A03,093561,Greenfeld; Be'Eri,5,0,36,31
1657460324385,MATH 103A,B01,083779,Greenfeld; Be'Eri,7,0,36,29
1657460324385,MATH 103A,B02,083780,Greenfeld; Be'Eri,4,0,36,32
1657460324385,MATH 103A,B03,093562,Greenfeld; Be'Eri,3,0,36,33
1657460330420,MATH 105,A01,085443,Carter; Anne Toulson,15,0,35,20
1657460330420,MATH 105,A02,093477,Carter; Anne Toulson,20,0,35,15
1657460336452,MATH 109,A01,083213,Ganzberger; Geoffrey Michael,2,0,34,32
1657460336452,MATH 109,A02,083214,Ganzberger; Geoffrey Michael,4,0,34,30
1657460336452,MATH 109,A03,093478,Ganzberger; Geoffrey Michael,2,0,34,32
1657460336452,MATH 109,B01,083215,Ganzberger; Geoffrey Michael,1,0,32,31
1657460336452,MATH 109,B02,083216,Ganzberger; Geoffrey Michael,2,0,32,30
1657460336452,MATH 109,B03,093479,Ganzberger; Geoffrey Michael,8,0,32,24
1657460342477,MATH 142A,A01,083219,Chow; Bennett,7,0,32,25
1657460342477,MATH 142A,A02,083220,Chow; Bennett,10,0,32,22
1657460342477,MATH 142A,A03,093480,Chow; Bennett,8,0,32,24
1657460342477,MATH 142A,B03,093481,Chow; Bennett,8,0,32,24
1657460342477,MATH 142A,B04,093558,Chow; Bennett,13,0,32,19
1657460342477,MATH 142A,B05,093559,Chow; Bennett,6,0,32,26
1657460348503,MATH 193A,A01,083224,Rotar; Vladimir,8,0,34,26
1657460348503,MATH 193A,A02,083225,Rotar; Vladimir,9,0,34,25
1657460348503,MATH 193A,A03,083781,Rotar; Vladimir,5,0,34,29
1657460348503,MATH 193A,A04,083782,Rotar; Vladimir,10,0,34,24
1657460348503,MATH 193A,A05,093482,Rotar; Vladimir,10,0,34,24
1657460354530,MATH 197,001,091859,McAuley; Julian John,9999,0,9999,0
1657460354530,MATH 197,002,095566,Kedlaya; Kiran S.,9997,0,9999,2
1657460354530,MATH 197,003,095567,Xiao; Ming,9999,0,9999,0
1657460354530,MATH 197,004,095571,Perols; Johan Lars,9998,0,9999,1
1657460361627,COGS 9,A01,083615,Shannon; Kyle Michael,9,0,75,66
1657460367667,COGS 11,A01,083617,Boyle; Mary E. T.,22,0,48,26
1657460373693,COGS 13,A01,083071,Bastos; Amalia Pinkusfeld,11,0,71,60
1657460379720,COGS 14A,A01,092681,Semenuks; Arturs,5,1,100,95
1657460385744,COGS 14B,A01,083073,Cheng; Tzu-Han,6,0,63,57
1657460391769,COGS 17,A01,092677,Semenuks; Arturs,6,0,81,75
1657460397796,COGS 100,A01,083619,Allen; Michael Gordon,17,0,70,53
1657460403821,COGS 101A,A01,083621,Davis; Joshua Daniel,9,0,68,59
1657460409855,COGS 101B,A01,091572,Allen; Michael Gordon,12,0,65,53
1657460415895,COGS 101C,A01,083625,Delgado; Tania,17,0,35,18
1657460421920,COGS 107A,A01,083627,Boyle; Mary E. T.,13,0,60,47
1657460427947,COGS 118A,A01,083075,Gupta; Anjum,21,0,76,55
1657460433981,CSE 3,A50,083646,Miranda; Gregory Joseph,24,0,50,26
1657460440008,CSE 8A,A50,083650,Miranda; Gregory Joseph,17,1,56,39
1657460446035,CSE 11,A01,083080,Cao; Yingjun,6,15,40,34
1657460452068,CSE 12,A01,083652,Krause-Levy; Sophia Louisa,28,1,120,92
1657460458096,CSE 15L,A01,083654,Morris; Justin Loren,9,0,50,41
1657460458096,CSE 15L,A02,083655,Morris; Justin Loren,9,0,50,41
1657460464120,CSE 20,A01,083657,Tran; Khoa Dang,39,0,80,41
1657460470144,CSE 21,A01,095574,Bach; Quang Tran,22,0,48,26
1657460476171,CSE 30,A01,083084,Eldon; John,5,0,80,75
1657460476171,CSE 30,B01,095061,Bhaskar; Nishant,9,0,50,41
1657460482197,CSE 100,A01,083659,Cao; Yingjun,5,4,70,65
1657460488228,CSE 134B,A01,083661,Powell; Thomas Allan,22,0,100,78
1657460494256,CSE 140,A01,083663,Gungor; Onat,15,0,85,70
1657460500283,CSE 140L,A01,083088,Eldon; John,21,0,100,79
1657460506311,CSE 175,A01,083665,Kumar; Rakesh,3,0,25,22
1657460512341,CSE 190,A00,092507,Dubnov; Shlomo,8,0,20,12
1657460518372,ECE 45,A01,083139,Congero; Spencer William,6,0,75,69
1657460524406,ECE 65,A50,083695,Saad; Andrew S,12,0,30,18
1657460524406,ECE 65,A51,095125,Saad; Andrew S,24,0,26,2
1657460530439,ECE 109,A01,091882,Touri; Behrouz,19,0,70,51
1657460536469,ECE 180,A00,083140,Abi Samra; Nicholas Camill,1,0,30,29
1657460536469,ECE 180,B00,083141,Abi Samra; Nicholas Camill,0,0,30,30
1657460542504,MATH 10A,A01,083735,Patchell; Gregory David,2,0,30,28
1657460542504,MATH 10A,A02,083736,Patchell; Gregory David,20,0,30,10
1657460542504,MATH 10A,A03,083737,Patchell; Gregory David,16,0,30,14
1657460548532,MATH 10B,A01,083207,Lim; Seonhee,8,0,34,26
1657460548532,MATH 10B,A02,083208,Lim; Seonhee,9,0,35,26
1657460548532,MATH 10B,A03,093472,Lim; Seonhee,7,0,34,27
1657460548532,MATH 10B,B01,083739,Sinha; Shubham,12,0,30,18
1657460554569,MATH 18,A01,083743,Cinel; Cameron Alexander,7,0,30,23
1657460554569,MATH 18,A02,083744,Cinel; Cameron Alexander,17,0,30,13
1657460554569,MATH 18,A03,083745,Cinel; Cameron Alexander,9,0,30,21
1657460554569,MATH 18,B01,083748,Rideout; David Porter,5,0,37,32
1657460554569,MATH 18,B02,083749,Rideout; David Porter,5,0,36,31
1657460554569,MATH 18,B03,083750,Rideout; David Porter,3,0,37,34
1657460554569,MATH 18,B04,083751,Rideout; David Porter,6,0,36,30
1657460554569,MATH 18,B05,093473,Rideout; David Porter,6,0,36,30
1657460554569,MATH 18,B06,093474,Rideout; David Porter,6,0,36,30
1657460560599,MATH 20A,A01,083754,Zheng; Zequn,14,0,40,26
1657460566633,MATH 20B,A01,083756,Briones; Jor-el Thomas Caparas,4,0,36,32
1657460566633,MATH 20B,A02,083757,Briones; Jor-el Thomas Caparas,1,0,36,35
1657460566633,MATH 20B,A03,093475,Briones; Jor-el Thomas Caparas,2,0,36,34
1657460572661,MATH 20C,A01,083760,Briones; Jor-el Thomas Caparas,1,0,35,34
1657460572661,MATH 20C,A02,083761,Briones; Jor-el Thomas Caparas,8,0,35,27
1657460572661,MATH 20C,A03,093476,Briones; Jor-el Thomas Caparas,0,1,36,36
1657460572661,MATH 20C,B01,083762,Bach; Quang Tran,1,0,30,29
1657460578686,MATH 20D,A01,083765,Tran; Brian Kha,5,0,30,25
1657460578686,MATH 20D,A02,083766,Tran; Brian Kha,5,0,30,25
1657460578686,MATH 20D,A03,083767,Tran; Brian Kha,5,0,30,25
1657460584720,MATH 20E,A01,083771,Ganguly; Soumya,9,0,32,23
1657460584720,MATH 20E,A02,083772,Ganguly; Soumya,6,0,32,26
1657460584720,MATH 20E,B01,083773,Ciotti; Benjamin,20,0,35,15
1657460584720,MATH 20E,B02,083774,Ciotti; Benjamin,17,0,35,18
1657460590755,MATH 103A,A01,083777,Greenfeld; Be'Eri,3,0,36,33
1657460590755,MATH 103A,A02,083778,Greenfeld; Be'Eri,5,0,36,31
1657460590755,MATH 103A,A03,093561,Greenfeld; Be'Eri,5,0,36,31
1657460590755,MATH 103A,B01,083779,Greenfeld; Be'Eri,7,0,36,29
1657460590755,MATH 103A,B02,083780,Greenfeld; Be'Eri,4,0,36,32
1657460590755,MATH 103A,B03,093562,Greenfeld; Be'Eri,3,0,36,33
1657460596784,MATH 105,A01,085443,Carter; Anne Toulson,15,0,35,20
1657460596784,MATH 105,A02,093477,Carter; Anne Toulson,20,0,35,15
1657460602815,MATH 109,A01,083213,Ganzberger; Geoffrey Michael,2,0,34,32
1657460602815,MATH 109,A02,083214,Ganzberger; Geoffrey Michael,4,0,34,30
1657460602815,MATH 109,A03,093478,Ganzberger; Geoffrey Michael,2,0,34,32
1657460602815,MATH 109,B01,083215,Ganzberger; Geoffrey Michael,1,0,32,31
1657460602815,MATH 109,B02,083216,Ganzberger; Geoffrey Michael,2,0,32,30
1657460602815,MATH 109,B03,093479,Ganzberger; Geoffrey Michael,8,0,32,24
1657460608840,MATH 142A,A01,083219,Chow; Bennett,7,0,32,25
1657460608840,MATH 142A,A02,083220,Chow; Bennett,10,0,32,22
1657460608840,MATH 142A,A03,093480,Chow; Bennett,8,0,32,24
1657460608840,MATH 142A,B03,093481,Chow; Bennett,8,0,32,24
1657460608840,MATH 142A,B04,093558,Chow; Bennett,13,0,32,19
1657460608840,MATH 142A,B05,093559,Chow; Bennett,6,0,32,26
1657460614871,MATH 193A,A01,083224,Rotar; Vladimir,8,0,34,26
1657460614871,MATH 193A,A02,083225,Rotar; Vladimir,9,0,34,25
1657460614871,MATH 193A,A03,083781,Rotar; Vladimir,5,0,34,29
1657460614871,MATH 193A,A04,083782,Rotar; Vladimir,10,0,34,24
1657460614871,MATH 193A,A05,093482,Rotar; Vladimir,10,0,34,24
1657460620897,MATH 197,001,091859,McAuley; Julian John,9999,0,9999,0
1657460620897,MATH 197,002,095566,Kedlaya; Kiran S.,9997,0,9999,2
1657460620897,MATH 197,003,095567,Xiao; Ming,9999,0,9999,0
1657460620897,MATH 197,004,095571,Perols; Johan Lars,9998,0,9999,1
1657460627966,COGS 9,A01,083615,Shannon; Kyle Michael,9,0,75,66
1657460633993,COGS 11,A01,083617,Boyle; Mary E. T.,22,0,48,26
1657460640025,COGS 13,A01,083071,Bastos; Amalia Pinkusfeld,11,0,71,60
1657460646052,COGS 14A,A01,092681,Semenuks; Arturs,5,1,100,95
1657460652078,COGS 14B,A01,083073,Cheng; Tzu-Han,6,0,63,57
1657460658102,COGS 17,A01,092677,Semenuks; Arturs,6,0,81,75
1657460664136,COGS 100,A01,083619,Allen; Michael Gordon,17,0,70,53
1657460670164,COGS 101A,A01,083621,Davis; Joshua Daniel,9,0,68,59
1657460676196,COGS 101B,A01,091572,Allen; Michael Gordon,12,0,65,53
1657460682228,COGS 101C,A01,083625,Delgado; Tania,17,0,35,18
1657460688253,COGS 107A,A01,083627,Boyle; Mary E. T.,13,0,60,47
1657460694286,COGS 118A,A01,083075,Gupta; Anjum,21,0,76,55
1657460700323,CSE 3,A50,083646,Miranda; Gregory Joseph,24,0,50,26
1657460706360,CSE 8A,A50,083650,Miranda; Gregory Joseph,17,1,56,39
1657460712387,CSE 11,A01,083080,Cao; Yingjun,6,15,40,34
1657460718484,CSE 12,A01,083652,Krause-Levy; Sophia Louisa,28,1,120,92
1657460724515,CSE 15L,A01,083654,Morris; Justin Loren,9,0,50,41
1657460724515,CSE 15L,A02,083655,Morris; Justin Loren,9,0,50,41
1657460730545,CSE 20,A01,083657,Tran; Khoa Dang,39,0,80,41
1657460736573,CSE 21,A01,095574,Bach; Quang Tran,22,0,48,26
1657460742604,CSE 30,A01,083084,Eldon; John,5,0,80,75
1657460742604,CSE 30,B01,095061,Bhaskar; Nishant,9,0,50,41
1657460748629,CSE 100,A01,083659,Cao; Yingjun,5,4,70,65
1657460754661,CSE 134B,A01,083661,Powell; Thomas Allan,22,0,100,78
1657460760685,CSE 140,A01,083663,Gungor; Onat,15,0,85,70
1657460766713,CSE 140L,A01,083088,Eldon; John,21,0,100,79
1657460772742,CSE 175,A01,083665,Kumar; Rakesh,3,0,25,22
1657460778766,CSE 190,A00,092507,Dubnov; Shlomo,8,0,20,12
1657460784792,ECE 45,A01,083139,Congero; Spencer William,6,0,75,69
1657460790820,ECE 65,A50,083695,Saad; Andrew S,12,0,30,18
1657460790820,ECE 65,A51,095125,Saad; Andrew S,24,0,26,2
1657460796851,ECE 109,A01,091882,Touri; Behrouz,19,0,70,51
1657460802877,ECE 180,A00,083140,Abi Samra; Nicholas Camill,1,0,30,29
1657460802877,ECE 180,B00,083141,Abi Samra; Nicholas Camill,0,0,30,30
1657460808912,MATH 10A,A01,083735,Patchell; Gregory David,2,0,30,28
1657460808912,MATH 10A,A02,083736,Patchell; Gregory David,20,0,30,10
1657460808912,MATH 10A,A03,083737,Patchell; Gregory David,16,0,30,14
1657460814940,MATH 10B,A01,083207,Lim; Seonhee,8,0,34,26
1657460814940,MATH 10B,A02,083208,Lim; Seonhee,9,0,35,26
1657460814940,MATH 10B,A03,093472,Lim; Seonhee,7,0,34,27
1657460814940,MATH 10B,B01,083739,Sinha; Shubham,12,0,30,18
1657460820967,MATH 18,A01,083743,Cinel; Cameron Alexander,7,0,30,23
1657460820967,MATH 18,A02,083744,Cinel; Cameron Alexander,17,0,30,13
1657460820967,MATH 18,A03,083745,Cinel; Cameron Alexander,9,0,30,21
1657460820967,MATH 18,B01,083748,Rideout; David Porter,5,0,37,32
1657460820967,MATH 18,B02,083749,Rideout; David Porter,5,0,36,31
1657460820967,MATH 18,B03,083750,Rideout; David Porter,3,0,37,34
1657460820967,MATH 18,B04,083751,Rideout; David Porter,6,0,36,30
1657460820967,MATH 18,B05,093473,Rideout; David Porter,6,0,36,30
1657460820967,MATH 18,B06,093474,Rideout; David Porter,6,0,36,30
1657460826997,MATH 20A,A01,083754,Zheng; Zequn,14,0,40,26
1657460833024,MATH 20B,A01,083756,Briones; Jor-el Thomas Caparas,4,0,36,32
1657460833024,MATH 20B,A02,083757,Briones; Jor-el Thomas Caparas,1,0,36,35
1657460833024,MATH 20B,A03,093475,Briones; Jor-el Thomas Caparas,2,0,36,34
1657460839056,MATH 20C,A01,083760,Briones; Jor-el Thomas Caparas,1,0,35,34
1657460839056,MATH 20C,A02,083761,Briones; Jor-el Thomas Caparas,8,0,35,27
1657460839056,MATH 20C,A03,093476,Briones; Jor-el Thomas Caparas,0,1,36,36
1657460839056,MATH 20C,B01,083762,Bach; Quang Tran,1,0,30,29
1657460845083,MATH 20D,A01,083765,Tran; Brian Kha,5,0,30,25
1657460845083,MATH 20D,A02,083766,Tran; Brian Kha,5,0,30,25
1657460845083,MATH 20D,A03,083767,Tran; Brian Kha,5,0,30,25
1657460851112,MATH 20E,A01,083771,Ganguly; Soumya,9,0,32,23
1657460851112,MATH 20E,A02,083772,Ganguly; Soumya,6,0,32,26
1657460851112,MATH 20E,B01,083773,Ciotti; Benjamin,20,0,35,15
1657460851112,MATH 20E,B02,083774,Ciotti; Benjamin,17,0,35,18
1657460857143,MATH 103A,A01,083777,Greenfeld; Be'Eri,3,0,36,33
1657460857143,MATH 103A,A02,083778,Greenfeld; Be'Eri,5,0,36,31
1657460857143,MATH 103A,A03,093561,Greenfeld; Be'Eri,5,0,36,31
1657460857143,MATH 103A,B01,083779,Greenfeld; Be'Eri,7,0,36,29
1657460857143,MATH 103A,B02,083780,Greenfeld; Be'Eri,4,0,36,32
1657460857143,MATH 103A,B03,093562,Greenfeld; Be'Eri,3,0,36,33
1657460863171,MATH 105,A01,085443,Carter; Anne Toulson,15,0,35,20
1657460863171,MATH 105,A02,093477,Carter; Anne Toulson,20,0,35,15
1657460869206,MATH 109,A01,083213,Ganzberger; Geoffrey Michael,2,0,34,32
1657460869206,MATH 109,A02,083214,Ganzberger; Geoffrey Michael,4,0,34,30
1657460869206,MATH 109,A03,093478,Ganzberger; Geoffrey Michael,2,0,34,32
1657460869206,MATH 109,B01,083215,Ganzberger; Geoffrey Michael,1,0,32,31
1657460869206,MATH 109,B02,083216,Ganzberger; Geoffrey Michael,2,0,32,30
1657460869206,MATH 109,B03,093479,Ganzberger; Geoffrey Michael,8,0,32,24
1657460875233,MATH 142A,A01,083219,Chow; Bennett,7,0,32,25
1657460875233,MATH 142A,A02,083220,Chow; Bennett,10,0,32,22
1657460875233,MATH 142A,A03,093480,Chow; Bennett,8,0,32,24
1657460875233,MATH 142A,B03,093481,Chow; Bennett,8,0,32,24
1657460875233,MATH 142A,B04,093558,Chow; Bennett,13,0,32,19
1657460875233,MATH 142A,B05,093559,Chow; Bennett,6,0,32,26
1657460881261,MATH 193A,A01,083224,Rotar; Vladimir,8,0,34,26
1657460881261,MATH 193A,A02,083225,Rotar; Vladimir,9,0,34,25
1657460881261,MATH 193A,A03,083781,Rotar; Vladimir,5,0,34,29
1657460881261,MATH 193A,A04,083782,Rotar; Vladimir,10,0,34,24
1657460881261,MATH 193A,A05,093482,Rotar; Vladimir,10,0,34,24
1657460887294,MATH 197,001,091859,McAuley; Julian John,9999,0,9999,0
1657460887294,MATH 197,002,095566,Kedlaya; Kiran S.,9997,0,9999,2
1657460887294,MATH 197,003,095567,Xiao; Ming,9999,0,9999,0
1657460887294,MATH 197,004,095571,Perols; Johan Lars,9998,0,9999,1
1657460894394,COGS 9,A01,083615,Shannon; Kyle Michael,9,0,75,66
1657460900425,COGS 11,A01,083617,Boyle; Mary E. T.,22,0,48,26
1657460906451,COGS 13,A01,083071,Bastos; Amalia Pinkusfeld,11,0,71,60
1657460912488,COGS 14A,A01,092681,Semenuks; Arturs,5,1,100,95
1657460918513,COGS 14B,A01,083073,Cheng; Tzu-Han,6,0,63,57
1657460924537,COGS 17,A01,092677,Semenuks; Arturs,6,0,81,75
1657460930568,COGS 100,A01,083619,Allen; Michael Gordon,17,0,70,53
1657460936593,COGS 101A,A01,083621,Davis; Joshua Daniel,9,0,68,59
1657460942620,COGS 101B,A01,091572,Allen; Michael Gordon,12,0,65,53
1657460948650,COGS 101C,A01,083625,Delgado; Tania,17,0,35,18
1657460954676,COGS 107A,A01,083627,Boyle; Mary E. T.,13,0,60,47
1657460960702,COGS 118A,A01,083075,Gupta; Anjum,21,0,76,55
1657460966734,CSE 3,A50,083646,Miranda; Gregory Joseph,24,0,50,26
1657460972766,CSE 8A,A50,083650,Miranda; Gregory Joseph,17,1,56,39
1657460978789,CSE 11,A01,083080,Cao; Yingjun,6,15,40,34
1657460984816,CSE 12,A01,083652,Krause-Levy; Sophia Louisa,28,1,120,92
1657460990840,CSE 15L,A01,083654,Morris; Justin Loren,9,0,50,41
1657460990840,CSE 15L,A02,083655,Morris; Justin Loren,9,0,50,41
1657460996867,CSE 20,A01,083657,Tran; Khoa Dang,39,0,80,41
1657461002906,CSE 21,A01,095574,Bach; Quang Tran,22,0,48,26
1657461008938,CSE 30,A01,083084,Eldon; John,5,0,80,75
1657461008938,CSE 30,B01,095061,Bhaskar; Nishant,9,0,50,41
1657461014965,CSE 100,A01,083659,Cao; Yingjun,5,4,70,65
1657461020991,CSE 134B,A01,083661,Powell; Thomas Allan,22,0,100,78
1657461027015,CSE 140,A01,083663,Gungor; Onat,15,0,85,70
1657461033040,CSE 140L,A01,083088,Eldon; John,21,0,100,79
1657461039081,CSE 175,A01,083665,Kumar; Rakesh,3,0,25,22
1657461045112,CSE 190,A00,092507,Dubnov; Shlomo,8,0,20,12
1657461051140,ECE 45,A01,083139,Congero; Spencer William,6,0,75,69
1657461057174,ECE 65,A50,083695,Saad; Andrew S,12,0,30,18
1657461057174,ECE 65,A51,095125,Saad; Andrew S,24,0,26,2
1657461063201,ECE 109,A01,091882,Touri; Behrouz,19,0,70,51
1657461069226,ECE 180,A00,083140,Abi Samra; Nicholas Camill,1,0,30,29
1657461069226,ECE 180,B00,083141,Abi Samra; Nicholas Camill,0,0,30,30
1657461075253,MATH 10A,A01,083735,Patchell; Gregory David,2,0,30,28
1657461075253,MATH 10A,A02,083736,Patchell; Gregory David,20,0,30,10
1657461075253,MATH 10A,A03,083737,Patchell; Gregory David,16,0,30,14
1657461081280,MATH 10B,A01,083207,Lim; Seonhee,8,0,34,26
1657461081280,MATH 10B,A02,083208,Lim; Seonhee,9,0,35,26
1657461081280,MATH 10B,A03,093472,Lim; Seonhee,7,0,34,27
1657461081280,MATH 10B,B01,083739,Sinha; Shubham,12,0,30,18
1657461087315,MATH 18,A01,083743,Cinel; Cameron Alexander,7,0,30,23
1657461087315,MATH 18,A02,083744,Cinel; Cameron Alexander,17,0,30,13
1657461087315,MATH 18,A03,083745,Cinel; Cameron Alexander,9,0,30,21
1657461087315,MATH 18,B01,083748,Rideout; David Porter,5,0,37,32
1657461087315,MATH 18,B02,083749,Rideout; David Porter,5,0,36,31
1657461087315,MATH 18,B03,083750,Rideout; David Porter,3,0,37,34
1657461087315,MATH 18,B04,083751,Rideout; David Porter,6,0,36,30
1657461087315,MATH 18,B05,093473,Rideout; David Porter,6,0,36,30
1657461087315,MATH 18,B06,093474,Rideout; David Porter,6,0,36,30
1657461093345,MATH 20A,A01,083754,Zheng; Zequn,14,0,40,26
1657461099382,MATH 20B,A01,083756,Briones; Jor-el Thomas Caparas,4,0,36,32
1657461099382,MATH 20B,A02,083757,Briones; Jor-el Thomas Caparas,1,0,36,35
1657461099382,MATH 20B,A03,093475,Briones; Jor-el Thomas Caparas,2,0,36,34
1657461105414,MATH 20C,A01,083760,Briones; Jor-el Thomas Caparas,1,0,35,34
1657461105414,MATH 20C,A02,083761,Briones; Jor-el Thomas Caparas,8,0,35,27
1657461105414,MATH 20C,A03,093476,Briones; Jor-el Thomas Caparas,0,1,36,36
1657461105414,MATH 20C,B01,083762,Bach; Quang Tran,1,0,30,29
1657461111444,MATH 20D,A01,083765,Tran; Brian Kha,5,0,30,25
1657461111444,MATH 20D,A02,083766,Tran; Brian Kha,5,0,30,25
1657461111444,MATH 20D,A03,083767,Tran; Brian Kha,5,0,30,25
1657461117476,MATH 20E,A01,083771,Ganguly; Soumya,9,0,32,23
1657461117476,MATH 20E,A02,083772,Ganguly; Soumya,6,0,32,26
1657461117476,MATH 20E,B01,083773,Ciotti; Benjamin,20,0,35,15
1657461117476,MATH 20E,B02,083774,Ciotti; Benjamin,17,0,35,18
1657461123507,MATH 103A,A01,083777,Greenfeld; Be'Eri,3,0,36,33
1657461123507,MATH 103A,A02,083778,Greenfeld; Be'Eri,5,0,36,31
1657461123507,MATH 103A,A03,093561,Greenfeld; Be'Eri,5,0,36,31
1657461123507,MATH 103A,B01,083779,Greenfeld; Be'Eri,7,0,36,29
1657461123507,MATH 103A,B02,083780,Greenfeld; Be'Eri,4,0,36,32
1657461123507,MATH 103A,B03,093562,Greenfeld; Be'Eri,3,0,36,33
1657461129535,MATH 105,A01,085443,Carter; Anne Toulson,15,0,35,20
1657461129535,MATH 105,A02,093477,Carter; Anne Toulson,20,0,35,15
1657461135562,MATH 109,A01,083213,Ganzberger; Geoffrey Michael,2,0,34,32
1657461135562,MATH 109,A02,083214,Ganzberger; Geoffrey Michael,4,0,34,30
1657461135562,MATH 109,A03,093478,Ganzberger; Geoffrey Michael,2,0,34,32
1657461135562,MATH 109,B01,083215,Ganzberger; Geoffrey Michael,1,0,32,31
1657461135562,MATH 109,B02,083216,Ganzberger; Geoffrey Michael,2,0,32,30
1657461135562,MATH 109,B03,093479,Ganzberger; Geoffrey Michael,8,0,32,24
1657461141597,MATH 142A,A01,083219,Chow; Bennett,7,0,32,25
1657461141597,MATH 142A,A02,083220,Chow; Bennett,10,0,32,22
1657461141597,MATH 142A,A03,093480,Chow; Bennett,8,0,32,24
1657461141597,MATH 142A,B03,093481,Chow; Bennett,8,0,32,24
1657461141597,MATH 142A,B04,093558,Chow; Bennett,13,0,32,19
1657461141597,MATH 142A,B05,093559,Chow; Bennett,6,0,32,26
1657461147622,MATH 193A,A01,083224,Rotar; Vladimir,8,0,34,26
1657461147622,MATH 193A,A02,083225,Rotar; Vladimir,9,0,34,25
1657461147622,MATH 193A,A03,083781,Rotar; Vladimir,5,0,34,29
1657461147622,MATH 193A,A04,083782,Rotar; Vladimir,10,0,34,24
1657461147622,MATH 193A,A05,093482,Rotar; Vladimir,10,0,34,24
1657461153649,MATH 197,001,091859,McAuley; Julian John,9999,0,9999,0
1657461153649,MATH 197,002,095566,Kedlaya; Kiran S.,9997,0,9999,2
1657461153649,MATH 197,003,095567,Xiao; Ming,9999,0,9999,0
1657461153649,MATH 197,004,095571,Perols; Johan Lars,9998,0,9999,1
1657461160725,COGS 9,A01,083615,Shannon; Kyle Michael,9,0,75,66
1657461166748,COGS 11,A01,083617,Boyle; Mary E. T.,22,0,48,26
1657461172773,COGS 13,A01,083071,Bastos; Amalia Pinkusfeld,11,0,71,60
1657461178796,COGS 14A,A01,092681,Semenuks; Arturs,5,1,100,95
1657461184820,COGS 14B,A01,083073,Cheng; Tzu-Han,6,0,63,57
1657461190845,COGS 17,A01,092677,Semenuks; Arturs,6,0,81,75
1657461196867,COGS 100,A01,083619,Allen; Michael Gordon,17,0,70,53
1657461202897,COGS 101A,A01,083621,Davis; Joshua Daniel,9,0,68,59
1657461208925,COGS 101B,A01,091572,Allen; Michael Gordon,12,0,65,53
1657461214954,COGS 101C,A01,083625,Delgado; Tania,17,0,35,18
1657461220980,COGS 107A,A01,083627,Boyle; Mary E. T.,13,0,60,47
1657461227008,COGS 118A,A01,083075,Gupta; Anjum,21,0,76,55
1657461233034,CSE 3,A50,083646,Miranda; Gregory Joseph,24,0,50,26
1657461239066,CSE 8A,A50,083650,Miranda; Gregory Joseph,17,1,56,39
1657461245092,CSE 11,A01,083080,Cao; Yingjun,6,15,40,34
1657461251122,CSE 12,A01,083652,Krause-Levy; Sophia Louisa,28,1,120,92
1657461257146,CSE 15L,A01,083654,Morris; Justin Loren,9,0,50,41
1657461257146,CSE 15L,A02,083655,Morris; Justin Loren,9,0,50,41
1657461263168,CSE 20,A01,083657,Tran; Khoa Dang,39,0,80,41
1657461269192,CSE 21,A01,095574,Bach; Quang Tran,22,0,48,26
1657461275221,CSE 30,A01,083084,Eldon; John,5,0,80,75
1657461275221,CSE 30,B01,095061,Bhaskar; Nishant,9,0,50,41
1657461281249,CSE 100,A01,083659,Cao; Yingjun,5,4,70,65
1657461287283,CSE 134B,A01,083661,Powell; Thomas Allan,22,0,100,78
1657461293308,CSE 140,A01,083663,Gungor; Onat,15,0,85,70
1657461299332,CSE 140L,A01,083088,Eldon; John,21,0,100,79
1657461305356,CSE 175,A01,083665,Kumar; Rakesh,3,0,25,22
1657461311385,CSE 190,A00,092507,Dubnov; Shlomo,8,0,20,12
1657461317485,ECE 45,A01,083139,Congero; Spencer William,6,0,75,69
1657461323508,ECE 65,A50,083695,Saad; Andrew S,12,0,30,18
1657461323508,ECE 65,A51,095125,Saad; Andrew S,24,0,26,2
1657461329531,ECE 109,A01,091882,Touri; Behrouz,19,0,70,51
1657461335556,ECE 180,A00,083140,Abi Samra; Nicholas Camill,1,0,30,29
1657461335556,ECE 180,B00,083141,Abi Samra; Nicholas Camill,0,0,30,30
1657461341584,MATH 10A,A01,083735,Patchell; Gregory David,2,0,30,28
1657461341584,MATH 10A,A02,083736,Patchell; Gregory David,20,0,30,10
1657461341584,MATH 10A,A03,083737,Patchell; Gregory David,16,0,30,14
1657461347607,MATH 10B,A01,083207,Lim; Seonhee,8,0,34,26
1657461347607,MATH 10B,A02,083208,Lim; Seonhee,9,0,35,26
1657461347607,MATH 10B,A03,093472,Lim; Seonhee,7,0,34,27
1657461347607,MATH 10B,B01,083739,Sinha; Shubham,12,0,30,18
1657461353631,MATH 18,A01,083743,Cinel; Cameron Alexander,7,0,30,23
1657461353631,MATH 18,A02,083744,Cinel; Cameron Alexander,17,0,30,13
1657461353631,MATH 18,A03,083745,Cinel; Cameron Alexander,9,0,30,21
1657461353631,MATH 18,B01,083748,Rideout; David Porter,5,0,37,32
1657461353631,MATH 18,B02,083749,Rideout; David Porter,5,0,36,31
1657461353631,MATH 18,B03,083750,Rideout; David Porter,3,0,37,34
1657461353631,MATH 18,B04,083751,Rideout; David Porter,6,0,36,30
1657461353631,MATH 18,B05,093473,Rideout; David Porter,6,0,36,30
1657461353631,MATH 18,B06,093474,Rideout; David Porter,6,0,36,30
1657461359655,MATH 20A,A01,083754,Zheng; Zequn,14,0,40,26
1657461365680,MATH 20B,A01,083756,Briones; Jor-el Thomas Caparas,4,0,36,32
1657461365680,MATH 20B,A02,083757,Briones; Jor-el Thomas Caparas,1,0,36,35
1657461365680,MATH 20B,A03,093475,Briones; Jor-el Thomas Caparas,2,0,36,34
1657461371710,MATH 20C,A01,083760,Briones; Jor-el Thomas Caparas,1,0,35,34
1657461371710,MATH 20C,A02,083761,Briones; Jor-el Thomas Caparas,8,0,35,27
1657461371710,MATH 20C,A03,093476,Briones; Jor-el Thomas Caparas,0,1,36,36
1657461371710,MATH 20C,B01,083762,Bach; Quang Tran,1,0,30,29
1657461377822,MATH 20D,A01,083765,Tran; Brian Kha,5,0,30,25
1657461377822,MATH 20D,A02,083766,Tran; Brian Kha,5,0,30,25
1657461377822,MATH 20D,A03,083767,Tran; Brian Kha,5,0,30,25
1657461383848,MATH 20E,A01,083771,Ganguly; Soumya,9,0,32,23
1657461383848,MATH 20E,A02,083772,Ganguly; Soumya,6,0,32,26
1657461383848,MATH 20E,B01,083773,Ciotti; Benjamin,20,0,35,15
1657461383848,MATH 20E,B02,083774,Ciotti; Benjamin,17,0,35,18
1657461389874,MATH 103A,A01,083777,Greenfeld; Be'Eri,3,0,36,33
1657461389874,MATH 103A,A02,083778,Greenfeld; Be'Eri,5,0,36,31
1657461389874,MATH 103A,A03,093561,Greenfeld; Be'Eri,5,0,36,31
1657461389874,MATH 103A,B01,083779,Greenfeld; Be'Eri,7,0,36,29
1657461389874,MATH 103A,B02,083780,Greenfeld; Be'Eri,4,0,36,32
1657461389874,MATH 103A,B03,093562,Greenfeld; Be'Eri,3,0,36,33
1657461395897,MATH 105,A01,085443,Carter; Anne Toulson,15,0,35,20
1657461395897,MATH 105,A02,093477,Carter; Anne Toulson,20,0,35,15
1657461401927,MATH 109,A01,083213,Ganzberger; Geoffrey Michael,2,0,34,32
1657461401927,MATH 109,A02,083214,Ganzberger; Geoffrey Michael,4,0,34,30
1657461401927,MATH 109,A03,093478,Ganzberger; Geoffrey Michael,2,0,34,32
1657461401927,MATH 109,B01,083215,Ganzberger; Geoffrey Michael,1,0,32,31
1657461401927,MATH 109,B02,083216,Ganzberger; Geoffrey Michael,2,0,32,30
1657461401927,MATH 109,B03,093479,Ganzberger; Geoffrey Michael,8,0,32,24
1657461407950,MATH 142A,A01,083219,Chow; Bennett,7,0,32,25
1657461407950,MATH 142A,A02,083220,Chow; Bennett,10,0,32,22
1657461407950,MATH 142A,A03,093480,Chow; Bennett,8,0,32,24
1657461407950,MATH 142A,B03,093481,Chow; Bennett,8,0,32,24
1657461407950,MATH 142A,B04,093558,Chow; Bennett,13,0,32,19
1657461407950,MATH 142A,B05,093559,Chow; Bennett,6,0,32,26
1657461413976,MATH 193A,A01,083224,Rotar; Vladimir,8,0,34,26
1657461413976,MATH 193A,A02,083225,Rotar; Vladimir,9,0,34,25
1657461413976,MATH 193A,A03,083781,Rotar; Vladimir,5,0,34,29
1657461413976,MATH 193A,A04,083782,Rotar; Vladimir,10,0,34,24
1657461413976,MATH 193A,A05,093482,Rotar; Vladimir,10,0,34,24
1657461420004,MATH 197,001,091859,McAuley; Julian John,9999,0,9999,0
1657461420004,MATH 197,002,095566,Kedlaya; Kiran S.,9997,0,9999,2
1657461420004,MATH 197,003,095567,Xiao; Ming,9999,0,9999,0
1657461420004,MATH 197,004,095571,Perols; Johan Lars,9998,0,9999,1
1657461427062,COGS 9,A01,083615,Shannon; Kyle Michael,9,0,75,66
1657461433086,COGS 11,A01,083617,Boyle; Mary E. T.,22,0,48,26
1657461439110,COGS 13,A01,083071,Bastos; Amalia Pinkusfeld,11,0,71,60
1657461445134,COGS 14A,A01,092681,Semenuks; Arturs,5,1,100,95
1657461451158,COGS 14B,A01,083073,Cheng; Tzu-Han,6,0,63,57
1657461457182,COGS 17,A01,092677,Semenuks; Arturs,6,0,81,75
1657461463204,COGS 100,A01,083619,Allen; Michael Gordon,17,0,70,53
1657461469229,COGS 101A,A01,083621,Davis; Joshua Daniel,9,0,68,59
1657461475261,COGS 101B,A01,091572,Allen; Michael Gordon,12,0,65,53
1657461481290,COGS 101C,A01,083625,Delgado; Tania,17,0,35,18
1657461487315,COGS 107A,A01,083627,Boyle; Mary E. T.,13,0,60,47
1657461493339,COGS 118A,A01,083075,Gupta; Anjum,21,0,76,55
1657461499369,CSE 3,A50,083646,Miranda; Gregory Joseph,24,0,50,26
1657461505392,CSE 8A,A50,083650,Miranda; Gregory Joseph,17,1,56,39
1657461511416,CSE 11,A01,083080,Cao; Yingjun,6,15,40,34
1657461517444,CSE 12,A01,083652,Krause-Levy; Sophia Louisa,28,1,120,92
1657461523472,CSE 15L,A01,083654,Morris; Justin Loren,9,0,50,41
1657461523472,CSE 15L,A02,083655,Morris; Justin Loren,9,0,50,41
1657461529497,CSE 20,A01,083657,Tran; Khoa Dang,39,0,80,41
1657461535523,CSE 21,A01,095574,Bach; Quang Tran,22,0,48,26
1657461541548,CSE 30,A01,083084,Eldon; John,5,0,80,75
1657461541548,CSE 30,B01,095061,Bhaskar; Nishant,9,0,50,41
1657461547576,CSE 100,A01,083659,Cao; Yingjun,5,4,70,65
1657461553603,CSE 134B,A01,083661,Powell; Thomas Allan,22,0,100,78
1657461559632,CSE 140,A01,083663,Gungor; Onat,15,0,85,70
1657461565660,CSE 140L,A01,083088,Eldon; John,21,0,100,79
1657461571686,CSE 175,A01,083665,Kumar; Rakesh,3,0,25,22
1657461577716,CSE 190,A00,092507,Dubnov; Shlomo,8,0,20,12
1657461583740,ECE 45,A01,083139,Congero; Spencer William,6,0,75,69
1657461589762,ECE 65,A50,083695,Saad; Andrew S,12,0,30,18
1657461589762,ECE 65,A51,095125,Saad; Andrew S,24,0,26,2
1657461595785,ECE 109,A01,091882,Touri; Behrouz,19,0,70,51
1657461601812,ECE 180,A00,083140,Abi Samra; Nicholas Camill,1,0,30,29
1657461601812,ECE 180,B00,083141,Abi Samra; Nicholas Camill,0,0,30,30
1657461607837,MATH 10A,A01,083735,Patchell; Gregory David,2,0,30,28
1657461607837,MATH 10A,A02,083736,Patchell; Gregory David,20,0,30,10
1657461607837,MATH 10A,A03,083737,Patchell; Gregory David,16,0,30,14
1657461613867,MATH 10B,A01,083207,Lim; Seonhee,8,0,34,26
1657461613867,MATH 10B,A02,083208,Lim; Seonhee,9,0,35,26
1657461613867,MATH 10B,A03,093472,Lim; Seonhee,7,0,34,27
1657461613867,MATH 10B,B01,083739,Sinha; Shubham,12,0,30,18
1657461619898,MATH 18,A01,083743,Cinel; Cameron Alexander,7,0,30,23
1657461619898,MATH 18,A02,083744,Cinel; Cameron Alexander,17,0,30,13
1657461619898,MATH 18,A03,083745,Cinel; Cameron Alexander,9,0,30,21
1657461619898,MATH 18,B01,083748,Rideout; David Porter,5,0,37,32
1657461619898,MATH 18,B02,083749,Rideout; David Porter,5,0,36,31
1657461619898,MATH 18,B03,083750,Rideout; David Porter,3,0,37,34
1657461619898,MATH 18,B04,083751,Rideout; David Porter,6,0,36,30
1657461619898,MATH 18,B05,093473,Rideout; David Porter,6,0,36,30
1657461619898,MATH 18,B06,093474,Rideout; David Porter,6,0,36,30
1657461625924,MATH 20A,A01,083754,Zheng; Zequn,14,0,40,26
1657461631950,MATH 20B,A01,083756,Briones; Jor-el Thomas Caparas,4,0,36,32
1657461631950,MATH 20B,A02,083757,Briones; Jor-el Thomas Caparas,1,0,36,35
1657461631950,MATH 20B,A03,093475,Briones; Jor-el Thomas Caparas,2,0,36,34
1657461637972,MATH 20C,A01,083760,Briones; Jor-el Thomas Caparas,1,0,35,34
1657461637972,MATH 20C,A02,083761,Briones; Jor-el Thomas Caparas,8,0,35,27
1657461637972,MATH 20C,A03,093476,Briones; Jor-el Thomas Caparas,0,1,36,36
1657461637972,MATH 20C,B01,083762,Bach; Quang Tran,1,0,30,29
1657461643997,MATH 20D,A01,083765,Tran; Brian Kha,5,0,30,25
1657461643997,MATH 20D,A02,083766,Tran; Brian Kha,5,0,30,25
1657461643997,MATH 20D,A03,083767,Tran; Brian Kha,5,0,30,25
1657461650025,MATH 20E,A01,083771,Ganguly; Soumya,9,0,32,23
1657461650025,MATH 20E,A02,083772,Ganguly; Soumya,6,0,32,26
1657461650025,MATH 20E,B01,083773,Ciotti; Benjamin,20,0,35,15
1657461650025,MATH 20E,B02,083774,Ciotti; Benjamin,17,0,35,18
1657461656054,MATH 103A,A01,083777,Greenfeld; Be'Eri,3,0,36,33
1657461656054,MATH 103A,A02,083778,Greenfeld; Be'Eri,5,0,36,31
1657461656054,MATH 103A,A03,093561,Greenfeld; Be'Eri,5,0,36,31
1657461656054,MATH 103A,B01,083779,Greenfeld; Be'Eri,7,0,36,29
1657461656054,MATH 103A,B02,083780,Greenfeld; Be'Eri,4,0,36,32
1657461656054,MATH 103A,B03,093562,Greenfeld; Be'Eri,3,0,36,33
1657461662087,MATH 105,A01,085443,Carter; Anne Toulson,15,0,35,20
1657461662087,MATH 105,A02,093477,Carter; Anne Toulson,20,0,35,15
1657461668112,MATH 109,A01,083213,Ganzberger; Geoffrey Michael,2,0,34,32
1657461668112,MATH 109,A02,083214,Ganzberger; Geoffrey Michael,4,0,34,30
1657461668112,MATH 109,A03,093478,Ganzberger; Geoffrey Michael,2,0,34,32
1657461668112,MATH 109,B01,083215,Ganzberger; Geoffrey Michael,1,0,32,31
1657461668112,MATH 109,B02,083216,Ganzberger; Geoffrey Michael,2,0,32,30
1657461668112,MATH 109,B03,093479,Ganzberger; Geoffrey Michael,8,0,32,24
1657461674142,MATH 142A,A01,083219,Chow; Bennett,7,0,32,25
1657461674142,MATH 142A,A02,083220,Chow; Bennett,10,0,32,22
1657461674142,MATH 142A,A03,093480,Chow; Bennett,8,0,32,24
1657461674142,MATH 142A,B03,093481,Chow; Bennett,8,0,32,24
1657461674142,MATH 142A,B04,093558,Chow; Bennett,13,0,32,19
1657461674142,MATH 142A,B05,093559,Chow; Bennett,6,0,32,26
1657461680169,MATH 193A,A01,083224,Rotar; Vladimir,8,0,34,26
1657461680169,MATH 193A,A02,083225,Rotar; Vladimir,9,0,34,25
1657461680169,MATH 193A,A03,083781,Rotar; Vladimir,5,0,34,29
1657461680169,MATH 193A,A04,083782,Rotar; Vladimir,10,0,34,24
1657461680169,MATH 193A,A05,093482,Rotar; Vladimir,10,0,34,24
1657461686197,MATH 197,001,091859,McAuley; Julian John,9999,0,9999,0
1657461686197,MATH 197,002,095566,Kedlaya; Kiran S.,9997,0,9999,2
1657461686197,MATH 197,003,095567,Xiao; Ming,9999,0,9999,0
1657461686197,MATH 197,004,095571,Perols; Johan Lars,9998,0,9999,1
1657461693257,COGS 9,A01,083615,Shannon; Kyle Michael,9,0,75,66
1657461699288,COGS 11,A01,083617,Boyle; Mary E. T.,22,0,48,26
1657461705312,COGS 13,A01,083071,Bastos; Amalia Pinkusfeld,11,0,71,60
1657461711337,COGS 14A,A01,092681,Semenuks; Arturs,5,1,100,95
1657461717361,COGS 14B,A01,083073,Cheng; Tzu-Han,6,0,63,57
1657461723388,COGS 17,A01,092677,Semenuks; Arturs,6,0,81,75
1657461729420,COGS 100,A01,083619,Allen; Michael Gordon,17,0,70,53
1657461735443,COGS 101A,A01,083621,Davis; Joshua Daniel,9,0,68,59
1657461741478,COGS 101B,A01,091572,Allen; Michael Gordon,12,0,65,53
1657461747507,COGS 101C,A01,083625,Delgado; Tania,17,0,35,18
1657461753532,COGS 107A,A01,083627,Boyle; Mary E. T.,13,0,60,47
1657461759556,COGS 118A,A01,083075,Gupta; Anjum,21,0,76,55
1657461765581,CSE 3,A50,083646,Miranda; Gregory Joseph,24,0,50,26
1657461771605,CSE 8A,A50,083650,Miranda; Gregory Joseph,17,1,56,39
1657461777629,CSE 11,A01,083080,Cao; Yingjun,6,15,40,34
1657461783655,CSE 12,A01,083652,Krause-Levy; Sophia Louisa,28,1,120,92
1657461789684,CSE 15L,A01,083654,Morris; Justin Loren,9,0,50,41
1657461789684,CSE 15L,A02,083655,Morris; Justin Loren,9,0,50,41
1657461795711,CSE 20,A01,083657,Tran; Khoa Dang,39,0,80,41
1657461801733,CSE 21,A01,095574,Bach; Quang Tran,22,0,48,26
1657461807754,CSE 30,A01,083084,Eldon; John,5,0,80,75
1657461807754,CSE 30,B01,095061,Bhaskar; Nishant,9,0,50,41
1657461813782,CSE 100,A01,083659,Cao; Yingjun,5,4,70,65
1657461819808,CSE 134B,A01,083661,Powell; Thomas Allan,22,0,100,78
1657461825836,CSE 140,A01,083663,Gungor; Onat,15,0,85,70
1657461831865,CSE 140L,A01,083088,Eldon; John,21,0,100,79
1657461837889,CSE 175,A01,083665,Kumar; Rakesh,3,0,25,22
1657461843916,CSE 190,A00,092507,Dubnov; Shlomo,8,0,20,12
1657461849945,ECE 45,A01,083139,Congero; Spencer William,6,0,75,69
1657461855972,ECE 65,A50,083695,Saad; Andrew S,12,0,30,18
1657461855972,ECE 65,A51,095125,Saad; Andrew S,24,0,26,2
1657461861997,ECE 109,A01,091882,Touri; Behrouz,19,0,70,51
1657461868023,ECE 180,A00,083140,Abi Samra; Nicholas Camill,1,0,30,29
1657461868023,ECE 180,B00,083141,Abi Samra; Nicholas Camill,0,0,30,30
1657461874047,MATH 10A,A01,083735,Patchell; Gregory David,2,0,30,28
1657461874047,MATH 10A,A02,083736,Patchell; Gregory David,20,0,30,10
1657461874047,MATH 10A,A03,083737,Patchell; Gregory David,16,0,30,14
1657461880078,MATH 10B,A01,083207,Lim; Seonhee,8,0,34,26
1657461880078,MATH 10B,A02,083208,Lim; Seonhee,9,0,35,26
1657461880078,MATH 10B,A03,093472,Lim; Seonhee,7,0,34,27
1657461880078,MATH 10B,B01,083739,Sinha; Shubham,12,0,30,18
1657461886112,MATH 18,A01,083743,Cinel; Cameron Alexander,7,0,30,23
1657461886112,MATH 18,A02,083744,Cinel; Cameron Alexander,17,0,30,13
1657461886112,MATH 18,A03,083745,Cinel; Cameron Alexander,9,0,30,21
1657461886112,MATH 18,B01,083748,Rideout; David Porter,5,0,37,32
1657461886112,MATH 18,B02,083749,Rideout; David Porter,5,0,36,31
1657461886112,MATH 18,B03,083750,Rideout; David Porter,3,0,37,34
1657461886112,MATH 18,B04,083751,Rideout; David Porter,6,0,36,30
1657461886112,MATH 18,B05,093473,Rideout; David Porter,6,0,36,30
1657461886112,MATH 18,B06,093474,Rideout; David Porter,6,0,36,30
1657461892139,MATH 20A,A01,083754,Zheng; Zequn,14,0,40,26
1657461898169,MATH 20B,A01,083756,Briones; Jor-el Thomas Caparas,4,0,36,32
1657461898169,MATH 20B,A02,083757,Briones; Jor-el Thomas Caparas,1,0,36,35
1657461898169,MATH 20B,A03,093475,Briones; Jor-el Thomas Caparas,2,0,36,34
1657461904194,MATH 20C,A01,083760,Briones; Jor-el Thomas Caparas,1,0,35,34
1657461904194,MATH 20C,A02,083761,Briones; Jor-el Thomas Caparas,8,0,35,27
1657461904194,MATH 20C,A03,093476,Briones; Jor-el Thomas Caparas,0,1,36,36
1657461904194,MATH 20C,B01,083762,Bach; Quang Tran,1,0,30,29
1657461910217,MATH 20D,A01,083765,Tran; Brian Kha,5,0,30,25
1657461910217,MATH 20D,A02,083766,Tran; Brian Kha,5,0,30,25
1657461910217,MATH 20D,A03,083767,Tran; Brian Kha,5,0,30,25
1657461916312,MATH 20E,A01,083771,Ganguly; Soumya,9,0,32,23
1657461916312,MATH 20E,A02,083772,Ganguly; Soumya,6,0,32,26
1657461916312,MATH 20E,B01,083773,Ciotti; Benjamin,20,0,35,15
1657461916312,MATH 20E,B02,083774,Ciotti; Benjamin,17,0,35,18
1657461922339,MATH 103A,A01,083777,Greenfeld; Be'Eri,3,0,36,33
1657461922339,MATH 103A,A02,083778,Greenfeld; Be'Eri,5,0,36,31
1657461922339,MATH 103A,A03,093561,Greenfeld; Be'Eri,5,0,36,31
1657461922339,MATH 103A,B01,083779,Greenfeld; Be'Eri,7,0,36,29
1657461922339,MATH 103A,B02,083780,Greenfeld; Be'Eri,4,0,36,32
1657461922339,MATH 103A,B03,093562,Greenfeld; Be'Eri,3,0,36,33
1657461928363,MATH 105,A01,085443,Carter; Anne Toulson,15,0,35,20
1657461928363,MATH 105,A02,093477,Carter; Anne Toulson,20,0,35,15
1657461934393,MATH 109,A01,083213,Ganzberger; Geoffrey Michael,2,0,34,32
1657461934393,MATH 109,A02,083214,Ganzberger; Geoffrey Michael,4,0,34,30
1657461934393,MATH 109,A03,093478,Ganzberger; Geoffrey Michael,2,0,34,32
1657461934393,MATH 109,B01,083215,Ganzberger; Geoffrey Michael,1,0,32,31
1657461934393,MATH 109,B02,083216,Ganzberger; Geoffrey Michael,2,0,32,30
1657461934393,MATH 109,B03,093479,Ganzberger; Geoffrey Michael,8,0,32,24
1657461940420,MATH 142A,A01,083219,Chow; Bennett,7,0,32,25
1657461940420,MATH 142A,A02,083220,Chow; Bennett,10,0,32,22
1657461940420,MATH 142A,A03,093480,Chow; Bennett,8,0,32,24
1657461940420,MATH 142A,B03,093481,Chow; Bennett,8,0,32,24
1657461940420,MATH 142A,B04,093558,Chow; Bennett,13,0,32,19
1657461940420,MATH 142A,B05,093559,Chow; Bennett,6,0,32,26
1657461946444,MATH 193A,A01,083224,Rotar; Vladimir,8,0,34,26
1657461946444,MATH 193A,A02,083225,Rotar; Vladimir,9,0,34,25
1657461946444,MATH 193A,A03,083781,Rotar; Vladimir,5,0,34,29
1657461946444,MATH 193A,A04,083782,Rotar; Vladimir,10,0,34,24
1657461946444,MATH 193A,A05,093482,Rotar; Vladimir,10,0,34,24
1657461952469,MATH 197,001,091859,McAuley; Julian John,9999,0,9999,0
1657461952469,MATH 197,002,095566,Kedlaya; Kiran S.,9997,0,9999,2
1657461952469,MATH 197,003,095567,Xiao; Ming,9999,0,9999,0
1657461952469,MATH 197,004,095571,Perols; Johan Lars,9998,0,9999,1
1657461959524,COGS 9,A01,083615,Shannon; Kyle Michael,9,0,75,66
1657461965549,COGS 11,A01,083617,Boyle; Mary E. T.,22,0,48,26
1657461971575,COGS 13,A01,083071,Bastos; Amalia Pinkusfeld,11,0,71,60
1657461977602,COGS 14A,A01,092681,Semenuks; Arturs,5,1,100,95
1657461983632,COGS 14B,A01,083073,Cheng; Tzu-Han,6,0,63,57
1657461989656,COGS 17,A01,092677,Semenuks; Arturs,6,0,81,75
1657461995679,COGS 100,A01,083619,Allen; Michael Gordon,17,0,70,53
1657462001701,COGS 101A,A01,083621,Davis; Joshua Daniel,9,0,68,59
1657462007723,COGS 101B,A01,091572,Allen; Michael Gordon,12,0,65,53
1657462013748,COGS 101C,A01,083625,Delgado; Tania,17,0,35,18
1657462019771,COGS 107A,A01,083627,Boyle; Mary E. T.,13,0,60,47
1657462025795,COGS 118A,A01,083075,Gupta; Anjum,21,0,76,55
1657462031819,CSE 3,A50,083646,Miranda; Gregory Joseph,24,0,50,26
1657462037844,CSE 8A,A50,083650,Miranda; Gregory Joseph,17,1,56,39
1657462043867,CSE 11,A01,083080,Cao; Yingjun,6,15,40,34
1657462049892,CSE 12,A01,083652,Krause-Levy; Sophia Louisa,28,1,120,92
1657462055921,CSE 15L,A01,083654,Morris; Justin Loren,9,0,50,41
1657462055921,CSE 15L,A02,083655,Morris; Justin Loren,9,0,50,41
1657462061949,CSE 20,A01,083657,Tran; Khoa Dang,39,0,80,41
1657462067978,CSE 21,A01,095574,Bach; Quang Tran,22,0,48,26
1657462074002,CSE 30,A01,083084,Eldon; John,5,0,80,75
1657462074002,CSE 30,B01,095061,Bhaskar; Nishant,9,0,50,41
1657462080034,CSE 100,A01,083659,Cao; Yingjun,5,4,70,65
1657462086062,CSE 134B,A01,083661,Powell; Thomas Allan,22,0,100,78
1657462092089,CSE 140,A01,083663,Gungor; Onat,15,0,85,70
1657462098116,CSE 140L,A01,083088,Eldon; John,21,0,100,79
1657462104141,CSE 175,A01,083665,Kumar; Rakesh,3,0,25,22
1657462110164,CSE 190,A00,092507,Dubnov; Shlomo,8,0,20,12
1657462116189,ECE 45,A01,083139,Congero; Spencer William,6,0,75,69
1657462122220,ECE 65,A50,083695,Saad; Andrew S,12,0,30,18
1657462122220,ECE 65,A51,095125,Saad; Andrew S,24,0,26,2
1657462128244,ECE 109,A01,091882,Touri; Behrouz,19,0,70,51
1657462134272,ECE 180,A00,083140,Abi Samra; Nicholas Camill,1,0,30,29
1657462134272,ECE 180,B00,083141,Abi Samra; Nicholas Camill,0,0,30,30
1657462140299,MATH 10A,A01,083735,Patchell; Gregory David,2,0,30,28
1657462140299,MATH 10A,A02,083736,Patchell; Gregory David,20,0,30,10
1657462140299,MATH 10A,A03,083737,Patchell; Gregory David,16,0,30,14
1657462146329,MATH 10B,A01,083207,Lim; Seonhee,8,0,34,26
1657462146329,MATH 10B,A02,083208,Lim; Seonhee,9,0,35,26
1657462146329,MATH 10B,A03,093472,Lim; Seonhee,7,0,34,27
1657462146329,MATH 10B,B01,083739,Sinha; Shubham,12,0,30,18
1657462152354,MATH 18,A01,083743,Cinel; Cameron Alexander,7,0,30,23
1657462152354,MATH 18,A02,083744,Cinel; Cameron Alexander,17,0,30,13
1657462152354,MATH 18,A03,083745,Cinel; Cameron Alexander,9,0,30,21
1657462152354,MATH 18,B01,083748,Rideout; David Porter,5,0,37,32
1657462152354,MATH 18,B02,083749,Rideout; David Porter,5,0,36,31
1657462152354,MATH 18,B03,083750,Rideout; David Porter,3,0,37,34
1657462152354,MATH 18,B04,083751,Rideout; David Porter,6,0,36,30
1657462152354,MATH 18,B05,093473,Rideout; David Porter,6,0,36,30
1657462152354,MATH 18,B06,093474,Rideout; David Porter,6,0,36,30
1657462158381,MATH 20A,A01,083754,Zheng; Zequn,14,0,40,26
1657462164411,MATH 20B,A01,083756,Briones; Jor-el Thomas Caparas,4,0,36,32
1657462164411,MATH 20B,A02,083757,Briones; Jor-el Thomas Caparas,1,0,36,35
1657462164411,MATH 20B,A03,093475,Briones; Jor-el Thomas Caparas,2,0,36,34
1657462170434,MATH 20C,A01,083760,Briones; Jor-el Thomas Caparas,1,0,35,34
1657462170434,MATH 20C,A02,083761,Briones; Jor-el Thomas Caparas,8,0,35,27
1657462170434,MATH 20C,A03,093476,Briones; Jor-el Thomas Caparas,0,1,36,36
1657462170434,MATH 20C,B01,083762,Bach; Quang Tran,1,0,30,29
1657462176464,MATH 20D,A01,083765,Tran; Brian Kha,5,0,30,25
1657462176464,MATH 20D,A02,083766,Tran; Brian Kha,5,0,30,25
1657462176464,MATH 20D,A03,083767,Tran; Brian Kha,5,0,30,25
1657462182491,MATH 20E,A01,083771,Ganguly; Soumya,9,0,32,23
1657462182491,MATH 20E,A02,083772,Ganguly; Soumya,6,0,32,26
1657462182491,MATH 20E,B01,083773,Ciotti; Benjamin,20,0,35,15
1657462182491,MATH 20E,B02,083774,Ciotti; Benjamin,17,0,35,18
1657462188522,MATH 103A,A01,083777,Greenfeld; Be'Eri,3,0,36,33
1657462188522,MATH 103A,A02,083778,Greenfeld; Be'Eri,5,0,36,31
1657462188522,MATH 103A,A03,093561,Greenfeld; Be'Eri,5,0,36,31
1657462188522,MATH 103A,B01,083779,Greenfeld; Be'Eri,7,0,36,29
1657462188522,MATH 103A,B02,083780,Greenfeld; Be'Eri,4,0,36,32
1657462188522,MATH 103A,B03,093562,Greenfeld; Be'Eri,3,0,36,33
1657462194549,MATH 105,A01,085443,Carter; Anne Toulson,15,0,35,20
1657462194549,MATH 105,A02,093477,Carter; Anne Toulson,20,0,35,15
1657462200585,MATH 109,A01,083213,Ganzberger; Geoffrey Michael,2,0,34,32
1657462200585,MATH 109,A02,083214,Ganzberger; Geoffrey Michael,4,0,34,30
1657462200585,MATH 109,A03,093478,Ganzberger; Geoffrey Michael,2,0,34,32
1657462200585,MATH 109,B01,083215,Ganzberger; Geoffrey Michael,1,0,32,31
1657462200585,MATH 109,B02,083216,Ganzberger; Geoffrey Michael,2,0,32,30
1657462200585,MATH 109,B03,093479,Ganzberger; Geoffrey Michael,8,0,32,24
1657462206609,MATH 142A,A01,083219,Chow; Bennett,7,0,32,25
1657462206609,MATH 142A,A02,083220,Chow; Bennett,10,0,32,22
1657462206609,MATH 142A,A03,093480,Chow; Bennett,8,0,32,24
1657462206609,MATH 142A,B03,093481,Chow; Bennett,8,0,32,24
1657462206609,MATH 142A,B04,093558,Chow; Bennett,13,0,32,19
1657462206609,MATH 142A,B05,093559,Chow; Bennett,6,0,32,26
1657462212648,MATH 193A,A01,083224,Rotar; Vladimir,8,0,34,26
1657462212648,MATH 193A,A02,083225,Rotar; Vladimir,9,0,34,25
1657462212648,MATH 193A,A03,083781,Rotar; Vladimir,5,0,34,29
1657462212648,MATH 193A,A04,083782,Rotar; Vladimir,10,0,34,24
1657462212648,MATH 193A,A05,093482,Rotar; Vladimir,10,0,34,24
1657462218676,MATH 197,001,091859,McAuley; Julian John,9999,0,9999,0
1657462218676,MATH 197,002,095566,Kedlaya; Kiran S.,9997,0,9999,2
1657462218676,MATH 197,003,095567,Xiao; Ming,9999,0,9999,0
1657462218676,MATH 197,004,095571,Perols; Johan Lars,9998,0,9999,1
1657462225749,COGS 9,A01,083615,Shannon; Kyle Michael,9,0,75,66
1657462231773,COGS 11,A01,083617,Boyle; Mary E. T.,22,0,48,26
1657462237795,COGS 13,A01,083071,Bastos; Amalia Pinkusfeld,11,0,71,60
1657462243820,COGS 14A,A01,092681,Semenuks; Arturs,5,1,100,95
1657462249843,COGS 14B,A01,083073,Cheng; Tzu-Han,6,0,63,57
1657462255870,COGS 17,A01,092677,Semenuks; Arturs,6,0,81,75
1657462261895,COGS 100,A01,083619,Allen; Michael Gordon,17,0,70,53
1657462267927,COGS 101A,A01,083621,Davis; Joshua Daniel,9,0,68,59
1657462273950,COGS 101B,A01,091572,Allen; Michael Gordon,12,0,65,53
1657462279974,COGS 101C,A01,083625,Delgado; Tania,17,0,35,18
1657462286001,COGS 107A,A01,083627,Boyle; Mary E. T.,13,0,60,47
1657462292030,COGS 118A,A01,083075,Gupta; Anjum,21,0,76,55
1657462298056,CSE 3,A50,083646,Miranda; Gregory Joseph,24,0,50,26
1657462304081,CSE 8A,A50,083650,Miranda; Gregory Joseph,17,1,56,39
1657462310104,CSE 11,A01,083080,Cao; Yingjun,6,15,40,34
1657462316138,CSE 12,A01,083652,Krause-Levy; Sophia Louisa,28,1,120,92
1657462322171,CSE 15L,A01,083654,Morris; Justin Loren,9,0,50,41
1657462322171,CSE 15L,A02,083655,Morris; Justin Loren,9,0,50,41
1657462328194,CSE 20,A01,083657,Tran; Khoa Dang,39,0,80,41
1657462334218,CSE 21,A01,095574,Bach; Quang Tran,22,0,48,26
1657462340242,CSE 30,A01,083084,Eldon; John,5,0,80,75
1657462340242,CSE 30,B01,095061,Bhaskar; Nishant,9,0,50,41
1657462346266,CSE 100,A01,083659,Cao; Yingjun,5,4,70,65
1657462352292,CSE 134B,A01,083661,Powell; Thomas Allan,22,0,100,78
1657462358316,CSE 140,A01,083663,Gungor; Onat,15,0,85,70
1657462364341,CSE 140L,A01,083088,Eldon; John,21,0,100,79
1657462370365,CSE 175,A01,083665,Kumar; Rakesh,3,0,25,22
1657462376390,CSE 190,A00,092507,Dubnov; Shlomo,8,0,20,12
1657462382416,ECE 45,A01,083139,Congero; Spencer William,6,0,75,69
1657462388443,ECE 65,A50,083695,Saad; Andrew S,12,0,30,18
1657462388443,ECE 65,A51,095125,Saad; Andrew S,24,0,26,2
1657462394467,ECE 109,A01,091882,Touri; Behrouz,19,0,70,51
1657462400491,ECE 180,A00,083140,Abi Samra; Nicholas Camill,1,0,30,29
1657462400491,ECE 180,B00,083141,Abi Samra; Nicholas Camill,0,0,30,30
1657462406521,MATH 10A,A01,083735,Patchell; Gregory David,2,0,30,28
1657462406521,MATH 10A,A02,083736,Patchell; Gregory David,20,0,30,10
1657462406521,MATH 10A,A03,083737,Patchell; Gregory David,16,0,30,14
1657462412555,MATH 10B,A01,083207,Lim; Seonhee,8,0,34,26
1657462412555,MATH 10B,A02,083208,Lim; Seonhee,9,0,35,26
1657462412555,MATH 10B,A03,093472,Lim; Seonhee,7,0,34,27
1657462412555,MATH 10B,B01,083739,Sinha; Shubham,12,0,30,18
1657462418582,MATH 18,A01,083743,Cinel; Cameron Alexander,7,0,30,23
1657462418582,MATH 18,A02,083744,Cinel; Cameron Alexander,17,0,30,13
1657462418582,MATH 18,A03,083745,Cinel; Cameron Alexander,9,0,30,21
1657462418582,MATH 18,B01,083748,Rideout; David Porter,5,0,37,32
1657462418582,MATH 18,B02,083749,Rideout; David Porter,5,0,36,31
1657462418582,MATH 18,B03,083750,Rideout; David Porter,3,0,37,34
1657462418582,MATH 18,B04,083751,Rideout; David Porter,6,0,36,30
1657462418582,MATH 18,B05,093473,Rideout; David Porter,6,0,36,30
1657462418582,MATH 18,B06,093474,Rideout; David Porter,6,0,36,30
1657462424605,MATH 20A,A01,083754,Zheng; Zequn,14,0,40,26
1657462430633,MATH 20B,A01,083756,Briones; Jor-el Thomas Caparas,4,0,36,32
1657462430633,MATH 20B,A02,083757,Briones; Jor-el Thomas Caparas,1,0,36,35
1657462430633,MATH 20B,A03,093475,Briones; Jor-el Thomas Caparas,2,0,36,34
1657462436664,MATH 20C,A01,083760,Briones; Jor-el Thomas Caparas,1,0,35,34
1657462436664,MATH 20C,A02,083761,Briones; Jor-el Thomas Caparas,8,0,35,27
1657462436664,MATH 20C,A03,093476,Briones; Jor-el Thomas Caparas,0,1,36,36
1657462436664,MATH 20C,B01,083762,Bach; Quang Tran,1,0,30,29
1657462442690,MATH 20D,A01,083765,Tran; Brian Kha,5,0,30,25
1657462442690,MATH 20D,A02,083766,Tran; Brian Kha,5,0,30,25
1657462442690,MATH 20D,A03,083767,Tran; Brian Kha,5,0,30,25
1657462448734,MATH 20E,A01,083771,Ganguly; Soumya,9,0,32,23
1657462448734,MATH 20E,A02,083772,Ganguly; Soumya,6,0,32,26
1657462448734,MATH 20E,B01,083773,Ciotti; Benjamin,20,0,35,15
1657462448734,MATH 20E,B02,083774,Ciotti; Benjamin,17,0,35,18
1657462454759,MATH 103A,A01,083777,Greenfeld; Be'Eri,3,0,36,33
1657462454759,MATH 103A,A02,083778,Greenfeld; Be'Eri,5,0,36,31
1657462454759,MATH 103A,A03,093561,Greenfeld; Be'Eri,5,0,36,31
1657462454759,MATH 103A,B01,083779,Greenfeld; Be'Eri,7,0,36,29
1657462454759,MATH 103A,B02,083780,Greenfeld; Be'Eri,4,0,36,32
1657462454759,MATH 103A,B03,093562,Greenfeld; Be'Eri,3,0,36,33
1657462460790,MATH 105,A01,085443,Carter; Anne Toulson,15,0,35,20
1657462460790,MATH 105,A02,093477,Carter; Anne Toulson,20,0,35,15
1657462466821,MATH 109,A01,083213,Ganzberger; Geoffrey Michael,2,0,34,32
1657462466821,MATH 109,A02,083214,Ganzberger; Geoffrey Michael,4,0,34,30
1657462466821,MATH 109,A03,093478,Ganzberger; Geoffrey Michael,2,0,34,32
1657462466821,MATH 109,B01,083215,Ganzberger; Geoffrey Michael,1,0,32,31
1657462466821,MATH 109,B02,083216,Ganzberger; Geoffrey Michael,2,0,32,30
1657462466821,MATH 109,B03,093479,Ganzberger; Geoffrey Michael,8,0,32,24
1657462472847,MATH 142A,A01,083219,Chow; Bennett,7,0,32,25
1657462472847,MATH 142A,A02,083220,Chow; Bennett,10,0,32,22
1657462472847,MATH 142A,A03,093480,Chow; Bennett,8,0,32,24
1657462472847,MATH 142A,B03,093481,Chow; Bennett,8,0,32,24
1657462472847,MATH 142A,B04,093558,Chow; Bennett,13,0,32,19
1657462472847,MATH 142A,B05,093559,Chow; Bennett,6,0,32,26
1657462478876,MATH 193A,A01,083224,Rotar; Vladimir,8,0,34,26
1657462478876,MATH 193A,A02,083225,Rotar; Vladimir,9,0,34,25
1657462478876,MATH 193A,A03,083781,Rotar; Vladimir,5,0,34,29
1657462478876,MATH 193A,A04,083782,Rotar; Vladimir,10,0,34,24
1657462478876,MATH 193A,A05,093482,Rotar; Vladimir,10,0,34,24
1657462484899,MATH 197,001,091859,McAuley; Julian John,9999,0,9999,0
1657462484899,MATH 197,002,095566,Kedlaya; Kiran S.,9997,0,9999,2
1657462484899,MATH 197,003,095567,Xiao; Ming,9999,0,9999,0
1657462484899,MATH 197,004,095571,Perols; Johan Lars,9998,0,9999,1
1657462491953,COGS 9,A01,083615,Shannon; Kyle Michael,9,0,75,66
1657462497980,COGS 11,A01,083617,Boyle; Mary E. T.,22,0,48,26
1657462504008,COGS 13,A01,083071,Bastos; Amalia Pinkusfeld,11,0,71,60
1657462510125,COGS 14A,A01,092681,Semenuks; Arturs,5,1,100,95
1657462516149,COGS 14B,A01,083073,Cheng; Tzu-Han,6,0,63,57
1657462522171,COGS 17,A01,092677,Semenuks; Arturs,6,0,81,75
1657462528202,COGS 100,A01,083619,Allen; Michael Gordon,17,0,70,53
1657462534227,COGS 101A,A01,083621,Davis; Joshua Daniel,9,0,68,59
1657462540250,COGS 101B,A01,091572,Allen; Michael Gordon,12,0,65,53
1657462546273,COGS 101C,A01,083625,Delgado; Tania,17,0,35,18
1657462552299,COGS 107A,A01,083627,Boyle; Mary E. T.,13,0,60,47
1657462558324,COGS 118A,A01,083075,Gupta; Anjum,21,0,76,55
1657462564353,CSE 3,A50,083646,Miranda; Gregory Joseph,24,0,50,26
1657462570378,CSE 8A,A50,083650,Miranda; Gregory Joseph,17,1,56,39
1657462576408,CSE 11,A01,083080,Cao; Yingjun,6,15,40,34
1657462582435,CSE 12,A01,083652,Krause-Levy; Sophia Louisa,28,1,120,92
1657462588458,CSE 15L,A01,083654,Morris; Justin Loren,9,0,50,41
1657462588458,CSE 15L,A02,083655,Morris; Justin Loren,9,0,50,41
1657462594485,CSE 20,A01,083657,Tran; Khoa Dang,39,0,80,41
1657462600510,CSE 21,A01,095574,Bach; Quang Tran,22,0,48,26
1657462606535,CSE 30,A01,083084,Eldon; John,5,0,80,75
1657462606535,CSE 30,B01,095061,Bhaskar; Nishant,9,0,50,41
1657462612560,CSE 100,A01,083659,Cao; Yingjun,5,4,70,65
1657462618584,CSE 134B,A01,083661,Powell; Thomas Allan,22,0,100,78
1657462624610,CSE 140,A01,083663,Gungor; Onat,15,0,85,70
1657462630633,CSE 140L,A01,083088,Eldon; John,21,0,100,79
1657462636658,CSE 175,A01,083665,Kumar; Rakesh,3,0,25,22
1657462642680,CSE 190,A00,092507,Dubnov; Shlomo,8,0,20,12
1657462648703,ECE 45,A01,083139,Congero; Spencer William,6,0,75,69
1657462654734,ECE 65,A50,083695,Saad; Andrew S,12,0,30,18
1657462654734,ECE 65,A51,095125,Saad; Andrew S,24,0,26,2
1657462660759,ECE 109,A01,091882,Touri; Behrouz,19,0,70,51
1657462666786,ECE 180,A00,083140,Abi Samra; Nicholas Camill,1,0,30,29
1657462666786,ECE 180,B00,083141,Abi Samra; Nicholas Camill,0,0,30,30
1657462672815,MATH 10A,A01,083735,Patchell; Gregory David,2,0,30,28
1657462672815,MATH 10A,A02,083736,Patchell; Gregory David,20,0,30,10
1657462672815,MATH 10A,A03,083737,Patchell; Gregory David,16,0,30,14
1657462678843,MATH 10B,A01,083207,Lim; Seonhee,8,0,34,26
1657462678843,MATH 10B,A02,083208,Lim; Seonhee,9,0,35,26
1657462678843,MATH 10B,A03,093472,Lim; Seonhee,7,0,34,27
1657462678843,MATH 10B,B01,083739,Sinha; Shubham,12,0,30,18
1657462684867,MATH 18,A01,083743,Cinel; Cameron Alexander,7,0,30,23
1657462684867,MATH 18,A02,083744,Cinel; Cameron Alexander,17,0,30,13
1657462684867,MATH 18,A03,083745,Cinel; Cameron Alexander,9,0,30,21
1657462684867,MATH 18,B01,083748,Rideout; David Porter,5,0,37,32
1657462684867,MATH 18,B02,083749,Rideout; David Porter,5,0,36,31
1657462684867,MATH 18,B03,083750,Rideout; David Porter,3,0,37,34
1657462684867,MATH 18,B04,083751,Rideout; David Porter,6,0,36,30
1657462684867,MATH 18,B05,093473,Rideout; David Porter,6,0,36,30
1657462684867,MATH 18,B06,093474,Rideout; David Porter,6,0,36,30
1657462690890,MATH 20A,A01,083754,Zheng; Zequn,14,0,40,26
1657462696913,MATH 20B,A01,083756,Briones; Jor-el Thomas Caparas,4,0,36,32
1657462696913,MATH 20B,A02,083757,Briones; Jor-el Thomas Caparas,1,0,36,35
1657462696913,MATH 20B,A03,093475,Briones; Jor-el Thomas Caparas,2,0,36,34
1657462702943,MATH 20C,A01,083760,Briones; Jor-el Thomas Caparas,1,0,35,34
1657462702943,MATH 20C,A02,083761,Briones; Jor-el Thomas Caparas,8,0,35,27
1657462702943,MATH 20C,A03,093476,Briones; Jor-el Thomas Caparas,0,1,36,36
1657462702943,MATH 20C,B01,083762,Bach; Quang Tran,1,0,30,29
1657462708970,MATH 20D,A01,083765,Tran; Brian Kha,5,0,30,25
1657462708970,MATH 20D,A02,083766,Tran; Brian Kha,5,0,30,25
1657462708970,MATH 20D,A03,083767,Tran; Brian Kha,5,0,30,25
1657462715001,MATH 20E,A01,083771,Ganguly; Soumya,9,0,32,23
1657462715001,MATH 20E,A02,083772,Ganguly; Soumya,6,0,32,26
1657462715001,MATH 20E,B01,083773,Ciotti; Benjamin,20,0,35,15
1657462715001,MATH 20E,B02,083774,Ciotti; Benjamin,17,0,35,18
1657462721026,MATH 103A,A01,083777,Greenfeld; Be'Eri,3,0,36,33
1657462721026,MATH 103A,A02,083778,Greenfeld; Be'Eri,5,0,36,31
1657462721026,MATH 103A,A03,093561,Greenfeld; Be'Eri,5,0,36,31
1657462721026,MATH 103A,B01,083779,Greenfeld; Be'Eri,7,0,36,29
1657462721026,MATH 103A,B02,083780,Greenfeld; Be'Eri,4,0,36,32
1657462721026,MATH 103A,B03,093562,Greenfeld; Be'Eri,3,0,36,33
1657462727058,MATH 105,A01,085443,Carter; Anne Toulson,15,0,35,20
1657462727058,MATH 105,A02,093477,Carter; Anne Toulson,20,0,35,15
1657462733086,MATH 109,A01,083213,Ganzberger; Geoffrey Michael,2,0,34,32
1657462733086,MATH 109,A02,083214,Ganzberger; Geoffrey Michael,4,0,34,30
1657462733086,MATH 109,A03,093478,Ganzberger; Geoffrey Michael,2,0,34,32
1657462733086,MATH 109,B01,083215,Ganzberger; Geoffrey Michael,1,0,32,31
1657462733086,MATH 109,B02,083216,Ganzberger; Geoffrey Michael,2,0,32,30
1657462733086,MATH 109,B03,093479,Ganzberger; Geoffrey Michael,8,0,32,24
1657462739118,MATH 142A,A01,083219,Chow; Bennett,7,0,32,25
1657462739118,MATH 142A,A02,083220,Chow; Bennett,10,0,32,22
1657462739118,MATH 142A,A03,093480,Chow; Bennett,8,0,32,24
1657462739118,MATH 142A,B03,093481,Chow; Bennett,8,0,32,24
1657462739118,MATH 142A,B04,093558,Chow; Bennett,13,0,32,19
1657462739118,MATH 142A,B05,093559,Chow; Bennett,6,0,32,26
1657462745145,MATH 193A,A01,083224,Rotar; Vladimir,8,0,34,26
1657462745145,MATH 193A,A02,083225,Rotar; Vladimir,9,0,34,25
1657462745145,MATH 193A,A03,083781,Rotar; Vladimir,5,0,34,29
1657462745145,MATH 193A,A04,083782,Rotar; Vladimir,10,0,34,24
1657462745145,MATH 193A,A05,093482,Rotar; Vladimir,10,0,34,24
1657462751170,MATH 197,001,091859,McAuley; Julian John,9999,0,9999,0
1657462751170,MATH 197,002,095566,Kedlaya; Kiran S.,9997,0,9999,2
1657462751170,MATH 197,003,095567,Xiao; Ming,9999,0,9999,0
1657462751170,MATH 197,004,095571,Perols; Johan Lars,9998,0,9999,1
1657462758240,COGS 9,A01,083615,Shannon; Kyle Michael,9,0,75,66
1657462764269,COGS 11,A01,083617,Boyle; Mary E. T.,22,0,48,26
1657462770297,COGS 13,A01,083071,Bastos; Amalia Pinkusfeld,11,0,71,60
1657462776320,COGS 14A,A01,092681,Semenuks; Arturs,5,1,100,95
1657462782349,COGS 14B,A01,083073,Cheng; Tzu-Han,6,0,63,57
1657462788384,COGS 17,A01,092677,Semenuks; Arturs,6,0,81,75
1657462794408,COGS 100,A01,083619,Allen; Michael Gordon,17,0,70,53
1657462800434,COGS 101A,A01,083621,Davis; Joshua Daniel,9,0,68,59
1657462806458,COGS 101B,A01,091572,Allen; Michael Gordon,12,0,65,53
1657462812482,COGS 101C,A01,083625,Delgado; Tania,17,0,35,18
1657462818504,COGS 107A,A01,083627,Boyle; Mary E. T.,13,0,60,47
1657462824528,COGS 118A,A01,083075,Gupta; Anjum,21,0,76,55
1657462830555,CSE 3,A50,083646,Miranda; Gregory Joseph,24,0,50,26
1657462836578,CSE 8A,A50,083650,Miranda; Gregory Joseph,17,1,56,39
1657462842614,CSE 11,A01,083080,Cao; Yingjun,6,15,40,34
1657462848639,CSE 12,A01,083652,Krause-Levy; Sophia Louisa,28,1,120,92
1657462854670,CSE 15L,A01,083654,Morris; Justin Loren,9,0,50,41
1657462854670,CSE 15L,A02,083655,Morris; Justin Loren,9,0,50,41
1657462860698,CSE 20,A01,083657,Tran; Khoa Dang,39,0,80,41
1657462866724,CSE 21,A01,095574,Bach; Quang Tran,22,0,48,26
1657462872750,CSE 30,A01,083084,Eldon; John,5,0,80,75
1657462872750,CSE 30,B01,095061,Bhaskar; Nishant,9,0,50,41
1657462878773,CSE 100,A01,083659,Cao; Yingjun,5,4,70,65
1657462884798,CSE 134B,A01,083661,Powell; Thomas Allan,22,0,100,78
1657462890824,CSE 140,A01,083663,Gungor; Onat,15,0,85,70
1657462896850,CSE 140L,A01,083088,Eldon; John,21,0,100,79
1657462902875,CSE 175,A01,083665,Kumar; Rakesh,3,0,25,22
1657462908906,CSE 190,A00,092507,Dubnov; Shlomo,8,0,20,12
1657462914954,ECE 45,A01,083139,Congero; Spencer William,6,0,75,69
1657462920980,ECE 65,A50,083695,Saad; Andrew S,12,0,30,18
1657462920980,ECE 65,A51,095125,Saad; Andrew S,24,0,26,2
1657462927006,ECE 109,A01,091882,Touri; Behrouz,19,0,70,51
1657462933029,ECE 180,A00,083140,Abi Samra; Nicholas Camill,1,0,30,29
1657462933029,ECE 180,B00,083141,Abi Samra; Nicholas Camill,0,0,30,30
1657462939053,MATH 10A,A01,083735,Patchell; Gregory David,2,0,30,28
1657462939053,MATH 10A,A02,083736,Patchell; Gregory David,20,0,30,10
1657462939053,MATH 10A,A03,083737,Patchell; Gregory David,16,0,30,14
1657462945083,MATH 10B,A01,083207,Lim; Seonhee,8,0,34,26
1657462945083,MATH 10B,A02,083208,Lim; Seonhee,9,0,35,26
1657462945083,MATH 10B,A03,093472,Lim; Seonhee,7,0,34,27
1657462945083,MATH 10B,B01,083739,Sinha; Shubham,12,0,30,18
1657462951108,MATH 18,A01,083743,Cinel; Cameron Alexander,7,0,30,23
1657462951108,MATH 18,A02,083744,Cinel; Cameron Alexander,17,0,30,13
1657462951108,MATH 18,A03,083745,Cinel; Cameron Alexander,9,0,30,21
1657462951108,MATH 18,B01,083748,Rideout; David Porter,5,0,37,32
1657462951108,MATH 18,B02,083749,Rideout; David Porter,5,0,36,31
1657462951108,MATH 18,B03,083750,Rideout; David Porter,3,0,37,34
1657462951108,MATH 18,B04,083751,Rideout; David Porter,6,0,36,30
1657462951108,MATH 18,B05,093473,Rideout; David Porter,6,0,36,30
1657462951108,MATH 18,B06,093474,Rideout; David Porter,6,0,36,30
1657462957129,MATH 20A,A01,083754,Zheng; Zequn,14,0,40,26
1657462963153,MATH 20B,A01,083756,Briones; Jor-el Thomas Caparas,4,0,36,32
1657462963153,MATH 20B,A02,083757,Briones; Jor-el Thomas Caparas,1,0,36,35
1657462963153,MATH 20B,A03,093475,Briones; Jor-el Thomas Caparas,2,0,36,34
1657462969178,MATH 20C,A01,083760,Briones; Jor-el Thomas Caparas,1,0,35,34
1657462969178,MATH 20C,A02,083761,Briones; Jor-el Thomas Caparas,8,0,35,27
1657462969178,MATH 20C,A03,093476,Briones; Jor-el Thomas Caparas,0,1,36,36
1657462969178,MATH 20C,B01,083762,Bach; Quang Tran,1,0,30,29
1657462975202,MATH 20D,A01,083765,Tran; Brian Kha,5,0,30,25
1657462975202,MATH 20D,A02,083766,Tran; Brian Kha,5,0,30,25
1657462975202,MATH 20D,A03,083767,Tran; Brian Kha,5,0,30,25
1657462981225,MATH 20E,A01,083771,Ganguly; Soumya,9,0,32,23
1657462981225,MATH 20E,A02,083772,Ganguly; Soumya,6,0,32,26
1657462981225,MATH 20E,B01,083773,Ciotti; Benjamin,20,0,35,15
1657462981225,MATH 20E,B02,083774,Ciotti; Benjamin,17,0,35,18
1657462987251,MATH 103A,A01,083777,Greenfeld; Be'Eri,3,0,36,33
1657462987251,MATH 103A,A02,083778,Greenfeld; Be'Eri,5,0,36,31
1657462987251,MATH 103A,A03,093561,Greenfeld; Be'Eri,5,0,36,31
1657462987251,MATH 103A,B01,083779,Greenfeld; Be'Eri,7,0,36,29
1657462987251,MATH 103A,B02,083780,Greenfeld; Be'Eri,4,0,36,32
1657462987251,MATH 103A,B03,093562,Greenfeld; Be'Eri,3,0,36,33
1657462993280,MATH 105,A01,085443,Carter; Anne Toulson,15,0,35,20
1657462993280,MATH 105,A02,093477,Carter; Anne Toulson,20,0,35,15
1657462999306,MATH 109,A01,083213,Ganzberger; Geoffrey Michael,2,0,34,32
1657462999306,MATH 109,A02,083214,Ganzberger; Geoffrey Michael,4,0,34,30
1657462999306,MATH 109,A03,093478,Ganzberger; Geoffrey Michael,2,0,34,32
1657462999306,MATH 109,B01,083215,Ganzberger; Geoffrey Michael,1,0,32,31
1657462999306,MATH 109,B02,083216,Ganzberger; Geoffrey Michael,2,0,32,30
1657462999306,MATH 109,B03,093479,Ganzberger; Geoffrey Michael,8,0,32,24
1657463005334,MATH 142A,A01,083219,Chow; Bennett,7,0,32,25
1657463005334,MATH 142A,A02,083220,Chow; Bennett,10,0,32,22
1657463005334,MATH 142A,A03,093480,Chow; Bennett,8,0,32,24
1657463005334,MATH 142A,B03,093481,Chow; Bennett,8,0,32,24
1657463005334,MATH 142A,B04,093558,Chow; Bennett,13,0,32,19
1657463005334,MATH 142A,B05,093559,Chow; Bennett,6,0,32,26
1657463011358,MATH 193A,A01,083224,Rotar; Vladimir,8,0,34,26
1657463011358,MATH 193A,A02,083225,Rotar; Vladimir,9,0,34,25
1657463011358,MATH 193A,A03,083781,Rotar; Vladimir,5,0,34,29
1657463011358,MATH 193A,A04,083782,Rotar; Vladimir,10,0,34,24
1657463011358,MATH 193A,A05,093482,Rotar; Vladimir,10,0,34,24
1657463017380,MATH 197,001,091859,McAuley; Julian John,9999,0,9999,0
1657463017380,MATH 197,002,095566,Kedlaya; Kiran S.,9997,0,9999,2
1657463017380,MATH 197,003,095567,Xiao; Ming,9999,0,9999,0
1657463017380,MATH 197,004,095571,Perols; Johan Lars,9998,0,9999,1
1657463024446,COGS 9,A01,083615,Shannon; Kyle Michael,9,0,75,66
1657463030473,COGS 11,A01,083617,Boyle; Mary E. T.,22,0,48,26
1657463036502,COGS 13,A01,083071,Bastos; Amalia Pinkusfeld,11,0,71,60
1657463042543,COGS 14A,A01,092681,Semenuks; Arturs,5,1,100,95
1657463048566,COGS 14B,A01,083073,Cheng; Tzu-Han,6,0,63,57
1657463054590,COGS 17,A01,092677,Semenuks; Arturs,6,0,81,75
1657463060617,COGS 100,A01,083619,Allen; Michael Gordon,17,0,70,53
1657463066642,COGS 101A,A01,083621,Davis; Joshua Daniel,9,0,68,59
1657463072667,COGS 101B,A01,091572,Allen; Michael Gordon,12,0,65,53
1657463078691,COGS 101C,A01,083625,Delgado; Tania,17,0,35,18
1657463084718,COGS 107A,A01,083627,Boyle; Mary E. T.,13,0,60,47
1657463090742,COGS 118A,A01,083075,Gupta; Anjum,21,0,76,55
1657463096770,CSE 3,A50,083646,Miranda; Gregory Joseph,24,0,50,26
1657463102797,CSE 8A,A50,083650,Miranda; Gregory Joseph,17,1,56,39
1657463108918,CSE 11,A01,083080,Cao; Yingjun,6,15,40,34
1657463114948,CSE 12,A01,083652,Krause-Levy; Sophia Louisa,28,1,120,92
1657463120977,CSE 15L,A01,083654,Morris; Justin Loren,9,0,50,41
1657463120977,CSE 15L,A02,083655,Morris; Justin Loren,9,0,50,41
1657463127008,CSE 20,A01,083657,Tran; Khoa Dang,39,0,80,41
1657463133037,CSE 21,A01,095574,Bach; Quang Tran,22,0,48,26
1657463139073,CSE 30,A01,083084,Eldon; John,5,0,80,75
1657463139073,CSE 30,B01,095061,Bhaskar; Nishant,9,0,50,41
1657463145099,CSE 100,A01,083659,Cao; Yingjun,5,4,70,65
1657463151124,CSE 134B,A01,083661,Powell; Thomas Allan,22,0,100,78
1657463157149,CSE 140,A01,083663,Gungor; Onat,15,0,85,70
1657463163178,CSE 140L,A01,083088,Eldon; John,21,0,100,79
1657463169204,CSE 175,A01,083665,Kumar; Rakesh,3,0,25,22
1657463175235,CSE 190,A00,092507,Dubnov; Shlomo,8,0,20,12
1657463181259,ECE 45,A01,083139,Congero; Spencer William,6,0,75,69
1657463187293,ECE 65,A50,083695,Saad; Andrew S,12,0,30,18
1657463187293,ECE 65,A51,095125,Saad; Andrew S,24,0,26,2
1657463193318,ECE 109,A01,091882,Touri; Behrouz,19,0,70,51
1657463199347,ECE 180,A00,083140,Abi Samra; Nicholas Camill,1,0,30,29
1657463199347,ECE 180,B00,083141,Abi Samra; Nicholas Camill,0,0,30,30
1657463205371,MATH 10A,A01,083735,Patchell; Gregory David,2,0,30,28
1657463205371,MATH 10A,A02,083736,Patchell; Gregory David,20,0,30,10
1657463205371,MATH 10A,A03,083737,Patchell; Gregory David,16,0,30,14
1657463211394,MATH 10B,A01,083207,Lim; Seonhee,8,0,34,26
1657463211394,MATH 10B,A02,083208,Lim; Seonhee,9,0,35,26
1657463211394,MATH 10B,A03,093472,Lim; Seonhee,7,0,34,27
1657463211394,MATH 10B,B01,083739,Sinha; Shubham,12,0,30,18
1657463217421,MATH 18,A01,083743,Cinel; Cameron Alexander,7,0,30,23
1657463217421,MATH 18,A02,083744,Cinel; Cameron Alexander,17,0,30,13
1657463217421,MATH 18,A03,083745,Cinel; Cameron Alexander,9,0,30,21
1657463217421,MATH 18,B01,083748,Rideout; David Porter,5,0,37,32
1657463217421,MATH 18,B02,083749,Rideout; David Porter,5,0,36,31
1657463217421,MATH 18,B03,083750,Rideout; David Porter,3,0,37,34
1657463217421,MATH 18,B04,083751,Rideout; David Porter,6,0,36,30
1657463217421,MATH 18,B05,093473,Rideout; David Porter,6,0,36,30
1657463217421,MATH 18,B06,093474,Rideout; David Porter,6,0,36,30
1657463223443,MATH 20A,A01,083754,Zheng; Zequn,14,0,40,26
1657463229477,MATH 20B,A01,083756,Briones; Jor-el Thomas Caparas,4,0,36,32
1657463229477,MATH 20B,A02,083757,Briones; Jor-el Thomas Caparas,1,0,36,35
1657463229477,MATH 20B,A03,093475,Briones; Jor-el Thomas Caparas,2,0,36,34
1657463235507,MATH 20C,A01,083760,Briones; Jor-el Thomas Caparas,1,0,35,34
1657463235507,MATH 20C,A02,083761,Briones; Jor-el Thomas Caparas,8,0,35,27
1657463235507,MATH 20C,A03,093476,Briones; Jor-el Thomas Caparas,0,1,36,36
1657463235507,MATH 20C,B01,083762,Bach; Quang Tran,1,0,30,29
1657463241533,MATH 20D,A01,083765,Tran; Brian Kha,5,0,30,25
1657463241533,MATH 20D,A02,083766,Tran; Brian Kha,5,0,30,25
1657463241533,MATH 20D,A03,083767,Tran; Brian Kha,5,0,30,25
1657463247559,MATH 20E,A01,083771,Ganguly; Soumya,9,0,32,23
1657463247559,MATH 20E,A02,083772,Ganguly; Soumya,6,0,32,26
1657463247559,MATH 20E,B01,083773,Ciotti; Benjamin,20,0,35,15
1657463247559,MATH 20E,B02,083774,Ciotti; Benjamin,17,0,35,18
1657463253593,MATH 103A,A01,083777,Greenfeld; Be'Eri,3,0,36,33
1657463253593,MATH 103A,A02,083778,Greenfeld; Be'Eri,5,0,36,31
1657463253593,MATH 103A,A03,093561,Greenfeld; Be'Eri,5,0,36,31
1657463253593,MATH 103A,B01,083779,Greenfeld; Be'Eri,7,0,36,29
1657463253593,MATH 103A,B02,083780,Greenfeld; Be'Eri,4,0,36,32
1657463253593,MATH 103A,B03,093562,Greenfeld; Be'Eri,3,0,36,33
1657463259621,MATH 105,A01,085443,Carter; Anne Toulson,15,0,35,20
1657463259621,MATH 105,A02,093477,Carter; Anne Toulson,20,0,35,15
1657463265646,MATH 109,A01,083213,Ganzberger; Geoffrey Michael,2,0,34,32
1657463265646,MATH 109,A02,083214,Ganzberger; Geoffrey Michael,4,0,34,30
1657463265646,MATH 109,A03,093478,Ganzberger; Geoffrey Michael,2,0,34,32
1657463265646,MATH 109,B01,083215,Ganzberger; Geoffrey Michael,1,0,32,31
1657463265646,MATH 109,B02,083216,Ganzberger; Geoffrey Michael,2,0,32,30
1657463265646,MATH 109,B03,093479,Ganzberger; Geoffrey Michael,8,0,32,24
1657463271672,MATH 142A,A01,083219,Chow; Bennett,7,0,32,25
1657463271672,MATH 142A,A02,083220,Chow; Bennett,10,0,32,22
1657463271672,MATH 142A,A03,093480,Chow; Bennett,8,0,32,24
1657463271672,MATH 142A,B03,093481,Chow; Bennett,8,0,32,24
1657463271672,MATH 142A,B04,093558,Chow; Bennett,13,0,32,19
1657463271672,MATH 142A,B05,093559,Chow; Bennett,6,0,32,26
1657463277696,MATH 193A,A01,083224,Rotar; Vladimir,8,0,34,26
1657463277696,MATH 193A,A02,083225,Rotar; Vladimir,9,0,34,25
1657463277696,MATH 193A,A03,083781,Rotar; Vladimir,5,0,34,29
1657463277696,MATH 193A,A04,083782,Rotar; Vladimir,10,0,34,24
1657463277696,MATH 193A,A05,093482,Rotar; Vladimir,10,0,34,24
1657463283725,MATH 197,001,091859,McAuley; Julian John,9999,0,9999,0
1657463283725,MATH 197,002,095566,Kedlaya; Kiran S.,9997,0,9999,2
1657463283725,MATH 197,003,095567,Xiao; Ming,9999,0,9999,0
1657463283725,MATH 197,004,095571,Perols; Johan Lars,9998,0,9999,1
1657463290781,COGS 9,A01,083615,Shannon; Kyle Michael,9,0,75,66
1657463296804,COGS 11,A01,083617,Boyle; Mary E. T.,22,0,48,26
1657463302829,COGS 13,A01,083071,Bastos; Amalia Pinkusfeld,11,0,71,60
1657463308852,COGS 14A,A01,092681,Semenuks; Arturs,5,1,100,95
1657463314877,COGS 14B,A01,083073,Cheng; Tzu-Han,6,0,63,57
1657463320900,COGS 17,A01,092677,Semenuks; Arturs,6,0,81,75
1657463326922,COGS 100,A01,083619,Allen; Michael Gordon,17,0,70,53
1657463332944,COGS 101A,A01,083621,Davis; Joshua Daniel,9,0,68,59
1657463338968,COGS 101B,A01,091572,Allen; Michael Gordon,12,0,65,53
1657463345007,COGS 101C,A01,083625,Delgado; Tania,17,0,35,18
1657463351031,COGS 107A,A01,083627,Boyle; Mary E. T.,13,0,60,47
1657463357060,COGS 118A,A01,083075,Gupta; Anjum,21,0,76,55
1657463363085,CSE 3,A50,083646,Miranda; Gregory Joseph,24,0,50,26
1657463369111,CSE 8A,A50,083650,Miranda; Gregory Joseph,17,1,56,39
1657463375137,CSE 11,A01,083080,Cao; Yingjun,6,15,40,34
1657463381160,CSE 12,A01,083652,Krause-Levy; Sophia Louisa,28,1,120,92
1657463387183,CSE 15L,A01,083654,Morris; Justin Loren,9,0,50,41
1657463387183,CSE 15L,A02,083655,Morris; Justin Loren,9,0,50,41
1657463393206,CSE 20,A01,083657,Tran; Khoa Dang,39,0,80,41
1657463399234,CSE 21,A01,095574,Bach; Quang Tran,22,0,48,26
1657463405261,CSE 30,A01,083084,Eldon; John,5,0,80,75
1657463405261,CSE 30,B01,095061,Bhaskar; Nishant,9,0,50,41
1657463411287,CSE 100,A01,083659,Cao; Yingjun,5,4,70,65
1657463417315,CSE 134B,A01,083661,Powell; Thomas Allan,22,0,100,78
1657463423339,CSE 140,A01,083663,Gungor; Onat,15,0,85,70
1657463429364,CSE 140L,A01,083088,Eldon; John,21,0,100,79
1657463435390,CSE 175,A01,083665,Kumar; Rakesh,3,0,25,22
1657463441417,CSE 190,A00,092507,Dubnov; Shlomo,8,0,20,12
1657463447440,ECE 45,A01,083139,Congero; Spencer William,6,0,75,69
1657463453466,ECE 65,A50,083695,Saad; Andrew S,12,0,30,18
1657463453466,ECE 65,A51,095125,Saad; Andrew S,24,0,26,2
1657463459492,ECE 109,A01,091882,Touri; Behrouz,19,0,70,51
1657463465517,ECE 180,A00,083140,Abi Samra; Nicholas Camill,1,0,30,29
1657463465517,ECE 180,B00,083141,Abi Samra; Nicholas Camill,0,0,30,30
1657463471546,MATH 10A,A01,083735,Patchell; Gregory David,2,0,30,28
1657463471546,MATH 10A,A02,083736,Patchell; Gregory David,20,0,30,10
1657463471546,MATH 10A,A03,083737,Patchell; Gregory David,16,0,30,14
1657463477577,MATH 10B,A01,083207,Lim; Seonhee,8,0,34,26
1657463477577,MATH 10B,A02,083208,Lim; Seonhee,9,0,35,26
1657463477577,MATH 10B,A03,093472,Lim; Seonhee,7,0,34,27
1657463477577,MATH 10B,B01,083739,Sinha; Shubham,12,0,30,18
1657463483601,MATH 18,A01,083743,Cinel; Cameron Alexander,7,0,30,23
1657463483601,MATH 18,A02,083744,Cinel; Cameron Alexander,17,0,30,13
1657463483601,MATH 18,A03,083745,Cinel; Cameron Alexander,9,0,30,21
1657463483601,MATH 18,B01,083748,Rideout; David Porter,5,0,37,32
1657463483601,MATH 18,B02,083749,Rideout; David Porter,5,0,36,31
1657463483601,MATH 18,B03,083750,Rideout; David Porter,3,0,37,34
1657463483601,MATH 18,B04,083751,Rideout; David Porter,6,0,36,30
1657463483601,MATH 18,B05,093473,Rideout; David Porter,6,0,36,30
1657463483601,MATH 18,B06,093474,Rideout; David Porter,6,0,36,30
1657463489625,MATH 20A,A01,083754,Zheng; Zequn,14,0,40,26
1657463495648,MATH 20B,A01,083756,Briones; Jor-el Thomas Caparas,4,0,36,32
1657463495648,MATH 20B,A02,083757,Briones; Jor-el Thomas Caparas,1,0,36,35
1657463495648,MATH 20B,A03,093475,Briones; Jor-el Thomas Caparas,2,0,36,34
1657463501683,MATH 20C,A01,083760,Briones; Jor-el Thomas Caparas,1,0,35,34
1657463501683,MATH 20C,A02,083761,Briones; Jor-el Thomas Caparas,8,0,35,27
1657463501683,MATH 20C,A03,093476,Briones; Jor-el Thomas Caparas,0,1,36,36
1657463501683,MATH 20C,B01,083762,Bach; Quang Tran,1,0,30,29
1657463507717,MATH 20D,A01,083765,Tran; Brian Kha,5,0,30,25
1657463507717,MATH 20D,A02,083766,Tran; Brian Kha,5,0,30,25
1657463507717,MATH 20D,A03,083767,Tran; Brian Kha,5,0,30,25
1657463513746,MATH 20E,A01,083771,Ganguly; Soumya,9,0,32,23
1657463513746,MATH 20E,A02,083772,Ganguly; Soumya,6,0,32,26
1657463513746,MATH 20E,B01,083773,Ciotti; Benjamin,20,0,35,15
1657463513746,MATH 20E,B02,083774,Ciotti; Benjamin,17,0,35,18
1657463519771,MATH 103A,A01,083777,Greenfeld; Be'Eri,3,0,36,33
1657463519771,MATH 103A,A02,083778,Greenfeld; Be'Eri,5,0,36,31
1657463519771,MATH 103A,A03,093561,Greenfeld; Be'Eri,5,0,36,31
1657463519771,MATH 103A,B01,083779,Greenfeld; Be'Eri,7,0,36,29
1657463519771,MATH 103A,B02,083780,Greenfeld; Be'Eri,4,0,36,32
1657463519771,MATH 103A,B03,093562,Greenfeld; Be'Eri,3,0,36,33
1657463525801,MATH 105,A01,085443,Carter; Anne Toulson,15,0,35,20
1657463525801,MATH 105,A02,093477,Carter; Anne Toulson,20,0,35,15
1657463531830,MATH 109,A01,083213,Ganzberger; Geoffrey Michael,2,0,34,32
1657463531830,MATH 109,A02,083214,Ganzberger; Geoffrey Michael,4,0,34,30
1657463531830,MATH 109,A03,093478,Ganzberger; Geoffrey Michael,2,0,34,32
1657463531830,MATH 109,B01,083215,Ganzberger; Geoffrey Michael,1,0,32,31
1657463531830,MATH 109,B02,083216,Ganzberger; Geoffrey Michael,2,0,32,30
1657463531830,MATH 109,B03,093479,Ganzberger; Geoffrey Michael,8,0,32,24
1657463537862,MATH 142A,A01,083219,Chow; Bennett,7,0,32,25
1657463537862,MATH 142A,A02,083220,Chow; Bennett,10,0,32,22
1657463537862,MATH 142A,A03,093480,Chow; Bennett,8,0,32,24
1657463537862,MATH 142A,B03,093481,Chow; Bennett,8,0,32,24
1657463537862,MATH 142A,B04,093558,Chow; Bennett,13,0,32,19
1657463537862,MATH 142A,B05,093559,Chow; Bennett,6,0,32,26
1657463543886,MATH 193A,A01,083224,Rotar; Vladimir,8,0,34,26
1657463543886,MATH 193A,A02,083225,Rotar; Vladimir,9,0,34,25
1657463543886,MATH 193A,A03,083781,Rotar; Vladimir,5,0,34,29
1657463543886,MATH 193A,A04,083782,Rotar; Vladimir,10,0,34,24
1657463543886,MATH 193A,A05,093482,Rotar; Vladimir,10,0,34,24
1657463549912,MATH 197,001,091859,McAuley; Julian John,9999,0,9999,0
1657463549912,MATH 197,002,095566,Kedlaya; Kiran S.,9997,0,9999,2
1657463549912,MATH 197,003,095567,Xiao; Ming,9999,0,9999,0
1657463549912,MATH 197,004,095571,Perols; Johan Lars,9998,0,9999,1
1657463556971,COGS 9,A01,083615,Shannon; Kyle Michael,9,0,75,66
1657463562995,COGS 11,A01,083617,Boyle; Mary E. T.,22,0,48,26
1657463569018,COGS 13,A01,083071,Bastos; Amalia Pinkusfeld,11,0,71,60
1657463575046,COGS 14A,A01,092681,Semenuks; Arturs,5,1,100,95
1657463581069,COGS 14B,A01,083073,Cheng; Tzu-Han,6,0,63,57
1657463587093,COGS 17,A01,092677,Semenuks; Arturs,6,0,81,75
1657463593117,COGS 100,A01,083619,Allen; Michael Gordon,17,0,70,53
1657463599145,COGS 101A,A01,083621,Davis; Joshua Daniel,9,0,68,59
1657463605169,COGS 101B,A01,091572,Allen; Michael Gordon,12,0,65,53
1657463611202,COGS 101C,A01,083625,Delgado; Tania,17,0,35,18
1657463617226,COGS 107A,A01,083627,Boyle; Mary E. T.,13,0,60,47
1657463623247,COGS 118A,A01,083075,Gupta; Anjum,21,0,76,55
1657463629272,CSE 3,A50,083646,Miranda; Gregory Joseph,24,0,50,26
1657463635300,CSE 8A,A50,083650,Miranda; Gregory Joseph,17,1,56,39
1657463641323,CSE 11,A01,083080,Cao; Yingjun,6,15,40,34
1657463647350,CSE 12,A01,083652,Krause-Levy; Sophia Louisa,28,1,120,92
1657463653379,CSE 15L,A01,083654,Morris; Justin Loren,9,0,50,41
1657463653379,CSE 15L,A02,083655,Morris; Justin Loren,9,0,50,41
1657463659410,CSE 20,A01,083657,Tran; Khoa Dang,39,0,80,41
1657463665438,CSE 21,A01,095574,Bach; Quang Tran,22,0,48,26
1657463671462,CSE 30,A01,083084,Eldon; John,5,0,80,75
1657463671462,CSE 30,B01,095061,Bhaskar; Nishant,9,0,50,41
1657463677489,CSE 100,A01,083659,Cao; Yingjun,5,4,70,65
1657463683512,CSE 134B,A01,083661,Powell; Thomas Allan,22,0,100,78
1657463689538,CSE 140,A01,083663,Gungor; Onat,15,0,85,70
1657463695565,CSE 140L,A01,083088,Eldon; John,21,0,100,79
1657463701589,CSE 175,A01,083665,Kumar; Rakesh,3,0,25,22
1657463707682,CSE 190,A00,092507,Dubnov; Shlomo,8,0,20,12
1657463713706,ECE 45,A01,083139,Congero; Spencer William,6,0,75,69
1657463719735,ECE 65,A50,083695,Saad; Andrew S,12,0,30,18
1657463719735,ECE 65,A51,095125,Saad; Andrew S,24,0,26,2
1657463725764,ECE 109,A01,091882,Touri; Behrouz,19,0,70,51
1657463731792,ECE 180,A00,083140,Abi Samra; Nicholas Camill,1,0,30,29
1657463731792,ECE 180,B00,083141,Abi Samra; Nicholas Camill,0,0,30,30
1657463737816,MATH 10A,A01,083735,Patchell; Gregory David,2,0,30,28
1657463737816,MATH 10A,A02,083736,Patchell; Gregory David,20,0,30,10
1657463737816,MATH 10A,A03,083737,Patchell; Gregory David,16,0,30,14
1657463743839,MATH 10B,A01,083207,Lim; Seonhee,8,0,34,26
1657463743839,MATH 10B,A02,083208,Lim; Seonhee,9,0,35,26
1657463743839,MATH 10B,A03,093472,Lim; Seonhee,7,0,34,27
1657463743839,MATH 10B,B01,083739,Sinha; Shubham,12,0,30,18
1657463749863,MATH 18,A01,083743,Cinel; Cameron Alexander,7,0,30,23
1657463749863,MATH 18,A02,083744,Cinel; Cameron Alexander,17,0,30,13
1657463749863,MATH 18,A03,083745,Cinel; Cameron Alexander,9,0,30,21
1657463749863,MATH 18,B01,083748,Rideout; David Porter,5,0,37,32
1657463749863,MATH 18,B02,083749,Rideout; David Porter,5,0,36,31
1657463749863,MATH 18,B03,083750,Rideout; David Porter,3,0,37,34
1657463749863,MATH 18,B04,083751,Rideout; David Porter,6,0,36,30
1657463749863,MATH 18,B05,093473,Rideout; David Porter,6,0,36,30
1657463749863,MATH 18,B06,093474,Rideout; David Porter,6,0,36,30
1657463755887,MATH 20A,A01,083754,Zheng; Zequn,14,0,40,26
1657463761912,MATH 20B,A01,083756,Briones; Jor-el Thomas Caparas,4,0,36,32
1657463761912,MATH 20B,A02,083757,Briones; Jor-el Thomas Caparas,1,0,36,35
1657463761912,MATH 20B,A03,093475,Briones; Jor-el Thomas Caparas,2,0,36,34
1657463767935,MATH 20C,A01,083760,Briones; Jor-el Thomas Caparas,1,0,35,34
1657463767935,MATH 20C,A02,083761,Briones; Jor-el Thomas Caparas,8,0,35,27
1657463767935,MATH 20C,A03,093476,Briones; Jor-el Thomas Caparas,0,1,36,36
1657463767935,MATH 20C,B01,083762,Bach; Quang Tran,1,0,30,29
1657463773965,MATH 20D,A01,083765,Tran; Brian Kha,5,0,30,25
1657463773965,MATH 20D,A02,083766,Tran; Brian Kha,5,0,30,25
1657463773965,MATH 20D,A03,083767,Tran; Brian Kha,5,0,30,25
1657463779994,MATH 20E,A01,083771,Ganguly; Soumya,9,0,32,23
1657463779994,MATH 20E,A02,083772,Ganguly; Soumya,6,0,32,26
1657463779994,MATH 20E,B01,083773,Ciotti; Benjamin,20,0,35,15
1657463779994,MATH 20E,B02,083774,Ciotti; Benjamin,17,0,35,18
1657463786025,MATH 103A,A01,083777,Greenfeld; Be'Eri,3,0,36,33
1657463786025,MATH 103A,A02,083778,Greenfeld; Be'Eri,5,0,36,31
1657463786025,MATH 103A,A03,093561,Greenfeld; Be'Eri,5,0,36,31
1657463786025,MATH 103A,B01,083779,Greenfeld; Be'Eri,7,0,36,29
1657463786025,MATH 103A,B02,083780,Greenfeld; Be'Eri,4,0,36,32
1657463786025,MATH 103A,B03,093562,Greenfeld; Be'Eri,3,0,36,33
1657463792048,MATH 105,A01,085443,Carter; Anne Toulson,15,0,35,20
1657463792048,MATH 105,A02,093477,Carter; Anne Toulson,20,0,35,15
1657463798074,MATH 109,A01,083213,Ganzberger; Geoffrey Michael,2,0,34,32
1657463798074,MATH 109,A02,083214,Ganzberger; Geoffrey Michael,4,0,34,30
1657463798074,MATH 109,A03,093478,Ganzberger; Geoffrey Michael,2,0,34,32
1657463798074,MATH 109,B01,083215,Ganzberger; Geoffrey Michael,1,0,32,31
1657463798074,MATH 109,B02,083216,Ganzberger; Geoffrey Michael,2,0,32,30
1657463798074,MATH 109,B03,093479,Ganzberger; Geoffrey Michael,8,0,32,24
1657463804100,MATH 142A,A01,083219,Chow; Bennett,7,0,32,25
1657463804100,MATH 142A,A02,083220,Chow; Bennett,10,0,32,22
1657463804100,MATH 142A,A03,093480,Chow; Bennett,8,0,32,24
1657463804100,MATH 142A,B03,093481,Chow; Bennett,8,0,32,24
1657463804100,MATH 142A,B04,093558,Chow; Bennett,13,0,32,19
1657463804100,MATH 142A,B05,093559,Chow; Bennett,6,0,32,26
1657463810132,MATH 193A,A01,083224,Rotar; Vladimir,8,0,34,26
1657463810132,MATH 193A,A02,083225,Rotar; Vladimir,9,0,34,25
1657463810132,MATH 193A,A03,083781,Rotar; Vladimir,5,0,34,29
1657463810132,MATH 193A,A04,083782,Rotar; Vladimir,10,0,34,24
1657463810132,MATH 193A,A05,093482,Rotar; Vladimir,10,0,34,24
1657463816160,MATH 197,001,091859,McAuley; Julian John,9999,0,9999,0
1657463816160,MATH 197,002,095566,Kedlaya; Kiran S.,9997,0,9999,2
1657463816160,MATH 197,003,095567,Xiao; Ming,9999,0,9999,0
1657463816160,MATH 197,004,095571,Perols; Johan Lars,9998,0,9999,1
1657463823220,COGS 9,A01,083615,Shannon; Kyle Michael,9,0,75,66
1657463829246,COGS 11,A01,083617,Boyle; Mary E. T.,22,0,48,26
1657463835270,COGS 13,A01,083071,Bastos; Amalia Pinkusfeld,11,0,71,60
1657463841296,COGS 14A,A01,092681,Semenuks; Arturs,5,1,100,95
1657463847321,COGS 14B,A01,083073,Cheng; Tzu-Han,6,0,63,57
1657463853349,COGS 17,A01,092677,Semenuks; Arturs,6,0,81,75
1657463859378,COGS 100,A01,083619,Allen; Michael Gordon,17,0,70,53
1657463865402,COGS 101A,A01,083621,Davis; Joshua Daniel,9,0,68,59
1657463871425,COGS 101B,A01,091572,Allen; Michael Gordon,12,0,65,53
1657463877448,COGS 101C,A01,083625,Delgado; Tania,17,0,35,18
1657463883479,COGS 107A,A01,083627,Boyle; Mary E. T.,13,0,60,47
1657463889523,COGS 118A,A01,083075,Gupta; Anjum,21,0,76,55
1657463895545,CSE 3,A50,083646,Miranda; Gregory Joseph,24,0,50,26
1657463901573,CSE 8A,A50,083650,Miranda; Gregory Joseph,17,1,56,39
1657463907600,CSE 11,A01,083080,Cao; Yingjun,6,15,40,34
1657463913626,CSE 12,A01,083652,Krause-Levy; Sophia Louisa,28,1,120,92
1657463919649,CSE 15L,A01,083654,Morris; Justin Loren,9,0,50,41
1657463919649,CSE 15L,A02,083655,Morris; Justin Loren,9,0,50,41
1657463925674,CSE 20,A01,083657,Tran; Khoa Dang,39,0,80,41
1657463931698,CSE 21,A01,095574,Bach; Quang Tran,22,0,48,26
1657463937723,CSE 30,A01,083084,Eldon; John,5,0,80,75
1657463937723,CSE 30,B01,095061,Bhaskar; Nishant,9,0,50,41
1657463943747,CSE 100,A01,083659,Cao; Yingjun,5,4,70,65
1657463949772,CSE 134B,A01,083661,Powell; Thomas Allan,22,0,100,78
1657463955798,CSE 140,A01,083663,Gungor; Onat,15,0,85,70
1657463961821,CSE 140L,A01,083088,Eldon; John,21,0,100,79
1657463967853,CSE 175,A01,083665,Kumar; Rakesh,3,0,25,22
1657463973880,CSE 190,A00,092507,Dubnov; Shlomo,8,0,20,12
1657463979921,ECE 45,A01,083139,Congero; Spencer William,6,0,75,69
1657463985945,ECE 65,A50,083695,Saad; Andrew S,12,0,30,18
1657463985945,ECE 65,A51,095125,Saad; Andrew S,24,0,26,2
1657463991973,ECE 109,A01,091882,Touri; Behrouz,19,0,70,51
1657463998002,ECE 180,A00,083140,Abi Samra; Nicholas Camill,1,0,30,29
1657463998002,ECE 180,B00,083141,Abi Samra; Nicholas Camill,0,0,30,30
1657464004025,MATH 10A,A01,083735,Patchell; Gregory David,2,0,30,28
1657464004025,MATH 10A,A02,083736,Patchell; Gregory David,20,0,30,10
1657464004025,MATH 10A,A03,083737,Patchell; Gregory David,16,0,30,14
1657464010048,MATH 10B,A01,083207,Lim; Seonhee,8,0,34,26
1657464010048,MATH 10B,A02,083208,Lim; Seonhee,9,0,35,26
1657464010048,MATH 10B,A03,093472,Lim; Seonhee,7,0,34,27
1657464010048,MATH 10B,B01,083739,Sinha; Shubham,12,0,30,18
1657464016074,MATH 18,A01,083743,Cinel; Cameron Alexander,7,0,30,23
1657464016074,MATH 18,A02,083744,Cinel; Cameron Alexander,17,0,30,13
1657464016074,MATH 18,A03,083745,Cinel; Cameron Alexander,9,0,30,21
1657464016074,MATH 18,B01,083748,Rideout; David Porter,5,0,37,32
1657464016074,MATH 18,B02,083749,Rideout; David Porter,5,0,36,31
1657464016074,MATH 18,B03,083750,Rideout; David Porter,3,0,37,34
1657464016074,MATH 18,B04,083751,Rideout; David Porter,6,0,36,30
1657464016074,MATH 18,B05,093473,Rideout; David Porter,6,0,36,30
1657464016074,MATH 18,B06,093474,Rideout; David Porter,6,0,36,30
1657464022104,MATH 20A,A01,083754,Zheng; Zequn,14,0,40,26
1657464028126,MATH 20B,A01,083756,Briones; Jor-el Thomas Caparas,4,0,36,32
1657464028126,MATH 20B,A02,083757,Briones; Jor-el Thomas Caparas,1,0,36,35
1657464028126,MATH 20B,A03,093475,Briones; Jor-el Thomas Caparas,2,0,36,34
1657464034152,MATH 20C,A01,083760,Briones; Jor-el Thomas Caparas,1,0,35,34
1657464034152,MATH 20C,A02,083761,Briones; Jor-el Thomas Caparas,8,0,35,27
1657464034152,MATH 20C,A03,093476,Briones; Jor-el Thomas Caparas,0,1,36,36
1657464034152,MATH 20C,B01,083762,Bach; Quang Tran,1,0,30,29
1657464040183,MATH 20D,A01,083765,Tran; Brian Kha,5,0,30,25
1657464040183,MATH 20D,A02,083766,Tran; Brian Kha,5,0,30,25
1657464040183,MATH 20D,A03,083767,Tran; Brian Kha,5,0,30,25
1657464046208,MATH 20E,A01,083771,Ganguly; Soumya,9,0,32,23
1657464046208,MATH 20E,A02,083772,Ganguly; Soumya,6,0,32,26
1657464046208,MATH 20E,B01,083773,Ciotti; Benjamin,20,0,35,15
1657464046208,MATH 20E,B02,083774,Ciotti; Benjamin,17,0,35,18
1657464052232,MATH 103A,A01,083777,Greenfeld; Be'Eri,3,0,36,33
1657464052232,MATH 103A,A02,083778,Greenfeld; Be'Eri,5,0,36,31
1657464052232,MATH 103A,A03,093561,Greenfeld; Be'Eri,5,0,36,31
1657464052232,MATH 103A,B01,083779,Greenfeld; Be'Eri,7,0,36,29
1657464052232,MATH 103A,B02,083780,Greenfeld; Be'Eri,4,0,36,32
1657464052232,MATH 103A,B03,093562,Greenfeld; Be'Eri,3,0,36,33
1657464058256,MATH 105,A01,085443,Carter; Anne Toulson,15,0,35,20
1657464058256,MATH 105,A02,093477,Carter; Anne Toulson,20,0,35,15
1657464064284,MATH 109,A01,083213,Ganzberger; Geoffrey Michael,2,0,34,32
1657464064284,MATH 109,A02,083214,Ganzberger; Geoffrey Michael,4,0,34,30
1657464064284,MATH 109,A03,093478,Ganzberger; Geoffrey Michael,2,0,34,32
1657464064284,MATH 109,B01,083215,Ganzberger; Geoffrey Michael,1,0,32,31
1657464064284,MATH 109,B02,083216,Ganzberger; Geoffrey Michael,2,0,32,30
1657464064284,MATH 109,B03,093479,Ganzberger; Geoffrey Michael,8,0,32,24
1657464070307,MATH 142A,A01,083219,Chow; Bennett,7,0,32,25
1657464070307,MATH 142A,A02,083220,Chow; Bennett,10,0,32,22
1657464070307,MATH 142A,A03,093480,Chow; Bennett,8,0,32,24
1657464070307,MATH 142A,B03,093481,Chow; Bennett,8,0,32,24
1657464070307,MATH 142A,B04,093558,Chow; Bennett,13,0,32,19
1657464070307,MATH 142A,B05,093559,Chow; Bennett,6,0,32,26
1657464076336,MATH 193A,A01,083224,Rotar; Vladimir,8,0,34,26
1657464076336,MATH 193A,A02,083225,Rotar; Vladimir,9,0,34,25
1657464076336,MATH 193A,A03,083781,Rotar; Vladimir,5,0,34,29
1657464076336,MATH 193A,A04,083782,Rotar; Vladimir,10,0,34,24
1657464076336,MATH 193A,A05,093482,Rotar; Vladimir,10,0,34,24
1657464082365,MATH 197,001,091859,McAuley; Julian John,9999,0,9999,0
1657464082365,MATH 197,002,095566,Kedlaya; Kiran S.,9997,0,9999,2
1657464082365,MATH 197,003,095567,Xiao; Ming,9999,0,9999,0
1657464082365,MATH 197,004,095571,Perols; Johan Lars,9998,0,9999,1
1657464089416,COGS 9,A01,083615,Shannon; Kyle Michael,9,0,75,66
1657464095442,COGS 11,A01,083617,Boyle; Mary E. T.,22,0,48,26
1657464101465,COGS 13,A01,083071,Bastos; Amalia Pinkusfeld,11,0,71,60
1657464107488,COGS 14A,A01,092681,Semenuks; Arturs,5,1,100,95
1657464113517,COGS 14B,A01,083073,Cheng; Tzu-Han,6,0,63,57
1657464119544,COGS 17,A01,092677,Semenuks; Arturs,6,0,81,75
1657464125568,COGS 100,A01,083619,Allen; Michael Gordon,17,0,70,53
1657464131591,COGS 101A,A01,083621,Davis; Joshua Daniel,9,0,68,59
1657464137613,COGS 101B,A01,091572,Allen; Michael Gordon,12,0,65,53
1657464143641,COGS 101C,A01,083625,Delgado; Tania,17,0,35,18
1657464149668,COGS 107A,A01,083627,Boyle; Mary E. T.,13,0,60,47
1657464155693,COGS 118A,A01,083075,Gupta; Anjum,21,0,76,55
1657464161718,CSE 3,A50,083646,Miranda; Gregory Joseph,24,0,50,26
1657464167747,CSE 8A,A50,083650,Miranda; Gregory Joseph,17,1,56,39
1657464173776,CSE 11,A01,083080,Cao; Yingjun,6,15,40,34
1657464179800,CSE 12,A01,083652,Krause-Levy; Sophia Louisa,28,1,120,92
1657464185828,CSE 15L,A01,083654,Morris; Justin Loren,9,0,50,41
1657464185828,CSE 15L,A02,083655,Morris; Justin Loren,9,0,50,41
1657464191850,CSE 20,A01,083657,Tran; Khoa Dang,39,0,80,41
1657464197874,CSE 21,A01,095574,Bach; Quang Tran,22,0,48,26
1657464203901,CSE 30,A01,083084,Eldon; John,5,0,80,75
1657464203901,CSE 30,B01,095061,Bhaskar; Nishant,9,0,50,41
1657464209938,CSE 100,A01,083659,Cao; Yingjun,5,4,70,65
1657464215963,CSE 134B,A01,083661,Powell; Thomas Allan,22,0,100,78
1657464221987,CSE 140,A01,083663,Gungor; Onat,15,0,85,70
1657464228011,CSE 140L,A01,083088,Eldon; John,21,0,100,79
1657464234043,CSE 175,A01,083665,Kumar; Rakesh,3,0,25,22
1657464240067,CSE 190,A00,092507,Dubnov; Shlomo,8,0,20,12
1657464246090,ECE 45,A01,083139,Congero; Spencer William,6,0,75,69
1657464252118,ECE 65,A50,083695,Saad; Andrew S,12,0,30,18
1657464252118,ECE 65,A51,095125,Saad; Andrew S,24,0,26,2
1657464258141,ECE 109,A01,091882,Touri; Behrouz,19,0,70,51
1657464264170,ECE 180,A00,083140,Abi Samra; Nicholas Camill,1,0,30,29
1657464264170,ECE 180,B00,083141,Abi Samra; Nicholas Camill,0,0,30,30
1657464270193,MATH 10A,A01,083735,Patchell; Gregory David,2,0,30,28
1657464270193,MATH 10A,A02,083736,Patchell; Gregory David,20,0,30,10
1657464270193,MATH 10A,A03,083737,Patchell; Gregory David,16,0,30,14
1657464276217,MATH 10B,A01,083207,Lim; Seonhee,8,0,34,26
1657464276217,MATH 10B,A02,083208,Lim; Seonhee,9,0,35,26
1657464276217,MATH 10B,A03,093472,Lim; Seonhee,7,0,34,27
1657464276217,MATH 10B,B01,083739,Sinha; Shubham,12,0,30,18
1657464282243,MATH 18,A01,083743,Cinel; Cameron Alexander,7,0,30,23
1657464282243,MATH 18,A02,083744,Cinel; Cameron Alexander,17,0,30,13
1657464282243,MATH 18,A03,083745,Cinel; Cameron Alexander,9,0,30,21
1657464282243,MATH 18,B01,083748,Rideout; David Porter,5,0,37,32
1657464282243,MATH 18,B02,083749,Rideout; David Porter,5,0,36,31
1657464282243,MATH 18,B03,083750,Rideout; David Porter,3,0,37,34
1657464282243,MATH 18,B04,083751,Rideout; David Porter,6,0,36,30
1657464282243,MATH 18,B05,093473,Rideout; David Porter,6,0,36,30
1657464282243,MATH 18,B06,093474,Rideout; David Porter,6,0,36,30
1657464288268,MATH 20A,A01,083754,Zheng; Zequn,14,0,40,26
1657464294296,MATH 20B,A01,083756,Briones; Jor-el Thomas Caparas,4,0,36,32
1657464294296,MATH 20B,A02,083757,Briones; Jor-el Thomas Caparas,1,0,36,35
1657464294296,MATH 20B,A03,093475,Briones; Jor-el Thomas Caparas,2,0,36,34
1657464300319,MATH 20C,A01,083760,Briones; Jor-el Thomas Caparas,1,0,35,34
1657464300319,MATH 20C,A02,083761,Briones; Jor-el Thomas Caparas,8,0,35,27
1657464300319,MATH 20C,A03,093476,Briones; Jor-el Thomas Caparas,0,1,36,36
1657464300319,MATH 20C,B01,083762,Bach; Quang Tran,1,0,30,29
1657464306431,MATH 20D,A01,083765,Tran; Brian Kha,5,0,30,25
1657464306431,MATH 20D,A02,083766,Tran; Brian Kha,5,0,30,25
1657464306431,MATH 20D,A03,083767,Tran; Brian Kha,5,0,30,25
1657464312463,MATH 20E,A01,083771,Ganguly; Soumya,9,0,32,23
1657464312463,MATH 20E,A02,083772,Ganguly; Soumya,6,0,32,26
1657464312463,MATH 20E,B01,083773,Ciotti; Benjamin,20,0,35,15
1657464312463,MATH 20E,B02,083774,Ciotti; Benjamin,17,0,35,18
1657464318492,MATH 103A,A01,083777,Greenfeld; Be'Eri,3,0,36,33
1657464318492,MATH 103A,A02,083778,Greenfeld; Be'Eri,5,0,36,31
1657464318492,MATH 103A,A03,093561,Greenfeld; Be'Eri,5,0,36,31
1657464318492,MATH 103A,B01,083779,Greenfeld; Be'Eri,7,0,36,29
1657464318492,MATH 103A,B02,083780,Greenfeld; Be'Eri,4,0,36,32
1657464318492,MATH 103A,B03,093562,Greenfeld; Be'Eri,3,0,36,33
1657464324522,MATH 105,A01,085443,Carter; Anne Toulson,15,0,35,20
1657464324522,MATH 105,A02,093477,Carter; Anne Toulson,20,0,35,15
1657464330548,MATH 109,A01,083213,Ganzberger; Geoffrey Michael,2,0,34,32
1657464330548,MATH 109,A02,083214,Ganzberger; Geoffrey Michael,4,0,34,30
1657464330548,MATH 109,A03,093478,Ganzberger; Geoffrey Michael,2,0,34,32
1657464330548,MATH 109,B01,083215,Ganzberger; Geoffrey Michael,1,0,32,31
1657464330548,MATH 109,B02,083216,Ganzberger; Geoffrey Michael,2,0,32,30
1657464330548,MATH 109,B03,093479,Ganzberger; Geoffrey Michael,8,0,32,24
1657464336573,MATH 142A,A01,083219,Chow; Bennett,7,0,32,25
1657464336573,MATH 142A,A02,083220,Chow; Bennett,10,0,32,22
1657464336573,MATH 142A,A03,093480,Chow; Bennett,8,0,32,24
1657464336573,MATH 142A,B03,093481,Chow; Bennett,8,0,32,24
1657464336573,MATH 142A,B04,093558,Chow; Bennett,13,0,32,19
1657464336573,MATH 142A,B05,093559,Chow; Bennett,6,0,32,26
1657464342603,MATH 193A,A01,083224,Rotar; Vladimir,8,0,34,26
1657464342603,MATH 193A,A02,083225,Rotar; Vladimir,9,0,34,25
1657464342603,MATH 193A,A03,083781,Rotar; Vladimir,5,0,34,29
1657464342603,MATH 193A,A04,083782,Rotar; Vladimir,10,0,34,24
1657464342603,MATH 193A,A05,093482,Rotar; Vladimir,10,0,34,24
1657464348631,MATH 197,001,091859,McAuley; Julian John,9999,0,9999,0
1657464348631,MATH 197,002,095566,Kedlaya; Kiran S.,9997,0,9999,2
1657464348631,MATH 197,003,095567,Xiao; Ming,9999,0,9999,0
1657464348631,MATH 197,004,095571,Perols; Johan Lars,9998,0,9999,1
1657464355684,COGS 9,A01,083615,Shannon; Kyle Michael,9,0,75,66
1657464361713,COGS 11,A01,083617,Boyle; Mary E. T.,22,0,48,26
1657464367739,COGS 13,A01,083071,Bastos; Amalia Pinkusfeld,11,0,71,60
1657464373761,COGS 14A,A01,092681,Semenuks; Arturs,5,1,100,95
1657464379795,COGS 14B,A01,083073,Cheng; Tzu-Han,6,0,63,57
1657464385818,COGS 17,A01,092677,Semenuks; Arturs,6,0,81,75
1657464391843,COGS 100,A01,083619,Allen; Michael Gordon,17,0,70,53
1657464397870,COGS 101A,A01,083621,Davis; Joshua Daniel,9,0,68,59
1657464403897,COGS 101B,A01,091572,Allen; Michael Gordon,12,0,65,53
1657464409922,COGS 101C,A01,083625,Delgado; Tania,17,0,35,18
1657464415950,COGS 107A,A01,083627,Boyle; Mary E. T.,13,0,60,47
1657464421979,COGS 118A,A01,083075,Gupta; Anjum,21,0,76,55
1657464428005,CSE 3,A50,083646,Miranda; Gregory Joseph,24,0,50,26
1657464434034,CSE 8A,A50,083650,Miranda; Gregory Joseph,17,1,56,39
1657464440056,CSE 11,A01,083080,Cao; Yingjun,6,15,40,34
1657464446081,CSE 12,A01,083652,Krause-Levy; Sophia Louisa,28,1,120,92
1657464452105,CSE 15L,A01,083654,Morris; Justin Loren,9,0,50,41
1657464452105,CSE 15L,A02,083655,Morris; Justin Loren,9,0,50,41
1657464458130,CSE 20,A01,083657,Tran; Khoa Dang,39,0,80,41
1657464464155,CSE 21,A01,095574,Bach; Quang Tran,22,0,48,26
1657464470183,CSE 30,A01,083084,Eldon; John,5,0,80,75
1657464470183,CSE 30,B01,095061,Bhaskar; Nishant,9,0,50,41
1657464476216,CSE 100,A01,083659,Cao; Yingjun,5,4,70,65
1657464482244,CSE 134B,A01,083661,Powell; Thomas Allan,22,0,100,78
1657464488271,CSE 140,A01,083663,Gungor; Onat,15,0,85,70
1657464494300,CSE 140L,A01,083088,Eldon; John,21,0,100,79
1657464500322,CSE 175,A01,083665,Kumar; Rakesh,3,0,25,22
1657464506351,CSE 190,A00,092507,Dubnov; Shlomo,8,0,20,12
1657464512468,ECE 45,A01,083139,Congero; Spencer William,6,0,75,69
1657464518490,ECE 65,A50,083695,Saad; Andrew S,12,0,30,18
1657464518490,ECE 65,A51,095125,Saad; Andrew S,24,0,26,2
1657464524516,ECE 109,A01,091882,Touri; Behrouz,19,0,70,51
1657464530540,ECE 180,A00,083140,Abi Samra; Nicholas Camill,1,0,30,29
1657464530540,ECE 180,B00,083141,Abi Samra; Nicholas Camill,0,0,30,30
1657464536563,MATH 10A,A01,083735,Patchell; Gregory David,2,0,30,28
1657464536563,MATH 10A,A02,083736,Patchell; Gregory David,20,0,30,10
1657464536563,MATH 10A,A03,083737,Patchell; Gregory David,16,0,30,14
1657464542589,MATH 10B,A01,083207,Lim; Seonhee,8,0,34,26
1657464542589,MATH 10B,A02,083208,Lim; Seonhee,9,0,35,26
1657464542589,MATH 10B,A03,093472,Lim; Seonhee,7,0,34,27
1657464542589,MATH 10B,B01,083739,Sinha; Shubham,12,0,30,18
1657464548623,MATH 18,A01,083743,Cinel; Cameron Alexander,7,0,30,23
1657464548623,MATH 18,A02,083744,Cinel; Cameron Alexander,17,0,30,13
1657464548623,MATH 18,A03,083745,Cinel; Cameron Alexander,9,0,30,21
1657464548623,MATH 18,B01,083748,Rideout; David Porter,5,0,37,32
1657464548623,MATH 18,B02,083749,Rideout; David Porter,5,0,36,31
1657464548623,MATH 18,B03,083750,Rideout; David Porter,3,0,37,34
1657464548623,MATH 18,B04,083751,Rideout; David Porter,6,0,36,30
1657464548623,MATH 18,B05,093473,Rideout; David Porter,6,0,36,30
1657464548623,MATH 18,B06,093474,Rideout; David Porter,6,0,36,30
1657464554655,MATH 20A,A01,083754,Zheng; Zequn,14,0,40,26
1657464560679,MATH 20B,A01,083756,Briones; Jor-el Thomas Caparas,4,0,36,32
1657464560679,MATH 20B,A02,083757,Briones; Jor-el Thomas Caparas,1,0,36,35
1657464560679,MATH 20B,A03,093475,Briones; Jor-el Thomas Caparas,2,0,36,34
1657464566702,MATH 20C,A01,083760,Briones; Jor-el Thomas Caparas,1,0,35,34
1657464566702,MATH 20C,A02,083761,Briones; Jor-el Thomas Caparas,8,0,35,27
1657464566702,MATH 20C,A03,093476,Briones; Jor-el Thomas Caparas,0,1,36,36
1657464566702,MATH 20C,B01,083762,Bach; Quang Tran,1,0,30,29
1657464572726,MATH 20D,A01,083765,Tran; Brian Kha,5,0,30,25
1657464572726,MATH 20D,A02,083766,Tran; Brian Kha,5,0,30,25
1657464572726,MATH 20D,A03,083767,Tran; Brian Kha,5,0,30,25
1657464578757,MATH 20E,A01,083771,Ganguly; Soumya,9,0,32,23
1657464578757,MATH 20E,A02,083772,Ganguly; Soumya,6,0,32,26
1657464578757,MATH 20E,B01,083773,Ciotti; Benjamin,20,0,35,15
1657464578757,MATH 20E,B02,083774,Ciotti; Benjamin,17,0,35,18
1657464584783,MATH 103A,A01,083777,Greenfeld; Be'Eri,3,0,36,33
1657464584783,MATH 103A,A02,083778,Greenfeld; Be'Eri,5,0,36,31
1657464584783,MATH 103A,A03,093561,Greenfeld; Be'Eri,5,0,36,31
1657464584783,MATH 103A,B01,083779,Greenfeld; Be'Eri,7,0,36,29
1657464584783,MATH 103A,B02,083780,Greenfeld; Be'Eri,4,0,36,32
1657464584783,MATH 103A,B03,093562,Greenfeld; Be'Eri,3,0,36,33
1657464590807,MATH 105,A01,085443,Carter; Anne Toulson,15,0,35,20
1657464590807,MATH 105,A02,093477,Carter; Anne Toulson,20,0,35,15
1657464596838,MATH 109,A01,083213,Ganzberger; Geoffrey Michael,2,0,34,32
1657464596838,MATH 109,A02,083214,Ganzberger; Geoffrey Michael,4,0,34,30
1657464596838,MATH 109,A03,093478,Ganzberger; Geoffrey Michael,2,0,34,32
1657464596838,MATH 109,B01,083215,Ganzberger; Geoffrey Michael,1,0,32,31
1657464596838,MATH 109,B02,083216,Ganzberger; Geoffrey Michael,2,0,32,30
1657464596838,MATH 109,B03,093479,Ganzberger; Geoffrey Michael,8,0,32,24
1657464602863,MATH 142A,A01,083219,Chow; Bennett,7,0,32,25
1657464602863,MATH 142A,A02,083220,Chow; Bennett,10,0,32,22
1657464602863,MATH 142A,A03,093480,Chow; Bennett,8,0,32,24
1657464602863,MATH 142A,B03,093481,Chow; Bennett,8,0,32,24
1657464602863,MATH 142A,B04,093558,Chow; Bennett,13,0,32,19
1657464602863,MATH 142A,B05,093559,Chow; Bennett,6,0,32,26
1657464608892,MATH 193A,A01,083224,Rotar; Vladimir,8,0,34,26
1657464608892,MATH 193A,A02,083225,Rotar; Vladimir,9,0,34,25
1657464608892,MATH 193A,A03,083781,Rotar; Vladimir,5,0,34,29
1657464608892,MATH 193A,A04,083782,Rotar; Vladimir,10,0,34,24
1657464608892,MATH 193A,A05,093482,Rotar; Vladimir,10,0,34,24
1657464614919,MATH 197,001,091859,McAuley; Julian John,9999,0,9999,0
1657464614919,MATH 197,002,095566,Kedlaya; Kiran S.,9997,0,9999,2
1657464614919,MATH 197,003,095567,Xiao; Ming,9999,0,9999,0
1657464614919,MATH 197,004,095571,Perols; Johan Lars,9998,0,9999,1
1657464621981,COGS 9,A01,083615,Shannon; Kyle Michael,9,0,75,66
1657464628007,COGS 11,A01,083617,Boyle; Mary E. T.,22,0,48,26
1657464634039,COGS 13,A01,083071,Bastos; Amalia Pinkusfeld,11,0,71,60
1657464640064,COGS 14A,A01,092681,Semenuks; Arturs,5,1,100,95
1657464646088,COGS 14B,A01,083073,Cheng; Tzu-Han,6,0,63,57
1657464652112,COGS 17,A01,092677,Semenuks; Arturs,6,0,81,75
1657464658136,COGS 100,A01,083619,Allen; Michael Gordon,17,0,70,53
1657464664164,COGS 101A,A01,083621,Davis; Joshua Daniel,9,0,68,59
1657464670187,COGS 101B,A01,091572,Allen; Michael Gordon,12,0,65,53
1657464676216,COGS 101C,A01,083625,Delgado; Tania,17,0,35,18
1657464682244,COGS 107A,A01,083627,Boyle; Mary E. T.,13,0,60,47
1657464688272,COGS 118A,A01,083075,Gupta; Anjum,21,0,76,55
1657464694297,CSE 3,A50,083646,Miranda; Gregory Joseph,24,0,50,26
1657464700320,CSE 8A,A50,083650,Miranda; Gregory Joseph,17,1,56,39
1657464706348,CSE 11,A01,083080,Cao; Yingjun,6,15,40,34
1657464712376,CSE 12,A01,083652,Krause-Levy; Sophia Louisa,28,1,120,92
1657464718405,CSE 15L,A01,083654,Morris; Justin Loren,9,0,50,41
1657464718405,CSE 15L,A02,083655,Morris; Justin Loren,9,0,50,41
1657464724429,CSE 20,A01,083657,Tran; Khoa Dang,39,0,80,41
1657464730451,CSE 21,A01,095574,Bach; Quang Tran,22,0,48,26
1657464736477,CSE 30,A01,083084,Eldon; John,5,0,80,75
1657464736477,CSE 30,B01,095061,Bhaskar; Nishant,9,0,50,41
1657464742501,CSE 100,A01,083659,Cao; Yingjun,5,4,70,65
1657464748533,CSE 134B,A01,083661,Powell; Thomas Allan,22,0,100,78
1657464754557,CSE 140,A01,083663,Gungor; Onat,15,0,85,70
1657464760584,CSE 140L,A01,083088,Eldon; John,21,0,100,79
1657464766609,CSE 175,A01,083665,Kumar; Rakesh,3,0,25,22
1657464772633,CSE 190,A00,092507,Dubnov; Shlomo,8,0,20,12
1657464778658,ECE 45,A01,083139,Congero; Spencer William,6,0,75,69
1657464784683,ECE 65,A50,083695,Saad; Andrew S,12,0,30,18
1657464784683,ECE 65,A51,095125,Saad; Andrew S,24,0,26,2
1657464790710,ECE 109,A01,091882,Touri; Behrouz,19,0,70,51
1657464796737,ECE 180,A00,083140,Abi Samra; Nicholas Camill,1,0,30,29
1657464796737,ECE 180,B00,083141,Abi Samra; Nicholas Camill,0,0,30,30
1657464802764,MATH 10A,A01,083735,Patchell; Gregory David,2,0,30,28
1657464802764,MATH 10A,A02,083736,Patchell; Gregory David,20,0,30,10
1657464802764,MATH 10A,A03,083737,Patchell; Gregory David,16,0,30,14
1657464808800,MATH 10B,A01,083207,Lim; Seonhee,8,0,34,26
1657464808800,MATH 10B,A02,083208,Lim; Seonhee,9,0,35,26
1657464808800,MATH 10B,A03,093472,Lim; Seonhee,7,0,34,27
1657464808800,MATH 10B,B01,083739,Sinha; Shubham,12,0,30,18
1657464814824,MATH 18,A01,083743,Cinel; Cameron Alexander,7,0,30,23
1657464814824,MATH 18,A02,083744,Cinel; Cameron Alexander,17,0,30,13
1657464814824,MATH 18,A03,083745,Cinel; Cameron Alexander,9,0,30,21
1657464814824,MATH 18,B01,083748,Rideout; David Porter,5,0,37,32
1657464814824,MATH 18,B02,083749,Rideout; David Porter,5,0,36,31
1657464814824,MATH 18,B03,083750,Rideout; David Porter,3,0,37,34
1657464814824,MATH 18,B04,083751,Rideout; David Porter,6,0,36,30
1657464814824,MATH 18,B05,093473,Rideout; David Porter,6,0,36,30
1657464814824,MATH 18,B06,093474,Rideout; David Porter,6,0,36,30
1657464820846,MATH 20A,A01,083754,Zheng; Zequn,14,0,40,26
1657464826870,MATH 20B,A01,083756,Briones; Jor-el Thomas Caparas,4,0,36,32
1657464826870,MATH 20B,A02,083757,Briones; Jor-el Thomas Caparas,1,0,36,35
1657464826870,MATH 20B,A03,093475,Briones; Jor-el Thomas Caparas,2,0,36,34
1657464832895,MATH 20C,A01,083760,Briones; Jor-el Thomas Caparas,1,0,35,34
1657464832895,MATH 20C,A02,083761,Briones; Jor-el Thomas Caparas,8,0,35,27
1657464832895,MATH 20C,A03,093476,Briones; Jor-el Thomas Caparas,0,1,36,36
1657464832895,MATH 20C,B01,083762,Bach; Quang Tran,1,0,30,29
1657464838919,MATH 20D,A01,083765,Tran; Brian Kha,5,0,30,25
1657464838919,MATH 20D,A02,083766,Tran; Brian Kha,5,0,30,25
1657464838919,MATH 20D,A03,083767,Tran; Brian Kha,5,0,30,25
1657464844947,MATH 20E,A01,083771,Ganguly; Soumya,9,0,32,23
1657464844947,MATH 20E,A02,083772,Ganguly; Soumya,6,0,32,26
1657464844947,MATH 20E,B01,083773,Ciotti; Benjamin,20,0,35,15
1657464844947,MATH 20E,B02,083774,Ciotti; Benjamin,17,0,35,18
1657464850973,MATH 103A,A01,083777,Greenfeld; Be'Eri,3,0,36,33
1657464850973,MATH 103A,A02,083778,Greenfeld; Be'Eri,5,0,36,31
1657464850973,MATH 103A,A03,093561,Greenfeld; Be'Eri,5,0,36,31
1657464850973,MATH 103A,B01,083779,Greenfeld; Be'Eri,7,0,36,29
1657464850973,MATH 103A,B02,083780,Greenfeld; Be'Eri,4,0,36,32
1657464850973,MATH 103A,B03,093562,Greenfeld; Be'Eri,3,0,36,33
1657464857017,MATH 105,A01,085443,Carter; Anne Toulson,15,0,35,20
1657464857017,MATH 105,A02,093477,Carter; Anne Toulson,20,0,35,15
1657464863044,MATH 109,A01,083213,Ganzberger; Geoffrey Michael,2,0,34,32
1657464863044,MATH 109,A02,083214,Ganzberger; Geoffrey Michael,4,0,34,30
1657464863044,MATH 109,A03,093478,Ganzberger; Geoffrey Michael,2,0,34,32
1657464863044,MATH 109,B01,083215,Ganzberger; Geoffrey Michael,1,0,32,31
1657464863044,MATH 109,B02,083216,Ganzberger; Geoffrey Michael,2,0,32,30
1657464863044,MATH 109,B03,093479,Ganzberger; Geoffrey Michael,8,0,32,24
1657464869079,MATH 142A,A01,083219,Chow; Bennett,7,0,32,25
1657464869079,MATH 142A,A02,083220,Chow; Bennett,10,0,32,22
1657464869079,MATH 142A,A03,093480,Chow; Bennett,8,0,32,24
1657464869079,MATH 142A,B03,093481,Chow; Bennett,8,0,32,24
1657464869079,MATH 142A,B04,093558,Chow; Bennett,13,0,32,19
1657464869079,MATH 142A,B05,093559,Chow; Bennett,6,0,32,26
1657464875107,MATH 193A,A01,083224,Rotar; Vladimir,8,0,34,26
1657464875107,MATH 193A,A02,083225,Rotar; Vladimir,9,0,34,25
1657464875107,MATH 193A,A03,083781,Rotar; Vladimir,5,0,34,29
1657464875107,MATH 193A,A04,083782,Rotar; Vladimir,10,0,34,24
1657464875107,MATH 193A,A05,093482,Rotar; Vladimir,10,0,34,24
1657464881131,MATH 197,001,091859,McAuley; Julian John,9999,0,9999,0
1657464881131,MATH 197,002,095566,Kedlaya; Kiran S.,9997,0,9999,2
1657464881131,MATH 197,003,095567,Xiao; Ming,9999,0,9999,0
1657464881131,MATH 197,004,095571,Perols; Johan Lars,9998,0,9999,1
1657464888187,COGS 9,A01,083615,Shannon; Kyle Michael,9,0,75,66
1657464894212,COGS 11,A01,083617,Boyle; Mary E. T.,22,0,48,26
1657464900329,COGS 13,A01,083071,Bastos; Amalia Pinkusfeld,11,0,71,60
1657464906357,COGS 14A,A01,092681,Semenuks; Arturs,5,1,100,95
1657464912380,COGS 14B,A01,083073,Cheng; Tzu-Han,6,0,63,57
1657464918404,COGS 17,A01,092677,Semenuks; Arturs,6,0,81,75
1657464924430,COGS 100,A01,083619,Allen; Michael Gordon,17,0,70,53
1657464930454,COGS 101A,A01,083621,Davis; Joshua Daniel,9,0,68,59
1657464936477,COGS 101B,A01,091572,Allen; Michael Gordon,12,0,65,53
1657464942499,COGS 101C,A01,083625,Delgado; Tania,17,0,35,18
1657464948522,COGS 107A,A01,083627,Boyle; Mary E. T.,13,0,60,47
1657464954547,COGS 118A,A01,083075,Gupta; Anjum,21,0,76,55
1657464960579,CSE 3,A50,083646,Miranda; Gregory Joseph,24,0,50,26
1657464966606,CSE 8A,A50,083650,Miranda; Gregory Joseph,17,1,56,39
1657464972628,CSE 11,A01,083080,Cao; Yingjun,6,15,40,34
1657464978656,CSE 12,A01,083652,Krause-Levy; Sophia Louisa,28,1,120,92
1657464984678,CSE 15L,A01,083654,Morris; Justin Loren,9,0,50,41
1657464984678,CSE 15L,A02,083655,Morris; Justin Loren,9,0,50,41
1657464990707,CSE 20,A01,083657,Tran; Khoa Dang,39,0,80,41
1657464996733,CSE 21,A01,095574,Bach; Quang Tran,22,0,48,26
1657465002759,CSE 30,A01,083084,Eldon; John,5,0,80,75
1657465002759,CSE 30,B01,095061,Bhaskar; Nishant,9,0,50,41
1657465008786,CSE 100,A01,083659,Cao; Yingjun,5,4,70,65
1657465014810,CSE 134B,A01,083661,Powell; Thomas Allan,22,0,100,78
1657465020839,CSE 140,A01,083663,Gungor; Onat,15,0,85,70
1657465026876,CSE 140L,A01,083088,Eldon; John,21,0,100,79
1657465032904,CSE 175,A01,083665,Kumar; Rakesh,3,0,25,22
1657465038929,CSE 190,A00,092507,Dubnov; Shlomo,8,0,20,12
1657465044958,ECE 45,A01,083139,Congero; Spencer William,6,0,75,69
1657465050983,ECE 65,A50,083695,Saad; Andrew S,12,0,30,18
1657465050983,ECE 65,A51,095125,Saad; Andrew S,24,0,26,2
1657465057008,ECE 109,A01,091882,Touri; Behrouz,19,0,70,51
1657465063037,ECE 180,A00,083140,Abi Samra; Nicholas Camill,1,0,30,29
1657465063037,ECE 180,B00,083141,Abi Samra; Nicholas Camill,0,0,30,30
1657465069064,MATH 10A,A01,083735,Patchell; Gregory David,2,0,30,28
1657465069064,MATH 10A,A02,083736,Patchell; Gregory David,20,0,30,10
1657465069064,MATH 10A,A03,083737,Patchell; Gregory David,16,0,30,14
1657465075088,MATH 10B,A01,083207,Lim; Seonhee,8,0,34,26
1657465075088,MATH 10B,A02,083208,Lim; Seonhee,9,0,35,26
1657465075088,MATH 10B,A03,093472,Lim; Seonhee,7,0,34,27
1657465075088,MATH 10B,B01,083739,Sinha; Shubham,12,0,30,18
1657465081120,MATH 18,A01,083743,Cinel; Cameron Alexander,7,0,30,23
1657465081120,MATH 18,A02,083744,Cinel; Cameron Alexander,17,0,30,13
1657465081120,MATH 18,A03,083745,Cinel; Cameron Alexander,9,0,30,21
1657465081120,MATH 18,B01,083748,Rideout; David Porter,5,0,37,32
1657465081120,MATH 18,B02,083749,Rideout; David Porter,5,0,36,31
1657465081120,MATH 18,B03,083750,Rideout; David Porter,3,0,37,34
1657465081120,MATH 18,B04,083751,Rideout; David Porter,6,0,36,30
1657465081120,MATH 18,B05,093473,Rideout; David Porter,6,0,36,30
1657465081120,MATH 18,B06,093474,Rideout; David Porter,6,0,36,30
1657465087143,MATH 20A,A01,083754,Zheng; Zequn,14,0,40,26
1657465093170,MATH 20B,A01,083756,Briones; Jor-el Thomas Caparas,4,0,36,32
1657465093170,MATH 20B,A02,083757,Briones; Jor-el Thomas Caparas,1,0,36,35
1657465093170,MATH 20B,A03,093475,Briones; Jor-el Thomas Caparas,2,0,36,34
1657465099195,MATH 20C,A01,083760,Briones; Jor-el Thomas Caparas,1,0,35,34
1657465099195,MATH 20C,A02,083761,Briones; Jor-el Thomas Caparas,8,0,35,27
1657465099195,MATH 20C,A03,093476,Briones; Jor-el Thomas Caparas,0,1,36,36
1657465099195,MATH 20C,B01,083762,Bach; Quang Tran,1,0,30,29
1657465105219,MATH 20D,A01,083765,Tran; Brian Kha,5,0,30,25
1657465105219,MATH 20D,A02,083766,Tran; Brian Kha,5,0,30,25
1657465105219,MATH 20D,A03,083767,Tran; Brian Kha,5,0,30,25
1657465111247,MATH 20E,A01,083771,Ganguly; Soumya,9,0,32,23
1657465111247,MATH 20E,A02,083772,Ganguly; Soumya,6,0,32,26
1657465111247,MATH 20E,B01,083773,Ciotti; Benjamin,20,0,35,15
1657465111247,MATH 20E,B02,083774,Ciotti; Benjamin,17,0,35,18
1657465117273,MATH 103A,A01,083777,Greenfeld; Be'Eri,3,0,36,33
1657465117273,MATH 103A,A02,083778,Greenfeld; Be'Eri,5,0,36,31
1657465117273,MATH 103A,A03,093561,Greenfeld; Be'Eri,5,0,36,31
1657465117273,MATH 103A,B01,083779,Greenfeld; Be'Eri,7,0,36,29
1657465117273,MATH 103A,B02,083780,Greenfeld; Be'Eri,4,0,36,32
1657465117273,MATH 103A,B03,093562,Greenfeld; Be'Eri,3,0,36,33
1657465123299,MATH 105,A01,085443,Carter; Anne Toulson,15,0,35,20
1657465123299,MATH 105,A02,093477,Carter; Anne Toulson,20,0,35,15
1657465129330,MATH 109,A01,083213,Ganzberger; Geoffrey Michael,2,0,34,32
1657465129330,MATH 109,A02,083214,Ganzberger; Geoffrey Michael,4,0,34,30
1657465129330,MATH 109,A03,093478,Ganzberger; Geoffrey Michael,2,0,34,32
1657465129330,MATH 109,B01,083215,Ganzberger; Geoffrey Michael,1,0,32,31
1657465129330,MATH 109,B02,083216,Ganzberger; Geoffrey Michael,2,0,32,30
1657465129330,MATH 109,B03,093479,Ganzberger; Geoffrey Michael,8,0,32,24
1657465135358,MATH 142A,A01,083219,Chow; Bennett,7,0,32,25
1657465135358,MATH 142A,A02,083220,Chow; Bennett,10,0,32,22
1657465135358,MATH 142A,A03,093480,Chow; Bennett,8,0,32,24
1657465135358,MATH 142A,B03,093481,Chow; Bennett,8,0,32,24
1657465135358,MATH 142A,B04,093558,Chow; Bennett,13,0,32,19
1657465135358,MATH 142A,B05,093559,Chow; Bennett,6,0,32,26
1657465141395,MATH 193A,A01,083224,Rotar; Vladimir,8,0,34,26
1657465141395,MATH 193A,A02,083225,Rotar; Vladimir,9,0,34,25
1657465141395,MATH 193A,A03,083781,Rotar; Vladimir,5,0,34,29
1657465141395,MATH 193A,A04,083782,Rotar; Vladimir,10,0,34,24
1657465141395,MATH 193A,A05,093482,Rotar; Vladimir,10,0,34,24
1657465147418,MATH 197,001,091859,McAuley; Julian John,9999,0,9999,0
1657465147418,MATH 197,002,095566,Kedlaya; Kiran S.,9997,0,9999,2
1657465147418,MATH 197,003,095567,Xiao; Ming,9999,0,9999,0
1657465147418,MATH 197,004,095571,Perols; Johan Lars,9998,0,9999,1
1657465154483,COGS 9,A01,083615,Shannon; Kyle Michael,9,0,75,66
1657465160506,COGS 11,A01,083617,Boyle; Mary E. T.,22,0,48,26
1657465166534,COGS 13,A01,083071,Bastos; Amalia Pinkusfeld,11,0,71,60
1657465172560,COGS 14A,A01,092681,Semenuks; Arturs,5,1,100,95
1657465178591,COGS 14B,A01,083073,Cheng; Tzu-Han,6,0,63,57
1657465184624,COGS 17,A01,092677,Semenuks; Arturs,6,0,81,75
1657465190649,COGS 100,A01,083619,Allen; Michael Gordon,17,0,70,53
1657465196677,COGS 101A,A01,083621,Davis; Joshua Daniel,9,0,68,59
1657465202706,COGS 101B,A01,091572,Allen; Michael Gordon,12,0,65,53
1657465208730,COGS 101C,A01,083625,Delgado; Tania,17,0,35,18
1657465214753,COGS 107A,A01,083627,Boyle; Mary E. T.,13,0,60,47
1657465220780,COGS 118A,A01,083075,Gupta; Anjum,21,0,76,55
1657465226819,CSE 3,A50,083646,Miranda; Gregory Joseph,24,0,50,26
1657465232843,CSE 8A,A50,083650,Miranda; Gregory Joseph,17,1,56,39
1657465238874,CSE 11,A01,083080,Cao; Yingjun,6,15,40,34
1657465244896,CSE 12,A01,083652,Krause-Levy; Sophia Louisa,28,1,120,92
1657465250920,CSE 15L,A01,083654,Morris; Justin Loren,9,0,50,41
1657465250920,CSE 15L,A02,083655,Morris; Justin Loren,9,0,50,41
1657465256946,CSE 20,A01,083657,Tran; Khoa Dang,39,0,80,41
1657465262971,CSE 21,A01,095574,Bach; Quang Tran,22,0,48,26
1657465268996,CSE 30,A01,083084,Eldon; John,5,0,80,75
1657465268996,CSE 30,B01,095061,Bhaskar; Nishant,9,0,50,41
1657465275042,CSE 100,A01,083659,Cao; Yingjun,5,4,70,65
1657465281066,CSE 134B,A01,083661,Powell; Thomas Allan,22,0,100,78
1657465287090,CSE 140,A01,083663,Gungor; Onat,15,0,85,70
1657465293115,CSE 140L,A01,083088,Eldon; John,21,0,100,79
1657465299138,CSE 175,A01,083665,Kumar; Rakesh,3,0,25,22
1657465305163,CSE 190,A00,092507,Dubnov; Shlomo,8,0,20,12
1657465311204,ECE 45,A01,083139,Congero; Spencer William,6,0,75,69
1657465317228,ECE 65,A50,083695,Saad; Andrew S,12,0,30,18
1657465317228,ECE 65,A51,095125,Saad; Andrew S,24,0,26,2
1657465323252,ECE 109,A01,091882,Touri; Behrouz,19,0,70,51
1657465329280,ECE 180,A00,083140,Abi Samra; Nicholas Camill,1,0,30,29
1657465329280,ECE 180,B00,083141,Abi Samra; Nicholas Camill,0,0,30,30
1657465335314,MATH 10A,A01,083735,Patchell; Gregory David,2,0,30,28
1657465335314,MATH 10A,A02,083736,Patchell; Gregory David,20,0,30,10
1657465335314,MATH 10A,A03,083737,Patchell; Gregory David,16,0,30,14
1657465341338,MATH 10B,A01,083207,Lim; Seonhee,8,0,34,26
1657465341338,MATH 10B,A02,083208,Lim; Seonhee,9,0,35,26
1657465341338,MATH 10B,A03,093472,Lim; Seonhee,7,0,34,27
1657465341338,MATH 10B,B01,083739,Sinha; Shubham,12,0,30,18
1657465347363,MATH 18,A01,083743,Cinel; Cameron Alexander,7,0,30,23
1657465347363,MATH 18,A02,083744,Cinel; Cameron Alexander,17,0,30,13
1657465347363,MATH 18,A03,083745,Cinel; Cameron Alexander,9,0,30,21
1657465347363,MATH 18,B01,083748,Rideout; David Porter,5,0,37,32
1657465347363,MATH 18,B02,083749,Rideout; David Porter,5,0,36,31
1657465347363,MATH 18,B03,083750,Rideout; David Porter,3,0,37,34
1657465347363,MATH 18,B04,083751,Rideout; David Porter,6,0,36,30
1657465347363,MATH 18,B05,093473,Rideout; David Porter,6,0,36,30
1657465347363,MATH 18,B06,093474,Rideout; David Porter,6,0,36,30
1657465353386,MATH 20A,A01,083754,Zheng; Zequn,14,0,40,26
1657465359411,MATH 20B,A01,083756,Briones; Jor-el Thomas Caparas,4,0,36,32
1657465359411,MATH 20B,A02,083757,Briones; Jor-el Thomas Caparas,1,0,36,35
1657465359411,MATH 20B,A03,093475,Briones; Jor-el Thomas Caparas,2,0,36,34
1657465365440,MATH 20C,A01,083760,Briones; Jor-el Thomas Caparas,1,0,35,34
1657465365440,MATH 20C,A02,083761,Briones; Jor-el Thomas Caparas,8,0,35,27
1657465365440,MATH 20C,A03,093476,Briones; Jor-el Thomas Caparas,0,1,36,36
1657465365440,MATH 20C,B01,083762,Bach; Quang Tran,1,0,30,29
1657465371470,MATH 20D,A01,083765,Tran; Brian Kha,5,0,30,25
1657465371470,MATH 20D,A02,083766,Tran; Brian Kha,5,0,30,25
1657465371470,MATH 20D,A03,083767,Tran; Brian Kha,5,0,30,25
1657465377500,MATH 20E,A01,083771,Ganguly; Soumya,9,0,32,23
1657465377500,MATH 20E,A02,083772,Ganguly; Soumya,6,0,32,26
1657465377500,MATH 20E,B01,083773,Ciotti; Benjamin,20,0,35,15
1657465377500,MATH 20E,B02,083774,Ciotti; Benjamin,17,0,35,18
1657465383529,MATH 103A,A01,083777,Greenfeld; Be'Eri,3,0,36,33
1657465383529,MATH 103A,A02,083778,Greenfeld; Be'Eri,5,0,36,31
1657465383529,MATH 103A,A03,093561,Greenfeld; Be'Eri,5,0,36,31
1657465383529,MATH 103A,B01,083779,Greenfeld; Be'Eri,7,0,36,29
1657465383529,MATH 103A,B02,083780,Greenfeld; Be'Eri,4,0,36,32
1657465383529,MATH 103A,B03,093562,Greenfeld; Be'Eri,3,0,36,33
1657465389553,MATH 105,A01,085443,Carter; Anne Toulson,15,0,35,20
1657465389553,MATH 105,A02,093477,Carter; Anne Toulson,20,0,35,15
1657465395582,MATH 109,A01,083213,Ganzberger; Geoffrey Michael,2,0,34,32
1657465395582,MATH 109,A02,083214,Ganzberger; Geoffrey Michael,4,0,34,30
1657465395582,MATH 109,A03,093478,Ganzberger; Geoffrey Michael,2,0,34,32
1657465395582,MATH 109,B01,083215,Ganzberger; Geoffrey Michael,1,0,32,31
1657465395582,MATH 109,B02,083216,Ganzberger; Geoffrey Michael,2,0,32,30
1657465395582,MATH 109,B03,093479,Ganzberger; Geoffrey Michael,8,0,32,24
1657465401612,MATH 142A,A01,083219,Chow; Bennett,7,0,32,25
1657465401612,MATH 142A,A02,083220,Chow; Bennett,10,0,32,22
1657465401612,MATH 142A,A03,093480,Chow; Bennett,8,0,32,24
1657465401612,MATH 142A,B03,093481,Chow; Bennett,8,0,32,24
1657465401612,MATH 142A,B04,093558,Chow; Bennett,13,0,32,19
1657465401612,MATH 142A,B05,093559,Chow; Bennett,6,0,32,26
1657465407643,MATH 193A,A01,083224,Rotar; Vladimir,8,0,34,26
1657465407643,MATH 193A,A02,083225,Rotar; Vladimir,9,0,34,25
1657465407643,MATH 193A,A03,083781,Rotar; Vladimir,5,0,34,29
1657465407643,MATH 193A,A04,083782,Rotar; Vladimir,10,0,34,24
1657465407643,MATH 193A,A05,093482,Rotar; Vladimir,10,0,34,24
1657465413667,MATH 197,001,091859,McAuley; Julian John,9999,0,9999,0
1657465413667,MATH 197,002,095566,Kedlaya; Kiran S.,9997,0,9999,2
1657465413667,MATH 197,003,095567,Xiao; Ming,9999,0,9999,0
1657465413667,MATH 197,004,095571,Perols; Johan Lars,9998,0,9999,1
1657465420736,COGS 9,A01,083615,Shannon; Kyle Michael,9,0,75,66
1657465426759,COGS 11,A01,083617,Boyle; Mary E. T.,22,0,48,26
1657465432780,COGS 13,A01,083071,Bastos; Amalia Pinkusfeld,11,0,71,60
1657465438803,COGS 14A,A01,092681,Semenuks; Arturs,5,1,100,95
1657465444827,COGS 14B,A01,083073,Cheng; Tzu-Han,6,0,63,57
1657465450850,COGS 17,A01,092677,Semenuks; Arturs,6,0,81,75
1657465456877,COGS 100,A01,083619,Allen; Michael Gordon,17,0,70,53
1657465462901,COGS 101A,A01,083621,Davis; Joshua Daniel,9,0,68,59
1657465468928,COGS 101B,A01,091572,Allen; Michael Gordon,12,0,65,53
1657465474955,COGS 101C,A01,083625,Delgado; Tania,17,0,35,18
1657465480981,COGS 107A,A01,083627,Boyle; Mary E. T.,13,0,60,47
1657465487010,COGS 118A,A01,083075,Gupta; Anjum,21,0,76,55
1657465493034,CSE 3,A50,083646,Miranda; Gregory Joseph,24,0,50,26
1657465499129,CSE 8A,A50,083650,Miranda; Gregory Joseph,17,1,56,39
1657465505164,CSE 11,A01,083080,Cao; Yingjun,6,15,40,34
1657465511188,CSE 12,A01,083652,Krause-Levy; Sophia Louisa,28,1,120,92
1657465517213,CSE 15L,A01,083654,Morris; Justin Loren,9,0,50,41
1657465517213,CSE 15L,A02,083655,Morris; Justin Loren,9,0,50,41
1657465523236,CSE 20,A01,083657,Tran; Khoa Dang,39,0,80,41
1657465529258,CSE 21,A01,095574,Bach; Quang Tran,22,0,48,26
1657465535285,CSE 30,A01,083084,Eldon; John,5,0,80,75
1657465535285,CSE 30,B01,095061,Bhaskar; Nishant,9,0,50,41
1657465541313,CSE 100,A01,083659,Cao; Yingjun,5,4,70,65
1657465547339,CSE 134B,A01,083661,Powell; Thomas Allan,22,0,100,78
1657465553364,CSE 140,A01,083663,Gungor; Onat,15,0,85,70
1657465559391,CSE 140L,A01,083088,Eldon; John,21,0,100,79
1657465565414,CSE 175,A01,083665,Kumar; Rakesh,3,0,25,22
1657465571437,CSE 190,A00,092507,Dubnov; Shlomo,8,0,20,12
1657465577461,ECE 45,A01,083139,Congero; Spencer William,6,0,75,69
1657465583489,ECE 65,A50,083695,Saad; Andrew S,12,0,30,18
1657465583489,ECE 65,A51,095125,Saad; Andrew S,24,0,26,2
1657465589513,ECE 109,A01,091882,Touri; Behrouz,19,0,70,51
1657465595536,ECE 180,A00,083140,Abi Samra; Nicholas Camill,1,0,30,29
1657465595536,ECE 180,B00,083141,Abi Samra; Nicholas Camill,0,0,30,30
1657465601561,MATH 10A,A01,083735,Patchell; Gregory David,2,0,30,28
1657465601561,MATH 10A,A02,083736,Patchell; Gregory David,20,0,30,10
1657465601561,MATH 10A,A03,083737,Patchell; Gregory David,16,0,30,14
1657465607584,MATH 10B,A01,083207,Lim; Seonhee,8,0,34,26
1657465607584,MATH 10B,A02,083208,Lim; Seonhee,9,0,35,26
1657465607584,MATH 10B,A03,093472,Lim; Seonhee,7,0,34,27
1657465607584,MATH 10B,B01,083739,Sinha; Shubham,12,0,30,18
1657465613615,MATH 18,A01,083743,Cinel; Cameron Alexander,7,0,30,23
1657465613615,MATH 18,A02,083744,Cinel; Cameron Alexander,17,0,30,13
1657465613615,MATH 18,A03,083745,Cinel; Cameron Alexander,9,0,30,21
1657465613615,MATH 18,B01,083748,Rideout; David Porter,5,0,37,32
1657465613615,MATH 18,B02,083749,Rideout; David Porter,5,0,36,31
1657465613615,MATH 18,B03,083750,Rideout; David Porter,3,0,37,34
1657465613615,MATH 18,B04,083751,Rideout; David Porter,6,0,36,30
1657465613615,MATH 18,B05,093473,Rideout; David Porter,6,0,36,30
1657465613615,MATH 18,B06,093474,Rideout; David Porter,6,0,36,30
1657465619639,MATH 20A,A01,083754,Zheng; Zequn,14,0,40,26
1657465625665,MATH 20B,A01,083756,Briones; Jor-el Thomas Caparas,4,0,36,32
1657465625665,MATH 20B,A02,083757,Briones; Jor-el Thomas Caparas,1,0,36,35
1657465625665,MATH 20B,A03,093475,Briones; Jor-el Thomas Caparas,2,0,36,34
1657465631690,MATH 20C,A01,083760,Briones; Jor-el Thomas Caparas,1,0,35,34
1657465631690,MATH 20C,A02,083761,Briones; Jor-el Thomas Caparas,8,0,35,27
1657465631690,MATH 20C,A03,093476,Briones; Jor-el Thomas Caparas,0,1,36,36
1657465631690,MATH 20C,B01,083762,Bach; Quang Tran,1,0,30,29
1657465637720,MATH 20D,A01,083765,Tran; Brian Kha,5,0,30,25
1657465637720,MATH 20D,A02,083766,Tran; Brian Kha,5,0,30,25
1657465637720,MATH 20D,A03,083767,Tran; Brian Kha,5,0,30,25
1657465643745,MATH 20E,A01,083771,Ganguly; Soumya,9,0,32,23
1657465643745,MATH 20E,A02,083772,Ganguly; Soumya,6,0,32,26
1657465643745,MATH 20E,B01,083773,Ciotti; Benjamin,20,0,35,15
1657465643745,MATH 20E,B02,083774,Ciotti; Benjamin,17,0,35,18
1657465649770,MATH 103A,A01,083777,Greenfeld; Be'Eri,3,0,36,33
1657465649770,MATH 103A,A02,083778,Greenfeld; Be'Eri,5,0,36,31
1657465649770,MATH 103A,A03,093561,Greenfeld; Be'Eri,5,0,36,31
1657465649770,MATH 103A,B01,083779,Greenfeld; Be'Eri,7,0,36,29
1657465649770,MATH 103A,B02,083780,Greenfeld; Be'Eri,4,0,36,32
1657465649770,MATH 103A,B03,093562,Greenfeld; Be'Eri,3,0,36,33
1657465655799,MATH 105,A01,085443,Carter; Anne Toulson,15,0,35,20
1657465655799,MATH 105,A02,093477,Carter; Anne Toulson,20,0,35,15
1657465661823,MATH 109,A01,083213,Ganzberger; Geoffrey Michael,2,0,34,32
1657465661823,MATH 109,A02,083214,Ganzberger; Geoffrey Michael,4,0,34,30
1657465661823,MATH 109,A03,093478,Ganzberger; Geoffrey Michael,2,0,34,32
1657465661823,MATH 109,B01,083215,Ganzberger; Geoffrey Michael,1,0,32,31
1657465661823,MATH 109,B02,083216,Ganzberger; Geoffrey Michael,2,0,32,30
1657465661823,MATH 109,B03,093479,Ganzberger; Geoffrey Michael,8,0,32,24
1657465667850,MATH 142A,A01,083219,Chow; Bennett,7,0,32,25
1657465667850,MATH 142A,A02,083220,Chow; Bennett,10,0,32,22
1657465667850,MATH 142A,A03,093480,Chow; Bennett,8,0,32,24
1657465667850,MATH 142A,B03,093481,Chow; Bennett,8,0,32,24
1657465667850,MATH 142A,B04,093558,Chow; Bennett,13,0,32,19
1657465667850,MATH 142A,B05,093559,Chow; Bennett,6,0,32,26
1657465673873,MATH 193A,A01,083224,Rotar; Vladimir,8,0,34,26
1657465673873,MATH 193A,A02,083225,Rotar; Vladimir,9,0,34,25
1657465673873,MATH 193A,A03,083781,Rotar; Vladimir,5,0,34,29
1657465673873,MATH 193A,A04,083782,Rotar; Vladimir,10,0,34,24
1657465673873,MATH 193A,A05,093482,Rotar; Vladimir,10,0,34,24
1657465679897,MATH 197,001,091859,McAuley; Julian John,9999,0,9999,0
1657465679897,MATH 197,002,095566,Kedlaya; Kiran S.,9997,0,9999,2
1657465679897,MATH 197,003,095567,Xiao; Ming,9999,0,9999,0
1657465679897,MATH 197,004,095571,Perols; Johan Lars,9998,0,9999,1
1657465686950,COGS 9,A01,083615,Shannon; Kyle Michael,9,0,75,66
1657465692977,COGS 11,A01,083617,Boyle; Mary E. T.,22,0,48,26
1657465699002,COGS 13,A01,083071,Bastos; Amalia Pinkusfeld,11,0,71,60
1657465705027,COGS 14A,A01,092681,Semenuks; Arturs,5,1,100,95
1657465711055,COGS 14B,A01,083073,Cheng; Tzu-Han,6,0,63,57
1657465717080,COGS 17,A01,092677,Semenuks; Arturs,6,0,81,75
1657465723104,COGS 100,A01,083619,Allen; Michael Gordon,17,0,70,53
1657465729132,COGS 101A,A01,083621,Davis; Joshua Daniel,9,0,68,59
1657465735155,COGS 101B,A01,091572,Allen; Michael Gordon,12,0,65,53
1657465741187,COGS 101C,A01,083625,Delgado; Tania,17,0,35,18
1657465747211,COGS 107A,A01,083627,Boyle; Mary E. T.,13,0,60,47
1657465753235,COGS 118A,A01,083075,Gupta; Anjum,21,0,76,55
1657465759268,CSE 3,A50,083646,Miranda; Gregory Joseph,24,0,50,26
1657465765296,CSE 8A,A50,083650,Miranda; Gregory Joseph,17,1,56,39
1657465771319,CSE 11,A01,083080,Cao; Yingjun,6,15,40,34
1657465777345,CSE 12,A01,083652,Krause-Levy; Sophia Louisa,28,1,120,92
1657465783368,CSE 15L,A01,083654,Morris; Justin Loren,9,0,50,41
1657465783368,CSE 15L,A02,083655,Morris; Justin Loren,9,0,50,41
1657465789391,CSE 20,A01,083657,Tran; Khoa Dang,39,0,80,41
1657465795414,CSE 21,A01,095574,Bach; Quang Tran,22,0,48,26
1657465801441,CSE 30,A01,083084,Eldon; John,5,0,80,75
1657465801441,CSE 30,B01,095061,Bhaskar; Nishant,9,0,50,41
1657465807467,CSE 100,A01,083659,Cao; Yingjun,5,4,70,65
1657465813493,CSE 134B,A01,083661,Powell; Thomas Allan,22,0,100,78
1657465819526,CSE 140,A01,083663,Gungor; Onat,15,0,85,70
1657465825553,CSE 140L,A01,083088,Eldon; John,21,0,100,79
1657465831578,CSE 175,A01,083665,Kumar; Rakesh,3,0,25,22
1657465837603,CSE 190,A00,092507,Dubnov; Shlomo,8,0,20,12
1657465843628,ECE 45,A01,083139,Congero; Spencer William,6,0,75,69
1657465849650,ECE 65,A50,083695,Saad; Andrew S,12,0,30,18
1657465849650,ECE 65,A51,095125,Saad; Andrew S,24,0,26,2
1657465855672,ECE 109,A01,091882,Touri; Behrouz,19,0,70,51
1657465861696,ECE 180,A00,083140,Abi Samra; Nicholas Camill,1,0,30,29
1657465861696,ECE 180,B00,083141,Abi Samra; Nicholas Camill,0,0,30,30
1657465867718,MATH 10A,A01,083735,Patchell; Gregory David,2,0,30,28
1657465867718,MATH 10A,A02,083736,Patchell; Gregory David,20,0,30,10
1657465867718,MATH 10A,A03,083737,Patchell; Gregory David,16,0,30,14
1657465873742,MATH 10B,A01,083207,Lim; Seonhee,8,0,34,26
1657465873742,MATH 10B,A02,083208,Lim; Seonhee,9,0,35,26
1657465873742,MATH 10B,A03,093472,Lim; Seonhee,7,0,34,27
1657465873742,MATH 10B,B01,083739,Sinha; Shubham,12,0,30,18
1657465879771,MATH 18,A01,083743,Cinel; Cameron Alexander,7,0,30,23
1657465879771,MATH 18,A02,083744,Cinel; Cameron Alexander,17,0,30,13
1657465879771,MATH 18,A03,083745,Cinel; Cameron Alexander,9,0,30,21
1657465879771,MATH 18,B01,083748,Rideout; David Porter,5,0,37,32
1657465879771,MATH 18,B02,083749,Rideout; David Porter,5,0,36,31
1657465879771,MATH 18,B03,083750,Rideout; David Porter,3,0,37,34
1657465879771,MATH 18,B04,083751,Rideout; David Porter,6,0,36,30
1657465879771,MATH 18,B05,093473,Rideout; David Porter,6,0,36,30
1657465879771,MATH 18,B06,093474,Rideout; David Porter,6,0,36,30
1657465885796,MATH 20A,A01,083754,Zheng; Zequn,14,0,40,26
1657465891821,MATH 20B,A01,083756,Briones; Jor-el Thomas Caparas,4,0,36,32
1657465891821,MATH 20B,A02,083757,Briones; Jor-el Thomas Caparas,1,0,36,35
1657465891821,MATH 20B,A03,093475,Briones; Jor-el Thomas Caparas,2,0,36,34
1657465897847,MATH 20C,A01,083760,Briones; Jor-el Thomas Caparas,1,0,35,34
1657465897847,MATH 20C,A02,083761,Briones; Jor-el Thomas Caparas,8,0,35,27
1657465897847,MATH 20C,A03,093476,Briones; Jor-el Thomas Caparas,0,1,36,36
1657465897847,MATH 20C,B01,083762,Bach; Quang Tran,1,0,30,29
1657465903870,MATH 20D,A01,083765,Tran; Brian Kha,5,0,30,25
1657465903870,MATH 20D,A02,083766,Tran; Brian Kha,5,0,30,25
1657465903870,MATH 20D,A03,083767,Tran; Brian Kha,5,0,30,25
1657465909894,MATH 20E,A01,083771,Ganguly; Soumya,9,0,32,23
1657465909894,MATH 20E,A02,083772,Ganguly; Soumya,6,0,32,26
1657465909894,MATH 20E,B01,083773,Ciotti; Benjamin,20,0,35,15
1657465909894,MATH 20E,B02,083774,Ciotti; Benjamin,17,0,35,18
1657465915919,MATH 103A,A01,083777,Greenfeld; Be'Eri,3,0,36,33
1657465915919,MATH 103A,A02,083778,Greenfeld; Be'Eri,5,0,36,31
1657465915919,MATH 103A,A03,093561,Greenfeld; Be'Eri,5,0,36,31
1657465915919,MATH 103A,B01,083779,Greenfeld; Be'Eri,7,0,36,29
1657465915919,MATH 103A,B02,083780,Greenfeld; Be'Eri,4,0,36,32
1657465915919,MATH 103A,B03,093562,Greenfeld; Be'Eri,3,0,36,33
1657465921947,MATH 105,A01,085443,Carter; Anne Toulson,15,0,35,20
1657465921947,MATH 105,A02,093477,Carter; Anne Toulson,20,0,35,15
1657465927976,MATH 109,A01,083213,Ganzberger; Geoffrey Michael,2,0,34,32
1657465927976,MATH 109,A02,083214,Ganzberger; Geoffrey Michael,4,0,34,30
1657465927976,MATH 109,A03,093478,Ganzberger; Geoffrey Michael,2,0,34,32
1657465927976,MATH 109,B01,083215,Ganzberger; Geoffrey Michael,1,0,32,31
1657465927976,MATH 109,B02,083216,Ganzberger; Geoffrey Michael,2,0,32,30
1657465927976,MATH 109,B03,093479,Ganzberger; Geoffrey Michael,8,0,32,24
1657465934002,MATH 142A,A01,083219,Chow; Bennett,7,0,32,25
1657465934002,MATH 142A,A02,083220,Chow; Bennett,10,0,32,22
1657465934002,MATH 142A,A03,093480,Chow; Bennett,8,0,32,24
1657465934002,MATH 142A,B03,093481,Chow; Bennett,8,0,32,24
1657465934002,MATH 142A,B04,093558,Chow; Bennett,13,0,32,19
1657465934002,MATH 142A,B05,093559,Chow; Bennett,6,0,32,26
1657465940025,MATH 193A,A01,083224,Rotar; Vladimir,8,0,34,26
1657465940025,MATH 193A,A02,083225,Rotar; Vladimir,9,0,34,25
1657465940025,MATH 193A,A03,083781,Rotar; Vladimir,5,0,34,29
1657465940025,MATH 193A,A04,083782,Rotar; Vladimir,10,0,34,24
1657465940025,MATH 193A,A05,093482,Rotar; Vladimir,10,0,34,24
1657465946051,MATH 197,001,091859,McAuley; Julian John,9999,0,9999,0
1657465946051,MATH 197,002,095566,Kedlaya; Kiran S.,9997,0,9999,2
1657465946051,MATH 197,003,095567,Xiao; Ming,9999,0,9999,0
1657465946051,MATH 197,004,095571,Perols; Johan Lars,9998,0,9999,1
1657465953102,COGS 9,A01,083615,Shannon; Kyle Michael,9,0,75,66
1657465959129,COGS 11,A01,083617,Boyle; Mary E. T.,22,0,48,26
1657465965157,COGS 13,A01,083071,Bastos; Amalia Pinkusfeld,11,0,71,60
1657465971185,COGS 14A,A01,092681,Semenuks; Arturs,5,1,100,95
1657465977209,COGS 14B,A01,083073,Cheng; Tzu-Han,6,0,63,57
1657465983236,COGS 17,A01,092677,Semenuks; Arturs,6,0,81,75
1657465989259,COGS 100,A01,083619,Allen; Michael Gordon,17,0,70,53
1657465995287,COGS 101A,A01,083621,Davis; Joshua Daniel,9,0,68,59
1657466001309,COGS 101B,A01,091572,Allen; Michael Gordon,12,0,65,53
1657466007336,COGS 101C,A01,083625,Delgado; Tania,17,0,35,18
1657466013360,COGS 107A,A01,083627,Boyle; Mary E. T.,13,0,60,47
1657466019389,COGS 118A,A01,083075,Gupta; Anjum,21,0,76,55
1657466025412,CSE 3,A50,083646,Miranda; Gregory Joseph,24,0,50,26
1657466031436,CSE 8A,A50,083650,Miranda; Gregory Joseph,17,1,56,39
1657466037458,CSE 11,A01,083080,Cao; Yingjun,6,15,40,34
1657466043485,CSE 12,A01,083652,Krause-Levy; Sophia Louisa,28,1,120,92
1657466049508,CSE 15L,A01,083654,Morris; Justin Loren,9,0,50,41
1657466049508,CSE 15L,A02,083655,Morris; Justin Loren,9,0,50,41
1657466055531,CSE 20,A01,083657,Tran; Khoa Dang,39,0,80,41
1657466061558,CSE 21,A01,095574,Bach; Quang Tran,22,0,48,26
1657466067596,CSE 30,A01,083084,Eldon; John,5,0,80,75
1657466067596,CSE 30,B01,095061,Bhaskar; Nishant,9,0,50,41
1657466073619,CSE 100,A01,083659,Cao; Yingjun,5,4,70,65
1657466079643,CSE 134B,A01,083661,Powell; Thomas Allan,22,0,100,78
1657466085666,CSE 140,A01,083663,Gungor; Onat,15,0,85,70
1657466091694,CSE 140L,A01,083088,Eldon; John,21,0,100,79
1657466097794,CSE 175,A01,083665,Kumar; Rakesh,3,0,25,22
1657466103821,CSE 190,A00,092507,Dubnov; Shlomo,8,0,20,12
1657466109844,ECE 45,A01,083139,Congero; Spencer William,6,0,75,69
1657466115876,ECE 65,A50,083695,Saad; Andrew S,12,0,30,18
1657466115876,ECE 65,A51,095125,Saad; Andrew S,24,0,26,2
1657466121900,ECE 109,A01,091882,Touri; Behrouz,19,0,70,51
1657466127943,ECE 180,A00,083140,Abi Samra; Nicholas Camill,1,0,30,29
1657466127943,ECE 180,B00,083141,Abi Samra; Nicholas Camill,0,0,30,30
1657466133974,MATH 10A,A01,083735,Patchell; Gregory David,2,0,30,28
1657466133974,MATH 10A,A02,083736,Patchell; Gregory David,20,0,30,10
1657466133974,MATH 10A,A03,083737,Patchell; Gregory David,16,0,30,14
1657466139999,MATH 10B,A01,083207,Lim; Seonhee,8,0,34,26
1657466139999,MATH 10B,A02,083208,Lim; Seonhee,9,0,35,26
1657466139999,MATH 10B,A03,093472,Lim; Seonhee,7,0,34,27
1657466139999,MATH 10B,B01,083739,Sinha; Shubham,12,0,30,18
1657466146030,MATH 18,A01,083743,Cinel; Cameron Alexander,7,0,30,23
1657466146030,MATH 18,A02,083744,Cinel; Cameron Alexander,17,0,30,13
1657466146030,MATH 18,A03,083745,Cinel; Cameron Alexander,9,0,30,21
1657466146030,MATH 18,B01,083748,Rideout; David Porter,5,0,37,32
1657466146030,MATH 18,B02,083749,Rideout; David Porter,5,0,36,31
1657466146030,MATH 18,B03,083750,Rideout; David Porter,3,0,37,34
1657466146030,MATH 18,B04,083751,Rideout; David Porter,6,0,36,30
1657466146030,MATH 18,B05,093473,Rideout; David Porter,6,0,36,30
1657466146030,MATH 18,B06,093474,Rideout; David Porter,6,0,36,30
1657466152057,MATH 20A,A01,083754,Zheng; Zequn,14,0,40,26
1657466158080,MATH 20B,A01,083756,Briones; Jor-el Thomas Caparas,4,0,36,32
1657466158080,MATH 20B,A02,083757,Briones; Jor-el Thomas Caparas,1,0,36,35
1657466158080,MATH 20B,A03,093475,Briones; Jor-el Thomas Caparas,2,0,36,34
1657466164110,MATH 20C,A01,083760,Briones; Jor-el Thomas Caparas,1,0,35,34
1657466164110,MATH 20C,A02,083761,Briones; Jor-el Thomas Caparas,8,0,35,27
1657466164110,MATH 20C,A03,093476,Briones; Jor-el Thomas Caparas,0,1,36,36
1657466164110,MATH 20C,B01,083762,Bach; Quang Tran,1,0,30,29
1657466170139,MATH 20D,A01,083765,Tran; Brian Kha,5,0,30,25
1657466170139,MATH 20D,A02,083766,Tran; Brian Kha,5,0,30,25
1657466170139,MATH 20D,A03,083767,Tran; Brian Kha,5,0,30,25
1657466176162,MATH 20E,A01,083771,Ganguly; Soumya,9,0,32,23
1657466176162,MATH 20E,A02,083772,Ganguly; Soumya,6,0,32,26
1657466176162,MATH 20E,B01,083773,Ciotti; Benjamin,20,0,35,15
1657466176162,MATH 20E,B02,083774,Ciotti; Benjamin,17,0,35,18
1657466182186,MATH 103A,A01,083777,Greenfeld; Be'Eri,3,0,36,33
1657466182186,MATH 103A,A02,083778,Greenfeld; Be'Eri,5,0,36,31
1657466182186,MATH 103A,A03,093561,Greenfeld; Be'Eri,5,0,36,31
1657466182186,MATH 103A,B01,083779,Greenfeld; Be'Eri,7,0,36,29
1657466182186,MATH 103A,B02,083780,Greenfeld; Be'Eri,4,0,36,32
1657466182186,MATH 103A,B03,093562,Greenfeld; Be'Eri,3,0,36,33
1657466188211,MATH 105,A01,085443,Carter; Anne Toulson,15,0,35,20
1657466188211,MATH 105,A02,093477,Carter; Anne Toulson,20,0,35,15
1657466194239,MATH 109,A01,083213,Ganzberger; Geoffrey Michael,2,0,34,32
1657466194239,MATH 109,A02,083214,Ganzberger; Geoffrey Michael,4,0,34,30
1657466194239,MATH 109,A03,093478,Ganzberger; Geoffrey Michael,2,0,34,32
1657466194239,MATH 109,B01,083215,Ganzberger; Geoffrey Michael,1,0,32,31
1657466194239,MATH 109,B02,083216,Ganzberger; Geoffrey Michael,2,0,32,30
1657466194239,MATH 109,B03,093479,Ganzberger; Geoffrey Michael,8,0,32,24
1657466200270,MATH 142A,A01,083219,Chow; Bennett,7,0,32,25
1657466200270,MATH 142A,A02,083220,Chow; Bennett,10,0,32,22
1657466200270,MATH 142A,A03,093480,Chow; Bennett,8,0,32,24
1657466200270,MATH 142A,B03,093481,Chow; Bennett,8,0,32,24
1657466200270,MATH 142A,B04,093558,Chow; Bennett,13,0,32,19
1657466200270,MATH 142A,B05,093559,Chow; Bennett,6,0,32,26
1657466206297,MATH 193A,A01,083224,Rotar; Vladimir,8,0,34,26
1657466206297,MATH 193A,A02,083225,Rotar; Vladimir,9,0,34,25
1657466206297,MATH 193A,A03,083781,Rotar; Vladimir,5,0,34,29
1657466206297,MATH 193A,A04,083782,Rotar; Vladimir,10,0,34,24
1657466206297,MATH 193A,A05,093482,Rotar; Vladimir,10,0,34,24
1657466212324,MATH 197,001,091859,McAuley; Julian John,9999,0,9999,0
1657466212324,MATH 197,002,095566,Kedlaya; Kiran S.,9997,0,9999,2
1657466212324,MATH 197,003,095567,Xiao; Ming,9999,0,9999,0
1657466212324,MATH 197,004,095571,Perols; Johan Lars,9998,0,9999,1
1657466219378,COGS 9,A01,083615,Shannon; Kyle Michael,9,0,75,66
1657466225400,COGS 11,A01,083617,Boyle; Mary E. T.,22,0,48,26
1657466231422,COGS 13,A01,083071,Bastos; Amalia Pinkusfeld,11,0,71,60
1657466237445,COGS 14A,A01,092681,Semenuks; Arturs,5,1,100,95
1657466243468,COGS 14B,A01,083073,Cheng; Tzu-Han,6,0,63,57
1657466249497,COGS 17,A01,092677,Semenuks; Arturs,6,0,81,75
1657466255525,COGS 100,A01,083619,Allen; Michael Gordon,17,0,70,53
1657466261548,COGS 101A,A01,083621,Davis; Joshua Daniel,9,0,68,59
1657466267576,COGS 101B,A01,091572,Allen; Michael Gordon,12,0,65,53
1657466273604,COGS 101C,A01,083625,Delgado; Tania,17,0,35,18
1657466279630,COGS 107A,A01,083627,Boyle; Mary E. T.,13,0,60,47
1657466285652,COGS 118A,A01,083075,Gupta; Anjum,21,0,76,55
1657466291675,CSE 3,A50,083646,Miranda; Gregory Joseph,24,0,50,26
1657466297702,CSE 8A,A50,083650,Miranda; Gregory Joseph,17,1,56,39
1657466303728,CSE 11,A01,083080,Cao; Yingjun,6,15,40,34
1657466309751,CSE 12,A01,083652,Krause-Levy; Sophia Louisa,28,1,120,92
1657466315779,CSE 15L,A01,083654,Morris; Justin Loren,9,0,50,41
1657466315779,CSE 15L,A02,083655,Morris; Justin Loren,9,0,50,41
1657466321807,CSE 20,A01,083657,Tran; Khoa Dang,39,0,80,41
1657466327832,CSE 21,A01,095574,Bach; Quang Tran,22,0,48,26
1657466333875,CSE 30,A01,083084,Eldon; John,5,0,80,75
1657466333875,CSE 30,B01,095061,Bhaskar; Nishant,9,0,50,41
1657466339901,CSE 100,A01,083659,Cao; Yingjun,5,4,70,65
1657466345929,CSE 134B,A01,083661,Powell; Thomas Allan,22,0,100,78
1657466351952,CSE 140,A01,083663,Gungor; Onat,15,0,85,70
1657466357980,CSE 140L,A01,083088,Eldon; John,21,0,100,79
1657466364003,CSE 175,A01,083665,Kumar; Rakesh,3,0,25,22
1657466370031,CSE 190,A00,092507,Dubnov; Shlomo,8,0,20,12
1657466376059,ECE 45,A01,083139,Congero; Spencer William,6,0,75,69
1657466382084,ECE 65,A50,083695,Saad; Andrew S,12,0,30,18
1657466382084,ECE 65,A51,095125,Saad; Andrew S,24,0,26,2
1657466388108,ECE 109,A01,091882,Touri; Behrouz,19,0,70,51
1657466394133,ECE 180,A00,083140,Abi Samra; Nicholas Camill,1,0,30,29
1657466394133,ECE 180,B00,083141,Abi Samra; Nicholas Camill,0,0,30,30
1657466400155,MATH 10A,A01,083735,Patchell; Gregory David,2,0,30,28
1657466400155,MATH 10A,A02,083736,Patchell; Gregory David,20,0,30,10
1657466400155,MATH 10A,A03,083737,Patchell; Gregory David,16,0,30,14
1657466406184,MATH 10B,A01,083207,Lim; Seonhee,8,0,34,26
1657466406184,MATH 10B,A02,083208,Lim; Seonhee,9,0,35,26
1657466406184,MATH 10B,A03,093472,Lim; Seonhee,7,0,34,27
1657466406184,MATH 10B,B01,083739,Sinha; Shubham,12,0,30,18
1657466412211,MATH 18,A01,083743,Cinel; Cameron Alexander,7,0,30,23
1657466412211,MATH 18,A02,083744,Cinel; Cameron Alexander,17,0,30,13
1657466412211,MATH 18,A03,083745,Cinel; Cameron Alexander,9,0,30,21
1657466412211,MATH 18,B01,083748,Rideout; David Porter,5,0,37,32
1657466412211,MATH 18,B02,083749,Rideout; David Porter,5,0,36,31
1657466412211,MATH 18,B03,083750,Rideout; David Porter,3,0,37,34
1657466412211,MATH 18,B04,083751,Rideout; David Porter,6,0,36,30
1657466412211,MATH 18,B05,093473,Rideout; David Porter,6,0,36,30
1657466412211,MATH 18,B06,093474,Rideout; David Porter,6,0,36,30
1657466418235,MATH 20A,A01,083754,Zheng; Zequn,14,0,40,26
1657466424263,MATH 20B,A01,083756,Briones; Jor-el Thomas Caparas,4,0,36,32
1657466424263,MATH 20B,A02,083757,Briones; Jor-el Thomas Caparas,1,0,36,35
1657466424263,MATH 20B,A03,093475,Briones; Jor-el Thomas Caparas,2,0,36,34
1657466430287,MATH 20C,A01,083760,Briones; Jor-el Thomas Caparas,1,0,35,34
1657466430287,MATH 20C,A02,083761,Briones; Jor-el Thomas Caparas,8,0,35,27
1657466430287,MATH 20C,A03,093476,Briones; Jor-el Thomas Caparas,0,1,36,36
1657466430287,MATH 20C,B01,083762,Bach; Quang Tran,1,0,30,29
1657466436311,MATH 20D,A01,083765,Tran; Brian Kha,5,0,30,25
1657466436311,MATH 20D,A02,083766,Tran; Brian Kha,5,0,30,25
1657466436311,MATH 20D,A03,083767,Tran; Brian Kha,5,0,30,25
1657466442334,MATH 20E,A01,083771,Ganguly; Soumya,9,0,32,23
1657466442334,MATH 20E,A02,083772,Ganguly; Soumya,6,0,32,26
1657466442334,MATH 20E,B01,083773,Ciotti; Benjamin,20,0,35,15
1657466442334,MATH 20E,B02,083774,Ciotti; Benjamin,17,0,35,18
1657466448357,MATH 103A,A01,083777,Greenfeld; Be'Eri,3,0,36,33
1657466448357,MATH 103A,A02,083778,Greenfeld; Be'Eri,5,0,36,31
1657466448357,MATH 103A,A03,093561,Greenfeld; Be'Eri,5,0,36,31
1657466448357,MATH 103A,B01,083779,Greenfeld; Be'Eri,7,0,36,29
1657466448357,MATH 103A,B02,083780,Greenfeld; Be'Eri,4,0,36,32
1657466448357,MATH 103A,B03,093562,Greenfeld; Be'Eri,3,0,36,33
1657466454382,MATH 105,A01,085443,Carter; Anne Toulson,15,0,35,20
1657466454382,MATH 105,A02,093477,Carter; Anne Toulson,20,0,35,15
1657466460408,MATH 109,A01,083213,Ganzberger; Geoffrey Michael,2,0,34,32
1657466460408,MATH 109,A02,083214,Ganzberger; Geoffrey Michael,4,0,34,30
1657466460408,MATH 109,A03,093478,Ganzberger; Geoffrey Michael,2,0,34,32
1657466460408,MATH 109,B01,083215,Ganzberger; Geoffrey Michael,1,0,32,31
1657466460408,MATH 109,B02,083216,Ganzberger; Geoffrey Michael,2,0,32,30
1657466460408,MATH 109,B03,093479,Ganzberger; Geoffrey Michael,8,0,32,24
1657466466433,MATH 142A,A01,083219,Chow; Bennett,7,0,32,25
1657466466433,MATH 142A,A02,083220,Chow; Bennett,10,0,32,22
1657466466433,MATH 142A,A03,093480,Chow; Bennett,8,0,32,24
1657466466433,MATH 142A,B03,093481,Chow; Bennett,8,0,32,24
1657466466433,MATH 142A,B04,093558,Chow; Bennett,13,0,32,19
1657466466433,MATH 142A,B05,093559,Chow; Bennett,6,0,32,26
1657466472456,MATH 193A,A01,083224,Rotar; Vladimir,8,0,34,26
1657466472456,MATH 193A,A02,083225,Rotar; Vladimir,9,0,34,25
1657466472456,MATH 193A,A03,083781,Rotar; Vladimir,5,0,34,29
1657466472456,MATH 193A,A04,083782,Rotar; Vladimir,10,0,34,24
1657466472456,MATH 193A,A05,093482,Rotar; Vladimir,10,0,34,24
1657466478478,MATH 197,001,091859,McAuley; Julian John,9999,0,9999,0
1657466478478,MATH 197,002,095566,Kedlaya; Kiran S.,9997,0,9999,2
1657466478478,MATH 197,003,095567,Xiao; Ming,9999,0,9999,0
1657466478478,MATH 197,004,095571,Perols; Johan Lars,9998,0,9999,1
1657466485532,COGS 9,A01,083615,Shannon; Kyle Michael,9,0,75,66
1657466491557,COGS 11,A01,083617,Boyle; Mary E. T.,22,0,48,26
1657466497585,COGS 13,A01,083071,Bastos; Amalia Pinkusfeld,11,0,71,60
1657466503609,COGS 14A,A01,092681,Semenuks; Arturs,5,1,100,95
1657466509641,COGS 14B,A01,083073,Cheng; Tzu-Han,6,0,63,57
1657466515667,COGS 17,A01,092677,Semenuks; Arturs,6,0,81,75
1657466521691,COGS 100,A01,083619,Allen; Michael Gordon,17,0,70,53
1657466527714,COGS 101A,A01,083621,Davis; Joshua Daniel,9,0,68,59
1657466533738,COGS 101B,A01,091572,Allen; Michael Gordon,12,0,65,53
1657466539765,COGS 101C,A01,083625,Delgado; Tania,17,0,35,18
1657466545786,COGS 107A,A01,083627,Boyle; Mary E. T.,13,0,60,47
1657466551813,COGS 118A,A01,083075,Gupta; Anjum,21,0,76,55
1657466557837,CSE 3,A50,083646,Miranda; Gregory Joseph,24,0,50,26
1657466563876,CSE 8A,A50,083650,Miranda; Gregory Joseph,17,1,56,39
1657466569907,CSE 11,A01,083080,Cao; Yingjun,6,15,40,34
1657466575932,CSE 12,A01,083652,Krause-Levy; Sophia Louisa,28,1,120,92
1657466581956,CSE 15L,A01,083654,Morris; Justin Loren,9,0,50,41
1657466581956,CSE 15L,A02,083655,Morris; Justin Loren,9,0,50,41
1657466587978,CSE 20,A01,083657,Tran; Khoa Dang,39,0,80,41
1657466594013,CSE 21,A01,095574,Bach; Quang Tran,22,0,48,26
1657466600049,CSE 30,A01,083084,Eldon; John,5,0,80,75
1657466600049,CSE 30,B01,095061,Bhaskar; Nishant,9,0,50,41
1657466606073,CSE 100,A01,083659,Cao; Yingjun,5,4,70,65
1657466612102,CSE 134B,A01,083661,Powell; Thomas Allan,22,0,100,78
1657466618132,CSE 140,A01,083663,Gungor; Onat,15,0,85,70
1657466624156,CSE 140L,A01,083088,Eldon; John,21,0,100,79
1657466630183,CSE 175,A01,083665,Kumar; Rakesh,3,0,25,22
1657466636207,CSE 190,A00,092507,Dubnov; Shlomo,8,0,20,12
1657466642235,ECE 45,A01,083139,Congero; Spencer William,6,0,75,69
1657466648260,ECE 65,A50,083695,Saad; Andrew S,12,0,30,18
1657466648260,ECE 65,A51,095125,Saad; Andrew S,24,0,26,2
1657466654287,ECE 109,A01,091882,Touri; Behrouz,19,0,70,51
1657466660325,ECE 180,A00,083140,Abi Samra; Nicholas Camill,1,0,30,29
1657466660325,ECE 180,B00,083141,Abi Samra; Nicholas Camill,0,0,30,30
1657466666406,MATH 10A,A01,083735,Patchell; Gregory David,2,0,30,28
1657466666406,MATH 10A,A02,083736,Patchell; Gregory David,20,0,30,10
1657466666406,MATH 10A,A03,083737,Patchell; Gregory David,16,0,30,14
1657466672439,MATH 10B,A01,083207,Lim; Seonhee,8,0,34,26
1657466672439,MATH 10B,A02,083208,Lim; Seonhee,9,0,35,26
1657466672439,MATH 10B,A03,093472,Lim; Seonhee,7,0,34,27
1657466672439,MATH 10B,B01,083739,Sinha; Shubham,12,0,30,18
1657466678476,MATH 18,A01,083743,Cinel; Cameron Alexander,7,0,30,23
1657466678476,MATH 18,A02,083744,Cinel; Cameron Alexander,17,0,30,13
1657466678476,MATH 18,A03,083745,Cinel; Cameron Alexander,9,0,30,21
1657466678476,MATH 18,B01,083748,Rideout; David Porter,5,0,37,32
1657466678476,MATH 18,B02,083749,Rideout; David Porter,5,0,36,31
1657466678476,MATH 18,B03,083750,Rideout; David Porter,3,0,37,34
1657466678476,MATH 18,B04,083751,Rideout; David Porter,6,0,36,30
1657466678476,MATH 18,B05,093473,Rideout; David Porter,6,0,36,30
1657466678476,MATH 18,B06,093474,Rideout; David Porter,6,0,36,30
1657466684514,MATH 20A,A01,083754,Zheng; Zequn,14,0,40,26
1657466690564,MATH 20B,A01,083756,Briones; Jor-el Thomas Caparas,4,0,36,32
1657466690564,MATH 20B,A02,083757,Briones; Jor-el Thomas Caparas,1,0,36,35
1657466690564,MATH 20B,A03,093475,Briones; Jor-el Thomas Caparas,2,0,36,34
1657466696675,MATH 20C,A01,083760,Briones; Jor-el Thomas Caparas,1,0,35,34
1657466696675,MATH 20C,A02,083761,Briones; Jor-el Thomas Caparas,8,0,35,27
1657466696675,MATH 20C,A03,093476,Briones; Jor-el Thomas Caparas,0,1,36,36
1657466696675,MATH 20C,B01,083762,Bach; Quang Tran,1,0,30,29
1657466702699,MATH 20D,A01,083765,Tran; Brian Kha,5,0,30,25
1657466702699,MATH 20D,A02,083766,Tran; Brian Kha,5,0,30,25
1657466702699,MATH 20D,A03,083767,Tran; Brian Kha,5,0,30,25
1657466708737,MATH 20E,A01,083771,Ganguly; Soumya,9,0,32,23
1657466708737,MATH 20E,A02,083772,Ganguly; Soumya,6,0,32,26
1657466708737,MATH 20E,B01,083773,Ciotti; Benjamin,20,0,35,15
1657466708737,MATH 20E,B02,083774,Ciotti; Benjamin,17,0,35,18
1657466714765,MATH 103A,A01,083777,Greenfeld; Be'Eri,3,0,36,33
1657466714765,MATH 103A,A02,083778,Greenfeld; Be'Eri,5,0,36,31
1657466714765,MATH 103A,A03,093561,Greenfeld; Be'Eri,5,0,36,31
1657466714765,MATH 103A,B01,083779,Greenfeld; Be'Eri,7,0,36,29
1657466714765,MATH 103A,B02,083780,Greenfeld; Be'Eri,4,0,36,32
1657466714765,MATH 103A,B03,093562,Greenfeld; Be'Eri,3,0,36,33
1657466720793,MATH 105,A01,085443,Carter; Anne Toulson,15,0,35,20
1657466720793,MATH 105,A02,093477,Carter; Anne Toulson,20,0,35,15
1657466726823,MATH 109,A01,083213,Ganzberger; Geoffrey Michael,2,0,34,32
1657466726823,MATH 109,A02,083214,Ganzberger; Geoffrey Michael,4,0,34,30
1657466726823,MATH 109,A03,093478,Ganzberger; Geoffrey Michael,2,0,34,32
1657466726823,MATH 109,B01,083215,Ganzberger; Geoffrey Michael,1,0,32,31
1657466726823,MATH 109,B02,083216,Ganzberger; Geoffrey Michael,2,0,32,30
1657466726823,MATH 109,B03,093479,Ganzberger; Geoffrey Michael,8,0,32,24
1657466732854,MATH 142A,A01,083219,Chow; Bennett,7,0,32,25
1657466732854,MATH 142A,A02,083220,Chow; Bennett,10,0,32,22
1657466732854,MATH 142A,A03,093480,Chow; Bennett,8,0,32,24
1657466732854,MATH 142A,B03,093481,Chow; Bennett,8,0,32,24
1657466732854,MATH 142A,B04,093558,Chow; Bennett,13,0,32,19
1657466732854,MATH 142A,B05,093559,Chow; Bennett,6,0,32,26
1657466738887,MATH 193A,A01,083224,Rotar; Vladimir,8,0,34,26
1657466738887,MATH 193A,A02,083225,Rotar; Vladimir,9,0,34,25
1657466738887,MATH 193A,A03,083781,Rotar; Vladimir,5,0,34,29
1657466738887,MATH 193A,A04,083782,Rotar; Vladimir,10,0,34,24
1657466738887,MATH 193A,A05,093482,Rotar; Vladimir,10,0,34,24
1657466744911,MATH 197,001,091859,McAuley; Julian John,9999,0,9999,0
1657466744911,MATH 197,002,095566,Kedlaya; Kiran S.,9997,0,9999,2
1657466744911,MATH 197,003,095567,Xiao; Ming,9999,0,9999,0
1657466744911,MATH 197,004,095571,Perols; Johan Lars,9998,0,9999,1
1657466752031,COGS 9,A01,083615,Shannon; Kyle Michael,9,0,75,66
1657466758055,COGS 11,A01,083617,Boyle; Mary E. T.,22,0,48,26
1657466764083,COGS 13,A01,083071,Bastos; Amalia Pinkusfeld,11,0,71,60
1657466770107,COGS 14A,A01,092681,Semenuks; Arturs,5,1,100,95
1657466776129,COGS 14B,A01,083073,Cheng; Tzu-Han,6,0,63,57
1657466782161,COGS 17,A01,092677,Semenuks; Arturs,6,0,81,75
1657466788185,COGS 100,A01,083619,Allen; Michael Gordon,17,0,70,53
1657466794208,COGS 101A,A01,083621,Davis; Joshua Daniel,9,0,68,59
1657466800231,COGS 101B,A01,091572,Allen; Michael Gordon,12,0,65,53
1657466806267,COGS 101C,A01,083625,Delgado; Tania,17,0,35,18
1657466812292,COGS 107A,A01,083627,Boyle; Mary E. T.,13,0,60,47
1657466818316,COGS 118A,A01,083075,Gupta; Anjum,21,0,76,55
1657466824341,CSE 3,A50,083646,Miranda; Gregory Joseph,24,0,50,26
1657466830365,CSE 8A,A50,083650,Miranda; Gregory Joseph,17,1,56,39
1657466836389,CSE 11,A01,083080,Cao; Yingjun,6,15,40,34
1657466842414,CSE 12,A01,083652,Krause-Levy; Sophia Louisa,28,1,120,92
1657466848446,CSE 15L,A01,083654,Morris; Justin Loren,9,0,50,41
1657466848446,CSE 15L,A02,083655,Morris; Justin Loren,9,0,50,41
1657466854471,CSE 20,A01,083657,Tran; Khoa Dang,39,0,80,41
1657466860495,CSE 21,A01,095574,Bach; Quang Tran,22,0,48,26
1657466866524,CSE 30,A01,083084,Eldon; John,5,0,80,75
1657466866524,CSE 30,B01,095061,Bhaskar; Nishant,9,0,50,41
1657466872552,CSE 100,A01,083659,Cao; Yingjun,5,4,70,65
1657466878575,CSE 134B,A01,083661,Powell; Thomas Allan,22,0,100,78
1657466884602,CSE 140,A01,083663,Gungor; Onat,15,0,85,70
1657466890625,CSE 140L,A01,083088,Eldon; John,21,0,100,79
1657466896650,CSE 175,A01,083665,Kumar; Rakesh,3,0,25,22
1657466902678,CSE 190,A00,092507,Dubnov; Shlomo,8,0,20,12
1657466908701,ECE 45,A01,083139,Congero; Spencer William,6,0,75,69
1657466914731,ECE 65,A50,083695,Saad; Andrew S,12,0,30,18
1657466914731,ECE 65,A51,095125,Saad; Andrew S,24,0,26,2
1657466920755,ECE 109,A01,091882,Touri; Behrouz,19,0,70,51
1657466926776,ECE 180,A00,083140,Abi Samra; Nicholas Camill,1,0,30,29
1657466926776,ECE 180,B00,083141,Abi Samra; Nicholas Camill,0,0,30,30
1657466932804,MATH 10A,A01,083735,Patchell; Gregory David,2,0,30,28
1657466932804,MATH 10A,A02,083736,Patchell; Gregory David,20,0,30,10
1657466932804,MATH 10A,A03,083737,Patchell; Gregory David,16,0,30,14
1657466938828,MATH 10B,A01,083207,Lim; Seonhee,8,0,34,26
1657466938828,MATH 10B,A02,083208,Lim; Seonhee,9,0,35,26
1657466938828,MATH 10B,A03,093472,Lim; Seonhee,7,0,34,27
1657466938828,MATH 10B,B01,083739,Sinha; Shubham,12,0,30,18
1657466944853,MATH 18,A01,083743,Cinel; Cameron Alexander,7,0,30,23
1657466944853,MATH 18,A02,083744,Cinel; Cameron Alexander,17,0,30,13
1657466944853,MATH 18,A03,083745,Cinel; Cameron Alexander,9,0,30,21
1657466944853,MATH 18,B01,083748,Rideout; David Porter,5,0,37,32
1657466944853,MATH 18,B02,083749,Rideout; David Porter,5,0,36,31
1657466944853,MATH 18,B03,083750,Rideout; David Porter,3,0,37,34
1657466944853,MATH 18,B04,083751,Rideout; David Porter,6,0,36,30
1657466944853,MATH 18,B05,093473,Rideout; David Porter,6,0,36,30
1657466944853,MATH 18,B06,093474,Rideout; David Porter,6,0,36,30
1657466950881,MATH 20A,A01,083754,Zheng; Zequn,14,0,40,26
1657466956906,MATH 20B,A01,083756,Briones; Jor-el Thomas Caparas,4,0,36,32
1657466956906,MATH 20B,A02,083757,Briones; Jor-el Thomas Caparas,1,0,36,35
1657466956906,MATH 20B,A03,093475,Briones; Jor-el Thomas Caparas,2,0,36,34
1657466962930,MATH 20C,A01,083760,Briones; Jor-el Thomas Caparas,1,0,35,34
1657466962930,MATH 20C,A02,083761,Briones; Jor-el Thomas Caparas,8,0,35,27
1657466962930,MATH 20C,A03,093476,Briones; Jor-el Thomas Caparas,0,1,36,36
1657466962930,MATH 20C,B01,083762,Bach; Quang Tran,1,0,30,29
1657466968964,MATH 20D,A01,083765,Tran; Brian Kha,5,0,30,25
1657466968964,MATH 20D,A02,083766,Tran; Brian Kha,5,0,30,25
1657466968964,MATH 20D,A03,083767,Tran; Brian Kha,5,0,30,25
1657466974993,MATH 20E,A01,083771,Ganguly; Soumya,9,0,32,23
1657466974993,MATH 20E,A02,083772,Ganguly; Soumya,6,0,32,26
1657466974993,MATH 20E,B01,083773,Ciotti; Benjamin,20,0,35,15
1657466974993,MATH 20E,B02,083774,Ciotti; Benjamin,17,0,35,18
1657466981021,MATH 103A,A01,083777,Greenfeld; Be'Eri,3,0,36,33
1657466981021,MATH 103A,A02,083778,Greenfeld; Be'Eri,5,0,36,31
1657466981021,MATH 103A,A03,093561,Greenfeld; Be'Eri,5,0,36,31
1657466981021,MATH 103A,B01,083779,Greenfeld; Be'Eri,7,0,36,29
1657466981021,MATH 103A,B02,083780,Greenfeld; Be'Eri,4,0,36,32
1657466981021,MATH 103A,B03,093562,Greenfeld; Be'Eri,3,0,36,33
1657466987045,MATH 105,A01,085443,Carter; Anne Toulson,15,0,35,20
1657466987045,MATH 105,A02,093477,Carter; Anne Toulson,20,0,35,15
1657466993069,MATH 109,A01,083213,Ganzberger; Geoffrey Michael,2,0,34,32
1657466993069,MATH 109,A02,083214,Ganzberger; Geoffrey Michael,4,0,34,30
1657466993069,MATH 109,A03,093478,Ganzberger; Geoffrey Michael,2,0,34,32
1657466993069,MATH 109,B01,083215,Ganzberger; Geoffrey Michael,1,0,32,31
1657466993069,MATH 109,B02,083216,Ganzberger; Geoffrey Michael,2,0,32,30
1657466993069,MATH 109,B03,093479,Ganzberger; Geoffrey Michael,8,0,32,24
1657466999096,MATH 142A,A01,083219,Chow; Bennett,7,0,32,25
1657466999096,MATH 142A,A02,083220,Chow; Bennett,10,0,32,22
1657466999096,MATH 142A,A03,093480,Chow; Bennett,8,0,32,24
1657466999096,MATH 142A,B03,093481,Chow; Bennett,8,0,32,24
1657466999096,MATH 142A,B04,093558,Chow; Bennett,13,0,32,19
1657466999096,MATH 142A,B05,093559,Chow; Bennett,6,0,32,26
1657467005120,MATH 193A,A01,083224,Rotar; Vladimir,8,0,34,26
1657467005120,MATH 193A,A02,083225,Rotar; Vladimir,9,0,34,25
1657467005120,MATH 193A,A03,083781,Rotar; Vladimir,5,0,34,29
1657467005120,MATH 193A,A04,083782,Rotar; Vladimir,10,0,34,24
1657467005120,MATH 193A,A05,093482,Rotar; Vladimir,10,0,34,24
1657467011144,MATH 197,001,091859,McAuley; Julian John,9999,0,9999,0
1657467011144,MATH 197,002,095566,Kedlaya; Kiran S.,9997,0,9999,2
1657467011144,MATH 197,003,095567,Xiao; Ming,9999,0,9999,0
1657467011144,MATH 197,004,095571,Perols; Johan Lars,9998,0,9999,1
1657467018207,COGS 9,A01,083615,Shannon; Kyle Michael,9,0,75,66
1657467024231,COGS 11,A01,083617,Boyle; Mary E. T.,22,0,48,26
1657467030255,COGS 13,A01,083071,Bastos; Amalia Pinkusfeld,11,0,71,60
1657467036278,COGS 14A,A01,092681,Semenuks; Arturs,5,1,100,95
1657467042306,COGS 14B,A01,083073,Cheng; Tzu-Han,6,0,63,57
1657467048331,COGS 17,A01,092677,Semenuks; Arturs,6,0,81,75
1657467054357,COGS 100,A01,083619,Allen; Michael Gordon,17,0,70,53
1657467060380,COGS 101A,A01,083621,Davis; Joshua Daniel,9,0,68,59
1657467066406,COGS 101B,A01,091572,Allen; Michael Gordon,12,0,65,53
1657467072431,COGS 101C,A01,083625,Delgado; Tania,17,0,35,18
1657467078454,COGS 107A,A01,083627,Boyle; Mary E. T.,13,0,60,47
1657467084478,COGS 118A,A01,083075,Gupta; Anjum,21,0,76,55
1657467090507,CSE 3,A50,083646,Miranda; Gregory Joseph,24,0,50,26
1657467096535,CSE 8A,A50,083650,Miranda; Gregory Joseph,17,1,56,39
1657467102557,CSE 11,A01,083080,Cao; Yingjun,6,15,40,34
1657467108585,CSE 12,A01,083652,Krause-Levy; Sophia Louisa,28,1,120,92
1657467114613,CSE 15L,A01,083654,Morris; Justin Loren,9,0,50,41
1657467114613,CSE 15L,A02,083655,Morris; Justin Loren,9,0,50,41
1657467120636,CSE 20,A01,083657,Tran; Khoa Dang,39,0,80,41
1657467126671,CSE 21,A01,095574,Bach; Quang Tran,22,0,48,26
1657467132700,CSE 30,A01,083084,Eldon; John,5,0,80,75
1657467132700,CSE 30,B01,095061,Bhaskar; Nishant,9,0,50,41
1657467138726,CSE 100,A01,083659,Cao; Yingjun,5,4,70,65
1657467144750,CSE 134B,A01,083661,Powell; Thomas Allan,22,0,100,78
1657467150775,CSE 140,A01,083663,Gungor; Onat,15,0,85,70
1657467156799,CSE 140L,A01,083088,Eldon; John,21,0,100,79
1657467162824,CSE 175,A01,083665,Kumar; Rakesh,3,0,25,22
1657467168853,CSE 190,A00,092507,Dubnov; Shlomo,8,0,20,12
1657467174881,ECE 45,A01,083139,Congero; Spencer William,6,0,75,69
1657467180904,ECE 65,A50,083695,Saad; Andrew S,12,0,30,18
1657467180904,ECE 65,A51,095125,Saad; Andrew S,24,0,26,2
1657467186935,ECE 109,A01,091882,Touri; Behrouz,19,0,70,51
1657467192960,ECE 180,A00,083140,Abi Samra; Nicholas Camill,1,0,30,29
1657467192960,ECE 180,B00,083141,Abi Samra; Nicholas Camill,0,0,30,30
1657467198988,MATH 10A,A01,083735,Patchell; Gregory David,2,0,30,28
1657467198988,MATH 10A,A02,083736,Patchell; Gregory David,20,0,30,10
1657467198988,MATH 10A,A03,083737,Patchell; Gregory David,16,0,30,14
1657467205015,MATH 10B,A01,083207,Lim; Seonhee,8,0,34,26
1657467205015,MATH 10B,A02,083208,Lim; Seonhee,9,0,35,26
1657467205015,MATH 10B,A03,093472,Lim; Seonhee,7,0,34,27
1657467205015,MATH 10B,B01,083739,Sinha; Shubham,12,0,30,18
1657467211041,MATH 18,A01,083743,Cinel; Cameron Alexander,7,0,30,23
1657467211041,MATH 18,A02,083744,Cinel; Cameron Alexander,17,0,30,13
1657467211041,MATH 18,A03,083745,Cinel; Cameron Alexander,9,0,30,21
1657467211041,MATH 18,B01,083748,Rideout; David Porter,5,0,37,32
1657467211041,MATH 18,B02,083749,Rideout; David Porter,5,0,36,31
1657467211041,MATH 18,B03,083750,Rideout; David Porter,3,0,37,34
1657467211041,MATH 18,B04,083751,Rideout; David Porter,6,0,36,30
1657467211041,MATH 18,B05,093473,Rideout; David Porter,6,0,36,30
1657467211041,MATH 18,B06,093474,Rideout; David Porter,6,0,36,30
1657467217064,MATH 20A,A01,083754,Zheng; Zequn,14,0,40,26
1657467223086,MATH 20B,A01,083756,Briones; Jor-el Thomas Caparas,4,0,36,32
1657467223086,MATH 20B,A02,083757,Briones; Jor-el Thomas Caparas,1,0,36,35
1657467223086,MATH 20B,A03,093475,Briones; Jor-el Thomas Caparas,2,0,36,34
1657467229114,MATH 20C,A01,083760,Briones; Jor-el Thomas Caparas,1,0,35,34
1657467229114,MATH 20C,A02,083761,Briones; Jor-el Thomas Caparas,8,0,35,27
1657467229114,MATH 20C,A03,093476,Briones; Jor-el Thomas Caparas,0,1,36,36
1657467229114,MATH 20C,B01,083762,Bach; Quang Tran,1,0,30,29
1657467235139,MATH 20D,A01,083765,Tran; Brian Kha,5,0,30,25
1657467235139,MATH 20D,A02,083766,Tran; Brian Kha,5,0,30,25
1657467235139,MATH 20D,A03,083767,Tran; Brian Kha,5,0,30,25
1657467241167,MATH 20E,A01,083771,Ganguly; Soumya,9,0,32,23
1657467241167,MATH 20E,A02,083772,Ganguly; Soumya,6,0,32,26
1657467241167,MATH 20E,B01,083773,Ciotti; Benjamin,20,0,35,15
1657467241167,MATH 20E,B02,083774,Ciotti; Benjamin,17,0,35,18
1657467247197,MATH 103A,A01,083777,Greenfeld; Be'Eri,3,0,36,33
1657467247197,MATH 103A,A02,083778,Greenfeld; Be'Eri,5,0,36,31
1657467247197,MATH 103A,A03,093561,Greenfeld; Be'Eri,5,0,36,31
1657467247197,MATH 103A,B01,083779,Greenfeld; Be'Eri,7,0,36,29
1657467247197,MATH 103A,B02,083780,Greenfeld; Be'Eri,4,0,36,32
1657467247197,MATH 103A,B03,093562,Greenfeld; Be'Eri,3,0,36,33
1657467253223,MATH 105,A01,085443,Carter; Anne Toulson,15,0,35,20
1657467253223,MATH 105,A02,093477,Carter; Anne Toulson,20,0,35,15
1657467259250,MATH 109,A01,083213,Ganzberger; Geoffrey Michael,2,0,34,32
1657467259250,MATH 109,A02,083214,Ganzberger; Geoffrey Michael,4,0,34,30
1657467259250,MATH 109,A03,093478,Ganzberger; Geoffrey Michael,2,0,34,32
1657467259250,MATH 109,B01,083215,Ganzberger; Geoffrey Michael,1,0,32,31
1657467259250,MATH 109,B02,083216,Ganzberger; Geoffrey Michael,2,0,32,30
1657467259250,MATH 109,B03,093479,Ganzberger; Geoffrey Michael,8,0,32,24
1657467265277,MATH 142A,A01,083219,Chow; Bennett,7,0,32,25
1657467265277,MATH 142A,A02,083220,Chow; Bennett,10,0,32,22
1657467265277,MATH 142A,A03,093480,Chow; Bennett,8,0,32,24
1657467265277,MATH 142A,B03,093481,Chow; Bennett,8,0,32,24
1657467265277,MATH 142A,B04,093558,Chow; Bennett,13,0,32,19
1657467265277,MATH 142A,B05,093559,Chow; Bennett,6,0,32,26
1657467271301,MATH 193A,A01,083224,Rotar; Vladimir,8,0,34,26
1657467271301,MATH 193A,A02,083225,Rotar; Vladimir,9,0,34,25
1657467271301,MATH 193A,A03,083781,Rotar; Vladimir,5,0,34,29
1657467271301,MATH 193A,A04,083782,Rotar; Vladimir,10,0,34,24
1657467271301,MATH 193A,A05,093482,Rotar; Vladimir,10,0,34,24
1657467277325,MATH 197,001,091859,McAuley; Julian John,9999,0,9999,0
1657467277325,MATH 197,002,095566,Kedlaya; Kiran S.,9997,0,9999,2
1657467277325,MATH 197,003,095567,Xiao; Ming,9999,0,9999,0
1657467277325,MATH 197,004,095571,Perols; Johan Lars,9998,0,9999,1
1657467284377,COGS 9,A01,083615,Shannon; Kyle Michael,9,0,75,66
1657467290476,COGS 11,A01,083617,Boyle; Mary E. T.,22,0,48,26
1657467296499,COGS 13,A01,083071,Bastos; Amalia Pinkusfeld,11,0,71,60
1657467302523,COGS 14A,A01,092681,Semenuks; Arturs,5,1,100,95
1657467308547,COGS 14B,A01,083073,Cheng; Tzu-Han,6,0,63,57
1657467314573,COGS 17,A01,092677,Semenuks; Arturs,6,0,81,75
1657467320597,COGS 100,A01,083619,Allen; Michael Gordon,17,0,70,53
1657467326622,COGS 101A,A01,083621,Davis; Joshua Daniel,9,0,68,59
1657467332646,COGS 101B,A01,091572,Allen; Michael Gordon,12,0,65,53
1657467338670,COGS 101C,A01,083625,Delgado; Tania,17,0,35,18
1657467344694,COGS 107A,A01,083627,Boyle; Mary E. T.,13,0,60,47
1657467350717,COGS 118A,A01,083075,Gupta; Anjum,21,0,76,55
1657467356744,CSE 3,A50,083646,Miranda; Gregory Joseph,24,0,50,26
1657467362769,CSE 8A,A50,083650,Miranda; Gregory Joseph,17,1,56,39
1657467368792,CSE 11,A01,083080,Cao; Yingjun,6,15,40,34
1657467374817,CSE 12,A01,083652,Krause-Levy; Sophia Louisa,28,1,120,92
1657467380840,CSE 15L,A01,083654,Morris; Justin Loren,9,0,50,41
1657467380840,CSE 15L,A02,083655,Morris; Justin Loren,9,0,50,41
1657467386863,CSE 20,A01,083657,Tran; Khoa Dang,39,0,80,41
1657467392891,CSE 21,A01,095574,Bach; Quang Tran,22,0,48,26
1657467398919,CSE 30,A01,083084,Eldon; John,5,0,80,75
1657467398919,CSE 30,B01,095061,Bhaskar; Nishant,9,0,50,41
1657467404941,CSE 100,A01,083659,Cao; Yingjun,5,4,70,65
1657467410966,CSE 134B,A01,083661,Powell; Thomas Allan,22,0,100,78
1657467416991,CSE 140,A01,083663,Gungor; Onat,15,0,85,70
1657467423013,CSE 140L,A01,083088,Eldon; John,21,0,100,79
1657467429039,CSE 175,A01,083665,Kumar; Rakesh,3,0,25,22
1657467435075,CSE 190,A00,092507,Dubnov; Shlomo,8,0,20,12
1657467441099,ECE 45,A01,083139,Congero; Spencer William,6,0,75,69
1657467447128,ECE 65,A50,083695,Saad; Andrew S,12,0,30,18
1657467447128,ECE 65,A51,095125,Saad; Andrew S,24,0,26,2
1657467453157,ECE 109,A01,091882,Touri; Behrouz,19,0,70,51
1657467459179,ECE 180,A00,083140,Abi Samra; Nicholas Camill,1,0,30,29
1657467459179,ECE 180,B00,083141,Abi Samra; Nicholas Camill,0,0,30,30
1657467465209,MATH 10A,A01,083735,Patchell; Gregory David,2,0,30,28
1657467465209,MATH 10A,A02,083736,Patchell; Gregory David,20,0,30,10
1657467465209,MATH 10A,A03,083737,Patchell; Gregory David,16,0,30,14
1657467471232,MATH 10B,A01,083207,Lim; Seonhee,8,0,34,26
1657467471232,MATH 10B,A02,083208,Lim; Seonhee,9,0,35,26
1657467471232,MATH 10B,A03,093472,Lim; Seonhee,7,0,34,27
1657467471232,MATH 10B,B01,083739,Sinha; Shubham,12,0,30,18
1657467477256,MATH 18,A01,083743,Cinel; Cameron Alexander,7,0,30,23
1657467477256,MATH 18,A02,083744,Cinel; Cameron Alexander,17,0,30,13
1657467477256,MATH 18,A03,083745,Cinel; Cameron Alexander,9,0,30,21
1657467477256,MATH 18,B01,083748,Rideout; David Porter,5,0,37,32
1657467477256,MATH 18,B02,083749,Rideout; David Porter,5,0,36,31
1657467477256,MATH 18,B03,083750,Rideout; David Porter,3,0,37,34
1657467477256,MATH 18,B04,083751,Rideout; David Porter,6,0,36,30
1657467477256,MATH 18,B05,093473,Rideout; David Porter,6,0,36,30
1657467477256,MATH 18,B06,093474,Rideout; David Porter,6,0,36,30
1657467483283,MATH 20A,A01,083754,Zheng; Zequn,14,0,40,26
1657467489308,MATH 20B,A01,083756,Briones; Jor-el Thomas Caparas,4,0,36,32
1657467489308,MATH 20B,A02,083757,Briones; Jor-el Thomas Caparas,1,0,36,35
1657467489308,MATH 20B,A03,093475,Briones; Jor-el Thomas Caparas,2,0,36,34
1657467495331,MATH 20C,A01,083760,Briones; Jor-el Thomas Caparas,1,0,35,34
1657467495331,MATH 20C,A02,083761,Briones; Jor-el Thomas Caparas,8,0,35,27
1657467495331,MATH 20C,A03,093476,Briones; Jor-el Thomas Caparas,0,1,36,36
1657467495331,MATH 20C,B01,083762,Bach; Quang Tran,1,0,30,29
1657467501356,MATH 20D,A01,083765,Tran; Brian Kha,5,0,30,25
1657467501356,MATH 20D,A02,083766,Tran; Brian Kha,5,0,30,25
1657467501356,MATH 20D,A03,083767,Tran; Brian Kha,5,0,30,25
1657467507379,MATH 20E,A01,083771,Ganguly; Soumya,9,0,32,23
1657467507379,MATH 20E,A02,083772,Ganguly; Soumya,6,0,32,26
1657467507379,MATH 20E,B01,083773,Ciotti; Benjamin,20,0,35,15
1657467507379,MATH 20E,B02,083774,Ciotti; Benjamin,17,0,35,18
1657467513403,MATH 103A,A01,083777,Greenfeld; Be'Eri,3,0,36,33
1657467513403,MATH 103A,A02,083778,Greenfeld; Be'Eri,5,0,36,31
1657467513403,MATH 103A,A03,093561,Greenfeld; Be'Eri,5,0,36,31
1657467513403,MATH 103A,B01,083779,Greenfeld; Be'Eri,7,0,36,29
1657467513403,MATH 103A,B02,083780,Greenfeld; Be'Eri,4,0,36,32
1657467513403,MATH 103A,B03,093562,Greenfeld; Be'Eri,3,0,36,33
1657467519427,MATH 105,A01,085443,Carter; Anne Toulson,15,0,35,20
1657467519427,MATH 105,A02,093477,Carter; Anne Toulson,20,0,35,15
1657467525450,MATH 109,A01,083213,Ganzberger; Geoffrey Michael,2,0,34,32
1657467525450,MATH 109,A02,083214,Ganzberger; Geoffrey Michael,4,0,34,30
1657467525450,MATH 109,A03,093478,Ganzberger; Geoffrey Michael,2,0,34,32
1657467525450,MATH 109,B01,083215,Ganzberger; Geoffrey Michael,1,0,32,31
1657467525450,MATH 109,B02,083216,Ganzberger; Geoffrey Michael,2,0,32,30
1657467525450,MATH 109,B03,093479,Ganzberger; Geoffrey Michael,8,0,32,24
1657467531477,MATH 142A,A01,083219,Chow; Bennett,7,0,32,25
1657467531477,MATH 142A,A02,083220,Chow; Bennett,10,0,32,22
1657467531477,MATH 142A,A03,093480,Chow; Bennett,8,0,32,24
1657467531477,MATH 142A,B03,093481,Chow; Bennett,8,0,32,24
1657467531477,MATH 142A,B04,093558,Chow; Bennett,13,0,32,19
1657467531477,MATH 142A,B05,093559,Chow; Bennett,6,0,32,26
1657467537501,MATH 193A,A01,083224,Rotar; Vladimir,8,0,34,26
1657467537501,MATH 193A,A02,083225,Rotar; Vladimir,9,0,34,25
1657467537501,MATH 193A,A03,083781,Rotar; Vladimir,5,0,34,29
1657467537501,MATH 193A,A04,083782,Rotar; Vladimir,10,0,34,24
1657467537501,MATH 193A,A05,093482,Rotar; Vladimir,10,0,34,24
1657467543523,MATH 197,001,091859,McAuley; Julian John,9999,0,9999,0
1657467543523,MATH 197,002,095566,Kedlaya; Kiran S.,9997,0,9999,2
1657467543523,MATH 197,003,095567,Xiao; Ming,9999,0,9999,0
1657467543523,MATH 197,004,095571,Perols; Johan Lars,9998,0,9999,1
1657467550575,COGS 9,A01,083615,Shannon; Kyle Michael,9,0,75,66
1657467556597,COGS 11,A01,083617,Boyle; Mary E. T.,22,0,48,26
1657467562620,COGS 13,A01,083071,Bastos; Amalia Pinkusfeld,11,0,71,60
1657467568643,COGS 14A,A01,092681,Semenuks; Arturs,5,1,100,95
1657467574664,COGS 14B,A01,083073,Cheng; Tzu-Han,6,0,63,57
1657467580686,COGS 17,A01,092677,Semenuks; Arturs,6,0,81,75
1657467586713,COGS 100,A01,083619,Allen; Michael Gordon,17,0,70,53
1657467592735,COGS 101A,A01,083621,Davis; Joshua Daniel,9,0,68,59
1657467598757,COGS 101B,A01,091572,Allen; Michael Gordon,12,0,65,53
1657467604786,COGS 101C,A01,083625,Delgado; Tania,17,0,35,18
1657467610813,COGS 107A,A01,083627,Boyle; Mary E. T.,13,0,60,47
1657467616840,COGS 118A,A01,083075,Gupta; Anjum,21,0,76,55
1657467622868,CSE 3,A50,083646,Miranda; Gregory Joseph,24,0,50,26
1657467628894,CSE 8A,A50,083650,Miranda; Gregory Joseph,17,1,56,39
1657467634922,CSE 11,A01,083080,Cao; Yingjun,6,15,40,34
1657467640949,CSE 12,A01,083652,Krause-Levy; Sophia Louisa,28,1,120,92
1657467646976,CSE 15L,A01,083654,Morris; Justin Loren,9,0,50,41
1657467646976,CSE 15L,A02,083655,Morris; Justin Loren,9,0,50,41
1657467653004,CSE 20,A01,083657,Tran; Khoa Dang,39,0,80,41
1657467659027,CSE 21,A01,095574,Bach; Quang Tran,22,0,48,26
1657467665054,CSE 30,A01,083084,Eldon; John,5,0,80,75
1657467665054,CSE 30,B01,095061,Bhaskar; Nishant,9,0,50,41
1657467671080,CSE 100,A01,083659,Cao; Yingjun,5,4,70,65
1657467677103,CSE 134B,A01,083661,Powell; Thomas Allan,22,0,100,78
1657467683127,CSE 140,A01,083663,Gungor; Onat,15,0,85,70
1657467689150,CSE 140L,A01,083088,Eldon; John,21,0,100,79
1657467695175,CSE 175,A01,083665,Kumar; Rakesh,3,0,25,22
1657467701198,CSE 190,A00,092507,Dubnov; Shlomo,8,0,20,12
1657467707224,ECE 45,A01,083139,Congero; Spencer William,6,0,75,69
1657467713251,ECE 65,A50,083695,Saad; Andrew S,12,0,30,18
1657467713251,ECE 65,A51,095125,Saad; Andrew S,24,0,26,2
1657467719277,ECE 109,A01,091882,Touri; Behrouz,19,0,70,51
1657467725303,ECE 180,A00,083140,Abi Samra; Nicholas Camill,1,0,30,29
1657467725303,ECE 180,B00,083141,Abi Samra; Nicholas Camill,0,0,30,30
1657467731332,MATH 10A,A01,083735,Patchell; Gregory David,2,0,30,28
1657467731332,MATH 10A,A02,083736,Patchell; Gregory David,20,0,30,10
1657467731332,MATH 10A,A03,083737,Patchell; Gregory David,16,0,30,14
1657467737355,MATH 10B,A01,083207,Lim; Seonhee,8,0,34,26
1657467737355,MATH 10B,A02,083208,Lim; Seonhee,9,0,35,26
1657467737355,MATH 10B,A03,093472,Lim; Seonhee,7,0,34,27
1657467737355,MATH 10B,B01,083739,Sinha; Shubham,12,0,30,18
1657467743386,MATH 18,A01,083743,Cinel; Cameron Alexander,7,0,30,23
1657467743386,MATH 18,A02,083744,Cinel; Cameron Alexander,17,0,30,13
1657467743386,MATH 18,A03,083745,Cinel; Cameron Alexander,9,0,30,21
1657467743386,MATH 18,B01,083748,Rideout; David Porter,5,0,37,32
1657467743386,MATH 18,B02,083749,Rideout; David Porter,5,0,36,31
1657467743386,MATH 18,B03,083750,Rideout; David Porter,3,0,37,34
1657467743386,MATH 18,B04,083751,Rideout; David Porter,6,0,36,30
1657467743386,MATH 18,B05,093473,Rideout; David Porter,6,0,36,30
1657467743386,MATH 18,B06,093474,Rideout; David Porter,6,0,36,30
1657467749408,MATH 20A,A01,083754,Zheng; Zequn,14,0,40,26
1657467755442,MATH 20B,A01,083756,Briones; Jor-el Thomas Caparas,4,0,36,32
1657467755442,MATH 20B,A02,083757,Briones; Jor-el Thomas Caparas,1,0,36,35
1657467755442,MATH 20B,A03,093475,Briones; Jor-el Thomas Caparas,2,0,36,34
1657467761470,MATH 20C,A01,083760,Briones; Jor-el Thomas Caparas,1,0,35,34
1657467761470,MATH 20C,A02,083761,Briones; Jor-el Thomas Caparas,8,0,35,27
1657467761470,MATH 20C,A03,093476,Briones; Jor-el Thomas Caparas,0,1,36,36
1657467761470,MATH 20C,B01,083762,Bach; Quang Tran,1,0,30,29
1657467767498,MATH 20D,A01,083765,Tran; Brian Kha,5,0,30,25
1657467767498,MATH 20D,A02,083766,Tran; Brian Kha,5,0,30,25
1657467767498,MATH 20D,A03,083767,Tran; Brian Kha,5,0,30,25
1657467773526,MATH 20E,A01,083771,Ganguly; Soumya,9,0,32,23
1657467773526,MATH 20E,A02,083772,Ganguly; Soumya,6,0,32,26
1657467773526,MATH 20E,B01,083773,Ciotti; Benjamin,20,0,35,15
1657467773526,MATH 20E,B02,083774,Ciotti; Benjamin,17,0,35,18
1657467779550,MATH 103A,A01,083777,Greenfeld; Be'Eri,3,0,36,33
1657467779550,MATH 103A,A02,083778,Greenfeld; Be'Eri,5,0,36,31
1657467779550,MATH 103A,A03,093561,Greenfeld; Be'Eri,5,0,36,31
1657467779550,MATH 103A,B01,083779,Greenfeld; Be'Eri,7,0,36,29
1657467779550,MATH 103A,B02,083780,Greenfeld; Be'Eri,4,0,36,32
1657467779550,MATH 103A,B03,093562,Greenfeld; Be'Eri,3,0,36,33
1657467785574,MATH 105,A01,085443,Carter; Anne Toulson,15,0,35,20
1657467785574,MATH 105,A02,093477,Carter; Anne Toulson,20,0,35,15
1657467791601,MATH 109,A01,083213,Ganzberger; Geoffrey Michael,2,0,34,32
1657467791601,MATH 109,A02,083214,Ganzberger; Geoffrey Michael,4,0,34,30
1657467791601,MATH 109,A03,093478,Ganzberger; Geoffrey Michael,2,0,34,32
1657467791601,MATH 109,B01,083215,Ganzberger; Geoffrey Michael,1,0,32,31
1657467791601,MATH 109,B02,083216,Ganzberger; Geoffrey Michael,2,0,32,30
1657467791601,MATH 109,B03,093479,Ganzberger; Geoffrey Michael,8,0,32,24
1657467797625,MATH 142A,A01,083219,Chow; Bennett,7,0,32,25
1657467797625,MATH 142A,A02,083220,Chow; Bennett,10,0,32,22
1657467797625,MATH 142A,A03,093480,Chow; Bennett,8,0,32,24
1657467797625,MATH 142A,B03,093481,Chow; Bennett,8,0,32,24
1657467797625,MATH 142A,B04,093558,Chow; Bennett,13,0,32,19
1657467797625,MATH 142A,B05,093559,Chow; Bennett,6,0,32,26
1657467803652,MATH 193A,A01,083224,Rotar; Vladimir,8,0,34,26
1657467803652,MATH 193A,A02,083225,Rotar; Vladimir,9,0,34,25
1657467803652,MATH 193A,A03,083781,Rotar; Vladimir,5,0,34,29
1657467803652,MATH 193A,A04,083782,Rotar; Vladimir,10,0,34,24
1657467803652,MATH 193A,A05,093482,Rotar; Vladimir,10,0,34,24
1657467809683,MATH 197,001,091859,McAuley; Julian John,9999,0,9999,0
1657467809683,MATH 197,002,095566,Kedlaya; Kiran S.,9997,0,9999,2
1657467809683,MATH 197,003,095567,Xiao; Ming,9999,0,9999,0
1657467809683,MATH 197,004,095571,Perols; Johan Lars,9998,0,9999,1
1657467816738,COGS 9,A01,083615,Shannon; Kyle Michael,9,0,75,66
1657467822764,COGS 11,A01,083617,Boyle; Mary E. T.,22,0,48,26
1657467828787,COGS 13,A01,083071,Bastos; Amalia Pinkusfeld,11,0,71,60
1657467834811,COGS 14A,A01,092681,Semenuks; Arturs,5,1,100,95
1657467840834,COGS 14B,A01,083073,Cheng; Tzu-Han,6,0,63,57
1657467846857,COGS 17,A01,092677,Semenuks; Arturs,6,0,81,75
1657467852881,COGS 100,A01,083619,Allen; Michael Gordon,17,0,70,53
1657467858905,COGS 101A,A01,083621,Davis; Joshua Daniel,9,0,68,59
1657467864927,COGS 101B,A01,091572,Allen; Michael Gordon,12,0,65,53
1657467870951,COGS 101C,A01,083625,Delgado; Tania,17,0,35,18
1657467876974,COGS 107A,A01,083627,Boyle; Mary E. T.,13,0,60,47
1657467883001,COGS 118A,A01,083075,Gupta; Anjum,21,0,76,55
1657467889115,CSE 3,A50,083646,Miranda; Gregory Joseph,24,0,50,26
1657467895147,CSE 8A,A50,083650,Miranda; Gregory Joseph,17,1,56,39
1657467901172,CSE 11,A01,083080,Cao; Yingjun,6,15,40,34
1657467907194,CSE 12,A01,083652,Krause-Levy; Sophia Louisa,28,1,120,92
1657467913217,CSE 15L,A01,083654,Morris; Justin Loren,9,0,50,41
1657467913217,CSE 15L,A02,083655,Morris; Justin Loren,9,0,50,41
1657467919245,CSE 20,A01,083657,Tran; Khoa Dang,39,0,80,41
1657467925268,CSE 21,A01,095574,Bach; Quang Tran,22,0,48,26
1657467931290,CSE 30,A01,083084,Eldon; John,5,0,80,75
1657467931290,CSE 30,B01,095061,Bhaskar; Nishant,9,0,50,41
1657467937316,CSE 100,A01,083659,Cao; Yingjun,5,4,70,65
1657467943342,CSE 134B,A01,083661,Powell; Thomas Allan,22,0,100,78
1657467949365,CSE 140,A01,083663,Gungor; Onat,15,0,85,70
1657467955389,CSE 140L,A01,083088,Eldon; John,21,0,100,79
1657467961414,CSE 175,A01,083665,Kumar; Rakesh,3,0,25,22
1657467967440,CSE 190,A00,092507,Dubnov; Shlomo,8,0,20,12
1657467973466,ECE 45,A01,083139,Congero; Spencer William,6,0,75,69
1657467979490,ECE 65,A50,083695,Saad; Andrew S,12,0,30,18
1657467979490,ECE 65,A51,095125,Saad; Andrew S,24,0,26,2
1657467985518,ECE 109,A01,091882,Touri; Behrouz,19,0,70,51
1657467991548,ECE 180,A00,083140,Abi Samra; Nicholas Camill,1,0,30,29
1657467991548,ECE 180,B00,083141,Abi Samra; Nicholas Camill,0,0,30,30
1657467997575,MATH 10A,A01,083735,Patchell; Gregory David,2,0,30,28
1657467997575,MATH 10A,A02,083736,Patchell; Gregory David,20,0,30,10
1657467997575,MATH 10A,A03,083737,Patchell; Gregory David,16,0,30,14
1657468003598,MATH 10B,A01,083207,Lim; Seonhee,8,0,34,26
1657468003598,MATH 10B,A02,083208,Lim; Seonhee,9,0,35,26
1657468003598,MATH 10B,A03,093472,Lim; Seonhee,7,0,34,27
1657468003598,MATH 10B,B01,083739,Sinha; Shubham,12,0,30,18
1657468009630,MATH 18,A01,083743,Cinel; Cameron Alexander,7,0,30,23
1657468009630,MATH 18,A02,083744,Cinel; Cameron Alexander,17,0,30,13
1657468009630,MATH 18,A03,083745,Cinel; Cameron Alexander,9,0,30,21
1657468009630,MATH 18,B01,083748,Rideout; David Porter,5,0,37,32
1657468009630,MATH 18,B02,083749,Rideout; David Porter,5,0,36,31
1657468009630,MATH 18,B03,083750,Rideout; David Porter,3,0,37,34
1657468009630,MATH 18,B04,083751,Rideout; David Porter,6,0,36,30
1657468009630,MATH 18,B05,093473,Rideout; David Porter,6,0,36,30
1657468009630,MATH 18,B06,093474,Rideout; David Porter,6,0,36,30
1657468015655,MATH 20A,A01,083754,Zheng; Zequn,14,0,40,26
1657468021682,MATH 20B,A01,083756,Briones; Jor-el Thomas Caparas,4,0,36,32
1657468021682,MATH 20B,A02,083757,Briones; Jor-el Thomas Caparas,1,0,36,35
1657468021682,MATH 20B,A03,093475,Briones; Jor-el Thomas Caparas,2,0,36,34
1657468027704,MATH 20C,A01,083760,Briones; Jor-el Thomas Caparas,1,0,35,34
1657468027704,MATH 20C,A02,083761,Briones; Jor-el Thomas Caparas,8,0,35,27
1657468027704,MATH 20C,A03,093476,Briones; Jor-el Thomas Caparas,0,1,36,36
1657468027704,MATH 20C,B01,083762,Bach; Quang Tran,1,0,30,29
1657468033727,MATH 20D,A01,083765,Tran; Brian Kha,5,0,30,25
1657468033727,MATH 20D,A02,083766,Tran; Brian Kha,5,0,30,25
1657468033727,MATH 20D,A03,083767,Tran; Brian Kha,5,0,30,25
1657468039755,MATH 20E,A01,083771,Ganguly; Soumya,9,0,32,23
1657468039755,MATH 20E,A02,083772,Ganguly; Soumya,6,0,32,26
1657468039755,MATH 20E,B01,083773,Ciotti; Benjamin,20,0,35,15
1657468039755,MATH 20E,B02,083774,Ciotti; Benjamin,17,0,35,18
1657468045793,MATH 103A,A01,083777,Greenfeld; Be'Eri,3,0,36,33
1657468045793,MATH 103A,A02,083778,Greenfeld; Be'Eri,5,0,36,31
1657468045793,MATH 103A,A03,093561,Greenfeld; Be'Eri,5,0,36,31
1657468045793,MATH 103A,B01,083779,Greenfeld; Be'Eri,7,0,36,29
1657468045793,MATH 103A,B02,083780,Greenfeld; Be'Eri,4,0,36,32
1657468045793,MATH 103A,B03,093562,Greenfeld; Be'Eri,3,0,36,33
1657468051821,MATH 105,A01,085443,Carter; Anne Toulson,15,0,35,20
1657468051821,MATH 105,A02,093477,Carter; Anne Toulson,20,0,35,15
1657468057847,MATH 109,A01,083213,Ganzberger; Geoffrey Michael,2,0,34,32
1657468057847,MATH 109,A02,083214,Ganzberger; Geoffrey Michael,4,0,34,30
1657468057847,MATH 109,A03,093478,Ganzberger; Geoffrey Michael,2,0,34,32
1657468057847,MATH 109,B01,083215,Ganzberger; Geoffrey Michael,1,0,32,31
1657468057847,MATH 109,B02,083216,Ganzberger; Geoffrey Michael,2,0,32,30
1657468057847,MATH 109,B03,093479,Ganzberger; Geoffrey Michael,8,0,32,24
1657468063870,MATH 142A,A01,083219,Chow; Bennett,7,0,32,25
1657468063870,MATH 142A,A02,083220,Chow; Bennett,10,0,32,22
1657468063870,MATH 142A,A03,093480,Chow; Bennett,8,0,32,24
1657468063870,MATH 142A,B03,093481,Chow; Bennett,8,0,32,24
1657468063870,MATH 142A,B04,093558,Chow; Bennett,13,0,32,19
1657468063870,MATH 142A,B05,093559,Chow; Bennett,6,0,32,26
1657468069899,MATH 193A,A01,083224,Rotar; Vladimir,8,0,34,26
1657468069899,MATH 193A,A02,083225,Rotar; Vladimir,9,0,34,25
1657468069899,MATH 193A,A03,083781,Rotar; Vladimir,5,0,34,29
1657468069899,MATH 193A,A04,083782,Rotar; Vladimir,10,0,34,24
1657468069899,MATH 193A,A05,093482,Rotar; Vladimir,10,0,34,24
1657468075926,MATH 197,001,091859,McAuley; Julian John,9999,0,9999,0
1657468075926,MATH 197,002,095566,Kedlaya; Kiran S.,9997,0,9999,2
1657468075926,MATH 197,003,095567,Xiao; Ming,9999,0,9999,0
1657468075926,MATH 197,004,095571,Perols; Johan Lars,9998,0,9999,1
1657468082990,COGS 9,A01,083615,Shannon; Kyle Michael,9,0,75,66
1657468089028,COGS 11,A01,083617,Boyle; Mary E. T.,22,0,48,26
1657468095052,COGS 13,A01,083071,Bastos; Amalia Pinkusfeld,11,0,71,60
1657468101075,COGS 14A,A01,092681,Semenuks; Arturs,5,1,100,95
1657468107097,COGS 14B,A01,083073,Cheng; Tzu-Han,6,0,63,57
1657468113119,COGS 17,A01,092677,Semenuks; Arturs,6,0,81,75
1657468119146,COGS 100,A01,083619,Allen; Michael Gordon,17,0,70,53
1657468125168,COGS 101A,A01,083621,Davis; Joshua Daniel,9,0,68,59
1657468131191,COGS 101B,A01,091572,Allen; Michael Gordon,12,0,65,53
1657468137215,COGS 101C,A01,083625,Delgado; Tania,17,0,35,18
1657468143240,COGS 107A,A01,083627,Boyle; Mary E. T.,13,0,60,47
1657468149264,COGS 118A,A01,083075,Gupta; Anjum,21,0,76,55
1657468155290,CSE 3,A50,083646,Miranda; Gregory Joseph,24,0,50,26
1657468161316,CSE 8A,A50,083650,Miranda; Gregory Joseph,17,1,56,39
1657468167339,CSE 11,A01,083080,Cao; Yingjun,6,15,40,34
1657468173361,CSE 12,A01,083652,Krause-Levy; Sophia Louisa,28,1,120,92
1657468179384,CSE 15L,A01,083654,Morris; Justin Loren,9,0,50,41
1657468179384,CSE 15L,A02,083655,Morris; Justin Loren,9,0,50,41
1657468185408,CSE 20,A01,083657,Tran; Khoa Dang,39,0,80,41
1657468191430,CSE 21,A01,095574,Bach; Quang Tran,22,0,48,26
1657468197460,CSE 30,A01,083084,Eldon; John,5,0,80,75
1657468197460,CSE 30,B01,095061,Bhaskar; Nishant,9,0,50,41
1657468203486,CSE 100,A01,083659,Cao; Yingjun,5,4,70,65
1657468209509,CSE 134B,A01,083661,Powell; Thomas Allan,22,0,100,78
1657468215536,CSE 140,A01,083663,Gungor; Onat,15,0,85,70
1657468221559,CSE 140L,A01,083088,Eldon; John,21,0,100,79
1657468227582,CSE 175,A01,083665,Kumar; Rakesh,3,0,25,22
1657468233606,CSE 190,A00,092507,Dubnov; Shlomo,8,0,20,12
1657468239629,ECE 45,A01,083139,Congero; Spencer William,6,0,75,69
1657468245656,ECE 65,A50,083695,Saad; Andrew S,12,0,30,18
1657468245656,ECE 65,A51,095125,Saad; Andrew S,24,0,26,2
1657468251683,ECE 109,A01,091882,Touri; Behrouz,19,0,70,51
1657468257709,ECE 180,A00,083140,Abi Samra; Nicholas Camill,1,0,30,29
1657468257709,ECE 180,B00,083141,Abi Samra; Nicholas Camill,0,0,30,30
1657468263730,MATH 10A,A01,083735,Patchell; Gregory David,2,0,30,28
1657468263730,MATH 10A,A02,083736,Patchell; Gregory David,20,0,30,10
1657468263730,MATH 10A,A03,083737,Patchell; Gregory David,16,0,30,14
1657468269755,MATH 10B,A01,083207,Lim; Seonhee,8,0,34,26
1657468269755,MATH 10B,A02,083208,Lim; Seonhee,9,0,35,26
1657468269755,MATH 10B,A03,093472,Lim; Seonhee,7,0,34,27
1657468269755,MATH 10B,B01,083739,Sinha; Shubham,12,0,30,18
1657468275777,MATH 18,A01,083743,Cinel; Cameron Alexander,7,0,30,23
1657468275777,MATH 18,A02,083744,Cinel; Cameron Alexander,17,0,30,13
1657468275777,MATH 18,A03,083745,Cinel; Cameron Alexander,9,0,30,21
1657468275777,MATH 18,B01,083748,Rideout; David Porter,5,0,37,32
1657468275777,MATH 18,B02,083749,Rideout; David Porter,5,0,36,31
1657468275777,MATH 18,B03,083750,Rideout; David Porter,3,0,37,34
1657468275777,MATH 18,B04,083751,Rideout; David Porter,6,0,36,30
1657468275777,MATH 18,B05,093473,Rideout; David Porter,6,0,36,30
1657468275777,MATH 18,B06,093474,Rideout; David Porter,6,0,36,30
1657468281803,MATH 20A,A01,083754,Zheng; Zequn,14,0,40,26
1657468287826,MATH 20B,A01,083756,Briones; Jor-el Thomas Caparas,4,0,36,32
1657468287826,MATH 20B,A02,083757,Briones; Jor-el Thomas Caparas,1,0,36,35
1657468287826,MATH 20B,A03,093475,Briones; Jor-el Thomas Caparas,2,0,36,34
1657468293851,MATH 20C,A01,083760,Briones; Jor-el Thomas Caparas,1,0,35,34
1657468293851,MATH 20C,A02,083761,Briones; Jor-el Thomas Caparas,8,0,35,27
1657468293851,MATH 20C,A03,093476,Briones; Jor-el Thomas Caparas,0,1,36,36
1657468293851,MATH 20C,B01,083762,Bach; Quang Tran,1,0,30,29
1657468299876,MATH 20D,A01,083765,Tran; Brian Kha,5,0,30,25
1657468299876,MATH 20D,A02,083766,Tran; Brian Kha,5,0,30,25
1657468299876,MATH 20D,A03,083767,Tran; Brian Kha,5,0,30,25
1657468305904,MATH 20E,A01,083771,Ganguly; Soumya,9,0,32,23
1657468305904,MATH 20E,A02,083772,Ganguly; Soumya,6,0,32,26
1657468305904,MATH 20E,B01,083773,Ciotti; Benjamin,20,0,35,15
1657468305904,MATH 20E,B02,083774,Ciotti; Benjamin,17,0,35,18
1657468311932,MATH 103A,A01,083777,Greenfeld; Be'Eri,3,0,36,33
1657468311932,MATH 103A,A02,083778,Greenfeld; Be'Eri,5,0,36,31
1657468311932,MATH 103A,A03,093561,Greenfeld; Be'Eri,5,0,36,31
1657468311932,MATH 103A,B01,083779,Greenfeld; Be'Eri,7,0,36,29
1657468311932,MATH 103A,B02,083780,Greenfeld; Be'Eri,4,0,36,32
1657468311932,MATH 103A,B03,093562,Greenfeld; Be'Eri,3,0,36,33
1657468317958,MATH 105,A01,085443,Carter; Anne Toulson,15,0,35,20
1657468317958,MATH 105,A02,093477,Carter; Anne Toulson,20,0,35,15
1657468323983,MATH 109,A01,083213,Ganzberger; Geoffrey Michael,2,0,34,32
1657468323983,MATH 109,A02,083214,Ganzberger; Geoffrey Michael,4,0,34,30
1657468323983,MATH 109,A03,093478,Ganzberger; Geoffrey Michael,2,0,34,32
1657468323983,MATH 109,B01,083215,Ganzberger; Geoffrey Michael,1,0,32,31
1657468323983,MATH 109,B02,083216,Ganzberger; Geoffrey Michael,2,0,32,30
1657468323983,MATH 109,B03,093479,Ganzberger; Geoffrey Michael,8,0,32,24
1657468330006,MATH 142A,A01,083219,Chow; Bennett,7,0,32,25
1657468330006,MATH 142A,A02,083220,Chow; Bennett,10,0,32,22
1657468330006,MATH 142A,A03,093480,Chow; Bennett,8,0,32,24
1657468330006,MATH 142A,B03,093481,Chow; Bennett,8,0,32,24
1657468330006,MATH 142A,B04,093558,Chow; Bennett,13,0,32,19
1657468330006,MATH 142A,B05,093559,Chow; Bennett,6,0,32,26
1657468336030,MATH 193A,A01,083224,Rotar; Vladimir,8,0,34,26
1657468336030,MATH 193A,A02,083225,Rotar; Vladimir,9,0,34,25
1657468336030,MATH 193A,A03,083781,Rotar; Vladimir,5,0,34,29
1657468336030,MATH 193A,A04,083782,Rotar; Vladimir,10,0,34,24
1657468336030,MATH 193A,A05,093482,Rotar; Vladimir,10,0,34,24
1657468342057,MATH 197,001,091859,McAuley; Julian John,9999,0,9999,0
1657468342057,MATH 197,002,095566,Kedlaya; Kiran S.,9997,0,9999,2
1657468342057,MATH 197,003,095567,Xiao; Ming,9999,0,9999,0
1657468342057,MATH 197,004,095571,Perols; Johan Lars,9998,0,9999,1
1657468349123,COGS 9,A01,083615,Shannon; Kyle Michael,9,0,75,66
1657468355149,COGS 11,A01,083617,Boyle; Mary E. T.,22,0,48,26
1657468361174,COGS 13,A01,083071,Bastos; Amalia Pinkusfeld,11,0,71,60
1657468367201,COGS 14A,A01,092681,Semenuks; Arturs,5,1,100,95
1657468373223,COGS 14B,A01,083073,Cheng; Tzu-Han,6,0,63,57
1657468379247,COGS 17,A01,092677,Semenuks; Arturs,6,0,81,75
1657468385272,COGS 100,A01,083619,Allen; Michael Gordon,17,0,70,53
1657468391296,COGS 101A,A01,083621,Davis; Joshua Daniel,9,0,68,59
1657468397318,COGS 101B,A01,091572,Allen; Michael Gordon,12,0,65,53
1657468403345,COGS 101C,A01,083625,Delgado; Tania,17,0,35,18
1657468409371,COGS 107A,A01,083627,Boyle; Mary E. T.,13,0,60,47
1657468415394,COGS 118A,A01,083075,Gupta; Anjum,21,0,76,55
1657468421423,CSE 3,A50,083646,Miranda; Gregory Joseph,24,0,50,26
1657468427446,CSE 8A,A50,083650,Miranda; Gregory Joseph,17,1,56,39
1657468433471,CSE 11,A01,083080,Cao; Yingjun,6,15,40,34
1657468439497,CSE 12,A01,083652,Krause-Levy; Sophia Louisa,28,1,120,92
1657468445524,CSE 15L,A01,083654,Morris; Justin Loren,9,0,50,41
1657468445524,CSE 15L,A02,083655,Morris; Justin Loren,9,0,50,41
1657468451547,CSE 20,A01,083657,Tran; Khoa Dang,39,0,80,41
1657468457573,CSE 21,A01,095574,Bach; Quang Tran,22,0,48,26
1657468463598,CSE 30,A01,083084,Eldon; John,5,0,80,75
1657468463598,CSE 30,B01,095061,Bhaskar; Nishant,9,0,50,41
1657468469624,CSE 100,A01,083659,Cao; Yingjun,5,4,70,65
1657468475653,CSE 134B,A01,083661,Powell; Thomas Allan,22,0,100,78
1657468481676,CSE 140,A01,083663,Gungor; Onat,15,0,85,70
1657468487797,CSE 140L,A01,083088,Eldon; John,21,0,100,79
1657468493824,CSE 175,A01,083665,Kumar; Rakesh,3,0,25,22
1657468499846,CSE 190,A00,092507,Dubnov; Shlomo,8,0,20,12
1657468505872,ECE 45,A01,083139,Congero; Spencer William,6,0,75,69
1657468511895,ECE 65,A50,083695,Saad; Andrew S,12,0,30,18
1657468511895,ECE 65,A51,095125,Saad; Andrew S,24,0,26,2
1657468517918,ECE 109,A01,091882,Touri; Behrouz,19,0,70,51
1657468523942,ECE 180,A00,083140,Abi Samra; Nicholas Camill,1,0,30,29
1657468523942,ECE 180,B00,083141,Abi Samra; Nicholas Camill,0,0,30,30
1657468529966,MATH 10A,A01,083735,Patchell; Gregory David,2,0,30,28
1657468529966,MATH 10A,A02,083736,Patchell; Gregory David,20,0,30,10
1657468529966,MATH 10A,A03,083737,Patchell; Gregory David,16,0,30,14
1657468535990,MATH 10B,A01,083207,Lim; Seonhee,8,0,34,26
1657468535990,MATH 10B,A02,083208,Lim; Seonhee,9,0,35,26
1657468535990,MATH 10B,A03,093472,Lim; Seonhee,7,0,34,27
1657468535990,MATH 10B,B01,083739,Sinha; Shubham,12,0,30,18
1657468542016,MATH 18,A01,083743,Cinel; Cameron Alexander,7,0,30,23
1657468542016,MATH 18,A02,083744,Cinel; Cameron Alexander,17,0,30,13
1657468542016,MATH 18,A03,083745,Cinel; Cameron Alexander,9,0,30,21
1657468542016,MATH 18,B01,083748,Rideout; David Porter,5,0,37,32
1657468542016,MATH 18,B02,083749,Rideout; David Porter,5,0,36,31
1657468542016,MATH 18,B03,083750,Rideout; David Porter,3,0,37,34
1657468542016,MATH 18,B04,083751,Rideout; David Porter,6,0,36,30
1657468542016,MATH 18,B05,093473,Rideout; David Porter,6,0,36,30
1657468542016,MATH 18,B06,093474,Rideout; David Porter,6,0,36,30
1657468548038,MATH 20A,A01,083754,Zheng; Zequn,14,0,40,26
1657468554064,MATH 20B,A01,083756,Briones; Jor-el Thomas Caparas,4,0,36,32
1657468554064,MATH 20B,A02,083757,Briones; Jor-el Thomas Caparas,1,0,36,35
1657468554064,MATH 20B,A03,093475,Briones; Jor-el Thomas Caparas,2,0,36,34
1657468560088,MATH 20C,A01,083760,Briones; Jor-el Thomas Caparas,1,0,35,34
1657468560088,MATH 20C,A02,083761,Briones; Jor-el Thomas Caparas,8,0,35,27
1657468560088,MATH 20C,A03,093476,Briones; Jor-el Thomas Caparas,0,1,36,36
1657468560088,MATH 20C,B01,083762,Bach; Quang Tran,1,0,30,29
1657468566113,MATH 20D,A01,083765,Tran; Brian Kha,5,0,30,25
1657468566113,MATH 20D,A02,083766,Tran; Brian Kha,5,0,30,25
1657468566113,MATH 20D,A03,083767,Tran; Brian Kha,5,0,30,25
1657468572140,MATH 20E,A01,083771,Ganguly; Soumya,9,0,32,23
1657468572140,MATH 20E,A02,083772,Ganguly; Soumya,6,0,32,26
1657468572140,MATH 20E,B01,083773,Ciotti; Benjamin,20,0,35,15
1657468572140,MATH 20E,B02,083774,Ciotti; Benjamin,17,0,35,18
1657468578165,MATH 103A,A01,083777,Greenfeld; Be'Eri,3,0,36,33
1657468578165,MATH 103A,A02,083778,Greenfeld; Be'Eri,5,0,36,31
1657468578165,MATH 103A,A03,093561,Greenfeld; Be'Eri,5,0,36,31
1657468578165,MATH 103A,B01,083779,Greenfeld; Be'Eri,7,0,36,29
1657468578165,MATH 103A,B02,083780,Greenfeld; Be'Eri,4,0,36,32
1657468578165,MATH 103A,B03,093562,Greenfeld; Be'Eri,3,0,36,33
1657468584191,MATH 105,A01,085443,Carter; Anne Toulson,15,0,35,20
1657468584191,MATH 105,A02,093477,Carter; Anne Toulson,20,0,35,15
1657468590221,MATH 109,A01,083213,Ganzberger; Geoffrey Michael,2,0,34,32
1657468590221,MATH 109,A02,083214,Ganzberger; Geoffrey Michael,4,0,34,30
1657468590221,MATH 109,A03,093478,Ganzberger; Geoffrey Michael,2,0,34,32
1657468590221,MATH 109,B01,083215,Ganzberger; Geoffrey Michael,1,0,32,31
1657468590221,MATH 109,B02,083216,Ganzberger; Geoffrey Michael,2,0,32,30
1657468590221,MATH 109,B03,093479,Ganzberger; Geoffrey Michael,8,0,32,24
1657468596275,MATH 142A,A01,083219,Chow; Bennett,7,0,32,25
1657468596275,MATH 142A,A02,083220,Chow; Bennett,10,0,32,22
1657468596275,MATH 142A,A03,093480,Chow; Bennett,8,0,32,24
1657468596275,MATH 142A,B03,093481,Chow; Bennett,8,0,32,24
1657468596275,MATH 142A,B04,093558,Chow; Bennett,13,0,32,19
1657468596275,MATH 142A,B05,093559,Chow; Bennett,6,0,32,26
1657468602311,MATH 193A,A01,083224,Rotar; Vladimir,8,0,34,26
1657468602311,MATH 193A,A02,083225,Rotar; Vladimir,9,0,34,25
1657468602311,MATH 193A,A03,083781,Rotar; Vladimir,5,0,34,29
1657468602311,MATH 193A,A04,083782,Rotar; Vladimir,10,0,34,24
1657468602311,MATH 193A,A05,093482,Rotar; Vladimir,10,0,34,24
1657468608336,MATH 197,001,091859,McAuley; Julian John,9999,0,9999,0
1657468608336,MATH 197,002,095566,Kedlaya; Kiran S.,9997,0,9999,2
1657468608336,MATH 197,003,095567,Xiao; Ming,9999,0,9999,0
1657468608336,MATH 197,004,095571,Perols; Johan Lars,9998,0,9999,1
1657468615390,COGS 9,A01,083615,Shannon; Kyle Michael,9,0,75,66
1657468621415,COGS 11,A01,083617,Boyle; Mary E. T.,22,0,48,26
1657468627442,COGS 13,A01,083071,Bastos; Amalia Pinkusfeld,11,0,71,60
1657468633470,COGS 14A,A01,092681,Semenuks; Arturs,5,1,100,95
1657468639493,COGS 14B,A01,083073,Cheng; Tzu-Han,6,0,63,57
1657468645518,COGS 17,A01,092677,Semenuks; Arturs,6,0,81,75
1657468651543,COGS 100,A01,083619,Allen; Michael Gordon,17,0,70,53
1657468657573,COGS 101A,A01,083621,Davis; Joshua Daniel,9,0,68,59
1657468663597,COGS 101B,A01,091572,Allen; Michael Gordon,12,0,65,53
1657468669621,COGS 101C,A01,083625,Delgado; Tania,17,0,35,18
1657468675648,COGS 107A,A01,083627,Boyle; Mary E. T.,13,0,60,47
1657468681672,COGS 118A,A01,083075,Gupta; Anjum,21,0,76,55
1657468687699,CSE 3,A50,083646,Miranda; Gregory Joseph,24,0,50,26
1657468693722,CSE 8A,A50,083650,Miranda; Gregory Joseph,17,1,56,39
1657468699745,CSE 11,A01,083080,Cao; Yingjun,6,15,40,34
1657468705771,CSE 12,A01,083652,Krause-Levy; Sophia Louisa,28,1,120,92
1657468711797,CSE 15L,A01,083654,Morris; Justin Loren,9,0,50,41
1657468711797,CSE 15L,A02,083655,Morris; Justin Loren,9,0,50,41
1657468717820,CSE 20,A01,083657,Tran; Khoa Dang,39,0,80,41
1657468723844,CSE 21,A01,095574,Bach; Quang Tran,22,0,48,26
1657468729872,CSE 30,A01,083084,Eldon; John,5,0,80,75
1657468729872,CSE 30,B01,095061,Bhaskar; Nishant,9,0,50,41
1657468735899,CSE 100,A01,083659,Cao; Yingjun,5,4,70,65
1657468741923,CSE 134B,A01,083661,Powell; Thomas Allan,22,0,100,78
1657468747944,CSE 140,A01,083663,Gungor; Onat,15,0,85,70
1657468753968,CSE 140L,A01,083088,Eldon; John,21,0,100,79
1657468759991,CSE 175,A01,083665,Kumar; Rakesh,3,0,25,22
1657468766015,CSE 190,A00,092507,Dubnov; Shlomo,8,0,20,12
1657468772049,ECE 45,A01,083139,Congero; Spencer William,6,0,75,69
1657468778075,ECE 65,A50,083695,Saad; Andrew S,12,0,30,18
1657468778075,ECE 65,A51,095125,Saad; Andrew S,24,0,26,2
1657468784099,ECE 109,A01,091882,Touri; Behrouz,19,0,70,51
1657468790122,ECE 180,A00,083140,Abi Samra; Nicholas Camill,1,0,30,29
1657468790122,ECE 180,B00,083141,Abi Samra; Nicholas Camill,0,0,30,30
1657468796154,MATH 10A,A01,083735,Patchell; Gregory David,2,0,30,28
1657468796154,MATH 10A,A02,083736,Patchell; Gregory David,20,0,30,10
1657468796154,MATH 10A,A03,083737,Patchell; Gregory David,16,0,30,14
1657468802189,MATH 10B,A01,083207,Lim; Seonhee,8,0,34,26
1657468802189,MATH 10B,A02,083208,Lim; Seonhee,9,0,35,26
1657468802189,MATH 10B,A03,093472,Lim; Seonhee,7,0,34,27
1657468802189,MATH 10B,B01,083739,Sinha; Shubham,12,0,30,18
1657468808212,MATH 18,A01,083743,Cinel; Cameron Alexander,7,0,30,23
1657468808212,MATH 18,A02,083744,Cinel; Cameron Alexander,17,0,30,13
1657468808212,MATH 18,A03,083745,Cinel; Cameron Alexander,9,0,30,21
1657468808212,MATH 18,B01,083748,Rideout; David Porter,5,0,37,32
1657468808212,MATH 18,B02,083749,Rideout; David Porter,5,0,36,31
1657468808212,MATH 18,B03,083750,Rideout; David Porter,3,0,37,34
1657468808212,MATH 18,B04,083751,Rideout; David Porter,6,0,36,30
1657468808212,MATH 18,B05,093473,Rideout; David Porter,6,0,36,30
1657468808212,MATH 18,B06,093474,Rideout; David Porter,6,0,36,30
1657468814235,MATH 20A,A01,083754,Zheng; Zequn,14,0,40,26
1657468820259,MATH 20B,A01,083756,Briones; Jor-el Thomas Caparas,4,0,36,32
1657468820259,MATH 20B,A02,083757,Briones; Jor-el Thomas Caparas,1,0,36,35
1657468820259,MATH 20B,A03,093475,Briones; Jor-el Thomas Caparas,2,0,36,34
1657468826281,MATH 20C,A01,083760,Briones; Jor-el Thomas Caparas,1,0,35,34
1657468826281,MATH 20C,A02,083761,Briones; Jor-el Thomas Caparas,8,0,35,27
1657468826281,MATH 20C,A03,093476,Briones; Jor-el Thomas Caparas,0,1,36,36
1657468826281,MATH 20C,B01,083762,Bach; Quang Tran,1,0,30,29
1657468832308,MATH 20D,A01,083765,Tran; Brian Kha,5,0,30,25
1657468832308,MATH 20D,A02,083766,Tran; Brian Kha,5,0,30,25
1657468832308,MATH 20D,A03,083767,Tran; Brian Kha,5,0,30,25
1657468838334,MATH 20E,A01,083771,Ganguly; Soumya,9,0,32,23
1657468838334,MATH 20E,A02,083772,Ganguly; Soumya,6,0,32,26
1657468838334,MATH 20E,B01,083773,Ciotti; Benjamin,20,0,35,15
1657468838334,MATH 20E,B02,083774,Ciotti; Benjamin,17,0,35,18
1657468844359,MATH 103A,A01,083777,Greenfeld; Be'Eri,3,0,36,33
1657468844359,MATH 103A,A02,083778,Greenfeld; Be'Eri,5,0,36,31
1657468844359,MATH 103A,A03,093561,Greenfeld; Be'Eri,5,0,36,31
1657468844359,MATH 103A,B01,083779,Greenfeld; Be'Eri,7,0,36,29
1657468844359,MATH 103A,B02,083780,Greenfeld; Be'Eri,4,0,36,32
1657468844359,MATH 103A,B03,093562,Greenfeld; Be'Eri,3,0,36,33
1657468850389,MATH 105,A01,085443,Carter; Anne Toulson,15,0,35,20
1657468850389,MATH 105,A02,093477,Carter; Anne Toulson,20,0,35,15
1657468856422,MATH 109,A01,083213,Ganzberger; Geoffrey Michael,2,0,34,32
1657468856422,MATH 109,A02,083214,Ganzberger; Geoffrey Michael,4,0,34,30
1657468856422,MATH 109,A03,093478,Ganzberger; Geoffrey Michael,2,0,34,32
1657468856422,MATH 109,B01,083215,Ganzberger; Geoffrey Michael,1,0,32,31
1657468856422,MATH 109,B02,083216,Ganzberger; Geoffrey Michael,2,0,32,30
1657468856422,MATH 109,B03,093479,Ganzberger; Geoffrey Michael,8,0,32,24
1657468862448,MATH 142A,A01,083219,Chow; Bennett,7,0,32,25
1657468862448,MATH 142A,A02,083220,Chow; Bennett,10,0,32,22
1657468862448,MATH 142A,A03,093480,Chow; Bennett,8,0,32,24
1657468862448,MATH 142A,B03,093481,Chow; Bennett,8,0,32,24
1657468862448,MATH 142A,B04,093558,Chow; Bennett,13,0,32,19
1657468862448,MATH 142A,B05,093559,Chow; Bennett,6,0,32,26
1657468868477,MATH 193A,A01,083224,Rotar; Vladimir,8,0,34,26
1657468868477,MATH 193A,A02,083225,Rotar; Vladimir,9,0,34,25
1657468868477,MATH 193A,A03,083781,Rotar; Vladimir,5,0,34,29
1657468868477,MATH 193A,A04,083782,Rotar; Vladimir,10,0,34,24
1657468868477,MATH 193A,A05,093482,Rotar; Vladimir,10,0,34,24
1657468874512,MATH 197,001,091859,McAuley; Julian John,9999,0,9999,0
1657468874512,MATH 197,002,095566,Kedlaya; Kiran S.,9997,0,9999,2
1657468874512,MATH 197,003,095567,Xiao; Ming,9999,0,9999,0
1657468874512,MATH 197,004,095571,Perols; Johan Lars,9998,0,9999,1
1657468881563,COGS 9,A01,083615,Shannon; Kyle Michael,9,0,75,66
1657468887586,COGS 11,A01,083617,Boyle; Mary E. T.,22,0,48,26
1657468893610,COGS 13,A01,083071,Bastos; Amalia Pinkusfeld,11,0,71,60
1657468899651,COGS 14A,A01,092681,Semenuks; Arturs,5,1,100,95
1657468905674,COGS 14B,A01,083073,Cheng; Tzu-Han,6,0,63,57
1657468911697,COGS 17,A01,092677,Semenuks; Arturs,6,0,81,75
1657468917723,COGS 100,A01,083619,Allen; Michael Gordon,17,0,70,53
1657468923750,COGS 101A,A01,083621,Davis; Joshua Daniel,9,0,68,59
1657468929777,COGS 101B,A01,091572,Allen; Michael Gordon,12,0,65,53
1657468935801,COGS 101C,A01,083625,Delgado; Tania,17,0,35,18
1657468941827,COGS 107A,A01,083627,Boyle; Mary E. T.,13,0,60,47
1657468947855,COGS 118A,A01,083075,Gupta; Anjum,21,0,76,55
1657468953879,CSE 3,A50,083646,Miranda; Gregory Joseph,24,0,50,26
1657468959908,CSE 8A,A50,083650,Miranda; Gregory Joseph,17,1,56,39
1657468965931,CSE 11,A01,083080,Cao; Yingjun,6,15,40,34
1657468971954,CSE 12,A01,083652,Krause-Levy; Sophia Louisa,28,1,120,92
1657468977981,CSE 15L,A01,083654,Morris; Justin Loren,9,0,50,41
1657468977981,CSE 15L,A02,083655,Morris; Justin Loren,9,0,50,41
1657468984005,CSE 20,A01,083657,Tran; Khoa Dang,39,0,80,41
1657468990029,CSE 21,A01,095574,Bach; Quang Tran,22,0,48,26
1657468996058,CSE 30,A01,083084,Eldon; John,5,0,80,75
1657468996058,CSE 30,B01,095061,Bhaskar; Nishant,9,0,50,41
1657469002081,CSE 100,A01,083659,Cao; Yingjun,5,4,70,65
1657469008108,CSE 134B,A01,083661,Powell; Thomas Allan,22,0,100,78
1657469014156,CSE 140,A01,083663,Gungor; Onat,15,0,85,70
1657469020179,CSE 140L,A01,083088,Eldon; John,21,0,100,79
1657469026207,CSE 175,A01,083665,Kumar; Rakesh,3,0,25,22
1657469032231,CSE 190,A00,092507,Dubnov; Shlomo,8,0,20,12
1657469038258,ECE 45,A01,083139,Congero; Spencer William,6,0,75,69
1657469044282,ECE 65,A50,083695,Saad; Andrew S,12,0,30,18
1657469044282,ECE 65,A51,095125,Saad; Andrew S,24,0,26,2
1657469050307,ECE 109,A01,091882,Touri; Behrouz,19,0,70,51
1657469056330,ECE 180,A00,083140,Abi Samra; Nicholas Camill,1,0,30,29
1657469056330,ECE 180,B00,083141,Abi Samra; Nicholas Camill,0,0,30,30
1657469062356,MATH 10A,A01,083735,Patchell; Gregory David,2,0,30,28
1657469062356,MATH 10A,A02,083736,Patchell; Gregory David,20,0,30,10
1657469062356,MATH 10A,A03,083737,Patchell; Gregory David,16,0,30,14
1657469068380,MATH 10B,A01,083207,Lim; Seonhee,8,0,34,26
1657469068380,MATH 10B,A02,083208,Lim; Seonhee,9,0,35,26
1657469068380,MATH 10B,A03,093472,Lim; Seonhee,7,0,34,27
1657469068380,MATH 10B,B01,083739,Sinha; Shubham,12,0,30,18
1657469074412,MATH 18,A01,083743,Cinel; Cameron Alexander,7,0,30,23
1657469074412,MATH 18,A02,083744,Cinel; Cameron Alexander,17,0,30,13
1657469074412,MATH 18,A03,083745,Cinel; Cameron Alexander,9,0,30,21
1657469074412,MATH 18,B01,083748,Rideout; David Porter,5,0,37,32
1657469074412,MATH 18,B02,083749,Rideout; David Porter,5,0,36,31
1657469074412,MATH 18,B03,083750,Rideout; David Porter,3,0,37,34
1657469074412,MATH 18,B04,083751,Rideout; David Porter,6,0,36,30
1657469074412,MATH 18,B05,093473,Rideout; David Porter,6,0,36,30
1657469074412,MATH 18,B06,093474,Rideout; David Porter,6,0,36,30
1657469080436,MATH 20A,A01,083754,Zheng; Zequn,14,0,40,26
1657469086531,MATH 20B,A01,083756,Briones; Jor-el Thomas Caparas,4,0,36,32
1657469086531,MATH 20B,A02,083757,Briones; Jor-el Thomas Caparas,1,0,36,35
1657469086531,MATH 20B,A03,093475,Briones; Jor-el Thomas Caparas,2,0,36,34
1657469092556,MATH 20C,A01,083760,Briones; Jor-el Thomas Caparas,1,0,35,34
1657469092556,MATH 20C,A02,083761,Briones; Jor-el Thomas Caparas,8,0,35,27
1657469092556,MATH 20C,A03,093476,Briones; Jor-el Thomas Caparas,0,1,36,36
1657469092556,MATH 20C,B01,083762,Bach; Quang Tran,1,0,30,29
1657469098585,MATH 20D,A01,083765,Tran; Brian Kha,5,0,30,25
1657469098585,MATH 20D,A02,083766,Tran; Brian Kha,5,0,30,25
1657469098585,MATH 20D,A03,083767,Tran; Brian Kha,5,0,30,25
1657469104608,MATH 20E,A01,083771,Ganguly; Soumya,9,0,32,23
1657469104608,MATH 20E,A02,083772,Ganguly; Soumya,6,0,32,26
1657469104608,MATH 20E,B01,083773,Ciotti; Benjamin,20,0,35,15
1657469104608,MATH 20E,B02,083774,Ciotti; Benjamin,17,0,35,18
1657469110636,MATH 103A,A01,083777,Greenfeld; Be'Eri,3,0,36,33
1657469110636,MATH 103A,A02,083778,Greenfeld; Be'Eri,5,0,36,31
1657469110636,MATH 103A,A03,093561,Greenfeld; Be'Eri,5,0,36,31
1657469110636,MATH 103A,B01,083779,Greenfeld; Be'Eri,7,0,36,29
1657469110636,MATH 103A,B02,083780,Greenfeld; Be'Eri,4,0,36,32
1657469110636,MATH 103A,B03,093562,Greenfeld; Be'Eri,3,0,36,33
1657469116662,MATH 105,A01,085443,Carter; Anne Toulson,15,0,35,20
1657469116662,MATH 105,A02,093477,Carter; Anne Toulson,20,0,35,15
1657469122693,MATH 109,A01,083213,Ganzberger; Geoffrey Michael,2,0,34,32
1657469122693,MATH 109,A02,083214,Ganzberger; Geoffrey Michael,4,0,34,30
1657469122693,MATH 109,A03,093478,Ganzberger; Geoffrey Michael,2,0,34,32
1657469122693,MATH 109,B01,083215,Ganzberger; Geoffrey Michael,1,0,32,31
1657469122693,MATH 109,B02,083216,Ganzberger; Geoffrey Michael,2,0,32,30
1657469122693,MATH 109,B03,093479,Ganzberger; Geoffrey Michael,8,0,32,24
1657469128724,MATH 142A,A01,083219,Chow; Bennett,7,0,32,25
1657469128724,MATH 142A,A02,083220,Chow; Bennett,10,0,32,22
1657469128724,MATH 142A,A03,093480,Chow; Bennett,8,0,32,24
1657469128724,MATH 142A,B03,093481,Chow; Bennett,8,0,32,24
1657469128724,MATH 142A,B04,093558,Chow; Bennett,13,0,32,19
1657469128724,MATH 142A,B05,093559,Chow; Bennett,6,0,32,26
1657469134753,MATH 193A,A01,083224,Rotar; Vladimir,8,0,34,26
1657469134753,MATH 193A,A02,083225,Rotar; Vladimir,9,0,34,25
1657469134753,MATH 193A,A03,083781,Rotar; Vladimir,5,0,34,29
1657469134753,MATH 193A,A04,083782,Rotar; Vladimir,10,0,34,24
1657469134753,MATH 193A,A05,093482,Rotar; Vladimir,10,0,34,24
1657469140780,MATH 197,001,091859,McAuley; Julian John,9999,0,9999,0
1657469140780,MATH 197,002,095566,Kedlaya; Kiran S.,9997,0,9999,2
1657469140780,MATH 197,003,095567,Xiao; Ming,9999,0,9999,0
1657469140780,MATH 197,004,095571,Perols; Johan Lars,9998,0,9999,1
1657469147839,COGS 9,A01,083615,Shannon; Kyle Michael,9,0,75,66
1657469153866,COGS 11,A01,083617,Boyle; Mary E. T.,22,0,48,26
1657469159888,COGS 13,A01,083071,Bastos; Amalia Pinkusfeld,11,0,71,60
1657469165912,COGS 14A,A01,092681,Semenuks; Arturs,5,1,100,95
1657469171934,COGS 14B,A01,083073,Cheng; Tzu-Han,6,0,63,57
1657469177959,COGS 17,A01,092677,Semenuks; Arturs,6,0,81,75
1657469183982,COGS 100,A01,083619,Allen; Michael Gordon,17,0,70,53
1657469190010,COGS 101A,A01,083621,Davis; Joshua Daniel,9,0,68,59
1657469196033,COGS 101B,A01,091572,Allen; Michael Gordon,12,0,65,53
1657469202057,COGS 101C,A01,083625,Delgado; Tania,17,0,35,18
1657469208085,COGS 107A,A01,083627,Boyle; Mary E. T.,13,0,60,47
1657469214107,COGS 118A,A01,083075,Gupta; Anjum,21,0,76,55
1657469220131,CSE 3,A50,083646,Miranda; Gregory Joseph,24,0,50,26
1657469226155,CSE 8A,A50,083650,Miranda; Gregory Joseph,17,1,56,39
1657469232177,CSE 11,A01,083080,Cao; Yingjun,6,15,40,34
1657469238206,CSE 12,A01,083652,Krause-Levy; Sophia Louisa,28,1,120,92
1657469244228,CSE 15L,A01,083654,Morris; Justin Loren,9,0,50,41
1657469244228,CSE 15L,A02,083655,Morris; Justin Loren,9,0,50,41
1657469250252,CSE 20,A01,083657,Tran; Khoa Dang,39,0,80,41
1657469256279,CSE 21,A01,095574,Bach; Quang Tran,22,0,48,26
1657469262303,CSE 30,A01,083084,Eldon; John,5,0,80,75
1657469262303,CSE 30,B01,095061,Bhaskar; Nishant,9,0,50,41
1657469268326,CSE 100,A01,083659,Cao; Yingjun,5,4,70,65
1657469274359,CSE 134B,A01,083661,Powell; Thomas Allan,22,0,100,78
1657469280384,CSE 140,A01,083663,Gungor; Onat,15,0,85,70
1657469286408,CSE 140L,A01,083088,Eldon; John,21,0,100,79
1657469292430,CSE 175,A01,083665,Kumar; Rakesh,3,0,25,22
1657469298454,CSE 190,A00,092507,Dubnov; Shlomo,8,0,20,12
1657469304485,ECE 45,A01,083139,Congero; Spencer William,6,0,75,69
1657469310511,ECE 65,A50,083695,Saad; Andrew S,12,0,30,18
1657469310511,ECE 65,A51,095125,Saad; Andrew S,24,0,26,2
1657469316535,ECE 109,A01,091882,Touri; Behrouz,19,0,70,51
1657469322558,ECE 180,A00,083140,Abi Samra; Nicholas Camill,1,0,30,29
1657469322558,ECE 180,B00,083141,Abi Samra; Nicholas Camill,0,0,30,30
1657469328584,MATH 10A,A01,083735,Patchell; Gregory David,2,0,30,28
1657469328584,MATH 10A,A02,083736,Patchell; Gregory David,20,0,30,10
1657469328584,MATH 10A,A03,083737,Patchell; Gregory David,16,0,30,14
1657469334607,MATH 10B,A01,083207,Lim; Seonhee,8,0,34,26
1657469334607,MATH 10B,A02,083208,Lim; Seonhee,9,0,35,26
1657469334607,MATH 10B,A03,093472,Lim; Seonhee,7,0,34,27
1657469334607,MATH 10B,B01,083739,Sinha; Shubham,12,0,30,18
1657469340635,MATH 18,A01,083743,Cinel; Cameron Alexander,7,0,30,23
1657469340635,MATH 18,A02,083744,Cinel; Cameron Alexander,17,0,30,13
1657469340635,MATH 18,A03,083745,Cinel; Cameron Alexander,9,0,30,21
1657469340635,MATH 18,B01,083748,Rideout; David Porter,5,0,37,32
1657469340635,MATH 18,B02,083749,Rideout; David Porter,5,0,36,31
1657469340635,MATH 18,B03,083750,Rideout; David Porter,3,0,37,34
1657469340635,MATH 18,B04,083751,Rideout; David Porter,6,0,36,30
1657469340635,MATH 18,B05,093473,Rideout; David Porter,6,0,36,30
1657469340635,MATH 18,B06,093474,Rideout; David Porter,6,0,36,30
1657469346664,MATH 20A,A01,083754,Zheng; Zequn,14,0,40,26
1657469352686,MATH 20B,A01,083756,Briones; Jor-el Thomas Caparas,4,0,36,32
1657469352686,MATH 20B,A02,083757,Briones; Jor-el Thomas Caparas,1,0,36,35
1657469352686,MATH 20B,A03,093475,Briones; Jor-el Thomas Caparas,2,0,36,34
1657469358732,MATH 20C,A01,083760,Briones; Jor-el Thomas Caparas,1,0,35,34
1657469358732,MATH 20C,A02,083761,Briones; Jor-el Thomas Caparas,8,0,35,27
1657469358732,MATH 20C,A03,093476,Briones; Jor-el Thomas Caparas,0,1,36,36
1657469358732,MATH 20C,B01,083762,Bach; Quang Tran,1,0,30,29
1657469364755,MATH 20D,A01,083765,Tran; Brian Kha,5,0,30,25
1657469364755,MATH 20D,A02,083766,Tran; Brian Kha,5,0,30,25
1657469364755,MATH 20D,A03,083767,Tran; Brian Kha,5,0,30,25
1657469370777,MATH 20E,A01,083771,Ganguly; Soumya,9,0,32,23
1657469370777,MATH 20E,A02,083772,Ganguly; Soumya,6,0,32,26
1657469370777,MATH 20E,B01,083773,Ciotti; Benjamin,20,0,35,15
1657469370777,MATH 20E,B02,083774,Ciotti; Benjamin,17,0,35,18
1657469376801,MATH 103A,A01,083777,Greenfeld; Be'Eri,3,0,36,33
1657469376801,MATH 103A,A02,083778,Greenfeld; Be'Eri,5,0,36,31
1657469376801,MATH 103A,A03,093561,Greenfeld; Be'Eri,5,0,36,31
1657469376801,MATH 103A,B01,083779,Greenfeld; Be'Eri,7,0,36,29
1657469376801,MATH 103A,B02,083780,Greenfeld; Be'Eri,4,0,36,32
1657469376801,MATH 103A,B03,093562,Greenfeld; Be'Eri,3,0,36,33
1657469382825,MATH 105,A01,085443,Carter; Anne Toulson,15,0,35,20
1657469382825,MATH 105,A02,093477,Carter; Anne Toulson,20,0,35,15
1657469388848,MATH 109,A01,083213,Ganzberger; Geoffrey Michael,2,0,34,32
1657469388848,MATH 109,A02,083214,Ganzberger; Geoffrey Michael,4,0,34,30
1657469388848,MATH 109,A03,093478,Ganzberger; Geoffrey Michael,2,0,34,32
1657469388848,MATH 109,B01,083215,Ganzberger; Geoffrey Michael,1,0,32,31
1657469388848,MATH 109,B02,083216,Ganzberger; Geoffrey Michael,2,0,32,30
1657469388848,MATH 109,B03,093479,Ganzberger; Geoffrey Michael,8,0,32,24
1657469394873,MATH 142A,A01,083219,Chow; Bennett,7,0,32,25
1657469394873,MATH 142A,A02,083220,Chow; Bennett,10,0,32,22
1657469394873,MATH 142A,A03,093480,Chow; Bennett,8,0,32,24
1657469394873,MATH 142A,B03,093481,Chow; Bennett,8,0,32,24
1657469394873,MATH 142A,B04,093558,Chow; Bennett,13,0,32,19
1657469394873,MATH 142A,B05,093559,Chow; Bennett,6,0,32,26
1657469400898,MATH 193A,A01,083224,Rotar; Vladimir,8,0,34,26
1657469400898,MATH 193A,A02,083225,Rotar; Vladimir,9,0,34,25
1657469400898,MATH 193A,A03,083781,Rotar; Vladimir,5,0,34,29
1657469400898,MATH 193A,A04,083782,Rotar; Vladimir,10,0,34,24
1657469400898,MATH 193A,A05,093482,Rotar; Vladimir,10,0,34,24
1657469406920,MATH 197,001,091859,McAuley; Julian John,9999,0,9999,0
1657469406920,MATH 197,002,095566,Kedlaya; Kiran S.,9997,0,9999,2
1657469406920,MATH 197,003,095567,Xiao; Ming,9999,0,9999,0
1657469406920,MATH 197,004,095571,Perols; Johan Lars,9998,0,9999,1
1657469413971,COGS 9,A01,083615,Shannon; Kyle Michael,9,0,75,66
1657469419995,COGS 11,A01,083617,Boyle; Mary E. T.,22,0,48,26
1657469426017,COGS 13,A01,083071,Bastos; Amalia Pinkusfeld,11,0,71,60
1657469432044,COGS 14A,A01,092681,Semenuks; Arturs,5,1,100,95
1657469438068,COGS 14B,A01,083073,Cheng; Tzu-Han,6,0,63,57
1657469444096,COGS 17,A01,092677,Semenuks; Arturs,6,0,81,75
1657469450119,COGS 100,A01,083619,Allen; Michael Gordon,17,0,70,53
1657469456142,COGS 101A,A01,083621,Davis; Joshua Daniel,9,0,68,59
1657469462165,COGS 101B,A01,091572,Allen; Michael Gordon,12,0,65,53
1657469468192,COGS 101C,A01,083625,Delgado; Tania,17,0,35,18
1657469474218,COGS 107A,A01,083627,Boyle; Mary E. T.,13,0,60,47
1657469480241,COGS 118A,A01,083075,Gupta; Anjum,21,0,76,55
1657469486265,CSE 3,A50,083646,Miranda; Gregory Joseph,24,0,50,26
1657469492291,CSE 8A,A50,083650,Miranda; Gregory Joseph,17,1,56,39
1657469498313,CSE 11,A01,083080,Cao; Yingjun,6,15,40,34
1657469504336,CSE 12,A01,083652,Krause-Levy; Sophia Louisa,28,1,120,92
1657469510358,CSE 15L,A01,083654,Morris; Justin Loren,9,0,50,41
1657469510358,CSE 15L,A02,083655,Morris; Justin Loren,9,0,50,41
1657469516383,CSE 20,A01,083657,Tran; Khoa Dang,39,0,80,41
1657469522408,CSE 21,A01,095574,Bach; Quang Tran,22,0,48,26
1657469528430,CSE 30,A01,083084,Eldon; John,5,0,80,75
1657469528430,CSE 30,B01,095061,Bhaskar; Nishant,9,0,50,41
1657469534454,CSE 100,A01,083659,Cao; Yingjun,5,4,70,65
1657469540480,CSE 134B,A01,083661,Powell; Thomas Allan,22,0,100,78
1657469546503,CSE 140,A01,083663,Gungor; Onat,15,0,85,70
1657469552526,CSE 140L,A01,083088,Eldon; John,21,0,100,79
1657469558551,CSE 175,A01,083665,Kumar; Rakesh,3,0,25,22
1657469564578,CSE 190,A00,092507,Dubnov; Shlomo,8,0,20,12
1657469570605,ECE 45,A01,083139,Congero; Spencer William,6,0,75,69
1657469576627,ECE 65,A50,083695,Saad; Andrew S,12,0,30,18
1657469576627,ECE 65,A51,095125,Saad; Andrew S,24,0,26,2
1657469582651,ECE 109,A01,091882,Touri; Behrouz,19,0,70,51
1657469588680,ECE 180,A00,083140,Abi Samra; Nicholas Camill,1,0,30,29
1657469588680,ECE 180,B00,083141,Abi Samra; Nicholas Camill,0,0,30,30
1657469594703,MATH 10A,A01,083735,Patchell; Gregory David,2,0,30,28
1657469594703,MATH 10A,A02,083736,Patchell; Gregory David,20,0,30,10
1657469594703,MATH 10A,A03,083737,Patchell; Gregory David,16,0,30,14
1657469600732,MATH 10B,A01,083207,Lim; Seonhee,8,0,34,26
1657469600732,MATH 10B,A02,083208,Lim; Seonhee,9,0,35,26
1657469600732,MATH 10B,A03,093472,Lim; Seonhee,7,0,34,27
1657469600732,MATH 10B,B01,083739,Sinha; Shubham,12,0,30,18
1657469606757,MATH 18,A01,083743,Cinel; Cameron Alexander,7,0,30,23
1657469606757,MATH 18,A02,083744,Cinel; Cameron Alexander,17,0,30,13
1657469606757,MATH 18,A03,083745,Cinel; Cameron Alexander,9,0,30,21
1657469606757,MATH 18,B01,083748,Rideout; David Porter,5,0,37,32
1657469606757,MATH 18,B02,083749,Rideout; David Porter,5,0,36,31
1657469606757,MATH 18,B03,083750,Rideout; David Porter,3,0,37,34
1657469606757,MATH 18,B04,083751,Rideout; David Porter,6,0,36,30
1657469606757,MATH 18,B05,093473,Rideout; David Porter,6,0,36,30
1657469606757,MATH 18,B06,093474,Rideout; David Porter,6,0,36,30
1657469612782,MATH 20A,A01,083754,Zheng; Zequn,14,0,40,26
1657469618814,MATH 20B,A01,083756,Briones; Jor-el Thomas Caparas,4,0,36,32
1657469618814,MATH 20B,A02,083757,Briones; Jor-el Thomas Caparas,1,0,36,35
1657469618814,MATH 20B,A03,093475,Briones; Jor-el Thomas Caparas,2,0,36,34
1657469624841,MATH 20C,A01,083760,Briones; Jor-el Thomas Caparas,1,0,35,34
1657469624841,MATH 20C,A02,083761,Briones; Jor-el Thomas Caparas,8,0,35,27
1657469624841,MATH 20C,A03,093476,Briones; Jor-el Thomas Caparas,0,1,36,36
1657469624841,MATH 20C,B01,083762,Bach; Quang Tran,1,0,30,29
1657469630867,MATH 20D,A01,083765,Tran; Brian Kha,5,0,30,25
1657469630867,MATH 20D,A02,083766,Tran; Brian Kha,5,0,30,25
1657469630867,MATH 20D,A03,083767,Tran; Brian Kha,5,0,30,25
1657469636892,MATH 20E,A01,083771,Ganguly; Soumya,9,0,32,23
1657469636892,MATH 20E,A02,083772,Ganguly; Soumya,6,0,32,26
1657469636892,MATH 20E,B01,083773,Ciotti; Benjamin,20,0,35,15
1657469636892,MATH 20E,B02,083774,Ciotti; Benjamin,17,0,35,18
1657469642924,MATH 103A,A01,083777,Greenfeld; Be'Eri,3,0,36,33
1657469642924,MATH 103A,A02,083778,Greenfeld; Be'Eri,5,0,36,31
1657469642924,MATH 103A,A03,093561,Greenfeld; Be'Eri,5,0,36,31
1657469642924,MATH 103A,B01,083779,Greenfeld; Be'Eri,7,0,36,29
1657469642924,MATH 103A,B02,083780,Greenfeld; Be'Eri,4,0,36,32
1657469642924,MATH 103A,B03,093562,Greenfeld; Be'Eri,3,0,36,33
1657469648946,MATH 105,A01,085443,Carter; Anne Toulson,15,0,35,20
1657469648946,MATH 105,A02,093477,Carter; Anne Toulson,20,0,35,15
1657469654971,MATH 109,A01,083213,Ganzberger; Geoffrey Michael,2,0,34,32
1657469654971,MATH 109,A02,083214,Ganzberger; Geoffrey Michael,4,0,34,30
1657469654971,MATH 109,A03,093478,Ganzberger; Geoffrey Michael,2,0,34,32
1657469654971,MATH 109,B01,083215,Ganzberger; Geoffrey Michael,1,0,32,31
1657469654971,MATH 109,B02,083216,Ganzberger; Geoffrey Michael,2,0,32,30
1657469654971,MATH 109,B03,093479,Ganzberger; Geoffrey Michael,8,0,32,24
1657469660995,MATH 142A,A01,083219,Chow; Bennett,7,0,32,25
1657469660995,MATH 142A,A02,083220,Chow; Bennett,10,0,32,22
1657469660995,MATH 142A,A03,093480,Chow; Bennett,8,0,32,24
1657469660995,MATH 142A,B03,093481,Chow; Bennett,8,0,32,24
1657469660995,MATH 142A,B04,093558,Chow; Bennett,13,0,32,19
1657469660995,MATH 142A,B05,093559,Chow; Bennett,6,0,32,26
1657469667023,MATH 193A,A01,083224,Rotar; Vladimir,8,0,34,26
1657469667023,MATH 193A,A02,083225,Rotar; Vladimir,9,0,34,25
1657469667023,MATH 193A,A03,083781,Rotar; Vladimir,5,0,34,29
1657469667023,MATH 193A,A04,083782,Rotar; Vladimir,10,0,34,24
1657469667023,MATH 193A,A05,093482,Rotar; Vladimir,10,0,34,24
1657469673051,MATH 197,001,091859,McAuley; Julian John,9999,0,9999,0
1657469673051,MATH 197,002,095566,Kedlaya; Kiran S.,9997,0,9999,2
1657469673051,MATH 197,003,095567,Xiao; Ming,9999,0,9999,0
1657469673051,MATH 197,004,095571,Perols; Johan Lars,9998,0,9999,1
1657469680188,COGS 9,A01,083615,Shannon; Kyle Michael,9,0,75,66
1657469686211,COGS 11,A01,083617,Boyle; Mary E. T.,22,0,48,26
1657469692234,COGS 13,A01,083071,Bastos; Amalia Pinkusfeld,11,0,71,60
1657469698260,COGS 14A,A01,092681,Semenuks; Arturs,5,1,100,95
1657469704287,COGS 14B,A01,083073,Cheng; Tzu-Han,6,0,63,57
1657469710313,COGS 17,A01,092677,Semenuks; Arturs,6,0,81,75
1657469716340,COGS 100,A01,083619,Allen; Michael Gordon,17,0,70,53
1657469722363,COGS 101A,A01,083621,Davis; Joshua Daniel,9,0,68,59
1657469728386,COGS 101B,A01,091572,Allen; Michael Gordon,12,0,65,53
1657469734409,COGS 101C,A01,083625,Delgado; Tania,17,0,35,18
1657469740432,COGS 107A,A01,083627,Boyle; Mary E. T.,13,0,60,47
1657469746463,COGS 118A,A01,083075,Gupta; Anjum,21,0,76,55
1657469752485,CSE 3,A50,083646,Miranda; Gregory Joseph,24,0,50,26
1657469758511,CSE 8A,A50,083650,Miranda; Gregory Joseph,17,1,56,39
1657469764535,CSE 11,A01,083080,Cao; Yingjun,6,15,40,34
1657469770562,CSE 12,A01,083652,Krause-Levy; Sophia Louisa,28,1,120,92
1657469776588,CSE 15L,A01,083654,Morris; Justin Loren,9,0,50,41
1657469776588,CSE 15L,A02,083655,Morris; Justin Loren,9,0,50,41
1657469782610,CSE 20,A01,083657,Tran; Khoa Dang,39,0,80,41
1657469788635,CSE 21,A01,095574,Bach; Quang Tran,22,0,48,26
1657469794659,CSE 30,A01,083084,Eldon; John,5,0,80,75
1657469794659,CSE 30,B01,095061,Bhaskar; Nishant,9,0,50,41
1657469800682,CSE 100,A01,083659,Cao; Yingjun,5,4,70,65
1657469806704,CSE 134B,A01,083661,Powell; Thomas Allan,22,0,100,78
1657469812725,CSE 140,A01,083663,Gungor; Onat,15,0,85,70
1657469818751,CSE 140L,A01,083088,Eldon; John,21,0,100,79
1657469824773,CSE 175,A01,083665,Kumar; Rakesh,3,0,25,22
1657469830795,CSE 190,A00,092507,Dubnov; Shlomo,8,0,20,12
1657469836821,ECE 45,A01,083139,Congero; Spencer William,6,0,75,69
1657469842848,ECE 65,A50,083695,Saad; Andrew S,12,0,30,18
1657469842848,ECE 65,A51,095125,Saad; Andrew S,24,0,26,2
1657469848873,ECE 109,A01,091882,Touri; Behrouz,19,0,70,51
1657469854902,ECE 180,A00,083140,Abi Samra; Nicholas Camill,1,0,30,29
1657469854902,ECE 180,B00,083141,Abi Samra; Nicholas Camill,0,0,30,30
1657469860932,MATH 10A,A01,083735,Patchell; Gregory David,2,0,30,28
1657469860932,MATH 10A,A02,083736,Patchell; Gregory David,20,0,30,10
1657469860932,MATH 10A,A03,083737,Patchell; Gregory David,16,0,30,14
1657469866954,MATH 10B,A01,083207,Lim; Seonhee,8,0,34,26
1657469866954,MATH 10B,A02,083208,Lim; Seonhee,9,0,35,26
1657469866954,MATH 10B,A03,093472,Lim; Seonhee,7,0,34,27
1657469866954,MATH 10B,B01,083739,Sinha; Shubham,12,0,30,18
1657469872985,MATH 18,A01,083743,Cinel; Cameron Alexander,7,0,30,23
1657469872985,MATH 18,A02,083744,Cinel; Cameron Alexander,17,0,30,13
1657469872985,MATH 18,A03,083745,Cinel; Cameron Alexander,9,0,30,21
1657469872985,MATH 18,B01,083748,Rideout; David Porter,5,0,37,32
1657469872985,MATH 18,B02,083749,Rideout; David Porter,5,0,36,31
1657469872985,MATH 18,B03,083750,Rideout; David Porter,3,0,37,34
1657469872985,MATH 18,B04,083751,Rideout; David Porter,6,0,36,30
1657469872985,MATH 18,B05,093473,Rideout; David Porter,6,0,36,30
1657469872985,MATH 18,B06,093474,Rideout; David Porter,6,0,36,30
1657469879008,MATH 20A,A01,083754,Zheng; Zequn,14,0,40,26
1657469885032,MATH 20B,A01,083756,Briones; Jor-el Thomas Caparas,4,0,36,32
1657469885032,MATH 20B,A02,083757,Briones; Jor-el Thomas Caparas,1,0,36,35
1657469885032,MATH 20B,A03,093475,Briones; Jor-el Thomas Caparas,2,0,36,34
1657469891056,MATH 20C,A01,083760,Briones; Jor-el Thomas Caparas,1,0,35,34
1657469891056,MATH 20C,A02,083761,Briones; Jor-el Thomas Caparas,8,0,35,27
1657469891056,MATH 20C,A03,093476,Briones; Jor-el Thomas Caparas,0,1,36,36
1657469891056,MATH 20C,B01,083762,Bach; Quang Tran,1,0,30,29
1657469897093,MATH 20D,A01,083765,Tran; Brian Kha,5,0,30,25
1657469897093,MATH 20D,A02,083766,Tran; Brian Kha,5,0,30,25
1657469897093,MATH 20D,A03,083767,Tran; Brian Kha,5,0,30,25
1657469903121,MATH 20E,A01,083771,Ganguly; Soumya,9,0,32,23
1657469903121,MATH 20E,A02,083772,Ganguly; Soumya,6,0,32,26
1657469903121,MATH 20E,B01,083773,Ciotti; Benjamin,20,0,35,15
1657469903121,MATH 20E,B02,083774,Ciotti; Benjamin,17,0,35,18
1657469909145,MATH 103A,A01,083777,Greenfeld; Be'Eri,3,0,36,33
1657469909145,MATH 103A,A02,083778,Greenfeld; Be'Eri,5,0,36,31
1657469909145,MATH 103A,A03,093561,Greenfeld; Be'Eri,5,0,36,31
1657469909145,MATH 103A,B01,083779,Greenfeld; Be'Eri,7,0,36,29
1657469909145,MATH 103A,B02,083780,Greenfeld; Be'Eri,4,0,36,32
1657469909145,MATH 103A,B03,093562,Greenfeld; Be'Eri,3,0,36,33
1657469915168,MATH 105,A01,085443,Carter; Anne Toulson,15,0,35,20
1657469915168,MATH 105,A02,093477,Carter; Anne Toulson,20,0,35,15
1657469921196,MATH 109,A01,083213,Ganzberger; Geoffrey Michael,2,0,34,32
1657469921196,MATH 109,A02,083214,Ganzberger; Geoffrey Michael,4,0,34,30
1657469921196,MATH 109,A03,093478,Ganzberger; Geoffrey Michael,2,0,34,32
1657469921196,MATH 109,B01,083215,Ganzberger; Geoffrey Michael,1,0,32,31
1657469921196,MATH 109,B02,083216,Ganzberger; Geoffrey Michael,2,0,32,30
1657469921196,MATH 109,B03,093479,Ganzberger; Geoffrey Michael,8,0,32,24
1657469927225,MATH 142A,A01,083219,Chow; Bennett,7,0,32,25
1657469927225,MATH 142A,A02,083220,Chow; Bennett,10,0,32,22
1657469927225,MATH 142A,A03,093480,Chow; Bennett,8,0,32,24
1657469927225,MATH 142A,B03,093481,Chow; Bennett,8,0,32,24
1657469927225,MATH 142A,B04,093558,Chow; Bennett,13,0,32,19
1657469927225,MATH 142A,B05,093559,Chow; Bennett,6,0,32,26
1657469933248,MATH 193A,A01,083224,Rotar; Vladimir,8,0,34,26
1657469933248,MATH 193A,A02,083225,Rotar; Vladimir,9,0,34,25
1657469933248,MATH 193A,A03,083781,Rotar; Vladimir,5,0,34,29
1657469933248,MATH 193A,A04,083782,Rotar; Vladimir,10,0,34,24
1657469933248,MATH 193A,A05,093482,Rotar; Vladimir,10,0,34,24
1657469939270,MATH 197,001,091859,McAuley; Julian John,9999,0,9999,0
1657469939270,MATH 197,002,095566,Kedlaya; Kiran S.,9997,0,9999,2
1657469939270,MATH 197,003,095567,Xiao; Ming,9999,0,9999,0
1657469939270,MATH 197,004,095571,Perols; Johan Lars,9998,0,9999,1
1657469946323,COGS 9,A01,083615,Shannon; Kyle Michael,9,0,75,66
1657469952347,COGS 11,A01,083617,Boyle; Mary E. T.,22,0,48,26
1657469958369,COGS 13,A01,083071,Bastos; Amalia Pinkusfeld,11,0,71,60
1657469964397,COGS 14A,A01,092681,Semenuks; Arturs,5,1,100,95
1657469970420,COGS 14B,A01,083073,Cheng; Tzu-Han,6,0,63,57
1657469976442,COGS 17,A01,092677,Semenuks; Arturs,6,0,81,75
1657469982468,COGS 100,A01,083619,Allen; Michael Gordon,17,0,70,53
1657469988491,COGS 101A,A01,083621,Davis; Joshua Daniel,9,0,68,59
1657469994514,COGS 101B,A01,091572,Allen; Michael Gordon,12,0,65,53
1657470000538,COGS 101C,A01,083625,Delgado; Tania,17,0,35,18
1657470006565,COGS 107A,A01,083627,Boyle; Mary E. T.,13,0,60,47
1657470012591,COGS 118A,A01,083075,Gupta; Anjum,21,0,76,55
1657470018620,CSE 3,A50,083646,Miranda; Gregory Joseph,24,0,50,26
1657470024644,CSE 8A,A50,083650,Miranda; Gregory Joseph,17,1,56,39
1657470030667,CSE 11,A01,083080,Cao; Yingjun,6,15,40,34
1657470036694,CSE 12,A01,083652,Krause-Levy; Sophia Louisa,28,1,120,92
1657470042721,CSE 15L,A01,083654,Morris; Justin Loren,9,0,50,41
1657470042721,CSE 15L,A02,083655,Morris; Justin Loren,9,0,50,41
1657470048748,CSE 20,A01,083657,Tran; Khoa Dang,39,0,80,41
1657470054772,CSE 21,A01,095574,Bach; Quang Tran,22,0,48,26
1657470060799,CSE 30,A01,083084,Eldon; John,5,0,80,75
1657470060799,CSE 30,B01,095061,Bhaskar; Nishant,9,0,50,41
1657470066823,CSE 100,A01,083659,Cao; Yingjun,5,4,70,65
1657470072851,CSE 134B,A01,083661,Powell; Thomas Allan,22,0,100,78
1657470078879,CSE 140,A01,083663,Gungor; Onat,15,0,85,70
1657470084903,CSE 140L,A01,083088,Eldon; John,21,0,100,79
1657470090931,CSE 175,A01,083665,Kumar; Rakesh,3,0,25,22
1657470096952,CSE 190,A00,092507,Dubnov; Shlomo,8,0,20,12
1657470102975,ECE 45,A01,083139,Congero; Spencer William,6,0,75,69
1657470109011,ECE 65,A50,083695,Saad; Andrew S,12,0,30,18
1657470109011,ECE 65,A51,095125,Saad; Andrew S,24,0,26,2
1657470115034,ECE 109,A01,091882,Touri; Behrouz,19,0,70,51
1657470121059,ECE 180,A00,083140,Abi Samra; Nicholas Camill,1,0,30,29
1657470121059,ECE 180,B00,083141,Abi Samra; Nicholas Camill,0,0,30,30
1657470127088,MATH 10A,A01,083735,Patchell; Gregory David,2,0,30,28
1657470127088,MATH 10A,A02,083736,Patchell; Gregory David,20,0,30,10
1657470127088,MATH 10A,A03,083737,Patchell; Gregory David,16,0,30,14
1657470133113,MATH 10B,A01,083207,Lim; Seonhee,8,0,34,26
1657470133113,MATH 10B,A02,083208,Lim; Seonhee,9,0,35,26
1657470133113,MATH 10B,A03,093472,Lim; Seonhee,7,0,34,27
1657470133113,MATH 10B,B01,083739,Sinha; Shubham,12,0,30,18
1657470139146,MATH 18,A01,083743,Cinel; Cameron Alexander,7,0,30,23
1657470139146,MATH 18,A02,083744,Cinel; Cameron Alexander,17,0,30,13
1657470139146,MATH 18,A03,083745,Cinel; Cameron Alexander,9,0,30,21
1657470139146,MATH 18,B01,083748,Rideout; David Porter,5,0,37,32
1657470139146,MATH 18,B02,083749,Rideout; David Porter,5,0,36,31
1657470139146,MATH 18,B03,083750,Rideout; David Porter,3,0,37,34
1657470139146,MATH 18,B04,083751,Rideout; David Porter,6,0,36,30
1657470139146,MATH 18,B05,093473,Rideout; David Porter,6,0,36,30
1657470139146,MATH 18,B06,093474,Rideout; David Porter,6,0,36,30
1657470145169,MATH 20A,A01,083754,Zheng; Zequn,14,0,40,26
1657470151194,MATH 20B,A01,083756,Briones; Jor-el Thomas Caparas,4,0,36,32
1657470151194,MATH 20B,A02,083757,Briones; Jor-el Thomas Caparas,1,0,36,35
1657470151194,MATH 20B,A03,093475,Briones; Jor-el Thomas Caparas,2,0,36,34
1657470157218,MATH 20C,A01,083760,Briones; Jor-el Thomas Caparas,1,0,35,34
1657470157218,MATH 20C,A02,083761,Briones; Jor-el Thomas Caparas,8,0,35,27
1657470157218,MATH 20C,A03,093476,Briones; Jor-el Thomas Caparas,0,1,36,36
1657470157218,MATH 20C,B01,083762,Bach; Quang Tran,1,0,30,29
1657470163243,MATH 20D,A01,083765,Tran; Brian Kha,5,0,30,25
1657470163243,MATH 20D,A02,083766,Tran; Brian Kha,5,0,30,25
1657470163243,MATH 20D,A03,083767,Tran; Brian Kha,5,0,30,25
1657470169266,MATH 20E,A01,083771,Ganguly; Soumya,9,0,32,23
1657470169266,MATH 20E,A02,083772,Ganguly; Soumya,6,0,32,26
1657470169266,MATH 20E,B01,083773,Ciotti; Benjamin,20,0,35,15
1657470169266,MATH 20E,B02,083774,Ciotti; Benjamin,17,0,35,18
1657470175289,MATH 103A,A01,083777,Greenfeld; Be'Eri,3,0,36,33
1657470175289,MATH 103A,A02,083778,Greenfeld; Be'Eri,5,0,36,31
1657470175289,MATH 103A,A03,093561,Greenfeld; Be'Eri,5,0,36,31
1657470175289,MATH 103A,B01,083779,Greenfeld; Be'Eri,7,0,36,29
1657470175289,MATH 103A,B02,083780,Greenfeld; Be'Eri,4,0,36,32
1657470175289,MATH 103A,B03,093562,Greenfeld; Be'Eri,3,0,36,33
1657470181313,MATH 105,A01,085443,Carter; Anne Toulson,15,0,35,20
1657470181313,MATH 105,A02,093477,Carter; Anne Toulson,20,0,35,15
1657470187342,MATH 109,A01,083213,Ganzberger; Geoffrey Michael,2,0,34,32
1657470187342,MATH 109,A02,083214,Ganzberger; Geoffrey Michael,4,0,34,30
1657470187342,MATH 109,A03,093478,Ganzberger; Geoffrey Michael,2,0,34,32
1657470187342,MATH 109,B01,083215,Ganzberger; Geoffrey Michael,1,0,32,31
1657470187342,MATH 109,B02,083216,Ganzberger; Geoffrey Michael,2,0,32,30
1657470187342,MATH 109,B03,093479,Ganzberger; Geoffrey Michael,8,0,32,24
1657470193366,MATH 142A,A01,083219,Chow; Bennett,7,0,32,25
1657470193366,MATH 142A,A02,083220,Chow; Bennett,10,0,32,22
1657470193366,MATH 142A,A03,093480,Chow; Bennett,8,0,32,24
1657470193366,MATH 142A,B03,093481,Chow; Bennett,8,0,32,24
1657470193366,MATH 142A,B04,093558,Chow; Bennett,13,0,32,19
1657470193366,MATH 142A,B05,093559,Chow; Bennett,6,0,32,26
1657470199392,MATH 193A,A01,083224,Rotar; Vladimir,8,0,34,26
1657470199392,MATH 193A,A02,083225,Rotar; Vladimir,9,0,34,25
1657470199392,MATH 193A,A03,083781,Rotar; Vladimir,5,0,34,29
1657470199392,MATH 193A,A04,083782,Rotar; Vladimir,10,0,34,24
1657470199392,MATH 193A,A05,093482,Rotar; Vladimir,10,0,34,24
1657470205417,MATH 197,001,091859,McAuley; Julian John,9999,0,9999,0
1657470205417,MATH 197,002,095566,Kedlaya; Kiran S.,9997,0,9999,2
1657470205417,MATH 197,003,095567,Xiao; Ming,9999,0,9999,0
1657470205417,MATH 197,004,095571,Perols; Johan Lars,9998,0,9999,1
1657470212470,COGS 9,A01,083615,Shannon; Kyle Michael,9,0,75,66
1657470218494,COGS 11,A01,083617,Boyle; Mary E. T.,22,0,48,26
1657470224520,COGS 13,A01,083071,Bastos; Amalia Pinkusfeld,11,0,71,60
1657470230551,COGS 14A,A01,092681,Semenuks; Arturs,5,1,100,95
1657470236579,COGS 14B,A01,083073,Cheng; Tzu-Han,6,0,63,57
1657470242606,COGS 17,A01,092677,Semenuks; Arturs,6,0,81,75
1657470248630,COGS 100,A01,083619,Allen; Michael Gordon,17,0,70,53
1657470254663,COGS 101A,A01,083621,Davis; Joshua Daniel,9,0,68,59
1657470260686,COGS 101B,A01,091572,Allen; Michael Gordon,12,0,65,53
1657470266710,COGS 101C,A01,083625,Delgado; Tania,17,0,35,18
1657470272733,COGS 107A,A01,083627,Boyle; Mary E. T.,13,0,60,47
1657470278834,COGS 118A,A01,083075,Gupta; Anjum,21,0,76,55
1657470284858,CSE 3,A50,083646,Miranda; Gregory Joseph,24,0,50,26
1657470290890,CSE 8A,A50,083650,Miranda; Gregory Joseph,17,1,56,39
1657470296916,CSE 11,A01,083080,Cao; Yingjun,6,15,40,34
1657470302941,CSE 12,A01,083652,Krause-Levy; Sophia Louisa,28,1,120,92
1657470308966,CSE 15L,A01,083654,Morris; Justin Loren,9,0,50,41
1657470308966,CSE 15L,A02,083655,Morris; Justin Loren,9,0,50,41
1657470314990,CSE 20,A01,083657,Tran; Khoa Dang,39,0,80,41
1657470321018,CSE 21,A01,095574,Bach; Quang Tran,22,0,48,26
1657470327044,CSE 30,A01,083084,Eldon; John,5,0,80,75
1657470327044,CSE 30,B01,095061,Bhaskar; Nishant,9,0,50,41
1657470333070,CSE 100,A01,083659,Cao; Yingjun,5,4,70,65
1657470339095,CSE 134B,A01,083661,Powell; Thomas Allan,22,0,100,78
1657470345118,CSE 140,A01,083663,Gungor; Onat,15,0,85,70
1657470351142,CSE 140L,A01,083088,Eldon; John,21,0,100,79
1657470357164,CSE 175,A01,083665,Kumar; Rakesh,3,0,25,22
1657470363186,CSE 190,A00,092507,Dubnov; Shlomo,8,0,20,12
1657470369212,ECE 45,A01,083139,Congero; Spencer William,6,0,75,69
1657470375235,ECE 65,A50,083695,Saad; Andrew S,12,0,30,18
1657470375235,ECE 65,A51,095125,Saad; Andrew S,24,0,26,2
1657470381259,ECE 109,A01,091882,Touri; Behrouz,19,0,70,51
1657470387284,ECE 180,A00,083140,Abi Samra; Nicholas Camill,1,0,30,29
1657470387284,ECE 180,B00,083141,Abi Samra; Nicholas Camill,0,0,30,30
1657470393313,MATH 10A,A01,083735,Patchell; Gregory David,2,0,30,28
1657470393313,MATH 10A,A02,083736,Patchell; Gregory David,20,0,30,10
1657470393313,MATH 10A,A03,083737,Patchell; Gregory David,16,0,30,14
1657470399345,MATH 10B,A01,083207,Lim; Seonhee,8,0,34,26
1657470399345,MATH 10B,A02,083208,Lim; Seonhee,9,0,35,26
1657470399345,MATH 10B,A03,093472,Lim; Seonhee,7,0,34,27
1657470399345,MATH 10B,B01,083739,Sinha; Shubham,12,0,30,18
1657470405367,MATH 18,A01,083743,Cinel; Cameron Alexander,7,0,30,23
1657470405367,MATH 18,A02,083744,Cinel; Cameron Alexander,17,0,30,13
1657470405367,MATH 18,A03,083745,Cinel; Cameron Alexander,9,0,30,21
1657470405367,MATH 18,B01,083748,Rideout; David Porter,5,0,37,32
1657470405367,MATH 18,B02,083749,Rideout; David Porter,5,0,36,31
1657470405367,MATH 18,B03,083750,Rideout; David Porter,3,0,37,34
1657470405367,MATH 18,B04,083751,Rideout; David Porter,6,0,36,30
1657470405367,MATH 18,B05,093473,Rideout; David Porter,6,0,36,30
1657470405367,MATH 18,B06,093474,Rideout; David Porter,6,0,36,30
1657470411390,MATH 20A,A01,083754,Zheng; Zequn,14,0,40,26
1657470417415,MATH 20B,A01,083756,Briones; Jor-el Thomas Caparas,4,0,36,32
1657470417415,MATH 20B,A02,083757,Briones; Jor-el Thomas Caparas,1,0,36,35
1657470417415,MATH 20B,A03,093475,Briones; Jor-el Thomas Caparas,2,0,36,34
1657470423439,MATH 20C,A01,083760,Briones; Jor-el Thomas Caparas,1,0,35,34
1657470423439,MATH 20C,A02,083761,Briones; Jor-el Thomas Caparas,8,0,35,27
1657470423439,MATH 20C,A03,093476,Briones; Jor-el Thomas Caparas,0,1,36,36
1657470423439,MATH 20C,B01,083762,Bach; Quang Tran,1,0,30,29
1657470429467,MATH 20D,A01,083765,Tran; Brian Kha,5,0,30,25
1657470429467,MATH 20D,A02,083766,Tran; Brian Kha,5,0,30,25
1657470429467,MATH 20D,A03,083767,Tran; Brian Kha,5,0,30,25
1657470435491,MATH 20E,A01,083771,Ganguly; Soumya,9,0,32,23
1657470435491,MATH 20E,A02,083772,Ganguly; Soumya,6,0,32,26
1657470435491,MATH 20E,B01,083773,Ciotti; Benjamin,20,0,35,15
1657470435491,MATH 20E,B02,083774,Ciotti; Benjamin,17,0,35,18
1657470441514,MATH 103A,A01,083777,Greenfeld; Be'Eri,3,0,36,33
1657470441514,MATH 103A,A02,083778,Greenfeld; Be'Eri,5,0,36,31
1657470441514,MATH 103A,A03,093561,Greenfeld; Be'Eri,5,0,36,31
1657470441514,MATH 103A,B01,083779,Greenfeld; Be'Eri,7,0,36,29
1657470441514,MATH 103A,B02,083780,Greenfeld; Be'Eri,4,0,36,32
1657470441514,MATH 103A,B03,093562,Greenfeld; Be'Eri,3,0,36,33
1657470447538,MATH 105,A01,085443,Carter; Anne Toulson,15,0,35,20
1657470447538,MATH 105,A02,093477,Carter; Anne Toulson,20,0,35,15
1657470453567,MATH 109,A01,083213,Ganzberger; Geoffrey Michael,2,0,34,32
1657470453567,MATH 109,A02,083214,Ganzberger; Geoffrey Michael,4,0,34,30
1657470453567,MATH 109,A03,093478,Ganzberger; Geoffrey Michael,2,0,34,32
1657470453567,MATH 109,B01,083215,Ganzberger; Geoffrey Michael,1,0,32,31
1657470453567,MATH 109,B02,083216,Ganzberger; Geoffrey Michael,2,0,32,30
1657470453567,MATH 109,B03,093479,Ganzberger; Geoffrey Michael,8,0,32,24
1657470459596,MATH 142A,A01,083219,Chow; Bennett,7,0,32,25
1657470459596,MATH 142A,A02,083220,Chow; Bennett,10,0,32,22
1657470459596,MATH 142A,A03,093480,Chow; Bennett,8,0,32,24
1657470459596,MATH 142A,B03,093481,Chow; Bennett,8,0,32,24
1657470459596,MATH 142A,B04,093558,Chow; Bennett,13,0,32,19
1657470459596,MATH 142A,B05,093559,Chow; Bennett,6,0,32,26
1657470465623,MATH 193A,A01,083224,Rotar; Vladimir,8,0,34,26
1657470465623,MATH 193A,A02,083225,Rotar; Vladimir,9,0,34,25
1657470465623,MATH 193A,A03,083781,Rotar; Vladimir,5,0,34,29
1657470465623,MATH 193A,A04,083782,Rotar; Vladimir,10,0,34,24
1657470465623,MATH 193A,A05,093482,Rotar; Vladimir,10,0,34,24
1657470471647,MATH 197,001,091859,McAuley; Julian John,9999,0,9999,0
1657470471647,MATH 197,002,095566,Kedlaya; Kiran S.,9997,0,9999,2
1657470471647,MATH 197,003,095567,Xiao; Ming,9999,0,9999,0
1657470471647,MATH 197,004,095571,Perols; Johan Lars,9998,0,9999,1
1657470478707,COGS 9,A01,083615,Shannon; Kyle Michael,9,0,75,66
1657470484730,COGS 11,A01,083617,Boyle; Mary E. T.,22,0,48,26
1657470490758,COGS 13,A01,083071,Bastos; Amalia Pinkusfeld,11,0,71,60
1657470496784,COGS 14A,A01,092681,Semenuks; Arturs,5,1,100,95
1657470502807,COGS 14B,A01,083073,Cheng; Tzu-Han,6,0,63,57
1657470508831,COGS 17,A01,092677,Semenuks; Arturs,6,0,81,75
1657470514853,COGS 100,A01,083619,Allen; Michael Gordon,17,0,70,53
1657470520880,COGS 101A,A01,083621,Davis; Joshua Daniel,9,0,68,59
1657470526904,COGS 101B,A01,091572,Allen; Michael Gordon,12,0,65,53
1657470532928,COGS 101C,A01,083625,Delgado; Tania,17,0,35,18
1657470538954,COGS 107A,A01,083627,Boyle; Mary E. T.,13,0,60,47
1657470544979,COGS 118A,A01,083075,Gupta; Anjum,21,0,76,55
1657470551003,CSE 3,A50,083646,Miranda; Gregory Joseph,24,0,50,26
1657470557030,CSE 8A,A50,083650,Miranda; Gregory Joseph,17,1,56,39
1657470563058,CSE 11,A01,083080,Cao; Yingjun,6,15,40,34
1657470569081,CSE 12,A01,083652,Krause-Levy; Sophia Louisa,28,1,120,92
1657470575104,CSE 15L,A01,083654,Morris; Justin Loren,9,0,50,41
1657470575104,CSE 15L,A02,083655,Morris; Justin Loren,9,0,50,41
1657470581126,CSE 20,A01,083657,Tran; Khoa Dang,39,0,80,41
1657470587151,CSE 21,A01,095574,Bach; Quang Tran,22,0,48,26
1657470593177,CSE 30,A01,083084,Eldon; John,5,0,80,75
1657470593177,CSE 30,B01,095061,Bhaskar; Nishant,9,0,50,41
1657470599200,CSE 100,A01,083659,Cao; Yingjun,5,4,70,65
1657470605229,CSE 134B,A01,083661,Powell; Thomas Allan,22,0,100,78
1657470611255,CSE 140,A01,083663,Gungor; Onat,15,0,85,70
1657470617278,CSE 140L,A01,083088,Eldon; John,21,0,100,79
1657470623312,CSE 175,A01,083665,Kumar; Rakesh,3,0,25,22
1657470629343,CSE 190,A00,092507,Dubnov; Shlomo,8,0,20,12
1657470635366,ECE 45,A01,083139,Congero; Spencer William,6,0,75,69
1657470641389,ECE 65,A50,083695,Saad; Andrew S,12,0,30,18
1657470641389,ECE 65,A51,095125,Saad; Andrew S,24,0,26,2
1657470647424,ECE 109,A01,091882,Touri; Behrouz,19,0,70,51
1657470653446,ECE 180,A00,083140,Abi Samra; Nicholas Camill,1,0,30,29
1657470653446,ECE 180,B00,083141,Abi Samra; Nicholas Camill,0,0,30,30
1657470659469,MATH 10A,A01,083735,Patchell; Gregory David,2,0,30,28
1657470659469,MATH 10A,A02,083736,Patchell; Gregory David,20,0,30,10
1657470659469,MATH 10A,A03,083737,Patchell; Gregory David,16,0,30,14
1657470665492,MATH 10B,A01,083207,Lim; Seonhee,8,0,34,26
1657470665492,MATH 10B,A02,083208,Lim; Seonhee,9,0,35,26
1657470665492,MATH 10B,A03,093472,Lim; Seonhee,7,0,34,27
1657470665492,MATH 10B,B01,083739,Sinha; Shubham,12,0,30,18
1657470671518,MATH 18,A01,083743,Cinel; Cameron Alexander,7,0,30,23
1657470671518,MATH 18,A02,083744,Cinel; Cameron Alexander,17,0,30,13
1657470671518,MATH 18,A03,083745,Cinel; Cameron Alexander,9,0,30,21
1657470671518,MATH 18,B01,083748,Rideout; David Porter,5,0,37,32
1657470671518,MATH 18,B02,083749,Rideout; David Porter,5,0,36,31
1657470671518,MATH 18,B03,083750,Rideout; David Porter,3,0,37,34
1657470671518,MATH 18,B04,083751,Rideout; David Porter,6,0,36,30
1657470671518,MATH 18,B05,093473,Rideout; David Porter,6,0,36,30
1657470671518,MATH 18,B06,093474,Rideout; David Porter,6,0,36,30
1657470677541,MATH 20A,A01,083754,Zheng; Zequn,14,0,40,26
1657470683581,MATH 20B,A01,083756,Briones; Jor-el Thomas Caparas,4,0,36,32
1657470683581,MATH 20B,A02,083757,Briones; Jor-el Thomas Caparas,1,0,36,35
1657470683581,MATH 20B,A03,093475,Briones; Jor-el Thomas Caparas,2,0,36,34
1657470689609,MATH 20C,A01,083760,Briones; Jor-el Thomas Caparas,1,0,35,34
1657470689609,MATH 20C,A02,083761,Briones; Jor-el Thomas Caparas,8,0,35,27
1657470689609,MATH 20C,A03,093476,Briones; Jor-el Thomas Caparas,0,1,36,36
1657470689609,MATH 20C,B01,083762,Bach; Quang Tran,1,0,30,29
1657470695638,MATH 20D,A01,083765,Tran; Brian Kha,5,0,30,25
1657470695638,MATH 20D,A02,083766,Tran; Brian Kha,5,0,30,25
1657470695638,MATH 20D,A03,083767,Tran; Brian Kha,5,0,30,25
1657470701666,MATH 20E,A01,083771,Ganguly; Soumya,9,0,32,23
1657470701666,MATH 20E,A02,083772,Ganguly; Soumya,6,0,32,26
1657470701666,MATH 20E,B01,083773,Ciotti; Benjamin,20,0,35,15
1657470701666,MATH 20E,B02,083774,Ciotti; Benjamin,17,0,35,18
1657470707694,MATH 103A,A01,083777,Greenfeld; Be'Eri,3,0,36,33
1657470707694,MATH 103A,A02,083778,Greenfeld; Be'Eri,5,0,36,31
1657470707694,MATH 103A,A03,093561,Greenfeld; Be'Eri,5,0,36,31
1657470707694,MATH 103A,B01,083779,Greenfeld; Be'Eri,7,0,36,29
1657470707694,MATH 103A,B02,083780,Greenfeld; Be'Eri,4,0,36,32
1657470707694,MATH 103A,B03,093562,Greenfeld; Be'Eri,3,0,36,33
1657470713718,MATH 105,A01,085443,Carter; Anne Toulson,15,0,35,20
1657470713718,MATH 105,A02,093477,Carter; Anne Toulson,20,0,35,15
1657470719748,MATH 109,A01,083213,Ganzberger; Geoffrey Michael,2,0,34,32
1657470719748,MATH 109,A02,083214,Ganzberger; Geoffrey Michael,4,0,34,30
1657470719748,MATH 109,A03,093478,Ganzberger; Geoffrey Michael,2,0,34,32
1657470719748,MATH 109,B01,083215,Ganzberger; Geoffrey Michael,1,0,32,31
1657470719748,MATH 109,B02,083216,Ganzberger; Geoffrey Michael,2,0,32,30
1657470719748,MATH 109,B03,093479,Ganzberger; Geoffrey Michael,8,0,32,24
1657470725771,MATH 142A,A01,083219,Chow; Bennett,7,0,32,25
1657470725771,MATH 142A,A02,083220,Chow; Bennett,10,0,32,22
1657470725771,MATH 142A,A03,093480,Chow; Bennett,8,0,32,24
1657470725771,MATH 142A,B03,093481,Chow; Bennett,8,0,32,24
1657470725771,MATH 142A,B04,093558,Chow; Bennett,13,0,32,19
1657470725771,MATH 142A,B05,093559,Chow; Bennett,6,0,32,26
1657470731794,MATH 193A,A01,083224,Rotar; Vladimir,8,0,34,26
1657470731794,MATH 193A,A02,083225,Rotar; Vladimir,9,0,34,25
1657470731794,MATH 193A,A03,083781,Rotar; Vladimir,5,0,34,29
1657470731794,MATH 193A,A04,083782,Rotar; Vladimir,10,0,34,24
1657470731794,MATH 193A,A05,093482,Rotar; Vladimir,10,0,34,24
1657470737816,MATH 197,001,091859,McAuley; Julian John,9999,0,9999,0
1657470737816,MATH 197,002,095566,Kedlaya; Kiran S.,9997,0,9999,2
1657470737816,MATH 197,003,095567,Xiao; Ming,9999,0,9999,0
1657470737816,MATH 197,004,095571,Perols; Johan Lars,9998,0,9999,1
1657470744872,COGS 9,A01,083615,Shannon; Kyle Michael,9,0,75,66
1657470750899,COGS 11,A01,083617,Boyle; Mary E. T.,22,0,48,26
1657470756922,COGS 13,A01,083071,Bastos; Amalia Pinkusfeld,11,0,71,60
1657470762947,COGS 14A,A01,092681,Semenuks; Arturs,5,1,100,95
1657470768968,COGS 14B,A01,083073,Cheng; Tzu-Han,6,0,63,57
1657470774992,COGS 17,A01,092677,Semenuks; Arturs,6,0,81,75
1657470781019,COGS 100,A01,083619,Allen; Michael Gordon,17,0,70,53
1657470787048,COGS 101A,A01,083621,Davis; Joshua Daniel,9,0,68,59
1657470793074,COGS 101B,A01,091572,Allen; Michael Gordon,12,0,65,53
1657470799101,COGS 101C,A01,083625,Delgado; Tania,17,0,35,18
1657470805123,COGS 107A,A01,083627,Boyle; Mary E. T.,13,0,60,47
1657470811148,COGS 118A,A01,083075,Gupta; Anjum,21,0,76,55
1657470817170,CSE 3,A50,083646,Miranda; Gregory Joseph,24,0,50,26
1657470823194,CSE 8A,A50,083650,Miranda; Gregory Joseph,17,1,56,39
1657470829221,CSE 11,A01,083080,Cao; Yingjun,6,15,40,34
1657470835251,CSE 12,A01,083652,Krause-Levy; Sophia Louisa,28,1,120,92
1657470841273,CSE 15L,A01,083654,Morris; Justin Loren,9,0,50,41
1657470841273,CSE 15L,A02,083655,Morris; Justin Loren,9,0,50,41
1657470847299,CSE 20,A01,083657,Tran; Khoa Dang,39,0,80,41
1657470853321,CSE 21,A01,095574,Bach; Quang Tran,22,0,48,26
1657470859346,CSE 30,A01,083084,Eldon; John,5,0,80,75
1657470859346,CSE 30,B01,095061,Bhaskar; Nishant,9,0,50,41
1657470865369,CSE 100,A01,083659,Cao; Yingjun,5,4,70,65
1657470871396,CSE 134B,A01,083661,Powell; Thomas Allan,22,0,100,78
1657470877493,CSE 140,A01,083663,Gungor; Onat,15,0,85,70
1657470883523,CSE 140L,A01,083088,Eldon; John,21,0,100,79
1657470889547,CSE 175,A01,083665,Kumar; Rakesh,3,0,25,22
1657470895573,CSE 190,A00,092507,Dubnov; Shlomo,8,0,20,12
1657470901606,ECE 45,A01,083139,Congero; Spencer William,6,0,75,69
1657470907641,ECE 65,A50,083695,Saad; Andrew S,12,0,30,18
1657470907641,ECE 65,A51,095125,Saad; Andrew S,24,0,26,2
1657470913667,ECE 109,A01,091882,Touri; Behrouz,19,0,70,51
1657470919690,ECE 180,A00,083140,Abi Samra; Nicholas Camill,1,0,30,29
1657470919690,ECE 180,B00,083141,Abi Samra; Nicholas Camill,0,0,30,30
1657470925713,MATH 10A,A01,083735,Patchell; Gregory David,2,0,30,28
1657470925713,MATH 10A,A02,083736,Patchell; Gregory David,20,0,30,10
1657470925713,MATH 10A,A03,083737,Patchell; Gregory David,16,0,30,14
1657470931742,MATH 10B,A01,083207,Lim; Seonhee,8,0,34,26
1657470931742,MATH 10B,A02,083208,Lim; Seonhee,9,0,35,26
1657470931742,MATH 10B,A03,093472,Lim; Seonhee,7,0,34,27
1657470931742,MATH 10B,B01,083739,Sinha; Shubham,12,0,30,18
1657470937764,MATH 18,A01,083743,Cinel; Cameron Alexander,7,0,30,23
1657470937764,MATH 18,A02,083744,Cinel; Cameron Alexander,17,0,30,13
1657470937764,MATH 18,A03,083745,Cinel; Cameron Alexander,9,0,30,21
1657470937764,MATH 18,B01,083748,Rideout; David Porter,5,0,37,32
1657470937764,MATH 18,B02,083749,Rideout; David Porter,5,0,36,31
1657470937764,MATH 18,B03,083750,Rideout; David Porter,3,0,37,34
1657470937764,MATH 18,B04,083751,Rideout; David Porter,6,0,36,30
1657470937764,MATH 18,B05,093473,Rideout; David Porter,6,0,36,30
1657470937764,MATH 18,B06,093474,Rideout; David Porter,6,0,36,30
1657470943791,MATH 20A,A01,083754,Zheng; Zequn,14,0,40,26
1657470949817,MATH 20B,A01,083756,Briones; Jor-el Thomas Caparas,4,0,36,32
1657470949817,MATH 20B,A02,083757,Briones; Jor-el Thomas Caparas,1,0,36,35
1657470949817,MATH 20B,A03,093475,Briones; Jor-el Thomas Caparas,2,0,36,34
1657470955841,MATH 20C,A01,083760,Briones; Jor-el Thomas Caparas,1,0,35,34
1657470955841,MATH 20C,A02,083761,Briones; Jor-el Thomas Caparas,8,0,35,27
1657470955841,MATH 20C,A03,093476,Briones; Jor-el Thomas Caparas,0,1,36,36
1657470955841,MATH 20C,B01,083762,Bach; Quang Tran,1,0,30,29
1657470961869,MATH 20D,A01,083765,Tran; Brian Kha,5,0,30,25
1657470961869,MATH 20D,A02,083766,Tran; Brian Kha,5,0,30,25
1657470961869,MATH 20D,A03,083767,Tran; Brian Kha,5,0,30,25
1657470967897,MATH 20E,A01,083771,Ganguly; Soumya,9,0,32,23
1657470967897,MATH 20E,A02,083772,Ganguly; Soumya,6,0,32,26
1657470967897,MATH 20E,B01,083773,Ciotti; Benjamin,20,0,35,15
1657470967897,MATH 20E,B02,083774,Ciotti; Benjamin,17,0,35,18
1657470973927,MATH 103A,A01,083777,Greenfeld; Be'Eri,3,0,36,33
1657470973927,MATH 103A,A02,083778,Greenfeld; Be'Eri,5,0,36,31
1657470973927,MATH 103A,A03,093561,Greenfeld; Be'Eri,5,0,36,31
1657470973927,MATH 103A,B01,083779,Greenfeld; Be'Eri,7,0,36,29
1657470973927,MATH 103A,B02,083780,Greenfeld; Be'Eri,4,0,36,32
1657470973927,MATH 103A,B03,093562,Greenfeld; Be'Eri,3,0,36,33
1657470979955,MATH 105,A01,085443,Carter; Anne Toulson,15,0,35,20
1657470979955,MATH 105,A02,093477,Carter; Anne Toulson,20,0,35,15
1657470985978,MATH 109,A01,083213,Ganzberger; Geoffrey Michael,2,0,34,32
1657470985978,MATH 109,A02,083214,Ganzberger; Geoffrey Michael,4,0,34,30
1657470985978,MATH 109,A03,093478,Ganzberger; Geoffrey Michael,2,0,34,32
1657470985978,MATH 109,B01,083215,Ganzberger; Geoffrey Michael,1,0,32,31
1657470985978,MATH 109,B02,083216,Ganzberger; Geoffrey Michael,2,0,32,30
1657470985978,MATH 109,B03,093479,Ganzberger; Geoffrey Michael,8,0,32,24
1657470992006,MATH 142A,A01,083219,Chow; Bennett,7,0,32,25
1657470992006,MATH 142A,A02,083220,Chow; Bennett,10,0,32,22
1657470992006,MATH 142A,A03,093480,Chow; Bennett,8,0,32,24
1657470992006,MATH 142A,B03,093481,Chow; Bennett,8,0,32,24
1657470992006,MATH 142A,B04,093558,Chow; Bennett,13,0,32,19
1657470992006,MATH 142A,B05,093559,Chow; Bennett,6,0,32,26
1657470998035,MATH 193A,A01,083224,Rotar; Vladimir,8,0,34,26
1657470998035,MATH 193A,A02,083225,Rotar; Vladimir,9,0,34,25
1657470998035,MATH 193A,A03,083781,Rotar; Vladimir,5,0,34,29
1657470998035,MATH 193A,A04,083782,Rotar; Vladimir,10,0,34,24
1657470998035,MATH 193A,A05,093482,Rotar; Vladimir,10,0,34,24
1657471004061,MATH 197,001,091859,McAuley; Julian John,9999,0,9999,0
1657471004061,MATH 197,002,095566,Kedlaya; Kiran S.,9997,0,9999,2
1657471004061,MATH 197,003,095567,Xiao; Ming,9999,0,9999,0
1657471004061,MATH 197,004,095571,Perols; Johan Lars,9998,0,9999,1
1657471011126,COGS 9,A01,083615,Shannon; Kyle Michael,9,0,75,66
1657471017153,COGS 11,A01,083617,Boyle; Mary E. T.,22,0,48,26
1657471023175,COGS 13,A01,083071,Bastos; Amalia Pinkusfeld,11,0,71,60
1657471029202,COGS 14A,A01,092681,Semenuks; Arturs,5,1,100,95
1657471035226,COGS 14B,A01,083073,Cheng; Tzu-Han,6,0,63,57
1657471041252,COGS 17,A01,092677,Semenuks; Arturs,6,0,81,75
1657471047288,COGS 100,A01,083619,Allen; Michael Gordon,17,0,70,53
1657471053315,COGS 101A,A01,083621,Davis; Joshua Daniel,9,0,68,59
1657471059341,COGS 101B,A01,091572,Allen; Michael Gordon,12,0,65,53
1657471065365,COGS 101C,A01,083625,Delgado; Tania,17,0,35,18
1657471071389,COGS 107A,A01,083627,Boyle; Mary E. T.,13,0,60,47
1657471077417,COGS 118A,A01,083075,Gupta; Anjum,21,0,76,55
1657471083442,CSE 3,A50,083646,Miranda; Gregory Joseph,24,0,50,26
1657471089464,CSE 8A,A50,083650,Miranda; Gregory Joseph,17,1,56,39
1657471095489,CSE 11,A01,083080,Cao; Yingjun,6,15,40,34
1657471101514,CSE 12,A01,083652,Krause-Levy; Sophia Louisa,28,1,120,92
1657471107540,CSE 15L,A01,083654,Morris; Justin Loren,9,0,50,41
1657471107540,CSE 15L,A02,083655,Morris; Justin Loren,9,0,50,41
1657471113563,CSE 20,A01,083657,Tran; Khoa Dang,39,0,80,41
1657471119585,CSE 21,A01,095574,Bach; Quang Tran,22,0,48,26
1657471125613,CSE 30,A01,083084,Eldon; John,5,0,80,75
1657471125613,CSE 30,B01,095061,Bhaskar; Nishant,9,0,50,41
1657471131636,CSE 100,A01,083659,Cao; Yingjun,5,4,70,65
1657471137660,CSE 134B,A01,083661,Powell; Thomas Allan,22,0,100,78
1657471143687,CSE 140,A01,083663,Gungor; Onat,15,0,85,70
1657471149715,CSE 140L,A01,083088,Eldon; John,21,0,100,79
1657471155737,CSE 175,A01,083665,Kumar; Rakesh,3,0,25,22
1657471161764,CSE 190,A00,092507,Dubnov; Shlomo,8,0,20,12
1657471167786,ECE 45,A01,083139,Congero; Spencer William,6,0,75,69
1657471173808,ECE 65,A50,083695,Saad; Andrew S,12,0,30,18
1657471173808,ECE 65,A51,095125,Saad; Andrew S,24,0,26,2
1657471179833,ECE 109,A01,091882,Touri; Behrouz,19,0,70,51
1657471185863,ECE 180,A00,083140,Abi Samra; Nicholas Camill,1,0,30,29
1657471185863,ECE 180,B00,083141,Abi Samra; Nicholas Camill,0,0,30,30
1657471191895,MATH 10A,A01,083735,Patchell; Gregory David,2,0,30,28
1657471191895,MATH 10A,A02,083736,Patchell; Gregory David,20,0,30,10
1657471191895,MATH 10A,A03,083737,Patchell; Gregory David,16,0,30,14
1657471197924,MATH 10B,A01,083207,Lim; Seonhee,8,0,34,26
1657471197924,MATH 10B,A02,083208,Lim; Seonhee,9,0,35,26
1657471197924,MATH 10B,A03,093472,Lim; Seonhee,7,0,34,27
1657471197924,MATH 10B,B01,083739,Sinha; Shubham,12,0,30,18
1657471203955,MATH 18,A01,083743,Cinel; Cameron Alexander,7,0,30,23
1657471203955,MATH 18,A02,083744,Cinel; Cameron Alexander,17,0,30,13
1657471203955,MATH 18,A03,083745,Cinel; Cameron Alexander,9,0,30,21
1657471203955,MATH 18,B01,083748,Rideout; David Porter,5,0,37,32
1657471203955,MATH 18,B02,083749,Rideout; David Porter,5,0,36,31
1657471203955,MATH 18,B03,083750,Rideout; David Porter,3,0,37,34
1657471203955,MATH 18,B04,083751,Rideout; David Porter,6,0,36,30
1657471203955,MATH 18,B05,093473,Rideout; David Porter,6,0,36,30
1657471203955,MATH 18,B06,093474,Rideout; David Porter,6,0,36,30
1657471209986,MATH 20A,A01,083754,Zheng; Zequn,14,0,40,26
1657471216017,MATH 20B,A01,083756,Briones; Jor-el Thomas Caparas,4,0,36,32
1657471216017,MATH 20B,A02,083757,Briones; Jor-el Thomas Caparas,1,0,36,35
1657471216017,MATH 20B,A03,093475,Briones; Jor-el Thomas Caparas,2,0,36,34
1657471222046,MATH 20C,A01,083760,Briones; Jor-el Thomas Caparas,1,0,35,34
1657471222046,MATH 20C,A02,083761,Briones; Jor-el Thomas Caparas,8,0,35,27
1657471222046,MATH 20C,A03,093476,Briones; Jor-el Thomas Caparas,0,1,36,36
1657471222046,MATH 20C,B01,083762,Bach; Quang Tran,1,0,30,29
1657471228069,MATH 20D,A01,083765,Tran; Brian Kha,5,0,30,25
1657471228069,MATH 20D,A02,083766,Tran; Brian Kha,5,0,30,25
1657471228069,MATH 20D,A03,083767,Tran; Brian Kha,5,0,30,25
1657471234097,MATH 20E,A01,083771,Ganguly; Soumya,9,0,32,23
1657471234097,MATH 20E,A02,083772,Ganguly; Soumya,6,0,32,26
1657471234097,MATH 20E,B01,083773,Ciotti; Benjamin,20,0,35,15
1657471234097,MATH 20E,B02,083774,Ciotti; Benjamin,17,0,35,18
1657471240126,MATH 103A,A01,083777,Greenfeld; Be'Eri,3,0,36,33
1657471240126,MATH 103A,A02,083778,Greenfeld; Be'Eri,5,0,36,31
1657471240126,MATH 103A,A03,093561,Greenfeld; Be'Eri,5,0,36,31
1657471240126,MATH 103A,B01,083779,Greenfeld; Be'Eri,7,0,36,29
1657471240126,MATH 103A,B02,083780,Greenfeld; Be'Eri,4,0,36,32
1657471240126,MATH 103A,B03,093562,Greenfeld; Be'Eri,3,0,36,33
1657471246151,MATH 105,A01,085443,Carter; Anne Toulson,15,0,35,20
1657471246151,MATH 105,A02,093477,Carter; Anne Toulson,20,0,35,15
1657471252174,MATH 109,A01,083213,Ganzberger; Geoffrey Michael,2,0,34,32
1657471252174,MATH 109,A02,083214,Ganzberger; Geoffrey Michael,4,0,34,30
1657471252174,MATH 109,A03,093478,Ganzberger; Geoffrey Michael,2,0,34,32
1657471252174,MATH 109,B01,083215,Ganzberger; Geoffrey Michael,1,0,32,31
1657471252174,MATH 109,B02,083216,Ganzberger; Geoffrey Michael,2,0,32,30
1657471252174,MATH 109,B03,093479,Ganzberger; Geoffrey Michael,8,0,32,24
1657471258199,MATH 142A,A01,083219,Chow; Bennett,7,0,32,25
1657471258199,MATH 142A,A02,083220,Chow; Bennett,10,0,32,22
1657471258199,MATH 142A,A03,093480,Chow; Bennett,8,0,32,24
1657471258199,MATH 142A,B03,093481,Chow; Bennett,8,0,32,24
1657471258199,MATH 142A,B04,093558,Chow; Bennett,13,0,32,19
1657471258199,MATH 142A,B05,093559,Chow; Bennett,6,0,32,26
1657471264230,MATH 193A,A01,083224,Rotar; Vladimir,8,0,34,26
1657471264230,MATH 193A,A02,083225,Rotar; Vladimir,9,0,34,25
1657471264230,MATH 193A,A03,083781,Rotar; Vladimir,5,0,34,29
1657471264230,MATH 193A,A04,083782,Rotar; Vladimir,10,0,34,24
1657471264230,MATH 193A,A05,093482,Rotar; Vladimir,10,0,34,24
1657471270256,MATH 197,001,091859,McAuley; Julian John,9999,0,9999,0
1657471270256,MATH 197,002,095566,Kedlaya; Kiran S.,9997,0,9999,2
1657471270256,MATH 197,003,095567,Xiao; Ming,9999,0,9999,0
1657471270256,MATH 197,004,095571,Perols; Johan Lars,9998,0,9999,1
1657471277325,COGS 9,A01,083615,Shannon; Kyle Michael,9,0,75,66
1657471283352,COGS 11,A01,083617,Boyle; Mary E. T.,22,0,48,26
1657471289375,COGS 13,A01,083071,Bastos; Amalia Pinkusfeld,11,0,71,60
1657471295415,COGS 14A,A01,092681,Semenuks; Arturs,5,1,100,95
1657471301438,COGS 14B,A01,083073,Cheng; Tzu-Han,6,0,63,57
1657471307461,COGS 17,A01,092677,Semenuks; Arturs,6,0,81,75
1657471313486,COGS 100,A01,083619,Allen; Michael Gordon,17,0,70,53
1657471319517,COGS 101A,A01,083621,Davis; Joshua Daniel,9,0,68,59
1657471325546,COGS 101B,A01,091572,Allen; Michael Gordon,12,0,65,53
1657471331580,COGS 101C,A01,083625,Delgado; Tania,17,0,35,18
1657471337604,COGS 107A,A01,083627,Boyle; Mary E. T.,13,0,60,47
1657471343631,COGS 118A,A01,083075,Gupta; Anjum,21,0,76,55
1657471349678,CSE 3,A50,083646,Miranda; Gregory Joseph,24,0,50,26
1657471355708,CSE 8A,A50,083650,Miranda; Gregory Joseph,17,1,56,39
1657471361733,CSE 11,A01,083080,Cao; Yingjun,6,15,40,34
1657471367756,CSE 12,A01,083652,Krause-Levy; Sophia Louisa,28,1,120,92
1657471373778,CSE 15L,A01,083654,Morris; Justin Loren,9,0,50,41
1657471373778,CSE 15L,A02,083655,Morris; Justin Loren,9,0,50,41
1657471379803,CSE 20,A01,083657,Tran; Khoa Dang,39,0,80,41
1657471385824,CSE 21,A01,095574,Bach; Quang Tran,22,0,48,26
1657471391853,CSE 30,A01,083084,Eldon; John,5,0,80,75
1657471391853,CSE 30,B01,095061,Bhaskar; Nishant,9,0,50,41
1657471397881,CSE 100,A01,083659,Cao; Yingjun,5,4,70,65
1657471403908,CSE 134B,A01,083661,Powell; Thomas Allan,22,0,100,78
1657471409935,CSE 140,A01,083663,Gungor; Onat,15,0,85,70
1657471415957,CSE 140L,A01,083088,Eldon; John,21,0,100,79
1657471421987,CSE 175,A01,083665,Kumar; Rakesh,3,0,25,22
1657471428011,CSE 190,A00,092507,Dubnov; Shlomo,8,0,20,12
1657471434046,ECE 45,A01,083139,Congero; Spencer William,6,0,75,69
1657471440074,ECE 65,A50,083695,Saad; Andrew S,12,0,30,18
1657471440074,ECE 65,A51,095125,Saad; Andrew S,24,0,26,2
1657471446097,ECE 109,A01,091882,Touri; Behrouz,19,0,70,51
1657471452121,ECE 180,A00,083140,Abi Samra; Nicholas Camill,1,0,30,29
1657471452121,ECE 180,B00,083141,Abi Samra; Nicholas Camill,0,0,30,30
1657471458150,MATH 10A,A01,083735,Patchell; Gregory David,2,0,30,28
1657471458150,MATH 10A,A02,083736,Patchell; Gregory David,20,0,30,10
1657471458150,MATH 10A,A03,083737,Patchell; Gregory David,16,0,30,14
1657471464173,MATH 10B,A01,083207,Lim; Seonhee,8,0,34,26
1657471464173,MATH 10B,A02,083208,Lim; Seonhee,9,0,35,26
1657471464173,MATH 10B,A03,093472,Lim; Seonhee,7,0,34,27
1657471464173,MATH 10B,B01,083739,Sinha; Shubham,12,0,30,18
1657471470208,MATH 18,A01,083743,Cinel; Cameron Alexander,7,0,30,23
1657471470208,MATH 18,A02,083744,Cinel; Cameron Alexander,17,0,30,13
1657471470208,MATH 18,A03,083745,Cinel; Cameron Alexander,9,0,30,21
1657471470208,MATH 18,B01,083748,Rideout; David Porter,5,0,37,32
1657471470208,MATH 18,B02,083749,Rideout; David Porter,5,0,36,31
1657471470208,MATH 18,B03,083750,Rideout; David Porter,3,0,37,34
1657471470208,MATH 18,B04,083751,Rideout; David Porter,6,0,36,30
1657471470208,MATH 18,B05,093473,Rideout; David Porter,6,0,36,30
1657471470208,MATH 18,B06,093474,Rideout; David Porter,6,0,36,30
1657471476329,MATH 20A,A01,083754,Zheng; Zequn,14,0,40,26
1657471482357,MATH 20B,A01,083756,Briones; Jor-el Thomas Caparas,4,0,36,32
1657471482357,MATH 20B,A02,083757,Briones; Jor-el Thomas Caparas,1,0,36,35
1657471482357,MATH 20B,A03,093475,Briones; Jor-el Thomas Caparas,2,0,36,34
1657471488387,MATH 20C,A01,083760,Briones; Jor-el Thomas Caparas,1,0,35,34
1657471488387,MATH 20C,A02,083761,Briones; Jor-el Thomas Caparas,8,0,35,27
1657471488387,MATH 20C,A03,093476,Briones; Jor-el Thomas Caparas,0,1,36,36
1657471488387,MATH 20C,B01,083762,Bach; Quang Tran,1,0,30,29
1657471494416,MATH 20D,A01,083765,Tran; Brian Kha,5,0,30,25
1657471494416,MATH 20D,A02,083766,Tran; Brian Kha,5,0,30,25
1657471494416,MATH 20D,A03,083767,Tran; Brian Kha,5,0,30,25
1657471500439,MATH 20E,A01,083771,Ganguly; Soumya,9,0,32,23
1657471500439,MATH 20E,A02,083772,Ganguly; Soumya,6,0,32,26
1657471500439,MATH 20E,B01,083773,Ciotti; Benjamin,20,0,35,15
1657471500439,MATH 20E,B02,083774,Ciotti; Benjamin,17,0,35,18
1657471506464,MATH 103A,A01,083777,Greenfeld; Be'Eri,3,0,36,33
1657471506464,MATH 103A,A02,083778,Greenfeld; Be'Eri,5,0,36,31
1657471506464,MATH 103A,A03,093561,Greenfeld; Be'Eri,5,0,36,31
1657471506464,MATH 103A,B01,083779,Greenfeld; Be'Eri,7,0,36,29
1657471506464,MATH 103A,B02,083780,Greenfeld; Be'Eri,4,0,36,32
1657471506464,MATH 103A,B03,093562,Greenfeld; Be'Eri,3,0,36,33
1657471512489,MATH 105,A01,085443,Carter; Anne Toulson,15,0,35,20
1657471512489,MATH 105,A02,093477,Carter; Anne Toulson,20,0,35,15
1657471518512,MATH 109,A01,083213,Ganzberger; Geoffrey Michael,2,0,34,32
1657471518512,MATH 109,A02,083214,Ganzberger; Geoffrey Michael,4,0,34,30
1657471518512,MATH 109,A03,093478,Ganzberger; Geoffrey Michael,2,0,34,32
1657471518512,MATH 109,B01,083215,Ganzberger; Geoffrey Michael,1,0,32,31
1657471518512,MATH 109,B02,083216,Ganzberger; Geoffrey Michael,2,0,32,30
1657471518512,MATH 109,B03,093479,Ganzberger; Geoffrey Michael,8,0,32,24
1657471524535,MATH 142A,A01,083219,Chow; Bennett,7,0,32,25
1657471524535,MATH 142A,A02,083220,Chow; Bennett,10,0,32,22
1657471524535,MATH 142A,A03,093480,Chow; Bennett,8,0,32,24
1657471524535,MATH 142A,B03,093481,Chow; Bennett,8,0,32,24
1657471524535,MATH 142A,B04,093558,Chow; Bennett,13,0,32,19
1657471524535,MATH 142A,B05,093559,Chow; Bennett,6,0,32,26
1657471530565,MATH 193A,A01,083224,Rotar; Vladimir,8,0,34,26
1657471530565,MATH 193A,A02,083225,Rotar; Vladimir,9,0,34,25
1657471530565,MATH 193A,A03,083781,Rotar; Vladimir,5,0,34,29
1657471530565,MATH 193A,A04,083782,Rotar; Vladimir,10,0,34,24
1657471530565,MATH 193A,A05,093482,Rotar; Vladimir,10,0,34,24
1657471536587,MATH 197,001,091859,McAuley; Julian John,9999,0,9999,0
1657471536587,MATH 197,002,095566,Kedlaya; Kiran S.,9997,0,9999,2
1657471536587,MATH 197,003,095567,Xiao; Ming,9999,0,9999,0
1657471536587,MATH 197,004,095571,Perols; Johan Lars,9998,0,9999,1
1657471543652,COGS 9,A01,083615,Shannon; Kyle Michael,9,0,75,66
1657471549678,COGS 11,A01,083617,Boyle; Mary E. T.,22,0,48,26
1657471555706,COGS 13,A01,083071,Bastos; Amalia Pinkusfeld,11,0,71,60
1657471561729,COGS 14A,A01,092681,Semenuks; Arturs,5,1,100,95
1657471567751,COGS 14B,A01,083073,Cheng; Tzu-Han,6,0,63,57
1657471573774,COGS 17,A01,092677,Semenuks; Arturs,6,0,81,75
1657471579815,COGS 100,A01,083619,Allen; Michael Gordon,17,0,70,53
1657471585839,COGS 101A,A01,083621,Davis; Joshua Daniel,9,0,68,59
1657471591867,COGS 101B,A01,091572,Allen; Michael Gordon,12,0,65,53
1657471597901,COGS 101C,A01,083625,Delgado; Tania,17,0,35,18
1657471603925,COGS 107A,A01,083627,Boyle; Mary E. T.,13,0,60,47
1657471609954,COGS 118A,A01,083075,Gupta; Anjum,21,0,76,55
1657471615978,CSE 3,A50,083646,Miranda; Gregory Joseph,24,0,50,26
1657471622003,CSE 8A,A50,083650,Miranda; Gregory Joseph,17,1,56,39
1657471628026,CSE 11,A01,083080,Cao; Yingjun,6,15,40,34
1657471634052,CSE 12,A01,083652,Krause-Levy; Sophia Louisa,28,1,120,92
1657471640080,CSE 15L,A01,083654,Morris; Justin Loren,9,0,50,41
1657471640080,CSE 15L,A02,083655,Morris; Justin Loren,9,0,50,41
1657471646110,CSE 20,A01,083657,Tran; Khoa Dang,39,0,80,41
1657471652135,CSE 21,A01,095574,Bach; Quang Tran,22,0,48,26
1657471658162,CSE 30,A01,083084,Eldon; John,5,0,80,75
1657471658162,CSE 30,B01,095061,Bhaskar; Nishant,9,0,50,41
1657471664186,CSE 100,A01,083659,Cao; Yingjun,5,4,70,65
1657471670215,CSE 134B,A01,083661,Powell; Thomas Allan,22,0,100,78
1657471676236,CSE 140,A01,083663,Gungor; Onat,15,0,85,70
1657471682260,CSE 140L,A01,083088,Eldon; John,21,0,100,79
1657471688283,CSE 175,A01,083665,Kumar; Rakesh,3,0,25,22
1657471694307,CSE 190,A00,092507,Dubnov; Shlomo,8,0,20,12
1657471700328,ECE 45,A01,083139,Congero; Spencer William,6,0,75,69
1657471706352,ECE 65,A50,083695,Saad; Andrew S,12,0,30,18
1657471706352,ECE 65,A51,095125,Saad; Andrew S,24,0,26,2
1657471712376,ECE 109,A01,091882,Touri; Behrouz,19,0,70,51
1657471718407,ECE 180,A00,083140,Abi Samra; Nicholas Camill,1,0,30,29
1657471718407,ECE 180,B00,083141,Abi Samra; Nicholas Camill,0,0,30,30
1657471724434,MATH 10A,A01,083735,Patchell; Gregory David,2,0,30,28
1657471724434,MATH 10A,A02,083736,Patchell; Gregory David,20,0,30,10
1657471724434,MATH 10A,A03,083737,Patchell; Gregory David,16,0,30,14
1657471730465,MATH 10B,A01,083207,Lim; Seonhee,8,0,34,26
1657471730465,MATH 10B,A02,083208,Lim; Seonhee,9,0,35,26
1657471730465,MATH 10B,A03,093472,Lim; Seonhee,7,0,34,27
1657471730465,MATH 10B,B01,083739,Sinha; Shubham,12,0,30,18
1657471736491,MATH 18,A01,083743,Cinel; Cameron Alexander,7,0,30,23
1657471736491,MATH 18,A02,083744,Cinel; Cameron Alexander,17,0,30,13
1657471736491,MATH 18,A03,083745,Cinel; Cameron Alexander,9,0,30,21
1657471736491,MATH 18,B01,083748,Rideout; David Porter,5,0,37,32
1657471736491,MATH 18,B02,083749,Rideout; David Porter,5,0,36,31
1657471736491,MATH 18,B03,083750,Rideout; David Porter,3,0,37,34
1657471736491,MATH 18,B04,083751,Rideout; David Porter,6,0,36,30
1657471736491,MATH 18,B05,093473,Rideout; David Porter,6,0,36,30
1657471736491,MATH 18,B06,093474,Rideout; David Porter,6,0,36,30
1657471742514,MATH 20A,A01,083754,Zheng; Zequn,14,0,40,26
1657471748543,MATH 20B,A01,083756,Briones; Jor-el Thomas Caparas,4,0,36,32
1657471748543,MATH 20B,A02,083757,Briones; Jor-el Thomas Caparas,1,0,36,35
1657471748543,MATH 20B,A03,093475,Briones; Jor-el Thomas Caparas,2,0,36,34
1657471754567,MATH 20C,A01,083760,Briones; Jor-el Thomas Caparas,1,0,35,34
1657471754567,MATH 20C,A02,083761,Briones; Jor-el Thomas Caparas,8,0,35,27
1657471754567,MATH 20C,A03,093476,Briones; Jor-el Thomas Caparas,0,1,36,36
1657471754567,MATH 20C,B01,083762,Bach; Quang Tran,1,0,30,29
1657471760591,MATH 20D,A01,083765,Tran; Brian Kha,5,0,30,25
1657471760591,MATH 20D,A02,083766,Tran; Brian Kha,5,0,30,25
1657471760591,MATH 20D,A03,083767,Tran; Brian Kha,5,0,30,25
1657471766620,MATH 20E,A01,083771,Ganguly; Soumya,9,0,32,23
1657471766620,MATH 20E,A02,083772,Ganguly; Soumya,6,0,32,26
1657471766620,MATH 20E,B01,083773,Ciotti; Benjamin,20,0,35,15
1657471766620,MATH 20E,B02,083774,Ciotti; Benjamin,17,0,35,18
1657471772650,MATH 103A,A01,083777,Greenfeld; Be'Eri,3,0,36,33
1657471772650,MATH 103A,A02,083778,Greenfeld; Be'Eri,5,0,36,31
1657471772650,MATH 103A,A03,093561,Greenfeld; Be'Eri,5,0,36,31
1657471772650,MATH 103A,B01,083779,Greenfeld; Be'Eri,7,0,36,29
1657471772650,MATH 103A,B02,083780,Greenfeld; Be'Eri,4,0,36,32
1657471772650,MATH 103A,B03,093562,Greenfeld; Be'Eri,3,0,36,33
1657471778679,MATH 105,A01,085443,Carter; Anne Toulson,15,0,35,20
1657471778679,MATH 105,A02,093477,Carter; Anne Toulson,20,0,35,15
1657471784702,MATH 109,A01,083213,Ganzberger; Geoffrey Michael,2,0,34,32
1657471784702,MATH 109,A02,083214,Ganzberger; Geoffrey Michael,4,0,34,30
1657471784702,MATH 109,A03,093478,Ganzberger; Geoffrey Michael,2,0,34,32
1657471784702,MATH 109,B01,083215,Ganzberger; Geoffrey Michael,1,0,32,31
1657471784702,MATH 109,B02,083216,Ganzberger; Geoffrey Michael,2,0,32,30
1657471784702,MATH 109,B03,093479,Ganzberger; Geoffrey Michael,8,0,32,24
1657471790728,MATH 142A,A01,083219,Chow; Bennett,7,0,32,25
1657471790728,MATH 142A,A02,083220,Chow; Bennett,10,0,32,22
1657471790728,MATH 142A,A03,093480,Chow; Bennett,8,0,32,24
1657471790728,MATH 142A,B03,093481,Chow; Bennett,8,0,32,24
1657471790728,MATH 142A,B04,093558,Chow; Bennett,13,0,32,19
1657471790728,MATH 142A,B05,093559,Chow; Bennett,6,0,32,26
1657471796751,MATH 193A,A01,083224,Rotar; Vladimir,8,0,34,26
1657471796751,MATH 193A,A02,083225,Rotar; Vladimir,9,0,34,25
1657471796751,MATH 193A,A03,083781,Rotar; Vladimir,5,0,34,29
1657471796751,MATH 193A,A04,083782,Rotar; Vladimir,10,0,34,24
1657471796751,MATH 193A,A05,093482,Rotar; Vladimir,10,0,34,24
1657471802779,MATH 197,001,091859,McAuley; Julian John,9999,0,9999,0
1657471802779,MATH 197,002,095566,Kedlaya; Kiran S.,9997,0,9999,2
1657471802779,MATH 197,003,095567,Xiao; Ming,9999,0,9999,0
1657471802779,MATH 197,004,095571,Perols; Johan Lars,9998,0,9999,1
1657471809831,COGS 9,A01,083615,Shannon; Kyle Michael,9,0,75,66
1657471815859,COGS 11,A01,083617,Boyle; Mary E. T.,22,0,48,26
1657471821887,COGS 13,A01,083071,Bastos; Amalia Pinkusfeld,11,0,71,60
1657471827914,COGS 14A,A01,092681,Semenuks; Arturs,5,1,100,95
1657471833937,COGS 14B,A01,083073,Cheng; Tzu-Han,6,0,63,57
1657471839965,COGS 17,A01,092677,Semenuks; Arturs,6,0,81,75
1657471845991,COGS 100,A01,083619,Allen; Michael Gordon,17,0,70,53
1657471852022,COGS 101A,A01,083621,Davis; Joshua Daniel,9,0,68,59
1657471858046,COGS 101B,A01,091572,Allen; Michael Gordon,12,0,65,53
1657471864073,COGS 101C,A01,083625,Delgado; Tania,17,0,35,18
1657471870095,COGS 107A,A01,083627,Boyle; Mary E. T.,13,0,60,47
1657471876119,COGS 118A,A01,083075,Gupta; Anjum,21,0,76,55
1657471882141,CSE 3,A50,083646,Miranda; Gregory Joseph,24,0,50,26
1657471888164,CSE 8A,A50,083650,Miranda; Gregory Joseph,17,1,56,39
1657471894187,CSE 11,A01,083080,Cao; Yingjun,6,15,40,34
1657471900210,CSE 12,A01,083652,Krause-Levy; Sophia Louisa,28,1,120,92
1657471906263,CSE 15L,A01,083654,Morris; Justin Loren,9,0,50,41
1657471906263,CSE 15L,A02,083655,Morris; Justin Loren,9,0,50,41
1657471912289,CSE 20,A01,083657,Tran; Khoa Dang,39,0,80,41
1657471918312,CSE 21,A01,095574,Bach; Quang Tran,22,0,48,26
1657471924334,CSE 30,A01,083084,Eldon; John,5,0,80,75
1657471924334,CSE 30,B01,095061,Bhaskar; Nishant,9,0,50,41
1657471930361,CSE 100,A01,083659,Cao; Yingjun,5,4,70,65
1657471936385,CSE 134B,A01,083661,Powell; Thomas Allan,22,0,100,78
1657471942409,CSE 140,A01,083663,Gungor; Onat,15,0,85,70
1657471948437,CSE 140L,A01,083088,Eldon; John,21,0,100,79
1657471954464,CSE 175,A01,083665,Kumar; Rakesh,3,0,25,22
1657471960486,CSE 190,A00,092507,Dubnov; Shlomo,8,0,20,12
1657471966513,ECE 45,A01,083139,Congero; Spencer William,6,0,75,69
1657471972545,ECE 65,A50,083695,Saad; Andrew S,12,0,30,18
1657471972545,ECE 65,A51,095125,Saad; Andrew S,24,0,26,2
1657471978569,ECE 109,A01,091882,Touri; Behrouz,19,0,70,51
1657471984595,ECE 180,A00,083140,Abi Samra; Nicholas Camill,1,0,30,29
1657471984595,ECE 180,B00,083141,Abi Samra; Nicholas Camill,0,0,30,30
1657471990620,MATH 10A,A01,083735,Patchell; Gregory David,2,0,30,28
1657471990620,MATH 10A,A02,083736,Patchell; Gregory David,20,0,30,10
1657471990620,MATH 10A,A03,083737,Patchell; Gregory David,16,0,30,14
1657471996649,MATH 10B,A01,083207,Lim; Seonhee,8,0,34,26
1657471996649,MATH 10B,A02,083208,Lim; Seonhee,9,0,35,26
1657471996649,MATH 10B,A03,093472,Lim; Seonhee,7,0,34,27
1657471996649,MATH 10B,B01,083739,Sinha; Shubham,12,0,30,18
1657472002671,MATH 18,A01,083743,Cinel; Cameron Alexander,7,0,30,23
1657472002671,MATH 18,A02,083744,Cinel; Cameron Alexander,17,0,30,13
1657472002671,MATH 18,A03,083745,Cinel; Cameron Alexander,9,0,30,21
1657472002671,MATH 18,B01,083748,Rideout; David Porter,5,0,37,32
1657472002671,MATH 18,B02,083749,Rideout; David Porter,5,0,36,31
1657472002671,MATH 18,B03,083750,Rideout; David Porter,3,0,37,34
1657472002671,MATH 18,B04,083751,Rideout; David Porter,6,0,36,30
1657472002671,MATH 18,B05,093473,Rideout; David Porter,6,0,36,30
1657472002671,MATH 18,B06,093474,Rideout; David Porter,6,0,36,30
1657472008695,MATH 20A,A01,083754,Zheng; Zequn,14,0,40,26
1657472014724,MATH 20B,A01,083756,Briones; Jor-el Thomas Caparas,4,0,36,32
1657472014724,MATH 20B,A02,083757,Briones; Jor-el Thomas Caparas,1,0,36,35
1657472014724,MATH 20B,A03,093475,Briones; Jor-el Thomas Caparas,2,0,36,34
1657472020747,MATH 20C,A01,083760,Briones; Jor-el Thomas Caparas,1,0,35,34
1657472020747,MATH 20C,A02,083761,Briones; Jor-el Thomas Caparas,8,0,35,27
1657472020747,MATH 20C,A03,093476,Briones; Jor-el Thomas Caparas,0,1,36,36
1657472020747,MATH 20C,B01,083762,Bach; Quang Tran,1,0,30,29
1657472026777,MATH 20D,A01,083765,Tran; Brian Kha,5,0,30,25
1657472026777,MATH 20D,A02,083766,Tran; Brian Kha,5,0,30,25
1657472026777,MATH 20D,A03,083767,Tran; Brian Kha,5,0,30,25
1657472032803,MATH 20E,A01,083771,Ganguly; Soumya,9,0,32,23
1657472032803,MATH 20E,A02,083772,Ganguly; Soumya,6,0,32,26
1657472032803,MATH 20E,B01,083773,Ciotti; Benjamin,20,0,35,15
1657472032803,MATH 20E,B02,083774,Ciotti; Benjamin,17,0,35,18
1657472038826,MATH 103A,A01,083777,Greenfeld; Be'Eri,3,0,36,33
1657472038826,MATH 103A,A02,083778,Greenfeld; Be'Eri,5,0,36,31
1657472038826,MATH 103A,A03,093561,Greenfeld; Be'Eri,5,0,36,31
1657472038826,MATH 103A,B01,083779,Greenfeld; Be'Eri,7,0,36,29
1657472038826,MATH 103A,B02,083780,Greenfeld; Be'Eri,4,0,36,32
1657472038826,MATH 103A,B03,093562,Greenfeld; Be'Eri,3,0,36,33
1657472044850,MATH 105,A01,085443,Carter; Anne Toulson,15,0,35,20
1657472044850,MATH 105,A02,093477,Carter; Anne Toulson,20,0,35,15
1657472050878,MATH 109,A01,083213,Ganzberger; Geoffrey Michael,2,0,34,32
1657472050878,MATH 109,A02,083214,Ganzberger; Geoffrey Michael,4,0,34,30
1657472050878,MATH 109,A03,093478,Ganzberger; Geoffrey Michael,2,0,34,32
1657472050878,MATH 109,B01,083215,Ganzberger; Geoffrey Michael,1,0,32,31
1657472050878,MATH 109,B02,083216,Ganzberger; Geoffrey Michael,2,0,32,30
1657472050878,MATH 109,B03,093479,Ganzberger; Geoffrey Michael,8,0,32,24
1657472056901,MATH 142A,A01,083219,Chow; Bennett,7,0,32,25
1657472056901,MATH 142A,A02,083220,Chow; Bennett,10,0,32,22
1657472056901,MATH 142A,A03,093480,Chow; Bennett,8,0,32,24
1657472056901,MATH 142A,B03,093481,Chow; Bennett,8,0,32,24
1657472056901,MATH 142A,B04,093558,Chow; Bennett,13,0,32,19
1657472056901,MATH 142A,B05,093559,Chow; Bennett,6,0,32,26
1657472062925,MATH 193A,A01,083224,Rotar; Vladimir,8,0,34,26
1657472062925,MATH 193A,A02,083225,Rotar; Vladimir,9,0,34,25
1657472062925,MATH 193A,A03,083781,Rotar; Vladimir,5,0,34,29
1657472062925,MATH 193A,A04,083782,Rotar; Vladimir,10,0,34,24
1657472062925,MATH 193A,A05,093482,Rotar; Vladimir,10,0,34,24
1657472068953,MATH 197,001,091859,McAuley; Julian John,9999,0,9999,0
1657472068953,MATH 197,002,095566,Kedlaya; Kiran S.,9997,0,9999,2
1657472068953,MATH 197,003,095567,Xiao; Ming,9999,0,9999,0
1657472068953,MATH 197,004,095571,Perols; Johan Lars,9998,0,9999,1
1657472076074,COGS 9,A01,083615,Shannon; Kyle Michael,9,0,75,66
1657472082101,COGS 11,A01,083617,Boyle; Mary E. T.,22,0,48,26
1657472088134,COGS 13,A01,083071,Bastos; Amalia Pinkusfeld,11,0,71,60
1657472094158,COGS 14A,A01,092681,Semenuks; Arturs,5,1,100,95
1657472100181,COGS 14B,A01,083073,Cheng; Tzu-Han,6,0,63,57
1657472106209,COGS 17,A01,092677,Semenuks; Arturs,6,0,81,75
1657472112237,COGS 100,A01,083619,Allen; Michael Gordon,17,0,70,53
1657472118263,COGS 101A,A01,083621,Davis; Joshua Daniel,9,0,68,59
1657472124286,COGS 101B,A01,091572,Allen; Michael Gordon,12,0,65,53
1657472130314,COGS 101C,A01,083625,Delgado; Tania,17,0,35,18
1657472136359,COGS 107A,A01,083627,Boyle; Mary E. T.,13,0,60,47
1657472142381,COGS 118A,A01,083075,Gupta; Anjum,21,0,76,55
1657472148421,CSE 3,A50,083646,Miranda; Gregory Joseph,24,0,50,26
1657472154444,CSE 8A,A50,083650,Miranda; Gregory Joseph,17,1,56,39
1657472160470,CSE 11,A01,083080,Cao; Yingjun,6,15,40,34
1657472166498,CSE 12,A01,083652,Krause-Levy; Sophia Louisa,28,1,120,92
1657472172524,CSE 15L,A01,083654,Morris; Justin Loren,9,0,50,41
1657472172524,CSE 15L,A02,083655,Morris; Justin Loren,9,0,50,41
1657472178551,CSE 20,A01,083657,Tran; Khoa Dang,39,0,80,41
1657472184590,CSE 21,A01,095574,Bach; Quang Tran,22,0,48,26
1657472190617,CSE 30,A01,083084,Eldon; John,5,0,80,75
1657472190617,CSE 30,B01,095061,Bhaskar; Nishant,9,0,50,41
1657472196641,CSE 100,A01,083659,Cao; Yingjun,5,4,70,65
1657472202664,CSE 134B,A01,083661,Powell; Thomas Allan,22,0,100,78
1657472208687,CSE 140,A01,083663,Gungor; Onat,15,0,85,70
1657472214710,CSE 140L,A01,083088,Eldon; John,21,0,100,79
1657472220733,CSE 175,A01,083665,Kumar; Rakesh,3,0,25,22
1657472226759,CSE 190,A00,092507,Dubnov; Shlomo,8,0,20,12
1657472232783,ECE 45,A01,083139,Congero; Spencer William,6,0,75,69
1657472238810,ECE 65,A50,083695,Saad; Andrew S,12,0,30,18
1657472238810,ECE 65,A51,095125,Saad; Andrew S,24,0,26,2
1657472244833,ECE 109,A01,091882,Touri; Behrouz,19,0,70,51
1657472250861,ECE 180,A00,083140,Abi Samra; Nicholas Camill,1,0,30,29
1657472250861,ECE 180,B00,083141,Abi Samra; Nicholas Camill,0,0,30,30
1657472256885,MATH 10A,A01,083735,Patchell; Gregory David,2,0,30,28
1657472256885,MATH 10A,A02,083736,Patchell; Gregory David,20,0,30,10
1657472256885,MATH 10A,A03,083737,Patchell; Gregory David,16,0,30,14
1657472262915,MATH 10B,A01,083207,Lim; Seonhee,8,0,34,26
1657472262915,MATH 10B,A02,083208,Lim; Seonhee,9,0,35,26
1657472262915,MATH 10B,A03,093472,Lim; Seonhee,7,0,34,27
1657472262915,MATH 10B,B01,083739,Sinha; Shubham,12,0,30,18
1657472268940,MATH 18,A01,083743,Cinel; Cameron Alexander,7,0,30,23
1657472268940,MATH 18,A02,083744,Cinel; Cameron Alexander,17,0,30,13
1657472268940,MATH 18,A03,083745,Cinel; Cameron Alexander,9,0,30,21
1657472268940,MATH 18,B01,083748,Rideout; David Porter,5,0,37,32
1657472268940,MATH 18,B02,083749,Rideout; David Porter,5,0,36,31
1657472268940,MATH 18,B03,083750,Rideout; David Porter,3,0,37,34
1657472268940,MATH 18,B04,083751,Rideout; David Porter,6,0,36,30
1657472268940,MATH 18,B05,093473,Rideout; David Porter,6,0,36,30
1657472268940,MATH 18,B06,093474,Rideout; David Porter,6,0,36,30
1657472274967,MATH 20A,A01,083754,Zheng; Zequn,14,0,40,26
1657472280992,MATH 20B,A01,083756,Briones; Jor-el Thomas Caparas,4,0,36,32
1657472280992,MATH 20B,A02,083757,Briones; Jor-el Thomas Caparas,1,0,36,35
1657472280992,MATH 20B,A03,093475,Briones; Jor-el Thomas Caparas,2,0,36,34
1657472287022,MATH 20C,A01,083760,Briones; Jor-el Thomas Caparas,1,0,35,34
1657472287022,MATH 20C,A02,083761,Briones; Jor-el Thomas Caparas,8,0,35,27
1657472287022,MATH 20C,A03,093476,Briones; Jor-el Thomas Caparas,0,1,36,36
1657472287022,MATH 20C,B01,083762,Bach; Quang Tran,1,0,30,29
1657472293052,MATH 20D,A01,083765,Tran; Brian Kha,5,0,30,25
1657472293052,MATH 20D,A02,083766,Tran; Brian Kha,5,0,30,25
1657472293052,MATH 20D,A03,083767,Tran; Brian Kha,5,0,30,25
1657472299081,MATH 20E,A01,083771,Ganguly; Soumya,9,0,32,23
1657472299081,MATH 20E,A02,083772,Ganguly; Soumya,6,0,32,26
1657472299081,MATH 20E,B01,083773,Ciotti; Benjamin,20,0,35,15
1657472299081,MATH 20E,B02,083774,Ciotti; Benjamin,17,0,35,18
1657472305104,MATH 103A,A01,083777,Greenfeld; Be'Eri,3,0,36,33
1657472305104,MATH 103A,A02,083778,Greenfeld; Be'Eri,5,0,36,31
1657472305104,MATH 103A,A03,093561,Greenfeld; Be'Eri,5,0,36,31
1657472305104,MATH 103A,B01,083779,Greenfeld; Be'Eri,7,0,36,29
1657472305104,MATH 103A,B02,083780,Greenfeld; Be'Eri,4,0,36,32
1657472305104,MATH 103A,B03,093562,Greenfeld; Be'Eri,3,0,36,33
1657472311133,MATH 105,A01,085443,Carter; Anne Toulson,15,0,35,20
1657472311133,MATH 105,A02,093477,Carter; Anne Toulson,20,0,35,15
1657472317158,MATH 109,A01,083213,Ganzberger; Geoffrey Michael,2,0,34,32
1657472317158,MATH 109,A02,083214,Ganzberger; Geoffrey Michael,4,0,34,30
1657472317158,MATH 109,A03,093478,Ganzberger; Geoffrey Michael,2,0,34,32
1657472317158,MATH 109,B01,083215,Ganzberger; Geoffrey Michael,1,0,32,31
1657472317158,MATH 109,B02,083216,Ganzberger; Geoffrey Michael,2,0,32,30
1657472317158,MATH 109,B03,093479,Ganzberger; Geoffrey Michael,8,0,32,24
1657472323186,MATH 142A,A01,083219,Chow; Bennett,7,0,32,25
1657472323186,MATH 142A,A02,083220,Chow; Bennett,10,0,32,22
1657472323186,MATH 142A,A03,093480,Chow; Bennett,8,0,32,24
1657472323186,MATH 142A,B03,093481,Chow; Bennett,8,0,32,24
1657472323186,MATH 142A,B04,093558,Chow; Bennett,13,0,32,19
1657472323186,MATH 142A,B05,093559,Chow; Bennett,6,0,32,26
1657472329211,MATH 193A,A01,083224,Rotar; Vladimir,8,0,34,26
1657472329211,MATH 193A,A02,083225,Rotar; Vladimir,9,0,34,25
1657472329211,MATH 193A,A03,083781,Rotar; Vladimir,5,0,34,29
1657472329211,MATH 193A,A04,083782,Rotar; Vladimir,10,0,34,24
1657472329211,MATH 193A,A05,093482,Rotar; Vladimir,10,0,34,24
1657472335237,MATH 197,001,091859,McAuley; Julian John,9999,0,9999,0
1657472335237,MATH 197,002,095566,Kedlaya; Kiran S.,9997,0,9999,2
1657472335237,MATH 197,003,095567,Xiao; Ming,9999,0,9999,0
1657472335237,MATH 197,004,095571,Perols; Johan Lars,9998,0,9999,1
1657472342302,COGS 9,A01,083615,Shannon; Kyle Michael,9,0,75,66
1657472348329,COGS 11,A01,083617,Boyle; Mary E. T.,22,0,48,26
1657472354356,COGS 13,A01,083071,Bastos; Amalia Pinkusfeld,11,0,71,60
1657472360384,COGS 14A,A01,092681,Semenuks; Arturs,5,1,100,95
1657472366408,COGS 14B,A01,083073,Cheng; Tzu-Han,6,0,63,57
1657472372435,COGS 17,A01,092677,Semenuks; Arturs,6,0,81,75
1657472378458,COGS 100,A01,083619,Allen; Michael Gordon,17,0,70,53
1657472384484,COGS 101A,A01,083621,Davis; Joshua Daniel,9,0,68,59
1657472390511,COGS 101B,A01,091572,Allen; Michael Gordon,12,0,65,53
1657472396534,COGS 101C,A01,083625,Delgado; Tania,17,0,35,18
1657472402564,COGS 107A,A01,083627,Boyle; Mary E. T.,13,0,60,47
1657472408586,COGS 118A,A01,083075,Gupta; Anjum,21,0,76,55
1657472414609,CSE 3,A50,083646,Miranda; Gregory Joseph,24,0,50,26
1657472420632,CSE 8A,A50,083650,Miranda; Gregory Joseph,17,1,56,39
1657472426655,CSE 11,A01,083080,Cao; Yingjun,6,15,40,34
1657472432687,CSE 12,A01,083652,Krause-Levy; Sophia Louisa,28,1,120,92
1657472438710,CSE 15L,A01,083654,Morris; Justin Loren,9,0,50,41
1657472438710,CSE 15L,A02,083655,Morris; Justin Loren,9,0,50,41
1657472444737,CSE 20,A01,083657,Tran; Khoa Dang,39,0,80,41
1657472450762,CSE 21,A01,095574,Bach; Quang Tran,22,0,48,26
1657472456786,CSE 30,A01,083084,Eldon; John,5,0,80,75
1657472456786,CSE 30,B01,095061,Bhaskar; Nishant,9,0,50,41
1657472462813,CSE 100,A01,083659,Cao; Yingjun,5,4,70,65
1657472468838,CSE 134B,A01,083661,Powell; Thomas Allan,22,0,100,78
1657472474866,CSE 140,A01,083663,Gungor; Onat,15,0,85,70
1657472480889,CSE 140L,A01,083088,Eldon; John,21,0,100,79
1657472486913,CSE 175,A01,083665,Kumar; Rakesh,3,0,25,22
1657472492939,CSE 190,A00,092507,Dubnov; Shlomo,8,0,20,12
1657472498965,ECE 45,A01,083139,Congero; Spencer William,6,0,75,69
1657472504987,ECE 65,A50,083695,Saad; Andrew S,12,0,30,18
1657472504987,ECE 65,A51,095125,Saad; Andrew S,24,0,26,2
1657472511016,ECE 109,A01,091882,Touri; Behrouz,19,0,70,51
1657472517054,ECE 180,A00,083140,Abi Samra; Nicholas Camill,1,0,30,29
1657472517054,ECE 180,B00,083141,Abi Samra; Nicholas Camill,0,0,30,30
1657472523104,MATH 10A,A01,083735,Patchell; Gregory David,2,0,30,28
1657472523104,MATH 10A,A02,083736,Patchell; Gregory David,20,0,30,10
1657472523104,MATH 10A,A03,083737,Patchell; Gregory David,16,0,30,14
1657472529132,MATH 10B,A01,083207,Lim; Seonhee,8,0,34,26
1657472529132,MATH 10B,A02,083208,Lim; Seonhee,9,0,35,26
1657472529132,MATH 10B,A03,093472,Lim; Seonhee,7,0,34,27
1657472529132,MATH 10B,B01,083739,Sinha; Shubham,12,0,30,18
1657472535163,MATH 18,A01,083743,Cinel; Cameron Alexander,7,0,30,23
1657472535163,MATH 18,A02,083744,Cinel; Cameron Alexander,17,0,30,13
1657472535163,MATH 18,A03,083745,Cinel; Cameron Alexander,9,0,30,21
1657472535163,MATH 18,B01,083748,Rideout; David Porter,5,0,37,32
1657472535163,MATH 18,B02,083749,Rideout; David Porter,5,0,36,31
1657472535163,MATH 18,B03,083750,Rideout; David Porter,3,0,37,34
1657472535163,MATH 18,B04,083751,Rideout; David Porter,6,0,36,30
1657472535163,MATH 18,B05,093473,Rideout; David Porter,6,0,36,30
1657472535163,MATH 18,B06,093474,Rideout; David Porter,6,0,36,30
1657472541185,MATH 20A,A01,083754,Zheng; Zequn,14,0,40,26
1657472547209,MATH 20B,A01,083756,Briones; Jor-el Thomas Caparas,4,0,36,32
1657472547209,MATH 20B,A02,083757,Briones; Jor-el Thomas Caparas,1,0,36,35
1657472547209,MATH 20B,A03,093475,Briones; Jor-el Thomas Caparas,2,0,36,34
1657472553241,MATH 20C,A01,083760,Briones; Jor-el Thomas Caparas,1,0,35,34
1657472553241,MATH 20C,A02,083761,Briones; Jor-el Thomas Caparas,8,0,35,27
1657472553241,MATH 20C,A03,093476,Briones; Jor-el Thomas Caparas,0,1,36,36
1657472553241,MATH 20C,B01,083762,Bach; Quang Tran,1,0,30,29
1657472559265,MATH 20D,A01,083765,Tran; Brian Kha,5,0,30,25
1657472559265,MATH 20D,A02,083766,Tran; Brian Kha,5,0,30,25
1657472559265,MATH 20D,A03,083767,Tran; Brian Kha,5,0,30,25
1657472565294,MATH 20E,A01,083771,Ganguly; Soumya,9,0,32,23
1657472565294,MATH 20E,A02,083772,Ganguly; Soumya,6,0,32,26
1657472565294,MATH 20E,B01,083773,Ciotti; Benjamin,20,0,35,15
1657472565294,MATH 20E,B02,083774,Ciotti; Benjamin,17,0,35,18
1657472571325,MATH 103A,A01,083777,Greenfeld; Be'Eri,3,0,36,33
1657472571325,MATH 103A,A02,083778,Greenfeld; Be'Eri,5,0,36,31
1657472571325,MATH 103A,A03,093561,Greenfeld; Be'Eri,5,0,36,31
1657472571325,MATH 103A,B01,083779,Greenfeld; Be'Eri,7,0,36,29
1657472571325,MATH 103A,B02,083780,Greenfeld; Be'Eri,4,0,36,32
1657472571325,MATH 103A,B03,093562,Greenfeld; Be'Eri,3,0,36,33
1657472577351,MATH 105,A01,085443,Carter; Anne Toulson,15,0,35,20
1657472577351,MATH 105,A02,093477,Carter; Anne Toulson,20,0,35,15
1657472583376,MATH 109,A01,083213,Ganzberger; Geoffrey Michael,2,0,34,32
1657472583376,MATH 109,A02,083214,Ganzberger; Geoffrey Michael,4,0,34,30
1657472583376,MATH 109,A03,093478,Ganzberger; Geoffrey Michael,2,0,34,32
1657472583376,MATH 109,B01,083215,Ganzberger; Geoffrey Michael,1,0,32,31
1657472583376,MATH 109,B02,083216,Ganzberger; Geoffrey Michael,2,0,32,30
1657472583376,MATH 109,B03,093479,Ganzberger; Geoffrey Michael,8,0,32,24
1657472589412,MATH 142A,A01,083219,Chow; Bennett,7,0,32,25
1657472589412,MATH 142A,A02,083220,Chow; Bennett,10,0,32,22
1657472589412,MATH 142A,A03,093480,Chow; Bennett,8,0,32,24
1657472589412,MATH 142A,B03,093481,Chow; Bennett,8,0,32,24
1657472589412,MATH 142A,B04,093558,Chow; Bennett,13,0,32,19
1657472589412,MATH 142A,B05,093559,Chow; Bennett,6,0,32,26
1657472595440,MATH 193A,A01,083224,Rotar; Vladimir,8,0,34,26
1657472595440,MATH 193A,A02,083225,Rotar; Vladimir,9,0,34,25
1657472595440,MATH 193A,A03,083781,Rotar; Vladimir,5,0,34,29
1657472595440,MATH 193A,A04,083782,Rotar; Vladimir,10,0,34,24
1657472595440,MATH 193A,A05,093482,Rotar; Vladimir,10,0,34,24
1657472601467,MATH 197,001,091859,McAuley; Julian John,9999,0,9999,0
1657472601467,MATH 197,002,095566,Kedlaya; Kiran S.,9997,0,9999,2
1657472601467,MATH 197,003,095567,Xiao; Ming,9999,0,9999,0
1657472601467,MATH 197,004,095571,Perols; Johan Lars,9998,0,9999,1
1657472608543,COGS 9,A01,083615,Shannon; Kyle Michael,9,0,75,66
1657472614571,COGS 11,A01,083617,Boyle; Mary E. T.,22,0,48,26
1657472620599,COGS 13,A01,083071,Bastos; Amalia Pinkusfeld,11,0,71,60
1657472626627,COGS 14A,A01,092681,Semenuks; Arturs,5,1,100,95
1657472632654,COGS 14B,A01,083073,Cheng; Tzu-Han,6,0,63,57
1657472638681,COGS 17,A01,092677,Semenuks; Arturs,6,0,81,75
1657472644702,COGS 100,A01,083619,Allen; Michael Gordon,17,0,70,53
1657472650730,COGS 101A,A01,083621,Davis; Joshua Daniel,9,0,68,59
1657472656752,COGS 101B,A01,091572,Allen; Michael Gordon,12,0,65,53
1657472662777,COGS 101C,A01,083625,Delgado; Tania,17,0,35,18
1657472668884,COGS 107A,A01,083627,Boyle; Mary E. T.,13,0,60,47
1657472674905,COGS 118A,A01,083075,Gupta; Anjum,21,0,76,55
1657472680933,CSE 3,A50,083646,Miranda; Gregory Joseph,24,0,50,26
1657472686957,CSE 8A,A50,083650,Miranda; Gregory Joseph,17,1,56,39
1657472692995,CSE 11,A01,083080,Cao; Yingjun,6,15,40,34
1657472699019,CSE 12,A01,083652,Krause-Levy; Sophia Louisa,28,1,120,92
1657472705053,CSE 15L,A01,083654,Morris; Justin Loren,9,0,50,41
1657472705053,CSE 15L,A02,083655,Morris; Justin Loren,9,0,50,41
1657472711077,CSE 20,A01,083657,Tran; Khoa Dang,39,0,80,41
1657472717099,CSE 21,A01,095574,Bach; Quang Tran,22,0,48,26
1657472723122,CSE 30,A01,083084,Eldon; John,5,0,80,75
1657472723122,CSE 30,B01,095061,Bhaskar; Nishant,9,0,50,41
1657472729148,CSE 100,A01,083659,Cao; Yingjun,5,4,70,65
1657472735175,CSE 134B,A01,083661,Powell; Thomas Allan,22,0,100,78
1657472741197,CSE 140,A01,083663,Gungor; Onat,15,0,85,70
1657472747221,CSE 140L,A01,083088,Eldon; John,21,0,100,79
1657472753245,CSE 175,A01,083665,Kumar; Rakesh,3,0,25,22
1657472759270,CSE 190,A00,092507,Dubnov; Shlomo,8,0,20,12
1657472765297,ECE 45,A01,083139,Congero; Spencer William,6,0,75,69
1657472771322,ECE 65,A50,083695,Saad; Andrew S,12,0,30,18
1657472771322,ECE 65,A51,095125,Saad; Andrew S,24,0,26,2
1657472777351,ECE 109,A01,091882,Touri; Behrouz,19,0,70,51
1657472783379,ECE 180,A00,083140,Abi Samra; Nicholas Camill,1,0,30,29
1657472783379,ECE 180,B00,083141,Abi Samra; Nicholas Camill,0,0,30,30
1657472789403,MATH 10A,A01,083735,Patchell; Gregory David,2,0,30,28
1657472789403,MATH 10A,A02,083736,Patchell; Gregory David,20,0,30,10
1657472789403,MATH 10A,A03,083737,Patchell; Gregory David,16,0,30,14
1657472795431,MATH 10B,A01,083207,Lim; Seonhee,8,0,34,26
1657472795431,MATH 10B,A02,083208,Lim; Seonhee,9,0,35,26
1657472795431,MATH 10B,A03,093472,Lim; Seonhee,7,0,34,27
1657472795431,MATH 10B,B01,083739,Sinha; Shubham,12,0,30,18
1657472801455,MATH 18,A01,083743,Cinel; Cameron Alexander,7,0,30,23
1657472801455,MATH 18,A02,083744,Cinel; Cameron Alexander,17,0,30,13
1657472801455,MATH 18,A03,083745,Cinel; Cameron Alexander,9,0,30,21
1657472801455,MATH 18,B01,083748,Rideout; David Porter,5,0,37,32
1657472801455,MATH 18,B02,083749,Rideout; David Porter,5,0,36,31
1657472801455,MATH 18,B03,083750,Rideout; David Porter,3,0,37,34
1657472801455,MATH 18,B04,083751,Rideout; David Porter,6,0,36,30
1657472801455,MATH 18,B05,093473,Rideout; David Porter,6,0,36,30
1657472801455,MATH 18,B06,093474,Rideout; David Porter,6,0,36,30
1657472807478,MATH 20A,A01,083754,Zheng; Zequn,14,0,40,26
1657472813505,MATH 20B,A01,083756,Briones; Jor-el Thomas Caparas,4,0,36,32
1657472813505,MATH 20B,A02,083757,Briones; Jor-el Thomas Caparas,1,0,36,35
1657472813505,MATH 20B,A03,093475,Briones; Jor-el Thomas Caparas,2,0,36,34
1657472819535,MATH 20C,A01,083760,Briones; Jor-el Thomas Caparas,1,0,35,34
1657472819535,MATH 20C,A02,083761,Briones; Jor-el Thomas Caparas,8,0,35,27
1657472819535,MATH 20C,A03,093476,Briones; Jor-el Thomas Caparas,0,1,36,36
1657472819535,MATH 20C,B01,083762,Bach; Quang Tran,1,0,30,29
1657472825558,MATH 20D,A01,083765,Tran; Brian Kha,5,0,30,25
1657472825558,MATH 20D,A02,083766,Tran; Brian Kha,5,0,30,25
1657472825558,MATH 20D,A03,083767,Tran; Brian Kha,5,0,30,25
1657472831581,MATH 20E,A01,083771,Ganguly; Soumya,9,0,32,23
1657472831581,MATH 20E,A02,083772,Ganguly; Soumya,6,0,32,26
1657472831581,MATH 20E,B01,083773,Ciotti; Benjamin,20,0,35,15
1657472831581,MATH 20E,B02,083774,Ciotti; Benjamin,17,0,35,18
1657472837605,MATH 103A,A01,083777,Greenfeld; Be'Eri,3,0,36,33
1657472837605,MATH 103A,A02,083778,Greenfeld; Be'Eri,5,0,36,31
1657472837605,MATH 103A,A03,093561,Greenfeld; Be'Eri,5,0,36,31
1657472837605,MATH 103A,B01,083779,Greenfeld; Be'Eri,7,0,36,29
1657472837605,MATH 103A,B02,083780,Greenfeld; Be'Eri,4,0,36,32
1657472837605,MATH 103A,B03,093562,Greenfeld; Be'Eri,3,0,36,33
1657472843632,MATH 105,A01,085443,Carter; Anne Toulson,15,0,35,20
1657472843632,MATH 105,A02,093477,Carter; Anne Toulson,20,0,35,15
1657472849661,MATH 109,A01,083213,Ganzberger; Geoffrey Michael,2,0,34,32
1657472849661,MATH 109,A02,083214,Ganzberger; Geoffrey Michael,4,0,34,30
1657472849661,MATH 109,A03,093478,Ganzberger; Geoffrey Michael,2,0,34,32
1657472849661,MATH 109,B01,083215,Ganzberger; Geoffrey Michael,1,0,32,31
1657472849661,MATH 109,B02,083216,Ganzberger; Geoffrey Michael,2,0,32,30
1657472849661,MATH 109,B03,093479,Ganzberger; Geoffrey Michael,8,0,32,24
1657472855688,MATH 142A,A01,083219,Chow; Bennett,7,0,32,25
1657472855688,MATH 142A,A02,083220,Chow; Bennett,10,0,32,22
1657472855688,MATH 142A,A03,093480,Chow; Bennett,8,0,32,24
1657472855688,MATH 142A,B03,093481,Chow; Bennett,8,0,32,24
1657472855688,MATH 142A,B04,093558,Chow; Bennett,13,0,32,19
1657472855688,MATH 142A,B05,093559,Chow; Bennett,6,0,32,26
1657472861730,MATH 193A,A01,083224,Rotar; Vladimir,8,0,34,26
1657472861730,MATH 193A,A02,083225,Rotar; Vladimir,9,0,34,25
1657472861730,MATH 193A,A03,083781,Rotar; Vladimir,5,0,34,29
1657472861730,MATH 193A,A04,083782,Rotar; Vladimir,10,0,34,24
1657472861730,MATH 193A,A05,093482,Rotar; Vladimir,10,0,34,24
1657472867756,MATH 197,001,091859,McAuley; Julian John,9999,0,9999,0
1657472867756,MATH 197,002,095566,Kedlaya; Kiran S.,9997,0,9999,2
1657472867756,MATH 197,003,095567,Xiao; Ming,9999,0,9999,0
1657472867756,MATH 197,004,095571,Perols; Johan Lars,9998,0,9999,1
1657472874820,COGS 9,A01,083615,Shannon; Kyle Michael,9,0,75,66
1657472880843,COGS 11,A01,083617,Boyle; Mary E. T.,22,0,48,26
1657472886867,COGS 13,A01,083071,Bastos; Amalia Pinkusfeld,11,0,71,60
1657472892890,COGS 14A,A01,092681,Semenuks; Arturs,5,1,100,95
1657472898913,COGS 14B,A01,083073,Cheng; Tzu-Han,6,0,63,57
1657472904941,COGS 17,A01,092677,Semenuks; Arturs,6,0,81,75
1657472910964,COGS 100,A01,083619,Allen; Michael Gordon,17,0,70,53
1657472916988,COGS 101A,A01,083621,Davis; Joshua Daniel,9,0,68,59
1657472923013,COGS 101B,A01,091572,Allen; Michael Gordon,12,0,65,53
1657472929037,COGS 101C,A01,083625,Delgado; Tania,17,0,35,18
1657472935062,COGS 107A,A01,083627,Boyle; Mary E. T.,13,0,60,47
1657472941093,COGS 118A,A01,083075,Gupta; Anjum,21,0,76,55
1657472947115,CSE 3,A50,083646,Miranda; Gregory Joseph,24,0,50,26
1657472953144,CSE 8A,A50,083650,Miranda; Gregory Joseph,17,1,56,39
1657472959176,CSE 11,A01,083080,Cao; Yingjun,6,15,40,34
1657472965204,CSE 12,A01,083652,Krause-Levy; Sophia Louisa,28,1,120,92
1657472971226,CSE 15L,A01,083654,Morris; Justin Loren,9,0,50,41
1657472971226,CSE 15L,A02,083655,Morris; Justin Loren,9,0,50,41
1657472977251,CSE 20,A01,083657,Tran; Khoa Dang,39,0,80,41
1657472983275,CSE 21,A01,095574,Bach; Quang Tran,22,0,48,26
1657472989301,CSE 30,A01,083084,Eldon; John,5,0,80,75
1657472989301,CSE 30,B01,095061,Bhaskar; Nishant,9,0,50,41
1657472995331,CSE 100,A01,083659,Cao; Yingjun,5,4,70,65
1657473001359,CSE 134B,A01,083661,Powell; Thomas Allan,22,0,100,78
1657473007381,CSE 140,A01,083663,Gungor; Onat,15,0,85,70
1657473013409,CSE 140L,A01,083088,Eldon; John,21,0,100,79
1657473019432,CSE 175,A01,083665,Kumar; Rakesh,3,0,25,22
1657473025457,CSE 190,A00,092507,Dubnov; Shlomo,8,0,20,12
1657473031485,ECE 45,A01,083139,Congero; Spencer William,6,0,75,69
1657473037513,ECE 65,A50,083695,Saad; Andrew S,12,0,30,18
1657473037513,ECE 65,A51,095125,Saad; Andrew S,24,0,26,2
1657473043538,ECE 109,A01,091882,Touri; Behrouz,19,0,70,51
1657473049566,ECE 180,A00,083140,Abi Samra; Nicholas Camill,1,0,30,29
1657473049566,ECE 180,B00,083141,Abi Samra; Nicholas Camill,0,0,30,30
1657473055590,MATH 10A,A01,083735,Patchell; Gregory David,2,0,30,28
1657473055590,MATH 10A,A02,083736,Patchell; Gregory David,20,0,30,10
1657473055590,MATH 10A,A03,083737,Patchell; Gregory David,16,0,30,14
1657473061613,MATH 10B,A01,083207,Lim; Seonhee,8,0,34,26
1657473061613,MATH 10B,A02,083208,Lim; Seonhee,9,0,35,26
1657473061613,MATH 10B,A03,093472,Lim; Seonhee,7,0,34,27
1657473061613,MATH 10B,B01,083739,Sinha; Shubham,12,0,30,18
1657473067644,MATH 18,A01,083743,Cinel; Cameron Alexander,7,0,30,23
1657473067644,MATH 18,A02,083744,Cinel; Cameron Alexander,17,0,30,13
1657473067644,MATH 18,A03,083745,Cinel; Cameron Alexander,9,0,30,21
1657473067644,MATH 18,B01,083748,Rideout; David Porter,5,0,37,32
1657473067644,MATH 18,B02,083749,Rideout; David Porter,5,0,36,31
1657473067644,MATH 18,B03,083750,Rideout; David Porter,3,0,37,34
1657473067644,MATH 18,B04,083751,Rideout; David Porter,6,0,36,30
1657473067644,MATH 18,B05,093473,Rideout; David Porter,6,0,36,30
1657473067644,MATH 18,B06,093474,Rideout; David Porter,6,0,36,30
1657473073671,MATH 20A,A01,083754,Zheng; Zequn,14,0,40,26
1657473079694,MATH 20B,A01,083756,Briones; Jor-el Thomas Caparas,4,0,36,32
1657473079694,MATH 20B,A02,083757,Briones; Jor-el Thomas Caparas,1,0,36,35
1657473079694,MATH 20B,A03,093475,Briones; Jor-el Thomas Caparas,2,0,36,34
1657473085729,MATH 20C,A01,083760,Briones; Jor-el Thomas Caparas,1,0,35,34
1657473085729,MATH 20C,A02,083761,Briones; Jor-el Thomas Caparas,8,0,35,27
1657473085729,MATH 20C,A03,093476,Briones; Jor-el Thomas Caparas,0,1,36,36
1657473085729,MATH 20C,B01,083762,Bach; Quang Tran,1,0,30,29
1657473091751,MATH 20D,A01,083765,Tran; Brian Kha,5,0,30,25
1657473091751,MATH 20D,A02,083766,Tran; Brian Kha,5,0,30,25
1657473091751,MATH 20D,A03,083767,Tran; Brian Kha,5,0,30,25
1657473097783,MATH 20E,A01,083771,Ganguly; Soumya,9,0,32,23
1657473097783,MATH 20E,A02,083772,Ganguly; Soumya,6,0,32,26
1657473097783,MATH 20E,B01,083773,Ciotti; Benjamin,20,0,35,15
1657473097783,MATH 20E,B02,083774,Ciotti; Benjamin,17,0,35,18
1657473103814,MATH 103A,A01,083777,Greenfeld; Be'Eri,3,0,36,33
1657473103814,MATH 103A,A02,083778,Greenfeld; Be'Eri,5,0,36,31
1657473103814,MATH 103A,A03,093561,Greenfeld; Be'Eri,5,0,36,31
1657473103814,MATH 103A,B01,083779,Greenfeld; Be'Eri,7,0,36,29
1657473103814,MATH 103A,B02,083780,Greenfeld; Be'Eri,4,0,36,32
1657473103814,MATH 103A,B03,093562,Greenfeld; Be'Eri,3,0,36,33
1657473109836,MATH 105,A01,085443,Carter; Anne Toulson,15,0,35,20
1657473109836,MATH 105,A02,093477,Carter; Anne Toulson,20,0,35,15
1657473115861,MATH 109,A01,083213,Ganzberger; Geoffrey Michael,2,0,34,32
1657473115861,MATH 109,A02,083214,Ganzberger; Geoffrey Michael,4,0,34,30
1657473115861,MATH 109,A03,093478,Ganzberger; Geoffrey Michael,2,0,34,32
1657473115861,MATH 109,B01,083215,Ganzberger; Geoffrey Michael,1,0,32,31
1657473115861,MATH 109,B02,083216,Ganzberger; Geoffrey Michael,2,0,32,30
1657473115861,MATH 109,B03,093479,Ganzberger; Geoffrey Michael,8,0,32,24
1657473121889,MATH 142A,A01,083219,Chow; Bennett,7,0,32,25
1657473121889,MATH 142A,A02,083220,Chow; Bennett,10,0,32,22
1657473121889,MATH 142A,A03,093480,Chow; Bennett,8,0,32,24
1657473121889,MATH 142A,B03,093481,Chow; Bennett,8,0,32,24
1657473121889,MATH 142A,B04,093558,Chow; Bennett,13,0,32,19
1657473121889,MATH 142A,B05,093559,Chow; Bennett,6,0,32,26
1657473127913,MATH 193A,A01,083224,Rotar; Vladimir,8,0,34,26
1657473127913,MATH 193A,A02,083225,Rotar; Vladimir,9,0,34,25
1657473127913,MATH 193A,A03,083781,Rotar; Vladimir,5,0,34,29
1657473127913,MATH 193A,A04,083782,Rotar; Vladimir,10,0,34,24
1657473127913,MATH 193A,A05,093482,Rotar; Vladimir,10,0,34,24
1657473133935,MATH 197,001,091859,McAuley; Julian John,9999,0,9999,0
1657473133935,MATH 197,002,095566,Kedlaya; Kiran S.,9997,0,9999,2
1657473133935,MATH 197,003,095567,Xiao; Ming,9999,0,9999,0
1657473133935,MATH 197,004,095571,Perols; Johan Lars,9998,0,9999,1
1657473140994,COGS 9,A01,083615,Shannon; Kyle Michael,9,0,75,66
1657473147018,COGS 11,A01,083617,Boyle; Mary E. T.,22,0,48,26
1657473153041,COGS 13,A01,083071,Bastos; Amalia Pinkusfeld,11,0,71,60
1657473159064,COGS 14A,A01,092681,Semenuks; Arturs,5,1,100,95
1657473165087,COGS 14B,A01,083073,Cheng; Tzu-Han,6,0,63,57
1657473171111,COGS 17,A01,092677,Semenuks; Arturs,6,0,81,75
1657473177135,COGS 100,A01,083619,Allen; Michael Gordon,17,0,70,53
1657473183159,COGS 101A,A01,083621,Davis; Joshua Daniel,9,0,68,59
1657473189185,COGS 101B,A01,091572,Allen; Michael Gordon,12,0,65,53
1657473195210,COGS 101C,A01,083625,Delgado; Tania,17,0,35,18
1657473201235,COGS 107A,A01,083627,Boyle; Mary E. T.,13,0,60,47
1657473207258,COGS 118A,A01,083075,Gupta; Anjum,21,0,76,55
1657473213285,CSE 3,A50,083646,Miranda; Gregory Joseph,24,0,50,26
1657473219308,CSE 8A,A50,083650,Miranda; Gregory Joseph,17,1,56,39
1657473225339,CSE 11,A01,083080,Cao; Yingjun,6,15,40,34
1657473231362,CSE 12,A01,083652,Krause-Levy; Sophia Louisa,28,1,120,92
1657473237390,CSE 15L,A01,083654,Morris; Justin Loren,9,0,50,41
1657473237390,CSE 15L,A02,083655,Morris; Justin Loren,9,0,50,41
1657473243414,CSE 20,A01,083657,Tran; Khoa Dang,39,0,80,41
1657473249446,CSE 21,A01,095574,Bach; Quang Tran,22,0,48,26
1657473255480,CSE 30,A01,083084,Eldon; John,5,0,80,75
1657473255480,CSE 30,B01,095061,Bhaskar; Nishant,9,0,50,41
1657473261504,CSE 100,A01,083659,Cao; Yingjun,5,4,70,65
1657473267599,CSE 134B,A01,083661,Powell; Thomas Allan,22,0,100,78
1657473273627,CSE 140,A01,083663,Gungor; Onat,15,0,85,70
1657473279655,CSE 140L,A01,083088,Eldon; John,21,0,100,79
1657473285682,CSE 175,A01,083665,Kumar; Rakesh,3,0,25,22
1657473291705,CSE 190,A00,092507,Dubnov; Shlomo,8,0,20,12
1657473297734,ECE 45,A01,083139,Congero; Spencer William,6,0,75,69
1657473303758,ECE 65,A50,083695,Saad; Andrew S,12,0,30,18
1657473303758,ECE 65,A51,095125,Saad; Andrew S,24,0,26,2
1657473309784,ECE 109,A01,091882,Touri; Behrouz,19,0,70,51
1657473315806,ECE 180,A00,083140,Abi Samra; Nicholas Camill,1,0,30,29
1657473315806,ECE 180,B00,083141,Abi Samra; Nicholas Camill,0,0,30,30
1657473321834,MATH 10A,A01,083735,Patchell; Gregory David,2,0,30,28
1657473321834,MATH 10A,A02,083736,Patchell; Gregory David,20,0,30,10
1657473321834,MATH 10A,A03,083737,Patchell; Gregory David,16,0,30,14
1657473327858,MATH 10B,A01,083207,Lim; Seonhee,8,0,34,26
1657473327858,MATH 10B,A02,083208,Lim; Seonhee,9,0,35,26
1657473327858,MATH 10B,A03,093472,Lim; Seonhee,7,0,34,27
1657473327858,MATH 10B,B01,083739,Sinha; Shubham,12,0,30,18
1657473333884,MATH 18,A01,083743,Cinel; Cameron Alexander,7,0,30,23
1657473333884,MATH 18,A02,083744,Cinel; Cameron Alexander,17,0,30,13
1657473333884,MATH 18,A03,083745,Cinel; Cameron Alexander,9,0,30,21
1657473333884,MATH 18,B01,083748,Rideout; David Porter,5,0,37,32
1657473333884,MATH 18,B02,083749,Rideout; David Porter,5,0,36,31
1657473333884,MATH 18,B03,083750,Rideout; David Porter,3,0,37,34
1657473333884,MATH 18,B04,083751,Rideout; David Porter,6,0,36,30
1657473333884,MATH 18,B05,093473,Rideout; David Porter,6,0,36,30
1657473333884,MATH 18,B06,093474,Rideout; David Porter,6,0,36,30
1657473339919,MATH 20A,A01,083754,Zheng; Zequn,14,0,40,26
1657473345948,MATH 20B,A01,083756,Briones; Jor-el Thomas Caparas,4,0,36,32
1657473345948,MATH 20B,A02,083757,Briones; Jor-el Thomas Caparas,1,0,36,35
1657473345948,MATH 20B,A03,093475,Briones; Jor-el Thomas Caparas,2,0,36,34
1657473351972,MATH 20C,A01,083760,Briones; Jor-el Thomas Caparas,1,0,35,34
1657473351972,MATH 20C,A02,083761,Briones; Jor-el Thomas Caparas,8,0,35,27
1657473351972,MATH 20C,A03,093476,Briones; Jor-el Thomas Caparas,0,1,36,36
1657473351972,MATH 20C,B01,083762,Bach; Quang Tran,1,0,30,29
1657473357996,MATH 20D,A01,083765,Tran; Brian Kha,5,0,30,25
1657473357996,MATH 20D,A02,083766,Tran; Brian Kha,5,0,30,25
1657473357996,MATH 20D,A03,083767,Tran; Brian Kha,5,0,30,25
1657473364020,MATH 20E,A01,083771,Ganguly; Soumya,9,0,32,23
1657473364020,MATH 20E,A02,083772,Ganguly; Soumya,6,0,32,26
1657473364020,MATH 20E,B01,083773,Ciotti; Benjamin,20,0,35,15
1657473364020,MATH 20E,B02,083774,Ciotti; Benjamin,17,0,35,18
1657473370049,MATH 103A,A01,083777,Greenfeld; Be'Eri,3,0,36,33
1657473370049,MATH 103A,A02,083778,Greenfeld; Be'Eri,5,0,36,31
1657473370049,MATH 103A,A03,093561,Greenfeld; Be'Eri,5,0,36,31
1657473370049,MATH 103A,B01,083779,Greenfeld; Be'Eri,7,0,36,29
1657473370049,MATH 103A,B02,083780,Greenfeld; Be'Eri,4,0,36,32
1657473370049,MATH 103A,B03,093562,Greenfeld; Be'Eri,3,0,36,33
1657473376072,MATH 105,A01,085443,Carter; Anne Toulson,15,0,35,20
1657473376072,MATH 105,A02,093477,Carter; Anne Toulson,20,0,35,15
1657473382097,MATH 109,A01,083213,Ganzberger; Geoffrey Michael,2,0,34,32
1657473382097,MATH 109,A02,083214,Ganzberger; Geoffrey Michael,4,0,34,30
1657473382097,MATH 109,A03,093478,Ganzberger; Geoffrey Michael,2,0,34,32
1657473382097,MATH 109,B01,083215,Ganzberger; Geoffrey Michael,1,0,32,31
1657473382097,MATH 109,B02,083216,Ganzberger; Geoffrey Michael,2,0,32,30
1657473382097,MATH 109,B03,093479,Ganzberger; Geoffrey Michael,8,0,32,24
1657473388128,MATH 142A,A01,083219,Chow; Bennett,7,0,32,25
1657473388128,MATH 142A,A02,083220,Chow; Bennett,10,0,32,22
1657473388128,MATH 142A,A03,093480,Chow; Bennett,8,0,32,24
1657473388128,MATH 142A,B03,093481,Chow; Bennett,8,0,32,24
1657473388128,MATH 142A,B04,093558,Chow; Bennett,13,0,32,19
1657473388128,MATH 142A,B05,093559,Chow; Bennett,6,0,32,26
1657473394157,MATH 193A,A01,083224,Rotar; Vladimir,8,0,34,26
1657473394157,MATH 193A,A02,083225,Rotar; Vladimir,9,0,34,25
1657473394157,MATH 193A,A03,083781,Rotar; Vladimir,5,0,34,29
1657473394157,MATH 193A,A04,083782,Rotar; Vladimir,10,0,34,24
1657473394157,MATH 193A,A05,093482,Rotar; Vladimir,10,0,34,24
1657473400179,MATH 197,001,091859,McAuley; Julian John,9999,0,9999,0
1657473400179,MATH 197,002,095566,Kedlaya; Kiran S.,9997,0,9999,2
1657473400179,MATH 197,003,095567,Xiao; Ming,9999,0,9999,0
1657473400179,MATH 197,004,095571,Perols; Johan Lars,9998,0,9999,1
1657473407255,COGS 9,A01,083615,Shannon; Kyle Michael,9,0,75,66
1657473413278,COGS 11,A01,083617,Boyle; Mary E. T.,22,0,48,26
1657473419303,COGS 13,A01,083071,Bastos; Amalia Pinkusfeld,11,0,71,60
1657473425326,COGS 14A,A01,092681,Semenuks; Arturs,5,1,100,95
1657473431349,COGS 14B,A01,083073,Cheng; Tzu-Han,6,0,63,57
1657473437384,COGS 17,A01,092677,Semenuks; Arturs,6,0,81,75
1657473443410,COGS 100,A01,083619,Allen; Michael Gordon,17,0,70,53
1657473449433,COGS 101A,A01,083621,Davis; Joshua Daniel,9,0,68,59
1657473455455,COGS 101B,A01,091572,Allen; Michael Gordon,12,0,65,53
1657473461477,COGS 101C,A01,083625,Delgado; Tania,17,0,35,18
1657473467505,COGS 107A,A01,083627,Boyle; Mary E. T.,13,0,60,47
1657473473533,COGS 118A,A01,083075,Gupta; Anjum,21,0,76,55
1657473479559,CSE 3,A50,083646,Miranda; Gregory Joseph,24,0,50,26
1657473485587,CSE 8A,A50,083650,Miranda; Gregory Joseph,17,1,56,39
1657473491613,CSE 11,A01,083080,Cao; Yingjun,6,15,40,34
1657473497639,CSE 12,A01,083652,Krause-Levy; Sophia Louisa,28,1,120,92
1657473503668,CSE 15L,A01,083654,Morris; Justin Loren,9,0,50,41
1657473503668,CSE 15L,A02,083655,Morris; Justin Loren,9,0,50,41
1657473509690,CSE 20,A01,083657,Tran; Khoa Dang,39,0,80,41
1657473515725,CSE 21,A01,095574,Bach; Quang Tran,22,0,48,26
1657473521749,CSE 30,A01,083084,Eldon; John,5,0,80,75
1657473521749,CSE 30,B01,095061,Bhaskar; Nishant,9,0,50,41
1657473527774,CSE 100,A01,083659,Cao; Yingjun,5,4,70,65
1657473533797,CSE 134B,A01,083661,Powell; Thomas Allan,22,0,100,78
1657473539821,CSE 140,A01,083663,Gungor; Onat,15,0,85,70
1657473545844,CSE 140L,A01,083088,Eldon; John,21,0,100,79
1657473551871,CSE 175,A01,083665,Kumar; Rakesh,3,0,25,22
1657473557893,CSE 190,A00,092507,Dubnov; Shlomo,8,0,20,12
1657473563926,ECE 45,A01,083139,Congero; Spencer William,6,0,75,69
1657473569950,ECE 65,A50,083695,Saad; Andrew S,12,0,30,18
1657473569950,ECE 65,A51,095125,Saad; Andrew S,24,0,26,2
1657473575982,ECE 109,A01,091882,Touri; Behrouz,19,0,70,51
1657473582006,ECE 180,A00,083140,Abi Samra; Nicholas Camill,1,0,30,29
1657473582006,ECE 180,B00,083141,Abi Samra; Nicholas Camill,0,0,30,30
1657473588034,MATH 10A,A01,083735,Patchell; Gregory David,2,0,30,28
1657473588034,MATH 10A,A02,083736,Patchell; Gregory David,20,0,30,10
1657473588034,MATH 10A,A03,083737,Patchell; Gregory David,16,0,30,14
1657473594064,MATH 10B,A01,083207,Lim; Seonhee,8,0,34,26
1657473594064,MATH 10B,A02,083208,Lim; Seonhee,9,0,35,26
1657473594064,MATH 10B,A03,093472,Lim; Seonhee,7,0,34,27
1657473594064,MATH 10B,B01,083739,Sinha; Shubham,12,0,30,18
1657473600090,MATH 18,A01,083743,Cinel; Cameron Alexander,7,0,30,23
1657473600090,MATH 18,A02,083744,Cinel; Cameron Alexander,17,0,30,13
1657473600090,MATH 18,A03,083745,Cinel; Cameron Alexander,9,0,30,21
1657473600090,MATH 18,B01,083748,Rideout; David Porter,5,0,37,32
1657473600090,MATH 18,B02,083749,Rideout; David Porter,5,0,36,31
1657473600090,MATH 18,B03,083750,Rideout; David Porter,3,0,37,34
1657473600090,MATH 18,B04,083751,Rideout; David Porter,6,0,36,30
1657473600090,MATH 18,B05,093473,Rideout; David Porter,6,0,36,30
1657473600090,MATH 18,B06,093474,Rideout; David Porter,6,0,36,30
1657473606112,MATH 20A,A01,083754,Zheng; Zequn,14,0,40,26
1657473612134,MATH 20B,A01,083756,Briones; Jor-el Thomas Caparas,4,0,36,32
1657473612134,MATH 20B,A02,083757,Briones; Jor-el Thomas Caparas,1,0,36,35
1657473612134,MATH 20B,A03,093475,Briones; Jor-el Thomas Caparas,2,0,36,34
1657473618158,MATH 20C,A01,083760,Briones; Jor-el Thomas Caparas,1,0,35,34
1657473618158,MATH 20C,A02,083761,Briones; Jor-el Thomas Caparas,8,0,35,27
1657473618158,MATH 20C,A03,093476,Briones; Jor-el Thomas Caparas,0,1,36,36
1657473618158,MATH 20C,B01,083762,Bach; Quang Tran,1,0,30,29
1657473624196,MATH 20D,A01,083765,Tran; Brian Kha,5,0,30,25
1657473624196,MATH 20D,A02,083766,Tran; Brian Kha,5,0,30,25
1657473624196,MATH 20D,A03,083767,Tran; Brian Kha,5,0,30,25
1657473630225,MATH 20E,A01,083771,Ganguly; Soumya,9,0,32,23
1657473630225,MATH 20E,A02,083772,Ganguly; Soumya,6,0,32,26
1657473630225,MATH 20E,B01,083773,Ciotti; Benjamin,20,0,35,15
1657473630225,MATH 20E,B02,083774,Ciotti; Benjamin,17,0,35,18
1657473636251,MATH 103A,A01,083777,Greenfeld; Be'Eri,3,0,36,33
1657473636251,MATH 103A,A02,083778,Greenfeld; Be'Eri,5,0,36,31
1657473636251,MATH 103A,A03,093561,Greenfeld; Be'Eri,5,0,36,31
1657473636251,MATH 103A,B01,083779,Greenfeld; Be'Eri,7,0,36,29
1657473636251,MATH 103A,B02,083780,Greenfeld; Be'Eri,4,0,36,32
1657473636251,MATH 103A,B03,093562,Greenfeld; Be'Eri,3,0,36,33
1657473642277,MATH 105,A01,085443,Carter; Anne Toulson,15,0,35,20
1657473642277,MATH 105,A02,093477,Carter; Anne Toulson,20,0,35,15
1657473648305,MATH 109,A01,083213,Ganzberger; Geoffrey Michael,2,0,34,32
1657473648305,MATH 109,A02,083214,Ganzberger; Geoffrey Michael,4,0,34,30
1657473648305,MATH 109,A03,093478,Ganzberger; Geoffrey Michael,2,0,34,32
1657473648305,MATH 109,B01,083215,Ganzberger; Geoffrey Michael,1,0,32,31
1657473648305,MATH 109,B02,083216,Ganzberger; Geoffrey Michael,2,0,32,30
1657473648305,MATH 109,B03,093479,Ganzberger; Geoffrey Michael,8,0,32,24
1657473654333,MATH 142A,A01,083219,Chow; Bennett,7,0,32,25
1657473654333,MATH 142A,A02,083220,Chow; Bennett,10,0,32,22
1657473654333,MATH 142A,A03,093480,Chow; Bennett,8,0,32,24
1657473654333,MATH 142A,B03,093481,Chow; Bennett,8,0,32,24
1657473654333,MATH 142A,B04,093558,Chow; Bennett,13,0,32,19
1657473654333,MATH 142A,B05,093559,Chow; Bennett,6,0,32,26
1657473660359,MATH 193A,A01,083224,Rotar; Vladimir,8,0,34,26
1657473660359,MATH 193A,A02,083225,Rotar; Vladimir,9,0,34,25
1657473660359,MATH 193A,A03,083781,Rotar; Vladimir,5,0,34,29
1657473660359,MATH 193A,A04,083782,Rotar; Vladimir,10,0,34,24
1657473660359,MATH 193A,A05,093482,Rotar; Vladimir,10,0,34,24
1657473666385,MATH 197,001,091859,McAuley; Julian John,9999,0,9999,0
1657473666385,MATH 197,002,095566,Kedlaya; Kiran S.,9997,0,9999,2
1657473666385,MATH 197,003,095567,Xiao; Ming,9999,0,9999,0
1657473666385,MATH 197,004,095571,Perols; Johan Lars,9998,0,9999,1
1657473673454,COGS 9,A01,083615,Shannon; Kyle Michael,9,0,75,66
1657473679481,COGS 11,A01,083617,Boyle; Mary E. T.,22,0,48,26
1657473685508,COGS 13,A01,083071,Bastos; Amalia Pinkusfeld,11,0,71,60
1657473691535,COGS 14A,A01,092681,Semenuks; Arturs,5,1,100,95
1657473697557,COGS 14B,A01,083073,Cheng; Tzu-Han,6,0,63,57
1657473703579,COGS 17,A01,092677,Semenuks; Arturs,6,0,81,75
1657473709601,COGS 100,A01,083619,Allen; Michael Gordon,17,0,70,53
1657473715624,COGS 101A,A01,083621,Davis; Joshua Daniel,9,0,68,59
1657473721648,COGS 101B,A01,091572,Allen; Michael Gordon,12,0,65,53
1657473727695,COGS 101C,A01,083625,Delgado; Tania,17,0,35,18
1657473733718,COGS 107A,A01,083627,Boyle; Mary E. T.,13,0,60,47
1657473739742,COGS 118A,A01,083075,Gupta; Anjum,21,0,76,55
1657473745779,CSE 3,A50,083646,Miranda; Gregory Joseph,24,0,50,26
1657473751806,CSE 8A,A50,083650,Miranda; Gregory Joseph,17,1,56,39
1657473757832,CSE 11,A01,083080,Cao; Yingjun,6,15,40,34
1657473763856,CSE 12,A01,083652,Krause-Levy; Sophia Louisa,28,1,120,92
1657473769886,CSE 15L,A01,083654,Morris; Justin Loren,9,0,50,41
1657473769886,CSE 15L,A02,083655,Morris; Justin Loren,9,0,50,41
1657473775908,CSE 20,A01,083657,Tran; Khoa Dang,39,0,80,41
1657473781931,CSE 21,A01,095574,Bach; Quang Tran,22,0,48,26
1657473787953,CSE 30,A01,083084,Eldon; John,5,0,80,75
1657473787953,CSE 30,B01,095061,Bhaskar; Nishant,9,0,50,41
1657473793979,CSE 100,A01,083659,Cao; Yingjun,5,4,70,65
1657473800003,CSE 134B,A01,083661,Powell; Thomas Allan,22,0,100,78
1657473806030,CSE 140,A01,083663,Gungor; Onat,15,0,85,70
1657473812062,CSE 140L,A01,083088,Eldon; John,21,0,100,79
1657473818086,CSE 175,A01,083665,Kumar; Rakesh,3,0,25,22
1657473824126,CSE 190,A00,092507,Dubnov; Shlomo,8,0,20,12
1657473830150,ECE 45,A01,083139,Congero; Spencer William,6,0,75,69
1657473836177,ECE 65,A50,083695,Saad; Andrew S,12,0,30,18
1657473836177,ECE 65,A51,095125,Saad; Andrew S,24,0,26,2
1657473842204,ECE 109,A01,091882,Touri; Behrouz,19,0,70,51
1657473848245,ECE 180,A00,083140,Abi Samra; Nicholas Camill,1,0,30,29
1657473848245,ECE 180,B00,083141,Abi Samra; Nicholas Camill,0,0,30,30
1657473854269,MATH 10A,A01,083735,Patchell; Gregory David,2,0,30,28
1657473854269,MATH 10A,A02,083736,Patchell; Gregory David,20,0,30,10
1657473854269,MATH 10A,A03,083737,Patchell; Gregory David,16,0,30,14
1657473860291,MATH 10B,A01,083207,Lim; Seonhee,8,0,34,26
1657473860291,MATH 10B,A02,083208,Lim; Seonhee,9,0,35,26
1657473860291,MATH 10B,A03,093472,Lim; Seonhee,7,0,34,27
1657473860291,MATH 10B,B01,083739,Sinha; Shubham,12,0,30,18
1657473866402,MATH 18,A01,083743,Cinel; Cameron Alexander,7,0,30,23
1657473866402,MATH 18,A02,083744,Cinel; Cameron Alexander,17,0,30,13
1657473866402,MATH 18,A03,083745,Cinel; Cameron Alexander,9,0,30,21
1657473866402,MATH 18,B01,083748,Rideout; David Porter,5,0,37,32
1657473866402,MATH 18,B02,083749,Rideout; David Porter,5,0,36,31
1657473866402,MATH 18,B03,083750,Rideout; David Porter,3,0,37,34
1657473866402,MATH 18,B04,083751,Rideout; David Porter,6,0,36,30
1657473866402,MATH 18,B05,093473,Rideout; David Porter,6,0,36,30
1657473866402,MATH 18,B06,093474,Rideout; David Porter,6,0,36,30
1657473872429,MATH 20A,A01,083754,Zheng; Zequn,14,0,40,26
1657473878451,MATH 20B,A01,083756,Briones; Jor-el Thomas Caparas,4,0,36,32
1657473878451,MATH 20B,A02,083757,Briones; Jor-el Thomas Caparas,1,0,36,35
1657473878451,MATH 20B,A03,093475,Briones; Jor-el Thomas Caparas,2,0,36,34
1657473884487,MATH 20C,A01,083760,Briones; Jor-el Thomas Caparas,1,0,35,34
1657473884487,MATH 20C,A02,083761,Briones; Jor-el Thomas Caparas,8,0,35,27
1657473884487,MATH 20C,A03,093476,Briones; Jor-el Thomas Caparas,0,1,36,36
1657473884487,MATH 20C,B01,083762,Bach; Quang Tran,1,0,30,29
1657473890516,MATH 20D,A01,083765,Tran; Brian Kha,5,0,30,25
1657473890516,MATH 20D,A02,083766,Tran; Brian Kha,5,0,30,25
1657473890516,MATH 20D,A03,083767,Tran; Brian Kha,5,0,30,25
1657473896538,MATH 20E,A01,083771,Ganguly; Soumya,9,0,32,23
1657473896538,MATH 20E,A02,083772,Ganguly; Soumya,6,0,32,26
1657473896538,MATH 20E,B01,083773,Ciotti; Benjamin,20,0,35,15
1657473896538,MATH 20E,B02,083774,Ciotti; Benjamin,17,0,35,18
1657473902566,MATH 103A,A01,083777,Greenfeld; Be'Eri,3,0,36,33
1657473902566,MATH 103A,A02,083778,Greenfeld; Be'Eri,5,0,36,31
1657473902566,MATH 103A,A03,093561,Greenfeld; Be'Eri,5,0,36,31
1657473902566,MATH 103A,B01,083779,Greenfeld; Be'Eri,7,0,36,29
1657473902566,MATH 103A,B02,083780,Greenfeld; Be'Eri,4,0,36,32
1657473902566,MATH 103A,B03,093562,Greenfeld; Be'Eri,3,0,36,33
1657473908594,MATH 105,A01,085443,Carter; Anne Toulson,15,0,35,20
1657473908594,MATH 105,A02,093477,Carter; Anne Toulson,20,0,35,15
1657473914622,MATH 109,A01,083213,Ganzberger; Geoffrey Michael,2,0,34,32
1657473914622,MATH 109,A02,083214,Ganzberger; Geoffrey Michael,4,0,34,30
1657473914622,MATH 109,A03,093478,Ganzberger; Geoffrey Michael,2,0,34,32
1657473914622,MATH 109,B01,083215,Ganzberger; Geoffrey Michael,1,0,32,31
1657473914622,MATH 109,B02,083216,Ganzberger; Geoffrey Michael,2,0,32,30
1657473914622,MATH 109,B03,093479,Ganzberger; Geoffrey Michael,8,0,32,24
1657473920646,MATH 142A,A01,083219,Chow; Bennett,7,0,32,25
1657473920646,MATH 142A,A02,083220,Chow; Bennett,10,0,32,22
1657473920646,MATH 142A,A03,093480,Chow; Bennett,8,0,32,24
1657473920646,MATH 142A,B03,093481,Chow; Bennett,8,0,32,24
1657473920646,MATH 142A,B04,093558,Chow; Bennett,13,0,32,19
1657473920646,MATH 142A,B05,093559,Chow; Bennett,6,0,32,26
1657473926671,MATH 193A,A01,083224,Rotar; Vladimir,8,0,34,26
1657473926671,MATH 193A,A02,083225,Rotar; Vladimir,9,0,34,25
1657473926671,MATH 193A,A03,083781,Rotar; Vladimir,5,0,34,29
1657473926671,MATH 193A,A04,083782,Rotar; Vladimir,10,0,34,24
1657473926671,MATH 193A,A05,093482,Rotar; Vladimir,10,0,34,24
1657473932694,MATH 197,001,091859,McAuley; Julian John,9999,0,9999,0
1657473932694,MATH 197,002,095566,Kedlaya; Kiran S.,9997,0,9999,2
1657473932694,MATH 197,003,095567,Xiao; Ming,9999,0,9999,0
1657473932694,MATH 197,004,095571,Perols; Johan Lars,9998,0,9999,1
1657473939746,COGS 9,A01,083615,Shannon; Kyle Michael,9,0,75,66
1657473945773,COGS 11,A01,083617,Boyle; Mary E. T.,22,0,48,26
1657473951811,COGS 13,A01,083071,Bastos; Amalia Pinkusfeld,11,0,71,60
1657473957838,COGS 14A,A01,092681,Semenuks; Arturs,5,1,100,95
1657473963865,COGS 14B,A01,083073,Cheng; Tzu-Han,6,0,63,57
1657473969889,COGS 17,A01,092677,Semenuks; Arturs,6,0,81,75
1657473975915,COGS 100,A01,083619,Allen; Michael Gordon,17,0,70,53
1657473981953,COGS 101A,A01,083621,Davis; Joshua Daniel,9,0,68,59
1657473987979,COGS 101B,A01,091572,Allen; Michael Gordon,12,0,65,53
1657473994002,COGS 101C,A01,083625,Delgado; Tania,17,0,35,18
1657474000038,COGS 107A,A01,083627,Boyle; Mary E. T.,13,0,60,47
1657474006063,COGS 118A,A01,083075,Gupta; Anjum,21,0,76,55
1657474012087,CSE 3,A50,083646,Miranda; Gregory Joseph,24,0,50,26
1657474018110,CSE 8A,A50,083650,Miranda; Gregory Joseph,17,1,56,39
1657474024136,CSE 11,A01,083080,Cao; Yingjun,6,15,40,34
1657474030163,CSE 12,A01,083652,Krause-Levy; Sophia Louisa,28,1,120,92
1657474036186,CSE 15L,A01,083654,Morris; Justin Loren,9,0,50,41
1657474036186,CSE 15L,A02,083655,Morris; Justin Loren,9,0,50,41
1657474042208,CSE 20,A01,083657,Tran; Khoa Dang,39,0,80,41
1657474048235,CSE 21,A01,095574,Bach; Quang Tran,22,0,48,26
1657474054259,CSE 30,A01,083084,Eldon; John,5,0,80,75
1657474054259,CSE 30,B01,095061,Bhaskar; Nishant,9,0,50,41
1657474060281,CSE 100,A01,083659,Cao; Yingjun,5,4,70,65
1657474066309,CSE 134B,A01,083661,Powell; Thomas Allan,22,0,100,78
1657474072332,CSE 140,A01,083663,Gungor; Onat,15,0,85,70
1657474078375,CSE 140L,A01,083088,Eldon; John,21,0,100,79
1657474084398,CSE 175,A01,083665,Kumar; Rakesh,3,0,25,22
1657474090427,CSE 190,A00,092507,Dubnov; Shlomo,8,0,20,12
1657474096451,ECE 45,A01,083139,Congero; Spencer William,6,0,75,69
1657474102473,ECE 65,A50,083695,Saad; Andrew S,12,0,30,18
1657474102473,ECE 65,A51,095125,Saad; Andrew S,24,0,26,2
1657474108501,ECE 109,A01,091882,Touri; Behrouz,19,0,70,51
1657474114533,ECE 180,A00,083140,Abi Samra; Nicholas Camill,1,0,30,29
1657474114533,ECE 180,B00,083141,Abi Samra; Nicholas Camill,0,0,30,30
1657474120556,MATH 10A,A01,083735,Patchell; Gregory David,2,0,30,28
1657474120556,MATH 10A,A02,083736,Patchell; Gregory David,20,0,30,10
1657474120556,MATH 10A,A03,083737,Patchell; Gregory David,16,0,30,14
1657474126584,MATH 10B,A01,083207,Lim; Seonhee,8,0,34,26
1657474126584,MATH 10B,A02,083208,Lim; Seonhee,9,0,35,26
1657474126584,MATH 10B,A03,093472,Lim; Seonhee,7,0,34,27
1657474126584,MATH 10B,B01,083739,Sinha; Shubham,12,0,30,18
1657474132608,MATH 18,A01,083743,Cinel; Cameron Alexander,7,0,30,23
1657474132608,MATH 18,A02,083744,Cinel; Cameron Alexander,17,0,30,13
1657474132608,MATH 18,A03,083745,Cinel; Cameron Alexander,9,0,30,21
1657474132608,MATH 18,B01,083748,Rideout; David Porter,5,0,37,32
1657474132608,MATH 18,B02,083749,Rideout; David Porter,5,0,36,31
1657474132608,MATH 18,B03,083750,Rideout; David Porter,3,0,37,34
1657474132608,MATH 18,B04,083751,Rideout; David Porter,6,0,36,30
1657474132608,MATH 18,B05,093473,Rideout; David Porter,6,0,36,30
1657474132608,MATH 18,B06,093474,Rideout; David Porter,6,0,36,30
1657474138633,MATH 20A,A01,083754,Zheng; Zequn,14,0,40,26
1657474144663,MATH 20B,A01,083756,Briones; Jor-el Thomas Caparas,4,0,36,32
1657474144663,MATH 20B,A02,083757,Briones; Jor-el Thomas Caparas,1,0,36,35
1657474144663,MATH 20B,A03,093475,Briones; Jor-el Thomas Caparas,2,0,36,34
1657474150692,MATH 20C,A01,083760,Briones; Jor-el Thomas Caparas,1,0,35,34
1657474150692,MATH 20C,A02,083761,Briones; Jor-el Thomas Caparas,8,0,35,27
1657474150692,MATH 20C,A03,093476,Briones; Jor-el Thomas Caparas,0,1,36,36
1657474150692,MATH 20C,B01,083762,Bach; Quang Tran,1,0,30,29
1657474156720,MATH 20D,A01,083765,Tran; Brian Kha,5,0,30,25
1657474156720,MATH 20D,A02,083766,Tran; Brian Kha,5,0,30,25
1657474156720,MATH 20D,A03,083767,Tran; Brian Kha,5,0,30,25
1657474162743,MATH 20E,A01,083771,Ganguly; Soumya,9,0,32,23
1657474162743,MATH 20E,A02,083772,Ganguly; Soumya,6,0,32,26
1657474162743,MATH 20E,B01,083773,Ciotti; Benjamin,20,0,35,15
1657474162743,MATH 20E,B02,083774,Ciotti; Benjamin,17,0,35,18
1657474168765,MATH 103A,A01,083777,Greenfeld; Be'Eri,3,0,36,33
1657474168765,MATH 103A,A02,083778,Greenfeld; Be'Eri,5,0,36,31
1657474168765,MATH 103A,A03,093561,Greenfeld; Be'Eri,5,0,36,31
1657474168765,MATH 103A,B01,083779,Greenfeld; Be'Eri,7,0,36,29
1657474168765,MATH 103A,B02,083780,Greenfeld; Be'Eri,4,0,36,32
1657474168765,MATH 103A,B03,093562,Greenfeld; Be'Eri,3,0,36,33
1657474174788,MATH 105,A01,085443,Carter; Anne Toulson,15,0,35,20
1657474174788,MATH 105,A02,093477,Carter; Anne Toulson,20,0,35,15
1657474180810,MATH 109,A01,083213,Ganzberger; Geoffrey Michael,2,0,34,32
1657474180810,MATH 109,A02,083214,Ganzberger; Geoffrey Michael,4,0,34,30
1657474180810,MATH 109,A03,093478,Ganzberger; Geoffrey Michael,2,0,34,32
1657474180810,MATH 109,B01,083215,Ganzberger; Geoffrey Michael,1,0,32,31
1657474180810,MATH 109,B02,083216,Ganzberger; Geoffrey Michael,2,0,32,30
1657474180810,MATH 109,B03,093479,Ganzberger; Geoffrey Michael,8,0,32,24
1657474186837,MATH 142A,A01,083219,Chow; Bennett,7,0,32,25
1657474186837,MATH 142A,A02,083220,Chow; Bennett,10,0,32,22
1657474186837,MATH 142A,A03,093480,Chow; Bennett,8,0,32,24
1657474186837,MATH 142A,B03,093481,Chow; Bennett,8,0,32,24
1657474186837,MATH 142A,B04,093558,Chow; Bennett,13,0,32,19
1657474186837,MATH 142A,B05,093559,Chow; Bennett,6,0,32,26
1657474192864,MATH 193A,A01,083224,Rotar; Vladimir,8,0,34,26
1657474192864,MATH 193A,A02,083225,Rotar; Vladimir,9,0,34,25
1657474192864,MATH 193A,A03,083781,Rotar; Vladimir,5,0,34,29
1657474192864,MATH 193A,A04,083782,Rotar; Vladimir,10,0,34,24
1657474192864,MATH 193A,A05,093482,Rotar; Vladimir,10,0,34,24
1657474198890,MATH 197,001,091859,McAuley; Julian John,9999,0,9999,0
1657474198890,MATH 197,002,095566,Kedlaya; Kiran S.,9997,0,9999,2
1657474198890,MATH 197,003,095567,Xiao; Ming,9999,0,9999,0
1657474198890,MATH 197,004,095571,Perols; Johan Lars,9998,0,9999,1
1657474205952,COGS 9,A01,083615,Shannon; Kyle Michael,9,0,75,66
1657474211978,COGS 11,A01,083617,Boyle; Mary E. T.,22,0,48,26
1657474218002,COGS 13,A01,083071,Bastos; Amalia Pinkusfeld,11,0,71,60
1657474224034,COGS 14A,A01,092681,Semenuks; Arturs,5,1,100,95
1657474230059,COGS 14B,A01,083073,Cheng; Tzu-Han,6,0,63,57
1657474236080,COGS 17,A01,092677,Semenuks; Arturs,6,0,81,75
1657474242108,COGS 100,A01,083619,Allen; Michael Gordon,17,0,70,53
1657474248134,COGS 101A,A01,083621,Davis; Joshua Daniel,9,0,68,59
1657474254157,COGS 101B,A01,091572,Allen; Michael Gordon,12,0,65,53
1657474260188,COGS 101C,A01,083625,Delgado; Tania,17,0,35,18
1657474266211,COGS 107A,A01,083627,Boyle; Mary E. T.,13,0,60,47
1657474272236,COGS 118A,A01,083075,Gupta; Anjum,21,0,76,55
1657474278266,CSE 3,A50,083646,Miranda; Gregory Joseph,24,0,50,26
1657474284289,CSE 8A,A50,083650,Miranda; Gregory Joseph,17,1,56,39
1657474290314,CSE 11,A01,083080,Cao; Yingjun,6,15,40,34
1657474296336,CSE 12,A01,083652,Krause-Levy; Sophia Louisa,28,1,120,92
1657474302358,CSE 15L,A01,083654,Morris; Justin Loren,9,0,50,41
1657474302358,CSE 15L,A02,083655,Morris; Justin Loren,9,0,50,41
1657474308387,CSE 20,A01,083657,Tran; Khoa Dang,39,0,80,41
1657474314408,CSE 21,A01,095574,Bach; Quang Tran,22,0,48,26
1657474320431,CSE 30,A01,083084,Eldon; John,5,0,80,75
1657474320431,CSE 30,B01,095061,Bhaskar; Nishant,9,0,50,41
1657474326458,CSE 100,A01,083659,Cao; Yingjun,5,4,70,65
1657474332484,CSE 134B,A01,083661,Powell; Thomas Allan,22,0,100,78
1657474338508,CSE 140,A01,083663,Gungor; Onat,15,0,85,70
1657474344532,CSE 140L,A01,083088,Eldon; John,21,0,100,79
1657474350559,CSE 175,A01,083665,Kumar; Rakesh,3,0,25,22
1657474356583,CSE 190,A00,092507,Dubnov; Shlomo,8,0,20,12
1657474362606,ECE 45,A01,083139,Congero; Spencer William,6,0,75,69
1657474368629,ECE 65,A50,083695,Saad; Andrew S,12,0,30,18
1657474368629,ECE 65,A51,095125,Saad; Andrew S,24,0,26,2
1657474374653,ECE 109,A01,091882,Touri; Behrouz,19,0,70,51
1657474380681,ECE 180,A00,083140,Abi Samra; Nicholas Camill,1,0,30,29
1657474380681,ECE 180,B00,083141,Abi Samra; Nicholas Camill,0,0,30,30
1657474386706,MATH 10A,A01,083735,Patchell; Gregory David,2,0,30,28
1657474386706,MATH 10A,A02,083736,Patchell; Gregory David,20,0,30,10
1657474386706,MATH 10A,A03,083737,Patchell; Gregory David,16,0,30,14
1657474392731,MATH 10B,A01,083207,Lim; Seonhee,8,0,34,26
1657474392731,MATH 10B,A02,083208,Lim; Seonhee,9,0,35,26
1657474392731,MATH 10B,A03,093472,Lim; Seonhee,7,0,34,27
1657474392731,MATH 10B,B01,083739,Sinha; Shubham,12,0,30,18
1657474398756,MATH 18,A01,083743,Cinel; Cameron Alexander,7,0,30,23
1657474398756,MATH 18,A02,083744,Cinel; Cameron Alexander,17,0,30,13
1657474398756,MATH 18,A03,083745,Cinel; Cameron Alexander,9,0,30,21
1657474398756,MATH 18,B01,083748,Rideout; David Porter,5,0,37,32
1657474398756,MATH 18,B02,083749,Rideout; David Porter,5,0,36,31
1657474398756,MATH 18,B03,083750,Rideout; David Porter,3,0,37,34
1657474398756,MATH 18,B04,083751,Rideout; David Porter,6,0,36,30
1657474398756,MATH 18,B05,093473,Rideout; David Porter,6,0,36,30
1657474398756,MATH 18,B06,093474,Rideout; David Porter,6,0,36,30
1657474404779,MATH 20A,A01,083754,Zheng; Zequn,14,0,40,26
1657474410808,MATH 20B,A01,083756,Briones; Jor-el Thomas Caparas,4,0,36,32
1657474410808,MATH 20B,A02,083757,Briones; Jor-el Thomas Caparas,1,0,36,35
1657474410808,MATH 20B,A03,093475,Briones; Jor-el Thomas Caparas,2,0,36,34
1657474416833,MATH 20C,A01,083760,Briones; Jor-el Thomas Caparas,1,0,35,34
1657474416833,MATH 20C,A02,083761,Briones; Jor-el Thomas Caparas,8,0,35,27
1657474416833,MATH 20C,A03,093476,Briones; Jor-el Thomas Caparas,0,1,36,36
1657474416833,MATH 20C,B01,083762,Bach; Quang Tran,1,0,30,29
1657474422855,MATH 20D,A01,083765,Tran; Brian Kha,5,0,30,25
1657474422855,MATH 20D,A02,083766,Tran; Brian Kha,5,0,30,25
1657474422855,MATH 20D,A03,083767,Tran; Brian Kha,5,0,30,25
1657474428883,MATH 20E,A01,083771,Ganguly; Soumya,9,0,32,23
1657474428883,MATH 20E,A02,083772,Ganguly; Soumya,6,0,32,26
1657474428883,MATH 20E,B01,083773,Ciotti; Benjamin,20,0,35,15
1657474428883,MATH 20E,B02,083774,Ciotti; Benjamin,17,0,35,18
1657474434906,MATH 103A,A01,083777,Greenfeld; Be'Eri,3,0,36,33
1657474434906,MATH 103A,A02,083778,Greenfeld; Be'Eri,5,0,36,31
1657474434906,MATH 103A,A03,093561,Greenfeld; Be'Eri,5,0,36,31
1657474434906,MATH 103A,B01,083779,Greenfeld; Be'Eri,7,0,36,29
1657474434906,MATH 103A,B02,083780,Greenfeld; Be'Eri,4,0,36,32
1657474434906,MATH 103A,B03,093562,Greenfeld; Be'Eri,3,0,36,33
1657474440938,MATH 105,A01,085443,Carter; Anne Toulson,15,0,35,20
1657474440938,MATH 105,A02,093477,Carter; Anne Toulson,20,0,35,15
1657474446968,MATH 109,A01,083213,Ganzberger; Geoffrey Michael,2,0,34,32
1657474446968,MATH 109,A02,083214,Ganzberger; Geoffrey Michael,4,0,34,30
1657474446968,MATH 109,A03,093478,Ganzberger; Geoffrey Michael,2,0,34,32
1657474446968,MATH 109,B01,083215,Ganzberger; Geoffrey Michael,1,0,32,31
1657474446968,MATH 109,B02,083216,Ganzberger; Geoffrey Michael,2,0,32,30
1657474446968,MATH 109,B03,093479,Ganzberger; Geoffrey Michael,8,0,32,24
1657474452992,MATH 142A,A01,083219,Chow; Bennett,7,0,32,25
1657474452992,MATH 142A,A02,083220,Chow; Bennett,10,0,32,22
1657474452992,MATH 142A,A03,093480,Chow; Bennett,8,0,32,24
1657474452992,MATH 142A,B03,093481,Chow; Bennett,8,0,32,24
1657474452992,MATH 142A,B04,093558,Chow; Bennett,13,0,32,19
1657474452992,MATH 142A,B05,093559,Chow; Bennett,6,0,32,26
1657474459017,MATH 193A,A01,083224,Rotar; Vladimir,8,0,34,26
1657474459017,MATH 193A,A02,083225,Rotar; Vladimir,9,0,34,25
1657474459017,MATH 193A,A03,083781,Rotar; Vladimir,5,0,34,29
1657474459017,MATH 193A,A04,083782,Rotar; Vladimir,10,0,34,24
1657474459017,MATH 193A,A05,093482,Rotar; Vladimir,10,0,34,24
1657474465127,MATH 197,001,091859,McAuley; Julian John,9999,0,9999,0
1657474465127,MATH 197,002,095566,Kedlaya; Kiran S.,9997,0,9999,2
1657474465127,MATH 197,003,095567,Xiao; Ming,9999,0,9999,0
1657474465127,MATH 197,004,095571,Perols; Johan Lars,9998,0,9999,1
1657474472189,COGS 9,A01,083615,Shannon; Kyle Michael,9,0,75,66
1657474478216,COGS 11,A01,083617,Boyle; Mary E. T.,22,0,48,26
1657474484247,COGS 13,A01,083071,Bastos; Amalia Pinkusfeld,11,0,71,60
1657474490270,COGS 14A,A01,092681,Semenuks; Arturs,5,1,100,95
1657474496297,COGS 14B,A01,083073,Cheng; Tzu-Han,6,0,63,57
1657474502326,COGS 17,A01,092677,Semenuks; Arturs,6,0,81,75
1657474508349,COGS 100,A01,083619,Allen; Michael Gordon,17,0,70,53
1657474514378,COGS 101A,A01,083621,Davis; Joshua Daniel,9,0,68,59
1657474520410,COGS 101B,A01,091572,Allen; Michael Gordon,12,0,65,53
1657474526433,COGS 101C,A01,083625,Delgado; Tania,17,0,35,18
1657474532459,COGS 107A,A01,083627,Boyle; Mary E. T.,13,0,60,47
1657474538487,COGS 118A,A01,083075,Gupta; Anjum,21,0,76,55
1657474544545,CSE 3,A50,083646,Miranda; Gregory Joseph,24,0,50,26
1657474550570,CSE 8A,A50,083650,Miranda; Gregory Joseph,17,1,56,39
1657474556592,CSE 11,A01,083080,Cao; Yingjun,6,15,40,34
1657474562620,CSE 12,A01,083652,Krause-Levy; Sophia Louisa,28,1,120,92
1657474568650,CSE 15L,A01,083654,Morris; Justin Loren,9,0,50,41
1657474568650,CSE 15L,A02,083655,Morris; Justin Loren,9,0,50,41
1657474574672,CSE 20,A01,083657,Tran; Khoa Dang,39,0,80,41
1657474580693,CSE 21,A01,095574,Bach; Quang Tran,22,0,48,26
1657474586714,CSE 30,A01,083084,Eldon; John,5,0,80,75
1657474586714,CSE 30,B01,095061,Bhaskar; Nishant,9,0,50,41
1657474592737,CSE 100,A01,083659,Cao; Yingjun,5,4,70,65
1657474598760,CSE 134B,A01,083661,Powell; Thomas Allan,22,0,100,78
1657474604785,CSE 140,A01,083663,Gungor; Onat,15,0,85,70
1657474610810,CSE 140L,A01,083088,Eldon; John,21,0,100,79
1657474616838,CSE 175,A01,083665,Kumar; Rakesh,3,0,25,22
1657474622862,CSE 190,A00,092507,Dubnov; Shlomo,8,0,20,12
1657474628888,ECE 45,A01,083139,Congero; Spencer William,6,0,75,69
1657474634911,ECE 65,A50,083695,Saad; Andrew S,12,0,30,18
1657474634911,ECE 65,A51,095125,Saad; Andrew S,24,0,26,2
1657474640938,ECE 109,A01,091882,Touri; Behrouz,19,0,70,51
1657474646965,ECE 180,A00,083140,Abi Samra; Nicholas Camill,1,0,30,29
1657474646965,ECE 180,B00,083141,Abi Samra; Nicholas Camill,0,0,30,30
1657474652990,MATH 10A,A01,083735,Patchell; Gregory David,2,0,30,28
1657474652990,MATH 10A,A02,083736,Patchell; Gregory David,20,0,30,10
1657474652990,MATH 10A,A03,083737,Patchell; Gregory David,16,0,30,14
1657474659018,MATH 10B,A01,083207,Lim; Seonhee,8,0,34,26
1657474659018,MATH 10B,A02,083208,Lim; Seonhee,9,0,35,26
1657474659018,MATH 10B,A03,093472,Lim; Seonhee,7,0,34,27
1657474659018,MATH 10B,B01,083739,Sinha; Shubham,12,0,30,18
1657474665054,MATH 18,A01,083743,Cinel; Cameron Alexander,7,0,30,23
1657474665054,MATH 18,A02,083744,Cinel; Cameron Alexander,17,0,30,13
1657474665054,MATH 18,A03,083745,Cinel; Cameron Alexander,9,0,30,21
1657474665054,MATH 18,B01,083748,Rideout; David Porter,5,0,37,32
1657474665054,MATH 18,B02,083749,Rideout; David Porter,5,0,36,31
1657474665054,MATH 18,B03,083750,Rideout; David Porter,3,0,37,34
1657474665054,MATH 18,B04,083751,Rideout; David Porter,6,0,36,30
1657474665054,MATH 18,B05,093473,Rideout; David Porter,6,0,36,30
1657474665054,MATH 18,B06,093474,Rideout; David Porter,6,0,36,30
1657474671078,MATH 20A,A01,083754,Zheng; Zequn,14,0,40,26
1657474677106,MATH 20B,A01,083756,Briones; Jor-el Thomas Caparas,4,0,36,32
1657474677106,MATH 20B,A02,083757,Briones; Jor-el Thomas Caparas,1,0,36,35
1657474677106,MATH 20B,A03,093475,Briones; Jor-el Thomas Caparas,2,0,36,34
1657474683134,MATH 20C,A01,083760,Briones; Jor-el Thomas Caparas,1,0,35,34
1657474683134,MATH 20C,A02,083761,Briones; Jor-el Thomas Caparas,8,0,35,27
1657474683134,MATH 20C,A03,093476,Briones; Jor-el Thomas Caparas,0,1,36,36
1657474683134,MATH 20C,B01,083762,Bach; Quang Tran,1,0,30,29
1657474689158,MATH 20D,A01,083765,Tran; Brian Kha,5,0,30,25
1657474689158,MATH 20D,A02,083766,Tran; Brian Kha,5,0,30,25
1657474689158,MATH 20D,A03,083767,Tran; Brian Kha,5,0,30,25
1657474695180,MATH 20E,A01,083771,Ganguly; Soumya,9,0,32,23
1657474695180,MATH 20E,A02,083772,Ganguly; Soumya,6,0,32,26
1657474695180,MATH 20E,B01,083773,Ciotti; Benjamin,20,0,35,15
1657474695180,MATH 20E,B02,083774,Ciotti; Benjamin,17,0,35,18
1657474701205,MATH 103A,A01,083777,Greenfeld; Be'Eri,3,0,36,33
1657474701205,MATH 103A,A02,083778,Greenfeld; Be'Eri,5,0,36,31
1657474701205,MATH 103A,A03,093561,Greenfeld; Be'Eri,5,0,36,31
1657474701205,MATH 103A,B01,083779,Greenfeld; Be'Eri,7,0,36,29
1657474701205,MATH 103A,B02,083780,Greenfeld; Be'Eri,4,0,36,32
1657474701205,MATH 103A,B03,093562,Greenfeld; Be'Eri,3,0,36,33
1657474707226,MATH 105,A01,085443,Carter; Anne Toulson,15,0,35,20
1657474707226,MATH 105,A02,093477,Carter; Anne Toulson,20,0,35,15
1657474713259,MATH 109,A01,083213,Ganzberger; Geoffrey Michael,2,0,34,32
1657474713259,MATH 109,A02,083214,Ganzberger; Geoffrey Michael,4,0,34,30
1657474713259,MATH 109,A03,093478,Ganzberger; Geoffrey Michael,2,0,34,32
1657474713259,MATH 109,B01,083215,Ganzberger; Geoffrey Michael,1,0,32,31
1657474713259,MATH 109,B02,083216,Ganzberger; Geoffrey Michael,2,0,32,30
1657474713259,MATH 109,B03,093479,Ganzberger; Geoffrey Michael,8,0,32,24
1657474719282,MATH 142A,A01,083219,Chow; Bennett,7,0,32,25
1657474719282,MATH 142A,A02,083220,Chow; Bennett,10,0,32,22
1657474719282,MATH 142A,A03,093480,Chow; Bennett,8,0,32,24
1657474719282,MATH 142A,B03,093481,Chow; Bennett,8,0,32,24
1657474719282,MATH 142A,B04,093558,Chow; Bennett,13,0,32,19
1657474719282,MATH 142A,B05,093559,Chow; Bennett,6,0,32,26
1657474725307,MATH 193A,A01,083224,Rotar; Vladimir,8,0,34,26
1657474725307,MATH 193A,A02,083225,Rotar; Vladimir,9,0,34,25
1657474725307,MATH 193A,A03,083781,Rotar; Vladimir,5,0,34,29
1657474725307,MATH 193A,A04,083782,Rotar; Vladimir,10,0,34,24
1657474725307,MATH 193A,A05,093482,Rotar; Vladimir,10,0,34,24
1657474731334,MATH 197,001,091859,McAuley; Julian John,9999,0,9999,0
1657474731334,MATH 197,002,095566,Kedlaya; Kiran S.,9997,0,9999,2
1657474731334,MATH 197,003,095567,Xiao; Ming,9999,0,9999,0
1657474731334,MATH 197,004,095571,Perols; Johan Lars,9998,0,9999,1
1657474738387,COGS 9,A01,083615,Shannon; Kyle Michael,9,0,75,66
1657474744412,COGS 11,A01,083617,Boyle; Mary E. T.,22,0,48,26
1657474750434,COGS 13,A01,083071,Bastos; Amalia Pinkusfeld,11,0,71,60
1657474756460,COGS 14A,A01,092681,Semenuks; Arturs,5,1,100,95
1657474762482,COGS 14B,A01,083073,Cheng; Tzu-Han,6,0,63,57
1657474768504,COGS 17,A01,092677,Semenuks; Arturs,6,0,81,75
1657474774531,COGS 100,A01,083619,Allen; Michael Gordon,17,0,70,53
1657474780558,COGS 101A,A01,083621,Davis; Joshua Daniel,9,0,68,59
1657474786588,COGS 101B,A01,091572,Allen; Michael Gordon,12,0,65,53
1657474792615,COGS 101C,A01,083625,Delgado; Tania,17,0,35,18
1657474798640,COGS 107A,A01,083627,Boyle; Mary E. T.,13,0,60,47
1657474804663,COGS 118A,A01,083075,Gupta; Anjum,21,0,76,55
1657474810687,CSE 3,A50,083646,Miranda; Gregory Joseph,24,0,50,26
1657474816709,CSE 8A,A50,083650,Miranda; Gregory Joseph,17,1,56,39
1657474822732,CSE 11,A01,083080,Cao; Yingjun,6,15,40,34
1657474828754,CSE 12,A01,083652,Krause-Levy; Sophia Louisa,28,1,120,92
1657474834777,CSE 15L,A01,083654,Morris; Justin Loren,9,0,50,41
1657474834777,CSE 15L,A02,083655,Morris; Justin Loren,9,0,50,41
1657474840804,CSE 20,A01,083657,Tran; Khoa Dang,39,0,80,41
1657474846827,CSE 21,A01,095574,Bach; Quang Tran,22,0,48,26
1657474852853,CSE 30,A01,083084,Eldon; John,5,0,80,75
1657474852853,CSE 30,B01,095061,Bhaskar; Nishant,9,0,50,41
1657474858875,CSE 100,A01,083659,Cao; Yingjun,5,4,70,65
1657474864896,CSE 134B,A01,083661,Powell; Thomas Allan,22,0,100,78
1657474870919,CSE 140,A01,083663,Gungor; Onat,15,0,85,70
1657474876944,CSE 140L,A01,083088,Eldon; John,21,0,100,79
1657474882968,CSE 175,A01,083665,Kumar; Rakesh,3,0,25,22
1657474888991,CSE 190,A00,092507,Dubnov; Shlomo,8,0,20,12
1657474895016,ECE 45,A01,083139,Congero; Spencer William,6,0,75,69
1657474901043,ECE 65,A50,083695,Saad; Andrew S,12,0,30,18
1657474901043,ECE 65,A51,095125,Saad; Andrew S,24,0,26,2
1657474907066,ECE 109,A01,091882,Touri; Behrouz,19,0,70,51
1657474913090,ECE 180,A00,083140,Abi Samra; Nicholas Camill,1,0,30,29
1657474913090,ECE 180,B00,083141,Abi Samra; Nicholas Camill,0,0,30,30
1657474919114,MATH 10A,A01,083735,Patchell; Gregory David,2,0,30,28
1657474919114,MATH 10A,A02,083736,Patchell; Gregory David,20,0,30,10
1657474919114,MATH 10A,A03,083737,Patchell; Gregory David,16,0,30,14
1657474925138,MATH 10B,A01,083207,Lim; Seonhee,8,0,34,26
1657474925138,MATH 10B,A02,083208,Lim; Seonhee,9,0,35,26
1657474925138,MATH 10B,A03,093472,Lim; Seonhee,7,0,34,27
1657474925138,MATH 10B,B01,083739,Sinha; Shubham,12,0,30,18
1657474931171,MATH 18,A01,083743,Cinel; Cameron Alexander,7,0,30,23
1657474931171,MATH 18,A02,083744,Cinel; Cameron Alexander,17,0,30,13
1657474931171,MATH 18,A03,083745,Cinel; Cameron Alexander,9,0,30,21
1657474931171,MATH 18,B01,083748,Rideout; David Porter,5,0,37,32
1657474931171,MATH 18,B02,083749,Rideout; David Porter,5,0,36,31
1657474931171,MATH 18,B03,083750,Rideout; David Porter,3,0,37,34
1657474931171,MATH 18,B04,083751,Rideout; David Porter,6,0,36,30
1657474931171,MATH 18,B05,093473,Rideout; David Porter,6,0,36,30
1657474931171,MATH 18,B06,093474,Rideout; David Porter,6,0,36,30
1657474937195,MATH 20A,A01,083754,Zheng; Zequn,14,0,40,26
1657474943236,MATH 20B,A01,083756,Briones; Jor-el Thomas Caparas,4,0,36,32
1657474943236,MATH 20B,A02,083757,Briones; Jor-el Thomas Caparas,1,0,36,35
1657474943236,MATH 20B,A03,093475,Briones; Jor-el Thomas Caparas,2,0,36,34
1657474949258,MATH 20C,A01,083760,Briones; Jor-el Thomas Caparas,1,0,35,34
1657474949258,MATH 20C,A02,083761,Briones; Jor-el Thomas Caparas,8,0,35,27
1657474949258,MATH 20C,A03,093476,Briones; Jor-el Thomas Caparas,0,1,36,36
1657474949258,MATH 20C,B01,083762,Bach; Quang Tran,1,0,30,29
1657474955282,MATH 20D,A01,083765,Tran; Brian Kha,5,0,30,25
1657474955282,MATH 20D,A02,083766,Tran; Brian Kha,5,0,30,25
1657474955282,MATH 20D,A03,083767,Tran; Brian Kha,5,0,30,25
1657474961306,MATH 20E,A01,083771,Ganguly; Soumya,9,0,32,23
1657474961306,MATH 20E,A02,083772,Ganguly; Soumya,6,0,32,26
1657474961306,MATH 20E,B01,083773,Ciotti; Benjamin,20,0,35,15
1657474961306,MATH 20E,B02,083774,Ciotti; Benjamin,17,0,35,18
1657474967331,MATH 103A,A01,083777,Greenfeld; Be'Eri,3,0,36,33
1657474967331,MATH 103A,A02,083778,Greenfeld; Be'Eri,5,0,36,31
1657474967331,MATH 103A,A03,093561,Greenfeld; Be'Eri,5,0,36,31
1657474967331,MATH 103A,B01,083779,Greenfeld; Be'Eri,7,0,36,29
1657474967331,MATH 103A,B02,083780,Greenfeld; Be'Eri,4,0,36,32
1657474967331,MATH 103A,B03,093562,Greenfeld; Be'Eri,3,0,36,33
1657474973359,MATH 105,A01,085443,Carter; Anne Toulson,15,0,35,20
1657474973359,MATH 105,A02,093477,Carter; Anne Toulson,20,0,35,15
1657474979390,MATH 109,A01,083213,Ganzberger; Geoffrey Michael,2,0,34,32
1657474979390,MATH 109,A02,083214,Ganzberger; Geoffrey Michael,4,0,34,30
1657474979390,MATH 109,A03,093478,Ganzberger; Geoffrey Michael,2,0,34,32
1657474979390,MATH 109,B01,083215,Ganzberger; Geoffrey Michael,1,0,32,31
1657474979390,MATH 109,B02,083216,Ganzberger; Geoffrey Michael,2,0,32,30
1657474979390,MATH 109,B03,093479,Ganzberger; Geoffrey Michael,8,0,32,24
1657474985417,MATH 142A,A01,083219,Chow; Bennett,7,0,32,25
1657474985417,MATH 142A,A02,083220,Chow; Bennett,10,0,32,22
1657474985417,MATH 142A,A03,093480,Chow; Bennett,8,0,32,24
1657474985417,MATH 142A,B03,093481,Chow; Bennett,8,0,32,24
1657474985417,MATH 142A,B04,093558,Chow; Bennett,13,0,32,19
1657474985417,MATH 142A,B05,093559,Chow; Bennett,6,0,32,26
1657474991441,MATH 193A,A01,083224,Rotar; Vladimir,8,0,34,26
1657474991441,MATH 193A,A02,083225,Rotar; Vladimir,9,0,34,25
1657474991441,MATH 193A,A03,083781,Rotar; Vladimir,5,0,34,29
1657474991441,MATH 193A,A04,083782,Rotar; Vladimir,10,0,34,24
1657474991441,MATH 193A,A05,093482,Rotar; Vladimir,10,0,34,24
1657474997463,MATH 197,001,091859,McAuley; Julian John,9999,0,9999,0
1657474997463,MATH 197,002,095566,Kedlaya; Kiran S.,9997,0,9999,2
1657474997463,MATH 197,003,095567,Xiao; Ming,9999,0,9999,0
1657474997463,MATH 197,004,095571,Perols; Johan Lars,9998,0,9999,1
1657475004515,COGS 9,A01,083615,Shannon; Kyle Michael,9,0,75,66
1657475010543,COGS 11,A01,083617,Boyle; Mary E. T.,22,0,48,26
1657475016566,COGS 13,A01,083071,Bastos; Amalia Pinkusfeld,11,0,71,60
1657475022594,COGS 14A,A01,092681,Semenuks; Arturs,5,1,100,95
1657475028617,COGS 14B,A01,083073,Cheng; Tzu-Han,6,0,63,57
1657475034642,COGS 17,A01,092677,Semenuks; Arturs,6,0,81,75
1657475040670,COGS 100,A01,083619,Allen; Michael Gordon,17,0,70,53
1657475046693,COGS 101A,A01,083621,Davis; Joshua Daniel,9,0,68,59
1657475052721,COGS 101B,A01,091572,Allen; Michael Gordon,12,0,65,53
1657475058844,COGS 101C,A01,083625,Delgado; Tania,17,0,35,18
1657475064877,COGS 107A,A01,083627,Boyle; Mary E. T.,13,0,60,47
1657475070899,COGS 118A,A01,083075,Gupta; Anjum,21,0,76,55
1657475076925,CSE 3,A50,083646,Miranda; Gregory Joseph,24,0,50,26
1657475082950,CSE 8A,A50,083650,Miranda; Gregory Joseph,17,1,56,39
1657475088974,CSE 11,A01,083080,Cao; Yingjun,6,15,40,34
1657475095002,CSE 12,A01,083652,Krause-Levy; Sophia Louisa,28,1,120,92
1657475101030,CSE 15L,A01,083654,Morris; Justin Loren,9,0,50,41
1657475101030,CSE 15L,A02,083655,Morris; Justin Loren,9,0,50,41
1657475107051,CSE 20,A01,083657,Tran; Khoa Dang,39,0,80,41
1657475113074,CSE 21,A01,095574,Bach; Quang Tran,22,0,48,26
1657475119100,CSE 30,A01,083084,Eldon; John,5,0,80,75
1657475119100,CSE 30,B01,095061,Bhaskar; Nishant,9,0,50,41
1657475125122,CSE 100,A01,083659,Cao; Yingjun,5,4,70,65
1657475131148,CSE 134B,A01,083661,Powell; Thomas Allan,22,0,100,78
1657475137176,CSE 140,A01,083663,Gungor; Onat,15,0,85,70
1657475143201,CSE 140L,A01,083088,Eldon; John,21,0,100,79
1657475149224,CSE 175,A01,083665,Kumar; Rakesh,3,0,25,22
1657475155246,CSE 190,A00,092507,Dubnov; Shlomo,8,0,20,12
1657475161271,ECE 45,A01,083139,Congero; Spencer William,6,0,75,69
1657475167297,ECE 65,A50,083695,Saad; Andrew S,12,0,30,18
1657475167297,ECE 65,A51,095125,Saad; Andrew S,24,0,26,2
1657475173321,ECE 109,A01,091882,Touri; Behrouz,19,0,70,51
1657475179346,ECE 180,A00,083140,Abi Samra; Nicholas Camill,1,0,30,29
1657475179346,ECE 180,B00,083141,Abi Samra; Nicholas Camill,0,0,30,30
1657475185376,MATH 10A,A01,083735,Patchell; Gregory David,2,0,30,28
1657475185376,MATH 10A,A02,083736,Patchell; Gregory David,20,0,30,10
1657475185376,MATH 10A,A03,083737,Patchell; Gregory David,16,0,30,14
1657475191404,MATH 10B,A01,083207,Lim; Seonhee,8,0,34,26
1657475191404,MATH 10B,A02,083208,Lim; Seonhee,9,0,35,26
1657475191404,MATH 10B,A03,093472,Lim; Seonhee,7,0,34,27
1657475191404,MATH 10B,B01,083739,Sinha; Shubham,12,0,30,18
1657475197435,MATH 18,A01,083743,Cinel; Cameron Alexander,7,0,30,23
1657475197435,MATH 18,A02,083744,Cinel; Cameron Alexander,17,0,30,13
1657475197435,MATH 18,A03,083745,Cinel; Cameron Alexander,9,0,30,21
1657475197435,MATH 18,B01,083748,Rideout; David Porter,5,0,37,32
1657475197435,MATH 18,B02,083749,Rideout; David Porter,5,0,36,31
1657475197435,MATH 18,B03,083750,Rideout; David Porter,3,0,37,34
1657475197435,MATH 18,B04,083751,Rideout; David Porter,6,0,36,30
1657475197435,MATH 18,B05,093473,Rideout; David Porter,6,0,36,30
1657475197435,MATH 18,B06,093474,Rideout; David Porter,6,0,36,30
1657475203458,MATH 20A,A01,083754,Zheng; Zequn,14,0,40,26
1657475209485,MATH 20B,A01,083756,Briones; Jor-el Thomas Caparas,4,0,36,32
1657475209485,MATH 20B,A02,083757,Briones; Jor-el Thomas Caparas,1,0,36,35
1657475209485,MATH 20B,A03,093475,Briones; Jor-el Thomas Caparas,2,0,36,34
1657475215508,MATH 20C,A01,083760,Briones; Jor-el Thomas Caparas,1,0,35,34
1657475215508,MATH 20C,A02,083761,Briones; Jor-el Thomas Caparas,8,0,35,27
1657475215508,MATH 20C,A03,093476,Briones; Jor-el Thomas Caparas,0,1,36,36
1657475215508,MATH 20C,B01,083762,Bach; Quang Tran,1,0,30,29
1657475221532,MATH 20D,A01,083765,Tran; Brian Kha,5,0,30,25
1657475221532,MATH 20D,A02,083766,Tran; Brian Kha,5,0,30,25
1657475221532,MATH 20D,A03,083767,Tran; Brian Kha,5,0,30,25
1657475227562,MATH 20E,A01,083771,Ganguly; Soumya,9,0,32,23
1657475227562,MATH 20E,A02,083772,Ganguly; Soumya,6,0,32,26
1657475227562,MATH 20E,B01,083773,Ciotti; Benjamin,20,0,35,15
1657475227562,MATH 20E,B02,083774,Ciotti; Benjamin,17,0,35,18
1657475233591,MATH 103A,A01,083777,Greenfeld; Be'Eri,3,0,36,33
1657475233591,MATH 103A,A02,083778,Greenfeld; Be'Eri,5,0,36,31
1657475233591,MATH 103A,A03,093561,Greenfeld; Be'Eri,5,0,36,31
1657475233591,MATH 103A,B01,083779,Greenfeld; Be'Eri,7,0,36,29
1657475233591,MATH 103A,B02,083780,Greenfeld; Be'Eri,4,0,36,32
1657475233591,MATH 103A,B03,093562,Greenfeld; Be'Eri,3,0,36,33
1657475239614,MATH 105,A01,085443,Carter; Anne Toulson,15,0,35,20
1657475239614,MATH 105,A02,093477,Carter; Anne Toulson,20,0,35,15
1657475245638,MATH 109,A01,083213,Ganzberger; Geoffrey Michael,2,0,34,32
1657475245638,MATH 109,A02,083214,Ganzberger; Geoffrey Michael,4,0,34,30
1657475245638,MATH 109,A03,093478,Ganzberger; Geoffrey Michael,2,0,34,32
1657475245638,MATH 109,B01,083215,Ganzberger; Geoffrey Michael,1,0,32,31
1657475245638,MATH 109,B02,083216,Ganzberger; Geoffrey Michael,2,0,32,30
1657475245638,MATH 109,B03,093479,Ganzberger; Geoffrey Michael,8,0,32,24
1657475251663,MATH 142A,A01,083219,Chow; Bennett,7,0,32,25
1657475251663,MATH 142A,A02,083220,Chow; Bennett,10,0,32,22
1657475251663,MATH 142A,A03,093480,Chow; Bennett,8,0,32,24
1657475251663,MATH 142A,B03,093481,Chow; Bennett,8,0,32,24
1657475251663,MATH 142A,B04,093558,Chow; Bennett,13,0,32,19
1657475251663,MATH 142A,B05,093559,Chow; Bennett,6,0,32,26
1657475257685,MATH 193A,A01,083224,Rotar; Vladimir,8,0,34,26
1657475257685,MATH 193A,A02,083225,Rotar; Vladimir,9,0,34,25
1657475257685,MATH 193A,A03,083781,Rotar; Vladimir,5,0,34,29
1657475257685,MATH 193A,A04,083782,Rotar; Vladimir,10,0,34,24
1657475257685,MATH 193A,A05,093482,Rotar; Vladimir,10,0,34,24
1657475263712,MATH 197,001,091859,McAuley; Julian John,9999,0,9999,0
1657475263712,MATH 197,002,095566,Kedlaya; Kiran S.,9997,0,9999,2
1657475263712,MATH 197,003,095567,Xiao; Ming,9999,0,9999,0
1657475263712,MATH 197,004,095571,Perols; Johan Lars,9998,0,9999,1
1657475270765,COGS 9,A01,083615,Shannon; Kyle Michael,9,0,75,66
1657475276793,COGS 11,A01,083617,Boyle; Mary E. T.,22,0,48,26
1657475282821,COGS 13,A01,083071,Bastos; Amalia Pinkusfeld,11,0,71,60
1657475288844,COGS 14A,A01,092681,Semenuks; Arturs,5,1,100,95
1657475294871,COGS 14B,A01,083073,Cheng; Tzu-Han,6,0,63,57
1657475300895,COGS 17,A01,092677,Semenuks; Arturs,6,0,81,75
1657475306922,COGS 100,A01,083619,Allen; Michael Gordon,17,0,70,53
1657475312946,COGS 101A,A01,083621,Davis; Joshua Daniel,9,0,68,59
1657475318968,COGS 101B,A01,091572,Allen; Michael Gordon,12,0,65,53
1657475324992,COGS 101C,A01,083625,Delgado; Tania,17,0,35,18
1657475331015,COGS 107A,A01,083627,Boyle; Mary E. T.,13,0,60,47
1657475337046,COGS 118A,A01,083075,Gupta; Anjum,21,0,76,55
1657475343075,CSE 3,A50,083646,Miranda; Gregory Joseph,24,0,50,26
1657475349100,CSE 8A,A50,083650,Miranda; Gregory Joseph,17,1,56,39
1657475355127,CSE 11,A01,083080,Cao; Yingjun,6,15,40,34
1657475361153,CSE 12,A01,083652,Krause-Levy; Sophia Louisa,28,1,120,92
1657475367182,CSE 15L,A01,083654,Morris; Justin Loren,9,0,50,41
1657475367182,CSE 15L,A02,083655,Morris; Justin Loren,9,0,50,41
1657475373205,CSE 20,A01,083657,Tran; Khoa Dang,39,0,80,41
1657475379231,CSE 21,A01,095574,Bach; Quang Tran,22,0,48,26
1657475385255,CSE 30,A01,083084,Eldon; John,5,0,80,75
1657475385255,CSE 30,B01,095061,Bhaskar; Nishant,9,0,50,41
1657475391279,CSE 100,A01,083659,Cao; Yingjun,5,4,70,65
1657475397307,CSE 134B,A01,083661,Powell; Thomas Allan,22,0,100,78
1657475403335,CSE 140,A01,083663,Gungor; Onat,15,0,85,70
1657475409359,CSE 140L,A01,083088,Eldon; John,21,0,100,79
1657475415380,CSE 175,A01,083665,Kumar; Rakesh,3,0,25,22
1657475421402,CSE 190,A00,092507,Dubnov; Shlomo,8,0,20,12
1657475427425,ECE 45,A01,083139,Congero; Spencer William,6,0,75,69
1657475433451,ECE 65,A50,083695,Saad; Andrew S,12,0,30,18
1657475433451,ECE 65,A51,095125,Saad; Andrew S,24,0,26,2
1657475439493,ECE 109,A01,091882,Touri; Behrouz,19,0,70,51
1657475445516,ECE 180,A00,083140,Abi Samra; Nicholas Camill,1,0,30,29
1657475445516,ECE 180,B00,083141,Abi Samra; Nicholas Camill,0,0,30,30
1657475451541,MATH 10A,A01,083735,Patchell; Gregory David,2,0,30,28
1657475451541,MATH 10A,A02,083736,Patchell; Gregory David,20,0,30,10
1657475451541,MATH 10A,A03,083737,Patchell; Gregory David,16,0,30,14
1657475457566,MATH 10B,A01,083207,Lim; Seonhee,8,0,34,26
1657475457566,MATH 10B,A02,083208,Lim; Seonhee,9,0,35,26
1657475457566,MATH 10B,A03,093472,Lim; Seonhee,7,0,34,27
1657475457566,MATH 10B,B01,083739,Sinha; Shubham,12,0,30,18
1657475463592,MATH 18,A01,083743,Cinel; Cameron Alexander,7,0,30,23
1657475463592,MATH 18,A02,083744,Cinel; Cameron Alexander,17,0,30,13
1657475463592,MATH 18,A03,083745,Cinel; Cameron Alexander,9,0,30,21
1657475463592,MATH 18,B01,083748,Rideout; David Porter,5,0,37,32
1657475463592,MATH 18,B02,083749,Rideout; David Porter,5,0,36,31
1657475463592,MATH 18,B03,083750,Rideout; David Porter,3,0,37,34
1657475463592,MATH 18,B04,083751,Rideout; David Porter,6,0,36,30
1657475463592,MATH 18,B05,093473,Rideout; David Porter,6,0,36,30
1657475463592,MATH 18,B06,093474,Rideout; David Porter,6,0,36,30
1657475469617,MATH 20A,A01,083754,Zheng; Zequn,14,0,40,26
1657475475640,MATH 20B,A01,083756,Briones; Jor-el Thomas Caparas,4,0,36,32
1657475475640,MATH 20B,A02,083757,Briones; Jor-el Thomas Caparas,1,0,36,35
1657475475640,MATH 20B,A03,093475,Briones; Jor-el Thomas Caparas,2,0,36,34
1657475481664,MATH 20C,A01,083760,Briones; Jor-el Thomas Caparas,1,0,35,34
1657475481664,MATH 20C,A02,083761,Briones; Jor-el Thomas Caparas,8,0,35,27
1657475481664,MATH 20C,A03,093476,Briones; Jor-el Thomas Caparas,0,1,36,36
1657475481664,MATH 20C,B01,083762,Bach; Quang Tran,1,0,30,29
1657475487691,MATH 20D,A01,083765,Tran; Brian Kha,5,0,30,25
1657475487691,MATH 20D,A02,083766,Tran; Brian Kha,5,0,30,25
1657475487691,MATH 20D,A03,083767,Tran; Brian Kha,5,0,30,25
1657475493713,MATH 20E,A01,083771,Ganguly; Soumya,9,0,32,23
1657475493713,MATH 20E,A02,083772,Ganguly; Soumya,6,0,32,26
1657475493713,MATH 20E,B01,083773,Ciotti; Benjamin,20,0,35,15
1657475493713,MATH 20E,B02,083774,Ciotti; Benjamin,17,0,35,18
1657475499737,MATH 103A,A01,083777,Greenfeld; Be'Eri,3,0,36,33
1657475499737,MATH 103A,A02,083778,Greenfeld; Be'Eri,5,0,36,31
1657475499737,MATH 103A,A03,093561,Greenfeld; Be'Eri,5,0,36,31
1657475499737,MATH 103A,B01,083779,Greenfeld; Be'Eri,7,0,36,29
1657475499737,MATH 103A,B02,083780,Greenfeld; Be'Eri,4,0,36,32
1657475499737,MATH 103A,B03,093562,Greenfeld; Be'Eri,3,0,36,33
1657475505761,MATH 105,A01,085443,Carter; Anne Toulson,15,0,35,20
1657475505761,MATH 105,A02,093477,Carter; Anne Toulson,20,0,35,15
1657475511785,MATH 109,A01,083213,Ganzberger; Geoffrey Michael,2,0,34,32
1657475511785,MATH 109,A02,083214,Ganzberger; Geoffrey Michael,4,0,34,30
1657475511785,MATH 109,A03,093478,Ganzberger; Geoffrey Michael,2,0,34,32
1657475511785,MATH 109,B01,083215,Ganzberger; Geoffrey Michael,1,0,32,31
1657475511785,MATH 109,B02,083216,Ganzberger; Geoffrey Michael,2,0,32,30
1657475511785,MATH 109,B03,093479,Ganzberger; Geoffrey Michael,8,0,32,24
1657475517815,MATH 142A,A01,083219,Chow; Bennett,7,0,32,25
1657475517815,MATH 142A,A02,083220,Chow; Bennett,10,0,32,22
1657475517815,MATH 142A,A03,093480,Chow; Bennett,8,0,32,24
1657475517815,MATH 142A,B03,093481,Chow; Bennett,8,0,32,24
1657475517815,MATH 142A,B04,093558,Chow; Bennett,13,0,32,19
1657475517815,MATH 142A,B05,093559,Chow; Bennett,6,0,32,26
1657475523842,MATH 193A,A01,083224,Rotar; Vladimir,8,0,34,26
1657475523842,MATH 193A,A02,083225,Rotar; Vladimir,9,0,34,25
1657475523842,MATH 193A,A03,083781,Rotar; Vladimir,5,0,34,29
1657475523842,MATH 193A,A04,083782,Rotar; Vladimir,10,0,34,24
1657475523842,MATH 193A,A05,093482,Rotar; Vladimir,10,0,34,24
1657475529866,MATH 197,001,091859,McAuley; Julian John,9999,0,9999,0
1657475529866,MATH 197,002,095566,Kedlaya; Kiran S.,9997,0,9999,2
1657475529866,MATH 197,003,095567,Xiao; Ming,9999,0,9999,0
1657475529866,MATH 197,004,095571,Perols; Johan Lars,9998,0,9999,1
1657475536926,COGS 9,A01,083615,Shannon; Kyle Michael,9,0,75,66
1657475542953,COGS 11,A01,083617,Boyle; Mary E. T.,22,0,48,26
1657475548982,COGS 13,A01,083071,Bastos; Amalia Pinkusfeld,11,0,71,60
1657475555006,COGS 14A,A01,092681,Semenuks; Arturs,5,1,100,95
1657475561032,COGS 14B,A01,083073,Cheng; Tzu-Han,6,0,63,57
1657475567055,COGS 17,A01,092677,Semenuks; Arturs,6,0,81,75
1657475573083,COGS 100,A01,083619,Allen; Michael Gordon,17,0,70,53
1657475579105,COGS 101A,A01,083621,Davis; Joshua Daniel,9,0,68,59
1657475585130,COGS 101B,A01,091572,Allen; Michael Gordon,12,0,65,53
1657475591158,COGS 101C,A01,083625,Delgado; Tania,17,0,35,18
1657475597183,COGS 107A,A01,083627,Boyle; Mary E. T.,13,0,60,47
1657475603205,COGS 118A,A01,083075,Gupta; Anjum,21,0,76,55
1657475609234,CSE 3,A50,083646,Miranda; Gregory Joseph,24,0,50,26
1657475615256,CSE 8A,A50,083650,Miranda; Gregory Joseph,17,1,56,39
1657475621279,CSE 11,A01,083080,Cao; Yingjun,6,15,40,34
1657475627313,CSE 12,A01,083652,Krause-Levy; Sophia Louisa,28,1,120,92
1657475633343,CSE 15L,A01,083654,Morris; Justin Loren,9,0,50,41
1657475633343,CSE 15L,A02,083655,Morris; Justin Loren,9,0,50,41
1657475639369,CSE 20,A01,083657,Tran; Khoa Dang,39,0,80,41
1657475645396,CSE 21,A01,095574,Bach; Quang Tran,22,0,48,26
1657475651425,CSE 30,A01,083084,Eldon; John,5,0,80,75
1657475651425,CSE 30,B01,095061,Bhaskar; Nishant,9,0,50,41
1657475657519,CSE 100,A01,083659,Cao; Yingjun,5,4,70,65
1657475663542,CSE 134B,A01,083661,Powell; Thomas Allan,22,0,100,78
1657475669563,CSE 140,A01,083663,Gungor; Onat,15,0,85,70
1657475675591,CSE 140L,A01,083088,Eldon; John,21,0,100,79
1657475681617,CSE 175,A01,083665,Kumar; Rakesh,3,0,25,22
1657475687641,CSE 190,A00,092507,Dubnov; Shlomo,8,0,20,12
1657475693667,ECE 45,A01,083139,Congero; Spencer William,6,0,75,69
1657475699691,ECE 65,A50,083695,Saad; Andrew S,12,0,30,18
1657475699691,ECE 65,A51,095125,Saad; Andrew S,24,0,26,2
1657475705719,ECE 109,A01,091882,Touri; Behrouz,19,0,70,51
1657475711748,ECE 180,A00,083140,Abi Samra; Nicholas Camill,1,0,30,29
1657475711748,ECE 180,B00,083141,Abi Samra; Nicholas Camill,0,0,30,30
1657475717774,MATH 10A,A01,083735,Patchell; Gregory David,2,0,30,28
1657475717774,MATH 10A,A02,083736,Patchell; Gregory David,20,0,30,10
1657475717774,MATH 10A,A03,083737,Patchell; Gregory David,16,0,30,14
1657475723804,MATH 10B,A01,083207,Lim; Seonhee,8,0,34,26
1657475723804,MATH 10B,A02,083208,Lim; Seonhee,9,0,35,26
1657475723804,MATH 10B,A03,093472,Lim; Seonhee,7,0,34,27
1657475723804,MATH 10B,B01,083739,Sinha; Shubham,12,0,30,18
1657475729835,MATH 18,A01,083743,Cinel; Cameron Alexander,7,0,30,23
1657475729835,MATH 18,A02,083744,Cinel; Cameron Alexander,17,0,30,13
1657475729835,MATH 18,A03,083745,Cinel; Cameron Alexander,9,0,30,21
1657475729835,MATH 18,B01,083748,Rideout; David Porter,5,0,37,32
1657475729835,MATH 18,B02,083749,Rideout; David Porter,5,0,36,31
1657475729835,MATH 18,B03,083750,Rideout; David Porter,3,0,37,34
1657475729835,MATH 18,B04,083751,Rideout; David Porter,6,0,36,30
1657475729835,MATH 18,B05,093473,Rideout; David Porter,6,0,36,30
1657475729835,MATH 18,B06,093474,Rideout; David Porter,6,0,36,30
1657475735860,MATH 20A,A01,083754,Zheng; Zequn,14,0,40,26
1657475741882,MATH 20B,A01,083756,Briones; Jor-el Thomas Caparas,4,0,36,32
1657475741882,MATH 20B,A02,083757,Briones; Jor-el Thomas Caparas,1,0,36,35
1657475741882,MATH 20B,A03,093475,Briones; Jor-el Thomas Caparas,2,0,36,34
1657475747911,MATH 20C,A01,083760,Briones; Jor-el Thomas Caparas,1,0,35,34
1657475747911,MATH 20C,A02,083761,Briones; Jor-el Thomas Caparas,8,0,35,27
1657475747911,MATH 20C,A03,093476,Briones; Jor-el Thomas Caparas,0,1,36,36
1657475747911,MATH 20C,B01,083762,Bach; Quang Tran,1,0,30,29
1657475753936,MATH 20D,A01,083765,Tran; Brian Kha,5,0,30,25
1657475753936,MATH 20D,A02,083766,Tran; Brian Kha,5,0,30,25
1657475753936,MATH 20D,A03,083767,Tran; Brian Kha,5,0,30,25
1657475759959,MATH 20E,A01,083771,Ganguly; Soumya,9,0,32,23
1657475759959,MATH 20E,A02,083772,Ganguly; Soumya,6,0,32,26
1657475759959,MATH 20E,B01,083773,Ciotti; Benjamin,20,0,35,15
1657475759959,MATH 20E,B02,083774,Ciotti; Benjamin,17,0,35,18
1657475765982,MATH 103A,A01,083777,Greenfeld; Be'Eri,3,0,36,33
1657475765982,MATH 103A,A02,083778,Greenfeld; Be'Eri,5,0,36,31
1657475765982,MATH 103A,A03,093561,Greenfeld; Be'Eri,5,0,36,31
1657475765982,MATH 103A,B01,083779,Greenfeld; Be'Eri,7,0,36,29
1657475765982,MATH 103A,B02,083780,Greenfeld; Be'Eri,4,0,36,32
1657475765982,MATH 103A,B03,093562,Greenfeld; Be'Eri,3,0,36,33
1657475772005,MATH 105,A01,085443,Carter; Anne Toulson,15,0,35,20
1657475772005,MATH 105,A02,093477,Carter; Anne Toulson,20,0,35,15
1657475778030,MATH 109,A01,083213,Ganzberger; Geoffrey Michael,2,0,34,32
1657475778030,MATH 109,A02,083214,Ganzberger; Geoffrey Michael,4,0,34,30
1657475778030,MATH 109,A03,093478,Ganzberger; Geoffrey Michael,2,0,34,32
1657475778030,MATH 109,B01,083215,Ganzberger; Geoffrey Michael,1,0,32,31
1657475778030,MATH 109,B02,083216,Ganzberger; Geoffrey Michael,2,0,32,30
1657475778030,MATH 109,B03,093479,Ganzberger; Geoffrey Michael,8,0,32,24
1657475784063,MATH 142A,A01,083219,Chow; Bennett,7,0,32,25
1657475784063,MATH 142A,A02,083220,Chow; Bennett,10,0,32,22
1657475784063,MATH 142A,A03,093480,Chow; Bennett,8,0,32,24
1657475784063,MATH 142A,B03,093481,Chow; Bennett,8,0,32,24
1657475784063,MATH 142A,B04,093558,Chow; Bennett,13,0,32,19
1657475784063,MATH 142A,B05,093559,Chow; Bennett,6,0,32,26
1657475790092,MATH 193A,A01,083224,Rotar; Vladimir,8,0,34,26
1657475790092,MATH 193A,A02,083225,Rotar; Vladimir,9,0,34,25
1657475790092,MATH 193A,A03,083781,Rotar; Vladimir,5,0,34,29
1657475790092,MATH 193A,A04,083782,Rotar; Vladimir,10,0,34,24
1657475790092,MATH 193A,A05,093482,Rotar; Vladimir,10,0,34,24
1657475796119,MATH 197,001,091859,McAuley; Julian John,9999,0,9999,0
1657475796119,MATH 197,002,095566,Kedlaya; Kiran S.,9997,0,9999,2
1657475796119,MATH 197,003,095567,Xiao; Ming,9999,0,9999,0
1657475796119,MATH 197,004,095571,Perols; Johan Lars,9998,0,9999,1
1657475803208,COGS 9,A01,083615,Shannon; Kyle Michael,9,0,75,66
1657475809231,COGS 11,A01,083617,Boyle; Mary E. T.,22,0,48,26
1657475815255,COGS 13,A01,083071,Bastos; Amalia Pinkusfeld,11,0,71,60
1657475821282,COGS 14A,A01,092681,Semenuks; Arturs,5,1,100,95
1657475827305,COGS 14B,A01,083073,Cheng; Tzu-Han,6,0,63,57
1657475833332,COGS 17,A01,092677,Semenuks; Arturs,6,0,81,75
1657475839360,COGS 100,A01,083619,Allen; Michael Gordon,17,0,70,53
1657475845383,COGS 101A,A01,083621,Davis; Joshua Daniel,9,0,68,59
1657475851416,COGS 101B,A01,091572,Allen; Michael Gordon,12,0,65,53
1657475857442,COGS 101C,A01,083625,Delgado; Tania,17,0,35,18
1657475863467,COGS 107A,A01,083627,Boyle; Mary E. T.,13,0,60,47
1657475869491,COGS 118A,A01,083075,Gupta; Anjum,21,0,76,55
1657475875515,CSE 3,A50,083646,Miranda; Gregory Joseph,24,0,50,26
1657475881542,CSE 8A,A50,083650,Miranda; Gregory Joseph,17,1,56,39
1657475887564,CSE 11,A01,083080,Cao; Yingjun,6,15,40,34
1657475893590,CSE 12,A01,083652,Krause-Levy; Sophia Louisa,28,1,120,92
1657475899614,CSE 15L,A01,083654,Morris; Justin Loren,9,0,50,41
1657475899614,CSE 15L,A02,083655,Morris; Justin Loren,9,0,50,41
1657475905640,CSE 20,A01,083657,Tran; Khoa Dang,39,0,80,41
1657475911663,CSE 21,A01,095574,Bach; Quang Tran,22,0,48,26
1657475917689,CSE 30,A01,083084,Eldon; John,5,0,80,75
1657475917689,CSE 30,B01,095061,Bhaskar; Nishant,9,0,50,41
1657475923717,CSE 100,A01,083659,Cao; Yingjun,5,4,70,65
1657475929739,CSE 134B,A01,083661,Powell; Thomas Allan,22,0,100,78
1657475935763,CSE 140,A01,083663,Gungor; Onat,15,0,85,70
1657475941785,CSE 140L,A01,083088,Eldon; John,21,0,100,79
1657475947809,CSE 175,A01,083665,Kumar; Rakesh,3,0,25,22
1657475953832,CSE 190,A00,092507,Dubnov; Shlomo,8,0,20,12
1657475959860,ECE 45,A01,083139,Congero; Spencer William,6,0,75,69
1657475965885,ECE 65,A50,083695,Saad; Andrew S,12,0,30,18
1657475965885,ECE 65,A51,095125,Saad; Andrew S,24,0,26,2
1657475971908,ECE 109,A01,091882,Touri; Behrouz,19,0,70,51
1657475977929,ECE 180,A00,083140,Abi Samra; Nicholas Camill,1,0,30,29
1657475977929,ECE 180,B00,083141,Abi Samra; Nicholas Camill,0,0,30,30
1657475983953,MATH 10A,A01,083735,Patchell; Gregory David,2,0,30,28
1657475983953,MATH 10A,A02,083736,Patchell; Gregory David,20,0,30,10
1657475983953,MATH 10A,A03,083737,Patchell; Gregory David,16,0,30,14
1657475989981,MATH 10B,A01,083207,Lim; Seonhee,8,0,34,26
1657475989981,MATH 10B,A02,083208,Lim; Seonhee,9,0,35,26
1657475989981,MATH 10B,A03,093472,Lim; Seonhee,7,0,34,27
1657475989981,MATH 10B,B01,083739,Sinha; Shubham,12,0,30,18
1657475996004,MATH 18,A01,083743,Cinel; Cameron Alexander,7,0,30,23
1657475996004,MATH 18,A02,083744,Cinel; Cameron Alexander,17,0,30,13
1657475996004,MATH 18,A03,083745,Cinel; Cameron Alexander,9,0,30,21
1657475996004,MATH 18,B01,083748,Rideout; David Porter,5,0,37,32
1657475996004,MATH 18,B02,083749,Rideout; David Porter,5,0,36,31
1657475996004,MATH 18,B03,083750,Rideout; David Porter,3,0,37,34
1657475996004,MATH 18,B04,083751,Rideout; David Porter,6,0,36,30
1657475996004,MATH 18,B05,093473,Rideout; David Porter,6,0,36,30
1657475996004,MATH 18,B06,093474,Rideout; David Porter,6,0,36,30
1657476002031,MATH 20A,A01,083754,Zheng; Zequn,14,0,40,26
1657476008054,MATH 20B,A01,083756,Briones; Jor-el Thomas Caparas,4,0,36,32
1657476008054,MATH 20B,A02,083757,Briones; Jor-el Thomas Caparas,1,0,36,35
1657476008054,MATH 20B,A03,093475,Briones; Jor-el Thomas Caparas,2,0,36,34
1657476014078,MATH 20C,A01,083760,Briones; Jor-el Thomas Caparas,1,0,35,34
1657476014078,MATH 20C,A02,083761,Briones; Jor-el Thomas Caparas,8,0,35,27
1657476014078,MATH 20C,A03,093476,Briones; Jor-el Thomas Caparas,0,1,36,36
1657476014078,MATH 20C,B01,083762,Bach; Quang Tran,1,0,30,29
1657476020105,MATH 20D,A01,083765,Tran; Brian Kha,5,0,30,25
1657476020105,MATH 20D,A02,083766,Tran; Brian Kha,5,0,30,25
1657476020105,MATH 20D,A03,083767,Tran; Brian Kha,5,0,30,25
1657476026133,MATH 20E,A01,083771,Ganguly; Soumya,9,0,32,23
1657476026133,MATH 20E,A02,083772,Ganguly; Soumya,6,0,32,26
1657476026133,MATH 20E,B01,083773,Ciotti; Benjamin,20,0,35,15
1657476026133,MATH 20E,B02,083774,Ciotti; Benjamin,17,0,35,18
1657476032161,MATH 103A,A01,083777,Greenfeld; Be'Eri,3,0,36,33
1657476032161,MATH 103A,A02,083778,Greenfeld; Be'Eri,5,0,36,31
1657476032161,MATH 103A,A03,093561,Greenfeld; Be'Eri,5,0,36,31
1657476032161,MATH 103A,B01,083779,Greenfeld; Be'Eri,7,0,36,29
1657476032161,MATH 103A,B02,083780,Greenfeld; Be'Eri,4,0,36,32
1657476032161,MATH 103A,B03,093562,Greenfeld; Be'Eri,3,0,36,33
1657476038190,MATH 105,A01,085443,Carter; Anne Toulson,15,0,35,20
1657476038190,MATH 105,A02,093477,Carter; Anne Toulson,20,0,35,15
1657476044218,MATH 109,A01,083213,Ganzberger; Geoffrey Michael,2,0,34,32
1657476044218,MATH 109,A02,083214,Ganzberger; Geoffrey Michael,4,0,34,30
1657476044218,MATH 109,A03,093478,Ganzberger; Geoffrey Michael,2,0,34,32
1657476044218,MATH 109,B01,083215,Ganzberger; Geoffrey Michael,1,0,32,31
1657476044218,MATH 109,B02,083216,Ganzberger; Geoffrey Michael,2,0,32,30
1657476044218,MATH 109,B03,093479,Ganzberger; Geoffrey Michael,8,0,32,24
1657476050240,MATH 142A,A01,083219,Chow; Bennett,7,0,32,25
1657476050240,MATH 142A,A02,083220,Chow; Bennett,10,0,32,22
1657476050240,MATH 142A,A03,093480,Chow; Bennett,8,0,32,24
1657476050240,MATH 142A,B03,093481,Chow; Bennett,8,0,32,24
1657476050240,MATH 142A,B04,093558,Chow; Bennett,13,0,32,19
1657476050240,MATH 142A,B05,093559,Chow; Bennett,6,0,32,26
1657476056263,MATH 193A,A01,083224,Rotar; Vladimir,8,0,34,26
1657476056263,MATH 193A,A02,083225,Rotar; Vladimir,9,0,34,25
1657476056263,MATH 193A,A03,083781,Rotar; Vladimir,5,0,34,29
1657476056263,MATH 193A,A04,083782,Rotar; Vladimir,10,0,34,24
1657476056263,MATH 193A,A05,093482,Rotar; Vladimir,10,0,34,24
1657476062302,MATH 197,001,091859,McAuley; Julian John,9999,0,9999,0
1657476062302,MATH 197,002,095566,Kedlaya; Kiran S.,9997,0,9999,2
1657476062302,MATH 197,003,095567,Xiao; Ming,9999,0,9999,0
1657476062302,MATH 197,004,095571,Perols; Johan Lars,9998,0,9999,1
1657476069361,COGS 9,A01,083615,Shannon; Kyle Michael,9,0,75,66
1657476075388,COGS 11,A01,083617,Boyle; Mary E. T.,22,0,48,26
1657476081411,COGS 13,A01,083071,Bastos; Amalia Pinkusfeld,11,0,71,60
1657476087436,COGS 14A,A01,092681,Semenuks; Arturs,5,1,100,95
1657476093464,COGS 14B,A01,083073,Cheng; Tzu-Han,6,0,63,57
1657476099492,COGS 17,A01,092677,Semenuks; Arturs,6,0,81,75
1657476105513,COGS 100,A01,083619,Allen; Michael Gordon,17,0,70,53
1657476111541,COGS 101A,A01,083621,Davis; Joshua Daniel,9,0,68,59
1657476117565,COGS 101B,A01,091572,Allen; Michael Gordon,12,0,65,53
1657476123589,COGS 101C,A01,083625,Delgado; Tania,17,0,35,18
1657476129612,COGS 107A,A01,083627,Boyle; Mary E. T.,13,0,60,47
1657476135639,COGS 118A,A01,083075,Gupta; Anjum,21,0,76,55
1657476141662,CSE 3,A50,083646,Miranda; Gregory Joseph,24,0,50,26
1657476147686,CSE 8A,A50,083650,Miranda; Gregory Joseph,17,1,56,39
1657476153713,CSE 11,A01,083080,Cao; Yingjun,6,15,40,34
1657476159736,CSE 12,A01,083652,Krause-Levy; Sophia Louisa,28,1,120,92
1657476165759,CSE 15L,A01,083654,Morris; Justin Loren,9,0,50,41
1657476165759,CSE 15L,A02,083655,Morris; Justin Loren,9,0,50,41
1657476171787,CSE 20,A01,083657,Tran; Khoa Dang,39,0,80,41
1657476177813,CSE 21,A01,095574,Bach; Quang Tran,22,0,48,26
1657476183841,CSE 30,A01,083084,Eldon; John,5,0,80,75
1657476183841,CSE 30,B01,095061,Bhaskar; Nishant,9,0,50,41
1657476189865,CSE 100,A01,083659,Cao; Yingjun,5,4,70,65
1657476195890,CSE 134B,A01,083661,Powell; Thomas Allan,22,0,100,78
1657476201911,CSE 140,A01,083663,Gungor; Onat,15,0,85,70
1657476207936,CSE 140L,A01,083088,Eldon; John,21,0,100,79
1657476213963,CSE 175,A01,083665,Kumar; Rakesh,3,0,25,22
1657476219985,CSE 190,A00,092507,Dubnov; Shlomo,8,0,20,12
1657476226008,ECE 45,A01,083139,Congero; Spencer William,6,0,75,69
1657476232030,ECE 65,A50,083695,Saad; Andrew S,12,0,30,18
1657476232030,ECE 65,A51,095125,Saad; Andrew S,24,0,26,2
1657476238056,ECE 109,A01,091882,Touri; Behrouz,19,0,70,51
1657476244080,ECE 180,A00,083140,Abi Samra; Nicholas Camill,1,0,30,29
1657476244080,ECE 180,B00,083141,Abi Samra; Nicholas Camill,0,0,30,30
1657476250106,MATH 10A,A01,083735,Patchell; Gregory David,2,0,30,28
1657476250106,MATH 10A,A02,083736,Patchell; Gregory David,20,0,30,10
1657476250106,MATH 10A,A03,083737,Patchell; Gregory David,16,0,30,14
1657476256205,MATH 10B,A01,083207,Lim; Seonhee,8,0,34,26
1657476256205,MATH 10B,A02,083208,Lim; Seonhee,9,0,35,26
1657476256205,MATH 10B,A03,093472,Lim; Seonhee,7,0,34,27
1657476256205,MATH 10B,B01,083739,Sinha; Shubham,12,0,30,18
1657476262230,MATH 18,A01,083743,Cinel; Cameron Alexander,7,0,30,23
1657476262230,MATH 18,A02,083744,Cinel; Cameron Alexander,17,0,30,13
1657476262230,MATH 18,A03,083745,Cinel; Cameron Alexander,9,0,30,21
1657476262230,MATH 18,B01,083748,Rideout; David Porter,5,0,37,32
1657476262230,MATH 18,B02,083749,Rideout; David Porter,5,0,36,31
1657476262230,MATH 18,B03,083750,Rideout; David Porter,3,0,37,34
1657476262230,MATH 18,B04,083751,Rideout; David Porter,6,0,36,30
1657476262230,MATH 18,B05,093473,Rideout; David Porter,6,0,36,30
1657476262230,MATH 18,B06,093474,Rideout; David Porter,6,0,36,30
1657476268252,MATH 20A,A01,083754,Zheng; Zequn,14,0,40,26
1657476274276,MATH 20B,A01,083756,Briones; Jor-el Thomas Caparas,4,0,36,32
1657476274276,MATH 20B,A02,083757,Briones; Jor-el Thomas Caparas,1,0,36,35
1657476274276,MATH 20B,A03,093475,Briones; Jor-el Thomas Caparas,2,0,36,34
1657476280301,MATH 20C,A01,083760,Briones; Jor-el Thomas Caparas,1,0,35,34
1657476280301,MATH 20C,A02,083761,Briones; Jor-el Thomas Caparas,8,0,35,27
1657476280301,MATH 20C,A03,093476,Briones; Jor-el Thomas Caparas,0,1,36,36
1657476280301,MATH 20C,B01,083762,Bach; Quang Tran,1,0,30,29
1657476286326,MATH 20D,A01,083765,Tran; Brian Kha,5,0,30,25
1657476286326,MATH 20D,A02,083766,Tran; Brian Kha,5,0,30,25
1657476286326,MATH 20D,A03,083767,Tran; Brian Kha,5,0,30,25
1657476292349,MATH 20E,A01,083771,Ganguly; Soumya,9,0,32,23
1657476292349,MATH 20E,A02,083772,Ganguly; Soumya,6,0,32,26
1657476292349,MATH 20E,B01,083773,Ciotti; Benjamin,20,0,35,15
1657476292349,MATH 20E,B02,083774,Ciotti; Benjamin,17,0,35,18
1657476298374,MATH 103A,A01,083777,Greenfeld; Be'Eri,3,0,36,33
1657476298374,MATH 103A,A02,083778,Greenfeld; Be'Eri,5,0,36,31
1657476298374,MATH 103A,A03,093561,Greenfeld; Be'Eri,5,0,36,31
1657476298374,MATH 103A,B01,083779,Greenfeld; Be'Eri,7,0,36,29
1657476298374,MATH 103A,B02,083780,Greenfeld; Be'Eri,4,0,36,32
1657476298374,MATH 103A,B03,093562,Greenfeld; Be'Eri,3,0,36,33
1657476304400,MATH 105,A01,085443,Carter; Anne Toulson,15,0,35,20
1657476304400,MATH 105,A02,093477,Carter; Anne Toulson,20,0,35,15
1657476310424,MATH 109,A01,083213,Ganzberger; Geoffrey Michael,2,0,34,32
1657476310424,MATH 109,A02,083214,Ganzberger; Geoffrey Michael,4,0,34,30
1657476310424,MATH 109,A03,093478,Ganzberger; Geoffrey Michael,2,0,34,32
1657476310424,MATH 109,B01,083215,Ganzberger; Geoffrey Michael,1,0,32,31
1657476310424,MATH 109,B02,083216,Ganzberger; Geoffrey Michael,2,0,32,30
1657476310424,MATH 109,B03,093479,Ganzberger; Geoffrey Michael,8,0,32,24
1657476316446,MATH 142A,A01,083219,Chow; Bennett,7,0,32,25
1657476316446,MATH 142A,A02,083220,Chow; Bennett,10,0,32,22
1657476316446,MATH 142A,A03,093480,Chow; Bennett,8,0,32,24
1657476316446,MATH 142A,B03,093481,Chow; Bennett,8,0,32,24
1657476316446,MATH 142A,B04,093558,Chow; Bennett,13,0,32,19
1657476316446,MATH 142A,B05,093559,Chow; Bennett,6,0,32,26
1657476322475,MATH 193A,A01,083224,Rotar; Vladimir,8,0,34,26
1657476322475,MATH 193A,A02,083225,Rotar; Vladimir,9,0,34,25
1657476322475,MATH 193A,A03,083781,Rotar; Vladimir,5,0,34,29
1657476322475,MATH 193A,A04,083782,Rotar; Vladimir,10,0,34,24
1657476322475,MATH 193A,A05,093482,Rotar; Vladimir,10,0,34,24
1657476328501,MATH 197,001,091859,McAuley; Julian John,9999,0,9999,0
1657476328501,MATH 197,002,095566,Kedlaya; Kiran S.,9997,0,9999,2
1657476328501,MATH 197,003,095567,Xiao; Ming,9999,0,9999,0
1657476328501,MATH 197,004,095571,Perols; Johan Lars,9998,0,9999,1
1657476335573,COGS 9,A01,083615,Shannon; Kyle Michael,9,0,75,66
1657476341596,COGS 11,A01,083617,Boyle; Mary E. T.,22,0,48,26
1657476347630,COGS 13,A01,083071,Bastos; Amalia Pinkusfeld,11,0,71,60
1657476353654,COGS 14A,A01,092681,Semenuks; Arturs,5,1,100,95
1657476359681,COGS 14B,A01,083073,Cheng; Tzu-Han,6,0,63,57
1657476365704,COGS 17,A01,092677,Semenuks; Arturs,6,0,81,75
1657476371734,COGS 100,A01,083619,Allen; Michael Gordon,17,0,70,53
1657476377758,COGS 101A,A01,083621,Davis; Joshua Daniel,9,0,68,59
1657476383780,COGS 101B,A01,091572,Allen; Michael Gordon,12,0,65,53
1657476389802,COGS 101C,A01,083625,Delgado; Tania,17,0,35,18
1657476395829,COGS 107A,A01,083627,Boyle; Mary E. T.,13,0,60,47
1657476401851,COGS 118A,A01,083075,Gupta; Anjum,21,0,76,55
1657476407873,CSE 3,A50,083646,Miranda; Gregory Joseph,24,0,50,26
1657476413896,CSE 8A,A50,083650,Miranda; Gregory Joseph,17,1,56,39
1657476419918,CSE 11,A01,083080,Cao; Yingjun,6,15,40,34
1657476425946,CSE 12,A01,083652,Krause-Levy; Sophia Louisa,28,1,120,92
1657476431971,CSE 15L,A01,083654,Morris; Justin Loren,9,0,50,41
1657476431971,CSE 15L,A02,083655,Morris; Justin Loren,9,0,50,41
1657476437995,CSE 20,A01,083657,Tran; Khoa Dang,39,0,80,41
1657476444019,CSE 21,A01,095574,Bach; Quang Tran,22,0,48,26
1657476450044,CSE 30,A01,083084,Eldon; John,5,0,80,75
1657476450044,CSE 30,B01,095061,Bhaskar; Nishant,9,0,50,41
1657476456071,CSE 100,A01,083659,Cao; Yingjun,5,4,70,65
1657476462094,CSE 134B,A01,083661,Powell; Thomas Allan,22,0,100,78
1657476468117,CSE 140,A01,083663,Gungor; Onat,15,0,85,70
1657476474141,CSE 140L,A01,083088,Eldon; John,21,0,100,79
1657476480168,CSE 175,A01,083665,Kumar; Rakesh,3,0,25,22
1657476486195,CSE 190,A00,092507,Dubnov; Shlomo,8,0,20,12
1657476492219,ECE 45,A01,083139,Congero; Spencer William,6,0,75,69
1657476498241,ECE 65,A50,083695,Saad; Andrew S,12,0,30,18
1657476498241,ECE 65,A51,095125,Saad; Andrew S,24,0,26,2
1657476504266,ECE 109,A01,091882,Touri; Behrouz,19,0,70,51
1657476510293,ECE 180,A00,083140,Abi Samra; Nicholas Camill,1,0,30,29
1657476510293,ECE 180,B00,083141,Abi Samra; Nicholas Camill,0,0,30,30
1657476516322,MATH 10A,A01,083735,Patchell; Gregory David,2,0,30,28
1657476516322,MATH 10A,A02,083736,Patchell; Gregory David,20,0,30,10
1657476516322,MATH 10A,A03,083737,Patchell; Gregory David,16,0,30,14
1657476522349,MATH 10B,A01,083207,Lim; Seonhee,8,0,34,26
1657476522349,MATH 10B,A02,083208,Lim; Seonhee,9,0,35,26
1657476522349,MATH 10B,A03,093472,Lim; Seonhee,7,0,34,27
1657476522349,MATH 10B,B01,083739,Sinha; Shubham,12,0,30,18
1657476528372,MATH 18,A01,083743,Cinel; Cameron Alexander,7,0,30,23
1657476528372,MATH 18,A02,083744,Cinel; Cameron Alexander,17,0,30,13
1657476528372,MATH 18,A03,083745,Cinel; Cameron Alexander,9,0,30,21
1657476528372,MATH 18,B01,083748,Rideout; David Porter,5,0,37,32
1657476528372,MATH 18,B02,083749,Rideout; David Porter,5,0,36,31
1657476528372,MATH 18,B03,083750,Rideout; David Porter,3,0,37,34
1657476528372,MATH 18,B04,083751,Rideout; David Porter,6,0,36,30
1657476528372,MATH 18,B05,093473,Rideout; David Porter,6,0,36,30
1657476528372,MATH 18,B06,093474,Rideout; David Porter,6,0,36,30
1657476534395,MATH 20A,A01,083754,Zheng; Zequn,14,0,40,26
1657476540422,MATH 20B,A01,083756,Briones; Jor-el Thomas Caparas,4,0,36,32
1657476540422,MATH 20B,A02,083757,Briones; Jor-el Thomas Caparas,1,0,36,35
1657476540422,MATH 20B,A03,093475,Briones; Jor-el Thomas Caparas,2,0,36,34
1657476546446,MATH 20C,A01,083760,Briones; Jor-el Thomas Caparas,1,0,35,34
1657476546446,MATH 20C,A02,083761,Briones; Jor-el Thomas Caparas,8,0,35,27
1657476546446,MATH 20C,A03,093476,Briones; Jor-el Thomas Caparas,0,1,36,36
1657476546446,MATH 20C,B01,083762,Bach; Quang Tran,1,0,30,29
1657476552475,MATH 20D,A01,083765,Tran; Brian Kha,5,0,30,25
1657476552475,MATH 20D,A02,083766,Tran; Brian Kha,5,0,30,25
1657476552475,MATH 20D,A03,083767,Tran; Brian Kha,5,0,30,25
1657476558504,MATH 20E,A01,083771,Ganguly; Soumya,9,0,32,23
1657476558504,MATH 20E,A02,083772,Ganguly; Soumya,6,0,32,26
1657476558504,MATH 20E,B01,083773,Ciotti; Benjamin,20,0,35,15
1657476558504,MATH 20E,B02,083774,Ciotti; Benjamin,17,0,35,18
1657476564534,MATH 103A,A01,083777,Greenfeld; Be'Eri,3,0,36,33
1657476564534,MATH 103A,A02,083778,Greenfeld; Be'Eri,5,0,36,31
1657476564534,MATH 103A,A03,093561,Greenfeld; Be'Eri,5,0,36,31
1657476564534,MATH 103A,B01,083779,Greenfeld; Be'Eri,7,0,36,29
1657476564534,MATH 103A,B02,083780,Greenfeld; Be'Eri,4,0,36,32
1657476564534,MATH 103A,B03,093562,Greenfeld; Be'Eri,3,0,36,33
1657476570577,MATH 105,A01,085443,Carter; Anne Toulson,15,0,35,20
1657476570577,MATH 105,A02,093477,Carter; Anne Toulson,20,0,35,15
1657476576602,MATH 109,A01,083213,Ganzberger; Geoffrey Michael,2,0,34,32
1657476576602,MATH 109,A02,083214,Ganzberger; Geoffrey Michael,4,0,34,30
1657476576602,MATH 109,A03,093478,Ganzberger; Geoffrey Michael,2,0,34,32
1657476576602,MATH 109,B01,083215,Ganzberger; Geoffrey Michael,1,0,32,31
1657476576602,MATH 109,B02,083216,Ganzberger; Geoffrey Michael,2,0,32,30
1657476576602,MATH 109,B03,093479,Ganzberger; Geoffrey Michael,8,0,32,24
1657476582634,MATH 142A,A01,083219,Chow; Bennett,7,0,32,25
1657476582634,MATH 142A,A02,083220,Chow; Bennett,10,0,32,22
1657476582634,MATH 142A,A03,093480,Chow; Bennett,8,0,32,24
1657476582634,MATH 142A,B03,093481,Chow; Bennett,8,0,32,24
1657476582634,MATH 142A,B04,093558,Chow; Bennett,13,0,32,19
1657476582634,MATH 142A,B05,093559,Chow; Bennett,6,0,32,26
1657476588657,MATH 193A,A01,083224,Rotar; Vladimir,8,0,34,26
1657476588657,MATH 193A,A02,083225,Rotar; Vladimir,9,0,34,25
1657476588657,MATH 193A,A03,083781,Rotar; Vladimir,5,0,34,29
1657476588657,MATH 193A,A04,083782,Rotar; Vladimir,10,0,34,24
1657476588657,MATH 193A,A05,093482,Rotar; Vladimir,10,0,34,24
1657476594685,MATH 197,001,091859,McAuley; Julian John,9999,0,9999,0
1657476594685,MATH 197,002,095566,Kedlaya; Kiran S.,9997,0,9999,2
1657476594685,MATH 197,003,095567,Xiao; Ming,9999,0,9999,0
1657476594685,MATH 197,004,095571,Perols; Johan Lars,9998,0,9999,1
1657476601746,COGS 9,A01,083615,Shannon; Kyle Michael,9,0,75,66
1657476607772,COGS 11,A01,083617,Boyle; Mary E. T.,22,0,48,26
1657476613799,COGS 13,A01,083071,Bastos; Amalia Pinkusfeld,11,0,71,60
1657476619823,COGS 14A,A01,092681,Semenuks; Arturs,5,1,100,95
1657476625847,COGS 14B,A01,083073,Cheng; Tzu-Han,6,0,63,57
1657476631875,COGS 17,A01,092677,Semenuks; Arturs,6,0,81,75
1657476637897,COGS 100,A01,083619,Allen; Michael Gordon,17,0,70,53
1657476643922,COGS 101A,A01,083621,Davis; Joshua Daniel,9,0,68,59
1657476649944,COGS 101B,A01,091572,Allen; Michael Gordon,12,0,65,53
1657476655968,COGS 101C,A01,083625,Delgado; Tania,17,0,35,18
1657476661990,COGS 107A,A01,083627,Boyle; Mary E. T.,13,0,60,47
1657476668014,COGS 118A,A01,083075,Gupta; Anjum,21,0,76,55
1657476674036,CSE 3,A50,083646,Miranda; Gregory Joseph,24,0,50,26
1657476680065,CSE 8A,A50,083650,Miranda; Gregory Joseph,17,1,56,39
1657476686089,CSE 11,A01,083080,Cao; Yingjun,6,15,40,34
1657476692114,CSE 12,A01,083652,Krause-Levy; Sophia Louisa,28,1,120,92
1657476698137,CSE 15L,A01,083654,Morris; Justin Loren,9,0,50,41
1657476698137,CSE 15L,A02,083655,Morris; Justin Loren,9,0,50,41
1657476704163,CSE 20,A01,083657,Tran; Khoa Dang,39,0,80,41
1657476710185,CSE 21,A01,095574,Bach; Quang Tran,22,0,48,26
1657476716210,CSE 30,A01,083084,Eldon; John,5,0,80,75
1657476716210,CSE 30,B01,095061,Bhaskar; Nishant,9,0,50,41
1657476722234,CSE 100,A01,083659,Cao; Yingjun,5,4,70,65
1657476728260,CSE 134B,A01,083661,Powell; Thomas Allan,22,0,100,78
1657476734287,CSE 140,A01,083663,Gungor; Onat,15,0,85,70
1657476740313,CSE 140L,A01,083088,Eldon; John,21,0,100,79
1657476746337,CSE 175,A01,083665,Kumar; Rakesh,3,0,25,22
1657476752361,CSE 190,A00,092507,Dubnov; Shlomo,8,0,20,12
1657476758384,ECE 45,A01,083139,Congero; Spencer William,6,0,75,69
1657476764412,ECE 65,A50,083695,Saad; Andrew S,12,0,30,18
1657476764412,ECE 65,A51,095125,Saad; Andrew S,24,0,26,2
1657476770435,ECE 109,A01,091882,Touri; Behrouz,19,0,70,51
1657476776458,ECE 180,A00,083140,Abi Samra; Nicholas Camill,1,0,30,29
1657476776458,ECE 180,B00,083141,Abi Samra; Nicholas Camill,0,0,30,30
1657476782488,MATH 10A,A01,083735,Patchell; Gregory David,2,0,30,28
1657476782488,MATH 10A,A02,083736,Patchell; Gregory David,20,0,30,10
1657476782488,MATH 10A,A03,083737,Patchell; Gregory David,16,0,30,14
1657476788521,MATH 10B,A01,083207,Lim; Seonhee,8,0,34,26
1657476788521,MATH 10B,A02,083208,Lim; Seonhee,9,0,35,26
1657476788521,MATH 10B,A03,093472,Lim; Seonhee,7,0,34,27
1657476788521,MATH 10B,B01,083739,Sinha; Shubham,12,0,30,18
1657476794551,MATH 18,A01,083743,Cinel; Cameron Alexander,7,0,30,23
1657476794551,MATH 18,A02,083744,Cinel; Cameron Alexander,17,0,30,13
1657476794551,MATH 18,A03,083745,Cinel; Cameron Alexander,9,0,30,21
1657476794551,MATH 18,B01,083748,Rideout; David Porter,5,0,37,32
1657476794551,MATH 18,B02,083749,Rideout; David Porter,5,0,36,31
1657476794551,MATH 18,B03,083750,Rideout; David Porter,3,0,37,34
1657476794551,MATH 18,B04,083751,Rideout; David Porter,6,0,36,30
1657476794551,MATH 18,B05,093473,Rideout; David Porter,6,0,36,30
1657476794551,MATH 18,B06,093474,Rideout; David Porter,6,0,36,30
1657476800579,MATH 20A,A01,083754,Zheng; Zequn,14,0,40,26
1657476806602,MATH 20B,A01,083756,Briones; Jor-el Thomas Caparas,4,0,36,32
1657476806602,MATH 20B,A02,083757,Briones; Jor-el Thomas Caparas,1,0,36,35
1657476806602,MATH 20B,A03,093475,Briones; Jor-el Thomas Caparas,2,0,36,34
1657476812626,MATH 20C,A01,083760,Briones; Jor-el Thomas Caparas,1,0,35,34
1657476812626,MATH 20C,A02,083761,Briones; Jor-el Thomas Caparas,8,0,35,27
1657476812626,MATH 20C,A03,093476,Briones; Jor-el Thomas Caparas,0,1,36,36
1657476812626,MATH 20C,B01,083762,Bach; Quang Tran,1,0,30,29
1657476818656,MATH 20D,A01,083765,Tran; Brian Kha,5,0,30,25
1657476818656,MATH 20D,A02,083766,Tran; Brian Kha,5,0,30,25
1657476818656,MATH 20D,A03,083767,Tran; Brian Kha,5,0,30,25
1657476824685,MATH 20E,A01,083771,Ganguly; Soumya,9,0,32,23
1657476824685,MATH 20E,A02,083772,Ganguly; Soumya,6,0,32,26
1657476824685,MATH 20E,B01,083773,Ciotti; Benjamin,20,0,35,15
1657476824685,MATH 20E,B02,083774,Ciotti; Benjamin,17,0,35,18
1657476830709,MATH 103A,A01,083777,Greenfeld; Be'Eri,3,0,36,33
1657476830709,MATH 103A,A02,083778,Greenfeld; Be'Eri,5,0,36,31
1657476830709,MATH 103A,A03,093561,Greenfeld; Be'Eri,5,0,36,31
1657476830709,MATH 103A,B01,083779,Greenfeld; Be'Eri,7,0,36,29
1657476830709,MATH 103A,B02,083780,Greenfeld; Be'Eri,4,0,36,32
1657476830709,MATH 103A,B03,093562,Greenfeld; Be'Eri,3,0,36,33
1657476836738,MATH 105,A01,085443,Carter; Anne Toulson,15,0,35,20
1657476836738,MATH 105,A02,093477,Carter; Anne Toulson,20,0,35,15
1657476842768,MATH 109,A01,083213,Ganzberger; Geoffrey Michael,2,0,34,32
1657476842768,MATH 109,A02,083214,Ganzberger; Geoffrey Michael,4,0,34,30
1657476842768,MATH 109,A03,093478,Ganzberger; Geoffrey Michael,2,0,34,32
1657476842768,MATH 109,B01,083215,Ganzberger; Geoffrey Michael,1,0,32,31
1657476842768,MATH 109,B02,083216,Ganzberger; Geoffrey Michael,2,0,32,30
1657476842768,MATH 109,B03,093479,Ganzberger; Geoffrey Michael,8,0,32,24
1657476848792,MATH 142A,A01,083219,Chow; Bennett,7,0,32,25
1657476848792,MATH 142A,A02,083220,Chow; Bennett,10,0,32,22
1657476848792,MATH 142A,A03,093480,Chow; Bennett,8,0,32,24
1657476848792,MATH 142A,B03,093481,Chow; Bennett,8,0,32,24
1657476848792,MATH 142A,B04,093558,Chow; Bennett,13,0,32,19
1657476848792,MATH 142A,B05,093559,Chow; Bennett,6,0,32,26
1657476854887,MATH 193A,A01,083224,Rotar; Vladimir,8,0,34,26
1657476854887,MATH 193A,A02,083225,Rotar; Vladimir,9,0,34,25
1657476854887,MATH 193A,A03,083781,Rotar; Vladimir,5,0,34,29
1657476854887,MATH 193A,A04,083782,Rotar; Vladimir,10,0,34,24
1657476854887,MATH 193A,A05,093482,Rotar; Vladimir,10,0,34,24
1657476860917,MATH 197,001,091859,McAuley; Julian John,9999,0,9999,0
1657476860917,MATH 197,002,095566,Kedlaya; Kiran S.,9997,0,9999,2
1657476860917,MATH 197,003,095567,Xiao; Ming,9999,0,9999,0
1657476860917,MATH 197,004,095571,Perols; Johan Lars,9998,0,9999,1
1657476867972,COGS 9,A01,083615,Shannon; Kyle Michael,9,0,75,66
1657476873995,COGS 11,A01,083617,Boyle; Mary E. T.,22,0,48,26
1657476880020,COGS 13,A01,083071,Bastos; Amalia Pinkusfeld,11,0,71,60
1657476886044,COGS 14A,A01,092681,Semenuks; Arturs,5,1,100,95
1657476892069,COGS 14B,A01,083073,Cheng; Tzu-Han,6,0,63,57
1657476898096,COGS 17,A01,092677,Semenuks; Arturs,6,0,81,75
1657476904119,COGS 100,A01,083619,Allen; Michael Gordon,17,0,70,53
1657476910142,COGS 101A,A01,083621,Davis; Joshua Daniel,9,0,68,59
1657476916166,COGS 101B,A01,091572,Allen; Michael Gordon,12,0,65,53
1657476922190,COGS 101C,A01,083625,Delgado; Tania,17,0,35,18
1657476928219,COGS 107A,A01,083627,Boyle; Mary E. T.,13,0,60,47
1657476934253,COGS 118A,A01,083075,Gupta; Anjum,21,0,76,55
1657476940280,CSE 3,A50,083646,Miranda; Gregory Joseph,24,0,50,26
1657476946308,CSE 8A,A50,083650,Miranda; Gregory Joseph,17,1,56,39
1657476952331,CSE 11,A01,083080,Cao; Yingjun,6,15,40,34
1657476958363,CSE 12,A01,083652,Krause-Levy; Sophia Louisa,28,1,120,92
1657476964387,CSE 15L,A01,083654,Morris; Justin Loren,9,0,50,41
1657476964387,CSE 15L,A02,083655,Morris; Justin Loren,9,0,50,41
1657476970410,CSE 20,A01,083657,Tran; Khoa Dang,39,0,80,41
1657476976432,CSE 21,A01,095574,Bach; Quang Tran,22,0,48,26
1657476982455,CSE 30,A01,083084,Eldon; John,5,0,80,75
1657476982455,CSE 30,B01,095061,Bhaskar; Nishant,9,0,50,41
1657476988480,CSE 100,A01,083659,Cao; Yingjun,5,4,70,65
1657476994503,CSE 134B,A01,083661,Powell; Thomas Allan,22,0,100,78
1657477000530,CSE 140,A01,083663,Gungor; Onat,15,0,85,70
1657477006560,CSE 140L,A01,083088,Eldon; John,21,0,100,79
1657477012582,CSE 175,A01,083665,Kumar; Rakesh,3,0,25,22
1657477018608,CSE 190,A00,092507,Dubnov; Shlomo,8,0,20,12
1657477024633,ECE 45,A01,083139,Congero; Spencer William,6,0,75,69
1657477030660,ECE 65,A50,083695,Saad; Andrew S,12,0,30,18
1657477030660,ECE 65,A51,095125,Saad; Andrew S,24,0,26,2
1657477036687,ECE 109,A01,091882,Touri; Behrouz,19,0,70,51
1657477042712,ECE 180,A00,083140,Abi Samra; Nicholas Camill,1,0,30,29
1657477042712,ECE 180,B00,083141,Abi Samra; Nicholas Camill,0,0,30,30
1657477048740,MATH 10A,A01,083735,Patchell; Gregory David,2,0,30,28
1657477048740,MATH 10A,A02,083736,Patchell; Gregory David,20,0,30,10
1657477048740,MATH 10A,A03,083737,Patchell; Gregory David,16,0,30,14
1657477054763,MATH 10B,A01,083207,Lim; Seonhee,8,0,34,26
1657477054763,MATH 10B,A02,083208,Lim; Seonhee,9,0,35,26
1657477054763,MATH 10B,A03,093472,Lim; Seonhee,7,0,34,27
1657477054763,MATH 10B,B01,083739,Sinha; Shubham,12,0,30,18
1657477060787,MATH 18,A01,083743,Cinel; Cameron Alexander,7,0,30,23
1657477060787,MATH 18,A02,083744,Cinel; Cameron Alexander,17,0,30,13
1657477060787,MATH 18,A03,083745,Cinel; Cameron Alexander,9,0,30,21
1657477060787,MATH 18,B01,083748,Rideout; David Porter,5,0,37,32
1657477060787,MATH 18,B02,083749,Rideout; David Porter,5,0,36,31
1657477060787,MATH 18,B03,083750,Rideout; David Porter,3,0,37,34
1657477060787,MATH 18,B04,083751,Rideout; David Porter,6,0,36,30
1657477060787,MATH 18,B05,093473,Rideout; David Porter,6,0,36,30
1657477060787,MATH 18,B06,093474,Rideout; David Porter,6,0,36,30
1657477066809,MATH 20A,A01,083754,Zheng; Zequn,14,0,40,26
1657477072832,MATH 20B,A01,083756,Briones; Jor-el Thomas Caparas,4,0,36,32
1657477072832,MATH 20B,A02,083757,Briones; Jor-el Thomas Caparas,1,0,36,35
1657477072832,MATH 20B,A03,093475,Briones; Jor-el Thomas Caparas,2,0,36,34
1657477078856,MATH 20C,A01,083760,Briones; Jor-el Thomas Caparas,1,0,35,34
1657477078856,MATH 20C,A02,083761,Briones; Jor-el Thomas Caparas,8,0,35,27
1657477078856,MATH 20C,A03,093476,Briones; Jor-el Thomas Caparas,0,1,36,36
1657477078856,MATH 20C,B01,083762,Bach; Quang Tran,1,0,30,29
1657477084880,MATH 20D,A01,083765,Tran; Brian Kha,5,0,30,25
1657477084880,MATH 20D,A02,083766,Tran; Brian Kha,5,0,30,25
1657477084880,MATH 20D,A03,083767,Tran; Brian Kha,5,0,30,25
1657477090906,MATH 20E,A01,083771,Ganguly; Soumya,9,0,32,23
1657477090906,MATH 20E,A02,083772,Ganguly; Soumya,6,0,32,26
1657477090906,MATH 20E,B01,083773,Ciotti; Benjamin,20,0,35,15
1657477090906,MATH 20E,B02,083774,Ciotti; Benjamin,17,0,35,18
1657477096935,MATH 103A,A01,083777,Greenfeld; Be'Eri,3,0,36,33
1657477096935,MATH 103A,A02,083778,Greenfeld; Be'Eri,5,0,36,31
1657477096935,MATH 103A,A03,093561,Greenfeld; Be'Eri,5,0,36,31
1657477096935,MATH 103A,B01,083779,Greenfeld; Be'Eri,7,0,36,29
1657477096935,MATH 103A,B02,083780,Greenfeld; Be'Eri,4,0,36,32
1657477096935,MATH 103A,B03,093562,Greenfeld; Be'Eri,3,0,36,33
1657477102962,MATH 105,A01,085443,Carter; Anne Toulson,15,0,35,20
1657477102962,MATH 105,A02,093477,Carter; Anne Toulson,20,0,35,15
1657477108986,MATH 109,A01,083213,Ganzberger; Geoffrey Michael,2,0,34,32
1657477108986,MATH 109,A02,083214,Ganzberger; Geoffrey Michael,4,0,34,30
1657477108986,MATH 109,A03,093478,Ganzberger; Geoffrey Michael,2,0,34,32
1657477108986,MATH 109,B01,083215,Ganzberger; Geoffrey Michael,1,0,32,31
1657477108986,MATH 109,B02,083216,Ganzberger; Geoffrey Michael,2,0,32,30
1657477108986,MATH 109,B03,093479,Ganzberger; Geoffrey Michael,8,0,32,24
1657477115011,MATH 142A,A01,083219,Chow; Bennett,7,0,32,25
1657477115011,MATH 142A,A02,083220,Chow; Bennett,10,0,32,22
1657477115011,MATH 142A,A03,093480,Chow; Bennett,8,0,32,24
1657477115011,MATH 142A,B03,093481,Chow; Bennett,8,0,32,24
1657477115011,MATH 142A,B04,093558,Chow; Bennett,13,0,32,19
1657477115011,MATH 142A,B05,093559,Chow; Bennett,6,0,32,26
1657477121035,MATH 193A,A01,083224,Rotar; Vladimir,8,0,34,26
1657477121035,MATH 193A,A02,083225,Rotar; Vladimir,9,0,34,25
1657477121035,MATH 193A,A03,083781,Rotar; Vladimir,5,0,34,29
1657477121035,MATH 193A,A04,083782,Rotar; Vladimir,10,0,34,24
1657477121035,MATH 193A,A05,093482,Rotar; Vladimir,10,0,34,24
1657477127058,MATH 197,001,091859,McAuley; Julian John,9999,0,9999,0
1657477127058,MATH 197,002,095566,Kedlaya; Kiran S.,9997,0,9999,2
1657477127058,MATH 197,003,095567,Xiao; Ming,9999,0,9999,0
1657477127058,MATH 197,004,095571,Perols; Johan Lars,9998,0,9999,1
1657477134115,COGS 9,A01,083615,Shannon; Kyle Michael,9,0,75,66
1657477140138,COGS 11,A01,083617,Boyle; Mary E. T.,22,0,48,26
1657477146166,COGS 13,A01,083071,Bastos; Amalia Pinkusfeld,11,0,71,60
1657477152205,COGS 14A,A01,092681,Semenuks; Arturs,5,1,100,95
1657477158228,COGS 14B,A01,083073,Cheng; Tzu-Han,6,0,63,57
1657477164257,COGS 17,A01,092677,Semenuks; Arturs,6,0,81,75
1657477170284,COGS 100,A01,083619,Allen; Michael Gordon,17,0,70,53
1657477176312,COGS 101A,A01,083621,Davis; Joshua Daniel,9,0,68,59
1657477182336,COGS 101B,A01,091572,Allen; Michael Gordon,12,0,65,53
1657477188363,COGS 101C,A01,083625,Delgado; Tania,17,0,35,18
1657477194385,COGS 107A,A01,083627,Boyle; Mary E. T.,13,0,60,47
1657477200411,COGS 118A,A01,083075,Gupta; Anjum,21,0,76,55
1657477206438,CSE 3,A50,083646,Miranda; Gregory Joseph,24,0,50,26
1657477212460,CSE 8A,A50,083650,Miranda; Gregory Joseph,17,1,56,39
1657477218487,CSE 11,A01,083080,Cao; Yingjun,6,15,40,34
1657477224509,CSE 12,A01,083652,Krause-Levy; Sophia Louisa,28,1,120,92
1657477230534,CSE 15L,A01,083654,Morris; Justin Loren,9,0,50,41
1657477230534,CSE 15L,A02,083655,Morris; Justin Loren,9,0,50,41
1657477236565,CSE 20,A01,083657,Tran; Khoa Dang,39,0,80,41
1657477242586,CSE 21,A01,095574,Bach; Quang Tran,22,0,48,26
1657477248615,CSE 30,A01,083084,Eldon; John,5,0,80,75
1657477248615,CSE 30,B01,095061,Bhaskar; Nishant,9,0,50,41
1657477254637,CSE 100,A01,083659,Cao; Yingjun,5,4,70,65
1657477260664,CSE 134B,A01,083661,Powell; Thomas Allan,22,0,100,78
1657477266692,CSE 140,A01,083663,Gungor; Onat,15,0,85,70
1657477272720,CSE 140L,A01,083088,Eldon; John,21,0,100,79
1657477278756,CSE 175,A01,083665,Kumar; Rakesh,3,0,25,22
1657477284778,CSE 190,A00,092507,Dubnov; Shlomo,8,0,20,12
1657477290799,ECE 45,A01,083139,Congero; Spencer William,6,0,75,69
1657477296823,ECE 65,A50,083695,Saad; Andrew S,12,0,30,18
1657477296823,ECE 65,A51,095125,Saad; Andrew S,24,0,26,2
1657477302848,ECE 109,A01,091882,Touri; Behrouz,19,0,70,51
1657477308871,ECE 180,A00,083140,Abi Samra; Nicholas Camill,1,0,30,29
1657477308871,ECE 180,B00,083141,Abi Samra; Nicholas Camill,0,0,30,30
1657477314897,MATH 10A,A01,083735,Patchell; Gregory David,2,0,30,28
1657477314897,MATH 10A,A02,083736,Patchell; Gregory David,20,0,30,10
1657477314897,MATH 10A,A03,083737,Patchell; Gregory David,16,0,30,14
1657477320927,MATH 10B,A01,083207,Lim; Seonhee,8,0,34,26
1657477320927,MATH 10B,A02,083208,Lim; Seonhee,9,0,35,26
1657477320927,MATH 10B,A03,093472,Lim; Seonhee,7,0,34,27
1657477320927,MATH 10B,B01,083739,Sinha; Shubham,12,0,30,18
1657477326952,MATH 18,A01,083743,Cinel; Cameron Alexander,7,0,30,23
1657477326952,MATH 18,A02,083744,Cinel; Cameron Alexander,17,0,30,13
1657477326952,MATH 18,A03,083745,Cinel; Cameron Alexander,9,0,30,21
1657477326952,MATH 18,B01,083748,Rideout; David Porter,5,0,37,32
1657477326952,MATH 18,B02,083749,Rideout; David Porter,5,0,36,31
1657477326952,MATH 18,B03,083750,Rideout; David Porter,3,0,37,34
1657477326952,MATH 18,B04,083751,Rideout; David Porter,6,0,36,30
1657477326952,MATH 18,B05,093473,Rideout; David Porter,6,0,36,30
1657477326952,MATH 18,B06,093474,Rideout; David Porter,6,0,36,30
1657477332976,MATH 20A,A01,083754,Zheng; Zequn,14,0,40,26
1657477339004,MATH 20B,A01,083756,Briones; Jor-el Thomas Caparas,4,0,36,32
1657477339004,MATH 20B,A02,083757,Briones; Jor-el Thomas Caparas,1,0,36,35
1657477339004,MATH 20B,A03,093475,Briones; Jor-el Thomas Caparas,2,0,36,34
1657477345033,MATH 20C,A01,083760,Briones; Jor-el Thomas Caparas,1,0,35,34
1657477345033,MATH 20C,A02,083761,Briones; Jor-el Thomas Caparas,8,0,35,27
1657477345033,MATH 20C,A03,093476,Briones; Jor-el Thomas Caparas,0,1,36,36
1657477345033,MATH 20C,B01,083762,Bach; Quang Tran,1,0,30,29
1657477351056,MATH 20D,A01,083765,Tran; Brian Kha,5,0,30,25
1657477351056,MATH 20D,A02,083766,Tran; Brian Kha,5,0,30,25
1657477351056,MATH 20D,A03,083767,Tran; Brian Kha,5,0,30,25
1657477357084,MATH 20E,A01,083771,Ganguly; Soumya,9,0,32,23
1657477357084,MATH 20E,A02,083772,Ganguly; Soumya,6,0,32,26
1657477357084,MATH 20E,B01,083773,Ciotti; Benjamin,20,0,35,15
1657477357084,MATH 20E,B02,083774,Ciotti; Benjamin,17,0,35,18
1657477363109,MATH 103A,A01,083777,Greenfeld; Be'Eri,3,0,36,33
1657477363109,MATH 103A,A02,083778,Greenfeld; Be'Eri,5,0,36,31
1657477363109,MATH 103A,A03,093561,Greenfeld; Be'Eri,5,0,36,31
1657477363109,MATH 103A,B01,083779,Greenfeld; Be'Eri,7,0,36,29
1657477363109,MATH 103A,B02,083780,Greenfeld; Be'Eri,4,0,36,32
1657477363109,MATH 103A,B03,093562,Greenfeld; Be'Eri,3,0,36,33
1657477369137,MATH 105,A01,085443,Carter; Anne Toulson,15,0,35,20
1657477369137,MATH 105,A02,093477,Carter; Anne Toulson,20,0,35,15
1657477375166,MATH 109,A01,083213,Ganzberger; Geoffrey Michael,2,0,34,32
1657477375166,MATH 109,A02,083214,Ganzberger; Geoffrey Michael,4,0,34,30
1657477375166,MATH 109,A03,093478,Ganzberger; Geoffrey Michael,2,0,34,32
1657477375166,MATH 109,B01,083215,Ganzberger; Geoffrey Michael,1,0,32,31
1657477375166,MATH 109,B02,083216,Ganzberger; Geoffrey Michael,2,0,32,30
1657477375166,MATH 109,B03,093479,Ganzberger; Geoffrey Michael,8,0,32,24
1657477381198,MATH 142A,A01,083219,Chow; Bennett,7,0,32,25
1657477381198,MATH 142A,A02,083220,Chow; Bennett,10,0,32,22
1657477381198,MATH 142A,A03,093480,Chow; Bennett,8,0,32,24
1657477381198,MATH 142A,B03,093481,Chow; Bennett,8,0,32,24
1657477381198,MATH 142A,B04,093558,Chow; Bennett,13,0,32,19
1657477381198,MATH 142A,B05,093559,Chow; Bennett,6,0,32,26
1657477387223,MATH 193A,A01,083224,Rotar; Vladimir,8,0,34,26
1657477387223,MATH 193A,A02,083225,Rotar; Vladimir,9,0,34,25
1657477387223,MATH 193A,A03,083781,Rotar; Vladimir,5,0,34,29
1657477387223,MATH 193A,A04,083782,Rotar; Vladimir,10,0,34,24
1657477387223,MATH 193A,A05,093482,Rotar; Vladimir,10,0,34,24
1657477393254,MATH 197,001,091859,McAuley; Julian John,9999,0,9999,0
1657477393254,MATH 197,002,095566,Kedlaya; Kiran S.,9997,0,9999,2
1657477393254,MATH 197,003,095567,Xiao; Ming,9999,0,9999,0
1657477393254,MATH 197,004,095571,Perols; Johan Lars,9998,0,9999,1
1657477400310,COGS 9,A01,083615,Shannon; Kyle Michael,9,0,75,66
1657477406337,COGS 11,A01,083617,Boyle; Mary E. T.,22,0,48,26
1657477412370,COGS 13,A01,083071,Bastos; Amalia Pinkusfeld,11,0,71,60
1657477418393,COGS 14A,A01,092681,Semenuks; Arturs,5,1,100,95
1657477424418,COGS 14B,A01,083073,Cheng; Tzu-Han,6,0,63,57
1657477430444,COGS 17,A01,092677,Semenuks; Arturs,6,0,81,75
1657477436472,COGS 100,A01,083619,Allen; Michael Gordon,17,0,70,53
1657477442496,COGS 101A,A01,083621,Davis; Joshua Daniel,9,0,68,59
1657477448592,COGS 101B,A01,091572,Allen; Michael Gordon,12,0,65,53
1657477454616,COGS 101C,A01,083625,Delgado; Tania,17,0,35,18
1657477460640,COGS 107A,A01,083627,Boyle; Mary E. T.,13,0,60,47
1657477466664,COGS 118A,A01,083075,Gupta; Anjum,21,0,76,55
1657477472687,CSE 3,A50,083646,Miranda; Gregory Joseph,24,0,50,26
1657477478714,CSE 8A,A50,083650,Miranda; Gregory Joseph,17,1,56,39
1657477484738,CSE 11,A01,083080,Cao; Yingjun,6,15,40,34
1657477490761,CSE 12,A01,083652,Krause-Levy; Sophia Louisa,28,1,120,92
1657477496788,CSE 15L,A01,083654,Morris; Justin Loren,9,0,50,41
1657477496788,CSE 15L,A02,083655,Morris; Justin Loren,9,0,50,41
1657477502811,CSE 20,A01,083657,Tran; Khoa Dang,39,0,80,41
1657477508837,CSE 21,A01,095574,Bach; Quang Tran,22,0,48,26
1657477514864,CSE 30,A01,083084,Eldon; John,5,0,80,75
1657477514864,CSE 30,B01,095061,Bhaskar; Nishant,9,0,50,41
1657477520888,CSE 100,A01,083659,Cao; Yingjun,5,4,70,65
1657477526914,CSE 134B,A01,083661,Powell; Thomas Allan,22,0,100,78
1657477532946,CSE 140,A01,083663,Gungor; Onat,15,0,85,70
1657477538973,CSE 140L,A01,083088,Eldon; John,21,0,100,79
1657477544996,CSE 175,A01,083665,Kumar; Rakesh,3,0,25,22
1657477551019,CSE 190,A00,092507,Dubnov; Shlomo,8,0,20,12
1657477557047,ECE 45,A01,083139,Congero; Spencer William,6,0,75,69
1657477563072,ECE 65,A50,083695,Saad; Andrew S,12,0,30,18
1657477563072,ECE 65,A51,095125,Saad; Andrew S,24,0,26,2
1657477569098,ECE 109,A01,091882,Touri; Behrouz,19,0,70,51
1657477575126,ECE 180,A00,083140,Abi Samra; Nicholas Camill,1,0,30,29
1657477575126,ECE 180,B00,083141,Abi Samra; Nicholas Camill,0,0,30,30
1657477581150,MATH 10A,A01,083735,Patchell; Gregory David,2,0,30,28
1657477581150,MATH 10A,A02,083736,Patchell; Gregory David,20,0,30,10
1657477581150,MATH 10A,A03,083737,Patchell; Gregory David,16,0,30,14
1657477587174,MATH 10B,A01,083207,Lim; Seonhee,8,0,34,26
1657477587174,MATH 10B,A02,083208,Lim; Seonhee,9,0,35,26
1657477587174,MATH 10B,A03,093472,Lim; Seonhee,7,0,34,27
1657477587174,MATH 10B,B01,083739,Sinha; Shubham,12,0,30,18
1657477593206,MATH 18,A01,083743,Cinel; Cameron Alexander,7,0,30,23
1657477593206,MATH 18,A02,083744,Cinel; Cameron Alexander,17,0,30,13
1657477593206,MATH 18,A03,083745,Cinel; Cameron Alexander,9,0,30,21
1657477593206,MATH 18,B01,083748,Rideout; David Porter,5,0,37,32
1657477593206,MATH 18,B02,083749,Rideout; David Porter,5,0,36,31
1657477593206,MATH 18,B03,083750,Rideout; David Porter,3,0,37,34
1657477593206,MATH 18,B04,083751,Rideout; David Porter,6,0,36,30
1657477593206,MATH 18,B05,093473,Rideout; David Porter,6,0,36,30
1657477593206,MATH 18,B06,093474,Rideout; David Porter,6,0,36,30
1657477599230,MATH 20A,A01,083754,Zheng; Zequn,14,0,40,26
1657477605266,MATH 20B,A01,083756,Briones; Jor-el Thomas Caparas,4,0,36,32
1657477605266,MATH 20B,A02,083757,Briones; Jor-el Thomas Caparas,1,0,36,35
1657477605266,MATH 20B,A03,093475,Briones; Jor-el Thomas Caparas,2,0,36,34
1657477611296,MATH 20C,A01,083760,Briones; Jor-el Thomas Caparas,1,0,35,34
1657477611296,MATH 20C,A02,083761,Briones; Jor-el Thomas Caparas,8,0,35,27
1657477611296,MATH 20C,A03,093476,Briones; Jor-el Thomas Caparas,0,1,36,36
1657477611296,MATH 20C,B01,083762,Bach; Quang Tran,1,0,30,29
1657477617325,MATH 20D,A01,083765,Tran; Brian Kha,5,0,30,25
1657477617325,MATH 20D,A02,083766,Tran; Brian Kha,5,0,30,25
1657477617325,MATH 20D,A03,083767,Tran; Brian Kha,5,0,30,25
1657477623354,MATH 20E,A01,083771,Ganguly; Soumya,9,0,32,23
1657477623354,MATH 20E,A02,083772,Ganguly; Soumya,6,0,32,26
1657477623354,MATH 20E,B01,083773,Ciotti; Benjamin,20,0,35,15
1657477623354,MATH 20E,B02,083774,Ciotti; Benjamin,17,0,35,18
1657477629378,MATH 103A,A01,083777,Greenfeld; Be'Eri,3,0,36,33
1657477629378,MATH 103A,A02,083778,Greenfeld; Be'Eri,5,0,36,31
1657477629378,MATH 103A,A03,093561,Greenfeld; Be'Eri,5,0,36,31
1657477629378,MATH 103A,B01,083779,Greenfeld; Be'Eri,7,0,36,29
1657477629378,MATH 103A,B02,083780,Greenfeld; Be'Eri,4,0,36,32
1657477629378,MATH 103A,B03,093562,Greenfeld; Be'Eri,3,0,36,33
1657477635401,MATH 105,A01,085443,Carter; Anne Toulson,15,0,35,20
1657477635401,MATH 105,A02,093477,Carter; Anne Toulson,20,0,35,15
1657477641429,MATH 109,A01,083213,Ganzberger; Geoffrey Michael,2,0,34,32
1657477641429,MATH 109,A02,083214,Ganzberger; Geoffrey Michael,4,0,34,30
1657477641429,MATH 109,A03,093478,Ganzberger; Geoffrey Michael,2,0,34,32
1657477641429,MATH 109,B01,083215,Ganzberger; Geoffrey Michael,1,0,32,31
1657477641429,MATH 109,B02,083216,Ganzberger; Geoffrey Michael,2,0,32,30
1657477641429,MATH 109,B03,093479,Ganzberger; Geoffrey Michael,8,0,32,24
1657477647453,MATH 142A,A01,083219,Chow; Bennett,7,0,32,25
1657477647453,MATH 142A,A02,083220,Chow; Bennett,10,0,32,22
1657477647453,MATH 142A,A03,093480,Chow; Bennett,8,0,32,24
1657477647453,MATH 142A,B03,093481,Chow; Bennett,8,0,32,24
1657477647453,MATH 142A,B04,093558,Chow; Bennett,13,0,32,19
1657477647453,MATH 142A,B05,093559,Chow; Bennett,6,0,32,26
1657477653476,MATH 193A,A01,083224,Rotar; Vladimir,8,0,34,26
1657477653476,MATH 193A,A02,083225,Rotar; Vladimir,9,0,34,25
1657477653476,MATH 193A,A03,083781,Rotar; Vladimir,5,0,34,29
1657477653476,MATH 193A,A04,083782,Rotar; Vladimir,10,0,34,24
1657477653476,MATH 193A,A05,093482,Rotar; Vladimir,10,0,34,24
1657477659502,MATH 197,001,091859,McAuley; Julian John,9999,0,9999,0
1657477659502,MATH 197,002,095566,Kedlaya; Kiran S.,9997,0,9999,2
1657477659502,MATH 197,003,095567,Xiao; Ming,9999,0,9999,0
1657477659502,MATH 197,004,095571,Perols; Johan Lars,9998,0,9999,1
1657477666553,COGS 9,A01,083615,Shannon; Kyle Michael,9,0,75,66
1657477672592,COGS 11,A01,083617,Boyle; Mary E. T.,22,0,48,26
1657477678620,COGS 13,A01,083071,Bastos; Amalia Pinkusfeld,11,0,71,60
1657477684647,COGS 14A,A01,092681,Semenuks; Arturs,5,1,100,95
1657477690672,COGS 14B,A01,083073,Cheng; Tzu-Han,6,0,63,57
1657477696694,COGS 17,A01,092677,Semenuks; Arturs,6,0,81,75
1657477702717,COGS 100,A01,083619,Allen; Michael Gordon,17,0,70,53
1657477708742,COGS 101A,A01,083621,Davis; Joshua Daniel,9,0,68,59
1657477714768,COGS 101B,A01,091572,Allen; Michael Gordon,12,0,65,53
1657477720794,COGS 101C,A01,083625,Delgado; Tania,17,0,35,18
1657477726820,COGS 107A,A01,083627,Boyle; Mary E. T.,13,0,60,47
1657477732853,COGS 118A,A01,083075,Gupta; Anjum,21,0,76,55
1657477738877,CSE 3,A50,083646,Miranda; Gregory Joseph,24,0,50,26
1657477744899,CSE 8A,A50,083650,Miranda; Gregory Joseph,17,1,56,39
1657477750925,CSE 11,A01,083080,Cao; Yingjun,6,15,40,34
1657477756947,CSE 12,A01,083652,Krause-Levy; Sophia Louisa,28,1,120,92
1657477762970,CSE 15L,A01,083654,Morris; Justin Loren,9,0,50,41
1657477762970,CSE 15L,A02,083655,Morris; Justin Loren,9,0,50,41
1657477768995,CSE 20,A01,083657,Tran; Khoa Dang,39,0,80,41
1657477775019,CSE 21,A01,095574,Bach; Quang Tran,22,0,48,26
1657477781042,CSE 30,A01,083084,Eldon; John,5,0,80,75
1657477781042,CSE 30,B01,095061,Bhaskar; Nishant,9,0,50,41
1657477787066,CSE 100,A01,083659,Cao; Yingjun,5,4,70,65
1657477793090,CSE 134B,A01,083661,Powell; Thomas Allan,22,0,100,78
1657477799111,CSE 140,A01,083663,Gungor; Onat,15,0,85,70
1657477805135,CSE 140L,A01,083088,Eldon; John,21,0,100,79
1657477811160,CSE 175,A01,083665,Kumar; Rakesh,3,0,25,22
1657477817186,CSE 190,A00,092507,Dubnov; Shlomo,8,0,20,12
1657477823211,ECE 45,A01,083139,Congero; Spencer William,6,0,75,69
1657477829234,ECE 65,A50,083695,Saad; Andrew S,12,0,30,18
1657477829234,ECE 65,A51,095125,Saad; Andrew S,24,0,26,2
1657477835256,ECE 109,A01,091882,Touri; Behrouz,19,0,70,51
1657477841289,ECE 180,A00,083140,Abi Samra; Nicholas Camill,1,0,30,29
1657477841289,ECE 180,B00,083141,Abi Samra; Nicholas Camill,0,0,30,30
1657477847322,MATH 10A,A01,083735,Patchell; Gregory David,2,0,30,28
1657477847322,MATH 10A,A02,083736,Patchell; Gregory David,20,0,30,10
1657477847322,MATH 10A,A03,083737,Patchell; Gregory David,16,0,30,14
1657477853348,MATH 10B,A01,083207,Lim; Seonhee,8,0,34,26
1657477853348,MATH 10B,A02,083208,Lim; Seonhee,9,0,35,26
1657477853348,MATH 10B,A03,093472,Lim; Seonhee,7,0,34,27
1657477853348,MATH 10B,B01,083739,Sinha; Shubham,12,0,30,18
1657477859370,MATH 18,A01,083743,Cinel; Cameron Alexander,7,0,30,23
1657477859370,MATH 18,A02,083744,Cinel; Cameron Alexander,17,0,30,13
1657477859370,MATH 18,A03,083745,Cinel; Cameron Alexander,9,0,30,21
1657477859370,MATH 18,B01,083748,Rideout; David Porter,5,0,37,32
1657477859370,MATH 18,B02,083749,Rideout; David Porter,5,0,36,31
1657477859370,MATH 18,B03,083750,Rideout; David Porter,3,0,37,34
1657477859370,MATH 18,B04,083751,Rideout; David Porter,6,0,36,30
1657477859370,MATH 18,B05,093473,Rideout; David Porter,6,0,36,30
1657477859370,MATH 18,B06,093474,Rideout; David Porter,6,0,36,30
1657477865393,MATH 20A,A01,083754,Zheng; Zequn,14,0,40,26
1657477871424,MATH 20B,A01,083756,Briones; Jor-el Thomas Caparas,4,0,36,32
1657477871424,MATH 20B,A02,083757,Briones; Jor-el Thomas Caparas,1,0,36,35
1657477871424,MATH 20B,A03,093475,Briones; Jor-el Thomas Caparas,2,0,36,34
1657477877447,MATH 20C,A01,083760,Briones; Jor-el Thomas Caparas,1,0,35,34
1657477877447,MATH 20C,A02,083761,Briones; Jor-el Thomas Caparas,8,0,35,27
1657477877447,MATH 20C,A03,093476,Briones; Jor-el Thomas Caparas,0,1,36,36
1657477877447,MATH 20C,B01,083762,Bach; Quang Tran,1,0,30,29
1657477883477,MATH 20D,A01,083765,Tran; Brian Kha,5,0,30,25
1657477883477,MATH 20D,A02,083766,Tran; Brian Kha,5,0,30,25
1657477883477,MATH 20D,A03,083767,Tran; Brian Kha,5,0,30,25
1657477889500,MATH 20E,A01,083771,Ganguly; Soumya,9,0,32,23
1657477889500,MATH 20E,A02,083772,Ganguly; Soumya,6,0,32,26
1657477889500,MATH 20E,B01,083773,Ciotti; Benjamin,20,0,35,15
1657477889500,MATH 20E,B02,083774,Ciotti; Benjamin,17,0,35,18
1657477895525,MATH 103A,A01,083777,Greenfeld; Be'Eri,3,0,36,33
1657477895525,MATH 103A,A02,083778,Greenfeld; Be'Eri,5,0,36,31
1657477895525,MATH 103A,A03,093561,Greenfeld; Be'Eri,5,0,36,31
1657477895525,MATH 103A,B01,083779,Greenfeld; Be'Eri,7,0,36,29
1657477895525,MATH 103A,B02,083780,Greenfeld; Be'Eri,4,0,36,32
1657477895525,MATH 103A,B03,093562,Greenfeld; Be'Eri,3,0,36,33
1657477901549,MATH 105,A01,085443,Carter; Anne Toulson,15,0,35,20
1657477901549,MATH 105,A02,093477,Carter; Anne Toulson,20,0,35,15
1657477907574,MATH 109,A01,083213,Ganzberger; Geoffrey Michael,2,0,34,32
1657477907574,MATH 109,A02,083214,Ganzberger; Geoffrey Michael,4,0,34,30
1657477907574,MATH 109,A03,093478,Ganzberger; Geoffrey Michael,2,0,34,32
1657477907574,MATH 109,B01,083215,Ganzberger; Geoffrey Michael,1,0,32,31
1657477907574,MATH 109,B02,083216,Ganzberger; Geoffrey Michael,2,0,32,30
1657477907574,MATH 109,B03,093479,Ganzberger; Geoffrey Michael,8,0,32,24
1657477913599,MATH 142A,A01,083219,Chow; Bennett,7,0,32,25
1657477913599,MATH 142A,A02,083220,Chow; Bennett,10,0,32,22
1657477913599,MATH 142A,A03,093480,Chow; Bennett,8,0,32,24
1657477913599,MATH 142A,B03,093481,Chow; Bennett,8,0,32,24
1657477913599,MATH 142A,B04,093558,Chow; Bennett,13,0,32,19
1657477913599,MATH 142A,B05,093559,Chow; Bennett,6,0,32,26
1657477919623,MATH 193A,A01,083224,Rotar; Vladimir,8,0,34,26
1657477919623,MATH 193A,A02,083225,Rotar; Vladimir,9,0,34,25
1657477919623,MATH 193A,A03,083781,Rotar; Vladimir,5,0,34,29
1657477919623,MATH 193A,A04,083782,Rotar; Vladimir,10,0,34,24
1657477919623,MATH 193A,A05,093482,Rotar; Vladimir,10,0,34,24
1657477925650,MATH 197,001,091859,McAuley; Julian John,9999,0,9999,0
1657477925650,MATH 197,002,095566,Kedlaya; Kiran S.,9997,0,9999,2
1657477925650,MATH 197,003,095567,Xiao; Ming,9999,0,9999,0
1657477925650,MATH 197,004,095571,Perols; Johan Lars,9998,0,9999,1
1657477932704,COGS 9,A01,083615,Shannon; Kyle Michael,9,0,75,66
1657477938730,COGS 11,A01,083617,Boyle; Mary E. T.,22,0,48,26
1657477944755,COGS 13,A01,083071,Bastos; Amalia Pinkusfeld,11,0,71,60
1657477950781,COGS 14A,A01,092681,Semenuks; Arturs,5,1,100,95
1657477956809,COGS 14B,A01,083073,Cheng; Tzu-Han,6,0,63,57
1657477962835,COGS 17,A01,092677,Semenuks; Arturs,6,0,81,75
1657477968860,COGS 100,A01,083619,Allen; Michael Gordon,17,0,70,53
1657477974888,COGS 101A,A01,083621,Davis; Joshua Daniel,9,0,68,59
1657477980914,COGS 101B,A01,091572,Allen; Michael Gordon,12,0,65,53
1657477986938,COGS 101C,A01,083625,Delgado; Tania,17,0,35,18
1657477992964,COGS 107A,A01,083627,Boyle; Mary E. T.,13,0,60,47
1657477998993,COGS 118A,A01,083075,Gupta; Anjum,21,0,76,55
1657478005015,CSE 3,A50,083646,Miranda; Gregory Joseph,24,0,50,26
1657478011039,CSE 8A,A50,083650,Miranda; Gregory Joseph,17,1,56,39
1657478017067,CSE 11,A01,083080,Cao; Yingjun,6,15,40,34
1657478023089,CSE 12,A01,083652,Krause-Levy; Sophia Louisa,28,1,120,92
1657478029115,CSE 15L,A01,083654,Morris; Justin Loren,9,0,50,41
1657478029115,CSE 15L,A02,083655,Morris; Justin Loren,9,0,50,41
1657478035140,CSE 20,A01,083657,Tran; Khoa Dang,39,0,80,41
1657478041166,CSE 21,A01,095574,Bach; Quang Tran,22,0,48,26
1657478047281,CSE 30,A01,083084,Eldon; John,5,0,80,75
1657478047281,CSE 30,B01,095061,Bhaskar; Nishant,9,0,50,41
1657478053302,CSE 100,A01,083659,Cao; Yingjun,5,4,70,65
1657478059328,CSE 134B,A01,083661,Powell; Thomas Allan,22,0,100,78
1657478065355,CSE 140,A01,083663,Gungor; Onat,15,0,85,70
1657478071378,CSE 140L,A01,083088,Eldon; John,21,0,100,79
1657478077405,CSE 175,A01,083665,Kumar; Rakesh,3,0,25,22
1657478083430,CSE 190,A00,092507,Dubnov; Shlomo,8,0,20,12
1657478089454,ECE 45,A01,083139,Congero; Spencer William,6,0,75,69
1657478095491,ECE 65,A50,083695,Saad; Andrew S,12,0,30,18
1657478095491,ECE 65,A51,095125,Saad; Andrew S,24,0,26,2
1657478101518,ECE 109,A01,091882,Touri; Behrouz,19,0,70,51
1657478107544,ECE 180,A00,083140,Abi Samra; Nicholas Camill,1,0,30,29
1657478107544,ECE 180,B00,083141,Abi Samra; Nicholas Camill,0,0,30,30
1657478113568,MATH 10A,A01,083735,Patchell; Gregory David,2,0,30,28
1657478113568,MATH 10A,A02,083736,Patchell; Gregory David,20,0,30,10
1657478113568,MATH 10A,A03,083737,Patchell; Gregory David,16,0,30,14
1657478119592,MATH 10B,A01,083207,Lim; Seonhee,8,0,34,26
1657478119592,MATH 10B,A02,083208,Lim; Seonhee,9,0,35,26
1657478119592,MATH 10B,A03,093472,Lim; Seonhee,7,0,34,27
1657478119592,MATH 10B,B01,083739,Sinha; Shubham,12,0,30,18
1657478125621,MATH 18,A01,083743,Cinel; Cameron Alexander,7,0,30,23
1657478125621,MATH 18,A02,083744,Cinel; Cameron Alexander,17,0,30,13
1657478125621,MATH 18,A03,083745,Cinel; Cameron Alexander,9,0,30,21
1657478125621,MATH 18,B01,083748,Rideout; David Porter,5,0,37,32
1657478125621,MATH 18,B02,083749,Rideout; David Porter,5,0,36,31
1657478125621,MATH 18,B03,083750,Rideout; David Porter,3,0,37,34
1657478125621,MATH 18,B04,083751,Rideout; David Porter,6,0,36,30
1657478125621,MATH 18,B05,093473,Rideout; David Porter,6,0,36,30
1657478125621,MATH 18,B06,093474,Rideout; David Porter,6,0,36,30
1657478131644,MATH 20A,A01,083754,Zheng; Zequn,14,0,40,26
1657478137672,MATH 20B,A01,083756,Briones; Jor-el Thomas Caparas,4,0,36,32
1657478137672,MATH 20B,A02,083757,Briones; Jor-el Thomas Caparas,1,0,36,35
1657478137672,MATH 20B,A03,093475,Briones; Jor-el Thomas Caparas,2,0,36,34
1657478143712,MATH 20C,A01,083760,Briones; Jor-el Thomas Caparas,1,0,35,34
1657478143712,MATH 20C,A02,083761,Briones; Jor-el Thomas Caparas,8,0,35,27
1657478143712,MATH 20C,A03,093476,Briones; Jor-el Thomas Caparas,0,1,36,36
1657478143712,MATH 20C,B01,083762,Bach; Quang Tran,1,0,30,29
1657478149754,MATH 20D,A01,083765,Tran; Brian Kha,5,0,30,25
1657478149754,MATH 20D,A02,083766,Tran; Brian Kha,5,0,30,25
1657478149754,MATH 20D,A03,083767,Tran; Brian Kha,5,0,30,25
1657478155794,MATH 20E,A01,083771,Ganguly; Soumya,9,0,32,23
1657478155794,MATH 20E,A02,083772,Ganguly; Soumya,6,0,32,26
1657478155794,MATH 20E,B01,083773,Ciotti; Benjamin,20,0,35,15
1657478155794,MATH 20E,B02,083774,Ciotti; Benjamin,17,0,35,18
1657478161823,MATH 103A,A01,083777,Greenfeld; Be'Eri,3,0,36,33
1657478161823,MATH 103A,A02,083778,Greenfeld; Be'Eri,5,0,36,31
1657478161823,MATH 103A,A03,093561,Greenfeld; Be'Eri,5,0,36,31
1657478161823,MATH 103A,B01,083779,Greenfeld; Be'Eri,7,0,36,29
1657478161823,MATH 103A,B02,083780,Greenfeld; Be'Eri,4,0,36,32
1657478161823,MATH 103A,B03,093562,Greenfeld; Be'Eri,3,0,36,33
1657478167846,MATH 105,A01,085443,Carter; Anne Toulson,15,0,35,20
1657478167846,MATH 105,A02,093477,Carter; Anne Toulson,20,0,35,15
1657478173872,MATH 109,A01,083213,Ganzberger; Geoffrey Michael,2,0,34,32
1657478173872,MATH 109,A02,083214,Ganzberger; Geoffrey Michael,4,0,34,30
1657478173872,MATH 109,A03,093478,Ganzberger; Geoffrey Michael,2,0,34,32
1657478173872,MATH 109,B01,083215,Ganzberger; Geoffrey Michael,1,0,32,31
1657478173872,MATH 109,B02,083216,Ganzberger; Geoffrey Michael,2,0,32,30
1657478173872,MATH 109,B03,093479,Ganzberger; Geoffrey Michael,8,0,32,24
1657478179919,MATH 142A,A01,083219,Chow; Bennett,7,0,32,25
1657478179919,MATH 142A,A02,083220,Chow; Bennett,10,0,32,22
1657478179919,MATH 142A,A03,093480,Chow; Bennett,8,0,32,24
1657478179919,MATH 142A,B03,093481,Chow; Bennett,8,0,32,24
1657478179919,MATH 142A,B04,093558,Chow; Bennett,13,0,32,19
1657478179919,MATH 142A,B05,093559,Chow; Bennett,6,0,32,26
1657478185943,MATH 193A,A01,083224,Rotar; Vladimir,8,0,34,26
1657478185943,MATH 193A,A02,083225,Rotar; Vladimir,9,0,34,25
1657478185943,MATH 193A,A03,083781,Rotar; Vladimir,5,0,34,29
1657478185943,MATH 193A,A04,083782,Rotar; Vladimir,10,0,34,24
1657478185943,MATH 193A,A05,093482,Rotar; Vladimir,10,0,34,24
1657478191969,MATH 197,001,091859,McAuley; Julian John,9999,0,9999,0
1657478191969,MATH 197,002,095566,Kedlaya; Kiran S.,9997,0,9999,2
1657478191969,MATH 197,003,095567,Xiao; Ming,9999,0,9999,0
1657478191969,MATH 197,004,095571,Perols; Johan Lars,9998,0,9999,1
1657478199035,COGS 9,A01,083615,Shannon; Kyle Michael,9,0,75,66
1657478205067,COGS 11,A01,083617,Boyle; Mary E. T.,22,0,48,26
1657478211095,COGS 13,A01,083071,Bastos; Amalia Pinkusfeld,11,0,71,60
1657478217122,COGS 14A,A01,092681,Semenuks; Arturs,5,1,100,95
1657478223149,COGS 14B,A01,083073,Cheng; Tzu-Han,6,0,63,57
1657478229171,COGS 17,A01,092677,Semenuks; Arturs,6,0,81,75
1657478235196,COGS 100,A01,083619,Allen; Michael Gordon,17,0,70,53
1657478241218,COGS 101A,A01,083621,Davis; Joshua Daniel,9,0,68,59
1657478247243,COGS 101B,A01,091572,Allen; Michael Gordon,12,0,65,53
1657478253265,COGS 101C,A01,083625,Delgado; Tania,17,0,35,18
1657478259288,COGS 107A,A01,083627,Boyle; Mary E. T.,13,0,60,47
1657478265315,COGS 118A,A01,083075,Gupta; Anjum,21,0,76,55
1657478271350,CSE 3,A50,083646,Miranda; Gregory Joseph,24,0,50,26
1657478277395,CSE 8A,A50,083650,Miranda; Gregory Joseph,17,1,56,39
1657478283420,CSE 11,A01,083080,Cao; Yingjun,6,15,40,34
1657478289448,CSE 12,A01,083652,Krause-Levy; Sophia Louisa,28,1,120,92
1657478295474,CSE 15L,A01,083654,Morris; Justin Loren,9,0,50,41
1657478295474,CSE 15L,A02,083655,Morris; Justin Loren,9,0,50,41
1657478301511,CSE 20,A01,083657,Tran; Khoa Dang,39,0,80,41
1657478307537,CSE 21,A01,095574,Bach; Quang Tran,22,0,48,26
1657478313561,CSE 30,A01,083084,Eldon; John,5,0,80,75
1657478313561,CSE 30,B01,095061,Bhaskar; Nishant,9,0,50,41
1657478319585,CSE 100,A01,083659,Cao; Yingjun,5,4,70,65
1657478325607,CSE 134B,A01,083661,Powell; Thomas Allan,22,0,100,78
1657478331634,CSE 140,A01,083663,Gungor; Onat,15,0,85,70
1657478337660,CSE 140L,A01,083088,Eldon; John,21,0,100,79
1657478343698,CSE 175,A01,083665,Kumar; Rakesh,3,0,25,22
1657478349724,CSE 190,A00,092507,Dubnov; Shlomo,8,0,20,12
1657478355755,ECE 45,A01,083139,Congero; Spencer William,6,0,75,69
1657478361789,ECE 65,A50,083695,Saad; Andrew S,12,0,30,18
1657478361789,ECE 65,A51,095125,Saad; Andrew S,24,0,26,2
1657478367812,ECE 109,A01,091882,Touri; Behrouz,19,0,70,51
1657478373833,ECE 180,A00,083140,Abi Samra; Nicholas Camill,1,0,30,29
1657478373833,ECE 180,B00,083141,Abi Samra; Nicholas Camill,0,0,30,30
1657478379856,MATH 10A,A01,083735,Patchell; Gregory David,2,0,30,28
1657478379856,MATH 10A,A02,083736,Patchell; Gregory David,20,0,30,10
1657478379856,MATH 10A,A03,083737,Patchell; Gregory David,16,0,30,14
1657478385886,MATH 10B,A01,083207,Lim; Seonhee,8,0,34,26
1657478385886,MATH 10B,A02,083208,Lim; Seonhee,9,0,35,26
1657478385886,MATH 10B,A03,093472,Lim; Seonhee,7,0,34,27
1657478385886,MATH 10B,B01,083739,Sinha; Shubham,12,0,30,18
1657478391910,MATH 18,A01,083743,Cinel; Cameron Alexander,7,0,30,23
1657478391910,MATH 18,A02,083744,Cinel; Cameron Alexander,17,0,30,13
1657478391910,MATH 18,A03,083745,Cinel; Cameron Alexander,9,0,30,21
1657478391910,MATH 18,B01,083748,Rideout; David Porter,5,0,37,32
1657478391910,MATH 18,B02,083749,Rideout; David Porter,5,0,36,31
1657478391910,MATH 18,B03,083750,Rideout; David Porter,3,0,37,34
1657478391910,MATH 18,B04,083751,Rideout; David Porter,6,0,36,30
1657478391910,MATH 18,B05,093473,Rideout; David Porter,6,0,36,30
1657478391910,MATH 18,B06,093474,Rideout; David Porter,6,0,36,30
1657478397948,MATH 20A,A01,083754,Zheng; Zequn,14,0,40,26
1657478403971,MATH 20B,A01,083756,Briones; Jor-el Thomas Caparas,4,0,36,32
1657478403971,MATH 20B,A02,083757,Briones; Jor-el Thomas Caparas,1,0,36,35
1657478403971,MATH 20B,A03,093475,Briones; Jor-el Thomas Caparas,2,0,36,34
1657478409999,MATH 20C,A01,083760,Briones; Jor-el Thomas Caparas,1,0,35,34
1657478409999,MATH 20C,A02,083761,Briones; Jor-el Thomas Caparas,8,0,35,27
1657478409999,MATH 20C,A03,093476,Briones; Jor-el Thomas Caparas,0,1,36,36
1657478409999,MATH 20C,B01,083762,Bach; Quang Tran,1,0,30,29
1657478416023,MATH 20D,A01,083765,Tran; Brian Kha,5,0,30,25
1657478416023,MATH 20D,A02,083766,Tran; Brian Kha,5,0,30,25
1657478416023,MATH 20D,A03,083767,Tran; Brian Kha,5,0,30,25
1657478422050,MATH 20E,A01,083771,Ganguly; Soumya,9,0,32,23
1657478422050,MATH 20E,A02,083772,Ganguly; Soumya,6,0,32,26
1657478422050,MATH 20E,B01,083773,Ciotti; Benjamin,20,0,35,15
1657478422050,MATH 20E,B02,083774,Ciotti; Benjamin,17,0,35,18
1657478428081,MATH 103A,A01,083777,Greenfeld; Be'Eri,3,0,36,33
1657478428081,MATH 103A,A02,083778,Greenfeld; Be'Eri,5,0,36,31
1657478428081,MATH 103A,A03,093561,Greenfeld; Be'Eri,5,0,36,31
1657478428081,MATH 103A,B01,083779,Greenfeld; Be'Eri,7,0,36,29
1657478428081,MATH 103A,B02,083780,Greenfeld; Be'Eri,4,0,36,32
1657478428081,MATH 103A,B03,093562,Greenfeld; Be'Eri,3,0,36,33
1657478434119,MATH 105,A01,085443,Carter; Anne Toulson,15,0,35,20
1657478434119,MATH 105,A02,093477,Carter; Anne Toulson,20,0,35,15
1657478440143,MATH 109,A01,083213,Ganzberger; Geoffrey Michael,2,0,34,32
1657478440143,MATH 109,A02,083214,Ganzberger; Geoffrey Michael,4,0,34,30
1657478440143,MATH 109,A03,093478,Ganzberger; Geoffrey Michael,2,0,34,32
1657478440143,MATH 109,B01,083215,Ganzberger; Geoffrey Michael,1,0,32,31
1657478440143,MATH 109,B02,083216,Ganzberger; Geoffrey Michael,2,0,32,30
1657478440143,MATH 109,B03,093479,Ganzberger; Geoffrey Michael,8,0,32,24
1657478446167,MATH 142A,A01,083219,Chow; Bennett,7,0,32,25
1657478446167,MATH 142A,A02,083220,Chow; Bennett,10,0,32,22
1657478446167,MATH 142A,A03,093480,Chow; Bennett,8,0,32,24
1657478446167,MATH 142A,B03,093481,Chow; Bennett,8,0,32,24
1657478446167,MATH 142A,B04,093558,Chow; Bennett,13,0,32,19
1657478446167,MATH 142A,B05,093559,Chow; Bennett,6,0,32,26
1657478452200,MATH 193A,A01,083224,Rotar; Vladimir,8,0,34,26
1657478452200,MATH 193A,A02,083225,Rotar; Vladimir,9,0,34,25
1657478452200,MATH 193A,A03,083781,Rotar; Vladimir,5,0,34,29
1657478452200,MATH 193A,A04,083782,Rotar; Vladimir,10,0,34,24
1657478452200,MATH 193A,A05,093482,Rotar; Vladimir,10,0,34,24
1657478458226,MATH 197,001,091859,McAuley; Julian John,9999,0,9999,0
1657478458226,MATH 197,002,095566,Kedlaya; Kiran S.,9997,0,9999,2
1657478458226,MATH 197,003,095567,Xiao; Ming,9999,0,9999,0
1657478458226,MATH 197,004,095571,Perols; Johan Lars,9998,0,9999,1
1657478465282,COGS 9,A01,083615,Shannon; Kyle Michael,9,0,75,66
1657478471306,COGS 11,A01,083617,Boyle; Mary E. T.,22,0,48,26
1657478477333,COGS 13,A01,083071,Bastos; Amalia Pinkusfeld,11,0,71,60
1657478483357,COGS 14A,A01,092681,Semenuks; Arturs,5,1,100,95
1657478489384,COGS 14B,A01,083073,Cheng; Tzu-Han,6,0,63,57
1657478495410,COGS 17,A01,092677,Semenuks; Arturs,6,0,81,75
1657478501443,COGS 100,A01,083619,Allen; Michael Gordon,17,0,70,53
1657478507468,COGS 101A,A01,083621,Davis; Joshua Daniel,9,0,68,59
1657478513495,COGS 101B,A01,091572,Allen; Michael Gordon,12,0,65,53
1657478519518,COGS 101C,A01,083625,Delgado; Tania,17,0,35,18
1657478525546,COGS 107A,A01,083627,Boyle; Mary E. T.,13,0,60,47
1657478531569,COGS 118A,A01,083075,Gupta; Anjum,21,0,76,55
1657478537598,CSE 3,A50,083646,Miranda; Gregory Joseph,24,0,50,26
1657478543626,CSE 8A,A50,083650,Miranda; Gregory Joseph,17,1,56,39
1657478549655,CSE 11,A01,083080,Cao; Yingjun,6,15,40,34
1657478555676,CSE 12,A01,083652,Krause-Levy; Sophia Louisa,28,1,120,92
1657478561700,CSE 15L,A01,083654,Morris; Justin Loren,9,0,50,41
1657478561700,CSE 15L,A02,083655,Morris; Justin Loren,9,0,50,41
1657478567732,CSE 20,A01,083657,Tran; Khoa Dang,39,0,80,41
1657478573757,CSE 21,A01,095574,Bach; Quang Tran,22,0,48,26
1657478579782,CSE 30,A01,083084,Eldon; John,5,0,80,75
1657478579782,CSE 30,B01,095061,Bhaskar; Nishant,9,0,50,41
1657478585810,CSE 100,A01,083659,Cao; Yingjun,5,4,70,65
1657478591835,CSE 134B,A01,083661,Powell; Thomas Allan,22,0,100,78
1657478597861,CSE 140,A01,083663,Gungor; Onat,15,0,85,70
1657478603884,CSE 140L,A01,083088,Eldon; John,21,0,100,79
1657478609906,CSE 175,A01,083665,Kumar; Rakesh,3,0,25,22
1657478615937,CSE 190,A00,092507,Dubnov; Shlomo,8,0,20,12
1657478621958,ECE 45,A01,083139,Congero; Spencer William,6,0,75,69
1657478627983,ECE 65,A50,083695,Saad; Andrew S,12,0,30,18
1657478627983,ECE 65,A51,095125,Saad; Andrew S,24,0,26,2
1657478634006,ECE 109,A01,091882,Touri; Behrouz,19,0,70,51
1657478640033,ECE 180,A00,083140,Abi Samra; Nicholas Camill,1,0,30,29
1657478640033,ECE 180,B00,083141,Abi Samra; Nicholas Camill,0,0,30,30
1657478646153,MATH 10A,A01,083735,Patchell; Gregory David,2,0,30,28
1657478646153,MATH 10A,A02,083736,Patchell; Gregory David,20,0,30,10
1657478646153,MATH 10A,A03,083737,Patchell; Gregory David,16,0,30,14
1657478652181,MATH 10B,A01,083207,Lim; Seonhee,8,0,34,26
1657478652181,MATH 10B,A02,083208,Lim; Seonhee,9,0,35,26
1657478652181,MATH 10B,A03,093472,Lim; Seonhee,7,0,34,27
1657478652181,MATH 10B,B01,083739,Sinha; Shubham,12,0,30,18
1657478658213,MATH 18,A01,083743,Cinel; Cameron Alexander,7,0,30,23
1657478658213,MATH 18,A02,083744,Cinel; Cameron Alexander,17,0,30,13
1657478658213,MATH 18,A03,083745,Cinel; Cameron Alexander,9,0,30,21
1657478658213,MATH 18,B01,083748,Rideout; David Porter,5,0,37,32
1657478658213,MATH 18,B02,083749,Rideout; David Porter,5,0,36,31
1657478658213,MATH 18,B03,083750,Rideout; David Porter,3,0,37,34
1657478658213,MATH 18,B04,083751,Rideout; David Porter,6,0,36,30
1657478658213,MATH 18,B05,093473,Rideout; David Porter,6,0,36,30
1657478658213,MATH 18,B06,093474,Rideout; David Porter,6,0,36,30
1657478664237,MATH 20A,A01,083754,Zheng; Zequn,14,0,40,26
1657478670265,MATH 20B,A01,083756,Briones; Jor-el Thomas Caparas,4,0,36,32
1657478670265,MATH 20B,A02,083757,Briones; Jor-el Thomas Caparas,1,0,36,35
1657478670265,MATH 20B,A03,093475,Briones; Jor-el Thomas Caparas,2,0,36,34
1657478676290,MATH 20C,A01,083760,Briones; Jor-el Thomas Caparas,1,0,35,34
1657478676290,MATH 20C,A02,083761,Briones; Jor-el Thomas Caparas,8,0,35,27
1657478676290,MATH 20C,A03,093476,Briones; Jor-el Thomas Caparas,0,1,36,36
1657478676290,MATH 20C,B01,083762,Bach; Quang Tran,1,0,30,29
1657478682326,MATH 20D,A01,083765,Tran; Brian Kha,5,0,30,25
1657478682326,MATH 20D,A02,083766,Tran; Brian Kha,5,0,30,25
1657478682326,MATH 20D,A03,083767,Tran; Brian Kha,5,0,30,25
1657478688355,MATH 20E,A01,083771,Ganguly; Soumya,9,0,32,23
1657478688355,MATH 20E,A02,083772,Ganguly; Soumya,6,0,32,26
1657478688355,MATH 20E,B01,083773,Ciotti; Benjamin,20,0,35,15
1657478688355,MATH 20E,B02,083774,Ciotti; Benjamin,17,0,35,18
1657478694380,MATH 103A,A01,083777,Greenfeld; Be'Eri,3,0,36,33
1657478694380,MATH 103A,A02,083778,Greenfeld; Be'Eri,5,0,36,31
1657478694380,MATH 103A,A03,093561,Greenfeld; Be'Eri,5,0,36,31
1657478694380,MATH 103A,B01,083779,Greenfeld; Be'Eri,7,0,36,29
1657478694380,MATH 103A,B02,083780,Greenfeld; Be'Eri,4,0,36,32
1657478694380,MATH 103A,B03,093562,Greenfeld; Be'Eri,3,0,36,33
1657478700407,MATH 105,A01,085443,Carter; Anne Toulson,15,0,35,20
1657478700407,MATH 105,A02,093477,Carter; Anne Toulson,20,0,35,15
1657478706437,MATH 109,A01,083213,Ganzberger; Geoffrey Michael,2,0,34,32
1657478706437,MATH 109,A02,083214,Ganzberger; Geoffrey Michael,4,0,34,30
1657478706437,MATH 109,A03,093478,Ganzberger; Geoffrey Michael,2,0,34,32
1657478706437,MATH 109,B01,083215,Ganzberger; Geoffrey Michael,1,0,32,31
1657478706437,MATH 109,B02,083216,Ganzberger; Geoffrey Michael,2,0,32,30
1657478706437,MATH 109,B03,093479,Ganzberger; Geoffrey Michael,8,0,32,24
1657478712459,MATH 142A,A01,083219,Chow; Bennett,7,0,32,25
1657478712459,MATH 142A,A02,083220,Chow; Bennett,10,0,32,22
1657478712459,MATH 142A,A03,093480,Chow; Bennett,8,0,32,24
1657478712459,MATH 142A,B03,093481,Chow; Bennett,8,0,32,24
1657478712459,MATH 142A,B04,093558,Chow; Bennett,13,0,32,19
1657478712459,MATH 142A,B05,093559,Chow; Bennett,6,0,32,26
1657478718487,MATH 193A,A01,083224,Rotar; Vladimir,8,0,34,26
1657478718487,MATH 193A,A02,083225,Rotar; Vladimir,9,0,34,25
1657478718487,MATH 193A,A03,083781,Rotar; Vladimir,5,0,34,29
1657478718487,MATH 193A,A04,083782,Rotar; Vladimir,10,0,34,24
1657478718487,MATH 193A,A05,093482,Rotar; Vladimir,10,0,34,24
1657478724517,MATH 197,001,091859,McAuley; Julian John,9999,0,9999,0
1657478724517,MATH 197,002,095566,Kedlaya; Kiran S.,9997,0,9999,2
1657478724517,MATH 197,003,095567,Xiao; Ming,9999,0,9999,0
1657478724517,MATH 197,004,095571,Perols; Johan Lars,9998,0,9999,1
1657478731570,COGS 9,A01,083615,Shannon; Kyle Michael,9,0,75,66
1657478737597,COGS 11,A01,083617,Boyle; Mary E. T.,22,0,48,26
1657478743621,COGS 13,A01,083071,Bastos; Amalia Pinkusfeld,11,0,71,60
1657478749649,COGS 14A,A01,092681,Semenuks; Arturs,5,1,100,95
1657478755671,COGS 14B,A01,083073,Cheng; Tzu-Han,6,0,63,57
1657478761696,COGS 17,A01,092677,Semenuks; Arturs,6,0,81,75
1657478767722,COGS 100,A01,083619,Allen; Michael Gordon,17,0,70,53
1657478773743,COGS 101A,A01,083621,Davis; Joshua Daniel,9,0,68,59
1657478779770,COGS 101B,A01,091572,Allen; Michael Gordon,12,0,65,53
1657478785799,COGS 101C,A01,083625,Delgado; Tania,17,0,35,18
1657478791822,COGS 107A,A01,083627,Boyle; Mary E. T.,13,0,60,47
1657478797843,COGS 118A,A01,083075,Gupta; Anjum,21,0,76,55
1657478803870,CSE 3,A50,083646,Miranda; Gregory Joseph,24,0,50,26
1657478809894,CSE 8A,A50,083650,Miranda; Gregory Joseph,17,1,56,39
1657478815918,CSE 11,A01,083080,Cao; Yingjun,6,15,40,34
1657478821943,CSE 12,A01,083652,Krause-Levy; Sophia Louisa,28,1,120,92
1657478827968,CSE 15L,A01,083654,Morris; Justin Loren,9,0,50,41
1657478827968,CSE 15L,A02,083655,Morris; Justin Loren,9,0,50,41
1657478833996,CSE 20,A01,083657,Tran; Khoa Dang,39,0,80,41
1657478840023,CSE 21,A01,095574,Bach; Quang Tran,22,0,48,26
1657478846048,CSE 30,A01,083084,Eldon; John,5,0,80,75
1657478846048,CSE 30,B01,095061,Bhaskar; Nishant,9,0,50,41
1657478852076,CSE 100,A01,083659,Cao; Yingjun,5,4,70,65
1657478858099,CSE 134B,A01,083661,Powell; Thomas Allan,22,0,100,78
1657478864121,CSE 140,A01,083663,Gungor; Onat,15,0,85,70
1657478870146,CSE 140L,A01,083088,Eldon; John,21,0,100,79
1657478876171,CSE 175,A01,083665,Kumar; Rakesh,3,0,25,22
1657478882195,CSE 190,A00,092507,Dubnov; Shlomo,8,0,20,12
1657478888226,ECE 45,A01,083139,Congero; Spencer William,6,0,75,69
1657478894256,ECE 65,A50,083695,Saad; Andrew S,12,0,30,18
1657478894256,ECE 65,A51,095125,Saad; Andrew S,24,0,26,2
1657478900282,ECE 109,A01,091882,Touri; Behrouz,19,0,70,51
1657478906305,ECE 180,A00,083140,Abi Samra; Nicholas Camill,1,0,30,29
1657478906305,ECE 180,B00,083141,Abi Samra; Nicholas Camill,0,0,30,30
1657478912328,MATH 10A,A01,083735,Patchell; Gregory David,2,0,30,28
1657478912328,MATH 10A,A02,083736,Patchell; Gregory David,20,0,30,10
1657478912328,MATH 10A,A03,083737,Patchell; Gregory David,16,0,30,14
1657478918356,MATH 10B,A01,083207,Lim; Seonhee,8,0,34,26
1657478918356,MATH 10B,A02,083208,Lim; Seonhee,9,0,35,26
1657478918356,MATH 10B,A03,093472,Lim; Seonhee,7,0,34,27
1657478918356,MATH 10B,B01,083739,Sinha; Shubham,12,0,30,18
1657478924381,MATH 18,A01,083743,Cinel; Cameron Alexander,7,0,30,23
1657478924381,MATH 18,A02,083744,Cinel; Cameron Alexander,17,0,30,13
1657478924381,MATH 18,A03,083745,Cinel; Cameron Alexander,9,0,30,21
1657478924381,MATH 18,B01,083748,Rideout; David Porter,5,0,37,32
1657478924381,MATH 18,B02,083749,Rideout; David Porter,5,0,36,31
1657478924381,MATH 18,B03,083750,Rideout; David Porter,3,0,37,34
1657478924381,MATH 18,B04,083751,Rideout; David Porter,6,0,36,30
1657478924381,MATH 18,B05,093473,Rideout; David Porter,6,0,36,30
1657478924381,MATH 18,B06,093474,Rideout; David Porter,6,0,36,30
1657478930406,MATH 20A,A01,083754,Zheng; Zequn,14,0,40,26
1657478936430,MATH 20B,A01,083756,Briones; Jor-el Thomas Caparas,4,0,36,32
1657478936430,MATH 20B,A02,083757,Briones; Jor-el Thomas Caparas,1,0,36,35
1657478936430,MATH 20B,A03,093475,Briones; Jor-el Thomas Caparas,2,0,36,34
1657478942457,MATH 20C,A01,083760,Briones; Jor-el Thomas Caparas,1,0,35,34
1657478942457,MATH 20C,A02,083761,Briones; Jor-el Thomas Caparas,8,0,35,27
1657478942457,MATH 20C,A03,093476,Briones; Jor-el Thomas Caparas,0,1,36,36
1657478942457,MATH 20C,B01,083762,Bach; Quang Tran,1,0,30,29
1657478948480,MATH 20D,A01,083765,Tran; Brian Kha,5,0,30,25
1657478948480,MATH 20D,A02,083766,Tran; Brian Kha,5,0,30,25
1657478948480,MATH 20D,A03,083767,Tran; Brian Kha,5,0,30,25
1657478954509,MATH 20E,A01,083771,Ganguly; Soumya,9,0,32,23
1657478954509,MATH 20E,A02,083772,Ganguly; Soumya,6,0,32,26
1657478954509,MATH 20E,B01,083773,Ciotti; Benjamin,20,0,35,15
1657478954509,MATH 20E,B02,083774,Ciotti; Benjamin,17,0,35,18
1657478960532,MATH 103A,A01,083777,Greenfeld; Be'Eri,3,0,36,33
1657478960532,MATH 103A,A02,083778,Greenfeld; Be'Eri,5,0,36,31
1657478960532,MATH 103A,A03,093561,Greenfeld; Be'Eri,5,0,36,31
1657478960532,MATH 103A,B01,083779,Greenfeld; Be'Eri,7,0,36,29
1657478960532,MATH 103A,B02,083780,Greenfeld; Be'Eri,4,0,36,32
1657478960532,MATH 103A,B03,093562,Greenfeld; Be'Eri,3,0,36,33
1657478966560,MATH 105,A01,085443,Carter; Anne Toulson,15,0,35,20
1657478966560,MATH 105,A02,093477,Carter; Anne Toulson,20,0,35,15
1657478972588,MATH 109,A01,083213,Ganzberger; Geoffrey Michael,2,0,34,32
1657478972588,MATH 109,A02,083214,Ganzberger; Geoffrey Michael,4,0,34,30
1657478972588,MATH 109,A03,093478,Ganzberger; Geoffrey Michael,2,0,34,32
1657478972588,MATH 109,B01,083215,Ganzberger; Geoffrey Michael,1,0,32,31
1657478972588,MATH 109,B02,083216,Ganzberger; Geoffrey Michael,2,0,32,30
1657478972588,MATH 109,B03,093479,Ganzberger; Geoffrey Michael,8,0,32,24
1657478978610,MATH 142A,A01,083219,Chow; Bennett,7,0,32,25
1657478978610,MATH 142A,A02,083220,Chow; Bennett,10,0,32,22
1657478978610,MATH 142A,A03,093480,Chow; Bennett,8,0,32,24
1657478978610,MATH 142A,B03,093481,Chow; Bennett,8,0,32,24
1657478978610,MATH 142A,B04,093558,Chow; Bennett,13,0,32,19
1657478978610,MATH 142A,B05,093559,Chow; Bennett,6,0,32,26
1657478984642,MATH 193A,A01,083224,Rotar; Vladimir,8,0,34,26
1657478984642,MATH 193A,A02,083225,Rotar; Vladimir,9,0,34,25
1657478984642,MATH 193A,A03,083781,Rotar; Vladimir,5,0,34,29
1657478984642,MATH 193A,A04,083782,Rotar; Vladimir,10,0,34,24
1657478984642,MATH 193A,A05,093482,Rotar; Vladimir,10,0,34,24
1657478990671,MATH 197,001,091859,McAuley; Julian John,9999,0,9999,0
1657478990671,MATH 197,002,095566,Kedlaya; Kiran S.,9997,0,9999,2
1657478990671,MATH 197,003,095567,Xiao; Ming,9999,0,9999,0
1657478990671,MATH 197,004,095571,Perols; Johan Lars,9998,0,9999,1
1657478997726,COGS 9,A01,083615,Shannon; Kyle Michael,9,0,75,66
1657479003759,COGS 11,A01,083617,Boyle; Mary E. T.,22,0,48,26
1657479009783,COGS 13,A01,083071,Bastos; Amalia Pinkusfeld,11,0,71,60
1657479015806,COGS 14A,A01,092681,Semenuks; Arturs,5,1,100,95
1657479021829,COGS 14B,A01,083073,Cheng; Tzu-Han,6,0,63,57
1657479027851,COGS 17,A01,092677,Semenuks; Arturs,6,0,81,75
1657479033878,COGS 100,A01,083619,Allen; Michael Gordon,17,0,70,53
1657479039900,COGS 101A,A01,083621,Davis; Joshua Daniel,9,0,68,59
1657479045923,COGS 101B,A01,091572,Allen; Michael Gordon,12,0,65,53
1657479051950,COGS 101C,A01,083625,Delgado; Tania,17,0,35,18
1657479057980,COGS 107A,A01,083627,Boyle; Mary E. T.,13,0,60,47
1657479064005,COGS 118A,A01,083075,Gupta; Anjum,21,0,76,55
1657479070032,CSE 3,A50,083646,Miranda; Gregory Joseph,24,0,50,26
1657479076055,CSE 8A,A50,083650,Miranda; Gregory Joseph,17,1,56,39
1657479082081,CSE 11,A01,083080,Cao; Yingjun,6,15,40,34
1657479088104,CSE 12,A01,083652,Krause-Levy; Sophia Louisa,28,1,120,92
1657479094131,CSE 15L,A01,083654,Morris; Justin Loren,9,0,50,41
1657479094131,CSE 15L,A02,083655,Morris; Justin Loren,9,0,50,41
1657479100154,CSE 20,A01,083657,Tran; Khoa Dang,39,0,80,41
1657479106176,CSE 21,A01,095574,Bach; Quang Tran,22,0,48,26
1657479112204,CSE 30,A01,083084,Eldon; John,5,0,80,75
1657479112204,CSE 30,B01,095061,Bhaskar; Nishant,9,0,50,41
1657479118228,CSE 100,A01,083659,Cao; Yingjun,5,4,70,65
1657479124253,CSE 134B,A01,083661,Powell; Thomas Allan,22,0,100,78
1657479130275,CSE 140,A01,083663,Gungor; Onat,15,0,85,70
1657479136300,CSE 140L,A01,083088,Eldon; John,21,0,100,79
1657479142325,CSE 175,A01,083665,Kumar; Rakesh,3,0,25,22
1657479148352,CSE 190,A00,092507,Dubnov; Shlomo,8,0,20,12
1657479154376,ECE 45,A01,083139,Congero; Spencer William,6,0,75,69
1657479160399,ECE 65,A50,083695,Saad; Andrew S,12,0,30,18
1657479160399,ECE 65,A51,095125,Saad; Andrew S,24,0,26,2
1657479166422,ECE 109,A01,091882,Touri; Behrouz,19,0,70,51
1657479172448,ECE 180,A00,083140,Abi Samra; Nicholas Camill,1,0,30,29
1657479172448,ECE 180,B00,083141,Abi Samra; Nicholas Camill,0,0,30,30
1657479178471,MATH 10A,A01,083735,Patchell; Gregory David,2,0,30,28
1657479178471,MATH 10A,A02,083736,Patchell; Gregory David,20,0,30,10
1657479178471,MATH 10A,A03,083737,Patchell; Gregory David,16,0,30,14
1657479184505,MATH 10B,A01,083207,Lim; Seonhee,8,0,34,26
1657479184505,MATH 10B,A02,083208,Lim; Seonhee,9,0,35,26
1657479184505,MATH 10B,A03,093472,Lim; Seonhee,7,0,34,27
1657479184505,MATH 10B,B01,083739,Sinha; Shubham,12,0,30,18
1657479190528,MATH 18,A01,083743,Cinel; Cameron Alexander,7,0,30,23
1657479190528,MATH 18,A02,083744,Cinel; Cameron Alexander,17,0,30,13
1657479190528,MATH 18,A03,083745,Cinel; Cameron Alexander,9,0,30,21
1657479190528,MATH 18,B01,083748,Rideout; David Porter,5,0,37,32
1657479190528,MATH 18,B02,083749,Rideout; David Porter,5,0,36,31
1657479190528,MATH 18,B03,083750,Rideout; David Porter,3,0,37,34
1657479190528,MATH 18,B04,083751,Rideout; David Porter,6,0,36,30
1657479190528,MATH 18,B05,093473,Rideout; David Porter,6,0,36,30
1657479190528,MATH 18,B06,093474,Rideout; David Porter,6,0,36,30
1657479196554,MATH 20A,A01,083754,Zheng; Zequn,14,0,40,26
1657479202579,MATH 20B,A01,083756,Briones; Jor-el Thomas Caparas,4,0,36,32
1657479202579,MATH 20B,A02,083757,Briones; Jor-el Thomas Caparas,1,0,36,35
1657479202579,MATH 20B,A03,093475,Briones; Jor-el Thomas Caparas,2,0,36,34
1657479208614,MATH 20C,A01,083760,Briones; Jor-el Thomas Caparas,1,0,35,34
1657479208614,MATH 20C,A02,083761,Briones; Jor-el Thomas Caparas,8,0,35,27
1657479208614,MATH 20C,A03,093476,Briones; Jor-el Thomas Caparas,0,1,36,36
1657479208614,MATH 20C,B01,083762,Bach; Quang Tran,1,0,30,29
1657479214637,MATH 20D,A01,083765,Tran; Brian Kha,5,0,30,25
1657479214637,MATH 20D,A02,083766,Tran; Brian Kha,5,0,30,25
1657479214637,MATH 20D,A03,083767,Tran; Brian Kha,5,0,30,25
1657479220664,MATH 20E,A01,083771,Ganguly; Soumya,9,0,32,23
1657479220664,MATH 20E,A02,083772,Ganguly; Soumya,6,0,32,26
1657479220664,MATH 20E,B01,083773,Ciotti; Benjamin,20,0,35,15
1657479220664,MATH 20E,B02,083774,Ciotti; Benjamin,17,0,35,18
1657479226694,MATH 103A,A01,083777,Greenfeld; Be'Eri,3,0,36,33
1657479226694,MATH 103A,A02,083778,Greenfeld; Be'Eri,5,0,36,31
1657479226694,MATH 103A,A03,093561,Greenfeld; Be'Eri,5,0,36,31
1657479226694,MATH 103A,B01,083779,Greenfeld; Be'Eri,7,0,36,29
1657479226694,MATH 103A,B02,083780,Greenfeld; Be'Eri,4,0,36,32
1657479226694,MATH 103A,B03,093562,Greenfeld; Be'Eri,3,0,36,33
1657479232717,MATH 105,A01,085443,Carter; Anne Toulson,15,0,35,20
1657479232717,MATH 105,A02,093477,Carter; Anne Toulson,20,0,35,15
1657479238741,MATH 109,A01,083213,Ganzberger; Geoffrey Michael,2,0,34,32
1657479238741,MATH 109,A02,083214,Ganzberger; Geoffrey Michael,4,0,34,30
1657479238741,MATH 109,A03,093478,Ganzberger; Geoffrey Michael,2,0,34,32
1657479238741,MATH 109,B01,083215,Ganzberger; Geoffrey Michael,1,0,32,31
1657479238741,MATH 109,B02,083216,Ganzberger; Geoffrey Michael,2,0,32,30
1657479238741,MATH 109,B03,093479,Ganzberger; Geoffrey Michael,8,0,32,24
1657479244836,MATH 142A,A01,083219,Chow; Bennett,7,0,32,25
1657479244836,MATH 142A,A02,083220,Chow; Bennett,10,0,32,22
1657479244836,MATH 142A,A03,093480,Chow; Bennett,8,0,32,24
1657479244836,MATH 142A,B03,093481,Chow; Bennett,8,0,32,24
1657479244836,MATH 142A,B04,093558,Chow; Bennett,13,0,32,19
1657479244836,MATH 142A,B05,093559,Chow; Bennett,6,0,32,26
1657479250871,MATH 193A,A01,083224,Rotar; Vladimir,8,0,34,26
1657479250871,MATH 193A,A02,083225,Rotar; Vladimir,9,0,34,25
1657479250871,MATH 193A,A03,083781,Rotar; Vladimir,5,0,34,29
1657479250871,MATH 193A,A04,083782,Rotar; Vladimir,10,0,34,24
1657479250871,MATH 193A,A05,093482,Rotar; Vladimir,10,0,34,24
1657479256909,MATH 197,001,091859,McAuley; Julian John,9999,0,9999,0
1657479256909,MATH 197,002,095566,Kedlaya; Kiran S.,9997,0,9999,2
1657479256909,MATH 197,003,095567,Xiao; Ming,9999,0,9999,0
1657479256909,MATH 197,004,095571,Perols; Johan Lars,9998,0,9999,1
1657479263961,COGS 9,A01,083615,Shannon; Kyle Michael,9,0,75,66
1657479269988,COGS 11,A01,083617,Boyle; Mary E. T.,22,0,48,26
1657479276014,COGS 13,A01,083071,Bastos; Amalia Pinkusfeld,11,0,71,60
1657479282040,COGS 14A,A01,092681,Semenuks; Arturs,5,1,100,95
1657479288075,COGS 14B,A01,083073,Cheng; Tzu-Han,6,0,63,57
1657479294099,COGS 17,A01,092677,Semenuks; Arturs,6,0,81,75
1657479300123,COGS 100,A01,083619,Allen; Michael Gordon,17,0,70,53
1657479306151,COGS 101A,A01,083621,Davis; Joshua Daniel,9,0,68,59
1657479312174,COGS 101B,A01,091572,Allen; Michael Gordon,12,0,65,53
1657479318197,COGS 101C,A01,083625,Delgado; Tania,17,0,35,18
1657479324223,COGS 107A,A01,083627,Boyle; Mary E. T.,13,0,60,47
1657479330246,COGS 118A,A01,083075,Gupta; Anjum,21,0,76,55
1657479336267,CSE 3,A50,083646,Miranda; Gregory Joseph,24,0,50,26
1657479342295,CSE 8A,A50,083650,Miranda; Gregory Joseph,17,1,56,39
1657479348319,CSE 11,A01,083080,Cao; Yingjun,6,15,40,34
1657479354345,CSE 12,A01,083652,Krause-Levy; Sophia Louisa,28,1,120,92
1657479360368,CSE 15L,A01,083654,Morris; Justin Loren,9,0,50,41
1657479360368,CSE 15L,A02,083655,Morris; Justin Loren,9,0,50,41
1657479366391,CSE 20,A01,083657,Tran; Khoa Dang,39,0,80,41
1657479372414,CSE 21,A01,095574,Bach; Quang Tran,22,0,48,26
1657479378441,CSE 30,A01,083084,Eldon; John,5,0,80,75
1657479378441,CSE 30,B01,095061,Bhaskar; Nishant,9,0,50,41
1657479384468,CSE 100,A01,083659,Cao; Yingjun,5,4,70,65
1657479390494,CSE 134B,A01,083661,Powell; Thomas Allan,22,0,100,78
1657479396519,CSE 140,A01,083663,Gungor; Onat,15,0,85,70
1657479402557,CSE 140L,A01,083088,Eldon; John,21,0,100,79
1657479408585,CSE 175,A01,083665,Kumar; Rakesh,3,0,25,22
1657479414612,CSE 190,A00,092507,Dubnov; Shlomo,8,0,20,12
1657479420639,ECE 45,A01,083139,Congero; Spencer William,6,0,75,69
1657479426665,ECE 65,A50,083695,Saad; Andrew S,12,0,30,18
1657479426665,ECE 65,A51,095125,Saad; Andrew S,24,0,26,2
1657479432692,ECE 109,A01,091882,Touri; Behrouz,19,0,70,51
1657479438715,ECE 180,A00,083140,Abi Samra; Nicholas Camill,1,0,30,29
1657479438715,ECE 180,B00,083141,Abi Samra; Nicholas Camill,0,0,30,30
1657479444748,MATH 10A,A01,083735,Patchell; Gregory David,2,0,30,28
1657479444748,MATH 10A,A02,083736,Patchell; Gregory David,20,0,30,10
1657479444748,MATH 10A,A03,083737,Patchell; Gregory David,16,0,30,14
1657479450771,MATH 10B,A01,083207,Lim; Seonhee,8,0,34,26
1657479450771,MATH 10B,A02,083208,Lim; Seonhee,9,0,35,26
1657479450771,MATH 10B,A03,093472,Lim; Seonhee,7,0,34,27
1657479450771,MATH 10B,B01,083739,Sinha; Shubham,12,0,30,18
1657479456797,MATH 18,A01,083743,Cinel; Cameron Alexander,7,0,30,23
1657479456797,MATH 18,A02,083744,Cinel; Cameron Alexander,17,0,30,13
1657479456797,MATH 18,A03,083745,Cinel; Cameron Alexander,9,0,30,21
1657479456797,MATH 18,B01,083748,Rideout; David Porter,5,0,37,32
1657479456797,MATH 18,B02,083749,Rideout; David Porter,5,0,36,31
1657479456797,MATH 18,B03,083750,Rideout; David Porter,3,0,37,34
1657479456797,MATH 18,B04,083751,Rideout; David Porter,6,0,36,30
1657479456797,MATH 18,B05,093473,Rideout; David Porter,6,0,36,30
1657479456797,MATH 18,B06,093474,Rideout; David Porter,6,0,36,30
1657479462823,MATH 20A,A01,083754,Zheng; Zequn,14,0,40,26
1657479468851,MATH 20B,A01,083756,Briones; Jor-el Thomas Caparas,4,0,36,32
1657479468851,MATH 20B,A02,083757,Briones; Jor-el Thomas Caparas,1,0,36,35
1657479468851,MATH 20B,A03,093475,Briones; Jor-el Thomas Caparas,2,0,36,34
1657479474876,MATH 20C,A01,083760,Briones; Jor-el Thomas Caparas,1,0,35,34
1657479474876,MATH 20C,A02,083761,Briones; Jor-el Thomas Caparas,8,0,35,27
1657479474876,MATH 20C,A03,093476,Briones; Jor-el Thomas Caparas,0,1,36,36
1657479474876,MATH 20C,B01,083762,Bach; Quang Tran,1,0,30,29
1657479480898,MATH 20D,A01,083765,Tran; Brian Kha,5,0,30,25
1657479480898,MATH 20D,A02,083766,Tran; Brian Kha,5,0,30,25
1657479480898,MATH 20D,A03,083767,Tran; Brian Kha,5,0,30,25
1657479486921,MATH 20E,A01,083771,Ganguly; Soumya,9,0,32,23
1657479486921,MATH 20E,A02,083772,Ganguly; Soumya,6,0,32,26
1657479486921,MATH 20E,B01,083773,Ciotti; Benjamin,20,0,35,15
1657479486921,MATH 20E,B02,083774,Ciotti; Benjamin,17,0,35,18
1657479492949,MATH 103A,A01,083777,Greenfeld; Be'Eri,3,0,36,33
1657479492949,MATH 103A,A02,083778,Greenfeld; Be'Eri,5,0,36,31
1657479492949,MATH 103A,A03,093561,Greenfeld; Be'Eri,5,0,36,31
1657479492949,MATH 103A,B01,083779,Greenfeld; Be'Eri,7,0,36,29
1657479492949,MATH 103A,B02,083780,Greenfeld; Be'Eri,4,0,36,32
1657479492949,MATH 103A,B03,093562,Greenfeld; Be'Eri,3,0,36,33
1657479498971,MATH 105,A01,085443,Carter; Anne Toulson,15,0,35,20
1657479498971,MATH 105,A02,093477,Carter; Anne Toulson,20,0,35,15
1657479504996,MATH 109,A01,083213,Ganzberger; Geoffrey Michael,2,0,34,32
1657479504996,MATH 109,A02,083214,Ganzberger; Geoffrey Michael,4,0,34,30
1657479504996,MATH 109,A03,093478,Ganzberger; Geoffrey Michael,2,0,34,32
1657479504996,MATH 109,B01,083215,Ganzberger; Geoffrey Michael,1,0,32,31
1657479504996,MATH 109,B02,083216,Ganzberger; Geoffrey Michael,2,0,32,30
1657479504996,MATH 109,B03,093479,Ganzberger; Geoffrey Michael,8,0,32,24
1657479511026,MATH 142A,A01,083219,Chow; Bennett,7,0,32,25
1657479511026,MATH 142A,A02,083220,Chow; Bennett,10,0,32,22
1657479511026,MATH 142A,A03,093480,Chow; Bennett,8,0,32,24
1657479511026,MATH 142A,B03,093481,Chow; Bennett,8,0,32,24
1657479511026,MATH 142A,B04,093558,Chow; Bennett,13,0,32,19
1657479511026,MATH 142A,B05,093559,Chow; Bennett,6,0,32,26
1657479517050,MATH 193A,A01,083224,Rotar; Vladimir,8,0,34,26
1657479517050,MATH 193A,A02,083225,Rotar; Vladimir,9,0,34,25
1657479517050,MATH 193A,A03,083781,Rotar; Vladimir,5,0,34,29
1657479517050,MATH 193A,A04,083782,Rotar; Vladimir,10,0,34,24
1657479517050,MATH 193A,A05,093482,Rotar; Vladimir,10,0,34,24
1657479523073,MATH 197,001,091859,McAuley; Julian John,9999,0,9999,0
1657479523073,MATH 197,002,095566,Kedlaya; Kiran S.,9997,0,9999,2
1657479523073,MATH 197,003,095567,Xiao; Ming,9999,0,9999,0
1657479523073,MATH 197,004,095571,Perols; Johan Lars,9998,0,9999,1
1657479530137,COGS 9,A01,083615,Shannon; Kyle Michael,9,0,75,66
1657479536164,COGS 11,A01,083617,Boyle; Mary E. T.,22,0,48,26
1657479542193,COGS 13,A01,083071,Bastos; Amalia Pinkusfeld,11,0,71,60
1657479548219,COGS 14A,A01,092681,Semenuks; Arturs,5,1,100,95
1657479554244,COGS 14B,A01,083073,Cheng; Tzu-Han,6,0,63,57
1657479560268,COGS 17,A01,092677,Semenuks; Arturs,6,0,81,75
1657479566291,COGS 100,A01,083619,Allen; Michael Gordon,17,0,70,53
1657479572318,COGS 101A,A01,083621,Davis; Joshua Daniel,9,0,68,59
1657479578346,COGS 101B,A01,091572,Allen; Michael Gordon,12,0,65,53
1657479584374,COGS 101C,A01,083625,Delgado; Tania,17,0,35,18
1657479590401,COGS 107A,A01,083627,Boyle; Mary E. T.,13,0,60,47
1657479596425,COGS 118A,A01,083075,Gupta; Anjum,21,0,76,55
1657479602447,CSE 3,A50,083646,Miranda; Gregory Joseph,24,0,50,26
1657479608474,CSE 8A,A50,083650,Miranda; Gregory Joseph,17,1,56,39
1657479614500,CSE 11,A01,083080,Cao; Yingjun,6,15,40,34
1657479620523,CSE 12,A01,083652,Krause-Levy; Sophia Louisa,28,1,120,92
1657479626546,CSE 15L,A01,083654,Morris; Justin Loren,9,0,50,41
1657479626546,CSE 15L,A02,083655,Morris; Justin Loren,9,0,50,41
1657479632569,CSE 20,A01,083657,Tran; Khoa Dang,39,0,80,41
1657479638597,CSE 21,A01,095574,Bach; Quang Tran,22,0,48,26
1657479644625,CSE 30,A01,083084,Eldon; John,5,0,80,75
1657479644625,CSE 30,B01,095061,Bhaskar; Nishant,9,0,50,41
1657479650649,CSE 100,A01,083659,Cao; Yingjun,5,4,70,65
1657479656672,CSE 134B,A01,083661,Powell; Thomas Allan,22,0,100,78
1657479662698,CSE 140,A01,083663,Gungor; Onat,15,0,85,70
1657479668725,CSE 140L,A01,083088,Eldon; John,21,0,100,79
1657479674750,CSE 175,A01,083665,Kumar; Rakesh,3,0,25,22
1657479680777,CSE 190,A00,092507,Dubnov; Shlomo,8,0,20,12
1657479686803,ECE 45,A01,083139,Congero; Spencer William,6,0,75,69
1657479692827,ECE 65,A50,083695,Saad; Andrew S,12,0,30,18
1657479692827,ECE 65,A51,095125,Saad; Andrew S,24,0,26,2
1657479698866,ECE 109,A01,091882,Touri; Behrouz,19,0,70,51
1657479704890,ECE 180,A00,083140,Abi Samra; Nicholas Camill,1,0,30,29
1657479704890,ECE 180,B00,083141,Abi Samra; Nicholas Camill,0,0,30,30
1657479710919,MATH 10A,A01,083735,Patchell; Gregory David,2,0,30,28
1657479710919,MATH 10A,A02,083736,Patchell; Gregory David,20,0,30,10
1657479710919,MATH 10A,A03,083737,Patchell; Gregory David,16,0,30,14
1657479716947,MATH 10B,A01,083207,Lim; Seonhee,8,0,34,26
1657479716947,MATH 10B,A02,083208,Lim; Seonhee,9,0,35,26
1657479716947,MATH 10B,A03,093472,Lim; Seonhee,7,0,34,27
1657479716947,MATH 10B,B01,083739,Sinha; Shubham,12,0,30,18
1657479722988,MATH 18,A01,083743,Cinel; Cameron Alexander,7,0,30,23
1657479722988,MATH 18,A02,083744,Cinel; Cameron Alexander,17,0,30,13
1657479722988,MATH 18,A03,083745,Cinel; Cameron Alexander,9,0,30,21
1657479722988,MATH 18,B01,083748,Rideout; David Porter,5,0,37,32
1657479722988,MATH 18,B02,083749,Rideout; David Porter,5,0,36,31
1657479722988,MATH 18,B03,083750,Rideout; David Porter,3,0,37,34
1657479722988,MATH 18,B04,083751,Rideout; David Porter,6,0,36,30
1657479722988,MATH 18,B05,093473,Rideout; David Porter,6,0,36,30
1657479722988,MATH 18,B06,093474,Rideout; David Porter,6,0,36,30
1657479729013,MATH 20A,A01,083754,Zheng; Zequn,14,0,40,26
1657479735037,MATH 20B,A01,083756,Briones; Jor-el Thomas Caparas,4,0,36,32
1657479735037,MATH 20B,A02,083757,Briones; Jor-el Thomas Caparas,1,0,36,35
1657479735037,MATH 20B,A03,093475,Briones; Jor-el Thomas Caparas,2,0,36,34
1657479741075,MATH 20C,A01,083760,Briones; Jor-el Thomas Caparas,1,0,35,34
1657479741075,MATH 20C,A02,083761,Briones; Jor-el Thomas Caparas,8,0,35,27
1657479741075,MATH 20C,A03,093476,Briones; Jor-el Thomas Caparas,0,1,36,36
1657479741075,MATH 20C,B01,083762,Bach; Quang Tran,1,0,30,29
1657479747104,MATH 20D,A01,083765,Tran; Brian Kha,5,0,30,25
1657479747104,MATH 20D,A02,083766,Tran; Brian Kha,5,0,30,25
1657479747104,MATH 20D,A03,083767,Tran; Brian Kha,5,0,30,25
1657479753128,MATH 20E,A01,083771,Ganguly; Soumya,9,0,32,23
1657479753128,MATH 20E,A02,083772,Ganguly; Soumya,6,0,32,26
1657479753128,MATH 20E,B01,083773,Ciotti; Benjamin,20,0,35,15
1657479753128,MATH 20E,B02,083774,Ciotti; Benjamin,17,0,35,18
1657479759153,MATH 103A,A01,083777,Greenfeld; Be'Eri,3,0,36,33
1657479759153,MATH 103A,A02,083778,Greenfeld; Be'Eri,5,0,36,31
1657479759153,MATH 103A,A03,093561,Greenfeld; Be'Eri,5,0,36,31
1657479759153,MATH 103A,B01,083779,Greenfeld; Be'Eri,7,0,36,29
1657479759153,MATH 103A,B02,083780,Greenfeld; Be'Eri,4,0,36,32
1657479759153,MATH 103A,B03,093562,Greenfeld; Be'Eri,3,0,36,33
1657479765179,MATH 105,A01,085443,Carter; Anne Toulson,15,0,35,20
1657479765179,MATH 105,A02,093477,Carter; Anne Toulson,20,0,35,15
1657479771208,MATH 109,A01,083213,Ganzberger; Geoffrey Michael,2,0,34,32
1657479771208,MATH 109,A02,083214,Ganzberger; Geoffrey Michael,4,0,34,30
1657479771208,MATH 109,A03,093478,Ganzberger; Geoffrey Michael,2,0,34,32
1657479771208,MATH 109,B01,083215,Ganzberger; Geoffrey Michael,1,0,32,31
1657479771208,MATH 109,B02,083216,Ganzberger; Geoffrey Michael,2,0,32,30
1657479771208,MATH 109,B03,093479,Ganzberger; Geoffrey Michael,8,0,32,24
1657479777238,MATH 142A,A01,083219,Chow; Bennett,7,0,32,25
1657479777238,MATH 142A,A02,083220,Chow; Bennett,10,0,32,22
1657479777238,MATH 142A,A03,093480,Chow; Bennett,8,0,32,24
1657479777238,MATH 142A,B03,093481,Chow; Bennett,8,0,32,24
1657479777238,MATH 142A,B04,093558,Chow; Bennett,13,0,32,19
1657479777238,MATH 142A,B05,093559,Chow; Bennett,6,0,32,26
1657479783266,MATH 193A,A01,083224,Rotar; Vladimir,8,0,34,26
1657479783266,MATH 193A,A02,083225,Rotar; Vladimir,9,0,34,25
1657479783266,MATH 193A,A03,083781,Rotar; Vladimir,5,0,34,29
1657479783266,MATH 193A,A04,083782,Rotar; Vladimir,10,0,34,24
1657479783266,MATH 193A,A05,093482,Rotar; Vladimir,10,0,34,24
1657479789289,MATH 197,001,091859,McAuley; Julian John,9999,0,9999,0
1657479789289,MATH 197,002,095566,Kedlaya; Kiran S.,9997,0,9999,2
1657479789289,MATH 197,003,095567,Xiao; Ming,9999,0,9999,0
1657479789289,MATH 197,004,095571,Perols; Johan Lars,9998,0,9999,1
1657479796343,COGS 9,A01,083615,Shannon; Kyle Michael,9,0,75,66
1657479802370,COGS 11,A01,083617,Boyle; Mary E. T.,22,0,48,26
1657479808395,COGS 13,A01,083071,Bastos; Amalia Pinkusfeld,11,0,71,60
1657479814419,COGS 14A,A01,092681,Semenuks; Arturs,5,1,100,95
1657479820443,COGS 14B,A01,083073,Cheng; Tzu-Han,6,0,63,57
1657479826466,COGS 17,A01,092677,Semenuks; Arturs,6,0,81,75
1657479832489,COGS 100,A01,083619,Allen; Michael Gordon,17,0,70,53
1657479838585,COGS 101A,A01,083621,Davis; Joshua Daniel,9,0,68,59
1657479844608,COGS 101B,A01,091572,Allen; Michael Gordon,12,0,65,53
1657479850630,COGS 101C,A01,083625,Delgado; Tania,17,0,35,18
1657479856660,COGS 107A,A01,083627,Boyle; Mary E. T.,13,0,60,47
1657479862682,COGS 118A,A01,083075,Gupta; Anjum,21,0,76,55
1657479868705,CSE 3,A50,083646,Miranda; Gregory Joseph,24,0,50,26
1657479874727,CSE 8A,A50,083650,Miranda; Gregory Joseph,17,1,56,39
1657479880752,CSE 11,A01,083080,Cao; Yingjun,6,15,40,34
1657479886779,CSE 12,A01,083652,Krause-Levy; Sophia Louisa,28,1,120,92
1657479892803,CSE 15L,A01,083654,Morris; Justin Loren,9,0,50,41
1657479892803,CSE 15L,A02,083655,Morris; Justin Loren,9,0,50,41
1657479898827,CSE 20,A01,083657,Tran; Khoa Dang,39,0,80,41
1657479904854,CSE 21,A01,095574,Bach; Quang Tran,22,0,48,26
1657479910877,CSE 30,A01,083084,Eldon; John,5,0,80,75
1657479910877,CSE 30,B01,095061,Bhaskar; Nishant,9,0,50,41
1657479916899,CSE 100,A01,083659,Cao; Yingjun,5,4,70,65
1657479922925,CSE 134B,A01,083661,Powell; Thomas Allan,22,0,100,78
1657479928953,CSE 140,A01,083663,Gungor; Onat,15,0,85,70
1657479934974,CSE 140L,A01,083088,Eldon; John,21,0,100,79
1657479940999,CSE 175,A01,083665,Kumar; Rakesh,3,0,25,22
1657479947024,CSE 190,A00,092507,Dubnov; Shlomo,8,0,20,12
1657479953050,ECE 45,A01,083139,Congero; Spencer William,6,0,75,69
1657479959073,ECE 65,A50,083695,Saad; Andrew S,12,0,30,18
1657479959073,ECE 65,A51,095125,Saad; Andrew S,24,0,26,2
1657479965108,ECE 109,A01,091882,Touri; Behrouz,19,0,70,51
1657479971133,ECE 180,A00,083140,Abi Samra; Nicholas Camill,1,0,30,29
1657479971133,ECE 180,B00,083141,Abi Samra; Nicholas Camill,0,0,30,30
1657479977155,MATH 10A,A01,083735,Patchell; Gregory David,2,0,30,28
1657479977155,MATH 10A,A02,083736,Patchell; Gregory David,20,0,30,10
1657479977155,MATH 10A,A03,083737,Patchell; Gregory David,16,0,30,14
1657479983178,MATH 10B,A01,083207,Lim; Seonhee,8,0,34,26
1657479983178,MATH 10B,A02,083208,Lim; Seonhee,9,0,35,26
1657479983178,MATH 10B,A03,093472,Lim; Seonhee,7,0,34,27
1657479983178,MATH 10B,B01,083739,Sinha; Shubham,12,0,30,18
1657479989209,MATH 18,A01,083743,Cinel; Cameron Alexander,7,0,30,23
1657479989209,MATH 18,A02,083744,Cinel; Cameron Alexander,17,0,30,13
1657479989209,MATH 18,A03,083745,Cinel; Cameron Alexander,9,0,30,21
1657479989209,MATH 18,B01,083748,Rideout; David Porter,5,0,37,32
1657479989209,MATH 18,B02,083749,Rideout; David Porter,5,0,36,31
1657479989209,MATH 18,B03,083750,Rideout; David Porter,3,0,37,34
1657479989209,MATH 18,B04,083751,Rideout; David Porter,6,0,36,30
1657479989209,MATH 18,B05,093473,Rideout; David Porter,6,0,36,30
1657479989209,MATH 18,B06,093474,Rideout; David Porter,6,0,36,30
1657479995235,MATH 20A,A01,083754,Zheng; Zequn,14,0,40,26
1657480001258,MATH 20B,A01,083756,Briones; Jor-el Thomas Caparas,4,0,36,32
1657480001258,MATH 20B,A02,083757,Briones; Jor-el Thomas Caparas,1,0,36,35
1657480001258,MATH 20B,A03,093475,Briones; Jor-el Thomas Caparas,2,0,36,34
1657480007279,MATH 20C,A01,083760,Briones; Jor-el Thomas Caparas,1,0,35,34
1657480007279,MATH 20C,A02,083761,Briones; Jor-el Thomas Caparas,8,0,35,27
1657480007279,MATH 20C,A03,093476,Briones; Jor-el Thomas Caparas,0,1,36,36
1657480007279,MATH 20C,B01,083762,Bach; Quang Tran,1,0,30,29
1657480013304,MATH 20D,A01,083765,Tran; Brian Kha,5,0,30,25
1657480013304,MATH 20D,A02,083766,Tran; Brian Kha,5,0,30,25
1657480013304,MATH 20D,A03,083767,Tran; Brian Kha,5,0,30,25
1657480019329,MATH 20E,A01,083771,Ganguly; Soumya,9,0,32,23
1657480019329,MATH 20E,A02,083772,Ganguly; Soumya,6,0,32,26
1657480019329,MATH 20E,B01,083773,Ciotti; Benjamin,20,0,35,15
1657480019329,MATH 20E,B02,083774,Ciotti; Benjamin,17,0,35,18
1657480025360,MATH 103A,A01,083777,Greenfeld; Be'Eri,3,0,36,33
1657480025360,MATH 103A,A02,083778,Greenfeld; Be'Eri,5,0,36,31
1657480025360,MATH 103A,A03,093561,Greenfeld; Be'Eri,5,0,36,31
1657480025360,MATH 103A,B01,083779,Greenfeld; Be'Eri,7,0,36,29
1657480025360,MATH 103A,B02,083780,Greenfeld; Be'Eri,4,0,36,32
1657480025360,MATH 103A,B03,093562,Greenfeld; Be'Eri,3,0,36,33
1657480031404,MATH 105,A01,085443,Carter; Anne Toulson,15,0,35,20
1657480031404,MATH 105,A02,093477,Carter; Anne Toulson,20,0,35,15
1657480037432,MATH 109,A01,083213,Ganzberger; Geoffrey Michael,2,0,34,32
1657480037432,MATH 109,A02,083214,Ganzberger; Geoffrey Michael,4,0,34,30
1657480037432,MATH 109,A03,093478,Ganzberger; Geoffrey Michael,2,0,34,32
1657480037432,MATH 109,B01,083215,Ganzberger; Geoffrey Michael,1,0,32,31
1657480037432,MATH 109,B02,083216,Ganzberger; Geoffrey Michael,2,0,32,30
1657480037432,MATH 109,B03,093479,Ganzberger; Geoffrey Michael,8,0,32,24
1657480043464,MATH 142A,A01,083219,Chow; Bennett,7,0,32,25
1657480043464,MATH 142A,A02,083220,Chow; Bennett,10,0,32,22
1657480043464,MATH 142A,A03,093480,Chow; Bennett,8,0,32,24
1657480043464,MATH 142A,B03,093481,Chow; Bennett,8,0,32,24
1657480043464,MATH 142A,B04,093558,Chow; Bennett,13,0,32,19
1657480043464,MATH 142A,B05,093559,Chow; Bennett,6,0,32,26
1657480049497,MATH 193A,A01,083224,Rotar; Vladimir,8,0,34,26
1657480049497,MATH 193A,A02,083225,Rotar; Vladimir,9,0,34,25
1657480049497,MATH 193A,A03,083781,Rotar; Vladimir,5,0,34,29
1657480049497,MATH 193A,A04,083782,Rotar; Vladimir,10,0,34,24
1657480049497,MATH 193A,A05,093482,Rotar; Vladimir,10,0,34,24
1657480055521,MATH 197,001,091859,McAuley; Julian John,9999,0,9999,0
1657480055521,MATH 197,002,095566,Kedlaya; Kiran S.,9997,0,9999,2
1657480055521,MATH 197,003,095567,Xiao; Ming,9999,0,9999,0
1657480055521,MATH 197,004,095571,Perols; Johan Lars,9998,0,9999,1
1657480062574,COGS 9,A01,083615,Shannon; Kyle Michael,9,0,75,66
1657480068602,COGS 11,A01,083617,Boyle; Mary E. T.,22,0,48,26
1657480074628,COGS 13,A01,083071,Bastos; Amalia Pinkusfeld,11,0,71,60
1657480080654,COGS 14A,A01,092681,Semenuks; Arturs,5,1,100,95
1657480086681,COGS 14B,A01,083073,Cheng; Tzu-Han,6,0,63,57
1657480092708,COGS 17,A01,092677,Semenuks; Arturs,6,0,81,75
1657480098732,COGS 100,A01,083619,Allen; Michael Gordon,17,0,70,53
1657480104758,COGS 101A,A01,083621,Davis; Joshua Daniel,9,0,68,59
1657480110790,COGS 101B,A01,091572,Allen; Michael Gordon,12,0,65,53
1657480116817,COGS 101C,A01,083625,Delgado; Tania,17,0,35,18
1657480122841,COGS 107A,A01,083627,Boyle; Mary E. T.,13,0,60,47
1657480128868,COGS 118A,A01,083075,Gupta; Anjum,21,0,76,55
1657480134891,CSE 3,A50,083646,Miranda; Gregory Joseph,24,0,50,26
1657480140918,CSE 8A,A50,083650,Miranda; Gregory Joseph,17,1,56,39
1657480146945,CSE 11,A01,083080,Cao; Yingjun,6,15,40,34
1657480152970,CSE 12,A01,083652,Krause-Levy; Sophia Louisa,28,1,120,92
1657480158993,CSE 15L,A01,083654,Morris; Justin Loren,9,0,50,41
1657480158993,CSE 15L,A02,083655,Morris; Justin Loren,9,0,50,41
1657480165016,CSE 20,A01,083657,Tran; Khoa Dang,39,0,80,41
1657480171039,CSE 21,A01,095574,Bach; Quang Tran,22,0,48,26
1657480177066,CSE 30,A01,083084,Eldon; John,5,0,80,75
1657480177066,CSE 30,B01,095061,Bhaskar; Nishant,9,0,50,41
1657480183087,CSE 100,A01,083659,Cao; Yingjun,5,4,70,65
1657480189115,CSE 134B,A01,083661,Powell; Thomas Allan,22,0,100,78
1657480195151,CSE 140,A01,083663,Gungor; Onat,15,0,85,70
1657480201177,CSE 140L,A01,083088,Eldon; John,21,0,100,79
1657480207208,CSE 175,A01,083665,Kumar; Rakesh,3,0,25,22
1657480213229,CSE 190,A00,092507,Dubnov; Shlomo,8,0,20,12
1657480219257,ECE 45,A01,083139,Congero; Spencer William,6,0,75,69
1657480225283,ECE 65,A50,083695,Saad; Andrew S,12,0,30,18
1657480225283,ECE 65,A51,095125,Saad; Andrew S,24,0,26,2
1657480231306,ECE 109,A01,091882,Touri; Behrouz,19,0,70,51
1657480237330,ECE 180,A00,083140,Abi Samra; Nicholas Camill,1,0,30,29
1657480237330,ECE 180,B00,083141,Abi Samra; Nicholas Camill,0,0,30,30
1657480243352,MATH 10A,A01,083735,Patchell; Gregory David,2,0,30,28
1657480243352,MATH 10A,A02,083736,Patchell; Gregory David,20,0,30,10
1657480243352,MATH 10A,A03,083737,Patchell; Gregory David,16,0,30,14
1657480249376,MATH 10B,A01,083207,Lim; Seonhee,8,0,34,26
1657480249376,MATH 10B,A02,083208,Lim; Seonhee,9,0,35,26
1657480249376,MATH 10B,A03,093472,Lim; Seonhee,7,0,34,27
1657480249376,MATH 10B,B01,083739,Sinha; Shubham,12,0,30,18
1657480255402,MATH 18,A01,083743,Cinel; Cameron Alexander,7,0,30,23
1657480255402,MATH 18,A02,083744,Cinel; Cameron Alexander,17,0,30,13
1657480255402,MATH 18,A03,083745,Cinel; Cameron Alexander,9,0,30,21
1657480255402,MATH 18,B01,083748,Rideout; David Porter,5,0,37,32
1657480255402,MATH 18,B02,083749,Rideout; David Porter,5,0,36,31
1657480255402,MATH 18,B03,083750,Rideout; David Porter,3,0,37,34
1657480255402,MATH 18,B04,083751,Rideout; David Porter,6,0,36,30
1657480255402,MATH 18,B05,093473,Rideout; David Porter,6,0,36,30
1657480255402,MATH 18,B06,093474,Rideout; David Porter,6,0,36,30
1657480261425,MATH 20A,A01,083754,Zheng; Zequn,14,0,40,26
1657480267452,MATH 20B,A01,083756,Briones; Jor-el Thomas Caparas,4,0,36,32
1657480267452,MATH 20B,A02,083757,Briones; Jor-el Thomas Caparas,1,0,36,35
1657480267452,MATH 20B,A03,093475,Briones; Jor-el Thomas Caparas,2,0,36,34
1657480273481,MATH 20C,A01,083760,Briones; Jor-el Thomas Caparas,1,0,35,34
1657480273481,MATH 20C,A02,083761,Briones; Jor-el Thomas Caparas,8,0,35,27
1657480273481,MATH 20C,A03,093476,Briones; Jor-el Thomas Caparas,0,1,36,36
1657480273481,MATH 20C,B01,083762,Bach; Quang Tran,1,0,30,29
1657480279509,MATH 20D,A01,083765,Tran; Brian Kha,5,0,30,25
1657480279509,MATH 20D,A02,083766,Tran; Brian Kha,5,0,30,25
1657480279509,MATH 20D,A03,083767,Tran; Brian Kha,5,0,30,25
1657480285541,MATH 20E,A01,083771,Ganguly; Soumya,9,0,32,23
1657480285541,MATH 20E,A02,083772,Ganguly; Soumya,6,0,32,26
1657480285541,MATH 20E,B01,083773,Ciotti; Benjamin,20,0,35,15
1657480285541,MATH 20E,B02,083774,Ciotti; Benjamin,17,0,35,18
1657480291566,MATH 103A,A01,083777,Greenfeld; Be'Eri,3,0,36,33
1657480291566,MATH 103A,A02,083778,Greenfeld; Be'Eri,5,0,36,31
1657480291566,MATH 103A,A03,093561,Greenfeld; Be'Eri,5,0,36,31
1657480291566,MATH 103A,B01,083779,Greenfeld; Be'Eri,7,0,36,29
1657480291566,MATH 103A,B02,083780,Greenfeld; Be'Eri,4,0,36,32
1657480291566,MATH 103A,B03,093562,Greenfeld; Be'Eri,3,0,36,33
1657480297593,MATH 105,A01,085443,Carter; Anne Toulson,15,0,35,20
1657480297593,MATH 105,A02,093477,Carter; Anne Toulson,20,0,35,15
1657480303615,MATH 109,A01,083213,Ganzberger; Geoffrey Michael,2,0,34,32
1657480303615,MATH 109,A02,083214,Ganzberger; Geoffrey Michael,4,0,34,30
1657480303615,MATH 109,A03,093478,Ganzberger; Geoffrey Michael,2,0,34,32
1657480303615,MATH 109,B01,083215,Ganzberger; Geoffrey Michael,1,0,32,31
1657480303615,MATH 109,B02,083216,Ganzberger; Geoffrey Michael,2,0,32,30
1657480303615,MATH 109,B03,093479,Ganzberger; Geoffrey Michael,8,0,32,24
1657480309640,MATH 142A,A01,083219,Chow; Bennett,7,0,32,25
1657480309640,MATH 142A,A02,083220,Chow; Bennett,10,0,32,22
1657480309640,MATH 142A,A03,093480,Chow; Bennett,8,0,32,24
1657480309640,MATH 142A,B03,093481,Chow; Bennett,8,0,32,24
1657480309640,MATH 142A,B04,093558,Chow; Bennett,13,0,32,19
1657480309640,MATH 142A,B05,093559,Chow; Bennett,6,0,32,26
1657480315662,MATH 193A,A01,083224,Rotar; Vladimir,8,0,34,26
1657480315662,MATH 193A,A02,083225,Rotar; Vladimir,9,0,34,25
1657480315662,MATH 193A,A03,083781,Rotar; Vladimir,5,0,34,29
1657480315662,MATH 193A,A04,083782,Rotar; Vladimir,10,0,34,24
1657480315662,MATH 193A,A05,093482,Rotar; Vladimir,10,0,34,24
1657480321688,MATH 197,001,091859,McAuley; Julian John,9999,0,9999,0
1657480321688,MATH 197,002,095566,Kedlaya; Kiran S.,9997,0,9999,2
1657480321688,MATH 197,003,095567,Xiao; Ming,9999,0,9999,0
1657480321688,MATH 197,004,095571,Perols; Johan Lars,9998,0,9999,1
1657480328745,COGS 9,A01,083615,Shannon; Kyle Michael,9,0,75,66
1657480334769,COGS 11,A01,083617,Boyle; Mary E. T.,22,0,48,26
1657480340793,COGS 13,A01,083071,Bastos; Amalia Pinkusfeld,11,0,71,60
1657480346818,COGS 14A,A01,092681,Semenuks; Arturs,5,1,100,95
1657480352841,COGS 14B,A01,083073,Cheng; Tzu-Han,6,0,63,57
1657480358868,COGS 17,A01,092677,Semenuks; Arturs,6,0,81,75
1657480364895,COGS 100,A01,083619,Allen; Michael Gordon,17,0,70,53
1657480370924,COGS 101A,A01,083621,Davis; Joshua Daniel,9,0,68,59
1657480376949,COGS 101B,A01,091572,Allen; Michael Gordon,12,0,65,53
1657480382977,COGS 101C,A01,083625,Delgado; Tania,17,0,35,18
1657480389005,COGS 107A,A01,083627,Boyle; Mary E. T.,13,0,60,47
1657480395029,COGS 118A,A01,083075,Gupta; Anjum,21,0,76,55
1657480401059,CSE 3,A50,083646,Miranda; Gregory Joseph,24,0,50,26
1657480407087,CSE 8A,A50,083650,Miranda; Gregory Joseph,17,1,56,39
1657480413114,CSE 11,A01,083080,Cao; Yingjun,6,15,40,34
1657480419137,CSE 12,A01,083652,Krause-Levy; Sophia Louisa,28,1,120,92
1657480425161,CSE 15L,A01,083654,Morris; Justin Loren,9,0,50,41
1657480425161,CSE 15L,A02,083655,Morris; Justin Loren,9,0,50,41
1657480431185,CSE 20,A01,083657,Tran; Khoa Dang,39,0,80,41
1657480437282,CSE 21,A01,095574,Bach; Quang Tran,22,0,48,26
1657480443312,CSE 30,A01,083084,Eldon; John,5,0,80,75
1657480443312,CSE 30,B01,095061,Bhaskar; Nishant,9,0,50,41
1657480449339,CSE 100,A01,083659,Cao; Yingjun,5,4,70,65
1657480455362,CSE 134B,A01,083661,Powell; Thomas Allan,22,0,100,78
1657480461389,CSE 140,A01,083663,Gungor; Onat,15,0,85,70
1657480467418,CSE 140L,A01,083088,Eldon; John,21,0,100,79
1657480473444,CSE 175,A01,083665,Kumar; Rakesh,3,0,25,22
1657480479465,CSE 190,A00,092507,Dubnov; Shlomo,8,0,20,12
1657480485493,ECE 45,A01,083139,Congero; Spencer William,6,0,75,69
1657480491518,ECE 65,A50,083695,Saad; Andrew S,12,0,30,18
1657480491518,ECE 65,A51,095125,Saad; Andrew S,24,0,26,2
1657480497542,ECE 109,A01,091882,Touri; Behrouz,19,0,70,51
1657480503570,ECE 180,A00,083140,Abi Samra; Nicholas Camill,1,0,30,29
1657480503570,ECE 180,B00,083141,Abi Samra; Nicholas Camill,0,0,30,30
1657480509592,MATH 10A,A01,083735,Patchell; Gregory David,2,0,30,28
1657480509592,MATH 10A,A02,083736,Patchell; Gregory David,20,0,30,10
1657480509592,MATH 10A,A03,083737,Patchell; Gregory David,16,0,30,14
1657480515620,MATH 10B,A01,083207,Lim; Seonhee,8,0,34,26
1657480515620,MATH 10B,A02,083208,Lim; Seonhee,9,0,35,26
1657480515620,MATH 10B,A03,093472,Lim; Seonhee,7,0,34,27
1657480515620,MATH 10B,B01,083739,Sinha; Shubham,12,0,30,18
1657480521645,MATH 18,A01,083743,Cinel; Cameron Alexander,7,0,30,23
1657480521645,MATH 18,A02,083744,Cinel; Cameron Alexander,17,0,30,13
1657480521645,MATH 18,A03,083745,Cinel; Cameron Alexander,9,0,30,21
1657480521645,MATH 18,B01,083748,Rideout; David Porter,5,0,37,32
1657480521645,MATH 18,B02,083749,Rideout; David Porter,5,0,36,31
1657480521645,MATH 18,B03,083750,Rideout; David Porter,3,0,37,34
1657480521645,MATH 18,B04,083751,Rideout; David Porter,6,0,36,30
1657480521645,MATH 18,B05,093473,Rideout; David Porter,6,0,36,30
1657480521645,MATH 18,B06,093474,Rideout; David Porter,6,0,36,30
1657480527669,MATH 20A,A01,083754,Zheng; Zequn,14,0,40,26
1657480533698,MATH 20B,A01,083756,Briones; Jor-el Thomas Caparas,4,0,36,32
1657480533698,MATH 20B,A02,083757,Briones; Jor-el Thomas Caparas,1,0,36,35
1657480533698,MATH 20B,A03,093475,Briones; Jor-el Thomas Caparas,2,0,36,34
1657480539726,MATH 20C,A01,083760,Briones; Jor-el Thomas Caparas,1,0,35,34
1657480539726,MATH 20C,A02,083761,Briones; Jor-el Thomas Caparas,8,0,35,27
1657480539726,MATH 20C,A03,093476,Briones; Jor-el Thomas Caparas,0,1,36,36
1657480539726,MATH 20C,B01,083762,Bach; Quang Tran,1,0,30,29
1657480545749,MATH 20D,A01,083765,Tran; Brian Kha,5,0,30,25
1657480545749,MATH 20D,A02,083766,Tran; Brian Kha,5,0,30,25
1657480545749,MATH 20D,A03,083767,Tran; Brian Kha,5,0,30,25
1657480551777,MATH 20E,A01,083771,Ganguly; Soumya,9,0,32,23
1657480551777,MATH 20E,A02,083772,Ganguly; Soumya,6,0,32,26
1657480551777,MATH 20E,B01,083773,Ciotti; Benjamin,20,0,35,15
1657480551777,MATH 20E,B02,083774,Ciotti; Benjamin,17,0,35,18
1657480557802,MATH 103A,A01,083777,Greenfeld; Be'Eri,3,0,36,33
1657480557802,MATH 103A,A02,083778,Greenfeld; Be'Eri,5,0,36,31
1657480557802,MATH 103A,A03,093561,Greenfeld; Be'Eri,5,0,36,31
1657480557802,MATH 103A,B01,083779,Greenfeld; Be'Eri,7,0,36,29
1657480557802,MATH 103A,B02,083780,Greenfeld; Be'Eri,4,0,36,32
1657480557802,MATH 103A,B03,093562,Greenfeld; Be'Eri,3,0,36,33
1657480563830,MATH 105,A01,085443,Carter; Anne Toulson,15,0,35,20
1657480563830,MATH 105,A02,093477,Carter; Anne Toulson,20,0,35,15
1657480569854,MATH 109,A01,083213,Ganzberger; Geoffrey Michael,2,0,34,32
1657480569854,MATH 109,A02,083214,Ganzberger; Geoffrey Michael,4,0,34,30
1657480569854,MATH 109,A03,093478,Ganzberger; Geoffrey Michael,2,0,34,32
1657480569854,MATH 109,B01,083215,Ganzberger; Geoffrey Michael,1,0,32,31
1657480569854,MATH 109,B02,083216,Ganzberger; Geoffrey Michael,2,0,32,30
1657480569854,MATH 109,B03,093479,Ganzberger; Geoffrey Michael,8,0,32,24
1657480575877,MATH 142A,A01,083219,Chow; Bennett,7,0,32,25
1657480575877,MATH 142A,A02,083220,Chow; Bennett,10,0,32,22
1657480575877,MATH 142A,A03,093480,Chow; Bennett,8,0,32,24
1657480575877,MATH 142A,B03,093481,Chow; Bennett,8,0,32,24
1657480575877,MATH 142A,B04,093558,Chow; Bennett,13,0,32,19
1657480575877,MATH 142A,B05,093559,Chow; Bennett,6,0,32,26
1657480581916,MATH 193A,A01,083224,Rotar; Vladimir,8,0,34,26
1657480581916,MATH 193A,A02,083225,Rotar; Vladimir,9,0,34,25
1657480581916,MATH 193A,A03,083781,Rotar; Vladimir,5,0,34,29
1657480581916,MATH 193A,A04,083782,Rotar; Vladimir,10,0,34,24
1657480581916,MATH 193A,A05,093482,Rotar; Vladimir,10,0,34,24
1657480587939,MATH 197,001,091859,McAuley; Julian John,9999,0,9999,0
1657480587939,MATH 197,002,095566,Kedlaya; Kiran S.,9997,0,9999,2
1657480587939,MATH 197,003,095567,Xiao; Ming,9999,0,9999,0
1657480587939,MATH 197,004,095571,Perols; Johan Lars,9998,0,9999,1
1657480594995,COGS 9,A01,083615,Shannon; Kyle Michael,9,0,75,66
1657480601019,COGS 11,A01,083617,Boyle; Mary E. T.,22,0,48,26
1657480607044,COGS 13,A01,083071,Bastos; Amalia Pinkusfeld,11,0,71,60
1657480613067,COGS 14A,A01,092681,Semenuks; Arturs,5,1,100,95
1657480619091,COGS 14B,A01,083073,Cheng; Tzu-Han,6,0,63,57
1657480625116,COGS 17,A01,092677,Semenuks; Arturs,6,0,81,75
1657480631139,COGS 100,A01,083619,Allen; Michael Gordon,17,0,70,53
1657480637164,COGS 101A,A01,083621,Davis; Joshua Daniel,9,0,68,59
1657480643188,COGS 101B,A01,091572,Allen; Michael Gordon,12,0,65,53
1657480649225,COGS 101C,A01,083625,Delgado; Tania,17,0,35,18
1657480655248,COGS 107A,A01,083627,Boyle; Mary E. T.,13,0,60,47
1657480661272,COGS 118A,A01,083075,Gupta; Anjum,21,0,76,55
1657480667296,CSE 3,A50,083646,Miranda; Gregory Joseph,24,0,50,26
1657480673318,CSE 8A,A50,083650,Miranda; Gregory Joseph,17,1,56,39
1657480679352,CSE 11,A01,083080,Cao; Yingjun,6,15,40,34
1657480685384,CSE 12,A01,083652,Krause-Levy; Sophia Louisa,28,1,120,92
1657480691408,CSE 15L,A01,083654,Morris; Justin Loren,9,0,50,41
1657480691408,CSE 15L,A02,083655,Morris; Justin Loren,9,0,50,41
1657480697431,CSE 20,A01,083657,Tran; Khoa Dang,39,0,80,41
1657480703454,CSE 21,A01,095574,Bach; Quang Tran,22,0,48,26
1657480709477,CSE 30,A01,083084,Eldon; John,5,0,80,75
1657480709477,CSE 30,B01,095061,Bhaskar; Nishant,9,0,50,41
1657480715500,CSE 100,A01,083659,Cao; Yingjun,5,4,70,65
1657480721527,CSE 134B,A01,083661,Powell; Thomas Allan,22,0,100,78
1657480727553,CSE 140,A01,083663,Gungor; Onat,15,0,85,70
1657480733579,CSE 140L,A01,083088,Eldon; John,21,0,100,79
1657480739602,CSE 175,A01,083665,Kumar; Rakesh,3,0,25,22
1657480745626,CSE 190,A00,092507,Dubnov; Shlomo,8,0,20,12
1657480751649,ECE 45,A01,083139,Congero; Spencer William,6,0,75,69
1657480757673,ECE 65,A50,083695,Saad; Andrew S,12,0,30,18
1657480757673,ECE 65,A51,095125,Saad; Andrew S,24,0,26,2
1657480763701,ECE 109,A01,091882,Touri; Behrouz,19,0,70,51
1657480769723,ECE 180,A00,083140,Abi Samra; Nicholas Camill,1,0,30,29
1657480769723,ECE 180,B00,083141,Abi Samra; Nicholas Camill,0,0,30,30
1657480775757,MATH 10A,A01,083735,Patchell; Gregory David,2,0,30,28
1657480775757,MATH 10A,A02,083736,Patchell; Gregory David,20,0,30,10
1657480775757,MATH 10A,A03,083737,Patchell; Gregory David,16,0,30,14
1657480781785,MATH 10B,A01,083207,Lim; Seonhee,8,0,34,26
1657480781785,MATH 10B,A02,083208,Lim; Seonhee,9,0,35,26
1657480781785,MATH 10B,A03,093472,Lim; Seonhee,7,0,34,27
1657480781785,MATH 10B,B01,083739,Sinha; Shubham,12,0,30,18
1657480787811,MATH 18,A01,083743,Cinel; Cameron Alexander,7,0,30,23
1657480787811,MATH 18,A02,083744,Cinel; Cameron Alexander,17,0,30,13
1657480787811,MATH 18,A03,083745,Cinel; Cameron Alexander,9,0,30,21
1657480787811,MATH 18,B01,083748,Rideout; David Porter,5,0,37,32
1657480787811,MATH 18,B02,083749,Rideout; David Porter,5,0,36,31
1657480787811,MATH 18,B03,083750,Rideout; David Porter,3,0,37,34
1657480787811,MATH 18,B04,083751,Rideout; David Porter,6,0,36,30
1657480787811,MATH 18,B05,093473,Rideout; David Porter,6,0,36,30
1657480787811,MATH 18,B06,093474,Rideout; David Porter,6,0,36,30
1657480793835,MATH 20A,A01,083754,Zheng; Zequn,14,0,40,26
1657480799858,MATH 20B,A01,083756,Briones; Jor-el Thomas Caparas,4,0,36,32
1657480799858,MATH 20B,A02,083757,Briones; Jor-el Thomas Caparas,1,0,36,35
1657480799858,MATH 20B,A03,093475,Briones; Jor-el Thomas Caparas,2,0,36,34
1657480805885,MATH 20C,A01,083760,Briones; Jor-el Thomas Caparas,1,0,35,34
1657480805885,MATH 20C,A02,083761,Briones; Jor-el Thomas Caparas,8,0,35,27
1657480805885,MATH 20C,A03,093476,Briones; Jor-el Thomas Caparas,0,1,36,36
1657480805885,MATH 20C,B01,083762,Bach; Quang Tran,1,0,30,29
1657480811911,MATH 20D,A01,083765,Tran; Brian Kha,5,0,30,25
1657480811911,MATH 20D,A02,083766,Tran; Brian Kha,5,0,30,25
1657480811911,MATH 20D,A03,083767,Tran; Brian Kha,5,0,30,25
1657480817933,MATH 20E,A01,083771,Ganguly; Soumya,9,0,32,23
1657480817933,MATH 20E,A02,083772,Ganguly; Soumya,6,0,32,26
1657480817933,MATH 20E,B01,083773,Ciotti; Benjamin,20,0,35,15
1657480817933,MATH 20E,B02,083774,Ciotti; Benjamin,17,0,35,18
1657480823956,MATH 103A,A01,083777,Greenfeld; Be'Eri,3,0,36,33
1657480823956,MATH 103A,A02,083778,Greenfeld; Be'Eri,5,0,36,31
1657480823956,MATH 103A,A03,093561,Greenfeld; Be'Eri,5,0,36,31
1657480823956,MATH 103A,B01,083779,Greenfeld; Be'Eri,7,0,36,29
1657480823956,MATH 103A,B02,083780,Greenfeld; Be'Eri,4,0,36,32
1657480823956,MATH 103A,B03,093562,Greenfeld; Be'Eri,3,0,36,33
1657480829983,MATH 105,A01,085443,Carter; Anne Toulson,15,0,35,20
1657480829983,MATH 105,A02,093477,Carter; Anne Toulson,20,0,35,15
1657480836019,MATH 109,A01,083213,Ganzberger; Geoffrey Michael,2,0,34,32
1657480836019,MATH 109,A02,083214,Ganzberger; Geoffrey Michael,4,0,34,30
1657480836019,MATH 109,A03,093478,Ganzberger; Geoffrey Michael,2,0,34,32
1657480836019,MATH 109,B01,083215,Ganzberger; Geoffrey Michael,1,0,32,31
1657480836019,MATH 109,B02,083216,Ganzberger; Geoffrey Michael,2,0,32,30
1657480836019,MATH 109,B03,093479,Ganzberger; Geoffrey Michael,8,0,32,24
1657480842045,MATH 142A,A01,083219,Chow; Bennett,7,0,32,25
1657480842045,MATH 142A,A02,083220,Chow; Bennett,10,0,32,22
1657480842045,MATH 142A,A03,093480,Chow; Bennett,8,0,32,24
1657480842045,MATH 142A,B03,093481,Chow; Bennett,8,0,32,24
1657480842045,MATH 142A,B04,093558,Chow; Bennett,13,0,32,19
1657480842045,MATH 142A,B05,093559,Chow; Bennett,6,0,32,26
1657480848069,MATH 193A,A01,083224,Rotar; Vladimir,8,0,34,26
1657480848069,MATH 193A,A02,083225,Rotar; Vladimir,9,0,34,25
1657480848069,MATH 193A,A03,083781,Rotar; Vladimir,5,0,34,29
1657480848069,MATH 193A,A04,083782,Rotar; Vladimir,10,0,34,24
1657480848069,MATH 193A,A05,093482,Rotar; Vladimir,10,0,34,24
1657480854091,MATH 197,001,091859,McAuley; Julian John,9999,0,9999,0
1657480854091,MATH 197,002,095566,Kedlaya; Kiran S.,9997,0,9999,2
1657480854091,MATH 197,003,095567,Xiao; Ming,9999,0,9999,0
1657480854091,MATH 197,004,095571,Perols; Johan Lars,9998,0,9999,1
1657480861166,COGS 9,A01,083615,Shannon; Kyle Michael,9,0,75,66
1657480867189,COGS 11,A01,083617,Boyle; Mary E. T.,22,0,48,26
1657480873212,COGS 13,A01,083071,Bastos; Amalia Pinkusfeld,11,0,71,60
1657480879251,COGS 14A,A01,092681,Semenuks; Arturs,5,1,100,95
1657480885273,COGS 14B,A01,083073,Cheng; Tzu-Han,6,0,63,57
1657480891301,COGS 17,A01,092677,Semenuks; Arturs,6,0,81,75
1657480897329,COGS 100,A01,083619,Allen; Michael Gordon,17,0,70,53
1657480903355,COGS 101A,A01,083621,Davis; Joshua Daniel,9,0,68,59
1657480909379,COGS 101B,A01,091572,Allen; Michael Gordon,12,0,65,53
1657480915402,COGS 101C,A01,083625,Delgado; Tania,17,0,35,18
1657480921425,COGS 107A,A01,083627,Boyle; Mary E. T.,13,0,60,47
1657480927448,COGS 118A,A01,083075,Gupta; Anjum,21,0,76,55
1657480933475,CSE 3,A50,083646,Miranda; Gregory Joseph,24,0,50,26
1657480939502,CSE 8A,A50,083650,Miranda; Gregory Joseph,17,1,56,39
1657480945526,CSE 11,A01,083080,Cao; Yingjun,6,15,40,34
1657480951549,CSE 12,A01,083652,Krause-Levy; Sophia Louisa,28,1,120,92
1657480957577,CSE 15L,A01,083654,Morris; Justin Loren,9,0,50,41
1657480957577,CSE 15L,A02,083655,Morris; Justin Loren,9,0,50,41
1657480963604,CSE 20,A01,083657,Tran; Khoa Dang,39,0,80,41
1657480969630,CSE 21,A01,095574,Bach; Quang Tran,22,0,48,26
1657480975656,CSE 30,A01,083084,Eldon; John,5,0,80,75
1657480975656,CSE 30,B01,095061,Bhaskar; Nishant,9,0,50,41
1657480981684,CSE 100,A01,083659,Cao; Yingjun,5,4,70,65
1657480987705,CSE 134B,A01,083661,Powell; Thomas Allan,22,0,100,78
1657480993728,CSE 140,A01,083663,Gungor; Onat,15,0,85,70
1657480999751,CSE 140L,A01,083088,Eldon; John,21,0,100,79
1657481005774,CSE 175,A01,083665,Kumar; Rakesh,3,0,25,22
1657481011797,CSE 190,A00,092507,Dubnov; Shlomo,8,0,20,12
1657481017822,ECE 45,A01,083139,Congero; Spencer William,6,0,75,69
1657481023847,ECE 65,A50,083695,Saad; Andrew S,12,0,30,18
1657481023847,ECE 65,A51,095125,Saad; Andrew S,24,0,26,2
1657481029872,ECE 109,A01,091882,Touri; Behrouz,19,0,70,51
1657481035968,ECE 180,A00,083140,Abi Samra; Nicholas Camill,1,0,30,29
1657481035968,ECE 180,B00,083141,Abi Samra; Nicholas Camill,0,0,30,30
1657481041997,MATH 10A,A01,083735,Patchell; Gregory David,2,0,30,28
1657481041997,MATH 10A,A02,083736,Patchell; Gregory David,20,0,30,10
1657481041997,MATH 10A,A03,083737,Patchell; Gregory David,16,0,30,14
1657481048020,MATH 10B,A01,083207,Lim; Seonhee,8,0,34,26
1657481048020,MATH 10B,A02,083208,Lim; Seonhee,9,0,35,26
1657481048020,MATH 10B,A03,093472,Lim; Seonhee,7,0,34,27
1657481048020,MATH 10B,B01,083739,Sinha; Shubham,12,0,30,18
1657481054044,MATH 18,A01,083743,Cinel; Cameron Alexander,7,0,30,23
1657481054044,MATH 18,A02,083744,Cinel; Cameron Alexander,17,0,30,13
1657481054044,MATH 18,A03,083745,Cinel; Cameron Alexander,9,0,30,21
1657481054044,MATH 18,B01,083748,Rideout; David Porter,5,0,37,32
1657481054044,MATH 18,B02,083749,Rideout; David Porter,5,0,36,31
1657481054044,MATH 18,B03,083750,Rideout; David Porter,3,0,37,34
1657481054044,MATH 18,B04,083751,Rideout; David Porter,6,0,36,30
1657481054044,MATH 18,B05,093473,Rideout; David Porter,6,0,36,30
1657481054044,MATH 18,B06,093474,Rideout; David Porter,6,0,36,30
1657481060068,MATH 20A,A01,083754,Zheng; Zequn,14,0,40,26
1657481066092,MATH 20B,A01,083756,Briones; Jor-el Thomas Caparas,4,0,36,32
1657481066092,MATH 20B,A02,083757,Briones; Jor-el Thomas Caparas,1,0,36,35
1657481066092,MATH 20B,A03,093475,Briones; Jor-el Thomas Caparas,2,0,36,34
1657481072120,MATH 20C,A01,083760,Briones; Jor-el Thomas Caparas,1,0,35,34
1657481072120,MATH 20C,A02,083761,Briones; Jor-el Thomas Caparas,8,0,35,27
1657481072120,MATH 20C,A03,093476,Briones; Jor-el Thomas Caparas,0,1,36,36
1657481072120,MATH 20C,B01,083762,Bach; Quang Tran,1,0,30,29
1657481078146,MATH 20D,A01,083765,Tran; Brian Kha,5,0,30,25
1657481078146,MATH 20D,A02,083766,Tran; Brian Kha,5,0,30,25
1657481078146,MATH 20D,A03,083767,Tran; Brian Kha,5,0,30,25
1657481084174,MATH 20E,A01,083771,Ganguly; Soumya,9,0,32,23
1657481084174,MATH 20E,A02,083772,Ganguly; Soumya,6,0,32,26
1657481084174,MATH 20E,B01,083773,Ciotti; Benjamin,20,0,35,15
1657481084174,MATH 20E,B02,083774,Ciotti; Benjamin,17,0,35,18
1657481090202,MATH 103A,A01,083777,Greenfeld; Be'Eri,3,0,36,33
1657481090202,MATH 103A,A02,083778,Greenfeld; Be'Eri,5,0,36,31
1657481090202,MATH 103A,A03,093561,Greenfeld; Be'Eri,5,0,36,31
1657481090202,MATH 103A,B01,083779,Greenfeld; Be'Eri,7,0,36,29
1657481090202,MATH 103A,B02,083780,Greenfeld; Be'Eri,4,0,36,32
1657481090202,MATH 103A,B03,093562,Greenfeld; Be'Eri,3,0,36,33
1657481096229,MATH 105,A01,085443,Carter; Anne Toulson,15,0,35,20
1657481096229,MATH 105,A02,093477,Carter; Anne Toulson,20,0,35,15
1657481102258,MATH 109,A01,083213,Ganzberger; Geoffrey Michael,2,0,34,32
1657481102258,MATH 109,A02,083214,Ganzberger; Geoffrey Michael,4,0,34,30
1657481102258,MATH 109,A03,093478,Ganzberger; Geoffrey Michael,2,0,34,32
1657481102258,MATH 109,B01,083215,Ganzberger; Geoffrey Michael,1,0,32,31
1657481102258,MATH 109,B02,083216,Ganzberger; Geoffrey Michael,2,0,32,30
1657481102258,MATH 109,B03,093479,Ganzberger; Geoffrey Michael,8,0,32,24
1657481108288,MATH 142A,A01,083219,Chow; Bennett,7,0,32,25
1657481108288,MATH 142A,A02,083220,Chow; Bennett,10,0,32,22
1657481108288,MATH 142A,A03,093480,Chow; Bennett,8,0,32,24
1657481108288,MATH 142A,B03,093481,Chow; Bennett,8,0,32,24
1657481108288,MATH 142A,B04,093558,Chow; Bennett,13,0,32,19
1657481108288,MATH 142A,B05,093559,Chow; Bennett,6,0,32,26
1657481114315,MATH 193A,A01,083224,Rotar; Vladimir,8,0,34,26
1657481114315,MATH 193A,A02,083225,Rotar; Vladimir,9,0,34,25
1657481114315,MATH 193A,A03,083781,Rotar; Vladimir,5,0,34,29
1657481114315,MATH 193A,A04,083782,Rotar; Vladimir,10,0,34,24
1657481114315,MATH 193A,A05,093482,Rotar; Vladimir,10,0,34,24
1657481120338,MATH 197,001,091859,McAuley; Julian John,9999,0,9999,0
1657481120338,MATH 197,002,095566,Kedlaya; Kiran S.,9997,0,9999,2
1657481120338,MATH 197,003,095567,Xiao; Ming,9999,0,9999,0
1657481120338,MATH 197,004,095571,Perols; Johan Lars,9998,0,9999,1
1657481127411,COGS 9,A01,083615,Shannon; Kyle Michael,9,0,75,66
1657481133438,COGS 11,A01,083617,Boyle; Mary E. T.,22,0,48,26
1657481139461,COGS 13,A01,083071,Bastos; Amalia Pinkusfeld,11,0,71,60
1657481145484,COGS 14A,A01,092681,Semenuks; Arturs,5,1,100,95
1657481151506,COGS 14B,A01,083073,Cheng; Tzu-Han,6,0,63,57
1657481157533,COGS 17,A01,092677,Semenuks; Arturs,6,0,81,75
1657481163558,COGS 100,A01,083619,Allen; Michael Gordon,17,0,70,53
1657481169584,COGS 101A,A01,083621,Davis; Joshua Daniel,9,0,68,59
1657481175606,COGS 101B,A01,091572,Allen; Michael Gordon,12,0,65,53
1657481181633,COGS 101C,A01,083625,Delgado; Tania,17,0,35,18
1657481187657,COGS 107A,A01,083627,Boyle; Mary E. T.,13,0,60,47
1657481193683,COGS 118A,A01,083075,Gupta; Anjum,21,0,76,55
1657481199710,CSE 3,A50,083646,Miranda; Gregory Joseph,24,0,50,26
1657481205737,CSE 8A,A50,083650,Miranda; Gregory Joseph,17,1,56,39
1657481211768,CSE 11,A01,083080,Cao; Yingjun,6,15,40,34
1657481217793,CSE 12,A01,083652,Krause-Levy; Sophia Louisa,28,1,120,92
1657481223816,CSE 15L,A01,083654,Morris; Justin Loren,9,0,50,41
1657481223816,CSE 15L,A02,083655,Morris; Justin Loren,9,0,50,41
1657481229851,CSE 20,A01,083657,Tran; Khoa Dang,39,0,80,41
1657481235875,CSE 21,A01,095574,Bach; Quang Tran,22,0,48,26
1657481241898,CSE 30,A01,083084,Eldon; John,5,0,80,75
1657481241898,CSE 30,B01,095061,Bhaskar; Nishant,9,0,50,41
1657481247930,CSE 100,A01,083659,Cao; Yingjun,5,4,70,65
1657481253954,CSE 134B,A01,083661,Powell; Thomas Allan,22,0,100,78
1657481259978,CSE 140,A01,083663,Gungor; Onat,15,0,85,70
1657481266001,CSE 140L,A01,083088,Eldon; John,21,0,100,79
1657481272026,CSE 175,A01,083665,Kumar; Rakesh,3,0,25,22
1657481278049,CSE 190,A00,092507,Dubnov; Shlomo,8,0,20,12
1657481284076,ECE 45,A01,083139,Congero; Spencer William,6,0,75,69
1657481290100,ECE 65,A50,083695,Saad; Andrew S,12,0,30,18
1657481290100,ECE 65,A51,095125,Saad; Andrew S,24,0,26,2
1657481296126,ECE 109,A01,091882,Touri; Behrouz,19,0,70,51
1657481302151,ECE 180,A00,083140,Abi Samra; Nicholas Camill,1,0,30,29
1657481302151,ECE 180,B00,083141,Abi Samra; Nicholas Camill,0,0,30,30
1657481308188,MATH 10A,A01,083735,Patchell; Gregory David,2,0,30,28
1657481308188,MATH 10A,A02,083736,Patchell; Gregory David,20,0,30,10
1657481308188,MATH 10A,A03,083737,Patchell; Gregory David,16,0,30,14
1657481314220,MATH 10B,A01,083207,Lim; Seonhee,8,0,34,26
1657481314220,MATH 10B,A02,083208,Lim; Seonhee,9,0,35,26
1657481314220,MATH 10B,A03,093472,Lim; Seonhee,7,0,34,27
1657481314220,MATH 10B,B01,083739,Sinha; Shubham,12,0,30,18
1657481320249,MATH 18,A01,083743,Cinel; Cameron Alexander,7,0,30,23
1657481320249,MATH 18,A02,083744,Cinel; Cameron Alexander,17,0,30,13
1657481320249,MATH 18,A03,083745,Cinel; Cameron Alexander,9,0,30,21
1657481320249,MATH 18,B01,083748,Rideout; David Porter,5,0,37,32
1657481320249,MATH 18,B02,083749,Rideout; David Porter,5,0,36,31
1657481320249,MATH 18,B03,083750,Rideout; David Porter,3,0,37,34
1657481320249,MATH 18,B04,083751,Rideout; David Porter,6,0,36,30
1657481320249,MATH 18,B05,093473,Rideout; David Porter,6,0,36,30
1657481320249,MATH 18,B06,093474,Rideout; David Porter,6,0,36,30
1657481326284,MATH 20A,A01,083754,Zheng; Zequn,14,0,40,26
1657481332307,MATH 20B,A01,083756,Briones; Jor-el Thomas Caparas,4,0,36,32
1657481332307,MATH 20B,A02,083757,Briones; Jor-el Thomas Caparas,1,0,36,35
1657481332307,MATH 20B,A03,093475,Briones; Jor-el Thomas Caparas,2,0,36,34
1657481338336,MATH 20C,A01,083760,Briones; Jor-el Thomas Caparas,1,0,35,34
1657481338336,MATH 20C,A02,083761,Briones; Jor-el Thomas Caparas,8,0,35,27
1657481338336,MATH 20C,A03,093476,Briones; Jor-el Thomas Caparas,0,1,36,36
1657481338336,MATH 20C,B01,083762,Bach; Quang Tran,1,0,30,29
1657481344361,MATH 20D,A01,083765,Tran; Brian Kha,5,0,30,25
1657481344361,MATH 20D,A02,083766,Tran; Brian Kha,5,0,30,25
1657481344361,MATH 20D,A03,083767,Tran; Brian Kha,5,0,30,25
1657481350390,MATH 20E,A01,083771,Ganguly; Soumya,9,0,32,23
1657481350390,MATH 20E,A02,083772,Ganguly; Soumya,6,0,32,26
1657481350390,MATH 20E,B01,083773,Ciotti; Benjamin,20,0,35,15
1657481350390,MATH 20E,B02,083774,Ciotti; Benjamin,17,0,35,18
1657481356416,MATH 103A,A01,083777,Greenfeld; Be'Eri,3,0,36,33
1657481356416,MATH 103A,A02,083778,Greenfeld; Be'Eri,5,0,36,31
1657481356416,MATH 103A,A03,093561,Greenfeld; Be'Eri,5,0,36,31
1657481356416,MATH 103A,B01,083779,Greenfeld; Be'Eri,7,0,36,29
1657481356416,MATH 103A,B02,083780,Greenfeld; Be'Eri,4,0,36,32
1657481356416,MATH 103A,B03,093562,Greenfeld; Be'Eri,3,0,36,33
1657481362444,MATH 105,A01,085443,Carter; Anne Toulson,15,0,35,20
1657481362444,MATH 105,A02,093477,Carter; Anne Toulson,20,0,35,15
1657481368466,MATH 109,A01,083213,Ganzberger; Geoffrey Michael,2,0,34,32
1657481368466,MATH 109,A02,083214,Ganzberger; Geoffrey Michael,4,0,34,30
1657481368466,MATH 109,A03,093478,Ganzberger; Geoffrey Michael,2,0,34,32
1657481368466,MATH 109,B01,083215,Ganzberger; Geoffrey Michael,1,0,32,31
1657481368466,MATH 109,B02,083216,Ganzberger; Geoffrey Michael,2,0,32,30
1657481368466,MATH 109,B03,093479,Ganzberger; Geoffrey Michael,8,0,32,24
1657481374494,MATH 142A,A01,083219,Chow; Bennett,7,0,32,25
1657481374494,MATH 142A,A02,083220,Chow; Bennett,10,0,32,22
1657481374494,MATH 142A,A03,093480,Chow; Bennett,8,0,32,24
1657481374494,MATH 142A,B03,093481,Chow; Bennett,8,0,32,24
1657481374494,MATH 142A,B04,093558,Chow; Bennett,13,0,32,19
1657481374494,MATH 142A,B05,093559,Chow; Bennett,6,0,32,26
1657481380528,MATH 193A,A01,083224,Rotar; Vladimir,8,0,34,26
1657481380528,MATH 193A,A02,083225,Rotar; Vladimir,9,0,34,25
1657481380528,MATH 193A,A03,083781,Rotar; Vladimir,5,0,34,29
1657481380528,MATH 193A,A04,083782,Rotar; Vladimir,10,0,34,24
1657481380528,MATH 193A,A05,093482,Rotar; Vladimir,10,0,34,24
1657481386560,MATH 197,001,091859,McAuley; Julian John,9999,0,9999,0
1657481386560,MATH 197,002,095566,Kedlaya; Kiran S.,9997,0,9999,2
1657481386560,MATH 197,003,095567,Xiao; Ming,9999,0,9999,0
1657481386560,MATH 197,004,095571,Perols; Johan Lars,9998,0,9999,1
1657481393615,COGS 9,A01,083615,Shannon; Kyle Michael,9,0,75,66
1657481399641,COGS 11,A01,083617,Boyle; Mary E. T.,22,0,48,26
1657481405670,COGS 13,A01,083071,Bastos; Amalia Pinkusfeld,11,0,71,60
1657481411695,COGS 14A,A01,092681,Semenuks; Arturs,5,1,100,95
1657481417720,COGS 14B,A01,083073,Cheng; Tzu-Han,6,0,63,57
1657481423747,COGS 17,A01,092677,Semenuks; Arturs,6,0,81,75
1657481429773,COGS 100,A01,083619,Allen; Michael Gordon,17,0,70,53
1657481435800,COGS 101A,A01,083621,Davis; Joshua Daniel,9,0,68,59
1657481441825,COGS 101B,A01,091572,Allen; Michael Gordon,12,0,65,53
1657481447861,COGS 101C,A01,083625,Delgado; Tania,17,0,35,18
1657481453884,COGS 107A,A01,083627,Boyle; Mary E. T.,13,0,60,47
1657481459911,COGS 118A,A01,083075,Gupta; Anjum,21,0,76,55
1657481465939,CSE 3,A50,083646,Miranda; Gregory Joseph,24,0,50,26
1657481471962,CSE 8A,A50,083650,Miranda; Gregory Joseph,17,1,56,39
1657481477985,CSE 11,A01,083080,Cao; Yingjun,6,15,40,34
1657481484009,CSE 12,A01,083652,Krause-Levy; Sophia Louisa,28,1,120,92
1657481490030,CSE 15L,A01,083654,Morris; Justin Loren,9,0,50,41
1657481490030,CSE 15L,A02,083655,Morris; Justin Loren,9,0,50,41
1657481496067,CSE 20,A01,083657,Tran; Khoa Dang,39,0,80,41
1657481502093,CSE 21,A01,095574,Bach; Quang Tran,22,0,48,26
1657481508120,CSE 30,A01,083084,Eldon; John,5,0,80,75
1657481508120,CSE 30,B01,095061,Bhaskar; Nishant,9,0,50,41
1657481514143,CSE 100,A01,083659,Cao; Yingjun,5,4,70,65
1657481520170,CSE 134B,A01,083661,Powell; Thomas Allan,22,0,100,78
1657481526196,CSE 140,A01,083663,Gungor; Onat,15,0,85,70
1657481532217,CSE 140L,A01,083088,Eldon; John,21,0,100,79
1657481538248,CSE 175,A01,083665,Kumar; Rakesh,3,0,25,22
1657481544271,CSE 190,A00,092507,Dubnov; Shlomo,8,0,20,12
1657481550297,ECE 45,A01,083139,Congero; Spencer William,6,0,75,69
1657481556320,ECE 65,A50,083695,Saad; Andrew S,12,0,30,18
1657481556320,ECE 65,A51,095125,Saad; Andrew S,24,0,26,2
1657481562347,ECE 109,A01,091882,Touri; Behrouz,19,0,70,51
1657481568378,ECE 180,A00,083140,Abi Samra; Nicholas Camill,1,0,30,29
1657481568378,ECE 180,B00,083141,Abi Samra; Nicholas Camill,0,0,30,30
1657481574403,MATH 10A,A01,083735,Patchell; Gregory David,2,0,30,28
1657481574403,MATH 10A,A02,083736,Patchell; Gregory David,20,0,30,10
1657481574403,MATH 10A,A03,083737,Patchell; Gregory David,16,0,30,14
1657481580431,MATH 10B,A01,083207,Lim; Seonhee,8,0,34,26
1657481580431,MATH 10B,A02,083208,Lim; Seonhee,9,0,35,26
1657481580431,MATH 10B,A03,093472,Lim; Seonhee,7,0,34,27
1657481580431,MATH 10B,B01,083739,Sinha; Shubham,12,0,30,18
1657481586461,MATH 18,A01,083743,Cinel; Cameron Alexander,7,0,30,23
1657481586461,MATH 18,A02,083744,Cinel; Cameron Alexander,17,0,30,13
1657481586461,MATH 18,A03,083745,Cinel; Cameron Alexander,9,0,30,21
1657481586461,MATH 18,B01,083748,Rideout; David Porter,5,0,37,32
1657481586461,MATH 18,B02,083749,Rideout; David Porter,5,0,36,31
1657481586461,MATH 18,B03,083750,Rideout; David Porter,3,0,37,34
1657481586461,MATH 18,B04,083751,Rideout; David Porter,6,0,36,30
1657481586461,MATH 18,B05,093473,Rideout; David Porter,6,0,36,30
1657481586461,MATH 18,B06,093474,Rideout; David Porter,6,0,36,30
1657481592484,MATH 20A,A01,083754,Zheng; Zequn,14,0,40,26
1657481598511,MATH 20B,A01,083756,Briones; Jor-el Thomas Caparas,4,0,36,32
1657481598511,MATH 20B,A02,083757,Briones; Jor-el Thomas Caparas,1,0,36,35
1657481598511,MATH 20B,A03,093475,Briones; Jor-el Thomas Caparas,2,0,36,34
1657481604539,MATH 20C,A01,083760,Briones; Jor-el Thomas Caparas,1,0,35,34
1657481604539,MATH 20C,A02,083761,Briones; Jor-el Thomas Caparas,8,0,35,27
1657481604539,MATH 20C,A03,093476,Briones; Jor-el Thomas Caparas,0,1,36,36
1657481604539,MATH 20C,B01,083762,Bach; Quang Tran,1,0,30,29
1657481610561,MATH 20D,A01,083765,Tran; Brian Kha,5,0,30,25
1657481610561,MATH 20D,A02,083766,Tran; Brian Kha,5,0,30,25
1657481610561,MATH 20D,A03,083767,Tran; Brian Kha,5,0,30,25
1657481616584,MATH 20E,A01,083771,Ganguly; Soumya,9,0,32,23
1657481616584,MATH 20E,A02,083772,Ganguly; Soumya,6,0,32,26
1657481616584,MATH 20E,B01,083773,Ciotti; Benjamin,20,0,35,15
1657481616584,MATH 20E,B02,083774,Ciotti; Benjamin,17,0,35,18
1657481622610,MATH 103A,A01,083777,Greenfeld; Be'Eri,3,0,36,33
1657481622610,MATH 103A,A02,083778,Greenfeld; Be'Eri,5,0,36,31
1657481622610,MATH 103A,A03,093561,Greenfeld; Be'Eri,5,0,36,31
1657481622610,MATH 103A,B01,083779,Greenfeld; Be'Eri,7,0,36,29
1657481622610,MATH 103A,B02,083780,Greenfeld; Be'Eri,4,0,36,32
1657481622610,MATH 103A,B03,093562,Greenfeld; Be'Eri,3,0,36,33
1657481628637,MATH 105,A01,085443,Carter; Anne Toulson,15,0,35,20
1657481628637,MATH 105,A02,093477,Carter; Anne Toulson,20,0,35,15
1657481634734,MATH 109,A01,083213,Ganzberger; Geoffrey Michael,2,0,34,32
1657481634734,MATH 109,A02,083214,Ganzberger; Geoffrey Michael,4,0,34,30
1657481634734,MATH 109,A03,093478,Ganzberger; Geoffrey Michael,2,0,34,32
1657481634734,MATH 109,B01,083215,Ganzberger; Geoffrey Michael,1,0,32,31
1657481634734,MATH 109,B02,083216,Ganzberger; Geoffrey Michael,2,0,32,30
1657481634734,MATH 109,B03,093479,Ganzberger; Geoffrey Michael,8,0,32,24
1657481640757,MATH 142A,A01,083219,Chow; Bennett,7,0,32,25
1657481640757,MATH 142A,A02,083220,Chow; Bennett,10,0,32,22
1657481640757,MATH 142A,A03,093480,Chow; Bennett,8,0,32,24
1657481640757,MATH 142A,B03,093481,Chow; Bennett,8,0,32,24
1657481640757,MATH 142A,B04,093558,Chow; Bennett,13,0,32,19
1657481640757,MATH 142A,B05,093559,Chow; Bennett,6,0,32,26
1657481646786,MATH 193A,A01,083224,Rotar; Vladimir,8,0,34,26
1657481646786,MATH 193A,A02,083225,Rotar; Vladimir,9,0,34,25
1657481646786,MATH 193A,A03,083781,Rotar; Vladimir,5,0,34,29
1657481646786,MATH 193A,A04,083782,Rotar; Vladimir,10,0,34,24
1657481646786,MATH 193A,A05,093482,Rotar; Vladimir,10,0,34,24
1657481652810,MATH 197,001,091859,McAuley; Julian John,9999,0,9999,0
1657481652810,MATH 197,002,095566,Kedlaya; Kiran S.,9997,0,9999,2
1657481652810,MATH 197,003,095567,Xiao; Ming,9999,0,9999,0
1657481652810,MATH 197,004,095571,Perols; Johan Lars,9998,0,9999,1
1657481659866,COGS 9,A01,083615,Shannon; Kyle Michael,9,0,75,66
1657481665888,COGS 11,A01,083617,Boyle; Mary E. T.,22,0,48,26
1657481671923,COGS 13,A01,083071,Bastos; Amalia Pinkusfeld,11,0,71,60
1657481677944,COGS 14A,A01,092681,Semenuks; Arturs,5,1,100,95
1657481683978,COGS 14B,A01,083073,Cheng; Tzu-Han,6,0,63,57
1657481690006,COGS 17,A01,092677,Semenuks; Arturs,6,0,81,75
1657481696029,COGS 100,A01,083619,Allen; Michael Gordon,17,0,70,53
1657481702053,COGS 101A,A01,083621,Davis; Joshua Daniel,9,0,68,59
1657481708079,COGS 101B,A01,091572,Allen; Michael Gordon,12,0,65,53
1657481714105,COGS 101C,A01,083625,Delgado; Tania,17,0,35,18
1657481720132,COGS 107A,A01,083627,Boyle; Mary E. T.,13,0,60,47
1657481726155,COGS 118A,A01,083075,Gupta; Anjum,21,0,76,55
1657481732184,CSE 3,A50,083646,Miranda; Gregory Joseph,24,0,50,26
1657481738210,CSE 8A,A50,083650,Miranda; Gregory Joseph,17,1,56,39
1657481744233,CSE 11,A01,083080,Cao; Yingjun,6,15,40,34
1657481750257,CSE 12,A01,083652,Krause-Levy; Sophia Louisa,28,1,120,92
1657481756281,CSE 15L,A01,083654,Morris; Justin Loren,9,0,50,41
1657481756281,CSE 15L,A02,083655,Morris; Justin Loren,9,0,50,41
1657481762303,CSE 20,A01,083657,Tran; Khoa Dang,39,0,80,41
1657481768327,CSE 21,A01,095574,Bach; Quang Tran,22,0,48,26
1657481774354,CSE 30,A01,083084,Eldon; John,5,0,80,75
1657481774354,CSE 30,B01,095061,Bhaskar; Nishant,9,0,50,41
1657481780376,CSE 100,A01,083659,Cao; Yingjun,5,4,70,65
1657481786398,CSE 134B,A01,083661,Powell; Thomas Allan,22,0,100,78
1657481792427,CSE 140,A01,083663,Gungor; Onat,15,0,85,70
1657481798449,CSE 140L,A01,083088,Eldon; John,21,0,100,79
1657481804476,CSE 175,A01,083665,Kumar; Rakesh,3,0,25,22
1657481810502,CSE 190,A00,092507,Dubnov; Shlomo,8,0,20,12
1657481816527,ECE 45,A01,083139,Congero; Spencer William,6,0,75,69
1657481822550,ECE 65,A50,083695,Saad; Andrew S,12,0,30,18
1657481822550,ECE 65,A51,095125,Saad; Andrew S,24,0,26,2
1657481828573,ECE 109,A01,091882,Touri; Behrouz,19,0,70,51
1657481834599,ECE 180,A00,083140,Abi Samra; Nicholas Camill,1,0,30,29
1657481834599,ECE 180,B00,083141,Abi Samra; Nicholas Camill,0,0,30,30
1657481840628,MATH 10A,A01,083735,Patchell; Gregory David,2,0,30,28
1657481840628,MATH 10A,A02,083736,Patchell; Gregory David,20,0,30,10
1657481840628,MATH 10A,A03,083737,Patchell; Gregory David,16,0,30,14
1657481846660,MATH 10B,A01,083207,Lim; Seonhee,8,0,34,26
1657481846660,MATH 10B,A02,083208,Lim; Seonhee,9,0,35,26
1657481846660,MATH 10B,A03,093472,Lim; Seonhee,7,0,34,27
1657481846660,MATH 10B,B01,083739,Sinha; Shubham,12,0,30,18
1657481852690,MATH 18,A01,083743,Cinel; Cameron Alexander,7,0,30,23
1657481852690,MATH 18,A02,083744,Cinel; Cameron Alexander,17,0,30,13
1657481852690,MATH 18,A03,083745,Cinel; Cameron Alexander,9,0,30,21
1657481852690,MATH 18,B01,083748,Rideout; David Porter,5,0,37,32
1657481852690,MATH 18,B02,083749,Rideout; David Porter,5,0,36,31
1657481852690,MATH 18,B03,083750,Rideout; David Porter,3,0,37,34
1657481852690,MATH 18,B04,083751,Rideout; David Porter,6,0,36,30
1657481852690,MATH 18,B05,093473,Rideout; David Porter,6,0,36,30
1657481852690,MATH 18,B06,093474,Rideout; David Porter,6,0,36,30
1657481858712,MATH 20A,A01,083754,Zheng; Zequn,14,0,40,26
1657481864740,MATH 20B,A01,083756,Briones; Jor-el Thomas Caparas,4,0,36,32
1657481864740,MATH 20B,A02,083757,Briones; Jor-el Thomas Caparas,1,0,36,35
1657481864740,MATH 20B,A03,093475,Briones; Jor-el Thomas Caparas,2,0,36,34
1657481870771,MATH 20C,A01,083760,Briones; Jor-el Thomas Caparas,1,0,35,34
1657481870771,MATH 20C,A02,083761,Briones; Jor-el Thomas Caparas,8,0,35,27
1657481870771,MATH 20C,A03,093476,Briones; Jor-el Thomas Caparas,0,1,36,36
1657481870771,MATH 20C,B01,083762,Bach; Quang Tran,1,0,30,29
1657481876796,MATH 20D,A01,083765,Tran; Brian Kha,5,0,30,25
1657481876796,MATH 20D,A02,083766,Tran; Brian Kha,5,0,30,25
1657481876796,MATH 20D,A03,083767,Tran; Brian Kha,5,0,30,25
1657481882823,MATH 20E,A01,083771,Ganguly; Soumya,9,0,32,23
1657481882823,MATH 20E,A02,083772,Ganguly; Soumya,6,0,32,26
1657481882823,MATH 20E,B01,083773,Ciotti; Benjamin,20,0,35,15
1657481882823,MATH 20E,B02,083774,Ciotti; Benjamin,17,0,35,18
1657481888853,MATH 103A,A01,083777,Greenfeld; Be'Eri,3,0,36,33
1657481888853,MATH 103A,A02,083778,Greenfeld; Be'Eri,5,0,36,31
1657481888853,MATH 103A,A03,093561,Greenfeld; Be'Eri,5,0,36,31
1657481888853,MATH 103A,B01,083779,Greenfeld; Be'Eri,7,0,36,29
1657481888853,MATH 103A,B02,083780,Greenfeld; Be'Eri,4,0,36,32
1657481888853,MATH 103A,B03,093562,Greenfeld; Be'Eri,3,0,36,33
1657481894876,MATH 105,A01,085443,Carter; Anne Toulson,15,0,35,20
1657481894876,MATH 105,A02,093477,Carter; Anne Toulson,20,0,35,15
1657481900904,MATH 109,A01,083213,Ganzberger; Geoffrey Michael,2,0,34,32
1657481900904,MATH 109,A02,083214,Ganzberger; Geoffrey Michael,4,0,34,30
1657481900904,MATH 109,A03,093478,Ganzberger; Geoffrey Michael,2,0,34,32
1657481900904,MATH 109,B01,083215,Ganzberger; Geoffrey Michael,1,0,32,31
1657481900904,MATH 109,B02,083216,Ganzberger; Geoffrey Michael,2,0,32,30
1657481900904,MATH 109,B03,093479,Ganzberger; Geoffrey Michael,8,0,32,24
1657481906935,MATH 142A,A01,083219,Chow; Bennett,7,0,32,25
1657481906935,MATH 142A,A02,083220,Chow; Bennett,10,0,32,22
1657481906935,MATH 142A,A03,093480,Chow; Bennett,8,0,32,24
1657481906935,MATH 142A,B03,093481,Chow; Bennett,8,0,32,24
1657481906935,MATH 142A,B04,093558,Chow; Bennett,13,0,32,19
1657481906935,MATH 142A,B05,093559,Chow; Bennett,6,0,32,26
1657481912958,MATH 193A,A01,083224,Rotar; Vladimir,8,0,34,26
1657481912958,MATH 193A,A02,083225,Rotar; Vladimir,9,0,34,25
1657481912958,MATH 193A,A03,083781,Rotar; Vladimir,5,0,34,29
1657481912958,MATH 193A,A04,083782,Rotar; Vladimir,10,0,34,24
1657481912958,MATH 193A,A05,093482,Rotar; Vladimir,10,0,34,24
1657481918980,MATH 197,001,091859,McAuley; Julian John,9999,0,9999,0
1657481918980,MATH 197,002,095566,Kedlaya; Kiran S.,9997,0,9999,2
1657481918980,MATH 197,003,095567,Xiao; Ming,9999,0,9999,0
1657481918980,MATH 197,004,095571,Perols; Johan Lars,9998,0,9999,1
1657481926035,COGS 9,A01,083615,Shannon; Kyle Michael,9,0,75,66
1657481932063,COGS 11,A01,083617,Boyle; Mary E. T.,22,0,48,26
1657481938090,COGS 13,A01,083071,Bastos; Amalia Pinkusfeld,11,0,71,60
1657481944114,COGS 14A,A01,092681,Semenuks; Arturs,5,1,100,95
1657481950138,COGS 14B,A01,083073,Cheng; Tzu-Han,6,0,63,57
1657481956160,COGS 17,A01,092677,Semenuks; Arturs,6,0,81,75
1657481962198,COGS 100,A01,083619,Allen; Michael Gordon,17,0,70,53
1657481968224,COGS 101A,A01,083621,Davis; Joshua Daniel,9,0,68,59
1657481974250,COGS 101B,A01,091572,Allen; Michael Gordon,12,0,65,53
1657481980277,COGS 101C,A01,083625,Delgado; Tania,17,0,35,18
1657481986299,COGS 107A,A01,083627,Boyle; Mary E. T.,13,0,60,47
1657481992325,COGS 118A,A01,083075,Gupta; Anjum,21,0,76,55
1657481998349,CSE 3,A50,083646,Miranda; Gregory Joseph,24,0,50,26
1657482004373,CSE 8A,A50,083650,Miranda; Gregory Joseph,17,1,56,39
1657482010400,CSE 11,A01,083080,Cao; Yingjun,6,15,40,34
1657482016423,CSE 12,A01,083652,Krause-Levy; Sophia Louisa,28,1,120,92
1657482022449,CSE 15L,A01,083654,Morris; Justin Loren,9,0,50,41
1657482022449,CSE 15L,A02,083655,Morris; Justin Loren,9,0,50,41
1657482028470,CSE 20,A01,083657,Tran; Khoa Dang,39,0,80,41
1657482034590,CSE 21,A01,095574,Bach; Quang Tran,22,0,48,26
1657482040613,CSE 30,A01,083084,Eldon; John,5,0,80,75
1657482040613,CSE 30,B01,095061,Bhaskar; Nishant,9,0,50,41
1657482046636,CSE 100,A01,083659,Cao; Yingjun,5,4,70,65
1657482052663,CSE 134B,A01,083661,Powell; Thomas Allan,22,0,100,78
1657482058689,CSE 140,A01,083663,Gungor; Onat,15,0,85,70
1657482064716,CSE 140L,A01,083088,Eldon; John,21,0,100,79
1657482070742,CSE 175,A01,083665,Kumar; Rakesh,3,0,25,22
1657482076764,CSE 190,A00,092507,Dubnov; Shlomo,8,0,20,12
1657482082788,ECE 45,A01,083139,Congero; Spencer William,6,0,75,69
1657482088814,ECE 65,A50,083695,Saad; Andrew S,12,0,30,18
1657482088814,ECE 65,A51,095125,Saad; Andrew S,24,0,26,2
1657482094837,ECE 109,A01,091882,Touri; Behrouz,19,0,70,51
1657482100859,ECE 180,A00,083140,Abi Samra; Nicholas Camill,1,0,30,29
1657482100859,ECE 180,B00,083141,Abi Samra; Nicholas Camill,0,0,30,30
1657482106884,MATH 10A,A01,083735,Patchell; Gregory David,2,0,30,28
1657482106884,MATH 10A,A02,083736,Patchell; Gregory David,20,0,30,10
1657482106884,MATH 10A,A03,083737,Patchell; Gregory David,16,0,30,14
1657482112908,MATH 10B,A01,083207,Lim; Seonhee,8,0,34,26
1657482112908,MATH 10B,A02,083208,Lim; Seonhee,9,0,35,26
1657482112908,MATH 10B,A03,093472,Lim; Seonhee,7,0,34,27
1657482112908,MATH 10B,B01,083739,Sinha; Shubham,12,0,30,18
1657482118933,MATH 18,A01,083743,Cinel; Cameron Alexander,7,0,30,23
1657482118933,MATH 18,A02,083744,Cinel; Cameron Alexander,17,0,30,13
1657482118933,MATH 18,A03,083745,Cinel; Cameron Alexander,9,0,30,21
1657482118933,MATH 18,B01,083748,Rideout; David Porter,5,0,37,32
1657482118933,MATH 18,B02,083749,Rideout; David Porter,5,0,36,31
1657482118933,MATH 18,B03,083750,Rideout; David Porter,3,0,37,34
1657482118933,MATH 18,B04,083751,Rideout; David Porter,6,0,36,30
1657482118933,MATH 18,B05,093473,Rideout; David Porter,6,0,36,30
1657482118933,MATH 18,B06,093474,Rideout; David Porter,6,0,36,30
1657482124958,MATH 20A,A01,083754,Zheng; Zequn,14,0,40,26
1657482130984,MATH 20B,A01,083756,Briones; Jor-el Thomas Caparas,4,0,36,32
1657482130984,MATH 20B,A02,083757,Briones; Jor-el Thomas Caparas,1,0,36,35
1657482130984,MATH 20B,A03,093475,Briones; Jor-el Thomas Caparas,2,0,36,34
1657482137010,MATH 20C,A01,083760,Briones; Jor-el Thomas Caparas,1,0,35,34
1657482137010,MATH 20C,A02,083761,Briones; Jor-el Thomas Caparas,8,0,35,27
1657482137010,MATH 20C,A03,093476,Briones; Jor-el Thomas Caparas,0,1,36,36
1657482137010,MATH 20C,B01,083762,Bach; Quang Tran,1,0,30,29
1657482143039,MATH 20D,A01,083765,Tran; Brian Kha,5,0,30,25
1657482143039,MATH 20D,A02,083766,Tran; Brian Kha,5,0,30,25
1657482143039,MATH 20D,A03,083767,Tran; Brian Kha,5,0,30,25
1657482149062,MATH 20E,A01,083771,Ganguly; Soumya,9,0,32,23
1657482149062,MATH 20E,A02,083772,Ganguly; Soumya,6,0,32,26
1657482149062,MATH 20E,B01,083773,Ciotti; Benjamin,20,0,35,15
1657482149062,MATH 20E,B02,083774,Ciotti; Benjamin,17,0,35,18
1657482155087,MATH 103A,A01,083777,Greenfeld; Be'Eri,3,0,36,33
1657482155087,MATH 103A,A02,083778,Greenfeld; Be'Eri,5,0,36,31
1657482155087,MATH 103A,A03,093561,Greenfeld; Be'Eri,5,0,36,31
1657482155087,MATH 103A,B01,083779,Greenfeld; Be'Eri,7,0,36,29
1657482155087,MATH 103A,B02,083780,Greenfeld; Be'Eri,4,0,36,32
1657482155087,MATH 103A,B03,093562,Greenfeld; Be'Eri,3,0,36,33
1657482161114,MATH 105,A01,085443,Carter; Anne Toulson,15,0,35,20
1657482161114,MATH 105,A02,093477,Carter; Anne Toulson,20,0,35,15
1657482167143,MATH 109,A01,083213,Ganzberger; Geoffrey Michael,2,0,34,32
1657482167143,MATH 109,A02,083214,Ganzberger; Geoffrey Michael,4,0,34,30
1657482167143,MATH 109,A03,093478,Ganzberger; Geoffrey Michael,2,0,34,32
1657482167143,MATH 109,B01,083215,Ganzberger; Geoffrey Michael,1,0,32,31
1657482167143,MATH 109,B02,083216,Ganzberger; Geoffrey Michael,2,0,32,30
1657482167143,MATH 109,B03,093479,Ganzberger; Geoffrey Michael,8,0,32,24
1657482173167,MATH 142A,A01,083219,Chow; Bennett,7,0,32,25
1657482173167,MATH 142A,A02,083220,Chow; Bennett,10,0,32,22
1657482173167,MATH 142A,A03,093480,Chow; Bennett,8,0,32,24
1657482173167,MATH 142A,B03,093481,Chow; Bennett,8,0,32,24
1657482173167,MATH 142A,B04,093558,Chow; Bennett,13,0,32,19
1657482173167,MATH 142A,B05,093559,Chow; Bennett,6,0,32,26
1657482179194,MATH 193A,A01,083224,Rotar; Vladimir,8,0,34,26
1657482179194,MATH 193A,A02,083225,Rotar; Vladimir,9,0,34,25
1657482179194,MATH 193A,A03,083781,Rotar; Vladimir,5,0,34,29
1657482179194,MATH 193A,A04,083782,Rotar; Vladimir,10,0,34,24
1657482179194,MATH 193A,A05,093482,Rotar; Vladimir,10,0,34,24
1657482185218,MATH 197,001,091859,McAuley; Julian John,9999,0,9999,0
1657482185218,MATH 197,002,095566,Kedlaya; Kiran S.,9997,0,9999,2
1657482185218,MATH 197,003,095567,Xiao; Ming,9999,0,9999,0
1657482185218,MATH 197,004,095571,Perols; Johan Lars,9998,0,9999,1
1657482192268,COGS 9,A01,083615,Shannon; Kyle Michael,9,0,75,66
1657482198294,COGS 11,A01,083617,Boyle; Mary E. T.,22,0,48,26
1657482204317,COGS 13,A01,083071,Bastos; Amalia Pinkusfeld,11,0,71,60
1657482210344,COGS 14A,A01,092681,Semenuks; Arturs,5,1,100,95
1657482216368,COGS 14B,A01,083073,Cheng; Tzu-Han,6,0,63,57
1657482222410,COGS 17,A01,092677,Semenuks; Arturs,6,0,81,75
1657482228506,COGS 100,A01,083619,Allen; Michael Gordon,17,0,70,53
1657482234540,COGS 101A,A01,083621,Davis; Joshua Daniel,9,0,68,59
1657482240570,COGS 101B,A01,091572,Allen; Michael Gordon,12,0,65,53
1657482246594,COGS 101C,A01,083625,Delgado; Tania,17,0,35,18
1657482252622,COGS 107A,A01,083627,Boyle; Mary E. T.,13,0,60,47
1657482258645,COGS 118A,A01,083075,Gupta; Anjum,21,0,76,55
1657482264668,CSE 3,A50,083646,Miranda; Gregory Joseph,24,0,50,26
1657482270692,CSE 8A,A50,083650,Miranda; Gregory Joseph,17,1,56,39
1657482276719,CSE 11,A01,083080,Cao; Yingjun,6,15,40,34
1657482282741,CSE 12,A01,083652,Krause-Levy; Sophia Louisa,28,1,120,92
1657482288765,CSE 15L,A01,083654,Morris; Justin Loren,9,0,50,41
1657482288765,CSE 15L,A02,083655,Morris; Justin Loren,9,0,50,41
1657482294790,CSE 20,A01,083657,Tran; Khoa Dang,39,0,80,41
1657482300815,CSE 21,A01,095574,Bach; Quang Tran,22,0,48,26
1657482306847,CSE 30,A01,083084,Eldon; John,5,0,80,75
1657482306847,CSE 30,B01,095061,Bhaskar; Nishant,9,0,50,41
1657482312872,CSE 100,A01,083659,Cao; Yingjun,5,4,70,65
1657482318898,CSE 134B,A01,083661,Powell; Thomas Allan,22,0,100,78
1657482324924,CSE 140,A01,083663,Gungor; Onat,15,0,85,70
1657482330947,CSE 140L,A01,083088,Eldon; John,21,0,100,79
1657482336976,CSE 175,A01,083665,Kumar; Rakesh,3,0,25,22
1657482343005,CSE 190,A00,092507,Dubnov; Shlomo,8,0,20,12
1657482349029,ECE 45,A01,083139,Congero; Spencer William,6,0,75,69
1657482355054,ECE 65,A50,083695,Saad; Andrew S,12,0,30,18
1657482355054,ECE 65,A51,095125,Saad; Andrew S,24,0,26,2
1657482361083,ECE 109,A01,091882,Touri; Behrouz,19,0,70,51
1657482367111,ECE 180,A00,083140,Abi Samra; Nicholas Camill,1,0,30,29
1657482367111,ECE 180,B00,083141,Abi Samra; Nicholas Camill,0,0,30,30
1657482373135,MATH 10A,A01,083735,Patchell; Gregory David,2,0,30,28
1657482373135,MATH 10A,A02,083736,Patchell; Gregory David,20,0,30,10
1657482373135,MATH 10A,A03,083737,Patchell; Gregory David,16,0,30,14
1657482379161,MATH 10B,A01,083207,Lim; Seonhee,8,0,34,26
1657482379161,MATH 10B,A02,083208,Lim; Seonhee,9,0,35,26
1657482379161,MATH 10B,A03,093472,Lim; Seonhee,7,0,34,27
1657482379161,MATH 10B,B01,083739,Sinha; Shubham,12,0,30,18
1657482385184,MATH 18,A01,083743,Cinel; Cameron Alexander,7,0,30,23
1657482385184,MATH 18,A02,083744,Cinel; Cameron Alexander,17,0,30,13
1657482385184,MATH 18,A03,083745,Cinel; Cameron Alexander,9,0,30,21
1657482385184,MATH 18,B01,083748,Rideout; David Porter,5,0,37,32
1657482385184,MATH 18,B02,083749,Rideout; David Porter,5,0,36,31
1657482385184,MATH 18,B03,083750,Rideout; David Porter,3,0,37,34
1657482385184,MATH 18,B04,083751,Rideout; David Porter,6,0,36,30
1657482385184,MATH 18,B05,093473,Rideout; David Porter,6,0,36,30
1657482385184,MATH 18,B06,093474,Rideout; David Porter,6,0,36,30
1657482391212,MATH 20A,A01,083754,Zheng; Zequn,14,0,40,26
1657482397241,MATH 20B,A01,083756,Briones; Jor-el Thomas Caparas,4,0,36,32
1657482397241,MATH 20B,A02,083757,Briones; Jor-el Thomas Caparas,1,0,36,35
1657482397241,MATH 20B,A03,093475,Briones; Jor-el Thomas Caparas,2,0,36,34
1657482403264,MATH 20C,A01,083760,Briones; Jor-el Thomas Caparas,1,0,35,34
1657482403264,MATH 20C,A02,083761,Briones; Jor-el Thomas Caparas,8,0,35,27
1657482403264,MATH 20C,A03,093476,Briones; Jor-el Thomas Caparas,0,1,36,36
1657482403264,MATH 20C,B01,083762,Bach; Quang Tran,1,0,30,29
1657482409288,MATH 20D,A01,083765,Tran; Brian Kha,5,0,30,25
1657482409288,MATH 20D,A02,083766,Tran; Brian Kha,5,0,30,25
1657482409288,MATH 20D,A03,083767,Tran; Brian Kha,5,0,30,25
1657482415317,MATH 20E,A01,083771,Ganguly; Soumya,9,0,32,23
1657482415317,MATH 20E,A02,083772,Ganguly; Soumya,6,0,32,26
1657482415317,MATH 20E,B01,083773,Ciotti; Benjamin,20,0,35,15
1657482415317,MATH 20E,B02,083774,Ciotti; Benjamin,17,0,35,18
1657482421345,MATH 103A,A01,083777,Greenfeld; Be'Eri,3,0,36,33
1657482421345,MATH 103A,A02,083778,Greenfeld; Be'Eri,5,0,36,31
1657482421345,MATH 103A,A03,093561,Greenfeld; Be'Eri,5,0,36,31
1657482421345,MATH 103A,B01,083779,Greenfeld; Be'Eri,7,0,36,29
1657482421345,MATH 103A,B02,083780,Greenfeld; Be'Eri,4,0,36,32
1657482421345,MATH 103A,B03,093562,Greenfeld; Be'Eri,3,0,36,33
1657482427369,MATH 105,A01,085443,Carter; Anne Toulson,15,0,35,20
1657482427369,MATH 105,A02,093477,Carter; Anne Toulson,20,0,35,15
1657482433398,MATH 109,A01,083213,Ganzberger; Geoffrey Michael,2,0,34,32
1657482433398,MATH 109,A02,083214,Ganzberger; Geoffrey Michael,4,0,34,30
1657482433398,MATH 109,A03,093478,Ganzberger; Geoffrey Michael,2,0,34,32
1657482433398,MATH 109,B01,083215,Ganzberger; Geoffrey Michael,1,0,32,31
1657482433398,MATH 109,B02,083216,Ganzberger; Geoffrey Michael,2,0,32,30
1657482433398,MATH 109,B03,093479,Ganzberger; Geoffrey Michael,8,0,32,24
1657482439422,MATH 142A,A01,083219,Chow; Bennett,7,0,32,25
1657482439422,MATH 142A,A02,083220,Chow; Bennett,10,0,32,22
1657482439422,MATH 142A,A03,093480,Chow; Bennett,8,0,32,24
1657482439422,MATH 142A,B03,093481,Chow; Bennett,8,0,32,24
1657482439422,MATH 142A,B04,093558,Chow; Bennett,13,0,32,19
1657482439422,MATH 142A,B05,093559,Chow; Bennett,6,0,32,26
1657482445449,MATH 193A,A01,083224,Rotar; Vladimir,8,0,34,26
1657482445449,MATH 193A,A02,083225,Rotar; Vladimir,9,0,34,25
1657482445449,MATH 193A,A03,083781,Rotar; Vladimir,5,0,34,29
1657482445449,MATH 193A,A04,083782,Rotar; Vladimir,10,0,34,24
1657482445449,MATH 193A,A05,093482,Rotar; Vladimir,10,0,34,24
1657482451472,MATH 197,001,091859,McAuley; Julian John,9999,0,9999,0
1657482451472,MATH 197,002,095566,Kedlaya; Kiran S.,9997,0,9999,2
1657482451472,MATH 197,003,095567,Xiao; Ming,9999,0,9999,0
1657482451472,MATH 197,004,095571,Perols; Johan Lars,9998,0,9999,1
1657482458535,COGS 9,A01,083615,Shannon; Kyle Michael,9,0,75,66
1657482464560,COGS 11,A01,083617,Boyle; Mary E. T.,22,0,48,26
1657482470586,COGS 13,A01,083071,Bastos; Amalia Pinkusfeld,11,0,71,60
1657482476609,COGS 14A,A01,092681,Semenuks; Arturs,5,1,100,95
1657482482637,COGS 14B,A01,083073,Cheng; Tzu-Han,6,0,63,57
1657482488662,COGS 17,A01,092677,Semenuks; Arturs,6,0,81,75
1657482494685,COGS 100,A01,083619,Allen; Michael Gordon,17,0,70,53
1657482500709,COGS 101A,A01,083621,Davis; Joshua Daniel,9,0,68,59
1657482506734,COGS 101B,A01,091572,Allen; Michael Gordon,12,0,65,53
1657482512762,COGS 101C,A01,083625,Delgado; Tania,17,0,35,18
1657482518786,COGS 107A,A01,083627,Boyle; Mary E. T.,13,0,60,47
1657482524810,COGS 118A,A01,083075,Gupta; Anjum,21,0,76,55
1657482530838,CSE 3,A50,083646,Miranda; Gregory Joseph,24,0,50,26
1657482536860,CSE 8A,A50,083650,Miranda; Gregory Joseph,17,1,56,39
1657482542882,CSE 11,A01,083080,Cao; Yingjun,6,15,40,34
1657482548914,CSE 12,A01,083652,Krause-Levy; Sophia Louisa,28,1,120,92
1657482554941,CSE 15L,A01,083654,Morris; Justin Loren,9,0,50,41
1657482554941,CSE 15L,A02,083655,Morris; Justin Loren,9,0,50,41
1657482560969,CSE 20,A01,083657,Tran; Khoa Dang,39,0,80,41
1657482566996,CSE 21,A01,095574,Bach; Quang Tran,22,0,48,26
1657482573025,CSE 30,A01,083084,Eldon; John,5,0,80,75
1657482573025,CSE 30,B01,095061,Bhaskar; Nishant,9,0,50,41
1657482579049,CSE 100,A01,083659,Cao; Yingjun,5,4,70,65
1657482585076,CSE 134B,A01,083661,Powell; Thomas Allan,22,0,100,78
1657482591102,CSE 140,A01,083663,Gungor; Onat,15,0,85,70
1657482597127,CSE 140L,A01,083088,Eldon; John,21,0,100,79
1657482603151,CSE 175,A01,083665,Kumar; Rakesh,3,0,25,22
1657482609173,CSE 190,A00,092507,Dubnov; Shlomo,8,0,20,12
1657482615196,ECE 45,A01,083139,Congero; Spencer William,6,0,75,69
1657482621223,ECE 65,A50,083695,Saad; Andrew S,12,0,30,18
1657482621223,ECE 65,A51,095125,Saad; Andrew S,24,0,26,2
1657482627248,ECE 109,A01,091882,Touri; Behrouz,19,0,70,51
1657482633271,ECE 180,A00,083140,Abi Samra; Nicholas Camill,1,0,30,29
1657482633271,ECE 180,B00,083141,Abi Samra; Nicholas Camill,0,0,30,30
1657482639295,MATH 10A,A01,083735,Patchell; Gregory David,2,0,30,28
1657482639295,MATH 10A,A02,083736,Patchell; Gregory David,20,0,30,10
1657482639295,MATH 10A,A03,083737,Patchell; Gregory David,16,0,30,14
1657482645318,MATH 10B,A01,083207,Lim; Seonhee,8,0,34,26
1657482645318,MATH 10B,A02,083208,Lim; Seonhee,9,0,35,26
1657482645318,MATH 10B,A03,093472,Lim; Seonhee,7,0,34,27
1657482645318,MATH 10B,B01,083739,Sinha; Shubham,12,0,30,18
1657482651344,MATH 18,A01,083743,Cinel; Cameron Alexander,7,0,30,23
1657482651344,MATH 18,A02,083744,Cinel; Cameron Alexander,17,0,30,13
1657482651344,MATH 18,A03,083745,Cinel; Cameron Alexander,9,0,30,21
1657482651344,MATH 18,B01,083748,Rideout; David Porter,5,0,37,32
1657482651344,MATH 18,B02,083749,Rideout; David Porter,5,0,36,31
1657482651344,MATH 18,B03,083750,Rideout; David Porter,3,0,37,34
1657482651344,MATH 18,B04,083751,Rideout; David Porter,6,0,36,30
1657482651344,MATH 18,B05,093473,Rideout; David Porter,6,0,36,30
1657482651344,MATH 18,B06,093474,Rideout; David Porter,6,0,36,30
1657482657370,MATH 20A,A01,083754,Zheng; Zequn,14,0,40,26
1657482663398,MATH 20B,A01,083756,Briones; Jor-el Thomas Caparas,4,0,36,32
1657482663398,MATH 20B,A02,083757,Briones; Jor-el Thomas Caparas,1,0,36,35
1657482663398,MATH 20B,A03,093475,Briones; Jor-el Thomas Caparas,2,0,36,34
1657482669422,MATH 20C,A01,083760,Briones; Jor-el Thomas Caparas,1,0,35,34
1657482669422,MATH 20C,A02,083761,Briones; Jor-el Thomas Caparas,8,0,35,27
1657482669422,MATH 20C,A03,093476,Briones; Jor-el Thomas Caparas,0,1,36,36
1657482669422,MATH 20C,B01,083762,Bach; Quang Tran,1,0,30,29
1657482675450,MATH 20D,A01,083765,Tran; Brian Kha,5,0,30,25
1657482675450,MATH 20D,A02,083766,Tran; Brian Kha,5,0,30,25
1657482675450,MATH 20D,A03,083767,Tran; Brian Kha,5,0,30,25
1657482681474,MATH 20E,A01,083771,Ganguly; Soumya,9,0,32,23
1657482681474,MATH 20E,A02,083772,Ganguly; Soumya,6,0,32,26
1657482681474,MATH 20E,B01,083773,Ciotti; Benjamin,20,0,35,15
1657482681474,MATH 20E,B02,083774,Ciotti; Benjamin,17,0,35,18
1657482687498,MATH 103A,A01,083777,Greenfeld; Be'Eri,3,0,36,33
1657482687498,MATH 103A,A02,083778,Greenfeld; Be'Eri,5,0,36,31
1657482687498,MATH 103A,A03,093561,Greenfeld; Be'Eri,5,0,36,31
1657482687498,MATH 103A,B01,083779,Greenfeld; Be'Eri,7,0,36,29
1657482687498,MATH 103A,B02,083780,Greenfeld; Be'Eri,4,0,36,32
1657482687498,MATH 103A,B03,093562,Greenfeld; Be'Eri,3,0,36,33
1657482693520,MATH 105,A01,085443,Carter; Anne Toulson,15,0,35,20
1657482693520,MATH 105,A02,093477,Carter; Anne Toulson,20,0,35,15
1657482699554,MATH 109,A01,083213,Ganzberger; Geoffrey Michael,2,0,34,32
1657482699554,MATH 109,A02,083214,Ganzberger; Geoffrey Michael,4,0,34,30
1657482699554,MATH 109,A03,093478,Ganzberger; Geoffrey Michael,2,0,34,32
1657482699554,MATH 109,B01,083215,Ganzberger; Geoffrey Michael,1,0,32,31
1657482699554,MATH 109,B02,083216,Ganzberger; Geoffrey Michael,2,0,32,30
1657482699554,MATH 109,B03,093479,Ganzberger; Geoffrey Michael,8,0,32,24
1657482705579,MATH 142A,A01,083219,Chow; Bennett,7,0,32,25
1657482705579,MATH 142A,A02,083220,Chow; Bennett,10,0,32,22
1657482705579,MATH 142A,A03,093480,Chow; Bennett,8,0,32,24
1657482705579,MATH 142A,B03,093481,Chow; Bennett,8,0,32,24
1657482705579,MATH 142A,B04,093558,Chow; Bennett,13,0,32,19
1657482705579,MATH 142A,B05,093559,Chow; Bennett,6,0,32,26
1657482711618,MATH 193A,A01,083224,Rotar; Vladimir,8,0,34,26
1657482711618,MATH 193A,A02,083225,Rotar; Vladimir,9,0,34,25
1657482711618,MATH 193A,A03,083781,Rotar; Vladimir,5,0,34,29
1657482711618,MATH 193A,A04,083782,Rotar; Vladimir,10,0,34,24
1657482711618,MATH 193A,A05,093482,Rotar; Vladimir,10,0,34,24
1657482717644,MATH 197,001,091859,McAuley; Julian John,9999,0,9999,0
1657482717644,MATH 197,002,095566,Kedlaya; Kiran S.,9997,0,9999,2
1657482717644,MATH 197,003,095567,Xiao; Ming,9999,0,9999,0
1657482717644,MATH 197,004,095571,Perols; Johan Lars,9998,0,9999,1
1657482724696,COGS 9,A01,083615,Shannon; Kyle Michael,9,0,75,66
1657482730719,COGS 11,A01,083617,Boyle; Mary E. T.,22,0,48,26
1657482736745,COGS 13,A01,083071,Bastos; Amalia Pinkusfeld,11,0,71,60
1657482742771,COGS 14A,A01,092681,Semenuks; Arturs,5,1,100,95
1657482748794,COGS 14B,A01,083073,Cheng; Tzu-Han,6,0,63,57
1657482754824,COGS 17,A01,092677,Semenuks; Arturs,6,0,81,75
1657482760853,COGS 100,A01,083619,Allen; Michael Gordon,17,0,70,53
1657482766878,COGS 101A,A01,083621,Davis; Joshua Daniel,9,0,68,59
1657482772903,COGS 101B,A01,091572,Allen; Michael Gordon,12,0,65,53
1657482778928,COGS 101C,A01,083625,Delgado; Tania,17,0,35,18
1657482784955,COGS 107A,A01,083627,Boyle; Mary E. T.,13,0,60,47
1657482790981,COGS 118A,A01,083075,Gupta; Anjum,21,0,76,55
1657482797005,CSE 3,A50,083646,Miranda; Gregory Joseph,24,0,50,26
1657482803032,CSE 8A,A50,083650,Miranda; Gregory Joseph,17,1,56,39
1657482809057,CSE 11,A01,083080,Cao; Yingjun,6,15,40,34
1657482815081,CSE 12,A01,083652,Krause-Levy; Sophia Louisa,28,1,120,92
1657482821104,CSE 15L,A01,083654,Morris; Justin Loren,9,0,50,41
1657482821104,CSE 15L,A02,083655,Morris; Justin Loren,9,0,50,41
1657482827202,CSE 20,A01,083657,Tran; Khoa Dang,39,0,80,41
1657482833230,CSE 21,A01,095574,Bach; Quang Tran,22,0,48,26
1657482839257,CSE 30,A01,083084,Eldon; John,5,0,80,75
1657482839257,CSE 30,B01,095061,Bhaskar; Nishant,9,0,50,41
1657482845287,CSE 100,A01,083659,Cao; Yingjun,5,4,70,65
1657482851313,CSE 134B,A01,083661,Powell; Thomas Allan,22,0,100,78
1657482857334,CSE 140,A01,083663,Gungor; Onat,15,0,85,70
1657482863362,CSE 140L,A01,083088,Eldon; John,21,0,100,79
1657482869387,CSE 175,A01,083665,Kumar; Rakesh,3,0,25,22
1657482875412,CSE 190,A00,092507,Dubnov; Shlomo,8,0,20,12
1657482881436,ECE 45,A01,083139,Congero; Spencer William,6,0,75,69
1657482887469,ECE 65,A50,083695,Saad; Andrew S,12,0,30,18
1657482887469,ECE 65,A51,095125,Saad; Andrew S,24,0,26,2
1657482893491,ECE 109,A01,091882,Touri; Behrouz,19,0,70,51
1657482899514,ECE 180,A00,083140,Abi Samra; Nicholas Camill,1,0,30,29
1657482899514,ECE 180,B00,083141,Abi Samra; Nicholas Camill,0,0,30,30
1657482905537,MATH 10A,A01,083735,Patchell; Gregory David,2,0,30,28
1657482905537,MATH 10A,A02,083736,Patchell; Gregory David,20,0,30,10
1657482905537,MATH 10A,A03,083737,Patchell; Gregory David,16,0,30,14
1657482911561,MATH 10B,A01,083207,Lim; Seonhee,8,0,34,26
1657482911561,MATH 10B,A02,083208,Lim; Seonhee,9,0,35,26
1657482911561,MATH 10B,A03,093472,Lim; Seonhee,7,0,34,27
1657482911561,MATH 10B,B01,083739,Sinha; Shubham,12,0,30,18
1657482917587,MATH 18,A01,083743,Cinel; Cameron Alexander,7,0,30,23
1657482917587,MATH 18,A02,083744,Cinel; Cameron Alexander,17,0,30,13
1657482917587,MATH 18,A03,083745,Cinel; Cameron Alexander,9,0,30,21
1657482917587,MATH 18,B01,083748,Rideout; David Porter,5,0,37,32
1657482917587,MATH 18,B02,083749,Rideout; David Porter,5,0,36,31
1657482917587,MATH 18,B03,083750,Rideout; David Porter,3,0,37,34
1657482917587,MATH 18,B04,083751,Rideout; David Porter,6,0,36,30
1657482917587,MATH 18,B05,093473,Rideout; David Porter,6,0,36,30
1657482917587,MATH 18,B06,093474,Rideout; David Porter,6,0,36,30
1657482923613,MATH 20A,A01,083754,Zheng; Zequn,14,0,40,26
1657482929640,MATH 20B,A01,083756,Briones; Jor-el Thomas Caparas,4,0,36,32
1657482929640,MATH 20B,A02,083757,Briones; Jor-el Thomas Caparas,1,0,36,35
1657482929640,MATH 20B,A03,093475,Briones; Jor-el Thomas Caparas,2,0,36,34
1657482935668,MATH 20C,A01,083760,Briones; Jor-el Thomas Caparas,1,0,35,34
1657482935668,MATH 20C,A02,083761,Briones; Jor-el Thomas Caparas,8,0,35,27
1657482935668,MATH 20C,A03,093476,Briones; Jor-el Thomas Caparas,0,1,36,36
1657482935668,MATH 20C,B01,083762,Bach; Quang Tran,1,0,30,29
1657482941708,MATH 20D,A01,083765,Tran; Brian Kha,5,0,30,25
1657482941708,MATH 20D,A02,083766,Tran; Brian Kha,5,0,30,25
1657482941708,MATH 20D,A03,083767,Tran; Brian Kha,5,0,30,25
1657482947732,MATH 20E,A01,083771,Ganguly; Soumya,9,0,32,23
1657482947732,MATH 20E,A02,083772,Ganguly; Soumya,6,0,32,26
1657482947732,MATH 20E,B01,083773,Ciotti; Benjamin,20,0,35,15
1657482947732,MATH 20E,B02,083774,Ciotti; Benjamin,17,0,35,18
1657482953756,MATH 103A,A01,083777,Greenfeld; Be'Eri,3,0,36,33
1657482953756,MATH 103A,A02,083778,Greenfeld; Be'Eri,5,0,36,31
1657482953756,MATH 103A,A03,093561,Greenfeld; Be'Eri,5,0,36,31
1657482953756,MATH 103A,B01,083779,Greenfeld; Be'Eri,7,0,36,29
1657482953756,MATH 103A,B02,083780,Greenfeld; Be'Eri,4,0,36,32
1657482953756,MATH 103A,B03,093562,Greenfeld; Be'Eri,3,0,36,33
1657482959779,MATH 105,A01,085443,Carter; Anne Toulson,15,0,35,20
1657482959779,MATH 105,A02,093477,Carter; Anne Toulson,20,0,35,15
1657482965806,MATH 109,A01,083213,Ganzberger; Geoffrey Michael,2,0,34,32
1657482965806,MATH 109,A02,083214,Ganzberger; Geoffrey Michael,4,0,34,30
1657482965806,MATH 109,A03,093478,Ganzberger; Geoffrey Michael,2,0,34,32
1657482965806,MATH 109,B01,083215,Ganzberger; Geoffrey Michael,1,0,32,31
1657482965806,MATH 109,B02,083216,Ganzberger; Geoffrey Michael,2,0,32,30
1657482965806,MATH 109,B03,093479,Ganzberger; Geoffrey Michael,8,0,32,24
1657482971837,MATH 142A,A01,083219,Chow; Bennett,7,0,32,25
1657482971837,MATH 142A,A02,083220,Chow; Bennett,10,0,32,22
1657482971837,MATH 142A,A03,093480,Chow; Bennett,8,0,32,24
1657482971837,MATH 142A,B03,093481,Chow; Bennett,8,0,32,24
1657482971837,MATH 142A,B04,093558,Chow; Bennett,13,0,32,19
1657482971837,MATH 142A,B05,093559,Chow; Bennett,6,0,32,26
1657482977864,MATH 193A,A01,083224,Rotar; Vladimir,8,0,34,26
1657482977864,MATH 193A,A02,083225,Rotar; Vladimir,9,0,34,25
1657482977864,MATH 193A,A03,083781,Rotar; Vladimir,5,0,34,29
1657482977864,MATH 193A,A04,083782,Rotar; Vladimir,10,0,34,24
1657482977864,MATH 193A,A05,093482,Rotar; Vladimir,10,0,34,24
1657482983887,MATH 197,001,091859,McAuley; Julian John,9999,0,9999,0
1657482983887,MATH 197,002,095566,Kedlaya; Kiran S.,9997,0,9999,2
1657482983887,MATH 197,003,095567,Xiao; Ming,9999,0,9999,0
1657482983887,MATH 197,004,095571,Perols; Johan Lars,9998,0,9999,1
1657482990953,COGS 9,A01,083615,Shannon; Kyle Michael,9,0,75,66
1657482996974,COGS 11,A01,083617,Boyle; Mary E. T.,22,0,48,26
1657483002998,COGS 13,A01,083071,Bastos; Amalia Pinkusfeld,11,0,71,60
1657483009024,COGS 14A,A01,092681,Semenuks; Arturs,5,1,100,95
1657483015048,COGS 14B,A01,083073,Cheng; Tzu-Han,6,0,63,57
1657483021076,COGS 17,A01,092677,Semenuks; Arturs,6,0,81,75
1657483027098,COGS 100,A01,083619,Allen; Michael Gordon,17,0,70,53
1657483033121,COGS 101A,A01,083621,Davis; Joshua Daniel,9,0,68,59
1657483039143,COGS 101B,A01,091572,Allen; Michael Gordon,12,0,65,53
1657483045165,COGS 101C,A01,083625,Delgado; Tania,17,0,35,18
1657483051192,COGS 107A,A01,083627,Boyle; Mary E. T.,13,0,60,47
1657483057295,COGS 118A,A01,083075,Gupta; Anjum,21,0,76,55
1657483063318,CSE 3,A50,083646,Miranda; Gregory Joseph,24,0,50,26
1657483069349,CSE 8A,A50,083650,Miranda; Gregory Joseph,17,1,56,39
1657483075372,CSE 11,A01,083080,Cao; Yingjun,6,15,40,34
1657483081399,CSE 12,A01,083652,Krause-Levy; Sophia Louisa,28,1,120,92
1657483087431,CSE 15L,A01,083654,Morris; Justin Loren,9,0,50,41
1657483087431,CSE 15L,A02,083655,Morris; Justin Loren,9,0,50,41
1657483093456,CSE 20,A01,083657,Tran; Khoa Dang,39,0,80,41
1657483099482,CSE 21,A01,095574,Bach; Quang Tran,22,0,48,26
1657483105510,CSE 30,A01,083084,Eldon; John,5,0,80,75
1657483105510,CSE 30,B01,095061,Bhaskar; Nishant,9,0,50,41
1657483111532,CSE 100,A01,083659,Cao; Yingjun,5,4,70,65
1657483117555,CSE 134B,A01,083661,Powell; Thomas Allan,22,0,100,78
1657483123577,CSE 140,A01,083663,Gungor; Onat,15,0,85,70
1657483129604,CSE 140L,A01,083088,Eldon; John,21,0,100,79
1657483135631,CSE 175,A01,083665,Kumar; Rakesh,3,0,25,22
1657483141659,CSE 190,A00,092507,Dubnov; Shlomo,8,0,20,12
1657483147686,ECE 45,A01,083139,Congero; Spencer William,6,0,75,69
1657483153713,ECE 65,A50,083695,Saad; Andrew S,12,0,30,18
1657483153713,ECE 65,A51,095125,Saad; Andrew S,24,0,26,2
1657483159735,ECE 109,A01,091882,Touri; Behrouz,19,0,70,51
1657483165759,ECE 180,A00,083140,Abi Samra; Nicholas Camill,1,0,30,29
1657483165759,ECE 180,B00,083141,Abi Samra; Nicholas Camill,0,0,30,30
1657483171781,MATH 10A,A01,083735,Patchell; Gregory David,2,0,30,28
1657483171781,MATH 10A,A02,083736,Patchell; Gregory David,20,0,30,10
1657483171781,MATH 10A,A03,083737,Patchell; Gregory David,16,0,30,14
1657483177803,MATH 10B,A01,083207,Lim; Seonhee,8,0,34,26
1657483177803,MATH 10B,A02,083208,Lim; Seonhee,9,0,35,26
1657483177803,MATH 10B,A03,093472,Lim; Seonhee,7,0,34,27
1657483177803,MATH 10B,B01,083739,Sinha; Shubham,12,0,30,18
1657483183829,MATH 18,A01,083743,Cinel; Cameron Alexander,7,0,30,23
1657483183829,MATH 18,A02,083744,Cinel; Cameron Alexander,17,0,30,13
1657483183829,MATH 18,A03,083745,Cinel; Cameron Alexander,9,0,30,21
1657483183829,MATH 18,B01,083748,Rideout; David Porter,5,0,37,32
1657483183829,MATH 18,B02,083749,Rideout; David Porter,5,0,36,31
1657483183829,MATH 18,B03,083750,Rideout; David Porter,3,0,37,34
1657483183829,MATH 18,B04,083751,Rideout; David Porter,6,0,36,30
1657483183829,MATH 18,B05,093473,Rideout; David Porter,6,0,36,30
1657483183829,MATH 18,B06,093474,Rideout; David Porter,6,0,36,30
1657483189853,MATH 20A,A01,083754,Zheng; Zequn,14,0,40,26
1657483195880,MATH 20B,A01,083756,Briones; Jor-el Thomas Caparas,4,0,36,32
1657483195880,MATH 20B,A02,083757,Briones; Jor-el Thomas Caparas,1,0,36,35
1657483195880,MATH 20B,A03,093475,Briones; Jor-el Thomas Caparas,2,0,36,34
1657483201904,MATH 20C,A01,083760,Briones; Jor-el Thomas Caparas,1,0,35,34
1657483201904,MATH 20C,A02,083761,Briones; Jor-el Thomas Caparas,8,0,35,27
1657483201904,MATH 20C,A03,093476,Briones; Jor-el Thomas Caparas,0,1,36,36
1657483201904,MATH 20C,B01,083762,Bach; Quang Tran,1,0,30,29
1657483207931,MATH 20D,A01,083765,Tran; Brian Kha,5,0,30,25
1657483207931,MATH 20D,A02,083766,Tran; Brian Kha,5,0,30,25
1657483207931,MATH 20D,A03,083767,Tran; Brian Kha,5,0,30,25
1657483213954,MATH 20E,A01,083771,Ganguly; Soumya,9,0,32,23
1657483213954,MATH 20E,A02,083772,Ganguly; Soumya,6,0,32,26
1657483213954,MATH 20E,B01,083773,Ciotti; Benjamin,20,0,35,15
1657483213954,MATH 20E,B02,083774,Ciotti; Benjamin,17,0,35,18
1657483219978,MATH 103A,A01,083777,Greenfeld; Be'Eri,3,0,36,33
1657483219978,MATH 103A,A02,083778,Greenfeld; Be'Eri,5,0,36,31
1657483219978,MATH 103A,A03,093561,Greenfeld; Be'Eri,5,0,36,31
1657483219978,MATH 103A,B01,083779,Greenfeld; Be'Eri,7,0,36,29
1657483219978,MATH 103A,B02,083780,Greenfeld; Be'Eri,4,0,36,32
1657483219978,MATH 103A,B03,093562,Greenfeld; Be'Eri,3,0,36,33
1657483226000,MATH 105,A01,085443,Carter; Anne Toulson,15,0,35,20
1657483226000,MATH 105,A02,093477,Carter; Anne Toulson,20,0,35,15
1657483232030,MATH 109,A01,083213,Ganzberger; Geoffrey Michael,2,0,34,32
1657483232030,MATH 109,A02,083214,Ganzberger; Geoffrey Michael,4,0,34,30
1657483232030,MATH 109,A03,093478,Ganzberger; Geoffrey Michael,2,0,34,32
1657483232030,MATH 109,B01,083215,Ganzberger; Geoffrey Michael,1,0,32,31
1657483232030,MATH 109,B02,083216,Ganzberger; Geoffrey Michael,2,0,32,30
1657483232030,MATH 109,B03,093479,Ganzberger; Geoffrey Michael,8,0,32,24
1657483238069,MATH 142A,A01,083219,Chow; Bennett,7,0,32,25
1657483238069,MATH 142A,A02,083220,Chow; Bennett,10,0,32,22
1657483238069,MATH 142A,A03,093480,Chow; Bennett,8,0,32,24
1657483238069,MATH 142A,B03,093481,Chow; Bennett,8,0,32,24
1657483238069,MATH 142A,B04,093558,Chow; Bennett,13,0,32,19
1657483238069,MATH 142A,B05,093559,Chow; Bennett,6,0,32,26
1657483244098,MATH 193A,A01,083224,Rotar; Vladimir,8,0,34,26
1657483244098,MATH 193A,A02,083225,Rotar; Vladimir,9,0,34,25
1657483244098,MATH 193A,A03,083781,Rotar; Vladimir,5,0,34,29
1657483244098,MATH 193A,A04,083782,Rotar; Vladimir,10,0,34,24
1657483244098,MATH 193A,A05,093482,Rotar; Vladimir,10,0,34,24
1657483250122,MATH 197,001,091859,McAuley; Julian John,9999,0,9999,0
1657483250122,MATH 197,002,095566,Kedlaya; Kiran S.,9997,0,9999,2
1657483250122,MATH 197,003,095567,Xiao; Ming,9999,0,9999,0
1657483250122,MATH 197,004,095571,Perols; Johan Lars,9998,0,9999,1
1657483257175,COGS 9,A01,083615,Shannon; Kyle Michael,9,0,75,66
1657483263199,COGS 11,A01,083617,Boyle; Mary E. T.,22,0,48,26
1657483269221,COGS 13,A01,083071,Bastos; Amalia Pinkusfeld,11,0,71,60
1657483275245,COGS 14A,A01,092681,Semenuks; Arturs,5,1,100,95
1657483281267,COGS 14B,A01,083073,Cheng; Tzu-Han,6,0,63,57
1657483287291,COGS 17,A01,092677,Semenuks; Arturs,6,0,81,75
1657483293313,COGS 100,A01,083619,Allen; Michael Gordon,17,0,70,53
1657483299336,COGS 101A,A01,083621,Davis; Joshua Daniel,9,0,68,59
1657483305361,COGS 101B,A01,091572,Allen; Michael Gordon,12,0,65,53
1657483311388,COGS 101C,A01,083625,Delgado; Tania,17,0,35,18
1657483317415,COGS 107A,A01,083627,Boyle; Mary E. T.,13,0,60,47
1657483323448,COGS 118A,A01,083075,Gupta; Anjum,21,0,76,55
1657483329475,CSE 3,A50,083646,Miranda; Gregory Joseph,24,0,50,26
1657483335499,CSE 8A,A50,083650,Miranda; Gregory Joseph,17,1,56,39
1657483341521,CSE 11,A01,083080,Cao; Yingjun,6,15,40,34
1657483347545,CSE 12,A01,083652,Krause-Levy; Sophia Louisa,28,1,120,92
1657483353572,CSE 15L,A01,083654,Morris; Justin Loren,9,0,50,41
1657483353572,CSE 15L,A02,083655,Morris; Justin Loren,9,0,50,41
1657483359599,CSE 20,A01,083657,Tran; Khoa Dang,39,0,80,41
1657483365623,CSE 21,A01,095574,Bach; Quang Tran,22,0,48,26
1657483371646,CSE 30,A01,083084,Eldon; John,5,0,80,75
1657483371646,CSE 30,B01,095061,Bhaskar; Nishant,9,0,50,41
1657483377669,CSE 100,A01,083659,Cao; Yingjun,5,4,70,65
1657483383696,CSE 134B,A01,083661,Powell; Thomas Allan,22,0,100,78
1657483389728,CSE 140,A01,083663,Gungor; Onat,15,0,85,70
1657483395751,CSE 140L,A01,083088,Eldon; John,21,0,100,79
1657483401775,CSE 175,A01,083665,Kumar; Rakesh,3,0,25,22
1657483407800,CSE 190,A00,092507,Dubnov; Shlomo,8,0,20,12
1657483413821,ECE 45,A01,083139,Congero; Spencer William,6,0,75,69
1657483419845,ECE 65,A50,083695,Saad; Andrew S,12,0,30,18
1657483419845,ECE 65,A51,095125,Saad; Andrew S,24,0,26,2
1657483425951,ECE 109,A01,091882,Touri; Behrouz,19,0,70,51
1657483431978,ECE 180,A00,083140,Abi Samra; Nicholas Camill,1,0,30,29
1657483431978,ECE 180,B00,083141,Abi Samra; Nicholas Camill,0,0,30,30
1657483438005,MATH 10A,A01,083735,Patchell; Gregory David,2,0,30,28
1657483438005,MATH 10A,A02,083736,Patchell; Gregory David,20,0,30,10
1657483438005,MATH 10A,A03,083737,Patchell; Gregory David,16,0,30,14
1657483444033,MATH 10B,A01,083207,Lim; Seonhee,8,0,34,26
1657483444033,MATH 10B,A02,083208,Lim; Seonhee,9,0,35,26
1657483444033,MATH 10B,A03,093472,Lim; Seonhee,7,0,34,27
1657483444033,MATH 10B,B01,083739,Sinha; Shubham,12,0,30,18
1657483450057,MATH 18,A01,083743,Cinel; Cameron Alexander,7,0,30,23
1657483450057,MATH 18,A02,083744,Cinel; Cameron Alexander,17,0,30,13
1657483450057,MATH 18,A03,083745,Cinel; Cameron Alexander,9,0,30,21
1657483450057,MATH 18,B01,083748,Rideout; David Porter,5,0,37,32
1657483450057,MATH 18,B02,083749,Rideout; David Porter,5,0,36,31
1657483450057,MATH 18,B03,083750,Rideout; David Porter,3,0,37,34
1657483450057,MATH 18,B04,083751,Rideout; David Porter,6,0,36,30
1657483450057,MATH 18,B05,093473,Rideout; David Porter,6,0,36,30
1657483450057,MATH 18,B06,093474,Rideout; David Porter,6,0,36,30
1657483456083,MATH 20A,A01,083754,Zheng; Zequn,14,0,40,26
1657483462106,MATH 20B,A01,083756,Briones; Jor-el Thomas Caparas,4,0,36,32
1657483462106,MATH 20B,A02,083757,Briones; Jor-el Thomas Caparas,1,0,36,35
1657483462106,MATH 20B,A03,093475,Briones; Jor-el Thomas Caparas,2,0,36,34
1657483468130,MATH 20C,A01,083760,Briones; Jor-el Thomas Caparas,1,0,35,34
1657483468130,MATH 20C,A02,083761,Briones; Jor-el Thomas Caparas,8,0,35,27
1657483468130,MATH 20C,A03,093476,Briones; Jor-el Thomas Caparas,0,1,36,36
1657483468130,MATH 20C,B01,083762,Bach; Quang Tran,1,0,30,29
1657483474161,MATH 20D,A01,083765,Tran; Brian Kha,5,0,30,25
1657483474161,MATH 20D,A02,083766,Tran; Brian Kha,5,0,30,25
1657483474161,MATH 20D,A03,083767,Tran; Brian Kha,5,0,30,25
1657483480187,MATH 20E,A01,083771,Ganguly; Soumya,9,0,32,23
1657483480187,MATH 20E,A02,083772,Ganguly; Soumya,6,0,32,26
1657483480187,MATH 20E,B01,083773,Ciotti; Benjamin,20,0,35,15
1657483480187,MATH 20E,B02,083774,Ciotti; Benjamin,17,0,35,18
1657483486211,MATH 103A,A01,083777,Greenfeld; Be'Eri,3,0,36,33
1657483486211,MATH 103A,A02,083778,Greenfeld; Be'Eri,5,0,36,31
1657483486211,MATH 103A,A03,093561,Greenfeld; Be'Eri,5,0,36,31
1657483486211,MATH 103A,B01,083779,Greenfeld; Be'Eri,7,0,36,29
1657483486211,MATH 103A,B02,083780,Greenfeld; Be'Eri,4,0,36,32
1657483486211,MATH 103A,B03,093562,Greenfeld; Be'Eri,3,0,36,33
1657483492235,MATH 105,A01,085443,Carter; Anne Toulson,15,0,35,20
1657483492235,MATH 105,A02,093477,Carter; Anne Toulson,20,0,35,15
1657483498265,MATH 109,A01,083213,Ganzberger; Geoffrey Michael,2,0,34,32
1657483498265,MATH 109,A02,083214,Ganzberger; Geoffrey Michael,4,0,34,30
1657483498265,MATH 109,A03,093478,Ganzberger; Geoffrey Michael,2,0,34,32
1657483498265,MATH 109,B01,083215,Ganzberger; Geoffrey Michael,1,0,32,31
1657483498265,MATH 109,B02,083216,Ganzberger; Geoffrey Michael,2,0,32,30
1657483498265,MATH 109,B03,093479,Ganzberger; Geoffrey Michael,8,0,32,24
1657483504296,MATH 142A,A01,083219,Chow; Bennett,7,0,32,25
1657483504296,MATH 142A,A02,083220,Chow; Bennett,10,0,32,22
1657483504296,MATH 142A,A03,093480,Chow; Bennett,8,0,32,24
1657483504296,MATH 142A,B03,093481,Chow; Bennett,8,0,32,24
1657483504296,MATH 142A,B04,093558,Chow; Bennett,13,0,32,19
1657483504296,MATH 142A,B05,093559,Chow; Bennett,6,0,32,26
1657483510318,MATH 193A,A01,083224,Rotar; Vladimir,8,0,34,26
1657483510318,MATH 193A,A02,083225,Rotar; Vladimir,9,0,34,25
1657483510318,MATH 193A,A03,083781,Rotar; Vladimir,5,0,34,29
1657483510318,MATH 193A,A04,083782,Rotar; Vladimir,10,0,34,24
1657483510318,MATH 193A,A05,093482,Rotar; Vladimir,10,0,34,24
1657483516345,MATH 197,001,091859,McAuley; Julian John,9999,0,9999,0
1657483516345,MATH 197,002,095566,Kedlaya; Kiran S.,9997,0,9999,2
1657483516345,MATH 197,003,095567,Xiao; Ming,9999,0,9999,0
1657483516345,MATH 197,004,095571,Perols; Johan Lars,9998,0,9999,1
1657483523407,COGS 9,A01,083615,Shannon; Kyle Michael,9,0,75,66
1657483529429,COGS 11,A01,083617,Boyle; Mary E. T.,22,0,48,26
1657483535450,COGS 13,A01,083071,Bastos; Amalia Pinkusfeld,11,0,71,60
1657483541473,COGS 14A,A01,092681,Semenuks; Arturs,5,1,100,95
1657483547506,COGS 14B,A01,083073,Cheng; Tzu-Han,6,0,63,57
1657483553533,COGS 17,A01,092677,Semenuks; Arturs,6,0,81,75
1657483559560,COGS 100,A01,083619,Allen; Michael Gordon,17,0,70,53
1657483565595,COGS 101A,A01,083621,Davis; Joshua Daniel,9,0,68,59
1657483571620,COGS 101B,A01,091572,Allen; Michael Gordon,12,0,65,53
1657483577644,COGS 101C,A01,083625,Delgado; Tania,17,0,35,18
1657483583666,COGS 107A,A01,083627,Boyle; Mary E. T.,13,0,60,47
1657483589693,COGS 118A,A01,083075,Gupta; Anjum,21,0,76,55
1657483595717,CSE 3,A50,083646,Miranda; Gregory Joseph,24,0,50,26
1657483601745,CSE 8A,A50,083650,Miranda; Gregory Joseph,17,1,56,39
1657483607768,CSE 11,A01,083080,Cao; Yingjun,6,15,40,34
1657483613792,CSE 12,A01,083652,Krause-Levy; Sophia Louisa,28,1,120,92
1657483619826,CSE 15L,A01,083654,Morris; Justin Loren,9,0,50,41
1657483619826,CSE 15L,A02,083655,Morris; Justin Loren,9,0,50,41
1657483625850,CSE 20,A01,083657,Tran; Khoa Dang,39,0,80,41
1657483631881,CSE 21,A01,095574,Bach; Quang Tran,22,0,48,26
1657483637907,CSE 30,A01,083084,Eldon; John,5,0,80,75
1657483637907,CSE 30,B01,095061,Bhaskar; Nishant,9,0,50,41
1657483643930,CSE 100,A01,083659,Cao; Yingjun,5,4,70,65
1657483649957,CSE 134B,A01,083661,Powell; Thomas Allan,22,0,100,78
1657483655986,CSE 140,A01,083663,Gungor; Onat,15,0,85,70
1657483662014,CSE 140L,A01,083088,Eldon; John,21,0,100,79
1657483668038,CSE 175,A01,083665,Kumar; Rakesh,3,0,25,22
1657483674064,CSE 190,A00,092507,Dubnov; Shlomo,8,0,20,12
1657483680091,ECE 45,A01,083139,Congero; Spencer William,6,0,75,69
1657483686119,ECE 65,A50,083695,Saad; Andrew S,12,0,30,18
1657483686119,ECE 65,A51,095125,Saad; Andrew S,24,0,26,2
1657483692146,ECE 109,A01,091882,Touri; Behrouz,19,0,70,51
1657483698169,ECE 180,A00,083140,Abi Samra; Nicholas Camill,1,0,30,29
1657483698169,ECE 180,B00,083141,Abi Samra; Nicholas Camill,0,0,30,30
1657483704192,MATH 10A,A01,083735,Patchell; Gregory David,2,0,30,28
1657483704192,MATH 10A,A02,083736,Patchell; Gregory David,20,0,30,10
1657483704192,MATH 10A,A03,083737,Patchell; Gregory David,16,0,30,14
1657483710222,MATH 10B,A01,083207,Lim; Seonhee,8,0,34,26
1657483710222,MATH 10B,A02,083208,Lim; Seonhee,9,0,35,26
1657483710222,MATH 10B,A03,093472,Lim; Seonhee,7,0,34,27
1657483710222,MATH 10B,B01,083739,Sinha; Shubham,12,0,30,18
1657483716254,MATH 18,A01,083743,Cinel; Cameron Alexander,7,0,30,23
1657483716254,MATH 18,A02,083744,Cinel; Cameron Alexander,17,0,30,13
1657483716254,MATH 18,A03,083745,Cinel; Cameron Alexander,9,0,30,21
1657483716254,MATH 18,B01,083748,Rideout; David Porter,5,0,37,32
1657483716254,MATH 18,B02,083749,Rideout; David Porter,5,0,36,31
1657483716254,MATH 18,B03,083750,Rideout; David Porter,3,0,37,34
1657483716254,MATH 18,B04,083751,Rideout; David Porter,6,0,36,30
1657483716254,MATH 18,B05,093473,Rideout; David Porter,6,0,36,30
1657483716254,MATH 18,B06,093474,Rideout; David Porter,6,0,36,30
1657483722283,MATH 20A,A01,083754,Zheng; Zequn,14,0,40,26
1657483728327,MATH 20B,A01,083756,Briones; Jor-el Thomas Caparas,4,0,36,32
1657483728327,MATH 20B,A02,083757,Briones; Jor-el Thomas Caparas,1,0,36,35
1657483728327,MATH 20B,A03,093475,Briones; Jor-el Thomas Caparas,2,0,36,34
1657483734352,MATH 20C,A01,083760,Briones; Jor-el Thomas Caparas,1,0,35,34
1657483734352,MATH 20C,A02,083761,Briones; Jor-el Thomas Caparas,8,0,35,27
1657483734352,MATH 20C,A03,093476,Briones; Jor-el Thomas Caparas,0,1,36,36
1657483734352,MATH 20C,B01,083762,Bach; Quang Tran,1,0,30,29
1657483740376,MATH 20D,A01,083765,Tran; Brian Kha,5,0,30,25
1657483740376,MATH 20D,A02,083766,Tran; Brian Kha,5,0,30,25
1657483740376,MATH 20D,A03,083767,Tran; Brian Kha,5,0,30,25
1657483746401,MATH 20E,A01,083771,Ganguly; Soumya,9,0,32,23
1657483746401,MATH 20E,A02,083772,Ganguly; Soumya,6,0,32,26
1657483746401,MATH 20E,B01,083773,Ciotti; Benjamin,20,0,35,15
1657483746401,MATH 20E,B02,083774,Ciotti; Benjamin,17,0,35,18
1657483752425,MATH 103A,A01,083777,Greenfeld; Be'Eri,3,0,36,33
1657483752425,MATH 103A,A02,083778,Greenfeld; Be'Eri,5,0,36,31
1657483752425,MATH 103A,A03,093561,Greenfeld; Be'Eri,5,0,36,31
1657483752425,MATH 103A,B01,083779,Greenfeld; Be'Eri,7,0,36,29
1657483752425,MATH 103A,B02,083780,Greenfeld; Be'Eri,4,0,36,32
1657483752425,MATH 103A,B03,093562,Greenfeld; Be'Eri,3,0,36,33
1657483758448,MATH 105,A01,085443,Carter; Anne Toulson,15,0,35,20
1657483758448,MATH 105,A02,093477,Carter; Anne Toulson,20,0,35,15
1657483764475,MATH 109,A01,083213,Ganzberger; Geoffrey Michael,2,0,34,32
1657483764475,MATH 109,A02,083214,Ganzberger; Geoffrey Michael,4,0,34,30
1657483764475,MATH 109,A03,093478,Ganzberger; Geoffrey Michael,2,0,34,32
1657483764475,MATH 109,B01,083215,Ganzberger; Geoffrey Michael,1,0,32,31
1657483764475,MATH 109,B02,083216,Ganzberger; Geoffrey Michael,2,0,32,30
1657483764475,MATH 109,B03,093479,Ganzberger; Geoffrey Michael,8,0,32,24
1657483770498,MATH 142A,A01,083219,Chow; Bennett,7,0,32,25
1657483770498,MATH 142A,A02,083220,Chow; Bennett,10,0,32,22
1657483770498,MATH 142A,A03,093480,Chow; Bennett,8,0,32,24
1657483770498,MATH 142A,B03,093481,Chow; Bennett,8,0,32,24
1657483770498,MATH 142A,B04,093558,Chow; Bennett,13,0,32,19
1657483770498,MATH 142A,B05,093559,Chow; Bennett,6,0,32,26
1657483776539,MATH 193A,A01,083224,Rotar; Vladimir,8,0,34,26
1657483776539,MATH 193A,A02,083225,Rotar; Vladimir,9,0,34,25
1657483776539,MATH 193A,A03,083781,Rotar; Vladimir,5,0,34,29
1657483776539,MATH 193A,A04,083782,Rotar; Vladimir,10,0,34,24
1657483776539,MATH 193A,A05,093482,Rotar; Vladimir,10,0,34,24
1657483782565,MATH 197,001,091859,McAuley; Julian John,9999,0,9999,0
1657483782565,MATH 197,002,095566,Kedlaya; Kiran S.,9997,0,9999,2
1657483782565,MATH 197,003,095567,Xiao; Ming,9999,0,9999,0
1657483782565,MATH 197,004,095571,Perols; Johan Lars,9998,0,9999,1
1657483789622,COGS 9,A01,083615,Shannon; Kyle Michael,9,0,75,66
1657483795645,COGS 11,A01,083617,Boyle; Mary E. T.,22,0,48,26
1657483801672,COGS 13,A01,083071,Bastos; Amalia Pinkusfeld,11,0,71,60
1657483807698,COGS 14A,A01,092681,Semenuks; Arturs,5,1,100,95
1657483813734,COGS 14B,A01,083073,Cheng; Tzu-Han,6,0,63,57
1657483819757,COGS 17,A01,092677,Semenuks; Arturs,6,0,81,75
1657483825782,COGS 100,A01,083619,Allen; Michael Gordon,17,0,70,53
1657483831811,COGS 101A,A01,083621,Davis; Joshua Daniel,9,0,68,59
1657483837833,COGS 101B,A01,091572,Allen; Michael Gordon,12,0,65,53
1657483843857,COGS 101C,A01,083625,Delgado; Tania,17,0,35,18
1657483849885,COGS 107A,A01,083627,Boyle; Mary E. T.,13,0,60,47
1657483855908,COGS 118A,A01,083075,Gupta; Anjum,21,0,76,55
1657483861932,CSE 3,A50,083646,Miranda; Gregory Joseph,24,0,50,26
1657483867954,CSE 8A,A50,083650,Miranda; Gregory Joseph,17,1,56,39
1657483873977,CSE 11,A01,083080,Cao; Yingjun,6,15,40,34
1657483880004,CSE 12,A01,083652,Krause-Levy; Sophia Louisa,28,1,120,92
1657483886027,CSE 15L,A01,083654,Morris; Justin Loren,9,0,50,41
1657483886027,CSE 15L,A02,083655,Morris; Justin Loren,9,0,50,41
1657483892054,CSE 20,A01,083657,Tran; Khoa Dang,39,0,80,41
1657483898077,CSE 21,A01,095574,Bach; Quang Tran,22,0,48,26
1657483904104,CSE 30,A01,083084,Eldon; John,5,0,80,75
1657483904104,CSE 30,B01,095061,Bhaskar; Nishant,9,0,50,41
1657483910131,CSE 100,A01,083659,Cao; Yingjun,5,4,70,65
1657483916164,CSE 134B,A01,083661,Powell; Thomas Allan,22,0,100,78
1657483922188,CSE 140,A01,083663,Gungor; Onat,15,0,85,70
1657483928212,CSE 140L,A01,083088,Eldon; John,21,0,100,79
1657483934238,CSE 175,A01,083665,Kumar; Rakesh,3,0,25,22
1657483940262,CSE 190,A00,092507,Dubnov; Shlomo,8,0,20,12
1657483946291,ECE 45,A01,083139,Congero; Spencer William,6,0,75,69
1657483952318,ECE 65,A50,083695,Saad; Andrew S,12,0,30,18
1657483952318,ECE 65,A51,095125,Saad; Andrew S,24,0,26,2
1657483958340,ECE 109,A01,091882,Touri; Behrouz,19,0,70,51
1657483964362,ECE 180,A00,083140,Abi Samra; Nicholas Camill,1,0,30,29
1657483964362,ECE 180,B00,083141,Abi Samra; Nicholas Camill,0,0,30,30
1657483970386,MATH 10A,A01,083735,Patchell; Gregory David,2,0,30,28
1657483970386,MATH 10A,A02,083736,Patchell; Gregory David,20,0,30,10
1657483970386,MATH 10A,A03,083737,Patchell; Gregory David,16,0,30,14
1657483976412,MATH 10B,A01,083207,Lim; Seonhee,8,0,34,26
1657483976412,MATH 10B,A02,083208,Lim; Seonhee,9,0,35,26
1657483976412,MATH 10B,A03,093472,Lim; Seonhee,7,0,34,27
1657483976412,MATH 10B,B01,083739,Sinha; Shubham,12,0,30,18
1657483982436,MATH 18,A01,083743,Cinel; Cameron Alexander,7,0,30,23
1657483982436,MATH 18,A02,083744,Cinel; Cameron Alexander,17,0,30,13
1657483982436,MATH 18,A03,083745,Cinel; Cameron Alexander,9,0,30,21
1657483982436,MATH 18,B01,083748,Rideout; David Porter,5,0,37,32
1657483982436,MATH 18,B02,083749,Rideout; David Porter,5,0,36,31
1657483982436,MATH 18,B03,083750,Rideout; David Porter,3,0,37,34
1657483982436,MATH 18,B04,083751,Rideout; David Porter,6,0,36,30
1657483982436,MATH 18,B05,093473,Rideout; David Porter,6,0,36,30
1657483982436,MATH 18,B06,093474,Rideout; David Porter,6,0,36,30
1657483988458,MATH 20A,A01,083754,Zheng; Zequn,14,0,40,26
1657483994481,MATH 20B,A01,083756,Briones; Jor-el Thomas Caparas,4,0,36,32
1657483994481,MATH 20B,A02,083757,Briones; Jor-el Thomas Caparas,1,0,36,35
1657483994481,MATH 20B,A03,093475,Briones; Jor-el Thomas Caparas,2,0,36,34
1657484000505,MATH 20C,A01,083760,Briones; Jor-el Thomas Caparas,1,0,35,34
1657484000505,MATH 20C,A02,083761,Briones; Jor-el Thomas Caparas,8,0,35,27
1657484000505,MATH 20C,A03,093476,Briones; Jor-el Thomas Caparas,0,1,36,36
1657484000505,MATH 20C,B01,083762,Bach; Quang Tran,1,0,30,29
1657484006530,MATH 20D,A01,083765,Tran; Brian Kha,5,0,30,25
1657484006530,MATH 20D,A02,083766,Tran; Brian Kha,5,0,30,25
1657484006530,MATH 20D,A03,083767,Tran; Brian Kha,5,0,30,25
1657484012559,MATH 20E,A01,083771,Ganguly; Soumya,9,0,32,23
1657484012559,MATH 20E,A02,083772,Ganguly; Soumya,6,0,32,26
1657484012559,MATH 20E,B01,083773,Ciotti; Benjamin,20,0,35,15
1657484012559,MATH 20E,B02,083774,Ciotti; Benjamin,17,0,35,18
1657484018585,MATH 103A,A01,083777,Greenfeld; Be'Eri,3,0,36,33
1657484018585,MATH 103A,A02,083778,Greenfeld; Be'Eri,5,0,36,31
1657484018585,MATH 103A,A03,093561,Greenfeld; Be'Eri,5,0,36,31
1657484018585,MATH 103A,B01,083779,Greenfeld; Be'Eri,7,0,36,29
1657484018585,MATH 103A,B02,083780,Greenfeld; Be'Eri,4,0,36,32
1657484018585,MATH 103A,B03,093562,Greenfeld; Be'Eri,3,0,36,33
1657484024703,MATH 105,A01,085443,Carter; Anne Toulson,15,0,35,20
1657484024703,MATH 105,A02,093477,Carter; Anne Toulson,20,0,35,15
1657484030731,MATH 109,A01,083213,Ganzberger; Geoffrey Michael,2,0,34,32
1657484030731,MATH 109,A02,083214,Ganzberger; Geoffrey Michael,4,0,34,30
1657484030731,MATH 109,A03,093478,Ganzberger; Geoffrey Michael,2,0,34,32
1657484030731,MATH 109,B01,083215,Ganzberger; Geoffrey Michael,1,0,32,31
1657484030731,MATH 109,B02,083216,Ganzberger; Geoffrey Michael,2,0,32,30
1657484030731,MATH 109,B03,093479,Ganzberger; Geoffrey Michael,8,0,32,24
1657484036757,MATH 142A,A01,083219,Chow; Bennett,7,0,32,25
1657484036757,MATH 142A,A02,083220,Chow; Bennett,10,0,32,22
1657484036757,MATH 142A,A03,093480,Chow; Bennett,8,0,32,24
1657484036757,MATH 142A,B03,093481,Chow; Bennett,8,0,32,24
1657484036757,MATH 142A,B04,093558,Chow; Bennett,13,0,32,19
1657484036757,MATH 142A,B05,093559,Chow; Bennett,6,0,32,26
1657484042791,MATH 193A,A01,083224,Rotar; Vladimir,8,0,34,26
1657484042791,MATH 193A,A02,083225,Rotar; Vladimir,9,0,34,25
1657484042791,MATH 193A,A03,083781,Rotar; Vladimir,5,0,34,29
1657484042791,MATH 193A,A04,083782,Rotar; Vladimir,10,0,34,24
1657484042791,MATH 193A,A05,093482,Rotar; Vladimir,10,0,34,24
1657484048819,MATH 197,001,091859,McAuley; Julian John,9999,0,9999,0
1657484048819,MATH 197,002,095566,Kedlaya; Kiran S.,9997,0,9999,2
1657484048819,MATH 197,003,095567,Xiao; Ming,9999,0,9999,0
1657484048819,MATH 197,004,095571,Perols; Johan Lars,9998,0,9999,1
1657484055876,COGS 9,A01,083615,Shannon; Kyle Michael,9,0,75,66
1657484061898,COGS 11,A01,083617,Boyle; Mary E. T.,22,0,48,26
1657484067929,COGS 13,A01,083071,Bastos; Amalia Pinkusfeld,11,0,71,60
1657484073953,COGS 14A,A01,092681,Semenuks; Arturs,5,1,100,95
1657484079977,COGS 14B,A01,083073,Cheng; Tzu-Han,6,0,63,57
1657484086001,COGS 17,A01,092677,Semenuks; Arturs,6,0,81,75
1657484092024,COGS 100,A01,083619,Allen; Michael Gordon,17,0,70,53
1657484098049,COGS 101A,A01,083621,Davis; Joshua Daniel,9,0,68,59
1657484104075,COGS 101B,A01,091572,Allen; Michael Gordon,12,0,65,53
1657484110104,COGS 101C,A01,083625,Delgado; Tania,17,0,35,18
1657484116129,COGS 107A,A01,083627,Boyle; Mary E. T.,13,0,60,47
1657484122154,COGS 118A,A01,083075,Gupta; Anjum,21,0,76,55
1657484128176,CSE 3,A50,083646,Miranda; Gregory Joseph,24,0,50,26
1657484134205,CSE 8A,A50,083650,Miranda; Gregory Joseph,17,1,56,39
1657484140230,CSE 11,A01,083080,Cao; Yingjun,6,15,40,34
1657484146257,CSE 12,A01,083652,Krause-Levy; Sophia Louisa,28,1,120,92
1657484152281,CSE 15L,A01,083654,Morris; Justin Loren,9,0,50,41
1657484152281,CSE 15L,A02,083655,Morris; Justin Loren,9,0,50,41
1657484158308,CSE 20,A01,083657,Tran; Khoa Dang,39,0,80,41
1657484164332,CSE 21,A01,095574,Bach; Quang Tran,22,0,48,26
1657484170366,CSE 30,A01,083084,Eldon; John,5,0,80,75
1657484170366,CSE 30,B01,095061,Bhaskar; Nishant,9,0,50,41
1657484176393,CSE 100,A01,083659,Cao; Yingjun,5,4,70,65
1657484182421,CSE 134B,A01,083661,Powell; Thomas Allan,22,0,100,78
1657484188449,CSE 140,A01,083663,Gungor; Onat,15,0,85,70
1657484194476,CSE 140L,A01,083088,Eldon; John,21,0,100,79
1657484200500,CSE 175,A01,083665,Kumar; Rakesh,3,0,25,22
1657484206534,CSE 190,A00,092507,Dubnov; Shlomo,8,0,20,12
1657484212557,ECE 45,A01,083139,Congero; Spencer William,6,0,75,69
1657484218585,ECE 65,A50,083695,Saad; Andrew S,12,0,30,18
1657484218585,ECE 65,A51,095125,Saad; Andrew S,24,0,26,2
1657484224609,ECE 109,A01,091882,Touri; Behrouz,19,0,70,51
1657484230633,ECE 180,A00,083140,Abi Samra; Nicholas Camill,1,0,30,29
1657484230633,ECE 180,B00,083141,Abi Samra; Nicholas Camill,0,0,30,30
1657484236654,MATH 10A,A01,083735,Patchell; Gregory David,2,0,30,28
1657484236654,MATH 10A,A02,083736,Patchell; Gregory David,20,0,30,10
1657484236654,MATH 10A,A03,083737,Patchell; Gregory David,16,0,30,14
1657484242684,MATH 10B,A01,083207,Lim; Seonhee,8,0,34,26
1657484242684,MATH 10B,A02,083208,Lim; Seonhee,9,0,35,26
1657484242684,MATH 10B,A03,093472,Lim; Seonhee,7,0,34,27
1657484242684,MATH 10B,B01,083739,Sinha; Shubham,12,0,30,18
1657484248709,MATH 18,A01,083743,Cinel; Cameron Alexander,7,0,30,23
1657484248709,MATH 18,A02,083744,Cinel; Cameron Alexander,17,0,30,13
1657484248709,MATH 18,A03,083745,Cinel; Cameron Alexander,9,0,30,21
1657484248709,MATH 18,B01,083748,Rideout; David Porter,5,0,37,32
1657484248709,MATH 18,B02,083749,Rideout; David Porter,5,0,36,31
1657484248709,MATH 18,B03,083750,Rideout; David Porter,3,0,37,34
1657484248709,MATH 18,B04,083751,Rideout; David Porter,6,0,36,30
1657484248709,MATH 18,B05,093473,Rideout; David Porter,6,0,36,30
1657484248709,MATH 18,B06,093474,Rideout; David Porter,6,0,36,30
1657484254738,MATH 20A,A01,083754,Zheng; Zequn,14,0,40,26
1657484260760,MATH 20B,A01,083756,Briones; Jor-el Thomas Caparas,4,0,36,32
1657484260760,MATH 20B,A02,083757,Briones; Jor-el Thomas Caparas,1,0,36,35
1657484260760,MATH 20B,A03,093475,Briones; Jor-el Thomas Caparas,2,0,36,34
1657484266792,MATH 20C,A01,083760,Briones; Jor-el Thomas Caparas,1,0,35,34
1657484266792,MATH 20C,A02,083761,Briones; Jor-el Thomas Caparas,8,0,35,27
1657484266792,MATH 20C,A03,093476,Briones; Jor-el Thomas Caparas,0,1,36,36
1657484266792,MATH 20C,B01,083762,Bach; Quang Tran,1,0,30,29
1657484272822,MATH 20D,A01,083765,Tran; Brian Kha,5,0,30,25
1657484272822,MATH 20D,A02,083766,Tran; Brian Kha,5,0,30,25
1657484272822,MATH 20D,A03,083767,Tran; Brian Kha,5,0,30,25
1657484278847,MATH 20E,A01,083771,Ganguly; Soumya,9,0,32,23
1657484278847,MATH 20E,A02,083772,Ganguly; Soumya,6,0,32,26
1657484278847,MATH 20E,B01,083773,Ciotti; Benjamin,20,0,35,15
1657484278847,MATH 20E,B02,083774,Ciotti; Benjamin,17,0,35,18
1657484284871,MATH 103A,A01,083777,Greenfeld; Be'Eri,3,0,36,33
1657484284871,MATH 103A,A02,083778,Greenfeld; Be'Eri,5,0,36,31
1657484284871,MATH 103A,A03,093561,Greenfeld; Be'Eri,5,0,36,31
1657484284871,MATH 103A,B01,083779,Greenfeld; Be'Eri,7,0,36,29
1657484284871,MATH 103A,B02,083780,Greenfeld; Be'Eri,4,0,36,32
1657484284871,MATH 103A,B03,093562,Greenfeld; Be'Eri,3,0,36,33
1657484290897,MATH 105,A01,085443,Carter; Anne Toulson,15,0,35,20
1657484290897,MATH 105,A02,093477,Carter; Anne Toulson,20,0,35,15
1657484296922,MATH 109,A01,083213,Ganzberger; Geoffrey Michael,2,0,34,32
1657484296922,MATH 109,A02,083214,Ganzberger; Geoffrey Michael,4,0,34,30
1657484296922,MATH 109,A03,093478,Ganzberger; Geoffrey Michael,2,0,34,32
1657484296922,MATH 109,B01,083215,Ganzberger; Geoffrey Michael,1,0,32,31
1657484296922,MATH 109,B02,083216,Ganzberger; Geoffrey Michael,2,0,32,30
1657484296922,MATH 109,B03,093479,Ganzberger; Geoffrey Michael,8,0,32,24
1657484302949,MATH 142A,A01,083219,Chow; Bennett,7,0,32,25
1657484302949,MATH 142A,A02,083220,Chow; Bennett,10,0,32,22
1657484302949,MATH 142A,A03,093480,Chow; Bennett,8,0,32,24
1657484302949,MATH 142A,B03,093481,Chow; Bennett,8,0,32,24
1657484302949,MATH 142A,B04,093558,Chow; Bennett,13,0,32,19
1657484302949,MATH 142A,B05,093559,Chow; Bennett,6,0,32,26
1657484308973,MATH 193A,A01,083224,Rotar; Vladimir,8,0,34,26
1657484308973,MATH 193A,A02,083225,Rotar; Vladimir,9,0,34,25
1657484308973,MATH 193A,A03,083781,Rotar; Vladimir,5,0,34,29
1657484308973,MATH 193A,A04,083782,Rotar; Vladimir,10,0,34,24
1657484308973,MATH 193A,A05,093482,Rotar; Vladimir,10,0,34,24
1657484314999,MATH 197,001,091859,McAuley; Julian John,9999,0,9999,0
1657484314999,MATH 197,002,095566,Kedlaya; Kiran S.,9997,0,9999,2
1657484314999,MATH 197,003,095567,Xiao; Ming,9999,0,9999,0
1657484314999,MATH 197,004,095571,Perols; Johan Lars,9998,0,9999,1
1657484322049,COGS 9,A01,083615,Shannon; Kyle Michael,9,0,75,66
1657484328074,COGS 11,A01,083617,Boyle; Mary E. T.,22,0,48,26
1657484334099,COGS 13,A01,083071,Bastos; Amalia Pinkusfeld,11,0,71,60
1657484340126,COGS 14A,A01,092681,Semenuks; Arturs,5,1,100,95
1657484346151,COGS 14B,A01,083073,Cheng; Tzu-Han,6,0,63,57
1657484352177,COGS 17,A01,092677,Semenuks; Arturs,6,0,81,75
1657484358203,COGS 100,A01,083619,Allen; Michael Gordon,17,0,70,53
1657484364226,COGS 101A,A01,083621,Davis; Joshua Daniel,9,0,68,59
1657484370250,COGS 101B,A01,091572,Allen; Michael Gordon,12,0,65,53
1657484376274,COGS 101C,A01,083625,Delgado; Tania,17,0,35,18
1657484382298,COGS 107A,A01,083627,Boyle; Mary E. T.,13,0,60,47
1657484388324,COGS 118A,A01,083075,Gupta; Anjum,21,0,76,55
1657484394348,CSE 3,A50,083646,Miranda; Gregory Joseph,24,0,50,26
1657484400373,CSE 8A,A50,083650,Miranda; Gregory Joseph,17,1,56,39
1657484406396,CSE 11,A01,083080,Cao; Yingjun,6,15,40,34
1657484412422,CSE 12,A01,083652,Krause-Levy; Sophia Louisa,28,1,120,92
1657484418459,CSE 15L,A01,083654,Morris; Justin Loren,9,0,50,41
1657484418459,CSE 15L,A02,083655,Morris; Justin Loren,9,0,50,41
1657484424483,CSE 20,A01,083657,Tran; Khoa Dang,39,0,80,41
1657484430507,CSE 21,A01,095574,Bach; Quang Tran,22,0,48,26
1657484436532,CSE 30,A01,083084,Eldon; John,5,0,80,75
1657484436532,CSE 30,B01,095061,Bhaskar; Nishant,9,0,50,41
1657484442566,CSE 100,A01,083659,Cao; Yingjun,5,4,70,65
1657484448592,CSE 134B,A01,083661,Powell; Thomas Allan,22,0,100,78
1657484454619,CSE 140,A01,083663,Gungor; Onat,15,0,85,70
1657484460642,CSE 140L,A01,083088,Eldon; John,21,0,100,79
1657484466673,CSE 175,A01,083665,Kumar; Rakesh,3,0,25,22
1657484472697,CSE 190,A00,092507,Dubnov; Shlomo,8,0,20,12
1657484478722,ECE 45,A01,083139,Congero; Spencer William,6,0,75,69
1657484484750,ECE 65,A50,083695,Saad; Andrew S,12,0,30,18
1657484484750,ECE 65,A51,095125,Saad; Andrew S,24,0,26,2
1657484490775,ECE 109,A01,091882,Touri; Behrouz,19,0,70,51
1657484496801,ECE 180,A00,083140,Abi Samra; Nicholas Camill,1,0,30,29
1657484496801,ECE 180,B00,083141,Abi Samra; Nicholas Camill,0,0,30,30
1657484502846,MATH 10A,A01,083735,Patchell; Gregory David,2,0,30,28
1657484502846,MATH 10A,A02,083736,Patchell; Gregory David,20,0,30,10
1657484502846,MATH 10A,A03,083737,Patchell; Gregory David,16,0,30,14
1657484508874,MATH 10B,A01,083207,Lim; Seonhee,8,0,34,26
1657484508874,MATH 10B,A02,083208,Lim; Seonhee,9,0,35,26
1657484508874,MATH 10B,A03,093472,Lim; Seonhee,7,0,34,27
1657484508874,MATH 10B,B01,083739,Sinha; Shubham,12,0,30,18
1657484514909,MATH 18,A01,083743,Cinel; Cameron Alexander,7,0,30,23
1657484514909,MATH 18,A02,083744,Cinel; Cameron Alexander,17,0,30,13
1657484514909,MATH 18,A03,083745,Cinel; Cameron Alexander,9,0,30,21
1657484514909,MATH 18,B01,083748,Rideout; David Porter,5,0,37,32
1657484514909,MATH 18,B02,083749,Rideout; David Porter,5,0,36,31
1657484514909,MATH 18,B03,083750,Rideout; David Porter,3,0,37,34
1657484514909,MATH 18,B04,083751,Rideout; David Porter,6,0,36,30
1657484514909,MATH 18,B05,093473,Rideout; David Porter,6,0,36,30
1657484514909,MATH 18,B06,093474,Rideout; David Porter,6,0,36,30
1657484520930,MATH 20A,A01,083754,Zheng; Zequn,14,0,40,26
1657484526959,MATH 20B,A01,083756,Briones; Jor-el Thomas Caparas,4,0,36,32
1657484526959,MATH 20B,A02,083757,Briones; Jor-el Thomas Caparas,1,0,36,35
1657484526959,MATH 20B,A03,093475,Briones; Jor-el Thomas Caparas,2,0,36,34
1657484532995,MATH 20C,A01,083760,Briones; Jor-el Thomas Caparas,1,0,35,34
1657484532995,MATH 20C,A02,083761,Briones; Jor-el Thomas Caparas,8,0,35,27
1657484532995,MATH 20C,A03,093476,Briones; Jor-el Thomas Caparas,0,1,36,36
1657484532995,MATH 20C,B01,083762,Bach; Quang Tran,1,0,30,29
1657484539042,MATH 20D,A01,083765,Tran; Brian Kha,5,0,30,25
1657484539042,MATH 20D,A02,083766,Tran; Brian Kha,5,0,30,25
1657484539042,MATH 20D,A03,083767,Tran; Brian Kha,5,0,30,25
1657484545070,MATH 20E,A01,083771,Ganguly; Soumya,9,0,32,23
1657484545070,MATH 20E,A02,083772,Ganguly; Soumya,6,0,32,26
1657484545070,MATH 20E,B01,083773,Ciotti; Benjamin,20,0,35,15
1657484545070,MATH 20E,B02,083774,Ciotti; Benjamin,17,0,35,18
1657484551100,MATH 103A,A01,083777,Greenfeld; Be'Eri,3,0,36,33
1657484551100,MATH 103A,A02,083778,Greenfeld; Be'Eri,5,0,36,31
1657484551100,MATH 103A,A03,093561,Greenfeld; Be'Eri,5,0,36,31
1657484551100,MATH 103A,B01,083779,Greenfeld; Be'Eri,7,0,36,29
1657484551100,MATH 103A,B02,083780,Greenfeld; Be'Eri,4,0,36,32
1657484551100,MATH 103A,B03,093562,Greenfeld; Be'Eri,3,0,36,33
1657484557121,MATH 105,A01,085443,Carter; Anne Toulson,15,0,35,20
1657484557121,MATH 105,A02,093477,Carter; Anne Toulson,20,0,35,15
1657484563144,MATH 109,A01,083213,Ganzberger; Geoffrey Michael,2,0,34,32
1657484563144,MATH 109,A02,083214,Ganzberger; Geoffrey Michael,4,0,34,30
1657484563144,MATH 109,A03,093478,Ganzberger; Geoffrey Michael,2,0,34,32
1657484563144,MATH 109,B01,083215,Ganzberger; Geoffrey Michael,1,0,32,31
1657484563144,MATH 109,B02,083216,Ganzberger; Geoffrey Michael,2,0,32,30
1657484563144,MATH 109,B03,093479,Ganzberger; Geoffrey Michael,8,0,32,24
1657484569172,MATH 142A,A01,083219,Chow; Bennett,7,0,32,25
1657484569172,MATH 142A,A02,083220,Chow; Bennett,10,0,32,22
1657484569172,MATH 142A,A03,093480,Chow; Bennett,8,0,32,24
1657484569172,MATH 142A,B03,093481,Chow; Bennett,8,0,32,24
1657484569172,MATH 142A,B04,093558,Chow; Bennett,13,0,32,19
1657484569172,MATH 142A,B05,093559,Chow; Bennett,6,0,32,26
1657484575199,MATH 193A,A01,083224,Rotar; Vladimir,8,0,34,26
1657484575199,MATH 193A,A02,083225,Rotar; Vladimir,9,0,34,25
1657484575199,MATH 193A,A03,083781,Rotar; Vladimir,5,0,34,29
1657484575199,MATH 193A,A04,083782,Rotar; Vladimir,10,0,34,24
1657484575199,MATH 193A,A05,093482,Rotar; Vladimir,10,0,34,24
1657484581222,MATH 197,001,091859,McAuley; Julian John,9999,0,9999,0
1657484581222,MATH 197,002,095566,Kedlaya; Kiran S.,9997,0,9999,2
1657484581222,MATH 197,003,095567,Xiao; Ming,9999,0,9999,0
1657484581222,MATH 197,004,095571,Perols; Johan Lars,9998,0,9999,1
1657484588280,COGS 9,A01,083615,Shannon; Kyle Michael,9,0,75,66
1657484594302,COGS 11,A01,083617,Boyle; Mary E. T.,22,0,48,26
1657484600328,COGS 13,A01,083071,Bastos; Amalia Pinkusfeld,11,0,71,60
1657484606350,COGS 14A,A01,092681,Semenuks; Arturs,5,1,100,95
1657484612379,COGS 14B,A01,083073,Cheng; Tzu-Han,6,0,63,57
1657484618499,COGS 17,A01,092677,Semenuks; Arturs,6,0,81,75
1657484624520,COGS 100,A01,083619,Allen; Michael Gordon,17,0,70,53
1657484630547,COGS 101A,A01,083621,Davis; Joshua Daniel,9,0,68,59
1657484636574,COGS 101B,A01,091572,Allen; Michael Gordon,12,0,65,53
1657484642598,COGS 101C,A01,083625,Delgado; Tania,17,0,35,18
1657484648625,COGS 107A,A01,083627,Boyle; Mary E. T.,13,0,60,47
1657484654649,COGS 118A,A01,083075,Gupta; Anjum,21,0,76,55
1657484660672,CSE 3,A50,083646,Miranda; Gregory Joseph,24,0,50,26
1657484666696,CSE 8A,A50,083650,Miranda; Gregory Joseph,17,1,56,39
1657484672720,CSE 11,A01,083080,Cao; Yingjun,6,15,40,34
1657484678747,CSE 12,A01,083652,Krause-Levy; Sophia Louisa,28,1,120,92
1657484684776,CSE 15L,A01,083654,Morris; Justin Loren,9,0,50,41
1657484684776,CSE 15L,A02,083655,Morris; Justin Loren,9,0,50,41
1657484690798,CSE 20,A01,083657,Tran; Khoa Dang,39,0,80,41
1657484696821,CSE 21,A01,095574,Bach; Quang Tran,22,0,48,26
1657484702849,CSE 30,A01,083084,Eldon; John,5,0,80,75
1657484702849,CSE 30,B01,095061,Bhaskar; Nishant,9,0,50,41
1657484708875,CSE 100,A01,083659,Cao; Yingjun,5,4,70,65
1657484714898,CSE 134B,A01,083661,Powell; Thomas Allan,22,0,100,78
1657484720920,CSE 140,A01,083663,Gungor; Onat,15,0,85,70
1657484726957,CSE 140L,A01,083088,Eldon; John,21,0,100,79
1657484732983,CSE 175,A01,083665,Kumar; Rakesh,3,0,25,22
1657484739006,CSE 190,A00,092507,Dubnov; Shlomo,8,0,20,12
1657484745033,ECE 45,A01,083139,Congero; Spencer William,6,0,75,69
1657484751060,ECE 65,A50,083695,Saad; Andrew S,12,0,30,18
1657484751060,ECE 65,A51,095125,Saad; Andrew S,24,0,26,2
1657484757105,ECE 109,A01,091882,Touri; Behrouz,19,0,70,51
1657484763130,ECE 180,A00,083140,Abi Samra; Nicholas Camill,1,0,30,29
1657484763130,ECE 180,B00,083141,Abi Samra; Nicholas Camill,0,0,30,30
1657484769152,MATH 10A,A01,083735,Patchell; Gregory David,2,0,30,28
1657484769152,MATH 10A,A02,083736,Patchell; Gregory David,20,0,30,10
1657484769152,MATH 10A,A03,083737,Patchell; Gregory David,16,0,30,14
1657484775192,MATH 10B,A01,083207,Lim; Seonhee,8,0,34,26
1657484775192,MATH 10B,A02,083208,Lim; Seonhee,9,0,35,26
1657484775192,MATH 10B,A03,093472,Lim; Seonhee,7,0,34,27
1657484775192,MATH 10B,B01,083739,Sinha; Shubham,12,0,30,18
1657484781215,MATH 18,A01,083743,Cinel; Cameron Alexander,7,0,30,23
1657484781215,MATH 18,A02,083744,Cinel; Cameron Alexander,17,0,30,13
1657484781215,MATH 18,A03,083745,Cinel; Cameron Alexander,9,0,30,21
1657484781215,MATH 18,B01,083748,Rideout; David Porter,5,0,37,32
1657484781215,MATH 18,B02,083749,Rideout; David Porter,5,0,36,31
1657484781215,MATH 18,B03,083750,Rideout; David Porter,3,0,37,34
1657484781215,MATH 18,B04,083751,Rideout; David Porter,6,0,36,30
1657484781215,MATH 18,B05,093473,Rideout; David Porter,6,0,36,30
1657484781215,MATH 18,B06,093474,Rideout; David Porter,6,0,36,30
1657484787241,MATH 20A,A01,083754,Zheng; Zequn,14,0,40,26
1657484793265,MATH 20B,A01,083756,Briones; Jor-el Thomas Caparas,4,0,36,32
1657484793265,MATH 20B,A02,083757,Briones; Jor-el Thomas Caparas,1,0,36,35
1657484793265,MATH 20B,A03,093475,Briones; Jor-el Thomas Caparas,2,0,36,34
1657484799288,MATH 20C,A01,083760,Briones; Jor-el Thomas Caparas,1,0,35,34
1657484799288,MATH 20C,A02,083761,Briones; Jor-el Thomas Caparas,8,0,35,27
1657484799288,MATH 20C,A03,093476,Briones; Jor-el Thomas Caparas,0,1,36,36
1657484799288,MATH 20C,B01,083762,Bach; Quang Tran,1,0,30,29
1657484805322,MATH 20D,A01,083765,Tran; Brian Kha,5,0,30,25
1657484805322,MATH 20D,A02,083766,Tran; Brian Kha,5,0,30,25
1657484805322,MATH 20D,A03,083767,Tran; Brian Kha,5,0,30,25
1657484811347,MATH 20E,A01,083771,Ganguly; Soumya,9,0,32,23
1657484811347,MATH 20E,A02,083772,Ganguly; Soumya,6,0,32,26
1657484811347,MATH 20E,B01,083773,Ciotti; Benjamin,20,0,35,15
1657484811347,MATH 20E,B02,083774,Ciotti; Benjamin,17,0,35,18
1657484817370,MATH 103A,A01,083777,Greenfeld; Be'Eri,3,0,36,33
1657484817370,MATH 103A,A02,083778,Greenfeld; Be'Eri,5,0,36,31
1657484817370,MATH 103A,A03,093561,Greenfeld; Be'Eri,5,0,36,31
1657484817370,MATH 103A,B01,083779,Greenfeld; Be'Eri,7,0,36,29
1657484817370,MATH 103A,B02,083780,Greenfeld; Be'Eri,4,0,36,32
1657484817370,MATH 103A,B03,093562,Greenfeld; Be'Eri,3,0,36,33
1657484823398,MATH 105,A01,085443,Carter; Anne Toulson,15,0,35,20
1657484823398,MATH 105,A02,093477,Carter; Anne Toulson,20,0,35,15
1657484829422,MATH 109,A01,083213,Ganzberger; Geoffrey Michael,2,0,34,32
1657484829422,MATH 109,A02,083214,Ganzberger; Geoffrey Michael,4,0,34,30
1657484829422,MATH 109,A03,093478,Ganzberger; Geoffrey Michael,2,0,34,32
1657484829422,MATH 109,B01,083215,Ganzberger; Geoffrey Michael,1,0,32,31
1657484829422,MATH 109,B02,083216,Ganzberger; Geoffrey Michael,2,0,32,30
1657484829422,MATH 109,B03,093479,Ganzberger; Geoffrey Michael,8,0,32,24
1657484835445,MATH 142A,A01,083219,Chow; Bennett,7,0,32,25
1657484835445,MATH 142A,A02,083220,Chow; Bennett,10,0,32,22
1657484835445,MATH 142A,A03,093480,Chow; Bennett,8,0,32,24
1657484835445,MATH 142A,B03,093481,Chow; Bennett,8,0,32,24
1657484835445,MATH 142A,B04,093558,Chow; Bennett,13,0,32,19
1657484835445,MATH 142A,B05,093559,Chow; Bennett,6,0,32,26
1657484841480,MATH 193A,A01,083224,Rotar; Vladimir,8,0,34,26
1657484841480,MATH 193A,A02,083225,Rotar; Vladimir,9,0,34,25
1657484841480,MATH 193A,A03,083781,Rotar; Vladimir,5,0,34,29
1657484841480,MATH 193A,A04,083782,Rotar; Vladimir,10,0,34,24
1657484841480,MATH 193A,A05,093482,Rotar; Vladimir,10,0,34,24
1657484847505,MATH 197,001,091859,McAuley; Julian John,9999,0,9999,0
1657484847505,MATH 197,002,095566,Kedlaya; Kiran S.,9997,0,9999,2
1657484847505,MATH 197,003,095567,Xiao; Ming,9999,0,9999,0
1657484847505,MATH 197,004,095571,Perols; Johan Lars,9998,0,9999,1
1657484854561,COGS 9,A01,083615,Shannon; Kyle Michael,9,0,75,66
1657484860585,COGS 11,A01,083617,Boyle; Mary E. T.,22,0,48,26
1657484866608,COGS 13,A01,083071,Bastos; Amalia Pinkusfeld,11,0,71,60
1657484872631,COGS 14A,A01,092681,Semenuks; Arturs,5,1,100,95
1657484878654,COGS 14B,A01,083073,Cheng; Tzu-Han,6,0,63,57
1657484884677,COGS 17,A01,092677,Semenuks; Arturs,6,0,81,75
1657484890703,COGS 100,A01,083619,Allen; Michael Gordon,17,0,70,53
1657484896730,COGS 101A,A01,083621,Davis; Joshua Daniel,9,0,68,59
1657484902756,COGS 101B,A01,091572,Allen; Michael Gordon,12,0,65,53
1657484908783,COGS 101C,A01,083625,Delgado; Tania,17,0,35,18
1657484914804,COGS 107A,A01,083627,Boyle; Mary E. T.,13,0,60,47
1657484920833,COGS 118A,A01,083075,Gupta; Anjum,21,0,76,55
1657484926861,CSE 3,A50,083646,Miranda; Gregory Joseph,24,0,50,26
1657484932888,CSE 8A,A50,083650,Miranda; Gregory Joseph,17,1,56,39
1657484938910,CSE 11,A01,083080,Cao; Yingjun,6,15,40,34
1657484944937,CSE 12,A01,083652,Krause-Levy; Sophia Louisa,28,1,120,92
1657484950964,CSE 15L,A01,083654,Morris; Justin Loren,9,0,50,41
1657484950964,CSE 15L,A02,083655,Morris; Justin Loren,9,0,50,41
1657484956989,CSE 20,A01,083657,Tran; Khoa Dang,39,0,80,41
1657484963015,CSE 21,A01,095574,Bach; Quang Tran,22,0,48,26
1657484969039,CSE 30,A01,083084,Eldon; John,5,0,80,75
1657484969039,CSE 30,B01,095061,Bhaskar; Nishant,9,0,50,41
1657484975063,CSE 100,A01,083659,Cao; Yingjun,5,4,70,65
1657484981090,CSE 134B,A01,083661,Powell; Thomas Allan,22,0,100,78
1657484987114,CSE 140,A01,083663,Gungor; Onat,15,0,85,70
1657484993138,CSE 140L,A01,083088,Eldon; John,21,0,100,79
1657484999161,CSE 175,A01,083665,Kumar; Rakesh,3,0,25,22
1657485005188,CSE 190,A00,092507,Dubnov; Shlomo,8,0,20,12
1657485011212,ECE 45,A01,083139,Congero; Spencer William,6,0,75,69
1657485017240,ECE 65,A50,083695,Saad; Andrew S,12,0,30,18
1657485017240,ECE 65,A51,095125,Saad; Andrew S,24,0,26,2
1657485023266,ECE 109,A01,091882,Touri; Behrouz,19,0,70,51
1657485029288,ECE 180,A00,083140,Abi Samra; Nicholas Camill,1,0,30,29
1657485029288,ECE 180,B00,083141,Abi Samra; Nicholas Camill,0,0,30,30
1657485035312,MATH 10A,A01,083735,Patchell; Gregory David,2,0,30,28
1657485035312,MATH 10A,A02,083736,Patchell; Gregory David,20,0,30,10
1657485035312,MATH 10A,A03,083737,Patchell; Gregory David,16,0,30,14
1657485041335,MATH 10B,A01,083207,Lim; Seonhee,8,0,34,26
1657485041335,MATH 10B,A02,083208,Lim; Seonhee,9,0,35,26
1657485041335,MATH 10B,A03,093472,Lim; Seonhee,7,0,34,27
1657485041335,MATH 10B,B01,083739,Sinha; Shubham,12,0,30,18
1657485047359,MATH 18,A01,083743,Cinel; Cameron Alexander,7,0,30,23
1657485047359,MATH 18,A02,083744,Cinel; Cameron Alexander,17,0,30,13
1657485047359,MATH 18,A03,083745,Cinel; Cameron Alexander,9,0,30,21
1657485047359,MATH 18,B01,083748,Rideout; David Porter,5,0,37,32
1657485047359,MATH 18,B02,083749,Rideout; David Porter,5,0,36,31
1657485047359,MATH 18,B03,083750,Rideout; David Porter,3,0,37,34
1657485047359,MATH 18,B04,083751,Rideout; David Porter,6,0,36,30
1657485047359,MATH 18,B05,093473,Rideout; David Porter,6,0,36,30
1657485047359,MATH 18,B06,093474,Rideout; David Porter,6,0,36,30
1657485053381,MATH 20A,A01,083754,Zheng; Zequn,14,0,40,26
1657485059408,MATH 20B,A01,083756,Briones; Jor-el Thomas Caparas,4,0,36,32
1657485059408,MATH 20B,A02,083757,Briones; Jor-el Thomas Caparas,1,0,36,35
1657485059408,MATH 20B,A03,093475,Briones; Jor-el Thomas Caparas,2,0,36,34
1657485065432,MATH 20C,A01,083760,Briones; Jor-el Thomas Caparas,1,0,35,34
1657485065432,MATH 20C,A02,083761,Briones; Jor-el Thomas Caparas,8,0,35,27
1657485065432,MATH 20C,A03,093476,Briones; Jor-el Thomas Caparas,0,1,36,36
1657485065432,MATH 20C,B01,083762,Bach; Quang Tran,1,0,30,29
1657485071459,MATH 20D,A01,083765,Tran; Brian Kha,5,0,30,25
1657485071459,MATH 20D,A02,083766,Tran; Brian Kha,5,0,30,25
1657485071459,MATH 20D,A03,083767,Tran; Brian Kha,5,0,30,25
1657485077485,MATH 20E,A01,083771,Ganguly; Soumya,9,0,32,23
1657485077485,MATH 20E,A02,083772,Ganguly; Soumya,6,0,32,26
1657485077485,MATH 20E,B01,083773,Ciotti; Benjamin,20,0,35,15
1657485077485,MATH 20E,B02,083774,Ciotti; Benjamin,17,0,35,18
1657485083514,MATH 103A,A01,083777,Greenfeld; Be'Eri,3,0,36,33
1657485083514,MATH 103A,A02,083778,Greenfeld; Be'Eri,5,0,36,31
1657485083514,MATH 103A,A03,093561,Greenfeld; Be'Eri,5,0,36,31
1657485083514,MATH 103A,B01,083779,Greenfeld; Be'Eri,7,0,36,29
1657485083514,MATH 103A,B02,083780,Greenfeld; Be'Eri,4,0,36,32
1657485083514,MATH 103A,B03,093562,Greenfeld; Be'Eri,3,0,36,33
1657485089538,MATH 105,A01,085443,Carter; Anne Toulson,15,0,35,20
1657485089538,MATH 105,A02,093477,Carter; Anne Toulson,20,0,35,15
1657485095561,MATH 109,A01,083213,Ganzberger; Geoffrey Michael,2,0,34,32
1657485095561,MATH 109,A02,083214,Ganzberger; Geoffrey Michael,4,0,34,30
1657485095561,MATH 109,A03,093478,Ganzberger; Geoffrey Michael,2,0,34,32
1657485095561,MATH 109,B01,083215,Ganzberger; Geoffrey Michael,1,0,32,31
1657485095561,MATH 109,B02,083216,Ganzberger; Geoffrey Michael,2,0,32,30
1657485095561,MATH 109,B03,093479,Ganzberger; Geoffrey Michael,8,0,32,24
1657485101589,MATH 142A,A01,083219,Chow; Bennett,7,0,32,25
1657485101589,MATH 142A,A02,083220,Chow; Bennett,10,0,32,22
1657485101589,MATH 142A,A03,093480,Chow; Bennett,8,0,32,24
1657485101589,MATH 142A,B03,093481,Chow; Bennett,8,0,32,24
1657485101589,MATH 142A,B04,093558,Chow; Bennett,13,0,32,19
1657485101589,MATH 142A,B05,093559,Chow; Bennett,6,0,32,26
1657485107618,MATH 193A,A01,083224,Rotar; Vladimir,8,0,34,26
1657485107618,MATH 193A,A02,083225,Rotar; Vladimir,9,0,34,25
1657485107618,MATH 193A,A03,083781,Rotar; Vladimir,5,0,34,29
1657485107618,MATH 193A,A04,083782,Rotar; Vladimir,10,0,34,24
1657485107618,MATH 193A,A05,093482,Rotar; Vladimir,10,0,34,24
1657485113644,MATH 197,001,091859,McAuley; Julian John,9999,0,9999,0
1657485113644,MATH 197,002,095566,Kedlaya; Kiran S.,9997,0,9999,2
1657485113644,MATH 197,003,095567,Xiao; Ming,9999,0,9999,0
1657485113644,MATH 197,004,095571,Perols; Johan Lars,9998,0,9999,1
1657485120694,COGS 9,A01,083615,Shannon; Kyle Michael,9,0,75,66
1657485126721,COGS 11,A01,083617,Boyle; Mary E. T.,22,0,48,26
1657485132744,COGS 13,A01,083071,Bastos; Amalia Pinkusfeld,11,0,71,60
1657485138768,COGS 14A,A01,092681,Semenuks; Arturs,5,1,100,95
1657485144791,COGS 14B,A01,083073,Cheng; Tzu-Han,6,0,63,57
1657485150814,COGS 17,A01,092677,Semenuks; Arturs,6,0,81,75
1657485156841,COGS 100,A01,083619,Allen; Michael Gordon,17,0,70,53
1657485162867,COGS 101A,A01,083621,Davis; Joshua Daniel,9,0,68,59
1657485168891,COGS 101B,A01,091572,Allen; Michael Gordon,12,0,65,53
1657485174914,COGS 101C,A01,083625,Delgado; Tania,17,0,35,18
1657485180938,COGS 107A,A01,083627,Boyle; Mary E. T.,13,0,60,47
1657485186963,COGS 118A,A01,083075,Gupta; Anjum,21,0,76,55
1657485192986,CSE 3,A50,083646,Miranda; Gregory Joseph,24,0,50,26
1657485199016,CSE 8A,A50,083650,Miranda; Gregory Joseph,17,1,56,39
1657485205037,CSE 11,A01,083080,Cao; Yingjun,6,15,40,34
1657485211060,CSE 12,A01,083652,Krause-Levy; Sophia Louisa,28,1,120,92
1657485217152,CSE 15L,A01,083654,Morris; Justin Loren,9,0,50,41
1657485217152,CSE 15L,A02,083655,Morris; Justin Loren,9,0,50,41
1657485223177,CSE 20,A01,083657,Tran; Khoa Dang,39,0,80,41
1657485229201,CSE 21,A01,095574,Bach; Quang Tran,22,0,48,26
1657485235225,CSE 30,A01,083084,Eldon; John,5,0,80,75
1657485235225,CSE 30,B01,095061,Bhaskar; Nishant,9,0,50,41
1657485241247,CSE 100,A01,083659,Cao; Yingjun,5,4,70,65
1657485247275,CSE 134B,A01,083661,Powell; Thomas Allan,22,0,100,78
1657485253299,CSE 140,A01,083663,Gungor; Onat,15,0,85,70
1657485259324,CSE 140L,A01,083088,Eldon; John,21,0,100,79
1657485265348,CSE 175,A01,083665,Kumar; Rakesh,3,0,25,22
1657485271374,CSE 190,A00,092507,Dubnov; Shlomo,8,0,20,12
1657485277397,ECE 45,A01,083139,Congero; Spencer William,6,0,75,69
1657485283420,ECE 65,A50,083695,Saad; Andrew S,12,0,30,18
1657485283420,ECE 65,A51,095125,Saad; Andrew S,24,0,26,2
1657485289444,ECE 109,A01,091882,Touri; Behrouz,19,0,70,51
1657485295467,ECE 180,A00,083140,Abi Samra; Nicholas Camill,1,0,30,29
1657485295467,ECE 180,B00,083141,Abi Samra; Nicholas Camill,0,0,30,30
1657485301492,MATH 10A,A01,083735,Patchell; Gregory David,2,0,30,28
1657485301492,MATH 10A,A02,083736,Patchell; Gregory David,20,0,30,10
1657485301492,MATH 10A,A03,083737,Patchell; Gregory David,16,0,30,14
1657485307519,MATH 10B,A01,083207,Lim; Seonhee,8,0,34,26
1657485307519,MATH 10B,A02,083208,Lim; Seonhee,9,0,35,26
1657485307519,MATH 10B,A03,093472,Lim; Seonhee,7,0,34,27
1657485307519,MATH 10B,B01,083739,Sinha; Shubham,12,0,30,18
1657485313545,MATH 18,A01,083743,Cinel; Cameron Alexander,7,0,30,23
1657485313545,MATH 18,A02,083744,Cinel; Cameron Alexander,17,0,30,13
1657485313545,MATH 18,A03,083745,Cinel; Cameron Alexander,9,0,30,21
1657485313545,MATH 18,B01,083748,Rideout; David Porter,5,0,37,32
1657485313545,MATH 18,B02,083749,Rideout; David Porter,5,0,36,31
1657485313545,MATH 18,B03,083750,Rideout; David Porter,3,0,37,34
1657485313545,MATH 18,B04,083751,Rideout; David Porter,6,0,36,30
1657485313545,MATH 18,B05,093473,Rideout; David Porter,6,0,36,30
1657485313545,MATH 18,B06,093474,Rideout; David Porter,6,0,36,30
1657485319572,MATH 20A,A01,083754,Zheng; Zequn,14,0,40,26
1657485325595,MATH 20B,A01,083756,Briones; Jor-el Thomas Caparas,4,0,36,32
1657485325595,MATH 20B,A02,083757,Briones; Jor-el Thomas Caparas,1,0,36,35
1657485325595,MATH 20B,A03,093475,Briones; Jor-el Thomas Caparas,2,0,36,34
1657485331619,MATH 20C,A01,083760,Briones; Jor-el Thomas Caparas,1,0,35,34
1657485331619,MATH 20C,A02,083761,Briones; Jor-el Thomas Caparas,8,0,35,27
1657485331619,MATH 20C,A03,093476,Briones; Jor-el Thomas Caparas,0,1,36,36
1657485331619,MATH 20C,B01,083762,Bach; Quang Tran,1,0,30,29
1657485337645,MATH 20D,A01,083765,Tran; Brian Kha,5,0,30,25
1657485337645,MATH 20D,A02,083766,Tran; Brian Kha,5,0,30,25
1657485337645,MATH 20D,A03,083767,Tran; Brian Kha,5,0,30,25
1657485343669,MATH 20E,A01,083771,Ganguly; Soumya,9,0,32,23
1657485343669,MATH 20E,A02,083772,Ganguly; Soumya,6,0,32,26
1657485343669,MATH 20E,B01,083773,Ciotti; Benjamin,20,0,35,15
1657485343669,MATH 20E,B02,083774,Ciotti; Benjamin,17,0,35,18
1657485349691,MATH 103A,A01,083777,Greenfeld; Be'Eri,3,0,36,33
1657485349691,MATH 103A,A02,083778,Greenfeld; Be'Eri,5,0,36,31
1657485349691,MATH 103A,A03,093561,Greenfeld; Be'Eri,5,0,36,31
1657485349691,MATH 103A,B01,083779,Greenfeld; Be'Eri,7,0,36,29
1657485349691,MATH 103A,B02,083780,Greenfeld; Be'Eri,4,0,36,32
1657485349691,MATH 103A,B03,093562,Greenfeld; Be'Eri,3,0,36,33
1657485355713,MATH 105,A01,085443,Carter; Anne Toulson,15,0,35,20
1657485355713,MATH 105,A02,093477,Carter; Anne Toulson,20,0,35,15
1657485361740,MATH 109,A01,083213,Ganzberger; Geoffrey Michael,2,0,34,32
1657485361740,MATH 109,A02,083214,Ganzberger; Geoffrey Michael,4,0,34,30
1657485361740,MATH 109,A03,093478,Ganzberger; Geoffrey Michael,2,0,34,32
1657485361740,MATH 109,B01,083215,Ganzberger; Geoffrey Michael,1,0,32,31
1657485361740,MATH 109,B02,083216,Ganzberger; Geoffrey Michael,2,0,32,30
1657485361740,MATH 109,B03,093479,Ganzberger; Geoffrey Michael,8,0,32,24
1657485367763,MATH 142A,A01,083219,Chow; Bennett,7,0,32,25
1657485367763,MATH 142A,A02,083220,Chow; Bennett,10,0,32,22
1657485367763,MATH 142A,A03,093480,Chow; Bennett,8,0,32,24
1657485367763,MATH 142A,B03,093481,Chow; Bennett,8,0,32,24
1657485367763,MATH 142A,B04,093558,Chow; Bennett,13,0,32,19
1657485367763,MATH 142A,B05,093559,Chow; Bennett,6,0,32,26
1657485373787,MATH 193A,A01,083224,Rotar; Vladimir,8,0,34,26
1657485373787,MATH 193A,A02,083225,Rotar; Vladimir,9,0,34,25
1657485373787,MATH 193A,A03,083781,Rotar; Vladimir,5,0,34,29
1657485373787,MATH 193A,A04,083782,Rotar; Vladimir,10,0,34,24
1657485373787,MATH 193A,A05,093482,Rotar; Vladimir,10,0,34,24
1657485379812,MATH 197,001,091859,McAuley; Julian John,9999,0,9999,0
1657485379812,MATH 197,002,095566,Kedlaya; Kiran S.,9997,0,9999,2
1657485379812,MATH 197,003,095567,Xiao; Ming,9999,0,9999,0
1657485379812,MATH 197,004,095571,Perols; Johan Lars,9998,0,9999,1
1657485386863,COGS 9,A01,083615,Shannon; Kyle Michael,9,0,75,66
1657485392892,COGS 11,A01,083617,Boyle; Mary E. T.,22,0,48,26
1657485398919,COGS 13,A01,083071,Bastos; Amalia Pinkusfeld,11,0,71,60
1657485404944,COGS 14A,A01,092681,Semenuks; Arturs,5,1,100,95
1657485410967,COGS 14B,A01,083073,Cheng; Tzu-Han,6,0,63,57
1657485416995,COGS 17,A01,092677,Semenuks; Arturs,6,0,81,75
1657485423019,COGS 100,A01,083619,Allen; Michael Gordon,17,0,70,53
1657485429043,COGS 101A,A01,083621,Davis; Joshua Daniel,9,0,68,59
1657485435065,COGS 101B,A01,091572,Allen; Michael Gordon,12,0,65,53
1657485441097,COGS 101C,A01,083625,Delgado; Tania,17,0,35,18
1657485447123,COGS 107A,A01,083627,Boyle; Mary E. T.,13,0,60,47
1657485453150,COGS 118A,A01,083075,Gupta; Anjum,21,0,76,55
1657485459175,CSE 3,A50,083646,Miranda; Gregory Joseph,24,0,50,26
1657485465203,CSE 8A,A50,083650,Miranda; Gregory Joseph,17,1,56,39
1657485471226,CSE 11,A01,083080,Cao; Yingjun,6,15,40,34
1657485477259,CSE 12,A01,083652,Krause-Levy; Sophia Louisa,28,1,120,92
1657485483284,CSE 15L,A01,083654,Morris; Justin Loren,9,0,50,41
1657485483284,CSE 15L,A02,083655,Morris; Justin Loren,9,0,50,41
1657485489316,CSE 20,A01,083657,Tran; Khoa Dang,39,0,80,41
1657485495344,CSE 21,A01,095574,Bach; Quang Tran,22,0,48,26
1657485501370,CSE 30,A01,083084,Eldon; John,5,0,80,75
1657485501370,CSE 30,B01,095061,Bhaskar; Nishant,9,0,50,41
1657485507392,CSE 100,A01,083659,Cao; Yingjun,5,4,70,65
1657485513415,CSE 134B,A01,083661,Powell; Thomas Allan,22,0,100,78
1657485519438,CSE 140,A01,083663,Gungor; Onat,15,0,85,70
1657485525464,CSE 140L,A01,083088,Eldon; John,21,0,100,79
1657485531489,CSE 175,A01,083665,Kumar; Rakesh,3,0,25,22
1657485537525,CSE 190,A00,092507,Dubnov; Shlomo,8,0,20,12
1657485543548,ECE 45,A01,083139,Congero; Spencer William,6,0,75,69
1657485549575,ECE 65,A50,083695,Saad; Andrew S,12,0,30,18
1657485549575,ECE 65,A51,095125,Saad; Andrew S,24,0,26,2
1657485555602,ECE 109,A01,091882,Touri; Behrouz,19,0,70,51
1657485561627,ECE 180,A00,083140,Abi Samra; Nicholas Camill,1,0,30,29
1657485561627,ECE 180,B00,083141,Abi Samra; Nicholas Camill,0,0,30,30
1657485567650,MATH 10A,A01,083735,Patchell; Gregory David,2,0,30,28
1657485567650,MATH 10A,A02,083736,Patchell; Gregory David,20,0,30,10
1657485567650,MATH 10A,A03,083737,Patchell; Gregory David,16,0,30,14
1657485573680,MATH 10B,A01,083207,Lim; Seonhee,8,0,34,26
1657485573680,MATH 10B,A02,083208,Lim; Seonhee,9,0,35,26
1657485573680,MATH 10B,A03,093472,Lim; Seonhee,7,0,34,27
1657485573680,MATH 10B,B01,083739,Sinha; Shubham,12,0,30,18
1657485579711,MATH 18,A01,083743,Cinel; Cameron Alexander,7,0,30,23
1657485579711,MATH 18,A02,083744,Cinel; Cameron Alexander,17,0,30,13
1657485579711,MATH 18,A03,083745,Cinel; Cameron Alexander,9,0,30,21
1657485579711,MATH 18,B01,083748,Rideout; David Porter,5,0,37,32
1657485579711,MATH 18,B02,083749,Rideout; David Porter,5,0,36,31
1657485579711,MATH 18,B03,083750,Rideout; David Porter,3,0,37,34
1657485579711,MATH 18,B04,083751,Rideout; David Porter,6,0,36,30
1657485579711,MATH 18,B05,093473,Rideout; David Porter,6,0,36,30
1657485579711,MATH 18,B06,093474,Rideout; David Porter,6,0,36,30
1657485585735,MATH 20A,A01,083754,Zheng; Zequn,14,0,40,26
1657485591758,MATH 20B,A01,083756,Briones; Jor-el Thomas Caparas,4,0,36,32
1657485591758,MATH 20B,A02,083757,Briones; Jor-el Thomas Caparas,1,0,36,35
1657485591758,MATH 20B,A03,093475,Briones; Jor-el Thomas Caparas,2,0,36,34
1657485597786,MATH 20C,A01,083760,Briones; Jor-el Thomas Caparas,1,0,35,34
1657485597786,MATH 20C,A02,083761,Briones; Jor-el Thomas Caparas,8,0,35,27
1657485597786,MATH 20C,A03,093476,Briones; Jor-el Thomas Caparas,0,1,36,36
1657485597786,MATH 20C,B01,083762,Bach; Quang Tran,1,0,30,29
1657485603811,MATH 20D,A01,083765,Tran; Brian Kha,5,0,30,25
1657485603811,MATH 20D,A02,083766,Tran; Brian Kha,5,0,30,25
1657485603811,MATH 20D,A03,083767,Tran; Brian Kha,5,0,30,25
1657485609840,MATH 20E,A01,083771,Ganguly; Soumya,9,0,32,23
1657485609840,MATH 20E,A02,083772,Ganguly; Soumya,6,0,32,26
1657485609840,MATH 20E,B01,083773,Ciotti; Benjamin,20,0,35,15
1657485609840,MATH 20E,B02,083774,Ciotti; Benjamin,17,0,35,18
1657485615864,MATH 103A,A01,083777,Greenfeld; Be'Eri,3,0,36,33
1657485615864,MATH 103A,A02,083778,Greenfeld; Be'Eri,5,0,36,31
1657485615864,MATH 103A,A03,093561,Greenfeld; Be'Eri,5,0,36,31
1657485615864,MATH 103A,B01,083779,Greenfeld; Be'Eri,7,0,36,29
1657485615864,MATH 103A,B02,083780,Greenfeld; Be'Eri,4,0,36,32
1657485615864,MATH 103A,B03,093562,Greenfeld; Be'Eri,3,0,36,33
1657485621886,MATH 105,A01,085443,Carter; Anne Toulson,15,0,35,20
1657485621886,MATH 105,A02,093477,Carter; Anne Toulson,20,0,35,15
1657485627910,MATH 109,A01,083213,Ganzberger; Geoffrey Michael,2,0,34,32
1657485627910,MATH 109,A02,083214,Ganzberger; Geoffrey Michael,4,0,34,30
1657485627910,MATH 109,A03,093478,Ganzberger; Geoffrey Michael,2,0,34,32
1657485627910,MATH 109,B01,083215,Ganzberger; Geoffrey Michael,1,0,32,31
1657485627910,MATH 109,B02,083216,Ganzberger; Geoffrey Michael,2,0,32,30
1657485627910,MATH 109,B03,093479,Ganzberger; Geoffrey Michael,8,0,32,24
1657485633936,MATH 142A,A01,083219,Chow; Bennett,7,0,32,25
1657485633936,MATH 142A,A02,083220,Chow; Bennett,10,0,32,22
1657485633936,MATH 142A,A03,093480,Chow; Bennett,8,0,32,24
1657485633936,MATH 142A,B03,093481,Chow; Bennett,8,0,32,24
1657485633936,MATH 142A,B04,093558,Chow; Bennett,13,0,32,19
1657485633936,MATH 142A,B05,093559,Chow; Bennett,6,0,32,26
1657485639972,MATH 193A,A01,083224,Rotar; Vladimir,8,0,34,26
1657485639972,MATH 193A,A02,083225,Rotar; Vladimir,9,0,34,25
1657485639972,MATH 193A,A03,083781,Rotar; Vladimir,5,0,34,29
1657485639972,MATH 193A,A04,083782,Rotar; Vladimir,10,0,34,24
1657485639972,MATH 193A,A05,093482,Rotar; Vladimir,10,0,34,24
1657485645996,MATH 197,001,091859,McAuley; Julian John,9999,0,9999,0
1657485645996,MATH 197,002,095566,Kedlaya; Kiran S.,9997,0,9999,2
1657485645996,MATH 197,003,095567,Xiao; Ming,9999,0,9999,0
1657485645996,MATH 197,004,095571,Perols; Johan Lars,9998,0,9999,1
1657485653048,COGS 9,A01,083615,Shannon; Kyle Michael,9,0,75,66
1657485659081,COGS 11,A01,083617,Boyle; Mary E. T.,22,0,48,26
1657485665104,COGS 13,A01,083071,Bastos; Amalia Pinkusfeld,11,0,71,60
1657485671127,COGS 14A,A01,092681,Semenuks; Arturs,5,1,100,95
1657485677152,COGS 14B,A01,083073,Cheng; Tzu-Han,6,0,63,57
1657485683178,COGS 17,A01,092677,Semenuks; Arturs,6,0,81,75
1657485689200,COGS 100,A01,083619,Allen; Michael Gordon,17,0,70,53
1657485695223,COGS 101A,A01,083621,Davis; Joshua Daniel,9,0,68,59
1657485701251,COGS 101B,A01,091572,Allen; Michael Gordon,12,0,65,53
1657485707289,COGS 101C,A01,083625,Delgado; Tania,17,0,35,18
1657485713315,COGS 107A,A01,083627,Boyle; Mary E. T.,13,0,60,47
1657485719341,COGS 118A,A01,083075,Gupta; Anjum,21,0,76,55
1657485725365,CSE 3,A50,083646,Miranda; Gregory Joseph,24,0,50,26
1657485731393,CSE 8A,A50,083650,Miranda; Gregory Joseph,17,1,56,39
1657485737427,CSE 11,A01,083080,Cao; Yingjun,6,15,40,34
1657485743450,CSE 12,A01,083652,Krause-Levy; Sophia Louisa,28,1,120,92
1657485749473,CSE 15L,A01,083654,Morris; Justin Loren,9,0,50,41
1657485749473,CSE 15L,A02,083655,Morris; Justin Loren,9,0,50,41
1657485755501,CSE 20,A01,083657,Tran; Khoa Dang,39,0,80,41
1657485761524,CSE 21,A01,095574,Bach; Quang Tran,22,0,48,26
1657485767549,CSE 30,A01,083084,Eldon; John,5,0,80,75
1657485767549,CSE 30,B01,095061,Bhaskar; Nishant,9,0,50,41
1657485773571,CSE 100,A01,083659,Cao; Yingjun,5,4,70,65
1657485779595,CSE 134B,A01,083661,Powell; Thomas Allan,22,0,100,78
1657485785622,CSE 140,A01,083663,Gungor; Onat,15,0,85,70
1657485791644,CSE 140L,A01,083088,Eldon; John,21,0,100,79
1657485797667,CSE 175,A01,083665,Kumar; Rakesh,3,0,25,22
1657485803688,CSE 190,A00,092507,Dubnov; Shlomo,8,0,20,12
1657485809710,ECE 45,A01,083139,Congero; Spencer William,6,0,75,69
1657485815827,ECE 65,A50,083695,Saad; Andrew S,12,0,30,18
1657485815827,ECE 65,A51,095125,Saad; Andrew S,24,0,26,2
1657485821851,ECE 109,A01,091882,Touri; Behrouz,19,0,70,51
1657485827884,ECE 180,A00,083140,Abi Samra; Nicholas Camill,1,0,30,29
1657485827884,ECE 180,B00,083141,Abi Samra; Nicholas Camill,0,0,30,30
1657485833910,MATH 10A,A01,083735,Patchell; Gregory David,2,0,30,28
1657485833910,MATH 10A,A02,083736,Patchell; Gregory David,20,0,30,10
1657485833910,MATH 10A,A03,083737,Patchell; Gregory David,16,0,30,14
1657485839938,MATH 10B,A01,083207,Lim; Seonhee,8,0,34,26
1657485839938,MATH 10B,A02,083208,Lim; Seonhee,9,0,35,26
1657485839938,MATH 10B,A03,093472,Lim; Seonhee,7,0,34,27
1657485839938,MATH 10B,B01,083739,Sinha; Shubham,12,0,30,18
1657485845974,MATH 18,A01,083743,Cinel; Cameron Alexander,7,0,30,23
1657485845974,MATH 18,A02,083744,Cinel; Cameron Alexander,17,0,30,13
1657485845974,MATH 18,A03,083745,Cinel; Cameron Alexander,9,0,30,21
1657485845974,MATH 18,B01,083748,Rideout; David Porter,5,0,37,32
1657485845974,MATH 18,B02,083749,Rideout; David Porter,5,0,36,31
1657485845974,MATH 18,B03,083750,Rideout; David Porter,3,0,37,34
1657485845974,MATH 18,B04,083751,Rideout; David Porter,6,0,36,30
1657485845974,MATH 18,B05,093473,Rideout; David Porter,6,0,36,30
1657485845974,MATH 18,B06,093474,Rideout; David Porter,6,0,36,30
1657485852001,MATH 20A,A01,083754,Zheng; Zequn,14,0,40,26
1657485858024,MATH 20B,A01,083756,Briones; Jor-el Thomas Caparas,4,0,36,32
1657485858024,MATH 20B,A02,083757,Briones; Jor-el Thomas Caparas,1,0,36,35
1657485858024,MATH 20B,A03,093475,Briones; Jor-el Thomas Caparas,2,0,36,34
1657485864055,MATH 20C,A01,083760,Briones; Jor-el Thomas Caparas,1,0,35,34
1657485864055,MATH 20C,A02,083761,Briones; Jor-el Thomas Caparas,8,0,35,27
1657485864055,MATH 20C,A03,093476,Briones; Jor-el Thomas Caparas,0,1,36,36
1657485864055,MATH 20C,B01,083762,Bach; Quang Tran,1,0,30,29
1657485870085,MATH 20D,A01,083765,Tran; Brian Kha,5,0,30,25
1657485870085,MATH 20D,A02,083766,Tran; Brian Kha,5,0,30,25
1657485870085,MATH 20D,A03,083767,Tran; Brian Kha,5,0,30,25
1657485876112,MATH 20E,A01,083771,Ganguly; Soumya,9,0,32,23
1657485876112,MATH 20E,A02,083772,Ganguly; Soumya,6,0,32,26
1657485876112,MATH 20E,B01,083773,Ciotti; Benjamin,20,0,35,15
1657485876112,MATH 20E,B02,083774,Ciotti; Benjamin,17,0,35,18
1657485882137,MATH 103A,A01,083777,Greenfeld; Be'Eri,3,0,36,33
1657485882137,MATH 103A,A02,083778,Greenfeld; Be'Eri,5,0,36,31
1657485882137,MATH 103A,A03,093561,Greenfeld; Be'Eri,5,0,36,31
1657485882137,MATH 103A,B01,083779,Greenfeld; Be'Eri,7,0,36,29
1657485882137,MATH 103A,B02,083780,Greenfeld; Be'Eri,4,0,36,32
1657485882137,MATH 103A,B03,093562,Greenfeld; Be'Eri,3,0,36,33
1657485888168,MATH 105,A01,085443,Carter; Anne Toulson,15,0,35,20
1657485888168,MATH 105,A02,093477,Carter; Anne Toulson,20,0,35,15
1657485894191,MATH 109,A01,083213,Ganzberger; Geoffrey Michael,2,0,34,32
1657485894191,MATH 109,A02,083214,Ganzberger; Geoffrey Michael,4,0,34,30
1657485894191,MATH 109,A03,093478,Ganzberger; Geoffrey Michael,2,0,34,32
1657485894191,MATH 109,B01,083215,Ganzberger; Geoffrey Michael,1,0,32,31
1657485894191,MATH 109,B02,083216,Ganzberger; Geoffrey Michael,2,0,32,30
1657485894191,MATH 109,B03,093479,Ganzberger; Geoffrey Michael,8,0,32,24
1657485900215,MATH 142A,A01,083219,Chow; Bennett,7,0,32,25
1657485900215,MATH 142A,A02,083220,Chow; Bennett,10,0,32,22
1657485900215,MATH 142A,A03,093480,Chow; Bennett,8,0,32,24
1657485900215,MATH 142A,B03,093481,Chow; Bennett,8,0,32,24
1657485900215,MATH 142A,B04,093558,Chow; Bennett,13,0,32,19
1657485900215,MATH 142A,B05,093559,Chow; Bennett,6,0,32,26
1657485906241,MATH 193A,A01,083224,Rotar; Vladimir,8,0,34,26
1657485906241,MATH 193A,A02,083225,Rotar; Vladimir,9,0,34,25
1657485906241,MATH 193A,A03,083781,Rotar; Vladimir,5,0,34,29
1657485906241,MATH 193A,A04,083782,Rotar; Vladimir,10,0,34,24
1657485906241,MATH 193A,A05,093482,Rotar; Vladimir,10,0,34,24
1657485912267,MATH 197,001,091859,McAuley; Julian John,9999,0,9999,0
1657485912267,MATH 197,002,095566,Kedlaya; Kiran S.,9997,0,9999,2
1657485912267,MATH 197,003,095567,Xiao; Ming,9999,0,9999,0
1657485912267,MATH 197,004,095571,Perols; Johan Lars,9998,0,9999,1
1657485919319,COGS 9,A01,083615,Shannon; Kyle Michael,9,0,75,66
1657485925346,COGS 11,A01,083617,Boyle; Mary E. T.,22,0,48,26
1657485931367,COGS 13,A01,083071,Bastos; Amalia Pinkusfeld,11,0,71,60
1657485937389,COGS 14A,A01,092681,Semenuks; Arturs,5,1,100,95
1657485943419,COGS 14B,A01,083073,Cheng; Tzu-Han,6,0,63,57
1657485949442,COGS 17,A01,092677,Semenuks; Arturs,6,0,81,75
1657485955464,COGS 100,A01,083619,Allen; Michael Gordon,17,0,70,53
1657485961489,COGS 101A,A01,083621,Davis; Joshua Daniel,9,0,68,59
1657485967515,COGS 101B,A01,091572,Allen; Michael Gordon,12,0,65,53
1657485973538,COGS 101C,A01,083625,Delgado; Tania,17,0,35,18
1657485979564,COGS 107A,A01,083627,Boyle; Mary E. T.,13,0,60,47
1657485985587,COGS 118A,A01,083075,Gupta; Anjum,21,0,76,55
1657485991611,CSE 3,A50,083646,Miranda; Gregory Joseph,24,0,50,26
1657485997635,CSE 8A,A50,083650,Miranda; Gregory Joseph,17,1,56,39
1657486003658,CSE 11,A01,083080,Cao; Yingjun,6,15,40,34
1657486009680,CSE 12,A01,083652,Krause-Levy; Sophia Louisa,28,1,120,92
1657486015705,CSE 15L,A01,083654,Morris; Justin Loren,9,0,50,41
1657486015705,CSE 15L,A02,083655,Morris; Justin Loren,9,0,50,41
1657486021727,CSE 20,A01,083657,Tran; Khoa Dang,39,0,80,41
1657486027749,CSE 21,A01,095574,Bach; Quang Tran,22,0,48,26
1657486033772,CSE 30,A01,083084,Eldon; John,5,0,80,75
1657486033772,CSE 30,B01,095061,Bhaskar; Nishant,9,0,50,41
1657486039797,CSE 100,A01,083659,Cao; Yingjun,5,4,70,65
1657486045822,CSE 134B,A01,083661,Powell; Thomas Allan,22,0,100,78
1657486051846,CSE 140,A01,083663,Gungor; Onat,15,0,85,70
1657486057871,CSE 140L,A01,083088,Eldon; John,21,0,100,79
1657486063894,CSE 175,A01,083665,Kumar; Rakesh,3,0,25,22
1657486069917,CSE 190,A00,092507,Dubnov; Shlomo,8,0,20,12
1657486075941,ECE 45,A01,083139,Congero; Spencer William,6,0,75,69
1657486081964,ECE 65,A50,083695,Saad; Andrew S,12,0,30,18
1657486081964,ECE 65,A51,095125,Saad; Andrew S,24,0,26,2
1657486087989,ECE 109,A01,091882,Touri; Behrouz,19,0,70,51
1657486094013,ECE 180,A00,083140,Abi Samra; Nicholas Camill,1,0,30,29
1657486094013,ECE 180,B00,083141,Abi Samra; Nicholas Camill,0,0,30,30
1657486100035,MATH 10A,A01,083735,Patchell; Gregory David,2,0,30,28
1657486100035,MATH 10A,A02,083736,Patchell; Gregory David,20,0,30,10
1657486100035,MATH 10A,A03,083737,Patchell; Gregory David,16,0,30,14
1657486106060,MATH 10B,A01,083207,Lim; Seonhee,8,0,34,26
1657486106060,MATH 10B,A02,083208,Lim; Seonhee,9,0,35,26
1657486106060,MATH 10B,A03,093472,Lim; Seonhee,7,0,34,27
1657486106060,MATH 10B,B01,083739,Sinha; Shubham,12,0,30,18
1657486112084,MATH 18,A01,083743,Cinel; Cameron Alexander,7,0,30,23
1657486112084,MATH 18,A02,083744,Cinel; Cameron Alexander,17,0,30,13
1657486112084,MATH 18,A03,083745,Cinel; Cameron Alexander,9,0,30,21
1657486112084,MATH 18,B01,083748,Rideout; David Porter,5,0,37,32
1657486112084,MATH 18,B02,083749,Rideout; David Porter,5,0,36,31
1657486112084,MATH 18,B03,083750,Rideout; David Porter,3,0,37,34
1657486112084,MATH 18,B04,083751,Rideout; David Porter,6,0,36,30
1657486112084,MATH 18,B05,093473,Rideout; David Porter,6,0,36,30
1657486112084,MATH 18,B06,093474,Rideout; David Porter,6,0,36,30
1657486118116,MATH 20A,A01,083754,Zheng; Zequn,14,0,40,26
1657486124155,MATH 20B,A01,083756,Briones; Jor-el Thomas Caparas,4,0,36,32
1657486124155,MATH 20B,A02,083757,Briones; Jor-el Thomas Caparas,1,0,36,35
1657486124155,MATH 20B,A03,093475,Briones; Jor-el Thomas Caparas,2,0,36,34
1657486130183,MATH 20C,A01,083760,Briones; Jor-el Thomas Caparas,1,0,35,34
1657486130183,MATH 20C,A02,083761,Briones; Jor-el Thomas Caparas,8,0,35,27
1657486130183,MATH 20C,A03,093476,Briones; Jor-el Thomas Caparas,0,1,36,36
1657486130183,MATH 20C,B01,083762,Bach; Quang Tran,1,0,30,29
1657486136210,MATH 20D,A01,083765,Tran; Brian Kha,5,0,30,25
1657486136210,MATH 20D,A02,083766,Tran; Brian Kha,5,0,30,25
1657486136210,MATH 20D,A03,083767,Tran; Brian Kha,5,0,30,25
1657486142233,MATH 20E,A01,083771,Ganguly; Soumya,9,0,32,23
1657486142233,MATH 20E,A02,083772,Ganguly; Soumya,6,0,32,26
1657486142233,MATH 20E,B01,083773,Ciotti; Benjamin,20,0,35,15
1657486142233,MATH 20E,B02,083774,Ciotti; Benjamin,17,0,35,18
1657486148262,MATH 103A,A01,083777,Greenfeld; Be'Eri,3,0,36,33
1657486148262,MATH 103A,A02,083778,Greenfeld; Be'Eri,5,0,36,31
1657486148262,MATH 103A,A03,093561,Greenfeld; Be'Eri,5,0,36,31
1657486148262,MATH 103A,B01,083779,Greenfeld; Be'Eri,7,0,36,29
1657486148262,MATH 103A,B02,083780,Greenfeld; Be'Eri,4,0,36,32
1657486148262,MATH 103A,B03,093562,Greenfeld; Be'Eri,3,0,36,33
1657486154289,MATH 105,A01,085443,Carter; Anne Toulson,15,0,35,20
1657486154289,MATH 105,A02,093477,Carter; Anne Toulson,20,0,35,15
1657486160318,MATH 109,A01,083213,Ganzberger; Geoffrey Michael,2,0,34,32
1657486160318,MATH 109,A02,083214,Ganzberger; Geoffrey Michael,4,0,34,30
1657486160318,MATH 109,A03,093478,Ganzberger; Geoffrey Michael,2,0,34,32
1657486160318,MATH 109,B01,083215,Ganzberger; Geoffrey Michael,1,0,32,31
1657486160318,MATH 109,B02,083216,Ganzberger; Geoffrey Michael,2,0,32,30
1657486160318,MATH 109,B03,093479,Ganzberger; Geoffrey Michael,8,0,32,24
1657486166341,MATH 142A,A01,083219,Chow; Bennett,7,0,32,25
1657486166341,MATH 142A,A02,083220,Chow; Bennett,10,0,32,22
1657486166341,MATH 142A,A03,093480,Chow; Bennett,8,0,32,24
1657486166341,MATH 142A,B03,093481,Chow; Bennett,8,0,32,24
1657486166341,MATH 142A,B04,093558,Chow; Bennett,13,0,32,19
1657486166341,MATH 142A,B05,093559,Chow; Bennett,6,0,32,26
1657486172368,MATH 193A,A01,083224,Rotar; Vladimir,8,0,34,26
1657486172368,MATH 193A,A02,083225,Rotar; Vladimir,9,0,34,25
1657486172368,MATH 193A,A03,083781,Rotar; Vladimir,5,0,34,29
1657486172368,MATH 193A,A04,083782,Rotar; Vladimir,10,0,34,24
1657486172368,MATH 193A,A05,093482,Rotar; Vladimir,10,0,34,24
1657486178395,MATH 197,001,091859,McAuley; Julian John,9999,0,9999,0
1657486178395,MATH 197,002,095566,Kedlaya; Kiran S.,9997,0,9999,2
1657486178395,MATH 197,003,095567,Xiao; Ming,9999,0,9999,0
1657486178395,MATH 197,004,095571,Perols; Johan Lars,9998,0,9999,1
1657486185456,COGS 9,A01,083615,Shannon; Kyle Michael,9,0,75,66
1657486191483,COGS 11,A01,083617,Boyle; Mary E. T.,22,0,48,26
1657486197507,COGS 13,A01,083071,Bastos; Amalia Pinkusfeld,11,0,71,60
1657486203540,COGS 14A,A01,092681,Semenuks; Arturs,5,1,100,95
1657486209566,COGS 14B,A01,083073,Cheng; Tzu-Han,6,0,63,57
1657486215591,COGS 17,A01,092677,Semenuks; Arturs,6,0,81,75
1657486221614,COGS 100,A01,083619,Allen; Michael Gordon,17,0,70,53
1657486227636,COGS 101A,A01,083621,Davis; Joshua Daniel,9,0,68,59
1657486233660,COGS 101B,A01,091572,Allen; Michael Gordon,12,0,65,53
1657486239686,COGS 101C,A01,083625,Delgado; Tania,17,0,35,18
1657486245713,COGS 107A,A01,083627,Boyle; Mary E. T.,13,0,60,47
1657486251735,COGS 118A,A01,083075,Gupta; Anjum,21,0,76,55
1657486257761,CSE 3,A50,083646,Miranda; Gregory Joseph,24,0,50,26
1657486263783,CSE 8A,A50,083650,Miranda; Gregory Joseph,17,1,56,39
1657486269813,CSE 11,A01,083080,Cao; Yingjun,6,15,40,34
1657486275836,CSE 12,A01,083652,Krause-Levy; Sophia Louisa,28,1,120,92
1657486281863,CSE 15L,A01,083654,Morris; Justin Loren,9,0,50,41
1657486281863,CSE 15L,A02,083655,Morris; Justin Loren,9,0,50,41
1657486287888,CSE 20,A01,083657,Tran; Khoa Dang,39,0,80,41
1657486293916,CSE 21,A01,095574,Bach; Quang Tran,22,0,48,26
1657486299939,CSE 30,A01,083084,Eldon; John,5,0,80,75
1657486299939,CSE 30,B01,095061,Bhaskar; Nishant,9,0,50,41
1657486305962,CSE 100,A01,083659,Cao; Yingjun,5,4,70,65
1657486311988,CSE 134B,A01,083661,Powell; Thomas Allan,22,0,100,78
1657486318012,CSE 140,A01,083663,Gungor; Onat,15,0,85,70
1657486324035,CSE 140L,A01,083088,Eldon; John,21,0,100,79
1657486330059,CSE 175,A01,083665,Kumar; Rakesh,3,0,25,22
1657486336085,CSE 190,A00,092507,Dubnov; Shlomo,8,0,20,12
1657486342106,ECE 45,A01,083139,Congero; Spencer William,6,0,75,69
1657486348132,ECE 65,A50,083695,Saad; Andrew S,12,0,30,18
1657486348132,ECE 65,A51,095125,Saad; Andrew S,24,0,26,2
1657486354155,ECE 109,A01,091882,Touri; Behrouz,19,0,70,51
1657486360183,ECE 180,A00,083140,Abi Samra; Nicholas Camill,1,0,30,29
1657486360183,ECE 180,B00,083141,Abi Samra; Nicholas Camill,0,0,30,30
1657486366209,MATH 10A,A01,083735,Patchell; Gregory David,2,0,30,28
1657486366209,MATH 10A,A02,083736,Patchell; Gregory David,20,0,30,10
1657486366209,MATH 10A,A03,083737,Patchell; Gregory David,16,0,30,14
1657486372234,MATH 10B,A01,083207,Lim; Seonhee,8,0,34,26
1657486372234,MATH 10B,A02,083208,Lim; Seonhee,9,0,35,26
1657486372234,MATH 10B,A03,093472,Lim; Seonhee,7,0,34,27
1657486372234,MATH 10B,B01,083739,Sinha; Shubham,12,0,30,18
1657486378264,MATH 18,A01,083743,Cinel; Cameron Alexander,7,0,30,23
1657486378264,MATH 18,A02,083744,Cinel; Cameron Alexander,17,0,30,13
1657486378264,MATH 18,A03,083745,Cinel; Cameron Alexander,9,0,30,21
1657486378264,MATH 18,B01,083748,Rideout; David Porter,5,0,37,32
1657486378264,MATH 18,B02,083749,Rideout; David Porter,5,0,36,31
1657486378264,MATH 18,B03,083750,Rideout; David Porter,3,0,37,34
1657486378264,MATH 18,B04,083751,Rideout; David Porter,6,0,36,30
1657486378264,MATH 18,B05,093473,Rideout; David Porter,6,0,36,30
1657486378264,MATH 18,B06,093474,Rideout; David Porter,6,0,36,30
1657486384287,MATH 20A,A01,083754,Zheng; Zequn,14,0,40,26
1657486390311,MATH 20B,A01,083756,Briones; Jor-el Thomas Caparas,4,0,36,32
1657486390311,MATH 20B,A02,083757,Briones; Jor-el Thomas Caparas,1,0,36,35
1657486390311,MATH 20B,A03,093475,Briones; Jor-el Thomas Caparas,2,0,36,34
1657486396333,MATH 20C,A01,083760,Briones; Jor-el Thomas Caparas,1,0,35,34
1657486396333,MATH 20C,A02,083761,Briones; Jor-el Thomas Caparas,8,0,35,27
1657486396333,MATH 20C,A03,093476,Briones; Jor-el Thomas Caparas,0,1,36,36
1657486396333,MATH 20C,B01,083762,Bach; Quang Tran,1,0,30,29
1657486402358,MATH 20D,A01,083765,Tran; Brian Kha,5,0,30,25
1657486402358,MATH 20D,A02,083766,Tran; Brian Kha,5,0,30,25
1657486402358,MATH 20D,A03,083767,Tran; Brian Kha,5,0,30,25
1657486408381,MATH 20E,A01,083771,Ganguly; Soumya,9,0,32,23
1657486408381,MATH 20E,A02,083772,Ganguly; Soumya,6,0,32,26
1657486408381,MATH 20E,B01,083773,Ciotti; Benjamin,20,0,35,15
1657486408381,MATH 20E,B02,083774,Ciotti; Benjamin,17,0,35,18
1657486414493,MATH 103A,A01,083777,Greenfeld; Be'Eri,3,0,36,33
1657486414493,MATH 103A,A02,083778,Greenfeld; Be'Eri,5,0,36,31
1657486414493,MATH 103A,A03,093561,Greenfeld; Be'Eri,5,0,36,31
1657486414493,MATH 103A,B01,083779,Greenfeld; Be'Eri,7,0,36,29
1657486414493,MATH 103A,B02,083780,Greenfeld; Be'Eri,4,0,36,32
1657486414493,MATH 103A,B03,093562,Greenfeld; Be'Eri,3,0,36,33
1657486420518,MATH 105,A01,085443,Carter; Anne Toulson,15,0,35,20
1657486420518,MATH 105,A02,093477,Carter; Anne Toulson,20,0,35,15
1657486426542,MATH 109,A01,083213,Ganzberger; Geoffrey Michael,2,0,34,32
1657486426542,MATH 109,A02,083214,Ganzberger; Geoffrey Michael,4,0,34,30
1657486426542,MATH 109,A03,093478,Ganzberger; Geoffrey Michael,2,0,34,32
1657486426542,MATH 109,B01,083215,Ganzberger; Geoffrey Michael,1,0,32,31
1657486426542,MATH 109,B02,083216,Ganzberger; Geoffrey Michael,2,0,32,30
1657486426542,MATH 109,B03,093479,Ganzberger; Geoffrey Michael,8,0,32,24
1657486432571,MATH 142A,A01,083219,Chow; Bennett,7,0,32,25
1657486432571,MATH 142A,A02,083220,Chow; Bennett,10,0,32,22
1657486432571,MATH 142A,A03,093480,Chow; Bennett,8,0,32,24
1657486432571,MATH 142A,B03,093481,Chow; Bennett,8,0,32,24
1657486432571,MATH 142A,B04,093558,Chow; Bennett,13,0,32,19
1657486432571,MATH 142A,B05,093559,Chow; Bennett,6,0,32,26
1657486438598,MATH 193A,A01,083224,Rotar; Vladimir,8,0,34,26
1657486438598,MATH 193A,A02,083225,Rotar; Vladimir,9,0,34,25
1657486438598,MATH 193A,A03,083781,Rotar; Vladimir,5,0,34,29
1657486438598,MATH 193A,A04,083782,Rotar; Vladimir,10,0,34,24
1657486438598,MATH 193A,A05,093482,Rotar; Vladimir,10,0,34,24
1657486444630,MATH 197,001,091859,McAuley; Julian John,9999,0,9999,0
1657486444630,MATH 197,002,095566,Kedlaya; Kiran S.,9997,0,9999,2
1657486444630,MATH 197,003,095567,Xiao; Ming,9999,0,9999,0
1657486444630,MATH 197,004,095571,Perols; Johan Lars,9998,0,9999,1
1657486451706,COGS 9,A01,083615,Shannon; Kyle Michael,9,0,75,66
1657486457728,COGS 11,A01,083617,Boyle; Mary E. T.,22,0,48,26
1657486463751,COGS 13,A01,083071,Bastos; Amalia Pinkusfeld,11,0,71,60
1657486469775,COGS 14A,A01,092681,Semenuks; Arturs,5,1,100,95
1657486475800,COGS 14B,A01,083073,Cheng; Tzu-Han,6,0,63,57
1657486481846,COGS 17,A01,092677,Semenuks; Arturs,6,0,81,75
1657486487872,COGS 100,A01,083619,Allen; Michael Gordon,17,0,70,53
1657486493898,COGS 101A,A01,083621,Davis; Joshua Daniel,9,0,68,59
1657486499923,COGS 101B,A01,091572,Allen; Michael Gordon,12,0,65,53
1657486505947,COGS 101C,A01,083625,Delgado; Tania,17,0,35,18
1657486511973,COGS 107A,A01,083627,Boyle; Mary E. T.,13,0,60,47
1657486517997,COGS 118A,A01,083075,Gupta; Anjum,21,0,76,55
1657486524022,CSE 3,A50,083646,Miranda; Gregory Joseph,24,0,50,26
1657486530049,CSE 8A,A50,083650,Miranda; Gregory Joseph,17,1,56,39
1657486536070,CSE 11,A01,083080,Cao; Yingjun,6,15,40,34
1657486542094,CSE 12,A01,083652,Krause-Levy; Sophia Louisa,28,1,120,92
1657486548119,CSE 15L,A01,083654,Morris; Justin Loren,9,0,50,41
1657486548119,CSE 15L,A02,083655,Morris; Justin Loren,9,0,50,41
1657486554144,CSE 20,A01,083657,Tran; Khoa Dang,39,0,80,41
1657486560166,CSE 21,A01,095574,Bach; Quang Tran,22,0,48,26
1657486566191,CSE 30,A01,083084,Eldon; John,5,0,80,75
1657486566191,CSE 30,B01,095061,Bhaskar; Nishant,9,0,50,41
1657486572221,CSE 100,A01,083659,Cao; Yingjun,5,4,70,65
1657486578250,CSE 134B,A01,083661,Powell; Thomas Allan,22,0,100,78
1657486584277,CSE 140,A01,083663,Gungor; Onat,15,0,85,70
1657486590304,CSE 140L,A01,083088,Eldon; John,21,0,100,79
1657486596334,CSE 175,A01,083665,Kumar; Rakesh,3,0,25,22
1657486602357,CSE 190,A00,092507,Dubnov; Shlomo,8,0,20,12
1657486608384,ECE 45,A01,083139,Congero; Spencer William,6,0,75,69
1657486614407,ECE 65,A50,083695,Saad; Andrew S,12,0,30,18
1657486614407,ECE 65,A51,095125,Saad; Andrew S,24,0,26,2
1657486620429,ECE 109,A01,091882,Touri; Behrouz,19,0,70,51
1657486626452,ECE 180,A00,083140,Abi Samra; Nicholas Camill,1,0,30,29
1657486626452,ECE 180,B00,083141,Abi Samra; Nicholas Camill,0,0,30,30
1657486632475,MATH 10A,A01,083735,Patchell; Gregory David,2,0,30,28
1657486632475,MATH 10A,A02,083736,Patchell; Gregory David,20,0,30,10
1657486632475,MATH 10A,A03,083737,Patchell; Gregory David,16,0,30,14
1657486638498,MATH 10B,A01,083207,Lim; Seonhee,8,0,34,26
1657486638498,MATH 10B,A02,083208,Lim; Seonhee,9,0,35,26
1657486638498,MATH 10B,A03,093472,Lim; Seonhee,7,0,34,27
1657486638498,MATH 10B,B01,083739,Sinha; Shubham,12,0,30,18
1657486644522,MATH 18,A01,083743,Cinel; Cameron Alexander,7,0,30,23
1657486644522,MATH 18,A02,083744,Cinel; Cameron Alexander,17,0,30,13
1657486644522,MATH 18,A03,083745,Cinel; Cameron Alexander,9,0,30,21
1657486644522,MATH 18,B01,083748,Rideout; David Porter,5,0,37,32
1657486644522,MATH 18,B02,083749,Rideout; David Porter,5,0,36,31
1657486644522,MATH 18,B03,083750,Rideout; David Porter,3,0,37,34
1657486644522,MATH 18,B04,083751,Rideout; David Porter,6,0,36,30
1657486644522,MATH 18,B05,093473,Rideout; David Porter,6,0,36,30
1657486644522,MATH 18,B06,093474,Rideout; David Porter,6,0,36,30
1657486650553,MATH 20A,A01,083754,Zheng; Zequn,14,0,40,26
1657486656582,MATH 20B,A01,083756,Briones; Jor-el Thomas Caparas,4,0,36,32
1657486656582,MATH 20B,A02,083757,Briones; Jor-el Thomas Caparas,1,0,36,35
1657486656582,MATH 20B,A03,093475,Briones; Jor-el Thomas Caparas,2,0,36,34
1657486662605,MATH 20C,A01,083760,Briones; Jor-el Thomas Caparas,1,0,35,34
1657486662605,MATH 20C,A02,083761,Briones; Jor-el Thomas Caparas,8,0,35,27
1657486662605,MATH 20C,A03,093476,Briones; Jor-el Thomas Caparas,0,1,36,36
1657486662605,MATH 20C,B01,083762,Bach; Quang Tran,1,0,30,29
1657486668628,MATH 20D,A01,083765,Tran; Brian Kha,5,0,30,25
1657486668628,MATH 20D,A02,083766,Tran; Brian Kha,5,0,30,25
1657486668628,MATH 20D,A03,083767,Tran; Brian Kha,5,0,30,25
1657486674653,MATH 20E,A01,083771,Ganguly; Soumya,9,0,32,23
1657486674653,MATH 20E,A02,083772,Ganguly; Soumya,6,0,32,26
1657486674653,MATH 20E,B01,083773,Ciotti; Benjamin,20,0,35,15
1657486674653,MATH 20E,B02,083774,Ciotti; Benjamin,17,0,35,18
1657486680686,MATH 103A,A01,083777,Greenfeld; Be'Eri,3,0,36,33
1657486680686,MATH 103A,A02,083778,Greenfeld; Be'Eri,5,0,36,31
1657486680686,MATH 103A,A03,093561,Greenfeld; Be'Eri,5,0,36,31
1657486680686,MATH 103A,B01,083779,Greenfeld; Be'Eri,7,0,36,29
1657486680686,MATH 103A,B02,083780,Greenfeld; Be'Eri,4,0,36,32
1657486680686,MATH 103A,B03,093562,Greenfeld; Be'Eri,3,0,36,33
1657486686708,MATH 105,A01,085443,Carter; Anne Toulson,15,0,35,20
1657486686708,MATH 105,A02,093477,Carter; Anne Toulson,20,0,35,15
1657486692732,MATH 109,A01,083213,Ganzberger; Geoffrey Michael,2,0,34,32
1657486692732,MATH 109,A02,083214,Ganzberger; Geoffrey Michael,4,0,34,30
1657486692732,MATH 109,A03,093478,Ganzberger; Geoffrey Michael,2,0,34,32
1657486692732,MATH 109,B01,083215,Ganzberger; Geoffrey Michael,1,0,32,31
1657486692732,MATH 109,B02,083216,Ganzberger; Geoffrey Michael,2,0,32,30
1657486692732,MATH 109,B03,093479,Ganzberger; Geoffrey Michael,8,0,32,24
1657486698761,MATH 142A,A01,083219,Chow; Bennett,7,0,32,25
1657486698761,MATH 142A,A02,083220,Chow; Bennett,10,0,32,22
1657486698761,MATH 142A,A03,093480,Chow; Bennett,8,0,32,24
1657486698761,MATH 142A,B03,093481,Chow; Bennett,8,0,32,24
1657486698761,MATH 142A,B04,093558,Chow; Bennett,13,0,32,19
1657486698761,MATH 142A,B05,093559,Chow; Bennett,6,0,32,26
1657486704786,MATH 193A,A01,083224,Rotar; Vladimir,8,0,34,26
1657486704786,MATH 193A,A02,083225,Rotar; Vladimir,9,0,34,25
1657486704786,MATH 193A,A03,083781,Rotar; Vladimir,5,0,34,29
1657486704786,MATH 193A,A04,083782,Rotar; Vladimir,10,0,34,24
1657486704786,MATH 193A,A05,093482,Rotar; Vladimir,10,0,34,24
1657486710809,MATH 197,001,091859,McAuley; Julian John,9999,0,9999,0
1657486710809,MATH 197,002,095566,Kedlaya; Kiran S.,9997,0,9999,2
1657486710809,MATH 197,003,095567,Xiao; Ming,9999,0,9999,0
1657486710809,MATH 197,004,095571,Perols; Johan Lars,9998,0,9999,1
1657486717887,COGS 9,A01,083615,Shannon; Kyle Michael,9,0,75,66
1657486723910,COGS 11,A01,083617,Boyle; Mary E. T.,22,0,48,26
1657486729933,COGS 13,A01,083071,Bastos; Amalia Pinkusfeld,11,0,71,60
1657486735963,COGS 14A,A01,092681,Semenuks; Arturs,5,1,100,95
1657486741988,COGS 14B,A01,083073,Cheng; Tzu-Han,6,0,63,57
1657486748014,COGS 17,A01,092677,Semenuks; Arturs,6,0,81,75
1657486754038,COGS 100,A01,083619,Allen; Michael Gordon,17,0,70,53
1657486760059,COGS 101A,A01,083621,Davis; Joshua Daniel,9,0,68,59
1657486766084,COGS 101B,A01,091572,Allen; Michael Gordon,12,0,65,53
1657486772109,COGS 101C,A01,083625,Delgado; Tania,17,0,35,18
1657486778131,COGS 107A,A01,083627,Boyle; Mary E. T.,13,0,60,47
1657486784160,COGS 118A,A01,083075,Gupta; Anjum,21,0,76,55
1657486790182,CSE 3,A50,083646,Miranda; Gregory Joseph,24,0,50,26
1657486796205,CSE 8A,A50,083650,Miranda; Gregory Joseph,17,1,56,39
1657486802231,CSE 11,A01,083080,Cao; Yingjun,6,15,40,34
1657486808254,CSE 12,A01,083652,Krause-Levy; Sophia Louisa,28,1,120,92
1657486814276,CSE 15L,A01,083654,Morris; Justin Loren,9,0,50,41
1657486814276,CSE 15L,A02,083655,Morris; Justin Loren,9,0,50,41
1657486820302,CSE 20,A01,083657,Tran; Khoa Dang,39,0,80,41
1657486826327,CSE 21,A01,095574,Bach; Quang Tran,22,0,48,26
1657486832355,CSE 30,A01,083084,Eldon; John,5,0,80,75
1657486832355,CSE 30,B01,095061,Bhaskar; Nishant,9,0,50,41
1657486838381,CSE 100,A01,083659,Cao; Yingjun,5,4,70,65
1657486844404,CSE 134B,A01,083661,Powell; Thomas Allan,22,0,100,78
1657486850427,CSE 140,A01,083663,Gungor; Onat,15,0,85,70
1657486856454,CSE 140L,A01,083088,Eldon; John,21,0,100,79
1657486862477,CSE 175,A01,083665,Kumar; Rakesh,3,0,25,22
1657486868500,CSE 190,A00,092507,Dubnov; Shlomo,8,0,20,12
1657486874526,ECE 45,A01,083139,Congero; Spencer William,6,0,75,69
1657486880552,ECE 65,A50,083695,Saad; Andrew S,12,0,30,18
1657486880552,ECE 65,A51,095125,Saad; Andrew S,24,0,26,2
1657486886574,ECE 109,A01,091882,Touri; Behrouz,19,0,70,51
1657486892597,ECE 180,A00,083140,Abi Samra; Nicholas Camill,1,0,30,29
1657486892597,ECE 180,B00,083141,Abi Samra; Nicholas Camill,0,0,30,30
1657486898624,MATH 10A,A01,083735,Patchell; Gregory David,2,0,30,28
1657486898624,MATH 10A,A02,083736,Patchell; Gregory David,20,0,30,10
1657486898624,MATH 10A,A03,083737,Patchell; Gregory David,16,0,30,14
1657486904647,MATH 10B,A01,083207,Lim; Seonhee,8,0,34,26
1657486904647,MATH 10B,A02,083208,Lim; Seonhee,9,0,35,26
1657486904647,MATH 10B,A03,093472,Lim; Seonhee,7,0,34,27
1657486904647,MATH 10B,B01,083739,Sinha; Shubham,12,0,30,18
1657486910671,MATH 18,A01,083743,Cinel; Cameron Alexander,7,0,30,23
1657486910671,MATH 18,A02,083744,Cinel; Cameron Alexander,17,0,30,13
1657486910671,MATH 18,A03,083745,Cinel; Cameron Alexander,9,0,30,21
1657486910671,MATH 18,B01,083748,Rideout; David Porter,5,0,37,32
1657486910671,MATH 18,B02,083749,Rideout; David Porter,5,0,36,31
1657486910671,MATH 18,B03,083750,Rideout; David Porter,3,0,37,34
1657486910671,MATH 18,B04,083751,Rideout; David Porter,6,0,36,30
1657486910671,MATH 18,B05,093473,Rideout; David Porter,6,0,36,30
1657486910671,MATH 18,B06,093474,Rideout; David Porter,6,0,36,30
1657486916698,MATH 20A,A01,083754,Zheng; Zequn,14,0,40,26
1657486922723,MATH 20B,A01,083756,Briones; Jor-el Thomas Caparas,4,0,36,32
1657486922723,MATH 20B,A02,083757,Briones; Jor-el Thomas Caparas,1,0,36,35
1657486922723,MATH 20B,A03,093475,Briones; Jor-el Thomas Caparas,2,0,36,34
1657486928751,MATH 20C,A01,083760,Briones; Jor-el Thomas Caparas,1,0,35,34
1657486928751,MATH 20C,A02,083761,Briones; Jor-el Thomas Caparas,8,0,35,27
1657486928751,MATH 20C,A03,093476,Briones; Jor-el Thomas Caparas,0,1,36,36
1657486928751,MATH 20C,B01,083762,Bach; Quang Tran,1,0,30,29
1657486934775,MATH 20D,A01,083765,Tran; Brian Kha,5,0,30,25
1657486934775,MATH 20D,A02,083766,Tran; Brian Kha,5,0,30,25
1657486934775,MATH 20D,A03,083767,Tran; Brian Kha,5,0,30,25
1657486940798,MATH 20E,A01,083771,Ganguly; Soumya,9,0,32,23
1657486940798,MATH 20E,A02,083772,Ganguly; Soumya,6,0,32,26
1657486940798,MATH 20E,B01,083773,Ciotti; Benjamin,20,0,35,15
1657486940798,MATH 20E,B02,083774,Ciotti; Benjamin,17,0,35,18
1657486946830,MATH 103A,A01,083777,Greenfeld; Be'Eri,3,0,36,33
1657486946830,MATH 103A,A02,083778,Greenfeld; Be'Eri,5,0,36,31
1657486946830,MATH 103A,A03,093561,Greenfeld; Be'Eri,5,0,36,31
1657486946830,MATH 103A,B01,083779,Greenfeld; Be'Eri,7,0,36,29
1657486946830,MATH 103A,B02,083780,Greenfeld; Be'Eri,4,0,36,32
1657486946830,MATH 103A,B03,093562,Greenfeld; Be'Eri,3,0,36,33
1657486952857,MATH 105,A01,085443,Carter; Anne Toulson,15,0,35,20
1657486952857,MATH 105,A02,093477,Carter; Anne Toulson,20,0,35,15
1657486958881,MATH 109,A01,083213,Ganzberger; Geoffrey Michael,2,0,34,32
1657486958881,MATH 109,A02,083214,Ganzberger; Geoffrey Michael,4,0,34,30
1657486958881,MATH 109,A03,093478,Ganzberger; Geoffrey Michael,2,0,34,32
1657486958881,MATH 109,B01,083215,Ganzberger; Geoffrey Michael,1,0,32,31
1657486958881,MATH 109,B02,083216,Ganzberger; Geoffrey Michael,2,0,32,30
1657486958881,MATH 109,B03,093479,Ganzberger; Geoffrey Michael,8,0,32,24
1657486964912,MATH 142A,A01,083219,Chow; Bennett,7,0,32,25
1657486964912,MATH 142A,A02,083220,Chow; Bennett,10,0,32,22
1657486964912,MATH 142A,A03,093480,Chow; Bennett,8,0,32,24
1657486964912,MATH 142A,B03,093481,Chow; Bennett,8,0,32,24
1657486964912,MATH 142A,B04,093558,Chow; Bennett,13,0,32,19
1657486964912,MATH 142A,B05,093559,Chow; Bennett,6,0,32,26
1657486970936,MATH 193A,A01,083224,Rotar; Vladimir,8,0,34,26
1657486970936,MATH 193A,A02,083225,Rotar; Vladimir,9,0,34,25
1657486970936,MATH 193A,A03,083781,Rotar; Vladimir,5,0,34,29
1657486970936,MATH 193A,A04,083782,Rotar; Vladimir,10,0,34,24
1657486970936,MATH 193A,A05,093482,Rotar; Vladimir,10,0,34,24
1657486976958,MATH 197,001,091859,McAuley; Julian John,9999,0,9999,0
1657486976958,MATH 197,002,095566,Kedlaya; Kiran S.,9997,0,9999,2
1657486976958,MATH 197,003,095567,Xiao; Ming,9999,0,9999,0
1657486976958,MATH 197,004,095571,Perols; Johan Lars,9998,0,9999,1
1657486984012,COGS 9,A01,083615,Shannon; Kyle Michael,9,0,75,66
1657486990035,COGS 11,A01,083617,Boyle; Mary E. T.,22,0,48,26
1657486996058,COGS 13,A01,083071,Bastos; Amalia Pinkusfeld,11,0,71,60
1657487002080,COGS 14A,A01,092681,Semenuks; Arturs,5,1,100,95
1657487008195,COGS 14B,A01,083073,Cheng; Tzu-Han,6,0,63,57
1657487014222,COGS 17,A01,092677,Semenuks; Arturs,6,0,81,75
1657487020257,COGS 100,A01,083619,Allen; Michael Gordon,17,0,70,53
1657487026280,COGS 101A,A01,083621,Davis; Joshua Daniel,9,0,68,59
1657487032302,COGS 101B,A01,091572,Allen; Michael Gordon,12,0,65,53
1657487038327,COGS 101C,A01,083625,Delgado; Tania,17,0,35,18
1657487044353,COGS 107A,A01,083627,Boyle; Mary E. T.,13,0,60,47
1657487050375,COGS 118A,A01,083075,Gupta; Anjum,21,0,76,55
1657487056408,CSE 3,A50,083646,Miranda; Gregory Joseph,24,0,50,26
1657487062431,CSE 8A,A50,083650,Miranda; Gregory Joseph,17,1,56,39
1657487068454,CSE 11,A01,083080,Cao; Yingjun,6,15,40,34
1657487074478,CSE 12,A01,083652,Krause-Levy; Sophia Louisa,28,1,120,92
1657487080505,CSE 15L,A01,083654,Morris; Justin Loren,9,0,50,41
1657487080505,CSE 15L,A02,083655,Morris; Justin Loren,9,0,50,41
1657487086532,CSE 20,A01,083657,Tran; Khoa Dang,39,0,80,41
1657487092557,CSE 21,A01,095574,Bach; Quang Tran,22,0,48,26
1657487098579,CSE 30,A01,083084,Eldon; John,5,0,80,75
1657487098579,CSE 30,B01,095061,Bhaskar; Nishant,9,0,50,41
1657487104602,CSE 100,A01,083659,Cao; Yingjun,5,4,70,65
1657487110628,CSE 134B,A01,083661,Powell; Thomas Allan,22,0,100,78
1657487116650,CSE 140,A01,083663,Gungor; Onat,15,0,85,70
1657487122676,CSE 140L,A01,083088,Eldon; John,21,0,100,79
1657487128700,CSE 175,A01,083665,Kumar; Rakesh,3,0,25,22
1657487134724,CSE 190,A00,092507,Dubnov; Shlomo,8,0,20,12
1657487140746,ECE 45,A01,083139,Congero; Spencer William,6,0,75,69
1657487146772,ECE 65,A50,083695,Saad; Andrew S,12,0,30,18
1657487146772,ECE 65,A51,095125,Saad; Andrew S,24,0,26,2
1657487152793,ECE 109,A01,091882,Touri; Behrouz,19,0,70,51
1657487158817,ECE 180,A00,083140,Abi Samra; Nicholas Camill,1,0,30,29
1657487158817,ECE 180,B00,083141,Abi Samra; Nicholas Camill,0,0,30,30
1657487164841,MATH 10A,A01,083735,Patchell; Gregory David,2,0,30,28
1657487164841,MATH 10A,A02,083736,Patchell; Gregory David,20,0,30,10
1657487164841,MATH 10A,A03,083737,Patchell; Gregory David,16,0,30,14
1657487170864,MATH 10B,A01,083207,Lim; Seonhee,8,0,34,26
1657487170864,MATH 10B,A02,083208,Lim; Seonhee,9,0,35,26
1657487170864,MATH 10B,A03,093472,Lim; Seonhee,7,0,34,27
1657487170864,MATH 10B,B01,083739,Sinha; Shubham,12,0,30,18
1657487176897,MATH 18,A01,083743,Cinel; Cameron Alexander,7,0,30,23
1657487176897,MATH 18,A02,083744,Cinel; Cameron Alexander,17,0,30,13
1657487176897,MATH 18,A03,083745,Cinel; Cameron Alexander,9,0,30,21
1657487176897,MATH 18,B01,083748,Rideout; David Porter,5,0,37,32
1657487176897,MATH 18,B02,083749,Rideout; David Porter,5,0,36,31
1657487176897,MATH 18,B03,083750,Rideout; David Porter,3,0,37,34
1657487176897,MATH 18,B04,083751,Rideout; David Porter,6,0,36,30
1657487176897,MATH 18,B05,093473,Rideout; David Porter,6,0,36,30
1657487176897,MATH 18,B06,093474,Rideout; David Porter,6,0,36,30
1657487182932,MATH 20A,A01,083754,Zheng; Zequn,14,0,40,26
1657487188960,MATH 20B,A01,083756,Briones; Jor-el Thomas Caparas,4,0,36,32
1657487188960,MATH 20B,A02,083757,Briones; Jor-el Thomas Caparas,1,0,36,35
1657487188960,MATH 20B,A03,093475,Briones; Jor-el Thomas Caparas,2,0,36,34
1657487194989,MATH 20C,A01,083760,Briones; Jor-el Thomas Caparas,1,0,35,34
1657487194989,MATH 20C,A02,083761,Briones; Jor-el Thomas Caparas,8,0,35,27
1657487194989,MATH 20C,A03,093476,Briones; Jor-el Thomas Caparas,0,1,36,36
1657487194989,MATH 20C,B01,083762,Bach; Quang Tran,1,0,30,29
1657487201014,MATH 20D,A01,083765,Tran; Brian Kha,5,0,30,25
1657487201014,MATH 20D,A02,083766,Tran; Brian Kha,5,0,30,25
1657487201014,MATH 20D,A03,083767,Tran; Brian Kha,5,0,30,25
1657487207043,MATH 20E,A01,083771,Ganguly; Soumya,9,0,32,23
1657487207043,MATH 20E,A02,083772,Ganguly; Soumya,6,0,32,26
1657487207043,MATH 20E,B01,083773,Ciotti; Benjamin,20,0,35,15
1657487207043,MATH 20E,B02,083774,Ciotti; Benjamin,17,0,35,18
1657487213073,MATH 103A,A01,083777,Greenfeld; Be'Eri,3,0,36,33
1657487213073,MATH 103A,A02,083778,Greenfeld; Be'Eri,5,0,36,31
1657487213073,MATH 103A,A03,093561,Greenfeld; Be'Eri,5,0,36,31
1657487213073,MATH 103A,B01,083779,Greenfeld; Be'Eri,7,0,36,29
1657487213073,MATH 103A,B02,083780,Greenfeld; Be'Eri,4,0,36,32
1657487213073,MATH 103A,B03,093562,Greenfeld; Be'Eri,3,0,36,33
1657487219098,MATH 105,A01,085443,Carter; Anne Toulson,15,0,35,20
1657487219098,MATH 105,A02,093477,Carter; Anne Toulson,20,0,35,15
1657487225125,MATH 109,A01,083213,Ganzberger; Geoffrey Michael,2,0,34,32
1657487225125,MATH 109,A02,083214,Ganzberger; Geoffrey Michael,4,0,34,30
1657487225125,MATH 109,A03,093478,Ganzberger; Geoffrey Michael,2,0,34,32
1657487225125,MATH 109,B01,083215,Ganzberger; Geoffrey Michael,1,0,32,31
1657487225125,MATH 109,B02,083216,Ganzberger; Geoffrey Michael,2,0,32,30
1657487225125,MATH 109,B03,093479,Ganzberger; Geoffrey Michael,8,0,32,24
1657487231148,MATH 142A,A01,083219,Chow; Bennett,7,0,32,25
1657487231148,MATH 142A,A02,083220,Chow; Bennett,10,0,32,22
1657487231148,MATH 142A,A03,093480,Chow; Bennett,8,0,32,24
1657487231148,MATH 142A,B03,093481,Chow; Bennett,8,0,32,24
1657487231148,MATH 142A,B04,093558,Chow; Bennett,13,0,32,19
1657487231148,MATH 142A,B05,093559,Chow; Bennett,6,0,32,26
1657487237172,MATH 193A,A01,083224,Rotar; Vladimir,8,0,34,26
1657487237172,MATH 193A,A02,083225,Rotar; Vladimir,9,0,34,25
1657487237172,MATH 193A,A03,083781,Rotar; Vladimir,5,0,34,29
1657487237172,MATH 193A,A04,083782,Rotar; Vladimir,10,0,34,24
1657487237172,MATH 193A,A05,093482,Rotar; Vladimir,10,0,34,24
1657487243216,MATH 197,001,091859,McAuley; Julian John,9999,0,9999,0
1657487243216,MATH 197,002,095566,Kedlaya; Kiran S.,9997,0,9999,2
1657487243216,MATH 197,003,095567,Xiao; Ming,9999,0,9999,0
1657487243216,MATH 197,004,095571,Perols; Johan Lars,9998,0,9999,1
1657487250285,COGS 9,A01,083615,Shannon; Kyle Michael,9,0,75,66
1657487256308,COGS 11,A01,083617,Boyle; Mary E. T.,22,0,48,26
1657487262331,COGS 13,A01,083071,Bastos; Amalia Pinkusfeld,11,0,71,60
1657487268357,COGS 14A,A01,092681,Semenuks; Arturs,5,1,100,95
1657487274385,COGS 14B,A01,083073,Cheng; Tzu-Han,6,0,63,57
1657487280408,COGS 17,A01,092677,Semenuks; Arturs,6,0,81,75
1657487286435,COGS 100,A01,083619,Allen; Michael Gordon,17,0,70,53
1657487292457,COGS 101A,A01,083621,Davis; Joshua Daniel,9,0,68,59
1657487298489,COGS 101B,A01,091572,Allen; Michael Gordon,12,0,65,53
1657487304512,COGS 101C,A01,083625,Delgado; Tania,17,0,35,18
1657487310538,COGS 107A,A01,083627,Boyle; Mary E. T.,13,0,60,47
1657487316562,COGS 118A,A01,083075,Gupta; Anjum,21,0,76,55
1657487322594,CSE 3,A50,083646,Miranda; Gregory Joseph,24,0,50,26
1657487328622,CSE 8A,A50,083650,Miranda; Gregory Joseph,17,1,56,39
1657487334649,CSE 11,A01,083080,Cao; Yingjun,6,15,40,34
1657487340676,CSE 12,A01,083652,Krause-Levy; Sophia Louisa,28,1,120,92
1657487346703,CSE 15L,A01,083654,Morris; Justin Loren,9,0,50,41
1657487346703,CSE 15L,A02,083655,Morris; Justin Loren,9,0,50,41
1657487352728,CSE 20,A01,083657,Tran; Khoa Dang,39,0,80,41
1657487358755,CSE 21,A01,095574,Bach; Quang Tran,22,0,48,26
1657487364777,CSE 30,A01,083084,Eldon; John,5,0,80,75
1657487364777,CSE 30,B01,095061,Bhaskar; Nishant,9,0,50,41
1657487370803,CSE 100,A01,083659,Cao; Yingjun,5,4,70,65
1657487376842,CSE 134B,A01,083661,Powell; Thomas Allan,22,0,100,78
1657487382874,CSE 140,A01,083663,Gungor; Onat,15,0,85,70
1657487388897,CSE 140L,A01,083088,Eldon; John,21,0,100,79
1657487394931,CSE 175,A01,083665,Kumar; Rakesh,3,0,25,22
1657487400960,CSE 190,A00,092507,Dubnov; Shlomo,8,0,20,12
1657487406983,ECE 45,A01,083139,Congero; Spencer William,6,0,75,69
1657487413007,ECE 65,A50,083695,Saad; Andrew S,12,0,30,18
1657487413007,ECE 65,A51,095125,Saad; Andrew S,24,0,26,2
1657487419033,ECE 109,A01,091882,Touri; Behrouz,19,0,70,51
1657487425054,ECE 180,A00,083140,Abi Samra; Nicholas Camill,1,0,30,29
1657487425054,ECE 180,B00,083141,Abi Samra; Nicholas Camill,0,0,30,30
1657487431102,MATH 10A,A01,083735,Patchell; Gregory David,2,0,30,28
1657487431102,MATH 10A,A02,083736,Patchell; Gregory David,20,0,30,10
1657487431102,MATH 10A,A03,083737,Patchell; Gregory David,16,0,30,14
1657487437126,MATH 10B,A01,083207,Lim; Seonhee,8,0,34,26
1657487437126,MATH 10B,A02,083208,Lim; Seonhee,9,0,35,26
1657487437126,MATH 10B,A03,093472,Lim; Seonhee,7,0,34,27
1657487437126,MATH 10B,B01,083739,Sinha; Shubham,12,0,30,18
1657487443156,MATH 18,A01,083743,Cinel; Cameron Alexander,7,0,30,23
1657487443156,MATH 18,A02,083744,Cinel; Cameron Alexander,17,0,30,13
1657487443156,MATH 18,A03,083745,Cinel; Cameron Alexander,9,0,30,21
1657487443156,MATH 18,B01,083748,Rideout; David Porter,5,0,37,32
1657487443156,MATH 18,B02,083749,Rideout; David Porter,5,0,36,31
1657487443156,MATH 18,B03,083750,Rideout; David Porter,3,0,37,34
1657487443156,MATH 18,B04,083751,Rideout; David Porter,6,0,36,30
1657487443156,MATH 18,B05,093473,Rideout; David Porter,6,0,36,30
1657487443156,MATH 18,B06,093474,Rideout; David Porter,6,0,36,30
1657487449182,MATH 20A,A01,083754,Zheng; Zequn,14,0,40,26
1657487455212,MATH 20B,A01,083756,Briones; Jor-el Thomas Caparas,4,0,36,32
1657487455212,MATH 20B,A02,083757,Briones; Jor-el Thomas Caparas,1,0,36,35
1657487455212,MATH 20B,A03,093475,Briones; Jor-el Thomas Caparas,2,0,36,34
1657487461235,MATH 20C,A01,083760,Briones; Jor-el Thomas Caparas,1,0,35,34
1657487461235,MATH 20C,A02,083761,Briones; Jor-el Thomas Caparas,8,0,35,27
1657487461235,MATH 20C,A03,093476,Briones; Jor-el Thomas Caparas,0,1,36,36
1657487461235,MATH 20C,B01,083762,Bach; Quang Tran,1,0,30,29
1657487467258,MATH 20D,A01,083765,Tran; Brian Kha,5,0,30,25
1657487467258,MATH 20D,A02,083766,Tran; Brian Kha,5,0,30,25
1657487467258,MATH 20D,A03,083767,Tran; Brian Kha,5,0,30,25
1657487473283,MATH 20E,A01,083771,Ganguly; Soumya,9,0,32,23
1657487473283,MATH 20E,A02,083772,Ganguly; Soumya,6,0,32,26
1657487473283,MATH 20E,B01,083773,Ciotti; Benjamin,20,0,35,15
1657487473283,MATH 20E,B02,083774,Ciotti; Benjamin,17,0,35,18
1657487479306,MATH 103A,A01,083777,Greenfeld; Be'Eri,3,0,36,33
1657487479306,MATH 103A,A02,083778,Greenfeld; Be'Eri,5,0,36,31
1657487479306,MATH 103A,A03,093561,Greenfeld; Be'Eri,5,0,36,31
1657487479306,MATH 103A,B01,083779,Greenfeld; Be'Eri,7,0,36,29
1657487479306,MATH 103A,B02,083780,Greenfeld; Be'Eri,4,0,36,32
1657487479306,MATH 103A,B03,093562,Greenfeld; Be'Eri,3,0,36,33
1657487485328,MATH 105,A01,085443,Carter; Anne Toulson,15,0,35,20
1657487485328,MATH 105,A02,093477,Carter; Anne Toulson,20,0,35,15
1657487491352,MATH 109,A01,083213,Ganzberger; Geoffrey Michael,2,0,34,32
1657487491352,MATH 109,A02,083214,Ganzberger; Geoffrey Michael,4,0,34,30
1657487491352,MATH 109,A03,093478,Ganzberger; Geoffrey Michael,2,0,34,32
1657487491352,MATH 109,B01,083215,Ganzberger; Geoffrey Michael,1,0,32,31
1657487491352,MATH 109,B02,083216,Ganzberger; Geoffrey Michael,2,0,32,30
1657487491352,MATH 109,B03,093479,Ganzberger; Geoffrey Michael,8,0,32,24
1657487497380,MATH 142A,A01,083219,Chow; Bennett,7,0,32,25
1657487497380,MATH 142A,A02,083220,Chow; Bennett,10,0,32,22
1657487497380,MATH 142A,A03,093480,Chow; Bennett,8,0,32,24
1657487497380,MATH 142A,B03,093481,Chow; Bennett,8,0,32,24
1657487497380,MATH 142A,B04,093558,Chow; Bennett,13,0,32,19
1657487497380,MATH 142A,B05,093559,Chow; Bennett,6,0,32,26
1657487503411,MATH 193A,A01,083224,Rotar; Vladimir,8,0,34,26
1657487503411,MATH 193A,A02,083225,Rotar; Vladimir,9,0,34,25
1657487503411,MATH 193A,A03,083781,Rotar; Vladimir,5,0,34,29
1657487503411,MATH 193A,A04,083782,Rotar; Vladimir,10,0,34,24
1657487503411,MATH 193A,A05,093482,Rotar; Vladimir,10,0,34,24
1657487509435,MATH 197,001,091859,McAuley; Julian John,9999,0,9999,0
1657487509435,MATH 197,002,095566,Kedlaya; Kiran S.,9997,0,9999,2
1657487509435,MATH 197,003,095567,Xiao; Ming,9999,0,9999,0
1657487509435,MATH 197,004,095571,Perols; Johan Lars,9998,0,9999,1
1657487516490,COGS 9,A01,083615,Shannon; Kyle Michael,9,0,75,66
1657487522513,COGS 11,A01,083617,Boyle; Mary E. T.,22,0,48,26
1657487528536,COGS 13,A01,083071,Bastos; Amalia Pinkusfeld,11,0,71,60
1657487534563,COGS 14A,A01,092681,Semenuks; Arturs,5,1,100,95
1657487540589,COGS 14B,A01,083073,Cheng; Tzu-Han,6,0,63,57
1657487546610,COGS 17,A01,092677,Semenuks; Arturs,6,0,81,75
1657487552641,COGS 100,A01,083619,Allen; Michael Gordon,17,0,70,53
1657487558668,COGS 101A,A01,083621,Davis; Joshua Daniel,9,0,68,59
1657487564692,COGS 101B,A01,091572,Allen; Michael Gordon,12,0,65,53
1657487570715,COGS 101C,A01,083625,Delgado; Tania,17,0,35,18
1657487576738,COGS 107A,A01,083627,Boyle; Mary E. T.,13,0,60,47
1657487582766,COGS 118A,A01,083075,Gupta; Anjum,21,0,76,55
1657487588793,CSE 3,A50,083646,Miranda; Gregory Joseph,24,0,50,26
1657487594821,CSE 8A,A50,083650,Miranda; Gregory Joseph,17,1,56,39
1657487600845,CSE 11,A01,083080,Cao; Yingjun,6,15,40,34
1657487606963,CSE 12,A01,083652,Krause-Levy; Sophia Louisa,28,1,120,92
1657487612991,CSE 15L,A01,083654,Morris; Justin Loren,9,0,50,41
1657487612991,CSE 15L,A02,083655,Morris; Justin Loren,9,0,50,41
1657487619025,CSE 20,A01,083657,Tran; Khoa Dang,39,0,80,41
1657487625051,CSE 21,A01,095574,Bach; Quang Tran,22,0,48,26
1657487631073,CSE 30,A01,083084,Eldon; John,5,0,80,75
1657487631073,CSE 30,B01,095061,Bhaskar; Nishant,9,0,50,41
1657487637098,CSE 100,A01,083659,Cao; Yingjun,5,4,70,65
1657487643127,CSE 134B,A01,083661,Powell; Thomas Allan,22,0,100,78
1657487649152,CSE 140,A01,083663,Gungor; Onat,15,0,85,70
1657487655178,CSE 140L,A01,083088,Eldon; John,21,0,100,79
1657487661204,CSE 175,A01,083665,Kumar; Rakesh,3,0,25,22
1657487667227,CSE 190,A00,092507,Dubnov; Shlomo,8,0,20,12
1657487673253,ECE 45,A01,083139,Congero; Spencer William,6,0,75,69
1657487679280,ECE 65,A50,083695,Saad; Andrew S,12,0,30,18
1657487679280,ECE 65,A51,095125,Saad; Andrew S,24,0,26,2
1657487685306,ECE 109,A01,091882,Touri; Behrouz,19,0,70,51
1657487691329,ECE 180,A00,083140,Abi Samra; Nicholas Camill,1,0,30,29
1657487691329,ECE 180,B00,083141,Abi Samra; Nicholas Camill,0,0,30,30
1657487697371,MATH 10A,A01,083735,Patchell; Gregory David,2,0,30,28
1657487697371,MATH 10A,A02,083736,Patchell; Gregory David,20,0,30,10
1657487697371,MATH 10A,A03,083737,Patchell; Gregory David,16,0,30,14
1657487703402,MATH 10B,A01,083207,Lim; Seonhee,8,0,34,26
1657487703402,MATH 10B,A02,083208,Lim; Seonhee,9,0,35,26
1657487703402,MATH 10B,A03,093472,Lim; Seonhee,7,0,34,27
1657487703402,MATH 10B,B01,083739,Sinha; Shubham,12,0,30,18
1657487709426,MATH 18,A01,083743,Cinel; Cameron Alexander,7,0,30,23
1657487709426,MATH 18,A02,083744,Cinel; Cameron Alexander,17,0,30,13
1657487709426,MATH 18,A03,083745,Cinel; Cameron Alexander,9,0,30,21
1657487709426,MATH 18,B01,083748,Rideout; David Porter,5,0,37,32
1657487709426,MATH 18,B02,083749,Rideout; David Porter,5,0,36,31
1657487709426,MATH 18,B03,083750,Rideout; David Porter,3,0,37,34
1657487709426,MATH 18,B04,083751,Rideout; David Porter,6,0,36,30
1657487709426,MATH 18,B05,093473,Rideout; David Porter,6,0,36,30
1657487709426,MATH 18,B06,093474,Rideout; David Porter,6,0,36,30
1657487715448,MATH 20A,A01,083754,Zheng; Zequn,14,0,40,26
1657487721473,MATH 20B,A01,083756,Briones; Jor-el Thomas Caparas,4,0,36,32
1657487721473,MATH 20B,A02,083757,Briones; Jor-el Thomas Caparas,1,0,36,35
1657487721473,MATH 20B,A03,093475,Briones; Jor-el Thomas Caparas,2,0,36,34
1657487727496,MATH 20C,A01,083760,Briones; Jor-el Thomas Caparas,1,0,35,34
1657487727496,MATH 20C,A02,083761,Briones; Jor-el Thomas Caparas,8,0,35,27
1657487727496,MATH 20C,A03,093476,Briones; Jor-el Thomas Caparas,0,1,36,36
1657487727496,MATH 20C,B01,083762,Bach; Quang Tran,1,0,30,29
1657487733518,MATH 20D,A01,083765,Tran; Brian Kha,5,0,30,25
1657487733518,MATH 20D,A02,083766,Tran; Brian Kha,5,0,30,25
1657487733518,MATH 20D,A03,083767,Tran; Brian Kha,5,0,30,25
1657487739547,MATH 20E,A01,083771,Ganguly; Soumya,9,0,32,23
1657487739547,MATH 20E,A02,083772,Ganguly; Soumya,6,0,32,26
1657487739547,MATH 20E,B01,083773,Ciotti; Benjamin,20,0,35,15
1657487739547,MATH 20E,B02,083774,Ciotti; Benjamin,17,0,35,18
1657487745576,MATH 103A,A01,083777,Greenfeld; Be'Eri,3,0,36,33
1657487745576,MATH 103A,A02,083778,Greenfeld; Be'Eri,5,0,36,31
1657487745576,MATH 103A,A03,093561,Greenfeld; Be'Eri,5,0,36,31
1657487745576,MATH 103A,B01,083779,Greenfeld; Be'Eri,7,0,36,29
1657487745576,MATH 103A,B02,083780,Greenfeld; Be'Eri,4,0,36,32
1657487745576,MATH 103A,B03,093562,Greenfeld; Be'Eri,3,0,36,33
1657487751599,MATH 105,A01,085443,Carter; Anne Toulson,15,0,35,20
1657487751599,MATH 105,A02,093477,Carter; Anne Toulson,20,0,35,15
1657487757621,MATH 109,A01,083213,Ganzberger; Geoffrey Michael,2,0,34,32
1657487757621,MATH 109,A02,083214,Ganzberger; Geoffrey Michael,4,0,34,30
1657487757621,MATH 109,A03,093478,Ganzberger; Geoffrey Michael,2,0,34,32
1657487757621,MATH 109,B01,083215,Ganzberger; Geoffrey Michael,1,0,32,31
1657487757621,MATH 109,B02,083216,Ganzberger; Geoffrey Michael,2,0,32,30
1657487757621,MATH 109,B03,093479,Ganzberger; Geoffrey Michael,8,0,32,24
1657487763643,MATH 142A,A01,083219,Chow; Bennett,7,0,32,25
1657487763643,MATH 142A,A02,083220,Chow; Bennett,10,0,32,22
1657487763643,MATH 142A,A03,093480,Chow; Bennett,8,0,32,24
1657487763643,MATH 142A,B03,093481,Chow; Bennett,8,0,32,24
1657487763643,MATH 142A,B04,093558,Chow; Bennett,13,0,32,19
1657487763643,MATH 142A,B05,093559,Chow; Bennett,6,0,32,26
1657487769668,MATH 193A,A01,083224,Rotar; Vladimir,8,0,34,26
1657487769668,MATH 193A,A02,083225,Rotar; Vladimir,9,0,34,25
1657487769668,MATH 193A,A03,083781,Rotar; Vladimir,5,0,34,29
1657487769668,MATH 193A,A04,083782,Rotar; Vladimir,10,0,34,24
1657487769668,MATH 193A,A05,093482,Rotar; Vladimir,10,0,34,24
1657487775692,MATH 197,001,091859,McAuley; Julian John,9999,0,9999,0
1657487775692,MATH 197,002,095566,Kedlaya; Kiran S.,9997,0,9999,2
1657487775692,MATH 197,003,095567,Xiao; Ming,9999,0,9999,0
1657487775692,MATH 197,004,095571,Perols; Johan Lars,9998,0,9999,1
1657487782746,COGS 9,A01,083615,Shannon; Kyle Michael,9,0,75,66
1657487788768,COGS 11,A01,083617,Boyle; Mary E. T.,22,0,48,26
1657487794791,COGS 13,A01,083071,Bastos; Amalia Pinkusfeld,11,0,71,60
1657487800817,COGS 14A,A01,092681,Semenuks; Arturs,5,1,100,95
1657487806839,COGS 14B,A01,083073,Cheng; Tzu-Han,6,0,63,57
1657487812865,COGS 17,A01,092677,Semenuks; Arturs,6,0,81,75
1657487818889,COGS 100,A01,083619,Allen; Michael Gordon,17,0,70,53
1657487824915,COGS 101A,A01,083621,Davis; Joshua Daniel,9,0,68,59
1657487830939,COGS 101B,A01,091572,Allen; Michael Gordon,12,0,65,53
1657487836966,COGS 101C,A01,083625,Delgado; Tania,17,0,35,18
1657487842992,COGS 107A,A01,083627,Boyle; Mary E. T.,13,0,60,47
1657487849018,COGS 118A,A01,083075,Gupta; Anjum,21,0,76,55
1657487855042,CSE 3,A50,083646,Miranda; Gregory Joseph,24,0,50,26
1657487861066,CSE 8A,A50,083650,Miranda; Gregory Joseph,17,1,56,39
1657487867090,CSE 11,A01,083080,Cao; Yingjun,6,15,40,34
1657487873117,CSE 12,A01,083652,Krause-Levy; Sophia Louisa,28,1,120,92
1657487879148,CSE 15L,A01,083654,Morris; Justin Loren,9,0,50,41
1657487879148,CSE 15L,A02,083655,Morris; Justin Loren,9,0,50,41
1657487885171,CSE 20,A01,083657,Tran; Khoa Dang,39,0,80,41
1657487891194,CSE 21,A01,095574,Bach; Quang Tran,22,0,48,26
1657487897219,CSE 30,A01,083084,Eldon; John,5,0,80,75
1657487897219,CSE 30,B01,095061,Bhaskar; Nishant,9,0,50,41
1657487903247,CSE 100,A01,083659,Cao; Yingjun,5,4,70,65
1657487909269,CSE 134B,A01,083661,Powell; Thomas Allan,22,0,100,78
1657487915291,CSE 140,A01,083663,Gungor; Onat,15,0,85,70
1657487921319,CSE 140L,A01,083088,Eldon; John,21,0,100,79
1657487927342,CSE 175,A01,083665,Kumar; Rakesh,3,0,25,22
1657487933365,CSE 190,A00,092507,Dubnov; Shlomo,8,0,20,12
1657487939390,ECE 45,A01,083139,Congero; Spencer William,6,0,75,69
1657487945415,ECE 65,A50,083695,Saad; Andrew S,12,0,30,18
1657487945415,ECE 65,A51,095125,Saad; Andrew S,24,0,26,2
1657487951437,ECE 109,A01,091882,Touri; Behrouz,19,0,70,51
1657487957460,ECE 180,A00,083140,Abi Samra; Nicholas Camill,1,0,30,29
1657487957460,ECE 180,B00,083141,Abi Samra; Nicholas Camill,0,0,30,30
1657487963483,MATH 10A,A01,083735,Patchell; Gregory David,2,0,30,28
1657487963483,MATH 10A,A02,083736,Patchell; Gregory David,20,0,30,10
1657487963483,MATH 10A,A03,083737,Patchell; Gregory David,16,0,30,14
1657487969511,MATH 10B,A01,083207,Lim; Seonhee,8,0,34,26
1657487969511,MATH 10B,A02,083208,Lim; Seonhee,9,0,35,26
1657487969511,MATH 10B,A03,093472,Lim; Seonhee,7,0,34,27
1657487969511,MATH 10B,B01,083739,Sinha; Shubham,12,0,30,18
1657487975536,MATH 18,A01,083743,Cinel; Cameron Alexander,7,0,30,23
1657487975536,MATH 18,A02,083744,Cinel; Cameron Alexander,17,0,30,13
1657487975536,MATH 18,A03,083745,Cinel; Cameron Alexander,9,0,30,21
1657487975536,MATH 18,B01,083748,Rideout; David Porter,5,0,37,32
1657487975536,MATH 18,B02,083749,Rideout; David Porter,5,0,36,31
1657487975536,MATH 18,B03,083750,Rideout; David Porter,3,0,37,34
1657487975536,MATH 18,B04,083751,Rideout; David Porter,6,0,36,30
1657487975536,MATH 18,B05,093473,Rideout; David Porter,6,0,36,30
1657487975536,MATH 18,B06,093474,Rideout; David Porter,6,0,36,30
1657487981559,MATH 20A,A01,083754,Zheng; Zequn,14,0,40,26
1657487987584,MATH 20B,A01,083756,Briones; Jor-el Thomas Caparas,4,0,36,32
1657487987584,MATH 20B,A02,083757,Briones; Jor-el Thomas Caparas,1,0,36,35
1657487987584,MATH 20B,A03,093475,Briones; Jor-el Thomas Caparas,2,0,36,34
1657487993609,MATH 20C,A01,083760,Briones; Jor-el Thomas Caparas,1,0,35,34
1657487993609,MATH 20C,A02,083761,Briones; Jor-el Thomas Caparas,8,0,35,27
1657487993609,MATH 20C,A03,093476,Briones; Jor-el Thomas Caparas,0,1,36,36
1657487993609,MATH 20C,B01,083762,Bach; Quang Tran,1,0,30,29
1657487999633,MATH 20D,A01,083765,Tran; Brian Kha,5,0,30,25
1657487999633,MATH 20D,A02,083766,Tran; Brian Kha,5,0,30,25
1657487999633,MATH 20D,A03,083767,Tran; Brian Kha,5,0,30,25
1657488005661,MATH 20E,A01,083771,Ganguly; Soumya,9,0,32,23
1657488005661,MATH 20E,A02,083772,Ganguly; Soumya,6,0,32,26
1657488005661,MATH 20E,B01,083773,Ciotti; Benjamin,20,0,35,15
1657488005661,MATH 20E,B02,083774,Ciotti; Benjamin,17,0,35,18
1657488011705,MATH 103A,A01,083777,Greenfeld; Be'Eri,3,0,36,33
1657488011705,MATH 103A,A02,083778,Greenfeld; Be'Eri,5,0,36,31
1657488011705,MATH 103A,A03,093561,Greenfeld; Be'Eri,5,0,36,31
1657488011705,MATH 103A,B01,083779,Greenfeld; Be'Eri,7,0,36,29
1657488011705,MATH 103A,B02,083780,Greenfeld; Be'Eri,4,0,36,32
1657488011705,MATH 103A,B03,093562,Greenfeld; Be'Eri,3,0,36,33
1657488017732,MATH 105,A01,085443,Carter; Anne Toulson,15,0,35,20
1657488017732,MATH 105,A02,093477,Carter; Anne Toulson,20,0,35,15
1657488023761,MATH 109,A01,083213,Ganzberger; Geoffrey Michael,2,0,34,32
1657488023761,MATH 109,A02,083214,Ganzberger; Geoffrey Michael,4,0,34,30
1657488023761,MATH 109,A03,093478,Ganzberger; Geoffrey Michael,2,0,34,32
1657488023761,MATH 109,B01,083215,Ganzberger; Geoffrey Michael,1,0,32,31
1657488023761,MATH 109,B02,083216,Ganzberger; Geoffrey Michael,2,0,32,30
1657488023761,MATH 109,B03,093479,Ganzberger; Geoffrey Michael,8,0,32,24
1657488029783,MATH 142A,A01,083219,Chow; Bennett,7,0,32,25
1657488029783,MATH 142A,A02,083220,Chow; Bennett,10,0,32,22
1657488029783,MATH 142A,A03,093480,Chow; Bennett,8,0,32,24
1657488029783,MATH 142A,B03,093481,Chow; Bennett,8,0,32,24
1657488029783,MATH 142A,B04,093558,Chow; Bennett,13,0,32,19
1657488029783,MATH 142A,B05,093559,Chow; Bennett,6,0,32,26
1657488035811,MATH 193A,A01,083224,Rotar; Vladimir,8,0,34,26
1657488035811,MATH 193A,A02,083225,Rotar; Vladimir,9,0,34,25
1657488035811,MATH 193A,A03,083781,Rotar; Vladimir,5,0,34,29
1657488035811,MATH 193A,A04,083782,Rotar; Vladimir,10,0,34,24
1657488035811,MATH 193A,A05,093482,Rotar; Vladimir,10,0,34,24
1657488041837,MATH 197,001,091859,McAuley; Julian John,9999,0,9999,0
1657488041837,MATH 197,002,095566,Kedlaya; Kiran S.,9997,0,9999,2
1657488041837,MATH 197,003,095567,Xiao; Ming,9999,0,9999,0
1657488041837,MATH 197,004,095571,Perols; Johan Lars,9998,0,9999,1
1657488048899,COGS 9,A01,083615,Shannon; Kyle Michael,9,0,75,66
1657488054926,COGS 11,A01,083617,Boyle; Mary E. T.,22,0,48,26
1657488060953,COGS 13,A01,083071,Bastos; Amalia Pinkusfeld,11,0,71,60
1657488066974,COGS 14A,A01,092681,Semenuks; Arturs,5,1,100,95
1657488073002,COGS 14B,A01,083073,Cheng; Tzu-Han,6,0,63,57
1657488079026,COGS 17,A01,092677,Semenuks; Arturs,6,0,81,75
1657488085052,COGS 100,A01,083619,Allen; Michael Gordon,17,0,70,53
1657488091079,COGS 101A,A01,083621,Davis; Joshua Daniel,9,0,68,59
1657488097103,COGS 101B,A01,091572,Allen; Michael Gordon,12,0,65,53
1657488103127,COGS 101C,A01,083625,Delgado; Tania,17,0,35,18
1657488109150,COGS 107A,A01,083627,Boyle; Mary E. T.,13,0,60,47
1657488115173,COGS 118A,A01,083075,Gupta; Anjum,21,0,76,55
1657488121206,CSE 3,A50,083646,Miranda; Gregory Joseph,24,0,50,26
1657488127228,CSE 8A,A50,083650,Miranda; Gregory Joseph,17,1,56,39
1657488133254,CSE 11,A01,083080,Cao; Yingjun,6,15,40,34
1657488139291,CSE 12,A01,083652,Krause-Levy; Sophia Louisa,28,1,120,92
1657488145314,CSE 15L,A01,083654,Morris; Justin Loren,9,0,50,41
1657488145314,CSE 15L,A02,083655,Morris; Justin Loren,9,0,50,41
1657488151337,CSE 20,A01,083657,Tran; Khoa Dang,39,0,80,41
1657488157363,CSE 21,A01,095574,Bach; Quang Tran,22,0,48,26
1657488163387,CSE 30,A01,083084,Eldon; John,5,0,80,75
1657488163387,CSE 30,B01,095061,Bhaskar; Nishant,9,0,50,41
1657488169414,CSE 100,A01,083659,Cao; Yingjun,5,4,70,65
1657488175438,CSE 134B,A01,083661,Powell; Thomas Allan,22,0,100,78
1657488181463,CSE 140,A01,083663,Gungor; Onat,15,0,85,70
1657488187486,CSE 140L,A01,083088,Eldon; John,21,0,100,79
1657488193510,CSE 175,A01,083665,Kumar; Rakesh,3,0,25,22
1657488199535,CSE 190,A00,092507,Dubnov; Shlomo,8,0,20,12
1657488205638,ECE 45,A01,083139,Congero; Spencer William,6,0,75,69
1657488211664,ECE 65,A50,083695,Saad; Andrew S,12,0,30,18
1657488211664,ECE 65,A51,095125,Saad; Andrew S,24,0,26,2
1657488217686,ECE 109,A01,091882,Touri; Behrouz,19,0,70,51
1657488223709,ECE 180,A00,083140,Abi Samra; Nicholas Camill,1,0,30,29
1657488223709,ECE 180,B00,083141,Abi Samra; Nicholas Camill,0,0,30,30
1657488229732,MATH 10A,A01,083735,Patchell; Gregory David,2,0,30,28
1657488229732,MATH 10A,A02,083736,Patchell; Gregory David,20,0,30,10
1657488229732,MATH 10A,A03,083737,Patchell; Gregory David,16,0,30,14
1657488235757,MATH 10B,A01,083207,Lim; Seonhee,8,0,34,26
1657488235757,MATH 10B,A02,083208,Lim; Seonhee,9,0,35,26
1657488235757,MATH 10B,A03,093472,Lim; Seonhee,7,0,34,27
1657488235757,MATH 10B,B01,083739,Sinha; Shubham,12,0,30,18
1657488241790,MATH 18,A01,083743,Cinel; Cameron Alexander,7,0,30,23
1657488241790,MATH 18,A02,083744,Cinel; Cameron Alexander,17,0,30,13
1657488241790,MATH 18,A03,083745,Cinel; Cameron Alexander,9,0,30,21
1657488241790,MATH 18,B01,083748,Rideout; David Porter,5,0,37,32
1657488241790,MATH 18,B02,083749,Rideout; David Porter,5,0,36,31
1657488241790,MATH 18,B03,083750,Rideout; David Porter,3,0,37,34
1657488241790,MATH 18,B04,083751,Rideout; David Porter,6,0,36,30
1657488241790,MATH 18,B05,093473,Rideout; David Porter,6,0,36,30
1657488241790,MATH 18,B06,093474,Rideout; David Porter,6,0,36,30
1657488247812,MATH 20A,A01,083754,Zheng; Zequn,14,0,40,26
1657488253839,MATH 20B,A01,083756,Briones; Jor-el Thomas Caparas,4,0,36,32
1657488253839,MATH 20B,A02,083757,Briones; Jor-el Thomas Caparas,1,0,36,35
1657488253839,MATH 20B,A03,093475,Briones; Jor-el Thomas Caparas,2,0,36,34
1657488259869,MATH 20C,A01,083760,Briones; Jor-el Thomas Caparas,1,0,35,34
1657488259869,MATH 20C,A02,083761,Briones; Jor-el Thomas Caparas,8,0,35,27
1657488259869,MATH 20C,A03,093476,Briones; Jor-el Thomas Caparas,0,1,36,36
1657488259869,MATH 20C,B01,083762,Bach; Quang Tran,1,0,30,29
1657488265896,MATH 20D,A01,083765,Tran; Brian Kha,5,0,30,25
1657488265896,MATH 20D,A02,083766,Tran; Brian Kha,5,0,30,25
1657488265896,MATH 20D,A03,083767,Tran; Brian Kha,5,0,30,25
1657488271921,MATH 20E,A01,083771,Ganguly; Soumya,9,0,32,23
1657488271921,MATH 20E,A02,083772,Ganguly; Soumya,6,0,32,26
1657488271921,MATH 20E,B01,083773,Ciotti; Benjamin,20,0,35,15
1657488271921,MATH 20E,B02,083774,Ciotti; Benjamin,17,0,35,18
1657488277952,MATH 103A,A01,083777,Greenfeld; Be'Eri,3,0,36,33
1657488277952,MATH 103A,A02,083778,Greenfeld; Be'Eri,5,0,36,31
1657488277952,MATH 103A,A03,093561,Greenfeld; Be'Eri,5,0,36,31
1657488277952,MATH 103A,B01,083779,Greenfeld; Be'Eri,7,0,36,29
1657488277952,MATH 103A,B02,083780,Greenfeld; Be'Eri,4,0,36,32
1657488277952,MATH 103A,B03,093562,Greenfeld; Be'Eri,3,0,36,33
1657488283981,MATH 105,A01,085443,Carter; Anne Toulson,15,0,35,20
1657488283981,MATH 105,A02,093477,Carter; Anne Toulson,20,0,35,15
1657488290006,MATH 109,A01,083213,Ganzberger; Geoffrey Michael,2,0,34,32
1657488290006,MATH 109,A02,083214,Ganzberger; Geoffrey Michael,4,0,34,30
1657488290006,MATH 109,A03,093478,Ganzberger; Geoffrey Michael,2,0,34,32
1657488290006,MATH 109,B01,083215,Ganzberger; Geoffrey Michael,1,0,32,31
1657488290006,MATH 109,B02,083216,Ganzberger; Geoffrey Michael,2,0,32,30
1657488290006,MATH 109,B03,093479,Ganzberger; Geoffrey Michael,8,0,32,24
1657488296036,MATH 142A,A01,083219,Chow; Bennett,7,0,32,25
1657488296036,MATH 142A,A02,083220,Chow; Bennett,10,0,32,22
1657488296036,MATH 142A,A03,093480,Chow; Bennett,8,0,32,24
1657488296036,MATH 142A,B03,093481,Chow; Bennett,8,0,32,24
1657488296036,MATH 142A,B04,093558,Chow; Bennett,13,0,32,19
1657488296036,MATH 142A,B05,093559,Chow; Bennett,6,0,32,26
1657488302067,MATH 193A,A01,083224,Rotar; Vladimir,8,0,34,26
1657488302067,MATH 193A,A02,083225,Rotar; Vladimir,9,0,34,25
1657488302067,MATH 193A,A03,083781,Rotar; Vladimir,5,0,34,29
1657488302067,MATH 193A,A04,083782,Rotar; Vladimir,10,0,34,24
1657488302067,MATH 193A,A05,093482,Rotar; Vladimir,10,0,34,24
1657488308097,MATH 197,001,091859,McAuley; Julian John,9999,0,9999,0
1657488308097,MATH 197,002,095566,Kedlaya; Kiran S.,9997,0,9999,2
1657488308097,MATH 197,003,095567,Xiao; Ming,9999,0,9999,0
1657488308097,MATH 197,004,095571,Perols; Johan Lars,9998,0,9999,1
1657488315149,COGS 9,A01,083615,Shannon; Kyle Michael,9,0,75,66
1657488321173,COGS 11,A01,083617,Boyle; Mary E. T.,22,0,48,26
1657488327195,COGS 13,A01,083071,Bastos; Amalia Pinkusfeld,11,0,71,60
1657488333221,COGS 14A,A01,092681,Semenuks; Arturs,5,1,100,95
1657488339249,COGS 14B,A01,083073,Cheng; Tzu-Han,6,0,63,57
1657488345270,COGS 17,A01,092677,Semenuks; Arturs,6,0,81,75
1657488351332,COGS 100,A01,083619,Allen; Michael Gordon,17,0,70,53
1657488357356,COGS 101A,A01,083621,Davis; Joshua Daniel,9,0,68,59
1657488363381,COGS 101B,A01,091572,Allen; Michael Gordon,12,0,65,53
1657488369405,COGS 101C,A01,083625,Delgado; Tania,17,0,35,18
1657488375434,COGS 107A,A01,083627,Boyle; Mary E. T.,13,0,60,47
1657488381473,COGS 118A,A01,083075,Gupta; Anjum,21,0,76,55
1657488387502,CSE 3,A50,083646,Miranda; Gregory Joseph,24,0,50,26
1657488393527,CSE 8A,A50,083650,Miranda; Gregory Joseph,17,1,56,39
1657488399551,CSE 11,A01,083080,Cao; Yingjun,6,15,40,34
1657488405583,CSE 12,A01,083652,Krause-Levy; Sophia Louisa,28,1,120,92
1657488411619,CSE 15L,A01,083654,Morris; Justin Loren,9,0,50,41
1657488411619,CSE 15L,A02,083655,Morris; Justin Loren,9,0,50,41
1657488417643,CSE 20,A01,083657,Tran; Khoa Dang,39,0,80,41
1657488423672,CSE 21,A01,095574,Bach; Quang Tran,22,0,48,26
1657488429697,CSE 30,A01,083084,Eldon; John,5,0,80,75
1657488429697,CSE 30,B01,095061,Bhaskar; Nishant,9,0,50,41
1657488435724,CSE 100,A01,083659,Cao; Yingjun,5,4,70,65
1657488441752,CSE 134B,A01,083661,Powell; Thomas Allan,22,0,100,78
1657488447775,CSE 140,A01,083663,Gungor; Onat,15,0,85,70
1657488453802,CSE 140L,A01,083088,Eldon; John,21,0,100,79
1657488459830,CSE 175,A01,083665,Kumar; Rakesh,3,0,25,22
1657488465853,CSE 190,A00,092507,Dubnov; Shlomo,8,0,20,12
1657488471881,ECE 45,A01,083139,Congero; Spencer William,6,0,75,69
1657488477905,ECE 65,A50,083695,Saad; Andrew S,12,0,30,18
1657488477905,ECE 65,A51,095125,Saad; Andrew S,24,0,26,2
1657488483928,ECE 109,A01,091882,Touri; Behrouz,19,0,70,51
1657488489953,ECE 180,A00,083140,Abi Samra; Nicholas Camill,1,0,30,29
1657488489953,ECE 180,B00,083141,Abi Samra; Nicholas Camill,0,0,30,30
1657488495977,MATH 10A,A01,083735,Patchell; Gregory David,2,0,30,28
1657488495977,MATH 10A,A02,083736,Patchell; Gregory David,20,0,30,10
1657488495977,MATH 10A,A03,083737,Patchell; Gregory David,16,0,30,14
1657488502001,MATH 10B,A01,083207,Lim; Seonhee,8,0,34,26
1657488502001,MATH 10B,A02,083208,Lim; Seonhee,9,0,35,26
1657488502001,MATH 10B,A03,093472,Lim; Seonhee,7,0,34,27
1657488502001,MATH 10B,B01,083739,Sinha; Shubham,12,0,30,18
1657488508032,MATH 18,A01,083743,Cinel; Cameron Alexander,7,0,30,23
1657488508032,MATH 18,A02,083744,Cinel; Cameron Alexander,17,0,30,13
1657488508032,MATH 18,A03,083745,Cinel; Cameron Alexander,9,0,30,21
1657488508032,MATH 18,B01,083748,Rideout; David Porter,5,0,37,32
1657488508032,MATH 18,B02,083749,Rideout; David Porter,5,0,36,31
1657488508032,MATH 18,B03,083750,Rideout; David Porter,3,0,37,34
1657488508032,MATH 18,B04,083751,Rideout; David Porter,6,0,36,30
1657488508032,MATH 18,B05,093473,Rideout; David Porter,6,0,36,30
1657488508032,MATH 18,B06,093474,Rideout; David Porter,6,0,36,30
1657488514054,MATH 20A,A01,083754,Zheng; Zequn,14,0,40,26
1657488520083,MATH 20B,A01,083756,Briones; Jor-el Thomas Caparas,4,0,36,32
1657488520083,MATH 20B,A02,083757,Briones; Jor-el Thomas Caparas,1,0,36,35
1657488520083,MATH 20B,A03,093475,Briones; Jor-el Thomas Caparas,2,0,36,34
1657488526111,MATH 20C,A01,083760,Briones; Jor-el Thomas Caparas,1,0,35,34
1657488526111,MATH 20C,A02,083761,Briones; Jor-el Thomas Caparas,8,0,35,27
1657488526111,MATH 20C,A03,093476,Briones; Jor-el Thomas Caparas,0,1,36,36
1657488526111,MATH 20C,B01,083762,Bach; Quang Tran,1,0,30,29
1657488532135,MATH 20D,A01,083765,Tran; Brian Kha,5,0,30,25
1657488532135,MATH 20D,A02,083766,Tran; Brian Kha,5,0,30,25
1657488532135,MATH 20D,A03,083767,Tran; Brian Kha,5,0,30,25
1657488538160,MATH 20E,A01,083771,Ganguly; Soumya,9,0,32,23
1657488538160,MATH 20E,A02,083772,Ganguly; Soumya,6,0,32,26
1657488538160,MATH 20E,B01,083773,Ciotti; Benjamin,20,0,35,15
1657488538160,MATH 20E,B02,083774,Ciotti; Benjamin,17,0,35,18
1657488544184,MATH 103A,A01,083777,Greenfeld; Be'Eri,3,0,36,33
1657488544184,MATH 103A,A02,083778,Greenfeld; Be'Eri,5,0,36,31
1657488544184,MATH 103A,A03,093561,Greenfeld; Be'Eri,5,0,36,31
1657488544184,MATH 103A,B01,083779,Greenfeld; Be'Eri,7,0,36,29
1657488544184,MATH 103A,B02,083780,Greenfeld; Be'Eri,4,0,36,32
1657488544184,MATH 103A,B03,093562,Greenfeld; Be'Eri,3,0,36,33
1657488550211,MATH 105,A01,085443,Carter; Anne Toulson,15,0,35,20
1657488550211,MATH 105,A02,093477,Carter; Anne Toulson,20,0,35,15
1657488556240,MATH 109,A01,083213,Ganzberger; Geoffrey Michael,2,0,34,32
1657488556240,MATH 109,A02,083214,Ganzberger; Geoffrey Michael,4,0,34,30
1657488556240,MATH 109,A03,093478,Ganzberger; Geoffrey Michael,2,0,34,32
1657488556240,MATH 109,B01,083215,Ganzberger; Geoffrey Michael,1,0,32,31
1657488556240,MATH 109,B02,083216,Ganzberger; Geoffrey Michael,2,0,32,30
1657488556240,MATH 109,B03,093479,Ganzberger; Geoffrey Michael,8,0,32,24
1657488562270,MATH 142A,A01,083219,Chow; Bennett,7,0,32,25
1657488562270,MATH 142A,A02,083220,Chow; Bennett,10,0,32,22
1657488562270,MATH 142A,A03,093480,Chow; Bennett,8,0,32,24
1657488562270,MATH 142A,B03,093481,Chow; Bennett,8,0,32,24
1657488562270,MATH 142A,B04,093558,Chow; Bennett,13,0,32,19
1657488562270,MATH 142A,B05,093559,Chow; Bennett,6,0,32,26
1657488568294,MATH 193A,A01,083224,Rotar; Vladimir,8,0,34,26
1657488568294,MATH 193A,A02,083225,Rotar; Vladimir,9,0,34,25
1657488568294,MATH 193A,A03,083781,Rotar; Vladimir,5,0,34,29
1657488568294,MATH 193A,A04,083782,Rotar; Vladimir,10,0,34,24
1657488568294,MATH 193A,A05,093482,Rotar; Vladimir,10,0,34,24
1657488574317,MATH 197,001,091859,McAuley; Julian John,9999,0,9999,0
1657488574317,MATH 197,002,095566,Kedlaya; Kiran S.,9997,0,9999,2
1657488574317,MATH 197,003,095567,Xiao; Ming,9999,0,9999,0
1657488574317,MATH 197,004,095571,Perols; Johan Lars,9998,0,9999,1
1657488581370,COGS 9,A01,083615,Shannon; Kyle Michael,9,0,75,66
1657488587396,COGS 11,A01,083617,Boyle; Mary E. T.,22,0,48,26
1657488593424,COGS 13,A01,083071,Bastos; Amalia Pinkusfeld,11,0,71,60
1657488599448,COGS 14A,A01,092681,Semenuks; Arturs,5,1,100,95
1657488605470,COGS 14B,A01,083073,Cheng; Tzu-Han,6,0,63,57
1657488611492,COGS 17,A01,092677,Semenuks; Arturs,6,0,81,75
1657488617515,COGS 100,A01,083619,Allen; Michael Gordon,17,0,70,53
1657488623539,COGS 101A,A01,083621,Davis; Joshua Daniel,9,0,68,59
1657488629566,COGS 101B,A01,091572,Allen; Michael Gordon,12,0,65,53
1657488635593,COGS 101C,A01,083625,Delgado; Tania,17,0,35,18
1657488641616,COGS 107A,A01,083627,Boyle; Mary E. T.,13,0,60,47
1657488647640,COGS 118A,A01,083075,Gupta; Anjum,21,0,76,55
1657488653664,CSE 3,A50,083646,Miranda; Gregory Joseph,24,0,50,26
1657488659692,CSE 8A,A50,083650,Miranda; Gregory Joseph,17,1,56,39
1657488665735,CSE 11,A01,083080,Cao; Yingjun,6,15,40,34
1657488671759,CSE 12,A01,083652,Krause-Levy; Sophia Louisa,28,1,120,92
1657488677787,CSE 15L,A01,083654,Morris; Justin Loren,9,0,50,41
1657488677787,CSE 15L,A02,083655,Morris; Justin Loren,9,0,50,41
1657488683811,CSE 20,A01,083657,Tran; Khoa Dang,39,0,80,41
1657488689838,CSE 21,A01,095574,Bach; Quang Tran,22,0,48,26
1657488695872,CSE 30,A01,083084,Eldon; John,5,0,80,75
1657488695872,CSE 30,B01,095061,Bhaskar; Nishant,9,0,50,41
1657488701898,CSE 100,A01,083659,Cao; Yingjun,5,4,70,65
1657488707928,CSE 134B,A01,083661,Powell; Thomas Allan,22,0,100,78
1657488713953,CSE 140,A01,083663,Gungor; Onat,15,0,85,70
1657488719978,CSE 140L,A01,083088,Eldon; John,21,0,100,79
1657488726002,CSE 175,A01,083665,Kumar; Rakesh,3,0,25,22
1657488732026,CSE 190,A00,092507,Dubnov; Shlomo,8,0,20,12
1657488738054,ECE 45,A01,083139,Congero; Spencer William,6,0,75,69
1657488744079,ECE 65,A50,083695,Saad; Andrew S,12,0,30,18
1657488744079,ECE 65,A51,095125,Saad; Andrew S,24,0,26,2
1657488750103,ECE 109,A01,091882,Touri; Behrouz,19,0,70,51
1657488756126,ECE 180,A00,083140,Abi Samra; Nicholas Camill,1,0,30,29
1657488756126,ECE 180,B00,083141,Abi Samra; Nicholas Camill,0,0,30,30
1657488762154,MATH 10A,A01,083735,Patchell; Gregory David,2,0,30,28
1657488762154,MATH 10A,A02,083736,Patchell; Gregory David,20,0,30,10
1657488762154,MATH 10A,A03,083737,Patchell; Gregory David,16,0,30,14
1657488768185,MATH 10B,A01,083207,Lim; Seonhee,8,0,34,26
1657488768185,MATH 10B,A02,083208,Lim; Seonhee,9,0,35,26
1657488768185,MATH 10B,A03,093472,Lim; Seonhee,7,0,34,27
1657488768185,MATH 10B,B01,083739,Sinha; Shubham,12,0,30,18
1657488774219,MATH 18,A01,083743,Cinel; Cameron Alexander,7,0,30,23
1657488774219,MATH 18,A02,083744,Cinel; Cameron Alexander,17,0,30,13
1657488774219,MATH 18,A03,083745,Cinel; Cameron Alexander,9,0,30,21
1657488774219,MATH 18,B01,083748,Rideout; David Porter,5,0,37,32
1657488774219,MATH 18,B02,083749,Rideout; David Porter,5,0,36,31
1657488774219,MATH 18,B03,083750,Rideout; David Porter,3,0,37,34
1657488774219,MATH 18,B04,083751,Rideout; David Porter,6,0,36,30
1657488774219,MATH 18,B05,093473,Rideout; David Porter,6,0,36,30
1657488774219,MATH 18,B06,093474,Rideout; David Porter,6,0,36,30
1657488780252,MATH 20A,A01,083754,Zheng; Zequn,14,0,40,26
1657488786276,MATH 20B,A01,083756,Briones; Jor-el Thomas Caparas,4,0,36,32
1657488786276,MATH 20B,A02,083757,Briones; Jor-el Thomas Caparas,1,0,36,35
1657488786276,MATH 20B,A03,093475,Briones; Jor-el Thomas Caparas,2,0,36,34
1657488792301,MATH 20C,A01,083760,Briones; Jor-el Thomas Caparas,1,0,35,34
1657488792301,MATH 20C,A02,083761,Briones; Jor-el Thomas Caparas,8,0,35,27
1657488792301,MATH 20C,A03,093476,Briones; Jor-el Thomas Caparas,0,1,36,36
1657488792301,MATH 20C,B01,083762,Bach; Quang Tran,1,0,30,29
1657488798325,MATH 20D,A01,083765,Tran; Brian Kha,5,0,30,25
1657488798325,MATH 20D,A02,083766,Tran; Brian Kha,5,0,30,25
1657488798325,MATH 20D,A03,083767,Tran; Brian Kha,5,0,30,25
1657488804434,MATH 20E,A01,083771,Ganguly; Soumya,9,0,32,23
1657488804434,MATH 20E,A02,083772,Ganguly; Soumya,6,0,32,26
1657488804434,MATH 20E,B01,083773,Ciotti; Benjamin,20,0,35,15
1657488804434,MATH 20E,B02,083774,Ciotti; Benjamin,17,0,35,18
1657488810457,MATH 103A,A01,083777,Greenfeld; Be'Eri,3,0,36,33
1657488810457,MATH 103A,A02,083778,Greenfeld; Be'Eri,5,0,36,31
1657488810457,MATH 103A,A03,093561,Greenfeld; Be'Eri,5,0,36,31
1657488810457,MATH 103A,B01,083779,Greenfeld; Be'Eri,7,0,36,29
1657488810457,MATH 103A,B02,083780,Greenfeld; Be'Eri,4,0,36,32
1657488810457,MATH 103A,B03,093562,Greenfeld; Be'Eri,3,0,36,33
1657488816481,MATH 105,A01,085443,Carter; Anne Toulson,15,0,35,20
1657488816481,MATH 105,A02,093477,Carter; Anne Toulson,20,0,35,15
1657488822505,MATH 109,A01,083213,Ganzberger; Geoffrey Michael,2,0,34,32
1657488822505,MATH 109,A02,083214,Ganzberger; Geoffrey Michael,4,0,34,30
1657488822505,MATH 109,A03,093478,Ganzberger; Geoffrey Michael,2,0,34,32
1657488822505,MATH 109,B01,083215,Ganzberger; Geoffrey Michael,1,0,32,31
1657488822505,MATH 109,B02,083216,Ganzberger; Geoffrey Michael,2,0,32,30
1657488822505,MATH 109,B03,093479,Ganzberger; Geoffrey Michael,8,0,32,24
1657488828531,MATH 142A,A01,083219,Chow; Bennett,7,0,32,25
1657488828531,MATH 142A,A02,083220,Chow; Bennett,10,0,32,22
1657488828531,MATH 142A,A03,093480,Chow; Bennett,8,0,32,24
1657488828531,MATH 142A,B03,093481,Chow; Bennett,8,0,32,24
1657488828531,MATH 142A,B04,093558,Chow; Bennett,13,0,32,19
1657488828531,MATH 142A,B05,093559,Chow; Bennett,6,0,32,26
1657488834557,MATH 193A,A01,083224,Rotar; Vladimir,8,0,34,26
1657488834557,MATH 193A,A02,083225,Rotar; Vladimir,9,0,34,25
1657488834557,MATH 193A,A03,083781,Rotar; Vladimir,5,0,34,29
1657488834557,MATH 193A,A04,083782,Rotar; Vladimir,10,0,34,24
1657488834557,MATH 193A,A05,093482,Rotar; Vladimir,10,0,34,24
1657488840582,MATH 197,001,091859,McAuley; Julian John,9999,0,9999,0
1657488840582,MATH 197,002,095566,Kedlaya; Kiran S.,9997,0,9999,2
1657488840582,MATH 197,003,095567,Xiao; Ming,9999,0,9999,0
1657488840582,MATH 197,004,095571,Perols; Johan Lars,9998,0,9999,1
1657488847633,COGS 9,A01,083615,Shannon; Kyle Michael,9,0,75,66
1657488853657,COGS 11,A01,083617,Boyle; Mary E. T.,22,0,48,26
1657488859685,COGS 13,A01,083071,Bastos; Amalia Pinkusfeld,11,0,71,60
1657488865710,COGS 14A,A01,092681,Semenuks; Arturs,5,1,100,95
1657488871737,COGS 14B,A01,083073,Cheng; Tzu-Han,6,0,63,57
1657488877759,COGS 17,A01,092677,Semenuks; Arturs,6,0,81,75
1657488883796,COGS 100,A01,083619,Allen; Michael Gordon,17,0,70,53
1657488889822,COGS 101A,A01,083621,Davis; Joshua Daniel,9,0,68,59
1657488895844,COGS 101B,A01,091572,Allen; Michael Gordon,12,0,65,53
1657488901870,COGS 101C,A01,083625,Delgado; Tania,17,0,35,18
1657488907896,COGS 107A,A01,083627,Boyle; Mary E. T.,13,0,60,47
1657488913920,COGS 118A,A01,083075,Gupta; Anjum,21,0,76,55
1657488919944,CSE 3,A50,083646,Miranda; Gregory Joseph,24,0,50,26
1657488925966,CSE 8A,A50,083650,Miranda; Gregory Joseph,17,1,56,39
1657488931990,CSE 11,A01,083080,Cao; Yingjun,6,15,40,34
1657488938014,CSE 12,A01,083652,Krause-Levy; Sophia Louisa,28,1,120,92
1657488944037,CSE 15L,A01,083654,Morris; Justin Loren,9,0,50,41
1657488944037,CSE 15L,A02,083655,Morris; Justin Loren,9,0,50,41
1657488950061,CSE 20,A01,083657,Tran; Khoa Dang,39,0,80,41
1657488956088,CSE 21,A01,095574,Bach; Quang Tran,22,0,48,26
1657488962118,CSE 30,A01,083084,Eldon; John,5,0,80,75
1657488962118,CSE 30,B01,095061,Bhaskar; Nishant,9,0,50,41
1657488968144,CSE 100,A01,083659,Cao; Yingjun,5,4,70,65
1657488974168,CSE 134B,A01,083661,Powell; Thomas Allan,22,0,100,78
1657488980190,CSE 140,A01,083663,Gungor; Onat,15,0,85,70
1657488986215,CSE 140L,A01,083088,Eldon; John,21,0,100,79
1657488992237,CSE 175,A01,083665,Kumar; Rakesh,3,0,25,22
1657488998260,CSE 190,A00,092507,Dubnov; Shlomo,8,0,20,12
1657489004287,ECE 45,A01,083139,Congero; Spencer William,6,0,75,69
1657489010311,ECE 65,A50,083695,Saad; Andrew S,12,0,30,18
1657489010311,ECE 65,A51,095125,Saad; Andrew S,24,0,26,2
1657489016337,ECE 109,A01,091882,Touri; Behrouz,19,0,70,51
1657489022369,ECE 180,A00,083140,Abi Samra; Nicholas Camill,1,0,30,29
1657489022369,ECE 180,B00,083141,Abi Samra; Nicholas Camill,0,0,30,30
1657489028392,MATH 10A,A01,083735,Patchell; Gregory David,2,0,30,28
1657489028392,MATH 10A,A02,083736,Patchell; Gregory David,20,0,30,10
1657489028392,MATH 10A,A03,083737,Patchell; Gregory David,16,0,30,14
1657489034423,MATH 10B,A01,083207,Lim; Seonhee,8,0,34,26
1657489034423,MATH 10B,A02,083208,Lim; Seonhee,9,0,35,26
1657489034423,MATH 10B,A03,093472,Lim; Seonhee,7,0,34,27
1657489034423,MATH 10B,B01,083739,Sinha; Shubham,12,0,30,18
1657489040453,MATH 18,A01,083743,Cinel; Cameron Alexander,7,0,30,23
1657489040453,MATH 18,A02,083744,Cinel; Cameron Alexander,17,0,30,13
1657489040453,MATH 18,A03,083745,Cinel; Cameron Alexander,9,0,30,21
1657489040453,MATH 18,B01,083748,Rideout; David Porter,5,0,37,32
1657489040453,MATH 18,B02,083749,Rideout; David Porter,5,0,36,31
1657489040453,MATH 18,B03,083750,Rideout; David Porter,3,0,37,34
1657489040453,MATH 18,B04,083751,Rideout; David Porter,6,0,36,30
1657489040453,MATH 18,B05,093473,Rideout; David Porter,6,0,36,30
1657489040453,MATH 18,B06,093474,Rideout; David Porter,6,0,36,30
1657489046475,MATH 20A,A01,083754,Zheng; Zequn,14,0,40,26
1657489052499,MATH 20B,A01,083756,Briones; Jor-el Thomas Caparas,4,0,36,32
1657489052499,MATH 20B,A02,083757,Briones; Jor-el Thomas Caparas,1,0,36,35
1657489052499,MATH 20B,A03,093475,Briones; Jor-el Thomas Caparas,2,0,36,34
1657489058523,MATH 20C,A01,083760,Briones; Jor-el Thomas Caparas,1,0,35,34
1657489058523,MATH 20C,A02,083761,Briones; Jor-el Thomas Caparas,8,0,35,27
1657489058523,MATH 20C,A03,093476,Briones; Jor-el Thomas Caparas,0,1,36,36
1657489058523,MATH 20C,B01,083762,Bach; Quang Tran,1,0,30,29
1657489064551,MATH 20D,A01,083765,Tran; Brian Kha,5,0,30,25
1657489064551,MATH 20D,A02,083766,Tran; Brian Kha,5,0,30,25
1657489064551,MATH 20D,A03,083767,Tran; Brian Kha,5,0,30,25
1657489070576,MATH 20E,A01,083771,Ganguly; Soumya,9,0,32,23
1657489070576,MATH 20E,A02,083772,Ganguly; Soumya,6,0,32,26
1657489070576,MATH 20E,B01,083773,Ciotti; Benjamin,20,0,35,15
1657489070576,MATH 20E,B02,083774,Ciotti; Benjamin,17,0,35,18
1657489076599,MATH 103A,A01,083777,Greenfeld; Be'Eri,3,0,36,33
1657489076599,MATH 103A,A02,083778,Greenfeld; Be'Eri,5,0,36,31
1657489076599,MATH 103A,A03,093561,Greenfeld; Be'Eri,5,0,36,31
1657489076599,MATH 103A,B01,083779,Greenfeld; Be'Eri,7,0,36,29
1657489076599,MATH 103A,B02,083780,Greenfeld; Be'Eri,4,0,36,32
1657489076599,MATH 103A,B03,093562,Greenfeld; Be'Eri,3,0,36,33
1657489082633,MATH 105,A01,085443,Carter; Anne Toulson,15,0,35,20
1657489082633,MATH 105,A02,093477,Carter; Anne Toulson,20,0,35,15
1657489088663,MATH 109,A01,083213,Ganzberger; Geoffrey Michael,2,0,34,32
1657489088663,MATH 109,A02,083214,Ganzberger; Geoffrey Michael,4,0,34,30
1657489088663,MATH 109,A03,093478,Ganzberger; Geoffrey Michael,2,0,34,32
1657489088663,MATH 109,B01,083215,Ganzberger; Geoffrey Michael,1,0,32,31
1657489088663,MATH 109,B02,083216,Ganzberger; Geoffrey Michael,2,0,32,30
1657489088663,MATH 109,B03,093479,Ganzberger; Geoffrey Michael,8,0,32,24
1657489094691,MATH 142A,A01,083219,Chow; Bennett,7,0,32,25
1657489094691,MATH 142A,A02,083220,Chow; Bennett,10,0,32,22
1657489094691,MATH 142A,A03,093480,Chow; Bennett,8,0,32,24
1657489094691,MATH 142A,B03,093481,Chow; Bennett,8,0,32,24
1657489094691,MATH 142A,B04,093558,Chow; Bennett,13,0,32,19
1657489094691,MATH 142A,B05,093559,Chow; Bennett,6,0,32,26
1657489100713,MATH 193A,A01,083224,Rotar; Vladimir,8,0,34,26
1657489100713,MATH 193A,A02,083225,Rotar; Vladimir,9,0,34,25
1657489100713,MATH 193A,A03,083781,Rotar; Vladimir,5,0,34,29
1657489100713,MATH 193A,A04,083782,Rotar; Vladimir,10,0,34,24
1657489100713,MATH 193A,A05,093482,Rotar; Vladimir,10,0,34,24
1657489106735,MATH 197,001,091859,McAuley; Julian John,9999,0,9999,0
1657489106735,MATH 197,002,095566,Kedlaya; Kiran S.,9997,0,9999,2
1657489106735,MATH 197,003,095567,Xiao; Ming,9999,0,9999,0
1657489106735,MATH 197,004,095571,Perols; Johan Lars,9998,0,9999,1
1657489113794,COGS 9,A01,083615,Shannon; Kyle Michael,9,0,75,66
1657489119816,COGS 11,A01,083617,Boyle; Mary E. T.,22,0,48,26
1657489125838,COGS 13,A01,083071,Bastos; Amalia Pinkusfeld,11,0,71,60
1657489131865,COGS 14A,A01,092681,Semenuks; Arturs,5,1,100,95
1657489137889,COGS 14B,A01,083073,Cheng; Tzu-Han,6,0,63,57
1657489143914,COGS 17,A01,092677,Semenuks; Arturs,6,0,81,75
1657489149936,COGS 100,A01,083619,Allen; Michael Gordon,17,0,70,53
1657489155959,COGS 101A,A01,083621,Davis; Joshua Daniel,9,0,68,59
1657489161981,COGS 101B,A01,091572,Allen; Michael Gordon,12,0,65,53
1657489168006,COGS 101C,A01,083625,Delgado; Tania,17,0,35,18
1657489174031,COGS 107A,A01,083627,Boyle; Mary E. T.,13,0,60,47
1657489180055,COGS 118A,A01,083075,Gupta; Anjum,21,0,76,55
1657489186084,CSE 3,A50,083646,Miranda; Gregory Joseph,24,0,50,26
1657489192108,CSE 8A,A50,083650,Miranda; Gregory Joseph,17,1,56,39
1657489198132,CSE 11,A01,083080,Cao; Yingjun,6,15,40,34
1657489204156,CSE 12,A01,083652,Krause-Levy; Sophia Louisa,28,1,120,92
1657489210182,CSE 15L,A01,083654,Morris; Justin Loren,9,0,50,41
1657489210182,CSE 15L,A02,083655,Morris; Justin Loren,9,0,50,41
1657489216204,CSE 20,A01,083657,Tran; Khoa Dang,39,0,80,41
1657489222228,CSE 21,A01,095574,Bach; Quang Tran,22,0,48,26
1657489228251,CSE 30,A01,083084,Eldon; John,5,0,80,75
1657489228251,CSE 30,B01,095061,Bhaskar; Nishant,9,0,50,41
1657489234283,CSE 100,A01,083659,Cao; Yingjun,5,4,70,65
1657489240307,CSE 134B,A01,083661,Powell; Thomas Allan,22,0,100,78
1657489246329,CSE 140,A01,083663,Gungor; Onat,15,0,85,70
1657489252357,CSE 140L,A01,083088,Eldon; John,21,0,100,79
1657489258381,CSE 175,A01,083665,Kumar; Rakesh,3,0,25,22
1657489264405,CSE 190,A00,092507,Dubnov; Shlomo,8,0,20,12
1657489270432,ECE 45,A01,083139,Congero; Spencer William,6,0,75,69
1657489276456,ECE 65,A50,083695,Saad; Andrew S,12,0,30,18
1657489276456,ECE 65,A51,095125,Saad; Andrew S,24,0,26,2
1657489282478,ECE 109,A01,091882,Touri; Behrouz,19,0,70,51
1657489288500,ECE 180,A00,083140,Abi Samra; Nicholas Camill,1,0,30,29
1657489288500,ECE 180,B00,083141,Abi Samra; Nicholas Camill,0,0,30,30
1657489294525,MATH 10A,A01,083735,Patchell; Gregory David,2,0,30,28
1657489294525,MATH 10A,A02,083736,Patchell; Gregory David,20,0,30,10
1657489294525,MATH 10A,A03,083737,Patchell; Gregory David,16,0,30,14
1657489300554,MATH 10B,A01,083207,Lim; Seonhee,8,0,34,26
1657489300554,MATH 10B,A02,083208,Lim; Seonhee,9,0,35,26
1657489300554,MATH 10B,A03,093472,Lim; Seonhee,7,0,34,27
1657489300554,MATH 10B,B01,083739,Sinha; Shubham,12,0,30,18
1657489306585,MATH 18,A01,083743,Cinel; Cameron Alexander,7,0,30,23
1657489306585,MATH 18,A02,083744,Cinel; Cameron Alexander,17,0,30,13
1657489306585,MATH 18,A03,083745,Cinel; Cameron Alexander,9,0,30,21
1657489306585,MATH 18,B01,083748,Rideout; David Porter,5,0,37,32
1657489306585,MATH 18,B02,083749,Rideout; David Porter,5,0,36,31
1657489306585,MATH 18,B03,083750,Rideout; David Porter,3,0,37,34
1657489306585,MATH 18,B04,083751,Rideout; David Porter,6,0,36,30
1657489306585,MATH 18,B05,093473,Rideout; David Porter,6,0,36,30
1657489306585,MATH 18,B06,093474,Rideout; David Porter,6,0,36,30
1657489312609,MATH 20A,A01,083754,Zheng; Zequn,14,0,40,26
1657489318644,MATH 20B,A01,083756,Briones; Jor-el Thomas Caparas,4,0,36,32
1657489318644,MATH 20B,A02,083757,Briones; Jor-el Thomas Caparas,1,0,36,35
1657489318644,MATH 20B,A03,093475,Briones; Jor-el Thomas Caparas,2,0,36,34
1657489324669,MATH 20C,A01,083760,Briones; Jor-el Thomas Caparas,1,0,35,34
1657489324669,MATH 20C,A02,083761,Briones; Jor-el Thomas Caparas,8,0,35,27
1657489324669,MATH 20C,A03,093476,Briones; Jor-el Thomas Caparas,0,1,36,36
1657489324669,MATH 20C,B01,083762,Bach; Quang Tran,1,0,30,29
1657489330693,MATH 20D,A01,083765,Tran; Brian Kha,5,0,30,25
1657489330693,MATH 20D,A02,083766,Tran; Brian Kha,5,0,30,25
1657489330693,MATH 20D,A03,083767,Tran; Brian Kha,5,0,30,25
1657489336719,MATH 20E,A01,083771,Ganguly; Soumya,9,0,32,23
1657489336719,MATH 20E,A02,083772,Ganguly; Soumya,6,0,32,26
1657489336719,MATH 20E,B01,083773,Ciotti; Benjamin,20,0,35,15
1657489336719,MATH 20E,B02,083774,Ciotti; Benjamin,17,0,35,18
1657489342741,MATH 103A,A01,083777,Greenfeld; Be'Eri,3,0,36,33
1657489342741,MATH 103A,A02,083778,Greenfeld; Be'Eri,5,0,36,31
1657489342741,MATH 103A,A03,093561,Greenfeld; Be'Eri,5,0,36,31
1657489342741,MATH 103A,B01,083779,Greenfeld; Be'Eri,7,0,36,29
1657489342741,MATH 103A,B02,083780,Greenfeld; Be'Eri,4,0,36,32
1657489342741,MATH 103A,B03,093562,Greenfeld; Be'Eri,3,0,36,33
1657489348771,MATH 105,A01,085443,Carter; Anne Toulson,15,0,35,20
1657489348771,MATH 105,A02,093477,Carter; Anne Toulson,20,0,35,15
1657489354798,MATH 109,A01,083213,Ganzberger; Geoffrey Michael,2,0,34,32
1657489354798,MATH 109,A02,083214,Ganzberger; Geoffrey Michael,4,0,34,30
1657489354798,MATH 109,A03,093478,Ganzberger; Geoffrey Michael,2,0,34,32
1657489354798,MATH 109,B01,083215,Ganzberger; Geoffrey Michael,1,0,32,31
1657489354798,MATH 109,B02,083216,Ganzberger; Geoffrey Michael,2,0,32,30
1657489354798,MATH 109,B03,093479,Ganzberger; Geoffrey Michael,8,0,32,24
1657489360825,MATH 142A,A01,083219,Chow; Bennett,7,0,32,25
1657489360825,MATH 142A,A02,083220,Chow; Bennett,10,0,32,22
1657489360825,MATH 142A,A03,093480,Chow; Bennett,8,0,32,24
1657489360825,MATH 142A,B03,093481,Chow; Bennett,8,0,32,24
1657489360825,MATH 142A,B04,093558,Chow; Bennett,13,0,32,19
1657489360825,MATH 142A,B05,093559,Chow; Bennett,6,0,32,26
1657489366850,MATH 193A,A01,083224,Rotar; Vladimir,8,0,34,26
1657489366850,MATH 193A,A02,083225,Rotar; Vladimir,9,0,34,25
1657489366850,MATH 193A,A03,083781,Rotar; Vladimir,5,0,34,29
1657489366850,MATH 193A,A04,083782,Rotar; Vladimir,10,0,34,24
1657489366850,MATH 193A,A05,093482,Rotar; Vladimir,10,0,34,24
1657489372877,MATH 197,001,091859,McAuley; Julian John,9999,0,9999,0
1657489372877,MATH 197,002,095566,Kedlaya; Kiran S.,9997,0,9999,2
1657489372877,MATH 197,003,095567,Xiao; Ming,9999,0,9999,0
1657489372877,MATH 197,004,095571,Perols; Johan Lars,9998,0,9999,1
1657489379940,COGS 9,A01,083615,Shannon; Kyle Michael,9,0,75,66
1657489385965,COGS 11,A01,083617,Boyle; Mary E. T.,22,0,48,26
1657489391992,COGS 13,A01,083071,Bastos; Amalia Pinkusfeld,11,0,71,60
1657489398106,COGS 14A,A01,092681,Semenuks; Arturs,5,1,100,95
1657489404129,COGS 14B,A01,083073,Cheng; Tzu-Han,6,0,63,57
1657489410153,COGS 17,A01,092677,Semenuks; Arturs,6,0,81,75
1657489416178,COGS 100,A01,083619,Allen; Michael Gordon,17,0,70,53
1657489422201,COGS 101A,A01,083621,Davis; Joshua Daniel,9,0,68,59
1657489428223,COGS 101B,A01,091572,Allen; Michael Gordon,12,0,65,53
1657489434247,COGS 101C,A01,083625,Delgado; Tania,17,0,35,18
1657489440282,COGS 107A,A01,083627,Boyle; Mary E. T.,13,0,60,47
1657489446309,COGS 118A,A01,083075,Gupta; Anjum,21,0,76,55
1657489452332,CSE 3,A50,083646,Miranda; Gregory Joseph,24,0,50,26
1657489458354,CSE 8A,A50,083650,Miranda; Gregory Joseph,17,1,56,39
1657489464378,CSE 11,A01,083080,Cao; Yingjun,6,15,40,34
1657489470404,CSE 12,A01,083652,Krause-Levy; Sophia Louisa,28,1,120,92
1657489476429,CSE 15L,A01,083654,Morris; Justin Loren,9,0,50,41
1657489476429,CSE 15L,A02,083655,Morris; Justin Loren,9,0,50,41
1657489482450,CSE 20,A01,083657,Tran; Khoa Dang,39,0,80,41
1657489488472,CSE 21,A01,095574,Bach; Quang Tran,22,0,48,26
1657489494499,CSE 30,A01,083084,Eldon; John,5,0,80,75
1657489494499,CSE 30,B01,095061,Bhaskar; Nishant,9,0,50,41
1657489500525,CSE 100,A01,083659,Cao; Yingjun,5,4,70,65
1657489506548,CSE 134B,A01,083661,Powell; Thomas Allan,22,0,100,78
1657489512574,CSE 140,A01,083663,Gungor; Onat,15,0,85,70
1657489518597,CSE 140L,A01,083088,Eldon; John,21,0,100,79
1657489524619,CSE 175,A01,083665,Kumar; Rakesh,3,0,25,22
1657489530645,CSE 190,A00,092507,Dubnov; Shlomo,8,0,20,12
1657489536672,ECE 45,A01,083139,Congero; Spencer William,6,0,75,69
1657489542702,ECE 65,A50,083695,Saad; Andrew S,12,0,30,18
1657489542702,ECE 65,A51,095125,Saad; Andrew S,24,0,26,2
1657489548730,ECE 109,A01,091882,Touri; Behrouz,19,0,70,51
1657489554754,ECE 180,A00,083140,Abi Samra; Nicholas Camill,1,0,30,29
1657489554754,ECE 180,B00,083141,Abi Samra; Nicholas Camill,0,0,30,30
1657489560777,MATH 10A,A01,083735,Patchell; Gregory David,2,0,30,28
1657489560777,MATH 10A,A02,083736,Patchell; Gregory David,20,0,30,10
1657489560777,MATH 10A,A03,083737,Patchell; Gregory David,16,0,30,14
1657489566805,MATH 10B,A01,083207,Lim; Seonhee,8,0,34,26
1657489566805,MATH 10B,A02,083208,Lim; Seonhee,9,0,35,26
1657489566805,MATH 10B,A03,093472,Lim; Seonhee,7,0,34,27
1657489566805,MATH 10B,B01,083739,Sinha; Shubham,12,0,30,18
1657489572829,MATH 18,A01,083743,Cinel; Cameron Alexander,7,0,30,23
1657489572829,MATH 18,A02,083744,Cinel; Cameron Alexander,17,0,30,13
1657489572829,MATH 18,A03,083745,Cinel; Cameron Alexander,9,0,30,21
1657489572829,MATH 18,B01,083748,Rideout; David Porter,5,0,37,32
1657489572829,MATH 18,B02,083749,Rideout; David Porter,5,0,36,31
1657489572829,MATH 18,B03,083750,Rideout; David Porter,3,0,37,34
1657489572829,MATH 18,B04,083751,Rideout; David Porter,6,0,36,30
1657489572829,MATH 18,B05,093473,Rideout; David Porter,6,0,36,30
1657489572829,MATH 18,B06,093474,Rideout; David Porter,6,0,36,30
1657489578854,MATH 20A,A01,083754,Zheng; Zequn,14,0,40,26
1657489584877,MATH 20B,A01,083756,Briones; Jor-el Thomas Caparas,4,0,36,32
1657489584877,MATH 20B,A02,083757,Briones; Jor-el Thomas Caparas,1,0,36,35
1657489584877,MATH 20B,A03,093475,Briones; Jor-el Thomas Caparas,2,0,36,34
1657489590906,MATH 20C,A01,083760,Briones; Jor-el Thomas Caparas,1,0,35,34
1657489590906,MATH 20C,A02,083761,Briones; Jor-el Thomas Caparas,8,0,35,27
1657489590906,MATH 20C,A03,093476,Briones; Jor-el Thomas Caparas,0,1,36,36
1657489590906,MATH 20C,B01,083762,Bach; Quang Tran,1,0,30,29
1657489596930,MATH 20D,A01,083765,Tran; Brian Kha,5,0,30,25
1657489596930,MATH 20D,A02,083766,Tran; Brian Kha,5,0,30,25
1657489596930,MATH 20D,A03,083767,Tran; Brian Kha,5,0,30,25
1657489602956,MATH 20E,A01,083771,Ganguly; Soumya,9,0,32,23
1657489602956,MATH 20E,A02,083772,Ganguly; Soumya,6,0,32,26
1657489602956,MATH 20E,B01,083773,Ciotti; Benjamin,20,0,35,15
1657489602956,MATH 20E,B02,083774,Ciotti; Benjamin,17,0,35,18
1657489608988,MATH 103A,A01,083777,Greenfeld; Be'Eri,3,0,36,33
1657489608988,MATH 103A,A02,083778,Greenfeld; Be'Eri,5,0,36,31
1657489608988,MATH 103A,A03,093561,Greenfeld; Be'Eri,5,0,36,31
1657489608988,MATH 103A,B01,083779,Greenfeld; Be'Eri,7,0,36,29
1657489608988,MATH 103A,B02,083780,Greenfeld; Be'Eri,4,0,36,32
1657489608988,MATH 103A,B03,093562,Greenfeld; Be'Eri,3,0,36,33
1657489615024,MATH 105,A01,085443,Carter; Anne Toulson,15,0,35,20
1657489615024,MATH 105,A02,093477,Carter; Anne Toulson,20,0,35,15
1657489621048,MATH 109,A01,083213,Ganzberger; Geoffrey Michael,2,0,34,32
1657489621048,MATH 109,A02,083214,Ganzberger; Geoffrey Michael,4,0,34,30
1657489621048,MATH 109,A03,093478,Ganzberger; Geoffrey Michael,2,0,34,32
1657489621048,MATH 109,B01,083215,Ganzberger; Geoffrey Michael,1,0,32,31
1657489621048,MATH 109,B02,083216,Ganzberger; Geoffrey Michael,2,0,32,30
1657489621048,MATH 109,B03,093479,Ganzberger; Geoffrey Michael,8,0,32,24
1657489627077,MATH 142A,A01,083219,Chow; Bennett,7,0,32,25
1657489627077,MATH 142A,A02,083220,Chow; Bennett,10,0,32,22
1657489627077,MATH 142A,A03,093480,Chow; Bennett,8,0,32,24
1657489627077,MATH 142A,B03,093481,Chow; Bennett,8,0,32,24
1657489627077,MATH 142A,B04,093558,Chow; Bennett,13,0,32,19
1657489627077,MATH 142A,B05,093559,Chow; Bennett,6,0,32,26
1657489633101,MATH 193A,A01,083224,Rotar; Vladimir,8,0,34,26
1657489633101,MATH 193A,A02,083225,Rotar; Vladimir,9,0,34,25
1657489633101,MATH 193A,A03,083781,Rotar; Vladimir,5,0,34,29
1657489633101,MATH 193A,A04,083782,Rotar; Vladimir,10,0,34,24
1657489633101,MATH 193A,A05,093482,Rotar; Vladimir,10,0,34,24
1657489639127,MATH 197,001,091859,McAuley; Julian John,9999,0,9999,0
1657489639127,MATH 197,002,095566,Kedlaya; Kiran S.,9997,0,9999,2
1657489639127,MATH 197,003,095567,Xiao; Ming,9999,0,9999,0
1657489639127,MATH 197,004,095571,Perols; Johan Lars,9998,0,9999,1
1657489646191,COGS 9,A01,083615,Shannon; Kyle Michael,9,0,75,66
1657489652219,COGS 11,A01,083617,Boyle; Mary E. T.,22,0,48,26
1657489658240,COGS 13,A01,083071,Bastos; Amalia Pinkusfeld,11,0,71,60
1657489664267,COGS 14A,A01,092681,Semenuks; Arturs,5,1,100,95
1657489670297,COGS 14B,A01,083073,Cheng; Tzu-Han,6,0,63,57
1657489676322,COGS 17,A01,092677,Semenuks; Arturs,6,0,81,75
1657489682346,COGS 100,A01,083619,Allen; Michael Gordon,17,0,70,53
1657489688373,COGS 101A,A01,083621,Davis; Joshua Daniel,9,0,68,59
1657489694401,COGS 101B,A01,091572,Allen; Michael Gordon,12,0,65,53
1657489700429,COGS 101C,A01,083625,Delgado; Tania,17,0,35,18
1657489706453,COGS 107A,A01,083627,Boyle; Mary E. T.,13,0,60,47
1657489712475,COGS 118A,A01,083075,Gupta; Anjum,21,0,76,55
1657489718503,CSE 3,A50,083646,Miranda; Gregory Joseph,24,0,50,26
1657489724527,CSE 8A,A50,083650,Miranda; Gregory Joseph,17,1,56,39
1657489730553,CSE 11,A01,083080,Cao; Yingjun,6,15,40,34
1657489736587,CSE 12,A01,083652,Krause-Levy; Sophia Louisa,28,1,120,92
1657489742612,CSE 15L,A01,083654,Morris; Justin Loren,9,0,50,41
1657489742612,CSE 15L,A02,083655,Morris; Justin Loren,9,0,50,41
1657489748636,CSE 20,A01,083657,Tran; Khoa Dang,39,0,80,41
1657489754663,CSE 21,A01,095574,Bach; Quang Tran,22,0,48,26
1657489760686,CSE 30,A01,083084,Eldon; John,5,0,80,75
1657489760686,CSE 30,B01,095061,Bhaskar; Nishant,9,0,50,41
1657489766710,CSE 100,A01,083659,Cao; Yingjun,5,4,70,65
1657489772735,CSE 134B,A01,083661,Powell; Thomas Allan,22,0,100,78
1657489778761,CSE 140,A01,083663,Gungor; Onat,15,0,85,70
1657489784784,CSE 140L,A01,083088,Eldon; John,21,0,100,79
1657489790815,CSE 175,A01,083665,Kumar; Rakesh,3,0,25,22
1657489796847,CSE 190,A00,092507,Dubnov; Shlomo,8,0,20,12
1657489802877,ECE 45,A01,083139,Congero; Spencer William,6,0,75,69
1657489808904,ECE 65,A50,083695,Saad; Andrew S,12,0,30,18
1657489808904,ECE 65,A51,095125,Saad; Andrew S,24,0,26,2
1657489814926,ECE 109,A01,091882,Touri; Behrouz,19,0,70,51
1657489820956,ECE 180,A00,083140,Abi Samra; Nicholas Camill,1,0,30,29
1657489820956,ECE 180,B00,083141,Abi Samra; Nicholas Camill,0,0,30,30
1657489826998,MATH 10A,A01,083735,Patchell; Gregory David,2,0,30,28
1657489826998,MATH 10A,A02,083736,Patchell; Gregory David,20,0,30,10
1657489826998,MATH 10A,A03,083737,Patchell; Gregory David,16,0,30,14
1657489833020,MATH 10B,A01,083207,Lim; Seonhee,8,0,34,26
1657489833020,MATH 10B,A02,083208,Lim; Seonhee,9,0,35,26
1657489833020,MATH 10B,A03,093472,Lim; Seonhee,7,0,34,27
1657489833020,MATH 10B,B01,083739,Sinha; Shubham,12,0,30,18
1657489839056,MATH 18,A01,083743,Cinel; Cameron Alexander,7,0,30,23
1657489839056,MATH 18,A02,083744,Cinel; Cameron Alexander,17,0,30,13
1657489839056,MATH 18,A03,083745,Cinel; Cameron Alexander,9,0,30,21
1657489839056,MATH 18,B01,083748,Rideout; David Porter,5,0,37,32
1657489839056,MATH 18,B02,083749,Rideout; David Porter,5,0,36,31
1657489839056,MATH 18,B03,083750,Rideout; David Porter,3,0,37,34
1657489839056,MATH 18,B04,083751,Rideout; David Porter,6,0,36,30
1657489839056,MATH 18,B05,093473,Rideout; David Porter,6,0,36,30
1657489839056,MATH 18,B06,093474,Rideout; David Porter,6,0,36,30
1657489845084,MATH 20A,A01,083754,Zheng; Zequn,14,0,40,26
1657489851111,MATH 20B,A01,083756,Briones; Jor-el Thomas Caparas,4,0,36,32
1657489851111,MATH 20B,A02,083757,Briones; Jor-el Thomas Caparas,1,0,36,35
1657489851111,MATH 20B,A03,093475,Briones; Jor-el Thomas Caparas,2,0,36,34
1657489857142,MATH 20C,A01,083760,Briones; Jor-el Thomas Caparas,1,0,35,34
1657489857142,MATH 20C,A02,083761,Briones; Jor-el Thomas Caparas,8,0,35,27
1657489857142,MATH 20C,A03,093476,Briones; Jor-el Thomas Caparas,0,1,36,36
1657489857142,MATH 20C,B01,083762,Bach; Quang Tran,1,0,30,29
1657489863171,MATH 20D,A01,083765,Tran; Brian Kha,5,0,30,25
1657489863171,MATH 20D,A02,083766,Tran; Brian Kha,5,0,30,25
1657489863171,MATH 20D,A03,083767,Tran; Brian Kha,5,0,30,25
1657489869193,MATH 20E,A01,083771,Ganguly; Soumya,9,0,32,23
1657489869193,MATH 20E,A02,083772,Ganguly; Soumya,6,0,32,26
1657489869193,MATH 20E,B01,083773,Ciotti; Benjamin,20,0,35,15
1657489869193,MATH 20E,B02,083774,Ciotti; Benjamin,17,0,35,18
1657489875217,MATH 103A,A01,083777,Greenfeld; Be'Eri,3,0,36,33
1657489875217,MATH 103A,A02,083778,Greenfeld; Be'Eri,5,0,36,31
1657489875217,MATH 103A,A03,093561,Greenfeld; Be'Eri,5,0,36,31
1657489875217,MATH 103A,B01,083779,Greenfeld; Be'Eri,7,0,36,29
1657489875217,MATH 103A,B02,083780,Greenfeld; Be'Eri,4,0,36,32
1657489875217,MATH 103A,B03,093562,Greenfeld; Be'Eri,3,0,36,33
1657489881246,MATH 105,A01,085443,Carter; Anne Toulson,15,0,35,20
1657489881246,MATH 105,A02,093477,Carter; Anne Toulson,20,0,35,15
1657489887284,MATH 109,A01,083213,Ganzberger; Geoffrey Michael,2,0,34,32
1657489887284,MATH 109,A02,083214,Ganzberger; Geoffrey Michael,4,0,34,30
1657489887284,MATH 109,A03,093478,Ganzberger; Geoffrey Michael,2,0,34,32
1657489887284,MATH 109,B01,083215,Ganzberger; Geoffrey Michael,1,0,32,31
1657489887284,MATH 109,B02,083216,Ganzberger; Geoffrey Michael,2,0,32,30
1657489887284,MATH 109,B03,093479,Ganzberger; Geoffrey Michael,8,0,32,24
1657489893307,MATH 142A,A01,083219,Chow; Bennett,7,0,32,25
1657489893307,MATH 142A,A02,083220,Chow; Bennett,10,0,32,22
1657489893307,MATH 142A,A03,093480,Chow; Bennett,8,0,32,24
1657489893307,MATH 142A,B03,093481,Chow; Bennett,8,0,32,24
1657489893307,MATH 142A,B04,093558,Chow; Bennett,13,0,32,19
1657489893307,MATH 142A,B05,093559,Chow; Bennett,6,0,32,26
1657489899331,MATH 193A,A01,083224,Rotar; Vladimir,8,0,34,26
1657489899331,MATH 193A,A02,083225,Rotar; Vladimir,9,0,34,25
1657489899331,MATH 193A,A03,083781,Rotar; Vladimir,5,0,34,29
1657489899331,MATH 193A,A04,083782,Rotar; Vladimir,10,0,34,24
1657489899331,MATH 193A,A05,093482,Rotar; Vladimir,10,0,34,24
1657489905358,MATH 197,001,091859,McAuley; Julian John,9999,0,9999,0
1657489905358,MATH 197,002,095566,Kedlaya; Kiran S.,9997,0,9999,2
1657489905358,MATH 197,003,095567,Xiao; Ming,9999,0,9999,0
1657489905358,MATH 197,004,095571,Perols; Johan Lars,9998,0,9999,1
1657489912422,COGS 9,A01,083615,Shannon; Kyle Michael,9,0,75,66
1657489918445,COGS 11,A01,083617,Boyle; Mary E. T.,22,0,48,26
1657489924468,COGS 13,A01,083071,Bastos; Amalia Pinkusfeld,11,0,71,60
1657489930494,COGS 14A,A01,092681,Semenuks; Arturs,5,1,100,95
1657489936522,COGS 14B,A01,083073,Cheng; Tzu-Han,6,0,63,57
1657489942545,COGS 17,A01,092677,Semenuks; Arturs,6,0,81,75
1657489948588,COGS 100,A01,083619,Allen; Michael Gordon,17,0,70,53
1657489954610,COGS 101A,A01,083621,Davis; Joshua Daniel,9,0,68,59
1657489960631,COGS 101B,A01,091572,Allen; Michael Gordon,12,0,65,53
1657489966653,COGS 101C,A01,083625,Delgado; Tania,17,0,35,18
1657489972688,COGS 107A,A01,083627,Boyle; Mary E. T.,13,0,60,47
1657489978711,COGS 118A,A01,083075,Gupta; Anjum,21,0,76,55
1657489984739,CSE 3,A50,083646,Miranda; Gregory Joseph,24,0,50,26
1657489990761,CSE 8A,A50,083650,Miranda; Gregory Joseph,17,1,56,39
1657489996856,CSE 11,A01,083080,Cao; Yingjun,6,15,40,34
1657490002884,CSE 12,A01,083652,Krause-Levy; Sophia Louisa,28,1,120,92
1657490008912,CSE 15L,A01,083654,Morris; Justin Loren,9,0,50,41
1657490008912,CSE 15L,A02,083655,Morris; Justin Loren,9,0,50,41
1657490014936,CSE 20,A01,083657,Tran; Khoa Dang,39,0,80,41
1657490020959,CSE 21,A01,095574,Bach; Quang Tran,22,0,48,26
1657490026983,CSE 30,A01,083084,Eldon; John,5,0,80,75
1657490026983,CSE 30,B01,095061,Bhaskar; Nishant,9,0,50,41
1657490033012,CSE 100,A01,083659,Cao; Yingjun,5,4,70,65
1657490039042,CSE 134B,A01,083661,Powell; Thomas Allan,22,0,100,78
1657490045066,CSE 140,A01,083663,Gungor; Onat,15,0,85,70
1657490051092,CSE 140L,A01,083088,Eldon; John,21,0,100,79
1657490057118,CSE 175,A01,083665,Kumar; Rakesh,3,0,25,22
1657490063145,CSE 190,A00,092507,Dubnov; Shlomo,8,0,20,12
1657490069171,ECE 45,A01,083139,Congero; Spencer William,6,0,75,69
1657490075195,ECE 65,A50,083695,Saad; Andrew S,12,0,30,18
1657490075195,ECE 65,A51,095125,Saad; Andrew S,24,0,26,2
1657490081219,ECE 109,A01,091882,Touri; Behrouz,19,0,70,51
1657490087253,ECE 180,A00,083140,Abi Samra; Nicholas Camill,1,0,30,29
1657490087253,ECE 180,B00,083141,Abi Samra; Nicholas Camill,0,0,30,30
1657490093276,MATH 10A,A01,083735,Patchell; Gregory David,2,0,30,28
1657490093276,MATH 10A,A02,083736,Patchell; Gregory David,20,0,30,10
1657490093276,MATH 10A,A03,083737,Patchell; Gregory David,16,0,30,14
1657490099307,MATH 10B,A01,083207,Lim; Seonhee,8,0,34,26
1657490099307,MATH 10B,A02,083208,Lim; Seonhee,9,0,35,26
1657490099307,MATH 10B,A03,093472,Lim; Seonhee,7,0,34,27
1657490099307,MATH 10B,B01,083739,Sinha; Shubham,12,0,30,18
1657490105337,MATH 18,A01,083743,Cinel; Cameron Alexander,7,0,30,23
1657490105337,MATH 18,A02,083744,Cinel; Cameron Alexander,17,0,30,13
1657490105337,MATH 18,A03,083745,Cinel; Cameron Alexander,9,0,30,21
1657490105337,MATH 18,B01,083748,Rideout; David Porter,5,0,37,32
1657490105337,MATH 18,B02,083749,Rideout; David Porter,5,0,36,31
1657490105337,MATH 18,B03,083750,Rideout; David Porter,3,0,37,34
1657490105337,MATH 18,B04,083751,Rideout; David Porter,6,0,36,30
1657490105337,MATH 18,B05,093473,Rideout; David Porter,6,0,36,30
1657490105337,MATH 18,B06,093474,Rideout; David Porter,6,0,36,30
1657490111367,MATH 20A,A01,083754,Zheng; Zequn,14,0,40,26
1657490117394,MATH 20B,A01,083756,Briones; Jor-el Thomas Caparas,4,0,36,32
1657490117394,MATH 20B,A02,083757,Briones; Jor-el Thomas Caparas,1,0,36,35
1657490117394,MATH 20B,A03,093475,Briones; Jor-el Thomas Caparas,2,0,36,34
1657490123423,MATH 20C,A01,083760,Briones; Jor-el Thomas Caparas,1,0,35,34
1657490123423,MATH 20C,A02,083761,Briones; Jor-el Thomas Caparas,8,0,35,27
1657490123423,MATH 20C,A03,093476,Briones; Jor-el Thomas Caparas,0,1,36,36
1657490123423,MATH 20C,B01,083762,Bach; Quang Tran,1,0,30,29
1657490129451,MATH 20D,A01,083765,Tran; Brian Kha,5,0,30,25
1657490129451,MATH 20D,A02,083766,Tran; Brian Kha,5,0,30,25
1657490129451,MATH 20D,A03,083767,Tran; Brian Kha,5,0,30,25
1657490135479,MATH 20E,A01,083771,Ganguly; Soumya,9,0,32,23
1657490135479,MATH 20E,A02,083772,Ganguly; Soumya,6,0,32,26
1657490135479,MATH 20E,B01,083773,Ciotti; Benjamin,20,0,35,15
1657490135479,MATH 20E,B02,083774,Ciotti; Benjamin,17,0,35,18
1657490141508,MATH 103A,A01,083777,Greenfeld; Be'Eri,3,0,36,33
1657490141508,MATH 103A,A02,083778,Greenfeld; Be'Eri,5,0,36,31
1657490141508,MATH 103A,A03,093561,Greenfeld; Be'Eri,5,0,36,31
1657490141508,MATH 103A,B01,083779,Greenfeld; Be'Eri,7,0,36,29
1657490141508,MATH 103A,B02,083780,Greenfeld; Be'Eri,4,0,36,32
1657490141508,MATH 103A,B03,093562,Greenfeld; Be'Eri,3,0,36,33
1657490147532,MATH 105,A01,085443,Carter; Anne Toulson,15,0,35,20
1657490147532,MATH 105,A02,093477,Carter; Anne Toulson,20,0,35,15
1657490153557,MATH 109,A01,083213,Ganzberger; Geoffrey Michael,2,0,34,32
1657490153557,MATH 109,A02,083214,Ganzberger; Geoffrey Michael,4,0,34,30
1657490153557,MATH 109,A03,093478,Ganzberger; Geoffrey Michael,2,0,34,32
1657490153557,MATH 109,B01,083215,Ganzberger; Geoffrey Michael,1,0,32,31
1657490153557,MATH 109,B02,083216,Ganzberger; Geoffrey Michael,2,0,32,30
1657490153557,MATH 109,B03,093479,Ganzberger; Geoffrey Michael,8,0,32,24
1657490159587,MATH 142A,A01,083219,Chow; Bennett,7,0,32,25
1657490159587,MATH 142A,A02,083220,Chow; Bennett,10,0,32,22
1657490159587,MATH 142A,A03,093480,Chow; Bennett,8,0,32,24
1657490159587,MATH 142A,B03,093481,Chow; Bennett,8,0,32,24
1657490159587,MATH 142A,B04,093558,Chow; Bennett,13,0,32,19
1657490159587,MATH 142A,B05,093559,Chow; Bennett,6,0,32,26
1657490165610,MATH 193A,A01,083224,Rotar; Vladimir,8,0,34,26
1657490165610,MATH 193A,A02,083225,Rotar; Vladimir,9,0,34,25
1657490165610,MATH 193A,A03,083781,Rotar; Vladimir,5,0,34,29
1657490165610,MATH 193A,A04,083782,Rotar; Vladimir,10,0,34,24
1657490165610,MATH 193A,A05,093482,Rotar; Vladimir,10,0,34,24
1657490171637,MATH 197,001,091859,McAuley; Julian John,9999,0,9999,0
1657490171637,MATH 197,002,095566,Kedlaya; Kiran S.,9997,0,9999,2
1657490171637,MATH 197,003,095567,Xiao; Ming,9999,0,9999,0
1657490171637,MATH 197,004,095571,Perols; Johan Lars,9998,0,9999,1
1657490178701,COGS 9,A01,083615,Shannon; Kyle Michael,9,0,75,66
1657490184725,COGS 11,A01,083617,Boyle; Mary E. T.,22,0,48,26
1657490190760,COGS 13,A01,083071,Bastos; Amalia Pinkusfeld,11,0,71,60
1657490196784,COGS 14A,A01,092681,Semenuks; Arturs,5,1,100,95
1657490202812,COGS 14B,A01,083073,Cheng; Tzu-Han,6,0,63,57
1657490208834,COGS 17,A01,092677,Semenuks; Arturs,6,0,81,75
1657490214861,COGS 100,A01,083619,Allen; Michael Gordon,17,0,70,53
1657490220888,COGS 101A,A01,083621,Davis; Joshua Daniel,9,0,68,59
1657490226919,COGS 101B,A01,091572,Allen; Michael Gordon,12,0,65,53
1657490232943,COGS 101C,A01,083625,Delgado; Tania,17,0,35,18
1657490238972,COGS 107A,A01,083627,Boyle; Mary E. T.,13,0,60,47
1657490244998,COGS 118A,A01,083075,Gupta; Anjum,21,0,76,55
1657490251022,CSE 3,A50,083646,Miranda; Gregory Joseph,24,0,50,26
1657490257046,CSE 8A,A50,083650,Miranda; Gregory Joseph,17,1,56,39
1657490263073,CSE 11,A01,083080,Cao; Yingjun,6,15,40,34
1657490269100,CSE 12,A01,083652,Krause-Levy; Sophia Louisa,28,1,120,92
1657490275123,CSE 15L,A01,083654,Morris; Justin Loren,9,0,50,41
1657490275123,CSE 15L,A02,083655,Morris; Justin Loren,9,0,50,41
1657490281147,CSE 20,A01,083657,Tran; Khoa Dang,39,0,80,41
1657490287173,CSE 21,A01,095574,Bach; Quang Tran,22,0,48,26
1657490293195,CSE 30,A01,083084,Eldon; John,5,0,80,75
1657490293195,CSE 30,B01,095061,Bhaskar; Nishant,9,0,50,41
1657490299222,CSE 100,A01,083659,Cao; Yingjun,5,4,70,65
1657490305249,CSE 134B,A01,083661,Powell; Thomas Allan,22,0,100,78
1657490311271,CSE 140,A01,083663,Gungor; Onat,15,0,85,70
1657490317297,CSE 140L,A01,083088,Eldon; John,21,0,100,79
1657490323320,CSE 175,A01,083665,Kumar; Rakesh,3,0,25,22
1657490329346,CSE 190,A00,092507,Dubnov; Shlomo,8,0,20,12
1657490335374,ECE 45,A01,083139,Congero; Spencer William,6,0,75,69
1657490341405,ECE 65,A50,083695,Saad; Andrew S,12,0,30,18
1657490341405,ECE 65,A51,095125,Saad; Andrew S,24,0,26,2
1657490347428,ECE 109,A01,091882,Touri; Behrouz,19,0,70,51
1657490353457,ECE 180,A00,083140,Abi Samra; Nicholas Camill,1,0,30,29
1657490353457,ECE 180,B00,083141,Abi Samra; Nicholas Camill,0,0,30,30
1657490359485,MATH 10A,A01,083735,Patchell; Gregory David,2,0,30,28
1657490359485,MATH 10A,A02,083736,Patchell; Gregory David,20,0,30,10
1657490359485,MATH 10A,A03,083737,Patchell; Gregory David,16,0,30,14
1657490365515,MATH 10B,A01,083207,Lim; Seonhee,8,0,34,26
1657490365515,MATH 10B,A02,083208,Lim; Seonhee,9,0,35,26
1657490365515,MATH 10B,A03,093472,Lim; Seonhee,7,0,34,27
1657490365515,MATH 10B,B01,083739,Sinha; Shubham,12,0,30,18
1657490371540,MATH 18,A01,083743,Cinel; Cameron Alexander,7,0,30,23
1657490371540,MATH 18,A02,083744,Cinel; Cameron Alexander,17,0,30,13
1657490371540,MATH 18,A03,083745,Cinel; Cameron Alexander,9,0,30,21
1657490371540,MATH 18,B01,083748,Rideout; David Porter,5,0,37,32
1657490371540,MATH 18,B02,083749,Rideout; David Porter,5,0,36,31
1657490371540,MATH 18,B03,083750,Rideout; David Porter,3,0,37,34
1657490371540,MATH 18,B04,083751,Rideout; David Porter,6,0,36,30
1657490371540,MATH 18,B05,093473,Rideout; David Porter,6,0,36,30
1657490371540,MATH 18,B06,093474,Rideout; David Porter,6,0,36,30
1657490377567,MATH 20A,A01,083754,Zheng; Zequn,14,0,40,26
1657490383592,MATH 20B,A01,083756,Briones; Jor-el Thomas Caparas,4,0,36,32
1657490383592,MATH 20B,A02,083757,Briones; Jor-el Thomas Caparas,1,0,36,35
1657490383592,MATH 20B,A03,093475,Briones; Jor-el Thomas Caparas,2,0,36,34
1657490389624,MATH 20C,A01,083760,Briones; Jor-el Thomas Caparas,1,0,35,34
1657490389624,MATH 20C,A02,083761,Briones; Jor-el Thomas Caparas,8,0,35,27
1657490389624,MATH 20C,A03,093476,Briones; Jor-el Thomas Caparas,0,1,36,36
1657490389624,MATH 20C,B01,083762,Bach; Quang Tran,1,0,30,29
1657490395648,MATH 20D,A01,083765,Tran; Brian Kha,5,0,30,25
1657490395648,MATH 20D,A02,083766,Tran; Brian Kha,5,0,30,25
1657490395648,MATH 20D,A03,083767,Tran; Brian Kha,5,0,30,25
1657490401673,MATH 20E,A01,083771,Ganguly; Soumya,9,0,32,23
1657490401673,MATH 20E,A02,083772,Ganguly; Soumya,6,0,32,26
1657490401673,MATH 20E,B01,083773,Ciotti; Benjamin,20,0,35,15
1657490401673,MATH 20E,B02,083774,Ciotti; Benjamin,17,0,35,18
1657490407702,MATH 103A,A01,083777,Greenfeld; Be'Eri,3,0,36,33
1657490407702,MATH 103A,A02,083778,Greenfeld; Be'Eri,5,0,36,31
1657490407702,MATH 103A,A03,093561,Greenfeld; Be'Eri,5,0,36,31
1657490407702,MATH 103A,B01,083779,Greenfeld; Be'Eri,7,0,36,29
1657490407702,MATH 103A,B02,083780,Greenfeld; Be'Eri,4,0,36,32
1657490407702,MATH 103A,B03,093562,Greenfeld; Be'Eri,3,0,36,33
1657490413725,MATH 105,A01,085443,Carter; Anne Toulson,15,0,35,20
1657490413725,MATH 105,A02,093477,Carter; Anne Toulson,20,0,35,15
1657490419748,MATH 109,A01,083213,Ganzberger; Geoffrey Michael,2,0,34,32
1657490419748,MATH 109,A02,083214,Ganzberger; Geoffrey Michael,4,0,34,30
1657490419748,MATH 109,A03,093478,Ganzberger; Geoffrey Michael,2,0,34,32
1657490419748,MATH 109,B01,083215,Ganzberger; Geoffrey Michael,1,0,32,31
1657490419748,MATH 109,B02,083216,Ganzberger; Geoffrey Michael,2,0,32,30
1657490419748,MATH 109,B03,093479,Ganzberger; Geoffrey Michael,8,0,32,24
1657490425780,MATH 142A,A01,083219,Chow; Bennett,7,0,32,25
1657490425780,MATH 142A,A02,083220,Chow; Bennett,10,0,32,22
1657490425780,MATH 142A,A03,093480,Chow; Bennett,8,0,32,24
1657490425780,MATH 142A,B03,093481,Chow; Bennett,8,0,32,24
1657490425780,MATH 142A,B04,093558,Chow; Bennett,13,0,32,19
1657490425780,MATH 142A,B05,093559,Chow; Bennett,6,0,32,26
1657490431808,MATH 193A,A01,083224,Rotar; Vladimir,8,0,34,26
1657490431808,MATH 193A,A02,083225,Rotar; Vladimir,9,0,34,25
1657490431808,MATH 193A,A03,083781,Rotar; Vladimir,5,0,34,29
1657490431808,MATH 193A,A04,083782,Rotar; Vladimir,10,0,34,24
1657490431808,MATH 193A,A05,093482,Rotar; Vladimir,10,0,34,24
1657490437832,MATH 197,001,091859,McAuley; Julian John,9999,0,9999,0
1657490437832,MATH 197,002,095566,Kedlaya; Kiran S.,9997,0,9999,2
1657490437832,MATH 197,003,095567,Xiao; Ming,9999,0,9999,0
1657490437832,MATH 197,004,095571,Perols; Johan Lars,9998,0,9999,1
1657490444900,COGS 9,A01,083615,Shannon; Kyle Michael,9,0,75,66
1657490450923,COGS 11,A01,083617,Boyle; Mary E. T.,22,0,48,26
1657490456948,COGS 13,A01,083071,Bastos; Amalia Pinkusfeld,11,0,71,60
1657490462971,COGS 14A,A01,092681,Semenuks; Arturs,5,1,100,95
1657490468994,COGS 14B,A01,083073,Cheng; Tzu-Han,6,0,63,57
1657490475023,COGS 17,A01,092677,Semenuks; Arturs,6,0,81,75
1657490481053,COGS 100,A01,083619,Allen; Michael Gordon,17,0,70,53
1657490487077,COGS 101A,A01,083621,Davis; Joshua Daniel,9,0,68,59
1657490493102,COGS 101B,A01,091572,Allen; Michael Gordon,12,0,65,53
1657490499125,COGS 101C,A01,083625,Delgado; Tania,17,0,35,18
1657490505151,COGS 107A,A01,083627,Boyle; Mary E. T.,13,0,60,47
1657490511175,COGS 118A,A01,083075,Gupta; Anjum,21,0,76,55
1657490517199,CSE 3,A50,083646,Miranda; Gregory Joseph,24,0,50,26
1657490523227,CSE 8A,A50,083650,Miranda; Gregory Joseph,17,1,56,39
1657490529251,CSE 11,A01,083080,Cao; Yingjun,6,15,40,34
1657490535276,CSE 12,A01,083652,Krause-Levy; Sophia Louisa,28,1,120,92
1657490541312,CSE 15L,A01,083654,Morris; Justin Loren,9,0,50,41
1657490541312,CSE 15L,A02,083655,Morris; Justin Loren,9,0,50,41
1657490547340,CSE 20,A01,083657,Tran; Khoa Dang,39,0,80,41
1657490553368,CSE 21,A01,095574,Bach; Quang Tran,22,0,48,26
1657490559397,CSE 30,A01,083084,Eldon; John,5,0,80,75
1657490559397,CSE 30,B01,095061,Bhaskar; Nishant,9,0,50,41
1657490565419,CSE 100,A01,083659,Cao; Yingjun,5,4,70,65
1657490571455,CSE 134B,A01,083661,Powell; Thomas Allan,22,0,100,78
1657490577482,CSE 140,A01,083663,Gungor; Onat,15,0,85,70
1657490583507,CSE 140L,A01,083088,Eldon; John,21,0,100,79
1657490589530,CSE 175,A01,083665,Kumar; Rakesh,3,0,25,22
1657490595626,CSE 190,A00,092507,Dubnov; Shlomo,8,0,20,12
1657490601652,ECE 45,A01,083139,Congero; Spencer William,6,0,75,69
1657490607675,ECE 65,A50,083695,Saad; Andrew S,12,0,30,18
1657490607675,ECE 65,A51,095125,Saad; Andrew S,24,0,26,2
1657490613701,ECE 109,A01,091882,Touri; Behrouz,19,0,70,51
1657490619722,ECE 180,A00,083140,Abi Samra; Nicholas Camill,1,0,30,29
1657490619722,ECE 180,B00,083141,Abi Samra; Nicholas Camill,0,0,30,30
1657490625748,MATH 10A,A01,083735,Patchell; Gregory David,2,0,30,28
1657490625748,MATH 10A,A02,083736,Patchell; Gregory David,20,0,30,10
1657490625748,MATH 10A,A03,083737,Patchell; Gregory David,16,0,30,14
1657490631777,MATH 10B,A01,083207,Lim; Seonhee,8,0,34,26
1657490631777,MATH 10B,A02,083208,Lim; Seonhee,9,0,35,26
1657490631777,MATH 10B,A03,093472,Lim; Seonhee,7,0,34,27
1657490631777,MATH 10B,B01,083739,Sinha; Shubham,12,0,30,18
1657490637803,MATH 18,A01,083743,Cinel; Cameron Alexander,7,0,30,23
1657490637803,MATH 18,A02,083744,Cinel; Cameron Alexander,17,0,30,13
1657490637803,MATH 18,A03,083745,Cinel; Cameron Alexander,9,0,30,21
1657490637803,MATH 18,B01,083748,Rideout; David Porter,5,0,37,32
1657490637803,MATH 18,B02,083749,Rideout; David Porter,5,0,36,31
1657490637803,MATH 18,B03,083750,Rideout; David Porter,3,0,37,34
1657490637803,MATH 18,B04,083751,Rideout; David Porter,6,0,36,30
1657490637803,MATH 18,B05,093473,Rideout; David Porter,6,0,36,30
1657490637803,MATH 18,B06,093474,Rideout; David Porter,6,0,36,30
1657490643827,MATH 20A,A01,083754,Zheng; Zequn,14,0,40,26
1657490649850,MATH 20B,A01,083756,Briones; Jor-el Thomas Caparas,4,0,36,32
1657490649850,MATH 20B,A02,083757,Briones; Jor-el Thomas Caparas,1,0,36,35
1657490649850,MATH 20B,A03,093475,Briones; Jor-el Thomas Caparas,2,0,36,34
1657490655884,MATH 20C,A01,083760,Briones; Jor-el Thomas Caparas,1,0,35,34
1657490655884,MATH 20C,A02,083761,Briones; Jor-el Thomas Caparas,8,0,35,27
1657490655884,MATH 20C,A03,093476,Briones; Jor-el Thomas Caparas,0,1,36,36
1657490655884,MATH 20C,B01,083762,Bach; Quang Tran,1,0,30,29
1657490661905,MATH 20D,A01,083765,Tran; Brian Kha,5,0,30,25
1657490661905,MATH 20D,A02,083766,Tran; Brian Kha,5,0,30,25
1657490661905,MATH 20D,A03,083767,Tran; Brian Kha,5,0,30,25
1657490667926,MATH 20E,A01,083771,Ganguly; Soumya,9,0,32,23
1657490667926,MATH 20E,A02,083772,Ganguly; Soumya,6,0,32,26
1657490667926,MATH 20E,B01,083773,Ciotti; Benjamin,20,0,35,15
1657490667926,MATH 20E,B02,083774,Ciotti; Benjamin,17,0,35,18
1657490673954,MATH 103A,A01,083777,Greenfeld; Be'Eri,3,0,36,33
1657490673954,MATH 103A,A02,083778,Greenfeld; Be'Eri,5,0,36,31
1657490673954,MATH 103A,A03,093561,Greenfeld; Be'Eri,5,0,36,31
1657490673954,MATH 103A,B01,083779,Greenfeld; Be'Eri,7,0,36,29
1657490673954,MATH 103A,B02,083780,Greenfeld; Be'Eri,4,0,36,32
1657490673954,MATH 103A,B03,093562,Greenfeld; Be'Eri,3,0,36,33
1657490679978,MATH 105,A01,085443,Carter; Anne Toulson,15,0,35,20
1657490679978,MATH 105,A02,093477,Carter; Anne Toulson,20,0,35,15
1657490686006,MATH 109,A01,083213,Ganzberger; Geoffrey Michael,2,0,34,32
1657490686006,MATH 109,A02,083214,Ganzberger; Geoffrey Michael,4,0,34,30
1657490686006,MATH 109,A03,093478,Ganzberger; Geoffrey Michael,2,0,34,32
1657490686006,MATH 109,B01,083215,Ganzberger; Geoffrey Michael,1,0,32,31
1657490686006,MATH 109,B02,083216,Ganzberger; Geoffrey Michael,2,0,32,30
1657490686006,MATH 109,B03,093479,Ganzberger; Geoffrey Michael,8,0,32,24
1657490692036,MATH 142A,A01,083219,Chow; Bennett,7,0,32,25
1657490692036,MATH 142A,A02,083220,Chow; Bennett,10,0,32,22
1657490692036,MATH 142A,A03,093480,Chow; Bennett,8,0,32,24
1657490692036,MATH 142A,B03,093481,Chow; Bennett,8,0,32,24
1657490692036,MATH 142A,B04,093558,Chow; Bennett,13,0,32,19
1657490692036,MATH 142A,B05,093559,Chow; Bennett,6,0,32,26
1657490698061,MATH 193A,A01,083224,Rotar; Vladimir,8,0,34,26
1657490698061,MATH 193A,A02,083225,Rotar; Vladimir,9,0,34,25
1657490698061,MATH 193A,A03,083781,Rotar; Vladimir,5,0,34,29
1657490698061,MATH 193A,A04,083782,Rotar; Vladimir,10,0,34,24
1657490698061,MATH 193A,A05,093482,Rotar; Vladimir,10,0,34,24
1657490704087,MATH 197,001,091859,McAuley; Julian John,9999,0,9999,0
1657490704087,MATH 197,002,095566,Kedlaya; Kiran S.,9997,0,9999,2
1657490704087,MATH 197,003,095567,Xiao; Ming,9999,0,9999,0
1657490704087,MATH 197,004,095571,Perols; Johan Lars,9998,0,9999,1
1657490711144,COGS 9,A01,083615,Shannon; Kyle Michael,9,0,75,66
1657490717168,COGS 11,A01,083617,Boyle; Mary E. T.,22,0,48,26
1657490723192,COGS 13,A01,083071,Bastos; Amalia Pinkusfeld,11,0,71,60
1657490729218,COGS 14A,A01,092681,Semenuks; Arturs,5,1,100,95
1657490735245,COGS 14B,A01,083073,Cheng; Tzu-Han,6,0,63,57
1657490741271,COGS 17,A01,092677,Semenuks; Arturs,6,0,81,75
1657490747303,COGS 100,A01,083619,Allen; Michael Gordon,17,0,70,53
1657490753326,COGS 101A,A01,083621,Davis; Joshua Daniel,9,0,68,59
1657490759359,COGS 101B,A01,091572,Allen; Michael Gordon,12,0,65,53
1657490765382,COGS 101C,A01,083625,Delgado; Tania,17,0,35,18
1657490771408,COGS 107A,A01,083627,Boyle; Mary E. T.,13,0,60,47
1657490777431,COGS 118A,A01,083075,Gupta; Anjum,21,0,76,55
1657490783454,CSE 3,A50,083646,Miranda; Gregory Joseph,24,0,50,26
1657490789481,CSE 8A,A50,083650,Miranda; Gregory Joseph,17,1,56,39
1657490795510,CSE 11,A01,083080,Cao; Yingjun,6,15,40,34
1657490801534,CSE 12,A01,083652,Krause-Levy; Sophia Louisa,28,1,120,92
1657490807564,CSE 15L,A01,083654,Morris; Justin Loren,9,0,50,41
1657490807564,CSE 15L,A02,083655,Morris; Justin Loren,9,0,50,41
1657490813589,CSE 20,A01,083657,Tran; Khoa Dang,39,0,80,41
1657490819613,CSE 21,A01,095574,Bach; Quang Tran,22,0,48,26
1657490825636,CSE 30,A01,083084,Eldon; John,5,0,80,75
1657490825636,CSE 30,B01,095061,Bhaskar; Nishant,9,0,50,41
1657490831660,CSE 100,A01,083659,Cao; Yingjun,5,4,70,65
1657490837684,CSE 134B,A01,083661,Powell; Thomas Allan,22,0,100,78
1657490843708,CSE 140,A01,083663,Gungor; Onat,15,0,85,70
1657490849731,CSE 140L,A01,083088,Eldon; John,21,0,100,79
1657490855753,CSE 175,A01,083665,Kumar; Rakesh,3,0,25,22
1657490861783,CSE 190,A00,092507,Dubnov; Shlomo,8,0,20,12
1657490867810,ECE 45,A01,083139,Congero; Spencer William,6,0,75,69
1657490873834,ECE 65,A50,083695,Saad; Andrew S,12,0,30,18
1657490873834,ECE 65,A51,095125,Saad; Andrew S,24,0,26,2
1657490879857,ECE 109,A01,091882,Touri; Behrouz,19,0,70,51
1657490885880,ECE 180,A00,083140,Abi Samra; Nicholas Camill,1,0,30,29
1657490885880,ECE 180,B00,083141,Abi Samra; Nicholas Camill,0,0,30,30
1657490891907,MATH 10A,A01,083735,Patchell; Gregory David,2,0,30,28
1657490891907,MATH 10A,A02,083736,Patchell; Gregory David,20,0,30,10
1657490891907,MATH 10A,A03,083737,Patchell; Gregory David,16,0,30,14
1657490897935,MATH 10B,A01,083207,Lim; Seonhee,8,0,34,26
1657490897935,MATH 10B,A02,083208,Lim; Seonhee,9,0,35,26
1657490897935,MATH 10B,A03,093472,Lim; Seonhee,7,0,34,27
1657490897935,MATH 10B,B01,083739,Sinha; Shubham,12,0,30,18
1657490903957,MATH 18,A01,083743,Cinel; Cameron Alexander,7,0,30,23
1657490903957,MATH 18,A02,083744,Cinel; Cameron Alexander,17,0,30,13
1657490903957,MATH 18,A03,083745,Cinel; Cameron Alexander,9,0,30,21
1657490903957,MATH 18,B01,083748,Rideout; David Porter,5,0,37,32
1657490903957,MATH 18,B02,083749,Rideout; David Porter,5,0,36,31
1657490903957,MATH 18,B03,083750,Rideout; David Porter,3,0,37,34
1657490903957,MATH 18,B04,083751,Rideout; David Porter,6,0,36,30
1657490903957,MATH 18,B05,093473,Rideout; David Porter,6,0,36,30
1657490903957,MATH 18,B06,093474,Rideout; David Porter,6,0,36,30
1657490909983,MATH 20A,A01,083754,Zheng; Zequn,14,0,40,26
1657490916019,MATH 20B,A01,083756,Briones; Jor-el Thomas Caparas,4,0,36,32
1657490916019,MATH 20B,A02,083757,Briones; Jor-el Thomas Caparas,1,0,36,35
1657490916019,MATH 20B,A03,093475,Briones; Jor-el Thomas Caparas,2,0,36,34
1657490922047,MATH 20C,A01,083760,Briones; Jor-el Thomas Caparas,1,0,35,34
1657490922047,MATH 20C,A02,083761,Briones; Jor-el Thomas Caparas,8,0,35,27
1657490922047,MATH 20C,A03,093476,Briones; Jor-el Thomas Caparas,0,1,36,36
1657490922047,MATH 20C,B01,083762,Bach; Quang Tran,1,0,30,29
1657490928073,MATH 20D,A01,083765,Tran; Brian Kha,5,0,30,25
1657490928073,MATH 20D,A02,083766,Tran; Brian Kha,5,0,30,25
1657490928073,MATH 20D,A03,083767,Tran; Brian Kha,5,0,30,25
1657490934097,MATH 20E,A01,083771,Ganguly; Soumya,9,0,32,23
1657490934097,MATH 20E,A02,083772,Ganguly; Soumya,6,0,32,26
1657490934097,MATH 20E,B01,083773,Ciotti; Benjamin,20,0,35,15
1657490934097,MATH 20E,B02,083774,Ciotti; Benjamin,17,0,35,18
1657490940122,MATH 103A,A01,083777,Greenfeld; Be'Eri,3,0,36,33
1657490940122,MATH 103A,A02,083778,Greenfeld; Be'Eri,5,0,36,31
1657490940122,MATH 103A,A03,093561,Greenfeld; Be'Eri,5,0,36,31
1657490940122,MATH 103A,B01,083779,Greenfeld; Be'Eri,7,0,36,29
1657490940122,MATH 103A,B02,083780,Greenfeld; Be'Eri,4,0,36,32
1657490940122,MATH 103A,B03,093562,Greenfeld; Be'Eri,3,0,36,33
1657490946157,MATH 105,A01,085443,Carter; Anne Toulson,15,0,35,20
1657490946157,MATH 105,A02,093477,Carter; Anne Toulson,20,0,35,15
1657490952181,MATH 109,A01,083213,Ganzberger; Geoffrey Michael,2,0,34,32
1657490952181,MATH 109,A02,083214,Ganzberger; Geoffrey Michael,4,0,34,30
1657490952181,MATH 109,A03,093478,Ganzberger; Geoffrey Michael,2,0,34,32
1657490952181,MATH 109,B01,083215,Ganzberger; Geoffrey Michael,1,0,32,31
1657490952181,MATH 109,B02,083216,Ganzberger; Geoffrey Michael,2,0,32,30
1657490952181,MATH 109,B03,093479,Ganzberger; Geoffrey Michael,8,0,32,24
1657490958206,MATH 142A,A01,083219,Chow; Bennett,7,0,32,25
1657490958206,MATH 142A,A02,083220,Chow; Bennett,10,0,32,22
1657490958206,MATH 142A,A03,093480,Chow; Bennett,8,0,32,24
1657490958206,MATH 142A,B03,093481,Chow; Bennett,8,0,32,24
1657490958206,MATH 142A,B04,093558,Chow; Bennett,13,0,32,19
1657490958206,MATH 142A,B05,093559,Chow; Bennett,6,0,32,26
1657490964231,MATH 193A,A01,083224,Rotar; Vladimir,8,0,34,26
1657490964231,MATH 193A,A02,083225,Rotar; Vladimir,9,0,34,25
1657490964231,MATH 193A,A03,083781,Rotar; Vladimir,5,0,34,29
1657490964231,MATH 193A,A04,083782,Rotar; Vladimir,10,0,34,24
1657490964231,MATH 193A,A05,093482,Rotar; Vladimir,10,0,34,24
1657490970255,MATH 197,001,091859,McAuley; Julian John,9999,0,9999,0
1657490970255,MATH 197,002,095566,Kedlaya; Kiran S.,9997,0,9999,2
1657490970255,MATH 197,003,095567,Xiao; Ming,9999,0,9999,0
1657490970255,MATH 197,004,095571,Perols; Johan Lars,9998,0,9999,1
1657490977316,COGS 9,A01,083615,Shannon; Kyle Michael,9,0,75,66
1657490983343,COGS 11,A01,083617,Boyle; Mary E. T.,22,0,48,26
1657490989366,COGS 13,A01,083071,Bastos; Amalia Pinkusfeld,11,0,71,60
1657490995389,COGS 14A,A01,092681,Semenuks; Arturs,5,1,100,95
1657491001410,COGS 14B,A01,083073,Cheng; Tzu-Han,6,0,63,57
1657491007449,COGS 17,A01,092677,Semenuks; Arturs,6,0,81,75
1657491013471,COGS 100,A01,083619,Allen; Michael Gordon,17,0,70,53
1657491019493,COGS 101A,A01,083621,Davis; Joshua Daniel,9,0,68,59
1657491025520,COGS 101B,A01,091572,Allen; Michael Gordon,12,0,65,53
1657491031546,COGS 101C,A01,083625,Delgado; Tania,17,0,35,18
1657491037572,COGS 107A,A01,083627,Boyle; Mary E. T.,13,0,60,47
1657491043595,COGS 118A,A01,083075,Gupta; Anjum,21,0,76,55
1657491049621,CSE 3,A50,083646,Miranda; Gregory Joseph,24,0,50,26
1657491055645,CSE 8A,A50,083650,Miranda; Gregory Joseph,17,1,56,39
1657491061667,CSE 11,A01,083080,Cao; Yingjun,6,15,40,34
1657491067692,CSE 12,A01,083652,Krause-Levy; Sophia Louisa,28,1,120,92
1657491073714,CSE 15L,A01,083654,Morris; Justin Loren,9,0,50,41
1657491073714,CSE 15L,A02,083655,Morris; Justin Loren,9,0,50,41
1657491079740,CSE 20,A01,083657,Tran; Khoa Dang,39,0,80,41
1657491085762,CSE 21,A01,095574,Bach; Quang Tran,22,0,48,26
1657491091788,CSE 30,A01,083084,Eldon; John,5,0,80,75
1657491091788,CSE 30,B01,095061,Bhaskar; Nishant,9,0,50,41
1657491097812,CSE 100,A01,083659,Cao; Yingjun,5,4,70,65
1657491103834,CSE 134B,A01,083661,Powell; Thomas Allan,22,0,100,78
1657491109860,CSE 140,A01,083663,Gungor; Onat,15,0,85,70
1657491115884,CSE 140L,A01,083088,Eldon; John,21,0,100,79
1657491121909,CSE 175,A01,083665,Kumar; Rakesh,3,0,25,22
1657491127934,CSE 190,A00,092507,Dubnov; Shlomo,8,0,20,12
1657491133956,ECE 45,A01,083139,Congero; Spencer William,6,0,75,69
1657491139980,ECE 65,A50,083695,Saad; Andrew S,12,0,30,18
1657491139980,ECE 65,A51,095125,Saad; Andrew S,24,0,26,2
1657491146004,ECE 109,A01,091882,Touri; Behrouz,19,0,70,51
1657491152028,ECE 180,A00,083140,Abi Samra; Nicholas Camill,1,0,30,29
1657491152028,ECE 180,B00,083141,Abi Samra; Nicholas Camill,0,0,30,30
1657491158054,MATH 10A,A01,083735,Patchell; Gregory David,2,0,30,28
1657491158054,MATH 10A,A02,083736,Patchell; Gregory David,20,0,30,10
1657491158054,MATH 10A,A03,083737,Patchell; Gregory David,16,0,30,14
1657491164079,MATH 10B,A01,083207,Lim; Seonhee,8,0,34,26
1657491164079,MATH 10B,A02,083208,Lim; Seonhee,9,0,35,26
1657491164079,MATH 10B,A03,093472,Lim; Seonhee,7,0,34,27
1657491164079,MATH 10B,B01,083739,Sinha; Shubham,12,0,30,18
1657491170104,MATH 18,A01,083743,Cinel; Cameron Alexander,7,0,30,23
1657491170104,MATH 18,A02,083744,Cinel; Cameron Alexander,17,0,30,13
1657491170104,MATH 18,A03,083745,Cinel; Cameron Alexander,9,0,30,21
1657491170104,MATH 18,B01,083748,Rideout; David Porter,5,0,37,32
1657491170104,MATH 18,B02,083749,Rideout; David Porter,5,0,36,31
1657491170104,MATH 18,B03,083750,Rideout; David Porter,3,0,37,34
1657491170104,MATH 18,B04,083751,Rideout; David Porter,6,0,36,30
1657491170104,MATH 18,B05,093473,Rideout; David Porter,6,0,36,30
1657491170104,MATH 18,B06,093474,Rideout; David Porter,6,0,36,30
1657491176126,MATH 20A,A01,083754,Zheng; Zequn,14,0,40,26
1657491182149,MATH 20B,A01,083756,Briones; Jor-el Thomas Caparas,4,0,36,32
1657491182149,MATH 20B,A02,083757,Briones; Jor-el Thomas Caparas,1,0,36,35
1657491182149,MATH 20B,A03,093475,Briones; Jor-el Thomas Caparas,2,0,36,34
1657491188173,MATH 20C,A01,083760,Briones; Jor-el Thomas Caparas,1,0,35,34
1657491188173,MATH 20C,A02,083761,Briones; Jor-el Thomas Caparas,8,0,35,27
1657491188173,MATH 20C,A03,093476,Briones; Jor-el Thomas Caparas,0,1,36,36
1657491188173,MATH 20C,B01,083762,Bach; Quang Tran,1,0,30,29
1657491194273,MATH 20D,A01,083765,Tran; Brian Kha,5,0,30,25
1657491194273,MATH 20D,A02,083766,Tran; Brian Kha,5,0,30,25
1657491194273,MATH 20D,A03,083767,Tran; Brian Kha,5,0,30,25
1657491200297,MATH 20E,A01,083771,Ganguly; Soumya,9,0,32,23
1657491200297,MATH 20E,A02,083772,Ganguly; Soumya,6,0,32,26
1657491200297,MATH 20E,B01,083773,Ciotti; Benjamin,20,0,35,15
1657491200297,MATH 20E,B02,083774,Ciotti; Benjamin,17,0,35,18
1657491206319,MATH 103A,A01,083777,Greenfeld; Be'Eri,3,0,36,33
1657491206319,MATH 103A,A02,083778,Greenfeld; Be'Eri,5,0,36,31
1657491206319,MATH 103A,A03,093561,Greenfeld; Be'Eri,5,0,36,31
1657491206319,MATH 103A,B01,083779,Greenfeld; Be'Eri,7,0,36,29
1657491206319,MATH 103A,B02,083780,Greenfeld; Be'Eri,4,0,36,32
1657491206319,MATH 103A,B03,093562,Greenfeld; Be'Eri,3,0,36,33
1657491212353,MATH 105,A01,085443,Carter; Anne Toulson,15,0,35,20
1657491212353,MATH 105,A02,093477,Carter; Anne Toulson,20,0,35,15
1657491218377,MATH 109,A01,083213,Ganzberger; Geoffrey Michael,2,0,34,32
1657491218377,MATH 109,A02,083214,Ganzberger; Geoffrey Michael,4,0,34,30
1657491218377,MATH 109,A03,093478,Ganzberger; Geoffrey Michael,2,0,34,32
1657491218377,MATH 109,B01,083215,Ganzberger; Geoffrey Michael,1,0,32,31
1657491218377,MATH 109,B02,083216,Ganzberger; Geoffrey Michael,2,0,32,30
1657491218377,MATH 109,B03,093479,Ganzberger; Geoffrey Michael,8,0,32,24
1657491224400,MATH 142A,A01,083219,Chow; Bennett,7,0,32,25
1657491224400,MATH 142A,A02,083220,Chow; Bennett,10,0,32,22
1657491224400,MATH 142A,A03,093480,Chow; Bennett,8,0,32,24
1657491224400,MATH 142A,B03,093481,Chow; Bennett,8,0,32,24
1657491224400,MATH 142A,B04,093558,Chow; Bennett,13,0,32,19
1657491224400,MATH 142A,B05,093559,Chow; Bennett,6,0,32,26
1657491230424,MATH 193A,A01,083224,Rotar; Vladimir,8,0,34,26
1657491230424,MATH 193A,A02,083225,Rotar; Vladimir,9,0,34,25
1657491230424,MATH 193A,A03,083781,Rotar; Vladimir,5,0,34,29
1657491230424,MATH 193A,A04,083782,Rotar; Vladimir,10,0,34,24
1657491230424,MATH 193A,A05,093482,Rotar; Vladimir,10,0,34,24
1657491236450,MATH 197,001,091859,McAuley; Julian John,9999,0,9999,0
1657491236450,MATH 197,002,095566,Kedlaya; Kiran S.,9997,0,9999,2
1657491236450,MATH 197,003,095567,Xiao; Ming,9999,0,9999,0
1657491236450,MATH 197,004,095571,Perols; Johan Lars,9998,0,9999,1
1657491243505,COGS 9,A01,083615,Shannon; Kyle Michael,9,0,75,66
1657491249529,COGS 11,A01,083617,Boyle; Mary E. T.,22,0,48,26
1657491255551,COGS 13,A01,083071,Bastos; Amalia Pinkusfeld,11,0,71,60
1657491261574,COGS 14A,A01,092681,Semenuks; Arturs,5,1,100,95
1657491267599,COGS 14B,A01,083073,Cheng; Tzu-Han,6,0,63,57
1657491273629,COGS 17,A01,092677,Semenuks; Arturs,6,0,81,75
1657491279659,COGS 100,A01,083619,Allen; Michael Gordon,17,0,70,53
1657491285682,COGS 101A,A01,083621,Davis; Joshua Daniel,9,0,68,59
1657491291705,COGS 101B,A01,091572,Allen; Michael Gordon,12,0,65,53
1657491297731,COGS 101C,A01,083625,Delgado; Tania,17,0,35,18
1657491303754,COGS 107A,A01,083627,Boyle; Mary E. T.,13,0,60,47
1657491309778,COGS 118A,A01,083075,Gupta; Anjum,21,0,76,55
1657491315804,CSE 3,A50,083646,Miranda; Gregory Joseph,24,0,50,26
1657491321827,CSE 8A,A50,083650,Miranda; Gregory Joseph,17,1,56,39
1657491327851,CSE 11,A01,083080,Cao; Yingjun,6,15,40,34
1657491333873,CSE 12,A01,083652,Krause-Levy; Sophia Louisa,28,1,120,92
1657491339895,CSE 15L,A01,083654,Morris; Justin Loren,9,0,50,41
1657491339895,CSE 15L,A02,083655,Morris; Justin Loren,9,0,50,41
1657491345921,CSE 20,A01,083657,Tran; Khoa Dang,39,0,80,41
1657491351948,CSE 21,A01,095574,Bach; Quang Tran,22,0,48,26
1657491357976,CSE 30,A01,083084,Eldon; John,5,0,80,75
1657491357976,CSE 30,B01,095061,Bhaskar; Nishant,9,0,50,41
1657491363999,CSE 100,A01,083659,Cao; Yingjun,5,4,70,65
1657491370029,CSE 134B,A01,083661,Powell; Thomas Allan,22,0,100,78
1657491376055,CSE 140,A01,083663,Gungor; Onat,15,0,85,70
1657491382082,CSE 140L,A01,083088,Eldon; John,21,0,100,79
1657491388106,CSE 175,A01,083665,Kumar; Rakesh,3,0,25,22
1657491394132,CSE 190,A00,092507,Dubnov; Shlomo,8,0,20,12
1657491400159,ECE 45,A01,083139,Congero; Spencer William,6,0,75,69
1657491406182,ECE 65,A50,083695,Saad; Andrew S,12,0,30,18
1657491406182,ECE 65,A51,095125,Saad; Andrew S,24,0,26,2
1657491412208,ECE 109,A01,091882,Touri; Behrouz,19,0,70,51
1657491418231,ECE 180,A00,083140,Abi Samra; Nicholas Camill,1,0,30,29
1657491418231,ECE 180,B00,083141,Abi Samra; Nicholas Camill,0,0,30,30
1657491424253,MATH 10A,A01,083735,Patchell; Gregory David,2,0,30,28
1657491424253,MATH 10A,A02,083736,Patchell; Gregory David,20,0,30,10
1657491424253,MATH 10A,A03,083737,Patchell; Gregory David,16,0,30,14
1657491430282,MATH 10B,A01,083207,Lim; Seonhee,8,0,34,26
1657491430282,MATH 10B,A02,083208,Lim; Seonhee,9,0,35,26
1657491430282,MATH 10B,A03,093472,Lim; Seonhee,7,0,34,27
1657491430282,MATH 10B,B01,083739,Sinha; Shubham,12,0,30,18
1657491436313,MATH 18,A01,083743,Cinel; Cameron Alexander,7,0,30,23
1657491436313,MATH 18,A02,083744,Cinel; Cameron Alexander,17,0,30,13
1657491436313,MATH 18,A03,083745,Cinel; Cameron Alexander,9,0,30,21
1657491436313,MATH 18,B01,083748,Rideout; David Porter,5,0,37,32
1657491436313,MATH 18,B02,083749,Rideout; David Porter,5,0,36,31
1657491436313,MATH 18,B03,083750,Rideout; David Porter,3,0,37,34
1657491436313,MATH 18,B04,083751,Rideout; David Porter,6,0,36,30
1657491436313,MATH 18,B05,093473,Rideout; David Porter,6,0,36,30
1657491436313,MATH 18,B06,093474,Rideout; David Porter,6,0,36,30
1657491442337,MATH 20A,A01,083754,Zheng; Zequn,14,0,40,26
1657491448363,MATH 20B,A01,083756,Briones; Jor-el Thomas Caparas,4,0,36,32
1657491448363,MATH 20B,A02,083757,Briones; Jor-el Thomas Caparas,1,0,36,35
1657491448363,MATH 20B,A03,093475,Briones; Jor-el Thomas Caparas,2,0,36,34
1657491454386,MATH 20C,A01,083760,Briones; Jor-el Thomas Caparas,1,0,35,34
1657491454386,MATH 20C,A02,083761,Briones; Jor-el Thomas Caparas,8,0,35,27
1657491454386,MATH 20C,A03,093476,Briones; Jor-el Thomas Caparas,0,1,36,36
1657491454386,MATH 20C,B01,083762,Bach; Quang Tran,1,0,30,29
1657491460419,MATH 20D,A01,083765,Tran; Brian Kha,5,0,30,25
1657491460419,MATH 20D,A02,083766,Tran; Brian Kha,5,0,30,25
1657491460419,MATH 20D,A03,083767,Tran; Brian Kha,5,0,30,25
1657491466446,MATH 20E,A01,083771,Ganguly; Soumya,9,0,32,23
1657491466446,MATH 20E,A02,083772,Ganguly; Soumya,6,0,32,26
1657491466446,MATH 20E,B01,083773,Ciotti; Benjamin,20,0,35,15
1657491466446,MATH 20E,B02,083774,Ciotti; Benjamin,17,0,35,18
1657491472476,MATH 103A,A01,083777,Greenfeld; Be'Eri,3,0,36,33
1657491472476,MATH 103A,A02,083778,Greenfeld; Be'Eri,5,0,36,31
1657491472476,MATH 103A,A03,093561,Greenfeld; Be'Eri,5,0,36,31
1657491472476,MATH 103A,B01,083779,Greenfeld; Be'Eri,7,0,36,29
1657491472476,MATH 103A,B02,083780,Greenfeld; Be'Eri,4,0,36,32
1657491472476,MATH 103A,B03,093562,Greenfeld; Be'Eri,3,0,36,33
1657491478499,MATH 105,A01,085443,Carter; Anne Toulson,15,0,35,20
1657491478499,MATH 105,A02,093477,Carter; Anne Toulson,20,0,35,15
1657491484521,MATH 109,A01,083213,Ganzberger; Geoffrey Michael,2,0,34,32
1657491484521,MATH 109,A02,083214,Ganzberger; Geoffrey Michael,4,0,34,30
1657491484521,MATH 109,A03,093478,Ganzberger; Geoffrey Michael,2,0,34,32
1657491484521,MATH 109,B01,083215,Ganzberger; Geoffrey Michael,1,0,32,31
1657491484521,MATH 109,B02,083216,Ganzberger; Geoffrey Michael,2,0,32,30
1657491484521,MATH 109,B03,093479,Ganzberger; Geoffrey Michael,8,0,32,24
1657491490544,MATH 142A,A01,083219,Chow; Bennett,7,0,32,25
1657491490544,MATH 142A,A02,083220,Chow; Bennett,10,0,32,22
1657491490544,MATH 142A,A03,093480,Chow; Bennett,8,0,32,24
1657491490544,MATH 142A,B03,093481,Chow; Bennett,8,0,32,24
1657491490544,MATH 142A,B04,093558,Chow; Bennett,13,0,32,19
1657491490544,MATH 142A,B05,093559,Chow; Bennett,6,0,32,26
1657491496568,MATH 193A,A01,083224,Rotar; Vladimir,8,0,34,26
1657491496568,MATH 193A,A02,083225,Rotar; Vladimir,9,0,34,25
1657491496568,MATH 193A,A03,083781,Rotar; Vladimir,5,0,34,29
1657491496568,MATH 193A,A04,083782,Rotar; Vladimir,10,0,34,24
1657491496568,MATH 193A,A05,093482,Rotar; Vladimir,10,0,34,24
1657491502591,MATH 197,001,091859,McAuley; Julian John,9999,0,9999,0
1657491502591,MATH 197,002,095566,Kedlaya; Kiran S.,9997,0,9999,2
1657491502591,MATH 197,003,095567,Xiao; Ming,9999,0,9999,0
1657491502591,MATH 197,004,095571,Perols; Johan Lars,9998,0,9999,1
1657491509643,COGS 9,A01,083615,Shannon; Kyle Michael,9,0,75,66
1657491515665,COGS 11,A01,083617,Boyle; Mary E. T.,22,0,48,26
1657491521695,COGS 13,A01,083071,Bastos; Amalia Pinkusfeld,11,0,71,60
1657491527719,COGS 14A,A01,092681,Semenuks; Arturs,5,1,100,95
1657491533740,COGS 14B,A01,083073,Cheng; Tzu-Han,6,0,63,57
1657491539768,COGS 17,A01,092677,Semenuks; Arturs,6,0,81,75
1657491545791,COGS 100,A01,083619,Allen; Michael Gordon,17,0,70,53
1657491551818,COGS 101A,A01,083621,Davis; Joshua Daniel,9,0,68,59
1657491557840,COGS 101B,A01,091572,Allen; Michael Gordon,12,0,65,53
1657491563865,COGS 101C,A01,083625,Delgado; Tania,17,0,35,18
1657491569889,COGS 107A,A01,083627,Boyle; Mary E. T.,13,0,60,47
1657491575913,COGS 118A,A01,083075,Gupta; Anjum,21,0,76,55
1657491581942,CSE 3,A50,083646,Miranda; Gregory Joseph,24,0,50,26
1657491587968,CSE 8A,A50,083650,Miranda; Gregory Joseph,17,1,56,39
1657491593993,CSE 11,A01,083080,Cao; Yingjun,6,15,40,34
1657491600016,CSE 12,A01,083652,Krause-Levy; Sophia Louisa,28,1,120,92
1657491606039,CSE 15L,A01,083654,Morris; Justin Loren,9,0,50,41
1657491606039,CSE 15L,A02,083655,Morris; Justin Loren,9,0,50,41
1657491612061,CSE 20,A01,083657,Tran; Khoa Dang,39,0,80,41
1657491618085,CSE 21,A01,095574,Bach; Quang Tran,22,0,48,26
1657491624110,CSE 30,A01,083084,Eldon; John,5,0,80,75
1657491624110,CSE 30,B01,095061,Bhaskar; Nishant,9,0,50,41
1657491630137,CSE 100,A01,083659,Cao; Yingjun,5,4,70,65
1657491636164,CSE 134B,A01,083661,Powell; Thomas Allan,22,0,100,78
1657491642192,CSE 140,A01,083663,Gungor; Onat,15,0,85,70
1657491648223,CSE 140L,A01,083088,Eldon; John,21,0,100,79
1657491654251,CSE 175,A01,083665,Kumar; Rakesh,3,0,25,22
1657491660273,CSE 190,A00,092507,Dubnov; Shlomo,8,0,20,12
1657491666300,ECE 45,A01,083139,Congero; Spencer William,6,0,75,69
1657491672328,ECE 65,A50,083695,Saad; Andrew S,12,0,30,18
1657491672328,ECE 65,A51,095125,Saad; Andrew S,24,0,26,2
1657491678350,ECE 109,A01,091882,Touri; Behrouz,19,0,70,51
1657491684383,ECE 180,A00,083140,Abi Samra; Nicholas Camill,1,0,30,29
1657491684383,ECE 180,B00,083141,Abi Samra; Nicholas Camill,0,0,30,30
1657491690410,MATH 10A,A01,083735,Patchell; Gregory David,2,0,30,28
1657491690410,MATH 10A,A02,083736,Patchell; Gregory David,20,0,30,10
1657491690410,MATH 10A,A03,083737,Patchell; Gregory David,16,0,30,14
1657491696439,MATH 10B,A01,083207,Lim; Seonhee,8,0,34,26
1657491696439,MATH 10B,A02,083208,Lim; Seonhee,9,0,35,26
1657491696439,MATH 10B,A03,093472,Lim; Seonhee,7,0,34,27
1657491696439,MATH 10B,B01,083739,Sinha; Shubham,12,0,30,18
1657491702468,MATH 18,A01,083743,Cinel; Cameron Alexander,7,0,30,23
1657491702468,MATH 18,A02,083744,Cinel; Cameron Alexander,17,0,30,13
1657491702468,MATH 18,A03,083745,Cinel; Cameron Alexander,9,0,30,21
1657491702468,MATH 18,B01,083748,Rideout; David Porter,5,0,37,32
1657491702468,MATH 18,B02,083749,Rideout; David Porter,5,0,36,31
1657491702468,MATH 18,B03,083750,Rideout; David Porter,3,0,37,34
1657491702468,MATH 18,B04,083751,Rideout; David Porter,6,0,36,30
1657491702468,MATH 18,B05,093473,Rideout; David Porter,6,0,36,30
1657491702468,MATH 18,B06,093474,Rideout; David Porter,6,0,36,30
1657491708490,MATH 20A,A01,083754,Zheng; Zequn,14,0,40,26
1657491714513,MATH 20B,A01,083756,Briones; Jor-el Thomas Caparas,4,0,36,32
1657491714513,MATH 20B,A02,083757,Briones; Jor-el Thomas Caparas,1,0,36,35
1657491714513,MATH 20B,A03,093475,Briones; Jor-el Thomas Caparas,2,0,36,34
1657491720543,MATH 20C,A01,083760,Briones; Jor-el Thomas Caparas,1,0,35,34
1657491720543,MATH 20C,A02,083761,Briones; Jor-el Thomas Caparas,8,0,35,27
1657491720543,MATH 20C,A03,093476,Briones; Jor-el Thomas Caparas,0,1,36,36
1657491720543,MATH 20C,B01,083762,Bach; Quang Tran,1,0,30,29
1657491726572,MATH 20D,A01,083765,Tran; Brian Kha,5,0,30,25
1657491726572,MATH 20D,A02,083766,Tran; Brian Kha,5,0,30,25
1657491726572,MATH 20D,A03,083767,Tran; Brian Kha,5,0,30,25
1657491732605,MATH 20E,A01,083771,Ganguly; Soumya,9,0,32,23
1657491732605,MATH 20E,A02,083772,Ganguly; Soumya,6,0,32,26
1657491732605,MATH 20E,B01,083773,Ciotti; Benjamin,20,0,35,15
1657491732605,MATH 20E,B02,083774,Ciotti; Benjamin,17,0,35,18
1657491738630,MATH 103A,A01,083777,Greenfeld; Be'Eri,3,0,36,33
1657491738630,MATH 103A,A02,083778,Greenfeld; Be'Eri,5,0,36,31
1657491738630,MATH 103A,A03,093561,Greenfeld; Be'Eri,5,0,36,31
1657491738630,MATH 103A,B01,083779,Greenfeld; Be'Eri,7,0,36,29
1657491738630,MATH 103A,B02,083780,Greenfeld; Be'Eri,4,0,36,32
1657491738630,MATH 103A,B03,093562,Greenfeld; Be'Eri,3,0,36,33
1657491744672,MATH 105,A01,085443,Carter; Anne Toulson,15,0,35,20
1657491744672,MATH 105,A02,093477,Carter; Anne Toulson,20,0,35,15
1657491750696,MATH 109,A01,083213,Ganzberger; Geoffrey Michael,2,0,34,32
1657491750696,MATH 109,A02,083214,Ganzberger; Geoffrey Michael,4,0,34,30
1657491750696,MATH 109,A03,093478,Ganzberger; Geoffrey Michael,2,0,34,32
1657491750696,MATH 109,B01,083215,Ganzberger; Geoffrey Michael,1,0,32,31
1657491750696,MATH 109,B02,083216,Ganzberger; Geoffrey Michael,2,0,32,30
1657491750696,MATH 109,B03,093479,Ganzberger; Geoffrey Michael,8,0,32,24
1657491756719,MATH 142A,A01,083219,Chow; Bennett,7,0,32,25
1657491756719,MATH 142A,A02,083220,Chow; Bennett,10,0,32,22
1657491756719,MATH 142A,A03,093480,Chow; Bennett,8,0,32,24
1657491756719,MATH 142A,B03,093481,Chow; Bennett,8,0,32,24
1657491756719,MATH 142A,B04,093558,Chow; Bennett,13,0,32,19
1657491756719,MATH 142A,B05,093559,Chow; Bennett,6,0,32,26
1657491762747,MATH 193A,A01,083224,Rotar; Vladimir,8,0,34,26
1657491762747,MATH 193A,A02,083225,Rotar; Vladimir,9,0,34,25
1657491762747,MATH 193A,A03,083781,Rotar; Vladimir,5,0,34,29
1657491762747,MATH 193A,A04,083782,Rotar; Vladimir,10,0,34,24
1657491762747,MATH 193A,A05,093482,Rotar; Vladimir,10,0,34,24
1657491768772,MATH 197,001,091859,McAuley; Julian John,9999,0,9999,0
1657491768772,MATH 197,002,095566,Kedlaya; Kiran S.,9997,0,9999,2
1657491768772,MATH 197,003,095567,Xiao; Ming,9999,0,9999,0
1657491768772,MATH 197,004,095571,Perols; Johan Lars,9998,0,9999,1
1657491775847,COGS 9,A01,083615,Shannon; Kyle Michael,9,0,75,66
1657491781872,COGS 11,A01,083617,Boyle; Mary E. T.,22,0,48,26
1657491787970,COGS 13,A01,083071,Bastos; Amalia Pinkusfeld,11,0,71,60
1657491793992,COGS 14A,A01,092681,Semenuks; Arturs,5,1,100,95
1657491800015,COGS 14B,A01,083073,Cheng; Tzu-Han,6,0,63,57
1657491806037,COGS 17,A01,092677,Semenuks; Arturs,6,0,81,75
1657491812060,COGS 100,A01,083619,Allen; Michael Gordon,17,0,70,53
1657491818087,COGS 101A,A01,083621,Davis; Joshua Daniel,9,0,68,59
1657491824115,COGS 101B,A01,091572,Allen; Michael Gordon,12,0,65,53
1657491830141,COGS 101C,A01,083625,Delgado; Tania,17,0,35,18
1657491836165,COGS 107A,A01,083627,Boyle; Mary E. T.,13,0,60,47
1657491842188,COGS 118A,A01,083075,Gupta; Anjum,21,0,76,55
1657491848222,CSE 3,A50,083646,Miranda; Gregory Joseph,24,0,50,26
1657491854249,CSE 8A,A50,083650,Miranda; Gregory Joseph,17,1,56,39
1657491860276,CSE 11,A01,083080,Cao; Yingjun,6,15,40,34
1657491866301,CSE 12,A01,083652,Krause-Levy; Sophia Louisa,28,1,120,92
1657491872326,CSE 15L,A01,083654,Morris; Justin Loren,9,0,50,41
1657491872326,CSE 15L,A02,083655,Morris; Justin Loren,9,0,50,41
1657491878359,CSE 20,A01,083657,Tran; Khoa Dang,39,0,80,41
1657491884383,CSE 21,A01,095574,Bach; Quang Tran,22,0,48,26
1657491890405,CSE 30,A01,083084,Eldon; John,5,0,80,75
1657491890405,CSE 30,B01,095061,Bhaskar; Nishant,9,0,50,41
1657491896432,CSE 100,A01,083659,Cao; Yingjun,5,4,70,65
1657491902461,CSE 134B,A01,083661,Powell; Thomas Allan,22,0,100,78
1657491908483,CSE 140,A01,083663,Gungor; Onat,15,0,85,70
1657491914510,CSE 140L,A01,083088,Eldon; John,21,0,100,79
1657491920536,CSE 175,A01,083665,Kumar; Rakesh,3,0,25,22
1657491926561,CSE 190,A00,092507,Dubnov; Shlomo,8,0,20,12
1657491932583,ECE 45,A01,083139,Congero; Spencer William,6,0,75,69
1657491938608,ECE 65,A50,083695,Saad; Andrew S,12,0,30,18
1657491938608,ECE 65,A51,095125,Saad; Andrew S,24,0,26,2
1657491944633,ECE 109,A01,091882,Touri; Behrouz,19,0,70,51
1657491950656,ECE 180,A00,083140,Abi Samra; Nicholas Camill,1,0,30,29
1657491950656,ECE 180,B00,083141,Abi Samra; Nicholas Camill,0,0,30,30
1657491956684,MATH 10A,A01,083735,Patchell; Gregory David,2,0,30,28
1657491956684,MATH 10A,A02,083736,Patchell; Gregory David,20,0,30,10
1657491956684,MATH 10A,A03,083737,Patchell; Gregory David,16,0,30,14
1657491962708,MATH 10B,A01,083207,Lim; Seonhee,8,0,34,26
1657491962708,MATH 10B,A02,083208,Lim; Seonhee,9,0,35,26
1657491962708,MATH 10B,A03,093472,Lim; Seonhee,7,0,34,27
1657491962708,MATH 10B,B01,083739,Sinha; Shubham,12,0,30,18
1657491968731,MATH 18,A01,083743,Cinel; Cameron Alexander,7,0,30,23
1657491968731,MATH 18,A02,083744,Cinel; Cameron Alexander,17,0,30,13
1657491968731,MATH 18,A03,083745,Cinel; Cameron Alexander,9,0,30,21
1657491968731,MATH 18,B01,083748,Rideout; David Porter,5,0,37,32
1657491968731,MATH 18,B02,083749,Rideout; David Porter,5,0,36,31
1657491968731,MATH 18,B03,083750,Rideout; David Porter,3,0,37,34
1657491968731,MATH 18,B04,083751,Rideout; David Porter,6,0,36,30
1657491968731,MATH 18,B05,093473,Rideout; David Porter,6,0,36,30
1657491968731,MATH 18,B06,093474,Rideout; David Porter,6,0,36,30
1657491974757,MATH 20A,A01,083754,Zheng; Zequn,14,0,40,26
1657491980786,MATH 20B,A01,083756,Briones; Jor-el Thomas Caparas,4,0,36,32
1657491980786,MATH 20B,A02,083757,Briones; Jor-el Thomas Caparas,1,0,36,35
1657491980786,MATH 20B,A03,093475,Briones; Jor-el Thomas Caparas,2,0,36,34
1657491986816,MATH 20C,A01,083760,Briones; Jor-el Thomas Caparas,1,0,35,34
1657491986816,MATH 20C,A02,083761,Briones; Jor-el Thomas Caparas,8,0,35,27
1657491986816,MATH 20C,A03,093476,Briones; Jor-el Thomas Caparas,0,1,36,36
1657491986816,MATH 20C,B01,083762,Bach; Quang Tran,1,0,30,29
1657491992841,MATH 20D,A01,083765,Tran; Brian Kha,5,0,30,25
1657491992841,MATH 20D,A02,083766,Tran; Brian Kha,5,0,30,25
1657491992841,MATH 20D,A03,083767,Tran; Brian Kha,5,0,30,25
1657491998864,MATH 20E,A01,083771,Ganguly; Soumya,9,0,32,23
1657491998864,MATH 20E,A02,083772,Ganguly; Soumya,6,0,32,26
1657491998864,MATH 20E,B01,083773,Ciotti; Benjamin,20,0,35,15
1657491998864,MATH 20E,B02,083774,Ciotti; Benjamin,17,0,35,18
1657492004894,MATH 103A,A01,083777,Greenfeld; Be'Eri,3,0,36,33
1657492004894,MATH 103A,A02,083778,Greenfeld; Be'Eri,5,0,36,31
1657492004894,MATH 103A,A03,093561,Greenfeld; Be'Eri,5,0,36,31
1657492004894,MATH 103A,B01,083779,Greenfeld; Be'Eri,7,0,36,29
1657492004894,MATH 103A,B02,083780,Greenfeld; Be'Eri,4,0,36,32
1657492004894,MATH 103A,B03,093562,Greenfeld; Be'Eri,3,0,36,33
1657492010920,MATH 105,A01,085443,Carter; Anne Toulson,15,0,35,20
1657492010920,MATH 105,A02,093477,Carter; Anne Toulson,20,0,35,15
1657492016944,MATH 109,A01,083213,Ganzberger; Geoffrey Michael,2,0,34,32
1657492016944,MATH 109,A02,083214,Ganzberger; Geoffrey Michael,4,0,34,30
1657492016944,MATH 109,A03,093478,Ganzberger; Geoffrey Michael,2,0,34,32
1657492016944,MATH 109,B01,083215,Ganzberger; Geoffrey Michael,1,0,32,31
1657492016944,MATH 109,B02,083216,Ganzberger; Geoffrey Michael,2,0,32,30
1657492016944,MATH 109,B03,093479,Ganzberger; Geoffrey Michael,8,0,32,24
1657492022971,MATH 142A,A01,083219,Chow; Bennett,7,0,32,25
1657492022971,MATH 142A,A02,083220,Chow; Bennett,10,0,32,22
1657492022971,MATH 142A,A03,093480,Chow; Bennett,8,0,32,24
1657492022971,MATH 142A,B03,093481,Chow; Bennett,8,0,32,24
1657492022971,MATH 142A,B04,093558,Chow; Bennett,13,0,32,19
1657492022971,MATH 142A,B05,093559,Chow; Bennett,6,0,32,26
1657492029058,MATH 193A,A01,083224,Rotar; Vladimir,8,0,34,26
1657492029058,MATH 193A,A02,083225,Rotar; Vladimir,9,0,34,25
1657492029058,MATH 193A,A03,083781,Rotar; Vladimir,5,0,34,29
1657492029058,MATH 193A,A04,083782,Rotar; Vladimir,10,0,34,24
1657492029058,MATH 193A,A05,093482,Rotar; Vladimir,10,0,34,24
1657492035086,MATH 197,001,091859,McAuley; Julian John,9999,0,9999,0
1657492035086,MATH 197,002,095566,Kedlaya; Kiran S.,9997,0,9999,2
1657492035086,MATH 197,003,095567,Xiao; Ming,9999,0,9999,0
1657492035086,MATH 197,004,095571,Perols; Johan Lars,9998,0,9999,1
1657492042159,COGS 9,A01,083615,Shannon; Kyle Michael,9,0,75,66
1657492048183,COGS 11,A01,083617,Boyle; Mary E. T.,22,0,48,26
1657492054213,COGS 13,A01,083071,Bastos; Amalia Pinkusfeld,11,0,71,60
1657492060236,COGS 14A,A01,092681,Semenuks; Arturs,5,1,100,95
1657492066262,COGS 14B,A01,083073,Cheng; Tzu-Han,6,0,63,57
1657492072285,COGS 17,A01,092677,Semenuks; Arturs,6,0,81,75
1657492078308,COGS 100,A01,083619,Allen; Michael Gordon,17,0,70,53
1657492084343,COGS 101A,A01,083621,Davis; Joshua Daniel,9,0,68,59
1657492090370,COGS 101B,A01,091572,Allen; Michael Gordon,12,0,65,53
1657492096392,COGS 101C,A01,083625,Delgado; Tania,17,0,35,18
1657492102419,COGS 107A,A01,083627,Boyle; Mary E. T.,13,0,60,47
1657492108444,COGS 118A,A01,083075,Gupta; Anjum,21,0,76,55
1657492114467,CSE 3,A50,083646,Miranda; Gregory Joseph,24,0,50,26
1657492120490,CSE 8A,A50,083650,Miranda; Gregory Joseph,17,1,56,39
1657492126516,CSE 11,A01,083080,Cao; Yingjun,6,15,40,34
1657492132548,CSE 12,A01,083652,Krause-Levy; Sophia Louisa,28,1,120,92
1657492138571,CSE 15L,A01,083654,Morris; Justin Loren,9,0,50,41
1657492138571,CSE 15L,A02,083655,Morris; Justin Loren,9,0,50,41
1657492144594,CSE 20,A01,083657,Tran; Khoa Dang,39,0,80,41
1657492150621,CSE 21,A01,095574,Bach; Quang Tran,22,0,48,26
1657492156645,CSE 30,A01,083084,Eldon; John,5,0,80,75
1657492156645,CSE 30,B01,095061,Bhaskar; Nishant,9,0,50,41
1657492162668,CSE 100,A01,083659,Cao; Yingjun,5,4,70,65
1657492168694,CSE 134B,A01,083661,Powell; Thomas Allan,22,0,100,78
1657492174716,CSE 140,A01,083663,Gungor; Onat,15,0,85,70
1657492180739,CSE 140L,A01,083088,Eldon; John,21,0,100,79
1657492197035,CSE 175,A01,083665,Kumar; Rakesh,3,0,25,22
1657492203068,CSE 190,A00,092507,Dubnov; Shlomo,8,0,20,12
1657492209089,ECE 45,A01,083139,Congero; Spencer William,6,0,75,69
1657492215113,ECE 65,A50,083695,Saad; Andrew S,12,0,30,18
1657492215113,ECE 65,A51,095125,Saad; Andrew S,24,0,26,2
1657492221135,ECE 109,A01,091882,Touri; Behrouz,19,0,70,51
1657492227160,ECE 180,A00,083140,Abi Samra; Nicholas Camill,1,0,30,29
1657492227160,ECE 180,B00,083141,Abi Samra; Nicholas Camill,0,0,30,30
1657492233184,MATH 10A,A01,083735,Patchell; Gregory David,2,0,30,28
1657492233184,MATH 10A,A02,083736,Patchell; Gregory David,20,0,30,10
1657492233184,MATH 10A,A03,083737,Patchell; Gregory David,16,0,30,14
1657492239207,MATH 10B,A01,083207,Lim; Seonhee,8,0,34,26
1657492239207,MATH 10B,A02,083208,Lim; Seonhee,9,0,35,26
1657492239207,MATH 10B,A03,093472,Lim; Seonhee,7,0,34,27
1657492239207,MATH 10B,B01,083739,Sinha; Shubham,12,0,30,18
1657492245232,MATH 18,A01,083743,Cinel; Cameron Alexander,7,0,30,23
1657492245232,MATH 18,A02,083744,Cinel; Cameron Alexander,17,0,30,13
1657492245232,MATH 18,A03,083745,Cinel; Cameron Alexander,9,0,30,21
1657492245232,MATH 18,B01,083748,Rideout; David Porter,5,0,37,32
1657492245232,MATH 18,B02,083749,Rideout; David Porter,5,0,36,31
1657492245232,MATH 18,B03,083750,Rideout; David Porter,3,0,37,34
1657492245232,MATH 18,B04,083751,Rideout; David Porter,6,0,36,30
1657492245232,MATH 18,B05,093473,Rideout; David Porter,6,0,36,30
1657492245232,MATH 18,B06,093474,Rideout; David Porter,6,0,36,30
1657492251259,MATH 20A,A01,083754,Zheng; Zequn,14,0,40,26
1657492257282,MATH 20B,A01,083756,Briones; Jor-el Thomas Caparas,4,0,36,32
1657492257282,MATH 20B,A02,083757,Briones; Jor-el Thomas Caparas,1,0,36,35
1657492257282,MATH 20B,A03,093475,Briones; Jor-el Thomas Caparas,2,0,36,34
1657492263315,MATH 20C,A01,083760,Briones; Jor-el Thomas Caparas,1,0,35,34
1657492263315,MATH 20C,A02,083761,Briones; Jor-el Thomas Caparas,8,0,35,27
1657492263315,MATH 20C,A03,093476,Briones; Jor-el Thomas Caparas,0,1,36,36
1657492263315,MATH 20C,B01,083762,Bach; Quang Tran,1,0,30,29
1657492269339,MATH 20D,A01,083765,Tran; Brian Kha,5,0,30,25
1657492269339,MATH 20D,A02,083766,Tran; Brian Kha,5,0,30,25
1657492269339,MATH 20D,A03,083767,Tran; Brian Kha,5,0,30,25
1657492275371,MATH 20E,A01,083771,Ganguly; Soumya,9,0,32,23
1657492275371,MATH 20E,A02,083772,Ganguly; Soumya,6,0,32,26
1657492275371,MATH 20E,B01,083773,Ciotti; Benjamin,20,0,35,15
1657492275371,MATH 20E,B02,083774,Ciotti; Benjamin,17,0,35,18
1657492281399,MATH 103A,A01,083777,Greenfeld; Be'Eri,3,0,36,33
1657492281399,MATH 103A,A02,083778,Greenfeld; Be'Eri,5,0,36,31
1657492281399,MATH 103A,A03,093561,Greenfeld; Be'Eri,5,0,36,31
1657492281399,MATH 103A,B01,083779,Greenfeld; Be'Eri,7,0,36,29
1657492281399,MATH 103A,B02,083780,Greenfeld; Be'Eri,4,0,36,32
1657492281399,MATH 103A,B03,093562,Greenfeld; Be'Eri,3,0,36,33
1657492287427,MATH 105,A01,085443,Carter; Anne Toulson,15,0,35,20
1657492287427,MATH 105,A02,093477,Carter; Anne Toulson,20,0,35,15
1657492293448,MATH 109,A01,083213,Ganzberger; Geoffrey Michael,2,0,34,32
1657492293448,MATH 109,A02,083214,Ganzberger; Geoffrey Michael,4,0,34,30
1657492293448,MATH 109,A03,093478,Ganzberger; Geoffrey Michael,2,0,34,32
1657492293448,MATH 109,B01,083215,Ganzberger; Geoffrey Michael,1,0,32,31
1657492293448,MATH 109,B02,083216,Ganzberger; Geoffrey Michael,2,0,32,30
1657492293448,MATH 109,B03,093479,Ganzberger; Geoffrey Michael,8,0,32,24
1657492299477,MATH 142A,A01,083219,Chow; Bennett,7,0,32,25
1657492299477,MATH 142A,A02,083220,Chow; Bennett,10,0,32,22
1657492299477,MATH 142A,A03,093480,Chow; Bennett,8,0,32,24
1657492299477,MATH 142A,B03,093481,Chow; Bennett,8,0,32,24
1657492299477,MATH 142A,B04,093558,Chow; Bennett,13,0,32,19
1657492299477,MATH 142A,B05,093559,Chow; Bennett,6,0,32,26
1657492305509,MATH 193A,A01,083224,Rotar; Vladimir,8,0,34,26
1657492305509,MATH 193A,A02,083225,Rotar; Vladimir,9,0,34,25
1657492305509,MATH 193A,A03,083781,Rotar; Vladimir,5,0,34,29
1657492305509,MATH 193A,A04,083782,Rotar; Vladimir,10,0,34,24
1657492305509,MATH 193A,A05,093482,Rotar; Vladimir,10,0,34,24
1657492311535,MATH 197,001,091859,McAuley; Julian John,9999,0,9999,0
1657492311535,MATH 197,002,095566,Kedlaya; Kiran S.,9997,0,9999,2
1657492311535,MATH 197,003,095567,Xiao; Ming,9999,0,9999,0
1657492311535,MATH 197,004,095571,Perols; Johan Lars,9998,0,9999,1
1657492318602,COGS 9,A01,083615,Shannon; Kyle Michael,9,0,75,66
1657492324624,COGS 11,A01,083617,Boyle; Mary E. T.,22,0,48,26
1657492330645,COGS 13,A01,083071,Bastos; Amalia Pinkusfeld,11,0,71,60
1657492336669,COGS 14A,A01,092681,Semenuks; Arturs,5,1,100,95
1657492342691,COGS 14B,A01,083073,Cheng; Tzu-Han,6,0,63,57
1657492348716,COGS 17,A01,092677,Semenuks; Arturs,6,0,81,75
1657492354741,COGS 100,A01,083619,Allen; Michael Gordon,17,0,70,53
1657492360762,COGS 101A,A01,083621,Davis; Joshua Daniel,9,0,68,59
1657492366783,COGS 101B,A01,091572,Allen; Michael Gordon,12,0,65,53
1657492372814,COGS 101C,A01,083625,Delgado; Tania,17,0,35,18
1657492378836,COGS 107A,A01,083627,Boyle; Mary E. T.,13,0,60,47
1657492384859,COGS 118A,A01,083075,Gupta; Anjum,21,0,76,55
1657492390882,CSE 3,A50,083646,Miranda; Gregory Joseph,24,0,50,26
1657492396976,CSE 8A,A50,083650,Miranda; Gregory Joseph,17,1,56,39
1657492402999,CSE 11,A01,083080,Cao; Yingjun,6,15,40,34
1657492409020,CSE 12,A01,083652,Krause-Levy; Sophia Louisa,28,1,120,92
1657492415043,CSE 15L,A01,083654,Morris; Justin Loren,9,0,50,41
1657492415043,CSE 15L,A02,083655,Morris; Justin Loren,9,0,50,41
1657492421065,CSE 20,A01,083657,Tran; Khoa Dang,39,0,80,41
1657492427089,CSE 21,A01,095574,Bach; Quang Tran,22,0,48,26
1657492433118,CSE 30,A01,083084,Eldon; John,5,0,80,75
1657492433118,CSE 30,B01,095061,Bhaskar; Nishant,9,0,50,41
1657492439145,CSE 100,A01,083659,Cao; Yingjun,5,4,70,65
1657492445172,CSE 134B,A01,083661,Powell; Thomas Allan,22,0,100,78
1657492451196,CSE 140,A01,083663,Gungor; Onat,15,0,85,70
1657492457219,CSE 140L,A01,083088,Eldon; John,21,0,100,79
1657492463242,CSE 175,A01,083665,Kumar; Rakesh,3,0,25,22
1657492469266,CSE 190,A00,092507,Dubnov; Shlomo,8,0,20,12
1657492475288,ECE 45,A01,083139,Congero; Spencer William,6,0,75,69
1657492481311,ECE 65,A50,083695,Saad; Andrew S,12,0,30,18
1657492481311,ECE 65,A51,095125,Saad; Andrew S,24,0,26,2
1657492487340,ECE 109,A01,091882,Touri; Behrouz,19,0,70,51
1657492493365,ECE 180,A00,083140,Abi Samra; Nicholas Camill,1,0,30,29
1657492493365,ECE 180,B00,083141,Abi Samra; Nicholas Camill,0,0,30,30
1657492499388,MATH 10A,A01,083735,Patchell; Gregory David,2,0,30,28
1657492499388,MATH 10A,A02,083736,Patchell; Gregory David,20,0,30,10
1657492499388,MATH 10A,A03,083737,Patchell; Gregory David,16,0,30,14
1657492505416,MATH 10B,A01,083207,Lim; Seonhee,8,0,34,26
1657492505416,MATH 10B,A02,083208,Lim; Seonhee,9,0,35,26
1657492505416,MATH 10B,A03,093472,Lim; Seonhee,7,0,34,27
1657492505416,MATH 10B,B01,083739,Sinha; Shubham,12,0,30,18
1657492511439,MATH 18,A01,083743,Cinel; Cameron Alexander,7,0,30,23
1657492511439,MATH 18,A02,083744,Cinel; Cameron Alexander,17,0,30,13
1657492511439,MATH 18,A03,083745,Cinel; Cameron Alexander,9,0,30,21
1657492511439,MATH 18,B01,083748,Rideout; David Porter,5,0,37,32
1657492511439,MATH 18,B02,083749,Rideout; David Porter,5,0,36,31
1657492511439,MATH 18,B03,083750,Rideout; David Porter,3,0,37,34
1657492511439,MATH 18,B04,083751,Rideout; David Porter,6,0,36,30
1657492511439,MATH 18,B05,093473,Rideout; David Porter,6,0,36,30
1657492511439,MATH 18,B06,093474,Rideout; David Porter,6,0,36,30
1657492517470,MATH 20A,A01,083754,Zheng; Zequn,14,0,40,26
1657492523495,MATH 20B,A01,083756,Briones; Jor-el Thomas Caparas,4,0,36,32
1657492523495,MATH 20B,A02,083757,Briones; Jor-el Thomas Caparas,1,0,36,35
1657492523495,MATH 20B,A03,093475,Briones; Jor-el Thomas Caparas,2,0,36,34
1657492529520,MATH 20C,A01,083760,Briones; Jor-el Thomas Caparas,1,0,35,34
1657492529520,MATH 20C,A02,083761,Briones; Jor-el Thomas Caparas,8,0,35,27
1657492529520,MATH 20C,A03,093476,Briones; Jor-el Thomas Caparas,0,1,36,36
1657492529520,MATH 20C,B01,083762,Bach; Quang Tran,1,0,30,29
1657492535544,MATH 20D,A01,083765,Tran; Brian Kha,5,0,30,25
1657492535544,MATH 20D,A02,083766,Tran; Brian Kha,5,0,30,25
1657492535544,MATH 20D,A03,083767,Tran; Brian Kha,5,0,30,25
1657492541569,MATH 20E,A01,083771,Ganguly; Soumya,9,0,32,23
1657492541569,MATH 20E,A02,083772,Ganguly; Soumya,6,0,32,26
1657492541569,MATH 20E,B01,083773,Ciotti; Benjamin,20,0,35,15
1657492541569,MATH 20E,B02,083774,Ciotti; Benjamin,17,0,35,18
1657492547592,MATH 103A,A01,083777,Greenfeld; Be'Eri,3,0,36,33
1657492547592,MATH 103A,A02,083778,Greenfeld; Be'Eri,5,0,36,31
1657492547592,MATH 103A,A03,093561,Greenfeld; Be'Eri,5,0,36,31
1657492547592,MATH 103A,B01,083779,Greenfeld; Be'Eri,7,0,36,29
1657492547592,MATH 103A,B02,083780,Greenfeld; Be'Eri,4,0,36,32
1657492547592,MATH 103A,B03,093562,Greenfeld; Be'Eri,3,0,36,33
1657492553616,MATH 105,A01,085443,Carter; Anne Toulson,15,0,35,20
1657492553616,MATH 105,A02,093477,Carter; Anne Toulson,20,0,35,15
1657492559645,MATH 109,A01,083213,Ganzberger; Geoffrey Michael,2,0,34,32
1657492559645,MATH 109,A02,083214,Ganzberger; Geoffrey Michael,4,0,34,30
1657492559645,MATH 109,A03,093478,Ganzberger; Geoffrey Michael,2,0,34,32
1657492559645,MATH 109,B01,083215,Ganzberger; Geoffrey Michael,1,0,32,31
1657492559645,MATH 109,B02,083216,Ganzberger; Geoffrey Michael,2,0,32,30
1657492559645,MATH 109,B03,093479,Ganzberger; Geoffrey Michael,8,0,32,24
1657492565674,MATH 142A,A01,083219,Chow; Bennett,7,0,32,25
1657492565674,MATH 142A,A02,083220,Chow; Bennett,10,0,32,22
1657492565674,MATH 142A,A03,093480,Chow; Bennett,8,0,32,24
1657492565674,MATH 142A,B03,093481,Chow; Bennett,8,0,32,24
1657492565674,MATH 142A,B04,093558,Chow; Bennett,13,0,32,19
1657492565674,MATH 142A,B05,093559,Chow; Bennett,6,0,32,26
1657492571696,MATH 193A,A01,083224,Rotar; Vladimir,8,0,34,26
1657492571696,MATH 193A,A02,083225,Rotar; Vladimir,9,0,34,25
1657492571696,MATH 193A,A03,083781,Rotar; Vladimir,5,0,34,29
1657492571696,MATH 193A,A04,083782,Rotar; Vladimir,10,0,34,24
1657492571696,MATH 193A,A05,093482,Rotar; Vladimir,10,0,34,24
1657492577722,MATH 197,001,091859,McAuley; Julian John,9999,0,9999,0
1657492577722,MATH 197,002,095566,Kedlaya; Kiran S.,9997,0,9999,2
1657492577722,MATH 197,003,095567,Xiao; Ming,9999,0,9999,0
1657492577722,MATH 197,004,095571,Perols; Johan Lars,9998,0,9999,1
1657492584778,COGS 9,A01,083615,Shannon; Kyle Michael,9,0,75,66
1657492590805,COGS 11,A01,083617,Boyle; Mary E. T.,22,0,48,26
1657492596838,COGS 13,A01,083071,Bastos; Amalia Pinkusfeld,11,0,71,60
1657492602866,COGS 14A,A01,092681,Semenuks; Arturs,5,1,100,95
1657492608889,COGS 14B,A01,083073,Cheng; Tzu-Han,6,0,63,57
1657492614913,COGS 17,A01,092677,Semenuks; Arturs,6,0,81,75
1657492620950,COGS 100,A01,083619,Allen; Michael Gordon,17,0,70,53
1657492626973,COGS 101A,A01,083621,Davis; Joshua Daniel,9,0,68,59
1657492632995,COGS 101B,A01,091572,Allen; Michael Gordon,12,0,65,53
1657492639019,COGS 101C,A01,083625,Delgado; Tania,17,0,35,18
1657492645043,COGS 107A,A01,083627,Boyle; Mary E. T.,13,0,60,47
1657492651065,COGS 118A,A01,083075,Gupta; Anjum,21,0,76,55
1657492657095,CSE 3,A50,083646,Miranda; Gregory Joseph,24,0,50,26
1657492663119,CSE 8A,A50,083650,Miranda; Gregory Joseph,17,1,56,39
1657492669146,CSE 11,A01,083080,Cao; Yingjun,6,15,40,34
1657492675172,CSE 12,A01,083652,Krause-Levy; Sophia Louisa,28,1,120,92
1657492681195,CSE 15L,A01,083654,Morris; Justin Loren,9,0,50,41
1657492681195,CSE 15L,A02,083655,Morris; Justin Loren,9,0,50,41
1657492687222,CSE 20,A01,083657,Tran; Khoa Dang,39,0,80,41
1657492693245,CSE 21,A01,095574,Bach; Quang Tran,22,0,48,26
1657492699273,CSE 30,A01,083084,Eldon; John,5,0,80,75
1657492699273,CSE 30,B01,095061,Bhaskar; Nishant,9,0,50,41
1657492705296,CSE 100,A01,083659,Cao; Yingjun,5,4,70,65
1657492711318,CSE 134B,A01,083661,Powell; Thomas Allan,22,0,100,78
1657492717342,CSE 140,A01,083663,Gungor; Onat,15,0,85,70
1657492723365,CSE 140L,A01,083088,Eldon; John,21,0,100,79
1657492729389,CSE 175,A01,083665,Kumar; Rakesh,3,0,25,22
1657492735411,CSE 190,A00,092507,Dubnov; Shlomo,8,0,20,12
1657492741450,ECE 45,A01,083139,Congero; Spencer William,6,0,75,69
1657492747473,ECE 65,A50,083695,Saad; Andrew S,12,0,30,18
1657492747473,ECE 65,A51,095125,Saad; Andrew S,24,0,26,2
1657492753497,ECE 109,A01,091882,Touri; Behrouz,19,0,70,51
1657492759537,ECE 180,A00,083140,Abi Samra; Nicholas Camill,1,0,30,29
1657492759537,ECE 180,B00,083141,Abi Samra; Nicholas Camill,0,0,30,30
1657492765565,MATH 10A,A01,083735,Patchell; Gregory David,2,0,30,28
1657492765565,MATH 10A,A02,083736,Patchell; Gregory David,20,0,30,10
1657492765565,MATH 10A,A03,083737,Patchell; Gregory David,16,0,30,14
1657492771597,MATH 10B,A01,083207,Lim; Seonhee,8,0,34,26
1657492771597,MATH 10B,A02,083208,Lim; Seonhee,9,0,35,26
1657492771597,MATH 10B,A03,093472,Lim; Seonhee,7,0,34,27
1657492771597,MATH 10B,B01,083739,Sinha; Shubham,12,0,30,18
1657492777626,MATH 18,A01,083743,Cinel; Cameron Alexander,7,0,30,23
1657492777626,MATH 18,A02,083744,Cinel; Cameron Alexander,17,0,30,13
1657492777626,MATH 18,A03,083745,Cinel; Cameron Alexander,9,0,30,21
1657492777626,MATH 18,B01,083748,Rideout; David Porter,5,0,37,32
1657492777626,MATH 18,B02,083749,Rideout; David Porter,5,0,36,31
1657492777626,MATH 18,B03,083750,Rideout; David Porter,3,0,37,34
1657492777626,MATH 18,B04,083751,Rideout; David Porter,6,0,36,30
1657492777626,MATH 18,B05,093473,Rideout; David Porter,6,0,36,30
1657492777626,MATH 18,B06,093474,Rideout; David Porter,6,0,36,30
1657492783648,MATH 20A,A01,083754,Zheng; Zequn,14,0,40,26
1657492789674,MATH 20B,A01,083756,Briones; Jor-el Thomas Caparas,4,0,36,32
1657492789674,MATH 20B,A02,083757,Briones; Jor-el Thomas Caparas,1,0,36,35
1657492789674,MATH 20B,A03,093475,Briones; Jor-el Thomas Caparas,2,0,36,34
1657492795704,MATH 20C,A01,083760,Briones; Jor-el Thomas Caparas,1,0,35,34
1657492795704,MATH 20C,A02,083761,Briones; Jor-el Thomas Caparas,8,0,35,27
1657492795704,MATH 20C,A03,093476,Briones; Jor-el Thomas Caparas,0,1,36,36
1657492795704,MATH 20C,B01,083762,Bach; Quang Tran,1,0,30,29
1657492801736,MATH 20D,A01,083765,Tran; Brian Kha,5,0,30,25
1657492801736,MATH 20D,A02,083766,Tran; Brian Kha,5,0,30,25
1657492801736,MATH 20D,A03,083767,Tran; Brian Kha,5,0,30,25
1657492807770,MATH 20E,A01,083771,Ganguly; Soumya,9,0,32,23
1657492807770,MATH 20E,A02,083772,Ganguly; Soumya,6,0,32,26
1657492807770,MATH 20E,B01,083773,Ciotti; Benjamin,20,0,35,15
1657492807770,MATH 20E,B02,083774,Ciotti; Benjamin,17,0,35,18
1657492813795,MATH 103A,A01,083777,Greenfeld; Be'Eri,3,0,36,33
1657492813795,MATH 103A,A02,083778,Greenfeld; Be'Eri,5,0,36,31
1657492813795,MATH 103A,A03,093561,Greenfeld; Be'Eri,5,0,36,31
1657492813795,MATH 103A,B01,083779,Greenfeld; Be'Eri,7,0,36,29
1657492813795,MATH 103A,B02,083780,Greenfeld; Be'Eri,4,0,36,32
1657492813795,MATH 103A,B03,093562,Greenfeld; Be'Eri,3,0,36,33
1657492819816,MATH 105,A01,085443,Carter; Anne Toulson,15,0,35,20
1657492819816,MATH 105,A02,093477,Carter; Anne Toulson,20,0,35,15
1657492825838,MATH 109,A01,083213,Ganzberger; Geoffrey Michael,2,0,34,32
1657492825838,MATH 109,A02,083214,Ganzberger; Geoffrey Michael,4,0,34,30
1657492825838,MATH 109,A03,093478,Ganzberger; Geoffrey Michael,2,0,34,32
1657492825838,MATH 109,B01,083215,Ganzberger; Geoffrey Michael,1,0,32,31
1657492825838,MATH 109,B02,083216,Ganzberger; Geoffrey Michael,2,0,32,30
1657492825838,MATH 109,B03,093479,Ganzberger; Geoffrey Michael,8,0,32,24
1657492831866,MATH 142A,A01,083219,Chow; Bennett,7,0,32,25
1657492831866,MATH 142A,A02,083220,Chow; Bennett,10,0,32,22
1657492831866,MATH 142A,A03,093480,Chow; Bennett,8,0,32,24
1657492831866,MATH 142A,B03,093481,Chow; Bennett,8,0,32,24
1657492831866,MATH 142A,B04,093558,Chow; Bennett,13,0,32,19
1657492831866,MATH 142A,B05,093559,Chow; Bennett,6,0,32,26
1657492837895,MATH 193A,A01,083224,Rotar; Vladimir,8,0,34,26
1657492837895,MATH 193A,A02,083225,Rotar; Vladimir,9,0,34,25
1657492837895,MATH 193A,A03,083781,Rotar; Vladimir,5,0,34,29
1657492837895,MATH 193A,A04,083782,Rotar; Vladimir,10,0,34,24
1657492837895,MATH 193A,A05,093482,Rotar; Vladimir,10,0,34,24
1657492843917,MATH 197,001,091859,McAuley; Julian John,9999,0,9999,0
1657492843917,MATH 197,002,095566,Kedlaya; Kiran S.,9997,0,9999,2
1657492843917,MATH 197,003,095567,Xiao; Ming,9999,0,9999,0
1657492843917,MATH 197,004,095571,Perols; Johan Lars,9998,0,9999,1
1657492850967,COGS 9,A01,083615,Shannon; Kyle Michael,9,0,75,66
1657492856989,COGS 11,A01,083617,Boyle; Mary E. T.,22,0,48,26
1657492863012,COGS 13,A01,083071,Bastos; Amalia Pinkusfeld,11,0,71,60
1657492869038,COGS 14A,A01,092681,Semenuks; Arturs,5,1,100,95
1657492875067,COGS 14B,A01,083073,Cheng; Tzu-Han,6,0,63,57
1657492881090,COGS 17,A01,092677,Semenuks; Arturs,6,0,81,75
1657492887110,COGS 100,A01,083619,Allen; Michael Gordon,17,0,70,53
1657492893135,COGS 101A,A01,083621,Davis; Joshua Daniel,9,0,68,59
1657492899161,COGS 101B,A01,091572,Allen; Michael Gordon,12,0,65,53
1657492905183,COGS 101C,A01,083625,Delgado; Tania,17,0,35,18
1657492911206,COGS 107A,A01,083627,Boyle; Mary E. T.,13,0,60,47
1657492917230,COGS 118A,A01,083075,Gupta; Anjum,21,0,76,55
1657492923258,CSE 3,A50,083646,Miranda; Gregory Joseph,24,0,50,26
1657492929292,CSE 8A,A50,083650,Miranda; Gregory Joseph,17,1,56,39
1657492935317,CSE 11,A01,083080,Cao; Yingjun,6,15,40,34
1657492941340,CSE 12,A01,083652,Krause-Levy; Sophia Louisa,28,1,120,92
1657492947363,CSE 15L,A01,083654,Morris; Justin Loren,9,0,50,41
1657492947363,CSE 15L,A02,083655,Morris; Justin Loren,9,0,50,41
1657492953390,CSE 20,A01,083657,Tran; Khoa Dang,39,0,80,41
1657492959411,CSE 21,A01,095574,Bach; Quang Tran,22,0,48,26
1657492965435,CSE 30,A01,083084,Eldon; John,5,0,80,75
1657492965435,CSE 30,B01,095061,Bhaskar; Nishant,9,0,50,41
1657492971462,CSE 100,A01,083659,Cao; Yingjun,5,4,70,65
1657492977486,CSE 134B,A01,083661,Powell; Thomas Allan,22,0,100,78
1657492983515,CSE 140,A01,083663,Gungor; Onat,15,0,85,70
1657492989539,CSE 140L,A01,083088,Eldon; John,21,0,100,79
1657492995640,CSE 175,A01,083665,Kumar; Rakesh,3,0,25,22
1657493001662,CSE 190,A00,092507,Dubnov; Shlomo,8,0,20,12
1657493007688,ECE 45,A01,083139,Congero; Spencer William,6,0,75,69
1657493013711,ECE 65,A50,083695,Saad; Andrew S,12,0,30,18
1657493013711,ECE 65,A51,095125,Saad; Andrew S,24,0,26,2
1657493019733,ECE 109,A01,091882,Touri; Behrouz,19,0,70,51
1657493025757,ECE 180,A00,083140,Abi Samra; Nicholas Camill,1,0,30,29
1657493025757,ECE 180,B00,083141,Abi Samra; Nicholas Camill,0,0,30,30
1657493031783,MATH 10A,A01,083735,Patchell; Gregory David,2,0,30,28
1657493031783,MATH 10A,A02,083736,Patchell; Gregory David,20,0,30,10
1657493031783,MATH 10A,A03,083737,Patchell; Gregory David,16,0,30,14
1657493037805,MATH 10B,A01,083207,Lim; Seonhee,8,0,34,26
1657493037805,MATH 10B,A02,083208,Lim; Seonhee,9,0,35,26
1657493037805,MATH 10B,A03,093472,Lim; Seonhee,7,0,34,27
1657493037805,MATH 10B,B01,083739,Sinha; Shubham,12,0,30,18
1657493043831,MATH 18,A01,083743,Cinel; Cameron Alexander,7,0,30,23
1657493043831,MATH 18,A02,083744,Cinel; Cameron Alexander,17,0,30,13
1657493043831,MATH 18,A03,083745,Cinel; Cameron Alexander,9,0,30,21
1657493043831,MATH 18,B01,083748,Rideout; David Porter,5,0,37,32
1657493043831,MATH 18,B02,083749,Rideout; David Porter,5,0,36,31
1657493043831,MATH 18,B03,083750,Rideout; David Porter,3,0,37,34
1657493043831,MATH 18,B04,083751,Rideout; David Porter,6,0,36,30
1657493043831,MATH 18,B05,093473,Rideout; David Porter,6,0,36,30
1657493043831,MATH 18,B06,093474,Rideout; David Porter,6,0,36,30
1657493049854,MATH 20A,A01,083754,Zheng; Zequn,14,0,40,26
1657493055877,MATH 20B,A01,083756,Briones; Jor-el Thomas Caparas,4,0,36,32
1657493055877,MATH 20B,A02,083757,Briones; Jor-el Thomas Caparas,1,0,36,35
1657493055877,MATH 20B,A03,093475,Briones; Jor-el Thomas Caparas,2,0,36,34
1657493061906,MATH 20C,A01,083760,Briones; Jor-el Thomas Caparas,1,0,35,34
1657493061906,MATH 20C,A02,083761,Briones; Jor-el Thomas Caparas,8,0,35,27
1657493061906,MATH 20C,A03,093476,Briones; Jor-el Thomas Caparas,0,1,36,36
1657493061906,MATH 20C,B01,083762,Bach; Quang Tran,1,0,30,29
1657493067927,MATH 20D,A01,083765,Tran; Brian Kha,5,0,30,25
1657493067927,MATH 20D,A02,083766,Tran; Brian Kha,5,0,30,25
1657493067927,MATH 20D,A03,083767,Tran; Brian Kha,5,0,30,25
1657493073950,MATH 20E,A01,083771,Ganguly; Soumya,9,0,32,23
1657493073950,MATH 20E,A02,083772,Ganguly; Soumya,6,0,32,26
1657493073950,MATH 20E,B01,083773,Ciotti; Benjamin,20,0,35,15
1657493073950,MATH 20E,B02,083774,Ciotti; Benjamin,17,0,35,18
1657493079981,MATH 103A,A01,083777,Greenfeld; Be'Eri,3,0,36,33
1657493079981,MATH 103A,A02,083778,Greenfeld; Be'Eri,5,0,36,31
1657493079981,MATH 103A,A03,093561,Greenfeld; Be'Eri,5,0,36,31
1657493079981,MATH 103A,B01,083779,Greenfeld; Be'Eri,7,0,36,29
1657493079981,MATH 103A,B02,083780,Greenfeld; Be'Eri,4,0,36,32
1657493079981,MATH 103A,B03,093562,Greenfeld; Be'Eri,3,0,36,33
1657493086004,MATH 105,A01,085443,Carter; Anne Toulson,15,0,35,20
1657493086004,MATH 105,A02,093477,Carter; Anne Toulson,20,0,35,15
1657493092029,MATH 109,A01,083213,Ganzberger; Geoffrey Michael,2,0,34,32
1657493092029,MATH 109,A02,083214,Ganzberger; Geoffrey Michael,4,0,34,30
1657493092029,MATH 109,A03,093478,Ganzberger; Geoffrey Michael,2,0,34,32
1657493092029,MATH 109,B01,083215,Ganzberger; Geoffrey Michael,1,0,32,31
1657493092029,MATH 109,B02,083216,Ganzberger; Geoffrey Michael,2,0,32,30
1657493092029,MATH 109,B03,093479,Ganzberger; Geoffrey Michael,8,0,32,24
1657493098057,MATH 142A,A01,083219,Chow; Bennett,7,0,32,25
1657493098057,MATH 142A,A02,083220,Chow; Bennett,10,0,32,22
1657493098057,MATH 142A,A03,093480,Chow; Bennett,8,0,32,24
1657493098057,MATH 142A,B03,093481,Chow; Bennett,8,0,32,24
1657493098057,MATH 142A,B04,093558,Chow; Bennett,13,0,32,19
1657493098057,MATH 142A,B05,093559,Chow; Bennett,6,0,32,26
1657493104081,MATH 193A,A01,083224,Rotar; Vladimir,8,0,34,26
1657493104081,MATH 193A,A02,083225,Rotar; Vladimir,9,0,34,25
1657493104081,MATH 193A,A03,083781,Rotar; Vladimir,5,0,34,29
1657493104081,MATH 193A,A04,083782,Rotar; Vladimir,10,0,34,24
1657493104081,MATH 193A,A05,093482,Rotar; Vladimir,10,0,34,24
1657493110111,MATH 197,001,091859,McAuley; Julian John,9999,0,9999,0
1657493110111,MATH 197,002,095566,Kedlaya; Kiran S.,9997,0,9999,2
1657493110111,MATH 197,003,095567,Xiao; Ming,9999,0,9999,0
1657493110111,MATH 197,004,095571,Perols; Johan Lars,9998,0,9999,1
1657493117171,COGS 9,A01,083615,Shannon; Kyle Michael,9,0,75,66
1657493123198,COGS 11,A01,083617,Boyle; Mary E. T.,22,0,48,26
1657493129226,COGS 13,A01,083071,Bastos; Amalia Pinkusfeld,11,0,71,60
1657493135247,COGS 14A,A01,092681,Semenuks; Arturs,5,1,100,95
1657493141271,COGS 14B,A01,083073,Cheng; Tzu-Han,6,0,63,57
1657493147294,COGS 17,A01,092677,Semenuks; Arturs,6,0,81,75
1657493153316,COGS 100,A01,083619,Allen; Michael Gordon,17,0,70,53
1657493159341,COGS 101A,A01,083621,Davis; Joshua Daniel,9,0,68,59
1657493165368,COGS 101B,A01,091572,Allen; Michael Gordon,12,0,65,53
1657493171391,COGS 101C,A01,083625,Delgado; Tania,17,0,35,18
1657493177414,COGS 107A,A01,083627,Boyle; Mary E. T.,13,0,60,47
1657493183437,COGS 118A,A01,083075,Gupta; Anjum,21,0,76,55
1657493189461,CSE 3,A50,083646,Miranda; Gregory Joseph,24,0,50,26
1657493195485,CSE 8A,A50,083650,Miranda; Gregory Joseph,17,1,56,39
1657493201521,CSE 11,A01,083080,Cao; Yingjun,6,15,40,34
1657493207543,CSE 12,A01,083652,Krause-Levy; Sophia Louisa,28,1,120,92
1657493213566,CSE 15L,A01,083654,Morris; Justin Loren,9,0,50,41
1657493213566,CSE 15L,A02,083655,Morris; Justin Loren,9,0,50,41
1657493219591,CSE 20,A01,083657,Tran; Khoa Dang,39,0,80,41
1657493225614,CSE 21,A01,095574,Bach; Quang Tran,22,0,48,26
1657493231638,CSE 30,A01,083084,Eldon; John,5,0,80,75
1657493231638,CSE 30,B01,095061,Bhaskar; Nishant,9,0,50,41
1657493237660,CSE 100,A01,083659,Cao; Yingjun,5,4,70,65
1657493243687,CSE 134B,A01,083661,Powell; Thomas Allan,22,0,100,78
1657493249718,CSE 140,A01,083663,Gungor; Onat,15,0,85,70
1657493255746,CSE 140L,A01,083088,Eldon; John,21,0,100,79
1657493261767,CSE 175,A01,083665,Kumar; Rakesh,3,0,25,22
1657493267790,CSE 190,A00,092507,Dubnov; Shlomo,8,0,20,12
1657493273813,ECE 45,A01,083139,Congero; Spencer William,6,0,75,69
1657493279840,ECE 65,A50,083695,Saad; Andrew S,12,0,30,18
1657493279840,ECE 65,A51,095125,Saad; Andrew S,24,0,26,2
1657493285862,ECE 109,A01,091882,Touri; Behrouz,19,0,70,51
1657493291890,ECE 180,A00,083140,Abi Samra; Nicholas Camill,1,0,30,29
1657493291890,ECE 180,B00,083141,Abi Samra; Nicholas Camill,0,0,30,30
1657493297917,MATH 10A,A01,083735,Patchell; Gregory David,2,0,30,28
1657493297917,MATH 10A,A02,083736,Patchell; Gregory David,20,0,30,10
1657493297917,MATH 10A,A03,083737,Patchell; Gregory David,16,0,30,14
1657493303944,MATH 10B,A01,083207,Lim; Seonhee,8,0,34,26
1657493303944,MATH 10B,A02,083208,Lim; Seonhee,9,0,35,26
1657493303944,MATH 10B,A03,093472,Lim; Seonhee,7,0,34,27
1657493303944,MATH 10B,B01,083739,Sinha; Shubham,12,0,30,18
1657493309966,MATH 18,A01,083743,Cinel; Cameron Alexander,7,0,30,23
1657493309966,MATH 18,A02,083744,Cinel; Cameron Alexander,17,0,30,13
1657493309966,MATH 18,A03,083745,Cinel; Cameron Alexander,9,0,30,21
1657493309966,MATH 18,B01,083748,Rideout; David Porter,5,0,37,32
1657493309966,MATH 18,B02,083749,Rideout; David Porter,5,0,36,31
1657493309966,MATH 18,B03,083750,Rideout; David Porter,3,0,37,34
1657493309966,MATH 18,B04,083751,Rideout; David Porter,6,0,36,30
1657493309966,MATH 18,B05,093473,Rideout; David Porter,6,0,36,30
1657493309966,MATH 18,B06,093474,Rideout; David Porter,6,0,36,30
1657493316004,MATH 20A,A01,083754,Zheng; Zequn,14,0,40,26
1657493322028,MATH 20B,A01,083756,Briones; Jor-el Thomas Caparas,4,0,36,32
1657493322028,MATH 20B,A02,083757,Briones; Jor-el Thomas Caparas,1,0,36,35
1657493322028,MATH 20B,A03,093475,Briones; Jor-el Thomas Caparas,2,0,36,34
1657493328052,MATH 20C,A01,083760,Briones; Jor-el Thomas Caparas,1,0,35,34
1657493328052,MATH 20C,A02,083761,Briones; Jor-el Thomas Caparas,8,0,35,27
1657493328052,MATH 20C,A03,093476,Briones; Jor-el Thomas Caparas,0,1,36,36
1657493328052,MATH 20C,B01,083762,Bach; Quang Tran,1,0,30,29
1657493334079,MATH 20D,A01,083765,Tran; Brian Kha,5,0,30,25
1657493334079,MATH 20D,A02,083766,Tran; Brian Kha,5,0,30,25
1657493334079,MATH 20D,A03,083767,Tran; Brian Kha,5,0,30,25
1657493340102,MATH 20E,A01,083771,Ganguly; Soumya,9,0,32,23
1657493340102,MATH 20E,A02,083772,Ganguly; Soumya,6,0,32,26
1657493340102,MATH 20E,B01,083773,Ciotti; Benjamin,20,0,35,15
1657493340102,MATH 20E,B02,083774,Ciotti; Benjamin,17,0,35,18
1657493346131,MATH 103A,A01,083777,Greenfeld; Be'Eri,3,0,36,33
1657493346131,MATH 103A,A02,083778,Greenfeld; Be'Eri,5,0,36,31
1657493346131,MATH 103A,A03,093561,Greenfeld; Be'Eri,5,0,36,31
1657493346131,MATH 103A,B01,083779,Greenfeld; Be'Eri,7,0,36,29
1657493346131,MATH 103A,B02,083780,Greenfeld; Be'Eri,4,0,36,32
1657493346131,MATH 103A,B03,093562,Greenfeld; Be'Eri,3,0,36,33
1657493352161,MATH 105,A01,085443,Carter; Anne Toulson,15,0,35,20
1657493352161,MATH 105,A02,093477,Carter; Anne Toulson,20,0,35,15
1657493358187,MATH 109,A01,083213,Ganzberger; Geoffrey Michael,2,0,34,32
1657493358187,MATH 109,A02,083214,Ganzberger; Geoffrey Michael,4,0,34,30
1657493358187,MATH 109,A03,093478,Ganzberger; Geoffrey Michael,2,0,34,32
1657493358187,MATH 109,B01,083215,Ganzberger; Geoffrey Michael,1,0,32,31
1657493358187,MATH 109,B02,083216,Ganzberger; Geoffrey Michael,2,0,32,30
1657493358187,MATH 109,B03,093479,Ganzberger; Geoffrey Michael,8,0,32,24
1657493364216,MATH 142A,A01,083219,Chow; Bennett,7,0,32,25
1657493364216,MATH 142A,A02,083220,Chow; Bennett,10,0,32,22
1657493364216,MATH 142A,A03,093480,Chow; Bennett,8,0,32,24
1657493364216,MATH 142A,B03,093481,Chow; Bennett,8,0,32,24
1657493364216,MATH 142A,B04,093558,Chow; Bennett,13,0,32,19
1657493364216,MATH 142A,B05,093559,Chow; Bennett,6,0,32,26
1657493370240,MATH 193A,A01,083224,Rotar; Vladimir,8,0,34,26
1657493370240,MATH 193A,A02,083225,Rotar; Vladimir,9,0,34,25
1657493370240,MATH 193A,A03,083781,Rotar; Vladimir,5,0,34,29
1657493370240,MATH 193A,A04,083782,Rotar; Vladimir,10,0,34,24
1657493370240,MATH 193A,A05,093482,Rotar; Vladimir,10,0,34,24
1657493376265,MATH 197,001,091859,McAuley; Julian John,9999,0,9999,0
1657493376265,MATH 197,002,095566,Kedlaya; Kiran S.,9997,0,9999,2
1657493376265,MATH 197,003,095567,Xiao; Ming,9999,0,9999,0
1657493376265,MATH 197,004,095571,Perols; Johan Lars,9998,0,9999,1
1657493383320,COGS 9,A01,083615,Shannon; Kyle Michael,9,0,75,66
1657493389343,COGS 11,A01,083617,Boyle; Mary E. T.,22,0,48,26
1657493395370,COGS 13,A01,083071,Bastos; Amalia Pinkusfeld,11,0,71,60
1657493401395,COGS 14A,A01,092681,Semenuks; Arturs,5,1,100,95
1657493407418,COGS 14B,A01,083073,Cheng; Tzu-Han,6,0,63,57
1657493413440,COGS 17,A01,092677,Semenuks; Arturs,6,0,81,75
1657493419465,COGS 100,A01,083619,Allen; Michael Gordon,17,0,70,53
1657493425492,COGS 101A,A01,083621,Davis; Joshua Daniel,9,0,68,59
1657493431522,COGS 101B,A01,091572,Allen; Michael Gordon,12,0,65,53
1657493437552,COGS 101C,A01,083625,Delgado; Tania,17,0,35,18
1657493443583,COGS 107A,A01,083627,Boyle; Mary E. T.,13,0,60,47
1657493449610,COGS 118A,A01,083075,Gupta; Anjum,21,0,76,55
1657493455637,CSE 3,A50,083646,Miranda; Gregory Joseph,24,0,50,26
1657493461663,CSE 8A,A50,083650,Miranda; Gregory Joseph,17,1,56,39
1657493467685,CSE 11,A01,083080,Cao; Yingjun,6,15,40,34
1657493473708,CSE 12,A01,083652,Krause-Levy; Sophia Louisa,28,1,120,92
1657493479729,CSE 15L,A01,083654,Morris; Justin Loren,9,0,50,41
1657493479729,CSE 15L,A02,083655,Morris; Justin Loren,9,0,50,41
1657493485751,CSE 20,A01,083657,Tran; Khoa Dang,39,0,80,41
1657493491777,CSE 21,A01,095574,Bach; Quang Tran,22,0,48,26
1657493497799,CSE 30,A01,083084,Eldon; John,5,0,80,75
1657493497799,CSE 30,B01,095061,Bhaskar; Nishant,9,0,50,41
1657493503823,CSE 100,A01,083659,Cao; Yingjun,5,4,70,65
1657493509849,CSE 134B,A01,083661,Powell; Thomas Allan,22,0,100,78
1657493515875,CSE 140,A01,083663,Gungor; Onat,15,0,85,70
1657493521898,CSE 140L,A01,083088,Eldon; John,21,0,100,79
1657493527920,CSE 175,A01,083665,Kumar; Rakesh,3,0,25,22
1657493533942,CSE 190,A00,092507,Dubnov; Shlomo,8,0,20,12
1657493539965,ECE 45,A01,083139,Congero; Spencer William,6,0,75,69
1657493545993,ECE 65,A50,083695,Saad; Andrew S,12,0,30,18
1657493545993,ECE 65,A51,095125,Saad; Andrew S,24,0,26,2
1657493552016,ECE 109,A01,091882,Touri; Behrouz,19,0,70,51
1657493558039,ECE 180,A00,083140,Abi Samra; Nicholas Camill,1,0,30,29
1657493558039,ECE 180,B00,083141,Abi Samra; Nicholas Camill,0,0,30,30
1657493564062,MATH 10A,A01,083735,Patchell; Gregory David,2,0,30,28
1657493564062,MATH 10A,A02,083736,Patchell; Gregory David,20,0,30,10
1657493564062,MATH 10A,A03,083737,Patchell; Gregory David,16,0,30,14
1657493570084,MATH 10B,A01,083207,Lim; Seonhee,8,0,34,26
1657493570084,MATH 10B,A02,083208,Lim; Seonhee,9,0,35,26
1657493570084,MATH 10B,A03,093472,Lim; Seonhee,7,0,34,27
1657493570084,MATH 10B,B01,083739,Sinha; Shubham,12,0,30,18
1657493576109,MATH 18,A01,083743,Cinel; Cameron Alexander,7,0,30,23
1657493576109,MATH 18,A02,083744,Cinel; Cameron Alexander,17,0,30,13
1657493576109,MATH 18,A03,083745,Cinel; Cameron Alexander,9,0,30,21
1657493576109,MATH 18,B01,083748,Rideout; David Porter,5,0,37,32
1657493576109,MATH 18,B02,083749,Rideout; David Porter,5,0,36,31
1657493576109,MATH 18,B03,083750,Rideout; David Porter,3,0,37,34
1657493576109,MATH 18,B04,083751,Rideout; David Porter,6,0,36,30
1657493576109,MATH 18,B05,093473,Rideout; David Porter,6,0,36,30
1657493576109,MATH 18,B06,093474,Rideout; David Porter,6,0,36,30
1657493582139,MATH 20A,A01,083754,Zheng; Zequn,14,0,40,26
1657493588162,MATH 20B,A01,083756,Briones; Jor-el Thomas Caparas,4,0,36,32
1657493588162,MATH 20B,A02,083757,Briones; Jor-el Thomas Caparas,1,0,36,35
1657493588162,MATH 20B,A03,093475,Briones; Jor-el Thomas Caparas,2,0,36,34
1657493594265,MATH 20C,A01,083760,Briones; Jor-el Thomas Caparas,1,0,35,34
1657493594265,MATH 20C,A02,083761,Briones; Jor-el Thomas Caparas,8,0,35,27
1657493594265,MATH 20C,A03,093476,Briones; Jor-el Thomas Caparas,0,1,36,36
1657493594265,MATH 20C,B01,083762,Bach; Quang Tran,1,0,30,29
1657493600292,MATH 20D,A01,083765,Tran; Brian Kha,5,0,30,25
1657493600292,MATH 20D,A02,083766,Tran; Brian Kha,5,0,30,25
1657493600292,MATH 20D,A03,083767,Tran; Brian Kha,5,0,30,25
1657493606322,MATH 20E,A01,083771,Ganguly; Soumya,9,0,32,23
1657493606322,MATH 20E,A02,083772,Ganguly; Soumya,6,0,32,26
1657493606322,MATH 20E,B01,083773,Ciotti; Benjamin,20,0,35,15
1657493606322,MATH 20E,B02,083774,Ciotti; Benjamin,17,0,35,18
1657493612346,MATH 103A,A01,083777,Greenfeld; Be'Eri,3,0,36,33
1657493612346,MATH 103A,A02,083778,Greenfeld; Be'Eri,5,0,36,31
1657493612346,MATH 103A,A03,093561,Greenfeld; Be'Eri,5,0,36,31
1657493612346,MATH 103A,B01,083779,Greenfeld; Be'Eri,7,0,36,29
1657493612346,MATH 103A,B02,083780,Greenfeld; Be'Eri,4,0,36,32
1657493612346,MATH 103A,B03,093562,Greenfeld; Be'Eri,3,0,36,33
1657493618369,MATH 105,A01,085443,Carter; Anne Toulson,15,0,35,20
1657493618369,MATH 105,A02,093477,Carter; Anne Toulson,20,0,35,15
1657493624397,MATH 109,A01,083213,Ganzberger; Geoffrey Michael,2,0,34,32
1657493624397,MATH 109,A02,083214,Ganzberger; Geoffrey Michael,4,0,34,30
1657493624397,MATH 109,A03,093478,Ganzberger; Geoffrey Michael,2,0,34,32
1657493624397,MATH 109,B01,083215,Ganzberger; Geoffrey Michael,1,0,32,31
1657493624397,MATH 109,B02,083216,Ganzberger; Geoffrey Michael,2,0,32,30
1657493624397,MATH 109,B03,093479,Ganzberger; Geoffrey Michael,8,0,32,24
1657493630446,MATH 142A,A01,083219,Chow; Bennett,7,0,32,25
1657493630446,MATH 142A,A02,083220,Chow; Bennett,10,0,32,22
1657493630446,MATH 142A,A03,093480,Chow; Bennett,8,0,32,24
1657493630446,MATH 142A,B03,093481,Chow; Bennett,8,0,32,24
1657493630446,MATH 142A,B04,093558,Chow; Bennett,13,0,32,19
1657493630446,MATH 142A,B05,093559,Chow; Bennett,6,0,32,26
1657493636470,MATH 193A,A01,083224,Rotar; Vladimir,8,0,34,26
1657493636470,MATH 193A,A02,083225,Rotar; Vladimir,9,0,34,25
1657493636470,MATH 193A,A03,083781,Rotar; Vladimir,5,0,34,29
1657493636470,MATH 193A,A04,083782,Rotar; Vladimir,10,0,34,24
1657493636470,MATH 193A,A05,093482,Rotar; Vladimir,10,0,34,24
1657493642495,MATH 197,001,091859,McAuley; Julian John,9999,0,9999,0
1657493642495,MATH 197,002,095566,Kedlaya; Kiran S.,9997,0,9999,2
1657493642495,MATH 197,003,095567,Xiao; Ming,9999,0,9999,0
1657493642495,MATH 197,004,095571,Perols; Johan Lars,9998,0,9999,1
1657493649560,COGS 9,A01,083615,Shannon; Kyle Michael,9,0,75,66
1657493655584,COGS 11,A01,083617,Boyle; Mary E. T.,22,0,48,26
1657493661611,COGS 13,A01,083071,Bastos; Amalia Pinkusfeld,11,0,71,60
1657493667641,COGS 14A,A01,092681,Semenuks; Arturs,5,1,100,95
1657493673663,COGS 14B,A01,083073,Cheng; Tzu-Han,6,0,63,57
1657493679688,COGS 17,A01,092677,Semenuks; Arturs,6,0,81,75
1657493685713,COGS 100,A01,083619,Allen; Michael Gordon,17,0,70,53
1657493691737,COGS 101A,A01,083621,Davis; Joshua Daniel,9,0,68,59
1657493697760,COGS 101B,A01,091572,Allen; Michael Gordon,12,0,65,53
1657493703788,COGS 101C,A01,083625,Delgado; Tania,17,0,35,18
1657493709819,COGS 107A,A01,083627,Boyle; Mary E. T.,13,0,60,47
1657493715842,COGS 118A,A01,083075,Gupta; Anjum,21,0,76,55
1657493721866,CSE 3,A50,083646,Miranda; Gregory Joseph,24,0,50,26
1657493727889,CSE 8A,A50,083650,Miranda; Gregory Joseph,17,1,56,39
1657493733910,CSE 11,A01,083080,Cao; Yingjun,6,15,40,34
1657493739934,CSE 12,A01,083652,Krause-Levy; Sophia Louisa,28,1,120,92
1657493745962,CSE 15L,A01,083654,Morris; Justin Loren,9,0,50,41
1657493745962,CSE 15L,A02,083655,Morris; Justin Loren,9,0,50,41
1657493751986,CSE 20,A01,083657,Tran; Khoa Dang,39,0,80,41
1657493758008,CSE 21,A01,095574,Bach; Quang Tran,22,0,48,26
1657493764031,CSE 30,A01,083084,Eldon; John,5,0,80,75
1657493764031,CSE 30,B01,095061,Bhaskar; Nishant,9,0,50,41
1657493770058,CSE 100,A01,083659,Cao; Yingjun,5,4,70,65
1657493776082,CSE 134B,A01,083661,Powell; Thomas Allan,22,0,100,78
1657493782104,CSE 140,A01,083663,Gungor; Onat,15,0,85,70
1657493788125,CSE 140L,A01,083088,Eldon; John,21,0,100,79
1657493794149,CSE 175,A01,083665,Kumar; Rakesh,3,0,25,22
1657493800172,CSE 190,A00,092507,Dubnov; Shlomo,8,0,20,12
1657493806195,ECE 45,A01,083139,Congero; Spencer William,6,0,75,69
1657493812222,ECE 65,A50,083695,Saad; Andrew S,12,0,30,18
1657493812222,ECE 65,A51,095125,Saad; Andrew S,24,0,26,2
1657493818245,ECE 109,A01,091882,Touri; Behrouz,19,0,70,51
1657493824273,ECE 180,A00,083140,Abi Samra; Nicholas Camill,1,0,30,29
1657493824273,ECE 180,B00,083141,Abi Samra; Nicholas Camill,0,0,30,30
1657493830296,MATH 10A,A01,083735,Patchell; Gregory David,2,0,30,28
1657493830296,MATH 10A,A02,083736,Patchell; Gregory David,20,0,30,10
1657493830296,MATH 10A,A03,083737,Patchell; Gregory David,16,0,30,14
1657493836322,MATH 10B,A01,083207,Lim; Seonhee,8,0,34,26
1657493836322,MATH 10B,A02,083208,Lim; Seonhee,9,0,35,26
1657493836322,MATH 10B,A03,093472,Lim; Seonhee,7,0,34,27
1657493836322,MATH 10B,B01,083739,Sinha; Shubham,12,0,30,18
1657493842345,MATH 18,A01,083743,Cinel; Cameron Alexander,7,0,30,23
1657493842345,MATH 18,A02,083744,Cinel; Cameron Alexander,17,0,30,13
1657493842345,MATH 18,A03,083745,Cinel; Cameron Alexander,9,0,30,21
1657493842345,MATH 18,B01,083748,Rideout; David Porter,5,0,37,32
1657493842345,MATH 18,B02,083749,Rideout; David Porter,5,0,36,31
1657493842345,MATH 18,B03,083750,Rideout; David Porter,3,0,37,34
1657493842345,MATH 18,B04,083751,Rideout; David Porter,6,0,36,30
1657493842345,MATH 18,B05,093473,Rideout; David Porter,6,0,36,30
1657493842345,MATH 18,B06,093474,Rideout; David Porter,6,0,36,30
1657493848368,MATH 20A,A01,083754,Zheng; Zequn,14,0,40,26
1657493854392,MATH 20B,A01,083756,Briones; Jor-el Thomas Caparas,4,0,36,32
1657493854392,MATH 20B,A02,083757,Briones; Jor-el Thomas Caparas,1,0,36,35
1657493854392,MATH 20B,A03,093475,Briones; Jor-el Thomas Caparas,2,0,36,34
1657493860427,MATH 20C,A01,083760,Briones; Jor-el Thomas Caparas,1,0,35,34
1657493860427,MATH 20C,A02,083761,Briones; Jor-el Thomas Caparas,8,0,35,27
1657493860427,MATH 20C,A03,093476,Briones; Jor-el Thomas Caparas,0,1,36,36
1657493860427,MATH 20C,B01,083762,Bach; Quang Tran,1,0,30,29
1657493866451,MATH 20D,A01,083765,Tran; Brian Kha,5,0,30,25
1657493866451,MATH 20D,A02,083766,Tran; Brian Kha,5,0,30,25
1657493866451,MATH 20D,A03,083767,Tran; Brian Kha,5,0,30,25
1657493872486,MATH 20E,A01,083771,Ganguly; Soumya,9,0,32,23
1657493872486,MATH 20E,A02,083772,Ganguly; Soumya,6,0,32,26
1657493872486,MATH 20E,B01,083773,Ciotti; Benjamin,20,0,35,15
1657493872486,MATH 20E,B02,083774,Ciotti; Benjamin,17,0,35,18
1657493878519,MATH 103A,A01,083777,Greenfeld; Be'Eri,3,0,36,33
1657493878519,MATH 103A,A02,083778,Greenfeld; Be'Eri,5,0,36,31
1657493878519,MATH 103A,A03,093561,Greenfeld; Be'Eri,5,0,36,31
1657493878519,MATH 103A,B01,083779,Greenfeld; Be'Eri,7,0,36,29
1657493878519,MATH 103A,B02,083780,Greenfeld; Be'Eri,4,0,36,32
1657493878519,MATH 103A,B03,093562,Greenfeld; Be'Eri,3,0,36,33
1657493884546,MATH 105,A01,085443,Carter; Anne Toulson,15,0,35,20
1657493884546,MATH 105,A02,093477,Carter; Anne Toulson,20,0,35,15
1657493890574,MATH 109,A01,083213,Ganzberger; Geoffrey Michael,2,0,34,32
1657493890574,MATH 109,A02,083214,Ganzberger; Geoffrey Michael,4,0,34,30
1657493890574,MATH 109,A03,093478,Ganzberger; Geoffrey Michael,2,0,34,32
1657493890574,MATH 109,B01,083215,Ganzberger; Geoffrey Michael,1,0,32,31
1657493890574,MATH 109,B02,083216,Ganzberger; Geoffrey Michael,2,0,32,30
1657493890574,MATH 109,B03,093479,Ganzberger; Geoffrey Michael,8,0,32,24
1657493896599,MATH 142A,A01,083219,Chow; Bennett,7,0,32,25
1657493896599,MATH 142A,A02,083220,Chow; Bennett,10,0,32,22
1657493896599,MATH 142A,A03,093480,Chow; Bennett,8,0,32,24
1657493896599,MATH 142A,B03,093481,Chow; Bennett,8,0,32,24
1657493896599,MATH 142A,B04,093558,Chow; Bennett,13,0,32,19
1657493896599,MATH 142A,B05,093559,Chow; Bennett,6,0,32,26
1657493902620,MATH 193A,A01,083224,Rotar; Vladimir,8,0,34,26
1657493902620,MATH 193A,A02,083225,Rotar; Vladimir,9,0,34,25
1657493902620,MATH 193A,A03,083781,Rotar; Vladimir,5,0,34,29
1657493902620,MATH 193A,A04,083782,Rotar; Vladimir,10,0,34,24
1657493902620,MATH 193A,A05,093482,Rotar; Vladimir,10,0,34,24
1657493908646,MATH 197,001,091859,McAuley; Julian John,9999,0,9999,0
1657493908646,MATH 197,002,095566,Kedlaya; Kiran S.,9997,0,9999,2
1657493908646,MATH 197,003,095567,Xiao; Ming,9999,0,9999,0
1657493908646,MATH 197,004,095571,Perols; Johan Lars,9998,0,9999,1
1657493915695,COGS 9,A01,083615,Shannon; Kyle Michael,9,0,75,66
1657493921716,COGS 11,A01,083617,Boyle; Mary E. T.,22,0,48,26
1657493927739,COGS 13,A01,083071,Bastos; Amalia Pinkusfeld,11,0,71,60
1657493933785,COGS 14A,A01,092681,Semenuks; Arturs,5,1,100,95
1657493939807,COGS 14B,A01,083073,Cheng; Tzu-Han,6,0,63,57
1657493945840,COGS 17,A01,092677,Semenuks; Arturs,6,0,81,75
1657493951863,COGS 100,A01,083619,Allen; Michael Gordon,17,0,70,53
1657493957887,COGS 101A,A01,083621,Davis; Joshua Daniel,9,0,68,59
1657493963910,COGS 101B,A01,091572,Allen; Michael Gordon,12,0,65,53
1657493969937,COGS 101C,A01,083625,Delgado; Tania,17,0,35,18
1657493975960,COGS 107A,A01,083627,Boyle; Mary E. T.,13,0,60,47
1657493981987,COGS 118A,A01,083075,Gupta; Anjum,21,0,76,55
1657493988014,CSE 3,A50,083646,Miranda; Gregory Joseph,24,0,50,26
1657493994038,CSE 8A,A50,083650,Miranda; Gregory Joseph,17,1,56,39
1657494000064,CSE 11,A01,083080,Cao; Yingjun,6,15,40,34
1657494006087,CSE 12,A01,083652,Krause-Levy; Sophia Louisa,28,1,120,92
1657494012111,CSE 15L,A01,083654,Morris; Justin Loren,9,0,50,41
1657494012111,CSE 15L,A02,083655,Morris; Justin Loren,9,0,50,41
1657494018135,CSE 20,A01,083657,Tran; Khoa Dang,39,0,80,41
1657494024161,CSE 21,A01,095574,Bach; Quang Tran,22,0,48,26
1657494030182,CSE 30,A01,083084,Eldon; John,5,0,80,75
1657494030182,CSE 30,B01,095061,Bhaskar; Nishant,9,0,50,41
1657494036207,CSE 100,A01,083659,Cao; Yingjun,5,4,70,65
1657494042230,CSE 134B,A01,083661,Powell; Thomas Allan,22,0,100,78
1657494048260,CSE 140,A01,083663,Gungor; Onat,15,0,85,70
1657494054287,CSE 140L,A01,083088,Eldon; John,21,0,100,79
1657494060311,CSE 175,A01,083665,Kumar; Rakesh,3,0,25,22
1657494066339,CSE 190,A00,092507,Dubnov; Shlomo,8,0,20,12
1657494072361,ECE 45,A01,083139,Congero; Spencer William,6,0,75,69
1657494078384,ECE 65,A50,083695,Saad; Andrew S,12,0,30,18
1657494078384,ECE 65,A51,095125,Saad; Andrew S,24,0,26,2
1657494084411,ECE 109,A01,091882,Touri; Behrouz,19,0,70,51
1657494090434,ECE 180,A00,083140,Abi Samra; Nicholas Camill,1,0,30,29
1657494090434,ECE 180,B00,083141,Abi Samra; Nicholas Camill,0,0,30,30
1657494096455,MATH 10A,A01,083735,Patchell; Gregory David,2,0,30,28
1657494096455,MATH 10A,A02,083736,Patchell; Gregory David,20,0,30,10
1657494096455,MATH 10A,A03,083737,Patchell; Gregory David,16,0,30,14
1657494102485,MATH 10B,A01,083207,Lim; Seonhee,8,0,34,26
1657494102485,MATH 10B,A02,083208,Lim; Seonhee,9,0,35,26
1657494102485,MATH 10B,A03,093472,Lim; Seonhee,7,0,34,27
1657494102485,MATH 10B,B01,083739,Sinha; Shubham,12,0,30,18
1657494108515,MATH 18,A01,083743,Cinel; Cameron Alexander,7,0,30,23
1657494108515,MATH 18,A02,083744,Cinel; Cameron Alexander,17,0,30,13
1657494108515,MATH 18,A03,083745,Cinel; Cameron Alexander,9,0,30,21
1657494108515,MATH 18,B01,083748,Rideout; David Porter,5,0,37,32
1657494108515,MATH 18,B02,083749,Rideout; David Porter,5,0,36,31
1657494108515,MATH 18,B03,083750,Rideout; David Porter,3,0,37,34
1657494108515,MATH 18,B04,083751,Rideout; David Porter,6,0,36,30
1657494108515,MATH 18,B05,093473,Rideout; David Porter,6,0,36,30
1657494108515,MATH 18,B06,093474,Rideout; David Porter,6,0,36,30
1657494114538,MATH 20A,A01,083754,Zheng; Zequn,14,0,40,26
1657494120574,MATH 20B,A01,083756,Briones; Jor-el Thomas Caparas,4,0,36,32
1657494120574,MATH 20B,A02,083757,Briones; Jor-el Thomas Caparas,1,0,36,35
1657494120574,MATH 20B,A03,093475,Briones; Jor-el Thomas Caparas,2,0,36,34
1657494126602,MATH 20C,A01,083760,Briones; Jor-el Thomas Caparas,1,0,35,34
1657494126602,MATH 20C,A02,083761,Briones; Jor-el Thomas Caparas,8,0,35,27
1657494126602,MATH 20C,A03,093476,Briones; Jor-el Thomas Caparas,0,1,36,36
1657494126602,MATH 20C,B01,083762,Bach; Quang Tran,1,0,30,29
1657494132630,MATH 20D,A01,083765,Tran; Brian Kha,5,0,30,25
1657494132630,MATH 20D,A02,083766,Tran; Brian Kha,5,0,30,25
1657494132630,MATH 20D,A03,083767,Tran; Brian Kha,5,0,30,25
1657494138665,MATH 20E,A01,083771,Ganguly; Soumya,9,0,32,23
1657494138665,MATH 20E,A02,083772,Ganguly; Soumya,6,0,32,26
1657494138665,MATH 20E,B01,083773,Ciotti; Benjamin,20,0,35,15
1657494138665,MATH 20E,B02,083774,Ciotti; Benjamin,17,0,35,18
1657494144689,MATH 103A,A01,083777,Greenfeld; Be'Eri,3,0,36,33
1657494144689,MATH 103A,A02,083778,Greenfeld; Be'Eri,5,0,36,31
1657494144689,MATH 103A,A03,093561,Greenfeld; Be'Eri,5,0,36,31
1657494144689,MATH 103A,B01,083779,Greenfeld; Be'Eri,7,0,36,29
1657494144689,MATH 103A,B02,083780,Greenfeld; Be'Eri,4,0,36,32
1657494144689,MATH 103A,B03,093562,Greenfeld; Be'Eri,3,0,36,33
1657494150716,MATH 105,A01,085443,Carter; Anne Toulson,15,0,35,20
1657494150716,MATH 105,A02,093477,Carter; Anne Toulson,20,0,35,15
1657494156745,MATH 109,A01,083213,Ganzberger; Geoffrey Michael,2,0,34,32
1657494156745,MATH 109,A02,083214,Ganzberger; Geoffrey Michael,4,0,34,30
1657494156745,MATH 109,A03,093478,Ganzberger; Geoffrey Michael,2,0,34,32
1657494156745,MATH 109,B01,083215,Ganzberger; Geoffrey Michael,1,0,32,31
1657494156745,MATH 109,B02,083216,Ganzberger; Geoffrey Michael,2,0,32,30
1657494156745,MATH 109,B03,093479,Ganzberger; Geoffrey Michael,8,0,32,24
1657494162770,MATH 142A,A01,083219,Chow; Bennett,7,0,32,25
1657494162770,MATH 142A,A02,083220,Chow; Bennett,10,0,32,22
1657494162770,MATH 142A,A03,093480,Chow; Bennett,8,0,32,24
1657494162770,MATH 142A,B03,093481,Chow; Bennett,8,0,32,24
1657494162770,MATH 142A,B04,093558,Chow; Bennett,13,0,32,19
1657494162770,MATH 142A,B05,093559,Chow; Bennett,6,0,32,26
1657494168794,MATH 193A,A01,083224,Rotar; Vladimir,8,0,34,26
1657494168794,MATH 193A,A02,083225,Rotar; Vladimir,9,0,34,25
1657494168794,MATH 193A,A03,083781,Rotar; Vladimir,5,0,34,29
1657494168794,MATH 193A,A04,083782,Rotar; Vladimir,10,0,34,24
1657494168794,MATH 193A,A05,093482,Rotar; Vladimir,10,0,34,24
1657494174816,MATH 197,001,091859,McAuley; Julian John,9999,0,9999,0
1657494174816,MATH 197,002,095566,Kedlaya; Kiran S.,9997,0,9999,2
1657494174816,MATH 197,003,095567,Xiao; Ming,9999,0,9999,0
1657494174816,MATH 197,004,095571,Perols; Johan Lars,9998,0,9999,1
1657494181867,COGS 9,A01,083615,Shannon; Kyle Michael,9,0,75,66
1657494187960,COGS 11,A01,083617,Boyle; Mary E. T.,22,0,48,26
1657494194005,COGS 13,A01,083071,Bastos; Amalia Pinkusfeld,11,0,71,60
1657494200032,COGS 14A,A01,092681,Semenuks; Arturs,5,1,100,95
1657494206057,COGS 14B,A01,083073,Cheng; Tzu-Han,6,0,63,57
1657494212083,COGS 17,A01,092677,Semenuks; Arturs,6,0,81,75
1657494218106,COGS 100,A01,083619,Allen; Michael Gordon,17,0,70,53
1657494224130,COGS 101A,A01,083621,Davis; Joshua Daniel,9,0,68,59
1657494230154,COGS 101B,A01,091572,Allen; Michael Gordon,12,0,65,53
1657494236180,COGS 101C,A01,083625,Delgado; Tania,17,0,35,18
1657494242206,COGS 107A,A01,083627,Boyle; Mary E. T.,13,0,60,47
1657494248228,COGS 118A,A01,083075,Gupta; Anjum,21,0,76,55
1657494254253,CSE 3,A50,083646,Miranda; Gregory Joseph,24,0,50,26
1657494260281,CSE 8A,A50,083650,Miranda; Gregory Joseph,17,1,56,39
1657494266304,CSE 11,A01,083080,Cao; Yingjun,6,15,40,34
1657494272326,CSE 12,A01,083652,Krause-Levy; Sophia Louisa,28,1,120,92
1657494278351,CSE 15L,A01,083654,Morris; Justin Loren,9,0,50,41
1657494278351,CSE 15L,A02,083655,Morris; Justin Loren,9,0,50,41
1657494284378,CSE 20,A01,083657,Tran; Khoa Dang,39,0,80,41
1657494290411,CSE 21,A01,095574,Bach; Quang Tran,22,0,48,26
1657494296435,CSE 30,A01,083084,Eldon; John,5,0,80,75
1657494296435,CSE 30,B01,095061,Bhaskar; Nishant,9,0,50,41
1657494302463,CSE 100,A01,083659,Cao; Yingjun,5,4,70,65
1657494308485,CSE 134B,A01,083661,Powell; Thomas Allan,22,0,100,78
1657494314512,CSE 140,A01,083663,Gungor; Onat,15,0,85,70
1657494320538,CSE 140L,A01,083088,Eldon; John,21,0,100,79
1657494326560,CSE 175,A01,083665,Kumar; Rakesh,3,0,25,22
1657494332582,CSE 190,A00,092507,Dubnov; Shlomo,8,0,20,12
1657494338616,ECE 45,A01,083139,Congero; Spencer William,6,0,75,69
1657494344645,ECE 65,A50,083695,Saad; Andrew S,12,0,30,18
1657494344645,ECE 65,A51,095125,Saad; Andrew S,24,0,26,2
1657494350669,ECE 109,A01,091882,Touri; Behrouz,19,0,70,51
1657494356694,ECE 180,A00,083140,Abi Samra; Nicholas Camill,1,0,30,29
1657494356694,ECE 180,B00,083141,Abi Samra; Nicholas Camill,0,0,30,30
1657494362716,MATH 10A,A01,083735,Patchell; Gregory David,2,0,30,28
1657494362716,MATH 10A,A02,083736,Patchell; Gregory David,20,0,30,10
1657494362716,MATH 10A,A03,083737,Patchell; Gregory David,16,0,30,14
1657494368740,MATH 10B,A01,083207,Lim; Seonhee,8,0,34,26
1657494368740,MATH 10B,A02,083208,Lim; Seonhee,9,0,35,26
1657494368740,MATH 10B,A03,093472,Lim; Seonhee,7,0,34,27
1657494368740,MATH 10B,B01,083739,Sinha; Shubham,12,0,30,18
1657494374771,MATH 18,A01,083743,Cinel; Cameron Alexander,7,0,30,23
1657494374771,MATH 18,A02,083744,Cinel; Cameron Alexander,17,0,30,13
1657494374771,MATH 18,A03,083745,Cinel; Cameron Alexander,9,0,30,21
1657494374771,MATH 18,B01,083748,Rideout; David Porter,5,0,37,32
1657494374771,MATH 18,B02,083749,Rideout; David Porter,5,0,36,31
1657494374771,MATH 18,B03,083750,Rideout; David Porter,3,0,37,34
1657494374771,MATH 18,B04,083751,Rideout; David Porter,6,0,36,30
1657494374771,MATH 18,B05,093473,Rideout; David Porter,6,0,36,30
1657494374771,MATH 18,B06,093474,Rideout; David Porter,6,0,36,30
1657494380797,MATH 20A,A01,083754,Zheng; Zequn,14,0,40,26
1657494386823,MATH 20B,A01,083756,Briones; Jor-el Thomas Caparas,4,0,36,32
1657494386823,MATH 20B,A02,083757,Briones; Jor-el Thomas Caparas,1,0,36,35
1657494386823,MATH 20B,A03,093475,Briones; Jor-el Thomas Caparas,2,0,36,34
1657494392853,MATH 20C,A01,083760,Briones; Jor-el Thomas Caparas,1,0,35,34
1657494392853,MATH 20C,A02,083761,Briones; Jor-el Thomas Caparas,8,0,35,27
1657494392853,MATH 20C,A03,093476,Briones; Jor-el Thomas Caparas,0,1,36,36
1657494392853,MATH 20C,B01,083762,Bach; Quang Tran,1,0,30,29
1657494398876,MATH 20D,A01,083765,Tran; Brian Kha,5,0,30,25
1657494398876,MATH 20D,A02,083766,Tran; Brian Kha,5,0,30,25
1657494398876,MATH 20D,A03,083767,Tran; Brian Kha,5,0,30,25
1657494404904,MATH 20E,A01,083771,Ganguly; Soumya,9,0,32,23
1657494404904,MATH 20E,A02,083772,Ganguly; Soumya,6,0,32,26
1657494404904,MATH 20E,B01,083773,Ciotti; Benjamin,20,0,35,15
1657494404904,MATH 20E,B02,083774,Ciotti; Benjamin,17,0,35,18
1657494410933,MATH 103A,A01,083777,Greenfeld; Be'Eri,3,0,36,33
1657494410933,MATH 103A,A02,083778,Greenfeld; Be'Eri,5,0,36,31
1657494410933,MATH 103A,A03,093561,Greenfeld; Be'Eri,5,0,36,31
1657494410933,MATH 103A,B01,083779,Greenfeld; Be'Eri,7,0,36,29
1657494410933,MATH 103A,B02,083780,Greenfeld; Be'Eri,4,0,36,32
1657494410933,MATH 103A,B03,093562,Greenfeld; Be'Eri,3,0,36,33
1657494416961,MATH 105,A01,085443,Carter; Anne Toulson,15,0,35,20
1657494416961,MATH 105,A02,093477,Carter; Anne Toulson,20,0,35,15
1657494422990,MATH 109,A01,083213,Ganzberger; Geoffrey Michael,2,0,34,32
1657494422990,MATH 109,A02,083214,Ganzberger; Geoffrey Michael,4,0,34,30
1657494422990,MATH 109,A03,093478,Ganzberger; Geoffrey Michael,2,0,34,32
1657494422990,MATH 109,B01,083215,Ganzberger; Geoffrey Michael,1,0,32,31
1657494422990,MATH 109,B02,083216,Ganzberger; Geoffrey Michael,2,0,32,30
1657494422990,MATH 109,B03,093479,Ganzberger; Geoffrey Michael,8,0,32,24
1657494429054,MATH 142A,A01,083219,Chow; Bennett,7,0,32,25
1657494429054,MATH 142A,A02,083220,Chow; Bennett,10,0,32,22
1657494429054,MATH 142A,A03,093480,Chow; Bennett,8,0,32,24
1657494429054,MATH 142A,B03,093481,Chow; Bennett,8,0,32,24
1657494429054,MATH 142A,B04,093558,Chow; Bennett,13,0,32,19
1657494429054,MATH 142A,B05,093559,Chow; Bennett,6,0,32,26
1657494435076,MATH 193A,A01,083224,Rotar; Vladimir,8,0,34,26
1657494435076,MATH 193A,A02,083225,Rotar; Vladimir,9,0,34,25
1657494435076,MATH 193A,A03,083781,Rotar; Vladimir,5,0,34,29
1657494435076,MATH 193A,A04,083782,Rotar; Vladimir,10,0,34,24
1657494435076,MATH 193A,A05,093482,Rotar; Vladimir,10,0,34,24
1657494441100,MATH 197,001,091859,McAuley; Julian John,9999,0,9999,0
1657494441100,MATH 197,002,095566,Kedlaya; Kiran S.,9997,0,9999,2
1657494441100,MATH 197,003,095567,Xiao; Ming,9999,0,9999,0
1657494441100,MATH 197,004,095571,Perols; Johan Lars,9998,0,9999,1
1657494448165,COGS 9,A01,083615,Shannon; Kyle Michael,9,0,75,66
1657494454187,COGS 11,A01,083617,Boyle; Mary E. T.,22,0,48,26
1657494460210,COGS 13,A01,083071,Bastos; Amalia Pinkusfeld,11,0,71,60
1657494466233,COGS 14A,A01,092681,Semenuks; Arturs,5,1,100,95
1657494472258,COGS 14B,A01,083073,Cheng; Tzu-Han,6,0,63,57
1657494478286,COGS 17,A01,092677,Semenuks; Arturs,6,0,81,75
1657494484308,COGS 100,A01,083619,Allen; Michael Gordon,17,0,70,53
1657494490333,COGS 101A,A01,083621,Davis; Joshua Daniel,9,0,68,59
1657494496359,COGS 101B,A01,091572,Allen; Michael Gordon,12,0,65,53
1657494502381,COGS 101C,A01,083625,Delgado; Tania,17,0,35,18
1657494508408,COGS 107A,A01,083627,Boyle; Mary E. T.,13,0,60,47
1657494514435,COGS 118A,A01,083075,Gupta; Anjum,21,0,76,55
1657494520462,CSE 3,A50,083646,Miranda; Gregory Joseph,24,0,50,26
1657494526484,CSE 8A,A50,083650,Miranda; Gregory Joseph,17,1,56,39
1657494532507,CSE 11,A01,083080,Cao; Yingjun,6,15,40,34
1657494538531,CSE 12,A01,083652,Krause-Levy; Sophia Louisa,28,1,120,92
1657494544558,CSE 15L,A01,083654,Morris; Justin Loren,9,0,50,41
1657494544558,CSE 15L,A02,083655,Morris; Justin Loren,9,0,50,41
1657494550582,CSE 20,A01,083657,Tran; Khoa Dang,39,0,80,41
1657494556607,CSE 21,A01,095574,Bach; Quang Tran,22,0,48,26
1657494562629,CSE 30,A01,083084,Eldon; John,5,0,80,75
1657494562629,CSE 30,B01,095061,Bhaskar; Nishant,9,0,50,41
1657494568652,CSE 100,A01,083659,Cao; Yingjun,5,4,70,65
1657494574678,CSE 134B,A01,083661,Powell; Thomas Allan,22,0,100,78
1657494580700,CSE 140,A01,083663,Gungor; Onat,15,0,85,70
1657494586723,CSE 140L,A01,083088,Eldon; John,21,0,100,79
1657494592749,CSE 175,A01,083665,Kumar; Rakesh,3,0,25,22
1657494598770,CSE 190,A00,092507,Dubnov; Shlomo,8,0,20,12
1657494604792,ECE 45,A01,083139,Congero; Spencer William,6,0,75,69
1657494610816,ECE 65,A50,083695,Saad; Andrew S,12,0,30,18
1657494610816,ECE 65,A51,095125,Saad; Andrew S,24,0,26,2
1657494616842,ECE 109,A01,091882,Touri; Behrouz,19,0,70,51
1657494622868,ECE 180,A00,083140,Abi Samra; Nicholas Camill,1,0,30,29
1657494622868,ECE 180,B00,083141,Abi Samra; Nicholas Camill,0,0,30,30
1657494628896,MATH 10A,A01,083735,Patchell; Gregory David,2,0,30,28
1657494628896,MATH 10A,A02,083736,Patchell; Gregory David,20,0,30,10
1657494628896,MATH 10A,A03,083737,Patchell; Gregory David,16,0,30,14
1657494634924,MATH 10B,A01,083207,Lim; Seonhee,8,0,34,26
1657494634924,MATH 10B,A02,083208,Lim; Seonhee,9,0,35,26
1657494634924,MATH 10B,A03,093472,Lim; Seonhee,7,0,34,27
1657494634924,MATH 10B,B01,083739,Sinha; Shubham,12,0,30,18
1657494640955,MATH 18,A01,083743,Cinel; Cameron Alexander,7,0,30,23
1657494640955,MATH 18,A02,083744,Cinel; Cameron Alexander,17,0,30,13
1657494640955,MATH 18,A03,083745,Cinel; Cameron Alexander,9,0,30,21
1657494640955,MATH 18,B01,083748,Rideout; David Porter,5,0,37,32
1657494640955,MATH 18,B02,083749,Rideout; David Porter,5,0,36,31
1657494640955,MATH 18,B03,083750,Rideout; David Porter,3,0,37,34
1657494640955,MATH 18,B04,083751,Rideout; David Porter,6,0,36,30
1657494640955,MATH 18,B05,093473,Rideout; David Porter,6,0,36,30
1657494640955,MATH 18,B06,093474,Rideout; David Porter,6,0,36,30
1657494646979,MATH 20A,A01,083754,Zheng; Zequn,14,0,40,26
1657494653005,MATH 20B,A01,083756,Briones; Jor-el Thomas Caparas,4,0,36,32
1657494653005,MATH 20B,A02,083757,Briones; Jor-el Thomas Caparas,1,0,36,35
1657494653005,MATH 20B,A03,093475,Briones; Jor-el Thomas Caparas,2,0,36,34
1657494659029,MATH 20C,A01,083760,Briones; Jor-el Thomas Caparas,1,0,35,34
1657494659029,MATH 20C,A02,083761,Briones; Jor-el Thomas Caparas,8,0,35,27
1657494659029,MATH 20C,A03,093476,Briones; Jor-el Thomas Caparas,0,1,36,36
1657494659029,MATH 20C,B01,083762,Bach; Quang Tran,1,0,30,29
1657494665054,MATH 20D,A01,083765,Tran; Brian Kha,5,0,30,25
1657494665054,MATH 20D,A02,083766,Tran; Brian Kha,5,0,30,25
1657494665054,MATH 20D,A03,083767,Tran; Brian Kha,5,0,30,25
1657494671083,MATH 20E,A01,083771,Ganguly; Soumya,9,0,32,23
1657494671083,MATH 20E,A02,083772,Ganguly; Soumya,6,0,32,26
1657494671083,MATH 20E,B01,083773,Ciotti; Benjamin,20,0,35,15
1657494671083,MATH 20E,B02,083774,Ciotti; Benjamin,17,0,35,18
1657494677107,MATH 103A,A01,083777,Greenfeld; Be'Eri,3,0,36,33
1657494677107,MATH 103A,A02,083778,Greenfeld; Be'Eri,5,0,36,31
1657494677107,MATH 103A,A03,093561,Greenfeld; Be'Eri,5,0,36,31
1657494677107,MATH 103A,B01,083779,Greenfeld; Be'Eri,7,0,36,29
1657494677107,MATH 103A,B02,083780,Greenfeld; Be'Eri,4,0,36,32
1657494677107,MATH 103A,B03,093562,Greenfeld; Be'Eri,3,0,36,33
1657494683131,MATH 105,A01,085443,Carter; Anne Toulson,15,0,35,20
1657494683131,MATH 105,A02,093477,Carter; Anne Toulson,20,0,35,15
1657494689157,MATH 109,A01,083213,Ganzberger; Geoffrey Michael,2,0,34,32
1657494689157,MATH 109,A02,083214,Ganzberger; Geoffrey Michael,4,0,34,30
1657494689157,MATH 109,A03,093478,Ganzberger; Geoffrey Michael,2,0,34,32
1657494689157,MATH 109,B01,083215,Ganzberger; Geoffrey Michael,1,0,32,31
1657494689157,MATH 109,B02,083216,Ganzberger; Geoffrey Michael,2,0,32,30
1657494689157,MATH 109,B03,093479,Ganzberger; Geoffrey Michael,8,0,32,24
1657494695194,MATH 142A,A01,083219,Chow; Bennett,7,0,32,25
1657494695194,MATH 142A,A02,083220,Chow; Bennett,10,0,32,22
1657494695194,MATH 142A,A03,093480,Chow; Bennett,8,0,32,24
1657494695194,MATH 142A,B03,093481,Chow; Bennett,8,0,32,24
1657494695194,MATH 142A,B04,093558,Chow; Bennett,13,0,32,19
1657494695194,MATH 142A,B05,093559,Chow; Bennett,6,0,32,26
1657494701219,MATH 193A,A01,083224,Rotar; Vladimir,8,0,34,26
1657494701219,MATH 193A,A02,083225,Rotar; Vladimir,9,0,34,25
1657494701219,MATH 193A,A03,083781,Rotar; Vladimir,5,0,34,29
1657494701219,MATH 193A,A04,083782,Rotar; Vladimir,10,0,34,24
1657494701219,MATH 193A,A05,093482,Rotar; Vladimir,10,0,34,24
1657494707245,MATH 197,001,091859,McAuley; Julian John,9999,0,9999,0
1657494707245,MATH 197,002,095566,Kedlaya; Kiran S.,9997,0,9999,2
1657494707245,MATH 197,003,095567,Xiao; Ming,9999,0,9999,0
1657494707245,MATH 197,004,095571,Perols; Johan Lars,9998,0,9999,1
1657494714303,COGS 9,A01,083615,Shannon; Kyle Michael,9,0,75,66
1657494720325,COGS 11,A01,083617,Boyle; Mary E. T.,22,0,48,26
1657494726352,COGS 13,A01,083071,Bastos; Amalia Pinkusfeld,11,0,71,60
1657494732375,COGS 14A,A01,092681,Semenuks; Arturs,5,1,100,95
1657494738398,COGS 14B,A01,083073,Cheng; Tzu-Han,6,0,63,57
1657494744422,COGS 17,A01,092677,Semenuks; Arturs,6,0,81,75
1657494750445,COGS 100,A01,083619,Allen; Michael Gordon,17,0,70,53
1657494756472,COGS 101A,A01,083621,Davis; Joshua Daniel,9,0,68,59
1657494762495,COGS 101B,A01,091572,Allen; Michael Gordon,12,0,65,53
1657494768519,COGS 101C,A01,083625,Delgado; Tania,17,0,35,18
1657494774543,COGS 107A,A01,083627,Boyle; Mary E. T.,13,0,60,47
1657494780570,COGS 118A,A01,083075,Gupta; Anjum,21,0,76,55
1657494786675,CSE 3,A50,083646,Miranda; Gregory Joseph,24,0,50,26
1657494792698,CSE 8A,A50,083650,Miranda; Gregory Joseph,17,1,56,39
1657494798721,CSE 11,A01,083080,Cao; Yingjun,6,15,40,34
1657494804747,CSE 12,A01,083652,Krause-Levy; Sophia Louisa,28,1,120,92
1657494810770,CSE 15L,A01,083654,Morris; Justin Loren,9,0,50,41
1657494810770,CSE 15L,A02,083655,Morris; Justin Loren,9,0,50,41
1657494816796,CSE 20,A01,083657,Tran; Khoa Dang,39,0,80,41
1657494822818,CSE 21,A01,095574,Bach; Quang Tran,22,0,48,26
1657494828841,CSE 30,A01,083084,Eldon; John,5,0,80,75
1657494828841,CSE 30,B01,095061,Bhaskar; Nishant,9,0,50,41
1657494834869,CSE 100,A01,083659,Cao; Yingjun,5,4,70,65
1657494840892,CSE 134B,A01,083661,Powell; Thomas Allan,22,0,100,78
1657494846916,CSE 140,A01,083663,Gungor; Onat,15,0,85,70
1657494852939,CSE 140L,A01,083088,Eldon; John,21,0,100,79
1657494858962,CSE 175,A01,083665,Kumar; Rakesh,3,0,25,22
1657494864985,CSE 190,A00,092507,Dubnov; Shlomo,8,0,20,12
1657494871009,ECE 45,A01,083139,Congero; Spencer William,6,0,75,69
1657494877032,ECE 65,A50,083695,Saad; Andrew S,12,0,30,18
1657494877032,ECE 65,A51,095125,Saad; Andrew S,24,0,26,2
1657494883055,ECE 109,A01,091882,Touri; Behrouz,19,0,70,51
1657494889079,ECE 180,A00,083140,Abi Samra; Nicholas Camill,1,0,30,29
1657494889079,ECE 180,B00,083141,Abi Samra; Nicholas Camill,0,0,30,30
1657494895106,MATH 10A,A01,083735,Patchell; Gregory David,2,0,30,28
1657494895106,MATH 10A,A02,083736,Patchell; Gregory David,20,0,30,10
1657494895106,MATH 10A,A03,083737,Patchell; Gregory David,16,0,30,14
1657494901131,MATH 10B,A01,083207,Lim; Seonhee,8,0,34,26
1657494901131,MATH 10B,A02,083208,Lim; Seonhee,9,0,35,26
1657494901131,MATH 10B,A03,093472,Lim; Seonhee,7,0,34,27
1657494901131,MATH 10B,B01,083739,Sinha; Shubham,12,0,30,18
1657494907155,MATH 18,A01,083743,Cinel; Cameron Alexander,7,0,30,23
1657494907155,MATH 18,A02,083744,Cinel; Cameron Alexander,17,0,30,13
1657494907155,MATH 18,A03,083745,Cinel; Cameron Alexander,9,0,30,21
1657494907155,MATH 18,B01,083748,Rideout; David Porter,5,0,37,32
1657494907155,MATH 18,B02,083749,Rideout; David Porter,5,0,36,31
1657494907155,MATH 18,B03,083750,Rideout; David Porter,3,0,37,34
1657494907155,MATH 18,B04,083751,Rideout; David Porter,6,0,36,30
1657494907155,MATH 18,B05,093473,Rideout; David Porter,6,0,36,30
1657494907155,MATH 18,B06,093474,Rideout; David Porter,6,0,36,30
1657494913180,MATH 20A,A01,083754,Zheng; Zequn,14,0,40,26
1657494919208,MATH 20B,A01,083756,Briones; Jor-el Thomas Caparas,4,0,36,32
1657494919208,MATH 20B,A02,083757,Briones; Jor-el Thomas Caparas,1,0,36,35
1657494919208,MATH 20B,A03,093475,Briones; Jor-el Thomas Caparas,2,0,36,34
1657494925237,MATH 20C,A01,083760,Briones; Jor-el Thomas Caparas,1,0,35,34
1657494925237,MATH 20C,A02,083761,Briones; Jor-el Thomas Caparas,8,0,35,27
1657494925237,MATH 20C,A03,093476,Briones; Jor-el Thomas Caparas,0,1,36,36
1657494925237,MATH 20C,B01,083762,Bach; Quang Tran,1,0,30,29
1657494931266,MATH 20D,A01,083765,Tran; Brian Kha,5,0,30,25
1657494931266,MATH 20D,A02,083766,Tran; Brian Kha,5,0,30,25
1657494931266,MATH 20D,A03,083767,Tran; Brian Kha,5,0,30,25
1657494937301,MATH 20E,A01,083771,Ganguly; Soumya,9,0,32,23
1657494937301,MATH 20E,A02,083772,Ganguly; Soumya,6,0,32,26
1657494937301,MATH 20E,B01,083773,Ciotti; Benjamin,20,0,35,15
1657494937301,MATH 20E,B02,083774,Ciotti; Benjamin,17,0,35,18
1657494943331,MATH 103A,A01,083777,Greenfeld; Be'Eri,3,0,36,33
1657494943331,MATH 103A,A02,083778,Greenfeld; Be'Eri,5,0,36,31
1657494943331,MATH 103A,A03,093561,Greenfeld; Be'Eri,5,0,36,31
1657494943331,MATH 103A,B01,083779,Greenfeld; Be'Eri,7,0,36,29
1657494943331,MATH 103A,B02,083780,Greenfeld; Be'Eri,4,0,36,32
1657494943331,MATH 103A,B03,093562,Greenfeld; Be'Eri,3,0,36,33
1657494949359,MATH 105,A01,085443,Carter; Anne Toulson,15,0,35,20
1657494949359,MATH 105,A02,093477,Carter; Anne Toulson,20,0,35,15
1657494955381,MATH 109,A01,083213,Ganzberger; Geoffrey Michael,2,0,34,32
1657494955381,MATH 109,A02,083214,Ganzberger; Geoffrey Michael,4,0,34,30
1657494955381,MATH 109,A03,093478,Ganzberger; Geoffrey Michael,2,0,34,32
1657494955381,MATH 109,B01,083215,Ganzberger; Geoffrey Michael,1,0,32,31
1657494955381,MATH 109,B02,083216,Ganzberger; Geoffrey Michael,2,0,32,30
1657494955381,MATH 109,B03,093479,Ganzberger; Geoffrey Michael,8,0,32,24
1657494961406,MATH 142A,A01,083219,Chow; Bennett,7,0,32,25
1657494961406,MATH 142A,A02,083220,Chow; Bennett,10,0,32,22
1657494961406,MATH 142A,A03,093480,Chow; Bennett,8,0,32,24
1657494961406,MATH 142A,B03,093481,Chow; Bennett,8,0,32,24
1657494961406,MATH 142A,B04,093558,Chow; Bennett,13,0,32,19
1657494961406,MATH 142A,B05,093559,Chow; Bennett,6,0,32,26
1657494967444,MATH 193A,A01,083224,Rotar; Vladimir,8,0,34,26
1657494967444,MATH 193A,A02,083225,Rotar; Vladimir,9,0,34,25
1657494967444,MATH 193A,A03,083781,Rotar; Vladimir,5,0,34,29
1657494967444,MATH 193A,A04,083782,Rotar; Vladimir,10,0,34,24
1657494967444,MATH 193A,A05,093482,Rotar; Vladimir,10,0,34,24
1657494973465,MATH 197,001,091859,McAuley; Julian John,9999,0,9999,0
1657494973465,MATH 197,002,095566,Kedlaya; Kiran S.,9997,0,9999,2
1657494973465,MATH 197,003,095567,Xiao; Ming,9999,0,9999,0
1657494973465,MATH 197,004,095571,Perols; Johan Lars,9998,0,9999,1
1657494980531,COGS 9,A01,083615,Shannon; Kyle Michael,9,0,75,66
1657494986554,COGS 11,A01,083617,Boyle; Mary E. T.,22,0,48,26
1657494992582,COGS 13,A01,083071,Bastos; Amalia Pinkusfeld,11,0,71,60
1657494998605,COGS 14A,A01,092681,Semenuks; Arturs,5,1,100,95
1657495004633,COGS 14B,A01,083073,Cheng; Tzu-Han,6,0,63,57
1657495010657,COGS 17,A01,092677,Semenuks; Arturs,6,0,81,75
1657495016683,COGS 100,A01,083619,Allen; Michael Gordon,17,0,70,53
1657495022712,COGS 101A,A01,083621,Davis; Joshua Daniel,9,0,68,59
1657495028740,COGS 101B,A01,091572,Allen; Michael Gordon,12,0,65,53
1657495034762,COGS 101C,A01,083625,Delgado; Tania,17,0,35,18
1657495040790,COGS 107A,A01,083627,Boyle; Mary E. T.,13,0,60,47
1657495046818,COGS 118A,A01,083075,Gupta; Anjum,21,0,76,55
1657495052848,CSE 3,A50,083646,Miranda; Gregory Joseph,24,0,50,26
1657495058872,CSE 8A,A50,083650,Miranda; Gregory Joseph,17,1,56,39
1657495064895,CSE 11,A01,083080,Cao; Yingjun,6,15,40,34
1657495070925,CSE 12,A01,083652,Krause-Levy; Sophia Louisa,28,1,120,92
1657495076949,CSE 15L,A01,083654,Morris; Justin Loren,9,0,50,41
1657495076949,CSE 15L,A02,083655,Morris; Justin Loren,9,0,50,41
1657495082977,CSE 20,A01,083657,Tran; Khoa Dang,39,0,80,41
1657495089000,CSE 21,A01,095574,Bach; Quang Tran,22,0,48,26
1657495095022,CSE 30,A01,083084,Eldon; John,5,0,80,75
1657495095022,CSE 30,B01,095061,Bhaskar; Nishant,9,0,50,41
1657495101046,CSE 100,A01,083659,Cao; Yingjun,5,4,70,65
1657495107069,CSE 134B,A01,083661,Powell; Thomas Allan,22,0,100,78
1657495113091,CSE 140,A01,083663,Gungor; Onat,15,0,85,70
1657495119115,CSE 140L,A01,083088,Eldon; John,21,0,100,79
1657495125142,CSE 175,A01,083665,Kumar; Rakesh,3,0,25,22
1657495131165,CSE 190,A00,092507,Dubnov; Shlomo,8,0,20,12
1657495137187,ECE 45,A01,083139,Congero; Spencer William,6,0,75,69
1657495143214,ECE 65,A50,083695,Saad; Andrew S,12,0,30,18
1657495143214,ECE 65,A51,095125,Saad; Andrew S,24,0,26,2
1657495149241,ECE 109,A01,091882,Touri; Behrouz,19,0,70,51
1657495155272,ECE 180,A00,083140,Abi Samra; Nicholas Camill,1,0,30,29
1657495155272,ECE 180,B00,083141,Abi Samra; Nicholas Camill,0,0,30,30
1657495161295,MATH 10A,A01,083735,Patchell; Gregory David,2,0,30,28
1657495161295,MATH 10A,A02,083736,Patchell; Gregory David,20,0,30,10
1657495161295,MATH 10A,A03,083737,Patchell; Gregory David,16,0,30,14
1657495167319,MATH 10B,A01,083207,Lim; Seonhee,8,0,34,26
1657495167319,MATH 10B,A02,083208,Lim; Seonhee,9,0,35,26
1657495167319,MATH 10B,A03,093472,Lim; Seonhee,7,0,34,27
1657495167319,MATH 10B,B01,083739,Sinha; Shubham,12,0,30,18
1657495173343,MATH 18,A01,083743,Cinel; Cameron Alexander,7,0,30,23
1657495173343,MATH 18,A02,083744,Cinel; Cameron Alexander,17,0,30,13
1657495173343,MATH 18,A03,083745,Cinel; Cameron Alexander,9,0,30,21
1657495173343,MATH 18,B01,083748,Rideout; David Porter,5,0,37,32
1657495173343,MATH 18,B02,083749,Rideout; David Porter,5,0,36,31
1657495173343,MATH 18,B03,083750,Rideout; David Porter,3,0,37,34
1657495173343,MATH 18,B04,083751,Rideout; David Porter,6,0,36,30
1657495173343,MATH 18,B05,093473,Rideout; David Porter,6,0,36,30
1657495173343,MATH 18,B06,093474,Rideout; David Porter,6,0,36,30
1657495179366,MATH 20A,A01,083754,Zheng; Zequn,14,0,40,26
1657495185389,MATH 20B,A01,083756,Briones; Jor-el Thomas Caparas,4,0,36,32
1657495185389,MATH 20B,A02,083757,Briones; Jor-el Thomas Caparas,1,0,36,35
1657495185389,MATH 20B,A03,093475,Briones; Jor-el Thomas Caparas,2,0,36,34
1657495191421,MATH 20C,A01,083760,Briones; Jor-el Thomas Caparas,1,0,35,34
1657495191421,MATH 20C,A02,083761,Briones; Jor-el Thomas Caparas,8,0,35,27
1657495191421,MATH 20C,A03,093476,Briones; Jor-el Thomas Caparas,0,1,36,36
1657495191421,MATH 20C,B01,083762,Bach; Quang Tran,1,0,30,29
1657495197445,MATH 20D,A01,083765,Tran; Brian Kha,5,0,30,25
1657495197445,MATH 20D,A02,083766,Tran; Brian Kha,5,0,30,25
1657495197445,MATH 20D,A03,083767,Tran; Brian Kha,5,0,30,25
1657495203467,MATH 20E,A01,083771,Ganguly; Soumya,9,0,32,23
1657495203467,MATH 20E,A02,083772,Ganguly; Soumya,6,0,32,26
1657495203467,MATH 20E,B01,083773,Ciotti; Benjamin,20,0,35,15
1657495203467,MATH 20E,B02,083774,Ciotti; Benjamin,17,0,35,18
1657495209492,MATH 103A,A01,083777,Greenfeld; Be'Eri,3,0,36,33
1657495209492,MATH 103A,A02,083778,Greenfeld; Be'Eri,5,0,36,31
1657495209492,MATH 103A,A03,093561,Greenfeld; Be'Eri,5,0,36,31
1657495209492,MATH 103A,B01,083779,Greenfeld; Be'Eri,7,0,36,29
1657495209492,MATH 103A,B02,083780,Greenfeld; Be'Eri,4,0,36,32
1657495209492,MATH 103A,B03,093562,Greenfeld; Be'Eri,3,0,36,33
1657495215517,MATH 105,A01,085443,Carter; Anne Toulson,15,0,35,20
1657495215517,MATH 105,A02,093477,Carter; Anne Toulson,20,0,35,15
1657495221541,MATH 109,A01,083213,Ganzberger; Geoffrey Michael,2,0,34,32
1657495221541,MATH 109,A02,083214,Ganzberger; Geoffrey Michael,4,0,34,30
1657495221541,MATH 109,A03,093478,Ganzberger; Geoffrey Michael,2,0,34,32
1657495221541,MATH 109,B01,083215,Ganzberger; Geoffrey Michael,1,0,32,31
1657495221541,MATH 109,B02,083216,Ganzberger; Geoffrey Michael,2,0,32,30
1657495221541,MATH 109,B03,093479,Ganzberger; Geoffrey Michael,8,0,32,24
1657495227566,MATH 142A,A01,083219,Chow; Bennett,7,0,32,25
1657495227566,MATH 142A,A02,083220,Chow; Bennett,10,0,32,22
1657495227566,MATH 142A,A03,093480,Chow; Bennett,8,0,32,24
1657495227566,MATH 142A,B03,093481,Chow; Bennett,8,0,32,24
1657495227566,MATH 142A,B04,093558,Chow; Bennett,13,0,32,19
1657495227566,MATH 142A,B05,093559,Chow; Bennett,6,0,32,26
1657495233590,MATH 193A,A01,083224,Rotar; Vladimir,8,0,34,26
1657495233590,MATH 193A,A02,083225,Rotar; Vladimir,9,0,34,25
1657495233590,MATH 193A,A03,083781,Rotar; Vladimir,5,0,34,29
1657495233590,MATH 193A,A04,083782,Rotar; Vladimir,10,0,34,24
1657495233590,MATH 193A,A05,093482,Rotar; Vladimir,10,0,34,24
1657495239615,MATH 197,001,091859,McAuley; Julian John,9999,0,9999,0
1657495239615,MATH 197,002,095566,Kedlaya; Kiran S.,9997,0,9999,2
1657495239615,MATH 197,003,095567,Xiao; Ming,9999,0,9999,0
1657495239615,MATH 197,004,095571,Perols; Johan Lars,9998,0,9999,1
1657495246669,COGS 9,A01,083615,Shannon; Kyle Michael,9,0,75,66
1657495252697,COGS 11,A01,083617,Boyle; Mary E. T.,22,0,48,26
1657495258723,COGS 13,A01,083071,Bastos; Amalia Pinkusfeld,11,0,71,60
1657495264750,COGS 14A,A01,092681,Semenuks; Arturs,5,1,100,95
1657495270774,COGS 14B,A01,083073,Cheng; Tzu-Han,6,0,63,57
1657495276806,COGS 17,A01,092677,Semenuks; Arturs,6,0,81,75
1657495282834,COGS 100,A01,083619,Allen; Michael Gordon,17,0,70,53
1657495288858,COGS 101A,A01,083621,Davis; Joshua Daniel,9,0,68,59
1657495294883,COGS 101B,A01,091572,Allen; Michael Gordon,12,0,65,53
1657495300911,COGS 101C,A01,083625,Delgado; Tania,17,0,35,18
1657495306933,COGS 107A,A01,083627,Boyle; Mary E. T.,13,0,60,47
1657495312961,COGS 118A,A01,083075,Gupta; Anjum,21,0,76,55
1657495318986,CSE 3,A50,083646,Miranda; Gregory Joseph,24,0,50,26
1657495325007,CSE 8A,A50,083650,Miranda; Gregory Joseph,17,1,56,39
1657495331030,CSE 11,A01,083080,Cao; Yingjun,6,15,40,34
1657495337058,CSE 12,A01,083652,Krause-Levy; Sophia Louisa,28,1,120,92
1657495343087,CSE 15L,A01,083654,Morris; Justin Loren,9,0,50,41
1657495343087,CSE 15L,A02,083655,Morris; Justin Loren,9,0,50,41
1657495349115,CSE 20,A01,083657,Tran; Khoa Dang,39,0,80,41
1657495355143,CSE 21,A01,095574,Bach; Quang Tran,22,0,48,26
1657495361170,CSE 30,A01,083084,Eldon; John,5,0,80,75
1657495361170,CSE 30,B01,095061,Bhaskar; Nishant,9,0,50,41
1657495367194,CSE 100,A01,083659,Cao; Yingjun,5,4,70,65
1657495373217,CSE 134B,A01,083661,Powell; Thomas Allan,22,0,100,78
1657495379244,CSE 140,A01,083663,Gungor; Onat,15,0,85,70
1657495385345,CSE 140L,A01,083088,Eldon; John,21,0,100,79
1657495391372,CSE 175,A01,083665,Kumar; Rakesh,3,0,25,22
1657495397399,CSE 190,A00,092507,Dubnov; Shlomo,8,0,20,12
1657495403424,ECE 45,A01,083139,Congero; Spencer William,6,0,75,69
1657495409450,ECE 65,A50,083695,Saad; Andrew S,12,0,30,18
1657495409450,ECE 65,A51,095125,Saad; Andrew S,24,0,26,2
1657495415472,ECE 109,A01,091882,Touri; Behrouz,19,0,70,51
1657495421496,ECE 180,A00,083140,Abi Samra; Nicholas Camill,1,0,30,29
1657495421496,ECE 180,B00,083141,Abi Samra; Nicholas Camill,0,0,30,30
1657495427523,MATH 10A,A01,083735,Patchell; Gregory David,2,0,30,28
1657495427523,MATH 10A,A02,083736,Patchell; Gregory David,20,0,30,10
1657495427523,MATH 10A,A03,083737,Patchell; Gregory David,16,0,30,14
1657495433551,MATH 10B,A01,083207,Lim; Seonhee,8,0,34,26
1657495433551,MATH 10B,A02,083208,Lim; Seonhee,9,0,35,26
1657495433551,MATH 10B,A03,093472,Lim; Seonhee,7,0,34,27
1657495433551,MATH 10B,B01,083739,Sinha; Shubham,12,0,30,18
1657495439583,MATH 18,A01,083743,Cinel; Cameron Alexander,7,0,30,23
1657495439583,MATH 18,A02,083744,Cinel; Cameron Alexander,17,0,30,13
1657495439583,MATH 18,A03,083745,Cinel; Cameron Alexander,9,0,30,21
1657495439583,MATH 18,B01,083748,Rideout; David Porter,5,0,37,32
1657495439583,MATH 18,B02,083749,Rideout; David Porter,5,0,36,31
1657495439583,MATH 18,B03,083750,Rideout; David Porter,3,0,37,34
1657495439583,MATH 18,B04,083751,Rideout; David Porter,6,0,36,30
1657495439583,MATH 18,B05,093473,Rideout; David Porter,6,0,36,30
1657495439583,MATH 18,B06,093474,Rideout; David Porter,6,0,36,30
1657495445620,MATH 20A,A01,083754,Zheng; Zequn,14,0,40,26
1657495451646,MATH 20B,A01,083756,Briones; Jor-el Thomas Caparas,4,0,36,32
1657495451646,MATH 20B,A02,083757,Briones; Jor-el Thomas Caparas,1,0,36,35
1657495451646,MATH 20B,A03,093475,Briones; Jor-el Thomas Caparas,2,0,36,34
1657495457669,MATH 20C,A01,083760,Briones; Jor-el Thomas Caparas,1,0,35,34
1657495457669,MATH 20C,A02,083761,Briones; Jor-el Thomas Caparas,8,0,35,27
1657495457669,MATH 20C,A03,093476,Briones; Jor-el Thomas Caparas,0,1,36,36
1657495457669,MATH 20C,B01,083762,Bach; Quang Tran,1,0,30,29
1657495463694,MATH 20D,A01,083765,Tran; Brian Kha,5,0,30,25
1657495463694,MATH 20D,A02,083766,Tran; Brian Kha,5,0,30,25
1657495463694,MATH 20D,A03,083767,Tran; Brian Kha,5,0,30,25
1657495469731,MATH 20E,A01,083771,Ganguly; Soumya,9,0,32,23
1657495469731,MATH 20E,A02,083772,Ganguly; Soumya,6,0,32,26
1657495469731,MATH 20E,B01,083773,Ciotti; Benjamin,20,0,35,15
1657495469731,MATH 20E,B02,083774,Ciotti; Benjamin,17,0,35,18
1657495475760,MATH 103A,A01,083777,Greenfeld; Be'Eri,3,0,36,33
1657495475760,MATH 103A,A02,083778,Greenfeld; Be'Eri,5,0,36,31
1657495475760,MATH 103A,A03,093561,Greenfeld; Be'Eri,5,0,36,31
1657495475760,MATH 103A,B01,083779,Greenfeld; Be'Eri,7,0,36,29
1657495475760,MATH 103A,B02,083780,Greenfeld; Be'Eri,4,0,36,32
1657495475760,MATH 103A,B03,093562,Greenfeld; Be'Eri,3,0,36,33
1657495481784,MATH 105,A01,085443,Carter; Anne Toulson,15,0,35,20
1657495481784,MATH 105,A02,093477,Carter; Anne Toulson,20,0,35,15
1657495487808,MATH 109,A01,083213,Ganzberger; Geoffrey Michael,2,0,34,32
1657495487808,MATH 109,A02,083214,Ganzberger; Geoffrey Michael,4,0,34,30
1657495487808,MATH 109,A03,093478,Ganzberger; Geoffrey Michael,2,0,34,32
1657495487808,MATH 109,B01,083215,Ganzberger; Geoffrey Michael,1,0,32,31
1657495487808,MATH 109,B02,083216,Ganzberger; Geoffrey Michael,2,0,32,30
1657495487808,MATH 109,B03,093479,Ganzberger; Geoffrey Michael,8,0,32,24
1657495493844,MATH 142A,A01,083219,Chow; Bennett,7,0,32,25
1657495493844,MATH 142A,A02,083220,Chow; Bennett,10,0,32,22
1657495493844,MATH 142A,A03,093480,Chow; Bennett,8,0,32,24
1657495493844,MATH 142A,B03,093481,Chow; Bennett,8,0,32,24
1657495493844,MATH 142A,B04,093558,Chow; Bennett,13,0,32,19
1657495493844,MATH 142A,B05,093559,Chow; Bennett,6,0,32,26
1657495499871,MATH 193A,A01,083224,Rotar; Vladimir,8,0,34,26
1657495499871,MATH 193A,A02,083225,Rotar; Vladimir,9,0,34,25
1657495499871,MATH 193A,A03,083781,Rotar; Vladimir,5,0,34,29
1657495499871,MATH 193A,A04,083782,Rotar; Vladimir,10,0,34,24
1657495499871,MATH 193A,A05,093482,Rotar; Vladimir,10,0,34,24
1657495505903,MATH 197,001,091859,McAuley; Julian John,9999,0,9999,0
1657495505903,MATH 197,002,095566,Kedlaya; Kiran S.,9997,0,9999,2
1657495505903,MATH 197,003,095567,Xiao; Ming,9999,0,9999,0
1657495505903,MATH 197,004,095571,Perols; Johan Lars,9998,0,9999,1
1657495512966,COGS 9,A01,083615,Shannon; Kyle Michael,9,0,75,66
1657495518988,COGS 11,A01,083617,Boyle; Mary E. T.,22,0,48,26
1657495525015,COGS 13,A01,083071,Bastos; Amalia Pinkusfeld,11,0,71,60
1657495531038,COGS 14A,A01,092681,Semenuks; Arturs,5,1,100,95
1657495537062,COGS 14B,A01,083073,Cheng; Tzu-Han,6,0,63,57
1657495543090,COGS 17,A01,092677,Semenuks; Arturs,6,0,81,75
1657495549121,COGS 100,A01,083619,Allen; Michael Gordon,17,0,70,53
1657495555144,COGS 101A,A01,083621,Davis; Joshua Daniel,9,0,68,59
1657495561167,COGS 101B,A01,091572,Allen; Michael Gordon,12,0,65,53
1657495567196,COGS 101C,A01,083625,Delgado; Tania,17,0,35,18
1657495573241,COGS 107A,A01,083627,Boyle; Mary E. T.,13,0,60,47
1657495579265,COGS 118A,A01,083075,Gupta; Anjum,21,0,76,55
1657495585290,CSE 3,A50,083646,Miranda; Gregory Joseph,24,0,50,26
1657495591317,CSE 8A,A50,083650,Miranda; Gregory Joseph,17,1,56,39
1657495597345,CSE 11,A01,083080,Cao; Yingjun,6,15,40,34
1657495603371,CSE 12,A01,083652,Krause-Levy; Sophia Louisa,28,1,120,92
1657495609399,CSE 15L,A01,083654,Morris; Justin Loren,9,0,50,41
1657495609399,CSE 15L,A02,083655,Morris; Justin Loren,9,0,50,41
1657495615424,CSE 20,A01,083657,Tran; Khoa Dang,39,0,80,41
1657495621454,CSE 21,A01,095574,Bach; Quang Tran,22,0,48,26
1657495627476,CSE 30,A01,083084,Eldon; John,5,0,80,75
1657495627476,CSE 30,B01,095061,Bhaskar; Nishant,9,0,50,41
1657495633500,CSE 100,A01,083659,Cao; Yingjun,5,4,70,65
1657495639527,CSE 134B,A01,083661,Powell; Thomas Allan,22,0,100,78
1657495645553,CSE 140,A01,083663,Gungor; Onat,15,0,85,70
1657495651577,CSE 140L,A01,083088,Eldon; John,21,0,100,79
1657495657605,CSE 175,A01,083665,Kumar; Rakesh,3,0,25,22
1657495663628,CSE 190,A00,092507,Dubnov; Shlomo,8,0,20,12
1657495669652,ECE 45,A01,083139,Congero; Spencer William,6,0,75,69
1657495675674,ECE 65,A50,083695,Saad; Andrew S,12,0,30,18
1657495675674,ECE 65,A51,095125,Saad; Andrew S,24,0,26,2
1657495681701,ECE 109,A01,091882,Touri; Behrouz,19,0,70,51
1657495687724,ECE 180,A00,083140,Abi Samra; Nicholas Camill,1,0,30,29
1657495687724,ECE 180,B00,083141,Abi Samra; Nicholas Camill,0,0,30,30
1657495693747,MATH 10A,A01,083735,Patchell; Gregory David,2,0,30,28
1657495693747,MATH 10A,A02,083736,Patchell; Gregory David,20,0,30,10
1657495693747,MATH 10A,A03,083737,Patchell; Gregory David,16,0,30,14
1657495699770,MATH 10B,A01,083207,Lim; Seonhee,8,0,34,26
1657495699770,MATH 10B,A02,083208,Lim; Seonhee,9,0,35,26
1657495699770,MATH 10B,A03,093472,Lim; Seonhee,7,0,34,27
1657495699770,MATH 10B,B01,083739,Sinha; Shubham,12,0,30,18
1657495705800,MATH 18,A01,083743,Cinel; Cameron Alexander,7,0,30,23
1657495705800,MATH 18,A02,083744,Cinel; Cameron Alexander,17,0,30,13
1657495705800,MATH 18,A03,083745,Cinel; Cameron Alexander,9,0,30,21
1657495705800,MATH 18,B01,083748,Rideout; David Porter,5,0,37,32
1657495705800,MATH 18,B02,083749,Rideout; David Porter,5,0,36,31
1657495705800,MATH 18,B03,083750,Rideout; David Porter,3,0,37,34
1657495705800,MATH 18,B04,083751,Rideout; David Porter,6,0,36,30
1657495705800,MATH 18,B05,093473,Rideout; David Porter,6,0,36,30
1657495705800,MATH 18,B06,093474,Rideout; David Porter,6,0,36,30
1657495711831,MATH 20A,A01,083754,Zheng; Zequn,14,0,40,26
1657495717854,MATH 20B,A01,083756,Briones; Jor-el Thomas Caparas,4,0,36,32
1657495717854,MATH 20B,A02,083757,Briones; Jor-el Thomas Caparas,1,0,36,35
1657495717854,MATH 20B,A03,093475,Briones; Jor-el Thomas Caparas,2,0,36,34
1657495723878,MATH 20C,A01,083760,Briones; Jor-el Thomas Caparas,1,0,35,34
1657495723878,MATH 20C,A02,083761,Briones; Jor-el Thomas Caparas,8,0,35,27
1657495723878,MATH 20C,A03,093476,Briones; Jor-el Thomas Caparas,0,1,36,36
1657495723878,MATH 20C,B01,083762,Bach; Quang Tran,1,0,30,29
1657495729902,MATH 20D,A01,083765,Tran; Brian Kha,5,0,30,25
1657495729902,MATH 20D,A02,083766,Tran; Brian Kha,5,0,30,25
1657495729902,MATH 20D,A03,083767,Tran; Brian Kha,5,0,30,25
1657495735930,MATH 20E,A01,083771,Ganguly; Soumya,9,0,32,23
1657495735930,MATH 20E,A02,083772,Ganguly; Soumya,6,0,32,26
1657495735930,MATH 20E,B01,083773,Ciotti; Benjamin,20,0,35,15
1657495735930,MATH 20E,B02,083774,Ciotti; Benjamin,17,0,35,18
1657495741954,MATH 103A,A01,083777,Greenfeld; Be'Eri,3,0,36,33
1657495741954,MATH 103A,A02,083778,Greenfeld; Be'Eri,5,0,36,31
1657495741954,MATH 103A,A03,093561,Greenfeld; Be'Eri,5,0,36,31
1657495741954,MATH 103A,B01,083779,Greenfeld; Be'Eri,7,0,36,29
1657495741954,MATH 103A,B02,083780,Greenfeld; Be'Eri,4,0,36,32
1657495741954,MATH 103A,B03,093562,Greenfeld; Be'Eri,3,0,36,33
1657495747981,MATH 105,A01,085443,Carter; Anne Toulson,15,0,35,20
1657495747981,MATH 105,A02,093477,Carter; Anne Toulson,20,0,35,15
1657495754008,MATH 109,A01,083213,Ganzberger; Geoffrey Michael,2,0,34,32
1657495754008,MATH 109,A02,083214,Ganzberger; Geoffrey Michael,4,0,34,30
1657495754008,MATH 109,A03,093478,Ganzberger; Geoffrey Michael,2,0,34,32
1657495754008,MATH 109,B01,083215,Ganzberger; Geoffrey Michael,1,0,32,31
1657495754008,MATH 109,B02,083216,Ganzberger; Geoffrey Michael,2,0,32,30
1657495754008,MATH 109,B03,093479,Ganzberger; Geoffrey Michael,8,0,32,24
1657495760039,MATH 142A,A01,083219,Chow; Bennett,7,0,32,25
1657495760039,MATH 142A,A02,083220,Chow; Bennett,10,0,32,22
1657495760039,MATH 142A,A03,093480,Chow; Bennett,8,0,32,24
1657495760039,MATH 142A,B03,093481,Chow; Bennett,8,0,32,24
1657495760039,MATH 142A,B04,093558,Chow; Bennett,13,0,32,19
1657495760039,MATH 142A,B05,093559,Chow; Bennett,6,0,32,26
1657495766062,MATH 193A,A01,083224,Rotar; Vladimir,8,0,34,26
1657495766062,MATH 193A,A02,083225,Rotar; Vladimir,9,0,34,25
1657495766062,MATH 193A,A03,083781,Rotar; Vladimir,5,0,34,29
1657495766062,MATH 193A,A04,083782,Rotar; Vladimir,10,0,34,24
1657495766062,MATH 193A,A05,093482,Rotar; Vladimir,10,0,34,24
1657495772084,MATH 197,001,091859,McAuley; Julian John,9999,0,9999,0
1657495772084,MATH 197,002,095566,Kedlaya; Kiran S.,9997,0,9999,2
1657495772084,MATH 197,003,095567,Xiao; Ming,9999,0,9999,0
1657495772084,MATH 197,004,095571,Perols; Johan Lars,9998,0,9999,1
1657495779151,COGS 9,A01,083615,Shannon; Kyle Michael,9,0,75,66
1657495785175,COGS 11,A01,083617,Boyle; Mary E. T.,22,0,48,26
1657495791199,COGS 13,A01,083071,Bastos; Amalia Pinkusfeld,11,0,71,60
1657495797221,COGS 14A,A01,092681,Semenuks; Arturs,5,1,100,95
1657495803248,COGS 14B,A01,083073,Cheng; Tzu-Han,6,0,63,57
1657495809271,COGS 17,A01,092677,Semenuks; Arturs,6,0,81,75
1657495815296,COGS 100,A01,083619,Allen; Michael Gordon,17,0,70,53
1657495821326,COGS 101A,A01,083621,Davis; Joshua Daniel,9,0,68,59
1657495827349,COGS 101B,A01,091572,Allen; Michael Gordon,12,0,65,53
1657495833375,COGS 101C,A01,083625,Delgado; Tania,17,0,35,18
1657495839403,COGS 107A,A01,083627,Boyle; Mary E. T.,13,0,60,47
1657495845439,COGS 118A,A01,083075,Gupta; Anjum,21,0,76,55
1657495851463,CSE 3,A50,083646,Miranda; Gregory Joseph,24,0,50,26
1657495857494,CSE 8A,A50,083650,Miranda; Gregory Joseph,17,1,56,39
1657495863520,CSE 11,A01,083080,Cao; Yingjun,6,15,40,34
1657495869547,CSE 12,A01,083652,Krause-Levy; Sophia Louisa,28,1,120,92
1657495875576,CSE 15L,A01,083654,Morris; Justin Loren,9,0,50,41
1657495875576,CSE 15L,A02,083655,Morris; Justin Loren,9,0,50,41
1657495881605,CSE 20,A01,083657,Tran; Khoa Dang,39,0,80,41
1657495887636,CSE 21,A01,095574,Bach; Quang Tran,22,0,48,26
1657495893664,CSE 30,A01,083084,Eldon; John,5,0,80,75
1657495893664,CSE 30,B01,095061,Bhaskar; Nishant,9,0,50,41
1657495899691,CSE 100,A01,083659,Cao; Yingjun,5,4,70,65
1657495905713,CSE 134B,A01,083661,Powell; Thomas Allan,22,0,100,78
1657495911741,CSE 140,A01,083663,Gungor; Onat,15,0,85,70
1657495917772,CSE 140L,A01,083088,Eldon; John,21,0,100,79
1657495923795,CSE 175,A01,083665,Kumar; Rakesh,3,0,25,22
1657495929826,CSE 190,A00,092507,Dubnov; Shlomo,8,0,20,12
1657495935855,ECE 45,A01,083139,Congero; Spencer William,6,0,75,69
1657495941883,ECE 65,A50,083695,Saad; Andrew S,12,0,30,18
1657495941883,ECE 65,A51,095125,Saad; Andrew S,24,0,26,2
1657495947906,ECE 109,A01,091882,Touri; Behrouz,19,0,70,51
1657495953931,ECE 180,A00,083140,Abi Samra; Nicholas Camill,1,0,30,29
1657495953931,ECE 180,B00,083141,Abi Samra; Nicholas Camill,0,0,30,30
1657495959958,MATH 10A,A01,083735,Patchell; Gregory David,2,0,30,28
1657495959958,MATH 10A,A02,083736,Patchell; Gregory David,20,0,30,10
1657495959958,MATH 10A,A03,083737,Patchell; Gregory David,16,0,30,14
1657495965990,MATH 10B,A01,083207,Lim; Seonhee,8,0,34,26
1657495965990,MATH 10B,A02,083208,Lim; Seonhee,9,0,35,26
1657495965990,MATH 10B,A03,093472,Lim; Seonhee,7,0,34,27
1657495965990,MATH 10B,B01,083739,Sinha; Shubham,12,0,30,18
1657495972022,MATH 18,A01,083743,Cinel; Cameron Alexander,7,0,30,23
1657495972022,MATH 18,A02,083744,Cinel; Cameron Alexander,17,0,30,13
1657495972022,MATH 18,A03,083745,Cinel; Cameron Alexander,9,0,30,21
1657495972022,MATH 18,B01,083748,Rideout; David Porter,5,0,37,32
1657495972022,MATH 18,B02,083749,Rideout; David Porter,5,0,36,31
1657495972022,MATH 18,B03,083750,Rideout; David Porter,3,0,37,34
1657495972022,MATH 18,B04,083751,Rideout; David Porter,6,0,36,30
1657495972022,MATH 18,B05,093473,Rideout; David Porter,6,0,36,30
1657495972022,MATH 18,B06,093474,Rideout; David Porter,6,0,36,30
1657495978046,MATH 20A,A01,083754,Zheng; Zequn,14,0,40,26
1657495984172,MATH 20B,A01,083756,Briones; Jor-el Thomas Caparas,4,0,36,32
1657495984172,MATH 20B,A02,083757,Briones; Jor-el Thomas Caparas,1,0,36,35
1657495984172,MATH 20B,A03,093475,Briones; Jor-el Thomas Caparas,2,0,36,34
1657495990200,MATH 20C,A01,083760,Briones; Jor-el Thomas Caparas,1,0,35,34
1657495990200,MATH 20C,A02,083761,Briones; Jor-el Thomas Caparas,8,0,35,27
1657495990200,MATH 20C,A03,093476,Briones; Jor-el Thomas Caparas,0,1,36,36
1657495990200,MATH 20C,B01,083762,Bach; Quang Tran,1,0,30,29
1657495996227,MATH 20D,A01,083765,Tran; Brian Kha,5,0,30,25
1657495996227,MATH 20D,A02,083766,Tran; Brian Kha,5,0,30,25
1657495996227,MATH 20D,A03,083767,Tran; Brian Kha,5,0,30,25
1657496002252,MATH 20E,A01,083771,Ganguly; Soumya,9,0,32,23
1657496002252,MATH 20E,A02,083772,Ganguly; Soumya,6,0,32,26
1657496002252,MATH 20E,B01,083773,Ciotti; Benjamin,20,0,35,15
1657496002252,MATH 20E,B02,083774,Ciotti; Benjamin,17,0,35,18
1657496008281,MATH 103A,A01,083777,Greenfeld; Be'Eri,3,0,36,33
1657496008281,MATH 103A,A02,083778,Greenfeld; Be'Eri,5,0,36,31
1657496008281,MATH 103A,A03,093561,Greenfeld; Be'Eri,5,0,36,31
1657496008281,MATH 103A,B01,083779,Greenfeld; Be'Eri,7,0,36,29
1657496008281,MATH 103A,B02,083780,Greenfeld; Be'Eri,4,0,36,32
1657496008281,MATH 103A,B03,093562,Greenfeld; Be'Eri,3,0,36,33
1657496014308,MATH 105,A01,085443,Carter; Anne Toulson,15,0,35,20
1657496014308,MATH 105,A02,093477,Carter; Anne Toulson,20,0,35,15
1657496020332,MATH 109,A01,083213,Ganzberger; Geoffrey Michael,2,0,34,32
1657496020332,MATH 109,A02,083214,Ganzberger; Geoffrey Michael,4,0,34,30
1657496020332,MATH 109,A03,093478,Ganzberger; Geoffrey Michael,2,0,34,32
1657496020332,MATH 109,B01,083215,Ganzberger; Geoffrey Michael,1,0,32,31
1657496020332,MATH 109,B02,083216,Ganzberger; Geoffrey Michael,2,0,32,30
1657496020332,MATH 109,B03,093479,Ganzberger; Geoffrey Michael,8,0,32,24
1657496026360,MATH 142A,A01,083219,Chow; Bennett,7,0,32,25
1657496026360,MATH 142A,A02,083220,Chow; Bennett,10,0,32,22
1657496026360,MATH 142A,A03,093480,Chow; Bennett,8,0,32,24
1657496026360,MATH 142A,B03,093481,Chow; Bennett,8,0,32,24
1657496026360,MATH 142A,B04,093558,Chow; Bennett,13,0,32,19
1657496026360,MATH 142A,B05,093559,Chow; Bennett,6,0,32,26
1657496032386,MATH 193A,A01,083224,Rotar; Vladimir,8,0,34,26
1657496032386,MATH 193A,A02,083225,Rotar; Vladimir,9,0,34,25
1657496032386,MATH 193A,A03,083781,Rotar; Vladimir,5,0,34,29
1657496032386,MATH 193A,A04,083782,Rotar; Vladimir,10,0,34,24
1657496032386,MATH 193A,A05,093482,Rotar; Vladimir,10,0,34,24
1657496038410,MATH 197,001,091859,McAuley; Julian John,9999,0,9999,0
1657496038410,MATH 197,002,095566,Kedlaya; Kiran S.,9997,0,9999,2
1657496038410,MATH 197,003,095567,Xiao; Ming,9999,0,9999,0
1657496038410,MATH 197,004,095571,Perols; Johan Lars,9998,0,9999,1
1657496045475,COGS 9,A01,083615,Shannon; Kyle Michael,9,0,75,66
1657496051497,COGS 11,A01,083617,Boyle; Mary E. T.,22,0,48,26
1657496057520,COGS 13,A01,083071,Bastos; Amalia Pinkusfeld,11,0,71,60
1657496063547,COGS 14A,A01,092681,Semenuks; Arturs,5,1,100,95
1657496069581,COGS 14B,A01,083073,Cheng; Tzu-Han,6,0,63,57
1657496075607,COGS 17,A01,092677,Semenuks; Arturs,6,0,81,75
1657496081632,COGS 100,A01,083619,Allen; Michael Gordon,17,0,70,53
1657496087662,COGS 101A,A01,083621,Davis; Joshua Daniel,9,0,68,59
1657496093687,COGS 101B,A01,091572,Allen; Michael Gordon,12,0,65,53
1657496099722,COGS 101C,A01,083625,Delgado; Tania,17,0,35,18
1657496105747,COGS 107A,A01,083627,Boyle; Mary E. T.,13,0,60,47
1657496111775,COGS 118A,A01,083075,Gupta; Anjum,21,0,76,55
1657496117803,CSE 3,A50,083646,Miranda; Gregory Joseph,24,0,50,26
1657496123825,CSE 8A,A50,083650,Miranda; Gregory Joseph,17,1,56,39
1657496129849,CSE 11,A01,083080,Cao; Yingjun,6,15,40,34
1657496135885,CSE 12,A01,083652,Krause-Levy; Sophia Louisa,28,1,120,92
1657496141911,CSE 15L,A01,083654,Morris; Justin Loren,9,0,50,41
1657496141911,CSE 15L,A02,083655,Morris; Justin Loren,9,0,50,41
1657496147938,CSE 20,A01,083657,Tran; Khoa Dang,39,0,80,41
1657496153960,CSE 21,A01,095574,Bach; Quang Tran,22,0,48,26
1657496159984,CSE 30,A01,083084,Eldon; John,5,0,80,75
1657496159984,CSE 30,B01,095061,Bhaskar; Nishant,9,0,50,41
1657496166032,CSE 100,A01,083659,Cao; Yingjun,5,4,70,65
1657496172058,CSE 134B,A01,083661,Powell; Thomas Allan,22,0,100,78
1657496178081,CSE 140,A01,083663,Gungor; Onat,15,0,85,70
1657496184104,CSE 140L,A01,083088,Eldon; John,21,0,100,79
1657496190139,CSE 175,A01,083665,Kumar; Rakesh,3,0,25,22
1657496196166,CSE 190,A00,092507,Dubnov; Shlomo,8,0,20,12
1657496202188,ECE 45,A01,083139,Congero; Spencer William,6,0,75,69
1657496208211,ECE 65,A50,083695,Saad; Andrew S,12,0,30,18
1657496208211,ECE 65,A51,095125,Saad; Andrew S,24,0,26,2
1657496214242,ECE 109,A01,091882,Touri; Behrouz,19,0,70,51
1657496220271,ECE 180,A00,083140,Abi Samra; Nicholas Camill,1,0,30,29
1657496220271,ECE 180,B00,083141,Abi Samra; Nicholas Camill,0,0,30,30
1657496226300,MATH 10A,A01,083735,Patchell; Gregory David,2,0,30,28
1657496226300,MATH 10A,A02,083736,Patchell; Gregory David,20,0,30,10
1657496226300,MATH 10A,A03,083737,Patchell; Gregory David,16,0,30,14
1657496232328,MATH 10B,A01,083207,Lim; Seonhee,8,0,34,26
1657496232328,MATH 10B,A02,083208,Lim; Seonhee,9,0,35,26
1657496232328,MATH 10B,A03,093472,Lim; Seonhee,7,0,34,27
1657496232328,MATH 10B,B01,083739,Sinha; Shubham,12,0,30,18
1657496238351,MATH 18,A01,083743,Cinel; Cameron Alexander,7,0,30,23
1657496238351,MATH 18,A02,083744,Cinel; Cameron Alexander,17,0,30,13
1657496238351,MATH 18,A03,083745,Cinel; Cameron Alexander,9,0,30,21
1657496238351,MATH 18,B01,083748,Rideout; David Porter,5,0,37,32
1657496238351,MATH 18,B02,083749,Rideout; David Porter,5,0,36,31
1657496238351,MATH 18,B03,083750,Rideout; David Porter,3,0,37,34
1657496238351,MATH 18,B04,083751,Rideout; David Porter,6,0,36,30
1657496238351,MATH 18,B05,093473,Rideout; David Porter,6,0,36,30
1657496238351,MATH 18,B06,093474,Rideout; David Porter,6,0,36,30
1657496244379,MATH 20A,A01,083754,Zheng; Zequn,14,0,40,26
1657496250401,MATH 20B,A01,083756,Briones; Jor-el Thomas Caparas,4,0,36,32
1657496250401,MATH 20B,A02,083757,Briones; Jor-el Thomas Caparas,1,0,36,35
1657496250401,MATH 20B,A03,093475,Briones; Jor-el Thomas Caparas,2,0,36,34
1657496256424,MATH 20C,A01,083760,Briones; Jor-el Thomas Caparas,1,0,35,34
1657496256424,MATH 20C,A02,083761,Briones; Jor-el Thomas Caparas,8,0,35,27
1657496256424,MATH 20C,A03,093476,Briones; Jor-el Thomas Caparas,0,1,36,36
1657496256424,MATH 20C,B01,083762,Bach; Quang Tran,1,0,30,29
1657496262452,MATH 20D,A01,083765,Tran; Brian Kha,5,0,30,25
1657496262452,MATH 20D,A02,083766,Tran; Brian Kha,5,0,30,25
1657496262452,MATH 20D,A03,083767,Tran; Brian Kha,5,0,30,25
1657496268488,MATH 20E,A01,083771,Ganguly; Soumya,9,0,32,23
1657496268488,MATH 20E,A02,083772,Ganguly; Soumya,6,0,32,26
1657496268488,MATH 20E,B01,083773,Ciotti; Benjamin,20,0,35,15
1657496268488,MATH 20E,B02,083774,Ciotti; Benjamin,17,0,35,18
1657496274516,MATH 103A,A01,083777,Greenfeld; Be'Eri,3,0,36,33
1657496274516,MATH 103A,A02,083778,Greenfeld; Be'Eri,5,0,36,31
1657496274516,MATH 103A,A03,093561,Greenfeld; Be'Eri,5,0,36,31
1657496274516,MATH 103A,B01,083779,Greenfeld; Be'Eri,7,0,36,29
1657496274516,MATH 103A,B02,083780,Greenfeld; Be'Eri,4,0,36,32
1657496274516,MATH 103A,B03,093562,Greenfeld; Be'Eri,3,0,36,33
1657496280541,MATH 105,A01,085443,Carter; Anne Toulson,15,0,35,20
1657496280541,MATH 105,A02,093477,Carter; Anne Toulson,20,0,35,15
1657496286578,MATH 109,A01,083213,Ganzberger; Geoffrey Michael,2,0,34,32
1657496286578,MATH 109,A02,083214,Ganzberger; Geoffrey Michael,4,0,34,30
1657496286578,MATH 109,A03,093478,Ganzberger; Geoffrey Michael,2,0,34,32
1657496286578,MATH 109,B01,083215,Ganzberger; Geoffrey Michael,1,0,32,31
1657496286578,MATH 109,B02,083216,Ganzberger; Geoffrey Michael,2,0,32,30
1657496286578,MATH 109,B03,093479,Ganzberger; Geoffrey Michael,8,0,32,24
1657496292603,MATH 142A,A01,083219,Chow; Bennett,7,0,32,25
1657496292603,MATH 142A,A02,083220,Chow; Bennett,10,0,32,22
1657496292603,MATH 142A,A03,093480,Chow; Bennett,8,0,32,24
1657496292603,MATH 142A,B03,093481,Chow; Bennett,8,0,32,24
1657496292603,MATH 142A,B04,093558,Chow; Bennett,13,0,32,19
1657496292603,MATH 142A,B05,093559,Chow; Bennett,6,0,32,26
1657496298627,MATH 193A,A01,083224,Rotar; Vladimir,8,0,34,26
1657496298627,MATH 193A,A02,083225,Rotar; Vladimir,9,0,34,25
1657496298627,MATH 193A,A03,083781,Rotar; Vladimir,5,0,34,29
1657496298627,MATH 193A,A04,083782,Rotar; Vladimir,10,0,34,24
1657496298627,MATH 193A,A05,093482,Rotar; Vladimir,10,0,34,24
1657496304651,MATH 197,001,091859,McAuley; Julian John,9999,0,9999,0
1657496304651,MATH 197,002,095566,Kedlaya; Kiran S.,9997,0,9999,2
1657496304651,MATH 197,003,095567,Xiao; Ming,9999,0,9999,0
1657496304651,MATH 197,004,095571,Perols; Johan Lars,9998,0,9999,1
1657496311710,COGS 9,A01,083615,Shannon; Kyle Michael,9,0,75,66
1657496317735,COGS 11,A01,083617,Boyle; Mary E. T.,22,0,48,26
1657496323767,COGS 13,A01,083071,Bastos; Amalia Pinkusfeld,11,0,71,60
1657496329789,COGS 14A,A01,092681,Semenuks; Arturs,5,1,100,95
1657496335817,COGS 14B,A01,083073,Cheng; Tzu-Han,6,0,63,57
1657496341840,COGS 17,A01,092677,Semenuks; Arturs,6,0,81,75
1657496347862,COGS 100,A01,083619,Allen; Michael Gordon,17,0,70,53
1657496353886,COGS 101A,A01,083621,Davis; Joshua Daniel,9,0,68,59
1657496359911,COGS 101B,A01,091572,Allen; Michael Gordon,12,0,65,53
1657496365933,COGS 101C,A01,083625,Delgado; Tania,17,0,35,18
1657496371961,COGS 107A,A01,083627,Boyle; Mary E. T.,13,0,60,47
1657496377994,COGS 118A,A01,083075,Gupta; Anjum,21,0,76,55
1657496384022,CSE 3,A50,083646,Miranda; Gregory Joseph,24,0,50,26
1657496390047,CSE 8A,A50,083650,Miranda; Gregory Joseph,17,1,56,39
1657496396069,CSE 11,A01,083080,Cao; Yingjun,6,15,40,34
1657496402098,CSE 12,A01,083652,Krause-Levy; Sophia Louisa,28,1,120,92
1657496408121,CSE 15L,A01,083654,Morris; Justin Loren,9,0,50,41
1657496408121,CSE 15L,A02,083655,Morris; Justin Loren,9,0,50,41
1657496414148,CSE 20,A01,083657,Tran; Khoa Dang,39,0,80,41
1657496420174,CSE 21,A01,095574,Bach; Quang Tran,22,0,48,26
1657496426201,CSE 30,A01,083084,Eldon; John,5,0,80,75
1657496426201,CSE 30,B01,095061,Bhaskar; Nishant,9,0,50,41
1657496432227,CSE 100,A01,083659,Cao; Yingjun,5,4,70,65
1657496438250,CSE 134B,A01,083661,Powell; Thomas Allan,22,0,100,78
1657496444273,CSE 140,A01,083663,Gungor; Onat,15,0,85,70
1657496450300,CSE 140L,A01,083088,Eldon; John,21,0,100,79
1657496456326,CSE 175,A01,083665,Kumar; Rakesh,3,0,25,22
1657496462351,CSE 190,A00,092507,Dubnov; Shlomo,8,0,20,12
1657496468374,ECE 45,A01,083139,Congero; Spencer William,6,0,75,69
1657496474396,ECE 65,A50,083695,Saad; Andrew S,12,0,30,18
1657496474396,ECE 65,A51,095125,Saad; Andrew S,24,0,26,2
1657496480419,ECE 109,A01,091882,Touri; Behrouz,19,0,70,51
1657496486444,ECE 180,A00,083140,Abi Samra; Nicholas Camill,1,0,30,29
1657496486444,ECE 180,B00,083141,Abi Samra; Nicholas Camill,0,0,30,30
1657496492466,MATH 10A,A01,083735,Patchell; Gregory David,2,0,30,28
1657496492466,MATH 10A,A02,083736,Patchell; Gregory David,20,0,30,10
1657496492466,MATH 10A,A03,083737,Patchell; Gregory David,16,0,30,14
1657496498489,MATH 10B,A01,083207,Lim; Seonhee,8,0,34,26
1657496498489,MATH 10B,A02,083208,Lim; Seonhee,9,0,35,26
1657496498489,MATH 10B,A03,093472,Lim; Seonhee,7,0,34,27
1657496498489,MATH 10B,B01,083739,Sinha; Shubham,12,0,30,18
1657496504519,MATH 18,A01,083743,Cinel; Cameron Alexander,7,0,30,23
1657496504519,MATH 18,A02,083744,Cinel; Cameron Alexander,17,0,30,13
1657496504519,MATH 18,A03,083745,Cinel; Cameron Alexander,9,0,30,21
1657496504519,MATH 18,B01,083748,Rideout; David Porter,5,0,37,32
1657496504519,MATH 18,B02,083749,Rideout; David Porter,5,0,36,31
1657496504519,MATH 18,B03,083750,Rideout; David Porter,3,0,37,34
1657496504519,MATH 18,B04,083751,Rideout; David Porter,6,0,36,30
1657496504519,MATH 18,B05,093473,Rideout; David Porter,6,0,36,30
1657496504519,MATH 18,B06,093474,Rideout; David Porter,6,0,36,30
1657496510543,MATH 20A,A01,083754,Zheng; Zequn,14,0,40,26
1657496516569,MATH 20B,A01,083756,Briones; Jor-el Thomas Caparas,4,0,36,32
1657496516569,MATH 20B,A02,083757,Briones; Jor-el Thomas Caparas,1,0,36,35
1657496516569,MATH 20B,A03,093475,Briones; Jor-el Thomas Caparas,2,0,36,34
1657496522594,MATH 20C,A01,083760,Briones; Jor-el Thomas Caparas,1,0,35,34
1657496522594,MATH 20C,A02,083761,Briones; Jor-el Thomas Caparas,8,0,35,27
1657496522594,MATH 20C,A03,093476,Briones; Jor-el Thomas Caparas,0,1,36,36
1657496522594,MATH 20C,B01,083762,Bach; Quang Tran,1,0,30,29
1657496528622,MATH 20D,A01,083765,Tran; Brian Kha,5,0,30,25
1657496528622,MATH 20D,A02,083766,Tran; Brian Kha,5,0,30,25
1657496528622,MATH 20D,A03,083767,Tran; Brian Kha,5,0,30,25
1657496534654,MATH 20E,A01,083771,Ganguly; Soumya,9,0,32,23
1657496534654,MATH 20E,A02,083772,Ganguly; Soumya,6,0,32,26
1657496534654,MATH 20E,B01,083773,Ciotti; Benjamin,20,0,35,15
1657496534654,MATH 20E,B02,083774,Ciotti; Benjamin,17,0,35,18
1657496540684,MATH 103A,A01,083777,Greenfeld; Be'Eri,3,0,36,33
1657496540684,MATH 103A,A02,083778,Greenfeld; Be'Eri,5,0,36,31
1657496540684,MATH 103A,A03,093561,Greenfeld; Be'Eri,5,0,36,31
1657496540684,MATH 103A,B01,083779,Greenfeld; Be'Eri,7,0,36,29
1657496540684,MATH 103A,B02,083780,Greenfeld; Be'Eri,4,0,36,32
1657496540684,MATH 103A,B03,093562,Greenfeld; Be'Eri,3,0,36,33
1657496546709,MATH 105,A01,085443,Carter; Anne Toulson,15,0,35,20
1657496546709,MATH 105,A02,093477,Carter; Anne Toulson,20,0,35,15
1657496552731,MATH 109,A01,083213,Ganzberger; Geoffrey Michael,2,0,34,32
1657496552731,MATH 109,A02,083214,Ganzberger; Geoffrey Michael,4,0,34,30
1657496552731,MATH 109,A03,093478,Ganzberger; Geoffrey Michael,2,0,34,32
1657496552731,MATH 109,B01,083215,Ganzberger; Geoffrey Michael,1,0,32,31
1657496552731,MATH 109,B02,083216,Ganzberger; Geoffrey Michael,2,0,32,30
1657496552731,MATH 109,B03,093479,Ganzberger; Geoffrey Michael,8,0,32,24
1657496558760,MATH 142A,A01,083219,Chow; Bennett,7,0,32,25
1657496558760,MATH 142A,A02,083220,Chow; Bennett,10,0,32,22
1657496558760,MATH 142A,A03,093480,Chow; Bennett,8,0,32,24
1657496558760,MATH 142A,B03,093481,Chow; Bennett,8,0,32,24
1657496558760,MATH 142A,B04,093558,Chow; Bennett,13,0,32,19
1657496558760,MATH 142A,B05,093559,Chow; Bennett,6,0,32,26
1657496564783,MATH 193A,A01,083224,Rotar; Vladimir,8,0,34,26
1657496564783,MATH 193A,A02,083225,Rotar; Vladimir,9,0,34,25
1657496564783,MATH 193A,A03,083781,Rotar; Vladimir,5,0,34,29
1657496564783,MATH 193A,A04,083782,Rotar; Vladimir,10,0,34,24
1657496564783,MATH 193A,A05,093482,Rotar; Vladimir,10,0,34,24
1657496570808,MATH 197,001,091859,McAuley; Julian John,9999,0,9999,0
1657496570808,MATH 197,002,095566,Kedlaya; Kiran S.,9997,0,9999,2
1657496570808,MATH 197,003,095567,Xiao; Ming,9999,0,9999,0
1657496570808,MATH 197,004,095571,Perols; Johan Lars,9998,0,9999,1
1657496577945,COGS 9,A01,083615,Shannon; Kyle Michael,9,0,75,66
1657496583972,COGS 11,A01,083617,Boyle; Mary E. T.,22,0,48,26
1657496589994,COGS 13,A01,083071,Bastos; Amalia Pinkusfeld,11,0,71,60
1657496596032,COGS 14A,A01,092681,Semenuks; Arturs,5,1,100,95
1657496602057,COGS 14B,A01,083073,Cheng; Tzu-Han,6,0,63,57
1657496608079,COGS 17,A01,092677,Semenuks; Arturs,6,0,81,75
1657496614102,COGS 100,A01,083619,Allen; Michael Gordon,17,0,70,53
1657496620125,COGS 101A,A01,083621,Davis; Joshua Daniel,9,0,68,59
1657496626149,COGS 101B,A01,091572,Allen; Michael Gordon,12,0,65,53
1657496632173,COGS 101C,A01,083625,Delgado; Tania,17,0,35,18
1657496638202,COGS 107A,A01,083627,Boyle; Mary E. T.,13,0,60,47
1657496644240,COGS 118A,A01,083075,Gupta; Anjum,21,0,76,55
1657496650273,CSE 3,A50,083646,Miranda; Gregory Joseph,24,0,50,26
1657496656300,CSE 8A,A50,083650,Miranda; Gregory Joseph,17,1,56,39
1657496662323,CSE 11,A01,083080,Cao; Yingjun,6,15,40,34
1657496668351,CSE 12,A01,083652,Krause-Levy; Sophia Louisa,28,1,120,92
1657496674379,CSE 15L,A01,083654,Morris; Justin Loren,9,0,50,41
1657496674379,CSE 15L,A02,083655,Morris; Justin Loren,9,0,50,41
1657496680402,CSE 20,A01,083657,Tran; Khoa Dang,39,0,80,41
1657496686424,CSE 21,A01,095574,Bach; Quang Tran,22,0,48,26
1657496692452,CSE 30,A01,083084,Eldon; John,5,0,80,75
1657496692452,CSE 30,B01,095061,Bhaskar; Nishant,9,0,50,41
1657496698484,CSE 100,A01,083659,Cao; Yingjun,5,4,70,65
1657496704510,CSE 134B,A01,083661,Powell; Thomas Allan,22,0,100,78
1657496710537,CSE 140,A01,083663,Gungor; Onat,15,0,85,70
1657496716560,CSE 140L,A01,083088,Eldon; John,21,0,100,79
1657496722583,CSE 175,A01,083665,Kumar; Rakesh,3,0,25,22
1657496728607,CSE 190,A00,092507,Dubnov; Shlomo,8,0,20,12
1657496734631,ECE 45,A01,083139,Congero; Spencer William,6,0,75,69
1657496740656,ECE 65,A50,083695,Saad; Andrew S,12,0,30,18
1657496740656,ECE 65,A51,095125,Saad; Andrew S,24,0,26,2
1657496746688,ECE 109,A01,091882,Touri; Behrouz,19,0,70,51
1657496752722,ECE 180,A00,083140,Abi Samra; Nicholas Camill,1,0,30,29
1657496752722,ECE 180,B00,083141,Abi Samra; Nicholas Camill,0,0,30,30
1657496758746,MATH 10A,A01,083735,Patchell; Gregory David,2,0,30,28
1657496758746,MATH 10A,A02,083736,Patchell; Gregory David,20,0,30,10
1657496758746,MATH 10A,A03,083737,Patchell; Gregory David,16,0,30,14
1657496764774,MATH 10B,A01,083207,Lim; Seonhee,8,0,34,26
1657496764774,MATH 10B,A02,083208,Lim; Seonhee,9,0,35,26
1657496764774,MATH 10B,A03,093472,Lim; Seonhee,7,0,34,27
1657496764774,MATH 10B,B01,083739,Sinha; Shubham,12,0,30,18
1657496770808,MATH 18,A01,083743,Cinel; Cameron Alexander,7,0,30,23
1657496770808,MATH 18,A02,083744,Cinel; Cameron Alexander,17,0,30,13
1657496770808,MATH 18,A03,083745,Cinel; Cameron Alexander,9,0,30,21
1657496770808,MATH 18,B01,083748,Rideout; David Porter,5,0,37,32
1657496770808,MATH 18,B02,083749,Rideout; David Porter,5,0,36,31
1657496770808,MATH 18,B03,083750,Rideout; David Porter,3,0,37,34
1657496770808,MATH 18,B04,083751,Rideout; David Porter,6,0,36,30
1657496770808,MATH 18,B05,093473,Rideout; David Porter,6,0,36,30
1657496770808,MATH 18,B06,093474,Rideout; David Porter,6,0,36,30
1657496776834,MATH 20A,A01,083754,Zheng; Zequn,14,0,40,26
1657496782856,MATH 20B,A01,083756,Briones; Jor-el Thomas Caparas,4,0,36,32
1657496782856,MATH 20B,A02,083757,Briones; Jor-el Thomas Caparas,1,0,36,35
1657496782856,MATH 20B,A03,093475,Briones; Jor-el Thomas Caparas,2,0,36,34
1657496788881,MATH 20C,A01,083760,Briones; Jor-el Thomas Caparas,1,0,35,34
1657496788881,MATH 20C,A02,083761,Briones; Jor-el Thomas Caparas,8,0,35,27
1657496788881,MATH 20C,A03,093476,Briones; Jor-el Thomas Caparas,0,1,36,36
1657496788881,MATH 20C,B01,083762,Bach; Quang Tran,1,0,30,29
1657496794917,MATH 20D,A01,083765,Tran; Brian Kha,5,0,30,25
1657496794917,MATH 20D,A02,083766,Tran; Brian Kha,5,0,30,25
1657496794917,MATH 20D,A03,083767,Tran; Brian Kha,5,0,30,25
1657496800955,MATH 20E,A01,083771,Ganguly; Soumya,9,0,32,23
1657496800955,MATH 20E,A02,083772,Ganguly; Soumya,6,0,32,26
1657496800955,MATH 20E,B01,083773,Ciotti; Benjamin,20,0,35,15
1657496800955,MATH 20E,B02,083774,Ciotti; Benjamin,17,0,35,18
1657496806977,MATH 103A,A01,083777,Greenfeld; Be'Eri,3,0,36,33
1657496806977,MATH 103A,A02,083778,Greenfeld; Be'Eri,5,0,36,31
1657496806977,MATH 103A,A03,093561,Greenfeld; Be'Eri,5,0,36,31
1657496806977,MATH 103A,B01,083779,Greenfeld; Be'Eri,7,0,36,29
1657496806977,MATH 103A,B02,083780,Greenfeld; Be'Eri,4,0,36,32
1657496806977,MATH 103A,B03,093562,Greenfeld; Be'Eri,3,0,36,33
1657496813004,MATH 105,A01,085443,Carter; Anne Toulson,15,0,35,20
1657496813004,MATH 105,A02,093477,Carter; Anne Toulson,20,0,35,15
1657496819034,MATH 109,A01,083213,Ganzberger; Geoffrey Michael,2,0,34,32
1657496819034,MATH 109,A02,083214,Ganzberger; Geoffrey Michael,4,0,34,30
1657496819034,MATH 109,A03,093478,Ganzberger; Geoffrey Michael,2,0,34,32
1657496819034,MATH 109,B01,083215,Ganzberger; Geoffrey Michael,1,0,32,31
1657496819034,MATH 109,B02,083216,Ganzberger; Geoffrey Michael,2,0,32,30
1657496819034,MATH 109,B03,093479,Ganzberger; Geoffrey Michael,8,0,32,24
1657496825064,MATH 142A,A01,083219,Chow; Bennett,7,0,32,25
1657496825064,MATH 142A,A02,083220,Chow; Bennett,10,0,32,22
1657496825064,MATH 142A,A03,093480,Chow; Bennett,8,0,32,24
1657496825064,MATH 142A,B03,093481,Chow; Bennett,8,0,32,24
1657496825064,MATH 142A,B04,093558,Chow; Bennett,13,0,32,19
1657496825064,MATH 142A,B05,093559,Chow; Bennett,6,0,32,26
1657496831090,MATH 193A,A01,083224,Rotar; Vladimir,8,0,34,26
1657496831090,MATH 193A,A02,083225,Rotar; Vladimir,9,0,34,25
1657496831090,MATH 193A,A03,083781,Rotar; Vladimir,5,0,34,29
1657496831090,MATH 193A,A04,083782,Rotar; Vladimir,10,0,34,24
1657496831090,MATH 193A,A05,093482,Rotar; Vladimir,10,0,34,24
1657496837116,MATH 197,001,091859,McAuley; Julian John,9999,0,9999,0
1657496837116,MATH 197,002,095566,Kedlaya; Kiran S.,9997,0,9999,2
1657496837116,MATH 197,003,095567,Xiao; Ming,9999,0,9999,0
1657496837116,MATH 197,004,095571,Perols; Johan Lars,9998,0,9999,1
1657496844185,COGS 9,A01,083615,Shannon; Kyle Michael,9,0,75,66
1657496850219,COGS 11,A01,083617,Boyle; Mary E. T.,22,0,48,26
1657496856243,COGS 13,A01,083071,Bastos; Amalia Pinkusfeld,11,0,71,60
1657496862266,COGS 14A,A01,092681,Semenuks; Arturs,5,1,100,95
1657496868294,COGS 14B,A01,083073,Cheng; Tzu-Han,6,0,63,57
1657496874317,COGS 17,A01,092677,Semenuks; Arturs,6,0,81,75
1657496880345,COGS 100,A01,083619,Allen; Michael Gordon,17,0,70,53
1657496886373,COGS 101A,A01,083621,Davis; Joshua Daniel,9,0,68,59
1657496892396,COGS 101B,A01,091572,Allen; Michael Gordon,12,0,65,53
1657496898421,COGS 101C,A01,083625,Delgado; Tania,17,0,35,18
1657496904449,COGS 107A,A01,083627,Boyle; Mary E. T.,13,0,60,47
1657496910470,COGS 118A,A01,083075,Gupta; Anjum,21,0,76,55
1657496916497,CSE 3,A50,083646,Miranda; Gregory Joseph,24,0,50,26
1657496922521,CSE 8A,A50,083650,Miranda; Gregory Joseph,17,1,56,39
1657496928547,CSE 11,A01,083080,Cao; Yingjun,6,15,40,34
1657496934573,CSE 12,A01,083652,Krause-Levy; Sophia Louisa,28,1,120,92
1657496940608,CSE 15L,A01,083654,Morris; Justin Loren,9,0,50,41
1657496940608,CSE 15L,A02,083655,Morris; Justin Loren,9,0,50,41
1657496946633,CSE 20,A01,083657,Tran; Khoa Dang,39,0,80,41
1657496952656,CSE 21,A01,095574,Bach; Quang Tran,22,0,48,26
1657496958683,CSE 30,A01,083084,Eldon; John,5,0,80,75
1657496958683,CSE 30,B01,095061,Bhaskar; Nishant,9,0,50,41
1657496964712,CSE 100,A01,083659,Cao; Yingjun,5,4,70,65
1657496970742,CSE 134B,A01,083661,Powell; Thomas Allan,22,0,100,78
1657496976765,CSE 140,A01,083663,Gungor; Onat,15,0,85,70
1657496982789,CSE 140L,A01,083088,Eldon; John,21,0,100,79
1657496988812,CSE 175,A01,083665,Kumar; Rakesh,3,0,25,22
1657496994836,CSE 190,A00,092507,Dubnov; Shlomo,8,0,20,12
1657497000860,ECE 45,A01,083139,Congero; Spencer William,6,0,75,69
1657497006882,ECE 65,A50,083695,Saad; Andrew S,12,0,30,18
1657497006882,ECE 65,A51,095125,Saad; Andrew S,24,0,26,2
1657497012905,ECE 109,A01,091882,Touri; Behrouz,19,0,70,51
1657497018931,ECE 180,A00,083140,Abi Samra; Nicholas Camill,1,0,30,29
1657497018931,ECE 180,B00,083141,Abi Samra; Nicholas Camill,0,0,30,30
1657497024956,MATH 10A,A01,083735,Patchell; Gregory David,2,0,30,28
1657497024956,MATH 10A,A02,083736,Patchell; Gregory David,20,0,30,10
1657497024956,MATH 10A,A03,083737,Patchell; Gregory David,16,0,30,14
1657497030981,MATH 10B,A01,083207,Lim; Seonhee,8,0,34,26
1657497030981,MATH 10B,A02,083208,Lim; Seonhee,9,0,35,26
1657497030981,MATH 10B,A03,093472,Lim; Seonhee,7,0,34,27
1657497030981,MATH 10B,B01,083739,Sinha; Shubham,12,0,30,18
1657497037009,MATH 18,A01,083743,Cinel; Cameron Alexander,7,0,30,23
1657497037009,MATH 18,A02,083744,Cinel; Cameron Alexander,17,0,30,13
1657497037009,MATH 18,A03,083745,Cinel; Cameron Alexander,9,0,30,21
1657497037009,MATH 18,B01,083748,Rideout; David Porter,5,0,37,32
1657497037009,MATH 18,B02,083749,Rideout; David Porter,5,0,36,31
1657497037009,MATH 18,B03,083750,Rideout; David Porter,3,0,37,34
1657497037009,MATH 18,B04,083751,Rideout; David Porter,6,0,36,30
1657497037009,MATH 18,B05,093473,Rideout; David Porter,6,0,36,30
1657497037009,MATH 18,B06,093474,Rideout; David Porter,6,0,36,30
1657497043033,MATH 20A,A01,083754,Zheng; Zequn,14,0,40,26
1657497049061,MATH 20B,A01,083756,Briones; Jor-el Thomas Caparas,4,0,36,32
1657497049061,MATH 20B,A02,083757,Briones; Jor-el Thomas Caparas,1,0,36,35
1657497049061,MATH 20B,A03,093475,Briones; Jor-el Thomas Caparas,2,0,36,34
1657497055089,MATH 20C,A01,083760,Briones; Jor-el Thomas Caparas,1,0,35,34
1657497055089,MATH 20C,A02,083761,Briones; Jor-el Thomas Caparas,8,0,35,27
1657497055089,MATH 20C,A03,093476,Briones; Jor-el Thomas Caparas,0,1,36,36
1657497055089,MATH 20C,B01,083762,Bach; Quang Tran,1,0,30,29
1657497061117,MATH 20D,A01,083765,Tran; Brian Kha,5,0,30,25
1657497061117,MATH 20D,A02,083766,Tran; Brian Kha,5,0,30,25
1657497061117,MATH 20D,A03,083767,Tran; Brian Kha,5,0,30,25
1657497067144,MATH 20E,A01,083771,Ganguly; Soumya,9,0,32,23
1657497067144,MATH 20E,A02,083772,Ganguly; Soumya,6,0,32,26
1657497067144,MATH 20E,B01,083773,Ciotti; Benjamin,20,0,35,15
1657497067144,MATH 20E,B02,083774,Ciotti; Benjamin,17,0,35,18
1657497073169,MATH 103A,A01,083777,Greenfeld; Be'Eri,3,0,36,33
1657497073169,MATH 103A,A02,083778,Greenfeld; Be'Eri,5,0,36,31
1657497073169,MATH 103A,A03,093561,Greenfeld; Be'Eri,5,0,36,31
1657497073169,MATH 103A,B01,083779,Greenfeld; Be'Eri,7,0,36,29
1657497073169,MATH 103A,B02,083780,Greenfeld; Be'Eri,4,0,36,32
1657497073169,MATH 103A,B03,093562,Greenfeld; Be'Eri,3,0,36,33
1657497079192,MATH 105,A01,085443,Carter; Anne Toulson,15,0,35,20
1657497079192,MATH 105,A02,093477,Carter; Anne Toulson,20,0,35,15
1657497085222,MATH 109,A01,083213,Ganzberger; Geoffrey Michael,2,0,34,32
1657497085222,MATH 109,A02,083214,Ganzberger; Geoffrey Michael,4,0,34,30
1657497085222,MATH 109,A03,093478,Ganzberger; Geoffrey Michael,2,0,34,32
1657497085222,MATH 109,B01,083215,Ganzberger; Geoffrey Michael,1,0,32,31
1657497085222,MATH 109,B02,083216,Ganzberger; Geoffrey Michael,2,0,32,30
1657497085222,MATH 109,B03,093479,Ganzberger; Geoffrey Michael,8,0,32,24
1657497091249,MATH 142A,A01,083219,Chow; Bennett,7,0,32,25
1657497091249,MATH 142A,A02,083220,Chow; Bennett,10,0,32,22
1657497091249,MATH 142A,A03,093480,Chow; Bennett,8,0,32,24
1657497091249,MATH 142A,B03,093481,Chow; Bennett,8,0,32,24
1657497091249,MATH 142A,B04,093558,Chow; Bennett,13,0,32,19
1657497091249,MATH 142A,B05,093559,Chow; Bennett,6,0,32,26
1657497097272,MATH 193A,A01,083224,Rotar; Vladimir,8,0,34,26
1657497097272,MATH 193A,A02,083225,Rotar; Vladimir,9,0,34,25
1657497097272,MATH 193A,A03,083781,Rotar; Vladimir,5,0,34,29
1657497097272,MATH 193A,A04,083782,Rotar; Vladimir,10,0,34,24
1657497097272,MATH 193A,A05,093482,Rotar; Vladimir,10,0,34,24
1657497103299,MATH 197,001,091859,McAuley; Julian John,9999,0,9999,0
1657497103299,MATH 197,002,095566,Kedlaya; Kiran S.,9997,0,9999,2
1657497103299,MATH 197,003,095567,Xiao; Ming,9999,0,9999,0
1657497103299,MATH 197,004,095571,Perols; Johan Lars,9998,0,9999,1
1657497110370,COGS 9,A01,083615,Shannon; Kyle Michael,9,0,75,66
1657497116394,COGS 11,A01,083617,Boyle; Mary E. T.,22,0,48,26
1657497122422,COGS 13,A01,083071,Bastos; Amalia Pinkusfeld,11,0,71,60
1657497128448,COGS 14A,A01,092681,Semenuks; Arturs,5,1,100,95
1657497134474,COGS 14B,A01,083073,Cheng; Tzu-Han,6,0,63,57
1657497140496,COGS 17,A01,092677,Semenuks; Arturs,6,0,81,75
1657497146523,COGS 100,A01,083619,Allen; Michael Gordon,17,0,70,53
1657497152549,COGS 101A,A01,083621,Davis; Joshua Daniel,9,0,68,59
1657497158577,COGS 101B,A01,091572,Allen; Michael Gordon,12,0,65,53
1657497164610,COGS 101C,A01,083625,Delgado; Tania,17,0,35,18
1657497170634,COGS 107A,A01,083627,Boyle; Mary E. T.,13,0,60,47
1657497176732,COGS 118A,A01,083075,Gupta; Anjum,21,0,76,55
1657497182756,CSE 3,A50,083646,Miranda; Gregory Joseph,24,0,50,26
1657497188789,CSE 8A,A50,083650,Miranda; Gregory Joseph,17,1,56,39
1657497194844,CSE 11,A01,083080,Cao; Yingjun,6,15,40,34
1657497200875,CSE 12,A01,083652,Krause-Levy; Sophia Louisa,28,1,120,92
1657497206897,CSE 15L,A01,083654,Morris; Justin Loren,9,0,50,41
1657497206897,CSE 15L,A02,083655,Morris; Justin Loren,9,0,50,41
1657497212920,CSE 20,A01,083657,Tran; Khoa Dang,39,0,80,41
1657497218943,CSE 21,A01,095574,Bach; Quang Tran,22,0,48,26
1657497224967,CSE 30,A01,083084,Eldon; John,5,0,80,75
1657497224967,CSE 30,B01,095061,Bhaskar; Nishant,9,0,50,41
1657497230993,CSE 100,A01,083659,Cao; Yingjun,5,4,70,65
1657497237017,CSE 134B,A01,083661,Powell; Thomas Allan,22,0,100,78
1657497243041,CSE 140,A01,083663,Gungor; Onat,15,0,85,70
1657497249068,CSE 140L,A01,083088,Eldon; John,21,0,100,79
1657497255097,CSE 175,A01,083665,Kumar; Rakesh,3,0,25,22
1657497261129,CSE 190,A00,092507,Dubnov; Shlomo,8,0,20,12
1657497267152,ECE 45,A01,083139,Congero; Spencer William,6,0,75,69
1657497273180,ECE 65,A50,083695,Saad; Andrew S,12,0,30,18
1657497273180,ECE 65,A51,095125,Saad; Andrew S,24,0,26,2
1657497279202,ECE 109,A01,091882,Touri; Behrouz,19,0,70,51
1657497285229,ECE 180,A00,083140,Abi Samra; Nicholas Camill,1,0,30,29
1657497285229,ECE 180,B00,083141,Abi Samra; Nicholas Camill,0,0,30,30
1657497291257,MATH 10A,A01,083735,Patchell; Gregory David,2,0,30,28
1657497291257,MATH 10A,A02,083736,Patchell; Gregory David,20,0,30,10
1657497291257,MATH 10A,A03,083737,Patchell; Gregory David,16,0,30,14
1657497297282,MATH 10B,A01,083207,Lim; Seonhee,8,0,34,26
1657497297282,MATH 10B,A02,083208,Lim; Seonhee,9,0,35,26
1657497297282,MATH 10B,A03,093472,Lim; Seonhee,7,0,34,27
1657497297282,MATH 10B,B01,083739,Sinha; Shubham,12,0,30,18
1657497303314,MATH 18,A01,083743,Cinel; Cameron Alexander,7,0,30,23
1657497303314,MATH 18,A02,083744,Cinel; Cameron Alexander,17,0,30,13
1657497303314,MATH 18,A03,083745,Cinel; Cameron Alexander,9,0,30,21
1657497303314,MATH 18,B01,083748,Rideout; David Porter,5,0,37,32
1657497303314,MATH 18,B02,083749,Rideout; David Porter,5,0,36,31
1657497303314,MATH 18,B03,083750,Rideout; David Porter,3,0,37,34
1657497303314,MATH 18,B04,083751,Rideout; David Porter,6,0,36,30
1657497303314,MATH 18,B05,093473,Rideout; David Porter,6,0,36,30
1657497303314,MATH 18,B06,093474,Rideout; David Porter,6,0,36,30
1657497309335,MATH 20A,A01,083754,Zheng; Zequn,14,0,40,26
1657497315359,MATH 20B,A01,083756,Briones; Jor-el Thomas Caparas,4,0,36,32
1657497315359,MATH 20B,A02,083757,Briones; Jor-el Thomas Caparas,1,0,36,35
1657497315359,MATH 20B,A03,093475,Briones; Jor-el Thomas Caparas,2,0,36,34
1657497321388,MATH 20C,A01,083760,Briones; Jor-el Thomas Caparas,1,0,35,34
1657497321388,MATH 20C,A02,083761,Briones; Jor-el Thomas Caparas,8,0,35,27
1657497321388,MATH 20C,A03,093476,Briones; Jor-el Thomas Caparas,0,1,36,36
1657497321388,MATH 20C,B01,083762,Bach; Quang Tran,1,0,30,29
1657497327423,MATH 20D,A01,083765,Tran; Brian Kha,5,0,30,25
1657497327423,MATH 20D,A02,083766,Tran; Brian Kha,5,0,30,25
1657497327423,MATH 20D,A03,083767,Tran; Brian Kha,5,0,30,25
1657497333451,MATH 20E,A01,083771,Ganguly; Soumya,9,0,32,23
1657497333451,MATH 20E,A02,083772,Ganguly; Soumya,6,0,32,26
1657497333451,MATH 20E,B01,083773,Ciotti; Benjamin,20,0,35,15
1657497333451,MATH 20E,B02,083774,Ciotti; Benjamin,17,0,35,18
1657497339480,MATH 103A,A01,083777,Greenfeld; Be'Eri,3,0,36,33
1657497339480,MATH 103A,A02,083778,Greenfeld; Be'Eri,5,0,36,31
1657497339480,MATH 103A,A03,093561,Greenfeld; Be'Eri,5,0,36,31
1657497339480,MATH 103A,B01,083779,Greenfeld; Be'Eri,7,0,36,29
1657497339480,MATH 103A,B02,083780,Greenfeld; Be'Eri,4,0,36,32
1657497339480,MATH 103A,B03,093562,Greenfeld; Be'Eri,3,0,36,33
1657497345502,MATH 105,A01,085443,Carter; Anne Toulson,15,0,35,20
1657497345502,MATH 105,A02,093477,Carter; Anne Toulson,20,0,35,15
1657497351527,MATH 109,A01,083213,Ganzberger; Geoffrey Michael,2,0,34,32
1657497351527,MATH 109,A02,083214,Ganzberger; Geoffrey Michael,4,0,34,30
1657497351527,MATH 109,A03,093478,Ganzberger; Geoffrey Michael,2,0,34,32
1657497351527,MATH 109,B01,083215,Ganzberger; Geoffrey Michael,1,0,32,31
1657497351527,MATH 109,B02,083216,Ganzberger; Geoffrey Michael,2,0,32,30
1657497351527,MATH 109,B03,093479,Ganzberger; Geoffrey Michael,8,0,32,24
1657497357554,MATH 142A,A01,083219,Chow; Bennett,7,0,32,25
1657497357554,MATH 142A,A02,083220,Chow; Bennett,10,0,32,22
1657497357554,MATH 142A,A03,093480,Chow; Bennett,8,0,32,24
1657497357554,MATH 142A,B03,093481,Chow; Bennett,8,0,32,24
1657497357554,MATH 142A,B04,093558,Chow; Bennett,13,0,32,19
1657497357554,MATH 142A,B05,093559,Chow; Bennett,6,0,32,26
1657497363578,MATH 193A,A01,083224,Rotar; Vladimir,8,0,34,26
1657497363578,MATH 193A,A02,083225,Rotar; Vladimir,9,0,34,25
1657497363578,MATH 193A,A03,083781,Rotar; Vladimir,5,0,34,29
1657497363578,MATH 193A,A04,083782,Rotar; Vladimir,10,0,34,24
1657497363578,MATH 193A,A05,093482,Rotar; Vladimir,10,0,34,24
1657497369599,MATH 197,001,091859,McAuley; Julian John,9999,0,9999,0
1657497369599,MATH 197,002,095566,Kedlaya; Kiran S.,9997,0,9999,2
1657497369599,MATH 197,003,095567,Xiao; Ming,9999,0,9999,0
1657497369599,MATH 197,004,095571,Perols; Johan Lars,9998,0,9999,1
1657497376649,COGS 9,A01,083615,Shannon; Kyle Michael,9,0,75,66
1657497382676,COGS 11,A01,083617,Boyle; Mary E. T.,22,0,48,26
1657497388702,COGS 13,A01,083071,Bastos; Amalia Pinkusfeld,11,0,71,60
1657497394725,COGS 14A,A01,092681,Semenuks; Arturs,5,1,100,95
1657497400747,COGS 14B,A01,083073,Cheng; Tzu-Han,6,0,63,57
1657497406770,COGS 17,A01,092677,Semenuks; Arturs,6,0,81,75
1657497412793,COGS 100,A01,083619,Allen; Michael Gordon,17,0,70,53
1657497418823,COGS 101A,A01,083621,Davis; Joshua Daniel,9,0,68,59
1657497424856,COGS 101B,A01,091572,Allen; Michael Gordon,12,0,65,53
1657497430880,COGS 101C,A01,083625,Delgado; Tania,17,0,35,18
1657497436907,COGS 107A,A01,083627,Boyle; Mary E. T.,13,0,60,47
1657497442934,COGS 118A,A01,083075,Gupta; Anjum,21,0,76,55
1657497448956,CSE 3,A50,083646,Miranda; Gregory Joseph,24,0,50,26
1657497454980,CSE 8A,A50,083650,Miranda; Gregory Joseph,17,1,56,39
1657497461003,CSE 11,A01,083080,Cao; Yingjun,6,15,40,34
1657497467033,CSE 12,A01,083652,Krause-Levy; Sophia Louisa,28,1,120,92
1657497473060,CSE 15L,A01,083654,Morris; Justin Loren,9,0,50,41
1657497473060,CSE 15L,A02,083655,Morris; Justin Loren,9,0,50,41
1657497479086,CSE 20,A01,083657,Tran; Khoa Dang,39,0,80,41
1657497485113,CSE 21,A01,095574,Bach; Quang Tran,22,0,48,26
1657497491137,CSE 30,A01,083084,Eldon; John,5,0,80,75
1657497491137,CSE 30,B01,095061,Bhaskar; Nishant,9,0,50,41
1657497497159,CSE 100,A01,083659,Cao; Yingjun,5,4,70,65
1657497503187,CSE 134B,A01,083661,Powell; Thomas Allan,22,0,100,78
1657497509209,CSE 140,A01,083663,Gungor; Onat,15,0,85,70
1657497515248,CSE 140L,A01,083088,Eldon; John,21,0,100,79
1657497521273,CSE 175,A01,083665,Kumar; Rakesh,3,0,25,22
1657497527299,CSE 190,A00,092507,Dubnov; Shlomo,8,0,20,12
1657497533322,ECE 45,A01,083139,Congero; Spencer William,6,0,75,69
1657497539355,ECE 65,A50,083695,Saad; Andrew S,12,0,30,18
1657497539355,ECE 65,A51,095125,Saad; Andrew S,24,0,26,2
1657497545378,ECE 109,A01,091882,Touri; Behrouz,19,0,70,51
1657497551402,ECE 180,A00,083140,Abi Samra; Nicholas Camill,1,0,30,29
1657497551402,ECE 180,B00,083141,Abi Samra; Nicholas Camill,0,0,30,30
1657497557430,MATH 10A,A01,083735,Patchell; Gregory David,2,0,30,28
1657497557430,MATH 10A,A02,083736,Patchell; Gregory David,20,0,30,10
1657497557430,MATH 10A,A03,083737,Patchell; Gregory David,16,0,30,14
1657497563459,MATH 10B,A01,083207,Lim; Seonhee,8,0,34,26
1657497563459,MATH 10B,A02,083208,Lim; Seonhee,9,0,35,26
1657497563459,MATH 10B,A03,093472,Lim; Seonhee,7,0,34,27
1657497563459,MATH 10B,B01,083739,Sinha; Shubham,12,0,30,18
1657497569490,MATH 18,A01,083743,Cinel; Cameron Alexander,7,0,30,23
1657497569490,MATH 18,A02,083744,Cinel; Cameron Alexander,17,0,30,13
1657497569490,MATH 18,A03,083745,Cinel; Cameron Alexander,9,0,30,21
1657497569490,MATH 18,B01,083748,Rideout; David Porter,5,0,37,32
1657497569490,MATH 18,B02,083749,Rideout; David Porter,5,0,36,31
1657497569490,MATH 18,B03,083750,Rideout; David Porter,3,0,37,34
1657497569490,MATH 18,B04,083751,Rideout; David Porter,6,0,36,30
1657497569490,MATH 18,B05,093473,Rideout; David Porter,6,0,36,30
1657497569490,MATH 18,B06,093474,Rideout; David Porter,6,0,36,30
1657497575512,MATH 20A,A01,083754,Zheng; Zequn,14,0,40,26
1657497581533,MATH 20B,A01,083756,Briones; Jor-el Thomas Caparas,4,0,36,32
1657497581533,MATH 20B,A02,083757,Briones; Jor-el Thomas Caparas,1,0,36,35
1657497581533,MATH 20B,A03,093475,Briones; Jor-el Thomas Caparas,2,0,36,34
1657497587563,MATH 20C,A01,083760,Briones; Jor-el Thomas Caparas,1,0,35,34
1657497587563,MATH 20C,A02,083761,Briones; Jor-el Thomas Caparas,8,0,35,27
1657497587563,MATH 20C,A03,093476,Briones; Jor-el Thomas Caparas,0,1,36,36
1657497587563,MATH 20C,B01,083762,Bach; Quang Tran,1,0,30,29
1657497593591,MATH 20D,A01,083765,Tran; Brian Kha,5,0,30,25
1657497593591,MATH 20D,A02,083766,Tran; Brian Kha,5,0,30,25
1657497593591,MATH 20D,A03,083767,Tran; Brian Kha,5,0,30,25
1657497599618,MATH 20E,A01,083771,Ganguly; Soumya,9,0,32,23
1657497599618,MATH 20E,A02,083772,Ganguly; Soumya,6,0,32,26
1657497599618,MATH 20E,B01,083773,Ciotti; Benjamin,20,0,35,15
1657497599618,MATH 20E,B02,083774,Ciotti; Benjamin,17,0,35,18
1657497605650,MATH 103A,A01,083777,Greenfeld; Be'Eri,3,0,36,33
1657497605650,MATH 103A,A02,083778,Greenfeld; Be'Eri,5,0,36,31
1657497605650,MATH 103A,A03,093561,Greenfeld; Be'Eri,5,0,36,31
1657497605650,MATH 103A,B01,083779,Greenfeld; Be'Eri,7,0,36,29
1657497605650,MATH 103A,B02,083780,Greenfeld; Be'Eri,4,0,36,32
1657497605650,MATH 103A,B03,093562,Greenfeld; Be'Eri,3,0,36,33
1657497611676,MATH 105,A01,085443,Carter; Anne Toulson,15,0,35,20
1657497611676,MATH 105,A02,093477,Carter; Anne Toulson,20,0,35,15
1657497617699,MATH 109,A01,083213,Ganzberger; Geoffrey Michael,2,0,34,32
1657497617699,MATH 109,A02,083214,Ganzberger; Geoffrey Michael,4,0,34,30
1657497617699,MATH 109,A03,093478,Ganzberger; Geoffrey Michael,2,0,34,32
1657497617699,MATH 109,B01,083215,Ganzberger; Geoffrey Michael,1,0,32,31
1657497617699,MATH 109,B02,083216,Ganzberger; Geoffrey Michael,2,0,32,30
1657497617699,MATH 109,B03,093479,Ganzberger; Geoffrey Michael,8,0,32,24
1657497623721,MATH 142A,A01,083219,Chow; Bennett,7,0,32,25
1657497623721,MATH 142A,A02,083220,Chow; Bennett,10,0,32,22
1657497623721,MATH 142A,A03,093480,Chow; Bennett,8,0,32,24
1657497623721,MATH 142A,B03,093481,Chow; Bennett,8,0,32,24
1657497623721,MATH 142A,B04,093558,Chow; Bennett,13,0,32,19
1657497623721,MATH 142A,B05,093559,Chow; Bennett,6,0,32,26
1657497629742,MATH 193A,A01,083224,Rotar; Vladimir,8,0,34,26
1657497629742,MATH 193A,A02,083225,Rotar; Vladimir,9,0,34,25
1657497629742,MATH 193A,A03,083781,Rotar; Vladimir,5,0,34,29
1657497629742,MATH 193A,A04,083782,Rotar; Vladimir,10,0,34,24
1657497629742,MATH 193A,A05,093482,Rotar; Vladimir,10,0,34,24
1657497635767,MATH 197,001,091859,McAuley; Julian John,9999,0,9999,0
1657497635767,MATH 197,002,095566,Kedlaya; Kiran S.,9997,0,9999,2
1657497635767,MATH 197,003,095567,Xiao; Ming,9999,0,9999,0
1657497635767,MATH 197,004,095571,Perols; Johan Lars,9998,0,9999,1
1657497642821,COGS 9,A01,083615,Shannon; Kyle Michael,9,0,75,66
1657497648876,COGS 11,A01,083617,Boyle; Mary E. T.,22,0,48,26
1657497654898,COGS 13,A01,083071,Bastos; Amalia Pinkusfeld,11,0,71,60
1657497660924,COGS 14A,A01,092681,Semenuks; Arturs,5,1,100,95
1657497666955,COGS 14B,A01,083073,Cheng; Tzu-Han,6,0,63,57
1657497672980,COGS 17,A01,092677,Semenuks; Arturs,6,0,81,75
1657497679006,COGS 100,A01,083619,Allen; Michael Gordon,17,0,70,53
1657497685033,COGS 101A,A01,083621,Davis; Joshua Daniel,9,0,68,59
1657497691061,COGS 101B,A01,091572,Allen; Michael Gordon,12,0,65,53
1657497697087,COGS 101C,A01,083625,Delgado; Tania,17,0,35,18
1657497703116,COGS 107A,A01,083627,Boyle; Mary E. T.,13,0,60,47
1657497709138,COGS 118A,A01,083075,Gupta; Anjum,21,0,76,55
1657497715161,CSE 3,A50,083646,Miranda; Gregory Joseph,24,0,50,26
1657497721189,CSE 8A,A50,083650,Miranda; Gregory Joseph,17,1,56,39
1657497727214,CSE 11,A01,083080,Cao; Yingjun,6,15,40,34
1657497733240,CSE 12,A01,083652,Krause-Levy; Sophia Louisa,28,1,120,92
1657497739265,CSE 15L,A01,083654,Morris; Justin Loren,9,0,50,41
1657497739265,CSE 15L,A02,083655,Morris; Justin Loren,9,0,50,41
1657497745292,CSE 20,A01,083657,Tran; Khoa Dang,39,0,80,41
1657497751319,CSE 21,A01,095574,Bach; Quang Tran,22,0,48,26
1657497757347,CSE 30,A01,083084,Eldon; John,5,0,80,75
1657497757347,CSE 30,B01,095061,Bhaskar; Nishant,9,0,50,41
1657497763376,CSE 100,A01,083659,Cao; Yingjun,5,4,70,65
1657497769400,CSE 134B,A01,083661,Powell; Thomas Allan,22,0,100,78
1657497775497,CSE 140,A01,083663,Gungor; Onat,15,0,85,70
1657497781518,CSE 140L,A01,083088,Eldon; John,21,0,100,79
1657497787541,CSE 175,A01,083665,Kumar; Rakesh,3,0,25,22
1657497793563,CSE 190,A00,092507,Dubnov; Shlomo,8,0,20,12
1657497799590,ECE 45,A01,083139,Congero; Spencer William,6,0,75,69
1657497805614,ECE 65,A50,083695,Saad; Andrew S,12,0,30,18
1657497805614,ECE 65,A51,095125,Saad; Andrew S,24,0,26,2
1657497811646,ECE 109,A01,091882,Touri; Behrouz,19,0,70,51
1657497817669,ECE 180,A00,083140,Abi Samra; Nicholas Camill,1,0,30,29
1657497817669,ECE 180,B00,083141,Abi Samra; Nicholas Camill,0,0,30,30
1657497823692,MATH 10A,A01,083735,Patchell; Gregory David,2,0,30,28
1657497823692,MATH 10A,A02,083736,Patchell; Gregory David,20,0,30,10
1657497823692,MATH 10A,A03,083737,Patchell; Gregory David,16,0,30,14
1657497829716,MATH 10B,A01,083207,Lim; Seonhee,8,0,34,26
1657497829716,MATH 10B,A02,083208,Lim; Seonhee,9,0,35,26
1657497829716,MATH 10B,A03,093472,Lim; Seonhee,7,0,34,27
1657497829716,MATH 10B,B01,083739,Sinha; Shubham,12,0,30,18
1657497835743,MATH 18,A01,083743,Cinel; Cameron Alexander,7,0,30,23
1657497835743,MATH 18,A02,083744,Cinel; Cameron Alexander,17,0,30,13
1657497835743,MATH 18,A03,083745,Cinel; Cameron Alexander,9,0,30,21
1657497835743,MATH 18,B01,083748,Rideout; David Porter,5,0,37,32
1657497835743,MATH 18,B02,083749,Rideout; David Porter,5,0,36,31
1657497835743,MATH 18,B03,083750,Rideout; David Porter,3,0,37,34
1657497835743,MATH 18,B04,083751,Rideout; David Porter,6,0,36,30
1657497835743,MATH 18,B05,093473,Rideout; David Porter,6,0,36,30
1657497835743,MATH 18,B06,093474,Rideout; David Porter,6,0,36,30
1657497841764,MATH 20A,A01,083754,Zheng; Zequn,14,0,40,26
1657497847791,MATH 20B,A01,083756,Briones; Jor-el Thomas Caparas,4,0,36,32
1657497847791,MATH 20B,A02,083757,Briones; Jor-el Thomas Caparas,1,0,36,35
1657497847791,MATH 20B,A03,093475,Briones; Jor-el Thomas Caparas,2,0,36,34
1657497853813,MATH 20C,A01,083760,Briones; Jor-el Thomas Caparas,1,0,35,34
1657497853813,MATH 20C,A02,083761,Briones; Jor-el Thomas Caparas,8,0,35,27
1657497853813,MATH 20C,A03,093476,Briones; Jor-el Thomas Caparas,0,1,36,36
1657497853813,MATH 20C,B01,083762,Bach; Quang Tran,1,0,30,29
1657497859836,MATH 20D,A01,083765,Tran; Brian Kha,5,0,30,25
1657497859836,MATH 20D,A02,083766,Tran; Brian Kha,5,0,30,25
1657497859836,MATH 20D,A03,083767,Tran; Brian Kha,5,0,30,25
1657497865859,MATH 20E,A01,083771,Ganguly; Soumya,9,0,32,23
1657497865859,MATH 20E,A02,083772,Ganguly; Soumya,6,0,32,26
1657497865859,MATH 20E,B01,083773,Ciotti; Benjamin,20,0,35,15
1657497865859,MATH 20E,B02,083774,Ciotti; Benjamin,17,0,35,18
1657497871882,MATH 103A,A01,083777,Greenfeld; Be'Eri,3,0,36,33
1657497871882,MATH 103A,A02,083778,Greenfeld; Be'Eri,5,0,36,31
1657497871882,MATH 103A,A03,093561,Greenfeld; Be'Eri,5,0,36,31
1657497871882,MATH 103A,B01,083779,Greenfeld; Be'Eri,7,0,36,29
1657497871882,MATH 103A,B02,083780,Greenfeld; Be'Eri,4,0,36,32
1657497871882,MATH 103A,B03,093562,Greenfeld; Be'Eri,3,0,36,33
1657497877908,MATH 105,A01,085443,Carter; Anne Toulson,15,0,35,20
1657497877908,MATH 105,A02,093477,Carter; Anne Toulson,20,0,35,15
1657497883930,MATH 109,A01,083213,Ganzberger; Geoffrey Michael,2,0,34,32
1657497883930,MATH 109,A02,083214,Ganzberger; Geoffrey Michael,4,0,34,30
1657497883930,MATH 109,A03,093478,Ganzberger; Geoffrey Michael,2,0,34,32
1657497883930,MATH 109,B01,083215,Ganzberger; Geoffrey Michael,1,0,32,31
1657497883930,MATH 109,B02,083216,Ganzberger; Geoffrey Michael,2,0,32,30
1657497883930,MATH 109,B03,093479,Ganzberger; Geoffrey Michael,8,0,32,24
1657497889953,MATH 142A,A01,083219,Chow; Bennett,7,0,32,25
1657497889953,MATH 142A,A02,083220,Chow; Bennett,10,0,32,22
1657497889953,MATH 142A,A03,093480,Chow; Bennett,8,0,32,24
1657497889953,MATH 142A,B03,093481,Chow; Bennett,8,0,32,24
1657497889953,MATH 142A,B04,093558,Chow; Bennett,13,0,32,19
1657497889953,MATH 142A,B05,093559,Chow; Bennett,6,0,32,26
1657497895980,MATH 193A,A01,083224,Rotar; Vladimir,8,0,34,26
1657497895980,MATH 193A,A02,083225,Rotar; Vladimir,9,0,34,25
1657497895980,MATH 193A,A03,083781,Rotar; Vladimir,5,0,34,29
1657497895980,MATH 193A,A04,083782,Rotar; Vladimir,10,0,34,24
1657497895980,MATH 193A,A05,093482,Rotar; Vladimir,10,0,34,24
1657497902003,MATH 197,001,091859,McAuley; Julian John,9999,0,9999,0
1657497902003,MATH 197,002,095566,Kedlaya; Kiran S.,9997,0,9999,2
1657497902003,MATH 197,003,095567,Xiao; Ming,9999,0,9999,0
1657497902003,MATH 197,004,095571,Perols; Johan Lars,9998,0,9999,1
1657497909055,COGS 9,A01,083615,Shannon; Kyle Michael,9,0,75,66
1657497915079,COGS 11,A01,083617,Boyle; Mary E. T.,22,0,48,26
1657497921111,COGS 13,A01,083071,Bastos; Amalia Pinkusfeld,11,0,71,60
1657497927135,COGS 14A,A01,092681,Semenuks; Arturs,5,1,100,95
1657497933157,COGS 14B,A01,083073,Cheng; Tzu-Han,6,0,63,57
1657497939195,COGS 17,A01,092677,Semenuks; Arturs,6,0,81,75
1657497945221,COGS 100,A01,083619,Allen; Michael Gordon,17,0,70,53
1657497951250,COGS 101A,A01,083621,Davis; Joshua Daniel,9,0,68,59
1657497957284,COGS 101B,A01,091572,Allen; Michael Gordon,12,0,65,53
1657497963313,COGS 101C,A01,083625,Delgado; Tania,17,0,35,18
1657497969340,COGS 107A,A01,083627,Boyle; Mary E. T.,13,0,60,47
1657497975362,COGS 118A,A01,083075,Gupta; Anjum,21,0,76,55
1657497981386,CSE 3,A50,083646,Miranda; Gregory Joseph,24,0,50,26
1657497987409,CSE 8A,A50,083650,Miranda; Gregory Joseph,17,1,56,39
1657497993432,CSE 11,A01,083080,Cao; Yingjun,6,15,40,34
1657497999456,CSE 12,A01,083652,Krause-Levy; Sophia Louisa,28,1,120,92
1657498005477,CSE 15L,A01,083654,Morris; Justin Loren,9,0,50,41
1657498005477,CSE 15L,A02,083655,Morris; Justin Loren,9,0,50,41
1657498011504,CSE 20,A01,083657,Tran; Khoa Dang,39,0,80,41
1657498017528,CSE 21,A01,095574,Bach; Quang Tran,22,0,48,26
1657498023552,CSE 30,A01,083084,Eldon; John,5,0,80,75
1657498023552,CSE 30,B01,095061,Bhaskar; Nishant,9,0,50,41
1657498029578,CSE 100,A01,083659,Cao; Yingjun,5,4,70,65
1657498035601,CSE 134B,A01,083661,Powell; Thomas Allan,22,0,100,78
1657498041625,CSE 140,A01,083663,Gungor; Onat,15,0,85,70
1657498047652,CSE 140L,A01,083088,Eldon; John,21,0,100,79
1657498053674,CSE 175,A01,083665,Kumar; Rakesh,3,0,25,22
1657498059696,CSE 190,A00,092507,Dubnov; Shlomo,8,0,20,12
1657498065719,ECE 45,A01,083139,Congero; Spencer William,6,0,75,69
1657498071745,ECE 65,A50,083695,Saad; Andrew S,12,0,30,18
1657498071745,ECE 65,A51,095125,Saad; Andrew S,24,0,26,2
1657498077769,ECE 109,A01,091882,Touri; Behrouz,19,0,70,51
1657498083796,ECE 180,A00,083140,Abi Samra; Nicholas Camill,1,0,30,29
1657498083796,ECE 180,B00,083141,Abi Samra; Nicholas Camill,0,0,30,30
1657498089820,MATH 10A,A01,083735,Patchell; Gregory David,2,0,30,28
1657498089820,MATH 10A,A02,083736,Patchell; Gregory David,20,0,30,10
1657498089820,MATH 10A,A03,083737,Patchell; Gregory David,16,0,30,14
1657498095847,MATH 10B,A01,083207,Lim; Seonhee,8,0,34,26
1657498095847,MATH 10B,A02,083208,Lim; Seonhee,9,0,35,26
1657498095847,MATH 10B,A03,093472,Lim; Seonhee,7,0,34,27
1657498095847,MATH 10B,B01,083739,Sinha; Shubham,12,0,30,18
1657498101869,MATH 18,A01,083743,Cinel; Cameron Alexander,7,0,30,23
1657498101869,MATH 18,A02,083744,Cinel; Cameron Alexander,17,0,30,13
1657498101869,MATH 18,A03,083745,Cinel; Cameron Alexander,9,0,30,21
1657498101869,MATH 18,B01,083748,Rideout; David Porter,5,0,37,32
1657498101869,MATH 18,B02,083749,Rideout; David Porter,5,0,36,31
1657498101869,MATH 18,B03,083750,Rideout; David Porter,3,0,37,34
1657498101869,MATH 18,B04,083751,Rideout; David Porter,6,0,36,30
1657498101869,MATH 18,B05,093473,Rideout; David Porter,6,0,36,30
1657498101869,MATH 18,B06,093474,Rideout; David Porter,6,0,36,30
1657498107892,MATH 20A,A01,083754,Zheng; Zequn,14,0,40,26
1657498113914,MATH 20B,A01,083756,Briones; Jor-el Thomas Caparas,4,0,36,32
1657498113914,MATH 20B,A02,083757,Briones; Jor-el Thomas Caparas,1,0,36,35
1657498113914,MATH 20B,A03,093475,Briones; Jor-el Thomas Caparas,2,0,36,34
1657498119941,MATH 20C,A01,083760,Briones; Jor-el Thomas Caparas,1,0,35,34
1657498119941,MATH 20C,A02,083761,Briones; Jor-el Thomas Caparas,8,0,35,27
1657498119941,MATH 20C,A03,093476,Briones; Jor-el Thomas Caparas,0,1,36,36
1657498119941,MATH 20C,B01,083762,Bach; Quang Tran,1,0,30,29
1657498125965,MATH 20D,A01,083765,Tran; Brian Kha,5,0,30,25
1657498125965,MATH 20D,A02,083766,Tran; Brian Kha,5,0,30,25
1657498125965,MATH 20D,A03,083767,Tran; Brian Kha,5,0,30,25
1657498131996,MATH 20E,A01,083771,Ganguly; Soumya,9,0,32,23
1657498131996,MATH 20E,A02,083772,Ganguly; Soumya,6,0,32,26
1657498131996,MATH 20E,B01,083773,Ciotti; Benjamin,20,0,35,15
1657498131996,MATH 20E,B02,083774,Ciotti; Benjamin,17,0,35,18
1657498138025,MATH 103A,A01,083777,Greenfeld; Be'Eri,3,0,36,33
1657498138025,MATH 103A,A02,083778,Greenfeld; Be'Eri,5,0,36,31
1657498138025,MATH 103A,A03,093561,Greenfeld; Be'Eri,5,0,36,31
1657498138025,MATH 103A,B01,083779,Greenfeld; Be'Eri,7,0,36,29
1657498138025,MATH 103A,B02,083780,Greenfeld; Be'Eri,4,0,36,32
1657498138025,MATH 103A,B03,093562,Greenfeld; Be'Eri,3,0,36,33
1657498144047,MATH 105,A01,085443,Carter; Anne Toulson,15,0,35,20
1657498144047,MATH 105,A02,093477,Carter; Anne Toulson,20,0,35,15
1657498150076,MATH 109,A01,083213,Ganzberger; Geoffrey Michael,2,0,34,32
1657498150076,MATH 109,A02,083214,Ganzberger; Geoffrey Michael,4,0,34,30
1657498150076,MATH 109,A03,093478,Ganzberger; Geoffrey Michael,2,0,34,32
1657498150076,MATH 109,B01,083215,Ganzberger; Geoffrey Michael,1,0,32,31
1657498150076,MATH 109,B02,083216,Ganzberger; Geoffrey Michael,2,0,32,30
1657498150076,MATH 109,B03,093479,Ganzberger; Geoffrey Michael,8,0,32,24
1657498156109,MATH 142A,A01,083219,Chow; Bennett,7,0,32,25
1657498156109,MATH 142A,A02,083220,Chow; Bennett,10,0,32,22
1657498156109,MATH 142A,A03,093480,Chow; Bennett,8,0,32,24
1657498156109,MATH 142A,B03,093481,Chow; Bennett,8,0,32,24
1657498156109,MATH 142A,B04,093558,Chow; Bennett,13,0,32,19
1657498156109,MATH 142A,B05,093559,Chow; Bennett,6,0,32,26
1657498162132,MATH 193A,A01,083224,Rotar; Vladimir,8,0,34,26
1657498162132,MATH 193A,A02,083225,Rotar; Vladimir,9,0,34,25
1657498162132,MATH 193A,A03,083781,Rotar; Vladimir,5,0,34,29
1657498162132,MATH 193A,A04,083782,Rotar; Vladimir,10,0,34,24
1657498162132,MATH 193A,A05,093482,Rotar; Vladimir,10,0,34,24
1657498168165,MATH 197,001,091859,McAuley; Julian John,9999,0,9999,0
1657498168165,MATH 197,002,095566,Kedlaya; Kiran S.,9997,0,9999,2
1657498168165,MATH 197,003,095567,Xiao; Ming,9999,0,9999,0
1657498168165,MATH 197,004,095571,Perols; Johan Lars,9998,0,9999,1
1657498175219,COGS 9,A01,083615,Shannon; Kyle Michael,9,0,75,66
1657498181243,COGS 11,A01,083617,Boyle; Mary E. T.,22,0,48,26
1657498187271,COGS 13,A01,083071,Bastos; Amalia Pinkusfeld,11,0,71,60
1657498193299,COGS 14A,A01,092681,Semenuks; Arturs,5,1,100,95
1657498199321,COGS 14B,A01,083073,Cheng; Tzu-Han,6,0,63,57
1657498205344,COGS 17,A01,092677,Semenuks; Arturs,6,0,81,75
1657498211366,COGS 100,A01,083619,Allen; Michael Gordon,17,0,70,53
1657498217389,COGS 101A,A01,083621,Davis; Joshua Daniel,9,0,68,59
1657498223428,COGS 101B,A01,091572,Allen; Michael Gordon,12,0,65,53
1657498229453,COGS 101C,A01,083625,Delgado; Tania,17,0,35,18
1657498235479,COGS 107A,A01,083627,Boyle; Mary E. T.,13,0,60,47
1657498241505,COGS 118A,A01,083075,Gupta; Anjum,21,0,76,55
1657498247528,CSE 3,A50,083646,Miranda; Gregory Joseph,24,0,50,26
1657498253552,CSE 8A,A50,083650,Miranda; Gregory Joseph,17,1,56,39
1657498259579,CSE 11,A01,083080,Cao; Yingjun,6,15,40,34
1657498265605,CSE 12,A01,083652,Krause-Levy; Sophia Louisa,28,1,120,92
1657498271632,CSE 15L,A01,083654,Morris; Justin Loren,9,0,50,41
1657498271632,CSE 15L,A02,083655,Morris; Justin Loren,9,0,50,41
1657498277671,CSE 20,A01,083657,Tran; Khoa Dang,39,0,80,41
1657498283704,CSE 21,A01,095574,Bach; Quang Tran,22,0,48,26
1657498289736,CSE 30,A01,083084,Eldon; John,5,0,80,75
1657498289736,CSE 30,B01,095061,Bhaskar; Nishant,9,0,50,41
1657498295762,CSE 100,A01,083659,Cao; Yingjun,5,4,70,65
1657498301786,CSE 134B,A01,083661,Powell; Thomas Allan,22,0,100,78
1657498307808,CSE 140,A01,083663,Gungor; Onat,15,0,85,70
1657498313832,CSE 140L,A01,083088,Eldon; John,21,0,100,79
1657498319858,CSE 175,A01,083665,Kumar; Rakesh,3,0,25,22
1657498325894,CSE 190,A00,092507,Dubnov; Shlomo,8,0,20,12
1657498331923,ECE 45,A01,083139,Congero; Spencer William,6,0,75,69
1657498337945,ECE 65,A50,083695,Saad; Andrew S,12,0,30,18
1657498337945,ECE 65,A51,095125,Saad; Andrew S,24,0,26,2
1657498343974,ECE 109,A01,091882,Touri; Behrouz,19,0,70,51
1657498350001,ECE 180,A00,083140,Abi Samra; Nicholas Camill,1,0,30,29
1657498350001,ECE 180,B00,083141,Abi Samra; Nicholas Camill,0,0,30,30
1657498356027,MATH 10A,A01,083735,Patchell; Gregory David,2,0,30,28
1657498356027,MATH 10A,A02,083736,Patchell; Gregory David,20,0,30,10
1657498356027,MATH 10A,A03,083737,Patchell; Gregory David,16,0,30,14
1657498362057,MATH 10B,A01,083207,Lim; Seonhee,8,0,34,26
1657498362057,MATH 10B,A02,083208,Lim; Seonhee,9,0,35,26
1657498362057,MATH 10B,A03,093472,Lim; Seonhee,7,0,34,27
1657498362057,MATH 10B,B01,083739,Sinha; Shubham,12,0,30,18
1657498368082,MATH 18,A01,083743,Cinel; Cameron Alexander,7,0,30,23
1657498368082,MATH 18,A02,083744,Cinel; Cameron Alexander,17,0,30,13
1657498368082,MATH 18,A03,083745,Cinel; Cameron Alexander,9,0,30,21
1657498368082,MATH 18,B01,083748,Rideout; David Porter,5,0,37,32
1657498368082,MATH 18,B02,083749,Rideout; David Porter,5,0,36,31
1657498368082,MATH 18,B03,083750,Rideout; David Porter,3,0,37,34
1657498368082,MATH 18,B04,083751,Rideout; David Porter,6,0,36,30
1657498368082,MATH 18,B05,093473,Rideout; David Porter,6,0,36,30
1657498368082,MATH 18,B06,093474,Rideout; David Porter,6,0,36,30
1657498374186,MATH 20A,A01,083754,Zheng; Zequn,14,0,40,26
1657498380209,MATH 20B,A01,083756,Briones; Jor-el Thomas Caparas,4,0,36,32
1657498380209,MATH 20B,A02,083757,Briones; Jor-el Thomas Caparas,1,0,36,35
1657498380209,MATH 20B,A03,093475,Briones; Jor-el Thomas Caparas,2,0,36,34
1657498386239,MATH 20C,A01,083760,Briones; Jor-el Thomas Caparas,1,0,35,34
1657498386239,MATH 20C,A02,083761,Briones; Jor-el Thomas Caparas,8,0,35,27
1657498386239,MATH 20C,A03,093476,Briones; Jor-el Thomas Caparas,0,1,36,36
1657498386239,MATH 20C,B01,083762,Bach; Quang Tran,1,0,30,29
1657498392271,MATH 20D,A01,083765,Tran; Brian Kha,5,0,30,25
1657498392271,MATH 20D,A02,083766,Tran; Brian Kha,5,0,30,25
1657498392271,MATH 20D,A03,083767,Tran; Brian Kha,5,0,30,25
1657498398296,MATH 20E,A01,083771,Ganguly; Soumya,9,0,32,23
1657498398296,MATH 20E,A02,083772,Ganguly; Soumya,6,0,32,26
1657498398296,MATH 20E,B01,083773,Ciotti; Benjamin,20,0,35,15
1657498398296,MATH 20E,B02,083774,Ciotti; Benjamin,17,0,35,18
1657498404318,MATH 103A,A01,083777,Greenfeld; Be'Eri,3,0,36,33
1657498404318,MATH 103A,A02,083778,Greenfeld; Be'Eri,5,0,36,31
1657498404318,MATH 103A,A03,093561,Greenfeld; Be'Eri,5,0,36,31
1657498404318,MATH 103A,B01,083779,Greenfeld; Be'Eri,7,0,36,29
1657498404318,MATH 103A,B02,083780,Greenfeld; Be'Eri,4,0,36,32
1657498404318,MATH 103A,B03,093562,Greenfeld; Be'Eri,3,0,36,33
1657498410341,MATH 105,A01,085443,Carter; Anne Toulson,15,0,35,20
1657498410341,MATH 105,A02,093477,Carter; Anne Toulson,20,0,35,15
1657498416363,MATH 109,A01,083213,Ganzberger; Geoffrey Michael,2,0,34,32
1657498416363,MATH 109,A02,083214,Ganzberger; Geoffrey Michael,4,0,34,30
1657498416363,MATH 109,A03,093478,Ganzberger; Geoffrey Michael,2,0,34,32
1657498416363,MATH 109,B01,083215,Ganzberger; Geoffrey Michael,1,0,32,31
1657498416363,MATH 109,B02,083216,Ganzberger; Geoffrey Michael,2,0,32,30
1657498416363,MATH 109,B03,093479,Ganzberger; Geoffrey Michael,8,0,32,24
1657498422388,MATH 142A,A01,083219,Chow; Bennett,7,0,32,25
1657498422388,MATH 142A,A02,083220,Chow; Bennett,10,0,32,22
1657498422388,MATH 142A,A03,093480,Chow; Bennett,8,0,32,24
1657498422388,MATH 142A,B03,093481,Chow; Bennett,8,0,32,24
1657498422388,MATH 142A,B04,093558,Chow; Bennett,13,0,32,19
1657498422388,MATH 142A,B05,093559,Chow; Bennett,6,0,32,26
1657498428418,MATH 193A,A01,083224,Rotar; Vladimir,8,0,34,26
1657498428418,MATH 193A,A02,083225,Rotar; Vladimir,9,0,34,25
1657498428418,MATH 193A,A03,083781,Rotar; Vladimir,5,0,34,29
1657498428418,MATH 193A,A04,083782,Rotar; Vladimir,10,0,34,24
1657498428418,MATH 193A,A05,093482,Rotar; Vladimir,10,0,34,24
1657498434441,MATH 197,001,091859,McAuley; Julian John,9999,0,9999,0
1657498434441,MATH 197,002,095566,Kedlaya; Kiran S.,9997,0,9999,2
1657498434441,MATH 197,003,095567,Xiao; Ming,9999,0,9999,0
1657498434441,MATH 197,004,095571,Perols; Johan Lars,9998,0,9999,1
1657498441496,COGS 9,A01,083615,Shannon; Kyle Michael,9,0,75,66
1657498447523,COGS 11,A01,083617,Boyle; Mary E. T.,22,0,48,26
1657498453550,COGS 13,A01,083071,Bastos; Amalia Pinkusfeld,11,0,71,60
1657498459578,COGS 14A,A01,092681,Semenuks; Arturs,5,1,100,95
1657498465600,COGS 14B,A01,083073,Cheng; Tzu-Han,6,0,63,57
1657498471625,COGS 17,A01,092677,Semenuks; Arturs,6,0,81,75
1657498477647,COGS 100,A01,083619,Allen; Michael Gordon,17,0,70,53
1657498483670,COGS 101A,A01,083621,Davis; Joshua Daniel,9,0,68,59
1657498489692,COGS 101B,A01,091572,Allen; Michael Gordon,12,0,65,53
1657498495715,COGS 101C,A01,083625,Delgado; Tania,17,0,35,18
1657498501753,COGS 107A,A01,083627,Boyle; Mary E. T.,13,0,60,47
1657498507779,COGS 118A,A01,083075,Gupta; Anjum,21,0,76,55
1657498513801,CSE 3,A50,083646,Miranda; Gregory Joseph,24,0,50,26
1657498519829,CSE 8A,A50,083650,Miranda; Gregory Joseph,17,1,56,39
1657498525862,CSE 11,A01,083080,Cao; Yingjun,6,15,40,34
1657498531892,CSE 12,A01,083652,Krause-Levy; Sophia Louisa,28,1,120,92
1657498537918,CSE 15L,A01,083654,Morris; Justin Loren,9,0,50,41
1657498537918,CSE 15L,A02,083655,Morris; Justin Loren,9,0,50,41
1657498543941,CSE 20,A01,083657,Tran; Khoa Dang,39,0,80,41
1657498549966,CSE 21,A01,095574,Bach; Quang Tran,22,0,48,26
1657498555989,CSE 30,A01,083084,Eldon; John,5,0,80,75
1657498555989,CSE 30,B01,095061,Bhaskar; Nishant,9,0,50,41
1657498562024,CSE 100,A01,083659,Cao; Yingjun,5,4,70,65
1657498568051,CSE 134B,A01,083661,Powell; Thomas Allan,22,0,100,78
1657498574077,CSE 140,A01,083663,Gungor; Onat,15,0,85,70
1657498580099,CSE 140L,A01,083088,Eldon; John,21,0,100,79
1657498586131,CSE 175,A01,083665,Kumar; Rakesh,3,0,25,22
1657498592155,CSE 190,A00,092507,Dubnov; Shlomo,8,0,20,12
1657498598182,ECE 45,A01,083139,Congero; Spencer William,6,0,75,69
1657498604206,ECE 65,A50,083695,Saad; Andrew S,12,0,30,18
1657498604206,ECE 65,A51,095125,Saad; Andrew S,24,0,26,2
1657498610229,ECE 109,A01,091882,Touri; Behrouz,19,0,70,51
1657498616256,ECE 180,A00,083140,Abi Samra; Nicholas Camill,1,0,30,29
1657498616256,ECE 180,B00,083141,Abi Samra; Nicholas Camill,0,0,30,30
1657498622281,MATH 10A,A01,083735,Patchell; Gregory David,2,0,30,28
1657498622281,MATH 10A,A02,083736,Patchell; Gregory David,20,0,30,10
1657498622281,MATH 10A,A03,083737,Patchell; Gregory David,16,0,30,14
1657498628304,MATH 10B,A01,083207,Lim; Seonhee,8,0,34,26
1657498628304,MATH 10B,A02,083208,Lim; Seonhee,9,0,35,26
1657498628304,MATH 10B,A03,093472,Lim; Seonhee,7,0,34,27
1657498628304,MATH 10B,B01,083739,Sinha; Shubham,12,0,30,18
1657498634329,MATH 18,A01,083743,Cinel; Cameron Alexander,7,0,30,23
1657498634329,MATH 18,A02,083744,Cinel; Cameron Alexander,17,0,30,13
1657498634329,MATH 18,A03,083745,Cinel; Cameron Alexander,9,0,30,21
1657498634329,MATH 18,B01,083748,Rideout; David Porter,5,0,37,32
1657498634329,MATH 18,B02,083749,Rideout; David Porter,5,0,36,31
1657498634329,MATH 18,B03,083750,Rideout; David Porter,3,0,37,34
1657498634329,MATH 18,B04,083751,Rideout; David Porter,6,0,36,30
1657498634329,MATH 18,B05,093473,Rideout; David Porter,6,0,36,30
1657498634329,MATH 18,B06,093474,Rideout; David Porter,6,0,36,30
1657498640352,MATH 20A,A01,083754,Zheng; Zequn,14,0,40,26
1657498646381,MATH 20B,A01,083756,Briones; Jor-el Thomas Caparas,4,0,36,32
1657498646381,MATH 20B,A02,083757,Briones; Jor-el Thomas Caparas,1,0,36,35
1657498646381,MATH 20B,A03,093475,Briones; Jor-el Thomas Caparas,2,0,36,34
1657498652409,MATH 20C,A01,083760,Briones; Jor-el Thomas Caparas,1,0,35,34
1657498652409,MATH 20C,A02,083761,Briones; Jor-el Thomas Caparas,8,0,35,27
1657498652409,MATH 20C,A03,093476,Briones; Jor-el Thomas Caparas,0,1,36,36
1657498652409,MATH 20C,B01,083762,Bach; Quang Tran,1,0,30,29
1657498658433,MATH 20D,A01,083765,Tran; Brian Kha,5,0,30,25
1657498658433,MATH 20D,A02,083766,Tran; Brian Kha,5,0,30,25
1657498658433,MATH 20D,A03,083767,Tran; Brian Kha,5,0,30,25
1657498664455,MATH 20E,A01,083771,Ganguly; Soumya,9,0,32,23
1657498664455,MATH 20E,A02,083772,Ganguly; Soumya,6,0,32,26
1657498664455,MATH 20E,B01,083773,Ciotti; Benjamin,20,0,35,15
1657498664455,MATH 20E,B02,083774,Ciotti; Benjamin,17,0,35,18
1657498670477,MATH 103A,A01,083777,Greenfeld; Be'Eri,3,0,36,33
1657498670477,MATH 103A,A02,083778,Greenfeld; Be'Eri,5,0,36,31
1657498670477,MATH 103A,A03,093561,Greenfeld; Be'Eri,5,0,36,31
1657498670477,MATH 103A,B01,083779,Greenfeld; Be'Eri,7,0,36,29
1657498670477,MATH 103A,B02,083780,Greenfeld; Be'Eri,4,0,36,32
1657498670477,MATH 103A,B03,093562,Greenfeld; Be'Eri,3,0,36,33
1657498676499,MATH 105,A01,085443,Carter; Anne Toulson,15,0,35,20
1657498676499,MATH 105,A02,093477,Carter; Anne Toulson,20,0,35,15
1657498682524,MATH 109,A01,083213,Ganzberger; Geoffrey Michael,2,0,34,32
1657498682524,MATH 109,A02,083214,Ganzberger; Geoffrey Michael,4,0,34,30
1657498682524,MATH 109,A03,093478,Ganzberger; Geoffrey Michael,2,0,34,32
1657498682524,MATH 109,B01,083215,Ganzberger; Geoffrey Michael,1,0,32,31
1657498682524,MATH 109,B02,083216,Ganzberger; Geoffrey Michael,2,0,32,30
1657498682524,MATH 109,B03,093479,Ganzberger; Geoffrey Michael,8,0,32,24
1657498688553,MATH 142A,A01,083219,Chow; Bennett,7,0,32,25
1657498688553,MATH 142A,A02,083220,Chow; Bennett,10,0,32,22
1657498688553,MATH 142A,A03,093480,Chow; Bennett,8,0,32,24
1657498688553,MATH 142A,B03,093481,Chow; Bennett,8,0,32,24
1657498688553,MATH 142A,B04,093558,Chow; Bennett,13,0,32,19
1657498688553,MATH 142A,B05,093559,Chow; Bennett,6,0,32,26
1657498694578,MATH 193A,A01,083224,Rotar; Vladimir,8,0,34,26
1657498694578,MATH 193A,A02,083225,Rotar; Vladimir,9,0,34,25
1657498694578,MATH 193A,A03,083781,Rotar; Vladimir,5,0,34,29
1657498694578,MATH 193A,A04,083782,Rotar; Vladimir,10,0,34,24
1657498694578,MATH 193A,A05,093482,Rotar; Vladimir,10,0,34,24
1657498700599,MATH 197,001,091859,McAuley; Julian John,9999,0,9999,0
1657498700599,MATH 197,002,095566,Kedlaya; Kiran S.,9997,0,9999,2
1657498700599,MATH 197,003,095567,Xiao; Ming,9999,0,9999,0
1657498700599,MATH 197,004,095571,Perols; Johan Lars,9998,0,9999,1
1657498707661,COGS 9,A01,083615,Shannon; Kyle Michael,9,0,75,66
1657498713687,COGS 11,A01,083617,Boyle; Mary E. T.,22,0,48,26
1657498719712,COGS 13,A01,083071,Bastos; Amalia Pinkusfeld,11,0,71,60
1657498725741,COGS 14A,A01,092681,Semenuks; Arturs,5,1,100,95
1657498731769,COGS 14B,A01,083073,Cheng; Tzu-Han,6,0,63,57
1657498737797,COGS 17,A01,092677,Semenuks; Arturs,6,0,81,75
1657498743820,COGS 100,A01,083619,Allen; Michael Gordon,17,0,70,53
1657498749842,COGS 101A,A01,083621,Davis; Joshua Daniel,9,0,68,59
1657498755865,COGS 101B,A01,091572,Allen; Michael Gordon,12,0,65,53
1657498761888,COGS 101C,A01,083625,Delgado; Tania,17,0,35,18
1657498767912,COGS 107A,A01,083627,Boyle; Mary E. T.,13,0,60,47
1657498773938,COGS 118A,A01,083075,Gupta; Anjum,21,0,76,55
1657498779964,CSE 3,A50,083646,Miranda; Gregory Joseph,24,0,50,26
1657498785992,CSE 8A,A50,083650,Miranda; Gregory Joseph,17,1,56,39
1657498792014,CSE 11,A01,083080,Cao; Yingjun,6,15,40,34
1657498798038,CSE 12,A01,083652,Krause-Levy; Sophia Louisa,28,1,120,92
1657498804062,CSE 15L,A01,083654,Morris; Justin Loren,9,0,50,41
1657498804062,CSE 15L,A02,083655,Morris; Justin Loren,9,0,50,41
1657498810092,CSE 20,A01,083657,Tran; Khoa Dang,39,0,80,41
1657498816115,CSE 21,A01,095574,Bach; Quang Tran,22,0,48,26
1657498822138,CSE 30,A01,083084,Eldon; John,5,0,80,75
1657498822138,CSE 30,B01,095061,Bhaskar; Nishant,9,0,50,41
1657498828164,CSE 100,A01,083659,Cao; Yingjun,5,4,70,65
1657498834188,CSE 134B,A01,083661,Powell; Thomas Allan,22,0,100,78
1657498840217,CSE 140,A01,083663,Gungor; Onat,15,0,85,70
1657498846239,CSE 140L,A01,083088,Eldon; John,21,0,100,79
1657498852265,CSE 175,A01,083665,Kumar; Rakesh,3,0,25,22
1657498858293,CSE 190,A00,092507,Dubnov; Shlomo,8,0,20,12
1657498864315,ECE 45,A01,083139,Congero; Spencer William,6,0,75,69
1657498870338,ECE 65,A50,083695,Saad; Andrew S,12,0,30,18
1657498870338,ECE 65,A51,095125,Saad; Andrew S,24,0,26,2
1657498876359,ECE 109,A01,091882,Touri; Behrouz,19,0,70,51
1657498882386,ECE 180,A00,083140,Abi Samra; Nicholas Camill,1,0,30,29
1657498882386,ECE 180,B00,083141,Abi Samra; Nicholas Camill,0,0,30,30
1657498888414,MATH 10A,A01,083735,Patchell; Gregory David,2,0,30,28
1657498888414,MATH 10A,A02,083736,Patchell; Gregory David,20,0,30,10
1657498888414,MATH 10A,A03,083737,Patchell; Gregory David,16,0,30,14
1657498894437,MATH 10B,A01,083207,Lim; Seonhee,8,0,34,26
1657498894437,MATH 10B,A02,083208,Lim; Seonhee,9,0,35,26
1657498894437,MATH 10B,A03,093472,Lim; Seonhee,7,0,34,27
1657498894437,MATH 10B,B01,083739,Sinha; Shubham,12,0,30,18
1657498900461,MATH 18,A01,083743,Cinel; Cameron Alexander,7,0,30,23
1657498900461,MATH 18,A02,083744,Cinel; Cameron Alexander,17,0,30,13
1657498900461,MATH 18,A03,083745,Cinel; Cameron Alexander,9,0,30,21
1657498900461,MATH 18,B01,083748,Rideout; David Porter,5,0,37,32
1657498900461,MATH 18,B02,083749,Rideout; David Porter,5,0,36,31
1657498900461,MATH 18,B03,083750,Rideout; David Porter,3,0,37,34
1657498900461,MATH 18,B04,083751,Rideout; David Porter,6,0,36,30
1657498900461,MATH 18,B05,093473,Rideout; David Porter,6,0,36,30
1657498900461,MATH 18,B06,093474,Rideout; David Porter,6,0,36,30
1657498906487,MATH 20A,A01,083754,Zheng; Zequn,14,0,40,26
1657498912515,MATH 20B,A01,083756,Briones; Jor-el Thomas Caparas,4,0,36,32
1657498912515,MATH 20B,A02,083757,Briones; Jor-el Thomas Caparas,1,0,36,35
1657498912515,MATH 20B,A03,093475,Briones; Jor-el Thomas Caparas,2,0,36,34
1657498918538,MATH 20C,A01,083760,Briones; Jor-el Thomas Caparas,1,0,35,34
1657498918538,MATH 20C,A02,083761,Briones; Jor-el Thomas Caparas,8,0,35,27
1657498918538,MATH 20C,A03,093476,Briones; Jor-el Thomas Caparas,0,1,36,36
1657498918538,MATH 20C,B01,083762,Bach; Quang Tran,1,0,30,29
1657498924562,MATH 20D,A01,083765,Tran; Brian Kha,5,0,30,25
1657498924562,MATH 20D,A02,083766,Tran; Brian Kha,5,0,30,25
1657498924562,MATH 20D,A03,083767,Tran; Brian Kha,5,0,30,25
1657498930595,MATH 20E,A01,083771,Ganguly; Soumya,9,0,32,23
1657498930595,MATH 20E,A02,083772,Ganguly; Soumya,6,0,32,26
1657498930595,MATH 20E,B01,083773,Ciotti; Benjamin,20,0,35,15
1657498930595,MATH 20E,B02,083774,Ciotti; Benjamin,17,0,35,18
1657498936618,MATH 103A,A01,083777,Greenfeld; Be'Eri,3,0,36,33
1657498936618,MATH 103A,A02,083778,Greenfeld; Be'Eri,5,0,36,31
1657498936618,MATH 103A,A03,093561,Greenfeld; Be'Eri,5,0,36,31
1657498936618,MATH 103A,B01,083779,Greenfeld; Be'Eri,7,0,36,29
1657498936618,MATH 103A,B02,083780,Greenfeld; Be'Eri,4,0,36,32
1657498936618,MATH 103A,B03,093562,Greenfeld; Be'Eri,3,0,36,33
1657498942642,MATH 105,A01,085443,Carter; Anne Toulson,15,0,35,20
1657498942642,MATH 105,A02,093477,Carter; Anne Toulson,20,0,35,15
1657498948671,MATH 109,A01,083213,Ganzberger; Geoffrey Michael,2,0,34,32
1657498948671,MATH 109,A02,083214,Ganzberger; Geoffrey Michael,4,0,34,30
1657498948671,MATH 109,A03,093478,Ganzberger; Geoffrey Michael,2,0,34,32
1657498948671,MATH 109,B01,083215,Ganzberger; Geoffrey Michael,1,0,32,31
1657498948671,MATH 109,B02,083216,Ganzberger; Geoffrey Michael,2,0,32,30
1657498948671,MATH 109,B03,093479,Ganzberger; Geoffrey Michael,8,0,32,24
1657498954697,MATH 142A,A01,083219,Chow; Bennett,7,0,32,25
1657498954697,MATH 142A,A02,083220,Chow; Bennett,10,0,32,22
1657498954697,MATH 142A,A03,093480,Chow; Bennett,8,0,32,24
1657498954697,MATH 142A,B03,093481,Chow; Bennett,8,0,32,24
1657498954697,MATH 142A,B04,093558,Chow; Bennett,13,0,32,19
1657498954697,MATH 142A,B05,093559,Chow; Bennett,6,0,32,26
1657498960729,MATH 193A,A01,083224,Rotar; Vladimir,8,0,34,26
1657498960729,MATH 193A,A02,083225,Rotar; Vladimir,9,0,34,25
1657498960729,MATH 193A,A03,083781,Rotar; Vladimir,5,0,34,29
1657498960729,MATH 193A,A04,083782,Rotar; Vladimir,10,0,34,24
1657498960729,MATH 193A,A05,093482,Rotar; Vladimir,10,0,34,24
1657498966754,MATH 197,001,091859,McAuley; Julian John,9999,0,9999,0
1657498966754,MATH 197,002,095566,Kedlaya; Kiran S.,9997,0,9999,2
1657498966754,MATH 197,003,095567,Xiao; Ming,9999,0,9999,0
1657498966754,MATH 197,004,095571,Perols; Johan Lars,9998,0,9999,1
1657498973880,COGS 9,A01,083615,Shannon; Kyle Michael,9,0,75,66
1657498979904,COGS 11,A01,083617,Boyle; Mary E. T.,22,0,48,26
1657498985931,COGS 13,A01,083071,Bastos; Amalia Pinkusfeld,11,0,71,60
1657498991955,COGS 14A,A01,092681,Semenuks; Arturs,5,1,100,95
1657498997980,COGS 14B,A01,083073,Cheng; Tzu-Han,6,0,63,57
1657499004004,COGS 17,A01,092677,Semenuks; Arturs,6,0,81,75
1657499010028,COGS 100,A01,083619,Allen; Michael Gordon,17,0,70,53
1657499016051,COGS 101A,A01,083621,Davis; Joshua Daniel,9,0,68,59
1657499022072,COGS 101B,A01,091572,Allen; Michael Gordon,12,0,65,53
1657499028097,COGS 101C,A01,083625,Delgado; Tania,17,0,35,18
1657499034121,COGS 107A,A01,083627,Boyle; Mary E. T.,13,0,60,47
1657499040145,COGS 118A,A01,083075,Gupta; Anjum,21,0,76,55
1657499046168,CSE 3,A50,083646,Miranda; Gregory Joseph,24,0,50,26
1657499052196,CSE 8A,A50,083650,Miranda; Gregory Joseph,17,1,56,39
1657499058223,CSE 11,A01,083080,Cao; Yingjun,6,15,40,34
1657499064248,CSE 12,A01,083652,Krause-Levy; Sophia Louisa,28,1,120,92
1657499070272,CSE 15L,A01,083654,Morris; Justin Loren,9,0,50,41
1657499070272,CSE 15L,A02,083655,Morris; Justin Loren,9,0,50,41
1657499076304,CSE 20,A01,083657,Tran; Khoa Dang,39,0,80,41
1657499082326,CSE 21,A01,095574,Bach; Quang Tran,22,0,48,26
1657499088349,CSE 30,A01,083084,Eldon; John,5,0,80,75
1657499088349,CSE 30,B01,095061,Bhaskar; Nishant,9,0,50,41
1657499094377,CSE 100,A01,083659,Cao; Yingjun,5,4,70,65
1657499100399,CSE 134B,A01,083661,Powell; Thomas Allan,22,0,100,78
1657499106423,CSE 140,A01,083663,Gungor; Onat,15,0,85,70
1657499112445,CSE 140L,A01,083088,Eldon; John,21,0,100,79
1657499118466,CSE 175,A01,083665,Kumar; Rakesh,3,0,25,22
1657499124489,CSE 190,A00,092507,Dubnov; Shlomo,8,0,20,12
1657499130516,ECE 45,A01,083139,Congero; Spencer William,6,0,75,69
1657499136550,ECE 65,A50,083695,Saad; Andrew S,12,0,30,18
1657499136550,ECE 65,A51,095125,Saad; Andrew S,24,0,26,2
1657499142582,ECE 109,A01,091882,Touri; Behrouz,19,0,70,51
1657499148613,ECE 180,A00,083140,Abi Samra; Nicholas Camill,1,0,30,29
1657499148613,ECE 180,B00,083141,Abi Samra; Nicholas Camill,0,0,30,30
1657499154640,MATH 10A,A01,083735,Patchell; Gregory David,2,0,30,28
1657499154640,MATH 10A,A02,083736,Patchell; Gregory David,20,0,30,10
1657499154640,MATH 10A,A03,083737,Patchell; Gregory David,16,0,30,14
1657499160668,MATH 10B,A01,083207,Lim; Seonhee,8,0,34,26
1657499160668,MATH 10B,A02,083208,Lim; Seonhee,9,0,35,26
1657499160668,MATH 10B,A03,093472,Lim; Seonhee,7,0,34,27
1657499160668,MATH 10B,B01,083739,Sinha; Shubham,12,0,30,18
1657499166698,MATH 18,A01,083743,Cinel; Cameron Alexander,7,0,30,23
1657499166698,MATH 18,A02,083744,Cinel; Cameron Alexander,17,0,30,13
1657499166698,MATH 18,A03,083745,Cinel; Cameron Alexander,9,0,30,21
1657499166698,MATH 18,B01,083748,Rideout; David Porter,5,0,37,32
1657499166698,MATH 18,B02,083749,Rideout; David Porter,5,0,36,31
1657499166698,MATH 18,B03,083750,Rideout; David Porter,3,0,37,34
1657499166698,MATH 18,B04,083751,Rideout; David Porter,6,0,36,30
1657499166698,MATH 18,B05,093473,Rideout; David Porter,6,0,36,30
1657499166698,MATH 18,B06,093474,Rideout; David Porter,6,0,36,30
1657499172723,MATH 20A,A01,083754,Zheng; Zequn,14,0,40,26
1657499178746,MATH 20B,A01,083756,Briones; Jor-el Thomas Caparas,4,0,36,32
1657499178746,MATH 20B,A02,083757,Briones; Jor-el Thomas Caparas,1,0,36,35
1657499178746,MATH 20B,A03,093475,Briones; Jor-el Thomas Caparas,2,0,36,34
1657499184771,MATH 20C,A01,083760,Briones; Jor-el Thomas Caparas,1,0,35,34
1657499184771,MATH 20C,A02,083761,Briones; Jor-el Thomas Caparas,8,0,35,27
1657499184771,MATH 20C,A03,093476,Briones; Jor-el Thomas Caparas,0,1,36,36
1657499184771,MATH 20C,B01,083762,Bach; Quang Tran,1,0,30,29
1657499190799,MATH 20D,A01,083765,Tran; Brian Kha,5,0,30,25
1657499190799,MATH 20D,A02,083766,Tran; Brian Kha,5,0,30,25
1657499190799,MATH 20D,A03,083767,Tran; Brian Kha,5,0,30,25
1657499196825,MATH 20E,A01,083771,Ganguly; Soumya,9,0,32,23
1657499196825,MATH 20E,A02,083772,Ganguly; Soumya,6,0,32,26
1657499196825,MATH 20E,B01,083773,Ciotti; Benjamin,20,0,35,15
1657499196825,MATH 20E,B02,083774,Ciotti; Benjamin,17,0,35,18
1657499202848,MATH 103A,A01,083777,Greenfeld; Be'Eri,3,0,36,33
1657499202848,MATH 103A,A02,083778,Greenfeld; Be'Eri,5,0,36,31
1657499202848,MATH 103A,A03,093561,Greenfeld; Be'Eri,5,0,36,31
1657499202848,MATH 103A,B01,083779,Greenfeld; Be'Eri,7,0,36,29
1657499202848,MATH 103A,B02,083780,Greenfeld; Be'Eri,4,0,36,32
1657499202848,MATH 103A,B03,093562,Greenfeld; Be'Eri,3,0,36,33
1657499208875,MATH 105,A01,085443,Carter; Anne Toulson,15,0,35,20
1657499208875,MATH 105,A02,093477,Carter; Anne Toulson,20,0,35,15
1657499214902,MATH 109,A01,083213,Ganzberger; Geoffrey Michael,2,0,34,32
1657499214902,MATH 109,A02,083214,Ganzberger; Geoffrey Michael,4,0,34,30
1657499214902,MATH 109,A03,093478,Ganzberger; Geoffrey Michael,2,0,34,32
1657499214902,MATH 109,B01,083215,Ganzberger; Geoffrey Michael,1,0,32,31
1657499214902,MATH 109,B02,083216,Ganzberger; Geoffrey Michael,2,0,32,30
1657499214902,MATH 109,B03,093479,Ganzberger; Geoffrey Michael,8,0,32,24
1657499220926,MATH 142A,A01,083219,Chow; Bennett,7,0,32,25
1657499220926,MATH 142A,A02,083220,Chow; Bennett,10,0,32,22
1657499220926,MATH 142A,A03,093480,Chow; Bennett,8,0,32,24
1657499220926,MATH 142A,B03,093481,Chow; Bennett,8,0,32,24
1657499220926,MATH 142A,B04,093558,Chow; Bennett,13,0,32,19
1657499220926,MATH 142A,B05,093559,Chow; Bennett,6,0,32,26
1657499226949,MATH 193A,A01,083224,Rotar; Vladimir,8,0,34,26
1657499226949,MATH 193A,A02,083225,Rotar; Vladimir,9,0,34,25
1657499226949,MATH 193A,A03,083781,Rotar; Vladimir,5,0,34,29
1657499226949,MATH 193A,A04,083782,Rotar; Vladimir,10,0,34,24
1657499226949,MATH 193A,A05,093482,Rotar; Vladimir,10,0,34,24
1657499232973,MATH 197,001,091859,McAuley; Julian John,9999,0,9999,0
1657499232973,MATH 197,002,095566,Kedlaya; Kiran S.,9997,0,9999,2
1657499232973,MATH 197,003,095567,Xiao; Ming,9999,0,9999,0
1657499232973,MATH 197,004,095571,Perols; Johan Lars,9998,0,9999,1
1657499240036,COGS 9,A01,083615,Shannon; Kyle Michael,9,0,75,66
1657499246058,COGS 11,A01,083617,Boyle; Mary E. T.,22,0,48,26
1657499252081,COGS 13,A01,083071,Bastos; Amalia Pinkusfeld,11,0,71,60
1657499258107,COGS 14A,A01,092681,Semenuks; Arturs,5,1,100,95
1657499264141,COGS 14B,A01,083073,Cheng; Tzu-Han,6,0,63,57
1657499270166,COGS 17,A01,092677,Semenuks; Arturs,6,0,81,75
1657499276193,COGS 100,A01,083619,Allen; Michael Gordon,17,0,70,53
1657499282216,COGS 101A,A01,083621,Davis; Joshua Daniel,9,0,68,59
1657499288238,COGS 101B,A01,091572,Allen; Michael Gordon,12,0,65,53
1657499294262,COGS 101C,A01,083625,Delgado; Tania,17,0,35,18
1657499300285,COGS 107A,A01,083627,Boyle; Mary E. T.,13,0,60,47
1657499306308,COGS 118A,A01,083075,Gupta; Anjum,21,0,76,55
1657499312340,CSE 3,A50,083646,Miranda; Gregory Joseph,24,0,50,26
1657499318368,CSE 8A,A50,083650,Miranda; Gregory Joseph,17,1,56,39
1657499324391,CSE 11,A01,083080,Cao; Yingjun,6,15,40,34
1657499330412,CSE 12,A01,083652,Krause-Levy; Sophia Louisa,28,1,120,92
1657499336438,CSE 15L,A01,083654,Morris; Justin Loren,9,0,50,41
1657499336438,CSE 15L,A02,083655,Morris; Justin Loren,9,0,50,41
1657499342462,CSE 20,A01,083657,Tran; Khoa Dang,39,0,80,41
1657499348485,CSE 21,A01,095574,Bach; Quang Tran,22,0,48,26
1657499354512,CSE 30,A01,083084,Eldon; John,5,0,80,75
1657499354512,CSE 30,B01,095061,Bhaskar; Nishant,9,0,50,41
1657499360542,CSE 100,A01,083659,Cao; Yingjun,5,4,70,65
1657499366566,CSE 134B,A01,083661,Powell; Thomas Allan,22,0,100,78
1657499372590,CSE 140,A01,083663,Gungor; Onat,15,0,85,70
1657499378612,CSE 140L,A01,083088,Eldon; John,21,0,100,79
1657499384635,CSE 175,A01,083665,Kumar; Rakesh,3,0,25,22
1657499390659,CSE 190,A00,092507,Dubnov; Shlomo,8,0,20,12
1657499396681,ECE 45,A01,083139,Congero; Spencer William,6,0,75,69
1657499402703,ECE 65,A50,083695,Saad; Andrew S,12,0,30,18
1657499402703,ECE 65,A51,095125,Saad; Andrew S,24,0,26,2
1657499408736,ECE 109,A01,091882,Touri; Behrouz,19,0,70,51
1657499414759,ECE 180,A00,083140,Abi Samra; Nicholas Camill,1,0,30,29
1657499414759,ECE 180,B00,083141,Abi Samra; Nicholas Camill,0,0,30,30
1657499420782,MATH 10A,A01,083735,Patchell; Gregory David,2,0,30,28
1657499420782,MATH 10A,A02,083736,Patchell; Gregory David,20,0,30,10
1657499420782,MATH 10A,A03,083737,Patchell; Gregory David,16,0,30,14
1657499426817,MATH 10B,A01,083207,Lim; Seonhee,8,0,34,26
1657499426817,MATH 10B,A02,083208,Lim; Seonhee,9,0,35,26
1657499426817,MATH 10B,A03,093472,Lim; Seonhee,7,0,34,27
1657499426817,MATH 10B,B01,083739,Sinha; Shubham,12,0,30,18
1657499432841,MATH 18,A01,083743,Cinel; Cameron Alexander,7,0,30,23
1657499432841,MATH 18,A02,083744,Cinel; Cameron Alexander,17,0,30,13
1657499432841,MATH 18,A03,083745,Cinel; Cameron Alexander,9,0,30,21
1657499432841,MATH 18,B01,083748,Rideout; David Porter,5,0,37,32
1657499432841,MATH 18,B02,083749,Rideout; David Porter,5,0,36,31
1657499432841,MATH 18,B03,083750,Rideout; David Porter,3,0,37,34
1657499432841,MATH 18,B04,083751,Rideout; David Porter,6,0,36,30
1657499432841,MATH 18,B05,093473,Rideout; David Porter,6,0,36,30
1657499432841,MATH 18,B06,093474,Rideout; David Porter,6,0,36,30
1657499438864,MATH 20A,A01,083754,Zheng; Zequn,14,0,40,26
1657499444892,MATH 20B,A01,083756,Briones; Jor-el Thomas Caparas,4,0,36,32
1657499444892,MATH 20B,A02,083757,Briones; Jor-el Thomas Caparas,1,0,36,35
1657499444892,MATH 20B,A03,093475,Briones; Jor-el Thomas Caparas,2,0,36,34
1657499450918,MATH 20C,A01,083760,Briones; Jor-el Thomas Caparas,1,0,35,34
1657499450918,MATH 20C,A02,083761,Briones; Jor-el Thomas Caparas,8,0,35,27
1657499450918,MATH 20C,A03,093476,Briones; Jor-el Thomas Caparas,0,1,36,36
1657499450918,MATH 20C,B01,083762,Bach; Quang Tran,1,0,30,29
1657499456946,MATH 20D,A01,083765,Tran; Brian Kha,5,0,30,25
1657499456946,MATH 20D,A02,083766,Tran; Brian Kha,5,0,30,25
1657499456946,MATH 20D,A03,083767,Tran; Brian Kha,5,0,30,25
1657499462974,MATH 20E,A01,083771,Ganguly; Soumya,9,0,32,23
1657499462974,MATH 20E,A02,083772,Ganguly; Soumya,6,0,32,26
1657499462974,MATH 20E,B01,083773,Ciotti; Benjamin,20,0,35,15
1657499462974,MATH 20E,B02,083774,Ciotti; Benjamin,17,0,35,18
1657499468998,MATH 103A,A01,083777,Greenfeld; Be'Eri,3,0,36,33
1657499468998,MATH 103A,A02,083778,Greenfeld; Be'Eri,5,0,36,31
1657499468998,MATH 103A,A03,093561,Greenfeld; Be'Eri,5,0,36,31
1657499468998,MATH 103A,B01,083779,Greenfeld; Be'Eri,7,0,36,29
1657499468998,MATH 103A,B02,083780,Greenfeld; Be'Eri,4,0,36,32
1657499468998,MATH 103A,B03,093562,Greenfeld; Be'Eri,3,0,36,33
1657499475023,MATH 105,A01,085443,Carter; Anne Toulson,15,0,35,20
1657499475023,MATH 105,A02,093477,Carter; Anne Toulson,20,0,35,15
1657499481047,MATH 109,A01,083213,Ganzberger; Geoffrey Michael,2,0,34,32
1657499481047,MATH 109,A02,083214,Ganzberger; Geoffrey Michael,4,0,34,30
1657499481047,MATH 109,A03,093478,Ganzberger; Geoffrey Michael,2,0,34,32
1657499481047,MATH 109,B01,083215,Ganzberger; Geoffrey Michael,1,0,32,31
1657499481047,MATH 109,B02,083216,Ganzberger; Geoffrey Michael,2,0,32,30
1657499481047,MATH 109,B03,093479,Ganzberger; Geoffrey Michael,8,0,32,24
1657499487072,MATH 142A,A01,083219,Chow; Bennett,7,0,32,25
1657499487072,MATH 142A,A02,083220,Chow; Bennett,10,0,32,22
1657499487072,MATH 142A,A03,093480,Chow; Bennett,8,0,32,24
1657499487072,MATH 142A,B03,093481,Chow; Bennett,8,0,32,24
1657499487072,MATH 142A,B04,093558,Chow; Bennett,13,0,32,19
1657499487072,MATH 142A,B05,093559,Chow; Bennett,6,0,32,26
1657499493094,MATH 193A,A01,083224,Rotar; Vladimir,8,0,34,26
1657499493094,MATH 193A,A02,083225,Rotar; Vladimir,9,0,34,25
1657499493094,MATH 193A,A03,083781,Rotar; Vladimir,5,0,34,29
1657499493094,MATH 193A,A04,083782,Rotar; Vladimir,10,0,34,24
1657499493094,MATH 193A,A05,093482,Rotar; Vladimir,10,0,34,24
1657499499136,MATH 197,001,091859,McAuley; Julian John,9999,0,9999,0
1657499499136,MATH 197,002,095566,Kedlaya; Kiran S.,9997,0,9999,2
1657499499136,MATH 197,003,095567,Xiao; Ming,9999,0,9999,0
1657499499136,MATH 197,004,095571,Perols; Johan Lars,9998,0,9999,1
1657499506185,COGS 9,A01,083615,Shannon; Kyle Michael,9,0,75,66
1657499512213,COGS 11,A01,083617,Boyle; Mary E. T.,22,0,48,26
1657499518235,COGS 13,A01,083071,Bastos; Amalia Pinkusfeld,11,0,71,60
1657499524262,COGS 14A,A01,092681,Semenuks; Arturs,5,1,100,95
1657499530286,COGS 14B,A01,083073,Cheng; Tzu-Han,6,0,63,57
1657499536309,COGS 17,A01,092677,Semenuks; Arturs,6,0,81,75
1657499542332,COGS 100,A01,083619,Allen; Michael Gordon,17,0,70,53
1657499548359,COGS 101A,A01,083621,Davis; Joshua Daniel,9,0,68,59
1657499554382,COGS 101B,A01,091572,Allen; Michael Gordon,12,0,65,53
1657499560419,COGS 101C,A01,083625,Delgado; Tania,17,0,35,18
1657499566538,COGS 107A,A01,083627,Boyle; Mary E. T.,13,0,60,47
1657499572569,COGS 118A,A01,083075,Gupta; Anjum,21,0,76,55
1657499578593,CSE 3,A50,083646,Miranda; Gregory Joseph,24,0,50,26
1657499584620,CSE 8A,A50,083650,Miranda; Gregory Joseph,17,1,56,39
1657499590644,CSE 11,A01,083080,Cao; Yingjun,6,15,40,34
1657499596675,CSE 12,A01,083652,Krause-Levy; Sophia Louisa,28,1,120,92
1657499602700,CSE 15L,A01,083654,Morris; Justin Loren,9,0,50,41
1657499602700,CSE 15L,A02,083655,Morris; Justin Loren,9,0,50,41
1657499608723,CSE 20,A01,083657,Tran; Khoa Dang,39,0,80,41
1657499614750,CSE 21,A01,095574,Bach; Quang Tran,22,0,48,26
1657499620780,CSE 30,A01,083084,Eldon; John,5,0,80,75
1657499620780,CSE 30,B01,095061,Bhaskar; Nishant,9,0,50,41
1657499626805,CSE 100,A01,083659,Cao; Yingjun,5,4,70,65
1657499632828,CSE 134B,A01,083661,Powell; Thomas Allan,22,0,100,78
1657499638851,CSE 140,A01,083663,Gungor; Onat,15,0,85,70
1657499644876,CSE 140L,A01,083088,Eldon; John,21,0,100,79
1657499650898,CSE 175,A01,083665,Kumar; Rakesh,3,0,25,22
1657499656920,CSE 190,A00,092507,Dubnov; Shlomo,8,0,20,12
1657499662956,ECE 45,A01,083139,Congero; Spencer William,6,0,75,69
1657499669027,ECE 65,A50,083695,Saad; Andrew S,12,0,30,18
1657499669027,ECE 65,A51,095125,Saad; Andrew S,24,0,26,2
1657499675050,ECE 109,A01,091882,Touri; Behrouz,19,0,70,51
1657499681072,ECE 180,A00,083140,Abi Samra; Nicholas Camill,1,0,30,29
1657499681072,ECE 180,B00,083141,Abi Samra; Nicholas Camill,0,0,30,30
1657499687100,MATH 10A,A01,083735,Patchell; Gregory David,2,0,30,28
1657499687100,MATH 10A,A02,083736,Patchell; Gregory David,20,0,30,10
1657499687100,MATH 10A,A03,083737,Patchell; Gregory David,16,0,30,14
1657499693138,MATH 10B,A01,083207,Lim; Seonhee,8,0,34,26
1657499693138,MATH 10B,A02,083208,Lim; Seonhee,9,0,35,26
1657499693138,MATH 10B,A03,093472,Lim; Seonhee,7,0,34,27
1657499693138,MATH 10B,B01,083739,Sinha; Shubham,12,0,30,18
1657499699163,MATH 18,A01,083743,Cinel; Cameron Alexander,7,0,30,23
1657499699163,MATH 18,A02,083744,Cinel; Cameron Alexander,17,0,30,13
1657499699163,MATH 18,A03,083745,Cinel; Cameron Alexander,9,0,30,21
1657499699163,MATH 18,B01,083748,Rideout; David Porter,5,0,37,32
1657499699163,MATH 18,B02,083749,Rideout; David Porter,5,0,36,31
1657499699163,MATH 18,B03,083750,Rideout; David Porter,3,0,37,34
1657499699163,MATH 18,B04,083751,Rideout; David Porter,6,0,36,30
1657499699163,MATH 18,B05,093473,Rideout; David Porter,6,0,36,30
1657499699163,MATH 18,B06,093474,Rideout; David Porter,6,0,36,30
1657499705187,MATH 20A,A01,083754,Zheng; Zequn,14,0,40,26
1657499711212,MATH 20B,A01,083756,Briones; Jor-el Thomas Caparas,4,0,36,32
1657499711212,MATH 20B,A02,083757,Briones; Jor-el Thomas Caparas,1,0,36,35
1657499711212,MATH 20B,A03,093475,Briones; Jor-el Thomas Caparas,2,0,36,34
1657499717241,MATH 20C,A01,083760,Briones; Jor-el Thomas Caparas,1,0,35,34
1657499717241,MATH 20C,A02,083761,Briones; Jor-el Thomas Caparas,8,0,35,27
1657499717241,MATH 20C,A03,093476,Briones; Jor-el Thomas Caparas,0,1,36,36
1657499717241,MATH 20C,B01,083762,Bach; Quang Tran,1,0,30,29
1657499723268,MATH 20D,A01,083765,Tran; Brian Kha,5,0,30,25
1657499723268,MATH 20D,A02,083766,Tran; Brian Kha,5,0,30,25
1657499723268,MATH 20D,A03,083767,Tran; Brian Kha,5,0,30,25
1657499729309,MATH 20E,A01,083771,Ganguly; Soumya,9,0,32,23
1657499729309,MATH 20E,A02,083772,Ganguly; Soumya,6,0,32,26
1657499729309,MATH 20E,B01,083773,Ciotti; Benjamin,20,0,35,15
1657499729309,MATH 20E,B02,083774,Ciotti; Benjamin,17,0,35,18
1657499735336,MATH 103A,A01,083777,Greenfeld; Be'Eri,3,0,36,33
1657499735336,MATH 103A,A02,083778,Greenfeld; Be'Eri,5,0,36,31
1657499735336,MATH 103A,A03,093561,Greenfeld; Be'Eri,5,0,36,31
1657499735336,MATH 103A,B01,083779,Greenfeld; Be'Eri,7,0,36,29
1657499735336,MATH 103A,B02,083780,Greenfeld; Be'Eri,4,0,36,32
1657499735336,MATH 103A,B03,093562,Greenfeld; Be'Eri,3,0,36,33
1657499741362,MATH 105,A01,085443,Carter; Anne Toulson,15,0,35,20
1657499741362,MATH 105,A02,093477,Carter; Anne Toulson,20,0,35,15
1657499747386,MATH 109,A01,083213,Ganzberger; Geoffrey Michael,2,0,34,32
1657499747386,MATH 109,A02,083214,Ganzberger; Geoffrey Michael,4,0,34,30
1657499747386,MATH 109,A03,093478,Ganzberger; Geoffrey Michael,2,0,34,32
1657499747386,MATH 109,B01,083215,Ganzberger; Geoffrey Michael,1,0,32,31
1657499747386,MATH 109,B02,083216,Ganzberger; Geoffrey Michael,2,0,32,30
1657499747386,MATH 109,B03,093479,Ganzberger; Geoffrey Michael,8,0,32,24
1657499753411,MATH 142A,A01,083219,Chow; Bennett,7,0,32,25
1657499753411,MATH 142A,A02,083220,Chow; Bennett,10,0,32,22
1657499753411,MATH 142A,A03,093480,Chow; Bennett,8,0,32,24
1657499753411,MATH 142A,B03,093481,Chow; Bennett,8,0,32,24
1657499753411,MATH 142A,B04,093558,Chow; Bennett,13,0,32,19
1657499753411,MATH 142A,B05,093559,Chow; Bennett,6,0,32,26
1657499759432,MATH 193A,A01,083224,Rotar; Vladimir,8,0,34,26
1657499759432,MATH 193A,A02,083225,Rotar; Vladimir,9,0,34,25
1657499759432,MATH 193A,A03,083781,Rotar; Vladimir,5,0,34,29
1657499759432,MATH 193A,A04,083782,Rotar; Vladimir,10,0,34,24
1657499759432,MATH 193A,A05,093482,Rotar; Vladimir,10,0,34,24
1657499765458,MATH 197,001,091859,McAuley; Julian John,9999,0,9999,0
1657499765458,MATH 197,002,095566,Kedlaya; Kiran S.,9997,0,9999,2
1657499765458,MATH 197,003,095567,Xiao; Ming,9999,0,9999,0
1657499765458,MATH 197,004,095571,Perols; Johan Lars,9998,0,9999,1
1657499772510,COGS 9,A01,083615,Shannon; Kyle Michael,9,0,75,66
1657499778550,COGS 11,A01,083617,Boyle; Mary E. T.,22,0,48,26
1657499784572,COGS 13,A01,083071,Bastos; Amalia Pinkusfeld,11,0,71,60
1657499790596,COGS 14A,A01,092681,Semenuks; Arturs,5,1,100,95
1657499796623,COGS 14B,A01,083073,Cheng; Tzu-Han,6,0,63,57
1657499802651,COGS 17,A01,092677,Semenuks; Arturs,6,0,81,75
1657499808673,COGS 100,A01,083619,Allen; Michael Gordon,17,0,70,53
1657499814700,COGS 101A,A01,083621,Davis; Joshua Daniel,9,0,68,59
1657499820724,COGS 101B,A01,091572,Allen; Michael Gordon,12,0,65,53
1657499826750,COGS 101C,A01,083625,Delgado; Tania,17,0,35,18
1657499832773,COGS 107A,A01,083627,Boyle; Mary E. T.,13,0,60,47
1657499838795,COGS 118A,A01,083075,Gupta; Anjum,21,0,76,55
1657499844823,CSE 3,A50,083646,Miranda; Gregory Joseph,24,0,50,26
1657499850846,CSE 8A,A50,083650,Miranda; Gregory Joseph,17,1,56,39
1657499856871,CSE 11,A01,083080,Cao; Yingjun,6,15,40,34
1657499862895,CSE 12,A01,083652,Krause-Levy; Sophia Louisa,28,1,120,92
1657499868918,CSE 15L,A01,083654,Morris; Justin Loren,9,0,50,41
1657499868918,CSE 15L,A02,083655,Morris; Justin Loren,9,0,50,41
1657499874945,CSE 20,A01,083657,Tran; Khoa Dang,39,0,80,41
1657499880971,CSE 21,A01,095574,Bach; Quang Tran,22,0,48,26
1657499886998,CSE 30,A01,083084,Eldon; John,5,0,80,75
1657499886998,CSE 30,B01,095061,Bhaskar; Nishant,9,0,50,41
1657499893024,CSE 100,A01,083659,Cao; Yingjun,5,4,70,65
1657499899046,CSE 134B,A01,083661,Powell; Thomas Allan,22,0,100,78
1657499905068,CSE 140,A01,083663,Gungor; Onat,15,0,85,70
1657499911095,CSE 140L,A01,083088,Eldon; John,21,0,100,79
1657499917120,CSE 175,A01,083665,Kumar; Rakesh,3,0,25,22
1657499923143,CSE 190,A00,092507,Dubnov; Shlomo,8,0,20,12
1657499929168,ECE 45,A01,083139,Congero; Spencer William,6,0,75,69
1657499935195,ECE 65,A50,083695,Saad; Andrew S,12,0,30,18
1657499935195,ECE 65,A51,095125,Saad; Andrew S,24,0,26,2
1657499941222,ECE 109,A01,091882,Touri; Behrouz,19,0,70,51
1657499947249,ECE 180,A00,083140,Abi Samra; Nicholas Camill,1,0,30,29
1657499947249,ECE 180,B00,083141,Abi Samra; Nicholas Camill,0,0,30,30
1657499953278,MATH 10A,A01,083735,Patchell; Gregory David,2,0,30,28
1657499953278,MATH 10A,A02,083736,Patchell; Gregory David,20,0,30,10
1657499953278,MATH 10A,A03,083737,Patchell; Gregory David,16,0,30,14
1657499959307,MATH 10B,A01,083207,Lim; Seonhee,8,0,34,26
1657499959307,MATH 10B,A02,083208,Lim; Seonhee,9,0,35,26
1657499959307,MATH 10B,A03,093472,Lim; Seonhee,7,0,34,27
1657499959307,MATH 10B,B01,083739,Sinha; Shubham,12,0,30,18
1657499965344,MATH 18,A01,083743,Cinel; Cameron Alexander,7,0,30,23
1657499965344,MATH 18,A02,083744,Cinel; Cameron Alexander,17,0,30,13
1657499965344,MATH 18,A03,083745,Cinel; Cameron Alexander,9,0,30,21
1657499965344,MATH 18,B01,083748,Rideout; David Porter,5,0,37,32
1657499965344,MATH 18,B02,083749,Rideout; David Porter,5,0,36,31
1657499965344,MATH 18,B03,083750,Rideout; David Porter,3,0,37,34
1657499965344,MATH 18,B04,083751,Rideout; David Porter,6,0,36,30
1657499965344,MATH 18,B05,093473,Rideout; David Porter,6,0,36,30
1657499965344,MATH 18,B06,093474,Rideout; David Porter,6,0,36,30
1657499971371,MATH 20A,A01,083754,Zheng; Zequn,14,0,40,26
1657499977399,MATH 20B,A01,083756,Briones; Jor-el Thomas Caparas,4,0,36,32
1657499977399,MATH 20B,A02,083757,Briones; Jor-el Thomas Caparas,1,0,36,35
1657499977399,MATH 20B,A03,093475,Briones; Jor-el Thomas Caparas,2,0,36,34
1657499983425,MATH 20C,A01,083760,Briones; Jor-el Thomas Caparas,1,0,35,34
1657499983425,MATH 20C,A02,083761,Briones; Jor-el Thomas Caparas,8,0,35,27
1657499983425,MATH 20C,A03,093476,Briones; Jor-el Thomas Caparas,0,1,36,36
1657499983425,MATH 20C,B01,083762,Bach; Quang Tran,1,0,30,29
1657499989449,MATH 20D,A01,083765,Tran; Brian Kha,5,0,30,25
1657499989449,MATH 20D,A02,083766,Tran; Brian Kha,5,0,30,25
1657499989449,MATH 20D,A03,083767,Tran; Brian Kha,5,0,30,25
1657499995472,MATH 20E,A01,083771,Ganguly; Soumya,9,0,32,23
1657499995472,MATH 20E,A02,083772,Ganguly; Soumya,6,0,32,26
1657499995472,MATH 20E,B01,083773,Ciotti; Benjamin,20,0,35,15
1657499995472,MATH 20E,B02,083774,Ciotti; Benjamin,17,0,35,18
1657500001497,MATH 103A,A01,083777,Greenfeld; Be'Eri,3,0,36,33
1657500001497,MATH 103A,A02,083778,Greenfeld; Be'Eri,5,0,36,31
1657500001497,MATH 103A,A03,093561,Greenfeld; Be'Eri,5,0,36,31
1657500001497,MATH 103A,B01,083779,Greenfeld; Be'Eri,7,0,36,29
1657500001497,MATH 103A,B02,083780,Greenfeld; Be'Eri,4,0,36,32
1657500001497,MATH 103A,B03,093562,Greenfeld; Be'Eri,3,0,36,33
1657500007525,MATH 105,A01,085443,Carter; Anne Toulson,15,0,35,20
1657500007525,MATH 105,A02,093477,Carter; Anne Toulson,20,0,35,15
1657500013554,MATH 109,A01,083213,Ganzberger; Geoffrey Michael,2,0,34,32
1657500013554,MATH 109,A02,083214,Ganzberger; Geoffrey Michael,4,0,34,30
1657500013554,MATH 109,A03,093478,Ganzberger; Geoffrey Michael,2,0,34,32
1657500013554,MATH 109,B01,083215,Ganzberger; Geoffrey Michael,1,0,32,31
1657500013554,MATH 109,B02,083216,Ganzberger; Geoffrey Michael,2,0,32,30
1657500013554,MATH 109,B03,093479,Ganzberger; Geoffrey Michael,8,0,32,24
1657500019584,MATH 142A,A01,083219,Chow; Bennett,7,0,32,25
1657500019584,MATH 142A,A02,083220,Chow; Bennett,10,0,32,22
1657500019584,MATH 142A,A03,093480,Chow; Bennett,8,0,32,24
1657500019584,MATH 142A,B03,093481,Chow; Bennett,8,0,32,24
1657500019584,MATH 142A,B04,093558,Chow; Bennett,13,0,32,19
1657500019584,MATH 142A,B05,093559,Chow; Bennett,6,0,32,26
1657500025613,MATH 193A,A01,083224,Rotar; Vladimir,8,0,34,26
1657500025613,MATH 193A,A02,083225,Rotar; Vladimir,9,0,34,25
1657500025613,MATH 193A,A03,083781,Rotar; Vladimir,5,0,34,29
1657500025613,MATH 193A,A04,083782,Rotar; Vladimir,10,0,34,24
1657500025613,MATH 193A,A05,093482,Rotar; Vladimir,10,0,34,24
1657500031642,MATH 197,001,091859,McAuley; Julian John,9999,0,9999,0
1657500031642,MATH 197,002,095566,Kedlaya; Kiran S.,9997,0,9999,2
1657500031642,MATH 197,003,095567,Xiao; Ming,9999,0,9999,0
1657500031642,MATH 197,004,095571,Perols; Johan Lars,9998,0,9999,1
1657500038710,COGS 9,A01,083615,Shannon; Kyle Michael,9,0,75,66
1657500044733,COGS 11,A01,083617,Boyle; Mary E. T.,22,0,48,26
1657500050756,COGS 13,A01,083071,Bastos; Amalia Pinkusfeld,11,0,71,60
1657500056785,COGS 14A,A01,092681,Semenuks; Arturs,5,1,100,95
1657500062807,COGS 14B,A01,083073,Cheng; Tzu-Han,6,0,63,57
1657500068845,COGS 17,A01,092677,Semenuks; Arturs,6,0,81,75
1657500074871,COGS 100,A01,083619,Allen; Michael Gordon,17,0,70,53
1657500080897,COGS 101A,A01,083621,Davis; Joshua Daniel,9,0,68,59
1657500086927,COGS 101B,A01,091572,Allen; Michael Gordon,12,0,65,53
1657500092954,COGS 101C,A01,083625,Delgado; Tania,17,0,35,18
1657500098980,COGS 107A,A01,083627,Boyle; Mary E. T.,13,0,60,47
1657500105007,COGS 118A,A01,083075,Gupta; Anjum,21,0,76,55
1657500111041,CSE 3,A50,083646,Miranda; Gregory Joseph,24,0,50,26
1657500117064,CSE 8A,A50,083650,Miranda; Gregory Joseph,17,1,56,39
1657500123088,CSE 11,A01,083080,Cao; Yingjun,6,15,40,34
1657500129110,CSE 12,A01,083652,Krause-Levy; Sophia Louisa,28,1,120,92
1657500135142,CSE 15L,A01,083654,Morris; Justin Loren,9,0,50,41
1657500135142,CSE 15L,A02,083655,Morris; Justin Loren,9,0,50,41
1657500141164,CSE 20,A01,083657,Tran; Khoa Dang,39,0,80,41
1657500147187,CSE 21,A01,095574,Bach; Quang Tran,22,0,48,26
1657500153211,CSE 30,A01,083084,Eldon; John,5,0,80,75
1657500153211,CSE 30,B01,095061,Bhaskar; Nishant,9,0,50,41
1657500159238,CSE 100,A01,083659,Cao; Yingjun,5,4,70,65
1657500165341,CSE 134B,A01,083661,Powell; Thomas Allan,22,0,100,78
1657500171365,CSE 140,A01,083663,Gungor; Onat,15,0,85,70
1657500177388,CSE 140L,A01,083088,Eldon; John,21,0,100,79
1657500183410,CSE 175,A01,083665,Kumar; Rakesh,3,0,25,22
1657500189444,CSE 190,A00,092507,Dubnov; Shlomo,8,0,20,12
1657500195479,ECE 45,A01,083139,Congero; Spencer William,6,0,75,69
1657500201501,ECE 65,A50,083695,Saad; Andrew S,12,0,30,18
1657500201501,ECE 65,A51,095125,Saad; Andrew S,24,0,26,2
1657500207524,ECE 109,A01,091882,Touri; Behrouz,19,0,70,51
1657500213551,ECE 180,A00,083140,Abi Samra; Nicholas Camill,1,0,30,29
1657500213551,ECE 180,B00,083141,Abi Samra; Nicholas Camill,0,0,30,30
1657500219593,MATH 10A,A01,083735,Patchell; Gregory David,2,0,30,28
1657500219593,MATH 10A,A02,083736,Patchell; Gregory David,20,0,30,10
1657500219593,MATH 10A,A03,083737,Patchell; Gregory David,16,0,30,14
1657500225630,MATH 10B,A01,083207,Lim; Seonhee,8,0,34,26
1657500225630,MATH 10B,A02,083208,Lim; Seonhee,9,0,35,26
1657500225630,MATH 10B,A03,093472,Lim; Seonhee,7,0,34,27
1657500225630,MATH 10B,B01,083739,Sinha; Shubham,12,0,30,18
1657500231661,MATH 18,A01,083743,Cinel; Cameron Alexander,7,0,30,23
1657500231661,MATH 18,A02,083744,Cinel; Cameron Alexander,17,0,30,13
1657500231661,MATH 18,A03,083745,Cinel; Cameron Alexander,9,0,30,21
1657500231661,MATH 18,B01,083748,Rideout; David Porter,5,0,37,32
1657500231661,MATH 18,B02,083749,Rideout; David Porter,5,0,36,31
1657500231661,MATH 18,B03,083750,Rideout; David Porter,3,0,37,34
1657500231661,MATH 18,B04,083751,Rideout; David Porter,6,0,36,30
1657500231661,MATH 18,B05,093473,Rideout; David Porter,6,0,36,30
1657500231661,MATH 18,B06,093474,Rideout; David Porter,6,0,36,30
1657500237684,MATH 20A,A01,083754,Zheng; Zequn,14,0,40,26
1657500243707,MATH 20B,A01,083756,Briones; Jor-el Thomas Caparas,4,0,36,32
1657500243707,MATH 20B,A02,083757,Briones; Jor-el Thomas Caparas,1,0,36,35
1657500243707,MATH 20B,A03,093475,Briones; Jor-el Thomas Caparas,2,0,36,34
1657500249736,MATH 20C,A01,083760,Briones; Jor-el Thomas Caparas,1,0,35,34
1657500249736,MATH 20C,A02,083761,Briones; Jor-el Thomas Caparas,8,0,35,27
1657500249736,MATH 20C,A03,093476,Briones; Jor-el Thomas Caparas,0,1,36,36
1657500249736,MATH 20C,B01,083762,Bach; Quang Tran,1,0,30,29
1657500255765,MATH 20D,A01,083765,Tran; Brian Kha,5,0,30,25
1657500255765,MATH 20D,A02,083766,Tran; Brian Kha,5,0,30,25
1657500255765,MATH 20D,A03,083767,Tran; Brian Kha,5,0,30,25
1657500261795,MATH 20E,A01,083771,Ganguly; Soumya,9,0,32,23
1657500261795,MATH 20E,A02,083772,Ganguly; Soumya,6,0,32,26
1657500261795,MATH 20E,B01,083773,Ciotti; Benjamin,20,0,35,15
1657500261795,MATH 20E,B02,083774,Ciotti; Benjamin,17,0,35,18
1657500267826,MATH 103A,A01,083777,Greenfeld; Be'Eri,3,0,36,33
1657500267826,MATH 103A,A02,083778,Greenfeld; Be'Eri,5,0,36,31
1657500267826,MATH 103A,A03,093561,Greenfeld; Be'Eri,5,0,36,31
1657500267826,MATH 103A,B01,083779,Greenfeld; Be'Eri,7,0,36,29
1657500267826,MATH 103A,B02,083780,Greenfeld; Be'Eri,4,0,36,32
1657500267826,MATH 103A,B03,093562,Greenfeld; Be'Eri,3,0,36,33
1657500273847,MATH 105,A01,085443,Carter; Anne Toulson,15,0,35,20
1657500273847,MATH 105,A02,093477,Carter; Anne Toulson,20,0,35,15
1657500279875,MATH 109,A01,083213,Ganzberger; Geoffrey Michael,2,0,34,32
1657500279875,MATH 109,A02,083214,Ganzberger; Geoffrey Michael,4,0,34,30
1657500279875,MATH 109,A03,093478,Ganzberger; Geoffrey Michael,2,0,34,32
1657500279875,MATH 109,B01,083215,Ganzberger; Geoffrey Michael,1,0,32,31
1657500279875,MATH 109,B02,083216,Ganzberger; Geoffrey Michael,2,0,32,30
1657500279875,MATH 109,B03,093479,Ganzberger; Geoffrey Michael,8,0,32,24
1657500285898,MATH 142A,A01,083219,Chow; Bennett,7,0,32,25
1657500285898,MATH 142A,A02,083220,Chow; Bennett,10,0,32,22
1657500285898,MATH 142A,A03,093480,Chow; Bennett,8,0,32,24
1657500285898,MATH 142A,B03,093481,Chow; Bennett,8,0,32,24
1657500285898,MATH 142A,B04,093558,Chow; Bennett,13,0,32,19
1657500285898,MATH 142A,B05,093559,Chow; Bennett,6,0,32,26
1657500291926,MATH 193A,A01,083224,Rotar; Vladimir,8,0,34,26
1657500291926,MATH 193A,A02,083225,Rotar; Vladimir,9,0,34,25
1657500291926,MATH 193A,A03,083781,Rotar; Vladimir,5,0,34,29
1657500291926,MATH 193A,A04,083782,Rotar; Vladimir,10,0,34,24
1657500291926,MATH 193A,A05,093482,Rotar; Vladimir,10,0,34,24
1657500297952,MATH 197,001,091859,McAuley; Julian John,9999,0,9999,0
1657500297952,MATH 197,002,095566,Kedlaya; Kiran S.,9997,0,9999,2
1657500297952,MATH 197,003,095567,Xiao; Ming,9999,0,9999,0
1657500297952,MATH 197,004,095571,Perols; Johan Lars,9998,0,9999,1
1657500305018,COGS 9,A01,083615,Shannon; Kyle Michael,9,0,75,66
1657500311043,COGS 11,A01,083617,Boyle; Mary E. T.,22,0,48,26
1657500317066,COGS 13,A01,083071,Bastos; Amalia Pinkusfeld,11,0,71,60
1657500323089,COGS 14A,A01,092681,Semenuks; Arturs,5,1,100,95
1657500329115,COGS 14B,A01,083073,Cheng; Tzu-Han,6,0,63,57
1657500335148,COGS 17,A01,092677,Semenuks; Arturs,6,0,81,75
1657500341187,COGS 100,A01,083619,Allen; Michael Gordon,17,0,70,53
1657500347214,COGS 101A,A01,083621,Davis; Joshua Daniel,9,0,68,59
1657500353240,COGS 101B,A01,091572,Allen; Michael Gordon,12,0,65,53
1657500359267,COGS 101C,A01,083625,Delgado; Tania,17,0,35,18
1657500365295,COGS 107A,A01,083627,Boyle; Mary E. T.,13,0,60,47
1657500371318,COGS 118A,A01,083075,Gupta; Anjum,21,0,76,55
1657500377347,CSE 3,A50,083646,Miranda; Gregory Joseph,24,0,50,26
1657500383375,CSE 8A,A50,083650,Miranda; Gregory Joseph,17,1,56,39
1657500389397,CSE 11,A01,083080,Cao; Yingjun,6,15,40,34
1657500395422,CSE 12,A01,083652,Krause-Levy; Sophia Louisa,28,1,120,92
1657500401453,CSE 15L,A01,083654,Morris; Justin Loren,9,0,50,41
1657500401453,CSE 15L,A02,083655,Morris; Justin Loren,9,0,50,41
1657500407478,CSE 20,A01,083657,Tran; Khoa Dang,39,0,80,41
1657500413502,CSE 21,A01,095574,Bach; Quang Tran,22,0,48,26
1657500419531,CSE 30,A01,083084,Eldon; John,5,0,80,75
1657500419531,CSE 30,B01,095061,Bhaskar; Nishant,9,0,50,41
1657500425554,CSE 100,A01,083659,Cao; Yingjun,5,4,70,65
1657500431577,CSE 134B,A01,083661,Powell; Thomas Allan,22,0,100,78
1657500437603,CSE 140,A01,083663,Gungor; Onat,15,0,85,70
1657500443632,CSE 140L,A01,083088,Eldon; John,21,0,100,79
1657500449658,CSE 175,A01,083665,Kumar; Rakesh,3,0,25,22
1657500455685,CSE 190,A00,092507,Dubnov; Shlomo,8,0,20,12
1657500461713,ECE 45,A01,083139,Congero; Spencer William,6,0,75,69
1657500467736,ECE 65,A50,083695,Saad; Andrew S,12,0,30,18
1657500467736,ECE 65,A51,095125,Saad; Andrew S,24,0,26,2
1657500473760,ECE 109,A01,091882,Touri; Behrouz,19,0,70,51
1657500479783,ECE 180,A00,083140,Abi Samra; Nicholas Camill,1,0,30,29
1657500479783,ECE 180,B00,083141,Abi Samra; Nicholas Camill,0,0,30,30
1657500485806,MATH 10A,A01,083735,Patchell; Gregory David,2,0,30,28
1657500485806,MATH 10A,A02,083736,Patchell; Gregory David,20,0,30,10
1657500485806,MATH 10A,A03,083737,Patchell; Gregory David,16,0,30,14
1657500491828,MATH 10B,A01,083207,Lim; Seonhee,8,0,34,26
1657500491828,MATH 10B,A02,083208,Lim; Seonhee,9,0,35,26
1657500491828,MATH 10B,A03,093472,Lim; Seonhee,7,0,34,27
1657500491828,MATH 10B,B01,083739,Sinha; Shubham,12,0,30,18
1657500497851,MATH 18,A01,083743,Cinel; Cameron Alexander,7,0,30,23
1657500497851,MATH 18,A02,083744,Cinel; Cameron Alexander,17,0,30,13
1657500497851,MATH 18,A03,083745,Cinel; Cameron Alexander,9,0,30,21
1657500497851,MATH 18,B01,083748,Rideout; David Porter,5,0,37,32
1657500497851,MATH 18,B02,083749,Rideout; David Porter,5,0,36,31
1657500497851,MATH 18,B03,083750,Rideout; David Porter,3,0,37,34
1657500497851,MATH 18,B04,083751,Rideout; David Porter,6,0,36,30
1657500497851,MATH 18,B05,093473,Rideout; David Porter,6,0,36,30
1657500497851,MATH 18,B06,093474,Rideout; David Porter,6,0,36,30
1657500503884,MATH 20A,A01,083754,Zheng; Zequn,14,0,40,26
1657500509907,MATH 20B,A01,083756,Briones; Jor-el Thomas Caparas,4,0,36,32
1657500509907,MATH 20B,A02,083757,Briones; Jor-el Thomas Caparas,1,0,36,35
1657500509907,MATH 20B,A03,093475,Briones; Jor-el Thomas Caparas,2,0,36,34
1657500515955,MATH 20C,A01,083760,Briones; Jor-el Thomas Caparas,1,0,35,34
1657500515955,MATH 20C,A02,083761,Briones; Jor-el Thomas Caparas,8,0,35,27
1657500515955,MATH 20C,A03,093476,Briones; Jor-el Thomas Caparas,0,1,36,36
1657500515955,MATH 20C,B01,083762,Bach; Quang Tran,1,0,30,29
1657500521980,MATH 20D,A01,083765,Tran; Brian Kha,5,0,30,25
1657500521980,MATH 20D,A02,083766,Tran; Brian Kha,5,0,30,25
1657500521980,MATH 20D,A03,083767,Tran; Brian Kha,5,0,30,25
1657500528008,MATH 20E,A01,083771,Ganguly; Soumya,9,0,32,23
1657500528008,MATH 20E,A02,083772,Ganguly; Soumya,6,0,32,26
1657500528008,MATH 20E,B01,083773,Ciotti; Benjamin,20,0,35,15
1657500528008,MATH 20E,B02,083774,Ciotti; Benjamin,17,0,35,18
1657500534036,MATH 103A,A01,083777,Greenfeld; Be'Eri,3,0,36,33
1657500534036,MATH 103A,A02,083778,Greenfeld; Be'Eri,5,0,36,31
1657500534036,MATH 103A,A03,093561,Greenfeld; Be'Eri,5,0,36,31
1657500534036,MATH 103A,B01,083779,Greenfeld; Be'Eri,7,0,36,29
1657500534036,MATH 103A,B02,083780,Greenfeld; Be'Eri,4,0,36,32
1657500534036,MATH 103A,B03,093562,Greenfeld; Be'Eri,3,0,36,33
1657500540064,MATH 105,A01,085443,Carter; Anne Toulson,15,0,35,20
1657500540064,MATH 105,A02,093477,Carter; Anne Toulson,20,0,35,15
1657500546093,MATH 109,A01,083213,Ganzberger; Geoffrey Michael,2,0,34,32
1657500546093,MATH 109,A02,083214,Ganzberger; Geoffrey Michael,4,0,34,30
1657500546093,MATH 109,A03,093478,Ganzberger; Geoffrey Michael,2,0,34,32
1657500546093,MATH 109,B01,083215,Ganzberger; Geoffrey Michael,1,0,32,31
1657500546093,MATH 109,B02,083216,Ganzberger; Geoffrey Michael,2,0,32,30
1657500546093,MATH 109,B03,093479,Ganzberger; Geoffrey Michael,8,0,32,24
1657500552127,MATH 142A,A01,083219,Chow; Bennett,7,0,32,25
1657500552127,MATH 142A,A02,083220,Chow; Bennett,10,0,32,22
1657500552127,MATH 142A,A03,093480,Chow; Bennett,8,0,32,24
1657500552127,MATH 142A,B03,093481,Chow; Bennett,8,0,32,24
1657500552127,MATH 142A,B04,093558,Chow; Bennett,13,0,32,19
1657500552127,MATH 142A,B05,093559,Chow; Bennett,6,0,32,26
1657500558148,MATH 193A,A01,083224,Rotar; Vladimir,8,0,34,26
1657500558148,MATH 193A,A02,083225,Rotar; Vladimir,9,0,34,25
1657500558148,MATH 193A,A03,083781,Rotar; Vladimir,5,0,34,29
1657500558148,MATH 193A,A04,083782,Rotar; Vladimir,10,0,34,24
1657500558148,MATH 193A,A05,093482,Rotar; Vladimir,10,0,34,24
1657500564171,MATH 197,001,091859,McAuley; Julian John,9999,0,9999,0
1657500564171,MATH 197,002,095566,Kedlaya; Kiran S.,9997,0,9999,2
1657500564171,MATH 197,003,095567,Xiao; Ming,9999,0,9999,0
1657500564171,MATH 197,004,095571,Perols; Johan Lars,9998,0,9999,1
1657500571224,COGS 9,A01,083615,Shannon; Kyle Michael,9,0,75,66
1657500577250,COGS 11,A01,083617,Boyle; Mary E. T.,22,0,48,26
1657500583272,COGS 13,A01,083071,Bastos; Amalia Pinkusfeld,11,0,71,60
1657500589297,COGS 14A,A01,092681,Semenuks; Arturs,5,1,100,95
1657500595320,COGS 14B,A01,083073,Cheng; Tzu-Han,6,0,63,57
1657500601349,COGS 17,A01,092677,Semenuks; Arturs,6,0,81,75
1657500607372,COGS 100,A01,083619,Allen; Michael Gordon,17,0,70,53
1657500613400,COGS 101A,A01,083621,Davis; Joshua Daniel,9,0,68,59
1657500619427,COGS 101B,A01,091572,Allen; Michael Gordon,12,0,65,53
1657500625450,COGS 101C,A01,083625,Delgado; Tania,17,0,35,18
1657500631472,COGS 107A,A01,083627,Boyle; Mary E. T.,13,0,60,47
1657500637497,COGS 118A,A01,083075,Gupta; Anjum,21,0,76,55
1657500643524,CSE 3,A50,083646,Miranda; Gregory Joseph,24,0,50,26
1657500649546,CSE 8A,A50,083650,Miranda; Gregory Joseph,17,1,56,39
1657500655569,CSE 11,A01,083080,Cao; Yingjun,6,15,40,34
1657500661595,CSE 12,A01,083652,Krause-Levy; Sophia Louisa,28,1,120,92
1657500667618,CSE 15L,A01,083654,Morris; Justin Loren,9,0,50,41
1657500667618,CSE 15L,A02,083655,Morris; Justin Loren,9,0,50,41
1657500673642,CSE 20,A01,083657,Tran; Khoa Dang,39,0,80,41
1657500679668,CSE 21,A01,095574,Bach; Quang Tran,22,0,48,26
1657500685690,CSE 30,A01,083084,Eldon; John,5,0,80,75
1657500685690,CSE 30,B01,095061,Bhaskar; Nishant,9,0,50,41
1657500691719,CSE 100,A01,083659,Cao; Yingjun,5,4,70,65
1657500697745,CSE 134B,A01,083661,Powell; Thomas Allan,22,0,100,78
1657500703771,CSE 140,A01,083663,Gungor; Onat,15,0,85,70
1657500709798,CSE 140L,A01,083088,Eldon; John,21,0,100,79
1657500715820,CSE 175,A01,083665,Kumar; Rakesh,3,0,25,22
1657500721846,CSE 190,A00,092507,Dubnov; Shlomo,8,0,20,12
1657500727872,ECE 45,A01,083139,Congero; Spencer William,6,0,75,69
1657500733903,ECE 65,A50,083695,Saad; Andrew S,12,0,30,18
1657500733903,ECE 65,A51,095125,Saad; Andrew S,24,0,26,2
1657500739931,ECE 109,A01,091882,Touri; Behrouz,19,0,70,51
1657500745957,ECE 180,A00,083140,Abi Samra; Nicholas Camill,1,0,30,29
1657500745957,ECE 180,B00,083141,Abi Samra; Nicholas Camill,0,0,30,30
1657500751984,MATH 10A,A01,083735,Patchell; Gregory David,2,0,30,28
1657500751984,MATH 10A,A02,083736,Patchell; Gregory David,20,0,30,10
1657500751984,MATH 10A,A03,083737,Patchell; Gregory David,16,0,30,14
1657500758009,MATH 10B,A01,083207,Lim; Seonhee,8,0,34,26
1657500758009,MATH 10B,A02,083208,Lim; Seonhee,9,0,35,26
1657500758009,MATH 10B,A03,093472,Lim; Seonhee,7,0,34,27
1657500758009,MATH 10B,B01,083739,Sinha; Shubham,12,0,30,18
1657500764111,MATH 18,A01,083743,Cinel; Cameron Alexander,7,0,30,23
1657500764111,MATH 18,A02,083744,Cinel; Cameron Alexander,17,0,30,13
1657500764111,MATH 18,A03,083745,Cinel; Cameron Alexander,9,0,30,21
1657500764111,MATH 18,B01,083748,Rideout; David Porter,5,0,37,32
1657500764111,MATH 18,B02,083749,Rideout; David Porter,5,0,36,31
1657500764111,MATH 18,B03,083750,Rideout; David Porter,3,0,37,34
1657500764111,MATH 18,B04,083751,Rideout; David Porter,6,0,36,30
1657500764111,MATH 18,B05,093473,Rideout; David Porter,6,0,36,30
1657500764111,MATH 18,B06,093474,Rideout; David Porter,6,0,36,30
1657500770138,MATH 20A,A01,083754,Zheng; Zequn,14,0,40,26
1657500776161,MATH 20B,A01,083756,Briones; Jor-el Thomas Caparas,4,0,36,32
1657500776161,MATH 20B,A02,083757,Briones; Jor-el Thomas Caparas,1,0,36,35
1657500776161,MATH 20B,A03,093475,Briones; Jor-el Thomas Caparas,2,0,36,34
1657500782186,MATH 20C,A01,083760,Briones; Jor-el Thomas Caparas,1,0,35,34
1657500782186,MATH 20C,A02,083761,Briones; Jor-el Thomas Caparas,8,0,35,27
1657500782186,MATH 20C,A03,093476,Briones; Jor-el Thomas Caparas,0,1,36,36
1657500782186,MATH 20C,B01,083762,Bach; Quang Tran,1,0,30,29
1657500788213,MATH 20D,A01,083765,Tran; Brian Kha,5,0,30,25
1657500788213,MATH 20D,A02,083766,Tran; Brian Kha,5,0,30,25
1657500788213,MATH 20D,A03,083767,Tran; Brian Kha,5,0,30,25
1657500794240,MATH 20E,A01,083771,Ganguly; Soumya,9,0,32,23
1657500794240,MATH 20E,A02,083772,Ganguly; Soumya,6,0,32,26
1657500794240,MATH 20E,B01,083773,Ciotti; Benjamin,20,0,35,15
1657500794240,MATH 20E,B02,083774,Ciotti; Benjamin,17,0,35,18
1657500800264,MATH 103A,A01,083777,Greenfeld; Be'Eri,3,0,36,33
1657500800264,MATH 103A,A02,083778,Greenfeld; Be'Eri,5,0,36,31
1657500800264,MATH 103A,A03,093561,Greenfeld; Be'Eri,5,0,36,31
1657500800264,MATH 103A,B01,083779,Greenfeld; Be'Eri,7,0,36,29
1657500800264,MATH 103A,B02,083780,Greenfeld; Be'Eri,4,0,36,32
1657500800264,MATH 103A,B03,093562,Greenfeld; Be'Eri,3,0,36,33
1657500806290,MATH 105,A01,085443,Carter; Anne Toulson,15,0,35,20
1657500806290,MATH 105,A02,093477,Carter; Anne Toulson,20,0,35,15
1657500812314,MATH 109,A01,083213,Ganzberger; Geoffrey Michael,2,0,34,32
1657500812314,MATH 109,A02,083214,Ganzberger; Geoffrey Michael,4,0,34,30
1657500812314,MATH 109,A03,093478,Ganzberger; Geoffrey Michael,2,0,34,32
1657500812314,MATH 109,B01,083215,Ganzberger; Geoffrey Michael,1,0,32,31
1657500812314,MATH 109,B02,083216,Ganzberger; Geoffrey Michael,2,0,32,30
1657500812314,MATH 109,B03,093479,Ganzberger; Geoffrey Michael,8,0,32,24
1657500818336,MATH 142A,A01,083219,Chow; Bennett,7,0,32,25
1657500818336,MATH 142A,A02,083220,Chow; Bennett,10,0,32,22
1657500818336,MATH 142A,A03,093480,Chow; Bennett,8,0,32,24
1657500818336,MATH 142A,B03,093481,Chow; Bennett,8,0,32,24
1657500818336,MATH 142A,B04,093558,Chow; Bennett,13,0,32,19
1657500818336,MATH 142A,B05,093559,Chow; Bennett,6,0,32,26
1657500824365,MATH 193A,A01,083224,Rotar; Vladimir,8,0,34,26
1657500824365,MATH 193A,A02,083225,Rotar; Vladimir,9,0,34,25
1657500824365,MATH 193A,A03,083781,Rotar; Vladimir,5,0,34,29
1657500824365,MATH 193A,A04,083782,Rotar; Vladimir,10,0,34,24
1657500824365,MATH 193A,A05,093482,Rotar; Vladimir,10,0,34,24
1657500830389,MATH 197,001,091859,McAuley; Julian John,9999,0,9999,0
1657500830389,MATH 197,002,095566,Kedlaya; Kiran S.,9997,0,9999,2
1657500830389,MATH 197,003,095567,Xiao; Ming,9999,0,9999,0
1657500830389,MATH 197,004,095571,Perols; Johan Lars,9998,0,9999,1
1657500837440,COGS 9,A01,083615,Shannon; Kyle Michael,9,0,75,66
1657500843466,COGS 11,A01,083617,Boyle; Mary E. T.,22,0,48,26
1657500849493,COGS 13,A01,083071,Bastos; Amalia Pinkusfeld,11,0,71,60
1657500855516,COGS 14A,A01,092681,Semenuks; Arturs,5,1,100,95
1657500861543,COGS 14B,A01,083073,Cheng; Tzu-Han,6,0,63,57
1657500867569,COGS 17,A01,092677,Semenuks; Arturs,6,0,81,75
1657500873591,COGS 100,A01,083619,Allen; Michael Gordon,17,0,70,53
1657500879616,COGS 101A,A01,083621,Davis; Joshua Daniel,9,0,68,59
1657500885639,COGS 101B,A01,091572,Allen; Michael Gordon,12,0,65,53
1657500891666,COGS 101C,A01,083625,Delgado; Tania,17,0,35,18
1657500897690,COGS 107A,A01,083627,Boyle; Mary E. T.,13,0,60,47
1657500903718,COGS 118A,A01,083075,Gupta; Anjum,21,0,76,55
1657500909741,CSE 3,A50,083646,Miranda; Gregory Joseph,24,0,50,26
1657500915766,CSE 8A,A50,083650,Miranda; Gregory Joseph,17,1,56,39
1657500921790,CSE 11,A01,083080,Cao; Yingjun,6,15,40,34
1657500927817,CSE 12,A01,083652,Krause-Levy; Sophia Louisa,28,1,120,92
1657500933842,CSE 15L,A01,083654,Morris; Justin Loren,9,0,50,41
1657500933842,CSE 15L,A02,083655,Morris; Justin Loren,9,0,50,41
1657500939865,CSE 20,A01,083657,Tran; Khoa Dang,39,0,80,41
1657500945890,CSE 21,A01,095574,Bach; Quang Tran,22,0,48,26
1657500951921,CSE 30,A01,083084,Eldon; John,5,0,80,75
1657500951921,CSE 30,B01,095061,Bhaskar; Nishant,9,0,50,41
1657500957943,CSE 100,A01,083659,Cao; Yingjun,5,4,70,65
1657500963972,CSE 134B,A01,083661,Powell; Thomas Allan,22,0,100,78
1657500969997,CSE 140,A01,083663,Gungor; Onat,15,0,85,70
1657500976022,CSE 140L,A01,083088,Eldon; John,21,0,100,79
1657500982049,CSE 175,A01,083665,Kumar; Rakesh,3,0,25,22
1657500988073,CSE 190,A00,092507,Dubnov; Shlomo,8,0,20,12
1657500994100,ECE 45,A01,083139,Congero; Spencer William,6,0,75,69
1657501000139,ECE 65,A50,083695,Saad; Andrew S,12,0,30,18
1657501000139,ECE 65,A51,095125,Saad; Andrew S,24,0,26,2
1657501006166,ECE 109,A01,091882,Touri; Behrouz,19,0,70,51
1657501012206,ECE 180,A00,083140,Abi Samra; Nicholas Camill,1,0,30,29
1657501012206,ECE 180,B00,083141,Abi Samra; Nicholas Camill,0,0,30,30
1657501018234,MATH 10A,A01,083735,Patchell; Gregory David,2,0,30,28
1657501018234,MATH 10A,A02,083736,Patchell; Gregory David,20,0,30,10
1657501018234,MATH 10A,A03,083737,Patchell; Gregory David,16,0,30,14
1657501024257,MATH 10B,A01,083207,Lim; Seonhee,8,0,34,26
1657501024257,MATH 10B,A02,083208,Lim; Seonhee,9,0,35,26
1657501024257,MATH 10B,A03,093472,Lim; Seonhee,7,0,34,27
1657501024257,MATH 10B,B01,083739,Sinha; Shubham,12,0,30,18
1657501030284,MATH 18,A01,083743,Cinel; Cameron Alexander,7,0,30,23
1657501030284,MATH 18,A02,083744,Cinel; Cameron Alexander,17,0,30,13
1657501030284,MATH 18,A03,083745,Cinel; Cameron Alexander,9,0,30,21
1657501030284,MATH 18,B01,083748,Rideout; David Porter,5,0,37,32
1657501030284,MATH 18,B02,083749,Rideout; David Porter,5,0,36,31
1657501030284,MATH 18,B03,083750,Rideout; David Porter,3,0,37,34
1657501030284,MATH 18,B04,083751,Rideout; David Porter,6,0,36,30
1657501030284,MATH 18,B05,093473,Rideout; David Porter,6,0,36,30
1657501030284,MATH 18,B06,093474,Rideout; David Porter,6,0,36,30
1657501036307,MATH 20A,A01,083754,Zheng; Zequn,14,0,40,26
1657501042334,MATH 20B,A01,083756,Briones; Jor-el Thomas Caparas,4,0,36,32
1657501042334,MATH 20B,A02,083757,Briones; Jor-el Thomas Caparas,1,0,36,35
1657501042334,MATH 20B,A03,093475,Briones; Jor-el Thomas Caparas,2,0,36,34
1657501048359,MATH 20C,A01,083760,Briones; Jor-el Thomas Caparas,1,0,35,34
1657501048359,MATH 20C,A02,083761,Briones; Jor-el Thomas Caparas,8,0,35,27
1657501048359,MATH 20C,A03,093476,Briones; Jor-el Thomas Caparas,0,1,36,36
1657501048359,MATH 20C,B01,083762,Bach; Quang Tran,1,0,30,29
1657501054475,MATH 20D,A01,083765,Tran; Brian Kha,5,0,30,25
1657501054475,MATH 20D,A02,083766,Tran; Brian Kha,5,0,30,25
1657501054475,MATH 20D,A03,083767,Tran; Brian Kha,5,0,30,25
1657501060504,MATH 20E,A01,083771,Ganguly; Soumya,9,0,32,23
1657501060504,MATH 20E,A02,083772,Ganguly; Soumya,6,0,32,26
1657501060504,MATH 20E,B01,083773,Ciotti; Benjamin,20,0,35,15
1657501060504,MATH 20E,B02,083774,Ciotti; Benjamin,17,0,35,18
1657501066529,MATH 103A,A01,083777,Greenfeld; Be'Eri,3,0,36,33
1657501066529,MATH 103A,A02,083778,Greenfeld; Be'Eri,5,0,36,31
1657501066529,MATH 103A,A03,093561,Greenfeld; Be'Eri,5,0,36,31
1657501066529,MATH 103A,B01,083779,Greenfeld; Be'Eri,7,0,36,29
1657501066529,MATH 103A,B02,083780,Greenfeld; Be'Eri,4,0,36,32
1657501066529,MATH 103A,B03,093562,Greenfeld; Be'Eri,3,0,36,33
1657501072553,MATH 105,A01,085443,Carter; Anne Toulson,15,0,35,20
1657501072553,MATH 105,A02,093477,Carter; Anne Toulson,20,0,35,15
1657501078582,MATH 109,A01,083213,Ganzberger; Geoffrey Michael,2,0,34,32
1657501078582,MATH 109,A02,083214,Ganzberger; Geoffrey Michael,4,0,34,30
1657501078582,MATH 109,A03,093478,Ganzberger; Geoffrey Michael,2,0,34,32
1657501078582,MATH 109,B01,083215,Ganzberger; Geoffrey Michael,1,0,32,31
1657501078582,MATH 109,B02,083216,Ganzberger; Geoffrey Michael,2,0,32,30
1657501078582,MATH 109,B03,093479,Ganzberger; Geoffrey Michael,8,0,32,24
1657501084616,MATH 142A,A01,083219,Chow; Bennett,7,0,32,25
1657501084616,MATH 142A,A02,083220,Chow; Bennett,10,0,32,22
1657501084616,MATH 142A,A03,093480,Chow; Bennett,8,0,32,24
1657501084616,MATH 142A,B03,093481,Chow; Bennett,8,0,32,24
1657501084616,MATH 142A,B04,093558,Chow; Bennett,13,0,32,19
1657501084616,MATH 142A,B05,093559,Chow; Bennett,6,0,32,26
1657501090645,MATH 193A,A01,083224,Rotar; Vladimir,8,0,34,26
1657501090645,MATH 193A,A02,083225,Rotar; Vladimir,9,0,34,25
1657501090645,MATH 193A,A03,083781,Rotar; Vladimir,5,0,34,29
1657501090645,MATH 193A,A04,083782,Rotar; Vladimir,10,0,34,24
1657501090645,MATH 193A,A05,093482,Rotar; Vladimir,10,0,34,24
1657501096667,MATH 197,001,091859,McAuley; Julian John,9999,0,9999,0
1657501096667,MATH 197,002,095566,Kedlaya; Kiran S.,9997,0,9999,2
1657501096667,MATH 197,003,095567,Xiao; Ming,9999,0,9999,0
1657501096667,MATH 197,004,095571,Perols; Johan Lars,9998,0,9999,1
1657501103732,COGS 9,A01,083615,Shannon; Kyle Michael,9,0,75,66
1657501109755,COGS 11,A01,083617,Boyle; Mary E. T.,22,0,48,26
1657501115783,COGS 13,A01,083071,Bastos; Amalia Pinkusfeld,11,0,71,60
1657501121807,COGS 14A,A01,092681,Semenuks; Arturs,5,1,100,95
1657501127830,COGS 14B,A01,083073,Cheng; Tzu-Han,6,0,63,57
1657501133856,COGS 17,A01,092677,Semenuks; Arturs,6,0,81,75
1657501139883,COGS 100,A01,083619,Allen; Michael Gordon,17,0,70,53
1657501145906,COGS 101A,A01,083621,Davis; Joshua Daniel,9,0,68,59
1657501151941,COGS 101B,A01,091572,Allen; Michael Gordon,12,0,65,53
1657501157966,COGS 101C,A01,083625,Delgado; Tania,17,0,35,18
1657501163993,COGS 107A,A01,083627,Boyle; Mary E. T.,13,0,60,47
1657501170016,COGS 118A,A01,083075,Gupta; Anjum,21,0,76,55
1657501176040,CSE 3,A50,083646,Miranda; Gregory Joseph,24,0,50,26
1657501182066,CSE 8A,A50,083650,Miranda; Gregory Joseph,17,1,56,39
1657501188089,CSE 11,A01,083080,Cao; Yingjun,6,15,40,34
1657501194118,CSE 12,A01,083652,Krause-Levy; Sophia Louisa,28,1,120,92
1657501200141,CSE 15L,A01,083654,Morris; Justin Loren,9,0,50,41
1657501200141,CSE 15L,A02,083655,Morris; Justin Loren,9,0,50,41
1657501206167,CSE 20,A01,083657,Tran; Khoa Dang,39,0,80,41
1657501212189,CSE 21,A01,095574,Bach; Quang Tran,22,0,48,26
1657501218216,CSE 30,A01,083084,Eldon; John,5,0,80,75
1657501218216,CSE 30,B01,095061,Bhaskar; Nishant,9,0,50,41
1657501224242,CSE 100,A01,083659,Cao; Yingjun,5,4,70,65
1657501230264,CSE 134B,A01,083661,Powell; Thomas Allan,22,0,100,78
1657501236296,CSE 140,A01,083663,Gungor; Onat,15,0,85,70
1657501242319,CSE 140L,A01,083088,Eldon; John,21,0,100,79
1657501248350,CSE 175,A01,083665,Kumar; Rakesh,3,0,25,22
1657501254372,CSE 190,A00,092507,Dubnov; Shlomo,8,0,20,12
1657501260395,ECE 45,A01,083139,Congero; Spencer William,6,0,75,69
1657501266421,ECE 65,A50,083695,Saad; Andrew S,12,0,30,18
1657501266421,ECE 65,A51,095125,Saad; Andrew S,24,0,26,2
1657501272448,ECE 109,A01,091882,Touri; Behrouz,19,0,70,51
1657501278475,ECE 180,A00,083140,Abi Samra; Nicholas Camill,1,0,30,29
1657501278475,ECE 180,B00,083141,Abi Samra; Nicholas Camill,0,0,30,30
1657501284503,MATH 10A,A01,083735,Patchell; Gregory David,2,0,30,28
1657501284503,MATH 10A,A02,083736,Patchell; Gregory David,20,0,30,10
1657501284503,MATH 10A,A03,083737,Patchell; Gregory David,16,0,30,14
1657501290533,MATH 10B,A01,083207,Lim; Seonhee,8,0,34,26
1657501290533,MATH 10B,A02,083208,Lim; Seonhee,9,0,35,26
1657501290533,MATH 10B,A03,093472,Lim; Seonhee,7,0,34,27
1657501290533,MATH 10B,B01,083739,Sinha; Shubham,12,0,30,18
1657501296565,MATH 18,A01,083743,Cinel; Cameron Alexander,7,0,30,23
1657501296565,MATH 18,A02,083744,Cinel; Cameron Alexander,17,0,30,13
1657501296565,MATH 18,A03,083745,Cinel; Cameron Alexander,9,0,30,21
1657501296565,MATH 18,B01,083748,Rideout; David Porter,5,0,37,32
1657501296565,MATH 18,B02,083749,Rideout; David Porter,5,0,36,31
1657501296565,MATH 18,B03,083750,Rideout; David Porter,3,0,37,34
1657501296565,MATH 18,B04,083751,Rideout; David Porter,6,0,36,30
1657501296565,MATH 18,B05,093473,Rideout; David Porter,6,0,36,30
1657501296565,MATH 18,B06,093474,Rideout; David Porter,6,0,36,30
1657501302591,MATH 20A,A01,083754,Zheng; Zequn,14,0,40,26
1657501308612,MATH 20B,A01,083756,Briones; Jor-el Thomas Caparas,4,0,36,32
1657501308612,MATH 20B,A02,083757,Briones; Jor-el Thomas Caparas,1,0,36,35
1657501308612,MATH 20B,A03,093475,Briones; Jor-el Thomas Caparas,2,0,36,34
1657501314636,MATH 20C,A01,083760,Briones; Jor-el Thomas Caparas,1,0,35,34
1657501314636,MATH 20C,A02,083761,Briones; Jor-el Thomas Caparas,8,0,35,27
1657501314636,MATH 20C,A03,093476,Briones; Jor-el Thomas Caparas,0,1,36,36
1657501314636,MATH 20C,B01,083762,Bach; Quang Tran,1,0,30,29
1657501320660,MATH 20D,A01,083765,Tran; Brian Kha,5,0,30,25
1657501320660,MATH 20D,A02,083766,Tran; Brian Kha,5,0,30,25
1657501320660,MATH 20D,A03,083767,Tran; Brian Kha,5,0,30,25
1657501326682,MATH 20E,A01,083771,Ganguly; Soumya,9,0,32,23
1657501326682,MATH 20E,A02,083772,Ganguly; Soumya,6,0,32,26
1657501326682,MATH 20E,B01,083773,Ciotti; Benjamin,20,0,35,15
1657501326682,MATH 20E,B02,083774,Ciotti; Benjamin,17,0,35,18
1657501332707,MATH 103A,A01,083777,Greenfeld; Be'Eri,3,0,36,33
1657501332707,MATH 103A,A02,083778,Greenfeld; Be'Eri,5,0,36,31
1657501332707,MATH 103A,A03,093561,Greenfeld; Be'Eri,5,0,36,31
1657501332707,MATH 103A,B01,083779,Greenfeld; Be'Eri,7,0,36,29
1657501332707,MATH 103A,B02,083780,Greenfeld; Be'Eri,4,0,36,32
1657501332707,MATH 103A,B03,093562,Greenfeld; Be'Eri,3,0,36,33
1657501338729,MATH 105,A01,085443,Carter; Anne Toulson,15,0,35,20
1657501338729,MATH 105,A02,093477,Carter; Anne Toulson,20,0,35,15
1657501344753,MATH 109,A01,083213,Ganzberger; Geoffrey Michael,2,0,34,32
1657501344753,MATH 109,A02,083214,Ganzberger; Geoffrey Michael,4,0,34,30
1657501344753,MATH 109,A03,093478,Ganzberger; Geoffrey Michael,2,0,34,32
1657501344753,MATH 109,B01,083215,Ganzberger; Geoffrey Michael,1,0,32,31
1657501344753,MATH 109,B02,083216,Ganzberger; Geoffrey Michael,2,0,32,30
1657501344753,MATH 109,B03,093479,Ganzberger; Geoffrey Michael,8,0,32,24
1657501350777,MATH 142A,A01,083219,Chow; Bennett,7,0,32,25
1657501350777,MATH 142A,A02,083220,Chow; Bennett,10,0,32,22
1657501350777,MATH 142A,A03,093480,Chow; Bennett,8,0,32,24
1657501350777,MATH 142A,B03,093481,Chow; Bennett,8,0,32,24
1657501350777,MATH 142A,B04,093558,Chow; Bennett,13,0,32,19
1657501350777,MATH 142A,B05,093559,Chow; Bennett,6,0,32,26
1657501356806,MATH 193A,A01,083224,Rotar; Vladimir,8,0,34,26
1657501356806,MATH 193A,A02,083225,Rotar; Vladimir,9,0,34,25
1657501356806,MATH 193A,A03,083781,Rotar; Vladimir,5,0,34,29
1657501356806,MATH 193A,A04,083782,Rotar; Vladimir,10,0,34,24
1657501356806,MATH 193A,A05,093482,Rotar; Vladimir,10,0,34,24
1657501362901,MATH 197,001,091859,McAuley; Julian John,9999,0,9999,0
1657501362901,MATH 197,002,095566,Kedlaya; Kiran S.,9997,0,9999,2
1657501362901,MATH 197,003,095567,Xiao; Ming,9999,0,9999,0
1657501362901,MATH 197,004,095571,Perols; Johan Lars,9998,0,9999,1
1657501369966,COGS 9,A01,083615,Shannon; Kyle Michael,9,0,75,66
1657501375989,COGS 11,A01,083617,Boyle; Mary E. T.,22,0,48,26
1657501382014,COGS 13,A01,083071,Bastos; Amalia Pinkusfeld,11,0,71,60
1657501388037,COGS 14A,A01,092681,Semenuks; Arturs,5,1,100,95
1657501394062,COGS 14B,A01,083073,Cheng; Tzu-Han,6,0,63,57
1657501400089,COGS 17,A01,092677,Semenuks; Arturs,6,0,81,75
1657501406111,COGS 100,A01,083619,Allen; Michael Gordon,17,0,70,53
1657501412133,COGS 101A,A01,083621,Davis; Joshua Daniel,9,0,68,59
1657501418159,COGS 101B,A01,091572,Allen; Michael Gordon,12,0,65,53
1657501424182,COGS 101C,A01,083625,Delgado; Tania,17,0,35,18
1657501430220,COGS 107A,A01,083627,Boyle; Mary E. T.,13,0,60,47
1657501436243,COGS 118A,A01,083075,Gupta; Anjum,21,0,76,55
1657501442265,CSE 3,A50,083646,Miranda; Gregory Joseph,24,0,50,26
1657501448288,CSE 8A,A50,083650,Miranda; Gregory Joseph,17,1,56,39
1657501454313,CSE 11,A01,083080,Cao; Yingjun,6,15,40,34
1657501460337,CSE 12,A01,083652,Krause-Levy; Sophia Louisa,28,1,120,92
1657501466365,CSE 15L,A01,083654,Morris; Justin Loren,9,0,50,41
1657501466365,CSE 15L,A02,083655,Morris; Justin Loren,9,0,50,41
1657501472390,CSE 20,A01,083657,Tran; Khoa Dang,39,0,80,41
1657501478416,CSE 21,A01,095574,Bach; Quang Tran,22,0,48,26
1657501484448,CSE 30,A01,083084,Eldon; John,5,0,80,75
1657501484448,CSE 30,B01,095061,Bhaskar; Nishant,9,0,50,41
1657501490472,CSE 100,A01,083659,Cao; Yingjun,5,4,70,65
1657501496495,CSE 134B,A01,083661,Powell; Thomas Allan,22,0,100,78
1657501502519,CSE 140,A01,083663,Gungor; Onat,15,0,85,70
1657501508546,CSE 140L,A01,083088,Eldon; John,21,0,100,79
1657501514569,CSE 175,A01,083665,Kumar; Rakesh,3,0,25,22
1657501520597,CSE 190,A00,092507,Dubnov; Shlomo,8,0,20,12
1657501526623,ECE 45,A01,083139,Congero; Spencer William,6,0,75,69
1657501532652,ECE 65,A50,083695,Saad; Andrew S,12,0,30,18
1657501532652,ECE 65,A51,095125,Saad; Andrew S,24,0,26,2
1657501538679,ECE 109,A01,091882,Touri; Behrouz,19,0,70,51
1657501544706,ECE 180,A00,083140,Abi Samra; Nicholas Camill,1,0,30,29
1657501544706,ECE 180,B00,083141,Abi Samra; Nicholas Camill,0,0,30,30
1657501550731,MATH 10A,A01,083735,Patchell; Gregory David,2,0,30,28
1657501550731,MATH 10A,A02,083736,Patchell; Gregory David,20,0,30,10
1657501550731,MATH 10A,A03,083737,Patchell; Gregory David,16,0,30,14
1657501556761,MATH 10B,A01,083207,Lim; Seonhee,8,0,34,26
1657501556761,MATH 10B,A02,083208,Lim; Seonhee,9,0,35,26
1657501556761,MATH 10B,A03,093472,Lim; Seonhee,7,0,34,27
1657501556761,MATH 10B,B01,083739,Sinha; Shubham,12,0,30,18
1657501562796,MATH 18,A01,083743,Cinel; Cameron Alexander,7,0,30,23
1657501562796,MATH 18,A02,083744,Cinel; Cameron Alexander,17,0,30,13
1657501562796,MATH 18,A03,083745,Cinel; Cameron Alexander,9,0,30,21
1657501562796,MATH 18,B01,083748,Rideout; David Porter,5,0,37,32
1657501562796,MATH 18,B02,083749,Rideout; David Porter,5,0,36,31
1657501562796,MATH 18,B03,083750,Rideout; David Porter,3,0,37,34
1657501562796,MATH 18,B04,083751,Rideout; David Porter,6,0,36,30
1657501562796,MATH 18,B05,093473,Rideout; David Porter,6,0,36,30
1657501562796,MATH 18,B06,093474,Rideout; David Porter,6,0,36,30
1657501568819,MATH 20A,A01,083754,Zheng; Zequn,14,0,40,26
1657501574852,MATH 20B,A01,083756,Briones; Jor-el Thomas Caparas,4,0,36,32
1657501574852,MATH 20B,A02,083757,Briones; Jor-el Thomas Caparas,1,0,36,35
1657501574852,MATH 20B,A03,093475,Briones; Jor-el Thomas Caparas,2,0,36,34
1657501580880,MATH 20C,A01,083760,Briones; Jor-el Thomas Caparas,1,0,35,34
1657501580880,MATH 20C,A02,083761,Briones; Jor-el Thomas Caparas,8,0,35,27
1657501580880,MATH 20C,A03,093476,Briones; Jor-el Thomas Caparas,0,1,36,36
1657501580880,MATH 20C,B01,083762,Bach; Quang Tran,1,0,30,29
1657501586904,MATH 20D,A01,083765,Tran; Brian Kha,5,0,30,25
1657501586904,MATH 20D,A02,083766,Tran; Brian Kha,5,0,30,25
1657501586904,MATH 20D,A03,083767,Tran; Brian Kha,5,0,30,25
1657501592925,MATH 20E,A01,083771,Ganguly; Soumya,9,0,32,23
1657501592925,MATH 20E,A02,083772,Ganguly; Soumya,6,0,32,26
1657501592925,MATH 20E,B01,083773,Ciotti; Benjamin,20,0,35,15
1657501592925,MATH 20E,B02,083774,Ciotti; Benjamin,17,0,35,18
1657501598950,MATH 103A,A01,083777,Greenfeld; Be'Eri,3,0,36,33
1657501598950,MATH 103A,A02,083778,Greenfeld; Be'Eri,5,0,36,31
1657501598950,MATH 103A,A03,093561,Greenfeld; Be'Eri,5,0,36,31
1657501598950,MATH 103A,B01,083779,Greenfeld; Be'Eri,7,0,36,29
1657501598950,MATH 103A,B02,083780,Greenfeld; Be'Eri,4,0,36,32
1657501598950,MATH 103A,B03,093562,Greenfeld; Be'Eri,3,0,36,33
1657501604975,MATH 105,A01,085443,Carter; Anne Toulson,15,0,35,20
1657501604975,MATH 105,A02,093477,Carter; Anne Toulson,20,0,35,15
1657501610998,MATH 109,A01,083213,Ganzberger; Geoffrey Michael,2,0,34,32
1657501610998,MATH 109,A02,083214,Ganzberger; Geoffrey Michael,4,0,34,30
1657501610998,MATH 109,A03,093478,Ganzberger; Geoffrey Michael,2,0,34,32
1657501610998,MATH 109,B01,083215,Ganzberger; Geoffrey Michael,1,0,32,31
1657501610998,MATH 109,B02,083216,Ganzberger; Geoffrey Michael,2,0,32,30
1657501610998,MATH 109,B03,093479,Ganzberger; Geoffrey Michael,8,0,32,24
1657501617029,MATH 142A,A01,083219,Chow; Bennett,7,0,32,25
1657501617029,MATH 142A,A02,083220,Chow; Bennett,10,0,32,22
1657501617029,MATH 142A,A03,093480,Chow; Bennett,8,0,32,24
1657501617029,MATH 142A,B03,093481,Chow; Bennett,8,0,32,24
1657501617029,MATH 142A,B04,093558,Chow; Bennett,13,0,32,19
1657501617029,MATH 142A,B05,093559,Chow; Bennett,6,0,32,26
1657501623054,MATH 193A,A01,083224,Rotar; Vladimir,8,0,34,26
1657501623054,MATH 193A,A02,083225,Rotar; Vladimir,9,0,34,25
1657501623054,MATH 193A,A03,083781,Rotar; Vladimir,5,0,34,29
1657501623054,MATH 193A,A04,083782,Rotar; Vladimir,10,0,34,24
1657501623054,MATH 193A,A05,093482,Rotar; Vladimir,10,0,34,24
1657501629082,MATH 197,001,091859,McAuley; Julian John,9999,0,9999,0
1657501629082,MATH 197,002,095566,Kedlaya; Kiran S.,9997,0,9999,2
1657501629082,MATH 197,003,095567,Xiao; Ming,9999,0,9999,0
1657501629082,MATH 197,004,095571,Perols; Johan Lars,9998,0,9999,1
1657501636158,COGS 9,A01,083615,Shannon; Kyle Michael,9,0,75,66
1657501642179,COGS 11,A01,083617,Boyle; Mary E. T.,22,0,48,26
1657501648203,COGS 13,A01,083071,Bastos; Amalia Pinkusfeld,11,0,71,60
1657501654229,COGS 14A,A01,092681,Semenuks; Arturs,5,1,100,95
1657501660257,COGS 14B,A01,083073,Cheng; Tzu-Han,6,0,63,57
1657501666280,COGS 17,A01,092677,Semenuks; Arturs,6,0,81,75
1657501672301,COGS 100,A01,083619,Allen; Michael Gordon,17,0,70,53
1657501678329,COGS 101A,A01,083621,Davis; Joshua Daniel,9,0,68,59
1657501684353,COGS 101B,A01,091572,Allen; Michael Gordon,12,0,65,53
1657501690377,COGS 101C,A01,083625,Delgado; Tania,17,0,35,18
1657501696403,COGS 107A,A01,083627,Boyle; Mary E. T.,13,0,60,47
1657501702426,COGS 118A,A01,083075,Gupta; Anjum,21,0,76,55
1657501708453,CSE 3,A50,083646,Miranda; Gregory Joseph,24,0,50,26
1657501714481,CSE 8A,A50,083650,Miranda; Gregory Joseph,17,1,56,39
1657501720504,CSE 11,A01,083080,Cao; Yingjun,6,15,40,34
1657501726531,CSE 12,A01,083652,Krause-Levy; Sophia Louisa,28,1,120,92
1657501732559,CSE 15L,A01,083654,Morris; Justin Loren,9,0,50,41
1657501732559,CSE 15L,A02,083655,Morris; Justin Loren,9,0,50,41
1657501738586,CSE 20,A01,083657,Tran; Khoa Dang,39,0,80,41
1657501744607,CSE 21,A01,095574,Bach; Quang Tran,22,0,48,26
1657501750633,CSE 30,A01,083084,Eldon; John,5,0,80,75
1657501750633,CSE 30,B01,095061,Bhaskar; Nishant,9,0,50,41
1657501756687,CSE 100,A01,083659,Cao; Yingjun,5,4,70,65
1657501762710,CSE 134B,A01,083661,Powell; Thomas Allan,22,0,100,78
1657501768733,CSE 140,A01,083663,Gungor; Onat,15,0,85,70
1657501774754,CSE 140L,A01,083088,Eldon; John,21,0,100,79
1657501780779,CSE 175,A01,083665,Kumar; Rakesh,3,0,25,22
1657501786803,CSE 190,A00,092507,Dubnov; Shlomo,8,0,20,12
1657501792828,ECE 45,A01,083139,Congero; Spencer William,6,0,75,69
1657501798851,ECE 65,A50,083695,Saad; Andrew S,12,0,30,18
1657501798851,ECE 65,A51,095125,Saad; Andrew S,24,0,26,2
1657501804876,ECE 109,A01,091882,Touri; Behrouz,19,0,70,51
1657501810899,ECE 180,A00,083140,Abi Samra; Nicholas Camill,1,0,30,29
1657501810899,ECE 180,B00,083141,Abi Samra; Nicholas Camill,0,0,30,30
1657501816923,MATH 10A,A01,083735,Patchell; Gregory David,2,0,30,28
1657501816923,MATH 10A,A02,083736,Patchell; Gregory David,20,0,30,10
1657501816923,MATH 10A,A03,083737,Patchell; Gregory David,16,0,30,14
1657501822948,MATH 10B,A01,083207,Lim; Seonhee,8,0,34,26
1657501822948,MATH 10B,A02,083208,Lim; Seonhee,9,0,35,26
1657501822948,MATH 10B,A03,093472,Lim; Seonhee,7,0,34,27
1657501822948,MATH 10B,B01,083739,Sinha; Shubham,12,0,30,18
1657501828973,MATH 18,A01,083743,Cinel; Cameron Alexander,7,0,30,23
1657501828973,MATH 18,A02,083744,Cinel; Cameron Alexander,17,0,30,13
1657501828973,MATH 18,A03,083745,Cinel; Cameron Alexander,9,0,30,21
1657501828973,MATH 18,B01,083748,Rideout; David Porter,5,0,37,32
1657501828973,MATH 18,B02,083749,Rideout; David Porter,5,0,36,31
1657501828973,MATH 18,B03,083750,Rideout; David Porter,3,0,37,34
1657501828973,MATH 18,B04,083751,Rideout; David Porter,6,0,36,30
1657501828973,MATH 18,B05,093473,Rideout; David Porter,6,0,36,30
1657501828973,MATH 18,B06,093474,Rideout; David Porter,6,0,36,30
1657501835002,MATH 20A,A01,083754,Zheng; Zequn,14,0,40,26
1657501841024,MATH 20B,A01,083756,Briones; Jor-el Thomas Caparas,4,0,36,32
1657501841024,MATH 20B,A02,083757,Briones; Jor-el Thomas Caparas,1,0,36,35
1657501841024,MATH 20B,A03,093475,Briones; Jor-el Thomas Caparas,2,0,36,34
1657501847049,MATH 20C,A01,083760,Briones; Jor-el Thomas Caparas,1,0,35,34
1657501847049,MATH 20C,A02,083761,Briones; Jor-el Thomas Caparas,8,0,35,27
1657501847049,MATH 20C,A03,093476,Briones; Jor-el Thomas Caparas,0,1,36,36
1657501847049,MATH 20C,B01,083762,Bach; Quang Tran,1,0,30,29
1657501853072,MATH 20D,A01,083765,Tran; Brian Kha,5,0,30,25
1657501853072,MATH 20D,A02,083766,Tran; Brian Kha,5,0,30,25
1657501853072,MATH 20D,A03,083767,Tran; Brian Kha,5,0,30,25
1657501859095,MATH 20E,A01,083771,Ganguly; Soumya,9,0,32,23
1657501859095,MATH 20E,A02,083772,Ganguly; Soumya,6,0,32,26
1657501859095,MATH 20E,B01,083773,Ciotti; Benjamin,20,0,35,15
1657501859095,MATH 20E,B02,083774,Ciotti; Benjamin,17,0,35,18
1657501865122,MATH 103A,A01,083777,Greenfeld; Be'Eri,3,0,36,33
1657501865122,MATH 103A,A02,083778,Greenfeld; Be'Eri,5,0,36,31
1657501865122,MATH 103A,A03,093561,Greenfeld; Be'Eri,5,0,36,31
1657501865122,MATH 103A,B01,083779,Greenfeld; Be'Eri,7,0,36,29
1657501865122,MATH 103A,B02,083780,Greenfeld; Be'Eri,4,0,36,32
1657501865122,MATH 103A,B03,093562,Greenfeld; Be'Eri,3,0,36,33
1657501871145,MATH 105,A01,085443,Carter; Anne Toulson,15,0,35,20
1657501871145,MATH 105,A02,093477,Carter; Anne Toulson,20,0,35,15
1657501877174,MATH 109,A01,083213,Ganzberger; Geoffrey Michael,2,0,34,32
1657501877174,MATH 109,A02,083214,Ganzberger; Geoffrey Michael,4,0,34,30
1657501877174,MATH 109,A03,093478,Ganzberger; Geoffrey Michael,2,0,34,32
1657501877174,MATH 109,B01,083215,Ganzberger; Geoffrey Michael,1,0,32,31
1657501877174,MATH 109,B02,083216,Ganzberger; Geoffrey Michael,2,0,32,30
1657501877174,MATH 109,B03,093479,Ganzberger; Geoffrey Michael,8,0,32,24
1657501883198,MATH 142A,A01,083219,Chow; Bennett,7,0,32,25
1657501883198,MATH 142A,A02,083220,Chow; Bennett,10,0,32,22
1657501883198,MATH 142A,A03,093480,Chow; Bennett,8,0,32,24
1657501883198,MATH 142A,B03,093481,Chow; Bennett,8,0,32,24
1657501883198,MATH 142A,B04,093558,Chow; Bennett,13,0,32,19
1657501883198,MATH 142A,B05,093559,Chow; Bennett,6,0,32,26
1657501889225,MATH 193A,A01,083224,Rotar; Vladimir,8,0,34,26
1657501889225,MATH 193A,A02,083225,Rotar; Vladimir,9,0,34,25
1657501889225,MATH 193A,A03,083781,Rotar; Vladimir,5,0,34,29
1657501889225,MATH 193A,A04,083782,Rotar; Vladimir,10,0,34,24
1657501889225,MATH 193A,A05,093482,Rotar; Vladimir,10,0,34,24
1657501895249,MATH 197,001,091859,McAuley; Julian John,9999,0,9999,0
1657501895249,MATH 197,002,095566,Kedlaya; Kiran S.,9997,0,9999,2
1657501895249,MATH 197,003,095567,Xiao; Ming,9999,0,9999,0
1657501895249,MATH 197,004,095571,Perols; Johan Lars,9998,0,9999,1
1657501902304,COGS 9,A01,083615,Shannon; Kyle Michael,9,0,75,66
1657501908329,COGS 11,A01,083617,Boyle; Mary E. T.,22,0,48,26
1657501914353,COGS 13,A01,083071,Bastos; Amalia Pinkusfeld,11,0,71,60
1657501920380,COGS 14A,A01,092681,Semenuks; Arturs,5,1,100,95
1657501926403,COGS 14B,A01,083073,Cheng; Tzu-Han,6,0,63,57
1657501932443,COGS 17,A01,092677,Semenuks; Arturs,6,0,81,75
1657501938471,COGS 100,A01,083619,Allen; Michael Gordon,17,0,70,53
1657501944500,COGS 101A,A01,083621,Davis; Joshua Daniel,9,0,68,59
1657501950528,COGS 101B,A01,091572,Allen; Michael Gordon,12,0,65,53
1657501956644,COGS 101C,A01,083625,Delgado; Tania,17,0,35,18
1657501962667,COGS 107A,A01,083627,Boyle; Mary E. T.,13,0,60,47
1657501968692,COGS 118A,A01,083075,Gupta; Anjum,21,0,76,55
1657501974725,CSE 3,A50,083646,Miranda; Gregory Joseph,24,0,50,26
1657501980747,CSE 8A,A50,083650,Miranda; Gregory Joseph,17,1,56,39
1657501986770,CSE 11,A01,083080,Cao; Yingjun,6,15,40,34
1657501992792,CSE 12,A01,083652,Krause-Levy; Sophia Louisa,28,1,120,92
1657501998818,CSE 15L,A01,083654,Morris; Justin Loren,9,0,50,41
1657501998818,CSE 15L,A02,083655,Morris; Justin Loren,9,0,50,41
1657502004841,CSE 20,A01,083657,Tran; Khoa Dang,39,0,80,41
1657502010868,CSE 21,A01,095574,Bach; Quang Tran,22,0,48,26
1657502016897,CSE 30,A01,083084,Eldon; John,5,0,80,75
1657502016897,CSE 30,B01,095061,Bhaskar; Nishant,9,0,50,41
1657502022922,CSE 100,A01,083659,Cao; Yingjun,5,4,70,65
1657502028945,CSE 134B,A01,083661,Powell; Thomas Allan,22,0,100,78
1657502034966,CSE 140,A01,083663,Gungor; Onat,15,0,85,70
1657502040993,CSE 140L,A01,083088,Eldon; John,21,0,100,79
1657502047020,CSE 175,A01,083665,Kumar; Rakesh,3,0,25,22
1657502053046,CSE 190,A00,092507,Dubnov; Shlomo,8,0,20,12
1657502059071,ECE 45,A01,083139,Congero; Spencer William,6,0,75,69
1657502065094,ECE 65,A50,083695,Saad; Andrew S,12,0,30,18
1657502065094,ECE 65,A51,095125,Saad; Andrew S,24,0,26,2
1657502071120,ECE 109,A01,091882,Touri; Behrouz,19,0,70,51
1657502077147,ECE 180,A00,083140,Abi Samra; Nicholas Camill,1,0,30,29
1657502077147,ECE 180,B00,083141,Abi Samra; Nicholas Camill,0,0,30,30
1657502083176,MATH 10A,A01,083735,Patchell; Gregory David,2,0,30,28
1657502083176,MATH 10A,A02,083736,Patchell; Gregory David,20,0,30,10
1657502083176,MATH 10A,A03,083737,Patchell; Gregory David,16,0,30,14
1657502089197,MATH 10B,A01,083207,Lim; Seonhee,8,0,34,26
1657502089197,MATH 10B,A02,083208,Lim; Seonhee,9,0,35,26
1657502089197,MATH 10B,A03,093472,Lim; Seonhee,7,0,34,27
1657502089197,MATH 10B,B01,083739,Sinha; Shubham,12,0,30,18
1657502095222,MATH 18,A01,083743,Cinel; Cameron Alexander,7,0,30,23
1657502095222,MATH 18,A02,083744,Cinel; Cameron Alexander,17,0,30,13
1657502095222,MATH 18,A03,083745,Cinel; Cameron Alexander,9,0,30,21
1657502095222,MATH 18,B01,083748,Rideout; David Porter,5,0,37,32
1657502095222,MATH 18,B02,083749,Rideout; David Porter,5,0,36,31
1657502095222,MATH 18,B03,083750,Rideout; David Porter,3,0,37,34
1657502095222,MATH 18,B04,083751,Rideout; David Porter,6,0,36,30
1657502095222,MATH 18,B05,093473,Rideout; David Porter,6,0,36,30
1657502095222,MATH 18,B06,093474,Rideout; David Porter,6,0,36,30
1657502101245,MATH 20A,A01,083754,Zheng; Zequn,14,0,40,26
1657502107268,MATH 20B,A01,083756,Briones; Jor-el Thomas Caparas,4,0,36,32
1657502107268,MATH 20B,A02,083757,Briones; Jor-el Thomas Caparas,1,0,36,35
1657502107268,MATH 20B,A03,093475,Briones; Jor-el Thomas Caparas,2,0,36,34
1657502113291,MATH 20C,A01,083760,Briones; Jor-el Thomas Caparas,1,0,35,34
1657502113291,MATH 20C,A02,083761,Briones; Jor-el Thomas Caparas,8,0,35,27
1657502113291,MATH 20C,A03,093476,Briones; Jor-el Thomas Caparas,0,1,36,36
1657502113291,MATH 20C,B01,083762,Bach; Quang Tran,1,0,30,29
1657502119318,MATH 20D,A01,083765,Tran; Brian Kha,5,0,30,25
1657502119318,MATH 20D,A02,083766,Tran; Brian Kha,5,0,30,25
1657502119318,MATH 20D,A03,083767,Tran; Brian Kha,5,0,30,25
1657502125340,MATH 20E,A01,083771,Ganguly; Soumya,9,0,32,23
1657502125340,MATH 20E,A02,083772,Ganguly; Soumya,6,0,32,26
1657502125340,MATH 20E,B01,083773,Ciotti; Benjamin,20,0,35,15
1657502125340,MATH 20E,B02,083774,Ciotti; Benjamin,17,0,35,18
1657502131362,MATH 103A,A01,083777,Greenfeld; Be'Eri,3,0,36,33
1657502131362,MATH 103A,A02,083778,Greenfeld; Be'Eri,5,0,36,31
1657502131362,MATH 103A,A03,093561,Greenfeld; Be'Eri,5,0,36,31
1657502131362,MATH 103A,B01,083779,Greenfeld; Be'Eri,7,0,36,29
1657502131362,MATH 103A,B02,083780,Greenfeld; Be'Eri,4,0,36,32
1657502131362,MATH 103A,B03,093562,Greenfeld; Be'Eri,3,0,36,33
1657502137385,MATH 105,A01,085443,Carter; Anne Toulson,15,0,35,20
1657502137385,MATH 105,A02,093477,Carter; Anne Toulson,20,0,35,15
1657502143414,MATH 109,A01,083213,Ganzberger; Geoffrey Michael,2,0,34,32
1657502143414,MATH 109,A02,083214,Ganzberger; Geoffrey Michael,4,0,34,30
1657502143414,MATH 109,A03,093478,Ganzberger; Geoffrey Michael,2,0,34,32
1657502143414,MATH 109,B01,083215,Ganzberger; Geoffrey Michael,1,0,32,31
1657502143414,MATH 109,B02,083216,Ganzberger; Geoffrey Michael,2,0,32,30
1657502143414,MATH 109,B03,093479,Ganzberger; Geoffrey Michael,8,0,32,24
1657502149437,MATH 142A,A01,083219,Chow; Bennett,7,0,32,25
1657502149437,MATH 142A,A02,083220,Chow; Bennett,10,0,32,22
1657502149437,MATH 142A,A03,093480,Chow; Bennett,8,0,32,24
1657502149437,MATH 142A,B03,093481,Chow; Bennett,8,0,32,24
1657502149437,MATH 142A,B04,093558,Chow; Bennett,13,0,32,19
1657502149437,MATH 142A,B05,093559,Chow; Bennett,6,0,32,26
1657502155465,MATH 193A,A01,083224,Rotar; Vladimir,8,0,34,26
1657502155465,MATH 193A,A02,083225,Rotar; Vladimir,9,0,34,25
1657502155465,MATH 193A,A03,083781,Rotar; Vladimir,5,0,34,29
1657502155465,MATH 193A,A04,083782,Rotar; Vladimir,10,0,34,24
1657502155465,MATH 193A,A05,093482,Rotar; Vladimir,10,0,34,24
1657502161487,MATH 197,001,091859,McAuley; Julian John,9999,0,9999,0
1657502161487,MATH 197,002,095566,Kedlaya; Kiran S.,9997,0,9999,2
1657502161487,MATH 197,003,095567,Xiao; Ming,9999,0,9999,0
1657502161487,MATH 197,004,095571,Perols; Johan Lars,9998,0,9999,1
1657502168538,COGS 9,A01,083615,Shannon; Kyle Michael,9,0,75,66
1657502174565,COGS 11,A01,083617,Boyle; Mary E. T.,22,0,48,26
1657502180588,COGS 13,A01,083071,Bastos; Amalia Pinkusfeld,11,0,71,60
1657502186611,COGS 14A,A01,092681,Semenuks; Arturs,5,1,100,95
1657502192634,COGS 14B,A01,083073,Cheng; Tzu-Han,6,0,63,57
1657502198657,COGS 17,A01,092677,Semenuks; Arturs,6,0,81,75
1657502204680,COGS 100,A01,083619,Allen; Michael Gordon,17,0,70,53
1657502210704,COGS 101A,A01,083621,Davis; Joshua Daniel,9,0,68,59
1657502216730,COGS 101B,A01,091572,Allen; Michael Gordon,12,0,65,53
1657502222753,COGS 101C,A01,083625,Delgado; Tania,17,0,35,18
1657502228776,COGS 107A,A01,083627,Boyle; Mary E. T.,13,0,60,47
1657502234799,COGS 118A,A01,083075,Gupta; Anjum,21,0,76,55
1657502240830,CSE 3,A50,083646,Miranda; Gregory Joseph,24,0,50,26
1657502246859,CSE 8A,A50,083650,Miranda; Gregory Joseph,17,1,56,39
1657502252881,CSE 11,A01,083080,Cao; Yingjun,6,15,40,34
1657502258907,CSE 12,A01,083652,Krause-Levy; Sophia Louisa,28,1,120,92
1657502264932,CSE 15L,A01,083654,Morris; Justin Loren,9,0,50,41
1657502264932,CSE 15L,A02,083655,Morris; Justin Loren,9,0,50,41
1657502270955,CSE 20,A01,083657,Tran; Khoa Dang,39,0,80,41
1657502276989,CSE 21,A01,095574,Bach; Quang Tran,22,0,48,26
1657502283014,CSE 30,A01,083084,Eldon; John,5,0,80,75
1657502283014,CSE 30,B01,095061,Bhaskar; Nishant,9,0,50,41
1657502289041,CSE 100,A01,083659,Cao; Yingjun,5,4,70,65
1657502295068,CSE 134B,A01,083661,Powell; Thomas Allan,22,0,100,78
1657502301097,CSE 140,A01,083663,Gungor; Onat,15,0,85,70
1657502307121,CSE 140L,A01,083088,Eldon; John,21,0,100,79
1657502313147,CSE 175,A01,083665,Kumar; Rakesh,3,0,25,22
1657502319171,CSE 190,A00,092507,Dubnov; Shlomo,8,0,20,12
1657502325192,ECE 45,A01,083139,Congero; Spencer William,6,0,75,69
1657502331230,ECE 65,A50,083695,Saad; Andrew S,12,0,30,18
1657502331230,ECE 65,A51,095125,Saad; Andrew S,24,0,26,2
1657502337255,ECE 109,A01,091882,Touri; Behrouz,19,0,70,51
1657502343280,ECE 180,A00,083140,Abi Samra; Nicholas Camill,1,0,30,29
1657502343280,ECE 180,B00,083141,Abi Samra; Nicholas Camill,0,0,30,30
1657502349305,MATH 10A,A01,083735,Patchell; Gregory David,2,0,30,28
1657502349305,MATH 10A,A02,083736,Patchell; Gregory David,20,0,30,10
1657502349305,MATH 10A,A03,083737,Patchell; Gregory David,16,0,30,14
1657502355333,MATH 10B,A01,083207,Lim; Seonhee,8,0,34,26
1657502355333,MATH 10B,A02,083208,Lim; Seonhee,9,0,35,26
1657502355333,MATH 10B,A03,093472,Lim; Seonhee,7,0,34,27
1657502355333,MATH 10B,B01,083739,Sinha; Shubham,12,0,30,18
1657502361356,MATH 18,A01,083743,Cinel; Cameron Alexander,7,0,30,23
1657502361356,MATH 18,A02,083744,Cinel; Cameron Alexander,17,0,30,13
1657502361356,MATH 18,A03,083745,Cinel; Cameron Alexander,9,0,30,21
1657502361356,MATH 18,B01,083748,Rideout; David Porter,5,0,37,32
1657502361356,MATH 18,B02,083749,Rideout; David Porter,5,0,36,31
1657502361356,MATH 18,B03,083750,Rideout; David Porter,3,0,37,34
1657502361356,MATH 18,B04,083751,Rideout; David Porter,6,0,36,30
1657502361356,MATH 18,B05,093473,Rideout; David Porter,6,0,36,30
1657502361356,MATH 18,B06,093474,Rideout; David Porter,6,0,36,30
1657502367379,MATH 20A,A01,083754,Zheng; Zequn,14,0,40,26
1657502373406,MATH 20B,A01,083756,Briones; Jor-el Thomas Caparas,4,0,36,32
1657502373406,MATH 20B,A02,083757,Briones; Jor-el Thomas Caparas,1,0,36,35
1657502373406,MATH 20B,A03,093475,Briones; Jor-el Thomas Caparas,2,0,36,34
1657502379431,MATH 20C,A01,083760,Briones; Jor-el Thomas Caparas,1,0,35,34
1657502379431,MATH 20C,A02,083761,Briones; Jor-el Thomas Caparas,8,0,35,27
1657502379431,MATH 20C,A03,093476,Briones; Jor-el Thomas Caparas,0,1,36,36
1657502379431,MATH 20C,B01,083762,Bach; Quang Tran,1,0,30,29
1657502385459,MATH 20D,A01,083765,Tran; Brian Kha,5,0,30,25
1657502385459,MATH 20D,A02,083766,Tran; Brian Kha,5,0,30,25
1657502385459,MATH 20D,A03,083767,Tran; Brian Kha,5,0,30,25
1657502391484,MATH 20E,A01,083771,Ganguly; Soumya,9,0,32,23
1657502391484,MATH 20E,A02,083772,Ganguly; Soumya,6,0,32,26
1657502391484,MATH 20E,B01,083773,Ciotti; Benjamin,20,0,35,15
1657502391484,MATH 20E,B02,083774,Ciotti; Benjamin,17,0,35,18
1657502397513,MATH 103A,A01,083777,Greenfeld; Be'Eri,3,0,36,33
1657502397513,MATH 103A,A02,083778,Greenfeld; Be'Eri,5,0,36,31
1657502397513,MATH 103A,A03,093561,Greenfeld; Be'Eri,5,0,36,31
1657502397513,MATH 103A,B01,083779,Greenfeld; Be'Eri,7,0,36,29
1657502397513,MATH 103A,B02,083780,Greenfeld; Be'Eri,4,0,36,32
1657502397513,MATH 103A,B03,093562,Greenfeld; Be'Eri,3,0,36,33
1657502403537,MATH 105,A01,085443,Carter; Anne Toulson,15,0,35,20
1657502403537,MATH 105,A02,093477,Carter; Anne Toulson,20,0,35,15
1657502409559,MATH 109,A01,083213,Ganzberger; Geoffrey Michael,2,0,34,32
1657502409559,MATH 109,A02,083214,Ganzberger; Geoffrey Michael,4,0,34,30
1657502409559,MATH 109,A03,093478,Ganzberger; Geoffrey Michael,2,0,34,32
1657502409559,MATH 109,B01,083215,Ganzberger; Geoffrey Michael,1,0,32,31
1657502409559,MATH 109,B02,083216,Ganzberger; Geoffrey Michael,2,0,32,30
1657502409559,MATH 109,B03,093479,Ganzberger; Geoffrey Michael,8,0,32,24
1657502415584,MATH 142A,A01,083219,Chow; Bennett,7,0,32,25
1657502415584,MATH 142A,A02,083220,Chow; Bennett,10,0,32,22
1657502415584,MATH 142A,A03,093480,Chow; Bennett,8,0,32,24
1657502415584,MATH 142A,B03,093481,Chow; Bennett,8,0,32,24
1657502415584,MATH 142A,B04,093558,Chow; Bennett,13,0,32,19
1657502415584,MATH 142A,B05,093559,Chow; Bennett,6,0,32,26
1657502421608,MATH 193A,A01,083224,Rotar; Vladimir,8,0,34,26
1657502421608,MATH 193A,A02,083225,Rotar; Vladimir,9,0,34,25
1657502421608,MATH 193A,A03,083781,Rotar; Vladimir,5,0,34,29
1657502421608,MATH 193A,A04,083782,Rotar; Vladimir,10,0,34,24
1657502421608,MATH 193A,A05,093482,Rotar; Vladimir,10,0,34,24
1657502427630,MATH 197,001,091859,McAuley; Julian John,9999,0,9999,0
1657502427630,MATH 197,002,095566,Kedlaya; Kiran S.,9997,0,9999,2
1657502427630,MATH 197,003,095567,Xiao; Ming,9999,0,9999,0
1657502427630,MATH 197,004,095571,Perols; Johan Lars,9998,0,9999,1
1657502434683,COGS 9,A01,083615,Shannon; Kyle Michael,9,0,75,66
1657502440709,COGS 11,A01,083617,Boyle; Mary E. T.,22,0,48,26
1657502446736,COGS 13,A01,083071,Bastos; Amalia Pinkusfeld,11,0,71,60
1657502452759,COGS 14A,A01,092681,Semenuks; Arturs,5,1,100,95
1657502458782,COGS 14B,A01,083073,Cheng; Tzu-Han,6,0,63,57
1657502464805,COGS 17,A01,092677,Semenuks; Arturs,6,0,81,75
1657502470831,COGS 100,A01,083619,Allen; Michael Gordon,17,0,70,53
1657502476853,COGS 101A,A01,083621,Davis; Joshua Daniel,9,0,68,59
1657502482888,COGS 101B,A01,091572,Allen; Michael Gordon,12,0,65,53
1657502488916,COGS 101C,A01,083625,Delgado; Tania,17,0,35,18
1657502494940,COGS 107A,A01,083627,Boyle; Mary E. T.,13,0,60,47
1657502500964,COGS 118A,A01,083075,Gupta; Anjum,21,0,76,55
1657502506988,CSE 3,A50,083646,Miranda; Gregory Joseph,24,0,50,26
1657502513011,CSE 8A,A50,083650,Miranda; Gregory Joseph,17,1,56,39
1657502519035,CSE 11,A01,083080,Cao; Yingjun,6,15,40,34
1657502525063,CSE 12,A01,083652,Krause-Levy; Sophia Louisa,28,1,120,92
1657502531085,CSE 15L,A01,083654,Morris; Justin Loren,9,0,50,41
1657502531085,CSE 15L,A02,083655,Morris; Justin Loren,9,0,50,41
1657502537110,CSE 20,A01,083657,Tran; Khoa Dang,39,0,80,41
1657502543133,CSE 21,A01,095574,Bach; Quang Tran,22,0,48,26
1657502549156,CSE 30,A01,083084,Eldon; John,5,0,80,75
1657502549156,CSE 30,B01,095061,Bhaskar; Nishant,9,0,50,41
1657502555280,CSE 100,A01,083659,Cao; Yingjun,5,4,70,65
1657502561312,CSE 134B,A01,083661,Powell; Thomas Allan,22,0,100,78
1657502567337,CSE 140,A01,083663,Gungor; Onat,15,0,85,70
1657502573360,CSE 140L,A01,083088,Eldon; John,21,0,100,79
1657502579381,CSE 175,A01,083665,Kumar; Rakesh,3,0,25,22
1657502585408,CSE 190,A00,092507,Dubnov; Shlomo,8,0,20,12
1657502591431,ECE 45,A01,083139,Congero; Spencer William,6,0,75,69
1657502597458,ECE 65,A50,083695,Saad; Andrew S,12,0,30,18
1657502597458,ECE 65,A51,095125,Saad; Andrew S,24,0,26,2
1657502603480,ECE 109,A01,091882,Touri; Behrouz,19,0,70,51
1657502609501,ECE 180,A00,083140,Abi Samra; Nicholas Camill,1,0,30,29
1657502609501,ECE 180,B00,083141,Abi Samra; Nicholas Camill,0,0,30,30
1657502615526,MATH 10A,A01,083735,Patchell; Gregory David,2,0,30,28
1657502615526,MATH 10A,A02,083736,Patchell; Gregory David,20,0,30,10
1657502615526,MATH 10A,A03,083737,Patchell; Gregory David,16,0,30,14
1657502621553,MATH 10B,A01,083207,Lim; Seonhee,8,0,34,26
1657502621553,MATH 10B,A02,083208,Lim; Seonhee,9,0,35,26
1657502621553,MATH 10B,A03,093472,Lim; Seonhee,7,0,34,27
1657502621553,MATH 10B,B01,083739,Sinha; Shubham,12,0,30,18
1657502627578,MATH 18,A01,083743,Cinel; Cameron Alexander,7,0,30,23
1657502627578,MATH 18,A02,083744,Cinel; Cameron Alexander,17,0,30,13
1657502627578,MATH 18,A03,083745,Cinel; Cameron Alexander,9,0,30,21
1657502627578,MATH 18,B01,083748,Rideout; David Porter,5,0,37,32
1657502627578,MATH 18,B02,083749,Rideout; David Porter,5,0,36,31
1657502627578,MATH 18,B03,083750,Rideout; David Porter,3,0,37,34
1657502627578,MATH 18,B04,083751,Rideout; David Porter,6,0,36,30
1657502627578,MATH 18,B05,093473,Rideout; David Porter,6,0,36,30
1657502627578,MATH 18,B06,093474,Rideout; David Porter,6,0,36,30
1657502633605,MATH 20A,A01,083754,Zheng; Zequn,14,0,40,26
1657502639628,MATH 20B,A01,083756,Briones; Jor-el Thomas Caparas,4,0,36,32
1657502639628,MATH 20B,A02,083757,Briones; Jor-el Thomas Caparas,1,0,36,35
1657502639628,MATH 20B,A03,093475,Briones; Jor-el Thomas Caparas,2,0,36,34
1657502645652,MATH 20C,A01,083760,Briones; Jor-el Thomas Caparas,1,0,35,34
1657502645652,MATH 20C,A02,083761,Briones; Jor-el Thomas Caparas,8,0,35,27
1657502645652,MATH 20C,A03,093476,Briones; Jor-el Thomas Caparas,0,1,36,36
1657502645652,MATH 20C,B01,083762,Bach; Quang Tran,1,0,30,29
1657502651680,MATH 20D,A01,083765,Tran; Brian Kha,5,0,30,25
1657502651680,MATH 20D,A02,083766,Tran; Brian Kha,5,0,30,25
1657502651680,MATH 20D,A03,083767,Tran; Brian Kha,5,0,30,25
1657502657711,MATH 20E,A01,083771,Ganguly; Soumya,9,0,32,23
1657502657711,MATH 20E,A02,083772,Ganguly; Soumya,6,0,32,26
1657502657711,MATH 20E,B01,083773,Ciotti; Benjamin,20,0,35,15
1657502657711,MATH 20E,B02,083774,Ciotti; Benjamin,17,0,35,18
1657502663735,MATH 103A,A01,083777,Greenfeld; Be'Eri,3,0,36,33
1657502663735,MATH 103A,A02,083778,Greenfeld; Be'Eri,5,0,36,31
1657502663735,MATH 103A,A03,093561,Greenfeld; Be'Eri,5,0,36,31
1657502663735,MATH 103A,B01,083779,Greenfeld; Be'Eri,7,0,36,29
1657502663735,MATH 103A,B02,083780,Greenfeld; Be'Eri,4,0,36,32
1657502663735,MATH 103A,B03,093562,Greenfeld; Be'Eri,3,0,36,33
1657502669758,MATH 105,A01,085443,Carter; Anne Toulson,15,0,35,20
1657502669758,MATH 105,A02,093477,Carter; Anne Toulson,20,0,35,15
1657502675786,MATH 109,A01,083213,Ganzberger; Geoffrey Michael,2,0,34,32
1657502675786,MATH 109,A02,083214,Ganzberger; Geoffrey Michael,4,0,34,30
1657502675786,MATH 109,A03,093478,Ganzberger; Geoffrey Michael,2,0,34,32
1657502675786,MATH 109,B01,083215,Ganzberger; Geoffrey Michael,1,0,32,31
1657502675786,MATH 109,B02,083216,Ganzberger; Geoffrey Michael,2,0,32,30
1657502675786,MATH 109,B03,093479,Ganzberger; Geoffrey Michael,8,0,32,24
1657502681815,MATH 142A,A01,083219,Chow; Bennett,7,0,32,25
1657502681815,MATH 142A,A02,083220,Chow; Bennett,10,0,32,22
1657502681815,MATH 142A,A03,093480,Chow; Bennett,8,0,32,24
1657502681815,MATH 142A,B03,093481,Chow; Bennett,8,0,32,24
1657502681815,MATH 142A,B04,093558,Chow; Bennett,13,0,32,19
1657502681815,MATH 142A,B05,093559,Chow; Bennett,6,0,32,26
1657502687840,MATH 193A,A01,083224,Rotar; Vladimir,8,0,34,26
1657502687840,MATH 193A,A02,083225,Rotar; Vladimir,9,0,34,25
1657502687840,MATH 193A,A03,083781,Rotar; Vladimir,5,0,34,29
1657502687840,MATH 193A,A04,083782,Rotar; Vladimir,10,0,34,24
1657502687840,MATH 193A,A05,093482,Rotar; Vladimir,10,0,34,24
1657502693865,MATH 197,001,091859,McAuley; Julian John,9999,0,9999,0
1657502693865,MATH 197,002,095566,Kedlaya; Kiran S.,9997,0,9999,2
1657502693865,MATH 197,003,095567,Xiao; Ming,9999,0,9999,0
1657502693865,MATH 197,004,095571,Perols; Johan Lars,9998,0,9999,1
1657502700932,COGS 9,A01,083615,Shannon; Kyle Michael,9,0,75,66
1657502706959,COGS 11,A01,083617,Boyle; Mary E. T.,22,0,48,26
1657502712983,COGS 13,A01,083071,Bastos; Amalia Pinkusfeld,11,0,71,60
1657502719006,COGS 14A,A01,092681,Semenuks; Arturs,5,1,100,95
1657502725032,COGS 14B,A01,083073,Cheng; Tzu-Han,6,0,63,57
1657502731060,COGS 17,A01,092677,Semenuks; Arturs,6,0,81,75
1657502737087,COGS 100,A01,083619,Allen; Michael Gordon,17,0,70,53
1657502743115,COGS 101A,A01,083621,Davis; Joshua Daniel,9,0,68,59
1657502749149,COGS 101B,A01,091572,Allen; Michael Gordon,12,0,65,53
1657502755176,COGS 101C,A01,083625,Delgado; Tania,17,0,35,18
1657502761199,COGS 107A,A01,083627,Boyle; Mary E. T.,13,0,60,47
1657502767222,COGS 118A,A01,083075,Gupta; Anjum,21,0,76,55
1657502773245,CSE 3,A50,083646,Miranda; Gregory Joseph,24,0,50,26
1657502779270,CSE 8A,A50,083650,Miranda; Gregory Joseph,17,1,56,39
1657502785295,CSE 11,A01,083080,Cao; Yingjun,6,15,40,34
1657502791319,CSE 12,A01,083652,Krause-Levy; Sophia Louisa,28,1,120,92
1657502797344,CSE 15L,A01,083654,Morris; Justin Loren,9,0,50,41
1657502797344,CSE 15L,A02,083655,Morris; Justin Loren,9,0,50,41
1657502803368,CSE 20,A01,083657,Tran; Khoa Dang,39,0,80,41
1657502809395,CSE 21,A01,095574,Bach; Quang Tran,22,0,48,26
1657502815419,CSE 30,A01,083084,Eldon; John,5,0,80,75
1657502815419,CSE 30,B01,095061,Bhaskar; Nishant,9,0,50,41
1657502821447,CSE 100,A01,083659,Cao; Yingjun,5,4,70,65
1657502827469,CSE 134B,A01,083661,Powell; Thomas Allan,22,0,100,78
1657502833493,CSE 140,A01,083663,Gungor; Onat,15,0,85,70
1657502839524,CSE 140L,A01,083088,Eldon; John,21,0,100,79
1657502845550,CSE 175,A01,083665,Kumar; Rakesh,3,0,25,22
1657502851573,CSE 190,A00,092507,Dubnov; Shlomo,8,0,20,12
1657502857598,ECE 45,A01,083139,Congero; Spencer William,6,0,75,69
1657502863622,ECE 65,A50,083695,Saad; Andrew S,12,0,30,18
1657502863622,ECE 65,A51,095125,Saad; Andrew S,24,0,26,2
1657502869645,ECE 109,A01,091882,Touri; Behrouz,19,0,70,51
1657502875674,ECE 180,A00,083140,Abi Samra; Nicholas Camill,1,0,30,29
1657502875674,ECE 180,B00,083141,Abi Samra; Nicholas Camill,0,0,30,30
1657502881701,MATH 10A,A01,083735,Patchell; Gregory David,2,0,30,28
1657502881701,MATH 10A,A02,083736,Patchell; Gregory David,20,0,30,10
1657502881701,MATH 10A,A03,083737,Patchell; Gregory David,16,0,30,14
1657502887724,MATH 10B,A01,083207,Lim; Seonhee,8,0,34,26
1657502887724,MATH 10B,A02,083208,Lim; Seonhee,9,0,35,26
1657502887724,MATH 10B,A03,093472,Lim; Seonhee,7,0,34,27
1657502887724,MATH 10B,B01,083739,Sinha; Shubham,12,0,30,18
1657502893754,MATH 18,A01,083743,Cinel; Cameron Alexander,7,0,30,23
1657502893754,MATH 18,A02,083744,Cinel; Cameron Alexander,17,0,30,13
1657502893754,MATH 18,A03,083745,Cinel; Cameron Alexander,9,0,30,21
1657502893754,MATH 18,B01,083748,Rideout; David Porter,5,0,37,32
1657502893754,MATH 18,B02,083749,Rideout; David Porter,5,0,36,31
1657502893754,MATH 18,B03,083750,Rideout; David Porter,3,0,37,34
1657502893754,MATH 18,B04,083751,Rideout; David Porter,6,0,36,30
1657502893754,MATH 18,B05,093473,Rideout; David Porter,6,0,36,30
1657502893754,MATH 18,B06,093474,Rideout; David Porter,6,0,36,30
1657502899777,MATH 20A,A01,083754,Zheng; Zequn,14,0,40,26
1657502905798,MATH 20B,A01,083756,Briones; Jor-el Thomas Caparas,4,0,36,32
1657502905798,MATH 20B,A02,083757,Briones; Jor-el Thomas Caparas,1,0,36,35
1657502905798,MATH 20B,A03,093475,Briones; Jor-el Thomas Caparas,2,0,36,34
1657502911827,MATH 20C,A01,083760,Briones; Jor-el Thomas Caparas,1,0,35,34
1657502911827,MATH 20C,A02,083761,Briones; Jor-el Thomas Caparas,8,0,35,27
1657502911827,MATH 20C,A03,093476,Briones; Jor-el Thomas Caparas,0,1,36,36
1657502911827,MATH 20C,B01,083762,Bach; Quang Tran,1,0,30,29
1657502917848,MATH 20D,A01,083765,Tran; Brian Kha,5,0,30,25
1657502917848,MATH 20D,A02,083766,Tran; Brian Kha,5,0,30,25
1657502917848,MATH 20D,A03,083767,Tran; Brian Kha,5,0,30,25
1657502923876,MATH 20E,A01,083771,Ganguly; Soumya,9,0,32,23
1657502923876,MATH 20E,A02,083772,Ganguly; Soumya,6,0,32,26
1657502923876,MATH 20E,B01,083773,Ciotti; Benjamin,20,0,35,15
1657502923876,MATH 20E,B02,083774,Ciotti; Benjamin,17,0,35,18
1657502929898,MATH 103A,A01,083777,Greenfeld; Be'Eri,3,0,36,33
1657502929898,MATH 103A,A02,083778,Greenfeld; Be'Eri,5,0,36,31
1657502929898,MATH 103A,A03,093561,Greenfeld; Be'Eri,5,0,36,31
1657502929898,MATH 103A,B01,083779,Greenfeld; Be'Eri,7,0,36,29
1657502929898,MATH 103A,B02,083780,Greenfeld; Be'Eri,4,0,36,32
1657502929898,MATH 103A,B03,093562,Greenfeld; Be'Eri,3,0,36,33
1657502935924,MATH 105,A01,085443,Carter; Anne Toulson,15,0,35,20
1657502935924,MATH 105,A02,093477,Carter; Anne Toulson,20,0,35,15
1657502941951,MATH 109,A01,083213,Ganzberger; Geoffrey Michael,2,0,34,32
1657502941951,MATH 109,A02,083214,Ganzberger; Geoffrey Michael,4,0,34,30
1657502941951,MATH 109,A03,093478,Ganzberger; Geoffrey Michael,2,0,34,32
1657502941951,MATH 109,B01,083215,Ganzberger; Geoffrey Michael,1,0,32,31
1657502941951,MATH 109,B02,083216,Ganzberger; Geoffrey Michael,2,0,32,30
1657502941951,MATH 109,B03,093479,Ganzberger; Geoffrey Michael,8,0,32,24
1657502947981,MATH 142A,A01,083219,Chow; Bennett,7,0,32,25
1657502947981,MATH 142A,A02,083220,Chow; Bennett,10,0,32,22
1657502947981,MATH 142A,A03,093480,Chow; Bennett,8,0,32,24
1657502947981,MATH 142A,B03,093481,Chow; Bennett,8,0,32,24
1657502947981,MATH 142A,B04,093558,Chow; Bennett,13,0,32,19
1657502947981,MATH 142A,B05,093559,Chow; Bennett,6,0,32,26
1657502954008,MATH 193A,A01,083224,Rotar; Vladimir,8,0,34,26
1657502954008,MATH 193A,A02,083225,Rotar; Vladimir,9,0,34,25
1657502954008,MATH 193A,A03,083781,Rotar; Vladimir,5,0,34,29
1657502954008,MATH 193A,A04,083782,Rotar; Vladimir,10,0,34,24
1657502954008,MATH 193A,A05,093482,Rotar; Vladimir,10,0,34,24
1657502960030,MATH 197,001,091859,McAuley; Julian John,9999,0,9999,0
1657502960030,MATH 197,002,095566,Kedlaya; Kiran S.,9997,0,9999,2
1657502960030,MATH 197,003,095567,Xiao; Ming,9999,0,9999,0
1657502960030,MATH 197,004,095571,Perols; Johan Lars,9998,0,9999,1
1657502967094,COGS 9,A01,083615,Shannon; Kyle Michael,9,0,75,66
1657502973117,COGS 11,A01,083617,Boyle; Mary E. T.,22,0,48,26
1657502979143,COGS 13,A01,083071,Bastos; Amalia Pinkusfeld,11,0,71,60
1657502985168,COGS 14A,A01,092681,Semenuks; Arturs,5,1,100,95
1657502991192,COGS 14B,A01,083073,Cheng; Tzu-Han,6,0,63,57
1657502997215,COGS 17,A01,092677,Semenuks; Arturs,6,0,81,75
1657503003240,COGS 100,A01,083619,Allen; Michael Gordon,17,0,70,53
1657503009266,COGS 101A,A01,083621,Davis; Joshua Daniel,9,0,68,59
1657503015289,COGS 101B,A01,091572,Allen; Michael Gordon,12,0,65,53
1657503021314,COGS 101C,A01,083625,Delgado; Tania,17,0,35,18
1657503027338,COGS 107A,A01,083627,Boyle; Mary E. T.,13,0,60,47
1657503033361,COGS 118A,A01,083075,Gupta; Anjum,21,0,76,55
1657503039384,CSE 3,A50,083646,Miranda; Gregory Joseph,24,0,50,26
1657503045409,CSE 8A,A50,083650,Miranda; Gregory Joseph,17,1,56,39
1657503051437,CSE 11,A01,083080,Cao; Yingjun,6,15,40,34
1657503057466,CSE 12,A01,083652,Krause-Levy; Sophia Louisa,28,1,120,92
1657503063493,CSE 15L,A01,083654,Morris; Justin Loren,9,0,50,41
1657503063493,CSE 15L,A02,083655,Morris; Justin Loren,9,0,50,41
1657503069516,CSE 20,A01,083657,Tran; Khoa Dang,39,0,80,41
1657503075544,CSE 21,A01,095574,Bach; Quang Tran,22,0,48,26
1657503081572,CSE 30,A01,083084,Eldon; John,5,0,80,75
1657503081572,CSE 30,B01,095061,Bhaskar; Nishant,9,0,50,41
1657503087595,CSE 100,A01,083659,Cao; Yingjun,5,4,70,65
1657503093618,CSE 134B,A01,083661,Powell; Thomas Allan,22,0,100,78
1657503099645,CSE 140,A01,083663,Gungor; Onat,15,0,85,70
1657503105673,CSE 140L,A01,083088,Eldon; John,21,0,100,79
1657503111707,CSE 175,A01,083665,Kumar; Rakesh,3,0,25,22
1657503117731,CSE 190,A00,092507,Dubnov; Shlomo,8,0,20,12
1657503123754,ECE 45,A01,083139,Congero; Spencer William,6,0,75,69
1657503129779,ECE 65,A50,083695,Saad; Andrew S,12,0,30,18
1657503129779,ECE 65,A51,095125,Saad; Andrew S,24,0,26,2
1657503135810,ECE 109,A01,091882,Touri; Behrouz,19,0,70,51
1657503141836,ECE 180,A00,083140,Abi Samra; Nicholas Camill,1,0,30,29
1657503141836,ECE 180,B00,083141,Abi Samra; Nicholas Camill,0,0,30,30
1657503147859,MATH 10A,A01,083735,Patchell; Gregory David,2,0,30,28
1657503147859,MATH 10A,A02,083736,Patchell; Gregory David,20,0,30,10
1657503147859,MATH 10A,A03,083737,Patchell; Gregory David,16,0,30,14
1657503153957,MATH 10B,A01,083207,Lim; Seonhee,8,0,34,26
1657503153957,MATH 10B,A02,083208,Lim; Seonhee,9,0,35,26
1657503153957,MATH 10B,A03,093472,Lim; Seonhee,7,0,34,27
1657503153957,MATH 10B,B01,083739,Sinha; Shubham,12,0,30,18
1657503159988,MATH 18,A01,083743,Cinel; Cameron Alexander,7,0,30,23
1657503159988,MATH 18,A02,083744,Cinel; Cameron Alexander,17,0,30,13
1657503159988,MATH 18,A03,083745,Cinel; Cameron Alexander,9,0,30,21
1657503159988,MATH 18,B01,083748,Rideout; David Porter,5,0,37,32
1657503159988,MATH 18,B02,083749,Rideout; David Porter,5,0,36,31
1657503159988,MATH 18,B03,083750,Rideout; David Porter,3,0,37,34
1657503159988,MATH 18,B04,083751,Rideout; David Porter,6,0,36,30
1657503159988,MATH 18,B05,093473,Rideout; David Porter,6,0,36,30
1657503159988,MATH 18,B06,093474,Rideout; David Porter,6,0,36,30
1657503166013,MATH 20A,A01,083754,Zheng; Zequn,14,0,40,26
1657503172038,MATH 20B,A01,083756,Briones; Jor-el Thomas Caparas,4,0,36,32
1657503172038,MATH 20B,A02,083757,Briones; Jor-el Thomas Caparas,1,0,36,35
1657503172038,MATH 20B,A03,093475,Briones; Jor-el Thomas Caparas,2,0,36,34
1657503178060,MATH 20C,A01,083760,Briones; Jor-el Thomas Caparas,1,0,35,34
1657503178060,MATH 20C,A02,083761,Briones; Jor-el Thomas Caparas,8,0,35,27
1657503178060,MATH 20C,A03,093476,Briones; Jor-el Thomas Caparas,0,1,36,36
1657503178060,MATH 20C,B01,083762,Bach; Quang Tran,1,0,30,29
1657503184084,MATH 20D,A01,083765,Tran; Brian Kha,5,0,30,25
1657503184084,MATH 20D,A02,083766,Tran; Brian Kha,5,0,30,25
1657503184084,MATH 20D,A03,083767,Tran; Brian Kha,5,0,30,25
1657503190112,MATH 20E,A01,083771,Ganguly; Soumya,9,0,32,23
1657503190112,MATH 20E,A02,083772,Ganguly; Soumya,6,0,32,26
1657503190112,MATH 20E,B01,083773,Ciotti; Benjamin,20,0,35,15
1657503190112,MATH 20E,B02,083774,Ciotti; Benjamin,17,0,35,18
1657503196140,MATH 103A,A01,083777,Greenfeld; Be'Eri,3,0,36,33
1657503196140,MATH 103A,A02,083778,Greenfeld; Be'Eri,5,0,36,31
1657503196140,MATH 103A,A03,093561,Greenfeld; Be'Eri,5,0,36,31
1657503196140,MATH 103A,B01,083779,Greenfeld; Be'Eri,7,0,36,29
1657503196140,MATH 103A,B02,083780,Greenfeld; Be'Eri,4,0,36,32
1657503196140,MATH 103A,B03,093562,Greenfeld; Be'Eri,3,0,36,33
1657503202164,MATH 105,A01,085443,Carter; Anne Toulson,15,0,35,20
1657503202164,MATH 105,A02,093477,Carter; Anne Toulson,20,0,35,15
1657503208192,MATH 109,A01,083213,Ganzberger; Geoffrey Michael,2,0,34,32
1657503208192,MATH 109,A02,083214,Ganzberger; Geoffrey Michael,4,0,34,30
1657503208192,MATH 109,A03,093478,Ganzberger; Geoffrey Michael,2,0,34,32
1657503208192,MATH 109,B01,083215,Ganzberger; Geoffrey Michael,1,0,32,31
1657503208192,MATH 109,B02,083216,Ganzberger; Geoffrey Michael,2,0,32,30
1657503208192,MATH 109,B03,093479,Ganzberger; Geoffrey Michael,8,0,32,24
1657503214214,MATH 142A,A01,083219,Chow; Bennett,7,0,32,25
1657503214214,MATH 142A,A02,083220,Chow; Bennett,10,0,32,22
1657503214214,MATH 142A,A03,093480,Chow; Bennett,8,0,32,24
1657503214214,MATH 142A,B03,093481,Chow; Bennett,8,0,32,24
1657503214214,MATH 142A,B04,093558,Chow; Bennett,13,0,32,19
1657503214214,MATH 142A,B05,093559,Chow; Bennett,6,0,32,26
1657503220247,MATH 193A,A01,083224,Rotar; Vladimir,8,0,34,26
1657503220247,MATH 193A,A02,083225,Rotar; Vladimir,9,0,34,25
1657503220247,MATH 193A,A03,083781,Rotar; Vladimir,5,0,34,29
1657503220247,MATH 193A,A04,083782,Rotar; Vladimir,10,0,34,24
1657503220247,MATH 193A,A05,093482,Rotar; Vladimir,10,0,34,24
1657503226269,MATH 197,001,091859,McAuley; Julian John,9999,0,9999,0
1657503226269,MATH 197,002,095566,Kedlaya; Kiran S.,9997,0,9999,2
1657503226269,MATH 197,003,095567,Xiao; Ming,9999,0,9999,0
1657503226269,MATH 197,004,095571,Perols; Johan Lars,9998,0,9999,1
1657503233327,COGS 9,A01,083615,Shannon; Kyle Michael,9,0,75,66
1657503239349,COGS 11,A01,083617,Boyle; Mary E. T.,22,0,48,26
1657503245374,COGS 13,A01,083071,Bastos; Amalia Pinkusfeld,11,0,71,60
1657503251398,COGS 14A,A01,092681,Semenuks; Arturs,5,1,100,95
1657503257421,COGS 14B,A01,083073,Cheng; Tzu-Han,6,0,63,57
1657503263445,COGS 17,A01,092677,Semenuks; Arturs,6,0,81,75
1657503269468,COGS 100,A01,083619,Allen; Michael Gordon,17,0,70,53
1657503275491,COGS 101A,A01,083621,Davis; Joshua Daniel,9,0,68,59
1657503281514,COGS 101B,A01,091572,Allen; Michael Gordon,12,0,65,53
1657503287542,COGS 101C,A01,083625,Delgado; Tania,17,0,35,18
1657503293568,COGS 107A,A01,083627,Boyle; Mary E. T.,13,0,60,47
1657503299592,COGS 118A,A01,083075,Gupta; Anjum,21,0,76,55
1657503305618,CSE 3,A50,083646,Miranda; Gregory Joseph,24,0,50,26
1657503311641,CSE 8A,A50,083650,Miranda; Gregory Joseph,17,1,56,39
1657503317666,CSE 11,A01,083080,Cao; Yingjun,6,15,40,34
1657503323694,CSE 12,A01,083652,Krause-Levy; Sophia Louisa,28,1,120,92
1657503329720,CSE 15L,A01,083654,Morris; Justin Loren,9,0,50,41
1657503329720,CSE 15L,A02,083655,Morris; Justin Loren,9,0,50,41
1657503335743,CSE 20,A01,083657,Tran; Khoa Dang,39,0,80,41
1657503341769,CSE 21,A01,095574,Bach; Quang Tran,22,0,48,26
1657503347794,CSE 30,A01,083084,Eldon; John,5,0,80,75
1657503347794,CSE 30,B01,095061,Bhaskar; Nishant,9,0,50,41
1657503353815,CSE 100,A01,083659,Cao; Yingjun,5,4,70,65
1657503359841,CSE 134B,A01,083661,Powell; Thomas Allan,22,0,100,78
1657503365862,CSE 140,A01,083663,Gungor; Onat,15,0,85,70
1657503371887,CSE 140L,A01,083088,Eldon; John,21,0,100,79
1657503377911,CSE 175,A01,083665,Kumar; Rakesh,3,0,25,22
1657503383933,CSE 190,A00,092507,Dubnov; Shlomo,8,0,20,12
1657503389959,ECE 45,A01,083139,Congero; Spencer William,6,0,75,69
1657503395983,ECE 65,A50,083695,Saad; Andrew S,12,0,30,18
1657503395983,ECE 65,A51,095125,Saad; Andrew S,24,0,26,2
1657503402006,ECE 109,A01,091882,Touri; Behrouz,19,0,70,51
1657503408029,ECE 180,A00,083140,Abi Samra; Nicholas Camill,1,0,30,29
1657503408029,ECE 180,B00,083141,Abi Samra; Nicholas Camill,0,0,30,30
1657503414053,MATH 10A,A01,083735,Patchell; Gregory David,2,0,30,28
1657503414053,MATH 10A,A02,083736,Patchell; Gregory David,20,0,30,10
1657503414053,MATH 10A,A03,083737,Patchell; Gregory David,16,0,30,14
1657503420083,MATH 10B,A01,083207,Lim; Seonhee,8,0,34,26
1657503420083,MATH 10B,A02,083208,Lim; Seonhee,9,0,35,26
1657503420083,MATH 10B,A03,093472,Lim; Seonhee,7,0,34,27
1657503420083,MATH 10B,B01,083739,Sinha; Shubham,12,0,30,18
1657503426110,MATH 18,A01,083743,Cinel; Cameron Alexander,7,0,30,23
1657503426110,MATH 18,A02,083744,Cinel; Cameron Alexander,17,0,30,13
1657503426110,MATH 18,A03,083745,Cinel; Cameron Alexander,9,0,30,21
1657503426110,MATH 18,B01,083748,Rideout; David Porter,5,0,37,32
1657503426110,MATH 18,B02,083749,Rideout; David Porter,5,0,36,31
1657503426110,MATH 18,B03,083750,Rideout; David Porter,3,0,37,34
1657503426110,MATH 18,B04,083751,Rideout; David Porter,6,0,36,30
1657503426110,MATH 18,B05,093473,Rideout; David Porter,6,0,36,30
1657503426110,MATH 18,B06,093474,Rideout; David Porter,6,0,36,30
1657503432134,MATH 20A,A01,083754,Zheng; Zequn,14,0,40,26
1657503438157,MATH 20B,A01,083756,Briones; Jor-el Thomas Caparas,4,0,36,32
1657503438157,MATH 20B,A02,083757,Briones; Jor-el Thomas Caparas,1,0,36,35
1657503438157,MATH 20B,A03,093475,Briones; Jor-el Thomas Caparas,2,0,36,34
1657503444186,MATH 20C,A01,083760,Briones; Jor-el Thomas Caparas,1,0,35,34
1657503444186,MATH 20C,A02,083761,Briones; Jor-el Thomas Caparas,8,0,35,27
1657503444186,MATH 20C,A03,093476,Briones; Jor-el Thomas Caparas,0,1,36,36
1657503444186,MATH 20C,B01,083762,Bach; Quang Tran,1,0,30,29
1657503450211,MATH 20D,A01,083765,Tran; Brian Kha,5,0,30,25
1657503450211,MATH 20D,A02,083766,Tran; Brian Kha,5,0,30,25
1657503450211,MATH 20D,A03,083767,Tran; Brian Kha,5,0,30,25
1657503456237,MATH 20E,A01,083771,Ganguly; Soumya,9,0,32,23
1657503456237,MATH 20E,A02,083772,Ganguly; Soumya,6,0,32,26
1657503456237,MATH 20E,B01,083773,Ciotti; Benjamin,20,0,35,15
1657503456237,MATH 20E,B02,083774,Ciotti; Benjamin,17,0,35,18
1657503462265,MATH 103A,A01,083777,Greenfeld; Be'Eri,3,0,36,33
1657503462265,MATH 103A,A02,083778,Greenfeld; Be'Eri,5,0,36,31
1657503462265,MATH 103A,A03,093561,Greenfeld; Be'Eri,5,0,36,31
1657503462265,MATH 103A,B01,083779,Greenfeld; Be'Eri,7,0,36,29
1657503462265,MATH 103A,B02,083780,Greenfeld; Be'Eri,4,0,36,32
1657503462265,MATH 103A,B03,093562,Greenfeld; Be'Eri,3,0,36,33
1657503468288,MATH 105,A01,085443,Carter; Anne Toulson,15,0,35,20
1657503468288,MATH 105,A02,093477,Carter; Anne Toulson,20,0,35,15
1657503474315,MATH 109,A01,083213,Ganzberger; Geoffrey Michael,2,0,34,32
1657503474315,MATH 109,A02,083214,Ganzberger; Geoffrey Michael,4,0,34,30
1657503474315,MATH 109,A03,093478,Ganzberger; Geoffrey Michael,2,0,34,32
1657503474315,MATH 109,B01,083215,Ganzberger; Geoffrey Michael,1,0,32,31
1657503474315,MATH 109,B02,083216,Ganzberger; Geoffrey Michael,2,0,32,30
1657503474315,MATH 109,B03,093479,Ganzberger; Geoffrey Michael,8,0,32,24
1657503480348,MATH 142A,A01,083219,Chow; Bennett,7,0,32,25
1657503480348,MATH 142A,A02,083220,Chow; Bennett,10,0,32,22
1657503480348,MATH 142A,A03,093480,Chow; Bennett,8,0,32,24
1657503480348,MATH 142A,B03,093481,Chow; Bennett,8,0,32,24
1657503480348,MATH 142A,B04,093558,Chow; Bennett,13,0,32,19
1657503480348,MATH 142A,B05,093559,Chow; Bennett,6,0,32,26
1657503486373,MATH 193A,A01,083224,Rotar; Vladimir,8,0,34,26
1657503486373,MATH 193A,A02,083225,Rotar; Vladimir,9,0,34,25
1657503486373,MATH 193A,A03,083781,Rotar; Vladimir,5,0,34,29
1657503486373,MATH 193A,A04,083782,Rotar; Vladimir,10,0,34,24
1657503486373,MATH 193A,A05,093482,Rotar; Vladimir,10,0,34,24
1657503492396,MATH 197,001,091859,McAuley; Julian John,9999,0,9999,0
1657503492396,MATH 197,002,095566,Kedlaya; Kiran S.,9997,0,9999,2
1657503492396,MATH 197,003,095567,Xiao; Ming,9999,0,9999,0
1657503492396,MATH 197,004,095571,Perols; Johan Lars,9998,0,9999,1
1657503499449,COGS 9,A01,083615,Shannon; Kyle Michael,9,0,75,66
1657503505476,COGS 11,A01,083617,Boyle; Mary E. T.,22,0,48,26
1657503511502,COGS 13,A01,083071,Bastos; Amalia Pinkusfeld,11,0,71,60
1657503517524,COGS 14A,A01,092681,Semenuks; Arturs,5,1,100,95
1657503523548,COGS 14B,A01,083073,Cheng; Tzu-Han,6,0,63,57
1657503529576,COGS 17,A01,092677,Semenuks; Arturs,6,0,81,75
1657503535600,COGS 100,A01,083619,Allen; Michael Gordon,17,0,70,53
1657503541635,COGS 101A,A01,083621,Davis; Joshua Daniel,9,0,68,59
1657503547657,COGS 101B,A01,091572,Allen; Michael Gordon,12,0,65,53
1657503553678,COGS 101C,A01,083625,Delgado; Tania,17,0,35,18
1657503559700,COGS 107A,A01,083627,Boyle; Mary E. T.,13,0,60,47
1657503565722,COGS 118A,A01,083075,Gupta; Anjum,21,0,76,55
1657503571747,CSE 3,A50,083646,Miranda; Gregory Joseph,24,0,50,26
1657503577768,CSE 8A,A50,083650,Miranda; Gregory Joseph,17,1,56,39
1657503583791,CSE 11,A01,083080,Cao; Yingjun,6,15,40,34
1657503589814,CSE 12,A01,083652,Krause-Levy; Sophia Louisa,28,1,120,92
1657503595842,CSE 15L,A01,083654,Morris; Justin Loren,9,0,50,41
1657503595842,CSE 15L,A02,083655,Morris; Justin Loren,9,0,50,41
1657503601863,CSE 20,A01,083657,Tran; Khoa Dang,39,0,80,41
1657503607890,CSE 21,A01,095574,Bach; Quang Tran,22,0,48,26
1657503613911,CSE 30,A01,083084,Eldon; John,5,0,80,75
1657503613911,CSE 30,B01,095061,Bhaskar; Nishant,9,0,50,41
1657503619937,CSE 100,A01,083659,Cao; Yingjun,5,4,70,65
1657503625960,CSE 134B,A01,083661,Powell; Thomas Allan,22,0,100,78
1657503631987,CSE 140,A01,083663,Gungor; Onat,15,0,85,70
1657503638011,CSE 140L,A01,083088,Eldon; John,21,0,100,79
1657503644035,CSE 175,A01,083665,Kumar; Rakesh,3,0,25,22
1657503650057,CSE 190,A00,092507,Dubnov; Shlomo,8,0,20,12
1657503656079,ECE 45,A01,083139,Congero; Spencer William,6,0,75,69
1657503662104,ECE 65,A50,083695,Saad; Andrew S,12,0,30,18
1657503662104,ECE 65,A51,095125,Saad; Andrew S,24,0,26,2
1657503668129,ECE 109,A01,091882,Touri; Behrouz,19,0,70,51
1657503674153,ECE 180,A00,083140,Abi Samra; Nicholas Camill,1,0,30,29
1657503674153,ECE 180,B00,083141,Abi Samra; Nicholas Camill,0,0,30,30
1657503680177,MATH 10A,A01,083735,Patchell; Gregory David,2,0,30,28
1657503680177,MATH 10A,A02,083736,Patchell; Gregory David,20,0,30,10
1657503680177,MATH 10A,A03,083737,Patchell; Gregory David,16,0,30,14
1657503686204,MATH 10B,A01,083207,Lim; Seonhee,8,0,34,26
1657503686204,MATH 10B,A02,083208,Lim; Seonhee,9,0,35,26
1657503686204,MATH 10B,A03,093472,Lim; Seonhee,7,0,34,27
1657503686204,MATH 10B,B01,083739,Sinha; Shubham,12,0,30,18
1657503692234,MATH 18,A01,083743,Cinel; Cameron Alexander,7,0,30,23
1657503692234,MATH 18,A02,083744,Cinel; Cameron Alexander,17,0,30,13
1657503692234,MATH 18,A03,083745,Cinel; Cameron Alexander,9,0,30,21
1657503692234,MATH 18,B01,083748,Rideout; David Porter,5,0,37,32
1657503692234,MATH 18,B02,083749,Rideout; David Porter,5,0,36,31
1657503692234,MATH 18,B03,083750,Rideout; David Porter,3,0,37,34
1657503692234,MATH 18,B04,083751,Rideout; David Porter,6,0,36,30
1657503692234,MATH 18,B05,093473,Rideout; David Porter,6,0,36,30
1657503692234,MATH 18,B06,093474,Rideout; David Porter,6,0,36,30
1657503698259,MATH 20A,A01,083754,Zheng; Zequn,14,0,40,26
1657503704287,MATH 20B,A01,083756,Briones; Jor-el Thomas Caparas,4,0,36,32
1657503704287,MATH 20B,A02,083757,Briones; Jor-el Thomas Caparas,1,0,36,35
1657503704287,MATH 20B,A03,093475,Briones; Jor-el Thomas Caparas,2,0,36,34
1657503710316,MATH 20C,A01,083760,Briones; Jor-el Thomas Caparas,1,0,35,34
1657503710316,MATH 20C,A02,083761,Briones; Jor-el Thomas Caparas,8,0,35,27
1657503710316,MATH 20C,A03,093476,Briones; Jor-el Thomas Caparas,0,1,36,36
1657503710316,MATH 20C,B01,083762,Bach; Quang Tran,1,0,30,29
1657503716344,MATH 20D,A01,083765,Tran; Brian Kha,5,0,30,25
1657503716344,MATH 20D,A02,083766,Tran; Brian Kha,5,0,30,25
1657503716344,MATH 20D,A03,083767,Tran; Brian Kha,5,0,30,25
1657503722381,MATH 20E,A01,083771,Ganguly; Soumya,9,0,32,23
1657503722381,MATH 20E,A02,083772,Ganguly; Soumya,6,0,32,26
1657503722381,MATH 20E,B01,083773,Ciotti; Benjamin,20,0,35,15
1657503722381,MATH 20E,B02,083774,Ciotti; Benjamin,17,0,35,18
1657503728410,MATH 103A,A01,083777,Greenfeld; Be'Eri,3,0,36,33
1657503728410,MATH 103A,A02,083778,Greenfeld; Be'Eri,5,0,36,31
1657503728410,MATH 103A,A03,093561,Greenfeld; Be'Eri,5,0,36,31
1657503728410,MATH 103A,B01,083779,Greenfeld; Be'Eri,7,0,36,29
1657503728410,MATH 103A,B02,083780,Greenfeld; Be'Eri,4,0,36,32
1657503728410,MATH 103A,B03,093562,Greenfeld; Be'Eri,3,0,36,33
1657503734437,MATH 105,A01,085443,Carter; Anne Toulson,15,0,35,20
1657503734437,MATH 105,A02,093477,Carter; Anne Toulson,20,0,35,15
1657503740472,MATH 109,A01,083213,Ganzberger; Geoffrey Michael,2,0,34,32
1657503740472,MATH 109,A02,083214,Ganzberger; Geoffrey Michael,4,0,34,30
1657503740472,MATH 109,A03,093478,Ganzberger; Geoffrey Michael,2,0,34,32
1657503740472,MATH 109,B01,083215,Ganzberger; Geoffrey Michael,1,0,32,31
1657503740472,MATH 109,B02,083216,Ganzberger; Geoffrey Michael,2,0,32,30
1657503740472,MATH 109,B03,093479,Ganzberger; Geoffrey Michael,8,0,32,24
1657503746505,MATH 142A,A01,083219,Chow; Bennett,7,0,32,25
1657503746505,MATH 142A,A02,083220,Chow; Bennett,10,0,32,22
1657503746505,MATH 142A,A03,093480,Chow; Bennett,8,0,32,24
1657503746505,MATH 142A,B03,093481,Chow; Bennett,8,0,32,24
1657503746505,MATH 142A,B04,093558,Chow; Bennett,13,0,32,19
1657503746505,MATH 142A,B05,093559,Chow; Bennett,6,0,32,26
1657503752631,MATH 193A,A01,083224,Rotar; Vladimir,8,0,34,26
1657503752631,MATH 193A,A02,083225,Rotar; Vladimir,9,0,34,25
1657503752631,MATH 193A,A03,083781,Rotar; Vladimir,5,0,34,29
1657503752631,MATH 193A,A04,083782,Rotar; Vladimir,10,0,34,24
1657503752631,MATH 193A,A05,093482,Rotar; Vladimir,10,0,34,24
1657503758657,MATH 197,001,091859,McAuley; Julian John,9999,0,9999,0
1657503758657,MATH 197,002,095566,Kedlaya; Kiran S.,9997,0,9999,2
1657503758657,MATH 197,003,095567,Xiao; Ming,9999,0,9999,0
1657503758657,MATH 197,004,095571,Perols; Johan Lars,9998,0,9999,1
1657503765714,COGS 9,A01,083615,Shannon; Kyle Michael,9,0,75,66
1657503771735,COGS 11,A01,083617,Boyle; Mary E. T.,22,0,48,26
1657503777764,COGS 13,A01,083071,Bastos; Amalia Pinkusfeld,11,0,71,60
1657503783788,COGS 14A,A01,092681,Semenuks; Arturs,5,1,100,95
1657503789810,COGS 14B,A01,083073,Cheng; Tzu-Han,6,0,63,57
1657503795835,COGS 17,A01,092677,Semenuks; Arturs,6,0,81,75
1657503801859,COGS 100,A01,083619,Allen; Michael Gordon,17,0,70,53
1657503807883,COGS 101A,A01,083621,Davis; Joshua Daniel,9,0,68,59
1657503813907,COGS 101B,A01,091572,Allen; Michael Gordon,12,0,65,53
1657503819933,COGS 101C,A01,083625,Delgado; Tania,17,0,35,18
1657503825960,COGS 107A,A01,083627,Boyle; Mary E. T.,13,0,60,47
1657503831983,COGS 118A,A01,083075,Gupta; Anjum,21,0,76,55
1657503838012,CSE 3,A50,083646,Miranda; Gregory Joseph,24,0,50,26
1657503844035,CSE 8A,A50,083650,Miranda; Gregory Joseph,17,1,56,39
1657503850062,CSE 11,A01,083080,Cao; Yingjun,6,15,40,34
1657503856088,CSE 12,A01,083652,Krause-Levy; Sophia Louisa,28,1,120,92
1657503862115,CSE 15L,A01,083654,Morris; Justin Loren,9,0,50,41
1657503862115,CSE 15L,A02,083655,Morris; Justin Loren,9,0,50,41
1657503868136,CSE 20,A01,083657,Tran; Khoa Dang,39,0,80,41
1657503874160,CSE 21,A01,095574,Bach; Quang Tran,22,0,48,26
1657503880187,CSE 30,A01,083084,Eldon; John,5,0,80,75
1657503880187,CSE 30,B01,095061,Bhaskar; Nishant,9,0,50,41
1657503886209,CSE 100,A01,083659,Cao; Yingjun,5,4,70,65
1657503892233,CSE 134B,A01,083661,Powell; Thomas Allan,22,0,100,78
1657503898260,CSE 140,A01,083663,Gungor; Onat,15,0,85,70
1657503904283,CSE 140L,A01,083088,Eldon; John,21,0,100,79
1657503910305,CSE 175,A01,083665,Kumar; Rakesh,3,0,25,22
1657503916338,CSE 190,A00,092507,Dubnov; Shlomo,8,0,20,12
1657503922361,ECE 45,A01,083139,Congero; Spencer William,6,0,75,69
1657503928386,ECE 65,A50,083695,Saad; Andrew S,12,0,30,18
1657503928386,ECE 65,A51,095125,Saad; Andrew S,24,0,26,2
1657503934412,ECE 109,A01,091882,Touri; Behrouz,19,0,70,51
1657503940434,ECE 180,A00,083140,Abi Samra; Nicholas Camill,1,0,30,29
1657503940434,ECE 180,B00,083141,Abi Samra; Nicholas Camill,0,0,30,30
1657503946466,MATH 10A,A01,083735,Patchell; Gregory David,2,0,30,28
1657503946466,MATH 10A,A02,083736,Patchell; Gregory David,20,0,30,10
1657503946466,MATH 10A,A03,083737,Patchell; Gregory David,16,0,30,14
1657503952494,MATH 10B,A01,083207,Lim; Seonhee,8,0,34,26
1657503952494,MATH 10B,A02,083208,Lim; Seonhee,9,0,35,26
1657503952494,MATH 10B,A03,093472,Lim; Seonhee,7,0,34,27
1657503952494,MATH 10B,B01,083739,Sinha; Shubham,12,0,30,18
1657503958519,MATH 18,A01,083743,Cinel; Cameron Alexander,7,0,30,23
1657503958519,MATH 18,A02,083744,Cinel; Cameron Alexander,17,0,30,13
1657503958519,MATH 18,A03,083745,Cinel; Cameron Alexander,9,0,30,21
1657503958519,MATH 18,B01,083748,Rideout; David Porter,5,0,37,32
1657503958519,MATH 18,B02,083749,Rideout; David Porter,5,0,36,31
1657503958519,MATH 18,B03,083750,Rideout; David Porter,3,0,37,34
1657503958519,MATH 18,B04,083751,Rideout; David Porter,6,0,36,30
1657503958519,MATH 18,B05,093473,Rideout; David Porter,6,0,36,30
1657503958519,MATH 18,B06,093474,Rideout; David Porter,6,0,36,30
1657503964545,MATH 20A,A01,083754,Zheng; Zequn,14,0,40,26
1657503970572,MATH 20B,A01,083756,Briones; Jor-el Thomas Caparas,4,0,36,32
1657503970572,MATH 20B,A02,083757,Briones; Jor-el Thomas Caparas,1,0,36,35
1657503970572,MATH 20B,A03,093475,Briones; Jor-el Thomas Caparas,2,0,36,34
1657503976600,MATH 20C,A01,083760,Briones; Jor-el Thomas Caparas,1,0,35,34
1657503976600,MATH 20C,A02,083761,Briones; Jor-el Thomas Caparas,8,0,35,27
1657503976600,MATH 20C,A03,093476,Briones; Jor-el Thomas Caparas,0,1,36,36
1657503976600,MATH 20C,B01,083762,Bach; Quang Tran,1,0,30,29
1657503982632,MATH 20D,A01,083765,Tran; Brian Kha,5,0,30,25
1657503982632,MATH 20D,A02,083766,Tran; Brian Kha,5,0,30,25
1657503982632,MATH 20D,A03,083767,Tran; Brian Kha,5,0,30,25
1657503988667,MATH 20E,A01,083771,Ganguly; Soumya,9,0,32,23
1657503988667,MATH 20E,A02,083772,Ganguly; Soumya,6,0,32,26
1657503988667,MATH 20E,B01,083773,Ciotti; Benjamin,20,0,35,15
1657503988667,MATH 20E,B02,083774,Ciotti; Benjamin,17,0,35,18
1657503994697,MATH 103A,A01,083777,Greenfeld; Be'Eri,3,0,36,33
1657503994697,MATH 103A,A02,083778,Greenfeld; Be'Eri,5,0,36,31
1657503994697,MATH 103A,A03,093561,Greenfeld; Be'Eri,5,0,36,31
1657503994697,MATH 103A,B01,083779,Greenfeld; Be'Eri,7,0,36,29
1657503994697,MATH 103A,B02,083780,Greenfeld; Be'Eri,4,0,36,32
1657503994697,MATH 103A,B03,093562,Greenfeld; Be'Eri,3,0,36,33
1657504000719,MATH 105,A01,085443,Carter; Anne Toulson,15,0,35,20
1657504000719,MATH 105,A02,093477,Carter; Anne Toulson,20,0,35,15
1657504006744,MATH 109,A01,083213,Ganzberger; Geoffrey Michael,2,0,34,32
1657504006744,MATH 109,A02,083214,Ganzberger; Geoffrey Michael,4,0,34,30
1657504006744,MATH 109,A03,093478,Ganzberger; Geoffrey Michael,2,0,34,32
1657504006744,MATH 109,B01,083215,Ganzberger; Geoffrey Michael,1,0,32,31
1657504006744,MATH 109,B02,083216,Ganzberger; Geoffrey Michael,2,0,32,30
1657504006744,MATH 109,B03,093479,Ganzberger; Geoffrey Michael,8,0,32,24
1657504012769,MATH 142A,A01,083219,Chow; Bennett,7,0,32,25
1657504012769,MATH 142A,A02,083220,Chow; Bennett,10,0,32,22
1657504012769,MATH 142A,A03,093480,Chow; Bennett,8,0,32,24
1657504012769,MATH 142A,B03,093481,Chow; Bennett,8,0,32,24
1657504012769,MATH 142A,B04,093558,Chow; Bennett,13,0,32,19
1657504012769,MATH 142A,B05,093559,Chow; Bennett,6,0,32,26
1657504018792,MATH 193A,A01,083224,Rotar; Vladimir,8,0,34,26
1657504018792,MATH 193A,A02,083225,Rotar; Vladimir,9,0,34,25
1657504018792,MATH 193A,A03,083781,Rotar; Vladimir,5,0,34,29
1657504018792,MATH 193A,A04,083782,Rotar; Vladimir,10,0,34,24
1657504018792,MATH 193A,A05,093482,Rotar; Vladimir,10,0,34,24
1657504024814,MATH 197,001,091859,McAuley; Julian John,9999,0,9999,0
1657504024814,MATH 197,002,095566,Kedlaya; Kiran S.,9997,0,9999,2
1657504024814,MATH 197,003,095567,Xiao; Ming,9999,0,9999,0
1657504024814,MATH 197,004,095571,Perols; Johan Lars,9998,0,9999,1
1657504031883,COGS 9,A01,083615,Shannon; Kyle Michael,9,0,75,66
1657504037910,COGS 11,A01,083617,Boyle; Mary E. T.,22,0,48,26
1657504043940,COGS 13,A01,083071,Bastos; Amalia Pinkusfeld,11,0,71,60
1657504049964,COGS 14A,A01,092681,Semenuks; Arturs,5,1,100,95
1657504055990,COGS 14B,A01,083073,Cheng; Tzu-Han,6,0,63,57
1657504062016,COGS 17,A01,092677,Semenuks; Arturs,6,0,81,75
1657504068042,COGS 100,A01,083619,Allen; Michael Gordon,17,0,70,53
1657504074069,COGS 101A,A01,083621,Davis; Joshua Daniel,9,0,68,59
1657504080092,COGS 101B,A01,091572,Allen; Michael Gordon,12,0,65,53
1657504086128,COGS 101C,A01,083625,Delgado; Tania,17,0,35,18
1657504092150,COGS 107A,A01,083627,Boyle; Mary E. T.,13,0,60,47
1657504098178,COGS 118A,A01,083075,Gupta; Anjum,21,0,76,55
1657504104205,CSE 3,A50,083646,Miranda; Gregory Joseph,24,0,50,26
1657504110231,CSE 8A,A50,083650,Miranda; Gregory Joseph,17,1,56,39
1657504116257,CSE 11,A01,083080,Cao; Yingjun,6,15,40,34
1657504122282,CSE 12,A01,083652,Krause-Levy; Sophia Louisa,28,1,120,92
1657504128313,CSE 15L,A01,083654,Morris; Justin Loren,9,0,50,41
1657504128313,CSE 15L,A02,083655,Morris; Justin Loren,9,0,50,41
1657504134336,CSE 20,A01,083657,Tran; Khoa Dang,39,0,80,41
1657504140362,CSE 21,A01,095574,Bach; Quang Tran,22,0,48,26
1657504146386,CSE 30,A01,083084,Eldon; John,5,0,80,75
1657504146386,CSE 30,B01,095061,Bhaskar; Nishant,9,0,50,41
1657504152413,CSE 100,A01,083659,Cao; Yingjun,5,4,70,65
1657504158435,CSE 134B,A01,083661,Powell; Thomas Allan,22,0,100,78
1657504164457,CSE 140,A01,083663,Gungor; Onat,15,0,85,70
1657504170481,CSE 140L,A01,083088,Eldon; John,21,0,100,79
1657504176510,CSE 175,A01,083665,Kumar; Rakesh,3,0,25,22
1657504182533,CSE 190,A00,092507,Dubnov; Shlomo,8,0,20,12
1657504188556,ECE 45,A01,083139,Congero; Spencer William,6,0,75,69
1657504194580,ECE 65,A50,083695,Saad; Andrew S,12,0,30,18
1657504194580,ECE 65,A51,095125,Saad; Andrew S,24,0,26,2
1657504200605,ECE 109,A01,091882,Touri; Behrouz,19,0,70,51
1657504206627,ECE 180,A00,083140,Abi Samra; Nicholas Camill,1,0,30,29
1657504206627,ECE 180,B00,083141,Abi Samra; Nicholas Camill,0,0,30,30
1657504212655,MATH 10A,A01,083735,Patchell; Gregory David,2,0,30,28
1657504212655,MATH 10A,A02,083736,Patchell; Gregory David,20,0,30,10
1657504212655,MATH 10A,A03,083737,Patchell; Gregory David,16,0,30,14
1657504218677,MATH 10B,A01,083207,Lim; Seonhee,8,0,34,26
1657504218677,MATH 10B,A02,083208,Lim; Seonhee,9,0,35,26
1657504218677,MATH 10B,A03,093472,Lim; Seonhee,7,0,34,27
1657504218677,MATH 10B,B01,083739,Sinha; Shubham,12,0,30,18
1657504224702,MATH 18,A01,083743,Cinel; Cameron Alexander,7,0,30,23
1657504224702,MATH 18,A02,083744,Cinel; Cameron Alexander,17,0,30,13
1657504224702,MATH 18,A03,083745,Cinel; Cameron Alexander,9,0,30,21
1657504224702,MATH 18,B01,083748,Rideout; David Porter,5,0,37,32
1657504224702,MATH 18,B02,083749,Rideout; David Porter,5,0,36,31
1657504224702,MATH 18,B03,083750,Rideout; David Porter,3,0,37,34
1657504224702,MATH 18,B04,083751,Rideout; David Porter,6,0,36,30
1657504224702,MATH 18,B05,093473,Rideout; David Porter,6,0,36,30
1657504224702,MATH 18,B06,093474,Rideout; David Porter,6,0,36,30
1657504230736,MATH 20A,A01,083754,Zheng; Zequn,14,0,40,26
1657504236760,MATH 20B,A01,083756,Briones; Jor-el Thomas Caparas,4,0,36,32
1657504236760,MATH 20B,A02,083757,Briones; Jor-el Thomas Caparas,1,0,36,35
1657504236760,MATH 20B,A03,093475,Briones; Jor-el Thomas Caparas,2,0,36,34
1657504242783,MATH 20C,A01,083760,Briones; Jor-el Thomas Caparas,1,0,35,34
1657504242783,MATH 20C,A02,083761,Briones; Jor-el Thomas Caparas,8,0,35,27
1657504242783,MATH 20C,A03,093476,Briones; Jor-el Thomas Caparas,0,1,36,36
1657504242783,MATH 20C,B01,083762,Bach; Quang Tran,1,0,30,29
1657504248813,MATH 20D,A01,083765,Tran; Brian Kha,5,0,30,25
1657504248813,MATH 20D,A02,083766,Tran; Brian Kha,5,0,30,25
1657504248813,MATH 20D,A03,083767,Tran; Brian Kha,5,0,30,25
1657504254841,MATH 20E,A01,083771,Ganguly; Soumya,9,0,32,23
1657504254841,MATH 20E,A02,083772,Ganguly; Soumya,6,0,32,26
1657504254841,MATH 20E,B01,083773,Ciotti; Benjamin,20,0,35,15
1657504254841,MATH 20E,B02,083774,Ciotti; Benjamin,17,0,35,18
1657504260865,MATH 103A,A01,083777,Greenfeld; Be'Eri,3,0,36,33
1657504260865,MATH 103A,A02,083778,Greenfeld; Be'Eri,5,0,36,31
1657504260865,MATH 103A,A03,093561,Greenfeld; Be'Eri,5,0,36,31
1657504260865,MATH 103A,B01,083779,Greenfeld; Be'Eri,7,0,36,29
1657504260865,MATH 103A,B02,083780,Greenfeld; Be'Eri,4,0,36,32
1657504260865,MATH 103A,B03,093562,Greenfeld; Be'Eri,3,0,36,33
1657504266892,MATH 105,A01,085443,Carter; Anne Toulson,15,0,35,20
1657504266892,MATH 105,A02,093477,Carter; Anne Toulson,20,0,35,15
1657504272920,MATH 109,A01,083213,Ganzberger; Geoffrey Michael,2,0,34,32
1657504272920,MATH 109,A02,083214,Ganzberger; Geoffrey Michael,4,0,34,30
1657504272920,MATH 109,A03,093478,Ganzberger; Geoffrey Michael,2,0,34,32
1657504272920,MATH 109,B01,083215,Ganzberger; Geoffrey Michael,1,0,32,31
1657504272920,MATH 109,B02,083216,Ganzberger; Geoffrey Michael,2,0,32,30
1657504272920,MATH 109,B03,093479,Ganzberger; Geoffrey Michael,8,0,32,24
1657504278944,MATH 142A,A01,083219,Chow; Bennett,7,0,32,25
1657504278944,MATH 142A,A02,083220,Chow; Bennett,10,0,32,22
1657504278944,MATH 142A,A03,093480,Chow; Bennett,8,0,32,24
1657504278944,MATH 142A,B03,093481,Chow; Bennett,8,0,32,24
1657504278944,MATH 142A,B04,093558,Chow; Bennett,13,0,32,19
1657504278944,MATH 142A,B05,093559,Chow; Bennett,6,0,32,26
1657504284967,MATH 193A,A01,083224,Rotar; Vladimir,8,0,34,26
1657504284967,MATH 193A,A02,083225,Rotar; Vladimir,9,0,34,25
1657504284967,MATH 193A,A03,083781,Rotar; Vladimir,5,0,34,29
1657504284967,MATH 193A,A04,083782,Rotar; Vladimir,10,0,34,24
1657504284967,MATH 193A,A05,093482,Rotar; Vladimir,10,0,34,24
1657504290991,MATH 197,001,091859,McAuley; Julian John,9999,0,9999,0
1657504290991,MATH 197,002,095566,Kedlaya; Kiran S.,9997,0,9999,2
1657504290991,MATH 197,003,095567,Xiao; Ming,9999,0,9999,0
1657504290991,MATH 197,004,095571,Perols; Johan Lars,9998,0,9999,1
1657504298041,COGS 9,A01,083615,Shannon; Kyle Michael,9,0,75,66
1657504304062,COGS 11,A01,083617,Boyle; Mary E. T.,22,0,48,26
1657504310087,COGS 13,A01,083071,Bastos; Amalia Pinkusfeld,11,0,71,60
1657504316118,COGS 14A,A01,092681,Semenuks; Arturs,5,1,100,95
1657504322141,COGS 14B,A01,083073,Cheng; Tzu-Han,6,0,63,57
1657504328163,COGS 17,A01,092677,Semenuks; Arturs,6,0,81,75
1657504334185,COGS 100,A01,083619,Allen; Michael Gordon,17,0,70,53
1657504340212,COGS 101A,A01,083621,Davis; Joshua Daniel,9,0,68,59
1657504346306,COGS 101B,A01,091572,Allen; Michael Gordon,12,0,65,53
1657504352333,COGS 101C,A01,083625,Delgado; Tania,17,0,35,18
1657504358355,COGS 107A,A01,083627,Boyle; Mary E. T.,13,0,60,47
1657504364380,COGS 118A,A01,083075,Gupta; Anjum,21,0,76,55
1657504370405,CSE 3,A50,083646,Miranda; Gregory Joseph,24,0,50,26
1657504376428,CSE 8A,A50,083650,Miranda; Gregory Joseph,17,1,56,39
1657504382463,CSE 11,A01,083080,Cao; Yingjun,6,15,40,34
1657504388485,CSE 12,A01,083652,Krause-Levy; Sophia Louisa,28,1,120,92
1657504394507,CSE 15L,A01,083654,Morris; Justin Loren,9,0,50,41
1657504394507,CSE 15L,A02,083655,Morris; Justin Loren,9,0,50,41
1657504400532,CSE 20,A01,083657,Tran; Khoa Dang,39,0,80,41
1657504406561,CSE 21,A01,095574,Bach; Quang Tran,22,0,48,26
1657504412591,CSE 30,A01,083084,Eldon; John,5,0,80,75
1657504412591,CSE 30,B01,095061,Bhaskar; Nishant,9,0,50,41
1657504418613,CSE 100,A01,083659,Cao; Yingjun,5,4,70,65
1657504424636,CSE 134B,A01,083661,Powell; Thomas Allan,22,0,100,78
1657504430658,CSE 140,A01,083663,Gungor; Onat,15,0,85,70
1657504436680,CSE 140L,A01,083088,Eldon; John,21,0,100,79
1657504442705,CSE 175,A01,083665,Kumar; Rakesh,3,0,25,22
1657504448730,CSE 190,A00,092507,Dubnov; Shlomo,8,0,20,12
1657504454751,ECE 45,A01,083139,Congero; Spencer William,6,0,75,69
1657504460773,ECE 65,A50,083695,Saad; Andrew S,12,0,30,18
1657504460773,ECE 65,A51,095125,Saad; Andrew S,24,0,26,2
1657504466798,ECE 109,A01,091882,Touri; Behrouz,19,0,70,51
1657504472820,ECE 180,A00,083140,Abi Samra; Nicholas Camill,1,0,30,29
1657504472820,ECE 180,B00,083141,Abi Samra; Nicholas Camill,0,0,30,30
1657504478843,MATH 10A,A01,083735,Patchell; Gregory David,2,0,30,28
1657504478843,MATH 10A,A02,083736,Patchell; Gregory David,20,0,30,10
1657504478843,MATH 10A,A03,083737,Patchell; Gregory David,16,0,30,14
1657504484872,MATH 10B,A01,083207,Lim; Seonhee,8,0,34,26
1657504484872,MATH 10B,A02,083208,Lim; Seonhee,9,0,35,26
1657504484872,MATH 10B,A03,093472,Lim; Seonhee,7,0,34,27
1657504484872,MATH 10B,B01,083739,Sinha; Shubham,12,0,30,18
1657504490901,MATH 18,A01,083743,Cinel; Cameron Alexander,7,0,30,23
1657504490901,MATH 18,A02,083744,Cinel; Cameron Alexander,17,0,30,13
1657504490901,MATH 18,A03,083745,Cinel; Cameron Alexander,9,0,30,21
1657504490901,MATH 18,B01,083748,Rideout; David Porter,5,0,37,32
1657504490901,MATH 18,B02,083749,Rideout; David Porter,5,0,36,31
1657504490901,MATH 18,B03,083750,Rideout; David Porter,3,0,37,34
1657504490901,MATH 18,B04,083751,Rideout; David Porter,6,0,36,30
1657504490901,MATH 18,B05,093473,Rideout; David Porter,6,0,36,30
1657504490901,MATH 18,B06,093474,Rideout; David Porter,6,0,36,30
1657504496925,MATH 20A,A01,083754,Zheng; Zequn,14,0,40,26
1657504502955,MATH 20B,A01,083756,Briones; Jor-el Thomas Caparas,4,0,36,32
1657504502955,MATH 20B,A02,083757,Briones; Jor-el Thomas Caparas,1,0,36,35
1657504502955,MATH 20B,A03,093475,Briones; Jor-el Thomas Caparas,2,0,36,34
1657504508977,MATH 20C,A01,083760,Briones; Jor-el Thomas Caparas,1,0,35,34
1657504508977,MATH 20C,A02,083761,Briones; Jor-el Thomas Caparas,8,0,35,27
1657504508977,MATH 20C,A03,093476,Briones; Jor-el Thomas Caparas,0,1,36,36
1657504508977,MATH 20C,B01,083762,Bach; Quang Tran,1,0,30,29
1657504515001,MATH 20D,A01,083765,Tran; Brian Kha,5,0,30,25
1657504515001,MATH 20D,A02,083766,Tran; Brian Kha,5,0,30,25
1657504515001,MATH 20D,A03,083767,Tran; Brian Kha,5,0,30,25
1657504521030,MATH 20E,A01,083771,Ganguly; Soumya,9,0,32,23
1657504521030,MATH 20E,A02,083772,Ganguly; Soumya,6,0,32,26
1657504521030,MATH 20E,B01,083773,Ciotti; Benjamin,20,0,35,15
1657504521030,MATH 20E,B02,083774,Ciotti; Benjamin,17,0,35,18
1657504527053,MATH 103A,A01,083777,Greenfeld; Be'Eri,3,0,36,33
1657504527053,MATH 103A,A02,083778,Greenfeld; Be'Eri,5,0,36,31
1657504527053,MATH 103A,A03,093561,Greenfeld; Be'Eri,5,0,36,31
1657504527053,MATH 103A,B01,083779,Greenfeld; Be'Eri,7,0,36,29
1657504527053,MATH 103A,B02,083780,Greenfeld; Be'Eri,4,0,36,32
1657504527053,MATH 103A,B03,093562,Greenfeld; Be'Eri,3,0,36,33
1657504533078,MATH 105,A01,085443,Carter; Anne Toulson,15,0,35,20
1657504533078,MATH 105,A02,093477,Carter; Anne Toulson,20,0,35,15
1657504539100,MATH 109,A01,083213,Ganzberger; Geoffrey Michael,2,0,34,32
1657504539100,MATH 109,A02,083214,Ganzberger; Geoffrey Michael,4,0,34,30
1657504539100,MATH 109,A03,093478,Ganzberger; Geoffrey Michael,2,0,34,32
1657504539100,MATH 109,B01,083215,Ganzberger; Geoffrey Michael,1,0,32,31
1657504539100,MATH 109,B02,083216,Ganzberger; Geoffrey Michael,2,0,32,30
1657504539100,MATH 109,B03,093479,Ganzberger; Geoffrey Michael,8,0,32,24
1657504545125,MATH 142A,A01,083219,Chow; Bennett,7,0,32,25
1657504545125,MATH 142A,A02,083220,Chow; Bennett,10,0,32,22
1657504545125,MATH 142A,A03,093480,Chow; Bennett,8,0,32,24
1657504545125,MATH 142A,B03,093481,Chow; Bennett,8,0,32,24
1657504545125,MATH 142A,B04,093558,Chow; Bennett,13,0,32,19
1657504545125,MATH 142A,B05,093559,Chow; Bennett,6,0,32,26
1657504551152,MATH 193A,A01,083224,Rotar; Vladimir,8,0,34,26
1657504551152,MATH 193A,A02,083225,Rotar; Vladimir,9,0,34,25
1657504551152,MATH 193A,A03,083781,Rotar; Vladimir,5,0,34,29
1657504551152,MATH 193A,A04,083782,Rotar; Vladimir,10,0,34,24
1657504551152,MATH 193A,A05,093482,Rotar; Vladimir,10,0,34,24
1657504557179,MATH 197,001,091859,McAuley; Julian John,9999,0,9999,0
1657504557179,MATH 197,002,095566,Kedlaya; Kiran S.,9997,0,9999,2
1657504557179,MATH 197,003,095567,Xiao; Ming,9999,0,9999,0
1657504557179,MATH 197,004,095571,Perols; Johan Lars,9998,0,9999,1
1657504564229,COGS 9,A01,083615,Shannon; Kyle Michael,9,0,75,66
1657504570253,COGS 11,A01,083617,Boyle; Mary E. T.,22,0,48,26
1657504576275,COGS 13,A01,083071,Bastos; Amalia Pinkusfeld,11,0,71,60
1657504582298,COGS 14A,A01,092681,Semenuks; Arturs,5,1,100,95
1657504588322,COGS 14B,A01,083073,Cheng; Tzu-Han,6,0,63,57
1657504594347,COGS 17,A01,092677,Semenuks; Arturs,6,0,81,75
1657504600369,COGS 100,A01,083619,Allen; Michael Gordon,17,0,70,53
1657504606396,COGS 101A,A01,083621,Davis; Joshua Daniel,9,0,68,59
1657504612420,COGS 101B,A01,091572,Allen; Michael Gordon,12,0,65,53
1657504618443,COGS 101C,A01,083625,Delgado; Tania,17,0,35,18
1657504624469,COGS 107A,A01,083627,Boyle; Mary E. T.,13,0,60,47
1657504630503,COGS 118A,A01,083075,Gupta; Anjum,21,0,76,55
1657504636527,CSE 3,A50,083646,Miranda; Gregory Joseph,24,0,50,26
1657504642552,CSE 8A,A50,083650,Miranda; Gregory Joseph,17,1,56,39
1657504648580,CSE 11,A01,083080,Cao; Yingjun,6,15,40,34
1657504654608,CSE 12,A01,083652,Krause-Levy; Sophia Louisa,28,1,120,92
1657504660630,CSE 15L,A01,083654,Morris; Justin Loren,9,0,50,41
1657504660630,CSE 15L,A02,083655,Morris; Justin Loren,9,0,50,41
1657504666653,CSE 20,A01,083657,Tran; Khoa Dang,39,0,80,41
1657504672681,CSE 21,A01,095574,Bach; Quang Tran,22,0,48,26
1657504678709,CSE 30,A01,083084,Eldon; John,5,0,80,75
1657504678709,CSE 30,B01,095061,Bhaskar; Nishant,9,0,50,41
1657504684734,CSE 100,A01,083659,Cao; Yingjun,5,4,70,65
1657504690759,CSE 134B,A01,083661,Powell; Thomas Allan,22,0,100,78
1657504696781,CSE 140,A01,083663,Gungor; Onat,15,0,85,70
1657504702807,CSE 140L,A01,083088,Eldon; John,21,0,100,79
1657504708830,CSE 175,A01,083665,Kumar; Rakesh,3,0,25,22
1657504714854,CSE 190,A00,092507,Dubnov; Shlomo,8,0,20,12
1657504720880,ECE 45,A01,083139,Congero; Spencer William,6,0,75,69
1657504726903,ECE 65,A50,083695,Saad; Andrew S,12,0,30,18
1657504726903,ECE 65,A51,095125,Saad; Andrew S,24,0,26,2
1657504732927,ECE 109,A01,091882,Touri; Behrouz,19,0,70,51
1657504738950,ECE 180,A00,083140,Abi Samra; Nicholas Camill,1,0,30,29
1657504738950,ECE 180,B00,083141,Abi Samra; Nicholas Camill,0,0,30,30
1657504744973,MATH 10A,A01,083735,Patchell; Gregory David,2,0,30,28
1657504744973,MATH 10A,A02,083736,Patchell; Gregory David,20,0,30,10
1657504744973,MATH 10A,A03,083737,Patchell; Gregory David,16,0,30,14
1657504750997,MATH 10B,A01,083207,Lim; Seonhee,8,0,34,26
1657504750997,MATH 10B,A02,083208,Lim; Seonhee,9,0,35,26
1657504750997,MATH 10B,A03,093472,Lim; Seonhee,7,0,34,27
1657504750997,MATH 10B,B01,083739,Sinha; Shubham,12,0,30,18
1657504757032,MATH 18,A01,083743,Cinel; Cameron Alexander,7,0,30,23
1657504757032,MATH 18,A02,083744,Cinel; Cameron Alexander,17,0,30,13
1657504757032,MATH 18,A03,083745,Cinel; Cameron Alexander,9,0,30,21
1657504757032,MATH 18,B01,083748,Rideout; David Porter,5,0,37,32
1657504757032,MATH 18,B02,083749,Rideout; David Porter,5,0,36,31
1657504757032,MATH 18,B03,083750,Rideout; David Porter,3,0,37,34
1657504757032,MATH 18,B04,083751,Rideout; David Porter,6,0,36,30
1657504757032,MATH 18,B05,093473,Rideout; David Porter,6,0,36,30
1657504757032,MATH 18,B06,093474,Rideout; David Porter,6,0,36,30
1657504763054,MATH 20A,A01,083754,Zheng; Zequn,14,0,40,26
1657504769081,MATH 20B,A01,083756,Briones; Jor-el Thomas Caparas,4,0,36,32
1657504769081,MATH 20B,A02,083757,Briones; Jor-el Thomas Caparas,1,0,36,35
1657504769081,MATH 20B,A03,093475,Briones; Jor-el Thomas Caparas,2,0,36,34
1657504775106,MATH 20C,A01,083760,Briones; Jor-el Thomas Caparas,1,0,35,34
1657504775106,MATH 20C,A02,083761,Briones; Jor-el Thomas Caparas,8,0,35,27
1657504775106,MATH 20C,A03,093476,Briones; Jor-el Thomas Caparas,0,1,36,36
1657504775106,MATH 20C,B01,083762,Bach; Quang Tran,1,0,30,29
1657504781131,MATH 20D,A01,083765,Tran; Brian Kha,5,0,30,25
1657504781131,MATH 20D,A02,083766,Tran; Brian Kha,5,0,30,25
1657504781131,MATH 20D,A03,083767,Tran; Brian Kha,5,0,30,25
1657504787157,MATH 20E,A01,083771,Ganguly; Soumya,9,0,32,23
1657504787157,MATH 20E,A02,083772,Ganguly; Soumya,6,0,32,26
1657504787157,MATH 20E,B01,083773,Ciotti; Benjamin,20,0,35,15
1657504787157,MATH 20E,B02,083774,Ciotti; Benjamin,17,0,35,18
1657504793197,MATH 103A,A01,083777,Greenfeld; Be'Eri,3,0,36,33
1657504793197,MATH 103A,A02,083778,Greenfeld; Be'Eri,5,0,36,31
1657504793197,MATH 103A,A03,093561,Greenfeld; Be'Eri,5,0,36,31
1657504793197,MATH 103A,B01,083779,Greenfeld; Be'Eri,7,0,36,29
1657504793197,MATH 103A,B02,083780,Greenfeld; Be'Eri,4,0,36,32
1657504793197,MATH 103A,B03,093562,Greenfeld; Be'Eri,3,0,36,33
1657504799231,MATH 105,A01,085443,Carter; Anne Toulson,15,0,35,20
1657504799231,MATH 105,A02,093477,Carter; Anne Toulson,20,0,35,15
1657504805254,MATH 109,A01,083213,Ganzberger; Geoffrey Michael,2,0,34,32
1657504805254,MATH 109,A02,083214,Ganzberger; Geoffrey Michael,4,0,34,30
1657504805254,MATH 109,A03,093478,Ganzberger; Geoffrey Michael,2,0,34,32
1657504805254,MATH 109,B01,083215,Ganzberger; Geoffrey Michael,1,0,32,31
1657504805254,MATH 109,B02,083216,Ganzberger; Geoffrey Michael,2,0,32,30
1657504805254,MATH 109,B03,093479,Ganzberger; Geoffrey Michael,8,0,32,24
1657504811282,MATH 142A,A01,083219,Chow; Bennett,7,0,32,25
1657504811282,MATH 142A,A02,083220,Chow; Bennett,10,0,32,22
1657504811282,MATH 142A,A03,093480,Chow; Bennett,8,0,32,24
1657504811282,MATH 142A,B03,093481,Chow; Bennett,8,0,32,24
1657504811282,MATH 142A,B04,093558,Chow; Bennett,13,0,32,19
1657504811282,MATH 142A,B05,093559,Chow; Bennett,6,0,32,26
1657504817310,MATH 193A,A01,083224,Rotar; Vladimir,8,0,34,26
1657504817310,MATH 193A,A02,083225,Rotar; Vladimir,9,0,34,25
1657504817310,MATH 193A,A03,083781,Rotar; Vladimir,5,0,34,29
1657504817310,MATH 193A,A04,083782,Rotar; Vladimir,10,0,34,24
1657504817310,MATH 193A,A05,093482,Rotar; Vladimir,10,0,34,24
1657504823335,MATH 197,001,091859,McAuley; Julian John,9999,0,9999,0
1657504823335,MATH 197,002,095566,Kedlaya; Kiran S.,9997,0,9999,2
1657504823335,MATH 197,003,095567,Xiao; Ming,9999,0,9999,0
1657504823335,MATH 197,004,095571,Perols; Johan Lars,9998,0,9999,1
1657504830396,COGS 9,A01,083615,Shannon; Kyle Michael,9,0,75,66
1657504836422,COGS 11,A01,083617,Boyle; Mary E. T.,22,0,48,26
1657504842448,COGS 13,A01,083071,Bastos; Amalia Pinkusfeld,11,0,71,60
1657504848488,COGS 14A,A01,092681,Semenuks; Arturs,5,1,100,95
1657504854511,COGS 14B,A01,083073,Cheng; Tzu-Han,6,0,63,57
1657504860537,COGS 17,A01,092677,Semenuks; Arturs,6,0,81,75
1657504866564,COGS 100,A01,083619,Allen; Michael Gordon,17,0,70,53
1657504872587,COGS 101A,A01,083621,Davis; Joshua Daniel,9,0,68,59
1657504878609,COGS 101B,A01,091572,Allen; Michael Gordon,12,0,65,53
1657504884632,COGS 101C,A01,083625,Delgado; Tania,17,0,35,18
1657504890659,COGS 107A,A01,083627,Boyle; Mary E. T.,13,0,60,47
1657504896689,COGS 118A,A01,083075,Gupta; Anjum,21,0,76,55
1657504902712,CSE 3,A50,083646,Miranda; Gregory Joseph,24,0,50,26
1657504908740,CSE 8A,A50,083650,Miranda; Gregory Joseph,17,1,56,39
1657504914767,CSE 11,A01,083080,Cao; Yingjun,6,15,40,34
1657504920794,CSE 12,A01,083652,Krause-Levy; Sophia Louisa,28,1,120,92
1657504926820,CSE 15L,A01,083654,Morris; Justin Loren,9,0,50,41
1657504926820,CSE 15L,A02,083655,Morris; Justin Loren,9,0,50,41
1657504932848,CSE 20,A01,083657,Tran; Khoa Dang,39,0,80,41
1657504938869,CSE 21,A01,095574,Bach; Quang Tran,22,0,48,26
1657504944981,CSE 30,A01,083084,Eldon; John,5,0,80,75
1657504944981,CSE 30,B01,095061,Bhaskar; Nishant,9,0,50,41
1657504951008,CSE 100,A01,083659,Cao; Yingjun,5,4,70,65
1657504957033,CSE 134B,A01,083661,Powell; Thomas Allan,22,0,100,78
1657504963062,CSE 140,A01,083663,Gungor; Onat,15,0,85,70
1657504969096,CSE 140L,A01,083088,Eldon; John,21,0,100,79
1657504975127,CSE 175,A01,083665,Kumar; Rakesh,3,0,25,22
1657504981166,CSE 190,A00,092507,Dubnov; Shlomo,8,0,20,12
1657504987236,ECE 45,A01,083139,Congero; Spencer William,6,0,75,69
1657504993270,ECE 65,A50,083695,Saad; Andrew S,12,0,30,18
1657504993270,ECE 65,A51,095125,Saad; Andrew S,24,0,26,2
1657504999304,ECE 109,A01,091882,Touri; Behrouz,19,0,70,51
1657505005340,ECE 180,A00,083140,Abi Samra; Nicholas Camill,1,0,30,29
1657505005340,ECE 180,B00,083141,Abi Samra; Nicholas Camill,0,0,30,30
1657505011362,MATH 10A,A01,083735,Patchell; Gregory David,2,0,30,28
1657505011362,MATH 10A,A02,083736,Patchell; Gregory David,20,0,30,10
1657505011362,MATH 10A,A03,083737,Patchell; Gregory David,16,0,30,14
1657505017386,MATH 10B,A01,083207,Lim; Seonhee,8,0,34,26
1657505017386,MATH 10B,A02,083208,Lim; Seonhee,9,0,35,26
1657505017386,MATH 10B,A03,093472,Lim; Seonhee,7,0,34,27
1657505017386,MATH 10B,B01,083739,Sinha; Shubham,12,0,30,18
1657505023415,MATH 18,A01,083743,Cinel; Cameron Alexander,7,0,30,23
1657505023415,MATH 18,A02,083744,Cinel; Cameron Alexander,17,0,30,13
1657505023415,MATH 18,A03,083745,Cinel; Cameron Alexander,9,0,30,21
1657505023415,MATH 18,B01,083748,Rideout; David Porter,5,0,37,32
1657505023415,MATH 18,B02,083749,Rideout; David Porter,5,0,36,31
1657505023415,MATH 18,B03,083750,Rideout; David Porter,3,0,37,34
1657505023415,MATH 18,B04,083751,Rideout; David Porter,6,0,36,30
1657505023415,MATH 18,B05,093473,Rideout; David Porter,6,0,36,30
1657505023415,MATH 18,B06,093474,Rideout; David Porter,6,0,36,30
1657505029438,MATH 20A,A01,083754,Zheng; Zequn,14,0,40,26
1657505035465,MATH 20B,A01,083756,Briones; Jor-el Thomas Caparas,4,0,36,32
1657505035465,MATH 20B,A02,083757,Briones; Jor-el Thomas Caparas,1,0,36,35
1657505035465,MATH 20B,A03,093475,Briones; Jor-el Thomas Caparas,2,0,36,34
1657505041493,MATH 20C,A01,083760,Briones; Jor-el Thomas Caparas,1,0,35,34
1657505041493,MATH 20C,A02,083761,Briones; Jor-el Thomas Caparas,8,0,35,27
1657505041493,MATH 20C,A03,093476,Briones; Jor-el Thomas Caparas,0,1,36,36
1657505041493,MATH 20C,B01,083762,Bach; Quang Tran,1,0,30,29
1657505047524,MATH 20D,A01,083765,Tran; Brian Kha,5,0,30,25
1657505047524,MATH 20D,A02,083766,Tran; Brian Kha,5,0,30,25
1657505047524,MATH 20D,A03,083767,Tran; Brian Kha,5,0,30,25
1657505053548,MATH 20E,A01,083771,Ganguly; Soumya,9,0,32,23
1657505053548,MATH 20E,A02,083772,Ganguly; Soumya,6,0,32,26
1657505053548,MATH 20E,B01,083773,Ciotti; Benjamin,20,0,35,15
1657505053548,MATH 20E,B02,083774,Ciotti; Benjamin,17,0,35,18
1657505059577,MATH 103A,A01,083777,Greenfeld; Be'Eri,3,0,36,33
1657505059577,MATH 103A,A02,083778,Greenfeld; Be'Eri,5,0,36,31
1657505059577,MATH 103A,A03,093561,Greenfeld; Be'Eri,5,0,36,31
1657505059577,MATH 103A,B01,083779,Greenfeld; Be'Eri,7,0,36,29
1657505059577,MATH 103A,B02,083780,Greenfeld; Be'Eri,4,0,36,32
1657505059577,MATH 103A,B03,093562,Greenfeld; Be'Eri,3,0,36,33
1657505065598,MATH 105,A01,085443,Carter; Anne Toulson,15,0,35,20
1657505065598,MATH 105,A02,093477,Carter; Anne Toulson,20,0,35,15
1657505071628,MATH 109,A01,083213,Ganzberger; Geoffrey Michael,2,0,34,32
1657505071628,MATH 109,A02,083214,Ganzberger; Geoffrey Michael,4,0,34,30
1657505071628,MATH 109,A03,093478,Ganzberger; Geoffrey Michael,2,0,34,32
1657505071628,MATH 109,B01,083215,Ganzberger; Geoffrey Michael,1,0,32,31
1657505071628,MATH 109,B02,083216,Ganzberger; Geoffrey Michael,2,0,32,30
1657505071628,MATH 109,B03,093479,Ganzberger; Geoffrey Michael,8,0,32,24
1657505077655,MATH 142A,A01,083219,Chow; Bennett,7,0,32,25
1657505077655,MATH 142A,A02,083220,Chow; Bennett,10,0,32,22
1657505077655,MATH 142A,A03,093480,Chow; Bennett,8,0,32,24
1657505077655,MATH 142A,B03,093481,Chow; Bennett,8,0,32,24
1657505077655,MATH 142A,B04,093558,Chow; Bennett,13,0,32,19
1657505077655,MATH 142A,B05,093559,Chow; Bennett,6,0,32,26
1657505083678,MATH 193A,A01,083224,Rotar; Vladimir,8,0,34,26
1657505083678,MATH 193A,A02,083225,Rotar; Vladimir,9,0,34,25
1657505083678,MATH 193A,A03,083781,Rotar; Vladimir,5,0,34,29
1657505083678,MATH 193A,A04,083782,Rotar; Vladimir,10,0,34,24
1657505083678,MATH 193A,A05,093482,Rotar; Vladimir,10,0,34,24
1657505089701,MATH 197,001,091859,McAuley; Julian John,9999,0,9999,0
1657505089701,MATH 197,002,095566,Kedlaya; Kiran S.,9997,0,9999,2
1657505089701,MATH 197,003,095567,Xiao; Ming,9999,0,9999,0
1657505089701,MATH 197,004,095571,Perols; Johan Lars,9998,0,9999,1
1657505096773,COGS 9,A01,083615,Shannon; Kyle Michael,9,0,75,66
1657505102796,COGS 11,A01,083617,Boyle; Mary E. T.,22,0,48,26
1657505108819,COGS 13,A01,083071,Bastos; Amalia Pinkusfeld,11,0,71,60
1657505114841,COGS 14A,A01,092681,Semenuks; Arturs,5,1,100,95
1657505120864,COGS 14B,A01,083073,Cheng; Tzu-Han,6,0,63,57
1657505126888,COGS 17,A01,092677,Semenuks; Arturs,6,0,81,75
1657505132915,COGS 100,A01,083619,Allen; Michael Gordon,17,0,70,53
1657505138938,COGS 101A,A01,083621,Davis; Joshua Daniel,9,0,68,59
1657505144963,COGS 101B,A01,091572,Allen; Michael Gordon,12,0,65,53
1657505150988,COGS 101C,A01,083625,Delgado; Tania,17,0,35,18
1657505157016,COGS 107A,A01,083627,Boyle; Mary E. T.,13,0,60,47
1657505163039,COGS 118A,A01,083075,Gupta; Anjum,21,0,76,55
1657505169068,CSE 3,A50,083646,Miranda; Gregory Joseph,24,0,50,26
1657505175089,CSE 8A,A50,083650,Miranda; Gregory Joseph,17,1,56,39
1657505181116,CSE 11,A01,083080,Cao; Yingjun,6,15,40,34
1657505187138,CSE 12,A01,083652,Krause-Levy; Sophia Louisa,28,1,120,92
1657505193166,CSE 15L,A01,083654,Morris; Justin Loren,9,0,50,41
1657505193166,CSE 15L,A02,083655,Morris; Justin Loren,9,0,50,41
1657505199194,CSE 20,A01,083657,Tran; Khoa Dang,39,0,80,41
1657505205230,CSE 21,A01,095574,Bach; Quang Tran,22,0,48,26
1657505211254,CSE 30,A01,083084,Eldon; John,5,0,80,75
1657505211254,CSE 30,B01,095061,Bhaskar; Nishant,9,0,50,41
1657505217280,CSE 100,A01,083659,Cao; Yingjun,5,4,70,65
1657505223319,CSE 134B,A01,083661,Powell; Thomas Allan,22,0,100,78
1657505229346,CSE 140,A01,083663,Gungor; Onat,15,0,85,70
1657505235368,CSE 140L,A01,083088,Eldon; John,21,0,100,79
1657505241391,CSE 175,A01,083665,Kumar; Rakesh,3,0,25,22
1657505247416,CSE 190,A00,092507,Dubnov; Shlomo,8,0,20,12
1657505253441,ECE 45,A01,083139,Congero; Spencer William,6,0,75,69
1657505259472,ECE 65,A50,083695,Saad; Andrew S,12,0,30,18
1657505259472,ECE 65,A51,095125,Saad; Andrew S,24,0,26,2
1657505265494,ECE 109,A01,091882,Touri; Behrouz,19,0,70,51
1657505271522,ECE 180,A00,083140,Abi Samra; Nicholas Camill,1,0,30,29
1657505271522,ECE 180,B00,083141,Abi Samra; Nicholas Camill,0,0,30,30
1657505277544,MATH 10A,A01,083735,Patchell; Gregory David,2,0,30,28
1657505277544,MATH 10A,A02,083736,Patchell; Gregory David,20,0,30,10
1657505277544,MATH 10A,A03,083737,Patchell; Gregory David,16,0,30,14
1657505283590,MATH 10B,A01,083207,Lim; Seonhee,8,0,34,26
1657505283590,MATH 10B,A02,083208,Lim; Seonhee,9,0,35,26
1657505283590,MATH 10B,A03,093472,Lim; Seonhee,7,0,34,27
1657505283590,MATH 10B,B01,083739,Sinha; Shubham,12,0,30,18
1657505289614,MATH 18,A01,083743,Cinel; Cameron Alexander,7,0,30,23
1657505289614,MATH 18,A02,083744,Cinel; Cameron Alexander,17,0,30,13
1657505289614,MATH 18,A03,083745,Cinel; Cameron Alexander,9,0,30,21
1657505289614,MATH 18,B01,083748,Rideout; David Porter,5,0,37,32
1657505289614,MATH 18,B02,083749,Rideout; David Porter,5,0,36,31
1657505289614,MATH 18,B03,083750,Rideout; David Porter,3,0,37,34
1657505289614,MATH 18,B04,083751,Rideout; David Porter,6,0,36,30
1657505289614,MATH 18,B05,093473,Rideout; David Porter,6,0,36,30
1657505289614,MATH 18,B06,093474,Rideout; David Porter,6,0,36,30
1657505295639,MATH 20A,A01,083754,Zheng; Zequn,14,0,40,26
1657505301663,MATH 20B,A01,083756,Briones; Jor-el Thomas Caparas,4,0,36,32
1657505301663,MATH 20B,A02,083757,Briones; Jor-el Thomas Caparas,1,0,36,35
1657505301663,MATH 20B,A03,093475,Briones; Jor-el Thomas Caparas,2,0,36,34
1657505307692,MATH 20C,A01,083760,Briones; Jor-el Thomas Caparas,1,0,35,34
1657505307692,MATH 20C,A02,083761,Briones; Jor-el Thomas Caparas,8,0,35,27
1657505307692,MATH 20C,A03,093476,Briones; Jor-el Thomas Caparas,0,1,36,36
1657505307692,MATH 20C,B01,083762,Bach; Quang Tran,1,0,30,29
1657505313721,MATH 20D,A01,083765,Tran; Brian Kha,5,0,30,25
1657505313721,MATH 20D,A02,083766,Tran; Brian Kha,5,0,30,25
1657505313721,MATH 20D,A03,083767,Tran; Brian Kha,5,0,30,25
1657505319749,MATH 20E,A01,083771,Ganguly; Soumya,9,0,32,23
1657505319749,MATH 20E,A02,083772,Ganguly; Soumya,6,0,32,26
1657505319749,MATH 20E,B01,083773,Ciotti; Benjamin,20,0,35,15
1657505319749,MATH 20E,B02,083774,Ciotti; Benjamin,17,0,35,18
1657505325778,MATH 103A,A01,083777,Greenfeld; Be'Eri,3,0,36,33
1657505325778,MATH 103A,A02,083778,Greenfeld; Be'Eri,5,0,36,31
1657505325778,MATH 103A,A03,093561,Greenfeld; Be'Eri,5,0,36,31
1657505325778,MATH 103A,B01,083779,Greenfeld; Be'Eri,7,0,36,29
1657505325778,MATH 103A,B02,083780,Greenfeld; Be'Eri,4,0,36,32
1657505325778,MATH 103A,B03,093562,Greenfeld; Be'Eri,3,0,36,33
1657505331805,MATH 105,A01,085443,Carter; Anne Toulson,15,0,35,20
1657505331805,MATH 105,A02,093477,Carter; Anne Toulson,20,0,35,15
1657505337829,MATH 109,A01,083213,Ganzberger; Geoffrey Michael,2,0,34,32
1657505337829,MATH 109,A02,083214,Ganzberger; Geoffrey Michael,4,0,34,30
1657505337829,MATH 109,A03,093478,Ganzberger; Geoffrey Michael,2,0,34,32
1657505337829,MATH 109,B01,083215,Ganzberger; Geoffrey Michael,1,0,32,31
1657505337829,MATH 109,B02,083216,Ganzberger; Geoffrey Michael,2,0,32,30
1657505337829,MATH 109,B03,093479,Ganzberger; Geoffrey Michael,8,0,32,24
1657505343853,MATH 142A,A01,083219,Chow; Bennett,7,0,32,25
1657505343853,MATH 142A,A02,083220,Chow; Bennett,10,0,32,22
1657505343853,MATH 142A,A03,093480,Chow; Bennett,8,0,32,24
1657505343853,MATH 142A,B03,093481,Chow; Bennett,8,0,32,24
1657505343853,MATH 142A,B04,093558,Chow; Bennett,13,0,32,19
1657505343853,MATH 142A,B05,093559,Chow; Bennett,6,0,32,26
1657505349881,MATH 193A,A01,083224,Rotar; Vladimir,8,0,34,26
1657505349881,MATH 193A,A02,083225,Rotar; Vladimir,9,0,34,25
1657505349881,MATH 193A,A03,083781,Rotar; Vladimir,5,0,34,29
1657505349881,MATH 193A,A04,083782,Rotar; Vladimir,10,0,34,24
1657505349881,MATH 193A,A05,093482,Rotar; Vladimir,10,0,34,24
1657505355921,MATH 197,001,091859,McAuley; Julian John,9999,0,9999,0
1657505355921,MATH 197,002,095566,Kedlaya; Kiran S.,9997,0,9999,2
1657505355921,MATH 197,003,095567,Xiao; Ming,9999,0,9999,0
1657505355921,MATH 197,004,095571,Perols; Johan Lars,9998,0,9999,1
1657505362987,COGS 9,A01,083615,Shannon; Kyle Michael,9,0,75,66
1657505369011,COGS 11,A01,083617,Boyle; Mary E. T.,22,0,48,26
1657505375037,COGS 13,A01,083071,Bastos; Amalia Pinkusfeld,11,0,71,60
1657505381060,COGS 14A,A01,092681,Semenuks; Arturs,5,1,100,95
1657505387092,COGS 14B,A01,083073,Cheng; Tzu-Han,6,0,63,57
1657505393117,COGS 17,A01,092677,Semenuks; Arturs,6,0,81,75
1657505399145,COGS 100,A01,083619,Allen; Michael Gordon,17,0,70,53
1657505405172,COGS 101A,A01,083621,Davis; Joshua Daniel,9,0,68,59
1657505411193,COGS 101B,A01,091572,Allen; Michael Gordon,12,0,65,53
1657505417221,COGS 101C,A01,083625,Delgado; Tania,17,0,35,18
1657505423244,COGS 107A,A01,083627,Boyle; Mary E. T.,13,0,60,47
1657505429274,COGS 118A,A01,083075,Gupta; Anjum,21,0,76,55
1657505435302,CSE 3,A50,083646,Miranda; Gregory Joseph,24,0,50,26
1657505441331,CSE 8A,A50,083650,Miranda; Gregory Joseph,17,1,56,39
1657505447356,CSE 11,A01,083080,Cao; Yingjun,6,15,40,34
1657505453380,CSE 12,A01,083652,Krause-Levy; Sophia Louisa,28,1,120,92
1657505459402,CSE 15L,A01,083654,Morris; Justin Loren,9,0,50,41
1657505459402,CSE 15L,A02,083655,Morris; Justin Loren,9,0,50,41
1657505465429,CSE 20,A01,083657,Tran; Khoa Dang,39,0,80,41
1657505471453,CSE 21,A01,095574,Bach; Quang Tran,22,0,48,26
1657505477479,CSE 30,A01,083084,Eldon; John,5,0,80,75
1657505477479,CSE 30,B01,095061,Bhaskar; Nishant,9,0,50,41
1657505483505,CSE 100,A01,083659,Cao; Yingjun,5,4,70,65
1657505489527,CSE 134B,A01,083661,Powell; Thomas Allan,22,0,100,78
1657505495556,CSE 140,A01,083663,Gungor; Onat,15,0,85,70
1657505501583,CSE 140L,A01,083088,Eldon; John,21,0,100,79
1657505507606,CSE 175,A01,083665,Kumar; Rakesh,3,0,25,22
1657505513630,CSE 190,A00,092507,Dubnov; Shlomo,8,0,20,12
1657505519652,ECE 45,A01,083139,Congero; Spencer William,6,0,75,69
1657505525678,ECE 65,A50,083695,Saad; Andrew S,12,0,30,18
1657505525678,ECE 65,A51,095125,Saad; Andrew S,24,0,26,2
1657505531700,ECE 109,A01,091882,Touri; Behrouz,19,0,70,51
1657505537725,ECE 180,A00,083140,Abi Samra; Nicholas Camill,1,0,30,29
1657505537725,ECE 180,B00,083141,Abi Samra; Nicholas Camill,0,0,30,30
1657505543840,MATH 10A,A01,083735,Patchell; Gregory David,2,0,30,28
1657505543840,MATH 10A,A02,083736,Patchell; Gregory David,20,0,30,10
1657505543840,MATH 10A,A03,083737,Patchell; Gregory David,16,0,30,14
1657505549869,MATH 10B,A01,083207,Lim; Seonhee,8,0,34,26
1657505549869,MATH 10B,A02,083208,Lim; Seonhee,9,0,35,26
1657505549869,MATH 10B,A03,093472,Lim; Seonhee,7,0,34,27
1657505549869,MATH 10B,B01,083739,Sinha; Shubham,12,0,30,18
1657505555894,MATH 18,A01,083743,Cinel; Cameron Alexander,7,0,30,23
1657505555894,MATH 18,A02,083744,Cinel; Cameron Alexander,17,0,30,13
1657505555894,MATH 18,A03,083745,Cinel; Cameron Alexander,9,0,30,21
1657505555894,MATH 18,B01,083748,Rideout; David Porter,5,0,37,32
1657505555894,MATH 18,B02,083749,Rideout; David Porter,5,0,36,31
1657505555894,MATH 18,B03,083750,Rideout; David Porter,3,0,37,34
1657505555894,MATH 18,B04,083751,Rideout; David Porter,6,0,36,30
1657505555894,MATH 18,B05,093473,Rideout; David Porter,6,0,36,30
1657505555894,MATH 18,B06,093474,Rideout; David Porter,6,0,36,30
1657505561915,MATH 20A,A01,083754,Zheng; Zequn,14,0,40,26
1657505567938,MATH 20B,A01,083756,Briones; Jor-el Thomas Caparas,4,0,36,32
1657505567938,MATH 20B,A02,083757,Briones; Jor-el Thomas Caparas,1,0,36,35
1657505567938,MATH 20B,A03,093475,Briones; Jor-el Thomas Caparas,2,0,36,34
1657505573968,MATH 20C,A01,083760,Briones; Jor-el Thomas Caparas,1,0,35,34
1657505573968,MATH 20C,A02,083761,Briones; Jor-el Thomas Caparas,8,0,35,27
1657505573968,MATH 20C,A03,093476,Briones; Jor-el Thomas Caparas,0,1,36,36
1657505573968,MATH 20C,B01,083762,Bach; Quang Tran,1,0,30,29
1657505579995,MATH 20D,A01,083765,Tran; Brian Kha,5,0,30,25
1657505579995,MATH 20D,A02,083766,Tran; Brian Kha,5,0,30,25
1657505579995,MATH 20D,A03,083767,Tran; Brian Kha,5,0,30,25
1657505586018,MATH 20E,A01,083771,Ganguly; Soumya,9,0,32,23
1657505586018,MATH 20E,A02,083772,Ganguly; Soumya,6,0,32,26
1657505586018,MATH 20E,B01,083773,Ciotti; Benjamin,20,0,35,15
1657505586018,MATH 20E,B02,083774,Ciotti; Benjamin,17,0,35,18
1657505592042,MATH 103A,A01,083777,Greenfeld; Be'Eri,3,0,36,33
1657505592042,MATH 103A,A02,083778,Greenfeld; Be'Eri,5,0,36,31
1657505592042,MATH 103A,A03,093561,Greenfeld; Be'Eri,5,0,36,31
1657505592042,MATH 103A,B01,083779,Greenfeld; Be'Eri,7,0,36,29
1657505592042,MATH 103A,B02,083780,Greenfeld; Be'Eri,4,0,36,32
1657505592042,MATH 103A,B03,093562,Greenfeld; Be'Eri,3,0,36,33
1657505598070,MATH 105,A01,085443,Carter; Anne Toulson,15,0,35,20
1657505598070,MATH 105,A02,093477,Carter; Anne Toulson,20,0,35,15
1657505604099,MATH 109,A01,083213,Ganzberger; Geoffrey Michael,2,0,34,32
1657505604099,MATH 109,A02,083214,Ganzberger; Geoffrey Michael,4,0,34,30
1657505604099,MATH 109,A03,093478,Ganzberger; Geoffrey Michael,2,0,34,32
1657505604099,MATH 109,B01,083215,Ganzberger; Geoffrey Michael,1,0,32,31
1657505604099,MATH 109,B02,083216,Ganzberger; Geoffrey Michael,2,0,32,30
1657505604099,MATH 109,B03,093479,Ganzberger; Geoffrey Michael,8,0,32,24
1657505610128,MATH 142A,A01,083219,Chow; Bennett,7,0,32,25
1657505610128,MATH 142A,A02,083220,Chow; Bennett,10,0,32,22
1657505610128,MATH 142A,A03,093480,Chow; Bennett,8,0,32,24
1657505610128,MATH 142A,B03,093481,Chow; Bennett,8,0,32,24
1657505610128,MATH 142A,B04,093558,Chow; Bennett,13,0,32,19
1657505610128,MATH 142A,B05,093559,Chow; Bennett,6,0,32,26
1657505616152,MATH 193A,A01,083224,Rotar; Vladimir,8,0,34,26
1657505616152,MATH 193A,A02,083225,Rotar; Vladimir,9,0,34,25
1657505616152,MATH 193A,A03,083781,Rotar; Vladimir,5,0,34,29
1657505616152,MATH 193A,A04,083782,Rotar; Vladimir,10,0,34,24
1657505616152,MATH 193A,A05,093482,Rotar; Vladimir,10,0,34,24
1657505622177,MATH 197,001,091859,McAuley; Julian John,9999,0,9999,0
1657505622177,MATH 197,002,095566,Kedlaya; Kiran S.,9997,0,9999,2
1657505622177,MATH 197,003,095567,Xiao; Ming,9999,0,9999,0
1657505622177,MATH 197,004,095571,Perols; Johan Lars,9998,0,9999,1
1657505629229,COGS 9,A01,083615,Shannon; Kyle Michael,9,0,75,66
1657505635252,COGS 11,A01,083617,Boyle; Mary E. T.,22,0,48,26
1657505641278,COGS 13,A01,083071,Bastos; Amalia Pinkusfeld,11,0,71,60
1657505647305,COGS 14A,A01,092681,Semenuks; Arturs,5,1,100,95
1657505653332,COGS 14B,A01,083073,Cheng; Tzu-Han,6,0,63,57
1657505659354,COGS 17,A01,092677,Semenuks; Arturs,6,0,81,75
1657505665380,COGS 100,A01,083619,Allen; Michael Gordon,17,0,70,53
1657505671405,COGS 101A,A01,083621,Davis; Joshua Daniel,9,0,68,59
1657505677428,COGS 101B,A01,091572,Allen; Michael Gordon,12,0,65,53
1657505683455,COGS 101C,A01,083625,Delgado; Tania,17,0,35,18
1657505689479,COGS 107A,A01,083627,Boyle; Mary E. T.,13,0,60,47
1657505695503,COGS 118A,A01,083075,Gupta; Anjum,21,0,76,55
1657505701532,CSE 3,A50,083646,Miranda; Gregory Joseph,24,0,50,26
1657505707554,CSE 8A,A50,083650,Miranda; Gregory Joseph,17,1,56,39
1657505713575,CSE 11,A01,083080,Cao; Yingjun,6,15,40,34
1657505719599,CSE 12,A01,083652,Krause-Levy; Sophia Louisa,28,1,120,92
1657505725619,CSE 15L,A01,083654,Morris; Justin Loren,9,0,50,41
1657505725619,CSE 15L,A02,083655,Morris; Justin Loren,9,0,50,41
1657505731646,CSE 20,A01,083657,Tran; Khoa Dang,39,0,80,41
1657505737669,CSE 21,A01,095574,Bach; Quang Tran,22,0,48,26
1657505743690,CSE 30,A01,083084,Eldon; John,5,0,80,75
1657505743690,CSE 30,B01,095061,Bhaskar; Nishant,9,0,50,41
1657505749712,CSE 100,A01,083659,Cao; Yingjun,5,4,70,65
1657505755738,CSE 134B,A01,083661,Powell; Thomas Allan,22,0,100,78
1657505761763,CSE 140,A01,083663,Gungor; Onat,15,0,85,70
1657505767786,CSE 140L,A01,083088,Eldon; John,21,0,100,79
1657505773813,CSE 175,A01,083665,Kumar; Rakesh,3,0,25,22
1657505779836,CSE 190,A00,092507,Dubnov; Shlomo,8,0,20,12
1657505785863,ECE 45,A01,083139,Congero; Spencer William,6,0,75,69
1657505791886,ECE 65,A50,083695,Saad; Andrew S,12,0,30,18
1657505791886,ECE 65,A51,095125,Saad; Andrew S,24,0,26,2
1657505797913,ECE 109,A01,091882,Touri; Behrouz,19,0,70,51
1657505803937,ECE 180,A00,083140,Abi Samra; Nicholas Camill,1,0,30,29
1657505803937,ECE 180,B00,083141,Abi Samra; Nicholas Camill,0,0,30,30
1657505809960,MATH 10A,A01,083735,Patchell; Gregory David,2,0,30,28
1657505809960,MATH 10A,A02,083736,Patchell; Gregory David,20,0,30,10
1657505809960,MATH 10A,A03,083737,Patchell; Gregory David,16,0,30,14
1657505815985,MATH 10B,A01,083207,Lim; Seonhee,8,0,34,26
1657505815985,MATH 10B,A02,083208,Lim; Seonhee,9,0,35,26
1657505815985,MATH 10B,A03,093472,Lim; Seonhee,7,0,34,27
1657505815985,MATH 10B,B01,083739,Sinha; Shubham,12,0,30,18
1657505822015,MATH 18,A01,083743,Cinel; Cameron Alexander,7,0,30,23
1657505822015,MATH 18,A02,083744,Cinel; Cameron Alexander,17,0,30,13
1657505822015,MATH 18,A03,083745,Cinel; Cameron Alexander,9,0,30,21
1657505822015,MATH 18,B01,083748,Rideout; David Porter,5,0,37,32
1657505822015,MATH 18,B02,083749,Rideout; David Porter,5,0,36,31
1657505822015,MATH 18,B03,083750,Rideout; David Porter,3,0,37,34
1657505822015,MATH 18,B04,083751,Rideout; David Porter,6,0,36,30
1657505822015,MATH 18,B05,093473,Rideout; David Porter,6,0,36,30
1657505822015,MATH 18,B06,093474,Rideout; David Porter,6,0,36,30
1657505828040,MATH 20A,A01,083754,Zheng; Zequn,14,0,40,26
1657505834065,MATH 20B,A01,083756,Briones; Jor-el Thomas Caparas,4,0,36,32
1657505834065,MATH 20B,A02,083757,Briones; Jor-el Thomas Caparas,1,0,36,35
1657505834065,MATH 20B,A03,093475,Briones; Jor-el Thomas Caparas,2,0,36,34
1657505840095,MATH 20C,A01,083760,Briones; Jor-el Thomas Caparas,1,0,35,34
1657505840095,MATH 20C,A02,083761,Briones; Jor-el Thomas Caparas,8,0,35,27
1657505840095,MATH 20C,A03,093476,Briones; Jor-el Thomas Caparas,0,1,36,36
1657505840095,MATH 20C,B01,083762,Bach; Quang Tran,1,0,30,29
1657505846118,MATH 20D,A01,083765,Tran; Brian Kha,5,0,30,25
1657505846118,MATH 20D,A02,083766,Tran; Brian Kha,5,0,30,25
1657505846118,MATH 20D,A03,083767,Tran; Brian Kha,5,0,30,25
1657505852146,MATH 20E,A01,083771,Ganguly; Soumya,9,0,32,23
1657505852146,MATH 20E,A02,083772,Ganguly; Soumya,6,0,32,26
1657505852146,MATH 20E,B01,083773,Ciotti; Benjamin,20,0,35,15
1657505852146,MATH 20E,B02,083774,Ciotti; Benjamin,17,0,35,18
1657505858172,MATH 103A,A01,083777,Greenfeld; Be'Eri,3,0,36,33
1657505858172,MATH 103A,A02,083778,Greenfeld; Be'Eri,5,0,36,31
1657505858172,MATH 103A,A03,093561,Greenfeld; Be'Eri,5,0,36,31
1657505858172,MATH 103A,B01,083779,Greenfeld; Be'Eri,7,0,36,29
1657505858172,MATH 103A,B02,083780,Greenfeld; Be'Eri,4,0,36,32
1657505858172,MATH 103A,B03,093562,Greenfeld; Be'Eri,3,0,36,33
1657505864195,MATH 105,A01,085443,Carter; Anne Toulson,15,0,35,20
1657505864195,MATH 105,A02,093477,Carter; Anne Toulson,20,0,35,15
1657505870224,MATH 109,A01,083213,Ganzberger; Geoffrey Michael,2,0,34,32
1657505870224,MATH 109,A02,083214,Ganzberger; Geoffrey Michael,4,0,34,30
1657505870224,MATH 109,A03,093478,Ganzberger; Geoffrey Michael,2,0,34,32
1657505870224,MATH 109,B01,083215,Ganzberger; Geoffrey Michael,1,0,32,31
1657505870224,MATH 109,B02,083216,Ganzberger; Geoffrey Michael,2,0,32,30
1657505870224,MATH 109,B03,093479,Ganzberger; Geoffrey Michael,8,0,32,24
1657505876252,MATH 142A,A01,083219,Chow; Bennett,7,0,32,25
1657505876252,MATH 142A,A02,083220,Chow; Bennett,10,0,32,22
1657505876252,MATH 142A,A03,093480,Chow; Bennett,8,0,32,24
1657505876252,MATH 142A,B03,093481,Chow; Bennett,8,0,32,24
1657505876252,MATH 142A,B04,093558,Chow; Bennett,13,0,32,19
1657505876252,MATH 142A,B05,093559,Chow; Bennett,6,0,32,26
1657505882279,MATH 193A,A01,083224,Rotar; Vladimir,8,0,34,26
1657505882279,MATH 193A,A02,083225,Rotar; Vladimir,9,0,34,25
1657505882279,MATH 193A,A03,083781,Rotar; Vladimir,5,0,34,29
1657505882279,MATH 193A,A04,083782,Rotar; Vladimir,10,0,34,24
1657505882279,MATH 193A,A05,093482,Rotar; Vladimir,10,0,34,24
1657505888305,MATH 197,001,091859,McAuley; Julian John,9999,0,9999,0
1657505888305,MATH 197,002,095566,Kedlaya; Kiran S.,9997,0,9999,2
1657505888305,MATH 197,003,095567,Xiao; Ming,9999,0,9999,0
1657505888305,MATH 197,004,095571,Perols; Johan Lars,9998,0,9999,1
1657505895381,COGS 9,A01,083615,Shannon; Kyle Michael,9,0,75,66
1657505901403,COGS 11,A01,083617,Boyle; Mary E. T.,22,0,48,26
1657505907429,COGS 13,A01,083071,Bastos; Amalia Pinkusfeld,11,0,71,60
1657505913451,COGS 14A,A01,092681,Semenuks; Arturs,5,1,100,95
1657505919475,COGS 14B,A01,083073,Cheng; Tzu-Han,6,0,63,57
1657505925497,COGS 17,A01,092677,Semenuks; Arturs,6,0,81,75
1657505931525,COGS 100,A01,083619,Allen; Michael Gordon,17,0,70,53
1657505937551,COGS 101A,A01,083621,Davis; Joshua Daniel,9,0,68,59
1657505943575,COGS 101B,A01,091572,Allen; Michael Gordon,12,0,65,53
1657505949605,COGS 101C,A01,083625,Delgado; Tania,17,0,35,18
1657505955627,COGS 107A,A01,083627,Boyle; Mary E. T.,13,0,60,47
1657505961654,COGS 118A,A01,083075,Gupta; Anjum,21,0,76,55
1657505967677,CSE 3,A50,083646,Miranda; Gregory Joseph,24,0,50,26
1657505973699,CSE 8A,A50,083650,Miranda; Gregory Joseph,17,1,56,39
1657505979725,CSE 11,A01,083080,Cao; Yingjun,6,15,40,34
1657505985754,CSE 12,A01,083652,Krause-Levy; Sophia Louisa,28,1,120,92
1657505991775,CSE 15L,A01,083654,Morris; Justin Loren,9,0,50,41
1657505991775,CSE 15L,A02,083655,Morris; Justin Loren,9,0,50,41
1657505997801,CSE 20,A01,083657,Tran; Khoa Dang,39,0,80,41
1657506003825,CSE 21,A01,095574,Bach; Quang Tran,22,0,48,26
1657506009851,CSE 30,A01,083084,Eldon; John,5,0,80,75
1657506009851,CSE 30,B01,095061,Bhaskar; Nishant,9,0,50,41
1657506015875,CSE 100,A01,083659,Cao; Yingjun,5,4,70,65
1657506021901,CSE 134B,A01,083661,Powell; Thomas Allan,22,0,100,78
1657506027923,CSE 140,A01,083663,Gungor; Onat,15,0,85,70
1657506033947,CSE 140L,A01,083088,Eldon; John,21,0,100,79
1657506039972,CSE 175,A01,083665,Kumar; Rakesh,3,0,25,22
1657506045995,CSE 190,A00,092507,Dubnov; Shlomo,8,0,20,12
1657506052047,ECE 45,A01,083139,Congero; Spencer William,6,0,75,69
1657506058073,ECE 65,A50,083695,Saad; Andrew S,12,0,30,18
1657506058073,ECE 65,A51,095125,Saad; Andrew S,24,0,26,2
1657506064097,ECE 109,A01,091882,Touri; Behrouz,19,0,70,51
1657506070123,ECE 180,A00,083140,Abi Samra; Nicholas Camill,1,0,30,29
1657506070123,ECE 180,B00,083141,Abi Samra; Nicholas Camill,0,0,30,30
1657506076154,MATH 10A,A01,083735,Patchell; Gregory David,2,0,30,28
1657506076154,MATH 10A,A02,083736,Patchell; Gregory David,20,0,30,10
1657506076154,MATH 10A,A03,083737,Patchell; Gregory David,16,0,30,14
1657506082177,MATH 10B,A01,083207,Lim; Seonhee,8,0,34,26
1657506082177,MATH 10B,A02,083208,Lim; Seonhee,9,0,35,26
1657506082177,MATH 10B,A03,093472,Lim; Seonhee,7,0,34,27
1657506082177,MATH 10B,B01,083739,Sinha; Shubham,12,0,30,18
1657506088202,MATH 18,A01,083743,Cinel; Cameron Alexander,7,0,30,23
1657506088202,MATH 18,A02,083744,Cinel; Cameron Alexander,17,0,30,13
1657506088202,MATH 18,A03,083745,Cinel; Cameron Alexander,9,0,30,21
1657506088202,MATH 18,B01,083748,Rideout; David Porter,5,0,37,32
1657506088202,MATH 18,B02,083749,Rideout; David Porter,5,0,36,31
1657506088202,MATH 18,B03,083750,Rideout; David Porter,3,0,37,34
1657506088202,MATH 18,B04,083751,Rideout; David Porter,6,0,36,30
1657506088202,MATH 18,B05,093473,Rideout; David Porter,6,0,36,30
1657506088202,MATH 18,B06,093474,Rideout; David Porter,6,0,36,30
1657506094226,MATH 20A,A01,083754,Zheng; Zequn,14,0,40,26
1657506100252,MATH 20B,A01,083756,Briones; Jor-el Thomas Caparas,4,0,36,32
1657506100252,MATH 20B,A02,083757,Briones; Jor-el Thomas Caparas,1,0,36,35
1657506100252,MATH 20B,A03,093475,Briones; Jor-el Thomas Caparas,2,0,36,34
1657506106281,MATH 20C,A01,083760,Briones; Jor-el Thomas Caparas,1,0,35,34
1657506106281,MATH 20C,A02,083761,Briones; Jor-el Thomas Caparas,8,0,35,27
1657506106281,MATH 20C,A03,093476,Briones; Jor-el Thomas Caparas,0,1,36,36
1657506106281,MATH 20C,B01,083762,Bach; Quang Tran,1,0,30,29
1657506112305,MATH 20D,A01,083765,Tran; Brian Kha,5,0,30,25
1657506112305,MATH 20D,A02,083766,Tran; Brian Kha,5,0,30,25
1657506112305,MATH 20D,A03,083767,Tran; Brian Kha,5,0,30,25
1657506118328,MATH 20E,A01,083771,Ganguly; Soumya,9,0,32,23
1657506118328,MATH 20E,A02,083772,Ganguly; Soumya,6,0,32,26
1657506118328,MATH 20E,B01,083773,Ciotti; Benjamin,20,0,35,15
1657506118328,MATH 20E,B02,083774,Ciotti; Benjamin,17,0,35,18
1657506124357,MATH 103A,A01,083777,Greenfeld; Be'Eri,3,0,36,33
1657506124357,MATH 103A,A02,083778,Greenfeld; Be'Eri,5,0,36,31
1657506124357,MATH 103A,A03,093561,Greenfeld; Be'Eri,5,0,36,31
1657506124357,MATH 103A,B01,083779,Greenfeld; Be'Eri,7,0,36,29
1657506124357,MATH 103A,B02,083780,Greenfeld; Be'Eri,4,0,36,32
1657506124357,MATH 103A,B03,093562,Greenfeld; Be'Eri,3,0,36,33
1657506130384,MATH 105,A01,085443,Carter; Anne Toulson,15,0,35,20
1657506130384,MATH 105,A02,093477,Carter; Anne Toulson,20,0,35,15
1657506136414,MATH 109,A01,083213,Ganzberger; Geoffrey Michael,2,0,34,32
1657506136414,MATH 109,A02,083214,Ganzberger; Geoffrey Michael,4,0,34,30
1657506136414,MATH 109,A03,093478,Ganzberger; Geoffrey Michael,2,0,34,32
1657506136414,MATH 109,B01,083215,Ganzberger; Geoffrey Michael,1,0,32,31
1657506136414,MATH 109,B02,083216,Ganzberger; Geoffrey Michael,2,0,32,30
1657506136414,MATH 109,B03,093479,Ganzberger; Geoffrey Michael,8,0,32,24
1657506142514,MATH 142A,A01,083219,Chow; Bennett,7,0,32,25
1657506142514,MATH 142A,A02,083220,Chow; Bennett,10,0,32,22
1657506142514,MATH 142A,A03,093480,Chow; Bennett,8,0,32,24
1657506142514,MATH 142A,B03,093481,Chow; Bennett,8,0,32,24
1657506142514,MATH 142A,B04,093558,Chow; Bennett,13,0,32,19
1657506142514,MATH 142A,B05,093559,Chow; Bennett,6,0,32,26
1657506148538,MATH 193A,A01,083224,Rotar; Vladimir,8,0,34,26
1657506148538,MATH 193A,A02,083225,Rotar; Vladimir,9,0,34,25
1657506148538,MATH 193A,A03,083781,Rotar; Vladimir,5,0,34,29
1657506148538,MATH 193A,A04,083782,Rotar; Vladimir,10,0,34,24
1657506148538,MATH 193A,A05,093482,Rotar; Vladimir,10,0,34,24
1657506154562,MATH 197,001,091859,McAuley; Julian John,9999,0,9999,0
1657506154562,MATH 197,002,095566,Kedlaya; Kiran S.,9997,0,9999,2
1657506154562,MATH 197,003,095567,Xiao; Ming,9999,0,9999,0
1657506154562,MATH 197,004,095571,Perols; Johan Lars,9998,0,9999,1
1657506161638,COGS 9,A01,083615,Shannon; Kyle Michael,9,0,75,66
1657506167665,COGS 11,A01,083617,Boyle; Mary E. T.,22,0,48,26
1657506173687,COGS 13,A01,083071,Bastos; Amalia Pinkusfeld,11,0,71,60
1657506179710,COGS 14A,A01,092681,Semenuks; Arturs,5,1,100,95
1657506185732,COGS 14B,A01,083073,Cheng; Tzu-Han,6,0,63,57
1657506191755,COGS 17,A01,092677,Semenuks; Arturs,6,0,81,75
1657506197787,COGS 100,A01,083619,Allen; Michael Gordon,17,0,70,53
1657506203815,COGS 101A,A01,083621,Davis; Joshua Daniel,9,0,68,59
1657506209840,COGS 101B,A01,091572,Allen; Michael Gordon,12,0,65,53
1657506215863,COGS 101C,A01,083625,Delgado; Tania,17,0,35,18
1657506221885,COGS 107A,A01,083627,Boyle; Mary E. T.,13,0,60,47
1657506227910,COGS 118A,A01,083075,Gupta; Anjum,21,0,76,55
1657506233937,CSE 3,A50,083646,Miranda; Gregory Joseph,24,0,50,26
1657506239959,CSE 8A,A50,083650,Miranda; Gregory Joseph,17,1,56,39
1657506245981,CSE 11,A01,083080,Cao; Yingjun,6,15,40,34
1657506252007,CSE 12,A01,083652,Krause-Levy; Sophia Louisa,28,1,120,92
1657506258032,CSE 15L,A01,083654,Morris; Justin Loren,9,0,50,41
1657506258032,CSE 15L,A02,083655,Morris; Justin Loren,9,0,50,41
1657506264058,CSE 20,A01,083657,Tran; Khoa Dang,39,0,80,41
1657506270086,CSE 21,A01,095574,Bach; Quang Tran,22,0,48,26
1657506276110,CSE 30,A01,083084,Eldon; John,5,0,80,75
1657506276110,CSE 30,B01,095061,Bhaskar; Nishant,9,0,50,41
1657506282132,CSE 100,A01,083659,Cao; Yingjun,5,4,70,65
1657506288155,CSE 134B,A01,083661,Powell; Thomas Allan,22,0,100,78
1657506294182,CSE 140,A01,083663,Gungor; Onat,15,0,85,70
1657506300214,CSE 140L,A01,083088,Eldon; John,21,0,100,79
1657506306240,CSE 175,A01,083665,Kumar; Rakesh,3,0,25,22
1657506312262,CSE 190,A00,092507,Dubnov; Shlomo,8,0,20,12
1657506318290,ECE 45,A01,083139,Congero; Spencer William,6,0,75,69
1657506324318,ECE 65,A50,083695,Saad; Andrew S,12,0,30,18
1657506324318,ECE 65,A51,095125,Saad; Andrew S,24,0,26,2
1657506330341,ECE 109,A01,091882,Touri; Behrouz,19,0,70,51
1657506336364,ECE 180,A00,083140,Abi Samra; Nicholas Camill,1,0,30,29
1657506336364,ECE 180,B00,083141,Abi Samra; Nicholas Camill,0,0,30,30
1657506342387,MATH 10A,A01,083735,Patchell; Gregory David,2,0,30,28
1657506342387,MATH 10A,A02,083736,Patchell; Gregory David,20,0,30,10
1657506342387,MATH 10A,A03,083737,Patchell; Gregory David,16,0,30,14
1657506348410,MATH 10B,A01,083207,Lim; Seonhee,8,0,34,26
1657506348410,MATH 10B,A02,083208,Lim; Seonhee,9,0,35,26
1657506348410,MATH 10B,A03,093472,Lim; Seonhee,7,0,34,27
1657506348410,MATH 10B,B01,083739,Sinha; Shubham,12,0,30,18
1657506354435,MATH 18,A01,083743,Cinel; Cameron Alexander,7,0,30,23
1657506354435,MATH 18,A02,083744,Cinel; Cameron Alexander,17,0,30,13
1657506354435,MATH 18,A03,083745,Cinel; Cameron Alexander,9,0,30,21
1657506354435,MATH 18,B01,083748,Rideout; David Porter,5,0,37,32
1657506354435,MATH 18,B02,083749,Rideout; David Porter,5,0,36,31
1657506354435,MATH 18,B03,083750,Rideout; David Porter,3,0,37,34
1657506354435,MATH 18,B04,083751,Rideout; David Porter,6,0,36,30
1657506354435,MATH 18,B05,093473,Rideout; David Porter,6,0,36,30
1657506354435,MATH 18,B06,093474,Rideout; David Porter,6,0,36,30
1657506360465,MATH 20A,A01,083754,Zheng; Zequn,14,0,40,26
1657506366487,MATH 20B,A01,083756,Briones; Jor-el Thomas Caparas,4,0,36,32
1657506366487,MATH 20B,A02,083757,Briones; Jor-el Thomas Caparas,1,0,36,35
1657506366487,MATH 20B,A03,093475,Briones; Jor-el Thomas Caparas,2,0,36,34
1657506372515,MATH 20C,A01,083760,Briones; Jor-el Thomas Caparas,1,0,35,34
1657506372515,MATH 20C,A02,083761,Briones; Jor-el Thomas Caparas,8,0,35,27
1657506372515,MATH 20C,A03,093476,Briones; Jor-el Thomas Caparas,0,1,36,36
1657506372515,MATH 20C,B01,083762,Bach; Quang Tran,1,0,30,29
1657506378543,MATH 20D,A01,083765,Tran; Brian Kha,5,0,30,25
1657506378543,MATH 20D,A02,083766,Tran; Brian Kha,5,0,30,25
1657506378543,MATH 20D,A03,083767,Tran; Brian Kha,5,0,30,25
1657506384578,MATH 20E,A01,083771,Ganguly; Soumya,9,0,32,23
1657506384578,MATH 20E,A02,083772,Ganguly; Soumya,6,0,32,26
1657506384578,MATH 20E,B01,083773,Ciotti; Benjamin,20,0,35,15
1657506384578,MATH 20E,B02,083774,Ciotti; Benjamin,17,0,35,18
1657506390603,MATH 103A,A01,083777,Greenfeld; Be'Eri,3,0,36,33
1657506390603,MATH 103A,A02,083778,Greenfeld; Be'Eri,5,0,36,31
1657506390603,MATH 103A,A03,093561,Greenfeld; Be'Eri,5,0,36,31
1657506390603,MATH 103A,B01,083779,Greenfeld; Be'Eri,7,0,36,29
1657506390603,MATH 103A,B02,083780,Greenfeld; Be'Eri,4,0,36,32
1657506390603,MATH 103A,B03,093562,Greenfeld; Be'Eri,3,0,36,33
1657506396632,MATH 105,A01,085443,Carter; Anne Toulson,15,0,35,20
1657506396632,MATH 105,A02,093477,Carter; Anne Toulson,20,0,35,15
1657506402656,MATH 109,A01,083213,Ganzberger; Geoffrey Michael,2,0,34,32
1657506402656,MATH 109,A02,083214,Ganzberger; Geoffrey Michael,4,0,34,30
1657506402656,MATH 109,A03,093478,Ganzberger; Geoffrey Michael,2,0,34,32
1657506402656,MATH 109,B01,083215,Ganzberger; Geoffrey Michael,1,0,32,31
1657506402656,MATH 109,B02,083216,Ganzberger; Geoffrey Michael,2,0,32,30
1657506402656,MATH 109,B03,093479,Ganzberger; Geoffrey Michael,8,0,32,24
1657506408680,MATH 142A,A01,083219,Chow; Bennett,7,0,32,25
1657506408680,MATH 142A,A02,083220,Chow; Bennett,10,0,32,22
1657506408680,MATH 142A,A03,093480,Chow; Bennett,8,0,32,24
1657506408680,MATH 142A,B03,093481,Chow; Bennett,8,0,32,24
1657506408680,MATH 142A,B04,093558,Chow; Bennett,13,0,32,19
1657506408680,MATH 142A,B05,093559,Chow; Bennett,6,0,32,26
1657506414703,MATH 193A,A01,083224,Rotar; Vladimir,8,0,34,26
1657506414703,MATH 193A,A02,083225,Rotar; Vladimir,9,0,34,25
1657506414703,MATH 193A,A03,083781,Rotar; Vladimir,5,0,34,29
1657506414703,MATH 193A,A04,083782,Rotar; Vladimir,10,0,34,24
1657506414703,MATH 193A,A05,093482,Rotar; Vladimir,10,0,34,24
1657506420728,MATH 197,001,091859,McAuley; Julian John,9999,0,9999,0
1657506420728,MATH 197,002,095566,Kedlaya; Kiran S.,9997,0,9999,2
1657506420728,MATH 197,003,095567,Xiao; Ming,9999,0,9999,0
1657506420728,MATH 197,004,095571,Perols; Johan Lars,9998,0,9999,1
1657506427788,COGS 9,A01,083615,Shannon; Kyle Michael,9,0,75,66
1657506433820,COGS 11,A01,083617,Boyle; Mary E. T.,22,0,48,26
1657506439848,COGS 13,A01,083071,Bastos; Amalia Pinkusfeld,11,0,71,60
1657506445869,COGS 14A,A01,092681,Semenuks; Arturs,5,1,100,95
1657506451891,COGS 14B,A01,083073,Cheng; Tzu-Han,6,0,63,57
1657506457914,COGS 17,A01,092677,Semenuks; Arturs,6,0,81,75
1657506463947,COGS 100,A01,083619,Allen; Michael Gordon,17,0,70,53
1657506469973,COGS 101A,A01,083621,Davis; Joshua Daniel,9,0,68,59
1657506476000,COGS 101B,A01,091572,Allen; Michael Gordon,12,0,65,53
1657506482024,COGS 101C,A01,083625,Delgado; Tania,17,0,35,18
1657506488046,COGS 107A,A01,083627,Boyle; Mary E. T.,13,0,60,47
1657506494073,COGS 118A,A01,083075,Gupta; Anjum,21,0,76,55
1657506500100,CSE 3,A50,083646,Miranda; Gregory Joseph,24,0,50,26
1657506506127,CSE 8A,A50,083650,Miranda; Gregory Joseph,17,1,56,39
1657506512151,CSE 11,A01,083080,Cao; Yingjun,6,15,40,34
1657506518175,CSE 12,A01,083652,Krause-Levy; Sophia Louisa,28,1,120,92
1657506524206,CSE 15L,A01,083654,Morris; Justin Loren,9,0,50,41
1657506524206,CSE 15L,A02,083655,Morris; Justin Loren,9,0,50,41
1657506530229,CSE 20,A01,083657,Tran; Khoa Dang,39,0,80,41
1657506536251,CSE 21,A01,095574,Bach; Quang Tran,22,0,48,26
1657506542282,CSE 30,A01,083084,Eldon; John,5,0,80,75
1657506542282,CSE 30,B01,095061,Bhaskar; Nishant,9,0,50,41
1657506548311,CSE 100,A01,083659,Cao; Yingjun,5,4,70,65
1657506554337,CSE 134B,A01,083661,Powell; Thomas Allan,22,0,100,78
1657506560369,CSE 140,A01,083663,Gungor; Onat,15,0,85,70
1657506566391,CSE 140L,A01,083088,Eldon; John,21,0,100,79
1657506572415,CSE 175,A01,083665,Kumar; Rakesh,3,0,25,22
1657506578441,CSE 190,A00,092507,Dubnov; Shlomo,8,0,20,12
1657506584467,ECE 45,A01,083139,Congero; Spencer William,6,0,75,69
1657506590490,ECE 65,A50,083695,Saad; Andrew S,12,0,30,18
1657506590490,ECE 65,A51,095125,Saad; Andrew S,24,0,26,2
1657506596514,ECE 109,A01,091882,Touri; Behrouz,19,0,70,51
1657506602539,ECE 180,A00,083140,Abi Samra; Nicholas Camill,1,0,30,29
1657506602539,ECE 180,B00,083141,Abi Samra; Nicholas Camill,0,0,30,30
1657506608561,MATH 10A,A01,083735,Patchell; Gregory David,2,0,30,28
1657506608561,MATH 10A,A02,083736,Patchell; Gregory David,20,0,30,10
1657506608561,MATH 10A,A03,083737,Patchell; Gregory David,16,0,30,14
1657506614584,MATH 10B,A01,083207,Lim; Seonhee,8,0,34,26
1657506614584,MATH 10B,A02,083208,Lim; Seonhee,9,0,35,26
1657506614584,MATH 10B,A03,093472,Lim; Seonhee,7,0,34,27
1657506614584,MATH 10B,B01,083739,Sinha; Shubham,12,0,30,18
1657506620609,MATH 18,A01,083743,Cinel; Cameron Alexander,7,0,30,23
1657506620609,MATH 18,A02,083744,Cinel; Cameron Alexander,17,0,30,13
1657506620609,MATH 18,A03,083745,Cinel; Cameron Alexander,9,0,30,21
1657506620609,MATH 18,B01,083748,Rideout; David Porter,5,0,37,32
1657506620609,MATH 18,B02,083749,Rideout; David Porter,5,0,36,31
1657506620609,MATH 18,B03,083750,Rideout; David Porter,3,0,37,34
1657506620609,MATH 18,B04,083751,Rideout; David Porter,6,0,36,30
1657506620609,MATH 18,B05,093473,Rideout; David Porter,6,0,36,30
1657506620609,MATH 18,B06,093474,Rideout; David Porter,6,0,36,30
1657506626633,MATH 20A,A01,083754,Zheng; Zequn,14,0,40,26
1657506632654,MATH 20B,A01,083756,Briones; Jor-el Thomas Caparas,4,0,36,32
1657506632654,MATH 20B,A02,083757,Briones; Jor-el Thomas Caparas,1,0,36,35
1657506632654,MATH 20B,A03,093475,Briones; Jor-el Thomas Caparas,2,0,36,34
1657506638684,MATH 20C,A01,083760,Briones; Jor-el Thomas Caparas,1,0,35,34
1657506638684,MATH 20C,A02,083761,Briones; Jor-el Thomas Caparas,8,0,35,27
1657506638684,MATH 20C,A03,093476,Briones; Jor-el Thomas Caparas,0,1,36,36
1657506638684,MATH 20C,B01,083762,Bach; Quang Tran,1,0,30,29
1657506644707,MATH 20D,A01,083765,Tran; Brian Kha,5,0,30,25
1657506644707,MATH 20D,A02,083766,Tran; Brian Kha,5,0,30,25
1657506644707,MATH 20D,A03,083767,Tran; Brian Kha,5,0,30,25
1657506650736,MATH 20E,A01,083771,Ganguly; Soumya,9,0,32,23
1657506650736,MATH 20E,A02,083772,Ganguly; Soumya,6,0,32,26
1657506650736,MATH 20E,B01,083773,Ciotti; Benjamin,20,0,35,15
1657506650736,MATH 20E,B02,083774,Ciotti; Benjamin,17,0,35,18
1657506656766,MATH 103A,A01,083777,Greenfeld; Be'Eri,3,0,36,33
1657506656766,MATH 103A,A02,083778,Greenfeld; Be'Eri,5,0,36,31
1657506656766,MATH 103A,A03,093561,Greenfeld; Be'Eri,5,0,36,31
1657506656766,MATH 103A,B01,083779,Greenfeld; Be'Eri,7,0,36,29
1657506656766,MATH 103A,B02,083780,Greenfeld; Be'Eri,4,0,36,32
1657506656766,MATH 103A,B03,093562,Greenfeld; Be'Eri,3,0,36,33
1657506662795,MATH 105,A01,085443,Carter; Anne Toulson,15,0,35,20
1657506662795,MATH 105,A02,093477,Carter; Anne Toulson,20,0,35,15
1657506668822,MATH 109,A01,083213,Ganzberger; Geoffrey Michael,2,0,34,32
1657506668822,MATH 109,A02,083214,Ganzberger; Geoffrey Michael,4,0,34,30
1657506668822,MATH 109,A03,093478,Ganzberger; Geoffrey Michael,2,0,34,32
1657506668822,MATH 109,B01,083215,Ganzberger; Geoffrey Michael,1,0,32,31
1657506668822,MATH 109,B02,083216,Ganzberger; Geoffrey Michael,2,0,32,30
1657506668822,MATH 109,B03,093479,Ganzberger; Geoffrey Michael,8,0,32,24
1657506674856,MATH 142A,A01,083219,Chow; Bennett,7,0,32,25
1657506674856,MATH 142A,A02,083220,Chow; Bennett,10,0,32,22
1657506674856,MATH 142A,A03,093480,Chow; Bennett,8,0,32,24
1657506674856,MATH 142A,B03,093481,Chow; Bennett,8,0,32,24
1657506674856,MATH 142A,B04,093558,Chow; Bennett,13,0,32,19
1657506674856,MATH 142A,B05,093559,Chow; Bennett,6,0,32,26
1657506680884,MATH 193A,A01,083224,Rotar; Vladimir,8,0,34,26
1657506680884,MATH 193A,A02,083225,Rotar; Vladimir,9,0,34,25
1657506680884,MATH 193A,A03,083781,Rotar; Vladimir,5,0,34,29
1657506680884,MATH 193A,A04,083782,Rotar; Vladimir,10,0,34,24
1657506680884,MATH 193A,A05,093482,Rotar; Vladimir,10,0,34,24
1657506687015,MATH 197,001,091859,McAuley; Julian John,9999,0,9999,0
1657506687015,MATH 197,002,095566,Kedlaya; Kiran S.,9997,0,9999,2
1657506687015,MATH 197,003,095567,Xiao; Ming,9999,0,9999,0
1657506687015,MATH 197,004,095571,Perols; Johan Lars,9998,0,9999,1
1657506694083,COGS 9,A01,083615,Shannon; Kyle Michael,9,0,75,66
1657506700111,COGS 11,A01,083617,Boyle; Mary E. T.,22,0,48,26
1657506706134,COGS 13,A01,083071,Bastos; Amalia Pinkusfeld,11,0,71,60
1657506712157,COGS 14A,A01,092681,Semenuks; Arturs,5,1,100,95
1657506718180,COGS 14B,A01,083073,Cheng; Tzu-Han,6,0,63,57
1657506724202,COGS 17,A01,092677,Semenuks; Arturs,6,0,81,75
1657506730239,COGS 100,A01,083619,Allen; Michael Gordon,17,0,70,53
1657506736337,COGS 101A,A01,083621,Davis; Joshua Daniel,9,0,68,59
1657506742362,COGS 101B,A01,091572,Allen; Michael Gordon,12,0,65,53
1657506748387,COGS 101C,A01,083625,Delgado; Tania,17,0,35,18
1657506754410,COGS 107A,A01,083627,Boyle; Mary E. T.,13,0,60,47
1657506760435,COGS 118A,A01,083075,Gupta; Anjum,21,0,76,55
1657506766468,CSE 3,A50,083646,Miranda; Gregory Joseph,24,0,50,26
1657506772490,CSE 8A,A50,083650,Miranda; Gregory Joseph,17,1,56,39
1657506778513,CSE 11,A01,083080,Cao; Yingjun,6,15,40,34
1657506784536,CSE 12,A01,083652,Krause-Levy; Sophia Louisa,28,1,120,92
1657506790563,CSE 15L,A01,083654,Morris; Justin Loren,9,0,50,41
1657506790563,CSE 15L,A02,083655,Morris; Justin Loren,9,0,50,41
1657506796585,CSE 20,A01,083657,Tran; Khoa Dang,39,0,80,41
1657506802608,CSE 21,A01,095574,Bach; Quang Tran,22,0,48,26
1657506808631,CSE 30,A01,083084,Eldon; John,5,0,80,75
1657506808631,CSE 30,B01,095061,Bhaskar; Nishant,9,0,50,41
1657506814655,CSE 100,A01,083659,Cao; Yingjun,5,4,70,65
1657506820677,CSE 134B,A01,083661,Powell; Thomas Allan,22,0,100,78
1657506826703,CSE 140,A01,083663,Gungor; Onat,15,0,85,70
1657506832726,CSE 140L,A01,083088,Eldon; John,21,0,100,79
1657506838751,CSE 175,A01,083665,Kumar; Rakesh,3,0,25,22
1657506844773,CSE 190,A00,092507,Dubnov; Shlomo,8,0,20,12
1657506850800,ECE 45,A01,083139,Congero; Spencer William,6,0,75,69
1657506856823,ECE 65,A50,083695,Saad; Andrew S,12,0,30,18
1657506856823,ECE 65,A51,095125,Saad; Andrew S,24,0,26,2
1657506862848,ECE 109,A01,091882,Touri; Behrouz,19,0,70,51
1657506868869,ECE 180,A00,083140,Abi Samra; Nicholas Camill,1,0,30,29
1657506868869,ECE 180,B00,083141,Abi Samra; Nicholas Camill,0,0,30,30
1657506874895,MATH 10A,A01,083735,Patchell; Gregory David,2,0,30,28
1657506874895,MATH 10A,A02,083736,Patchell; Gregory David,20,0,30,10
1657506874895,MATH 10A,A03,083737,Patchell; Gregory David,16,0,30,14
1657506880925,MATH 10B,A01,083207,Lim; Seonhee,8,0,34,26
1657506880925,MATH 10B,A02,083208,Lim; Seonhee,9,0,35,26
1657506880925,MATH 10B,A03,093472,Lim; Seonhee,7,0,34,27
1657506880925,MATH 10B,B01,083739,Sinha; Shubham,12,0,30,18
1657506886949,MATH 18,A01,083743,Cinel; Cameron Alexander,7,0,30,23
1657506886949,MATH 18,A02,083744,Cinel; Cameron Alexander,17,0,30,13
1657506886949,MATH 18,A03,083745,Cinel; Cameron Alexander,9,0,30,21
1657506886949,MATH 18,B01,083748,Rideout; David Porter,5,0,37,32
1657506886949,MATH 18,B02,083749,Rideout; David Porter,5,0,36,31
1657506886949,MATH 18,B03,083750,Rideout; David Porter,3,0,37,34
1657506886949,MATH 18,B04,083751,Rideout; David Porter,6,0,36,30
1657506886949,MATH 18,B05,093473,Rideout; David Porter,6,0,36,30
1657506886949,MATH 18,B06,093474,Rideout; David Porter,6,0,36,30
1657506892972,MATH 20A,A01,083754,Zheng; Zequn,14,0,40,26
1657506899000,MATH 20B,A01,083756,Briones; Jor-el Thomas Caparas,4,0,36,32
1657506899000,MATH 20B,A02,083757,Briones; Jor-el Thomas Caparas,1,0,36,35
1657506899000,MATH 20B,A03,093475,Briones; Jor-el Thomas Caparas,2,0,36,34
1657506905027,MATH 20C,A01,083760,Briones; Jor-el Thomas Caparas,1,0,35,34
1657506905027,MATH 20C,A02,083761,Briones; Jor-el Thomas Caparas,8,0,35,27
1657506905027,MATH 20C,A03,093476,Briones; Jor-el Thomas Caparas,0,1,36,36
1657506905027,MATH 20C,B01,083762,Bach; Quang Tran,1,0,30,29
1657506911054,MATH 20D,A01,083765,Tran; Brian Kha,5,0,30,25
1657506911054,MATH 20D,A02,083766,Tran; Brian Kha,5,0,30,25
1657506911054,MATH 20D,A03,083767,Tran; Brian Kha,5,0,30,25
1657506917078,MATH 20E,A01,083771,Ganguly; Soumya,9,0,32,23
1657506917078,MATH 20E,A02,083772,Ganguly; Soumya,6,0,32,26
1657506917078,MATH 20E,B01,083773,Ciotti; Benjamin,20,0,35,15
1657506917078,MATH 20E,B02,083774,Ciotti; Benjamin,17,0,35,18
1657506923108,MATH 103A,A01,083777,Greenfeld; Be'Eri,3,0,36,33
1657506923108,MATH 103A,A02,083778,Greenfeld; Be'Eri,5,0,36,31
1657506923108,MATH 103A,A03,093561,Greenfeld; Be'Eri,5,0,36,31
1657506923108,MATH 103A,B01,083779,Greenfeld; Be'Eri,7,0,36,29
1657506923108,MATH 103A,B02,083780,Greenfeld; Be'Eri,4,0,36,32
1657506923108,MATH 103A,B03,093562,Greenfeld; Be'Eri,3,0,36,33
1657506929135,MATH 105,A01,085443,Carter; Anne Toulson,15,0,35,20
1657506929135,MATH 105,A02,093477,Carter; Anne Toulson,20,0,35,15
1657506935163,MATH 109,A01,083213,Ganzberger; Geoffrey Michael,2,0,34,32
1657506935163,MATH 109,A02,083214,Ganzberger; Geoffrey Michael,4,0,34,30
1657506935163,MATH 109,A03,093478,Ganzberger; Geoffrey Michael,2,0,34,32
1657506935163,MATH 109,B01,083215,Ganzberger; Geoffrey Michael,1,0,32,31
1657506935163,MATH 109,B02,083216,Ganzberger; Geoffrey Michael,2,0,32,30
1657506935163,MATH 109,B03,093479,Ganzberger; Geoffrey Michael,8,0,32,24
1657506941187,MATH 142A,A01,083219,Chow; Bennett,7,0,32,25
1657506941187,MATH 142A,A02,083220,Chow; Bennett,10,0,32,22
1657506941187,MATH 142A,A03,093480,Chow; Bennett,8,0,32,24
1657506941187,MATH 142A,B03,093481,Chow; Bennett,8,0,32,24
1657506941187,MATH 142A,B04,093558,Chow; Bennett,13,0,32,19
1657506941187,MATH 142A,B05,093559,Chow; Bennett,6,0,32,26
1657506947212,MATH 193A,A01,083224,Rotar; Vladimir,8,0,34,26
1657506947212,MATH 193A,A02,083225,Rotar; Vladimir,9,0,34,25
1657506947212,MATH 193A,A03,083781,Rotar; Vladimir,5,0,34,29
1657506947212,MATH 193A,A04,083782,Rotar; Vladimir,10,0,34,24
1657506947212,MATH 193A,A05,093482,Rotar; Vladimir,10,0,34,24
1657506953238,MATH 197,001,091859,McAuley; Julian John,9999,0,9999,0
1657506953238,MATH 197,002,095566,Kedlaya; Kiran S.,9997,0,9999,2
1657506953238,MATH 197,003,095567,Xiao; Ming,9999,0,9999,0
1657506953238,MATH 197,004,095571,Perols; Johan Lars,9998,0,9999,1
1657506960295,COGS 9,A01,083615,Shannon; Kyle Michael,9,0,75,66
1657506966319,COGS 11,A01,083617,Boyle; Mary E. T.,22,0,48,26
1657506972342,COGS 13,A01,083071,Bastos; Amalia Pinkusfeld,11,0,71,60
1657506978369,COGS 14A,A01,092681,Semenuks; Arturs,5,1,100,95
1657506984400,COGS 14B,A01,083073,Cheng; Tzu-Han,6,0,63,57
1657506990426,COGS 17,A01,092677,Semenuks; Arturs,6,0,81,75
1657506996452,COGS 100,A01,083619,Allen; Michael Gordon,17,0,70,53
1657507002474,COGS 101A,A01,083621,Davis; Joshua Daniel,9,0,68,59
1657507008497,COGS 101B,A01,091572,Allen; Michael Gordon,12,0,65,53
1657507014519,COGS 101C,A01,083625,Delgado; Tania,17,0,35,18
1657507020541,COGS 107A,A01,083627,Boyle; Mary E. T.,13,0,60,47
1657507026565,COGS 118A,A01,083075,Gupta; Anjum,21,0,76,55
1657507032596,CSE 3,A50,083646,Miranda; Gregory Joseph,24,0,50,26
1657507038618,CSE 8A,A50,083650,Miranda; Gregory Joseph,17,1,56,39
1657507044645,CSE 11,A01,083080,Cao; Yingjun,6,15,40,34
1657507050675,CSE 12,A01,083652,Krause-Levy; Sophia Louisa,28,1,120,92
1657507056700,CSE 15L,A01,083654,Morris; Justin Loren,9,0,50,41
1657507056700,CSE 15L,A02,083655,Morris; Justin Loren,9,0,50,41
1657507062731,CSE 20,A01,083657,Tran; Khoa Dang,39,0,80,41
1657507068755,CSE 21,A01,095574,Bach; Quang Tran,22,0,48,26
1657507074779,CSE 30,A01,083084,Eldon; John,5,0,80,75
1657507074779,CSE 30,B01,095061,Bhaskar; Nishant,9,0,50,41
1657507080804,CSE 100,A01,083659,Cao; Yingjun,5,4,70,65
1657507086830,CSE 134B,A01,083661,Powell; Thomas Allan,22,0,100,78
1657507092855,CSE 140,A01,083663,Gungor; Onat,15,0,85,70
1657507098880,CSE 140L,A01,083088,Eldon; John,21,0,100,79
1657507104903,CSE 175,A01,083665,Kumar; Rakesh,3,0,25,22
1657507110927,CSE 190,A00,092507,Dubnov; Shlomo,8,0,20,12
1657507116951,ECE 45,A01,083139,Congero; Spencer William,6,0,75,69
1657507122975,ECE 65,A50,083695,Saad; Andrew S,12,0,30,18
1657507122975,ECE 65,A51,095125,Saad; Andrew S,24,0,26,2
1657507129000,ECE 109,A01,091882,Touri; Behrouz,19,0,70,51
1657507135028,ECE 180,A00,083140,Abi Samra; Nicholas Camill,1,0,30,29
1657507135028,ECE 180,B00,083141,Abi Samra; Nicholas Camill,0,0,30,30
1657507141050,MATH 10A,A01,083735,Patchell; Gregory David,2,0,30,28
1657507141050,MATH 10A,A02,083736,Patchell; Gregory David,20,0,30,10
1657507141050,MATH 10A,A03,083737,Patchell; Gregory David,16,0,30,14
1657507147083,MATH 10B,A01,083207,Lim; Seonhee,8,0,34,26
1657507147083,MATH 10B,A02,083208,Lim; Seonhee,9,0,35,26
1657507147083,MATH 10B,A03,093472,Lim; Seonhee,7,0,34,27
1657507147083,MATH 10B,B01,083739,Sinha; Shubham,12,0,30,18
1657507153114,MATH 18,A01,083743,Cinel; Cameron Alexander,7,0,30,23
1657507153114,MATH 18,A02,083744,Cinel; Cameron Alexander,17,0,30,13
1657507153114,MATH 18,A03,083745,Cinel; Cameron Alexander,9,0,30,21
1657507153114,MATH 18,B01,083748,Rideout; David Porter,5,0,37,32
1657507153114,MATH 18,B02,083749,Rideout; David Porter,5,0,36,31
1657507153114,MATH 18,B03,083750,Rideout; David Porter,3,0,37,34
1657507153114,MATH 18,B04,083751,Rideout; David Porter,6,0,36,30
1657507153114,MATH 18,B05,093473,Rideout; David Porter,6,0,36,30
1657507153114,MATH 18,B06,093474,Rideout; David Porter,6,0,36,30
1657507159137,MATH 20A,A01,083754,Zheng; Zequn,14,0,40,26
1657507165160,MATH 20B,A01,083756,Briones; Jor-el Thomas Caparas,4,0,36,32
1657507165160,MATH 20B,A02,083757,Briones; Jor-el Thomas Caparas,1,0,36,35
1657507165160,MATH 20B,A03,093475,Briones; Jor-el Thomas Caparas,2,0,36,34
1657507171184,MATH 20C,A01,083760,Briones; Jor-el Thomas Caparas,1,0,35,34
1657507171184,MATH 20C,A02,083761,Briones; Jor-el Thomas Caparas,8,0,35,27
1657507171184,MATH 20C,A03,093476,Briones; Jor-el Thomas Caparas,0,1,36,36
1657507171184,MATH 20C,B01,083762,Bach; Quang Tran,1,0,30,29
1657507177216,MATH 20D,A01,083765,Tran; Brian Kha,5,0,30,25
1657507177216,MATH 20D,A02,083766,Tran; Brian Kha,5,0,30,25
1657507177216,MATH 20D,A03,083767,Tran; Brian Kha,5,0,30,25
1657507183251,MATH 20E,A01,083771,Ganguly; Soumya,9,0,32,23
1657507183251,MATH 20E,A02,083772,Ganguly; Soumya,6,0,32,26
1657507183251,MATH 20E,B01,083773,Ciotti; Benjamin,20,0,35,15
1657507183251,MATH 20E,B02,083774,Ciotti; Benjamin,17,0,35,18
1657507189275,MATH 103A,A01,083777,Greenfeld; Be'Eri,3,0,36,33
1657507189275,MATH 103A,A02,083778,Greenfeld; Be'Eri,5,0,36,31
1657507189275,MATH 103A,A03,093561,Greenfeld; Be'Eri,5,0,36,31
1657507189275,MATH 103A,B01,083779,Greenfeld; Be'Eri,7,0,36,29
1657507189275,MATH 103A,B02,083780,Greenfeld; Be'Eri,4,0,36,32
1657507189275,MATH 103A,B03,093562,Greenfeld; Be'Eri,3,0,36,33
1657507195299,MATH 105,A01,085443,Carter; Anne Toulson,15,0,35,20
1657507195299,MATH 105,A02,093477,Carter; Anne Toulson,20,0,35,15
1657507201326,MATH 109,A01,083213,Ganzberger; Geoffrey Michael,2,0,34,32
1657507201326,MATH 109,A02,083214,Ganzberger; Geoffrey Michael,4,0,34,30
1657507201326,MATH 109,A03,093478,Ganzberger; Geoffrey Michael,2,0,34,32
1657507201326,MATH 109,B01,083215,Ganzberger; Geoffrey Michael,1,0,32,31
1657507201326,MATH 109,B02,083216,Ganzberger; Geoffrey Michael,2,0,32,30
1657507201326,MATH 109,B03,093479,Ganzberger; Geoffrey Michael,8,0,32,24
1657507207349,MATH 142A,A01,083219,Chow; Bennett,7,0,32,25
1657507207349,MATH 142A,A02,083220,Chow; Bennett,10,0,32,22
1657507207349,MATH 142A,A03,093480,Chow; Bennett,8,0,32,24
1657507207349,MATH 142A,B03,093481,Chow; Bennett,8,0,32,24
1657507207349,MATH 142A,B04,093558,Chow; Bennett,13,0,32,19
1657507207349,MATH 142A,B05,093559,Chow; Bennett,6,0,32,26
1657507213372,MATH 193A,A01,083224,Rotar; Vladimir,8,0,34,26
1657507213372,MATH 193A,A02,083225,Rotar; Vladimir,9,0,34,25
1657507213372,MATH 193A,A03,083781,Rotar; Vladimir,5,0,34,29
1657507213372,MATH 193A,A04,083782,Rotar; Vladimir,10,0,34,24
1657507213372,MATH 193A,A05,093482,Rotar; Vladimir,10,0,34,24
1657507219394,MATH 197,001,091859,McAuley; Julian John,9999,0,9999,0
1657507219394,MATH 197,002,095566,Kedlaya; Kiran S.,9997,0,9999,2
1657507219394,MATH 197,003,095567,Xiao; Ming,9999,0,9999,0
1657507219394,MATH 197,004,095571,Perols; Johan Lars,9998,0,9999,1
1657507226448,COGS 9,A01,083615,Shannon; Kyle Michael,9,0,75,66
1657507232470,COGS 11,A01,083617,Boyle; Mary E. T.,22,0,48,26
1657507238492,COGS 13,A01,083071,Bastos; Amalia Pinkusfeld,11,0,71,60
1657507244515,COGS 14A,A01,092681,Semenuks; Arturs,5,1,100,95
1657507250542,COGS 14B,A01,083073,Cheng; Tzu-Han,6,0,63,57
1657507256565,COGS 17,A01,092677,Semenuks; Arturs,6,0,81,75
1657507262603,COGS 100,A01,083619,Allen; Michael Gordon,17,0,70,53
1657507268630,COGS 101A,A01,083621,Davis; Joshua Daniel,9,0,68,59
1657507274656,COGS 101B,A01,091572,Allen; Michael Gordon,12,0,65,53
1657507280678,COGS 101C,A01,083625,Delgado; Tania,17,0,35,18
1657507286705,COGS 107A,A01,083627,Boyle; Mary E. T.,13,0,60,47
1657507292731,COGS 118A,A01,083075,Gupta; Anjum,21,0,76,55
1657507298755,CSE 3,A50,083646,Miranda; Gregory Joseph,24,0,50,26
1657507304786,CSE 8A,A50,083650,Miranda; Gregory Joseph,17,1,56,39
1657507310812,CSE 11,A01,083080,Cao; Yingjun,6,15,40,34
1657507316835,CSE 12,A01,083652,Krause-Levy; Sophia Louisa,28,1,120,92
1657507322863,CSE 15L,A01,083654,Morris; Justin Loren,9,0,50,41
1657507322863,CSE 15L,A02,083655,Morris; Justin Loren,9,0,50,41
1657507328891,CSE 20,A01,083657,Tran; Khoa Dang,39,0,80,41
1657507335006,CSE 21,A01,095574,Bach; Quang Tran,22,0,48,26
1657507341045,CSE 30,A01,083084,Eldon; John,5,0,80,75
1657507341045,CSE 30,B01,095061,Bhaskar; Nishant,9,0,50,41
1657507347071,CSE 100,A01,083659,Cao; Yingjun,5,4,70,65
1657507353100,CSE 134B,A01,083661,Powell; Thomas Allan,22,0,100,78
1657507359124,CSE 140,A01,083663,Gungor; Onat,15,0,85,70
1657507365148,CSE 140L,A01,083088,Eldon; John,21,0,100,79
1657507371172,CSE 175,A01,083665,Kumar; Rakesh,3,0,25,22
1657507377196,CSE 190,A00,092507,Dubnov; Shlomo,8,0,20,12
1657507383220,ECE 45,A01,083139,Congero; Spencer William,6,0,75,69
1657507389248,ECE 65,A50,083695,Saad; Andrew S,12,0,30,18
1657507389248,ECE 65,A51,095125,Saad; Andrew S,24,0,26,2
1657507395269,ECE 109,A01,091882,Touri; Behrouz,19,0,70,51
1657507401296,ECE 180,A00,083140,Abi Samra; Nicholas Camill,1,0,30,29
1657507401296,ECE 180,B00,083141,Abi Samra; Nicholas Camill,0,0,30,30
1657507407325,MATH 10A,A01,083735,Patchell; Gregory David,2,0,30,28
1657507407325,MATH 10A,A02,083736,Patchell; Gregory David,20,0,30,10
1657507407325,MATH 10A,A03,083737,Patchell; Gregory David,16,0,30,14
1657507413356,MATH 10B,A01,083207,Lim; Seonhee,8,0,34,26
1657507413356,MATH 10B,A02,083208,Lim; Seonhee,9,0,35,26
1657507413356,MATH 10B,A03,093472,Lim; Seonhee,7,0,34,27
1657507413356,MATH 10B,B01,083739,Sinha; Shubham,12,0,30,18
1657507419380,MATH 18,A01,083743,Cinel; Cameron Alexander,7,0,30,23
1657507419380,MATH 18,A02,083744,Cinel; Cameron Alexander,17,0,30,13
1657507419380,MATH 18,A03,083745,Cinel; Cameron Alexander,9,0,30,21
1657507419380,MATH 18,B01,083748,Rideout; David Porter,5,0,37,32
1657507419380,MATH 18,B02,083749,Rideout; David Porter,5,0,36,31
1657507419380,MATH 18,B03,083750,Rideout; David Porter,3,0,37,34
1657507419380,MATH 18,B04,083751,Rideout; David Porter,6,0,36,30
1657507419380,MATH 18,B05,093473,Rideout; David Porter,6,0,36,30
1657507419380,MATH 18,B06,093474,Rideout; David Porter,6,0,36,30
1657507425403,MATH 20A,A01,083754,Zheng; Zequn,14,0,40,26
1657507431425,MATH 20B,A01,083756,Briones; Jor-el Thomas Caparas,4,0,36,32
1657507431425,MATH 20B,A02,083757,Briones; Jor-el Thomas Caparas,1,0,36,35
1657507431425,MATH 20B,A03,093475,Briones; Jor-el Thomas Caparas,2,0,36,34
1657507437448,MATH 20C,A01,083760,Briones; Jor-el Thomas Caparas,1,0,35,34
1657507437448,MATH 20C,A02,083761,Briones; Jor-el Thomas Caparas,8,0,35,27
1657507437448,MATH 20C,A03,093476,Briones; Jor-el Thomas Caparas,0,1,36,36
1657507437448,MATH 20C,B01,083762,Bach; Quang Tran,1,0,30,29
1657507443476,MATH 20D,A01,083765,Tran; Brian Kha,5,0,30,25
1657507443476,MATH 20D,A02,083766,Tran; Brian Kha,5,0,30,25
1657507443476,MATH 20D,A03,083767,Tran; Brian Kha,5,0,30,25
1657507449503,MATH 20E,A01,083771,Ganguly; Soumya,9,0,32,23
1657507449503,MATH 20E,A02,083772,Ganguly; Soumya,6,0,32,26
1657507449503,MATH 20E,B01,083773,Ciotti; Benjamin,20,0,35,15
1657507449503,MATH 20E,B02,083774,Ciotti; Benjamin,17,0,35,18
1657507455525,MATH 103A,A01,083777,Greenfeld; Be'Eri,3,0,36,33
1657507455525,MATH 103A,A02,083778,Greenfeld; Be'Eri,5,0,36,31
1657507455525,MATH 103A,A03,093561,Greenfeld; Be'Eri,5,0,36,31
1657507455525,MATH 103A,B01,083779,Greenfeld; Be'Eri,7,0,36,29
1657507455525,MATH 103A,B02,083780,Greenfeld; Be'Eri,4,0,36,32
1657507455525,MATH 103A,B03,093562,Greenfeld; Be'Eri,3,0,36,33
1657507461555,MATH 105,A01,085443,Carter; Anne Toulson,15,0,35,20
1657507461555,MATH 105,A02,093477,Carter; Anne Toulson,20,0,35,15
1657507467577,MATH 109,A01,083213,Ganzberger; Geoffrey Michael,2,0,34,32
1657507467577,MATH 109,A02,083214,Ganzberger; Geoffrey Michael,4,0,34,30
1657507467577,MATH 109,A03,093478,Ganzberger; Geoffrey Michael,2,0,34,32
1657507467577,MATH 109,B01,083215,Ganzberger; Geoffrey Michael,1,0,32,31
1657507467577,MATH 109,B02,083216,Ganzberger; Geoffrey Michael,2,0,32,30
1657507467577,MATH 109,B03,093479,Ganzberger; Geoffrey Michael,8,0,32,24
1657507473603,MATH 142A,A01,083219,Chow; Bennett,7,0,32,25
1657507473603,MATH 142A,A02,083220,Chow; Bennett,10,0,32,22
1657507473603,MATH 142A,A03,093480,Chow; Bennett,8,0,32,24
1657507473603,MATH 142A,B03,093481,Chow; Bennett,8,0,32,24
1657507473603,MATH 142A,B04,093558,Chow; Bennett,13,0,32,19
1657507473603,MATH 142A,B05,093559,Chow; Bennett,6,0,32,26
1657507479631,MATH 193A,A01,083224,Rotar; Vladimir,8,0,34,26
1657507479631,MATH 193A,A02,083225,Rotar; Vladimir,9,0,34,25
1657507479631,MATH 193A,A03,083781,Rotar; Vladimir,5,0,34,29
1657507479631,MATH 193A,A04,083782,Rotar; Vladimir,10,0,34,24
1657507479631,MATH 193A,A05,093482,Rotar; Vladimir,10,0,34,24
1657507485653,MATH 197,001,091859,McAuley; Julian John,9999,0,9999,0
1657507485653,MATH 197,002,095566,Kedlaya; Kiran S.,9997,0,9999,2
1657507485653,MATH 197,003,095567,Xiao; Ming,9999,0,9999,0
1657507485653,MATH 197,004,095571,Perols; Johan Lars,9998,0,9999,1
1657507492711,COGS 9,A01,083615,Shannon; Kyle Michael,9,0,75,66
1657507498737,COGS 11,A01,083617,Boyle; Mary E. T.,22,0,48,26
1657507504758,COGS 13,A01,083071,Bastos; Amalia Pinkusfeld,11,0,71,60
1657507510781,COGS 14A,A01,092681,Semenuks; Arturs,5,1,100,95
1657507516803,COGS 14B,A01,083073,Cheng; Tzu-Han,6,0,63,57
1657507522829,COGS 17,A01,092677,Semenuks; Arturs,6,0,81,75
1657507528855,COGS 100,A01,083619,Allen; Michael Gordon,17,0,70,53
1657507534879,COGS 101A,A01,083621,Davis; Joshua Daniel,9,0,68,59
1657507540906,COGS 101B,A01,091572,Allen; Michael Gordon,12,0,65,53
1657507546958,COGS 101C,A01,083625,Delgado; Tania,17,0,35,18
1657507552982,COGS 107A,A01,083627,Boyle; Mary E. T.,13,0,60,47
1657507559004,COGS 118A,A01,083075,Gupta; Anjum,21,0,76,55
1657507565028,CSE 3,A50,083646,Miranda; Gregory Joseph,24,0,50,26
1657507571053,CSE 8A,A50,083650,Miranda; Gregory Joseph,17,1,56,39
1657507577081,CSE 11,A01,083080,Cao; Yingjun,6,15,40,34
1657507583113,CSE 12,A01,083652,Krause-Levy; Sophia Louisa,28,1,120,92
1657507589137,CSE 15L,A01,083654,Morris; Justin Loren,9,0,50,41
1657507589137,CSE 15L,A02,083655,Morris; Justin Loren,9,0,50,41
1657507595169,CSE 20,A01,083657,Tran; Khoa Dang,39,0,80,41
1657507601195,CSE 21,A01,095574,Bach; Quang Tran,22,0,48,26
1657507607224,CSE 30,A01,083084,Eldon; John,5,0,80,75
1657507607224,CSE 30,B01,095061,Bhaskar; Nishant,9,0,50,41
1657507613252,CSE 100,A01,083659,Cao; Yingjun,5,4,70,65
1657507619278,CSE 134B,A01,083661,Powell; Thomas Allan,22,0,100,78
1657507625306,CSE 140,A01,083663,Gungor; Onat,15,0,85,70
1657507631331,CSE 140L,A01,083088,Eldon; John,21,0,100,79
1657507637358,CSE 175,A01,083665,Kumar; Rakesh,3,0,25,22
1657507643384,CSE 190,A00,092507,Dubnov; Shlomo,8,0,20,12
1657507649410,ECE 45,A01,083139,Congero; Spencer William,6,0,75,69
1657507655442,ECE 65,A50,083695,Saad; Andrew S,12,0,30,18
1657507655442,ECE 65,A51,095125,Saad; Andrew S,24,0,26,2
1657507661467,ECE 109,A01,091882,Touri; Behrouz,19,0,70,51
1657507667490,ECE 180,A00,083140,Abi Samra; Nicholas Camill,1,0,30,29
1657507667490,ECE 180,B00,083141,Abi Samra; Nicholas Camill,0,0,30,30
1657507673517,MATH 10A,A01,083735,Patchell; Gregory David,2,0,30,28
1657507673517,MATH 10A,A02,083736,Patchell; Gregory David,20,0,30,10
1657507673517,MATH 10A,A03,083737,Patchell; Gregory David,16,0,30,14
1657507679546,MATH 10B,A01,083207,Lim; Seonhee,8,0,34,26
1657507679546,MATH 10B,A02,083208,Lim; Seonhee,9,0,35,26
1657507679546,MATH 10B,A03,093472,Lim; Seonhee,7,0,34,27
1657507679546,MATH 10B,B01,083739,Sinha; Shubham,12,0,30,18
1657507685578,MATH 18,A01,083743,Cinel; Cameron Alexander,7,0,30,23
1657507685578,MATH 18,A02,083744,Cinel; Cameron Alexander,17,0,30,13
1657507685578,MATH 18,A03,083745,Cinel; Cameron Alexander,9,0,30,21
1657507685578,MATH 18,B01,083748,Rideout; David Porter,5,0,37,32
1657507685578,MATH 18,B02,083749,Rideout; David Porter,5,0,36,31
1657507685578,MATH 18,B03,083750,Rideout; David Porter,3,0,37,34
1657507685578,MATH 18,B04,083751,Rideout; David Porter,6,0,36,30
1657507685578,MATH 18,B05,093473,Rideout; David Porter,6,0,36,30
1657507685578,MATH 18,B06,093474,Rideout; David Porter,6,0,36,30
1657507691599,MATH 20A,A01,083754,Zheng; Zequn,14,0,40,26
1657507697626,MATH 20B,A01,083756,Briones; Jor-el Thomas Caparas,4,0,36,32
1657507697626,MATH 20B,A02,083757,Briones; Jor-el Thomas Caparas,1,0,36,35
1657507697626,MATH 20B,A03,093475,Briones; Jor-el Thomas Caparas,2,0,36,34
1657507703650,MATH 20C,A01,083760,Briones; Jor-el Thomas Caparas,1,0,35,34
1657507703650,MATH 20C,A02,083761,Briones; Jor-el Thomas Caparas,8,0,35,27
1657507703650,MATH 20C,A03,093476,Briones; Jor-el Thomas Caparas,0,1,36,36
1657507703650,MATH 20C,B01,083762,Bach; Quang Tran,1,0,30,29
1657507709673,MATH 20D,A01,083765,Tran; Brian Kha,5,0,30,25
1657507709673,MATH 20D,A02,083766,Tran; Brian Kha,5,0,30,25
1657507709673,MATH 20D,A03,083767,Tran; Brian Kha,5,0,30,25
1657507715710,MATH 20E,A01,083771,Ganguly; Soumya,9,0,32,23
1657507715710,MATH 20E,A02,083772,Ganguly; Soumya,6,0,32,26
1657507715710,MATH 20E,B01,083773,Ciotti; Benjamin,20,0,35,15
1657507715710,MATH 20E,B02,083774,Ciotti; Benjamin,17,0,35,18
1657507721740,MATH 103A,A01,083777,Greenfeld; Be'Eri,3,0,36,33
1657507721740,MATH 103A,A02,083778,Greenfeld; Be'Eri,5,0,36,31
1657507721740,MATH 103A,A03,093561,Greenfeld; Be'Eri,5,0,36,31
1657507721740,MATH 103A,B01,083779,Greenfeld; Be'Eri,7,0,36,29
1657507721740,MATH 103A,B02,083780,Greenfeld; Be'Eri,4,0,36,32
1657507721740,MATH 103A,B03,093562,Greenfeld; Be'Eri,3,0,36,33
1657507727768,MATH 105,A01,085443,Carter; Anne Toulson,15,0,35,20
1657507727768,MATH 105,A02,093477,Carter; Anne Toulson,20,0,35,15
1657507733791,MATH 109,A01,083213,Ganzberger; Geoffrey Michael,2,0,34,32
1657507733791,MATH 109,A02,083214,Ganzberger; Geoffrey Michael,4,0,34,30
1657507733791,MATH 109,A03,093478,Ganzberger; Geoffrey Michael,2,0,34,32
1657507733791,MATH 109,B01,083215,Ganzberger; Geoffrey Michael,1,0,32,31
1657507733791,MATH 109,B02,083216,Ganzberger; Geoffrey Michael,2,0,32,30
1657507733791,MATH 109,B03,093479,Ganzberger; Geoffrey Michael,8,0,32,24
1657507739814,MATH 142A,A01,083219,Chow; Bennett,7,0,32,25
1657507739814,MATH 142A,A02,083220,Chow; Bennett,10,0,32,22
1657507739814,MATH 142A,A03,093480,Chow; Bennett,8,0,32,24
1657507739814,MATH 142A,B03,093481,Chow; Bennett,8,0,32,24
1657507739814,MATH 142A,B04,093558,Chow; Bennett,13,0,32,19
1657507739814,MATH 142A,B05,093559,Chow; Bennett,6,0,32,26
1657507745838,MATH 193A,A01,083224,Rotar; Vladimir,8,0,34,26
1657507745838,MATH 193A,A02,083225,Rotar; Vladimir,9,0,34,25
1657507745838,MATH 193A,A03,083781,Rotar; Vladimir,5,0,34,29
1657507745838,MATH 193A,A04,083782,Rotar; Vladimir,10,0,34,24
1657507745838,MATH 193A,A05,093482,Rotar; Vladimir,10,0,34,24
1657507751869,MATH 197,001,091859,McAuley; Julian John,9999,0,9999,0
1657507751869,MATH 197,002,095566,Kedlaya; Kiran S.,9997,0,9999,2
1657507751869,MATH 197,003,095567,Xiao; Ming,9999,0,9999,0
1657507751869,MATH 197,004,095571,Perols; Johan Lars,9998,0,9999,1
1657507758928,COGS 9,A01,083615,Shannon; Kyle Michael,9,0,75,66
1657507764956,COGS 11,A01,083617,Boyle; Mary E. T.,22,0,48,26
1657507770979,COGS 13,A01,083071,Bastos; Amalia Pinkusfeld,11,0,71,60
1657507777001,COGS 14A,A01,092681,Semenuks; Arturs,5,1,100,95
1657507783024,COGS 14B,A01,083073,Cheng; Tzu-Han,6,0,63,57
1657507789049,COGS 17,A01,092677,Semenuks; Arturs,6,0,81,75
1657507795075,COGS 100,A01,083619,Allen; Michael Gordon,17,0,70,53
1657507801098,COGS 101A,A01,083621,Davis; Joshua Daniel,9,0,68,59
1657507807125,COGS 101B,A01,091572,Allen; Michael Gordon,12,0,65,53
1657507813154,COGS 101C,A01,083625,Delgado; Tania,17,0,35,18
1657507819177,COGS 107A,A01,083627,Boyle; Mary E. T.,13,0,60,47
1657507825199,COGS 118A,A01,083075,Gupta; Anjum,21,0,76,55
1657507831222,CSE 3,A50,083646,Miranda; Gregory Joseph,24,0,50,26
1657507837246,CSE 8A,A50,083650,Miranda; Gregory Joseph,17,1,56,39
1657507843274,CSE 11,A01,083080,Cao; Yingjun,6,15,40,34
1657507849299,CSE 12,A01,083652,Krause-Levy; Sophia Louisa,28,1,120,92
1657507855321,CSE 15L,A01,083654,Morris; Justin Loren,9,0,50,41
1657507855321,CSE 15L,A02,083655,Morris; Justin Loren,9,0,50,41
1657507861348,CSE 20,A01,083657,Tran; Khoa Dang,39,0,80,41
1657507867371,CSE 21,A01,095574,Bach; Quang Tran,22,0,48,26
1657507873395,CSE 30,A01,083084,Eldon; John,5,0,80,75
1657507873395,CSE 30,B01,095061,Bhaskar; Nishant,9,0,50,41
1657507879421,CSE 100,A01,083659,Cao; Yingjun,5,4,70,65
1657507885448,CSE 134B,A01,083661,Powell; Thomas Allan,22,0,100,78
1657507891469,CSE 140,A01,083663,Gungor; Onat,15,0,85,70
1657507897503,CSE 140L,A01,083088,Eldon; John,21,0,100,79
1657507903524,CSE 175,A01,083665,Kumar; Rakesh,3,0,25,22
1657507909550,CSE 190,A00,092507,Dubnov; Shlomo,8,0,20,12
1657507915574,ECE 45,A01,083139,Congero; Spencer William,6,0,75,69
1657507921602,ECE 65,A50,083695,Saad; Andrew S,12,0,30,18
1657507921602,ECE 65,A51,095125,Saad; Andrew S,24,0,26,2
1657507927628,ECE 109,A01,091882,Touri; Behrouz,19,0,70,51
1657507933726,ECE 180,A00,083140,Abi Samra; Nicholas Camill,1,0,30,29
1657507933726,ECE 180,B00,083141,Abi Samra; Nicholas Camill,0,0,30,30
1657507939749,MATH 10A,A01,083735,Patchell; Gregory David,2,0,30,28
1657507939749,MATH 10A,A02,083736,Patchell; Gregory David,20,0,30,10
1657507939749,MATH 10A,A03,083737,Patchell; Gregory David,16,0,30,14
1657507945775,MATH 10B,A01,083207,Lim; Seonhee,8,0,34,26
1657507945775,MATH 10B,A02,083208,Lim; Seonhee,9,0,35,26
1657507945775,MATH 10B,A03,093472,Lim; Seonhee,7,0,34,27
1657507945775,MATH 10B,B01,083739,Sinha; Shubham,12,0,30,18
1657507951805,MATH 18,A01,083743,Cinel; Cameron Alexander,7,0,30,23
1657507951805,MATH 18,A02,083744,Cinel; Cameron Alexander,17,0,30,13
1657507951805,MATH 18,A03,083745,Cinel; Cameron Alexander,9,0,30,21
1657507951805,MATH 18,B01,083748,Rideout; David Porter,5,0,37,32
1657507951805,MATH 18,B02,083749,Rideout; David Porter,5,0,36,31
1657507951805,MATH 18,B03,083750,Rideout; David Porter,3,0,37,34
1657507951805,MATH 18,B04,083751,Rideout; David Porter,6,0,36,30
1657507951805,MATH 18,B05,093473,Rideout; David Porter,6,0,36,30
1657507951805,MATH 18,B06,093474,Rideout; David Porter,6,0,36,30
1657507957833,MATH 20A,A01,083754,Zheng; Zequn,14,0,40,26
1657507963860,MATH 20B,A01,083756,Briones; Jor-el Thomas Caparas,4,0,36,32
1657507963860,MATH 20B,A02,083757,Briones; Jor-el Thomas Caparas,1,0,36,35
1657507963860,MATH 20B,A03,093475,Briones; Jor-el Thomas Caparas,2,0,36,34
1657507969886,MATH 20C,A01,083760,Briones; Jor-el Thomas Caparas,1,0,35,34
1657507969886,MATH 20C,A02,083761,Briones; Jor-el Thomas Caparas,8,0,35,27
1657507969886,MATH 20C,A03,093476,Briones; Jor-el Thomas Caparas,0,1,36,36
1657507969886,MATH 20C,B01,083762,Bach; Quang Tran,1,0,30,29
1657507975911,MATH 20D,A01,083765,Tran; Brian Kha,5,0,30,25
1657507975911,MATH 20D,A02,083766,Tran; Brian Kha,5,0,30,25
1657507975911,MATH 20D,A03,083767,Tran; Brian Kha,5,0,30,25
1657507981939,MATH 20E,A01,083771,Ganguly; Soumya,9,0,32,23
1657507981939,MATH 20E,A02,083772,Ganguly; Soumya,6,0,32,26
1657507981939,MATH 20E,B01,083773,Ciotti; Benjamin,20,0,35,15
1657507981939,MATH 20E,B02,083774,Ciotti; Benjamin,17,0,35,18
1657507987960,MATH 103A,A01,083777,Greenfeld; Be'Eri,3,0,36,33
1657507987960,MATH 103A,A02,083778,Greenfeld; Be'Eri,5,0,36,31
1657507987960,MATH 103A,A03,093561,Greenfeld; Be'Eri,5,0,36,31
1657507987960,MATH 103A,B01,083779,Greenfeld; Be'Eri,7,0,36,29
1657507987960,MATH 103A,B02,083780,Greenfeld; Be'Eri,4,0,36,32
1657507987960,MATH 103A,B03,093562,Greenfeld; Be'Eri,3,0,36,33
1657507993987,MATH 105,A01,085443,Carter; Anne Toulson,15,0,35,20
1657507993987,MATH 105,A02,093477,Carter; Anne Toulson,20,0,35,15
1657508000010,MATH 109,A01,083213,Ganzberger; Geoffrey Michael,2,0,34,32
1657508000010,MATH 109,A02,083214,Ganzberger; Geoffrey Michael,4,0,34,30
1657508000010,MATH 109,A03,093478,Ganzberger; Geoffrey Michael,2,0,34,32
1657508000010,MATH 109,B01,083215,Ganzberger; Geoffrey Michael,1,0,32,31
1657508000010,MATH 109,B02,083216,Ganzberger; Geoffrey Michael,2,0,32,30
1657508000010,MATH 109,B03,093479,Ganzberger; Geoffrey Michael,8,0,32,24
1657508006039,MATH 142A,A01,083219,Chow; Bennett,7,0,32,25
1657508006039,MATH 142A,A02,083220,Chow; Bennett,10,0,32,22
1657508006039,MATH 142A,A03,093480,Chow; Bennett,8,0,32,24
1657508006039,MATH 142A,B03,093481,Chow; Bennett,8,0,32,24
1657508006039,MATH 142A,B04,093558,Chow; Bennett,13,0,32,19
1657508006039,MATH 142A,B05,093559,Chow; Bennett,6,0,32,26
1657508012063,MATH 193A,A01,083224,Rotar; Vladimir,8,0,34,26
1657508012063,MATH 193A,A02,083225,Rotar; Vladimir,9,0,34,25
1657508012063,MATH 193A,A03,083781,Rotar; Vladimir,5,0,34,29
1657508012063,MATH 193A,A04,083782,Rotar; Vladimir,10,0,34,24
1657508012063,MATH 193A,A05,093482,Rotar; Vladimir,10,0,34,24
1657508018088,MATH 197,001,091859,McAuley; Julian John,9999,0,9999,0
1657508018088,MATH 197,002,095566,Kedlaya; Kiran S.,9997,0,9999,2
1657508018088,MATH 197,003,095567,Xiao; Ming,9999,0,9999,0
1657508018088,MATH 197,004,095571,Perols; Johan Lars,9998,0,9999,1
1657508025147,COGS 9,A01,083615,Shannon; Kyle Michael,9,0,75,66
1657508031179,COGS 11,A01,083617,Boyle; Mary E. T.,22,0,48,26
1657508037206,COGS 13,A01,083071,Bastos; Amalia Pinkusfeld,11,0,71,60
1657508043229,COGS 14A,A01,092681,Semenuks; Arturs,5,1,100,95
1657508049255,COGS 14B,A01,083073,Cheng; Tzu-Han,6,0,63,57
1657508055278,COGS 17,A01,092677,Semenuks; Arturs,6,0,81,75
1657508061300,COGS 100,A01,083619,Allen; Michael Gordon,17,0,70,53
1657508067324,COGS 101A,A01,083621,Davis; Joshua Daniel,9,0,68,59
1657508073355,COGS 101B,A01,091572,Allen; Michael Gordon,12,0,65,53
1657508079380,COGS 101C,A01,083625,Delgado; Tania,17,0,35,18
1657508085404,COGS 107A,A01,083627,Boyle; Mary E. T.,13,0,60,47
1657508091433,COGS 118A,A01,083075,Gupta; Anjum,21,0,76,55
1657508097455,CSE 3,A50,083646,Miranda; Gregory Joseph,24,0,50,26
1657508103478,CSE 8A,A50,083650,Miranda; Gregory Joseph,17,1,56,39
1657508109503,CSE 11,A01,083080,Cao; Yingjun,6,15,40,34
1657508115526,CSE 12,A01,083652,Krause-Levy; Sophia Louisa,28,1,120,92
1657508121550,CSE 15L,A01,083654,Morris; Justin Loren,9,0,50,41
1657508121550,CSE 15L,A02,083655,Morris; Justin Loren,9,0,50,41
1657508127575,CSE 20,A01,083657,Tran; Khoa Dang,39,0,80,41
1657508133599,CSE 21,A01,095574,Bach; Quang Tran,22,0,48,26
1657508139626,CSE 30,A01,083084,Eldon; John,5,0,80,75
1657508139626,CSE 30,B01,095061,Bhaskar; Nishant,9,0,50,41
1657508145657,CSE 100,A01,083659,Cao; Yingjun,5,4,70,65
1657508151680,CSE 134B,A01,083661,Powell; Thomas Allan,22,0,100,78
1657508157702,CSE 140,A01,083663,Gungor; Onat,15,0,85,70
1657508163726,CSE 140L,A01,083088,Eldon; John,21,0,100,79
1657508169750,CSE 175,A01,083665,Kumar; Rakesh,3,0,25,22
1657508175774,CSE 190,A00,092507,Dubnov; Shlomo,8,0,20,12
1657508181801,ECE 45,A01,083139,Congero; Spencer William,6,0,75,69
1657508187825,ECE 65,A50,083695,Saad; Andrew S,12,0,30,18
1657508187825,ECE 65,A51,095125,Saad; Andrew S,24,0,26,2
1657508193850,ECE 109,A01,091882,Touri; Behrouz,19,0,70,51
1657508199875,ECE 180,A00,083140,Abi Samra; Nicholas Camill,1,0,30,29
1657508199875,ECE 180,B00,083141,Abi Samra; Nicholas Camill,0,0,30,30
1657508205904,MATH 10A,A01,083735,Patchell; Gregory David,2,0,30,28
1657508205904,MATH 10A,A02,083736,Patchell; Gregory David,20,0,30,10
1657508205904,MATH 10A,A03,083737,Patchell; Gregory David,16,0,30,14
1657508211930,MATH 10B,A01,083207,Lim; Seonhee,8,0,34,26
1657508211930,MATH 10B,A02,083208,Lim; Seonhee,9,0,35,26
1657508211930,MATH 10B,A03,093472,Lim; Seonhee,7,0,34,27
1657508211930,MATH 10B,B01,083739,Sinha; Shubham,12,0,30,18
1657508217956,MATH 18,A01,083743,Cinel; Cameron Alexander,7,0,30,23
1657508217956,MATH 18,A02,083744,Cinel; Cameron Alexander,17,0,30,13
1657508217956,MATH 18,A03,083745,Cinel; Cameron Alexander,9,0,30,21
1657508217956,MATH 18,B01,083748,Rideout; David Porter,5,0,37,32
1657508217956,MATH 18,B02,083749,Rideout; David Porter,5,0,36,31
1657508217956,MATH 18,B03,083750,Rideout; David Porter,3,0,37,34
1657508217956,MATH 18,B04,083751,Rideout; David Porter,6,0,36,30
1657508217956,MATH 18,B05,093473,Rideout; David Porter,6,0,36,30
1657508217956,MATH 18,B06,093474,Rideout; David Porter,6,0,36,30
1657508223985,MATH 20A,A01,083754,Zheng; Zequn,14,0,40,26
1657508230019,MATH 20B,A01,083756,Briones; Jor-el Thomas Caparas,4,0,36,32
1657508230019,MATH 20B,A02,083757,Briones; Jor-el Thomas Caparas,1,0,36,35
1657508230019,MATH 20B,A03,093475,Briones; Jor-el Thomas Caparas,2,0,36,34
1657508236045,MATH 20C,A01,083760,Briones; Jor-el Thomas Caparas,1,0,35,34
1657508236045,MATH 20C,A02,083761,Briones; Jor-el Thomas Caparas,8,0,35,27
1657508236045,MATH 20C,A03,093476,Briones; Jor-el Thomas Caparas,0,1,36,36
1657508236045,MATH 20C,B01,083762,Bach; Quang Tran,1,0,30,29
1657508242073,MATH 20D,A01,083765,Tran; Brian Kha,5,0,30,25
1657508242073,MATH 20D,A02,083766,Tran; Brian Kha,5,0,30,25
1657508242073,MATH 20D,A03,083767,Tran; Brian Kha,5,0,30,25
1657508248101,MATH 20E,A01,083771,Ganguly; Soumya,9,0,32,23
1657508248101,MATH 20E,A02,083772,Ganguly; Soumya,6,0,32,26
1657508248101,MATH 20E,B01,083773,Ciotti; Benjamin,20,0,35,15
1657508248101,MATH 20E,B02,083774,Ciotti; Benjamin,17,0,35,18
1657508254130,MATH 103A,A01,083777,Greenfeld; Be'Eri,3,0,36,33
1657508254130,MATH 103A,A02,083778,Greenfeld; Be'Eri,5,0,36,31
1657508254130,MATH 103A,A03,093561,Greenfeld; Be'Eri,5,0,36,31
1657508254130,MATH 103A,B01,083779,Greenfeld; Be'Eri,7,0,36,29
1657508254130,MATH 103A,B02,083780,Greenfeld; Be'Eri,4,0,36,32
1657508254130,MATH 103A,B03,093562,Greenfeld; Be'Eri,3,0,36,33
1657508260157,MATH 105,A01,085443,Carter; Anne Toulson,15,0,35,20
1657508260157,MATH 105,A02,093477,Carter; Anne Toulson,20,0,35,15
1657508266182,MATH 109,A01,083213,Ganzberger; Geoffrey Michael,2,0,34,32
1657508266182,MATH 109,A02,083214,Ganzberger; Geoffrey Michael,4,0,34,30
1657508266182,MATH 109,A03,093478,Ganzberger; Geoffrey Michael,2,0,34,32
1657508266182,MATH 109,B01,083215,Ganzberger; Geoffrey Michael,1,0,32,31
1657508266182,MATH 109,B02,083216,Ganzberger; Geoffrey Michael,2,0,32,30
1657508266182,MATH 109,B03,093479,Ganzberger; Geoffrey Michael,8,0,32,24
1657508272208,MATH 142A,A01,083219,Chow; Bennett,7,0,32,25
1657508272208,MATH 142A,A02,083220,Chow; Bennett,10,0,32,22
1657508272208,MATH 142A,A03,093480,Chow; Bennett,8,0,32,24
1657508272208,MATH 142A,B03,093481,Chow; Bennett,8,0,32,24
1657508272208,MATH 142A,B04,093558,Chow; Bennett,13,0,32,19
1657508272208,MATH 142A,B05,093559,Chow; Bennett,6,0,32,26
1657508278231,MATH 193A,A01,083224,Rotar; Vladimir,8,0,34,26
1657508278231,MATH 193A,A02,083225,Rotar; Vladimir,9,0,34,25
1657508278231,MATH 193A,A03,083781,Rotar; Vladimir,5,0,34,29
1657508278231,MATH 193A,A04,083782,Rotar; Vladimir,10,0,34,24
1657508278231,MATH 193A,A05,093482,Rotar; Vladimir,10,0,34,24
1657508284255,MATH 197,001,091859,McAuley; Julian John,9999,0,9999,0
1657508284255,MATH 197,002,095566,Kedlaya; Kiran S.,9997,0,9999,2
1657508284255,MATH 197,003,095567,Xiao; Ming,9999,0,9999,0
1657508284255,MATH 197,004,095571,Perols; Johan Lars,9998,0,9999,1
1657508291305,COGS 9,A01,083615,Shannon; Kyle Michael,9,0,75,66
1657508297333,COGS 11,A01,083617,Boyle; Mary E. T.,22,0,48,26
1657508303354,COGS 13,A01,083071,Bastos; Amalia Pinkusfeld,11,0,71,60
1657508309381,COGS 14A,A01,092681,Semenuks; Arturs,5,1,100,95
1657508315403,COGS 14B,A01,083073,Cheng; Tzu-Han,6,0,63,57
1657508321425,COGS 17,A01,092677,Semenuks; Arturs,6,0,81,75
1657508327449,COGS 100,A01,083619,Allen; Michael Gordon,17,0,70,53
1657508333472,COGS 101A,A01,083621,Davis; Joshua Daniel,9,0,68,59
1657508339496,COGS 101B,A01,091572,Allen; Michael Gordon,12,0,65,53
1657508345519,COGS 101C,A01,083625,Delgado; Tania,17,0,35,18
1657508351542,COGS 107A,A01,083627,Boyle; Mary E. T.,13,0,60,47
1657508357566,COGS 118A,A01,083075,Gupta; Anjum,21,0,76,55
1657508363594,CSE 3,A50,083646,Miranda; Gregory Joseph,24,0,50,26
1657508369622,CSE 8A,A50,083650,Miranda; Gregory Joseph,17,1,56,39
1657508375660,CSE 11,A01,083080,Cao; Yingjun,6,15,40,34
1657508381683,CSE 12,A01,083652,Krause-Levy; Sophia Louisa,28,1,120,92
1657508387711,CSE 15L,A01,083654,Morris; Justin Loren,9,0,50,41
1657508387711,CSE 15L,A02,083655,Morris; Justin Loren,9,0,50,41
1657508393734,CSE 20,A01,083657,Tran; Khoa Dang,39,0,80,41
1657508399761,CSE 21,A01,095574,Bach; Quang Tran,22,0,48,26
1657508405802,CSE 30,A01,083084,Eldon; John,5,0,80,75
1657508405802,CSE 30,B01,095061,Bhaskar; Nishant,9,0,50,41
1657508411829,CSE 100,A01,083659,Cao; Yingjun,5,4,70,65
1657508417852,CSE 134B,A01,083661,Powell; Thomas Allan,22,0,100,78
1657508423877,CSE 140,A01,083663,Gungor; Onat,15,0,85,70
1657508429900,CSE 140L,A01,083088,Eldon; John,21,0,100,79
1657508435926,CSE 175,A01,083665,Kumar; Rakesh,3,0,25,22
1657508441951,CSE 190,A00,092507,Dubnov; Shlomo,8,0,20,12
1657508447973,ECE 45,A01,083139,Congero; Spencer William,6,0,75,69
1657508454001,ECE 65,A50,083695,Saad; Andrew S,12,0,30,18
1657508454001,ECE 65,A51,095125,Saad; Andrew S,24,0,26,2
1657508460027,ECE 109,A01,091882,Touri; Behrouz,19,0,70,51
1657508466054,ECE 180,A00,083140,Abi Samra; Nicholas Camill,1,0,30,29
1657508466054,ECE 180,B00,083141,Abi Samra; Nicholas Camill,0,0,30,30
1657508472081,MATH 10A,A01,083735,Patchell; Gregory David,2,0,30,28
1657508472081,MATH 10A,A02,083736,Patchell; Gregory David,20,0,30,10
1657508472081,MATH 10A,A03,083737,Patchell; Gregory David,16,0,30,14
1657508478109,MATH 10B,A01,083207,Lim; Seonhee,8,0,34,26
1657508478109,MATH 10B,A02,083208,Lim; Seonhee,9,0,35,26
1657508478109,MATH 10B,A03,093472,Lim; Seonhee,7,0,34,27
1657508478109,MATH 10B,B01,083739,Sinha; Shubham,12,0,30,18
1657508484138,MATH 18,A01,083743,Cinel; Cameron Alexander,7,0,30,23
1657508484138,MATH 18,A02,083744,Cinel; Cameron Alexander,17,0,30,13
1657508484138,MATH 18,A03,083745,Cinel; Cameron Alexander,9,0,30,21
1657508484138,MATH 18,B01,083748,Rideout; David Porter,5,0,37,32
1657508484138,MATH 18,B02,083749,Rideout; David Porter,5,0,36,31
1657508484138,MATH 18,B03,083750,Rideout; David Porter,3,0,37,34
1657508484138,MATH 18,B04,083751,Rideout; David Porter,6,0,36,30
1657508484138,MATH 18,B05,093473,Rideout; David Porter,6,0,36,30
1657508484138,MATH 18,B06,093474,Rideout; David Porter,6,0,36,30
1657508490168,MATH 20A,A01,083754,Zheng; Zequn,14,0,40,26
1657508496196,MATH 20B,A01,083756,Briones; Jor-el Thomas Caparas,4,0,36,32
1657508496196,MATH 20B,A02,083757,Briones; Jor-el Thomas Caparas,1,0,36,35
1657508496196,MATH 20B,A03,093475,Briones; Jor-el Thomas Caparas,2,0,36,34
1657508502221,MATH 20C,A01,083760,Briones; Jor-el Thomas Caparas,1,0,35,34
1657508502221,MATH 20C,A02,083761,Briones; Jor-el Thomas Caparas,8,0,35,27
1657508502221,MATH 20C,A03,093476,Briones; Jor-el Thomas Caparas,0,1,36,36
1657508502221,MATH 20C,B01,083762,Bach; Quang Tran,1,0,30,29
1657508508250,MATH 20D,A01,083765,Tran; Brian Kha,5,0,30,25
1657508508250,MATH 20D,A02,083766,Tran; Brian Kha,5,0,30,25
1657508508250,MATH 20D,A03,083767,Tran; Brian Kha,5,0,30,25
1657508514275,MATH 20E,A01,083771,Ganguly; Soumya,9,0,32,23
1657508514275,MATH 20E,A02,083772,Ganguly; Soumya,6,0,32,26
1657508514275,MATH 20E,B01,083773,Ciotti; Benjamin,20,0,35,15
1657508514275,MATH 20E,B02,083774,Ciotti; Benjamin,17,0,35,18
1657508520311,MATH 103A,A01,083777,Greenfeld; Be'Eri,3,0,36,33
1657508520311,MATH 103A,A02,083778,Greenfeld; Be'Eri,5,0,36,31
1657508520311,MATH 103A,A03,093561,Greenfeld; Be'Eri,5,0,36,31
1657508520311,MATH 103A,B01,083779,Greenfeld; Be'Eri,7,0,36,29
1657508520311,MATH 103A,B02,083780,Greenfeld; Be'Eri,4,0,36,32
1657508520311,MATH 103A,B03,093562,Greenfeld; Be'Eri,3,0,36,33
1657508526340,MATH 105,A01,085443,Carter; Anne Toulson,15,0,35,20
1657508526340,MATH 105,A02,093477,Carter; Anne Toulson,20,0,35,15
1657508532440,MATH 109,A01,083213,Ganzberger; Geoffrey Michael,2,0,34,32
1657508532440,MATH 109,A02,083214,Ganzberger; Geoffrey Michael,4,0,34,30
1657508532440,MATH 109,A03,093478,Ganzberger; Geoffrey Michael,2,0,34,32
1657508532440,MATH 109,B01,083215,Ganzberger; Geoffrey Michael,1,0,32,31
1657508532440,MATH 109,B02,083216,Ganzberger; Geoffrey Michael,2,0,32,30
1657508532440,MATH 109,B03,093479,Ganzberger; Geoffrey Michael,8,0,32,24
1657508538469,MATH 142A,A01,083219,Chow; Bennett,7,0,32,25
1657508538469,MATH 142A,A02,083220,Chow; Bennett,10,0,32,22
1657508538469,MATH 142A,A03,093480,Chow; Bennett,8,0,32,24
1657508538469,MATH 142A,B03,093481,Chow; Bennett,8,0,32,24
1657508538469,MATH 142A,B04,093558,Chow; Bennett,13,0,32,19
1657508538469,MATH 142A,B05,093559,Chow; Bennett,6,0,32,26
1657508544492,MATH 193A,A01,083224,Rotar; Vladimir,8,0,34,26
1657508544492,MATH 193A,A02,083225,Rotar; Vladimir,9,0,34,25
1657508544492,MATH 193A,A03,083781,Rotar; Vladimir,5,0,34,29
1657508544492,MATH 193A,A04,083782,Rotar; Vladimir,10,0,34,24
1657508544492,MATH 193A,A05,093482,Rotar; Vladimir,10,0,34,24
1657508550518,MATH 197,001,091859,McAuley; Julian John,9999,0,9999,0
1657508550518,MATH 197,002,095566,Kedlaya; Kiran S.,9997,0,9999,2
1657508550518,MATH 197,003,095567,Xiao; Ming,9999,0,9999,0
1657508550518,MATH 197,004,095571,Perols; Johan Lars,9998,0,9999,1
1657508557578,COGS 9,A01,083615,Shannon; Kyle Michael,9,0,75,66
1657508563600,COGS 11,A01,083617,Boyle; Mary E. T.,22,0,48,26
1657508569626,COGS 13,A01,083071,Bastos; Amalia Pinkusfeld,11,0,71,60
1657508575649,COGS 14A,A01,092681,Semenuks; Arturs,5,1,100,95
1657508581673,COGS 14B,A01,083073,Cheng; Tzu-Han,6,0,63,57
1657508587696,COGS 17,A01,092677,Semenuks; Arturs,6,0,81,75
1657508593718,COGS 100,A01,083619,Allen; Michael Gordon,17,0,70,53
1657508599741,COGS 101A,A01,083621,Davis; Joshua Daniel,9,0,68,59
1657508605764,COGS 101B,A01,091572,Allen; Michael Gordon,12,0,65,53
1657508611798,COGS 101C,A01,083625,Delgado; Tania,17,0,35,18
1657508617820,COGS 107A,A01,083627,Boyle; Mary E. T.,13,0,60,47
1657508623847,COGS 118A,A01,083075,Gupta; Anjum,21,0,76,55
1657508629871,CSE 3,A50,083646,Miranda; Gregory Joseph,24,0,50,26
1657508635894,CSE 8A,A50,083650,Miranda; Gregory Joseph,17,1,56,39
1657508641917,CSE 11,A01,083080,Cao; Yingjun,6,15,40,34
1657508647939,CSE 12,A01,083652,Krause-Levy; Sophia Louisa,28,1,120,92
1657508653965,CSE 15L,A01,083654,Morris; Justin Loren,9,0,50,41
1657508653965,CSE 15L,A02,083655,Morris; Justin Loren,9,0,50,41
1657508659993,CSE 20,A01,083657,Tran; Khoa Dang,39,0,80,41
1657508666018,CSE 21,A01,095574,Bach; Quang Tran,22,0,48,26
1657508672041,CSE 30,A01,083084,Eldon; John,5,0,80,75
1657508672041,CSE 30,B01,095061,Bhaskar; Nishant,9,0,50,41
1657508678067,CSE 100,A01,083659,Cao; Yingjun,5,4,70,65
1657508684090,CSE 134B,A01,083661,Powell; Thomas Allan,22,0,100,78
1657508690112,CSE 140,A01,083663,Gungor; Onat,15,0,85,70
1657508696140,CSE 140L,A01,083088,Eldon; John,21,0,100,79
1657508702163,CSE 175,A01,083665,Kumar; Rakesh,3,0,25,22
1657508708190,CSE 190,A00,092507,Dubnov; Shlomo,8,0,20,12
1657508714211,ECE 45,A01,083139,Congero; Spencer William,6,0,75,69
1657508720235,ECE 65,A50,083695,Saad; Andrew S,12,0,30,18
1657508720235,ECE 65,A51,095125,Saad; Andrew S,24,0,26,2
1657508726259,ECE 109,A01,091882,Touri; Behrouz,19,0,70,51
1657508732281,ECE 180,A00,083140,Abi Samra; Nicholas Camill,1,0,30,29
1657508732281,ECE 180,B00,083141,Abi Samra; Nicholas Camill,0,0,30,30
1657508738306,MATH 10A,A01,083735,Patchell; Gregory David,2,0,30,28
1657508738306,MATH 10A,A02,083736,Patchell; Gregory David,20,0,30,10
1657508738306,MATH 10A,A03,083737,Patchell; Gregory David,16,0,30,14
1657508744333,MATH 10B,A01,083207,Lim; Seonhee,8,0,34,26
1657508744333,MATH 10B,A02,083208,Lim; Seonhee,9,0,35,26
1657508744333,MATH 10B,A03,093472,Lim; Seonhee,7,0,34,27
1657508744333,MATH 10B,B01,083739,Sinha; Shubham,12,0,30,18
1657508750355,MATH 18,A01,083743,Cinel; Cameron Alexander,7,0,30,23
1657508750355,MATH 18,A02,083744,Cinel; Cameron Alexander,17,0,30,13
1657508750355,MATH 18,A03,083745,Cinel; Cameron Alexander,9,0,30,21
1657508750355,MATH 18,B01,083748,Rideout; David Porter,5,0,37,32
1657508750355,MATH 18,B02,083749,Rideout; David Porter,5,0,36,31
1657508750355,MATH 18,B03,083750,Rideout; David Porter,3,0,37,34
1657508750355,MATH 18,B04,083751,Rideout; David Porter,6,0,36,30
1657508750355,MATH 18,B05,093473,Rideout; David Porter,6,0,36,30
1657508750355,MATH 18,B06,093474,Rideout; David Porter,6,0,36,30
1657508756381,MATH 20A,A01,083754,Zheng; Zequn,14,0,40,26
1657508762406,MATH 20B,A01,083756,Briones; Jor-el Thomas Caparas,4,0,36,32
1657508762406,MATH 20B,A02,083757,Briones; Jor-el Thomas Caparas,1,0,36,35
1657508762406,MATH 20B,A03,093475,Briones; Jor-el Thomas Caparas,2,0,36,34
1657508768434,MATH 20C,A01,083760,Briones; Jor-el Thomas Caparas,1,0,35,34
1657508768434,MATH 20C,A02,083761,Briones; Jor-el Thomas Caparas,8,0,35,27
1657508768434,MATH 20C,A03,093476,Briones; Jor-el Thomas Caparas,0,1,36,36
1657508768434,MATH 20C,B01,083762,Bach; Quang Tran,1,0,30,29
1657508774461,MATH 20D,A01,083765,Tran; Brian Kha,5,0,30,25
1657508774461,MATH 20D,A02,083766,Tran; Brian Kha,5,0,30,25
1657508774461,MATH 20D,A03,083767,Tran; Brian Kha,5,0,30,25
1657508780490,MATH 20E,A01,083771,Ganguly; Soumya,9,0,32,23
1657508780490,MATH 20E,A02,083772,Ganguly; Soumya,6,0,32,26
1657508780490,MATH 20E,B01,083773,Ciotti; Benjamin,20,0,35,15
1657508780490,MATH 20E,B02,083774,Ciotti; Benjamin,17,0,35,18
1657508786518,MATH 103A,A01,083777,Greenfeld; Be'Eri,3,0,36,33
1657508786518,MATH 103A,A02,083778,Greenfeld; Be'Eri,5,0,36,31
1657508786518,MATH 103A,A03,093561,Greenfeld; Be'Eri,5,0,36,31
1657508786518,MATH 103A,B01,083779,Greenfeld; Be'Eri,7,0,36,29
1657508786518,MATH 103A,B02,083780,Greenfeld; Be'Eri,4,0,36,32
1657508786518,MATH 103A,B03,093562,Greenfeld; Be'Eri,3,0,36,33
1657508792542,MATH 105,A01,085443,Carter; Anne Toulson,15,0,35,20
1657508792542,MATH 105,A02,093477,Carter; Anne Toulson,20,0,35,15
1657508798564,MATH 109,A01,083213,Ganzberger; Geoffrey Michael,2,0,34,32
1657508798564,MATH 109,A02,083214,Ganzberger; Geoffrey Michael,4,0,34,30
1657508798564,MATH 109,A03,093478,Ganzberger; Geoffrey Michael,2,0,34,32
1657508798564,MATH 109,B01,083215,Ganzberger; Geoffrey Michael,1,0,32,31
1657508798564,MATH 109,B02,083216,Ganzberger; Geoffrey Michael,2,0,32,30
1657508798564,MATH 109,B03,093479,Ganzberger; Geoffrey Michael,8,0,32,24
1657508804592,MATH 142A,A01,083219,Chow; Bennett,7,0,32,25
1657508804592,MATH 142A,A02,083220,Chow; Bennett,10,0,32,22
1657508804592,MATH 142A,A03,093480,Chow; Bennett,8,0,32,24
1657508804592,MATH 142A,B03,093481,Chow; Bennett,8,0,32,24
1657508804592,MATH 142A,B04,093558,Chow; Bennett,13,0,32,19
1657508804592,MATH 142A,B05,093559,Chow; Bennett,6,0,32,26
1657508810621,MATH 193A,A01,083224,Rotar; Vladimir,8,0,34,26
1657508810621,MATH 193A,A02,083225,Rotar; Vladimir,9,0,34,25
1657508810621,MATH 193A,A03,083781,Rotar; Vladimir,5,0,34,29
1657508810621,MATH 193A,A04,083782,Rotar; Vladimir,10,0,34,24
1657508810621,MATH 193A,A05,093482,Rotar; Vladimir,10,0,34,24
1657508816643,MATH 197,001,091859,McAuley; Julian John,9999,0,9999,0
1657508816643,MATH 197,002,095566,Kedlaya; Kiran S.,9997,0,9999,2
1657508816643,MATH 197,003,095567,Xiao; Ming,9999,0,9999,0
1657508816643,MATH 197,004,095571,Perols; Johan Lars,9998,0,9999,1
1657508823694,COGS 9,A01,083615,Shannon; Kyle Michael,9,0,75,66
1657508829722,COGS 11,A01,083617,Boyle; Mary E. T.,22,0,48,26
1657508835746,COGS 13,A01,083071,Bastos; Amalia Pinkusfeld,11,0,71,60
1657508841769,COGS 14A,A01,092681,Semenuks; Arturs,5,1,100,95
1657508847794,COGS 14B,A01,083073,Cheng; Tzu-Han,6,0,63,57
1657508853820,COGS 17,A01,092677,Semenuks; Arturs,6,0,81,75
1657508859844,COGS 100,A01,083619,Allen; Michael Gordon,17,0,70,53
1657508865875,COGS 101A,A01,083621,Davis; Joshua Daniel,9,0,68,59
1657508871904,COGS 101B,A01,091572,Allen; Michael Gordon,12,0,65,53
1657508877931,COGS 101C,A01,083625,Delgado; Tania,17,0,35,18
1657508883954,COGS 107A,A01,083627,Boyle; Mary E. T.,13,0,60,47
1657508889975,COGS 118A,A01,083075,Gupta; Anjum,21,0,76,55
1657508895999,CSE 3,A50,083646,Miranda; Gregory Joseph,24,0,50,26
1657508902025,CSE 8A,A50,083650,Miranda; Gregory Joseph,17,1,56,39
1657508908057,CSE 11,A01,083080,Cao; Yingjun,6,15,40,34
1657508914078,CSE 12,A01,083652,Krause-Levy; Sophia Louisa,28,1,120,92
1657508920106,CSE 15L,A01,083654,Morris; Justin Loren,9,0,50,41
1657508920106,CSE 15L,A02,083655,Morris; Justin Loren,9,0,50,41
1657508926132,CSE 20,A01,083657,Tran; Khoa Dang,39,0,80,41
1657508932155,CSE 21,A01,095574,Bach; Quang Tran,22,0,48,26
1657508938180,CSE 30,A01,083084,Eldon; John,5,0,80,75
1657508938180,CSE 30,B01,095061,Bhaskar; Nishant,9,0,50,41
1657508944202,CSE 100,A01,083659,Cao; Yingjun,5,4,70,65
1657508950226,CSE 134B,A01,083661,Powell; Thomas Allan,22,0,100,78
1657508956255,CSE 140,A01,083663,Gungor; Onat,15,0,85,70
1657508962279,CSE 140L,A01,083088,Eldon; John,21,0,100,79
1657508968302,CSE 175,A01,083665,Kumar; Rakesh,3,0,25,22
1657508974328,CSE 190,A00,092507,Dubnov; Shlomo,8,0,20,12
1657508980354,ECE 45,A01,083139,Congero; Spencer William,6,0,75,69
1657508986381,ECE 65,A50,083695,Saad; Andrew S,12,0,30,18
1657508986381,ECE 65,A51,095125,Saad; Andrew S,24,0,26,2
1657508992412,ECE 109,A01,091882,Touri; Behrouz,19,0,70,51
1657508998438,ECE 180,A00,083140,Abi Samra; Nicholas Camill,1,0,30,29
1657508998438,ECE 180,B00,083141,Abi Samra; Nicholas Camill,0,0,30,30
1657509004462,MATH 10A,A01,083735,Patchell; Gregory David,2,0,30,28
1657509004462,MATH 10A,A02,083736,Patchell; Gregory David,20,0,30,10
1657509004462,MATH 10A,A03,083737,Patchell; Gregory David,16,0,30,14
1657509010490,MATH 10B,A01,083207,Lim; Seonhee,8,0,34,26
1657509010490,MATH 10B,A02,083208,Lim; Seonhee,9,0,35,26
1657509010490,MATH 10B,A03,093472,Lim; Seonhee,7,0,34,27
1657509010490,MATH 10B,B01,083739,Sinha; Shubham,12,0,30,18
1657509016516,MATH 18,A01,083743,Cinel; Cameron Alexander,7,0,30,23
1657509016516,MATH 18,A02,083744,Cinel; Cameron Alexander,17,0,30,13
1657509016516,MATH 18,A03,083745,Cinel; Cameron Alexander,9,0,30,21
1657509016516,MATH 18,B01,083748,Rideout; David Porter,5,0,37,32
1657509016516,MATH 18,B02,083749,Rideout; David Porter,5,0,36,31
1657509016516,MATH 18,B03,083750,Rideout; David Porter,3,0,37,34
1657509016516,MATH 18,B04,083751,Rideout; David Porter,6,0,36,30
1657509016516,MATH 18,B05,093473,Rideout; David Porter,6,0,36,30
1657509016516,MATH 18,B06,093474,Rideout; David Porter,6,0,36,30
1657509022548,MATH 20A,A01,083754,Zheng; Zequn,14,0,40,26
1657509028572,MATH 20B,A01,083756,Briones; Jor-el Thomas Caparas,4,0,36,32
1657509028572,MATH 20B,A02,083757,Briones; Jor-el Thomas Caparas,1,0,36,35
1657509028572,MATH 20B,A03,093475,Briones; Jor-el Thomas Caparas,2,0,36,34
1657509034594,MATH 20C,A01,083760,Briones; Jor-el Thomas Caparas,1,0,35,34
1657509034594,MATH 20C,A02,083761,Briones; Jor-el Thomas Caparas,8,0,35,27
1657509034594,MATH 20C,A03,093476,Briones; Jor-el Thomas Caparas,0,1,36,36
1657509034594,MATH 20C,B01,083762,Bach; Quang Tran,1,0,30,29
1657509040618,MATH 20D,A01,083765,Tran; Brian Kha,5,0,30,25
1657509040618,MATH 20D,A02,083766,Tran; Brian Kha,5,0,30,25
1657509040618,MATH 20D,A03,083767,Tran; Brian Kha,5,0,30,25
1657509046646,MATH 20E,A01,083771,Ganguly; Soumya,9,0,32,23
1657509046646,MATH 20E,A02,083772,Ganguly; Soumya,6,0,32,26
1657509046646,MATH 20E,B01,083773,Ciotti; Benjamin,20,0,35,15
1657509046646,MATH 20E,B02,083774,Ciotti; Benjamin,17,0,35,18
1657509052669,MATH 103A,A01,083777,Greenfeld; Be'Eri,3,0,36,33
1657509052669,MATH 103A,A02,083778,Greenfeld; Be'Eri,5,0,36,31
1657509052669,MATH 103A,A03,093561,Greenfeld; Be'Eri,5,0,36,31
1657509052669,MATH 103A,B01,083779,Greenfeld; Be'Eri,7,0,36,29
1657509052669,MATH 103A,B02,083780,Greenfeld; Be'Eri,4,0,36,32
1657509052669,MATH 103A,B03,093562,Greenfeld; Be'Eri,3,0,36,33
1657509058694,MATH 105,A01,085443,Carter; Anne Toulson,15,0,35,20
1657509058694,MATH 105,A02,093477,Carter; Anne Toulson,20,0,35,15
1657509064721,MATH 109,A01,083213,Ganzberger; Geoffrey Michael,2,0,34,32
1657509064721,MATH 109,A02,083214,Ganzberger; Geoffrey Michael,4,0,34,30
1657509064721,MATH 109,A03,093478,Ganzberger; Geoffrey Michael,2,0,34,32
1657509064721,MATH 109,B01,083215,Ganzberger; Geoffrey Michael,1,0,32,31
1657509064721,MATH 109,B02,083216,Ganzberger; Geoffrey Michael,2,0,32,30
1657509064721,MATH 109,B03,093479,Ganzberger; Geoffrey Michael,8,0,32,24
1657509070744,MATH 142A,A01,083219,Chow; Bennett,7,0,32,25
1657509070744,MATH 142A,A02,083220,Chow; Bennett,10,0,32,22
1657509070744,MATH 142A,A03,093480,Chow; Bennett,8,0,32,24
1657509070744,MATH 142A,B03,093481,Chow; Bennett,8,0,32,24
1657509070744,MATH 142A,B04,093558,Chow; Bennett,13,0,32,19
1657509070744,MATH 142A,B05,093559,Chow; Bennett,6,0,32,26
1657509076768,MATH 193A,A01,083224,Rotar; Vladimir,8,0,34,26
1657509076768,MATH 193A,A02,083225,Rotar; Vladimir,9,0,34,25
1657509076768,MATH 193A,A03,083781,Rotar; Vladimir,5,0,34,29
1657509076768,MATH 193A,A04,083782,Rotar; Vladimir,10,0,34,24
1657509076768,MATH 193A,A05,093482,Rotar; Vladimir,10,0,34,24
1657509082791,MATH 197,001,091859,McAuley; Julian John,9999,0,9999,0
1657509082791,MATH 197,002,095566,Kedlaya; Kiran S.,9997,0,9999,2
1657509082791,MATH 197,003,095567,Xiao; Ming,9999,0,9999,0
1657509082791,MATH 197,004,095571,Perols; Johan Lars,9998,0,9999,1
1657509089850,COGS 9,A01,083615,Shannon; Kyle Michael,9,0,75,66
1657509095874,COGS 11,A01,083617,Boyle; Mary E. T.,22,0,48,26
1657509101900,COGS 13,A01,083071,Bastos; Amalia Pinkusfeld,11,0,71,60
1657509107927,COGS 14A,A01,092681,Semenuks; Arturs,5,1,100,95
1657509113949,COGS 14B,A01,083073,Cheng; Tzu-Han,6,0,63,57
1657509119977,COGS 17,A01,092677,Semenuks; Arturs,6,0,81,75
1657509126073,COGS 100,A01,083619,Allen; Michael Gordon,17,0,70,53
1657509132097,COGS 101A,A01,083621,Davis; Joshua Daniel,9,0,68,59
1657509138133,COGS 101B,A01,091572,Allen; Michael Gordon,12,0,65,53
1657509144157,COGS 101C,A01,083625,Delgado; Tania,17,0,35,18
1657509150178,COGS 107A,A01,083627,Boyle; Mary E. T.,13,0,60,47
1657509156214,COGS 118A,A01,083075,Gupta; Anjum,21,0,76,55
1657509162238,CSE 3,A50,083646,Miranda; Gregory Joseph,24,0,50,26
1657509168261,CSE 8A,A50,083650,Miranda; Gregory Joseph,17,1,56,39
1657509174284,CSE 11,A01,083080,Cao; Yingjun,6,15,40,34
1657509180308,CSE 12,A01,083652,Krause-Levy; Sophia Louisa,28,1,120,92
1657509186330,CSE 15L,A01,083654,Morris; Justin Loren,9,0,50,41
1657509186330,CSE 15L,A02,083655,Morris; Justin Loren,9,0,50,41
1657509192353,CSE 20,A01,083657,Tran; Khoa Dang,39,0,80,41
1657509198380,CSE 21,A01,095574,Bach; Quang Tran,22,0,48,26
1657509204407,CSE 30,A01,083084,Eldon; John,5,0,80,75
1657509204407,CSE 30,B01,095061,Bhaskar; Nishant,9,0,50,41
1657509210431,CSE 100,A01,083659,Cao; Yingjun,5,4,70,65
1657509216456,CSE 134B,A01,083661,Powell; Thomas Allan,22,0,100,78
1657509222481,CSE 140,A01,083663,Gungor; Onat,15,0,85,70
1657509228504,CSE 140L,A01,083088,Eldon; John,21,0,100,79
1657509234528,CSE 175,A01,083665,Kumar; Rakesh,3,0,25,22
1657509240561,CSE 190,A00,092507,Dubnov; Shlomo,8,0,20,12
1657509246597,ECE 45,A01,083139,Congero; Spencer William,6,0,75,69
1657509252621,ECE 65,A50,083695,Saad; Andrew S,12,0,30,18
1657509252621,ECE 65,A51,095125,Saad; Andrew S,24,0,26,2
1657509258648,ECE 109,A01,091882,Touri; Behrouz,19,0,70,51
1657509264675,ECE 180,A00,083140,Abi Samra; Nicholas Camill,1,0,30,29
1657509264675,ECE 180,B00,083141,Abi Samra; Nicholas Camill,0,0,30,30
1657509270700,MATH 10A,A01,083735,Patchell; Gregory David,2,0,30,28
1657509270700,MATH 10A,A02,083736,Patchell; Gregory David,20,0,30,10
1657509270700,MATH 10A,A03,083737,Patchell; Gregory David,16,0,30,14
1657509276728,MATH 10B,A01,083207,Lim; Seonhee,8,0,34,26
1657509276728,MATH 10B,A02,083208,Lim; Seonhee,9,0,35,26
1657509276728,MATH 10B,A03,093472,Lim; Seonhee,7,0,34,27
1657509276728,MATH 10B,B01,083739,Sinha; Shubham,12,0,30,18
1657509282761,MATH 18,A01,083743,Cinel; Cameron Alexander,7,0,30,23
1657509282761,MATH 18,A02,083744,Cinel; Cameron Alexander,17,0,30,13
1657509282761,MATH 18,A03,083745,Cinel; Cameron Alexander,9,0,30,21
1657509282761,MATH 18,B01,083748,Rideout; David Porter,5,0,37,32
1657509282761,MATH 18,B02,083749,Rideout; David Porter,5,0,36,31
1657509282761,MATH 18,B03,083750,Rideout; David Porter,3,0,37,34
1657509282761,MATH 18,B04,083751,Rideout; David Porter,6,0,36,30
1657509282761,MATH 18,B05,093473,Rideout; David Porter,6,0,36,30
1657509282761,MATH 18,B06,093474,Rideout; David Porter,6,0,36,30
1657509288788,MATH 20A,A01,083754,Zheng; Zequn,14,0,40,26
1657509294809,MATH 20B,A01,083756,Briones; Jor-el Thomas Caparas,4,0,36,32
1657509294809,MATH 20B,A02,083757,Briones; Jor-el Thomas Caparas,1,0,36,35
1657509294809,MATH 20B,A03,093475,Briones; Jor-el Thomas Caparas,2,0,36,34
1657509300833,MATH 20C,A01,083760,Briones; Jor-el Thomas Caparas,1,0,35,34
1657509300833,MATH 20C,A02,083761,Briones; Jor-el Thomas Caparas,8,0,35,27
1657509300833,MATH 20C,A03,093476,Briones; Jor-el Thomas Caparas,0,1,36,36
1657509300833,MATH 20C,B01,083762,Bach; Quang Tran,1,0,30,29
1657509306860,MATH 20D,A01,083765,Tran; Brian Kha,5,0,30,25
1657509306860,MATH 20D,A02,083766,Tran; Brian Kha,5,0,30,25
1657509306860,MATH 20D,A03,083767,Tran; Brian Kha,5,0,30,25
1657509312882,MATH 20E,A01,083771,Ganguly; Soumya,9,0,32,23
1657509312882,MATH 20E,A02,083772,Ganguly; Soumya,6,0,32,26
1657509312882,MATH 20E,B01,083773,Ciotti; Benjamin,20,0,35,15
1657509312882,MATH 20E,B02,083774,Ciotti; Benjamin,17,0,35,18
1657509318907,MATH 103A,A01,083777,Greenfeld; Be'Eri,3,0,36,33
1657509318907,MATH 103A,A02,083778,Greenfeld; Be'Eri,5,0,36,31
1657509318907,MATH 103A,A03,093561,Greenfeld; Be'Eri,5,0,36,31
1657509318907,MATH 103A,B01,083779,Greenfeld; Be'Eri,7,0,36,29
1657509318907,MATH 103A,B02,083780,Greenfeld; Be'Eri,4,0,36,32
1657509318907,MATH 103A,B03,093562,Greenfeld; Be'Eri,3,0,36,33
1657509324933,MATH 105,A01,085443,Carter; Anne Toulson,15,0,35,20
1657509324933,MATH 105,A02,093477,Carter; Anne Toulson,20,0,35,15
1657509330961,MATH 109,A01,083213,Ganzberger; Geoffrey Michael,2,0,34,32
1657509330961,MATH 109,A02,083214,Ganzberger; Geoffrey Michael,4,0,34,30
1657509330961,MATH 109,A03,093478,Ganzberger; Geoffrey Michael,2,0,34,32
1657509330961,MATH 109,B01,083215,Ganzberger; Geoffrey Michael,1,0,32,31
1657509330961,MATH 109,B02,083216,Ganzberger; Geoffrey Michael,2,0,32,30
1657509330961,MATH 109,B03,093479,Ganzberger; Geoffrey Michael,8,0,32,24
1657509336984,MATH 142A,A01,083219,Chow; Bennett,7,0,32,25
1657509336984,MATH 142A,A02,083220,Chow; Bennett,10,0,32,22
1657509336984,MATH 142A,A03,093480,Chow; Bennett,8,0,32,24
1657509336984,MATH 142A,B03,093481,Chow; Bennett,8,0,32,24
1657509336984,MATH 142A,B04,093558,Chow; Bennett,13,0,32,19
1657509336984,MATH 142A,B05,093559,Chow; Bennett,6,0,32,26
1657509343010,MATH 193A,A01,083224,Rotar; Vladimir,8,0,34,26
1657509343010,MATH 193A,A02,083225,Rotar; Vladimir,9,0,34,25
1657509343010,MATH 193A,A03,083781,Rotar; Vladimir,5,0,34,29
1657509343010,MATH 193A,A04,083782,Rotar; Vladimir,10,0,34,24
1657509343010,MATH 193A,A05,093482,Rotar; Vladimir,10,0,34,24
1657509349032,MATH 197,001,091859,McAuley; Julian John,9999,0,9999,0
1657509349032,MATH 197,002,095566,Kedlaya; Kiran S.,9997,0,9999,2
1657509349032,MATH 197,003,095567,Xiao; Ming,9999,0,9999,0
1657509349032,MATH 197,004,095571,Perols; Johan Lars,9998,0,9999,1
1657509356084,COGS 9,A01,083615,Shannon; Kyle Michael,9,0,75,66
1657509362122,COGS 11,A01,083617,Boyle; Mary E. T.,22,0,48,26
1657509368144,COGS 13,A01,083071,Bastos; Amalia Pinkusfeld,11,0,71,60
1657509374171,COGS 14A,A01,092681,Semenuks; Arturs,5,1,100,95
1657509380196,COGS 14B,A01,083073,Cheng; Tzu-Han,6,0,63,57
1657509386221,COGS 17,A01,092677,Semenuks; Arturs,6,0,81,75
1657509392246,COGS 100,A01,083619,Allen; Michael Gordon,17,0,70,53
1657509398269,COGS 101A,A01,083621,Davis; Joshua Daniel,9,0,68,59
1657509404293,COGS 101B,A01,091572,Allen; Michael Gordon,12,0,65,53
1657509410316,COGS 101C,A01,083625,Delgado; Tania,17,0,35,18
1657509416339,COGS 107A,A01,083627,Boyle; Mary E. T.,13,0,60,47
1657509422366,COGS 118A,A01,083075,Gupta; Anjum,21,0,76,55
1657509428390,CSE 3,A50,083646,Miranda; Gregory Joseph,24,0,50,26
1657509434414,CSE 8A,A50,083650,Miranda; Gregory Joseph,17,1,56,39
1657509440440,CSE 11,A01,083080,Cao; Yingjun,6,15,40,34
1657509446462,CSE 12,A01,083652,Krause-Levy; Sophia Louisa,28,1,120,92
1657509452484,CSE 15L,A01,083654,Morris; Justin Loren,9,0,50,41
1657509452484,CSE 15L,A02,083655,Morris; Justin Loren,9,0,50,41
1657509458506,CSE 20,A01,083657,Tran; Khoa Dang,39,0,80,41
1657509464530,CSE 21,A01,095574,Bach; Quang Tran,22,0,48,26
1657509470552,CSE 30,A01,083084,Eldon; John,5,0,80,75
1657509470552,CSE 30,B01,095061,Bhaskar; Nishant,9,0,50,41
1657509476579,CSE 100,A01,083659,Cao; Yingjun,5,4,70,65
1657509482601,CSE 134B,A01,083661,Powell; Thomas Allan,22,0,100,78
1657509488640,CSE 140,A01,083663,Gungor; Onat,15,0,85,70
1657509494665,CSE 140L,A01,083088,Eldon; John,21,0,100,79
1657509500687,CSE 175,A01,083665,Kumar; Rakesh,3,0,25,22
1657509506713,CSE 190,A00,092507,Dubnov; Shlomo,8,0,20,12
1657509512739,ECE 45,A01,083139,Congero; Spencer William,6,0,75,69
1657509518766,ECE 65,A50,083695,Saad; Andrew S,12,0,30,18
1657509518766,ECE 65,A51,095125,Saad; Andrew S,24,0,26,2
1657509524787,ECE 109,A01,091882,Touri; Behrouz,19,0,70,51
1657509530831,ECE 180,A00,083140,Abi Samra; Nicholas Camill,1,0,30,29
1657509530831,ECE 180,B00,083141,Abi Samra; Nicholas Camill,0,0,30,30
1657509536853,MATH 10A,A01,083735,Patchell; Gregory David,2,0,30,28
1657509536853,MATH 10A,A02,083736,Patchell; Gregory David,20,0,30,10
1657509536853,MATH 10A,A03,083737,Patchell; Gregory David,16,0,30,14
1657509542878,MATH 10B,A01,083207,Lim; Seonhee,8,0,34,26
1657509542878,MATH 10B,A02,083208,Lim; Seonhee,9,0,35,26
1657509542878,MATH 10B,A03,093472,Lim; Seonhee,7,0,34,27
1657509542878,MATH 10B,B01,083739,Sinha; Shubham,12,0,30,18
1657509548908,MATH 18,A01,083743,Cinel; Cameron Alexander,7,0,30,23
1657509548908,MATH 18,A02,083744,Cinel; Cameron Alexander,17,0,30,13
1657509548908,MATH 18,A03,083745,Cinel; Cameron Alexander,9,0,30,21
1657509548908,MATH 18,B01,083748,Rideout; David Porter,5,0,37,32
1657509548908,MATH 18,B02,083749,Rideout; David Porter,5,0,36,31
1657509548908,MATH 18,B03,083750,Rideout; David Porter,3,0,37,34
1657509548908,MATH 18,B04,083751,Rideout; David Porter,6,0,36,30
1657509548908,MATH 18,B05,093473,Rideout; David Porter,6,0,36,30
1657509548908,MATH 18,B06,093474,Rideout; David Porter,6,0,36,30
1657509554932,MATH 20A,A01,083754,Zheng; Zequn,14,0,40,26
1657509560954,MATH 20B,A01,083756,Briones; Jor-el Thomas Caparas,4,0,36,32
1657509560954,MATH 20B,A02,083757,Briones; Jor-el Thomas Caparas,1,0,36,35
1657509560954,MATH 20B,A03,093475,Briones; Jor-el Thomas Caparas,2,0,36,34
1657509566978,MATH 20C,A01,083760,Briones; Jor-el Thomas Caparas,1,0,35,34
1657509566978,MATH 20C,A02,083761,Briones; Jor-el Thomas Caparas,8,0,35,27
1657509566978,MATH 20C,A03,093476,Briones; Jor-el Thomas Caparas,0,1,36,36
1657509566978,MATH 20C,B01,083762,Bach; Quang Tran,1,0,30,29
1657509573006,MATH 20D,A01,083765,Tran; Brian Kha,5,0,30,25
1657509573006,MATH 20D,A02,083766,Tran; Brian Kha,5,0,30,25
1657509573006,MATH 20D,A03,083767,Tran; Brian Kha,5,0,30,25
1657509579029,MATH 20E,A01,083771,Ganguly; Soumya,9,0,32,23
1657509579029,MATH 20E,A02,083772,Ganguly; Soumya,6,0,32,26
1657509579029,MATH 20E,B01,083773,Ciotti; Benjamin,20,0,35,15
1657509579029,MATH 20E,B02,083774,Ciotti; Benjamin,17,0,35,18
1657509585058,MATH 103A,A01,083777,Greenfeld; Be'Eri,3,0,36,33
1657509585058,MATH 103A,A02,083778,Greenfeld; Be'Eri,5,0,36,31
1657509585058,MATH 103A,A03,093561,Greenfeld; Be'Eri,5,0,36,31
1657509585058,MATH 103A,B01,083779,Greenfeld; Be'Eri,7,0,36,29
1657509585058,MATH 103A,B02,083780,Greenfeld; Be'Eri,4,0,36,32
1657509585058,MATH 103A,B03,093562,Greenfeld; Be'Eri,3,0,36,33
1657509591081,MATH 105,A01,085443,Carter; Anne Toulson,15,0,35,20
1657509591081,MATH 105,A02,093477,Carter; Anne Toulson,20,0,35,15
1657509597105,MATH 109,A01,083213,Ganzberger; Geoffrey Michael,2,0,34,32
1657509597105,MATH 109,A02,083214,Ganzberger; Geoffrey Michael,4,0,34,30
1657509597105,MATH 109,A03,093478,Ganzberger; Geoffrey Michael,2,0,34,32
1657509597105,MATH 109,B01,083215,Ganzberger; Geoffrey Michael,1,0,32,31
1657509597105,MATH 109,B02,083216,Ganzberger; Geoffrey Michael,2,0,32,30
1657509597105,MATH 109,B03,093479,Ganzberger; Geoffrey Michael,8,0,32,24
1657509603131,MATH 142A,A01,083219,Chow; Bennett,7,0,32,25
1657509603131,MATH 142A,A02,083220,Chow; Bennett,10,0,32,22
1657509603131,MATH 142A,A03,093480,Chow; Bennett,8,0,32,24
1657509603131,MATH 142A,B03,093481,Chow; Bennett,8,0,32,24
1657509603131,MATH 142A,B04,093558,Chow; Bennett,13,0,32,19
1657509603131,MATH 142A,B05,093559,Chow; Bennett,6,0,32,26
1657509609155,MATH 193A,A01,083224,Rotar; Vladimir,8,0,34,26
1657509609155,MATH 193A,A02,083225,Rotar; Vladimir,9,0,34,25
1657509609155,MATH 193A,A03,083781,Rotar; Vladimir,5,0,34,29
1657509609155,MATH 193A,A04,083782,Rotar; Vladimir,10,0,34,24
1657509609155,MATH 193A,A05,093482,Rotar; Vladimir,10,0,34,24
1657509615177,MATH 197,001,091859,McAuley; Julian John,9999,0,9999,0
1657509615177,MATH 197,002,095566,Kedlaya; Kiran S.,9997,0,9999,2
1657509615177,MATH 197,003,095567,Xiao; Ming,9999,0,9999,0
1657509615177,MATH 197,004,095571,Perols; Johan Lars,9998,0,9999,1
1657509622227,COGS 9,A01,083615,Shannon; Kyle Michael,9,0,75,66
1657509628253,COGS 11,A01,083617,Boyle; Mary E. T.,22,0,48,26
1657509634279,COGS 13,A01,083071,Bastos; Amalia Pinkusfeld,11,0,71,60
1657509640301,COGS 14A,A01,092681,Semenuks; Arturs,5,1,100,95
1657509646328,COGS 14B,A01,083073,Cheng; Tzu-Han,6,0,63,57
1657509652350,COGS 17,A01,092677,Semenuks; Arturs,6,0,81,75
1657509658376,COGS 100,A01,083619,Allen; Michael Gordon,17,0,70,53
1657509664405,COGS 101A,A01,083621,Davis; Joshua Daniel,9,0,68,59
1657509670430,COGS 101B,A01,091572,Allen; Michael Gordon,12,0,65,53
1657509676458,COGS 101C,A01,083625,Delgado; Tania,17,0,35,18
1657509682479,COGS 107A,A01,083627,Boyle; Mary E. T.,13,0,60,47
1657509688506,COGS 118A,A01,083075,Gupta; Anjum,21,0,76,55
1657509694528,CSE 3,A50,083646,Miranda; Gregory Joseph,24,0,50,26
1657509700552,CSE 8A,A50,083650,Miranda; Gregory Joseph,17,1,56,39
1657509706575,CSE 11,A01,083080,Cao; Yingjun,6,15,40,34
1657509712597,CSE 12,A01,083652,Krause-Levy; Sophia Louisa,28,1,120,92
1657509718629,CSE 15L,A01,083654,Morris; Justin Loren,9,0,50,41
1657509718629,CSE 15L,A02,083655,Morris; Justin Loren,9,0,50,41
1657509724722,CSE 20,A01,083657,Tran; Khoa Dang,39,0,80,41
1657509730744,CSE 21,A01,095574,Bach; Quang Tran,22,0,48,26
1657509736774,CSE 30,A01,083084,Eldon; John,5,0,80,75
1657509736774,CSE 30,B01,095061,Bhaskar; Nishant,9,0,50,41
1657509742801,CSE 100,A01,083659,Cao; Yingjun,5,4,70,65
1657509748827,CSE 134B,A01,083661,Powell; Thomas Allan,22,0,100,78
1657509754849,CSE 140,A01,083663,Gungor; Onat,15,0,85,70
1657509760870,CSE 140L,A01,083088,Eldon; John,21,0,100,79
1657509766896,CSE 175,A01,083665,Kumar; Rakesh,3,0,25,22
1657509772922,CSE 190,A00,092507,Dubnov; Shlomo,8,0,20,12
1657509778948,ECE 45,A01,083139,Congero; Spencer William,6,0,75,69
1657509784970,ECE 65,A50,083695,Saad; Andrew S,12,0,30,18
1657509784970,ECE 65,A51,095125,Saad; Andrew S,24,0,26,2
1657509790998,ECE 109,A01,091882,Touri; Behrouz,19,0,70,51
1657509797019,ECE 180,A00,083140,Abi Samra; Nicholas Camill,1,0,30,29
1657509797019,ECE 180,B00,083141,Abi Samra; Nicholas Camill,0,0,30,30
1657509803041,MATH 10A,A01,083735,Patchell; Gregory David,2,0,30,28
1657509803041,MATH 10A,A02,083736,Patchell; Gregory David,20,0,30,10
1657509803041,MATH 10A,A03,083737,Patchell; Gregory David,16,0,30,14
1657509809070,MATH 10B,A01,083207,Lim; Seonhee,8,0,34,26
1657509809070,MATH 10B,A02,083208,Lim; Seonhee,9,0,35,26
1657509809070,MATH 10B,A03,093472,Lim; Seonhee,7,0,34,27
1657509809070,MATH 10B,B01,083739,Sinha; Shubham,12,0,30,18
1657509815102,MATH 18,A01,083743,Cinel; Cameron Alexander,7,0,30,23
1657509815102,MATH 18,A02,083744,Cinel; Cameron Alexander,17,0,30,13
1657509815102,MATH 18,A03,083745,Cinel; Cameron Alexander,9,0,30,21
1657509815102,MATH 18,B01,083748,Rideout; David Porter,5,0,37,32
1657509815102,MATH 18,B02,083749,Rideout; David Porter,5,0,36,31
1657509815102,MATH 18,B03,083750,Rideout; David Porter,3,0,37,34
1657509815102,MATH 18,B04,083751,Rideout; David Porter,6,0,36,30
1657509815102,MATH 18,B05,093473,Rideout; David Porter,6,0,36,30
1657509815102,MATH 18,B06,093474,Rideout; David Porter,6,0,36,30
1657509821126,MATH 20A,A01,083754,Zheng; Zequn,14,0,40,26
1657509827150,MATH 20B,A01,083756,Briones; Jor-el Thomas Caparas,4,0,36,32
1657509827150,MATH 20B,A02,083757,Briones; Jor-el Thomas Caparas,1,0,36,35
1657509827150,MATH 20B,A03,093475,Briones; Jor-el Thomas Caparas,2,0,36,34
1657509833173,MATH 20C,A01,083760,Briones; Jor-el Thomas Caparas,1,0,35,34
1657509833173,MATH 20C,A02,083761,Briones; Jor-el Thomas Caparas,8,0,35,27
1657509833173,MATH 20C,A03,093476,Briones; Jor-el Thomas Caparas,0,1,36,36
1657509833173,MATH 20C,B01,083762,Bach; Quang Tran,1,0,30,29
1657509839197,MATH 20D,A01,083765,Tran; Brian Kha,5,0,30,25
1657509839197,MATH 20D,A02,083766,Tran; Brian Kha,5,0,30,25
1657509839197,MATH 20D,A03,083767,Tran; Brian Kha,5,0,30,25
1657509845224,MATH 20E,A01,083771,Ganguly; Soumya,9,0,32,23
1657509845224,MATH 20E,A02,083772,Ganguly; Soumya,6,0,32,26
1657509845224,MATH 20E,B01,083773,Ciotti; Benjamin,20,0,35,15
1657509845224,MATH 20E,B02,083774,Ciotti; Benjamin,17,0,35,18
1657509851253,MATH 103A,A01,083777,Greenfeld; Be'Eri,3,0,36,33
1657509851253,MATH 103A,A02,083778,Greenfeld; Be'Eri,5,0,36,31
1657509851253,MATH 103A,A03,093561,Greenfeld; Be'Eri,5,0,36,31
1657509851253,MATH 103A,B01,083779,Greenfeld; Be'Eri,7,0,36,29
1657509851253,MATH 103A,B02,083780,Greenfeld; Be'Eri,4,0,36,32
1657509851253,MATH 103A,B03,093562,Greenfeld; Be'Eri,3,0,36,33
1657509857280,MATH 105,A01,085443,Carter; Anne Toulson,15,0,35,20
1657509857280,MATH 105,A02,093477,Carter; Anne Toulson,20,0,35,15
1657509863309,MATH 109,A01,083213,Ganzberger; Geoffrey Michael,2,0,34,32
1657509863309,MATH 109,A02,083214,Ganzberger; Geoffrey Michael,4,0,34,30
1657509863309,MATH 109,A03,093478,Ganzberger; Geoffrey Michael,2,0,34,32
1657509863309,MATH 109,B01,083215,Ganzberger; Geoffrey Michael,1,0,32,31
1657509863309,MATH 109,B02,083216,Ganzberger; Geoffrey Michael,2,0,32,30
1657509863309,MATH 109,B03,093479,Ganzberger; Geoffrey Michael,8,0,32,24
1657509869340,MATH 142A,A01,083219,Chow; Bennett,7,0,32,25
1657509869340,MATH 142A,A02,083220,Chow; Bennett,10,0,32,22
1657509869340,MATH 142A,A03,093480,Chow; Bennett,8,0,32,24
1657509869340,MATH 142A,B03,093481,Chow; Bennett,8,0,32,24
1657509869340,MATH 142A,B04,093558,Chow; Bennett,13,0,32,19
1657509869340,MATH 142A,B05,093559,Chow; Bennett,6,0,32,26
1657509875367,MATH 193A,A01,083224,Rotar; Vladimir,8,0,34,26
1657509875367,MATH 193A,A02,083225,Rotar; Vladimir,9,0,34,25
1657509875367,MATH 193A,A03,083781,Rotar; Vladimir,5,0,34,29
1657509875367,MATH 193A,A04,083782,Rotar; Vladimir,10,0,34,24
1657509875367,MATH 193A,A05,093482,Rotar; Vladimir,10,0,34,24
1657509881389,MATH 197,001,091859,McAuley; Julian John,9999,0,9999,0
1657509881389,MATH 197,002,095566,Kedlaya; Kiran S.,9997,0,9999,2
1657509881389,MATH 197,003,095567,Xiao; Ming,9999,0,9999,0
1657509881389,MATH 197,004,095571,Perols; Johan Lars,9998,0,9999,1
1657509888446,COGS 9,A01,083615,Shannon; Kyle Michael,9,0,75,66
1657509894469,COGS 11,A01,083617,Boyle; Mary E. T.,22,0,48,26
1657509900490,COGS 13,A01,083071,Bastos; Amalia Pinkusfeld,11,0,71,60
1657509906512,COGS 14A,A01,092681,Semenuks; Arturs,5,1,100,95
1657509912534,COGS 14B,A01,083073,Cheng; Tzu-Han,6,0,63,57
1657509918557,COGS 17,A01,092677,Semenuks; Arturs,6,0,81,75
1657509924584,COGS 100,A01,083619,Allen; Michael Gordon,17,0,70,53
1657509930606,COGS 101A,A01,083621,Davis; Joshua Daniel,9,0,68,59
1657509936629,COGS 101B,A01,091572,Allen; Michael Gordon,12,0,65,53
1657509942652,COGS 101C,A01,083625,Delgado; Tania,17,0,35,18
1657509948673,COGS 107A,A01,083627,Boyle; Mary E. T.,13,0,60,47
1657509954700,COGS 118A,A01,083075,Gupta; Anjum,21,0,76,55
1657509969133,CSE 3,A50,083646,Miranda; Gregory Joseph,24,0,50,26
1657509975159,CSE 8A,A50,083650,Miranda; Gregory Joseph,17,1,56,39
1657509981186,CSE 11,A01,083080,Cao; Yingjun,6,15,40,34
1657509987212,CSE 12,A01,083652,Krause-Levy; Sophia Louisa,28,1,120,92
1657509993235,CSE 15L,A01,083654,Morris; Justin Loren,9,0,50,41
1657509993235,CSE 15L,A02,083655,Morris; Justin Loren,9,0,50,41
1657509999257,CSE 20,A01,083657,Tran; Khoa Dang,39,0,80,41
1657510005279,CSE 21,A01,095574,Bach; Quang Tran,22,0,48,26
1657510011307,CSE 30,A01,083084,Eldon; John,5,0,80,75
1657510011307,CSE 30,B01,095061,Bhaskar; Nishant,9,0,50,41
1657510017329,CSE 100,A01,083659,Cao; Yingjun,5,4,70,65
1657510023357,CSE 134B,A01,083661,Powell; Thomas Allan,22,0,100,78
1657510029382,CSE 140,A01,083663,Gungor; Onat,15,0,85,70
1657510035403,CSE 140L,A01,083088,Eldon; John,21,0,100,79
1657510041430,CSE 175,A01,083665,Kumar; Rakesh,3,0,25,22
1657510047453,CSE 190,A00,092507,Dubnov; Shlomo,8,0,20,12
1657510053480,ECE 45,A01,083139,Congero; Spencer William,6,0,75,69
1657510059515,ECE 65,A50,083695,Saad; Andrew S,12,0,30,18
1657510059515,ECE 65,A51,095125,Saad; Andrew S,24,0,26,2
1657510065538,ECE 109,A01,091882,Touri; Behrouz,19,0,70,51
1657510071565,ECE 180,A00,083140,Abi Samra; Nicholas Camill,1,0,30,29
1657510071565,ECE 180,B00,083141,Abi Samra; Nicholas Camill,0,0,30,30
1657510077587,MATH 10A,A01,083735,Patchell; Gregory David,2,0,30,28
1657510077587,MATH 10A,A02,083736,Patchell; Gregory David,20,0,30,10
1657510077587,MATH 10A,A03,083737,Patchell; Gregory David,16,0,30,14
1657510083615,MATH 10B,A01,083207,Lim; Seonhee,8,0,34,26
1657510083615,MATH 10B,A02,083208,Lim; Seonhee,9,0,35,26
1657510083615,MATH 10B,A03,093472,Lim; Seonhee,7,0,34,27
1657510083615,MATH 10B,B01,083739,Sinha; Shubham,12,0,30,18
1657510089639,MATH 18,A01,083743,Cinel; Cameron Alexander,7,0,30,23
1657510089639,MATH 18,A02,083744,Cinel; Cameron Alexander,17,0,30,13
1657510089639,MATH 18,A03,083745,Cinel; Cameron Alexander,9,0,30,21
1657510089639,MATH 18,B01,083748,Rideout; David Porter,5,0,37,32
1657510089639,MATH 18,B02,083749,Rideout; David Porter,5,0,36,31
1657510089639,MATH 18,B03,083750,Rideout; David Porter,3,0,37,34
1657510089639,MATH 18,B04,083751,Rideout; David Porter,6,0,36,30
1657510089639,MATH 18,B05,093473,Rideout; David Porter,6,0,36,30
1657510089639,MATH 18,B06,093474,Rideout; David Porter,6,0,36,30
1657510095662,MATH 20A,A01,083754,Zheng; Zequn,14,0,40,26
1657510101689,MATH 20B,A01,083756,Briones; Jor-el Thomas Caparas,4,0,36,32
1657510101689,MATH 20B,A02,083757,Briones; Jor-el Thomas Caparas,1,0,36,35
1657510101689,MATH 20B,A03,093475,Briones; Jor-el Thomas Caparas,2,0,36,34
1657510107718,MATH 20C,A01,083760,Briones; Jor-el Thomas Caparas,1,0,35,34
1657510107718,MATH 20C,A02,083761,Briones; Jor-el Thomas Caparas,8,0,35,27
1657510107718,MATH 20C,A03,093476,Briones; Jor-el Thomas Caparas,0,1,36,36
1657510107718,MATH 20C,B01,083762,Bach; Quang Tran,1,0,30,29
1657510113741,MATH 20D,A01,083765,Tran; Brian Kha,5,0,30,25
1657510113741,MATH 20D,A02,083766,Tran; Brian Kha,5,0,30,25
1657510113741,MATH 20D,A03,083767,Tran; Brian Kha,5,0,30,25
1657510119804,MATH 20E,A01,083771,Ganguly; Soumya,9,0,32,23
1657510119804,MATH 20E,A02,083772,Ganguly; Soumya,6,0,32,26
1657510119804,MATH 20E,B01,083773,Ciotti; Benjamin,20,0,35,15
1657510119804,MATH 20E,B02,083774,Ciotti; Benjamin,17,0,35,18
1657510125828,MATH 103A,A01,083777,Greenfeld; Be'Eri,3,0,36,33
1657510125828,MATH 103A,A02,083778,Greenfeld; Be'Eri,5,0,36,31
1657510125828,MATH 103A,A03,093561,Greenfeld; Be'Eri,5,0,36,31
1657510125828,MATH 103A,B01,083779,Greenfeld; Be'Eri,7,0,36,29
1657510125828,MATH 103A,B02,083780,Greenfeld; Be'Eri,4,0,36,32
1657510125828,MATH 103A,B03,093562,Greenfeld; Be'Eri,3,0,36,33
1657510131854,MATH 105,A01,085443,Carter; Anne Toulson,15,0,35,20
1657510131854,MATH 105,A02,093477,Carter; Anne Toulson,20,0,35,15
1657510137882,MATH 109,A01,083213,Ganzberger; Geoffrey Michael,2,0,34,32
1657510137882,MATH 109,A02,083214,Ganzberger; Geoffrey Michael,4,0,34,30
1657510137882,MATH 109,A03,093478,Ganzberger; Geoffrey Michael,2,0,34,32
1657510137882,MATH 109,B01,083215,Ganzberger; Geoffrey Michael,1,0,32,31
1657510137882,MATH 109,B02,083216,Ganzberger; Geoffrey Michael,2,0,32,30
1657510137882,MATH 109,B03,093479,Ganzberger; Geoffrey Michael,8,0,32,24
1657510143907,MATH 142A,A01,083219,Chow; Bennett,7,0,32,25
1657510143907,MATH 142A,A02,083220,Chow; Bennett,10,0,32,22
1657510143907,MATH 142A,A03,093480,Chow; Bennett,8,0,32,24
1657510143907,MATH 142A,B03,093481,Chow; Bennett,8,0,32,24
1657510143907,MATH 142A,B04,093558,Chow; Bennett,13,0,32,19
1657510143907,MATH 142A,B05,093559,Chow; Bennett,6,0,32,26
1657510149931,MATH 193A,A01,083224,Rotar; Vladimir,8,0,34,26
1657510149931,MATH 193A,A02,083225,Rotar; Vladimir,9,0,34,25
1657510149931,MATH 193A,A03,083781,Rotar; Vladimir,5,0,34,29
1657510149931,MATH 193A,A04,083782,Rotar; Vladimir,10,0,34,24
1657510149931,MATH 193A,A05,093482,Rotar; Vladimir,10,0,34,24
1657510155954,MATH 197,001,091859,McAuley; Julian John,9999,0,9999,0
1657510155954,MATH 197,002,095566,Kedlaya; Kiran S.,9997,0,9999,2
1657510155954,MATH 197,003,095567,Xiao; Ming,9999,0,9999,0
1657510155954,MATH 197,004,095571,Perols; Johan Lars,9998,0,9999,1
1657510163014,COGS 9,A01,083615,Shannon; Kyle Michael,9,0,75,66
1657510169048,COGS 11,A01,083617,Boyle; Mary E. T.,22,0,48,26
1657510175077,COGS 13,A01,083071,Bastos; Amalia Pinkusfeld,11,0,71,60
1657510181100,COGS 14A,A01,092681,Semenuks; Arturs,5,1,100,95
1657510187130,COGS 14B,A01,083073,Cheng; Tzu-Han,6,0,63,57
1657510193161,COGS 17,A01,092677,Semenuks; Arturs,6,0,81,75
1657510199185,COGS 100,A01,083619,Allen; Michael Gordon,17,0,70,53
1657510205236,COGS 101A,A01,083621,Davis; Joshua Daniel,9,0,68,59
1657510211259,COGS 101B,A01,091572,Allen; Michael Gordon,12,0,65,53
1657510217286,COGS 101C,A01,083625,Delgado; Tania,17,0,35,18
1657510223309,COGS 107A,A01,083627,Boyle; Mary E. T.,13,0,60,47
1657510229336,COGS 118A,A01,083075,Gupta; Anjum,21,0,76,55
1657510235363,CSE 3,A50,083646,Miranda; Gregory Joseph,24,0,50,26
1657510241386,CSE 8A,A50,083650,Miranda; Gregory Joseph,17,1,56,39
1657510247410,CSE 11,A01,083080,Cao; Yingjun,6,15,40,34
1657510253433,CSE 12,A01,083652,Krause-Levy; Sophia Louisa,28,1,120,92
1657510259469,CSE 15L,A01,083654,Morris; Justin Loren,9,0,50,41
1657510259469,CSE 15L,A02,083655,Morris; Justin Loren,9,0,50,41
1657510265493,CSE 20,A01,083657,Tran; Khoa Dang,39,0,80,41
1657510271518,CSE 21,A01,095574,Bach; Quang Tran,22,0,48,26
1657510277547,CSE 30,A01,083084,Eldon; John,5,0,80,75
1657510277547,CSE 30,B01,095061,Bhaskar; Nishant,9,0,50,41
1657510283571,CSE 100,A01,083659,Cao; Yingjun,5,4,70,65
1657510289596,CSE 134B,A01,083661,Powell; Thomas Allan,22,0,100,78
1657510295622,CSE 140,A01,083663,Gungor; Onat,15,0,85,70
1657510301649,CSE 140L,A01,083088,Eldon; John,21,0,100,79
1657510307672,CSE 175,A01,083665,Kumar; Rakesh,3,0,25,22
1657510313698,CSE 190,A00,092507,Dubnov; Shlomo,8,0,20,12
1657510319721,ECE 45,A01,083139,Congero; Spencer William,6,0,75,69
1657510325752,ECE 65,A50,083695,Saad; Andrew S,12,0,30,18
1657510325752,ECE 65,A51,095125,Saad; Andrew S,24,0,26,2
1657510331850,ECE 109,A01,091882,Touri; Behrouz,19,0,70,51
1657510337873,ECE 180,A00,083140,Abi Samra; Nicholas Camill,1,0,30,29
1657510337873,ECE 180,B00,083141,Abi Samra; Nicholas Camill,0,0,30,30
1657510343899,MATH 10A,A01,083735,Patchell; Gregory David,2,0,30,28
1657510343899,MATH 10A,A02,083736,Patchell; Gregory David,20,0,30,10
1657510343899,MATH 10A,A03,083737,Patchell; Gregory David,16,0,30,14
1657510349922,MATH 10B,A01,083207,Lim; Seonhee,8,0,34,26
1657510349922,MATH 10B,A02,083208,Lim; Seonhee,9,0,35,26
1657510349922,MATH 10B,A03,093472,Lim; Seonhee,7,0,34,27
1657510349922,MATH 10B,B01,083739,Sinha; Shubham,12,0,30,18
1657510355946,MATH 18,A01,083743,Cinel; Cameron Alexander,7,0,30,23
1657510355946,MATH 18,A02,083744,Cinel; Cameron Alexander,17,0,30,13
1657510355946,MATH 18,A03,083745,Cinel; Cameron Alexander,9,0,30,21
1657510355946,MATH 18,B01,083748,Rideout; David Porter,5,0,37,32
1657510355946,MATH 18,B02,083749,Rideout; David Porter,5,0,36,31
1657510355946,MATH 18,B03,083750,Rideout; David Porter,3,0,37,34
1657510355946,MATH 18,B04,083751,Rideout; David Porter,6,0,36,30
1657510355946,MATH 18,B05,093473,Rideout; David Porter,6,0,36,30
1657510355946,MATH 18,B06,093474,Rideout; David Porter,6,0,36,30
1657510361970,MATH 20A,A01,083754,Zheng; Zequn,14,0,40,26
1657510367994,MATH 20B,A01,083756,Briones; Jor-el Thomas Caparas,4,0,36,32
1657510367994,MATH 20B,A02,083757,Briones; Jor-el Thomas Caparas,1,0,36,35
1657510367994,MATH 20B,A03,093475,Briones; Jor-el Thomas Caparas,2,0,36,34
1657510374022,MATH 20C,A01,083760,Briones; Jor-el Thomas Caparas,1,0,35,34
1657510374022,MATH 20C,A02,083761,Briones; Jor-el Thomas Caparas,8,0,35,27
1657510374022,MATH 20C,A03,093476,Briones; Jor-el Thomas Caparas,0,1,36,36
1657510374022,MATH 20C,B01,083762,Bach; Quang Tran,1,0,30,29
1657510380047,MATH 20D,A01,083765,Tran; Brian Kha,5,0,30,25
1657510380047,MATH 20D,A02,083766,Tran; Brian Kha,5,0,30,25
1657510380047,MATH 20D,A03,083767,Tran; Brian Kha,5,0,30,25
1657510386076,MATH 20E,A01,083771,Ganguly; Soumya,9,0,32,23
1657510386076,MATH 20E,A02,083772,Ganguly; Soumya,6,0,32,26
1657510386076,MATH 20E,B01,083773,Ciotti; Benjamin,20,0,35,15
1657510386076,MATH 20E,B02,083774,Ciotti; Benjamin,17,0,35,18
1657510392098,MATH 103A,A01,083777,Greenfeld; Be'Eri,3,0,36,33
1657510392098,MATH 103A,A02,083778,Greenfeld; Be'Eri,5,0,36,31
1657510392098,MATH 103A,A03,093561,Greenfeld; Be'Eri,5,0,36,31
1657510392098,MATH 103A,B01,083779,Greenfeld; Be'Eri,7,0,36,29
1657510392098,MATH 103A,B02,083780,Greenfeld; Be'Eri,4,0,36,32
1657510392098,MATH 103A,B03,093562,Greenfeld; Be'Eri,3,0,36,33
1657510398122,MATH 105,A01,085443,Carter; Anne Toulson,15,0,35,20
1657510398122,MATH 105,A02,093477,Carter; Anne Toulson,20,0,35,15
1657510404149,MATH 109,A01,083213,Ganzberger; Geoffrey Michael,2,0,34,32
1657510404149,MATH 109,A02,083214,Ganzberger; Geoffrey Michael,4,0,34,30
1657510404149,MATH 109,A03,093478,Ganzberger; Geoffrey Michael,2,0,34,32
1657510404149,MATH 109,B01,083215,Ganzberger; Geoffrey Michael,1,0,32,31
1657510404149,MATH 109,B02,083216,Ganzberger; Geoffrey Michael,2,0,32,30
1657510404149,MATH 109,B03,093479,Ganzberger; Geoffrey Michael,8,0,32,24
1657510410174,MATH 142A,A01,083219,Chow; Bennett,7,0,32,25
1657510410174,MATH 142A,A02,083220,Chow; Bennett,10,0,32,22
1657510410174,MATH 142A,A03,093480,Chow; Bennett,8,0,32,24
1657510410174,MATH 142A,B03,093481,Chow; Bennett,8,0,32,24
1657510410174,MATH 142A,B04,093558,Chow; Bennett,13,0,32,19
1657510410174,MATH 142A,B05,093559,Chow; Bennett,6,0,32,26
1657510416206,MATH 193A,A01,083224,Rotar; Vladimir,8,0,34,26
1657510416206,MATH 193A,A02,083225,Rotar; Vladimir,9,0,34,25
1657510416206,MATH 193A,A03,083781,Rotar; Vladimir,5,0,34,29
1657510416206,MATH 193A,A04,083782,Rotar; Vladimir,10,0,34,24
1657510416206,MATH 193A,A05,093482,Rotar; Vladimir,10,0,34,24
1657510422230,MATH 197,001,091859,McAuley; Julian John,9999,0,9999,0
1657510422230,MATH 197,002,095566,Kedlaya; Kiran S.,9997,0,9999,2
1657510422230,MATH 197,003,095567,Xiao; Ming,9999,0,9999,0
1657510422230,MATH 197,004,095571,Perols; Johan Lars,9998,0,9999,1
1657510429287,COGS 9,A01,083615,Shannon; Kyle Michael,9,0,75,66
1657510435313,COGS 11,A01,083617,Boyle; Mary E. T.,22,0,48,26
1657510441353,COGS 13,A01,083071,Bastos; Amalia Pinkusfeld,11,0,71,60
1657510447382,COGS 14A,A01,092681,Semenuks; Arturs,5,1,100,95
1657510453409,COGS 14B,A01,083073,Cheng; Tzu-Han,6,0,63,57
1657510459431,COGS 17,A01,092677,Semenuks; Arturs,6,0,81,75
1657510465456,COGS 100,A01,083619,Allen; Michael Gordon,17,0,70,53
1657510471482,COGS 101A,A01,083621,Davis; Joshua Daniel,9,0,68,59
1657510477503,COGS 101B,A01,091572,Allen; Michael Gordon,12,0,65,53
1657510483527,COGS 101C,A01,083625,Delgado; Tania,17,0,35,18
1657510489549,COGS 107A,A01,083627,Boyle; Mary E. T.,13,0,60,47
1657510495574,COGS 118A,A01,083075,Gupta; Anjum,21,0,76,55
1657510501601,CSE 3,A50,083646,Miranda; Gregory Joseph,24,0,50,26
1657510507624,CSE 8A,A50,083650,Miranda; Gregory Joseph,17,1,56,39
1657510513646,CSE 11,A01,083080,Cao; Yingjun,6,15,40,34
1657510519672,CSE 12,A01,083652,Krause-Levy; Sophia Louisa,28,1,120,92
1657510525695,CSE 15L,A01,083654,Morris; Justin Loren,9,0,50,41
1657510525695,CSE 15L,A02,083655,Morris; Justin Loren,9,0,50,41
1657510531717,CSE 20,A01,083657,Tran; Khoa Dang,39,0,80,41
1657510537738,CSE 21,A01,095574,Bach; Quang Tran,22,0,48,26
1657510543761,CSE 30,A01,083084,Eldon; John,5,0,80,75
1657510543761,CSE 30,B01,095061,Bhaskar; Nishant,9,0,50,41
1657510549783,CSE 100,A01,083659,Cao; Yingjun,5,4,70,65
1657510555804,CSE 134B,A01,083661,Powell; Thomas Allan,22,0,100,78
1657510561830,CSE 140,A01,083663,Gungor; Onat,15,0,85,70
1657510567852,CSE 140L,A01,083088,Eldon; John,21,0,100,79
1657510573875,CSE 175,A01,083665,Kumar; Rakesh,3,0,25,22
1657510579897,CSE 190,A00,092507,Dubnov; Shlomo,8,0,20,12
1657510585918,ECE 45,A01,083139,Congero; Spencer William,6,0,75,69
1657510591948,ECE 65,A50,083695,Saad; Andrew S,12,0,30,18
1657510591948,ECE 65,A51,095125,Saad; Andrew S,24,0,26,2
1657510597970,ECE 109,A01,091882,Touri; Behrouz,19,0,70,51
1657510604000,ECE 180,A00,083140,Abi Samra; Nicholas Camill,1,0,30,29
1657510604000,ECE 180,B00,083141,Abi Samra; Nicholas Camill,0,0,30,30
1657510610041,MATH 10A,A01,083735,Patchell; Gregory David,2,0,30,28
1657510610041,MATH 10A,A02,083736,Patchell; Gregory David,20,0,30,10
1657510610041,MATH 10A,A03,083737,Patchell; Gregory David,16,0,30,14
1657510616064,MATH 10B,A01,083207,Lim; Seonhee,8,0,34,26
1657510616064,MATH 10B,A02,083208,Lim; Seonhee,9,0,35,26
1657510616064,MATH 10B,A03,093472,Lim; Seonhee,7,0,34,27
1657510616064,MATH 10B,B01,083739,Sinha; Shubham,12,0,30,18
1657510622095,MATH 18,A01,083743,Cinel; Cameron Alexander,7,0,30,23
1657510622095,MATH 18,A02,083744,Cinel; Cameron Alexander,17,0,30,13
1657510622095,MATH 18,A03,083745,Cinel; Cameron Alexander,9,0,30,21
1657510622095,MATH 18,B01,083748,Rideout; David Porter,5,0,37,32
1657510622095,MATH 18,B02,083749,Rideout; David Porter,5,0,36,31
1657510622095,MATH 18,B03,083750,Rideout; David Porter,3,0,37,34
1657510622095,MATH 18,B04,083751,Rideout; David Porter,6,0,36,30
1657510622095,MATH 18,B05,093473,Rideout; David Porter,6,0,36,30
1657510622095,MATH 18,B06,093474,Rideout; David Porter,6,0,36,30
1657510628129,MATH 20A,A01,083754,Zheng; Zequn,14,0,40,26
1657510634151,MATH 20B,A01,083756,Briones; Jor-el Thomas Caparas,4,0,36,32
1657510634151,MATH 20B,A02,083757,Briones; Jor-el Thomas Caparas,1,0,36,35
1657510634151,MATH 20B,A03,093475,Briones; Jor-el Thomas Caparas,2,0,36,34
1657510640179,MATH 20C,A01,083760,Briones; Jor-el Thomas Caparas,1,0,35,34
1657510640179,MATH 20C,A02,083761,Briones; Jor-el Thomas Caparas,8,0,35,27
1657510640179,MATH 20C,A03,093476,Briones; Jor-el Thomas Caparas,0,1,36,36
1657510640179,MATH 20C,B01,083762,Bach; Quang Tran,1,0,30,29
1657510646203,MATH 20D,A01,083765,Tran; Brian Kha,5,0,30,25
1657510646203,MATH 20D,A02,083766,Tran; Brian Kha,5,0,30,25
1657510646203,MATH 20D,A03,083767,Tran; Brian Kha,5,0,30,25
1657510652228,MATH 20E,A01,083771,Ganguly; Soumya,9,0,32,23
1657510652228,MATH 20E,A02,083772,Ganguly; Soumya,6,0,32,26
1657510652228,MATH 20E,B01,083773,Ciotti; Benjamin,20,0,35,15
1657510652228,MATH 20E,B02,083774,Ciotti; Benjamin,17,0,35,18
1657510658251,MATH 103A,A01,083777,Greenfeld; Be'Eri,3,0,36,33
1657510658251,MATH 103A,A02,083778,Greenfeld; Be'Eri,5,0,36,31
1657510658251,MATH 103A,A03,093561,Greenfeld; Be'Eri,5,0,36,31
1657510658251,MATH 103A,B01,083779,Greenfeld; Be'Eri,7,0,36,29
1657510658251,MATH 103A,B02,083780,Greenfeld; Be'Eri,4,0,36,32
1657510658251,MATH 103A,B03,093562,Greenfeld; Be'Eri,3,0,36,33
1657510664279,MATH 105,A01,085443,Carter; Anne Toulson,15,0,35,20
1657510664279,MATH 105,A02,093477,Carter; Anne Toulson,20,0,35,15
1657510670308,MATH 109,A01,083213,Ganzberger; Geoffrey Michael,2,0,34,32
1657510670308,MATH 109,A02,083214,Ganzberger; Geoffrey Michael,4,0,34,30
1657510670308,MATH 109,A03,093478,Ganzberger; Geoffrey Michael,2,0,34,32
1657510670308,MATH 109,B01,083215,Ganzberger; Geoffrey Michael,1,0,32,31
1657510670308,MATH 109,B02,083216,Ganzberger; Geoffrey Michael,2,0,32,30
1657510670308,MATH 109,B03,093479,Ganzberger; Geoffrey Michael,8,0,32,24
1657510676337,MATH 142A,A01,083219,Chow; Bennett,7,0,32,25
1657510676337,MATH 142A,A02,083220,Chow; Bennett,10,0,32,22
1657510676337,MATH 142A,A03,093480,Chow; Bennett,8,0,32,24
1657510676337,MATH 142A,B03,093481,Chow; Bennett,8,0,32,24
1657510676337,MATH 142A,B04,093558,Chow; Bennett,13,0,32,19
1657510676337,MATH 142A,B05,093559,Chow; Bennett,6,0,32,26
1657510682373,MATH 193A,A01,083224,Rotar; Vladimir,8,0,34,26
1657510682373,MATH 193A,A02,083225,Rotar; Vladimir,9,0,34,25
1657510682373,MATH 193A,A03,083781,Rotar; Vladimir,5,0,34,29
1657510682373,MATH 193A,A04,083782,Rotar; Vladimir,10,0,34,24
1657510682373,MATH 193A,A05,093482,Rotar; Vladimir,10,0,34,24
1657510688400,MATH 197,001,091859,McAuley; Julian John,9999,0,9999,0
1657510688400,MATH 197,002,095566,Kedlaya; Kiran S.,9997,0,9999,2
1657510688400,MATH 197,003,095567,Xiao; Ming,9999,0,9999,0
1657510688400,MATH 197,004,095571,Perols; Johan Lars,9998,0,9999,1
1657510695448,COGS 9,A01,083615,Shannon; Kyle Michael,9,0,75,66
1657510701474,COGS 11,A01,083617,Boyle; Mary E. T.,22,0,48,26
1657510707497,COGS 13,A01,083071,Bastos; Amalia Pinkusfeld,11,0,71,60
1657510713524,COGS 14A,A01,092681,Semenuks; Arturs,5,1,100,95
1657510719548,COGS 14B,A01,083073,Cheng; Tzu-Han,6,0,63,57
1657510725573,COGS 17,A01,092677,Semenuks; Arturs,6,0,81,75
1657510731599,COGS 100,A01,083619,Allen; Michael Gordon,17,0,70,53
1657510737623,COGS 101A,A01,083621,Davis; Joshua Daniel,9,0,68,59
1657510743645,COGS 101B,A01,091572,Allen; Michael Gordon,12,0,65,53
1657510749671,COGS 101C,A01,083625,Delgado; Tania,17,0,35,18
1657510755698,COGS 107A,A01,083627,Boyle; Mary E. T.,13,0,60,47
1657510761729,COGS 118A,A01,083075,Gupta; Anjum,21,0,76,55
1657510767752,CSE 3,A50,083646,Miranda; Gregory Joseph,24,0,50,26
1657510773777,CSE 8A,A50,083650,Miranda; Gregory Joseph,17,1,56,39
1657510779803,CSE 11,A01,083080,Cao; Yingjun,6,15,40,34
1657510785830,CSE 12,A01,083652,Krause-Levy; Sophia Louisa,28,1,120,92
1657510791851,CSE 15L,A01,083654,Morris; Justin Loren,9,0,50,41
1657510791851,CSE 15L,A02,083655,Morris; Justin Loren,9,0,50,41
1657510797873,CSE 20,A01,083657,Tran; Khoa Dang,39,0,80,41
1657510803903,CSE 21,A01,095574,Bach; Quang Tran,22,0,48,26
1657510809941,CSE 30,A01,083084,Eldon; John,5,0,80,75
1657510809941,CSE 30,B01,095061,Bhaskar; Nishant,9,0,50,41
1657510815968,CSE 100,A01,083659,Cao; Yingjun,5,4,70,65
1657510821991,CSE 134B,A01,083661,Powell; Thomas Allan,22,0,100,78
1657510828012,CSE 140,A01,083663,Gungor; Onat,15,0,85,70
1657510834035,CSE 140L,A01,083088,Eldon; John,21,0,100,79
1657510840056,CSE 175,A01,083665,Kumar; Rakesh,3,0,25,22
1657510846082,CSE 190,A00,092507,Dubnov; Shlomo,8,0,20,12
1657510852106,ECE 45,A01,083139,Congero; Spencer William,6,0,75,69
1657510858130,ECE 65,A50,083695,Saad; Andrew S,12,0,30,18
1657510858130,ECE 65,A51,095125,Saad; Andrew S,24,0,26,2
1657510864152,ECE 109,A01,091882,Touri; Behrouz,19,0,70,51
1657510870180,ECE 180,A00,083140,Abi Samra; Nicholas Camill,1,0,30,29
1657510870180,ECE 180,B00,083141,Abi Samra; Nicholas Camill,0,0,30,30
1657510876212,MATH 10A,A01,083735,Patchell; Gregory David,2,0,30,28
1657510876212,MATH 10A,A02,083736,Patchell; Gregory David,20,0,30,10
1657510876212,MATH 10A,A03,083737,Patchell; Gregory David,16,0,30,14
1657510882239,MATH 10B,A01,083207,Lim; Seonhee,8,0,34,26
1657510882239,MATH 10B,A02,083208,Lim; Seonhee,9,0,35,26
1657510882239,MATH 10B,A03,093472,Lim; Seonhee,7,0,34,27
1657510882239,MATH 10B,B01,083739,Sinha; Shubham,12,0,30,18
1657510888269,MATH 18,A01,083743,Cinel; Cameron Alexander,7,0,30,23
1657510888269,MATH 18,A02,083744,Cinel; Cameron Alexander,17,0,30,13
1657510888269,MATH 18,A03,083745,Cinel; Cameron Alexander,9,0,30,21
1657510888269,MATH 18,B01,083748,Rideout; David Porter,5,0,37,32
1657510888269,MATH 18,B02,083749,Rideout; David Porter,5,0,36,31
1657510888269,MATH 18,B03,083750,Rideout; David Porter,3,0,37,34
1657510888269,MATH 18,B04,083751,Rideout; David Porter,6,0,36,30
1657510888269,MATH 18,B05,093473,Rideout; David Porter,6,0,36,30
1657510888269,MATH 18,B06,093474,Rideout; David Porter,6,0,36,30
1657510894296,MATH 20A,A01,083754,Zheng; Zequn,14,0,40,26
1657510900320,MATH 20B,A01,083756,Briones; Jor-el Thomas Caparas,4,0,36,32
1657510900320,MATH 20B,A02,083757,Briones; Jor-el Thomas Caparas,1,0,36,35
1657510900320,MATH 20B,A03,093475,Briones; Jor-el Thomas Caparas,2,0,36,34
1657510906343,MATH 20C,A01,083760,Briones; Jor-el Thomas Caparas,1,0,35,34
1657510906343,MATH 20C,A02,083761,Briones; Jor-el Thomas Caparas,8,0,35,27
1657510906343,MATH 20C,A03,093476,Briones; Jor-el Thomas Caparas,0,1,36,36
1657510906343,MATH 20C,B01,083762,Bach; Quang Tran,1,0,30,29
1657510912366,MATH 20D,A01,083765,Tran; Brian Kha,5,0,30,25
1657510912366,MATH 20D,A02,083766,Tran; Brian Kha,5,0,30,25
1657510912366,MATH 20D,A03,083767,Tran; Brian Kha,5,0,30,25
1657510918393,MATH 20E,A01,083771,Ganguly; Soumya,9,0,32,23
1657510918393,MATH 20E,A02,083772,Ganguly; Soumya,6,0,32,26
1657510918393,MATH 20E,B01,083773,Ciotti; Benjamin,20,0,35,15
1657510918393,MATH 20E,B02,083774,Ciotti; Benjamin,17,0,35,18
1657510924427,MATH 103A,A01,083777,Greenfeld; Be'Eri,3,0,36,33
1657510924427,MATH 103A,A02,083778,Greenfeld; Be'Eri,5,0,36,31
1657510924427,MATH 103A,A03,093561,Greenfeld; Be'Eri,5,0,36,31
1657510924427,MATH 103A,B01,083779,Greenfeld; Be'Eri,7,0,36,29
1657510924427,MATH 103A,B02,083780,Greenfeld; Be'Eri,4,0,36,32
1657510924427,MATH 103A,B03,093562,Greenfeld; Be'Eri,3,0,36,33
1657510930526,MATH 105,A01,085443,Carter; Anne Toulson,15,0,35,20
1657510930526,MATH 105,A02,093477,Carter; Anne Toulson,20,0,35,15
1657510936549,MATH 109,A01,083213,Ganzberger; Geoffrey Michael,2,0,34,32
1657510936549,MATH 109,A02,083214,Ganzberger; Geoffrey Michael,4,0,34,30
1657510936549,MATH 109,A03,093478,Ganzberger; Geoffrey Michael,2,0,34,32
1657510936549,MATH 109,B01,083215,Ganzberger; Geoffrey Michael,1,0,32,31
1657510936549,MATH 109,B02,083216,Ganzberger; Geoffrey Michael,2,0,32,30
1657510936549,MATH 109,B03,093479,Ganzberger; Geoffrey Michael,8,0,32,24
1657510942578,MATH 142A,A01,083219,Chow; Bennett,7,0,32,25
1657510942578,MATH 142A,A02,083220,Chow; Bennett,10,0,32,22
1657510942578,MATH 142A,A03,093480,Chow; Bennett,8,0,32,24
1657510942578,MATH 142A,B03,093481,Chow; Bennett,8,0,32,24
1657510942578,MATH 142A,B04,093558,Chow; Bennett,13,0,32,19
1657510942578,MATH 142A,B05,093559,Chow; Bennett,6,0,32,26
1657510948600,MATH 193A,A01,083224,Rotar; Vladimir,8,0,34,26
1657510948600,MATH 193A,A02,083225,Rotar; Vladimir,9,0,34,25
1657510948600,MATH 193A,A03,083781,Rotar; Vladimir,5,0,34,29
1657510948600,MATH 193A,A04,083782,Rotar; Vladimir,10,0,34,24
1657510948600,MATH 193A,A05,093482,Rotar; Vladimir,10,0,34,24
1657510954625,MATH 197,001,091859,McAuley; Julian John,9999,0,9999,0
1657510954625,MATH 197,002,095566,Kedlaya; Kiran S.,9997,0,9999,2
1657510954625,MATH 197,003,095567,Xiao; Ming,9999,0,9999,0
1657510954625,MATH 197,004,095571,Perols; Johan Lars,9998,0,9999,1
1657510961686,COGS 9,A01,083615,Shannon; Kyle Michael,9,0,75,66
1657510967710,COGS 11,A01,083617,Boyle; Mary E. T.,22,0,48,26
1657510973736,COGS 13,A01,083071,Bastos; Amalia Pinkusfeld,11,0,71,60
1657510979767,COGS 14A,A01,092681,Semenuks; Arturs,5,1,100,95
1657510985788,COGS 14B,A01,083073,Cheng; Tzu-Han,6,0,63,57
1657510991818,COGS 17,A01,092677,Semenuks; Arturs,6,0,81,75
1657510997842,COGS 100,A01,083619,Allen; Michael Gordon,17,0,70,53
1657511003864,COGS 101A,A01,083621,Davis; Joshua Daniel,9,0,68,59
1657511009890,COGS 101B,A01,091572,Allen; Michael Gordon,12,0,65,53
1657511015917,COGS 101C,A01,083625,Delgado; Tania,17,0,35,18
1657511021942,COGS 107A,A01,083627,Boyle; Mary E. T.,13,0,60,47
1657511027964,COGS 118A,A01,083075,Gupta; Anjum,21,0,76,55
1657511033993,CSE 3,A50,083646,Miranda; Gregory Joseph,24,0,50,26
1657511040018,CSE 8A,A50,083650,Miranda; Gregory Joseph,17,1,56,39
1657511046044,CSE 11,A01,083080,Cao; Yingjun,6,15,40,34
1657511052068,CSE 12,A01,083652,Krause-Levy; Sophia Louisa,28,1,120,92
1657511058095,CSE 15L,A01,083654,Morris; Justin Loren,9,0,50,41
1657511058095,CSE 15L,A02,083655,Morris; Justin Loren,9,0,50,41
1657511064119,CSE 20,A01,083657,Tran; Khoa Dang,39,0,80,41
1657511070145,CSE 21,A01,095574,Bach; Quang Tran,22,0,48,26
1657511076168,CSE 30,A01,083084,Eldon; John,5,0,80,75
1657511076168,CSE 30,B01,095061,Bhaskar; Nishant,9,0,50,41
1657511082191,CSE 100,A01,083659,Cao; Yingjun,5,4,70,65
1657511088215,CSE 134B,A01,083661,Powell; Thomas Allan,22,0,100,78
1657511094238,CSE 140,A01,083663,Gungor; Onat,15,0,85,70
1657511100263,CSE 140L,A01,083088,Eldon; John,21,0,100,79
1657511106289,CSE 175,A01,083665,Kumar; Rakesh,3,0,25,22
1657511112310,CSE 190,A00,092507,Dubnov; Shlomo,8,0,20,12
1657511118340,ECE 45,A01,083139,Congero; Spencer William,6,0,75,69
1657511124366,ECE 65,A50,083695,Saad; Andrew S,12,0,30,18
1657511124366,ECE 65,A51,095125,Saad; Andrew S,24,0,26,2
1657511130388,ECE 109,A01,091882,Touri; Behrouz,19,0,70,51
1657511136414,ECE 180,A00,083140,Abi Samra; Nicholas Camill,1,0,30,29
1657511136414,ECE 180,B00,083141,Abi Samra; Nicholas Camill,0,0,30,30
1657511142438,MATH 10A,A01,083735,Patchell; Gregory David,2,0,30,28
1657511142438,MATH 10A,A02,083736,Patchell; Gregory David,20,0,30,10
1657511142438,MATH 10A,A03,083737,Patchell; Gregory David,16,0,30,14
1657511148480,MATH 10B,A01,083207,Lim; Seonhee,8,0,34,26
1657511148480,MATH 10B,A02,083208,Lim; Seonhee,9,0,35,26
1657511148480,MATH 10B,A03,093472,Lim; Seonhee,7,0,34,27
1657511148480,MATH 10B,B01,083739,Sinha; Shubham,12,0,30,18
1657511154505,MATH 18,A01,083743,Cinel; Cameron Alexander,7,0,30,23
1657511154505,MATH 18,A02,083744,Cinel; Cameron Alexander,17,0,30,13
1657511154505,MATH 18,A03,083745,Cinel; Cameron Alexander,9,0,30,21
1657511154505,MATH 18,B01,083748,Rideout; David Porter,5,0,37,32
1657511154505,MATH 18,B02,083749,Rideout; David Porter,5,0,36,31
1657511154505,MATH 18,B03,083750,Rideout; David Porter,3,0,37,34
1657511154505,MATH 18,B04,083751,Rideout; David Porter,6,0,36,30
1657511154505,MATH 18,B05,093473,Rideout; David Porter,6,0,36,30
1657511154505,MATH 18,B06,093474,Rideout; David Porter,6,0,36,30
1657511160528,MATH 20A,A01,083754,Zheng; Zequn,14,0,40,26
1657511166550,MATH 20B,A01,083756,Briones; Jor-el Thomas Caparas,4,0,36,32
1657511166550,MATH 20B,A02,083757,Briones; Jor-el Thomas Caparas,1,0,36,35
1657511166550,MATH 20B,A03,093475,Briones; Jor-el Thomas Caparas,2,0,36,34
1657511172572,MATH 20C,A01,083760,Briones; Jor-el Thomas Caparas,1,0,35,34
1657511172572,MATH 20C,A02,083761,Briones; Jor-el Thomas Caparas,8,0,35,27
1657511172572,MATH 20C,A03,093476,Briones; Jor-el Thomas Caparas,0,1,36,36
1657511172572,MATH 20C,B01,083762,Bach; Quang Tran,1,0,30,29
1657511178598,MATH 20D,A01,083765,Tran; Brian Kha,5,0,30,25
1657511178598,MATH 20D,A02,083766,Tran; Brian Kha,5,0,30,25
1657511178598,MATH 20D,A03,083767,Tran; Brian Kha,5,0,30,25
1657511184622,MATH 20E,A01,083771,Ganguly; Soumya,9,0,32,23
1657511184622,MATH 20E,A02,083772,Ganguly; Soumya,6,0,32,26
1657511184622,MATH 20E,B01,083773,Ciotti; Benjamin,20,0,35,15
1657511184622,MATH 20E,B02,083774,Ciotti; Benjamin,17,0,35,18
1657511190646,MATH 103A,A01,083777,Greenfeld; Be'Eri,3,0,36,33
1657511190646,MATH 103A,A02,083778,Greenfeld; Be'Eri,5,0,36,31
1657511190646,MATH 103A,A03,093561,Greenfeld; Be'Eri,5,0,36,31
1657511190646,MATH 103A,B01,083779,Greenfeld; Be'Eri,7,0,36,29
1657511190646,MATH 103A,B02,083780,Greenfeld; Be'Eri,4,0,36,32
1657511190646,MATH 103A,B03,093562,Greenfeld; Be'Eri,3,0,36,33
1657511196670,MATH 105,A01,085443,Carter; Anne Toulson,15,0,35,20
1657511196670,MATH 105,A02,093477,Carter; Anne Toulson,20,0,35,15
1657511202694,MATH 109,A01,083213,Ganzberger; Geoffrey Michael,2,0,34,32
1657511202694,MATH 109,A02,083214,Ganzberger; Geoffrey Michael,4,0,34,30
1657511202694,MATH 109,A03,093478,Ganzberger; Geoffrey Michael,2,0,34,32
1657511202694,MATH 109,B01,083215,Ganzberger; Geoffrey Michael,1,0,32,31
1657511202694,MATH 109,B02,083216,Ganzberger; Geoffrey Michael,2,0,32,30
1657511202694,MATH 109,B03,093479,Ganzberger; Geoffrey Michael,8,0,32,24
1657511208719,MATH 142A,A01,083219,Chow; Bennett,7,0,32,25
1657511208719,MATH 142A,A02,083220,Chow; Bennett,10,0,32,22
1657511208719,MATH 142A,A03,093480,Chow; Bennett,8,0,32,24
1657511208719,MATH 142A,B03,093481,Chow; Bennett,8,0,32,24
1657511208719,MATH 142A,B04,093558,Chow; Bennett,13,0,32,19
1657511208719,MATH 142A,B05,093559,Chow; Bennett,6,0,32,26
1657511214746,MATH 193A,A01,083224,Rotar; Vladimir,8,0,34,26
1657511214746,MATH 193A,A02,083225,Rotar; Vladimir,9,0,34,25
1657511214746,MATH 193A,A03,083781,Rotar; Vladimir,5,0,34,29
1657511214746,MATH 193A,A04,083782,Rotar; Vladimir,10,0,34,24
1657511214746,MATH 193A,A05,093482,Rotar; Vladimir,10,0,34,24
1657511220773,MATH 197,001,091859,McAuley; Julian John,9999,0,9999,0
1657511220773,MATH 197,002,095566,Kedlaya; Kiran S.,9997,0,9999,2
1657511220773,MATH 197,003,095567,Xiao; Ming,9999,0,9999,0
1657511220773,MATH 197,004,095571,Perols; Johan Lars,9998,0,9999,1
1657511227832,COGS 9,A01,083615,Shannon; Kyle Michael,9,0,75,66
1657511233856,COGS 11,A01,083617,Boyle; Mary E. T.,22,0,48,26
1657511239882,COGS 13,A01,083071,Bastos; Amalia Pinkusfeld,11,0,71,60
1657511245908,COGS 14A,A01,092681,Semenuks; Arturs,5,1,100,95
1657511251931,COGS 14B,A01,083073,Cheng; Tzu-Han,6,0,63,57
1657511257954,COGS 17,A01,092677,Semenuks; Arturs,6,0,81,75
1657511263981,COGS 100,A01,083619,Allen; Michael Gordon,17,0,70,53
1657511270008,COGS 101A,A01,083621,Davis; Joshua Daniel,9,0,68,59
1657511276036,COGS 101B,A01,091572,Allen; Michael Gordon,12,0,65,53
1657511282068,COGS 101C,A01,083625,Delgado; Tania,17,0,35,18
1657511288094,COGS 107A,A01,083627,Boyle; Mary E. T.,13,0,60,47
1657511294119,COGS 118A,A01,083075,Gupta; Anjum,21,0,76,55
1657511300142,CSE 3,A50,083646,Miranda; Gregory Joseph,24,0,50,26
1657511306164,CSE 8A,A50,083650,Miranda; Gregory Joseph,17,1,56,39
1657511312187,CSE 11,A01,083080,Cao; Yingjun,6,15,40,34
1657511318214,CSE 12,A01,083652,Krause-Levy; Sophia Louisa,28,1,120,92
1657511324243,CSE 15L,A01,083654,Morris; Justin Loren,9,0,50,41
1657511324243,CSE 15L,A02,083655,Morris; Justin Loren,9,0,50,41
1657511330272,CSE 20,A01,083657,Tran; Khoa Dang,39,0,80,41
1657511336293,CSE 21,A01,095574,Bach; Quang Tran,22,0,48,26
1657511342321,CSE 30,A01,083084,Eldon; John,5,0,80,75
1657511342321,CSE 30,B01,095061,Bhaskar; Nishant,9,0,50,41
1657511348348,CSE 100,A01,083659,Cao; Yingjun,5,4,70,65
1657511354370,CSE 134B,A01,083661,Powell; Thomas Allan,22,0,100,78
1657511360394,CSE 140,A01,083663,Gungor; Onat,15,0,85,70
1657511366418,CSE 140L,A01,083088,Eldon; John,21,0,100,79
1657511372449,CSE 175,A01,083665,Kumar; Rakesh,3,0,25,22
1657511378472,CSE 190,A00,092507,Dubnov; Shlomo,8,0,20,12
1657511384493,ECE 45,A01,083139,Congero; Spencer William,6,0,75,69
1657511390516,ECE 65,A50,083695,Saad; Andrew S,12,0,30,18
1657511390516,ECE 65,A51,095125,Saad; Andrew S,24,0,26,2
1657511396542,ECE 109,A01,091882,Touri; Behrouz,19,0,70,51
1657511402570,ECE 180,A00,083140,Abi Samra; Nicholas Camill,1,0,30,29
1657511402570,ECE 180,B00,083141,Abi Samra; Nicholas Camill,0,0,30,30
1657511408594,MATH 10A,A01,083735,Patchell; Gregory David,2,0,30,28
1657511408594,MATH 10A,A02,083736,Patchell; Gregory David,20,0,30,10
1657511408594,MATH 10A,A03,083737,Patchell; Gregory David,16,0,30,14
1657511414617,MATH 10B,A01,083207,Lim; Seonhee,8,0,34,26
1657511414617,MATH 10B,A02,083208,Lim; Seonhee,9,0,35,26
1657511414617,MATH 10B,A03,093472,Lim; Seonhee,7,0,34,27
1657511414617,MATH 10B,B01,083739,Sinha; Shubham,12,0,30,18
1657511420642,MATH 18,A01,083743,Cinel; Cameron Alexander,7,0,30,23
1657511420642,MATH 18,A02,083744,Cinel; Cameron Alexander,17,0,30,13
1657511420642,MATH 18,A03,083745,Cinel; Cameron Alexander,9,0,30,21
1657511420642,MATH 18,B01,083748,Rideout; David Porter,5,0,37,32
1657511420642,MATH 18,B02,083749,Rideout; David Porter,5,0,36,31
1657511420642,MATH 18,B03,083750,Rideout; David Porter,3,0,37,34
1657511420642,MATH 18,B04,083751,Rideout; David Porter,6,0,36,30
1657511420642,MATH 18,B05,093473,Rideout; David Porter,6,0,36,30
1657511420642,MATH 18,B06,093474,Rideout; David Porter,6,0,36,30
1657511426668,MATH 20A,A01,083754,Zheng; Zequn,14,0,40,26
1657511432692,MATH 20B,A01,083756,Briones; Jor-el Thomas Caparas,4,0,36,32
1657511432692,MATH 20B,A02,083757,Briones; Jor-el Thomas Caparas,1,0,36,35
1657511432692,MATH 20B,A03,093475,Briones; Jor-el Thomas Caparas,2,0,36,34
1657511438721,MATH 20C,A01,083760,Briones; Jor-el Thomas Caparas,1,0,35,34
1657511438721,MATH 20C,A02,083761,Briones; Jor-el Thomas Caparas,8,0,35,27
1657511438721,MATH 20C,A03,093476,Briones; Jor-el Thomas Caparas,0,1,36,36
1657511438721,MATH 20C,B01,083762,Bach; Quang Tran,1,0,30,29
1657511444749,MATH 20D,A01,083765,Tran; Brian Kha,5,0,30,25
1657511444749,MATH 20D,A02,083766,Tran; Brian Kha,5,0,30,25
1657511444749,MATH 20D,A03,083767,Tran; Brian Kha,5,0,30,25
1657511450773,MATH 20E,A01,083771,Ganguly; Soumya,9,0,32,23
1657511450773,MATH 20E,A02,083772,Ganguly; Soumya,6,0,32,26
1657511450773,MATH 20E,B01,083773,Ciotti; Benjamin,20,0,35,15
1657511450773,MATH 20E,B02,083774,Ciotti; Benjamin,17,0,35,18
1657511456803,MATH 103A,A01,083777,Greenfeld; Be'Eri,3,0,36,33
1657511456803,MATH 103A,A02,083778,Greenfeld; Be'Eri,5,0,36,31
1657511456803,MATH 103A,A03,093561,Greenfeld; Be'Eri,5,0,36,31
1657511456803,MATH 103A,B01,083779,Greenfeld; Be'Eri,7,0,36,29
1657511456803,MATH 103A,B02,083780,Greenfeld; Be'Eri,4,0,36,32
1657511456803,MATH 103A,B03,093562,Greenfeld; Be'Eri,3,0,36,33
1657511462831,MATH 105,A01,085443,Carter; Anne Toulson,15,0,35,20
1657511462831,MATH 105,A02,093477,Carter; Anne Toulson,20,0,35,15
1657511468861,MATH 109,A01,083213,Ganzberger; Geoffrey Michael,2,0,34,32
1657511468861,MATH 109,A02,083214,Ganzberger; Geoffrey Michael,4,0,34,30
1657511468861,MATH 109,A03,093478,Ganzberger; Geoffrey Michael,2,0,34,32
1657511468861,MATH 109,B01,083215,Ganzberger; Geoffrey Michael,1,0,32,31
1657511468861,MATH 109,B02,083216,Ganzberger; Geoffrey Michael,2,0,32,30
1657511468861,MATH 109,B03,093479,Ganzberger; Geoffrey Michael,8,0,32,24
1657511474890,MATH 142A,A01,083219,Chow; Bennett,7,0,32,25
1657511474890,MATH 142A,A02,083220,Chow; Bennett,10,0,32,22
1657511474890,MATH 142A,A03,093480,Chow; Bennett,8,0,32,24
1657511474890,MATH 142A,B03,093481,Chow; Bennett,8,0,32,24
1657511474890,MATH 142A,B04,093558,Chow; Bennett,13,0,32,19
1657511474890,MATH 142A,B05,093559,Chow; Bennett,6,0,32,26
1657511480913,MATH 193A,A01,083224,Rotar; Vladimir,8,0,34,26
1657511480913,MATH 193A,A02,083225,Rotar; Vladimir,9,0,34,25
1657511480913,MATH 193A,A03,083781,Rotar; Vladimir,5,0,34,29
1657511480913,MATH 193A,A04,083782,Rotar; Vladimir,10,0,34,24
1657511480913,MATH 193A,A05,093482,Rotar; Vladimir,10,0,34,24
1657511486940,MATH 197,001,091859,McAuley; Julian John,9999,0,9999,0
1657511486940,MATH 197,002,095566,Kedlaya; Kiran S.,9997,0,9999,2
1657511486940,MATH 197,003,095567,Xiao; Ming,9999,0,9999,0
1657511486940,MATH 197,004,095571,Perols; Johan Lars,9998,0,9999,1
1657511493997,COGS 9,A01,083615,Shannon; Kyle Michael,9,0,75,66
1657511500022,COGS 11,A01,083617,Boyle; Mary E. T.,22,0,48,26
1657511506044,COGS 13,A01,083071,Bastos; Amalia Pinkusfeld,11,0,71,60
1657511512066,COGS 14A,A01,092681,Semenuks; Arturs,5,1,100,95
1657511518092,COGS 14B,A01,083073,Cheng; Tzu-Han,6,0,63,57
1657511524193,COGS 17,A01,092677,Semenuks; Arturs,6,0,81,75
1657511530221,COGS 100,A01,083619,Allen; Michael Gordon,17,0,70,53
1657511536245,COGS 101A,A01,083621,Davis; Joshua Daniel,9,0,68,59
1657511542272,COGS 101B,A01,091572,Allen; Michael Gordon,12,0,65,53
1657511548302,COGS 101C,A01,083625,Delgado; Tania,17,0,35,18
1657511554331,COGS 107A,A01,083627,Boyle; Mary E. T.,13,0,60,47
1657511560357,COGS 118A,A01,083075,Gupta; Anjum,21,0,76,55
1657511566381,CSE 3,A50,083646,Miranda; Gregory Joseph,24,0,50,26
1657511572405,CSE 8A,A50,083650,Miranda; Gregory Joseph,17,1,56,39
1657511578428,CSE 11,A01,083080,Cao; Yingjun,6,15,40,34
1657511584451,CSE 12,A01,083652,Krause-Levy; Sophia Louisa,28,1,120,92
1657511590481,CSE 15L,A01,083654,Morris; Justin Loren,9,0,50,41
1657511590481,CSE 15L,A02,083655,Morris; Justin Loren,9,0,50,41
1657511596511,CSE 20,A01,083657,Tran; Khoa Dang,39,0,80,41
1657511602544,CSE 21,A01,095574,Bach; Quang Tran,22,0,48,26
1657511608571,CSE 30,A01,083084,Eldon; John,5,0,80,75
1657511608571,CSE 30,B01,095061,Bhaskar; Nishant,9,0,50,41
1657511614593,CSE 100,A01,083659,Cao; Yingjun,5,4,70,65
1657511620616,CSE 134B,A01,083661,Powell; Thomas Allan,22,0,100,78
1657511626644,CSE 140,A01,083663,Gungor; Onat,15,0,85,70
1657511632668,CSE 140L,A01,083088,Eldon; John,21,0,100,79
1657511638691,CSE 175,A01,083665,Kumar; Rakesh,3,0,25,22
1657511644712,CSE 190,A00,092507,Dubnov; Shlomo,8,0,20,12
1657511650734,ECE 45,A01,083139,Congero; Spencer William,6,0,75,69
1657511656758,ECE 65,A50,083695,Saad; Andrew S,12,0,30,18
1657511656758,ECE 65,A51,095125,Saad; Andrew S,24,0,26,2
1657511662783,ECE 109,A01,091882,Touri; Behrouz,19,0,70,51
1657511668805,ECE 180,A00,083140,Abi Samra; Nicholas Camill,1,0,30,29
1657511668805,ECE 180,B00,083141,Abi Samra; Nicholas Camill,0,0,30,30
1657511674837,MATH 10A,A01,083735,Patchell; Gregory David,2,0,30,28
1657511674837,MATH 10A,A02,083736,Patchell; Gregory David,20,0,30,10
1657511674837,MATH 10A,A03,083737,Patchell; Gregory David,16,0,30,14
1657511680866,MATH 10B,A01,083207,Lim; Seonhee,8,0,34,26
1657511680866,MATH 10B,A02,083208,Lim; Seonhee,9,0,35,26
1657511680866,MATH 10B,A03,093472,Lim; Seonhee,7,0,34,27
1657511680866,MATH 10B,B01,083739,Sinha; Shubham,12,0,30,18
1657511686889,MATH 18,A01,083743,Cinel; Cameron Alexander,7,0,30,23
1657511686889,MATH 18,A02,083744,Cinel; Cameron Alexander,17,0,30,13
1657511686889,MATH 18,A03,083745,Cinel; Cameron Alexander,9,0,30,21
1657511686889,MATH 18,B01,083748,Rideout; David Porter,5,0,37,32
1657511686889,MATH 18,B02,083749,Rideout; David Porter,5,0,36,31
1657511686889,MATH 18,B03,083750,Rideout; David Porter,3,0,37,34
1657511686889,MATH 18,B04,083751,Rideout; David Porter,6,0,36,30
1657511686889,MATH 18,B05,093473,Rideout; David Porter,6,0,36,30
1657511686889,MATH 18,B06,093474,Rideout; David Porter,6,0,36,30
1657511692912,MATH 20A,A01,083754,Zheng; Zequn,14,0,40,26
1657511698939,MATH 20B,A01,083756,Briones; Jor-el Thomas Caparas,4,0,36,32
1657511698939,MATH 20B,A02,083757,Briones; Jor-el Thomas Caparas,1,0,36,35
1657511698939,MATH 20B,A03,093475,Briones; Jor-el Thomas Caparas,2,0,36,34
1657511704962,MATH 20C,A01,083760,Briones; Jor-el Thomas Caparas,1,0,35,34
1657511704962,MATH 20C,A02,083761,Briones; Jor-el Thomas Caparas,8,0,35,27
1657511704962,MATH 20C,A03,093476,Briones; Jor-el Thomas Caparas,0,1,36,36
1657511704962,MATH 20C,B01,083762,Bach; Quang Tran,1,0,30,29
1657511710990,MATH 20D,A01,083765,Tran; Brian Kha,5,0,30,25
1657511710990,MATH 20D,A02,083766,Tran; Brian Kha,5,0,30,25
1657511710990,MATH 20D,A03,083767,Tran; Brian Kha,5,0,30,25
1657511717014,MATH 20E,A01,083771,Ganguly; Soumya,9,0,32,23
1657511717014,MATH 20E,A02,083772,Ganguly; Soumya,6,0,32,26
1657511717014,MATH 20E,B01,083773,Ciotti; Benjamin,20,0,35,15
1657511717014,MATH 20E,B02,083774,Ciotti; Benjamin,17,0,35,18
1657511723038,MATH 103A,A01,083777,Greenfeld; Be'Eri,3,0,36,33
1657511723038,MATH 103A,A02,083778,Greenfeld; Be'Eri,5,0,36,31
1657511723038,MATH 103A,A03,093561,Greenfeld; Be'Eri,5,0,36,31
1657511723038,MATH 103A,B01,083779,Greenfeld; Be'Eri,7,0,36,29
1657511723038,MATH 103A,B02,083780,Greenfeld; Be'Eri,4,0,36,32
1657511723038,MATH 103A,B03,093562,Greenfeld; Be'Eri,3,0,36,33
1657511729065,MATH 105,A01,085443,Carter; Anne Toulson,15,0,35,20
1657511729065,MATH 105,A02,093477,Carter; Anne Toulson,20,0,35,15
1657511735096,MATH 109,A01,083213,Ganzberger; Geoffrey Michael,2,0,34,32
1657511735096,MATH 109,A02,083214,Ganzberger; Geoffrey Michael,4,0,34,30
1657511735096,MATH 109,A03,093478,Ganzberger; Geoffrey Michael,2,0,34,32
1657511735096,MATH 109,B01,083215,Ganzberger; Geoffrey Michael,1,0,32,31
1657511735096,MATH 109,B02,083216,Ganzberger; Geoffrey Michael,2,0,32,30
1657511735096,MATH 109,B03,093479,Ganzberger; Geoffrey Michael,8,0,32,24
1657511741120,MATH 142A,A01,083219,Chow; Bennett,7,0,32,25
1657511741120,MATH 142A,A02,083220,Chow; Bennett,10,0,32,22
1657511741120,MATH 142A,A03,093480,Chow; Bennett,8,0,32,24
1657511741120,MATH 142A,B03,093481,Chow; Bennett,8,0,32,24
1657511741120,MATH 142A,B04,093558,Chow; Bennett,13,0,32,19
1657511741120,MATH 142A,B05,093559,Chow; Bennett,6,0,32,26
1657511747147,MATH 193A,A01,083224,Rotar; Vladimir,8,0,34,26
1657511747147,MATH 193A,A02,083225,Rotar; Vladimir,9,0,34,25
1657511747147,MATH 193A,A03,083781,Rotar; Vladimir,5,0,34,29
1657511747147,MATH 193A,A04,083782,Rotar; Vladimir,10,0,34,24
1657511747147,MATH 193A,A05,093482,Rotar; Vladimir,10,0,34,24
1657511753169,MATH 197,001,091859,McAuley; Julian John,9999,0,9999,0
1657511753169,MATH 197,002,095566,Kedlaya; Kiran S.,9997,0,9999,2
1657511753169,MATH 197,003,095567,Xiao; Ming,9999,0,9999,0
1657511753169,MATH 197,004,095571,Perols; Johan Lars,9998,0,9999,1
1657511760231,COGS 9,A01,083615,Shannon; Kyle Michael,9,0,75,66
1657511766271,COGS 11,A01,083617,Boyle; Mary E. T.,22,0,48,26
1657511772293,COGS 13,A01,083071,Bastos; Amalia Pinkusfeld,11,0,71,60
1657511778317,COGS 14A,A01,092681,Semenuks; Arturs,5,1,100,95
1657511784345,COGS 14B,A01,083073,Cheng; Tzu-Han,6,0,63,57
1657511790367,COGS 17,A01,092677,Semenuks; Arturs,6,0,81,75
1657511796390,COGS 100,A01,083619,Allen; Michael Gordon,17,0,70,53
1657511802418,COGS 101A,A01,083621,Davis; Joshua Daniel,9,0,68,59
1657511808445,COGS 101B,A01,091572,Allen; Michael Gordon,12,0,65,53
1657511814467,COGS 101C,A01,083625,Delgado; Tania,17,0,35,18
1657511820493,COGS 107A,A01,083627,Boyle; Mary E. T.,13,0,60,47
1657511826514,COGS 118A,A01,083075,Gupta; Anjum,21,0,76,55
1657511832538,CSE 3,A50,083646,Miranda; Gregory Joseph,24,0,50,26
1657511838563,CSE 8A,A50,083650,Miranda; Gregory Joseph,17,1,56,39
1657511844589,CSE 11,A01,083080,Cao; Yingjun,6,15,40,34
1657511850611,CSE 12,A01,083652,Krause-Levy; Sophia Louisa,28,1,120,92
1657511856638,CSE 15L,A01,083654,Morris; Justin Loren,9,0,50,41
1657511856638,CSE 15L,A02,083655,Morris; Justin Loren,9,0,50,41
1657511862661,CSE 20,A01,083657,Tran; Khoa Dang,39,0,80,41
1657511868685,CSE 21,A01,095574,Bach; Quang Tran,22,0,48,26
1657511874709,CSE 30,A01,083084,Eldon; John,5,0,80,75
1657511874709,CSE 30,B01,095061,Bhaskar; Nishant,9,0,50,41
1657511880731,CSE 100,A01,083659,Cao; Yingjun,5,4,70,65
1657511886754,CSE 134B,A01,083661,Powell; Thomas Allan,22,0,100,78
1657511892778,CSE 140,A01,083663,Gungor; Onat,15,0,85,70
1657511898800,CSE 140L,A01,083088,Eldon; John,21,0,100,79
1657511904822,CSE 175,A01,083665,Kumar; Rakesh,3,0,25,22
1657511910848,CSE 190,A00,092507,Dubnov; Shlomo,8,0,20,12
1657511916871,ECE 45,A01,083139,Congero; Spencer William,6,0,75,69
1657511922902,ECE 65,A50,083695,Saad; Andrew S,12,0,30,18
1657511922902,ECE 65,A51,095125,Saad; Andrew S,24,0,26,2
1657511928929,ECE 109,A01,091882,Touri; Behrouz,19,0,70,51
1657511934952,ECE 180,A00,083140,Abi Samra; Nicholas Camill,1,0,30,29
1657511934952,ECE 180,B00,083141,Abi Samra; Nicholas Camill,0,0,30,30
1657511940978,MATH 10A,A01,083735,Patchell; Gregory David,2,0,30,28
1657511940978,MATH 10A,A02,083736,Patchell; Gregory David,20,0,30,10
1657511940978,MATH 10A,A03,083737,Patchell; Gregory David,16,0,30,14
1657511947013,MATH 10B,A01,083207,Lim; Seonhee,8,0,34,26
1657511947013,MATH 10B,A02,083208,Lim; Seonhee,9,0,35,26
1657511947013,MATH 10B,A03,093472,Lim; Seonhee,7,0,34,27
1657511947013,MATH 10B,B01,083739,Sinha; Shubham,12,0,30,18
1657511953036,MATH 18,A01,083743,Cinel; Cameron Alexander,7,0,30,23
1657511953036,MATH 18,A02,083744,Cinel; Cameron Alexander,17,0,30,13
1657511953036,MATH 18,A03,083745,Cinel; Cameron Alexander,9,0,30,21
1657511953036,MATH 18,B01,083748,Rideout; David Porter,5,0,37,32
1657511953036,MATH 18,B02,083749,Rideout; David Porter,5,0,36,31
1657511953036,MATH 18,B03,083750,Rideout; David Porter,3,0,37,34
1657511953036,MATH 18,B04,083751,Rideout; David Porter,6,0,36,30
1657511953036,MATH 18,B05,093473,Rideout; David Porter,6,0,36,30
1657511953036,MATH 18,B06,093474,Rideout; David Porter,6,0,36,30
1657511959058,MATH 20A,A01,083754,Zheng; Zequn,14,0,40,26
1657511965085,MATH 20B,A01,083756,Briones; Jor-el Thomas Caparas,4,0,36,32
1657511965085,MATH 20B,A02,083757,Briones; Jor-el Thomas Caparas,1,0,36,35
1657511965085,MATH 20B,A03,093475,Briones; Jor-el Thomas Caparas,2,0,36,34
1657511971107,MATH 20C,A01,083760,Briones; Jor-el Thomas Caparas,1,0,35,34
1657511971107,MATH 20C,A02,083761,Briones; Jor-el Thomas Caparas,8,0,35,27
1657511971107,MATH 20C,A03,093476,Briones; Jor-el Thomas Caparas,0,1,36,36
1657511971107,MATH 20C,B01,083762,Bach; Quang Tran,1,0,30,29
1657511977134,MATH 20D,A01,083765,Tran; Brian Kha,5,0,30,25
1657511977134,MATH 20D,A02,083766,Tran; Brian Kha,5,0,30,25
1657511977134,MATH 20D,A03,083767,Tran; Brian Kha,5,0,30,25
1657511983158,MATH 20E,A01,083771,Ganguly; Soumya,9,0,32,23
1657511983158,MATH 20E,A02,083772,Ganguly; Soumya,6,0,32,26
1657511983158,MATH 20E,B01,083773,Ciotti; Benjamin,20,0,35,15
1657511983158,MATH 20E,B02,083774,Ciotti; Benjamin,17,0,35,18
1657511989182,MATH 103A,A01,083777,Greenfeld; Be'Eri,3,0,36,33
1657511989182,MATH 103A,A02,083778,Greenfeld; Be'Eri,5,0,36,31
1657511989182,MATH 103A,A03,093561,Greenfeld; Be'Eri,5,0,36,31
1657511989182,MATH 103A,B01,083779,Greenfeld; Be'Eri,7,0,36,29
1657511989182,MATH 103A,B02,083780,Greenfeld; Be'Eri,4,0,36,32
1657511989182,MATH 103A,B03,093562,Greenfeld; Be'Eri,3,0,36,33
1657511995205,MATH 105,A01,085443,Carter; Anne Toulson,15,0,35,20
1657511995205,MATH 105,A02,093477,Carter; Anne Toulson,20,0,35,15
1657512001228,MATH 109,A01,083213,Ganzberger; Geoffrey Michael,2,0,34,32
1657512001228,MATH 109,A02,083214,Ganzberger; Geoffrey Michael,4,0,34,30
1657512001228,MATH 109,A03,093478,Ganzberger; Geoffrey Michael,2,0,34,32
1657512001228,MATH 109,B01,083215,Ganzberger; Geoffrey Michael,1,0,32,31
1657512001228,MATH 109,B02,083216,Ganzberger; Geoffrey Michael,2,0,32,30
1657512001228,MATH 109,B03,093479,Ganzberger; Geoffrey Michael,8,0,32,24
1657512007257,MATH 142A,A01,083219,Chow; Bennett,7,0,32,25
1657512007257,MATH 142A,A02,083220,Chow; Bennett,10,0,32,22
1657512007257,MATH 142A,A03,093480,Chow; Bennett,8,0,32,24
1657512007257,MATH 142A,B03,093481,Chow; Bennett,8,0,32,24
1657512007257,MATH 142A,B04,093558,Chow; Bennett,13,0,32,19
1657512007257,MATH 142A,B05,093559,Chow; Bennett,6,0,32,26
1657512013280,MATH 193A,A01,083224,Rotar; Vladimir,8,0,34,26
1657512013280,MATH 193A,A02,083225,Rotar; Vladimir,9,0,34,25
1657512013280,MATH 193A,A03,083781,Rotar; Vladimir,5,0,34,29
1657512013280,MATH 193A,A04,083782,Rotar; Vladimir,10,0,34,24
1657512013280,MATH 193A,A05,093482,Rotar; Vladimir,10,0,34,24
1657512019310,MATH 197,001,091859,McAuley; Julian John,9999,0,9999,0
1657512019310,MATH 197,002,095566,Kedlaya; Kiran S.,9997,0,9999,2
1657512019310,MATH 197,003,095567,Xiao; Ming,9999,0,9999,0
1657512019310,MATH 197,004,095571,Perols; Johan Lars,9998,0,9999,1
1657512026378,COGS 9,A01,083615,Shannon; Kyle Michael,9,0,75,66
1657512032402,COGS 11,A01,083617,Boyle; Mary E. T.,22,0,48,26
1657512038428,COGS 13,A01,083071,Bastos; Amalia Pinkusfeld,11,0,71,60
1657512044450,COGS 14A,A01,092681,Semenuks; Arturs,5,1,100,95
1657512050473,COGS 14B,A01,083073,Cheng; Tzu-Han,6,0,63,57
1657512056499,COGS 17,A01,092677,Semenuks; Arturs,6,0,81,75
1657512062527,COGS 100,A01,083619,Allen; Michael Gordon,17,0,70,53
1657512068549,COGS 101A,A01,083621,Davis; Joshua Daniel,9,0,68,59
1657512074572,COGS 101B,A01,091572,Allen; Michael Gordon,12,0,65,53
1657512080596,COGS 101C,A01,083625,Delgado; Tania,17,0,35,18
1657512086618,COGS 107A,A01,083627,Boyle; Mary E. T.,13,0,60,47
1657512092645,COGS 118A,A01,083075,Gupta; Anjum,21,0,76,55
1657512098668,CSE 3,A50,083646,Miranda; Gregory Joseph,24,0,50,26
1657512104691,CSE 8A,A50,083650,Miranda; Gregory Joseph,17,1,56,39
1657512110720,CSE 11,A01,083080,Cao; Yingjun,6,15,40,34
1657512116743,CSE 12,A01,083652,Krause-Levy; Sophia Louisa,28,1,120,92
1657512122846,CSE 15L,A01,083654,Morris; Justin Loren,9,0,50,41
1657512122846,CSE 15L,A02,083655,Morris; Justin Loren,9,0,50,41
1657512128873,CSE 20,A01,083657,Tran; Khoa Dang,39,0,80,41
1657512134902,CSE 21,A01,095574,Bach; Quang Tran,22,0,48,26
1657512140926,CSE 30,A01,083084,Eldon; John,5,0,80,75
1657512140926,CSE 30,B01,095061,Bhaskar; Nishant,9,0,50,41
1657512146951,CSE 100,A01,083659,Cao; Yingjun,5,4,70,65
1657512152976,CSE 134B,A01,083661,Powell; Thomas Allan,22,0,100,78
1657512159000,CSE 140,A01,083663,Gungor; Onat,15,0,85,70
1657512165031,CSE 140L,A01,083088,Eldon; John,21,0,100,79
1657512171078,CSE 175,A01,083665,Kumar; Rakesh,3,0,25,22
1657512177105,CSE 190,A00,092507,Dubnov; Shlomo,8,0,20,12
1657512183139,ECE 45,A01,083139,Congero; Spencer William,6,0,75,69
1657512189162,ECE 65,A50,083695,Saad; Andrew S,12,0,30,18
1657512189162,ECE 65,A51,095125,Saad; Andrew S,24,0,26,2
1657512195193,ECE 109,A01,091882,Touri; Behrouz,19,0,70,51
1657512201225,ECE 180,A00,083140,Abi Samra; Nicholas Camill,1,0,30,29
1657512201225,ECE 180,B00,083141,Abi Samra; Nicholas Camill,0,0,30,30
1657512207258,MATH 10A,A01,083735,Patchell; Gregory David,2,0,30,28
1657512207258,MATH 10A,A02,083736,Patchell; Gregory David,20,0,30,10
1657512207258,MATH 10A,A03,083737,Patchell; Gregory David,16,0,30,14
1657512213282,MATH 10B,A01,083207,Lim; Seonhee,8,0,34,26
1657512213282,MATH 10B,A02,083208,Lim; Seonhee,9,0,35,26
1657512213282,MATH 10B,A03,093472,Lim; Seonhee,7,0,34,27
1657512213282,MATH 10B,B01,083739,Sinha; Shubham,12,0,30,18
1657512219308,MATH 18,A01,083743,Cinel; Cameron Alexander,7,0,30,23
1657512219308,MATH 18,A02,083744,Cinel; Cameron Alexander,17,0,30,13
1657512219308,MATH 18,A03,083745,Cinel; Cameron Alexander,9,0,30,21
1657512219308,MATH 18,B01,083748,Rideout; David Porter,5,0,37,32
1657512219308,MATH 18,B02,083749,Rideout; David Porter,5,0,36,31
1657512219308,MATH 18,B03,083750,Rideout; David Porter,3,0,37,34
1657512219308,MATH 18,B04,083751,Rideout; David Porter,6,0,36,30
1657512219308,MATH 18,B05,093473,Rideout; David Porter,6,0,36,30
1657512219308,MATH 18,B06,093474,Rideout; David Porter,6,0,36,30
1657512225331,MATH 20A,A01,083754,Zheng; Zequn,14,0,40,26
1657512231359,MATH 20B,A01,083756,Briones; Jor-el Thomas Caparas,4,0,36,32
1657512231359,MATH 20B,A02,083757,Briones; Jor-el Thomas Caparas,1,0,36,35
1657512231359,MATH 20B,A03,093475,Briones; Jor-el Thomas Caparas,2,0,36,34
1657512237386,MATH 20C,A01,083760,Briones; Jor-el Thomas Caparas,1,0,35,34
1657512237386,MATH 20C,A02,083761,Briones; Jor-el Thomas Caparas,8,0,35,27
1657512237386,MATH 20C,A03,093476,Briones; Jor-el Thomas Caparas,0,1,36,36
1657512237386,MATH 20C,B01,083762,Bach; Quang Tran,1,0,30,29
1657512243414,MATH 20D,A01,083765,Tran; Brian Kha,5,0,30,25
1657512243414,MATH 20D,A02,083766,Tran; Brian Kha,5,0,30,25
1657512243414,MATH 20D,A03,083767,Tran; Brian Kha,5,0,30,25
1657512249443,MATH 20E,A01,083771,Ganguly; Soumya,9,0,32,23
1657512249443,MATH 20E,A02,083772,Ganguly; Soumya,6,0,32,26
1657512249443,MATH 20E,B01,083773,Ciotti; Benjamin,20,0,35,15
1657512249443,MATH 20E,B02,083774,Ciotti; Benjamin,17,0,35,18
1657512255465,MATH 103A,A01,083777,Greenfeld; Be'Eri,3,0,36,33
1657512255465,MATH 103A,A02,083778,Greenfeld; Be'Eri,5,0,36,31
1657512255465,MATH 103A,A03,093561,Greenfeld; Be'Eri,5,0,36,31
1657512255465,MATH 103A,B01,083779,Greenfeld; Be'Eri,7,0,36,29
1657512255465,MATH 103A,B02,083780,Greenfeld; Be'Eri,4,0,36,32
1657512255465,MATH 103A,B03,093562,Greenfeld; Be'Eri,3,0,36,33
1657512261492,MATH 105,A01,085443,Carter; Anne Toulson,15,0,35,20
1657512261492,MATH 105,A02,093477,Carter; Anne Toulson,20,0,35,15
1657512267531,MATH 109,A01,083213,Ganzberger; Geoffrey Michael,2,0,34,32
1657512267531,MATH 109,A02,083214,Ganzberger; Geoffrey Michael,4,0,34,30
1657512267531,MATH 109,A03,093478,Ganzberger; Geoffrey Michael,2,0,34,32
1657512267531,MATH 109,B01,083215,Ganzberger; Geoffrey Michael,1,0,32,31
1657512267531,MATH 109,B02,083216,Ganzberger; Geoffrey Michael,2,0,32,30
1657512267531,MATH 109,B03,093479,Ganzberger; Geoffrey Michael,8,0,32,24
1657512273555,MATH 142A,A01,083219,Chow; Bennett,7,0,32,25
1657512273555,MATH 142A,A02,083220,Chow; Bennett,10,0,32,22
1657512273555,MATH 142A,A03,093480,Chow; Bennett,8,0,32,24
1657512273555,MATH 142A,B03,093481,Chow; Bennett,8,0,32,24
1657512273555,MATH 142A,B04,093558,Chow; Bennett,13,0,32,19
1657512273555,MATH 142A,B05,093559,Chow; Bennett,6,0,32,26
1657512279583,MATH 193A,A01,083224,Rotar; Vladimir,8,0,34,26
1657512279583,MATH 193A,A02,083225,Rotar; Vladimir,9,0,34,25
1657512279583,MATH 193A,A03,083781,Rotar; Vladimir,5,0,34,29
1657512279583,MATH 193A,A04,083782,Rotar; Vladimir,10,0,34,24
1657512279583,MATH 193A,A05,093482,Rotar; Vladimir,10,0,34,24
1657512285616,MATH 197,001,091859,McAuley; Julian John,9999,0,9999,0
1657512285616,MATH 197,002,095566,Kedlaya; Kiran S.,9997,0,9999,2
1657512285616,MATH 197,003,095567,Xiao; Ming,9999,0,9999,0
1657512285616,MATH 197,004,095571,Perols; Johan Lars,9998,0,9999,1
1657512292672,COGS 9,A01,083615,Shannon; Kyle Michael,9,0,75,66
1657512298696,COGS 11,A01,083617,Boyle; Mary E. T.,22,0,48,26
1657512304724,COGS 13,A01,083071,Bastos; Amalia Pinkusfeld,11,0,71,60
1657512310756,COGS 14A,A01,092681,Semenuks; Arturs,5,1,100,95
1657512316778,COGS 14B,A01,083073,Cheng; Tzu-Han,6,0,63,57
1657512322804,COGS 17,A01,092677,Semenuks; Arturs,6,0,81,75
1657512328850,COGS 100,A01,083619,Allen; Michael Gordon,17,0,70,53
1657512334882,COGS 101A,A01,083621,Davis; Joshua Daniel,9,0,68,59
1657512340904,COGS 101B,A01,091572,Allen; Michael Gordon,12,0,65,53
1657512346925,COGS 101C,A01,083625,Delgado; Tania,17,0,35,18
1657512352961,COGS 107A,A01,083627,Boyle; Mary E. T.,13,0,60,47
1657512358986,COGS 118A,A01,083075,Gupta; Anjum,21,0,76,55
1657512365012,CSE 3,A50,083646,Miranda; Gregory Joseph,24,0,50,26
1657512371040,CSE 8A,A50,083650,Miranda; Gregory Joseph,17,1,56,39
1657512377063,CSE 11,A01,083080,Cao; Yingjun,6,15,40,34
1657512383089,CSE 12,A01,083652,Krause-Levy; Sophia Louisa,28,1,120,92
1657512389115,CSE 15L,A01,083654,Morris; Justin Loren,9,0,50,41
1657512389115,CSE 15L,A02,083655,Morris; Justin Loren,9,0,50,41
1657512395142,CSE 20,A01,083657,Tran; Khoa Dang,39,0,80,41
1657512401176,CSE 21,A01,095574,Bach; Quang Tran,22,0,48,26
1657512407204,CSE 30,A01,083084,Eldon; John,5,0,80,75
1657512407204,CSE 30,B01,095061,Bhaskar; Nishant,9,0,50,41
1657512413227,CSE 100,A01,083659,Cao; Yingjun,5,4,70,65
1657512419256,CSE 134B,A01,083661,Powell; Thomas Allan,22,0,100,78
1657512425282,CSE 140,A01,083663,Gungor; Onat,15,0,85,70
1657512431305,CSE 140L,A01,083088,Eldon; John,21,0,100,79
1657512437330,CSE 175,A01,083665,Kumar; Rakesh,3,0,25,22
1657512443352,CSE 190,A00,092507,Dubnov; Shlomo,8,0,20,12
1657512449380,ECE 45,A01,083139,Congero; Spencer William,6,0,75,69
1657512455420,ECE 65,A50,083695,Saad; Andrew S,12,0,30,18
1657512455420,ECE 65,A51,095125,Saad; Andrew S,24,0,26,2
1657512461449,ECE 109,A01,091882,Touri; Behrouz,19,0,70,51
1657512467470,ECE 180,A00,083140,Abi Samra; Nicholas Camill,1,0,30,29
1657512467470,ECE 180,B00,083141,Abi Samra; Nicholas Camill,0,0,30,30
1657512473494,MATH 10A,A01,083735,Patchell; Gregory David,2,0,30,28
1657512473494,MATH 10A,A02,083736,Patchell; Gregory David,20,0,30,10
1657512473494,MATH 10A,A03,083737,Patchell; Gregory David,16,0,30,14
1657512479517,MATH 10B,A01,083207,Lim; Seonhee,8,0,34,26
1657512479517,MATH 10B,A02,083208,Lim; Seonhee,9,0,35,26
1657512479517,MATH 10B,A03,093472,Lim; Seonhee,7,0,34,27
1657512479517,MATH 10B,B01,083739,Sinha; Shubham,12,0,30,18
1657512485548,MATH 18,A01,083743,Cinel; Cameron Alexander,7,0,30,23
1657512485548,MATH 18,A02,083744,Cinel; Cameron Alexander,17,0,30,13
1657512485548,MATH 18,A03,083745,Cinel; Cameron Alexander,9,0,30,21
1657512485548,MATH 18,B01,083748,Rideout; David Porter,5,0,37,32
1657512485548,MATH 18,B02,083749,Rideout; David Porter,5,0,36,31
1657512485548,MATH 18,B03,083750,Rideout; David Porter,3,0,37,34
1657512485548,MATH 18,B04,083751,Rideout; David Porter,6,0,36,30
1657512485548,MATH 18,B05,093473,Rideout; David Porter,6,0,36,30
1657512485548,MATH 18,B06,093474,Rideout; David Porter,6,0,36,30
1657512491571,MATH 20A,A01,083754,Zheng; Zequn,14,0,40,26
1657512497594,MATH 20B,A01,083756,Briones; Jor-el Thomas Caparas,4,0,36,32
1657512497594,MATH 20B,A02,083757,Briones; Jor-el Thomas Caparas,1,0,36,35
1657512497594,MATH 20B,A03,093475,Briones; Jor-el Thomas Caparas,2,0,36,34
1657512503617,MATH 20C,A01,083760,Briones; Jor-el Thomas Caparas,1,0,35,34
1657512503617,MATH 20C,A02,083761,Briones; Jor-el Thomas Caparas,8,0,35,27
1657512503617,MATH 20C,A03,093476,Briones; Jor-el Thomas Caparas,0,1,36,36
1657512503617,MATH 20C,B01,083762,Bach; Quang Tran,1,0,30,29
1657512509645,MATH 20D,A01,083765,Tran; Brian Kha,5,0,30,25
1657512509645,MATH 20D,A02,083766,Tran; Brian Kha,5,0,30,25
1657512509645,MATH 20D,A03,083767,Tran; Brian Kha,5,0,30,25
1657512515675,MATH 20E,A01,083771,Ganguly; Soumya,9,0,32,23
1657512515675,MATH 20E,A02,083772,Ganguly; Soumya,6,0,32,26
1657512515675,MATH 20E,B01,083773,Ciotti; Benjamin,20,0,35,15
1657512515675,MATH 20E,B02,083774,Ciotti; Benjamin,17,0,35,18
1657512521698,MATH 103A,A01,083777,Greenfeld; Be'Eri,3,0,36,33
1657512521698,MATH 103A,A02,083778,Greenfeld; Be'Eri,5,0,36,31
1657512521698,MATH 103A,A03,093561,Greenfeld; Be'Eri,5,0,36,31
1657512521698,MATH 103A,B01,083779,Greenfeld; Be'Eri,7,0,36,29
1657512521698,MATH 103A,B02,083780,Greenfeld; Be'Eri,4,0,36,32
1657512521698,MATH 103A,B03,093562,Greenfeld; Be'Eri,3,0,36,33
1657512527723,MATH 105,A01,085443,Carter; Anne Toulson,15,0,35,20
1657512527723,MATH 105,A02,093477,Carter; Anne Toulson,20,0,35,15
1657512533766,MATH 109,A01,083213,Ganzberger; Geoffrey Michael,2,0,34,32
1657512533766,MATH 109,A02,083214,Ganzberger; Geoffrey Michael,4,0,34,30
1657512533766,MATH 109,A03,093478,Ganzberger; Geoffrey Michael,2,0,34,32
1657512533766,MATH 109,B01,083215,Ganzberger; Geoffrey Michael,1,0,32,31
1657512533766,MATH 109,B02,083216,Ganzberger; Geoffrey Michael,2,0,32,30
1657512533766,MATH 109,B03,093479,Ganzberger; Geoffrey Michael,8,0,32,24
1657512539795,MATH 142A,A01,083219,Chow; Bennett,7,0,32,25
1657512539795,MATH 142A,A02,083220,Chow; Bennett,10,0,32,22
1657512539795,MATH 142A,A03,093480,Chow; Bennett,8,0,32,24
1657512539795,MATH 142A,B03,093481,Chow; Bennett,8,0,32,24
1657512539795,MATH 142A,B04,093558,Chow; Bennett,13,0,32,19
1657512539795,MATH 142A,B05,093559,Chow; Bennett,6,0,32,26
1657512545820,MATH 193A,A01,083224,Rotar; Vladimir,8,0,34,26
1657512545820,MATH 193A,A02,083225,Rotar; Vladimir,9,0,34,25
1657512545820,MATH 193A,A03,083781,Rotar; Vladimir,5,0,34,29
1657512545820,MATH 193A,A04,083782,Rotar; Vladimir,10,0,34,24
1657512545820,MATH 193A,A05,093482,Rotar; Vladimir,10,0,34,24
1657512551847,MATH 197,001,091859,McAuley; Julian John,9999,0,9999,0
1657512551847,MATH 197,002,095566,Kedlaya; Kiran S.,9997,0,9999,2
1657512551847,MATH 197,003,095567,Xiao; Ming,9999,0,9999,0
1657512551847,MATH 197,004,095571,Perols; Johan Lars,9998,0,9999,1
1657512558909,COGS 9,A01,083615,Shannon; Kyle Michael,9,0,75,66
1657512564934,COGS 11,A01,083617,Boyle; Mary E. T.,22,0,48,26
1657512570958,COGS 13,A01,083071,Bastos; Amalia Pinkusfeld,11,0,71,60
1657512576981,COGS 14A,A01,092681,Semenuks; Arturs,5,1,100,95
1657512583004,COGS 14B,A01,083073,Cheng; Tzu-Han,6,0,63,57
1657512589036,COGS 17,A01,092677,Semenuks; Arturs,6,0,81,75
1657512595063,COGS 100,A01,083619,Allen; Michael Gordon,17,0,70,53
1657512601089,COGS 101A,A01,083621,Davis; Joshua Daniel,9,0,68,59
1657512607116,COGS 101B,A01,091572,Allen; Michael Gordon,12,0,65,53
1657512613139,COGS 101C,A01,083625,Delgado; Tania,17,0,35,18
1657512619161,COGS 107A,A01,083627,Boyle; Mary E. T.,13,0,60,47
1657512625188,COGS 118A,A01,083075,Gupta; Anjum,21,0,76,55
1657512631211,CSE 3,A50,083646,Miranda; Gregory Joseph,24,0,50,26
1657512637242,CSE 8A,A50,083650,Miranda; Gregory Joseph,17,1,56,39
1657512643265,CSE 11,A01,083080,Cao; Yingjun,6,15,40,34
1657512649293,CSE 12,A01,083652,Krause-Levy; Sophia Louisa,28,1,120,92
1657512655320,CSE 15L,A01,083654,Morris; Justin Loren,9,0,50,41
1657512655320,CSE 15L,A02,083655,Morris; Justin Loren,9,0,50,41
1657512661342,CSE 20,A01,083657,Tran; Khoa Dang,39,0,80,41
1657512667365,CSE 21,A01,095574,Bach; Quang Tran,22,0,48,26
1657512673392,CSE 30,A01,083084,Eldon; John,5,0,80,75
1657512673392,CSE 30,B01,095061,Bhaskar; Nishant,9,0,50,41
1657512679424,CSE 100,A01,083659,Cao; Yingjun,5,4,70,65
1657512685447,CSE 134B,A01,083661,Powell; Thomas Allan,22,0,100,78
1657512691475,CSE 140,A01,083663,Gungor; Onat,15,0,85,70
1657512697497,CSE 140L,A01,083088,Eldon; John,21,0,100,79
1657512703535,CSE 175,A01,083665,Kumar; Rakesh,3,0,25,22
1657512709564,CSE 190,A00,092507,Dubnov; Shlomo,8,0,20,12
1657512715593,ECE 45,A01,083139,Congero; Spencer William,6,0,75,69
1657512721698,ECE 65,A50,083695,Saad; Andrew S,12,0,30,18
1657512721698,ECE 65,A51,095125,Saad; Andrew S,24,0,26,2
1657512727720,ECE 109,A01,091882,Touri; Behrouz,19,0,70,51
1657512733743,ECE 180,A00,083140,Abi Samra; Nicholas Camill,1,0,30,29
1657512733743,ECE 180,B00,083141,Abi Samra; Nicholas Camill,0,0,30,30
1657512739765,MATH 10A,A01,083735,Patchell; Gregory David,2,0,30,28
1657512739765,MATH 10A,A02,083736,Patchell; Gregory David,20,0,30,10
1657512739765,MATH 10A,A03,083737,Patchell; Gregory David,16,0,30,14
1657512745793,MATH 10B,A01,083207,Lim; Seonhee,8,0,34,26
1657512745793,MATH 10B,A02,083208,Lim; Seonhee,9,0,35,26
1657512745793,MATH 10B,A03,093472,Lim; Seonhee,7,0,34,27
1657512745793,MATH 10B,B01,083739,Sinha; Shubham,12,0,30,18
1657512751830,MATH 18,A01,083743,Cinel; Cameron Alexander,7,0,30,23
1657512751830,MATH 18,A02,083744,Cinel; Cameron Alexander,17,0,30,13
1657512751830,MATH 18,A03,083745,Cinel; Cameron Alexander,9,0,30,21
1657512751830,MATH 18,B01,083748,Rideout; David Porter,5,0,37,32
1657512751830,MATH 18,B02,083749,Rideout; David Porter,5,0,36,31
1657512751830,MATH 18,B03,083750,Rideout; David Porter,3,0,37,34
1657512751830,MATH 18,B04,083751,Rideout; David Porter,6,0,36,30
1657512751830,MATH 18,B05,093473,Rideout; David Porter,6,0,36,30
1657512751830,MATH 18,B06,093474,Rideout; David Porter,6,0,36,30
1657512757855,MATH 20A,A01,083754,Zheng; Zequn,14,0,40,26
1657512763878,MATH 20B,A01,083756,Briones; Jor-el Thomas Caparas,4,0,36,32
1657512763878,MATH 20B,A02,083757,Briones; Jor-el Thomas Caparas,1,0,36,35
1657512763878,MATH 20B,A03,093475,Briones; Jor-el Thomas Caparas,2,0,36,34
1657512769902,MATH 20C,A01,083760,Briones; Jor-el Thomas Caparas,1,0,35,34
1657512769902,MATH 20C,A02,083761,Briones; Jor-el Thomas Caparas,8,0,35,27
1657512769902,MATH 20C,A03,093476,Briones; Jor-el Thomas Caparas,0,1,36,36
1657512769902,MATH 20C,B01,083762,Bach; Quang Tran,1,0,30,29
1657512775926,MATH 20D,A01,083765,Tran; Brian Kha,5,0,30,25
1657512775926,MATH 20D,A02,083766,Tran; Brian Kha,5,0,30,25
1657512775926,MATH 20D,A03,083767,Tran; Brian Kha,5,0,30,25
1657512781951,MATH 20E,A01,083771,Ganguly; Soumya,9,0,32,23
1657512781951,MATH 20E,A02,083772,Ganguly; Soumya,6,0,32,26
1657512781951,MATH 20E,B01,083773,Ciotti; Benjamin,20,0,35,15
1657512781951,MATH 20E,B02,083774,Ciotti; Benjamin,17,0,35,18
1657512787980,MATH 103A,A01,083777,Greenfeld; Be'Eri,3,0,36,33
1657512787980,MATH 103A,A02,083778,Greenfeld; Be'Eri,5,0,36,31
1657512787980,MATH 103A,A03,093561,Greenfeld; Be'Eri,5,0,36,31
1657512787980,MATH 103A,B01,083779,Greenfeld; Be'Eri,7,0,36,29
1657512787980,MATH 103A,B02,083780,Greenfeld; Be'Eri,4,0,36,32
1657512787980,MATH 103A,B03,093562,Greenfeld; Be'Eri,3,0,36,33
1657512794007,MATH 105,A01,085443,Carter; Anne Toulson,15,0,35,20
1657512794007,MATH 105,A02,093477,Carter; Anne Toulson,20,0,35,15
1657512800035,MATH 109,A01,083213,Ganzberger; Geoffrey Michael,2,0,34,32
1657512800035,MATH 109,A02,083214,Ganzberger; Geoffrey Michael,4,0,34,30
1657512800035,MATH 109,A03,093478,Ganzberger; Geoffrey Michael,2,0,34,32
1657512800035,MATH 109,B01,083215,Ganzberger; Geoffrey Michael,1,0,32,31
1657512800035,MATH 109,B02,083216,Ganzberger; Geoffrey Michael,2,0,32,30
1657512800035,MATH 109,B03,093479,Ganzberger; Geoffrey Michael,8,0,32,24
1657512806065,MATH 142A,A01,083219,Chow; Bennett,7,0,32,25
1657512806065,MATH 142A,A02,083220,Chow; Bennett,10,0,32,22
1657512806065,MATH 142A,A03,093480,Chow; Bennett,8,0,32,24
1657512806065,MATH 142A,B03,093481,Chow; Bennett,8,0,32,24
1657512806065,MATH 142A,B04,093558,Chow; Bennett,13,0,32,19
1657512806065,MATH 142A,B05,093559,Chow; Bennett,6,0,32,26
1657512812088,MATH 193A,A01,083224,Rotar; Vladimir,8,0,34,26
1657512812088,MATH 193A,A02,083225,Rotar; Vladimir,9,0,34,25
1657512812088,MATH 193A,A03,083781,Rotar; Vladimir,5,0,34,29
1657512812088,MATH 193A,A04,083782,Rotar; Vladimir,10,0,34,24
1657512812088,MATH 193A,A05,093482,Rotar; Vladimir,10,0,34,24
1657512818114,MATH 197,001,091859,McAuley; Julian John,9999,0,9999,0
1657512818114,MATH 197,002,095566,Kedlaya; Kiran S.,9997,0,9999,2
1657512818114,MATH 197,003,095567,Xiao; Ming,9999,0,9999,0
1657512818114,MATH 197,004,095571,Perols; Johan Lars,9998,0,9999,1
1657512825173,COGS 9,A01,083615,Shannon; Kyle Michael,9,0,75,66
1657512831199,COGS 11,A01,083617,Boyle; Mary E. T.,22,0,48,26
1657512837221,COGS 13,A01,083071,Bastos; Amalia Pinkusfeld,11,0,71,60
1657512843249,COGS 14A,A01,092681,Semenuks; Arturs,5,1,100,95
1657512849272,COGS 14B,A01,083073,Cheng; Tzu-Han,6,0,63,57
1657512855297,COGS 17,A01,092677,Semenuks; Arturs,6,0,81,75
1657512861321,COGS 100,A01,083619,Allen; Michael Gordon,17,0,70,53
1657512867349,COGS 101A,A01,083621,Davis; Joshua Daniel,9,0,68,59
1657512873372,COGS 101B,A01,091572,Allen; Michael Gordon,12,0,65,53
1657512879394,COGS 101C,A01,083625,Delgado; Tania,17,0,35,18
1657512885418,COGS 107A,A01,083627,Boyle; Mary E. T.,13,0,60,47
1657512891441,COGS 118A,A01,083075,Gupta; Anjum,21,0,76,55
1657512897464,CSE 3,A50,083646,Miranda; Gregory Joseph,24,0,50,26
1657512903491,CSE 8A,A50,083650,Miranda; Gregory Joseph,17,1,56,39
1657512909515,CSE 11,A01,083080,Cao; Yingjun,6,15,40,34
1657512915538,CSE 12,A01,083652,Krause-Levy; Sophia Louisa,28,1,120,92
1657512921564,CSE 15L,A01,083654,Morris; Justin Loren,9,0,50,41
1657512921564,CSE 15L,A02,083655,Morris; Justin Loren,9,0,50,41
1657512927587,CSE 20,A01,083657,Tran; Khoa Dang,39,0,80,41
1657512933633,CSE 21,A01,095574,Bach; Quang Tran,22,0,48,26
1657512939657,CSE 30,A01,083084,Eldon; John,5,0,80,75
1657512939657,CSE 30,B01,095061,Bhaskar; Nishant,9,0,50,41
1657512945682,CSE 100,A01,083659,Cao; Yingjun,5,4,70,65
1657512951717,CSE 134B,A01,083661,Powell; Thomas Allan,22,0,100,78
1657512957741,CSE 140,A01,083663,Gungor; Onat,15,0,85,70
1657512963767,CSE 140L,A01,083088,Eldon; John,21,0,100,79
1657512969790,CSE 175,A01,083665,Kumar; Rakesh,3,0,25,22
1657512975816,CSE 190,A00,092507,Dubnov; Shlomo,8,0,20,12
1657512981841,ECE 45,A01,083139,Congero; Spencer William,6,0,75,69
1657512987864,ECE 65,A50,083695,Saad; Andrew S,12,0,30,18
1657512987864,ECE 65,A51,095125,Saad; Andrew S,24,0,26,2
1657512993886,ECE 109,A01,091882,Touri; Behrouz,19,0,70,51
1657512999910,ECE 180,A00,083140,Abi Samra; Nicholas Camill,1,0,30,29
1657512999910,ECE 180,B00,083141,Abi Samra; Nicholas Camill,0,0,30,30
1657513005933,MATH 10A,A01,083735,Patchell; Gregory David,2,0,30,28
1657513005933,MATH 10A,A02,083736,Patchell; Gregory David,20,0,30,10
1657513005933,MATH 10A,A03,083737,Patchell; Gregory David,16,0,30,14
1657513011957,MATH 10B,A01,083207,Lim; Seonhee,8,0,34,26
1657513011957,MATH 10B,A02,083208,Lim; Seonhee,9,0,35,26
1657513011957,MATH 10B,A03,093472,Lim; Seonhee,7,0,34,27
1657513011957,MATH 10B,B01,083739,Sinha; Shubham,12,0,30,18
1657513017988,MATH 18,A01,083743,Cinel; Cameron Alexander,7,0,30,23
1657513017988,MATH 18,A02,083744,Cinel; Cameron Alexander,17,0,30,13
1657513017988,MATH 18,A03,083745,Cinel; Cameron Alexander,9,0,30,21
1657513017988,MATH 18,B01,083748,Rideout; David Porter,5,0,37,32
1657513017988,MATH 18,B02,083749,Rideout; David Porter,5,0,36,31
1657513017988,MATH 18,B03,083750,Rideout; David Porter,3,0,37,34
1657513017988,MATH 18,B04,083751,Rideout; David Porter,6,0,36,30
1657513017988,MATH 18,B05,093473,Rideout; David Porter,6,0,36,30
1657513017988,MATH 18,B06,093474,Rideout; David Porter,6,0,36,30
1657513024010,MATH 20A,A01,083754,Zheng; Zequn,14,0,40,26
1657513030049,MATH 20B,A01,083756,Briones; Jor-el Thomas Caparas,4,0,36,32
1657513030049,MATH 20B,A02,083757,Briones; Jor-el Thomas Caparas,1,0,36,35
1657513030049,MATH 20B,A03,093475,Briones; Jor-el Thomas Caparas,2,0,36,34
1657513036072,MATH 20C,A01,083760,Briones; Jor-el Thomas Caparas,1,0,35,34
1657513036072,MATH 20C,A02,083761,Briones; Jor-el Thomas Caparas,8,0,35,27
1657513036072,MATH 20C,A03,093476,Briones; Jor-el Thomas Caparas,0,1,36,36
1657513036072,MATH 20C,B01,083762,Bach; Quang Tran,1,0,30,29
1657513042100,MATH 20D,A01,083765,Tran; Brian Kha,5,0,30,25
1657513042100,MATH 20D,A02,083766,Tran; Brian Kha,5,0,30,25
1657513042100,MATH 20D,A03,083767,Tran; Brian Kha,5,0,30,25
1657513048124,MATH 20E,A01,083771,Ganguly; Soumya,9,0,32,23
1657513048124,MATH 20E,A02,083772,Ganguly; Soumya,6,0,32,26
1657513048124,MATH 20E,B01,083773,Ciotti; Benjamin,20,0,35,15
1657513048124,MATH 20E,B02,083774,Ciotti; Benjamin,17,0,35,18
1657513054154,MATH 103A,A01,083777,Greenfeld; Be'Eri,3,0,36,33
1657513054154,MATH 103A,A02,083778,Greenfeld; Be'Eri,5,0,36,31
1657513054154,MATH 103A,A03,093561,Greenfeld; Be'Eri,5,0,36,31
1657513054154,MATH 103A,B01,083779,Greenfeld; Be'Eri,7,0,36,29
1657513054154,MATH 103A,B02,083780,Greenfeld; Be'Eri,4,0,36,32
1657513054154,MATH 103A,B03,093562,Greenfeld; Be'Eri,3,0,36,33
1657513060181,MATH 105,A01,085443,Carter; Anne Toulson,15,0,35,20
1657513060181,MATH 105,A02,093477,Carter; Anne Toulson,20,0,35,15
1657513066210,MATH 109,A01,083213,Ganzberger; Geoffrey Michael,2,0,34,32
1657513066210,MATH 109,A02,083214,Ganzberger; Geoffrey Michael,4,0,34,30
1657513066210,MATH 109,A03,093478,Ganzberger; Geoffrey Michael,2,0,34,32
1657513066210,MATH 109,B01,083215,Ganzberger; Geoffrey Michael,1,0,32,31
1657513066210,MATH 109,B02,083216,Ganzberger; Geoffrey Michael,2,0,32,30
1657513066210,MATH 109,B03,093479,Ganzberger; Geoffrey Michael,8,0,32,24
1657513072239,MATH 142A,A01,083219,Chow; Bennett,7,0,32,25
1657513072239,MATH 142A,A02,083220,Chow; Bennett,10,0,32,22
1657513072239,MATH 142A,A03,093480,Chow; Bennett,8,0,32,24
1657513072239,MATH 142A,B03,093481,Chow; Bennett,8,0,32,24
1657513072239,MATH 142A,B04,093558,Chow; Bennett,13,0,32,19
1657513072239,MATH 142A,B05,093559,Chow; Bennett,6,0,32,26
1657513078262,MATH 193A,A01,083224,Rotar; Vladimir,8,0,34,26
1657513078262,MATH 193A,A02,083225,Rotar; Vladimir,9,0,34,25
1657513078262,MATH 193A,A03,083781,Rotar; Vladimir,5,0,34,29
1657513078262,MATH 193A,A04,083782,Rotar; Vladimir,10,0,34,24
1657513078262,MATH 193A,A05,093482,Rotar; Vladimir,10,0,34,24
1657513084288,MATH 197,001,091859,McAuley; Julian John,9999,0,9999,0
1657513084288,MATH 197,002,095566,Kedlaya; Kiran S.,9997,0,9999,2
1657513084288,MATH 197,003,095567,Xiao; Ming,9999,0,9999,0
1657513084288,MATH 197,004,095571,Perols; Johan Lars,9998,0,9999,1
1657513091360,COGS 9,A01,083615,Shannon; Kyle Michael,9,0,75,66
1657513097382,COGS 11,A01,083617,Boyle; Mary E. T.,22,0,48,26
1657513103418,COGS 13,A01,083071,Bastos; Amalia Pinkusfeld,11,0,71,60
1657513109443,COGS 14A,A01,092681,Semenuks; Arturs,5,1,100,95
1657513115466,COGS 14B,A01,083073,Cheng; Tzu-Han,6,0,63,57
1657513121493,COGS 17,A01,092677,Semenuks; Arturs,6,0,81,75
1657513127519,COGS 100,A01,083619,Allen; Michael Gordon,17,0,70,53
1657513133542,COGS 101A,A01,083621,Davis; Joshua Daniel,9,0,68,59
1657513139565,COGS 101B,A01,091572,Allen; Michael Gordon,12,0,65,53
1657513145607,COGS 101C,A01,083625,Delgado; Tania,17,0,35,18
1657513151634,COGS 107A,A01,083627,Boyle; Mary E. T.,13,0,60,47
1657513157659,COGS 118A,A01,083075,Gupta; Anjum,21,0,76,55
1657513163681,CSE 3,A50,083646,Miranda; Gregory Joseph,24,0,50,26
1657513169709,CSE 8A,A50,083650,Miranda; Gregory Joseph,17,1,56,39
1657513175732,CSE 11,A01,083080,Cao; Yingjun,6,15,40,34
1657513181757,CSE 12,A01,083652,Krause-Levy; Sophia Louisa,28,1,120,92
1657513187784,CSE 15L,A01,083654,Morris; Justin Loren,9,0,50,41
1657513187784,CSE 15L,A02,083655,Morris; Justin Loren,9,0,50,41
1657513193808,CSE 20,A01,083657,Tran; Khoa Dang,39,0,80,41
1657513199836,CSE 21,A01,095574,Bach; Quang Tran,22,0,48,26
1657513205858,CSE 30,A01,083084,Eldon; John,5,0,80,75
1657513205858,CSE 30,B01,095061,Bhaskar; Nishant,9,0,50,41
1657513211892,CSE 100,A01,083659,Cao; Yingjun,5,4,70,65
1657513217913,CSE 134B,A01,083661,Powell; Thomas Allan,22,0,100,78
1657513223939,CSE 140,A01,083663,Gungor; Onat,15,0,85,70
1657513229960,CSE 140L,A01,083088,Eldon; John,21,0,100,79
1657513235993,CSE 175,A01,083665,Kumar; Rakesh,3,0,25,22
1657513242015,CSE 190,A00,092507,Dubnov; Shlomo,8,0,20,12
1657513248040,ECE 45,A01,083139,Congero; Spencer William,6,0,75,69
1657513254067,ECE 65,A50,083695,Saad; Andrew S,12,0,30,18
1657513254067,ECE 65,A51,095125,Saad; Andrew S,24,0,26,2
1657513260092,ECE 109,A01,091882,Touri; Behrouz,19,0,70,51
1657513266131,ECE 180,A00,083140,Abi Samra; Nicholas Camill,1,0,30,29
1657513266131,ECE 180,B00,083141,Abi Samra; Nicholas Camill,0,0,30,30
1657513272169,MATH 10A,A01,083735,Patchell; Gregory David,2,0,30,28
1657513272169,MATH 10A,A02,083736,Patchell; Gregory David,20,0,30,10
1657513272169,MATH 10A,A03,083737,Patchell; Gregory David,16,0,30,14
1657513278200,MATH 10B,A01,083207,Lim; Seonhee,8,0,34,26
1657513278200,MATH 10B,A02,083208,Lim; Seonhee,9,0,35,26
1657513278200,MATH 10B,A03,093472,Lim; Seonhee,7,0,34,27
1657513278200,MATH 10B,B01,083739,Sinha; Shubham,12,0,30,18
1657513284224,MATH 18,A01,083743,Cinel; Cameron Alexander,7,0,30,23
1657513284224,MATH 18,A02,083744,Cinel; Cameron Alexander,17,0,30,13
1657513284224,MATH 18,A03,083745,Cinel; Cameron Alexander,9,0,30,21
1657513284224,MATH 18,B01,083748,Rideout; David Porter,5,0,37,32
1657513284224,MATH 18,B02,083749,Rideout; David Porter,5,0,36,31
1657513284224,MATH 18,B03,083750,Rideout; David Porter,3,0,37,34
1657513284224,MATH 18,B04,083751,Rideout; David Porter,6,0,36,30
1657513284224,MATH 18,B05,093473,Rideout; David Porter,6,0,36,30
1657513284224,MATH 18,B06,093474,Rideout; David Porter,6,0,36,30
1657513290251,MATH 20A,A01,083754,Zheng; Zequn,14,0,40,26
1657513296282,MATH 20B,A01,083756,Briones; Jor-el Thomas Caparas,4,0,36,32
1657513296282,MATH 20B,A02,083757,Briones; Jor-el Thomas Caparas,1,0,36,35
1657513296282,MATH 20B,A03,093475,Briones; Jor-el Thomas Caparas,2,0,36,34
1657513302311,MATH 20C,A01,083760,Briones; Jor-el Thomas Caparas,1,0,35,34
1657513302311,MATH 20C,A02,083761,Briones; Jor-el Thomas Caparas,8,0,35,27
1657513302311,MATH 20C,A03,093476,Briones; Jor-el Thomas Caparas,0,1,36,36
1657513302311,MATH 20C,B01,083762,Bach; Quang Tran,1,0,30,29
1657513308337,MATH 20D,A01,083765,Tran; Brian Kha,5,0,30,25
1657513308337,MATH 20D,A02,083766,Tran; Brian Kha,5,0,30,25
1657513308337,MATH 20D,A03,083767,Tran; Brian Kha,5,0,30,25
1657513314367,MATH 20E,A01,083771,Ganguly; Soumya,9,0,32,23
1657513314367,MATH 20E,A02,083772,Ganguly; Soumya,6,0,32,26
1657513314367,MATH 20E,B01,083773,Ciotti; Benjamin,20,0,35,15
1657513314367,MATH 20E,B02,083774,Ciotti; Benjamin,17,0,35,18
1657513320491,MATH 103A,A01,083777,Greenfeld; Be'Eri,3,0,36,33
1657513320491,MATH 103A,A02,083778,Greenfeld; Be'Eri,5,0,36,31
1657513320491,MATH 103A,A03,093561,Greenfeld; Be'Eri,5,0,36,31
1657513320491,MATH 103A,B01,083779,Greenfeld; Be'Eri,7,0,36,29
1657513320491,MATH 103A,B02,083780,Greenfeld; Be'Eri,4,0,36,32
1657513320491,MATH 103A,B03,093562,Greenfeld; Be'Eri,3,0,36,33
1657513326517,MATH 105,A01,085443,Carter; Anne Toulson,15,0,35,20
1657513326517,MATH 105,A02,093477,Carter; Anne Toulson,20,0,35,15
1657513332540,MATH 109,A01,083213,Ganzberger; Geoffrey Michael,2,0,34,32
1657513332540,MATH 109,A02,083214,Ganzberger; Geoffrey Michael,4,0,34,30
1657513332540,MATH 109,A03,093478,Ganzberger; Geoffrey Michael,2,0,34,32
1657513332540,MATH 109,B01,083215,Ganzberger; Geoffrey Michael,1,0,32,31
1657513332540,MATH 109,B02,083216,Ganzberger; Geoffrey Michael,2,0,32,30
1657513332540,MATH 109,B03,093479,Ganzberger; Geoffrey Michael,8,0,32,24
1657513338569,MATH 142A,A01,083219,Chow; Bennett,7,0,32,25
1657513338569,MATH 142A,A02,083220,Chow; Bennett,10,0,32,22
1657513338569,MATH 142A,A03,093480,Chow; Bennett,8,0,32,24
1657513338569,MATH 142A,B03,093481,Chow; Bennett,8,0,32,24
1657513338569,MATH 142A,B04,093558,Chow; Bennett,13,0,32,19
1657513338569,MATH 142A,B05,093559,Chow; Bennett,6,0,32,26
1657513344597,MATH 193A,A01,083224,Rotar; Vladimir,8,0,34,26
1657513344597,MATH 193A,A02,083225,Rotar; Vladimir,9,0,34,25
1657513344597,MATH 193A,A03,083781,Rotar; Vladimir,5,0,34,29
1657513344597,MATH 193A,A04,083782,Rotar; Vladimir,10,0,34,24
1657513344597,MATH 193A,A05,093482,Rotar; Vladimir,10,0,34,24
1657513350630,MATH 197,001,091859,McAuley; Julian John,9999,0,9999,0
1657513350630,MATH 197,002,095566,Kedlaya; Kiran S.,9997,0,9999,2
1657513350630,MATH 197,003,095567,Xiao; Ming,9999,0,9999,0
1657513350630,MATH 197,004,095571,Perols; Johan Lars,9998,0,9999,1
1657513357691,COGS 9,A01,083615,Shannon; Kyle Michael,9,0,75,66
1657513363718,COGS 11,A01,083617,Boyle; Mary E. T.,22,0,48,26
1657513369743,COGS 13,A01,083071,Bastos; Amalia Pinkusfeld,11,0,71,60
1657513375771,COGS 14A,A01,092681,Semenuks; Arturs,5,1,100,95
1657513381795,COGS 14B,A01,083073,Cheng; Tzu-Han,6,0,63,57
1657513387822,COGS 17,A01,092677,Semenuks; Arturs,6,0,81,75
1657513393845,COGS 100,A01,083619,Allen; Michael Gordon,17,0,70,53
1657513399874,COGS 101A,A01,083621,Davis; Joshua Daniel,9,0,68,59
1657513405906,COGS 101B,A01,091572,Allen; Michael Gordon,12,0,65,53
1657513411932,COGS 101C,A01,083625,Delgado; Tania,17,0,35,18
1657513417960,COGS 107A,A01,083627,Boyle; Mary E. T.,13,0,60,47
1657513423983,COGS 118A,A01,083075,Gupta; Anjum,21,0,76,55
1657513430011,CSE 3,A50,083646,Miranda; Gregory Joseph,24,0,50,26
1657513436033,CSE 8A,A50,083650,Miranda; Gregory Joseph,17,1,56,39
1657513442055,CSE 11,A01,083080,Cao; Yingjun,6,15,40,34
1657513448078,CSE 12,A01,083652,Krause-Levy; Sophia Louisa,28,1,120,92
1657513454105,CSE 15L,A01,083654,Morris; Justin Loren,9,0,50,41
1657513454105,CSE 15L,A02,083655,Morris; Justin Loren,9,0,50,41
1657513460128,CSE 20,A01,083657,Tran; Khoa Dang,39,0,80,41
1657513466150,CSE 21,A01,095574,Bach; Quang Tran,22,0,48,26
1657513472176,CSE 30,A01,083084,Eldon; John,5,0,80,75
1657513472176,CSE 30,B01,095061,Bhaskar; Nishant,9,0,50,41
1657513478204,CSE 100,A01,083659,Cao; Yingjun,5,4,70,65
1657513484226,CSE 134B,A01,083661,Powell; Thomas Allan,22,0,100,78
1657513490256,CSE 140,A01,083663,Gungor; Onat,15,0,85,70
1657513496280,CSE 140L,A01,083088,Eldon; John,21,0,100,79
1657513502307,CSE 175,A01,083665,Kumar; Rakesh,3,0,25,22
1657513508333,CSE 190,A00,092507,Dubnov; Shlomo,8,0,20,12
1657513514360,ECE 45,A01,083139,Congero; Spencer William,6,0,75,69
1657513520387,ECE 65,A50,083695,Saad; Andrew S,12,0,30,18
1657513520387,ECE 65,A51,095125,Saad; Andrew S,24,0,26,2
1657513526411,ECE 109,A01,091882,Touri; Behrouz,19,0,70,51
1657513532440,ECE 180,A00,083140,Abi Samra; Nicholas Camill,1,0,30,29
1657513532440,ECE 180,B00,083141,Abi Samra; Nicholas Camill,0,0,30,30
1657513538475,MATH 10A,A01,083735,Patchell; Gregory David,2,0,30,28
1657513538475,MATH 10A,A02,083736,Patchell; Gregory David,20,0,30,10
1657513538475,MATH 10A,A03,083737,Patchell; Gregory David,16,0,30,14
1657513544504,MATH 10B,A01,083207,Lim; Seonhee,8,0,34,26
1657513544504,MATH 10B,A02,083208,Lim; Seonhee,9,0,35,26
1657513544504,MATH 10B,A03,093472,Lim; Seonhee,7,0,34,27
1657513544504,MATH 10B,B01,083739,Sinha; Shubham,12,0,30,18
1657513550528,MATH 18,A01,083743,Cinel; Cameron Alexander,7,0,30,23
1657513550528,MATH 18,A02,083744,Cinel; Cameron Alexander,17,0,30,13
1657513550528,MATH 18,A03,083745,Cinel; Cameron Alexander,9,0,30,21
1657513550528,MATH 18,B01,083748,Rideout; David Porter,5,0,37,32
1657513550528,MATH 18,B02,083749,Rideout; David Porter,5,0,36,31
1657513550528,MATH 18,B03,083750,Rideout; David Porter,3,0,37,34
1657513550528,MATH 18,B04,083751,Rideout; David Porter,6,0,36,30
1657513550528,MATH 18,B05,093473,Rideout; David Porter,6,0,36,30
1657513550528,MATH 18,B06,093474,Rideout; David Porter,6,0,36,30
1657513556551,MATH 20A,A01,083754,Zheng; Zequn,14,0,40,26
1657513562579,MATH 20B,A01,083756,Briones; Jor-el Thomas Caparas,4,0,36,32
1657513562579,MATH 20B,A02,083757,Briones; Jor-el Thomas Caparas,1,0,36,35
1657513562579,MATH 20B,A03,093475,Briones; Jor-el Thomas Caparas,2,0,36,34
1657513568612,MATH 20C,A01,083760,Briones; Jor-el Thomas Caparas,1,0,35,34
1657513568612,MATH 20C,A02,083761,Briones; Jor-el Thomas Caparas,8,0,35,27
1657513568612,MATH 20C,A03,093476,Briones; Jor-el Thomas Caparas,0,1,36,36
1657513568612,MATH 20C,B01,083762,Bach; Quang Tran,1,0,30,29
1657513574633,MATH 20D,A01,083765,Tran; Brian Kha,5,0,30,25
1657513574633,MATH 20D,A02,083766,Tran; Brian Kha,5,0,30,25
1657513574633,MATH 20D,A03,083767,Tran; Brian Kha,5,0,30,25
1657513580658,MATH 20E,A01,083771,Ganguly; Soumya,9,0,32,23
1657513580658,MATH 20E,A02,083772,Ganguly; Soumya,6,0,32,26
1657513580658,MATH 20E,B01,083773,Ciotti; Benjamin,20,0,35,15
1657513580658,MATH 20E,B02,083774,Ciotti; Benjamin,17,0,35,18
1657513586683,MATH 103A,A01,083777,Greenfeld; Be'Eri,3,0,36,33
1657513586683,MATH 103A,A02,083778,Greenfeld; Be'Eri,5,0,36,31
1657513586683,MATH 103A,A03,093561,Greenfeld; Be'Eri,5,0,36,31
1657513586683,MATH 103A,B01,083779,Greenfeld; Be'Eri,7,0,36,29
1657513586683,MATH 103A,B02,083780,Greenfeld; Be'Eri,4,0,36,32
1657513586683,MATH 103A,B03,093562,Greenfeld; Be'Eri,3,0,36,33
1657513592710,MATH 105,A01,085443,Carter; Anne Toulson,15,0,35,20
1657513592710,MATH 105,A02,093477,Carter; Anne Toulson,20,0,35,15
1657513598733,MATH 109,A01,083213,Ganzberger; Geoffrey Michael,2,0,34,32
1657513598733,MATH 109,A02,083214,Ganzberger; Geoffrey Michael,4,0,34,30
1657513598733,MATH 109,A03,093478,Ganzberger; Geoffrey Michael,2,0,34,32
1657513598733,MATH 109,B01,083215,Ganzberger; Geoffrey Michael,1,0,32,31
1657513598733,MATH 109,B02,083216,Ganzberger; Geoffrey Michael,2,0,32,30
1657513598733,MATH 109,B03,093479,Ganzberger; Geoffrey Michael,8,0,32,24
1657513604764,MATH 142A,A01,083219,Chow; Bennett,7,0,32,25
1657513604764,MATH 142A,A02,083220,Chow; Bennett,10,0,32,22
1657513604764,MATH 142A,A03,093480,Chow; Bennett,8,0,32,24
1657513604764,MATH 142A,B03,093481,Chow; Bennett,8,0,32,24
1657513604764,MATH 142A,B04,093558,Chow; Bennett,13,0,32,19
1657513604764,MATH 142A,B05,093559,Chow; Bennett,6,0,32,26
1657513610793,MATH 193A,A01,083224,Rotar; Vladimir,8,0,34,26
1657513610793,MATH 193A,A02,083225,Rotar; Vladimir,9,0,34,25
1657513610793,MATH 193A,A03,083781,Rotar; Vladimir,5,0,34,29
1657513610793,MATH 193A,A04,083782,Rotar; Vladimir,10,0,34,24
1657513610793,MATH 193A,A05,093482,Rotar; Vladimir,10,0,34,24
1657513616824,MATH 197,001,091859,McAuley; Julian John,9999,0,9999,0
1657513616824,MATH 197,002,095566,Kedlaya; Kiran S.,9997,0,9999,2
1657513616824,MATH 197,003,095567,Xiao; Ming,9999,0,9999,0
1657513616824,MATH 197,004,095571,Perols; Johan Lars,9998,0,9999,1
1657513623890,COGS 9,A01,083615,Shannon; Kyle Michael,9,0,75,66
1657513629916,COGS 11,A01,083617,Boyle; Mary E. T.,22,0,48,26
1657513635957,COGS 13,A01,083071,Bastos; Amalia Pinkusfeld,11,0,71,60
1657513641979,COGS 14A,A01,092681,Semenuks; Arturs,5,1,100,95
1657513648007,COGS 14B,A01,083073,Cheng; Tzu-Han,6,0,63,57
1657513654029,COGS 17,A01,092677,Semenuks; Arturs,6,0,81,75
1657513660055,COGS 100,A01,083619,Allen; Michael Gordon,17,0,70,53
1657513666087,COGS 101A,A01,083621,Davis; Joshua Daniel,9,0,68,59
1657513672113,COGS 101B,A01,091572,Allen; Michael Gordon,12,0,65,53
1657513678136,COGS 101C,A01,083625,Delgado; Tania,17,0,35,18
1657513684166,COGS 107A,A01,083627,Boyle; Mary E. T.,13,0,60,47
1657513690191,COGS 118A,A01,083075,Gupta; Anjum,21,0,76,55
1657513696220,CSE 3,A50,083646,Miranda; Gregory Joseph,24,0,50,26
1657513702242,CSE 8A,A50,083650,Miranda; Gregory Joseph,17,1,56,39
1657513708268,CSE 11,A01,083080,Cao; Yingjun,6,15,40,34
1657513714293,CSE 12,A01,083652,Krause-Levy; Sophia Louisa,28,1,120,92
1657513720322,CSE 15L,A01,083654,Morris; Justin Loren,9,0,50,41
1657513720322,CSE 15L,A02,083655,Morris; Justin Loren,9,0,50,41
1657513726346,CSE 20,A01,083657,Tran; Khoa Dang,39,0,80,41
1657513732371,CSE 21,A01,095574,Bach; Quang Tran,22,0,48,26
1657513738394,CSE 30,A01,083084,Eldon; John,5,0,80,75
1657513738394,CSE 30,B01,095061,Bhaskar; Nishant,9,0,50,41
1657513744420,CSE 100,A01,083659,Cao; Yingjun,5,4,70,65
1657513750443,CSE 134B,A01,083661,Powell; Thomas Allan,22,0,100,78
1657513756465,CSE 140,A01,083663,Gungor; Onat,15,0,85,70
1657513762488,CSE 140L,A01,083088,Eldon; John,21,0,100,79
1657513768513,CSE 175,A01,083665,Kumar; Rakesh,3,0,25,22
1657513774536,CSE 190,A00,092507,Dubnov; Shlomo,8,0,20,12
1657513780559,ECE 45,A01,083139,Congero; Spencer William,6,0,75,69
1657513786590,ECE 65,A50,083695,Saad; Andrew S,12,0,30,18
1657513786590,ECE 65,A51,095125,Saad; Andrew S,24,0,26,2
1657513792620,ECE 109,A01,091882,Touri; Behrouz,19,0,70,51
1657513798645,ECE 180,A00,083140,Abi Samra; Nicholas Camill,1,0,30,29
1657513798645,ECE 180,B00,083141,Abi Samra; Nicholas Camill,0,0,30,30
1657513804666,MATH 10A,A01,083735,Patchell; Gregory David,2,0,30,28
1657513804666,MATH 10A,A02,083736,Patchell; Gregory David,20,0,30,10
1657513804666,MATH 10A,A03,083737,Patchell; Gregory David,16,0,30,14
1657513810695,MATH 10B,A01,083207,Lim; Seonhee,8,0,34,26
1657513810695,MATH 10B,A02,083208,Lim; Seonhee,9,0,35,26
1657513810695,MATH 10B,A03,093472,Lim; Seonhee,7,0,34,27
1657513810695,MATH 10B,B01,083739,Sinha; Shubham,12,0,30,18
1657513816738,MATH 18,A01,083743,Cinel; Cameron Alexander,7,0,30,23
1657513816738,MATH 18,A02,083744,Cinel; Cameron Alexander,17,0,30,13
1657513816738,MATH 18,A03,083745,Cinel; Cameron Alexander,9,0,30,21
1657513816738,MATH 18,B01,083748,Rideout; David Porter,5,0,37,32
1657513816738,MATH 18,B02,083749,Rideout; David Porter,5,0,36,31
1657513816738,MATH 18,B03,083750,Rideout; David Porter,3,0,37,34
1657513816738,MATH 18,B04,083751,Rideout; David Porter,6,0,36,30
1657513816738,MATH 18,B05,093473,Rideout; David Porter,6,0,36,30
1657513816738,MATH 18,B06,093474,Rideout; David Porter,6,0,36,30
1657513822761,MATH 20A,A01,083754,Zheng; Zequn,14,0,40,26
1657513828794,MATH 20B,A01,083756,Briones; Jor-el Thomas Caparas,4,0,36,32
1657513828794,MATH 20B,A02,083757,Briones; Jor-el Thomas Caparas,1,0,36,35
1657513828794,MATH 20B,A03,093475,Briones; Jor-el Thomas Caparas,2,0,36,34
1657513834816,MATH 20C,A01,083760,Briones; Jor-el Thomas Caparas,1,0,35,34
1657513834816,MATH 20C,A02,083761,Briones; Jor-el Thomas Caparas,8,0,35,27
1657513834816,MATH 20C,A03,093476,Briones; Jor-el Thomas Caparas,0,1,36,36
1657513834816,MATH 20C,B01,083762,Bach; Quang Tran,1,0,30,29
1657513840838,MATH 20D,A01,083765,Tran; Brian Kha,5,0,30,25
1657513840838,MATH 20D,A02,083766,Tran; Brian Kha,5,0,30,25
1657513840838,MATH 20D,A03,083767,Tran; Brian Kha,5,0,30,25
1657513846862,MATH 20E,A01,083771,Ganguly; Soumya,9,0,32,23
1657513846862,MATH 20E,A02,083772,Ganguly; Soumya,6,0,32,26
1657513846862,MATH 20E,B01,083773,Ciotti; Benjamin,20,0,35,15
1657513846862,MATH 20E,B02,083774,Ciotti; Benjamin,17,0,35,18
1657513852907,MATH 103A,A01,083777,Greenfeld; Be'Eri,3,0,36,33
1657513852907,MATH 103A,A02,083778,Greenfeld; Be'Eri,5,0,36,31
1657513852907,MATH 103A,A03,093561,Greenfeld; Be'Eri,5,0,36,31
1657513852907,MATH 103A,B01,083779,Greenfeld; Be'Eri,7,0,36,29
1657513852907,MATH 103A,B02,083780,Greenfeld; Be'Eri,4,0,36,32
1657513852907,MATH 103A,B03,093562,Greenfeld; Be'Eri,3,0,36,33
1657513858935,MATH 105,A01,085443,Carter; Anne Toulson,15,0,35,20
1657513858935,MATH 105,A02,093477,Carter; Anne Toulson,20,0,35,15
1657513864959,MATH 109,A01,083213,Ganzberger; Geoffrey Michael,2,0,34,32
1657513864959,MATH 109,A02,083214,Ganzberger; Geoffrey Michael,4,0,34,30
1657513864959,MATH 109,A03,093478,Ganzberger; Geoffrey Michael,2,0,34,32
1657513864959,MATH 109,B01,083215,Ganzberger; Geoffrey Michael,1,0,32,31
1657513864959,MATH 109,B02,083216,Ganzberger; Geoffrey Michael,2,0,32,30
1657513864959,MATH 109,B03,093479,Ganzberger; Geoffrey Michael,8,0,32,24
1657513870992,MATH 142A,A01,083219,Chow; Bennett,7,0,32,25
1657513870992,MATH 142A,A02,083220,Chow; Bennett,10,0,32,22
1657513870992,MATH 142A,A03,093480,Chow; Bennett,8,0,32,24
1657513870992,MATH 142A,B03,093481,Chow; Bennett,8,0,32,24
1657513870992,MATH 142A,B04,093558,Chow; Bennett,13,0,32,19
1657513870992,MATH 142A,B05,093559,Chow; Bennett,6,0,32,26
1657513877019,MATH 193A,A01,083224,Rotar; Vladimir,8,0,34,26
1657513877019,MATH 193A,A02,083225,Rotar; Vladimir,9,0,34,25
1657513877019,MATH 193A,A03,083781,Rotar; Vladimir,5,0,34,29
1657513877019,MATH 193A,A04,083782,Rotar; Vladimir,10,0,34,24
1657513877019,MATH 193A,A05,093482,Rotar; Vladimir,10,0,34,24
1657513883044,MATH 197,001,091859,McAuley; Julian John,9999,0,9999,0
1657513883044,MATH 197,002,095566,Kedlaya; Kiran S.,9997,0,9999,2
1657513883044,MATH 197,003,095567,Xiao; Ming,9999,0,9999,0
1657513883044,MATH 197,004,095571,Perols; Johan Lars,9998,0,9999,1
1657513890121,COGS 9,A01,083615,Shannon; Kyle Michael,9,0,75,66
1657513896150,COGS 11,A01,083617,Boyle; Mary E. T.,22,0,48,26
1657513902177,COGS 13,A01,083071,Bastos; Amalia Pinkusfeld,11,0,71,60
1657513908201,COGS 14A,A01,092681,Semenuks; Arturs,5,1,100,95
1657513914306,COGS 14B,A01,083073,Cheng; Tzu-Han,6,0,63,57
1657513920331,COGS 17,A01,092677,Semenuks; Arturs,6,0,81,75
1657513926355,COGS 100,A01,083619,Allen; Michael Gordon,17,0,70,53
1657513932381,COGS 101A,A01,083621,Davis; Joshua Daniel,9,0,68,59
1657513938405,COGS 101B,A01,091572,Allen; Michael Gordon,12,0,65,53
1657513944430,COGS 101C,A01,083625,Delgado; Tania,17,0,35,18
1657513950454,COGS 107A,A01,083627,Boyle; Mary E. T.,13,0,60,47
1657513956484,COGS 118A,A01,083075,Gupta; Anjum,21,0,76,55
1657513962515,CSE 3,A50,083646,Miranda; Gregory Joseph,24,0,50,26
1657513968539,CSE 8A,A50,083650,Miranda; Gregory Joseph,17,1,56,39
1657513974563,CSE 11,A01,083080,Cao; Yingjun,6,15,40,34
1657513980585,CSE 12,A01,083652,Krause-Levy; Sophia Louisa,28,1,120,92
1657513986612,CSE 15L,A01,083654,Morris; Justin Loren,9,0,50,41
1657513986612,CSE 15L,A02,083655,Morris; Justin Loren,9,0,50,41
1657513992634,CSE 20,A01,083657,Tran; Khoa Dang,39,0,80,41
1657513998662,CSE 21,A01,095574,Bach; Quang Tran,22,0,48,26
1657514004686,CSE 30,A01,083084,Eldon; John,5,0,80,75
1657514004686,CSE 30,B01,095061,Bhaskar; Nishant,9,0,50,41
1657514010710,CSE 100,A01,083659,Cao; Yingjun,5,4,70,65
1657514016736,CSE 134B,A01,083661,Powell; Thomas Allan,22,0,100,78
1657514022763,CSE 140,A01,083663,Gungor; Onat,15,0,85,70
1657514028789,CSE 140L,A01,083088,Eldon; John,21,0,100,79
1657514034815,CSE 175,A01,083665,Kumar; Rakesh,3,0,25,22
1657514040839,CSE 190,A00,092507,Dubnov; Shlomo,8,0,20,12
1657514046870,ECE 45,A01,083139,Congero; Spencer William,6,0,75,69
1657514052895,ECE 65,A50,083695,Saad; Andrew S,12,0,30,18
1657514052895,ECE 65,A51,095125,Saad; Andrew S,24,0,26,2
1657514058920,ECE 109,A01,091882,Touri; Behrouz,19,0,70,51
1657514064954,ECE 180,A00,083140,Abi Samra; Nicholas Camill,1,0,30,29
1657514064954,ECE 180,B00,083141,Abi Samra; Nicholas Camill,0,0,30,30
1657514070981,MATH 10A,A01,083735,Patchell; Gregory David,2,0,30,28
1657514070981,MATH 10A,A02,083736,Patchell; Gregory David,20,0,30,10
1657514070981,MATH 10A,A03,083737,Patchell; Gregory David,16,0,30,14
1657514077005,MATH 10B,A01,083207,Lim; Seonhee,8,0,34,26
1657514077005,MATH 10B,A02,083208,Lim; Seonhee,9,0,35,26
1657514077005,MATH 10B,A03,093472,Lim; Seonhee,7,0,34,27
1657514077005,MATH 10B,B01,083739,Sinha; Shubham,12,0,30,18
1657514083037,MATH 18,A01,083743,Cinel; Cameron Alexander,7,0,30,23
1657514083037,MATH 18,A02,083744,Cinel; Cameron Alexander,17,0,30,13
1657514083037,MATH 18,A03,083745,Cinel; Cameron Alexander,9,0,30,21
1657514083037,MATH 18,B01,083748,Rideout; David Porter,5,0,37,32
1657514083037,MATH 18,B02,083749,Rideout; David Porter,5,0,36,31
1657514083037,MATH 18,B03,083750,Rideout; David Porter,3,0,37,34
1657514083037,MATH 18,B04,083751,Rideout; David Porter,6,0,36,30
1657514083037,MATH 18,B05,093473,Rideout; David Porter,6,0,36,30
1657514083037,MATH 18,B06,093474,Rideout; David Porter,6,0,36,30
1657514089060,MATH 20A,A01,083754,Zheng; Zequn,14,0,40,26
1657514095090,MATH 20B,A01,083756,Briones; Jor-el Thomas Caparas,4,0,36,32
1657514095090,MATH 20B,A02,083757,Briones; Jor-el Thomas Caparas,1,0,36,35
1657514095090,MATH 20B,A03,093475,Briones; Jor-el Thomas Caparas,2,0,36,34
1657514101119,MATH 20C,A01,083760,Briones; Jor-el Thomas Caparas,1,0,35,34
1657514101119,MATH 20C,A02,083761,Briones; Jor-el Thomas Caparas,8,0,35,27
1657514101119,MATH 20C,A03,093476,Briones; Jor-el Thomas Caparas,0,1,36,36
1657514101119,MATH 20C,B01,083762,Bach; Quang Tran,1,0,30,29
1657514107141,MATH 20D,A01,083765,Tran; Brian Kha,5,0,30,25
1657514107141,MATH 20D,A02,083766,Tran; Brian Kha,5,0,30,25
1657514107141,MATH 20D,A03,083767,Tran; Brian Kha,5,0,30,25
1657514113164,MATH 20E,A01,083771,Ganguly; Soumya,9,0,32,23
1657514113164,MATH 20E,A02,083772,Ganguly; Soumya,6,0,32,26
1657514113164,MATH 20E,B01,083773,Ciotti; Benjamin,20,0,35,15
1657514113164,MATH 20E,B02,083774,Ciotti; Benjamin,17,0,35,18
1657514119186,MATH 103A,A01,083777,Greenfeld; Be'Eri,3,0,36,33
1657514119186,MATH 103A,A02,083778,Greenfeld; Be'Eri,5,0,36,31
1657514119186,MATH 103A,A03,093561,Greenfeld; Be'Eri,5,0,36,31
1657514119186,MATH 103A,B01,083779,Greenfeld; Be'Eri,7,0,36,29
1657514119186,MATH 103A,B02,083780,Greenfeld; Be'Eri,4,0,36,32
1657514119186,MATH 103A,B03,093562,Greenfeld; Be'Eri,3,0,36,33
1657514125210,MATH 105,A01,085443,Carter; Anne Toulson,15,0,35,20
1657514125210,MATH 105,A02,093477,Carter; Anne Toulson,20,0,35,15
1657514131238,MATH 109,A01,083213,Ganzberger; Geoffrey Michael,2,0,34,32
1657514131238,MATH 109,A02,083214,Ganzberger; Geoffrey Michael,4,0,34,30
1657514131238,MATH 109,A03,093478,Ganzberger; Geoffrey Michael,2,0,34,32
1657514131238,MATH 109,B01,083215,Ganzberger; Geoffrey Michael,1,0,32,31
1657514131238,MATH 109,B02,083216,Ganzberger; Geoffrey Michael,2,0,32,30
1657514131238,MATH 109,B03,093479,Ganzberger; Geoffrey Michael,8,0,32,24
1657514137267,MATH 142A,A01,083219,Chow; Bennett,7,0,32,25
1657514137267,MATH 142A,A02,083220,Chow; Bennett,10,0,32,22
1657514137267,MATH 142A,A03,093480,Chow; Bennett,8,0,32,24
1657514137267,MATH 142A,B03,093481,Chow; Bennett,8,0,32,24
1657514137267,MATH 142A,B04,093558,Chow; Bennett,13,0,32,19
1657514137267,MATH 142A,B05,093559,Chow; Bennett,6,0,32,26
1657514143290,MATH 193A,A01,083224,Rotar; Vladimir,8,0,34,26
1657514143290,MATH 193A,A02,083225,Rotar; Vladimir,9,0,34,25
1657514143290,MATH 193A,A03,083781,Rotar; Vladimir,5,0,34,29
1657514143290,MATH 193A,A04,083782,Rotar; Vladimir,10,0,34,24
1657514143290,MATH 193A,A05,093482,Rotar; Vladimir,10,0,34,24
1657514149314,MATH 197,001,091859,McAuley; Julian John,9999,0,9999,0
1657514149314,MATH 197,002,095566,Kedlaya; Kiran S.,9997,0,9999,2
1657514149314,MATH 197,003,095567,Xiao; Ming,9999,0,9999,0
1657514149314,MATH 197,004,095571,Perols; Johan Lars,9998,0,9999,1
1657514156373,COGS 9,A01,083615,Shannon; Kyle Michael,9,0,75,66
1657514162397,COGS 11,A01,083617,Boyle; Mary E. T.,22,0,48,26
1657514168422,COGS 13,A01,083071,Bastos; Amalia Pinkusfeld,11,0,71,60
1657514174445,COGS 14A,A01,092681,Semenuks; Arturs,5,1,100,95
1657514180468,COGS 14B,A01,083073,Cheng; Tzu-Han,6,0,63,57
1657514186493,COGS 17,A01,092677,Semenuks; Arturs,6,0,81,75
1657514192524,COGS 100,A01,083619,Allen; Michael Gordon,17,0,70,53
1657514198548,COGS 101A,A01,083621,Davis; Joshua Daniel,9,0,68,59
1657514204572,COGS 101B,A01,091572,Allen; Michael Gordon,12,0,65,53
1657514210597,COGS 101C,A01,083625,Delgado; Tania,17,0,35,18
1657514216620,COGS 107A,A01,083627,Boyle; Mary E. T.,13,0,60,47
1657514222642,COGS 118A,A01,083075,Gupta; Anjum,21,0,76,55
1657514228669,CSE 3,A50,083646,Miranda; Gregory Joseph,24,0,50,26
1657514234696,CSE 8A,A50,083650,Miranda; Gregory Joseph,17,1,56,39
1657514240720,CSE 11,A01,083080,Cao; Yingjun,6,15,40,34
1657514246744,CSE 12,A01,083652,Krause-Levy; Sophia Louisa,28,1,120,92
1657514252771,CSE 15L,A01,083654,Morris; Justin Loren,9,0,50,41
1657514252771,CSE 15L,A02,083655,Morris; Justin Loren,9,0,50,41
1657514258794,CSE 20,A01,083657,Tran; Khoa Dang,39,0,80,41
1657514264816,CSE 21,A01,095574,Bach; Quang Tran,22,0,48,26
1657514270842,CSE 30,A01,083084,Eldon; John,5,0,80,75
1657514270842,CSE 30,B01,095061,Bhaskar; Nishant,9,0,50,41
1657514276872,CSE 100,A01,083659,Cao; Yingjun,5,4,70,65
1657514282899,CSE 134B,A01,083661,Powell; Thomas Allan,22,0,100,78
1657514288923,CSE 140,A01,083663,Gungor; Onat,15,0,85,70
1657514294949,CSE 140L,A01,083088,Eldon; John,21,0,100,79
1657514300970,CSE 175,A01,083665,Kumar; Rakesh,3,0,25,22
1657514306995,CSE 190,A00,092507,Dubnov; Shlomo,8,0,20,12
1657514313020,ECE 45,A01,083139,Congero; Spencer William,6,0,75,69
1657514319047,ECE 65,A50,083695,Saad; Andrew S,12,0,30,18
1657514319047,ECE 65,A51,095125,Saad; Andrew S,24,0,26,2
1657514325074,ECE 109,A01,091882,Touri; Behrouz,19,0,70,51
1657514331098,ECE 180,A00,083140,Abi Samra; Nicholas Camill,1,0,30,29
1657514331098,ECE 180,B00,083141,Abi Samra; Nicholas Camill,0,0,30,30
1657514337125,MATH 10A,A01,083735,Patchell; Gregory David,2,0,30,28
1657514337125,MATH 10A,A02,083736,Patchell; Gregory David,20,0,30,10
1657514337125,MATH 10A,A03,083737,Patchell; Gregory David,16,0,30,14
1657514343149,MATH 10B,A01,083207,Lim; Seonhee,8,0,34,26
1657514343149,MATH 10B,A02,083208,Lim; Seonhee,9,0,35,26
1657514343149,MATH 10B,A03,093472,Lim; Seonhee,7,0,34,27
1657514343149,MATH 10B,B01,083739,Sinha; Shubham,12,0,30,18
1657514349182,MATH 18,A01,083743,Cinel; Cameron Alexander,7,0,30,23
1657514349182,MATH 18,A02,083744,Cinel; Cameron Alexander,17,0,30,13
1657514349182,MATH 18,A03,083745,Cinel; Cameron Alexander,9,0,30,21
1657514349182,MATH 18,B01,083748,Rideout; David Porter,5,0,37,32
1657514349182,MATH 18,B02,083749,Rideout; David Porter,5,0,36,31
1657514349182,MATH 18,B03,083750,Rideout; David Porter,3,0,37,34
1657514349182,MATH 18,B04,083751,Rideout; David Porter,6,0,36,30
1657514349182,MATH 18,B05,093473,Rideout; David Porter,6,0,36,30
1657514349182,MATH 18,B06,093474,Rideout; David Porter,6,0,36,30
1657514355205,MATH 20A,A01,083754,Zheng; Zequn,14,0,40,26
1657514361229,MATH 20B,A01,083756,Briones; Jor-el Thomas Caparas,4,0,36,32
1657514361229,MATH 20B,A02,083757,Briones; Jor-el Thomas Caparas,1,0,36,35
1657514361229,MATH 20B,A03,093475,Briones; Jor-el Thomas Caparas,2,0,36,34
1657514367256,MATH 20C,A01,083760,Briones; Jor-el Thomas Caparas,1,0,35,34
1657514367256,MATH 20C,A02,083761,Briones; Jor-el Thomas Caparas,8,0,35,27
1657514367256,MATH 20C,A03,093476,Briones; Jor-el Thomas Caparas,0,1,36,36
1657514367256,MATH 20C,B01,083762,Bach; Quang Tran,1,0,30,29
1657514373283,MATH 20D,A01,083765,Tran; Brian Kha,5,0,30,25
1657514373283,MATH 20D,A02,083766,Tran; Brian Kha,5,0,30,25
1657514373283,MATH 20D,A03,083767,Tran; Brian Kha,5,0,30,25
1657514379310,MATH 20E,A01,083771,Ganguly; Soumya,9,0,32,23
1657514379310,MATH 20E,A02,083772,Ganguly; Soumya,6,0,32,26
1657514379310,MATH 20E,B01,083773,Ciotti; Benjamin,20,0,35,15
1657514379310,MATH 20E,B02,083774,Ciotti; Benjamin,17,0,35,18
1657514385333,MATH 103A,A01,083777,Greenfeld; Be'Eri,3,0,36,33
1657514385333,MATH 103A,A02,083778,Greenfeld; Be'Eri,5,0,36,31
1657514385333,MATH 103A,A03,093561,Greenfeld; Be'Eri,5,0,36,31
1657514385333,MATH 103A,B01,083779,Greenfeld; Be'Eri,7,0,36,29
1657514385333,MATH 103A,B02,083780,Greenfeld; Be'Eri,4,0,36,32
1657514385333,MATH 103A,B03,093562,Greenfeld; Be'Eri,3,0,36,33
1657514391357,MATH 105,A01,085443,Carter; Anne Toulson,15,0,35,20
1657514391357,MATH 105,A02,093477,Carter; Anne Toulson,20,0,35,15
1657514397379,MATH 109,A01,083213,Ganzberger; Geoffrey Michael,2,0,34,32
1657514397379,MATH 109,A02,083214,Ganzberger; Geoffrey Michael,4,0,34,30
1657514397379,MATH 109,A03,093478,Ganzberger; Geoffrey Michael,2,0,34,32
1657514397379,MATH 109,B01,083215,Ganzberger; Geoffrey Michael,1,0,32,31
1657514397379,MATH 109,B02,083216,Ganzberger; Geoffrey Michael,2,0,32,30
1657514397379,MATH 109,B03,093479,Ganzberger; Geoffrey Michael,8,0,32,24
1657514403409,MATH 142A,A01,083219,Chow; Bennett,7,0,32,25
1657514403409,MATH 142A,A02,083220,Chow; Bennett,10,0,32,22
1657514403409,MATH 142A,A03,093480,Chow; Bennett,8,0,32,24
1657514403409,MATH 142A,B03,093481,Chow; Bennett,8,0,32,24
1657514403409,MATH 142A,B04,093558,Chow; Bennett,13,0,32,19
1657514403409,MATH 142A,B05,093559,Chow; Bennett,6,0,32,26
1657514409433,MATH 193A,A01,083224,Rotar; Vladimir,8,0,34,26
1657514409433,MATH 193A,A02,083225,Rotar; Vladimir,9,0,34,25
1657514409433,MATH 193A,A03,083781,Rotar; Vladimir,5,0,34,29
1657514409433,MATH 193A,A04,083782,Rotar; Vladimir,10,0,34,24
1657514409433,MATH 193A,A05,093482,Rotar; Vladimir,10,0,34,24
1657514415459,MATH 197,001,091859,McAuley; Julian John,9999,0,9999,0
1657514415459,MATH 197,002,095566,Kedlaya; Kiran S.,9997,0,9999,2
1657514415459,MATH 197,003,095567,Xiao; Ming,9999,0,9999,0
1657514415459,MATH 197,004,095571,Perols; Johan Lars,9998,0,9999,1
1657514422511,COGS 9,A01,083615,Shannon; Kyle Michael,9,0,75,66
1657514428534,COGS 11,A01,083617,Boyle; Mary E. T.,22,0,48,26
1657514434555,COGS 13,A01,083071,Bastos; Amalia Pinkusfeld,11,0,71,60
1657514440578,COGS 14A,A01,092681,Semenuks; Arturs,5,1,100,95
1657514446604,COGS 14B,A01,083073,Cheng; Tzu-Han,6,0,63,57
1657514452627,COGS 17,A01,092677,Semenuks; Arturs,6,0,81,75
1657514458654,COGS 100,A01,083619,Allen; Michael Gordon,17,0,70,53
1657514464680,COGS 101A,A01,083621,Davis; Joshua Daniel,9,0,68,59
1657514470706,COGS 101B,A01,091572,Allen; Michael Gordon,12,0,65,53
1657514476729,COGS 101C,A01,083625,Delgado; Tania,17,0,35,18
1657514482752,COGS 107A,A01,083627,Boyle; Mary E. T.,13,0,60,47
1657514488784,COGS 118A,A01,083075,Gupta; Anjum,21,0,76,55
1657514494807,CSE 3,A50,083646,Miranda; Gregory Joseph,24,0,50,26
1657514500830,CSE 8A,A50,083650,Miranda; Gregory Joseph,17,1,56,39
1657514506858,CSE 11,A01,083080,Cao; Yingjun,6,15,40,34
1657514512954,CSE 12,A01,083652,Krause-Levy; Sophia Louisa,28,1,120,92
1657514518978,CSE 15L,A01,083654,Morris; Justin Loren,9,0,50,41
1657514518978,CSE 15L,A02,083655,Morris; Justin Loren,9,0,50,41
1657514525002,CSE 20,A01,083657,Tran; Khoa Dang,39,0,80,41
1657514531031,CSE 21,A01,095574,Bach; Quang Tran,22,0,48,26
1657514537056,CSE 30,A01,083084,Eldon; John,5,0,80,75
1657514537056,CSE 30,B01,095061,Bhaskar; Nishant,9,0,50,41
1657514543080,CSE 100,A01,083659,Cao; Yingjun,5,4,70,65
1657514549104,CSE 134B,A01,083661,Powell; Thomas Allan,22,0,100,78
1657514555128,CSE 140,A01,083663,Gungor; Onat,15,0,85,70
1657514561150,CSE 140L,A01,083088,Eldon; John,21,0,100,79
1657514567175,CSE 175,A01,083665,Kumar; Rakesh,3,0,25,22
1657514573207,CSE 190,A00,092507,Dubnov; Shlomo,8,0,20,12
1657514579230,ECE 45,A01,083139,Congero; Spencer William,6,0,75,69
1657514585256,ECE 65,A50,083695,Saad; Andrew S,12,0,30,18
1657514585256,ECE 65,A51,095125,Saad; Andrew S,24,0,26,2
1657514591281,ECE 109,A01,091882,Touri; Behrouz,19,0,70,51
1657514597305,ECE 180,A00,083140,Abi Samra; Nicholas Camill,1,0,30,29
1657514597305,ECE 180,B00,083141,Abi Samra; Nicholas Camill,0,0,30,30
1657514603331,MATH 10A,A01,083735,Patchell; Gregory David,2,0,30,28
1657514603331,MATH 10A,A02,083736,Patchell; Gregory David,20,0,30,10
1657514603331,MATH 10A,A03,083737,Patchell; Gregory David,16,0,30,14
1657514609358,MATH 10B,A01,083207,Lim; Seonhee,8,0,34,26
1657514609358,MATH 10B,A02,083208,Lim; Seonhee,9,0,35,26
1657514609358,MATH 10B,A03,093472,Lim; Seonhee,7,0,34,27
1657514609358,MATH 10B,B01,083739,Sinha; Shubham,12,0,30,18
1657514615388,MATH 18,A01,083743,Cinel; Cameron Alexander,7,0,30,23
1657514615388,MATH 18,A02,083744,Cinel; Cameron Alexander,17,0,30,13
1657514615388,MATH 18,A03,083745,Cinel; Cameron Alexander,9,0,30,21
1657514615388,MATH 18,B01,083748,Rideout; David Porter,5,0,37,32
1657514615388,MATH 18,B02,083749,Rideout; David Porter,5,0,36,31
1657514615388,MATH 18,B03,083750,Rideout; David Porter,3,0,37,34
1657514615388,MATH 18,B04,083751,Rideout; David Porter,6,0,36,30
1657514615388,MATH 18,B05,093473,Rideout; David Porter,6,0,36,30
1657514615388,MATH 18,B06,093474,Rideout; David Porter,6,0,36,30
1657514621411,MATH 20A,A01,083754,Zheng; Zequn,14,0,40,26
1657514627439,MATH 20B,A01,083756,Briones; Jor-el Thomas Caparas,4,0,36,32
1657514627439,MATH 20B,A02,083757,Briones; Jor-el Thomas Caparas,1,0,36,35
1657514627439,MATH 20B,A03,093475,Briones; Jor-el Thomas Caparas,2,0,36,34
1657514633462,MATH 20C,A01,083760,Briones; Jor-el Thomas Caparas,1,0,35,34
1657514633462,MATH 20C,A02,083761,Briones; Jor-el Thomas Caparas,8,0,35,27
1657514633462,MATH 20C,A03,093476,Briones; Jor-el Thomas Caparas,0,1,36,36
1657514633462,MATH 20C,B01,083762,Bach; Quang Tran,1,0,30,29
1657514639486,MATH 20D,A01,083765,Tran; Brian Kha,5,0,30,25
1657514639486,MATH 20D,A02,083766,Tran; Brian Kha,5,0,30,25
1657514639486,MATH 20D,A03,083767,Tran; Brian Kha,5,0,30,25
1657514645548,MATH 20E,A01,083771,Ganguly; Soumya,9,0,32,23
1657514645548,MATH 20E,A02,083772,Ganguly; Soumya,6,0,32,26
1657514645548,MATH 20E,B01,083773,Ciotti; Benjamin,20,0,35,15
1657514645548,MATH 20E,B02,083774,Ciotti; Benjamin,17,0,35,18
1657514651577,MATH 103A,A01,083777,Greenfeld; Be'Eri,3,0,36,33
1657514651577,MATH 103A,A02,083778,Greenfeld; Be'Eri,5,0,36,31
1657514651577,MATH 103A,A03,093561,Greenfeld; Be'Eri,5,0,36,31
1657514651577,MATH 103A,B01,083779,Greenfeld; Be'Eri,7,0,36,29
1657514651577,MATH 103A,B02,083780,Greenfeld; Be'Eri,4,0,36,32
1657514651577,MATH 103A,B03,093562,Greenfeld; Be'Eri,3,0,36,33
1657514657602,MATH 105,A01,085443,Carter; Anne Toulson,15,0,35,20
1657514657602,MATH 105,A02,093477,Carter; Anne Toulson,20,0,35,15
1657514663636,MATH 109,A01,083213,Ganzberger; Geoffrey Michael,2,0,34,32
1657514663636,MATH 109,A02,083214,Ganzberger; Geoffrey Michael,4,0,34,30
1657514663636,MATH 109,A03,093478,Ganzberger; Geoffrey Michael,2,0,34,32
1657514663636,MATH 109,B01,083215,Ganzberger; Geoffrey Michael,1,0,32,31
1657514663636,MATH 109,B02,083216,Ganzberger; Geoffrey Michael,2,0,32,30
1657514663636,MATH 109,B03,093479,Ganzberger; Geoffrey Michael,8,0,32,24
1657514669659,MATH 142A,A01,083219,Chow; Bennett,7,0,32,25
1657514669659,MATH 142A,A02,083220,Chow; Bennett,10,0,32,22
1657514669659,MATH 142A,A03,093480,Chow; Bennett,8,0,32,24
1657514669659,MATH 142A,B03,093481,Chow; Bennett,8,0,32,24
1657514669659,MATH 142A,B04,093558,Chow; Bennett,13,0,32,19
1657514669659,MATH 142A,B05,093559,Chow; Bennett,6,0,32,26
1657514675688,MATH 193A,A01,083224,Rotar; Vladimir,8,0,34,26
1657514675688,MATH 193A,A02,083225,Rotar; Vladimir,9,0,34,25
1657514675688,MATH 193A,A03,083781,Rotar; Vladimir,5,0,34,29
1657514675688,MATH 193A,A04,083782,Rotar; Vladimir,10,0,34,24
1657514675688,MATH 193A,A05,093482,Rotar; Vladimir,10,0,34,24
1657514681710,MATH 197,001,091859,McAuley; Julian John,9999,0,9999,0
1657514681710,MATH 197,002,095566,Kedlaya; Kiran S.,9997,0,9999,2
1657514681710,MATH 197,003,095567,Xiao; Ming,9999,0,9999,0
1657514681710,MATH 197,004,095571,Perols; Johan Lars,9998,0,9999,1
1657514688775,COGS 9,A01,083615,Shannon; Kyle Michael,9,0,75,66
1657514694802,COGS 11,A01,083617,Boyle; Mary E. T.,22,0,48,26
1657514700826,COGS 13,A01,083071,Bastos; Amalia Pinkusfeld,11,0,71,60
1657514706848,COGS 14A,A01,092681,Semenuks; Arturs,5,1,100,95
1657514712871,COGS 14B,A01,083073,Cheng; Tzu-Han,6,0,63,57
1657514718894,COGS 17,A01,092677,Semenuks; Arturs,6,0,81,75
1657514724925,COGS 100,A01,083619,Allen; Michael Gordon,17,0,70,53
1657514730948,COGS 101A,A01,083621,Davis; Joshua Daniel,9,0,68,59
1657514736980,COGS 101B,A01,091572,Allen; Michael Gordon,12,0,65,53
1657514743006,COGS 101C,A01,083625,Delgado; Tania,17,0,35,18
1657514749034,COGS 107A,A01,083627,Boyle; Mary E. T.,13,0,60,47
1657514755057,COGS 118A,A01,083075,Gupta; Anjum,21,0,76,55
1657514761081,CSE 3,A50,083646,Miranda; Gregory Joseph,24,0,50,26
1657514767104,CSE 8A,A50,083650,Miranda; Gregory Joseph,17,1,56,39
1657514773130,CSE 11,A01,083080,Cao; Yingjun,6,15,40,34
1657514779153,CSE 12,A01,083652,Krause-Levy; Sophia Louisa,28,1,120,92
1657514785176,CSE 15L,A01,083654,Morris; Justin Loren,9,0,50,41
1657514785176,CSE 15L,A02,083655,Morris; Justin Loren,9,0,50,41
1657514791217,CSE 20,A01,083657,Tran; Khoa Dang,39,0,80,41
1657514797244,CSE 21,A01,095574,Bach; Quang Tran,22,0,48,26
1657514803276,CSE 30,A01,083084,Eldon; John,5,0,80,75
1657514803276,CSE 30,B01,095061,Bhaskar; Nishant,9,0,50,41
1657514809302,CSE 100,A01,083659,Cao; Yingjun,5,4,70,65
1657514815328,CSE 134B,A01,083661,Powell; Thomas Allan,22,0,100,78
1657514821356,CSE 140,A01,083663,Gungor; Onat,15,0,85,70
1657514827387,CSE 140L,A01,083088,Eldon; John,21,0,100,79
1657514833413,CSE 175,A01,083665,Kumar; Rakesh,3,0,25,22
1657514839436,CSE 190,A00,092507,Dubnov; Shlomo,8,0,20,12
1657514845476,ECE 45,A01,083139,Congero; Spencer William,6,0,75,69
1657514851500,ECE 65,A50,083695,Saad; Andrew S,12,0,30,18
1657514851500,ECE 65,A51,095125,Saad; Andrew S,24,0,26,2
1657514857527,ECE 109,A01,091882,Touri; Behrouz,19,0,70,51
1657514863553,ECE 180,A00,083140,Abi Samra; Nicholas Camill,1,0,30,29
1657514863553,ECE 180,B00,083141,Abi Samra; Nicholas Camill,0,0,30,30
1657514869581,MATH 10A,A01,083735,Patchell; Gregory David,2,0,30,28
1657514869581,MATH 10A,A02,083736,Patchell; Gregory David,20,0,30,10
1657514869581,MATH 10A,A03,083737,Patchell; Gregory David,16,0,30,14
1657514875609,MATH 10B,A01,083207,Lim; Seonhee,8,0,34,26
1657514875609,MATH 10B,A02,083208,Lim; Seonhee,9,0,35,26
1657514875609,MATH 10B,A03,093472,Lim; Seonhee,7,0,34,27
1657514875609,MATH 10B,B01,083739,Sinha; Shubham,12,0,30,18
1657514881637,MATH 18,A01,083743,Cinel; Cameron Alexander,7,0,30,23
1657514881637,MATH 18,A02,083744,Cinel; Cameron Alexander,17,0,30,13
1657514881637,MATH 18,A03,083745,Cinel; Cameron Alexander,9,0,30,21
1657514881637,MATH 18,B01,083748,Rideout; David Porter,5,0,37,32
1657514881637,MATH 18,B02,083749,Rideout; David Porter,5,0,36,31
1657514881637,MATH 18,B03,083750,Rideout; David Porter,3,0,37,34
1657514881637,MATH 18,B04,083751,Rideout; David Porter,6,0,36,30
1657514881637,MATH 18,B05,093473,Rideout; David Porter,6,0,36,30
1657514881637,MATH 18,B06,093474,Rideout; David Porter,6,0,36,30
1657514887662,MATH 20A,A01,083754,Zheng; Zequn,14,0,40,26
1657514893699,MATH 20B,A01,083756,Briones; Jor-el Thomas Caparas,4,0,36,32
1657514893699,MATH 20B,A02,083757,Briones; Jor-el Thomas Caparas,1,0,36,35
1657514893699,MATH 20B,A03,093475,Briones; Jor-el Thomas Caparas,2,0,36,34
1657514899721,MATH 20C,A01,083760,Briones; Jor-el Thomas Caparas,1,0,35,34
1657514899721,MATH 20C,A02,083761,Briones; Jor-el Thomas Caparas,8,0,35,27
1657514899721,MATH 20C,A03,093476,Briones; Jor-el Thomas Caparas,0,1,36,36
1657514899721,MATH 20C,B01,083762,Bach; Quang Tran,1,0,30,29
1657514905748,MATH 20D,A01,083765,Tran; Brian Kha,5,0,30,25
1657514905748,MATH 20D,A02,083766,Tran; Brian Kha,5,0,30,25
1657514905748,MATH 20D,A03,083767,Tran; Brian Kha,5,0,30,25
1657514911771,MATH 20E,A01,083771,Ganguly; Soumya,9,0,32,23
1657514911771,MATH 20E,A02,083772,Ganguly; Soumya,6,0,32,26
1657514911771,MATH 20E,B01,083773,Ciotti; Benjamin,20,0,35,15
1657514911771,MATH 20E,B02,083774,Ciotti; Benjamin,17,0,35,18
1657514917792,MATH 103A,A01,083777,Greenfeld; Be'Eri,3,0,36,33
1657514917792,MATH 103A,A02,083778,Greenfeld; Be'Eri,5,0,36,31
1657514917792,MATH 103A,A03,093561,Greenfeld; Be'Eri,5,0,36,31
1657514917792,MATH 103A,B01,083779,Greenfeld; Be'Eri,7,0,36,29
1657514917792,MATH 103A,B02,083780,Greenfeld; Be'Eri,4,0,36,32
1657514917792,MATH 103A,B03,093562,Greenfeld; Be'Eri,3,0,36,33
1657514923833,MATH 105,A01,085443,Carter; Anne Toulson,15,0,35,20
1657514923833,MATH 105,A02,093477,Carter; Anne Toulson,20,0,35,15
1657514929857,MATH 109,A01,083213,Ganzberger; Geoffrey Michael,2,0,34,32
1657514929857,MATH 109,A02,083214,Ganzberger; Geoffrey Michael,4,0,34,30
1657514929857,MATH 109,A03,093478,Ganzberger; Geoffrey Michael,2,0,34,32
1657514929857,MATH 109,B01,083215,Ganzberger; Geoffrey Michael,1,0,32,31
1657514929857,MATH 109,B02,083216,Ganzberger; Geoffrey Michael,2,0,32,30
1657514929857,MATH 109,B03,093479,Ganzberger; Geoffrey Michael,8,0,32,24
1657514935886,MATH 142A,A01,083219,Chow; Bennett,7,0,32,25
1657514935886,MATH 142A,A02,083220,Chow; Bennett,10,0,32,22
1657514935886,MATH 142A,A03,093480,Chow; Bennett,8,0,32,24
1657514935886,MATH 142A,B03,093481,Chow; Bennett,8,0,32,24
1657514935886,MATH 142A,B04,093558,Chow; Bennett,13,0,32,19
1657514935886,MATH 142A,B05,093559,Chow; Bennett,6,0,32,26
1657514941910,MATH 193A,A01,083224,Rotar; Vladimir,8,0,34,26
1657514941910,MATH 193A,A02,083225,Rotar; Vladimir,9,0,34,25
1657514941910,MATH 193A,A03,083781,Rotar; Vladimir,5,0,34,29
1657514941910,MATH 193A,A04,083782,Rotar; Vladimir,10,0,34,24
1657514941910,MATH 193A,A05,093482,Rotar; Vladimir,10,0,34,24
1657514947935,MATH 197,001,091859,McAuley; Julian John,9999,0,9999,0
1657514947935,MATH 197,002,095566,Kedlaya; Kiran S.,9997,0,9999,2
1657514947935,MATH 197,003,095567,Xiao; Ming,9999,0,9999,0
1657514947935,MATH 197,004,095571,Perols; Johan Lars,9998,0,9999,1
1657514954995,COGS 9,A01,083615,Shannon; Kyle Michael,9,0,75,66
1657514961021,COGS 11,A01,083617,Boyle; Mary E. T.,22,0,48,26
1657514967043,COGS 13,A01,083071,Bastos; Amalia Pinkusfeld,11,0,71,60
1657514973071,COGS 14A,A01,092681,Semenuks; Arturs,5,1,100,95
1657514979102,COGS 14B,A01,083073,Cheng; Tzu-Han,6,0,63,57
1657514985129,COGS 17,A01,092677,Semenuks; Arturs,6,0,81,75
1657514991151,COGS 100,A01,083619,Allen; Michael Gordon,17,0,70,53
1657514997177,COGS 101A,A01,083621,Davis; Joshua Daniel,9,0,68,59
1657515003203,COGS 101B,A01,091572,Allen; Michael Gordon,12,0,65,53
1657515009229,COGS 101C,A01,083625,Delgado; Tania,17,0,35,18
1657515015260,COGS 107A,A01,083627,Boyle; Mary E. T.,13,0,60,47
1657515021286,COGS 118A,A01,083075,Gupta; Anjum,21,0,76,55
1657515027313,CSE 3,A50,083646,Miranda; Gregory Joseph,24,0,50,26
1657515033337,CSE 8A,A50,083650,Miranda; Gregory Joseph,17,1,56,39
1657515039363,CSE 11,A01,083080,Cao; Yingjun,6,15,40,34
1657515045386,CSE 12,A01,083652,Krause-Levy; Sophia Louisa,28,1,120,92
1657515051412,CSE 15L,A01,083654,Morris; Justin Loren,9,0,50,41
1657515051412,CSE 15L,A02,083655,Morris; Justin Loren,9,0,50,41
1657515057435,CSE 20,A01,083657,Tran; Khoa Dang,39,0,80,41
1657515063465,CSE 21,A01,095574,Bach; Quang Tran,22,0,48,26
1657515069487,CSE 30,A01,083084,Eldon; John,5,0,80,75
1657515069487,CSE 30,B01,095061,Bhaskar; Nishant,9,0,50,41
1657515075512,CSE 100,A01,083659,Cao; Yingjun,5,4,70,65
1657515081541,CSE 134B,A01,083661,Powell; Thomas Allan,22,0,100,78
1657515087566,CSE 140,A01,083663,Gungor; Onat,15,0,85,70
1657515093589,CSE 140L,A01,083088,Eldon; John,21,0,100,79
1657515099612,CSE 175,A01,083665,Kumar; Rakesh,3,0,25,22
1657515105638,CSE 190,A00,092507,Dubnov; Shlomo,8,0,20,12
1657515111736,ECE 45,A01,083139,Congero; Spencer William,6,0,75,69
1657515117760,ECE 65,A50,083695,Saad; Andrew S,12,0,30,18
1657515117760,ECE 65,A51,095125,Saad; Andrew S,24,0,26,2
1657515123782,ECE 109,A01,091882,Touri; Behrouz,19,0,70,51
1657515129818,ECE 180,A00,083140,Abi Samra; Nicholas Camill,1,0,30,29
1657515129818,ECE 180,B00,083141,Abi Samra; Nicholas Camill,0,0,30,30
1657515135853,MATH 10A,A01,083735,Patchell; Gregory David,2,0,30,28
1657515135853,MATH 10A,A02,083736,Patchell; Gregory David,20,0,30,10
1657515135853,MATH 10A,A03,083737,Patchell; Gregory David,16,0,30,14
1657515141881,MATH 10B,A01,083207,Lim; Seonhee,8,0,34,26
1657515141881,MATH 10B,A02,083208,Lim; Seonhee,9,0,35,26
1657515141881,MATH 10B,A03,093472,Lim; Seonhee,7,0,34,27
1657515141881,MATH 10B,B01,083739,Sinha; Shubham,12,0,30,18
1657515147910,MATH 18,A01,083743,Cinel; Cameron Alexander,7,0,30,23
1657515147910,MATH 18,A02,083744,Cinel; Cameron Alexander,17,0,30,13
1657515147910,MATH 18,A03,083745,Cinel; Cameron Alexander,9,0,30,21
1657515147910,MATH 18,B01,083748,Rideout; David Porter,5,0,37,32
1657515147910,MATH 18,B02,083749,Rideout; David Porter,5,0,36,31
1657515147910,MATH 18,B03,083750,Rideout; David Porter,3,0,37,34
1657515147910,MATH 18,B04,083751,Rideout; David Porter,6,0,36,30
1657515147910,MATH 18,B05,093473,Rideout; David Porter,6,0,36,30
1657515147910,MATH 18,B06,093474,Rideout; David Porter,6,0,36,30
1657515153939,MATH 20A,A01,083754,Zheng; Zequn,14,0,40,26
1657515159963,MATH 20B,A01,083756,Briones; Jor-el Thomas Caparas,4,0,36,32
1657515159963,MATH 20B,A02,083757,Briones; Jor-el Thomas Caparas,1,0,36,35
1657515159963,MATH 20B,A03,093475,Briones; Jor-el Thomas Caparas,2,0,36,34
1657515165985,MATH 20C,A01,083760,Briones; Jor-el Thomas Caparas,1,0,35,34
1657515165985,MATH 20C,A02,083761,Briones; Jor-el Thomas Caparas,8,0,35,27
1657515165985,MATH 20C,A03,093476,Briones; Jor-el Thomas Caparas,0,1,36,36
1657515165985,MATH 20C,B01,083762,Bach; Quang Tran,1,0,30,29
1657515172014,MATH 20D,A01,083765,Tran; Brian Kha,5,0,30,25
1657515172014,MATH 20D,A02,083766,Tran; Brian Kha,5,0,30,25
1657515172014,MATH 20D,A03,083767,Tran; Brian Kha,5,0,30,25
1657515178039,MATH 20E,A01,083771,Ganguly; Soumya,9,0,32,23
1657515178039,MATH 20E,A02,083772,Ganguly; Soumya,6,0,32,26
1657515178039,MATH 20E,B01,083773,Ciotti; Benjamin,20,0,35,15
1657515178039,MATH 20E,B02,083774,Ciotti; Benjamin,17,0,35,18
1657515184064,MATH 103A,A01,083777,Greenfeld; Be'Eri,3,0,36,33
1657515184064,MATH 103A,A02,083778,Greenfeld; Be'Eri,5,0,36,31
1657515184064,MATH 103A,A03,093561,Greenfeld; Be'Eri,5,0,36,31
1657515184064,MATH 103A,B01,083779,Greenfeld; Be'Eri,7,0,36,29
1657515184064,MATH 103A,B02,083780,Greenfeld; Be'Eri,4,0,36,32
1657515184064,MATH 103A,B03,093562,Greenfeld; Be'Eri,3,0,36,33
1657515190087,MATH 105,A01,085443,Carter; Anne Toulson,15,0,35,20
1657515190087,MATH 105,A02,093477,Carter; Anne Toulson,20,0,35,15
1657515196114,MATH 109,A01,083213,Ganzberger; Geoffrey Michael,2,0,34,32
1657515196114,MATH 109,A02,083214,Ganzberger; Geoffrey Michael,4,0,34,30
1657515196114,MATH 109,A03,093478,Ganzberger; Geoffrey Michael,2,0,34,32
1657515196114,MATH 109,B01,083215,Ganzberger; Geoffrey Michael,1,0,32,31
1657515196114,MATH 109,B02,083216,Ganzberger; Geoffrey Michael,2,0,32,30
1657515196114,MATH 109,B03,093479,Ganzberger; Geoffrey Michael,8,0,32,24
1657515202138,MATH 142A,A01,083219,Chow; Bennett,7,0,32,25
1657515202138,MATH 142A,A02,083220,Chow; Bennett,10,0,32,22
1657515202138,MATH 142A,A03,093480,Chow; Bennett,8,0,32,24
1657515202138,MATH 142A,B03,093481,Chow; Bennett,8,0,32,24
1657515202138,MATH 142A,B04,093558,Chow; Bennett,13,0,32,19
1657515202138,MATH 142A,B05,093559,Chow; Bennett,6,0,32,26
1657515208166,MATH 193A,A01,083224,Rotar; Vladimir,8,0,34,26
1657515208166,MATH 193A,A02,083225,Rotar; Vladimir,9,0,34,25
1657515208166,MATH 193A,A03,083781,Rotar; Vladimir,5,0,34,29
1657515208166,MATH 193A,A04,083782,Rotar; Vladimir,10,0,34,24
1657515208166,MATH 193A,A05,093482,Rotar; Vladimir,10,0,34,24
1657515214198,MATH 197,001,091859,McAuley; Julian John,9999,0,9999,0
1657515214198,MATH 197,002,095566,Kedlaya; Kiran S.,9997,0,9999,2
1657515214198,MATH 197,003,095567,Xiao; Ming,9999,0,9999,0
1657515214198,MATH 197,004,095571,Perols; Johan Lars,9998,0,9999,1
1657515221258,COGS 9,A01,083615,Shannon; Kyle Michael,9,0,75,66
1657515227293,COGS 11,A01,083617,Boyle; Mary E. T.,22,0,48,26
1657515233321,COGS 13,A01,083071,Bastos; Amalia Pinkusfeld,11,0,71,60
1657515239342,COGS 14A,A01,092681,Semenuks; Arturs,5,1,100,95
1657515245367,COGS 14B,A01,083073,Cheng; Tzu-Han,6,0,63,57
1657515251391,COGS 17,A01,092677,Semenuks; Arturs,6,0,81,75
1657515257418,COGS 100,A01,083619,Allen; Michael Gordon,17,0,70,53
1657515263446,COGS 101A,A01,083621,Davis; Joshua Daniel,9,0,68,59
1657515269473,COGS 101B,A01,091572,Allen; Michael Gordon,12,0,65,53
1657515275499,COGS 101C,A01,083625,Delgado; Tania,17,0,35,18
1657515281524,COGS 107A,A01,083627,Boyle; Mary E. T.,13,0,60,47
1657515287549,COGS 118A,A01,083075,Gupta; Anjum,21,0,76,55
1657515293570,CSE 3,A50,083646,Miranda; Gregory Joseph,24,0,50,26
1657515299593,CSE 8A,A50,083650,Miranda; Gregory Joseph,17,1,56,39
1657515305626,CSE 11,A01,083080,Cao; Yingjun,6,15,40,34
1657515311648,CSE 12,A01,083652,Krause-Levy; Sophia Louisa,28,1,120,92
1657515317674,CSE 15L,A01,083654,Morris; Justin Loren,9,0,50,41
1657515317674,CSE 15L,A02,083655,Morris; Justin Loren,9,0,50,41
1657515323699,CSE 20,A01,083657,Tran; Khoa Dang,39,0,80,41
1657515329721,CSE 21,A01,095574,Bach; Quang Tran,22,0,48,26
1657515335744,CSE 30,A01,083084,Eldon; John,5,0,80,75
1657515335744,CSE 30,B01,095061,Bhaskar; Nishant,9,0,50,41
1657515341771,CSE 100,A01,083659,Cao; Yingjun,5,4,70,65
1657515347796,CSE 134B,A01,083661,Powell; Thomas Allan,22,0,100,78
1657515353820,CSE 140,A01,083663,Gungor; Onat,15,0,85,70
1657515359842,CSE 140L,A01,083088,Eldon; John,21,0,100,79
1657515365876,CSE 175,A01,083665,Kumar; Rakesh,3,0,25,22
1657515371900,CSE 190,A00,092507,Dubnov; Shlomo,8,0,20,12
1657515377923,ECE 45,A01,083139,Congero; Spencer William,6,0,75,69
1657515383947,ECE 65,A50,083695,Saad; Andrew S,12,0,30,18
1657515383947,ECE 65,A51,095125,Saad; Andrew S,24,0,26,2
1657515389970,ECE 109,A01,091882,Touri; Behrouz,19,0,70,51
1657515395993,ECE 180,A00,083140,Abi Samra; Nicholas Camill,1,0,30,29
1657515395993,ECE 180,B00,083141,Abi Samra; Nicholas Camill,0,0,30,30
1657515402021,MATH 10A,A01,083735,Patchell; Gregory David,2,0,30,28
1657515402021,MATH 10A,A02,083736,Patchell; Gregory David,20,0,30,10
1657515402021,MATH 10A,A03,083737,Patchell; Gregory David,16,0,30,14
1657515408044,MATH 10B,A01,083207,Lim; Seonhee,8,0,34,26
1657515408044,MATH 10B,A02,083208,Lim; Seonhee,9,0,35,26
1657515408044,MATH 10B,A03,093472,Lim; Seonhee,7,0,34,27
1657515408044,MATH 10B,B01,083739,Sinha; Shubham,12,0,30,18
1657515414069,MATH 18,A01,083743,Cinel; Cameron Alexander,7,0,30,23
1657515414069,MATH 18,A02,083744,Cinel; Cameron Alexander,17,0,30,13
1657515414069,MATH 18,A03,083745,Cinel; Cameron Alexander,9,0,30,21
1657515414069,MATH 18,B01,083748,Rideout; David Porter,5,0,37,32
1657515414069,MATH 18,B02,083749,Rideout; David Porter,5,0,36,31
1657515414069,MATH 18,B03,083750,Rideout; David Porter,3,0,37,34
1657515414069,MATH 18,B04,083751,Rideout; David Porter,6,0,36,30
1657515414069,MATH 18,B05,093473,Rideout; David Porter,6,0,36,30
1657515414069,MATH 18,B06,093474,Rideout; David Porter,6,0,36,30
1657515420096,MATH 20A,A01,083754,Zheng; Zequn,14,0,40,26
1657515426120,MATH 20B,A01,083756,Briones; Jor-el Thomas Caparas,4,0,36,32
1657515426120,MATH 20B,A02,083757,Briones; Jor-el Thomas Caparas,1,0,36,35
1657515426120,MATH 20B,A03,093475,Briones; Jor-el Thomas Caparas,2,0,36,34
1657515432156,MATH 20C,A01,083760,Briones; Jor-el Thomas Caparas,1,0,35,34
1657515432156,MATH 20C,A02,083761,Briones; Jor-el Thomas Caparas,8,0,35,27
1657515432156,MATH 20C,A03,093476,Briones; Jor-el Thomas Caparas,0,1,36,36
1657515432156,MATH 20C,B01,083762,Bach; Quang Tran,1,0,30,29
1657515438180,MATH 20D,A01,083765,Tran; Brian Kha,5,0,30,25
1657515438180,MATH 20D,A02,083766,Tran; Brian Kha,5,0,30,25
1657515438180,MATH 20D,A03,083767,Tran; Brian Kha,5,0,30,25
1657515444209,MATH 20E,A01,083771,Ganguly; Soumya,9,0,32,23
1657515444209,MATH 20E,A02,083772,Ganguly; Soumya,6,0,32,26
1657515444209,MATH 20E,B01,083773,Ciotti; Benjamin,20,0,35,15
1657515444209,MATH 20E,B02,083774,Ciotti; Benjamin,17,0,35,18
1657515450232,MATH 103A,A01,083777,Greenfeld; Be'Eri,3,0,36,33
1657515450232,MATH 103A,A02,083778,Greenfeld; Be'Eri,5,0,36,31
1657515450232,MATH 103A,A03,093561,Greenfeld; Be'Eri,5,0,36,31
1657515450232,MATH 103A,B01,083779,Greenfeld; Be'Eri,7,0,36,29
1657515450232,MATH 103A,B02,083780,Greenfeld; Be'Eri,4,0,36,32
1657515450232,MATH 103A,B03,093562,Greenfeld; Be'Eri,3,0,36,33
1657515456256,MATH 105,A01,085443,Carter; Anne Toulson,15,0,35,20
1657515456256,MATH 105,A02,093477,Carter; Anne Toulson,20,0,35,15
1657515462284,MATH 109,A01,083213,Ganzberger; Geoffrey Michael,2,0,34,32
1657515462284,MATH 109,A02,083214,Ganzberger; Geoffrey Michael,4,0,34,30
1657515462284,MATH 109,A03,093478,Ganzberger; Geoffrey Michael,2,0,34,32
1657515462284,MATH 109,B01,083215,Ganzberger; Geoffrey Michael,1,0,32,31
1657515462284,MATH 109,B02,083216,Ganzberger; Geoffrey Michael,2,0,32,30
1657515462284,MATH 109,B03,093479,Ganzberger; Geoffrey Michael,8,0,32,24
1657515468308,MATH 142A,A01,083219,Chow; Bennett,7,0,32,25
1657515468308,MATH 142A,A02,083220,Chow; Bennett,10,0,32,22
1657515468308,MATH 142A,A03,093480,Chow; Bennett,8,0,32,24
1657515468308,MATH 142A,B03,093481,Chow; Bennett,8,0,32,24
1657515468308,MATH 142A,B04,093558,Chow; Bennett,13,0,32,19
1657515468308,MATH 142A,B05,093559,Chow; Bennett,6,0,32,26
1657515474331,MATH 193A,A01,083224,Rotar; Vladimir,8,0,34,26
1657515474331,MATH 193A,A02,083225,Rotar; Vladimir,9,0,34,25
1657515474331,MATH 193A,A03,083781,Rotar; Vladimir,5,0,34,29
1657515474331,MATH 193A,A04,083782,Rotar; Vladimir,10,0,34,24
1657515474331,MATH 193A,A05,093482,Rotar; Vladimir,10,0,34,24
1657515480354,MATH 197,001,091859,McAuley; Julian John,9999,0,9999,0
1657515480354,MATH 197,002,095566,Kedlaya; Kiran S.,9997,0,9999,2
1657515480354,MATH 197,003,095567,Xiao; Ming,9999,0,9999,0
1657515480354,MATH 197,004,095571,Perols; Johan Lars,9998,0,9999,1
1657515487417,COGS 9,A01,083615,Shannon; Kyle Michael,9,0,75,66
1657515493440,COGS 11,A01,083617,Boyle; Mary E. T.,22,0,48,26
1657515499463,COGS 13,A01,083071,Bastos; Amalia Pinkusfeld,11,0,71,60
1657515505484,COGS 14A,A01,092681,Semenuks; Arturs,5,1,100,95
1657515511507,COGS 14B,A01,083073,Cheng; Tzu-Han,6,0,63,57
1657515517530,COGS 17,A01,092677,Semenuks; Arturs,6,0,81,75
1657515523552,COGS 100,A01,083619,Allen; Michael Gordon,17,0,70,53
1657515529575,COGS 101A,A01,083621,Davis; Joshua Daniel,9,0,68,59
1657515535603,COGS 101B,A01,091572,Allen; Michael Gordon,12,0,65,53
1657515541631,COGS 101C,A01,083625,Delgado; Tania,17,0,35,18
1657515547658,COGS 107A,A01,083627,Boyle; Mary E. T.,13,0,60,47
1657515553685,COGS 118A,A01,083075,Gupta; Anjum,21,0,76,55
1657515559715,CSE 3,A50,083646,Miranda; Gregory Joseph,24,0,50,26
1657515565763,CSE 8A,A50,083650,Miranda; Gregory Joseph,17,1,56,39
1657515571786,CSE 11,A01,083080,Cao; Yingjun,6,15,40,34
1657515577807,CSE 12,A01,083652,Krause-Levy; Sophia Louisa,28,1,120,92
1657515583830,CSE 15L,A01,083654,Morris; Justin Loren,9,0,50,41
1657515583830,CSE 15L,A02,083655,Morris; Justin Loren,9,0,50,41
1657515589852,CSE 20,A01,083657,Tran; Khoa Dang,39,0,80,41
1657515595875,CSE 21,A01,095574,Bach; Quang Tran,22,0,48,26
1657515601900,CSE 30,A01,083084,Eldon; John,5,0,80,75
1657515601900,CSE 30,B01,095061,Bhaskar; Nishant,9,0,50,41
1657515607928,CSE 100,A01,083659,Cao; Yingjun,5,4,70,65
1657515613952,CSE 134B,A01,083661,Powell; Thomas Allan,22,0,100,78
1657515619974,CSE 140,A01,083663,Gungor; Onat,15,0,85,70
1657515625998,CSE 140L,A01,083088,Eldon; John,21,0,100,79
1657515632023,CSE 175,A01,083665,Kumar; Rakesh,3,0,25,22
1657515638050,CSE 190,A00,092507,Dubnov; Shlomo,8,0,20,12
1657515644077,ECE 45,A01,083139,Congero; Spencer William,6,0,75,69
1657515650105,ECE 65,A50,083695,Saad; Andrew S,12,0,30,18
1657515650105,ECE 65,A51,095125,Saad; Andrew S,24,0,26,2
1657515656129,ECE 109,A01,091882,Touri; Behrouz,19,0,70,51
1657515662152,ECE 180,A00,083140,Abi Samra; Nicholas Camill,1,0,30,29
1657515662152,ECE 180,B00,083141,Abi Samra; Nicholas Camill,0,0,30,30
1657515668174,MATH 10A,A01,083735,Patchell; Gregory David,2,0,30,28
1657515668174,MATH 10A,A02,083736,Patchell; Gregory David,20,0,30,10
1657515668174,MATH 10A,A03,083737,Patchell; Gregory David,16,0,30,14
1657515674202,MATH 10B,A01,083207,Lim; Seonhee,8,0,34,26
1657515674202,MATH 10B,A02,083208,Lim; Seonhee,9,0,35,26
1657515674202,MATH 10B,A03,093472,Lim; Seonhee,7,0,34,27
1657515674202,MATH 10B,B01,083739,Sinha; Shubham,12,0,30,18
1657515680231,MATH 18,A01,083743,Cinel; Cameron Alexander,7,0,30,23
1657515680231,MATH 18,A02,083744,Cinel; Cameron Alexander,17,0,30,13
1657515680231,MATH 18,A03,083745,Cinel; Cameron Alexander,9,0,30,21
1657515680231,MATH 18,B01,083748,Rideout; David Porter,5,0,37,32
1657515680231,MATH 18,B02,083749,Rideout; David Porter,5,0,36,31
1657515680231,MATH 18,B03,083750,Rideout; David Porter,3,0,37,34
1657515680231,MATH 18,B04,083751,Rideout; David Porter,6,0,36,30
1657515680231,MATH 18,B05,093473,Rideout; David Porter,6,0,36,30
1657515680231,MATH 18,B06,093474,Rideout; David Porter,6,0,36,30
1657515686253,MATH 20A,A01,083754,Zheng; Zequn,14,0,40,26
1657515692281,MATH 20B,A01,083756,Briones; Jor-el Thomas Caparas,4,0,36,32
1657515692281,MATH 20B,A02,083757,Briones; Jor-el Thomas Caparas,1,0,36,35
1657515692281,MATH 20B,A03,093475,Briones; Jor-el Thomas Caparas,2,0,36,34
1657515698304,MATH 20C,A01,083760,Briones; Jor-el Thomas Caparas,1,0,35,34
1657515698304,MATH 20C,A02,083761,Briones; Jor-el Thomas Caparas,8,0,35,27
1657515698304,MATH 20C,A03,093476,Briones; Jor-el Thomas Caparas,0,1,36,36
1657515698304,MATH 20C,B01,083762,Bach; Quang Tran,1,0,30,29
1657515704338,MATH 20D,A01,083765,Tran; Brian Kha,5,0,30,25
1657515704338,MATH 20D,A02,083766,Tran; Brian Kha,5,0,30,25
1657515704338,MATH 20D,A03,083767,Tran; Brian Kha,5,0,30,25
1657515710438,MATH 20E,A01,083771,Ganguly; Soumya,9,0,32,23
1657515710438,MATH 20E,A02,083772,Ganguly; Soumya,6,0,32,26
1657515710438,MATH 20E,B01,083773,Ciotti; Benjamin,20,0,35,15
1657515710438,MATH 20E,B02,083774,Ciotti; Benjamin,17,0,35,18
1657515716466,MATH 103A,A01,083777,Greenfeld; Be'Eri,3,0,36,33
1657515716466,MATH 103A,A02,083778,Greenfeld; Be'Eri,5,0,36,31
1657515716466,MATH 103A,A03,093561,Greenfeld; Be'Eri,5,0,36,31
1657515716466,MATH 103A,B01,083779,Greenfeld; Be'Eri,7,0,36,29
1657515716466,MATH 103A,B02,083780,Greenfeld; Be'Eri,4,0,36,32
1657515716466,MATH 103A,B03,093562,Greenfeld; Be'Eri,3,0,36,33
1657515722490,MATH 105,A01,085443,Carter; Anne Toulson,15,0,35,20
1657515722490,MATH 105,A02,093477,Carter; Anne Toulson,20,0,35,15
1657515728518,MATH 109,A01,083213,Ganzberger; Geoffrey Michael,2,0,34,32
1657515728518,MATH 109,A02,083214,Ganzberger; Geoffrey Michael,4,0,34,30
1657515728518,MATH 109,A03,093478,Ganzberger; Geoffrey Michael,2,0,34,32
1657515728518,MATH 109,B01,083215,Ganzberger; Geoffrey Michael,1,0,32,31
1657515728518,MATH 109,B02,083216,Ganzberger; Geoffrey Michael,2,0,32,30
1657515728518,MATH 109,B03,093479,Ganzberger; Geoffrey Michael,8,0,32,24
1657515734543,MATH 142A,A01,083219,Chow; Bennett,7,0,32,25
1657515734543,MATH 142A,A02,083220,Chow; Bennett,10,0,32,22
1657515734543,MATH 142A,A03,093480,Chow; Bennett,8,0,32,24
1657515734543,MATH 142A,B03,093481,Chow; Bennett,8,0,32,24
1657515734543,MATH 142A,B04,093558,Chow; Bennett,13,0,32,19
1657515734543,MATH 142A,B05,093559,Chow; Bennett,6,0,32,26
1657515740568,MATH 193A,A01,083224,Rotar; Vladimir,8,0,34,26
1657515740568,MATH 193A,A02,083225,Rotar; Vladimir,9,0,34,25
1657515740568,MATH 193A,A03,083781,Rotar; Vladimir,5,0,34,29
1657515740568,MATH 193A,A04,083782,Rotar; Vladimir,10,0,34,24
1657515740568,MATH 193A,A05,093482,Rotar; Vladimir,10,0,34,24
1657515746592,MATH 197,001,091859,McAuley; Julian John,9999,0,9999,0
1657515746592,MATH 197,002,095566,Kedlaya; Kiran S.,9997,0,9999,2
1657515746592,MATH 197,003,095567,Xiao; Ming,9999,0,9999,0
1657515746592,MATH 197,004,095571,Perols; Johan Lars,9998,0,9999,1
1657515753646,COGS 9,A01,083615,Shannon; Kyle Michael,9,0,75,66
1657515759673,COGS 11,A01,083617,Boyle; Mary E. T.,22,0,48,26
1657515765696,COGS 13,A01,083071,Bastos; Amalia Pinkusfeld,11,0,71,60
1657515771726,COGS 14A,A01,092681,Semenuks; Arturs,5,1,100,95
1657515777750,COGS 14B,A01,083073,Cheng; Tzu-Han,6,0,63,57
1657515783777,COGS 17,A01,092677,Semenuks; Arturs,6,0,81,75
1657515789800,COGS 100,A01,083619,Allen; Michael Gordon,17,0,70,53
1657515795825,COGS 101A,A01,083621,Davis; Joshua Daniel,9,0,68,59
1657515801849,COGS 101B,A01,091572,Allen; Michael Gordon,12,0,65,53
1657515807878,COGS 101C,A01,083625,Delgado; Tania,17,0,35,18
1657515813903,COGS 107A,A01,083627,Boyle; Mary E. T.,13,0,60,47
1657515819926,COGS 118A,A01,083075,Gupta; Anjum,21,0,76,55
1657515825955,CSE 3,A50,083646,Miranda; Gregory Joseph,24,0,50,26
1657515831978,CSE 8A,A50,083650,Miranda; Gregory Joseph,17,1,56,39
1657515838004,CSE 11,A01,083080,Cao; Yingjun,6,15,40,34
1657515844030,CSE 12,A01,083652,Krause-Levy; Sophia Louisa,28,1,120,92
1657515850056,CSE 15L,A01,083654,Morris; Justin Loren,9,0,50,41
1657515850056,CSE 15L,A02,083655,Morris; Justin Loren,9,0,50,41
1657515856089,CSE 20,A01,083657,Tran; Khoa Dang,39,0,80,41
1657515862115,CSE 21,A01,095574,Bach; Quang Tran,22,0,48,26
1657515868143,CSE 30,A01,083084,Eldon; John,5,0,80,75
1657515868143,CSE 30,B01,095061,Bhaskar; Nishant,9,0,50,41
1657515874167,CSE 100,A01,083659,Cao; Yingjun,5,4,70,65
1657515880189,CSE 134B,A01,083661,Powell; Thomas Allan,22,0,100,78
1657515886214,CSE 140,A01,083663,Gungor; Onat,15,0,85,70
1657515892240,CSE 140L,A01,083088,Eldon; John,21,0,100,79
1657515898264,CSE 175,A01,083665,Kumar; Rakesh,3,0,25,22
1657515904290,CSE 190,A00,092507,Dubnov; Shlomo,8,0,20,12
1657515910313,ECE 45,A01,083139,Congero; Spencer William,6,0,75,69
1657515916337,ECE 65,A50,083695,Saad; Andrew S,12,0,30,18
1657515916337,ECE 65,A51,095125,Saad; Andrew S,24,0,26,2
1657515922363,ECE 109,A01,091882,Touri; Behrouz,19,0,70,51
1657515928390,ECE 180,A00,083140,Abi Samra; Nicholas Camill,1,0,30,29
1657515928390,ECE 180,B00,083141,Abi Samra; Nicholas Camill,0,0,30,30
1657515934417,MATH 10A,A01,083735,Patchell; Gregory David,2,0,30,28
1657515934417,MATH 10A,A02,083736,Patchell; Gregory David,20,0,30,10
1657515934417,MATH 10A,A03,083737,Patchell; Gregory David,16,0,30,14
1657515940439,MATH 10B,A01,083207,Lim; Seonhee,8,0,34,26
1657515940439,MATH 10B,A02,083208,Lim; Seonhee,9,0,35,26
1657515940439,MATH 10B,A03,093472,Lim; Seonhee,7,0,34,27
1657515940439,MATH 10B,B01,083739,Sinha; Shubham,12,0,30,18
1657515946469,MATH 18,A01,083743,Cinel; Cameron Alexander,7,0,30,23
1657515946469,MATH 18,A02,083744,Cinel; Cameron Alexander,17,0,30,13
1657515946469,MATH 18,A03,083745,Cinel; Cameron Alexander,9,0,30,21
1657515946469,MATH 18,B01,083748,Rideout; David Porter,5,0,37,32
1657515946469,MATH 18,B02,083749,Rideout; David Porter,5,0,36,31
1657515946469,MATH 18,B03,083750,Rideout; David Porter,3,0,37,34
1657515946469,MATH 18,B04,083751,Rideout; David Porter,6,0,36,30
1657515946469,MATH 18,B05,093473,Rideout; David Porter,6,0,36,30
1657515946469,MATH 18,B06,093474,Rideout; David Porter,6,0,36,30
1657515952500,MATH 20A,A01,083754,Zheng; Zequn,14,0,40,26
1657515958524,MATH 20B,A01,083756,Briones; Jor-el Thomas Caparas,4,0,36,32
1657515958524,MATH 20B,A02,083757,Briones; Jor-el Thomas Caparas,1,0,36,35
1657515958524,MATH 20B,A03,093475,Briones; Jor-el Thomas Caparas,2,0,36,34
1657515964546,MATH 20C,A01,083760,Briones; Jor-el Thomas Caparas,1,0,35,34
1657515964546,MATH 20C,A02,083761,Briones; Jor-el Thomas Caparas,8,0,35,27
1657515964546,MATH 20C,A03,093476,Briones; Jor-el Thomas Caparas,0,1,36,36
1657515964546,MATH 20C,B01,083762,Bach; Quang Tran,1,0,30,29
1657515970577,MATH 20D,A01,083765,Tran; Brian Kha,5,0,30,25
1657515970577,MATH 20D,A02,083766,Tran; Brian Kha,5,0,30,25
1657515970577,MATH 20D,A03,083767,Tran; Brian Kha,5,0,30,25
1657515976607,MATH 20E,A01,083771,Ganguly; Soumya,9,0,32,23
1657515976607,MATH 20E,A02,083772,Ganguly; Soumya,6,0,32,26
1657515976607,MATH 20E,B01,083773,Ciotti; Benjamin,20,0,35,15
1657515976607,MATH 20E,B02,083774,Ciotti; Benjamin,17,0,35,18
1657515982635,MATH 103A,A01,083777,Greenfeld; Be'Eri,3,0,36,33
1657515982635,MATH 103A,A02,083778,Greenfeld; Be'Eri,5,0,36,31
1657515982635,MATH 103A,A03,093561,Greenfeld; Be'Eri,5,0,36,31
1657515982635,MATH 103A,B01,083779,Greenfeld; Be'Eri,7,0,36,29
1657515982635,MATH 103A,B02,083780,Greenfeld; Be'Eri,4,0,36,32
1657515982635,MATH 103A,B03,093562,Greenfeld; Be'Eri,3,0,36,33
1657515988658,MATH 105,A01,085443,Carter; Anne Toulson,15,0,35,20
1657515988658,MATH 105,A02,093477,Carter; Anne Toulson,20,0,35,15
1657515994688,MATH 109,A01,083213,Ganzberger; Geoffrey Michael,2,0,34,32
1657515994688,MATH 109,A02,083214,Ganzberger; Geoffrey Michael,4,0,34,30
1657515994688,MATH 109,A03,093478,Ganzberger; Geoffrey Michael,2,0,34,32
1657515994688,MATH 109,B01,083215,Ganzberger; Geoffrey Michael,1,0,32,31
1657515994688,MATH 109,B02,083216,Ganzberger; Geoffrey Michael,2,0,32,30
1657515994688,MATH 109,B03,093479,Ganzberger; Geoffrey Michael,8,0,32,24
1657516000711,MATH 142A,A01,083219,Chow; Bennett,7,0,32,25
1657516000711,MATH 142A,A02,083220,Chow; Bennett,10,0,32,22
1657516000711,MATH 142A,A03,093480,Chow; Bennett,8,0,32,24
1657516000711,MATH 142A,B03,093481,Chow; Bennett,8,0,32,24
1657516000711,MATH 142A,B04,093558,Chow; Bennett,13,0,32,19
1657516000711,MATH 142A,B05,093559,Chow; Bennett,6,0,32,26
1657516006738,MATH 193A,A01,083224,Rotar; Vladimir,8,0,34,26
1657516006738,MATH 193A,A02,083225,Rotar; Vladimir,9,0,34,25
1657516006738,MATH 193A,A03,083781,Rotar; Vladimir,5,0,34,29
1657516006738,MATH 193A,A04,083782,Rotar; Vladimir,10,0,34,24
1657516006738,MATH 193A,A05,093482,Rotar; Vladimir,10,0,34,24
1657516012763,MATH 197,001,091859,McAuley; Julian John,9999,0,9999,0
1657516012763,MATH 197,002,095566,Kedlaya; Kiran S.,9997,0,9999,2
1657516012763,MATH 197,003,095567,Xiao; Ming,9999,0,9999,0
1657516012763,MATH 197,004,095571,Perols; Johan Lars,9998,0,9999,1
1657516019828,COGS 9,A01,083615,Shannon; Kyle Michael,9,0,75,66
1657516025854,COGS 11,A01,083617,Boyle; Mary E. T.,22,0,48,26
1657516031878,COGS 13,A01,083071,Bastos; Amalia Pinkusfeld,11,0,71,60
1657516037901,COGS 14A,A01,092681,Semenuks; Arturs,5,1,100,95
1657516043929,COGS 14B,A01,083073,Cheng; Tzu-Han,6,0,63,57
1657516049958,COGS 17,A01,092677,Semenuks; Arturs,6,0,81,75
1657516055982,COGS 100,A01,083619,Allen; Michael Gordon,17,0,70,53
1657516062006,COGS 101A,A01,083621,Davis; Joshua Daniel,9,0,68,59
1657516068033,COGS 101B,A01,091572,Allen; Michael Gordon,12,0,65,53
1657516074057,COGS 101C,A01,083625,Delgado; Tania,17,0,35,18
1657516080085,COGS 107A,A01,083627,Boyle; Mary E. T.,13,0,60,47
1657516086117,COGS 118A,A01,083075,Gupta; Anjum,21,0,76,55
1657516092141,CSE 3,A50,083646,Miranda; Gregory Joseph,24,0,50,26
1657516098162,CSE 8A,A50,083650,Miranda; Gregory Joseph,17,1,56,39
1657516104185,CSE 11,A01,083080,Cao; Yingjun,6,15,40,34
1657516110213,CSE 12,A01,083652,Krause-Levy; Sophia Louisa,28,1,120,92
1657516116242,CSE 15L,A01,083654,Morris; Justin Loren,9,0,50,41
1657516116242,CSE 15L,A02,083655,Morris; Justin Loren,9,0,50,41
1657516122269,CSE 20,A01,083657,Tran; Khoa Dang,39,0,80,41
1657516128302,CSE 21,A01,095574,Bach; Quang Tran,22,0,48,26
1657516134329,CSE 30,A01,083084,Eldon; John,5,0,80,75
1657516134329,CSE 30,B01,095061,Bhaskar; Nishant,9,0,50,41
1657516140351,CSE 100,A01,083659,Cao; Yingjun,5,4,70,65
1657516146380,CSE 134B,A01,083661,Powell; Thomas Allan,22,0,100,78
1657516152404,CSE 140,A01,083663,Gungor; Onat,15,0,85,70
1657516158431,CSE 140L,A01,083088,Eldon; John,21,0,100,79
1657516164457,CSE 175,A01,083665,Kumar; Rakesh,3,0,25,22
1657516170481,CSE 190,A00,092507,Dubnov; Shlomo,8,0,20,12
1657516176510,ECE 45,A01,083139,Congero; Spencer William,6,0,75,69
1657516182544,ECE 65,A50,083695,Saad; Andrew S,12,0,30,18
1657516182544,ECE 65,A51,095125,Saad; Andrew S,24,0,26,2
1657516188582,ECE 109,A01,091882,Touri; Behrouz,19,0,70,51
1657516194615,ECE 180,A00,083140,Abi Samra; Nicholas Camill,1,0,30,29
1657516194615,ECE 180,B00,083141,Abi Samra; Nicholas Camill,0,0,30,30
1657516200643,MATH 10A,A01,083735,Patchell; Gregory David,2,0,30,28
1657516200643,MATH 10A,A02,083736,Patchell; Gregory David,20,0,30,10
1657516200643,MATH 10A,A03,083737,Patchell; Gregory David,16,0,30,14
1657516206667,MATH 10B,A01,083207,Lim; Seonhee,8,0,34,26
1657516206667,MATH 10B,A02,083208,Lim; Seonhee,9,0,35,26
1657516206667,MATH 10B,A03,093472,Lim; Seonhee,7,0,34,27
1657516206667,MATH 10B,B01,083739,Sinha; Shubham,12,0,30,18
1657516212691,MATH 18,A01,083743,Cinel; Cameron Alexander,7,0,30,23
1657516212691,MATH 18,A02,083744,Cinel; Cameron Alexander,17,0,30,13
1657516212691,MATH 18,A03,083745,Cinel; Cameron Alexander,9,0,30,21
1657516212691,MATH 18,B01,083748,Rideout; David Porter,5,0,37,32
1657516212691,MATH 18,B02,083749,Rideout; David Porter,5,0,36,31
1657516212691,MATH 18,B03,083750,Rideout; David Porter,3,0,37,34
1657516212691,MATH 18,B04,083751,Rideout; David Porter,6,0,36,30
1657516212691,MATH 18,B05,093473,Rideout; David Porter,6,0,36,30
1657516212691,MATH 18,B06,093474,Rideout; David Porter,6,0,36,30
1657516218714,MATH 20A,A01,083754,Zheng; Zequn,14,0,40,26
1657516224741,MATH 20B,A01,083756,Briones; Jor-el Thomas Caparas,4,0,36,32
1657516224741,MATH 20B,A02,083757,Briones; Jor-el Thomas Caparas,1,0,36,35
1657516224741,MATH 20B,A03,093475,Briones; Jor-el Thomas Caparas,2,0,36,34
1657516230769,MATH 20C,A01,083760,Briones; Jor-el Thomas Caparas,1,0,35,34
1657516230769,MATH 20C,A02,083761,Briones; Jor-el Thomas Caparas,8,0,35,27
1657516230769,MATH 20C,A03,093476,Briones; Jor-el Thomas Caparas,0,1,36,36
1657516230769,MATH 20C,B01,083762,Bach; Quang Tran,1,0,30,29
1657516236794,MATH 20D,A01,083765,Tran; Brian Kha,5,0,30,25
1657516236794,MATH 20D,A02,083766,Tran; Brian Kha,5,0,30,25
1657516236794,MATH 20D,A03,083767,Tran; Brian Kha,5,0,30,25
1657516242823,MATH 20E,A01,083771,Ganguly; Soumya,9,0,32,23
1657516242823,MATH 20E,A02,083772,Ganguly; Soumya,6,0,32,26
1657516242823,MATH 20E,B01,083773,Ciotti; Benjamin,20,0,35,15
1657516242823,MATH 20E,B02,083774,Ciotti; Benjamin,17,0,35,18
1657516248849,MATH 103A,A01,083777,Greenfeld; Be'Eri,3,0,36,33
1657516248849,MATH 103A,A02,083778,Greenfeld; Be'Eri,5,0,36,31
1657516248849,MATH 103A,A03,093561,Greenfeld; Be'Eri,5,0,36,31
1657516248849,MATH 103A,B01,083779,Greenfeld; Be'Eri,7,0,36,29
1657516248849,MATH 103A,B02,083780,Greenfeld; Be'Eri,4,0,36,32
1657516248849,MATH 103A,B03,093562,Greenfeld; Be'Eri,3,0,36,33
1657516254871,MATH 105,A01,085443,Carter; Anne Toulson,15,0,35,20
1657516254871,MATH 105,A02,093477,Carter; Anne Toulson,20,0,35,15
1657516260896,MATH 109,A01,083213,Ganzberger; Geoffrey Michael,2,0,34,32
1657516260896,MATH 109,A02,083214,Ganzberger; Geoffrey Michael,4,0,34,30
1657516260896,MATH 109,A03,093478,Ganzberger; Geoffrey Michael,2,0,34,32
1657516260896,MATH 109,B01,083215,Ganzberger; Geoffrey Michael,1,0,32,31
1657516260896,MATH 109,B02,083216,Ganzberger; Geoffrey Michael,2,0,32,30
1657516260896,MATH 109,B03,093479,Ganzberger; Geoffrey Michael,8,0,32,24
1657516266918,MATH 142A,A01,083219,Chow; Bennett,7,0,32,25
1657516266918,MATH 142A,A02,083220,Chow; Bennett,10,0,32,22
1657516266918,MATH 142A,A03,093480,Chow; Bennett,8,0,32,24
1657516266918,MATH 142A,B03,093481,Chow; Bennett,8,0,32,24
1657516266918,MATH 142A,B04,093558,Chow; Bennett,13,0,32,19
1657516266918,MATH 142A,B05,093559,Chow; Bennett,6,0,32,26
1657516272952,MATH 193A,A01,083224,Rotar; Vladimir,8,0,34,26
1657516272952,MATH 193A,A02,083225,Rotar; Vladimir,9,0,34,25
1657516272952,MATH 193A,A03,083781,Rotar; Vladimir,5,0,34,29
1657516272952,MATH 193A,A04,083782,Rotar; Vladimir,10,0,34,24
1657516272952,MATH 193A,A05,093482,Rotar; Vladimir,10,0,34,24
1657516278976,MATH 197,001,091859,McAuley; Julian John,9999,0,9999,0
1657516278976,MATH 197,002,095566,Kedlaya; Kiran S.,9997,0,9999,2
1657516278976,MATH 197,003,095567,Xiao; Ming,9999,0,9999,0
1657516278976,MATH 197,004,095571,Perols; Johan Lars,9998,0,9999,1
1657516286029,COGS 9,A01,083615,Shannon; Kyle Michael,9,0,75,66
1657516292052,COGS 11,A01,083617,Boyle; Mary E. T.,22,0,48,26
1657516298077,COGS 13,A01,083071,Bastos; Amalia Pinkusfeld,11,0,71,60
1657516304174,COGS 14A,A01,092681,Semenuks; Arturs,5,1,100,95
1657516310201,COGS 14B,A01,083073,Cheng; Tzu-Han,6,0,63,57
1657516316227,COGS 17,A01,092677,Semenuks; Arturs,6,0,81,75
1657516322251,COGS 100,A01,083619,Allen; Michael Gordon,17,0,70,53
1657516328277,COGS 101A,A01,083621,Davis; Joshua Daniel,9,0,68,59
1657516334304,COGS 101B,A01,091572,Allen; Michael Gordon,12,0,65,53
1657516340330,COGS 101C,A01,083625,Delgado; Tania,17,0,35,18
1657516346354,COGS 107A,A01,083627,Boyle; Mary E. T.,13,0,60,47
1657516352375,COGS 118A,A01,083075,Gupta; Anjum,21,0,76,55
1657516358404,CSE 3,A50,083646,Miranda; Gregory Joseph,24,0,50,26
1657516364427,CSE 8A,A50,083650,Miranda; Gregory Joseph,17,1,56,39
1657516370450,CSE 11,A01,083080,Cao; Yingjun,6,15,40,34
1657516376475,CSE 12,A01,083652,Krause-Levy; Sophia Louisa,28,1,120,92
1657516382503,CSE 15L,A01,083654,Morris; Justin Loren,9,0,50,41
1657516382503,CSE 15L,A02,083655,Morris; Justin Loren,9,0,50,41
1657516388530,CSE 20,A01,083657,Tran; Khoa Dang,39,0,80,41
1657516394555,CSE 21,A01,095574,Bach; Quang Tran,22,0,48,26
1657516400582,CSE 30,A01,083084,Eldon; John,5,0,80,75
1657516400582,CSE 30,B01,095061,Bhaskar; Nishant,9,0,50,41
1657516406609,CSE 100,A01,083659,Cao; Yingjun,5,4,70,65
1657516412635,CSE 134B,A01,083661,Powell; Thomas Allan,22,0,100,78
1657516418661,CSE 140,A01,083663,Gungor; Onat,15,0,85,70
1657516424719,CSE 140L,A01,083088,Eldon; John,21,0,100,79
1657516430742,CSE 175,A01,083665,Kumar; Rakesh,3,0,25,22
1657516436768,CSE 190,A00,092507,Dubnov; Shlomo,8,0,20,12
1657516442794,ECE 45,A01,083139,Congero; Spencer William,6,0,75,69
1657516448816,ECE 65,A50,083695,Saad; Andrew S,12,0,30,18
1657516448816,ECE 65,A51,095125,Saad; Andrew S,24,0,26,2
1657516454841,ECE 109,A01,091882,Touri; Behrouz,19,0,70,51
1657516460866,ECE 180,A00,083140,Abi Samra; Nicholas Camill,1,0,30,29
1657516460866,ECE 180,B00,083141,Abi Samra; Nicholas Camill,0,0,30,30
1657516466892,MATH 10A,A01,083735,Patchell; Gregory David,2,0,30,28
1657516466892,MATH 10A,A02,083736,Patchell; Gregory David,20,0,30,10
1657516466892,MATH 10A,A03,083737,Patchell; Gregory David,16,0,30,14
1657516472915,MATH 10B,A01,083207,Lim; Seonhee,8,0,34,26
1657516472915,MATH 10B,A02,083208,Lim; Seonhee,9,0,35,26
1657516472915,MATH 10B,A03,093472,Lim; Seonhee,7,0,34,27
1657516472915,MATH 10B,B01,083739,Sinha; Shubham,12,0,30,18
1657516478944,MATH 18,A01,083743,Cinel; Cameron Alexander,7,0,30,23
1657516478944,MATH 18,A02,083744,Cinel; Cameron Alexander,17,0,30,13
1657516478944,MATH 18,A03,083745,Cinel; Cameron Alexander,9,0,30,21
1657516478944,MATH 18,B01,083748,Rideout; David Porter,5,0,37,32
1657516478944,MATH 18,B02,083749,Rideout; David Porter,5,0,36,31
1657516478944,MATH 18,B03,083750,Rideout; David Porter,3,0,37,34
1657516478944,MATH 18,B04,083751,Rideout; David Porter,6,0,36,30
1657516478944,MATH 18,B05,093473,Rideout; David Porter,6,0,36,30
1657516478944,MATH 18,B06,093474,Rideout; David Porter,6,0,36,30
1657516484971,MATH 20A,A01,083754,Zheng; Zequn,14,0,40,26
1657516490999,MATH 20B,A01,083756,Briones; Jor-el Thomas Caparas,4,0,36,32
1657516490999,MATH 20B,A02,083757,Briones; Jor-el Thomas Caparas,1,0,36,35
1657516490999,MATH 20B,A03,093475,Briones; Jor-el Thomas Caparas,2,0,36,34
1657516497027,MATH 20C,A01,083760,Briones; Jor-el Thomas Caparas,1,0,35,34
1657516497027,MATH 20C,A02,083761,Briones; Jor-el Thomas Caparas,8,0,35,27
1657516497027,MATH 20C,A03,093476,Briones; Jor-el Thomas Caparas,0,1,36,36
1657516497027,MATH 20C,B01,083762,Bach; Quang Tran,1,0,30,29
1657516503050,MATH 20D,A01,083765,Tran; Brian Kha,5,0,30,25
1657516503050,MATH 20D,A02,083766,Tran; Brian Kha,5,0,30,25
1657516503050,MATH 20D,A03,083767,Tran; Brian Kha,5,0,30,25
1657516509079,MATH 20E,A01,083771,Ganguly; Soumya,9,0,32,23
1657516509079,MATH 20E,A02,083772,Ganguly; Soumya,6,0,32,26
1657516509079,MATH 20E,B01,083773,Ciotti; Benjamin,20,0,35,15
1657516509079,MATH 20E,B02,083774,Ciotti; Benjamin,17,0,35,18
1657516515107,MATH 103A,A01,083777,Greenfeld; Be'Eri,3,0,36,33
1657516515107,MATH 103A,A02,083778,Greenfeld; Be'Eri,5,0,36,31
1657516515107,MATH 103A,A03,093561,Greenfeld; Be'Eri,5,0,36,31
1657516515107,MATH 103A,B01,083779,Greenfeld; Be'Eri,7,0,36,29
1657516515107,MATH 103A,B02,083780,Greenfeld; Be'Eri,4,0,36,32
1657516515107,MATH 103A,B03,093562,Greenfeld; Be'Eri,3,0,36,33
1657516521131,MATH 105,A01,085443,Carter; Anne Toulson,15,0,35,20
1657516521131,MATH 105,A02,093477,Carter; Anne Toulson,20,0,35,15
1657516527154,MATH 109,A01,083213,Ganzberger; Geoffrey Michael,2,0,34,32
1657516527154,MATH 109,A02,083214,Ganzberger; Geoffrey Michael,4,0,34,30
1657516527154,MATH 109,A03,093478,Ganzberger; Geoffrey Michael,2,0,34,32
1657516527154,MATH 109,B01,083215,Ganzberger; Geoffrey Michael,1,0,32,31
1657516527154,MATH 109,B02,083216,Ganzberger; Geoffrey Michael,2,0,32,30
1657516527154,MATH 109,B03,093479,Ganzberger; Geoffrey Michael,8,0,32,24
1657516533176,MATH 142A,A01,083219,Chow; Bennett,7,0,32,25
1657516533176,MATH 142A,A02,083220,Chow; Bennett,10,0,32,22
1657516533176,MATH 142A,A03,093480,Chow; Bennett,8,0,32,24
1657516533176,MATH 142A,B03,093481,Chow; Bennett,8,0,32,24
1657516533176,MATH 142A,B04,093558,Chow; Bennett,13,0,32,19
1657516533176,MATH 142A,B05,093559,Chow; Bennett,6,0,32,26
1657516539203,MATH 193A,A01,083224,Rotar; Vladimir,8,0,34,26
1657516539203,MATH 193A,A02,083225,Rotar; Vladimir,9,0,34,25
1657516539203,MATH 193A,A03,083781,Rotar; Vladimir,5,0,34,29
1657516539203,MATH 193A,A04,083782,Rotar; Vladimir,10,0,34,24
1657516539203,MATH 193A,A05,093482,Rotar; Vladimir,10,0,34,24
1657516545228,MATH 197,001,091859,McAuley; Julian John,9999,0,9999,0
1657516545228,MATH 197,002,095566,Kedlaya; Kiran S.,9997,0,9999,2
1657516545228,MATH 197,003,095567,Xiao; Ming,9999,0,9999,0
1657516545228,MATH 197,004,095571,Perols; Johan Lars,9998,0,9999,1
1657516552290,COGS 9,A01,083615,Shannon; Kyle Michael,9,0,75,66
1657516558314,COGS 11,A01,083617,Boyle; Mary E. T.,22,0,48,26
1657516564340,COGS 13,A01,083071,Bastos; Amalia Pinkusfeld,11,0,71,60
1657516570366,COGS 14A,A01,092681,Semenuks; Arturs,5,1,100,95
1657516576391,COGS 14B,A01,083073,Cheng; Tzu-Han,6,0,63,57
1657516582417,COGS 17,A01,092677,Semenuks; Arturs,6,0,81,75
1657516588441,COGS 100,A01,083619,Allen; Michael Gordon,17,0,70,53
1657516594464,COGS 101A,A01,083621,Davis; Joshua Daniel,9,0,68,59
1657516600487,COGS 101B,A01,091572,Allen; Michael Gordon,12,0,65,53
1657516606514,COGS 101C,A01,083625,Delgado; Tania,17,0,35,18
1657516612542,COGS 107A,A01,083627,Boyle; Mary E. T.,13,0,60,47
1657516618574,COGS 118A,A01,083075,Gupta; Anjum,21,0,76,55
1657516624600,CSE 3,A50,083646,Miranda; Gregory Joseph,24,0,50,26
1657516630622,CSE 8A,A50,083650,Miranda; Gregory Joseph,17,1,56,39
1657516636645,CSE 11,A01,083080,Cao; Yingjun,6,15,40,34
1657516642668,CSE 12,A01,083652,Krause-Levy; Sophia Louisa,28,1,120,92
1657516648690,CSE 15L,A01,083654,Morris; Justin Loren,9,0,50,41
1657516648690,CSE 15L,A02,083655,Morris; Justin Loren,9,0,50,41
1657516654718,CSE 20,A01,083657,Tran; Khoa Dang,39,0,80,41
1657516660749,CSE 21,A01,095574,Bach; Quang Tran,22,0,48,26
1657516666775,CSE 30,A01,083084,Eldon; John,5,0,80,75
1657516666775,CSE 30,B01,095061,Bhaskar; Nishant,9,0,50,41
1657516672798,CSE 100,A01,083659,Cao; Yingjun,5,4,70,65
1657516678825,CSE 134B,A01,083661,Powell; Thomas Allan,22,0,100,78
1657516684847,CSE 140,A01,083663,Gungor; Onat,15,0,85,70
1657516690869,CSE 140L,A01,083088,Eldon; John,21,0,100,79
1657516696892,CSE 175,A01,083665,Kumar; Rakesh,3,0,25,22
1657516702914,CSE 190,A00,092507,Dubnov; Shlomo,8,0,20,12
1657516708941,ECE 45,A01,083139,Congero; Spencer William,6,0,75,69
1657516714964,ECE 65,A50,083695,Saad; Andrew S,12,0,30,18
1657516714964,ECE 65,A51,095125,Saad; Andrew S,24,0,26,2
1657516720987,ECE 109,A01,091882,Touri; Behrouz,19,0,70,51
1657516727032,ECE 180,A00,083140,Abi Samra; Nicholas Camill,1,0,30,29
1657516727032,ECE 180,B00,083141,Abi Samra; Nicholas Camill,0,0,30,30
1657516733059,MATH 10A,A01,083735,Patchell; Gregory David,2,0,30,28
1657516733059,MATH 10A,A02,083736,Patchell; Gregory David,20,0,30,10
1657516733059,MATH 10A,A03,083737,Patchell; Gregory David,16,0,30,14
1657516739087,MATH 10B,A01,083207,Lim; Seonhee,8,0,34,26
1657516739087,MATH 10B,A02,083208,Lim; Seonhee,9,0,35,26
1657516739087,MATH 10B,A03,093472,Lim; Seonhee,7,0,34,27
1657516739087,MATH 10B,B01,083739,Sinha; Shubham,12,0,30,18
1657516745111,MATH 18,A01,083743,Cinel; Cameron Alexander,7,0,30,23
1657516745111,MATH 18,A02,083744,Cinel; Cameron Alexander,17,0,30,13
1657516745111,MATH 18,A03,083745,Cinel; Cameron Alexander,9,0,30,21
1657516745111,MATH 18,B01,083748,Rideout; David Porter,5,0,37,32
1657516745111,MATH 18,B02,083749,Rideout; David Porter,5,0,36,31
1657516745111,MATH 18,B03,083750,Rideout; David Porter,3,0,37,34
1657516745111,MATH 18,B04,083751,Rideout; David Porter,6,0,36,30
1657516745111,MATH 18,B05,093473,Rideout; David Porter,6,0,36,30
1657516745111,MATH 18,B06,093474,Rideout; David Porter,6,0,36,30
1657516751134,MATH 20A,A01,083754,Zheng; Zequn,14,0,40,26
1657516757165,MATH 20B,A01,083756,Briones; Jor-el Thomas Caparas,4,0,36,32
1657516757165,MATH 20B,A02,083757,Briones; Jor-el Thomas Caparas,1,0,36,35
1657516757165,MATH 20B,A03,093475,Briones; Jor-el Thomas Caparas,2,0,36,34
1657516763187,MATH 20C,A01,083760,Briones; Jor-el Thomas Caparas,1,0,35,34
1657516763187,MATH 20C,A02,083761,Briones; Jor-el Thomas Caparas,8,0,35,27
1657516763187,MATH 20C,A03,093476,Briones; Jor-el Thomas Caparas,0,1,36,36
1657516763187,MATH 20C,B01,083762,Bach; Quang Tran,1,0,30,29
1657516769215,MATH 20D,A01,083765,Tran; Brian Kha,5,0,30,25
1657516769215,MATH 20D,A02,083766,Tran; Brian Kha,5,0,30,25
1657516769215,MATH 20D,A03,083767,Tran; Brian Kha,5,0,30,25
1657516775244,MATH 20E,A01,083771,Ganguly; Soumya,9,0,32,23
1657516775244,MATH 20E,A02,083772,Ganguly; Soumya,6,0,32,26
1657516775244,MATH 20E,B01,083773,Ciotti; Benjamin,20,0,35,15
1657516775244,MATH 20E,B02,083774,Ciotti; Benjamin,17,0,35,18
1657516781266,MATH 103A,A01,083777,Greenfeld; Be'Eri,3,0,36,33
1657516781266,MATH 103A,A02,083778,Greenfeld; Be'Eri,5,0,36,31
1657516781266,MATH 103A,A03,093561,Greenfeld; Be'Eri,5,0,36,31
1657516781266,MATH 103A,B01,083779,Greenfeld; Be'Eri,7,0,36,29
1657516781266,MATH 103A,B02,083780,Greenfeld; Be'Eri,4,0,36,32
1657516781266,MATH 103A,B03,093562,Greenfeld; Be'Eri,3,0,36,33
1657516787294,MATH 105,A01,085443,Carter; Anne Toulson,15,0,35,20
1657516787294,MATH 105,A02,093477,Carter; Anne Toulson,20,0,35,15
1657516793317,MATH 109,A01,083213,Ganzberger; Geoffrey Michael,2,0,34,32
1657516793317,MATH 109,A02,083214,Ganzberger; Geoffrey Michael,4,0,34,30
1657516793317,MATH 109,A03,093478,Ganzberger; Geoffrey Michael,2,0,34,32
1657516793317,MATH 109,B01,083215,Ganzberger; Geoffrey Michael,1,0,32,31
1657516793317,MATH 109,B02,083216,Ganzberger; Geoffrey Michael,2,0,32,30
1657516793317,MATH 109,B03,093479,Ganzberger; Geoffrey Michael,8,0,32,24
1657516799342,MATH 142A,A01,083219,Chow; Bennett,7,0,32,25
1657516799342,MATH 142A,A02,083220,Chow; Bennett,10,0,32,22
1657516799342,MATH 142A,A03,093480,Chow; Bennett,8,0,32,24
1657516799342,MATH 142A,B03,093481,Chow; Bennett,8,0,32,24
1657516799342,MATH 142A,B04,093558,Chow; Bennett,13,0,32,19
1657516799342,MATH 142A,B05,093559,Chow; Bennett,6,0,32,26
1657516805365,MATH 193A,A01,083224,Rotar; Vladimir,8,0,34,26
1657516805365,MATH 193A,A02,083225,Rotar; Vladimir,9,0,34,25
1657516805365,MATH 193A,A03,083781,Rotar; Vladimir,5,0,34,29
1657516805365,MATH 193A,A04,083782,Rotar; Vladimir,10,0,34,24
1657516805365,MATH 193A,A05,093482,Rotar; Vladimir,10,0,34,24
1657516811390,MATH 197,001,091859,McAuley; Julian John,9999,0,9999,0
1657516811390,MATH 197,002,095566,Kedlaya; Kiran S.,9997,0,9999,2
1657516811390,MATH 197,003,095567,Xiao; Ming,9999,0,9999,0
1657516811390,MATH 197,004,095571,Perols; Johan Lars,9998,0,9999,1
1657516818456,COGS 9,A01,083615,Shannon; Kyle Michael,9,0,75,66
1657516824485,COGS 11,A01,083617,Boyle; Mary E. T.,22,0,48,26
1657516830507,COGS 13,A01,083071,Bastos; Amalia Pinkusfeld,11,0,71,60
1657516836530,COGS 14A,A01,092681,Semenuks; Arturs,5,1,100,95
1657516842551,COGS 14B,A01,083073,Cheng; Tzu-Han,6,0,63,57
1657516848572,COGS 17,A01,092677,Semenuks; Arturs,6,0,81,75
1657516854604,COGS 100,A01,083619,Allen; Michael Gordon,17,0,70,53
1657516860627,COGS 101A,A01,083621,Davis; Joshua Daniel,9,0,68,59
1657516866653,COGS 101B,A01,091572,Allen; Michael Gordon,12,0,65,53
1657516872683,COGS 101C,A01,083625,Delgado; Tania,17,0,35,18
1657516878712,COGS 107A,A01,083627,Boyle; Mary E. T.,13,0,60,47
1657516884738,COGS 118A,A01,083075,Gupta; Anjum,21,0,76,55
1657516890762,CSE 3,A50,083646,Miranda; Gregory Joseph,24,0,50,26
1657516896784,CSE 8A,A50,083650,Miranda; Gregory Joseph,17,1,56,39
1657516902884,CSE 11,A01,083080,Cao; Yingjun,6,15,40,34
1657516908908,CSE 12,A01,083652,Krause-Levy; Sophia Louisa,28,1,120,92
1657516914964,CSE 15L,A01,083654,Morris; Justin Loren,9,0,50,41
1657516914964,CSE 15L,A02,083655,Morris; Justin Loren,9,0,50,41
1657516920990,CSE 20,A01,083657,Tran; Khoa Dang,39,0,80,41
1657516927014,CSE 21,A01,095574,Bach; Quang Tran,22,0,48,26
1657516933038,CSE 30,A01,083084,Eldon; John,5,0,80,75
1657516933038,CSE 30,B01,095061,Bhaskar; Nishant,9,0,50,41
1657516939065,CSE 100,A01,083659,Cao; Yingjun,5,4,70,65
1657516945091,CSE 134B,A01,083661,Powell; Thomas Allan,22,0,100,78
1657516951115,CSE 140,A01,083663,Gungor; Onat,15,0,85,70
1657516957145,CSE 140L,A01,083088,Eldon; John,21,0,100,79
1657516963167,CSE 175,A01,083665,Kumar; Rakesh,3,0,25,22
1657516969193,CSE 190,A00,092507,Dubnov; Shlomo,8,0,20,12
1657516975226,ECE 45,A01,083139,Congero; Spencer William,6,0,75,69
1657516981254,ECE 65,A50,083695,Saad; Andrew S,12,0,30,18
1657516981254,ECE 65,A51,095125,Saad; Andrew S,24,0,26,2
1657516987281,ECE 109,A01,091882,Touri; Behrouz,19,0,70,51
1657516993307,ECE 180,A00,083140,Abi Samra; Nicholas Camill,1,0,30,29
1657516993307,ECE 180,B00,083141,Abi Samra; Nicholas Camill,0,0,30,30
1657516999329,MATH 10A,A01,083735,Patchell; Gregory David,2,0,30,28
1657516999329,MATH 10A,A02,083736,Patchell; Gregory David,20,0,30,10
1657516999329,MATH 10A,A03,083737,Patchell; Gregory David,16,0,30,14
1657517005353,MATH 10B,A01,083207,Lim; Seonhee,8,0,34,26
1657517005353,MATH 10B,A02,083208,Lim; Seonhee,9,0,35,26
1657517005353,MATH 10B,A03,093472,Lim; Seonhee,7,0,34,27
1657517005353,MATH 10B,B01,083739,Sinha; Shubham,12,0,30,18
1657517011382,MATH 18,A01,083743,Cinel; Cameron Alexander,7,0,30,23
1657517011382,MATH 18,A02,083744,Cinel; Cameron Alexander,17,0,30,13
1657517011382,MATH 18,A03,083745,Cinel; Cameron Alexander,9,0,30,21
1657517011382,MATH 18,B01,083748,Rideout; David Porter,5,0,37,32
1657517011382,MATH 18,B02,083749,Rideout; David Porter,5,0,36,31
1657517011382,MATH 18,B03,083750,Rideout; David Porter,3,0,37,34
1657517011382,MATH 18,B04,083751,Rideout; David Porter,6,0,36,30
1657517011382,MATH 18,B05,093473,Rideout; David Porter,6,0,36,30
1657517011382,MATH 18,B06,093474,Rideout; David Porter,6,0,36,30
1657517017406,MATH 20A,A01,083754,Zheng; Zequn,14,0,40,26
1657517023439,MATH 20B,A01,083756,Briones; Jor-el Thomas Caparas,4,0,36,32
1657517023439,MATH 20B,A02,083757,Briones; Jor-el Thomas Caparas,1,0,36,35
1657517023439,MATH 20B,A03,093475,Briones; Jor-el Thomas Caparas,2,0,36,34
1657517029463,MATH 20C,A01,083760,Briones; Jor-el Thomas Caparas,1,0,35,34
1657517029463,MATH 20C,A02,083761,Briones; Jor-el Thomas Caparas,8,0,35,27
1657517029463,MATH 20C,A03,093476,Briones; Jor-el Thomas Caparas,0,1,36,36
1657517029463,MATH 20C,B01,083762,Bach; Quang Tran,1,0,30,29
1657517035492,MATH 20D,A01,083765,Tran; Brian Kha,5,0,30,25
1657517035492,MATH 20D,A02,083766,Tran; Brian Kha,5,0,30,25
1657517035492,MATH 20D,A03,083767,Tran; Brian Kha,5,0,30,25
1657517041522,MATH 20E,A01,083771,Ganguly; Soumya,9,0,32,23
1657517041522,MATH 20E,A02,083772,Ganguly; Soumya,6,0,32,26
1657517041522,MATH 20E,B01,083773,Ciotti; Benjamin,20,0,35,15
1657517041522,MATH 20E,B02,083774,Ciotti; Benjamin,17,0,35,18
1657517047545,MATH 103A,A01,083777,Greenfeld; Be'Eri,3,0,36,33
1657517047545,MATH 103A,A02,083778,Greenfeld; Be'Eri,5,0,36,31
1657517047545,MATH 103A,A03,093561,Greenfeld; Be'Eri,5,0,36,31
1657517047545,MATH 103A,B01,083779,Greenfeld; Be'Eri,7,0,36,29
1657517047545,MATH 103A,B02,083780,Greenfeld; Be'Eri,4,0,36,32
1657517047545,MATH 103A,B03,093562,Greenfeld; Be'Eri,3,0,36,33
1657517053575,MATH 105,A01,085443,Carter; Anne Toulson,15,0,35,20
1657517053575,MATH 105,A02,093477,Carter; Anne Toulson,20,0,35,15
1657517059605,MATH 109,A01,083213,Ganzberger; Geoffrey Michael,2,0,34,32
1657517059605,MATH 109,A02,083214,Ganzberger; Geoffrey Michael,4,0,34,30
1657517059605,MATH 109,A03,093478,Ganzberger; Geoffrey Michael,2,0,34,32
1657517059605,MATH 109,B01,083215,Ganzberger; Geoffrey Michael,1,0,32,31
1657517059605,MATH 109,B02,083216,Ganzberger; Geoffrey Michael,2,0,32,30
1657517059605,MATH 109,B03,093479,Ganzberger; Geoffrey Michael,8,0,32,24
1657517065633,MATH 142A,A01,083219,Chow; Bennett,7,0,32,25
1657517065633,MATH 142A,A02,083220,Chow; Bennett,10,0,32,22
1657517065633,MATH 142A,A03,093480,Chow; Bennett,8,0,32,24
1657517065633,MATH 142A,B03,093481,Chow; Bennett,8,0,32,24
1657517065633,MATH 142A,B04,093558,Chow; Bennett,13,0,32,19
1657517065633,MATH 142A,B05,093559,Chow; Bennett,6,0,32,26
1657517071663,MATH 193A,A01,083224,Rotar; Vladimir,8,0,34,26
1657517071663,MATH 193A,A02,083225,Rotar; Vladimir,9,0,34,25
1657517071663,MATH 193A,A03,083781,Rotar; Vladimir,5,0,34,29
1657517071663,MATH 193A,A04,083782,Rotar; Vladimir,10,0,34,24
1657517071663,MATH 193A,A05,093482,Rotar; Vladimir,10,0,34,24
1657517077684,MATH 197,001,091859,McAuley; Julian John,9999,0,9999,0
1657517077684,MATH 197,002,095566,Kedlaya; Kiran S.,9997,0,9999,2
1657517077684,MATH 197,003,095567,Xiao; Ming,9999,0,9999,0
1657517077684,MATH 197,004,095571,Perols; Johan Lars,9998,0,9999,1
1657517084751,COGS 9,A01,083615,Shannon; Kyle Michael,9,0,75,66
1657517090776,COGS 11,A01,083617,Boyle; Mary E. T.,22,0,48,26
1657517096803,COGS 13,A01,083071,Bastos; Amalia Pinkusfeld,11,0,71,60
1657517102830,COGS 14A,A01,092681,Semenuks; Arturs,5,1,100,95
1657517108861,COGS 14B,A01,083073,Cheng; Tzu-Han,6,0,63,57
1657517114887,COGS 17,A01,092677,Semenuks; Arturs,6,0,81,75
1657517120911,COGS 100,A01,083619,Allen; Michael Gordon,17,0,70,53
1657517126936,COGS 101A,A01,083621,Davis; Joshua Daniel,9,0,68,59
1657517132964,COGS 101B,A01,091572,Allen; Michael Gordon,12,0,65,53
1657517138988,COGS 101C,A01,083625,Delgado; Tania,17,0,35,18
1657517145012,COGS 107A,A01,083627,Boyle; Mary E. T.,13,0,60,47
1657517151037,COGS 118A,A01,083075,Gupta; Anjum,21,0,76,55
1657517157064,CSE 3,A50,083646,Miranda; Gregory Joseph,24,0,50,26
1657517163087,CSE 8A,A50,083650,Miranda; Gregory Joseph,17,1,56,39
1657517169115,CSE 11,A01,083080,Cao; Yingjun,6,15,40,34
1657517175152,CSE 12,A01,083652,Krause-Levy; Sophia Louisa,28,1,120,92
1657517181178,CSE 15L,A01,083654,Morris; Justin Loren,9,0,50,41
1657517181178,CSE 15L,A02,083655,Morris; Justin Loren,9,0,50,41
1657517187202,CSE 20,A01,083657,Tran; Khoa Dang,39,0,80,41
1657517193226,CSE 21,A01,095574,Bach; Quang Tran,22,0,48,26
1657517199250,CSE 30,A01,083084,Eldon; John,5,0,80,75
1657517199250,CSE 30,B01,095061,Bhaskar; Nishant,9,0,50,41
1657517205272,CSE 100,A01,083659,Cao; Yingjun,5,4,70,65
1657517211296,CSE 134B,A01,083661,Powell; Thomas Allan,22,0,100,78
1657517217320,CSE 140,A01,083663,Gungor; Onat,15,0,85,70
1657517223343,CSE 140L,A01,083088,Eldon; John,21,0,100,79
1657517229366,CSE 175,A01,083665,Kumar; Rakesh,3,0,25,22
1657517235393,CSE 190,A00,092507,Dubnov; Shlomo,8,0,20,12
1657517241415,ECE 45,A01,083139,Congero; Spencer William,6,0,75,69
1657517247445,ECE 65,A50,083695,Saad; Andrew S,12,0,30,18
1657517247445,ECE 65,A51,095125,Saad; Andrew S,24,0,26,2
1657517253472,ECE 109,A01,091882,Touri; Behrouz,19,0,70,51
1657517259503,ECE 180,A00,083140,Abi Samra; Nicholas Camill,1,0,30,29
1657517259503,ECE 180,B00,083141,Abi Samra; Nicholas Camill,0,0,30,30
1657517265533,MATH 10A,A01,083735,Patchell; Gregory David,2,0,30,28
1657517265533,MATH 10A,A02,083736,Patchell; Gregory David,20,0,30,10
1657517265533,MATH 10A,A03,083737,Patchell; Gregory David,16,0,30,14
1657517271560,MATH 10B,A01,083207,Lim; Seonhee,8,0,34,26
1657517271560,MATH 10B,A02,083208,Lim; Seonhee,9,0,35,26
1657517271560,MATH 10B,A03,093472,Lim; Seonhee,7,0,34,27
1657517271560,MATH 10B,B01,083739,Sinha; Shubham,12,0,30,18
1657517277585,MATH 18,A01,083743,Cinel; Cameron Alexander,7,0,30,23
1657517277585,MATH 18,A02,083744,Cinel; Cameron Alexander,17,0,30,13
1657517277585,MATH 18,A03,083745,Cinel; Cameron Alexander,9,0,30,21
1657517277585,MATH 18,B01,083748,Rideout; David Porter,5,0,37,32
1657517277585,MATH 18,B02,083749,Rideout; David Porter,5,0,36,31
1657517277585,MATH 18,B03,083750,Rideout; David Porter,3,0,37,34
1657517277585,MATH 18,B04,083751,Rideout; David Porter,6,0,36,30
1657517277585,MATH 18,B05,093473,Rideout; David Porter,6,0,36,30
1657517277585,MATH 18,B06,093474,Rideout; David Porter,6,0,36,30
1657517283608,MATH 20A,A01,083754,Zheng; Zequn,14,0,40,26
1657517289632,MATH 20B,A01,083756,Briones; Jor-el Thomas Caparas,4,0,36,32
1657517289632,MATH 20B,A02,083757,Briones; Jor-el Thomas Caparas,1,0,36,35
1657517289632,MATH 20B,A03,093475,Briones; Jor-el Thomas Caparas,2,0,36,34
1657517295659,MATH 20C,A01,083760,Briones; Jor-el Thomas Caparas,1,0,35,34
1657517295659,MATH 20C,A02,083761,Briones; Jor-el Thomas Caparas,8,0,35,27
1657517295659,MATH 20C,A03,093476,Briones; Jor-el Thomas Caparas,0,1,36,36
1657517295659,MATH 20C,B01,083762,Bach; Quang Tran,1,0,30,29
1657517301681,MATH 20D,A01,083765,Tran; Brian Kha,5,0,30,25
1657517301681,MATH 20D,A02,083766,Tran; Brian Kha,5,0,30,25
1657517301681,MATH 20D,A03,083767,Tran; Brian Kha,5,0,30,25
1657517307704,MATH 20E,A01,083771,Ganguly; Soumya,9,0,32,23
1657517307704,MATH 20E,A02,083772,Ganguly; Soumya,6,0,32,26
1657517307704,MATH 20E,B01,083773,Ciotti; Benjamin,20,0,35,15
1657517307704,MATH 20E,B02,083774,Ciotti; Benjamin,17,0,35,18
1657517313727,MATH 103A,A01,083777,Greenfeld; Be'Eri,3,0,36,33
1657517313727,MATH 103A,A02,083778,Greenfeld; Be'Eri,5,0,36,31
1657517313727,MATH 103A,A03,093561,Greenfeld; Be'Eri,5,0,36,31
1657517313727,MATH 103A,B01,083779,Greenfeld; Be'Eri,7,0,36,29
1657517313727,MATH 103A,B02,083780,Greenfeld; Be'Eri,4,0,36,32
1657517313727,MATH 103A,B03,093562,Greenfeld; Be'Eri,3,0,36,33
1657517319754,MATH 105,A01,085443,Carter; Anne Toulson,15,0,35,20
1657517319754,MATH 105,A02,093477,Carter; Anne Toulson,20,0,35,15
1657517325776,MATH 109,A01,083213,Ganzberger; Geoffrey Michael,2,0,34,32
1657517325776,MATH 109,A02,083214,Ganzberger; Geoffrey Michael,4,0,34,30
1657517325776,MATH 109,A03,093478,Ganzberger; Geoffrey Michael,2,0,34,32
1657517325776,MATH 109,B01,083215,Ganzberger; Geoffrey Michael,1,0,32,31
1657517325776,MATH 109,B02,083216,Ganzberger; Geoffrey Michael,2,0,32,30
1657517325776,MATH 109,B03,093479,Ganzberger; Geoffrey Michael,8,0,32,24
1657517331800,MATH 142A,A01,083219,Chow; Bennett,7,0,32,25
1657517331800,MATH 142A,A02,083220,Chow; Bennett,10,0,32,22
1657517331800,MATH 142A,A03,093480,Chow; Bennett,8,0,32,24
1657517331800,MATH 142A,B03,093481,Chow; Bennett,8,0,32,24
1657517331800,MATH 142A,B04,093558,Chow; Bennett,13,0,32,19
1657517331800,MATH 142A,B05,093559,Chow; Bennett,6,0,32,26
1657517337829,MATH 193A,A01,083224,Rotar; Vladimir,8,0,34,26
1657517337829,MATH 193A,A02,083225,Rotar; Vladimir,9,0,34,25
1657517337829,MATH 193A,A03,083781,Rotar; Vladimir,5,0,34,29
1657517337829,MATH 193A,A04,083782,Rotar; Vladimir,10,0,34,24
1657517337829,MATH 193A,A05,093482,Rotar; Vladimir,10,0,34,24
1657517343852,MATH 197,001,091859,McAuley; Julian John,9999,0,9999,0
1657517343852,MATH 197,002,095566,Kedlaya; Kiran S.,9997,0,9999,2
1657517343852,MATH 197,003,095567,Xiao; Ming,9999,0,9999,0
1657517343852,MATH 197,004,095571,Perols; Johan Lars,9998,0,9999,1
1657517350914,COGS 9,A01,083615,Shannon; Kyle Michael,9,0,75,66
1657517356941,COGS 11,A01,083617,Boyle; Mary E. T.,22,0,48,26
1657517362964,COGS 13,A01,083071,Bastos; Amalia Pinkusfeld,11,0,71,60
1657517368989,COGS 14A,A01,092681,Semenuks; Arturs,5,1,100,95
1657517375017,COGS 14B,A01,083073,Cheng; Tzu-Han,6,0,63,57
1657517381043,COGS 17,A01,092677,Semenuks; Arturs,6,0,81,75
1657517387070,COGS 100,A01,083619,Allen; Michael Gordon,17,0,70,53
1657517393093,COGS 101A,A01,083621,Davis; Joshua Daniel,9,0,68,59
1657517399119,COGS 101B,A01,091572,Allen; Michael Gordon,12,0,65,53
1657517405151,COGS 101C,A01,083625,Delgado; Tania,17,0,35,18
1657517411174,COGS 107A,A01,083627,Boyle; Mary E. T.,13,0,60,47
1657517417196,COGS 118A,A01,083075,Gupta; Anjum,21,0,76,55
1657517423221,CSE 3,A50,083646,Miranda; Gregory Joseph,24,0,50,26
1657517429250,CSE 8A,A50,083650,Miranda; Gregory Joseph,17,1,56,39
1657517435276,CSE 11,A01,083080,Cao; Yingjun,6,15,40,34
1657517441306,CSE 12,A01,083652,Krause-Levy; Sophia Louisa,28,1,120,92
1657517447329,CSE 15L,A01,083654,Morris; Justin Loren,9,0,50,41
1657517447329,CSE 15L,A02,083655,Morris; Justin Loren,9,0,50,41
1657517453352,CSE 20,A01,083657,Tran; Khoa Dang,39,0,80,41
1657517459378,CSE 21,A01,095574,Bach; Quang Tran,22,0,48,26
1657517465406,CSE 30,A01,083084,Eldon; John,5,0,80,75
1657517465406,CSE 30,B01,095061,Bhaskar; Nishant,9,0,50,41
1657517471432,CSE 100,A01,083659,Cao; Yingjun,5,4,70,65
1657517477455,CSE 134B,A01,083661,Powell; Thomas Allan,22,0,100,78
1657517483481,CSE 140,A01,083663,Gungor; Onat,15,0,85,70
1657517489506,CSE 140L,A01,083088,Eldon; John,21,0,100,79
1657517495527,CSE 175,A01,083665,Kumar; Rakesh,3,0,25,22
1657517501623,CSE 190,A00,092507,Dubnov; Shlomo,8,0,20,12
1657517507652,ECE 45,A01,083139,Congero; Spencer William,6,0,75,69
1657517513676,ECE 65,A50,083695,Saad; Andrew S,12,0,30,18
1657517513676,ECE 65,A51,095125,Saad; Andrew S,24,0,26,2
1657517519699,ECE 109,A01,091882,Touri; Behrouz,19,0,70,51
1657517525726,ECE 180,A00,083140,Abi Samra; Nicholas Camill,1,0,30,29
1657517525726,ECE 180,B00,083141,Abi Samra; Nicholas Camill,0,0,30,30
1657517531753,MATH 10A,A01,083735,Patchell; Gregory David,2,0,30,28
1657517531753,MATH 10A,A02,083736,Patchell; Gregory David,20,0,30,10
1657517531753,MATH 10A,A03,083737,Patchell; Gregory David,16,0,30,14
1657517537780,MATH 10B,A01,083207,Lim; Seonhee,8,0,34,26
1657517537780,MATH 10B,A02,083208,Lim; Seonhee,9,0,35,26
1657517537780,MATH 10B,A03,093472,Lim; Seonhee,7,0,34,27
1657517537780,MATH 10B,B01,083739,Sinha; Shubham,12,0,30,18
1657517543811,MATH 18,A01,083743,Cinel; Cameron Alexander,7,0,30,23
1657517543811,MATH 18,A02,083744,Cinel; Cameron Alexander,17,0,30,13
1657517543811,MATH 18,A03,083745,Cinel; Cameron Alexander,9,0,30,21
1657517543811,MATH 18,B01,083748,Rideout; David Porter,5,0,37,32
1657517543811,MATH 18,B02,083749,Rideout; David Porter,5,0,36,31
1657517543811,MATH 18,B03,083750,Rideout; David Porter,3,0,37,34
1657517543811,MATH 18,B04,083751,Rideout; David Porter,6,0,36,30
1657517543811,MATH 18,B05,093473,Rideout; David Porter,6,0,36,30
1657517543811,MATH 18,B06,093474,Rideout; David Porter,6,0,36,30
1657517549837,MATH 20A,A01,083754,Zheng; Zequn,14,0,40,26
1657517555860,MATH 20B,A01,083756,Briones; Jor-el Thomas Caparas,4,0,36,32
1657517555860,MATH 20B,A02,083757,Briones; Jor-el Thomas Caparas,1,0,36,35
1657517555860,MATH 20B,A03,093475,Briones; Jor-el Thomas Caparas,2,0,36,34
1657517561883,MATH 20C,A01,083760,Briones; Jor-el Thomas Caparas,1,0,35,34
1657517561883,MATH 20C,A02,083761,Briones; Jor-el Thomas Caparas,8,0,35,27
1657517561883,MATH 20C,A03,093476,Briones; Jor-el Thomas Caparas,0,1,36,36
1657517561883,MATH 20C,B01,083762,Bach; Quang Tran,1,0,30,29
1657517567907,MATH 20D,A01,083765,Tran; Brian Kha,5,0,30,25
1657517567907,MATH 20D,A02,083766,Tran; Brian Kha,5,0,30,25
1657517567907,MATH 20D,A03,083767,Tran; Brian Kha,5,0,30,25
1657517573930,MATH 20E,A01,083771,Ganguly; Soumya,9,0,32,23
1657517573930,MATH 20E,A02,083772,Ganguly; Soumya,6,0,32,26
1657517573930,MATH 20E,B01,083773,Ciotti; Benjamin,20,0,35,15
1657517573930,MATH 20E,B02,083774,Ciotti; Benjamin,17,0,35,18
1657517579962,MATH 103A,A01,083777,Greenfeld; Be'Eri,3,0,36,33
1657517579962,MATH 103A,A02,083778,Greenfeld; Be'Eri,5,0,36,31
1657517579962,MATH 103A,A03,093561,Greenfeld; Be'Eri,5,0,36,31
1657517579962,MATH 103A,B01,083779,Greenfeld; Be'Eri,7,0,36,29
1657517579962,MATH 103A,B02,083780,Greenfeld; Be'Eri,4,0,36,32
1657517579962,MATH 103A,B03,093562,Greenfeld; Be'Eri,3,0,36,33
1657517585990,MATH 105,A01,085443,Carter; Anne Toulson,15,0,35,20
1657517585990,MATH 105,A02,093477,Carter; Anne Toulson,20,0,35,15
1657517592016,MATH 109,A01,083213,Ganzberger; Geoffrey Michael,2,0,34,32
1657517592016,MATH 109,A02,083214,Ganzberger; Geoffrey Michael,4,0,34,30
1657517592016,MATH 109,A03,093478,Ganzberger; Geoffrey Michael,2,0,34,32
1657517592016,MATH 109,B01,083215,Ganzberger; Geoffrey Michael,1,0,32,31
1657517592016,MATH 109,B02,083216,Ganzberger; Geoffrey Michael,2,0,32,30
1657517592016,MATH 109,B03,093479,Ganzberger; Geoffrey Michael,8,0,32,24
1657517598039,MATH 142A,A01,083219,Chow; Bennett,7,0,32,25
1657517598039,MATH 142A,A02,083220,Chow; Bennett,10,0,32,22
1657517598039,MATH 142A,A03,093480,Chow; Bennett,8,0,32,24
1657517598039,MATH 142A,B03,093481,Chow; Bennett,8,0,32,24
1657517598039,MATH 142A,B04,093558,Chow; Bennett,13,0,32,19
1657517598039,MATH 142A,B05,093559,Chow; Bennett,6,0,32,26
1657517604067,MATH 193A,A01,083224,Rotar; Vladimir,8,0,34,26
1657517604067,MATH 193A,A02,083225,Rotar; Vladimir,9,0,34,25
1657517604067,MATH 193A,A03,083781,Rotar; Vladimir,5,0,34,29
1657517604067,MATH 193A,A04,083782,Rotar; Vladimir,10,0,34,24
1657517604067,MATH 193A,A05,093482,Rotar; Vladimir,10,0,34,24
1657517610096,MATH 197,001,091859,McAuley; Julian John,9999,0,9999,0
1657517610096,MATH 197,002,095566,Kedlaya; Kiran S.,9997,0,9999,2
1657517610096,MATH 197,003,095567,Xiao; Ming,9999,0,9999,0
1657517610096,MATH 197,004,095571,Perols; Johan Lars,9998,0,9999,1
1657517617150,COGS 9,A01,083615,Shannon; Kyle Michael,9,0,75,66
1657517623174,COGS 11,A01,083617,Boyle; Mary E. T.,22,0,48,26
1657517629198,COGS 13,A01,083071,Bastos; Amalia Pinkusfeld,11,0,71,60
1657517635225,COGS 14A,A01,092681,Semenuks; Arturs,5,1,100,95
1657517641249,COGS 14B,A01,083073,Cheng; Tzu-Han,6,0,63,57
1657517647281,COGS 17,A01,092677,Semenuks; Arturs,6,0,81,75
1657517653304,COGS 100,A01,083619,Allen; Michael Gordon,17,0,70,53
1657517659328,COGS 101A,A01,083621,Davis; Joshua Daniel,9,0,68,59
1657517665388,COGS 101B,A01,091572,Allen; Michael Gordon,12,0,65,53
1657517671416,COGS 101C,A01,083625,Delgado; Tania,17,0,35,18
1657517677443,COGS 107A,A01,083627,Boyle; Mary E. T.,13,0,60,47
1657517683469,COGS 118A,A01,083075,Gupta; Anjum,21,0,76,55
1657517689500,CSE 3,A50,083646,Miranda; Gregory Joseph,24,0,50,26
1657517695530,CSE 8A,A50,083650,Miranda; Gregory Joseph,17,1,56,39
1657517701554,CSE 11,A01,083080,Cao; Yingjun,6,15,40,34
1657517707579,CSE 12,A01,083652,Krause-Levy; Sophia Louisa,28,1,120,92
1657517713604,CSE 15L,A01,083654,Morris; Justin Loren,9,0,50,41
1657517713604,CSE 15L,A02,083655,Morris; Justin Loren,9,0,50,41
1657517719628,CSE 20,A01,083657,Tran; Khoa Dang,39,0,80,41
1657517725655,CSE 21,A01,095574,Bach; Quang Tran,22,0,48,26
1657517731681,CSE 30,A01,083084,Eldon; John,5,0,80,75
1657517731681,CSE 30,B01,095061,Bhaskar; Nishant,9,0,50,41
1657517737715,CSE 100,A01,083659,Cao; Yingjun,5,4,70,65
1657517743740,CSE 134B,A01,083661,Powell; Thomas Allan,22,0,100,78
1657517749766,CSE 140,A01,083663,Gungor; Onat,15,0,85,70
1657517755789,CSE 140L,A01,083088,Eldon; John,21,0,100,79
1657517761815,CSE 175,A01,083665,Kumar; Rakesh,3,0,25,22
1657517767846,CSE 190,A00,092507,Dubnov; Shlomo,8,0,20,12
1657517773870,ECE 45,A01,083139,Congero; Spencer William,6,0,75,69
1657517779895,ECE 65,A50,083695,Saad; Andrew S,12,0,30,18
1657517779895,ECE 65,A51,095125,Saad; Andrew S,24,0,26,2
1657517785918,ECE 109,A01,091882,Touri; Behrouz,19,0,70,51
1657517791942,ECE 180,A00,083140,Abi Samra; Nicholas Camill,1,0,30,29
1657517791942,ECE 180,B00,083141,Abi Samra; Nicholas Camill,0,0,30,30
1657517797964,MATH 10A,A01,083735,Patchell; Gregory David,2,0,30,28
1657517797964,MATH 10A,A02,083736,Patchell; Gregory David,20,0,30,10
1657517797964,MATH 10A,A03,083737,Patchell; Gregory David,16,0,30,14
1657517803990,MATH 10B,A01,083207,Lim; Seonhee,8,0,34,26
1657517803990,MATH 10B,A02,083208,Lim; Seonhee,9,0,35,26
1657517803990,MATH 10B,A03,093472,Lim; Seonhee,7,0,34,27
1657517803990,MATH 10B,B01,083739,Sinha; Shubham,12,0,30,18
1657517810014,MATH 18,A01,083743,Cinel; Cameron Alexander,7,0,30,23
1657517810014,MATH 18,A02,083744,Cinel; Cameron Alexander,17,0,30,13
1657517810014,MATH 18,A03,083745,Cinel; Cameron Alexander,9,0,30,21
1657517810014,MATH 18,B01,083748,Rideout; David Porter,5,0,37,32
1657517810014,MATH 18,B02,083749,Rideout; David Porter,5,0,36,31
1657517810014,MATH 18,B03,083750,Rideout; David Porter,3,0,37,34
1657517810014,MATH 18,B04,083751,Rideout; David Porter,6,0,36,30
1657517810014,MATH 18,B05,093473,Rideout; David Porter,6,0,36,30
1657517810014,MATH 18,B06,093474,Rideout; David Porter,6,0,36,30
1657517816042,MATH 20A,A01,083754,Zheng; Zequn,14,0,40,26
1657517822072,MATH 20B,A01,083756,Briones; Jor-el Thomas Caparas,4,0,36,32
1657517822072,MATH 20B,A02,083757,Briones; Jor-el Thomas Caparas,1,0,36,35
1657517822072,MATH 20B,A03,093475,Briones; Jor-el Thomas Caparas,2,0,36,34
1657517828096,MATH 20C,A01,083760,Briones; Jor-el Thomas Caparas,1,0,35,34
1657517828096,MATH 20C,A02,083761,Briones; Jor-el Thomas Caparas,8,0,35,27
1657517828096,MATH 20C,A03,093476,Briones; Jor-el Thomas Caparas,0,1,36,36
1657517828096,MATH 20C,B01,083762,Bach; Quang Tran,1,0,30,29
1657517834120,MATH 20D,A01,083765,Tran; Brian Kha,5,0,30,25
1657517834120,MATH 20D,A02,083766,Tran; Brian Kha,5,0,30,25
1657517834120,MATH 20D,A03,083767,Tran; Brian Kha,5,0,30,25
1657517840152,MATH 20E,A01,083771,Ganguly; Soumya,9,0,32,23
1657517840152,MATH 20E,A02,083772,Ganguly; Soumya,6,0,32,26
1657517840152,MATH 20E,B01,083773,Ciotti; Benjamin,20,0,35,15
1657517840152,MATH 20E,B02,083774,Ciotti; Benjamin,17,0,35,18
1657517846180,MATH 103A,A01,083777,Greenfeld; Be'Eri,3,0,36,33
1657517846180,MATH 103A,A02,083778,Greenfeld; Be'Eri,5,0,36,31
1657517846180,MATH 103A,A03,093561,Greenfeld; Be'Eri,5,0,36,31
1657517846180,MATH 103A,B01,083779,Greenfeld; Be'Eri,7,0,36,29
1657517846180,MATH 103A,B02,083780,Greenfeld; Be'Eri,4,0,36,32
1657517846180,MATH 103A,B03,093562,Greenfeld; Be'Eri,3,0,36,33
1657517852203,MATH 105,A01,085443,Carter; Anne Toulson,15,0,35,20
1657517852203,MATH 105,A02,093477,Carter; Anne Toulson,20,0,35,15
1657517858229,MATH 109,A01,083213,Ganzberger; Geoffrey Michael,2,0,34,32
1657517858229,MATH 109,A02,083214,Ganzberger; Geoffrey Michael,4,0,34,30
1657517858229,MATH 109,A03,093478,Ganzberger; Geoffrey Michael,2,0,34,32
1657517858229,MATH 109,B01,083215,Ganzberger; Geoffrey Michael,1,0,32,31
1657517858229,MATH 109,B02,083216,Ganzberger; Geoffrey Michael,2,0,32,30
1657517858229,MATH 109,B03,093479,Ganzberger; Geoffrey Michael,8,0,32,24
1657517864259,MATH 142A,A01,083219,Chow; Bennett,7,0,32,25
1657517864259,MATH 142A,A02,083220,Chow; Bennett,10,0,32,22
1657517864259,MATH 142A,A03,093480,Chow; Bennett,8,0,32,24
1657517864259,MATH 142A,B03,093481,Chow; Bennett,8,0,32,24
1657517864259,MATH 142A,B04,093558,Chow; Bennett,13,0,32,19
1657517864259,MATH 142A,B05,093559,Chow; Bennett,6,0,32,26
1657517870287,MATH 193A,A01,083224,Rotar; Vladimir,8,0,34,26
1657517870287,MATH 193A,A02,083225,Rotar; Vladimir,9,0,34,25
1657517870287,MATH 193A,A03,083781,Rotar; Vladimir,5,0,34,29
1657517870287,MATH 193A,A04,083782,Rotar; Vladimir,10,0,34,24
1657517870287,MATH 193A,A05,093482,Rotar; Vladimir,10,0,34,24
1657517876310,MATH 197,001,091859,McAuley; Julian John,9999,0,9999,0
1657517876310,MATH 197,002,095566,Kedlaya; Kiran S.,9997,0,9999,2
1657517876310,MATH 197,003,095567,Xiao; Ming,9999,0,9999,0
1657517876310,MATH 197,004,095571,Perols; Johan Lars,9998,0,9999,1
1657517883376,COGS 9,A01,083615,Shannon; Kyle Michael,9,0,75,66
1657517889402,COGS 11,A01,083617,Boyle; Mary E. T.,22,0,48,26
1657517895425,COGS 13,A01,083071,Bastos; Amalia Pinkusfeld,11,0,71,60
1657517901451,COGS 14A,A01,092681,Semenuks; Arturs,5,1,100,95
1657517907475,COGS 14B,A01,083073,Cheng; Tzu-Han,6,0,63,57
1657517913499,COGS 17,A01,092677,Semenuks; Arturs,6,0,81,75
1657517919522,COGS 100,A01,083619,Allen; Michael Gordon,17,0,70,53
1657517925545,COGS 101A,A01,083621,Davis; Joshua Daniel,9,0,68,59
1657517931570,COGS 101B,A01,091572,Allen; Michael Gordon,12,0,65,53
1657517937594,COGS 101C,A01,083625,Delgado; Tania,17,0,35,18
1657517943622,COGS 107A,A01,083627,Boyle; Mary E. T.,13,0,60,47
1657517949647,COGS 118A,A01,083075,Gupta; Anjum,21,0,76,55
1657517955670,CSE 3,A50,083646,Miranda; Gregory Joseph,24,0,50,26
1657517961697,CSE 8A,A50,083650,Miranda; Gregory Joseph,17,1,56,39
1657517967719,CSE 11,A01,083080,Cao; Yingjun,6,15,40,34
1657517973743,CSE 12,A01,083652,Krause-Levy; Sophia Louisa,28,1,120,92
1657517979776,CSE 15L,A01,083654,Morris; Justin Loren,9,0,50,41
1657517979776,CSE 15L,A02,083655,Morris; Justin Loren,9,0,50,41
1657517985802,CSE 20,A01,083657,Tran; Khoa Dang,39,0,80,41
1657517991826,CSE 21,A01,095574,Bach; Quang Tran,22,0,48,26
1657517997849,CSE 30,A01,083084,Eldon; John,5,0,80,75
1657517997849,CSE 30,B01,095061,Bhaskar; Nishant,9,0,50,41
1657518003871,CSE 100,A01,083659,Cao; Yingjun,5,4,70,65
1657518009896,CSE 134B,A01,083661,Powell; Thomas Allan,22,0,100,78
1657518015918,CSE 140,A01,083663,Gungor; Onat,15,0,85,70
1657518021941,CSE 140L,A01,083088,Eldon; John,21,0,100,79
1657518027966,CSE 175,A01,083665,Kumar; Rakesh,3,0,25,22
1657518033990,CSE 190,A00,092507,Dubnov; Shlomo,8,0,20,12
1657518040023,ECE 45,A01,083139,Congero; Spencer William,6,0,75,69
1657518046050,ECE 65,A50,083695,Saad; Andrew S,12,0,30,18
1657518046050,ECE 65,A51,095125,Saad; Andrew S,24,0,26,2
1657518052074,ECE 109,A01,091882,Touri; Behrouz,19,0,70,51
1657518058097,ECE 180,A00,083140,Abi Samra; Nicholas Camill,1,0,30,29
1657518058097,ECE 180,B00,083141,Abi Samra; Nicholas Camill,0,0,30,30
1657518064126,MATH 10A,A01,083735,Patchell; Gregory David,2,0,30,28
1657518064126,MATH 10A,A02,083736,Patchell; Gregory David,20,0,30,10
1657518064126,MATH 10A,A03,083737,Patchell; Gregory David,16,0,30,14
1657518070148,MATH 10B,A01,083207,Lim; Seonhee,8,0,34,26
1657518070148,MATH 10B,A02,083208,Lim; Seonhee,9,0,35,26
1657518070148,MATH 10B,A03,093472,Lim; Seonhee,7,0,34,27
1657518070148,MATH 10B,B01,083739,Sinha; Shubham,12,0,30,18
1657518076173,MATH 18,A01,083743,Cinel; Cameron Alexander,7,0,30,23
1657518076173,MATH 18,A02,083744,Cinel; Cameron Alexander,17,0,30,13
1657518076173,MATH 18,A03,083745,Cinel; Cameron Alexander,9,0,30,21
1657518076173,MATH 18,B01,083748,Rideout; David Porter,5,0,37,32
1657518076173,MATH 18,B02,083749,Rideout; David Porter,5,0,36,31
1657518076173,MATH 18,B03,083750,Rideout; David Porter,3,0,37,34
1657518076173,MATH 18,B04,083751,Rideout; David Porter,6,0,36,30
1657518076173,MATH 18,B05,093473,Rideout; David Porter,6,0,36,30
1657518076173,MATH 18,B06,093474,Rideout; David Porter,6,0,36,30
1657518082198,MATH 20A,A01,083754,Zheng; Zequn,14,0,40,26
1657518088220,MATH 20B,A01,083756,Briones; Jor-el Thomas Caparas,4,0,36,32
1657518088220,MATH 20B,A02,083757,Briones; Jor-el Thomas Caparas,1,0,36,35
1657518088220,MATH 20B,A03,093475,Briones; Jor-el Thomas Caparas,2,0,36,34
1657518094248,MATH 20C,A01,083760,Briones; Jor-el Thomas Caparas,1,0,35,34
1657518094248,MATH 20C,A02,083761,Briones; Jor-el Thomas Caparas,8,0,35,27
1657518094248,MATH 20C,A03,093476,Briones; Jor-el Thomas Caparas,0,1,36,36
1657518094248,MATH 20C,B01,083762,Bach; Quang Tran,1,0,30,29
1657518100365,MATH 20D,A01,083765,Tran; Brian Kha,5,0,30,25
1657518100365,MATH 20D,A02,083766,Tran; Brian Kha,5,0,30,25
1657518100365,MATH 20D,A03,083767,Tran; Brian Kha,5,0,30,25
1657518106395,MATH 20E,A01,083771,Ganguly; Soumya,9,0,32,23
1657518106395,MATH 20E,A02,083772,Ganguly; Soumya,6,0,32,26
1657518106395,MATH 20E,B01,083773,Ciotti; Benjamin,20,0,35,15
1657518106395,MATH 20E,B02,083774,Ciotti; Benjamin,17,0,35,18
1657518112420,MATH 103A,A01,083777,Greenfeld; Be'Eri,3,0,36,33
1657518112420,MATH 103A,A02,083778,Greenfeld; Be'Eri,5,0,36,31
1657518112420,MATH 103A,A03,093561,Greenfeld; Be'Eri,5,0,36,31
1657518112420,MATH 103A,B01,083779,Greenfeld; Be'Eri,7,0,36,29
1657518112420,MATH 103A,B02,083780,Greenfeld; Be'Eri,4,0,36,32
1657518112420,MATH 103A,B03,093562,Greenfeld; Be'Eri,3,0,36,33
1657518118447,MATH 105,A01,085443,Carter; Anne Toulson,15,0,35,20
1657518118447,MATH 105,A02,093477,Carter; Anne Toulson,20,0,35,15
1657518124470,MATH 109,A01,083213,Ganzberger; Geoffrey Michael,2,0,34,32
1657518124470,MATH 109,A02,083214,Ganzberger; Geoffrey Michael,4,0,34,30
1657518124470,MATH 109,A03,093478,Ganzberger; Geoffrey Michael,2,0,34,32
1657518124470,MATH 109,B01,083215,Ganzberger; Geoffrey Michael,1,0,32,31
1657518124470,MATH 109,B02,083216,Ganzberger; Geoffrey Michael,2,0,32,30
1657518124470,MATH 109,B03,093479,Ganzberger; Geoffrey Michael,8,0,32,24
1657518130493,MATH 142A,A01,083219,Chow; Bennett,7,0,32,25
1657518130493,MATH 142A,A02,083220,Chow; Bennett,10,0,32,22
1657518130493,MATH 142A,A03,093480,Chow; Bennett,8,0,32,24
1657518130493,MATH 142A,B03,093481,Chow; Bennett,8,0,32,24
1657518130493,MATH 142A,B04,093558,Chow; Bennett,13,0,32,19
1657518130493,MATH 142A,B05,093559,Chow; Bennett,6,0,32,26
1657518136516,MATH 193A,A01,083224,Rotar; Vladimir,8,0,34,26
1657518136516,MATH 193A,A02,083225,Rotar; Vladimir,9,0,34,25
1657518136516,MATH 193A,A03,083781,Rotar; Vladimir,5,0,34,29
1657518136516,MATH 193A,A04,083782,Rotar; Vladimir,10,0,34,24
1657518136516,MATH 193A,A05,093482,Rotar; Vladimir,10,0,34,24
1657518142548,MATH 197,001,091859,McAuley; Julian John,9999,0,9999,0
1657518142548,MATH 197,002,095566,Kedlaya; Kiran S.,9997,0,9999,2
1657518142548,MATH 197,003,095567,Xiao; Ming,9999,0,9999,0
1657518142548,MATH 197,004,095571,Perols; Johan Lars,9998,0,9999,1
1657518149604,COGS 9,A01,083615,Shannon; Kyle Michael,9,0,75,66
1657518155629,COGS 11,A01,083617,Boyle; Mary E. T.,22,0,48,26
1657518161652,COGS 13,A01,083071,Bastos; Amalia Pinkusfeld,11,0,71,60
1657518167680,COGS 14A,A01,092681,Semenuks; Arturs,5,1,100,95
1657518173707,COGS 14B,A01,083073,Cheng; Tzu-Han,6,0,63,57
1657518179732,COGS 17,A01,092677,Semenuks; Arturs,6,0,81,75
1657518185753,COGS 100,A01,083619,Allen; Michael Gordon,17,0,70,53
1657518191778,COGS 101A,A01,083621,Davis; Joshua Daniel,9,0,68,59
1657518197800,COGS 101B,A01,091572,Allen; Michael Gordon,12,0,65,53
1657518203823,COGS 101C,A01,083625,Delgado; Tania,17,0,35,18
1657518209847,COGS 107A,A01,083627,Boyle; Mary E. T.,13,0,60,47
1657518215869,COGS 118A,A01,083075,Gupta; Anjum,21,0,76,55
1657518221896,CSE 3,A50,083646,Miranda; Gregory Joseph,24,0,50,26
1657518227923,CSE 8A,A50,083650,Miranda; Gregory Joseph,17,1,56,39
1657518233950,CSE 11,A01,083080,Cao; Yingjun,6,15,40,34
1657518239973,CSE 12,A01,083652,Krause-Levy; Sophia Louisa,28,1,120,92
1657518246001,CSE 15L,A01,083654,Morris; Justin Loren,9,0,50,41
1657518246001,CSE 15L,A02,083655,Morris; Justin Loren,9,0,50,41
1657518252027,CSE 20,A01,083657,Tran; Khoa Dang,39,0,80,41
1657518258051,CSE 21,A01,095574,Bach; Quang Tran,22,0,48,26
1657518264077,CSE 30,A01,083084,Eldon; John,5,0,80,75
1657518264077,CSE 30,B01,095061,Bhaskar; Nishant,9,0,50,41
1657518270104,CSE 100,A01,083659,Cao; Yingjun,5,4,70,65
1657518276132,CSE 134B,A01,083661,Powell; Thomas Allan,22,0,100,78
1657518282155,CSE 140,A01,083663,Gungor; Onat,15,0,85,70
1657518288181,CSE 140L,A01,083088,Eldon; John,21,0,100,79
1657518294207,CSE 175,A01,083665,Kumar; Rakesh,3,0,25,22
1657518300233,CSE 190,A00,092507,Dubnov; Shlomo,8,0,20,12
1657518306255,ECE 45,A01,083139,Congero; Spencer William,6,0,75,69
1657518312278,ECE 65,A50,083695,Saad; Andrew S,12,0,30,18
1657518312278,ECE 65,A51,095125,Saad; Andrew S,24,0,26,2
1657518318300,ECE 109,A01,091882,Touri; Behrouz,19,0,70,51
1657518324322,ECE 180,A00,083140,Abi Samra; Nicholas Camill,1,0,30,29
1657518324322,ECE 180,B00,083141,Abi Samra; Nicholas Camill,0,0,30,30
1657518330344,MATH 10A,A01,083735,Patchell; Gregory David,2,0,30,28
1657518330344,MATH 10A,A02,083736,Patchell; Gregory David,20,0,30,10
1657518330344,MATH 10A,A03,083737,Patchell; Gregory David,16,0,30,14
1657518336368,MATH 10B,A01,083207,Lim; Seonhee,8,0,34,26
1657518336368,MATH 10B,A02,083208,Lim; Seonhee,9,0,35,26
1657518336368,MATH 10B,A03,093472,Lim; Seonhee,7,0,34,27
1657518336368,MATH 10B,B01,083739,Sinha; Shubham,12,0,30,18
1657518342398,MATH 18,A01,083743,Cinel; Cameron Alexander,7,0,30,23
1657518342398,MATH 18,A02,083744,Cinel; Cameron Alexander,17,0,30,13
1657518342398,MATH 18,A03,083745,Cinel; Cameron Alexander,9,0,30,21
1657518342398,MATH 18,B01,083748,Rideout; David Porter,5,0,37,32
1657518342398,MATH 18,B02,083749,Rideout; David Porter,5,0,36,31
1657518342398,MATH 18,B03,083750,Rideout; David Porter,3,0,37,34
1657518342398,MATH 18,B04,083751,Rideout; David Porter,6,0,36,30
1657518342398,MATH 18,B05,093473,Rideout; David Porter,6,0,36,30
1657518342398,MATH 18,B06,093474,Rideout; David Porter,6,0,36,30
1657518348422,MATH 20A,A01,083754,Zheng; Zequn,14,0,40,26
1657518354448,MATH 20B,A01,083756,Briones; Jor-el Thomas Caparas,4,0,36,32
1657518354448,MATH 20B,A02,083757,Briones; Jor-el Thomas Caparas,1,0,36,35
1657518354448,MATH 20B,A03,093475,Briones; Jor-el Thomas Caparas,2,0,36,34
1657518360476,MATH 20C,A01,083760,Briones; Jor-el Thomas Caparas,1,0,35,34
1657518360476,MATH 20C,A02,083761,Briones; Jor-el Thomas Caparas,8,0,35,27
1657518360476,MATH 20C,A03,093476,Briones; Jor-el Thomas Caparas,0,1,36,36
1657518360476,MATH 20C,B01,083762,Bach; Quang Tran,1,0,30,29
1657518366499,MATH 20D,A01,083765,Tran; Brian Kha,5,0,30,25
1657518366499,MATH 20D,A02,083766,Tran; Brian Kha,5,0,30,25
1657518366499,MATH 20D,A03,083767,Tran; Brian Kha,5,0,30,25
1657518372523,MATH 20E,A01,083771,Ganguly; Soumya,9,0,32,23
1657518372523,MATH 20E,A02,083772,Ganguly; Soumya,6,0,32,26
1657518372523,MATH 20E,B01,083773,Ciotti; Benjamin,20,0,35,15
1657518372523,MATH 20E,B02,083774,Ciotti; Benjamin,17,0,35,18
1657518378548,MATH 103A,A01,083777,Greenfeld; Be'Eri,3,0,36,33
1657518378548,MATH 103A,A02,083778,Greenfeld; Be'Eri,5,0,36,31
1657518378548,MATH 103A,A03,093561,Greenfeld; Be'Eri,5,0,36,31
1657518378548,MATH 103A,B01,083779,Greenfeld; Be'Eri,7,0,36,29
1657518378548,MATH 103A,B02,083780,Greenfeld; Be'Eri,4,0,36,32
1657518378548,MATH 103A,B03,093562,Greenfeld; Be'Eri,3,0,36,33
1657518384570,MATH 105,A01,085443,Carter; Anne Toulson,15,0,35,20
1657518384570,MATH 105,A02,093477,Carter; Anne Toulson,20,0,35,15
1657518390593,MATH 109,A01,083213,Ganzberger; Geoffrey Michael,2,0,34,32
1657518390593,MATH 109,A02,083214,Ganzberger; Geoffrey Michael,4,0,34,30
1657518390593,MATH 109,A03,093478,Ganzberger; Geoffrey Michael,2,0,34,32
1657518390593,MATH 109,B01,083215,Ganzberger; Geoffrey Michael,1,0,32,31
1657518390593,MATH 109,B02,083216,Ganzberger; Geoffrey Michael,2,0,32,30
1657518390593,MATH 109,B03,093479,Ganzberger; Geoffrey Michael,8,0,32,24
1657518396618,MATH 142A,A01,083219,Chow; Bennett,7,0,32,25
1657518396618,MATH 142A,A02,083220,Chow; Bennett,10,0,32,22
1657518396618,MATH 142A,A03,093480,Chow; Bennett,8,0,32,24
1657518396618,MATH 142A,B03,093481,Chow; Bennett,8,0,32,24
1657518396618,MATH 142A,B04,093558,Chow; Bennett,13,0,32,19
1657518396618,MATH 142A,B05,093559,Chow; Bennett,6,0,32,26
1657518402640,MATH 193A,A01,083224,Rotar; Vladimir,8,0,34,26
1657518402640,MATH 193A,A02,083225,Rotar; Vladimir,9,0,34,25
1657518402640,MATH 193A,A03,083781,Rotar; Vladimir,5,0,34,29
1657518402640,MATH 193A,A04,083782,Rotar; Vladimir,10,0,34,24
1657518402640,MATH 193A,A05,093482,Rotar; Vladimir,10,0,34,24
1657518408665,MATH 197,001,091859,McAuley; Julian John,9999,0,9999,0
1657518408665,MATH 197,002,095566,Kedlaya; Kiran S.,9997,0,9999,2
1657518408665,MATH 197,003,095567,Xiao; Ming,9999,0,9999,0
1657518408665,MATH 197,004,095571,Perols; Johan Lars,9998,0,9999,1
1657518415720,COGS 9,A01,083615,Shannon; Kyle Michael,9,0,75,66
1657518421745,COGS 11,A01,083617,Boyle; Mary E. T.,22,0,48,26
1657518427770,COGS 13,A01,083071,Bastos; Amalia Pinkusfeld,11,0,71,60
1657518433793,COGS 14A,A01,092681,Semenuks; Arturs,5,1,100,95
1657518439816,COGS 14B,A01,083073,Cheng; Tzu-Han,6,0,63,57
1657518445840,COGS 17,A01,092677,Semenuks; Arturs,6,0,81,75
1657518451869,COGS 100,A01,083619,Allen; Michael Gordon,17,0,70,53
1657518457890,COGS 101A,A01,083621,Davis; Joshua Daniel,9,0,68,59
1657518463916,COGS 101B,A01,091572,Allen; Michael Gordon,12,0,65,53
1657518469939,COGS 101C,A01,083625,Delgado; Tania,17,0,35,18
1657518475962,COGS 107A,A01,083627,Boyle; Mary E. T.,13,0,60,47
1657518481984,COGS 118A,A01,083075,Gupta; Anjum,21,0,76,55
1657518488007,CSE 3,A50,083646,Miranda; Gregory Joseph,24,0,50,26
1657518494033,CSE 8A,A50,083650,Miranda; Gregory Joseph,17,1,56,39
1657518500057,CSE 11,A01,083080,Cao; Yingjun,6,15,40,34
1657518506082,CSE 12,A01,083652,Krause-Levy; Sophia Louisa,28,1,120,92
1657518512111,CSE 15L,A01,083654,Morris; Justin Loren,9,0,50,41
1657518512111,CSE 15L,A02,083655,Morris; Justin Loren,9,0,50,41
1657518518134,CSE 20,A01,083657,Tran; Khoa Dang,39,0,80,41
1657518524161,CSE 21,A01,095574,Bach; Quang Tran,22,0,48,26
1657518530189,CSE 30,A01,083084,Eldon; John,5,0,80,75
1657518530189,CSE 30,B01,095061,Bhaskar; Nishant,9,0,50,41
1657518536216,CSE 100,A01,083659,Cao; Yingjun,5,4,70,65
1657518542247,CSE 134B,A01,083661,Powell; Thomas Allan,22,0,100,78
1657518548271,CSE 140,A01,083663,Gungor; Onat,15,0,85,70
1657518554293,CSE 140L,A01,083088,Eldon; John,21,0,100,79
1657518560318,CSE 175,A01,083665,Kumar; Rakesh,3,0,25,22
1657518566342,CSE 190,A00,092507,Dubnov; Shlomo,8,0,20,12
1657518572365,ECE 45,A01,083139,Congero; Spencer William,6,0,75,69
1657518578393,ECE 65,A50,083695,Saad; Andrew S,12,0,30,18
1657518578393,ECE 65,A51,095125,Saad; Andrew S,24,0,26,2
1657518584417,ECE 109,A01,091882,Touri; Behrouz,19,0,70,51
1657518590444,ECE 180,A00,083140,Abi Samra; Nicholas Camill,1,0,30,29
1657518590444,ECE 180,B00,083141,Abi Samra; Nicholas Camill,0,0,30,30
1657518596466,MATH 10A,A01,083735,Patchell; Gregory David,2,0,30,28
1657518596466,MATH 10A,A02,083736,Patchell; Gregory David,20,0,30,10
1657518596466,MATH 10A,A03,083737,Patchell; Gregory David,16,0,30,14
1657518602489,MATH 10B,A01,083207,Lim; Seonhee,8,0,34,26
1657518602489,MATH 10B,A02,083208,Lim; Seonhee,9,0,35,26
1657518602489,MATH 10B,A03,093472,Lim; Seonhee,7,0,34,27
1657518602489,MATH 10B,B01,083739,Sinha; Shubham,12,0,30,18
1657518608513,MATH 18,A01,083743,Cinel; Cameron Alexander,7,0,30,23
1657518608513,MATH 18,A02,083744,Cinel; Cameron Alexander,17,0,30,13
1657518608513,MATH 18,A03,083745,Cinel; Cameron Alexander,9,0,30,21
1657518608513,MATH 18,B01,083748,Rideout; David Porter,5,0,37,32
1657518608513,MATH 18,B02,083749,Rideout; David Porter,5,0,36,31
1657518608513,MATH 18,B03,083750,Rideout; David Porter,3,0,37,34
1657518608513,MATH 18,B04,083751,Rideout; David Porter,6,0,36,30
1657518608513,MATH 18,B05,093473,Rideout; David Porter,6,0,36,30
1657518608513,MATH 18,B06,093474,Rideout; David Porter,6,0,36,30
1657518614539,MATH 20A,A01,083754,Zheng; Zequn,14,0,40,26
1657518620565,MATH 20B,A01,083756,Briones; Jor-el Thomas Caparas,4,0,36,32
1657518620565,MATH 20B,A02,083757,Briones; Jor-el Thomas Caparas,1,0,36,35
1657518620565,MATH 20B,A03,093475,Briones; Jor-el Thomas Caparas,2,0,36,34
1657518626593,MATH 20C,A01,083760,Briones; Jor-el Thomas Caparas,1,0,35,34
1657518626593,MATH 20C,A02,083761,Briones; Jor-el Thomas Caparas,8,0,35,27
1657518626593,MATH 20C,A03,093476,Briones; Jor-el Thomas Caparas,0,1,36,36
1657518626593,MATH 20C,B01,083762,Bach; Quang Tran,1,0,30,29
1657518632616,MATH 20D,A01,083765,Tran; Brian Kha,5,0,30,25
1657518632616,MATH 20D,A02,083766,Tran; Brian Kha,5,0,30,25
1657518632616,MATH 20D,A03,083767,Tran; Brian Kha,5,0,30,25
1657518638642,MATH 20E,A01,083771,Ganguly; Soumya,9,0,32,23
1657518638642,MATH 20E,A02,083772,Ganguly; Soumya,6,0,32,26
1657518638642,MATH 20E,B01,083773,Ciotti; Benjamin,20,0,35,15
1657518638642,MATH 20E,B02,083774,Ciotti; Benjamin,17,0,35,18
1657518644667,MATH 103A,A01,083777,Greenfeld; Be'Eri,3,0,36,33
1657518644667,MATH 103A,A02,083778,Greenfeld; Be'Eri,5,0,36,31
1657518644667,MATH 103A,A03,093561,Greenfeld; Be'Eri,5,0,36,31
1657518644667,MATH 103A,B01,083779,Greenfeld; Be'Eri,7,0,36,29
1657518644667,MATH 103A,B02,083780,Greenfeld; Be'Eri,4,0,36,32
1657518644667,MATH 103A,B03,093562,Greenfeld; Be'Eri,3,0,36,33
1657518650691,MATH 105,A01,085443,Carter; Anne Toulson,15,0,35,20
1657518650691,MATH 105,A02,093477,Carter; Anne Toulson,20,0,35,15
1657518656714,MATH 109,A01,083213,Ganzberger; Geoffrey Michael,2,0,34,32
1657518656714,MATH 109,A02,083214,Ganzberger; Geoffrey Michael,4,0,34,30
1657518656714,MATH 109,A03,093478,Ganzberger; Geoffrey Michael,2,0,34,32
1657518656714,MATH 109,B01,083215,Ganzberger; Geoffrey Michael,1,0,32,31
1657518656714,MATH 109,B02,083216,Ganzberger; Geoffrey Michael,2,0,32,30
1657518656714,MATH 109,B03,093479,Ganzberger; Geoffrey Michael,8,0,32,24
1657518662743,MATH 142A,A01,083219,Chow; Bennett,7,0,32,25
1657518662743,MATH 142A,A02,083220,Chow; Bennett,10,0,32,22
1657518662743,MATH 142A,A03,093480,Chow; Bennett,8,0,32,24
1657518662743,MATH 142A,B03,093481,Chow; Bennett,8,0,32,24
1657518662743,MATH 142A,B04,093558,Chow; Bennett,13,0,32,19
1657518662743,MATH 142A,B05,093559,Chow; Bennett,6,0,32,26
1657518668772,MATH 193A,A01,083224,Rotar; Vladimir,8,0,34,26
1657518668772,MATH 193A,A02,083225,Rotar; Vladimir,9,0,34,25
1657518668772,MATH 193A,A03,083781,Rotar; Vladimir,5,0,34,29
1657518668772,MATH 193A,A04,083782,Rotar; Vladimir,10,0,34,24
1657518668772,MATH 193A,A05,093482,Rotar; Vladimir,10,0,34,24
1657518674793,MATH 197,001,091859,McAuley; Julian John,9999,0,9999,0
1657518674793,MATH 197,002,095566,Kedlaya; Kiran S.,9997,0,9999,2
1657518674793,MATH 197,003,095567,Xiao; Ming,9999,0,9999,0
1657518674793,MATH 197,004,095571,Perols; Johan Lars,9998,0,9999,1
1657518681852,COGS 9,A01,083615,Shannon; Kyle Michael,9,0,75,66
1657518687877,COGS 11,A01,083617,Boyle; Mary E. T.,22,0,48,26
1657518693970,COGS 13,A01,083071,Bastos; Amalia Pinkusfeld,11,0,71,60
1657518700002,COGS 14A,A01,092681,Semenuks; Arturs,5,1,100,95
1657518706026,COGS 14B,A01,083073,Cheng; Tzu-Han,6,0,63,57
1657518712050,COGS 17,A01,092677,Semenuks; Arturs,6,0,81,75
1657518718073,COGS 100,A01,083619,Allen; Michael Gordon,17,0,70,53
1657518724100,COGS 101A,A01,083621,Davis; Joshua Daniel,9,0,68,59
1657518730127,COGS 101B,A01,091572,Allen; Michael Gordon,12,0,65,53
1657518736150,COGS 101C,A01,083625,Delgado; Tania,17,0,35,18
1657518742176,COGS 107A,A01,083627,Boyle; Mary E. T.,13,0,60,47
1657518748201,COGS 118A,A01,083075,Gupta; Anjum,21,0,76,55
1657518754224,CSE 3,A50,083646,Miranda; Gregory Joseph,24,0,50,26
1657518760245,CSE 8A,A50,083650,Miranda; Gregory Joseph,17,1,56,39
1657518766272,CSE 11,A01,083080,Cao; Yingjun,6,15,40,34
1657518772295,CSE 12,A01,083652,Krause-Levy; Sophia Louisa,28,1,120,92
1657518778322,CSE 15L,A01,083654,Morris; Justin Loren,9,0,50,41
1657518778322,CSE 15L,A02,083655,Morris; Justin Loren,9,0,50,41
1657518784349,CSE 20,A01,083657,Tran; Khoa Dang,39,0,80,41
1657518790372,CSE 21,A01,095574,Bach; Quang Tran,22,0,48,26
1657518796413,CSE 30,A01,083084,Eldon; John,5,0,80,75
1657518796413,CSE 30,B01,095061,Bhaskar; Nishant,9,0,50,41
1657518802435,CSE 100,A01,083659,Cao; Yingjun,5,4,70,65
1657518808456,CSE 134B,A01,083661,Powell; Thomas Allan,22,0,100,78
1657518814490,CSE 140,A01,083663,Gungor; Onat,15,0,85,70
1657518820516,CSE 140L,A01,083088,Eldon; John,21,0,100,79
1657518826540,CSE 175,A01,083665,Kumar; Rakesh,3,0,25,22
1657518832573,CSE 190,A00,092507,Dubnov; Shlomo,8,0,20,12
1657518838594,ECE 45,A01,083139,Congero; Spencer William,6,0,75,69
1657518844617,ECE 65,A50,083695,Saad; Andrew S,12,0,30,18
1657518844617,ECE 65,A51,095125,Saad; Andrew S,24,0,26,2
1657518850639,ECE 109,A01,091882,Touri; Behrouz,19,0,70,51
1657518856661,ECE 180,A00,083140,Abi Samra; Nicholas Camill,1,0,30,29
1657518856661,ECE 180,B00,083141,Abi Samra; Nicholas Camill,0,0,30,30
1657518862689,MATH 10A,A01,083735,Patchell; Gregory David,2,0,30,28
1657518862689,MATH 10A,A02,083736,Patchell; Gregory David,20,0,30,10
1657518862689,MATH 10A,A03,083737,Patchell; Gregory David,16,0,30,14
1657518868715,MATH 10B,A01,083207,Lim; Seonhee,8,0,34,26
1657518868715,MATH 10B,A02,083208,Lim; Seonhee,9,0,35,26
1657518868715,MATH 10B,A03,093472,Lim; Seonhee,7,0,34,27
1657518868715,MATH 10B,B01,083739,Sinha; Shubham,12,0,30,18
1657518874739,MATH 18,A01,083743,Cinel; Cameron Alexander,7,0,30,23
1657518874739,MATH 18,A02,083744,Cinel; Cameron Alexander,17,0,30,13
1657518874739,MATH 18,A03,083745,Cinel; Cameron Alexander,9,0,30,21
1657518874739,MATH 18,B01,083748,Rideout; David Porter,5,0,37,32
1657518874739,MATH 18,B02,083749,Rideout; David Porter,5,0,36,31
1657518874739,MATH 18,B03,083750,Rideout; David Porter,3,0,37,34
1657518874739,MATH 18,B04,083751,Rideout; David Porter,6,0,36,30
1657518874739,MATH 18,B05,093473,Rideout; David Porter,6,0,36,30
1657518874739,MATH 18,B06,093474,Rideout; David Porter,6,0,36,30
1657518880763,MATH 20A,A01,083754,Zheng; Zequn,14,0,40,26
1657518886785,MATH 20B,A01,083756,Briones; Jor-el Thomas Caparas,4,0,36,32
1657518886785,MATH 20B,A02,083757,Briones; Jor-el Thomas Caparas,1,0,36,35
1657518886785,MATH 20B,A03,093475,Briones; Jor-el Thomas Caparas,2,0,36,34
1657518892810,MATH 20C,A01,083760,Briones; Jor-el Thomas Caparas,1,0,35,34
1657518892810,MATH 20C,A02,083761,Briones; Jor-el Thomas Caparas,8,0,35,27
1657518892810,MATH 20C,A03,093476,Briones; Jor-el Thomas Caparas,0,1,36,36
1657518892810,MATH 20C,B01,083762,Bach; Quang Tran,1,0,30,29
1657518898839,MATH 20D,A01,083765,Tran; Brian Kha,5,0,30,25
1657518898839,MATH 20D,A02,083766,Tran; Brian Kha,5,0,30,25
1657518898839,MATH 20D,A03,083767,Tran; Brian Kha,5,0,30,25
1657518904869,MATH 20E,A01,083771,Ganguly; Soumya,9,0,32,23
1657518904869,MATH 20E,A02,083772,Ganguly; Soumya,6,0,32,26
1657518904869,MATH 20E,B01,083773,Ciotti; Benjamin,20,0,35,15
1657518904869,MATH 20E,B02,083774,Ciotti; Benjamin,17,0,35,18
1657518910892,MATH 103A,A01,083777,Greenfeld; Be'Eri,3,0,36,33
1657518910892,MATH 103A,A02,083778,Greenfeld; Be'Eri,5,0,36,31
1657518910892,MATH 103A,A03,093561,Greenfeld; Be'Eri,5,0,36,31
1657518910892,MATH 103A,B01,083779,Greenfeld; Be'Eri,7,0,36,29
1657518910892,MATH 103A,B02,083780,Greenfeld; Be'Eri,4,0,36,32
1657518910892,MATH 103A,B03,093562,Greenfeld; Be'Eri,3,0,36,33
1657518916920,MATH 105,A01,085443,Carter; Anne Toulson,15,0,35,20
1657518916920,MATH 105,A02,093477,Carter; Anne Toulson,20,0,35,15
1657518922943,MATH 109,A01,083213,Ganzberger; Geoffrey Michael,2,0,34,32
1657518922943,MATH 109,A02,083214,Ganzberger; Geoffrey Michael,4,0,34,30
1657518922943,MATH 109,A03,093478,Ganzberger; Geoffrey Michael,2,0,34,32
1657518922943,MATH 109,B01,083215,Ganzberger; Geoffrey Michael,1,0,32,31
1657518922943,MATH 109,B02,083216,Ganzberger; Geoffrey Michael,2,0,32,30
1657518922943,MATH 109,B03,093479,Ganzberger; Geoffrey Michael,8,0,32,24
1657518928972,MATH 142A,A01,083219,Chow; Bennett,7,0,32,25
1657518928972,MATH 142A,A02,083220,Chow; Bennett,10,0,32,22
1657518928972,MATH 142A,A03,093480,Chow; Bennett,8,0,32,24
1657518928972,MATH 142A,B03,093481,Chow; Bennett,8,0,32,24
1657518928972,MATH 142A,B04,093558,Chow; Bennett,13,0,32,19
1657518928972,MATH 142A,B05,093559,Chow; Bennett,6,0,32,26
1657518934996,MATH 193A,A01,083224,Rotar; Vladimir,8,0,34,26
1657518934996,MATH 193A,A02,083225,Rotar; Vladimir,9,0,34,25
1657518934996,MATH 193A,A03,083781,Rotar; Vladimir,5,0,34,29
1657518934996,MATH 193A,A04,083782,Rotar; Vladimir,10,0,34,24
1657518934996,MATH 193A,A05,093482,Rotar; Vladimir,10,0,34,24
1657518941020,MATH 197,001,091859,McAuley; Julian John,9999,0,9999,0
1657518941020,MATH 197,002,095566,Kedlaya; Kiran S.,9997,0,9999,2
1657518941020,MATH 197,003,095567,Xiao; Ming,9999,0,9999,0
1657518941020,MATH 197,004,095571,Perols; Johan Lars,9998,0,9999,1
1657518948078,COGS 9,A01,083615,Shannon; Kyle Michael,9,0,75,66
1657518954100,COGS 11,A01,083617,Boyle; Mary E. T.,22,0,48,26
1657518960123,COGS 13,A01,083071,Bastos; Amalia Pinkusfeld,11,0,71,60
1657518966159,COGS 14A,A01,092681,Semenuks; Arturs,5,1,100,95
1657518972182,COGS 14B,A01,083073,Cheng; Tzu-Han,6,0,63,57
1657518978210,COGS 17,A01,092677,Semenuks; Arturs,6,0,81,75
1657518984233,COGS 100,A01,083619,Allen; Michael Gordon,17,0,70,53
1657518990256,COGS 101A,A01,083621,Davis; Joshua Daniel,9,0,68,59
1657518996283,COGS 101B,A01,091572,Allen; Michael Gordon,12,0,65,53
1657519002309,COGS 101C,A01,083625,Delgado; Tania,17,0,35,18
1657519008337,COGS 107A,A01,083627,Boyle; Mary E. T.,13,0,60,47
1657519014359,COGS 118A,A01,083075,Gupta; Anjum,21,0,76,55
1657519020384,CSE 3,A50,083646,Miranda; Gregory Joseph,24,0,50,26
1657519026420,CSE 8A,A50,083650,Miranda; Gregory Joseph,17,1,56,39
1657519032452,CSE 11,A01,083080,Cao; Yingjun,6,15,40,34
1657519038474,CSE 12,A01,083652,Krause-Levy; Sophia Louisa,28,1,120,92
1657519044497,CSE 15L,A01,083654,Morris; Justin Loren,9,0,50,41
1657519044497,CSE 15L,A02,083655,Morris; Justin Loren,9,0,50,41
1657519050522,CSE 20,A01,083657,Tran; Khoa Dang,39,0,80,41
1657519056544,CSE 21,A01,095574,Bach; Quang Tran,22,0,48,26
1657519062575,CSE 30,A01,083084,Eldon; John,5,0,80,75
1657519062575,CSE 30,B01,095061,Bhaskar; Nishant,9,0,50,41
1657519068598,CSE 100,A01,083659,Cao; Yingjun,5,4,70,65
1657519074622,CSE 134B,A01,083661,Powell; Thomas Allan,22,0,100,78
1657519080656,CSE 140,A01,083663,Gungor; Onat,15,0,85,70
1657519086681,CSE 140L,A01,083088,Eldon; John,21,0,100,79
1657519092708,CSE 175,A01,083665,Kumar; Rakesh,3,0,25,22
1657519098732,CSE 190,A00,092507,Dubnov; Shlomo,8,0,20,12
1657519104758,ECE 45,A01,083139,Congero; Spencer William,6,0,75,69
1657519110788,ECE 65,A50,083695,Saad; Andrew S,12,0,30,18
1657519110788,ECE 65,A51,095125,Saad; Andrew S,24,0,26,2
1657519116812,ECE 109,A01,091882,Touri; Behrouz,19,0,70,51
1657519122846,ECE 180,A00,083140,Abi Samra; Nicholas Camill,1,0,30,29
1657519122846,ECE 180,B00,083141,Abi Samra; Nicholas Camill,0,0,30,30
1657519128878,MATH 10A,A01,083735,Patchell; Gregory David,2,0,30,28
1657519128878,MATH 10A,A02,083736,Patchell; Gregory David,20,0,30,10
1657519128878,MATH 10A,A03,083737,Patchell; Gregory David,16,0,30,14
1657519134910,MATH 10B,A01,083207,Lim; Seonhee,8,0,34,26
1657519134910,MATH 10B,A02,083208,Lim; Seonhee,9,0,35,26
1657519134910,MATH 10B,A03,093472,Lim; Seonhee,7,0,34,27
1657519134910,MATH 10B,B01,083739,Sinha; Shubham,12,0,30,18
1657519140941,MATH 18,A01,083743,Cinel; Cameron Alexander,7,0,30,23
1657519140941,MATH 18,A02,083744,Cinel; Cameron Alexander,17,0,30,13
1657519140941,MATH 18,A03,083745,Cinel; Cameron Alexander,9,0,30,21
1657519140941,MATH 18,B01,083748,Rideout; David Porter,5,0,37,32
1657519140941,MATH 18,B02,083749,Rideout; David Porter,5,0,36,31
1657519140941,MATH 18,B03,083750,Rideout; David Porter,3,0,37,34
1657519140941,MATH 18,B04,083751,Rideout; David Porter,6,0,36,30
1657519140941,MATH 18,B05,093473,Rideout; David Porter,6,0,36,30
1657519140941,MATH 18,B06,093474,Rideout; David Porter,6,0,36,30
1657519146967,MATH 20A,A01,083754,Zheng; Zequn,14,0,40,26
1657519152994,MATH 20B,A01,083756,Briones; Jor-el Thomas Caparas,4,0,36,32
1657519152994,MATH 20B,A02,083757,Briones; Jor-el Thomas Caparas,1,0,36,35
1657519152994,MATH 20B,A03,093475,Briones; Jor-el Thomas Caparas,2,0,36,34
1657519159030,MATH 20C,A01,083760,Briones; Jor-el Thomas Caparas,1,0,35,34
1657519159030,MATH 20C,A02,083761,Briones; Jor-el Thomas Caparas,8,0,35,27
1657519159030,MATH 20C,A03,093476,Briones; Jor-el Thomas Caparas,0,1,36,36
1657519159030,MATH 20C,B01,083762,Bach; Quang Tran,1,0,30,29
1657519165058,MATH 20D,A01,083765,Tran; Brian Kha,5,0,30,25
1657519165058,MATH 20D,A02,083766,Tran; Brian Kha,5,0,30,25
1657519165058,MATH 20D,A03,083767,Tran; Brian Kha,5,0,30,25
1657519171086,MATH 20E,A01,083771,Ganguly; Soumya,9,0,32,23
1657519171086,MATH 20E,A02,083772,Ganguly; Soumya,6,0,32,26
1657519171086,MATH 20E,B01,083773,Ciotti; Benjamin,20,0,35,15
1657519171086,MATH 20E,B02,083774,Ciotti; Benjamin,17,0,35,18
1657519177115,MATH 103A,A01,083777,Greenfeld; Be'Eri,3,0,36,33
1657519177115,MATH 103A,A02,083778,Greenfeld; Be'Eri,5,0,36,31
1657519177115,MATH 103A,A03,093561,Greenfeld; Be'Eri,5,0,36,31
1657519177115,MATH 103A,B01,083779,Greenfeld; Be'Eri,7,0,36,29
1657519177115,MATH 103A,B02,083780,Greenfeld; Be'Eri,4,0,36,32
1657519177115,MATH 103A,B03,093562,Greenfeld; Be'Eri,3,0,36,33
1657519183139,MATH 105,A01,085443,Carter; Anne Toulson,15,0,35,20
1657519183139,MATH 105,A02,093477,Carter; Anne Toulson,20,0,35,15
1657519189189,MATH 109,A01,083213,Ganzberger; Geoffrey Michael,2,0,34,32
1657519189189,MATH 109,A02,083214,Ganzberger; Geoffrey Michael,4,0,34,30
1657519189189,MATH 109,A03,093478,Ganzberger; Geoffrey Michael,2,0,34,32
1657519189189,MATH 109,B01,083215,Ganzberger; Geoffrey Michael,1,0,32,31
1657519189189,MATH 109,B02,083216,Ganzberger; Geoffrey Michael,2,0,32,30
1657519189189,MATH 109,B03,093479,Ganzberger; Geoffrey Michael,8,0,32,24
1657519195213,MATH 142A,A01,083219,Chow; Bennett,7,0,32,25
1657519195213,MATH 142A,A02,083220,Chow; Bennett,10,0,32,22
1657519195213,MATH 142A,A03,093480,Chow; Bennett,8,0,32,24
1657519195213,MATH 142A,B03,093481,Chow; Bennett,8,0,32,24
1657519195213,MATH 142A,B04,093558,Chow; Bennett,13,0,32,19
1657519195213,MATH 142A,B05,093559,Chow; Bennett,6,0,32,26
1657519201235,MATH 193A,A01,083224,Rotar; Vladimir,8,0,34,26
1657519201235,MATH 193A,A02,083225,Rotar; Vladimir,9,0,34,25
1657519201235,MATH 193A,A03,083781,Rotar; Vladimir,5,0,34,29
1657519201235,MATH 193A,A04,083782,Rotar; Vladimir,10,0,34,24
1657519201235,MATH 193A,A05,093482,Rotar; Vladimir,10,0,34,24
1657519207260,MATH 197,001,091859,McAuley; Julian John,9999,0,9999,0
1657519207260,MATH 197,002,095566,Kedlaya; Kiran S.,9997,0,9999,2
1657519207260,MATH 197,003,095567,Xiao; Ming,9999,0,9999,0
1657519207260,MATH 197,004,095571,Perols; Johan Lars,9998,0,9999,1
1657519214322,COGS 9,A01,083615,Shannon; Kyle Michael,9,0,75,66
1657519220347,COGS 11,A01,083617,Boyle; Mary E. T.,22,0,48,26
1657519226374,COGS 13,A01,083071,Bastos; Amalia Pinkusfeld,11,0,71,60
1657519232399,COGS 14A,A01,092681,Semenuks; Arturs,5,1,100,95
1657519238426,COGS 14B,A01,083073,Cheng; Tzu-Han,6,0,63,57
1657519244451,COGS 17,A01,092677,Semenuks; Arturs,6,0,81,75
1657519250476,COGS 100,A01,083619,Allen; Michael Gordon,17,0,70,53
1657519256499,COGS 101A,A01,083621,Davis; Joshua Daniel,9,0,68,59
1657519262524,COGS 101B,A01,091572,Allen; Michael Gordon,12,0,65,53
1657519268548,COGS 101C,A01,083625,Delgado; Tania,17,0,35,18
1657519274572,COGS 107A,A01,083627,Boyle; Mary E. T.,13,0,60,47
1657519280605,COGS 118A,A01,083075,Gupta; Anjum,21,0,76,55
1657519286648,CSE 3,A50,083646,Miranda; Gregory Joseph,24,0,50,26
1657519292762,CSE 8A,A50,083650,Miranda; Gregory Joseph,17,1,56,39
1657519298787,CSE 11,A01,083080,Cao; Yingjun,6,15,40,34
1657519304812,CSE 12,A01,083652,Krause-Levy; Sophia Louisa,28,1,120,92
1657519310835,CSE 15L,A01,083654,Morris; Justin Loren,9,0,50,41
1657519310835,CSE 15L,A02,083655,Morris; Justin Loren,9,0,50,41
1657519316866,CSE 20,A01,083657,Tran; Khoa Dang,39,0,80,41
1657519322890,CSE 21,A01,095574,Bach; Quang Tran,22,0,48,26
1657519328917,CSE 30,A01,083084,Eldon; John,5,0,80,75
1657519328917,CSE 30,B01,095061,Bhaskar; Nishant,9,0,50,41
1657519334941,CSE 100,A01,083659,Cao; Yingjun,5,4,70,65
1657519340968,CSE 134B,A01,083661,Powell; Thomas Allan,22,0,100,78
1657519346994,CSE 140,A01,083663,Gungor; Onat,15,0,85,70
1657519353022,CSE 140L,A01,083088,Eldon; John,21,0,100,79
1657519359050,CSE 175,A01,083665,Kumar; Rakesh,3,0,25,22
1657519365082,CSE 190,A00,092507,Dubnov; Shlomo,8,0,20,12
1657519371111,ECE 45,A01,083139,Congero; Spencer William,6,0,75,69
1657519377150,ECE 65,A50,083695,Saad; Andrew S,12,0,30,18
1657519377150,ECE 65,A51,095125,Saad; Andrew S,24,0,26,2
1657519383177,ECE 109,A01,091882,Touri; Behrouz,19,0,70,51
1657519389207,ECE 180,A00,083140,Abi Samra; Nicholas Camill,1,0,30,29
1657519389207,ECE 180,B00,083141,Abi Samra; Nicholas Camill,0,0,30,30
1657519395232,MATH 10A,A01,083735,Patchell; Gregory David,2,0,30,28
1657519395232,MATH 10A,A02,083736,Patchell; Gregory David,20,0,30,10
1657519395232,MATH 10A,A03,083737,Patchell; Gregory David,16,0,30,14
1657519401257,MATH 10B,A01,083207,Lim; Seonhee,8,0,34,26
1657519401257,MATH 10B,A02,083208,Lim; Seonhee,9,0,35,26
1657519401257,MATH 10B,A03,093472,Lim; Seonhee,7,0,34,27
1657519401257,MATH 10B,B01,083739,Sinha; Shubham,12,0,30,18
1657519407345,MATH 18,A01,083743,Cinel; Cameron Alexander,7,0,30,23
1657519407345,MATH 18,A02,083744,Cinel; Cameron Alexander,17,0,30,13
1657519407345,MATH 18,A03,083745,Cinel; Cameron Alexander,9,0,30,21
1657519407345,MATH 18,B01,083748,Rideout; David Porter,5,0,37,32
1657519407345,MATH 18,B02,083749,Rideout; David Porter,5,0,36,31
1657519407345,MATH 18,B03,083750,Rideout; David Porter,3,0,37,34
1657519407345,MATH 18,B04,083751,Rideout; David Porter,6,0,36,30
1657519407345,MATH 18,B05,093473,Rideout; David Porter,6,0,36,30
1657519407345,MATH 18,B06,093474,Rideout; David Porter,6,0,36,30
1657519413370,MATH 20A,A01,083754,Zheng; Zequn,14,0,40,26
1657519419394,MATH 20B,A01,083756,Briones; Jor-el Thomas Caparas,4,0,36,32
1657519419394,MATH 20B,A02,083757,Briones; Jor-el Thomas Caparas,1,0,36,35
1657519419394,MATH 20B,A03,093475,Briones; Jor-el Thomas Caparas,2,0,36,34
1657519425423,MATH 20C,A01,083760,Briones; Jor-el Thomas Caparas,1,0,35,34
1657519425423,MATH 20C,A02,083761,Briones; Jor-el Thomas Caparas,8,0,35,27
1657519425423,MATH 20C,A03,093476,Briones; Jor-el Thomas Caparas,0,1,36,36
1657519425423,MATH 20C,B01,083762,Bach; Quang Tran,1,0,30,29
1657519431448,MATH 20D,A01,083765,Tran; Brian Kha,5,0,30,25
1657519431448,MATH 20D,A02,083766,Tran; Brian Kha,5,0,30,25
1657519431448,MATH 20D,A03,083767,Tran; Brian Kha,5,0,30,25
1657519437479,MATH 20E,A01,083771,Ganguly; Soumya,9,0,32,23
1657519437479,MATH 20E,A02,083772,Ganguly; Soumya,6,0,32,26
1657519437479,MATH 20E,B01,083773,Ciotti; Benjamin,20,0,35,15
1657519437479,MATH 20E,B02,083774,Ciotti; Benjamin,17,0,35,18
1657519443504,MATH 103A,A01,083777,Greenfeld; Be'Eri,3,0,36,33
1657519443504,MATH 103A,A02,083778,Greenfeld; Be'Eri,5,0,36,31
1657519443504,MATH 103A,A03,093561,Greenfeld; Be'Eri,5,0,36,31
1657519443504,MATH 103A,B01,083779,Greenfeld; Be'Eri,7,0,36,29
1657519443504,MATH 103A,B02,083780,Greenfeld; Be'Eri,4,0,36,32
1657519443504,MATH 103A,B03,093562,Greenfeld; Be'Eri,3,0,36,33
1657519449530,MATH 105,A01,085443,Carter; Anne Toulson,15,0,35,20
1657519449530,MATH 105,A02,093477,Carter; Anne Toulson,20,0,35,15
1657519455553,MATH 109,A01,083213,Ganzberger; Geoffrey Michael,2,0,34,32
1657519455553,MATH 109,A02,083214,Ganzberger; Geoffrey Michael,4,0,34,30
1657519455553,MATH 109,A03,093478,Ganzberger; Geoffrey Michael,2,0,34,32
1657519455553,MATH 109,B01,083215,Ganzberger; Geoffrey Michael,1,0,32,31
1657519455553,MATH 109,B02,083216,Ganzberger; Geoffrey Michael,2,0,32,30
1657519455553,MATH 109,B03,093479,Ganzberger; Geoffrey Michael,8,0,32,24
1657519461579,MATH 142A,A01,083219,Chow; Bennett,7,0,32,25
1657519461579,MATH 142A,A02,083220,Chow; Bennett,10,0,32,22
1657519461579,MATH 142A,A03,093480,Chow; Bennett,8,0,32,24
1657519461579,MATH 142A,B03,093481,Chow; Bennett,8,0,32,24
1657519461579,MATH 142A,B04,093558,Chow; Bennett,13,0,32,19
1657519461579,MATH 142A,B05,093559,Chow; Bennett,6,0,32,26
1657519467606,MATH 193A,A01,083224,Rotar; Vladimir,8,0,34,26
1657519467606,MATH 193A,A02,083225,Rotar; Vladimir,9,0,34,25
1657519467606,MATH 193A,A03,083781,Rotar; Vladimir,5,0,34,29
1657519467606,MATH 193A,A04,083782,Rotar; Vladimir,10,0,34,24
1657519467606,MATH 193A,A05,093482,Rotar; Vladimir,10,0,34,24
1657519473631,MATH 197,001,091859,McAuley; Julian John,9999,0,9999,0
1657519473631,MATH 197,002,095566,Kedlaya; Kiran S.,9997,0,9999,2
1657519473631,MATH 197,003,095567,Xiao; Ming,9999,0,9999,0
1657519473631,MATH 197,004,095571,Perols; Johan Lars,9998,0,9999,1
1657519480685,COGS 9,A01,083615,Shannon; Kyle Michael,9,0,75,66
1657519486716,COGS 11,A01,083617,Boyle; Mary E. T.,22,0,48,26
1657519492749,COGS 13,A01,083071,Bastos; Amalia Pinkusfeld,11,0,71,60
1657519498772,COGS 14A,A01,092681,Semenuks; Arturs,5,1,100,95
1657519504802,COGS 14B,A01,083073,Cheng; Tzu-Han,6,0,63,57
1657519510838,COGS 17,A01,092677,Semenuks; Arturs,6,0,81,75
1657519516862,COGS 100,A01,083619,Allen; Michael Gordon,17,0,70,53
1657519522886,COGS 101A,A01,083621,Davis; Joshua Daniel,9,0,68,59
1657519528913,COGS 101B,A01,091572,Allen; Michael Gordon,12,0,65,53
1657519534940,COGS 101C,A01,083625,Delgado; Tania,17,0,35,18
1657519540968,COGS 107A,A01,083627,Boyle; Mary E. T.,13,0,60,47
1657519546996,COGS 118A,A01,083075,Gupta; Anjum,21,0,76,55
1657519553028,CSE 3,A50,083646,Miranda; Gregory Joseph,24,0,50,26
1657519559056,CSE 8A,A50,083650,Miranda; Gregory Joseph,17,1,56,39
1657519565083,CSE 11,A01,083080,Cao; Yingjun,6,15,40,34
1657519571106,CSE 12,A01,083652,Krause-Levy; Sophia Louisa,28,1,120,92
1657519577131,CSE 15L,A01,083654,Morris; Justin Loren,9,0,50,41
1657519577131,CSE 15L,A02,083655,Morris; Justin Loren,9,0,50,41
1657519583160,CSE 20,A01,083657,Tran; Khoa Dang,39,0,80,41
1657519589187,CSE 21,A01,095574,Bach; Quang Tran,22,0,48,26
1657519595211,CSE 30,A01,083084,Eldon; John,5,0,80,75
1657519595211,CSE 30,B01,095061,Bhaskar; Nishant,9,0,50,41
1657519601237,CSE 100,A01,083659,Cao; Yingjun,5,4,70,65
1657519607261,CSE 134B,A01,083661,Powell; Thomas Allan,22,0,100,78
1657519613285,CSE 140,A01,083663,Gungor; Onat,15,0,85,70
1657519619313,CSE 140L,A01,083088,Eldon; John,21,0,100,79
1657519625337,CSE 175,A01,083665,Kumar; Rakesh,3,0,25,22
1657519631362,CSE 190,A00,092507,Dubnov; Shlomo,8,0,20,12
1657519637390,ECE 45,A01,083139,Congero; Spencer William,6,0,75,69
1657519643414,ECE 65,A50,083695,Saad; Andrew S,12,0,30,18
1657519643414,ECE 65,A51,095125,Saad; Andrew S,24,0,26,2
1657519649444,ECE 109,A01,091882,Touri; Behrouz,19,0,70,51
1657519655471,ECE 180,A00,083140,Abi Samra; Nicholas Camill,1,0,30,29
1657519655471,ECE 180,B00,083141,Abi Samra; Nicholas Camill,0,0,30,30
1657519661493,MATH 10A,A01,083735,Patchell; Gregory David,2,0,30,28
1657519661493,MATH 10A,A02,083736,Patchell; Gregory David,20,0,30,10
1657519661493,MATH 10A,A03,083737,Patchell; Gregory David,16,0,30,14
1657519667525,MATH 10B,A01,083207,Lim; Seonhee,8,0,34,26
1657519667525,MATH 10B,A02,083208,Lim; Seonhee,9,0,35,26
1657519667525,MATH 10B,A03,093472,Lim; Seonhee,7,0,34,27
1657519667525,MATH 10B,B01,083739,Sinha; Shubham,12,0,30,18
1657519673557,MATH 18,A01,083743,Cinel; Cameron Alexander,7,0,30,23
1657519673557,MATH 18,A02,083744,Cinel; Cameron Alexander,17,0,30,13
1657519673557,MATH 18,A03,083745,Cinel; Cameron Alexander,9,0,30,21
1657519673557,MATH 18,B01,083748,Rideout; David Porter,5,0,37,32
1657519673557,MATH 18,B02,083749,Rideout; David Porter,5,0,36,31
1657519673557,MATH 18,B03,083750,Rideout; David Porter,3,0,37,34
1657519673557,MATH 18,B04,083751,Rideout; David Porter,6,0,36,30
1657519673557,MATH 18,B05,093473,Rideout; David Porter,6,0,36,30
1657519673557,MATH 18,B06,093474,Rideout; David Porter,6,0,36,30
1657519679580,MATH 20A,A01,083754,Zheng; Zequn,14,0,40,26
1657519685609,MATH 20B,A01,083756,Briones; Jor-el Thomas Caparas,4,0,36,32
1657519685609,MATH 20B,A02,083757,Briones; Jor-el Thomas Caparas,1,0,36,35
1657519685609,MATH 20B,A03,093475,Briones; Jor-el Thomas Caparas,2,0,36,34
1657519691639,MATH 20C,A01,083760,Briones; Jor-el Thomas Caparas,1,0,35,34
1657519691639,MATH 20C,A02,083761,Briones; Jor-el Thomas Caparas,8,0,35,27
1657519691639,MATH 20C,A03,093476,Briones; Jor-el Thomas Caparas,0,1,36,36
1657519691639,MATH 20C,B01,083762,Bach; Quang Tran,1,0,30,29
1657519697662,MATH 20D,A01,083765,Tran; Brian Kha,5,0,30,25
1657519697662,MATH 20D,A02,083766,Tran; Brian Kha,5,0,30,25
1657519697662,MATH 20D,A03,083767,Tran; Brian Kha,5,0,30,25
1657519703686,MATH 20E,A01,083771,Ganguly; Soumya,9,0,32,23
1657519703686,MATH 20E,A02,083772,Ganguly; Soumya,6,0,32,26
1657519703686,MATH 20E,B01,083773,Ciotti; Benjamin,20,0,35,15
1657519703686,MATH 20E,B02,083774,Ciotti; Benjamin,17,0,35,18
1657519709708,MATH 103A,A01,083777,Greenfeld; Be'Eri,3,0,36,33
1657519709708,MATH 103A,A02,083778,Greenfeld; Be'Eri,5,0,36,31
1657519709708,MATH 103A,A03,093561,Greenfeld; Be'Eri,5,0,36,31
1657519709708,MATH 103A,B01,083779,Greenfeld; Be'Eri,7,0,36,29
1657519709708,MATH 103A,B02,083780,Greenfeld; Be'Eri,4,0,36,32
1657519709708,MATH 103A,B03,093562,Greenfeld; Be'Eri,3,0,36,33
1657519715733,MATH 105,A01,085443,Carter; Anne Toulson,15,0,35,20
1657519715733,MATH 105,A02,093477,Carter; Anne Toulson,20,0,35,15
1657519721825,MATH 109,A01,083213,Ganzberger; Geoffrey Michael,2,0,34,32
1657519721825,MATH 109,A02,083214,Ganzberger; Geoffrey Michael,4,0,34,30
1657519721825,MATH 109,A03,093478,Ganzberger; Geoffrey Michael,2,0,34,32
1657519721825,MATH 109,B01,083215,Ganzberger; Geoffrey Michael,1,0,32,31
1657519721825,MATH 109,B02,083216,Ganzberger; Geoffrey Michael,2,0,32,30
1657519721825,MATH 109,B03,093479,Ganzberger; Geoffrey Michael,8,0,32,24
1657519727848,MATH 142A,A01,083219,Chow; Bennett,7,0,32,25
1657519727848,MATH 142A,A02,083220,Chow; Bennett,10,0,32,22
1657519727848,MATH 142A,A03,093480,Chow; Bennett,8,0,32,24
1657519727848,MATH 142A,B03,093481,Chow; Bennett,8,0,32,24
1657519727848,MATH 142A,B04,093558,Chow; Bennett,13,0,32,19
1657519727848,MATH 142A,B05,093559,Chow; Bennett,6,0,32,26
1657519733876,MATH 193A,A01,083224,Rotar; Vladimir,8,0,34,26
1657519733876,MATH 193A,A02,083225,Rotar; Vladimir,9,0,34,25
1657519733876,MATH 193A,A03,083781,Rotar; Vladimir,5,0,34,29
1657519733876,MATH 193A,A04,083782,Rotar; Vladimir,10,0,34,24
1657519733876,MATH 193A,A05,093482,Rotar; Vladimir,10,0,34,24
1657519739898,MATH 197,001,091859,McAuley; Julian John,9999,0,9999,0
1657519739898,MATH 197,002,095566,Kedlaya; Kiran S.,9997,0,9999,2
1657519739898,MATH 197,003,095567,Xiao; Ming,9999,0,9999,0
1657519739898,MATH 197,004,095571,Perols; Johan Lars,9998,0,9999,1
1657519746958,COGS 9,A01,083615,Shannon; Kyle Michael,9,0,75,66
1657519752983,COGS 11,A01,083617,Boyle; Mary E. T.,22,0,48,26
1657519759010,COGS 13,A01,083071,Bastos; Amalia Pinkusfeld,11,0,71,60
1657519765038,COGS 14A,A01,092681,Semenuks; Arturs,5,1,100,95
1657519771060,COGS 14B,A01,083073,Cheng; Tzu-Han,6,0,63,57
1657519777083,COGS 17,A01,092677,Semenuks; Arturs,6,0,81,75
1657519783106,COGS 100,A01,083619,Allen; Michael Gordon,17,0,70,53
1657519789134,COGS 101A,A01,083621,Davis; Joshua Daniel,9,0,68,59
1657519795157,COGS 101B,A01,091572,Allen; Michael Gordon,12,0,65,53
1657519801185,COGS 101C,A01,083625,Delgado; Tania,17,0,35,18
1657519807212,COGS 107A,A01,083627,Boyle; Mary E. T.,13,0,60,47
1657519813241,COGS 118A,A01,083075,Gupta; Anjum,21,0,76,55
1657519819268,CSE 3,A50,083646,Miranda; Gregory Joseph,24,0,50,26
1657519825292,CSE 8A,A50,083650,Miranda; Gregory Joseph,17,1,56,39
1657519831317,CSE 11,A01,083080,Cao; Yingjun,6,15,40,34
1657519837343,CSE 12,A01,083652,Krause-Levy; Sophia Louisa,28,1,120,92
1657519843371,CSE 15L,A01,083654,Morris; Justin Loren,9,0,50,41
1657519843371,CSE 15L,A02,083655,Morris; Justin Loren,9,0,50,41
1657519849395,CSE 20,A01,083657,Tran; Khoa Dang,39,0,80,41
1657519855418,CSE 21,A01,095574,Bach; Quang Tran,22,0,48,26
1657519861442,CSE 30,A01,083084,Eldon; John,5,0,80,75
1657519861442,CSE 30,B01,095061,Bhaskar; Nishant,9,0,50,41
1657519867468,CSE 100,A01,083659,Cao; Yingjun,5,4,70,65
1657519873491,CSE 134B,A01,083661,Powell; Thomas Allan,22,0,100,78
1657519879518,CSE 140,A01,083663,Gungor; Onat,15,0,85,70
1657519885539,CSE 140L,A01,083088,Eldon; John,21,0,100,79
1657519891650,CSE 175,A01,083665,Kumar; Rakesh,3,0,25,22
1657519897675,CSE 190,A00,092507,Dubnov; Shlomo,8,0,20,12
1657519903696,ECE 45,A01,083139,Congero; Spencer William,6,0,75,69
1657519909722,ECE 65,A50,083695,Saad; Andrew S,12,0,30,18
1657519909722,ECE 65,A51,095125,Saad; Andrew S,24,0,26,2
1657519915754,ECE 109,A01,091882,Touri; Behrouz,19,0,70,51
1657519921780,ECE 180,A00,083140,Abi Samra; Nicholas Camill,1,0,30,29
1657519921780,ECE 180,B00,083141,Abi Samra; Nicholas Camill,0,0,30,30
1657519927806,MATH 10A,A01,083735,Patchell; Gregory David,2,0,30,28
1657519927806,MATH 10A,A02,083736,Patchell; Gregory David,20,0,30,10
1657519927806,MATH 10A,A03,083737,Patchell; Gregory David,16,0,30,14
1657519933834,MATH 10B,A01,083207,Lim; Seonhee,8,0,34,26
1657519933834,MATH 10B,A02,083208,Lim; Seonhee,9,0,35,26
1657519933834,MATH 10B,A03,093472,Lim; Seonhee,7,0,34,27
1657519933834,MATH 10B,B01,083739,Sinha; Shubham,12,0,30,18
1657519939865,MATH 18,A01,083743,Cinel; Cameron Alexander,7,0,30,23
1657519939865,MATH 18,A02,083744,Cinel; Cameron Alexander,17,0,30,13
1657519939865,MATH 18,A03,083745,Cinel; Cameron Alexander,9,0,30,21
1657519939865,MATH 18,B01,083748,Rideout; David Porter,5,0,37,32
1657519939865,MATH 18,B02,083749,Rideout; David Porter,5,0,36,31
1657519939865,MATH 18,B03,083750,Rideout; David Porter,3,0,37,34
1657519939865,MATH 18,B04,083751,Rideout; David Porter,6,0,36,30
1657519939865,MATH 18,B05,093473,Rideout; David Porter,6,0,36,30
1657519939865,MATH 18,B06,093474,Rideout; David Porter,6,0,36,30
1657519945886,MATH 20A,A01,083754,Zheng; Zequn,14,0,40,26
1657519951913,MATH 20B,A01,083756,Briones; Jor-el Thomas Caparas,4,0,36,32
1657519951913,MATH 20B,A02,083757,Briones; Jor-el Thomas Caparas,1,0,36,35
1657519951913,MATH 20B,A03,093475,Briones; Jor-el Thomas Caparas,2,0,36,34
1657519957937,MATH 20C,A01,083760,Briones; Jor-el Thomas Caparas,1,0,35,34
1657519957937,MATH 20C,A02,083761,Briones; Jor-el Thomas Caparas,8,0,35,27
1657519957937,MATH 20C,A03,093476,Briones; Jor-el Thomas Caparas,0,1,36,36
1657519957937,MATH 20C,B01,083762,Bach; Quang Tran,1,0,30,29
1657519963959,MATH 20D,A01,083765,Tran; Brian Kha,5,0,30,25
1657519963959,MATH 20D,A02,083766,Tran; Brian Kha,5,0,30,25
1657519963959,MATH 20D,A03,083767,Tran; Brian Kha,5,0,30,25
1657519969989,MATH 20E,A01,083771,Ganguly; Soumya,9,0,32,23
1657519969989,MATH 20E,A02,083772,Ganguly; Soumya,6,0,32,26
1657519969989,MATH 20E,B01,083773,Ciotti; Benjamin,20,0,35,15
1657519969989,MATH 20E,B02,083774,Ciotti; Benjamin,17,0,35,18
1657519976015,MATH 103A,A01,083777,Greenfeld; Be'Eri,3,0,36,33
1657519976015,MATH 103A,A02,083778,Greenfeld; Be'Eri,5,0,36,31
1657519976015,MATH 103A,A03,093561,Greenfeld; Be'Eri,5,0,36,31
1657519976015,MATH 103A,B01,083779,Greenfeld; Be'Eri,7,0,36,29
1657519976015,MATH 103A,B02,083780,Greenfeld; Be'Eri,4,0,36,32
1657519976015,MATH 103A,B03,093562,Greenfeld; Be'Eri,3,0,36,33
1657519982039,MATH 105,A01,085443,Carter; Anne Toulson,15,0,35,20
1657519982039,MATH 105,A02,093477,Carter; Anne Toulson,20,0,35,15
1657519988061,MATH 109,A01,083213,Ganzberger; Geoffrey Michael,2,0,34,32
1657519988061,MATH 109,A02,083214,Ganzberger; Geoffrey Michael,4,0,34,30
1657519988061,MATH 109,A03,093478,Ganzberger; Geoffrey Michael,2,0,34,32
1657519988061,MATH 109,B01,083215,Ganzberger; Geoffrey Michael,1,0,32,31
1657519988061,MATH 109,B02,083216,Ganzberger; Geoffrey Michael,2,0,32,30
1657519988061,MATH 109,B03,093479,Ganzberger; Geoffrey Michael,8,0,32,24
1657519994091,MATH 142A,A01,083219,Chow; Bennett,7,0,32,25
1657519994091,MATH 142A,A02,083220,Chow; Bennett,10,0,32,22
1657519994091,MATH 142A,A03,093480,Chow; Bennett,8,0,32,24
1657519994091,MATH 142A,B03,093481,Chow; Bennett,8,0,32,24
1657519994091,MATH 142A,B04,093558,Chow; Bennett,13,0,32,19
1657519994091,MATH 142A,B05,093559,Chow; Bennett,6,0,32,26
1657520000116,MATH 193A,A01,083224,Rotar; Vladimir,8,0,34,26
1657520000116,MATH 193A,A02,083225,Rotar; Vladimir,9,0,34,25
1657520000116,MATH 193A,A03,083781,Rotar; Vladimir,5,0,34,29
1657520000116,MATH 193A,A04,083782,Rotar; Vladimir,10,0,34,24
1657520000116,MATH 193A,A05,093482,Rotar; Vladimir,10,0,34,24
1657520006138,MATH 197,001,091859,McAuley; Julian John,9999,0,9999,0
1657520006138,MATH 197,002,095566,Kedlaya; Kiran S.,9997,0,9999,2
1657520006138,MATH 197,003,095567,Xiao; Ming,9999,0,9999,0
1657520006138,MATH 197,004,095571,Perols; Johan Lars,9998,0,9999,1
1657520013191,COGS 9,A01,083615,Shannon; Kyle Michael,9,0,75,66
1657520019216,COGS 11,A01,083617,Boyle; Mary E. T.,22,0,48,26
1657520025239,COGS 13,A01,083071,Bastos; Amalia Pinkusfeld,11,0,71,60
1657520031271,COGS 14A,A01,092681,Semenuks; Arturs,5,1,100,95
1657520037300,COGS 14B,A01,083073,Cheng; Tzu-Han,6,0,63,57
1657520043325,COGS 17,A01,092677,Semenuks; Arturs,6,0,81,75
1657520049349,COGS 100,A01,083619,Allen; Michael Gordon,17,0,70,53
1657520055372,COGS 101A,A01,083621,Davis; Joshua Daniel,9,0,68,59
1657520061406,COGS 101B,A01,091572,Allen; Michael Gordon,12,0,65,53
1657520067436,COGS 101C,A01,083625,Delgado; Tania,17,0,35,18
1657520073471,COGS 107A,A01,083627,Boyle; Mary E. T.,13,0,60,47
1657520079498,COGS 118A,A01,083075,Gupta; Anjum,21,0,76,55
1657520085520,CSE 3,A50,083646,Miranda; Gregory Joseph,24,0,50,26
1657520091544,CSE 8A,A50,083650,Miranda; Gregory Joseph,17,1,56,39
1657520097568,CSE 11,A01,083080,Cao; Yingjun,6,15,40,34
1657520103591,CSE 12,A01,083652,Krause-Levy; Sophia Louisa,28,1,120,92
1657520109619,CSE 15L,A01,083654,Morris; Justin Loren,9,0,50,41
1657520109619,CSE 15L,A02,083655,Morris; Justin Loren,9,0,50,41
1657520115643,CSE 20,A01,083657,Tran; Khoa Dang,39,0,80,41
1657520121668,CSE 21,A01,095574,Bach; Quang Tran,22,0,48,26
1657520127691,CSE 30,A01,083084,Eldon; John,5,0,80,75
1657520127691,CSE 30,B01,095061,Bhaskar; Nishant,9,0,50,41
1657520133720,CSE 100,A01,083659,Cao; Yingjun,5,4,70,65
1657520139753,CSE 134B,A01,083661,Powell; Thomas Allan,22,0,100,78
1657520145780,CSE 140,A01,083663,Gungor; Onat,15,0,85,70
1657520151813,CSE 140L,A01,083088,Eldon; John,21,0,100,79
1657520157856,CSE 175,A01,083665,Kumar; Rakesh,3,0,25,22
1657520163904,CSE 190,A00,092507,Dubnov; Shlomo,8,0,20,12
1657520169931,ECE 45,A01,083139,Congero; Spencer William,6,0,75,69
1657520175957,ECE 65,A50,083695,Saad; Andrew S,12,0,30,18
1657520175957,ECE 65,A51,095125,Saad; Andrew S,24,0,26,2
1657520181981,ECE 109,A01,091882,Touri; Behrouz,19,0,70,51
1657520188010,ECE 180,A00,083140,Abi Samra; Nicholas Camill,1,0,30,29
1657520188010,ECE 180,B00,083141,Abi Samra; Nicholas Camill,0,0,30,30
1657520194034,MATH 10A,A01,083735,Patchell; Gregory David,2,0,30,28
1657520194034,MATH 10A,A02,083736,Patchell; Gregory David,20,0,30,10
1657520194034,MATH 10A,A03,083737,Patchell; Gregory David,16,0,30,14
1657520200061,MATH 10B,A01,083207,Lim; Seonhee,8,0,34,26
1657520200061,MATH 10B,A02,083208,Lim; Seonhee,9,0,35,26
1657520200061,MATH 10B,A03,093472,Lim; Seonhee,7,0,34,27
1657520200061,MATH 10B,B01,083739,Sinha; Shubham,12,0,30,18
1657520206083,MATH 18,A01,083743,Cinel; Cameron Alexander,7,0,30,23
1657520206083,MATH 18,A02,083744,Cinel; Cameron Alexander,17,0,30,13
1657520206083,MATH 18,A03,083745,Cinel; Cameron Alexander,9,0,30,21
1657520206083,MATH 18,B01,083748,Rideout; David Porter,5,0,37,32
1657520206083,MATH 18,B02,083749,Rideout; David Porter,5,0,36,31
1657520206083,MATH 18,B03,083750,Rideout; David Porter,3,0,37,34
1657520206083,MATH 18,B04,083751,Rideout; David Porter,6,0,36,30
1657520206083,MATH 18,B05,093473,Rideout; David Porter,6,0,36,30
1657520206083,MATH 18,B06,093474,Rideout; David Porter,6,0,36,30
1657520212111,MATH 20A,A01,083754,Zheng; Zequn,14,0,40,26
1657520218135,MATH 20B,A01,083756,Briones; Jor-el Thomas Caparas,4,0,36,32
1657520218135,MATH 20B,A02,083757,Briones; Jor-el Thomas Caparas,1,0,36,35
1657520218135,MATH 20B,A03,093475,Briones; Jor-el Thomas Caparas,2,0,36,34
1657520224164,MATH 20C,A01,083760,Briones; Jor-el Thomas Caparas,1,0,35,34
1657520224164,MATH 20C,A02,083761,Briones; Jor-el Thomas Caparas,8,0,35,27
1657520224164,MATH 20C,A03,093476,Briones; Jor-el Thomas Caparas,0,1,36,36
1657520224164,MATH 20C,B01,083762,Bach; Quang Tran,1,0,30,29
1657520230193,MATH 20D,A01,083765,Tran; Brian Kha,5,0,30,25
1657520230193,MATH 20D,A02,083766,Tran; Brian Kha,5,0,30,25
1657520230193,MATH 20D,A03,083767,Tran; Brian Kha,5,0,30,25
1657520236224,MATH 20E,A01,083771,Ganguly; Soumya,9,0,32,23
1657520236224,MATH 20E,A02,083772,Ganguly; Soumya,6,0,32,26
1657520236224,MATH 20E,B01,083773,Ciotti; Benjamin,20,0,35,15
1657520236224,MATH 20E,B02,083774,Ciotti; Benjamin,17,0,35,18
1657520242248,MATH 103A,A01,083777,Greenfeld; Be'Eri,3,0,36,33
1657520242248,MATH 103A,A02,083778,Greenfeld; Be'Eri,5,0,36,31
1657520242248,MATH 103A,A03,093561,Greenfeld; Be'Eri,5,0,36,31
1657520242248,MATH 103A,B01,083779,Greenfeld; Be'Eri,7,0,36,29
1657520242248,MATH 103A,B02,083780,Greenfeld; Be'Eri,4,0,36,32
1657520242248,MATH 103A,B03,093562,Greenfeld; Be'Eri,3,0,36,33
1657520248272,MATH 105,A01,085443,Carter; Anne Toulson,15,0,35,20
1657520248272,MATH 105,A02,093477,Carter; Anne Toulson,20,0,35,15
1657520254296,MATH 109,A01,083213,Ganzberger; Geoffrey Michael,2,0,34,32
1657520254296,MATH 109,A02,083214,Ganzberger; Geoffrey Michael,4,0,34,30
1657520254296,MATH 109,A03,093478,Ganzberger; Geoffrey Michael,2,0,34,32
1657520254296,MATH 109,B01,083215,Ganzberger; Geoffrey Michael,1,0,32,31
1657520254296,MATH 109,B02,083216,Ganzberger; Geoffrey Michael,2,0,32,30
1657520254296,MATH 109,B03,093479,Ganzberger; Geoffrey Michael,8,0,32,24
1657520260326,MATH 142A,A01,083219,Chow; Bennett,7,0,32,25
1657520260326,MATH 142A,A02,083220,Chow; Bennett,10,0,32,22
1657520260326,MATH 142A,A03,093480,Chow; Bennett,8,0,32,24
1657520260326,MATH 142A,B03,093481,Chow; Bennett,8,0,32,24
1657520260326,MATH 142A,B04,093558,Chow; Bennett,13,0,32,19
1657520260326,MATH 142A,B05,093559,Chow; Bennett,6,0,32,26
1657520266354,MATH 193A,A01,083224,Rotar; Vladimir,8,0,34,26
1657520266354,MATH 193A,A02,083225,Rotar; Vladimir,9,0,34,25
1657520266354,MATH 193A,A03,083781,Rotar; Vladimir,5,0,34,29
1657520266354,MATH 193A,A04,083782,Rotar; Vladimir,10,0,34,24
1657520266354,MATH 193A,A05,093482,Rotar; Vladimir,10,0,34,24
1657520272378,MATH 197,001,091859,McAuley; Julian John,9999,0,9999,0
1657520272378,MATH 197,002,095566,Kedlaya; Kiran S.,9997,0,9999,2
1657520272378,MATH 197,003,095567,Xiao; Ming,9999,0,9999,0
1657520272378,MATH 197,004,095571,Perols; Johan Lars,9998,0,9999,1
1657520279428,COGS 9,A01,083615,Shannon; Kyle Michael,9,0,75,66
1657520285458,COGS 11,A01,083617,Boyle; Mary E. T.,22,0,48,26
1657520291483,COGS 13,A01,083071,Bastos; Amalia Pinkusfeld,11,0,71,60
1657520297509,COGS 14A,A01,092681,Semenuks; Arturs,5,1,100,95
1657520303537,COGS 14B,A01,083073,Cheng; Tzu-Han,6,0,63,57
1657520309577,COGS 17,A01,092677,Semenuks; Arturs,6,0,81,75
1657520315601,COGS 100,A01,083619,Allen; Michael Gordon,17,0,70,53
1657520321625,COGS 101A,A01,083621,Davis; Joshua Daniel,9,0,68,59
1657520327648,COGS 101B,A01,091572,Allen; Michael Gordon,12,0,65,53
1657520333674,COGS 101C,A01,083625,Delgado; Tania,17,0,35,18
1657520339697,COGS 107A,A01,083627,Boyle; Mary E. T.,13,0,60,47
1657520345723,COGS 118A,A01,083075,Gupta; Anjum,21,0,76,55
1657520351754,CSE 3,A50,083646,Miranda; Gregory Joseph,24,0,50,26
1657520357778,CSE 8A,A50,083650,Miranda; Gregory Joseph,17,1,56,39
1657520363805,CSE 11,A01,083080,Cao; Yingjun,6,15,40,34
1657520369830,CSE 12,A01,083652,Krause-Levy; Sophia Louisa,28,1,120,92
1657520375855,CSE 15L,A01,083654,Morris; Justin Loren,9,0,50,41
1657520375855,CSE 15L,A02,083655,Morris; Justin Loren,9,0,50,41
1657520381882,CSE 20,A01,083657,Tran; Khoa Dang,39,0,80,41
1657520387905,CSE 21,A01,095574,Bach; Quang Tran,22,0,48,26
1657520393937,CSE 30,A01,083084,Eldon; John,5,0,80,75
1657520393937,CSE 30,B01,095061,Bhaskar; Nishant,9,0,50,41
1657520399961,CSE 100,A01,083659,Cao; Yingjun,5,4,70,65
1657520405988,CSE 134B,A01,083661,Powell; Thomas Allan,22,0,100,78
1657520412024,CSE 140,A01,083663,Gungor; Onat,15,0,85,70
1657520418047,CSE 140L,A01,083088,Eldon; John,21,0,100,79
1657520424069,CSE 175,A01,083665,Kumar; Rakesh,3,0,25,22
1657520430093,CSE 190,A00,092507,Dubnov; Shlomo,8,0,20,12
1657520436116,ECE 45,A01,083139,Congero; Spencer William,6,0,75,69
1657520442138,ECE 65,A50,083695,Saad; Andrew S,12,0,30,18
1657520442138,ECE 65,A51,095125,Saad; Andrew S,24,0,26,2
1657520448164,ECE 109,A01,091882,Touri; Behrouz,19,0,70,51
1657520454205,ECE 180,A00,083140,Abi Samra; Nicholas Camill,1,0,30,29
1657520454205,ECE 180,B00,083141,Abi Samra; Nicholas Camill,0,0,30,30
1657520460254,MATH 10A,A01,083735,Patchell; Gregory David,2,0,30,28
1657520460254,MATH 10A,A02,083736,Patchell; Gregory David,20,0,30,10
1657520460254,MATH 10A,A03,083737,Patchell; Gregory David,16,0,30,14
1657520466282,MATH 10B,A01,083207,Lim; Seonhee,8,0,34,26
1657520466282,MATH 10B,A02,083208,Lim; Seonhee,9,0,35,26
1657520466282,MATH 10B,A03,093472,Lim; Seonhee,7,0,34,27
1657520466282,MATH 10B,B01,083739,Sinha; Shubham,12,0,30,18
1657520472307,MATH 18,A01,083743,Cinel; Cameron Alexander,7,0,30,23
1657520472307,MATH 18,A02,083744,Cinel; Cameron Alexander,17,0,30,13
1657520472307,MATH 18,A03,083745,Cinel; Cameron Alexander,9,0,30,21
1657520472307,MATH 18,B01,083748,Rideout; David Porter,5,0,37,32
1657520472307,MATH 18,B02,083749,Rideout; David Porter,5,0,36,31
1657520472307,MATH 18,B03,083750,Rideout; David Porter,3,0,37,34
1657520472307,MATH 18,B04,083751,Rideout; David Porter,6,0,36,30
1657520472307,MATH 18,B05,093473,Rideout; David Porter,6,0,36,30
1657520472307,MATH 18,B06,093474,Rideout; David Porter,6,0,36,30
1657520478331,MATH 20A,A01,083754,Zheng; Zequn,14,0,40,26
1657520484358,MATH 20B,A01,083756,Briones; Jor-el Thomas Caparas,4,0,36,32
1657520484358,MATH 20B,A02,083757,Briones; Jor-el Thomas Caparas,1,0,36,35
1657520484358,MATH 20B,A03,093475,Briones; Jor-el Thomas Caparas,2,0,36,34
1657520490459,MATH 20C,A01,083760,Briones; Jor-el Thomas Caparas,1,0,35,34
1657520490459,MATH 20C,A02,083761,Briones; Jor-el Thomas Caparas,8,0,35,27
1657520490459,MATH 20C,A03,093476,Briones; Jor-el Thomas Caparas,0,1,36,36
1657520490459,MATH 20C,B01,083762,Bach; Quang Tran,1,0,30,29
1657520496487,MATH 20D,A01,083765,Tran; Brian Kha,5,0,30,25
1657520496487,MATH 20D,A02,083766,Tran; Brian Kha,5,0,30,25
1657520496487,MATH 20D,A03,083767,Tran; Brian Kha,5,0,30,25
1657520502511,MATH 20E,A01,083771,Ganguly; Soumya,9,0,32,23
1657520502511,MATH 20E,A02,083772,Ganguly; Soumya,6,0,32,26
1657520502511,MATH 20E,B01,083773,Ciotti; Benjamin,20,0,35,15
1657520502511,MATH 20E,B02,083774,Ciotti; Benjamin,17,0,35,18
1657520508534,MATH 103A,A01,083777,Greenfeld; Be'Eri,3,0,36,33
1657520508534,MATH 103A,A02,083778,Greenfeld; Be'Eri,5,0,36,31
1657520508534,MATH 103A,A03,093561,Greenfeld; Be'Eri,5,0,36,31
1657520508534,MATH 103A,B01,083779,Greenfeld; Be'Eri,7,0,36,29
1657520508534,MATH 103A,B02,083780,Greenfeld; Be'Eri,4,0,36,32
1657520508534,MATH 103A,B03,093562,Greenfeld; Be'Eri,3,0,36,33
1657520514558,MATH 105,A01,085443,Carter; Anne Toulson,15,0,35,20
1657520514558,MATH 105,A02,093477,Carter; Anne Toulson,20,0,35,15
1657520520588,MATH 109,A01,083213,Ganzberger; Geoffrey Michael,2,0,34,32
1657520520588,MATH 109,A02,083214,Ganzberger; Geoffrey Michael,4,0,34,30
1657520520588,MATH 109,A03,093478,Ganzberger; Geoffrey Michael,2,0,34,32
1657520520588,MATH 109,B01,083215,Ganzberger; Geoffrey Michael,1,0,32,31
1657520520588,MATH 109,B02,083216,Ganzberger; Geoffrey Michael,2,0,32,30
1657520520588,MATH 109,B03,093479,Ganzberger; Geoffrey Michael,8,0,32,24
1657520526618,MATH 142A,A01,083219,Chow; Bennett,7,0,32,25
1657520526618,MATH 142A,A02,083220,Chow; Bennett,10,0,32,22
1657520526618,MATH 142A,A03,093480,Chow; Bennett,8,0,32,24
1657520526618,MATH 142A,B03,093481,Chow; Bennett,8,0,32,24
1657520526618,MATH 142A,B04,093558,Chow; Bennett,13,0,32,19
1657520526618,MATH 142A,B05,093559,Chow; Bennett,6,0,32,26
1657520532641,MATH 193A,A01,083224,Rotar; Vladimir,8,0,34,26
1657520532641,MATH 193A,A02,083225,Rotar; Vladimir,9,0,34,25
1657520532641,MATH 193A,A03,083781,Rotar; Vladimir,5,0,34,29
1657520532641,MATH 193A,A04,083782,Rotar; Vladimir,10,0,34,24
1657520532641,MATH 193A,A05,093482,Rotar; Vladimir,10,0,34,24
1657520538675,MATH 197,001,091859,McAuley; Julian John,9999,0,9999,0
1657520538675,MATH 197,002,095566,Kedlaya; Kiran S.,9997,0,9999,2
1657520538675,MATH 197,003,095567,Xiao; Ming,9999,0,9999,0
1657520538675,MATH 197,004,095571,Perols; Johan Lars,9998,0,9999,1
1657520545737,COGS 9,A01,083615,Shannon; Kyle Michael,9,0,75,66
1657520551760,COGS 11,A01,083617,Boyle; Mary E. T.,22,0,48,26
1657520557781,COGS 13,A01,083071,Bastos; Amalia Pinkusfeld,11,0,71,60
1657520563816,COGS 14A,A01,092681,Semenuks; Arturs,5,1,100,95
1657520569838,COGS 14B,A01,083073,Cheng; Tzu-Han,6,0,63,57
1657520575861,COGS 17,A01,092677,Semenuks; Arturs,6,0,81,75
1657520581885,COGS 100,A01,083619,Allen; Michael Gordon,17,0,70,53
1657520587909,COGS 101A,A01,083621,Davis; Joshua Daniel,9,0,68,59
1657520593934,COGS 101B,A01,091572,Allen; Michael Gordon,12,0,65,53
1657520599957,COGS 101C,A01,083625,Delgado; Tania,17,0,35,18
1657520605984,COGS 107A,A01,083627,Boyle; Mary E. T.,13,0,60,47
1657520612007,COGS 118A,A01,083075,Gupta; Anjum,21,0,76,55
1657520618033,CSE 3,A50,083646,Miranda; Gregory Joseph,24,0,50,26
1657520624058,CSE 8A,A50,083650,Miranda; Gregory Joseph,17,1,56,39
1657520630085,CSE 11,A01,083080,Cao; Yingjun,6,15,40,34
1657520636109,CSE 12,A01,083652,Krause-Levy; Sophia Louisa,28,1,120,92
1657520642140,CSE 15L,A01,083654,Morris; Justin Loren,9,0,50,41
1657520642140,CSE 15L,A02,083655,Morris; Justin Loren,9,0,50,41
1657520648178,CSE 20,A01,083657,Tran; Khoa Dang,39,0,80,41
1657520654211,CSE 21,A01,095574,Bach; Quang Tran,22,0,48,26
1657520660241,CSE 30,A01,083084,Eldon; John,5,0,80,75
1657520660241,CSE 30,B01,095061,Bhaskar; Nishant,9,0,50,41
1657520666267,CSE 100,A01,083659,Cao; Yingjun,5,4,70,65
1657520672290,CSE 134B,A01,083661,Powell; Thomas Allan,22,0,100,78
1657520678313,CSE 140,A01,083663,Gungor; Onat,15,0,85,70
1657520684342,CSE 140L,A01,083088,Eldon; John,21,0,100,79
1657520690371,CSE 175,A01,083665,Kumar; Rakesh,3,0,25,22
1657520696395,CSE 190,A00,092507,Dubnov; Shlomo,8,0,20,12
1657520702419,ECE 45,A01,083139,Congero; Spencer William,6,0,75,69
1657520708442,ECE 65,A50,083695,Saad; Andrew S,12,0,30,18
1657520708442,ECE 65,A51,095125,Saad; Andrew S,24,0,26,2
1657520714470,ECE 109,A01,091882,Touri; Behrouz,19,0,70,51
1657520720498,ECE 180,A00,083140,Abi Samra; Nicholas Camill,1,0,30,29
1657520720498,ECE 180,B00,083141,Abi Samra; Nicholas Camill,0,0,30,30
1657520726523,MATH 10A,A01,083735,Patchell; Gregory David,2,0,30,28
1657520726523,MATH 10A,A02,083736,Patchell; Gregory David,20,0,30,10
1657520726523,MATH 10A,A03,083737,Patchell; Gregory David,16,0,30,14
1657520732551,MATH 10B,A01,083207,Lim; Seonhee,8,0,34,26
1657520732551,MATH 10B,A02,083208,Lim; Seonhee,9,0,35,26
1657520732551,MATH 10B,A03,093472,Lim; Seonhee,7,0,34,27
1657520732551,MATH 10B,B01,083739,Sinha; Shubham,12,0,30,18
1657520738577,MATH 18,A01,083743,Cinel; Cameron Alexander,7,0,30,23
1657520738577,MATH 18,A02,083744,Cinel; Cameron Alexander,17,0,30,13
1657520738577,MATH 18,A03,083745,Cinel; Cameron Alexander,9,0,30,21
1657520738577,MATH 18,B01,083748,Rideout; David Porter,5,0,37,32
1657520738577,MATH 18,B02,083749,Rideout; David Porter,5,0,36,31
1657520738577,MATH 18,B03,083750,Rideout; David Porter,3,0,37,34
1657520738577,MATH 18,B04,083751,Rideout; David Porter,6,0,36,30
1657520738577,MATH 18,B05,093473,Rideout; David Porter,6,0,36,30
1657520738577,MATH 18,B06,093474,Rideout; David Porter,6,0,36,30
1657520744605,MATH 20A,A01,083754,Zheng; Zequn,14,0,40,26
1657520750631,MATH 20B,A01,083756,Briones; Jor-el Thomas Caparas,4,0,36,32
1657520750631,MATH 20B,A02,083757,Briones; Jor-el Thomas Caparas,1,0,36,35
1657520750631,MATH 20B,A03,093475,Briones; Jor-el Thomas Caparas,2,0,36,34
1657520756656,MATH 20C,A01,083760,Briones; Jor-el Thomas Caparas,1,0,35,34
1657520756656,MATH 20C,A02,083761,Briones; Jor-el Thomas Caparas,8,0,35,27
1657520756656,MATH 20C,A03,093476,Briones; Jor-el Thomas Caparas,0,1,36,36
1657520756656,MATH 20C,B01,083762,Bach; Quang Tran,1,0,30,29
1657520762685,MATH 20D,A01,083765,Tran; Brian Kha,5,0,30,25
1657520762685,MATH 20D,A02,083766,Tran; Brian Kha,5,0,30,25
1657520762685,MATH 20D,A03,083767,Tran; Brian Kha,5,0,30,25
1657520768710,MATH 20E,A01,083771,Ganguly; Soumya,9,0,32,23
1657520768710,MATH 20E,A02,083772,Ganguly; Soumya,6,0,32,26
1657520768710,MATH 20E,B01,083773,Ciotti; Benjamin,20,0,35,15
1657520768710,MATH 20E,B02,083774,Ciotti; Benjamin,17,0,35,18
1657520774746,MATH 103A,A01,083777,Greenfeld; Be'Eri,3,0,36,33
1657520774746,MATH 103A,A02,083778,Greenfeld; Be'Eri,5,0,36,31
1657520774746,MATH 103A,A03,093561,Greenfeld; Be'Eri,5,0,36,31
1657520774746,MATH 103A,B01,083779,Greenfeld; Be'Eri,7,0,36,29
1657520774746,MATH 103A,B02,083780,Greenfeld; Be'Eri,4,0,36,32
1657520774746,MATH 103A,B03,093562,Greenfeld; Be'Eri,3,0,36,33
1657520780776,MATH 105,A01,085443,Carter; Anne Toulson,15,0,35,20
1657520780776,MATH 105,A02,093477,Carter; Anne Toulson,20,0,35,15
1657520786807,MATH 109,A01,083213,Ganzberger; Geoffrey Michael,2,0,34,32
1657520786807,MATH 109,A02,083214,Ganzberger; Geoffrey Michael,4,0,34,30
1657520786807,MATH 109,A03,093478,Ganzberger; Geoffrey Michael,2,0,34,32
1657520786807,MATH 109,B01,083215,Ganzberger; Geoffrey Michael,1,0,32,31
1657520786807,MATH 109,B02,083216,Ganzberger; Geoffrey Michael,2,0,32,30
1657520786807,MATH 109,B03,093479,Ganzberger; Geoffrey Michael,8,0,32,24
1657520792847,MATH 142A,A01,083219,Chow; Bennett,7,0,32,25
1657520792847,MATH 142A,A02,083220,Chow; Bennett,10,0,32,22
1657520792847,MATH 142A,A03,093480,Chow; Bennett,8,0,32,24
1657520792847,MATH 142A,B03,093481,Chow; Bennett,8,0,32,24
1657520792847,MATH 142A,B04,093558,Chow; Bennett,13,0,32,19
1657520792847,MATH 142A,B05,093559,Chow; Bennett,6,0,32,26
1657520798870,MATH 193A,A01,083224,Rotar; Vladimir,8,0,34,26
1657520798870,MATH 193A,A02,083225,Rotar; Vladimir,9,0,34,25
1657520798870,MATH 193A,A03,083781,Rotar; Vladimir,5,0,34,29
1657520798870,MATH 193A,A04,083782,Rotar; Vladimir,10,0,34,24
1657520798870,MATH 193A,A05,093482,Rotar; Vladimir,10,0,34,24
1657520804898,MATH 197,001,091859,McAuley; Julian John,9999,0,9999,0
1657520804898,MATH 197,002,095566,Kedlaya; Kiran S.,9997,0,9999,2
1657520804898,MATH 197,003,095567,Xiao; Ming,9999,0,9999,0
1657520804898,MATH 197,004,095571,Perols; Johan Lars,9998,0,9999,1
1657520811970,COGS 9,A01,083615,Shannon; Kyle Michael,9,0,75,66
1657520817992,COGS 11,A01,083617,Boyle; Mary E. T.,22,0,48,26
1657520824015,COGS 13,A01,083071,Bastos; Amalia Pinkusfeld,11,0,71,60
1657520830038,COGS 14A,A01,092681,Semenuks; Arturs,5,1,100,95
1657520836061,COGS 14B,A01,083073,Cheng; Tzu-Han,6,0,63,57
1657520842084,COGS 17,A01,092677,Semenuks; Arturs,6,0,81,75
1657520848107,COGS 100,A01,083619,Allen; Michael Gordon,17,0,70,53
1657520854135,COGS 101A,A01,083621,Davis; Joshua Daniel,9,0,68,59
1657520860160,COGS 101B,A01,091572,Allen; Michael Gordon,12,0,65,53
1657520866184,COGS 101C,A01,083625,Delgado; Tania,17,0,35,18
1657520872217,COGS 107A,A01,083627,Boyle; Mary E. T.,13,0,60,47
1657520878246,COGS 118A,A01,083075,Gupta; Anjum,21,0,76,55
1657520884270,CSE 3,A50,083646,Miranda; Gregory Joseph,24,0,50,26
1657520890299,CSE 8A,A50,083650,Miranda; Gregory Joseph,17,1,56,39
1657520896324,CSE 11,A01,083080,Cao; Yingjun,6,15,40,34
1657520902352,CSE 12,A01,083652,Krause-Levy; Sophia Louisa,28,1,120,92
1657520908375,CSE 15L,A01,083654,Morris; Justin Loren,9,0,50,41
1657520908375,CSE 15L,A02,083655,Morris; Justin Loren,9,0,50,41
1657520914402,CSE 20,A01,083657,Tran; Khoa Dang,39,0,80,41
1657520920430,CSE 21,A01,095574,Bach; Quang Tran,22,0,48,26
1657520926459,CSE 30,A01,083084,Eldon; John,5,0,80,75
1657520926459,CSE 30,B01,095061,Bhaskar; Nishant,9,0,50,41
1657520932482,CSE 100,A01,083659,Cao; Yingjun,5,4,70,65
1657520938506,CSE 134B,A01,083661,Powell; Thomas Allan,22,0,100,78
1657520944534,CSE 140,A01,083663,Gungor; Onat,15,0,85,70
1657520950561,CSE 140L,A01,083088,Eldon; John,21,0,100,79
1657520956583,CSE 175,A01,083665,Kumar; Rakesh,3,0,25,22
1657520962608,CSE 190,A00,092507,Dubnov; Shlomo,8,0,20,12
1657520968631,ECE 45,A01,083139,Congero; Spencer William,6,0,75,69
1657520974653,ECE 65,A50,083695,Saad; Andrew S,12,0,30,18
1657520974653,ECE 65,A51,095125,Saad; Andrew S,24,0,26,2
1657520980679,ECE 109,A01,091882,Touri; Behrouz,19,0,70,51
1657520986710,ECE 180,A00,083140,Abi Samra; Nicholas Camill,1,0,30,29
1657520986710,ECE 180,B00,083141,Abi Samra; Nicholas Camill,0,0,30,30
1657520992731,MATH 10A,A01,083735,Patchell; Gregory David,2,0,30,28
1657520992731,MATH 10A,A02,083736,Patchell; Gregory David,20,0,30,10
1657520992731,MATH 10A,A03,083737,Patchell; Gregory David,16,0,30,14
1657520998756,MATH 10B,A01,083207,Lim; Seonhee,8,0,34,26
1657520998756,MATH 10B,A02,083208,Lim; Seonhee,9,0,35,26
1657520998756,MATH 10B,A03,093472,Lim; Seonhee,7,0,34,27
1657520998756,MATH 10B,B01,083739,Sinha; Shubham,12,0,30,18
1657521004784,MATH 18,A01,083743,Cinel; Cameron Alexander,7,0,30,23
1657521004784,MATH 18,A02,083744,Cinel; Cameron Alexander,17,0,30,13
1657521004784,MATH 18,A03,083745,Cinel; Cameron Alexander,9,0,30,21
1657521004784,MATH 18,B01,083748,Rideout; David Porter,5,0,37,32
1657521004784,MATH 18,B02,083749,Rideout; David Porter,5,0,36,31
1657521004784,MATH 18,B03,083750,Rideout; David Porter,3,0,37,34
1657521004784,MATH 18,B04,083751,Rideout; David Porter,6,0,36,30
1657521004784,MATH 18,B05,093473,Rideout; David Porter,6,0,36,30
1657521004784,MATH 18,B06,093474,Rideout; David Porter,6,0,36,30
1657521010810,MATH 20A,A01,083754,Zheng; Zequn,14,0,40,26
1657521016832,MATH 20B,A01,083756,Briones; Jor-el Thomas Caparas,4,0,36,32
1657521016832,MATH 20B,A02,083757,Briones; Jor-el Thomas Caparas,1,0,36,35
1657521016832,MATH 20B,A03,093475,Briones; Jor-el Thomas Caparas,2,0,36,34
1657521022854,MATH 20C,A01,083760,Briones; Jor-el Thomas Caparas,1,0,35,34
1657521022854,MATH 20C,A02,083761,Briones; Jor-el Thomas Caparas,8,0,35,27
1657521022854,MATH 20C,A03,093476,Briones; Jor-el Thomas Caparas,0,1,36,36
1657521022854,MATH 20C,B01,083762,Bach; Quang Tran,1,0,30,29
1657521028878,MATH 20D,A01,083765,Tran; Brian Kha,5,0,30,25
1657521028878,MATH 20D,A02,083766,Tran; Brian Kha,5,0,30,25
1657521028878,MATH 20D,A03,083767,Tran; Brian Kha,5,0,30,25
1657521034900,MATH 20E,A01,083771,Ganguly; Soumya,9,0,32,23
1657521034900,MATH 20E,A02,083772,Ganguly; Soumya,6,0,32,26
1657521034900,MATH 20E,B01,083773,Ciotti; Benjamin,20,0,35,15
1657521034900,MATH 20E,B02,083774,Ciotti; Benjamin,17,0,35,18
1657521040924,MATH 103A,A01,083777,Greenfeld; Be'Eri,3,0,36,33
1657521040924,MATH 103A,A02,083778,Greenfeld; Be'Eri,5,0,36,31
1657521040924,MATH 103A,A03,093561,Greenfeld; Be'Eri,5,0,36,31
1657521040924,MATH 103A,B01,083779,Greenfeld; Be'Eri,7,0,36,29
1657521040924,MATH 103A,B02,083780,Greenfeld; Be'Eri,4,0,36,32
1657521040924,MATH 103A,B03,093562,Greenfeld; Be'Eri,3,0,36,33
1657521046948,MATH 105,A01,085443,Carter; Anne Toulson,15,0,35,20
1657521046948,MATH 105,A02,093477,Carter; Anne Toulson,20,0,35,15
1657521052979,MATH 109,A01,083213,Ganzberger; Geoffrey Michael,2,0,34,32
1657521052979,MATH 109,A02,083214,Ganzberger; Geoffrey Michael,4,0,34,30
1657521052979,MATH 109,A03,093478,Ganzberger; Geoffrey Michael,2,0,34,32
1657521052979,MATH 109,B01,083215,Ganzberger; Geoffrey Michael,1,0,32,31
1657521052979,MATH 109,B02,083216,Ganzberger; Geoffrey Michael,2,0,32,30
1657521052979,MATH 109,B03,093479,Ganzberger; Geoffrey Michael,8,0,32,24
1657521059004,MATH 142A,A01,083219,Chow; Bennett,7,0,32,25
1657521059004,MATH 142A,A02,083220,Chow; Bennett,10,0,32,22
1657521059004,MATH 142A,A03,093480,Chow; Bennett,8,0,32,24
1657521059004,MATH 142A,B03,093481,Chow; Bennett,8,0,32,24
1657521059004,MATH 142A,B04,093558,Chow; Bennett,13,0,32,19
1657521059004,MATH 142A,B05,093559,Chow; Bennett,6,0,32,26
1657521065089,MATH 193A,A01,083224,Rotar; Vladimir,8,0,34,26
1657521065089,MATH 193A,A02,083225,Rotar; Vladimir,9,0,34,25
1657521065089,MATH 193A,A03,083781,Rotar; Vladimir,5,0,34,29
1657521065089,MATH 193A,A04,083782,Rotar; Vladimir,10,0,34,24
1657521065089,MATH 193A,A05,093482,Rotar; Vladimir,10,0,34,24
1657521071112,MATH 197,001,091859,McAuley; Julian John,9999,0,9999,0
1657521071112,MATH 197,002,095566,Kedlaya; Kiran S.,9997,0,9999,2
1657521071112,MATH 197,003,095567,Xiao; Ming,9999,0,9999,0
1657521071112,MATH 197,004,095571,Perols; Johan Lars,9998,0,9999,1
1657521078179,COGS 9,A01,083615,Shannon; Kyle Michael,9,0,75,66
1657521084275,COGS 11,A01,083617,Boyle; Mary E. T.,22,0,48,26
1657521090300,COGS 13,A01,083071,Bastos; Amalia Pinkusfeld,11,0,71,60
1657521096328,COGS 14A,A01,092681,Semenuks; Arturs,5,1,100,95
1657521102352,COGS 14B,A01,083073,Cheng; Tzu-Han,6,0,63,57
1657521108378,COGS 17,A01,092677,Semenuks; Arturs,6,0,81,75
1657521114403,COGS 100,A01,083619,Allen; Michael Gordon,17,0,70,53
1657521120429,COGS 101A,A01,083621,Davis; Joshua Daniel,9,0,68,59
1657521126451,COGS 101B,A01,091572,Allen; Michael Gordon,12,0,65,53
1657521132474,COGS 101C,A01,083625,Delgado; Tania,17,0,35,18
1657521138498,COGS 107A,A01,083627,Boyle; Mary E. T.,13,0,60,47
1657521144526,COGS 118A,A01,083075,Gupta; Anjum,21,0,76,55
1657521150555,CSE 3,A50,083646,Miranda; Gregory Joseph,24,0,50,26
1657521156582,CSE 8A,A50,083650,Miranda; Gregory Joseph,17,1,56,39
1657521162605,CSE 11,A01,083080,Cao; Yingjun,6,15,40,34
1657521168628,CSE 12,A01,083652,Krause-Levy; Sophia Louisa,28,1,120,92
1657521174651,CSE 15L,A01,083654,Morris; Justin Loren,9,0,50,41
1657521174651,CSE 15L,A02,083655,Morris; Justin Loren,9,0,50,41
1657521180674,CSE 20,A01,083657,Tran; Khoa Dang,39,0,80,41
1657521186700,CSE 21,A01,095574,Bach; Quang Tran,22,0,48,26
1657521192727,CSE 30,A01,083084,Eldon; John,5,0,80,75
1657521192727,CSE 30,B01,095061,Bhaskar; Nishant,9,0,50,41
1657521198752,CSE 100,A01,083659,Cao; Yingjun,5,4,70,65
1657521204781,CSE 134B,A01,083661,Powell; Thomas Allan,22,0,100,78
1657521210808,CSE 140,A01,083663,Gungor; Onat,15,0,85,70
1657521216832,CSE 140L,A01,083088,Eldon; John,21,0,100,79
1657521222857,CSE 175,A01,083665,Kumar; Rakesh,3,0,25,22
1657521228879,CSE 190,A00,092507,Dubnov; Shlomo,8,0,20,12
1657521234907,ECE 45,A01,083139,Congero; Spencer William,6,0,75,69
1657521240931,ECE 65,A50,083695,Saad; Andrew S,12,0,30,18
1657521240931,ECE 65,A51,095125,Saad; Andrew S,24,0,26,2
1657521246958,ECE 109,A01,091882,Touri; Behrouz,19,0,70,51
1657521252985,ECE 180,A00,083140,Abi Samra; Nicholas Camill,1,0,30,29
1657521252985,ECE 180,B00,083141,Abi Samra; Nicholas Camill,0,0,30,30
1657521259008,MATH 10A,A01,083735,Patchell; Gregory David,2,0,30,28
1657521259008,MATH 10A,A02,083736,Patchell; Gregory David,20,0,30,10
1657521259008,MATH 10A,A03,083737,Patchell; Gregory David,16,0,30,14
1657521265033,MATH 10B,A01,083207,Lim; Seonhee,8,0,34,26
1657521265033,MATH 10B,A02,083208,Lim; Seonhee,9,0,35,26
1657521265033,MATH 10B,A03,093472,Lim; Seonhee,7,0,34,27
1657521265033,MATH 10B,B01,083739,Sinha; Shubham,12,0,30,18
1657521271064,MATH 18,A01,083743,Cinel; Cameron Alexander,7,0,30,23
1657521271064,MATH 18,A02,083744,Cinel; Cameron Alexander,17,0,30,13
1657521271064,MATH 18,A03,083745,Cinel; Cameron Alexander,9,0,30,21
1657521271064,MATH 18,B01,083748,Rideout; David Porter,5,0,37,32
1657521271064,MATH 18,B02,083749,Rideout; David Porter,5,0,36,31
1657521271064,MATH 18,B03,083750,Rideout; David Porter,3,0,37,34
1657521271064,MATH 18,B04,083751,Rideout; David Porter,6,0,36,30
1657521271064,MATH 18,B05,093473,Rideout; David Porter,6,0,36,30
1657521271064,MATH 18,B06,093474,Rideout; David Porter,6,0,36,30
1657521277087,MATH 20A,A01,083754,Zheng; Zequn,14,0,40,26
1657521283112,MATH 20B,A01,083756,Briones; Jor-el Thomas Caparas,4,0,36,32
1657521283112,MATH 20B,A02,083757,Briones; Jor-el Thomas Caparas,1,0,36,35
1657521283112,MATH 20B,A03,093475,Briones; Jor-el Thomas Caparas,2,0,36,34
1657521289135,MATH 20C,A01,083760,Briones; Jor-el Thomas Caparas,1,0,35,34
1657521289135,MATH 20C,A02,083761,Briones; Jor-el Thomas Caparas,8,0,35,27
1657521289135,MATH 20C,A03,093476,Briones; Jor-el Thomas Caparas,0,1,36,36
1657521289135,MATH 20C,B01,083762,Bach; Quang Tran,1,0,30,29
1657521295161,MATH 20D,A01,083765,Tran; Brian Kha,5,0,30,25
1657521295161,MATH 20D,A02,083766,Tran; Brian Kha,5,0,30,25
1657521295161,MATH 20D,A03,083767,Tran; Brian Kha,5,0,30,25
1657521301185,MATH 20E,A01,083771,Ganguly; Soumya,9,0,32,23
1657521301185,MATH 20E,A02,083772,Ganguly; Soumya,6,0,32,26
1657521301185,MATH 20E,B01,083773,Ciotti; Benjamin,20,0,35,15
1657521301185,MATH 20E,B02,083774,Ciotti; Benjamin,17,0,35,18
1657521307208,MATH 103A,A01,083777,Greenfeld; Be'Eri,3,0,36,33
1657521307208,MATH 103A,A02,083778,Greenfeld; Be'Eri,5,0,36,31
1657521307208,MATH 103A,A03,093561,Greenfeld; Be'Eri,5,0,36,31
1657521307208,MATH 103A,B01,083779,Greenfeld; Be'Eri,7,0,36,29
1657521307208,MATH 103A,B02,083780,Greenfeld; Be'Eri,4,0,36,32
1657521307208,MATH 103A,B03,093562,Greenfeld; Be'Eri,3,0,36,33
1657521313235,MATH 105,A01,085443,Carter; Anne Toulson,15,0,35,20
1657521313235,MATH 105,A02,093477,Carter; Anne Toulson,20,0,35,15
1657521319259,MATH 109,A01,083213,Ganzberger; Geoffrey Michael,2,0,34,32
1657521319259,MATH 109,A02,083214,Ganzberger; Geoffrey Michael,4,0,34,30
1657521319259,MATH 109,A03,093478,Ganzberger; Geoffrey Michael,2,0,34,32
1657521319259,MATH 109,B01,083215,Ganzberger; Geoffrey Michael,1,0,32,31
1657521319259,MATH 109,B02,083216,Ganzberger; Geoffrey Michael,2,0,32,30
1657521319259,MATH 109,B03,093479,Ganzberger; Geoffrey Michael,8,0,32,24
1657521325287,MATH 142A,A01,083219,Chow; Bennett,7,0,32,25
1657521325287,MATH 142A,A02,083220,Chow; Bennett,10,0,32,22
1657521325287,MATH 142A,A03,093480,Chow; Bennett,8,0,32,24
1657521325287,MATH 142A,B03,093481,Chow; Bennett,8,0,32,24
1657521325287,MATH 142A,B04,093558,Chow; Bennett,13,0,32,19
1657521325287,MATH 142A,B05,093559,Chow; Bennett,6,0,32,26
1657521331310,MATH 193A,A01,083224,Rotar; Vladimir,8,0,34,26
1657521331310,MATH 193A,A02,083225,Rotar; Vladimir,9,0,34,25
1657521331310,MATH 193A,A03,083781,Rotar; Vladimir,5,0,34,29
1657521331310,MATH 193A,A04,083782,Rotar; Vladimir,10,0,34,24
1657521331310,MATH 193A,A05,093482,Rotar; Vladimir,10,0,34,24
1657521337332,MATH 197,001,091859,McAuley; Julian John,9999,0,9999,0
1657521337332,MATH 197,002,095566,Kedlaya; Kiran S.,9997,0,9999,2
1657521337332,MATH 197,003,095567,Xiao; Ming,9999,0,9999,0
1657521337332,MATH 197,004,095571,Perols; Johan Lars,9998,0,9999,1
1657521344386,COGS 9,A01,083615,Shannon; Kyle Michael,9,0,75,66
1657521350410,COGS 11,A01,083617,Boyle; Mary E. T.,22,0,48,26
1657521356433,COGS 13,A01,083071,Bastos; Amalia Pinkusfeld,11,0,71,60
1657521362455,COGS 14A,A01,092681,Semenuks; Arturs,5,1,100,95
1657521368489,COGS 14B,A01,083073,Cheng; Tzu-Han,6,0,63,57
1657521374512,COGS 17,A01,092677,Semenuks; Arturs,6,0,81,75
1657521380536,COGS 100,A01,083619,Allen; Michael Gordon,17,0,70,53
1657521386565,COGS 101A,A01,083621,Davis; Joshua Daniel,9,0,68,59
1657521392590,COGS 101B,A01,091572,Allen; Michael Gordon,12,0,65,53
1657521398613,COGS 101C,A01,083625,Delgado; Tania,17,0,35,18
1657521404640,COGS 107A,A01,083627,Boyle; Mary E. T.,13,0,60,47
1657521410668,COGS 118A,A01,083075,Gupta; Anjum,21,0,76,55
1657521416691,CSE 3,A50,083646,Miranda; Gregory Joseph,24,0,50,26
1657521422723,CSE 8A,A50,083650,Miranda; Gregory Joseph,17,1,56,39
1657521428747,CSE 11,A01,083080,Cao; Yingjun,6,15,40,34
1657521434769,CSE 12,A01,083652,Krause-Levy; Sophia Louisa,28,1,120,92
1657521440795,CSE 15L,A01,083654,Morris; Justin Loren,9,0,50,41
1657521440795,CSE 15L,A02,083655,Morris; Justin Loren,9,0,50,41
1657521446817,CSE 20,A01,083657,Tran; Khoa Dang,39,0,80,41
1657521452841,CSE 21,A01,095574,Bach; Quang Tran,22,0,48,26
1657521458870,CSE 30,A01,083084,Eldon; John,5,0,80,75
1657521458870,CSE 30,B01,095061,Bhaskar; Nishant,9,0,50,41
1657521464892,CSE 100,A01,083659,Cao; Yingjun,5,4,70,65
1657521470915,CSE 134B,A01,083661,Powell; Thomas Allan,22,0,100,78
1657521476941,CSE 140,A01,083663,Gungor; Onat,15,0,85,70
1657521482972,CSE 140L,A01,083088,Eldon; John,21,0,100,79
1657521488994,CSE 175,A01,083665,Kumar; Rakesh,3,0,25,22
1657521495023,CSE 190,A00,092507,Dubnov; Shlomo,8,0,20,12
1657521501045,ECE 45,A01,083139,Congero; Spencer William,6,0,75,69
1657521507069,ECE 65,A50,083695,Saad; Andrew S,12,0,30,18
1657521507069,ECE 65,A51,095125,Saad; Andrew S,24,0,26,2
1657521513094,ECE 109,A01,091882,Touri; Behrouz,19,0,70,51
1657521519118,ECE 180,A00,083140,Abi Samra; Nicholas Camill,1,0,30,29
1657521519118,ECE 180,B00,083141,Abi Samra; Nicholas Camill,0,0,30,30
1657521525142,MATH 10A,A01,083735,Patchell; Gregory David,2,0,30,28
1657521525142,MATH 10A,A02,083736,Patchell; Gregory David,20,0,30,10
1657521525142,MATH 10A,A03,083737,Patchell; Gregory David,16,0,30,14
1657521531171,MATH 10B,A01,083207,Lim; Seonhee,8,0,34,26
1657521531171,MATH 10B,A02,083208,Lim; Seonhee,9,0,35,26
1657521531171,MATH 10B,A03,093472,Lim; Seonhee,7,0,34,27
1657521531171,MATH 10B,B01,083739,Sinha; Shubham,12,0,30,18
1657521537200,MATH 18,A01,083743,Cinel; Cameron Alexander,7,0,30,23
1657521537200,MATH 18,A02,083744,Cinel; Cameron Alexander,17,0,30,13
1657521537200,MATH 18,A03,083745,Cinel; Cameron Alexander,9,0,30,21
1657521537200,MATH 18,B01,083748,Rideout; David Porter,5,0,37,32
1657521537200,MATH 18,B02,083749,Rideout; David Porter,5,0,36,31
1657521537200,MATH 18,B03,083750,Rideout; David Porter,3,0,37,34
1657521537200,MATH 18,B04,083751,Rideout; David Porter,6,0,36,30
1657521537200,MATH 18,B05,093473,Rideout; David Porter,6,0,36,30
1657521537200,MATH 18,B06,093474,Rideout; David Porter,6,0,36,30
1657521543223,MATH 20A,A01,083754,Zheng; Zequn,14,0,40,26
1657521549252,MATH 20B,A01,083756,Briones; Jor-el Thomas Caparas,4,0,36,32
1657521549252,MATH 20B,A02,083757,Briones; Jor-el Thomas Caparas,1,0,36,35
1657521549252,MATH 20B,A03,093475,Briones; Jor-el Thomas Caparas,2,0,36,34
1657521555284,MATH 20C,A01,083760,Briones; Jor-el Thomas Caparas,1,0,35,34
1657521555284,MATH 20C,A02,083761,Briones; Jor-el Thomas Caparas,8,0,35,27
1657521555284,MATH 20C,A03,093476,Briones; Jor-el Thomas Caparas,0,1,36,36
1657521555284,MATH 20C,B01,083762,Bach; Quang Tran,1,0,30,29
1657521561314,MATH 20D,A01,083765,Tran; Brian Kha,5,0,30,25
1657521561314,MATH 20D,A02,083766,Tran; Brian Kha,5,0,30,25
1657521561314,MATH 20D,A03,083767,Tran; Brian Kha,5,0,30,25
1657521567338,MATH 20E,A01,083771,Ganguly; Soumya,9,0,32,23
1657521567338,MATH 20E,A02,083772,Ganguly; Soumya,6,0,32,26
1657521567338,MATH 20E,B01,083773,Ciotti; Benjamin,20,0,35,15
1657521567338,MATH 20E,B02,083774,Ciotti; Benjamin,17,0,35,18
1657521573373,MATH 103A,A01,083777,Greenfeld; Be'Eri,3,0,36,33
1657521573373,MATH 103A,A02,083778,Greenfeld; Be'Eri,5,0,36,31
1657521573373,MATH 103A,A03,093561,Greenfeld; Be'Eri,5,0,36,31
1657521573373,MATH 103A,B01,083779,Greenfeld; Be'Eri,7,0,36,29
1657521573373,MATH 103A,B02,083780,Greenfeld; Be'Eri,4,0,36,32
1657521573373,MATH 103A,B03,093562,Greenfeld; Be'Eri,3,0,36,33
1657521579396,MATH 105,A01,085443,Carter; Anne Toulson,15,0,35,20
1657521579396,MATH 105,A02,093477,Carter; Anne Toulson,20,0,35,15
1657521585420,MATH 109,A01,083213,Ganzberger; Geoffrey Michael,2,0,34,32
1657521585420,MATH 109,A02,083214,Ganzberger; Geoffrey Michael,4,0,34,30
1657521585420,MATH 109,A03,093478,Ganzberger; Geoffrey Michael,2,0,34,32
1657521585420,MATH 109,B01,083215,Ganzberger; Geoffrey Michael,1,0,32,31
1657521585420,MATH 109,B02,083216,Ganzberger; Geoffrey Michael,2,0,32,30
1657521585420,MATH 109,B03,093479,Ganzberger; Geoffrey Michael,8,0,32,24
1657521591443,MATH 142A,A01,083219,Chow; Bennett,7,0,32,25
1657521591443,MATH 142A,A02,083220,Chow; Bennett,10,0,32,22
1657521591443,MATH 142A,A03,093480,Chow; Bennett,8,0,32,24
1657521591443,MATH 142A,B03,093481,Chow; Bennett,8,0,32,24
1657521591443,MATH 142A,B04,093558,Chow; Bennett,13,0,32,19
1657521591443,MATH 142A,B05,093559,Chow; Bennett,6,0,32,26
1657521597472,MATH 193A,A01,083224,Rotar; Vladimir,8,0,34,26
1657521597472,MATH 193A,A02,083225,Rotar; Vladimir,9,0,34,25
1657521597472,MATH 193A,A03,083781,Rotar; Vladimir,5,0,34,29
1657521597472,MATH 193A,A04,083782,Rotar; Vladimir,10,0,34,24
1657521597472,MATH 193A,A05,093482,Rotar; Vladimir,10,0,34,24
1657521603495,MATH 197,001,091859,McAuley; Julian John,9999,0,9999,0
1657521603495,MATH 197,002,095566,Kedlaya; Kiran S.,9997,0,9999,2
1657521603495,MATH 197,003,095567,Xiao; Ming,9999,0,9999,0
1657521603495,MATH 197,004,095571,Perols; Johan Lars,9998,0,9999,1
1657521610570,COGS 9,A01,083615,Shannon; Kyle Michael,9,0,75,66
1657521616596,COGS 11,A01,083617,Boyle; Mary E. T.,22,0,48,26
1657521622619,COGS 13,A01,083071,Bastos; Amalia Pinkusfeld,11,0,71,60
1657521628645,COGS 14A,A01,092681,Semenuks; Arturs,5,1,100,95
1657521634669,COGS 14B,A01,083073,Cheng; Tzu-Han,6,0,63,57
1657521640700,COGS 17,A01,092677,Semenuks; Arturs,6,0,81,75
1657521646734,COGS 100,A01,083619,Allen; Michael Gordon,17,0,70,53
1657521652757,COGS 101A,A01,083621,Davis; Joshua Daniel,9,0,68,59
1657521658779,COGS 101B,A01,091572,Allen; Michael Gordon,12,0,65,53
1657521664806,COGS 101C,A01,083625,Delgado; Tania,17,0,35,18
1657521670828,COGS 107A,A01,083627,Boyle; Mary E. T.,13,0,60,47
1657521676851,COGS 118A,A01,083075,Gupta; Anjum,21,0,76,55
1657521682959,CSE 3,A50,083646,Miranda; Gregory Joseph,24,0,50,26
1657521688986,CSE 8A,A50,083650,Miranda; Gregory Joseph,17,1,56,39
1657521695009,CSE 11,A01,083080,Cao; Yingjun,6,15,40,34
1657521701034,CSE 12,A01,083652,Krause-Levy; Sophia Louisa,28,1,120,92
1657521707056,CSE 15L,A01,083654,Morris; Justin Loren,9,0,50,41
1657521707056,CSE 15L,A02,083655,Morris; Justin Loren,9,0,50,41
1657521713079,CSE 20,A01,083657,Tran; Khoa Dang,39,0,80,41
1657521719101,CSE 21,A01,095574,Bach; Quang Tran,22,0,48,26
1657521725124,CSE 30,A01,083084,Eldon; John,5,0,80,75
1657521725124,CSE 30,B01,095061,Bhaskar; Nishant,9,0,50,41
1657521731146,CSE 100,A01,083659,Cao; Yingjun,5,4,70,65
1657521737173,CSE 134B,A01,083661,Powell; Thomas Allan,22,0,100,78
1657521743194,CSE 140,A01,083663,Gungor; Onat,15,0,85,70
1657521749217,CSE 140L,A01,083088,Eldon; John,21,0,100,79
1657521755241,CSE 175,A01,083665,Kumar; Rakesh,3,0,25,22
1657521761273,CSE 190,A00,092507,Dubnov; Shlomo,8,0,20,12
1657521767308,ECE 45,A01,083139,Congero; Spencer William,6,0,75,69
1657521773331,ECE 65,A50,083695,Saad; Andrew S,12,0,30,18
1657521773331,ECE 65,A51,095125,Saad; Andrew S,24,0,26,2
1657521779355,ECE 109,A01,091882,Touri; Behrouz,19,0,70,51
1657521785382,ECE 180,A00,083140,Abi Samra; Nicholas Camill,1,0,30,29
1657521785382,ECE 180,B00,083141,Abi Samra; Nicholas Camill,0,0,30,30
1657521791407,MATH 10A,A01,083735,Patchell; Gregory David,2,0,30,28
1657521791407,MATH 10A,A02,083736,Patchell; Gregory David,20,0,30,10
1657521791407,MATH 10A,A03,083737,Patchell; Gregory David,16,0,30,14
1657521797439,MATH 10B,A01,083207,Lim; Seonhee,8,0,34,26
1657521797439,MATH 10B,A02,083208,Lim; Seonhee,9,0,35,26
1657521797439,MATH 10B,A03,093472,Lim; Seonhee,7,0,34,27
1657521797439,MATH 10B,B01,083739,Sinha; Shubham,12,0,30,18
1657521803480,MATH 18,A01,083743,Cinel; Cameron Alexander,7,0,30,23
1657521803480,MATH 18,A02,083744,Cinel; Cameron Alexander,17,0,30,13
1657521803480,MATH 18,A03,083745,Cinel; Cameron Alexander,9,0,30,21
1657521803480,MATH 18,B01,083748,Rideout; David Porter,5,0,37,32
1657521803480,MATH 18,B02,083749,Rideout; David Porter,5,0,36,31
1657521803480,MATH 18,B03,083750,Rideout; David Porter,3,0,37,34
1657521803480,MATH 18,B04,083751,Rideout; David Porter,6,0,36,30
1657521803480,MATH 18,B05,093473,Rideout; David Porter,6,0,36,30
1657521803480,MATH 18,B06,093474,Rideout; David Porter,6,0,36,30
1657521809504,MATH 20A,A01,083754,Zheng; Zequn,14,0,40,26
1657521815534,MATH 20B,A01,083756,Briones; Jor-el Thomas Caparas,4,0,36,32
1657521815534,MATH 20B,A02,083757,Briones; Jor-el Thomas Caparas,1,0,36,35
1657521815534,MATH 20B,A03,093475,Briones; Jor-el Thomas Caparas,2,0,36,34
1657521821563,MATH 20C,A01,083760,Briones; Jor-el Thomas Caparas,1,0,35,34
1657521821563,MATH 20C,A02,083761,Briones; Jor-el Thomas Caparas,8,0,35,27
1657521821563,MATH 20C,A03,093476,Briones; Jor-el Thomas Caparas,0,1,36,36
1657521821563,MATH 20C,B01,083762,Bach; Quang Tran,1,0,30,29
1657521827593,MATH 20D,A01,083765,Tran; Brian Kha,5,0,30,25
1657521827593,MATH 20D,A02,083766,Tran; Brian Kha,5,0,30,25
1657521827593,MATH 20D,A03,083767,Tran; Brian Kha,5,0,30,25
1657521833616,MATH 20E,A01,083771,Ganguly; Soumya,9,0,32,23
1657521833616,MATH 20E,A02,083772,Ganguly; Soumya,6,0,32,26
1657521833616,MATH 20E,B01,083773,Ciotti; Benjamin,20,0,35,15
1657521833616,MATH 20E,B02,083774,Ciotti; Benjamin,17,0,35,18
1657521839644,MATH 103A,A01,083777,Greenfeld; Be'Eri,3,0,36,33
1657521839644,MATH 103A,A02,083778,Greenfeld; Be'Eri,5,0,36,31
1657521839644,MATH 103A,A03,093561,Greenfeld; Be'Eri,5,0,36,31
1657521839644,MATH 103A,B01,083779,Greenfeld; Be'Eri,7,0,36,29
1657521839644,MATH 103A,B02,083780,Greenfeld; Be'Eri,4,0,36,32
1657521839644,MATH 103A,B03,093562,Greenfeld; Be'Eri,3,0,36,33
1657521845668,MATH 105,A01,085443,Carter; Anne Toulson,15,0,35,20
1657521845668,MATH 105,A02,093477,Carter; Anne Toulson,20,0,35,15
1657521851696,MATH 109,A01,083213,Ganzberger; Geoffrey Michael,2,0,34,32
1657521851696,MATH 109,A02,083214,Ganzberger; Geoffrey Michael,4,0,34,30
1657521851696,MATH 109,A03,093478,Ganzberger; Geoffrey Michael,2,0,34,32
1657521851696,MATH 109,B01,083215,Ganzberger; Geoffrey Michael,1,0,32,31
1657521851696,MATH 109,B02,083216,Ganzberger; Geoffrey Michael,2,0,32,30
1657521851696,MATH 109,B03,093479,Ganzberger; Geoffrey Michael,8,0,32,24
1657521857719,MATH 142A,A01,083219,Chow; Bennett,7,0,32,25
1657521857719,MATH 142A,A02,083220,Chow; Bennett,10,0,32,22
1657521857719,MATH 142A,A03,093480,Chow; Bennett,8,0,32,24
1657521857719,MATH 142A,B03,093481,Chow; Bennett,8,0,32,24
1657521857719,MATH 142A,B04,093558,Chow; Bennett,13,0,32,19
1657521857719,MATH 142A,B05,093559,Chow; Bennett,6,0,32,26
1657521863742,MATH 193A,A01,083224,Rotar; Vladimir,8,0,34,26
1657521863742,MATH 193A,A02,083225,Rotar; Vladimir,9,0,34,25
1657521863742,MATH 193A,A03,083781,Rotar; Vladimir,5,0,34,29
1657521863742,MATH 193A,A04,083782,Rotar; Vladimir,10,0,34,24
1657521863742,MATH 193A,A05,093482,Rotar; Vladimir,10,0,34,24
1657521869769,MATH 197,001,091859,McAuley; Julian John,9999,0,9999,0
1657521869769,MATH 197,002,095566,Kedlaya; Kiran S.,9997,0,9999,2
1657521869769,MATH 197,003,095567,Xiao; Ming,9999,0,9999,0
1657521869769,MATH 197,004,095571,Perols; Johan Lars,9998,0,9999,1
1657521876823,COGS 9,A01,083615,Shannon; Kyle Michael,9,0,75,66
1657521882846,COGS 11,A01,083617,Boyle; Mary E. T.,22,0,48,26
1657521888869,COGS 13,A01,083071,Bastos; Amalia Pinkusfeld,11,0,71,60
1657521894891,COGS 14A,A01,092681,Semenuks; Arturs,5,1,100,95
1657521900918,COGS 14B,A01,083073,Cheng; Tzu-Han,6,0,63,57
1657521906940,COGS 17,A01,092677,Semenuks; Arturs,6,0,81,75
1657521912967,COGS 100,A01,083619,Allen; Michael Gordon,17,0,70,53
1657521918989,COGS 101A,A01,083621,Davis; Joshua Daniel,9,0,68,59
1657521925016,COGS 101B,A01,091572,Allen; Michael Gordon,12,0,65,53
1657521931040,COGS 101C,A01,083625,Delgado; Tania,17,0,35,18
1657521937064,COGS 107A,A01,083627,Boyle; Mary E. T.,13,0,60,47
1657521943090,COGS 118A,A01,083075,Gupta; Anjum,21,0,76,55
1657521949120,CSE 3,A50,083646,Miranda; Gregory Joseph,24,0,50,26
1657521955142,CSE 8A,A50,083650,Miranda; Gregory Joseph,17,1,56,39
1657521961166,CSE 11,A01,083080,Cao; Yingjun,6,15,40,34
1657521967193,CSE 12,A01,083652,Krause-Levy; Sophia Louisa,28,1,120,92
1657521973220,CSE 15L,A01,083654,Morris; Justin Loren,9,0,50,41
1657521973220,CSE 15L,A02,083655,Morris; Justin Loren,9,0,50,41
1657521979242,CSE 20,A01,083657,Tran; Khoa Dang,39,0,80,41
1657521985267,CSE 21,A01,095574,Bach; Quang Tran,22,0,48,26
1657521991290,CSE 30,A01,083084,Eldon; John,5,0,80,75
1657521991290,CSE 30,B01,095061,Bhaskar; Nishant,9,0,50,41
1657521997312,CSE 100,A01,083659,Cao; Yingjun,5,4,70,65
1657522003336,CSE 134B,A01,083661,Powell; Thomas Allan,22,0,100,78
1657522009362,CSE 140,A01,083663,Gungor; Onat,15,0,85,70
1657522015396,CSE 140L,A01,083088,Eldon; John,21,0,100,79
1657522021418,CSE 175,A01,083665,Kumar; Rakesh,3,0,25,22
1657522027444,CSE 190,A00,092507,Dubnov; Shlomo,8,0,20,12
1657522033471,ECE 45,A01,083139,Congero; Spencer William,6,0,75,69
1657522039493,ECE 65,A50,083695,Saad; Andrew S,12,0,30,18
1657522039493,ECE 65,A51,095125,Saad; Andrew S,24,0,26,2
1657522045518,ECE 109,A01,091882,Touri; Behrouz,19,0,70,51
1657522051549,ECE 180,A00,083140,Abi Samra; Nicholas Camill,1,0,30,29
1657522051549,ECE 180,B00,083141,Abi Samra; Nicholas Camill,0,0,30,30
1657522057583,MATH 10A,A01,083735,Patchell; Gregory David,2,0,30,28
1657522057583,MATH 10A,A02,083736,Patchell; Gregory David,20,0,30,10
1657522057583,MATH 10A,A03,083737,Patchell; Gregory David,16,0,30,14
1657522063606,MATH 10B,A01,083207,Lim; Seonhee,8,0,34,26
1657522063606,MATH 10B,A02,083208,Lim; Seonhee,9,0,35,26
1657522063606,MATH 10B,A03,093472,Lim; Seonhee,7,0,34,27
1657522063606,MATH 10B,B01,083739,Sinha; Shubham,12,0,30,18
1657522069631,MATH 18,A01,083743,Cinel; Cameron Alexander,7,0,30,23
1657522069631,MATH 18,A02,083744,Cinel; Cameron Alexander,17,0,30,13
1657522069631,MATH 18,A03,083745,Cinel; Cameron Alexander,9,0,30,21
1657522069631,MATH 18,B01,083748,Rideout; David Porter,5,0,37,32
1657522069631,MATH 18,B02,083749,Rideout; David Porter,5,0,36,31
1657522069631,MATH 18,B03,083750,Rideout; David Porter,3,0,37,34
1657522069631,MATH 18,B04,083751,Rideout; David Porter,6,0,36,30
1657522069631,MATH 18,B05,093473,Rideout; David Porter,6,0,36,30
1657522069631,MATH 18,B06,093474,Rideout; David Porter,6,0,36,30
1657522075658,MATH 20A,A01,083754,Zheng; Zequn,14,0,40,26
1657522081684,MATH 20B,A01,083756,Briones; Jor-el Thomas Caparas,4,0,36,32
1657522081684,MATH 20B,A02,083757,Briones; Jor-el Thomas Caparas,1,0,36,35
1657522081684,MATH 20B,A03,093475,Briones; Jor-el Thomas Caparas,2,0,36,34
1657522087709,MATH 20C,A01,083760,Briones; Jor-el Thomas Caparas,1,0,35,34
1657522087709,MATH 20C,A02,083761,Briones; Jor-el Thomas Caparas,8,0,35,27
1657522087709,MATH 20C,A03,093476,Briones; Jor-el Thomas Caparas,0,1,36,36
1657522087709,MATH 20C,B01,083762,Bach; Quang Tran,1,0,30,29
1657522093737,MATH 20D,A01,083765,Tran; Brian Kha,5,0,30,25
1657522093737,MATH 20D,A02,083766,Tran; Brian Kha,5,0,30,25
1657522093737,MATH 20D,A03,083767,Tran; Brian Kha,5,0,30,25
1657522099761,MATH 20E,A01,083771,Ganguly; Soumya,9,0,32,23
1657522099761,MATH 20E,A02,083772,Ganguly; Soumya,6,0,32,26
1657522099761,MATH 20E,B01,083773,Ciotti; Benjamin,20,0,35,15
1657522099761,MATH 20E,B02,083774,Ciotti; Benjamin,17,0,35,18
1657522105791,MATH 103A,A01,083777,Greenfeld; Be'Eri,3,0,36,33
1657522105791,MATH 103A,A02,083778,Greenfeld; Be'Eri,5,0,36,31
1657522105791,MATH 103A,A03,093561,Greenfeld; Be'Eri,5,0,36,31
1657522105791,MATH 103A,B01,083779,Greenfeld; Be'Eri,7,0,36,29
1657522105791,MATH 103A,B02,083780,Greenfeld; Be'Eri,4,0,36,32
1657522105791,MATH 103A,B03,093562,Greenfeld; Be'Eri,3,0,36,33
1657522111814,MATH 105,A01,085443,Carter; Anne Toulson,15,0,35,20
1657522111814,MATH 105,A02,093477,Carter; Anne Toulson,20,0,35,15
1657522117841,MATH 109,A01,083213,Ganzberger; Geoffrey Michael,2,0,34,32
1657522117841,MATH 109,A02,083214,Ganzberger; Geoffrey Michael,4,0,34,30
1657522117841,MATH 109,A03,093478,Ganzberger; Geoffrey Michael,2,0,34,32
1657522117841,MATH 109,B01,083215,Ganzberger; Geoffrey Michael,1,0,32,31
1657522117841,MATH 109,B02,083216,Ganzberger; Geoffrey Michael,2,0,32,30
1657522117841,MATH 109,B03,093479,Ganzberger; Geoffrey Michael,8,0,32,24
1657522123872,MATH 142A,A01,083219,Chow; Bennett,7,0,32,25
1657522123872,MATH 142A,A02,083220,Chow; Bennett,10,0,32,22
1657522123872,MATH 142A,A03,093480,Chow; Bennett,8,0,32,24
1657522123872,MATH 142A,B03,093481,Chow; Bennett,8,0,32,24
1657522123872,MATH 142A,B04,093558,Chow; Bennett,13,0,32,19
1657522123872,MATH 142A,B05,093559,Chow; Bennett,6,0,32,26
1657522129895,MATH 193A,A01,083224,Rotar; Vladimir,8,0,34,26
1657522129895,MATH 193A,A02,083225,Rotar; Vladimir,9,0,34,25
1657522129895,MATH 193A,A03,083781,Rotar; Vladimir,5,0,34,29
1657522129895,MATH 193A,A04,083782,Rotar; Vladimir,10,0,34,24
1657522129895,MATH 193A,A05,093482,Rotar; Vladimir,10,0,34,24
1657522135918,MATH 197,001,091859,McAuley; Julian John,9999,0,9999,0
1657522135918,MATH 197,002,095566,Kedlaya; Kiran S.,9997,0,9999,2
1657522135918,MATH 197,003,095567,Xiao; Ming,9999,0,9999,0
1657522135918,MATH 197,004,095571,Perols; Johan Lars,9998,0,9999,1
1657522142973,COGS 9,A01,083615,Shannon; Kyle Michael,9,0,75,66
1657522148995,COGS 11,A01,083617,Boyle; Mary E. T.,22,0,48,26
1657522155018,COGS 13,A01,083071,Bastos; Amalia Pinkusfeld,11,0,71,60
1657522161042,COGS 14A,A01,092681,Semenuks; Arturs,5,1,100,95
1657522167065,COGS 14B,A01,083073,Cheng; Tzu-Han,6,0,63,57
1657522173091,COGS 17,A01,092677,Semenuks; Arturs,6,0,81,75
1657522179115,COGS 100,A01,083619,Allen; Michael Gordon,17,0,70,53
1657522185139,COGS 101A,A01,083621,Davis; Joshua Daniel,9,0,68,59
1657522191176,COGS 101B,A01,091572,Allen; Michael Gordon,12,0,65,53
1657522197199,COGS 101C,A01,083625,Delgado; Tania,17,0,35,18
1657522203223,COGS 107A,A01,083627,Boyle; Mary E. T.,13,0,60,47
1657522209249,COGS 118A,A01,083075,Gupta; Anjum,21,0,76,55
1657522215271,CSE 3,A50,083646,Miranda; Gregory Joseph,24,0,50,26
1657522221296,CSE 8A,A50,083650,Miranda; Gregory Joseph,17,1,56,39
1657522227318,CSE 11,A01,083080,Cao; Yingjun,6,15,40,34
1657522233350,CSE 12,A01,083652,Krause-Levy; Sophia Louisa,28,1,120,92
1657522239378,CSE 15L,A01,083654,Morris; Justin Loren,9,0,50,41
1657522239378,CSE 15L,A02,083655,Morris; Justin Loren,9,0,50,41
1657522245401,CSE 20,A01,083657,Tran; Khoa Dang,39,0,80,41
1657522251422,CSE 21,A01,095574,Bach; Quang Tran,22,0,48,26
1657522257444,CSE 30,A01,083084,Eldon; John,5,0,80,75
1657522257444,CSE 30,B01,095061,Bhaskar; Nishant,9,0,50,41
1657522263472,CSE 100,A01,083659,Cao; Yingjun,5,4,70,65
1657522269494,CSE 134B,A01,083661,Powell; Thomas Allan,22,0,100,78
1657522275517,CSE 140,A01,083663,Gungor; Onat,15,0,85,70
1657522281613,CSE 140L,A01,083088,Eldon; John,21,0,100,79
1657522287635,CSE 175,A01,083665,Kumar; Rakesh,3,0,25,22
1657522293663,CSE 190,A00,092507,Dubnov; Shlomo,8,0,20,12
1657522299686,ECE 45,A01,083139,Congero; Spencer William,6,0,75,69
1657522305709,ECE 65,A50,083695,Saad; Andrew S,12,0,30,18
1657522305709,ECE 65,A51,095125,Saad; Andrew S,24,0,26,2
1657522311733,ECE 109,A01,091882,Touri; Behrouz,19,0,70,51
1657522317758,ECE 180,A00,083140,Abi Samra; Nicholas Camill,1,0,30,29
1657522317758,ECE 180,B00,083141,Abi Samra; Nicholas Camill,0,0,30,30
1657522323783,MATH 10A,A01,083735,Patchell; Gregory David,2,0,30,28
1657522323783,MATH 10A,A02,083736,Patchell; Gregory David,20,0,30,10
1657522323783,MATH 10A,A03,083737,Patchell; Gregory David,16,0,30,14
1657522329812,MATH 10B,A01,083207,Lim; Seonhee,8,0,34,26
1657522329812,MATH 10B,A02,083208,Lim; Seonhee,9,0,35,26
1657522329812,MATH 10B,A03,093472,Lim; Seonhee,7,0,34,27
1657522329812,MATH 10B,B01,083739,Sinha; Shubham,12,0,30,18
1657522335837,MATH 18,A01,083743,Cinel; Cameron Alexander,7,0,30,23
1657522335837,MATH 18,A02,083744,Cinel; Cameron Alexander,17,0,30,13
1657522335837,MATH 18,A03,083745,Cinel; Cameron Alexander,9,0,30,21
1657522335837,MATH 18,B01,083748,Rideout; David Porter,5,0,37,32
1657522335837,MATH 18,B02,083749,Rideout; David Porter,5,0,36,31
1657522335837,MATH 18,B03,083750,Rideout; David Porter,3,0,37,34
1657522335837,MATH 18,B04,083751,Rideout; David Porter,6,0,36,30
1657522335837,MATH 18,B05,093473,Rideout; David Porter,6,0,36,30
1657522335837,MATH 18,B06,093474,Rideout; David Porter,6,0,36,30
1657522341862,MATH 20A,A01,083754,Zheng; Zequn,14,0,40,26
1657522347885,MATH 20B,A01,083756,Briones; Jor-el Thomas Caparas,4,0,36,32
1657522347885,MATH 20B,A02,083757,Briones; Jor-el Thomas Caparas,1,0,36,35
1657522347885,MATH 20B,A03,093475,Briones; Jor-el Thomas Caparas,2,0,36,34
1657522353911,MATH 20C,A01,083760,Briones; Jor-el Thomas Caparas,1,0,35,34
1657522353911,MATH 20C,A02,083761,Briones; Jor-el Thomas Caparas,8,0,35,27
1657522353911,MATH 20C,A03,093476,Briones; Jor-el Thomas Caparas,0,1,36,36
1657522353911,MATH 20C,B01,083762,Bach; Quang Tran,1,0,30,29
1657522359935,MATH 20D,A01,083765,Tran; Brian Kha,5,0,30,25
1657522359935,MATH 20D,A02,083766,Tran; Brian Kha,5,0,30,25
1657522359935,MATH 20D,A03,083767,Tran; Brian Kha,5,0,30,25
1657522365962,MATH 20E,A01,083771,Ganguly; Soumya,9,0,32,23
1657522365962,MATH 20E,A02,083772,Ganguly; Soumya,6,0,32,26
1657522365962,MATH 20E,B01,083773,Ciotti; Benjamin,20,0,35,15
1657522365962,MATH 20E,B02,083774,Ciotti; Benjamin,17,0,35,18
1657522371987,MATH 103A,A01,083777,Greenfeld; Be'Eri,3,0,36,33
1657522371987,MATH 103A,A02,083778,Greenfeld; Be'Eri,5,0,36,31
1657522371987,MATH 103A,A03,093561,Greenfeld; Be'Eri,5,0,36,31
1657522371987,MATH 103A,B01,083779,Greenfeld; Be'Eri,7,0,36,29
1657522371987,MATH 103A,B02,083780,Greenfeld; Be'Eri,4,0,36,32
1657522371987,MATH 103A,B03,093562,Greenfeld; Be'Eri,3,0,36,33
1657522378011,MATH 105,A01,085443,Carter; Anne Toulson,15,0,35,20
1657522378011,MATH 105,A02,093477,Carter; Anne Toulson,20,0,35,15
1657522384041,MATH 109,A01,083213,Ganzberger; Geoffrey Michael,2,0,34,32
1657522384041,MATH 109,A02,083214,Ganzberger; Geoffrey Michael,4,0,34,30
1657522384041,MATH 109,A03,093478,Ganzberger; Geoffrey Michael,2,0,34,32
1657522384041,MATH 109,B01,083215,Ganzberger; Geoffrey Michael,1,0,32,31
1657522384041,MATH 109,B02,083216,Ganzberger; Geoffrey Michael,2,0,32,30
1657522384041,MATH 109,B03,093479,Ganzberger; Geoffrey Michael,8,0,32,24
1657522390071,MATH 142A,A01,083219,Chow; Bennett,7,0,32,25
1657522390071,MATH 142A,A02,083220,Chow; Bennett,10,0,32,22
1657522390071,MATH 142A,A03,093480,Chow; Bennett,8,0,32,24
1657522390071,MATH 142A,B03,093481,Chow; Bennett,8,0,32,24
1657522390071,MATH 142A,B04,093558,Chow; Bennett,13,0,32,19
1657522390071,MATH 142A,B05,093559,Chow; Bennett,6,0,32,26
1657522396094,MATH 193A,A01,083224,Rotar; Vladimir,8,0,34,26
1657522396094,MATH 193A,A02,083225,Rotar; Vladimir,9,0,34,25
1657522396094,MATH 193A,A03,083781,Rotar; Vladimir,5,0,34,29
1657522396094,MATH 193A,A04,083782,Rotar; Vladimir,10,0,34,24
1657522396094,MATH 193A,A05,093482,Rotar; Vladimir,10,0,34,24
1657522402117,MATH 197,001,091859,McAuley; Julian John,9999,0,9999,0
1657522402117,MATH 197,002,095566,Kedlaya; Kiran S.,9997,0,9999,2
1657522402117,MATH 197,003,095567,Xiao; Ming,9999,0,9999,0
1657522402117,MATH 197,004,095571,Perols; Johan Lars,9998,0,9999,1
1657522409175,COGS 9,A01,083615,Shannon; Kyle Michael,9,0,75,66
1657522415198,COGS 11,A01,083617,Boyle; Mary E. T.,22,0,48,26
1657522421222,COGS 13,A01,083071,Bastos; Amalia Pinkusfeld,11,0,71,60
1657522427246,COGS 14A,A01,092681,Semenuks; Arturs,5,1,100,95
1657522433272,COGS 14B,A01,083073,Cheng; Tzu-Han,6,0,63,57
1657522439300,COGS 17,A01,092677,Semenuks; Arturs,6,0,81,75
1657522445321,COGS 100,A01,083619,Allen; Michael Gordon,17,0,70,53
1657522451348,COGS 101A,A01,083621,Davis; Joshua Daniel,9,0,68,59
1657522457372,COGS 101B,A01,091572,Allen; Michael Gordon,12,0,65,53
1657522463398,COGS 101C,A01,083625,Delgado; Tania,17,0,35,18
1657522469440,COGS 107A,A01,083627,Boyle; Mary E. T.,13,0,60,47
1657522475462,COGS 118A,A01,083075,Gupta; Anjum,21,0,76,55
1657522481485,CSE 3,A50,083646,Miranda; Gregory Joseph,24,0,50,26
1657522487510,CSE 8A,A50,083650,Miranda; Gregory Joseph,17,1,56,39
1657522493532,CSE 11,A01,083080,Cao; Yingjun,6,15,40,34
1657522499557,CSE 12,A01,083652,Krause-Levy; Sophia Louisa,28,1,120,92
1657522505584,CSE 15L,A01,083654,Morris; Justin Loren,9,0,50,41
1657522505584,CSE 15L,A02,083655,Morris; Justin Loren,9,0,50,41
1657522511605,CSE 20,A01,083657,Tran; Khoa Dang,39,0,80,41
1657522517628,CSE 21,A01,095574,Bach; Quang Tran,22,0,48,26
1657522523654,CSE 30,A01,083084,Eldon; John,5,0,80,75
1657522523654,CSE 30,B01,095061,Bhaskar; Nishant,9,0,50,41
1657522529675,CSE 100,A01,083659,Cao; Yingjun,5,4,70,65
1657522535702,CSE 134B,A01,083661,Powell; Thomas Allan,22,0,100,78
1657522541738,CSE 140,A01,083663,Gungor; Onat,15,0,85,70
1657522547765,CSE 140L,A01,083088,Eldon; John,21,0,100,79
1657522553788,CSE 175,A01,083665,Kumar; Rakesh,3,0,25,22
1657522559819,CSE 190,A00,092507,Dubnov; Shlomo,8,0,20,12
1657522565843,ECE 45,A01,083139,Congero; Spencer William,6,0,75,69
1657522571867,ECE 65,A50,083695,Saad; Andrew S,12,0,30,18
1657522571867,ECE 65,A51,095125,Saad; Andrew S,24,0,26,2
1657522577892,ECE 109,A01,091882,Touri; Behrouz,19,0,70,51
1657522583916,ECE 180,A00,083140,Abi Samra; Nicholas Camill,1,0,30,29
1657522583916,ECE 180,B00,083141,Abi Samra; Nicholas Camill,0,0,30,30
1657522589940,MATH 10A,A01,083735,Patchell; Gregory David,2,0,30,28
1657522589940,MATH 10A,A02,083736,Patchell; Gregory David,20,0,30,10
1657522589940,MATH 10A,A03,083737,Patchell; Gregory David,16,0,30,14
1657522595969,MATH 10B,A01,083207,Lim; Seonhee,8,0,34,26
1657522595969,MATH 10B,A02,083208,Lim; Seonhee,9,0,35,26
1657522595969,MATH 10B,A03,093472,Lim; Seonhee,7,0,34,27
1657522595969,MATH 10B,B01,083739,Sinha; Shubham,12,0,30,18
1657522601994,MATH 18,A01,083743,Cinel; Cameron Alexander,7,0,30,23
1657522601994,MATH 18,A02,083744,Cinel; Cameron Alexander,17,0,30,13
1657522601994,MATH 18,A03,083745,Cinel; Cameron Alexander,9,0,30,21
1657522601994,MATH 18,B01,083748,Rideout; David Porter,5,0,37,32
1657522601994,MATH 18,B02,083749,Rideout; David Porter,5,0,36,31
1657522601994,MATH 18,B03,083750,Rideout; David Porter,3,0,37,34
1657522601994,MATH 18,B04,083751,Rideout; David Porter,6,0,36,30
1657522601994,MATH 18,B05,093473,Rideout; David Porter,6,0,36,30
1657522601994,MATH 18,B06,093474,Rideout; David Porter,6,0,36,30
1657522608019,MATH 20A,A01,083754,Zheng; Zequn,14,0,40,26
1657522614047,MATH 20B,A01,083756,Briones; Jor-el Thomas Caparas,4,0,36,32
1657522614047,MATH 20B,A02,083757,Briones; Jor-el Thomas Caparas,1,0,36,35
1657522614047,MATH 20B,A03,093475,Briones; Jor-el Thomas Caparas,2,0,36,34
1657522620070,MATH 20C,A01,083760,Briones; Jor-el Thomas Caparas,1,0,35,34
1657522620070,MATH 20C,A02,083761,Briones; Jor-el Thomas Caparas,8,0,35,27
1657522620070,MATH 20C,A03,093476,Briones; Jor-el Thomas Caparas,0,1,36,36
1657522620070,MATH 20C,B01,083762,Bach; Quang Tran,1,0,30,29
1657522626094,MATH 20D,A01,083765,Tran; Brian Kha,5,0,30,25
1657522626094,MATH 20D,A02,083766,Tran; Brian Kha,5,0,30,25
1657522626094,MATH 20D,A03,083767,Tran; Brian Kha,5,0,30,25
1657522632128,MATH 20E,A01,083771,Ganguly; Soumya,9,0,32,23
1657522632128,MATH 20E,A02,083772,Ganguly; Soumya,6,0,32,26
1657522632128,MATH 20E,B01,083773,Ciotti; Benjamin,20,0,35,15
1657522632128,MATH 20E,B02,083774,Ciotti; Benjamin,17,0,35,18
1657522638163,MATH 103A,A01,083777,Greenfeld; Be'Eri,3,0,36,33
1657522638163,MATH 103A,A02,083778,Greenfeld; Be'Eri,5,0,36,31
1657522638163,MATH 103A,A03,093561,Greenfeld; Be'Eri,5,0,36,31
1657522638163,MATH 103A,B01,083779,Greenfeld; Be'Eri,7,0,36,29
1657522638163,MATH 103A,B02,083780,Greenfeld; Be'Eri,4,0,36,32
1657522638163,MATH 103A,B03,093562,Greenfeld; Be'Eri,3,0,36,33
1657522644191,MATH 105,A01,085443,Carter; Anne Toulson,15,0,35,20
1657522644191,MATH 105,A02,093477,Carter; Anne Toulson,20,0,35,15
1657522650214,MATH 109,A01,083213,Ganzberger; Geoffrey Michael,2,0,34,32
1657522650214,MATH 109,A02,083214,Ganzberger; Geoffrey Michael,4,0,34,30
1657522650214,MATH 109,A03,093478,Ganzberger; Geoffrey Michael,2,0,34,32
1657522650214,MATH 109,B01,083215,Ganzberger; Geoffrey Michael,1,0,32,31
1657522650214,MATH 109,B02,083216,Ganzberger; Geoffrey Michael,2,0,32,30
1657522650214,MATH 109,B03,093479,Ganzberger; Geoffrey Michael,8,0,32,24
1657522656245,MATH 142A,A01,083219,Chow; Bennett,7,0,32,25
1657522656245,MATH 142A,A02,083220,Chow; Bennett,10,0,32,22
1657522656245,MATH 142A,A03,093480,Chow; Bennett,8,0,32,24
1657522656245,MATH 142A,B03,093481,Chow; Bennett,8,0,32,24
1657522656245,MATH 142A,B04,093558,Chow; Bennett,13,0,32,19
1657522656245,MATH 142A,B05,093559,Chow; Bennett,6,0,32,26
1657522662269,MATH 193A,A01,083224,Rotar; Vladimir,8,0,34,26
1657522662269,MATH 193A,A02,083225,Rotar; Vladimir,9,0,34,25
1657522662269,MATH 193A,A03,083781,Rotar; Vladimir,5,0,34,29
1657522662269,MATH 193A,A04,083782,Rotar; Vladimir,10,0,34,24
1657522662269,MATH 193A,A05,093482,Rotar; Vladimir,10,0,34,24
1657522668292,MATH 197,001,091859,McAuley; Julian John,9999,0,9999,0
1657522668292,MATH 197,002,095566,Kedlaya; Kiran S.,9997,0,9999,2
1657522668292,MATH 197,003,095567,Xiao; Ming,9999,0,9999,0
1657522668292,MATH 197,004,095571,Perols; Johan Lars,9998,0,9999,1
1657522675356,COGS 9,A01,083615,Shannon; Kyle Michael,9,0,75,66
1657522681379,COGS 11,A01,083617,Boyle; Mary E. T.,22,0,48,26
1657522687405,COGS 13,A01,083071,Bastos; Amalia Pinkusfeld,11,0,71,60
1657522693428,COGS 14A,A01,092681,Semenuks; Arturs,5,1,100,95
1657522699454,COGS 14B,A01,083073,Cheng; Tzu-Han,6,0,63,57
1657522705476,COGS 17,A01,092677,Semenuks; Arturs,6,0,81,75
1657522711502,COGS 100,A01,083619,Allen; Michael Gordon,17,0,70,53
1657522717528,COGS 101A,A01,083621,Davis; Joshua Daniel,9,0,68,59
1657522723560,COGS 101B,A01,091572,Allen; Michael Gordon,12,0,65,53
1657522729589,COGS 101C,A01,083625,Delgado; Tania,17,0,35,18
1657522735613,COGS 107A,A01,083627,Boyle; Mary E. T.,13,0,60,47
1657522741646,COGS 118A,A01,083075,Gupta; Anjum,21,0,76,55
1657522747673,CSE 3,A50,083646,Miranda; Gregory Joseph,24,0,50,26
1657522753700,CSE 8A,A50,083650,Miranda; Gregory Joseph,17,1,56,39
1657522759723,CSE 11,A01,083080,Cao; Yingjun,6,15,40,34
1657522765748,CSE 12,A01,083652,Krause-Levy; Sophia Louisa,28,1,120,92
1657522771770,CSE 15L,A01,083654,Morris; Justin Loren,9,0,50,41
1657522771770,CSE 15L,A02,083655,Morris; Justin Loren,9,0,50,41
1657522777798,CSE 20,A01,083657,Tran; Khoa Dang,39,0,80,41
1657522783820,CSE 21,A01,095574,Bach; Quang Tran,22,0,48,26
1657522789847,CSE 30,A01,083084,Eldon; John,5,0,80,75
1657522789847,CSE 30,B01,095061,Bhaskar; Nishant,9,0,50,41
1657522795871,CSE 100,A01,083659,Cao; Yingjun,5,4,70,65
1657522801893,CSE 134B,A01,083661,Powell; Thomas Allan,22,0,100,78
1657522807933,CSE 140,A01,083663,Gungor; Onat,15,0,85,70
1657522813959,CSE 140L,A01,083088,Eldon; John,21,0,100,79
1657522819982,CSE 175,A01,083665,Kumar; Rakesh,3,0,25,22
1657522826006,CSE 190,A00,092507,Dubnov; Shlomo,8,0,20,12
1657522832029,ECE 45,A01,083139,Congero; Spencer William,6,0,75,69
1657522838051,ECE 65,A50,083695,Saad; Andrew S,12,0,30,18
1657522838051,ECE 65,A51,095125,Saad; Andrew S,24,0,26,2
1657522844078,ECE 109,A01,091882,Touri; Behrouz,19,0,70,51
1657522850101,ECE 180,A00,083140,Abi Samra; Nicholas Camill,1,0,30,29
1657522850101,ECE 180,B00,083141,Abi Samra; Nicholas Camill,0,0,30,30
1657522856124,MATH 10A,A01,083735,Patchell; Gregory David,2,0,30,28
1657522856124,MATH 10A,A02,083736,Patchell; Gregory David,20,0,30,10
1657522856124,MATH 10A,A03,083737,Patchell; Gregory David,16,0,30,14
1657522862169,MATH 10B,A01,083207,Lim; Seonhee,8,0,34,26
1657522862169,MATH 10B,A02,083208,Lim; Seonhee,9,0,35,26
1657522862169,MATH 10B,A03,093472,Lim; Seonhee,7,0,34,27
1657522862169,MATH 10B,B01,083739,Sinha; Shubham,12,0,30,18
1657522868205,MATH 18,A01,083743,Cinel; Cameron Alexander,7,0,30,23
1657522868205,MATH 18,A02,083744,Cinel; Cameron Alexander,17,0,30,13
1657522868205,MATH 18,A03,083745,Cinel; Cameron Alexander,9,0,30,21
1657522868205,MATH 18,B01,083748,Rideout; David Porter,5,0,37,32
1657522868205,MATH 18,B02,083749,Rideout; David Porter,5,0,36,31
1657522868205,MATH 18,B03,083750,Rideout; David Porter,3,0,37,34
1657522868205,MATH 18,B04,083751,Rideout; David Porter,6,0,36,30
1657522868205,MATH 18,B05,093473,Rideout; David Porter,6,0,36,30
1657522868205,MATH 18,B06,093474,Rideout; David Porter,6,0,36,30
1657522874231,MATH 20A,A01,083754,Zheng; Zequn,14,0,40,26
1657522880359,MATH 20B,A01,083756,Briones; Jor-el Thomas Caparas,4,0,36,32
1657522880359,MATH 20B,A02,083757,Briones; Jor-el Thomas Caparas,1,0,36,35
1657522880359,MATH 20B,A03,093475,Briones; Jor-el Thomas Caparas,2,0,36,34
1657522886384,MATH 20C,A01,083760,Briones; Jor-el Thomas Caparas,1,0,35,34
1657522886384,MATH 20C,A02,083761,Briones; Jor-el Thomas Caparas,8,0,35,27
1657522886384,MATH 20C,A03,093476,Briones; Jor-el Thomas Caparas,0,1,36,36
1657522886384,MATH 20C,B01,083762,Bach; Quang Tran,1,0,30,29
1657522892409,MATH 20D,A01,083765,Tran; Brian Kha,5,0,30,25
1657522892409,MATH 20D,A02,083766,Tran; Brian Kha,5,0,30,25
1657522892409,MATH 20D,A03,083767,Tran; Brian Kha,5,0,30,25
1657522898441,MATH 20E,A01,083771,Ganguly; Soumya,9,0,32,23
1657522898441,MATH 20E,A02,083772,Ganguly; Soumya,6,0,32,26
1657522898441,MATH 20E,B01,083773,Ciotti; Benjamin,20,0,35,15
1657522898441,MATH 20E,B02,083774,Ciotti; Benjamin,17,0,35,18
1657522904478,MATH 103A,A01,083777,Greenfeld; Be'Eri,3,0,36,33
1657522904478,MATH 103A,A02,083778,Greenfeld; Be'Eri,5,0,36,31
1657522904478,MATH 103A,A03,093561,Greenfeld; Be'Eri,5,0,36,31
1657522904478,MATH 103A,B01,083779,Greenfeld; Be'Eri,7,0,36,29
1657522904478,MATH 103A,B02,083780,Greenfeld; Be'Eri,4,0,36,32
1657522904478,MATH 103A,B03,093562,Greenfeld; Be'Eri,3,0,36,33
1657522910503,MATH 105,A01,085443,Carter; Anne Toulson,15,0,35,20
1657522910503,MATH 105,A02,093477,Carter; Anne Toulson,20,0,35,15
1657522916537,MATH 109,A01,083213,Ganzberger; Geoffrey Michael,2,0,34,32
1657522916537,MATH 109,A02,083214,Ganzberger; Geoffrey Michael,4,0,34,30
1657522916537,MATH 109,A03,093478,Ganzberger; Geoffrey Michael,2,0,34,32
1657522916537,MATH 109,B01,083215,Ganzberger; Geoffrey Michael,1,0,32,31
1657522916537,MATH 109,B02,083216,Ganzberger; Geoffrey Michael,2,0,32,30
1657522916537,MATH 109,B03,093479,Ganzberger; Geoffrey Michael,8,0,32,24
1657522922569,MATH 142A,A01,083219,Chow; Bennett,7,0,32,25
1657522922569,MATH 142A,A02,083220,Chow; Bennett,10,0,32,22
1657522922569,MATH 142A,A03,093480,Chow; Bennett,8,0,32,24
1657522922569,MATH 142A,B03,093481,Chow; Bennett,8,0,32,24
1657522922569,MATH 142A,B04,093558,Chow; Bennett,13,0,32,19
1657522922569,MATH 142A,B05,093559,Chow; Bennett,6,0,32,26
1657522928607,MATH 193A,A01,083224,Rotar; Vladimir,8,0,34,26
1657522928607,MATH 193A,A02,083225,Rotar; Vladimir,9,0,34,25
1657522928607,MATH 193A,A03,083781,Rotar; Vladimir,5,0,34,29
1657522928607,MATH 193A,A04,083782,Rotar; Vladimir,10,0,34,24
1657522928607,MATH 193A,A05,093482,Rotar; Vladimir,10,0,34,24
1657522934631,MATH 197,001,091859,McAuley; Julian John,9999,0,9999,0
1657522934631,MATH 197,002,095566,Kedlaya; Kiran S.,9997,0,9999,2
1657522934631,MATH 197,003,095567,Xiao; Ming,9999,0,9999,0
1657522934631,MATH 197,004,095571,Perols; Johan Lars,9998,0,9999,1
1657522941705,COGS 9,A01,083615,Shannon; Kyle Michael,9,0,75,66
1657522947728,COGS 11,A01,083617,Boyle; Mary E. T.,22,0,48,26
1657522953750,COGS 13,A01,083071,Bastos; Amalia Pinkusfeld,11,0,71,60
1657522959776,COGS 14A,A01,092681,Semenuks; Arturs,5,1,100,95
1657522965800,COGS 14B,A01,083073,Cheng; Tzu-Han,6,0,63,57
1657522971829,COGS 17,A01,092677,Semenuks; Arturs,6,0,81,75
1657522977856,COGS 100,A01,083619,Allen; Michael Gordon,17,0,70,53
1657522983879,COGS 101A,A01,083621,Davis; Joshua Daniel,9,0,68,59
1657522989906,COGS 101B,A01,091572,Allen; Michael Gordon,12,0,65,53
1657522995935,COGS 101C,A01,083625,Delgado; Tania,17,0,35,18
1657523001961,COGS 107A,A01,083627,Boyle; Mary E. T.,13,0,60,47
1657523007986,COGS 118A,A01,083075,Gupta; Anjum,21,0,76,55
1657523014011,CSE 3,A50,083646,Miranda; Gregory Joseph,24,0,50,26
1657523020034,CSE 8A,A50,083650,Miranda; Gregory Joseph,17,1,56,39
1657523026058,CSE 11,A01,083080,Cao; Yingjun,6,15,40,34
1657523032084,CSE 12,A01,083652,Krause-Levy; Sophia Louisa,28,1,120,92
1657523038107,CSE 15L,A01,083654,Morris; Justin Loren,9,0,50,41
1657523038107,CSE 15L,A02,083655,Morris; Justin Loren,9,0,50,41
1657523044129,CSE 20,A01,083657,Tran; Khoa Dang,39,0,80,41
1657523050153,CSE 21,A01,095574,Bach; Quang Tran,22,0,48,26
1657523056177,CSE 30,A01,083084,Eldon; John,5,0,80,75
1657523056177,CSE 30,B01,095061,Bhaskar; Nishant,9,0,50,41
1657523062205,CSE 100,A01,083659,Cao; Yingjun,5,4,70,65
1657523068233,CSE 134B,A01,083661,Powell; Thomas Allan,22,0,100,78
1657523074259,CSE 140,A01,083663,Gungor; Onat,15,0,85,70
1657523080285,CSE 140L,A01,083088,Eldon; John,21,0,100,79
1657523086311,CSE 175,A01,083665,Kumar; Rakesh,3,0,25,22
1657523092334,CSE 190,A00,092507,Dubnov; Shlomo,8,0,20,12
1657523098356,ECE 45,A01,083139,Congero; Spencer William,6,0,75,69
1657523104380,ECE 65,A50,083695,Saad; Andrew S,12,0,30,18
1657523104380,ECE 65,A51,095125,Saad; Andrew S,24,0,26,2
1657523110406,ECE 109,A01,091882,Touri; Behrouz,19,0,70,51
1657523116428,ECE 180,A00,083140,Abi Samra; Nicholas Camill,1,0,30,29
1657523116428,ECE 180,B00,083141,Abi Samra; Nicholas Camill,0,0,30,30
1657523122460,MATH 10A,A01,083735,Patchell; Gregory David,2,0,30,28
1657523122460,MATH 10A,A02,083736,Patchell; Gregory David,20,0,30,10
1657523122460,MATH 10A,A03,083737,Patchell; Gregory David,16,0,30,14
1657523128492,MATH 10B,A01,083207,Lim; Seonhee,8,0,34,26
1657523128492,MATH 10B,A02,083208,Lim; Seonhee,9,0,35,26
1657523128492,MATH 10B,A03,093472,Lim; Seonhee,7,0,34,27
1657523128492,MATH 10B,B01,083739,Sinha; Shubham,12,0,30,18
1657523134515,MATH 18,A01,083743,Cinel; Cameron Alexander,7,0,30,23
1657523134515,MATH 18,A02,083744,Cinel; Cameron Alexander,17,0,30,13
1657523134515,MATH 18,A03,083745,Cinel; Cameron Alexander,9,0,30,21
1657523134515,MATH 18,B01,083748,Rideout; David Porter,5,0,37,32
1657523134515,MATH 18,B02,083749,Rideout; David Porter,5,0,36,31
1657523134515,MATH 18,B03,083750,Rideout; David Porter,3,0,37,34
1657523134515,MATH 18,B04,083751,Rideout; David Porter,6,0,36,30
1657523134515,MATH 18,B05,093473,Rideout; David Porter,6,0,36,30
1657523134515,MATH 18,B06,093474,Rideout; David Porter,6,0,36,30
1657523140537,MATH 20A,A01,083754,Zheng; Zequn,14,0,40,26
1657523146562,MATH 20B,A01,083756,Briones; Jor-el Thomas Caparas,4,0,36,32
1657523146562,MATH 20B,A02,083757,Briones; Jor-el Thomas Caparas,1,0,36,35
1657523146562,MATH 20B,A03,093475,Briones; Jor-el Thomas Caparas,2,0,36,34
1657523152588,MATH 20C,A01,083760,Briones; Jor-el Thomas Caparas,1,0,35,34
1657523152588,MATH 20C,A02,083761,Briones; Jor-el Thomas Caparas,8,0,35,27
1657523152588,MATH 20C,A03,093476,Briones; Jor-el Thomas Caparas,0,1,36,36
1657523152588,MATH 20C,B01,083762,Bach; Quang Tran,1,0,30,29
1657523158611,MATH 20D,A01,083765,Tran; Brian Kha,5,0,30,25
1657523158611,MATH 20D,A02,083766,Tran; Brian Kha,5,0,30,25
1657523158611,MATH 20D,A03,083767,Tran; Brian Kha,5,0,30,25
1657523164635,MATH 20E,A01,083771,Ganguly; Soumya,9,0,32,23
1657523164635,MATH 20E,A02,083772,Ganguly; Soumya,6,0,32,26
1657523164635,MATH 20E,B01,083773,Ciotti; Benjamin,20,0,35,15
1657523164635,MATH 20E,B02,083774,Ciotti; Benjamin,17,0,35,18
1657523170668,MATH 103A,A01,083777,Greenfeld; Be'Eri,3,0,36,33
1657523170668,MATH 103A,A02,083778,Greenfeld; Be'Eri,5,0,36,31
1657523170668,MATH 103A,A03,093561,Greenfeld; Be'Eri,5,0,36,31
1657523170668,MATH 103A,B01,083779,Greenfeld; Be'Eri,7,0,36,29
1657523170668,MATH 103A,B02,083780,Greenfeld; Be'Eri,4,0,36,32
1657523170668,MATH 103A,B03,093562,Greenfeld; Be'Eri,3,0,36,33
1657523176697,MATH 105,A01,085443,Carter; Anne Toulson,15,0,35,20
1657523176697,MATH 105,A02,093477,Carter; Anne Toulson,20,0,35,15
1657523182728,MATH 109,A01,083213,Ganzberger; Geoffrey Michael,2,0,34,32
1657523182728,MATH 109,A02,083214,Ganzberger; Geoffrey Michael,4,0,34,30
1657523182728,MATH 109,A03,093478,Ganzberger; Geoffrey Michael,2,0,34,32
1657523182728,MATH 109,B01,083215,Ganzberger; Geoffrey Michael,1,0,32,31
1657523182728,MATH 109,B02,083216,Ganzberger; Geoffrey Michael,2,0,32,30
1657523182728,MATH 109,B03,093479,Ganzberger; Geoffrey Michael,8,0,32,24
1657523188759,MATH 142A,A01,083219,Chow; Bennett,7,0,32,25
1657523188759,MATH 142A,A02,083220,Chow; Bennett,10,0,32,22
1657523188759,MATH 142A,A03,093480,Chow; Bennett,8,0,32,24
1657523188759,MATH 142A,B03,093481,Chow; Bennett,8,0,32,24
1657523188759,MATH 142A,B04,093558,Chow; Bennett,13,0,32,19
1657523188759,MATH 142A,B05,093559,Chow; Bennett,6,0,32,26
1657523194783,MATH 193A,A01,083224,Rotar; Vladimir,8,0,34,26
1657523194783,MATH 193A,A02,083225,Rotar; Vladimir,9,0,34,25
1657523194783,MATH 193A,A03,083781,Rotar; Vladimir,5,0,34,29
1657523194783,MATH 193A,A04,083782,Rotar; Vladimir,10,0,34,24
1657523194783,MATH 193A,A05,093482,Rotar; Vladimir,10,0,34,24
1657523200809,MATH 197,001,091859,McAuley; Julian John,9999,0,9999,0
1657523200809,MATH 197,002,095566,Kedlaya; Kiran S.,9997,0,9999,2
1657523200809,MATH 197,003,095567,Xiao; Ming,9999,0,9999,0
1657523200809,MATH 197,004,095571,Perols; Johan Lars,9998,0,9999,1
1657523207872,COGS 9,A01,083615,Shannon; Kyle Michael,9,0,75,66
1657523213899,COGS 11,A01,083617,Boyle; Mary E. T.,22,0,48,26
1657523219921,COGS 13,A01,083071,Bastos; Amalia Pinkusfeld,11,0,71,60
1657523225946,COGS 14A,A01,092681,Semenuks; Arturs,5,1,100,95
1657523231975,COGS 14B,A01,083073,Cheng; Tzu-Han,6,0,63,57
1657523238001,COGS 17,A01,092677,Semenuks; Arturs,6,0,81,75
1657523244026,COGS 100,A01,083619,Allen; Michael Gordon,17,0,70,53
1657523250051,COGS 101A,A01,083621,Davis; Joshua Daniel,9,0,68,59
1657523256083,COGS 101B,A01,091572,Allen; Michael Gordon,12,0,65,53
1657523262110,COGS 101C,A01,083625,Delgado; Tania,17,0,35,18
1657523268133,COGS 107A,A01,083627,Boyle; Mary E. T.,13,0,60,47
1657523274155,COGS 118A,A01,083075,Gupta; Anjum,21,0,76,55
1657523280186,CSE 3,A50,083646,Miranda; Gregory Joseph,24,0,50,26
1657523286211,CSE 8A,A50,083650,Miranda; Gregory Joseph,17,1,56,39
1657523292237,CSE 11,A01,083080,Cao; Yingjun,6,15,40,34
1657523298266,CSE 12,A01,083652,Krause-Levy; Sophia Louisa,28,1,120,92
1657523304293,CSE 15L,A01,083654,Morris; Justin Loren,9,0,50,41
1657523304293,CSE 15L,A02,083655,Morris; Justin Loren,9,0,50,41
1657523310315,CSE 20,A01,083657,Tran; Khoa Dang,39,0,80,41
1657523316338,CSE 21,A01,095574,Bach; Quang Tran,22,0,48,26
1657523322361,CSE 30,A01,083084,Eldon; John,5,0,80,75
1657523322361,CSE 30,B01,095061,Bhaskar; Nishant,9,0,50,41
1657523328385,CSE 100,A01,083659,Cao; Yingjun,5,4,70,65
1657523334408,CSE 134B,A01,083661,Powell; Thomas Allan,22,0,100,78
1657523340431,CSE 140,A01,083663,Gungor; Onat,15,0,85,70
1657523346453,CSE 140L,A01,083088,Eldon; John,21,0,100,79
1657523352490,CSE 175,A01,083665,Kumar; Rakesh,3,0,25,22
1657523358625,CSE 190,A00,092507,Dubnov; Shlomo,8,0,20,12
1657523364653,ECE 45,A01,083139,Congero; Spencer William,6,0,75,69
1657523370677,ECE 65,A50,083695,Saad; Andrew S,12,0,30,18
1657523370677,ECE 65,A51,095125,Saad; Andrew S,24,0,26,2
1657523376700,ECE 109,A01,091882,Touri; Behrouz,19,0,70,51
1657523382723,ECE 180,A00,083140,Abi Samra; Nicholas Camill,1,0,30,29
1657523382723,ECE 180,B00,083141,Abi Samra; Nicholas Camill,0,0,30,30
1657523388770,MATH 10A,A01,083735,Patchell; Gregory David,2,0,30,28
1657523388770,MATH 10A,A02,083736,Patchell; Gregory David,20,0,30,10
1657523388770,MATH 10A,A03,083737,Patchell; Gregory David,16,0,30,14
1657523394798,MATH 10B,A01,083207,Lim; Seonhee,8,0,34,26
1657523394798,MATH 10B,A02,083208,Lim; Seonhee,9,0,35,26
1657523394798,MATH 10B,A03,093472,Lim; Seonhee,7,0,34,27
1657523394798,MATH 10B,B01,083739,Sinha; Shubham,12,0,30,18
1657523400822,MATH 18,A01,083743,Cinel; Cameron Alexander,7,0,30,23
1657523400822,MATH 18,A02,083744,Cinel; Cameron Alexander,17,0,30,13
1657523400822,MATH 18,A03,083745,Cinel; Cameron Alexander,9,0,30,21
1657523400822,MATH 18,B01,083748,Rideout; David Porter,5,0,37,32
1657523400822,MATH 18,B02,083749,Rideout; David Porter,5,0,36,31
1657523400822,MATH 18,B03,083750,Rideout; David Porter,3,0,37,34
1657523400822,MATH 18,B04,083751,Rideout; David Porter,6,0,36,30
1657523400822,MATH 18,B05,093473,Rideout; David Porter,6,0,36,30
1657523400822,MATH 18,B06,093474,Rideout; David Porter,6,0,36,30
1657523406846,MATH 20A,A01,083754,Zheng; Zequn,14,0,40,26
1657523412871,MATH 20B,A01,083756,Briones; Jor-el Thomas Caparas,4,0,36,32
1657523412871,MATH 20B,A02,083757,Briones; Jor-el Thomas Caparas,1,0,36,35
1657523412871,MATH 20B,A03,093475,Briones; Jor-el Thomas Caparas,2,0,36,34
1657523418898,MATH 20C,A01,083760,Briones; Jor-el Thomas Caparas,1,0,35,34
1657523418898,MATH 20C,A02,083761,Briones; Jor-el Thomas Caparas,8,0,35,27
1657523418898,MATH 20C,A03,093476,Briones; Jor-el Thomas Caparas,0,1,36,36
1657523418898,MATH 20C,B01,083762,Bach; Quang Tran,1,0,30,29
1657523424933,MATH 20D,A01,083765,Tran; Brian Kha,5,0,30,25
1657523424933,MATH 20D,A02,083766,Tran; Brian Kha,5,0,30,25
1657523424933,MATH 20D,A03,083767,Tran; Brian Kha,5,0,30,25
1657523430956,MATH 20E,A01,083771,Ganguly; Soumya,9,0,32,23
1657523430956,MATH 20E,A02,083772,Ganguly; Soumya,6,0,32,26
1657523430956,MATH 20E,B01,083773,Ciotti; Benjamin,20,0,35,15
1657523430956,MATH 20E,B02,083774,Ciotti; Benjamin,17,0,35,18
1657523436978,MATH 103A,A01,083777,Greenfeld; Be'Eri,3,0,36,33
1657523436978,MATH 103A,A02,083778,Greenfeld; Be'Eri,5,0,36,31
1657523436978,MATH 103A,A03,093561,Greenfeld; Be'Eri,5,0,36,31
1657523436978,MATH 103A,B01,083779,Greenfeld; Be'Eri,7,0,36,29
1657523436978,MATH 103A,B02,083780,Greenfeld; Be'Eri,4,0,36,32
1657523436978,MATH 103A,B03,093562,Greenfeld; Be'Eri,3,0,36,33
1657523443002,MATH 105,A01,085443,Carter; Anne Toulson,15,0,35,20
1657523443002,MATH 105,A02,093477,Carter; Anne Toulson,20,0,35,15
1657523449026,MATH 109,A01,083213,Ganzberger; Geoffrey Michael,2,0,34,32
1657523449026,MATH 109,A02,083214,Ganzberger; Geoffrey Michael,4,0,34,30
1657523449026,MATH 109,A03,093478,Ganzberger; Geoffrey Michael,2,0,34,32
1657523449026,MATH 109,B01,083215,Ganzberger; Geoffrey Michael,1,0,32,31
1657523449026,MATH 109,B02,083216,Ganzberger; Geoffrey Michael,2,0,32,30
1657523449026,MATH 109,B03,093479,Ganzberger; Geoffrey Michael,8,0,32,24
1657523455068,MATH 142A,A01,083219,Chow; Bennett,7,0,32,25
1657523455068,MATH 142A,A02,083220,Chow; Bennett,10,0,32,22
1657523455068,MATH 142A,A03,093480,Chow; Bennett,8,0,32,24
1657523455068,MATH 142A,B03,093481,Chow; Bennett,8,0,32,24
1657523455068,MATH 142A,B04,093558,Chow; Bennett,13,0,32,19
1657523455068,MATH 142A,B05,093559,Chow; Bennett,6,0,32,26
1657523461104,MATH 193A,A01,083224,Rotar; Vladimir,8,0,34,26
1657523461104,MATH 193A,A02,083225,Rotar; Vladimir,9,0,34,25
1657523461104,MATH 193A,A03,083781,Rotar; Vladimir,5,0,34,29
1657523461104,MATH 193A,A04,083782,Rotar; Vladimir,10,0,34,24
1657523461104,MATH 193A,A05,093482,Rotar; Vladimir,10,0,34,24
1657523467130,MATH 197,001,091859,McAuley; Julian John,9999,0,9999,0
1657523467130,MATH 197,002,095566,Kedlaya; Kiran S.,9997,0,9999,2
1657523467130,MATH 197,003,095567,Xiao; Ming,9999,0,9999,0
1657523467130,MATH 197,004,095571,Perols; Johan Lars,9998,0,9999,1
1657523474315,COGS 9,A01,083615,Shannon; Kyle Michael,9,0,75,66
1657523480338,COGS 11,A01,083617,Boyle; Mary E. T.,22,0,48,26
1657523486366,COGS 13,A01,083071,Bastos; Amalia Pinkusfeld,11,0,71,60
1657523492391,COGS 14A,A01,092681,Semenuks; Arturs,5,1,100,95
1657523498416,COGS 14B,A01,083073,Cheng; Tzu-Han,6,0,63,57
1657523504442,COGS 17,A01,092677,Semenuks; Arturs,6,0,81,75
1657523510473,COGS 100,A01,083619,Allen; Michael Gordon,17,0,70,53
1657523516496,COGS 101A,A01,083621,Davis; Joshua Daniel,9,0,68,59
1657523522656,COGS 101B,A01,091572,Allen; Michael Gordon,12,0,65,53
1657523528687,COGS 101C,A01,083625,Delgado; Tania,17,0,35,18
1657523534711,COGS 107A,A01,083627,Boyle; Mary E. T.,13,0,60,47
1657523540738,COGS 118A,A01,083075,Gupta; Anjum,21,0,76,55
1657523546766,CSE 3,A50,083646,Miranda; Gregory Joseph,24,0,50,26
1657523552793,CSE 8A,A50,083650,Miranda; Gregory Joseph,17,1,56,39
1657523558819,CSE 11,A01,083080,Cao; Yingjun,6,15,40,34
1657523564847,CSE 12,A01,083652,Krause-Levy; Sophia Louisa,28,1,120,92
1657523570882,CSE 15L,A01,083654,Morris; Justin Loren,9,0,50,41
1657523570882,CSE 15L,A02,083655,Morris; Justin Loren,9,0,50,41
1657523576906,CSE 20,A01,083657,Tran; Khoa Dang,39,0,80,41
1657523582937,CSE 21,A01,095574,Bach; Quang Tran,22,0,48,26
1657523588977,CSE 30,A01,083084,Eldon; John,5,0,80,75
1657523588977,CSE 30,B01,095061,Bhaskar; Nishant,9,0,50,41
1657523595003,CSE 100,A01,083659,Cao; Yingjun,5,4,70,65
1657523601032,CSE 134B,A01,083661,Powell; Thomas Allan,22,0,100,78
1657523607063,CSE 140,A01,083663,Gungor; Onat,15,0,85,70
1657523613091,CSE 140L,A01,083088,Eldon; John,21,0,100,79
1657523619119,CSE 175,A01,083665,Kumar; Rakesh,3,0,25,22
1657523625147,CSE 190,A00,092507,Dubnov; Shlomo,8,0,20,12
1657523631178,ECE 45,A01,083139,Congero; Spencer William,6,0,75,69
1657523637208,ECE 65,A50,083695,Saad; Andrew S,12,0,30,18
1657523637208,ECE 65,A51,095125,Saad; Andrew S,24,0,26,2
1657523643233,ECE 109,A01,091882,Touri; Behrouz,19,0,70,51
1657523649261,ECE 180,A00,083140,Abi Samra; Nicholas Camill,1,0,30,29
1657523649261,ECE 180,B00,083141,Abi Samra; Nicholas Camill,0,0,30,30
1657523655287,MATH 10A,A01,083735,Patchell; Gregory David,2,0,30,28
1657523655287,MATH 10A,A02,083736,Patchell; Gregory David,20,0,30,10
1657523655287,MATH 10A,A03,083737,Patchell; Gregory David,16,0,30,14
1657523661316,MATH 10B,A01,083207,Lim; Seonhee,8,0,34,26
1657523661316,MATH 10B,A02,083208,Lim; Seonhee,9,0,35,26
1657523661316,MATH 10B,A03,093472,Lim; Seonhee,7,0,34,27
1657523661316,MATH 10B,B01,083739,Sinha; Shubham,12,0,30,18
1657523667348,MATH 18,A01,083743,Cinel; Cameron Alexander,7,0,30,23
1657523667348,MATH 18,A02,083744,Cinel; Cameron Alexander,17,0,30,13
1657523667348,MATH 18,A03,083745,Cinel; Cameron Alexander,9,0,30,21
1657523667348,MATH 18,B01,083748,Rideout; David Porter,5,0,37,32
1657523667348,MATH 18,B02,083749,Rideout; David Porter,5,0,36,31
1657523667348,MATH 18,B03,083750,Rideout; David Porter,3,0,37,34
1657523667348,MATH 18,B04,083751,Rideout; David Porter,6,0,36,30
1657523667348,MATH 18,B05,093473,Rideout; David Porter,6,0,36,30
1657523667348,MATH 18,B06,093474,Rideout; David Porter,6,0,36,30
1657523673371,MATH 20A,A01,083754,Zheng; Zequn,14,0,40,26
1657523679400,MATH 20B,A01,083756,Briones; Jor-el Thomas Caparas,4,0,36,32
1657523679400,MATH 20B,A02,083757,Briones; Jor-el Thomas Caparas,1,0,36,35
1657523679400,MATH 20B,A03,093475,Briones; Jor-el Thomas Caparas,2,0,36,34
1657523685422,MATH 20C,A01,083760,Briones; Jor-el Thomas Caparas,1,0,35,34
1657523685422,MATH 20C,A02,083761,Briones; Jor-el Thomas Caparas,8,0,35,27
1657523685422,MATH 20C,A03,093476,Briones; Jor-el Thomas Caparas,0,1,36,36
1657523685422,MATH 20C,B01,083762,Bach; Quang Tran,1,0,30,29
1657523691454,MATH 20D,A01,083765,Tran; Brian Kha,5,0,30,25
1657523691454,MATH 20D,A02,083766,Tran; Brian Kha,5,0,30,25
1657523691454,MATH 20D,A03,083767,Tran; Brian Kha,5,0,30,25
1657523697477,MATH 20E,A01,083771,Ganguly; Soumya,9,0,32,23
1657523697477,MATH 20E,A02,083772,Ganguly; Soumya,6,0,32,26
1657523697477,MATH 20E,B01,083773,Ciotti; Benjamin,20,0,35,15
1657523697477,MATH 20E,B02,083774,Ciotti; Benjamin,17,0,35,18
1657523703508,MATH 103A,A01,083777,Greenfeld; Be'Eri,3,0,36,33
1657523703508,MATH 103A,A02,083778,Greenfeld; Be'Eri,5,0,36,31
1657523703508,MATH 103A,A03,093561,Greenfeld; Be'Eri,5,0,36,31
1657523703508,MATH 103A,B01,083779,Greenfeld; Be'Eri,7,0,36,29
1657523703508,MATH 103A,B02,083780,Greenfeld; Be'Eri,4,0,36,32
1657523703508,MATH 103A,B03,093562,Greenfeld; Be'Eri,3,0,36,33
1657523709540,MATH 105,A01,085443,Carter; Anne Toulson,15,0,35,20
1657523709540,MATH 105,A02,093477,Carter; Anne Toulson,20,0,35,15
1657523715570,MATH 109,A01,083213,Ganzberger; Geoffrey Michael,2,0,34,32
1657523715570,MATH 109,A02,083214,Ganzberger; Geoffrey Michael,4,0,34,30
1657523715570,MATH 109,A03,093478,Ganzberger; Geoffrey Michael,2,0,34,32
1657523715570,MATH 109,B01,083215,Ganzberger; Geoffrey Michael,1,0,32,31
1657523715570,MATH 109,B02,083216,Ganzberger; Geoffrey Michael,2,0,32,30
1657523715570,MATH 109,B03,093479,Ganzberger; Geoffrey Michael,8,0,32,24
1657523721602,MATH 142A,A01,083219,Chow; Bennett,7,0,32,25
1657523721602,MATH 142A,A02,083220,Chow; Bennett,10,0,32,22
1657523721602,MATH 142A,A03,093480,Chow; Bennett,8,0,32,24
1657523721602,MATH 142A,B03,093481,Chow; Bennett,8,0,32,24
1657523721602,MATH 142A,B04,093558,Chow; Bennett,13,0,32,19
1657523721602,MATH 142A,B05,093559,Chow; Bennett,6,0,32,26
1657523727632,MATH 193A,A01,083224,Rotar; Vladimir,8,0,34,26
1657523727632,MATH 193A,A02,083225,Rotar; Vladimir,9,0,34,25
1657523727632,MATH 193A,A03,083781,Rotar; Vladimir,5,0,34,29
1657523727632,MATH 193A,A04,083782,Rotar; Vladimir,10,0,34,24
1657523727632,MATH 193A,A05,093482,Rotar; Vladimir,10,0,34,24
1657523733659,MATH 197,001,091859,McAuley; Julian John,9999,0,9999,0
1657523733659,MATH 197,002,095566,Kedlaya; Kiran S.,9997,0,9999,2
1657523733659,MATH 197,003,095567,Xiao; Ming,9999,0,9999,0
1657523733659,MATH 197,004,095571,Perols; Johan Lars,9998,0,9999,1
1657523740731,COGS 9,A01,083615,Shannon; Kyle Michael,9,0,75,66
1657523746760,COGS 11,A01,083617,Boyle; Mary E. T.,22,0,48,26
1657523752788,COGS 13,A01,083071,Bastos; Amalia Pinkusfeld,11,0,71,60
1657523758811,COGS 14A,A01,092681,Semenuks; Arturs,5,1,100,95
1657523764834,COGS 14B,A01,083073,Cheng; Tzu-Han,6,0,63,57
1657523770857,COGS 17,A01,092677,Semenuks; Arturs,6,0,81,75
1657523776880,COGS 100,A01,083619,Allen; Michael Gordon,17,0,70,53
1657523782908,COGS 101A,A01,083621,Davis; Joshua Daniel,9,0,68,59
1657523788936,COGS 101B,A01,091572,Allen; Michael Gordon,12,0,65,53
1657523794965,COGS 101C,A01,083625,Delgado; Tania,17,0,35,18
1657523800992,COGS 107A,A01,083627,Boyle; Mary E. T.,13,0,60,47
1657523807020,COGS 118A,A01,083075,Gupta; Anjum,21,0,76,55
1657523813048,CSE 3,A50,083646,Miranda; Gregory Joseph,24,0,50,26
1657523819076,CSE 8A,A50,083650,Miranda; Gregory Joseph,17,1,56,39
1657523825103,CSE 11,A01,083080,Cao; Yingjun,6,15,40,34
1657523831126,CSE 12,A01,083652,Krause-Levy; Sophia Louisa,28,1,120,92
1657523837155,CSE 15L,A01,083654,Morris; Justin Loren,9,0,50,41
1657523837155,CSE 15L,A02,083655,Morris; Justin Loren,9,0,50,41
1657523843180,CSE 20,A01,083657,Tran; Khoa Dang,39,0,80,41
1657523849204,CSE 21,A01,095574,Bach; Quang Tran,22,0,48,26
1657523855242,CSE 30,A01,083084,Eldon; John,5,0,80,75
1657523855242,CSE 30,B01,095061,Bhaskar; Nishant,9,0,50,41
1657523861269,CSE 100,A01,083659,Cao; Yingjun,5,4,70,65
1657523867293,CSE 134B,A01,083661,Powell; Thomas Allan,22,0,100,78
1657523873321,CSE 140,A01,083663,Gungor; Onat,15,0,85,70
1657523879347,CSE 140L,A01,083088,Eldon; John,21,0,100,79
1657523885373,CSE 175,A01,083665,Kumar; Rakesh,3,0,25,22
1657523891396,CSE 190,A00,092507,Dubnov; Shlomo,8,0,20,12
1657523897426,ECE 45,A01,083139,Congero; Spencer William,6,0,75,69
1657523903465,ECE 65,A50,083695,Saad; Andrew S,12,0,30,18
1657523903465,ECE 65,A51,095125,Saad; Andrew S,24,0,26,2
1657523909491,ECE 109,A01,091882,Touri; Behrouz,19,0,70,51
1657523915519,ECE 180,A00,083140,Abi Samra; Nicholas Camill,1,0,30,29
1657523915519,ECE 180,B00,083141,Abi Samra; Nicholas Camill,0,0,30,30
1657523921542,MATH 10A,A01,083735,Patchell; Gregory David,2,0,30,28
1657523921542,MATH 10A,A02,083736,Patchell; Gregory David,20,0,30,10
1657523921542,MATH 10A,A03,083737,Patchell; Gregory David,16,0,30,14
1657523927565,MATH 10B,A01,083207,Lim; Seonhee,8,0,34,26
1657523927565,MATH 10B,A02,083208,Lim; Seonhee,9,0,35,26
1657523927565,MATH 10B,A03,093472,Lim; Seonhee,7,0,34,27
1657523927565,MATH 10B,B01,083739,Sinha; Shubham,12,0,30,18
1657523933592,MATH 18,A01,083743,Cinel; Cameron Alexander,7,0,30,23
1657523933592,MATH 18,A02,083744,Cinel; Cameron Alexander,17,0,30,13
1657523933592,MATH 18,A03,083745,Cinel; Cameron Alexander,9,0,30,21
1657523933592,MATH 18,B01,083748,Rideout; David Porter,5,0,37,32
1657523933592,MATH 18,B02,083749,Rideout; David Porter,5,0,36,31
1657523933592,MATH 18,B03,083750,Rideout; David Porter,3,0,37,34
1657523933592,MATH 18,B04,083751,Rideout; David Porter,6,0,36,30
1657523933592,MATH 18,B05,093473,Rideout; David Porter,6,0,36,30
1657523933592,MATH 18,B06,093474,Rideout; David Porter,6,0,36,30
1657523939619,MATH 20A,A01,083754,Zheng; Zequn,14,0,40,26
1657523945642,MATH 20B,A01,083756,Briones; Jor-el Thomas Caparas,4,0,36,32
1657523945642,MATH 20B,A02,083757,Briones; Jor-el Thomas Caparas,1,0,36,35
1657523945642,MATH 20B,A03,093475,Briones; Jor-el Thomas Caparas,2,0,36,34
1657523951664,MATH 20C,A01,083760,Briones; Jor-el Thomas Caparas,1,0,35,34
1657523951664,MATH 20C,A02,083761,Briones; Jor-el Thomas Caparas,8,0,35,27
1657523951664,MATH 20C,A03,093476,Briones; Jor-el Thomas Caparas,0,1,36,36
1657523951664,MATH 20C,B01,083762,Bach; Quang Tran,1,0,30,29
1657523957688,MATH 20D,A01,083765,Tran; Brian Kha,5,0,30,25
1657523957688,MATH 20D,A02,083766,Tran; Brian Kha,5,0,30,25
1657523957688,MATH 20D,A03,083767,Tran; Brian Kha,5,0,30,25
1657523963718,MATH 20E,A01,083771,Ganguly; Soumya,9,0,32,23
1657523963718,MATH 20E,A02,083772,Ganguly; Soumya,6,0,32,26
1657523963718,MATH 20E,B01,083773,Ciotti; Benjamin,20,0,35,15
1657523963718,MATH 20E,B02,083774,Ciotti; Benjamin,17,0,35,18
1657523969748,MATH 103A,A01,083777,Greenfeld; Be'Eri,3,0,36,33
1657523969748,MATH 103A,A02,083778,Greenfeld; Be'Eri,5,0,36,31
1657523969748,MATH 103A,A03,093561,Greenfeld; Be'Eri,5,0,36,31
1657523969748,MATH 103A,B01,083779,Greenfeld; Be'Eri,7,0,36,29
1657523969748,MATH 103A,B02,083780,Greenfeld; Be'Eri,4,0,36,32
1657523969748,MATH 103A,B03,093562,Greenfeld; Be'Eri,3,0,36,33
1657523975771,MATH 105,A01,085443,Carter; Anne Toulson,15,0,35,20
1657523975771,MATH 105,A02,093477,Carter; Anne Toulson,20,0,35,15
1657523981803,MATH 109,A01,083213,Ganzberger; Geoffrey Michael,2,0,34,32
1657523981803,MATH 109,A02,083214,Ganzberger; Geoffrey Michael,4,0,34,30
1657523981803,MATH 109,A03,093478,Ganzberger; Geoffrey Michael,2,0,34,32
1657523981803,MATH 109,B01,083215,Ganzberger; Geoffrey Michael,1,0,32,31
1657523981803,MATH 109,B02,083216,Ganzberger; Geoffrey Michael,2,0,32,30
1657523981803,MATH 109,B03,093479,Ganzberger; Geoffrey Michael,8,0,32,24
1657523987829,MATH 142A,A01,083219,Chow; Bennett,7,0,32,25
1657523987829,MATH 142A,A02,083220,Chow; Bennett,10,0,32,22
1657523987829,MATH 142A,A03,093480,Chow; Bennett,8,0,32,24
1657523987829,MATH 142A,B03,093481,Chow; Bennett,8,0,32,24
1657523987829,MATH 142A,B04,093558,Chow; Bennett,13,0,32,19
1657523987829,MATH 142A,B05,093559,Chow; Bennett,6,0,32,26
1657523993853,MATH 193A,A01,083224,Rotar; Vladimir,8,0,34,26
1657523993853,MATH 193A,A02,083225,Rotar; Vladimir,9,0,34,25
1657523993853,MATH 193A,A03,083781,Rotar; Vladimir,5,0,34,29
1657523993853,MATH 193A,A04,083782,Rotar; Vladimir,10,0,34,24
1657523993853,MATH 193A,A05,093482,Rotar; Vladimir,10,0,34,24
1657523999876,MATH 197,001,091859,McAuley; Julian John,9999,0,9999,0
1657523999876,MATH 197,002,095566,Kedlaya; Kiran S.,9997,0,9999,2
1657523999876,MATH 197,003,095567,Xiao; Ming,9999,0,9999,0
1657523999876,MATH 197,004,095571,Perols; Johan Lars,9998,0,9999,1
1657524006943,COGS 9,A01,083615,Shannon; Kyle Michael,9,0,75,66
1657524012970,COGS 11,A01,083617,Boyle; Mary E. T.,22,0,48,26
1657524018996,COGS 13,A01,083071,Bastos; Amalia Pinkusfeld,11,0,71,60
1657524025027,COGS 14A,A01,092681,Semenuks; Arturs,5,1,100,95
1657524031061,COGS 14B,A01,083073,Cheng; Tzu-Han,6,0,63,57
1657524037093,COGS 17,A01,092677,Semenuks; Arturs,6,0,81,75
1657524043118,COGS 100,A01,083619,Allen; Michael Gordon,17,0,70,53
1657524049141,COGS 101A,A01,083621,Davis; Joshua Daniel,9,0,68,59
1657524055172,COGS 101B,A01,091572,Allen; Michael Gordon,12,0,65,53
1657524061196,COGS 101C,A01,083625,Delgado; Tania,17,0,35,18
1657524067223,COGS 107A,A01,083627,Boyle; Mary E. T.,13,0,60,47
1657524073323,COGS 118A,A01,083075,Gupta; Anjum,21,0,76,55
1657524079370,CSE 3,A50,083646,Miranda; Gregory Joseph,24,0,50,26
1657524085393,CSE 8A,A50,083650,Miranda; Gregory Joseph,17,1,56,39
1657524091416,CSE 11,A01,083080,Cao; Yingjun,6,15,40,34
1657524097443,CSE 12,A01,083652,Krause-Levy; Sophia Louisa,28,1,120,92
1657524103471,CSE 15L,A01,083654,Morris; Justin Loren,9,0,50,41
1657524103471,CSE 15L,A02,083655,Morris; Justin Loren,9,0,50,41
1657524109498,CSE 20,A01,083657,Tran; Khoa Dang,39,0,80,41
1657524115526,CSE 21,A01,095574,Bach; Quang Tran,22,0,48,26
1657524121556,CSE 30,A01,083084,Eldon; John,5,0,80,75
1657524121556,CSE 30,B01,095061,Bhaskar; Nishant,9,0,50,41
1657524127579,CSE 100,A01,083659,Cao; Yingjun,5,4,70,65
1657524133606,CSE 134B,A01,083661,Powell; Thomas Allan,22,0,100,78
1657524139634,CSE 140,A01,083663,Gungor; Onat,15,0,85,70
1657524145658,CSE 140L,A01,083088,Eldon; John,21,0,100,79
1657524151687,CSE 175,A01,083665,Kumar; Rakesh,3,0,25,22
1657524157708,CSE 190,A00,092507,Dubnov; Shlomo,8,0,20,12
1657524163735,ECE 45,A01,083139,Congero; Spencer William,6,0,75,69
1657524169756,ECE 65,A50,083695,Saad; Andrew S,12,0,30,18
1657524169756,ECE 65,A51,095125,Saad; Andrew S,24,0,26,2
1657524175778,ECE 109,A01,091882,Touri; Behrouz,19,0,70,51
1657524181814,ECE 180,A00,083140,Abi Samra; Nicholas Camill,1,0,30,29
1657524181814,ECE 180,B00,083141,Abi Samra; Nicholas Camill,0,0,30,30
1657524187841,MATH 10A,A01,083735,Patchell; Gregory David,2,0,30,28
1657524187841,MATH 10A,A02,083736,Patchell; Gregory David,20,0,30,10
1657524187841,MATH 10A,A03,083737,Patchell; Gregory David,16,0,30,14
1657524193871,MATH 10B,A01,083207,Lim; Seonhee,8,0,34,26
1657524193871,MATH 10B,A02,083208,Lim; Seonhee,9,0,35,26
1657524193871,MATH 10B,A03,093472,Lim; Seonhee,7,0,34,27
1657524193871,MATH 10B,B01,083739,Sinha; Shubham,12,0,30,18
1657524199900,MATH 18,A01,083743,Cinel; Cameron Alexander,7,0,30,23
1657524199900,MATH 18,A02,083744,Cinel; Cameron Alexander,17,0,30,13
1657524199900,MATH 18,A03,083745,Cinel; Cameron Alexander,9,0,30,21
1657524199900,MATH 18,B01,083748,Rideout; David Porter,5,0,37,32
1657524199900,MATH 18,B02,083749,Rideout; David Porter,5,0,36,31
1657524199900,MATH 18,B03,083750,Rideout; David Porter,3,0,37,34
1657524199900,MATH 18,B04,083751,Rideout; David Porter,6,0,36,30
1657524199900,MATH 18,B05,093473,Rideout; David Porter,6,0,36,30
1657524199900,MATH 18,B06,093474,Rideout; David Porter,6,0,36,30
1657524205926,MATH 20A,A01,083754,Zheng; Zequn,14,0,40,26
1657524211954,MATH 20B,A01,083756,Briones; Jor-el Thomas Caparas,4,0,36,32
1657524211954,MATH 20B,A02,083757,Briones; Jor-el Thomas Caparas,1,0,36,35
1657524211954,MATH 20B,A03,093475,Briones; Jor-el Thomas Caparas,2,0,36,34
1657524217987,MATH 20C,A01,083760,Briones; Jor-el Thomas Caparas,1,0,35,34
1657524217987,MATH 20C,A02,083761,Briones; Jor-el Thomas Caparas,8,0,35,27
1657524217987,MATH 20C,A03,093476,Briones; Jor-el Thomas Caparas,0,1,36,36
1657524217987,MATH 20C,B01,083762,Bach; Quang Tran,1,0,30,29
1657524224014,MATH 20D,A01,083765,Tran; Brian Kha,5,0,30,25
1657524224014,MATH 20D,A02,083766,Tran; Brian Kha,5,0,30,25
1657524224014,MATH 20D,A03,083767,Tran; Brian Kha,5,0,30,25
1657524230061,MATH 20E,A01,083771,Ganguly; Soumya,9,0,32,23
1657524230061,MATH 20E,A02,083772,Ganguly; Soumya,6,0,32,26
1657524230061,MATH 20E,B01,083773,Ciotti; Benjamin,20,0,35,15
1657524230061,MATH 20E,B02,083774,Ciotti; Benjamin,17,0,35,18
1657524236091,MATH 103A,A01,083777,Greenfeld; Be'Eri,3,0,36,33
1657524236091,MATH 103A,A02,083778,Greenfeld; Be'Eri,5,0,36,31
1657524236091,MATH 103A,A03,093561,Greenfeld; Be'Eri,5,0,36,31
1657524236091,MATH 103A,B01,083779,Greenfeld; Be'Eri,7,0,36,29
1657524236091,MATH 103A,B02,083780,Greenfeld; Be'Eri,4,0,36,32
1657524236091,MATH 103A,B03,093562,Greenfeld; Be'Eri,3,0,36,33
1657524242115,MATH 105,A01,085443,Carter; Anne Toulson,15,0,35,20
1657524242115,MATH 105,A02,093477,Carter; Anne Toulson,20,0,35,15
1657524248144,MATH 109,A01,083213,Ganzberger; Geoffrey Michael,2,0,34,32
1657524248144,MATH 109,A02,083214,Ganzberger; Geoffrey Michael,4,0,34,30
1657524248144,MATH 109,A03,093478,Ganzberger; Geoffrey Michael,2,0,34,32
1657524248144,MATH 109,B01,083215,Ganzberger; Geoffrey Michael,1,0,32,31
1657524248144,MATH 109,B02,083216,Ganzberger; Geoffrey Michael,2,0,32,30
1657524248144,MATH 109,B03,093479,Ganzberger; Geoffrey Michael,8,0,32,24
1657524254168,MATH 142A,A01,083219,Chow; Bennett,7,0,32,25
1657524254168,MATH 142A,A02,083220,Chow; Bennett,10,0,32,22
1657524254168,MATH 142A,A03,093480,Chow; Bennett,8,0,32,24
1657524254168,MATH 142A,B03,093481,Chow; Bennett,8,0,32,24
1657524254168,MATH 142A,B04,093558,Chow; Bennett,13,0,32,19
1657524254168,MATH 142A,B05,093559,Chow; Bennett,6,0,32,26
1657524260192,MATH 193A,A01,083224,Rotar; Vladimir,8,0,34,26
1657524260192,MATH 193A,A02,083225,Rotar; Vladimir,9,0,34,25
1657524260192,MATH 193A,A03,083781,Rotar; Vladimir,5,0,34,29
1657524260192,MATH 193A,A04,083782,Rotar; Vladimir,10,0,34,24
1657524260192,MATH 193A,A05,093482,Rotar; Vladimir,10,0,34,24
1657524266215,MATH 197,001,091859,McAuley; Julian John,9999,0,9999,0
1657524266215,MATH 197,002,095566,Kedlaya; Kiran S.,9997,0,9999,2
1657524266215,MATH 197,003,095567,Xiao; Ming,9999,0,9999,0
1657524266215,MATH 197,004,095571,Perols; Johan Lars,9998,0,9999,1
1657524273279,COGS 9,A01,083615,Shannon; Kyle Michael,9,0,75,66
1657524279306,COGS 11,A01,083617,Boyle; Mary E. T.,22,0,48,26
1657524285327,COGS 13,A01,083071,Bastos; Amalia Pinkusfeld,11,0,71,60
1657524291351,COGS 14A,A01,092681,Semenuks; Arturs,5,1,100,95
1657524297372,COGS 14B,A01,083073,Cheng; Tzu-Han,6,0,63,57
1657524303398,COGS 17,A01,092677,Semenuks; Arturs,6,0,81,75
1657524309421,COGS 100,A01,083619,Allen; Michael Gordon,17,0,70,53
1657524315451,COGS 101A,A01,083621,Davis; Joshua Daniel,9,0,68,59
1657524321476,COGS 101B,A01,091572,Allen; Michael Gordon,12,0,65,53
1657524327500,COGS 101C,A01,083625,Delgado; Tania,17,0,35,18
1657524333523,COGS 107A,A01,083627,Boyle; Mary E. T.,13,0,60,47
1657524339545,COGS 118A,A01,083075,Gupta; Anjum,21,0,76,55
1657524345570,CSE 3,A50,083646,Miranda; Gregory Joseph,24,0,50,26
1657524351598,CSE 8A,A50,083650,Miranda; Gregory Joseph,17,1,56,39
1657524357622,CSE 11,A01,083080,Cao; Yingjun,6,15,40,34
1657524363645,CSE 12,A01,083652,Krause-Levy; Sophia Louisa,28,1,120,92
1657524369677,CSE 15L,A01,083654,Morris; Justin Loren,9,0,50,41
1657524369677,CSE 15L,A02,083655,Morris; Justin Loren,9,0,50,41
1657524375702,CSE 20,A01,083657,Tran; Khoa Dang,39,0,80,41
1657524381726,CSE 21,A01,095574,Bach; Quang Tran,22,0,48,26
1657524387750,CSE 30,A01,083084,Eldon; John,5,0,80,75
1657524387750,CSE 30,B01,095061,Bhaskar; Nishant,9,0,50,41
1657524393781,CSE 100,A01,083659,Cao; Yingjun,5,4,70,65
1657524399807,CSE 134B,A01,083661,Powell; Thomas Allan,22,0,100,78
1657524405833,CSE 140,A01,083663,Gungor; Onat,15,0,85,70
1657524411861,CSE 140L,A01,083088,Eldon; John,21,0,100,79
1657524417884,CSE 175,A01,083665,Kumar; Rakesh,3,0,25,22
1657524423908,CSE 190,A00,092507,Dubnov; Shlomo,8,0,20,12
1657524429947,ECE 45,A01,083139,Congero; Spencer William,6,0,75,69
1657524435976,ECE 65,A50,083695,Saad; Andrew S,12,0,30,18
1657524435976,ECE 65,A51,095125,Saad; Andrew S,24,0,26,2
1657524442000,ECE 109,A01,091882,Touri; Behrouz,19,0,70,51
1657524448032,ECE 180,A00,083140,Abi Samra; Nicholas Camill,1,0,30,29
1657524448032,ECE 180,B00,083141,Abi Samra; Nicholas Camill,0,0,30,30
1657524454055,MATH 10A,A01,083735,Patchell; Gregory David,2,0,30,28
1657524454055,MATH 10A,A02,083736,Patchell; Gregory David,20,0,30,10
1657524454055,MATH 10A,A03,083737,Patchell; Gregory David,16,0,30,14
1657524460083,MATH 10B,A01,083207,Lim; Seonhee,8,0,34,26
1657524460083,MATH 10B,A02,083208,Lim; Seonhee,9,0,35,26
1657524460083,MATH 10B,A03,093472,Lim; Seonhee,7,0,34,27
1657524460083,MATH 10B,B01,083739,Sinha; Shubham,12,0,30,18
1657524466116,MATH 18,A01,083743,Cinel; Cameron Alexander,7,0,30,23
1657524466116,MATH 18,A02,083744,Cinel; Cameron Alexander,17,0,30,13
1657524466116,MATH 18,A03,083745,Cinel; Cameron Alexander,9,0,30,21
1657524466116,MATH 18,B01,083748,Rideout; David Porter,5,0,37,32
1657524466116,MATH 18,B02,083749,Rideout; David Porter,5,0,36,31
1657524466116,MATH 18,B03,083750,Rideout; David Porter,3,0,37,34
1657524466116,MATH 18,B04,083751,Rideout; David Porter,6,0,36,30
1657524466116,MATH 18,B05,093473,Rideout; David Porter,6,0,36,30
1657524466116,MATH 18,B06,093474,Rideout; David Porter,6,0,36,30
1657524472140,MATH 20A,A01,083754,Zheng; Zequn,14,0,40,26
1657524478163,MATH 20B,A01,083756,Briones; Jor-el Thomas Caparas,4,0,36,32
1657524478163,MATH 20B,A02,083757,Briones; Jor-el Thomas Caparas,1,0,36,35
1657524478163,MATH 20B,A03,093475,Briones; Jor-el Thomas Caparas,2,0,36,34
1657524484188,MATH 20C,A01,083760,Briones; Jor-el Thomas Caparas,1,0,35,34
1657524484188,MATH 20C,A02,083761,Briones; Jor-el Thomas Caparas,8,0,35,27
1657524484188,MATH 20C,A03,093476,Briones; Jor-el Thomas Caparas,0,1,36,36
1657524484188,MATH 20C,B01,083762,Bach; Quang Tran,1,0,30,29
1657524490216,MATH 20D,A01,083765,Tran; Brian Kha,5,0,30,25
1657524490216,MATH 20D,A02,083766,Tran; Brian Kha,5,0,30,25
1657524490216,MATH 20D,A03,083767,Tran; Brian Kha,5,0,30,25
1657524496245,MATH 20E,A01,083771,Ganguly; Soumya,9,0,32,23
1657524496245,MATH 20E,A02,083772,Ganguly; Soumya,6,0,32,26
1657524496245,MATH 20E,B01,083773,Ciotti; Benjamin,20,0,35,15
1657524496245,MATH 20E,B02,083774,Ciotti; Benjamin,17,0,35,18
1657524502268,MATH 103A,A01,083777,Greenfeld; Be'Eri,3,0,36,33
1657524502268,MATH 103A,A02,083778,Greenfeld; Be'Eri,5,0,36,31
1657524502268,MATH 103A,A03,093561,Greenfeld; Be'Eri,5,0,36,31
1657524502268,MATH 103A,B01,083779,Greenfeld; Be'Eri,7,0,36,29
1657524502268,MATH 103A,B02,083780,Greenfeld; Be'Eri,4,0,36,32
1657524502268,MATH 103A,B03,093562,Greenfeld; Be'Eri,3,0,36,33
1657524508293,MATH 105,A01,085443,Carter; Anne Toulson,15,0,35,20
1657524508293,MATH 105,A02,093477,Carter; Anne Toulson,20,0,35,15
1657524514322,MATH 109,A01,083213,Ganzberger; Geoffrey Michael,2,0,34,32
1657524514322,MATH 109,A02,083214,Ganzberger; Geoffrey Michael,4,0,34,30
1657524514322,MATH 109,A03,093478,Ganzberger; Geoffrey Michael,2,0,34,32
1657524514322,MATH 109,B01,083215,Ganzberger; Geoffrey Michael,1,0,32,31
1657524514322,MATH 109,B02,083216,Ganzberger; Geoffrey Michael,2,0,32,30
1657524514322,MATH 109,B03,093479,Ganzberger; Geoffrey Michael,8,0,32,24
1657524520349,MATH 142A,A01,083219,Chow; Bennett,7,0,32,25
1657524520349,MATH 142A,A02,083220,Chow; Bennett,10,0,32,22
1657524520349,MATH 142A,A03,093480,Chow; Bennett,8,0,32,24
1657524520349,MATH 142A,B03,093481,Chow; Bennett,8,0,32,24
1657524520349,MATH 142A,B04,093558,Chow; Bennett,13,0,32,19
1657524520349,MATH 142A,B05,093559,Chow; Bennett,6,0,32,26
1657524526387,MATH 193A,A01,083224,Rotar; Vladimir,8,0,34,26
1657524526387,MATH 193A,A02,083225,Rotar; Vladimir,9,0,34,25
1657524526387,MATH 193A,A03,083781,Rotar; Vladimir,5,0,34,29
1657524526387,MATH 193A,A04,083782,Rotar; Vladimir,10,0,34,24
1657524526387,MATH 193A,A05,093482,Rotar; Vladimir,10,0,34,24
1657524532409,MATH 197,001,091859,McAuley; Julian John,9999,0,9999,0
1657524532409,MATH 197,002,095566,Kedlaya; Kiran S.,9997,0,9999,2
1657524532409,MATH 197,003,095567,Xiao; Ming,9999,0,9999,0
1657524532409,MATH 197,004,095571,Perols; Johan Lars,9998,0,9999,1
1657524539470,COGS 9,A01,083615,Shannon; Kyle Michael,9,0,75,66
1657524545492,COGS 11,A01,083617,Boyle; Mary E. T.,22,0,48,26
1657524551514,COGS 13,A01,083071,Bastos; Amalia Pinkusfeld,11,0,71,60
1657524557542,COGS 14A,A01,092681,Semenuks; Arturs,5,1,100,95
1657524563565,COGS 14B,A01,083073,Cheng; Tzu-Han,6,0,63,57
1657524569592,COGS 17,A01,092677,Semenuks; Arturs,6,0,81,75
1657524575615,COGS 100,A01,083619,Allen; Michael Gordon,17,0,70,53
1657524581641,COGS 101A,A01,083621,Davis; Joshua Daniel,9,0,68,59
1657524587665,COGS 101B,A01,091572,Allen; Michael Gordon,12,0,65,53
1657524593701,COGS 101C,A01,083625,Delgado; Tania,17,0,35,18
1657524599739,COGS 107A,A01,083627,Boyle; Mary E. T.,13,0,60,47
1657524605766,COGS 118A,A01,083075,Gupta; Anjum,21,0,76,55
1657524611797,CSE 3,A50,083646,Miranda; Gregory Joseph,24,0,50,26
1657524617828,CSE 8A,A50,083650,Miranda; Gregory Joseph,17,1,56,39
1657524623854,CSE 11,A01,083080,Cao; Yingjun,6,15,40,34
1657524629877,CSE 12,A01,083652,Krause-Levy; Sophia Louisa,28,1,120,92
1657524635904,CSE 15L,A01,083654,Morris; Justin Loren,9,0,50,41
1657524635904,CSE 15L,A02,083655,Morris; Justin Loren,9,0,50,41
1657524641929,CSE 20,A01,083657,Tran; Khoa Dang,39,0,80,41
1657524647957,CSE 21,A01,095574,Bach; Quang Tran,22,0,48,26
1657524653984,CSE 30,A01,083084,Eldon; John,5,0,80,75
1657524653984,CSE 30,B01,095061,Bhaskar; Nishant,9,0,50,41
1657524660006,CSE 100,A01,083659,Cao; Yingjun,5,4,70,65
1657524666032,CSE 134B,A01,083661,Powell; Thomas Allan,22,0,100,78
1657524672138,CSE 140,A01,083663,Gungor; Onat,15,0,85,70
1657524678163,CSE 140L,A01,083088,Eldon; John,21,0,100,79
1657524684189,CSE 175,A01,083665,Kumar; Rakesh,3,0,25,22
1657524690216,CSE 190,A00,092507,Dubnov; Shlomo,8,0,20,12
1657524696240,ECE 45,A01,083139,Congero; Spencer William,6,0,75,69
1657524702266,ECE 65,A50,083695,Saad; Andrew S,12,0,30,18
1657524702266,ECE 65,A51,095125,Saad; Andrew S,24,0,26,2
1657524708289,ECE 109,A01,091882,Touri; Behrouz,19,0,70,51
1657524714312,ECE 180,A00,083140,Abi Samra; Nicholas Camill,1,0,30,29
1657524714312,ECE 180,B00,083141,Abi Samra; Nicholas Camill,0,0,30,30
1657524720340,MATH 10A,A01,083735,Patchell; Gregory David,2,0,30,28
1657524720340,MATH 10A,A02,083736,Patchell; Gregory David,20,0,30,10
1657524720340,MATH 10A,A03,083737,Patchell; Gregory David,16,0,30,14
1657524726362,MATH 10B,A01,083207,Lim; Seonhee,8,0,34,26
1657524726362,MATH 10B,A02,083208,Lim; Seonhee,9,0,35,26
1657524726362,MATH 10B,A03,093472,Lim; Seonhee,7,0,34,27
1657524726362,MATH 10B,B01,083739,Sinha; Shubham,12,0,30,18
1657524732400,MATH 18,A01,083743,Cinel; Cameron Alexander,7,0,30,23
1657524732400,MATH 18,A02,083744,Cinel; Cameron Alexander,17,0,30,13
1657524732400,MATH 18,A03,083745,Cinel; Cameron Alexander,9,0,30,21
1657524732400,MATH 18,B01,083748,Rideout; David Porter,5,0,37,32
1657524732400,MATH 18,B02,083749,Rideout; David Porter,5,0,36,31
1657524732400,MATH 18,B03,083750,Rideout; David Porter,3,0,37,34
1657524732400,MATH 18,B04,083751,Rideout; David Porter,6,0,36,30
1657524732400,MATH 18,B05,093473,Rideout; David Porter,6,0,36,30
1657524732400,MATH 18,B06,093474,Rideout; David Porter,6,0,36,30
1657524738426,MATH 20A,A01,083754,Zheng; Zequn,14,0,40,26
1657524744453,MATH 20B,A01,083756,Briones; Jor-el Thomas Caparas,4,0,36,32
1657524744453,MATH 20B,A02,083757,Briones; Jor-el Thomas Caparas,1,0,36,35
1657524744453,MATH 20B,A03,093475,Briones; Jor-el Thomas Caparas,2,0,36,34
1657524750476,MATH 20C,A01,083760,Briones; Jor-el Thomas Caparas,1,0,35,34
1657524750476,MATH 20C,A02,083761,Briones; Jor-el Thomas Caparas,8,0,35,27
1657524750476,MATH 20C,A03,093476,Briones; Jor-el Thomas Caparas,0,1,36,36
1657524750476,MATH 20C,B01,083762,Bach; Quang Tran,1,0,30,29
1657524756506,MATH 20D,A01,083765,Tran; Brian Kha,5,0,30,25
1657524756506,MATH 20D,A02,083766,Tran; Brian Kha,5,0,30,25
1657524756506,MATH 20D,A03,083767,Tran; Brian Kha,5,0,30,25
1657524762530,MATH 20E,A01,083771,Ganguly; Soumya,9,0,32,23
1657524762530,MATH 20E,A02,083772,Ganguly; Soumya,6,0,32,26
1657524762530,MATH 20E,B01,083773,Ciotti; Benjamin,20,0,35,15
1657524762530,MATH 20E,B02,083774,Ciotti; Benjamin,17,0,35,18
1657524768560,MATH 103A,A01,083777,Greenfeld; Be'Eri,3,0,36,33
1657524768560,MATH 103A,A02,083778,Greenfeld; Be'Eri,5,0,36,31
1657524768560,MATH 103A,A03,093561,Greenfeld; Be'Eri,5,0,36,31
1657524768560,MATH 103A,B01,083779,Greenfeld; Be'Eri,7,0,36,29
1657524768560,MATH 103A,B02,083780,Greenfeld; Be'Eri,4,0,36,32
1657524768560,MATH 103A,B03,093562,Greenfeld; Be'Eri,3,0,36,33
1657524774583,MATH 105,A01,085443,Carter; Anne Toulson,15,0,35,20
1657524774583,MATH 105,A02,093477,Carter; Anne Toulson,20,0,35,15
1657524780605,MATH 109,A01,083213,Ganzberger; Geoffrey Michael,2,0,34,32
1657524780605,MATH 109,A02,083214,Ganzberger; Geoffrey Michael,4,0,34,30
1657524780605,MATH 109,A03,093478,Ganzberger; Geoffrey Michael,2,0,34,32
1657524780605,MATH 109,B01,083215,Ganzberger; Geoffrey Michael,1,0,32,31
1657524780605,MATH 109,B02,083216,Ganzberger; Geoffrey Michael,2,0,32,30
1657524780605,MATH 109,B03,093479,Ganzberger; Geoffrey Michael,8,0,32,24
1657524786635,MATH 142A,A01,083219,Chow; Bennett,7,0,32,25
1657524786635,MATH 142A,A02,083220,Chow; Bennett,10,0,32,22
1657524786635,MATH 142A,A03,093480,Chow; Bennett,8,0,32,24
1657524786635,MATH 142A,B03,093481,Chow; Bennett,8,0,32,24
1657524786635,MATH 142A,B04,093558,Chow; Bennett,13,0,32,19
1657524786635,MATH 142A,B05,093559,Chow; Bennett,6,0,32,26
1657524792668,MATH 193A,A01,083224,Rotar; Vladimir,8,0,34,26
1657524792668,MATH 193A,A02,083225,Rotar; Vladimir,9,0,34,25
1657524792668,MATH 193A,A03,083781,Rotar; Vladimir,5,0,34,29
1657524792668,MATH 193A,A04,083782,Rotar; Vladimir,10,0,34,24
1657524792668,MATH 193A,A05,093482,Rotar; Vladimir,10,0,34,24
1657524798697,MATH 197,001,091859,McAuley; Julian John,9999,0,9999,0
1657524798697,MATH 197,002,095566,Kedlaya; Kiran S.,9997,0,9999,2
1657524798697,MATH 197,003,095567,Xiao; Ming,9999,0,9999,0
1657524798697,MATH 197,004,095571,Perols; Johan Lars,9998,0,9999,1
1657524805819,COGS 9,A01,083615,Shannon; Kyle Michael,9,0,75,66
1657524811847,COGS 11,A01,083617,Boyle; Mary E. T.,22,0,48,26
1657524817872,COGS 13,A01,083071,Bastos; Amalia Pinkusfeld,11,0,71,60
1657524823898,COGS 14A,A01,092681,Semenuks; Arturs,5,1,100,95
1657524829926,COGS 14B,A01,083073,Cheng; Tzu-Han,6,0,63,57
1657524835950,COGS 17,A01,092677,Semenuks; Arturs,6,0,81,75
1657524841978,COGS 100,A01,083619,Allen; Michael Gordon,17,0,70,53
1657524848009,COGS 101A,A01,083621,Davis; Joshua Daniel,9,0,68,59
1657524854035,COGS 101B,A01,091572,Allen; Michael Gordon,12,0,65,53
1657524860063,COGS 101C,A01,083625,Delgado; Tania,17,0,35,18
1657524866085,COGS 107A,A01,083627,Boyle; Mary E. T.,13,0,60,47
1657524872111,COGS 118A,A01,083075,Gupta; Anjum,21,0,76,55
1657524878134,CSE 3,A50,083646,Miranda; Gregory Joseph,24,0,50,26
1657524884157,CSE 8A,A50,083650,Miranda; Gregory Joseph,17,1,56,39
1657524890186,CSE 11,A01,083080,Cao; Yingjun,6,15,40,34
1657524896209,CSE 12,A01,083652,Krause-Levy; Sophia Louisa,28,1,120,92
1657524902233,CSE 15L,A01,083654,Morris; Justin Loren,9,0,50,41
1657524902233,CSE 15L,A02,083655,Morris; Justin Loren,9,0,50,41
1657524908256,CSE 20,A01,083657,Tran; Khoa Dang,39,0,80,41
1657524914278,CSE 21,A01,095574,Bach; Quang Tran,22,0,48,26
1657524920303,CSE 30,A01,083084,Eldon; John,5,0,80,75
1657524920303,CSE 30,B01,095061,Bhaskar; Nishant,9,0,50,41
1657524926331,CSE 100,A01,083659,Cao; Yingjun,5,4,70,65
1657524932358,CSE 134B,A01,083661,Powell; Thomas Allan,22,0,100,78
1657524938382,CSE 140,A01,083663,Gungor; Onat,15,0,85,70
1657524944410,CSE 140L,A01,083088,Eldon; John,21,0,100,79
1657524950433,CSE 175,A01,083665,Kumar; Rakesh,3,0,25,22
1657524956462,CSE 190,A00,092507,Dubnov; Shlomo,8,0,20,12
1657524962487,ECE 45,A01,083139,Congero; Spencer William,6,0,75,69
1657524968512,ECE 65,A50,083695,Saad; Andrew S,12,0,30,18
1657524968512,ECE 65,A51,095125,Saad; Andrew S,24,0,26,2
1657524974557,ECE 109,A01,091882,Touri; Behrouz,19,0,70,51
1657524980584,ECE 180,A00,083140,Abi Samra; Nicholas Camill,1,0,30,29
1657524980584,ECE 180,B00,083141,Abi Samra; Nicholas Camill,0,0,30,30
1657524986612,MATH 10A,A01,083735,Patchell; Gregory David,2,0,30,28
1657524986612,MATH 10A,A02,083736,Patchell; Gregory David,20,0,30,10
1657524986612,MATH 10A,A03,083737,Patchell; Gregory David,16,0,30,14
1657524992636,MATH 10B,A01,083207,Lim; Seonhee,8,0,34,26
1657524992636,MATH 10B,A02,083208,Lim; Seonhee,9,0,35,26
1657524992636,MATH 10B,A03,093472,Lim; Seonhee,7,0,34,27
1657524992636,MATH 10B,B01,083739,Sinha; Shubham,12,0,30,18
1657524998660,MATH 18,A01,083743,Cinel; Cameron Alexander,7,0,30,23
1657524998660,MATH 18,A02,083744,Cinel; Cameron Alexander,17,0,30,13
1657524998660,MATH 18,A03,083745,Cinel; Cameron Alexander,9,0,30,21
1657524998660,MATH 18,B01,083748,Rideout; David Porter,5,0,37,32
1657524998660,MATH 18,B02,083749,Rideout; David Porter,5,0,36,31
1657524998660,MATH 18,B03,083750,Rideout; David Porter,3,0,37,34
1657524998660,MATH 18,B04,083751,Rideout; David Porter,6,0,36,30
1657524998660,MATH 18,B05,093473,Rideout; David Porter,6,0,36,30
1657524998660,MATH 18,B06,093474,Rideout; David Porter,6,0,36,30
1657525004685,MATH 20A,A01,083754,Zheng; Zequn,14,0,40,26
1657525010712,MATH 20B,A01,083756,Briones; Jor-el Thomas Caparas,4,0,36,32
1657525010712,MATH 20B,A02,083757,Briones; Jor-el Thomas Caparas,1,0,36,35
1657525010712,MATH 20B,A03,093475,Briones; Jor-el Thomas Caparas,2,0,36,34
1657525016740,MATH 20C,A01,083760,Briones; Jor-el Thomas Caparas,1,0,35,34
1657525016740,MATH 20C,A02,083761,Briones; Jor-el Thomas Caparas,8,0,35,27
1657525016740,MATH 20C,A03,093476,Briones; Jor-el Thomas Caparas,0,1,36,36
1657525016740,MATH 20C,B01,083762,Bach; Quang Tran,1,0,30,29
1657525022773,MATH 20D,A01,083765,Tran; Brian Kha,5,0,30,25
1657525022773,MATH 20D,A02,083766,Tran; Brian Kha,5,0,30,25
1657525022773,MATH 20D,A03,083767,Tran; Brian Kha,5,0,30,25
1657525028804,MATH 20E,A01,083771,Ganguly; Soumya,9,0,32,23
1657525028804,MATH 20E,A02,083772,Ganguly; Soumya,6,0,32,26
1657525028804,MATH 20E,B01,083773,Ciotti; Benjamin,20,0,35,15
1657525028804,MATH 20E,B02,083774,Ciotti; Benjamin,17,0,35,18
1657525034835,MATH 103A,A01,083777,Greenfeld; Be'Eri,3,0,36,33
1657525034835,MATH 103A,A02,083778,Greenfeld; Be'Eri,5,0,36,31
1657525034835,MATH 103A,A03,093561,Greenfeld; Be'Eri,5,0,36,31
1657525034835,MATH 103A,B01,083779,Greenfeld; Be'Eri,7,0,36,29
1657525034835,MATH 103A,B02,083780,Greenfeld; Be'Eri,4,0,36,32
1657525034835,MATH 103A,B03,093562,Greenfeld; Be'Eri,3,0,36,33
1657525040865,MATH 105,A01,085443,Carter; Anne Toulson,15,0,35,20
1657525040865,MATH 105,A02,093477,Carter; Anne Toulson,20,0,35,15
1657525046896,MATH 109,A01,083213,Ganzberger; Geoffrey Michael,2,0,34,32
1657525046896,MATH 109,A02,083214,Ganzberger; Geoffrey Michael,4,0,34,30
1657525046896,MATH 109,A03,093478,Ganzberger; Geoffrey Michael,2,0,34,32
1657525046896,MATH 109,B01,083215,Ganzberger; Geoffrey Michael,1,0,32,31
1657525046896,MATH 109,B02,083216,Ganzberger; Geoffrey Michael,2,0,32,30
1657525046896,MATH 109,B03,093479,Ganzberger; Geoffrey Michael,8,0,32,24
1657525052919,MATH 142A,A01,083219,Chow; Bennett,7,0,32,25
1657525052919,MATH 142A,A02,083220,Chow; Bennett,10,0,32,22
1657525052919,MATH 142A,A03,093480,Chow; Bennett,8,0,32,24
1657525052919,MATH 142A,B03,093481,Chow; Bennett,8,0,32,24
1657525052919,MATH 142A,B04,093558,Chow; Bennett,13,0,32,19
1657525052919,MATH 142A,B05,093559,Chow; Bennett,6,0,32,26
1657525058943,MATH 193A,A01,083224,Rotar; Vladimir,8,0,34,26
1657525058943,MATH 193A,A02,083225,Rotar; Vladimir,9,0,34,25
1657525058943,MATH 193A,A03,083781,Rotar; Vladimir,5,0,34,29
1657525058943,MATH 193A,A04,083782,Rotar; Vladimir,10,0,34,24
1657525058943,MATH 193A,A05,093482,Rotar; Vladimir,10,0,34,24
1657525064965,MATH 197,001,091859,McAuley; Julian John,9999,0,9999,0
1657525064965,MATH 197,002,095566,Kedlaya; Kiran S.,9997,0,9999,2
1657525064965,MATH 197,003,095567,Xiao; Ming,9999,0,9999,0
1657525064965,MATH 197,004,095571,Perols; Johan Lars,9998,0,9999,1
1657525072025,COGS 9,A01,083615,Shannon; Kyle Michael,9,0,75,66
1657525078049,COGS 11,A01,083617,Boyle; Mary E. T.,22,0,48,26
1657525084072,COGS 13,A01,083071,Bastos; Amalia Pinkusfeld,11,0,71,60
1657525090099,COGS 14A,A01,092681,Semenuks; Arturs,5,1,100,95
1657525096121,COGS 14B,A01,083073,Cheng; Tzu-Han,6,0,63,57
1657525102143,COGS 17,A01,092677,Semenuks; Arturs,6,0,81,75
1657525108172,COGS 100,A01,083619,Allen; Michael Gordon,17,0,70,53
1657525114198,COGS 101A,A01,083621,Davis; Joshua Daniel,9,0,68,59
1657525120224,COGS 101B,A01,091572,Allen; Michael Gordon,12,0,65,53
1657525126251,COGS 101C,A01,083625,Delgado; Tania,17,0,35,18
1657525132278,COGS 107A,A01,083627,Boyle; Mary E. T.,13,0,60,47
1657525138301,COGS 118A,A01,083075,Gupta; Anjum,21,0,76,55
1657525144331,CSE 3,A50,083646,Miranda; Gregory Joseph,24,0,50,26
1657525150358,CSE 8A,A50,083650,Miranda; Gregory Joseph,17,1,56,39
1657525156382,CSE 11,A01,083080,Cao; Yingjun,6,15,40,34
1657525162404,CSE 12,A01,083652,Krause-Levy; Sophia Louisa,28,1,120,92
1657525168430,CSE 15L,A01,083654,Morris; Justin Loren,9,0,50,41
1657525168430,CSE 15L,A02,083655,Morris; Justin Loren,9,0,50,41
1657525174460,CSE 20,A01,083657,Tran; Khoa Dang,39,0,80,41
1657525180482,CSE 21,A01,095574,Bach; Quang Tran,22,0,48,26
1657525186505,CSE 30,A01,083084,Eldon; John,5,0,80,75
1657525186505,CSE 30,B01,095061,Bhaskar; Nishant,9,0,50,41
1657525192532,CSE 100,A01,083659,Cao; Yingjun,5,4,70,65
1657525198559,CSE 134B,A01,083661,Powell; Thomas Allan,22,0,100,78
1657525204591,CSE 140,A01,083663,Gungor; Onat,15,0,85,70
1657525210622,CSE 140L,A01,083088,Eldon; John,21,0,100,79
1657525216648,CSE 175,A01,083665,Kumar; Rakesh,3,0,25,22
1657525222674,CSE 190,A00,092507,Dubnov; Shlomo,8,0,20,12
1657525228706,ECE 45,A01,083139,Congero; Spencer William,6,0,75,69
1657525234733,ECE 65,A50,083695,Saad; Andrew S,12,0,30,18
1657525234733,ECE 65,A51,095125,Saad; Andrew S,24,0,26,2
1657525240762,ECE 109,A01,091882,Touri; Behrouz,19,0,70,51
1657525246784,ECE 180,A00,083140,Abi Samra; Nicholas Camill,1,0,30,29
1657525246784,ECE 180,B00,083141,Abi Samra; Nicholas Camill,0,0,30,30
1657525252811,MATH 10A,A01,083735,Patchell; Gregory David,2,0,30,28
1657525252811,MATH 10A,A02,083736,Patchell; Gregory David,20,0,30,10
1657525252811,MATH 10A,A03,083737,Patchell; Gregory David,16,0,30,14
1657525258840,MATH 10B,A01,083207,Lim; Seonhee,8,0,34,26
1657525258840,MATH 10B,A02,083208,Lim; Seonhee,9,0,35,26
1657525258840,MATH 10B,A03,093472,Lim; Seonhee,7,0,34,27
1657525258840,MATH 10B,B01,083739,Sinha; Shubham,12,0,30,18
1657525264867,MATH 18,A01,083743,Cinel; Cameron Alexander,7,0,30,23
1657525264867,MATH 18,A02,083744,Cinel; Cameron Alexander,17,0,30,13
1657525264867,MATH 18,A03,083745,Cinel; Cameron Alexander,9,0,30,21
1657525264867,MATH 18,B01,083748,Rideout; David Porter,5,0,37,32
1657525264867,MATH 18,B02,083749,Rideout; David Porter,5,0,36,31
1657525264867,MATH 18,B03,083750,Rideout; David Porter,3,0,37,34
1657525264867,MATH 18,B04,083751,Rideout; David Porter,6,0,36,30
1657525264867,MATH 18,B05,093473,Rideout; David Porter,6,0,36,30
1657525264867,MATH 18,B06,093474,Rideout; David Porter,6,0,36,30
1657525270981,MATH 20A,A01,083754,Zheng; Zequn,14,0,40,26
1657525277019,MATH 20B,A01,083756,Briones; Jor-el Thomas Caparas,4,0,36,32
1657525277019,MATH 20B,A02,083757,Briones; Jor-el Thomas Caparas,1,0,36,35
1657525277019,MATH 20B,A03,093475,Briones; Jor-el Thomas Caparas,2,0,36,34
1657525283041,MATH 20C,A01,083760,Briones; Jor-el Thomas Caparas,1,0,35,34
1657525283041,MATH 20C,A02,083761,Briones; Jor-el Thomas Caparas,8,0,35,27
1657525283041,MATH 20C,A03,093476,Briones; Jor-el Thomas Caparas,0,1,36,36
1657525283041,MATH 20C,B01,083762,Bach; Quang Tran,1,0,30,29
1657525289065,MATH 20D,A01,083765,Tran; Brian Kha,5,0,30,25
1657525289065,MATH 20D,A02,083766,Tran; Brian Kha,5,0,30,25
1657525289065,MATH 20D,A03,083767,Tran; Brian Kha,5,0,30,25
1657525295088,MATH 20E,A01,083771,Ganguly; Soumya,9,0,32,23
1657525295088,MATH 20E,A02,083772,Ganguly; Soumya,6,0,32,26
1657525295088,MATH 20E,B01,083773,Ciotti; Benjamin,20,0,35,15
1657525295088,MATH 20E,B02,083774,Ciotti; Benjamin,17,0,35,18
1657525301113,MATH 103A,A01,083777,Greenfeld; Be'Eri,3,0,36,33
1657525301113,MATH 103A,A02,083778,Greenfeld; Be'Eri,5,0,36,31
1657525301113,MATH 103A,A03,093561,Greenfeld; Be'Eri,5,0,36,31
1657525301113,MATH 103A,B01,083779,Greenfeld; Be'Eri,7,0,36,29
1657525301113,MATH 103A,B02,083780,Greenfeld; Be'Eri,4,0,36,32
1657525301113,MATH 103A,B03,093562,Greenfeld; Be'Eri,3,0,36,33
1657525307135,MATH 105,A01,085443,Carter; Anne Toulson,15,0,35,20
1657525307135,MATH 105,A02,093477,Carter; Anne Toulson,20,0,35,15
1657525313164,MATH 109,A01,083213,Ganzberger; Geoffrey Michael,2,0,34,32
1657525313164,MATH 109,A02,083214,Ganzberger; Geoffrey Michael,4,0,34,30
1657525313164,MATH 109,A03,093478,Ganzberger; Geoffrey Michael,2,0,34,32
1657525313164,MATH 109,B01,083215,Ganzberger; Geoffrey Michael,1,0,32,31
1657525313164,MATH 109,B02,083216,Ganzberger; Geoffrey Michael,2,0,32,30
1657525313164,MATH 109,B03,093479,Ganzberger; Geoffrey Michael,8,0,32,24
1657525319192,MATH 142A,A01,083219,Chow; Bennett,7,0,32,25
1657525319192,MATH 142A,A02,083220,Chow; Bennett,10,0,32,22
1657525319192,MATH 142A,A03,093480,Chow; Bennett,8,0,32,24
1657525319192,MATH 142A,B03,093481,Chow; Bennett,8,0,32,24
1657525319192,MATH 142A,B04,093558,Chow; Bennett,13,0,32,19
1657525319192,MATH 142A,B05,093559,Chow; Bennett,6,0,32,26
1657525325221,MATH 193A,A01,083224,Rotar; Vladimir,8,0,34,26
1657525325221,MATH 193A,A02,083225,Rotar; Vladimir,9,0,34,25
1657525325221,MATH 193A,A03,083781,Rotar; Vladimir,5,0,34,29
1657525325221,MATH 193A,A04,083782,Rotar; Vladimir,10,0,34,24
1657525325221,MATH 193A,A05,093482,Rotar; Vladimir,10,0,34,24
1657525331243,MATH 197,001,091859,McAuley; Julian John,9999,0,9999,0
1657525331243,MATH 197,002,095566,Kedlaya; Kiran S.,9997,0,9999,2
1657525331243,MATH 197,003,095567,Xiao; Ming,9999,0,9999,0
1657525331243,MATH 197,004,095571,Perols; Johan Lars,9998,0,9999,1
1657525338294,COGS 9,A01,083615,Shannon; Kyle Michael,9,0,75,66
1657525344316,COGS 11,A01,083617,Boyle; Mary E. T.,22,0,48,26
1657525350342,COGS 13,A01,083071,Bastos; Amalia Pinkusfeld,11,0,71,60
1657525356369,COGS 14A,A01,092681,Semenuks; Arturs,5,1,100,95
1657525362395,COGS 14B,A01,083073,Cheng; Tzu-Han,6,0,63,57
1657525368422,COGS 17,A01,092677,Semenuks; Arturs,6,0,81,75
1657525374448,COGS 100,A01,083619,Allen; Michael Gordon,17,0,70,53
1657525380482,COGS 101A,A01,083621,Davis; Joshua Daniel,9,0,68,59
1657525386513,COGS 101B,A01,091572,Allen; Michael Gordon,12,0,65,53
1657525392539,COGS 101C,A01,083625,Delgado; Tania,17,0,35,18
1657525398562,COGS 107A,A01,083627,Boyle; Mary E. T.,13,0,60,47
1657525404587,COGS 118A,A01,083075,Gupta; Anjum,21,0,76,55
1657525410612,CSE 3,A50,083646,Miranda; Gregory Joseph,24,0,50,26
1657525416634,CSE 8A,A50,083650,Miranda; Gregory Joseph,17,1,56,39
1657525422657,CSE 11,A01,083080,Cao; Yingjun,6,15,40,34
1657525428682,CSE 12,A01,083652,Krause-Levy; Sophia Louisa,28,1,120,92
1657525434710,CSE 15L,A01,083654,Morris; Justin Loren,9,0,50,41
1657525434710,CSE 15L,A02,083655,Morris; Justin Loren,9,0,50,41
1657525440738,CSE 20,A01,083657,Tran; Khoa Dang,39,0,80,41
1657525446765,CSE 21,A01,095574,Bach; Quang Tran,22,0,48,26
1657525452793,CSE 30,A01,083084,Eldon; John,5,0,80,75
1657525452793,CSE 30,B01,095061,Bhaskar; Nishant,9,0,50,41
1657525458819,CSE 100,A01,083659,Cao; Yingjun,5,4,70,65
1657525464844,CSE 134B,A01,083661,Powell; Thomas Allan,22,0,100,78
1657525470870,CSE 140,A01,083663,Gungor; Onat,15,0,85,70
1657525476895,CSE 140L,A01,083088,Eldon; John,21,0,100,79
1657525482920,CSE 175,A01,083665,Kumar; Rakesh,3,0,25,22
1657525488945,CSE 190,A00,092507,Dubnov; Shlomo,8,0,20,12
1657525494973,ECE 45,A01,083139,Congero; Spencer William,6,0,75,69
1657525500996,ECE 65,A50,083695,Saad; Andrew S,12,0,30,18
1657525500996,ECE 65,A51,095125,Saad; Andrew S,24,0,26,2
1657525507019,ECE 109,A01,091882,Touri; Behrouz,19,0,70,51
1657525513044,ECE 180,A00,083140,Abi Samra; Nicholas Camill,1,0,30,29
1657525513044,ECE 180,B00,083141,Abi Samra; Nicholas Camill,0,0,30,30
1657525519068,MATH 10A,A01,083735,Patchell; Gregory David,2,0,30,28
1657525519068,MATH 10A,A02,083736,Patchell; Gregory David,20,0,30,10
1657525519068,MATH 10A,A03,083737,Patchell; Gregory David,16,0,30,14
1657525525093,MATH 10B,A01,083207,Lim; Seonhee,8,0,34,26
1657525525093,MATH 10B,A02,083208,Lim; Seonhee,9,0,35,26
1657525525093,MATH 10B,A03,093472,Lim; Seonhee,7,0,34,27
1657525525093,MATH 10B,B01,083739,Sinha; Shubham,12,0,30,18
1657525531126,MATH 18,A01,083743,Cinel; Cameron Alexander,7,0,30,23
1657525531126,MATH 18,A02,083744,Cinel; Cameron Alexander,17,0,30,13
1657525531126,MATH 18,A03,083745,Cinel; Cameron Alexander,9,0,30,21
1657525531126,MATH 18,B01,083748,Rideout; David Porter,5,0,37,32
1657525531126,MATH 18,B02,083749,Rideout; David Porter,5,0,36,31
1657525531126,MATH 18,B03,083750,Rideout; David Porter,3,0,37,34
1657525531126,MATH 18,B04,083751,Rideout; David Porter,6,0,36,30
1657525531126,MATH 18,B05,093473,Rideout; David Porter,6,0,36,30
1657525531126,MATH 18,B06,093474,Rideout; David Porter,6,0,36,30
1657525537150,MATH 20A,A01,083754,Zheng; Zequn,14,0,40,26
1657525543177,MATH 20B,A01,083756,Briones; Jor-el Thomas Caparas,4,0,36,32
1657525543177,MATH 20B,A02,083757,Briones; Jor-el Thomas Caparas,1,0,36,35
1657525543177,MATH 20B,A03,093475,Briones; Jor-el Thomas Caparas,2,0,36,34
1657525549200,MATH 20C,A01,083760,Briones; Jor-el Thomas Caparas,1,0,35,34
1657525549200,MATH 20C,A02,083761,Briones; Jor-el Thomas Caparas,8,0,35,27
1657525549200,MATH 20C,A03,093476,Briones; Jor-el Thomas Caparas,0,1,36,36
1657525549200,MATH 20C,B01,083762,Bach; Quang Tran,1,0,30,29
1657525555224,MATH 20D,A01,083765,Tran; Brian Kha,5,0,30,25
1657525555224,MATH 20D,A02,083766,Tran; Brian Kha,5,0,30,25
1657525555224,MATH 20D,A03,083767,Tran; Brian Kha,5,0,30,25
1657525561252,MATH 20E,A01,083771,Ganguly; Soumya,9,0,32,23
1657525561252,MATH 20E,A02,083772,Ganguly; Soumya,6,0,32,26
1657525561252,MATH 20E,B01,083773,Ciotti; Benjamin,20,0,35,15
1657525561252,MATH 20E,B02,083774,Ciotti; Benjamin,17,0,35,18
1657525567276,MATH 103A,A01,083777,Greenfeld; Be'Eri,3,0,36,33
1657525567276,MATH 103A,A02,083778,Greenfeld; Be'Eri,5,0,36,31
1657525567276,MATH 103A,A03,093561,Greenfeld; Be'Eri,5,0,36,31
1657525567276,MATH 103A,B01,083779,Greenfeld; Be'Eri,7,0,36,29
1657525567276,MATH 103A,B02,083780,Greenfeld; Be'Eri,4,0,36,32
1657525567276,MATH 103A,B03,093562,Greenfeld; Be'Eri,3,0,36,33
1657525573301,MATH 105,A01,085443,Carter; Anne Toulson,15,0,35,20
1657525573301,MATH 105,A02,093477,Carter; Anne Toulson,20,0,35,15
1657525579325,MATH 109,A01,083213,Ganzberger; Geoffrey Michael,2,0,34,32
1657525579325,MATH 109,A02,083214,Ganzberger; Geoffrey Michael,4,0,34,30
1657525579325,MATH 109,A03,093478,Ganzberger; Geoffrey Michael,2,0,34,32
1657525579325,MATH 109,B01,083215,Ganzberger; Geoffrey Michael,1,0,32,31
1657525579325,MATH 109,B02,083216,Ganzberger; Geoffrey Michael,2,0,32,30
1657525579325,MATH 109,B03,093479,Ganzberger; Geoffrey Michael,8,0,32,24
1657525585348,MATH 142A,A01,083219,Chow; Bennett,7,0,32,25
1657525585348,MATH 142A,A02,083220,Chow; Bennett,10,0,32,22
1657525585348,MATH 142A,A03,093480,Chow; Bennett,8,0,32,24
1657525585348,MATH 142A,B03,093481,Chow; Bennett,8,0,32,24
1657525585348,MATH 142A,B04,093558,Chow; Bennett,13,0,32,19
1657525585348,MATH 142A,B05,093559,Chow; Bennett,6,0,32,26
1657525591378,MATH 193A,A01,083224,Rotar; Vladimir,8,0,34,26
1657525591378,MATH 193A,A02,083225,Rotar; Vladimir,9,0,34,25
1657525591378,MATH 193A,A03,083781,Rotar; Vladimir,5,0,34,29
1657525591378,MATH 193A,A04,083782,Rotar; Vladimir,10,0,34,24
1657525591378,MATH 193A,A05,093482,Rotar; Vladimir,10,0,34,24
1657525597404,MATH 197,001,091859,McAuley; Julian John,9999,0,9999,0
1657525597404,MATH 197,002,095566,Kedlaya; Kiran S.,9997,0,9999,2
1657525597404,MATH 197,003,095567,Xiao; Ming,9999,0,9999,0
1657525597404,MATH 197,004,095571,Perols; Johan Lars,9998,0,9999,1
1657525604468,COGS 9,A01,083615,Shannon; Kyle Michael,9,0,75,66
1657525610491,COGS 11,A01,083617,Boyle; Mary E. T.,22,0,48,26
1657525616514,COGS 13,A01,083071,Bastos; Amalia Pinkusfeld,11,0,71,60
1657525622543,COGS 14A,A01,092681,Semenuks; Arturs,5,1,100,95
1657525628570,COGS 14B,A01,083073,Cheng; Tzu-Han,6,0,63,57
1657525634601,COGS 17,A01,092677,Semenuks; Arturs,6,0,81,75
1657525640627,COGS 100,A01,083619,Allen; Michael Gordon,17,0,70,53
1657525646651,COGS 101A,A01,083621,Davis; Joshua Daniel,9,0,68,59
1657525652677,COGS 101B,A01,091572,Allen; Michael Gordon,12,0,65,53
1657525658705,COGS 101C,A01,083625,Delgado; Tania,17,0,35,18
1657525664729,COGS 107A,A01,083627,Boyle; Mary E. T.,13,0,60,47
1657525670752,COGS 118A,A01,083075,Gupta; Anjum,21,0,76,55
1657525676784,CSE 3,A50,083646,Miranda; Gregory Joseph,24,0,50,26
1657525682808,CSE 8A,A50,083650,Miranda; Gregory Joseph,17,1,56,39
1657525688836,CSE 11,A01,083080,Cao; Yingjun,6,15,40,34
1657525694860,CSE 12,A01,083652,Krause-Levy; Sophia Louisa,28,1,120,92
1657525700885,CSE 15L,A01,083654,Morris; Justin Loren,9,0,50,41
1657525700885,CSE 15L,A02,083655,Morris; Justin Loren,9,0,50,41
1657525706912,CSE 20,A01,083657,Tran; Khoa Dang,39,0,80,41
1657525712946,CSE 21,A01,095574,Bach; Quang Tran,22,0,48,26
1657525718982,CSE 30,A01,083084,Eldon; John,5,0,80,75
1657525718982,CSE 30,B01,095061,Bhaskar; Nishant,9,0,50,41
1657525725010,CSE 100,A01,083659,Cao; Yingjun,5,4,70,65
1657525731035,CSE 134B,A01,083661,Powell; Thomas Allan,22,0,100,78
1657525737064,CSE 140,A01,083663,Gungor; Onat,15,0,85,70
1657525743089,CSE 140L,A01,083088,Eldon; John,21,0,100,79
1657525749114,CSE 175,A01,083665,Kumar; Rakesh,3,0,25,22
1657525755150,CSE 190,A00,092507,Dubnov; Shlomo,8,0,20,12
1657525761175,ECE 45,A01,083139,Congero; Spencer William,6,0,75,69
1657525767198,ECE 65,A50,083695,Saad; Andrew S,12,0,30,18
1657525767198,ECE 65,A51,095125,Saad; Andrew S,24,0,26,2
1657525773237,ECE 109,A01,091882,Touri; Behrouz,19,0,70,51
1657525779270,ECE 180,A00,083140,Abi Samra; Nicholas Camill,1,0,30,29
1657525779270,ECE 180,B00,083141,Abi Samra; Nicholas Camill,0,0,30,30
1657525785303,MATH 10A,A01,083735,Patchell; Gregory David,2,0,30,28
1657525785303,MATH 10A,A02,083736,Patchell; Gregory David,20,0,30,10
1657525785303,MATH 10A,A03,083737,Patchell; Gregory David,16,0,30,14
1657525791330,MATH 10B,A01,083207,Lim; Seonhee,8,0,34,26
1657525791330,MATH 10B,A02,083208,Lim; Seonhee,9,0,35,26
1657525791330,MATH 10B,A03,093472,Lim; Seonhee,7,0,34,27
1657525791330,MATH 10B,B01,083739,Sinha; Shubham,12,0,30,18
1657525797363,MATH 18,A01,083743,Cinel; Cameron Alexander,7,0,30,23
1657525797363,MATH 18,A02,083744,Cinel; Cameron Alexander,17,0,30,13
1657525797363,MATH 18,A03,083745,Cinel; Cameron Alexander,9,0,30,21
1657525797363,MATH 18,B01,083748,Rideout; David Porter,5,0,37,32
1657525797363,MATH 18,B02,083749,Rideout; David Porter,5,0,36,31
1657525797363,MATH 18,B03,083750,Rideout; David Porter,3,0,37,34
1657525797363,MATH 18,B04,083751,Rideout; David Porter,6,0,36,30
1657525797363,MATH 18,B05,093473,Rideout; David Porter,6,0,36,30
1657525797363,MATH 18,B06,093474,Rideout; David Porter,6,0,36,30
1657525803391,MATH 20A,A01,083754,Zheng; Zequn,14,0,40,26
1657525809419,MATH 20B,A01,083756,Briones; Jor-el Thomas Caparas,4,0,36,32
1657525809419,MATH 20B,A02,083757,Briones; Jor-el Thomas Caparas,1,0,36,35
1657525809419,MATH 20B,A03,093475,Briones; Jor-el Thomas Caparas,2,0,36,34
1657525815446,MATH 20C,A01,083760,Briones; Jor-el Thomas Caparas,1,0,35,34
1657525815446,MATH 20C,A02,083761,Briones; Jor-el Thomas Caparas,8,0,35,27
1657525815446,MATH 20C,A03,093476,Briones; Jor-el Thomas Caparas,0,1,36,36
1657525815446,MATH 20C,B01,083762,Bach; Quang Tran,1,0,30,29
1657525821473,MATH 20D,A01,083765,Tran; Brian Kha,5,0,30,25
1657525821473,MATH 20D,A02,083766,Tran; Brian Kha,5,0,30,25
1657525821473,MATH 20D,A03,083767,Tran; Brian Kha,5,0,30,25
1657525827498,MATH 20E,A01,083771,Ganguly; Soumya,9,0,32,23
1657525827498,MATH 20E,A02,083772,Ganguly; Soumya,6,0,32,26
1657525827498,MATH 20E,B01,083773,Ciotti; Benjamin,20,0,35,15
1657525827498,MATH 20E,B02,083774,Ciotti; Benjamin,17,0,35,18
1657525833524,MATH 103A,A01,083777,Greenfeld; Be'Eri,3,0,36,33
1657525833524,MATH 103A,A02,083778,Greenfeld; Be'Eri,5,0,36,31
1657525833524,MATH 103A,A03,093561,Greenfeld; Be'Eri,5,0,36,31
1657525833524,MATH 103A,B01,083779,Greenfeld; Be'Eri,7,0,36,29
1657525833524,MATH 103A,B02,083780,Greenfeld; Be'Eri,4,0,36,32
1657525833524,MATH 103A,B03,093562,Greenfeld; Be'Eri,3,0,36,33
1657525839551,MATH 105,A01,085443,Carter; Anne Toulson,15,0,35,20
1657525839551,MATH 105,A02,093477,Carter; Anne Toulson,20,0,35,15
1657525845578,MATH 109,A01,083213,Ganzberger; Geoffrey Michael,2,0,34,32
1657525845578,MATH 109,A02,083214,Ganzberger; Geoffrey Michael,4,0,34,30
1657525845578,MATH 109,A03,093478,Ganzberger; Geoffrey Michael,2,0,34,32
1657525845578,MATH 109,B01,083215,Ganzberger; Geoffrey Michael,1,0,32,31
1657525845578,MATH 109,B02,083216,Ganzberger; Geoffrey Michael,2,0,32,30
1657525845578,MATH 109,B03,093479,Ganzberger; Geoffrey Michael,8,0,32,24
1657525851612,MATH 142A,A01,083219,Chow; Bennett,7,0,32,25
1657525851612,MATH 142A,A02,083220,Chow; Bennett,10,0,32,22
1657525851612,MATH 142A,A03,093480,Chow; Bennett,8,0,32,24
1657525851612,MATH 142A,B03,093481,Chow; Bennett,8,0,32,24
1657525851612,MATH 142A,B04,093558,Chow; Bennett,13,0,32,19
1657525851612,MATH 142A,B05,093559,Chow; Bennett,6,0,32,26
1657525857636,MATH 193A,A01,083224,Rotar; Vladimir,8,0,34,26
1657525857636,MATH 193A,A02,083225,Rotar; Vladimir,9,0,34,25
1657525857636,MATH 193A,A03,083781,Rotar; Vladimir,5,0,34,29
1657525857636,MATH 193A,A04,083782,Rotar; Vladimir,10,0,34,24
1657525857636,MATH 193A,A05,093482,Rotar; Vladimir,10,0,34,24
1657525863664,MATH 197,001,091859,McAuley; Julian John,9999,0,9999,0
1657525863664,MATH 197,002,095566,Kedlaya; Kiran S.,9997,0,9999,2
1657525863664,MATH 197,003,095567,Xiao; Ming,9999,0,9999,0
1657525863664,MATH 197,004,095571,Perols; Johan Lars,9998,0,9999,1
1657525870803,COGS 9,A01,083615,Shannon; Kyle Michael,9,0,75,66
1657525876830,COGS 11,A01,083617,Boyle; Mary E. T.,22,0,48,26
1657525882857,COGS 13,A01,083071,Bastos; Amalia Pinkusfeld,11,0,71,60
1657525888880,COGS 14A,A01,092681,Semenuks; Arturs,5,1,100,95
1657525894905,COGS 14B,A01,083073,Cheng; Tzu-Han,6,0,63,57
1657525900929,COGS 17,A01,092677,Semenuks; Arturs,6,0,81,75
1657525906956,COGS 100,A01,083619,Allen; Michael Gordon,17,0,70,53
1657525912983,COGS 101A,A01,083621,Davis; Joshua Daniel,9,0,68,59
1657525919008,COGS 101B,A01,091572,Allen; Michael Gordon,12,0,65,53
1657525925035,COGS 101C,A01,083625,Delgado; Tania,17,0,35,18
1657525931059,COGS 107A,A01,083627,Boyle; Mary E. T.,13,0,60,47
1657525937087,COGS 118A,A01,083075,Gupta; Anjum,21,0,76,55
1657525943113,CSE 3,A50,083646,Miranda; Gregory Joseph,24,0,50,26
1657525949136,CSE 8A,A50,083650,Miranda; Gregory Joseph,17,1,56,39
1657525955159,CSE 11,A01,083080,Cao; Yingjun,6,15,40,34
1657525961183,CSE 12,A01,083652,Krause-Levy; Sophia Louisa,28,1,120,92
1657525967206,CSE 15L,A01,083654,Morris; Justin Loren,9,0,50,41
1657525967206,CSE 15L,A02,083655,Morris; Justin Loren,9,0,50,41
1657525973233,CSE 20,A01,083657,Tran; Khoa Dang,39,0,80,41
1657525979256,CSE 21,A01,095574,Bach; Quang Tran,22,0,48,26
1657525985282,CSE 30,A01,083084,Eldon; John,5,0,80,75
1657525985282,CSE 30,B01,095061,Bhaskar; Nishant,9,0,50,41
1657525991307,CSE 100,A01,083659,Cao; Yingjun,5,4,70,65
1657525997329,CSE 134B,A01,083661,Powell; Thomas Allan,22,0,100,78
1657526003357,CSE 140,A01,083663,Gungor; Onat,15,0,85,70
1657526009380,CSE 140L,A01,083088,Eldon; John,21,0,100,79
1657526015403,CSE 175,A01,083665,Kumar; Rakesh,3,0,25,22
1657526021429,CSE 190,A00,092507,Dubnov; Shlomo,8,0,20,12
1657526027453,ECE 45,A01,083139,Congero; Spencer William,6,0,75,69
1657526033477,ECE 65,A50,083695,Saad; Andrew S,12,0,30,18
1657526033477,ECE 65,A51,095125,Saad; Andrew S,24,0,26,2
1657526039498,ECE 109,A01,091882,Touri; Behrouz,19,0,70,51
1657526045526,ECE 180,A00,083140,Abi Samra; Nicholas Camill,1,0,30,29
1657526045526,ECE 180,B00,083141,Abi Samra; Nicholas Camill,0,0,30,30
1657526051550,MATH 10A,A01,083735,Patchell; Gregory David,2,0,30,28
1657526051550,MATH 10A,A02,083736,Patchell; Gregory David,20,0,30,10
1657526051550,MATH 10A,A03,083737,Patchell; Gregory David,16,0,30,14
1657526057580,MATH 10B,A01,083207,Lim; Seonhee,8,0,34,26
1657526057580,MATH 10B,A02,083208,Lim; Seonhee,9,0,35,26
1657526057580,MATH 10B,A03,093472,Lim; Seonhee,7,0,34,27
1657526057580,MATH 10B,B01,083739,Sinha; Shubham,12,0,30,18
1657526063606,MATH 18,A01,083743,Cinel; Cameron Alexander,7,0,30,23
1657526063606,MATH 18,A02,083744,Cinel; Cameron Alexander,17,0,30,13
1657526063606,MATH 18,A03,083745,Cinel; Cameron Alexander,9,0,30,21
1657526063606,MATH 18,B01,083748,Rideout; David Porter,5,0,37,32
1657526063606,MATH 18,B02,083749,Rideout; David Porter,5,0,36,31
1657526063606,MATH 18,B03,083750,Rideout; David Porter,3,0,37,34
1657526063606,MATH 18,B04,083751,Rideout; David Porter,6,0,36,30
1657526063606,MATH 18,B05,093473,Rideout; David Porter,6,0,36,30
1657526063606,MATH 18,B06,093474,Rideout; David Porter,6,0,36,30
1657526069629,MATH 20A,A01,083754,Zheng; Zequn,14,0,40,26
1657526075652,MATH 20B,A01,083756,Briones; Jor-el Thomas Caparas,4,0,36,32
1657526075652,MATH 20B,A02,083757,Briones; Jor-el Thomas Caparas,1,0,36,35
1657526075652,MATH 20B,A03,093475,Briones; Jor-el Thomas Caparas,2,0,36,34
1657526081695,MATH 20C,A01,083760,Briones; Jor-el Thomas Caparas,1,0,35,34
1657526081695,MATH 20C,A02,083761,Briones; Jor-el Thomas Caparas,8,0,35,27
1657526081695,MATH 20C,A03,093476,Briones; Jor-el Thomas Caparas,0,1,36,36
1657526081695,MATH 20C,B01,083762,Bach; Quang Tran,1,0,30,29
1657526087724,MATH 20D,A01,083765,Tran; Brian Kha,5,0,30,25
1657526087724,MATH 20D,A02,083766,Tran; Brian Kha,5,0,30,25
1657526087724,MATH 20D,A03,083767,Tran; Brian Kha,5,0,30,25
1657526093751,MATH 20E,A01,083771,Ganguly; Soumya,9,0,32,23
1657526093751,MATH 20E,A02,083772,Ganguly; Soumya,6,0,32,26
1657526093751,MATH 20E,B01,083773,Ciotti; Benjamin,20,0,35,15
1657526093751,MATH 20E,B02,083774,Ciotti; Benjamin,17,0,35,18
1657526099775,MATH 103A,A01,083777,Greenfeld; Be'Eri,3,0,36,33
1657526099775,MATH 103A,A02,083778,Greenfeld; Be'Eri,5,0,36,31
1657526099775,MATH 103A,A03,093561,Greenfeld; Be'Eri,5,0,36,31
1657526099775,MATH 103A,B01,083779,Greenfeld; Be'Eri,7,0,36,29
1657526099775,MATH 103A,B02,083780,Greenfeld; Be'Eri,4,0,36,32
1657526099775,MATH 103A,B03,093562,Greenfeld; Be'Eri,3,0,36,33
1657526105802,MATH 105,A01,085443,Carter; Anne Toulson,15,0,35,20
1657526105802,MATH 105,A02,093477,Carter; Anne Toulson,20,0,35,15
1657526111825,MATH 109,A01,083213,Ganzberger; Geoffrey Michael,2,0,34,32
1657526111825,MATH 109,A02,083214,Ganzberger; Geoffrey Michael,4,0,34,30
1657526111825,MATH 109,A03,093478,Ganzberger; Geoffrey Michael,2,0,34,32
1657526111825,MATH 109,B01,083215,Ganzberger; Geoffrey Michael,1,0,32,31
1657526111825,MATH 109,B02,083216,Ganzberger; Geoffrey Michael,2,0,32,30
1657526111825,MATH 109,B03,093479,Ganzberger; Geoffrey Michael,8,0,32,24
1657526117849,MATH 142A,A01,083219,Chow; Bennett,7,0,32,25
1657526117849,MATH 142A,A02,083220,Chow; Bennett,10,0,32,22
1657526117849,MATH 142A,A03,093480,Chow; Bennett,8,0,32,24
1657526117849,MATH 142A,B03,093481,Chow; Bennett,8,0,32,24
1657526117849,MATH 142A,B04,093558,Chow; Bennett,13,0,32,19
1657526117849,MATH 142A,B05,093559,Chow; Bennett,6,0,32,26
1657526123879,MATH 193A,A01,083224,Rotar; Vladimir,8,0,34,26
1657526123879,MATH 193A,A02,083225,Rotar; Vladimir,9,0,34,25
1657526123879,MATH 193A,A03,083781,Rotar; Vladimir,5,0,34,29
1657526123879,MATH 193A,A04,083782,Rotar; Vladimir,10,0,34,24
1657526123879,MATH 193A,A05,093482,Rotar; Vladimir,10,0,34,24
1657526129902,MATH 197,001,091859,McAuley; Julian John,9999,0,9999,0
1657526129902,MATH 197,002,095566,Kedlaya; Kiran S.,9997,0,9999,2
1657526129902,MATH 197,003,095567,Xiao; Ming,9999,0,9999,0
1657526129902,MATH 197,004,095571,Perols; Johan Lars,9998,0,9999,1
1657526136956,COGS 9,A01,083615,Shannon; Kyle Michael,9,0,75,66
1657526142978,COGS 11,A01,083617,Boyle; Mary E. T.,22,0,48,26
1657526149004,COGS 13,A01,083071,Bastos; Amalia Pinkusfeld,11,0,71,60
1657526155029,COGS 14A,A01,092681,Semenuks; Arturs,5,1,100,95
1657526161052,COGS 14B,A01,083073,Cheng; Tzu-Han,6,0,63,57
1657526167075,COGS 17,A01,092677,Semenuks; Arturs,6,0,81,75
1657526173103,COGS 100,A01,083619,Allen; Michael Gordon,17,0,70,53
1657526179132,COGS 101A,A01,083621,Davis; Joshua Daniel,9,0,68,59
1657526185159,COGS 101B,A01,091572,Allen; Michael Gordon,12,0,65,53
1657526191190,COGS 101C,A01,083625,Delgado; Tania,17,0,35,18
1657526197215,COGS 107A,A01,083627,Boyle; Mary E. T.,13,0,60,47
1657526203243,COGS 118A,A01,083075,Gupta; Anjum,21,0,76,55
1657526209267,CSE 3,A50,083646,Miranda; Gregory Joseph,24,0,50,26
1657526215291,CSE 8A,A50,083650,Miranda; Gregory Joseph,17,1,56,39
1657526221318,CSE 11,A01,083080,Cao; Yingjun,6,15,40,34
1657526227348,CSE 12,A01,083652,Krause-Levy; Sophia Louisa,28,1,120,92
1657526233373,CSE 15L,A01,083654,Morris; Justin Loren,9,0,50,41
1657526233373,CSE 15L,A02,083655,Morris; Justin Loren,9,0,50,41
1657526239403,CSE 20,A01,083657,Tran; Khoa Dang,39,0,80,41
1657526245426,CSE 21,A01,095574,Bach; Quang Tran,22,0,48,26
1657526251447,CSE 30,A01,083084,Eldon; John,5,0,80,75
1657526251447,CSE 30,B01,095061,Bhaskar; Nishant,9,0,50,41
1657526257473,CSE 100,A01,083659,Cao; Yingjun,5,4,70,65
1657526263497,CSE 134B,A01,083661,Powell; Thomas Allan,22,0,100,78
1657526269524,CSE 140,A01,083663,Gungor; Onat,15,0,85,70
1657526275551,CSE 140L,A01,083088,Eldon; John,21,0,100,79
1657526281578,CSE 175,A01,083665,Kumar; Rakesh,3,0,25,22
1657526287601,CSE 190,A00,092507,Dubnov; Shlomo,8,0,20,12
1657526293623,ECE 45,A01,083139,Congero; Spencer William,6,0,75,69
1657526299649,ECE 65,A50,083695,Saad; Andrew S,12,0,30,18
1657526299649,ECE 65,A51,095125,Saad; Andrew S,24,0,26,2
1657526305684,ECE 109,A01,091882,Touri; Behrouz,19,0,70,51
1657526311709,ECE 180,A00,083140,Abi Samra; Nicholas Camill,1,0,30,29
1657526311709,ECE 180,B00,083141,Abi Samra; Nicholas Camill,0,0,30,30
1657526317733,MATH 10A,A01,083735,Patchell; Gregory David,2,0,30,28
1657526317733,MATH 10A,A02,083736,Patchell; Gregory David,20,0,30,10
1657526317733,MATH 10A,A03,083737,Patchell; Gregory David,16,0,30,14
1657526323763,MATH 10B,A01,083207,Lim; Seonhee,8,0,34,26
1657526323763,MATH 10B,A02,083208,Lim; Seonhee,9,0,35,26
1657526323763,MATH 10B,A03,093472,Lim; Seonhee,7,0,34,27
1657526323763,MATH 10B,B01,083739,Sinha; Shubham,12,0,30,18
1657526329787,MATH 18,A01,083743,Cinel; Cameron Alexander,7,0,30,23
1657526329787,MATH 18,A02,083744,Cinel; Cameron Alexander,17,0,30,13
1657526329787,MATH 18,A03,083745,Cinel; Cameron Alexander,9,0,30,21
1657526329787,MATH 18,B01,083748,Rideout; David Porter,5,0,37,32
1657526329787,MATH 18,B02,083749,Rideout; David Porter,5,0,36,31
1657526329787,MATH 18,B03,083750,Rideout; David Porter,3,0,37,34
1657526329787,MATH 18,B04,083751,Rideout; David Porter,6,0,36,30
1657526329787,MATH 18,B05,093473,Rideout; David Porter,6,0,36,30
1657526329787,MATH 18,B06,093474,Rideout; David Porter,6,0,36,30
1657526335811,MATH 20A,A01,083754,Zheng; Zequn,14,0,40,26
1657526341840,MATH 20B,A01,083756,Briones; Jor-el Thomas Caparas,4,0,36,32
1657526341840,MATH 20B,A02,083757,Briones; Jor-el Thomas Caparas,1,0,36,35
1657526341840,MATH 20B,A03,093475,Briones; Jor-el Thomas Caparas,2,0,36,34
1657526347864,MATH 20C,A01,083760,Briones; Jor-el Thomas Caparas,1,0,35,34
1657526347864,MATH 20C,A02,083761,Briones; Jor-el Thomas Caparas,8,0,35,27
1657526347864,MATH 20C,A03,093476,Briones; Jor-el Thomas Caparas,0,1,36,36
1657526347864,MATH 20C,B01,083762,Bach; Quang Tran,1,0,30,29
1657526353893,MATH 20D,A01,083765,Tran; Brian Kha,5,0,30,25
1657526353893,MATH 20D,A02,083766,Tran; Brian Kha,5,0,30,25
1657526353893,MATH 20D,A03,083767,Tran; Brian Kha,5,0,30,25
1657526359921,MATH 20E,A01,083771,Ganguly; Soumya,9,0,32,23
1657526359921,MATH 20E,A02,083772,Ganguly; Soumya,6,0,32,26
1657526359921,MATH 20E,B01,083773,Ciotti; Benjamin,20,0,35,15
1657526359921,MATH 20E,B02,083774,Ciotti; Benjamin,17,0,35,18
1657526365947,MATH 103A,A01,083777,Greenfeld; Be'Eri,3,0,36,33
1657526365947,MATH 103A,A02,083778,Greenfeld; Be'Eri,5,0,36,31
1657526365947,MATH 103A,A03,093561,Greenfeld; Be'Eri,5,0,36,31
1657526365947,MATH 103A,B01,083779,Greenfeld; Be'Eri,7,0,36,29
1657526365947,MATH 103A,B02,083780,Greenfeld; Be'Eri,4,0,36,32
1657526365947,MATH 103A,B03,093562,Greenfeld; Be'Eri,3,0,36,33
1657526371972,MATH 105,A01,085443,Carter; Anne Toulson,15,0,35,20
1657526371972,MATH 105,A02,093477,Carter; Anne Toulson,20,0,35,15
1657526377995,MATH 109,A01,083213,Ganzberger; Geoffrey Michael,2,0,34,32
1657526377995,MATH 109,A02,083214,Ganzberger; Geoffrey Michael,4,0,34,30
1657526377995,MATH 109,A03,093478,Ganzberger; Geoffrey Michael,2,0,34,32
1657526377995,MATH 109,B01,083215,Ganzberger; Geoffrey Michael,1,0,32,31
1657526377995,MATH 109,B02,083216,Ganzberger; Geoffrey Michael,2,0,32,30
1657526377995,MATH 109,B03,093479,Ganzberger; Geoffrey Michael,8,0,32,24
1657526384026,MATH 142A,A01,083219,Chow; Bennett,7,0,32,25
1657526384026,MATH 142A,A02,083220,Chow; Bennett,10,0,32,22
1657526384026,MATH 142A,A03,093480,Chow; Bennett,8,0,32,24
1657526384026,MATH 142A,B03,093481,Chow; Bennett,8,0,32,24
1657526384026,MATH 142A,B04,093558,Chow; Bennett,13,0,32,19
1657526384026,MATH 142A,B05,093559,Chow; Bennett,6,0,32,26
1657526390050,MATH 193A,A01,083224,Rotar; Vladimir,8,0,34,26
1657526390050,MATH 193A,A02,083225,Rotar; Vladimir,9,0,34,25
1657526390050,MATH 193A,A03,083781,Rotar; Vladimir,5,0,34,29
1657526390050,MATH 193A,A04,083782,Rotar; Vladimir,10,0,34,24
1657526390050,MATH 193A,A05,093482,Rotar; Vladimir,10,0,34,24
1657526396080,MATH 197,001,091859,McAuley; Julian John,9999,0,9999,0
1657526396080,MATH 197,002,095566,Kedlaya; Kiran S.,9997,0,9999,2
1657526396080,MATH 197,003,095567,Xiao; Ming,9999,0,9999,0
1657526396080,MATH 197,004,095571,Perols; Johan Lars,9998,0,9999,1
1657526403140,COGS 9,A01,083615,Shannon; Kyle Michael,9,0,75,66
1657526409168,COGS 11,A01,083617,Boyle; Mary E. T.,22,0,48,26
1657526415191,COGS 13,A01,083071,Bastos; Amalia Pinkusfeld,11,0,71,60
1657526421219,COGS 14A,A01,092681,Semenuks; Arturs,5,1,100,95
1657526427241,COGS 14B,A01,083073,Cheng; Tzu-Han,6,0,63,57
1657526433264,COGS 17,A01,092677,Semenuks; Arturs,6,0,81,75
1657526439290,COGS 100,A01,083619,Allen; Michael Gordon,17,0,70,53
1657526445312,COGS 101A,A01,083621,Davis; Joshua Daniel,9,0,68,59
1657526451338,COGS 101B,A01,091572,Allen; Michael Gordon,12,0,65,53
1657526457367,COGS 101C,A01,083625,Delgado; Tania,17,0,35,18
1657526463470,COGS 107A,A01,083627,Boyle; Mary E. T.,13,0,60,47
1657526469506,COGS 118A,A01,083075,Gupta; Anjum,21,0,76,55
1657526475546,CSE 3,A50,083646,Miranda; Gregory Joseph,24,0,50,26
1657526481569,CSE 8A,A50,083650,Miranda; Gregory Joseph,17,1,56,39
1657526487597,CSE 11,A01,083080,Cao; Yingjun,6,15,40,34
1657526493624,CSE 12,A01,083652,Krause-Levy; Sophia Louisa,28,1,120,92
1657526499649,CSE 15L,A01,083654,Morris; Justin Loren,9,0,50,41
1657526499649,CSE 15L,A02,083655,Morris; Justin Loren,9,0,50,41
1657526505674,CSE 20,A01,083657,Tran; Khoa Dang,39,0,80,41
1657526511697,CSE 21,A01,095574,Bach; Quang Tran,22,0,48,26
1657526517726,CSE 30,A01,083084,Eldon; John,5,0,80,75
1657526517726,CSE 30,B01,095061,Bhaskar; Nishant,9,0,50,41
1657526523754,CSE 100,A01,083659,Cao; Yingjun,5,4,70,65
1657526529788,CSE 134B,A01,083661,Powell; Thomas Allan,22,0,100,78
1657526535812,CSE 140,A01,083663,Gungor; Onat,15,0,85,70
1657526541843,CSE 140L,A01,083088,Eldon; John,21,0,100,79
1657526547876,CSE 175,A01,083665,Kumar; Rakesh,3,0,25,22
1657526553901,CSE 190,A00,092507,Dubnov; Shlomo,8,0,20,12
1657526559932,ECE 45,A01,083139,Congero; Spencer William,6,0,75,69
1657526565956,ECE 65,A50,083695,Saad; Andrew S,12,0,30,18
1657526565956,ECE 65,A51,095125,Saad; Andrew S,24,0,26,2
1657526571980,ECE 109,A01,091882,Touri; Behrouz,19,0,70,51
1657526578004,ECE 180,A00,083140,Abi Samra; Nicholas Camill,1,0,30,29
1657526578004,ECE 180,B00,083141,Abi Samra; Nicholas Camill,0,0,30,30
1657526584034,MATH 10A,A01,083735,Patchell; Gregory David,2,0,30,28
1657526584034,MATH 10A,A02,083736,Patchell; Gregory David,20,0,30,10
1657526584034,MATH 10A,A03,083737,Patchell; Gregory David,16,0,30,14
1657526590065,MATH 10B,A01,083207,Lim; Seonhee,8,0,34,26
1657526590065,MATH 10B,A02,083208,Lim; Seonhee,9,0,35,26
1657526590065,MATH 10B,A03,093472,Lim; Seonhee,7,0,34,27
1657526590065,MATH 10B,B01,083739,Sinha; Shubham,12,0,30,18
1657526596093,MATH 18,A01,083743,Cinel; Cameron Alexander,7,0,30,23
1657526596093,MATH 18,A02,083744,Cinel; Cameron Alexander,17,0,30,13
1657526596093,MATH 18,A03,083745,Cinel; Cameron Alexander,9,0,30,21
1657526596093,MATH 18,B01,083748,Rideout; David Porter,5,0,37,32
1657526596093,MATH 18,B02,083749,Rideout; David Porter,5,0,36,31
1657526596093,MATH 18,B03,083750,Rideout; David Porter,3,0,37,34
1657526596093,MATH 18,B04,083751,Rideout; David Porter,6,0,36,30
1657526596093,MATH 18,B05,093473,Rideout; David Porter,6,0,36,30
1657526596093,MATH 18,B06,093474,Rideout; David Porter,6,0,36,30
1657526602119,MATH 20A,A01,083754,Zheng; Zequn,14,0,40,26
1657526608151,MATH 20B,A01,083756,Briones; Jor-el Thomas Caparas,4,0,36,32
1657526608151,MATH 20B,A02,083757,Briones; Jor-el Thomas Caparas,1,0,36,35
1657526608151,MATH 20B,A03,093475,Briones; Jor-el Thomas Caparas,2,0,36,34
1657526614192,MATH 20C,A01,083760,Briones; Jor-el Thomas Caparas,1,0,35,34
1657526614192,MATH 20C,A02,083761,Briones; Jor-el Thomas Caparas,8,0,35,27
1657526614192,MATH 20C,A03,093476,Briones; Jor-el Thomas Caparas,0,1,36,36
1657526614192,MATH 20C,B01,083762,Bach; Quang Tran,1,0,30,29
1657526620220,MATH 20D,A01,083765,Tran; Brian Kha,5,0,30,25
1657526620220,MATH 20D,A02,083766,Tran; Brian Kha,5,0,30,25
1657526620220,MATH 20D,A03,083767,Tran; Brian Kha,5,0,30,25
1657526626256,MATH 20E,A01,083771,Ganguly; Soumya,9,0,32,23
1657526626256,MATH 20E,A02,083772,Ganguly; Soumya,6,0,32,26
1657526626256,MATH 20E,B01,083773,Ciotti; Benjamin,20,0,35,15
1657526626256,MATH 20E,B02,083774,Ciotti; Benjamin,17,0,35,18
1657526632290,MATH 103A,A01,083777,Greenfeld; Be'Eri,3,0,36,33
1657526632290,MATH 103A,A02,083778,Greenfeld; Be'Eri,5,0,36,31
1657526632290,MATH 103A,A03,093561,Greenfeld; Be'Eri,5,0,36,31
1657526632290,MATH 103A,B01,083779,Greenfeld; Be'Eri,7,0,36,29
1657526632290,MATH 103A,B02,083780,Greenfeld; Be'Eri,4,0,36,32
1657526632290,MATH 103A,B03,093562,Greenfeld; Be'Eri,3,0,36,33
1657526638320,MATH 105,A01,085443,Carter; Anne Toulson,15,0,35,20
1657526638320,MATH 105,A02,093477,Carter; Anne Toulson,20,0,35,15
1657526644355,MATH 109,A01,083213,Ganzberger; Geoffrey Michael,2,0,34,32
1657526644355,MATH 109,A02,083214,Ganzberger; Geoffrey Michael,4,0,34,30
1657526644355,MATH 109,A03,093478,Ganzberger; Geoffrey Michael,2,0,34,32
1657526644355,MATH 109,B01,083215,Ganzberger; Geoffrey Michael,1,0,32,31
1657526644355,MATH 109,B02,083216,Ganzberger; Geoffrey Michael,2,0,32,30
1657526644355,MATH 109,B03,093479,Ganzberger; Geoffrey Michael,8,0,32,24
1657526650388,MATH 142A,A01,083219,Chow; Bennett,7,0,32,25
1657526650388,MATH 142A,A02,083220,Chow; Bennett,10,0,32,22
1657526650388,MATH 142A,A03,093480,Chow; Bennett,8,0,32,24
1657526650388,MATH 142A,B03,093481,Chow; Bennett,8,0,32,24
1657526650388,MATH 142A,B04,093558,Chow; Bennett,13,0,32,19
1657526650388,MATH 142A,B05,093559,Chow; Bennett,6,0,32,26
1657526656421,MATH 193A,A01,083224,Rotar; Vladimir,8,0,34,26
1657526656421,MATH 193A,A02,083225,Rotar; Vladimir,9,0,34,25
1657526656421,MATH 193A,A03,083781,Rotar; Vladimir,5,0,34,29
1657526656421,MATH 193A,A04,083782,Rotar; Vladimir,10,0,34,24
1657526656421,MATH 193A,A05,093482,Rotar; Vladimir,10,0,34,24
1657526662462,MATH 197,001,091859,McAuley; Julian John,9999,0,9999,0
1657526662462,MATH 197,002,095566,Kedlaya; Kiran S.,9997,0,9999,2
1657526662462,MATH 197,003,095567,Xiao; Ming,9999,0,9999,0
1657526662462,MATH 197,004,095571,Perols; Johan Lars,9998,0,9999,1
1657526669566,COGS 9,A01,083615,Shannon; Kyle Michael,9,0,75,66
1657526675591,COGS 11,A01,083617,Boyle; Mary E. T.,22,0,48,26
1657526681840,COGS 13,A01,083071,Bastos; Amalia Pinkusfeld,11,0,71,60
1657526687877,COGS 14A,A01,092681,Semenuks; Arturs,5,1,100,95
1657526693902,COGS 14B,A01,083073,Cheng; Tzu-Han,6,0,63,57
1657526699926,COGS 17,A01,092677,Semenuks; Arturs,6,0,81,75
1657526705956,COGS 100,A01,083619,Allen; Michael Gordon,17,0,70,53
1657526711992,COGS 101A,A01,083621,Davis; Joshua Daniel,9,0,68,59
1657526718020,COGS 101B,A01,091572,Allen; Michael Gordon,12,0,65,53
1657526724047,COGS 101C,A01,083625,Delgado; Tania,17,0,35,18
1657526730073,COGS 107A,A01,083627,Boyle; Mary E. T.,13,0,60,47
1657526736108,COGS 118A,A01,083075,Gupta; Anjum,21,0,76,55
1657526742148,CSE 3,A50,083646,Miranda; Gregory Joseph,24,0,50,26
1657526748173,CSE 8A,A50,083650,Miranda; Gregory Joseph,17,1,56,39
1657526754200,CSE 11,A01,083080,Cao; Yingjun,6,15,40,34
1657526760243,CSE 12,A01,083652,Krause-Levy; Sophia Louisa,28,1,120,92
1657526766315,CSE 15L,A01,083654,Morris; Justin Loren,9,0,50,41
1657526766315,CSE 15L,A02,083655,Morris; Justin Loren,9,0,50,41
1657526772353,CSE 20,A01,083657,Tran; Khoa Dang,39,0,80,41
1657526778391,CSE 21,A01,095574,Bach; Quang Tran,22,0,48,26
1657526784448,CSE 30,A01,083084,Eldon; John,5,0,80,75
1657526784448,CSE 30,B01,095061,Bhaskar; Nishant,9,0,50,41
1657526790475,CSE 100,A01,083659,Cao; Yingjun,5,4,70,65
1657526796499,CSE 134B,A01,083661,Powell; Thomas Allan,22,0,100,78
1657526802533,CSE 140,A01,083663,Gungor; Onat,15,0,85,70
1657526808571,CSE 140L,A01,083088,Eldon; John,21,0,100,79
1657526814604,CSE 175,A01,083665,Kumar; Rakesh,3,0,25,22
1657526820666,CSE 190,A00,092507,Dubnov; Shlomo,8,0,20,12
1657526826690,ECE 45,A01,083139,Congero; Spencer William,6,0,75,69
1657526832723,ECE 65,A50,083695,Saad; Andrew S,12,0,30,18
1657526832723,ECE 65,A51,095125,Saad; Andrew S,24,0,26,2
1657526838755,ECE 109,A01,091882,Touri; Behrouz,19,0,70,51
1657526844782,ECE 180,A00,083140,Abi Samra; Nicholas Camill,1,0,30,29
1657526844782,ECE 180,B00,083141,Abi Samra; Nicholas Camill,0,0,30,30
1657526850809,MATH 10A,A01,083735,Patchell; Gregory David,2,0,30,28
1657526850809,MATH 10A,A02,083736,Patchell; Gregory David,20,0,30,10
1657526850809,MATH 10A,A03,083737,Patchell; Gregory David,16,0,30,14
1657526856851,MATH 10B,A01,083207,Lim; Seonhee,8,0,34,26
1657526856851,MATH 10B,A02,083208,Lim; Seonhee,9,0,35,26
1657526856851,MATH 10B,A03,093472,Lim; Seonhee,7,0,34,27
1657526856851,MATH 10B,B01,083739,Sinha; Shubham,12,0,30,18
1657526862884,MATH 18,A01,083743,Cinel; Cameron Alexander,7,0,30,23
1657526862884,MATH 18,A02,083744,Cinel; Cameron Alexander,17,0,30,13
1657526862884,MATH 18,A03,083745,Cinel; Cameron Alexander,9,0,30,21
1657526862884,MATH 18,B01,083748,Rideout; David Porter,5,0,37,32
1657526862884,MATH 18,B02,083749,Rideout; David Porter,5,0,36,31
1657526862884,MATH 18,B03,083750,Rideout; David Porter,3,0,37,34
1657526862884,MATH 18,B04,083751,Rideout; David Porter,6,0,36,30
1657526862884,MATH 18,B05,093473,Rideout; David Porter,6,0,36,30
1657526862884,MATH 18,B06,093474,Rideout; David Porter,6,0,36,30
1657526868908,MATH 20A,A01,083754,Zheng; Zequn,14,0,40,26
1657526874935,MATH 20B,A01,083756,Briones; Jor-el Thomas Caparas,4,0,36,32
1657526874935,MATH 20B,A02,083757,Briones; Jor-el Thomas Caparas,1,0,36,35
1657526874935,MATH 20B,A03,093475,Briones; Jor-el Thomas Caparas,2,0,36,34
1657526880962,MATH 20C,A01,083760,Briones; Jor-el Thomas Caparas,1,0,35,34
1657526880962,MATH 20C,A02,083761,Briones; Jor-el Thomas Caparas,8,0,35,27
1657526880962,MATH 20C,A03,093476,Briones; Jor-el Thomas Caparas,0,1,36,36
1657526880962,MATH 20C,B01,083762,Bach; Quang Tran,1,0,30,29
1657526886987,MATH 20D,A01,083765,Tran; Brian Kha,5,0,30,25
1657526886987,MATH 20D,A02,083766,Tran; Brian Kha,5,0,30,25
1657526886987,MATH 20D,A03,083767,Tran; Brian Kha,5,0,30,25
1657526893016,MATH 20E,A01,083771,Ganguly; Soumya,9,0,32,23
1657526893016,MATH 20E,A02,083772,Ganguly; Soumya,6,0,32,26
1657526893016,MATH 20E,B01,083773,Ciotti; Benjamin,20,0,35,15
1657526893016,MATH 20E,B02,083774,Ciotti; Benjamin,17,0,35,18
1657526899042,MATH 103A,A01,083777,Greenfeld; Be'Eri,3,0,36,33
1657526899042,MATH 103A,A02,083778,Greenfeld; Be'Eri,5,0,36,31
1657526899042,MATH 103A,A03,093561,Greenfeld; Be'Eri,5,0,36,31
1657526899042,MATH 103A,B01,083779,Greenfeld; Be'Eri,7,0,36,29
1657526899042,MATH 103A,B02,083780,Greenfeld; Be'Eri,4,0,36,32
1657526899042,MATH 103A,B03,093562,Greenfeld; Be'Eri,3,0,36,33
1657526905072,MATH 105,A01,085443,Carter; Anne Toulson,15,0,35,20
1657526905072,MATH 105,A02,093477,Carter; Anne Toulson,20,0,35,15
1657526911125,MATH 109,A01,083213,Ganzberger; Geoffrey Michael,2,0,34,32
1657526911125,MATH 109,A02,083214,Ganzberger; Geoffrey Michael,4,0,34,30
1657526911125,MATH 109,A03,093478,Ganzberger; Geoffrey Michael,2,0,34,32
1657526911125,MATH 109,B01,083215,Ganzberger; Geoffrey Michael,1,0,32,31
1657526911125,MATH 109,B02,083216,Ganzberger; Geoffrey Michael,2,0,32,30
1657526911125,MATH 109,B03,093479,Ganzberger; Geoffrey Michael,8,0,32,24
1657526917154,MATH 142A,A01,083219,Chow; Bennett,7,0,32,25
1657526917154,MATH 142A,A02,083220,Chow; Bennett,10,0,32,22
1657526917154,MATH 142A,A03,093480,Chow; Bennett,8,0,32,24
1657526917154,MATH 142A,B03,093481,Chow; Bennett,8,0,32,24
1657526917154,MATH 142A,B04,093558,Chow; Bennett,13,0,32,19
1657526917154,MATH 142A,B05,093559,Chow; Bennett,6,0,32,26
1657526923188,MATH 193A,A01,083224,Rotar; Vladimir,8,0,34,26
1657526923188,MATH 193A,A02,083225,Rotar; Vladimir,9,0,34,25
1657526923188,MATH 193A,A03,083781,Rotar; Vladimir,5,0,34,29
1657526923188,MATH 193A,A04,083782,Rotar; Vladimir,10,0,34,24
1657526923188,MATH 193A,A05,093482,Rotar; Vladimir,10,0,34,24
1657526929215,MATH 197,001,091859,McAuley; Julian John,9999,0,9999,0
1657526929215,MATH 197,002,095566,Kedlaya; Kiran S.,9997,0,9999,2
1657526929215,MATH 197,003,095567,Xiao; Ming,9999,0,9999,0
1657526929215,MATH 197,004,095571,Perols; Johan Lars,9998,0,9999,1
1657526936312,COGS 9,A01,083615,Shannon; Kyle Michael,9,0,75,66
1657526942344,COGS 11,A01,083617,Boyle; Mary E. T.,22,0,48,26
1657526948373,COGS 13,A01,083071,Bastos; Amalia Pinkusfeld,11,0,71,60
1657526954402,COGS 14A,A01,092681,Semenuks; Arturs,5,1,100,95
1657526960426,COGS 14B,A01,083073,Cheng; Tzu-Han,6,0,63,57
1657526966459,COGS 17,A01,092677,Semenuks; Arturs,6,0,81,75
1657526972488,COGS 100,A01,083619,Allen; Michael Gordon,17,0,70,53
1657526978525,COGS 101A,A01,083621,Davis; Joshua Daniel,9,0,68,59
1657526984553,COGS 101B,A01,091572,Allen; Michael Gordon,12,0,65,53
1657526990577,COGS 101C,A01,083625,Delgado; Tania,17,0,35,18
1657526996605,COGS 107A,A01,083627,Boyle; Mary E. T.,13,0,60,47
1657527002641,COGS 118A,A01,083075,Gupta; Anjum,21,0,76,55
1657527008668,CSE 3,A50,083646,Miranda; Gregory Joseph,24,0,50,26
1657527014700,CSE 8A,A50,083650,Miranda; Gregory Joseph,17,1,56,39
1657527020739,CSE 11,A01,083080,Cao; Yingjun,6,15,40,34
1657527026765,CSE 12,A01,083652,Krause-Levy; Sophia Louisa,28,1,120,92
1657527032790,CSE 15L,A01,083654,Morris; Justin Loren,9,0,50,41
1657527032790,CSE 15L,A02,083655,Morris; Justin Loren,9,0,50,41
1657527038816,CSE 20,A01,083657,Tran; Khoa Dang,39,0,80,41
1657527044839,CSE 21,A01,095574,Bach; Quang Tran,22,0,48,26
1657527050874,CSE 30,A01,083084,Eldon; John,5,0,80,75
1657527050874,CSE 30,B01,095061,Bhaskar; Nishant,9,0,50,41
1657527056898,CSE 100,A01,083659,Cao; Yingjun,5,4,70,65
1657527062994,CSE 134B,A01,083661,Powell; Thomas Allan,22,0,100,78
1657527069020,CSE 140,A01,083663,Gungor; Onat,15,0,85,70
1657527075043,CSE 140L,A01,083088,Eldon; John,21,0,100,79
1657527081071,CSE 175,A01,083665,Kumar; Rakesh,3,0,25,22
1657527087101,CSE 190,A00,092507,Dubnov; Shlomo,8,0,20,12
1657527093134,ECE 45,A01,083139,Congero; Spencer William,6,0,75,69
1657527099172,ECE 65,A50,083695,Saad; Andrew S,12,0,30,18
1657527099172,ECE 65,A51,095125,Saad; Andrew S,24,0,26,2
1657527105203,ECE 109,A01,091882,Touri; Behrouz,19,0,70,51
1657527111228,ECE 180,A00,083140,Abi Samra; Nicholas Camill,1,0,30,29
1657527111228,ECE 180,B00,083141,Abi Samra; Nicholas Camill,0,0,30,30
1657527117255,MATH 10A,A01,083735,Patchell; Gregory David,2,0,30,28
1657527117255,MATH 10A,A02,083736,Patchell; Gregory David,20,0,30,10
1657527117255,MATH 10A,A03,083737,Patchell; Gregory David,16,0,30,14
1657527123291,MATH 10B,A01,083207,Lim; Seonhee,8,0,34,26
1657527123291,MATH 10B,A02,083208,Lim; Seonhee,9,0,35,26
1657527123291,MATH 10B,A03,093472,Lim; Seonhee,7,0,34,27
1657527123291,MATH 10B,B01,083739,Sinha; Shubham,12,0,30,18
1657527129328,MATH 18,A01,083743,Cinel; Cameron Alexander,7,0,30,23
1657527129328,MATH 18,A02,083744,Cinel; Cameron Alexander,17,0,30,13
1657527129328,MATH 18,A03,083745,Cinel; Cameron Alexander,9,0,30,21
1657527129328,MATH 18,B01,083748,Rideout; David Porter,5,0,37,32
1657527129328,MATH 18,B02,083749,Rideout; David Porter,5,0,36,31
1657527129328,MATH 18,B03,083750,Rideout; David Porter,3,0,37,34
1657527129328,MATH 18,B04,083751,Rideout; David Porter,6,0,36,30
1657527129328,MATH 18,B05,093473,Rideout; David Porter,6,0,36,30
1657527129328,MATH 18,B06,093474,Rideout; David Porter,6,0,36,30
1657527135353,MATH 20A,A01,083754,Zheng; Zequn,14,0,40,26
1657527141391,MATH 20B,A01,083756,Briones; Jor-el Thomas Caparas,4,0,36,32
1657527141391,MATH 20B,A02,083757,Briones; Jor-el Thomas Caparas,1,0,36,35
1657527141391,MATH 20B,A03,093475,Briones; Jor-el Thomas Caparas,2,0,36,34
1657527147431,MATH 20C,A01,083760,Briones; Jor-el Thomas Caparas,1,0,35,34
1657527147431,MATH 20C,A02,083761,Briones; Jor-el Thomas Caparas,8,0,35,27
1657527147431,MATH 20C,A03,093476,Briones; Jor-el Thomas Caparas,0,1,36,36
1657527147431,MATH 20C,B01,083762,Bach; Quang Tran,1,0,30,29
1657527153461,MATH 20D,A01,083765,Tran; Brian Kha,5,0,30,25
1657527153461,MATH 20D,A02,083766,Tran; Brian Kha,5,0,30,25
1657527153461,MATH 20D,A03,083767,Tran; Brian Kha,5,0,30,25
1657527159493,MATH 20E,A01,083771,Ganguly; Soumya,9,0,32,23
1657527159493,MATH 20E,A02,083772,Ganguly; Soumya,6,0,32,26
1657527159493,MATH 20E,B01,083773,Ciotti; Benjamin,20,0,35,15
1657527159493,MATH 20E,B02,083774,Ciotti; Benjamin,17,0,35,18
1657527165520,MATH 103A,A01,083777,Greenfeld; Be'Eri,3,0,36,33
1657527165520,MATH 103A,A02,083778,Greenfeld; Be'Eri,5,0,36,31
1657527165520,MATH 103A,A03,093561,Greenfeld; Be'Eri,5,0,36,31
1657527165520,MATH 103A,B01,083779,Greenfeld; Be'Eri,7,0,36,29
1657527165520,MATH 103A,B02,083780,Greenfeld; Be'Eri,4,0,36,32
1657527165520,MATH 103A,B03,093562,Greenfeld; Be'Eri,3,0,36,33
1657527171550,MATH 105,A01,085443,Carter; Anne Toulson,15,0,35,20
1657527171550,MATH 105,A02,093477,Carter; Anne Toulson,20,0,35,15
1657527177578,MATH 109,A01,083213,Ganzberger; Geoffrey Michael,2,0,34,32
1657527177578,MATH 109,A02,083214,Ganzberger; Geoffrey Michael,4,0,34,30
1657527177578,MATH 109,A03,093478,Ganzberger; Geoffrey Michael,2,0,34,32
1657527177578,MATH 109,B01,083215,Ganzberger; Geoffrey Michael,1,0,32,31
1657527177578,MATH 109,B02,083216,Ganzberger; Geoffrey Michael,2,0,32,30
1657527177578,MATH 109,B03,093479,Ganzberger; Geoffrey Michael,8,0,32,24
1657527183613,MATH 142A,A01,083219,Chow; Bennett,7,0,32,25
1657527183613,MATH 142A,A02,083220,Chow; Bennett,10,0,32,22
1657527183613,MATH 142A,A03,093480,Chow; Bennett,8,0,32,24
1657527183613,MATH 142A,B03,093481,Chow; Bennett,8,0,32,24
1657527183613,MATH 142A,B04,093558,Chow; Bennett,13,0,32,19
1657527183613,MATH 142A,B05,093559,Chow; Bennett,6,0,32,26
1657527189647,MATH 193A,A01,083224,Rotar; Vladimir,8,0,34,26
1657527189647,MATH 193A,A02,083225,Rotar; Vladimir,9,0,34,25
1657527189647,MATH 193A,A03,083781,Rotar; Vladimir,5,0,34,29
1657527189647,MATH 193A,A04,083782,Rotar; Vladimir,10,0,34,24
1657527189647,MATH 193A,A05,093482,Rotar; Vladimir,10,0,34,24
1657527195674,MATH 197,001,091859,McAuley; Julian John,9999,0,9999,0
1657527195674,MATH 197,002,095566,Kedlaya; Kiran S.,9997,0,9999,2
1657527195674,MATH 197,003,095567,Xiao; Ming,9999,0,9999,0
1657527195674,MATH 197,004,095571,Perols; Johan Lars,9998,0,9999,1
1657527202750,COGS 9,A01,083615,Shannon; Kyle Michael,9,0,75,66
1657527208775,COGS 11,A01,083617,Boyle; Mary E. T.,22,0,48,26
1657527214804,COGS 13,A01,083071,Bastos; Amalia Pinkusfeld,11,0,71,60
1657527220835,COGS 14A,A01,092681,Semenuks; Arturs,5,1,100,95
1657527226859,COGS 14B,A01,083073,Cheng; Tzu-Han,6,0,63,57
1657527232885,COGS 17,A01,092677,Semenuks; Arturs,6,0,81,75
1657527238914,COGS 100,A01,083619,Allen; Michael Gordon,17,0,70,53
1657527244943,COGS 101A,A01,083621,Davis; Joshua Daniel,9,0,68,59
1657527250969,COGS 101B,A01,091572,Allen; Michael Gordon,12,0,65,53
1657527256995,COGS 101C,A01,083625,Delgado; Tania,17,0,35,18
1657527263019,COGS 107A,A01,083627,Boyle; Mary E. T.,13,0,60,47
1657527269044,COGS 118A,A01,083075,Gupta; Anjum,21,0,76,55
1657527275076,CSE 3,A50,083646,Miranda; Gregory Joseph,24,0,50,26
1657527281107,CSE 8A,A50,083650,Miranda; Gregory Joseph,17,1,56,39
1657527287133,CSE 11,A01,083080,Cao; Yingjun,6,15,40,34
1657527293163,CSE 12,A01,083652,Krause-Levy; Sophia Louisa,28,1,120,92
1657527299193,CSE 15L,A01,083654,Morris; Justin Loren,9,0,50,41
1657527299193,CSE 15L,A02,083655,Morris; Justin Loren,9,0,50,41
1657527305227,CSE 20,A01,083657,Tran; Khoa Dang,39,0,80,41
1657527311252,CSE 21,A01,095574,Bach; Quang Tran,22,0,48,26
1657527317278,CSE 30,A01,083084,Eldon; John,5,0,80,75
1657527317278,CSE 30,B01,095061,Bhaskar; Nishant,9,0,50,41
1657527323307,CSE 100,A01,083659,Cao; Yingjun,5,4,70,65
1657527329333,CSE 134B,A01,083661,Powell; Thomas Allan,22,0,100,78
1657527335361,CSE 140,A01,083663,Gungor; Onat,15,0,85,70
1657527341388,CSE 140L,A01,083088,Eldon; John,21,0,100,79
1657527347414,CSE 175,A01,083665,Kumar; Rakesh,3,0,25,22
1657527353439,CSE 190,A00,092507,Dubnov; Shlomo,8,0,20,12
1657527359469,ECE 45,A01,083139,Congero; Spencer William,6,0,75,69
1657527365505,ECE 65,A50,083695,Saad; Andrew S,12,0,30,18
1657527365505,ECE 65,A51,095125,Saad; Andrew S,24,0,26,2
1657527371549,ECE 109,A01,091882,Touri; Behrouz,19,0,70,51
1657527377578,ECE 180,A00,083140,Abi Samra; Nicholas Camill,1,0,30,29
1657527377578,ECE 180,B00,083141,Abi Samra; Nicholas Camill,0,0,30,30
1657527383611,MATH 10A,A01,083735,Patchell; Gregory David,2,0,30,28
1657527383611,MATH 10A,A02,083736,Patchell; Gregory David,20,0,30,10
1657527383611,MATH 10A,A03,083737,Patchell; Gregory David,16,0,30,14
1657527389641,MATH 10B,A01,083207,Lim; Seonhee,8,0,34,26
1657527389641,MATH 10B,A02,083208,Lim; Seonhee,9,0,35,26
1657527389641,MATH 10B,A03,093472,Lim; Seonhee,7,0,34,27
1657527389641,MATH 10B,B01,083739,Sinha; Shubham,12,0,30,18
1657527395669,MATH 18,A01,083743,Cinel; Cameron Alexander,7,0,30,23
1657527395669,MATH 18,A02,083744,Cinel; Cameron Alexander,17,0,30,13
1657527395669,MATH 18,A03,083745,Cinel; Cameron Alexander,9,0,30,21
1657527395669,MATH 18,B01,083748,Rideout; David Porter,5,0,37,32
1657527395669,MATH 18,B02,083749,Rideout; David Porter,5,0,36,31
1657527395669,MATH 18,B03,083750,Rideout; David Porter,3,0,37,34
1657527395669,MATH 18,B04,083751,Rideout; David Porter,6,0,36,30
1657527395669,MATH 18,B05,093473,Rideout; David Porter,6,0,36,30
1657527395669,MATH 18,B06,093474,Rideout; David Porter,6,0,36,30
1657527401698,MATH 20A,A01,083754,Zheng; Zequn,14,0,40,26
1657527407734,MATH 20B,A01,083756,Briones; Jor-el Thomas Caparas,4,0,36,32
1657527407734,MATH 20B,A02,083757,Briones; Jor-el Thomas Caparas,1,0,36,35
1657527407734,MATH 20B,A03,093475,Briones; Jor-el Thomas Caparas,2,0,36,34
1657527413771,MATH 20C,A01,083760,Briones; Jor-el Thomas Caparas,1,0,35,34
1657527413771,MATH 20C,A02,083761,Briones; Jor-el Thomas Caparas,8,0,35,27
1657527413771,MATH 20C,A03,093476,Briones; Jor-el Thomas Caparas,0,1,36,36
1657527413771,MATH 20C,B01,083762,Bach; Quang Tran,1,0,30,29
1657527419795,MATH 20D,A01,083765,Tran; Brian Kha,5,0,30,25
1657527419795,MATH 20D,A02,083766,Tran; Brian Kha,5,0,30,25
1657527419795,MATH 20D,A03,083767,Tran; Brian Kha,5,0,30,25
1657527425823,MATH 20E,A01,083771,Ganguly; Soumya,9,0,32,23
1657527425823,MATH 20E,A02,083772,Ganguly; Soumya,6,0,32,26
1657527425823,MATH 20E,B01,083773,Ciotti; Benjamin,20,0,35,15
1657527425823,MATH 20E,B02,083774,Ciotti; Benjamin,17,0,35,18
1657527431860,MATH 103A,A01,083777,Greenfeld; Be'Eri,3,0,36,33
1657527431860,MATH 103A,A02,083778,Greenfeld; Be'Eri,5,0,36,31
1657527431860,MATH 103A,A03,093561,Greenfeld; Be'Eri,5,0,36,31
1657527431860,MATH 103A,B01,083779,Greenfeld; Be'Eri,7,0,36,29
1657527431860,MATH 103A,B02,083780,Greenfeld; Be'Eri,4,0,36,32
1657527431860,MATH 103A,B03,093562,Greenfeld; Be'Eri,3,0,36,33
1657527437886,MATH 105,A01,085443,Carter; Anne Toulson,15,0,35,20
1657527437886,MATH 105,A02,093477,Carter; Anne Toulson,20,0,35,15
1657527443913,MATH 109,A01,083213,Ganzberger; Geoffrey Michael,2,0,34,32
1657527443913,MATH 109,A02,083214,Ganzberger; Geoffrey Michael,4,0,34,30
1657527443913,MATH 109,A03,093478,Ganzberger; Geoffrey Michael,2,0,34,32
1657527443913,MATH 109,B01,083215,Ganzberger; Geoffrey Michael,1,0,32,31
1657527443913,MATH 109,B02,083216,Ganzberger; Geoffrey Michael,2,0,32,30
1657527443913,MATH 109,B03,093479,Ganzberger; Geoffrey Michael,8,0,32,24
1657527449952,MATH 142A,A01,083219,Chow; Bennett,7,0,32,25
1657527449952,MATH 142A,A02,083220,Chow; Bennett,10,0,32,22
1657527449952,MATH 142A,A03,093480,Chow; Bennett,8,0,32,24
1657527449952,MATH 142A,B03,093481,Chow; Bennett,8,0,32,24
1657527449952,MATH 142A,B04,093558,Chow; Bennett,13,0,32,19
1657527449952,MATH 142A,B05,093559,Chow; Bennett,6,0,32,26
1657527455976,MATH 193A,A01,083224,Rotar; Vladimir,8,0,34,26
1657527455976,MATH 193A,A02,083225,Rotar; Vladimir,9,0,34,25
1657527455976,MATH 193A,A03,083781,Rotar; Vladimir,5,0,34,29
1657527455976,MATH 193A,A04,083782,Rotar; Vladimir,10,0,34,24
1657527455976,MATH 193A,A05,093482,Rotar; Vladimir,10,0,34,24
1657527462003,MATH 197,001,091859,McAuley; Julian John,9999,0,9999,0
1657527462003,MATH 197,002,095566,Kedlaya; Kiran S.,9997,0,9999,2
1657527462003,MATH 197,003,095567,Xiao; Ming,9999,0,9999,0
1657527462003,MATH 197,004,095571,Perols; Johan Lars,9998,0,9999,1
1657527469081,COGS 9,A01,083615,Shannon; Kyle Michael,9,0,75,66
1657527475111,COGS 11,A01,083617,Boyle; Mary E. T.,22,0,48,26
1657527481139,COGS 13,A01,083071,Bastos; Amalia Pinkusfeld,11,0,71,60
1657527487169,COGS 14A,A01,092681,Semenuks; Arturs,5,1,100,95
1657527493198,COGS 14B,A01,083073,Cheng; Tzu-Han,6,0,63,57
1657527499226,COGS 17,A01,092677,Semenuks; Arturs,6,0,81,75
1657527505260,COGS 100,A01,083619,Allen; Michael Gordon,17,0,70,53
1657527511283,COGS 101A,A01,083621,Davis; Joshua Daniel,9,0,68,59
1657527517314,COGS 101B,A01,091572,Allen; Michael Gordon,12,0,65,53
1657527523346,COGS 101C,A01,083625,Delgado; Tania,17,0,35,18
1657527529376,COGS 107A,A01,083627,Boyle; Mary E. T.,13,0,60,47
1657527535411,COGS 118A,A01,083075,Gupta; Anjum,21,0,76,55
1657527541447,CSE 3,A50,083646,Miranda; Gregory Joseph,24,0,50,26
1657527547477,CSE 8A,A50,083650,Miranda; Gregory Joseph,17,1,56,39
1657527553504,CSE 11,A01,083080,Cao; Yingjun,6,15,40,34
1657527559531,CSE 12,A01,083652,Krause-Levy; Sophia Louisa,28,1,120,92
1657527565560,CSE 15L,A01,083654,Morris; Justin Loren,9,0,50,41
1657527565560,CSE 15L,A02,083655,Morris; Justin Loren,9,0,50,41
1657527571585,CSE 20,A01,083657,Tran; Khoa Dang,39,0,80,41
1657527577614,CSE 21,A01,095574,Bach; Quang Tran,22,0,48,26
1657527583653,CSE 30,A01,083084,Eldon; John,5,0,80,75
1657527583653,CSE 30,B01,095061,Bhaskar; Nishant,9,0,50,41
1657527589678,CSE 100,A01,083659,Cao; Yingjun,5,4,70,65
1657527595701,CSE 134B,A01,083661,Powell; Thomas Allan,22,0,100,78
1657527601726,CSE 140,A01,083663,Gungor; Onat,15,0,85,70
1657527607750,CSE 140L,A01,083088,Eldon; John,21,0,100,79
1657527613776,CSE 175,A01,083665,Kumar; Rakesh,3,0,25,22
1657527619800,CSE 190,A00,092507,Dubnov; Shlomo,8,0,20,12
1657527625829,ECE 45,A01,083139,Congero; Spencer William,6,0,75,69
1657527631871,ECE 65,A50,083695,Saad; Andrew S,12,0,30,18
1657527631871,ECE 65,A51,095125,Saad; Andrew S,24,0,26,2
1657527637896,ECE 109,A01,091882,Touri; Behrouz,19,0,70,51
1657527643922,ECE 180,A00,083140,Abi Samra; Nicholas Camill,1,0,30,29
1657527643922,ECE 180,B00,083141,Abi Samra; Nicholas Camill,0,0,30,30
1657527649950,MATH 10A,A01,083735,Patchell; Gregory David,2,0,30,28
1657527649950,MATH 10A,A02,083736,Patchell; Gregory David,20,0,30,10
1657527649950,MATH 10A,A03,083737,Patchell; Gregory David,16,0,30,14
1657527655984,MATH 10B,A01,083207,Lim; Seonhee,8,0,34,26
1657527655984,MATH 10B,A02,083208,Lim; Seonhee,9,0,35,26
1657527655984,MATH 10B,A03,093472,Lim; Seonhee,7,0,34,27
1657527655984,MATH 10B,B01,083739,Sinha; Shubham,12,0,30,18
1657527662104,MATH 18,A01,083743,Cinel; Cameron Alexander,7,0,30,23
1657527662104,MATH 18,A02,083744,Cinel; Cameron Alexander,17,0,30,13
1657527662104,MATH 18,A03,083745,Cinel; Cameron Alexander,9,0,30,21
1657527662104,MATH 18,B01,083748,Rideout; David Porter,5,0,37,32
1657527662104,MATH 18,B02,083749,Rideout; David Porter,5,0,36,31
1657527662104,MATH 18,B03,083750,Rideout; David Porter,3,0,37,34
1657527662104,MATH 18,B04,083751,Rideout; David Porter,6,0,36,30
1657527662104,MATH 18,B05,093473,Rideout; David Porter,6,0,36,30
1657527662104,MATH 18,B06,093474,Rideout; David Porter,6,0,36,30
1657527668134,MATH 20A,A01,083754,Zheng; Zequn,14,0,40,26
1657527674160,MATH 20B,A01,083756,Briones; Jor-el Thomas Caparas,4,0,36,32
1657527674160,MATH 20B,A02,083757,Briones; Jor-el Thomas Caparas,1,0,36,35
1657527674160,MATH 20B,A03,093475,Briones; Jor-el Thomas Caparas,2,0,36,34
1657527680186,MATH 20C,A01,083760,Briones; Jor-el Thomas Caparas,1,0,35,34
1657527680186,MATH 20C,A02,083761,Briones; Jor-el Thomas Caparas,8,0,35,27
1657527680186,MATH 20C,A03,093476,Briones; Jor-el Thomas Caparas,0,1,36,36
1657527680186,MATH 20C,B01,083762,Bach; Quang Tran,1,0,30,29
1657527686221,MATH 20D,A01,083765,Tran; Brian Kha,5,0,30,25
1657527686221,MATH 20D,A02,083766,Tran; Brian Kha,5,0,30,25
1657527686221,MATH 20D,A03,083767,Tran; Brian Kha,5,0,30,25
1657527692253,MATH 20E,A01,083771,Ganguly; Soumya,9,0,32,23
1657527692253,MATH 20E,A02,083772,Ganguly; Soumya,6,0,32,26
1657527692253,MATH 20E,B01,083773,Ciotti; Benjamin,20,0,35,15
1657527692253,MATH 20E,B02,083774,Ciotti; Benjamin,17,0,35,18
1657527698287,MATH 103A,A01,083777,Greenfeld; Be'Eri,3,0,36,33
1657527698287,MATH 103A,A02,083778,Greenfeld; Be'Eri,5,0,36,31
1657527698287,MATH 103A,A03,093561,Greenfeld; Be'Eri,5,0,36,31
1657527698287,MATH 103A,B01,083779,Greenfeld; Be'Eri,7,0,36,29
1657527698287,MATH 103A,B02,083780,Greenfeld; Be'Eri,4,0,36,32
1657527698287,MATH 103A,B03,093562,Greenfeld; Be'Eri,3,0,36,33
1657527704320,MATH 105,A01,085443,Carter; Anne Toulson,15,0,35,20
1657527704320,MATH 105,A02,093477,Carter; Anne Toulson,20,0,35,15
1657527710355,MATH 109,A01,083213,Ganzberger; Geoffrey Michael,2,0,34,32
1657527710355,MATH 109,A02,083214,Ganzberger; Geoffrey Michael,4,0,34,30
1657527710355,MATH 109,A03,093478,Ganzberger; Geoffrey Michael,2,0,34,32
1657527710355,MATH 109,B01,083215,Ganzberger; Geoffrey Michael,1,0,32,31
1657527710355,MATH 109,B02,083216,Ganzberger; Geoffrey Michael,2,0,32,30
1657527710355,MATH 109,B03,093479,Ganzberger; Geoffrey Michael,8,0,32,24
1657527716391,MATH 142A,A01,083219,Chow; Bennett,7,0,32,25
1657527716391,MATH 142A,A02,083220,Chow; Bennett,10,0,32,22
1657527716391,MATH 142A,A03,093480,Chow; Bennett,8,0,32,24
1657527716391,MATH 142A,B03,093481,Chow; Bennett,8,0,32,24
1657527716391,MATH 142A,B04,093558,Chow; Bennett,13,0,32,19
1657527716391,MATH 142A,B05,093559,Chow; Bennett,6,0,32,26
1657527722416,MATH 193A,A01,083224,Rotar; Vladimir,8,0,34,26
1657527722416,MATH 193A,A02,083225,Rotar; Vladimir,9,0,34,25
1657527722416,MATH 193A,A03,083781,Rotar; Vladimir,5,0,34,29
1657527722416,MATH 193A,A04,083782,Rotar; Vladimir,10,0,34,24
1657527722416,MATH 193A,A05,093482,Rotar; Vladimir,10,0,34,24
1657527728442,MATH 197,001,091859,McAuley; Julian John,9999,0,9999,0
1657527728442,MATH 197,002,095566,Kedlaya; Kiran S.,9997,0,9999,2
1657527728442,MATH 197,003,095567,Xiao; Ming,9999,0,9999,0
1657527728442,MATH 197,004,095571,Perols; Johan Lars,9998,0,9999,1
1657527735519,COGS 9,A01,083615,Shannon; Kyle Michael,9,0,75,66
1657527741546,COGS 11,A01,083617,Boyle; Mary E. T.,22,0,48,26
1657527747571,COGS 13,A01,083071,Bastos; Amalia Pinkusfeld,11,0,71,60
1657527753614,COGS 14A,A01,092681,Semenuks; Arturs,5,1,100,95
1657527759642,COGS 14B,A01,083073,Cheng; Tzu-Han,6,0,63,57
1657527765670,COGS 17,A01,092677,Semenuks; Arturs,6,0,81,75
1657527771701,COGS 100,A01,083619,Allen; Michael Gordon,17,0,70,53
1657527777733,COGS 101A,A01,083621,Davis; Joshua Daniel,9,0,68,59
1657527783761,COGS 101B,A01,091572,Allen; Michael Gordon,12,0,65,53
1657527789792,COGS 101C,A01,083625,Delgado; Tania,17,0,35,18
1657527795823,COGS 107A,A01,083627,Boyle; Mary E. T.,13,0,60,47
1657527801853,COGS 118A,A01,083075,Gupta; Anjum,21,0,76,55
1657527807882,CSE 3,A50,083646,Miranda; Gregory Joseph,24,0,50,26
1657527813907,CSE 8A,A50,083650,Miranda; Gregory Joseph,17,1,56,39
1657527819933,CSE 11,A01,083080,Cao; Yingjun,6,15,40,34
1657527825958,CSE 12,A01,083652,Krause-Levy; Sophia Louisa,28,1,120,92
1657527831984,CSE 15L,A01,083654,Morris; Justin Loren,9,0,50,41
1657527831984,CSE 15L,A02,083655,Morris; Justin Loren,9,0,50,41
1657527838012,CSE 20,A01,083657,Tran; Khoa Dang,39,0,80,41
1657527844045,CSE 21,A01,095574,Bach; Quang Tran,22,0,48,26
1657527850070,CSE 30,A01,083084,Eldon; John,5,0,80,75
1657527850070,CSE 30,B01,095061,Bhaskar; Nishant,9,0,50,41
1657527856104,CSE 100,A01,083659,Cao; Yingjun,5,4,70,65
1657527862129,CSE 134B,A01,083661,Powell; Thomas Allan,22,0,100,78
1657527868158,CSE 140,A01,083663,Gungor; Onat,15,0,85,70
1657527874186,CSE 140L,A01,083088,Eldon; John,21,0,100,79
1657527880212,CSE 175,A01,083665,Kumar; Rakesh,3,0,25,22
1657527886237,CSE 190,A00,092507,Dubnov; Shlomo,8,0,20,12
1657527892266,ECE 45,A01,083139,Congero; Spencer William,6,0,75,69
1657527898301,ECE 65,A50,083695,Saad; Andrew S,12,0,30,18
1657527898301,ECE 65,A51,095125,Saad; Andrew S,24,0,26,2
1657527904326,ECE 109,A01,091882,Touri; Behrouz,19,0,70,51
1657527910358,ECE 180,A00,083140,Abi Samra; Nicholas Camill,1,0,30,29
1657527910358,ECE 180,B00,083141,Abi Samra; Nicholas Camill,0,0,30,30
1657527916396,MATH 10A,A01,083735,Patchell; Gregory David,2,0,30,28
1657527916396,MATH 10A,A02,083736,Patchell; Gregory David,20,0,30,10
1657527916396,MATH 10A,A03,083737,Patchell; Gregory David,16,0,30,14
1657527922424,MATH 10B,A01,083207,Lim; Seonhee,8,0,34,26
1657527922424,MATH 10B,A02,083208,Lim; Seonhee,9,0,35,26
1657527922424,MATH 10B,A03,093472,Lim; Seonhee,7,0,34,27
1657527922424,MATH 10B,B01,083739,Sinha; Shubham,12,0,30,18
1657527928467,MATH 18,A01,083743,Cinel; Cameron Alexander,7,0,30,23
1657527928467,MATH 18,A02,083744,Cinel; Cameron Alexander,17,0,30,13
1657527928467,MATH 18,A03,083745,Cinel; Cameron Alexander,9,0,30,21
1657527928467,MATH 18,B01,083748,Rideout; David Porter,5,0,37,32
1657527928467,MATH 18,B02,083749,Rideout; David Porter,5,0,36,31
1657527928467,MATH 18,B03,083750,Rideout; David Porter,3,0,37,34
1657527928467,MATH 18,B04,083751,Rideout; David Porter,6,0,36,30
1657527928467,MATH 18,B05,093473,Rideout; David Porter,6,0,36,30
1657527928467,MATH 18,B06,093474,Rideout; David Porter,6,0,36,30
1657527934497,MATH 20A,A01,083754,Zheng; Zequn,14,0,40,26
1657527940524,MATH 20B,A01,083756,Briones; Jor-el Thomas Caparas,4,0,36,32
1657527940524,MATH 20B,A02,083757,Briones; Jor-el Thomas Caparas,1,0,36,35
1657527940524,MATH 20B,A03,093475,Briones; Jor-el Thomas Caparas,2,0,36,34
1657527946554,MATH 20C,A01,083760,Briones; Jor-el Thomas Caparas,1,0,35,34
1657527946554,MATH 20C,A02,083761,Briones; Jor-el Thomas Caparas,8,0,35,27
1657527946554,MATH 20C,A03,093476,Briones; Jor-el Thomas Caparas,0,1,36,36
1657527946554,MATH 20C,B01,083762,Bach; Quang Tran,1,0,30,29
1657527952579,MATH 20D,A01,083765,Tran; Brian Kha,5,0,30,25
1657527952579,MATH 20D,A02,083766,Tran; Brian Kha,5,0,30,25
1657527952579,MATH 20D,A03,083767,Tran; Brian Kha,5,0,30,25
1657527958607,MATH 20E,A01,083771,Ganguly; Soumya,9,0,32,23
1657527958607,MATH 20E,A02,083772,Ganguly; Soumya,6,0,32,26
1657527958607,MATH 20E,B01,083773,Ciotti; Benjamin,20,0,35,15
1657527958607,MATH 20E,B02,083774,Ciotti; Benjamin,17,0,35,18
1657527964636,MATH 103A,A01,083777,Greenfeld; Be'Eri,3,0,36,33
1657527964636,MATH 103A,A02,083778,Greenfeld; Be'Eri,5,0,36,31
1657527964636,MATH 103A,A03,093561,Greenfeld; Be'Eri,5,0,36,31
1657527964636,MATH 103A,B01,083779,Greenfeld; Be'Eri,7,0,36,29
1657527964636,MATH 103A,B02,083780,Greenfeld; Be'Eri,4,0,36,32
1657527964636,MATH 103A,B03,093562,Greenfeld; Be'Eri,3,0,36,33
1657527970666,MATH 105,A01,085443,Carter; Anne Toulson,15,0,35,20
1657527970666,MATH 105,A02,093477,Carter; Anne Toulson,20,0,35,15
1657527976697,MATH 109,A01,083213,Ganzberger; Geoffrey Michael,2,0,34,32
1657527976697,MATH 109,A02,083214,Ganzberger; Geoffrey Michael,4,0,34,30
1657527976697,MATH 109,A03,093478,Ganzberger; Geoffrey Michael,2,0,34,32
1657527976697,MATH 109,B01,083215,Ganzberger; Geoffrey Michael,1,0,32,31
1657527976697,MATH 109,B02,083216,Ganzberger; Geoffrey Michael,2,0,32,30
1657527976697,MATH 109,B03,093479,Ganzberger; Geoffrey Michael,8,0,32,24
1657527982723,MATH 142A,A01,083219,Chow; Bennett,7,0,32,25
1657527982723,MATH 142A,A02,083220,Chow; Bennett,10,0,32,22
1657527982723,MATH 142A,A03,093480,Chow; Bennett,8,0,32,24
1657527982723,MATH 142A,B03,093481,Chow; Bennett,8,0,32,24
1657527982723,MATH 142A,B04,093558,Chow; Bennett,13,0,32,19
1657527982723,MATH 142A,B05,093559,Chow; Bennett,6,0,32,26
1657527988757,MATH 193A,A01,083224,Rotar; Vladimir,8,0,34,26
1657527988757,MATH 193A,A02,083225,Rotar; Vladimir,9,0,34,25
1657527988757,MATH 193A,A03,083781,Rotar; Vladimir,5,0,34,29
1657527988757,MATH 193A,A04,083782,Rotar; Vladimir,10,0,34,24
1657527988757,MATH 193A,A05,093482,Rotar; Vladimir,10,0,34,24
1657527994792,MATH 197,001,091859,McAuley; Julian John,9999,0,9999,0
1657527994792,MATH 197,002,095566,Kedlaya; Kiran S.,9997,0,9999,2
1657527994792,MATH 197,003,095567,Xiao; Ming,9999,0,9999,0
1657527994792,MATH 197,004,095571,Perols; Johan Lars,9998,0,9999,1
1657528001894,COGS 9,A01,083615,Shannon; Kyle Michael,9,0,75,66
1657528007927,COGS 11,A01,083617,Boyle; Mary E. T.,22,0,48,26
1657528013961,COGS 13,A01,083071,Bastos; Amalia Pinkusfeld,11,0,71,60
1657528019993,COGS 14A,A01,092681,Semenuks; Arturs,5,1,100,95
1657528026017,COGS 14B,A01,083073,Cheng; Tzu-Han,6,0,63,57
1657528032042,COGS 17,A01,092677,Semenuks; Arturs,6,0,81,75
1657528038069,COGS 100,A01,083619,Allen; Michael Gordon,17,0,70,53
1657528044094,COGS 101A,A01,083621,Davis; Joshua Daniel,9,0,68,59
1657528050120,COGS 101B,A01,091572,Allen; Michael Gordon,12,0,65,53
1657528056149,COGS 101C,A01,083625,Delgado; Tania,17,0,35,18
1657528062177,COGS 107A,A01,083627,Boyle; Mary E. T.,13,0,60,47
1657528068204,COGS 118A,A01,083075,Gupta; Anjum,21,0,76,55
1657528074241,CSE 3,A50,083646,Miranda; Gregory Joseph,24,0,50,26
1657528080264,CSE 8A,A50,083650,Miranda; Gregory Joseph,17,1,56,39
1657528086295,CSE 11,A01,083080,Cao; Yingjun,6,15,40,34
1657528092322,CSE 12,A01,083652,Krause-Levy; Sophia Louisa,28,1,120,92
1657528098347,CSE 15L,A01,083654,Morris; Justin Loren,9,0,50,41
1657528098347,CSE 15L,A02,083655,Morris; Justin Loren,9,0,50,41
1657528104378,CSE 20,A01,083657,Tran; Khoa Dang,39,0,80,41
1657528110404,CSE 21,A01,095574,Bach; Quang Tran,22,0,48,26
1657528116437,CSE 30,A01,083084,Eldon; John,5,0,80,75
1657528116437,CSE 30,B01,095061,Bhaskar; Nishant,9,0,50,41
1657528122461,CSE 100,A01,083659,Cao; Yingjun,5,4,70,65
1657528128495,CSE 134B,A01,083661,Powell; Thomas Allan,22,0,100,78
1657528134518,CSE 140,A01,083663,Gungor; Onat,15,0,85,70
1657528140546,CSE 140L,A01,083088,Eldon; John,21,0,100,79
1657528146577,CSE 175,A01,083665,Kumar; Rakesh,3,0,25,22
1657528152608,CSE 190,A00,092507,Dubnov; Shlomo,8,0,20,12
1657528158634,ECE 45,A01,083139,Congero; Spencer William,6,0,75,69
1657528164661,ECE 65,A50,083695,Saad; Andrew S,12,0,30,18
1657528164661,ECE 65,A51,095125,Saad; Andrew S,24,0,26,2
1657528170689,ECE 109,A01,091882,Touri; Behrouz,19,0,70,51
1657528176722,ECE 180,A00,083140,Abi Samra; Nicholas Camill,1,0,30,29
1657528176722,ECE 180,B00,083141,Abi Samra; Nicholas Camill,0,0,30,30
1657528182749,MATH 10A,A01,083735,Patchell; Gregory David,2,0,30,28
1657528182749,MATH 10A,A02,083736,Patchell; Gregory David,20,0,30,10
1657528182749,MATH 10A,A03,083737,Patchell; Gregory David,16,0,30,14
1657528188779,MATH 10B,A01,083207,Lim; Seonhee,8,0,34,26
1657528188779,MATH 10B,A02,083208,Lim; Seonhee,9,0,35,26
1657528188779,MATH 10B,A03,093472,Lim; Seonhee,7,0,34,27
1657528188779,MATH 10B,B01,083739,Sinha; Shubham,12,0,30,18
1657528194810,MATH 18,A01,083743,Cinel; Cameron Alexander,7,0,30,23
1657528194810,MATH 18,A02,083744,Cinel; Cameron Alexander,17,0,30,13
1657528194810,MATH 18,A03,083745,Cinel; Cameron Alexander,9,0,30,21
1657528194810,MATH 18,B01,083748,Rideout; David Porter,5,0,37,32
1657528194810,MATH 18,B02,083749,Rideout; David Porter,5,0,36,31
1657528194810,MATH 18,B03,083750,Rideout; David Porter,3,0,37,34
1657528194810,MATH 18,B04,083751,Rideout; David Porter,6,0,36,30
1657528194810,MATH 18,B05,093473,Rideout; David Porter,6,0,36,30
1657528194810,MATH 18,B06,093474,Rideout; David Porter,6,0,36,30
1657528200836,MATH 20A,A01,083754,Zheng; Zequn,14,0,40,26
1657528206862,MATH 20B,A01,083756,Briones; Jor-el Thomas Caparas,4,0,36,32
1657528206862,MATH 20B,A02,083757,Briones; Jor-el Thomas Caparas,1,0,36,35
1657528206862,MATH 20B,A03,093475,Briones; Jor-el Thomas Caparas,2,0,36,34
1657528212893,MATH 20C,A01,083760,Briones; Jor-el Thomas Caparas,1,0,35,34
1657528212893,MATH 20C,A02,083761,Briones; Jor-el Thomas Caparas,8,0,35,27
1657528212893,MATH 20C,A03,093476,Briones; Jor-el Thomas Caparas,0,1,36,36
1657528212893,MATH 20C,B01,083762,Bach; Quang Tran,1,0,30,29
1657528218922,MATH 20D,A01,083765,Tran; Brian Kha,5,0,30,25
1657528218922,MATH 20D,A02,083766,Tran; Brian Kha,5,0,30,25
1657528218922,MATH 20D,A03,083767,Tran; Brian Kha,5,0,30,25
1657528224947,MATH 20E,A01,083771,Ganguly; Soumya,9,0,32,23
1657528224947,MATH 20E,A02,083772,Ganguly; Soumya,6,0,32,26
1657528224947,MATH 20E,B01,083773,Ciotti; Benjamin,20,0,35,15
1657528224947,MATH 20E,B02,083774,Ciotti; Benjamin,17,0,35,18
1657528230974,MATH 103A,A01,083777,Greenfeld; Be'Eri,3,0,36,33
1657528230974,MATH 103A,A02,083778,Greenfeld; Be'Eri,5,0,36,31
1657528230974,MATH 103A,A03,093561,Greenfeld; Be'Eri,5,0,36,31
1657528230974,MATH 103A,B01,083779,Greenfeld; Be'Eri,7,0,36,29
1657528230974,MATH 103A,B02,083780,Greenfeld; Be'Eri,4,0,36,32
1657528230974,MATH 103A,B03,093562,Greenfeld; Be'Eri,3,0,36,33
1657528237006,MATH 105,A01,085443,Carter; Anne Toulson,15,0,35,20
1657528237006,MATH 105,A02,093477,Carter; Anne Toulson,20,0,35,15
1657528243038,MATH 109,A01,083213,Ganzberger; Geoffrey Michael,2,0,34,32
1657528243038,MATH 109,A02,083214,Ganzberger; Geoffrey Michael,4,0,34,30
1657528243038,MATH 109,A03,093478,Ganzberger; Geoffrey Michael,2,0,34,32
1657528243038,MATH 109,B01,083215,Ganzberger; Geoffrey Michael,1,0,32,31
1657528243038,MATH 109,B02,083216,Ganzberger; Geoffrey Michael,2,0,32,30
1657528243038,MATH 109,B03,093479,Ganzberger; Geoffrey Michael,8,0,32,24
1657528249065,MATH 142A,A01,083219,Chow; Bennett,7,0,32,25
1657528249065,MATH 142A,A02,083220,Chow; Bennett,10,0,32,22
1657528249065,MATH 142A,A03,093480,Chow; Bennett,8,0,32,24
1657528249065,MATH 142A,B03,093481,Chow; Bennett,8,0,32,24
1657528249065,MATH 142A,B04,093558,Chow; Bennett,13,0,32,19
1657528249065,MATH 142A,B05,093559,Chow; Bennett,6,0,32,26
1657528255090,MATH 193A,A01,083224,Rotar; Vladimir,8,0,34,26
1657528255090,MATH 193A,A02,083225,Rotar; Vladimir,9,0,34,25
1657528255090,MATH 193A,A03,083781,Rotar; Vladimir,5,0,34,29
1657528255090,MATH 193A,A04,083782,Rotar; Vladimir,10,0,34,24
1657528255090,MATH 193A,A05,093482,Rotar; Vladimir,10,0,34,24
1657528261225,MATH 197,001,091859,McAuley; Julian John,9999,0,9999,0
1657528261225,MATH 197,002,095566,Kedlaya; Kiran S.,9997,0,9999,2
1657528261225,MATH 197,003,095567,Xiao; Ming,9999,0,9999,0
1657528261225,MATH 197,004,095571,Perols; Johan Lars,9998,0,9999,1
1657528268298,COGS 9,A01,083615,Shannon; Kyle Michael,9,0,75,66
1657528274332,COGS 11,A01,083617,Boyle; Mary E. T.,22,0,48,26
1657528280358,COGS 13,A01,083071,Bastos; Amalia Pinkusfeld,11,0,71,60
1657528286382,COGS 14A,A01,092681,Semenuks; Arturs,5,1,100,95
1657528292408,COGS 14B,A01,083073,Cheng; Tzu-Han,6,0,63,57
1657528298433,COGS 17,A01,092677,Semenuks; Arturs,6,0,81,75
1657528304464,COGS 100,A01,083619,Allen; Michael Gordon,17,0,70,53
1657528310488,COGS 101A,A01,083621,Davis; Joshua Daniel,9,0,68,59
1657528316513,COGS 101B,A01,091572,Allen; Michael Gordon,12,0,65,53
1657528322539,COGS 101C,A01,083625,Delgado; Tania,17,0,35,18
1657528328562,COGS 107A,A01,083627,Boyle; Mary E. T.,13,0,60,47
1657528334594,COGS 118A,A01,083075,Gupta; Anjum,21,0,76,55
1657528340620,CSE 3,A50,083646,Miranda; Gregory Joseph,24,0,50,26
1657528346643,CSE 8A,A50,083650,Miranda; Gregory Joseph,17,1,56,39
1657528352668,CSE 11,A01,083080,Cao; Yingjun,6,15,40,34
1657528358702,CSE 12,A01,083652,Krause-Levy; Sophia Louisa,28,1,120,92
1657528364731,CSE 15L,A01,083654,Morris; Justin Loren,9,0,50,41
1657528364731,CSE 15L,A02,083655,Morris; Justin Loren,9,0,50,41
1657528370755,CSE 20,A01,083657,Tran; Khoa Dang,39,0,80,41
1657528376785,CSE 21,A01,095574,Bach; Quang Tran,22,0,48,26
1657528382812,CSE 30,A01,083084,Eldon; John,5,0,80,75
1657528382812,CSE 30,B01,095061,Bhaskar; Nishant,9,0,50,41
1657528388838,CSE 100,A01,083659,Cao; Yingjun,5,4,70,65
1657528394867,CSE 134B,A01,083661,Powell; Thomas Allan,22,0,100,78
1657528400894,CSE 140,A01,083663,Gungor; Onat,15,0,85,70
1657528406921,CSE 140L,A01,083088,Eldon; John,21,0,100,79
1657528412947,CSE 175,A01,083665,Kumar; Rakesh,3,0,25,22
1657528418971,CSE 190,A00,092507,Dubnov; Shlomo,8,0,20,12
1657528424997,ECE 45,A01,083139,Congero; Spencer William,6,0,75,69
1657528431030,ECE 65,A50,083695,Saad; Andrew S,12,0,30,18
1657528431030,ECE 65,A51,095125,Saad; Andrew S,24,0,26,2
1657528437062,ECE 109,A01,091882,Touri; Behrouz,19,0,70,51
1657528443106,ECE 180,A00,083140,Abi Samra; Nicholas Camill,1,0,30,29
1657528443106,ECE 180,B00,083141,Abi Samra; Nicholas Camill,0,0,30,30
1657528449132,MATH 10A,A01,083735,Patchell; Gregory David,2,0,30,28
1657528449132,MATH 10A,A02,083736,Patchell; Gregory David,20,0,30,10
1657528449132,MATH 10A,A03,083737,Patchell; Gregory David,16,0,30,14
1657528455160,MATH 10B,A01,083207,Lim; Seonhee,8,0,34,26
1657528455160,MATH 10B,A02,083208,Lim; Seonhee,9,0,35,26
1657528455160,MATH 10B,A03,093472,Lim; Seonhee,7,0,34,27
1657528455160,MATH 10B,B01,083739,Sinha; Shubham,12,0,30,18
1657528461189,MATH 18,A01,083743,Cinel; Cameron Alexander,7,0,30,23
1657528461189,MATH 18,A02,083744,Cinel; Cameron Alexander,17,0,30,13
1657528461189,MATH 18,A03,083745,Cinel; Cameron Alexander,9,0,30,21
1657528461189,MATH 18,B01,083748,Rideout; David Porter,5,0,37,32
1657528461189,MATH 18,B02,083749,Rideout; David Porter,5,0,36,31
1657528461189,MATH 18,B03,083750,Rideout; David Porter,3,0,37,34
1657528461189,MATH 18,B04,083751,Rideout; David Porter,6,0,36,30
1657528461189,MATH 18,B05,093473,Rideout; David Porter,6,0,36,30
1657528461189,MATH 18,B06,093474,Rideout; David Porter,6,0,36,30
1657528467219,MATH 20A,A01,083754,Zheng; Zequn,14,0,40,26
1657528473251,MATH 20B,A01,083756,Briones; Jor-el Thomas Caparas,4,0,36,32
1657528473251,MATH 20B,A02,083757,Briones; Jor-el Thomas Caparas,1,0,36,35
1657528473251,MATH 20B,A03,093475,Briones; Jor-el Thomas Caparas,2,0,36,34
1657528479279,MATH 20C,A01,083760,Briones; Jor-el Thomas Caparas,1,0,35,34
1657528479279,MATH 20C,A02,083761,Briones; Jor-el Thomas Caparas,8,0,35,27
1657528479279,MATH 20C,A03,093476,Briones; Jor-el Thomas Caparas,0,1,36,36
1657528479279,MATH 20C,B01,083762,Bach; Quang Tran,1,0,30,29
1657528485310,MATH 20D,A01,083765,Tran; Brian Kha,5,0,30,25
1657528485310,MATH 20D,A02,083766,Tran; Brian Kha,5,0,30,25
1657528485310,MATH 20D,A03,083767,Tran; Brian Kha,5,0,30,25
1657528491336,MATH 20E,A01,083771,Ganguly; Soumya,9,0,32,23
1657528491336,MATH 20E,A02,083772,Ganguly; Soumya,6,0,32,26
1657528491336,MATH 20E,B01,083773,Ciotti; Benjamin,20,0,35,15
1657528491336,MATH 20E,B02,083774,Ciotti; Benjamin,17,0,35,18
1657528497364,MATH 103A,A01,083777,Greenfeld; Be'Eri,3,0,36,33
1657528497364,MATH 103A,A02,083778,Greenfeld; Be'Eri,5,0,36,31
1657528497364,MATH 103A,A03,093561,Greenfeld; Be'Eri,5,0,36,31
1657528497364,MATH 103A,B01,083779,Greenfeld; Be'Eri,7,0,36,29
1657528497364,MATH 103A,B02,083780,Greenfeld; Be'Eri,4,0,36,32
1657528497364,MATH 103A,B03,093562,Greenfeld; Be'Eri,3,0,36,33
1657528503389,MATH 105,A01,085443,Carter; Anne Toulson,15,0,35,20
1657528503389,MATH 105,A02,093477,Carter; Anne Toulson,20,0,35,15
1657528509423,MATH 109,A01,083213,Ganzberger; Geoffrey Michael,2,0,34,32
1657528509423,MATH 109,A02,083214,Ganzberger; Geoffrey Michael,4,0,34,30
1657528509423,MATH 109,A03,093478,Ganzberger; Geoffrey Michael,2,0,34,32
1657528509423,MATH 109,B01,083215,Ganzberger; Geoffrey Michael,1,0,32,31
1657528509423,MATH 109,B02,083216,Ganzberger; Geoffrey Michael,2,0,32,30
1657528509423,MATH 109,B03,093479,Ganzberger; Geoffrey Michael,8,0,32,24
1657528515458,MATH 142A,A01,083219,Chow; Bennett,7,0,32,25
1657528515458,MATH 142A,A02,083220,Chow; Bennett,10,0,32,22
1657528515458,MATH 142A,A03,093480,Chow; Bennett,8,0,32,24
1657528515458,MATH 142A,B03,093481,Chow; Bennett,8,0,32,24
1657528515458,MATH 142A,B04,093558,Chow; Bennett,13,0,32,19
1657528515458,MATH 142A,B05,093559,Chow; Bennett,6,0,32,26
1657528521484,MATH 193A,A01,083224,Rotar; Vladimir,8,0,34,26
1657528521484,MATH 193A,A02,083225,Rotar; Vladimir,9,0,34,25
1657528521484,MATH 193A,A03,083781,Rotar; Vladimir,5,0,34,29
1657528521484,MATH 193A,A04,083782,Rotar; Vladimir,10,0,34,24
1657528521484,MATH 193A,A05,093482,Rotar; Vladimir,10,0,34,24
1657528527509,MATH 197,001,091859,McAuley; Julian John,9999,0,9999,0
1657528527509,MATH 197,002,095566,Kedlaya; Kiran S.,9997,0,9999,2
1657528527509,MATH 197,003,095567,Xiao; Ming,9999,0,9999,0
1657528527509,MATH 197,004,095571,Perols; Johan Lars,9998,0,9999,1
1657528534585,COGS 9,A01,083615,Shannon; Kyle Michael,9,0,75,66
1657528540610,COGS 11,A01,083617,Boyle; Mary E. T.,22,0,48,26
1657528546636,COGS 13,A01,083071,Bastos; Amalia Pinkusfeld,11,0,71,60
1657528552667,COGS 14A,A01,092681,Semenuks; Arturs,5,1,100,95
1657528558695,COGS 14B,A01,083073,Cheng; Tzu-Han,6,0,63,57
1657528564720,COGS 17,A01,092677,Semenuks; Arturs,6,0,81,75
1657528570753,COGS 100,A01,083619,Allen; Michael Gordon,17,0,70,53
1657528576778,COGS 101A,A01,083621,Davis; Joshua Daniel,9,0,68,59
1657528582807,COGS 101B,A01,091572,Allen; Michael Gordon,12,0,65,53
1657528588835,COGS 101C,A01,083625,Delgado; Tania,17,0,35,18
1657528594865,COGS 107A,A01,083627,Boyle; Mary E. T.,13,0,60,47
1657528600891,COGS 118A,A01,083075,Gupta; Anjum,21,0,76,55
1657528606917,CSE 3,A50,083646,Miranda; Gregory Joseph,24,0,50,26
1657528612942,CSE 8A,A50,083650,Miranda; Gregory Joseph,17,1,56,39
1657528618967,CSE 11,A01,083080,Cao; Yingjun,6,15,40,34
1657528624991,CSE 12,A01,083652,Krause-Levy; Sophia Louisa,28,1,120,92
1657528631017,CSE 15L,A01,083654,Morris; Justin Loren,9,0,50,41
1657528631017,CSE 15L,A02,083655,Morris; Justin Loren,9,0,50,41
1657528637041,CSE 20,A01,083657,Tran; Khoa Dang,39,0,80,41
1657528643077,CSE 21,A01,095574,Bach; Quang Tran,22,0,48,26
1657528649103,CSE 30,A01,083084,Eldon; John,5,0,80,75
1657528649103,CSE 30,B01,095061,Bhaskar; Nishant,9,0,50,41
1657528655131,CSE 100,A01,083659,Cao; Yingjun,5,4,70,65
1657528661156,CSE 134B,A01,083661,Powell; Thomas Allan,22,0,100,78
1657528667180,CSE 140,A01,083663,Gungor; Onat,15,0,85,70
1657528673208,CSE 140L,A01,083088,Eldon; John,21,0,100,79
1657528679233,CSE 175,A01,083665,Kumar; Rakesh,3,0,25,22
1657528685263,CSE 190,A00,092507,Dubnov; Shlomo,8,0,20,12
1657528691297,ECE 45,A01,083139,Congero; Spencer William,6,0,75,69
1657528697324,ECE 65,A50,083695,Saad; Andrew S,12,0,30,18
1657528697324,ECE 65,A51,095125,Saad; Andrew S,24,0,26,2
1657528703348,ECE 109,A01,091882,Touri; Behrouz,19,0,70,51
1657528709377,ECE 180,A00,083140,Abi Samra; Nicholas Camill,1,0,30,29
1657528709377,ECE 180,B00,083141,Abi Samra; Nicholas Camill,0,0,30,30
1657528715408,MATH 10A,A01,083735,Patchell; Gregory David,2,0,30,28
1657528715408,MATH 10A,A02,083736,Patchell; Gregory David,20,0,30,10
1657528715408,MATH 10A,A03,083737,Patchell; Gregory David,16,0,30,14
1657528721440,MATH 10B,A01,083207,Lim; Seonhee,8,0,34,26
1657528721440,MATH 10B,A02,083208,Lim; Seonhee,9,0,35,26
1657528721440,MATH 10B,A03,093472,Lim; Seonhee,7,0,34,27
1657528721440,MATH 10B,B01,083739,Sinha; Shubham,12,0,30,18
1657528727479,MATH 18,A01,083743,Cinel; Cameron Alexander,7,0,30,23
1657528727479,MATH 18,A02,083744,Cinel; Cameron Alexander,17,0,30,13
1657528727479,MATH 18,A03,083745,Cinel; Cameron Alexander,9,0,30,21
1657528727479,MATH 18,B01,083748,Rideout; David Porter,5,0,37,32
1657528727479,MATH 18,B02,083749,Rideout; David Porter,5,0,36,31
1657528727479,MATH 18,B03,083750,Rideout; David Porter,3,0,37,34
1657528727479,MATH 18,B04,083751,Rideout; David Porter,6,0,36,30
1657528727479,MATH 18,B05,093473,Rideout; David Porter,6,0,36,30
1657528727479,MATH 18,B06,093474,Rideout; David Porter,6,0,36,30
1657528733506,MATH 20A,A01,083754,Zheng; Zequn,14,0,40,26
1657528739530,MATH 20B,A01,083756,Briones; Jor-el Thomas Caparas,4,0,36,32
1657528739530,MATH 20B,A02,083757,Briones; Jor-el Thomas Caparas,1,0,36,35
1657528739530,MATH 20B,A03,093475,Briones; Jor-el Thomas Caparas,2,0,36,34
1657528745558,MATH 20C,A01,083760,Briones; Jor-el Thomas Caparas,1,0,35,34
1657528745558,MATH 20C,A02,083761,Briones; Jor-el Thomas Caparas,8,0,35,27
1657528745558,MATH 20C,A03,093476,Briones; Jor-el Thomas Caparas,0,1,36,36
1657528745558,MATH 20C,B01,083762,Bach; Quang Tran,1,0,30,29
1657528751583,MATH 20D,A01,083765,Tran; Brian Kha,5,0,30,25
1657528751583,MATH 20D,A02,083766,Tran; Brian Kha,5,0,30,25
1657528751583,MATH 20D,A03,083767,Tran; Brian Kha,5,0,30,25
1657528757610,MATH 20E,A01,083771,Ganguly; Soumya,9,0,32,23
1657528757610,MATH 20E,A02,083772,Ganguly; Soumya,6,0,32,26
1657528757610,MATH 20E,B01,083773,Ciotti; Benjamin,20,0,35,15
1657528757610,MATH 20E,B02,083774,Ciotti; Benjamin,17,0,35,18
1657528763640,MATH 103A,A01,083777,Greenfeld; Be'Eri,3,0,36,33
1657528763640,MATH 103A,A02,083778,Greenfeld; Be'Eri,5,0,36,31
1657528763640,MATH 103A,A03,093561,Greenfeld; Be'Eri,5,0,36,31
1657528763640,MATH 103A,B01,083779,Greenfeld; Be'Eri,7,0,36,29
1657528763640,MATH 103A,B02,083780,Greenfeld; Be'Eri,4,0,36,32
1657528763640,MATH 103A,B03,093562,Greenfeld; Be'Eri,3,0,36,33
1657528769679,MATH 105,A01,085443,Carter; Anne Toulson,15,0,35,20
1657528769679,MATH 105,A02,093477,Carter; Anne Toulson,20,0,35,15
1657528775708,MATH 109,A01,083213,Ganzberger; Geoffrey Michael,2,0,34,32
1657528775708,MATH 109,A02,083214,Ganzberger; Geoffrey Michael,4,0,34,30
1657528775708,MATH 109,A03,093478,Ganzberger; Geoffrey Michael,2,0,34,32
1657528775708,MATH 109,B01,083215,Ganzberger; Geoffrey Michael,1,0,32,31
1657528775708,MATH 109,B02,083216,Ganzberger; Geoffrey Michael,2,0,32,30
1657528775708,MATH 109,B03,093479,Ganzberger; Geoffrey Michael,8,0,32,24
1657528781740,MATH 142A,A01,083219,Chow; Bennett,7,0,32,25
1657528781740,MATH 142A,A02,083220,Chow; Bennett,10,0,32,22
1657528781740,MATH 142A,A03,093480,Chow; Bennett,8,0,32,24
1657528781740,MATH 142A,B03,093481,Chow; Bennett,8,0,32,24
1657528781740,MATH 142A,B04,093558,Chow; Bennett,13,0,32,19
1657528781740,MATH 142A,B05,093559,Chow; Bennett,6,0,32,26
1657528787762,MATH 193A,A01,083224,Rotar; Vladimir,8,0,34,26
1657528787762,MATH 193A,A02,083225,Rotar; Vladimir,9,0,34,25
1657528787762,MATH 193A,A03,083781,Rotar; Vladimir,5,0,34,29
1657528787762,MATH 193A,A04,083782,Rotar; Vladimir,10,0,34,24
1657528787762,MATH 193A,A05,093482,Rotar; Vladimir,10,0,34,24
1657528793786,MATH 197,001,091859,McAuley; Julian John,9999,0,9999,0
1657528793786,MATH 197,002,095566,Kedlaya; Kiran S.,9997,0,9999,2
1657528793786,MATH 197,003,095567,Xiao; Ming,9999,0,9999,0
1657528793786,MATH 197,004,095571,Perols; Johan Lars,9998,0,9999,1
1657528800852,COGS 9,A01,083615,Shannon; Kyle Michael,9,0,75,66
1657528806875,COGS 11,A01,083617,Boyle; Mary E. T.,22,0,48,26
1657528812902,COGS 13,A01,083071,Bastos; Amalia Pinkusfeld,11,0,71,60
1657528818928,COGS 14A,A01,092681,Semenuks; Arturs,5,1,100,95
1657528824951,COGS 14B,A01,083073,Cheng; Tzu-Han,6,0,63,57
1657528830973,COGS 17,A01,092677,Semenuks; Arturs,6,0,81,75
1657528836996,COGS 100,A01,083619,Allen; Michael Gordon,17,0,70,53
1657528843018,COGS 101A,A01,083621,Davis; Joshua Daniel,9,0,68,59
1657528849043,COGS 101B,A01,091572,Allen; Michael Gordon,12,0,65,53
1657528855153,COGS 101C,A01,083625,Delgado; Tania,17,0,35,18
1657528861176,COGS 107A,A01,083627,Boyle; Mary E. T.,13,0,60,47
1657528867200,COGS 118A,A01,083075,Gupta; Anjum,21,0,76,55
1657528873224,CSE 3,A50,083646,Miranda; Gregory Joseph,24,0,50,26
1657528879250,CSE 8A,A50,083650,Miranda; Gregory Joseph,17,1,56,39
1657528885273,CSE 11,A01,083080,Cao; Yingjun,6,15,40,34
1657528891300,CSE 12,A01,083652,Krause-Levy; Sophia Louisa,28,1,120,92
1657528897324,CSE 15L,A01,083654,Morris; Justin Loren,9,0,50,41
1657528897324,CSE 15L,A02,083655,Morris; Justin Loren,9,0,50,41
1657528903350,CSE 20,A01,083657,Tran; Khoa Dang,39,0,80,41
1657528909375,CSE 21,A01,095574,Bach; Quang Tran,22,0,48,26
1657528915398,CSE 30,A01,083084,Eldon; John,5,0,80,75
1657528915398,CSE 30,B01,095061,Bhaskar; Nishant,9,0,50,41
1657528921420,CSE 100,A01,083659,Cao; Yingjun,5,4,70,65
1657528927444,CSE 134B,A01,083661,Powell; Thomas Allan,22,0,100,78
1657528933472,CSE 140,A01,083663,Gungor; Onat,15,0,85,70
1657528939500,CSE 140L,A01,083088,Eldon; John,21,0,100,79
1657528945528,CSE 175,A01,083665,Kumar; Rakesh,3,0,25,22
1657528951550,CSE 190,A00,092507,Dubnov; Shlomo,8,0,20,12
1657528957579,ECE 45,A01,083139,Congero; Spencer William,6,0,75,69
1657528963603,ECE 65,A50,083695,Saad; Andrew S,12,0,30,18
1657528963603,ECE 65,A51,095125,Saad; Andrew S,24,0,26,2
1657528969631,ECE 109,A01,091882,Touri; Behrouz,19,0,70,51
1657528975653,ECE 180,A00,083140,Abi Samra; Nicholas Camill,1,0,30,29
1657528975653,ECE 180,B00,083141,Abi Samra; Nicholas Camill,0,0,30,30
1657528981678,MATH 10A,A01,083735,Patchell; Gregory David,2,0,30,28
1657528981678,MATH 10A,A02,083736,Patchell; Gregory David,20,0,30,10
1657528981678,MATH 10A,A03,083737,Patchell; Gregory David,16,0,30,14
1657528987701,MATH 10B,A01,083207,Lim; Seonhee,8,0,34,26
1657528987701,MATH 10B,A02,083208,Lim; Seonhee,9,0,35,26
1657528987701,MATH 10B,A03,093472,Lim; Seonhee,7,0,34,27
1657528987701,MATH 10B,B01,083739,Sinha; Shubham,12,0,30,18
1657528993725,MATH 18,A01,083743,Cinel; Cameron Alexander,7,0,30,23
1657528993725,MATH 18,A02,083744,Cinel; Cameron Alexander,17,0,30,13
1657528993725,MATH 18,A03,083745,Cinel; Cameron Alexander,9,0,30,21
1657528993725,MATH 18,B01,083748,Rideout; David Porter,5,0,37,32
1657528993725,MATH 18,B02,083749,Rideout; David Porter,5,0,36,31
1657528993725,MATH 18,B03,083750,Rideout; David Porter,3,0,37,34
1657528993725,MATH 18,B04,083751,Rideout; David Porter,6,0,36,30
1657528993725,MATH 18,B05,093473,Rideout; David Porter,6,0,36,30
1657528993725,MATH 18,B06,093474,Rideout; David Porter,6,0,36,30
1657528999748,MATH 20A,A01,083754,Zheng; Zequn,14,0,40,26
1657529005785,MATH 20B,A01,083756,Briones; Jor-el Thomas Caparas,4,0,36,32
1657529005785,MATH 20B,A02,083757,Briones; Jor-el Thomas Caparas,1,0,36,35
1657529005785,MATH 20B,A03,093475,Briones; Jor-el Thomas Caparas,2,0,36,34
1657529011808,MATH 20C,A01,083760,Briones; Jor-el Thomas Caparas,1,0,35,34
1657529011808,MATH 20C,A02,083761,Briones; Jor-el Thomas Caparas,8,0,35,27
1657529011808,MATH 20C,A03,093476,Briones; Jor-el Thomas Caparas,0,1,36,36
1657529011808,MATH 20C,B01,083762,Bach; Quang Tran,1,0,30,29
1657529017832,MATH 20D,A01,083765,Tran; Brian Kha,5,0,30,25
1657529017832,MATH 20D,A02,083766,Tran; Brian Kha,5,0,30,25
1657529017832,MATH 20D,A03,083767,Tran; Brian Kha,5,0,30,25
1657529023859,MATH 20E,A01,083771,Ganguly; Soumya,9,0,32,23
1657529023859,MATH 20E,A02,083772,Ganguly; Soumya,6,0,32,26
1657529023859,MATH 20E,B01,083773,Ciotti; Benjamin,20,0,35,15
1657529023859,MATH 20E,B02,083774,Ciotti; Benjamin,17,0,35,18
1657529029884,MATH 103A,A01,083777,Greenfeld; Be'Eri,3,0,36,33
1657529029884,MATH 103A,A02,083778,Greenfeld; Be'Eri,5,0,36,31
1657529029884,MATH 103A,A03,093561,Greenfeld; Be'Eri,5,0,36,31
1657529029884,MATH 103A,B01,083779,Greenfeld; Be'Eri,7,0,36,29
1657529029884,MATH 103A,B02,083780,Greenfeld; Be'Eri,4,0,36,32
1657529029884,MATH 103A,B03,093562,Greenfeld; Be'Eri,3,0,36,33
1657529035912,MATH 105,A01,085443,Carter; Anne Toulson,15,0,35,20
1657529035912,MATH 105,A02,093477,Carter; Anne Toulson,20,0,35,15
1657529041937,MATH 109,A01,083213,Ganzberger; Geoffrey Michael,2,0,34,32
1657529041937,MATH 109,A02,083214,Ganzberger; Geoffrey Michael,4,0,34,30
1657529041937,MATH 109,A03,093478,Ganzberger; Geoffrey Michael,2,0,34,32
1657529041937,MATH 109,B01,083215,Ganzberger; Geoffrey Michael,1,0,32,31
1657529041937,MATH 109,B02,083216,Ganzberger; Geoffrey Michael,2,0,32,30
1657529041937,MATH 109,B03,093479,Ganzberger; Geoffrey Michael,8,0,32,24
1657529047961,MATH 142A,A01,083219,Chow; Bennett,7,0,32,25
1657529047961,MATH 142A,A02,083220,Chow; Bennett,10,0,32,22
1657529047961,MATH 142A,A03,093480,Chow; Bennett,8,0,32,24
1657529047961,MATH 142A,B03,093481,Chow; Bennett,8,0,32,24
1657529047961,MATH 142A,B04,093558,Chow; Bennett,13,0,32,19
1657529047961,MATH 142A,B05,093559,Chow; Bennett,6,0,32,26
1657529053994,MATH 193A,A01,083224,Rotar; Vladimir,8,0,34,26
1657529053994,MATH 193A,A02,083225,Rotar; Vladimir,9,0,34,25
1657529053994,MATH 193A,A03,083781,Rotar; Vladimir,5,0,34,29
1657529053994,MATH 193A,A04,083782,Rotar; Vladimir,10,0,34,24
1657529053994,MATH 193A,A05,093482,Rotar; Vladimir,10,0,34,24
1657529060017,MATH 197,001,091859,McAuley; Julian John,9999,0,9999,0
1657529060017,MATH 197,002,095566,Kedlaya; Kiran S.,9997,0,9999,2
1657529060017,MATH 197,003,095567,Xiao; Ming,9999,0,9999,0
1657529060017,MATH 197,004,095571,Perols; Johan Lars,9998,0,9999,1
1657529067078,COGS 9,A01,083615,Shannon; Kyle Michael,9,0,75,66
1657529073106,COGS 11,A01,083617,Boyle; Mary E. T.,22,0,48,26
1657529079132,COGS 13,A01,083071,Bastos; Amalia Pinkusfeld,11,0,71,60
1657529085160,COGS 14A,A01,092681,Semenuks; Arturs,5,1,100,95
1657529091185,COGS 14B,A01,083073,Cheng; Tzu-Han,6,0,63,57
1657529097209,COGS 17,A01,092677,Semenuks; Arturs,6,0,81,75
1657529103241,COGS 100,A01,083619,Allen; Michael Gordon,17,0,70,53
1657529109264,COGS 101A,A01,083621,Davis; Joshua Daniel,9,0,68,59
1657529115298,COGS 101B,A01,091572,Allen; Michael Gordon,12,0,65,53
1657529121328,COGS 101C,A01,083625,Delgado; Tania,17,0,35,18
1657529127352,COGS 107A,A01,083627,Boyle; Mary E. T.,13,0,60,47
1657529133375,COGS 118A,A01,083075,Gupta; Anjum,21,0,76,55
1657529139408,CSE 3,A50,083646,Miranda; Gregory Joseph,24,0,50,26
1657529145431,CSE 8A,A50,083650,Miranda; Gregory Joseph,17,1,56,39
1657529151457,CSE 11,A01,083080,Cao; Yingjun,6,15,40,34
1657529157483,CSE 12,A01,083652,Krause-Levy; Sophia Louisa,28,1,120,92
1657529163510,CSE 15L,A01,083654,Morris; Justin Loren,9,0,50,41
1657529163510,CSE 15L,A02,083655,Morris; Justin Loren,9,0,50,41
1657529169539,CSE 20,A01,083657,Tran; Khoa Dang,39,0,80,41
1657529175563,CSE 21,A01,095574,Bach; Quang Tran,22,0,48,26
1657529181589,CSE 30,A01,083084,Eldon; John,5,0,80,75
1657529181589,CSE 30,B01,095061,Bhaskar; Nishant,9,0,50,41
1657529187616,CSE 100,A01,083659,Cao; Yingjun,5,4,70,65
1657529193647,CSE 134B,A01,083661,Powell; Thomas Allan,22,0,100,78
1657529199672,CSE 140,A01,083663,Gungor; Onat,15,0,85,70
1657529205695,CSE 140L,A01,083088,Eldon; John,21,0,100,79
1657529211725,CSE 175,A01,083665,Kumar; Rakesh,3,0,25,22
1657529217750,CSE 190,A00,092507,Dubnov; Shlomo,8,0,20,12
1657529223776,ECE 45,A01,083139,Congero; Spencer William,6,0,75,69
1657529229804,ECE 65,A50,083695,Saad; Andrew S,12,0,30,18
1657529229804,ECE 65,A51,095125,Saad; Andrew S,24,0,26,2
1657529235840,ECE 109,A01,091882,Touri; Behrouz,19,0,70,51
1657529241875,ECE 180,A00,083140,Abi Samra; Nicholas Camill,1,0,30,29
1657529241875,ECE 180,B00,083141,Abi Samra; Nicholas Camill,0,0,30,30
1657529247906,MATH 10A,A01,083735,Patchell; Gregory David,2,0,30,28
1657529247906,MATH 10A,A02,083736,Patchell; Gregory David,20,0,30,10
1657529247906,MATH 10A,A03,083737,Patchell; Gregory David,16,0,30,14
1657529253933,MATH 10B,A01,083207,Lim; Seonhee,8,0,34,26
1657529253933,MATH 10B,A02,083208,Lim; Seonhee,9,0,35,26
1657529253933,MATH 10B,A03,093472,Lim; Seonhee,7,0,34,27
1657529253933,MATH 10B,B01,083739,Sinha; Shubham,12,0,30,18
1657529259962,MATH 18,A01,083743,Cinel; Cameron Alexander,7,0,30,23
1657529259962,MATH 18,A02,083744,Cinel; Cameron Alexander,17,0,30,13
1657529259962,MATH 18,A03,083745,Cinel; Cameron Alexander,9,0,30,21
1657529259962,MATH 18,B01,083748,Rideout; David Porter,5,0,37,32
1657529259962,MATH 18,B02,083749,Rideout; David Porter,5,0,36,31
1657529259962,MATH 18,B03,083750,Rideout; David Porter,3,0,37,34
1657529259962,MATH 18,B04,083751,Rideout; David Porter,6,0,36,30
1657529259962,MATH 18,B05,093473,Rideout; David Porter,6,0,36,30
1657529259962,MATH 18,B06,093474,Rideout; David Porter,6,0,36,30
1657529265990,MATH 20A,A01,083754,Zheng; Zequn,14,0,40,26
1657529272016,MATH 20B,A01,083756,Briones; Jor-el Thomas Caparas,4,0,36,32
1657529272016,MATH 20B,A02,083757,Briones; Jor-el Thomas Caparas,1,0,36,35
1657529272016,MATH 20B,A03,093475,Briones; Jor-el Thomas Caparas,2,0,36,34
1657529278047,MATH 20C,A01,083760,Briones; Jor-el Thomas Caparas,1,0,35,34
1657529278047,MATH 20C,A02,083761,Briones; Jor-el Thomas Caparas,8,0,35,27
1657529278047,MATH 20C,A03,093476,Briones; Jor-el Thomas Caparas,0,1,36,36
1657529278047,MATH 20C,B01,083762,Bach; Quang Tran,1,0,30,29
1657529284075,MATH 20D,A01,083765,Tran; Brian Kha,5,0,30,25
1657529284075,MATH 20D,A02,083766,Tran; Brian Kha,5,0,30,25
1657529284075,MATH 20D,A03,083767,Tran; Brian Kha,5,0,30,25
1657529290118,MATH 20E,A01,083771,Ganguly; Soumya,9,0,32,23
1657529290118,MATH 20E,A02,083772,Ganguly; Soumya,6,0,32,26
1657529290118,MATH 20E,B01,083773,Ciotti; Benjamin,20,0,35,15
1657529290118,MATH 20E,B02,083774,Ciotti; Benjamin,17,0,35,18
1657529296143,MATH 103A,A01,083777,Greenfeld; Be'Eri,3,0,36,33
1657529296143,MATH 103A,A02,083778,Greenfeld; Be'Eri,5,0,36,31
1657529296143,MATH 103A,A03,093561,Greenfeld; Be'Eri,5,0,36,31
1657529296143,MATH 103A,B01,083779,Greenfeld; Be'Eri,7,0,36,29
1657529296143,MATH 103A,B02,083780,Greenfeld; Be'Eri,4,0,36,32
1657529296143,MATH 103A,B03,093562,Greenfeld; Be'Eri,3,0,36,33
1657529302177,MATH 105,A01,085443,Carter; Anne Toulson,15,0,35,20
1657529302177,MATH 105,A02,093477,Carter; Anne Toulson,20,0,35,15
1657529308201,MATH 109,A01,083213,Ganzberger; Geoffrey Michael,2,0,34,32
1657529308201,MATH 109,A02,083214,Ganzberger; Geoffrey Michael,4,0,34,30
1657529308201,MATH 109,A03,093478,Ganzberger; Geoffrey Michael,2,0,34,32
1657529308201,MATH 109,B01,083215,Ganzberger; Geoffrey Michael,1,0,32,31
1657529308201,MATH 109,B02,083216,Ganzberger; Geoffrey Michael,2,0,32,30
1657529308201,MATH 109,B03,093479,Ganzberger; Geoffrey Michael,8,0,32,24
1657529314228,MATH 142A,A01,083219,Chow; Bennett,7,0,32,25
1657529314228,MATH 142A,A02,083220,Chow; Bennett,10,0,32,22
1657529314228,MATH 142A,A03,093480,Chow; Bennett,8,0,32,24
1657529314228,MATH 142A,B03,093481,Chow; Bennett,8,0,32,24
1657529314228,MATH 142A,B04,093558,Chow; Bennett,13,0,32,19
1657529314228,MATH 142A,B05,093559,Chow; Bennett,6,0,32,26
1657529320253,MATH 193A,A01,083224,Rotar; Vladimir,8,0,34,26
1657529320253,MATH 193A,A02,083225,Rotar; Vladimir,9,0,34,25
1657529320253,MATH 193A,A03,083781,Rotar; Vladimir,5,0,34,29
1657529320253,MATH 193A,A04,083782,Rotar; Vladimir,10,0,34,24
1657529320253,MATH 193A,A05,093482,Rotar; Vladimir,10,0,34,24
1657529326278,MATH 197,001,091859,McAuley; Julian John,9999,0,9999,0
1657529326278,MATH 197,002,095566,Kedlaya; Kiran S.,9997,0,9999,2
1657529326278,MATH 197,003,095567,Xiao; Ming,9999,0,9999,0
1657529326278,MATH 197,004,095571,Perols; Johan Lars,9998,0,9999,1
1657529333347,COGS 9,A01,083615,Shannon; Kyle Michael,9,0,75,66
1657529339371,COGS 11,A01,083617,Boyle; Mary E. T.,22,0,48,26
1657529345395,COGS 13,A01,083071,Bastos; Amalia Pinkusfeld,11,0,71,60
1657529351417,COGS 14A,A01,092681,Semenuks; Arturs,5,1,100,95
1657529357440,COGS 14B,A01,083073,Cheng; Tzu-Han,6,0,63,57
1657529363464,COGS 17,A01,092677,Semenuks; Arturs,6,0,81,75
1657529369487,COGS 100,A01,083619,Allen; Michael Gordon,17,0,70,53
1657529375516,COGS 101A,A01,083621,Davis; Joshua Daniel,9,0,68,59
1657529381542,COGS 101B,A01,091572,Allen; Michael Gordon,12,0,65,53
1657529387567,COGS 101C,A01,083625,Delgado; Tania,17,0,35,18
1657529393592,COGS 107A,A01,083627,Boyle; Mary E. T.,13,0,60,47
1657529399617,COGS 118A,A01,083075,Gupta; Anjum,21,0,76,55
1657529405642,CSE 3,A50,083646,Miranda; Gregory Joseph,24,0,50,26
1657529411669,CSE 8A,A50,083650,Miranda; Gregory Joseph,17,1,56,39
1657529417695,CSE 11,A01,083080,Cao; Yingjun,6,15,40,34
1657529423719,CSE 12,A01,083652,Krause-Levy; Sophia Louisa,28,1,120,92
1657529429750,CSE 15L,A01,083654,Morris; Justin Loren,9,0,50,41
1657529429750,CSE 15L,A02,083655,Morris; Justin Loren,9,0,50,41
1657529435773,CSE 20,A01,083657,Tran; Khoa Dang,39,0,80,41
1657529441797,CSE 21,A01,095574,Bach; Quang Tran,22,0,48,26
1657529447825,CSE 30,A01,083084,Eldon; John,5,0,80,75
1657529447825,CSE 30,B01,095061,Bhaskar; Nishant,9,0,50,41
1657529453939,CSE 100,A01,083659,Cao; Yingjun,5,4,70,65
1657529459966,CSE 134B,A01,083661,Powell; Thomas Allan,22,0,100,78
1657529465994,CSE 140,A01,083663,Gungor; Onat,15,0,85,70
1657529472021,CSE 140L,A01,083088,Eldon; John,21,0,100,79
1657529478049,CSE 175,A01,083665,Kumar; Rakesh,3,0,25,22
1657529484079,CSE 190,A00,092507,Dubnov; Shlomo,8,0,20,12
1657529490107,ECE 45,A01,083139,Congero; Spencer William,6,0,75,69
1657529496140,ECE 65,A50,083695,Saad; Andrew S,12,0,30,18
1657529496140,ECE 65,A51,095125,Saad; Andrew S,24,0,26,2
1657529502167,ECE 109,A01,091882,Touri; Behrouz,19,0,70,51
1657529508195,ECE 180,A00,083140,Abi Samra; Nicholas Camill,1,0,30,29
1657529508195,ECE 180,B00,083141,Abi Samra; Nicholas Camill,0,0,30,30
1657529514232,MATH 10A,A01,083735,Patchell; Gregory David,2,0,30,28
1657529514232,MATH 10A,A02,083736,Patchell; Gregory David,20,0,30,10
1657529514232,MATH 10A,A03,083737,Patchell; Gregory David,16,0,30,14
1657529520265,MATH 10B,A01,083207,Lim; Seonhee,8,0,34,26
1657529520265,MATH 10B,A02,083208,Lim; Seonhee,9,0,35,26
1657529520265,MATH 10B,A03,093472,Lim; Seonhee,7,0,34,27
1657529520265,MATH 10B,B01,083739,Sinha; Shubham,12,0,30,18
1657529526312,MATH 18,A01,083743,Cinel; Cameron Alexander,7,0,30,23
1657529526312,MATH 18,A02,083744,Cinel; Cameron Alexander,17,0,30,13
1657529526312,MATH 18,A03,083745,Cinel; Cameron Alexander,9,0,30,21
1657529526312,MATH 18,B01,083748,Rideout; David Porter,5,0,37,32
1657529526312,MATH 18,B02,083749,Rideout; David Porter,5,0,36,31
1657529526312,MATH 18,B03,083750,Rideout; David Porter,3,0,37,34
1657529526312,MATH 18,B04,083751,Rideout; David Porter,6,0,36,30
1657529526312,MATH 18,B05,093473,Rideout; David Porter,6,0,36,30
1657529526312,MATH 18,B06,093474,Rideout; David Porter,6,0,36,30
1657529532335,MATH 20A,A01,083754,Zheng; Zequn,14,0,40,26
1657529538359,MATH 20B,A01,083756,Briones; Jor-el Thomas Caparas,4,0,36,32
1657529538359,MATH 20B,A02,083757,Briones; Jor-el Thomas Caparas,1,0,36,35
1657529538359,MATH 20B,A03,093475,Briones; Jor-el Thomas Caparas,2,0,36,34
1657529544385,MATH 20C,A01,083760,Briones; Jor-el Thomas Caparas,1,0,35,34
1657529544385,MATH 20C,A02,083761,Briones; Jor-el Thomas Caparas,8,0,35,27
1657529544385,MATH 20C,A03,093476,Briones; Jor-el Thomas Caparas,0,1,36,36
1657529544385,MATH 20C,B01,083762,Bach; Quang Tran,1,0,30,29
1657529550427,MATH 20D,A01,083765,Tran; Brian Kha,5,0,30,25
1657529550427,MATH 20D,A02,083766,Tran; Brian Kha,5,0,30,25
1657529550427,MATH 20D,A03,083767,Tran; Brian Kha,5,0,30,25
1657529556455,MATH 20E,A01,083771,Ganguly; Soumya,9,0,32,23
1657529556455,MATH 20E,A02,083772,Ganguly; Soumya,6,0,32,26
1657529556455,MATH 20E,B01,083773,Ciotti; Benjamin,20,0,35,15
1657529556455,MATH 20E,B02,083774,Ciotti; Benjamin,17,0,35,18
1657529562489,MATH 103A,A01,083777,Greenfeld; Be'Eri,3,0,36,33
1657529562489,MATH 103A,A02,083778,Greenfeld; Be'Eri,5,0,36,31
1657529562489,MATH 103A,A03,093561,Greenfeld; Be'Eri,5,0,36,31
1657529562489,MATH 103A,B01,083779,Greenfeld; Be'Eri,7,0,36,29
1657529562489,MATH 103A,B02,083780,Greenfeld; Be'Eri,4,0,36,32
1657529562489,MATH 103A,B03,093562,Greenfeld; Be'Eri,3,0,36,33
1657529568517,MATH 105,A01,085443,Carter; Anne Toulson,15,0,35,20
1657529568517,MATH 105,A02,093477,Carter; Anne Toulson,20,0,35,15
1657529574551,MATH 109,A01,083213,Ganzberger; Geoffrey Michael,2,0,34,32
1657529574551,MATH 109,A02,083214,Ganzberger; Geoffrey Michael,4,0,34,30
1657529574551,MATH 109,A03,093478,Ganzberger; Geoffrey Michael,2,0,34,32
1657529574551,MATH 109,B01,083215,Ganzberger; Geoffrey Michael,1,0,32,31
1657529574551,MATH 109,B02,083216,Ganzberger; Geoffrey Michael,2,0,32,30
1657529574551,MATH 109,B03,093479,Ganzberger; Geoffrey Michael,8,0,32,24
1657529580586,MATH 142A,A01,083219,Chow; Bennett,7,0,32,25
1657529580586,MATH 142A,A02,083220,Chow; Bennett,10,0,32,22
1657529580586,MATH 142A,A03,093480,Chow; Bennett,8,0,32,24
1657529580586,MATH 142A,B03,093481,Chow; Bennett,8,0,32,24
1657529580586,MATH 142A,B04,093558,Chow; Bennett,13,0,32,19
1657529580586,MATH 142A,B05,093559,Chow; Bennett,6,0,32,26
1657529586615,MATH 193A,A01,083224,Rotar; Vladimir,8,0,34,26
1657529586615,MATH 193A,A02,083225,Rotar; Vladimir,9,0,34,25
1657529586615,MATH 193A,A03,083781,Rotar; Vladimir,5,0,34,29
1657529586615,MATH 193A,A04,083782,Rotar; Vladimir,10,0,34,24
1657529586615,MATH 193A,A05,093482,Rotar; Vladimir,10,0,34,24
1657529592642,MATH 197,001,091859,McAuley; Julian John,9999,0,9999,0
1657529592642,MATH 197,002,095566,Kedlaya; Kiran S.,9997,0,9999,2
1657529592642,MATH 197,003,095567,Xiao; Ming,9999,0,9999,0
1657529592642,MATH 197,004,095571,Perols; Johan Lars,9998,0,9999,1
1657529599707,COGS 9,A01,083615,Shannon; Kyle Michael,9,0,75,66
1657529605731,COGS 11,A01,083617,Boyle; Mary E. T.,22,0,48,26
1657529611759,COGS 13,A01,083071,Bastos; Amalia Pinkusfeld,11,0,71,60
1657529617785,COGS 14A,A01,092681,Semenuks; Arturs,5,1,100,95
1657529623811,COGS 14B,A01,083073,Cheng; Tzu-Han,6,0,63,57
1657529629838,COGS 17,A01,092677,Semenuks; Arturs,6,0,81,75
1657529635867,COGS 100,A01,083619,Allen; Michael Gordon,17,0,70,53
1657529641897,COGS 101A,A01,083621,Davis; Joshua Daniel,9,0,68,59
1657529647922,COGS 101B,A01,091572,Allen; Michael Gordon,12,0,65,53
1657529653955,COGS 101C,A01,083625,Delgado; Tania,17,0,35,18
1657529659980,COGS 107A,A01,083627,Boyle; Mary E. T.,13,0,60,47
1657529666005,COGS 118A,A01,083075,Gupta; Anjum,21,0,76,55
1657529672033,CSE 3,A50,083646,Miranda; Gregory Joseph,24,0,50,26
1657529678057,CSE 8A,A50,083650,Miranda; Gregory Joseph,17,1,56,39
1657529684085,CSE 11,A01,083080,Cao; Yingjun,6,15,40,34
1657529690109,CSE 12,A01,083652,Krause-Levy; Sophia Louisa,28,1,120,92
1657529696135,CSE 15L,A01,083654,Morris; Justin Loren,9,0,50,41
1657529696135,CSE 15L,A02,083655,Morris; Justin Loren,9,0,50,41
1657529702168,CSE 20,A01,083657,Tran; Khoa Dang,39,0,80,41
1657529708198,CSE 21,A01,095574,Bach; Quang Tran,22,0,48,26
1657529714224,CSE 30,A01,083084,Eldon; John,5,0,80,75
1657529714224,CSE 30,B01,095061,Bhaskar; Nishant,9,0,50,41
1657529720257,CSE 100,A01,083659,Cao; Yingjun,5,4,70,65
1657529726284,CSE 134B,A01,083661,Powell; Thomas Allan,22,0,100,78
1657529732309,CSE 140,A01,083663,Gungor; Onat,15,0,85,70
1657529738337,CSE 140L,A01,083088,Eldon; John,21,0,100,79
1657529744361,CSE 175,A01,083665,Kumar; Rakesh,3,0,25,22
1657529750386,CSE 190,A00,092507,Dubnov; Shlomo,8,0,20,12
1657529756423,ECE 45,A01,083139,Congero; Spencer William,6,0,75,69
1657529762453,ECE 65,A50,083695,Saad; Andrew S,12,0,30,18
1657529762453,ECE 65,A51,095125,Saad; Andrew S,24,0,26,2
1657529768479,ECE 109,A01,091882,Touri; Behrouz,19,0,70,51
1657529774504,ECE 180,A00,083140,Abi Samra; Nicholas Camill,1,0,30,29
1657529774504,ECE 180,B00,083141,Abi Samra; Nicholas Camill,0,0,30,30
1657529780530,MATH 10A,A01,083735,Patchell; Gregory David,2,0,30,28
1657529780530,MATH 10A,A02,083736,Patchell; Gregory David,20,0,30,10
1657529780530,MATH 10A,A03,083737,Patchell; Gregory David,16,0,30,14
1657529786555,MATH 10B,A01,083207,Lim; Seonhee,8,0,34,26
1657529786555,MATH 10B,A02,083208,Lim; Seonhee,9,0,35,26
1657529786555,MATH 10B,A03,093472,Lim; Seonhee,7,0,34,27
1657529786555,MATH 10B,B01,083739,Sinha; Shubham,12,0,30,18
1657529792582,MATH 18,A01,083743,Cinel; Cameron Alexander,7,0,30,23
1657529792582,MATH 18,A02,083744,Cinel; Cameron Alexander,17,0,30,13
1657529792582,MATH 18,A03,083745,Cinel; Cameron Alexander,9,0,30,21
1657529792582,MATH 18,B01,083748,Rideout; David Porter,5,0,37,32
1657529792582,MATH 18,B02,083749,Rideout; David Porter,5,0,36,31
1657529792582,MATH 18,B03,083750,Rideout; David Porter,3,0,37,34
1657529792582,MATH 18,B04,083751,Rideout; David Porter,6,0,36,30
1657529792582,MATH 18,B05,093473,Rideout; David Porter,6,0,36,30
1657529792582,MATH 18,B06,093474,Rideout; David Porter,6,0,36,30
1657529798607,MATH 20A,A01,083754,Zheng; Zequn,14,0,40,26
1657529804637,MATH 20B,A01,083756,Briones; Jor-el Thomas Caparas,4,0,36,32
1657529804637,MATH 20B,A02,083757,Briones; Jor-el Thomas Caparas,1,0,36,35
1657529804637,MATH 20B,A03,093475,Briones; Jor-el Thomas Caparas,2,0,36,34
1657529810662,MATH 20C,A01,083760,Briones; Jor-el Thomas Caparas,1,0,35,34
1657529810662,MATH 20C,A02,083761,Briones; Jor-el Thomas Caparas,8,0,35,27
1657529810662,MATH 20C,A03,093476,Briones; Jor-el Thomas Caparas,0,1,36,36
1657529810662,MATH 20C,B01,083762,Bach; Quang Tran,1,0,30,29
1657529816686,MATH 20D,A01,083765,Tran; Brian Kha,5,0,30,25
1657529816686,MATH 20D,A02,083766,Tran; Brian Kha,5,0,30,25
1657529816686,MATH 20D,A03,083767,Tran; Brian Kha,5,0,30,25
1657529822720,MATH 20E,A01,083771,Ganguly; Soumya,9,0,32,23
1657529822720,MATH 20E,A02,083772,Ganguly; Soumya,6,0,32,26
1657529822720,MATH 20E,B01,083773,Ciotti; Benjamin,20,0,35,15
1657529822720,MATH 20E,B02,083774,Ciotti; Benjamin,17,0,35,18
1657529828747,MATH 103A,A01,083777,Greenfeld; Be'Eri,3,0,36,33
1657529828747,MATH 103A,A02,083778,Greenfeld; Be'Eri,5,0,36,31
1657529828747,MATH 103A,A03,093561,Greenfeld; Be'Eri,5,0,36,31
1657529828747,MATH 103A,B01,083779,Greenfeld; Be'Eri,7,0,36,29
1657529828747,MATH 103A,B02,083780,Greenfeld; Be'Eri,4,0,36,32
1657529828747,MATH 103A,B03,093562,Greenfeld; Be'Eri,3,0,36,33
1657529834773,MATH 105,A01,085443,Carter; Anne Toulson,15,0,35,20
1657529834773,MATH 105,A02,093477,Carter; Anne Toulson,20,0,35,15
1657529840806,MATH 109,A01,083213,Ganzberger; Geoffrey Michael,2,0,34,32
1657529840806,MATH 109,A02,083214,Ganzberger; Geoffrey Michael,4,0,34,30
1657529840806,MATH 109,A03,093478,Ganzberger; Geoffrey Michael,2,0,34,32
1657529840806,MATH 109,B01,083215,Ganzberger; Geoffrey Michael,1,0,32,31
1657529840806,MATH 109,B02,083216,Ganzberger; Geoffrey Michael,2,0,32,30
1657529840806,MATH 109,B03,093479,Ganzberger; Geoffrey Michael,8,0,32,24
1657529846840,MATH 142A,A01,083219,Chow; Bennett,7,0,32,25
1657529846840,MATH 142A,A02,083220,Chow; Bennett,10,0,32,22
1657529846840,MATH 142A,A03,093480,Chow; Bennett,8,0,32,24
1657529846840,MATH 142A,B03,093481,Chow; Bennett,8,0,32,24
1657529846840,MATH 142A,B04,093558,Chow; Bennett,13,0,32,19
1657529846840,MATH 142A,B05,093559,Chow; Bennett,6,0,32,26
1657529852875,MATH 193A,A01,083224,Rotar; Vladimir,8,0,34,26
1657529852875,MATH 193A,A02,083225,Rotar; Vladimir,9,0,34,25
1657529852875,MATH 193A,A03,083781,Rotar; Vladimir,5,0,34,29
1657529852875,MATH 193A,A04,083782,Rotar; Vladimir,10,0,34,24
1657529852875,MATH 193A,A05,093482,Rotar; Vladimir,10,0,34,24
1657529858911,MATH 197,001,091859,McAuley; Julian John,9999,0,9999,0
1657529858911,MATH 197,002,095566,Kedlaya; Kiran S.,9997,0,9999,2
1657529858911,MATH 197,003,095567,Xiao; Ming,9999,0,9999,0
1657529858911,MATH 197,004,095571,Perols; Johan Lars,9998,0,9999,1
1657529866007,COGS 9,A01,083615,Shannon; Kyle Michael,9,0,75,66
1657529872037,COGS 11,A01,083617,Boyle; Mary E. T.,22,0,48,26
1657529878063,COGS 13,A01,083071,Bastos; Amalia Pinkusfeld,11,0,71,60
1657529884089,COGS 14A,A01,092681,Semenuks; Arturs,5,1,100,95
1657529890114,COGS 14B,A01,083073,Cheng; Tzu-Han,6,0,63,57
1657529896136,COGS 17,A01,092677,Semenuks; Arturs,6,0,81,75
1657529902160,COGS 100,A01,083619,Allen; Michael Gordon,17,0,70,53
1657529908185,COGS 101A,A01,083621,Davis; Joshua Daniel,9,0,68,59
1657529914208,COGS 101B,A01,091572,Allen; Michael Gordon,12,0,65,53
1657529920234,COGS 101C,A01,083625,Delgado; Tania,17,0,35,18
1657529926267,COGS 107A,A01,083627,Boyle; Mary E. T.,13,0,60,47
1657529932292,COGS 118A,A01,083075,Gupta; Anjum,21,0,76,55
1657529938334,CSE 3,A50,083646,Miranda; Gregory Joseph,24,0,50,26
1657529944365,CSE 8A,A50,083650,Miranda; Gregory Joseph,17,1,56,39
1657529950390,CSE 11,A01,083080,Cao; Yingjun,6,15,40,34
1657529956420,CSE 12,A01,083652,Krause-Levy; Sophia Louisa,28,1,120,92
1657529962447,CSE 15L,A01,083654,Morris; Justin Loren,9,0,50,41
1657529962447,CSE 15L,A02,083655,Morris; Justin Loren,9,0,50,41
1657529968471,CSE 20,A01,083657,Tran; Khoa Dang,39,0,80,41
1657529974495,CSE 21,A01,095574,Bach; Quang Tran,22,0,48,26
1657529980521,CSE 30,A01,083084,Eldon; John,5,0,80,75
1657529980521,CSE 30,B01,095061,Bhaskar; Nishant,9,0,50,41
1657529986545,CSE 100,A01,083659,Cao; Yingjun,5,4,70,65
1657529992568,CSE 134B,A01,083661,Powell; Thomas Allan,22,0,100,78
1657529998591,CSE 140,A01,083663,Gungor; Onat,15,0,85,70
1657530004624,CSE 140L,A01,083088,Eldon; John,21,0,100,79
1657530010649,CSE 175,A01,083665,Kumar; Rakesh,3,0,25,22
1657530016674,CSE 190,A00,092507,Dubnov; Shlomo,8,0,20,12
1657530022700,ECE 45,A01,083139,Congero; Spencer William,6,0,75,69
1657530028725,ECE 65,A50,083695,Saad; Andrew S,12,0,30,18
1657530028725,ECE 65,A51,095125,Saad; Andrew S,24,0,26,2
1657530034754,ECE 109,A01,091882,Touri; Behrouz,19,0,70,51
1657530040779,ECE 180,A00,083140,Abi Samra; Nicholas Camill,1,0,30,29
1657530040779,ECE 180,B00,083141,Abi Samra; Nicholas Camill,0,0,30,30
1657530046804,MATH 10A,A01,083735,Patchell; Gregory David,2,0,30,28
1657530046804,MATH 10A,A02,083736,Patchell; Gregory David,20,0,30,10
1657530046804,MATH 10A,A03,083737,Patchell; Gregory David,16,0,30,14
1657530052916,MATH 10B,A01,083207,Lim; Seonhee,8,0,34,26
1657530052916,MATH 10B,A02,083208,Lim; Seonhee,9,0,35,26
1657530052916,MATH 10B,A03,093472,Lim; Seonhee,7,0,34,27
1657530052916,MATH 10B,B01,083739,Sinha; Shubham,12,0,30,18
1657530058956,MATH 18,A01,083743,Cinel; Cameron Alexander,7,0,30,23
1657530058956,MATH 18,A02,083744,Cinel; Cameron Alexander,17,0,30,13
1657530058956,MATH 18,A03,083745,Cinel; Cameron Alexander,9,0,30,21
1657530058956,MATH 18,B01,083748,Rideout; David Porter,5,0,37,32
1657530058956,MATH 18,B02,083749,Rideout; David Porter,5,0,36,31
1657530058956,MATH 18,B03,083750,Rideout; David Porter,3,0,37,34
1657530058956,MATH 18,B04,083751,Rideout; David Porter,6,0,36,30
1657530058956,MATH 18,B05,093473,Rideout; David Porter,6,0,36,30
1657530058956,MATH 18,B06,093474,Rideout; David Porter,6,0,36,30
1657530064978,MATH 20A,A01,083754,Zheng; Zequn,14,0,40,26
1657530071003,MATH 20B,A01,083756,Briones; Jor-el Thomas Caparas,4,0,36,32
1657530071003,MATH 20B,A02,083757,Briones; Jor-el Thomas Caparas,1,0,36,35
1657530071003,MATH 20B,A03,093475,Briones; Jor-el Thomas Caparas,2,0,36,34
1657530077037,MATH 20C,A01,083760,Briones; Jor-el Thomas Caparas,1,0,35,34
1657530077037,MATH 20C,A02,083761,Briones; Jor-el Thomas Caparas,8,0,35,27
1657530077037,MATH 20C,A03,093476,Briones; Jor-el Thomas Caparas,0,1,36,36
1657530077037,MATH 20C,B01,083762,Bach; Quang Tran,1,0,30,29
1657530083062,MATH 20D,A01,083765,Tran; Brian Kha,5,0,30,25
1657530083062,MATH 20D,A02,083766,Tran; Brian Kha,5,0,30,25
1657530083062,MATH 20D,A03,083767,Tran; Brian Kha,5,0,30,25
1657530089088,MATH 20E,A01,083771,Ganguly; Soumya,9,0,32,23
1657530089088,MATH 20E,A02,083772,Ganguly; Soumya,6,0,32,26
1657530089088,MATH 20E,B01,083773,Ciotti; Benjamin,20,0,35,15
1657530089088,MATH 20E,B02,083774,Ciotti; Benjamin,17,0,35,18
1657530095114,MATH 103A,A01,083777,Greenfeld; Be'Eri,3,0,36,33
1657530095114,MATH 103A,A02,083778,Greenfeld; Be'Eri,5,0,36,31
1657530095114,MATH 103A,A03,093561,Greenfeld; Be'Eri,5,0,36,31
1657530095114,MATH 103A,B01,083779,Greenfeld; Be'Eri,7,0,36,29
1657530095114,MATH 103A,B02,083780,Greenfeld; Be'Eri,4,0,36,32
1657530095114,MATH 103A,B03,093562,Greenfeld; Be'Eri,3,0,36,33
1657530101137,MATH 105,A01,085443,Carter; Anne Toulson,15,0,35,20
1657530101137,MATH 105,A02,093477,Carter; Anne Toulson,20,0,35,15
1657530107168,MATH 109,A01,083213,Ganzberger; Geoffrey Michael,2,0,34,32
1657530107168,MATH 109,A02,083214,Ganzberger; Geoffrey Michael,4,0,34,30
1657530107168,MATH 109,A03,093478,Ganzberger; Geoffrey Michael,2,0,34,32
1657530107168,MATH 109,B01,083215,Ganzberger; Geoffrey Michael,1,0,32,31
1657530107168,MATH 109,B02,083216,Ganzberger; Geoffrey Michael,2,0,32,30
1657530107168,MATH 109,B03,093479,Ganzberger; Geoffrey Michael,8,0,32,24
1657530113199,MATH 142A,A01,083219,Chow; Bennett,7,0,32,25
1657530113199,MATH 142A,A02,083220,Chow; Bennett,10,0,32,22
1657530113199,MATH 142A,A03,093480,Chow; Bennett,8,0,32,24
1657530113199,MATH 142A,B03,093481,Chow; Bennett,8,0,32,24
1657530113199,MATH 142A,B04,093558,Chow; Bennett,13,0,32,19
1657530113199,MATH 142A,B05,093559,Chow; Bennett,6,0,32,26
1657530119229,MATH 193A,A01,083224,Rotar; Vladimir,8,0,34,26
1657530119229,MATH 193A,A02,083225,Rotar; Vladimir,9,0,34,25
1657530119229,MATH 193A,A03,083781,Rotar; Vladimir,5,0,34,29
1657530119229,MATH 193A,A04,083782,Rotar; Vladimir,10,0,34,24
1657530119229,MATH 193A,A05,093482,Rotar; Vladimir,10,0,34,24
1657530125253,MATH 197,001,091859,McAuley; Julian John,9999,0,9999,0
1657530125253,MATH 197,002,095566,Kedlaya; Kiran S.,9997,0,9999,2
1657530125253,MATH 197,003,095567,Xiao; Ming,9999,0,9999,0
1657530125253,MATH 197,004,095571,Perols; Johan Lars,9998,0,9999,1
1657530132314,COGS 9,A01,083615,Shannon; Kyle Michael,9,0,75,66
1657530138345,COGS 11,A01,083617,Boyle; Mary E. T.,22,0,48,26
1657530144368,COGS 13,A01,083071,Bastos; Amalia Pinkusfeld,11,0,71,60
1657530150393,COGS 14A,A01,092681,Semenuks; Arturs,5,1,100,95
1657530156417,COGS 14B,A01,083073,Cheng; Tzu-Han,6,0,63,57
1657530162447,COGS 17,A01,092677,Semenuks; Arturs,6,0,81,75
1657530168472,COGS 100,A01,083619,Allen; Michael Gordon,17,0,70,53
1657530174506,COGS 101A,A01,083621,Davis; Joshua Daniel,9,0,68,59
1657530180533,COGS 101B,A01,091572,Allen; Michael Gordon,12,0,65,53
1657530186557,COGS 101C,A01,083625,Delgado; Tania,17,0,35,18
1657530193197,COGS 107A,A01,083627,Boyle; Mary E. T.,13,0,60,47
1657530199220,COGS 118A,A01,083075,Gupta; Anjum,21,0,76,55
1657530205249,CSE 3,A50,083646,Miranda; Gregory Joseph,24,0,50,26
1657530211276,CSE 8A,A50,083650,Miranda; Gregory Joseph,17,1,56,39
1657530217301,CSE 11,A01,083080,Cao; Yingjun,6,15,40,34
1657530223326,CSE 12,A01,083652,Krause-Levy; Sophia Louisa,28,1,120,92
1657530229351,CSE 15L,A01,083654,Morris; Justin Loren,9,0,50,41
1657530229351,CSE 15L,A02,083655,Morris; Justin Loren,9,0,50,41
1657530235376,CSE 20,A01,083657,Tran; Khoa Dang,39,0,80,41
1657530241407,CSE 21,A01,095574,Bach; Quang Tran,22,0,48,26
1657530247439,CSE 30,A01,083084,Eldon; John,5,0,80,75
1657530247439,CSE 30,B01,095061,Bhaskar; Nishant,9,0,50,41
1657530253462,CSE 100,A01,083659,Cao; Yingjun,5,4,70,65
1657530259490,CSE 134B,A01,083661,Powell; Thomas Allan,22,0,100,78
1657530265512,CSE 140,A01,083663,Gungor; Onat,15,0,85,70
1657530271541,CSE 140L,A01,083088,Eldon; John,21,0,100,79
1657530277566,CSE 175,A01,083665,Kumar; Rakesh,3,0,25,22
1657530283596,CSE 190,A00,092507,Dubnov; Shlomo,8,0,20,12
1657530289622,ECE 45,A01,083139,Congero; Spencer William,6,0,75,69
1657530295646,ECE 65,A50,083695,Saad; Andrew S,12,0,30,18
1657530295646,ECE 65,A51,095125,Saad; Andrew S,24,0,26,2
1657530301673,ECE 109,A01,091882,Touri; Behrouz,19,0,70,51
1657530307697,ECE 180,A00,083140,Abi Samra; Nicholas Camill,1,0,30,29
1657530307697,ECE 180,B00,083141,Abi Samra; Nicholas Camill,0,0,30,30
1657530313720,MATH 10A,A01,083735,Patchell; Gregory David,2,0,30,28
1657530313720,MATH 10A,A02,083736,Patchell; Gregory David,20,0,30,10
1657530313720,MATH 10A,A03,083737,Patchell; Gregory David,16,0,30,14
1657530319744,MATH 10B,A01,083207,Lim; Seonhee,8,0,34,26
1657530319744,MATH 10B,A02,083208,Lim; Seonhee,9,0,35,26
1657530319744,MATH 10B,A03,093472,Lim; Seonhee,7,0,34,27
1657530319744,MATH 10B,B01,083739,Sinha; Shubham,12,0,30,18
1657530325779,MATH 18,A01,083743,Cinel; Cameron Alexander,7,0,30,23
1657530325779,MATH 18,A02,083744,Cinel; Cameron Alexander,17,0,30,13
1657530325779,MATH 18,A03,083745,Cinel; Cameron Alexander,9,0,30,21
1657530325779,MATH 18,B01,083748,Rideout; David Porter,5,0,37,32
1657530325779,MATH 18,B02,083749,Rideout; David Porter,5,0,36,31
1657530325779,MATH 18,B03,083750,Rideout; David Porter,3,0,37,34
1657530325779,MATH 18,B04,083751,Rideout; David Porter,6,0,36,30
1657530325779,MATH 18,B05,093473,Rideout; David Porter,6,0,36,30
1657530325779,MATH 18,B06,093474,Rideout; David Porter,6,0,36,30
1657530331801,MATH 20A,A01,083754,Zheng; Zequn,14,0,40,26
1657530337831,MATH 20B,A01,083756,Briones; Jor-el Thomas Caparas,4,0,36,32
1657530337831,MATH 20B,A02,083757,Briones; Jor-el Thomas Caparas,1,0,36,35
1657530337831,MATH 20B,A03,093475,Briones; Jor-el Thomas Caparas,2,0,36,34
1657530343857,MATH 20C,A01,083760,Briones; Jor-el Thomas Caparas,1,0,35,34
1657530343857,MATH 20C,A02,083761,Briones; Jor-el Thomas Caparas,8,0,35,27
1657530343857,MATH 20C,A03,093476,Briones; Jor-el Thomas Caparas,0,1,36,36
1657530343857,MATH 20C,B01,083762,Bach; Quang Tran,1,0,30,29
1657530349887,MATH 20D,A01,083765,Tran; Brian Kha,5,0,30,25
1657530349887,MATH 20D,A02,083766,Tran; Brian Kha,5,0,30,25
1657530349887,MATH 20D,A03,083767,Tran; Brian Kha,5,0,30,25
1657530355920,MATH 20E,A01,083771,Ganguly; Soumya,9,0,32,23
1657530355920,MATH 20E,A02,083772,Ganguly; Soumya,6,0,32,26
1657530355920,MATH 20E,B01,083773,Ciotti; Benjamin,20,0,35,15
1657530355920,MATH 20E,B02,083774,Ciotti; Benjamin,17,0,35,18
1657530361946,MATH 103A,A01,083777,Greenfeld; Be'Eri,3,0,36,33
1657530361946,MATH 103A,A02,083778,Greenfeld; Be'Eri,5,0,36,31
1657530361946,MATH 103A,A03,093561,Greenfeld; Be'Eri,5,0,36,31
1657530361946,MATH 103A,B01,083779,Greenfeld; Be'Eri,7,0,36,29
1657530361946,MATH 103A,B02,083780,Greenfeld; Be'Eri,4,0,36,32
1657530361946,MATH 103A,B03,093562,Greenfeld; Be'Eri,3,0,36,33
1657530367974,MATH 105,A01,085443,Carter; Anne Toulson,15,0,35,20
1657530367974,MATH 105,A02,093477,Carter; Anne Toulson,20,0,35,15
1657530374008,MATH 109,A01,083213,Ganzberger; Geoffrey Michael,2,0,34,32
1657530374008,MATH 109,A02,083214,Ganzberger; Geoffrey Michael,4,0,34,30
1657530374008,MATH 109,A03,093478,Ganzberger; Geoffrey Michael,2,0,34,32
1657530374008,MATH 109,B01,083215,Ganzberger; Geoffrey Michael,1,0,32,31
1657530374008,MATH 109,B02,083216,Ganzberger; Geoffrey Michael,2,0,32,30
1657530374008,MATH 109,B03,093479,Ganzberger; Geoffrey Michael,8,0,32,24
1657530380033,MATH 142A,A01,083219,Chow; Bennett,7,0,32,25
1657530380033,MATH 142A,A02,083220,Chow; Bennett,10,0,32,22
1657530380033,MATH 142A,A03,093480,Chow; Bennett,8,0,32,24
1657530380033,MATH 142A,B03,093481,Chow; Bennett,8,0,32,24
1657530380033,MATH 142A,B04,093558,Chow; Bennett,13,0,32,19
1657530380033,MATH 142A,B05,093559,Chow; Bennett,6,0,32,26
1657530386058,MATH 193A,A01,083224,Rotar; Vladimir,8,0,34,26
1657530386058,MATH 193A,A02,083225,Rotar; Vladimir,9,0,34,25
1657530386058,MATH 193A,A03,083781,Rotar; Vladimir,5,0,34,29
1657530386058,MATH 193A,A04,083782,Rotar; Vladimir,10,0,34,24
1657530386058,MATH 193A,A05,093482,Rotar; Vladimir,10,0,34,24
1657530392096,MATH 197,001,091859,McAuley; Julian John,9999,0,9999,0
1657530392096,MATH 197,002,095566,Kedlaya; Kiran S.,9997,0,9999,2
1657530392096,MATH 197,003,095567,Xiao; Ming,9999,0,9999,0
1657530392096,MATH 197,004,095571,Perols; Johan Lars,9998,0,9999,1
1657530399184,COGS 9,A01,083615,Shannon; Kyle Michael,9,0,75,66
1657530405210,COGS 11,A01,083617,Boyle; Mary E. T.,22,0,48,26
1657530411242,COGS 13,A01,083071,Bastos; Amalia Pinkusfeld,11,0,71,60
1657530417278,COGS 14A,A01,092681,Semenuks; Arturs,5,1,100,95
1657530423306,COGS 14B,A01,083073,Cheng; Tzu-Han,6,0,63,57
1657530429332,COGS 17,A01,092677,Semenuks; Arturs,6,0,81,75
1657530435364,COGS 100,A01,083619,Allen; Michael Gordon,17,0,70,53
1657530441390,COGS 101A,A01,083621,Davis; Joshua Daniel,9,0,68,59
1657530447427,COGS 101B,A01,091572,Allen; Michael Gordon,12,0,65,53
1657530453451,COGS 101C,A01,083625,Delgado; Tania,17,0,35,18
1657530459475,COGS 107A,A01,083627,Boyle; Mary E. T.,13,0,60,47
1657530465506,COGS 118A,A01,083075,Gupta; Anjum,21,0,76,55
1657530471541,CSE 3,A50,083646,Miranda; Gregory Joseph,24,0,50,26
1657530477565,CSE 8A,A50,083650,Miranda; Gregory Joseph,17,1,56,39
1657530483587,CSE 11,A01,083080,Cao; Yingjun,6,15,40,34
1657530489620,CSE 12,A01,083652,Krause-Levy; Sophia Louisa,28,1,120,92
1657530495645,CSE 15L,A01,083654,Morris; Justin Loren,9,0,50,41
1657530495645,CSE 15L,A02,083655,Morris; Justin Loren,9,0,50,41
1657530501670,CSE 20,A01,083657,Tran; Khoa Dang,39,0,80,41
1657530507695,CSE 21,A01,095574,Bach; Quang Tran,22,0,48,26
1657530513723,CSE 30,A01,083084,Eldon; John,5,0,80,75
1657530513723,CSE 30,B01,095061,Bhaskar; Nishant,9,0,50,41
1657530519747,CSE 100,A01,083659,Cao; Yingjun,5,4,70,65
1657530525777,CSE 134B,A01,083661,Powell; Thomas Allan,22,0,100,78
1657530531811,CSE 140,A01,083663,Gungor; Onat,15,0,85,70
1657530537842,CSE 140L,A01,083088,Eldon; John,21,0,100,79
1657530543872,CSE 175,A01,083665,Kumar; Rakesh,3,0,25,22
1657530549900,CSE 190,A00,092507,Dubnov; Shlomo,8,0,20,12
1657530555925,ECE 45,A01,083139,Congero; Spencer William,6,0,75,69
1657530561958,ECE 65,A50,083695,Saad; Andrew S,12,0,30,18
1657530561958,ECE 65,A51,095125,Saad; Andrew S,24,0,26,2
1657530567984,ECE 109,A01,091882,Touri; Behrouz,19,0,70,51
1657530574013,ECE 180,A00,083140,Abi Samra; Nicholas Camill,1,0,30,29
1657530574013,ECE 180,B00,083141,Abi Samra; Nicholas Camill,0,0,30,30
1657530580047,MATH 10A,A01,083735,Patchell; Gregory David,2,0,30,28
1657530580047,MATH 10A,A02,083736,Patchell; Gregory David,20,0,30,10
1657530580047,MATH 10A,A03,083737,Patchell; Gregory David,16,0,30,14
1657530586076,MATH 10B,A01,083207,Lim; Seonhee,8,0,34,26
1657530586076,MATH 10B,A02,083208,Lim; Seonhee,9,0,35,26
1657530586076,MATH 10B,A03,093472,Lim; Seonhee,7,0,34,27
1657530586076,MATH 10B,B01,083739,Sinha; Shubham,12,0,30,18
1657530592106,MATH 18,A01,083743,Cinel; Cameron Alexander,7,0,30,23
1657530592106,MATH 18,A02,083744,Cinel; Cameron Alexander,17,0,30,13
1657530592106,MATH 18,A03,083745,Cinel; Cameron Alexander,9,0,30,21
1657530592106,MATH 18,B01,083748,Rideout; David Porter,5,0,37,32
1657530592106,MATH 18,B02,083749,Rideout; David Porter,5,0,36,31
1657530592106,MATH 18,B03,083750,Rideout; David Porter,3,0,37,34
1657530592106,MATH 18,B04,083751,Rideout; David Porter,6,0,36,30
1657530592106,MATH 18,B05,093473,Rideout; David Porter,6,0,36,30
1657530592106,MATH 18,B06,093474,Rideout; David Porter,6,0,36,30
1657530598140,MATH 20A,A01,083754,Zheng; Zequn,14,0,40,26
1657530604163,MATH 20B,A01,083756,Briones; Jor-el Thomas Caparas,4,0,36,32
1657530604163,MATH 20B,A02,083757,Briones; Jor-el Thomas Caparas,1,0,36,35
1657530604163,MATH 20B,A03,093475,Briones; Jor-el Thomas Caparas,2,0,36,34
1657530610189,MATH 20C,A01,083760,Briones; Jor-el Thomas Caparas,1,0,35,34
1657530610189,MATH 20C,A02,083761,Briones; Jor-el Thomas Caparas,8,0,35,27
1657530610189,MATH 20C,A03,093476,Briones; Jor-el Thomas Caparas,0,1,36,36
1657530610189,MATH 20C,B01,083762,Bach; Quang Tran,1,0,30,29
1657530616214,MATH 20D,A01,083765,Tran; Brian Kha,5,0,30,25
1657530616214,MATH 20D,A02,083766,Tran; Brian Kha,5,0,30,25
1657530616214,MATH 20D,A03,083767,Tran; Brian Kha,5,0,30,25
1657530622250,MATH 20E,A01,083771,Ganguly; Soumya,9,0,32,23
1657530622250,MATH 20E,A02,083772,Ganguly; Soumya,6,0,32,26
1657530622250,MATH 20E,B01,083773,Ciotti; Benjamin,20,0,35,15
1657530622250,MATH 20E,B02,083774,Ciotti; Benjamin,17,0,35,18
1657530628279,MATH 103A,A01,083777,Greenfeld; Be'Eri,3,0,36,33
1657530628279,MATH 103A,A02,083778,Greenfeld; Be'Eri,5,0,36,31
1657530628279,MATH 103A,A03,093561,Greenfeld; Be'Eri,5,0,36,31
1657530628279,MATH 103A,B01,083779,Greenfeld; Be'Eri,7,0,36,29
1657530628279,MATH 103A,B02,083780,Greenfeld; Be'Eri,4,0,36,32
1657530628279,MATH 103A,B03,093562,Greenfeld; Be'Eri,3,0,36,33
1657530634304,MATH 105,A01,085443,Carter; Anne Toulson,15,0,35,20
1657530634304,MATH 105,A02,093477,Carter; Anne Toulson,20,0,35,15
1657530640330,MATH 109,A01,083213,Ganzberger; Geoffrey Michael,2,0,34,32
1657530640330,MATH 109,A02,083214,Ganzberger; Geoffrey Michael,4,0,34,30
1657530640330,MATH 109,A03,093478,Ganzberger; Geoffrey Michael,2,0,34,32
1657530640330,MATH 109,B01,083215,Ganzberger; Geoffrey Michael,1,0,32,31
1657530640330,MATH 109,B02,083216,Ganzberger; Geoffrey Michael,2,0,32,30
1657530640330,MATH 109,B03,093479,Ganzberger; Geoffrey Michael,8,0,32,24
1657530646366,MATH 142A,A01,083219,Chow; Bennett,7,0,32,25
1657530646366,MATH 142A,A02,083220,Chow; Bennett,10,0,32,22
1657530646366,MATH 142A,A03,093480,Chow; Bennett,8,0,32,24
1657530646366,MATH 142A,B03,093481,Chow; Bennett,8,0,32,24
1657530646366,MATH 142A,B04,093558,Chow; Bennett,13,0,32,19
1657530646366,MATH 142A,B05,093559,Chow; Bennett,6,0,32,26
1657530652469,MATH 193A,A01,083224,Rotar; Vladimir,8,0,34,26
1657530652469,MATH 193A,A02,083225,Rotar; Vladimir,9,0,34,25
1657530652469,MATH 193A,A03,083781,Rotar; Vladimir,5,0,34,29
1657530652469,MATH 193A,A04,083782,Rotar; Vladimir,10,0,34,24
1657530652469,MATH 193A,A05,093482,Rotar; Vladimir,10,0,34,24
1657530658496,MATH 197,001,091859,McAuley; Julian John,9999,0,9999,0
1657530658496,MATH 197,002,095566,Kedlaya; Kiran S.,9997,0,9999,2
1657530658496,MATH 197,003,095567,Xiao; Ming,9999,0,9999,0
1657530658496,MATH 197,004,095571,Perols; Johan Lars,9998,0,9999,1
1657530665558,COGS 9,A01,083615,Shannon; Kyle Michael,9,0,75,66
1657530671581,COGS 11,A01,083617,Boyle; Mary E. T.,22,0,48,26
1657530677605,COGS 13,A01,083071,Bastos; Amalia Pinkusfeld,11,0,71,60
1657530683638,COGS 14A,A01,092681,Semenuks; Arturs,5,1,100,95
1657530689661,COGS 14B,A01,083073,Cheng; Tzu-Han,6,0,63,57
1657530695688,COGS 17,A01,092677,Semenuks; Arturs,6,0,81,75
1657530701718,COGS 100,A01,083619,Allen; Michael Gordon,17,0,70,53
1657530707744,COGS 101A,A01,083621,Davis; Joshua Daniel,9,0,68,59
1657530713768,COGS 101B,A01,091572,Allen; Michael Gordon,12,0,65,53
1657530719792,COGS 101C,A01,083625,Delgado; Tania,17,0,35,18
1657530725819,COGS 107A,A01,083627,Boyle; Mary E. T.,13,0,60,47
1657530731853,COGS 118A,A01,083075,Gupta; Anjum,21,0,76,55
1657530737878,CSE 3,A50,083646,Miranda; Gregory Joseph,24,0,50,26
1657530743906,CSE 8A,A50,083650,Miranda; Gregory Joseph,17,1,56,39
1657530749931,CSE 11,A01,083080,Cao; Yingjun,6,15,40,34
1657530755964,CSE 12,A01,083652,Krause-Levy; Sophia Louisa,28,1,120,92
1657530761990,CSE 15L,A01,083654,Morris; Justin Loren,9,0,50,41
1657530761990,CSE 15L,A02,083655,Morris; Justin Loren,9,0,50,41
1657530768014,CSE 20,A01,083657,Tran; Khoa Dang,39,0,80,41
1657530774039,CSE 21,A01,095574,Bach; Quang Tran,22,0,48,26
1657530780073,CSE 30,A01,083084,Eldon; John,5,0,80,75
1657530780073,CSE 30,B01,095061,Bhaskar; Nishant,9,0,50,41
1657530786098,CSE 100,A01,083659,Cao; Yingjun,5,4,70,65
1657530792120,CSE 134B,A01,083661,Powell; Thomas Allan,22,0,100,78
1657530798153,CSE 140,A01,083663,Gungor; Onat,15,0,85,70
1657530804177,CSE 140L,A01,083088,Eldon; John,21,0,100,79
1657530810211,CSE 175,A01,083665,Kumar; Rakesh,3,0,25,22
1657530816235,CSE 190,A00,092507,Dubnov; Shlomo,8,0,20,12
1657530822266,ECE 45,A01,083139,Congero; Spencer William,6,0,75,69
1657530828292,ECE 65,A50,083695,Saad; Andrew S,12,0,30,18
1657530828292,ECE 65,A51,095125,Saad; Andrew S,24,0,26,2
1657530834317,ECE 109,A01,091882,Touri; Behrouz,19,0,70,51
1657530840344,ECE 180,A00,083140,Abi Samra; Nicholas Camill,1,0,30,29
1657530840344,ECE 180,B00,083141,Abi Samra; Nicholas Camill,0,0,30,30
1657530846377,MATH 10A,A01,083735,Patchell; Gregory David,2,0,30,28
1657530846377,MATH 10A,A02,083736,Patchell; Gregory David,20,0,30,10
1657530846377,MATH 10A,A03,083737,Patchell; Gregory David,16,0,30,14
1657530852404,MATH 10B,A01,083207,Lim; Seonhee,8,0,34,26
1657530852404,MATH 10B,A02,083208,Lim; Seonhee,9,0,35,26
1657530852404,MATH 10B,A03,093472,Lim; Seonhee,7,0,34,27
1657530852404,MATH 10B,B01,083739,Sinha; Shubham,12,0,30,18
1657530858429,MATH 18,A01,083743,Cinel; Cameron Alexander,7,0,30,23
1657530858429,MATH 18,A02,083744,Cinel; Cameron Alexander,17,0,30,13
1657530858429,MATH 18,A03,083745,Cinel; Cameron Alexander,9,0,30,21
1657530858429,MATH 18,B01,083748,Rideout; David Porter,5,0,37,32
1657530858429,MATH 18,B02,083749,Rideout; David Porter,5,0,36,31
1657530858429,MATH 18,B03,083750,Rideout; David Porter,3,0,37,34
1657530858429,MATH 18,B04,083751,Rideout; David Porter,6,0,36,30
1657530858429,MATH 18,B05,093473,Rideout; David Porter,6,0,36,30
1657530858429,MATH 18,B06,093474,Rideout; David Porter,6,0,36,30
1657530864452,MATH 20A,A01,083754,Zheng; Zequn,14,0,40,26
1657530870478,MATH 20B,A01,083756,Briones; Jor-el Thomas Caparas,4,0,36,32
1657530870478,MATH 20B,A02,083757,Briones; Jor-el Thomas Caparas,1,0,36,35
1657530870478,MATH 20B,A03,093475,Briones; Jor-el Thomas Caparas,2,0,36,34
1657530876503,MATH 20C,A01,083760,Briones; Jor-el Thomas Caparas,1,0,35,34
1657530876503,MATH 20C,A02,083761,Briones; Jor-el Thomas Caparas,8,0,35,27
1657530876503,MATH 20C,A03,093476,Briones; Jor-el Thomas Caparas,0,1,36,36
1657530876503,MATH 20C,B01,083762,Bach; Quang Tran,1,0,30,29
1657530882528,MATH 20D,A01,083765,Tran; Brian Kha,5,0,30,25
1657530882528,MATH 20D,A02,083766,Tran; Brian Kha,5,0,30,25
1657530882528,MATH 20D,A03,083767,Tran; Brian Kha,5,0,30,25
1657530888554,MATH 20E,A01,083771,Ganguly; Soumya,9,0,32,23
1657530888554,MATH 20E,A02,083772,Ganguly; Soumya,6,0,32,26
1657530888554,MATH 20E,B01,083773,Ciotti; Benjamin,20,0,35,15
1657530888554,MATH 20E,B02,083774,Ciotti; Benjamin,17,0,35,18
1657530894581,MATH 103A,A01,083777,Greenfeld; Be'Eri,3,0,36,33
1657530894581,MATH 103A,A02,083778,Greenfeld; Be'Eri,5,0,36,31
1657530894581,MATH 103A,A03,093561,Greenfeld; Be'Eri,5,0,36,31
1657530894581,MATH 103A,B01,083779,Greenfeld; Be'Eri,7,0,36,29
1657530894581,MATH 103A,B02,083780,Greenfeld; Be'Eri,4,0,36,32
1657530894581,MATH 103A,B03,093562,Greenfeld; Be'Eri,3,0,36,33
1657530900610,MATH 105,A01,085443,Carter; Anne Toulson,15,0,35,20
1657530900610,MATH 105,A02,093477,Carter; Anne Toulson,20,0,35,15
1657530906635,MATH 109,A01,083213,Ganzberger; Geoffrey Michael,2,0,34,32
1657530906635,MATH 109,A02,083214,Ganzberger; Geoffrey Michael,4,0,34,30
1657530906635,MATH 109,A03,093478,Ganzberger; Geoffrey Michael,2,0,34,32
1657530906635,MATH 109,B01,083215,Ganzberger; Geoffrey Michael,1,0,32,31
1657530906635,MATH 109,B02,083216,Ganzberger; Geoffrey Michael,2,0,32,30
1657530906635,MATH 109,B03,093479,Ganzberger; Geoffrey Michael,8,0,32,24
1657530912665,MATH 142A,A01,083219,Chow; Bennett,7,0,32,25
1657530912665,MATH 142A,A02,083220,Chow; Bennett,10,0,32,22
1657530912665,MATH 142A,A03,093480,Chow; Bennett,8,0,32,24
1657530912665,MATH 142A,B03,093481,Chow; Bennett,8,0,32,24
1657530912665,MATH 142A,B04,093558,Chow; Bennett,13,0,32,19
1657530912665,MATH 142A,B05,093559,Chow; Bennett,6,0,32,26
1657530918688,MATH 193A,A01,083224,Rotar; Vladimir,8,0,34,26
1657530918688,MATH 193A,A02,083225,Rotar; Vladimir,9,0,34,25
1657530918688,MATH 193A,A03,083781,Rotar; Vladimir,5,0,34,29
1657530918688,MATH 193A,A04,083782,Rotar; Vladimir,10,0,34,24
1657530918688,MATH 193A,A05,093482,Rotar; Vladimir,10,0,34,24
1657530924710,MATH 197,001,091859,McAuley; Julian John,9999,0,9999,0
1657530924710,MATH 197,002,095566,Kedlaya; Kiran S.,9997,0,9999,2
1657530924710,MATH 197,003,095567,Xiao; Ming,9999,0,9999,0
1657530924710,MATH 197,004,095571,Perols; Johan Lars,9998,0,9999,1
1657530931768,COGS 9,A01,083615,Shannon; Kyle Michael,9,0,75,66
1657530937793,COGS 11,A01,083617,Boyle; Mary E. T.,22,0,48,26
1657530943816,COGS 13,A01,083071,Bastos; Amalia Pinkusfeld,11,0,71,60
1657530949839,COGS 14A,A01,092681,Semenuks; Arturs,5,1,100,95
1657530955865,COGS 14B,A01,083073,Cheng; Tzu-Han,6,0,63,57
1657530961888,COGS 17,A01,092677,Semenuks; Arturs,6,0,81,75
1657530967911,COGS 100,A01,083619,Allen; Michael Gordon,17,0,70,53
1657530973945,COGS 101A,A01,083621,Davis; Joshua Daniel,9,0,68,59
1657530979968,COGS 101B,A01,091572,Allen; Michael Gordon,12,0,65,53
1657530985992,COGS 101C,A01,083625,Delgado; Tania,17,0,35,18
1657530992019,COGS 107A,A01,083627,Boyle; Mary E. T.,13,0,60,47
1657530998044,COGS 118A,A01,083075,Gupta; Anjum,21,0,76,55
1657531004079,CSE 3,A50,083646,Miranda; Gregory Joseph,24,0,50,26
1657531010103,CSE 8A,A50,083650,Miranda; Gregory Joseph,17,1,56,39
1657531016130,CSE 11,A01,083080,Cao; Yingjun,6,15,40,34
1657531022198,CSE 12,A01,083652,Krause-Levy; Sophia Louisa,28,1,120,92
1657531028229,CSE 15L,A01,083654,Morris; Justin Loren,9,0,50,41
1657531028229,CSE 15L,A02,083655,Morris; Justin Loren,9,0,50,41
1657531034253,CSE 20,A01,083657,Tran; Khoa Dang,39,0,80,41
1657531040281,CSE 21,A01,095574,Bach; Quang Tran,22,0,48,26
1657531046313,CSE 30,A01,083084,Eldon; John,5,0,80,75
1657531046313,CSE 30,B01,095061,Bhaskar; Nishant,9,0,50,41
1657531052342,CSE 100,A01,083659,Cao; Yingjun,5,4,70,65
1657531058373,CSE 134B,A01,083661,Powell; Thomas Allan,22,0,100,78
1657531064398,CSE 140,A01,083663,Gungor; Onat,15,0,85,70
1657531070422,CSE 140L,A01,083088,Eldon; John,21,0,100,79
1657531076445,CSE 175,A01,083665,Kumar; Rakesh,3,0,25,22
1657531082474,CSE 190,A00,092507,Dubnov; Shlomo,8,0,20,12
1657531088498,ECE 45,A01,083139,Congero; Spencer William,6,0,75,69
1657531094527,ECE 65,A50,083695,Saad; Andrew S,12,0,30,18
1657531094527,ECE 65,A51,095125,Saad; Andrew S,24,0,26,2
1657531100551,ECE 109,A01,091882,Touri; Behrouz,19,0,70,51
1657531106574,ECE 180,A00,083140,Abi Samra; Nicholas Camill,1,0,30,29
1657531106574,ECE 180,B00,083141,Abi Samra; Nicholas Camill,0,0,30,30
1657531112601,MATH 10A,A01,083735,Patchell; Gregory David,2,0,30,28
1657531112601,MATH 10A,A02,083736,Patchell; Gregory David,20,0,30,10
1657531112601,MATH 10A,A03,083737,Patchell; Gregory David,16,0,30,14
1657531118626,MATH 10B,A01,083207,Lim; Seonhee,8,0,34,26
1657531118626,MATH 10B,A02,083208,Lim; Seonhee,9,0,35,26
1657531118626,MATH 10B,A03,093472,Lim; Seonhee,7,0,34,27
1657531118626,MATH 10B,B01,083739,Sinha; Shubham,12,0,30,18
1657531124662,MATH 18,A01,083743,Cinel; Cameron Alexander,7,0,30,23
1657531124662,MATH 18,A02,083744,Cinel; Cameron Alexander,17,0,30,13
1657531124662,MATH 18,A03,083745,Cinel; Cameron Alexander,9,0,30,21
1657531124662,MATH 18,B01,083748,Rideout; David Porter,5,0,37,32
1657531124662,MATH 18,B02,083749,Rideout; David Porter,5,0,36,31
1657531124662,MATH 18,B03,083750,Rideout; David Porter,3,0,37,34
1657531124662,MATH 18,B04,083751,Rideout; David Porter,6,0,36,30
1657531124662,MATH 18,B05,093473,Rideout; David Porter,6,0,36,30
1657531124662,MATH 18,B06,093474,Rideout; David Porter,6,0,36,30
1657531130692,MATH 20A,A01,083754,Zheng; Zequn,14,0,40,26
1657531136720,MATH 20B,A01,083756,Briones; Jor-el Thomas Caparas,4,0,36,32
1657531136720,MATH 20B,A02,083757,Briones; Jor-el Thomas Caparas,1,0,36,35
1657531136720,MATH 20B,A03,093475,Briones; Jor-el Thomas Caparas,2,0,36,34
1657531142764,MATH 20C,A01,083760,Briones; Jor-el Thomas Caparas,1,0,35,34
1657531142764,MATH 20C,A02,083761,Briones; Jor-el Thomas Caparas,8,0,35,27
1657531142764,MATH 20C,A03,093476,Briones; Jor-el Thomas Caparas,0,1,36,36
1657531142764,MATH 20C,B01,083762,Bach; Quang Tran,1,0,30,29
1657531148794,MATH 20D,A01,083765,Tran; Brian Kha,5,0,30,25
1657531148794,MATH 20D,A02,083766,Tran; Brian Kha,5,0,30,25
1657531148794,MATH 20D,A03,083767,Tran; Brian Kha,5,0,30,25
1657531154825,MATH 20E,A01,083771,Ganguly; Soumya,9,0,32,23
1657531154825,MATH 20E,A02,083772,Ganguly; Soumya,6,0,32,26
1657531154825,MATH 20E,B01,083773,Ciotti; Benjamin,20,0,35,15
1657531154825,MATH 20E,B02,083774,Ciotti; Benjamin,17,0,35,18
1657531160848,MATH 103A,A01,083777,Greenfeld; Be'Eri,3,0,36,33
1657531160848,MATH 103A,A02,083778,Greenfeld; Be'Eri,5,0,36,31
1657531160848,MATH 103A,A03,093561,Greenfeld; Be'Eri,5,0,36,31
1657531160848,MATH 103A,B01,083779,Greenfeld; Be'Eri,7,0,36,29
1657531160848,MATH 103A,B02,083780,Greenfeld; Be'Eri,4,0,36,32
1657531160848,MATH 103A,B03,093562,Greenfeld; Be'Eri,3,0,36,33
1657531166875,MATH 105,A01,085443,Carter; Anne Toulson,15,0,35,20
1657531166875,MATH 105,A02,093477,Carter; Anne Toulson,20,0,35,15
1657531172905,MATH 109,A01,083213,Ganzberger; Geoffrey Michael,2,0,34,32
1657531172905,MATH 109,A02,083214,Ganzberger; Geoffrey Michael,4,0,34,30
1657531172905,MATH 109,A03,093478,Ganzberger; Geoffrey Michael,2,0,34,32
1657531172905,MATH 109,B01,083215,Ganzberger; Geoffrey Michael,1,0,32,31
1657531172905,MATH 109,B02,083216,Ganzberger; Geoffrey Michael,2,0,32,30
1657531172905,MATH 109,B03,093479,Ganzberger; Geoffrey Michael,8,0,32,24
1657531178929,MATH 142A,A01,083219,Chow; Bennett,7,0,32,25
1657531178929,MATH 142A,A02,083220,Chow; Bennett,10,0,32,22
1657531178929,MATH 142A,A03,093480,Chow; Bennett,8,0,32,24
1657531178929,MATH 142A,B03,093481,Chow; Bennett,8,0,32,24
1657531178929,MATH 142A,B04,093558,Chow; Bennett,13,0,32,19
1657531178929,MATH 142A,B05,093559,Chow; Bennett,6,0,32,26
1657531184952,MATH 193A,A01,083224,Rotar; Vladimir,8,0,34,26
1657531184952,MATH 193A,A02,083225,Rotar; Vladimir,9,0,34,25
1657531184952,MATH 193A,A03,083781,Rotar; Vladimir,5,0,34,29
1657531184952,MATH 193A,A04,083782,Rotar; Vladimir,10,0,34,24
1657531184952,MATH 193A,A05,093482,Rotar; Vladimir,10,0,34,24
1657531190975,MATH 197,001,091859,McAuley; Julian John,9999,0,9999,0
1657531190975,MATH 197,002,095566,Kedlaya; Kiran S.,9997,0,9999,2
1657531190975,MATH 197,003,095567,Xiao; Ming,9999,0,9999,0
1657531190975,MATH 197,004,095571,Perols; Johan Lars,9998,0,9999,1
1657531198033,COGS 9,A01,083615,Shannon; Kyle Michael,9,0,75,66
1657531204061,COGS 11,A01,083617,Boyle; Mary E. T.,22,0,48,26
1657531210091,COGS 13,A01,083071,Bastos; Amalia Pinkusfeld,11,0,71,60
1657531216114,COGS 14A,A01,092681,Semenuks; Arturs,5,1,100,95
1657531222147,COGS 14B,A01,083073,Cheng; Tzu-Han,6,0,63,57
1657531228174,COGS 17,A01,092677,Semenuks; Arturs,6,0,81,75
1657531234198,COGS 100,A01,083619,Allen; Michael Gordon,17,0,70,53
1657531240230,COGS 101A,A01,083621,Davis; Joshua Daniel,9,0,68,59
1657531246327,COGS 101B,A01,091572,Allen; Michael Gordon,12,0,65,53
1657531252353,COGS 101C,A01,083625,Delgado; Tania,17,0,35,18
1657531258376,COGS 107A,A01,083627,Boyle; Mary E. T.,13,0,60,47
1657531264400,COGS 118A,A01,083075,Gupta; Anjum,21,0,76,55
1657531270425,CSE 3,A50,083646,Miranda; Gregory Joseph,24,0,50,26
1657531276448,CSE 8A,A50,083650,Miranda; Gregory Joseph,17,1,56,39
1657531282474,CSE 11,A01,083080,Cao; Yingjun,6,15,40,34
1657531288502,CSE 12,A01,083652,Krause-Levy; Sophia Louisa,28,1,120,92
1657531294526,CSE 15L,A01,083654,Morris; Justin Loren,9,0,50,41
1657531294526,CSE 15L,A02,083655,Morris; Justin Loren,9,0,50,41
1657531300550,CSE 20,A01,083657,Tran; Khoa Dang,39,0,80,41
1657531306577,CSE 21,A01,095574,Bach; Quang Tran,22,0,48,26
1657531312605,CSE 30,A01,083084,Eldon; John,5,0,80,75
1657531312605,CSE 30,B01,095061,Bhaskar; Nishant,9,0,50,41
1657531318628,CSE 100,A01,083659,Cao; Yingjun,5,4,70,65
1657531324659,CSE 134B,A01,083661,Powell; Thomas Allan,22,0,100,78
1657531330686,CSE 140,A01,083663,Gungor; Onat,15,0,85,70
1657531336714,CSE 140L,A01,083088,Eldon; John,21,0,100,79
1657531342741,CSE 175,A01,083665,Kumar; Rakesh,3,0,25,22
1657531348765,CSE 190,A00,092507,Dubnov; Shlomo,8,0,20,12
1657531354793,ECE 45,A01,083139,Congero; Spencer William,6,0,75,69
1657531360825,ECE 65,A50,083695,Saad; Andrew S,12,0,30,18
1657531360825,ECE 65,A51,095125,Saad; Andrew S,24,0,26,2
1657531366849,ECE 109,A01,091882,Touri; Behrouz,19,0,70,51
1657531372871,ECE 180,A00,083140,Abi Samra; Nicholas Camill,1,0,30,29
1657531372871,ECE 180,B00,083141,Abi Samra; Nicholas Camill,0,0,30,30
1657531378895,MATH 10A,A01,083735,Patchell; Gregory David,2,0,30,28
1657531378895,MATH 10A,A02,083736,Patchell; Gregory David,20,0,30,10
1657531378895,MATH 10A,A03,083737,Patchell; Gregory David,16,0,30,14
1657531384921,MATH 10B,A01,083207,Lim; Seonhee,8,0,34,26
1657531384921,MATH 10B,A02,083208,Lim; Seonhee,9,0,35,26
1657531384921,MATH 10B,A03,093472,Lim; Seonhee,7,0,34,27
1657531384921,MATH 10B,B01,083739,Sinha; Shubham,12,0,30,18
1657531390945,MATH 18,A01,083743,Cinel; Cameron Alexander,7,0,30,23
1657531390945,MATH 18,A02,083744,Cinel; Cameron Alexander,17,0,30,13
1657531390945,MATH 18,A03,083745,Cinel; Cameron Alexander,9,0,30,21
1657531390945,MATH 18,B01,083748,Rideout; David Porter,5,0,37,32
1657531390945,MATH 18,B02,083749,Rideout; David Porter,5,0,36,31
1657531390945,MATH 18,B03,083750,Rideout; David Porter,3,0,37,34
1657531390945,MATH 18,B04,083751,Rideout; David Porter,6,0,36,30
1657531390945,MATH 18,B05,093473,Rideout; David Porter,6,0,36,30
1657531390945,MATH 18,B06,093474,Rideout; David Porter,6,0,36,30
1657531396969,MATH 20A,A01,083754,Zheng; Zequn,14,0,40,26
1657531402994,MATH 20B,A01,083756,Briones; Jor-el Thomas Caparas,4,0,36,32
1657531402994,MATH 20B,A02,083757,Briones; Jor-el Thomas Caparas,1,0,36,35
1657531402994,MATH 20B,A03,093475,Briones; Jor-el Thomas Caparas,2,0,36,34
1657531409021,MATH 20C,A01,083760,Briones; Jor-el Thomas Caparas,1,0,35,34
1657531409021,MATH 20C,A02,083761,Briones; Jor-el Thomas Caparas,8,0,35,27
1657531409021,MATH 20C,A03,093476,Briones; Jor-el Thomas Caparas,0,1,36,36
1657531409021,MATH 20C,B01,083762,Bach; Quang Tran,1,0,30,29
1657531415050,MATH 20D,A01,083765,Tran; Brian Kha,5,0,30,25
1657531415050,MATH 20D,A02,083766,Tran; Brian Kha,5,0,30,25
1657531415050,MATH 20D,A03,083767,Tran; Brian Kha,5,0,30,25
1657531421081,MATH 20E,A01,083771,Ganguly; Soumya,9,0,32,23
1657531421081,MATH 20E,A02,083772,Ganguly; Soumya,6,0,32,26
1657531421081,MATH 20E,B01,083773,Ciotti; Benjamin,20,0,35,15
1657531421081,MATH 20E,B02,083774,Ciotti; Benjamin,17,0,35,18
1657531427113,MATH 103A,A01,083777,Greenfeld; Be'Eri,3,0,36,33
1657531427113,MATH 103A,A02,083778,Greenfeld; Be'Eri,5,0,36,31
1657531427113,MATH 103A,A03,093561,Greenfeld; Be'Eri,5,0,36,31
1657531427113,MATH 103A,B01,083779,Greenfeld; Be'Eri,7,0,36,29
1657531427113,MATH 103A,B02,083780,Greenfeld; Be'Eri,4,0,36,32
1657531427113,MATH 103A,B03,093562,Greenfeld; Be'Eri,3,0,36,33
1657531433137,MATH 105,A01,085443,Carter; Anne Toulson,15,0,35,20
1657531433137,MATH 105,A02,093477,Carter; Anne Toulson,20,0,35,15
1657531439161,MATH 109,A01,083213,Ganzberger; Geoffrey Michael,2,0,34,32
1657531439161,MATH 109,A02,083214,Ganzberger; Geoffrey Michael,4,0,34,30
1657531439161,MATH 109,A03,093478,Ganzberger; Geoffrey Michael,2,0,34,32
1657531439161,MATH 109,B01,083215,Ganzberger; Geoffrey Michael,1,0,32,31
1657531439161,MATH 109,B02,083216,Ganzberger; Geoffrey Michael,2,0,32,30
1657531439161,MATH 109,B03,093479,Ganzberger; Geoffrey Michael,8,0,32,24
1657531445187,MATH 142A,A01,083219,Chow; Bennett,7,0,32,25
1657531445187,MATH 142A,A02,083220,Chow; Bennett,10,0,32,22
1657531445187,MATH 142A,A03,093480,Chow; Bennett,8,0,32,24
1657531445187,MATH 142A,B03,093481,Chow; Bennett,8,0,32,24
1657531445187,MATH 142A,B04,093558,Chow; Bennett,13,0,32,19
1657531445187,MATH 142A,B05,093559,Chow; Bennett,6,0,32,26
1657531451212,MATH 193A,A01,083224,Rotar; Vladimir,8,0,34,26
1657531451212,MATH 193A,A02,083225,Rotar; Vladimir,9,0,34,25
1657531451212,MATH 193A,A03,083781,Rotar; Vladimir,5,0,34,29
1657531451212,MATH 193A,A04,083782,Rotar; Vladimir,10,0,34,24
1657531451212,MATH 193A,A05,093482,Rotar; Vladimir,10,0,34,24
1657531457238,MATH 197,001,091859,McAuley; Julian John,9999,0,9999,0
1657531457238,MATH 197,002,095566,Kedlaya; Kiran S.,9997,0,9999,2
1657531457238,MATH 197,003,095567,Xiao; Ming,9999,0,9999,0
1657531457238,MATH 197,004,095571,Perols; Johan Lars,9998,0,9999,1
1657531464291,COGS 9,A01,083615,Shannon; Kyle Michael,9,0,75,66
1657531470314,COGS 11,A01,083617,Boyle; Mary E. T.,22,0,48,26
1657531476339,COGS 13,A01,083071,Bastos; Amalia Pinkusfeld,11,0,71,60
1657531482361,COGS 14A,A01,092681,Semenuks; Arturs,5,1,100,95
1657531488389,COGS 14B,A01,083073,Cheng; Tzu-Han,6,0,63,57
1657531494416,COGS 17,A01,092677,Semenuks; Arturs,6,0,81,75
1657531500438,COGS 100,A01,083619,Allen; Michael Gordon,17,0,70,53
1657531506466,COGS 101A,A01,083621,Davis; Joshua Daniel,9,0,68,59
1657531512493,COGS 101B,A01,091572,Allen; Michael Gordon,12,0,65,53
1657531518517,COGS 101C,A01,083625,Delgado; Tania,17,0,35,18
1657531524539,COGS 107A,A01,083627,Boyle; Mary E. T.,13,0,60,47
1657531530563,COGS 118A,A01,083075,Gupta; Anjum,21,0,76,55
1657531536590,CSE 3,A50,083646,Miranda; Gregory Joseph,24,0,50,26
1657531542614,CSE 8A,A50,083650,Miranda; Gregory Joseph,17,1,56,39
1657531548638,CSE 11,A01,083080,Cao; Yingjun,6,15,40,34
1657531554664,CSE 12,A01,083652,Krause-Levy; Sophia Louisa,28,1,120,92
1657531560685,CSE 15L,A01,083654,Morris; Justin Loren,9,0,50,41
1657531560685,CSE 15L,A02,083655,Morris; Justin Loren,9,0,50,41
1657531566713,CSE 20,A01,083657,Tran; Khoa Dang,39,0,80,41
1657531572737,CSE 21,A01,095574,Bach; Quang Tran,22,0,48,26
1657531578762,CSE 30,A01,083084,Eldon; John,5,0,80,75
1657531578762,CSE 30,B01,095061,Bhaskar; Nishant,9,0,50,41
1657531584788,CSE 100,A01,083659,Cao; Yingjun,5,4,70,65
1657531590815,CSE 134B,A01,083661,Powell; Thomas Allan,22,0,100,78
1657531596842,CSE 140,A01,083663,Gungor; Onat,15,0,85,70
1657531602870,CSE 140L,A01,083088,Eldon; John,21,0,100,79
1657531608898,CSE 175,A01,083665,Kumar; Rakesh,3,0,25,22
1657531614919,CSE 190,A00,092507,Dubnov; Shlomo,8,0,20,12
1657531620959,ECE 45,A01,083139,Congero; Spencer William,6,0,75,69
1657531626990,ECE 65,A50,083695,Saad; Andrew S,12,0,30,18
1657531626990,ECE 65,A51,095125,Saad; Andrew S,24,0,26,2
1657531633014,ECE 109,A01,091882,Touri; Behrouz,19,0,70,51
1657531639042,ECE 180,A00,083140,Abi Samra; Nicholas Camill,1,0,30,29
1657531639042,ECE 180,B00,083141,Abi Samra; Nicholas Camill,0,0,30,30
1657531645068,MATH 10A,A01,083735,Patchell; Gregory David,2,0,30,28
1657531645068,MATH 10A,A02,083736,Patchell; Gregory David,20,0,30,10
1657531645068,MATH 10A,A03,083737,Patchell; Gregory David,16,0,30,14
1657531651098,MATH 10B,A01,083207,Lim; Seonhee,8,0,34,26
1657531651098,MATH 10B,A02,083208,Lim; Seonhee,9,0,35,26
1657531651098,MATH 10B,A03,093472,Lim; Seonhee,7,0,34,27
1657531651098,MATH 10B,B01,083739,Sinha; Shubham,12,0,30,18
1657531657125,MATH 18,A01,083743,Cinel; Cameron Alexander,7,0,30,23
1657531657125,MATH 18,A02,083744,Cinel; Cameron Alexander,17,0,30,13
1657531657125,MATH 18,A03,083745,Cinel; Cameron Alexander,9,0,30,21
1657531657125,MATH 18,B01,083748,Rideout; David Porter,5,0,37,32
1657531657125,MATH 18,B02,083749,Rideout; David Porter,5,0,36,31
1657531657125,MATH 18,B03,083750,Rideout; David Porter,3,0,37,34
1657531657125,MATH 18,B04,083751,Rideout; David Porter,6,0,36,30
1657531657125,MATH 18,B05,093473,Rideout; David Porter,6,0,36,30
1657531657125,MATH 18,B06,093474,Rideout; David Porter,6,0,36,30
1657531663149,MATH 20A,A01,083754,Zheng; Zequn,14,0,40,26
1657531669177,MATH 20B,A01,083756,Briones; Jor-el Thomas Caparas,4,0,36,32
1657531669177,MATH 20B,A02,083757,Briones; Jor-el Thomas Caparas,1,0,36,35
1657531669177,MATH 20B,A03,093475,Briones; Jor-el Thomas Caparas,2,0,36,34
1657531675207,MATH 20C,A01,083760,Briones; Jor-el Thomas Caparas,1,0,35,34
1657531675207,MATH 20C,A02,083761,Briones; Jor-el Thomas Caparas,8,0,35,27
1657531675207,MATH 20C,A03,093476,Briones; Jor-el Thomas Caparas,0,1,36,36
1657531675207,MATH 20C,B01,083762,Bach; Quang Tran,1,0,30,29
1657531681233,MATH 20D,A01,083765,Tran; Brian Kha,5,0,30,25
1657531681233,MATH 20D,A02,083766,Tran; Brian Kha,5,0,30,25
1657531681233,MATH 20D,A03,083767,Tran; Brian Kha,5,0,30,25
1657531687258,MATH 20E,A01,083771,Ganguly; Soumya,9,0,32,23
1657531687258,MATH 20E,A02,083772,Ganguly; Soumya,6,0,32,26
1657531687258,MATH 20E,B01,083773,Ciotti; Benjamin,20,0,35,15
1657531687258,MATH 20E,B02,083774,Ciotti; Benjamin,17,0,35,18
1657531693290,MATH 103A,A01,083777,Greenfeld; Be'Eri,3,0,36,33
1657531693290,MATH 103A,A02,083778,Greenfeld; Be'Eri,5,0,36,31
1657531693290,MATH 103A,A03,093561,Greenfeld; Be'Eri,5,0,36,31
1657531693290,MATH 103A,B01,083779,Greenfeld; Be'Eri,7,0,36,29
1657531693290,MATH 103A,B02,083780,Greenfeld; Be'Eri,4,0,36,32
1657531693290,MATH 103A,B03,093562,Greenfeld; Be'Eri,3,0,36,33
1657531699317,MATH 105,A01,085443,Carter; Anne Toulson,15,0,35,20
1657531699317,MATH 105,A02,093477,Carter; Anne Toulson,20,0,35,15
1657531705346,MATH 109,A01,083213,Ganzberger; Geoffrey Michael,2,0,34,32
1657531705346,MATH 109,A02,083214,Ganzberger; Geoffrey Michael,4,0,34,30
1657531705346,MATH 109,A03,093478,Ganzberger; Geoffrey Michael,2,0,34,32
1657531705346,MATH 109,B01,083215,Ganzberger; Geoffrey Michael,1,0,32,31
1657531705346,MATH 109,B02,083216,Ganzberger; Geoffrey Michael,2,0,32,30
1657531705346,MATH 109,B03,093479,Ganzberger; Geoffrey Michael,8,0,32,24
1657531711377,MATH 142A,A01,083219,Chow; Bennett,7,0,32,25
1657531711377,MATH 142A,A02,083220,Chow; Bennett,10,0,32,22
1657531711377,MATH 142A,A03,093480,Chow; Bennett,8,0,32,24
1657531711377,MATH 142A,B03,093481,Chow; Bennett,8,0,32,24
1657531711377,MATH 142A,B04,093558,Chow; Bennett,13,0,32,19
1657531711377,MATH 142A,B05,093559,Chow; Bennett,6,0,32,26
1657531717407,MATH 193A,A01,083224,Rotar; Vladimir,8,0,34,26
1657531717407,MATH 193A,A02,083225,Rotar; Vladimir,9,0,34,25
1657531717407,MATH 193A,A03,083781,Rotar; Vladimir,5,0,34,29
1657531717407,MATH 193A,A04,083782,Rotar; Vladimir,10,0,34,24
1657531717407,MATH 193A,A05,093482,Rotar; Vladimir,10,0,34,24
1657531723440,MATH 197,001,091859,McAuley; Julian John,9999,0,9999,0
1657531723440,MATH 197,002,095566,Kedlaya; Kiran S.,9997,0,9999,2
1657531723440,MATH 197,003,095567,Xiao; Ming,9999,0,9999,0
1657531723440,MATH 197,004,095571,Perols; Johan Lars,9998,0,9999,1
1657531730494,COGS 9,A01,083615,Shannon; Kyle Michael,9,0,75,66
1657531736522,COGS 11,A01,083617,Boyle; Mary E. T.,22,0,48,26
1657531742546,COGS 13,A01,083071,Bastos; Amalia Pinkusfeld,11,0,71,60
1657531748574,COGS 14A,A01,092681,Semenuks; Arturs,5,1,100,95
1657531754609,COGS 14B,A01,083073,Cheng; Tzu-Han,6,0,63,57
1657531760634,COGS 17,A01,092677,Semenuks; Arturs,6,0,81,75
1657531766656,COGS 100,A01,083619,Allen; Michael Gordon,17,0,70,53
1657531772679,COGS 101A,A01,083621,Davis; Joshua Daniel,9,0,68,59
1657531778702,COGS 101B,A01,091572,Allen; Michael Gordon,12,0,65,53
1657531784732,COGS 101C,A01,083625,Delgado; Tania,17,0,35,18
1657531790754,COGS 107A,A01,083627,Boyle; Mary E. T.,13,0,60,47
1657531796779,COGS 118A,A01,083075,Gupta; Anjum,21,0,76,55
1657531802804,CSE 3,A50,083646,Miranda; Gregory Joseph,24,0,50,26
1657531808833,CSE 8A,A50,083650,Miranda; Gregory Joseph,17,1,56,39
1657531814857,CSE 11,A01,083080,Cao; Yingjun,6,15,40,34
1657531820880,CSE 12,A01,083652,Krause-Levy; Sophia Louisa,28,1,120,92
1657531826906,CSE 15L,A01,083654,Morris; Justin Loren,9,0,50,41
1657531826906,CSE 15L,A02,083655,Morris; Justin Loren,9,0,50,41
1657531832929,CSE 20,A01,083657,Tran; Khoa Dang,39,0,80,41
1657531838959,CSE 21,A01,095574,Bach; Quang Tran,22,0,48,26
1657531845071,CSE 30,A01,083084,Eldon; John,5,0,80,75
1657531845071,CSE 30,B01,095061,Bhaskar; Nishant,9,0,50,41
1657531851096,CSE 100,A01,083659,Cao; Yingjun,5,4,70,65
1657531857122,CSE 134B,A01,083661,Powell; Thomas Allan,22,0,100,78
1657531863147,CSE 140,A01,083663,Gungor; Onat,15,0,85,70
1657531869174,CSE 140L,A01,083088,Eldon; John,21,0,100,79
1657531875208,CSE 175,A01,083665,Kumar; Rakesh,3,0,25,22
1657531881232,CSE 190,A00,092507,Dubnov; Shlomo,8,0,20,12
1657531887258,ECE 45,A01,083139,Congero; Spencer William,6,0,75,69
1657531893284,ECE 65,A50,083695,Saad; Andrew S,12,0,30,18
1657531893284,ECE 65,A51,095125,Saad; Andrew S,24,0,26,2
1657531899393,ECE 109,A01,091882,Touri; Behrouz,19,0,70,51
1657531905422,ECE 180,A00,083140,Abi Samra; Nicholas Camill,1,0,30,29
1657531905422,ECE 180,B00,083141,Abi Samra; Nicholas Camill,0,0,30,30
1657531911447,MATH 10A,A01,083735,Patchell; Gregory David,2,0,30,28
1657531911447,MATH 10A,A02,083736,Patchell; Gregory David,20,0,30,10
1657531911447,MATH 10A,A03,083737,Patchell; Gregory David,16,0,30,14
1657531917475,MATH 10B,A01,083207,Lim; Seonhee,8,0,34,26
1657531917475,MATH 10B,A02,083208,Lim; Seonhee,9,0,35,26
1657531917475,MATH 10B,A03,093472,Lim; Seonhee,7,0,34,27
1657531917475,MATH 10B,B01,083739,Sinha; Shubham,12,0,30,18
1657531923514,MATH 18,A01,083743,Cinel; Cameron Alexander,7,0,30,23
1657531923514,MATH 18,A02,083744,Cinel; Cameron Alexander,17,0,30,13
1657531923514,MATH 18,A03,083745,Cinel; Cameron Alexander,9,0,30,21
1657531923514,MATH 18,B01,083748,Rideout; David Porter,5,0,37,32
1657531923514,MATH 18,B02,083749,Rideout; David Porter,5,0,36,31
1657531923514,MATH 18,B03,083750,Rideout; David Porter,3,0,37,34
1657531923514,MATH 18,B04,083751,Rideout; David Porter,6,0,36,30
1657531923514,MATH 18,B05,093473,Rideout; David Porter,6,0,36,30
1657531923514,MATH 18,B06,093474,Rideout; David Porter,6,0,36,30
1657531929540,MATH 20A,A01,083754,Zheng; Zequn,14,0,40,26
1657531935573,MATH 20B,A01,083756,Briones; Jor-el Thomas Caparas,4,0,36,32
1657531935573,MATH 20B,A02,083757,Briones; Jor-el Thomas Caparas,1,0,36,35
1657531935573,MATH 20B,A03,093475,Briones; Jor-el Thomas Caparas,2,0,36,34
1657531941607,MATH 20C,A01,083760,Briones; Jor-el Thomas Caparas,1,0,35,34
1657531941607,MATH 20C,A02,083761,Briones; Jor-el Thomas Caparas,8,0,35,27
1657531941607,MATH 20C,A03,093476,Briones; Jor-el Thomas Caparas,0,1,36,36
1657531941607,MATH 20C,B01,083762,Bach; Quang Tran,1,0,30,29
1657531947631,MATH 20D,A01,083765,Tran; Brian Kha,5,0,30,25
1657531947631,MATH 20D,A02,083766,Tran; Brian Kha,5,0,30,25
1657531947631,MATH 20D,A03,083767,Tran; Brian Kha,5,0,30,25
1657531953658,MATH 20E,A01,083771,Ganguly; Soumya,9,0,32,23
1657531953658,MATH 20E,A02,083772,Ganguly; Soumya,6,0,32,26
1657531953658,MATH 20E,B01,083773,Ciotti; Benjamin,20,0,35,15
1657531953658,MATH 20E,B02,083774,Ciotti; Benjamin,17,0,35,18
1657531959694,MATH 103A,A01,083777,Greenfeld; Be'Eri,3,0,36,33
1657531959694,MATH 103A,A02,083778,Greenfeld; Be'Eri,5,0,36,31
1657531959694,MATH 103A,A03,093561,Greenfeld; Be'Eri,5,0,36,31
1657531959694,MATH 103A,B01,083779,Greenfeld; Be'Eri,7,0,36,29
1657531959694,MATH 103A,B02,083780,Greenfeld; Be'Eri,4,0,36,32
1657531959694,MATH 103A,B03,093562,Greenfeld; Be'Eri,3,0,36,33
1657531965720,MATH 105,A01,085443,Carter; Anne Toulson,15,0,35,20
1657531965720,MATH 105,A02,093477,Carter; Anne Toulson,20,0,35,15
1657531971747,MATH 109,A01,083213,Ganzberger; Geoffrey Michael,2,0,34,32
1657531971747,MATH 109,A02,083214,Ganzberger; Geoffrey Michael,4,0,34,30
1657531971747,MATH 109,A03,093478,Ganzberger; Geoffrey Michael,2,0,34,32
1657531971747,MATH 109,B01,083215,Ganzberger; Geoffrey Michael,1,0,32,31
1657531971747,MATH 109,B02,083216,Ganzberger; Geoffrey Michael,2,0,32,30
1657531971747,MATH 109,B03,093479,Ganzberger; Geoffrey Michael,8,0,32,24
1657531977782,MATH 142A,A01,083219,Chow; Bennett,7,0,32,25
1657531977782,MATH 142A,A02,083220,Chow; Bennett,10,0,32,22
1657531977782,MATH 142A,A03,093480,Chow; Bennett,8,0,32,24
1657531977782,MATH 142A,B03,093481,Chow; Bennett,8,0,32,24
1657531977782,MATH 142A,B04,093558,Chow; Bennett,13,0,32,19
1657531977782,MATH 142A,B05,093559,Chow; Bennett,6,0,32,26
1657531983812,MATH 193A,A01,083224,Rotar; Vladimir,8,0,34,26
1657531983812,MATH 193A,A02,083225,Rotar; Vladimir,9,0,34,25
1657531983812,MATH 193A,A03,083781,Rotar; Vladimir,5,0,34,29
1657531983812,MATH 193A,A04,083782,Rotar; Vladimir,10,0,34,24
1657531983812,MATH 193A,A05,093482,Rotar; Vladimir,10,0,34,24
1657531989846,MATH 197,001,091859,McAuley; Julian John,9999,0,9999,0
1657531989846,MATH 197,002,095566,Kedlaya; Kiran S.,9997,0,9999,2
1657531989846,MATH 197,003,095567,Xiao; Ming,9999,0,9999,0
1657531989846,MATH 197,004,095571,Perols; Johan Lars,9998,0,9999,1
1657531996927,COGS 9,A01,083615,Shannon; Kyle Michael,9,0,75,66
1657532002952,COGS 11,A01,083617,Boyle; Mary E. T.,22,0,48,26
1657532008979,COGS 13,A01,083071,Bastos; Amalia Pinkusfeld,11,0,71,60
1657532015005,COGS 14A,A01,092681,Semenuks; Arturs,5,1,100,95
1657532021029,COGS 14B,A01,083073,Cheng; Tzu-Han,6,0,63,57
1657532027053,COGS 17,A01,092677,Semenuks; Arturs,6,0,81,75
1657532033082,COGS 100,A01,083619,Allen; Michael Gordon,17,0,70,53
1657532039109,COGS 101A,A01,083621,Davis; Joshua Daniel,9,0,68,59
1657532045134,COGS 101B,A01,091572,Allen; Michael Gordon,12,0,65,53
1657532051160,COGS 101C,A01,083625,Delgado; Tania,17,0,35,18
1657532057183,COGS 107A,A01,083627,Boyle; Mary E. T.,13,0,60,47
1657532063217,COGS 118A,A01,083075,Gupta; Anjum,21,0,76,55
1657532069250,CSE 3,A50,083646,Miranda; Gregory Joseph,24,0,50,26
1657532075274,CSE 8A,A50,083650,Miranda; Gregory Joseph,17,1,56,39
1657532081299,CSE 11,A01,083080,Cao; Yingjun,6,15,40,34
1657532087322,CSE 12,A01,083652,Krause-Levy; Sophia Louisa,28,1,120,92
1657532093353,CSE 15L,A01,083654,Morris; Justin Loren,9,0,50,41
1657532093353,CSE 15L,A02,083655,Morris; Justin Loren,9,0,50,41
1657532099389,CSE 20,A01,083657,Tran; Khoa Dang,39,0,80,41
1657532105414,CSE 21,A01,095574,Bach; Quang Tran,22,0,48,26
1657532111449,CSE 30,A01,083084,Eldon; John,5,0,80,75
1657532111449,CSE 30,B01,095061,Bhaskar; Nishant,9,0,50,41
1657532117472,CSE 100,A01,083659,Cao; Yingjun,5,4,70,65
1657532123506,CSE 134B,A01,083661,Powell; Thomas Allan,22,0,100,78
1657532129529,CSE 140,A01,083663,Gungor; Onat,15,0,85,70
1657532135553,CSE 140L,A01,083088,Eldon; John,21,0,100,79
1657532141584,CSE 175,A01,083665,Kumar; Rakesh,3,0,25,22
1657532147611,CSE 190,A00,092507,Dubnov; Shlomo,8,0,20,12
1657532153642,ECE 45,A01,083139,Congero; Spencer William,6,0,75,69
1657532159686,ECE 65,A50,083695,Saad; Andrew S,12,0,30,18
1657532159686,ECE 65,A51,095125,Saad; Andrew S,24,0,26,2
1657532165710,ECE 109,A01,091882,Touri; Behrouz,19,0,70,51
1657532171735,ECE 180,A00,083140,Abi Samra; Nicholas Camill,1,0,30,29
1657532171735,ECE 180,B00,083141,Abi Samra; Nicholas Camill,0,0,30,30
1657532177772,MATH 10A,A01,083735,Patchell; Gregory David,2,0,30,28
1657532177772,MATH 10A,A02,083736,Patchell; Gregory David,20,0,30,10
1657532177772,MATH 10A,A03,083737,Patchell; Gregory David,16,0,30,14
1657532183800,MATH 10B,A01,083207,Lim; Seonhee,8,0,34,26
1657532183800,MATH 10B,A02,083208,Lim; Seonhee,9,0,35,26
1657532183800,MATH 10B,A03,093472,Lim; Seonhee,7,0,34,27
1657532183800,MATH 10B,B01,083739,Sinha; Shubham,12,0,30,18
1657532189824,MATH 18,A01,083743,Cinel; Cameron Alexander,7,0,30,23
1657532189824,MATH 18,A02,083744,Cinel; Cameron Alexander,17,0,30,13
1657532189824,MATH 18,A03,083745,Cinel; Cameron Alexander,9,0,30,21
1657532189824,MATH 18,B01,083748,Rideout; David Porter,5,0,37,32
1657532189824,MATH 18,B02,083749,Rideout; David Porter,5,0,36,31
1657532189824,MATH 18,B03,083750,Rideout; David Porter,3,0,37,34
1657532189824,MATH 18,B04,083751,Rideout; David Porter,6,0,36,30
1657532189824,MATH 18,B05,093473,Rideout; David Porter,6,0,36,30
1657532189824,MATH 18,B06,093474,Rideout; David Porter,6,0,36,30
1657532195850,MATH 20A,A01,083754,Zheng; Zequn,14,0,40,26
1657532201882,MATH 20B,A01,083756,Briones; Jor-el Thomas Caparas,4,0,36,32
1657532201882,MATH 20B,A02,083757,Briones; Jor-el Thomas Caparas,1,0,36,35
1657532201882,MATH 20B,A03,093475,Briones; Jor-el Thomas Caparas,2,0,36,34
1657532207905,MATH 20C,A01,083760,Briones; Jor-el Thomas Caparas,1,0,35,34
1657532207905,MATH 20C,A02,083761,Briones; Jor-el Thomas Caparas,8,0,35,27
1657532207905,MATH 20C,A03,093476,Briones; Jor-el Thomas Caparas,0,1,36,36
1657532207905,MATH 20C,B01,083762,Bach; Quang Tran,1,0,30,29
1657532213935,MATH 20D,A01,083765,Tran; Brian Kha,5,0,30,25
1657532213935,MATH 20D,A02,083766,Tran; Brian Kha,5,0,30,25
1657532213935,MATH 20D,A03,083767,Tran; Brian Kha,5,0,30,25
1657532219960,MATH 20E,A01,083771,Ganguly; Soumya,9,0,32,23
1657532219960,MATH 20E,A02,083772,Ganguly; Soumya,6,0,32,26
1657532219960,MATH 20E,B01,083773,Ciotti; Benjamin,20,0,35,15
1657532219960,MATH 20E,B02,083774,Ciotti; Benjamin,17,0,35,18
1657532225985,MATH 103A,A01,083777,Greenfeld; Be'Eri,3,0,36,33
1657532225985,MATH 103A,A02,083778,Greenfeld; Be'Eri,5,0,36,31
1657532225985,MATH 103A,A03,093561,Greenfeld; Be'Eri,5,0,36,31
1657532225985,MATH 103A,B01,083779,Greenfeld; Be'Eri,7,0,36,29
1657532225985,MATH 103A,B02,083780,Greenfeld; Be'Eri,4,0,36,32
1657532225985,MATH 103A,B03,093562,Greenfeld; Be'Eri,3,0,36,33
1657532232017,MATH 105,A01,085443,Carter; Anne Toulson,15,0,35,20
1657532232017,MATH 105,A02,093477,Carter; Anne Toulson,20,0,35,15
1657532238047,MATH 109,A01,083213,Ganzberger; Geoffrey Michael,2,0,34,32
1657532238047,MATH 109,A02,083214,Ganzberger; Geoffrey Michael,4,0,34,30
1657532238047,MATH 109,A03,093478,Ganzberger; Geoffrey Michael,2,0,34,32
1657532238047,MATH 109,B01,083215,Ganzberger; Geoffrey Michael,1,0,32,31
1657532238047,MATH 109,B02,083216,Ganzberger; Geoffrey Michael,2,0,32,30
1657532238047,MATH 109,B03,093479,Ganzberger; Geoffrey Michael,8,0,32,24
1657532244074,MATH 142A,A01,083219,Chow; Bennett,7,0,32,25
1657532244074,MATH 142A,A02,083220,Chow; Bennett,10,0,32,22
1657532244074,MATH 142A,A03,093480,Chow; Bennett,8,0,32,24
1657532244074,MATH 142A,B03,093481,Chow; Bennett,8,0,32,24
1657532244074,MATH 142A,B04,093558,Chow; Bennett,13,0,32,19
1657532244074,MATH 142A,B05,093559,Chow; Bennett,6,0,32,26
1657532250098,MATH 193A,A01,083224,Rotar; Vladimir,8,0,34,26
1657532250098,MATH 193A,A02,083225,Rotar; Vladimir,9,0,34,25
1657532250098,MATH 193A,A03,083781,Rotar; Vladimir,5,0,34,29
1657532250098,MATH 193A,A04,083782,Rotar; Vladimir,10,0,34,24
1657532250098,MATH 193A,A05,093482,Rotar; Vladimir,10,0,34,24
1657532256121,MATH 197,001,091859,McAuley; Julian John,9999,0,9999,0
1657532256121,MATH 197,002,095566,Kedlaya; Kiran S.,9997,0,9999,2
1657532256121,MATH 197,003,095567,Xiao; Ming,9999,0,9999,0
1657532256121,MATH 197,004,095571,Perols; Johan Lars,9998,0,9999,1
1657532263191,COGS 9,A01,083615,Shannon; Kyle Michael,9,0,75,66
1657532269214,COGS 11,A01,083617,Boyle; Mary E. T.,22,0,48,26
1657532275240,COGS 13,A01,083071,Bastos; Amalia Pinkusfeld,11,0,71,60
1657532281261,COGS 14A,A01,092681,Semenuks; Arturs,5,1,100,95
1657532287286,COGS 14B,A01,083073,Cheng; Tzu-Han,6,0,63,57
1657532293310,COGS 17,A01,092677,Semenuks; Arturs,6,0,81,75
1657532299335,COGS 100,A01,083619,Allen; Michael Gordon,17,0,70,53
1657532305367,COGS 101A,A01,083621,Davis; Joshua Daniel,9,0,68,59
1657532311390,COGS 101B,A01,091572,Allen; Michael Gordon,12,0,65,53
1657532317417,COGS 101C,A01,083625,Delgado; Tania,17,0,35,18
1657532323441,COGS 107A,A01,083627,Boyle; Mary E. T.,13,0,60,47
1657532329468,COGS 118A,A01,083075,Gupta; Anjum,21,0,76,55
1657532335492,CSE 3,A50,083646,Miranda; Gregory Joseph,24,0,50,26
1657532341515,CSE 8A,A50,083650,Miranda; Gregory Joseph,17,1,56,39
1657532347540,CSE 11,A01,083080,Cao; Yingjun,6,15,40,34
1657532353564,CSE 12,A01,083652,Krause-Levy; Sophia Louisa,28,1,120,92
1657532359589,CSE 15L,A01,083654,Morris; Justin Loren,9,0,50,41
1657532359589,CSE 15L,A02,083655,Morris; Justin Loren,9,0,50,41
1657532365616,CSE 20,A01,083657,Tran; Khoa Dang,39,0,80,41
1657532371642,CSE 21,A01,095574,Bach; Quang Tran,22,0,48,26
1657532377667,CSE 30,A01,083084,Eldon; John,5,0,80,75
1657532377667,CSE 30,B01,095061,Bhaskar; Nishant,9,0,50,41
1657532383688,CSE 100,A01,083659,Cao; Yingjun,5,4,70,65
1657532389714,CSE 134B,A01,083661,Powell; Thomas Allan,22,0,100,78
1657532395740,CSE 140,A01,083663,Gungor; Onat,15,0,85,70
1657532401762,CSE 140L,A01,083088,Eldon; John,21,0,100,79
1657532407786,CSE 175,A01,083665,Kumar; Rakesh,3,0,25,22
1657532413813,CSE 190,A00,092507,Dubnov; Shlomo,8,0,20,12
1657532419840,ECE 45,A01,083139,Congero; Spencer William,6,0,75,69
1657532425867,ECE 65,A50,083695,Saad; Andrew S,12,0,30,18
1657532425867,ECE 65,A51,095125,Saad; Andrew S,24,0,26,2
1657532431889,ECE 109,A01,091882,Touri; Behrouz,19,0,70,51
1657532437911,ECE 180,A00,083140,Abi Samra; Nicholas Camill,1,0,30,29
1657532437911,ECE 180,B00,083141,Abi Samra; Nicholas Camill,0,0,30,30
1657532444014,MATH 10A,A01,083735,Patchell; Gregory David,2,0,30,28
1657532444014,MATH 10A,A02,083736,Patchell; Gregory David,20,0,30,10
1657532444014,MATH 10A,A03,083737,Patchell; Gregory David,16,0,30,14
1657532450040,MATH 10B,A01,083207,Lim; Seonhee,8,0,34,26
1657532450040,MATH 10B,A02,083208,Lim; Seonhee,9,0,35,26
1657532450040,MATH 10B,A03,093472,Lim; Seonhee,7,0,34,27
1657532450040,MATH 10B,B01,083739,Sinha; Shubham,12,0,30,18
1657532456067,MATH 18,A01,083743,Cinel; Cameron Alexander,7,0,30,23
1657532456067,MATH 18,A02,083744,Cinel; Cameron Alexander,17,0,30,13
1657532456067,MATH 18,A03,083745,Cinel; Cameron Alexander,9,0,30,21
1657532456067,MATH 18,B01,083748,Rideout; David Porter,5,0,37,32
1657532456067,MATH 18,B02,083749,Rideout; David Porter,5,0,36,31
1657532456067,MATH 18,B03,083750,Rideout; David Porter,3,0,37,34
1657532456067,MATH 18,B04,083751,Rideout; David Porter,6,0,36,30
1657532456067,MATH 18,B05,093473,Rideout; David Porter,6,0,36,30
1657532456067,MATH 18,B06,093474,Rideout; David Porter,6,0,36,30
1657532462090,MATH 20A,A01,083754,Zheng; Zequn,14,0,40,26
1657532468114,MATH 20B,A01,083756,Briones; Jor-el Thomas Caparas,4,0,36,32
1657532468114,MATH 20B,A02,083757,Briones; Jor-el Thomas Caparas,1,0,36,35
1657532468114,MATH 20B,A03,093475,Briones; Jor-el Thomas Caparas,2,0,36,34
1657532474138,MATH 20C,A01,083760,Briones; Jor-el Thomas Caparas,1,0,35,34
1657532474138,MATH 20C,A02,083761,Briones; Jor-el Thomas Caparas,8,0,35,27
1657532474138,MATH 20C,A03,093476,Briones; Jor-el Thomas Caparas,0,1,36,36
1657532474138,MATH 20C,B01,083762,Bach; Quang Tran,1,0,30,29
1657532480161,MATH 20D,A01,083765,Tran; Brian Kha,5,0,30,25
1657532480161,MATH 20D,A02,083766,Tran; Brian Kha,5,0,30,25
1657532480161,MATH 20D,A03,083767,Tran; Brian Kha,5,0,30,25
1657532486184,MATH 20E,A01,083771,Ganguly; Soumya,9,0,32,23
1657532486184,MATH 20E,A02,083772,Ganguly; Soumya,6,0,32,26
1657532486184,MATH 20E,B01,083773,Ciotti; Benjamin,20,0,35,15
1657532486184,MATH 20E,B02,083774,Ciotti; Benjamin,17,0,35,18
1657532492216,MATH 103A,A01,083777,Greenfeld; Be'Eri,3,0,36,33
1657532492216,MATH 103A,A02,083778,Greenfeld; Be'Eri,5,0,36,31
1657532492216,MATH 103A,A03,093561,Greenfeld; Be'Eri,5,0,36,31
1657532492216,MATH 103A,B01,083779,Greenfeld; Be'Eri,7,0,36,29
1657532492216,MATH 103A,B02,083780,Greenfeld; Be'Eri,4,0,36,32
1657532492216,MATH 103A,B03,093562,Greenfeld; Be'Eri,3,0,36,33
1657532498239,MATH 105,A01,085443,Carter; Anne Toulson,15,0,35,20
1657532498239,MATH 105,A02,093477,Carter; Anne Toulson,20,0,35,15
1657532504262,MATH 109,A01,083213,Ganzberger; Geoffrey Michael,2,0,34,32
1657532504262,MATH 109,A02,083214,Ganzberger; Geoffrey Michael,4,0,34,30
1657532504262,MATH 109,A03,093478,Ganzberger; Geoffrey Michael,2,0,34,32
1657532504262,MATH 109,B01,083215,Ganzberger; Geoffrey Michael,1,0,32,31
1657532504262,MATH 109,B02,083216,Ganzberger; Geoffrey Michael,2,0,32,30
1657532504262,MATH 109,B03,093479,Ganzberger; Geoffrey Michael,8,0,32,24
1657532510287,MATH 142A,A01,083219,Chow; Bennett,7,0,32,25
1657532510287,MATH 142A,A02,083220,Chow; Bennett,10,0,32,22
1657532510287,MATH 142A,A03,093480,Chow; Bennett,8,0,32,24
1657532510287,MATH 142A,B03,093481,Chow; Bennett,8,0,32,24
1657532510287,MATH 142A,B04,093558,Chow; Bennett,13,0,32,19
1657532510287,MATH 142A,B05,093559,Chow; Bennett,6,0,32,26
1657532516311,MATH 193A,A01,083224,Rotar; Vladimir,8,0,34,26
1657532516311,MATH 193A,A02,083225,Rotar; Vladimir,9,0,34,25
1657532516311,MATH 193A,A03,083781,Rotar; Vladimir,5,0,34,29
1657532516311,MATH 193A,A04,083782,Rotar; Vladimir,10,0,34,24
1657532516311,MATH 193A,A05,093482,Rotar; Vladimir,10,0,34,24
1657532522340,MATH 197,001,091859,McAuley; Julian John,9999,0,9999,0
1657532522340,MATH 197,002,095566,Kedlaya; Kiran S.,9997,0,9999,2
1657532522340,MATH 197,003,095567,Xiao; Ming,9999,0,9999,0
1657532522340,MATH 197,004,095571,Perols; Johan Lars,9998,0,9999,1
1657532529401,COGS 9,A01,083615,Shannon; Kyle Michael,9,0,75,66
1657532535424,COGS 11,A01,083617,Boyle; Mary E. T.,22,0,48,26
1657532541462,COGS 13,A01,083071,Bastos; Amalia Pinkusfeld,11,0,71,60
1657532547487,COGS 14A,A01,092681,Semenuks; Arturs,5,1,100,95
1657532553511,COGS 14B,A01,083073,Cheng; Tzu-Han,6,0,63,57
1657532559535,COGS 17,A01,092677,Semenuks; Arturs,6,0,81,75
1657532565563,COGS 100,A01,083619,Allen; Michael Gordon,17,0,70,53
1657532571592,COGS 101A,A01,083621,Davis; Joshua Daniel,9,0,68,59
1657532577616,COGS 101B,A01,091572,Allen; Michael Gordon,12,0,65,53
1657532583644,COGS 101C,A01,083625,Delgado; Tania,17,0,35,18
1657532589670,COGS 107A,A01,083627,Boyle; Mary E. T.,13,0,60,47
1657532595695,COGS 118A,A01,083075,Gupta; Anjum,21,0,76,55
1657532601722,CSE 3,A50,083646,Miranda; Gregory Joseph,24,0,50,26
1657532607752,CSE 8A,A50,083650,Miranda; Gregory Joseph,17,1,56,39
1657532613776,CSE 11,A01,083080,Cao; Yingjun,6,15,40,34
1657532619805,CSE 12,A01,083652,Krause-Levy; Sophia Louisa,28,1,120,92
1657532625833,CSE 15L,A01,083654,Morris; Justin Loren,9,0,50,41
1657532625833,CSE 15L,A02,083655,Morris; Justin Loren,9,0,50,41
1657532631856,CSE 20,A01,083657,Tran; Khoa Dang,39,0,80,41
1657532637890,CSE 21,A01,095574,Bach; Quang Tran,22,0,48,26
1657532643915,CSE 30,A01,083084,Eldon; John,5,0,80,75
1657532643915,CSE 30,B01,095061,Bhaskar; Nishant,9,0,50,41
1657532649939,CSE 100,A01,083659,Cao; Yingjun,5,4,70,65
1657532655965,CSE 134B,A01,083661,Powell; Thomas Allan,22,0,100,78
1657532661998,CSE 140,A01,083663,Gungor; Onat,15,0,85,70
1657532668022,CSE 140L,A01,083088,Eldon; John,21,0,100,79
1657532674045,CSE 175,A01,083665,Kumar; Rakesh,3,0,25,22
1657532680068,CSE 190,A00,092507,Dubnov; Shlomo,8,0,20,12
1657532686093,ECE 45,A01,083139,Congero; Spencer William,6,0,75,69
1657532692122,ECE 65,A50,083695,Saad; Andrew S,12,0,30,18
1657532692122,ECE 65,A51,095125,Saad; Andrew S,24,0,26,2
1657532698149,ECE 109,A01,091882,Touri; Behrouz,19,0,70,51
1657532704177,ECE 180,A00,083140,Abi Samra; Nicholas Camill,1,0,30,29
1657532704177,ECE 180,B00,083141,Abi Samra; Nicholas Camill,0,0,30,30
1657532710200,MATH 10A,A01,083735,Patchell; Gregory David,2,0,30,28
1657532710200,MATH 10A,A02,083736,Patchell; Gregory David,20,0,30,10
1657532710200,MATH 10A,A03,083737,Patchell; Gregory David,16,0,30,14
1657532716227,MATH 10B,A01,083207,Lim; Seonhee,8,0,34,26
1657532716227,MATH 10B,A02,083208,Lim; Seonhee,9,0,35,26
1657532716227,MATH 10B,A03,093472,Lim; Seonhee,7,0,34,27
1657532716227,MATH 10B,B01,083739,Sinha; Shubham,12,0,30,18
1657532722265,MATH 18,A01,083743,Cinel; Cameron Alexander,7,0,30,23
1657532722265,MATH 18,A02,083744,Cinel; Cameron Alexander,17,0,30,13
1657532722265,MATH 18,A03,083745,Cinel; Cameron Alexander,9,0,30,21
1657532722265,MATH 18,B01,083748,Rideout; David Porter,5,0,37,32
1657532722265,MATH 18,B02,083749,Rideout; David Porter,5,0,36,31
1657532722265,MATH 18,B03,083750,Rideout; David Porter,3,0,37,34
1657532722265,MATH 18,B04,083751,Rideout; David Porter,6,0,36,30
1657532722265,MATH 18,B05,093473,Rideout; David Porter,6,0,36,30
1657532722265,MATH 18,B06,093474,Rideout; David Porter,6,0,36,30
1657532728293,MATH 20A,A01,083754,Zheng; Zequn,14,0,40,26
1657532734321,MATH 20B,A01,083756,Briones; Jor-el Thomas Caparas,4,0,36,32
1657532734321,MATH 20B,A02,083757,Briones; Jor-el Thomas Caparas,1,0,36,35
1657532734321,MATH 20B,A03,093475,Briones; Jor-el Thomas Caparas,2,0,36,34
1657532740350,MATH 20C,A01,083760,Briones; Jor-el Thomas Caparas,1,0,35,34
1657532740350,MATH 20C,A02,083761,Briones; Jor-el Thomas Caparas,8,0,35,27
1657532740350,MATH 20C,A03,093476,Briones; Jor-el Thomas Caparas,0,1,36,36
1657532740350,MATH 20C,B01,083762,Bach; Quang Tran,1,0,30,29
1657532746373,MATH 20D,A01,083765,Tran; Brian Kha,5,0,30,25
1657532746373,MATH 20D,A02,083766,Tran; Brian Kha,5,0,30,25
1657532746373,MATH 20D,A03,083767,Tran; Brian Kha,5,0,30,25
1657532752411,MATH 20E,A01,083771,Ganguly; Soumya,9,0,32,23
1657532752411,MATH 20E,A02,083772,Ganguly; Soumya,6,0,32,26
1657532752411,MATH 20E,B01,083773,Ciotti; Benjamin,20,0,35,15
1657532752411,MATH 20E,B02,083774,Ciotti; Benjamin,17,0,35,18
1657532758438,MATH 103A,A01,083777,Greenfeld; Be'Eri,3,0,36,33
1657532758438,MATH 103A,A02,083778,Greenfeld; Be'Eri,5,0,36,31
1657532758438,MATH 103A,A03,093561,Greenfeld; Be'Eri,5,0,36,31
1657532758438,MATH 103A,B01,083779,Greenfeld; Be'Eri,7,0,36,29
1657532758438,MATH 103A,B02,083780,Greenfeld; Be'Eri,4,0,36,32
1657532758438,MATH 103A,B03,093562,Greenfeld; Be'Eri,3,0,36,33
1657532764462,MATH 105,A01,085443,Carter; Anne Toulson,15,0,35,20
1657532764462,MATH 105,A02,093477,Carter; Anne Toulson,20,0,35,15
1657532770485,MATH 109,A01,083213,Ganzberger; Geoffrey Michael,2,0,34,32
1657532770485,MATH 109,A02,083214,Ganzberger; Geoffrey Michael,4,0,34,30
1657532770485,MATH 109,A03,093478,Ganzberger; Geoffrey Michael,2,0,34,32
1657532770485,MATH 109,B01,083215,Ganzberger; Geoffrey Michael,1,0,32,31
1657532770485,MATH 109,B02,083216,Ganzberger; Geoffrey Michael,2,0,32,30
1657532770485,MATH 109,B03,093479,Ganzberger; Geoffrey Michael,8,0,32,24
1657532776509,MATH 142A,A01,083219,Chow; Bennett,7,0,32,25
1657532776509,MATH 142A,A02,083220,Chow; Bennett,10,0,32,22
1657532776509,MATH 142A,A03,093480,Chow; Bennett,8,0,32,24
1657532776509,MATH 142A,B03,093481,Chow; Bennett,8,0,32,24
1657532776509,MATH 142A,B04,093558,Chow; Bennett,13,0,32,19
1657532776509,MATH 142A,B05,093559,Chow; Bennett,6,0,32,26
1657532782534,MATH 193A,A01,083224,Rotar; Vladimir,8,0,34,26
1657532782534,MATH 193A,A02,083225,Rotar; Vladimir,9,0,34,25
1657532782534,MATH 193A,A03,083781,Rotar; Vladimir,5,0,34,29
1657532782534,MATH 193A,A04,083782,Rotar; Vladimir,10,0,34,24
1657532782534,MATH 193A,A05,093482,Rotar; Vladimir,10,0,34,24
1657532788560,MATH 197,001,091859,McAuley; Julian John,9999,0,9999,0
1657532788560,MATH 197,002,095566,Kedlaya; Kiran S.,9997,0,9999,2
1657532788560,MATH 197,003,095567,Xiao; Ming,9999,0,9999,0
1657532788560,MATH 197,004,095571,Perols; Johan Lars,9998,0,9999,1
1657532795626,COGS 9,A01,083615,Shannon; Kyle Michael,9,0,75,66
1657532801654,COGS 11,A01,083617,Boyle; Mary E. T.,22,0,48,26
1657532807681,COGS 13,A01,083071,Bastos; Amalia Pinkusfeld,11,0,71,60
1657532813704,COGS 14A,A01,092681,Semenuks; Arturs,5,1,100,95
1657532819730,COGS 14B,A01,083073,Cheng; Tzu-Han,6,0,63,57
1657532825754,COGS 17,A01,092677,Semenuks; Arturs,6,0,81,75
1657532831778,COGS 100,A01,083619,Allen; Michael Gordon,17,0,70,53
1657532837800,COGS 101A,A01,083621,Davis; Joshua Daniel,9,0,68,59
1657532843827,COGS 101B,A01,091572,Allen; Michael Gordon,12,0,65,53
1657532849850,COGS 101C,A01,083625,Delgado; Tania,17,0,35,18
1657532855872,COGS 107A,A01,083627,Boyle; Mary E. T.,13,0,60,47
1657532861899,COGS 118A,A01,083075,Gupta; Anjum,21,0,76,55
1657532867983,CSE 3,A50,083646,Miranda; Gregory Joseph,24,0,50,26
1657532874006,CSE 8A,A50,083650,Miranda; Gregory Joseph,17,1,56,39
1657532880036,CSE 11,A01,083080,Cao; Yingjun,6,15,40,34
1657532886060,CSE 12,A01,083652,Krause-Levy; Sophia Louisa,28,1,120,92
1657532892085,CSE 15L,A01,083654,Morris; Justin Loren,9,0,50,41
1657532892085,CSE 15L,A02,083655,Morris; Justin Loren,9,0,50,41
1657532898108,CSE 20,A01,083657,Tran; Khoa Dang,39,0,80,41
1657532904133,CSE 21,A01,095574,Bach; Quang Tran,22,0,48,26
1657532910155,CSE 30,A01,083084,Eldon; John,5,0,80,75
1657532910155,CSE 30,B01,095061,Bhaskar; Nishant,9,0,50,41
1657532916182,CSE 100,A01,083659,Cao; Yingjun,5,4,70,65
1657532922205,CSE 134B,A01,083661,Powell; Thomas Allan,22,0,100,78
1657532928231,CSE 140,A01,083663,Gungor; Onat,15,0,85,70
1657532934254,CSE 140L,A01,083088,Eldon; John,21,0,100,79
1657532940280,CSE 175,A01,083665,Kumar; Rakesh,3,0,25,22
1657532946303,CSE 190,A00,092507,Dubnov; Shlomo,8,0,20,12
1657532952331,ECE 45,A01,083139,Congero; Spencer William,6,0,75,69
1657532958361,ECE 65,A50,083695,Saad; Andrew S,12,0,30,18
1657532958361,ECE 65,A51,095125,Saad; Andrew S,24,0,26,2
1657532964391,ECE 109,A01,091882,Touri; Behrouz,19,0,70,51
1657532970414,ECE 180,A00,083140,Abi Samra; Nicholas Camill,1,0,30,29
1657532970414,ECE 180,B00,083141,Abi Samra; Nicholas Camill,0,0,30,30
1657532976438,MATH 10A,A01,083735,Patchell; Gregory David,2,0,30,28
1657532976438,MATH 10A,A02,083736,Patchell; Gregory David,20,0,30,10
1657532976438,MATH 10A,A03,083737,Patchell; Gregory David,16,0,30,14
1657532982459,MATH 10B,A01,083207,Lim; Seonhee,8,0,34,26
1657532982459,MATH 10B,A02,083208,Lim; Seonhee,9,0,35,26
1657532982459,MATH 10B,A03,093472,Lim; Seonhee,7,0,34,27
1657532982459,MATH 10B,B01,083739,Sinha; Shubham,12,0,30,18
1657532988491,MATH 18,A01,083743,Cinel; Cameron Alexander,7,0,30,23
1657532988491,MATH 18,A02,083744,Cinel; Cameron Alexander,17,0,30,13
1657532988491,MATH 18,A03,083745,Cinel; Cameron Alexander,9,0,30,21
1657532988491,MATH 18,B01,083748,Rideout; David Porter,5,0,37,32
1657532988491,MATH 18,B02,083749,Rideout; David Porter,5,0,36,31
1657532988491,MATH 18,B03,083750,Rideout; David Porter,3,0,37,34
1657532988491,MATH 18,B04,083751,Rideout; David Porter,6,0,36,30
1657532988491,MATH 18,B05,093473,Rideout; David Porter,6,0,36,30
1657532988491,MATH 18,B06,093474,Rideout; David Porter,6,0,36,30
1657532994514,MATH 20A,A01,083754,Zheng; Zequn,14,0,40,26
1657533000536,MATH 20B,A01,083756,Briones; Jor-el Thomas Caparas,4,0,36,32
1657533000536,MATH 20B,A02,083757,Briones; Jor-el Thomas Caparas,1,0,36,35
1657533000536,MATH 20B,A03,093475,Briones; Jor-el Thomas Caparas,2,0,36,34
1657533006560,MATH 20C,A01,083760,Briones; Jor-el Thomas Caparas,1,0,35,34
1657533006560,MATH 20C,A02,083761,Briones; Jor-el Thomas Caparas,8,0,35,27
1657533006560,MATH 20C,A03,093476,Briones; Jor-el Thomas Caparas,0,1,36,36
1657533006560,MATH 20C,B01,083762,Bach; Quang Tran,1,0,30,29
1657533012582,MATH 20D,A01,083765,Tran; Brian Kha,5,0,30,25
1657533012582,MATH 20D,A02,083766,Tran; Brian Kha,5,0,30,25
1657533012582,MATH 20D,A03,083767,Tran; Brian Kha,5,0,30,25
1657533018608,MATH 20E,A01,083771,Ganguly; Soumya,9,0,32,23
1657533018608,MATH 20E,A02,083772,Ganguly; Soumya,6,0,32,26
1657533018608,MATH 20E,B01,083773,Ciotti; Benjamin,20,0,35,15
1657533018608,MATH 20E,B02,083774,Ciotti; Benjamin,17,0,35,18
1657533024637,MATH 103A,A01,083777,Greenfeld; Be'Eri,3,0,36,33
1657533024637,MATH 103A,A02,083778,Greenfeld; Be'Eri,5,0,36,31
1657533024637,MATH 103A,A03,093561,Greenfeld; Be'Eri,5,0,36,31
1657533024637,MATH 103A,B01,083779,Greenfeld; Be'Eri,7,0,36,29
1657533024637,MATH 103A,B02,083780,Greenfeld; Be'Eri,4,0,36,32
1657533024637,MATH 103A,B03,093562,Greenfeld; Be'Eri,3,0,36,33
1657533030660,MATH 105,A01,085443,Carter; Anne Toulson,15,0,35,20
1657533030660,MATH 105,A02,093477,Carter; Anne Toulson,20,0,35,15
1657533036684,MATH 109,A01,083213,Ganzberger; Geoffrey Michael,2,0,34,32
1657533036684,MATH 109,A02,083214,Ganzberger; Geoffrey Michael,4,0,34,30
1657533036684,MATH 109,A03,093478,Ganzberger; Geoffrey Michael,2,0,34,32
1657533036684,MATH 109,B01,083215,Ganzberger; Geoffrey Michael,1,0,32,31
1657533036684,MATH 109,B02,083216,Ganzberger; Geoffrey Michael,2,0,32,30
1657533036684,MATH 109,B03,093479,Ganzberger; Geoffrey Michael,8,0,32,24
1657533042780,MATH 142A,A01,083219,Chow; Bennett,7,0,32,25
1657533042780,MATH 142A,A02,083220,Chow; Bennett,10,0,32,22
1657533042780,MATH 142A,A03,093480,Chow; Bennett,8,0,32,24
1657533042780,MATH 142A,B03,093481,Chow; Bennett,8,0,32,24
1657533042780,MATH 142A,B04,093558,Chow; Bennett,13,0,32,19
1657533042780,MATH 142A,B05,093559,Chow; Bennett,6,0,32,26
1657533048804,MATH 193A,A01,083224,Rotar; Vladimir,8,0,34,26
1657533048804,MATH 193A,A02,083225,Rotar; Vladimir,9,0,34,25
1657533048804,MATH 193A,A03,083781,Rotar; Vladimir,5,0,34,29
1657533048804,MATH 193A,A04,083782,Rotar; Vladimir,10,0,34,24
1657533048804,MATH 193A,A05,093482,Rotar; Vladimir,10,0,34,24
1657533054827,MATH 197,001,091859,McAuley; Julian John,9999,0,9999,0
1657533054827,MATH 197,002,095566,Kedlaya; Kiran S.,9997,0,9999,2
1657533054827,MATH 197,003,095567,Xiao; Ming,9999,0,9999,0
1657533054827,MATH 197,004,095571,Perols; Johan Lars,9998,0,9999,1
1657533061887,COGS 9,A01,083615,Shannon; Kyle Michael,9,0,75,66
1657533067914,COGS 11,A01,083617,Boyle; Mary E. T.,22,0,48,26
1657533073941,COGS 13,A01,083071,Bastos; Amalia Pinkusfeld,11,0,71,60
1657533079969,COGS 14A,A01,092681,Semenuks; Arturs,5,1,100,95
1657533085993,COGS 14B,A01,083073,Cheng; Tzu-Han,6,0,63,57
1657533092017,COGS 17,A01,092677,Semenuks; Arturs,6,0,81,75
1657533098041,COGS 100,A01,083619,Allen; Michael Gordon,17,0,70,53
1657533104064,COGS 101A,A01,083621,Davis; Joshua Daniel,9,0,68,59
1657533110095,COGS 101B,A01,091572,Allen; Michael Gordon,12,0,65,53
1657533116122,COGS 101C,A01,083625,Delgado; Tania,17,0,35,18
1657533122144,COGS 107A,A01,083627,Boyle; Mary E. T.,13,0,60,47
1657533128170,COGS 118A,A01,083075,Gupta; Anjum,21,0,76,55
1657533134202,CSE 3,A50,083646,Miranda; Gregory Joseph,24,0,50,26
1657533140228,CSE 8A,A50,083650,Miranda; Gregory Joseph,17,1,56,39
1657533146255,CSE 11,A01,083080,Cao; Yingjun,6,15,40,34
1657533152284,CSE 12,A01,083652,Krause-Levy; Sophia Louisa,28,1,120,92
1657533158315,CSE 15L,A01,083654,Morris; Justin Loren,9,0,50,41
1657533158315,CSE 15L,A02,083655,Morris; Justin Loren,9,0,50,41
1657533164341,CSE 20,A01,083657,Tran; Khoa Dang,39,0,80,41
1657533170364,CSE 21,A01,095574,Bach; Quang Tran,22,0,48,26
1657533176387,CSE 30,A01,083084,Eldon; John,5,0,80,75
1657533176387,CSE 30,B01,095061,Bhaskar; Nishant,9,0,50,41
1657533182411,CSE 100,A01,083659,Cao; Yingjun,5,4,70,65
1657533188436,CSE 134B,A01,083661,Powell; Thomas Allan,22,0,100,78
1657533194460,CSE 140,A01,083663,Gungor; Onat,15,0,85,70
1657533200484,CSE 140L,A01,083088,Eldon; John,21,0,100,79
1657533206508,CSE 175,A01,083665,Kumar; Rakesh,3,0,25,22
1657533212535,CSE 190,A00,092507,Dubnov; Shlomo,8,0,20,12
1657533218562,ECE 45,A01,083139,Congero; Spencer William,6,0,75,69
1657533224586,ECE 65,A50,083695,Saad; Andrew S,12,0,30,18
1657533224586,ECE 65,A51,095125,Saad; Andrew S,24,0,26,2
1657533230615,ECE 109,A01,091882,Touri; Behrouz,19,0,70,51
1657533236637,ECE 180,A00,083140,Abi Samra; Nicholas Camill,1,0,30,29
1657533236637,ECE 180,B00,083141,Abi Samra; Nicholas Camill,0,0,30,30
1657533242663,MATH 10A,A01,083735,Patchell; Gregory David,2,0,30,28
1657533242663,MATH 10A,A02,083736,Patchell; Gregory David,20,0,30,10
1657533242663,MATH 10A,A03,083737,Patchell; Gregory David,16,0,30,14
1657533248688,MATH 10B,A01,083207,Lim; Seonhee,8,0,34,26
1657533248688,MATH 10B,A02,083208,Lim; Seonhee,9,0,35,26
1657533248688,MATH 10B,A03,093472,Lim; Seonhee,7,0,34,27
1657533248688,MATH 10B,B01,083739,Sinha; Shubham,12,0,30,18
1657533254712,MATH 18,A01,083743,Cinel; Cameron Alexander,7,0,30,23
1657533254712,MATH 18,A02,083744,Cinel; Cameron Alexander,17,0,30,13
1657533254712,MATH 18,A03,083745,Cinel; Cameron Alexander,9,0,30,21
1657533254712,MATH 18,B01,083748,Rideout; David Porter,5,0,37,32
1657533254712,MATH 18,B02,083749,Rideout; David Porter,5,0,36,31
1657533254712,MATH 18,B03,083750,Rideout; David Porter,3,0,37,34
1657533254712,MATH 18,B04,083751,Rideout; David Porter,6,0,36,30
1657533254712,MATH 18,B05,093473,Rideout; David Porter,6,0,36,30
1657533254712,MATH 18,B06,093474,Rideout; David Porter,6,0,36,30
1657533260737,MATH 20A,A01,083754,Zheng; Zequn,14,0,40,26
1657533266762,MATH 20B,A01,083756,Briones; Jor-el Thomas Caparas,4,0,36,32
1657533266762,MATH 20B,A02,083757,Briones; Jor-el Thomas Caparas,1,0,36,35
1657533266762,MATH 20B,A03,093475,Briones; Jor-el Thomas Caparas,2,0,36,34
1657533272788,MATH 20C,A01,083760,Briones; Jor-el Thomas Caparas,1,0,35,34
1657533272788,MATH 20C,A02,083761,Briones; Jor-el Thomas Caparas,8,0,35,27
1657533272788,MATH 20C,A03,093476,Briones; Jor-el Thomas Caparas,0,1,36,36
1657533272788,MATH 20C,B01,083762,Bach; Quang Tran,1,0,30,29
1657533278811,MATH 20D,A01,083765,Tran; Brian Kha,5,0,30,25
1657533278811,MATH 20D,A02,083766,Tran; Brian Kha,5,0,30,25
1657533278811,MATH 20D,A03,083767,Tran; Brian Kha,5,0,30,25
1657533284835,MATH 20E,A01,083771,Ganguly; Soumya,9,0,32,23
1657533284835,MATH 20E,A02,083772,Ganguly; Soumya,6,0,32,26
1657533284835,MATH 20E,B01,083773,Ciotti; Benjamin,20,0,35,15
1657533284835,MATH 20E,B02,083774,Ciotti; Benjamin,17,0,35,18
1657533290860,MATH 103A,A01,083777,Greenfeld; Be'Eri,3,0,36,33
1657533290860,MATH 103A,A02,083778,Greenfeld; Be'Eri,5,0,36,31
1657533290860,MATH 103A,A03,093561,Greenfeld; Be'Eri,5,0,36,31
1657533290860,MATH 103A,B01,083779,Greenfeld; Be'Eri,7,0,36,29
1657533290860,MATH 103A,B02,083780,Greenfeld; Be'Eri,4,0,36,32
1657533290860,MATH 103A,B03,093562,Greenfeld; Be'Eri,3,0,36,33
1657533296881,MATH 105,A01,085443,Carter; Anne Toulson,15,0,35,20
1657533296881,MATH 105,A02,093477,Carter; Anne Toulson,20,0,35,15
1657533302904,MATH 109,A01,083213,Ganzberger; Geoffrey Michael,2,0,34,32
1657533302904,MATH 109,A02,083214,Ganzberger; Geoffrey Michael,4,0,34,30
1657533302904,MATH 109,A03,093478,Ganzberger; Geoffrey Michael,2,0,34,32
1657533302904,MATH 109,B01,083215,Ganzberger; Geoffrey Michael,1,0,32,31
1657533302904,MATH 109,B02,083216,Ganzberger; Geoffrey Michael,2,0,32,30
1657533302904,MATH 109,B03,093479,Ganzberger; Geoffrey Michael,8,0,32,24
1657533308928,MATH 142A,A01,083219,Chow; Bennett,7,0,32,25
1657533308928,MATH 142A,A02,083220,Chow; Bennett,10,0,32,22
1657533308928,MATH 142A,A03,093480,Chow; Bennett,8,0,32,24
1657533308928,MATH 142A,B03,093481,Chow; Bennett,8,0,32,24
1657533308928,MATH 142A,B04,093558,Chow; Bennett,13,0,32,19
1657533308928,MATH 142A,B05,093559,Chow; Bennett,6,0,32,26
1657533314951,MATH 193A,A01,083224,Rotar; Vladimir,8,0,34,26
1657533314951,MATH 193A,A02,083225,Rotar; Vladimir,9,0,34,25
1657533314951,MATH 193A,A03,083781,Rotar; Vladimir,5,0,34,29
1657533314951,MATH 193A,A04,083782,Rotar; Vladimir,10,0,34,24
1657533314951,MATH 193A,A05,093482,Rotar; Vladimir,10,0,34,24
1657533320975,MATH 197,001,091859,McAuley; Julian John,9999,0,9999,0
1657533320975,MATH 197,002,095566,Kedlaya; Kiran S.,9997,0,9999,2
1657533320975,MATH 197,003,095567,Xiao; Ming,9999,0,9999,0
1657533320975,MATH 197,004,095571,Perols; Johan Lars,9998,0,9999,1
1657533328026,COGS 9,A01,083615,Shannon; Kyle Michael,9,0,75,66
1657533334054,COGS 11,A01,083617,Boyle; Mary E. T.,22,0,48,26
1657533340078,COGS 13,A01,083071,Bastos; Amalia Pinkusfeld,11,0,71,60
1657533346101,COGS 14A,A01,092681,Semenuks; Arturs,5,1,100,95
1657533352125,COGS 14B,A01,083073,Cheng; Tzu-Han,6,0,63,57
1657533358151,COGS 17,A01,092677,Semenuks; Arturs,6,0,81,75
1657533364175,COGS 100,A01,083619,Allen; Michael Gordon,17,0,70,53
1657533370200,COGS 101A,A01,083621,Davis; Joshua Daniel,9,0,68,59
1657533376224,COGS 101B,A01,091572,Allen; Michael Gordon,12,0,65,53
1657533382246,COGS 101C,A01,083625,Delgado; Tania,17,0,35,18
1657533388272,COGS 107A,A01,083627,Boyle; Mary E. T.,13,0,60,47
1657533394296,COGS 118A,A01,083075,Gupta; Anjum,21,0,76,55
1657533400319,CSE 3,A50,083646,Miranda; Gregory Joseph,24,0,50,26
1657533406349,CSE 8A,A50,083650,Miranda; Gregory Joseph,17,1,56,39
1657533412374,CSE 11,A01,083080,Cao; Yingjun,6,15,40,34
1657533418395,CSE 12,A01,083652,Krause-Levy; Sophia Louisa,28,1,120,92
1657533424419,CSE 15L,A01,083654,Morris; Justin Loren,9,0,50,41
1657533424419,CSE 15L,A02,083655,Morris; Justin Loren,9,0,50,41
1657533430441,CSE 20,A01,083657,Tran; Khoa Dang,39,0,80,41
1657533436468,CSE 21,A01,095574,Bach; Quang Tran,22,0,48,26
1657533442497,CSE 30,A01,083084,Eldon; John,5,0,80,75
1657533442497,CSE 30,B01,095061,Bhaskar; Nishant,9,0,50,41
1657533448522,CSE 100,A01,083659,Cao; Yingjun,5,4,70,65
1657533454549,CSE 134B,A01,083661,Powell; Thomas Allan,22,0,100,78
1657533460576,CSE 140,A01,083663,Gungor; Onat,15,0,85,70
1657533466600,CSE 140L,A01,083088,Eldon; John,21,0,100,79
1657533472624,CSE 175,A01,083665,Kumar; Rakesh,3,0,25,22
1657533478649,CSE 190,A00,092507,Dubnov; Shlomo,8,0,20,12
1657533484672,ECE 45,A01,083139,Congero; Spencer William,6,0,75,69
1657533490700,ECE 65,A50,083695,Saad; Andrew S,12,0,30,18
1657533490700,ECE 65,A51,095125,Saad; Andrew S,24,0,26,2
1657533496722,ECE 109,A01,091882,Touri; Behrouz,19,0,70,51
1657533502745,ECE 180,A00,083140,Abi Samra; Nicholas Camill,1,0,30,29
1657533502745,ECE 180,B00,083141,Abi Samra; Nicholas Camill,0,0,30,30
1657533508768,MATH 10A,A01,083735,Patchell; Gregory David,2,0,30,28
1657533508768,MATH 10A,A02,083736,Patchell; Gregory David,20,0,30,10
1657533508768,MATH 10A,A03,083737,Patchell; Gregory David,16,0,30,14
1657533514794,MATH 10B,A01,083207,Lim; Seonhee,8,0,34,26
1657533514794,MATH 10B,A02,083208,Lim; Seonhee,9,0,35,26
1657533514794,MATH 10B,A03,093472,Lim; Seonhee,7,0,34,27
1657533514794,MATH 10B,B01,083739,Sinha; Shubham,12,0,30,18
1657533520818,MATH 18,A01,083743,Cinel; Cameron Alexander,7,0,30,23
1657533520818,MATH 18,A02,083744,Cinel; Cameron Alexander,17,0,30,13
1657533520818,MATH 18,A03,083745,Cinel; Cameron Alexander,9,0,30,21
1657533520818,MATH 18,B01,083748,Rideout; David Porter,5,0,37,32
1657533520818,MATH 18,B02,083749,Rideout; David Porter,5,0,36,31
1657533520818,MATH 18,B03,083750,Rideout; David Porter,3,0,37,34
1657533520818,MATH 18,B04,083751,Rideout; David Porter,6,0,36,30
1657533520818,MATH 18,B05,093473,Rideout; David Porter,6,0,36,30
1657533520818,MATH 18,B06,093474,Rideout; David Porter,6,0,36,30
1657533526840,MATH 20A,A01,083754,Zheng; Zequn,14,0,40,26
1657533532864,MATH 20B,A01,083756,Briones; Jor-el Thomas Caparas,4,0,36,32
1657533532864,MATH 20B,A02,083757,Briones; Jor-el Thomas Caparas,1,0,36,35
1657533532864,MATH 20B,A03,093475,Briones; Jor-el Thomas Caparas,2,0,36,34
1657533538892,MATH 20C,A01,083760,Briones; Jor-el Thomas Caparas,1,0,35,34
1657533538892,MATH 20C,A02,083761,Briones; Jor-el Thomas Caparas,8,0,35,27
1657533538892,MATH 20C,A03,093476,Briones; Jor-el Thomas Caparas,0,1,36,36
1657533538892,MATH 20C,B01,083762,Bach; Quang Tran,1,0,30,29
1657533544918,MATH 20D,A01,083765,Tran; Brian Kha,5,0,30,25
1657533544918,MATH 20D,A02,083766,Tran; Brian Kha,5,0,30,25
1657533544918,MATH 20D,A03,083767,Tran; Brian Kha,5,0,30,25
1657533550943,MATH 20E,A01,083771,Ganguly; Soumya,9,0,32,23
1657533550943,MATH 20E,A02,083772,Ganguly; Soumya,6,0,32,26
1657533550943,MATH 20E,B01,083773,Ciotti; Benjamin,20,0,35,15
1657533550943,MATH 20E,B02,083774,Ciotti; Benjamin,17,0,35,18
1657533556973,MATH 103A,A01,083777,Greenfeld; Be'Eri,3,0,36,33
1657533556973,MATH 103A,A02,083778,Greenfeld; Be'Eri,5,0,36,31
1657533556973,MATH 103A,A03,093561,Greenfeld; Be'Eri,5,0,36,31
1657533556973,MATH 103A,B01,083779,Greenfeld; Be'Eri,7,0,36,29
1657533556973,MATH 103A,B02,083780,Greenfeld; Be'Eri,4,0,36,32
1657533556973,MATH 103A,B03,093562,Greenfeld; Be'Eri,3,0,36,33
1657533563003,MATH 105,A01,085443,Carter; Anne Toulson,15,0,35,20
1657533563003,MATH 105,A02,093477,Carter; Anne Toulson,20,0,35,15
1657533569028,MATH 109,A01,083213,Ganzberger; Geoffrey Michael,2,0,34,32
1657533569028,MATH 109,A02,083214,Ganzberger; Geoffrey Michael,4,0,34,30
1657533569028,MATH 109,A03,093478,Ganzberger; Geoffrey Michael,2,0,34,32
1657533569028,MATH 109,B01,083215,Ganzberger; Geoffrey Michael,1,0,32,31
1657533569028,MATH 109,B02,083216,Ganzberger; Geoffrey Michael,2,0,32,30
1657533569028,MATH 109,B03,093479,Ganzberger; Geoffrey Michael,8,0,32,24
1657533575050,MATH 142A,A01,083219,Chow; Bennett,7,0,32,25
1657533575050,MATH 142A,A02,083220,Chow; Bennett,10,0,32,22
1657533575050,MATH 142A,A03,093480,Chow; Bennett,8,0,32,24
1657533575050,MATH 142A,B03,093481,Chow; Bennett,8,0,32,24
1657533575050,MATH 142A,B04,093558,Chow; Bennett,13,0,32,19
1657533575050,MATH 142A,B05,093559,Chow; Bennett,6,0,32,26
1657533581075,MATH 193A,A01,083224,Rotar; Vladimir,8,0,34,26
1657533581075,MATH 193A,A02,083225,Rotar; Vladimir,9,0,34,25
1657533581075,MATH 193A,A03,083781,Rotar; Vladimir,5,0,34,29
1657533581075,MATH 193A,A04,083782,Rotar; Vladimir,10,0,34,24
1657533581075,MATH 193A,A05,093482,Rotar; Vladimir,10,0,34,24
1657533587099,MATH 197,001,091859,McAuley; Julian John,9999,0,9999,0
1657533587099,MATH 197,002,095566,Kedlaya; Kiran S.,9997,0,9999,2
1657533587099,MATH 197,003,095567,Xiao; Ming,9999,0,9999,0
1657533587099,MATH 197,004,095571,Perols; Johan Lars,9998,0,9999,1
1657533594152,COGS 9,A01,083615,Shannon; Kyle Michael,9,0,75,66
1657533600175,COGS 11,A01,083617,Boyle; Mary E. T.,22,0,48,26
1657533606197,COGS 13,A01,083071,Bastos; Amalia Pinkusfeld,11,0,71,60
1657533612220,COGS 14A,A01,092681,Semenuks; Arturs,5,1,100,95
1657533618247,COGS 14B,A01,083073,Cheng; Tzu-Han,6,0,63,57
1657533624270,COGS 17,A01,092677,Semenuks; Arturs,6,0,81,75
1657533630293,COGS 100,A01,083619,Allen; Michael Gordon,17,0,70,53
1657533636390,COGS 101A,A01,083621,Davis; Joshua Daniel,9,0,68,59
1657533642412,COGS 101B,A01,091572,Allen; Michael Gordon,12,0,65,53
1657533648434,COGS 101C,A01,083625,Delgado; Tania,17,0,35,18
1657533654460,COGS 107A,A01,083627,Boyle; Mary E. T.,13,0,60,47
1657533660493,COGS 118A,A01,083075,Gupta; Anjum,21,0,76,55
1657533666521,CSE 3,A50,083646,Miranda; Gregory Joseph,24,0,50,26
1657533672548,CSE 8A,A50,083650,Miranda; Gregory Joseph,17,1,56,39
1657533678574,CSE 11,A01,083080,Cao; Yingjun,6,15,40,34
1657533684603,CSE 12,A01,083652,Krause-Levy; Sophia Louisa,28,1,120,92
1657533690626,CSE 15L,A01,083654,Morris; Justin Loren,9,0,50,41
1657533690626,CSE 15L,A02,083655,Morris; Justin Loren,9,0,50,41
1657533696648,CSE 20,A01,083657,Tran; Khoa Dang,39,0,80,41
1657533702674,CSE 21,A01,095574,Bach; Quang Tran,22,0,48,26
1657533708697,CSE 30,A01,083084,Eldon; John,5,0,80,75
1657533708697,CSE 30,B01,095061,Bhaskar; Nishant,9,0,50,41
1657533714726,CSE 100,A01,083659,Cao; Yingjun,5,4,70,65
1657533720749,CSE 134B,A01,083661,Powell; Thomas Allan,22,0,100,78
1657533726784,CSE 140,A01,083663,Gungor; Onat,15,0,85,70
1657533732807,CSE 140L,A01,083088,Eldon; John,21,0,100,79
1657533738832,CSE 175,A01,083665,Kumar; Rakesh,3,0,25,22
1657533744869,CSE 190,A00,092507,Dubnov; Shlomo,8,0,20,12
1657533750914,ECE 45,A01,083139,Congero; Spencer William,6,0,75,69
1657533756938,ECE 65,A50,083695,Saad; Andrew S,12,0,30,18
1657533756938,ECE 65,A51,095125,Saad; Andrew S,24,0,26,2
1657533762965,ECE 109,A01,091882,Touri; Behrouz,19,0,70,51
1657533768987,ECE 180,A00,083140,Abi Samra; Nicholas Camill,1,0,30,29
1657533768987,ECE 180,B00,083141,Abi Samra; Nicholas Camill,0,0,30,30
1657533775018,MATH 10A,A01,083735,Patchell; Gregory David,2,0,30,28
1657533775018,MATH 10A,A02,083736,Patchell; Gregory David,20,0,30,10
1657533775018,MATH 10A,A03,083737,Patchell; Gregory David,16,0,30,14
1657533781043,MATH 10B,A01,083207,Lim; Seonhee,8,0,34,26
1657533781043,MATH 10B,A02,083208,Lim; Seonhee,9,0,35,26
1657533781043,MATH 10B,A03,093472,Lim; Seonhee,7,0,34,27
1657533781043,MATH 10B,B01,083739,Sinha; Shubham,12,0,30,18
1657533787067,MATH 18,A01,083743,Cinel; Cameron Alexander,7,0,30,23
1657533787067,MATH 18,A02,083744,Cinel; Cameron Alexander,17,0,30,13
1657533787067,MATH 18,A03,083745,Cinel; Cameron Alexander,9,0,30,21
1657533787067,MATH 18,B01,083748,Rideout; David Porter,5,0,37,32
1657533787067,MATH 18,B02,083749,Rideout; David Porter,5,0,36,31
1657533787067,MATH 18,B03,083750,Rideout; David Porter,3,0,37,34
1657533787067,MATH 18,B04,083751,Rideout; David Porter,6,0,36,30
1657533787067,MATH 18,B05,093473,Rideout; David Porter,6,0,36,30
1657533787067,MATH 18,B06,093474,Rideout; David Porter,6,0,36,30
1657533793094,MATH 20A,A01,083754,Zheng; Zequn,14,0,40,26
1657533799126,MATH 20B,A01,083756,Briones; Jor-el Thomas Caparas,4,0,36,32
1657533799126,MATH 20B,A02,083757,Briones; Jor-el Thomas Caparas,1,0,36,35
1657533799126,MATH 20B,A03,093475,Briones; Jor-el Thomas Caparas,2,0,36,34
1657533805150,MATH 20C,A01,083760,Briones; Jor-el Thomas Caparas,1,0,35,34
1657533805150,MATH 20C,A02,083761,Briones; Jor-el Thomas Caparas,8,0,35,27
1657533805150,MATH 20C,A03,093476,Briones; Jor-el Thomas Caparas,0,1,36,36
1657533805150,MATH 20C,B01,083762,Bach; Quang Tran,1,0,30,29
1657533811177,MATH 20D,A01,083765,Tran; Brian Kha,5,0,30,25
1657533811177,MATH 20D,A02,083766,Tran; Brian Kha,5,0,30,25
1657533811177,MATH 20D,A03,083767,Tran; Brian Kha,5,0,30,25
1657533817201,MATH 20E,A01,083771,Ganguly; Soumya,9,0,32,23
1657533817201,MATH 20E,A02,083772,Ganguly; Soumya,6,0,32,26
1657533817201,MATH 20E,B01,083773,Ciotti; Benjamin,20,0,35,15
1657533817201,MATH 20E,B02,083774,Ciotti; Benjamin,17,0,35,18
1657533823225,MATH 103A,A01,083777,Greenfeld; Be'Eri,3,0,36,33
1657533823225,MATH 103A,A02,083778,Greenfeld; Be'Eri,5,0,36,31
1657533823225,MATH 103A,A03,093561,Greenfeld; Be'Eri,5,0,36,31
1657533823225,MATH 103A,B01,083779,Greenfeld; Be'Eri,7,0,36,29
1657533823225,MATH 103A,B02,083780,Greenfeld; Be'Eri,4,0,36,32
1657533823225,MATH 103A,B03,093562,Greenfeld; Be'Eri,3,0,36,33
1657533829251,MATH 105,A01,085443,Carter; Anne Toulson,15,0,35,20
1657533829251,MATH 105,A02,093477,Carter; Anne Toulson,20,0,35,15
1657533835280,MATH 109,A01,083213,Ganzberger; Geoffrey Michael,2,0,34,32
1657533835280,MATH 109,A02,083214,Ganzberger; Geoffrey Michael,4,0,34,30
1657533835280,MATH 109,A03,093478,Ganzberger; Geoffrey Michael,2,0,34,32
1657533835280,MATH 109,B01,083215,Ganzberger; Geoffrey Michael,1,0,32,31
1657533835280,MATH 109,B02,083216,Ganzberger; Geoffrey Michael,2,0,32,30
1657533835280,MATH 109,B03,093479,Ganzberger; Geoffrey Michael,8,0,32,24
1657533841304,MATH 142A,A01,083219,Chow; Bennett,7,0,32,25
1657533841304,MATH 142A,A02,083220,Chow; Bennett,10,0,32,22
1657533841304,MATH 142A,A03,093480,Chow; Bennett,8,0,32,24
1657533841304,MATH 142A,B03,093481,Chow; Bennett,8,0,32,24
1657533841304,MATH 142A,B04,093558,Chow; Bennett,13,0,32,19
1657533841304,MATH 142A,B05,093559,Chow; Bennett,6,0,32,26
1657533847331,MATH 193A,A01,083224,Rotar; Vladimir,8,0,34,26
1657533847331,MATH 193A,A02,083225,Rotar; Vladimir,9,0,34,25
1657533847331,MATH 193A,A03,083781,Rotar; Vladimir,5,0,34,29
1657533847331,MATH 193A,A04,083782,Rotar; Vladimir,10,0,34,24
1657533847331,MATH 193A,A05,093482,Rotar; Vladimir,10,0,34,24
1657533853358,MATH 197,001,091859,McAuley; Julian John,9999,0,9999,0
1657533853358,MATH 197,002,095566,Kedlaya; Kiran S.,9997,0,9999,2
1657533853358,MATH 197,003,095567,Xiao; Ming,9999,0,9999,0
1657533853358,MATH 197,004,095571,Perols; Johan Lars,9998,0,9999,1
1657533860424,COGS 9,A01,083615,Shannon; Kyle Michael,9,0,75,66
1657533866451,COGS 11,A01,083617,Boyle; Mary E. T.,22,0,48,26
1657533872473,COGS 13,A01,083071,Bastos; Amalia Pinkusfeld,11,0,71,60
1657533878506,COGS 14A,A01,092681,Semenuks; Arturs,5,1,100,95
1657533884532,COGS 14B,A01,083073,Cheng; Tzu-Han,6,0,63,57
1657533890561,COGS 17,A01,092677,Semenuks; Arturs,6,0,81,75
1657533896589,COGS 100,A01,083619,Allen; Michael Gordon,17,0,70,53
1657533902618,COGS 101A,A01,083621,Davis; Joshua Daniel,9,0,68,59
1657533908645,COGS 101B,A01,091572,Allen; Michael Gordon,12,0,65,53
1657533914675,COGS 101C,A01,083625,Delgado; Tania,17,0,35,18
1657533920697,COGS 107A,A01,083627,Boyle; Mary E. T.,13,0,60,47
1657533926723,COGS 118A,A01,083075,Gupta; Anjum,21,0,76,55
1657533932753,CSE 3,A50,083646,Miranda; Gregory Joseph,24,0,50,26
1657533938783,CSE 8A,A50,083650,Miranda; Gregory Joseph,17,1,56,39
1657533944812,CSE 11,A01,083080,Cao; Yingjun,6,15,40,34
1657533950835,CSE 12,A01,083652,Krause-Levy; Sophia Louisa,28,1,120,92
1657533956865,CSE 15L,A01,083654,Morris; Justin Loren,9,0,50,41
1657533956865,CSE 15L,A02,083655,Morris; Justin Loren,9,0,50,41
1657533962889,CSE 20,A01,083657,Tran; Khoa Dang,39,0,80,41
1657533968915,CSE 21,A01,095574,Bach; Quang Tran,22,0,48,26
1657533974946,CSE 30,A01,083084,Eldon; John,5,0,80,75
1657533974946,CSE 30,B01,095061,Bhaskar; Nishant,9,0,50,41
1657533980973,CSE 100,A01,083659,Cao; Yingjun,5,4,70,65
1657533987001,CSE 134B,A01,083661,Powell; Thomas Allan,22,0,100,78
1657533993030,CSE 140,A01,083663,Gungor; Onat,15,0,85,70
1657533999052,CSE 140L,A01,083088,Eldon; John,21,0,100,79
1657534005079,CSE 175,A01,083665,Kumar; Rakesh,3,0,25,22
1657534011107,CSE 190,A00,092507,Dubnov; Shlomo,8,0,20,12
1657534017137,ECE 45,A01,083139,Congero; Spencer William,6,0,75,69
1657534023160,ECE 65,A50,083695,Saad; Andrew S,12,0,30,18
1657534023160,ECE 65,A51,095125,Saad; Andrew S,24,0,26,2
1657534029184,ECE 109,A01,091882,Touri; Behrouz,19,0,70,51
1657534035210,ECE 180,A00,083140,Abi Samra; Nicholas Camill,1,0,30,29
1657534035210,ECE 180,B00,083141,Abi Samra; Nicholas Camill,0,0,30,30
1657534041238,MATH 10A,A01,083735,Patchell; Gregory David,2,0,30,28
1657534041238,MATH 10A,A02,083736,Patchell; Gregory David,20,0,30,10
1657534041238,MATH 10A,A03,083737,Patchell; Gregory David,16,0,30,14
1657534047266,MATH 10B,A01,083207,Lim; Seonhee,8,0,34,26
1657534047266,MATH 10B,A02,083208,Lim; Seonhee,9,0,35,26
1657534047266,MATH 10B,A03,093472,Lim; Seonhee,7,0,34,27
1657534047266,MATH 10B,B01,083739,Sinha; Shubham,12,0,30,18
1657534053302,MATH 18,A01,083743,Cinel; Cameron Alexander,7,0,30,23
1657534053302,MATH 18,A02,083744,Cinel; Cameron Alexander,17,0,30,13
1657534053302,MATH 18,A03,083745,Cinel; Cameron Alexander,9,0,30,21
1657534053302,MATH 18,B01,083748,Rideout; David Porter,5,0,37,32
1657534053302,MATH 18,B02,083749,Rideout; David Porter,5,0,36,31
1657534053302,MATH 18,B03,083750,Rideout; David Porter,3,0,37,34
1657534053302,MATH 18,B04,083751,Rideout; David Porter,6,0,36,30
1657534053302,MATH 18,B05,093473,Rideout; David Porter,6,0,36,30
1657534053302,MATH 18,B06,093474,Rideout; David Porter,6,0,36,30
1657534059331,MATH 20A,A01,083754,Zheng; Zequn,14,0,40,26
1657534065361,MATH 20B,A01,083756,Briones; Jor-el Thomas Caparas,4,0,36,32
1657534065361,MATH 20B,A02,083757,Briones; Jor-el Thomas Caparas,1,0,36,35
1657534065361,MATH 20B,A03,093475,Briones; Jor-el Thomas Caparas,2,0,36,34
1657534071387,MATH 20C,A01,083760,Briones; Jor-el Thomas Caparas,1,0,35,34
1657534071387,MATH 20C,A02,083761,Briones; Jor-el Thomas Caparas,8,0,35,27
1657534071387,MATH 20C,A03,093476,Briones; Jor-el Thomas Caparas,0,1,36,36
1657534071387,MATH 20C,B01,083762,Bach; Quang Tran,1,0,30,29
1657534077411,MATH 20D,A01,083765,Tran; Brian Kha,5,0,30,25
1657534077411,MATH 20D,A02,083766,Tran; Brian Kha,5,0,30,25
1657534077411,MATH 20D,A03,083767,Tran; Brian Kha,5,0,30,25
1657534083435,MATH 20E,A01,083771,Ganguly; Soumya,9,0,32,23
1657534083435,MATH 20E,A02,083772,Ganguly; Soumya,6,0,32,26
1657534083435,MATH 20E,B01,083773,Ciotti; Benjamin,20,0,35,15
1657534083435,MATH 20E,B02,083774,Ciotti; Benjamin,17,0,35,18
1657534089460,MATH 103A,A01,083777,Greenfeld; Be'Eri,3,0,36,33
1657534089460,MATH 103A,A02,083778,Greenfeld; Be'Eri,5,0,36,31
1657534089460,MATH 103A,A03,093561,Greenfeld; Be'Eri,5,0,36,31
1657534089460,MATH 103A,B01,083779,Greenfeld; Be'Eri,7,0,36,29
1657534089460,MATH 103A,B02,083780,Greenfeld; Be'Eri,4,0,36,32
1657534089460,MATH 103A,B03,093562,Greenfeld; Be'Eri,3,0,36,33
1657534095482,MATH 105,A01,085443,Carter; Anne Toulson,15,0,35,20
1657534095482,MATH 105,A02,093477,Carter; Anne Toulson,20,0,35,15
1657534101506,MATH 109,A01,083213,Ganzberger; Geoffrey Michael,2,0,34,32
1657534101506,MATH 109,A02,083214,Ganzberger; Geoffrey Michael,4,0,34,30
1657534101506,MATH 109,A03,093478,Ganzberger; Geoffrey Michael,2,0,34,32
1657534101506,MATH 109,B01,083215,Ganzberger; Geoffrey Michael,1,0,32,31
1657534101506,MATH 109,B02,083216,Ganzberger; Geoffrey Michael,2,0,32,30
1657534101506,MATH 109,B03,093479,Ganzberger; Geoffrey Michael,8,0,32,24
1657534107538,MATH 142A,A01,083219,Chow; Bennett,7,0,32,25
1657534107538,MATH 142A,A02,083220,Chow; Bennett,10,0,32,22
1657534107538,MATH 142A,A03,093480,Chow; Bennett,8,0,32,24
1657534107538,MATH 142A,B03,093481,Chow; Bennett,8,0,32,24
1657534107538,MATH 142A,B04,093558,Chow; Bennett,13,0,32,19
1657534107538,MATH 142A,B05,093559,Chow; Bennett,6,0,32,26
1657534113575,MATH 193A,A01,083224,Rotar; Vladimir,8,0,34,26
1657534113575,MATH 193A,A02,083225,Rotar; Vladimir,9,0,34,25
1657534113575,MATH 193A,A03,083781,Rotar; Vladimir,5,0,34,29
1657534113575,MATH 193A,A04,083782,Rotar; Vladimir,10,0,34,24
1657534113575,MATH 193A,A05,093482,Rotar; Vladimir,10,0,34,24
1657534119602,MATH 197,001,091859,McAuley; Julian John,9999,0,9999,0
1657534119602,MATH 197,002,095566,Kedlaya; Kiran S.,9997,0,9999,2
1657534119602,MATH 197,003,095567,Xiao; Ming,9999,0,9999,0
1657534119602,MATH 197,004,095571,Perols; Johan Lars,9998,0,9999,1
1657534126655,COGS 9,A01,083615,Shannon; Kyle Michael,9,0,75,66
1657534132683,COGS 11,A01,083617,Boyle; Mary E. T.,22,0,48,26
1657534138711,COGS 13,A01,083071,Bastos; Amalia Pinkusfeld,11,0,71,60
1657534144746,COGS 14A,A01,092681,Semenuks; Arturs,5,1,100,95
1657534150768,COGS 14B,A01,083073,Cheng; Tzu-Han,6,0,63,57
1657534156793,COGS 17,A01,092677,Semenuks; Arturs,6,0,81,75
1657534162815,COGS 100,A01,083619,Allen; Michael Gordon,17,0,70,53
1657534168840,COGS 101A,A01,083621,Davis; Joshua Daniel,9,0,68,59
1657534174868,COGS 101B,A01,091572,Allen; Michael Gordon,12,0,65,53
1657534180893,COGS 101C,A01,083625,Delgado; Tania,17,0,35,18
1657534186915,COGS 107A,A01,083627,Boyle; Mary E. T.,13,0,60,47
1657534192939,COGS 118A,A01,083075,Gupta; Anjum,21,0,76,55
1657534198971,CSE 3,A50,083646,Miranda; Gregory Joseph,24,0,50,26
1657534204994,CSE 8A,A50,083650,Miranda; Gregory Joseph,17,1,56,39
1657534211018,CSE 11,A01,083080,Cao; Yingjun,6,15,40,34
1657534217041,CSE 12,A01,083652,Krause-Levy; Sophia Louisa,28,1,120,92
1657534223068,CSE 15L,A01,083654,Morris; Justin Loren,9,0,50,41
1657534223068,CSE 15L,A02,083655,Morris; Justin Loren,9,0,50,41
1657534229092,CSE 20,A01,083657,Tran; Khoa Dang,39,0,80,41
1657534235199,CSE 21,A01,095574,Bach; Quang Tran,22,0,48,26
1657534241220,CSE 30,A01,083084,Eldon; John,5,0,80,75
1657534241220,CSE 30,B01,095061,Bhaskar; Nishant,9,0,50,41
1657534247246,CSE 100,A01,083659,Cao; Yingjun,5,4,70,65
1657534253270,CSE 134B,A01,083661,Powell; Thomas Allan,22,0,100,78
1657534259294,CSE 140,A01,083663,Gungor; Onat,15,0,85,70
1657534265320,CSE 140L,A01,083088,Eldon; John,21,0,100,79
1657534271343,CSE 175,A01,083665,Kumar; Rakesh,3,0,25,22
1657534277365,CSE 190,A00,092507,Dubnov; Shlomo,8,0,20,12
1657534283389,ECE 45,A01,083139,Congero; Spencer William,6,0,75,69
1657534289420,ECE 65,A50,083695,Saad; Andrew S,12,0,30,18
1657534289420,ECE 65,A51,095125,Saad; Andrew S,24,0,26,2
1657534295443,ECE 109,A01,091882,Touri; Behrouz,19,0,70,51
1657534301466,ECE 180,A00,083140,Abi Samra; Nicholas Camill,1,0,30,29
1657534301466,ECE 180,B00,083141,Abi Samra; Nicholas Camill,0,0,30,30
1657534307488,MATH 10A,A01,083735,Patchell; Gregory David,2,0,30,28
1657534307488,MATH 10A,A02,083736,Patchell; Gregory David,20,0,30,10
1657534307488,MATH 10A,A03,083737,Patchell; Gregory David,16,0,30,14
1657534313517,MATH 10B,A01,083207,Lim; Seonhee,8,0,34,26
1657534313517,MATH 10B,A02,083208,Lim; Seonhee,9,0,35,26
1657534313517,MATH 10B,A03,093472,Lim; Seonhee,7,0,34,27
1657534313517,MATH 10B,B01,083739,Sinha; Shubham,12,0,30,18
1657534319541,MATH 18,A01,083743,Cinel; Cameron Alexander,7,0,30,23
1657534319541,MATH 18,A02,083744,Cinel; Cameron Alexander,17,0,30,13
1657534319541,MATH 18,A03,083745,Cinel; Cameron Alexander,9,0,30,21
1657534319541,MATH 18,B01,083748,Rideout; David Porter,5,0,37,32
1657534319541,MATH 18,B02,083749,Rideout; David Porter,5,0,36,31
1657534319541,MATH 18,B03,083750,Rideout; David Porter,3,0,37,34
1657534319541,MATH 18,B04,083751,Rideout; David Porter,6,0,36,30
1657534319541,MATH 18,B05,093473,Rideout; David Porter,6,0,36,30
1657534319541,MATH 18,B06,093474,Rideout; David Porter,6,0,36,30
1657534325564,MATH 20A,A01,083754,Zheng; Zequn,14,0,40,26
1657534331590,MATH 20B,A01,083756,Briones; Jor-el Thomas Caparas,4,0,36,32
1657534331590,MATH 20B,A02,083757,Briones; Jor-el Thomas Caparas,1,0,36,35
1657534331590,MATH 20B,A03,093475,Briones; Jor-el Thomas Caparas,2,0,36,34
1657534337615,MATH 20C,A01,083760,Briones; Jor-el Thomas Caparas,1,0,35,34
1657534337615,MATH 20C,A02,083761,Briones; Jor-el Thomas Caparas,8,0,35,27
1657534337615,MATH 20C,A03,093476,Briones; Jor-el Thomas Caparas,0,1,36,36
1657534337615,MATH 20C,B01,083762,Bach; Quang Tran,1,0,30,29
1657534343639,MATH 20D,A01,083765,Tran; Brian Kha,5,0,30,25
1657534343639,MATH 20D,A02,083766,Tran; Brian Kha,5,0,30,25
1657534343639,MATH 20D,A03,083767,Tran; Brian Kha,5,0,30,25
1657534349666,MATH 20E,A01,083771,Ganguly; Soumya,9,0,32,23
1657534349666,MATH 20E,A02,083772,Ganguly; Soumya,6,0,32,26
1657534349666,MATH 20E,B01,083773,Ciotti; Benjamin,20,0,35,15
1657534349666,MATH 20E,B02,083774,Ciotti; Benjamin,17,0,35,18
1657534355690,MATH 103A,A01,083777,Greenfeld; Be'Eri,3,0,36,33
1657534355690,MATH 103A,A02,083778,Greenfeld; Be'Eri,5,0,36,31
1657534355690,MATH 103A,A03,093561,Greenfeld; Be'Eri,5,0,36,31
1657534355690,MATH 103A,B01,083779,Greenfeld; Be'Eri,7,0,36,29
1657534355690,MATH 103A,B02,083780,Greenfeld; Be'Eri,4,0,36,32
1657534355690,MATH 103A,B03,093562,Greenfeld; Be'Eri,3,0,36,33
1657534361726,MATH 105,A01,085443,Carter; Anne Toulson,15,0,35,20
1657534361726,MATH 105,A02,093477,Carter; Anne Toulson,20,0,35,15
1657534367756,MATH 109,A01,083213,Ganzberger; Geoffrey Michael,2,0,34,32
1657534367756,MATH 109,A02,083214,Ganzberger; Geoffrey Michael,4,0,34,30
1657534367756,MATH 109,A03,093478,Ganzberger; Geoffrey Michael,2,0,34,32
1657534367756,MATH 109,B01,083215,Ganzberger; Geoffrey Michael,1,0,32,31
1657534367756,MATH 109,B02,083216,Ganzberger; Geoffrey Michael,2,0,32,30
1657534367756,MATH 109,B03,093479,Ganzberger; Geoffrey Michael,8,0,32,24
1657534373778,MATH 142A,A01,083219,Chow; Bennett,7,0,32,25
1657534373778,MATH 142A,A02,083220,Chow; Bennett,10,0,32,22
1657534373778,MATH 142A,A03,093480,Chow; Bennett,8,0,32,24
1657534373778,MATH 142A,B03,093481,Chow; Bennett,8,0,32,24
1657534373778,MATH 142A,B04,093558,Chow; Bennett,13,0,32,19
1657534373778,MATH 142A,B05,093559,Chow; Bennett,6,0,32,26
1657534379803,MATH 193A,A01,083224,Rotar; Vladimir,8,0,34,26
1657534379803,MATH 193A,A02,083225,Rotar; Vladimir,9,0,34,25
1657534379803,MATH 193A,A03,083781,Rotar; Vladimir,5,0,34,29
1657534379803,MATH 193A,A04,083782,Rotar; Vladimir,10,0,34,24
1657534379803,MATH 193A,A05,093482,Rotar; Vladimir,10,0,34,24
1657534385828,MATH 197,001,091859,McAuley; Julian John,9999,0,9999,0
1657534385828,MATH 197,002,095566,Kedlaya; Kiran S.,9997,0,9999,2
1657534385828,MATH 197,003,095567,Xiao; Ming,9999,0,9999,0
1657534385828,MATH 197,004,095571,Perols; Johan Lars,9998,0,9999,1
1657534392902,COGS 9,A01,083615,Shannon; Kyle Michael,9,0,75,66
1657534398929,COGS 11,A01,083617,Boyle; Mary E. T.,22,0,48,26
1657534404950,COGS 13,A01,083071,Bastos; Amalia Pinkusfeld,11,0,71,60
1657534410982,COGS 14A,A01,092681,Semenuks; Arturs,5,1,100,95
1657534417009,COGS 14B,A01,083073,Cheng; Tzu-Han,6,0,63,57
1657534423033,COGS 17,A01,092677,Semenuks; Arturs,6,0,81,75
1657534429057,COGS 100,A01,083619,Allen; Michael Gordon,17,0,70,53
1657534435081,COGS 101A,A01,083621,Davis; Joshua Daniel,9,0,68,59
1657534441103,COGS 101B,A01,091572,Allen; Michael Gordon,12,0,65,53
1657534447125,COGS 101C,A01,083625,Delgado; Tania,17,0,35,18
1657534453152,COGS 107A,A01,083627,Boyle; Mary E. T.,13,0,60,47
1657534459180,COGS 118A,A01,083075,Gupta; Anjum,21,0,76,55
1657534465204,CSE 3,A50,083646,Miranda; Gregory Joseph,24,0,50,26
1657534471231,CSE 8A,A50,083650,Miranda; Gregory Joseph,17,1,56,39
1657534477256,CSE 11,A01,083080,Cao; Yingjun,6,15,40,34
1657534483280,CSE 12,A01,083652,Krause-Levy; Sophia Louisa,28,1,120,92
1657534489307,CSE 15L,A01,083654,Morris; Justin Loren,9,0,50,41
1657534489307,CSE 15L,A02,083655,Morris; Justin Loren,9,0,50,41
1657534495330,CSE 20,A01,083657,Tran; Khoa Dang,39,0,80,41
1657534501359,CSE 21,A01,095574,Bach; Quang Tran,22,0,48,26
1657534507387,CSE 30,A01,083084,Eldon; John,5,0,80,75
1657534507387,CSE 30,B01,095061,Bhaskar; Nishant,9,0,50,41
1657534513414,CSE 100,A01,083659,Cao; Yingjun,5,4,70,65
1657534519441,CSE 134B,A01,083661,Powell; Thomas Allan,22,0,100,78
1657534525469,CSE 140,A01,083663,Gungor; Onat,15,0,85,70
1657534531497,CSE 140L,A01,083088,Eldon; John,21,0,100,79
1657534537521,CSE 175,A01,083665,Kumar; Rakesh,3,0,25,22
1657534543545,CSE 190,A00,092507,Dubnov; Shlomo,8,0,20,12
1657534549569,ECE 45,A01,083139,Congero; Spencer William,6,0,75,69
1657534555593,ECE 65,A50,083695,Saad; Andrew S,12,0,30,18
1657534555593,ECE 65,A51,095125,Saad; Andrew S,24,0,26,2
1657534561620,ECE 109,A01,091882,Touri; Behrouz,19,0,70,51
1657534567648,ECE 180,A00,083140,Abi Samra; Nicholas Camill,1,0,30,29
1657534567648,ECE 180,B00,083141,Abi Samra; Nicholas Camill,0,0,30,30
1657534573676,MATH 10A,A01,083735,Patchell; Gregory David,2,0,30,28
1657534573676,MATH 10A,A02,083736,Patchell; Gregory David,20,0,30,10
1657534573676,MATH 10A,A03,083737,Patchell; Gregory David,16,0,30,14
1657534579699,MATH 10B,A01,083207,Lim; Seonhee,8,0,34,26
1657534579699,MATH 10B,A02,083208,Lim; Seonhee,9,0,35,26
1657534579699,MATH 10B,A03,093472,Lim; Seonhee,7,0,34,27
1657534579699,MATH 10B,B01,083739,Sinha; Shubham,12,0,30,18
1657534585723,MATH 18,A01,083743,Cinel; Cameron Alexander,7,0,30,23
1657534585723,MATH 18,A02,083744,Cinel; Cameron Alexander,17,0,30,13
1657534585723,MATH 18,A03,083745,Cinel; Cameron Alexander,9,0,30,21
1657534585723,MATH 18,B01,083748,Rideout; David Porter,5,0,37,32
1657534585723,MATH 18,B02,083749,Rideout; David Porter,5,0,36,31
1657534585723,MATH 18,B03,083750,Rideout; David Porter,3,0,37,34
1657534585723,MATH 18,B04,083751,Rideout; David Porter,6,0,36,30
1657534585723,MATH 18,B05,093473,Rideout; David Porter,6,0,36,30
1657534585723,MATH 18,B06,093474,Rideout; David Porter,6,0,36,30
1657534591750,MATH 20A,A01,083754,Zheng; Zequn,14,0,40,26
1657534597777,MATH 20B,A01,083756,Briones; Jor-el Thomas Caparas,4,0,36,32
1657534597777,MATH 20B,A02,083757,Briones; Jor-el Thomas Caparas,1,0,36,35
1657534597777,MATH 20B,A03,093475,Briones; Jor-el Thomas Caparas,2,0,36,34
1657534603802,MATH 20C,A01,083760,Briones; Jor-el Thomas Caparas,1,0,35,34
1657534603802,MATH 20C,A02,083761,Briones; Jor-el Thomas Caparas,8,0,35,27
1657534603802,MATH 20C,A03,093476,Briones; Jor-el Thomas Caparas,0,1,36,36
1657534603802,MATH 20C,B01,083762,Bach; Quang Tran,1,0,30,29
1657534609832,MATH 20D,A01,083765,Tran; Brian Kha,5,0,30,25
1657534609832,MATH 20D,A02,083766,Tran; Brian Kha,5,0,30,25
1657534609832,MATH 20D,A03,083767,Tran; Brian Kha,5,0,30,25
1657534615855,MATH 20E,A01,083771,Ganguly; Soumya,9,0,32,23
1657534615855,MATH 20E,A02,083772,Ganguly; Soumya,6,0,32,26
1657534615855,MATH 20E,B01,083773,Ciotti; Benjamin,20,0,35,15
1657534615855,MATH 20E,B02,083774,Ciotti; Benjamin,17,0,35,18
1657534621883,MATH 103A,A01,083777,Greenfeld; Be'Eri,3,0,36,33
1657534621883,MATH 103A,A02,083778,Greenfeld; Be'Eri,5,0,36,31
1657534621883,MATH 103A,A03,093561,Greenfeld; Be'Eri,5,0,36,31
1657534621883,MATH 103A,B01,083779,Greenfeld; Be'Eri,7,0,36,29
1657534621883,MATH 103A,B02,083780,Greenfeld; Be'Eri,4,0,36,32
1657534621883,MATH 103A,B03,093562,Greenfeld; Be'Eri,3,0,36,33
1657534627909,MATH 105,A01,085443,Carter; Anne Toulson,15,0,35,20
1657534627909,MATH 105,A02,093477,Carter; Anne Toulson,20,0,35,15
1657534633932,MATH 109,A01,083213,Ganzberger; Geoffrey Michael,2,0,34,32
1657534633932,MATH 109,A02,083214,Ganzberger; Geoffrey Michael,4,0,34,30
1657534633932,MATH 109,A03,093478,Ganzberger; Geoffrey Michael,2,0,34,32
1657534633932,MATH 109,B01,083215,Ganzberger; Geoffrey Michael,1,0,32,31
1657534633932,MATH 109,B02,083216,Ganzberger; Geoffrey Michael,2,0,32,30
1657534633932,MATH 109,B03,093479,Ganzberger; Geoffrey Michael,8,0,32,24
1657534639957,MATH 142A,A01,083219,Chow; Bennett,7,0,32,25
1657534639957,MATH 142A,A02,083220,Chow; Bennett,10,0,32,22
1657534639957,MATH 142A,A03,093480,Chow; Bennett,8,0,32,24
1657534639957,MATH 142A,B03,093481,Chow; Bennett,8,0,32,24
1657534639957,MATH 142A,B04,093558,Chow; Bennett,13,0,32,19
1657534639957,MATH 142A,B05,093559,Chow; Bennett,6,0,32,26
1657534645982,MATH 193A,A01,083224,Rotar; Vladimir,8,0,34,26
1657534645982,MATH 193A,A02,083225,Rotar; Vladimir,9,0,34,25
1657534645982,MATH 193A,A03,083781,Rotar; Vladimir,5,0,34,29
1657534645982,MATH 193A,A04,083782,Rotar; Vladimir,10,0,34,24
1657534645982,MATH 193A,A05,093482,Rotar; Vladimir,10,0,34,24
1657534652006,MATH 197,001,091859,McAuley; Julian John,9999,0,9999,0
1657534652006,MATH 197,002,095566,Kedlaya; Kiran S.,9997,0,9999,2
1657534652006,MATH 197,003,095567,Xiao; Ming,9999,0,9999,0
1657534652006,MATH 197,004,095571,Perols; Johan Lars,9998,0,9999,1
1657534659063,COGS 9,A01,083615,Shannon; Kyle Michael,9,0,75,66
1657534665091,COGS 11,A01,083617,Boyle; Mary E. T.,22,0,48,26
1657534671116,COGS 13,A01,083071,Bastos; Amalia Pinkusfeld,11,0,71,60
1657534677145,COGS 14A,A01,092681,Semenuks; Arturs,5,1,100,95
1657534683168,COGS 14B,A01,083073,Cheng; Tzu-Han,6,0,63,57
1657534689192,COGS 17,A01,092677,Semenuks; Arturs,6,0,81,75
1657534695215,COGS 100,A01,083619,Allen; Michael Gordon,17,0,70,53
1657534701240,COGS 101A,A01,083621,Davis; Joshua Daniel,9,0,68,59
1657534707267,COGS 101B,A01,091572,Allen; Michael Gordon,12,0,65,53
1657534713303,COGS 101C,A01,083625,Delgado; Tania,17,0,35,18
1657534719328,COGS 107A,A01,083627,Boyle; Mary E. T.,13,0,60,47
1657534725354,COGS 118A,A01,083075,Gupta; Anjum,21,0,76,55
1657534731380,CSE 3,A50,083646,Miranda; Gregory Joseph,24,0,50,26
1657534737406,CSE 8A,A50,083650,Miranda; Gregory Joseph,17,1,56,39
1657534743430,CSE 11,A01,083080,Cao; Yingjun,6,15,40,34
1657534749459,CSE 12,A01,083652,Krause-Levy; Sophia Louisa,28,1,120,92
1657534755483,CSE 15L,A01,083654,Morris; Justin Loren,9,0,50,41
1657534755483,CSE 15L,A02,083655,Morris; Justin Loren,9,0,50,41
1657534761510,CSE 20,A01,083657,Tran; Khoa Dang,39,0,80,41
1657534767533,CSE 21,A01,095574,Bach; Quang Tran,22,0,48,26
1657534773557,CSE 30,A01,083084,Eldon; John,5,0,80,75
1657534773557,CSE 30,B01,095061,Bhaskar; Nishant,9,0,50,41
1657534779585,CSE 100,A01,083659,Cao; Yingjun,5,4,70,65
1657534785617,CSE 134B,A01,083661,Powell; Thomas Allan,22,0,100,78
1657534791643,CSE 140,A01,083663,Gungor; Onat,15,0,85,70
1657534797665,CSE 140L,A01,083088,Eldon; John,21,0,100,79
1657534803688,CSE 175,A01,083665,Kumar; Rakesh,3,0,25,22
1657534809712,CSE 190,A00,092507,Dubnov; Shlomo,8,0,20,12
1657534815747,ECE 45,A01,083139,Congero; Spencer William,6,0,75,69
1657534821770,ECE 65,A50,083695,Saad; Andrew S,12,0,30,18
1657534821770,ECE 65,A51,095125,Saad; Andrew S,24,0,26,2
1657534827794,ECE 109,A01,091882,Touri; Behrouz,19,0,70,51
1657534833907,ECE 180,A00,083140,Abi Samra; Nicholas Camill,1,0,30,29
1657534833907,ECE 180,B00,083141,Abi Samra; Nicholas Camill,0,0,30,30
1657534839938,MATH 10A,A01,083735,Patchell; Gregory David,2,0,30,28
1657534839938,MATH 10A,A02,083736,Patchell; Gregory David,20,0,30,10
1657534839938,MATH 10A,A03,083737,Patchell; Gregory David,16,0,30,14
1657534845966,MATH 10B,A01,083207,Lim; Seonhee,8,0,34,26
1657534845966,MATH 10B,A02,083208,Lim; Seonhee,9,0,35,26
1657534845966,MATH 10B,A03,093472,Lim; Seonhee,7,0,34,27
1657534845966,MATH 10B,B01,083739,Sinha; Shubham,12,0,30,18
1657534851998,MATH 18,A01,083743,Cinel; Cameron Alexander,7,0,30,23
1657534851998,MATH 18,A02,083744,Cinel; Cameron Alexander,17,0,30,13
1657534851998,MATH 18,A03,083745,Cinel; Cameron Alexander,9,0,30,21
1657534851998,MATH 18,B01,083748,Rideout; David Porter,5,0,37,32
1657534851998,MATH 18,B02,083749,Rideout; David Porter,5,0,36,31
1657534851998,MATH 18,B03,083750,Rideout; David Porter,3,0,37,34
1657534851998,MATH 18,B04,083751,Rideout; David Porter,6,0,36,30
1657534851998,MATH 18,B05,093473,Rideout; David Porter,6,0,36,30
1657534851998,MATH 18,B06,093474,Rideout; David Porter,6,0,36,30
1657534858025,MATH 20A,A01,083754,Zheng; Zequn,14,0,40,26
1657534864051,MATH 20B,A01,083756,Briones; Jor-el Thomas Caparas,4,0,36,32
1657534864051,MATH 20B,A02,083757,Briones; Jor-el Thomas Caparas,1,0,36,35
1657534864051,MATH 20B,A03,093475,Briones; Jor-el Thomas Caparas,2,0,36,34
1657534870079,MATH 20C,A01,083760,Briones; Jor-el Thomas Caparas,1,0,35,34
1657534870079,MATH 20C,A02,083761,Briones; Jor-el Thomas Caparas,8,0,35,27
1657534870079,MATH 20C,A03,093476,Briones; Jor-el Thomas Caparas,0,1,36,36
1657534870079,MATH 20C,B01,083762,Bach; Quang Tran,1,0,30,29
1657534876108,MATH 20D,A01,083765,Tran; Brian Kha,5,0,30,25
1657534876108,MATH 20D,A02,083766,Tran; Brian Kha,5,0,30,25
1657534876108,MATH 20D,A03,083767,Tran; Brian Kha,5,0,30,25
1657534882137,MATH 20E,A01,083771,Ganguly; Soumya,9,0,32,23
1657534882137,MATH 20E,A02,083772,Ganguly; Soumya,6,0,32,26
1657534882137,MATH 20E,B01,083773,Ciotti; Benjamin,20,0,35,15
1657534882137,MATH 20E,B02,083774,Ciotti; Benjamin,17,0,35,18
1657534888161,MATH 103A,A01,083777,Greenfeld; Be'Eri,3,0,36,33
1657534888161,MATH 103A,A02,083778,Greenfeld; Be'Eri,5,0,36,31
1657534888161,MATH 103A,A03,093561,Greenfeld; Be'Eri,5,0,36,31
1657534888161,MATH 103A,B01,083779,Greenfeld; Be'Eri,7,0,36,29
1657534888161,MATH 103A,B02,083780,Greenfeld; Be'Eri,4,0,36,32
1657534888161,MATH 103A,B03,093562,Greenfeld; Be'Eri,3,0,36,33
1657534894184,MATH 105,A01,085443,Carter; Anne Toulson,15,0,35,20
1657534894184,MATH 105,A02,093477,Carter; Anne Toulson,20,0,35,15
1657534900207,MATH 109,A01,083213,Ganzberger; Geoffrey Michael,2,0,34,32
1657534900207,MATH 109,A02,083214,Ganzberger; Geoffrey Michael,4,0,34,30
1657534900207,MATH 109,A03,093478,Ganzberger; Geoffrey Michael,2,0,34,32
1657534900207,MATH 109,B01,083215,Ganzberger; Geoffrey Michael,1,0,32,31
1657534900207,MATH 109,B02,083216,Ganzberger; Geoffrey Michael,2,0,32,30
1657534900207,MATH 109,B03,093479,Ganzberger; Geoffrey Michael,8,0,32,24
1657534906231,MATH 142A,A01,083219,Chow; Bennett,7,0,32,25
1657534906231,MATH 142A,A02,083220,Chow; Bennett,10,0,32,22
1657534906231,MATH 142A,A03,093480,Chow; Bennett,8,0,32,24
1657534906231,MATH 142A,B03,093481,Chow; Bennett,8,0,32,24
1657534906231,MATH 142A,B04,093558,Chow; Bennett,13,0,32,19
1657534906231,MATH 142A,B05,093559,Chow; Bennett,6,0,32,26
1657534912262,MATH 193A,A01,083224,Rotar; Vladimir,8,0,34,26
1657534912262,MATH 193A,A02,083225,Rotar; Vladimir,9,0,34,25
1657534912262,MATH 193A,A03,083781,Rotar; Vladimir,5,0,34,29
1657534912262,MATH 193A,A04,083782,Rotar; Vladimir,10,0,34,24
1657534912262,MATH 193A,A05,093482,Rotar; Vladimir,10,0,34,24
1657534918284,MATH 197,001,091859,McAuley; Julian John,9999,0,9999,0
1657534918284,MATH 197,002,095566,Kedlaya; Kiran S.,9997,0,9999,2
1657534918284,MATH 197,003,095567,Xiao; Ming,9999,0,9999,0
1657534918284,MATH 197,004,095571,Perols; Johan Lars,9998,0,9999,1
1657534925350,COGS 9,A01,083615,Shannon; Kyle Michael,9,0,75,66
1657534931373,COGS 11,A01,083617,Boyle; Mary E. T.,22,0,48,26
1657534937402,COGS 13,A01,083071,Bastos; Amalia Pinkusfeld,11,0,71,60
1657534943433,COGS 14A,A01,092681,Semenuks; Arturs,5,1,100,95
1657534949456,COGS 14B,A01,083073,Cheng; Tzu-Han,6,0,63,57
1657534955482,COGS 17,A01,092677,Semenuks; Arturs,6,0,81,75
1657534961509,COGS 100,A01,083619,Allen; Michael Gordon,17,0,70,53
1657534967536,COGS 101A,A01,083621,Davis; Joshua Daniel,9,0,68,59
1657534973559,COGS 101B,A01,091572,Allen; Michael Gordon,12,0,65,53
1657534979587,COGS 101C,A01,083625,Delgado; Tania,17,0,35,18
1657534985610,COGS 107A,A01,083627,Boyle; Mary E. T.,13,0,60,47
1657534991635,COGS 118A,A01,083075,Gupta; Anjum,21,0,76,55
1657534997657,CSE 3,A50,083646,Miranda; Gregory Joseph,24,0,50,26
1657535003686,CSE 8A,A50,083650,Miranda; Gregory Joseph,17,1,56,39
1657535009712,CSE 11,A01,083080,Cao; Yingjun,6,15,40,34
1657535015740,CSE 12,A01,083652,Krause-Levy; Sophia Louisa,28,1,120,92
1657535021763,CSE 15L,A01,083654,Morris; Justin Loren,9,0,50,41
1657535021763,CSE 15L,A02,083655,Morris; Justin Loren,9,0,50,41
1657535027787,CSE 20,A01,083657,Tran; Khoa Dang,39,0,80,41
1657535033810,CSE 21,A01,095574,Bach; Quang Tran,22,0,48,26
1657535039838,CSE 30,A01,083084,Eldon; John,5,0,80,75
1657535039838,CSE 30,B01,095061,Bhaskar; Nishant,9,0,50,41
1657535045866,CSE 100,A01,083659,Cao; Yingjun,5,4,70,65
1657535051890,CSE 134B,A01,083661,Powell; Thomas Allan,22,0,100,78
1657535057912,CSE 140,A01,083663,Gungor; Onat,15,0,85,70
1657535063936,CSE 140L,A01,083088,Eldon; John,21,0,100,79
1657535069962,CSE 175,A01,083665,Kumar; Rakesh,3,0,25,22
1657535075986,CSE 190,A00,092507,Dubnov; Shlomo,8,0,20,12
1657535082013,ECE 45,A01,083139,Congero; Spencer William,6,0,75,69
1657535088036,ECE 65,A50,083695,Saad; Andrew S,12,0,30,18
1657535088036,ECE 65,A51,095125,Saad; Andrew S,24,0,26,2
1657535094061,ECE 109,A01,091882,Touri; Behrouz,19,0,70,51
1657535100086,ECE 180,A00,083140,Abi Samra; Nicholas Camill,1,0,30,29
1657535100086,ECE 180,B00,083141,Abi Samra; Nicholas Camill,0,0,30,30
1657535106112,MATH 10A,A01,083735,Patchell; Gregory David,2,0,30,28
1657535106112,MATH 10A,A02,083736,Patchell; Gregory David,20,0,30,10
1657535106112,MATH 10A,A03,083737,Patchell; Gregory David,16,0,30,14
1657535112135,MATH 10B,A01,083207,Lim; Seonhee,8,0,34,26
1657535112135,MATH 10B,A02,083208,Lim; Seonhee,9,0,35,26
1657535112135,MATH 10B,A03,093472,Lim; Seonhee,7,0,34,27
1657535112135,MATH 10B,B01,083739,Sinha; Shubham,12,0,30,18
1657535118163,MATH 18,A01,083743,Cinel; Cameron Alexander,7,0,30,23
1657535118163,MATH 18,A02,083744,Cinel; Cameron Alexander,17,0,30,13
1657535118163,MATH 18,A03,083745,Cinel; Cameron Alexander,9,0,30,21
1657535118163,MATH 18,B01,083748,Rideout; David Porter,5,0,37,32
1657535118163,MATH 18,B02,083749,Rideout; David Porter,5,0,36,31
1657535118163,MATH 18,B03,083750,Rideout; David Porter,3,0,37,34
1657535118163,MATH 18,B04,083751,Rideout; David Porter,6,0,36,30
1657535118163,MATH 18,B05,093473,Rideout; David Porter,6,0,36,30
1657535118163,MATH 18,B06,093474,Rideout; David Porter,6,0,36,30
1657535124188,MATH 20A,A01,083754,Zheng; Zequn,14,0,40,26
1657535130211,MATH 20B,A01,083756,Briones; Jor-el Thomas Caparas,4,0,36,32
1657535130211,MATH 20B,A02,083757,Briones; Jor-el Thomas Caparas,1,0,36,35
1657535130211,MATH 20B,A03,093475,Briones; Jor-el Thomas Caparas,2,0,36,34
1657535136238,MATH 20C,A01,083760,Briones; Jor-el Thomas Caparas,1,0,35,34
1657535136238,MATH 20C,A02,083761,Briones; Jor-el Thomas Caparas,8,0,35,27
1657535136238,MATH 20C,A03,093476,Briones; Jor-el Thomas Caparas,0,1,36,36
1657535136238,MATH 20C,B01,083762,Bach; Quang Tran,1,0,30,29
1657535142267,MATH 20D,A01,083765,Tran; Brian Kha,5,0,30,25
1657535142267,MATH 20D,A02,083766,Tran; Brian Kha,5,0,30,25
1657535142267,MATH 20D,A03,083767,Tran; Brian Kha,5,0,30,25
1657535148291,MATH 20E,A01,083771,Ganguly; Soumya,9,0,32,23
1657535148291,MATH 20E,A02,083772,Ganguly; Soumya,6,0,32,26
1657535148291,MATH 20E,B01,083773,Ciotti; Benjamin,20,0,35,15
1657535148291,MATH 20E,B02,083774,Ciotti; Benjamin,17,0,35,18
1657535154315,MATH 103A,A01,083777,Greenfeld; Be'Eri,3,0,36,33
1657535154315,MATH 103A,A02,083778,Greenfeld; Be'Eri,5,0,36,31
1657535154315,MATH 103A,A03,093561,Greenfeld; Be'Eri,5,0,36,31
1657535154315,MATH 103A,B01,083779,Greenfeld; Be'Eri,7,0,36,29
1657535154315,MATH 103A,B02,083780,Greenfeld; Be'Eri,4,0,36,32
1657535154315,MATH 103A,B03,093562,Greenfeld; Be'Eri,3,0,36,33
1657535160339,MATH 105,A01,085443,Carter; Anne Toulson,15,0,35,20
1657535160339,MATH 105,A02,093477,Carter; Anne Toulson,20,0,35,15
1657535166361,MATH 109,A01,083213,Ganzberger; Geoffrey Michael,2,0,34,32
1657535166361,MATH 109,A02,083214,Ganzberger; Geoffrey Michael,4,0,34,30
1657535166361,MATH 109,A03,093478,Ganzberger; Geoffrey Michael,2,0,34,32
1657535166361,MATH 109,B01,083215,Ganzberger; Geoffrey Michael,1,0,32,31
1657535166361,MATH 109,B02,083216,Ganzberger; Geoffrey Michael,2,0,32,30
1657535166361,MATH 109,B03,093479,Ganzberger; Geoffrey Michael,8,0,32,24
1657535172386,MATH 142A,A01,083219,Chow; Bennett,7,0,32,25
1657535172386,MATH 142A,A02,083220,Chow; Bennett,10,0,32,22
1657535172386,MATH 142A,A03,093480,Chow; Bennett,8,0,32,24
1657535172386,MATH 142A,B03,093481,Chow; Bennett,8,0,32,24
1657535172386,MATH 142A,B04,093558,Chow; Bennett,13,0,32,19
1657535172386,MATH 142A,B05,093559,Chow; Bennett,6,0,32,26
1657535178415,MATH 193A,A01,083224,Rotar; Vladimir,8,0,34,26
1657535178415,MATH 193A,A02,083225,Rotar; Vladimir,9,0,34,25
1657535178415,MATH 193A,A03,083781,Rotar; Vladimir,5,0,34,29
1657535178415,MATH 193A,A04,083782,Rotar; Vladimir,10,0,34,24
1657535178415,MATH 193A,A05,093482,Rotar; Vladimir,10,0,34,24
1657535184441,MATH 197,001,091859,McAuley; Julian John,9999,0,9999,0
1657535184441,MATH 197,002,095566,Kedlaya; Kiran S.,9997,0,9999,2
1657535184441,MATH 197,003,095567,Xiao; Ming,9999,0,9999,0
1657535184441,MATH 197,004,095571,Perols; Johan Lars,9998,0,9999,1
1657535191496,COGS 9,A01,083615,Shannon; Kyle Michael,9,0,75,66
1657535197522,COGS 11,A01,083617,Boyle; Mary E. T.,22,0,48,26
1657535203552,COGS 13,A01,083071,Bastos; Amalia Pinkusfeld,11,0,71,60
1657535209577,COGS 14A,A01,092681,Semenuks; Arturs,5,1,100,95
1657535215598,COGS 14B,A01,083073,Cheng; Tzu-Han,6,0,63,57
1657535221620,COGS 17,A01,092677,Semenuks; Arturs,6,0,81,75
1657535227644,COGS 100,A01,083619,Allen; Michael Gordon,17,0,70,53
1657535233669,COGS 101A,A01,083621,Davis; Joshua Daniel,9,0,68,59
1657535239694,COGS 101B,A01,091572,Allen; Michael Gordon,12,0,65,53
1657535245718,COGS 101C,A01,083625,Delgado; Tania,17,0,35,18
1657535251741,COGS 107A,A01,083627,Boyle; Mary E. T.,13,0,60,47
1657535257766,COGS 118A,A01,083075,Gupta; Anjum,21,0,76,55
1657535263789,CSE 3,A50,083646,Miranda; Gregory Joseph,24,0,50,26
1657535269811,CSE 8A,A50,083650,Miranda; Gregory Joseph,17,1,56,39
1657535275836,CSE 11,A01,083080,Cao; Yingjun,6,15,40,34
1657535281858,CSE 12,A01,083652,Krause-Levy; Sophia Louisa,28,1,120,92
1657535287884,CSE 15L,A01,083654,Morris; Justin Loren,9,0,50,41
1657535287884,CSE 15L,A02,083655,Morris; Justin Loren,9,0,50,41
1657535293907,CSE 20,A01,083657,Tran; Khoa Dang,39,0,80,41
1657535299929,CSE 21,A01,095574,Bach; Quang Tran,22,0,48,26
1657535305955,CSE 30,A01,083084,Eldon; John,5,0,80,75
1657535305955,CSE 30,B01,095061,Bhaskar; Nishant,9,0,50,41
1657535311979,CSE 100,A01,083659,Cao; Yingjun,5,4,70,65
1657535318003,CSE 134B,A01,083661,Powell; Thomas Allan,22,0,100,78
1657535324025,CSE 140,A01,083663,Gungor; Onat,15,0,85,70
1657535330051,CSE 140L,A01,083088,Eldon; John,21,0,100,79
1657535336077,CSE 175,A01,083665,Kumar; Rakesh,3,0,25,22
1657535342109,CSE 190,A00,092507,Dubnov; Shlomo,8,0,20,12
1657535348134,ECE 45,A01,083139,Congero; Spencer William,6,0,75,69
1657535354156,ECE 65,A50,083695,Saad; Andrew S,12,0,30,18
1657535354156,ECE 65,A51,095125,Saad; Andrew S,24,0,26,2
1657535360179,ECE 109,A01,091882,Touri; Behrouz,19,0,70,51
1657535366202,ECE 180,A00,083140,Abi Samra; Nicholas Camill,1,0,30,29
1657535366202,ECE 180,B00,083141,Abi Samra; Nicholas Camill,0,0,30,30
1657535372231,MATH 10A,A01,083735,Patchell; Gregory David,2,0,30,28
1657535372231,MATH 10A,A02,083736,Patchell; Gregory David,20,0,30,10
1657535372231,MATH 10A,A03,083737,Patchell; Gregory David,16,0,30,14
1657535378254,MATH 10B,A01,083207,Lim; Seonhee,8,0,34,26
1657535378254,MATH 10B,A02,083208,Lim; Seonhee,9,0,35,26
1657535378254,MATH 10B,A03,093472,Lim; Seonhee,7,0,34,27
1657535378254,MATH 10B,B01,083739,Sinha; Shubham,12,0,30,18
1657535384277,MATH 18,A01,083743,Cinel; Cameron Alexander,7,0,30,23
1657535384277,MATH 18,A02,083744,Cinel; Cameron Alexander,17,0,30,13
1657535384277,MATH 18,A03,083745,Cinel; Cameron Alexander,9,0,30,21
1657535384277,MATH 18,B01,083748,Rideout; David Porter,5,0,37,32
1657535384277,MATH 18,B02,083749,Rideout; David Porter,5,0,36,31
1657535384277,MATH 18,B03,083750,Rideout; David Porter,3,0,37,34
1657535384277,MATH 18,B04,083751,Rideout; David Porter,6,0,36,30
1657535384277,MATH 18,B05,093473,Rideout; David Porter,6,0,36,30
1657535384277,MATH 18,B06,093474,Rideout; David Porter,6,0,36,30
1657535390302,MATH 20A,A01,083754,Zheng; Zequn,14,0,40,26
1657535396326,MATH 20B,A01,083756,Briones; Jor-el Thomas Caparas,4,0,36,32
1657535396326,MATH 20B,A02,083757,Briones; Jor-el Thomas Caparas,1,0,36,35
1657535396326,MATH 20B,A03,093475,Briones; Jor-el Thomas Caparas,2,0,36,34
1657535402365,MATH 20C,A01,083760,Briones; Jor-el Thomas Caparas,1,0,35,34
1657535402365,MATH 20C,A02,083761,Briones; Jor-el Thomas Caparas,8,0,35,27
1657535402365,MATH 20C,A03,093476,Briones; Jor-el Thomas Caparas,0,1,36,36
1657535402365,MATH 20C,B01,083762,Bach; Quang Tran,1,0,30,29
1657535408387,MATH 20D,A01,083765,Tran; Brian Kha,5,0,30,25
1657535408387,MATH 20D,A02,083766,Tran; Brian Kha,5,0,30,25
1657535408387,MATH 20D,A03,083767,Tran; Brian Kha,5,0,30,25
1657535414416,MATH 20E,A01,083771,Ganguly; Soumya,9,0,32,23
1657535414416,MATH 20E,A02,083772,Ganguly; Soumya,6,0,32,26
1657535414416,MATH 20E,B01,083773,Ciotti; Benjamin,20,0,35,15
1657535414416,MATH 20E,B02,083774,Ciotti; Benjamin,17,0,35,18
1657535420445,MATH 103A,A01,083777,Greenfeld; Be'Eri,3,0,36,33
1657535420445,MATH 103A,A02,083778,Greenfeld; Be'Eri,5,0,36,31
1657535420445,MATH 103A,A03,093561,Greenfeld; Be'Eri,5,0,36,31
1657535420445,MATH 103A,B01,083779,Greenfeld; Be'Eri,7,0,36,29
1657535420445,MATH 103A,B02,083780,Greenfeld; Be'Eri,4,0,36,32
1657535420445,MATH 103A,B03,093562,Greenfeld; Be'Eri,3,0,36,33
1657535426467,MATH 105,A01,085443,Carter; Anne Toulson,15,0,35,20
1657535426467,MATH 105,A02,093477,Carter; Anne Toulson,20,0,35,15
1657535432578,MATH 109,A01,083213,Ganzberger; Geoffrey Michael,2,0,34,32
1657535432578,MATH 109,A02,083214,Ganzberger; Geoffrey Michael,4,0,34,30
1657535432578,MATH 109,A03,093478,Ganzberger; Geoffrey Michael,2,0,34,32
1657535432578,MATH 109,B01,083215,Ganzberger; Geoffrey Michael,1,0,32,31
1657535432578,MATH 109,B02,083216,Ganzberger; Geoffrey Michael,2,0,32,30
1657535432578,MATH 109,B03,093479,Ganzberger; Geoffrey Michael,8,0,32,24
1657535438606,MATH 142A,A01,083219,Chow; Bennett,7,0,32,25
1657535438606,MATH 142A,A02,083220,Chow; Bennett,10,0,32,22
1657535438606,MATH 142A,A03,093480,Chow; Bennett,8,0,32,24
1657535438606,MATH 142A,B03,093481,Chow; Bennett,8,0,32,24
1657535438606,MATH 142A,B04,093558,Chow; Bennett,13,0,32,19
1657535438606,MATH 142A,B05,093559,Chow; Bennett,6,0,32,26
1657535444636,MATH 193A,A01,083224,Rotar; Vladimir,8,0,34,26
1657535444636,MATH 193A,A02,083225,Rotar; Vladimir,9,0,34,25
1657535444636,MATH 193A,A03,083781,Rotar; Vladimir,5,0,34,29
1657535444636,MATH 193A,A04,083782,Rotar; Vladimir,10,0,34,24
1657535444636,MATH 193A,A05,093482,Rotar; Vladimir,10,0,34,24
1657535450666,MATH 197,001,091859,McAuley; Julian John,9999,0,9999,0
1657535450666,MATH 197,002,095566,Kedlaya; Kiran S.,9997,0,9999,2
1657535450666,MATH 197,003,095567,Xiao; Ming,9999,0,9999,0
1657535450666,MATH 197,004,095571,Perols; Johan Lars,9998,0,9999,1
1657535457747,COGS 9,A01,083615,Shannon; Kyle Michael,9,0,75,66
1657535463774,COGS 11,A01,083617,Boyle; Mary E. T.,22,0,48,26
1657535469803,COGS 13,A01,083071,Bastos; Amalia Pinkusfeld,11,0,71,60
1657535475827,COGS 14A,A01,092681,Semenuks; Arturs,5,1,100,95
1657535481856,COGS 14B,A01,083073,Cheng; Tzu-Han,6,0,63,57
1657535487894,COGS 17,A01,092677,Semenuks; Arturs,6,0,81,75
1657535493928,COGS 100,A01,083619,Allen; Michael Gordon,17,0,70,53
1657535499958,COGS 101A,A01,083621,Davis; Joshua Daniel,9,0,68,59
1657535505982,COGS 101B,A01,091572,Allen; Michael Gordon,12,0,65,53
1657535512011,COGS 101C,A01,083625,Delgado; Tania,17,0,35,18
1657535518034,COGS 107A,A01,083627,Boyle; Mary E. T.,13,0,60,47
1657535524068,COGS 118A,A01,083075,Gupta; Anjum,21,0,76,55
1657535530091,CSE 3,A50,083646,Miranda; Gregory Joseph,24,0,50,26
1657535536114,CSE 8A,A50,083650,Miranda; Gregory Joseph,17,1,56,39
1657535542140,CSE 11,A01,083080,Cao; Yingjun,6,15,40,34
1657535548167,CSE 12,A01,083652,Krause-Levy; Sophia Louisa,28,1,120,92
1657535554191,CSE 15L,A01,083654,Morris; Justin Loren,9,0,50,41
1657535554191,CSE 15L,A02,083655,Morris; Justin Loren,9,0,50,41
1657535560223,CSE 20,A01,083657,Tran; Khoa Dang,39,0,80,41
1657535566257,CSE 21,A01,095574,Bach; Quang Tran,22,0,48,26
1657535572281,CSE 30,A01,083084,Eldon; John,5,0,80,75
1657535572281,CSE 30,B01,095061,Bhaskar; Nishant,9,0,50,41
1657535578305,CSE 100,A01,083659,Cao; Yingjun,5,4,70,65
1657535584333,CSE 134B,A01,083661,Powell; Thomas Allan,22,0,100,78
1657535590356,CSE 140,A01,083663,Gungor; Onat,15,0,85,70
1657535596388,CSE 140L,A01,083088,Eldon; John,21,0,100,79
1657535602416,CSE 175,A01,083665,Kumar; Rakesh,3,0,25,22
1657535608438,CSE 190,A00,092507,Dubnov; Shlomo,8,0,20,12
1657535614462,ECE 45,A01,083139,Congero; Spencer William,6,0,75,69
1657535620486,ECE 65,A50,083695,Saad; Andrew S,12,0,30,18
1657535620486,ECE 65,A51,095125,Saad; Andrew S,24,0,26,2
1657535626519,ECE 109,A01,091882,Touri; Behrouz,19,0,70,51
1657535632547,ECE 180,A00,083140,Abi Samra; Nicholas Camill,1,0,30,29
1657535632547,ECE 180,B00,083141,Abi Samra; Nicholas Camill,0,0,30,30
1657535638578,MATH 10A,A01,083735,Patchell; Gregory David,2,0,30,28
1657535638578,MATH 10A,A02,083736,Patchell; Gregory David,20,0,30,10
1657535638578,MATH 10A,A03,083737,Patchell; Gregory David,16,0,30,14
1657535644601,MATH 10B,A01,083207,Lim; Seonhee,8,0,34,26
1657535644601,MATH 10B,A02,083208,Lim; Seonhee,9,0,35,26
1657535644601,MATH 10B,A03,093472,Lim; Seonhee,7,0,34,27
1657535644601,MATH 10B,B01,083739,Sinha; Shubham,12,0,30,18
1657535650632,MATH 18,A01,083743,Cinel; Cameron Alexander,7,0,30,23
1657535650632,MATH 18,A02,083744,Cinel; Cameron Alexander,17,0,30,13
1657535650632,MATH 18,A03,083745,Cinel; Cameron Alexander,9,0,30,21
1657535650632,MATH 18,B01,083748,Rideout; David Porter,5,0,37,32
1657535650632,MATH 18,B02,083749,Rideout; David Porter,5,0,36,31
1657535650632,MATH 18,B03,083750,Rideout; David Porter,3,0,37,34
1657535650632,MATH 18,B04,083751,Rideout; David Porter,6,0,36,30
1657535650632,MATH 18,B05,093473,Rideout; David Porter,6,0,36,30
1657535650632,MATH 18,B06,093474,Rideout; David Porter,6,0,36,30
1657535656658,MATH 20A,A01,083754,Zheng; Zequn,14,0,40,26
1657535662680,MATH 20B,A01,083756,Briones; Jor-el Thomas Caparas,4,0,36,32
1657535662680,MATH 20B,A02,083757,Briones; Jor-el Thomas Caparas,1,0,36,35
1657535662680,MATH 20B,A03,093475,Briones; Jor-el Thomas Caparas,2,0,36,34
1657535668705,MATH 20C,A01,083760,Briones; Jor-el Thomas Caparas,1,0,35,34
1657535668705,MATH 20C,A02,083761,Briones; Jor-el Thomas Caparas,8,0,35,27
1657535668705,MATH 20C,A03,093476,Briones; Jor-el Thomas Caparas,0,1,36,36
1657535668705,MATH 20C,B01,083762,Bach; Quang Tran,1,0,30,29
1657535674728,MATH 20D,A01,083765,Tran; Brian Kha,5,0,30,25
1657535674728,MATH 20D,A02,083766,Tran; Brian Kha,5,0,30,25
1657535674728,MATH 20D,A03,083767,Tran; Brian Kha,5,0,30,25
1657535680761,MATH 20E,A01,083771,Ganguly; Soumya,9,0,32,23
1657535680761,MATH 20E,A02,083772,Ganguly; Soumya,6,0,32,26
1657535680761,MATH 20E,B01,083773,Ciotti; Benjamin,20,0,35,15
1657535680761,MATH 20E,B02,083774,Ciotti; Benjamin,17,0,35,18
1657535686784,MATH 103A,A01,083777,Greenfeld; Be'Eri,3,0,36,33
1657535686784,MATH 103A,A02,083778,Greenfeld; Be'Eri,5,0,36,31
1657535686784,MATH 103A,A03,093561,Greenfeld; Be'Eri,5,0,36,31
1657535686784,MATH 103A,B01,083779,Greenfeld; Be'Eri,7,0,36,29
1657535686784,MATH 103A,B02,083780,Greenfeld; Be'Eri,4,0,36,32
1657535686784,MATH 103A,B03,093562,Greenfeld; Be'Eri,3,0,36,33
1657535692811,MATH 105,A01,085443,Carter; Anne Toulson,15,0,35,20
1657535692811,MATH 105,A02,093477,Carter; Anne Toulson,20,0,35,15
1657535698834,MATH 109,A01,083213,Ganzberger; Geoffrey Michael,2,0,34,32
1657535698834,MATH 109,A02,083214,Ganzberger; Geoffrey Michael,4,0,34,30
1657535698834,MATH 109,A03,093478,Ganzberger; Geoffrey Michael,2,0,34,32
1657535698834,MATH 109,B01,083215,Ganzberger; Geoffrey Michael,1,0,32,31
1657535698834,MATH 109,B02,083216,Ganzberger; Geoffrey Michael,2,0,32,30
1657535698834,MATH 109,B03,093479,Ganzberger; Geoffrey Michael,8,0,32,24
1657535704874,MATH 142A,A01,083219,Chow; Bennett,7,0,32,25
1657535704874,MATH 142A,A02,083220,Chow; Bennett,10,0,32,22
1657535704874,MATH 142A,A03,093480,Chow; Bennett,8,0,32,24
1657535704874,MATH 142A,B03,093481,Chow; Bennett,8,0,32,24
1657535704874,MATH 142A,B04,093558,Chow; Bennett,13,0,32,19
1657535704874,MATH 142A,B05,093559,Chow; Bennett,6,0,32,26
1657535710897,MATH 193A,A01,083224,Rotar; Vladimir,8,0,34,26
1657535710897,MATH 193A,A02,083225,Rotar; Vladimir,9,0,34,25
1657535710897,MATH 193A,A03,083781,Rotar; Vladimir,5,0,34,29
1657535710897,MATH 193A,A04,083782,Rotar; Vladimir,10,0,34,24
1657535710897,MATH 193A,A05,093482,Rotar; Vladimir,10,0,34,24
1657535716928,MATH 197,001,091859,McAuley; Julian John,9999,0,9999,0
1657535716928,MATH 197,002,095566,Kedlaya; Kiran S.,9997,0,9999,2
1657535716928,MATH 197,003,095567,Xiao; Ming,9999,0,9999,0
1657535716928,MATH 197,004,095571,Perols; Johan Lars,9998,0,9999,1
1657535723988,COGS 9,A01,083615,Shannon; Kyle Michael,9,0,75,66
1657535730012,COGS 11,A01,083617,Boyle; Mary E. T.,22,0,48,26
1657535736038,COGS 13,A01,083071,Bastos; Amalia Pinkusfeld,11,0,71,60
1657535742061,COGS 14A,A01,092681,Semenuks; Arturs,5,1,100,95
1657535748096,COGS 14B,A01,083073,Cheng; Tzu-Han,6,0,63,57
1657535754126,COGS 17,A01,092677,Semenuks; Arturs,6,0,81,75
1657535760149,COGS 100,A01,083619,Allen; Michael Gordon,17,0,70,53
1657535766175,COGS 101A,A01,083621,Davis; Joshua Daniel,9,0,68,59
1657535772203,COGS 101B,A01,091572,Allen; Michael Gordon,12,0,65,53
1657535778234,COGS 101C,A01,083625,Delgado; Tania,17,0,35,18
1657535784257,COGS 107A,A01,083627,Boyle; Mary E. T.,13,0,60,47
1657535790281,COGS 118A,A01,083075,Gupta; Anjum,21,0,76,55
1657535796315,CSE 3,A50,083646,Miranda; Gregory Joseph,24,0,50,26
1657535802341,CSE 8A,A50,083650,Miranda; Gregory Joseph,17,1,56,39
1657535808369,CSE 11,A01,083080,Cao; Yingjun,6,15,40,34
1657535814408,CSE 12,A01,083652,Krause-Levy; Sophia Louisa,28,1,120,92
1657535820432,CSE 15L,A01,083654,Morris; Justin Loren,9,0,50,41
1657535820432,CSE 15L,A02,083655,Morris; Justin Loren,9,0,50,41
1657535826455,CSE 20,A01,083657,Tran; Khoa Dang,39,0,80,41
1657535832479,CSE 21,A01,095574,Bach; Quang Tran,22,0,48,26
1657535838512,CSE 30,A01,083084,Eldon; John,5,0,80,75
1657535838512,CSE 30,B01,095061,Bhaskar; Nishant,9,0,50,41
1657535844536,CSE 100,A01,083659,Cao; Yingjun,5,4,70,65
1657535850561,CSE 134B,A01,083661,Powell; Thomas Allan,22,0,100,78
1657535856592,CSE 140,A01,083663,Gungor; Onat,15,0,85,70
1657535862619,CSE 140L,A01,083088,Eldon; John,21,0,100,79
1657535868651,CSE 175,A01,083665,Kumar; Rakesh,3,0,25,22
1657535874674,CSE 190,A00,092507,Dubnov; Shlomo,8,0,20,12
1657535880698,ECE 45,A01,083139,Congero; Spencer William,6,0,75,69
1657535886729,ECE 65,A50,083695,Saad; Andrew S,12,0,30,18
1657535886729,ECE 65,A51,095125,Saad; Andrew S,24,0,26,2
1657535892780,ECE 109,A01,091882,Touri; Behrouz,19,0,70,51
1657535898811,ECE 180,A00,083140,Abi Samra; Nicholas Camill,1,0,30,29
1657535898811,ECE 180,B00,083141,Abi Samra; Nicholas Camill,0,0,30,30
1657535904848,MATH 10A,A01,083735,Patchell; Gregory David,2,0,30,28
1657535904848,MATH 10A,A02,083736,Patchell; Gregory David,20,0,30,10
1657535904848,MATH 10A,A03,083737,Patchell; Gregory David,16,0,30,14
1657535910876,MATH 10B,A01,083207,Lim; Seonhee,8,0,34,26
1657535910876,MATH 10B,A02,083208,Lim; Seonhee,9,0,35,26
1657535910876,MATH 10B,A03,093472,Lim; Seonhee,7,0,34,27
1657535910876,MATH 10B,B01,083739,Sinha; Shubham,12,0,30,18
1657535916903,MATH 18,A01,083743,Cinel; Cameron Alexander,7,0,30,23
1657535916903,MATH 18,A02,083744,Cinel; Cameron Alexander,17,0,30,13
1657535916903,MATH 18,A03,083745,Cinel; Cameron Alexander,9,0,30,21
1657535916903,MATH 18,B01,083748,Rideout; David Porter,5,0,37,32
1657535916903,MATH 18,B02,083749,Rideout; David Porter,5,0,36,31
1657535916903,MATH 18,B03,083750,Rideout; David Porter,3,0,37,34
1657535916903,MATH 18,B04,083751,Rideout; David Porter,6,0,36,30
1657535916903,MATH 18,B05,093473,Rideout; David Porter,6,0,36,30
1657535916903,MATH 18,B06,093474,Rideout; David Porter,6,0,36,30
1657535922927,MATH 20A,A01,083754,Zheng; Zequn,14,0,40,26
1657535928975,MATH 20B,A01,083756,Briones; Jor-el Thomas Caparas,4,0,36,32
1657535928975,MATH 20B,A02,083757,Briones; Jor-el Thomas Caparas,1,0,36,35
1657535928975,MATH 20B,A03,093475,Briones; Jor-el Thomas Caparas,2,0,36,34
1657535935010,MATH 20C,A01,083760,Briones; Jor-el Thomas Caparas,1,0,35,34
1657535935010,MATH 20C,A02,083761,Briones; Jor-el Thomas Caparas,8,0,35,27
1657535935010,MATH 20C,A03,093476,Briones; Jor-el Thomas Caparas,0,1,36,36
1657535935010,MATH 20C,B01,083762,Bach; Quang Tran,1,0,30,29
1657535941041,MATH 20D,A01,083765,Tran; Brian Kha,5,0,30,25
1657535941041,MATH 20D,A02,083766,Tran; Brian Kha,5,0,30,25
1657535941041,MATH 20D,A03,083767,Tran; Brian Kha,5,0,30,25
1657535947083,MATH 20E,A01,083771,Ganguly; Soumya,9,0,32,23
1657535947083,MATH 20E,A02,083772,Ganguly; Soumya,6,0,32,26
1657535947083,MATH 20E,B01,083773,Ciotti; Benjamin,20,0,35,15
1657535947083,MATH 20E,B02,083774,Ciotti; Benjamin,17,0,35,18
1657535953119,MATH 103A,A01,083777,Greenfeld; Be'Eri,3,0,36,33
1657535953119,MATH 103A,A02,083778,Greenfeld; Be'Eri,5,0,36,31
1657535953119,MATH 103A,A03,093561,Greenfeld; Be'Eri,5,0,36,31
1657535953119,MATH 103A,B01,083779,Greenfeld; Be'Eri,7,0,36,29
1657535953119,MATH 103A,B02,083780,Greenfeld; Be'Eri,4,0,36,32
1657535953119,MATH 103A,B03,093562,Greenfeld; Be'Eri,3,0,36,33
1657535959159,MATH 105,A01,085443,Carter; Anne Toulson,15,0,35,20
1657535959159,MATH 105,A02,093477,Carter; Anne Toulson,20,0,35,15
1657535965188,MATH 109,A01,083213,Ganzberger; Geoffrey Michael,2,0,34,32
1657535965188,MATH 109,A02,083214,Ganzberger; Geoffrey Michael,4,0,34,30
1657535965188,MATH 109,A03,093478,Ganzberger; Geoffrey Michael,2,0,34,32
1657535965188,MATH 109,B01,083215,Ganzberger; Geoffrey Michael,1,0,32,31
1657535965188,MATH 109,B02,083216,Ganzberger; Geoffrey Michael,2,0,32,30
1657535965188,MATH 109,B03,093479,Ganzberger; Geoffrey Michael,8,0,32,24
1657535971224,MATH 142A,A01,083219,Chow; Bennett,7,0,32,25
1657535971224,MATH 142A,A02,083220,Chow; Bennett,10,0,32,22
1657535971224,MATH 142A,A03,093480,Chow; Bennett,8,0,32,24
1657535971224,MATH 142A,B03,093481,Chow; Bennett,8,0,32,24
1657535971224,MATH 142A,B04,093558,Chow; Bennett,13,0,32,19
1657535971224,MATH 142A,B05,093559,Chow; Bennett,6,0,32,26
1657535977262,MATH 193A,A01,083224,Rotar; Vladimir,8,0,34,26
1657535977262,MATH 193A,A02,083225,Rotar; Vladimir,9,0,34,25
1657535977262,MATH 193A,A03,083781,Rotar; Vladimir,5,0,34,29
1657535977262,MATH 193A,A04,083782,Rotar; Vladimir,10,0,34,24
1657535977262,MATH 193A,A05,093482,Rotar; Vladimir,10,0,34,24
1657535983293,MATH 197,001,091859,McAuley; Julian John,9999,0,9999,0
1657535983293,MATH 197,002,095566,Kedlaya; Kiran S.,9997,0,9999,2
1657535983293,MATH 197,003,095567,Xiao; Ming,9999,0,9999,0
1657535983293,MATH 197,004,095571,Perols; Johan Lars,9998,0,9999,1
1657535990377,COGS 9,A01,083615,Shannon; Kyle Michael,9,0,75,66
1657535996405,COGS 11,A01,083617,Boyle; Mary E. T.,22,0,48,26
1657536002437,COGS 13,A01,083071,Bastos; Amalia Pinkusfeld,11,0,71,60
1657536008461,COGS 14A,A01,092681,Semenuks; Arturs,5,1,100,95
1657536014493,COGS 14B,A01,083073,Cheng; Tzu-Han,6,0,63,57
1657536020517,COGS 17,A01,092677,Semenuks; Arturs,6,0,81,75
1657536026615,COGS 100,A01,083619,Allen; Michael Gordon,17,0,70,53
1657536032640,COGS 101A,A01,083621,Davis; Joshua Daniel,9,0,68,59
1657536038666,COGS 101B,A01,091572,Allen; Michael Gordon,12,0,65,53
1657536044691,COGS 101C,A01,083625,Delgado; Tania,17,0,35,18
1657536050714,COGS 107A,A01,083627,Boyle; Mary E. T.,13,0,60,47
1657536056741,COGS 118A,A01,083075,Gupta; Anjum,21,0,76,55
1657536062777,CSE 3,A50,083646,Miranda; Gregory Joseph,24,0,50,26
1657536068807,CSE 8A,A50,083650,Miranda; Gregory Joseph,17,1,56,39
1657536074838,CSE 11,A01,083080,Cao; Yingjun,6,15,40,34
1657536080868,CSE 12,A01,083652,Krause-Levy; Sophia Louisa,28,1,120,92
1657536086902,CSE 15L,A01,083654,Morris; Justin Loren,9,0,50,41
1657536086902,CSE 15L,A02,083655,Morris; Justin Loren,9,0,50,41
1657536092927,CSE 20,A01,083657,Tran; Khoa Dang,39,0,80,41
1657536098959,CSE 21,A01,095574,Bach; Quang Tran,22,0,48,26
1657536104988,CSE 30,A01,083084,Eldon; John,5,0,80,75
1657536104988,CSE 30,B01,095061,Bhaskar; Nishant,9,0,50,41
1657536111013,CSE 100,A01,083659,Cao; Yingjun,5,4,70,65
1657536117043,CSE 134B,A01,083661,Powell; Thomas Allan,22,0,100,78
1657536123073,CSE 140,A01,083663,Gungor; Onat,15,0,85,70
1657536129101,CSE 140L,A01,083088,Eldon; John,21,0,100,79
1657536135133,CSE 175,A01,083665,Kumar; Rakesh,3,0,25,22
1657536141171,CSE 190,A00,092507,Dubnov; Shlomo,8,0,20,12
1657536147201,ECE 45,A01,083139,Congero; Spencer William,6,0,75,69
1657536153228,ECE 65,A50,083695,Saad; Andrew S,12,0,30,18
1657536153228,ECE 65,A51,095125,Saad; Andrew S,24,0,26,2
1657536159262,ECE 109,A01,091882,Touri; Behrouz,19,0,70,51
1657536165292,ECE 180,A00,083140,Abi Samra; Nicholas Camill,1,0,30,29
1657536165292,ECE 180,B00,083141,Abi Samra; Nicholas Camill,0,0,30,30
1657536171328,MATH 10A,A01,083735,Patchell; Gregory David,2,0,30,28
1657536171328,MATH 10A,A02,083736,Patchell; Gregory David,20,0,30,10
1657536171328,MATH 10A,A03,083737,Patchell; Gregory David,16,0,30,14
1657536177366,MATH 10B,A01,083207,Lim; Seonhee,8,0,34,26
1657536177366,MATH 10B,A02,083208,Lim; Seonhee,9,0,35,26
1657536177366,MATH 10B,A03,093472,Lim; Seonhee,7,0,34,27
1657536177366,MATH 10B,B01,083739,Sinha; Shubham,12,0,30,18
1657536183395,MATH 18,A01,083743,Cinel; Cameron Alexander,7,0,30,23
1657536183395,MATH 18,A02,083744,Cinel; Cameron Alexander,17,0,30,13
1657536183395,MATH 18,A03,083745,Cinel; Cameron Alexander,9,0,30,21
1657536183395,MATH 18,B01,083748,Rideout; David Porter,5,0,37,32
1657536183395,MATH 18,B02,083749,Rideout; David Porter,5,0,36,31
1657536183395,MATH 18,B03,083750,Rideout; David Porter,3,0,37,34
1657536183395,MATH 18,B04,083751,Rideout; David Porter,6,0,36,30
1657536183395,MATH 18,B05,093473,Rideout; David Porter,6,0,36,30
1657536183395,MATH 18,B06,093474,Rideout; David Porter,6,0,36,30
1657536189420,MATH 20A,A01,083754,Zheng; Zequn,14,0,40,26
1657536195451,MATH 20B,A01,083756,Briones; Jor-el Thomas Caparas,4,0,36,32
1657536195451,MATH 20B,A02,083757,Briones; Jor-el Thomas Caparas,1,0,36,35
1657536195451,MATH 20B,A03,093475,Briones; Jor-el Thomas Caparas,2,0,36,34
1657536201476,MATH 20C,A01,083760,Briones; Jor-el Thomas Caparas,1,0,35,34
1657536201476,MATH 20C,A02,083761,Briones; Jor-el Thomas Caparas,8,0,35,27
1657536201476,MATH 20C,A03,093476,Briones; Jor-el Thomas Caparas,0,1,36,36
1657536201476,MATH 20C,B01,083762,Bach; Quang Tran,1,0,30,29
1657536207502,MATH 20D,A01,083765,Tran; Brian Kha,5,0,30,25
1657536207502,MATH 20D,A02,083766,Tran; Brian Kha,5,0,30,25
1657536207502,MATH 20D,A03,083767,Tran; Brian Kha,5,0,30,25
1657536213529,MATH 20E,A01,083771,Ganguly; Soumya,9,0,32,23
1657536213529,MATH 20E,A02,083772,Ganguly; Soumya,6,0,32,26
1657536213529,MATH 20E,B01,083773,Ciotti; Benjamin,20,0,35,15
1657536213529,MATH 20E,B02,083774,Ciotti; Benjamin,17,0,35,18
1657536219557,MATH 103A,A01,083777,Greenfeld; Be'Eri,3,0,36,33
1657536219557,MATH 103A,A02,083778,Greenfeld; Be'Eri,5,0,36,31
1657536219557,MATH 103A,A03,093561,Greenfeld; Be'Eri,5,0,36,31
1657536219557,MATH 103A,B01,083779,Greenfeld; Be'Eri,7,0,36,29
1657536219557,MATH 103A,B02,083780,Greenfeld; Be'Eri,4,0,36,32
1657536219557,MATH 103A,B03,093562,Greenfeld; Be'Eri,3,0,36,33
1657536225591,MATH 105,A01,085443,Carter; Anne Toulson,15,0,35,20
1657536225591,MATH 105,A02,093477,Carter; Anne Toulson,20,0,35,15
1657536231617,MATH 109,A01,083213,Ganzberger; Geoffrey Michael,2,0,34,32
1657536231617,MATH 109,A02,083214,Ganzberger; Geoffrey Michael,4,0,34,30
1657536231617,MATH 109,A03,093478,Ganzberger; Geoffrey Michael,2,0,34,32
1657536231617,MATH 109,B01,083215,Ganzberger; Geoffrey Michael,1,0,32,31
1657536231617,MATH 109,B02,083216,Ganzberger; Geoffrey Michael,2,0,32,30
1657536231617,MATH 109,B03,093479,Ganzberger; Geoffrey Michael,8,0,32,24
1657536237654,MATH 142A,A01,083219,Chow; Bennett,7,0,32,25
1657536237654,MATH 142A,A02,083220,Chow; Bennett,10,0,32,22
1657536237654,MATH 142A,A03,093480,Chow; Bennett,8,0,32,24
1657536237654,MATH 142A,B03,093481,Chow; Bennett,8,0,32,24
1657536237654,MATH 142A,B04,093558,Chow; Bennett,13,0,32,19
1657536237654,MATH 142A,B05,093559,Chow; Bennett,6,0,32,26
1657536243686,MATH 193A,A01,083224,Rotar; Vladimir,8,0,34,26
1657536243686,MATH 193A,A02,083225,Rotar; Vladimir,9,0,34,25
1657536243686,MATH 193A,A03,083781,Rotar; Vladimir,5,0,34,29
1657536243686,MATH 193A,A04,083782,Rotar; Vladimir,10,0,34,24
1657536243686,MATH 193A,A05,093482,Rotar; Vladimir,10,0,34,24
1657536249722,MATH 197,001,091859,McAuley; Julian John,9999,0,9999,0
1657536249722,MATH 197,002,095566,Kedlaya; Kiran S.,9997,0,9999,2
1657536249722,MATH 197,003,095567,Xiao; Ming,9999,0,9999,0
1657536249722,MATH 197,004,095571,Perols; Johan Lars,9998,0,9999,1
1657536256790,COGS 9,A01,083615,Shannon; Kyle Michael,9,0,75,66
1657536262815,COGS 11,A01,083617,Boyle; Mary E. T.,22,0,48,26
1657536268839,COGS 13,A01,083071,Bastos; Amalia Pinkusfeld,11,0,71,60
1657536274874,COGS 14A,A01,092681,Semenuks; Arturs,5,1,100,95
1657536291177,COGS 14B,A01,083073,Cheng; Tzu-Han,6,0,63,57
1657536297203,COGS 17,A01,092677,Semenuks; Arturs,6,0,81,75
1657536317470,COGS 100,A01,083619,Allen; Michael Gordon,17,0,70,53
1657536323497,COGS 101A,A01,083621,Davis; Joshua Daniel,9,0,68,59
1657536342385,COGS 101B,A01,091572,Allen; Michael Gordon,12,0,65,53
1657536348411,COGS 101C,A01,083625,Delgado; Tania,17,0,35,18
1657536367117,COGS 107A,A01,083627,Boyle; Mary E. T.,13,0,60,47
1657536373143,COGS 118A,A01,083075,Gupta; Anjum,21,0,76,55
1657536391564,CSE 3,A50,083646,Miranda; Gregory Joseph,24,0,50,26
1657536397588,CSE 8A,A50,083650,Miranda; Gregory Joseph,17,1,56,39
1657536416127,CSE 11,A01,083080,Cao; Yingjun,6,15,40,34
1657536422169,CSE 12,A01,083652,Krause-Levy; Sophia Louisa,28,1,120,92
1657536440540,CSE 15L,A01,083654,Morris; Justin Loren,9,0,50,41
1657536440540,CSE 15L,A02,083655,Morris; Justin Loren,9,0,50,41
1657536446564,CSE 20,A01,083657,Tran; Khoa Dang,39,0,80,41
1657536464964,CSE 21,A01,095574,Bach; Quang Tran,22,0,48,26
1657536470999,CSE 30,A01,083084,Eldon; John,5,0,80,75
1657536470999,CSE 30,B01,095061,Bhaskar; Nishant,9,0,50,41
1657536484454,CSE 100,A01,083659,Cao; Yingjun,5,4,70,65
1657536490478,CSE 134B,A01,083661,Powell; Thomas Allan,22,0,100,78
1657536496503,CSE 140,A01,083663,Gungor; Onat,15,0,85,70
1657536502528,CSE 140L,A01,083088,Eldon; John,21,0,100,79
1657536508559,CSE 175,A01,083665,Kumar; Rakesh,3,0,25,22
1657536514589,CSE 190,A00,092507,Dubnov; Shlomo,8,0,20,12
1657536520615,ECE 45,A01,083139,Congero; Spencer William,6,0,75,69
1657536526641,ECE 65,A50,083695,Saad; Andrew S,12,0,30,18
1657536526641,ECE 65,A51,095125,Saad; Andrew S,24,0,26,2
1657536532670,ECE 109,A01,091882,Touri; Behrouz,19,0,70,51
1657536538700,ECE 180,A00,083140,Abi Samra; Nicholas Camill,1,0,30,29
1657536538700,ECE 180,B00,083141,Abi Samra; Nicholas Camill,0,0,30,30
1657536544735,MATH 10A,A01,083735,Patchell; Gregory David,2,0,30,28
1657536544735,MATH 10A,A02,083736,Patchell; Gregory David,20,0,30,10
1657536544735,MATH 10A,A03,083737,Patchell; Gregory David,16,0,30,14
1657536550771,MATH 10B,A01,083207,Lim; Seonhee,8,0,34,26
1657536550771,MATH 10B,A02,083208,Lim; Seonhee,9,0,35,26
1657536550771,MATH 10B,A03,093472,Lim; Seonhee,7,0,34,27
1657536550771,MATH 10B,B01,083739,Sinha; Shubham,12,0,30,18
1657536556810,MATH 18,A01,083743,Cinel; Cameron Alexander,7,0,30,23
1657536556810,MATH 18,A02,083744,Cinel; Cameron Alexander,17,0,30,13
1657536556810,MATH 18,A03,083745,Cinel; Cameron Alexander,9,0,30,21
1657536556810,MATH 18,B01,083748,Rideout; David Porter,5,0,37,32
1657536556810,MATH 18,B02,083749,Rideout; David Porter,5,0,36,31
1657536556810,MATH 18,B03,083750,Rideout; David Porter,3,0,37,34
1657536556810,MATH 18,B04,083751,Rideout; David Porter,6,0,36,30
1657536556810,MATH 18,B05,093473,Rideout; David Porter,6,0,36,30
1657536556810,MATH 18,B06,093474,Rideout; David Porter,6,0,36,30
1657536562849,MATH 20A,A01,083754,Zheng; Zequn,14,0,40,26
1657536568881,MATH 20B,A01,083756,Briones; Jor-el Thomas Caparas,4,0,36,32
1657536568881,MATH 20B,A02,083757,Briones; Jor-el Thomas Caparas,1,0,36,35
1657536568881,MATH 20B,A03,093475,Briones; Jor-el Thomas Caparas,2,0,36,34
1657536574905,MATH 20C,A01,083760,Briones; Jor-el Thomas Caparas,1,0,35,34
1657536574905,MATH 20C,A02,083761,Briones; Jor-el Thomas Caparas,8,0,35,27
1657536574905,MATH 20C,A03,093476,Briones; Jor-el Thomas Caparas,0,1,36,36
1657536574905,MATH 20C,B01,083762,Bach; Quang Tran,1,0,30,29
1657536580927,MATH 20D,A01,083765,Tran; Brian Kha,5,0,30,25
1657536580927,MATH 20D,A02,083766,Tran; Brian Kha,5,0,30,25
1657536580927,MATH 20D,A03,083767,Tran; Brian Kha,5,0,30,25
1657536586952,MATH 20E,A01,083771,Ganguly; Soumya,9,0,32,23
1657536586952,MATH 20E,A02,083772,Ganguly; Soumya,6,0,32,26
1657536586952,MATH 20E,B01,083773,Ciotti; Benjamin,20,0,35,15
1657536586952,MATH 20E,B02,083774,Ciotti; Benjamin,17,0,35,18
1657536592978,MATH 103A,A01,083777,Greenfeld; Be'Eri,3,0,36,33
1657536592978,MATH 103A,A02,083778,Greenfeld; Be'Eri,5,0,36,31
1657536592978,MATH 103A,A03,093561,Greenfeld; Be'Eri,5,0,36,31
1657536592978,MATH 103A,B01,083779,Greenfeld; Be'Eri,7,0,36,29
1657536592978,MATH 103A,B02,083780,Greenfeld; Be'Eri,4,0,36,32
1657536592978,MATH 103A,B03,093562,Greenfeld; Be'Eri,3,0,36,33
1657536599001,MATH 105,A01,085443,Carter; Anne Toulson,15,0,35,20
1657536599001,MATH 105,A02,093477,Carter; Anne Toulson,20,0,35,15
1657536605028,MATH 109,A01,083213,Ganzberger; Geoffrey Michael,2,0,34,32
1657536605028,MATH 109,A02,083214,Ganzberger; Geoffrey Michael,4,0,34,30
1657536605028,MATH 109,A03,093478,Ganzberger; Geoffrey Michael,2,0,34,32
1657536605028,MATH 109,B01,083215,Ganzberger; Geoffrey Michael,1,0,32,31
1657536605028,MATH 109,B02,083216,Ganzberger; Geoffrey Michael,2,0,32,30
1657536605028,MATH 109,B03,093479,Ganzberger; Geoffrey Michael,8,0,32,24
1657536611060,MATH 142A,A01,083219,Chow; Bennett,7,0,32,25
1657536611060,MATH 142A,A02,083220,Chow; Bennett,10,0,32,22
1657536611060,MATH 142A,A03,093480,Chow; Bennett,8,0,32,24
1657536611060,MATH 142A,B03,093481,Chow; Bennett,8,0,32,24
1657536611060,MATH 142A,B04,093558,Chow; Bennett,13,0,32,19
1657536611060,MATH 142A,B05,093559,Chow; Bennett,6,0,32,26
1657536617088,MATH 193A,A01,083224,Rotar; Vladimir,8,0,34,26
1657536617088,MATH 193A,A02,083225,Rotar; Vladimir,9,0,34,25
1657536617088,MATH 193A,A03,083781,Rotar; Vladimir,5,0,34,29
1657536617088,MATH 193A,A04,083782,Rotar; Vladimir,10,0,34,24
1657536617088,MATH 193A,A05,093482,Rotar; Vladimir,10,0,34,24
1657536623113,MATH 197,001,091859,McAuley; Julian John,9999,0,9999,0
1657536623113,MATH 197,002,095566,Kedlaya; Kiran S.,9997,0,9999,2
1657536623113,MATH 197,003,095567,Xiao; Ming,9999,0,9999,0
1657536623113,MATH 197,004,095571,Perols; Johan Lars,9998,0,9999,1
1657536630187,COGS 9,A01,083615,Shannon; Kyle Michael,9,0,75,66
1657536636213,COGS 11,A01,083617,Boyle; Mary E. T.,22,0,48,26
1657536642238,COGS 13,A01,083071,Bastos; Amalia Pinkusfeld,11,0,71,60
1657536648267,COGS 14A,A01,092681,Semenuks; Arturs,5,1,100,95
1657536654296,COGS 14B,A01,083073,Cheng; Tzu-Han,6,0,63,57
1657536660327,COGS 17,A01,092677,Semenuks; Arturs,6,0,81,75
1657536666351,COGS 100,A01,083619,Allen; Michael Gordon,17,0,70,53
1657536672374,COGS 101A,A01,083621,Davis; Joshua Daniel,9,0,68,59
1657536678399,COGS 101B,A01,091572,Allen; Michael Gordon,12,0,65,53
1657536684424,COGS 101C,A01,083625,Delgado; Tania,17,0,35,18
1657536690449,COGS 107A,A01,083627,Boyle; Mary E. T.,13,0,60,47
1657536696476,COGS 118A,A01,083075,Gupta; Anjum,21,0,76,55
1657536702502,CSE 3,A50,083646,Miranda; Gregory Joseph,24,0,50,26
1657536719323,CSE 8A,A50,083650,Miranda; Gregory Joseph,17,1,56,39
1657536725347,CSE 11,A01,083080,Cao; Yingjun,6,15,40,34
1657536739367,CSE 12,A01,083652,Krause-Levy; Sophia Louisa,28,1,120,92
1657536745397,CSE 15L,A01,083654,Morris; Justin Loren,9,0,50,41
1657536745397,CSE 15L,A02,083655,Morris; Justin Loren,9,0,50,41
1657536751494,CSE 20,A01,083657,Tran; Khoa Dang,39,0,80,41
1657536757533,CSE 21,A01,095574,Bach; Quang Tran,22,0,48,26
1657536763566,CSE 30,A01,083084,Eldon; John,5,0,80,75
1657536763566,CSE 30,B01,095061,Bhaskar; Nishant,9,0,50,41
1657536769595,CSE 100,A01,083659,Cao; Yingjun,5,4,70,65
1657536775624,CSE 134B,A01,083661,Powell; Thomas Allan,22,0,100,78
1657536781648,CSE 140,A01,083663,Gungor; Onat,15,0,85,70
1657536787676,CSE 140L,A01,083088,Eldon; John,21,0,100,79
1657536793701,CSE 175,A01,083665,Kumar; Rakesh,3,0,25,22
1657536799733,CSE 190,A00,092507,Dubnov; Shlomo,8,0,20,12
1657536805768,ECE 45,A01,083139,Congero; Spencer William,6,0,75,69
1657536811800,ECE 65,A50,083695,Saad; Andrew S,12,0,30,18
1657536811800,ECE 65,A51,095125,Saad; Andrew S,24,0,26,2
1657536817825,ECE 109,A01,091882,Touri; Behrouz,19,0,70,51
1657536823849,ECE 180,A00,083140,Abi Samra; Nicholas Camill,1,0,30,29
1657536823849,ECE 180,B00,083141,Abi Samra; Nicholas Camill,0,0,30,30
1657536829884,MATH 10A,A01,083735,Patchell; Gregory David,2,0,30,28
1657536829884,MATH 10A,A02,083736,Patchell; Gregory David,20,0,30,10
1657536829884,MATH 10A,A03,083737,Patchell; Gregory David,16,0,30,14
1657536835920,MATH 10B,A01,083207,Lim; Seonhee,8,0,34,26
1657536835920,MATH 10B,A02,083208,Lim; Seonhee,9,0,35,26
1657536835920,MATH 10B,A03,093472,Lim; Seonhee,7,0,34,27
1657536835920,MATH 10B,B01,083739,Sinha; Shubham,12,0,30,18
1657536841949,MATH 18,A01,083743,Cinel; Cameron Alexander,7,0,30,23
1657536841949,MATH 18,A02,083744,Cinel; Cameron Alexander,17,0,30,13
1657536841949,MATH 18,A03,083745,Cinel; Cameron Alexander,9,0,30,21
1657536841949,MATH 18,B01,083748,Rideout; David Porter,5,0,37,32
1657536841949,MATH 18,B02,083749,Rideout; David Porter,5,0,36,31
1657536841949,MATH 18,B03,083750,Rideout; David Porter,3,0,37,34
1657536841949,MATH 18,B04,083751,Rideout; David Porter,6,0,36,30
1657536841949,MATH 18,B05,093473,Rideout; David Porter,6,0,36,30
1657536841949,MATH 18,B06,093474,Rideout; David Porter,6,0,36,30
1657536847980,MATH 20A,A01,083754,Zheng; Zequn,14,0,40,26
1657536854007,MATH 20B,A01,083756,Briones; Jor-el Thomas Caparas,4,0,36,32
1657536854007,MATH 20B,A02,083757,Briones; Jor-el Thomas Caparas,1,0,36,35
1657536854007,MATH 20B,A03,093475,Briones; Jor-el Thomas Caparas,2,0,36,34
1657536860040,MATH 20C,A01,083760,Briones; Jor-el Thomas Caparas,1,0,35,34
1657536860040,MATH 20C,A02,083761,Briones; Jor-el Thomas Caparas,8,0,35,27
1657536860040,MATH 20C,A03,093476,Briones; Jor-el Thomas Caparas,0,1,36,36
1657536860040,MATH 20C,B01,083762,Bach; Quang Tran,1,0,30,29
1657536866069,MATH 20D,A01,083765,Tran; Brian Kha,5,0,30,25
1657536866069,MATH 20D,A02,083766,Tran; Brian Kha,5,0,30,25
1657536866069,MATH 20D,A03,083767,Tran; Brian Kha,5,0,30,25
1657536872097,MATH 20E,A01,083771,Ganguly; Soumya,9,0,32,23
1657536872097,MATH 20E,A02,083772,Ganguly; Soumya,6,0,32,26
1657536872097,MATH 20E,B01,083773,Ciotti; Benjamin,20,0,35,15
1657536872097,MATH 20E,B02,083774,Ciotti; Benjamin,17,0,35,18
1657536878126,MATH 103A,A01,083777,Greenfeld; Be'Eri,3,0,36,33
1657536878126,MATH 103A,A02,083778,Greenfeld; Be'Eri,5,0,36,31
1657536878126,MATH 103A,A03,093561,Greenfeld; Be'Eri,5,0,36,31
1657536878126,MATH 103A,B01,083779,Greenfeld; Be'Eri,7,0,36,29
1657536878126,MATH 103A,B02,083780,Greenfeld; Be'Eri,4,0,36,32
1657536878126,MATH 103A,B03,093562,Greenfeld; Be'Eri,3,0,36,33
1657536884154,MATH 105,A01,085443,Carter; Anne Toulson,15,0,35,20
1657536884154,MATH 105,A02,093477,Carter; Anne Toulson,20,0,35,15
1657536890179,MATH 109,A01,083213,Ganzberger; Geoffrey Michael,2,0,34,32
1657536890179,MATH 109,A02,083214,Ganzberger; Geoffrey Michael,4,0,34,30
1657536890179,MATH 109,A03,093478,Ganzberger; Geoffrey Michael,2,0,34,32
1657536890179,MATH 109,B01,083215,Ganzberger; Geoffrey Michael,1,0,32,31
1657536890179,MATH 109,B02,083216,Ganzberger; Geoffrey Michael,2,0,32,30
1657536890179,MATH 109,B03,093479,Ganzberger; Geoffrey Michael,8,0,32,24
1657536896218,MATH 142A,A01,083219,Chow; Bennett,7,0,32,25
1657536896218,MATH 142A,A02,083220,Chow; Bennett,10,0,32,22
1657536896218,MATH 142A,A03,093480,Chow; Bennett,8,0,32,24
1657536896218,MATH 142A,B03,093481,Chow; Bennett,8,0,32,24
1657536896218,MATH 142A,B04,093558,Chow; Bennett,13,0,32,19
1657536896218,MATH 142A,B05,093559,Chow; Bennett,6,0,32,26
1657536902244,MATH 193A,A01,083224,Rotar; Vladimir,8,0,34,26
1657536902244,MATH 193A,A02,083225,Rotar; Vladimir,9,0,34,25
1657536902244,MATH 193A,A03,083781,Rotar; Vladimir,5,0,34,29
1657536902244,MATH 193A,A04,083782,Rotar; Vladimir,10,0,34,24
1657536902244,MATH 193A,A05,093482,Rotar; Vladimir,10,0,34,24
1657536908275,MATH 197,001,091859,McAuley; Julian John,9999,0,9999,0
1657536908275,MATH 197,002,095566,Kedlaya; Kiran S.,9997,0,9999,2
1657536908275,MATH 197,003,095567,Xiao; Ming,9999,0,9999,0
1657536908275,MATH 197,004,095571,Perols; Johan Lars,9998,0,9999,1
1657536915353,COGS 9,A01,083615,Shannon; Kyle Michael,9,0,75,66
1657536921384,COGS 11,A01,083617,Boyle; Mary E. T.,22,0,48,26
1657536927410,COGS 13,A01,083071,Bastos; Amalia Pinkusfeld,11,0,71,60
1657536933441,COGS 14A,A01,092681,Semenuks; Arturs,5,1,100,95
1657536939464,COGS 14B,A01,083073,Cheng; Tzu-Han,6,0,63,57
1657536945494,COGS 17,A01,092677,Semenuks; Arturs,6,0,81,75
1657536951523,COGS 100,A01,083619,Allen; Michael Gordon,17,0,70,53
1657536957554,COGS 101A,A01,083621,Davis; Joshua Daniel,9,0,68,59
1657536963579,COGS 101B,A01,091572,Allen; Michael Gordon,12,0,65,53
1657536969604,COGS 101C,A01,083625,Delgado; Tania,17,0,35,18
1657536975631,COGS 107A,A01,083627,Boyle; Mary E. T.,13,0,60,47
1657536981661,COGS 118A,A01,083075,Gupta; Anjum,21,0,76,55
1657536987687,CSE 3,A50,083646,Miranda; Gregory Joseph,24,0,50,26
1657536993716,CSE 8A,A50,083650,Miranda; Gregory Joseph,17,1,56,39
1657536999740,CSE 11,A01,083080,Cao; Yingjun,6,15,40,34
1657537005771,CSE 12,A01,083652,Krause-Levy; Sophia Louisa,28,1,120,92
1657537011800,CSE 15L,A01,083654,Morris; Justin Loren,9,0,50,41
1657537011800,CSE 15L,A02,083655,Morris; Justin Loren,9,0,50,41
1657537017826,CSE 20,A01,083657,Tran; Khoa Dang,39,0,80,41
1657537023852,CSE 21,A01,095574,Bach; Quang Tran,22,0,48,26
1657537029876,CSE 30,A01,083084,Eldon; John,5,0,80,75
1657537029876,CSE 30,B01,095061,Bhaskar; Nishant,9,0,50,41
1657537035907,CSE 100,A01,083659,Cao; Yingjun,5,4,70,65
1657537041935,CSE 134B,A01,083661,Powell; Thomas Allan,22,0,100,78
1657537047959,CSE 140,A01,083663,Gungor; Onat,15,0,85,70
1657537053988,CSE 140L,A01,083088,Eldon; John,21,0,100,79
1657537060016,CSE 175,A01,083665,Kumar; Rakesh,3,0,25,22
1657537066046,CSE 190,A00,092507,Dubnov; Shlomo,8,0,20,12
1657537072072,ECE 45,A01,083139,Congero; Spencer William,6,0,75,69
1657537078101,ECE 65,A50,083695,Saad; Andrew S,12,0,30,18
1657537078101,ECE 65,A51,095125,Saad; Andrew S,24,0,26,2
1657537084126,ECE 109,A01,091882,Touri; Behrouz,19,0,70,51
1657537090150,ECE 180,A00,083140,Abi Samra; Nicholas Camill,1,0,30,29
1657537090150,ECE 180,B00,083141,Abi Samra; Nicholas Camill,0,0,30,30
1657537096177,MATH 10A,A01,083735,Patchell; Gregory David,2,0,30,28
1657537096177,MATH 10A,A02,083736,Patchell; Gregory David,20,0,30,10
1657537096177,MATH 10A,A03,083737,Patchell; Gregory David,16,0,30,14
1657537102215,MATH 10B,A01,083207,Lim; Seonhee,8,0,34,26
1657537102215,MATH 10B,A02,083208,Lim; Seonhee,9,0,35,26
1657537102215,MATH 10B,A03,093472,Lim; Seonhee,7,0,34,27
1657537102215,MATH 10B,B01,083739,Sinha; Shubham,12,0,30,18
1657537108254,MATH 18,A01,083743,Cinel; Cameron Alexander,7,0,30,23
1657537108254,MATH 18,A02,083744,Cinel; Cameron Alexander,17,0,30,13
1657537108254,MATH 18,A03,083745,Cinel; Cameron Alexander,9,0,30,21
1657537108254,MATH 18,B01,083748,Rideout; David Porter,5,0,37,32
1657537108254,MATH 18,B02,083749,Rideout; David Porter,5,0,36,31
1657537108254,MATH 18,B03,083750,Rideout; David Porter,3,0,37,34
1657537108254,MATH 18,B04,083751,Rideout; David Porter,6,0,36,30
1657537108254,MATH 18,B05,093473,Rideout; David Porter,6,0,36,30
1657537108254,MATH 18,B06,093474,Rideout; David Porter,6,0,36,30
1657537114286,MATH 20A,A01,083754,Zheng; Zequn,14,0,40,26
1657537120313,MATH 20B,A01,083756,Briones; Jor-el Thomas Caparas,4,0,36,32
1657537120313,MATH 20B,A02,083757,Briones; Jor-el Thomas Caparas,1,0,36,35
1657537120313,MATH 20B,A03,093475,Briones; Jor-el Thomas Caparas,2,0,36,34
1657537126340,MATH 20C,A01,083760,Briones; Jor-el Thomas Caparas,1,0,35,34
1657537126340,MATH 20C,A02,083761,Briones; Jor-el Thomas Caparas,8,0,35,27
1657537126340,MATH 20C,A03,093476,Briones; Jor-el Thomas Caparas,0,1,36,36
1657537126340,MATH 20C,B01,083762,Bach; Quang Tran,1,0,30,29
1657537132365,MATH 20D,A01,083765,Tran; Brian Kha,5,0,30,25
1657537132365,MATH 20D,A02,083766,Tran; Brian Kha,5,0,30,25
1657537132365,MATH 20D,A03,083767,Tran; Brian Kha,5,0,30,25
1657537138391,MATH 20E,A01,083771,Ganguly; Soumya,9,0,32,23
1657537138391,MATH 20E,A02,083772,Ganguly; Soumya,6,0,32,26
1657537138391,MATH 20E,B01,083773,Ciotti; Benjamin,20,0,35,15
1657537138391,MATH 20E,B02,083774,Ciotti; Benjamin,17,0,35,18
1657537144427,MATH 103A,A01,083777,Greenfeld; Be'Eri,3,0,36,33
1657537144427,MATH 103A,A02,083778,Greenfeld; Be'Eri,5,0,36,31
1657537144427,MATH 103A,A03,093561,Greenfeld; Be'Eri,5,0,36,31
1657537144427,MATH 103A,B01,083779,Greenfeld; Be'Eri,7,0,36,29
1657537144427,MATH 103A,B02,083780,Greenfeld; Be'Eri,4,0,36,32
1657537144427,MATH 103A,B03,093562,Greenfeld; Be'Eri,3,0,36,33
1657537150459,MATH 105,A01,085443,Carter; Anne Toulson,15,0,35,20
1657537150459,MATH 105,A02,093477,Carter; Anne Toulson,20,0,35,15
1657537156507,MATH 109,A01,083213,Ganzberger; Geoffrey Michael,2,0,34,32
1657537156507,MATH 109,A02,083214,Ganzberger; Geoffrey Michael,4,0,34,30
1657537156507,MATH 109,A03,093478,Ganzberger; Geoffrey Michael,2,0,34,32
1657537156507,MATH 109,B01,083215,Ganzberger; Geoffrey Michael,1,0,32,31
1657537156507,MATH 109,B02,083216,Ganzberger; Geoffrey Michael,2,0,32,30
1657537156507,MATH 109,B03,093479,Ganzberger; Geoffrey Michael,8,0,32,24
1657537162546,MATH 142A,A01,083219,Chow; Bennett,7,0,32,25
1657537162546,MATH 142A,A02,083220,Chow; Bennett,10,0,32,22
1657537162546,MATH 142A,A03,093480,Chow; Bennett,8,0,32,24
1657537162546,MATH 142A,B03,093481,Chow; Bennett,8,0,32,24
1657537162546,MATH 142A,B04,093558,Chow; Bennett,13,0,32,19
1657537162546,MATH 142A,B05,093559,Chow; Bennett,6,0,32,26
1657537168572,MATH 193A,A01,083224,Rotar; Vladimir,8,0,34,26
1657537168572,MATH 193A,A02,083225,Rotar; Vladimir,9,0,34,25
1657537168572,MATH 193A,A03,083781,Rotar; Vladimir,5,0,34,29
1657537168572,MATH 193A,A04,083782,Rotar; Vladimir,10,0,34,24
1657537168572,MATH 193A,A05,093482,Rotar; Vladimir,10,0,34,24
1657537174597,MATH 197,001,091859,McAuley; Julian John,9999,0,9999,0
1657537174597,MATH 197,002,095566,Kedlaya; Kiran S.,9997,0,9999,2
1657537174597,MATH 197,003,095567,Xiao; Ming,9999,0,9999,0
1657537174597,MATH 197,004,095571,Perols; Johan Lars,9998,0,9999,1
1657537181667,COGS 9,A01,083615,Shannon; Kyle Michael,9,0,75,66
1657537187691,COGS 11,A01,083617,Boyle; Mary E. T.,22,0,48,26
1657537193721,COGS 13,A01,083071,Bastos; Amalia Pinkusfeld,11,0,71,60
1657537199751,COGS 14A,A01,092681,Semenuks; Arturs,5,1,100,95
1657537205776,COGS 14B,A01,083073,Cheng; Tzu-Han,6,0,63,57
1657537211799,COGS 17,A01,092677,Semenuks; Arturs,6,0,81,75
1657537217842,COGS 100,A01,083619,Allen; Michael Gordon,17,0,70,53
1657537223868,COGS 101A,A01,083621,Davis; Joshua Daniel,9,0,68,59
1657537229895,COGS 101B,A01,091572,Allen; Michael Gordon,12,0,65,53
1657537235920,COGS 101C,A01,083625,Delgado; Tania,17,0,35,18
1657537241949,COGS 107A,A01,083627,Boyle; Mary E. T.,13,0,60,47
1657537247974,COGS 118A,A01,083075,Gupta; Anjum,21,0,76,55
1657537254008,CSE 3,A50,083646,Miranda; Gregory Joseph,24,0,50,26
1657537260032,CSE 8A,A50,083650,Miranda; Gregory Joseph,17,1,56,39
1657537266058,CSE 11,A01,083080,Cao; Yingjun,6,15,40,34
1657537272089,CSE 12,A01,083652,Krause-Levy; Sophia Louisa,28,1,120,92
1657537278147,CSE 15L,A01,083654,Morris; Justin Loren,9,0,50,41
1657537278147,CSE 15L,A02,083655,Morris; Justin Loren,9,0,50,41
1657537284172,CSE 20,A01,083657,Tran; Khoa Dang,39,0,80,41
1657537290206,CSE 21,A01,095574,Bach; Quang Tran,22,0,48,26
1657537296238,CSE 30,A01,083084,Eldon; John,5,0,80,75
1657537296238,CSE 30,B01,095061,Bhaskar; Nishant,9,0,50,41
1657537302268,CSE 100,A01,083659,Cao; Yingjun,5,4,70,65
1657537308294,CSE 134B,A01,083661,Powell; Thomas Allan,22,0,100,78
1657537314322,CSE 140,A01,083663,Gungor; Onat,15,0,85,70
1657537320354,CSE 140L,A01,083088,Eldon; John,21,0,100,79
1657537326378,CSE 175,A01,083665,Kumar; Rakesh,3,0,25,22
1657537332404,CSE 190,A00,092507,Dubnov; Shlomo,8,0,20,12
1657537338431,ECE 45,A01,083139,Congero; Spencer William,6,0,75,69
1657537344456,ECE 65,A50,083695,Saad; Andrew S,12,0,30,18
1657537344456,ECE 65,A51,095125,Saad; Andrew S,24,0,26,2
1657537350559,ECE 109,A01,091882,Touri; Behrouz,19,0,70,51
1657537356589,ECE 180,A00,083140,Abi Samra; Nicholas Camill,1,0,30,29
1657537356589,ECE 180,B00,083141,Abi Samra; Nicholas Camill,0,0,30,30
1657537362624,MATH 10A,A01,083735,Patchell; Gregory David,2,0,30,28
1657537362624,MATH 10A,A02,083736,Patchell; Gregory David,20,0,30,10
1657537362624,MATH 10A,A03,083737,Patchell; Gregory David,16,0,30,14
1657537368660,MATH 10B,A01,083207,Lim; Seonhee,8,0,34,26
1657537368660,MATH 10B,A02,083208,Lim; Seonhee,9,0,35,26
1657537368660,MATH 10B,A03,093472,Lim; Seonhee,7,0,34,27
1657537368660,MATH 10B,B01,083739,Sinha; Shubham,12,0,30,18
1657537374775,MATH 18,A01,083743,Cinel; Cameron Alexander,7,0,30,23
1657537374775,MATH 18,A02,083744,Cinel; Cameron Alexander,17,0,30,13
1657537374775,MATH 18,A03,083745,Cinel; Cameron Alexander,9,0,30,21
1657537374775,MATH 18,B01,083748,Rideout; David Porter,5,0,37,32
1657537374775,MATH 18,B02,083749,Rideout; David Porter,5,0,36,31
1657537374775,MATH 18,B03,083750,Rideout; David Porter,3,0,37,34
1657537374775,MATH 18,B04,083751,Rideout; David Porter,6,0,36,30
1657537374775,MATH 18,B05,093473,Rideout; David Porter,6,0,36,30
1657537374775,MATH 18,B06,093474,Rideout; David Porter,6,0,36,30
1657537380803,MATH 20A,A01,083754,Zheng; Zequn,14,0,40,26
1657537386845,MATH 20B,A01,083756,Briones; Jor-el Thomas Caparas,4,0,36,32
1657537386845,MATH 20B,A02,083757,Briones; Jor-el Thomas Caparas,1,0,36,35
1657537386845,MATH 20B,A03,093475,Briones; Jor-el Thomas Caparas,2,0,36,34
1657537392879,MATH 20C,A01,083760,Briones; Jor-el Thomas Caparas,1,0,35,34
1657537392879,MATH 20C,A02,083761,Briones; Jor-el Thomas Caparas,8,0,35,27
1657537392879,MATH 20C,A03,093476,Briones; Jor-el Thomas Caparas,0,1,36,36
1657537392879,MATH 20C,B01,083762,Bach; Quang Tran,1,0,30,29
1657537398905,MATH 20D,A01,083765,Tran; Brian Kha,5,0,30,25
1657537398905,MATH 20D,A02,083766,Tran; Brian Kha,5,0,30,25
1657537398905,MATH 20D,A03,083767,Tran; Brian Kha,5,0,30,25
1657537404939,MATH 20E,A01,083771,Ganguly; Soumya,9,0,32,23
1657537404939,MATH 20E,A02,083772,Ganguly; Soumya,6,0,32,26
1657537404939,MATH 20E,B01,083773,Ciotti; Benjamin,20,0,35,15
1657537404939,MATH 20E,B02,083774,Ciotti; Benjamin,17,0,35,18
1657537410974,MATH 103A,A01,083777,Greenfeld; Be'Eri,3,0,36,33
1657537410974,MATH 103A,A02,083778,Greenfeld; Be'Eri,5,0,36,31
1657537410974,MATH 103A,A03,093561,Greenfeld; Be'Eri,5,0,36,31
1657537410974,MATH 103A,B01,083779,Greenfeld; Be'Eri,7,0,36,29
1657537410974,MATH 103A,B02,083780,Greenfeld; Be'Eri,4,0,36,32
1657537410974,MATH 103A,B03,093562,Greenfeld; Be'Eri,3,0,36,33
1657537416997,MATH 105,A01,085443,Carter; Anne Toulson,15,0,35,20
1657537416997,MATH 105,A02,093477,Carter; Anne Toulson,20,0,35,15
1657537423021,MATH 109,A01,083213,Ganzberger; Geoffrey Michael,2,0,34,32
1657537423021,MATH 109,A02,083214,Ganzberger; Geoffrey Michael,4,0,34,30
1657537423021,MATH 109,A03,093478,Ganzberger; Geoffrey Michael,2,0,34,32
1657537423021,MATH 109,B01,083215,Ganzberger; Geoffrey Michael,1,0,32,31
1657537423021,MATH 109,B02,083216,Ganzberger; Geoffrey Michael,2,0,32,30
1657537423021,MATH 109,B03,093479,Ganzberger; Geoffrey Michael,8,0,32,24
1657537429048,MATH 142A,A01,083219,Chow; Bennett,7,0,32,25
1657537429048,MATH 142A,A02,083220,Chow; Bennett,10,0,32,22
1657537429048,MATH 142A,A03,093480,Chow; Bennett,8,0,32,24
1657537429048,MATH 142A,B03,093481,Chow; Bennett,8,0,32,24
1657537429048,MATH 142A,B04,093558,Chow; Bennett,13,0,32,19
1657537429048,MATH 142A,B05,093559,Chow; Bennett,6,0,32,26
1657537435076,MATH 193A,A01,083224,Rotar; Vladimir,8,0,34,26
1657537435076,MATH 193A,A02,083225,Rotar; Vladimir,9,0,34,25
1657537435076,MATH 193A,A03,083781,Rotar; Vladimir,5,0,34,29
1657537435076,MATH 193A,A04,083782,Rotar; Vladimir,10,0,34,24
1657537435076,MATH 193A,A05,093482,Rotar; Vladimir,10,0,34,24
1657537441100,MATH 197,001,091859,McAuley; Julian John,9999,0,9999,0
1657537441100,MATH 197,002,095566,Kedlaya; Kiran S.,9997,0,9999,2
1657537441100,MATH 197,003,095567,Xiao; Ming,9999,0,9999,0
1657537441100,MATH 197,004,095571,Perols; Johan Lars,9998,0,9999,1
1657537448171,COGS 9,A01,083615,Shannon; Kyle Michael,9,0,75,66
1657537454196,COGS 11,A01,083617,Boyle; Mary E. T.,22,0,48,26
1657537460224,COGS 13,A01,083071,Bastos; Amalia Pinkusfeld,11,0,71,60
1657537466248,COGS 14A,A01,092681,Semenuks; Arturs,5,1,100,95
1657537472275,COGS 14B,A01,083073,Cheng; Tzu-Han,6,0,63,57
1657537478300,COGS 17,A01,092677,Semenuks; Arturs,6,0,81,75
1657537484327,COGS 100,A01,083619,Allen; Michael Gordon,17,0,70,53
1657537490350,COGS 101A,A01,083621,Davis; Joshua Daniel,9,0,68,59
1657537496374,COGS 101B,A01,091572,Allen; Michael Gordon,12,0,65,53
1657537502400,COGS 101C,A01,083625,Delgado; Tania,17,0,35,18
1657537508423,COGS 107A,A01,083627,Boyle; Mary E. T.,13,0,60,47
1657537514447,COGS 118A,A01,083075,Gupta; Anjum,21,0,76,55
1657537520472,CSE 3,A50,083646,Miranda; Gregory Joseph,24,0,50,26
1657537526496,CSE 8A,A50,083650,Miranda; Gregory Joseph,17,1,56,39
1657537532522,CSE 11,A01,083080,Cao; Yingjun,6,15,40,34
1657537538549,CSE 12,A01,083652,Krause-Levy; Sophia Louisa,28,1,120,92
1657537544574,CSE 15L,A01,083654,Morris; Justin Loren,9,0,50,41
1657537544574,CSE 15L,A02,083655,Morris; Justin Loren,9,0,50,41
1657537550606,CSE 20,A01,083657,Tran; Khoa Dang,39,0,80,41
1657537556635,CSE 21,A01,095574,Bach; Quang Tran,22,0,48,26
1657537562661,CSE 30,A01,083084,Eldon; John,5,0,80,75
1657537562661,CSE 30,B01,095061,Bhaskar; Nishant,9,0,50,41
1657537568685,CSE 100,A01,083659,Cao; Yingjun,5,4,70,65
1657537574713,CSE 134B,A01,083661,Powell; Thomas Allan,22,0,100,78
1657537580738,CSE 140,A01,083663,Gungor; Onat,15,0,85,70
1657537586764,CSE 140L,A01,083088,Eldon; John,21,0,100,79
1657537592793,CSE 175,A01,083665,Kumar; Rakesh,3,0,25,22
1657537598819,CSE 190,A00,092507,Dubnov; Shlomo,8,0,20,12
1657537604850,ECE 45,A01,083139,Congero; Spencer William,6,0,75,69
1657537610879,ECE 65,A50,083695,Saad; Andrew S,12,0,30,18
1657537610879,ECE 65,A51,095125,Saad; Andrew S,24,0,26,2
1657537616907,ECE 109,A01,091882,Touri; Behrouz,19,0,70,51
1657537622934,ECE 180,A00,083140,Abi Samra; Nicholas Camill,1,0,30,29
1657537622934,ECE 180,B00,083141,Abi Samra; Nicholas Camill,0,0,30,30
1657537628967,MATH 10A,A01,083735,Patchell; Gregory David,2,0,30,28
1657537628967,MATH 10A,A02,083736,Patchell; Gregory David,20,0,30,10
1657537628967,MATH 10A,A03,083737,Patchell; Gregory David,16,0,30,14
1657537634994,MATH 10B,A01,083207,Lim; Seonhee,8,0,34,26
1657537634994,MATH 10B,A02,083208,Lim; Seonhee,9,0,35,26
1657537634994,MATH 10B,A03,093472,Lim; Seonhee,7,0,34,27
1657537634994,MATH 10B,B01,083739,Sinha; Shubham,12,0,30,18
1657537641036,MATH 18,A01,083743,Cinel; Cameron Alexander,7,0,30,23
1657537641036,MATH 18,A02,083744,Cinel; Cameron Alexander,17,0,30,13
1657537641036,MATH 18,A03,083745,Cinel; Cameron Alexander,9,0,30,21
1657537641036,MATH 18,B01,083748,Rideout; David Porter,5,0,37,32
1657537641036,MATH 18,B02,083749,Rideout; David Porter,5,0,36,31
1657537641036,MATH 18,B03,083750,Rideout; David Porter,3,0,37,34
1657537641036,MATH 18,B04,083751,Rideout; David Porter,6,0,36,30
1657537641036,MATH 18,B05,093473,Rideout; David Porter,6,0,36,30
1657537641036,MATH 18,B06,093474,Rideout; David Porter,6,0,36,30
1657537647064,MATH 20A,A01,083754,Zheng; Zequn,14,0,40,26
1657537653095,MATH 20B,A01,083756,Briones; Jor-el Thomas Caparas,4,0,36,32
1657537653095,MATH 20B,A02,083757,Briones; Jor-el Thomas Caparas,1,0,36,35
1657537653095,MATH 20B,A03,093475,Briones; Jor-el Thomas Caparas,2,0,36,34
1657537659119,MATH 20C,A01,083760,Briones; Jor-el Thomas Caparas,1,0,35,34
1657537659119,MATH 20C,A02,083761,Briones; Jor-el Thomas Caparas,8,0,35,27
1657537659119,MATH 20C,A03,093476,Briones; Jor-el Thomas Caparas,0,1,36,36
1657537659119,MATH 20C,B01,083762,Bach; Quang Tran,1,0,30,29
1657537665145,MATH 20D,A01,083765,Tran; Brian Kha,5,0,30,25
1657537665145,MATH 20D,A02,083766,Tran; Brian Kha,5,0,30,25
1657537665145,MATH 20D,A03,083767,Tran; Brian Kha,5,0,30,25
1657537671182,MATH 20E,A01,083771,Ganguly; Soumya,9,0,32,23
1657537671182,MATH 20E,A02,083772,Ganguly; Soumya,6,0,32,26
1657537671182,MATH 20E,B01,083773,Ciotti; Benjamin,20,0,35,15
1657537671182,MATH 20E,B02,083774,Ciotti; Benjamin,17,0,35,18
1657537677208,MATH 103A,A01,083777,Greenfeld; Be'Eri,3,0,36,33
1657537677208,MATH 103A,A02,083778,Greenfeld; Be'Eri,5,0,36,31
1657537677208,MATH 103A,A03,093561,Greenfeld; Be'Eri,5,0,36,31
1657537677208,MATH 103A,B01,083779,Greenfeld; Be'Eri,7,0,36,29
1657537677208,MATH 103A,B02,083780,Greenfeld; Be'Eri,4,0,36,32
1657537677208,MATH 103A,B03,093562,Greenfeld; Be'Eri,3,0,36,33
1657537683232,MATH 105,A01,085443,Carter; Anne Toulson,15,0,35,20
1657537683232,MATH 105,A02,093477,Carter; Anne Toulson,20,0,35,15
1657537689257,MATH 109,A01,083213,Ganzberger; Geoffrey Michael,2,0,34,32
1657537689257,MATH 109,A02,083214,Ganzberger; Geoffrey Michael,4,0,34,30
1657537689257,MATH 109,A03,093478,Ganzberger; Geoffrey Michael,2,0,34,32
1657537689257,MATH 109,B01,083215,Ganzberger; Geoffrey Michael,1,0,32,31
1657537689257,MATH 109,B02,083216,Ganzberger; Geoffrey Michael,2,0,32,30
1657537689257,MATH 109,B03,093479,Ganzberger; Geoffrey Michael,8,0,32,24
1657537695282,MATH 142A,A01,083219,Chow; Bennett,7,0,32,25
1657537695282,MATH 142A,A02,083220,Chow; Bennett,10,0,32,22
1657537695282,MATH 142A,A03,093480,Chow; Bennett,8,0,32,24
1657537695282,MATH 142A,B03,093481,Chow; Bennett,8,0,32,24
1657537695282,MATH 142A,B04,093558,Chow; Bennett,13,0,32,19
1657537695282,MATH 142A,B05,093559,Chow; Bennett,6,0,32,26
1657537701313,MATH 193A,A01,083224,Rotar; Vladimir,8,0,34,26
1657537701313,MATH 193A,A02,083225,Rotar; Vladimir,9,0,34,25
1657537701313,MATH 193A,A03,083781,Rotar; Vladimir,5,0,34,29
1657537701313,MATH 193A,A04,083782,Rotar; Vladimir,10,0,34,24
1657537701313,MATH 193A,A05,093482,Rotar; Vladimir,10,0,34,24
1657537707340,MATH 197,001,091859,McAuley; Julian John,9999,0,9999,0
1657537707340,MATH 197,002,095566,Kedlaya; Kiran S.,9997,0,9999,2
1657537707340,MATH 197,003,095567,Xiao; Ming,9999,0,9999,0
1657537707340,MATH 197,004,095571,Perols; Johan Lars,9998,0,9999,1
1657537714397,COGS 9,A01,083615,Shannon; Kyle Michael,9,0,75,66
1657537720421,COGS 11,A01,083617,Boyle; Mary E. T.,22,0,48,26
1657537726446,COGS 13,A01,083071,Bastos; Amalia Pinkusfeld,11,0,71,60
1657537732470,COGS 14A,A01,092681,Semenuks; Arturs,5,1,100,95
1657537738500,COGS 14B,A01,083073,Cheng; Tzu-Han,6,0,63,57
1657537744525,COGS 17,A01,092677,Semenuks; Arturs,6,0,81,75
1657537750551,COGS 100,A01,083619,Allen; Michael Gordon,17,0,70,53
1657537756579,COGS 101A,A01,083621,Davis; Joshua Daniel,9,0,68,59
1657537762608,COGS 101B,A01,091572,Allen; Michael Gordon,12,0,65,53
1657537768635,COGS 101C,A01,083625,Delgado; Tania,17,0,35,18
1657537774659,COGS 107A,A01,083627,Boyle; Mary E. T.,13,0,60,47
1657537780683,COGS 118A,A01,083075,Gupta; Anjum,21,0,76,55
1657537786710,CSE 3,A50,083646,Miranda; Gregory Joseph,24,0,50,26
1657537792739,CSE 8A,A50,083650,Miranda; Gregory Joseph,17,1,56,39
1657537798763,CSE 11,A01,083080,Cao; Yingjun,6,15,40,34
1657537804789,CSE 12,A01,083652,Krause-Levy; Sophia Louisa,28,1,120,92
1657537810817,CSE 15L,A01,083654,Morris; Justin Loren,9,0,50,41
1657537810817,CSE 15L,A02,083655,Morris; Justin Loren,9,0,50,41
1657537816850,CSE 20,A01,083657,Tran; Khoa Dang,39,0,80,41
1657537822878,CSE 21,A01,095574,Bach; Quang Tran,22,0,48,26
1657537828904,CSE 30,A01,083084,Eldon; John,5,0,80,75
1657537828904,CSE 30,B01,095061,Bhaskar; Nishant,9,0,50,41
1657537834929,CSE 100,A01,083659,Cao; Yingjun,5,4,70,65
1657537840958,CSE 134B,A01,083661,Powell; Thomas Allan,22,0,100,78
1657537846982,CSE 140,A01,083663,Gungor; Onat,15,0,85,70
1657537853009,CSE 140L,A01,083088,Eldon; John,21,0,100,79
1657537859040,CSE 175,A01,083665,Kumar; Rakesh,3,0,25,22
1657537865065,CSE 190,A00,092507,Dubnov; Shlomo,8,0,20,12
1657537871091,ECE 45,A01,083139,Congero; Spencer William,6,0,75,69
1657537877123,ECE 65,A50,083695,Saad; Andrew S,12,0,30,18
1657537877123,ECE 65,A51,095125,Saad; Andrew S,24,0,26,2
1657537883146,ECE 109,A01,091882,Touri; Behrouz,19,0,70,51
1657537889176,ECE 180,A00,083140,Abi Samra; Nicholas Camill,1,0,30,29
1657537889176,ECE 180,B00,083141,Abi Samra; Nicholas Camill,0,0,30,30
1657537895200,MATH 10A,A01,083735,Patchell; Gregory David,2,0,30,28
1657537895200,MATH 10A,A02,083736,Patchell; Gregory David,20,0,30,10
1657537895200,MATH 10A,A03,083737,Patchell; Gregory David,16,0,30,14
1657537901228,MATH 10B,A01,083207,Lim; Seonhee,8,0,34,26
1657537901228,MATH 10B,A02,083208,Lim; Seonhee,9,0,35,26
1657537901228,MATH 10B,A03,093472,Lim; Seonhee,7,0,34,27
1657537901228,MATH 10B,B01,083739,Sinha; Shubham,12,0,30,18
1657537907257,MATH 18,A01,083743,Cinel; Cameron Alexander,7,0,30,23
1657537907257,MATH 18,A02,083744,Cinel; Cameron Alexander,17,0,30,13
1657537907257,MATH 18,A03,083745,Cinel; Cameron Alexander,9,0,30,21
1657537907257,MATH 18,B01,083748,Rideout; David Porter,5,0,37,32
1657537907257,MATH 18,B02,083749,Rideout; David Porter,5,0,36,31
1657537907257,MATH 18,B03,083750,Rideout; David Porter,3,0,37,34
1657537907257,MATH 18,B04,083751,Rideout; David Porter,6,0,36,30
1657537907257,MATH 18,B05,093473,Rideout; David Porter,6,0,36,30
1657537907257,MATH 18,B06,093474,Rideout; David Porter,6,0,36,30
1657537913285,MATH 20A,A01,083754,Zheng; Zequn,14,0,40,26
1657537919315,MATH 20B,A01,083756,Briones; Jor-el Thomas Caparas,4,0,36,32
1657537919315,MATH 20B,A02,083757,Briones; Jor-el Thomas Caparas,1,0,36,35
1657537919315,MATH 20B,A03,093475,Briones; Jor-el Thomas Caparas,2,0,36,34
1657537925339,MATH 20C,A01,083760,Briones; Jor-el Thomas Caparas,1,0,35,34
1657537925339,MATH 20C,A02,083761,Briones; Jor-el Thomas Caparas,8,0,35,27
1657537925339,MATH 20C,A03,093476,Briones; Jor-el Thomas Caparas,0,1,36,36
1657537925339,MATH 20C,B01,083762,Bach; Quang Tran,1,0,30,29
1657537931365,MATH 20D,A01,083765,Tran; Brian Kha,5,0,30,25
1657537931365,MATH 20D,A02,083766,Tran; Brian Kha,5,0,30,25
1657537931365,MATH 20D,A03,083767,Tran; Brian Kha,5,0,30,25
1657537937391,MATH 20E,A01,083771,Ganguly; Soumya,9,0,32,23
1657537937391,MATH 20E,A02,083772,Ganguly; Soumya,6,0,32,26
1657537937391,MATH 20E,B01,083773,Ciotti; Benjamin,20,0,35,15
1657537937391,MATH 20E,B02,083774,Ciotti; Benjamin,17,0,35,18
1657537943427,MATH 103A,A01,083777,Greenfeld; Be'Eri,3,0,36,33
1657537943427,MATH 103A,A02,083778,Greenfeld; Be'Eri,5,0,36,31
1657537943427,MATH 103A,A03,093561,Greenfeld; Be'Eri,5,0,36,31
1657537943427,MATH 103A,B01,083779,Greenfeld; Be'Eri,7,0,36,29
1657537943427,MATH 103A,B02,083780,Greenfeld; Be'Eri,4,0,36,32
1657537943427,MATH 103A,B03,093562,Greenfeld; Be'Eri,3,0,36,33
1657537949465,MATH 105,A01,085443,Carter; Anne Toulson,15,0,35,20
1657537949465,MATH 105,A02,093477,Carter; Anne Toulson,20,0,35,15
1657537955496,MATH 109,A01,083213,Ganzberger; Geoffrey Michael,2,0,34,32
1657537955496,MATH 109,A02,083214,Ganzberger; Geoffrey Michael,4,0,34,30
1657537955496,MATH 109,A03,093478,Ganzberger; Geoffrey Michael,2,0,34,32
1657537955496,MATH 109,B01,083215,Ganzberger; Geoffrey Michael,1,0,32,31
1657537955496,MATH 109,B02,083216,Ganzberger; Geoffrey Michael,2,0,32,30
1657537955496,MATH 109,B03,093479,Ganzberger; Geoffrey Michael,8,0,32,24
1657537961526,MATH 142A,A01,083219,Chow; Bennett,7,0,32,25
1657537961526,MATH 142A,A02,083220,Chow; Bennett,10,0,32,22
1657537961526,MATH 142A,A03,093480,Chow; Bennett,8,0,32,24
1657537961526,MATH 142A,B03,093481,Chow; Bennett,8,0,32,24
1657537961526,MATH 142A,B04,093558,Chow; Bennett,13,0,32,19
1657537961526,MATH 142A,B05,093559,Chow; Bennett,6,0,32,26
1657537967559,MATH 193A,A01,083224,Rotar; Vladimir,8,0,34,26
1657537967559,MATH 193A,A02,083225,Rotar; Vladimir,9,0,34,25
1657537967559,MATH 193A,A03,083781,Rotar; Vladimir,5,0,34,29
1657537967559,MATH 193A,A04,083782,Rotar; Vladimir,10,0,34,24
1657537967559,MATH 193A,A05,093482,Rotar; Vladimir,10,0,34,24
1657537973675,MATH 197,001,091859,McAuley; Julian John,9999,0,9999,0
1657537973675,MATH 197,002,095566,Kedlaya; Kiran S.,9997,0,9999,2
1657537973675,MATH 197,003,095567,Xiao; Ming,9999,0,9999,0
1657537973675,MATH 197,004,095571,Perols; Johan Lars,9998,0,9999,1
1657537980739,COGS 9,A01,083615,Shannon; Kyle Michael,9,0,75,66
1657537986778,COGS 11,A01,083617,Boyle; Mary E. T.,22,0,48,26
1657537992810,COGS 13,A01,083071,Bastos; Amalia Pinkusfeld,11,0,71,60
1657537998840,COGS 14A,A01,092681,Semenuks; Arturs,5,1,100,95
1657538004873,COGS 14B,A01,083073,Cheng; Tzu-Han,6,0,63,57
1657538010899,COGS 17,A01,092677,Semenuks; Arturs,6,0,81,75
1657538016925,COGS 100,A01,083619,Allen; Michael Gordon,17,0,70,53
1657538022948,COGS 101A,A01,083621,Davis; Joshua Daniel,9,0,68,59
1657538028972,COGS 101B,A01,091572,Allen; Michael Gordon,12,0,65,53
1657538035002,COGS 101C,A01,083625,Delgado; Tania,17,0,35,18
1657538041027,COGS 107A,A01,083627,Boyle; Mary E. T.,13,0,60,47
1657538047051,COGS 118A,A01,083075,Gupta; Anjum,21,0,76,55
1657538053083,CSE 3,A50,083646,Miranda; Gregory Joseph,24,0,50,26
1657538059119,CSE 8A,A50,083650,Miranda; Gregory Joseph,17,1,56,39
1657538065151,CSE 11,A01,083080,Cao; Yingjun,6,15,40,34
1657538071182,CSE 12,A01,083652,Krause-Levy; Sophia Louisa,28,1,120,92
1657538077206,CSE 15L,A01,083654,Morris; Justin Loren,9,0,50,41
1657538077206,CSE 15L,A02,083655,Morris; Justin Loren,9,0,50,41
1657538083231,CSE 20,A01,083657,Tran; Khoa Dang,39,0,80,41
1657538089255,CSE 21,A01,095574,Bach; Quang Tran,22,0,48,26
1657538095290,CSE 30,A01,083084,Eldon; John,5,0,80,75
1657538095290,CSE 30,B01,095061,Bhaskar; Nishant,9,0,50,41
1657538101313,CSE 100,A01,083659,Cao; Yingjun,5,4,70,65
1657538107338,CSE 134B,A01,083661,Powell; Thomas Allan,22,0,100,78
1657538113366,CSE 140,A01,083663,Gungor; Onat,15,0,85,70
1657538119391,CSE 140L,A01,083088,Eldon; John,21,0,100,79
1657538125417,CSE 175,A01,083665,Kumar; Rakesh,3,0,25,22
1657538131442,CSE 190,A00,092507,Dubnov; Shlomo,8,0,20,12
1657538137468,ECE 45,A01,083139,Congero; Spencer William,6,0,75,69
1657538143506,ECE 65,A50,083695,Saad; Andrew S,12,0,30,18
1657538143506,ECE 65,A51,095125,Saad; Andrew S,24,0,26,2
1657538149532,ECE 109,A01,091882,Touri; Behrouz,19,0,70,51
1657538155560,ECE 180,A00,083140,Abi Samra; Nicholas Camill,1,0,30,29
1657538155560,ECE 180,B00,083141,Abi Samra; Nicholas Camill,0,0,30,30
1657538161595,MATH 10A,A01,083735,Patchell; Gregory David,2,0,30,28
1657538161595,MATH 10A,A02,083736,Patchell; Gregory David,20,0,30,10
1657538161595,MATH 10A,A03,083737,Patchell; Gregory David,16,0,30,14
1657538167631,MATH 10B,A01,083207,Lim; Seonhee,8,0,34,26
1657538167631,MATH 10B,A02,083208,Lim; Seonhee,9,0,35,26
1657538167631,MATH 10B,A03,093472,Lim; Seonhee,7,0,34,27
1657538167631,MATH 10B,B01,083739,Sinha; Shubham,12,0,30,18
1657538173658,MATH 18,A01,083743,Cinel; Cameron Alexander,7,0,30,23
1657538173658,MATH 18,A02,083744,Cinel; Cameron Alexander,17,0,30,13
1657538173658,MATH 18,A03,083745,Cinel; Cameron Alexander,9,0,30,21
1657538173658,MATH 18,B01,083748,Rideout; David Porter,5,0,37,32
1657538173658,MATH 18,B02,083749,Rideout; David Porter,5,0,36,31
1657538173658,MATH 18,B03,083750,Rideout; David Porter,3,0,37,34
1657538173658,MATH 18,B04,083751,Rideout; David Porter,6,0,36,30
1657538173658,MATH 18,B05,093473,Rideout; David Porter,6,0,36,30
1657538173658,MATH 18,B06,093474,Rideout; David Porter,6,0,36,30
1657538179683,MATH 20A,A01,083754,Zheng; Zequn,14,0,40,26
1657538185706,MATH 20B,A01,083756,Briones; Jor-el Thomas Caparas,4,0,36,32
1657538185706,MATH 20B,A02,083757,Briones; Jor-el Thomas Caparas,1,0,36,35
1657538185706,MATH 20B,A03,093475,Briones; Jor-el Thomas Caparas,2,0,36,34
1657538191731,MATH 20C,A01,083760,Briones; Jor-el Thomas Caparas,1,0,35,34
1657538191731,MATH 20C,A02,083761,Briones; Jor-el Thomas Caparas,8,0,35,27
1657538191731,MATH 20C,A03,093476,Briones; Jor-el Thomas Caparas,0,1,36,36
1657538191731,MATH 20C,B01,083762,Bach; Quang Tran,1,0,30,29
1657538197755,MATH 20D,A01,083765,Tran; Brian Kha,5,0,30,25
1657538197755,MATH 20D,A02,083766,Tran; Brian Kha,5,0,30,25
1657538197755,MATH 20D,A03,083767,Tran; Brian Kha,5,0,30,25
1657538203789,MATH 20E,A01,083771,Ganguly; Soumya,9,0,32,23
1657538203789,MATH 20E,A02,083772,Ganguly; Soumya,6,0,32,26
1657538203789,MATH 20E,B01,083773,Ciotti; Benjamin,20,0,35,15
1657538203789,MATH 20E,B02,083774,Ciotti; Benjamin,17,0,35,18
1657538209817,MATH 103A,A01,083777,Greenfeld; Be'Eri,3,0,36,33
1657538209817,MATH 103A,A02,083778,Greenfeld; Be'Eri,5,0,36,31
1657538209817,MATH 103A,A03,093561,Greenfeld; Be'Eri,5,0,36,31
1657538209817,MATH 103A,B01,083779,Greenfeld; Be'Eri,7,0,36,29
1657538209817,MATH 103A,B02,083780,Greenfeld; Be'Eri,4,0,36,32
1657538209817,MATH 103A,B03,093562,Greenfeld; Be'Eri,3,0,36,33
1657538215840,MATH 105,A01,085443,Carter; Anne Toulson,15,0,35,20
1657538215840,MATH 105,A02,093477,Carter; Anne Toulson,20,0,35,15
1657538221868,MATH 109,A01,083213,Ganzberger; Geoffrey Michael,2,0,34,32
1657538221868,MATH 109,A02,083214,Ganzberger; Geoffrey Michael,4,0,34,30
1657538221868,MATH 109,A03,093478,Ganzberger; Geoffrey Michael,2,0,34,32
1657538221868,MATH 109,B01,083215,Ganzberger; Geoffrey Michael,1,0,32,31
1657538221868,MATH 109,B02,083216,Ganzberger; Geoffrey Michael,2,0,32,30
1657538221868,MATH 109,B03,093479,Ganzberger; Geoffrey Michael,8,0,32,24
1657538227899,MATH 142A,A01,083219,Chow; Bennett,7,0,32,25
1657538227899,MATH 142A,A02,083220,Chow; Bennett,10,0,32,22
1657538227899,MATH 142A,A03,093480,Chow; Bennett,8,0,32,24
1657538227899,MATH 142A,B03,093481,Chow; Bennett,8,0,32,24
1657538227899,MATH 142A,B04,093558,Chow; Bennett,13,0,32,19
1657538227899,MATH 142A,B05,093559,Chow; Bennett,6,0,32,26
1657538233930,MATH 193A,A01,083224,Rotar; Vladimir,8,0,34,26
1657538233930,MATH 193A,A02,083225,Rotar; Vladimir,9,0,34,25
1657538233930,MATH 193A,A03,083781,Rotar; Vladimir,5,0,34,29
1657538233930,MATH 193A,A04,083782,Rotar; Vladimir,10,0,34,24
1657538233930,MATH 193A,A05,093482,Rotar; Vladimir,10,0,34,24
1657538239952,MATH 197,001,091859,McAuley; Julian John,9999,0,9999,0
1657538239952,MATH 197,002,095566,Kedlaya; Kiran S.,9997,0,9999,2
1657538239952,MATH 197,003,095567,Xiao; Ming,9999,0,9999,0
1657538239952,MATH 197,004,095571,Perols; Johan Lars,9998,0,9999,1
1657538247021,COGS 9,A01,083615,Shannon; Kyle Michael,9,0,75,66
1657538253048,COGS 11,A01,083617,Boyle; Mary E. T.,22,0,48,26
1657538259073,COGS 13,A01,083071,Bastos; Amalia Pinkusfeld,11,0,71,60
1657538265097,COGS 14A,A01,092681,Semenuks; Arturs,5,1,100,95
