time,subj_course_id,sec_code,sec_id,prof,available,waitlist,total,enrolled_ct
1657625007759,COGS 9,A01,083615,Shannon; Kyle Michael,9,0,75,66
1657625013795,COGS 11,A01,083617,Boyle; Mary E. T.,23,0,48,25
1657625019834,COGS 13,A01,083071,Bastos; Amalia Pinkusfeld,11,0,71,60
1657625025871,COGS 14A,A01,092681,Semenuks; Arturs,5,1,100,95
1657625031906,COGS 14B,A01,083073,Cheng; Tzu-Han,6,0,63,57
1657625037942,COGS 17,A01,092677,Semenuks; Arturs,6,0,81,75
1657625043977,COGS 100,A01,083619,Allen; Michael Gordon,17,0,70,53
1657625050004,COGS 101A,A01,083621,Davis; Joshua Daniel,9,0,68,59
1657625056038,COGS 101B,A01,091572,Allen; Michael Gordon,12,0,65,53
1657625062069,COGS 101C,A01,083625,Delgado; Tania,17,0,35,18
1657625068098,COGS 107A,A01,083627,Boyle; Mary E. T.,13,0,60,47
1657625074129,COGS 118A,A01,083075,Gupta; Anjum,21,0,76,55
1657625080162,CSE 3,A50,083646,Miranda; Gregory Joseph,24,0,50,26
1657625086196,CSE 8A,A50,083650,Miranda; Gregory Joseph,17,1,56,39
1657625092231,CSE 11,A01,083080,Cao; Yingjun,6,15,40,34
1657625098264,CSE 12,A01,083652,Krause-Levy; Sophia Louisa,28,1,120,92
1657625104303,CSE 15L,A01,083654,Morris; Justin Loren,9,0,50,41
1657625104303,CSE 15L,A02,083655,Morris; Justin Loren,9,0,50,41
1657625110332,CSE 20,A01,083657,Tran; Khoa Dang,39,0,80,41
1657625116362,CSE 21,A01,095574,Bach; Quang Tran,22,0,48,26
1657625122406,CSE 30,A01,083084,Eldon; John,6,0,80,74
1657625122406,CSE 30,B01,095061,Bhaskar; Nishant,9,0,50,41
1657625128446,CSE 100,A01,083659,Cao; Yingjun,5,4,70,65
1657625134474,CSE 134B,A01,083661,Powell; Thomas Allan,22,0,100,78
1657625140503,CSE 140,A01,083663,Gungor; Onat,15,0,85,70
1657625146540,CSE 140L,A01,083088,Eldon; John,21,0,100,79
1657625152569,CSE 175,A01,083665,Kumar; Rakesh,3,0,25,22
1657625158601,CSE 190,A00,092507,Dubnov; Shlomo,8,0,20,12
1657625164632,ECE 45,A01,083139,Congero; Spencer William,6,0,75,69
1657625170670,ECE 65,A50,083695,Saad; Andrew S,12,0,30,18
1657625170670,ECE 65,A51,095125,Saad; Andrew S,24,0,26,2
1657625176703,ECE 109,A01,091882,Touri; Behrouz,19,0,70,51
1657625182734,ECE 180,A00,083140,Abi Samra; Nicholas Camill,1,0,30,29
1657625182734,ECE 180,B00,083141,Abi Samra; Nicholas Camill,0,0,30,30
1657625188773,MATH 10A,A01,083735,Patchell; Gregory David,2,0,30,28
1657625188773,MATH 10A,A02,083736,Patchell; Gregory David,20,0,30,10
1657625188773,MATH 10A,A03,083737,Patchell; Gregory David,16,0,30,14
1657625194806,MATH 10B,A01,083207,Lim; Seonhee,8,0,34,26
1657625194806,MATH 10B,A02,083208,Lim; Seonhee,9,0,35,26
1657625194806,MATH 10B,A03,093472,Lim; Seonhee,7,0,34,27
1657625194806,MATH 10B,B01,083739,Sinha; Shubham,12,0,30,18
1657625200839,MATH 18,A01,083743,Cinel; Cameron Alexander,7,0,30,23
1657625200839,MATH 18,A02,083744,Cinel; Cameron Alexander,17,0,30,13
1657625200839,MATH 18,A03,083745,Cinel; Cameron Alexander,9,0,30,21
1657625200839,MATH 18,B01,083748,Rideout; David Porter,5,0,37,32
1657625200839,MATH 18,B02,083749,Rideout; David Porter,5,0,36,31
1657625200839,MATH 18,B03,083750,Rideout; David Porter,3,0,37,34
1657625200839,MATH 18,B04,083751,Rideout; David Porter,6,0,36,30
1657625200839,MATH 18,B05,093473,Rideout; David Porter,6,0,36,30
1657625200839,MATH 18,B06,093474,Rideout; David Porter,6,0,36,30
1657625206874,MATH 20A,A01,083754,Zheng; Zequn,14,0,40,26
1657625212912,MATH 20B,A01,083756,Briones; Jor-el Thomas Caparas,4,0,36,32
1657625212912,MATH 20B,A02,083757,Briones; Jor-el Thomas Caparas,1,0,36,35
1657625212912,MATH 20B,A03,093475,Briones; Jor-el Thomas Caparas,2,0,36,34
1657625218957,MATH 20C,A01,083760,Briones; Jor-el Thomas Caparas,1,0,35,34
1657625218957,MATH 20C,A02,083761,Briones; Jor-el Thomas Caparas,8,0,35,27
1657625218957,MATH 20C,A03,093476,Briones; Jor-el Thomas Caparas,0,1,36,36
1657625218957,MATH 20C,B01,083762,Bach; Quang Tran,1,0,30,29
1657625224989,MATH 20D,A01,083765,Tran; Brian Kha,5,0,30,25
1657625224989,MATH 20D,A02,083766,Tran; Brian Kha,5,0,30,25
1657625224989,MATH 20D,A03,083767,Tran; Brian Kha,5,0,30,25
1657625231030,MATH 20E,A01,083771,Ganguly; Soumya,9,0,32,23
1657625231030,MATH 20E,A02,083772,Ganguly; Soumya,6,0,32,26
1657625231030,MATH 20E,B01,083773,Ciotti; Benjamin,20,0,35,15
1657625231030,MATH 20E,B02,083774,Ciotti; Benjamin,18,0,35,17
1657625237074,MATH 103A,A01,083777,Greenfeld; Be'Eri,3,0,36,33
1657625237074,MATH 103A,A02,083778,Greenfeld; Be'Eri,5,0,36,31
1657625237074,MATH 103A,A03,093561,Greenfeld; Be'Eri,6,0,36,30
1657625237074,MATH 103A,B01,083779,Greenfeld; Be'Eri,7,0,36,29
1657625237074,MATH 103A,B02,083780,Greenfeld; Be'Eri,4,0,36,32
1657625237074,MATH 103A,B03,093562,Greenfeld; Be'Eri,3,0,36,33
1657625243106,MATH 105,A01,085443,Carter; Anne Toulson,15,0,35,20
1657625243106,MATH 105,A02,093477,Carter; Anne Toulson,20,0,35,15
1657625249144,MATH 109,A01,083213,Ganzberger; Geoffrey Michael,2,0,34,32
1657625249144,MATH 109,A02,083214,Ganzberger; Geoffrey Michael,4,0,34,30
1657625249144,MATH 109,A03,093478,Ganzberger; Geoffrey Michael,2,0,34,32
1657625249144,MATH 109,B01,083215,Ganzberger; Geoffrey Michael,1,0,32,31
1657625249144,MATH 109,B02,083216,Ganzberger; Geoffrey Michael,2,0,32,30
1657625249144,MATH 109,B03,093479,Ganzberger; Geoffrey Michael,8,0,32,24
1657625255174,MATH 142A,A01,083219,Chow; Bennett,7,0,32,25
1657625255174,MATH 142A,A02,083220,Chow; Bennett,10,0,32,22
1657625255174,MATH 142A,A03,093480,Chow; Bennett,9,0,32,23
1657625255174,MATH 142A,B03,093481,Chow; Bennett,8,0,32,24
1657625255174,MATH 142A,B04,093558,Chow; Bennett,13,0,32,19
1657625255174,MATH 142A,B05,093559,Chow; Bennett,6,0,32,26
1657625261210,MATH 193A,A01,083224,Rotar; Vladimir,8,0,34,26
1657625261210,MATH 193A,A02,083225,Rotar; Vladimir,9,0,34,25
1657625261210,MATH 193A,A03,083781,Rotar; Vladimir,5,0,34,29
1657625261210,MATH 193A,A04,083782,Rotar; Vladimir,10,0,34,24
1657625261210,MATH 193A,A05,093482,Rotar; Vladimir,10,0,34,24
1657625267244,MATH 197,001,091859,McAuley; Julian John,9999,0,9999,0
1657625267244,MATH 197,002,095566,Kedlaya; Kiran S.,9997,0,9999,2
1657625267244,MATH 197,003,095567,Xiao; Ming,9999,0,9999,0
1657625267244,MATH 197,004,095571,Perols; Johan Lars,9998,0,9999,1
1657625274350,COGS 9,A01,083615,Shannon; Kyle Michael,9,0,75,66
1657625280380,COGS 11,A01,083617,Boyle; Mary E. T.,23,0,48,25
1657625286410,COGS 13,A01,083071,Bastos; Amalia Pinkusfeld,11,0,71,60
1657625292440,COGS 14A,A01,092681,Semenuks; Arturs,5,1,100,95
1657625298468,COGS 14B,A01,083073,Cheng; Tzu-Han,6,0,63,57
1657625312372,COGS 17,A01,092677,Semenuks; Arturs,6,0,81,75
1657625318407,COGS 100,A01,083619,Allen; Michael Gordon,17,0,70,53
1657625332518,COGS 101A,A01,083621,Davis; Joshua Daniel,9,0,68,59
1657625338550,COGS 101B,A01,091572,Allen; Michael Gordon,12,0,65,53
1657625344587,COGS 101C,A01,083625,Delgado; Tania,17,0,35,18
1657625350621,COGS 107A,A01,083627,Boyle; Mary E. T.,13,0,60,47
1657625356656,COGS 118A,A01,083075,Gupta; Anjum,21,0,76,55
1657625362691,CSE 3,A50,083646,Miranda; Gregory Joseph,24,0,50,26
1657625368731,CSE 8A,A50,083650,Miranda; Gregory Joseph,17,1,56,39
1657625374762,CSE 11,A01,083080,Cao; Yingjun,6,15,40,34
1657625380795,CSE 12,A01,083652,Krause-Levy; Sophia Louisa,28,1,120,92
1657625386828,CSE 15L,A01,083654,Morris; Justin Loren,9,0,50,41
1657625386828,CSE 15L,A02,083655,Morris; Justin Loren,9,0,50,41
1657625392855,CSE 20,A01,083657,Tran; Khoa Dang,39,0,80,41
1657625398884,CSE 21,A01,095574,Bach; Quang Tran,22,0,48,26
1657625404914,CSE 30,A01,083084,Eldon; John,6,0,80,74
1657625404914,CSE 30,B01,095061,Bhaskar; Nishant,9,0,50,41
1657625410942,CSE 100,A01,083659,Cao; Yingjun,5,4,70,65
1657625416970,CSE 134B,A01,083661,Powell; Thomas Allan,22,0,100,78
1657625422997,CSE 140,A01,083663,Gungor; Onat,15,0,85,70
1657625429037,CSE 140L,A01,083088,Eldon; John,21,0,100,79
1657625435073,CSE 175,A01,083665,Kumar; Rakesh,3,0,25,22
1657625441103,CSE 190,A00,092507,Dubnov; Shlomo,8,0,20,12
1657625447138,ECE 45,A01,083139,Congero; Spencer William,6,0,75,69
1657625453178,ECE 65,A50,083695,Saad; Andrew S,12,0,30,18
1657625453178,ECE 65,A51,095125,Saad; Andrew S,24,0,26,2
1657625459217,ECE 109,A01,091882,Touri; Behrouz,19,0,70,51
1657625465247,ECE 180,A00,083140,Abi Samra; Nicholas Camill,1,0,30,29
1657625465247,ECE 180,B00,083141,Abi Samra; Nicholas Camill,0,0,30,30
1657625471286,MATH 10A,A01,083735,Patchell; Gregory David,2,0,30,28
1657625471286,MATH 10A,A02,083736,Patchell; Gregory David,20,0,30,10
1657625471286,MATH 10A,A03,083737,Patchell; Gregory David,16,0,30,14
1657625477328,MATH 10B,A01,083207,Lim; Seonhee,8,0,34,26
1657625477328,MATH 10B,A02,083208,Lim; Seonhee,9,0,35,26
1657625477328,MATH 10B,A03,093472,Lim; Seonhee,7,0,34,27
1657625477328,MATH 10B,B01,083739,Sinha; Shubham,12,0,30,18
1657625483370,MATH 18,A01,083743,Cinel; Cameron Alexander,7,0,30,23
1657625483370,MATH 18,A02,083744,Cinel; Cameron Alexander,17,0,30,13
1657625483370,MATH 18,A03,083745,Cinel; Cameron Alexander,9,0,30,21
1657625483370,MATH 18,B01,083748,Rideout; David Porter,5,0,37,32
1657625483370,MATH 18,B02,083749,Rideout; David Porter,5,0,36,31
1657625483370,MATH 18,B03,083750,Rideout; David Porter,3,0,37,34
1657625483370,MATH 18,B04,083751,Rideout; David Porter,6,0,36,30
1657625483370,MATH 18,B05,093473,Rideout; David Porter,6,0,36,30
1657625483370,MATH 18,B06,093474,Rideout; David Porter,6,0,36,30
1657625489398,MATH 20A,A01,083754,Zheng; Zequn,14,0,40,26
1657625495427,MATH 20B,A01,083756,Briones; Jor-el Thomas Caparas,4,0,36,32
1657625495427,MATH 20B,A02,083757,Briones; Jor-el Thomas Caparas,1,0,36,35
1657625495427,MATH 20B,A03,093475,Briones; Jor-el Thomas Caparas,2,0,36,34
1657625501458,MATH 20C,A01,083760,Briones; Jor-el Thomas Caparas,1,0,35,34
1657625501458,MATH 20C,A02,083761,Briones; Jor-el Thomas Caparas,8,0,35,27
1657625501458,MATH 20C,A03,093476,Briones; Jor-el Thomas Caparas,0,1,36,36
1657625501458,MATH 20C,B01,083762,Bach; Quang Tran,1,0,30,29
1657625507488,MATH 20D,A01,083765,Tran; Brian Kha,5,0,30,25
1657625507488,MATH 20D,A02,083766,Tran; Brian Kha,5,0,30,25
1657625507488,MATH 20D,A03,083767,Tran; Brian Kha,5,0,30,25
1657625513528,MATH 20E,A01,083771,Ganguly; Soumya,9,0,32,23
1657625513528,MATH 20E,A02,083772,Ganguly; Soumya,6,0,32,26
1657625513528,MATH 20E,B01,083773,Ciotti; Benjamin,20,0,35,15
1657625513528,MATH 20E,B02,083774,Ciotti; Benjamin,18,0,35,17
1657625519568,MATH 103A,A01,083777,Greenfeld; Be'Eri,3,0,36,33
1657625519568,MATH 103A,A02,083778,Greenfeld; Be'Eri,5,0,36,31
1657625519568,MATH 103A,A03,093561,Greenfeld; Be'Eri,6,0,36,30
1657625519568,MATH 103A,B01,083779,Greenfeld; Be'Eri,7,0,36,29
1657625519568,MATH 103A,B02,083780,Greenfeld; Be'Eri,4,0,36,32
1657625519568,MATH 103A,B03,093562,Greenfeld; Be'Eri,3,0,36,33
1657625525599,MATH 105,A01,085443,Carter; Anne Toulson,15,0,35,20
1657625525599,MATH 105,A02,093477,Carter; Anne Toulson,20,0,35,15
1657625531634,MATH 109,A01,083213,Ganzberger; Geoffrey Michael,2,0,34,32
1657625531634,MATH 109,A02,083214,Ganzberger; Geoffrey Michael,4,0,34,30
1657625531634,MATH 109,A03,093478,Ganzberger; Geoffrey Michael,2,0,34,32
1657625531634,MATH 109,B01,083215,Ganzberger; Geoffrey Michael,1,0,32,31
1657625531634,MATH 109,B02,083216,Ganzberger; Geoffrey Michael,2,0,32,30
1657625531634,MATH 109,B03,093479,Ganzberger; Geoffrey Michael,8,0,32,24
1657625537715,MATH 142A,A01,083219,Chow; Bennett,7,0,32,25
1657625537715,MATH 142A,A02,083220,Chow; Bennett,10,0,32,22
1657625537715,MATH 142A,A03,093480,Chow; Bennett,9,0,32,23
1657625537715,MATH 142A,B03,093481,Chow; Bennett,8,0,32,24
1657625537715,MATH 142A,B04,093558,Chow; Bennett,13,0,32,19
1657625537715,MATH 142A,B05,093559,Chow; Bennett,6,0,32,26
1657625543746,MATH 193A,A01,083224,Rotar; Vladimir,8,0,34,26
1657625543746,MATH 193A,A02,083225,Rotar; Vladimir,9,0,34,25
1657625543746,MATH 193A,A03,083781,Rotar; Vladimir,5,0,34,29
1657625543746,MATH 193A,A04,083782,Rotar; Vladimir,10,0,34,24
1657625543746,MATH 193A,A05,093482,Rotar; Vladimir,10,0,34,24
1657625549778,MATH 197,001,091859,McAuley; Julian John,9999,0,9999,0
1657625549778,MATH 197,002,095566,Kedlaya; Kiran S.,9997,0,9999,2
1657625549778,MATH 197,003,095567,Xiao; Ming,9999,0,9999,0
1657625549778,MATH 197,004,095571,Perols; Johan Lars,9998,0,9999,1
1657625556859,COGS 9,A01,083615,Shannon; Kyle Michael,9,0,75,66
1657625562889,COGS 11,A01,083617,Boyle; Mary E. T.,23,0,48,25
1657625568924,COGS 13,A01,083071,Bastos; Amalia Pinkusfeld,11,0,71,60
1657625574963,COGS 14A,A01,092681,Semenuks; Arturs,5,1,100,95
1657625580993,COGS 14B,A01,083073,Cheng; Tzu-Han,6,0,63,57
1657625587029,COGS 17,A01,092677,Semenuks; Arturs,6,0,81,75
1657625593068,COGS 100,A01,083619,Allen; Michael Gordon,17,0,70,53
1657625599178,COGS 101A,A01,083621,Davis; Joshua Daniel,9,0,68,59
1657625605213,COGS 101B,A01,091572,Allen; Michael Gordon,12,0,65,53
1657625611238,COGS 101C,A01,083625,Delgado; Tania,17,0,35,18
1657625617279,COGS 107A,A01,083627,Boyle; Mary E. T.,13,0,60,47
1657625623313,COGS 118A,A01,083075,Gupta; Anjum,21,0,76,55
1657625629344,CSE 3,A50,083646,Miranda; Gregory Joseph,24,0,50,26
1657625635370,CSE 8A,A50,083650,Miranda; Gregory Joseph,17,1,56,39
1657625641398,CSE 11,A01,083080,Cao; Yingjun,6,15,40,34
1657625647434,CSE 12,A01,083652,Krause-Levy; Sophia Louisa,28,1,120,92
1657625653466,CSE 15L,A01,083654,Morris; Justin Loren,9,0,50,41
1657625653466,CSE 15L,A02,083655,Morris; Justin Loren,9,0,50,41
1657625659498,CSE 20,A01,083657,Tran; Khoa Dang,39,0,80,41
1657625665527,CSE 21,A01,095574,Bach; Quang Tran,22,0,48,26
1657625671568,CSE 30,A01,083084,Eldon; John,6,0,80,74
1657625671568,CSE 30,B01,095061,Bhaskar; Nishant,9,0,50,41
1657625677594,CSE 100,A01,083659,Cao; Yingjun,5,4,70,65
1657625683619,CSE 134B,A01,083661,Powell; Thomas Allan,22,0,100,78
1657625689650,CSE 140,A01,083663,Gungor; Onat,15,0,85,70
1657625695681,CSE 140L,A01,083088,Eldon; John,21,0,100,79
1657625701728,CSE 175,A01,083665,Kumar; Rakesh,3,0,25,22
1657625707755,CSE 190,A00,092507,Dubnov; Shlomo,8,0,20,12
1657625713790,ECE 45,A01,083139,Congero; Spencer William,6,0,75,69
1657625719823,ECE 65,A50,083695,Saad; Andrew S,12,0,30,18
1657625719823,ECE 65,A51,095125,Saad; Andrew S,24,0,26,2
1657625725850,ECE 109,A01,091882,Touri; Behrouz,19,0,70,51
1657625731879,ECE 180,A00,083140,Abi Samra; Nicholas Camill,1,0,30,29
1657625731879,ECE 180,B00,083141,Abi Samra; Nicholas Camill,0,0,30,30
1657625737914,MATH 10A,A01,083735,Patchell; Gregory David,2,0,30,28
1657625737914,MATH 10A,A02,083736,Patchell; Gregory David,20,0,30,10
1657625737914,MATH 10A,A03,083737,Patchell; Gregory David,16,0,30,14
1657625743946,MATH 10B,A01,083207,Lim; Seonhee,8,0,34,26
1657625743946,MATH 10B,A02,083208,Lim; Seonhee,9,0,35,26
1657625743946,MATH 10B,A03,093472,Lim; Seonhee,7,0,34,27
1657625743946,MATH 10B,B01,083739,Sinha; Shubham,12,0,30,18
1657625749979,MATH 18,A01,083743,Cinel; Cameron Alexander,7,0,30,23
1657625749979,MATH 18,A02,083744,Cinel; Cameron Alexander,17,0,30,13
1657625749979,MATH 18,A03,083745,Cinel; Cameron Alexander,9,0,30,21
1657625749979,MATH 18,B01,083748,Rideout; David Porter,5,0,37,32
1657625749979,MATH 18,B02,083749,Rideout; David Porter,5,0,36,31
1657625749979,MATH 18,B03,083750,Rideout; David Porter,3,0,37,34
1657625749979,MATH 18,B04,083751,Rideout; David Porter,6,0,36,30
1657625749979,MATH 18,B05,093473,Rideout; David Porter,6,0,36,30
1657625749979,MATH 18,B06,093474,Rideout; David Porter,6,0,36,30
1657625756004,MATH 20A,A01,083754,Zheng; Zequn,14,0,40,26
1657625762037,MATH 20B,A01,083756,Briones; Jor-el Thomas Caparas,4,0,36,32
1657625762037,MATH 20B,A02,083757,Briones; Jor-el Thomas Caparas,1,0,36,35
1657625762037,MATH 20B,A03,093475,Briones; Jor-el Thomas Caparas,2,0,36,34
1657625768067,MATH 20C,A01,083760,Briones; Jor-el Thomas Caparas,1,0,35,34
1657625768067,MATH 20C,A02,083761,Briones; Jor-el Thomas Caparas,8,0,35,27
1657625768067,MATH 20C,A03,093476,Briones; Jor-el Thomas Caparas,0,1,36,36
1657625768067,MATH 20C,B01,083762,Bach; Quang Tran,1,0,30,29
1657625774107,MATH 20D,A01,083765,Tran; Brian Kha,5,0,30,25
1657625774107,MATH 20D,A02,083766,Tran; Brian Kha,5,0,30,25
1657625774107,MATH 20D,A03,083767,Tran; Brian Kha,5,0,30,25
1657625780135,MATH 20E,A01,083771,Ganguly; Soumya,9,0,32,23
1657625780135,MATH 20E,A02,083772,Ganguly; Soumya,6,0,32,26
1657625780135,MATH 20E,B01,083773,Ciotti; Benjamin,20,0,35,15
1657625780135,MATH 20E,B02,083774,Ciotti; Benjamin,18,0,35,17
1657625786164,MATH 103A,A01,083777,Greenfeld; Be'Eri,3,0,36,33
1657625786164,MATH 103A,A02,083778,Greenfeld; Be'Eri,5,0,36,31
1657625786164,MATH 103A,A03,093561,Greenfeld; Be'Eri,6,0,36,30
1657625786164,MATH 103A,B01,083779,Greenfeld; Be'Eri,7,0,36,29
1657625786164,MATH 103A,B02,083780,Greenfeld; Be'Eri,4,0,36,32
1657625786164,MATH 103A,B03,093562,Greenfeld; Be'Eri,3,0,36,33
1657625792191,MATH 105,A01,085443,Carter; Anne Toulson,15,0,35,20
1657625792191,MATH 105,A02,093477,Carter; Anne Toulson,20,0,35,15
1657625798226,MATH 109,A01,083213,Ganzberger; Geoffrey Michael,2,0,34,32
1657625798226,MATH 109,A02,083214,Ganzberger; Geoffrey Michael,4,0,34,30
1657625798226,MATH 109,A03,093478,Ganzberger; Geoffrey Michael,2,0,34,32
1657625798226,MATH 109,B01,083215,Ganzberger; Geoffrey Michael,1,0,32,31
1657625798226,MATH 109,B02,083216,Ganzberger; Geoffrey Michael,2,0,32,30
1657625798226,MATH 109,B03,093479,Ganzberger; Geoffrey Michael,8,0,32,24
1657625804268,MATH 142A,A01,083219,Chow; Bennett,7,0,32,25
1657625804268,MATH 142A,A02,083220,Chow; Bennett,10,0,32,22
1657625804268,MATH 142A,A03,093480,Chow; Bennett,9,0,32,23
1657625804268,MATH 142A,B03,093481,Chow; Bennett,8,0,32,24
1657625804268,MATH 142A,B04,093558,Chow; Bennett,13,0,32,19
1657625804268,MATH 142A,B05,093559,Chow; Bennett,6,0,32,26
1657625810294,MATH 193A,A01,083224,Rotar; Vladimir,8,0,34,26
1657625810294,MATH 193A,A02,083225,Rotar; Vladimir,9,0,34,25
1657625810294,MATH 193A,A03,083781,Rotar; Vladimir,5,0,34,29
1657625810294,MATH 193A,A04,083782,Rotar; Vladimir,10,0,34,24
1657625810294,MATH 193A,A05,093482,Rotar; Vladimir,10,0,34,24
1657625816323,MATH 197,001,091859,McAuley; Julian John,9999,0,9999,0
1657625816323,MATH 197,002,095566,Kedlaya; Kiran S.,9997,0,9999,2
1657625816323,MATH 197,003,095567,Xiao; Ming,9999,0,9999,0
1657625816323,MATH 197,004,095571,Perols; Johan Lars,9998,0,9999,1
1657625823407,COGS 9,A01,083615,Shannon; Kyle Michael,9,0,75,66
1657625829442,COGS 11,A01,083617,Boyle; Mary E. T.,23,0,48,25
1657625835474,COGS 13,A01,083071,Bastos; Amalia Pinkusfeld,11,0,71,60
1657625841502,COGS 14A,A01,092681,Semenuks; Arturs,5,1,100,95
1657625847528,COGS 14B,A01,083073,Cheng; Tzu-Han,6,0,63,57
1657625853557,COGS 17,A01,092677,Semenuks; Arturs,6,0,81,75
1657625859587,COGS 100,A01,083619,Allen; Michael Gordon,17,0,70,53
1657625865614,COGS 101A,A01,083621,Davis; Joshua Daniel,9,0,68,59
1657625871639,COGS 101B,A01,091572,Allen; Michael Gordon,12,0,65,53
1657625877666,COGS 101C,A01,083625,Delgado; Tania,17,0,35,18
1657625883695,COGS 107A,A01,083627,Boyle; Mary E. T.,13,0,60,47
1657625889726,COGS 118A,A01,083075,Gupta; Anjum,21,0,76,55
1657625895757,CSE 3,A50,083646,Miranda; Gregory Joseph,24,0,50,26
1657625901789,CSE 8A,A50,083650,Miranda; Gregory Joseph,17,1,56,39
1657625907822,CSE 11,A01,083080,Cao; Yingjun,6,15,40,34
1657625913854,CSE 12,A01,083652,Krause-Levy; Sophia Louisa,28,1,120,92
1657625919884,CSE 15L,A01,083654,Morris; Justin Loren,9,0,50,41
1657625919884,CSE 15L,A02,083655,Morris; Justin Loren,9,0,50,41
1657625925911,CSE 20,A01,083657,Tran; Khoa Dang,39,0,80,41
1657625931940,CSE 21,A01,095574,Bach; Quang Tran,22,0,48,26
1657625937973,CSE 30,A01,083084,Eldon; John,6,0,80,74
1657625937973,CSE 30,B01,095061,Bhaskar; Nishant,9,0,50,41
1657625944008,CSE 100,A01,083659,Cao; Yingjun,5,4,70,65
1657625950038,CSE 134B,A01,083661,Powell; Thomas Allan,22,0,100,78
1657625956065,CSE 140,A01,083663,Gungor; Onat,15,0,85,70
1657625962094,CSE 140L,A01,083088,Eldon; John,21,0,100,79
1657625968123,CSE 175,A01,083665,Kumar; Rakesh,3,0,25,22
1657625974151,CSE 190,A00,092507,Dubnov; Shlomo,8,0,20,12
1657625980177,ECE 45,A01,083139,Congero; Spencer William,6,0,75,69
1657625986212,ECE 65,A50,083695,Saad; Andrew S,12,0,30,18
1657625986212,ECE 65,A51,095125,Saad; Andrew S,24,0,26,2
1657625992243,ECE 109,A01,091882,Touri; Behrouz,19,0,70,51
1657625998271,ECE 180,A00,083140,Abi Samra; Nicholas Camill,1,0,30,29
1657625998271,ECE 180,B00,083141,Abi Samra; Nicholas Camill,0,0,30,30
1657626004302,MATH 10A,A01,083735,Patchell; Gregory David,2,0,30,28
1657626004302,MATH 10A,A02,083736,Patchell; Gregory David,20,0,30,10
1657626004302,MATH 10A,A03,083737,Patchell; Gregory David,16,0,30,14
1657626010332,MATH 10B,A01,083207,Lim; Seonhee,8,0,34,26
1657626010332,MATH 10B,A02,083208,Lim; Seonhee,9,0,35,26
1657626010332,MATH 10B,A03,093472,Lim; Seonhee,7,0,34,27
1657626010332,MATH 10B,B01,083739,Sinha; Shubham,12,0,30,18
1657626016363,MATH 18,A01,083743,Cinel; Cameron Alexander,7,0,30,23
1657626016363,MATH 18,A02,083744,Cinel; Cameron Alexander,17,0,30,13
1657626016363,MATH 18,A03,083745,Cinel; Cameron Alexander,9,0,30,21
1657626016363,MATH 18,B01,083748,Rideout; David Porter,5,0,37,32
1657626016363,MATH 18,B02,083749,Rideout; David Porter,5,0,36,31
1657626016363,MATH 18,B03,083750,Rideout; David Porter,3,0,37,34
1657626016363,MATH 18,B04,083751,Rideout; David Porter,6,0,36,30
1657626016363,MATH 18,B05,093473,Rideout; David Porter,6,0,36,30
1657626016363,MATH 18,B06,093474,Rideout; David Porter,6,0,36,30
1657626022396,MATH 20A,A01,083754,Zheng; Zequn,14,0,40,26
1657626028423,MATH 20B,A01,083756,Briones; Jor-el Thomas Caparas,4,0,36,32
1657626028423,MATH 20B,A02,083757,Briones; Jor-el Thomas Caparas,1,0,36,35
1657626028423,MATH 20B,A03,093475,Briones; Jor-el Thomas Caparas,2,0,36,34
1657626034457,MATH 20C,A01,083760,Briones; Jor-el Thomas Caparas,1,0,35,34
1657626034457,MATH 20C,A02,083761,Briones; Jor-el Thomas Caparas,8,0,35,27
1657626034457,MATH 20C,A03,093476,Briones; Jor-el Thomas Caparas,0,1,36,36
1657626034457,MATH 20C,B01,083762,Bach; Quang Tran,1,0,30,29
1657626040485,MATH 20D,A01,083765,Tran; Brian Kha,5,0,30,25
1657626040485,MATH 20D,A02,083766,Tran; Brian Kha,5,0,30,25
1657626040485,MATH 20D,A03,083767,Tran; Brian Kha,5,0,30,25
1657626046520,MATH 20E,A01,083771,Ganguly; Soumya,9,0,32,23
1657626046520,MATH 20E,A02,083772,Ganguly; Soumya,6,0,32,26
1657626046520,MATH 20E,B01,083773,Ciotti; Benjamin,20,0,35,15
1657626046520,MATH 20E,B02,083774,Ciotti; Benjamin,18,0,35,17
1657626052559,MATH 103A,A01,083777,Greenfeld; Be'Eri,3,0,36,33
1657626052559,MATH 103A,A02,083778,Greenfeld; Be'Eri,5,0,36,31
1657626052559,MATH 103A,A03,093561,Greenfeld; Be'Eri,6,0,36,30
1657626052559,MATH 103A,B01,083779,Greenfeld; Be'Eri,7,0,36,29
1657626052559,MATH 103A,B02,083780,Greenfeld; Be'Eri,4,0,36,32
1657626052559,MATH 103A,B03,093562,Greenfeld; Be'Eri,3,0,36,33
1657626058586,MATH 105,A01,085443,Carter; Anne Toulson,15,0,35,20
1657626058586,MATH 105,A02,093477,Carter; Anne Toulson,20,0,35,15
1657626064614,MATH 109,A01,083213,Ganzberger; Geoffrey Michael,2,0,34,32
1657626064614,MATH 109,A02,083214,Ganzberger; Geoffrey Michael,4,0,34,30
1657626064614,MATH 109,A03,093478,Ganzberger; Geoffrey Michael,2,0,34,32
1657626064614,MATH 109,B01,083215,Ganzberger; Geoffrey Michael,1,0,32,31
1657626064614,MATH 109,B02,083216,Ganzberger; Geoffrey Michael,2,0,32,30
1657626064614,MATH 109,B03,093479,Ganzberger; Geoffrey Michael,8,0,32,24
1657626070645,MATH 142A,A01,083219,Chow; Bennett,7,0,32,25
1657626070645,MATH 142A,A02,083220,Chow; Bennett,10,0,32,22
1657626070645,MATH 142A,A03,093480,Chow; Bennett,9,0,32,23
1657626070645,MATH 142A,B03,093481,Chow; Bennett,8,0,32,24
1657626070645,MATH 142A,B04,093558,Chow; Bennett,13,0,32,19
1657626070645,MATH 142A,B05,093559,Chow; Bennett,6,0,32,26
1657626076673,MATH 193A,A01,083224,Rotar; Vladimir,8,0,34,26
1657626076673,MATH 193A,A02,083225,Rotar; Vladimir,9,0,34,25
1657626076673,MATH 193A,A03,083781,Rotar; Vladimir,5,0,34,29
1657626076673,MATH 193A,A04,083782,Rotar; Vladimir,10,0,34,24
1657626076673,MATH 193A,A05,093482,Rotar; Vladimir,10,0,34,24
1657626082698,MATH 197,001,091859,McAuley; Julian John,9999,0,9999,0
1657626082698,MATH 197,002,095566,Kedlaya; Kiran S.,9997,0,9999,2
1657626082698,MATH 197,003,095567,Xiao; Ming,9999,0,9999,0
1657626082698,MATH 197,004,095571,Perols; Johan Lars,9998,0,9999,1
1657626089781,COGS 9,A01,083615,Shannon; Kyle Michael,9,0,75,66
1657626095812,COGS 11,A01,083617,Boyle; Mary E. T.,23,0,48,25
1657626101846,COGS 13,A01,083071,Bastos; Amalia Pinkusfeld,11,0,71,60
1657626107874,COGS 14A,A01,092681,Semenuks; Arturs,5,1,100,95
1657626113906,COGS 14B,A01,083073,Cheng; Tzu-Han,6,0,63,57
1657626119933,COGS 17,A01,092677,Semenuks; Arturs,6,0,81,75
1657626125966,COGS 100,A01,083619,Allen; Michael Gordon,17,0,70,53
1657626131992,COGS 101A,A01,083621,Davis; Joshua Daniel,9,0,68,59
1657626138040,COGS 101B,A01,091572,Allen; Michael Gordon,12,0,65,53
1657626144067,COGS 101C,A01,083625,Delgado; Tania,17,0,35,18
1657626150098,COGS 107A,A01,083627,Boyle; Mary E. T.,13,0,60,47
1657626156129,COGS 118A,A01,083075,Gupta; Anjum,21,0,76,55
1657626162159,CSE 3,A50,083646,Miranda; Gregory Joseph,24,0,50,26
1657626168186,CSE 8A,A50,083650,Miranda; Gregory Joseph,17,1,56,39
1657626174217,CSE 11,A01,083080,Cao; Yingjun,6,15,40,34
1657626180247,CSE 12,A01,083652,Krause-Levy; Sophia Louisa,28,1,120,92
1657626186274,CSE 15L,A01,083654,Morris; Justin Loren,9,0,50,41
1657626186274,CSE 15L,A02,083655,Morris; Justin Loren,9,0,50,41
1657626192305,CSE 20,A01,083657,Tran; Khoa Dang,39,0,80,41
1657626198405,CSE 21,A01,095574,Bach; Quang Tran,22,0,48,26
1657626204439,CSE 30,A01,083084,Eldon; John,6,0,80,74
1657626204439,CSE 30,B01,095061,Bhaskar; Nishant,9,0,50,41
1657626210467,CSE 100,A01,083659,Cao; Yingjun,5,4,70,65
1657626216509,CSE 134B,A01,083661,Powell; Thomas Allan,22,0,100,78
1657626222540,CSE 140,A01,083663,Gungor; Onat,15,0,85,70
1657626228571,CSE 140L,A01,083088,Eldon; John,21,0,100,79
1657626234604,CSE 175,A01,083665,Kumar; Rakesh,3,0,25,22
1657626240632,CSE 190,A00,092507,Dubnov; Shlomo,8,0,20,12
1657626246661,ECE 45,A01,083139,Congero; Spencer William,6,0,75,69
1657626252689,ECE 65,A50,083695,Saad; Andrew S,12,0,30,18
1657626252689,ECE 65,A51,095125,Saad; Andrew S,24,0,26,2
1657626258715,ECE 109,A01,091882,Touri; Behrouz,19,0,70,51
1657626264760,ECE 180,A00,083140,Abi Samra; Nicholas Camill,1,0,30,29
1657626264760,ECE 180,B00,083141,Abi Samra; Nicholas Camill,0,0,30,30
1657626270789,MATH 10A,A01,083735,Patchell; Gregory David,2,0,30,28
1657626270789,MATH 10A,A02,083736,Patchell; Gregory David,20,0,30,10
1657626270789,MATH 10A,A03,083737,Patchell; Gregory David,16,0,30,14
1657626276821,MATH 10B,A01,083207,Lim; Seonhee,8,0,34,26
1657626276821,MATH 10B,A02,083208,Lim; Seonhee,9,0,35,26
1657626276821,MATH 10B,A03,093472,Lim; Seonhee,7,0,34,27
1657626276821,MATH 10B,B01,083739,Sinha; Shubham,12,0,30,18
1657626282858,MATH 18,A01,083743,Cinel; Cameron Alexander,7,0,30,23
1657626282858,MATH 18,A02,083744,Cinel; Cameron Alexander,17,0,30,13
1657626282858,MATH 18,A03,083745,Cinel; Cameron Alexander,9,0,30,21
1657626282858,MATH 18,B01,083748,Rideout; David Porter,5,0,37,32
1657626282858,MATH 18,B02,083749,Rideout; David Porter,5,0,36,31
1657626282858,MATH 18,B03,083750,Rideout; David Porter,3,0,37,34
1657626282858,MATH 18,B04,083751,Rideout; David Porter,6,0,36,30
1657626282858,MATH 18,B05,093473,Rideout; David Porter,6,0,36,30
1657626282858,MATH 18,B06,093474,Rideout; David Porter,6,0,36,30
1657626288891,MATH 20A,A01,083754,Zheng; Zequn,14,0,40,26
1657626294922,MATH 20B,A01,083756,Briones; Jor-el Thomas Caparas,4,0,36,32
1657626294922,MATH 20B,A02,083757,Briones; Jor-el Thomas Caparas,1,0,36,35
1657626294922,MATH 20B,A03,093475,Briones; Jor-el Thomas Caparas,2,0,36,34
1657626300949,MATH 20C,A01,083760,Briones; Jor-el Thomas Caparas,1,0,35,34
1657626300949,MATH 20C,A02,083761,Briones; Jor-el Thomas Caparas,8,0,35,27
1657626300949,MATH 20C,A03,093476,Briones; Jor-el Thomas Caparas,0,1,36,36
1657626300949,MATH 20C,B01,083762,Bach; Quang Tran,1,0,30,29
1657626306980,MATH 20D,A01,083765,Tran; Brian Kha,5,0,30,25
1657626306980,MATH 20D,A02,083766,Tran; Brian Kha,5,0,30,25
1657626306980,MATH 20D,A03,083767,Tran; Brian Kha,5,0,30,25
1657626313014,MATH 20E,A01,083771,Ganguly; Soumya,9,0,32,23
1657626313014,MATH 20E,A02,083772,Ganguly; Soumya,6,0,32,26
1657626313014,MATH 20E,B01,083773,Ciotti; Benjamin,20,0,35,15
1657626313014,MATH 20E,B02,083774,Ciotti; Benjamin,18,0,35,17
1657626319047,MATH 103A,A01,083777,Greenfeld; Be'Eri,3,0,36,33
1657626319047,MATH 103A,A02,083778,Greenfeld; Be'Eri,5,0,36,31
1657626319047,MATH 103A,A03,093561,Greenfeld; Be'Eri,6,0,36,30
1657626319047,MATH 103A,B01,083779,Greenfeld; Be'Eri,7,0,36,29
1657626319047,MATH 103A,B02,083780,Greenfeld; Be'Eri,4,0,36,32
1657626319047,MATH 103A,B03,093562,Greenfeld; Be'Eri,3,0,36,33
1657626325084,MATH 105,A01,085443,Carter; Anne Toulson,15,0,35,20
1657626325084,MATH 105,A02,093477,Carter; Anne Toulson,20,0,35,15
1657626331110,MATH 109,A01,083213,Ganzberger; Geoffrey Michael,2,0,34,32
1657626331110,MATH 109,A02,083214,Ganzberger; Geoffrey Michael,4,0,34,30
1657626331110,MATH 109,A03,093478,Ganzberger; Geoffrey Michael,2,0,34,32
1657626331110,MATH 109,B01,083215,Ganzberger; Geoffrey Michael,1,0,32,31
1657626331110,MATH 109,B02,083216,Ganzberger; Geoffrey Michael,2,0,32,30
1657626331110,MATH 109,B03,093479,Ganzberger; Geoffrey Michael,8,0,32,24
1657626337145,MATH 142A,A01,083219,Chow; Bennett,7,0,32,25
1657626337145,MATH 142A,A02,083220,Chow; Bennett,10,0,32,22
1657626337145,MATH 142A,A03,093480,Chow; Bennett,9,0,32,23
1657626337145,MATH 142A,B03,093481,Chow; Bennett,8,0,32,24
1657626337145,MATH 142A,B04,093558,Chow; Bennett,13,0,32,19
1657626337145,MATH 142A,B05,093559,Chow; Bennett,6,0,32,26
1657626343177,MATH 193A,A01,083224,Rotar; Vladimir,8,0,34,26
1657626343177,MATH 193A,A02,083225,Rotar; Vladimir,9,0,34,25
1657626343177,MATH 193A,A03,083781,Rotar; Vladimir,5,0,34,29
1657626343177,MATH 193A,A04,083782,Rotar; Vladimir,10,0,34,24
1657626343177,MATH 193A,A05,093482,Rotar; Vladimir,10,0,34,24
1657626349205,MATH 197,001,091859,McAuley; Julian John,9999,0,9999,0
1657626349205,MATH 197,002,095566,Kedlaya; Kiran S.,9997,0,9999,2
1657626349205,MATH 197,003,095567,Xiao; Ming,9999,0,9999,0
1657626349205,MATH 197,004,095571,Perols; Johan Lars,9998,0,9999,1
1657626356286,COGS 9,A01,083615,Shannon; Kyle Michael,9,0,75,66
1657626362316,COGS 11,A01,083617,Boyle; Mary E. T.,23,0,48,25
1657626368350,COGS 13,A01,083071,Bastos; Amalia Pinkusfeld,11,0,71,60
1657626374394,COGS 14A,A01,092681,Semenuks; Arturs,5,1,100,95
1657626380427,COGS 14B,A01,083073,Cheng; Tzu-Han,6,0,63,57
1657626386468,COGS 17,A01,092677,Semenuks; Arturs,6,0,81,75
1657626392496,COGS 100,A01,083619,Allen; Michael Gordon,17,0,70,53
1657626398532,COGS 101A,A01,083621,Davis; Joshua Daniel,9,0,68,59
1657626404560,COGS 101B,A01,091572,Allen; Michael Gordon,12,0,65,53
1657626410594,COGS 101C,A01,083625,Delgado; Tania,17,0,35,18
1657626416630,COGS 107A,A01,083627,Boyle; Mary E. T.,13,0,60,47
1657626422656,COGS 118A,A01,083075,Gupta; Anjum,21,0,76,55
1657626428686,CSE 3,A50,083646,Miranda; Gregory Joseph,24,0,50,26
1657626434712,CSE 8A,A50,083650,Miranda; Gregory Joseph,17,1,56,39
1657626440738,CSE 11,A01,083080,Cao; Yingjun,6,15,40,34
1657626446765,CSE 12,A01,083652,Krause-Levy; Sophia Louisa,28,1,120,92
1657626452798,CSE 15L,A01,083654,Morris; Justin Loren,9,0,50,41
1657626452798,CSE 15L,A02,083655,Morris; Justin Loren,9,0,50,41
1657626458829,CSE 20,A01,083657,Tran; Khoa Dang,39,0,80,41
1657626464855,CSE 21,A01,095574,Bach; Quang Tran,22,0,48,26
1657626470881,CSE 30,A01,083084,Eldon; John,6,0,80,74
1657626470881,CSE 30,B01,095061,Bhaskar; Nishant,9,0,50,41
1657626476907,CSE 100,A01,083659,Cao; Yingjun,5,4,70,65
1657626482940,CSE 134B,A01,083661,Powell; Thomas Allan,22,0,100,78
1657626488967,CSE 140,A01,083663,Gungor; Onat,15,0,85,70
1657626494997,CSE 140L,A01,083088,Eldon; John,21,0,100,79
1657626501022,CSE 175,A01,083665,Kumar; Rakesh,3,0,25,22
1657626507053,CSE 190,A00,092507,Dubnov; Shlomo,8,0,20,12
1657626513082,ECE 45,A01,083139,Congero; Spencer William,6,0,75,69
1657626519108,ECE 65,A50,083695,Saad; Andrew S,12,0,30,18
1657626519108,ECE 65,A51,095125,Saad; Andrew S,24,0,26,2
1657626525138,ECE 109,A01,091882,Touri; Behrouz,19,0,70,51
1657626531165,ECE 180,A00,083140,Abi Samra; Nicholas Camill,1,0,30,29
1657626531165,ECE 180,B00,083141,Abi Samra; Nicholas Camill,0,0,30,30
1657626537202,MATH 10A,A01,083735,Patchell; Gregory David,2,0,30,28
1657626537202,MATH 10A,A02,083736,Patchell; Gregory David,20,0,30,10
1657626537202,MATH 10A,A03,083737,Patchell; Gregory David,16,0,30,14
1657626543233,MATH 10B,A01,083207,Lim; Seonhee,8,0,34,26
1657626543233,MATH 10B,A02,083208,Lim; Seonhee,9,0,35,26
1657626543233,MATH 10B,A03,093472,Lim; Seonhee,7,0,34,27
1657626543233,MATH 10B,B01,083739,Sinha; Shubham,12,0,30,18
1657626549286,MATH 18,A01,083743,Cinel; Cameron Alexander,7,0,30,23
1657626549286,MATH 18,A02,083744,Cinel; Cameron Alexander,17,0,30,13
1657626549286,MATH 18,A03,083745,Cinel; Cameron Alexander,9,0,30,21
1657626549286,MATH 18,B01,083748,Rideout; David Porter,5,0,37,32
1657626549286,MATH 18,B02,083749,Rideout; David Porter,5,0,36,31
1657626549286,MATH 18,B03,083750,Rideout; David Porter,3,0,37,34
1657626549286,MATH 18,B04,083751,Rideout; David Porter,6,0,36,30
1657626549286,MATH 18,B05,093473,Rideout; David Porter,6,0,36,30
1657626549286,MATH 18,B06,093474,Rideout; David Porter,6,0,36,30
1657626555313,MATH 20A,A01,083754,Zheng; Zequn,14,0,40,26
1657626561347,MATH 20B,A01,083756,Briones; Jor-el Thomas Caparas,4,0,36,32
1657626561347,MATH 20B,A02,083757,Briones; Jor-el Thomas Caparas,1,0,36,35
1657626561347,MATH 20B,A03,093475,Briones; Jor-el Thomas Caparas,2,0,36,34
1657626567378,MATH 20C,A01,083760,Briones; Jor-el Thomas Caparas,1,0,35,34
1657626567378,MATH 20C,A02,083761,Briones; Jor-el Thomas Caparas,8,0,35,27
1657626567378,MATH 20C,A03,093476,Briones; Jor-el Thomas Caparas,0,1,36,36
1657626567378,MATH 20C,B01,083762,Bach; Quang Tran,1,0,30,29
1657626573404,MATH 20D,A01,083765,Tran; Brian Kha,5,0,30,25
1657626573404,MATH 20D,A02,083766,Tran; Brian Kha,5,0,30,25
1657626573404,MATH 20D,A03,083767,Tran; Brian Kha,5,0,30,25
1657626579443,MATH 20E,A01,083771,Ganguly; Soumya,9,0,32,23
1657626579443,MATH 20E,A02,083772,Ganguly; Soumya,6,0,32,26
1657626579443,MATH 20E,B01,083773,Ciotti; Benjamin,20,0,35,15
1657626579443,MATH 20E,B02,083774,Ciotti; Benjamin,18,0,35,17
1657626585471,MATH 103A,A01,083777,Greenfeld; Be'Eri,3,0,36,33
1657626585471,MATH 103A,A02,083778,Greenfeld; Be'Eri,5,0,36,31
1657626585471,MATH 103A,A03,093561,Greenfeld; Be'Eri,6,0,36,30
1657626585471,MATH 103A,B01,083779,Greenfeld; Be'Eri,7,0,36,29
1657626585471,MATH 103A,B02,083780,Greenfeld; Be'Eri,4,0,36,32
1657626585471,MATH 103A,B03,093562,Greenfeld; Be'Eri,3,0,36,33
1657626591502,MATH 105,A01,085443,Carter; Anne Toulson,15,0,35,20
1657626591502,MATH 105,A02,093477,Carter; Anne Toulson,20,0,35,15
1657626597531,MATH 109,A01,083213,Ganzberger; Geoffrey Michael,2,0,34,32
1657626597531,MATH 109,A02,083214,Ganzberger; Geoffrey Michael,4,0,34,30
1657626597531,MATH 109,A03,093478,Ganzberger; Geoffrey Michael,2,0,34,32
1657626597531,MATH 109,B01,083215,Ganzberger; Geoffrey Michael,1,0,32,31
1657626597531,MATH 109,B02,083216,Ganzberger; Geoffrey Michael,2,0,32,30
1657626597531,MATH 109,B03,093479,Ganzberger; Geoffrey Michael,8,0,32,24
1657626603571,MATH 142A,A01,083219,Chow; Bennett,7,0,32,25
1657626603571,MATH 142A,A02,083220,Chow; Bennett,10,0,32,22
1657626603571,MATH 142A,A03,093480,Chow; Bennett,9,0,32,23
1657626603571,MATH 142A,B03,093481,Chow; Bennett,8,0,32,24
1657626603571,MATH 142A,B04,093558,Chow; Bennett,13,0,32,19
1657626603571,MATH 142A,B05,093559,Chow; Bennett,6,0,32,26
1657626609603,MATH 193A,A01,083224,Rotar; Vladimir,8,0,34,26
1657626609603,MATH 193A,A02,083225,Rotar; Vladimir,9,0,34,25
1657626609603,MATH 193A,A03,083781,Rotar; Vladimir,5,0,34,29
1657626609603,MATH 193A,A04,083782,Rotar; Vladimir,10,0,34,24
1657626609603,MATH 193A,A05,093482,Rotar; Vladimir,10,0,34,24
1657626615629,MATH 197,001,091859,McAuley; Julian John,9999,0,9999,0
1657626615629,MATH 197,002,095566,Kedlaya; Kiran S.,9997,0,9999,2
1657626615629,MATH 197,003,095567,Xiao; Ming,9999,0,9999,0
1657626615629,MATH 197,004,095571,Perols; Johan Lars,9998,0,9999,1
1657626622694,COGS 9,A01,083615,Shannon; Kyle Michael,9,0,75,66
1657626628726,COGS 11,A01,083617,Boyle; Mary E. T.,23,0,48,25
1657626634756,COGS 13,A01,083071,Bastos; Amalia Pinkusfeld,11,0,71,60
1657626640785,COGS 14A,A01,092681,Semenuks; Arturs,5,1,100,95
1657626646819,COGS 14B,A01,083073,Cheng; Tzu-Han,6,0,63,57
1657626652845,COGS 17,A01,092677,Semenuks; Arturs,6,0,81,75
1657626658875,COGS 100,A01,083619,Allen; Michael Gordon,17,0,70,53
1657626664905,COGS 101A,A01,083621,Davis; Joshua Daniel,9,0,68,59
1657626670931,COGS 101B,A01,091572,Allen; Michael Gordon,12,0,65,53
1657626676958,COGS 101C,A01,083625,Delgado; Tania,17,0,35,18
1657626682985,COGS 107A,A01,083627,Boyle; Mary E. T.,13,0,60,47
1657626689021,COGS 118A,A01,083075,Gupta; Anjum,21,0,76,55
1657626695048,CSE 3,A50,083646,Miranda; Gregory Joseph,24,0,50,26
1657626701080,CSE 8A,A50,083650,Miranda; Gregory Joseph,17,1,56,39
1657626707106,CSE 11,A01,083080,Cao; Yingjun,6,15,40,34
1657626713135,CSE 12,A01,083652,Krause-Levy; Sophia Louisa,28,1,120,92
1657626719163,CSE 15L,A01,083654,Morris; Justin Loren,9,0,50,41
1657626719163,CSE 15L,A02,083655,Morris; Justin Loren,9,0,50,41
1657626725188,CSE 20,A01,083657,Tran; Khoa Dang,39,0,80,41
1657626731219,CSE 21,A01,095574,Bach; Quang Tran,22,0,48,26
1657626737256,CSE 30,A01,083084,Eldon; John,6,0,80,74
1657626737256,CSE 30,B01,095061,Bhaskar; Nishant,9,0,50,41
1657626743289,CSE 100,A01,083659,Cao; Yingjun,5,4,70,65
1657626749320,CSE 134B,A01,083661,Powell; Thomas Allan,22,0,100,78
1657626755346,CSE 140,A01,083663,Gungor; Onat,15,0,85,70
1657626761378,CSE 140L,A01,083088,Eldon; John,21,0,100,79
1657626767410,CSE 175,A01,083665,Kumar; Rakesh,3,0,25,22
1657626773449,CSE 190,A00,092507,Dubnov; Shlomo,8,0,20,12
1657626779477,ECE 45,A01,083139,Congero; Spencer William,6,0,75,69
1657626785512,ECE 65,A50,083695,Saad; Andrew S,12,0,30,18
1657626785512,ECE 65,A51,095125,Saad; Andrew S,24,0,26,2
1657626791541,ECE 109,A01,091882,Touri; Behrouz,19,0,70,51
1657626797641,ECE 180,A00,083140,Abi Samra; Nicholas Camill,1,0,30,29
1657626797641,ECE 180,B00,083141,Abi Samra; Nicholas Camill,0,0,30,30
1657626803669,MATH 10A,A01,083735,Patchell; Gregory David,2,0,30,28
1657626803669,MATH 10A,A02,083736,Patchell; Gregory David,20,0,30,10
1657626803669,MATH 10A,A03,083737,Patchell; Gregory David,16,0,30,14
1657626809698,MATH 10B,A01,083207,Lim; Seonhee,8,0,34,26
1657626809698,MATH 10B,A02,083208,Lim; Seonhee,9,0,35,26
1657626809698,MATH 10B,A03,093472,Lim; Seonhee,7,0,34,27
1657626809698,MATH 10B,B01,083739,Sinha; Shubham,12,0,30,18
1657626815729,MATH 18,A01,083743,Cinel; Cameron Alexander,7,0,30,23
1657626815729,MATH 18,A02,083744,Cinel; Cameron Alexander,17,0,30,13
1657626815729,MATH 18,A03,083745,Cinel; Cameron Alexander,9,0,30,21
1657626815729,MATH 18,B01,083748,Rideout; David Porter,5,0,37,32
1657626815729,MATH 18,B02,083749,Rideout; David Porter,5,0,36,31
1657626815729,MATH 18,B03,083750,Rideout; David Porter,3,0,37,34
1657626815729,MATH 18,B04,083751,Rideout; David Porter,6,0,36,30
1657626815729,MATH 18,B05,093473,Rideout; David Porter,6,0,36,30
1657626815729,MATH 18,B06,093474,Rideout; David Porter,6,0,36,30
1657626821756,MATH 20A,A01,083754,Zheng; Zequn,14,0,40,26
1657626827785,MATH 20B,A01,083756,Briones; Jor-el Thomas Caparas,4,0,36,32
1657626827785,MATH 20B,A02,083757,Briones; Jor-el Thomas Caparas,1,0,36,35
1657626827785,MATH 20B,A03,093475,Briones; Jor-el Thomas Caparas,2,0,36,34
1657626833813,MATH 20C,A01,083760,Briones; Jor-el Thomas Caparas,1,0,35,34
1657626833813,MATH 20C,A02,083761,Briones; Jor-el Thomas Caparas,8,0,35,27
1657626833813,MATH 20C,A03,093476,Briones; Jor-el Thomas Caparas,0,1,36,36
1657626833813,MATH 20C,B01,083762,Bach; Quang Tran,1,0,30,29
1657626839838,MATH 20D,A01,083765,Tran; Brian Kha,5,0,30,25
1657626839838,MATH 20D,A02,083766,Tran; Brian Kha,5,0,30,25
1657626839838,MATH 20D,A03,083767,Tran; Brian Kha,5,0,30,25
1657626845869,MATH 20E,A01,083771,Ganguly; Soumya,9,0,32,23
1657626845869,MATH 20E,A02,083772,Ganguly; Soumya,6,0,32,26
1657626845869,MATH 20E,B01,083773,Ciotti; Benjamin,20,0,35,15
1657626845869,MATH 20E,B02,083774,Ciotti; Benjamin,18,0,35,17
1657626851895,MATH 103A,A01,083777,Greenfeld; Be'Eri,3,0,36,33
1657626851895,MATH 103A,A02,083778,Greenfeld; Be'Eri,5,0,36,31
1657626851895,MATH 103A,A03,093561,Greenfeld; Be'Eri,6,0,36,30
1657626851895,MATH 103A,B01,083779,Greenfeld; Be'Eri,7,0,36,29
1657626851895,MATH 103A,B02,083780,Greenfeld; Be'Eri,4,0,36,32
1657626851895,MATH 103A,B03,093562,Greenfeld; Be'Eri,3,0,36,33
1657626857923,MATH 105,A01,085443,Carter; Anne Toulson,15,0,35,20
1657626857923,MATH 105,A02,093477,Carter; Anne Toulson,20,0,35,15
1657626863949,MATH 109,A01,083213,Ganzberger; Geoffrey Michael,2,0,34,32
1657626863949,MATH 109,A02,083214,Ganzberger; Geoffrey Michael,4,0,34,30
1657626863949,MATH 109,A03,093478,Ganzberger; Geoffrey Michael,2,0,34,32
1657626863949,MATH 109,B01,083215,Ganzberger; Geoffrey Michael,1,0,32,31
1657626863949,MATH 109,B02,083216,Ganzberger; Geoffrey Michael,2,0,32,30
1657626863949,MATH 109,B03,093479,Ganzberger; Geoffrey Michael,8,0,32,24
1657626869990,MATH 142A,A01,083219,Chow; Bennett,7,0,32,25
1657626869990,MATH 142A,A02,083220,Chow; Bennett,10,0,32,22
1657626869990,MATH 142A,A03,093480,Chow; Bennett,9,0,32,23
1657626869990,MATH 142A,B03,093481,Chow; Bennett,8,0,32,24
1657626869990,MATH 142A,B04,093558,Chow; Bennett,13,0,32,19
1657626869990,MATH 142A,B05,093559,Chow; Bennett,6,0,32,26
1657626876020,MATH 193A,A01,083224,Rotar; Vladimir,8,0,34,26
1657626876020,MATH 193A,A02,083225,Rotar; Vladimir,9,0,34,25
1657626876020,MATH 193A,A03,083781,Rotar; Vladimir,5,0,34,29
1657626876020,MATH 193A,A04,083782,Rotar; Vladimir,10,0,34,24
1657626876020,MATH 193A,A05,093482,Rotar; Vladimir,10,0,34,24
1657626882048,MATH 197,001,091859,McAuley; Julian John,9999,0,9999,0
1657626882048,MATH 197,002,095566,Kedlaya; Kiran S.,9997,0,9999,2
1657626882048,MATH 197,003,095567,Xiao; Ming,9999,0,9999,0
1657626882048,MATH 197,004,095571,Perols; Johan Lars,9998,0,9999,1
1657626889112,COGS 9,A01,083615,Shannon; Kyle Michael,9,0,75,66
1657626895143,COGS 11,A01,083617,Boyle; Mary E. T.,23,0,48,25
1657626901168,COGS 13,A01,083071,Bastos; Amalia Pinkusfeld,11,0,71,60
1657626907195,COGS 14A,A01,092681,Semenuks; Arturs,5,1,100,95
1657626913220,COGS 14B,A01,083073,Cheng; Tzu-Han,6,0,63,57
1657626919244,COGS 17,A01,092677,Semenuks; Arturs,6,0,81,75
1657626925274,COGS 100,A01,083619,Allen; Michael Gordon,17,0,70,53
1657626931304,COGS 101A,A01,083621,Davis; Joshua Daniel,9,0,68,59
1657626937330,COGS 101B,A01,091572,Allen; Michael Gordon,12,0,65,53
1657626943355,COGS 101C,A01,083625,Delgado; Tania,17,0,35,18
1657626949396,COGS 107A,A01,083627,Boyle; Mary E. T.,13,0,60,47
1657626955426,COGS 118A,A01,083075,Gupta; Anjum,21,0,76,55
1657626961453,CSE 3,A50,083646,Miranda; Gregory Joseph,24,0,50,26
1657626967479,CSE 8A,A50,083650,Miranda; Gregory Joseph,17,1,56,39
1657626973506,CSE 11,A01,083080,Cao; Yingjun,6,15,40,34
1657626979532,CSE 12,A01,083652,Krause-Levy; Sophia Louisa,28,1,120,92
1657626985559,CSE 15L,A01,083654,Morris; Justin Loren,9,0,50,41
1657626985559,CSE 15L,A02,083655,Morris; Justin Loren,9,0,50,41
1657626991583,CSE 20,A01,083657,Tran; Khoa Dang,39,0,80,41
1657626997617,CSE 21,A01,095574,Bach; Quang Tran,22,0,48,26
1657627003644,CSE 30,A01,083084,Eldon; John,6,0,80,74
1657627003644,CSE 30,B01,095061,Bhaskar; Nishant,9,0,50,41
1657627009667,CSE 100,A01,083659,Cao; Yingjun,5,4,70,65
1657627015690,CSE 134B,A01,083661,Powell; Thomas Allan,22,0,100,78
1657627021715,CSE 140,A01,083663,Gungor; Onat,15,0,85,70
1657627027739,CSE 140L,A01,083088,Eldon; John,21,0,100,79
1657627033763,CSE 175,A01,083665,Kumar; Rakesh,3,0,25,22
1657627039791,CSE 190,A00,092507,Dubnov; Shlomo,8,0,20,12
1657627045815,ECE 45,A01,083139,Congero; Spencer William,6,0,75,69
1657627051845,ECE 65,A50,083695,Saad; Andrew S,12,0,30,18
1657627051845,ECE 65,A51,095125,Saad; Andrew S,24,0,26,2
1657627057874,ECE 109,A01,091882,Touri; Behrouz,19,0,70,51
1657627063900,ECE 180,A00,083140,Abi Samra; Nicholas Camill,1,0,30,29
1657627063900,ECE 180,B00,083141,Abi Samra; Nicholas Camill,0,0,30,30
1657627069926,MATH 10A,A01,083735,Patchell; Gregory David,2,0,30,28
1657627069926,MATH 10A,A02,083736,Patchell; Gregory David,20,0,30,10
1657627069926,MATH 10A,A03,083737,Patchell; Gregory David,16,0,30,14
1657627075957,MATH 10B,A01,083207,Lim; Seonhee,8,0,34,26
1657627075957,MATH 10B,A02,083208,Lim; Seonhee,9,0,35,26
1657627075957,MATH 10B,A03,093472,Lim; Seonhee,7,0,34,27
1657627075957,MATH 10B,B01,083739,Sinha; Shubham,12,0,30,18
1657627081990,MATH 18,A01,083743,Cinel; Cameron Alexander,7,0,30,23
1657627081990,MATH 18,A02,083744,Cinel; Cameron Alexander,17,0,30,13
1657627081990,MATH 18,A03,083745,Cinel; Cameron Alexander,9,0,30,21
1657627081990,MATH 18,B01,083748,Rideout; David Porter,5,0,37,32
1657627081990,MATH 18,B02,083749,Rideout; David Porter,5,0,36,31
1657627081990,MATH 18,B03,083750,Rideout; David Porter,3,0,37,34
1657627081990,MATH 18,B04,083751,Rideout; David Porter,6,0,36,30
1657627081990,MATH 18,B05,093473,Rideout; David Porter,6,0,36,30
1657627081990,MATH 18,B06,093474,Rideout; David Porter,6,0,36,30
1657627088017,MATH 20A,A01,083754,Zheng; Zequn,14,0,40,26
1657627094049,MATH 20B,A01,083756,Briones; Jor-el Thomas Caparas,4,0,36,32
1657627094049,MATH 20B,A02,083757,Briones; Jor-el Thomas Caparas,1,0,36,35
1657627094049,MATH 20B,A03,093475,Briones; Jor-el Thomas Caparas,2,0,36,34
1657627100074,MATH 20C,A01,083760,Briones; Jor-el Thomas Caparas,1,0,35,34
1657627100074,MATH 20C,A02,083761,Briones; Jor-el Thomas Caparas,8,0,35,27
1657627100074,MATH 20C,A03,093476,Briones; Jor-el Thomas Caparas,0,1,36,36
1657627100074,MATH 20C,B01,083762,Bach; Quang Tran,1,0,30,29
1657627106101,MATH 20D,A01,083765,Tran; Brian Kha,5,0,30,25
1657627106101,MATH 20D,A02,083766,Tran; Brian Kha,5,0,30,25
1657627106101,MATH 20D,A03,083767,Tran; Brian Kha,5,0,30,25
1657627112131,MATH 20E,A01,083771,Ganguly; Soumya,9,0,32,23
1657627112131,MATH 20E,A02,083772,Ganguly; Soumya,6,0,32,26
1657627112131,MATH 20E,B01,083773,Ciotti; Benjamin,20,0,35,15
1657627112131,MATH 20E,B02,083774,Ciotti; Benjamin,18,0,35,17
1657627118157,MATH 103A,A01,083777,Greenfeld; Be'Eri,3,0,36,33
1657627118157,MATH 103A,A02,083778,Greenfeld; Be'Eri,5,0,36,31
1657627118157,MATH 103A,A03,093561,Greenfeld; Be'Eri,6,0,36,30
1657627118157,MATH 103A,B01,083779,Greenfeld; Be'Eri,7,0,36,29
1657627118157,MATH 103A,B02,083780,Greenfeld; Be'Eri,4,0,36,32
1657627118157,MATH 103A,B03,093562,Greenfeld; Be'Eri,3,0,36,33
1657627124186,MATH 105,A01,085443,Carter; Anne Toulson,15,0,35,20
1657627124186,MATH 105,A02,093477,Carter; Anne Toulson,20,0,35,15
1657627130211,MATH 109,A01,083213,Ganzberger; Geoffrey Michael,2,0,34,32
1657627130211,MATH 109,A02,083214,Ganzberger; Geoffrey Michael,4,0,34,30
1657627130211,MATH 109,A03,093478,Ganzberger; Geoffrey Michael,2,0,34,32
1657627130211,MATH 109,B01,083215,Ganzberger; Geoffrey Michael,1,0,32,31
1657627130211,MATH 109,B02,083216,Ganzberger; Geoffrey Michael,2,0,32,30
1657627130211,MATH 109,B03,093479,Ganzberger; Geoffrey Michael,8,0,32,24
1657627136240,MATH 142A,A01,083219,Chow; Bennett,7,0,32,25
1657627136240,MATH 142A,A02,083220,Chow; Bennett,10,0,32,22
1657627136240,MATH 142A,A03,093480,Chow; Bennett,9,0,32,23
1657627136240,MATH 142A,B03,093481,Chow; Bennett,8,0,32,24
1657627136240,MATH 142A,B04,093558,Chow; Bennett,13,0,32,19
1657627136240,MATH 142A,B05,093559,Chow; Bennett,6,0,32,26
1657627142271,MATH 193A,A01,083224,Rotar; Vladimir,8,0,34,26
1657627142271,MATH 193A,A02,083225,Rotar; Vladimir,9,0,34,25
1657627142271,MATH 193A,A03,083781,Rotar; Vladimir,5,0,34,29
1657627142271,MATH 193A,A04,083782,Rotar; Vladimir,10,0,34,24
1657627142271,MATH 193A,A05,093482,Rotar; Vladimir,10,0,34,24
1657627148296,MATH 197,001,091859,McAuley; Julian John,9999,0,9999,0
1657627148296,MATH 197,002,095566,Kedlaya; Kiran S.,9997,0,9999,2
1657627148296,MATH 197,003,095567,Xiao; Ming,9999,0,9999,0
1657627148296,MATH 197,004,095571,Perols; Johan Lars,9998,0,9999,1
1657627155362,COGS 9,A01,083615,Shannon; Kyle Michael,9,0,75,66
1657627161387,COGS 11,A01,083617,Boyle; Mary E. T.,23,0,48,25
1657627167414,COGS 13,A01,083071,Bastos; Amalia Pinkusfeld,11,0,71,60
1657627173445,COGS 14A,A01,092681,Semenuks; Arturs,5,1,100,95
1657627179469,COGS 14B,A01,083073,Cheng; Tzu-Han,6,0,63,57
1657627185494,COGS 17,A01,092677,Semenuks; Arturs,6,0,81,75
1657627191519,COGS 100,A01,083619,Allen; Michael Gordon,17,0,70,53
1657627197547,COGS 101A,A01,083621,Davis; Joshua Daniel,9,0,68,59
1657627203578,COGS 101B,A01,091572,Allen; Michael Gordon,12,0,65,53
1657627209602,COGS 101C,A01,083625,Delgado; Tania,17,0,35,18
1657627215626,COGS 107A,A01,083627,Boyle; Mary E. T.,13,0,60,47
1657627221650,COGS 118A,A01,083075,Gupta; Anjum,21,0,76,55
1657627227674,CSE 3,A50,083646,Miranda; Gregory Joseph,24,0,50,26
1657627233701,CSE 8A,A50,083650,Miranda; Gregory Joseph,17,1,56,39
1657627239729,CSE 11,A01,083080,Cao; Yingjun,6,15,40,34
1657627245755,CSE 12,A01,083652,Krause-Levy; Sophia Louisa,28,1,120,92
1657627251782,CSE 15L,A01,083654,Morris; Justin Loren,9,0,50,41
1657627251782,CSE 15L,A02,083655,Morris; Justin Loren,9,0,50,41
1657627257807,CSE 20,A01,083657,Tran; Khoa Dang,39,0,80,41
1657627263831,CSE 21,A01,095574,Bach; Quang Tran,22,0,48,26
1657627269860,CSE 30,A01,083084,Eldon; John,6,0,80,74
1657627269860,CSE 30,B01,095061,Bhaskar; Nishant,9,0,50,41
1657627275885,CSE 100,A01,083659,Cao; Yingjun,5,4,70,65
1657627281908,CSE 134B,A01,083661,Powell; Thomas Allan,22,0,100,78
1657627287933,CSE 140,A01,083663,Gungor; Onat,15,0,85,70
1657627293959,CSE 140L,A01,083088,Eldon; John,21,0,100,79
1657627299986,CSE 175,A01,083665,Kumar; Rakesh,3,0,25,22
1657627306012,CSE 190,A00,092507,Dubnov; Shlomo,8,0,20,12
1657627312038,ECE 45,A01,083139,Congero; Spencer William,6,0,75,69
1657627318072,ECE 65,A50,083695,Saad; Andrew S,12,0,30,18
1657627318072,ECE 65,A51,095125,Saad; Andrew S,24,0,26,2
1657627324095,ECE 109,A01,091882,Touri; Behrouz,19,0,70,51
1657627330129,ECE 180,A00,083140,Abi Samra; Nicholas Camill,1,0,30,29
1657627330129,ECE 180,B00,083141,Abi Samra; Nicholas Camill,0,0,30,30
1657627336160,MATH 10A,A01,083735,Patchell; Gregory David,2,0,30,28
1657627336160,MATH 10A,A02,083736,Patchell; Gregory David,20,0,30,10
1657627336160,MATH 10A,A03,083737,Patchell; Gregory David,16,0,30,14
1657627342187,MATH 10B,A01,083207,Lim; Seonhee,8,0,34,26
1657627342187,MATH 10B,A02,083208,Lim; Seonhee,9,0,35,26
1657627342187,MATH 10B,A03,093472,Lim; Seonhee,7,0,34,27
1657627342187,MATH 10B,B01,083739,Sinha; Shubham,12,0,30,18
1657627348213,MATH 18,A01,083743,Cinel; Cameron Alexander,7,0,30,23
1657627348213,MATH 18,A02,083744,Cinel; Cameron Alexander,17,0,30,13
1657627348213,MATH 18,A03,083745,Cinel; Cameron Alexander,9,0,30,21
1657627348213,MATH 18,B01,083748,Rideout; David Porter,5,0,37,32
1657627348213,MATH 18,B02,083749,Rideout; David Porter,5,0,36,31
1657627348213,MATH 18,B03,083750,Rideout; David Porter,3,0,37,34
1657627348213,MATH 18,B04,083751,Rideout; David Porter,6,0,36,30
1657627348213,MATH 18,B05,093473,Rideout; David Porter,6,0,36,30
1657627348213,MATH 18,B06,093474,Rideout; David Porter,6,0,36,30
1657627354240,MATH 20A,A01,083754,Zheng; Zequn,14,0,40,26
1657627360269,MATH 20B,A01,083756,Briones; Jor-el Thomas Caparas,4,0,36,32
1657627360269,MATH 20B,A02,083757,Briones; Jor-el Thomas Caparas,1,0,36,35
1657627360269,MATH 20B,A03,093475,Briones; Jor-el Thomas Caparas,2,0,36,34
1657627366293,MATH 20C,A01,083760,Briones; Jor-el Thomas Caparas,1,0,35,34
1657627366293,MATH 20C,A02,083761,Briones; Jor-el Thomas Caparas,8,0,35,27
1657627366293,MATH 20C,A03,093476,Briones; Jor-el Thomas Caparas,0,1,36,36
1657627366293,MATH 20C,B01,083762,Bach; Quang Tran,1,0,30,29
1657627372319,MATH 20D,A01,083765,Tran; Brian Kha,5,0,30,25
1657627372319,MATH 20D,A02,083766,Tran; Brian Kha,5,0,30,25
1657627372319,MATH 20D,A03,083767,Tran; Brian Kha,5,0,30,25
1657627378345,MATH 20E,A01,083771,Ganguly; Soumya,9,0,32,23
1657627378345,MATH 20E,A02,083772,Ganguly; Soumya,6,0,32,26
1657627378345,MATH 20E,B01,083773,Ciotti; Benjamin,20,0,35,15
1657627378345,MATH 20E,B02,083774,Ciotti; Benjamin,18,0,35,17
1657627384377,MATH 103A,A01,083777,Greenfeld; Be'Eri,3,0,36,33
1657627384377,MATH 103A,A02,083778,Greenfeld; Be'Eri,5,0,36,31
1657627384377,MATH 103A,A03,093561,Greenfeld; Be'Eri,6,0,36,30
1657627384377,MATH 103A,B01,083779,Greenfeld; Be'Eri,7,0,36,29
1657627384377,MATH 103A,B02,083780,Greenfeld; Be'Eri,4,0,36,32
1657627384377,MATH 103A,B03,093562,Greenfeld; Be'Eri,3,0,36,33
1657627390401,MATH 105,A01,085443,Carter; Anne Toulson,15,0,35,20
1657627390401,MATH 105,A02,093477,Carter; Anne Toulson,20,0,35,15
1657627396498,MATH 109,A01,083213,Ganzberger; Geoffrey Michael,2,0,34,32
1657627396498,MATH 109,A02,083214,Ganzberger; Geoffrey Michael,4,0,34,30
1657627396498,MATH 109,A03,093478,Ganzberger; Geoffrey Michael,2,0,34,32
1657627396498,MATH 109,B01,083215,Ganzberger; Geoffrey Michael,1,0,32,31
1657627396498,MATH 109,B02,083216,Ganzberger; Geoffrey Michael,2,0,32,30
1657627396498,MATH 109,B03,093479,Ganzberger; Geoffrey Michael,8,0,32,24
1657627402524,MATH 142A,A01,083219,Chow; Bennett,7,0,32,25
1657627402524,MATH 142A,A02,083220,Chow; Bennett,10,0,32,22
1657627402524,MATH 142A,A03,093480,Chow; Bennett,9,0,32,23
1657627402524,MATH 142A,B03,093481,Chow; Bennett,8,0,32,24
1657627402524,MATH 142A,B04,093558,Chow; Bennett,13,0,32,19
1657627402524,MATH 142A,B05,093559,Chow; Bennett,6,0,32,26
1657627408556,MATH 193A,A01,083224,Rotar; Vladimir,8,0,34,26
1657627408556,MATH 193A,A02,083225,Rotar; Vladimir,9,0,34,25
1657627408556,MATH 193A,A03,083781,Rotar; Vladimir,5,0,34,29
1657627408556,MATH 193A,A04,083782,Rotar; Vladimir,10,0,34,24
1657627408556,MATH 193A,A05,093482,Rotar; Vladimir,10,0,34,24
1657627414587,MATH 197,001,091859,McAuley; Julian John,9999,0,9999,0
1657627414587,MATH 197,002,095566,Kedlaya; Kiran S.,9997,0,9999,2
1657627414587,MATH 197,003,095567,Xiao; Ming,9999,0,9999,0
1657627414587,MATH 197,004,095571,Perols; Johan Lars,9998,0,9999,1
1657627421651,COGS 9,A01,083615,Shannon; Kyle Michael,9,0,75,66
1657627427677,COGS 11,A01,083617,Boyle; Mary E. T.,23,0,48,25
1657627433701,COGS 13,A01,083071,Bastos; Amalia Pinkusfeld,11,0,71,60
1657627439728,COGS 14A,A01,092681,Semenuks; Arturs,5,1,100,95
1657627445757,COGS 14B,A01,083073,Cheng; Tzu-Han,6,0,63,57
1657627451782,COGS 17,A01,092677,Semenuks; Arturs,6,0,81,75
1657627457806,COGS 100,A01,083619,Allen; Michael Gordon,17,0,70,53
1657627463835,COGS 101A,A01,083621,Davis; Joshua Daniel,9,0,68,59
1657627469859,COGS 101B,A01,091572,Allen; Michael Gordon,12,0,65,53
1657627475885,COGS 101C,A01,083625,Delgado; Tania,17,0,35,18
1657627481916,COGS 107A,A01,083627,Boyle; Mary E. T.,13,0,60,47
1657627487946,COGS 118A,A01,083075,Gupta; Anjum,21,0,76,55
1657627493973,CSE 3,A50,083646,Miranda; Gregory Joseph,24,0,50,26
1657627499998,CSE 8A,A50,083650,Miranda; Gregory Joseph,17,1,56,39
1657627506022,CSE 11,A01,083080,Cao; Yingjun,6,15,40,34
1657627512051,CSE 12,A01,083652,Krause-Levy; Sophia Louisa,28,1,120,92
1657627518079,CSE 15L,A01,083654,Morris; Justin Loren,9,0,50,41
1657627518079,CSE 15L,A02,083655,Morris; Justin Loren,9,0,50,41
1657627524104,CSE 20,A01,083657,Tran; Khoa Dang,39,0,80,41
1657627530128,CSE 21,A01,095574,Bach; Quang Tran,22,0,48,26
1657627536165,CSE 30,A01,083084,Eldon; John,6,0,80,74
1657627536165,CSE 30,B01,095061,Bhaskar; Nishant,9,0,50,41
1657627542188,CSE 100,A01,083659,Cao; Yingjun,5,4,70,65
1657627548228,CSE 134B,A01,083661,Powell; Thomas Allan,22,0,100,78
1657627554254,CSE 140,A01,083663,Gungor; Onat,15,0,85,70
1657627560287,CSE 140L,A01,083088,Eldon; John,21,0,100,79
1657627566314,CSE 175,A01,083665,Kumar; Rakesh,3,0,25,22
1657627572340,CSE 190,A00,092507,Dubnov; Shlomo,8,0,20,12
1657627578368,ECE 45,A01,083139,Congero; Spencer William,6,0,75,69
1657627584395,ECE 65,A50,083695,Saad; Andrew S,12,0,30,18
1657627584395,ECE 65,A51,095125,Saad; Andrew S,24,0,26,2
1657627590421,ECE 109,A01,091882,Touri; Behrouz,19,0,70,51
1657627596446,ECE 180,A00,083140,Abi Samra; Nicholas Camill,1,0,30,29
1657627596446,ECE 180,B00,083141,Abi Samra; Nicholas Camill,0,0,30,30
1657627602475,MATH 10A,A01,083735,Patchell; Gregory David,2,0,30,28
1657627602475,MATH 10A,A02,083736,Patchell; Gregory David,20,0,30,10
1657627602475,MATH 10A,A03,083737,Patchell; Gregory David,16,0,30,14
1657627608508,MATH 10B,A01,083207,Lim; Seonhee,8,0,34,26
1657627608508,MATH 10B,A02,083208,Lim; Seonhee,9,0,35,26
1657627608508,MATH 10B,A03,093472,Lim; Seonhee,7,0,34,27
1657627608508,MATH 10B,B01,083739,Sinha; Shubham,12,0,30,18
1657627614537,MATH 18,A01,083743,Cinel; Cameron Alexander,7,0,30,23
1657627614537,MATH 18,A02,083744,Cinel; Cameron Alexander,17,0,30,13
1657627614537,MATH 18,A03,083745,Cinel; Cameron Alexander,9,0,30,21
1657627614537,MATH 18,B01,083748,Rideout; David Porter,5,0,37,32
1657627614537,MATH 18,B02,083749,Rideout; David Porter,5,0,36,31
1657627614537,MATH 18,B03,083750,Rideout; David Porter,3,0,37,34
1657627614537,MATH 18,B04,083751,Rideout; David Porter,6,0,36,30
1657627614537,MATH 18,B05,093473,Rideout; David Porter,6,0,36,30
1657627614537,MATH 18,B06,093474,Rideout; David Porter,6,0,36,30
1657627620568,MATH 20A,A01,083754,Zheng; Zequn,14,0,40,26
1657627626599,MATH 20B,A01,083756,Briones; Jor-el Thomas Caparas,4,0,36,32
1657627626599,MATH 20B,A02,083757,Briones; Jor-el Thomas Caparas,1,0,36,35
1657627626599,MATH 20B,A03,093475,Briones; Jor-el Thomas Caparas,2,0,36,34
1657627632637,MATH 20C,A01,083760,Briones; Jor-el Thomas Caparas,1,0,35,34
1657627632637,MATH 20C,A02,083761,Briones; Jor-el Thomas Caparas,8,0,35,27
1657627632637,MATH 20C,A03,093476,Briones; Jor-el Thomas Caparas,0,1,36,36
1657627632637,MATH 20C,B01,083762,Bach; Quang Tran,1,0,30,29
1657627638666,MATH 20D,A01,083765,Tran; Brian Kha,5,0,30,25
1657627638666,MATH 20D,A02,083766,Tran; Brian Kha,5,0,30,25
1657627638666,MATH 20D,A03,083767,Tran; Brian Kha,5,0,30,25
1657627644695,MATH 20E,A01,083771,Ganguly; Soumya,9,0,32,23
1657627644695,MATH 20E,A02,083772,Ganguly; Soumya,6,0,32,26
1657627644695,MATH 20E,B01,083773,Ciotti; Benjamin,20,0,35,15
1657627644695,MATH 20E,B02,083774,Ciotti; Benjamin,18,0,35,17
1657627650720,MATH 103A,A01,083777,Greenfeld; Be'Eri,3,0,36,33
1657627650720,MATH 103A,A02,083778,Greenfeld; Be'Eri,5,0,36,31
1657627650720,MATH 103A,A03,093561,Greenfeld; Be'Eri,6,0,36,30
1657627650720,MATH 103A,B01,083779,Greenfeld; Be'Eri,7,0,36,29
1657627650720,MATH 103A,B02,083780,Greenfeld; Be'Eri,4,0,36,32
1657627650720,MATH 103A,B03,093562,Greenfeld; Be'Eri,3,0,36,33
1657627656749,MATH 105,A01,085443,Carter; Anne Toulson,15,0,35,20
1657627656749,MATH 105,A02,093477,Carter; Anne Toulson,20,0,35,15
1657627662779,MATH 109,A01,083213,Ganzberger; Geoffrey Michael,2,0,34,32
1657627662779,MATH 109,A02,083214,Ganzberger; Geoffrey Michael,4,0,34,30
1657627662779,MATH 109,A03,093478,Ganzberger; Geoffrey Michael,2,0,34,32
1657627662779,MATH 109,B01,083215,Ganzberger; Geoffrey Michael,1,0,32,31
1657627662779,MATH 109,B02,083216,Ganzberger; Geoffrey Michael,2,0,32,30
1657627662779,MATH 109,B03,093479,Ganzberger; Geoffrey Michael,8,0,32,24
1657627668806,MATH 142A,A01,083219,Chow; Bennett,7,0,32,25
1657627668806,MATH 142A,A02,083220,Chow; Bennett,10,0,32,22
1657627668806,MATH 142A,A03,093480,Chow; Bennett,9,0,32,23
1657627668806,MATH 142A,B03,093481,Chow; Bennett,8,0,32,24
1657627668806,MATH 142A,B04,093558,Chow; Bennett,13,0,32,19
1657627668806,MATH 142A,B05,093559,Chow; Bennett,6,0,32,26
1657627674831,MATH 193A,A01,083224,Rotar; Vladimir,8,0,34,26
1657627674831,MATH 193A,A02,083225,Rotar; Vladimir,9,0,34,25
1657627674831,MATH 193A,A03,083781,Rotar; Vladimir,5,0,34,29
1657627674831,MATH 193A,A04,083782,Rotar; Vladimir,10,0,34,24
1657627674831,MATH 193A,A05,093482,Rotar; Vladimir,10,0,34,24
1657627680862,MATH 197,001,091859,McAuley; Julian John,9999,0,9999,0
1657627680862,MATH 197,002,095566,Kedlaya; Kiran S.,9997,0,9999,2
1657627680862,MATH 197,003,095567,Xiao; Ming,9999,0,9999,0
1657627680862,MATH 197,004,095571,Perols; Johan Lars,9998,0,9999,1
1657627687915,COGS 9,A01,083615,Shannon; Kyle Michael,9,0,75,66
1657627693947,COGS 11,A01,083617,Boyle; Mary E. T.,23,0,48,25
1657627699971,COGS 13,A01,083071,Bastos; Amalia Pinkusfeld,11,0,71,60
1657627706006,COGS 14A,A01,092681,Semenuks; Arturs,5,1,100,95
1657627712038,COGS 14B,A01,083073,Cheng; Tzu-Han,6,0,63,57
1657627718061,COGS 17,A01,092677,Semenuks; Arturs,6,0,81,75
1657627724088,COGS 100,A01,083619,Allen; Michael Gordon,17,0,70,53
1657627730117,COGS 101A,A01,083621,Davis; Joshua Daniel,9,0,68,59
1657627736150,COGS 101B,A01,091572,Allen; Michael Gordon,12,0,65,53
1657627742178,COGS 101C,A01,083625,Delgado; Tania,17,0,35,18
1657627748202,COGS 107A,A01,083627,Boyle; Mary E. T.,13,0,60,47
1657627754228,COGS 118A,A01,083075,Gupta; Anjum,21,0,76,55
1657627760257,CSE 3,A50,083646,Miranda; Gregory Joseph,24,0,50,26
1657627767652,CSE 8A,A50,083650,Miranda; Gregory Joseph,17,1,56,39
1657627773675,CSE 11,A01,083080,Cao; Yingjun,6,15,40,34
1657627779707,CSE 12,A01,083652,Krause-Levy; Sophia Louisa,28,1,120,92
1657627785733,CSE 15L,A01,083654,Morris; Justin Loren,9,0,50,41
1657627785733,CSE 15L,A02,083655,Morris; Justin Loren,9,0,50,41
1657627791757,CSE 20,A01,083657,Tran; Khoa Dang,39,0,80,41
1657627797782,CSE 21,A01,095574,Bach; Quang Tran,22,0,48,26
1657627803809,CSE 30,A01,083084,Eldon; John,6,0,80,74
1657627803809,CSE 30,B01,095061,Bhaskar; Nishant,9,0,50,41
1657627809833,CSE 100,A01,083659,Cao; Yingjun,5,4,70,65
1657627815859,CSE 134B,A01,083661,Powell; Thomas Allan,22,0,100,78
1657627821883,CSE 140,A01,083663,Gungor; Onat,15,0,85,70
1657627827916,CSE 140L,A01,083088,Eldon; John,21,0,100,79
1657627833939,CSE 175,A01,083665,Kumar; Rakesh,3,0,25,22
1657627839964,CSE 190,A00,092507,Dubnov; Shlomo,8,0,20,12
1657627845997,ECE 45,A01,083139,Congero; Spencer William,6,0,75,69
1657627852023,ECE 65,A50,083695,Saad; Andrew S,12,0,30,18
1657627852023,ECE 65,A51,095125,Saad; Andrew S,24,0,26,2
1657627858051,ECE 109,A01,091882,Touri; Behrouz,19,0,70,51
1657627864076,ECE 180,A00,083140,Abi Samra; Nicholas Camill,1,0,30,29
1657627864076,ECE 180,B00,083141,Abi Samra; Nicholas Camill,0,0,30,30
1657627870101,MATH 10A,A01,083735,Patchell; Gregory David,2,0,30,28
1657627870101,MATH 10A,A02,083736,Patchell; Gregory David,20,0,30,10
1657627870101,MATH 10A,A03,083737,Patchell; Gregory David,16,0,30,14
1657627876129,MATH 10B,A01,083207,Lim; Seonhee,8,0,34,26
1657627876129,MATH 10B,A02,083208,Lim; Seonhee,9,0,35,26
1657627876129,MATH 10B,A03,093472,Lim; Seonhee,7,0,34,27
1657627876129,MATH 10B,B01,083739,Sinha; Shubham,12,0,30,18
1657627882162,MATH 18,A01,083743,Cinel; Cameron Alexander,7,0,30,23
1657627882162,MATH 18,A02,083744,Cinel; Cameron Alexander,17,0,30,13
1657627882162,MATH 18,A03,083745,Cinel; Cameron Alexander,9,0,30,21
1657627882162,MATH 18,B01,083748,Rideout; David Porter,5,0,37,32
1657627882162,MATH 18,B02,083749,Rideout; David Porter,5,0,36,31
1657627882162,MATH 18,B03,083750,Rideout; David Porter,3,0,37,34
1657627882162,MATH 18,B04,083751,Rideout; David Porter,6,0,36,30
1657627882162,MATH 18,B05,093473,Rideout; David Porter,6,0,36,30
1657627882162,MATH 18,B06,093474,Rideout; David Porter,6,0,36,30
1657627888197,MATH 20A,A01,083754,Zheng; Zequn,14,0,40,26
1657627894222,MATH 20B,A01,083756,Briones; Jor-el Thomas Caparas,4,0,36,32
1657627894222,MATH 20B,A02,083757,Briones; Jor-el Thomas Caparas,1,0,36,35
1657627894222,MATH 20B,A03,093475,Briones; Jor-el Thomas Caparas,2,0,36,34
1657627900252,MATH 20C,A01,083760,Briones; Jor-el Thomas Caparas,1,0,35,34
1657627900252,MATH 20C,A02,083761,Briones; Jor-el Thomas Caparas,8,0,35,27
1657627900252,MATH 20C,A03,093476,Briones; Jor-el Thomas Caparas,0,1,36,36
1657627900252,MATH 20C,B01,083762,Bach; Quang Tran,1,0,30,29
1657627906279,MATH 20D,A01,083765,Tran; Brian Kha,5,0,30,25
1657627906279,MATH 20D,A02,083766,Tran; Brian Kha,5,0,30,25
1657627906279,MATH 20D,A03,083767,Tran; Brian Kha,5,0,30,25
1657627912306,MATH 20E,A01,083771,Ganguly; Soumya,9,0,32,23
1657627912306,MATH 20E,A02,083772,Ganguly; Soumya,6,0,32,26
1657627912306,MATH 20E,B01,083773,Ciotti; Benjamin,20,0,35,15
1657627912306,MATH 20E,B02,083774,Ciotti; Benjamin,18,0,35,17
1657627918337,MATH 103A,A01,083777,Greenfeld; Be'Eri,3,0,36,33
1657627918337,MATH 103A,A02,083778,Greenfeld; Be'Eri,5,0,36,31
1657627918337,MATH 103A,A03,093561,Greenfeld; Be'Eri,6,0,36,30
1657627918337,MATH 103A,B01,083779,Greenfeld; Be'Eri,7,0,36,29
1657627918337,MATH 103A,B02,083780,Greenfeld; Be'Eri,4,0,36,32
1657627918337,MATH 103A,B03,093562,Greenfeld; Be'Eri,3,0,36,33
1657627924365,MATH 105,A01,085443,Carter; Anne Toulson,15,0,35,20
1657627924365,MATH 105,A02,093477,Carter; Anne Toulson,20,0,35,15
1657627930391,MATH 109,A01,083213,Ganzberger; Geoffrey Michael,2,0,34,32
1657627930391,MATH 109,A02,083214,Ganzberger; Geoffrey Michael,4,0,34,30
1657627930391,MATH 109,A03,093478,Ganzberger; Geoffrey Michael,2,0,34,32
1657627930391,MATH 109,B01,083215,Ganzberger; Geoffrey Michael,1,0,32,31
1657627930391,MATH 109,B02,083216,Ganzberger; Geoffrey Michael,2,0,32,30
1657627930391,MATH 109,B03,093479,Ganzberger; Geoffrey Michael,8,0,32,24
1657627936420,MATH 142A,A01,083219,Chow; Bennett,7,0,32,25
1657627936420,MATH 142A,A02,083220,Chow; Bennett,10,0,32,22
1657627936420,MATH 142A,A03,093480,Chow; Bennett,9,0,32,23
1657627936420,MATH 142A,B03,093481,Chow; Bennett,8,0,32,24
1657627936420,MATH 142A,B04,093558,Chow; Bennett,13,0,32,19
1657627936420,MATH 142A,B05,093559,Chow; Bennett,6,0,32,26
1657627942445,MATH 193A,A01,083224,Rotar; Vladimir,8,0,34,26
1657627942445,MATH 193A,A02,083225,Rotar; Vladimir,9,0,34,25
1657627942445,MATH 193A,A03,083781,Rotar; Vladimir,5,0,34,29
1657627942445,MATH 193A,A04,083782,Rotar; Vladimir,10,0,34,24
1657627942445,MATH 193A,A05,093482,Rotar; Vladimir,10,0,34,24
1657627948483,MATH 197,001,091859,McAuley; Julian John,9999,0,9999,0
1657627948483,MATH 197,002,095566,Kedlaya; Kiran S.,9997,0,9999,2
1657627948483,MATH 197,003,095567,Xiao; Ming,9999,0,9999,0
1657627948483,MATH 197,004,095571,Perols; Johan Lars,9998,0,9999,1
1657627955547,COGS 9,A01,083615,Shannon; Kyle Michael,9,0,75,66
1657627961572,COGS 11,A01,083617,Boyle; Mary E. T.,23,0,48,25
1657627967598,COGS 13,A01,083071,Bastos; Amalia Pinkusfeld,11,0,71,60
1657627973632,COGS 14A,A01,092681,Semenuks; Arturs,5,1,100,95
1657627979657,COGS 14B,A01,083073,Cheng; Tzu-Han,6,0,63,57
1657627985683,COGS 17,A01,092677,Semenuks; Arturs,6,0,81,75
1657627991802,COGS 100,A01,083619,Allen; Michael Gordon,17,0,70,53
1657627997827,COGS 101A,A01,083621,Davis; Joshua Daniel,9,0,68,59
1657628003855,COGS 101B,A01,091572,Allen; Michael Gordon,12,0,65,53
1657628009897,COGS 101C,A01,083625,Delgado; Tania,17,0,35,18
1657628015933,COGS 107A,A01,083627,Boyle; Mary E. T.,13,0,60,47
1657628021968,COGS 118A,A01,083075,Gupta; Anjum,21,0,76,55
1657628028007,CSE 3,A50,083646,Miranda; Gregory Joseph,24,0,50,26
1657628034032,CSE 8A,A50,083650,Miranda; Gregory Joseph,17,1,56,39
1657628040056,CSE 11,A01,083080,Cao; Yingjun,6,15,40,34
1657628046079,CSE 12,A01,083652,Krause-Levy; Sophia Louisa,28,1,120,92
1657628052103,CSE 15L,A01,083654,Morris; Justin Loren,9,0,50,41
1657628052103,CSE 15L,A02,083655,Morris; Justin Loren,9,0,50,41
1657628058132,CSE 20,A01,083657,Tran; Khoa Dang,39,0,80,41
1657628064160,CSE 21,A01,095574,Bach; Quang Tran,22,0,48,26
1657628070190,CSE 30,A01,083084,Eldon; John,6,0,80,74
1657628070190,CSE 30,B01,095061,Bhaskar; Nishant,9,0,50,41
1657628076224,CSE 100,A01,083659,Cao; Yingjun,5,4,70,65
1657628082263,CSE 134B,A01,083661,Powell; Thomas Allan,22,0,100,78
1657628088293,CSE 140,A01,083663,Gungor; Onat,15,0,85,70
1657628094318,CSE 140L,A01,083088,Eldon; John,21,0,100,79
1657628100342,CSE 175,A01,083665,Kumar; Rakesh,3,0,25,22
1657628106366,CSE 190,A00,092507,Dubnov; Shlomo,8,0,20,12
1657628112390,ECE 45,A01,083139,Congero; Spencer William,6,0,75,69
1657628118418,ECE 65,A50,083695,Saad; Andrew S,12,0,30,18
1657628118418,ECE 65,A51,095125,Saad; Andrew S,24,0,26,2
1657628124444,ECE 109,A01,091882,Touri; Behrouz,19,0,70,51
1657628130472,ECE 180,A00,083140,Abi Samra; Nicholas Camill,1,0,30,29
1657628130472,ECE 180,B00,083141,Abi Samra; Nicholas Camill,0,0,30,30
1657628136497,MATH 10A,A01,083735,Patchell; Gregory David,2,0,30,28
1657628136497,MATH 10A,A02,083736,Patchell; Gregory David,20,0,30,10
1657628136497,MATH 10A,A03,083737,Patchell; Gregory David,16,0,30,14
1657628142522,MATH 10B,A01,083207,Lim; Seonhee,8,0,34,26
1657628142522,MATH 10B,A02,083208,Lim; Seonhee,9,0,35,26
1657628142522,MATH 10B,A03,093472,Lim; Seonhee,7,0,34,27
1657628142522,MATH 10B,B01,083739,Sinha; Shubham,12,0,30,18
1657628148553,MATH 18,A01,083743,Cinel; Cameron Alexander,7,0,30,23
1657628148553,MATH 18,A02,083744,Cinel; Cameron Alexander,17,0,30,13
1657628148553,MATH 18,A03,083745,Cinel; Cameron Alexander,9,0,30,21
1657628148553,MATH 18,B01,083748,Rideout; David Porter,5,0,37,32
1657628148553,MATH 18,B02,083749,Rideout; David Porter,5,0,36,31
1657628148553,MATH 18,B03,083750,Rideout; David Porter,3,0,37,34
1657628148553,MATH 18,B04,083751,Rideout; David Porter,6,0,36,30
1657628148553,MATH 18,B05,093473,Rideout; David Porter,6,0,36,30
1657628148553,MATH 18,B06,093474,Rideout; David Porter,6,0,36,30
1657628154584,MATH 20A,A01,083754,Zheng; Zequn,14,0,40,26
1657628160611,MATH 20B,A01,083756,Briones; Jor-el Thomas Caparas,4,0,36,32
1657628160611,MATH 20B,A02,083757,Briones; Jor-el Thomas Caparas,1,0,36,35
1657628160611,MATH 20B,A03,093475,Briones; Jor-el Thomas Caparas,2,0,36,34
1657628166635,MATH 20C,A01,083760,Briones; Jor-el Thomas Caparas,1,0,35,34
1657628166635,MATH 20C,A02,083761,Briones; Jor-el Thomas Caparas,8,0,35,27
1657628166635,MATH 20C,A03,093476,Briones; Jor-el Thomas Caparas,0,1,36,36
1657628166635,MATH 20C,B01,083762,Bach; Quang Tran,1,0,30,29
1657628172664,MATH 20D,A01,083765,Tran; Brian Kha,5,0,30,25
1657628172664,MATH 20D,A02,083766,Tran; Brian Kha,5,0,30,25
1657628172664,MATH 20D,A03,083767,Tran; Brian Kha,5,0,30,25
1657628178690,MATH 20E,A01,083771,Ganguly; Soumya,9,0,32,23
1657628178690,MATH 20E,A02,083772,Ganguly; Soumya,6,0,32,26
1657628178690,MATH 20E,B01,083773,Ciotti; Benjamin,20,0,35,15
1657628178690,MATH 20E,B02,083774,Ciotti; Benjamin,18,0,35,17
1657628184724,MATH 103A,A01,083777,Greenfeld; Be'Eri,3,0,36,33
1657628184724,MATH 103A,A02,083778,Greenfeld; Be'Eri,5,0,36,31
1657628184724,MATH 103A,A03,093561,Greenfeld; Be'Eri,6,0,36,30
1657628184724,MATH 103A,B01,083779,Greenfeld; Be'Eri,7,0,36,29
1657628184724,MATH 103A,B02,083780,Greenfeld; Be'Eri,4,0,36,32
1657628184724,MATH 103A,B03,093562,Greenfeld; Be'Eri,3,0,36,33
1657628190760,MATH 105,A01,085443,Carter; Anne Toulson,15,0,35,20
1657628190760,MATH 105,A02,093477,Carter; Anne Toulson,20,0,35,15
1657628196788,MATH 109,A01,083213,Ganzberger; Geoffrey Michael,2,0,34,32
1657628196788,MATH 109,A02,083214,Ganzberger; Geoffrey Michael,4,0,34,30
1657628196788,MATH 109,A03,093478,Ganzberger; Geoffrey Michael,2,0,34,32
1657628196788,MATH 109,B01,083215,Ganzberger; Geoffrey Michael,1,0,32,31
1657628196788,MATH 109,B02,083216,Ganzberger; Geoffrey Michael,2,0,32,30
1657628196788,MATH 109,B03,093479,Ganzberger; Geoffrey Michael,8,0,32,24
1657628202818,MATH 142A,A01,083219,Chow; Bennett,7,0,32,25
1657628202818,MATH 142A,A02,083220,Chow; Bennett,10,0,32,22
1657628202818,MATH 142A,A03,093480,Chow; Bennett,9,0,32,23
1657628202818,MATH 142A,B03,093481,Chow; Bennett,8,0,32,24
1657628202818,MATH 142A,B04,093558,Chow; Bennett,13,0,32,19
1657628202818,MATH 142A,B05,093559,Chow; Bennett,6,0,32,26
1657628208844,MATH 193A,A01,083224,Rotar; Vladimir,8,0,34,26
1657628208844,MATH 193A,A02,083225,Rotar; Vladimir,9,0,34,25
1657628208844,MATH 193A,A03,083781,Rotar; Vladimir,5,0,34,29
1657628208844,MATH 193A,A04,083782,Rotar; Vladimir,10,0,34,24
1657628208844,MATH 193A,A05,093482,Rotar; Vladimir,10,0,34,24
1657628214872,MATH 197,001,091859,McAuley; Julian John,9999,0,9999,0
1657628214872,MATH 197,002,095566,Kedlaya; Kiran S.,9997,0,9999,2
1657628214872,MATH 197,003,095567,Xiao; Ming,9999,0,9999,0
1657628214872,MATH 197,004,095571,Perols; Johan Lars,9998,0,9999,1
1657628221943,COGS 9,A01,083615,Shannon; Kyle Michael,9,0,75,66
1657628227971,COGS 11,A01,083617,Boyle; Mary E. T.,23,0,48,25
1657628233996,COGS 13,A01,083071,Bastos; Amalia Pinkusfeld,11,0,71,60
1657628240023,COGS 14A,A01,092681,Semenuks; Arturs,5,1,100,95
1657628246046,COGS 14B,A01,083073,Cheng; Tzu-Han,6,0,63,57
1657628252074,COGS 17,A01,092677,Semenuks; Arturs,6,0,81,75
1657628258101,COGS 100,A01,083619,Allen; Michael Gordon,17,0,70,53
1657628264131,COGS 101A,A01,083621,Davis; Joshua Daniel,9,0,68,59
1657628270159,COGS 101B,A01,091572,Allen; Michael Gordon,12,0,65,53
1657628276185,COGS 101C,A01,083625,Delgado; Tania,17,0,35,18
1657628282215,COGS 107A,A01,083627,Boyle; Mary E. T.,13,0,60,47
1657628288252,COGS 118A,A01,083075,Gupta; Anjum,21,0,76,55
1657628294276,CSE 3,A50,083646,Miranda; Gregory Joseph,24,0,50,26
1657628300299,CSE 8A,A50,083650,Miranda; Gregory Joseph,17,1,56,39
1657628306323,CSE 11,A01,083080,Cao; Yingjun,6,15,40,34
1657628312349,CSE 12,A01,083652,Krause-Levy; Sophia Louisa,28,1,120,92
1657628318372,CSE 15L,A01,083654,Morris; Justin Loren,9,0,50,41
1657628318372,CSE 15L,A02,083655,Morris; Justin Loren,9,0,50,41
1657628324398,CSE 20,A01,083657,Tran; Khoa Dang,39,0,80,41
1657628330427,CSE 21,A01,095574,Bach; Quang Tran,22,0,48,26
1657628336451,CSE 30,A01,083084,Eldon; John,6,0,80,74
1657628336451,CSE 30,B01,095061,Bhaskar; Nishant,9,0,50,41
1657628342486,CSE 100,A01,083659,Cao; Yingjun,5,4,70,65
1657628348514,CSE 134B,A01,083661,Powell; Thomas Allan,22,0,100,78
1657628354545,CSE 140,A01,083663,Gungor; Onat,15,0,85,70
1657628360573,CSE 140L,A01,083088,Eldon; John,21,0,100,79
1657628366598,CSE 175,A01,083665,Kumar; Rakesh,3,0,25,22
1657628372621,CSE 190,A00,092507,Dubnov; Shlomo,8,0,20,12
1657628378651,ECE 45,A01,083139,Congero; Spencer William,6,0,75,69
1657628384677,ECE 65,A50,083695,Saad; Andrew S,12,0,30,18
1657628384677,ECE 65,A51,095125,Saad; Andrew S,24,0,26,2
1657628390701,ECE 109,A01,091882,Touri; Behrouz,19,0,70,51
1657628396738,ECE 180,A00,083140,Abi Samra; Nicholas Camill,1,0,30,29
1657628396738,ECE 180,B00,083141,Abi Samra; Nicholas Camill,0,0,30,30
1657628402770,MATH 10A,A01,083735,Patchell; Gregory David,2,0,30,28
1657628402770,MATH 10A,A02,083736,Patchell; Gregory David,20,0,30,10
1657628402770,MATH 10A,A03,083737,Patchell; Gregory David,16,0,30,14
1657628408794,MATH 10B,A01,083207,Lim; Seonhee,8,0,34,26
1657628408794,MATH 10B,A02,083208,Lim; Seonhee,9,0,35,26
1657628408794,MATH 10B,A03,093472,Lim; Seonhee,7,0,34,27
1657628408794,MATH 10B,B01,083739,Sinha; Shubham,12,0,30,18
1657628414826,MATH 18,A01,083743,Cinel; Cameron Alexander,7,0,30,23
1657628414826,MATH 18,A02,083744,Cinel; Cameron Alexander,17,0,30,13
1657628414826,MATH 18,A03,083745,Cinel; Cameron Alexander,9,0,30,21
1657628414826,MATH 18,B01,083748,Rideout; David Porter,5,0,37,32
1657628414826,MATH 18,B02,083749,Rideout; David Porter,5,0,36,31
1657628414826,MATH 18,B03,083750,Rideout; David Porter,3,0,37,34
1657628414826,MATH 18,B04,083751,Rideout; David Porter,6,0,36,30
1657628414826,MATH 18,B05,093473,Rideout; David Porter,6,0,36,30
1657628414826,MATH 18,B06,093474,Rideout; David Porter,6,0,36,30
1657628420851,MATH 20A,A01,083754,Zheng; Zequn,14,0,40,26
1657628426876,MATH 20B,A01,083756,Briones; Jor-el Thomas Caparas,4,0,36,32
1657628426876,MATH 20B,A02,083757,Briones; Jor-el Thomas Caparas,1,0,36,35
1657628426876,MATH 20B,A03,093475,Briones; Jor-el Thomas Caparas,2,0,36,34
1657628432907,MATH 20C,A01,083760,Briones; Jor-el Thomas Caparas,1,0,35,34
1657628432907,MATH 20C,A02,083761,Briones; Jor-el Thomas Caparas,8,0,35,27
1657628432907,MATH 20C,A03,093476,Briones; Jor-el Thomas Caparas,0,1,36,36
1657628432907,MATH 20C,B01,083762,Bach; Quang Tran,1,0,30,29
1657628438953,MATH 20D,A01,083765,Tran; Brian Kha,5,0,30,25
1657628438953,MATH 20D,A02,083766,Tran; Brian Kha,5,0,30,25
1657628438953,MATH 20D,A03,083767,Tran; Brian Kha,5,0,30,25
1657628444977,MATH 20E,A01,083771,Ganguly; Soumya,9,0,32,23
1657628444977,MATH 20E,A02,083772,Ganguly; Soumya,6,0,32,26
1657628444977,MATH 20E,B01,083773,Ciotti; Benjamin,20,0,35,15
1657628444977,MATH 20E,B02,083774,Ciotti; Benjamin,18,0,35,17
1657628451003,MATH 103A,A01,083777,Greenfeld; Be'Eri,3,0,36,33
1657628451003,MATH 103A,A02,083778,Greenfeld; Be'Eri,5,0,36,31
1657628451003,MATH 103A,A03,093561,Greenfeld; Be'Eri,6,0,36,30
1657628451003,MATH 103A,B01,083779,Greenfeld; Be'Eri,7,0,36,29
1657628451003,MATH 103A,B02,083780,Greenfeld; Be'Eri,4,0,36,32
1657628451003,MATH 103A,B03,093562,Greenfeld; Be'Eri,3,0,36,33
1657628457028,MATH 105,A01,085443,Carter; Anne Toulson,15,0,35,20
1657628457028,MATH 105,A02,093477,Carter; Anne Toulson,20,0,35,15
1657628463057,MATH 109,A01,083213,Ganzberger; Geoffrey Michael,2,0,34,32
1657628463057,MATH 109,A02,083214,Ganzberger; Geoffrey Michael,4,0,34,30
1657628463057,MATH 109,A03,093478,Ganzberger; Geoffrey Michael,2,0,34,32
1657628463057,MATH 109,B01,083215,Ganzberger; Geoffrey Michael,1,0,32,31
1657628463057,MATH 109,B02,083216,Ganzberger; Geoffrey Michael,2,0,32,30
1657628463057,MATH 109,B03,093479,Ganzberger; Geoffrey Michael,8,0,32,24
1657628469087,MATH 142A,A01,083219,Chow; Bennett,7,0,32,25
1657628469087,MATH 142A,A02,083220,Chow; Bennett,10,0,32,22
1657628469087,MATH 142A,A03,093480,Chow; Bennett,9,0,32,23
1657628469087,MATH 142A,B03,093481,Chow; Bennett,8,0,32,24
1657628469087,MATH 142A,B04,093558,Chow; Bennett,13,0,32,19
1657628469087,MATH 142A,B05,093559,Chow; Bennett,6,0,32,26
1657628475119,MATH 193A,A01,083224,Rotar; Vladimir,8,0,34,26
1657628475119,MATH 193A,A02,083225,Rotar; Vladimir,9,0,34,25
1657628475119,MATH 193A,A03,083781,Rotar; Vladimir,5,0,34,29
1657628475119,MATH 193A,A04,083782,Rotar; Vladimir,10,0,34,24
1657628475119,MATH 193A,A05,093482,Rotar; Vladimir,10,0,34,24
1657628481146,MATH 197,001,091859,McAuley; Julian John,9999,0,9999,0
1657628481146,MATH 197,002,095566,Kedlaya; Kiran S.,9997,0,9999,2
1657628481146,MATH 197,003,095567,Xiao; Ming,9999,0,9999,0
1657628481146,MATH 197,004,095571,Perols; Johan Lars,9998,0,9999,1
1657628488204,COGS 9,A01,083615,Shannon; Kyle Michael,9,0,75,66
1657628494232,COGS 11,A01,083617,Boyle; Mary E. T.,23,0,48,25
1657628500257,COGS 13,A01,083071,Bastos; Amalia Pinkusfeld,11,0,71,60
1657628506281,COGS 14A,A01,092681,Semenuks; Arturs,5,1,100,95
1657628512305,COGS 14B,A01,083073,Cheng; Tzu-Han,6,0,63,57
1657628518337,COGS 17,A01,092677,Semenuks; Arturs,6,0,81,75
1657628524361,COGS 100,A01,083619,Allen; Michael Gordon,17,0,70,53
1657628530387,COGS 101A,A01,083621,Davis; Joshua Daniel,9,0,68,59
1657628536412,COGS 101B,A01,091572,Allen; Michael Gordon,12,0,65,53
1657628542440,COGS 101C,A01,083625,Delgado; Tania,17,0,35,18
1657628548465,COGS 107A,A01,083627,Boyle; Mary E. T.,13,0,60,47
1657628554490,COGS 118A,A01,083075,Gupta; Anjum,21,0,76,55
1657628560518,CSE 3,A50,083646,Miranda; Gregory Joseph,24,0,50,26
1657628566544,CSE 8A,A50,083650,Miranda; Gregory Joseph,17,1,56,39
1657628572568,CSE 11,A01,083080,Cao; Yingjun,6,15,40,34
1657628578594,CSE 12,A01,083652,Krause-Levy; Sophia Louisa,28,1,120,92
1657628584621,CSE 15L,A01,083654,Morris; Justin Loren,9,0,50,41
1657628584621,CSE 15L,A02,083655,Morris; Justin Loren,9,0,50,41
1657628590745,CSE 20,A01,083657,Tran; Khoa Dang,39,0,80,41
1657628596774,CSE 21,A01,095574,Bach; Quang Tran,22,0,48,26
1657628602802,CSE 30,A01,083084,Eldon; John,6,0,80,74
1657628602802,CSE 30,B01,095061,Bhaskar; Nishant,9,0,50,41
1657628608830,CSE 100,A01,083659,Cao; Yingjun,5,4,70,65
1657628614864,CSE 134B,A01,083661,Powell; Thomas Allan,22,0,100,78
1657628620890,CSE 140,A01,083663,Gungor; Onat,15,0,85,70
1657628626924,CSE 140L,A01,083088,Eldon; John,21,0,100,79
1657628632955,CSE 175,A01,083665,Kumar; Rakesh,3,0,25,22
1657628638984,CSE 190,A00,092507,Dubnov; Shlomo,8,0,20,12
1657628645011,ECE 45,A01,083139,Congero; Spencer William,6,0,75,69
1657628651042,ECE 65,A50,083695,Saad; Andrew S,12,0,30,18
1657628651042,ECE 65,A51,095125,Saad; Andrew S,24,0,26,2
1657628657066,ECE 109,A01,091882,Touri; Behrouz,19,0,70,51
1657628663095,ECE 180,A00,083140,Abi Samra; Nicholas Camill,1,0,30,29
1657628663095,ECE 180,B00,083141,Abi Samra; Nicholas Camill,0,0,30,30
1657628669122,MATH 10A,A01,083735,Patchell; Gregory David,2,0,30,28
1657628669122,MATH 10A,A02,083736,Patchell; Gregory David,20,0,30,10
1657628669122,MATH 10A,A03,083737,Patchell; Gregory David,16,0,30,14
1657628675146,MATH 10B,A01,083207,Lim; Seonhee,8,0,34,26
1657628675146,MATH 10B,A02,083208,Lim; Seonhee,9,0,35,26
1657628675146,MATH 10B,A03,093472,Lim; Seonhee,7,0,34,27
1657628675146,MATH 10B,B01,083739,Sinha; Shubham,12,0,30,18
1657628681172,MATH 18,A01,083743,Cinel; Cameron Alexander,7,0,30,23
1657628681172,MATH 18,A02,083744,Cinel; Cameron Alexander,17,0,30,13
1657628681172,MATH 18,A03,083745,Cinel; Cameron Alexander,9,0,30,21
1657628681172,MATH 18,B01,083748,Rideout; David Porter,5,0,37,32
1657628681172,MATH 18,B02,083749,Rideout; David Porter,5,0,36,31
1657628681172,MATH 18,B03,083750,Rideout; David Porter,3,0,37,34
1657628681172,MATH 18,B04,083751,Rideout; David Porter,6,0,36,30
1657628681172,MATH 18,B05,093473,Rideout; David Porter,6,0,36,30
1657628681172,MATH 18,B06,093474,Rideout; David Porter,6,0,36,30
1657628687197,MATH 20A,A01,083754,Zheng; Zequn,14,0,40,26
1657628693220,MATH 20B,A01,083756,Briones; Jor-el Thomas Caparas,4,0,36,32
1657628693220,MATH 20B,A02,083757,Briones; Jor-el Thomas Caparas,1,0,36,35
1657628693220,MATH 20B,A03,093475,Briones; Jor-el Thomas Caparas,2,0,36,34
1657628699247,MATH 20C,A01,083760,Briones; Jor-el Thomas Caparas,1,0,35,34
1657628699247,MATH 20C,A02,083761,Briones; Jor-el Thomas Caparas,8,0,35,27
1657628699247,MATH 20C,A03,093476,Briones; Jor-el Thomas Caparas,0,1,36,36
1657628699247,MATH 20C,B01,083762,Bach; Quang Tran,1,0,30,29
1657628705281,MATH 20D,A01,083765,Tran; Brian Kha,5,0,30,25
1657628705281,MATH 20D,A02,083766,Tran; Brian Kha,5,0,30,25
1657628705281,MATH 20D,A03,083767,Tran; Brian Kha,5,0,30,25
1657628711305,MATH 20E,A01,083771,Ganguly; Soumya,9,0,32,23
1657628711305,MATH 20E,A02,083772,Ganguly; Soumya,6,0,32,26
1657628711305,MATH 20E,B01,083773,Ciotti; Benjamin,20,0,35,15
1657628711305,MATH 20E,B02,083774,Ciotti; Benjamin,18,0,35,17
1657628717337,MATH 103A,A01,083777,Greenfeld; Be'Eri,3,0,36,33
1657628717337,MATH 103A,A02,083778,Greenfeld; Be'Eri,5,0,36,31
1657628717337,MATH 103A,A03,093561,Greenfeld; Be'Eri,6,0,36,30
1657628717337,MATH 103A,B01,083779,Greenfeld; Be'Eri,7,0,36,29
1657628717337,MATH 103A,B02,083780,Greenfeld; Be'Eri,4,0,36,32
1657628717337,MATH 103A,B03,093562,Greenfeld; Be'Eri,3,0,36,33
1657628723366,MATH 105,A01,085443,Carter; Anne Toulson,15,0,35,20
1657628723366,MATH 105,A02,093477,Carter; Anne Toulson,20,0,35,15
1657628729392,MATH 109,A01,083213,Ganzberger; Geoffrey Michael,2,0,34,32
1657628729392,MATH 109,A02,083214,Ganzberger; Geoffrey Michael,4,0,34,30
1657628729392,MATH 109,A03,093478,Ganzberger; Geoffrey Michael,2,0,34,32
1657628729392,MATH 109,B01,083215,Ganzberger; Geoffrey Michael,1,0,32,31
1657628729392,MATH 109,B02,083216,Ganzberger; Geoffrey Michael,2,0,32,30
1657628729392,MATH 109,B03,093479,Ganzberger; Geoffrey Michael,8,0,32,24
1657628735423,MATH 142A,A01,083219,Chow; Bennett,7,0,32,25
1657628735423,MATH 142A,A02,083220,Chow; Bennett,10,0,32,22
1657628735423,MATH 142A,A03,093480,Chow; Bennett,9,0,32,23
1657628735423,MATH 142A,B03,093481,Chow; Bennett,8,0,32,24
1657628735423,MATH 142A,B04,093558,Chow; Bennett,13,0,32,19
1657628735423,MATH 142A,B05,093559,Chow; Bennett,6,0,32,26
1657628741460,MATH 193A,A01,083224,Rotar; Vladimir,8,0,34,26
1657628741460,MATH 193A,A02,083225,Rotar; Vladimir,9,0,34,25
1657628741460,MATH 193A,A03,083781,Rotar; Vladimir,5,0,34,29
1657628741460,MATH 193A,A04,083782,Rotar; Vladimir,10,0,34,24
1657628741460,MATH 193A,A05,093482,Rotar; Vladimir,10,0,34,24
1657628747488,MATH 197,001,091859,McAuley; Julian John,9999,0,9999,0
1657628747488,MATH 197,002,095566,Kedlaya; Kiran S.,9997,0,9999,2
1657628747488,MATH 197,003,095567,Xiao; Ming,9999,0,9999,0
1657628747488,MATH 197,004,095571,Perols; Johan Lars,9998,0,9999,1
1657628754569,COGS 9,A01,083615,Shannon; Kyle Michael,9,0,75,66
1657628760592,COGS 11,A01,083617,Boyle; Mary E. T.,23,0,48,25
1657628766627,COGS 13,A01,083071,Bastos; Amalia Pinkusfeld,11,0,71,60
1657628772653,COGS 14A,A01,092681,Semenuks; Arturs,5,1,100,95
1657628778684,COGS 14B,A01,083073,Cheng; Tzu-Han,6,0,63,57
1657628784709,COGS 17,A01,092677,Semenuks; Arturs,6,0,81,75
1657628790735,COGS 100,A01,083619,Allen; Michael Gordon,17,0,70,53
1657628796764,COGS 101A,A01,083621,Davis; Joshua Daniel,9,0,68,59
1657628802800,COGS 101B,A01,091572,Allen; Michael Gordon,12,0,65,53
1657628808826,COGS 101C,A01,083625,Delgado; Tania,17,0,35,18
1657628814854,COGS 107A,A01,083627,Boyle; Mary E. T.,13,0,60,47
1657628820879,COGS 118A,A01,083075,Gupta; Anjum,21,0,76,55
1657628826908,CSE 3,A50,083646,Miranda; Gregory Joseph,24,0,50,26
1657628832935,CSE 8A,A50,083650,Miranda; Gregory Joseph,17,1,56,39
1657628838961,CSE 11,A01,083080,Cao; Yingjun,6,15,40,34
1657628844990,CSE 12,A01,083652,Krause-Levy; Sophia Louisa,28,1,120,92
1657628851019,CSE 15L,A01,083654,Morris; Justin Loren,9,0,50,41
1657628851019,CSE 15L,A02,083655,Morris; Justin Loren,9,0,50,41
1657628857044,CSE 20,A01,083657,Tran; Khoa Dang,39,0,80,41
1657628863070,CSE 21,A01,095574,Bach; Quang Tran,22,0,48,26
1657628869094,CSE 30,A01,083084,Eldon; John,6,0,80,74
1657628869094,CSE 30,B01,095061,Bhaskar; Nishant,9,0,50,41
1657628875117,CSE 100,A01,083659,Cao; Yingjun,5,4,70,65
1657628881143,CSE 134B,A01,083661,Powell; Thomas Allan,22,0,100,78
1657628887170,CSE 140,A01,083663,Gungor; Onat,15,0,85,70
1657628893195,CSE 140L,A01,083088,Eldon; John,21,0,100,79
1657628899217,CSE 175,A01,083665,Kumar; Rakesh,3,0,25,22
1657628905241,CSE 190,A00,092507,Dubnov; Shlomo,8,0,20,12
1657628911269,ECE 45,A01,083139,Congero; Spencer William,6,0,75,69
1657628917295,ECE 65,A50,083695,Saad; Andrew S,12,0,30,18
1657628917295,ECE 65,A51,095125,Saad; Andrew S,24,0,26,2
1657628923320,ECE 109,A01,091882,Touri; Behrouz,19,0,70,51
1657628929347,ECE 180,A00,083140,Abi Samra; Nicholas Camill,1,0,30,29
1657628929347,ECE 180,B00,083141,Abi Samra; Nicholas Camill,0,0,30,30
1657628935372,MATH 10A,A01,083735,Patchell; Gregory David,2,0,30,28
1657628935372,MATH 10A,A02,083736,Patchell; Gregory David,20,0,30,10
1657628935372,MATH 10A,A03,083737,Patchell; Gregory David,16,0,30,14
1657628941397,MATH 10B,A01,083207,Lim; Seonhee,8,0,34,26
1657628941397,MATH 10B,A02,083208,Lim; Seonhee,9,0,35,26
1657628941397,MATH 10B,A03,093472,Lim; Seonhee,7,0,34,27
1657628941397,MATH 10B,B01,083739,Sinha; Shubham,12,0,30,18
1657628947428,MATH 18,A01,083743,Cinel; Cameron Alexander,7,0,30,23
1657628947428,MATH 18,A02,083744,Cinel; Cameron Alexander,17,0,30,13
1657628947428,MATH 18,A03,083745,Cinel; Cameron Alexander,9,0,30,21
1657628947428,MATH 18,B01,083748,Rideout; David Porter,5,0,37,32
1657628947428,MATH 18,B02,083749,Rideout; David Porter,5,0,36,31
1657628947428,MATH 18,B03,083750,Rideout; David Porter,3,0,37,34
1657628947428,MATH 18,B04,083751,Rideout; David Porter,6,0,36,30
1657628947428,MATH 18,B05,093473,Rideout; David Porter,6,0,36,30
1657628947428,MATH 18,B06,093474,Rideout; David Porter,6,0,36,30
1657628953453,MATH 20A,A01,083754,Zheng; Zequn,14,0,40,26
1657628959477,MATH 20B,A01,083756,Briones; Jor-el Thomas Caparas,4,0,36,32
1657628959477,MATH 20B,A02,083757,Briones; Jor-el Thomas Caparas,1,0,36,35
1657628959477,MATH 20B,A03,093475,Briones; Jor-el Thomas Caparas,2,0,36,34
1657628965504,MATH 20C,A01,083760,Briones; Jor-el Thomas Caparas,1,0,35,34
1657628965504,MATH 20C,A02,083761,Briones; Jor-el Thomas Caparas,8,0,35,27
1657628965504,MATH 20C,A03,093476,Briones; Jor-el Thomas Caparas,0,1,36,36
1657628965504,MATH 20C,B01,083762,Bach; Quang Tran,1,0,30,29
1657628971531,MATH 20D,A01,083765,Tran; Brian Kha,5,0,30,25
1657628971531,MATH 20D,A02,083766,Tran; Brian Kha,5,0,30,25
1657628971531,MATH 20D,A03,083767,Tran; Brian Kha,5,0,30,25
1657628977555,MATH 20E,A01,083771,Ganguly; Soumya,9,0,32,23
1657628977555,MATH 20E,A02,083772,Ganguly; Soumya,6,0,32,26
1657628977555,MATH 20E,B01,083773,Ciotti; Benjamin,20,0,35,15
1657628977555,MATH 20E,B02,083774,Ciotti; Benjamin,18,0,35,17
1657628983584,MATH 103A,A01,083777,Greenfeld; Be'Eri,3,0,36,33
1657628983584,MATH 103A,A02,083778,Greenfeld; Be'Eri,5,0,36,31
1657628983584,MATH 103A,A03,093561,Greenfeld; Be'Eri,6,0,36,30
1657628983584,MATH 103A,B01,083779,Greenfeld; Be'Eri,7,0,36,29
1657628983584,MATH 103A,B02,083780,Greenfeld; Be'Eri,4,0,36,32
1657628983584,MATH 103A,B03,093562,Greenfeld; Be'Eri,3,0,36,33
1657628989611,MATH 105,A01,085443,Carter; Anne Toulson,15,0,35,20
1657628989611,MATH 105,A02,093477,Carter; Anne Toulson,20,0,35,15
1657628995640,MATH 109,A01,083213,Ganzberger; Geoffrey Michael,2,0,34,32
1657628995640,MATH 109,A02,083214,Ganzberger; Geoffrey Michael,4,0,34,30
1657628995640,MATH 109,A03,093478,Ganzberger; Geoffrey Michael,2,0,34,32
1657628995640,MATH 109,B01,083215,Ganzberger; Geoffrey Michael,1,0,32,31
1657628995640,MATH 109,B02,083216,Ganzberger; Geoffrey Michael,2,0,32,30
1657628995640,MATH 109,B03,093479,Ganzberger; Geoffrey Michael,8,0,32,24
1657629001670,MATH 142A,A01,083219,Chow; Bennett,7,0,32,25
1657629001670,MATH 142A,A02,083220,Chow; Bennett,10,0,32,22
1657629001670,MATH 142A,A03,093480,Chow; Bennett,9,0,32,23
1657629001670,MATH 142A,B03,093481,Chow; Bennett,8,0,32,24
1657629001670,MATH 142A,B04,093558,Chow; Bennett,13,0,32,19
1657629001670,MATH 142A,B05,093559,Chow; Bennett,6,0,32,26
1657629007695,MATH 193A,A01,083224,Rotar; Vladimir,8,0,34,26
1657629007695,MATH 193A,A02,083225,Rotar; Vladimir,9,0,34,25
1657629007695,MATH 193A,A03,083781,Rotar; Vladimir,5,0,34,29
1657629007695,MATH 193A,A04,083782,Rotar; Vladimir,10,0,34,24
1657629007695,MATH 193A,A05,093482,Rotar; Vladimir,10,0,34,24
1657629013717,MATH 197,001,091859,McAuley; Julian John,9999,0,9999,0
1657629013717,MATH 197,002,095566,Kedlaya; Kiran S.,9997,0,9999,2
1657629013717,MATH 197,003,095567,Xiao; Ming,9999,0,9999,0
1657629013717,MATH 197,004,095571,Perols; Johan Lars,9998,0,9999,1
1657629020771,COGS 9,A01,083615,Shannon; Kyle Michael,9,0,75,66
1657629026804,COGS 11,A01,083617,Boyle; Mary E. T.,23,0,48,25
1657629032829,COGS 13,A01,083071,Bastos; Amalia Pinkusfeld,11,0,71,60
1657629038857,COGS 14A,A01,092681,Semenuks; Arturs,5,1,100,95
1657629044883,COGS 14B,A01,083073,Cheng; Tzu-Han,6,0,63,57
1657629050907,COGS 17,A01,092677,Semenuks; Arturs,6,0,81,75
1657629056931,COGS 100,A01,083619,Allen; Michael Gordon,17,0,70,53
1657629062954,COGS 101A,A01,083621,Davis; Joshua Daniel,9,0,68,59
1657629068981,COGS 101B,A01,091572,Allen; Michael Gordon,12,0,65,53
1657629075005,COGS 101C,A01,083625,Delgado; Tania,17,0,35,18
1657629081035,COGS 107A,A01,083627,Boyle; Mary E. T.,13,0,60,47
1657629087064,COGS 118A,A01,083075,Gupta; Anjum,21,0,76,55
1657629093089,CSE 3,A50,083646,Miranda; Gregory Joseph,24,0,50,26
1657629099114,CSE 8A,A50,083650,Miranda; Gregory Joseph,17,1,56,39
1657629105139,CSE 11,A01,083080,Cao; Yingjun,6,15,40,34
1657629111168,CSE 12,A01,083652,Krause-Levy; Sophia Louisa,28,1,120,92
1657629117198,CSE 15L,A01,083654,Morris; Justin Loren,9,0,50,41
1657629117198,CSE 15L,A02,083655,Morris; Justin Loren,9,0,50,41
1657629123225,CSE 20,A01,083657,Tran; Khoa Dang,39,0,80,41
1657629129249,CSE 21,A01,095574,Bach; Quang Tran,22,0,48,26
1657629135275,CSE 30,A01,083084,Eldon; John,6,0,80,74
1657629135275,CSE 30,B01,095061,Bhaskar; Nishant,9,0,50,41
1657629141299,CSE 100,A01,083659,Cao; Yingjun,5,4,70,65
1657629147328,CSE 134B,A01,083661,Powell; Thomas Allan,22,0,100,78
1657629153356,CSE 140,A01,083663,Gungor; Onat,15,0,85,70
1657629159385,CSE 140L,A01,083088,Eldon; John,21,0,100,79
1657629165413,CSE 175,A01,083665,Kumar; Rakesh,3,0,25,22
1657629171447,CSE 190,A00,092507,Dubnov; Shlomo,8,0,20,12
1657629177475,ECE 45,A01,083139,Congero; Spencer William,6,0,75,69
1657629183501,ECE 65,A50,083695,Saad; Andrew S,12,0,30,18
1657629183501,ECE 65,A51,095125,Saad; Andrew S,24,0,26,2
1657629189601,ECE 109,A01,091882,Touri; Behrouz,19,0,70,51
1657629195628,ECE 180,A00,083140,Abi Samra; Nicholas Camill,1,0,30,29
1657629195628,ECE 180,B00,083141,Abi Samra; Nicholas Camill,0,0,30,30
1657629201652,MATH 10A,A01,083735,Patchell; Gregory David,2,0,30,28
1657629201652,MATH 10A,A02,083736,Patchell; Gregory David,20,0,30,10
1657629201652,MATH 10A,A03,083737,Patchell; Gregory David,16,0,30,14
1657629207681,MATH 10B,A01,083207,Lim; Seonhee,8,0,34,26
1657629207681,MATH 10B,A02,083208,Lim; Seonhee,9,0,35,26
1657629207681,MATH 10B,A03,093472,Lim; Seonhee,7,0,34,27
1657629207681,MATH 10B,B01,083739,Sinha; Shubham,12,0,30,18
1657629213705,MATH 18,A01,083743,Cinel; Cameron Alexander,7,0,30,23
1657629213705,MATH 18,A02,083744,Cinel; Cameron Alexander,17,0,30,13
1657629213705,MATH 18,A03,083745,Cinel; Cameron Alexander,9,0,30,21
1657629213705,MATH 18,B01,083748,Rideout; David Porter,5,0,37,32
1657629213705,MATH 18,B02,083749,Rideout; David Porter,5,0,36,31
1657629213705,MATH 18,B03,083750,Rideout; David Porter,3,0,37,34
1657629213705,MATH 18,B04,083751,Rideout; David Porter,6,0,36,30
1657629213705,MATH 18,B05,093473,Rideout; David Porter,6,0,36,30
1657629213705,MATH 18,B06,093474,Rideout; David Porter,6,0,36,30
1657629219731,MATH 20A,A01,083754,Zheng; Zequn,14,0,40,26
1657629225760,MATH 20B,A01,083756,Briones; Jor-el Thomas Caparas,4,0,36,32
1657629225760,MATH 20B,A02,083757,Briones; Jor-el Thomas Caparas,1,0,36,35
1657629225760,MATH 20B,A03,093475,Briones; Jor-el Thomas Caparas,2,0,36,34
1657629231784,MATH 20C,A01,083760,Briones; Jor-el Thomas Caparas,1,0,35,34
1657629231784,MATH 20C,A02,083761,Briones; Jor-el Thomas Caparas,8,0,35,27
1657629231784,MATH 20C,A03,093476,Briones; Jor-el Thomas Caparas,0,1,36,36
1657629231784,MATH 20C,B01,083762,Bach; Quang Tran,1,0,30,29
1657629237812,MATH 20D,A01,083765,Tran; Brian Kha,5,0,30,25
1657629237812,MATH 20D,A02,083766,Tran; Brian Kha,5,0,30,25
1657629237812,MATH 20D,A03,083767,Tran; Brian Kha,5,0,30,25
1657629243838,MATH 20E,A01,083771,Ganguly; Soumya,9,0,32,23
1657629243838,MATH 20E,A02,083772,Ganguly; Soumya,6,0,32,26
1657629243838,MATH 20E,B01,083773,Ciotti; Benjamin,20,0,35,15
1657629243838,MATH 20E,B02,083774,Ciotti; Benjamin,18,0,35,17
1657629249868,MATH 103A,A01,083777,Greenfeld; Be'Eri,3,0,36,33
1657629249868,MATH 103A,A02,083778,Greenfeld; Be'Eri,5,0,36,31
1657629249868,MATH 103A,A03,093561,Greenfeld; Be'Eri,6,0,36,30
1657629249868,MATH 103A,B01,083779,Greenfeld; Be'Eri,7,0,36,29
1657629249868,MATH 103A,B02,083780,Greenfeld; Be'Eri,4,0,36,32
1657629249868,MATH 103A,B03,093562,Greenfeld; Be'Eri,3,0,36,33
1657629255895,MATH 105,A01,085443,Carter; Anne Toulson,15,0,35,20
1657629255895,MATH 105,A02,093477,Carter; Anne Toulson,20,0,35,15
1657629261921,MATH 109,A01,083213,Ganzberger; Geoffrey Michael,2,0,34,32
1657629261921,MATH 109,A02,083214,Ganzberger; Geoffrey Michael,4,0,34,30
1657629261921,MATH 109,A03,093478,Ganzberger; Geoffrey Michael,2,0,34,32
1657629261921,MATH 109,B01,083215,Ganzberger; Geoffrey Michael,1,0,32,31
1657629261921,MATH 109,B02,083216,Ganzberger; Geoffrey Michael,2,0,32,30
1657629261921,MATH 109,B03,093479,Ganzberger; Geoffrey Michael,8,0,32,24
1657629267948,MATH 142A,A01,083219,Chow; Bennett,7,0,32,25
1657629267948,MATH 142A,A02,083220,Chow; Bennett,10,0,32,22
1657629267948,MATH 142A,A03,093480,Chow; Bennett,9,0,32,23
1657629267948,MATH 142A,B03,093481,Chow; Bennett,8,0,32,24
1657629267948,MATH 142A,B04,093558,Chow; Bennett,13,0,32,19
1657629267948,MATH 142A,B05,093559,Chow; Bennett,6,0,32,26
1657629273973,MATH 193A,A01,083224,Rotar; Vladimir,8,0,34,26
1657629273973,MATH 193A,A02,083225,Rotar; Vladimir,9,0,34,25
1657629273973,MATH 193A,A03,083781,Rotar; Vladimir,5,0,34,29
1657629273973,MATH 193A,A04,083782,Rotar; Vladimir,10,0,34,24
1657629273973,MATH 193A,A05,093482,Rotar; Vladimir,10,0,34,24
1657629280000,MATH 197,001,091859,McAuley; Julian John,9999,0,9999,0
1657629280000,MATH 197,002,095566,Kedlaya; Kiran S.,9997,0,9999,2
1657629280000,MATH 197,003,095567,Xiao; Ming,9999,0,9999,0
1657629280000,MATH 197,004,095571,Perols; Johan Lars,9998,0,9999,1
1657629287066,COGS 9,A01,083615,Shannon; Kyle Michael,9,0,75,66
1657629293090,COGS 11,A01,083617,Boyle; Mary E. T.,23,0,48,25
1657629299118,COGS 13,A01,083071,Bastos; Amalia Pinkusfeld,11,0,71,60
1657629305151,COGS 14A,A01,092681,Semenuks; Arturs,5,1,100,95
1657629311174,COGS 14B,A01,083073,Cheng; Tzu-Han,6,0,63,57
1657629317205,COGS 17,A01,092677,Semenuks; Arturs,6,0,81,75
1657629323231,COGS 100,A01,083619,Allen; Michael Gordon,17,0,70,53
1657629329255,COGS 101A,A01,083621,Davis; Joshua Daniel,9,0,68,59
1657629335285,COGS 101B,A01,091572,Allen; Michael Gordon,12,0,65,53
1657629341309,COGS 101C,A01,083625,Delgado; Tania,17,0,35,18
1657629347332,COGS 107A,A01,083627,Boyle; Mary E. T.,13,0,60,47
1657629353359,COGS 118A,A01,083075,Gupta; Anjum,21,0,76,55
1657629359385,CSE 3,A50,083646,Miranda; Gregory Joseph,24,0,50,26
1657629365419,CSE 8A,A50,083650,Miranda; Gregory Joseph,17,1,56,39
1657629371446,CSE 11,A01,083080,Cao; Yingjun,6,15,40,34
1657629377473,CSE 12,A01,083652,Krause-Levy; Sophia Louisa,28,1,120,92
1657629383502,CSE 15L,A01,083654,Morris; Justin Loren,9,0,50,41
1657629383502,CSE 15L,A02,083655,Morris; Justin Loren,9,0,50,41
1657629389538,CSE 20,A01,083657,Tran; Khoa Dang,39,0,80,41
1657629395562,CSE 21,A01,095574,Bach; Quang Tran,22,0,48,26
1657629401587,CSE 30,A01,083084,Eldon; John,6,0,80,74
1657629401587,CSE 30,B01,095061,Bhaskar; Nishant,9,0,50,41
1657629407615,CSE 100,A01,083659,Cao; Yingjun,5,4,70,65
1657629413640,CSE 134B,A01,083661,Powell; Thomas Allan,22,0,100,78
1657629419668,CSE 140,A01,083663,Gungor; Onat,15,0,85,70
1657629425696,CSE 140L,A01,083088,Eldon; John,21,0,100,79
1657629431723,CSE 175,A01,083665,Kumar; Rakesh,3,0,25,22
1657629437747,CSE 190,A00,092507,Dubnov; Shlomo,8,0,20,12
1657629443777,ECE 45,A01,083139,Congero; Spencer William,6,0,75,69
1657629449804,ECE 65,A50,083695,Saad; Andrew S,12,0,30,18
1657629449804,ECE 65,A51,095125,Saad; Andrew S,24,0,26,2
1657629455829,ECE 109,A01,091882,Touri; Behrouz,19,0,70,51
1657629461871,ECE 180,A00,083140,Abi Samra; Nicholas Camill,1,0,30,29
1657629461871,ECE 180,B00,083141,Abi Samra; Nicholas Camill,0,0,30,30
1657629467897,MATH 10A,A01,083735,Patchell; Gregory David,2,0,30,28
1657629467897,MATH 10A,A02,083736,Patchell; Gregory David,20,0,30,10
1657629467897,MATH 10A,A03,083737,Patchell; Gregory David,16,0,30,14
1657629473922,MATH 10B,A01,083207,Lim; Seonhee,8,0,34,26
1657629473922,MATH 10B,A02,083208,Lim; Seonhee,9,0,35,26
1657629473922,MATH 10B,A03,093472,Lim; Seonhee,7,0,34,27
1657629473922,MATH 10B,B01,083739,Sinha; Shubham,12,0,30,18
1657629479956,MATH 18,A01,083743,Cinel; Cameron Alexander,7,0,30,23
1657629479956,MATH 18,A02,083744,Cinel; Cameron Alexander,17,0,30,13
1657629479956,MATH 18,A03,083745,Cinel; Cameron Alexander,9,0,30,21
1657629479956,MATH 18,B01,083748,Rideout; David Porter,5,0,37,32
1657629479956,MATH 18,B02,083749,Rideout; David Porter,5,0,36,31
1657629479956,MATH 18,B03,083750,Rideout; David Porter,3,0,37,34
1657629479956,MATH 18,B04,083751,Rideout; David Porter,6,0,36,30
1657629479956,MATH 18,B05,093473,Rideout; David Porter,6,0,36,30
1657629479956,MATH 18,B06,093474,Rideout; David Porter,6,0,36,30
1657629485983,MATH 20A,A01,083754,Zheng; Zequn,14,0,40,26
1657629492013,MATH 20B,A01,083756,Briones; Jor-el Thomas Caparas,4,0,36,32
1657629492013,MATH 20B,A02,083757,Briones; Jor-el Thomas Caparas,1,0,36,35
1657629492013,MATH 20B,A03,093475,Briones; Jor-el Thomas Caparas,2,0,36,34
1657629498038,MATH 20C,A01,083760,Briones; Jor-el Thomas Caparas,1,0,35,34
1657629498038,MATH 20C,A02,083761,Briones; Jor-el Thomas Caparas,8,0,35,27
1657629498038,MATH 20C,A03,093476,Briones; Jor-el Thomas Caparas,0,1,36,36
1657629498038,MATH 20C,B01,083762,Bach; Quang Tran,1,0,30,29
1657629504067,MATH 20D,A01,083765,Tran; Brian Kha,5,0,30,25
1657629504067,MATH 20D,A02,083766,Tran; Brian Kha,5,0,30,25
1657629504067,MATH 20D,A03,083767,Tran; Brian Kha,5,0,30,25
1657629510099,MATH 20E,A01,083771,Ganguly; Soumya,9,0,32,23
1657629510099,MATH 20E,A02,083772,Ganguly; Soumya,6,0,32,26
1657629510099,MATH 20E,B01,083773,Ciotti; Benjamin,20,0,35,15
1657629510099,MATH 20E,B02,083774,Ciotti; Benjamin,18,0,35,17
1657629516123,MATH 103A,A01,083777,Greenfeld; Be'Eri,3,0,36,33
1657629516123,MATH 103A,A02,083778,Greenfeld; Be'Eri,5,0,36,31
1657629516123,MATH 103A,A03,093561,Greenfeld; Be'Eri,6,0,36,30
1657629516123,MATH 103A,B01,083779,Greenfeld; Be'Eri,7,0,36,29
1657629516123,MATH 103A,B02,083780,Greenfeld; Be'Eri,4,0,36,32
1657629516123,MATH 103A,B03,093562,Greenfeld; Be'Eri,3,0,36,33
1657629522148,MATH 105,A01,085443,Carter; Anne Toulson,15,0,35,20
1657629522148,MATH 105,A02,093477,Carter; Anne Toulson,20,0,35,15
1657629528179,MATH 109,A01,083213,Ganzberger; Geoffrey Michael,2,0,34,32
1657629528179,MATH 109,A02,083214,Ganzberger; Geoffrey Michael,4,0,34,30
1657629528179,MATH 109,A03,093478,Ganzberger; Geoffrey Michael,2,0,34,32
1657629528179,MATH 109,B01,083215,Ganzberger; Geoffrey Michael,1,0,32,31
1657629528179,MATH 109,B02,083216,Ganzberger; Geoffrey Michael,2,0,32,30
1657629528179,MATH 109,B03,093479,Ganzberger; Geoffrey Michael,8,0,32,24
1657629534203,MATH 142A,A01,083219,Chow; Bennett,7,0,32,25
1657629534203,MATH 142A,A02,083220,Chow; Bennett,10,0,32,22
1657629534203,MATH 142A,A03,093480,Chow; Bennett,9,0,32,23
1657629534203,MATH 142A,B03,093481,Chow; Bennett,8,0,32,24
1657629534203,MATH 142A,B04,093558,Chow; Bennett,13,0,32,19
1657629534203,MATH 142A,B05,093559,Chow; Bennett,6,0,32,26
1657629540235,MATH 193A,A01,083224,Rotar; Vladimir,8,0,34,26
1657629540235,MATH 193A,A02,083225,Rotar; Vladimir,9,0,34,25
1657629540235,MATH 193A,A03,083781,Rotar; Vladimir,5,0,34,29
1657629540235,MATH 193A,A04,083782,Rotar; Vladimir,10,0,34,24
1657629540235,MATH 193A,A05,093482,Rotar; Vladimir,10,0,34,24
1657629546259,MATH 197,001,091859,McAuley; Julian John,9999,0,9999,0
1657629546259,MATH 197,002,095566,Kedlaya; Kiran S.,9997,0,9999,2
1657629546259,MATH 197,003,095567,Xiao; Ming,9999,0,9999,0
1657629546259,MATH 197,004,095571,Perols; Johan Lars,9998,0,9999,1
1657629553313,COGS 9,A01,083615,Shannon; Kyle Michael,9,0,75,66
1657629559349,COGS 11,A01,083617,Boyle; Mary E. T.,23,0,48,25
1657629565377,COGS 13,A01,083071,Bastos; Amalia Pinkusfeld,11,0,71,60
1657629571405,COGS 14A,A01,092681,Semenuks; Arturs,5,1,100,95
1657629577430,COGS 14B,A01,083073,Cheng; Tzu-Han,6,0,63,57
1657629583456,COGS 17,A01,092677,Semenuks; Arturs,6,0,81,75
1657629589482,COGS 100,A01,083619,Allen; Michael Gordon,17,0,70,53
1657629595507,COGS 101A,A01,083621,Davis; Joshua Daniel,9,0,68,59
1657629601531,COGS 101B,A01,091572,Allen; Michael Gordon,12,0,65,53
1657629607556,COGS 101C,A01,083625,Delgado; Tania,17,0,35,18
1657629613584,COGS 107A,A01,083627,Boyle; Mary E. T.,13,0,60,47
1657629619613,COGS 118A,A01,083075,Gupta; Anjum,21,0,76,55
1657629625639,CSE 3,A50,083646,Miranda; Gregory Joseph,24,0,50,26
1657629631664,CSE 8A,A50,083650,Miranda; Gregory Joseph,17,1,56,39
1657629637701,CSE 11,A01,083080,Cao; Yingjun,6,15,40,34
1657629643729,CSE 12,A01,083652,Krause-Levy; Sophia Louisa,28,1,120,92
1657629649760,CSE 15L,A01,083654,Morris; Justin Loren,9,0,50,41
1657629649760,CSE 15L,A02,083655,Morris; Justin Loren,9,0,50,41
1657629655784,CSE 20,A01,083657,Tran; Khoa Dang,39,0,80,41
1657629661818,CSE 21,A01,095574,Bach; Quang Tran,22,0,48,26
1657629667842,CSE 30,A01,083084,Eldon; John,6,0,80,74
1657629667842,CSE 30,B01,095061,Bhaskar; Nishant,9,0,50,41
1657629673868,CSE 100,A01,083659,Cao; Yingjun,5,4,70,65
1657629679896,CSE 134B,A01,083661,Powell; Thomas Allan,22,0,100,78
1657629685921,CSE 140,A01,083663,Gungor; Onat,15,0,85,70
1657629691946,CSE 140L,A01,083088,Eldon; John,21,0,100,79
1657629697989,CSE 175,A01,083665,Kumar; Rakesh,3,0,25,22
1657629704021,CSE 190,A00,092507,Dubnov; Shlomo,8,0,20,12
1657629710066,ECE 45,A01,083139,Congero; Spencer William,6,0,75,69
1657629716093,ECE 65,A50,083695,Saad; Andrew S,12,0,30,18
1657629716093,ECE 65,A51,095125,Saad; Andrew S,24,0,26,2
1657629722126,ECE 109,A01,091882,Touri; Behrouz,19,0,70,51
1657629728150,ECE 180,A00,083140,Abi Samra; Nicholas Camill,1,0,30,29
1657629728150,ECE 180,B00,083141,Abi Samra; Nicholas Camill,0,0,30,30
1657629734184,MATH 10A,A01,083735,Patchell; Gregory David,2,0,30,28
1657629734184,MATH 10A,A02,083736,Patchell; Gregory David,20,0,30,10
1657629734184,MATH 10A,A03,083737,Patchell; Gregory David,16,0,30,14
1657629740226,MATH 10B,A01,083207,Lim; Seonhee,8,0,34,26
1657629740226,MATH 10B,A02,083208,Lim; Seonhee,9,0,35,26
1657629740226,MATH 10B,A03,093472,Lim; Seonhee,7,0,34,27
1657629740226,MATH 10B,B01,083739,Sinha; Shubham,12,0,30,18
1657629746261,MATH 18,A01,083743,Cinel; Cameron Alexander,7,0,30,23
1657629746261,MATH 18,A02,083744,Cinel; Cameron Alexander,17,0,30,13
1657629746261,MATH 18,A03,083745,Cinel; Cameron Alexander,9,0,30,21
1657629746261,MATH 18,B01,083748,Rideout; David Porter,5,0,37,32
1657629746261,MATH 18,B02,083749,Rideout; David Porter,5,0,36,31
1657629746261,MATH 18,B03,083750,Rideout; David Porter,3,0,37,34
1657629746261,MATH 18,B04,083751,Rideout; David Porter,6,0,36,30
1657629746261,MATH 18,B05,093473,Rideout; David Porter,6,0,36,30
1657629746261,MATH 18,B06,093474,Rideout; David Porter,6,0,36,30
1657629752298,MATH 20A,A01,083754,Zheng; Zequn,14,0,40,26
1657629758332,MATH 20B,A01,083756,Briones; Jor-el Thomas Caparas,4,0,36,32
1657629758332,MATH 20B,A02,083757,Briones; Jor-el Thomas Caparas,1,0,36,35
1657629758332,MATH 20B,A03,093475,Briones; Jor-el Thomas Caparas,2,0,36,34
1657629764362,MATH 20C,A01,083760,Briones; Jor-el Thomas Caparas,1,0,35,34
1657629764362,MATH 20C,A02,083761,Briones; Jor-el Thomas Caparas,8,0,35,27
1657629764362,MATH 20C,A03,093476,Briones; Jor-el Thomas Caparas,0,1,36,36
1657629764362,MATH 20C,B01,083762,Bach; Quang Tran,1,0,30,29
1657629770401,MATH 20D,A01,083765,Tran; Brian Kha,5,0,30,25
1657629770401,MATH 20D,A02,083766,Tran; Brian Kha,5,0,30,25
1657629770401,MATH 20D,A03,083767,Tran; Brian Kha,5,0,30,25
1657629776435,MATH 20E,A01,083771,Ganguly; Soumya,9,0,32,23
1657629776435,MATH 20E,A02,083772,Ganguly; Soumya,6,0,32,26
1657629776435,MATH 20E,B01,083773,Ciotti; Benjamin,20,0,35,15
1657629776435,MATH 20E,B02,083774,Ciotti; Benjamin,18,0,35,17
1657629782488,MATH 103A,A01,083777,Greenfeld; Be'Eri,3,0,36,33
1657629782488,MATH 103A,A02,083778,Greenfeld; Be'Eri,5,0,36,31
1657629782488,MATH 103A,A03,093561,Greenfeld; Be'Eri,6,0,36,30
1657629782488,MATH 103A,B01,083779,Greenfeld; Be'Eri,7,0,36,29
1657629782488,MATH 103A,B02,083780,Greenfeld; Be'Eri,4,0,36,32
1657629782488,MATH 103A,B03,093562,Greenfeld; Be'Eri,3,0,36,33
1657629788588,MATH 105,A01,085443,Carter; Anne Toulson,15,0,35,20
1657629788588,MATH 105,A02,093477,Carter; Anne Toulson,20,0,35,15
1657629794623,MATH 109,A01,083213,Ganzberger; Geoffrey Michael,2,0,34,32
1657629794623,MATH 109,A02,083214,Ganzberger; Geoffrey Michael,4,0,34,30
1657629794623,MATH 109,A03,093478,Ganzberger; Geoffrey Michael,2,0,34,32
1657629794623,MATH 109,B01,083215,Ganzberger; Geoffrey Michael,1,0,32,31
1657629794623,MATH 109,B02,083216,Ganzberger; Geoffrey Michael,2,0,32,30
1657629794623,MATH 109,B03,093479,Ganzberger; Geoffrey Michael,8,0,32,24
1657629800662,MATH 142A,A01,083219,Chow; Bennett,7,0,32,25
1657629800662,MATH 142A,A02,083220,Chow; Bennett,10,0,32,22
1657629800662,MATH 142A,A03,093480,Chow; Bennett,9,0,32,23
1657629800662,MATH 142A,B03,093481,Chow; Bennett,8,0,32,24
1657629800662,MATH 142A,B04,093558,Chow; Bennett,13,0,32,19
1657629800662,MATH 142A,B05,093559,Chow; Bennett,6,0,32,26
1657629806692,MATH 193A,A01,083224,Rotar; Vladimir,8,0,34,26
1657629806692,MATH 193A,A02,083225,Rotar; Vladimir,9,0,34,25
1657629806692,MATH 193A,A03,083781,Rotar; Vladimir,5,0,34,29
1657629806692,MATH 193A,A04,083782,Rotar; Vladimir,10,0,34,24
1657629806692,MATH 193A,A05,093482,Rotar; Vladimir,10,0,34,24
1657629812719,MATH 197,001,091859,McAuley; Julian John,9999,0,9999,0
1657629812719,MATH 197,002,095566,Kedlaya; Kiran S.,9997,0,9999,2
1657629812719,MATH 197,003,095567,Xiao; Ming,9999,0,9999,0
1657629812719,MATH 197,004,095571,Perols; Johan Lars,9998,0,9999,1
1657629819807,COGS 9,A01,083615,Shannon; Kyle Michael,9,0,75,66
1657629825833,COGS 11,A01,083617,Boyle; Mary E. T.,23,0,48,25
1657629831869,COGS 13,A01,083071,Bastos; Amalia Pinkusfeld,11,0,71,60
1657629837903,COGS 14A,A01,092681,Semenuks; Arturs,5,1,100,95
1657629843928,COGS 14B,A01,083073,Cheng; Tzu-Han,6,0,63,57
1657629849954,COGS 17,A01,092677,Semenuks; Arturs,6,0,81,75
1657629855988,COGS 100,A01,083619,Allen; Michael Gordon,17,0,70,53
1657629862014,COGS 101A,A01,083621,Davis; Joshua Daniel,9,0,68,59
1657629868043,COGS 101B,A01,091572,Allen; Michael Gordon,12,0,65,53
1657629874068,COGS 101C,A01,083625,Delgado; Tania,17,0,35,18
1657629880100,COGS 107A,A01,083627,Boyle; Mary E. T.,13,0,60,47
1657629886132,COGS 118A,A01,083075,Gupta; Anjum,21,0,76,55
1657629892176,CSE 3,A50,083646,Miranda; Gregory Joseph,24,0,50,26
1657629898201,CSE 8A,A50,083650,Miranda; Gregory Joseph,17,1,56,39
1657629904232,CSE 11,A01,083080,Cao; Yingjun,6,15,40,34
1657629910261,CSE 12,A01,083652,Krause-Levy; Sophia Louisa,28,1,120,92
1657629916287,CSE 15L,A01,083654,Morris; Justin Loren,9,0,50,41
1657629916287,CSE 15L,A02,083655,Morris; Justin Loren,9,0,50,41
1657629922316,CSE 20,A01,083657,Tran; Khoa Dang,39,0,80,41
1657629928346,CSE 21,A01,095574,Bach; Quang Tran,22,0,48,26
1657629934371,CSE 30,A01,083084,Eldon; John,6,0,80,74
1657629934371,CSE 30,B01,095061,Bhaskar; Nishant,9,0,50,41
1657629940403,CSE 100,A01,083659,Cao; Yingjun,5,4,70,65
1657629946428,CSE 134B,A01,083661,Powell; Thomas Allan,22,0,100,78
1657629952453,CSE 140,A01,083663,Gungor; Onat,15,0,85,70
1657629958478,CSE 140L,A01,083088,Eldon; John,21,0,100,79
1657629964509,CSE 175,A01,083665,Kumar; Rakesh,3,0,25,22
1657629970538,CSE 190,A00,092507,Dubnov; Shlomo,8,0,20,12
1657629976571,ECE 45,A01,083139,Congero; Spencer William,6,0,75,69
1657629982604,ECE 65,A50,083695,Saad; Andrew S,12,0,30,18
1657629982604,ECE 65,A51,095125,Saad; Andrew S,24,0,26,2
1657629988633,ECE 109,A01,091882,Touri; Behrouz,19,0,70,51
1657629994665,ECE 180,A00,083140,Abi Samra; Nicholas Camill,1,0,30,29
1657629994665,ECE 180,B00,083141,Abi Samra; Nicholas Camill,0,0,30,30
1657630000694,MATH 10A,A01,083735,Patchell; Gregory David,2,0,30,28
1657630000694,MATH 10A,A02,083736,Patchell; Gregory David,20,0,30,10
1657630000694,MATH 10A,A03,083737,Patchell; Gregory David,16,0,30,14
1657630006732,MATH 10B,A01,083207,Lim; Seonhee,8,0,34,26
1657630006732,MATH 10B,A02,083208,Lim; Seonhee,9,0,35,26
1657630006732,MATH 10B,A03,093472,Lim; Seonhee,7,0,34,27
1657630006732,MATH 10B,B01,083739,Sinha; Shubham,12,0,30,18
1657630012769,MATH 18,A01,083743,Cinel; Cameron Alexander,7,0,30,23
1657630012769,MATH 18,A02,083744,Cinel; Cameron Alexander,17,0,30,13
1657630012769,MATH 18,A03,083745,Cinel; Cameron Alexander,9,0,30,21
1657630012769,MATH 18,B01,083748,Rideout; David Porter,5,0,37,32
1657630012769,MATH 18,B02,083749,Rideout; David Porter,5,0,36,31
1657630012769,MATH 18,B03,083750,Rideout; David Porter,3,0,37,34
1657630012769,MATH 18,B04,083751,Rideout; David Porter,6,0,36,30
1657630012769,MATH 18,B05,093473,Rideout; David Porter,6,0,36,30
1657630012769,MATH 18,B06,093474,Rideout; David Porter,6,0,36,30
1657630018795,MATH 20A,A01,083754,Zheng; Zequn,14,0,40,26
1657630024829,MATH 20B,A01,083756,Briones; Jor-el Thomas Caparas,4,0,36,32
1657630024829,MATH 20B,A02,083757,Briones; Jor-el Thomas Caparas,1,0,36,35
1657630024829,MATH 20B,A03,093475,Briones; Jor-el Thomas Caparas,2,0,36,34
1657630030854,MATH 20C,A01,083760,Briones; Jor-el Thomas Caparas,1,0,35,34
1657630030854,MATH 20C,A02,083761,Briones; Jor-el Thomas Caparas,8,0,35,27
1657630030854,MATH 20C,A03,093476,Briones; Jor-el Thomas Caparas,0,1,36,36
1657630030854,MATH 20C,B01,083762,Bach; Quang Tran,1,0,30,29
1657630036888,MATH 20D,A01,083765,Tran; Brian Kha,5,0,30,25
1657630036888,MATH 20D,A02,083766,Tran; Brian Kha,5,0,30,25
1657630036888,MATH 20D,A03,083767,Tran; Brian Kha,5,0,30,25
1657630042926,MATH 20E,A01,083771,Ganguly; Soumya,9,0,32,23
1657630042926,MATH 20E,A02,083772,Ganguly; Soumya,6,0,32,26
1657630042926,MATH 20E,B01,083773,Ciotti; Benjamin,20,0,35,15
1657630042926,MATH 20E,B02,083774,Ciotti; Benjamin,18,0,35,17
1657630048963,MATH 103A,A01,083777,Greenfeld; Be'Eri,3,0,36,33
1657630048963,MATH 103A,A02,083778,Greenfeld; Be'Eri,5,0,36,31
1657630048963,MATH 103A,A03,093561,Greenfeld; Be'Eri,6,0,36,30
1657630048963,MATH 103A,B01,083779,Greenfeld; Be'Eri,7,0,36,29
1657630048963,MATH 103A,B02,083780,Greenfeld; Be'Eri,4,0,36,32
1657630048963,MATH 103A,B03,093562,Greenfeld; Be'Eri,3,0,36,33
1657630055019,MATH 105,A01,085443,Carter; Anne Toulson,15,0,35,20
1657630055019,MATH 105,A02,093477,Carter; Anne Toulson,20,0,35,15
1657630061047,MATH 109,A01,083213,Ganzberger; Geoffrey Michael,2,0,34,32
1657630061047,MATH 109,A02,083214,Ganzberger; Geoffrey Michael,4,0,34,30
1657630061047,MATH 109,A03,093478,Ganzberger; Geoffrey Michael,2,0,34,32
1657630061047,MATH 109,B01,083215,Ganzberger; Geoffrey Michael,1,0,32,31
1657630061047,MATH 109,B02,083216,Ganzberger; Geoffrey Michael,2,0,32,30
1657630061047,MATH 109,B03,093479,Ganzberger; Geoffrey Michael,8,0,32,24
1657630067081,MATH 142A,A01,083219,Chow; Bennett,7,0,32,25
1657630067081,MATH 142A,A02,083220,Chow; Bennett,10,0,32,22
1657630067081,MATH 142A,A03,093480,Chow; Bennett,9,0,32,23
1657630067081,MATH 142A,B03,093481,Chow; Bennett,8,0,32,24
1657630067081,MATH 142A,B04,093558,Chow; Bennett,13,0,32,19
1657630067081,MATH 142A,B05,093559,Chow; Bennett,6,0,32,26
1657630073106,MATH 193A,A01,083224,Rotar; Vladimir,8,0,34,26
1657630073106,MATH 193A,A02,083225,Rotar; Vladimir,9,0,34,25
1657630073106,MATH 193A,A03,083781,Rotar; Vladimir,5,0,34,29
1657630073106,MATH 193A,A04,083782,Rotar; Vladimir,10,0,34,24
1657630073106,MATH 193A,A05,093482,Rotar; Vladimir,10,0,34,24
1657630079133,MATH 197,001,091859,McAuley; Julian John,9999,0,9999,0
1657630079133,MATH 197,002,095566,Kedlaya; Kiran S.,9997,0,9999,2
1657630079133,MATH 197,003,095567,Xiao; Ming,9999,0,9999,0
1657630079133,MATH 197,004,095571,Perols; Johan Lars,9998,0,9999,1
1657630086233,COGS 9,A01,083615,Shannon; Kyle Michael,9,0,75,66
1657630092259,COGS 11,A01,083617,Boyle; Mary E. T.,23,0,48,25
1657630098286,COGS 13,A01,083071,Bastos; Amalia Pinkusfeld,11,0,71,60
1657630104313,COGS 14A,A01,092681,Semenuks; Arturs,5,1,100,95
1657630110344,COGS 14B,A01,083073,Cheng; Tzu-Han,6,0,63,57
1657630116374,COGS 17,A01,092677,Semenuks; Arturs,6,0,81,75
1657630122400,COGS 100,A01,083619,Allen; Michael Gordon,17,0,70,53
1657630128425,COGS 101A,A01,083621,Davis; Joshua Daniel,9,0,68,59
1657630134494,COGS 101B,A01,091572,Allen; Michael Gordon,12,0,65,53
1657630140532,COGS 101C,A01,083625,Delgado; Tania,17,0,35,18
1657630146558,COGS 107A,A01,083627,Boyle; Mary E. T.,13,0,60,47
1657630152586,COGS 118A,A01,083075,Gupta; Anjum,21,0,76,55
1657630158614,CSE 3,A50,083646,Miranda; Gregory Joseph,24,0,50,26
1657630164646,CSE 8A,A50,083650,Miranda; Gregory Joseph,17,1,56,39
1657630170671,CSE 11,A01,083080,Cao; Yingjun,6,15,40,34
1657630176700,CSE 12,A01,083652,Krause-Levy; Sophia Louisa,28,1,120,92
1657630182725,CSE 15L,A01,083654,Morris; Justin Loren,9,0,50,41
1657630182725,CSE 15L,A02,083655,Morris; Justin Loren,9,0,50,41
1657630188749,CSE 20,A01,083657,Tran; Khoa Dang,39,0,80,41
1657630194777,CSE 21,A01,095574,Bach; Quang Tran,22,0,48,26
1657630200811,CSE 30,A01,083084,Eldon; John,6,0,80,74
1657630200811,CSE 30,B01,095061,Bhaskar; Nishant,9,0,50,41
1657630206839,CSE 100,A01,083659,Cao; Yingjun,5,4,70,65
1657630212863,CSE 134B,A01,083661,Powell; Thomas Allan,22,0,100,78
1657630218893,CSE 140,A01,083663,Gungor; Onat,15,0,85,70
1657630224918,CSE 140L,A01,083088,Eldon; John,21,0,100,79
1657630230945,CSE 175,A01,083665,Kumar; Rakesh,3,0,25,22
1657630236973,CSE 190,A00,092507,Dubnov; Shlomo,8,0,20,12
1657630243007,ECE 45,A01,083139,Congero; Spencer William,6,0,75,69
1657630249039,ECE 65,A50,083695,Saad; Andrew S,12,0,30,18
1657630249039,ECE 65,A51,095125,Saad; Andrew S,24,0,26,2
1657630255066,ECE 109,A01,091882,Touri; Behrouz,19,0,70,51
1657630261092,ECE 180,A00,083140,Abi Samra; Nicholas Camill,1,0,30,29
1657630261092,ECE 180,B00,083141,Abi Samra; Nicholas Camill,0,0,30,30
1657630267120,MATH 10A,A01,083735,Patchell; Gregory David,2,0,30,28
1657630267120,MATH 10A,A02,083736,Patchell; Gregory David,20,0,30,10
1657630267120,MATH 10A,A03,083737,Patchell; Gregory David,16,0,30,14
1657630273160,MATH 10B,A01,083207,Lim; Seonhee,8,0,34,26
1657630273160,MATH 10B,A02,083208,Lim; Seonhee,9,0,35,26
1657630273160,MATH 10B,A03,093472,Lim; Seonhee,7,0,34,27
1657630273160,MATH 10B,B01,083739,Sinha; Shubham,12,0,30,18
1657630279188,MATH 18,A01,083743,Cinel; Cameron Alexander,7,0,30,23
1657630279188,MATH 18,A02,083744,Cinel; Cameron Alexander,17,0,30,13
1657630279188,MATH 18,A03,083745,Cinel; Cameron Alexander,9,0,30,21
1657630279188,MATH 18,B01,083748,Rideout; David Porter,5,0,37,32
1657630279188,MATH 18,B02,083749,Rideout; David Porter,5,0,36,31
1657630279188,MATH 18,B03,083750,Rideout; David Porter,3,0,37,34
1657630279188,MATH 18,B04,083751,Rideout; David Porter,6,0,36,30
1657630279188,MATH 18,B05,093473,Rideout; David Porter,6,0,36,30
1657630279188,MATH 18,B06,093474,Rideout; David Porter,6,0,36,30
1657630285228,MATH 20A,A01,083754,Zheng; Zequn,14,0,40,26
1657630291260,MATH 20B,A01,083756,Briones; Jor-el Thomas Caparas,4,0,36,32
1657630291260,MATH 20B,A02,083757,Briones; Jor-el Thomas Caparas,1,0,36,35
1657630291260,MATH 20B,A03,093475,Briones; Jor-el Thomas Caparas,2,0,36,34
1657630297298,MATH 20C,A01,083760,Briones; Jor-el Thomas Caparas,1,0,35,34
1657630297298,MATH 20C,A02,083761,Briones; Jor-el Thomas Caparas,8,0,35,27
1657630297298,MATH 20C,A03,093476,Briones; Jor-el Thomas Caparas,0,1,36,36
1657630297298,MATH 20C,B01,083762,Bach; Quang Tran,1,0,30,29
1657630303327,MATH 20D,A01,083765,Tran; Brian Kha,5,0,30,25
1657630303327,MATH 20D,A02,083766,Tran; Brian Kha,5,0,30,25
1657630303327,MATH 20D,A03,083767,Tran; Brian Kha,5,0,30,25
1657630309355,MATH 20E,A01,083771,Ganguly; Soumya,9,0,32,23
1657630309355,MATH 20E,A02,083772,Ganguly; Soumya,6,0,32,26
1657630309355,MATH 20E,B01,083773,Ciotti; Benjamin,20,0,35,15
1657630309355,MATH 20E,B02,083774,Ciotti; Benjamin,18,0,35,17
1657630315385,MATH 103A,A01,083777,Greenfeld; Be'Eri,3,0,36,33
1657630315385,MATH 103A,A02,083778,Greenfeld; Be'Eri,5,0,36,31
1657630315385,MATH 103A,A03,093561,Greenfeld; Be'Eri,6,0,36,30
1657630315385,MATH 103A,B01,083779,Greenfeld; Be'Eri,7,0,36,29
1657630315385,MATH 103A,B02,083780,Greenfeld; Be'Eri,4,0,36,32
1657630315385,MATH 103A,B03,093562,Greenfeld; Be'Eri,3,0,36,33
1657630321436,MATH 105,A01,085443,Carter; Anne Toulson,15,0,35,20
1657630321436,MATH 105,A02,093477,Carter; Anne Toulson,20,0,35,15
1657630327463,MATH 109,A01,083213,Ganzberger; Geoffrey Michael,2,0,34,32
1657630327463,MATH 109,A02,083214,Ganzberger; Geoffrey Michael,4,0,34,30
1657630327463,MATH 109,A03,093478,Ganzberger; Geoffrey Michael,2,0,34,32
1657630327463,MATH 109,B01,083215,Ganzberger; Geoffrey Michael,1,0,32,31
1657630327463,MATH 109,B02,083216,Ganzberger; Geoffrey Michael,2,0,32,30
1657630327463,MATH 109,B03,093479,Ganzberger; Geoffrey Michael,8,0,32,24
1657630333493,MATH 142A,A01,083219,Chow; Bennett,7,0,32,25
1657630333493,MATH 142A,A02,083220,Chow; Bennett,10,0,32,22
1657630333493,MATH 142A,A03,093480,Chow; Bennett,9,0,32,23
1657630333493,MATH 142A,B03,093481,Chow; Bennett,8,0,32,24
1657630333493,MATH 142A,B04,093558,Chow; Bennett,13,0,32,19
1657630333493,MATH 142A,B05,093559,Chow; Bennett,6,0,32,26
1657630339537,MATH 193A,A01,083224,Rotar; Vladimir,8,0,34,26
1657630339537,MATH 193A,A02,083225,Rotar; Vladimir,9,0,34,25
1657630339537,MATH 193A,A03,083781,Rotar; Vladimir,5,0,34,29
1657630339537,MATH 193A,A04,083782,Rotar; Vladimir,10,0,34,24
1657630339537,MATH 193A,A05,093482,Rotar; Vladimir,10,0,34,24
1657630345561,MATH 197,001,091859,McAuley; Julian John,9999,0,9999,0
1657630345561,MATH 197,002,095566,Kedlaya; Kiran S.,9997,0,9999,2
1657630345561,MATH 197,003,095567,Xiao; Ming,9999,0,9999,0
1657630345561,MATH 197,004,095571,Perols; Johan Lars,9998,0,9999,1
1657630352629,COGS 9,A01,083615,Shannon; Kyle Michael,9,0,75,66
1657630358661,COGS 11,A01,083617,Boyle; Mary E. T.,23,0,48,25
1657630364687,COGS 13,A01,083071,Bastos; Amalia Pinkusfeld,11,0,71,60
1657630370711,COGS 14A,A01,092681,Semenuks; Arturs,5,1,100,95
1657630376736,COGS 14B,A01,083073,Cheng; Tzu-Han,6,0,63,57
1657630382835,COGS 17,A01,092677,Semenuks; Arturs,6,0,81,75
1657630388860,COGS 100,A01,083619,Allen; Michael Gordon,17,0,70,53
1657630394885,COGS 101A,A01,083621,Davis; Joshua Daniel,9,0,68,59
1657630400911,COGS 101B,A01,091572,Allen; Michael Gordon,12,0,65,53
1657630406943,COGS 101C,A01,083625,Delgado; Tania,17,0,35,18
1657630412970,COGS 107A,A01,083627,Boyle; Mary E. T.,13,0,60,47
1657630418996,COGS 118A,A01,083075,Gupta; Anjum,21,0,76,55
1657630425021,CSE 3,A50,083646,Miranda; Gregory Joseph,24,0,50,26
1657630431046,CSE 8A,A50,083650,Miranda; Gregory Joseph,17,1,56,39
1657630437076,CSE 11,A01,083080,Cao; Yingjun,6,15,40,34
1657630443100,CSE 12,A01,083652,Krause-Levy; Sophia Louisa,28,1,120,92
1657630449131,CSE 15L,A01,083654,Morris; Justin Loren,9,0,50,41
1657630449131,CSE 15L,A02,083655,Morris; Justin Loren,9,0,50,41
1657630455167,CSE 20,A01,083657,Tran; Khoa Dang,39,0,80,41
1657630461193,CSE 21,A01,095574,Bach; Quang Tran,22,0,48,26
1657630467230,CSE 30,A01,083084,Eldon; John,6,0,80,74
1657630467230,CSE 30,B01,095061,Bhaskar; Nishant,9,0,50,41
1657630473257,CSE 100,A01,083659,Cao; Yingjun,5,4,70,65
1657630479288,CSE 134B,A01,083661,Powell; Thomas Allan,22,0,100,78
1657630485320,CSE 140,A01,083663,Gungor; Onat,15,0,85,70
1657630491348,CSE 140L,A01,083088,Eldon; John,21,0,100,79
1657630497378,CSE 175,A01,083665,Kumar; Rakesh,3,0,25,22
1657630503404,CSE 190,A00,092507,Dubnov; Shlomo,8,0,20,12
1657630509438,ECE 45,A01,083139,Congero; Spencer William,6,0,75,69
1657630515477,ECE 65,A50,083695,Saad; Andrew S,12,0,30,18
1657630515477,ECE 65,A51,095125,Saad; Andrew S,24,0,26,2
1657630521501,ECE 109,A01,091882,Touri; Behrouz,19,0,70,51
1657630527529,ECE 180,A00,083140,Abi Samra; Nicholas Camill,1,0,30,29
1657630527529,ECE 180,B00,083141,Abi Samra; Nicholas Camill,0,0,30,30
1657630533557,MATH 10A,A01,083735,Patchell; Gregory David,2,0,30,28
1657630533557,MATH 10A,A02,083736,Patchell; Gregory David,20,0,30,10
1657630533557,MATH 10A,A03,083737,Patchell; Gregory David,16,0,30,14
1657630539589,MATH 10B,A01,083207,Lim; Seonhee,8,0,34,26
1657630539589,MATH 10B,A02,083208,Lim; Seonhee,9,0,35,26
1657630539589,MATH 10B,A03,093472,Lim; Seonhee,7,0,34,27
1657630539589,MATH 10B,B01,083739,Sinha; Shubham,12,0,30,18
1657630545622,MATH 18,A01,083743,Cinel; Cameron Alexander,7,0,30,23
1657630545622,MATH 18,A02,083744,Cinel; Cameron Alexander,17,0,30,13
1657630545622,MATH 18,A03,083745,Cinel; Cameron Alexander,9,0,30,21
1657630545622,MATH 18,B01,083748,Rideout; David Porter,5,0,37,32
1657630545622,MATH 18,B02,083749,Rideout; David Porter,5,0,36,31
1657630545622,MATH 18,B03,083750,Rideout; David Porter,3,0,37,34
1657630545622,MATH 18,B04,083751,Rideout; David Porter,6,0,36,30
1657630545622,MATH 18,B05,093473,Rideout; David Porter,6,0,36,30
1657630545622,MATH 18,B06,093474,Rideout; David Porter,6,0,36,30
1657630551654,MATH 20A,A01,083754,Zheng; Zequn,14,0,40,26
1657630557681,MATH 20B,A01,083756,Briones; Jor-el Thomas Caparas,4,0,36,32
1657630557681,MATH 20B,A02,083757,Briones; Jor-el Thomas Caparas,1,0,36,35
1657630557681,MATH 20B,A03,093475,Briones; Jor-el Thomas Caparas,2,0,36,34
1657630563716,MATH 20C,A01,083760,Briones; Jor-el Thomas Caparas,1,0,35,34
1657630563716,MATH 20C,A02,083761,Briones; Jor-el Thomas Caparas,8,0,35,27
1657630563716,MATH 20C,A03,093476,Briones; Jor-el Thomas Caparas,0,1,36,36
1657630563716,MATH 20C,B01,083762,Bach; Quang Tran,1,0,30,29
1657630569744,MATH 20D,A01,083765,Tran; Brian Kha,5,0,30,25
1657630569744,MATH 20D,A02,083766,Tran; Brian Kha,5,0,30,25
1657630569744,MATH 20D,A03,083767,Tran; Brian Kha,5,0,30,25
1657630575771,MATH 20E,A01,083771,Ganguly; Soumya,9,0,32,23
1657630575771,MATH 20E,A02,083772,Ganguly; Soumya,6,0,32,26
1657630575771,MATH 20E,B01,083773,Ciotti; Benjamin,20,0,35,15
1657630575771,MATH 20E,B02,083774,Ciotti; Benjamin,18,0,35,17
1657630581810,MATH 103A,A01,083777,Greenfeld; Be'Eri,3,0,36,33
1657630581810,MATH 103A,A02,083778,Greenfeld; Be'Eri,5,0,36,31
1657630581810,MATH 103A,A03,093561,Greenfeld; Be'Eri,6,0,36,30
1657630581810,MATH 103A,B01,083779,Greenfeld; Be'Eri,7,0,36,29
1657630581810,MATH 103A,B02,083780,Greenfeld; Be'Eri,4,0,36,32
1657630581810,MATH 103A,B03,093562,Greenfeld; Be'Eri,3,0,36,33
1657630587835,MATH 105,A01,085443,Carter; Anne Toulson,15,0,35,20
1657630587835,MATH 105,A02,093477,Carter; Anne Toulson,20,0,35,15
1657630593869,MATH 109,A01,083213,Ganzberger; Geoffrey Michael,2,0,34,32
1657630593869,MATH 109,A02,083214,Ganzberger; Geoffrey Michael,4,0,34,30
1657630593869,MATH 109,A03,093478,Ganzberger; Geoffrey Michael,2,0,34,32
1657630593869,MATH 109,B01,083215,Ganzberger; Geoffrey Michael,1,0,32,31
1657630593869,MATH 109,B02,083216,Ganzberger; Geoffrey Michael,2,0,32,30
1657630593869,MATH 109,B03,093479,Ganzberger; Geoffrey Michael,8,0,32,24
1657630599896,MATH 142A,A01,083219,Chow; Bennett,7,0,32,25
1657630599896,MATH 142A,A02,083220,Chow; Bennett,10,0,32,22
1657630599896,MATH 142A,A03,093480,Chow; Bennett,9,0,32,23
1657630599896,MATH 142A,B03,093481,Chow; Bennett,8,0,32,24
1657630599896,MATH 142A,B04,093558,Chow; Bennett,13,0,32,19
1657630599896,MATH 142A,B05,093559,Chow; Bennett,6,0,32,26
1657630605931,MATH 193A,A01,083224,Rotar; Vladimir,8,0,34,26
1657630605931,MATH 193A,A02,083225,Rotar; Vladimir,9,0,34,25
1657630605931,MATH 193A,A03,083781,Rotar; Vladimir,5,0,34,29
1657630605931,MATH 193A,A04,083782,Rotar; Vladimir,10,0,34,24
1657630605931,MATH 193A,A05,093482,Rotar; Vladimir,10,0,34,24
1657630611965,MATH 197,001,091859,McAuley; Julian John,9999,0,9999,0
1657630611965,MATH 197,002,095566,Kedlaya; Kiran S.,9997,0,9999,2
1657630611965,MATH 197,003,095567,Xiao; Ming,9999,0,9999,0
1657630611965,MATH 197,004,095571,Perols; Johan Lars,9998,0,9999,1
1657630619042,COGS 9,A01,083615,Shannon; Kyle Michael,9,0,75,66
1657630625075,COGS 11,A01,083617,Boyle; Mary E. T.,23,0,48,25
1657630631101,COGS 13,A01,083071,Bastos; Amalia Pinkusfeld,11,0,71,60
1657630637131,COGS 14A,A01,092681,Semenuks; Arturs,5,1,100,95
1657630643162,COGS 14B,A01,083073,Cheng; Tzu-Han,6,0,63,57
1657630649188,COGS 17,A01,092677,Semenuks; Arturs,6,0,81,75
1657630655214,COGS 100,A01,083619,Allen; Michael Gordon,17,0,70,53
1657630661245,COGS 101A,A01,083621,Davis; Joshua Daniel,9,0,68,59
1657630667273,COGS 101B,A01,091572,Allen; Michael Gordon,12,0,65,53
1657630673306,COGS 101C,A01,083625,Delgado; Tania,17,0,35,18
1657630679335,COGS 107A,A01,083627,Boyle; Mary E. T.,13,0,60,47
1657630685360,COGS 118A,A01,083075,Gupta; Anjum,21,0,76,55
1657630691389,CSE 3,A50,083646,Miranda; Gregory Joseph,24,0,50,26
1657630697418,CSE 8A,A50,083650,Miranda; Gregory Joseph,17,1,56,39
1657630703443,CSE 11,A01,083080,Cao; Yingjun,6,15,40,34
1657630709468,CSE 12,A01,083652,Krause-Levy; Sophia Louisa,28,1,120,92
1657630715495,CSE 15L,A01,083654,Morris; Justin Loren,9,0,50,41
1657630715495,CSE 15L,A02,083655,Morris; Justin Loren,9,0,50,41
1657630721521,CSE 20,A01,083657,Tran; Khoa Dang,39,0,80,41
1657630727552,CSE 21,A01,095574,Bach; Quang Tran,22,0,48,26
1657630733584,CSE 30,A01,083084,Eldon; John,6,0,80,74
1657630733584,CSE 30,B01,095061,Bhaskar; Nishant,9,0,50,41
1657630739611,CSE 100,A01,083659,Cao; Yingjun,5,4,70,65
1657630745641,CSE 134B,A01,083661,Powell; Thomas Allan,22,0,100,78
1657630751667,CSE 140,A01,083663,Gungor; Onat,15,0,85,70
1657630757692,CSE 140L,A01,083088,Eldon; John,21,0,100,79
1657630763720,CSE 175,A01,083665,Kumar; Rakesh,3,0,25,22
1657630769746,CSE 190,A00,092507,Dubnov; Shlomo,8,0,20,12
1657630775772,ECE 45,A01,083139,Congero; Spencer William,6,0,75,69
1657630781798,ECE 65,A50,083695,Saad; Andrew S,12,0,30,18
1657630781798,ECE 65,A51,095125,Saad; Andrew S,24,0,26,2
1657630787825,ECE 109,A01,091882,Touri; Behrouz,19,0,70,51
1657630793865,ECE 180,A00,083140,Abi Samra; Nicholas Camill,1,0,30,29
1657630793865,ECE 180,B00,083141,Abi Samra; Nicholas Camill,0,0,30,30
1657630799898,MATH 10A,A01,083735,Patchell; Gregory David,2,0,30,28
1657630799898,MATH 10A,A02,083736,Patchell; Gregory David,20,0,30,10
1657630799898,MATH 10A,A03,083737,Patchell; Gregory David,16,0,30,14
1657630805930,MATH 10B,A01,083207,Lim; Seonhee,8,0,34,26
1657630805930,MATH 10B,A02,083208,Lim; Seonhee,9,0,35,26
1657630805930,MATH 10B,A03,093472,Lim; Seonhee,7,0,34,27
1657630805930,MATH 10B,B01,083739,Sinha; Shubham,12,0,30,18
1657630811958,MATH 18,A01,083743,Cinel; Cameron Alexander,7,0,30,23
1657630811958,MATH 18,A02,083744,Cinel; Cameron Alexander,17,0,30,13
1657630811958,MATH 18,A03,083745,Cinel; Cameron Alexander,9,0,30,21
1657630811958,MATH 18,B01,083748,Rideout; David Porter,5,0,37,32
1657630811958,MATH 18,B02,083749,Rideout; David Porter,5,0,36,31
1657630811958,MATH 18,B03,083750,Rideout; David Porter,3,0,37,34
1657630811958,MATH 18,B04,083751,Rideout; David Porter,6,0,36,30
1657630811958,MATH 18,B05,093473,Rideout; David Porter,6,0,36,30
1657630811958,MATH 18,B06,093474,Rideout; David Porter,6,0,36,30
1657630817984,MATH 20A,A01,083754,Zheng; Zequn,14,0,40,26
1657630824021,MATH 20B,A01,083756,Briones; Jor-el Thomas Caparas,4,0,36,32
1657630824021,MATH 20B,A02,083757,Briones; Jor-el Thomas Caparas,1,0,36,35
1657630824021,MATH 20B,A03,093475,Briones; Jor-el Thomas Caparas,2,0,36,34
1657630830054,MATH 20C,A01,083760,Briones; Jor-el Thomas Caparas,1,0,35,34
1657630830054,MATH 20C,A02,083761,Briones; Jor-el Thomas Caparas,8,0,35,27
1657630830054,MATH 20C,A03,093476,Briones; Jor-el Thomas Caparas,0,1,36,36
1657630830054,MATH 20C,B01,083762,Bach; Quang Tran,1,0,30,29
1657630836080,MATH 20D,A01,083765,Tran; Brian Kha,5,0,30,25
1657630836080,MATH 20D,A02,083766,Tran; Brian Kha,5,0,30,25
1657630836080,MATH 20D,A03,083767,Tran; Brian Kha,5,0,30,25
1657630842117,MATH 20E,A01,083771,Ganguly; Soumya,9,0,32,23
1657630842117,MATH 20E,A02,083772,Ganguly; Soumya,6,0,32,26
1657630842117,MATH 20E,B01,083773,Ciotti; Benjamin,20,0,35,15
1657630842117,MATH 20E,B02,083774,Ciotti; Benjamin,18,0,35,17
1657630848146,MATH 103A,A01,083777,Greenfeld; Be'Eri,3,0,36,33
1657630848146,MATH 103A,A02,083778,Greenfeld; Be'Eri,5,0,36,31
1657630848146,MATH 103A,A03,093561,Greenfeld; Be'Eri,6,0,36,30
1657630848146,MATH 103A,B01,083779,Greenfeld; Be'Eri,7,0,36,29
1657630848146,MATH 103A,B02,083780,Greenfeld; Be'Eri,4,0,36,32
1657630848146,MATH 103A,B03,093562,Greenfeld; Be'Eri,3,0,36,33
1657630854179,MATH 105,A01,085443,Carter; Anne Toulson,15,0,35,20
1657630854179,MATH 105,A02,093477,Carter; Anne Toulson,20,0,35,15
1657630860209,MATH 109,A01,083213,Ganzberger; Geoffrey Michael,2,0,34,32
1657630860209,MATH 109,A02,083214,Ganzberger; Geoffrey Michael,4,0,34,30
1657630860209,MATH 109,A03,093478,Ganzberger; Geoffrey Michael,2,0,34,32
1657630860209,MATH 109,B01,083215,Ganzberger; Geoffrey Michael,1,0,32,31
1657630860209,MATH 109,B02,083216,Ganzberger; Geoffrey Michael,2,0,32,30
1657630860209,MATH 109,B03,093479,Ganzberger; Geoffrey Michael,8,0,32,24
1657630866236,MATH 142A,A01,083219,Chow; Bennett,7,0,32,25
1657630866236,MATH 142A,A02,083220,Chow; Bennett,10,0,32,22
1657630866236,MATH 142A,A03,093480,Chow; Bennett,9,0,32,23
1657630866236,MATH 142A,B03,093481,Chow; Bennett,8,0,32,24
1657630866236,MATH 142A,B04,093558,Chow; Bennett,13,0,32,19
1657630866236,MATH 142A,B05,093559,Chow; Bennett,6,0,32,26
1657630872262,MATH 193A,A01,083224,Rotar; Vladimir,8,0,34,26
1657630872262,MATH 193A,A02,083225,Rotar; Vladimir,9,0,34,25
1657630872262,MATH 193A,A03,083781,Rotar; Vladimir,5,0,34,29
1657630872262,MATH 193A,A04,083782,Rotar; Vladimir,10,0,34,24
1657630872262,MATH 193A,A05,093482,Rotar; Vladimir,10,0,34,24
1657630878295,MATH 197,001,091859,McAuley; Julian John,9999,0,9999,0
1657630878295,MATH 197,002,095566,Kedlaya; Kiran S.,9997,0,9999,2
1657630878295,MATH 197,003,095567,Xiao; Ming,9999,0,9999,0
1657630878295,MATH 197,004,095571,Perols; Johan Lars,9998,0,9999,1
1657630885365,COGS 9,A01,083615,Shannon; Kyle Michael,9,0,75,66
1657630891391,COGS 11,A01,083617,Boyle; Mary E. T.,23,0,48,25
1657630897424,COGS 13,A01,083071,Bastos; Amalia Pinkusfeld,11,0,71,60
1657630903449,COGS 14A,A01,092681,Semenuks; Arturs,5,1,100,95
1657630909482,COGS 14B,A01,083073,Cheng; Tzu-Han,6,0,63,57
1657630915506,COGS 17,A01,092677,Semenuks; Arturs,6,0,81,75
1657630921532,COGS 100,A01,083619,Allen; Michael Gordon,17,0,70,53
1657630927558,COGS 101A,A01,083621,Davis; Joshua Daniel,9,0,68,59
1657630933586,COGS 101B,A01,091572,Allen; Michael Gordon,12,0,65,53
1657630939609,COGS 101C,A01,083625,Delgado; Tania,17,0,35,18
1657630945634,COGS 107A,A01,083627,Boyle; Mary E. T.,13,0,60,47
1657630951665,COGS 118A,A01,083075,Gupta; Anjum,21,0,76,55
1657630957690,CSE 3,A50,083646,Miranda; Gregory Joseph,24,0,50,26
1657630963720,CSE 8A,A50,083650,Miranda; Gregory Joseph,17,1,56,39
1657630969753,CSE 11,A01,083080,Cao; Yingjun,6,15,40,34
1657630975786,CSE 12,A01,083652,Krause-Levy; Sophia Louisa,28,1,120,92
1657630981889,CSE 15L,A01,083654,Morris; Justin Loren,9,0,50,41
1657630981889,CSE 15L,A02,083655,Morris; Justin Loren,9,0,50,41
1657630987915,CSE 20,A01,083657,Tran; Khoa Dang,39,0,80,41
1657630993939,CSE 21,A01,095574,Bach; Quang Tran,22,0,48,26
1657630999967,CSE 30,A01,083084,Eldon; John,6,0,80,74
1657630999967,CSE 30,B01,095061,Bhaskar; Nishant,9,0,50,41
1657631005996,CSE 100,A01,083659,Cao; Yingjun,5,4,70,65
1657631012029,CSE 134B,A01,083661,Powell; Thomas Allan,22,0,100,78
1657631018057,CSE 140,A01,083663,Gungor; Onat,15,0,85,70
1657631024082,CSE 140L,A01,083088,Eldon; John,21,0,100,79
1657631030106,CSE 175,A01,083665,Kumar; Rakesh,3,0,25,22
1657631036137,CSE 190,A00,092507,Dubnov; Shlomo,8,0,20,12
1657631042163,ECE 45,A01,083139,Congero; Spencer William,6,0,75,69
1657631048188,ECE 65,A50,083695,Saad; Andrew S,12,0,30,18
1657631048188,ECE 65,A51,095125,Saad; Andrew S,24,0,26,2
1657631054213,ECE 109,A01,091882,Touri; Behrouz,19,0,70,51
1657631060242,ECE 180,A00,083140,Abi Samra; Nicholas Camill,1,0,30,29
1657631060242,ECE 180,B00,083141,Abi Samra; Nicholas Camill,0,0,30,30
1657631066274,MATH 10A,A01,083735,Patchell; Gregory David,2,0,30,28
1657631066274,MATH 10A,A02,083736,Patchell; Gregory David,20,0,30,10
1657631066274,MATH 10A,A03,083737,Patchell; Gregory David,16,0,30,14
1657631072303,MATH 10B,A01,083207,Lim; Seonhee,8,0,34,26
1657631072303,MATH 10B,A02,083208,Lim; Seonhee,9,0,35,26
1657631072303,MATH 10B,A03,093472,Lim; Seonhee,7,0,34,27
1657631072303,MATH 10B,B01,083739,Sinha; Shubham,12,0,30,18
1657631078344,MATH 18,A01,083743,Cinel; Cameron Alexander,7,0,30,23
1657631078344,MATH 18,A02,083744,Cinel; Cameron Alexander,17,0,30,13
1657631078344,MATH 18,A03,083745,Cinel; Cameron Alexander,9,0,30,21
1657631078344,MATH 18,B01,083748,Rideout; David Porter,5,0,37,32
1657631078344,MATH 18,B02,083749,Rideout; David Porter,5,0,36,31
1657631078344,MATH 18,B03,083750,Rideout; David Porter,3,0,37,34
1657631078344,MATH 18,B04,083751,Rideout; David Porter,6,0,36,30
1657631078344,MATH 18,B05,093473,Rideout; David Porter,6,0,36,30
1657631078344,MATH 18,B06,093474,Rideout; David Porter,6,0,36,30
1657631084372,MATH 20A,A01,083754,Zheng; Zequn,14,0,40,26
1657631090401,MATH 20B,A01,083756,Briones; Jor-el Thomas Caparas,4,0,36,32
1657631090401,MATH 20B,A02,083757,Briones; Jor-el Thomas Caparas,1,0,36,35
1657631090401,MATH 20B,A03,093475,Briones; Jor-el Thomas Caparas,2,0,36,34
1657631096432,MATH 20C,A01,083760,Briones; Jor-el Thomas Caparas,1,0,35,34
1657631096432,MATH 20C,A02,083761,Briones; Jor-el Thomas Caparas,8,0,35,27
1657631096432,MATH 20C,A03,093476,Briones; Jor-el Thomas Caparas,0,1,36,36
1657631096432,MATH 20C,B01,083762,Bach; Quang Tran,1,0,30,29
1657631102463,MATH 20D,A01,083765,Tran; Brian Kha,5,0,30,25
1657631102463,MATH 20D,A02,083766,Tran; Brian Kha,5,0,30,25
1657631102463,MATH 20D,A03,083767,Tran; Brian Kha,5,0,30,25
1657631108499,MATH 20E,A01,083771,Ganguly; Soumya,9,0,32,23
1657631108499,MATH 20E,A02,083772,Ganguly; Soumya,6,0,32,26
1657631108499,MATH 20E,B01,083773,Ciotti; Benjamin,20,0,35,15
1657631108499,MATH 20E,B02,083774,Ciotti; Benjamin,18,0,35,17
1657631114524,MATH 103A,A01,083777,Greenfeld; Be'Eri,3,0,36,33
1657631114524,MATH 103A,A02,083778,Greenfeld; Be'Eri,5,0,36,31
1657631114524,MATH 103A,A03,093561,Greenfeld; Be'Eri,6,0,36,30
1657631114524,MATH 103A,B01,083779,Greenfeld; Be'Eri,7,0,36,29
1657631114524,MATH 103A,B02,083780,Greenfeld; Be'Eri,4,0,36,32
1657631114524,MATH 103A,B03,093562,Greenfeld; Be'Eri,3,0,36,33
1657631120549,MATH 105,A01,085443,Carter; Anne Toulson,15,0,35,20
1657631120549,MATH 105,A02,093477,Carter; Anne Toulson,20,0,35,15
1657631126580,MATH 109,A01,083213,Ganzberger; Geoffrey Michael,2,0,34,32
1657631126580,MATH 109,A02,083214,Ganzberger; Geoffrey Michael,4,0,34,30
1657631126580,MATH 109,A03,093478,Ganzberger; Geoffrey Michael,2,0,34,32
1657631126580,MATH 109,B01,083215,Ganzberger; Geoffrey Michael,1,0,32,31
1657631126580,MATH 109,B02,083216,Ganzberger; Geoffrey Michael,2,0,32,30
1657631126580,MATH 109,B03,093479,Ganzberger; Geoffrey Michael,8,0,32,24
1657631132608,MATH 142A,A01,083219,Chow; Bennett,7,0,32,25
1657631132608,MATH 142A,A02,083220,Chow; Bennett,10,0,32,22
1657631132608,MATH 142A,A03,093480,Chow; Bennett,9,0,32,23
1657631132608,MATH 142A,B03,093481,Chow; Bennett,8,0,32,24
1657631132608,MATH 142A,B04,093558,Chow; Bennett,13,0,32,19
1657631132608,MATH 142A,B05,093559,Chow; Bennett,6,0,32,26
1657631138635,MATH 193A,A01,083224,Rotar; Vladimir,8,0,34,26
1657631138635,MATH 193A,A02,083225,Rotar; Vladimir,9,0,34,25
1657631138635,MATH 193A,A03,083781,Rotar; Vladimir,5,0,34,29
1657631138635,MATH 193A,A04,083782,Rotar; Vladimir,10,0,34,24
1657631138635,MATH 193A,A05,093482,Rotar; Vladimir,10,0,34,24
1657631144661,MATH 197,001,091859,McAuley; Julian John,9999,0,9999,0
1657631144661,MATH 197,002,095566,Kedlaya; Kiran S.,9997,0,9999,2
1657631144661,MATH 197,003,095567,Xiao; Ming,9999,0,9999,0
1657631144661,MATH 197,004,095571,Perols; Johan Lars,9998,0,9999,1
1657631151755,COGS 9,A01,083615,Shannon; Kyle Michael,9,0,75,66
1657631157784,COGS 11,A01,083617,Boyle; Mary E. T.,23,0,48,25
1657631163818,COGS 13,A01,083071,Bastos; Amalia Pinkusfeld,11,0,71,60
1657631169847,COGS 14A,A01,092681,Semenuks; Arturs,5,1,100,95
1657631175872,COGS 14B,A01,083073,Cheng; Tzu-Han,6,0,63,57
1657631181900,COGS 17,A01,092677,Semenuks; Arturs,6,0,81,75
1657631187934,COGS 100,A01,083619,Allen; Michael Gordon,17,0,70,53
1657631193960,COGS 101A,A01,083621,Davis; Joshua Daniel,9,0,68,59
1657631199987,COGS 101B,A01,091572,Allen; Michael Gordon,12,0,65,53
1657631206013,COGS 101C,A01,083625,Delgado; Tania,17,0,35,18
1657631212043,COGS 107A,A01,083627,Boyle; Mary E. T.,13,0,60,47
1657631218085,COGS 118A,A01,083075,Gupta; Anjum,21,0,76,55
1657631224129,CSE 3,A50,083646,Miranda; Gregory Joseph,24,0,50,26
1657631230155,CSE 8A,A50,083650,Miranda; Gregory Joseph,17,1,56,39
1657631236183,CSE 11,A01,083080,Cao; Yingjun,6,15,40,34
1657631242216,CSE 12,A01,083652,Krause-Levy; Sophia Louisa,28,1,120,92
1657631248250,CSE 15L,A01,083654,Morris; Justin Loren,9,0,50,41
1657631248250,CSE 15L,A02,083655,Morris; Justin Loren,9,0,50,41
1657631254274,CSE 20,A01,083657,Tran; Khoa Dang,39,0,80,41
1657631260307,CSE 21,A01,095574,Bach; Quang Tran,22,0,48,26
1657631266335,CSE 30,A01,083084,Eldon; John,6,0,80,74
1657631266335,CSE 30,B01,095061,Bhaskar; Nishant,9,0,50,41
1657631272360,CSE 100,A01,083659,Cao; Yingjun,5,4,70,65
1657631278388,CSE 134B,A01,083661,Powell; Thomas Allan,22,0,100,78
1657631284415,CSE 140,A01,083663,Gungor; Onat,15,0,85,70
1657631290444,CSE 140L,A01,083088,Eldon; John,21,0,100,79
1657631296469,CSE 175,A01,083665,Kumar; Rakesh,3,0,25,22
1657631302502,CSE 190,A00,092507,Dubnov; Shlomo,8,0,20,12
1657631308536,ECE 45,A01,083139,Congero; Spencer William,6,0,75,69
1657631314563,ECE 65,A50,083695,Saad; Andrew S,12,0,30,18
1657631314563,ECE 65,A51,095125,Saad; Andrew S,24,0,26,2
1657631320589,ECE 109,A01,091882,Touri; Behrouz,19,0,70,51
1657631326614,ECE 180,A00,083140,Abi Samra; Nicholas Camill,1,0,30,29
1657631326614,ECE 180,B00,083141,Abi Samra; Nicholas Camill,0,0,30,30
1657631332643,MATH 10A,A01,083735,Patchell; Gregory David,2,0,30,28
1657631332643,MATH 10A,A02,083736,Patchell; Gregory David,20,0,30,10
1657631332643,MATH 10A,A03,083737,Patchell; Gregory David,16,0,30,14
1657631338684,MATH 10B,A01,083207,Lim; Seonhee,8,0,34,26
1657631338684,MATH 10B,A02,083208,Lim; Seonhee,9,0,35,26
1657631338684,MATH 10B,A03,093472,Lim; Seonhee,7,0,34,27
1657631338684,MATH 10B,B01,083739,Sinha; Shubham,12,0,30,18
1657631344728,MATH 18,A01,083743,Cinel; Cameron Alexander,7,0,30,23
1657631344728,MATH 18,A02,083744,Cinel; Cameron Alexander,17,0,30,13
1657631344728,MATH 18,A03,083745,Cinel; Cameron Alexander,9,0,30,21
1657631344728,MATH 18,B01,083748,Rideout; David Porter,5,0,37,32
1657631344728,MATH 18,B02,083749,Rideout; David Porter,5,0,36,31
1657631344728,MATH 18,B03,083750,Rideout; David Porter,3,0,37,34
1657631344728,MATH 18,B04,083751,Rideout; David Porter,6,0,36,30
1657631344728,MATH 18,B05,093473,Rideout; David Porter,6,0,36,30
1657631344728,MATH 18,B06,093474,Rideout; David Porter,6,0,36,30
1657631350755,MATH 20A,A01,083754,Zheng; Zequn,14,0,40,26
1657631356790,MATH 20B,A01,083756,Briones; Jor-el Thomas Caparas,4,0,36,32
1657631356790,MATH 20B,A02,083757,Briones; Jor-el Thomas Caparas,1,0,36,35
1657631356790,MATH 20B,A03,093475,Briones; Jor-el Thomas Caparas,2,0,36,34
1657631362818,MATH 20C,A01,083760,Briones; Jor-el Thomas Caparas,1,0,35,34
1657631362818,MATH 20C,A02,083761,Briones; Jor-el Thomas Caparas,8,0,35,27
1657631362818,MATH 20C,A03,093476,Briones; Jor-el Thomas Caparas,0,1,36,36
1657631362818,MATH 20C,B01,083762,Bach; Quang Tran,1,0,30,29
1657631368845,MATH 20D,A01,083765,Tran; Brian Kha,5,0,30,25
1657631368845,MATH 20D,A02,083766,Tran; Brian Kha,5,0,30,25
1657631368845,MATH 20D,A03,083767,Tran; Brian Kha,5,0,30,25
1657631374875,MATH 20E,A01,083771,Ganguly; Soumya,9,0,32,23
1657631374875,MATH 20E,A02,083772,Ganguly; Soumya,6,0,32,26
1657631374875,MATH 20E,B01,083773,Ciotti; Benjamin,20,0,35,15
1657631374875,MATH 20E,B02,083774,Ciotti; Benjamin,18,0,35,17
1657631380918,MATH 103A,A01,083777,Greenfeld; Be'Eri,3,0,36,33
1657631380918,MATH 103A,A02,083778,Greenfeld; Be'Eri,5,0,36,31
1657631380918,MATH 103A,A03,093561,Greenfeld; Be'Eri,6,0,36,30
1657631380918,MATH 103A,B01,083779,Greenfeld; Be'Eri,7,0,36,29
1657631380918,MATH 103A,B02,083780,Greenfeld; Be'Eri,4,0,36,32
1657631380918,MATH 103A,B03,093562,Greenfeld; Be'Eri,3,0,36,33
1657631386954,MATH 105,A01,085443,Carter; Anne Toulson,15,0,35,20
1657631386954,MATH 105,A02,093477,Carter; Anne Toulson,20,0,35,15
1657631392980,MATH 109,A01,083213,Ganzberger; Geoffrey Michael,2,0,34,32
1657631392980,MATH 109,A02,083214,Ganzberger; Geoffrey Michael,4,0,34,30
1657631392980,MATH 109,A03,093478,Ganzberger; Geoffrey Michael,2,0,34,32
1657631392980,MATH 109,B01,083215,Ganzberger; Geoffrey Michael,1,0,32,31
1657631392980,MATH 109,B02,083216,Ganzberger; Geoffrey Michael,2,0,32,30
1657631392980,MATH 109,B03,093479,Ganzberger; Geoffrey Michael,8,0,32,24
1657631399012,MATH 142A,A01,083219,Chow; Bennett,7,0,32,25
1657631399012,MATH 142A,A02,083220,Chow; Bennett,10,0,32,22
1657631399012,MATH 142A,A03,093480,Chow; Bennett,9,0,32,23
1657631399012,MATH 142A,B03,093481,Chow; Bennett,8,0,32,24
1657631399012,MATH 142A,B04,093558,Chow; Bennett,13,0,32,19
1657631399012,MATH 142A,B05,093559,Chow; Bennett,6,0,32,26
1657631405053,MATH 193A,A01,083224,Rotar; Vladimir,8,0,34,26
1657631405053,MATH 193A,A02,083225,Rotar; Vladimir,9,0,34,25
1657631405053,MATH 193A,A03,083781,Rotar; Vladimir,5,0,34,29
1657631405053,MATH 193A,A04,083782,Rotar; Vladimir,10,0,34,24
1657631405053,MATH 193A,A05,093482,Rotar; Vladimir,10,0,34,24
1657631411082,MATH 197,001,091859,McAuley; Julian John,9999,0,9999,0
1657631411082,MATH 197,002,095566,Kedlaya; Kiran S.,9997,0,9999,2
1657631411082,MATH 197,003,095567,Xiao; Ming,9999,0,9999,0
1657631411082,MATH 197,004,095571,Perols; Johan Lars,9998,0,9999,1
1657631418167,COGS 9,A01,083615,Shannon; Kyle Michael,9,0,75,66
1657631424194,COGS 11,A01,083617,Boyle; Mary E. T.,23,0,48,25
1657631430221,COGS 13,A01,083071,Bastos; Amalia Pinkusfeld,11,0,71,60
1657631436254,COGS 14A,A01,092681,Semenuks; Arturs,5,1,100,95
1657631442286,COGS 14B,A01,083073,Cheng; Tzu-Han,6,0,63,57
1657631448313,COGS 17,A01,092677,Semenuks; Arturs,6,0,81,75
1657631454340,COGS 100,A01,083619,Allen; Michael Gordon,17,0,70,53
1657631460365,COGS 101A,A01,083621,Davis; Joshua Daniel,9,0,68,59
1657631466399,COGS 101B,A01,091572,Allen; Michael Gordon,12,0,65,53
1657631472436,COGS 101C,A01,083625,Delgado; Tania,17,0,35,18
1657631478471,COGS 107A,A01,083627,Boyle; Mary E. T.,13,0,60,47
1657631484495,COGS 118A,A01,083075,Gupta; Anjum,21,0,76,55
1657631490523,CSE 3,A50,083646,Miranda; Gregory Joseph,24,0,50,26
1657631496555,CSE 8A,A50,083650,Miranda; Gregory Joseph,17,1,56,39
1657631502584,CSE 11,A01,083080,Cao; Yingjun,6,15,40,34
1657631508619,CSE 12,A01,083652,Krause-Levy; Sophia Louisa,28,1,120,92
1657631514650,CSE 15L,A01,083654,Morris; Justin Loren,9,0,50,41
1657631514650,CSE 15L,A02,083655,Morris; Justin Loren,9,0,50,41
1657631520674,CSE 20,A01,083657,Tran; Khoa Dang,39,0,80,41
1657631526707,CSE 21,A01,095574,Bach; Quang Tran,22,0,48,26
1657631532737,CSE 30,A01,083084,Eldon; John,6,0,80,74
1657631532737,CSE 30,B01,095061,Bhaskar; Nishant,9,0,50,41
1657631538769,CSE 100,A01,083659,Cao; Yingjun,5,4,70,65
1657631544797,CSE 134B,A01,083661,Powell; Thomas Allan,22,0,100,78
1657631550824,CSE 140,A01,083663,Gungor; Onat,15,0,85,70
1657631556850,CSE 140L,A01,083088,Eldon; John,21,0,100,79
1657631562886,CSE 175,A01,083665,Kumar; Rakesh,3,0,25,22
1657631568914,CSE 190,A00,092507,Dubnov; Shlomo,8,0,20,12
1657631574950,ECE 45,A01,083139,Congero; Spencer William,6,0,75,69
1657631581058,ECE 65,A50,083695,Saad; Andrew S,12,0,30,18
1657631581058,ECE 65,A51,095125,Saad; Andrew S,24,0,26,2
1657631587083,ECE 109,A01,091882,Touri; Behrouz,19,0,70,51
1657631593115,ECE 180,A00,083140,Abi Samra; Nicholas Camill,1,0,30,29
1657631593115,ECE 180,B00,083141,Abi Samra; Nicholas Camill,0,0,30,30
1657631599143,MATH 10A,A01,083735,Patchell; Gregory David,2,0,30,28
1657631599143,MATH 10A,A02,083736,Patchell; Gregory David,20,0,30,10
1657631599143,MATH 10A,A03,083737,Patchell; Gregory David,16,0,30,14
1657631605182,MATH 10B,A01,083207,Lim; Seonhee,8,0,34,26
1657631605182,MATH 10B,A02,083208,Lim; Seonhee,9,0,35,26
1657631605182,MATH 10B,A03,093472,Lim; Seonhee,7,0,34,27
1657631605182,MATH 10B,B01,083739,Sinha; Shubham,12,0,30,18
1657631611223,MATH 18,A01,083743,Cinel; Cameron Alexander,7,0,30,23
1657631611223,MATH 18,A02,083744,Cinel; Cameron Alexander,17,0,30,13
1657631611223,MATH 18,A03,083745,Cinel; Cameron Alexander,9,0,30,21
1657631611223,MATH 18,B01,083748,Rideout; David Porter,5,0,37,32
1657631611223,MATH 18,B02,083749,Rideout; David Porter,5,0,36,31
1657631611223,MATH 18,B03,083750,Rideout; David Porter,3,0,37,34
1657631611223,MATH 18,B04,083751,Rideout; David Porter,6,0,36,30
1657631611223,MATH 18,B05,093473,Rideout; David Porter,6,0,36,30
1657631611223,MATH 18,B06,093474,Rideout; David Porter,6,0,36,30
1657631617252,MATH 20A,A01,083754,Zheng; Zequn,14,0,40,26
1657631623278,MATH 20B,A01,083756,Briones; Jor-el Thomas Caparas,4,0,36,32
1657631623278,MATH 20B,A02,083757,Briones; Jor-el Thomas Caparas,1,0,36,35
1657631623278,MATH 20B,A03,093475,Briones; Jor-el Thomas Caparas,2,0,36,34
1657631629314,MATH 20C,A01,083760,Briones; Jor-el Thomas Caparas,1,0,35,34
1657631629314,MATH 20C,A02,083761,Briones; Jor-el Thomas Caparas,8,0,35,27
1657631629314,MATH 20C,A03,093476,Briones; Jor-el Thomas Caparas,0,1,36,36
1657631629314,MATH 20C,B01,083762,Bach; Quang Tran,1,0,30,29
1657631635347,MATH 20D,A01,083765,Tran; Brian Kha,5,0,30,25
1657631635347,MATH 20D,A02,083766,Tran; Brian Kha,5,0,30,25
1657631635347,MATH 20D,A03,083767,Tran; Brian Kha,5,0,30,25
1657631641382,MATH 20E,A01,083771,Ganguly; Soumya,9,0,32,23
1657631641382,MATH 20E,A02,083772,Ganguly; Soumya,6,0,32,26
1657631641382,MATH 20E,B01,083773,Ciotti; Benjamin,20,0,35,15
1657631641382,MATH 20E,B02,083774,Ciotti; Benjamin,18,0,35,17
1657631647410,MATH 103A,A01,083777,Greenfeld; Be'Eri,3,0,36,33
1657631647410,MATH 103A,A02,083778,Greenfeld; Be'Eri,5,0,36,31
1657631647410,MATH 103A,A03,093561,Greenfeld; Be'Eri,6,0,36,30
1657631647410,MATH 103A,B01,083779,Greenfeld; Be'Eri,7,0,36,29
1657631647410,MATH 103A,B02,083780,Greenfeld; Be'Eri,4,0,36,32
1657631647410,MATH 103A,B03,093562,Greenfeld; Be'Eri,3,0,36,33
1657631653445,MATH 105,A01,085443,Carter; Anne Toulson,15,0,35,20
1657631653445,MATH 105,A02,093477,Carter; Anne Toulson,20,0,35,15
1657631659476,MATH 109,A01,083213,Ganzberger; Geoffrey Michael,2,0,34,32
1657631659476,MATH 109,A02,083214,Ganzberger; Geoffrey Michael,4,0,34,30
1657631659476,MATH 109,A03,093478,Ganzberger; Geoffrey Michael,2,0,34,32
1657631659476,MATH 109,B01,083215,Ganzberger; Geoffrey Michael,1,0,32,31
1657631659476,MATH 109,B02,083216,Ganzberger; Geoffrey Michael,2,0,32,30
1657631659476,MATH 109,B03,093479,Ganzberger; Geoffrey Michael,8,0,32,24
1657631665504,MATH 142A,A01,083219,Chow; Bennett,7,0,32,25
1657631665504,MATH 142A,A02,083220,Chow; Bennett,10,0,32,22
1657631665504,MATH 142A,A03,093480,Chow; Bennett,9,0,32,23
1657631665504,MATH 142A,B03,093481,Chow; Bennett,8,0,32,24
1657631665504,MATH 142A,B04,093558,Chow; Bennett,13,0,32,19
1657631665504,MATH 142A,B05,093559,Chow; Bennett,6,0,32,26
1657631671528,MATH 193A,A01,083224,Rotar; Vladimir,8,0,34,26
1657631671528,MATH 193A,A02,083225,Rotar; Vladimir,9,0,34,25
1657631671528,MATH 193A,A03,083781,Rotar; Vladimir,5,0,34,29
1657631671528,MATH 193A,A04,083782,Rotar; Vladimir,10,0,34,24
1657631671528,MATH 193A,A05,093482,Rotar; Vladimir,10,0,34,24
1657631677554,MATH 197,001,091859,McAuley; Julian John,9999,0,9999,0
1657631677554,MATH 197,002,095566,Kedlaya; Kiran S.,9997,0,9999,2
1657631677554,MATH 197,003,095567,Xiao; Ming,9999,0,9999,0
1657631677554,MATH 197,004,095571,Perols; Johan Lars,9998,0,9999,1
1657631684624,COGS 9,A01,083615,Shannon; Kyle Michael,9,0,75,66
1657631690650,COGS 11,A01,083617,Boyle; Mary E. T.,23,0,48,25
1657631696677,COGS 13,A01,083071,Bastos; Amalia Pinkusfeld,11,0,71,60
1657631702716,COGS 14A,A01,092681,Semenuks; Arturs,5,1,100,95
1657631708742,COGS 14B,A01,083073,Cheng; Tzu-Han,6,0,63,57
1657631714767,COGS 17,A01,092677,Semenuks; Arturs,6,0,81,75
1657631720792,COGS 100,A01,083619,Allen; Michael Gordon,17,0,70,53
1657631726822,COGS 101A,A01,083621,Davis; Joshua Daniel,9,0,68,59
1657631732848,COGS 101B,A01,091572,Allen; Michael Gordon,12,0,65,53
1657631738879,COGS 101C,A01,083625,Delgado; Tania,17,0,35,18
1657631744904,COGS 107A,A01,083627,Boyle; Mary E. T.,13,0,60,47
1657631750930,COGS 118A,A01,083075,Gupta; Anjum,21,0,76,55
1657631756956,CSE 3,A50,083646,Miranda; Gregory Joseph,24,0,50,26
1657631762985,CSE 8A,A50,083650,Miranda; Gregory Joseph,17,1,56,39
1657631769015,CSE 11,A01,083080,Cao; Yingjun,6,15,40,34
1657631775041,CSE 12,A01,083652,Krause-Levy; Sophia Louisa,28,1,120,92
1657631781070,CSE 15L,A01,083654,Morris; Justin Loren,9,0,50,41
1657631781070,CSE 15L,A02,083655,Morris; Justin Loren,9,0,50,41
1657631787094,CSE 20,A01,083657,Tran; Khoa Dang,39,0,80,41
1657631793120,CSE 21,A01,095574,Bach; Quang Tran,22,0,48,26
1657631799150,CSE 30,A01,083084,Eldon; John,6,0,80,74
1657631799150,CSE 30,B01,095061,Bhaskar; Nishant,9,0,50,41
1657631805184,CSE 100,A01,083659,Cao; Yingjun,5,4,70,65
1657631811210,CSE 134B,A01,083661,Powell; Thomas Allan,22,0,100,78
1657631817239,CSE 140,A01,083663,Gungor; Onat,15,0,85,70
1657631823267,CSE 140L,A01,083088,Eldon; John,21,0,100,79
1657631829291,CSE 175,A01,083665,Kumar; Rakesh,3,0,25,22
1657631835324,CSE 190,A00,092507,Dubnov; Shlomo,8,0,20,12
1657631841351,ECE 45,A01,083139,Congero; Spencer William,6,0,75,69
1657631847381,ECE 65,A50,083695,Saad; Andrew S,12,0,30,18
1657631847381,ECE 65,A51,095125,Saad; Andrew S,24,0,26,2
1657631853406,ECE 109,A01,091882,Touri; Behrouz,19,0,70,51
1657631859431,ECE 180,A00,083140,Abi Samra; Nicholas Camill,1,0,30,29
1657631859431,ECE 180,B00,083141,Abi Samra; Nicholas Camill,0,0,30,30
1657631865468,MATH 10A,A01,083735,Patchell; Gregory David,2,0,30,28
1657631865468,MATH 10A,A02,083736,Patchell; Gregory David,20,0,30,10
1657631865468,MATH 10A,A03,083737,Patchell; Gregory David,16,0,30,14
1657631871508,MATH 10B,A01,083207,Lim; Seonhee,8,0,34,26
1657631871508,MATH 10B,A02,083208,Lim; Seonhee,9,0,35,26
1657631871508,MATH 10B,A03,093472,Lim; Seonhee,7,0,34,27
1657631871508,MATH 10B,B01,083739,Sinha; Shubham,12,0,30,18
1657631877546,MATH 18,A01,083743,Cinel; Cameron Alexander,7,0,30,23
1657631877546,MATH 18,A02,083744,Cinel; Cameron Alexander,17,0,30,13
1657631877546,MATH 18,A03,083745,Cinel; Cameron Alexander,9,0,30,21
1657631877546,MATH 18,B01,083748,Rideout; David Porter,5,0,37,32
1657631877546,MATH 18,B02,083749,Rideout; David Porter,5,0,36,31
1657631877546,MATH 18,B03,083750,Rideout; David Porter,3,0,37,34
1657631877546,MATH 18,B04,083751,Rideout; David Porter,6,0,36,30
1657631877546,MATH 18,B05,093473,Rideout; David Porter,6,0,36,30
1657631877546,MATH 18,B06,093474,Rideout; David Porter,6,0,36,30
1657631883570,MATH 20A,A01,083754,Zheng; Zequn,14,0,40,26
1657631889598,MATH 20B,A01,083756,Briones; Jor-el Thomas Caparas,4,0,36,32
1657631889598,MATH 20B,A02,083757,Briones; Jor-el Thomas Caparas,1,0,36,35
1657631889598,MATH 20B,A03,093475,Briones; Jor-el Thomas Caparas,2,0,36,34
1657631895627,MATH 20C,A01,083760,Briones; Jor-el Thomas Caparas,1,0,35,34
1657631895627,MATH 20C,A02,083761,Briones; Jor-el Thomas Caparas,8,0,35,27
1657631895627,MATH 20C,A03,093476,Briones; Jor-el Thomas Caparas,0,1,36,36
1657631895627,MATH 20C,B01,083762,Bach; Quang Tran,1,0,30,29
1657631901657,MATH 20D,A01,083765,Tran; Brian Kha,5,0,30,25
1657631901657,MATH 20D,A02,083766,Tran; Brian Kha,5,0,30,25
1657631901657,MATH 20D,A03,083767,Tran; Brian Kha,5,0,30,25
1657631907690,MATH 20E,A01,083771,Ganguly; Soumya,9,0,32,23
1657631907690,MATH 20E,A02,083772,Ganguly; Soumya,6,0,32,26
1657631907690,MATH 20E,B01,083773,Ciotti; Benjamin,20,0,35,15
1657631907690,MATH 20E,B02,083774,Ciotti; Benjamin,18,0,35,17
1657631913716,MATH 103A,A01,083777,Greenfeld; Be'Eri,3,0,36,33
1657631913716,MATH 103A,A02,083778,Greenfeld; Be'Eri,5,0,36,31
1657631913716,MATH 103A,A03,093561,Greenfeld; Be'Eri,6,0,36,30
1657631913716,MATH 103A,B01,083779,Greenfeld; Be'Eri,7,0,36,29
1657631913716,MATH 103A,B02,083780,Greenfeld; Be'Eri,4,0,36,32
1657631913716,MATH 103A,B03,093562,Greenfeld; Be'Eri,3,0,36,33
1657631919747,MATH 105,A01,085443,Carter; Anne Toulson,15,0,35,20
1657631919747,MATH 105,A02,093477,Carter; Anne Toulson,20,0,35,15
1657631925774,MATH 109,A01,083213,Ganzberger; Geoffrey Michael,2,0,34,32
1657631925774,MATH 109,A02,083214,Ganzberger; Geoffrey Michael,4,0,34,30
1657631925774,MATH 109,A03,093478,Ganzberger; Geoffrey Michael,2,0,34,32
1657631925774,MATH 109,B01,083215,Ganzberger; Geoffrey Michael,1,0,32,31
1657631925774,MATH 109,B02,083216,Ganzberger; Geoffrey Michael,2,0,32,30
1657631925774,MATH 109,B03,093479,Ganzberger; Geoffrey Michael,8,0,32,24
1657631931808,MATH 142A,A01,083219,Chow; Bennett,7,0,32,25
1657631931808,MATH 142A,A02,083220,Chow; Bennett,10,0,32,22
1657631931808,MATH 142A,A03,093480,Chow; Bennett,9,0,32,23
1657631931808,MATH 142A,B03,093481,Chow; Bennett,8,0,32,24
1657631931808,MATH 142A,B04,093558,Chow; Bennett,13,0,32,19
1657631931808,MATH 142A,B05,093559,Chow; Bennett,6,0,32,26
1657631937834,MATH 193A,A01,083224,Rotar; Vladimir,8,0,34,26
1657631937834,MATH 193A,A02,083225,Rotar; Vladimir,9,0,34,25
1657631937834,MATH 193A,A03,083781,Rotar; Vladimir,5,0,34,29
1657631937834,MATH 193A,A04,083782,Rotar; Vladimir,10,0,34,24
1657631937834,MATH 193A,A05,093482,Rotar; Vladimir,10,0,34,24
1657631943859,MATH 197,001,091859,McAuley; Julian John,9999,0,9999,0
1657631943859,MATH 197,002,095566,Kedlaya; Kiran S.,9997,0,9999,2
1657631943859,MATH 197,003,095567,Xiao; Ming,9999,0,9999,0
1657631943859,MATH 197,004,095571,Perols; Johan Lars,9998,0,9999,1
1657631950926,COGS 9,A01,083615,Shannon; Kyle Michael,9,0,75,66
1657631956951,COGS 11,A01,083617,Boyle; Mary E. T.,23,0,48,25
1657631962982,COGS 13,A01,083071,Bastos; Amalia Pinkusfeld,11,0,71,60
1657631969008,COGS 14A,A01,092681,Semenuks; Arturs,5,1,100,95
1657631975032,COGS 14B,A01,083073,Cheng; Tzu-Han,6,0,63,57
1657631981056,COGS 17,A01,092677,Semenuks; Arturs,6,0,81,75
1657631987081,COGS 100,A01,083619,Allen; Michael Gordon,17,0,70,53
1657631993108,COGS 101A,A01,083621,Davis; Joshua Daniel,9,0,68,59
1657631999137,COGS 101B,A01,091572,Allen; Michael Gordon,12,0,65,53
1657632005167,COGS 101C,A01,083625,Delgado; Tania,17,0,35,18
1657632011192,COGS 107A,A01,083627,Boyle; Mary E. T.,13,0,60,47
1657632017216,COGS 118A,A01,083075,Gupta; Anjum,21,0,76,55
1657632023244,CSE 3,A50,083646,Miranda; Gregory Joseph,24,0,50,26
1657632029269,CSE 8A,A50,083650,Miranda; Gregory Joseph,17,1,56,39
1657632035298,CSE 11,A01,083080,Cao; Yingjun,6,15,40,34
1657632041323,CSE 12,A01,083652,Krause-Levy; Sophia Louisa,28,1,120,92
1657632047347,CSE 15L,A01,083654,Morris; Justin Loren,9,0,50,41
1657632047347,CSE 15L,A02,083655,Morris; Justin Loren,9,0,50,41
1657632053377,CSE 20,A01,083657,Tran; Khoa Dang,39,0,80,41
1657632059401,CSE 21,A01,095574,Bach; Quang Tran,22,0,48,26
1657632065430,CSE 30,A01,083084,Eldon; John,6,0,80,74
1657632065430,CSE 30,B01,095061,Bhaskar; Nishant,9,0,50,41
1657632071453,CSE 100,A01,083659,Cao; Yingjun,5,4,70,65
1657632077479,CSE 134B,A01,083661,Powell; Thomas Allan,22,0,100,78
1657632083504,CSE 140,A01,083663,Gungor; Onat,15,0,85,70
1657632089534,CSE 140L,A01,083088,Eldon; John,21,0,100,79
1657632095564,CSE 175,A01,083665,Kumar; Rakesh,3,0,25,22
1657632101590,CSE 190,A00,092507,Dubnov; Shlomo,8,0,20,12
1657632107616,ECE 45,A01,083139,Congero; Spencer William,6,0,75,69
1657632113650,ECE 65,A50,083695,Saad; Andrew S,12,0,30,18
1657632113650,ECE 65,A51,095125,Saad; Andrew S,24,0,26,2
1657632119674,ECE 109,A01,091882,Touri; Behrouz,19,0,70,51
1657632125698,ECE 180,A00,083140,Abi Samra; Nicholas Camill,1,0,30,29
1657632125698,ECE 180,B00,083141,Abi Samra; Nicholas Camill,0,0,30,30
1657632131742,MATH 10A,A01,083735,Patchell; Gregory David,2,0,30,28
1657632131742,MATH 10A,A02,083736,Patchell; Gregory David,20,0,30,10
1657632131742,MATH 10A,A03,083737,Patchell; Gregory David,16,0,30,14
1657632137769,MATH 10B,A01,083207,Lim; Seonhee,8,0,34,26
1657632137769,MATH 10B,A02,083208,Lim; Seonhee,9,0,35,26
1657632137769,MATH 10B,A03,093472,Lim; Seonhee,7,0,34,27
1657632137769,MATH 10B,B01,083739,Sinha; Shubham,12,0,30,18
1657632143810,MATH 18,A01,083743,Cinel; Cameron Alexander,7,0,30,23
1657632143810,MATH 18,A02,083744,Cinel; Cameron Alexander,17,0,30,13
1657632143810,MATH 18,A03,083745,Cinel; Cameron Alexander,9,0,30,21
1657632143810,MATH 18,B01,083748,Rideout; David Porter,5,0,37,32
1657632143810,MATH 18,B02,083749,Rideout; David Porter,5,0,36,31
1657632143810,MATH 18,B03,083750,Rideout; David Porter,3,0,37,34
1657632143810,MATH 18,B04,083751,Rideout; David Porter,6,0,36,30
1657632143810,MATH 18,B05,093473,Rideout; David Porter,6,0,36,30
1657632143810,MATH 18,B06,093474,Rideout; David Porter,6,0,36,30
1657632149835,MATH 20A,A01,083754,Zheng; Zequn,14,0,40,26
1657632155868,MATH 20B,A01,083756,Briones; Jor-el Thomas Caparas,4,0,36,32
1657632155868,MATH 20B,A02,083757,Briones; Jor-el Thomas Caparas,1,0,36,35
1657632155868,MATH 20B,A03,093475,Briones; Jor-el Thomas Caparas,2,0,36,34
1657632161895,MATH 20C,A01,083760,Briones; Jor-el Thomas Caparas,1,0,35,34
1657632161895,MATH 20C,A02,083761,Briones; Jor-el Thomas Caparas,8,0,35,27
1657632161895,MATH 20C,A03,093476,Briones; Jor-el Thomas Caparas,0,1,36,36
1657632161895,MATH 20C,B01,083762,Bach; Quang Tran,1,0,30,29
1657632167921,MATH 20D,A01,083765,Tran; Brian Kha,5,0,30,25
1657632167921,MATH 20D,A02,083766,Tran; Brian Kha,5,0,30,25
1657632167921,MATH 20D,A03,083767,Tran; Brian Kha,5,0,30,25
1657632173949,MATH 20E,A01,083771,Ganguly; Soumya,9,0,32,23
1657632173949,MATH 20E,A02,083772,Ganguly; Soumya,6,0,32,26
1657632173949,MATH 20E,B01,083773,Ciotti; Benjamin,20,0,35,15
1657632173949,MATH 20E,B02,083774,Ciotti; Benjamin,18,0,35,17
1657632180065,MATH 103A,A01,083777,Greenfeld; Be'Eri,3,0,36,33
1657632180065,MATH 103A,A02,083778,Greenfeld; Be'Eri,5,0,36,31
1657632180065,MATH 103A,A03,093561,Greenfeld; Be'Eri,6,0,36,30
1657632180065,MATH 103A,B01,083779,Greenfeld; Be'Eri,7,0,36,29
1657632180065,MATH 103A,B02,083780,Greenfeld; Be'Eri,4,0,36,32
1657632180065,MATH 103A,B03,093562,Greenfeld; Be'Eri,3,0,36,33
1657632186092,MATH 105,A01,085443,Carter; Anne Toulson,15,0,35,20
1657632186092,MATH 105,A02,093477,Carter; Anne Toulson,20,0,35,15
1657632192121,MATH 109,A01,083213,Ganzberger; Geoffrey Michael,2,0,34,32
1657632192121,MATH 109,A02,083214,Ganzberger; Geoffrey Michael,4,0,34,30
1657632192121,MATH 109,A03,093478,Ganzberger; Geoffrey Michael,2,0,34,32
1657632192121,MATH 109,B01,083215,Ganzberger; Geoffrey Michael,1,0,32,31
1657632192121,MATH 109,B02,083216,Ganzberger; Geoffrey Michael,2,0,32,30
1657632192121,MATH 109,B03,093479,Ganzberger; Geoffrey Michael,8,0,32,24
1657632198158,MATH 142A,A01,083219,Chow; Bennett,7,0,32,25
1657632198158,MATH 142A,A02,083220,Chow; Bennett,10,0,32,22
1657632198158,MATH 142A,A03,093480,Chow; Bennett,9,0,32,23
1657632198158,MATH 142A,B03,093481,Chow; Bennett,8,0,32,24
1657632198158,MATH 142A,B04,093558,Chow; Bennett,13,0,32,19
1657632198158,MATH 142A,B05,093559,Chow; Bennett,6,0,32,26
1657632204183,MATH 193A,A01,083224,Rotar; Vladimir,8,0,34,26
1657632204183,MATH 193A,A02,083225,Rotar; Vladimir,9,0,34,25
1657632204183,MATH 193A,A03,083781,Rotar; Vladimir,5,0,34,29
1657632204183,MATH 193A,A04,083782,Rotar; Vladimir,10,0,34,24
1657632204183,MATH 193A,A05,093482,Rotar; Vladimir,10,0,34,24
1657632210212,MATH 197,001,091859,McAuley; Julian John,9999,0,9999,0
1657632210212,MATH 197,002,095566,Kedlaya; Kiran S.,9997,0,9999,2
1657632210212,MATH 197,003,095567,Xiao; Ming,9999,0,9999,0
1657632210212,MATH 197,004,095571,Perols; Johan Lars,9998,0,9999,1
1657632217288,COGS 9,A01,083615,Shannon; Kyle Michael,9,0,75,66
1657632223313,COGS 11,A01,083617,Boyle; Mary E. T.,23,0,48,25
1657632229342,COGS 13,A01,083071,Bastos; Amalia Pinkusfeld,11,0,71,60
1657632235366,COGS 14A,A01,092681,Semenuks; Arturs,5,1,100,95
1657632241392,COGS 14B,A01,083073,Cheng; Tzu-Han,6,0,63,57
1657632247420,COGS 17,A01,092677,Semenuks; Arturs,6,0,81,75
1657632253456,COGS 100,A01,083619,Allen; Michael Gordon,17,0,70,53
1657632259481,COGS 101A,A01,083621,Davis; Joshua Daniel,9,0,68,59
1657632265511,COGS 101B,A01,091572,Allen; Michael Gordon,12,0,65,53
1657632271541,COGS 101C,A01,083625,Delgado; Tania,17,0,35,18
1657632277570,COGS 107A,A01,083627,Boyle; Mary E. T.,13,0,60,47
1657632283599,COGS 118A,A01,083075,Gupta; Anjum,21,0,76,55
1657632289624,CSE 3,A50,083646,Miranda; Gregory Joseph,24,0,50,26
1657632295649,CSE 8A,A50,083650,Miranda; Gregory Joseph,17,1,56,39
1657632301675,CSE 11,A01,083080,Cao; Yingjun,6,15,40,34
1657632307700,CSE 12,A01,083652,Krause-Levy; Sophia Louisa,28,1,120,92
1657632313732,CSE 15L,A01,083654,Morris; Justin Loren,9,0,50,41
1657632313732,CSE 15L,A02,083655,Morris; Justin Loren,9,0,50,41
1657632319761,CSE 20,A01,083657,Tran; Khoa Dang,39,0,80,41
1657632325787,CSE 21,A01,095574,Bach; Quang Tran,22,0,48,26
1657632331832,CSE 30,A01,083084,Eldon; John,6,0,80,74
1657632331832,CSE 30,B01,095061,Bhaskar; Nishant,9,0,50,41
1657632337864,CSE 100,A01,083659,Cao; Yingjun,5,4,70,65
1657632343891,CSE 134B,A01,083661,Powell; Thomas Allan,22,0,100,78
1657632349917,CSE 140,A01,083663,Gungor; Onat,15,0,85,70
1657632355965,CSE 140L,A01,083088,Eldon; John,21,0,100,79
1657632361997,CSE 175,A01,083665,Kumar; Rakesh,3,0,25,22
1657632368022,CSE 190,A00,092507,Dubnov; Shlomo,8,0,20,12
1657632374054,ECE 45,A01,083139,Congero; Spencer William,6,0,75,69
1657632380081,ECE 65,A50,083695,Saad; Andrew S,12,0,30,18
1657632380081,ECE 65,A51,095125,Saad; Andrew S,24,0,26,2
1657632386107,ECE 109,A01,091882,Touri; Behrouz,19,0,70,51
1657632392132,ECE 180,A00,083140,Abi Samra; Nicholas Camill,1,0,30,29
1657632392132,ECE 180,B00,083141,Abi Samra; Nicholas Camill,0,0,30,30
1657632398160,MATH 10A,A01,083735,Patchell; Gregory David,2,0,30,28
1657632398160,MATH 10A,A02,083736,Patchell; Gregory David,20,0,30,10
1657632398160,MATH 10A,A03,083737,Patchell; Gregory David,16,0,30,14
1657632404197,MATH 10B,A01,083207,Lim; Seonhee,8,0,34,26
1657632404197,MATH 10B,A02,083208,Lim; Seonhee,9,0,35,26
1657632404197,MATH 10B,A03,093472,Lim; Seonhee,7,0,34,27
1657632404197,MATH 10B,B01,083739,Sinha; Shubham,12,0,30,18
1657632410226,MATH 18,A01,083743,Cinel; Cameron Alexander,7,0,30,23
1657632410226,MATH 18,A02,083744,Cinel; Cameron Alexander,17,0,30,13
1657632410226,MATH 18,A03,083745,Cinel; Cameron Alexander,9,0,30,21
1657632410226,MATH 18,B01,083748,Rideout; David Porter,5,0,37,32
1657632410226,MATH 18,B02,083749,Rideout; David Porter,5,0,36,31
1657632410226,MATH 18,B03,083750,Rideout; David Porter,3,0,37,34
1657632410226,MATH 18,B04,083751,Rideout; David Porter,6,0,36,30
1657632410226,MATH 18,B05,093473,Rideout; David Porter,6,0,36,30
1657632410226,MATH 18,B06,093474,Rideout; David Porter,6,0,36,30
1657632416260,MATH 20A,A01,083754,Zheng; Zequn,14,0,40,26
1657632422296,MATH 20B,A01,083756,Briones; Jor-el Thomas Caparas,4,0,36,32
1657632422296,MATH 20B,A02,083757,Briones; Jor-el Thomas Caparas,1,0,36,35
1657632422296,MATH 20B,A03,093475,Briones; Jor-el Thomas Caparas,2,0,36,34
1657632428321,MATH 20C,A01,083760,Briones; Jor-el Thomas Caparas,1,0,35,34
1657632428321,MATH 20C,A02,083761,Briones; Jor-el Thomas Caparas,8,0,35,27
1657632428321,MATH 20C,A03,093476,Briones; Jor-el Thomas Caparas,0,1,36,36
1657632428321,MATH 20C,B01,083762,Bach; Quang Tran,1,0,30,29
1657632434347,MATH 20D,A01,083765,Tran; Brian Kha,5,0,30,25
1657632434347,MATH 20D,A02,083766,Tran; Brian Kha,5,0,30,25
1657632434347,MATH 20D,A03,083767,Tran; Brian Kha,5,0,30,25
1657632440382,MATH 20E,A01,083771,Ganguly; Soumya,9,0,32,23
1657632440382,MATH 20E,A02,083772,Ganguly; Soumya,6,0,32,26
1657632440382,MATH 20E,B01,083773,Ciotti; Benjamin,20,0,35,15
1657632440382,MATH 20E,B02,083774,Ciotti; Benjamin,18,0,35,17
1657632446410,MATH 103A,A01,083777,Greenfeld; Be'Eri,3,0,36,33
1657632446410,MATH 103A,A02,083778,Greenfeld; Be'Eri,5,0,36,31
1657632446410,MATH 103A,A03,093561,Greenfeld; Be'Eri,6,0,36,30
1657632446410,MATH 103A,B01,083779,Greenfeld; Be'Eri,7,0,36,29
1657632446410,MATH 103A,B02,083780,Greenfeld; Be'Eri,4,0,36,32
1657632446410,MATH 103A,B03,093562,Greenfeld; Be'Eri,3,0,36,33
1657632452442,MATH 105,A01,085443,Carter; Anne Toulson,15,0,35,20
1657632452442,MATH 105,A02,093477,Carter; Anne Toulson,20,0,35,15
1657632458565,MATH 109,A01,083213,Ganzberger; Geoffrey Michael,2,0,34,32
1657632458565,MATH 109,A02,083214,Ganzberger; Geoffrey Michael,4,0,34,30
1657632458565,MATH 109,A03,093478,Ganzberger; Geoffrey Michael,2,0,34,32
1657632458565,MATH 109,B01,083215,Ganzberger; Geoffrey Michael,1,0,32,31
1657632458565,MATH 109,B02,083216,Ganzberger; Geoffrey Michael,2,0,32,30
1657632458565,MATH 109,B03,093479,Ganzberger; Geoffrey Michael,8,0,32,24
1657632464592,MATH 142A,A01,083219,Chow; Bennett,7,0,32,25
1657632464592,MATH 142A,A02,083220,Chow; Bennett,10,0,32,22
1657632464592,MATH 142A,A03,093480,Chow; Bennett,9,0,32,23
1657632464592,MATH 142A,B03,093481,Chow; Bennett,8,0,32,24
1657632464592,MATH 142A,B04,093558,Chow; Bennett,13,0,32,19
1657632464592,MATH 142A,B05,093559,Chow; Bennett,6,0,32,26
1657632470620,MATH 193A,A01,083224,Rotar; Vladimir,8,0,34,26
1657632470620,MATH 193A,A02,083225,Rotar; Vladimir,9,0,34,25
1657632470620,MATH 193A,A03,083781,Rotar; Vladimir,5,0,34,29
1657632470620,MATH 193A,A04,083782,Rotar; Vladimir,10,0,34,24
1657632470620,MATH 193A,A05,093482,Rotar; Vladimir,10,0,34,24
1657632476652,MATH 197,001,091859,McAuley; Julian John,9999,0,9999,0
1657632476652,MATH 197,002,095566,Kedlaya; Kiran S.,9997,0,9999,2
1657632476652,MATH 197,003,095567,Xiao; Ming,9999,0,9999,0
1657632476652,MATH 197,004,095571,Perols; Johan Lars,9998,0,9999,1
1657632483713,COGS 9,A01,083615,Shannon; Kyle Michael,9,0,75,66
1657632489743,COGS 11,A01,083617,Boyle; Mary E. T.,23,0,48,25
1657632495773,COGS 13,A01,083071,Bastos; Amalia Pinkusfeld,11,0,71,60
1657632501801,COGS 14A,A01,092681,Semenuks; Arturs,5,1,100,95
1657632507827,COGS 14B,A01,083073,Cheng; Tzu-Han,6,0,63,57
1657632513862,COGS 17,A01,092677,Semenuks; Arturs,6,0,81,75
1657632519888,COGS 100,A01,083619,Allen; Michael Gordon,17,0,70,53
1657632525913,COGS 101A,A01,083621,Davis; Joshua Daniel,9,0,68,59
1657632531943,COGS 101B,A01,091572,Allen; Michael Gordon,12,0,65,53
1657632537974,COGS 101C,A01,083625,Delgado; Tania,17,0,35,18
1657632543998,COGS 107A,A01,083627,Boyle; Mary E. T.,13,0,60,47
1657632550032,COGS 118A,A01,083075,Gupta; Anjum,21,0,76,55
1657632556065,CSE 3,A50,083646,Miranda; Gregory Joseph,24,0,50,26
1657632562088,CSE 8A,A50,083650,Miranda; Gregory Joseph,17,1,56,39
1657632568113,CSE 11,A01,083080,Cao; Yingjun,6,15,40,34
1657632574150,CSE 12,A01,083652,Krause-Levy; Sophia Louisa,28,1,120,92
1657632580180,CSE 15L,A01,083654,Morris; Justin Loren,9,0,50,41
1657632580180,CSE 15L,A02,083655,Morris; Justin Loren,9,0,50,41
1657632586206,CSE 20,A01,083657,Tran; Khoa Dang,39,0,80,41
1657632592229,CSE 21,A01,095574,Bach; Quang Tran,22,0,48,26
1657632598257,CSE 30,A01,083084,Eldon; John,6,0,80,74
1657632598257,CSE 30,B01,095061,Bhaskar; Nishant,9,0,50,41
1657632604292,CSE 100,A01,083659,Cao; Yingjun,5,4,70,65
1657632610320,CSE 134B,A01,083661,Powell; Thomas Allan,22,0,100,78
1657632616348,CSE 140,A01,083663,Gungor; Onat,15,0,85,70
1657632622373,CSE 140L,A01,083088,Eldon; John,21,0,100,79
1657632628399,CSE 175,A01,083665,Kumar; Rakesh,3,0,25,22
1657632634426,CSE 190,A00,092507,Dubnov; Shlomo,8,0,20,12
1657632640455,ECE 45,A01,083139,Congero; Spencer William,6,0,75,69
1657632646490,ECE 65,A50,083695,Saad; Andrew S,12,0,30,18
1657632646490,ECE 65,A51,095125,Saad; Andrew S,24,0,26,2
1657632652518,ECE 109,A01,091882,Touri; Behrouz,19,0,70,51
1657632658541,ECE 180,A00,083140,Abi Samra; Nicholas Camill,1,0,30,29
1657632658541,ECE 180,B00,083141,Abi Samra; Nicholas Camill,0,0,30,30
1657632664568,MATH 10A,A01,083735,Patchell; Gregory David,2,0,30,28
1657632664568,MATH 10A,A02,083736,Patchell; Gregory David,20,0,30,10
1657632664568,MATH 10A,A03,083737,Patchell; Gregory David,16,0,30,14
1657632670596,MATH 10B,A01,083207,Lim; Seonhee,8,0,34,26
1657632670596,MATH 10B,A02,083208,Lim; Seonhee,9,0,35,26
1657632670596,MATH 10B,A03,093472,Lim; Seonhee,7,0,34,27
1657632670596,MATH 10B,B01,083739,Sinha; Shubham,12,0,30,18
1657632676625,MATH 18,A01,083743,Cinel; Cameron Alexander,7,0,30,23
1657632676625,MATH 18,A02,083744,Cinel; Cameron Alexander,17,0,30,13
1657632676625,MATH 18,A03,083745,Cinel; Cameron Alexander,9,0,30,21
1657632676625,MATH 18,B01,083748,Rideout; David Porter,5,0,37,32
1657632676625,MATH 18,B02,083749,Rideout; David Porter,5,0,36,31
1657632676625,MATH 18,B03,083750,Rideout; David Porter,3,0,37,34
1657632676625,MATH 18,B04,083751,Rideout; David Porter,6,0,36,30
1657632676625,MATH 18,B05,093473,Rideout; David Porter,6,0,36,30
1657632676625,MATH 18,B06,093474,Rideout; David Porter,6,0,36,30
1657632682655,MATH 20A,A01,083754,Zheng; Zequn,14,0,40,26
1657632688685,MATH 20B,A01,083756,Briones; Jor-el Thomas Caparas,4,0,36,32
1657632688685,MATH 20B,A02,083757,Briones; Jor-el Thomas Caparas,1,0,36,35
1657632688685,MATH 20B,A03,093475,Briones; Jor-el Thomas Caparas,2,0,36,34
1657632694709,MATH 20C,A01,083760,Briones; Jor-el Thomas Caparas,1,0,35,34
1657632694709,MATH 20C,A02,083761,Briones; Jor-el Thomas Caparas,8,0,35,27
1657632694709,MATH 20C,A03,093476,Briones; Jor-el Thomas Caparas,0,1,36,36
1657632694709,MATH 20C,B01,083762,Bach; Quang Tran,1,0,30,29
1657632700735,MATH 20D,A01,083765,Tran; Brian Kha,5,0,30,25
1657632700735,MATH 20D,A02,083766,Tran; Brian Kha,5,0,30,25
1657632700735,MATH 20D,A03,083767,Tran; Brian Kha,5,0,30,25
1657632706771,MATH 20E,A01,083771,Ganguly; Soumya,9,0,32,23
1657632706771,MATH 20E,A02,083772,Ganguly; Soumya,6,0,32,26
1657632706771,MATH 20E,B01,083773,Ciotti; Benjamin,20,0,35,15
1657632706771,MATH 20E,B02,083774,Ciotti; Benjamin,18,0,35,17
1657632712796,MATH 103A,A01,083777,Greenfeld; Be'Eri,3,0,36,33
1657632712796,MATH 103A,A02,083778,Greenfeld; Be'Eri,5,0,36,31
1657632712796,MATH 103A,A03,093561,Greenfeld; Be'Eri,6,0,36,30
1657632712796,MATH 103A,B01,083779,Greenfeld; Be'Eri,7,0,36,29
1657632712796,MATH 103A,B02,083780,Greenfeld; Be'Eri,4,0,36,32
1657632712796,MATH 103A,B03,093562,Greenfeld; Be'Eri,3,0,36,33
1657632718821,MATH 105,A01,085443,Carter; Anne Toulson,15,0,35,20
1657632718821,MATH 105,A02,093477,Carter; Anne Toulson,20,0,35,15
1657632724848,MATH 109,A01,083213,Ganzberger; Geoffrey Michael,2,0,34,32
1657632724848,MATH 109,A02,083214,Ganzberger; Geoffrey Michael,4,0,34,30
1657632724848,MATH 109,A03,093478,Ganzberger; Geoffrey Michael,2,0,34,32
1657632724848,MATH 109,B01,083215,Ganzberger; Geoffrey Michael,1,0,32,31
1657632724848,MATH 109,B02,083216,Ganzberger; Geoffrey Michael,2,0,32,30
1657632724848,MATH 109,B03,093479,Ganzberger; Geoffrey Michael,8,0,32,24
1657632730874,MATH 142A,A01,083219,Chow; Bennett,7,0,32,25
1657632730874,MATH 142A,A02,083220,Chow; Bennett,10,0,32,22
1657632730874,MATH 142A,A03,093480,Chow; Bennett,9,0,32,23
1657632730874,MATH 142A,B03,093481,Chow; Bennett,8,0,32,24
1657632730874,MATH 142A,B04,093558,Chow; Bennett,13,0,32,19
1657632730874,MATH 142A,B05,093559,Chow; Bennett,6,0,32,26
1657632736904,MATH 193A,A01,083224,Rotar; Vladimir,8,0,34,26
1657632736904,MATH 193A,A02,083225,Rotar; Vladimir,9,0,34,25
1657632736904,MATH 193A,A03,083781,Rotar; Vladimir,5,0,34,29
1657632736904,MATH 193A,A04,083782,Rotar; Vladimir,10,0,34,24
1657632736904,MATH 193A,A05,093482,Rotar; Vladimir,10,0,34,24
1657632742931,MATH 197,001,091859,McAuley; Julian John,9999,0,9999,0
1657632742931,MATH 197,002,095566,Kedlaya; Kiran S.,9997,0,9999,2
1657632742931,MATH 197,003,095567,Xiao; Ming,9999,0,9999,0
1657632742931,MATH 197,004,095571,Perols; Johan Lars,9998,0,9999,1
1657632749998,COGS 9,A01,083615,Shannon; Kyle Michael,9,0,75,66
1657632756022,COGS 11,A01,083617,Boyle; Mary E. T.,23,0,48,25
1657632762056,COGS 13,A01,083071,Bastos; Amalia Pinkusfeld,11,0,71,60
1657632768085,COGS 14A,A01,092681,Semenuks; Arturs,5,1,100,95
1657632774212,COGS 14B,A01,083073,Cheng; Tzu-Han,6,0,63,57
1657632780238,COGS 17,A01,092677,Semenuks; Arturs,6,0,81,75
1657632786273,COGS 100,A01,083619,Allen; Michael Gordon,17,0,70,53
1657632792306,COGS 101A,A01,083621,Davis; Joshua Daniel,9,0,68,59
1657632798335,COGS 101B,A01,091572,Allen; Michael Gordon,12,0,65,53
1657632804362,COGS 101C,A01,083625,Delgado; Tania,17,0,35,18
1657632810389,COGS 107A,A01,083627,Boyle; Mary E. T.,13,0,60,47
1657632816413,COGS 118A,A01,083075,Gupta; Anjum,21,0,76,55
1657632822448,CSE 3,A50,083646,Miranda; Gregory Joseph,24,0,50,26
1657632828476,CSE 8A,A50,083650,Miranda; Gregory Joseph,17,1,56,39
1657632834510,CSE 11,A01,083080,Cao; Yingjun,6,15,40,34
1657632840541,CSE 12,A01,083652,Krause-Levy; Sophia Louisa,28,1,120,92
1657632846588,CSE 15L,A01,083654,Morris; Justin Loren,9,0,50,41
1657632846588,CSE 15L,A02,083655,Morris; Justin Loren,9,0,50,41
1657632852613,CSE 20,A01,083657,Tran; Khoa Dang,39,0,80,41
1657632858640,CSE 21,A01,095574,Bach; Quang Tran,22,0,48,26
1657632864673,CSE 30,A01,083084,Eldon; John,6,0,80,74
1657632864673,CSE 30,B01,095061,Bhaskar; Nishant,9,0,50,41
1657632870699,CSE 100,A01,083659,Cao; Yingjun,5,4,70,65
1657632876725,CSE 134B,A01,083661,Powell; Thomas Allan,22,0,100,78
1657632882751,CSE 140,A01,083663,Gungor; Onat,15,0,85,70
1657632888776,CSE 140L,A01,083088,Eldon; John,21,0,100,79
1657632894807,CSE 175,A01,083665,Kumar; Rakesh,3,0,25,22
1657632900833,CSE 190,A00,092507,Dubnov; Shlomo,8,0,20,12
1657632906860,ECE 45,A01,083139,Congero; Spencer William,6,0,75,69
1657632912895,ECE 65,A50,083695,Saad; Andrew S,12,0,30,18
1657632912895,ECE 65,A51,095125,Saad; Andrew S,24,0,26,2
1657632918923,ECE 109,A01,091882,Touri; Behrouz,19,0,70,51
1657632924955,ECE 180,A00,083140,Abi Samra; Nicholas Camill,1,0,30,29
1657632924955,ECE 180,B00,083141,Abi Samra; Nicholas Camill,0,0,30,30
1657632931007,MATH 10A,A01,083735,Patchell; Gregory David,2,0,30,28
1657632931007,MATH 10A,A02,083736,Patchell; Gregory David,20,0,30,10
1657632931007,MATH 10A,A03,083737,Patchell; Gregory David,16,0,30,14
1657632937044,MATH 10B,A01,083207,Lim; Seonhee,8,0,34,26
1657632937044,MATH 10B,A02,083208,Lim; Seonhee,9,0,35,26
1657632937044,MATH 10B,A03,093472,Lim; Seonhee,7,0,34,27
1657632937044,MATH 10B,B01,083739,Sinha; Shubham,12,0,30,18
1657632943075,MATH 18,A01,083743,Cinel; Cameron Alexander,7,0,30,23
1657632943075,MATH 18,A02,083744,Cinel; Cameron Alexander,17,0,30,13
1657632943075,MATH 18,A03,083745,Cinel; Cameron Alexander,9,0,30,21
1657632943075,MATH 18,B01,083748,Rideout; David Porter,5,0,37,32
1657632943075,MATH 18,B02,083749,Rideout; David Porter,5,0,36,31
1657632943075,MATH 18,B03,083750,Rideout; David Porter,3,0,37,34
1657632943075,MATH 18,B04,083751,Rideout; David Porter,6,0,36,30
1657632943075,MATH 18,B05,093473,Rideout; David Porter,6,0,36,30
1657632943075,MATH 18,B06,093474,Rideout; David Porter,6,0,36,30
1657632949101,MATH 20A,A01,083754,Zheng; Zequn,14,0,40,26
1657632955130,MATH 20B,A01,083756,Briones; Jor-el Thomas Caparas,4,0,36,32
1657632955130,MATH 20B,A02,083757,Briones; Jor-el Thomas Caparas,1,0,36,35
1657632955130,MATH 20B,A03,093475,Briones; Jor-el Thomas Caparas,2,0,36,34
1657632961155,MATH 20C,A01,083760,Briones; Jor-el Thomas Caparas,1,0,35,34
1657632961155,MATH 20C,A02,083761,Briones; Jor-el Thomas Caparas,8,0,35,27
1657632961155,MATH 20C,A03,093476,Briones; Jor-el Thomas Caparas,0,1,36,36
1657632961155,MATH 20C,B01,083762,Bach; Quang Tran,1,0,30,29
1657632967192,MATH 20D,A01,083765,Tran; Brian Kha,5,0,30,25
1657632967192,MATH 20D,A02,083766,Tran; Brian Kha,5,0,30,25
1657632967192,MATH 20D,A03,083767,Tran; Brian Kha,5,0,30,25
1657632973251,MATH 20E,A01,083771,Ganguly; Soumya,9,0,32,23
1657632973251,MATH 20E,A02,083772,Ganguly; Soumya,6,0,32,26
1657632973251,MATH 20E,B01,083773,Ciotti; Benjamin,20,0,35,15
1657632973251,MATH 20E,B02,083774,Ciotti; Benjamin,18,0,35,17
1657632979302,MATH 103A,A01,083777,Greenfeld; Be'Eri,3,0,36,33
1657632979302,MATH 103A,A02,083778,Greenfeld; Be'Eri,5,0,36,31
1657632979302,MATH 103A,A03,093561,Greenfeld; Be'Eri,6,0,36,30
1657632979302,MATH 103A,B01,083779,Greenfeld; Be'Eri,7,0,36,29
1657632979302,MATH 103A,B02,083780,Greenfeld; Be'Eri,4,0,36,32
1657632979302,MATH 103A,B03,093562,Greenfeld; Be'Eri,3,0,36,33
1657632985328,MATH 105,A01,085443,Carter; Anne Toulson,15,0,35,20
1657632985328,MATH 105,A02,093477,Carter; Anne Toulson,20,0,35,15
1657632991355,MATH 109,A01,083213,Ganzberger; Geoffrey Michael,2,0,34,32
1657632991355,MATH 109,A02,083214,Ganzberger; Geoffrey Michael,4,0,34,30
1657632991355,MATH 109,A03,093478,Ganzberger; Geoffrey Michael,2,0,34,32
1657632991355,MATH 109,B01,083215,Ganzberger; Geoffrey Michael,1,0,32,31
1657632991355,MATH 109,B02,083216,Ganzberger; Geoffrey Michael,2,0,32,30
1657632991355,MATH 109,B03,093479,Ganzberger; Geoffrey Michael,8,0,32,24
1657632997384,MATH 142A,A01,083219,Chow; Bennett,7,0,32,25
1657632997384,MATH 142A,A02,083220,Chow; Bennett,10,0,32,22
1657632997384,MATH 142A,A03,093480,Chow; Bennett,9,0,32,23
1657632997384,MATH 142A,B03,093481,Chow; Bennett,8,0,32,24
1657632997384,MATH 142A,B04,093558,Chow; Bennett,13,0,32,19
1657632997384,MATH 142A,B05,093559,Chow; Bennett,6,0,32,26
1657633003423,MATH 193A,A01,083224,Rotar; Vladimir,8,0,34,26
1657633003423,MATH 193A,A02,083225,Rotar; Vladimir,9,0,34,25
1657633003423,MATH 193A,A03,083781,Rotar; Vladimir,5,0,34,29
1657633003423,MATH 193A,A04,083782,Rotar; Vladimir,10,0,34,24
1657633003423,MATH 193A,A05,093482,Rotar; Vladimir,10,0,34,24
1657633009455,MATH 197,001,091859,McAuley; Julian John,9999,0,9999,0
1657633009455,MATH 197,002,095566,Kedlaya; Kiran S.,9997,0,9999,2
1657633009455,MATH 197,003,095567,Xiao; Ming,9999,0,9999,0
1657633009455,MATH 197,004,095571,Perols; Johan Lars,9998,0,9999,1
1657633016532,COGS 9,A01,083615,Shannon; Kyle Michael,9,0,75,66
1657633022557,COGS 11,A01,083617,Boyle; Mary E. T.,23,0,48,25
1657633028583,COGS 13,A01,083071,Bastos; Amalia Pinkusfeld,11,0,71,60
1657633034611,COGS 14A,A01,092681,Semenuks; Arturs,5,1,100,95
1657633040638,COGS 14B,A01,083073,Cheng; Tzu-Han,6,0,63,57
1657633046660,COGS 17,A01,092677,Semenuks; Arturs,6,0,81,75
1657633052690,COGS 100,A01,083619,Allen; Michael Gordon,17,0,70,53
1657633058715,COGS 101A,A01,083621,Davis; Joshua Daniel,9,0,68,59
1657633064746,COGS 101B,A01,091572,Allen; Michael Gordon,12,0,65,53
1657633070777,COGS 101C,A01,083625,Delgado; Tania,17,0,35,18
1657633076804,COGS 107A,A01,083627,Boyle; Mary E. T.,13,0,60,47
1657633082832,COGS 118A,A01,083075,Gupta; Anjum,21,0,76,55
1657633088880,CSE 3,A50,083646,Miranda; Gregory Joseph,24,0,50,26
1657633094905,CSE 8A,A50,083650,Miranda; Gregory Joseph,17,1,56,39
1657633100931,CSE 11,A01,083080,Cao; Yingjun,6,15,40,34
1657633106958,CSE 12,A01,083652,Krause-Levy; Sophia Louisa,28,1,120,92
1657633112989,CSE 15L,A01,083654,Morris; Justin Loren,9,0,50,41
1657633112989,CSE 15L,A02,083655,Morris; Justin Loren,9,0,50,41
1657633119020,CSE 20,A01,083657,Tran; Khoa Dang,39,0,80,41
1657633125049,CSE 21,A01,095574,Bach; Quang Tran,22,0,48,26
1657633131086,CSE 30,A01,083084,Eldon; John,6,0,80,74
1657633131086,CSE 30,B01,095061,Bhaskar; Nishant,9,0,50,41
1657633137113,CSE 100,A01,083659,Cao; Yingjun,5,4,70,65
1657633143138,CSE 134B,A01,083661,Powell; Thomas Allan,22,0,100,78
1657633149172,CSE 140,A01,083663,Gungor; Onat,15,0,85,70
1657633155197,CSE 140L,A01,083088,Eldon; John,21,0,100,79
1657633161225,CSE 175,A01,083665,Kumar; Rakesh,3,0,25,22
1657633167251,CSE 190,A00,092507,Dubnov; Shlomo,8,0,20,12
1657633173280,ECE 45,A01,083139,Congero; Spencer William,6,0,75,69
1657633179306,ECE 65,A50,083695,Saad; Andrew S,12,0,30,18
1657633179306,ECE 65,A51,095125,Saad; Andrew S,24,0,26,2
1657633185337,ECE 109,A01,091882,Touri; Behrouz,19,0,70,51
1657633191361,ECE 180,A00,083140,Abi Samra; Nicholas Camill,1,0,30,29
1657633191361,ECE 180,B00,083141,Abi Samra; Nicholas Camill,0,0,30,30
1657633197397,MATH 10A,A01,083735,Patchell; Gregory David,2,0,30,28
1657633197397,MATH 10A,A02,083736,Patchell; Gregory David,20,0,30,10
1657633197397,MATH 10A,A03,083737,Patchell; Gregory David,16,0,30,14
1657633203426,MATH 10B,A01,083207,Lim; Seonhee,8,0,34,26
1657633203426,MATH 10B,A02,083208,Lim; Seonhee,9,0,35,26
1657633203426,MATH 10B,A03,093472,Lim; Seonhee,7,0,34,27
1657633203426,MATH 10B,B01,083739,Sinha; Shubham,12,0,30,18
1657633209464,MATH 18,A01,083743,Cinel; Cameron Alexander,7,0,30,23
1657633209464,MATH 18,A02,083744,Cinel; Cameron Alexander,17,0,30,13
1657633209464,MATH 18,A03,083745,Cinel; Cameron Alexander,9,0,30,21
1657633209464,MATH 18,B01,083748,Rideout; David Porter,5,0,37,32
1657633209464,MATH 18,B02,083749,Rideout; David Porter,5,0,36,31
1657633209464,MATH 18,B03,083750,Rideout; David Porter,3,0,37,34
1657633209464,MATH 18,B04,083751,Rideout; David Porter,6,0,36,30
1657633209464,MATH 18,B05,093473,Rideout; David Porter,6,0,36,30
1657633209464,MATH 18,B06,093474,Rideout; David Porter,6,0,36,30
1657633215490,MATH 20A,A01,083754,Zheng; Zequn,14,0,40,26
1657633221522,MATH 20B,A01,083756,Briones; Jor-el Thomas Caparas,4,0,36,32
1657633221522,MATH 20B,A02,083757,Briones; Jor-el Thomas Caparas,1,0,36,35
1657633221522,MATH 20B,A03,093475,Briones; Jor-el Thomas Caparas,2,0,36,34
1657633227561,MATH 20C,A01,083760,Briones; Jor-el Thomas Caparas,1,0,35,34
1657633227561,MATH 20C,A02,083761,Briones; Jor-el Thomas Caparas,8,0,35,27
1657633227561,MATH 20C,A03,093476,Briones; Jor-el Thomas Caparas,0,1,36,36
1657633227561,MATH 20C,B01,083762,Bach; Quang Tran,1,0,30,29
1657633233592,MATH 20D,A01,083765,Tran; Brian Kha,5,0,30,25
1657633233592,MATH 20D,A02,083766,Tran; Brian Kha,5,0,30,25
1657633233592,MATH 20D,A03,083767,Tran; Brian Kha,5,0,30,25
1657633239625,MATH 20E,A01,083771,Ganguly; Soumya,9,0,32,23
1657633239625,MATH 20E,A02,083772,Ganguly; Soumya,6,0,32,26
1657633239625,MATH 20E,B01,083773,Ciotti; Benjamin,20,0,35,15
1657633239625,MATH 20E,B02,083774,Ciotti; Benjamin,18,0,35,17
1657633245652,MATH 103A,A01,083777,Greenfeld; Be'Eri,3,0,36,33
1657633245652,MATH 103A,A02,083778,Greenfeld; Be'Eri,5,0,36,31
1657633245652,MATH 103A,A03,093561,Greenfeld; Be'Eri,6,0,36,30
1657633245652,MATH 103A,B01,083779,Greenfeld; Be'Eri,7,0,36,29
1657633245652,MATH 103A,B02,083780,Greenfeld; Be'Eri,4,0,36,32
1657633245652,MATH 103A,B03,093562,Greenfeld; Be'Eri,3,0,36,33
1657633251684,MATH 105,A01,085443,Carter; Anne Toulson,15,0,35,20
1657633251684,MATH 105,A02,093477,Carter; Anne Toulson,20,0,35,15
1657633257714,MATH 109,A01,083213,Ganzberger; Geoffrey Michael,2,0,34,32
1657633257714,MATH 109,A02,083214,Ganzberger; Geoffrey Michael,4,0,34,30
1657633257714,MATH 109,A03,093478,Ganzberger; Geoffrey Michael,2,0,34,32
1657633257714,MATH 109,B01,083215,Ganzberger; Geoffrey Michael,1,0,32,31
1657633257714,MATH 109,B02,083216,Ganzberger; Geoffrey Michael,2,0,32,30
1657633257714,MATH 109,B03,093479,Ganzberger; Geoffrey Michael,8,0,32,24
1657633263754,MATH 142A,A01,083219,Chow; Bennett,7,0,32,25
1657633263754,MATH 142A,A02,083220,Chow; Bennett,10,0,32,22
1657633263754,MATH 142A,A03,093480,Chow; Bennett,9,0,32,23
1657633263754,MATH 142A,B03,093481,Chow; Bennett,8,0,32,24
1657633263754,MATH 142A,B04,093558,Chow; Bennett,13,0,32,19
1657633263754,MATH 142A,B05,093559,Chow; Bennett,6,0,32,26
1657633269788,MATH 193A,A01,083224,Rotar; Vladimir,8,0,34,26
1657633269788,MATH 193A,A02,083225,Rotar; Vladimir,9,0,34,25
1657633269788,MATH 193A,A03,083781,Rotar; Vladimir,5,0,34,29
1657633269788,MATH 193A,A04,083782,Rotar; Vladimir,10,0,34,24
1657633269788,MATH 193A,A05,093482,Rotar; Vladimir,10,0,34,24
1657633275813,MATH 197,001,091859,McAuley; Julian John,9999,0,9999,0
1657633275813,MATH 197,002,095566,Kedlaya; Kiran S.,9997,0,9999,2
1657633275813,MATH 197,003,095567,Xiao; Ming,9999,0,9999,0
1657633275813,MATH 197,004,095571,Perols; Johan Lars,9998,0,9999,1
1657633282876,COGS 9,A01,083615,Shannon; Kyle Michael,9,0,75,66
1657633288905,COGS 11,A01,083617,Boyle; Mary E. T.,23,0,48,25
1657633294933,COGS 13,A01,083071,Bastos; Amalia Pinkusfeld,11,0,71,60
1657633300961,COGS 14A,A01,092681,Semenuks; Arturs,5,1,100,95
1657633306994,COGS 14B,A01,083073,Cheng; Tzu-Han,6,0,63,57
1657633313018,COGS 17,A01,092677,Semenuks; Arturs,6,0,81,75
1657633319045,COGS 100,A01,083619,Allen; Michael Gordon,17,0,70,53
1657633325074,COGS 101A,A01,083621,Davis; Joshua Daniel,9,0,68,59
1657633331102,COGS 101B,A01,091572,Allen; Michael Gordon,12,0,65,53
1657633337133,COGS 101C,A01,083625,Delgado; Tania,17,0,35,18
1657633343159,COGS 107A,A01,083627,Boyle; Mary E. T.,13,0,60,47
1657633349183,COGS 118A,A01,083075,Gupta; Anjum,21,0,76,55
1657633355208,CSE 3,A50,083646,Miranda; Gregory Joseph,24,0,50,26
1657633361237,CSE 8A,A50,083650,Miranda; Gregory Joseph,17,1,56,39
1657633367268,CSE 11,A01,083080,Cao; Yingjun,6,15,40,34
1657633373394,CSE 12,A01,083652,Krause-Levy; Sophia Louisa,28,1,120,92
1657633379426,CSE 15L,A01,083654,Morris; Justin Loren,9,0,50,41
1657633379426,CSE 15L,A02,083655,Morris; Justin Loren,9,0,50,41
1657633385452,CSE 20,A01,083657,Tran; Khoa Dang,39,0,80,41
1657633391476,CSE 21,A01,095574,Bach; Quang Tran,22,0,48,26
1657633397507,CSE 30,A01,083084,Eldon; John,6,0,80,74
1657633397507,CSE 30,B01,095061,Bhaskar; Nishant,9,0,50,41
1657633403532,CSE 100,A01,083659,Cao; Yingjun,5,4,70,65
1657633409557,CSE 134B,A01,083661,Powell; Thomas Allan,22,0,100,78
1657633415586,CSE 140,A01,083663,Gungor; Onat,15,0,85,70
1657633421619,CSE 140L,A01,083088,Eldon; John,21,0,100,79
1657633427646,CSE 175,A01,083665,Kumar; Rakesh,3,0,25,22
1657633433679,CSE 190,A00,092507,Dubnov; Shlomo,8,0,20,12
1657633439706,ECE 45,A01,083139,Congero; Spencer William,6,0,75,69
1657633445743,ECE 65,A50,083695,Saad; Andrew S,12,0,30,18
1657633445743,ECE 65,A51,095125,Saad; Andrew S,24,0,26,2
1657633451771,ECE 109,A01,091882,Touri; Behrouz,19,0,70,51
1657633457799,ECE 180,A00,083140,Abi Samra; Nicholas Camill,1,0,30,29
1657633457799,ECE 180,B00,083141,Abi Samra; Nicholas Camill,0,0,30,30
1657633463827,MATH 10A,A01,083735,Patchell; Gregory David,2,0,30,28
1657633463827,MATH 10A,A02,083736,Patchell; Gregory David,20,0,30,10
1657633463827,MATH 10A,A03,083737,Patchell; Gregory David,16,0,30,14
1657633469865,MATH 10B,A01,083207,Lim; Seonhee,8,0,34,26
1657633469865,MATH 10B,A02,083208,Lim; Seonhee,9,0,35,26
1657633469865,MATH 10B,A03,093472,Lim; Seonhee,7,0,34,27
1657633469865,MATH 10B,B01,083739,Sinha; Shubham,12,0,30,18
1657633475896,MATH 18,A01,083743,Cinel; Cameron Alexander,7,0,30,23
1657633475896,MATH 18,A02,083744,Cinel; Cameron Alexander,17,0,30,13
1657633475896,MATH 18,A03,083745,Cinel; Cameron Alexander,9,0,30,21
1657633475896,MATH 18,B01,083748,Rideout; David Porter,5,0,37,32
1657633475896,MATH 18,B02,083749,Rideout; David Porter,5,0,36,31
1657633475896,MATH 18,B03,083750,Rideout; David Porter,3,0,37,34
1657633475896,MATH 18,B04,083751,Rideout; David Porter,6,0,36,30
1657633475896,MATH 18,B05,093473,Rideout; David Porter,6,0,36,30
1657633475896,MATH 18,B06,093474,Rideout; David Porter,6,0,36,30
1657633481926,MATH 20A,A01,083754,Zheng; Zequn,14,0,40,26
1657633487958,MATH 20B,A01,083756,Briones; Jor-el Thomas Caparas,4,0,36,32
1657633487958,MATH 20B,A02,083757,Briones; Jor-el Thomas Caparas,1,0,36,35
1657633487958,MATH 20B,A03,093475,Briones; Jor-el Thomas Caparas,2,0,36,34
1657633493986,MATH 20C,A01,083760,Briones; Jor-el Thomas Caparas,1,0,35,34
1657633493986,MATH 20C,A02,083761,Briones; Jor-el Thomas Caparas,8,0,35,27
1657633493986,MATH 20C,A03,093476,Briones; Jor-el Thomas Caparas,0,1,36,36
1657633493986,MATH 20C,B01,083762,Bach; Quang Tran,1,0,30,29
1657633500017,MATH 20D,A01,083765,Tran; Brian Kha,5,0,30,25
1657633500017,MATH 20D,A02,083766,Tran; Brian Kha,5,0,30,25
1657633500017,MATH 20D,A03,083767,Tran; Brian Kha,5,0,30,25
1657633506051,MATH 20E,A01,083771,Ganguly; Soumya,9,0,32,23
1657633506051,MATH 20E,A02,083772,Ganguly; Soumya,6,0,32,26
1657633506051,MATH 20E,B01,083773,Ciotti; Benjamin,20,0,35,15
1657633506051,MATH 20E,B02,083774,Ciotti; Benjamin,18,0,35,17
1657633512093,MATH 103A,A01,083777,Greenfeld; Be'Eri,3,0,36,33
1657633512093,MATH 103A,A02,083778,Greenfeld; Be'Eri,5,0,36,31
1657633512093,MATH 103A,A03,093561,Greenfeld; Be'Eri,6,0,36,30
1657633512093,MATH 103A,B01,083779,Greenfeld; Be'Eri,7,0,36,29
1657633512093,MATH 103A,B02,083780,Greenfeld; Be'Eri,4,0,36,32
1657633512093,MATH 103A,B03,093562,Greenfeld; Be'Eri,3,0,36,33
1657633518125,MATH 105,A01,085443,Carter; Anne Toulson,15,0,35,20
1657633518125,MATH 105,A02,093477,Carter; Anne Toulson,20,0,35,15
1657633524159,MATH 109,A01,083213,Ganzberger; Geoffrey Michael,2,0,34,32
1657633524159,MATH 109,A02,083214,Ganzberger; Geoffrey Michael,4,0,34,30
1657633524159,MATH 109,A03,093478,Ganzberger; Geoffrey Michael,2,0,34,32
1657633524159,MATH 109,B01,083215,Ganzberger; Geoffrey Michael,1,0,32,31
1657633524159,MATH 109,B02,083216,Ganzberger; Geoffrey Michael,2,0,32,30
1657633524159,MATH 109,B03,093479,Ganzberger; Geoffrey Michael,8,0,32,24
1657633530187,MATH 142A,A01,083219,Chow; Bennett,7,0,32,25
1657633530187,MATH 142A,A02,083220,Chow; Bennett,10,0,32,22
1657633530187,MATH 142A,A03,093480,Chow; Bennett,9,0,32,23
1657633530187,MATH 142A,B03,093481,Chow; Bennett,8,0,32,24
1657633530187,MATH 142A,B04,093558,Chow; Bennett,13,0,32,19
1657633530187,MATH 142A,B05,093559,Chow; Bennett,6,0,32,26
1657633536213,MATH 193A,A01,083224,Rotar; Vladimir,8,0,34,26
1657633536213,MATH 193A,A02,083225,Rotar; Vladimir,9,0,34,25
1657633536213,MATH 193A,A03,083781,Rotar; Vladimir,5,0,34,29
1657633536213,MATH 193A,A04,083782,Rotar; Vladimir,10,0,34,24
1657633536213,MATH 193A,A05,093482,Rotar; Vladimir,10,0,34,24
1657633542239,MATH 197,001,091859,McAuley; Julian John,9999,0,9999,0
1657633542239,MATH 197,002,095566,Kedlaya; Kiran S.,9997,0,9999,2
1657633542239,MATH 197,003,095567,Xiao; Ming,9999,0,9999,0
1657633542239,MATH 197,004,095571,Perols; Johan Lars,9998,0,9999,1
1657633549322,COGS 9,A01,083615,Shannon; Kyle Michael,9,0,75,66
1657633555350,COGS 11,A01,083617,Boyle; Mary E. T.,23,0,48,25
1657633561386,COGS 13,A01,083071,Bastos; Amalia Pinkusfeld,11,0,71,60
1657633567414,COGS 14A,A01,092681,Semenuks; Arturs,5,1,100,95
1657633573444,COGS 14B,A01,083073,Cheng; Tzu-Han,6,0,63,57
1657633579473,COGS 17,A01,092677,Semenuks; Arturs,6,0,81,75
1657633585504,COGS 100,A01,083619,Allen; Michael Gordon,17,0,70,53
1657633591535,COGS 101A,A01,083621,Davis; Joshua Daniel,9,0,68,59
1657633597564,COGS 101B,A01,091572,Allen; Michael Gordon,12,0,65,53
1657633603590,COGS 101C,A01,083625,Delgado; Tania,17,0,35,18
1657633609618,COGS 107A,A01,083627,Boyle; Mary E. T.,13,0,60,47
1657633615649,COGS 118A,A01,083075,Gupta; Anjum,21,0,76,55
1657633621681,CSE 3,A50,083646,Miranda; Gregory Joseph,24,0,50,26
1657633627710,CSE 8A,A50,083650,Miranda; Gregory Joseph,17,1,56,39
1657633633734,CSE 11,A01,083080,Cao; Yingjun,6,15,40,34
1657633639764,CSE 12,A01,083652,Krause-Levy; Sophia Louisa,28,1,120,92
1657633645794,CSE 15L,A01,083654,Morris; Justin Loren,9,0,50,41
1657633645794,CSE 15L,A02,083655,Morris; Justin Loren,9,0,50,41
1657633651818,CSE 20,A01,083657,Tran; Khoa Dang,39,0,80,41
1657633657841,CSE 21,A01,095574,Bach; Quang Tran,22,0,48,26
1657633663881,CSE 30,A01,083084,Eldon; John,6,0,80,74
1657633663881,CSE 30,B01,095061,Bhaskar; Nishant,9,0,50,41
1657633669913,CSE 100,A01,083659,Cao; Yingjun,5,4,70,65
1657633675939,CSE 134B,A01,083661,Powell; Thomas Allan,22,0,100,78
1657633681965,CSE 140,A01,083663,Gungor; Onat,15,0,85,70
1657633687988,CSE 140L,A01,083088,Eldon; John,21,0,100,79
1657633694016,CSE 175,A01,083665,Kumar; Rakesh,3,0,25,22
1657633700043,CSE 190,A00,092507,Dubnov; Shlomo,8,0,20,12
1657633706086,ECE 45,A01,083139,Congero; Spencer William,6,0,75,69
1657633712122,ECE 65,A50,083695,Saad; Andrew S,12,0,30,18
1657633712122,ECE 65,A51,095125,Saad; Andrew S,24,0,26,2
1657633718155,ECE 109,A01,091882,Touri; Behrouz,19,0,70,51
1657633724200,ECE 180,A00,083140,Abi Samra; Nicholas Camill,1,0,30,29
1657633724200,ECE 180,B00,083141,Abi Samra; Nicholas Camill,0,0,30,30
1657633730236,MATH 10A,A01,083735,Patchell; Gregory David,2,0,30,28
1657633730236,MATH 10A,A02,083736,Patchell; Gregory David,20,0,30,10
1657633730236,MATH 10A,A03,083737,Patchell; Gregory David,16,0,30,14
1657633736283,MATH 10B,A01,083207,Lim; Seonhee,8,0,34,26
1657633736283,MATH 10B,A02,083208,Lim; Seonhee,9,0,35,26
1657633736283,MATH 10B,A03,093472,Lim; Seonhee,7,0,34,27
1657633736283,MATH 10B,B01,083739,Sinha; Shubham,12,0,30,18
1657633742315,MATH 18,A01,083743,Cinel; Cameron Alexander,7,0,30,23
1657633742315,MATH 18,A02,083744,Cinel; Cameron Alexander,17,0,30,13
1657633742315,MATH 18,A03,083745,Cinel; Cameron Alexander,9,0,30,21
1657633742315,MATH 18,B01,083748,Rideout; David Porter,5,0,37,32
1657633742315,MATH 18,B02,083749,Rideout; David Porter,5,0,36,31
1657633742315,MATH 18,B03,083750,Rideout; David Porter,3,0,37,34
1657633742315,MATH 18,B04,083751,Rideout; David Porter,6,0,36,30
1657633742315,MATH 18,B05,093473,Rideout; David Porter,6,0,36,30
1657633742315,MATH 18,B06,093474,Rideout; David Porter,6,0,36,30
1657633748346,MATH 20A,A01,083754,Zheng; Zequn,14,0,40,26
1657633754387,MATH 20B,A01,083756,Briones; Jor-el Thomas Caparas,4,0,36,32
1657633754387,MATH 20B,A02,083757,Briones; Jor-el Thomas Caparas,1,0,36,35
1657633754387,MATH 20B,A03,093475,Briones; Jor-el Thomas Caparas,2,0,36,34
1657633760423,MATH 20C,A01,083760,Briones; Jor-el Thomas Caparas,1,0,35,34
1657633760423,MATH 20C,A02,083761,Briones; Jor-el Thomas Caparas,8,0,35,27
1657633760423,MATH 20C,A03,093476,Briones; Jor-el Thomas Caparas,0,1,36,36
1657633760423,MATH 20C,B01,083762,Bach; Quang Tran,1,0,30,29
1657633766456,MATH 20D,A01,083765,Tran; Brian Kha,5,0,30,25
1657633766456,MATH 20D,A02,083766,Tran; Brian Kha,5,0,30,25
1657633766456,MATH 20D,A03,083767,Tran; Brian Kha,5,0,30,25
1657633772494,MATH 20E,A01,083771,Ganguly; Soumya,9,0,32,23
1657633772494,MATH 20E,A02,083772,Ganguly; Soumya,6,0,32,26
1657633772494,MATH 20E,B01,083773,Ciotti; Benjamin,20,0,35,15
1657633772494,MATH 20E,B02,083774,Ciotti; Benjamin,18,0,35,17
1657633778528,MATH 103A,A01,083777,Greenfeld; Be'Eri,3,0,36,33
1657633778528,MATH 103A,A02,083778,Greenfeld; Be'Eri,5,0,36,31
1657633778528,MATH 103A,A03,093561,Greenfeld; Be'Eri,6,0,36,30
1657633778528,MATH 103A,B01,083779,Greenfeld; Be'Eri,7,0,36,29
1657633778528,MATH 103A,B02,083780,Greenfeld; Be'Eri,4,0,36,32
1657633778528,MATH 103A,B03,093562,Greenfeld; Be'Eri,3,0,36,33
1657633784561,MATH 105,A01,085443,Carter; Anne Toulson,15,0,35,20
1657633784561,MATH 105,A02,093477,Carter; Anne Toulson,20,0,35,15
1657633790587,MATH 109,A01,083213,Ganzberger; Geoffrey Michael,2,0,34,32
1657633790587,MATH 109,A02,083214,Ganzberger; Geoffrey Michael,4,0,34,30
1657633790587,MATH 109,A03,093478,Ganzberger; Geoffrey Michael,2,0,34,32
1657633790587,MATH 109,B01,083215,Ganzberger; Geoffrey Michael,1,0,32,31
1657633790587,MATH 109,B02,083216,Ganzberger; Geoffrey Michael,2,0,32,30
1657633790587,MATH 109,B03,093479,Ganzberger; Geoffrey Michael,8,0,32,24
1657633796616,MATH 142A,A01,083219,Chow; Bennett,7,0,32,25
1657633796616,MATH 142A,A02,083220,Chow; Bennett,10,0,32,22
1657633796616,MATH 142A,A03,093480,Chow; Bennett,9,0,32,23
1657633796616,MATH 142A,B03,093481,Chow; Bennett,8,0,32,24
1657633796616,MATH 142A,B04,093558,Chow; Bennett,13,0,32,19
1657633796616,MATH 142A,B05,093559,Chow; Bennett,6,0,32,26
1657633802644,MATH 193A,A01,083224,Rotar; Vladimir,8,0,34,26
1657633802644,MATH 193A,A02,083225,Rotar; Vladimir,9,0,34,25
1657633802644,MATH 193A,A03,083781,Rotar; Vladimir,5,0,34,29
1657633802644,MATH 193A,A04,083782,Rotar; Vladimir,10,0,34,24
1657633802644,MATH 193A,A05,093482,Rotar; Vladimir,10,0,34,24
1657633808673,MATH 197,001,091859,McAuley; Julian John,9999,0,9999,0
1657633808673,MATH 197,002,095566,Kedlaya; Kiran S.,9997,0,9999,2
1657633808673,MATH 197,003,095567,Xiao; Ming,9999,0,9999,0
1657633808673,MATH 197,004,095571,Perols; Johan Lars,9998,0,9999,1
1657633815780,COGS 9,A01,083615,Shannon; Kyle Michael,9,0,75,66
1657633821805,COGS 11,A01,083617,Boyle; Mary E. T.,23,0,48,25
1657633827836,COGS 13,A01,083071,Bastos; Amalia Pinkusfeld,11,0,71,60
1657633833861,COGS 14A,A01,092681,Semenuks; Arturs,5,1,100,95
1657633839887,COGS 14B,A01,083073,Cheng; Tzu-Han,6,0,63,57
1657633845909,COGS 17,A01,092677,Semenuks; Arturs,6,0,81,75
1657633851936,COGS 100,A01,083619,Allen; Michael Gordon,17,0,70,53
1657633857969,COGS 101A,A01,083621,Davis; Joshua Daniel,9,0,68,59
1657633863995,COGS 101B,A01,091572,Allen; Michael Gordon,12,0,65,53
1657633870021,COGS 101C,A01,083625,Delgado; Tania,17,0,35,18
1657633876054,COGS 107A,A01,083627,Boyle; Mary E. T.,13,0,60,47
1657633882083,COGS 118A,A01,083075,Gupta; Anjum,21,0,76,55
1657633888115,CSE 3,A50,083646,Miranda; Gregory Joseph,24,0,50,26
1657633894144,CSE 8A,A50,083650,Miranda; Gregory Joseph,17,1,56,39
1657633900170,CSE 11,A01,083080,Cao; Yingjun,6,15,40,34
1657633906196,CSE 12,A01,083652,Krause-Levy; Sophia Louisa,28,1,120,92
1657633912228,CSE 15L,A01,083654,Morris; Justin Loren,9,0,50,41
1657633912228,CSE 15L,A02,083655,Morris; Justin Loren,9,0,50,41
1657633918254,CSE 20,A01,083657,Tran; Khoa Dang,39,0,80,41
1657633924281,CSE 21,A01,095574,Bach; Quang Tran,22,0,48,26
1657633930313,CSE 30,A01,083084,Eldon; John,6,0,80,74
1657633930313,CSE 30,B01,095061,Bhaskar; Nishant,9,0,50,41
1657633936343,CSE 100,A01,083659,Cao; Yingjun,5,4,70,65
1657633942372,CSE 134B,A01,083661,Powell; Thomas Allan,22,0,100,78
1657633948398,CSE 140,A01,083663,Gungor; Onat,15,0,85,70
1657633954423,CSE 140L,A01,083088,Eldon; John,21,0,100,79
1657633960449,CSE 175,A01,083665,Kumar; Rakesh,3,0,25,22
1657633966477,CSE 190,A00,092507,Dubnov; Shlomo,8,0,20,12
1657633972587,ECE 45,A01,083139,Congero; Spencer William,6,0,75,69
1657633978615,ECE 65,A50,083695,Saad; Andrew S,12,0,30,18
1657633978615,ECE 65,A51,095125,Saad; Andrew S,24,0,26,2
1657633984642,ECE 109,A01,091882,Touri; Behrouz,19,0,70,51
1657633990672,ECE 180,A00,083140,Abi Samra; Nicholas Camill,1,0,30,29
1657633990672,ECE 180,B00,083141,Abi Samra; Nicholas Camill,0,0,30,30
1657633996696,MATH 10A,A01,083735,Patchell; Gregory David,2,0,30,28
1657633996696,MATH 10A,A02,083736,Patchell; Gregory David,20,0,30,10
1657633996696,MATH 10A,A03,083737,Patchell; Gregory David,16,0,30,14
1657634002729,MATH 10B,A01,083207,Lim; Seonhee,8,0,34,26
1657634002729,MATH 10B,A02,083208,Lim; Seonhee,9,0,35,26
1657634002729,MATH 10B,A03,093472,Lim; Seonhee,7,0,34,27
1657634002729,MATH 10B,B01,083739,Sinha; Shubham,12,0,30,18
1657634008756,MATH 18,A01,083743,Cinel; Cameron Alexander,7,0,30,23
1657634008756,MATH 18,A02,083744,Cinel; Cameron Alexander,17,0,30,13
1657634008756,MATH 18,A03,083745,Cinel; Cameron Alexander,9,0,30,21
1657634008756,MATH 18,B01,083748,Rideout; David Porter,5,0,37,32
1657634008756,MATH 18,B02,083749,Rideout; David Porter,5,0,36,31
1657634008756,MATH 18,B03,083750,Rideout; David Porter,3,0,37,34
1657634008756,MATH 18,B04,083751,Rideout; David Porter,6,0,36,30
1657634008756,MATH 18,B05,093473,Rideout; David Porter,6,0,36,30
1657634008756,MATH 18,B06,093474,Rideout; David Porter,6,0,36,30
1657634014784,MATH 20A,A01,083754,Zheng; Zequn,14,0,40,26
1657634020813,MATH 20B,A01,083756,Briones; Jor-el Thomas Caparas,4,0,36,32
1657634020813,MATH 20B,A02,083757,Briones; Jor-el Thomas Caparas,1,0,36,35
1657634020813,MATH 20B,A03,093475,Briones; Jor-el Thomas Caparas,2,0,36,34
1657634026837,MATH 20C,A01,083760,Briones; Jor-el Thomas Caparas,1,0,35,34
1657634026837,MATH 20C,A02,083761,Briones; Jor-el Thomas Caparas,8,0,35,27
1657634026837,MATH 20C,A03,093476,Briones; Jor-el Thomas Caparas,0,1,36,36
1657634026837,MATH 20C,B01,083762,Bach; Quang Tran,1,0,30,29
1657634032869,MATH 20D,A01,083765,Tran; Brian Kha,5,0,30,25
1657634032869,MATH 20D,A02,083766,Tran; Brian Kha,5,0,30,25
1657634032869,MATH 20D,A03,083767,Tran; Brian Kha,5,0,30,25
1657634038903,MATH 20E,A01,083771,Ganguly; Soumya,9,0,32,23
1657634038903,MATH 20E,A02,083772,Ganguly; Soumya,6,0,32,26
1657634038903,MATH 20E,B01,083773,Ciotti; Benjamin,20,0,35,15
1657634038903,MATH 20E,B02,083774,Ciotti; Benjamin,18,0,35,17
1657634044930,MATH 103A,A01,083777,Greenfeld; Be'Eri,3,0,36,33
1657634044930,MATH 103A,A02,083778,Greenfeld; Be'Eri,5,0,36,31
1657634044930,MATH 103A,A03,093561,Greenfeld; Be'Eri,6,0,36,30
1657634044930,MATH 103A,B01,083779,Greenfeld; Be'Eri,7,0,36,29
1657634044930,MATH 103A,B02,083780,Greenfeld; Be'Eri,4,0,36,32
1657634044930,MATH 103A,B03,093562,Greenfeld; Be'Eri,3,0,36,33
1657634050963,MATH 105,A01,085443,Carter; Anne Toulson,15,0,35,20
1657634050963,MATH 105,A02,093477,Carter; Anne Toulson,20,0,35,15
1657634056989,MATH 109,A01,083213,Ganzberger; Geoffrey Michael,2,0,34,32
1657634056989,MATH 109,A02,083214,Ganzberger; Geoffrey Michael,4,0,34,30
1657634056989,MATH 109,A03,093478,Ganzberger; Geoffrey Michael,2,0,34,32
1657634056989,MATH 109,B01,083215,Ganzberger; Geoffrey Michael,1,0,32,31
1657634056989,MATH 109,B02,083216,Ganzberger; Geoffrey Michael,2,0,32,30
1657634056989,MATH 109,B03,093479,Ganzberger; Geoffrey Michael,8,0,32,24
1657634063022,MATH 142A,A01,083219,Chow; Bennett,7,0,32,25
1657634063022,MATH 142A,A02,083220,Chow; Bennett,10,0,32,22
1657634063022,MATH 142A,A03,093480,Chow; Bennett,9,0,32,23
1657634063022,MATH 142A,B03,093481,Chow; Bennett,8,0,32,24
1657634063022,MATH 142A,B04,093558,Chow; Bennett,13,0,32,19
1657634063022,MATH 142A,B05,093559,Chow; Bennett,6,0,32,26
1657634069048,MATH 193A,A01,083224,Rotar; Vladimir,8,0,34,26
1657634069048,MATH 193A,A02,083225,Rotar; Vladimir,9,0,34,25
1657634069048,MATH 193A,A03,083781,Rotar; Vladimir,5,0,34,29
1657634069048,MATH 193A,A04,083782,Rotar; Vladimir,10,0,34,24
1657634069048,MATH 193A,A05,093482,Rotar; Vladimir,10,0,34,24
1657634075076,MATH 197,001,091859,McAuley; Julian John,9999,0,9999,0
1657634075076,MATH 197,002,095566,Kedlaya; Kiran S.,9997,0,9999,2
1657634075076,MATH 197,003,095567,Xiao; Ming,9999,0,9999,0
1657634075076,MATH 197,004,095571,Perols; Johan Lars,9998,0,9999,1
1657634082154,COGS 9,A01,083615,Shannon; Kyle Michael,9,0,75,66
1657634088178,COGS 11,A01,083617,Boyle; Mary E. T.,23,0,48,25
1657634094205,COGS 13,A01,083071,Bastos; Amalia Pinkusfeld,11,0,71,60
1657634100235,COGS 14A,A01,092681,Semenuks; Arturs,5,1,100,95
1657634106259,COGS 14B,A01,083073,Cheng; Tzu-Han,6,0,63,57
1657634112290,COGS 17,A01,092677,Semenuks; Arturs,6,0,81,75
1657634118319,COGS 100,A01,083619,Allen; Michael Gordon,17,0,70,53
1657634124343,COGS 101A,A01,083621,Davis; Joshua Daniel,9,0,68,59
1657634130366,COGS 101B,A01,091572,Allen; Michael Gordon,12,0,65,53
1657634136396,COGS 101C,A01,083625,Delgado; Tania,17,0,35,18
1657634142420,COGS 107A,A01,083627,Boyle; Mary E. T.,13,0,60,47
1657634148443,COGS 118A,A01,083075,Gupta; Anjum,21,0,76,55
1657634154478,CSE 3,A50,083646,Miranda; Gregory Joseph,24,0,50,26
1657634160502,CSE 8A,A50,083650,Miranda; Gregory Joseph,17,1,56,39
1657634166530,CSE 11,A01,083080,Cao; Yingjun,6,15,40,34
1657634172555,CSE 12,A01,083652,Krause-Levy; Sophia Louisa,28,1,120,92
1657634178580,CSE 15L,A01,083654,Morris; Justin Loren,9,0,50,41
1657634178580,CSE 15L,A02,083655,Morris; Justin Loren,9,0,50,41
1657634184610,CSE 20,A01,083657,Tran; Khoa Dang,39,0,80,41
1657634190637,CSE 21,A01,095574,Bach; Quang Tran,22,0,48,26
1657634196701,CSE 30,A01,083084,Eldon; John,6,0,80,74
1657634196701,CSE 30,B01,095061,Bhaskar; Nishant,9,0,50,41
1657634202737,CSE 100,A01,083659,Cao; Yingjun,5,4,70,65
1657634208761,CSE 134B,A01,083661,Powell; Thomas Allan,22,0,100,78
1657634214786,CSE 140,A01,083663,Gungor; Onat,15,0,85,70
1657634220810,CSE 140L,A01,083088,Eldon; John,21,0,100,79
1657634226835,CSE 175,A01,083665,Kumar; Rakesh,3,0,25,22
1657634232862,CSE 190,A00,092507,Dubnov; Shlomo,8,0,20,12
1657634238886,ECE 45,A01,083139,Congero; Spencer William,6,0,75,69
1657634244918,ECE 65,A50,083695,Saad; Andrew S,12,0,30,18
1657634244918,ECE 65,A51,095125,Saad; Andrew S,24,0,26,2
1657634250943,ECE 109,A01,091882,Touri; Behrouz,19,0,70,51
1657634256974,ECE 180,A00,083140,Abi Samra; Nicholas Camill,1,0,30,29
1657634256974,ECE 180,B00,083141,Abi Samra; Nicholas Camill,0,0,30,30
1657634263001,MATH 10A,A01,083735,Patchell; Gregory David,2,0,30,28
1657634263001,MATH 10A,A02,083736,Patchell; Gregory David,20,0,30,10
1657634263001,MATH 10A,A03,083737,Patchell; Gregory David,16,0,30,14
1657634269037,MATH 10B,A01,083207,Lim; Seonhee,8,0,34,26
1657634269037,MATH 10B,A02,083208,Lim; Seonhee,9,0,35,26
1657634269037,MATH 10B,A03,093472,Lim; Seonhee,7,0,34,27
1657634269037,MATH 10B,B01,083739,Sinha; Shubham,12,0,30,18
1657634275065,MATH 18,A01,083743,Cinel; Cameron Alexander,7,0,30,23
1657634275065,MATH 18,A02,083744,Cinel; Cameron Alexander,17,0,30,13
1657634275065,MATH 18,A03,083745,Cinel; Cameron Alexander,9,0,30,21
1657634275065,MATH 18,B01,083748,Rideout; David Porter,5,0,37,32
1657634275065,MATH 18,B02,083749,Rideout; David Porter,5,0,36,31
1657634275065,MATH 18,B03,083750,Rideout; David Porter,3,0,37,34
1657634275065,MATH 18,B04,083751,Rideout; David Porter,6,0,36,30
1657634275065,MATH 18,B05,093473,Rideout; David Porter,6,0,36,30
1657634275065,MATH 18,B06,093474,Rideout; David Porter,6,0,36,30
1657634281089,MATH 20A,A01,083754,Zheng; Zequn,14,0,40,26
1657634287115,MATH 20B,A01,083756,Briones; Jor-el Thomas Caparas,4,0,36,32
1657634287115,MATH 20B,A02,083757,Briones; Jor-el Thomas Caparas,1,0,36,35
1657634287115,MATH 20B,A03,093475,Briones; Jor-el Thomas Caparas,2,0,36,34
1657634293148,MATH 20C,A01,083760,Briones; Jor-el Thomas Caparas,1,0,35,34
1657634293148,MATH 20C,A02,083761,Briones; Jor-el Thomas Caparas,8,0,35,27
1657634293148,MATH 20C,A03,093476,Briones; Jor-el Thomas Caparas,0,1,36,36
1657634293148,MATH 20C,B01,083762,Bach; Quang Tran,1,0,30,29
1657634299174,MATH 20D,A01,083765,Tran; Brian Kha,5,0,30,25
1657634299174,MATH 20D,A02,083766,Tran; Brian Kha,5,0,30,25
1657634299174,MATH 20D,A03,083767,Tran; Brian Kha,5,0,30,25
1657634305200,MATH 20E,A01,083771,Ganguly; Soumya,9,0,32,23
1657634305200,MATH 20E,A02,083772,Ganguly; Soumya,6,0,32,26
1657634305200,MATH 20E,B01,083773,Ciotti; Benjamin,20,0,35,15
1657634305200,MATH 20E,B02,083774,Ciotti; Benjamin,18,0,35,17
1657634311226,MATH 103A,A01,083777,Greenfeld; Be'Eri,3,0,36,33
1657634311226,MATH 103A,A02,083778,Greenfeld; Be'Eri,5,0,36,31
1657634311226,MATH 103A,A03,093561,Greenfeld; Be'Eri,6,0,36,30
1657634311226,MATH 103A,B01,083779,Greenfeld; Be'Eri,7,0,36,29
1657634311226,MATH 103A,B02,083780,Greenfeld; Be'Eri,4,0,36,32
1657634311226,MATH 103A,B03,093562,Greenfeld; Be'Eri,3,0,36,33
1657634317252,MATH 105,A01,085443,Carter; Anne Toulson,15,0,35,20
1657634317252,MATH 105,A02,093477,Carter; Anne Toulson,20,0,35,15
1657634323277,MATH 109,A01,083213,Ganzberger; Geoffrey Michael,2,0,34,32
1657634323277,MATH 109,A02,083214,Ganzberger; Geoffrey Michael,4,0,34,30
1657634323277,MATH 109,A03,093478,Ganzberger; Geoffrey Michael,2,0,34,32
1657634323277,MATH 109,B01,083215,Ganzberger; Geoffrey Michael,1,0,32,31
1657634323277,MATH 109,B02,083216,Ganzberger; Geoffrey Michael,2,0,32,30
1657634323277,MATH 109,B03,093479,Ganzberger; Geoffrey Michael,8,0,32,24
1657634329303,MATH 142A,A01,083219,Chow; Bennett,7,0,32,25
1657634329303,MATH 142A,A02,083220,Chow; Bennett,10,0,32,22
1657634329303,MATH 142A,A03,093480,Chow; Bennett,9,0,32,23
1657634329303,MATH 142A,B03,093481,Chow; Bennett,8,0,32,24
1657634329303,MATH 142A,B04,093558,Chow; Bennett,13,0,32,19
1657634329303,MATH 142A,B05,093559,Chow; Bennett,6,0,32,26
1657634335329,MATH 193A,A01,083224,Rotar; Vladimir,8,0,34,26
1657634335329,MATH 193A,A02,083225,Rotar; Vladimir,9,0,34,25
1657634335329,MATH 193A,A03,083781,Rotar; Vladimir,5,0,34,29
1657634335329,MATH 193A,A04,083782,Rotar; Vladimir,10,0,34,24
1657634335329,MATH 193A,A05,093482,Rotar; Vladimir,10,0,34,24
1657634341362,MATH 197,001,091859,McAuley; Julian John,9999,0,9999,0
1657634341362,MATH 197,002,095566,Kedlaya; Kiran S.,9997,0,9999,2
1657634341362,MATH 197,003,095567,Xiao; Ming,9999,0,9999,0
1657634341362,MATH 197,004,095571,Perols; Johan Lars,9998,0,9999,1
1657634348430,COGS 9,A01,083615,Shannon; Kyle Michael,9,0,75,66
1657634354459,COGS 11,A01,083617,Boyle; Mary E. T.,23,0,48,25
1657634360485,COGS 13,A01,083071,Bastos; Amalia Pinkusfeld,11,0,71,60
1657634366512,COGS 14A,A01,092681,Semenuks; Arturs,5,1,100,95
1657634372536,COGS 14B,A01,083073,Cheng; Tzu-Han,6,0,63,57
1657634378561,COGS 17,A01,092677,Semenuks; Arturs,6,0,81,75
1657634384585,COGS 100,A01,083619,Allen; Michael Gordon,17,0,70,53
1657634390615,COGS 101A,A01,083621,Davis; Joshua Daniel,9,0,68,59
1657634396638,COGS 101B,A01,091572,Allen; Michael Gordon,12,0,65,53
1657634402666,COGS 101C,A01,083625,Delgado; Tania,17,0,35,18
1657634408701,COGS 107A,A01,083627,Boyle; Mary E. T.,13,0,60,47
1657634414730,COGS 118A,A01,083075,Gupta; Anjum,21,0,76,55
1657634420763,CSE 3,A50,083646,Miranda; Gregory Joseph,24,0,50,26
1657634426787,CSE 8A,A50,083650,Miranda; Gregory Joseph,17,1,56,39
1657634432814,CSE 11,A01,083080,Cao; Yingjun,6,15,40,34
1657634438837,CSE 12,A01,083652,Krause-Levy; Sophia Louisa,28,1,120,92
1657634444862,CSE 15L,A01,083654,Morris; Justin Loren,9,0,50,41
1657634444862,CSE 15L,A02,083655,Morris; Justin Loren,9,0,50,41
1657634450889,CSE 20,A01,083657,Tran; Khoa Dang,39,0,80,41
1657634456922,CSE 21,A01,095574,Bach; Quang Tran,22,0,48,26
1657634462951,CSE 30,A01,083084,Eldon; John,6,0,80,74
1657634462951,CSE 30,B01,095061,Bhaskar; Nishant,9,0,50,41
1657634468976,CSE 100,A01,083659,Cao; Yingjun,5,4,70,65
1657634475006,CSE 134B,A01,083661,Powell; Thomas Allan,22,0,100,78
1657634481034,CSE 140,A01,083663,Gungor; Onat,15,0,85,70
1657634487063,CSE 140L,A01,083088,Eldon; John,21,0,100,79
1657634493087,CSE 175,A01,083665,Kumar; Rakesh,3,0,25,22
1657634499113,CSE 190,A00,092507,Dubnov; Shlomo,8,0,20,12
1657634505141,ECE 45,A01,083139,Congero; Spencer William,6,0,75,69
1657634511169,ECE 65,A50,083695,Saad; Andrew S,12,0,30,18
1657634511169,ECE 65,A51,095125,Saad; Andrew S,24,0,26,2
1657634517203,ECE 109,A01,091882,Touri; Behrouz,19,0,70,51
1657634523233,ECE 180,A00,083140,Abi Samra; Nicholas Camill,1,0,30,29
1657634523233,ECE 180,B00,083141,Abi Samra; Nicholas Camill,0,0,30,30
1657634529266,MATH 10A,A01,083735,Patchell; Gregory David,2,0,30,28
1657634529266,MATH 10A,A02,083736,Patchell; Gregory David,20,0,30,10
1657634529266,MATH 10A,A03,083737,Patchell; Gregory David,16,0,30,14
1657634535319,MATH 10B,A01,083207,Lim; Seonhee,8,0,34,26
1657634535319,MATH 10B,A02,083208,Lim; Seonhee,9,0,35,26
1657634535319,MATH 10B,A03,093472,Lim; Seonhee,7,0,34,27
1657634535319,MATH 10B,B01,083739,Sinha; Shubham,12,0,30,18
1657634541353,MATH 18,A01,083743,Cinel; Cameron Alexander,7,0,30,23
1657634541353,MATH 18,A02,083744,Cinel; Cameron Alexander,17,0,30,13
1657634541353,MATH 18,A03,083745,Cinel; Cameron Alexander,9,0,30,21
1657634541353,MATH 18,B01,083748,Rideout; David Porter,5,0,37,32
1657634541353,MATH 18,B02,083749,Rideout; David Porter,5,0,36,31
1657634541353,MATH 18,B03,083750,Rideout; David Porter,3,0,37,34
1657634541353,MATH 18,B04,083751,Rideout; David Porter,6,0,36,30
1657634541353,MATH 18,B05,093473,Rideout; David Porter,6,0,36,30
1657634541353,MATH 18,B06,093474,Rideout; David Porter,6,0,36,30
1657634547383,MATH 20A,A01,083754,Zheng; Zequn,14,0,40,26
1657634553418,MATH 20B,A01,083756,Briones; Jor-el Thomas Caparas,4,0,36,32
1657634553418,MATH 20B,A02,083757,Briones; Jor-el Thomas Caparas,1,0,36,35
1657634553418,MATH 20B,A03,093475,Briones; Jor-el Thomas Caparas,2,0,36,34
1657634559450,MATH 20C,A01,083760,Briones; Jor-el Thomas Caparas,1,0,35,34
1657634559450,MATH 20C,A02,083761,Briones; Jor-el Thomas Caparas,8,0,35,27
1657634559450,MATH 20C,A03,093476,Briones; Jor-el Thomas Caparas,0,1,36,36
1657634559450,MATH 20C,B01,083762,Bach; Quang Tran,1,0,30,29
1657634565479,MATH 20D,A01,083765,Tran; Brian Kha,5,0,30,25
1657634565479,MATH 20D,A02,083766,Tran; Brian Kha,5,0,30,25
1657634565479,MATH 20D,A03,083767,Tran; Brian Kha,5,0,30,25
1657634571592,MATH 20E,A01,083771,Ganguly; Soumya,9,0,32,23
1657634571592,MATH 20E,A02,083772,Ganguly; Soumya,6,0,32,26
1657634571592,MATH 20E,B01,083773,Ciotti; Benjamin,20,0,35,15
1657634571592,MATH 20E,B02,083774,Ciotti; Benjamin,18,0,35,17
1657634577626,MATH 103A,A01,083777,Greenfeld; Be'Eri,3,0,36,33
1657634577626,MATH 103A,A02,083778,Greenfeld; Be'Eri,5,0,36,31
1657634577626,MATH 103A,A03,093561,Greenfeld; Be'Eri,6,0,36,30
1657634577626,MATH 103A,B01,083779,Greenfeld; Be'Eri,7,0,36,29
1657634577626,MATH 103A,B02,083780,Greenfeld; Be'Eri,4,0,36,32
1657634577626,MATH 103A,B03,093562,Greenfeld; Be'Eri,3,0,36,33
1657634583657,MATH 105,A01,085443,Carter; Anne Toulson,15,0,35,20
1657634583657,MATH 105,A02,093477,Carter; Anne Toulson,20,0,35,15
1657634589690,MATH 109,A01,083213,Ganzberger; Geoffrey Michael,2,0,34,32
1657634589690,MATH 109,A02,083214,Ganzberger; Geoffrey Michael,4,0,34,30
1657634589690,MATH 109,A03,093478,Ganzberger; Geoffrey Michael,2,0,34,32
1657634589690,MATH 109,B01,083215,Ganzberger; Geoffrey Michael,1,0,32,31
1657634589690,MATH 109,B02,083216,Ganzberger; Geoffrey Michael,2,0,32,30
1657634589690,MATH 109,B03,093479,Ganzberger; Geoffrey Michael,8,0,32,24
1657634595733,MATH 142A,A01,083219,Chow; Bennett,7,0,32,25
1657634595733,MATH 142A,A02,083220,Chow; Bennett,10,0,32,22
1657634595733,MATH 142A,A03,093480,Chow; Bennett,9,0,32,23
1657634595733,MATH 142A,B03,093481,Chow; Bennett,8,0,32,24
1657634595733,MATH 142A,B04,093558,Chow; Bennett,13,0,32,19
1657634595733,MATH 142A,B05,093559,Chow; Bennett,6,0,32,26
1657634601778,MATH 193A,A01,083224,Rotar; Vladimir,8,0,34,26
1657634601778,MATH 193A,A02,083225,Rotar; Vladimir,9,0,34,25
1657634601778,MATH 193A,A03,083781,Rotar; Vladimir,5,0,34,29
1657634601778,MATH 193A,A04,083782,Rotar; Vladimir,10,0,34,24
1657634601778,MATH 193A,A05,093482,Rotar; Vladimir,10,0,34,24
1657634607810,MATH 197,001,091859,McAuley; Julian John,9999,0,9999,0
1657634607810,MATH 197,002,095566,Kedlaya; Kiran S.,9997,0,9999,2
1657634607810,MATH 197,003,095567,Xiao; Ming,9999,0,9999,0
1657634607810,MATH 197,004,095571,Perols; Johan Lars,9998,0,9999,1
1657634614900,COGS 9,A01,083615,Shannon; Kyle Michael,9,0,75,66
1657634620927,COGS 11,A01,083617,Boyle; Mary E. T.,23,0,48,25
1657634626953,COGS 13,A01,083071,Bastos; Amalia Pinkusfeld,11,0,71,60
1657634632979,COGS 14A,A01,092681,Semenuks; Arturs,5,1,100,95
1657634639004,COGS 14B,A01,083073,Cheng; Tzu-Han,6,0,63,57
1657634645032,COGS 17,A01,092677,Semenuks; Arturs,6,0,81,75
1657634651060,COGS 100,A01,083619,Allen; Michael Gordon,17,0,70,53
1657634657087,COGS 101A,A01,083621,Davis; Joshua Daniel,9,0,68,59
1657634663115,COGS 101B,A01,091572,Allen; Michael Gordon,12,0,65,53
1657634669144,COGS 101C,A01,083625,Delgado; Tania,17,0,35,18
1657634675176,COGS 107A,A01,083627,Boyle; Mary E. T.,13,0,60,47
1657634681202,COGS 118A,A01,083075,Gupta; Anjum,21,0,76,55
1657634687230,CSE 3,A50,083646,Miranda; Gregory Joseph,24,0,50,26
1657634693254,CSE 8A,A50,083650,Miranda; Gregory Joseph,17,1,56,39
1657634699279,CSE 11,A01,083080,Cao; Yingjun,6,15,40,34
1657634705303,CSE 12,A01,083652,Krause-Levy; Sophia Louisa,28,1,120,92
1657634711327,CSE 15L,A01,083654,Morris; Justin Loren,9,0,50,41
1657634711327,CSE 15L,A02,083655,Morris; Justin Loren,9,0,50,41
1657634717356,CSE 20,A01,083657,Tran; Khoa Dang,39,0,80,41
1657634723394,CSE 21,A01,095574,Bach; Quang Tran,22,0,48,26
1657634729433,CSE 30,A01,083084,Eldon; John,6,0,80,74
1657634729433,CSE 30,B01,095061,Bhaskar; Nishant,9,0,50,41
1657634735467,CSE 100,A01,083659,Cao; Yingjun,5,4,70,65
1657634741494,CSE 134B,A01,083661,Powell; Thomas Allan,22,0,100,78
1657634747522,CSE 140,A01,083663,Gungor; Onat,15,0,85,70
1657634753546,CSE 140L,A01,083088,Eldon; John,21,0,100,79
1657634759573,CSE 175,A01,083665,Kumar; Rakesh,3,0,25,22
1657634765600,CSE 190,A00,092507,Dubnov; Shlomo,8,0,20,12
1657634771625,ECE 45,A01,083139,Congero; Spencer William,6,0,75,69
1657634777655,ECE 65,A50,083695,Saad; Andrew S,12,0,30,18
1657634777655,ECE 65,A51,095125,Saad; Andrew S,24,0,26,2
1657634783679,ECE 109,A01,091882,Touri; Behrouz,19,0,70,51
1657634789702,ECE 180,A00,083140,Abi Samra; Nicholas Camill,1,0,30,29
1657634789702,ECE 180,B00,083141,Abi Samra; Nicholas Camill,0,0,30,30
1657634795732,MATH 10A,A01,083735,Patchell; Gregory David,2,0,30,28
1657634795732,MATH 10A,A02,083736,Patchell; Gregory David,20,0,30,10
1657634795732,MATH 10A,A03,083737,Patchell; Gregory David,16,0,30,14
1657634801757,MATH 10B,A01,083207,Lim; Seonhee,8,0,34,26
1657634801757,MATH 10B,A02,083208,Lim; Seonhee,9,0,35,26
1657634801757,MATH 10B,A03,093472,Lim; Seonhee,7,0,34,27
1657634801757,MATH 10B,B01,083739,Sinha; Shubham,12,0,30,18
1657634807785,MATH 18,A01,083743,Cinel; Cameron Alexander,7,0,30,23
1657634807785,MATH 18,A02,083744,Cinel; Cameron Alexander,17,0,30,13
1657634807785,MATH 18,A03,083745,Cinel; Cameron Alexander,9,0,30,21
1657634807785,MATH 18,B01,083748,Rideout; David Porter,5,0,37,32
1657634807785,MATH 18,B02,083749,Rideout; David Porter,5,0,36,31
1657634807785,MATH 18,B03,083750,Rideout; David Porter,3,0,37,34
1657634807785,MATH 18,B04,083751,Rideout; David Porter,6,0,36,30
1657634807785,MATH 18,B05,093473,Rideout; David Porter,6,0,36,30
1657634807785,MATH 18,B06,093474,Rideout; David Porter,6,0,36,30
1657634813815,MATH 20A,A01,083754,Zheng; Zequn,14,0,40,26
1657634819840,MATH 20B,A01,083756,Briones; Jor-el Thomas Caparas,4,0,36,32
1657634819840,MATH 20B,A02,083757,Briones; Jor-el Thomas Caparas,1,0,36,35
1657634819840,MATH 20B,A03,093475,Briones; Jor-el Thomas Caparas,2,0,36,34
1657634825873,MATH 20C,A01,083760,Briones; Jor-el Thomas Caparas,1,0,35,34
1657634825873,MATH 20C,A02,083761,Briones; Jor-el Thomas Caparas,8,0,35,27
1657634825873,MATH 20C,A03,093476,Briones; Jor-el Thomas Caparas,0,1,36,36
1657634825873,MATH 20C,B01,083762,Bach; Quang Tran,1,0,30,29
1657634831896,MATH 20D,A01,083765,Tran; Brian Kha,5,0,30,25
1657634831896,MATH 20D,A02,083766,Tran; Brian Kha,5,0,30,25
1657634831896,MATH 20D,A03,083767,Tran; Brian Kha,5,0,30,25
1657634837921,MATH 20E,A01,083771,Ganguly; Soumya,9,0,32,23
1657634837921,MATH 20E,A02,083772,Ganguly; Soumya,6,0,32,26
1657634837921,MATH 20E,B01,083773,Ciotti; Benjamin,20,0,35,15
1657634837921,MATH 20E,B02,083774,Ciotti; Benjamin,18,0,35,17
1657634843948,MATH 103A,A01,083777,Greenfeld; Be'Eri,3,0,36,33
1657634843948,MATH 103A,A02,083778,Greenfeld; Be'Eri,5,0,36,31
1657634843948,MATH 103A,A03,093561,Greenfeld; Be'Eri,6,0,36,30
1657634843948,MATH 103A,B01,083779,Greenfeld; Be'Eri,7,0,36,29
1657634843948,MATH 103A,B02,083780,Greenfeld; Be'Eri,4,0,36,32
1657634843948,MATH 103A,B03,093562,Greenfeld; Be'Eri,3,0,36,33
1657634849987,MATH 105,A01,085443,Carter; Anne Toulson,15,0,35,20
1657634849987,MATH 105,A02,093477,Carter; Anne Toulson,20,0,35,15
1657634856012,MATH 109,A01,083213,Ganzberger; Geoffrey Michael,2,0,34,32
1657634856012,MATH 109,A02,083214,Ganzberger; Geoffrey Michael,4,0,34,30
1657634856012,MATH 109,A03,093478,Ganzberger; Geoffrey Michael,2,0,34,32
1657634856012,MATH 109,B01,083215,Ganzberger; Geoffrey Michael,1,0,32,31
1657634856012,MATH 109,B02,083216,Ganzberger; Geoffrey Michael,2,0,32,30
1657634856012,MATH 109,B03,093479,Ganzberger; Geoffrey Michael,8,0,32,24
1657634862041,MATH 142A,A01,083219,Chow; Bennett,7,0,32,25
1657634862041,MATH 142A,A02,083220,Chow; Bennett,10,0,32,22
1657634862041,MATH 142A,A03,093480,Chow; Bennett,9,0,32,23
1657634862041,MATH 142A,B03,093481,Chow; Bennett,8,0,32,24
1657634862041,MATH 142A,B04,093558,Chow; Bennett,13,0,32,19
1657634862041,MATH 142A,B05,093559,Chow; Bennett,6,0,32,26
1657634868067,MATH 193A,A01,083224,Rotar; Vladimir,8,0,34,26
1657634868067,MATH 193A,A02,083225,Rotar; Vladimir,9,0,34,25
1657634868067,MATH 193A,A03,083781,Rotar; Vladimir,5,0,34,29
1657634868067,MATH 193A,A04,083782,Rotar; Vladimir,10,0,34,24
1657634868067,MATH 193A,A05,093482,Rotar; Vladimir,10,0,34,24
1657634874091,MATH 197,001,091859,McAuley; Julian John,9999,0,9999,0
1657634874091,MATH 197,002,095566,Kedlaya; Kiran S.,9997,0,9999,2
1657634874091,MATH 197,003,095567,Xiao; Ming,9999,0,9999,0
1657634874091,MATH 197,004,095571,Perols; Johan Lars,9998,0,9999,1
1657634881162,COGS 9,A01,083615,Shannon; Kyle Michael,9,0,75,66
1657634887186,COGS 11,A01,083617,Boyle; Mary E. T.,23,0,48,25
1657634893214,COGS 13,A01,083071,Bastos; Amalia Pinkusfeld,11,0,71,60
1657634899238,COGS 14A,A01,092681,Semenuks; Arturs,5,1,100,95
1657634905262,COGS 14B,A01,083073,Cheng; Tzu-Han,6,0,63,57
1657634911286,COGS 17,A01,092677,Semenuks; Arturs,6,0,81,75
1657634917316,COGS 100,A01,083619,Allen; Michael Gordon,17,0,70,53
1657634923352,COGS 101A,A01,083621,Davis; Joshua Daniel,9,0,68,59
1657634929376,COGS 101B,A01,091572,Allen; Michael Gordon,12,0,65,53
1657634935400,COGS 101C,A01,083625,Delgado; Tania,17,0,35,18
1657634941427,COGS 107A,A01,083627,Boyle; Mary E. T.,13,0,60,47
1657634947457,COGS 118A,A01,083075,Gupta; Anjum,21,0,76,55
1657634953481,CSE 3,A50,083646,Miranda; Gregory Joseph,24,0,50,26
1657634959506,CSE 8A,A50,083650,Miranda; Gregory Joseph,17,1,56,39
1657634965531,CSE 11,A01,083080,Cao; Yingjun,6,15,40,34
1657634971556,CSE 12,A01,083652,Krause-Levy; Sophia Louisa,28,1,120,92
1657634977582,CSE 15L,A01,083654,Morris; Justin Loren,9,0,50,41
1657634977582,CSE 15L,A02,083655,Morris; Justin Loren,9,0,50,41
1657634983608,CSE 20,A01,083657,Tran; Khoa Dang,39,0,80,41
1657634989638,CSE 21,A01,095574,Bach; Quang Tran,22,0,48,26
1657634995667,CSE 30,A01,083084,Eldon; John,6,0,80,74
1657634995667,CSE 30,B01,095061,Bhaskar; Nishant,9,0,50,41
1657635001692,CSE 100,A01,083659,Cao; Yingjun,5,4,70,65
1657635007716,CSE 134B,A01,083661,Powell; Thomas Allan,22,0,100,78
1657635013746,CSE 140,A01,083663,Gungor; Onat,15,0,85,70
1657635019773,CSE 140L,A01,083088,Eldon; John,21,0,100,79
1657635025808,CSE 175,A01,083665,Kumar; Rakesh,3,0,25,22
1657635031832,CSE 190,A00,092507,Dubnov; Shlomo,8,0,20,12
1657635037853,ECE 45,A01,083139,Congero; Spencer William,6,0,75,69
1657635043878,ECE 65,A50,083695,Saad; Andrew S,12,0,30,18
1657635043878,ECE 65,A51,095125,Saad; Andrew S,24,0,26,2
1657635049903,ECE 109,A01,091882,Touri; Behrouz,19,0,70,51
1657635055929,ECE 180,A00,083140,Abi Samra; Nicholas Camill,1,0,30,29
1657635055929,ECE 180,B00,083141,Abi Samra; Nicholas Camill,0,0,30,30
1657635061955,MATH 10A,A01,083735,Patchell; Gregory David,2,0,30,28
1657635061955,MATH 10A,A02,083736,Patchell; Gregory David,20,0,30,10
1657635061955,MATH 10A,A03,083737,Patchell; Gregory David,16,0,30,14
1657635067984,MATH 10B,A01,083207,Lim; Seonhee,8,0,34,26
1657635067984,MATH 10B,A02,083208,Lim; Seonhee,9,0,35,26
1657635067984,MATH 10B,A03,093472,Lim; Seonhee,7,0,34,27
1657635067984,MATH 10B,B01,083739,Sinha; Shubham,12,0,30,18
1657635074011,MATH 18,A01,083743,Cinel; Cameron Alexander,7,0,30,23
1657635074011,MATH 18,A02,083744,Cinel; Cameron Alexander,17,0,30,13
1657635074011,MATH 18,A03,083745,Cinel; Cameron Alexander,9,0,30,21
1657635074011,MATH 18,B01,083748,Rideout; David Porter,5,0,37,32
1657635074011,MATH 18,B02,083749,Rideout; David Porter,5,0,36,31
1657635074011,MATH 18,B03,083750,Rideout; David Porter,3,0,37,34
1657635074011,MATH 18,B04,083751,Rideout; David Porter,6,0,36,30
1657635074011,MATH 18,B05,093473,Rideout; David Porter,6,0,36,30
1657635074011,MATH 18,B06,093474,Rideout; David Porter,6,0,36,30
1657635080037,MATH 20A,A01,083754,Zheng; Zequn,14,0,40,26
1657635086065,MATH 20B,A01,083756,Briones; Jor-el Thomas Caparas,4,0,36,32
1657635086065,MATH 20B,A02,083757,Briones; Jor-el Thomas Caparas,1,0,36,35
1657635086065,MATH 20B,A03,093475,Briones; Jor-el Thomas Caparas,2,0,36,34
1657635092091,MATH 20C,A01,083760,Briones; Jor-el Thomas Caparas,1,0,35,34
1657635092091,MATH 20C,A02,083761,Briones; Jor-el Thomas Caparas,8,0,35,27
1657635092091,MATH 20C,A03,093476,Briones; Jor-el Thomas Caparas,0,1,36,36
1657635092091,MATH 20C,B01,083762,Bach; Quang Tran,1,0,30,29
1657635098116,MATH 20D,A01,083765,Tran; Brian Kha,5,0,30,25
1657635098116,MATH 20D,A02,083766,Tran; Brian Kha,5,0,30,25
1657635098116,MATH 20D,A03,083767,Tran; Brian Kha,5,0,30,25
1657635104143,MATH 20E,A01,083771,Ganguly; Soumya,9,0,32,23
1657635104143,MATH 20E,A02,083772,Ganguly; Soumya,6,0,32,26
1657635104143,MATH 20E,B01,083773,Ciotti; Benjamin,20,0,35,15
1657635104143,MATH 20E,B02,083774,Ciotti; Benjamin,18,0,35,17
1657635110183,MATH 103A,A01,083777,Greenfeld; Be'Eri,3,0,36,33
1657635110183,MATH 103A,A02,083778,Greenfeld; Be'Eri,5,0,36,31
1657635110183,MATH 103A,A03,093561,Greenfeld; Be'Eri,6,0,36,30
1657635110183,MATH 103A,B01,083779,Greenfeld; Be'Eri,7,0,36,29
1657635110183,MATH 103A,B02,083780,Greenfeld; Be'Eri,4,0,36,32
1657635110183,MATH 103A,B03,093562,Greenfeld; Be'Eri,3,0,36,33
1657635116215,MATH 105,A01,085443,Carter; Anne Toulson,15,0,35,20
1657635116215,MATH 105,A02,093477,Carter; Anne Toulson,20,0,35,15
1657635122246,MATH 109,A01,083213,Ganzberger; Geoffrey Michael,2,0,34,32
1657635122246,MATH 109,A02,083214,Ganzberger; Geoffrey Michael,4,0,34,30
1657635122246,MATH 109,A03,093478,Ganzberger; Geoffrey Michael,2,0,34,32
1657635122246,MATH 109,B01,083215,Ganzberger; Geoffrey Michael,1,0,32,31
1657635122246,MATH 109,B02,083216,Ganzberger; Geoffrey Michael,2,0,32,30
1657635122246,MATH 109,B03,093479,Ganzberger; Geoffrey Michael,8,0,32,24
1657635128276,MATH 142A,A01,083219,Chow; Bennett,7,0,32,25
1657635128276,MATH 142A,A02,083220,Chow; Bennett,10,0,32,22
1657635128276,MATH 142A,A03,093480,Chow; Bennett,9,0,32,23
1657635128276,MATH 142A,B03,093481,Chow; Bennett,8,0,32,24
1657635128276,MATH 142A,B04,093558,Chow; Bennett,13,0,32,19
1657635128276,MATH 142A,B05,093559,Chow; Bennett,6,0,32,26
1657635134301,MATH 193A,A01,083224,Rotar; Vladimir,8,0,34,26
1657635134301,MATH 193A,A02,083225,Rotar; Vladimir,9,0,34,25
1657635134301,MATH 193A,A03,083781,Rotar; Vladimir,5,0,34,29
1657635134301,MATH 193A,A04,083782,Rotar; Vladimir,10,0,34,24
1657635134301,MATH 193A,A05,093482,Rotar; Vladimir,10,0,34,24
1657635140326,MATH 197,001,091859,McAuley; Julian John,9999,0,9999,0
1657635140326,MATH 197,002,095566,Kedlaya; Kiran S.,9997,0,9999,2
1657635140326,MATH 197,003,095567,Xiao; Ming,9999,0,9999,0
1657635140326,MATH 197,004,095571,Perols; Johan Lars,9998,0,9999,1
1657635147382,COGS 9,A01,083615,Shannon; Kyle Michael,9,0,75,66
1657635153407,COGS 11,A01,083617,Boyle; Mary E. T.,23,0,48,25
1657635159432,COGS 13,A01,083071,Bastos; Amalia Pinkusfeld,11,0,71,60
1657635165524,COGS 14A,A01,092681,Semenuks; Arturs,5,1,100,95
1657635171554,COGS 14B,A01,083073,Cheng; Tzu-Han,6,0,63,57
1657635177582,COGS 17,A01,092677,Semenuks; Arturs,6,0,81,75
1657635183610,COGS 100,A01,083619,Allen; Michael Gordon,17,0,70,53
1657635189635,COGS 101A,A01,083621,Davis; Joshua Daniel,9,0,68,59
1657635195665,COGS 101B,A01,091572,Allen; Michael Gordon,12,0,65,53
1657635201688,COGS 101C,A01,083625,Delgado; Tania,17,0,35,18
1657635207720,COGS 107A,A01,083627,Boyle; Mary E. T.,13,0,60,47
1657635213745,COGS 118A,A01,083075,Gupta; Anjum,21,0,76,55
1657635219784,CSE 3,A50,083646,Miranda; Gregory Joseph,24,0,50,26
1657635225807,CSE 8A,A50,083650,Miranda; Gregory Joseph,17,1,56,39
1657635231838,CSE 11,A01,083080,Cao; Yingjun,6,15,40,34
1657635237863,CSE 12,A01,083652,Krause-Levy; Sophia Louisa,28,1,120,92
1657635243901,CSE 15L,A01,083654,Morris; Justin Loren,9,0,50,41
1657635243901,CSE 15L,A02,083655,Morris; Justin Loren,9,0,50,41
1657635249927,CSE 20,A01,083657,Tran; Khoa Dang,39,0,80,41
1657635255958,CSE 21,A01,095574,Bach; Quang Tran,22,0,48,26
1657635261988,CSE 30,A01,083084,Eldon; John,6,0,80,74
1657635261988,CSE 30,B01,095061,Bhaskar; Nishant,9,0,50,41
1657635268013,CSE 100,A01,083659,Cao; Yingjun,5,4,70,65
1657635274036,CSE 134B,A01,083661,Powell; Thomas Allan,22,0,100,78
1657635280065,CSE 140,A01,083663,Gungor; Onat,15,0,85,70
1657635286091,CSE 140L,A01,083088,Eldon; John,21,0,100,79
1657635292116,CSE 175,A01,083665,Kumar; Rakesh,3,0,25,22
1657635298140,CSE 190,A00,092507,Dubnov; Shlomo,8,0,20,12
1657635304163,ECE 45,A01,083139,Congero; Spencer William,6,0,75,69
1657635310200,ECE 65,A50,083695,Saad; Andrew S,12,0,30,18
1657635310200,ECE 65,A51,095125,Saad; Andrew S,24,0,26,2
1657635316234,ECE 109,A01,091882,Touri; Behrouz,19,0,70,51
1657635322258,ECE 180,A00,083140,Abi Samra; Nicholas Camill,1,0,30,29
1657635322258,ECE 180,B00,083141,Abi Samra; Nicholas Camill,0,0,30,30
1657635328282,MATH 10A,A01,083735,Patchell; Gregory David,2,0,30,28
1657635328282,MATH 10A,A02,083736,Patchell; Gregory David,20,0,30,10
1657635328282,MATH 10A,A03,083737,Patchell; Gregory David,16,0,30,14
1657635334312,MATH 10B,A01,083207,Lim; Seonhee,8,0,34,26
1657635334312,MATH 10B,A02,083208,Lim; Seonhee,9,0,35,26
1657635334312,MATH 10B,A03,093472,Lim; Seonhee,7,0,34,27
1657635334312,MATH 10B,B01,083739,Sinha; Shubham,12,0,30,18
1657635340348,MATH 18,A01,083743,Cinel; Cameron Alexander,7,0,30,23
1657635340348,MATH 18,A02,083744,Cinel; Cameron Alexander,17,0,30,13
1657635340348,MATH 18,A03,083745,Cinel; Cameron Alexander,9,0,30,21
1657635340348,MATH 18,B01,083748,Rideout; David Porter,5,0,37,32
1657635340348,MATH 18,B02,083749,Rideout; David Porter,5,0,36,31
1657635340348,MATH 18,B03,083750,Rideout; David Porter,3,0,37,34
1657635340348,MATH 18,B04,083751,Rideout; David Porter,6,0,36,30
1657635340348,MATH 18,B05,093473,Rideout; David Porter,6,0,36,30
1657635340348,MATH 18,B06,093474,Rideout; David Porter,6,0,36,30
1657635346370,MATH 20A,A01,083754,Zheng; Zequn,14,0,40,26
1657635352407,MATH 20B,A01,083756,Briones; Jor-el Thomas Caparas,4,0,36,32
1657635352407,MATH 20B,A02,083757,Briones; Jor-el Thomas Caparas,1,0,36,35
1657635352407,MATH 20B,A03,093475,Briones; Jor-el Thomas Caparas,2,0,36,34
1657635358433,MATH 20C,A01,083760,Briones; Jor-el Thomas Caparas,1,0,35,34
1657635358433,MATH 20C,A02,083761,Briones; Jor-el Thomas Caparas,8,0,35,27
1657635358433,MATH 20C,A03,093476,Briones; Jor-el Thomas Caparas,0,1,36,36
1657635358433,MATH 20C,B01,083762,Bach; Quang Tran,1,0,30,29
1657635364459,MATH 20D,A01,083765,Tran; Brian Kha,5,0,30,25
1657635364459,MATH 20D,A02,083766,Tran; Brian Kha,5,0,30,25
1657635364459,MATH 20D,A03,083767,Tran; Brian Kha,5,0,30,25
1657635370490,MATH 20E,A01,083771,Ganguly; Soumya,9,0,32,23
1657635370490,MATH 20E,A02,083772,Ganguly; Soumya,6,0,32,26
1657635370490,MATH 20E,B01,083773,Ciotti; Benjamin,20,0,35,15
1657635370490,MATH 20E,B02,083774,Ciotti; Benjamin,18,0,35,17
1657635376520,MATH 103A,A01,083777,Greenfeld; Be'Eri,3,0,36,33
1657635376520,MATH 103A,A02,083778,Greenfeld; Be'Eri,5,0,36,31
1657635376520,MATH 103A,A03,093561,Greenfeld; Be'Eri,6,0,36,30
1657635376520,MATH 103A,B01,083779,Greenfeld; Be'Eri,7,0,36,29
1657635376520,MATH 103A,B02,083780,Greenfeld; Be'Eri,4,0,36,32
1657635376520,MATH 103A,B03,093562,Greenfeld; Be'Eri,3,0,36,33
1657635382548,MATH 105,A01,085443,Carter; Anne Toulson,15,0,35,20
1657635382548,MATH 105,A02,093477,Carter; Anne Toulson,20,0,35,15
1657635388577,MATH 109,A01,083213,Ganzberger; Geoffrey Michael,2,0,34,32
1657635388577,MATH 109,A02,083214,Ganzberger; Geoffrey Michael,4,0,34,30
1657635388577,MATH 109,A03,093478,Ganzberger; Geoffrey Michael,2,0,34,32
1657635388577,MATH 109,B01,083215,Ganzberger; Geoffrey Michael,1,0,32,31
1657635388577,MATH 109,B02,083216,Ganzberger; Geoffrey Michael,2,0,32,30
1657635388577,MATH 109,B03,093479,Ganzberger; Geoffrey Michael,8,0,32,24
1657635394606,MATH 142A,A01,083219,Chow; Bennett,7,0,32,25
1657635394606,MATH 142A,A02,083220,Chow; Bennett,10,0,32,22
1657635394606,MATH 142A,A03,093480,Chow; Bennett,9,0,32,23
1657635394606,MATH 142A,B03,093481,Chow; Bennett,8,0,32,24
1657635394606,MATH 142A,B04,093558,Chow; Bennett,13,0,32,19
1657635394606,MATH 142A,B05,093559,Chow; Bennett,6,0,32,26
1657635400633,MATH 193A,A01,083224,Rotar; Vladimir,8,0,34,26
1657635400633,MATH 193A,A02,083225,Rotar; Vladimir,9,0,34,25
1657635400633,MATH 193A,A03,083781,Rotar; Vladimir,5,0,34,29
1657635400633,MATH 193A,A04,083782,Rotar; Vladimir,10,0,34,24
1657635400633,MATH 193A,A05,093482,Rotar; Vladimir,10,0,34,24
1657635406657,MATH 197,001,091859,McAuley; Julian John,9999,0,9999,0
1657635406657,MATH 197,002,095566,Kedlaya; Kiran S.,9997,0,9999,2
1657635406657,MATH 197,003,095567,Xiao; Ming,9999,0,9999,0
1657635406657,MATH 197,004,095571,Perols; Johan Lars,9998,0,9999,1
1657635413724,COGS 9,A01,083615,Shannon; Kyle Michael,9,0,75,66
1657635419751,COGS 11,A01,083617,Boyle; Mary E. T.,23,0,48,25
1657635425780,COGS 13,A01,083071,Bastos; Amalia Pinkusfeld,11,0,71,60
1657635431809,COGS 14A,A01,092681,Semenuks; Arturs,5,1,100,95
1657635437837,COGS 14B,A01,083073,Cheng; Tzu-Han,6,0,63,57
1657635443863,COGS 17,A01,092677,Semenuks; Arturs,6,0,81,75
1657635449888,COGS 100,A01,083619,Allen; Michael Gordon,17,0,70,53
1657635455918,COGS 101A,A01,083621,Davis; Joshua Daniel,9,0,68,59
1657635461945,COGS 101B,A01,091572,Allen; Michael Gordon,12,0,65,53
1657635467974,COGS 101C,A01,083625,Delgado; Tania,17,0,35,18
1657635474003,COGS 107A,A01,083627,Boyle; Mary E. T.,13,0,60,47
1657635480036,COGS 118A,A01,083075,Gupta; Anjum,21,0,76,55
1657635486068,CSE 3,A50,083646,Miranda; Gregory Joseph,24,0,50,26
1657635492092,CSE 8A,A50,083650,Miranda; Gregory Joseph,17,1,56,39
1657635498121,CSE 11,A01,083080,Cao; Yingjun,6,15,40,34
1657635504155,CSE 12,A01,083652,Krause-Levy; Sophia Louisa,28,1,120,92
1657635510181,CSE 15L,A01,083654,Morris; Justin Loren,9,0,50,41
1657635510181,CSE 15L,A02,083655,Morris; Justin Loren,9,0,50,41
1657635516211,CSE 20,A01,083657,Tran; Khoa Dang,39,0,80,41
1657635522239,CSE 21,A01,095574,Bach; Quang Tran,22,0,48,26
1657635528274,CSE 30,A01,083084,Eldon; John,6,0,80,74
1657635528274,CSE 30,B01,095061,Bhaskar; Nishant,9,0,50,41
1657635534299,CSE 100,A01,083659,Cao; Yingjun,5,4,70,65
1657635540327,CSE 134B,A01,083661,Powell; Thomas Allan,22,0,100,78
1657635546353,CSE 140,A01,083663,Gungor; Onat,15,0,85,70
1657635552382,CSE 140L,A01,083088,Eldon; John,21,0,100,79
1657635558423,CSE 175,A01,083665,Kumar; Rakesh,3,0,25,22
1657635564451,CSE 190,A00,092507,Dubnov; Shlomo,8,0,20,12
1657635570476,ECE 45,A01,083139,Congero; Spencer William,6,0,75,69
1657635576501,ECE 65,A50,083695,Saad; Andrew S,12,0,30,18
1657635576501,ECE 65,A51,095125,Saad; Andrew S,24,0,26,2
1657635582537,ECE 109,A01,091882,Touri; Behrouz,19,0,70,51
1657635588572,ECE 180,A00,083140,Abi Samra; Nicholas Camill,1,0,30,29
1657635588572,ECE 180,B00,083141,Abi Samra; Nicholas Camill,0,0,30,30
1657635594597,MATH 10A,A01,083735,Patchell; Gregory David,2,0,30,28
1657635594597,MATH 10A,A02,083736,Patchell; Gregory David,20,0,30,10
1657635594597,MATH 10A,A03,083737,Patchell; Gregory David,16,0,30,14
1657635600622,MATH 10B,A01,083207,Lim; Seonhee,8,0,34,26
1657635600622,MATH 10B,A02,083208,Lim; Seonhee,9,0,35,26
1657635600622,MATH 10B,A03,093472,Lim; Seonhee,7,0,34,27
1657635600622,MATH 10B,B01,083739,Sinha; Shubham,12,0,30,18
1657635606647,MATH 18,A01,083743,Cinel; Cameron Alexander,7,0,30,23
1657635606647,MATH 18,A02,083744,Cinel; Cameron Alexander,17,0,30,13
1657635606647,MATH 18,A03,083745,Cinel; Cameron Alexander,9,0,30,21
1657635606647,MATH 18,B01,083748,Rideout; David Porter,5,0,37,32
1657635606647,MATH 18,B02,083749,Rideout; David Porter,5,0,36,31
1657635606647,MATH 18,B03,083750,Rideout; David Porter,3,0,37,34
1657635606647,MATH 18,B04,083751,Rideout; David Porter,6,0,36,30
1657635606647,MATH 18,B05,093473,Rideout; David Porter,6,0,36,30
1657635606647,MATH 18,B06,093474,Rideout; David Porter,6,0,36,30
1657635612671,MATH 20A,A01,083754,Zheng; Zequn,14,0,40,26
1657635618701,MATH 20B,A01,083756,Briones; Jor-el Thomas Caparas,4,0,36,32
1657635618701,MATH 20B,A02,083757,Briones; Jor-el Thomas Caparas,1,0,36,35
1657635618701,MATH 20B,A03,093475,Briones; Jor-el Thomas Caparas,2,0,36,34
1657635624729,MATH 20C,A01,083760,Briones; Jor-el Thomas Caparas,1,0,35,34
1657635624729,MATH 20C,A02,083761,Briones; Jor-el Thomas Caparas,8,0,35,27
1657635624729,MATH 20C,A03,093476,Briones; Jor-el Thomas Caparas,0,1,36,36
1657635624729,MATH 20C,B01,083762,Bach; Quang Tran,1,0,30,29
1657635630752,MATH 20D,A01,083765,Tran; Brian Kha,5,0,30,25
1657635630752,MATH 20D,A02,083766,Tran; Brian Kha,5,0,30,25
1657635630752,MATH 20D,A03,083767,Tran; Brian Kha,5,0,30,25
1657635636783,MATH 20E,A01,083771,Ganguly; Soumya,9,0,32,23
1657635636783,MATH 20E,A02,083772,Ganguly; Soumya,6,0,32,26
1657635636783,MATH 20E,B01,083773,Ciotti; Benjamin,20,0,35,15
1657635636783,MATH 20E,B02,083774,Ciotti; Benjamin,18,0,35,17
1657635642809,MATH 103A,A01,083777,Greenfeld; Be'Eri,3,0,36,33
1657635642809,MATH 103A,A02,083778,Greenfeld; Be'Eri,5,0,36,31
1657635642809,MATH 103A,A03,093561,Greenfeld; Be'Eri,6,0,36,30
1657635642809,MATH 103A,B01,083779,Greenfeld; Be'Eri,7,0,36,29
1657635642809,MATH 103A,B02,083780,Greenfeld; Be'Eri,4,0,36,32
1657635642809,MATH 103A,B03,093562,Greenfeld; Be'Eri,3,0,36,33
1657635648837,MATH 105,A01,085443,Carter; Anne Toulson,15,0,35,20
1657635648837,MATH 105,A02,093477,Carter; Anne Toulson,20,0,35,15
1657635654876,MATH 109,A01,083213,Ganzberger; Geoffrey Michael,2,0,34,32
1657635654876,MATH 109,A02,083214,Ganzberger; Geoffrey Michael,4,0,34,30
1657635654876,MATH 109,A03,093478,Ganzberger; Geoffrey Michael,2,0,34,32
1657635654876,MATH 109,B01,083215,Ganzberger; Geoffrey Michael,1,0,32,31
1657635654876,MATH 109,B02,083216,Ganzberger; Geoffrey Michael,2,0,32,30
1657635654876,MATH 109,B03,093479,Ganzberger; Geoffrey Michael,8,0,32,24
1657635660906,MATH 142A,A01,083219,Chow; Bennett,7,0,32,25
1657635660906,MATH 142A,A02,083220,Chow; Bennett,10,0,32,22
1657635660906,MATH 142A,A03,093480,Chow; Bennett,9,0,32,23
1657635660906,MATH 142A,B03,093481,Chow; Bennett,8,0,32,24
1657635660906,MATH 142A,B04,093558,Chow; Bennett,13,0,32,19
1657635660906,MATH 142A,B05,093559,Chow; Bennett,6,0,32,26
1657635666934,MATH 193A,A01,083224,Rotar; Vladimir,8,0,34,26
1657635666934,MATH 193A,A02,083225,Rotar; Vladimir,9,0,34,25
1657635666934,MATH 193A,A03,083781,Rotar; Vladimir,5,0,34,29
1657635666934,MATH 193A,A04,083782,Rotar; Vladimir,10,0,34,24
1657635666934,MATH 193A,A05,093482,Rotar; Vladimir,10,0,34,24
1657635672958,MATH 197,001,091859,McAuley; Julian John,9999,0,9999,0
1657635672958,MATH 197,002,095566,Kedlaya; Kiran S.,9997,0,9999,2
1657635672958,MATH 197,003,095567,Xiao; Ming,9999,0,9999,0
1657635672958,MATH 197,004,095571,Perols; Johan Lars,9998,0,9999,1
1657635680014,COGS 9,A01,083615,Shannon; Kyle Michael,9,0,75,66
1657635686039,COGS 11,A01,083617,Boyle; Mary E. T.,23,0,48,25
1657635692069,COGS 13,A01,083071,Bastos; Amalia Pinkusfeld,11,0,71,60
1657635698095,COGS 14A,A01,092681,Semenuks; Arturs,5,1,100,95
1657635704121,COGS 14B,A01,083073,Cheng; Tzu-Han,6,0,63,57
1657635710150,COGS 17,A01,092677,Semenuks; Arturs,6,0,81,75
1657635716175,COGS 100,A01,083619,Allen; Michael Gordon,17,0,70,53
1657635722204,COGS 101A,A01,083621,Davis; Joshua Daniel,9,0,68,59
1657635728232,COGS 101B,A01,091572,Allen; Michael Gordon,12,0,65,53
1657635734265,COGS 101C,A01,083625,Delgado; Tania,17,0,35,18
1657635740292,COGS 107A,A01,083627,Boyle; Mary E. T.,13,0,60,47
1657635746317,COGS 118A,A01,083075,Gupta; Anjum,21,0,76,55
1657635752344,CSE 3,A50,083646,Miranda; Gregory Joseph,24,0,50,26
1657635758370,CSE 8A,A50,083650,Miranda; Gregory Joseph,17,1,56,39
1657635764466,CSE 11,A01,083080,Cao; Yingjun,6,15,40,34
1657635770493,CSE 12,A01,083652,Krause-Levy; Sophia Louisa,28,1,120,92
1657635776518,CSE 15L,A01,083654,Morris; Justin Loren,9,0,50,41
1657635776518,CSE 15L,A02,083655,Morris; Justin Loren,9,0,50,41
1657635782545,CSE 20,A01,083657,Tran; Khoa Dang,39,0,80,41
1657635788574,CSE 21,A01,095574,Bach; Quang Tran,22,0,48,26
1657635794598,CSE 30,A01,083084,Eldon; John,6,0,80,74
1657635794598,CSE 30,B01,095061,Bhaskar; Nishant,9,0,50,41
1657635800624,CSE 100,A01,083659,Cao; Yingjun,5,4,70,65
1657635806654,CSE 134B,A01,083661,Powell; Thomas Allan,22,0,100,78
1657635812677,CSE 140,A01,083663,Gungor; Onat,15,0,85,70
1657635818700,CSE 140L,A01,083088,Eldon; John,21,0,100,79
1657635824726,CSE 175,A01,083665,Kumar; Rakesh,3,0,25,22
1657635830750,CSE 190,A00,092507,Dubnov; Shlomo,8,0,20,12
1657635836775,ECE 45,A01,083139,Congero; Spencer William,6,0,75,69
1657635842805,ECE 65,A50,083695,Saad; Andrew S,12,0,30,18
1657635842805,ECE 65,A51,095125,Saad; Andrew S,24,0,26,2
1657635848834,ECE 109,A01,091882,Touri; Behrouz,19,0,70,51
1657635854866,ECE 180,A00,083140,Abi Samra; Nicholas Camill,1,0,30,29
1657635854866,ECE 180,B00,083141,Abi Samra; Nicholas Camill,0,0,30,30
1657635860897,MATH 10A,A01,083735,Patchell; Gregory David,2,0,30,28
1657635860897,MATH 10A,A02,083736,Patchell; Gregory David,20,0,30,10
1657635860897,MATH 10A,A03,083737,Patchell; Gregory David,16,0,30,14
1657635866929,MATH 10B,A01,083207,Lim; Seonhee,8,0,34,26
1657635866929,MATH 10B,A02,083208,Lim; Seonhee,9,0,35,26
1657635866929,MATH 10B,A03,093472,Lim; Seonhee,7,0,34,27
1657635866929,MATH 10B,B01,083739,Sinha; Shubham,12,0,30,18
1657635872961,MATH 18,A01,083743,Cinel; Cameron Alexander,7,0,30,23
1657635872961,MATH 18,A02,083744,Cinel; Cameron Alexander,17,0,30,13
1657635872961,MATH 18,A03,083745,Cinel; Cameron Alexander,9,0,30,21
1657635872961,MATH 18,B01,083748,Rideout; David Porter,5,0,37,32
1657635872961,MATH 18,B02,083749,Rideout; David Porter,5,0,36,31
1657635872961,MATH 18,B03,083750,Rideout; David Porter,3,0,37,34
1657635872961,MATH 18,B04,083751,Rideout; David Porter,6,0,36,30
1657635872961,MATH 18,B05,093473,Rideout; David Porter,6,0,36,30
1657635872961,MATH 18,B06,093474,Rideout; David Porter,6,0,36,30
1657635878986,MATH 20A,A01,083754,Zheng; Zequn,14,0,40,26
1657635885011,MATH 20B,A01,083756,Briones; Jor-el Thomas Caparas,4,0,36,32
1657635885011,MATH 20B,A02,083757,Briones; Jor-el Thomas Caparas,1,0,36,35
1657635885011,MATH 20B,A03,093475,Briones; Jor-el Thomas Caparas,2,0,36,34
1657635891036,MATH 20C,A01,083760,Briones; Jor-el Thomas Caparas,1,0,35,34
1657635891036,MATH 20C,A02,083761,Briones; Jor-el Thomas Caparas,8,0,35,27
1657635891036,MATH 20C,A03,093476,Briones; Jor-el Thomas Caparas,0,1,36,36
1657635891036,MATH 20C,B01,083762,Bach; Quang Tran,1,0,30,29
1657635897073,MATH 20D,A01,083765,Tran; Brian Kha,5,0,30,25
1657635897073,MATH 20D,A02,083766,Tran; Brian Kha,5,0,30,25
1657635897073,MATH 20D,A03,083767,Tran; Brian Kha,5,0,30,25
1657635903105,MATH 20E,A01,083771,Ganguly; Soumya,9,0,32,23
1657635903105,MATH 20E,A02,083772,Ganguly; Soumya,6,0,32,26
1657635903105,MATH 20E,B01,083773,Ciotti; Benjamin,20,0,35,15
1657635903105,MATH 20E,B02,083774,Ciotti; Benjamin,18,0,35,17
1657635909130,MATH 103A,A01,083777,Greenfeld; Be'Eri,3,0,36,33
1657635909130,MATH 103A,A02,083778,Greenfeld; Be'Eri,5,0,36,31
1657635909130,MATH 103A,A03,093561,Greenfeld; Be'Eri,6,0,36,30
1657635909130,MATH 103A,B01,083779,Greenfeld; Be'Eri,7,0,36,29
1657635909130,MATH 103A,B02,083780,Greenfeld; Be'Eri,4,0,36,32
1657635909130,MATH 103A,B03,093562,Greenfeld; Be'Eri,3,0,36,33
1657635915159,MATH 105,A01,085443,Carter; Anne Toulson,15,0,35,20
1657635915159,MATH 105,A02,093477,Carter; Anne Toulson,20,0,35,15
1657635921185,MATH 109,A01,083213,Ganzberger; Geoffrey Michael,2,0,34,32
1657635921185,MATH 109,A02,083214,Ganzberger; Geoffrey Michael,4,0,34,30
1657635921185,MATH 109,A03,093478,Ganzberger; Geoffrey Michael,2,0,34,32
1657635921185,MATH 109,B01,083215,Ganzberger; Geoffrey Michael,1,0,32,31
1657635921185,MATH 109,B02,083216,Ganzberger; Geoffrey Michael,2,0,32,30
1657635921185,MATH 109,B03,093479,Ganzberger; Geoffrey Michael,8,0,32,24
1657635927209,MATH 142A,A01,083219,Chow; Bennett,7,0,32,25
1657635927209,MATH 142A,A02,083220,Chow; Bennett,10,0,32,22
1657635927209,MATH 142A,A03,093480,Chow; Bennett,9,0,32,23
1657635927209,MATH 142A,B03,093481,Chow; Bennett,8,0,32,24
1657635927209,MATH 142A,B04,093558,Chow; Bennett,13,0,32,19
1657635927209,MATH 142A,B05,093559,Chow; Bennett,6,0,32,26
1657635933238,MATH 193A,A01,083224,Rotar; Vladimir,8,0,34,26
1657635933238,MATH 193A,A02,083225,Rotar; Vladimir,9,0,34,25
1657635933238,MATH 193A,A03,083781,Rotar; Vladimir,5,0,34,29
1657635933238,MATH 193A,A04,083782,Rotar; Vladimir,10,0,34,24
1657635933238,MATH 193A,A05,093482,Rotar; Vladimir,10,0,34,24
1657635939264,MATH 197,001,091859,McAuley; Julian John,9999,0,9999,0
1657635939264,MATH 197,002,095566,Kedlaya; Kiran S.,9997,0,9999,2
1657635939264,MATH 197,003,095567,Xiao; Ming,9999,0,9999,0
1657635939264,MATH 197,004,095571,Perols; Johan Lars,9998,0,9999,1
1657635946341,COGS 9,A01,083615,Shannon; Kyle Michael,9,0,75,66
1657635952365,COGS 11,A01,083617,Boyle; Mary E. T.,23,0,48,25
1657635958394,COGS 13,A01,083071,Bastos; Amalia Pinkusfeld,11,0,71,60
1657635964437,COGS 14A,A01,092681,Semenuks; Arturs,5,1,100,95
1657635970466,COGS 14B,A01,083073,Cheng; Tzu-Han,6,0,63,57
1657635976505,COGS 17,A01,092677,Semenuks; Arturs,6,0,81,75
1657635982535,COGS 100,A01,083619,Allen; Michael Gordon,17,0,70,53
1657635988564,COGS 101A,A01,083621,Davis; Joshua Daniel,9,0,68,59
1657635994588,COGS 101B,A01,091572,Allen; Michael Gordon,12,0,65,53
1657636000612,COGS 101C,A01,083625,Delgado; Tania,17,0,35,18
1657636006638,COGS 107A,A01,083627,Boyle; Mary E. T.,13,0,60,47
1657636012666,COGS 118A,A01,083075,Gupta; Anjum,21,0,76,55
1657636018691,CSE 3,A50,083646,Miranda; Gregory Joseph,24,0,50,26
1657636024714,CSE 8A,A50,083650,Miranda; Gregory Joseph,17,1,56,39
1657636030742,CSE 11,A01,083080,Cao; Yingjun,6,15,40,34
1657636036767,CSE 12,A01,083652,Krause-Levy; Sophia Louisa,28,1,120,92
1657636042796,CSE 15L,A01,083654,Morris; Justin Loren,9,0,50,41
1657636042796,CSE 15L,A02,083655,Morris; Justin Loren,9,0,50,41
1657636048820,CSE 20,A01,083657,Tran; Khoa Dang,39,0,80,41
1657636054844,CSE 21,A01,095574,Bach; Quang Tran,22,0,48,26
1657636060874,CSE 30,A01,083084,Eldon; John,6,0,80,74
1657636060874,CSE 30,B01,095061,Bhaskar; Nishant,9,0,50,41
1657636066899,CSE 100,A01,083659,Cao; Yingjun,5,4,70,65
1657636072923,CSE 134B,A01,083661,Powell; Thomas Allan,22,0,100,78
1657636078948,CSE 140,A01,083663,Gungor; Onat,15,0,85,70
1657636084974,CSE 140L,A01,083088,Eldon; John,21,0,100,79
1657636091000,CSE 175,A01,083665,Kumar; Rakesh,3,0,25,22
1657636097024,CSE 190,A00,092507,Dubnov; Shlomo,8,0,20,12
1657636103062,ECE 45,A01,083139,Congero; Spencer William,6,0,75,69
1657636109087,ECE 65,A50,083695,Saad; Andrew S,12,0,30,18
1657636109087,ECE 65,A51,095125,Saad; Andrew S,24,0,26,2
1657636115115,ECE 109,A01,091882,Touri; Behrouz,19,0,70,51
1657636121153,ECE 180,A00,083140,Abi Samra; Nicholas Camill,1,0,30,29
1657636121153,ECE 180,B00,083141,Abi Samra; Nicholas Camill,0,0,30,30
1657636127193,MATH 10A,A01,083735,Patchell; Gregory David,2,0,30,28
1657636127193,MATH 10A,A02,083736,Patchell; Gregory David,20,0,30,10
1657636127193,MATH 10A,A03,083737,Patchell; Gregory David,16,0,30,14
1657636133217,MATH 10B,A01,083207,Lim; Seonhee,8,0,34,26
1657636133217,MATH 10B,A02,083208,Lim; Seonhee,9,0,35,26
1657636133217,MATH 10B,A03,093472,Lim; Seonhee,7,0,34,27
1657636133217,MATH 10B,B01,083739,Sinha; Shubham,12,0,30,18
1657636139244,MATH 18,A01,083743,Cinel; Cameron Alexander,7,0,30,23
1657636139244,MATH 18,A02,083744,Cinel; Cameron Alexander,17,0,30,13
1657636139244,MATH 18,A03,083745,Cinel; Cameron Alexander,9,0,30,21
1657636139244,MATH 18,B01,083748,Rideout; David Porter,5,0,37,32
1657636139244,MATH 18,B02,083749,Rideout; David Porter,5,0,36,31
1657636139244,MATH 18,B03,083750,Rideout; David Porter,3,0,37,34
1657636139244,MATH 18,B04,083751,Rideout; David Porter,6,0,36,30
1657636139244,MATH 18,B05,093473,Rideout; David Porter,6,0,36,30
1657636139244,MATH 18,B06,093474,Rideout; David Porter,6,0,36,30
1657636145273,MATH 20A,A01,083754,Zheng; Zequn,14,0,40,26
1657636151303,MATH 20B,A01,083756,Briones; Jor-el Thomas Caparas,4,0,36,32
1657636151303,MATH 20B,A02,083757,Briones; Jor-el Thomas Caparas,1,0,36,35
1657636151303,MATH 20B,A03,093475,Briones; Jor-el Thomas Caparas,2,0,36,34
1657636157328,MATH 20C,A01,083760,Briones; Jor-el Thomas Caparas,1,0,35,34
1657636157328,MATH 20C,A02,083761,Briones; Jor-el Thomas Caparas,8,0,35,27
1657636157328,MATH 20C,A03,093476,Briones; Jor-el Thomas Caparas,0,1,36,36
1657636157328,MATH 20C,B01,083762,Bach; Quang Tran,1,0,30,29
1657636163354,MATH 20D,A01,083765,Tran; Brian Kha,5,0,30,25
1657636163354,MATH 20D,A02,083766,Tran; Brian Kha,5,0,30,25
1657636163354,MATH 20D,A03,083767,Tran; Brian Kha,5,0,30,25
1657636169379,MATH 20E,A01,083771,Ganguly; Soumya,9,0,32,23
1657636169379,MATH 20E,A02,083772,Ganguly; Soumya,6,0,32,26
1657636169379,MATH 20E,B01,083773,Ciotti; Benjamin,20,0,35,15
1657636169379,MATH 20E,B02,083774,Ciotti; Benjamin,18,0,35,17
1657636175411,MATH 103A,A01,083777,Greenfeld; Be'Eri,3,0,36,33
1657636175411,MATH 103A,A02,083778,Greenfeld; Be'Eri,5,0,36,31
1657636175411,MATH 103A,A03,093561,Greenfeld; Be'Eri,6,0,36,30
1657636175411,MATH 103A,B01,083779,Greenfeld; Be'Eri,7,0,36,29
1657636175411,MATH 103A,B02,083780,Greenfeld; Be'Eri,4,0,36,32
1657636175411,MATH 103A,B03,093562,Greenfeld; Be'Eri,3,0,36,33
1657636181436,MATH 105,A01,085443,Carter; Anne Toulson,15,0,35,20
1657636181436,MATH 105,A02,093477,Carter; Anne Toulson,20,0,35,15
1657636187468,MATH 109,A01,083213,Ganzberger; Geoffrey Michael,2,0,34,32
1657636187468,MATH 109,A02,083214,Ganzberger; Geoffrey Michael,4,0,34,30
1657636187468,MATH 109,A03,093478,Ganzberger; Geoffrey Michael,2,0,34,32
1657636187468,MATH 109,B01,083215,Ganzberger; Geoffrey Michael,1,0,32,31
1657636187468,MATH 109,B02,083216,Ganzberger; Geoffrey Michael,2,0,32,30
1657636187468,MATH 109,B03,093479,Ganzberger; Geoffrey Michael,8,0,32,24
1657636193492,MATH 142A,A01,083219,Chow; Bennett,7,0,32,25
1657636193492,MATH 142A,A02,083220,Chow; Bennett,10,0,32,22
1657636193492,MATH 142A,A03,093480,Chow; Bennett,9,0,32,23
1657636193492,MATH 142A,B03,093481,Chow; Bennett,8,0,32,24
1657636193492,MATH 142A,B04,093558,Chow; Bennett,13,0,32,19
1657636193492,MATH 142A,B05,093559,Chow; Bennett,6,0,32,26
1657636199516,MATH 193A,A01,083224,Rotar; Vladimir,8,0,34,26
1657636199516,MATH 193A,A02,083225,Rotar; Vladimir,9,0,34,25
1657636199516,MATH 193A,A03,083781,Rotar; Vladimir,5,0,34,29
1657636199516,MATH 193A,A04,083782,Rotar; Vladimir,10,0,34,24
1657636199516,MATH 193A,A05,093482,Rotar; Vladimir,10,0,34,24
1657636205543,MATH 197,001,091859,McAuley; Julian John,9999,0,9999,0
1657636205543,MATH 197,002,095566,Kedlaya; Kiran S.,9997,0,9999,2
1657636205543,MATH 197,003,095567,Xiao; Ming,9999,0,9999,0
1657636205543,MATH 197,004,095571,Perols; Johan Lars,9998,0,9999,1
1657636212603,COGS 9,A01,083615,Shannon; Kyle Michael,9,0,75,66
1657636218626,COGS 11,A01,083617,Boyle; Mary E. T.,23,0,48,25
1657636224653,COGS 13,A01,083071,Bastos; Amalia Pinkusfeld,11,0,71,60
1657636230680,COGS 14A,A01,092681,Semenuks; Arturs,5,1,100,95
1657636236704,COGS 14B,A01,083073,Cheng; Tzu-Han,6,0,63,57
1657636242728,COGS 17,A01,092677,Semenuks; Arturs,6,0,81,75
1657636248752,COGS 100,A01,083619,Allen; Michael Gordon,17,0,70,53
1657636254784,COGS 101A,A01,083621,Davis; Joshua Daniel,9,0,68,59
1657636260818,COGS 101B,A01,091572,Allen; Michael Gordon,12,0,65,53
1657636266843,COGS 101C,A01,083625,Delgado; Tania,17,0,35,18
1657636272866,COGS 107A,A01,083627,Boyle; Mary E. T.,13,0,60,47
1657636278895,COGS 118A,A01,083075,Gupta; Anjum,21,0,76,55
1657636284918,CSE 3,A50,083646,Miranda; Gregory Joseph,24,0,50,26
1657636290946,CSE 8A,A50,083650,Miranda; Gregory Joseph,17,1,56,39
1657636296974,CSE 11,A01,083080,Cao; Yingjun,6,15,40,34
1657636302998,CSE 12,A01,083652,Krause-Levy; Sophia Louisa,28,1,120,92
1657636309022,CSE 15L,A01,083654,Morris; Justin Loren,9,0,50,41
1657636309022,CSE 15L,A02,083655,Morris; Justin Loren,9,0,50,41
1657636315047,CSE 20,A01,083657,Tran; Khoa Dang,39,0,80,41
1657636321074,CSE 21,A01,095574,Bach; Quang Tran,22,0,48,26
1657636327103,CSE 30,A01,083084,Eldon; John,6,0,80,74
1657636327103,CSE 30,B01,095061,Bhaskar; Nishant,9,0,50,41
1657636333134,CSE 100,A01,083659,Cao; Yingjun,5,4,70,65
1657636339157,CSE 134B,A01,083661,Powell; Thomas Allan,22,0,100,78
1657636345183,CSE 140,A01,083663,Gungor; Onat,15,0,85,70
1657636351208,CSE 140L,A01,083088,Eldon; John,21,0,100,79
1657636357233,CSE 175,A01,083665,Kumar; Rakesh,3,0,25,22
1657636363359,CSE 190,A00,092507,Dubnov; Shlomo,8,0,20,12
1657636369389,ECE 45,A01,083139,Congero; Spencer William,6,0,75,69
1657636375413,ECE 65,A50,083695,Saad; Andrew S,12,0,30,18
1657636375413,ECE 65,A51,095125,Saad; Andrew S,24,0,26,2
1657636381438,ECE 109,A01,091882,Touri; Behrouz,19,0,70,51
1657636387467,ECE 180,A00,083140,Abi Samra; Nicholas Camill,1,0,30,29
1657636387467,ECE 180,B00,083141,Abi Samra; Nicholas Camill,0,0,30,30
1657636393510,MATH 10A,A01,083735,Patchell; Gregory David,2,0,30,28
1657636393510,MATH 10A,A02,083736,Patchell; Gregory David,20,0,30,10
1657636393510,MATH 10A,A03,083737,Patchell; Gregory David,16,0,30,14
1657636399536,MATH 10B,A01,083207,Lim; Seonhee,8,0,34,26
1657636399536,MATH 10B,A02,083208,Lim; Seonhee,9,0,35,26
1657636399536,MATH 10B,A03,093472,Lim; Seonhee,7,0,34,27
1657636399536,MATH 10B,B01,083739,Sinha; Shubham,12,0,30,18
1657636405562,MATH 18,A01,083743,Cinel; Cameron Alexander,7,0,30,23
1657636405562,MATH 18,A02,083744,Cinel; Cameron Alexander,17,0,30,13
1657636405562,MATH 18,A03,083745,Cinel; Cameron Alexander,9,0,30,21
1657636405562,MATH 18,B01,083748,Rideout; David Porter,5,0,37,32
1657636405562,MATH 18,B02,083749,Rideout; David Porter,5,0,36,31
1657636405562,MATH 18,B03,083750,Rideout; David Porter,3,0,37,34
1657636405562,MATH 18,B04,083751,Rideout; David Porter,6,0,36,30
1657636405562,MATH 18,B05,093473,Rideout; David Porter,6,0,36,30
1657636405562,MATH 18,B06,093474,Rideout; David Porter,6,0,36,30
1657636411590,MATH 20A,A01,083754,Zheng; Zequn,14,0,40,26
1657636417618,MATH 20B,A01,083756,Briones; Jor-el Thomas Caparas,4,0,36,32
1657636417618,MATH 20B,A02,083757,Briones; Jor-el Thomas Caparas,1,0,36,35
1657636417618,MATH 20B,A03,093475,Briones; Jor-el Thomas Caparas,2,0,36,34
1657636423643,MATH 20C,A01,083760,Briones; Jor-el Thomas Caparas,1,0,35,34
1657636423643,MATH 20C,A02,083761,Briones; Jor-el Thomas Caparas,8,0,35,27
1657636423643,MATH 20C,A03,093476,Briones; Jor-el Thomas Caparas,0,1,36,36
1657636423643,MATH 20C,B01,083762,Bach; Quang Tran,1,0,30,29
1657636429677,MATH 20D,A01,083765,Tran; Brian Kha,5,0,30,25
1657636429677,MATH 20D,A02,083766,Tran; Brian Kha,5,0,30,25
1657636429677,MATH 20D,A03,083767,Tran; Brian Kha,5,0,30,25
1657636435705,MATH 20E,A01,083771,Ganguly; Soumya,9,0,32,23
1657636435705,MATH 20E,A02,083772,Ganguly; Soumya,6,0,32,26
1657636435705,MATH 20E,B01,083773,Ciotti; Benjamin,20,0,35,15
1657636435705,MATH 20E,B02,083774,Ciotti; Benjamin,18,0,35,17
1657636441738,MATH 103A,A01,083777,Greenfeld; Be'Eri,3,0,36,33
1657636441738,MATH 103A,A02,083778,Greenfeld; Be'Eri,5,0,36,31
1657636441738,MATH 103A,A03,093561,Greenfeld; Be'Eri,6,0,36,30
1657636441738,MATH 103A,B01,083779,Greenfeld; Be'Eri,7,0,36,29
1657636441738,MATH 103A,B02,083780,Greenfeld; Be'Eri,4,0,36,32
1657636441738,MATH 103A,B03,093562,Greenfeld; Be'Eri,3,0,36,33
1657636447765,MATH 105,A01,085443,Carter; Anne Toulson,15,0,35,20
1657636447765,MATH 105,A02,093477,Carter; Anne Toulson,20,0,35,15
1657636453796,MATH 109,A01,083213,Ganzberger; Geoffrey Michael,2,0,34,32
1657636453796,MATH 109,A02,083214,Ganzberger; Geoffrey Michael,4,0,34,30
1657636453796,MATH 109,A03,093478,Ganzberger; Geoffrey Michael,2,0,34,32
1657636453796,MATH 109,B01,083215,Ganzberger; Geoffrey Michael,1,0,32,31
1657636453796,MATH 109,B02,083216,Ganzberger; Geoffrey Michael,2,0,32,30
1657636453796,MATH 109,B03,093479,Ganzberger; Geoffrey Michael,8,0,32,24
1657636459819,MATH 142A,A01,083219,Chow; Bennett,7,0,32,25
1657636459819,MATH 142A,A02,083220,Chow; Bennett,10,0,32,22
1657636459819,MATH 142A,A03,093480,Chow; Bennett,9,0,32,23
1657636459819,MATH 142A,B03,093481,Chow; Bennett,8,0,32,24
1657636459819,MATH 142A,B04,093558,Chow; Bennett,13,0,32,19
1657636459819,MATH 142A,B05,093559,Chow; Bennett,6,0,32,26
1657636465841,MATH 193A,A01,083224,Rotar; Vladimir,8,0,34,26
1657636465841,MATH 193A,A02,083225,Rotar; Vladimir,9,0,34,25
1657636465841,MATH 193A,A03,083781,Rotar; Vladimir,5,0,34,29
1657636465841,MATH 193A,A04,083782,Rotar; Vladimir,10,0,34,24
1657636465841,MATH 193A,A05,093482,Rotar; Vladimir,10,0,34,24
1657636471871,MATH 197,001,091859,McAuley; Julian John,9999,0,9999,0
1657636471871,MATH 197,002,095566,Kedlaya; Kiran S.,9997,0,9999,2
1657636471871,MATH 197,003,095567,Xiao; Ming,9999,0,9999,0
1657636471871,MATH 197,004,095571,Perols; Johan Lars,9998,0,9999,1
1657636478928,COGS 9,A01,083615,Shannon; Kyle Michael,9,0,75,66
1657636484954,COGS 11,A01,083617,Boyle; Mary E. T.,23,0,48,25
1657636490979,COGS 13,A01,083071,Bastos; Amalia Pinkusfeld,11,0,71,60
1657636497002,COGS 14A,A01,092681,Semenuks; Arturs,5,1,100,95
1657636503028,COGS 14B,A01,083073,Cheng; Tzu-Han,6,0,63,57
1657636509053,COGS 17,A01,092677,Semenuks; Arturs,6,0,81,75
1657636515076,COGS 100,A01,083619,Allen; Michael Gordon,17,0,70,53
1657636521104,COGS 101A,A01,083621,Davis; Joshua Daniel,9,0,68,59
1657636527132,COGS 101B,A01,091572,Allen; Michael Gordon,12,0,65,53
1657636533157,COGS 101C,A01,083625,Delgado; Tania,17,0,35,18
1657636539181,COGS 107A,A01,083627,Boyle; Mary E. T.,13,0,60,47
1657636545204,COGS 118A,A01,083075,Gupta; Anjum,21,0,76,55
1657636551227,CSE 3,A50,083646,Miranda; Gregory Joseph,24,0,50,26
1657636557255,CSE 8A,A50,083650,Miranda; Gregory Joseph,17,1,56,39
1657636563281,CSE 11,A01,083080,Cao; Yingjun,6,15,40,34
1657636569304,CSE 12,A01,083652,Krause-Levy; Sophia Louisa,28,1,120,92
1657636575331,CSE 15L,A01,083654,Morris; Justin Loren,9,0,50,41
1657636575331,CSE 15L,A02,083655,Morris; Justin Loren,9,0,50,41
1657636581368,CSE 20,A01,083657,Tran; Khoa Dang,39,0,80,41
1657636587405,CSE 21,A01,095574,Bach; Quang Tran,22,0,48,26
1657636593433,CSE 30,A01,083084,Eldon; John,6,0,80,74
1657636593433,CSE 30,B01,095061,Bhaskar; Nishant,9,0,50,41
1657636599471,CSE 100,A01,083659,Cao; Yingjun,5,4,70,65
1657636605495,CSE 134B,A01,083661,Powell; Thomas Allan,22,0,100,78
1657636611520,CSE 140,A01,083663,Gungor; Onat,15,0,85,70
1657636617550,CSE 140L,A01,083088,Eldon; John,21,0,100,79
1657636623574,CSE 175,A01,083665,Kumar; Rakesh,3,0,25,22
1657636629601,CSE 190,A00,092507,Dubnov; Shlomo,8,0,20,12
1657636635626,ECE 45,A01,083139,Congero; Spencer William,6,0,75,69
1657636641652,ECE 65,A50,083695,Saad; Andrew S,12,0,30,18
1657636641652,ECE 65,A51,095125,Saad; Andrew S,24,0,26,2
1657636647682,ECE 109,A01,091882,Touri; Behrouz,19,0,70,51
1657636653706,ECE 180,A00,083140,Abi Samra; Nicholas Camill,1,0,30,29
1657636653706,ECE 180,B00,083141,Abi Samra; Nicholas Camill,0,0,30,30
1657636659739,MATH 10A,A01,083735,Patchell; Gregory David,2,0,30,28
1657636659739,MATH 10A,A02,083736,Patchell; Gregory David,20,0,30,10
1657636659739,MATH 10A,A03,083737,Patchell; Gregory David,16,0,30,14
1657636665777,MATH 10B,A01,083207,Lim; Seonhee,8,0,34,26
1657636665777,MATH 10B,A02,083208,Lim; Seonhee,9,0,35,26
1657636665777,MATH 10B,A03,093472,Lim; Seonhee,7,0,34,27
1657636665777,MATH 10B,B01,083739,Sinha; Shubham,12,0,30,18
1657636671814,MATH 18,A01,083743,Cinel; Cameron Alexander,7,0,30,23
1657636671814,MATH 18,A02,083744,Cinel; Cameron Alexander,17,0,30,13
1657636671814,MATH 18,A03,083745,Cinel; Cameron Alexander,9,0,30,21
1657636671814,MATH 18,B01,083748,Rideout; David Porter,5,0,37,32
1657636671814,MATH 18,B02,083749,Rideout; David Porter,5,0,36,31
1657636671814,MATH 18,B03,083750,Rideout; David Porter,3,0,37,34
1657636671814,MATH 18,B04,083751,Rideout; David Porter,6,0,36,30
1657636671814,MATH 18,B05,093473,Rideout; David Porter,6,0,36,30
1657636671814,MATH 18,B06,093474,Rideout; David Porter,6,0,36,30
1657636677843,MATH 20A,A01,083754,Zheng; Zequn,14,0,40,26
1657636683870,MATH 20B,A01,083756,Briones; Jor-el Thomas Caparas,4,0,36,32
1657636683870,MATH 20B,A02,083757,Briones; Jor-el Thomas Caparas,1,0,36,35
1657636683870,MATH 20B,A03,093475,Briones; Jor-el Thomas Caparas,2,0,36,34
1657636689903,MATH 20C,A01,083760,Briones; Jor-el Thomas Caparas,1,0,35,34
1657636689903,MATH 20C,A02,083761,Briones; Jor-el Thomas Caparas,8,0,35,27
1657636689903,MATH 20C,A03,093476,Briones; Jor-el Thomas Caparas,0,1,36,36
1657636689903,MATH 20C,B01,083762,Bach; Quang Tran,1,0,30,29
1657636695926,MATH 20D,A01,083765,Tran; Brian Kha,5,0,30,25
1657636695926,MATH 20D,A02,083766,Tran; Brian Kha,5,0,30,25
1657636695926,MATH 20D,A03,083767,Tran; Brian Kha,5,0,30,25
1657636701959,MATH 20E,A01,083771,Ganguly; Soumya,9,0,32,23
1657636701959,MATH 20E,A02,083772,Ganguly; Soumya,6,0,32,26
1657636701959,MATH 20E,B01,083773,Ciotti; Benjamin,20,0,35,15
1657636701959,MATH 20E,B02,083774,Ciotti; Benjamin,18,0,35,17
1657636707996,MATH 103A,A01,083777,Greenfeld; Be'Eri,3,0,36,33
1657636707996,MATH 103A,A02,083778,Greenfeld; Be'Eri,5,0,36,31
1657636707996,MATH 103A,A03,093561,Greenfeld; Be'Eri,6,0,36,30
1657636707996,MATH 103A,B01,083779,Greenfeld; Be'Eri,7,0,36,29
1657636707996,MATH 103A,B02,083780,Greenfeld; Be'Eri,4,0,36,32
1657636707996,MATH 103A,B03,093562,Greenfeld; Be'Eri,3,0,36,33
1657636714027,MATH 105,A01,085443,Carter; Anne Toulson,15,0,35,20
1657636714027,MATH 105,A02,093477,Carter; Anne Toulson,20,0,35,15
1657636720059,MATH 109,A01,083213,Ganzberger; Geoffrey Michael,2,0,34,32
1657636720059,MATH 109,A02,083214,Ganzberger; Geoffrey Michael,4,0,34,30
1657636720059,MATH 109,A03,093478,Ganzberger; Geoffrey Michael,2,0,34,32
1657636720059,MATH 109,B01,083215,Ganzberger; Geoffrey Michael,1,0,32,31
1657636720059,MATH 109,B02,083216,Ganzberger; Geoffrey Michael,2,0,32,30
1657636720059,MATH 109,B03,093479,Ganzberger; Geoffrey Michael,8,0,32,24
1657636726103,MATH 142A,A01,083219,Chow; Bennett,7,0,32,25
1657636726103,MATH 142A,A02,083220,Chow; Bennett,10,0,32,22
1657636726103,MATH 142A,A03,093480,Chow; Bennett,9,0,32,23
1657636726103,MATH 142A,B03,093481,Chow; Bennett,8,0,32,24
1657636726103,MATH 142A,B04,093558,Chow; Bennett,13,0,32,19
1657636726103,MATH 142A,B05,093559,Chow; Bennett,6,0,32,26
1657636732134,MATH 193A,A01,083224,Rotar; Vladimir,8,0,34,26
1657636732134,MATH 193A,A02,083225,Rotar; Vladimir,9,0,34,25
1657636732134,MATH 193A,A03,083781,Rotar; Vladimir,5,0,34,29
1657636732134,MATH 193A,A04,083782,Rotar; Vladimir,10,0,34,24
1657636732134,MATH 193A,A05,093482,Rotar; Vladimir,10,0,34,24
1657636738163,MATH 197,001,091859,McAuley; Julian John,9999,0,9999,0
1657636738163,MATH 197,002,095566,Kedlaya; Kiran S.,9997,0,9999,2
1657636738163,MATH 197,003,095567,Xiao; Ming,9999,0,9999,0
1657636738163,MATH 197,004,095571,Perols; Johan Lars,9998,0,9999,1
1657636745228,COGS 9,A01,083615,Shannon; Kyle Michael,9,0,75,66
1657636751257,COGS 11,A01,083617,Boyle; Mary E. T.,23,0,48,25
1657636757282,COGS 13,A01,083071,Bastos; Amalia Pinkusfeld,11,0,71,60
1657636763309,COGS 14A,A01,092681,Semenuks; Arturs,5,1,100,95
1657636769340,COGS 14B,A01,083073,Cheng; Tzu-Han,6,0,63,57
1657636775365,COGS 17,A01,092677,Semenuks; Arturs,6,0,81,75
1657636781394,COGS 100,A01,083619,Allen; Michael Gordon,17,0,70,53
1657636787418,COGS 101A,A01,083621,Davis; Joshua Daniel,9,0,68,59
1657636793459,COGS 101B,A01,091572,Allen; Michael Gordon,12,0,65,53
1657636799483,COGS 101C,A01,083625,Delgado; Tania,17,0,35,18
1657636805510,COGS 107A,A01,083627,Boyle; Mary E. T.,13,0,60,47
1657636811539,COGS 118A,A01,083075,Gupta; Anjum,21,0,76,55
1657636817564,CSE 3,A50,083646,Miranda; Gregory Joseph,24,0,50,26
1657636823597,CSE 8A,A50,083650,Miranda; Gregory Joseph,17,1,56,39
1657636829625,CSE 11,A01,083080,Cao; Yingjun,6,15,40,34
1657636835650,CSE 12,A01,083652,Krause-Levy; Sophia Louisa,28,1,120,92
1657636841674,CSE 15L,A01,083654,Morris; Justin Loren,9,0,50,41
1657636841674,CSE 15L,A02,083655,Morris; Justin Loren,9,0,50,41
1657636847697,CSE 20,A01,083657,Tran; Khoa Dang,39,0,80,41
1657636853737,CSE 21,A01,095574,Bach; Quang Tran,22,0,48,26
1657636859764,CSE 30,A01,083084,Eldon; John,6,0,80,74
1657636859764,CSE 30,B01,095061,Bhaskar; Nishant,9,0,50,41
1657636865796,CSE 100,A01,083659,Cao; Yingjun,5,4,70,65
1657636871819,CSE 134B,A01,083661,Powell; Thomas Allan,22,0,100,78
1657636877852,CSE 140,A01,083663,Gungor; Onat,15,0,85,70
1657636883882,CSE 140L,A01,083088,Eldon; John,21,0,100,79
1657636889909,CSE 175,A01,083665,Kumar; Rakesh,3,0,25,22
1657636895934,CSE 190,A00,092507,Dubnov; Shlomo,8,0,20,12
1657636901961,ECE 45,A01,083139,Congero; Spencer William,6,0,75,69
1657636907990,ECE 65,A50,083695,Saad; Andrew S,12,0,30,18
1657636907990,ECE 65,A51,095125,Saad; Andrew S,24,0,26,2
1657636914023,ECE 109,A01,091882,Touri; Behrouz,19,0,70,51
1657636920051,ECE 180,A00,083140,Abi Samra; Nicholas Camill,1,0,30,29
1657636920051,ECE 180,B00,083141,Abi Samra; Nicholas Camill,0,0,30,30
1657636926080,MATH 10A,A01,083735,Patchell; Gregory David,2,0,30,28
1657636926080,MATH 10A,A02,083736,Patchell; Gregory David,20,0,30,10
1657636926080,MATH 10A,A03,083737,Patchell; Gregory David,16,0,30,14
1657636932105,MATH 10B,A01,083207,Lim; Seonhee,8,0,34,26
1657636932105,MATH 10B,A02,083208,Lim; Seonhee,9,0,35,26
1657636932105,MATH 10B,A03,093472,Lim; Seonhee,7,0,34,27
1657636932105,MATH 10B,B01,083739,Sinha; Shubham,12,0,30,18
1657636938151,MATH 18,A01,083743,Cinel; Cameron Alexander,7,0,30,23
1657636938151,MATH 18,A02,083744,Cinel; Cameron Alexander,17,0,30,13
1657636938151,MATH 18,A03,083745,Cinel; Cameron Alexander,9,0,30,21
1657636938151,MATH 18,B01,083748,Rideout; David Porter,5,0,37,32
1657636938151,MATH 18,B02,083749,Rideout; David Porter,5,0,36,31
1657636938151,MATH 18,B03,083750,Rideout; David Porter,3,0,37,34
1657636938151,MATH 18,B04,083751,Rideout; David Porter,6,0,36,30
1657636938151,MATH 18,B05,093473,Rideout; David Porter,6,0,36,30
1657636938151,MATH 18,B06,093474,Rideout; David Porter,6,0,36,30
1657636944176,MATH 20A,A01,083754,Zheng; Zequn,14,0,40,26
1657636950210,MATH 20B,A01,083756,Briones; Jor-el Thomas Caparas,4,0,36,32
1657636950210,MATH 20B,A02,083757,Briones; Jor-el Thomas Caparas,1,0,36,35
1657636950210,MATH 20B,A03,093475,Briones; Jor-el Thomas Caparas,2,0,36,34
1657636956236,MATH 20C,A01,083760,Briones; Jor-el Thomas Caparas,1,0,35,34
1657636956236,MATH 20C,A02,083761,Briones; Jor-el Thomas Caparas,8,0,35,27
1657636956236,MATH 20C,A03,093476,Briones; Jor-el Thomas Caparas,0,1,36,36
1657636956236,MATH 20C,B01,083762,Bach; Quang Tran,1,0,30,29
1657636962355,MATH 20D,A01,083765,Tran; Brian Kha,5,0,30,25
1657636962355,MATH 20D,A02,083766,Tran; Brian Kha,5,0,30,25
1657636962355,MATH 20D,A03,083767,Tran; Brian Kha,5,0,30,25
1657636968384,MATH 20E,A01,083771,Ganguly; Soumya,9,0,32,23
1657636968384,MATH 20E,A02,083772,Ganguly; Soumya,6,0,32,26
1657636968384,MATH 20E,B01,083773,Ciotti; Benjamin,20,0,35,15
1657636968384,MATH 20E,B02,083774,Ciotti; Benjamin,18,0,35,17
1657636974413,MATH 103A,A01,083777,Greenfeld; Be'Eri,3,0,36,33
1657636974413,MATH 103A,A02,083778,Greenfeld; Be'Eri,5,0,36,31
1657636974413,MATH 103A,A03,093561,Greenfeld; Be'Eri,6,0,36,30
1657636974413,MATH 103A,B01,083779,Greenfeld; Be'Eri,7,0,36,29
1657636974413,MATH 103A,B02,083780,Greenfeld; Be'Eri,4,0,36,32
1657636974413,MATH 103A,B03,093562,Greenfeld; Be'Eri,3,0,36,33
1657636980442,MATH 105,A01,085443,Carter; Anne Toulson,15,0,35,20
1657636980442,MATH 105,A02,093477,Carter; Anne Toulson,20,0,35,15
1657636986479,MATH 109,A01,083213,Ganzberger; Geoffrey Michael,2,0,34,32
1657636986479,MATH 109,A02,083214,Ganzberger; Geoffrey Michael,4,0,34,30
1657636986479,MATH 109,A03,093478,Ganzberger; Geoffrey Michael,2,0,34,32
1657636986479,MATH 109,B01,083215,Ganzberger; Geoffrey Michael,1,0,32,31
1657636986479,MATH 109,B02,083216,Ganzberger; Geoffrey Michael,2,0,32,30
1657636986479,MATH 109,B03,093479,Ganzberger; Geoffrey Michael,8,0,32,24
1657636992520,MATH 142A,A01,083219,Chow; Bennett,7,0,32,25
1657636992520,MATH 142A,A02,083220,Chow; Bennett,10,0,32,22
1657636992520,MATH 142A,A03,093480,Chow; Bennett,9,0,32,23
1657636992520,MATH 142A,B03,093481,Chow; Bennett,8,0,32,24
1657636992520,MATH 142A,B04,093558,Chow; Bennett,13,0,32,19
1657636992520,MATH 142A,B05,093559,Chow; Bennett,6,0,32,26
1657636998571,MATH 193A,A01,083224,Rotar; Vladimir,8,0,34,26
1657636998571,MATH 193A,A02,083225,Rotar; Vladimir,9,0,34,25
1657636998571,MATH 193A,A03,083781,Rotar; Vladimir,5,0,34,29
1657636998571,MATH 193A,A04,083782,Rotar; Vladimir,10,0,34,24
1657636998571,MATH 193A,A05,093482,Rotar; Vladimir,10,0,34,24
1657637004595,MATH 197,001,091859,McAuley; Julian John,9999,0,9999,0
1657637004595,MATH 197,002,095566,Kedlaya; Kiran S.,9997,0,9999,2
1657637004595,MATH 197,003,095567,Xiao; Ming,9999,0,9999,0
1657637004595,MATH 197,004,095571,Perols; Johan Lars,9998,0,9999,1
1657637011664,COGS 9,A01,083615,Shannon; Kyle Michael,9,0,75,66
1657637017702,COGS 11,A01,083617,Boyle; Mary E. T.,23,0,48,25
1657637023726,COGS 13,A01,083071,Bastos; Amalia Pinkusfeld,11,0,71,60
1657637029755,COGS 14A,A01,092681,Semenuks; Arturs,5,1,100,95
1657637035785,COGS 14B,A01,083073,Cheng; Tzu-Han,6,0,63,57
1657637041826,COGS 17,A01,092677,Semenuks; Arturs,6,0,81,75
1657637047849,COGS 100,A01,083619,Allen; Michael Gordon,17,0,70,53
1657637053875,COGS 101A,A01,083621,Davis; Joshua Daniel,9,0,68,59
1657637059903,COGS 101B,A01,091572,Allen; Michael Gordon,12,0,65,53
1657637065932,COGS 101C,A01,083625,Delgado; Tania,17,0,35,18
1657637071960,COGS 107A,A01,083627,Boyle; Mary E. T.,13,0,60,47
1657637077994,COGS 118A,A01,083075,Gupta; Anjum,21,0,76,55
1657637084021,CSE 3,A50,083646,Miranda; Gregory Joseph,24,0,50,26
1657637090045,CSE 8A,A50,083650,Miranda; Gregory Joseph,17,1,56,39
1657637096082,CSE 11,A01,083080,Cao; Yingjun,6,15,40,34
1657637102116,CSE 12,A01,083652,Krause-Levy; Sophia Louisa,28,1,120,92
1657637108145,CSE 15L,A01,083654,Morris; Justin Loren,9,0,50,41
1657637108145,CSE 15L,A02,083655,Morris; Justin Loren,9,0,50,41
1657637114176,CSE 20,A01,083657,Tran; Khoa Dang,39,0,80,41
1657637120206,CSE 21,A01,095574,Bach; Quang Tran,22,0,48,26
1657637126238,CSE 30,A01,083084,Eldon; John,6,0,80,74
1657637126238,CSE 30,B01,095061,Bhaskar; Nishant,9,0,50,41
1657637132268,CSE 100,A01,083659,Cao; Yingjun,5,4,70,65
1657637138299,CSE 134B,A01,083661,Powell; Thomas Allan,22,0,100,78
1657637144322,CSE 140,A01,083663,Gungor; Onat,15,0,85,70
1657637150347,CSE 140L,A01,083088,Eldon; John,21,0,100,79
1657637156377,CSE 175,A01,083665,Kumar; Rakesh,3,0,25,22
1657637162408,CSE 190,A00,092507,Dubnov; Shlomo,8,0,20,12
1657637168439,ECE 45,A01,083139,Congero; Spencer William,6,0,75,69
1657637174470,ECE 65,A50,083695,Saad; Andrew S,12,0,30,18
1657637174470,ECE 65,A51,095125,Saad; Andrew S,24,0,26,2
1657637180500,ECE 109,A01,091882,Touri; Behrouz,19,0,70,51
1657637186525,ECE 180,A00,083140,Abi Samra; Nicholas Camill,1,0,30,29
1657637186525,ECE 180,B00,083141,Abi Samra; Nicholas Camill,0,0,30,30
1657637192552,MATH 10A,A01,083735,Patchell; Gregory David,2,0,30,28
1657637192552,MATH 10A,A02,083736,Patchell; Gregory David,20,0,30,10
1657637192552,MATH 10A,A03,083737,Patchell; Gregory David,16,0,30,14
1657637198580,MATH 10B,A01,083207,Lim; Seonhee,8,0,34,26
1657637198580,MATH 10B,A02,083208,Lim; Seonhee,9,0,35,26
1657637198580,MATH 10B,A03,093472,Lim; Seonhee,7,0,34,27
1657637198580,MATH 10B,B01,083739,Sinha; Shubham,12,0,30,18
1657637204616,MATH 18,A01,083743,Cinel; Cameron Alexander,7,0,30,23
1657637204616,MATH 18,A02,083744,Cinel; Cameron Alexander,17,0,30,13
1657637204616,MATH 18,A03,083745,Cinel; Cameron Alexander,9,0,30,21
1657637204616,MATH 18,B01,083748,Rideout; David Porter,5,0,37,32
1657637204616,MATH 18,B02,083749,Rideout; David Porter,5,0,36,31
1657637204616,MATH 18,B03,083750,Rideout; David Porter,3,0,37,34
1657637204616,MATH 18,B04,083751,Rideout; David Porter,6,0,36,30
1657637204616,MATH 18,B05,093473,Rideout; David Porter,6,0,36,30
1657637204616,MATH 18,B06,093474,Rideout; David Porter,6,0,36,30
1657637210646,MATH 20A,A01,083754,Zheng; Zequn,14,0,40,26
1657637216671,MATH 20B,A01,083756,Briones; Jor-el Thomas Caparas,4,0,36,32
1657637216671,MATH 20B,A02,083757,Briones; Jor-el Thomas Caparas,1,0,36,35
1657637216671,MATH 20B,A03,093475,Briones; Jor-el Thomas Caparas,2,0,36,34
1657637222696,MATH 20C,A01,083760,Briones; Jor-el Thomas Caparas,1,0,35,34
1657637222696,MATH 20C,A02,083761,Briones; Jor-el Thomas Caparas,8,0,35,27
1657637222696,MATH 20C,A03,093476,Briones; Jor-el Thomas Caparas,0,1,36,36
1657637222696,MATH 20C,B01,083762,Bach; Quang Tran,1,0,30,29
1657637228728,MATH 20D,A01,083765,Tran; Brian Kha,5,0,30,25
1657637228728,MATH 20D,A02,083766,Tran; Brian Kha,5,0,30,25
1657637228728,MATH 20D,A03,083767,Tran; Brian Kha,5,0,30,25
1657637234760,MATH 20E,A01,083771,Ganguly; Soumya,9,0,32,23
1657637234760,MATH 20E,A02,083772,Ganguly; Soumya,6,0,32,26
1657637234760,MATH 20E,B01,083773,Ciotti; Benjamin,20,0,35,15
1657637234760,MATH 20E,B02,083774,Ciotti; Benjamin,18,0,35,17
1657637240787,MATH 103A,A01,083777,Greenfeld; Be'Eri,3,0,36,33
1657637240787,MATH 103A,A02,083778,Greenfeld; Be'Eri,5,0,36,31
1657637240787,MATH 103A,A03,093561,Greenfeld; Be'Eri,6,0,36,30
1657637240787,MATH 103A,B01,083779,Greenfeld; Be'Eri,7,0,36,29
1657637240787,MATH 103A,B02,083780,Greenfeld; Be'Eri,4,0,36,32
1657637240787,MATH 103A,B03,093562,Greenfeld; Be'Eri,3,0,36,33
1657637246813,MATH 105,A01,085443,Carter; Anne Toulson,15,0,35,20
1657637246813,MATH 105,A02,093477,Carter; Anne Toulson,20,0,35,15
1657637252846,MATH 109,A01,083213,Ganzberger; Geoffrey Michael,2,0,34,32
1657637252846,MATH 109,A02,083214,Ganzberger; Geoffrey Michael,4,0,34,30
1657637252846,MATH 109,A03,093478,Ganzberger; Geoffrey Michael,2,0,34,32
1657637252846,MATH 109,B01,083215,Ganzberger; Geoffrey Michael,1,0,32,31
1657637252846,MATH 109,B02,083216,Ganzberger; Geoffrey Michael,2,0,32,30
1657637252846,MATH 109,B03,093479,Ganzberger; Geoffrey Michael,8,0,32,24
1657637258878,MATH 142A,A01,083219,Chow; Bennett,7,0,32,25
1657637258878,MATH 142A,A02,083220,Chow; Bennett,10,0,32,22
1657637258878,MATH 142A,A03,093480,Chow; Bennett,9,0,32,23
1657637258878,MATH 142A,B03,093481,Chow; Bennett,8,0,32,24
1657637258878,MATH 142A,B04,093558,Chow; Bennett,13,0,32,19
1657637258878,MATH 142A,B05,093559,Chow; Bennett,6,0,32,26
1657637264904,MATH 193A,A01,083224,Rotar; Vladimir,8,0,34,26
1657637264904,MATH 193A,A02,083225,Rotar; Vladimir,9,0,34,25
1657637264904,MATH 193A,A03,083781,Rotar; Vladimir,5,0,34,29
1657637264904,MATH 193A,A04,083782,Rotar; Vladimir,10,0,34,24
1657637264904,MATH 193A,A05,093482,Rotar; Vladimir,10,0,34,24
1657637270930,MATH 197,001,091859,McAuley; Julian John,9999,0,9999,0
1657637270930,MATH 197,002,095566,Kedlaya; Kiran S.,9997,0,9999,2
1657637270930,MATH 197,003,095567,Xiao; Ming,9999,0,9999,0
1657637270930,MATH 197,004,095571,Perols; Johan Lars,9998,0,9999,1
1657637277993,COGS 9,A01,083615,Shannon; Kyle Michael,9,0,75,66
1657637284019,COGS 11,A01,083617,Boyle; Mary E. T.,23,0,48,25
1657637290048,COGS 13,A01,083071,Bastos; Amalia Pinkusfeld,11,0,71,60
1657637296077,COGS 14A,A01,092681,Semenuks; Arturs,5,1,100,95
1657637302111,COGS 14B,A01,083073,Cheng; Tzu-Han,6,0,63,57
1657637308140,COGS 17,A01,092677,Semenuks; Arturs,6,0,81,75
1657637314176,COGS 100,A01,083619,Allen; Michael Gordon,17,0,70,53
1657637320229,COGS 101A,A01,083621,Davis; Joshua Daniel,9,0,68,59
1657637326256,COGS 101B,A01,091572,Allen; Michael Gordon,12,0,65,53
1657637332285,COGS 101C,A01,083625,Delgado; Tania,17,0,35,18
1657637338310,COGS 107A,A01,083627,Boyle; Mary E. T.,13,0,60,47
1657637344344,COGS 118A,A01,083075,Gupta; Anjum,21,0,76,55
1657637350371,CSE 3,A50,083646,Miranda; Gregory Joseph,24,0,50,26
1657637356397,CSE 8A,A50,083650,Miranda; Gregory Joseph,17,1,56,39
1657637362420,CSE 11,A01,083080,Cao; Yingjun,6,15,40,34
1657637368453,CSE 12,A01,083652,Krause-Levy; Sophia Louisa,28,1,120,92
1657637374481,CSE 15L,A01,083654,Morris; Justin Loren,9,0,50,41
1657637374481,CSE 15L,A02,083655,Morris; Justin Loren,9,0,50,41
1657637380506,CSE 20,A01,083657,Tran; Khoa Dang,39,0,80,41
1657637386529,CSE 21,A01,095574,Bach; Quang Tran,22,0,48,26
1657637392560,CSE 30,A01,083084,Eldon; John,6,0,80,74
1657637392560,CSE 30,B01,095061,Bhaskar; Nishant,9,0,50,41
1657637398584,CSE 100,A01,083659,Cao; Yingjun,5,4,70,65
1657637404612,CSE 134B,A01,083661,Powell; Thomas Allan,22,0,100,78
1657637410636,CSE 140,A01,083663,Gungor; Onat,15,0,85,70
1657637416660,CSE 140L,A01,083088,Eldon; John,21,0,100,79
1657637422690,CSE 175,A01,083665,Kumar; Rakesh,3,0,25,22
1657637428719,CSE 190,A00,092507,Dubnov; Shlomo,8,0,20,12
1657637434743,ECE 45,A01,083139,Congero; Spencer William,6,0,75,69
1657637440774,ECE 65,A50,083695,Saad; Andrew S,12,0,30,18
1657637440774,ECE 65,A51,095125,Saad; Andrew S,24,0,26,2
1657637446799,ECE 109,A01,091882,Touri; Behrouz,19,0,70,51
1657637452844,ECE 180,A00,083140,Abi Samra; Nicholas Camill,1,0,30,29
1657637452844,ECE 180,B00,083141,Abi Samra; Nicholas Camill,0,0,30,30
1657637458874,MATH 10A,A01,083735,Patchell; Gregory David,2,0,30,28
1657637458874,MATH 10A,A02,083736,Patchell; Gregory David,20,0,30,10
1657637458874,MATH 10A,A03,083737,Patchell; Gregory David,16,0,30,14
1657637464900,MATH 10B,A01,083207,Lim; Seonhee,8,0,34,26
1657637464900,MATH 10B,A02,083208,Lim; Seonhee,9,0,35,26
1657637464900,MATH 10B,A03,093472,Lim; Seonhee,7,0,34,27
1657637464900,MATH 10B,B01,083739,Sinha; Shubham,12,0,30,18
1657637470929,MATH 18,A01,083743,Cinel; Cameron Alexander,7,0,30,23
1657637470929,MATH 18,A02,083744,Cinel; Cameron Alexander,17,0,30,13
1657637470929,MATH 18,A03,083745,Cinel; Cameron Alexander,9,0,30,21
1657637470929,MATH 18,B01,083748,Rideout; David Porter,5,0,37,32
1657637470929,MATH 18,B02,083749,Rideout; David Porter,5,0,36,31
1657637470929,MATH 18,B03,083750,Rideout; David Porter,3,0,37,34
1657637470929,MATH 18,B04,083751,Rideout; David Porter,6,0,36,30
1657637470929,MATH 18,B05,093473,Rideout; David Porter,6,0,36,30
1657637470929,MATH 18,B06,093474,Rideout; David Porter,6,0,36,30
1657637476959,MATH 20A,A01,083754,Zheng; Zequn,14,0,40,26
1657637482989,MATH 20B,A01,083756,Briones; Jor-el Thomas Caparas,4,0,36,32
1657637482989,MATH 20B,A02,083757,Briones; Jor-el Thomas Caparas,1,0,36,35
1657637482989,MATH 20B,A03,093475,Briones; Jor-el Thomas Caparas,2,0,36,34
1657637489019,MATH 20C,A01,083760,Briones; Jor-el Thomas Caparas,1,0,35,34
1657637489019,MATH 20C,A02,083761,Briones; Jor-el Thomas Caparas,8,0,35,27
1657637489019,MATH 20C,A03,093476,Briones; Jor-el Thomas Caparas,0,1,36,36
1657637489019,MATH 20C,B01,083762,Bach; Quang Tran,1,0,30,29
1657637495044,MATH 20D,A01,083765,Tran; Brian Kha,5,0,30,25
1657637495044,MATH 20D,A02,083766,Tran; Brian Kha,5,0,30,25
1657637495044,MATH 20D,A03,083767,Tran; Brian Kha,5,0,30,25
1657637501070,MATH 20E,A01,083771,Ganguly; Soumya,9,0,32,23
1657637501070,MATH 20E,A02,083772,Ganguly; Soumya,6,0,32,26
1657637501070,MATH 20E,B01,083773,Ciotti; Benjamin,20,0,35,15
1657637501070,MATH 20E,B02,083774,Ciotti; Benjamin,18,0,35,17
1657637507099,MATH 103A,A01,083777,Greenfeld; Be'Eri,3,0,36,33
1657637507099,MATH 103A,A02,083778,Greenfeld; Be'Eri,5,0,36,31
1657637507099,MATH 103A,A03,093561,Greenfeld; Be'Eri,6,0,36,30
1657637507099,MATH 103A,B01,083779,Greenfeld; Be'Eri,7,0,36,29
1657637507099,MATH 103A,B02,083780,Greenfeld; Be'Eri,4,0,36,32
1657637507099,MATH 103A,B03,093562,Greenfeld; Be'Eri,3,0,36,33
1657637513124,MATH 105,A01,085443,Carter; Anne Toulson,15,0,35,20
1657637513124,MATH 105,A02,093477,Carter; Anne Toulson,20,0,35,15
1657637519157,MATH 109,A01,083213,Ganzberger; Geoffrey Michael,2,0,34,32
1657637519157,MATH 109,A02,083214,Ganzberger; Geoffrey Michael,4,0,34,30
1657637519157,MATH 109,A03,093478,Ganzberger; Geoffrey Michael,2,0,34,32
1657637519157,MATH 109,B01,083215,Ganzberger; Geoffrey Michael,1,0,32,31
1657637519157,MATH 109,B02,083216,Ganzberger; Geoffrey Michael,2,0,32,30
1657637519157,MATH 109,B03,093479,Ganzberger; Geoffrey Michael,8,0,32,24
1657637525189,MATH 142A,A01,083219,Chow; Bennett,7,0,32,25
1657637525189,MATH 142A,A02,083220,Chow; Bennett,10,0,32,22
1657637525189,MATH 142A,A03,093480,Chow; Bennett,9,0,32,23
1657637525189,MATH 142A,B03,093481,Chow; Bennett,8,0,32,24
1657637525189,MATH 142A,B04,093558,Chow; Bennett,13,0,32,19
1657637525189,MATH 142A,B05,093559,Chow; Bennett,6,0,32,26
1657637531219,MATH 193A,A01,083224,Rotar; Vladimir,8,0,34,26
1657637531219,MATH 193A,A02,083225,Rotar; Vladimir,9,0,34,25
1657637531219,MATH 193A,A03,083781,Rotar; Vladimir,5,0,34,29
1657637531219,MATH 193A,A04,083782,Rotar; Vladimir,10,0,34,24
1657637531219,MATH 193A,A05,093482,Rotar; Vladimir,10,0,34,24
1657637537251,MATH 197,001,091859,McAuley; Julian John,9999,0,9999,0
1657637537251,MATH 197,002,095566,Kedlaya; Kiran S.,9997,0,9999,2
1657637537251,MATH 197,003,095567,Xiao; Ming,9999,0,9999,0
1657637537251,MATH 197,004,095571,Perols; Johan Lars,9998,0,9999,1
1657637544308,COGS 9,A01,083615,Shannon; Kyle Michael,9,0,75,66
1657637550333,COGS 11,A01,083617,Boyle; Mary E. T.,23,0,48,25
1657637556429,COGS 13,A01,083071,Bastos; Amalia Pinkusfeld,11,0,71,60
1657637562455,COGS 14A,A01,092681,Semenuks; Arturs,5,1,100,95
1657637568485,COGS 14B,A01,083073,Cheng; Tzu-Han,6,0,63,57
1657637574511,COGS 17,A01,092677,Semenuks; Arturs,6,0,81,75
1657637580536,COGS 100,A01,083619,Allen; Michael Gordon,17,0,70,53
1657637586569,COGS 101A,A01,083621,Davis; Joshua Daniel,9,0,68,59
1657637592597,COGS 101B,A01,091572,Allen; Michael Gordon,12,0,65,53
1657637598622,COGS 101C,A01,083625,Delgado; Tania,17,0,35,18
1657637604651,COGS 107A,A01,083627,Boyle; Mary E. T.,13,0,60,47
1657637610674,COGS 118A,A01,083075,Gupta; Anjum,21,0,76,55
1657637616702,CSE 3,A50,083646,Miranda; Gregory Joseph,24,0,50,26
1657637622730,CSE 8A,A50,083650,Miranda; Gregory Joseph,17,1,56,39
1657637628753,CSE 11,A01,083080,Cao; Yingjun,6,15,40,34
1657637634788,CSE 12,A01,083652,Krause-Levy; Sophia Louisa,28,1,120,92
1657637640815,CSE 15L,A01,083654,Morris; Justin Loren,9,0,50,41
1657637640815,CSE 15L,A02,083655,Morris; Justin Loren,9,0,50,41
1657637646843,CSE 20,A01,083657,Tran; Khoa Dang,39,0,80,41
1657637652867,CSE 21,A01,095574,Bach; Quang Tran,22,0,48,26
1657637658895,CSE 30,A01,083084,Eldon; John,6,0,80,74
1657637658895,CSE 30,B01,095061,Bhaskar; Nishant,9,0,50,41
1657637664922,CSE 100,A01,083659,Cao; Yingjun,5,4,70,65
1657637670944,CSE 134B,A01,083661,Powell; Thomas Allan,22,0,100,78
1657637676967,CSE 140,A01,083663,Gungor; Onat,15,0,85,70
1657637682995,CSE 140L,A01,083088,Eldon; John,21,0,100,79
1657637689019,CSE 175,A01,083665,Kumar; Rakesh,3,0,25,22
1657637695043,CSE 190,A00,092507,Dubnov; Shlomo,8,0,20,12
1657637701073,ECE 45,A01,083139,Congero; Spencer William,6,0,75,69
1657637707100,ECE 65,A50,083695,Saad; Andrew S,12,0,30,18
1657637707100,ECE 65,A51,095125,Saad; Andrew S,24,0,26,2
1657637713133,ECE 109,A01,091882,Touri; Behrouz,19,0,70,51
1657637719157,ECE 180,A00,083140,Abi Samra; Nicholas Camill,1,0,30,29
1657637719157,ECE 180,B00,083141,Abi Samra; Nicholas Camill,0,0,30,30
1657637725187,MATH 10A,A01,083735,Patchell; Gregory David,2,0,30,28
1657637725187,MATH 10A,A02,083736,Patchell; Gregory David,20,0,30,10
1657637725187,MATH 10A,A03,083737,Patchell; Gregory David,16,0,30,14
1657637731215,MATH 10B,A01,083207,Lim; Seonhee,8,0,34,26
1657637731215,MATH 10B,A02,083208,Lim; Seonhee,9,0,35,26
1657637731215,MATH 10B,A03,093472,Lim; Seonhee,7,0,34,27
1657637731215,MATH 10B,B01,083739,Sinha; Shubham,12,0,30,18
1657637737245,MATH 18,A01,083743,Cinel; Cameron Alexander,7,0,30,23
1657637737245,MATH 18,A02,083744,Cinel; Cameron Alexander,17,0,30,13
1657637737245,MATH 18,A03,083745,Cinel; Cameron Alexander,9,0,30,21
1657637737245,MATH 18,B01,083748,Rideout; David Porter,5,0,37,32
1657637737245,MATH 18,B02,083749,Rideout; David Porter,5,0,36,31
1657637737245,MATH 18,B03,083750,Rideout; David Porter,3,0,37,34
1657637737245,MATH 18,B04,083751,Rideout; David Porter,6,0,36,30
1657637737245,MATH 18,B05,093473,Rideout; David Porter,6,0,36,30
1657637737245,MATH 18,B06,093474,Rideout; David Porter,6,0,36,30
1657637743276,MATH 20A,A01,083754,Zheng; Zequn,14,0,40,26
1657637749303,MATH 20B,A01,083756,Briones; Jor-el Thomas Caparas,4,0,36,32
1657637749303,MATH 20B,A02,083757,Briones; Jor-el Thomas Caparas,1,0,36,35
1657637749303,MATH 20B,A03,093475,Briones; Jor-el Thomas Caparas,2,0,36,34
1657637755334,MATH 20C,A01,083760,Briones; Jor-el Thomas Caparas,1,0,35,34
1657637755334,MATH 20C,A02,083761,Briones; Jor-el Thomas Caparas,8,0,35,27
1657637755334,MATH 20C,A03,093476,Briones; Jor-el Thomas Caparas,0,1,36,36
1657637755334,MATH 20C,B01,083762,Bach; Quang Tran,1,0,30,29
1657637761364,MATH 20D,A01,083765,Tran; Brian Kha,5,0,30,25
1657637761364,MATH 20D,A02,083766,Tran; Brian Kha,5,0,30,25
1657637761364,MATH 20D,A03,083767,Tran; Brian Kha,5,0,30,25
1657637767392,MATH 20E,A01,083771,Ganguly; Soumya,9,0,32,23
1657637767392,MATH 20E,A02,083772,Ganguly; Soumya,6,0,32,26
1657637767392,MATH 20E,B01,083773,Ciotti; Benjamin,20,0,35,15
1657637767392,MATH 20E,B02,083774,Ciotti; Benjamin,18,0,35,17
1657637773418,MATH 103A,A01,083777,Greenfeld; Be'Eri,3,0,36,33
1657637773418,MATH 103A,A02,083778,Greenfeld; Be'Eri,5,0,36,31
1657637773418,MATH 103A,A03,093561,Greenfeld; Be'Eri,6,0,36,30
1657637773418,MATH 103A,B01,083779,Greenfeld; Be'Eri,7,0,36,29
1657637773418,MATH 103A,B02,083780,Greenfeld; Be'Eri,4,0,36,32
1657637773418,MATH 103A,B03,093562,Greenfeld; Be'Eri,3,0,36,33
1657637779441,MATH 105,A01,085443,Carter; Anne Toulson,15,0,35,20
1657637779441,MATH 105,A02,093477,Carter; Anne Toulson,20,0,35,15
1657637785471,MATH 109,A01,083213,Ganzberger; Geoffrey Michael,2,0,34,32
1657637785471,MATH 109,A02,083214,Ganzberger; Geoffrey Michael,4,0,34,30
1657637785471,MATH 109,A03,093478,Ganzberger; Geoffrey Michael,2,0,34,32
1657637785471,MATH 109,B01,083215,Ganzberger; Geoffrey Michael,1,0,32,31
1657637785471,MATH 109,B02,083216,Ganzberger; Geoffrey Michael,2,0,32,30
1657637785471,MATH 109,B03,093479,Ganzberger; Geoffrey Michael,8,0,32,24
1657637791504,MATH 142A,A01,083219,Chow; Bennett,7,0,32,25
1657637791504,MATH 142A,A02,083220,Chow; Bennett,10,0,32,22
1657637791504,MATH 142A,A03,093480,Chow; Bennett,9,0,32,23
1657637791504,MATH 142A,B03,093481,Chow; Bennett,8,0,32,24
1657637791504,MATH 142A,B04,093558,Chow; Bennett,13,0,32,19
1657637791504,MATH 142A,B05,093559,Chow; Bennett,6,0,32,26
1657637797534,MATH 193A,A01,083224,Rotar; Vladimir,8,0,34,26
1657637797534,MATH 193A,A02,083225,Rotar; Vladimir,9,0,34,25
1657637797534,MATH 193A,A03,083781,Rotar; Vladimir,5,0,34,29
1657637797534,MATH 193A,A04,083782,Rotar; Vladimir,10,0,34,24
1657637797534,MATH 193A,A05,093482,Rotar; Vladimir,10,0,34,24
1657637803559,MATH 197,001,091859,McAuley; Julian John,9999,0,9999,0
1657637803559,MATH 197,002,095566,Kedlaya; Kiran S.,9997,0,9999,2
1657637803559,MATH 197,003,095567,Xiao; Ming,9999,0,9999,0
1657637803559,MATH 197,004,095571,Perols; Johan Lars,9998,0,9999,1
1657637810616,COGS 9,A01,083615,Shannon; Kyle Michael,9,0,75,66
1657637816640,COGS 11,A01,083617,Boyle; Mary E. T.,23,0,48,25
1657637822668,COGS 13,A01,083071,Bastos; Amalia Pinkusfeld,11,0,71,60
1657637828697,COGS 14A,A01,092681,Semenuks; Arturs,5,1,100,95
1657637834737,COGS 14B,A01,083073,Cheng; Tzu-Han,6,0,63,57
1657637840767,COGS 17,A01,092677,Semenuks; Arturs,6,0,81,75
1657637846794,COGS 100,A01,083619,Allen; Michael Gordon,17,0,70,53
1657637852820,COGS 101A,A01,083621,Davis; Joshua Daniel,9,0,68,59
1657637858850,COGS 101B,A01,091572,Allen; Michael Gordon,12,0,65,53
1657637864873,COGS 101C,A01,083625,Delgado; Tania,17,0,35,18
1657637870905,COGS 107A,A01,083627,Boyle; Mary E. T.,13,0,60,47
1657637876947,COGS 118A,A01,083075,Gupta; Anjum,21,0,76,55
1657637882975,CSE 3,A50,083646,Miranda; Gregory Joseph,24,0,50,26
1657637889009,CSE 8A,A50,083650,Miranda; Gregory Joseph,17,1,56,39
1657637895036,CSE 11,A01,083080,Cao; Yingjun,6,15,40,34
1657637901063,CSE 12,A01,083652,Krause-Levy; Sophia Louisa,28,1,120,92
1657637907087,CSE 15L,A01,083654,Morris; Justin Loren,9,0,50,41
1657637907087,CSE 15L,A02,083655,Morris; Justin Loren,9,0,50,41
1657637913116,CSE 20,A01,083657,Tran; Khoa Dang,39,0,80,41
1657637919158,CSE 21,A01,095574,Bach; Quang Tran,22,0,48,26
1657637925183,CSE 30,A01,083084,Eldon; John,6,0,80,74
1657637925183,CSE 30,B01,095061,Bhaskar; Nishant,9,0,50,41
1657637931206,CSE 100,A01,083659,Cao; Yingjun,5,4,70,65
1657637937231,CSE 134B,A01,083661,Powell; Thomas Allan,22,0,100,78
1657637943254,CSE 140,A01,083663,Gungor; Onat,15,0,85,70
1657637949280,CSE 140L,A01,083088,Eldon; John,21,0,100,79
1657637955316,CSE 175,A01,083665,Kumar; Rakesh,3,0,25,22
1657637961340,CSE 190,A00,092507,Dubnov; Shlomo,8,0,20,12
1657637967366,ECE 45,A01,083139,Congero; Spencer William,6,0,75,69
1657637973394,ECE 65,A50,083695,Saad; Andrew S,12,0,30,18
1657637973394,ECE 65,A51,095125,Saad; Andrew S,24,0,26,2
1657637979419,ECE 109,A01,091882,Touri; Behrouz,19,0,70,51
1657637985444,ECE 180,A00,083140,Abi Samra; Nicholas Camill,1,0,30,29
1657637985444,ECE 180,B00,083141,Abi Samra; Nicholas Camill,0,0,30,30
1657637991475,MATH 10A,A01,083735,Patchell; Gregory David,2,0,30,28
1657637991475,MATH 10A,A02,083736,Patchell; Gregory David,20,0,30,10
1657637991475,MATH 10A,A03,083737,Patchell; Gregory David,16,0,30,14
1657637997502,MATH 10B,A01,083207,Lim; Seonhee,8,0,34,26
1657637997502,MATH 10B,A02,083208,Lim; Seonhee,9,0,35,26
1657637997502,MATH 10B,A03,093472,Lim; Seonhee,7,0,34,27
1657637997502,MATH 10B,B01,083739,Sinha; Shubham,12,0,30,18
1657638003536,MATH 18,A01,083743,Cinel; Cameron Alexander,7,0,30,23
1657638003536,MATH 18,A02,083744,Cinel; Cameron Alexander,17,0,30,13
1657638003536,MATH 18,A03,083745,Cinel; Cameron Alexander,9,0,30,21
1657638003536,MATH 18,B01,083748,Rideout; David Porter,5,0,37,32
1657638003536,MATH 18,B02,083749,Rideout; David Porter,5,0,36,31
1657638003536,MATH 18,B03,083750,Rideout; David Porter,3,0,37,34
1657638003536,MATH 18,B04,083751,Rideout; David Porter,6,0,36,30
1657638003536,MATH 18,B05,093473,Rideout; David Porter,6,0,36,30
1657638003536,MATH 18,B06,093474,Rideout; David Porter,6,0,36,30
1657638009562,MATH 20A,A01,083754,Zheng; Zequn,14,0,40,26
1657638015587,MATH 20B,A01,083756,Briones; Jor-el Thomas Caparas,4,0,36,32
1657638015587,MATH 20B,A02,083757,Briones; Jor-el Thomas Caparas,1,0,36,35
1657638015587,MATH 20B,A03,093475,Briones; Jor-el Thomas Caparas,2,0,36,34
1657638021621,MATH 20C,A01,083760,Briones; Jor-el Thomas Caparas,1,0,35,34
1657638021621,MATH 20C,A02,083761,Briones; Jor-el Thomas Caparas,8,0,35,27
1657638021621,MATH 20C,A03,093476,Briones; Jor-el Thomas Caparas,0,1,36,36
1657638021621,MATH 20C,B01,083762,Bach; Quang Tran,1,0,30,29
1657638027650,MATH 20D,A01,083765,Tran; Brian Kha,5,0,30,25
1657638027650,MATH 20D,A02,083766,Tran; Brian Kha,5,0,30,25
1657638027650,MATH 20D,A03,083767,Tran; Brian Kha,5,0,30,25
1657638033678,MATH 20E,A01,083771,Ganguly; Soumya,9,0,32,23
1657638033678,MATH 20E,A02,083772,Ganguly; Soumya,6,0,32,26
1657638033678,MATH 20E,B01,083773,Ciotti; Benjamin,20,0,35,15
1657638033678,MATH 20E,B02,083774,Ciotti; Benjamin,18,0,35,17
1657638039711,MATH 103A,A01,083777,Greenfeld; Be'Eri,3,0,36,33
1657638039711,MATH 103A,A02,083778,Greenfeld; Be'Eri,5,0,36,31
1657638039711,MATH 103A,A03,093561,Greenfeld; Be'Eri,6,0,36,30
1657638039711,MATH 103A,B01,083779,Greenfeld; Be'Eri,7,0,36,29
1657638039711,MATH 103A,B02,083780,Greenfeld; Be'Eri,4,0,36,32
1657638039711,MATH 103A,B03,093562,Greenfeld; Be'Eri,3,0,36,33
1657638045734,MATH 105,A01,085443,Carter; Anne Toulson,15,0,35,20
1657638045734,MATH 105,A02,093477,Carter; Anne Toulson,20,0,35,15
1657638051759,MATH 109,A01,083213,Ganzberger; Geoffrey Michael,2,0,34,32
1657638051759,MATH 109,A02,083214,Ganzberger; Geoffrey Michael,4,0,34,30
1657638051759,MATH 109,A03,093478,Ganzberger; Geoffrey Michael,2,0,34,32
1657638051759,MATH 109,B01,083215,Ganzberger; Geoffrey Michael,1,0,32,31
1657638051759,MATH 109,B02,083216,Ganzberger; Geoffrey Michael,2,0,32,30
1657638051759,MATH 109,B03,093479,Ganzberger; Geoffrey Michael,8,0,32,24
1657638057786,MATH 142A,A01,083219,Chow; Bennett,7,0,32,25
1657638057786,MATH 142A,A02,083220,Chow; Bennett,10,0,32,22
1657638057786,MATH 142A,A03,093480,Chow; Bennett,9,0,32,23
1657638057786,MATH 142A,B03,093481,Chow; Bennett,8,0,32,24
1657638057786,MATH 142A,B04,093558,Chow; Bennett,13,0,32,19
1657638057786,MATH 142A,B05,093559,Chow; Bennett,6,0,32,26
1657638063811,MATH 193A,A01,083224,Rotar; Vladimir,8,0,34,26
1657638063811,MATH 193A,A02,083225,Rotar; Vladimir,9,0,34,25
1657638063811,MATH 193A,A03,083781,Rotar; Vladimir,5,0,34,29
1657638063811,MATH 193A,A04,083782,Rotar; Vladimir,10,0,34,24
1657638063811,MATH 193A,A05,093482,Rotar; Vladimir,10,0,34,24
1657638069851,MATH 197,001,091859,McAuley; Julian John,9999,0,9999,0
1657638069851,MATH 197,002,095566,Kedlaya; Kiran S.,9997,0,9999,2
1657638069851,MATH 197,003,095567,Xiao; Ming,9999,0,9999,0
1657638069851,MATH 197,004,095571,Perols; Johan Lars,9998,0,9999,1
1657638076918,COGS 9,A01,083615,Shannon; Kyle Michael,9,0,75,66
1657638082941,COGS 11,A01,083617,Boyle; Mary E. T.,23,0,48,25
1657638088965,COGS 13,A01,083071,Bastos; Amalia Pinkusfeld,11,0,71,60
1657638094998,COGS 14A,A01,092681,Semenuks; Arturs,5,1,100,95
1657638101023,COGS 14B,A01,083073,Cheng; Tzu-Han,6,0,63,57
1657638107050,COGS 17,A01,092677,Semenuks; Arturs,6,0,81,75
1657638113079,COGS 100,A01,083619,Allen; Michael Gordon,17,0,70,53
1657638119104,COGS 101A,A01,083621,Davis; Joshua Daniel,9,0,68,59
1657638125133,COGS 101B,A01,091572,Allen; Michael Gordon,12,0,65,53
1657638131176,COGS 101C,A01,083625,Delgado; Tania,17,0,35,18
1657638137205,COGS 107A,A01,083627,Boyle; Mary E. T.,13,0,60,47
1657638143228,COGS 118A,A01,083075,Gupta; Anjum,21,0,76,55
1657638149254,CSE 3,A50,083646,Miranda; Gregory Joseph,24,0,50,26
1657638155349,CSE 8A,A50,083650,Miranda; Gregory Joseph,17,1,56,39
1657638161382,CSE 11,A01,083080,Cao; Yingjun,6,15,40,34
1657638167409,CSE 12,A01,083652,Krause-Levy; Sophia Louisa,28,1,120,92
1657638173434,CSE 15L,A01,083654,Morris; Justin Loren,9,0,50,41
1657638173434,CSE 15L,A02,083655,Morris; Justin Loren,9,0,50,41
1657638179459,CSE 20,A01,083657,Tran; Khoa Dang,39,0,80,41
1657638185484,CSE 21,A01,095574,Bach; Quang Tran,22,0,48,26
1657638191517,CSE 30,A01,083084,Eldon; John,6,0,80,74
1657638191517,CSE 30,B01,095061,Bhaskar; Nishant,9,0,50,41
1657638197543,CSE 100,A01,083659,Cao; Yingjun,5,4,70,65
1657638203571,CSE 134B,A01,083661,Powell; Thomas Allan,22,0,100,78
1657638209595,CSE 140,A01,083663,Gungor; Onat,15,0,85,70
1657638215622,CSE 140L,A01,083088,Eldon; John,21,0,100,79
1657638221645,CSE 175,A01,083665,Kumar; Rakesh,3,0,25,22
1657638227669,CSE 190,A00,092507,Dubnov; Shlomo,8,0,20,12
1657638233694,ECE 45,A01,083139,Congero; Spencer William,6,0,75,69
1657638239718,ECE 65,A50,083695,Saad; Andrew S,12,0,30,18
1657638239718,ECE 65,A51,095125,Saad; Andrew S,24,0,26,2
1657638245742,ECE 109,A01,091882,Touri; Behrouz,19,0,70,51
1657638251771,ECE 180,A00,083140,Abi Samra; Nicholas Camill,1,0,30,29
1657638251771,ECE 180,B00,083141,Abi Samra; Nicholas Camill,0,0,30,30
1657638257802,MATH 10A,A01,083735,Patchell; Gregory David,2,0,30,28
1657638257802,MATH 10A,A02,083736,Patchell; Gregory David,20,0,30,10
1657638257802,MATH 10A,A03,083737,Patchell; Gregory David,16,0,30,14
1657638263833,MATH 10B,A01,083207,Lim; Seonhee,8,0,34,26
1657638263833,MATH 10B,A02,083208,Lim; Seonhee,9,0,35,26
1657638263833,MATH 10B,A03,093472,Lim; Seonhee,7,0,34,27
1657638263833,MATH 10B,B01,083739,Sinha; Shubham,12,0,30,18
1657638269860,MATH 18,A01,083743,Cinel; Cameron Alexander,7,0,30,23
1657638269860,MATH 18,A02,083744,Cinel; Cameron Alexander,17,0,30,13
1657638269860,MATH 18,A03,083745,Cinel; Cameron Alexander,9,0,30,21
1657638269860,MATH 18,B01,083748,Rideout; David Porter,5,0,37,32
1657638269860,MATH 18,B02,083749,Rideout; David Porter,5,0,36,31
1657638269860,MATH 18,B03,083750,Rideout; David Porter,3,0,37,34
1657638269860,MATH 18,B04,083751,Rideout; David Porter,6,0,36,30
1657638269860,MATH 18,B05,093473,Rideout; David Porter,6,0,36,30
1657638269860,MATH 18,B06,093474,Rideout; David Porter,6,0,36,30
1657638275884,MATH 20A,A01,083754,Zheng; Zequn,14,0,40,26
1657638281909,MATH 20B,A01,083756,Briones; Jor-el Thomas Caparas,4,0,36,32
1657638281909,MATH 20B,A02,083757,Briones; Jor-el Thomas Caparas,1,0,36,35
1657638281909,MATH 20B,A03,093475,Briones; Jor-el Thomas Caparas,2,0,36,34
1657638287937,MATH 20C,A01,083760,Briones; Jor-el Thomas Caparas,1,0,35,34
1657638287937,MATH 20C,A02,083761,Briones; Jor-el Thomas Caparas,8,0,35,27
1657638287937,MATH 20C,A03,093476,Briones; Jor-el Thomas Caparas,0,1,36,36
1657638287937,MATH 20C,B01,083762,Bach; Quang Tran,1,0,30,29
1657638293965,MATH 20D,A01,083765,Tran; Brian Kha,5,0,30,25
1657638293965,MATH 20D,A02,083766,Tran; Brian Kha,5,0,30,25
1657638293965,MATH 20D,A03,083767,Tran; Brian Kha,5,0,30,25
1657638299989,MATH 20E,A01,083771,Ganguly; Soumya,9,0,32,23
1657638299989,MATH 20E,A02,083772,Ganguly; Soumya,6,0,32,26
1657638299989,MATH 20E,B01,083773,Ciotti; Benjamin,20,0,35,15
1657638299989,MATH 20E,B02,083774,Ciotti; Benjamin,18,0,35,17
1657638306016,MATH 103A,A01,083777,Greenfeld; Be'Eri,3,0,36,33
1657638306016,MATH 103A,A02,083778,Greenfeld; Be'Eri,5,0,36,31
1657638306016,MATH 103A,A03,093561,Greenfeld; Be'Eri,6,0,36,30
1657638306016,MATH 103A,B01,083779,Greenfeld; Be'Eri,7,0,36,29
1657638306016,MATH 103A,B02,083780,Greenfeld; Be'Eri,4,0,36,32
1657638306016,MATH 103A,B03,093562,Greenfeld; Be'Eri,3,0,36,33
1657638312053,MATH 105,A01,085443,Carter; Anne Toulson,15,0,35,20
1657638312053,MATH 105,A02,093477,Carter; Anne Toulson,20,0,35,15
1657638318079,MATH 109,A01,083213,Ganzberger; Geoffrey Michael,2,0,34,32
1657638318079,MATH 109,A02,083214,Ganzberger; Geoffrey Michael,4,0,34,30
1657638318079,MATH 109,A03,093478,Ganzberger; Geoffrey Michael,2,0,34,32
1657638318079,MATH 109,B01,083215,Ganzberger; Geoffrey Michael,1,0,32,31
1657638318079,MATH 109,B02,083216,Ganzberger; Geoffrey Michael,2,0,32,30
1657638318079,MATH 109,B03,093479,Ganzberger; Geoffrey Michael,8,0,32,24
1657638324104,MATH 142A,A01,083219,Chow; Bennett,7,0,32,25
1657638324104,MATH 142A,A02,083220,Chow; Bennett,10,0,32,22
1657638324104,MATH 142A,A03,093480,Chow; Bennett,9,0,32,23
1657638324104,MATH 142A,B03,093481,Chow; Bennett,8,0,32,24
1657638324104,MATH 142A,B04,093558,Chow; Bennett,13,0,32,19
1657638324104,MATH 142A,B05,093559,Chow; Bennett,6,0,32,26
1657638330133,MATH 193A,A01,083224,Rotar; Vladimir,8,0,34,26
1657638330133,MATH 193A,A02,083225,Rotar; Vladimir,9,0,34,25
1657638330133,MATH 193A,A03,083781,Rotar; Vladimir,5,0,34,29
1657638330133,MATH 193A,A04,083782,Rotar; Vladimir,10,0,34,24
1657638330133,MATH 193A,A05,093482,Rotar; Vladimir,10,0,34,24
1657638336161,MATH 197,001,091859,McAuley; Julian John,9999,0,9999,0
1657638336161,MATH 197,002,095566,Kedlaya; Kiran S.,9997,0,9999,2
1657638336161,MATH 197,003,095567,Xiao; Ming,9999,0,9999,0
1657638336161,MATH 197,004,095571,Perols; Johan Lars,9998,0,9999,1
1657638343232,COGS 9,A01,083615,Shannon; Kyle Michael,9,0,75,66
1657638349258,COGS 11,A01,083617,Boyle; Mary E. T.,23,0,48,25
1657638355285,COGS 13,A01,083071,Bastos; Amalia Pinkusfeld,11,0,71,60
1657638361320,COGS 14A,A01,092681,Semenuks; Arturs,5,1,100,95
1657638367346,COGS 14B,A01,083073,Cheng; Tzu-Han,6,0,63,57
1657638373377,COGS 17,A01,092677,Semenuks; Arturs,6,0,81,75
1657638379401,COGS 100,A01,083619,Allen; Michael Gordon,17,0,70,53
1657638385424,COGS 101A,A01,083621,Davis; Joshua Daniel,9,0,68,59
1657638391447,COGS 101B,A01,091572,Allen; Michael Gordon,12,0,65,53
1657638397476,COGS 101C,A01,083625,Delgado; Tania,17,0,35,18
1657638403499,COGS 107A,A01,083627,Boyle; Mary E. T.,13,0,60,47
1657638409521,COGS 118A,A01,083075,Gupta; Anjum,21,0,76,55
1657638415549,CSE 3,A50,083646,Miranda; Gregory Joseph,24,0,50,26
1657638421576,CSE 8A,A50,083650,Miranda; Gregory Joseph,17,1,56,39
1657638427602,CSE 11,A01,083080,Cao; Yingjun,6,15,40,34
1657638433631,CSE 12,A01,083652,Krause-Levy; Sophia Louisa,28,1,120,92
1657638439655,CSE 15L,A01,083654,Morris; Justin Loren,9,0,50,41
1657638439655,CSE 15L,A02,083655,Morris; Justin Loren,9,0,50,41
1657638445680,CSE 20,A01,083657,Tran; Khoa Dang,39,0,80,41
1657638451717,CSE 21,A01,095574,Bach; Quang Tran,22,0,48,26
1657638457744,CSE 30,A01,083084,Eldon; John,6,0,80,74
1657638457744,CSE 30,B01,095061,Bhaskar; Nishant,9,0,50,41
1657638463767,CSE 100,A01,083659,Cao; Yingjun,5,4,70,65
1657638469790,CSE 134B,A01,083661,Powell; Thomas Allan,22,0,100,78
1657638475830,CSE 140,A01,083663,Gungor; Onat,15,0,85,70
1657638481856,CSE 140L,A01,083088,Eldon; John,21,0,100,79
1657638487889,CSE 175,A01,083665,Kumar; Rakesh,3,0,25,22
1657638493914,CSE 190,A00,092507,Dubnov; Shlomo,8,0,20,12
1657638499940,ECE 45,A01,083139,Congero; Spencer William,6,0,75,69
1657638505968,ECE 65,A50,083695,Saad; Andrew S,12,0,30,18
1657638505968,ECE 65,A51,095125,Saad; Andrew S,24,0,26,2
1657638511996,ECE 109,A01,091882,Touri; Behrouz,19,0,70,51
1657638518022,ECE 180,A00,083140,Abi Samra; Nicholas Camill,1,0,30,29
1657638518022,ECE 180,B00,083141,Abi Samra; Nicholas Camill,0,0,30,30
1657638524046,MATH 10A,A01,083735,Patchell; Gregory David,2,0,30,28
1657638524046,MATH 10A,A02,083736,Patchell; Gregory David,20,0,30,10
1657638524046,MATH 10A,A03,083737,Patchell; Gregory David,16,0,30,14
1657638530074,MATH 10B,A01,083207,Lim; Seonhee,8,0,34,26
1657638530074,MATH 10B,A02,083208,Lim; Seonhee,9,0,35,26
1657638530074,MATH 10B,A03,093472,Lim; Seonhee,7,0,34,27
1657638530074,MATH 10B,B01,083739,Sinha; Shubham,12,0,30,18
1657638536111,MATH 18,A01,083743,Cinel; Cameron Alexander,7,0,30,23
1657638536111,MATH 18,A02,083744,Cinel; Cameron Alexander,17,0,30,13
1657638536111,MATH 18,A03,083745,Cinel; Cameron Alexander,9,0,30,21
1657638536111,MATH 18,B01,083748,Rideout; David Porter,5,0,37,32
1657638536111,MATH 18,B02,083749,Rideout; David Porter,5,0,36,31
1657638536111,MATH 18,B03,083750,Rideout; David Porter,3,0,37,34
1657638536111,MATH 18,B04,083751,Rideout; David Porter,6,0,36,30
1657638536111,MATH 18,B05,093473,Rideout; David Porter,6,0,36,30
1657638536111,MATH 18,B06,093474,Rideout; David Porter,6,0,36,30
1657638542140,MATH 20A,A01,083754,Zheng; Zequn,14,0,40,26
1657638548167,MATH 20B,A01,083756,Briones; Jor-el Thomas Caparas,4,0,36,32
1657638548167,MATH 20B,A02,083757,Briones; Jor-el Thomas Caparas,1,0,36,35
1657638548167,MATH 20B,A03,093475,Briones; Jor-el Thomas Caparas,2,0,36,34
1657638554209,MATH 20C,A01,083760,Briones; Jor-el Thomas Caparas,1,0,35,34
1657638554209,MATH 20C,A02,083761,Briones; Jor-el Thomas Caparas,8,0,35,27
1657638554209,MATH 20C,A03,093476,Briones; Jor-el Thomas Caparas,0,1,36,36
1657638554209,MATH 20C,B01,083762,Bach; Quang Tran,1,0,30,29
1657638560253,MATH 20D,A01,083765,Tran; Brian Kha,5,0,30,25
1657638560253,MATH 20D,A02,083766,Tran; Brian Kha,5,0,30,25
1657638560253,MATH 20D,A03,083767,Tran; Brian Kha,5,0,30,25
1657638566277,MATH 20E,A01,083771,Ganguly; Soumya,9,0,32,23
1657638566277,MATH 20E,A02,083772,Ganguly; Soumya,6,0,32,26
1657638566277,MATH 20E,B01,083773,Ciotti; Benjamin,20,0,35,15
1657638566277,MATH 20E,B02,083774,Ciotti; Benjamin,18,0,35,17
1657638572314,MATH 103A,A01,083777,Greenfeld; Be'Eri,3,0,36,33
1657638572314,MATH 103A,A02,083778,Greenfeld; Be'Eri,5,0,36,31
1657638572314,MATH 103A,A03,093561,Greenfeld; Be'Eri,6,0,36,30
1657638572314,MATH 103A,B01,083779,Greenfeld; Be'Eri,7,0,36,29
1657638572314,MATH 103A,B02,083780,Greenfeld; Be'Eri,4,0,36,32
1657638572314,MATH 103A,B03,093562,Greenfeld; Be'Eri,3,0,36,33
1657638578339,MATH 105,A01,085443,Carter; Anne Toulson,15,0,35,20
1657638578339,MATH 105,A02,093477,Carter; Anne Toulson,20,0,35,15
1657638584369,MATH 109,A01,083213,Ganzberger; Geoffrey Michael,2,0,34,32
1657638584369,MATH 109,A02,083214,Ganzberger; Geoffrey Michael,4,0,34,30
1657638584369,MATH 109,A03,093478,Ganzberger; Geoffrey Michael,2,0,34,32
1657638584369,MATH 109,B01,083215,Ganzberger; Geoffrey Michael,1,0,32,31
1657638584369,MATH 109,B02,083216,Ganzberger; Geoffrey Michael,2,0,32,30
1657638584369,MATH 109,B03,093479,Ganzberger; Geoffrey Michael,8,0,32,24
1657638590402,MATH 142A,A01,083219,Chow; Bennett,7,0,32,25
1657638590402,MATH 142A,A02,083220,Chow; Bennett,10,0,32,22
1657638590402,MATH 142A,A03,093480,Chow; Bennett,9,0,32,23
1657638590402,MATH 142A,B03,093481,Chow; Bennett,8,0,32,24
1657638590402,MATH 142A,B04,093558,Chow; Bennett,13,0,32,19
1657638590402,MATH 142A,B05,093559,Chow; Bennett,6,0,32,26
1657638596431,MATH 193A,A01,083224,Rotar; Vladimir,8,0,34,26
1657638596431,MATH 193A,A02,083225,Rotar; Vladimir,9,0,34,25
1657638596431,MATH 193A,A03,083781,Rotar; Vladimir,5,0,34,29
1657638596431,MATH 193A,A04,083782,Rotar; Vladimir,10,0,34,24
1657638596431,MATH 193A,A05,093482,Rotar; Vladimir,10,0,34,24
1657638602456,MATH 197,001,091859,McAuley; Julian John,9999,0,9999,0
1657638602456,MATH 197,002,095566,Kedlaya; Kiran S.,9997,0,9999,2
1657638602456,MATH 197,003,095567,Xiao; Ming,9999,0,9999,0
1657638602456,MATH 197,004,095571,Perols; Johan Lars,9998,0,9999,1
1657638609526,COGS 9,A01,083615,Shannon; Kyle Michael,9,0,75,66
1657638615552,COGS 11,A01,083617,Boyle; Mary E. T.,23,0,48,25
1657638621585,COGS 13,A01,083071,Bastos; Amalia Pinkusfeld,11,0,71,60
1657638627615,COGS 14A,A01,092681,Semenuks; Arturs,5,1,100,95
1657638633650,COGS 14B,A01,083073,Cheng; Tzu-Han,6,0,63,57
1657638639678,COGS 17,A01,092677,Semenuks; Arturs,6,0,81,75
1657638645704,COGS 100,A01,083619,Allen; Michael Gordon,17,0,70,53
1657638651727,COGS 101A,A01,083621,Davis; Joshua Daniel,9,0,68,59
1657638657753,COGS 101B,A01,091572,Allen; Michael Gordon,12,0,65,53
1657638663777,COGS 101C,A01,083625,Delgado; Tania,17,0,35,18
1657638669800,COGS 107A,A01,083627,Boyle; Mary E. T.,13,0,60,47
1657638675828,COGS 118A,A01,083075,Gupta; Anjum,21,0,76,55
1657638681854,CSE 3,A50,083646,Miranda; Gregory Joseph,24,0,50,26
1657638687879,CSE 8A,A50,083650,Miranda; Gregory Joseph,17,1,56,39
1657638693905,CSE 11,A01,083080,Cao; Yingjun,6,15,40,34
1657638699930,CSE 12,A01,083652,Krause-Levy; Sophia Louisa,28,1,120,92
1657638705955,CSE 15L,A01,083654,Morris; Justin Loren,9,0,50,41
1657638705955,CSE 15L,A02,083655,Morris; Justin Loren,9,0,50,41
1657638711990,CSE 20,A01,083657,Tran; Khoa Dang,39,0,80,41
1657638718017,CSE 21,A01,095574,Bach; Quang Tran,22,0,48,26
1657638724045,CSE 30,A01,083084,Eldon; John,6,0,80,74
1657638724045,CSE 30,B01,095061,Bhaskar; Nishant,9,0,50,41
1657638730071,CSE 100,A01,083659,Cao; Yingjun,5,4,70,65
1657638736099,CSE 134B,A01,083661,Powell; Thomas Allan,22,0,100,78
1657638742133,CSE 140,A01,083663,Gungor; Onat,15,0,85,70
1657638748162,CSE 140L,A01,083088,Eldon; John,21,0,100,79
1657638754263,CSE 175,A01,083665,Kumar; Rakesh,3,0,25,22
1657638760291,CSE 190,A00,092507,Dubnov; Shlomo,8,0,20,12
1657638766319,ECE 45,A01,083139,Congero; Spencer William,6,0,75,69
1657638772351,ECE 65,A50,083695,Saad; Andrew S,12,0,30,18
1657638772351,ECE 65,A51,095125,Saad; Andrew S,24,0,26,2
1657638778380,ECE 109,A01,091882,Touri; Behrouz,19,0,70,51
1657638784405,ECE 180,A00,083140,Abi Samra; Nicholas Camill,1,0,30,29
1657638784405,ECE 180,B00,083141,Abi Samra; Nicholas Camill,0,0,30,30
1657638790432,MATH 10A,A01,083735,Patchell; Gregory David,2,0,30,28
1657638790432,MATH 10A,A02,083736,Patchell; Gregory David,20,0,30,10
1657638790432,MATH 10A,A03,083737,Patchell; Gregory David,16,0,30,14
1657638796465,MATH 10B,A01,083207,Lim; Seonhee,8,0,34,26
1657638796465,MATH 10B,A02,083208,Lim; Seonhee,9,0,35,26
1657638796465,MATH 10B,A03,093472,Lim; Seonhee,7,0,34,27
1657638796465,MATH 10B,B01,083739,Sinha; Shubham,12,0,30,18
1657638802496,MATH 18,A01,083743,Cinel; Cameron Alexander,7,0,30,23
1657638802496,MATH 18,A02,083744,Cinel; Cameron Alexander,17,0,30,13
1657638802496,MATH 18,A03,083745,Cinel; Cameron Alexander,9,0,30,21
1657638802496,MATH 18,B01,083748,Rideout; David Porter,5,0,37,32
1657638802496,MATH 18,B02,083749,Rideout; David Porter,5,0,36,31
1657638802496,MATH 18,B03,083750,Rideout; David Porter,3,0,37,34
1657638802496,MATH 18,B04,083751,Rideout; David Porter,6,0,36,30
1657638802496,MATH 18,B05,093473,Rideout; David Porter,6,0,36,30
1657638802496,MATH 18,B06,093474,Rideout; David Porter,6,0,36,30
1657638808531,MATH 20A,A01,083754,Zheng; Zequn,14,0,40,26
1657638814561,MATH 20B,A01,083756,Briones; Jor-el Thomas Caparas,4,0,36,32
1657638814561,MATH 20B,A02,083757,Briones; Jor-el Thomas Caparas,1,0,36,35
1657638814561,MATH 20B,A03,093475,Briones; Jor-el Thomas Caparas,2,0,36,34
1657638820589,MATH 20C,A01,083760,Briones; Jor-el Thomas Caparas,1,0,35,34
1657638820589,MATH 20C,A02,083761,Briones; Jor-el Thomas Caparas,8,0,35,27
1657638820589,MATH 20C,A03,093476,Briones; Jor-el Thomas Caparas,0,1,36,36
1657638820589,MATH 20C,B01,083762,Bach; Quang Tran,1,0,30,29
1657638826614,MATH 20D,A01,083765,Tran; Brian Kha,5,0,30,25
1657638826614,MATH 20D,A02,083766,Tran; Brian Kha,5,0,30,25
1657638826614,MATH 20D,A03,083767,Tran; Brian Kha,5,0,30,25
1657638832648,MATH 20E,A01,083771,Ganguly; Soumya,9,0,32,23
1657638832648,MATH 20E,A02,083772,Ganguly; Soumya,6,0,32,26
1657638832648,MATH 20E,B01,083773,Ciotti; Benjamin,20,0,35,15
1657638832648,MATH 20E,B02,083774,Ciotti; Benjamin,18,0,35,17
1657638838678,MATH 103A,A01,083777,Greenfeld; Be'Eri,3,0,36,33
1657638838678,MATH 103A,A02,083778,Greenfeld; Be'Eri,5,0,36,31
1657638838678,MATH 103A,A03,093561,Greenfeld; Be'Eri,6,0,36,30
1657638838678,MATH 103A,B01,083779,Greenfeld; Be'Eri,7,0,36,29
1657638838678,MATH 103A,B02,083780,Greenfeld; Be'Eri,4,0,36,32
1657638838678,MATH 103A,B03,093562,Greenfeld; Be'Eri,3,0,36,33
1657638844707,MATH 105,A01,085443,Carter; Anne Toulson,15,0,35,20
1657638844707,MATH 105,A02,093477,Carter; Anne Toulson,20,0,35,15
1657638850739,MATH 109,A01,083213,Ganzberger; Geoffrey Michael,2,0,34,32
1657638850739,MATH 109,A02,083214,Ganzberger; Geoffrey Michael,4,0,34,30
1657638850739,MATH 109,A03,093478,Ganzberger; Geoffrey Michael,2,0,34,32
1657638850739,MATH 109,B01,083215,Ganzberger; Geoffrey Michael,1,0,32,31
1657638850739,MATH 109,B02,083216,Ganzberger; Geoffrey Michael,2,0,32,30
1657638850739,MATH 109,B03,093479,Ganzberger; Geoffrey Michael,8,0,32,24
1657638856763,MATH 142A,A01,083219,Chow; Bennett,7,0,32,25
1657638856763,MATH 142A,A02,083220,Chow; Bennett,10,0,32,22
1657638856763,MATH 142A,A03,093480,Chow; Bennett,9,0,32,23
1657638856763,MATH 142A,B03,093481,Chow; Bennett,8,0,32,24
1657638856763,MATH 142A,B04,093558,Chow; Bennett,13,0,32,19
1657638856763,MATH 142A,B05,093559,Chow; Bennett,6,0,32,26
1657638862787,MATH 193A,A01,083224,Rotar; Vladimir,8,0,34,26
1657638862787,MATH 193A,A02,083225,Rotar; Vladimir,9,0,34,25
1657638862787,MATH 193A,A03,083781,Rotar; Vladimir,5,0,34,29
1657638862787,MATH 193A,A04,083782,Rotar; Vladimir,10,0,34,24
1657638862787,MATH 193A,A05,093482,Rotar; Vladimir,10,0,34,24
1657638868813,MATH 197,001,091859,McAuley; Julian John,9999,0,9999,0
1657638868813,MATH 197,002,095566,Kedlaya; Kiran S.,9997,0,9999,2
1657638868813,MATH 197,003,095567,Xiao; Ming,9999,0,9999,0
1657638868813,MATH 197,004,095571,Perols; Johan Lars,9998,0,9999,1
1657638875892,COGS 9,A01,083615,Shannon; Kyle Michael,9,0,75,66
1657638881918,COGS 11,A01,083617,Boyle; Mary E. T.,23,0,48,25
1657638887943,COGS 13,A01,083071,Bastos; Amalia Pinkusfeld,11,0,71,60
1657638893974,COGS 14A,A01,092681,Semenuks; Arturs,5,1,100,95
1657638900002,COGS 14B,A01,083073,Cheng; Tzu-Han,6,0,63,57
1657638906026,COGS 17,A01,092677,Semenuks; Arturs,6,0,81,75
1657638912050,COGS 100,A01,083619,Allen; Michael Gordon,17,0,70,53
1657638918079,COGS 101A,A01,083621,Davis; Joshua Daniel,9,0,68,59
1657638924104,COGS 101B,A01,091572,Allen; Michael Gordon,12,0,65,53
1657638930130,COGS 101C,A01,083625,Delgado; Tania,17,0,35,18
1657638936153,COGS 107A,A01,083627,Boyle; Mary E. T.,13,0,60,47
1657638942177,COGS 118A,A01,083075,Gupta; Anjum,21,0,76,55
1657638948205,CSE 3,A50,083646,Miranda; Gregory Joseph,24,0,50,26
1657638954233,CSE 8A,A50,083650,Miranda; Gregory Joseph,17,1,56,39
1657638960256,CSE 11,A01,083080,Cao; Yingjun,6,15,40,34
1657638966289,CSE 12,A01,083652,Krause-Levy; Sophia Louisa,28,1,120,92
1657638972312,CSE 15L,A01,083654,Morris; Justin Loren,9,0,50,41
1657638972312,CSE 15L,A02,083655,Morris; Justin Loren,9,0,50,41
1657638978336,CSE 20,A01,083657,Tran; Khoa Dang,39,0,80,41
1657638984362,CSE 21,A01,095574,Bach; Quang Tran,22,0,48,26
1657638990391,CSE 30,A01,083084,Eldon; John,6,0,80,74
1657638990391,CSE 30,B01,095061,Bhaskar; Nishant,9,0,50,41
1657638996415,CSE 100,A01,083659,Cao; Yingjun,5,4,70,65
1657639002441,CSE 134B,A01,083661,Powell; Thomas Allan,22,0,100,78
1657639008465,CSE 140,A01,083663,Gungor; Onat,15,0,85,70
1657639014498,CSE 140L,A01,083088,Eldon; John,21,0,100,79
1657639020523,CSE 175,A01,083665,Kumar; Rakesh,3,0,25,22
1657639026548,CSE 190,A00,092507,Dubnov; Shlomo,8,0,20,12
1657639032580,ECE 45,A01,083139,Congero; Spencer William,6,0,75,69
1657639038609,ECE 65,A50,083695,Saad; Andrew S,12,0,30,18
1657639038609,ECE 65,A51,095125,Saad; Andrew S,24,0,26,2
1657639044635,ECE 109,A01,091882,Touri; Behrouz,19,0,70,51
1657639050663,ECE 180,A00,083140,Abi Samra; Nicholas Camill,1,0,30,29
1657639050663,ECE 180,B00,083141,Abi Samra; Nicholas Camill,0,0,30,30
1657639056689,MATH 10A,A01,083735,Patchell; Gregory David,2,0,30,28
1657639056689,MATH 10A,A02,083736,Patchell; Gregory David,20,0,30,10
1657639056689,MATH 10A,A03,083737,Patchell; Gregory David,16,0,30,14
1657639062724,MATH 10B,A01,083207,Lim; Seonhee,8,0,34,26
1657639062724,MATH 10B,A02,083208,Lim; Seonhee,9,0,35,26
1657639062724,MATH 10B,A03,093472,Lim; Seonhee,7,0,34,27
1657639062724,MATH 10B,B01,083739,Sinha; Shubham,12,0,30,18
1657639068766,MATH 18,A01,083743,Cinel; Cameron Alexander,7,0,30,23
1657639068766,MATH 18,A02,083744,Cinel; Cameron Alexander,17,0,30,13
1657639068766,MATH 18,A03,083745,Cinel; Cameron Alexander,9,0,30,21
1657639068766,MATH 18,B01,083748,Rideout; David Porter,5,0,37,32
1657639068766,MATH 18,B02,083749,Rideout; David Porter,5,0,36,31
1657639068766,MATH 18,B03,083750,Rideout; David Porter,3,0,37,34
1657639068766,MATH 18,B04,083751,Rideout; David Porter,6,0,36,30
1657639068766,MATH 18,B05,093473,Rideout; David Porter,6,0,36,30
1657639068766,MATH 18,B06,093474,Rideout; David Porter,6,0,36,30
1657639074789,MATH 20A,A01,083754,Zheng; Zequn,14,0,40,26
1657639080817,MATH 20B,A01,083756,Briones; Jor-el Thomas Caparas,4,0,36,32
1657639080817,MATH 20B,A02,083757,Briones; Jor-el Thomas Caparas,1,0,36,35
1657639080817,MATH 20B,A03,093475,Briones; Jor-el Thomas Caparas,2,0,36,34
1657639086864,MATH 20C,A01,083760,Briones; Jor-el Thomas Caparas,1,0,35,34
1657639086864,MATH 20C,A02,083761,Briones; Jor-el Thomas Caparas,8,0,35,27
1657639086864,MATH 20C,A03,093476,Briones; Jor-el Thomas Caparas,0,1,36,36
1657639086864,MATH 20C,B01,083762,Bach; Quang Tran,1,0,30,29
1657639092890,MATH 20D,A01,083765,Tran; Brian Kha,5,0,30,25
1657639092890,MATH 20D,A02,083766,Tran; Brian Kha,5,0,30,25
1657639092890,MATH 20D,A03,083767,Tran; Brian Kha,5,0,30,25
1657639098918,MATH 20E,A01,083771,Ganguly; Soumya,9,0,32,23
1657639098918,MATH 20E,A02,083772,Ganguly; Soumya,6,0,32,26
1657639098918,MATH 20E,B01,083773,Ciotti; Benjamin,20,0,35,15
1657639098918,MATH 20E,B02,083774,Ciotti; Benjamin,18,0,35,17
1657639104945,MATH 103A,A01,083777,Greenfeld; Be'Eri,3,0,36,33
1657639104945,MATH 103A,A02,083778,Greenfeld; Be'Eri,5,0,36,31
1657639104945,MATH 103A,A03,093561,Greenfeld; Be'Eri,6,0,36,30
1657639104945,MATH 103A,B01,083779,Greenfeld; Be'Eri,7,0,36,29
1657639104945,MATH 103A,B02,083780,Greenfeld; Be'Eri,4,0,36,32
1657639104945,MATH 103A,B03,093562,Greenfeld; Be'Eri,3,0,36,33
1657639110975,MATH 105,A01,085443,Carter; Anne Toulson,15,0,35,20
1657639110975,MATH 105,A02,093477,Carter; Anne Toulson,20,0,35,15
1657639117000,MATH 109,A01,083213,Ganzberger; Geoffrey Michael,2,0,34,32
1657639117000,MATH 109,A02,083214,Ganzberger; Geoffrey Michael,4,0,34,30
1657639117000,MATH 109,A03,093478,Ganzberger; Geoffrey Michael,2,0,34,32
1657639117000,MATH 109,B01,083215,Ganzberger; Geoffrey Michael,1,0,32,31
1657639117000,MATH 109,B02,083216,Ganzberger; Geoffrey Michael,2,0,32,30
1657639117000,MATH 109,B03,093479,Ganzberger; Geoffrey Michael,8,0,32,24
1657639123024,MATH 142A,A01,083219,Chow; Bennett,7,0,32,25
1657639123024,MATH 142A,A02,083220,Chow; Bennett,10,0,32,22
1657639123024,MATH 142A,A03,093480,Chow; Bennett,9,0,32,23
1657639123024,MATH 142A,B03,093481,Chow; Bennett,8,0,32,24
1657639123024,MATH 142A,B04,093558,Chow; Bennett,13,0,32,19
1657639123024,MATH 142A,B05,093559,Chow; Bennett,6,0,32,26
1657639129050,MATH 193A,A01,083224,Rotar; Vladimir,8,0,34,26
1657639129050,MATH 193A,A02,083225,Rotar; Vladimir,9,0,34,25
1657639129050,MATH 193A,A03,083781,Rotar; Vladimir,5,0,34,29
1657639129050,MATH 193A,A04,083782,Rotar; Vladimir,10,0,34,24
1657639129050,MATH 193A,A05,093482,Rotar; Vladimir,10,0,34,24
1657639135077,MATH 197,001,091859,McAuley; Julian John,9999,0,9999,0
1657639135077,MATH 197,002,095566,Kedlaya; Kiran S.,9997,0,9999,2
1657639135077,MATH 197,003,095567,Xiao; Ming,9999,0,9999,0
1657639135077,MATH 197,004,095571,Perols; Johan Lars,9998,0,9999,1
1657639142143,COGS 9,A01,083615,Shannon; Kyle Michael,9,0,75,66
1657639148174,COGS 11,A01,083617,Boyle; Mary E. T.,23,0,48,25
1657639154204,COGS 13,A01,083071,Bastos; Amalia Pinkusfeld,11,0,71,60
1657639160240,COGS 14A,A01,092681,Semenuks; Arturs,5,1,100,95
1657639166268,COGS 14B,A01,083073,Cheng; Tzu-Han,6,0,63,57
1657639172291,COGS 17,A01,092677,Semenuks; Arturs,6,0,81,75
1657639178314,COGS 100,A01,083619,Allen; Michael Gordon,17,0,70,53
1657639184341,COGS 101A,A01,083621,Davis; Joshua Daniel,9,0,68,59
1657639190376,COGS 101B,A01,091572,Allen; Michael Gordon,12,0,65,53
1657639196405,COGS 101C,A01,083625,Delgado; Tania,17,0,35,18
1657639202432,COGS 107A,A01,083627,Boyle; Mary E. T.,13,0,60,47
1657639208458,COGS 118A,A01,083075,Gupta; Anjum,21,0,76,55
1657639214483,CSE 3,A50,083646,Miranda; Gregory Joseph,24,0,50,26
1657639220507,CSE 8A,A50,083650,Miranda; Gregory Joseph,17,1,56,39
1657639226531,CSE 11,A01,083080,Cao; Yingjun,6,15,40,34
1657639232554,CSE 12,A01,083652,Krause-Levy; Sophia Louisa,28,1,120,92
1657639238590,CSE 15L,A01,083654,Morris; Justin Loren,9,0,50,41
1657639238590,CSE 15L,A02,083655,Morris; Justin Loren,9,0,50,41
1657639244621,CSE 20,A01,083657,Tran; Khoa Dang,39,0,80,41
1657639250645,CSE 21,A01,095574,Bach; Quang Tran,22,0,48,26
1657639256673,CSE 30,A01,083084,Eldon; John,6,0,80,74
1657639256673,CSE 30,B01,095061,Bhaskar; Nishant,9,0,50,41
1657639262698,CSE 100,A01,083659,Cao; Yingjun,5,4,70,65
1657639268727,CSE 134B,A01,083661,Powell; Thomas Allan,22,0,100,78
1657639274752,CSE 140,A01,083663,Gungor; Onat,15,0,85,70
1657639280781,CSE 140L,A01,083088,Eldon; John,21,0,100,79
1657639286806,CSE 175,A01,083665,Kumar; Rakesh,3,0,25,22
1657639292832,CSE 190,A00,092507,Dubnov; Shlomo,8,0,20,12
1657639298870,ECE 45,A01,083139,Congero; Spencer William,6,0,75,69
1657639304904,ECE 65,A50,083695,Saad; Andrew S,12,0,30,18
1657639304904,ECE 65,A51,095125,Saad; Andrew S,24,0,26,2
1657639310936,ECE 109,A01,091882,Touri; Behrouz,19,0,70,51
1657639316961,ECE 180,A00,083140,Abi Samra; Nicholas Camill,1,0,30,29
1657639316961,ECE 180,B00,083141,Abi Samra; Nicholas Camill,0,0,30,30
1657639322994,MATH 10A,A01,083735,Patchell; Gregory David,2,0,30,28
1657639322994,MATH 10A,A02,083736,Patchell; Gregory David,20,0,30,10
1657639322994,MATH 10A,A03,083737,Patchell; Gregory David,16,0,30,14
1657639329026,MATH 10B,A01,083207,Lim; Seonhee,8,0,34,26
1657639329026,MATH 10B,A02,083208,Lim; Seonhee,9,0,35,26
1657639329026,MATH 10B,A03,093472,Lim; Seonhee,7,0,34,27
1657639329026,MATH 10B,B01,083739,Sinha; Shubham,12,0,30,18
1657639335066,MATH 18,A01,083743,Cinel; Cameron Alexander,7,0,30,23
1657639335066,MATH 18,A02,083744,Cinel; Cameron Alexander,17,0,30,13
1657639335066,MATH 18,A03,083745,Cinel; Cameron Alexander,9,0,30,21
1657639335066,MATH 18,B01,083748,Rideout; David Porter,5,0,37,32
1657639335066,MATH 18,B02,083749,Rideout; David Porter,5,0,36,31
1657639335066,MATH 18,B03,083750,Rideout; David Porter,3,0,37,34
1657639335066,MATH 18,B04,083751,Rideout; David Porter,6,0,36,30
1657639335066,MATH 18,B05,093473,Rideout; David Porter,6,0,36,30
1657639335066,MATH 18,B06,093474,Rideout; David Porter,6,0,36,30
1657639341092,MATH 20A,A01,083754,Zheng; Zequn,14,0,40,26
1657639347129,MATH 20B,A01,083756,Briones; Jor-el Thomas Caparas,4,0,36,32
1657639347129,MATH 20B,A02,083757,Briones; Jor-el Thomas Caparas,1,0,36,35
1657639347129,MATH 20B,A03,093475,Briones; Jor-el Thomas Caparas,2,0,36,34
1657639353242,MATH 20C,A01,083760,Briones; Jor-el Thomas Caparas,1,0,35,34
1657639353242,MATH 20C,A02,083761,Briones; Jor-el Thomas Caparas,8,0,35,27
1657639353242,MATH 20C,A03,093476,Briones; Jor-el Thomas Caparas,0,1,36,36
1657639353242,MATH 20C,B01,083762,Bach; Quang Tran,1,0,30,29
1657639359268,MATH 20D,A01,083765,Tran; Brian Kha,5,0,30,25
1657639359268,MATH 20D,A02,083766,Tran; Brian Kha,5,0,30,25
1657639359268,MATH 20D,A03,083767,Tran; Brian Kha,5,0,30,25
1657639365300,MATH 20E,A01,083771,Ganguly; Soumya,9,0,32,23
1657639365300,MATH 20E,A02,083772,Ganguly; Soumya,6,0,32,26
1657639365300,MATH 20E,B01,083773,Ciotti; Benjamin,20,0,35,15
1657639365300,MATH 20E,B02,083774,Ciotti; Benjamin,18,0,35,17
1657639371336,MATH 103A,A01,083777,Greenfeld; Be'Eri,3,0,36,33
1657639371336,MATH 103A,A02,083778,Greenfeld; Be'Eri,5,0,36,31
1657639371336,MATH 103A,A03,093561,Greenfeld; Be'Eri,6,0,36,30
1657639371336,MATH 103A,B01,083779,Greenfeld; Be'Eri,7,0,36,29
1657639371336,MATH 103A,B02,083780,Greenfeld; Be'Eri,4,0,36,32
1657639371336,MATH 103A,B03,093562,Greenfeld; Be'Eri,3,0,36,33
1657639377359,MATH 105,A01,085443,Carter; Anne Toulson,15,0,35,20
1657639377359,MATH 105,A02,093477,Carter; Anne Toulson,20,0,35,15
1657639383384,MATH 109,A01,083213,Ganzberger; Geoffrey Michael,2,0,34,32
1657639383384,MATH 109,A02,083214,Ganzberger; Geoffrey Michael,4,0,34,30
1657639383384,MATH 109,A03,093478,Ganzberger; Geoffrey Michael,2,0,34,32
1657639383384,MATH 109,B01,083215,Ganzberger; Geoffrey Michael,1,0,32,31
1657639383384,MATH 109,B02,083216,Ganzberger; Geoffrey Michael,2,0,32,30
1657639383384,MATH 109,B03,093479,Ganzberger; Geoffrey Michael,8,0,32,24
1657639389408,MATH 142A,A01,083219,Chow; Bennett,7,0,32,25
1657639389408,MATH 142A,A02,083220,Chow; Bennett,10,0,32,22
1657639389408,MATH 142A,A03,093480,Chow; Bennett,9,0,32,23
1657639389408,MATH 142A,B03,093481,Chow; Bennett,8,0,32,24
1657639389408,MATH 142A,B04,093558,Chow; Bennett,13,0,32,19
1657639389408,MATH 142A,B05,093559,Chow; Bennett,6,0,32,26
1657639395433,MATH 193A,A01,083224,Rotar; Vladimir,8,0,34,26
1657639395433,MATH 193A,A02,083225,Rotar; Vladimir,9,0,34,25
1657639395433,MATH 193A,A03,083781,Rotar; Vladimir,5,0,34,29
1657639395433,MATH 193A,A04,083782,Rotar; Vladimir,10,0,34,24
1657639395433,MATH 193A,A05,093482,Rotar; Vladimir,10,0,34,24
1657639401458,MATH 197,001,091859,McAuley; Julian John,9999,0,9999,0
1657639401458,MATH 197,002,095566,Kedlaya; Kiran S.,9997,0,9999,2
1657639401458,MATH 197,003,095567,Xiao; Ming,9999,0,9999,0
1657639401458,MATH 197,004,095571,Perols; Johan Lars,9998,0,9999,1
1657639408523,COGS 9,A01,083615,Shannon; Kyle Michael,9,0,75,66
1657639414547,COGS 11,A01,083617,Boyle; Mary E. T.,23,0,48,25
1657639420578,COGS 13,A01,083071,Bastos; Amalia Pinkusfeld,11,0,71,60
1657639426616,COGS 14A,A01,092681,Semenuks; Arturs,5,1,100,95
1657639432640,COGS 14B,A01,083073,Cheng; Tzu-Han,6,0,63,57
1657639438665,COGS 17,A01,092677,Semenuks; Arturs,6,0,81,75
1657639444688,COGS 100,A01,083619,Allen; Michael Gordon,17,0,70,53
1657639450711,COGS 101A,A01,083621,Davis; Joshua Daniel,9,0,68,59
1657639456739,COGS 101B,A01,091572,Allen; Michael Gordon,12,0,65,53
1657639462775,COGS 101C,A01,083625,Delgado; Tania,17,0,35,18
1657639468800,COGS 107A,A01,083627,Boyle; Mary E. T.,13,0,60,47
1657639474828,COGS 118A,A01,083075,Gupta; Anjum,21,0,76,55
1657639480864,CSE 3,A50,083646,Miranda; Gregory Joseph,24,0,50,26
1657639486890,CSE 8A,A50,083650,Miranda; Gregory Joseph,17,1,56,39
1657639492915,CSE 11,A01,083080,Cao; Yingjun,6,15,40,34
1657639498940,CSE 12,A01,083652,Krause-Levy; Sophia Louisa,28,1,120,92
1657639504965,CSE 15L,A01,083654,Morris; Justin Loren,9,0,50,41
1657639504965,CSE 15L,A02,083655,Morris; Justin Loren,9,0,50,41
1657639510994,CSE 20,A01,083657,Tran; Khoa Dang,39,0,80,41
1657639517024,CSE 21,A01,095574,Bach; Quang Tran,22,0,48,26
1657639523052,CSE 30,A01,083084,Eldon; John,6,0,80,74
1657639523052,CSE 30,B01,095061,Bhaskar; Nishant,9,0,50,41
1657639529081,CSE 100,A01,083659,Cao; Yingjun,5,4,70,65
1657639535116,CSE 134B,A01,083661,Powell; Thomas Allan,22,0,100,78
1657639541139,CSE 140,A01,083663,Gungor; Onat,15,0,85,70
1657639547162,CSE 140L,A01,083088,Eldon; John,21,0,100,79
1657639553213,CSE 175,A01,083665,Kumar; Rakesh,3,0,25,22
1657639559244,CSE 190,A00,092507,Dubnov; Shlomo,8,0,20,12
1657639565275,ECE 45,A01,083139,Congero; Spencer William,6,0,75,69
1657639571300,ECE 65,A50,083695,Saad; Andrew S,12,0,30,18
1657639571300,ECE 65,A51,095125,Saad; Andrew S,24,0,26,2
1657639577327,ECE 109,A01,091882,Touri; Behrouz,19,0,70,51
1657639583354,ECE 180,A00,083140,Abi Samra; Nicholas Camill,1,0,30,29
1657639583354,ECE 180,B00,083141,Abi Samra; Nicholas Camill,0,0,30,30
1657639589384,MATH 10A,A01,083735,Patchell; Gregory David,2,0,30,28
1657639589384,MATH 10A,A02,083736,Patchell; Gregory David,20,0,30,10
1657639589384,MATH 10A,A03,083737,Patchell; Gregory David,16,0,30,14
1657639595410,MATH 10B,A01,083207,Lim; Seonhee,8,0,34,26
1657639595410,MATH 10B,A02,083208,Lim; Seonhee,9,0,35,26
1657639595410,MATH 10B,A03,093472,Lim; Seonhee,7,0,34,27
1657639595410,MATH 10B,B01,083739,Sinha; Shubham,12,0,30,18
1657639601438,MATH 18,A01,083743,Cinel; Cameron Alexander,7,0,30,23
1657639601438,MATH 18,A02,083744,Cinel; Cameron Alexander,17,0,30,13
1657639601438,MATH 18,A03,083745,Cinel; Cameron Alexander,9,0,30,21
1657639601438,MATH 18,B01,083748,Rideout; David Porter,5,0,37,32
1657639601438,MATH 18,B02,083749,Rideout; David Porter,5,0,36,31
1657639601438,MATH 18,B03,083750,Rideout; David Porter,3,0,37,34
1657639601438,MATH 18,B04,083751,Rideout; David Porter,6,0,36,30
1657639601438,MATH 18,B05,093473,Rideout; David Porter,6,0,36,30
1657639601438,MATH 18,B06,093474,Rideout; David Porter,6,0,36,30
1657639607460,MATH 20A,A01,083754,Zheng; Zequn,14,0,40,26
1657639613493,MATH 20B,A01,083756,Briones; Jor-el Thomas Caparas,4,0,36,32
1657639613493,MATH 20B,A02,083757,Briones; Jor-el Thomas Caparas,1,0,36,35
1657639613493,MATH 20B,A03,093475,Briones; Jor-el Thomas Caparas,2,0,36,34
1657639619516,MATH 20C,A01,083760,Briones; Jor-el Thomas Caparas,1,0,35,34
1657639619516,MATH 20C,A02,083761,Briones; Jor-el Thomas Caparas,8,0,35,27
1657639619516,MATH 20C,A03,093476,Briones; Jor-el Thomas Caparas,0,1,36,36
1657639619516,MATH 20C,B01,083762,Bach; Quang Tran,1,0,30,29
1657639625540,MATH 20D,A01,083765,Tran; Brian Kha,5,0,30,25
1657639625540,MATH 20D,A02,083766,Tran; Brian Kha,5,0,30,25
1657639625540,MATH 20D,A03,083767,Tran; Brian Kha,5,0,30,25
1657639631566,MATH 20E,A01,083771,Ganguly; Soumya,9,0,32,23
1657639631566,MATH 20E,A02,083772,Ganguly; Soumya,6,0,32,26
1657639631566,MATH 20E,B01,083773,Ciotti; Benjamin,20,0,35,15
1657639631566,MATH 20E,B02,083774,Ciotti; Benjamin,18,0,35,17
1657639637602,MATH 103A,A01,083777,Greenfeld; Be'Eri,3,0,36,33
1657639637602,MATH 103A,A02,083778,Greenfeld; Be'Eri,5,0,36,31
1657639637602,MATH 103A,A03,093561,Greenfeld; Be'Eri,6,0,36,30
1657639637602,MATH 103A,B01,083779,Greenfeld; Be'Eri,7,0,36,29
1657639637602,MATH 103A,B02,083780,Greenfeld; Be'Eri,4,0,36,32
1657639637602,MATH 103A,B03,093562,Greenfeld; Be'Eri,3,0,36,33
1657639643630,MATH 105,A01,085443,Carter; Anne Toulson,15,0,35,20
1657639643630,MATH 105,A02,093477,Carter; Anne Toulson,20,0,35,15
1657639649656,MATH 109,A01,083213,Ganzberger; Geoffrey Michael,2,0,34,32
1657639649656,MATH 109,A02,083214,Ganzberger; Geoffrey Michael,4,0,34,30
1657639649656,MATH 109,A03,093478,Ganzberger; Geoffrey Michael,2,0,34,32
1657639649656,MATH 109,B01,083215,Ganzberger; Geoffrey Michael,1,0,32,31
1657639649656,MATH 109,B02,083216,Ganzberger; Geoffrey Michael,2,0,32,30
1657639649656,MATH 109,B03,093479,Ganzberger; Geoffrey Michael,8,0,32,24
1657639655683,MATH 142A,A01,083219,Chow; Bennett,7,0,32,25
1657639655683,MATH 142A,A02,083220,Chow; Bennett,10,0,32,22
1657639655683,MATH 142A,A03,093480,Chow; Bennett,9,0,32,23
1657639655683,MATH 142A,B03,093481,Chow; Bennett,8,0,32,24
1657639655683,MATH 142A,B04,093558,Chow; Bennett,13,0,32,19
1657639655683,MATH 142A,B05,093559,Chow; Bennett,6,0,32,26
1657639661706,MATH 193A,A01,083224,Rotar; Vladimir,8,0,34,26
1657639661706,MATH 193A,A02,083225,Rotar; Vladimir,9,0,34,25
1657639661706,MATH 193A,A03,083781,Rotar; Vladimir,5,0,34,29
1657639661706,MATH 193A,A04,083782,Rotar; Vladimir,10,0,34,24
1657639661706,MATH 193A,A05,093482,Rotar; Vladimir,10,0,34,24
1657639667733,MATH 197,001,091859,McAuley; Julian John,9999,0,9999,0
1657639667733,MATH 197,002,095566,Kedlaya; Kiran S.,9997,0,9999,2
1657639667733,MATH 197,003,095567,Xiao; Ming,9999,0,9999,0
1657639667733,MATH 197,004,095571,Perols; Johan Lars,9998,0,9999,1
1657639674800,COGS 9,A01,083615,Shannon; Kyle Michael,9,0,75,66
1657639680831,COGS 11,A01,083617,Boyle; Mary E. T.,23,0,48,25
1657639686856,COGS 13,A01,083071,Bastos; Amalia Pinkusfeld,11,0,71,60
1657639692881,COGS 14A,A01,092681,Semenuks; Arturs,5,1,100,95
1657639698913,COGS 14B,A01,083073,Cheng; Tzu-Han,6,0,63,57
1657639704936,COGS 17,A01,092677,Semenuks; Arturs,6,0,81,75
1657639710959,COGS 100,A01,083619,Allen; Michael Gordon,17,0,70,53
1657639716995,COGS 101A,A01,083621,Davis; Joshua Daniel,9,0,68,59
1657639723025,COGS 101B,A01,091572,Allen; Michael Gordon,12,0,65,53
1657639729049,COGS 101C,A01,083625,Delgado; Tania,17,0,35,18
1657639735076,COGS 107A,A01,083627,Boyle; Mary E. T.,13,0,60,47
1657639741101,COGS 118A,A01,083075,Gupta; Anjum,21,0,76,55
1657639747135,CSE 3,A50,083646,Miranda; Gregory Joseph,24,0,50,26
1657639753162,CSE 8A,A50,083650,Miranda; Gregory Joseph,17,1,56,39
1657639759185,CSE 11,A01,083080,Cao; Yingjun,6,15,40,34
1657639765210,CSE 12,A01,083652,Krause-Levy; Sophia Louisa,28,1,120,92
1657639771240,CSE 15L,A01,083654,Morris; Justin Loren,9,0,50,41
1657639771240,CSE 15L,A02,083655,Morris; Justin Loren,9,0,50,41
1657639777263,CSE 20,A01,083657,Tran; Khoa Dang,39,0,80,41
1657639783291,CSE 21,A01,095574,Bach; Quang Tran,22,0,48,26
1657639789315,CSE 30,A01,083084,Eldon; John,6,0,80,74
1657639789315,CSE 30,B01,095061,Bhaskar; Nishant,9,0,50,41
1657639795341,CSE 100,A01,083659,Cao; Yingjun,5,4,70,65
1657639801367,CSE 134B,A01,083661,Powell; Thomas Allan,22,0,100,78
1657639807394,CSE 140,A01,083663,Gungor; Onat,15,0,85,70
1657639813418,CSE 140L,A01,083088,Eldon; John,21,0,100,79
1657639819444,CSE 175,A01,083665,Kumar; Rakesh,3,0,25,22
1657639825472,CSE 190,A00,092507,Dubnov; Shlomo,8,0,20,12
1657639831501,ECE 45,A01,083139,Congero; Spencer William,6,0,75,69
1657639837525,ECE 65,A50,083695,Saad; Andrew S,12,0,30,18
1657639837525,ECE 65,A51,095125,Saad; Andrew S,24,0,26,2
1657639843556,ECE 109,A01,091882,Touri; Behrouz,19,0,70,51
1657639849580,ECE 180,A00,083140,Abi Samra; Nicholas Camill,1,0,30,29
1657639849580,ECE 180,B00,083141,Abi Samra; Nicholas Camill,0,0,30,30
1657639855605,MATH 10A,A01,083735,Patchell; Gregory David,2,0,30,28
1657639855605,MATH 10A,A02,083736,Patchell; Gregory David,20,0,30,10
1657639855605,MATH 10A,A03,083737,Patchell; Gregory David,16,0,30,14
1657639861630,MATH 10B,A01,083207,Lim; Seonhee,8,0,34,26
1657639861630,MATH 10B,A02,083208,Lim; Seonhee,9,0,35,26
1657639861630,MATH 10B,A03,093472,Lim; Seonhee,7,0,34,27
1657639861630,MATH 10B,B01,083739,Sinha; Shubham,12,0,30,18
1657639867669,MATH 18,A01,083743,Cinel; Cameron Alexander,7,0,30,23
1657639867669,MATH 18,A02,083744,Cinel; Cameron Alexander,17,0,30,13
1657639867669,MATH 18,A03,083745,Cinel; Cameron Alexander,9,0,30,21
1657639867669,MATH 18,B01,083748,Rideout; David Porter,5,0,37,32
1657639867669,MATH 18,B02,083749,Rideout; David Porter,5,0,36,31
1657639867669,MATH 18,B03,083750,Rideout; David Porter,3,0,37,34
1657639867669,MATH 18,B04,083751,Rideout; David Porter,6,0,36,30
1657639867669,MATH 18,B05,093473,Rideout; David Porter,6,0,36,30
1657639867669,MATH 18,B06,093474,Rideout; David Porter,6,0,36,30
1657639873692,MATH 20A,A01,083754,Zheng; Zequn,14,0,40,26
1657639879721,MATH 20B,A01,083756,Briones; Jor-el Thomas Caparas,4,0,36,32
1657639879721,MATH 20B,A02,083757,Briones; Jor-el Thomas Caparas,1,0,36,35
1657639879721,MATH 20B,A03,093475,Briones; Jor-el Thomas Caparas,2,0,36,34
1657639885753,MATH 20C,A01,083760,Briones; Jor-el Thomas Caparas,1,0,35,34
1657639885753,MATH 20C,A02,083761,Briones; Jor-el Thomas Caparas,8,0,35,27
1657639885753,MATH 20C,A03,093476,Briones; Jor-el Thomas Caparas,0,1,36,36
1657639885753,MATH 20C,B01,083762,Bach; Quang Tran,1,0,30,29
1657639891783,MATH 20D,A01,083765,Tran; Brian Kha,5,0,30,25
1657639891783,MATH 20D,A02,083766,Tran; Brian Kha,5,0,30,25
1657639891783,MATH 20D,A03,083767,Tran; Brian Kha,5,0,30,25
1657639897815,MATH 20E,A01,083771,Ganguly; Soumya,9,0,32,23
1657639897815,MATH 20E,A02,083772,Ganguly; Soumya,6,0,32,26
1657639897815,MATH 20E,B01,083773,Ciotti; Benjamin,20,0,35,15
1657639897815,MATH 20E,B02,083774,Ciotti; Benjamin,18,0,35,17
1657639903842,MATH 103A,A01,083777,Greenfeld; Be'Eri,3,0,36,33
1657639903842,MATH 103A,A02,083778,Greenfeld; Be'Eri,5,0,36,31
1657639903842,MATH 103A,A03,093561,Greenfeld; Be'Eri,6,0,36,30
1657639903842,MATH 103A,B01,083779,Greenfeld; Be'Eri,7,0,36,29
1657639903842,MATH 103A,B02,083780,Greenfeld; Be'Eri,4,0,36,32
1657639903842,MATH 103A,B03,093562,Greenfeld; Be'Eri,3,0,36,33
1657639909868,MATH 105,A01,085443,Carter; Anne Toulson,15,0,35,20
1657639909868,MATH 105,A02,093477,Carter; Anne Toulson,20,0,35,15
1657639915900,MATH 109,A01,083213,Ganzberger; Geoffrey Michael,2,0,34,32
1657639915900,MATH 109,A02,083214,Ganzberger; Geoffrey Michael,4,0,34,30
1657639915900,MATH 109,A03,093478,Ganzberger; Geoffrey Michael,2,0,34,32
1657639915900,MATH 109,B01,083215,Ganzberger; Geoffrey Michael,1,0,32,31
1657639915900,MATH 109,B02,083216,Ganzberger; Geoffrey Michael,2,0,32,30
1657639915900,MATH 109,B03,093479,Ganzberger; Geoffrey Michael,8,0,32,24
1657639921937,MATH 142A,A01,083219,Chow; Bennett,7,0,32,25
1657639921937,MATH 142A,A02,083220,Chow; Bennett,10,0,32,22
1657639921937,MATH 142A,A03,093480,Chow; Bennett,9,0,32,23
1657639921937,MATH 142A,B03,093481,Chow; Bennett,8,0,32,24
1657639921937,MATH 142A,B04,093558,Chow; Bennett,13,0,32,19
1657639921937,MATH 142A,B05,093559,Chow; Bennett,6,0,32,26
1657639927969,MATH 193A,A01,083224,Rotar; Vladimir,8,0,34,26
1657639927969,MATH 193A,A02,083225,Rotar; Vladimir,9,0,34,25
1657639927969,MATH 193A,A03,083781,Rotar; Vladimir,5,0,34,29
1657639927969,MATH 193A,A04,083782,Rotar; Vladimir,10,0,34,24
1657639927969,MATH 193A,A05,093482,Rotar; Vladimir,10,0,34,24
1657639933999,MATH 197,001,091859,McAuley; Julian John,9999,0,9999,0
1657639933999,MATH 197,002,095566,Kedlaya; Kiran S.,9997,0,9999,2
1657639933999,MATH 197,003,095567,Xiao; Ming,9999,0,9999,0
1657639933999,MATH 197,004,095571,Perols; Johan Lars,9998,0,9999,1
1657639941060,COGS 9,A01,083615,Shannon; Kyle Michael,9,0,75,66
1657639947190,COGS 11,A01,083617,Boyle; Mary E. T.,23,0,48,25
1657639953218,COGS 13,A01,083071,Bastos; Amalia Pinkusfeld,11,0,71,60
1657639959245,COGS 14A,A01,092681,Semenuks; Arturs,5,1,100,95
1657639965270,COGS 14B,A01,083073,Cheng; Tzu-Han,6,0,63,57
1657639971299,COGS 17,A01,092677,Semenuks; Arturs,6,0,81,75
1657639977323,COGS 100,A01,083619,Allen; Michael Gordon,17,0,70,53
1657639983348,COGS 101A,A01,083621,Davis; Joshua Daniel,9,0,68,59
1657639989373,COGS 101B,A01,091572,Allen; Michael Gordon,12,0,65,53
1657639995396,COGS 101C,A01,083625,Delgado; Tania,17,0,35,18
1657640001419,COGS 107A,A01,083627,Boyle; Mary E. T.,13,0,60,47
1657640007442,COGS 118A,A01,083075,Gupta; Anjum,21,0,76,55
1657640013472,CSE 3,A50,083646,Miranda; Gregory Joseph,24,0,50,26
1657640019497,CSE 8A,A50,083650,Miranda; Gregory Joseph,17,1,56,39
1657640025520,CSE 11,A01,083080,Cao; Yingjun,6,15,40,34
1657640031549,CSE 12,A01,083652,Krause-Levy; Sophia Louisa,28,1,120,92
1657640037584,CSE 15L,A01,083654,Morris; Justin Loren,9,0,50,41
1657640037584,CSE 15L,A02,083655,Morris; Justin Loren,9,0,50,41
1657640043613,CSE 20,A01,083657,Tran; Khoa Dang,39,0,80,41
1657640049641,CSE 21,A01,095574,Bach; Quang Tran,22,0,48,26
1657640055669,CSE 30,A01,083084,Eldon; John,6,0,80,74
1657640055669,CSE 30,B01,095061,Bhaskar; Nishant,9,0,50,41
1657640061698,CSE 100,A01,083659,Cao; Yingjun,5,4,70,65
1657640067726,CSE 134B,A01,083661,Powell; Thomas Allan,22,0,100,78
1657640073751,CSE 140,A01,083663,Gungor; Onat,15,0,85,70
1657640079781,CSE 140L,A01,083088,Eldon; John,21,0,100,79
1657640085809,CSE 175,A01,083665,Kumar; Rakesh,3,0,25,22
1657640091835,CSE 190,A00,092507,Dubnov; Shlomo,8,0,20,12
1657640097867,ECE 45,A01,083139,Congero; Spencer William,6,0,75,69
1657640103900,ECE 65,A50,083695,Saad; Andrew S,12,0,30,18
1657640103900,ECE 65,A51,095125,Saad; Andrew S,24,0,26,2
1657640109923,ECE 109,A01,091882,Touri; Behrouz,19,0,70,51
1657640115965,ECE 180,A00,083140,Abi Samra; Nicholas Camill,1,0,30,29
1657640115965,ECE 180,B00,083141,Abi Samra; Nicholas Camill,0,0,30,30
1657640121991,MATH 10A,A01,083735,Patchell; Gregory David,2,0,30,28
1657640121991,MATH 10A,A02,083736,Patchell; Gregory David,20,0,30,10
1657640121991,MATH 10A,A03,083737,Patchell; Gregory David,16,0,30,14
1657640128025,MATH 10B,A01,083207,Lim; Seonhee,8,0,34,26
1657640128025,MATH 10B,A02,083208,Lim; Seonhee,9,0,35,26
1657640128025,MATH 10B,A03,093472,Lim; Seonhee,7,0,34,27
1657640128025,MATH 10B,B01,083739,Sinha; Shubham,12,0,30,18
1657640134063,MATH 18,A01,083743,Cinel; Cameron Alexander,7,0,30,23
1657640134063,MATH 18,A02,083744,Cinel; Cameron Alexander,17,0,30,13
1657640134063,MATH 18,A03,083745,Cinel; Cameron Alexander,9,0,30,21
1657640134063,MATH 18,B01,083748,Rideout; David Porter,5,0,37,32
1657640134063,MATH 18,B02,083749,Rideout; David Porter,5,0,36,31
1657640134063,MATH 18,B03,083750,Rideout; David Porter,3,0,37,34
1657640134063,MATH 18,B04,083751,Rideout; David Porter,6,0,36,30
1657640134063,MATH 18,B05,093473,Rideout; David Porter,6,0,36,30
1657640134063,MATH 18,B06,093474,Rideout; David Porter,6,0,36,30
1657640140086,MATH 20A,A01,083754,Zheng; Zequn,14,0,40,26
1657640146123,MATH 20B,A01,083756,Briones; Jor-el Thomas Caparas,4,0,36,32
1657640146123,MATH 20B,A02,083757,Briones; Jor-el Thomas Caparas,1,0,36,35
1657640146123,MATH 20B,A03,093475,Briones; Jor-el Thomas Caparas,2,0,36,34
1657640152154,MATH 20C,A01,083760,Briones; Jor-el Thomas Caparas,1,0,35,34
1657640152154,MATH 20C,A02,083761,Briones; Jor-el Thomas Caparas,8,0,35,27
1657640152154,MATH 20C,A03,093476,Briones; Jor-el Thomas Caparas,0,1,36,36
1657640152154,MATH 20C,B01,083762,Bach; Quang Tran,1,0,30,29
1657640158183,MATH 20D,A01,083765,Tran; Brian Kha,5,0,30,25
1657640158183,MATH 20D,A02,083766,Tran; Brian Kha,5,0,30,25
1657640158183,MATH 20D,A03,083767,Tran; Brian Kha,5,0,30,25
1657640164208,MATH 20E,A01,083771,Ganguly; Soumya,9,0,32,23
1657640164208,MATH 20E,A02,083772,Ganguly; Soumya,6,0,32,26
1657640164208,MATH 20E,B01,083773,Ciotti; Benjamin,20,0,35,15
1657640164208,MATH 20E,B02,083774,Ciotti; Benjamin,18,0,35,17
1657640170242,MATH 103A,A01,083777,Greenfeld; Be'Eri,3,0,36,33
1657640170242,MATH 103A,A02,083778,Greenfeld; Be'Eri,5,0,36,31
1657640170242,MATH 103A,A03,093561,Greenfeld; Be'Eri,6,0,36,30
1657640170242,MATH 103A,B01,083779,Greenfeld; Be'Eri,7,0,36,29
1657640170242,MATH 103A,B02,083780,Greenfeld; Be'Eri,4,0,36,32
1657640170242,MATH 103A,B03,093562,Greenfeld; Be'Eri,3,0,36,33
1657640176274,MATH 105,A01,085443,Carter; Anne Toulson,15,0,35,20
1657640176274,MATH 105,A02,093477,Carter; Anne Toulson,20,0,35,15
1657640182316,MATH 109,A01,083213,Ganzberger; Geoffrey Michael,2,0,34,32
1657640182316,MATH 109,A02,083214,Ganzberger; Geoffrey Michael,4,0,34,30
1657640182316,MATH 109,A03,093478,Ganzberger; Geoffrey Michael,2,0,34,32
1657640182316,MATH 109,B01,083215,Ganzberger; Geoffrey Michael,1,0,32,31
1657640182316,MATH 109,B02,083216,Ganzberger; Geoffrey Michael,2,0,32,30
1657640182316,MATH 109,B03,093479,Ganzberger; Geoffrey Michael,8,0,32,24
1657640188347,MATH 142A,A01,083219,Chow; Bennett,7,0,32,25
1657640188347,MATH 142A,A02,083220,Chow; Bennett,10,0,32,22
1657640188347,MATH 142A,A03,093480,Chow; Bennett,9,0,32,23
1657640188347,MATH 142A,B03,093481,Chow; Bennett,8,0,32,24
1657640188347,MATH 142A,B04,093558,Chow; Bennett,13,0,32,19
1657640188347,MATH 142A,B05,093559,Chow; Bennett,6,0,32,26
1657640194379,MATH 193A,A01,083224,Rotar; Vladimir,8,0,34,26
1657640194379,MATH 193A,A02,083225,Rotar; Vladimir,9,0,34,25
1657640194379,MATH 193A,A03,083781,Rotar; Vladimir,5,0,34,29
1657640194379,MATH 193A,A04,083782,Rotar; Vladimir,10,0,34,24
1657640194379,MATH 193A,A05,093482,Rotar; Vladimir,10,0,34,24
1657640200405,MATH 197,001,091859,McAuley; Julian John,9999,0,9999,0
1657640200405,MATH 197,002,095566,Kedlaya; Kiran S.,9997,0,9999,2
1657640200405,MATH 197,003,095567,Xiao; Ming,9999,0,9999,0
1657640200405,MATH 197,004,095571,Perols; Johan Lars,9998,0,9999,1
1657640207486,COGS 9,A01,083615,Shannon; Kyle Michael,9,0,75,66
1657640213512,COGS 11,A01,083617,Boyle; Mary E. T.,23,0,48,25
1657640219535,COGS 13,A01,083071,Bastos; Amalia Pinkusfeld,11,0,71,60
1657640225567,COGS 14A,A01,092681,Semenuks; Arturs,5,1,100,95
1657640231590,COGS 14B,A01,083073,Cheng; Tzu-Han,6,0,63,57
1657640237616,COGS 17,A01,092677,Semenuks; Arturs,6,0,81,75
1657640243640,COGS 100,A01,083619,Allen; Michael Gordon,17,0,70,53
1657640249671,COGS 101A,A01,083621,Davis; Joshua Daniel,9,0,68,59
1657640255702,COGS 101B,A01,091572,Allen; Michael Gordon,12,0,65,53
1657640261732,COGS 101C,A01,083625,Delgado; Tania,17,0,35,18
1657640267756,COGS 107A,A01,083627,Boyle; Mary E. T.,13,0,60,47
1657640273780,COGS 118A,A01,083075,Gupta; Anjum,21,0,76,55
1657640279805,CSE 3,A50,083646,Miranda; Gregory Joseph,24,0,50,26
1657640285830,CSE 8A,A50,083650,Miranda; Gregory Joseph,17,1,56,39
1657640291853,CSE 11,A01,083080,Cao; Yingjun,6,15,40,34
1657640297880,CSE 12,A01,083652,Krause-Levy; Sophia Louisa,28,1,120,92
1657640303903,CSE 15L,A01,083654,Morris; Justin Loren,9,0,50,41
1657640303903,CSE 15L,A02,083655,Morris; Justin Loren,9,0,50,41
1657640309926,CSE 20,A01,083657,Tran; Khoa Dang,39,0,80,41
1657640315948,CSE 21,A01,095574,Bach; Quang Tran,22,0,48,26
1657640321973,CSE 30,A01,083084,Eldon; John,6,0,80,74
1657640321973,CSE 30,B01,095061,Bhaskar; Nishant,9,0,50,41
1657640327998,CSE 100,A01,083659,Cao; Yingjun,5,4,70,65
1657640334022,CSE 134B,A01,083661,Powell; Thomas Allan,22,0,100,78
1657640340045,CSE 140,A01,083663,Gungor; Onat,15,0,85,70
1657640346085,CSE 140L,A01,083088,Eldon; John,21,0,100,79
1657640352114,CSE 175,A01,083665,Kumar; Rakesh,3,0,25,22
1657640358141,CSE 190,A00,092507,Dubnov; Shlomo,8,0,20,12
1657640364168,ECE 45,A01,083139,Congero; Spencer William,6,0,75,69
1657640370203,ECE 65,A50,083695,Saad; Andrew S,12,0,30,18
1657640370203,ECE 65,A51,095125,Saad; Andrew S,24,0,26,2
1657640376226,ECE 109,A01,091882,Touri; Behrouz,19,0,70,51
1657640382252,ECE 180,A00,083140,Abi Samra; Nicholas Camill,1,0,30,29
1657640382252,ECE 180,B00,083141,Abi Samra; Nicholas Camill,0,0,30,30
1657640388275,MATH 10A,A01,083735,Patchell; Gregory David,2,0,30,28
1657640388275,MATH 10A,A02,083736,Patchell; Gregory David,20,0,30,10
1657640388275,MATH 10A,A03,083737,Patchell; Gregory David,16,0,30,14
1657640394299,MATH 10B,A01,083207,Lim; Seonhee,8,0,34,26
1657640394299,MATH 10B,A02,083208,Lim; Seonhee,9,0,35,26
1657640394299,MATH 10B,A03,093472,Lim; Seonhee,7,0,34,27
1657640394299,MATH 10B,B01,083739,Sinha; Shubham,12,0,30,18
1657640400329,MATH 18,A01,083743,Cinel; Cameron Alexander,7,0,30,23
1657640400329,MATH 18,A02,083744,Cinel; Cameron Alexander,17,0,30,13
1657640400329,MATH 18,A03,083745,Cinel; Cameron Alexander,9,0,30,21
1657640400329,MATH 18,B01,083748,Rideout; David Porter,5,0,37,32
1657640400329,MATH 18,B02,083749,Rideout; David Porter,5,0,36,31
1657640400329,MATH 18,B03,083750,Rideout; David Porter,3,0,37,34
1657640400329,MATH 18,B04,083751,Rideout; David Porter,6,0,36,30
1657640400329,MATH 18,B05,093473,Rideout; David Porter,6,0,36,30
1657640400329,MATH 18,B06,093474,Rideout; David Porter,6,0,36,30
1657640406353,MATH 20A,A01,083754,Zheng; Zequn,14,0,40,26
1657640412384,MATH 20B,A01,083756,Briones; Jor-el Thomas Caparas,4,0,36,32
1657640412384,MATH 20B,A02,083757,Briones; Jor-el Thomas Caparas,1,0,36,35
1657640412384,MATH 20B,A03,093475,Briones; Jor-el Thomas Caparas,2,0,36,34
1657640418410,MATH 20C,A01,083760,Briones; Jor-el Thomas Caparas,1,0,35,34
1657640418410,MATH 20C,A02,083761,Briones; Jor-el Thomas Caparas,8,0,35,27
1657640418410,MATH 20C,A03,093476,Briones; Jor-el Thomas Caparas,0,1,36,36
1657640418410,MATH 20C,B01,083762,Bach; Quang Tran,1,0,30,29
1657640424440,MATH 20D,A01,083765,Tran; Brian Kha,5,0,30,25
1657640424440,MATH 20D,A02,083766,Tran; Brian Kha,5,0,30,25
1657640424440,MATH 20D,A03,083767,Tran; Brian Kha,5,0,30,25
1657640430480,MATH 20E,A01,083771,Ganguly; Soumya,9,0,32,23
1657640430480,MATH 20E,A02,083772,Ganguly; Soumya,6,0,32,26
1657640430480,MATH 20E,B01,083773,Ciotti; Benjamin,20,0,35,15
1657640430480,MATH 20E,B02,083774,Ciotti; Benjamin,18,0,35,17
1657640436506,MATH 103A,A01,083777,Greenfeld; Be'Eri,3,0,36,33
1657640436506,MATH 103A,A02,083778,Greenfeld; Be'Eri,5,0,36,31
1657640436506,MATH 103A,A03,093561,Greenfeld; Be'Eri,6,0,36,30
1657640436506,MATH 103A,B01,083779,Greenfeld; Be'Eri,7,0,36,29
1657640436506,MATH 103A,B02,083780,Greenfeld; Be'Eri,4,0,36,32
1657640436506,MATH 103A,B03,093562,Greenfeld; Be'Eri,3,0,36,33
1657640442529,MATH 105,A01,085443,Carter; Anne Toulson,15,0,35,20
1657640442529,MATH 105,A02,093477,Carter; Anne Toulson,20,0,35,15
1657640448563,MATH 109,A01,083213,Ganzberger; Geoffrey Michael,2,0,34,32
1657640448563,MATH 109,A02,083214,Ganzberger; Geoffrey Michael,4,0,34,30
1657640448563,MATH 109,A03,093478,Ganzberger; Geoffrey Michael,2,0,34,32
1657640448563,MATH 109,B01,083215,Ganzberger; Geoffrey Michael,1,0,32,31
1657640448563,MATH 109,B02,083216,Ganzberger; Geoffrey Michael,2,0,32,30
1657640448563,MATH 109,B03,093479,Ganzberger; Geoffrey Michael,8,0,32,24
1657640454593,MATH 142A,A01,083219,Chow; Bennett,7,0,32,25
1657640454593,MATH 142A,A02,083220,Chow; Bennett,10,0,32,22
1657640454593,MATH 142A,A03,093480,Chow; Bennett,9,0,32,23
1657640454593,MATH 142A,B03,093481,Chow; Bennett,8,0,32,24
1657640454593,MATH 142A,B04,093558,Chow; Bennett,13,0,32,19
1657640454593,MATH 142A,B05,093559,Chow; Bennett,6,0,32,26
1657640460624,MATH 193A,A01,083224,Rotar; Vladimir,8,0,34,26
1657640460624,MATH 193A,A02,083225,Rotar; Vladimir,9,0,34,25
1657640460624,MATH 193A,A03,083781,Rotar; Vladimir,5,0,34,29
1657640460624,MATH 193A,A04,083782,Rotar; Vladimir,10,0,34,24
1657640460624,MATH 193A,A05,093482,Rotar; Vladimir,10,0,34,24
1657640466668,MATH 197,001,091859,McAuley; Julian John,9999,0,9999,0
1657640466668,MATH 197,002,095566,Kedlaya; Kiran S.,9997,0,9999,2
1657640466668,MATH 197,003,095567,Xiao; Ming,9999,0,9999,0
1657640466668,MATH 197,004,095571,Perols; Johan Lars,9998,0,9999,1
1657640473732,COGS 9,A01,083615,Shannon; Kyle Michael,9,0,75,66
1657640479754,COGS 11,A01,083617,Boyle; Mary E. T.,23,0,48,25
1657640485781,COGS 13,A01,083071,Bastos; Amalia Pinkusfeld,11,0,71,60
1657640491806,COGS 14A,A01,092681,Semenuks; Arturs,5,1,100,95
1657640497833,COGS 14B,A01,083073,Cheng; Tzu-Han,6,0,63,57
1657640503857,COGS 17,A01,092677,Semenuks; Arturs,6,0,81,75
1657640509886,COGS 100,A01,083619,Allen; Michael Gordon,17,0,70,53
1657640515908,COGS 101A,A01,083621,Davis; Joshua Daniel,9,0,68,59
1657640521941,COGS 101B,A01,091572,Allen; Michael Gordon,12,0,65,53
1657640527969,COGS 101C,A01,083625,Delgado; Tania,17,0,35,18
1657640534089,COGS 107A,A01,083627,Boyle; Mary E. T.,13,0,60,47
1657640540115,COGS 118A,A01,083075,Gupta; Anjum,21,0,76,55
1657640546226,CSE 3,A50,083646,Miranda; Gregory Joseph,24,0,50,26
1657640552250,CSE 8A,A50,083650,Miranda; Gregory Joseph,17,1,56,39
1657640558278,CSE 11,A01,083080,Cao; Yingjun,6,15,40,34
1657640564300,CSE 12,A01,083652,Krause-Levy; Sophia Louisa,28,1,120,92
1657640570324,CSE 15L,A01,083654,Morris; Justin Loren,9,0,50,41
1657640570324,CSE 15L,A02,083655,Morris; Justin Loren,9,0,50,41
1657640576348,CSE 20,A01,083657,Tran; Khoa Dang,39,0,80,41
1657640582370,CSE 21,A01,095574,Bach; Quang Tran,22,0,48,26
1657640588406,CSE 30,A01,083084,Eldon; John,6,0,80,74
1657640588406,CSE 30,B01,095061,Bhaskar; Nishant,9,0,50,41
1657640594446,CSE 100,A01,083659,Cao; Yingjun,5,4,70,65
1657640600471,CSE 134B,A01,083661,Powell; Thomas Allan,22,0,100,78
1657640606498,CSE 140,A01,083663,Gungor; Onat,15,0,85,70
1657640612522,CSE 140L,A01,083088,Eldon; John,21,0,100,79
1657640618545,CSE 175,A01,083665,Kumar; Rakesh,3,0,25,22
1657640624567,CSE 190,A00,092507,Dubnov; Shlomo,8,0,20,12
1657640630592,ECE 45,A01,083139,Congero; Spencer William,6,0,75,69
1657640636615,ECE 65,A50,083695,Saad; Andrew S,12,0,30,18
1657640636615,ECE 65,A51,095125,Saad; Andrew S,24,0,26,2
1657640642637,ECE 109,A01,091882,Touri; Behrouz,19,0,70,51
1657640648668,ECE 180,A00,083140,Abi Samra; Nicholas Camill,1,0,30,29
1657640648668,ECE 180,B00,083141,Abi Samra; Nicholas Camill,0,0,30,30
1657640654693,MATH 10A,A01,083735,Patchell; Gregory David,2,0,30,28
1657640654693,MATH 10A,A02,083736,Patchell; Gregory David,20,0,30,10
1657640654693,MATH 10A,A03,083737,Patchell; Gregory David,16,0,30,14
1657640660718,MATH 10B,A01,083207,Lim; Seonhee,8,0,34,26
1657640660718,MATH 10B,A02,083208,Lim; Seonhee,9,0,35,26
1657640660718,MATH 10B,A03,093472,Lim; Seonhee,7,0,34,27
1657640660718,MATH 10B,B01,083739,Sinha; Shubham,12,0,30,18
1657640666765,MATH 18,A01,083743,Cinel; Cameron Alexander,7,0,30,23
1657640666765,MATH 18,A02,083744,Cinel; Cameron Alexander,17,0,30,13
1657640666765,MATH 18,A03,083745,Cinel; Cameron Alexander,9,0,30,21
1657640666765,MATH 18,B01,083748,Rideout; David Porter,5,0,37,32
1657640666765,MATH 18,B02,083749,Rideout; David Porter,5,0,36,31
1657640666765,MATH 18,B03,083750,Rideout; David Porter,3,0,37,34
1657640666765,MATH 18,B04,083751,Rideout; David Porter,6,0,36,30
1657640666765,MATH 18,B05,093473,Rideout; David Porter,6,0,36,30
1657640666765,MATH 18,B06,093474,Rideout; David Porter,6,0,36,30
1657640672791,MATH 20A,A01,083754,Zheng; Zequn,14,0,40,26
1657640678826,MATH 20B,A01,083756,Briones; Jor-el Thomas Caparas,4,0,36,32
1657640678826,MATH 20B,A02,083757,Briones; Jor-el Thomas Caparas,1,0,36,35
1657640678826,MATH 20B,A03,093475,Briones; Jor-el Thomas Caparas,2,0,36,34
1657640684850,MATH 20C,A01,083760,Briones; Jor-el Thomas Caparas,1,0,35,34
1657640684850,MATH 20C,A02,083761,Briones; Jor-el Thomas Caparas,8,0,35,27
1657640684850,MATH 20C,A03,093476,Briones; Jor-el Thomas Caparas,0,1,36,36
1657640684850,MATH 20C,B01,083762,Bach; Quang Tran,1,0,30,29
1657640690880,MATH 20D,A01,083765,Tran; Brian Kha,5,0,30,25
1657640690880,MATH 20D,A02,083766,Tran; Brian Kha,5,0,30,25
1657640690880,MATH 20D,A03,083767,Tran; Brian Kha,5,0,30,25
1657640696907,MATH 20E,A01,083771,Ganguly; Soumya,9,0,32,23
1657640696907,MATH 20E,A02,083772,Ganguly; Soumya,6,0,32,26
1657640696907,MATH 20E,B01,083773,Ciotti; Benjamin,20,0,35,15
1657640696907,MATH 20E,B02,083774,Ciotti; Benjamin,18,0,35,17
1657640702936,MATH 103A,A01,083777,Greenfeld; Be'Eri,3,0,36,33
1657640702936,MATH 103A,A02,083778,Greenfeld; Be'Eri,5,0,36,31
1657640702936,MATH 103A,A03,093561,Greenfeld; Be'Eri,6,0,36,30
1657640702936,MATH 103A,B01,083779,Greenfeld; Be'Eri,7,0,36,29
1657640702936,MATH 103A,B02,083780,Greenfeld; Be'Eri,4,0,36,32
1657640702936,MATH 103A,B03,093562,Greenfeld; Be'Eri,3,0,36,33
1657640708974,MATH 105,A01,085443,Carter; Anne Toulson,15,0,35,20
1657640708974,MATH 105,A02,093477,Carter; Anne Toulson,20,0,35,15
1657640714999,MATH 109,A01,083213,Ganzberger; Geoffrey Michael,2,0,34,32
1657640714999,MATH 109,A02,083214,Ganzberger; Geoffrey Michael,4,0,34,30
1657640714999,MATH 109,A03,093478,Ganzberger; Geoffrey Michael,2,0,34,32
1657640714999,MATH 109,B01,083215,Ganzberger; Geoffrey Michael,1,0,32,31
1657640714999,MATH 109,B02,083216,Ganzberger; Geoffrey Michael,2,0,32,30
1657640714999,MATH 109,B03,093479,Ganzberger; Geoffrey Michael,8,0,32,24
1657640721031,MATH 142A,A01,083219,Chow; Bennett,7,0,32,25
1657640721031,MATH 142A,A02,083220,Chow; Bennett,10,0,32,22
1657640721031,MATH 142A,A03,093480,Chow; Bennett,9,0,32,23
1657640721031,MATH 142A,B03,093481,Chow; Bennett,8,0,32,24
1657640721031,MATH 142A,B04,093558,Chow; Bennett,13,0,32,19
1657640721031,MATH 142A,B05,093559,Chow; Bennett,6,0,32,26
1657640727056,MATH 193A,A01,083224,Rotar; Vladimir,8,0,34,26
1657640727056,MATH 193A,A02,083225,Rotar; Vladimir,9,0,34,25
1657640727056,MATH 193A,A03,083781,Rotar; Vladimir,5,0,34,29
1657640727056,MATH 193A,A04,083782,Rotar; Vladimir,10,0,34,24
1657640727056,MATH 193A,A05,093482,Rotar; Vladimir,10,0,34,24
1657640733082,MATH 197,001,091859,McAuley; Julian John,9999,0,9999,0
1657640733082,MATH 197,002,095566,Kedlaya; Kiran S.,9997,0,9999,2
1657640733082,MATH 197,003,095567,Xiao; Ming,9999,0,9999,0
1657640733082,MATH 197,004,095571,Perols; Johan Lars,9998,0,9999,1
1657640740147,COGS 9,A01,083615,Shannon; Kyle Michael,9,0,75,66
1657640746172,COGS 11,A01,083617,Boyle; Mary E. T.,23,0,48,25
1657640752209,COGS 13,A01,083071,Bastos; Amalia Pinkusfeld,11,0,71,60
1657640758246,COGS 14A,A01,092681,Semenuks; Arturs,5,1,100,95
1657640764271,COGS 14B,A01,083073,Cheng; Tzu-Han,6,0,63,57
1657640770299,COGS 17,A01,092677,Semenuks; Arturs,6,0,81,75
1657640776333,COGS 100,A01,083619,Allen; Michael Gordon,17,0,70,53
1657640782368,COGS 101A,A01,083621,Davis; Joshua Daniel,9,0,68,59
1657640788393,COGS 101B,A01,091572,Allen; Michael Gordon,12,0,65,53
1657640794422,COGS 101C,A01,083625,Delgado; Tania,17,0,35,18
1657640800449,COGS 107A,A01,083627,Boyle; Mary E. T.,13,0,60,47
1657640806488,COGS 118A,A01,083075,Gupta; Anjum,21,0,76,55
1657640812520,CSE 3,A50,083646,Miranda; Gregory Joseph,24,0,50,26
1657640818550,CSE 8A,A50,083650,Miranda; Gregory Joseph,17,1,56,39
1657640824575,CSE 11,A01,083080,Cao; Yingjun,6,15,40,34
1657640830603,CSE 12,A01,083652,Krause-Levy; Sophia Louisa,28,1,120,92
1657640836637,CSE 15L,A01,083654,Morris; Justin Loren,9,0,50,41
1657640836637,CSE 15L,A02,083655,Morris; Justin Loren,9,0,50,41
1657640842674,CSE 20,A01,083657,Tran; Khoa Dang,39,0,80,41
1657640848704,CSE 21,A01,095574,Bach; Quang Tran,22,0,48,26
1657640854731,CSE 30,A01,083084,Eldon; John,6,0,80,74
1657640854731,CSE 30,B01,095061,Bhaskar; Nishant,9,0,50,41
1657640860754,CSE 100,A01,083659,Cao; Yingjun,5,4,70,65
1657640866779,CSE 134B,A01,083661,Powell; Thomas Allan,22,0,100,78
1657640872803,CSE 140,A01,083663,Gungor; Onat,15,0,85,70
1657640878826,CSE 140L,A01,083088,Eldon; John,21,0,100,79
1657640884857,CSE 175,A01,083665,Kumar; Rakesh,3,0,25,22
1657640890890,CSE 190,A00,092507,Dubnov; Shlomo,8,0,20,12
1657640896921,ECE 45,A01,083139,Congero; Spencer William,6,0,75,69
1657640902963,ECE 65,A50,083695,Saad; Andrew S,12,0,30,18
1657640902963,ECE 65,A51,095125,Saad; Andrew S,24,0,26,2
1657640908990,ECE 109,A01,091882,Touri; Behrouz,19,0,70,51
1657640915020,ECE 180,A00,083140,Abi Samra; Nicholas Camill,1,0,30,29
1657640915020,ECE 180,B00,083141,Abi Samra; Nicholas Camill,0,0,30,30
1657640921047,MATH 10A,A01,083735,Patchell; Gregory David,2,0,30,28
1657640921047,MATH 10A,A02,083736,Patchell; Gregory David,20,0,30,10
1657640921047,MATH 10A,A03,083737,Patchell; Gregory David,16,0,30,14
1657640927084,MATH 10B,A01,083207,Lim; Seonhee,8,0,34,26
1657640927084,MATH 10B,A02,083208,Lim; Seonhee,9,0,35,26
1657640927084,MATH 10B,A03,093472,Lim; Seonhee,7,0,34,27
1657640927084,MATH 10B,B01,083739,Sinha; Shubham,12,0,30,18
1657640933112,MATH 18,A01,083743,Cinel; Cameron Alexander,7,0,30,23
1657640933112,MATH 18,A02,083744,Cinel; Cameron Alexander,17,0,30,13
1657640933112,MATH 18,A03,083745,Cinel; Cameron Alexander,9,0,30,21
1657640933112,MATH 18,B01,083748,Rideout; David Porter,5,0,37,32
1657640933112,MATH 18,B02,083749,Rideout; David Porter,5,0,36,31
1657640933112,MATH 18,B03,083750,Rideout; David Porter,3,0,37,34
1657640933112,MATH 18,B04,083751,Rideout; David Porter,6,0,36,30
1657640933112,MATH 18,B05,093473,Rideout; David Porter,6,0,36,30
1657640933112,MATH 18,B06,093474,Rideout; David Porter,6,0,36,30
1657640939143,MATH 20A,A01,083754,Zheng; Zequn,14,0,40,26
1657640945168,MATH 20B,A01,083756,Briones; Jor-el Thomas Caparas,4,0,36,32
1657640945168,MATH 20B,A02,083757,Briones; Jor-el Thomas Caparas,1,0,36,35
1657640945168,MATH 20B,A03,093475,Briones; Jor-el Thomas Caparas,2,0,36,34
1657640951194,MATH 20C,A01,083760,Briones; Jor-el Thomas Caparas,1,0,35,34
1657640951194,MATH 20C,A02,083761,Briones; Jor-el Thomas Caparas,8,0,35,27
1657640951194,MATH 20C,A03,093476,Briones; Jor-el Thomas Caparas,0,1,36,36
1657640951194,MATH 20C,B01,083762,Bach; Quang Tran,1,0,30,29
1657640957224,MATH 20D,A01,083765,Tran; Brian Kha,5,0,30,25
1657640957224,MATH 20D,A02,083766,Tran; Brian Kha,5,0,30,25
1657640957224,MATH 20D,A03,083767,Tran; Brian Kha,5,0,30,25
1657640963260,MATH 20E,A01,083771,Ganguly; Soumya,9,0,32,23
1657640963260,MATH 20E,A02,083772,Ganguly; Soumya,6,0,32,26
1657640963260,MATH 20E,B01,083773,Ciotti; Benjamin,20,0,35,15
1657640963260,MATH 20E,B02,083774,Ciotti; Benjamin,18,0,35,17
1657640969293,MATH 103A,A01,083777,Greenfeld; Be'Eri,3,0,36,33
1657640969293,MATH 103A,A02,083778,Greenfeld; Be'Eri,5,0,36,31
1657640969293,MATH 103A,A03,093561,Greenfeld; Be'Eri,6,0,36,30
1657640969293,MATH 103A,B01,083779,Greenfeld; Be'Eri,7,0,36,29
1657640969293,MATH 103A,B02,083780,Greenfeld; Be'Eri,4,0,36,32
1657640969293,MATH 103A,B03,093562,Greenfeld; Be'Eri,3,0,36,33
1657640975319,MATH 105,A01,085443,Carter; Anne Toulson,15,0,35,20
1657640975319,MATH 105,A02,093477,Carter; Anne Toulson,20,0,35,15
1657640981351,MATH 109,A01,083213,Ganzberger; Geoffrey Michael,2,0,34,32
1657640981351,MATH 109,A02,083214,Ganzberger; Geoffrey Michael,4,0,34,30
1657640981351,MATH 109,A03,093478,Ganzberger; Geoffrey Michael,2,0,34,32
1657640981351,MATH 109,B01,083215,Ganzberger; Geoffrey Michael,1,0,32,31
1657640981351,MATH 109,B02,083216,Ganzberger; Geoffrey Michael,2,0,32,30
1657640981351,MATH 109,B03,093479,Ganzberger; Geoffrey Michael,8,0,32,24
1657640987383,MATH 142A,A01,083219,Chow; Bennett,7,0,32,25
1657640987383,MATH 142A,A02,083220,Chow; Bennett,10,0,32,22
1657640987383,MATH 142A,A03,093480,Chow; Bennett,9,0,32,23
1657640987383,MATH 142A,B03,093481,Chow; Bennett,8,0,32,24
1657640987383,MATH 142A,B04,093558,Chow; Bennett,13,0,32,19
1657640987383,MATH 142A,B05,093559,Chow; Bennett,6,0,32,26
1657640993409,MATH 193A,A01,083224,Rotar; Vladimir,8,0,34,26
1657640993409,MATH 193A,A02,083225,Rotar; Vladimir,9,0,34,25
1657640993409,MATH 193A,A03,083781,Rotar; Vladimir,5,0,34,29
1657640993409,MATH 193A,A04,083782,Rotar; Vladimir,10,0,34,24
1657640993409,MATH 193A,A05,093482,Rotar; Vladimir,10,0,34,24
1657640999432,MATH 197,001,091859,McAuley; Julian John,9999,0,9999,0
1657640999432,MATH 197,002,095566,Kedlaya; Kiran S.,9997,0,9999,2
1657640999432,MATH 197,003,095567,Xiao; Ming,9999,0,9999,0
1657640999432,MATH 197,004,095571,Perols; Johan Lars,9998,0,9999,1
1657641006500,COGS 9,A01,083615,Shannon; Kyle Michael,9,0,75,66
1657641012529,COGS 11,A01,083617,Boyle; Mary E. T.,23,0,48,25
1657641018553,COGS 13,A01,083071,Bastos; Amalia Pinkusfeld,11,0,71,60
1657641024582,COGS 14A,A01,092681,Semenuks; Arturs,5,1,100,95
1657641030606,COGS 14B,A01,083073,Cheng; Tzu-Han,6,0,63,57
1657641036646,COGS 17,A01,092677,Semenuks; Arturs,6,0,81,75
1657641042670,COGS 100,A01,083619,Allen; Michael Gordon,17,0,70,53
1657641048715,COGS 101A,A01,083621,Davis; Joshua Daniel,9,0,68,59
1657641054738,COGS 101B,A01,091572,Allen; Michael Gordon,12,0,65,53
1657641060767,COGS 101C,A01,083625,Delgado; Tania,17,0,35,18
1657641066796,COGS 107A,A01,083627,Boyle; Mary E. T.,13,0,60,47
1657641072818,COGS 118A,A01,083075,Gupta; Anjum,21,0,76,55
1657641078849,CSE 3,A50,083646,Miranda; Gregory Joseph,24,0,50,26
1657641084879,CSE 8A,A50,083650,Miranda; Gregory Joseph,17,1,56,39
1657641090906,CSE 11,A01,083080,Cao; Yingjun,6,15,40,34
1657641096937,CSE 12,A01,083652,Krause-Levy; Sophia Louisa,28,1,120,92
1657641102966,CSE 15L,A01,083654,Morris; Justin Loren,9,0,50,41
1657641102966,CSE 15L,A02,083655,Morris; Justin Loren,9,0,50,41
1657641108995,CSE 20,A01,083657,Tran; Khoa Dang,39,0,80,41
1657641115028,CSE 21,A01,095574,Bach; Quang Tran,22,0,48,26
1657641121052,CSE 30,A01,083084,Eldon; John,6,0,80,74
1657641121052,CSE 30,B01,095061,Bhaskar; Nishant,9,0,50,41
1657641127076,CSE 100,A01,083659,Cao; Yingjun,5,4,70,65
1657641133100,CSE 134B,A01,083661,Powell; Thomas Allan,22,0,100,78
1657641139128,CSE 140,A01,083663,Gungor; Onat,15,0,85,70
1657641145250,CSE 140L,A01,083088,Eldon; John,21,0,100,79
1657641151293,CSE 175,A01,083665,Kumar; Rakesh,3,0,25,22
1657641157335,CSE 190,A00,092507,Dubnov; Shlomo,8,0,20,12
1657641163369,ECE 45,A01,083139,Congero; Spencer William,6,0,75,69
1657641169403,ECE 65,A50,083695,Saad; Andrew S,12,0,30,18
1657641169403,ECE 65,A51,095125,Saad; Andrew S,24,0,26,2
1657641175427,ECE 109,A01,091882,Touri; Behrouz,19,0,70,51
1657641181461,ECE 180,A00,083140,Abi Samra; Nicholas Camill,1,0,30,29
1657641181461,ECE 180,B00,083141,Abi Samra; Nicholas Camill,0,0,30,30
1657641187486,MATH 10A,A01,083735,Patchell; Gregory David,2,0,30,28
1657641187486,MATH 10A,A02,083736,Patchell; Gregory David,20,0,30,10
1657641187486,MATH 10A,A03,083737,Patchell; Gregory David,16,0,30,14
1657641193520,MATH 10B,A01,083207,Lim; Seonhee,8,0,34,26
1657641193520,MATH 10B,A02,083208,Lim; Seonhee,9,0,35,26
1657641193520,MATH 10B,A03,093472,Lim; Seonhee,7,0,34,27
1657641193520,MATH 10B,B01,083739,Sinha; Shubham,12,0,30,18
1657641199547,MATH 18,A01,083743,Cinel; Cameron Alexander,7,0,30,23
1657641199547,MATH 18,A02,083744,Cinel; Cameron Alexander,17,0,30,13
1657641199547,MATH 18,A03,083745,Cinel; Cameron Alexander,9,0,30,21
1657641199547,MATH 18,B01,083748,Rideout; David Porter,5,0,37,32
1657641199547,MATH 18,B02,083749,Rideout; David Porter,5,0,36,31
1657641199547,MATH 18,B03,083750,Rideout; David Porter,3,0,37,34
1657641199547,MATH 18,B04,083751,Rideout; David Porter,6,0,36,30
1657641199547,MATH 18,B05,093473,Rideout; David Porter,6,0,36,30
1657641199547,MATH 18,B06,093474,Rideout; David Porter,6,0,36,30
1657641205571,MATH 20A,A01,083754,Zheng; Zequn,14,0,40,26
1657641211602,MATH 20B,A01,083756,Briones; Jor-el Thomas Caparas,4,0,36,32
1657641211602,MATH 20B,A02,083757,Briones; Jor-el Thomas Caparas,1,0,36,35
1657641211602,MATH 20B,A03,093475,Briones; Jor-el Thomas Caparas,2,0,36,34
1657641217633,MATH 20C,A01,083760,Briones; Jor-el Thomas Caparas,1,0,35,34
1657641217633,MATH 20C,A02,083761,Briones; Jor-el Thomas Caparas,8,0,35,27
1657641217633,MATH 20C,A03,093476,Briones; Jor-el Thomas Caparas,0,1,36,36
1657641217633,MATH 20C,B01,083762,Bach; Quang Tran,1,0,30,29
1657641223663,MATH 20D,A01,083765,Tran; Brian Kha,5,0,30,25
1657641223663,MATH 20D,A02,083766,Tran; Brian Kha,5,0,30,25
1657641223663,MATH 20D,A03,083767,Tran; Brian Kha,5,0,30,25
1657641229688,MATH 20E,A01,083771,Ganguly; Soumya,9,0,32,23
1657641229688,MATH 20E,A02,083772,Ganguly; Soumya,6,0,32,26
1657641229688,MATH 20E,B01,083773,Ciotti; Benjamin,20,0,35,15
1657641229688,MATH 20E,B02,083774,Ciotti; Benjamin,18,0,35,17
1657641235724,MATH 103A,A01,083777,Greenfeld; Be'Eri,3,0,36,33
1657641235724,MATH 103A,A02,083778,Greenfeld; Be'Eri,5,0,36,31
1657641235724,MATH 103A,A03,093561,Greenfeld; Be'Eri,6,0,36,30
1657641235724,MATH 103A,B01,083779,Greenfeld; Be'Eri,7,0,36,29
1657641235724,MATH 103A,B02,083780,Greenfeld; Be'Eri,4,0,36,32
1657641235724,MATH 103A,B03,093562,Greenfeld; Be'Eri,3,0,36,33
1657641241748,MATH 105,A01,085443,Carter; Anne Toulson,15,0,35,20
1657641241748,MATH 105,A02,093477,Carter; Anne Toulson,20,0,35,15
1657641247771,MATH 109,A01,083213,Ganzberger; Geoffrey Michael,2,0,34,32
1657641247771,MATH 109,A02,083214,Ganzberger; Geoffrey Michael,4,0,34,30
1657641247771,MATH 109,A03,093478,Ganzberger; Geoffrey Michael,2,0,34,32
1657641247771,MATH 109,B01,083215,Ganzberger; Geoffrey Michael,1,0,32,31
1657641247771,MATH 109,B02,083216,Ganzberger; Geoffrey Michael,2,0,32,30
1657641247771,MATH 109,B03,093479,Ganzberger; Geoffrey Michael,8,0,32,24
1657641253799,MATH 142A,A01,083219,Chow; Bennett,7,0,32,25
1657641253799,MATH 142A,A02,083220,Chow; Bennett,10,0,32,22
1657641253799,MATH 142A,A03,093480,Chow; Bennett,9,0,32,23
1657641253799,MATH 142A,B03,093481,Chow; Bennett,8,0,32,24
1657641253799,MATH 142A,B04,093558,Chow; Bennett,13,0,32,19
1657641253799,MATH 142A,B05,093559,Chow; Bennett,6,0,32,26
1657641259830,MATH 193A,A01,083224,Rotar; Vladimir,8,0,34,26
1657641259830,MATH 193A,A02,083225,Rotar; Vladimir,9,0,34,25
1657641259830,MATH 193A,A03,083781,Rotar; Vladimir,5,0,34,29
1657641259830,MATH 193A,A04,083782,Rotar; Vladimir,10,0,34,24
1657641259830,MATH 193A,A05,093482,Rotar; Vladimir,10,0,34,24
1657641265855,MATH 197,001,091859,McAuley; Julian John,9999,0,9999,0
1657641265855,MATH 197,002,095566,Kedlaya; Kiran S.,9997,0,9999,2
1657641265855,MATH 197,003,095567,Xiao; Ming,9999,0,9999,0
1657641265855,MATH 197,004,095571,Perols; Johan Lars,9998,0,9999,1
1657641272929,COGS 9,A01,083615,Shannon; Kyle Michael,9,0,75,66
1657641278957,COGS 11,A01,083617,Boyle; Mary E. T.,23,0,48,25
1657641284988,COGS 13,A01,083071,Bastos; Amalia Pinkusfeld,11,0,71,60
1657641291022,COGS 14A,A01,092681,Semenuks; Arturs,5,1,100,95
1657641297047,COGS 14B,A01,083073,Cheng; Tzu-Han,6,0,63,57
1657641303076,COGS 17,A01,092677,Semenuks; Arturs,6,0,81,75
1657641309104,COGS 100,A01,083619,Allen; Michael Gordon,17,0,70,53
1657641315139,COGS 101A,A01,083621,Davis; Joshua Daniel,9,0,68,59
1657641321169,COGS 101B,A01,091572,Allen; Michael Gordon,12,0,65,53
1657641327194,COGS 101C,A01,083625,Delgado; Tania,17,0,35,18
1657641333217,COGS 107A,A01,083627,Boyle; Mary E. T.,13,0,60,47
1657641339245,COGS 118A,A01,083075,Gupta; Anjum,21,0,76,55
1657641345277,CSE 3,A50,083646,Miranda; Gregory Joseph,24,0,50,26
1657641351304,CSE 8A,A50,083650,Miranda; Gregory Joseph,17,1,56,39
1657641357333,CSE 11,A01,083080,Cao; Yingjun,6,15,40,34
1657641363362,CSE 12,A01,083652,Krause-Levy; Sophia Louisa,28,1,120,92
1657641369390,CSE 15L,A01,083654,Morris; Justin Loren,9,0,50,41
1657641369390,CSE 15L,A02,083655,Morris; Justin Loren,9,0,50,41
1657641375420,CSE 20,A01,083657,Tran; Khoa Dang,39,0,80,41
1657641381446,CSE 21,A01,095574,Bach; Quang Tran,22,0,48,26
1657641387470,CSE 30,A01,083084,Eldon; John,6,0,80,74
1657641387470,CSE 30,B01,095061,Bhaskar; Nishant,9,0,50,41
1657641393502,CSE 100,A01,083659,Cao; Yingjun,5,4,70,65
1657641399532,CSE 134B,A01,083661,Powell; Thomas Allan,22,0,100,78
1657641405556,CSE 140,A01,083663,Gungor; Onat,15,0,85,70
1657641411583,CSE 140L,A01,083088,Eldon; John,21,0,100,79
1657641417614,CSE 175,A01,083665,Kumar; Rakesh,3,0,25,22
1657641423639,CSE 190,A00,092507,Dubnov; Shlomo,8,0,20,12
1657641429671,ECE 45,A01,083139,Congero; Spencer William,6,0,75,69
1657641435702,ECE 65,A50,083695,Saad; Andrew S,12,0,30,18
1657641435702,ECE 65,A51,095125,Saad; Andrew S,24,0,26,2
1657641441726,ECE 109,A01,091882,Touri; Behrouz,19,0,70,51
1657641447754,ECE 180,A00,083140,Abi Samra; Nicholas Camill,1,0,30,29
1657641447754,ECE 180,B00,083141,Abi Samra; Nicholas Camill,0,0,30,30
1657641453787,MATH 10A,A01,083735,Patchell; Gregory David,2,0,30,28
1657641453787,MATH 10A,A02,083736,Patchell; Gregory David,20,0,30,10
1657641453787,MATH 10A,A03,083737,Patchell; Gregory David,16,0,30,14
1657641459821,MATH 10B,A01,083207,Lim; Seonhee,8,0,34,26
1657641459821,MATH 10B,A02,083208,Lim; Seonhee,9,0,35,26
1657641459821,MATH 10B,A03,093472,Lim; Seonhee,7,0,34,27
1657641459821,MATH 10B,B01,083739,Sinha; Shubham,12,0,30,18
1657641465848,MATH 18,A01,083743,Cinel; Cameron Alexander,7,0,30,23
1657641465848,MATH 18,A02,083744,Cinel; Cameron Alexander,17,0,30,13
1657641465848,MATH 18,A03,083745,Cinel; Cameron Alexander,9,0,30,21
1657641465848,MATH 18,B01,083748,Rideout; David Porter,5,0,37,32
1657641465848,MATH 18,B02,083749,Rideout; David Porter,5,0,36,31
1657641465848,MATH 18,B03,083750,Rideout; David Porter,3,0,37,34
1657641465848,MATH 18,B04,083751,Rideout; David Porter,6,0,36,30
1657641465848,MATH 18,B05,093473,Rideout; David Porter,6,0,36,30
1657641465848,MATH 18,B06,093474,Rideout; David Porter,6,0,36,30
1657641471873,MATH 20A,A01,083754,Zheng; Zequn,14,0,40,26
1657641477906,MATH 20B,A01,083756,Briones; Jor-el Thomas Caparas,4,0,36,32
1657641477906,MATH 20B,A02,083757,Briones; Jor-el Thomas Caparas,1,0,36,35
1657641477906,MATH 20B,A03,093475,Briones; Jor-el Thomas Caparas,2,0,36,34
1657641483943,MATH 20C,A01,083760,Briones; Jor-el Thomas Caparas,1,0,35,34
1657641483943,MATH 20C,A02,083761,Briones; Jor-el Thomas Caparas,8,0,35,27
1657641483943,MATH 20C,A03,093476,Briones; Jor-el Thomas Caparas,0,1,36,36
1657641483943,MATH 20C,B01,083762,Bach; Quang Tran,1,0,30,29
1657641489972,MATH 20D,A01,083765,Tran; Brian Kha,5,0,30,25
1657641489972,MATH 20D,A02,083766,Tran; Brian Kha,5,0,30,25
1657641489972,MATH 20D,A03,083767,Tran; Brian Kha,5,0,30,25
1657641495997,MATH 20E,A01,083771,Ganguly; Soumya,9,0,32,23
1657641495997,MATH 20E,A02,083772,Ganguly; Soumya,6,0,32,26
1657641495997,MATH 20E,B01,083773,Ciotti; Benjamin,20,0,35,15
1657641495997,MATH 20E,B02,083774,Ciotti; Benjamin,18,0,35,17
1657641502031,MATH 103A,A01,083777,Greenfeld; Be'Eri,3,0,36,33
1657641502031,MATH 103A,A02,083778,Greenfeld; Be'Eri,5,0,36,31
1657641502031,MATH 103A,A03,093561,Greenfeld; Be'Eri,6,0,36,30
1657641502031,MATH 103A,B01,083779,Greenfeld; Be'Eri,7,0,36,29
1657641502031,MATH 103A,B02,083780,Greenfeld; Be'Eri,4,0,36,32
1657641502031,MATH 103A,B03,093562,Greenfeld; Be'Eri,3,0,36,33
1657641508058,MATH 105,A01,085443,Carter; Anne Toulson,15,0,35,20
1657641508058,MATH 105,A02,093477,Carter; Anne Toulson,20,0,35,15
1657641514089,MATH 109,A01,083213,Ganzberger; Geoffrey Michael,2,0,34,32
1657641514089,MATH 109,A02,083214,Ganzberger; Geoffrey Michael,4,0,34,30
1657641514089,MATH 109,A03,093478,Ganzberger; Geoffrey Michael,2,0,34,32
1657641514089,MATH 109,B01,083215,Ganzberger; Geoffrey Michael,1,0,32,31
1657641514089,MATH 109,B02,083216,Ganzberger; Geoffrey Michael,2,0,32,30
1657641514089,MATH 109,B03,093479,Ganzberger; Geoffrey Michael,8,0,32,24
1657641520114,MATH 142A,A01,083219,Chow; Bennett,7,0,32,25
1657641520114,MATH 142A,A02,083220,Chow; Bennett,10,0,32,22
1657641520114,MATH 142A,A03,093480,Chow; Bennett,9,0,32,23
1657641520114,MATH 142A,B03,093481,Chow; Bennett,8,0,32,24
1657641520114,MATH 142A,B04,093558,Chow; Bennett,13,0,32,19
1657641520114,MATH 142A,B05,093559,Chow; Bennett,6,0,32,26
1657641526144,MATH 193A,A01,083224,Rotar; Vladimir,8,0,34,26
1657641526144,MATH 193A,A02,083225,Rotar; Vladimir,9,0,34,25
1657641526144,MATH 193A,A03,083781,Rotar; Vladimir,5,0,34,29
1657641526144,MATH 193A,A04,083782,Rotar; Vladimir,10,0,34,24
1657641526144,MATH 193A,A05,093482,Rotar; Vladimir,10,0,34,24
1657641532167,MATH 197,001,091859,McAuley; Julian John,9999,0,9999,0
1657641532167,MATH 197,002,095566,Kedlaya; Kiran S.,9997,0,9999,2
1657641532167,MATH 197,003,095567,Xiao; Ming,9999,0,9999,0
1657641532167,MATH 197,004,095571,Perols; Johan Lars,9998,0,9999,1
1657641539239,COGS 9,A01,083615,Shannon; Kyle Michael,9,0,75,66
1657641545269,COGS 11,A01,083617,Boyle; Mary E. T.,23,0,48,25
1657641551293,COGS 13,A01,083071,Bastos; Amalia Pinkusfeld,11,0,71,60
1657641557327,COGS 14A,A01,092681,Semenuks; Arturs,5,1,100,95
1657641563351,COGS 14B,A01,083073,Cheng; Tzu-Han,6,0,63,57
1657641569383,COGS 17,A01,092677,Semenuks; Arturs,6,0,81,75
1657641575407,COGS 100,A01,083619,Allen; Michael Gordon,17,0,70,53
1657641581439,COGS 101A,A01,083621,Davis; Joshua Daniel,9,0,68,59
1657641587469,COGS 101B,A01,091572,Allen; Michael Gordon,12,0,65,53
1657641593493,COGS 101C,A01,083625,Delgado; Tania,17,0,35,18
1657641599518,COGS 107A,A01,083627,Boyle; Mary E. T.,13,0,60,47
1657641605546,COGS 118A,A01,083075,Gupta; Anjum,21,0,76,55
1657641611570,CSE 3,A50,083646,Miranda; Gregory Joseph,24,0,50,26
1657641617595,CSE 8A,A50,083650,Miranda; Gregory Joseph,17,1,56,39
1657641623623,CSE 11,A01,083080,Cao; Yingjun,6,15,40,34
1657641629655,CSE 12,A01,083652,Krause-Levy; Sophia Louisa,28,1,120,92
1657641635680,CSE 15L,A01,083654,Morris; Justin Loren,9,0,50,41
1657641635680,CSE 15L,A02,083655,Morris; Justin Loren,9,0,50,41
1657641641703,CSE 20,A01,083657,Tran; Khoa Dang,39,0,80,41
1657641647730,CSE 21,A01,095574,Bach; Quang Tran,22,0,48,26
1657641653758,CSE 30,A01,083084,Eldon; John,6,0,80,74
1657641653758,CSE 30,B01,095061,Bhaskar; Nishant,9,0,50,41
1657641659785,CSE 100,A01,083659,Cao; Yingjun,5,4,70,65
1657641665821,CSE 134B,A01,083661,Powell; Thomas Allan,22,0,100,78
1657641671845,CSE 140,A01,083663,Gungor; Onat,15,0,85,70
1657641677869,CSE 140L,A01,083088,Eldon; John,21,0,100,79
1657641683893,CSE 175,A01,083665,Kumar; Rakesh,3,0,25,22
1657641689920,CSE 190,A00,092507,Dubnov; Shlomo,8,0,20,12
1657641695952,ECE 45,A01,083139,Congero; Spencer William,6,0,75,69
1657641701983,ECE 65,A50,083695,Saad; Andrew S,12,0,30,18
1657641701983,ECE 65,A51,095125,Saad; Andrew S,24,0,26,2
1657641708008,ECE 109,A01,091882,Touri; Behrouz,19,0,70,51
1657641714037,ECE 180,A00,083140,Abi Samra; Nicholas Camill,1,0,30,29
1657641714037,ECE 180,B00,083141,Abi Samra; Nicholas Camill,0,0,30,30
1657641720070,MATH 10A,A01,083735,Patchell; Gregory David,2,0,30,28
1657641720070,MATH 10A,A02,083736,Patchell; Gregory David,20,0,30,10
1657641720070,MATH 10A,A03,083737,Patchell; Gregory David,16,0,30,14
1657641726111,MATH 10B,A01,083207,Lim; Seonhee,8,0,34,26
1657641726111,MATH 10B,A02,083208,Lim; Seonhee,9,0,35,26
1657641726111,MATH 10B,A03,093472,Lim; Seonhee,7,0,34,27
1657641726111,MATH 10B,B01,083739,Sinha; Shubham,12,0,30,18
1657641732151,MATH 18,A01,083743,Cinel; Cameron Alexander,7,0,30,23
1657641732151,MATH 18,A02,083744,Cinel; Cameron Alexander,17,0,30,13
1657641732151,MATH 18,A03,083745,Cinel; Cameron Alexander,9,0,30,21
1657641732151,MATH 18,B01,083748,Rideout; David Porter,5,0,37,32
1657641732151,MATH 18,B02,083749,Rideout; David Porter,5,0,36,31
1657641732151,MATH 18,B03,083750,Rideout; David Porter,3,0,37,34
1657641732151,MATH 18,B04,083751,Rideout; David Porter,6,0,36,30
1657641732151,MATH 18,B05,093473,Rideout; David Porter,6,0,36,30
1657641732151,MATH 18,B06,093474,Rideout; David Porter,6,0,36,30
1657641738182,MATH 20A,A01,083754,Zheng; Zequn,14,0,40,26
1657641744292,MATH 20B,A01,083756,Briones; Jor-el Thomas Caparas,4,0,36,32
1657641744292,MATH 20B,A02,083757,Briones; Jor-el Thomas Caparas,1,0,36,35
1657641744292,MATH 20B,A03,093475,Briones; Jor-el Thomas Caparas,2,0,36,34
1657641750324,MATH 20C,A01,083760,Briones; Jor-el Thomas Caparas,1,0,35,34
1657641750324,MATH 20C,A02,083761,Briones; Jor-el Thomas Caparas,8,0,35,27
1657641750324,MATH 20C,A03,093476,Briones; Jor-el Thomas Caparas,0,1,36,36
1657641750324,MATH 20C,B01,083762,Bach; Quang Tran,1,0,30,29
1657641756349,MATH 20D,A01,083765,Tran; Brian Kha,5,0,30,25
1657641756349,MATH 20D,A02,083766,Tran; Brian Kha,5,0,30,25
1657641756349,MATH 20D,A03,083767,Tran; Brian Kha,5,0,30,25
1657641762373,MATH 20E,A01,083771,Ganguly; Soumya,9,0,32,23
1657641762373,MATH 20E,A02,083772,Ganguly; Soumya,6,0,32,26
1657641762373,MATH 20E,B01,083773,Ciotti; Benjamin,20,0,35,15
1657641762373,MATH 20E,B02,083774,Ciotti; Benjamin,18,0,35,17
1657641768398,MATH 103A,A01,083777,Greenfeld; Be'Eri,3,0,36,33
1657641768398,MATH 103A,A02,083778,Greenfeld; Be'Eri,5,0,36,31
1657641768398,MATH 103A,A03,093561,Greenfeld; Be'Eri,6,0,36,30
1657641768398,MATH 103A,B01,083779,Greenfeld; Be'Eri,7,0,36,29
1657641768398,MATH 103A,B02,083780,Greenfeld; Be'Eri,4,0,36,32
1657641768398,MATH 103A,B03,093562,Greenfeld; Be'Eri,3,0,36,33
1657641774424,MATH 105,A01,085443,Carter; Anne Toulson,15,0,35,20
1657641774424,MATH 105,A02,093477,Carter; Anne Toulson,20,0,35,15
1657641780455,MATH 109,A01,083213,Ganzberger; Geoffrey Michael,2,0,34,32
1657641780455,MATH 109,A02,083214,Ganzberger; Geoffrey Michael,4,0,34,30
1657641780455,MATH 109,A03,093478,Ganzberger; Geoffrey Michael,2,0,34,32
1657641780455,MATH 109,B01,083215,Ganzberger; Geoffrey Michael,1,0,32,31
1657641780455,MATH 109,B02,083216,Ganzberger; Geoffrey Michael,2,0,32,30
1657641780455,MATH 109,B03,093479,Ganzberger; Geoffrey Michael,8,0,32,24
1657641786487,MATH 142A,A01,083219,Chow; Bennett,7,0,32,25
1657641786487,MATH 142A,A02,083220,Chow; Bennett,10,0,32,22
1657641786487,MATH 142A,A03,093480,Chow; Bennett,9,0,32,23
1657641786487,MATH 142A,B03,093481,Chow; Bennett,8,0,32,24
1657641786487,MATH 142A,B04,093558,Chow; Bennett,13,0,32,19
1657641786487,MATH 142A,B05,093559,Chow; Bennett,6,0,32,26
1657641792513,MATH 193A,A01,083224,Rotar; Vladimir,8,0,34,26
1657641792513,MATH 193A,A02,083225,Rotar; Vladimir,9,0,34,25
1657641792513,MATH 193A,A03,083781,Rotar; Vladimir,5,0,34,29
1657641792513,MATH 193A,A04,083782,Rotar; Vladimir,10,0,34,24
1657641792513,MATH 193A,A05,093482,Rotar; Vladimir,10,0,34,24
1657641798546,MATH 197,001,091859,McAuley; Julian John,9999,0,9999,0
1657641798546,MATH 197,002,095566,Kedlaya; Kiran S.,9997,0,9999,2
1657641798546,MATH 197,003,095567,Xiao; Ming,9999,0,9999,0
1657641798546,MATH 197,004,095571,Perols; Johan Lars,9998,0,9999,1
1657641805623,COGS 9,A01,083615,Shannon; Kyle Michael,9,0,75,66
1657641811651,COGS 11,A01,083617,Boyle; Mary E. T.,23,0,48,25
1657641817694,COGS 13,A01,083071,Bastos; Amalia Pinkusfeld,11,0,71,60
1657641823723,COGS 14A,A01,092681,Semenuks; Arturs,5,1,100,95
1657641829746,COGS 14B,A01,083073,Cheng; Tzu-Han,6,0,63,57
1657641835773,COGS 17,A01,092677,Semenuks; Arturs,6,0,81,75
1657641841803,COGS 100,A01,083619,Allen; Michael Gordon,17,0,70,53
1657641847835,COGS 101A,A01,083621,Davis; Joshua Daniel,9,0,68,59
1657641853862,COGS 101B,A01,091572,Allen; Michael Gordon,12,0,65,53
1657641859887,COGS 101C,A01,083625,Delgado; Tania,17,0,35,18
1657641865915,COGS 107A,A01,083627,Boyle; Mary E. T.,13,0,60,47
1657641871940,COGS 118A,A01,083075,Gupta; Anjum,21,0,76,55
1657641877973,CSE 3,A50,083646,Miranda; Gregory Joseph,24,0,50,26
1657641884002,CSE 8A,A50,083650,Miranda; Gregory Joseph,17,1,56,39
1657641890029,CSE 11,A01,083080,Cao; Yingjun,6,15,40,34
1657641896056,CSE 12,A01,083652,Krause-Levy; Sophia Louisa,28,1,120,92
1657641902090,CSE 15L,A01,083654,Morris; Justin Loren,9,0,50,41
1657641902090,CSE 15L,A02,083655,Morris; Justin Loren,9,0,50,41
1657641908126,CSE 20,A01,083657,Tran; Khoa Dang,39,0,80,41
1657641914159,CSE 21,A01,095574,Bach; Quang Tran,22,0,48,26
1657641920184,CSE 30,A01,083084,Eldon; John,6,0,80,74
1657641920184,CSE 30,B01,095061,Bhaskar; Nishant,9,0,50,41
1657641926211,CSE 100,A01,083659,Cao; Yingjun,5,4,70,65
1657641932237,CSE 134B,A01,083661,Powell; Thomas Allan,22,0,100,78
1657641938262,CSE 140,A01,083663,Gungor; Onat,15,0,85,70
1657641944287,CSE 140L,A01,083088,Eldon; John,21,0,100,79
1657641950313,CSE 175,A01,083665,Kumar; Rakesh,3,0,25,22
1657641956342,CSE 190,A00,092507,Dubnov; Shlomo,8,0,20,12
1657641962374,ECE 45,A01,083139,Congero; Spencer William,6,0,75,69
1657641968404,ECE 65,A50,083695,Saad; Andrew S,12,0,30,18
1657641968404,ECE 65,A51,095125,Saad; Andrew S,24,0,26,2
1657641974430,ECE 109,A01,091882,Touri; Behrouz,19,0,70,51
1657641980455,ECE 180,A00,083140,Abi Samra; Nicholas Camill,1,0,30,29
1657641980455,ECE 180,B00,083141,Abi Samra; Nicholas Camill,0,0,30,30
1657641986490,MATH 10A,A01,083735,Patchell; Gregory David,2,0,30,28
1657641986490,MATH 10A,A02,083736,Patchell; Gregory David,20,0,30,10
1657641986490,MATH 10A,A03,083737,Patchell; Gregory David,16,0,30,14
1657641992523,MATH 10B,A01,083207,Lim; Seonhee,8,0,34,26
1657641992523,MATH 10B,A02,083208,Lim; Seonhee,9,0,35,26
1657641992523,MATH 10B,A03,093472,Lim; Seonhee,7,0,34,27
1657641992523,MATH 10B,B01,083739,Sinha; Shubham,12,0,30,18
1657641998563,MATH 18,A01,083743,Cinel; Cameron Alexander,7,0,30,23
1657641998563,MATH 18,A02,083744,Cinel; Cameron Alexander,17,0,30,13
1657641998563,MATH 18,A03,083745,Cinel; Cameron Alexander,9,0,30,21
1657641998563,MATH 18,B01,083748,Rideout; David Porter,5,0,37,32
1657641998563,MATH 18,B02,083749,Rideout; David Porter,5,0,36,31
1657641998563,MATH 18,B03,083750,Rideout; David Porter,3,0,37,34
1657641998563,MATH 18,B04,083751,Rideout; David Porter,6,0,36,30
1657641998563,MATH 18,B05,093473,Rideout; David Porter,6,0,36,30
1657641998563,MATH 18,B06,093474,Rideout; David Porter,6,0,36,30
1657642004588,MATH 20A,A01,083754,Zheng; Zequn,14,0,40,26
1657642010626,MATH 20B,A01,083756,Briones; Jor-el Thomas Caparas,4,0,36,32
1657642010626,MATH 20B,A02,083757,Briones; Jor-el Thomas Caparas,1,0,36,35
1657642010626,MATH 20B,A03,093475,Briones; Jor-el Thomas Caparas,2,0,36,34
1657642016657,MATH 20C,A01,083760,Briones; Jor-el Thomas Caparas,1,0,35,34
1657642016657,MATH 20C,A02,083761,Briones; Jor-el Thomas Caparas,8,0,35,27
1657642016657,MATH 20C,A03,093476,Briones; Jor-el Thomas Caparas,0,1,36,36
1657642016657,MATH 20C,B01,083762,Bach; Quang Tran,1,0,30,29
1657642022690,MATH 20D,A01,083765,Tran; Brian Kha,5,0,30,25
1657642022690,MATH 20D,A02,083766,Tran; Brian Kha,5,0,30,25
1657642022690,MATH 20D,A03,083767,Tran; Brian Kha,5,0,30,25
1657642028717,MATH 20E,A01,083771,Ganguly; Soumya,9,0,32,23
1657642028717,MATH 20E,A02,083772,Ganguly; Soumya,6,0,32,26
1657642028717,MATH 20E,B01,083773,Ciotti; Benjamin,20,0,35,15
1657642028717,MATH 20E,B02,083774,Ciotti; Benjamin,18,0,35,17
1657642034749,MATH 103A,A01,083777,Greenfeld; Be'Eri,3,0,36,33
1657642034749,MATH 103A,A02,083778,Greenfeld; Be'Eri,5,0,36,31
1657642034749,MATH 103A,A03,093561,Greenfeld; Be'Eri,6,0,36,30
1657642034749,MATH 103A,B01,083779,Greenfeld; Be'Eri,7,0,36,29
1657642034749,MATH 103A,B02,083780,Greenfeld; Be'Eri,4,0,36,32
1657642034749,MATH 103A,B03,093562,Greenfeld; Be'Eri,3,0,36,33
1657642040774,MATH 105,A01,085443,Carter; Anne Toulson,15,0,35,20
1657642040774,MATH 105,A02,093477,Carter; Anne Toulson,20,0,35,15
1657642046800,MATH 109,A01,083213,Ganzberger; Geoffrey Michael,2,0,34,32
1657642046800,MATH 109,A02,083214,Ganzberger; Geoffrey Michael,4,0,34,30
1657642046800,MATH 109,A03,093478,Ganzberger; Geoffrey Michael,2,0,34,32
1657642046800,MATH 109,B01,083215,Ganzberger; Geoffrey Michael,1,0,32,31
1657642046800,MATH 109,B02,083216,Ganzberger; Geoffrey Michael,2,0,32,30
1657642046800,MATH 109,B03,093479,Ganzberger; Geoffrey Michael,8,0,32,24
1657642052838,MATH 142A,A01,083219,Chow; Bennett,7,0,32,25
1657642052838,MATH 142A,A02,083220,Chow; Bennett,10,0,32,22
1657642052838,MATH 142A,A03,093480,Chow; Bennett,9,0,32,23
1657642052838,MATH 142A,B03,093481,Chow; Bennett,8,0,32,24
1657642052838,MATH 142A,B04,093558,Chow; Bennett,13,0,32,19
1657642052838,MATH 142A,B05,093559,Chow; Bennett,6,0,32,26
1657642058864,MATH 193A,A01,083224,Rotar; Vladimir,8,0,34,26
1657642058864,MATH 193A,A02,083225,Rotar; Vladimir,9,0,34,25
1657642058864,MATH 193A,A03,083781,Rotar; Vladimir,5,0,34,29
1657642058864,MATH 193A,A04,083782,Rotar; Vladimir,10,0,34,24
1657642058864,MATH 193A,A05,093482,Rotar; Vladimir,10,0,34,24
1657642064913,MATH 197,001,091859,McAuley; Julian John,9999,0,9999,0
1657642064913,MATH 197,002,095566,Kedlaya; Kiran S.,9997,0,9999,2
1657642064913,MATH 197,003,095567,Xiao; Ming,9999,0,9999,0
1657642064913,MATH 197,004,095571,Perols; Johan Lars,9998,0,9999,1
1657642071975,COGS 9,A01,083615,Shannon; Kyle Michael,9,0,75,66
1657642078000,COGS 11,A01,083617,Boyle; Mary E. T.,23,0,48,25
1657642084028,COGS 13,A01,083071,Bastos; Amalia Pinkusfeld,11,0,71,60
1657642090054,COGS 14A,A01,092681,Semenuks; Arturs,5,1,100,95
1657642096077,COGS 14B,A01,083073,Cheng; Tzu-Han,6,0,63,57
1657642102105,COGS 17,A01,092677,Semenuks; Arturs,6,0,81,75
1657642108129,COGS 100,A01,083619,Allen; Michael Gordon,17,0,70,53
1657642114160,COGS 101A,A01,083621,Davis; Joshua Daniel,9,0,68,59
1657642120188,COGS 101B,A01,091572,Allen; Michael Gordon,12,0,65,53
1657642126228,COGS 101C,A01,083625,Delgado; Tania,17,0,35,18
1657642132257,COGS 107A,A01,083627,Boyle; Mary E. T.,13,0,60,47
1657642138284,COGS 118A,A01,083075,Gupta; Anjum,21,0,76,55
1657642144309,CSE 3,A50,083646,Miranda; Gregory Joseph,24,0,50,26
1657642150339,CSE 8A,A50,083650,Miranda; Gregory Joseph,17,1,56,39
1657642156379,CSE 11,A01,083080,Cao; Yingjun,6,15,40,34
1657642162403,CSE 12,A01,083652,Krause-Levy; Sophia Louisa,28,1,120,92
1657642168428,CSE 15L,A01,083654,Morris; Justin Loren,9,0,50,41
1657642168428,CSE 15L,A02,083655,Morris; Justin Loren,9,0,50,41
1657642174453,CSE 20,A01,083657,Tran; Khoa Dang,39,0,80,41
1657642180483,CSE 21,A01,095574,Bach; Quang Tran,22,0,48,26
1657642186514,CSE 30,A01,083084,Eldon; John,6,0,80,74
1657642186514,CSE 30,B01,095061,Bhaskar; Nishant,9,0,50,41
1657642192542,CSE 100,A01,083659,Cao; Yingjun,5,4,70,65
1657642198575,CSE 134B,A01,083661,Powell; Thomas Allan,22,0,100,78
1657642204601,CSE 140,A01,083663,Gungor; Onat,15,0,85,70
1657642210624,CSE 140L,A01,083088,Eldon; John,21,0,100,79
1657642216652,CSE 175,A01,083665,Kumar; Rakesh,3,0,25,22
1657642222678,CSE 190,A00,092507,Dubnov; Shlomo,8,0,20,12
1657642228704,ECE 45,A01,083139,Congero; Spencer William,6,0,75,69
1657642234730,ECE 65,A50,083695,Saad; Andrew S,12,0,30,18
1657642234730,ECE 65,A51,095125,Saad; Andrew S,24,0,26,2
1657642240758,ECE 109,A01,091882,Touri; Behrouz,19,0,70,51
1657642246790,ECE 180,A00,083140,Abi Samra; Nicholas Camill,1,0,30,29
1657642246790,ECE 180,B00,083141,Abi Samra; Nicholas Camill,0,0,30,30
1657642252814,MATH 10A,A01,083735,Patchell; Gregory David,2,0,30,28
1657642252814,MATH 10A,A02,083736,Patchell; Gregory David,20,0,30,10
1657642252814,MATH 10A,A03,083737,Patchell; Gregory David,16,0,30,14
1657642258841,MATH 10B,A01,083207,Lim; Seonhee,8,0,34,26
1657642258841,MATH 10B,A02,083208,Lim; Seonhee,9,0,35,26
1657642258841,MATH 10B,A03,093472,Lim; Seonhee,7,0,34,27
1657642258841,MATH 10B,B01,083739,Sinha; Shubham,12,0,30,18
1657642264867,MATH 18,A01,083743,Cinel; Cameron Alexander,7,0,30,23
1657642264867,MATH 18,A02,083744,Cinel; Cameron Alexander,17,0,30,13
1657642264867,MATH 18,A03,083745,Cinel; Cameron Alexander,9,0,30,21
1657642264867,MATH 18,B01,083748,Rideout; David Porter,5,0,37,32
1657642264867,MATH 18,B02,083749,Rideout; David Porter,5,0,36,31
1657642264867,MATH 18,B03,083750,Rideout; David Porter,3,0,37,34
1657642264867,MATH 18,B04,083751,Rideout; David Porter,6,0,36,30
1657642264867,MATH 18,B05,093473,Rideout; David Porter,6,0,36,30
1657642264867,MATH 18,B06,093474,Rideout; David Porter,6,0,36,30
1657642270890,MATH 20A,A01,083754,Zheng; Zequn,14,0,40,26
1657642276916,MATH 20B,A01,083756,Briones; Jor-el Thomas Caparas,4,0,36,32
1657642276916,MATH 20B,A02,083757,Briones; Jor-el Thomas Caparas,1,0,36,35
1657642276916,MATH 20B,A03,093475,Briones; Jor-el Thomas Caparas,2,0,36,34
1657642282953,MATH 20C,A01,083760,Briones; Jor-el Thomas Caparas,1,0,35,34
1657642282953,MATH 20C,A02,083761,Briones; Jor-el Thomas Caparas,8,0,35,27
1657642282953,MATH 20C,A03,093476,Briones; Jor-el Thomas Caparas,0,1,36,36
1657642282953,MATH 20C,B01,083762,Bach; Quang Tran,1,0,30,29
1657642288977,MATH 20D,A01,083765,Tran; Brian Kha,5,0,30,25
1657642288977,MATH 20D,A02,083766,Tran; Brian Kha,5,0,30,25
1657642288977,MATH 20D,A03,083767,Tran; Brian Kha,5,0,30,25
1657642295007,MATH 20E,A01,083771,Ganguly; Soumya,9,0,32,23
1657642295007,MATH 20E,A02,083772,Ganguly; Soumya,6,0,32,26
1657642295007,MATH 20E,B01,083773,Ciotti; Benjamin,20,0,35,15
1657642295007,MATH 20E,B02,083774,Ciotti; Benjamin,18,0,35,17
1657642301037,MATH 103A,A01,083777,Greenfeld; Be'Eri,3,0,36,33
1657642301037,MATH 103A,A02,083778,Greenfeld; Be'Eri,5,0,36,31
1657642301037,MATH 103A,A03,093561,Greenfeld; Be'Eri,6,0,36,30
1657642301037,MATH 103A,B01,083779,Greenfeld; Be'Eri,7,0,36,29
1657642301037,MATH 103A,B02,083780,Greenfeld; Be'Eri,4,0,36,32
1657642301037,MATH 103A,B03,093562,Greenfeld; Be'Eri,3,0,36,33
1657642307062,MATH 105,A01,085443,Carter; Anne Toulson,15,0,35,20
1657642307062,MATH 105,A02,093477,Carter; Anne Toulson,20,0,35,15
1657642313092,MATH 109,A01,083213,Ganzberger; Geoffrey Michael,2,0,34,32
1657642313092,MATH 109,A02,083214,Ganzberger; Geoffrey Michael,4,0,34,30
1657642313092,MATH 109,A03,093478,Ganzberger; Geoffrey Michael,2,0,34,32
1657642313092,MATH 109,B01,083215,Ganzberger; Geoffrey Michael,1,0,32,31
1657642313092,MATH 109,B02,083216,Ganzberger; Geoffrey Michael,2,0,32,30
1657642313092,MATH 109,B03,093479,Ganzberger; Geoffrey Michael,8,0,32,24
1657642319117,MATH 142A,A01,083219,Chow; Bennett,7,0,32,25
1657642319117,MATH 142A,A02,083220,Chow; Bennett,10,0,32,22
1657642319117,MATH 142A,A03,093480,Chow; Bennett,9,0,32,23
1657642319117,MATH 142A,B03,093481,Chow; Bennett,8,0,32,24
1657642319117,MATH 142A,B04,093558,Chow; Bennett,13,0,32,19
1657642319117,MATH 142A,B05,093559,Chow; Bennett,6,0,32,26
1657642325149,MATH 193A,A01,083224,Rotar; Vladimir,8,0,34,26
1657642325149,MATH 193A,A02,083225,Rotar; Vladimir,9,0,34,25
1657642325149,MATH 193A,A03,083781,Rotar; Vladimir,5,0,34,29
1657642325149,MATH 193A,A04,083782,Rotar; Vladimir,10,0,34,24
1657642325149,MATH 193A,A05,093482,Rotar; Vladimir,10,0,34,24
1657642331180,MATH 197,001,091859,McAuley; Julian John,9999,0,9999,0
1657642331180,MATH 197,002,095566,Kedlaya; Kiran S.,9997,0,9999,2
1657642331180,MATH 197,003,095567,Xiao; Ming,9999,0,9999,0
1657642331180,MATH 197,004,095571,Perols; Johan Lars,9998,0,9999,1
1657642338320,COGS 9,A01,083615,Shannon; Kyle Michael,9,0,75,66
1657642344355,COGS 11,A01,083617,Boyle; Mary E. T.,23,0,48,25
1657642350378,COGS 13,A01,083071,Bastos; Amalia Pinkusfeld,11,0,71,60
1657642356407,COGS 14A,A01,092681,Semenuks; Arturs,5,1,100,95
1657642362431,COGS 14B,A01,083073,Cheng; Tzu-Han,6,0,63,57
1657642368459,COGS 17,A01,092677,Semenuks; Arturs,6,0,81,75
1657642374488,COGS 100,A01,083619,Allen; Michael Gordon,17,0,70,53
1657642380512,COGS 101A,A01,083621,Davis; Joshua Daniel,9,0,68,59
1657642386538,COGS 101B,A01,091572,Allen; Michael Gordon,12,0,65,53
1657642392570,COGS 101C,A01,083625,Delgado; Tania,17,0,35,18
1657642398602,COGS 107A,A01,083627,Boyle; Mary E. T.,13,0,60,47
1657642404626,COGS 118A,A01,083075,Gupta; Anjum,21,0,76,55
1657642410654,CSE 3,A50,083646,Miranda; Gregory Joseph,24,0,50,26
1657642416678,CSE 8A,A50,083650,Miranda; Gregory Joseph,17,1,56,39
1657642422702,CSE 11,A01,083080,Cao; Yingjun,6,15,40,34
1657642428731,CSE 12,A01,083652,Krause-Levy; Sophia Louisa,28,1,120,92
1657642434756,CSE 15L,A01,083654,Morris; Justin Loren,9,0,50,41
1657642434756,CSE 15L,A02,083655,Morris; Justin Loren,9,0,50,41
1657642440788,CSE 20,A01,083657,Tran; Khoa Dang,39,0,80,41
1657642446817,CSE 21,A01,095574,Bach; Quang Tran,22,0,48,26
1657642452848,CSE 30,A01,083084,Eldon; John,6,0,80,74
1657642452848,CSE 30,B01,095061,Bhaskar; Nishant,9,0,50,41
1657642458877,CSE 100,A01,083659,Cao; Yingjun,5,4,70,65
1657642464909,CSE 134B,A01,083661,Powell; Thomas Allan,22,0,100,78
1657642470938,CSE 140,A01,083663,Gungor; Onat,15,0,85,70
1657642476961,CSE 140L,A01,083088,Eldon; John,21,0,100,79
1657642483004,CSE 175,A01,083665,Kumar; Rakesh,3,0,25,22
1657642489029,CSE 190,A00,092507,Dubnov; Shlomo,8,0,20,12
1657642495056,ECE 45,A01,083139,Congero; Spencer William,6,0,75,69
1657642501081,ECE 65,A50,083695,Saad; Andrew S,12,0,30,18
1657642501081,ECE 65,A51,095125,Saad; Andrew S,24,0,26,2
1657642507105,ECE 109,A01,091882,Touri; Behrouz,19,0,70,51
1657642513131,ECE 180,A00,083140,Abi Samra; Nicholas Camill,1,0,30,29
1657642513131,ECE 180,B00,083141,Abi Samra; Nicholas Camill,0,0,30,30
1657642519157,MATH 10A,A01,083735,Patchell; Gregory David,2,0,30,28
1657642519157,MATH 10A,A02,083736,Patchell; Gregory David,20,0,30,10
1657642519157,MATH 10A,A03,083737,Patchell; Gregory David,16,0,30,14
1657642525199,MATH 10B,A01,083207,Lim; Seonhee,8,0,34,26
1657642525199,MATH 10B,A02,083208,Lim; Seonhee,9,0,35,26
1657642525199,MATH 10B,A03,093472,Lim; Seonhee,7,0,34,27
1657642525199,MATH 10B,B01,083739,Sinha; Shubham,12,0,30,18
1657642531227,MATH 18,A01,083743,Cinel; Cameron Alexander,7,0,30,23
1657642531227,MATH 18,A02,083744,Cinel; Cameron Alexander,17,0,30,13
1657642531227,MATH 18,A03,083745,Cinel; Cameron Alexander,9,0,30,21
1657642531227,MATH 18,B01,083748,Rideout; David Porter,5,0,37,32
1657642531227,MATH 18,B02,083749,Rideout; David Porter,5,0,36,31
1657642531227,MATH 18,B03,083750,Rideout; David Porter,3,0,37,34
1657642531227,MATH 18,B04,083751,Rideout; David Porter,6,0,36,30
1657642531227,MATH 18,B05,093473,Rideout; David Porter,6,0,36,30
1657642531227,MATH 18,B06,093474,Rideout; David Porter,6,0,36,30
1657642537254,MATH 20A,A01,083754,Zheng; Zequn,14,0,40,26
1657642543286,MATH 20B,A01,083756,Briones; Jor-el Thomas Caparas,4,0,36,32
1657642543286,MATH 20B,A02,083757,Briones; Jor-el Thomas Caparas,1,0,36,35
1657642543286,MATH 20B,A03,093475,Briones; Jor-el Thomas Caparas,2,0,36,34
1657642549325,MATH 20C,A01,083760,Briones; Jor-el Thomas Caparas,1,0,35,34
1657642549325,MATH 20C,A02,083761,Briones; Jor-el Thomas Caparas,8,0,35,27
1657642549325,MATH 20C,A03,093476,Briones; Jor-el Thomas Caparas,0,1,36,36
1657642549325,MATH 20C,B01,083762,Bach; Quang Tran,1,0,30,29
1657642555350,MATH 20D,A01,083765,Tran; Brian Kha,5,0,30,25
1657642555350,MATH 20D,A02,083766,Tran; Brian Kha,5,0,30,25
1657642555350,MATH 20D,A03,083767,Tran; Brian Kha,5,0,30,25
1657642561378,MATH 20E,A01,083771,Ganguly; Soumya,9,0,32,23
1657642561378,MATH 20E,A02,083772,Ganguly; Soumya,6,0,32,26
1657642561378,MATH 20E,B01,083773,Ciotti; Benjamin,20,0,35,15
1657642561378,MATH 20E,B02,083774,Ciotti; Benjamin,18,0,35,17
1657642567412,MATH 103A,A01,083777,Greenfeld; Be'Eri,3,0,36,33
1657642567412,MATH 103A,A02,083778,Greenfeld; Be'Eri,5,0,36,31
1657642567412,MATH 103A,A03,093561,Greenfeld; Be'Eri,6,0,36,30
1657642567412,MATH 103A,B01,083779,Greenfeld; Be'Eri,7,0,36,29
1657642567412,MATH 103A,B02,083780,Greenfeld; Be'Eri,4,0,36,32
1657642567412,MATH 103A,B03,093562,Greenfeld; Be'Eri,3,0,36,33
1657642573438,MATH 105,A01,085443,Carter; Anne Toulson,15,0,35,20
1657642573438,MATH 105,A02,093477,Carter; Anne Toulson,20,0,35,15
1657642579470,MATH 109,A01,083213,Ganzberger; Geoffrey Michael,2,0,34,32
1657642579470,MATH 109,A02,083214,Ganzberger; Geoffrey Michael,4,0,34,30
1657642579470,MATH 109,A03,093478,Ganzberger; Geoffrey Michael,2,0,34,32
1657642579470,MATH 109,B01,083215,Ganzberger; Geoffrey Michael,1,0,32,31
1657642579470,MATH 109,B02,083216,Ganzberger; Geoffrey Michael,2,0,32,30
1657642579470,MATH 109,B03,093479,Ganzberger; Geoffrey Michael,8,0,32,24
1657642585499,MATH 142A,A01,083219,Chow; Bennett,7,0,32,25
1657642585499,MATH 142A,A02,083220,Chow; Bennett,10,0,32,22
1657642585499,MATH 142A,A03,093480,Chow; Bennett,9,0,32,23
1657642585499,MATH 142A,B03,093481,Chow; Bennett,8,0,32,24
1657642585499,MATH 142A,B04,093558,Chow; Bennett,13,0,32,19
1657642585499,MATH 142A,B05,093559,Chow; Bennett,6,0,32,26
1657642591531,MATH 193A,A01,083224,Rotar; Vladimir,8,0,34,26
1657642591531,MATH 193A,A02,083225,Rotar; Vladimir,9,0,34,25
1657642591531,MATH 193A,A03,083781,Rotar; Vladimir,5,0,34,29
1657642591531,MATH 193A,A04,083782,Rotar; Vladimir,10,0,34,24
1657642591531,MATH 193A,A05,093482,Rotar; Vladimir,10,0,34,24
1657642597556,MATH 197,001,091859,McAuley; Julian John,9999,0,9999,0
1657642597556,MATH 197,002,095566,Kedlaya; Kiran S.,9997,0,9999,2
1657642597556,MATH 197,003,095567,Xiao; Ming,9999,0,9999,0
1657642597556,MATH 197,004,095571,Perols; Johan Lars,9998,0,9999,1
1657642604633,COGS 9,A01,083615,Shannon; Kyle Michael,9,0,75,66
1657642610658,COGS 11,A01,083617,Boyle; Mary E. T.,23,0,48,25
1657642616684,COGS 13,A01,083071,Bastos; Amalia Pinkusfeld,11,0,71,60
1657642622718,COGS 14A,A01,092681,Semenuks; Arturs,5,1,100,95
1657642628744,COGS 14B,A01,083073,Cheng; Tzu-Han,6,0,63,57
1657642634774,COGS 17,A01,092677,Semenuks; Arturs,6,0,81,75
1657642640798,COGS 100,A01,083619,Allen; Michael Gordon,17,0,70,53
1657642646837,COGS 101A,A01,083621,Davis; Joshua Daniel,9,0,68,59
1657642652871,COGS 101B,A01,091572,Allen; Michael Gordon,12,0,65,53
1657642658898,COGS 101C,A01,083625,Delgado; Tania,17,0,35,18
1657642664926,COGS 107A,A01,083627,Boyle; Mary E. T.,13,0,60,47
1657642670967,COGS 118A,A01,083075,Gupta; Anjum,21,0,76,55
1657642676991,CSE 3,A50,083646,Miranda; Gregory Joseph,24,0,50,26
1657642683024,CSE 8A,A50,083650,Miranda; Gregory Joseph,17,1,56,39
1657642689048,CSE 11,A01,083080,Cao; Yingjun,6,15,40,34
1657642695077,CSE 12,A01,083652,Krause-Levy; Sophia Louisa,28,1,120,92
1657642701100,CSE 15L,A01,083654,Morris; Justin Loren,9,0,50,41
1657642701100,CSE 15L,A02,083655,Morris; Justin Loren,9,0,50,41
1657642707129,CSE 20,A01,083657,Tran; Khoa Dang,39,0,80,41
1657642713164,CSE 21,A01,095574,Bach; Quang Tran,22,0,48,26
1657642719189,CSE 30,A01,083084,Eldon; John,6,0,80,74
1657642719189,CSE 30,B01,095061,Bhaskar; Nishant,9,0,50,41
1657642725216,CSE 100,A01,083659,Cao; Yingjun,5,4,70,65
1657642731242,CSE 134B,A01,083661,Powell; Thomas Allan,22,0,100,78
1657642737266,CSE 140,A01,083663,Gungor; Onat,15,0,85,70
1657642743294,CSE 140L,A01,083088,Eldon; John,21,0,100,79
1657642749334,CSE 175,A01,083665,Kumar; Rakesh,3,0,25,22
1657642755357,CSE 190,A00,092507,Dubnov; Shlomo,8,0,20,12
1657642761385,ECE 45,A01,083139,Congero; Spencer William,6,0,75,69
1657642767413,ECE 65,A50,083695,Saad; Andrew S,12,0,30,18
1657642767413,ECE 65,A51,095125,Saad; Andrew S,24,0,26,2
1657642773446,ECE 109,A01,091882,Touri; Behrouz,19,0,70,51
1657642779480,ECE 180,A00,083140,Abi Samra; Nicholas Camill,1,0,30,29
1657642779480,ECE 180,B00,083141,Abi Samra; Nicholas Camill,0,0,30,30
1657642785509,MATH 10A,A01,083735,Patchell; Gregory David,2,0,30,28
1657642785509,MATH 10A,A02,083736,Patchell; Gregory David,20,0,30,10
1657642785509,MATH 10A,A03,083737,Patchell; Gregory David,16,0,30,14
1657642791535,MATH 10B,A01,083207,Lim; Seonhee,8,0,34,26
1657642791535,MATH 10B,A02,083208,Lim; Seonhee,9,0,35,26
1657642791535,MATH 10B,A03,093472,Lim; Seonhee,7,0,34,27
1657642791535,MATH 10B,B01,083739,Sinha; Shubham,12,0,30,18
1657642797564,MATH 18,A01,083743,Cinel; Cameron Alexander,7,0,30,23
1657642797564,MATH 18,A02,083744,Cinel; Cameron Alexander,17,0,30,13
1657642797564,MATH 18,A03,083745,Cinel; Cameron Alexander,9,0,30,21
1657642797564,MATH 18,B01,083748,Rideout; David Porter,5,0,37,32
1657642797564,MATH 18,B02,083749,Rideout; David Porter,5,0,36,31
1657642797564,MATH 18,B03,083750,Rideout; David Porter,3,0,37,34
1657642797564,MATH 18,B04,083751,Rideout; David Porter,6,0,36,30
1657642797564,MATH 18,B05,093473,Rideout; David Porter,6,0,36,30
1657642797564,MATH 18,B06,093474,Rideout; David Porter,6,0,36,30
1657642803611,MATH 20A,A01,083754,Zheng; Zequn,14,0,40,26
1657642809640,MATH 20B,A01,083756,Briones; Jor-el Thomas Caparas,4,0,36,32
1657642809640,MATH 20B,A02,083757,Briones; Jor-el Thomas Caparas,1,0,36,35
1657642809640,MATH 20B,A03,093475,Briones; Jor-el Thomas Caparas,2,0,36,34
1657642815680,MATH 20C,A01,083760,Briones; Jor-el Thomas Caparas,1,0,35,34
1657642815680,MATH 20C,A02,083761,Briones; Jor-el Thomas Caparas,8,0,35,27
1657642815680,MATH 20C,A03,093476,Briones; Jor-el Thomas Caparas,0,1,36,36
1657642815680,MATH 20C,B01,083762,Bach; Quang Tran,1,0,30,29
1657642821704,MATH 20D,A01,083765,Tran; Brian Kha,5,0,30,25
1657642821704,MATH 20D,A02,083766,Tran; Brian Kha,5,0,30,25
1657642821704,MATH 20D,A03,083767,Tran; Brian Kha,5,0,30,25
1657642827733,MATH 20E,A01,083771,Ganguly; Soumya,9,0,32,23
1657642827733,MATH 20E,A02,083772,Ganguly; Soumya,6,0,32,26
1657642827733,MATH 20E,B01,083773,Ciotti; Benjamin,20,0,35,15
1657642827733,MATH 20E,B02,083774,Ciotti; Benjamin,18,0,35,17
1657642833757,MATH 103A,A01,083777,Greenfeld; Be'Eri,3,0,36,33
1657642833757,MATH 103A,A02,083778,Greenfeld; Be'Eri,5,0,36,31
1657642833757,MATH 103A,A03,093561,Greenfeld; Be'Eri,6,0,36,30
1657642833757,MATH 103A,B01,083779,Greenfeld; Be'Eri,7,0,36,29
1657642833757,MATH 103A,B02,083780,Greenfeld; Be'Eri,4,0,36,32
1657642833757,MATH 103A,B03,093562,Greenfeld; Be'Eri,3,0,36,33
1657642839784,MATH 105,A01,085443,Carter; Anne Toulson,15,0,35,20
1657642839784,MATH 105,A02,093477,Carter; Anne Toulson,20,0,35,15
1657642845809,MATH 109,A01,083213,Ganzberger; Geoffrey Michael,2,0,34,32
1657642845809,MATH 109,A02,083214,Ganzberger; Geoffrey Michael,4,0,34,30
1657642845809,MATH 109,A03,093478,Ganzberger; Geoffrey Michael,2,0,34,32
1657642845809,MATH 109,B01,083215,Ganzberger; Geoffrey Michael,1,0,32,31
1657642845809,MATH 109,B02,083216,Ganzberger; Geoffrey Michael,2,0,32,30
1657642845809,MATH 109,B03,093479,Ganzberger; Geoffrey Michael,8,0,32,24
1657642851843,MATH 142A,A01,083219,Chow; Bennett,7,0,32,25
1657642851843,MATH 142A,A02,083220,Chow; Bennett,10,0,32,22
1657642851843,MATH 142A,A03,093480,Chow; Bennett,9,0,32,23
1657642851843,MATH 142A,B03,093481,Chow; Bennett,8,0,32,24
1657642851843,MATH 142A,B04,093558,Chow; Bennett,13,0,32,19
1657642851843,MATH 142A,B05,093559,Chow; Bennett,6,0,32,26
1657642857873,MATH 193A,A01,083224,Rotar; Vladimir,8,0,34,26
1657642857873,MATH 193A,A02,083225,Rotar; Vladimir,9,0,34,25
1657642857873,MATH 193A,A03,083781,Rotar; Vladimir,5,0,34,29
1657642857873,MATH 193A,A04,083782,Rotar; Vladimir,10,0,34,24
1657642857873,MATH 193A,A05,093482,Rotar; Vladimir,10,0,34,24
1657642863900,MATH 197,001,091859,McAuley; Julian John,9999,0,9999,0
1657642863900,MATH 197,002,095566,Kedlaya; Kiran S.,9997,0,9999,2
1657642863900,MATH 197,003,095567,Xiao; Ming,9999,0,9999,0
1657642863900,MATH 197,004,095571,Perols; Johan Lars,9998,0,9999,1
1657642870956,COGS 9,A01,083615,Shannon; Kyle Michael,9,0,75,66
1657642876978,COGS 11,A01,083617,Boyle; Mary E. T.,23,0,48,25
1657642883013,COGS 13,A01,083071,Bastos; Amalia Pinkusfeld,11,0,71,60
1657642889036,COGS 14A,A01,092681,Semenuks; Arturs,5,1,100,95
1657642895063,COGS 14B,A01,083073,Cheng; Tzu-Han,6,0,63,57
1657642901086,COGS 17,A01,092677,Semenuks; Arturs,6,0,81,75
1657642907114,COGS 100,A01,083619,Allen; Michael Gordon,17,0,70,53
1657642913144,COGS 101A,A01,083621,Davis; Joshua Daniel,9,0,68,59
1657642919170,COGS 101B,A01,091572,Allen; Michael Gordon,12,0,65,53
1657642925193,COGS 101C,A01,083625,Delgado; Tania,17,0,35,18
1657642931218,COGS 107A,A01,083627,Boyle; Mary E. T.,13,0,60,47
1657642937341,COGS 118A,A01,083075,Gupta; Anjum,21,0,76,55
1657642943365,CSE 3,A50,083646,Miranda; Gregory Joseph,24,0,50,26
1657642949391,CSE 8A,A50,083650,Miranda; Gregory Joseph,17,1,56,39
1657642955415,CSE 11,A01,083080,Cao; Yingjun,6,15,40,34
1657642961439,CSE 12,A01,083652,Krause-Levy; Sophia Louisa,28,1,120,92
1657642967463,CSE 15L,A01,083654,Morris; Justin Loren,9,0,50,41
1657642967463,CSE 15L,A02,083655,Morris; Justin Loren,9,0,50,41
1657642973494,CSE 20,A01,083657,Tran; Khoa Dang,39,0,80,41
1657642979523,CSE 21,A01,095574,Bach; Quang Tran,22,0,48,26
1657642985555,CSE 30,A01,083084,Eldon; John,6,0,80,74
1657642985555,CSE 30,B01,095061,Bhaskar; Nishant,9,0,50,41
1657642991581,CSE 100,A01,083659,Cao; Yingjun,5,4,70,65
1657642997607,CSE 134B,A01,083661,Powell; Thomas Allan,22,0,100,78
1657643003631,CSE 140,A01,083663,Gungor; Onat,15,0,85,70
1657643009656,CSE 140L,A01,083088,Eldon; John,21,0,100,79
1657643015682,CSE 175,A01,083665,Kumar; Rakesh,3,0,25,22
1657643021705,CSE 190,A00,092507,Dubnov; Shlomo,8,0,20,12
1657643027733,ECE 45,A01,083139,Congero; Spencer William,6,0,75,69
1657643033757,ECE 65,A50,083695,Saad; Andrew S,12,0,30,18
1657643033757,ECE 65,A51,095125,Saad; Andrew S,24,0,26,2
1657643039783,ECE 109,A01,091882,Touri; Behrouz,19,0,70,51
1657643045819,ECE 180,A00,083140,Abi Samra; Nicholas Camill,1,0,30,29
1657643045819,ECE 180,B00,083141,Abi Samra; Nicholas Camill,0,0,30,30
1657643051858,MATH 10A,A01,083735,Patchell; Gregory David,2,0,30,28
1657643051858,MATH 10A,A02,083736,Patchell; Gregory David,20,0,30,10
1657643051858,MATH 10A,A03,083737,Patchell; Gregory David,16,0,30,14
1657643057883,MATH 10B,A01,083207,Lim; Seonhee,8,0,34,26
1657643057883,MATH 10B,A02,083208,Lim; Seonhee,9,0,35,26
1657643057883,MATH 10B,A03,093472,Lim; Seonhee,7,0,34,27
1657643057883,MATH 10B,B01,083739,Sinha; Shubham,12,0,30,18
1657643063915,MATH 18,A01,083743,Cinel; Cameron Alexander,7,0,30,23
1657643063915,MATH 18,A02,083744,Cinel; Cameron Alexander,17,0,30,13
1657643063915,MATH 18,A03,083745,Cinel; Cameron Alexander,9,0,30,21
1657643063915,MATH 18,B01,083748,Rideout; David Porter,5,0,37,32
1657643063915,MATH 18,B02,083749,Rideout; David Porter,5,0,36,31
1657643063915,MATH 18,B03,083750,Rideout; David Porter,3,0,37,34
1657643063915,MATH 18,B04,083751,Rideout; David Porter,6,0,36,30
1657643063915,MATH 18,B05,093473,Rideout; David Porter,6,0,36,30
1657643063915,MATH 18,B06,093474,Rideout; David Porter,6,0,36,30
1657643069940,MATH 20A,A01,083754,Zheng; Zequn,14,0,40,26
1657643075972,MATH 20B,A01,083756,Briones; Jor-el Thomas Caparas,4,0,36,32
1657643075972,MATH 20B,A02,083757,Briones; Jor-el Thomas Caparas,1,0,36,35
1657643075972,MATH 20B,A03,093475,Briones; Jor-el Thomas Caparas,2,0,36,34
1657643082000,MATH 20C,A01,083760,Briones; Jor-el Thomas Caparas,1,0,35,34
1657643082000,MATH 20C,A02,083761,Briones; Jor-el Thomas Caparas,8,0,35,27
1657643082000,MATH 20C,A03,093476,Briones; Jor-el Thomas Caparas,0,1,36,36
1657643082000,MATH 20C,B01,083762,Bach; Quang Tran,1,0,30,29
1657643088025,MATH 20D,A01,083765,Tran; Brian Kha,5,0,30,25
1657643088025,MATH 20D,A02,083766,Tran; Brian Kha,5,0,30,25
1657643088025,MATH 20D,A03,083767,Tran; Brian Kha,5,0,30,25
1657643094056,MATH 20E,A01,083771,Ganguly; Soumya,9,0,32,23
1657643094056,MATH 20E,A02,083772,Ganguly; Soumya,6,0,32,26
1657643094056,MATH 20E,B01,083773,Ciotti; Benjamin,20,0,35,15
1657643094056,MATH 20E,B02,083774,Ciotti; Benjamin,18,0,35,17
1657643100091,MATH 103A,A01,083777,Greenfeld; Be'Eri,3,0,36,33
1657643100091,MATH 103A,A02,083778,Greenfeld; Be'Eri,5,0,36,31
1657643100091,MATH 103A,A03,093561,Greenfeld; Be'Eri,6,0,36,30
1657643100091,MATH 103A,B01,083779,Greenfeld; Be'Eri,7,0,36,29
1657643100091,MATH 103A,B02,083780,Greenfeld; Be'Eri,4,0,36,32
1657643100091,MATH 103A,B03,093562,Greenfeld; Be'Eri,3,0,36,33
1657643106114,MATH 105,A01,085443,Carter; Anne Toulson,15,0,35,20
1657643106114,MATH 105,A02,093477,Carter; Anne Toulson,20,0,35,15
1657643112153,MATH 109,A01,083213,Ganzberger; Geoffrey Michael,2,0,34,32
1657643112153,MATH 109,A02,083214,Ganzberger; Geoffrey Michael,4,0,34,30
1657643112153,MATH 109,A03,093478,Ganzberger; Geoffrey Michael,2,0,34,32
1657643112153,MATH 109,B01,083215,Ganzberger; Geoffrey Michael,1,0,32,31
1657643112153,MATH 109,B02,083216,Ganzberger; Geoffrey Michael,2,0,32,30
1657643112153,MATH 109,B03,093479,Ganzberger; Geoffrey Michael,8,0,32,24
1657643118176,MATH 142A,A01,083219,Chow; Bennett,7,0,32,25
1657643118176,MATH 142A,A02,083220,Chow; Bennett,10,0,32,22
1657643118176,MATH 142A,A03,093480,Chow; Bennett,9,0,32,23
1657643118176,MATH 142A,B03,093481,Chow; Bennett,8,0,32,24
1657643118176,MATH 142A,B04,093558,Chow; Bennett,13,0,32,19
1657643118176,MATH 142A,B05,093559,Chow; Bennett,6,0,32,26
1657643124207,MATH 193A,A01,083224,Rotar; Vladimir,8,0,34,26
1657643124207,MATH 193A,A02,083225,Rotar; Vladimir,9,0,34,25
1657643124207,MATH 193A,A03,083781,Rotar; Vladimir,5,0,34,29
1657643124207,MATH 193A,A04,083782,Rotar; Vladimir,10,0,34,24
1657643124207,MATH 193A,A05,093482,Rotar; Vladimir,10,0,34,24
1657643130233,MATH 197,001,091859,McAuley; Julian John,9999,0,9999,0
1657643130233,MATH 197,002,095566,Kedlaya; Kiran S.,9997,0,9999,2
1657643130233,MATH 197,003,095567,Xiao; Ming,9999,0,9999,0
1657643130233,MATH 197,004,095571,Perols; Johan Lars,9998,0,9999,1
1657643137299,COGS 9,A01,083615,Shannon; Kyle Michael,9,0,75,66
1657643143322,COGS 11,A01,083617,Boyle; Mary E. T.,23,0,48,25
1657643149344,COGS 13,A01,083071,Bastos; Amalia Pinkusfeld,11,0,71,60
1657643155379,COGS 14A,A01,092681,Semenuks; Arturs,5,1,100,95
1657643161403,COGS 14B,A01,083073,Cheng; Tzu-Han,6,0,63,57
1657643167431,COGS 17,A01,092677,Semenuks; Arturs,6,0,81,75
1657643173454,COGS 100,A01,083619,Allen; Michael Gordon,17,0,70,53
1657643179477,COGS 101A,A01,083621,Davis; Joshua Daniel,9,0,68,59
1657643185501,COGS 101B,A01,091572,Allen; Michael Gordon,12,0,65,53
1657643191523,COGS 101C,A01,083625,Delgado; Tania,17,0,35,18
1657643197549,COGS 107A,A01,083627,Boyle; Mary E. T.,13,0,60,47
1657643203577,COGS 118A,A01,083075,Gupta; Anjum,21,0,76,55
1657643209610,CSE 3,A50,083646,Miranda; Gregory Joseph,24,0,50,26
1657643215636,CSE 8A,A50,083650,Miranda; Gregory Joseph,17,1,56,39
1657643221658,CSE 11,A01,083080,Cao; Yingjun,6,15,40,34
1657643227695,CSE 12,A01,083652,Krause-Levy; Sophia Louisa,28,1,120,92
1657643233723,CSE 15L,A01,083654,Morris; Justin Loren,9,0,50,41
1657643233723,CSE 15L,A02,083655,Morris; Justin Loren,9,0,50,41
1657643239761,CSE 20,A01,083657,Tran; Khoa Dang,39,0,80,41
1657643245786,CSE 21,A01,095574,Bach; Quang Tran,22,0,48,26
1657643251814,CSE 30,A01,083084,Eldon; John,6,0,80,74
1657643251814,CSE 30,B01,095061,Bhaskar; Nishant,9,0,50,41
1657643257836,CSE 100,A01,083659,Cao; Yingjun,5,4,70,65
1657643263875,CSE 134B,A01,083661,Powell; Thomas Allan,22,0,100,78
1657643269907,CSE 140,A01,083663,Gungor; Onat,15,0,85,70
1657643275932,CSE 140L,A01,083088,Eldon; John,21,0,100,79
1657643281962,CSE 175,A01,083665,Kumar; Rakesh,3,0,25,22
1657643288003,CSE 190,A00,092507,Dubnov; Shlomo,8,0,20,12
1657643294033,ECE 45,A01,083139,Congero; Spencer William,6,0,75,69
1657643300066,ECE 65,A50,083695,Saad; Andrew S,12,0,30,18
1657643300066,ECE 65,A51,095125,Saad; Andrew S,24,0,26,2
1657643306095,ECE 109,A01,091882,Touri; Behrouz,19,0,70,51
1657643312120,ECE 180,A00,083140,Abi Samra; Nicholas Camill,1,0,30,29
1657643312120,ECE 180,B00,083141,Abi Samra; Nicholas Camill,0,0,30,30
1657643318144,MATH 10A,A01,083735,Patchell; Gregory David,2,0,30,28
1657643318144,MATH 10A,A02,083736,Patchell; Gregory David,20,0,30,10
1657643318144,MATH 10A,A03,083737,Patchell; Gregory David,16,0,30,14
1657643324167,MATH 10B,A01,083207,Lim; Seonhee,8,0,34,26
1657643324167,MATH 10B,A02,083208,Lim; Seonhee,9,0,35,26
1657643324167,MATH 10B,A03,093472,Lim; Seonhee,7,0,34,27
1657643324167,MATH 10B,B01,083739,Sinha; Shubham,12,0,30,18
1657643330191,MATH 18,A01,083743,Cinel; Cameron Alexander,7,0,30,23
1657643330191,MATH 18,A02,083744,Cinel; Cameron Alexander,17,0,30,13
1657643330191,MATH 18,A03,083745,Cinel; Cameron Alexander,9,0,30,21
1657643330191,MATH 18,B01,083748,Rideout; David Porter,5,0,37,32
1657643330191,MATH 18,B02,083749,Rideout; David Porter,5,0,36,31
1657643330191,MATH 18,B03,083750,Rideout; David Porter,3,0,37,34
1657643330191,MATH 18,B04,083751,Rideout; David Porter,6,0,36,30
1657643330191,MATH 18,B05,093473,Rideout; David Porter,6,0,36,30
1657643330191,MATH 18,B06,093474,Rideout; David Porter,6,0,36,30
1657643336213,MATH 20A,A01,083754,Zheng; Zequn,14,0,40,26
1657643342243,MATH 20B,A01,083756,Briones; Jor-el Thomas Caparas,4,0,36,32
1657643342243,MATH 20B,A02,083757,Briones; Jor-el Thomas Caparas,1,0,36,35
1657643342243,MATH 20B,A03,093475,Briones; Jor-el Thomas Caparas,2,0,36,34
1657643348282,MATH 20C,A01,083760,Briones; Jor-el Thomas Caparas,1,0,35,34
1657643348282,MATH 20C,A02,083761,Briones; Jor-el Thomas Caparas,8,0,35,27
1657643348282,MATH 20C,A03,093476,Briones; Jor-el Thomas Caparas,0,1,36,36
1657643348282,MATH 20C,B01,083762,Bach; Quang Tran,1,0,30,29
1657643354313,MATH 20D,A01,083765,Tran; Brian Kha,5,0,30,25
1657643354313,MATH 20D,A02,083766,Tran; Brian Kha,5,0,30,25
1657643354313,MATH 20D,A03,083767,Tran; Brian Kha,5,0,30,25
1657643360345,MATH 20E,A01,083771,Ganguly; Soumya,9,0,32,23
1657643360345,MATH 20E,A02,083772,Ganguly; Soumya,6,0,32,26
1657643360345,MATH 20E,B01,083773,Ciotti; Benjamin,20,0,35,15
1657643360345,MATH 20E,B02,083774,Ciotti; Benjamin,18,0,35,17
1657643366369,MATH 103A,A01,083777,Greenfeld; Be'Eri,3,0,36,33
1657643366369,MATH 103A,A02,083778,Greenfeld; Be'Eri,5,0,36,31
1657643366369,MATH 103A,A03,093561,Greenfeld; Be'Eri,6,0,36,30
1657643366369,MATH 103A,B01,083779,Greenfeld; Be'Eri,7,0,36,29
1657643366369,MATH 103A,B02,083780,Greenfeld; Be'Eri,4,0,36,32
1657643366369,MATH 103A,B03,093562,Greenfeld; Be'Eri,3,0,36,33
1657643372396,MATH 105,A01,085443,Carter; Anne Toulson,15,0,35,20
1657643372396,MATH 105,A02,093477,Carter; Anne Toulson,20,0,35,15
1657643378420,MATH 109,A01,083213,Ganzberger; Geoffrey Michael,2,0,34,32
1657643378420,MATH 109,A02,083214,Ganzberger; Geoffrey Michael,4,0,34,30
1657643378420,MATH 109,A03,093478,Ganzberger; Geoffrey Michael,2,0,34,32
1657643378420,MATH 109,B01,083215,Ganzberger; Geoffrey Michael,1,0,32,31
1657643378420,MATH 109,B02,083216,Ganzberger; Geoffrey Michael,2,0,32,30
1657643378420,MATH 109,B03,093479,Ganzberger; Geoffrey Michael,8,0,32,24
1657643384448,MATH 142A,A01,083219,Chow; Bennett,7,0,32,25
1657643384448,MATH 142A,A02,083220,Chow; Bennett,10,0,32,22
1657643384448,MATH 142A,A03,093480,Chow; Bennett,9,0,32,23
1657643384448,MATH 142A,B03,093481,Chow; Bennett,8,0,32,24
1657643384448,MATH 142A,B04,093558,Chow; Bennett,13,0,32,19
1657643384448,MATH 142A,B05,093559,Chow; Bennett,6,0,32,26
1657643390471,MATH 193A,A01,083224,Rotar; Vladimir,8,0,34,26
1657643390471,MATH 193A,A02,083225,Rotar; Vladimir,9,0,34,25
1657643390471,MATH 193A,A03,083781,Rotar; Vladimir,5,0,34,29
1657643390471,MATH 193A,A04,083782,Rotar; Vladimir,10,0,34,24
1657643390471,MATH 193A,A05,093482,Rotar; Vladimir,10,0,34,24
1657643396498,MATH 197,001,091859,McAuley; Julian John,9999,0,9999,0
1657643396498,MATH 197,002,095566,Kedlaya; Kiran S.,9997,0,9999,2
1657643396498,MATH 197,003,095567,Xiao; Ming,9999,0,9999,0
1657643396498,MATH 197,004,095571,Perols; Johan Lars,9998,0,9999,1
1657643403568,COGS 9,A01,083615,Shannon; Kyle Michael,9,0,75,66
1657643409602,COGS 11,A01,083617,Boyle; Mary E. T.,23,0,48,25
1657643415645,COGS 13,A01,083071,Bastos; Amalia Pinkusfeld,11,0,71,60
1657643421670,COGS 14A,A01,092681,Semenuks; Arturs,5,1,100,95
1657643427692,COGS 14B,A01,083073,Cheng; Tzu-Han,6,0,63,57
1657643433724,COGS 17,A01,092677,Semenuks; Arturs,6,0,81,75
1657643439748,COGS 100,A01,083619,Allen; Michael Gordon,17,0,70,53
1657643445774,COGS 101A,A01,083621,Davis; Joshua Daniel,9,0,68,59
1657643451796,COGS 101B,A01,091572,Allen; Michael Gordon,12,0,65,53
1657643457829,COGS 101C,A01,083625,Delgado; Tania,17,0,35,18
1657643463861,COGS 107A,A01,083627,Boyle; Mary E. T.,13,0,60,47
1657643469890,COGS 118A,A01,083075,Gupta; Anjum,21,0,76,55
1657643475913,CSE 3,A50,083646,Miranda; Gregory Joseph,24,0,50,26
1657643481938,CSE 8A,A50,083650,Miranda; Gregory Joseph,17,1,56,39
1657643487962,CSE 11,A01,083080,Cao; Yingjun,6,15,40,34
1657643493989,CSE 12,A01,083652,Krause-Levy; Sophia Louisa,28,1,120,92
1657643500012,CSE 15L,A01,083654,Morris; Justin Loren,9,0,50,41
1657643500012,CSE 15L,A02,083655,Morris; Justin Loren,9,0,50,41
1657643506035,CSE 20,A01,083657,Tran; Khoa Dang,39,0,80,41
1657643512062,CSE 21,A01,095574,Bach; Quang Tran,22,0,48,26
1657643518089,CSE 30,A01,083084,Eldon; John,6,0,80,74
1657643518089,CSE 30,B01,095061,Bhaskar; Nishant,9,0,50,41
1657643524112,CSE 100,A01,083659,Cao; Yingjun,5,4,70,65
1657643530145,CSE 134B,A01,083661,Powell; Thomas Allan,22,0,100,78
1657643536237,CSE 140,A01,083663,Gungor; Onat,15,0,85,70
1657643542259,CSE 140L,A01,083088,Eldon; John,21,0,100,79
1657643548285,CSE 175,A01,083665,Kumar; Rakesh,3,0,25,22
1657643554313,CSE 190,A00,092507,Dubnov; Shlomo,8,0,20,12
1657643560349,ECE 45,A01,083139,Congero; Spencer William,6,0,75,69
1657643566377,ECE 65,A50,083695,Saad; Andrew S,12,0,30,18
1657643566377,ECE 65,A51,095125,Saad; Andrew S,24,0,26,2
1657643572399,ECE 109,A01,091882,Touri; Behrouz,19,0,70,51
1657643578426,ECE 180,A00,083140,Abi Samra; Nicholas Camill,1,0,30,29
1657643578426,ECE 180,B00,083141,Abi Samra; Nicholas Camill,0,0,30,30
1657643584465,MATH 10A,A01,083735,Patchell; Gregory David,2,0,30,28
1657643584465,MATH 10A,A02,083736,Patchell; Gregory David,20,0,30,10
1657643584465,MATH 10A,A03,083737,Patchell; Gregory David,16,0,30,14
1657643590494,MATH 10B,A01,083207,Lim; Seonhee,8,0,34,26
1657643590494,MATH 10B,A02,083208,Lim; Seonhee,9,0,35,26
1657643590494,MATH 10B,A03,093472,Lim; Seonhee,7,0,34,27
1657643590494,MATH 10B,B01,083739,Sinha; Shubham,12,0,30,18
1657643596526,MATH 18,A01,083743,Cinel; Cameron Alexander,7,0,30,23
1657643596526,MATH 18,A02,083744,Cinel; Cameron Alexander,17,0,30,13
1657643596526,MATH 18,A03,083745,Cinel; Cameron Alexander,9,0,30,21
1657643596526,MATH 18,B01,083748,Rideout; David Porter,5,0,37,32
1657643596526,MATH 18,B02,083749,Rideout; David Porter,5,0,36,31
1657643596526,MATH 18,B03,083750,Rideout; David Porter,3,0,37,34
1657643596526,MATH 18,B04,083751,Rideout; David Porter,6,0,36,30
1657643596526,MATH 18,B05,093473,Rideout; David Porter,6,0,36,30
1657643596526,MATH 18,B06,093474,Rideout; David Porter,6,0,36,30
1657643602548,MATH 20A,A01,083754,Zheng; Zequn,14,0,40,26
1657643608571,MATH 20B,A01,083756,Briones; Jor-el Thomas Caparas,4,0,36,32
1657643608571,MATH 20B,A02,083757,Briones; Jor-el Thomas Caparas,1,0,36,35
1657643608571,MATH 20B,A03,093475,Briones; Jor-el Thomas Caparas,2,0,36,34
1657643614595,MATH 20C,A01,083760,Briones; Jor-el Thomas Caparas,1,0,35,34
1657643614595,MATH 20C,A02,083761,Briones; Jor-el Thomas Caparas,8,0,35,27
1657643614595,MATH 20C,A03,093476,Briones; Jor-el Thomas Caparas,0,1,36,36
1657643614595,MATH 20C,B01,083762,Bach; Quang Tran,1,0,30,29
1657643620622,MATH 20D,A01,083765,Tran; Brian Kha,5,0,30,25
1657643620622,MATH 20D,A02,083766,Tran; Brian Kha,5,0,30,25
1657643620622,MATH 20D,A03,083767,Tran; Brian Kha,5,0,30,25
1657643626649,MATH 20E,A01,083771,Ganguly; Soumya,9,0,32,23
1657643626649,MATH 20E,A02,083772,Ganguly; Soumya,6,0,32,26
1657643626649,MATH 20E,B01,083773,Ciotti; Benjamin,20,0,35,15
1657643626649,MATH 20E,B02,083774,Ciotti; Benjamin,18,0,35,17
1657643632673,MATH 103A,A01,083777,Greenfeld; Be'Eri,3,0,36,33
1657643632673,MATH 103A,A02,083778,Greenfeld; Be'Eri,5,0,36,31
1657643632673,MATH 103A,A03,093561,Greenfeld; Be'Eri,6,0,36,30
1657643632673,MATH 103A,B01,083779,Greenfeld; Be'Eri,7,0,36,29
1657643632673,MATH 103A,B02,083780,Greenfeld; Be'Eri,4,0,36,32
1657643632673,MATH 103A,B03,093562,Greenfeld; Be'Eri,3,0,36,33
1657643638695,MATH 105,A01,085443,Carter; Anne Toulson,15,0,35,20
1657643638695,MATH 105,A02,093477,Carter; Anne Toulson,20,0,35,15
1657643644730,MATH 109,A01,083213,Ganzberger; Geoffrey Michael,2,0,34,32
1657643644730,MATH 109,A02,083214,Ganzberger; Geoffrey Michael,4,0,34,30
1657643644730,MATH 109,A03,093478,Ganzberger; Geoffrey Michael,2,0,34,32
1657643644730,MATH 109,B01,083215,Ganzberger; Geoffrey Michael,1,0,32,31
1657643644730,MATH 109,B02,083216,Ganzberger; Geoffrey Michael,2,0,32,30
1657643644730,MATH 109,B03,093479,Ganzberger; Geoffrey Michael,8,0,32,24
1657643650753,MATH 142A,A01,083219,Chow; Bennett,7,0,32,25
1657643650753,MATH 142A,A02,083220,Chow; Bennett,10,0,32,22
1657643650753,MATH 142A,A03,093480,Chow; Bennett,9,0,32,23
1657643650753,MATH 142A,B03,093481,Chow; Bennett,8,0,32,24
1657643650753,MATH 142A,B04,093558,Chow; Bennett,13,0,32,19
1657643650753,MATH 142A,B05,093559,Chow; Bennett,6,0,32,26
1657643656776,MATH 193A,A01,083224,Rotar; Vladimir,8,0,34,26
1657643656776,MATH 193A,A02,083225,Rotar; Vladimir,9,0,34,25
1657643656776,MATH 193A,A03,083781,Rotar; Vladimir,5,0,34,29
1657643656776,MATH 193A,A04,083782,Rotar; Vladimir,10,0,34,24
1657643656776,MATH 193A,A05,093482,Rotar; Vladimir,10,0,34,24
1657643662804,MATH 197,001,091859,McAuley; Julian John,9999,0,9999,0
1657643662804,MATH 197,002,095566,Kedlaya; Kiran S.,9997,0,9999,2
1657643662804,MATH 197,003,095567,Xiao; Ming,9999,0,9999,0
1657643662804,MATH 197,004,095571,Perols; Johan Lars,9998,0,9999,1
1657643669865,COGS 9,A01,083615,Shannon; Kyle Michael,9,0,75,66
1657643675890,COGS 11,A01,083617,Boyle; Mary E. T.,23,0,48,25
1657643681913,COGS 13,A01,083071,Bastos; Amalia Pinkusfeld,11,0,71,60
1657643687939,COGS 14A,A01,092681,Semenuks; Arturs,5,1,100,95
1657643693962,COGS 14B,A01,083073,Cheng; Tzu-Han,6,0,63,57
1657643700002,COGS 17,A01,092677,Semenuks; Arturs,6,0,81,75
1657643706025,COGS 100,A01,083619,Allen; Michael Gordon,17,0,70,53
1657643712056,COGS 101A,A01,083621,Davis; Joshua Daniel,9,0,68,59
1657643718080,COGS 101B,A01,091572,Allen; Michael Gordon,12,0,65,53
1657643724113,COGS 101C,A01,083625,Delgado; Tania,17,0,35,18
1657643730136,COGS 107A,A01,083627,Boyle; Mary E. T.,13,0,60,47
1657643736158,COGS 118A,A01,083075,Gupta; Anjum,21,0,76,55
1657643742185,CSE 3,A50,083646,Miranda; Gregory Joseph,24,0,50,26
1657643748207,CSE 8A,A50,083650,Miranda; Gregory Joseph,17,1,56,39
1657643754233,CSE 11,A01,083080,Cao; Yingjun,6,15,40,34
1657643760259,CSE 12,A01,083652,Krause-Levy; Sophia Louisa,28,1,120,92
1657643766282,CSE 15L,A01,083654,Morris; Justin Loren,9,0,50,41
1657643766282,CSE 15L,A02,083655,Morris; Justin Loren,9,0,50,41
1657643772307,CSE 20,A01,083657,Tran; Khoa Dang,39,0,80,41
1657643778347,CSE 21,A01,095574,Bach; Quang Tran,22,0,48,26
1657643784376,CSE 30,A01,083084,Eldon; John,6,0,80,74
1657643784376,CSE 30,B01,095061,Bhaskar; Nishant,9,0,50,41
1657643790400,CSE 100,A01,083659,Cao; Yingjun,5,4,70,65
1657643796427,CSE 134B,A01,083661,Powell; Thomas Allan,22,0,100,78
1657643802460,CSE 140,A01,083663,Gungor; Onat,15,0,85,70
1657643808482,CSE 140L,A01,083088,Eldon; John,21,0,100,79
1657643814509,CSE 175,A01,083665,Kumar; Rakesh,3,0,25,22
1657643820532,CSE 190,A00,092507,Dubnov; Shlomo,8,0,20,12
1657643826556,ECE 45,A01,083139,Congero; Spencer William,6,0,75,69
1657643832578,ECE 65,A50,083695,Saad; Andrew S,12,0,30,18
1657643832578,ECE 65,A51,095125,Saad; Andrew S,24,0,26,2
1657643838619,ECE 109,A01,091882,Touri; Behrouz,19,0,70,51
1657643844645,ECE 180,A00,083140,Abi Samra; Nicholas Camill,1,0,30,29
1657643844645,ECE 180,B00,083141,Abi Samra; Nicholas Camill,0,0,30,30
1657643850668,MATH 10A,A01,083735,Patchell; Gregory David,2,0,30,28
1657643850668,MATH 10A,A02,083736,Patchell; Gregory David,20,0,30,10
1657643850668,MATH 10A,A03,083737,Patchell; Gregory David,16,0,30,14
1657643856692,MATH 10B,A01,083207,Lim; Seonhee,8,0,34,26
1657643856692,MATH 10B,A02,083208,Lim; Seonhee,9,0,35,26
1657643856692,MATH 10B,A03,093472,Lim; Seonhee,7,0,34,27
1657643856692,MATH 10B,B01,083739,Sinha; Shubham,12,0,30,18
1657643862718,MATH 18,A01,083743,Cinel; Cameron Alexander,7,0,30,23
1657643862718,MATH 18,A02,083744,Cinel; Cameron Alexander,17,0,30,13
1657643862718,MATH 18,A03,083745,Cinel; Cameron Alexander,9,0,30,21
1657643862718,MATH 18,B01,083748,Rideout; David Porter,5,0,37,32
1657643862718,MATH 18,B02,083749,Rideout; David Porter,5,0,36,31
1657643862718,MATH 18,B03,083750,Rideout; David Porter,3,0,37,34
1657643862718,MATH 18,B04,083751,Rideout; David Porter,6,0,36,30
1657643862718,MATH 18,B05,093473,Rideout; David Porter,6,0,36,30
1657643862718,MATH 18,B06,093474,Rideout; David Porter,6,0,36,30
1657643868740,MATH 20A,A01,083754,Zheng; Zequn,14,0,40,26
1657643874765,MATH 20B,A01,083756,Briones; Jor-el Thomas Caparas,4,0,36,32
1657643874765,MATH 20B,A02,083757,Briones; Jor-el Thomas Caparas,1,0,36,35
1657643874765,MATH 20B,A03,093475,Briones; Jor-el Thomas Caparas,2,0,36,34
1657643880789,MATH 20C,A01,083760,Briones; Jor-el Thomas Caparas,1,0,35,34
1657643880789,MATH 20C,A02,083761,Briones; Jor-el Thomas Caparas,8,0,35,27
1657643880789,MATH 20C,A03,093476,Briones; Jor-el Thomas Caparas,0,1,36,36
1657643880789,MATH 20C,B01,083762,Bach; Quang Tran,1,0,30,29
1657643886817,MATH 20D,A01,083765,Tran; Brian Kha,5,0,30,25
1657643886817,MATH 20D,A02,083766,Tran; Brian Kha,5,0,30,25
1657643886817,MATH 20D,A03,083767,Tran; Brian Kha,5,0,30,25
1657643892853,MATH 20E,A01,083771,Ganguly; Soumya,9,0,32,23
1657643892853,MATH 20E,A02,083772,Ganguly; Soumya,6,0,32,26
1657643892853,MATH 20E,B01,083773,Ciotti; Benjamin,20,0,35,15
1657643892853,MATH 20E,B02,083774,Ciotti; Benjamin,18,0,35,17
1657643898878,MATH 103A,A01,083777,Greenfeld; Be'Eri,3,0,36,33
1657643898878,MATH 103A,A02,083778,Greenfeld; Be'Eri,5,0,36,31
1657643898878,MATH 103A,A03,093561,Greenfeld; Be'Eri,6,0,36,30
1657643898878,MATH 103A,B01,083779,Greenfeld; Be'Eri,7,0,36,29
1657643898878,MATH 103A,B02,083780,Greenfeld; Be'Eri,4,0,36,32
1657643898878,MATH 103A,B03,093562,Greenfeld; Be'Eri,3,0,36,33
1657643904904,MATH 105,A01,085443,Carter; Anne Toulson,15,0,35,20
1657643904904,MATH 105,A02,093477,Carter; Anne Toulson,20,0,35,15
1657643910938,MATH 109,A01,083213,Ganzberger; Geoffrey Michael,2,0,34,32
1657643910938,MATH 109,A02,083214,Ganzberger; Geoffrey Michael,4,0,34,30
1657643910938,MATH 109,A03,093478,Ganzberger; Geoffrey Michael,2,0,34,32
1657643910938,MATH 109,B01,083215,Ganzberger; Geoffrey Michael,1,0,32,31
1657643910938,MATH 109,B02,083216,Ganzberger; Geoffrey Michael,2,0,32,30
1657643910938,MATH 109,B03,093479,Ganzberger; Geoffrey Michael,8,0,32,24
1657643916975,MATH 142A,A01,083219,Chow; Bennett,7,0,32,25
1657643916975,MATH 142A,A02,083220,Chow; Bennett,10,0,32,22
1657643916975,MATH 142A,A03,093480,Chow; Bennett,9,0,32,23
1657643916975,MATH 142A,B03,093481,Chow; Bennett,8,0,32,24
1657643916975,MATH 142A,B04,093558,Chow; Bennett,13,0,32,19
1657643916975,MATH 142A,B05,093559,Chow; Bennett,6,0,32,26
1657643923003,MATH 193A,A01,083224,Rotar; Vladimir,8,0,34,26
1657643923003,MATH 193A,A02,083225,Rotar; Vladimir,9,0,34,25
1657643923003,MATH 193A,A03,083781,Rotar; Vladimir,5,0,34,29
1657643923003,MATH 193A,A04,083782,Rotar; Vladimir,10,0,34,24
1657643923003,MATH 193A,A05,093482,Rotar; Vladimir,10,0,34,24
1657643929027,MATH 197,001,091859,McAuley; Julian John,9999,0,9999,0
1657643929027,MATH 197,002,095566,Kedlaya; Kiran S.,9997,0,9999,2
1657643929027,MATH 197,003,095567,Xiao; Ming,9999,0,9999,0
1657643929027,MATH 197,004,095571,Perols; Johan Lars,9998,0,9999,1
1657643936089,COGS 9,A01,083615,Shannon; Kyle Michael,9,0,75,66
1657643942113,COGS 11,A01,083617,Boyle; Mary E. T.,23,0,48,25
1657643948139,COGS 13,A01,083071,Bastos; Amalia Pinkusfeld,11,0,71,60
1657643954165,COGS 14A,A01,092681,Semenuks; Arturs,5,1,100,95
1657643960186,COGS 14B,A01,083073,Cheng; Tzu-Han,6,0,63,57
1657643966220,COGS 17,A01,092677,Semenuks; Arturs,6,0,81,75
1657643972250,COGS 100,A01,083619,Allen; Michael Gordon,17,0,70,53
1657643978274,COGS 101A,A01,083621,Davis; Joshua Daniel,9,0,68,59
1657643984298,COGS 101B,A01,091572,Allen; Michael Gordon,12,0,65,53
1657643990322,COGS 101C,A01,083625,Delgado; Tania,17,0,35,18
1657643996344,COGS 107A,A01,083627,Boyle; Mary E. T.,13,0,60,47
1657644002367,COGS 118A,A01,083075,Gupta; Anjum,21,0,76,55
1657644008404,CSE 3,A50,083646,Miranda; Gregory Joseph,24,0,50,26
1657644014427,CSE 8A,A50,083650,Miranda; Gregory Joseph,17,1,56,39
1657644020454,CSE 11,A01,083080,Cao; Yingjun,6,15,40,34
1657644026477,CSE 12,A01,083652,Krause-Levy; Sophia Louisa,28,1,120,92
1657644032510,CSE 15L,A01,083654,Morris; Justin Loren,9,0,50,41
1657644032510,CSE 15L,A02,083655,Morris; Justin Loren,9,0,50,41
1657644038532,CSE 20,A01,083657,Tran; Khoa Dang,39,0,80,41
1657644044562,CSE 21,A01,095574,Bach; Quang Tran,22,0,48,26
1657644050598,CSE 30,A01,083084,Eldon; John,6,0,80,74
1657644050598,CSE 30,B01,095061,Bhaskar; Nishant,9,0,50,41
1657644056624,CSE 100,A01,083659,Cao; Yingjun,5,4,70,65
1657644062650,CSE 134B,A01,083661,Powell; Thomas Allan,22,0,100,78
1657644068676,CSE 140,A01,083663,Gungor; Onat,15,0,85,70
1657644074698,CSE 140L,A01,083088,Eldon; John,21,0,100,79
1657644080728,CSE 175,A01,083665,Kumar; Rakesh,3,0,25,22
1657644086753,CSE 190,A00,092507,Dubnov; Shlomo,8,0,20,12
1657644092776,ECE 45,A01,083139,Congero; Spencer William,6,0,75,69
1657644098801,ECE 65,A50,083695,Saad; Andrew S,12,0,30,18
1657644098801,ECE 65,A51,095125,Saad; Andrew S,24,0,26,2
1657644104827,ECE 109,A01,091882,Touri; Behrouz,19,0,70,51
1657644110850,ECE 180,A00,083140,Abi Samra; Nicholas Camill,1,0,30,29
1657644110850,ECE 180,B00,083141,Abi Samra; Nicholas Camill,0,0,30,30
1657644116878,MATH 10A,A01,083735,Patchell; Gregory David,2,0,30,28
1657644116878,MATH 10A,A02,083736,Patchell; Gregory David,20,0,30,10
1657644116878,MATH 10A,A03,083737,Patchell; Gregory David,16,0,30,14
1657644122906,MATH 10B,A01,083207,Lim; Seonhee,8,0,34,26
1657644122906,MATH 10B,A02,083208,Lim; Seonhee,9,0,35,26
1657644122906,MATH 10B,A03,093472,Lim; Seonhee,7,0,34,27
1657644122906,MATH 10B,B01,083739,Sinha; Shubham,12,0,30,18
1657644128938,MATH 18,A01,083743,Cinel; Cameron Alexander,7,0,30,23
1657644128938,MATH 18,A02,083744,Cinel; Cameron Alexander,17,0,30,13
1657644128938,MATH 18,A03,083745,Cinel; Cameron Alexander,9,0,30,21
1657644128938,MATH 18,B01,083748,Rideout; David Porter,5,0,37,32
1657644128938,MATH 18,B02,083749,Rideout; David Porter,5,0,36,31
1657644128938,MATH 18,B03,083750,Rideout; David Porter,3,0,37,34
1657644128938,MATH 18,B04,083751,Rideout; David Porter,6,0,36,30
1657644128938,MATH 18,B05,093473,Rideout; David Porter,6,0,36,30
1657644128938,MATH 18,B06,093474,Rideout; David Porter,6,0,36,30
1657644135036,MATH 20A,A01,083754,Zheng; Zequn,14,0,40,26
1657644141058,MATH 20B,A01,083756,Briones; Jor-el Thomas Caparas,4,0,36,32
1657644141058,MATH 20B,A02,083757,Briones; Jor-el Thomas Caparas,1,0,36,35
1657644141058,MATH 20B,A03,093475,Briones; Jor-el Thomas Caparas,2,0,36,34
1657644147083,MATH 20C,A01,083760,Briones; Jor-el Thomas Caparas,1,0,35,34
1657644147083,MATH 20C,A02,083761,Briones; Jor-el Thomas Caparas,8,0,35,27
1657644147083,MATH 20C,A03,093476,Briones; Jor-el Thomas Caparas,0,1,36,36
1657644147083,MATH 20C,B01,083762,Bach; Quang Tran,1,0,30,29
1657644153118,MATH 20D,A01,083765,Tran; Brian Kha,5,0,30,25
1657644153118,MATH 20D,A02,083766,Tran; Brian Kha,5,0,30,25
1657644153118,MATH 20D,A03,083767,Tran; Brian Kha,5,0,30,25
1657644159146,MATH 20E,A01,083771,Ganguly; Soumya,9,0,32,23
1657644159146,MATH 20E,A02,083772,Ganguly; Soumya,6,0,32,26
1657644159146,MATH 20E,B01,083773,Ciotti; Benjamin,20,0,35,15
1657644159146,MATH 20E,B02,083774,Ciotti; Benjamin,18,0,35,17
1657644165176,MATH 103A,A01,083777,Greenfeld; Be'Eri,3,0,36,33
1657644165176,MATH 103A,A02,083778,Greenfeld; Be'Eri,5,0,36,31
1657644165176,MATH 103A,A03,093561,Greenfeld; Be'Eri,6,0,36,30
1657644165176,MATH 103A,B01,083779,Greenfeld; Be'Eri,7,0,36,29
1657644165176,MATH 103A,B02,083780,Greenfeld; Be'Eri,4,0,36,32
1657644165176,MATH 103A,B03,093562,Greenfeld; Be'Eri,3,0,36,33
1657644171204,MATH 105,A01,085443,Carter; Anne Toulson,15,0,35,20
1657644171204,MATH 105,A02,093477,Carter; Anne Toulson,20,0,35,15
1657644177234,MATH 109,A01,083213,Ganzberger; Geoffrey Michael,2,0,34,32
1657644177234,MATH 109,A02,083214,Ganzberger; Geoffrey Michael,4,0,34,30
1657644177234,MATH 109,A03,093478,Ganzberger; Geoffrey Michael,2,0,34,32
1657644177234,MATH 109,B01,083215,Ganzberger; Geoffrey Michael,1,0,32,31
1657644177234,MATH 109,B02,083216,Ganzberger; Geoffrey Michael,2,0,32,30
1657644177234,MATH 109,B03,093479,Ganzberger; Geoffrey Michael,8,0,32,24
1657644183265,MATH 142A,A01,083219,Chow; Bennett,7,0,32,25
1657644183265,MATH 142A,A02,083220,Chow; Bennett,10,0,32,22
1657644183265,MATH 142A,A03,093480,Chow; Bennett,9,0,32,23
1657644183265,MATH 142A,B03,093481,Chow; Bennett,8,0,32,24
1657644183265,MATH 142A,B04,093558,Chow; Bennett,13,0,32,19
1657644183265,MATH 142A,B05,093559,Chow; Bennett,6,0,32,26
1657644189296,MATH 193A,A01,083224,Rotar; Vladimir,8,0,34,26
1657644189296,MATH 193A,A02,083225,Rotar; Vladimir,9,0,34,25
1657644189296,MATH 193A,A03,083781,Rotar; Vladimir,5,0,34,29
1657644189296,MATH 193A,A04,083782,Rotar; Vladimir,10,0,34,24
1657644189296,MATH 193A,A05,093482,Rotar; Vladimir,10,0,34,24
1657644195318,MATH 197,001,091859,McAuley; Julian John,9999,0,9999,0
1657644195318,MATH 197,002,095566,Kedlaya; Kiran S.,9997,0,9999,2
1657644195318,MATH 197,003,095567,Xiao; Ming,9999,0,9999,0
1657644195318,MATH 197,004,095571,Perols; Johan Lars,9998,0,9999,1
1657644202371,COGS 9,A01,083615,Shannon; Kyle Michael,9,0,75,66
1657644208399,COGS 11,A01,083617,Boyle; Mary E. T.,23,0,48,25
1657644214425,COGS 13,A01,083071,Bastos; Amalia Pinkusfeld,11,0,71,60
1657644220453,COGS 14A,A01,092681,Semenuks; Arturs,5,1,100,95
1657644226475,COGS 14B,A01,083073,Cheng; Tzu-Han,6,0,63,57
1657644232498,COGS 17,A01,092677,Semenuks; Arturs,6,0,81,75
1657644238524,COGS 100,A01,083619,Allen; Michael Gordon,17,0,70,53
1657644244545,COGS 101A,A01,083621,Davis; Joshua Daniel,9,0,68,59
1657644250568,COGS 101B,A01,091572,Allen; Michael Gordon,12,0,65,53
1657644256605,COGS 101C,A01,083625,Delgado; Tania,17,0,35,18
1657644262630,COGS 107A,A01,083627,Boyle; Mary E. T.,13,0,60,47
1657644268659,COGS 118A,A01,083075,Gupta; Anjum,21,0,76,55
1657644274683,CSE 3,A50,083646,Miranda; Gregory Joseph,24,0,50,26
1657644280705,CSE 8A,A50,083650,Miranda; Gregory Joseph,17,1,56,39
1657644286729,CSE 11,A01,083080,Cao; Yingjun,6,15,40,34
1657644292752,CSE 12,A01,083652,Krause-Levy; Sophia Louisa,28,1,120,92
1657644298780,CSE 15L,A01,083654,Morris; Justin Loren,9,0,50,41
1657644298780,CSE 15L,A02,083655,Morris; Justin Loren,9,0,50,41
1657644304809,CSE 20,A01,083657,Tran; Khoa Dang,39,0,80,41
1657644310831,CSE 21,A01,095574,Bach; Quang Tran,22,0,48,26
1657644316858,CSE 30,A01,083084,Eldon; John,6,0,80,74
1657644316858,CSE 30,B01,095061,Bhaskar; Nishant,9,0,50,41
1657644322881,CSE 100,A01,083659,Cao; Yingjun,5,4,70,65
1657644328905,CSE 134B,A01,083661,Powell; Thomas Allan,22,0,100,78
1657644334935,CSE 140,A01,083663,Gungor; Onat,15,0,85,70
1657644340961,CSE 140L,A01,083088,Eldon; John,21,0,100,79
1657644346985,CSE 175,A01,083665,Kumar; Rakesh,3,0,25,22
1657644353011,CSE 190,A00,092507,Dubnov; Shlomo,8,0,20,12
1657644359042,ECE 45,A01,083139,Congero; Spencer William,6,0,75,69
1657644365065,ECE 65,A50,083695,Saad; Andrew S,12,0,30,18
1657644365065,ECE 65,A51,095125,Saad; Andrew S,24,0,26,2
1657644371089,ECE 109,A01,091882,Touri; Behrouz,19,0,70,51
1657644377116,ECE 180,A00,083140,Abi Samra; Nicholas Camill,1,0,30,29
1657644377116,ECE 180,B00,083141,Abi Samra; Nicholas Camill,0,0,30,30
1657644383144,MATH 10A,A01,083735,Patchell; Gregory David,2,0,30,28
1657644383144,MATH 10A,A02,083736,Patchell; Gregory David,20,0,30,10
1657644383144,MATH 10A,A03,083737,Patchell; Gregory David,16,0,30,14
1657644389168,MATH 10B,A01,083207,Lim; Seonhee,8,0,34,26
1657644389168,MATH 10B,A02,083208,Lim; Seonhee,9,0,35,26
1657644389168,MATH 10B,A03,093472,Lim; Seonhee,7,0,34,27
1657644389168,MATH 10B,B01,083739,Sinha; Shubham,12,0,30,18
1657644395191,MATH 18,A01,083743,Cinel; Cameron Alexander,7,0,30,23
1657644395191,MATH 18,A02,083744,Cinel; Cameron Alexander,17,0,30,13
1657644395191,MATH 18,A03,083745,Cinel; Cameron Alexander,9,0,30,21
1657644395191,MATH 18,B01,083748,Rideout; David Porter,5,0,37,32
1657644395191,MATH 18,B02,083749,Rideout; David Porter,5,0,36,31
1657644395191,MATH 18,B03,083750,Rideout; David Porter,3,0,37,34
1657644395191,MATH 18,B04,083751,Rideout; David Porter,6,0,36,30
1657644395191,MATH 18,B05,093473,Rideout; David Porter,6,0,36,30
1657644395191,MATH 18,B06,093474,Rideout; David Porter,6,0,36,30
1657644401214,MATH 20A,A01,083754,Zheng; Zequn,14,0,40,26
1657644407242,MATH 20B,A01,083756,Briones; Jor-el Thomas Caparas,4,0,36,32
1657644407242,MATH 20B,A02,083757,Briones; Jor-el Thomas Caparas,1,0,36,35
1657644407242,MATH 20B,A03,093475,Briones; Jor-el Thomas Caparas,2,0,36,34
1657644413265,MATH 20C,A01,083760,Briones; Jor-el Thomas Caparas,1,0,35,34
1657644413265,MATH 20C,A02,083761,Briones; Jor-el Thomas Caparas,8,0,35,27
1657644413265,MATH 20C,A03,093476,Briones; Jor-el Thomas Caparas,0,1,36,36
1657644413265,MATH 20C,B01,083762,Bach; Quang Tran,1,0,30,29
1657644419289,MATH 20D,A01,083765,Tran; Brian Kha,5,0,30,25
1657644419289,MATH 20D,A02,083766,Tran; Brian Kha,5,0,30,25
1657644419289,MATH 20D,A03,083767,Tran; Brian Kha,5,0,30,25
1657644425322,MATH 20E,A01,083771,Ganguly; Soumya,9,0,32,23
1657644425322,MATH 20E,A02,083772,Ganguly; Soumya,6,0,32,26
1657644425322,MATH 20E,B01,083773,Ciotti; Benjamin,20,0,35,15
1657644425322,MATH 20E,B02,083774,Ciotti; Benjamin,18,0,35,17
1657644431346,MATH 103A,A01,083777,Greenfeld; Be'Eri,3,0,36,33
1657644431346,MATH 103A,A02,083778,Greenfeld; Be'Eri,5,0,36,31
1657644431346,MATH 103A,A03,093561,Greenfeld; Be'Eri,6,0,36,30
1657644431346,MATH 103A,B01,083779,Greenfeld; Be'Eri,7,0,36,29
1657644431346,MATH 103A,B02,083780,Greenfeld; Be'Eri,4,0,36,32
1657644431346,MATH 103A,B03,093562,Greenfeld; Be'Eri,3,0,36,33
1657644437382,MATH 105,A01,085443,Carter; Anne Toulson,15,0,35,20
1657644437382,MATH 105,A02,093477,Carter; Anne Toulson,20,0,35,15
1657644443412,MATH 109,A01,083213,Ganzberger; Geoffrey Michael,2,0,34,32
1657644443412,MATH 109,A02,083214,Ganzberger; Geoffrey Michael,4,0,34,30
1657644443412,MATH 109,A03,093478,Ganzberger; Geoffrey Michael,2,0,34,32
1657644443412,MATH 109,B01,083215,Ganzberger; Geoffrey Michael,1,0,32,31
1657644443412,MATH 109,B02,083216,Ganzberger; Geoffrey Michael,2,0,32,30
1657644443412,MATH 109,B03,093479,Ganzberger; Geoffrey Michael,8,0,32,24
1657644449438,MATH 142A,A01,083219,Chow; Bennett,7,0,32,25
1657644449438,MATH 142A,A02,083220,Chow; Bennett,10,0,32,22
1657644449438,MATH 142A,A03,093480,Chow; Bennett,9,0,32,23
1657644449438,MATH 142A,B03,093481,Chow; Bennett,8,0,32,24
1657644449438,MATH 142A,B04,093558,Chow; Bennett,13,0,32,19
1657644449438,MATH 142A,B05,093559,Chow; Bennett,6,0,32,26
1657644455463,MATH 193A,A01,083224,Rotar; Vladimir,8,0,34,26
1657644455463,MATH 193A,A02,083225,Rotar; Vladimir,9,0,34,25
1657644455463,MATH 193A,A03,083781,Rotar; Vladimir,5,0,34,29
1657644455463,MATH 193A,A04,083782,Rotar; Vladimir,10,0,34,24
1657644455463,MATH 193A,A05,093482,Rotar; Vladimir,10,0,34,24
1657644461490,MATH 197,001,091859,McAuley; Julian John,9999,0,9999,0
1657644461490,MATH 197,002,095566,Kedlaya; Kiran S.,9997,0,9999,2
1657644461490,MATH 197,003,095567,Xiao; Ming,9999,0,9999,0
1657644461490,MATH 197,004,095571,Perols; Johan Lars,9998,0,9999,1
1657644468556,COGS 9,A01,083615,Shannon; Kyle Michael,9,0,75,66
1657644474580,COGS 11,A01,083617,Boyle; Mary E. T.,23,0,48,25
1657644480602,COGS 13,A01,083071,Bastos; Amalia Pinkusfeld,11,0,71,60
1657644486624,COGS 14A,A01,092681,Semenuks; Arturs,5,1,100,95
1657644492650,COGS 14B,A01,083073,Cheng; Tzu-Han,6,0,63,57
1657644498679,COGS 17,A01,092677,Semenuks; Arturs,6,0,81,75
1657644504705,COGS 100,A01,083619,Allen; Michael Gordon,17,0,70,53
1657644510732,COGS 101A,A01,083621,Davis; Joshua Daniel,9,0,68,59
1657644516754,COGS 101B,A01,091572,Allen; Michael Gordon,12,0,65,53
1657644522778,COGS 101C,A01,083625,Delgado; Tania,17,0,35,18
1657644528805,COGS 107A,A01,083627,Boyle; Mary E. T.,13,0,60,47
1657644534831,COGS 118A,A01,083075,Gupta; Anjum,21,0,76,55
1657644540854,CSE 3,A50,083646,Miranda; Gregory Joseph,24,0,50,26
1657644546877,CSE 8A,A50,083650,Miranda; Gregory Joseph,17,1,56,39
1657644552900,CSE 11,A01,083080,Cao; Yingjun,6,15,40,34
1657644558925,CSE 12,A01,083652,Krause-Levy; Sophia Louisa,28,1,120,92
1657644564954,CSE 15L,A01,083654,Morris; Justin Loren,9,0,50,41
1657644564954,CSE 15L,A02,083655,Morris; Justin Loren,9,0,50,41
1657644570976,CSE 20,A01,083657,Tran; Khoa Dang,39,0,80,41
1657644577008,CSE 21,A01,095574,Bach; Quang Tran,22,0,48,26
1657644583032,CSE 30,A01,083084,Eldon; John,6,0,80,74
1657644583032,CSE 30,B01,095061,Bhaskar; Nishant,9,0,50,41
1657644589062,CSE 100,A01,083659,Cao; Yingjun,5,4,70,65
1657644595085,CSE 134B,A01,083661,Powell; Thomas Allan,22,0,100,78
1657644601110,CSE 140,A01,083663,Gungor; Onat,15,0,85,70
1657644607132,CSE 140L,A01,083088,Eldon; John,21,0,100,79
1657644613155,CSE 175,A01,083665,Kumar; Rakesh,3,0,25,22
1657644619188,CSE 190,A00,092507,Dubnov; Shlomo,8,0,20,12
1657644625228,ECE 45,A01,083139,Congero; Spencer William,6,0,75,69
1657644631262,ECE 65,A50,083695,Saad; Andrew S,12,0,30,18
1657644631262,ECE 65,A51,095125,Saad; Andrew S,24,0,26,2
1657644637289,ECE 109,A01,091882,Touri; Behrouz,19,0,70,51
1657644643313,ECE 180,A00,083140,Abi Samra; Nicholas Camill,1,0,30,29
1657644643313,ECE 180,B00,083141,Abi Samra; Nicholas Camill,0,0,30,30
1657644649340,MATH 10A,A01,083735,Patchell; Gregory David,2,0,30,28
1657644649340,MATH 10A,A02,083736,Patchell; Gregory David,20,0,30,10
1657644649340,MATH 10A,A03,083737,Patchell; Gregory David,16,0,30,14
1657644655369,MATH 10B,A01,083207,Lim; Seonhee,8,0,34,26
1657644655369,MATH 10B,A02,083208,Lim; Seonhee,9,0,35,26
1657644655369,MATH 10B,A03,093472,Lim; Seonhee,7,0,34,27
1657644655369,MATH 10B,B01,083739,Sinha; Shubham,12,0,30,18
1657644661393,MATH 18,A01,083743,Cinel; Cameron Alexander,7,0,30,23
1657644661393,MATH 18,A02,083744,Cinel; Cameron Alexander,17,0,30,13
1657644661393,MATH 18,A03,083745,Cinel; Cameron Alexander,9,0,30,21
1657644661393,MATH 18,B01,083748,Rideout; David Porter,5,0,37,32
1657644661393,MATH 18,B02,083749,Rideout; David Porter,5,0,36,31
1657644661393,MATH 18,B03,083750,Rideout; David Porter,3,0,37,34
1657644661393,MATH 18,B04,083751,Rideout; David Porter,6,0,36,30
1657644661393,MATH 18,B05,093473,Rideout; David Porter,6,0,36,30
1657644661393,MATH 18,B06,093474,Rideout; David Porter,6,0,36,30
1657644667421,MATH 20A,A01,083754,Zheng; Zequn,14,0,40,26
1657644673443,MATH 20B,A01,083756,Briones; Jor-el Thomas Caparas,4,0,36,32
1657644673443,MATH 20B,A02,083757,Briones; Jor-el Thomas Caparas,1,0,36,35
1657644673443,MATH 20B,A03,093475,Briones; Jor-el Thomas Caparas,2,0,36,34
1657644679466,MATH 20C,A01,083760,Briones; Jor-el Thomas Caparas,1,0,35,34
1657644679466,MATH 20C,A02,083761,Briones; Jor-el Thomas Caparas,8,0,35,27
1657644679466,MATH 20C,A03,093476,Briones; Jor-el Thomas Caparas,0,1,36,36
1657644679466,MATH 20C,B01,083762,Bach; Quang Tran,1,0,30,29
1657644685490,MATH 20D,A01,083765,Tran; Brian Kha,5,0,30,25
1657644685490,MATH 20D,A02,083766,Tran; Brian Kha,5,0,30,25
1657644685490,MATH 20D,A03,083767,Tran; Brian Kha,5,0,30,25
1657644691514,MATH 20E,A01,083771,Ganguly; Soumya,9,0,32,23
1657644691514,MATH 20E,A02,083772,Ganguly; Soumya,6,0,32,26
1657644691514,MATH 20E,B01,083773,Ciotti; Benjamin,20,0,35,15
1657644691514,MATH 20E,B02,083774,Ciotti; Benjamin,18,0,35,17
1657644697538,MATH 103A,A01,083777,Greenfeld; Be'Eri,3,0,36,33
1657644697538,MATH 103A,A02,083778,Greenfeld; Be'Eri,5,0,36,31
1657644697538,MATH 103A,A03,093561,Greenfeld; Be'Eri,6,0,36,30
1657644697538,MATH 103A,B01,083779,Greenfeld; Be'Eri,7,0,36,29
1657644697538,MATH 103A,B02,083780,Greenfeld; Be'Eri,4,0,36,32
1657644697538,MATH 103A,B03,093562,Greenfeld; Be'Eri,3,0,36,33
1657644703565,MATH 105,A01,085443,Carter; Anne Toulson,15,0,35,20
1657644703565,MATH 105,A02,093477,Carter; Anne Toulson,20,0,35,15
1657644709588,MATH 109,A01,083213,Ganzberger; Geoffrey Michael,2,0,34,32
1657644709588,MATH 109,A02,083214,Ganzberger; Geoffrey Michael,4,0,34,30
1657644709588,MATH 109,A03,093478,Ganzberger; Geoffrey Michael,2,0,34,32
1657644709588,MATH 109,B01,083215,Ganzberger; Geoffrey Michael,1,0,32,31
1657644709588,MATH 109,B02,083216,Ganzberger; Geoffrey Michael,2,0,32,30
1657644709588,MATH 109,B03,093479,Ganzberger; Geoffrey Michael,8,0,32,24
1657644715616,MATH 142A,A01,083219,Chow; Bennett,7,0,32,25
1657644715616,MATH 142A,A02,083220,Chow; Bennett,10,0,32,22
1657644715616,MATH 142A,A03,093480,Chow; Bennett,9,0,32,23
1657644715616,MATH 142A,B03,093481,Chow; Bennett,8,0,32,24
1657644715616,MATH 142A,B04,093558,Chow; Bennett,13,0,32,19
1657644715616,MATH 142A,B05,093559,Chow; Bennett,6,0,32,26
1657644721644,MATH 193A,A01,083224,Rotar; Vladimir,8,0,34,26
1657644721644,MATH 193A,A02,083225,Rotar; Vladimir,9,0,34,25
1657644721644,MATH 193A,A03,083781,Rotar; Vladimir,5,0,34,29
1657644721644,MATH 193A,A04,083782,Rotar; Vladimir,10,0,34,24
1657644721644,MATH 193A,A05,093482,Rotar; Vladimir,10,0,34,24
1657644727673,MATH 197,001,091859,McAuley; Julian John,9999,0,9999,0
1657644727673,MATH 197,002,095566,Kedlaya; Kiran S.,9997,0,9999,2
1657644727673,MATH 197,003,095567,Xiao; Ming,9999,0,9999,0
1657644727673,MATH 197,004,095571,Perols; Johan Lars,9998,0,9999,1
1657644734814,COGS 9,A01,083615,Shannon; Kyle Michael,9,0,75,66
1657644740841,COGS 11,A01,083617,Boyle; Mary E. T.,23,0,48,25
1657644746864,COGS 13,A01,083071,Bastos; Amalia Pinkusfeld,11,0,71,60
1657644752887,COGS 14A,A01,092681,Semenuks; Arturs,5,1,100,95
1657644758923,COGS 14B,A01,083073,Cheng; Tzu-Han,6,0,63,57
1657644764948,COGS 17,A01,092677,Semenuks; Arturs,6,0,81,75
1657644770973,COGS 100,A01,083619,Allen; Michael Gordon,17,0,70,53
1657644776998,COGS 101A,A01,083621,Davis; Joshua Daniel,9,0,68,59
1657644783025,COGS 101B,A01,091572,Allen; Michael Gordon,12,0,65,53
1657644789051,COGS 101C,A01,083625,Delgado; Tania,17,0,35,18
1657644795082,COGS 107A,A01,083627,Boyle; Mary E. T.,13,0,60,47
1657644801107,COGS 118A,A01,083075,Gupta; Anjum,21,0,76,55
1657644807150,CSE 3,A50,083646,Miranda; Gregory Joseph,24,0,50,26
1657644813184,CSE 8A,A50,083650,Miranda; Gregory Joseph,17,1,56,39
1657644819210,CSE 11,A01,083080,Cao; Yingjun,6,15,40,34
1657644825244,CSE 12,A01,083652,Krause-Levy; Sophia Louisa,28,1,120,92
1657644831270,CSE 15L,A01,083654,Morris; Justin Loren,9,0,50,41
1657644831270,CSE 15L,A02,083655,Morris; Justin Loren,9,0,50,41
1657644837293,CSE 20,A01,083657,Tran; Khoa Dang,39,0,80,41
1657644843314,CSE 21,A01,095574,Bach; Quang Tran,22,0,48,26
1657644849337,CSE 30,A01,083084,Eldon; John,6,0,80,74
1657644849337,CSE 30,B01,095061,Bhaskar; Nishant,9,0,50,41
1657644855362,CSE 100,A01,083659,Cao; Yingjun,5,4,70,65
1657644861392,CSE 134B,A01,083661,Powell; Thomas Allan,22,0,100,78
1657644867417,CSE 140,A01,083663,Gungor; Onat,15,0,85,70
1657644873439,CSE 140L,A01,083088,Eldon; John,21,0,100,79
1657644879461,CSE 175,A01,083665,Kumar; Rakesh,3,0,25,22
1657644885494,CSE 190,A00,092507,Dubnov; Shlomo,8,0,20,12
1657644891517,ECE 45,A01,083139,Congero; Spencer William,6,0,75,69
1657644897556,ECE 65,A50,083695,Saad; Andrew S,12,0,30,18
1657644897556,ECE 65,A51,095125,Saad; Andrew S,24,0,26,2
1657644903579,ECE 109,A01,091882,Touri; Behrouz,19,0,70,51
1657644909607,ECE 180,A00,083140,Abi Samra; Nicholas Camill,1,0,30,29
1657644909607,ECE 180,B00,083141,Abi Samra; Nicholas Camill,0,0,30,30
1657644915635,MATH 10A,A01,083735,Patchell; Gregory David,2,0,30,28
1657644915635,MATH 10A,A02,083736,Patchell; Gregory David,20,0,30,10
1657644915635,MATH 10A,A03,083737,Patchell; Gregory David,16,0,30,14
1657644921663,MATH 10B,A01,083207,Lim; Seonhee,8,0,34,26
1657644921663,MATH 10B,A02,083208,Lim; Seonhee,9,0,35,26
1657644921663,MATH 10B,A03,093472,Lim; Seonhee,7,0,34,27
1657644921663,MATH 10B,B01,083739,Sinha; Shubham,12,0,30,18
1657644927689,MATH 18,A01,083743,Cinel; Cameron Alexander,7,0,30,23
1657644927689,MATH 18,A02,083744,Cinel; Cameron Alexander,17,0,30,13
1657644927689,MATH 18,A03,083745,Cinel; Cameron Alexander,9,0,30,21
1657644927689,MATH 18,B01,083748,Rideout; David Porter,5,0,37,32
1657644927689,MATH 18,B02,083749,Rideout; David Porter,5,0,36,31
1657644927689,MATH 18,B03,083750,Rideout; David Porter,3,0,37,34
1657644927689,MATH 18,B04,083751,Rideout; David Porter,6,0,36,30
1657644927689,MATH 18,B05,093473,Rideout; David Porter,6,0,36,30
1657644927689,MATH 18,B06,093474,Rideout; David Porter,6,0,36,30
1657644933717,MATH 20A,A01,083754,Zheng; Zequn,14,0,40,26
1657644939751,MATH 20B,A01,083756,Briones; Jor-el Thomas Caparas,4,0,36,32
1657644939751,MATH 20B,A02,083757,Briones; Jor-el Thomas Caparas,1,0,36,35
1657644939751,MATH 20B,A03,093475,Briones; Jor-el Thomas Caparas,2,0,36,34
1657644945775,MATH 20C,A01,083760,Briones; Jor-el Thomas Caparas,1,0,35,34
1657644945775,MATH 20C,A02,083761,Briones; Jor-el Thomas Caparas,8,0,35,27
1657644945775,MATH 20C,A03,093476,Briones; Jor-el Thomas Caparas,0,1,36,36
1657644945775,MATH 20C,B01,083762,Bach; Quang Tran,1,0,30,29
1657644951799,MATH 20D,A01,083765,Tran; Brian Kha,5,0,30,25
1657644951799,MATH 20D,A02,083766,Tran; Brian Kha,5,0,30,25
1657644951799,MATH 20D,A03,083767,Tran; Brian Kha,5,0,30,25
1657644957829,MATH 20E,A01,083771,Ganguly; Soumya,9,0,32,23
1657644957829,MATH 20E,A02,083772,Ganguly; Soumya,6,0,32,26
1657644957829,MATH 20E,B01,083773,Ciotti; Benjamin,20,0,35,15
1657644957829,MATH 20E,B02,083774,Ciotti; Benjamin,18,0,35,17
1657644963854,MATH 103A,A01,083777,Greenfeld; Be'Eri,3,0,36,33
1657644963854,MATH 103A,A02,083778,Greenfeld; Be'Eri,5,0,36,31
1657644963854,MATH 103A,A03,093561,Greenfeld; Be'Eri,6,0,36,30
1657644963854,MATH 103A,B01,083779,Greenfeld; Be'Eri,7,0,36,29
1657644963854,MATH 103A,B02,083780,Greenfeld; Be'Eri,4,0,36,32
1657644963854,MATH 103A,B03,093562,Greenfeld; Be'Eri,3,0,36,33
1657644969882,MATH 105,A01,085443,Carter; Anne Toulson,15,0,35,20
1657644969882,MATH 105,A02,093477,Carter; Anne Toulson,20,0,35,15
1657644975914,MATH 109,A01,083213,Ganzberger; Geoffrey Michael,2,0,34,32
1657644975914,MATH 109,A02,083214,Ganzberger; Geoffrey Michael,4,0,34,30
1657644975914,MATH 109,A03,093478,Ganzberger; Geoffrey Michael,2,0,34,32
1657644975914,MATH 109,B01,083215,Ganzberger; Geoffrey Michael,1,0,32,31
1657644975914,MATH 109,B02,083216,Ganzberger; Geoffrey Michael,2,0,32,30
1657644975914,MATH 109,B03,093479,Ganzberger; Geoffrey Michael,8,0,32,24
1657644981941,MATH 142A,A01,083219,Chow; Bennett,7,0,32,25
1657644981941,MATH 142A,A02,083220,Chow; Bennett,10,0,32,22
1657644981941,MATH 142A,A03,093480,Chow; Bennett,9,0,32,23
1657644981941,MATH 142A,B03,093481,Chow; Bennett,8,0,32,24
1657644981941,MATH 142A,B04,093558,Chow; Bennett,13,0,32,19
1657644981941,MATH 142A,B05,093559,Chow; Bennett,6,0,32,26
1657644987974,MATH 193A,A01,083224,Rotar; Vladimir,8,0,34,26
1657644987974,MATH 193A,A02,083225,Rotar; Vladimir,9,0,34,25
1657644987974,MATH 193A,A03,083781,Rotar; Vladimir,5,0,34,29
1657644987974,MATH 193A,A04,083782,Rotar; Vladimir,10,0,34,24
1657644987974,MATH 193A,A05,093482,Rotar; Vladimir,10,0,34,24
1657644994001,MATH 197,001,091859,McAuley; Julian John,9999,0,9999,0
1657644994001,MATH 197,002,095566,Kedlaya; Kiran S.,9997,0,9999,2
1657644994001,MATH 197,003,095567,Xiao; Ming,9999,0,9999,0
1657644994001,MATH 197,004,095571,Perols; Johan Lars,9998,0,9999,1
1657645001063,COGS 9,A01,083615,Shannon; Kyle Michael,9,0,75,66
1657645007093,COGS 11,A01,083617,Boyle; Mary E. T.,23,0,48,25
1657645013117,COGS 13,A01,083071,Bastos; Amalia Pinkusfeld,11,0,71,60
1657645019141,COGS 14A,A01,092681,Semenuks; Arturs,5,1,100,95
1657645025167,COGS 14B,A01,083073,Cheng; Tzu-Han,6,0,63,57
1657645031191,COGS 17,A01,092677,Semenuks; Arturs,6,0,81,75
1657645037217,COGS 100,A01,083619,Allen; Michael Gordon,17,0,70,53
1657645043249,COGS 101A,A01,083621,Davis; Joshua Daniel,9,0,68,59
1657645049272,COGS 101B,A01,091572,Allen; Michael Gordon,12,0,65,53
1657645055298,COGS 101C,A01,083625,Delgado; Tania,17,0,35,18
1657645061324,COGS 107A,A01,083627,Boyle; Mary E. T.,13,0,60,47
1657645067347,COGS 118A,A01,083075,Gupta; Anjum,21,0,76,55
1657645073375,CSE 3,A50,083646,Miranda; Gregory Joseph,24,0,50,26
1657645079398,CSE 8A,A50,083650,Miranda; Gregory Joseph,17,1,56,39
1657645085425,CSE 11,A01,083080,Cao; Yingjun,6,15,40,34
1657645091450,CSE 12,A01,083652,Krause-Levy; Sophia Louisa,28,1,120,92
1657645097471,CSE 15L,A01,083654,Morris; Justin Loren,9,0,50,41
1657645097471,CSE 15L,A02,083655,Morris; Justin Loren,9,0,50,41
1657645103499,CSE 20,A01,083657,Tran; Khoa Dang,39,0,80,41
1657645109526,CSE 21,A01,095574,Bach; Quang Tran,22,0,48,26
1657645115549,CSE 30,A01,083084,Eldon; John,6,0,80,74
1657645115549,CSE 30,B01,095061,Bhaskar; Nishant,9,0,50,41
1657645121571,CSE 100,A01,083659,Cao; Yingjun,5,4,70,65
1657645127598,CSE 134B,A01,083661,Powell; Thomas Allan,22,0,100,78
1657645133622,CSE 140,A01,083663,Gungor; Onat,15,0,85,70
1657645139649,CSE 140L,A01,083088,Eldon; John,21,0,100,79
1657645145672,CSE 175,A01,083665,Kumar; Rakesh,3,0,25,22
1657645151694,CSE 190,A00,092507,Dubnov; Shlomo,8,0,20,12
1657645157717,ECE 45,A01,083139,Congero; Spencer William,6,0,75,69
1657645163744,ECE 65,A50,083695,Saad; Andrew S,12,0,30,18
1657645163744,ECE 65,A51,095125,Saad; Andrew S,24,0,26,2
1657645169775,ECE 109,A01,091882,Touri; Behrouz,19,0,70,51
1657645175807,ECE 180,A00,083140,Abi Samra; Nicholas Camill,1,0,30,29
1657645175807,ECE 180,B00,083141,Abi Samra; Nicholas Camill,0,0,30,30
1657645181839,MATH 10A,A01,083735,Patchell; Gregory David,2,0,30,28
1657645181839,MATH 10A,A02,083736,Patchell; Gregory David,20,0,30,10
1657645181839,MATH 10A,A03,083737,Patchell; Gregory David,16,0,30,14
1657645187867,MATH 10B,A01,083207,Lim; Seonhee,8,0,34,26
1657645187867,MATH 10B,A02,083208,Lim; Seonhee,9,0,35,26
1657645187867,MATH 10B,A03,093472,Lim; Seonhee,7,0,34,27
1657645187867,MATH 10B,B01,083739,Sinha; Shubham,12,0,30,18
1657645193892,MATH 18,A01,083743,Cinel; Cameron Alexander,7,0,30,23
1657645193892,MATH 18,A02,083744,Cinel; Cameron Alexander,17,0,30,13
1657645193892,MATH 18,A03,083745,Cinel; Cameron Alexander,9,0,30,21
1657645193892,MATH 18,B01,083748,Rideout; David Porter,5,0,37,32
1657645193892,MATH 18,B02,083749,Rideout; David Porter,5,0,36,31
1657645193892,MATH 18,B03,083750,Rideout; David Porter,3,0,37,34
1657645193892,MATH 18,B04,083751,Rideout; David Porter,6,0,36,30
1657645193892,MATH 18,B05,093473,Rideout; David Porter,6,0,36,30
1657645193892,MATH 18,B06,093474,Rideout; David Porter,6,0,36,30
1657645199918,MATH 20A,A01,083754,Zheng; Zequn,14,0,40,26
1657645205942,MATH 20B,A01,083756,Briones; Jor-el Thomas Caparas,4,0,36,32
1657645205942,MATH 20B,A02,083757,Briones; Jor-el Thomas Caparas,1,0,36,35
1657645205942,MATH 20B,A03,093475,Briones; Jor-el Thomas Caparas,2,0,36,34
1657645211973,MATH 20C,A01,083760,Briones; Jor-el Thomas Caparas,1,0,35,34
1657645211973,MATH 20C,A02,083761,Briones; Jor-el Thomas Caparas,8,0,35,27
1657645211973,MATH 20C,A03,093476,Briones; Jor-el Thomas Caparas,0,1,36,36
1657645211973,MATH 20C,B01,083762,Bach; Quang Tran,1,0,30,29
1657645217995,MATH 20D,A01,083765,Tran; Brian Kha,5,0,30,25
1657645217995,MATH 20D,A02,083766,Tran; Brian Kha,5,0,30,25
1657645217995,MATH 20D,A03,083767,Tran; Brian Kha,5,0,30,25
1657645224020,MATH 20E,A01,083771,Ganguly; Soumya,9,0,32,23
1657645224020,MATH 20E,A02,083772,Ganguly; Soumya,6,0,32,26
1657645224020,MATH 20E,B01,083773,Ciotti; Benjamin,20,0,35,15
1657645224020,MATH 20E,B02,083774,Ciotti; Benjamin,18,0,35,17
1657645230052,MATH 103A,A01,083777,Greenfeld; Be'Eri,3,0,36,33
1657645230052,MATH 103A,A02,083778,Greenfeld; Be'Eri,5,0,36,31
1657645230052,MATH 103A,A03,093561,Greenfeld; Be'Eri,6,0,36,30
1657645230052,MATH 103A,B01,083779,Greenfeld; Be'Eri,7,0,36,29
1657645230052,MATH 103A,B02,083780,Greenfeld; Be'Eri,4,0,36,32
1657645230052,MATH 103A,B03,093562,Greenfeld; Be'Eri,3,0,36,33
1657645236075,MATH 105,A01,085443,Carter; Anne Toulson,15,0,35,20
1657645236075,MATH 105,A02,093477,Carter; Anne Toulson,20,0,35,15
1657645242098,MATH 109,A01,083213,Ganzberger; Geoffrey Michael,2,0,34,32
1657645242098,MATH 109,A02,083214,Ganzberger; Geoffrey Michael,4,0,34,30
1657645242098,MATH 109,A03,093478,Ganzberger; Geoffrey Michael,2,0,34,32
1657645242098,MATH 109,B01,083215,Ganzberger; Geoffrey Michael,1,0,32,31
1657645242098,MATH 109,B02,083216,Ganzberger; Geoffrey Michael,2,0,32,30
1657645242098,MATH 109,B03,093479,Ganzberger; Geoffrey Michael,8,0,32,24
1657645248127,MATH 142A,A01,083219,Chow; Bennett,7,0,32,25
1657645248127,MATH 142A,A02,083220,Chow; Bennett,10,0,32,22
1657645248127,MATH 142A,A03,093480,Chow; Bennett,9,0,32,23
1657645248127,MATH 142A,B03,093481,Chow; Bennett,8,0,32,24
1657645248127,MATH 142A,B04,093558,Chow; Bennett,13,0,32,19
1657645248127,MATH 142A,B05,093559,Chow; Bennett,6,0,32,26
1657645254150,MATH 193A,A01,083224,Rotar; Vladimir,8,0,34,26
1657645254150,MATH 193A,A02,083225,Rotar; Vladimir,9,0,34,25
1657645254150,MATH 193A,A03,083781,Rotar; Vladimir,5,0,34,29
1657645254150,MATH 193A,A04,083782,Rotar; Vladimir,10,0,34,24
1657645254150,MATH 193A,A05,093482,Rotar; Vladimir,10,0,34,24
1657645260189,MATH 197,001,091859,McAuley; Julian John,9999,0,9999,0
1657645260189,MATH 197,002,095566,Kedlaya; Kiran S.,9997,0,9999,2
1657645260189,MATH 197,003,095567,Xiao; Ming,9999,0,9999,0
1657645260189,MATH 197,004,095571,Perols; Johan Lars,9998,0,9999,1
1657645267276,COGS 9,A01,083615,Shannon; Kyle Michael,9,0,75,66
1657645273297,COGS 11,A01,083617,Boyle; Mary E. T.,23,0,48,25
1657645279325,COGS 13,A01,083071,Bastos; Amalia Pinkusfeld,11,0,71,60
1657645285361,COGS 14A,A01,092681,Semenuks; Arturs,5,1,100,95
1657645291384,COGS 14B,A01,083073,Cheng; Tzu-Han,6,0,63,57
1657645297412,COGS 17,A01,092677,Semenuks; Arturs,6,0,81,75
1657645303438,COGS 100,A01,083619,Allen; Michael Gordon,17,0,70,53
1657645309465,COGS 101A,A01,083621,Davis; Joshua Daniel,9,0,68,59
1657645315488,COGS 101B,A01,091572,Allen; Michael Gordon,12,0,65,53
1657645321512,COGS 101C,A01,083625,Delgado; Tania,17,0,35,18
1657645327629,COGS 107A,A01,083627,Boyle; Mary E. T.,13,0,60,47
1657645333652,COGS 118A,A01,083075,Gupta; Anjum,21,0,76,55
1657645339678,CSE 3,A50,083646,Miranda; Gregory Joseph,24,0,50,26
1657645345704,CSE 8A,A50,083650,Miranda; Gregory Joseph,17,1,56,39
1657645351735,CSE 11,A01,083080,Cao; Yingjun,6,15,40,34
1657645357765,CSE 12,A01,083652,Krause-Levy; Sophia Louisa,28,1,120,92
1657645363787,CSE 15L,A01,083654,Morris; Justin Loren,9,0,50,41
1657645363787,CSE 15L,A02,083655,Morris; Justin Loren,9,0,50,41
1657645369811,CSE 20,A01,083657,Tran; Khoa Dang,39,0,80,41
1657645375838,CSE 21,A01,095574,Bach; Quang Tran,22,0,48,26
1657645381868,CSE 30,A01,083084,Eldon; John,6,0,80,74
1657645381868,CSE 30,B01,095061,Bhaskar; Nishant,9,0,50,41
1657645387892,CSE 100,A01,083659,Cao; Yingjun,5,4,70,65
1657645393915,CSE 134B,A01,083661,Powell; Thomas Allan,22,0,100,78
1657645399940,CSE 140,A01,083663,Gungor; Onat,15,0,85,70
1657645405963,CSE 140L,A01,083088,Eldon; John,21,0,100,79
1657645411988,CSE 175,A01,083665,Kumar; Rakesh,3,0,25,22
1657645418011,CSE 190,A00,092507,Dubnov; Shlomo,8,0,20,12
1657645424033,ECE 45,A01,083139,Congero; Spencer William,6,0,75,69
1657645430060,ECE 65,A50,083695,Saad; Andrew S,12,0,30,18
1657645430060,ECE 65,A51,095125,Saad; Andrew S,24,0,26,2
1657645436085,ECE 109,A01,091882,Touri; Behrouz,19,0,70,51
1657645442112,ECE 180,A00,083140,Abi Samra; Nicholas Camill,1,0,30,29
1657645442112,ECE 180,B00,083141,Abi Samra; Nicholas Camill,0,0,30,30
1657645448137,MATH 10A,A01,083735,Patchell; Gregory David,2,0,30,28
1657645448137,MATH 10A,A02,083736,Patchell; Gregory David,20,0,30,10
1657645448137,MATH 10A,A03,083737,Patchell; Gregory David,16,0,30,14
1657645454165,MATH 10B,A01,083207,Lim; Seonhee,8,0,34,26
1657645454165,MATH 10B,A02,083208,Lim; Seonhee,9,0,35,26
1657645454165,MATH 10B,A03,093472,Lim; Seonhee,7,0,34,27
1657645454165,MATH 10B,B01,083739,Sinha; Shubham,12,0,30,18
1657645460190,MATH 18,A01,083743,Cinel; Cameron Alexander,7,0,30,23
1657645460190,MATH 18,A02,083744,Cinel; Cameron Alexander,17,0,30,13
1657645460190,MATH 18,A03,083745,Cinel; Cameron Alexander,9,0,30,21
1657645460190,MATH 18,B01,083748,Rideout; David Porter,5,0,37,32
1657645460190,MATH 18,B02,083749,Rideout; David Porter,5,0,36,31
1657645460190,MATH 18,B03,083750,Rideout; David Porter,3,0,37,34
1657645460190,MATH 18,B04,083751,Rideout; David Porter,6,0,36,30
1657645460190,MATH 18,B05,093473,Rideout; David Porter,6,0,36,30
1657645460190,MATH 18,B06,093474,Rideout; David Porter,6,0,36,30
1657645466222,MATH 20A,A01,083754,Zheng; Zequn,14,0,40,26
1657645472251,MATH 20B,A01,083756,Briones; Jor-el Thomas Caparas,4,0,36,32
1657645472251,MATH 20B,A02,083757,Briones; Jor-el Thomas Caparas,1,0,36,35
1657645472251,MATH 20B,A03,093475,Briones; Jor-el Thomas Caparas,2,0,36,34
1657645478275,MATH 20C,A01,083760,Briones; Jor-el Thomas Caparas,1,0,35,34
1657645478275,MATH 20C,A02,083761,Briones; Jor-el Thomas Caparas,8,0,35,27
1657645478275,MATH 20C,A03,093476,Briones; Jor-el Thomas Caparas,0,1,36,36
1657645478275,MATH 20C,B01,083762,Bach; Quang Tran,1,0,30,29
1657645484311,MATH 20D,A01,083765,Tran; Brian Kha,5,0,30,25
1657645484311,MATH 20D,A02,083766,Tran; Brian Kha,5,0,30,25
1657645484311,MATH 20D,A03,083767,Tran; Brian Kha,5,0,30,25
1657645490340,MATH 20E,A01,083771,Ganguly; Soumya,9,0,32,23
1657645490340,MATH 20E,A02,083772,Ganguly; Soumya,6,0,32,26
1657645490340,MATH 20E,B01,083773,Ciotti; Benjamin,20,0,35,15
1657645490340,MATH 20E,B02,083774,Ciotti; Benjamin,18,0,35,17
1657645496365,MATH 103A,A01,083777,Greenfeld; Be'Eri,3,0,36,33
1657645496365,MATH 103A,A02,083778,Greenfeld; Be'Eri,5,0,36,31
1657645496365,MATH 103A,A03,093561,Greenfeld; Be'Eri,6,0,36,30
1657645496365,MATH 103A,B01,083779,Greenfeld; Be'Eri,7,0,36,29
1657645496365,MATH 103A,B02,083780,Greenfeld; Be'Eri,4,0,36,32
1657645496365,MATH 103A,B03,093562,Greenfeld; Be'Eri,3,0,36,33
1657645502387,MATH 105,A01,085443,Carter; Anne Toulson,15,0,35,20
1657645502387,MATH 105,A02,093477,Carter; Anne Toulson,20,0,35,15
1657645508424,MATH 109,A01,083213,Ganzberger; Geoffrey Michael,2,0,34,32
1657645508424,MATH 109,A02,083214,Ganzberger; Geoffrey Michael,4,0,34,30
1657645508424,MATH 109,A03,093478,Ganzberger; Geoffrey Michael,2,0,34,32
1657645508424,MATH 109,B01,083215,Ganzberger; Geoffrey Michael,1,0,32,31
1657645508424,MATH 109,B02,083216,Ganzberger; Geoffrey Michael,2,0,32,30
1657645508424,MATH 109,B03,093479,Ganzberger; Geoffrey Michael,8,0,32,24
1657645514454,MATH 142A,A01,083219,Chow; Bennett,7,0,32,25
1657645514454,MATH 142A,A02,083220,Chow; Bennett,10,0,32,22
1657645514454,MATH 142A,A03,093480,Chow; Bennett,9,0,32,23
1657645514454,MATH 142A,B03,093481,Chow; Bennett,8,0,32,24
1657645514454,MATH 142A,B04,093558,Chow; Bennett,13,0,32,19
1657645514454,MATH 142A,B05,093559,Chow; Bennett,6,0,32,26
1657645520478,MATH 193A,A01,083224,Rotar; Vladimir,8,0,34,26
1657645520478,MATH 193A,A02,083225,Rotar; Vladimir,9,0,34,25
1657645520478,MATH 193A,A03,083781,Rotar; Vladimir,5,0,34,29
1657645520478,MATH 193A,A04,083782,Rotar; Vladimir,10,0,34,24
1657645520478,MATH 193A,A05,093482,Rotar; Vladimir,10,0,34,24
1657645526518,MATH 197,001,091859,McAuley; Julian John,9999,0,9999,0
1657645526518,MATH 197,002,095566,Kedlaya; Kiran S.,9997,0,9999,2
1657645526518,MATH 197,003,095567,Xiao; Ming,9999,0,9999,0
1657645526518,MATH 197,004,095571,Perols; Johan Lars,9998,0,9999,1
1657645533595,COGS 9,A01,083615,Shannon; Kyle Michael,9,0,75,66
1657645539620,COGS 11,A01,083617,Boyle; Mary E. T.,23,0,48,25
1657645545644,COGS 13,A01,083071,Bastos; Amalia Pinkusfeld,11,0,71,60
1657645551669,COGS 14A,A01,092681,Semenuks; Arturs,5,1,100,95
1657645557709,COGS 14B,A01,083073,Cheng; Tzu-Han,6,0,63,57
1657645563731,COGS 17,A01,092677,Semenuks; Arturs,6,0,81,75
1657645569756,COGS 100,A01,083619,Allen; Michael Gordon,17,0,70,53
1657645575779,COGS 101A,A01,083621,Davis; Joshua Daniel,9,0,68,59
1657645581802,COGS 101B,A01,091572,Allen; Michael Gordon,12,0,65,53
1657645587828,COGS 101C,A01,083625,Delgado; Tania,17,0,35,18
1657645593855,COGS 107A,A01,083627,Boyle; Mary E. T.,13,0,60,47
1657645599878,COGS 118A,A01,083075,Gupta; Anjum,21,0,76,55
1657645605900,CSE 3,A50,083646,Miranda; Gregory Joseph,24,0,50,26
1657645611929,CSE 8A,A50,083650,Miranda; Gregory Joseph,17,1,56,39
1657645617952,CSE 11,A01,083080,Cao; Yingjun,6,15,40,34
1657645623975,CSE 12,A01,083652,Krause-Levy; Sophia Louisa,28,1,120,92
1657645629999,CSE 15L,A01,083654,Morris; Justin Loren,9,0,50,41
1657645629999,CSE 15L,A02,083655,Morris; Justin Loren,9,0,50,41
1657645636022,CSE 20,A01,083657,Tran; Khoa Dang,39,0,80,41
1657645642045,CSE 21,A01,095574,Bach; Quang Tran,22,0,48,26
1657645648072,CSE 30,A01,083084,Eldon; John,6,0,80,74
1657645648072,CSE 30,B01,095061,Bhaskar; Nishant,9,0,50,41
1657645654094,CSE 100,A01,083659,Cao; Yingjun,5,4,70,65
1657645660128,CSE 134B,A01,083661,Powell; Thomas Allan,22,0,100,78
1657645666156,CSE 140,A01,083663,Gungor; Onat,15,0,85,70
1657645672191,CSE 140L,A01,083088,Eldon; John,21,0,100,79
1657645678213,CSE 175,A01,083665,Kumar; Rakesh,3,0,25,22
1657645684240,CSE 190,A00,092507,Dubnov; Shlomo,8,0,20,12
1657645690275,ECE 45,A01,083139,Congero; Spencer William,6,0,75,69
1657645696312,ECE 65,A50,083695,Saad; Andrew S,12,0,30,18
1657645696312,ECE 65,A51,095125,Saad; Andrew S,24,0,26,2
1657645702342,ECE 109,A01,091882,Touri; Behrouz,19,0,70,51
1657645708368,ECE 180,A00,083140,Abi Samra; Nicholas Camill,1,0,30,29
1657645708368,ECE 180,B00,083141,Abi Samra; Nicholas Camill,0,0,30,30
1657645714401,MATH 10A,A01,083735,Patchell; Gregory David,2,0,30,28
1657645714401,MATH 10A,A02,083736,Patchell; Gregory David,20,0,30,10
1657645714401,MATH 10A,A03,083737,Patchell; Gregory David,16,0,30,14
1657645720425,MATH 10B,A01,083207,Lim; Seonhee,8,0,34,26
1657645720425,MATH 10B,A02,083208,Lim; Seonhee,9,0,35,26
1657645720425,MATH 10B,A03,093472,Lim; Seonhee,7,0,34,27
1657645720425,MATH 10B,B01,083739,Sinha; Shubham,12,0,30,18
1657645726452,MATH 18,A01,083743,Cinel; Cameron Alexander,7,0,30,23
1657645726452,MATH 18,A02,083744,Cinel; Cameron Alexander,17,0,30,13
1657645726452,MATH 18,A03,083745,Cinel; Cameron Alexander,9,0,30,21
1657645726452,MATH 18,B01,083748,Rideout; David Porter,5,0,37,32
1657645726452,MATH 18,B02,083749,Rideout; David Porter,5,0,36,31
1657645726452,MATH 18,B03,083750,Rideout; David Porter,3,0,37,34
1657645726452,MATH 18,B04,083751,Rideout; David Porter,6,0,36,30
1657645726452,MATH 18,B05,093473,Rideout; David Porter,6,0,36,30
1657645726452,MATH 18,B06,093474,Rideout; David Porter,6,0,36,30
1657645732479,MATH 20A,A01,083754,Zheng; Zequn,14,0,40,26
1657645738502,MATH 20B,A01,083756,Briones; Jor-el Thomas Caparas,4,0,36,32
1657645738502,MATH 20B,A02,083757,Briones; Jor-el Thomas Caparas,1,0,36,35
1657645738502,MATH 20B,A03,093475,Briones; Jor-el Thomas Caparas,2,0,36,34
1657645744531,MATH 20C,A01,083760,Briones; Jor-el Thomas Caparas,1,0,35,34
1657645744531,MATH 20C,A02,083761,Briones; Jor-el Thomas Caparas,8,0,35,27
1657645744531,MATH 20C,A03,093476,Briones; Jor-el Thomas Caparas,0,1,36,36
1657645744531,MATH 20C,B01,083762,Bach; Quang Tran,1,0,30,29
1657645750570,MATH 20D,A01,083765,Tran; Brian Kha,5,0,30,25
1657645750570,MATH 20D,A02,083766,Tran; Brian Kha,5,0,30,25
1657645750570,MATH 20D,A03,083767,Tran; Brian Kha,5,0,30,25
1657645756594,MATH 20E,A01,083771,Ganguly; Soumya,9,0,32,23
1657645756594,MATH 20E,A02,083772,Ganguly; Soumya,6,0,32,26
1657645756594,MATH 20E,B01,083773,Ciotti; Benjamin,20,0,35,15
1657645756594,MATH 20E,B02,083774,Ciotti; Benjamin,18,0,35,17
1657645762618,MATH 103A,A01,083777,Greenfeld; Be'Eri,3,0,36,33
1657645762618,MATH 103A,A02,083778,Greenfeld; Be'Eri,5,0,36,31
1657645762618,MATH 103A,A03,093561,Greenfeld; Be'Eri,6,0,36,30
1657645762618,MATH 103A,B01,083779,Greenfeld; Be'Eri,7,0,36,29
1657645762618,MATH 103A,B02,083780,Greenfeld; Be'Eri,4,0,36,32
1657645762618,MATH 103A,B03,093562,Greenfeld; Be'Eri,3,0,36,33
1657645768644,MATH 105,A01,085443,Carter; Anne Toulson,15,0,35,20
1657645768644,MATH 105,A02,093477,Carter; Anne Toulson,20,0,35,15
1657645774681,MATH 109,A01,083213,Ganzberger; Geoffrey Michael,2,0,34,32
1657645774681,MATH 109,A02,083214,Ganzberger; Geoffrey Michael,4,0,34,30
1657645774681,MATH 109,A03,093478,Ganzberger; Geoffrey Michael,2,0,34,32
1657645774681,MATH 109,B01,083215,Ganzberger; Geoffrey Michael,1,0,32,31
1657645774681,MATH 109,B02,083216,Ganzberger; Geoffrey Michael,2,0,32,30
1657645774681,MATH 109,B03,093479,Ganzberger; Geoffrey Michael,8,0,32,24
1657645780717,MATH 142A,A01,083219,Chow; Bennett,7,0,32,25
1657645780717,MATH 142A,A02,083220,Chow; Bennett,10,0,32,22
1657645780717,MATH 142A,A03,093480,Chow; Bennett,9,0,32,23
1657645780717,MATH 142A,B03,093481,Chow; Bennett,8,0,32,24
1657645780717,MATH 142A,B04,093558,Chow; Bennett,13,0,32,19
1657645780717,MATH 142A,B05,093559,Chow; Bennett,6,0,32,26
1657645786739,MATH 193A,A01,083224,Rotar; Vladimir,8,0,34,26
1657645786739,MATH 193A,A02,083225,Rotar; Vladimir,9,0,34,25
1657645786739,MATH 193A,A03,083781,Rotar; Vladimir,5,0,34,29
1657645786739,MATH 193A,A04,083782,Rotar; Vladimir,10,0,34,24
1657645786739,MATH 193A,A05,093482,Rotar; Vladimir,10,0,34,24
1657645792770,MATH 197,001,091859,McAuley; Julian John,9999,0,9999,0
1657645792770,MATH 197,002,095566,Kedlaya; Kiran S.,9997,0,9999,2
1657645792770,MATH 197,003,095567,Xiao; Ming,9999,0,9999,0
1657645792770,MATH 197,004,095571,Perols; Johan Lars,9998,0,9999,1
1657645799827,COGS 9,A01,083615,Shannon; Kyle Michael,9,0,75,66
1657645805851,COGS 11,A01,083617,Boyle; Mary E. T.,23,0,48,25
1657645811875,COGS 13,A01,083071,Bastos; Amalia Pinkusfeld,11,0,71,60
1657645817904,COGS 14A,A01,092681,Semenuks; Arturs,5,1,100,95
1657645823927,COGS 14B,A01,083073,Cheng; Tzu-Han,6,0,63,57
1657645829953,COGS 17,A01,092677,Semenuks; Arturs,6,0,81,75
1657645835980,COGS 100,A01,083619,Allen; Michael Gordon,17,0,70,53
1657645842002,COGS 101A,A01,083621,Davis; Joshua Daniel,9,0,68,59
1657645848029,COGS 101B,A01,091572,Allen; Michael Gordon,12,0,65,53
1657645854053,COGS 101C,A01,083625,Delgado; Tania,17,0,35,18
1657645860079,COGS 107A,A01,083627,Boyle; Mary E. T.,13,0,60,47
1657645866107,COGS 118A,A01,083075,Gupta; Anjum,21,0,76,55
1657645872133,CSE 3,A50,083646,Miranda; Gregory Joseph,24,0,50,26
1657645878166,CSE 8A,A50,083650,Miranda; Gregory Joseph,17,1,56,39
1657645884189,CSE 11,A01,083080,Cao; Yingjun,6,15,40,34
1657645890217,CSE 12,A01,083652,Krause-Levy; Sophia Louisa,28,1,120,92
1657645896259,CSE 15L,A01,083654,Morris; Justin Loren,9,0,50,41
1657645896259,CSE 15L,A02,083655,Morris; Justin Loren,9,0,50,41
1657645902285,CSE 20,A01,083657,Tran; Khoa Dang,39,0,80,41
1657645908309,CSE 21,A01,095574,Bach; Quang Tran,22,0,48,26
1657645914333,CSE 30,A01,083084,Eldon; John,6,0,80,74
1657645914333,CSE 30,B01,095061,Bhaskar; Nishant,9,0,50,41
1657645920366,CSE 100,A01,083659,Cao; Yingjun,5,4,70,65
1657645926483,CSE 134B,A01,083661,Powell; Thomas Allan,22,0,100,78
1657645932510,CSE 140,A01,083663,Gungor; Onat,15,0,85,70
1657645938533,CSE 140L,A01,083088,Eldon; John,21,0,100,79
1657645944562,CSE 175,A01,083665,Kumar; Rakesh,3,0,25,22
1657645950596,CSE 190,A00,092507,Dubnov; Shlomo,8,0,20,12
1657645956623,ECE 45,A01,083139,Congero; Spencer William,6,0,75,69
1657645962645,ECE 65,A50,083695,Saad; Andrew S,12,0,30,18
1657645962645,ECE 65,A51,095125,Saad; Andrew S,24,0,26,2
1657645968673,ECE 109,A01,091882,Touri; Behrouz,19,0,70,51
1657645974705,ECE 180,A00,083140,Abi Samra; Nicholas Camill,1,0,30,29
1657645974705,ECE 180,B00,083141,Abi Samra; Nicholas Camill,0,0,30,30
1657645980729,MATH 10A,A01,083735,Patchell; Gregory David,2,0,30,28
1657645980729,MATH 10A,A02,083736,Patchell; Gregory David,20,0,30,10
1657645980729,MATH 10A,A03,083737,Patchell; Gregory David,16,0,30,14
1657645986753,MATH 10B,A01,083207,Lim; Seonhee,8,0,34,26
1657645986753,MATH 10B,A02,083208,Lim; Seonhee,9,0,35,26
1657645986753,MATH 10B,A03,093472,Lim; Seonhee,7,0,34,27
1657645986753,MATH 10B,B01,083739,Sinha; Shubham,12,0,30,18
1657645992778,MATH 18,A01,083743,Cinel; Cameron Alexander,7,0,30,23
1657645992778,MATH 18,A02,083744,Cinel; Cameron Alexander,17,0,30,13
1657645992778,MATH 18,A03,083745,Cinel; Cameron Alexander,9,0,30,21
1657645992778,MATH 18,B01,083748,Rideout; David Porter,5,0,37,32
1657645992778,MATH 18,B02,083749,Rideout; David Porter,5,0,36,31
1657645992778,MATH 18,B03,083750,Rideout; David Porter,3,0,37,34
1657645992778,MATH 18,B04,083751,Rideout; David Porter,6,0,36,30
1657645992778,MATH 18,B05,093473,Rideout; David Porter,6,0,36,30
1657645992778,MATH 18,B06,093474,Rideout; David Porter,6,0,36,30
1657645998804,MATH 20A,A01,083754,Zheng; Zequn,14,0,40,26
1657646004831,MATH 20B,A01,083756,Briones; Jor-el Thomas Caparas,4,0,36,32
1657646004831,MATH 20B,A02,083757,Briones; Jor-el Thomas Caparas,1,0,36,35
1657646004831,MATH 20B,A03,093475,Briones; Jor-el Thomas Caparas,2,0,36,34
1657646010855,MATH 20C,A01,083760,Briones; Jor-el Thomas Caparas,1,0,35,34
1657646010855,MATH 20C,A02,083761,Briones; Jor-el Thomas Caparas,8,0,35,27
1657646010855,MATH 20C,A03,093476,Briones; Jor-el Thomas Caparas,0,1,36,36
1657646010855,MATH 20C,B01,083762,Bach; Quang Tran,1,0,30,29
1657646016879,MATH 20D,A01,083765,Tran; Brian Kha,5,0,30,25
1657646016879,MATH 20D,A02,083766,Tran; Brian Kha,5,0,30,25
1657646016879,MATH 20D,A03,083767,Tran; Brian Kha,5,0,30,25
1657646022905,MATH 20E,A01,083771,Ganguly; Soumya,9,0,32,23
1657646022905,MATH 20E,A02,083772,Ganguly; Soumya,6,0,32,26
1657646022905,MATH 20E,B01,083773,Ciotti; Benjamin,20,0,35,15
1657646022905,MATH 20E,B02,083774,Ciotti; Benjamin,18,0,35,17
1657646028940,MATH 103A,A01,083777,Greenfeld; Be'Eri,3,0,36,33
1657646028940,MATH 103A,A02,083778,Greenfeld; Be'Eri,5,0,36,31
1657646028940,MATH 103A,A03,093561,Greenfeld; Be'Eri,6,0,36,30
1657646028940,MATH 103A,B01,083779,Greenfeld; Be'Eri,7,0,36,29
1657646028940,MATH 103A,B02,083780,Greenfeld; Be'Eri,4,0,36,32
1657646028940,MATH 103A,B03,093562,Greenfeld; Be'Eri,3,0,36,33
1657646034978,MATH 105,A01,085443,Carter; Anne Toulson,15,0,35,20
1657646034978,MATH 105,A02,093477,Carter; Anne Toulson,20,0,35,15
1657646041008,MATH 109,A01,083213,Ganzberger; Geoffrey Michael,2,0,34,32
1657646041008,MATH 109,A02,083214,Ganzberger; Geoffrey Michael,4,0,34,30
1657646041008,MATH 109,A03,093478,Ganzberger; Geoffrey Michael,2,0,34,32
1657646041008,MATH 109,B01,083215,Ganzberger; Geoffrey Michael,1,0,32,31
1657646041008,MATH 109,B02,083216,Ganzberger; Geoffrey Michael,2,0,32,30
1657646041008,MATH 109,B03,093479,Ganzberger; Geoffrey Michael,8,0,32,24
1657646047037,MATH 142A,A01,083219,Chow; Bennett,7,0,32,25
1657646047037,MATH 142A,A02,083220,Chow; Bennett,10,0,32,22
1657646047037,MATH 142A,A03,093480,Chow; Bennett,9,0,32,23
1657646047037,MATH 142A,B03,093481,Chow; Bennett,8,0,32,24
1657646047037,MATH 142A,B04,093558,Chow; Bennett,13,0,32,19
1657646047037,MATH 142A,B05,093559,Chow; Bennett,6,0,32,26
1657646053068,MATH 193A,A01,083224,Rotar; Vladimir,8,0,34,26
1657646053068,MATH 193A,A02,083225,Rotar; Vladimir,9,0,34,25
1657646053068,MATH 193A,A03,083781,Rotar; Vladimir,5,0,34,29
1657646053068,MATH 193A,A04,083782,Rotar; Vladimir,10,0,34,24
1657646053068,MATH 193A,A05,093482,Rotar; Vladimir,10,0,34,24
1657646059099,MATH 197,001,091859,McAuley; Julian John,9999,0,9999,0
1657646059099,MATH 197,002,095566,Kedlaya; Kiran S.,9997,0,9999,2
1657646059099,MATH 197,003,095567,Xiao; Ming,9999,0,9999,0
1657646059099,MATH 197,004,095571,Perols; Johan Lars,9998,0,9999,1
1657646066150,COGS 9,A01,083615,Shannon; Kyle Michael,9,0,75,66
1657646072173,COGS 11,A01,083617,Boyle; Mary E. T.,23,0,48,25
1657646078197,COGS 13,A01,083071,Bastos; Amalia Pinkusfeld,11,0,71,60
1657646084220,COGS 14A,A01,092681,Semenuks; Arturs,5,1,100,95
1657646090242,COGS 14B,A01,083073,Cheng; Tzu-Han,6,0,63,57
1657646096281,COGS 17,A01,092677,Semenuks; Arturs,6,0,81,75
1657646102308,COGS 100,A01,083619,Allen; Michael Gordon,17,0,70,53
1657646108330,COGS 101A,A01,083621,Davis; Joshua Daniel,9,0,68,59
1657646114353,COGS 101B,A01,091572,Allen; Michael Gordon,12,0,65,53
1657646120375,COGS 101C,A01,083625,Delgado; Tania,17,0,35,18
1657646126419,COGS 107A,A01,083627,Boyle; Mary E. T.,13,0,60,47
1657646132472,COGS 118A,A01,083075,Gupta; Anjum,21,0,76,55
1657646138508,CSE 3,A50,083646,Miranda; Gregory Joseph,24,0,50,26
1657646144535,CSE 8A,A50,083650,Miranda; Gregory Joseph,17,1,56,39
1657646150563,CSE 11,A01,083080,Cao; Yingjun,6,15,40,34
1657646156587,CSE 12,A01,083652,Krause-Levy; Sophia Louisa,28,1,120,92
1657646162645,CSE 15L,A01,083654,Morris; Justin Loren,9,0,50,41
1657646162645,CSE 15L,A02,083655,Morris; Justin Loren,9,0,50,41
1657646168672,CSE 20,A01,083657,Tran; Khoa Dang,39,0,80,41
1657646174701,CSE 21,A01,095574,Bach; Quang Tran,22,0,48,26
1657646180723,CSE 30,A01,083084,Eldon; John,6,0,80,74
1657646180723,CSE 30,B01,095061,Bhaskar; Nishant,9,0,50,41
1657646186756,CSE 100,A01,083659,Cao; Yingjun,5,4,70,65
1657646192793,CSE 134B,A01,083661,Powell; Thomas Allan,22,0,100,78
1657646198816,CSE 140,A01,083663,Gungor; Onat,15,0,85,70
1657646204845,CSE 140L,A01,083088,Eldon; John,21,0,100,79
1657646210872,CSE 175,A01,083665,Kumar; Rakesh,3,0,25,22
1657646216894,CSE 190,A00,092507,Dubnov; Shlomo,8,0,20,12
1657646222920,ECE 45,A01,083139,Congero; Spencer William,6,0,75,69
1657646228950,ECE 65,A50,083695,Saad; Andrew S,12,0,30,18
1657646228950,ECE 65,A51,095125,Saad; Andrew S,24,0,26,2
1657646234977,ECE 109,A01,091882,Touri; Behrouz,19,0,70,51
1657646241000,ECE 180,A00,083140,Abi Samra; Nicholas Camill,1,0,30,29
1657646241000,ECE 180,B00,083141,Abi Samra; Nicholas Camill,0,0,30,30
1657646247025,MATH 10A,A01,083735,Patchell; Gregory David,2,0,30,28
1657646247025,MATH 10A,A02,083736,Patchell; Gregory David,20,0,30,10
1657646247025,MATH 10A,A03,083737,Patchell; Gregory David,16,0,30,14
1657646253054,MATH 10B,A01,083207,Lim; Seonhee,8,0,34,26
1657646253054,MATH 10B,A02,083208,Lim; Seonhee,9,0,35,26
1657646253054,MATH 10B,A03,093472,Lim; Seonhee,7,0,34,27
1657646253054,MATH 10B,B01,083739,Sinha; Shubham,12,0,30,18
1657646259088,MATH 18,A01,083743,Cinel; Cameron Alexander,7,0,30,23
1657646259088,MATH 18,A02,083744,Cinel; Cameron Alexander,17,0,30,13
1657646259088,MATH 18,A03,083745,Cinel; Cameron Alexander,9,0,30,21
1657646259088,MATH 18,B01,083748,Rideout; David Porter,5,0,37,32
1657646259088,MATH 18,B02,083749,Rideout; David Porter,5,0,36,31
1657646259088,MATH 18,B03,083750,Rideout; David Porter,3,0,37,34
1657646259088,MATH 18,B04,083751,Rideout; David Porter,6,0,36,30
1657646259088,MATH 18,B05,093473,Rideout; David Porter,6,0,36,30
1657646259088,MATH 18,B06,093474,Rideout; David Porter,6,0,36,30
1657646265112,MATH 20A,A01,083754,Zheng; Zequn,14,0,40,26
1657646271158,MATH 20B,A01,083756,Briones; Jor-el Thomas Caparas,4,0,36,32
1657646271158,MATH 20B,A02,083757,Briones; Jor-el Thomas Caparas,1,0,36,35
1657646271158,MATH 20B,A03,093475,Briones; Jor-el Thomas Caparas,2,0,36,34
1657646277187,MATH 20C,A01,083760,Briones; Jor-el Thomas Caparas,1,0,35,34
1657646277187,MATH 20C,A02,083761,Briones; Jor-el Thomas Caparas,8,0,35,27
1657646277187,MATH 20C,A03,093476,Briones; Jor-el Thomas Caparas,0,1,36,36
1657646277187,MATH 20C,B01,083762,Bach; Quang Tran,1,0,30,29
1657646283216,MATH 20D,A01,083765,Tran; Brian Kha,5,0,30,25
1657646283216,MATH 20D,A02,083766,Tran; Brian Kha,5,0,30,25
1657646283216,MATH 20D,A03,083767,Tran; Brian Kha,5,0,30,25
1657646289254,MATH 20E,A01,083771,Ganguly; Soumya,9,0,32,23
1657646289254,MATH 20E,A02,083772,Ganguly; Soumya,6,0,32,26
1657646289254,MATH 20E,B01,083773,Ciotti; Benjamin,20,0,35,15
1657646289254,MATH 20E,B02,083774,Ciotti; Benjamin,18,0,35,17
1657646295282,MATH 103A,A01,083777,Greenfeld; Be'Eri,3,0,36,33
1657646295282,MATH 103A,A02,083778,Greenfeld; Be'Eri,5,0,36,31
1657646295282,MATH 103A,A03,093561,Greenfeld; Be'Eri,6,0,36,30
1657646295282,MATH 103A,B01,083779,Greenfeld; Be'Eri,7,0,36,29
1657646295282,MATH 103A,B02,083780,Greenfeld; Be'Eri,4,0,36,32
1657646295282,MATH 103A,B03,093562,Greenfeld; Be'Eri,3,0,36,33
1657646301315,MATH 105,A01,085443,Carter; Anne Toulson,15,0,35,20
1657646301315,MATH 105,A02,093477,Carter; Anne Toulson,20,0,35,15
1657646307339,MATH 109,A01,083213,Ganzberger; Geoffrey Michael,2,0,34,32
1657646307339,MATH 109,A02,083214,Ganzberger; Geoffrey Michael,4,0,34,30
1657646307339,MATH 109,A03,093478,Ganzberger; Geoffrey Michael,2,0,34,32
1657646307339,MATH 109,B01,083215,Ganzberger; Geoffrey Michael,1,0,32,31
1657646307339,MATH 109,B02,083216,Ganzberger; Geoffrey Michael,2,0,32,30
1657646307339,MATH 109,B03,093479,Ganzberger; Geoffrey Michael,8,0,32,24
1657646313366,MATH 142A,A01,083219,Chow; Bennett,7,0,32,25
1657646313366,MATH 142A,A02,083220,Chow; Bennett,10,0,32,22
1657646313366,MATH 142A,A03,093480,Chow; Bennett,9,0,32,23
1657646313366,MATH 142A,B03,093481,Chow; Bennett,8,0,32,24
1657646313366,MATH 142A,B04,093558,Chow; Bennett,13,0,32,19
1657646313366,MATH 142A,B05,093559,Chow; Bennett,6,0,32,26
1657646319391,MATH 193A,A01,083224,Rotar; Vladimir,8,0,34,26
1657646319391,MATH 193A,A02,083225,Rotar; Vladimir,9,0,34,25
1657646319391,MATH 193A,A03,083781,Rotar; Vladimir,5,0,34,29
1657646319391,MATH 193A,A04,083782,Rotar; Vladimir,10,0,34,24
1657646319391,MATH 193A,A05,093482,Rotar; Vladimir,10,0,34,24
1657646325413,MATH 197,001,091859,McAuley; Julian John,9999,0,9999,0
1657646325413,MATH 197,002,095566,Kedlaya; Kiran S.,9997,0,9999,2
1657646325413,MATH 197,003,095567,Xiao; Ming,9999,0,9999,0
1657646325413,MATH 197,004,095571,Perols; Johan Lars,9998,0,9999,1
1657646332468,COGS 9,A01,083615,Shannon; Kyle Michael,9,0,75,66
1657646338491,COGS 11,A01,083617,Boyle; Mary E. T.,23,0,48,25
1657646344519,COGS 13,A01,083071,Bastos; Amalia Pinkusfeld,11,0,71,60
1657646350542,COGS 14A,A01,092681,Semenuks; Arturs,5,1,100,95
1657646356565,COGS 14B,A01,083073,Cheng; Tzu-Han,6,0,63,57
1657646362592,COGS 17,A01,092677,Semenuks; Arturs,6,0,81,75
1657646368623,COGS 100,A01,083619,Allen; Michael Gordon,17,0,70,53
1657646374655,COGS 101A,A01,083621,Davis; Joshua Daniel,9,0,68,59
1657646380679,COGS 101B,A01,091572,Allen; Michael Gordon,12,0,65,53
1657646386702,COGS 101C,A01,083625,Delgado; Tania,17,0,35,18
1657646392729,COGS 107A,A01,083627,Boyle; Mary E. T.,13,0,60,47
1657646398751,COGS 118A,A01,083075,Gupta; Anjum,21,0,76,55
1657646404773,CSE 3,A50,083646,Miranda; Gregory Joseph,24,0,50,26
1657646410795,CSE 8A,A50,083650,Miranda; Gregory Joseph,17,1,56,39
1657646416819,CSE 11,A01,083080,Cao; Yingjun,6,15,40,34
1657646422856,CSE 12,A01,083652,Krause-Levy; Sophia Louisa,28,1,120,92
1657646428881,CSE 15L,A01,083654,Morris; Justin Loren,9,0,50,41
1657646428881,CSE 15L,A02,083655,Morris; Justin Loren,9,0,50,41
1657646434907,CSE 20,A01,083657,Tran; Khoa Dang,39,0,80,41
1657646440930,CSE 21,A01,095574,Bach; Quang Tran,22,0,48,26
1657646446957,CSE 30,A01,083084,Eldon; John,6,0,80,74
1657646446957,CSE 30,B01,095061,Bhaskar; Nishant,9,0,50,41
1657646452982,CSE 100,A01,083659,Cao; Yingjun,5,4,70,65
1657646459009,CSE 134B,A01,083661,Powell; Thomas Allan,22,0,100,78
1657646465036,CSE 140,A01,083663,Gungor; Onat,15,0,85,70
1657646471068,CSE 140L,A01,083088,Eldon; John,21,0,100,79
1657646477100,CSE 175,A01,083665,Kumar; Rakesh,3,0,25,22
1657646483137,CSE 190,A00,092507,Dubnov; Shlomo,8,0,20,12
1657646489164,ECE 45,A01,083139,Congero; Spencer William,6,0,75,69
1657646495193,ECE 65,A50,083695,Saad; Andrew S,12,0,30,18
1657646495193,ECE 65,A51,095125,Saad; Andrew S,24,0,26,2
1657646501231,ECE 109,A01,091882,Touri; Behrouz,19,0,70,51
1657646507253,ECE 180,A00,083140,Abi Samra; Nicholas Camill,1,0,30,29
1657646507253,ECE 180,B00,083141,Abi Samra; Nicholas Camill,0,0,30,30
1657646513285,MATH 10A,A01,083735,Patchell; Gregory David,2,0,30,28
1657646513285,MATH 10A,A02,083736,Patchell; Gregory David,20,0,30,10
1657646513285,MATH 10A,A03,083737,Patchell; Gregory David,16,0,30,14
1657646519314,MATH 10B,A01,083207,Lim; Seonhee,8,0,34,26
1657646519314,MATH 10B,A02,083208,Lim; Seonhee,9,0,35,26
1657646519314,MATH 10B,A03,093472,Lim; Seonhee,7,0,34,27
1657646519314,MATH 10B,B01,083739,Sinha; Shubham,12,0,30,18
1657646525410,MATH 18,A01,083743,Cinel; Cameron Alexander,7,0,30,23
1657646525410,MATH 18,A02,083744,Cinel; Cameron Alexander,17,0,30,13
1657646525410,MATH 18,A03,083745,Cinel; Cameron Alexander,9,0,30,21
1657646525410,MATH 18,B01,083748,Rideout; David Porter,5,0,37,32
1657646525410,MATH 18,B02,083749,Rideout; David Porter,5,0,36,31
1657646525410,MATH 18,B03,083750,Rideout; David Porter,3,0,37,34
1657646525410,MATH 18,B04,083751,Rideout; David Porter,6,0,36,30
1657646525410,MATH 18,B05,093473,Rideout; David Porter,6,0,36,30
1657646525410,MATH 18,B06,093474,Rideout; David Porter,6,0,36,30
1657646531444,MATH 20A,A01,083754,Zheng; Zequn,14,0,40,26
1657646537472,MATH 20B,A01,083756,Briones; Jor-el Thomas Caparas,4,0,36,32
1657646537472,MATH 20B,A02,083757,Briones; Jor-el Thomas Caparas,1,0,36,35
1657646537472,MATH 20B,A03,093475,Briones; Jor-el Thomas Caparas,2,0,36,34
1657646543499,MATH 20C,A01,083760,Briones; Jor-el Thomas Caparas,1,0,35,34
1657646543499,MATH 20C,A02,083761,Briones; Jor-el Thomas Caparas,8,0,35,27
1657646543499,MATH 20C,A03,093476,Briones; Jor-el Thomas Caparas,0,1,36,36
1657646543499,MATH 20C,B01,083762,Bach; Quang Tran,1,0,30,29
1657646549524,MATH 20D,A01,083765,Tran; Brian Kha,5,0,30,25
1657646549524,MATH 20D,A02,083766,Tran; Brian Kha,5,0,30,25
1657646549524,MATH 20D,A03,083767,Tran; Brian Kha,5,0,30,25
1657646555546,MATH 20E,A01,083771,Ganguly; Soumya,9,0,32,23
1657646555546,MATH 20E,A02,083772,Ganguly; Soumya,6,0,32,26
1657646555546,MATH 20E,B01,083773,Ciotti; Benjamin,20,0,35,15
1657646555546,MATH 20E,B02,083774,Ciotti; Benjamin,18,0,35,17
1657646561567,MATH 103A,A01,083777,Greenfeld; Be'Eri,3,0,36,33
1657646561567,MATH 103A,A02,083778,Greenfeld; Be'Eri,5,0,36,31
1657646561567,MATH 103A,A03,093561,Greenfeld; Be'Eri,6,0,36,30
1657646561567,MATH 103A,B01,083779,Greenfeld; Be'Eri,7,0,36,29
1657646561567,MATH 103A,B02,083780,Greenfeld; Be'Eri,4,0,36,32
1657646561567,MATH 103A,B03,093562,Greenfeld; Be'Eri,3,0,36,33
1657646567597,MATH 105,A01,085443,Carter; Anne Toulson,15,0,35,20
1657646567597,MATH 105,A02,093477,Carter; Anne Toulson,20,0,35,15
1657646573622,MATH 109,A01,083213,Ganzberger; Geoffrey Michael,2,0,34,32
1657646573622,MATH 109,A02,083214,Ganzberger; Geoffrey Michael,4,0,34,30
1657646573622,MATH 109,A03,093478,Ganzberger; Geoffrey Michael,2,0,34,32
1657646573622,MATH 109,B01,083215,Ganzberger; Geoffrey Michael,1,0,32,31
1657646573622,MATH 109,B02,083216,Ganzberger; Geoffrey Michael,2,0,32,30
1657646573622,MATH 109,B03,093479,Ganzberger; Geoffrey Michael,8,0,32,24
1657646579652,MATH 142A,A01,083219,Chow; Bennett,7,0,32,25
1657646579652,MATH 142A,A02,083220,Chow; Bennett,10,0,32,22
1657646579652,MATH 142A,A03,093480,Chow; Bennett,9,0,32,23
1657646579652,MATH 142A,B03,093481,Chow; Bennett,8,0,32,24
1657646579652,MATH 142A,B04,093558,Chow; Bennett,13,0,32,19
1657646579652,MATH 142A,B05,093559,Chow; Bennett,6,0,32,26
1657646585682,MATH 193A,A01,083224,Rotar; Vladimir,8,0,34,26
1657646585682,MATH 193A,A02,083225,Rotar; Vladimir,9,0,34,25
1657646585682,MATH 193A,A03,083781,Rotar; Vladimir,5,0,34,29
1657646585682,MATH 193A,A04,083782,Rotar; Vladimir,10,0,34,24
1657646585682,MATH 193A,A05,093482,Rotar; Vladimir,10,0,34,24
1657646591708,MATH 197,001,091859,McAuley; Julian John,9999,0,9999,0
1657646591708,MATH 197,002,095566,Kedlaya; Kiran S.,9997,0,9999,2
1657646591708,MATH 197,003,095567,Xiao; Ming,9999,0,9999,0
1657646591708,MATH 197,004,095571,Perols; Johan Lars,9998,0,9999,1
1657646598761,COGS 9,A01,083615,Shannon; Kyle Michael,9,0,75,66
1657646604784,COGS 11,A01,083617,Boyle; Mary E. T.,23,0,48,25
1657646610815,COGS 13,A01,083071,Bastos; Amalia Pinkusfeld,11,0,71,60
1657646616838,COGS 14A,A01,092681,Semenuks; Arturs,5,1,100,95
1657646622861,COGS 14B,A01,083073,Cheng; Tzu-Han,6,0,63,57
1657646628889,COGS 17,A01,092677,Semenuks; Arturs,6,0,81,75
1657646634915,COGS 100,A01,083619,Allen; Michael Gordon,17,0,70,53
1657646640937,COGS 101A,A01,083621,Davis; Joshua Daniel,9,0,68,59
1657646646967,COGS 101B,A01,091572,Allen; Michael Gordon,12,0,65,53
1657646652989,COGS 101C,A01,083625,Delgado; Tania,17,0,35,18
1657646659016,COGS 107A,A01,083627,Boyle; Mary E. T.,13,0,60,47
1657646665044,COGS 118A,A01,083075,Gupta; Anjum,21,0,76,55
1657646671073,CSE 3,A50,083646,Miranda; Gregory Joseph,24,0,50,26
1657646677100,CSE 8A,A50,083650,Miranda; Gregory Joseph,17,1,56,39
1657646683130,CSE 11,A01,083080,Cao; Yingjun,6,15,40,34
1657646689156,CSE 12,A01,083652,Krause-Levy; Sophia Louisa,28,1,120,92
1657646695183,CSE 15L,A01,083654,Morris; Justin Loren,9,0,50,41
1657646695183,CSE 15L,A02,083655,Morris; Justin Loren,9,0,50,41
1657646701206,CSE 20,A01,083657,Tran; Khoa Dang,39,0,80,41
1657646707238,CSE 21,A01,095574,Bach; Quang Tran,22,0,48,26
1657646713262,CSE 30,A01,083084,Eldon; John,6,0,80,74
1657646713262,CSE 30,B01,095061,Bhaskar; Nishant,9,0,50,41
1657646719293,CSE 100,A01,083659,Cao; Yingjun,5,4,70,65
1657646725338,CSE 134B,A01,083661,Powell; Thomas Allan,22,0,100,78
1657646731363,CSE 140,A01,083663,Gungor; Onat,15,0,85,70
1657646737389,CSE 140L,A01,083088,Eldon; John,21,0,100,79
1657646743414,CSE 175,A01,083665,Kumar; Rakesh,3,0,25,22
1657646749437,CSE 190,A00,092507,Dubnov; Shlomo,8,0,20,12
1657646755471,ECE 45,A01,083139,Congero; Spencer William,6,0,75,69
1657646761494,ECE 65,A50,083695,Saad; Andrew S,12,0,30,18
1657646761494,ECE 65,A51,095125,Saad; Andrew S,24,0,26,2
1657646767517,ECE 109,A01,091882,Touri; Behrouz,19,0,70,51
1657646773551,ECE 180,A00,083140,Abi Samra; Nicholas Camill,1,0,30,29
1657646773551,ECE 180,B00,083141,Abi Samra; Nicholas Camill,0,0,30,30
1657646779574,MATH 10A,A01,083735,Patchell; Gregory David,2,0,30,28
1657646779574,MATH 10A,A02,083736,Patchell; Gregory David,20,0,30,10
1657646779574,MATH 10A,A03,083737,Patchell; Gregory David,16,0,30,14
1657646785598,MATH 10B,A01,083207,Lim; Seonhee,8,0,34,26
1657646785598,MATH 10B,A02,083208,Lim; Seonhee,9,0,35,26
1657646785598,MATH 10B,A03,093472,Lim; Seonhee,7,0,34,27
1657646785598,MATH 10B,B01,083739,Sinha; Shubham,12,0,30,18
1657646791625,MATH 18,A01,083743,Cinel; Cameron Alexander,7,0,30,23
1657646791625,MATH 18,A02,083744,Cinel; Cameron Alexander,17,0,30,13
1657646791625,MATH 18,A03,083745,Cinel; Cameron Alexander,9,0,30,21
1657646791625,MATH 18,B01,083748,Rideout; David Porter,5,0,37,32
1657646791625,MATH 18,B02,083749,Rideout; David Porter,5,0,36,31
1657646791625,MATH 18,B03,083750,Rideout; David Porter,3,0,37,34
1657646791625,MATH 18,B04,083751,Rideout; David Porter,6,0,36,30
1657646791625,MATH 18,B05,093473,Rideout; David Porter,6,0,36,30
1657646791625,MATH 18,B06,093474,Rideout; David Porter,6,0,36,30
1657646797650,MATH 20A,A01,083754,Zheng; Zequn,14,0,40,26
1657646803676,MATH 20B,A01,083756,Briones; Jor-el Thomas Caparas,4,0,36,32
1657646803676,MATH 20B,A02,083757,Briones; Jor-el Thomas Caparas,1,0,36,35
1657646803676,MATH 20B,A03,093475,Briones; Jor-el Thomas Caparas,2,0,36,34
1657646809702,MATH 20C,A01,083760,Briones; Jor-el Thomas Caparas,1,0,35,34
1657646809702,MATH 20C,A02,083761,Briones; Jor-el Thomas Caparas,8,0,35,27
1657646809702,MATH 20C,A03,093476,Briones; Jor-el Thomas Caparas,0,1,36,36
1657646809702,MATH 20C,B01,083762,Bach; Quang Tran,1,0,30,29
1657646815753,MATH 20D,A01,083765,Tran; Brian Kha,5,0,30,25
1657646815753,MATH 20D,A02,083766,Tran; Brian Kha,5,0,30,25
1657646815753,MATH 20D,A03,083767,Tran; Brian Kha,5,0,30,25
1657646821775,MATH 20E,A01,083771,Ganguly; Soumya,9,0,32,23
1657646821775,MATH 20E,A02,083772,Ganguly; Soumya,6,0,32,26
1657646821775,MATH 20E,B01,083773,Ciotti; Benjamin,20,0,35,15
1657646821775,MATH 20E,B02,083774,Ciotti; Benjamin,18,0,35,17
1657646827805,MATH 103A,A01,083777,Greenfeld; Be'Eri,3,0,36,33
1657646827805,MATH 103A,A02,083778,Greenfeld; Be'Eri,5,0,36,31
1657646827805,MATH 103A,A03,093561,Greenfeld; Be'Eri,6,0,36,30
1657646827805,MATH 103A,B01,083779,Greenfeld; Be'Eri,7,0,36,29
1657646827805,MATH 103A,B02,083780,Greenfeld; Be'Eri,4,0,36,32
1657646827805,MATH 103A,B03,093562,Greenfeld; Be'Eri,3,0,36,33
1657646833828,MATH 105,A01,085443,Carter; Anne Toulson,15,0,35,20
1657646833828,MATH 105,A02,093477,Carter; Anne Toulson,20,0,35,15
1657646839855,MATH 109,A01,083213,Ganzberger; Geoffrey Michael,2,0,34,32
1657646839855,MATH 109,A02,083214,Ganzberger; Geoffrey Michael,4,0,34,30
1657646839855,MATH 109,A03,093478,Ganzberger; Geoffrey Michael,2,0,34,32
1657646839855,MATH 109,B01,083215,Ganzberger; Geoffrey Michael,1,0,32,31
1657646839855,MATH 109,B02,083216,Ganzberger; Geoffrey Michael,2,0,32,30
1657646839855,MATH 109,B03,093479,Ganzberger; Geoffrey Michael,8,0,32,24
1657646845879,MATH 142A,A01,083219,Chow; Bennett,7,0,32,25
1657646845879,MATH 142A,A02,083220,Chow; Bennett,10,0,32,22
1657646845879,MATH 142A,A03,093480,Chow; Bennett,9,0,32,23
1657646845879,MATH 142A,B03,093481,Chow; Bennett,8,0,32,24
1657646845879,MATH 142A,B04,093558,Chow; Bennett,13,0,32,19
1657646845879,MATH 142A,B05,093559,Chow; Bennett,6,0,32,26
1657646851908,MATH 193A,A01,083224,Rotar; Vladimir,8,0,34,26
1657646851908,MATH 193A,A02,083225,Rotar; Vladimir,9,0,34,25
1657646851908,MATH 193A,A03,083781,Rotar; Vladimir,5,0,34,29
1657646851908,MATH 193A,A04,083782,Rotar; Vladimir,10,0,34,24
1657646851908,MATH 193A,A05,093482,Rotar; Vladimir,10,0,34,24
1657646857929,MATH 197,001,091859,McAuley; Julian John,9999,0,9999,0
1657646857929,MATH 197,002,095566,Kedlaya; Kiran S.,9997,0,9999,2
1657646857929,MATH 197,003,095567,Xiao; Ming,9999,0,9999,0
1657646857929,MATH 197,004,095571,Perols; Johan Lars,9998,0,9999,1
1657646864985,COGS 9,A01,083615,Shannon; Kyle Michael,9,0,75,66
1657646871007,COGS 11,A01,083617,Boyle; Mary E. T.,23,0,48,25
1657646877036,COGS 13,A01,083071,Bastos; Amalia Pinkusfeld,11,0,71,60
1657646883064,COGS 14A,A01,092681,Semenuks; Arturs,5,1,100,95
1657646889099,COGS 14B,A01,083073,Cheng; Tzu-Han,6,0,63,57
1657646895121,COGS 17,A01,092677,Semenuks; Arturs,6,0,81,75
1657646901156,COGS 100,A01,083619,Allen; Michael Gordon,17,0,70,53
1657646907179,COGS 101A,A01,083621,Davis; Joshua Daniel,9,0,68,59
1657646913203,COGS 101B,A01,091572,Allen; Michael Gordon,12,0,65,53
1657646919235,COGS 101C,A01,083625,Delgado; Tania,17,0,35,18
1657646925259,COGS 107A,A01,083627,Boyle; Mary E. T.,13,0,60,47
1657646931281,COGS 118A,A01,083075,Gupta; Anjum,21,0,76,55
1657646937314,CSE 3,A50,083646,Miranda; Gregory Joseph,24,0,50,26
1657646943337,CSE 8A,A50,083650,Miranda; Gregory Joseph,17,1,56,39
1657646949372,CSE 11,A01,083080,Cao; Yingjun,6,15,40,34
1657646955399,CSE 12,A01,083652,Krause-Levy; Sophia Louisa,28,1,120,92
1657646961436,CSE 15L,A01,083654,Morris; Justin Loren,9,0,50,41
1657646961436,CSE 15L,A02,083655,Morris; Justin Loren,9,0,50,41
1657646967479,CSE 20,A01,083657,Tran; Khoa Dang,39,0,80,41
1657646973515,CSE 21,A01,095574,Bach; Quang Tran,22,0,48,26
1657646979537,CSE 30,A01,083084,Eldon; John,6,0,80,74
1657646979537,CSE 30,B01,095061,Bhaskar; Nishant,9,0,50,41
1657646985564,CSE 100,A01,083659,Cao; Yingjun,5,4,70,65
1657646991586,CSE 134B,A01,083661,Powell; Thomas Allan,23,0,100,77
1657646997610,CSE 140,A01,083663,Gungor; Onat,15,0,85,70
1657647003633,CSE 140L,A01,083088,Eldon; John,21,0,100,79
1657647009655,CSE 175,A01,083665,Kumar; Rakesh,3,0,25,22
1657647015678,CSE 190,A00,092507,Dubnov; Shlomo,8,0,20,12
1657647021719,ECE 45,A01,083139,Congero; Spencer William,6,0,75,69
1657647027751,ECE 65,A50,083695,Saad; Andrew S,12,0,30,18
1657647027751,ECE 65,A51,095125,Saad; Andrew S,24,0,26,2
1657647033780,ECE 109,A01,091882,Touri; Behrouz,19,0,70,51
1657647039809,ECE 180,A00,083140,Abi Samra; Nicholas Camill,1,0,30,29
1657647039809,ECE 180,B00,083141,Abi Samra; Nicholas Camill,0,0,30,30
1657647045837,MATH 10A,A01,083735,Patchell; Gregory David,2,0,30,28
1657647045837,MATH 10A,A02,083736,Patchell; Gregory David,20,0,30,10
1657647045837,MATH 10A,A03,083737,Patchell; Gregory David,16,0,30,14
1657647051860,MATH 10B,A01,083207,Lim; Seonhee,8,0,34,26
1657647051860,MATH 10B,A02,083208,Lim; Seonhee,9,0,35,26
1657647051860,MATH 10B,A03,093472,Lim; Seonhee,7,0,34,27
1657647051860,MATH 10B,B01,083739,Sinha; Shubham,12,0,30,18
1657647057885,MATH 18,A01,083743,Cinel; Cameron Alexander,7,0,30,23
1657647057885,MATH 18,A02,083744,Cinel; Cameron Alexander,17,0,30,13
1657647057885,MATH 18,A03,083745,Cinel; Cameron Alexander,9,0,30,21
1657647057885,MATH 18,B01,083748,Rideout; David Porter,5,0,37,32
1657647057885,MATH 18,B02,083749,Rideout; David Porter,5,0,36,31
1657647057885,MATH 18,B03,083750,Rideout; David Porter,3,0,37,34
1657647057885,MATH 18,B04,083751,Rideout; David Porter,6,0,36,30
1657647057885,MATH 18,B05,093473,Rideout; David Porter,6,0,36,30
1657647057885,MATH 18,B06,093474,Rideout; David Porter,6,0,36,30
1657647063920,MATH 20A,A01,083754,Zheng; Zequn,14,0,40,26
1657647069943,MATH 20B,A01,083756,Briones; Jor-el Thomas Caparas,4,0,36,32
1657647069943,MATH 20B,A02,083757,Briones; Jor-el Thomas Caparas,1,0,36,35
1657647069943,MATH 20B,A03,093475,Briones; Jor-el Thomas Caparas,2,0,36,34
1657647075980,MATH 20C,A01,083760,Briones; Jor-el Thomas Caparas,1,0,35,34
1657647075980,MATH 20C,A02,083761,Briones; Jor-el Thomas Caparas,8,0,35,27
1657647075980,MATH 20C,A03,093476,Briones; Jor-el Thomas Caparas,0,1,36,36
1657647075980,MATH 20C,B01,083762,Bach; Quang Tran,1,0,30,29
1657647082007,MATH 20D,A01,083765,Tran; Brian Kha,5,0,30,25
1657647082007,MATH 20D,A02,083766,Tran; Brian Kha,5,0,30,25
1657647082007,MATH 20D,A03,083767,Tran; Brian Kha,5,0,30,25
1657647088036,MATH 20E,A01,083771,Ganguly; Soumya,9,0,32,23
1657647088036,MATH 20E,A02,083772,Ganguly; Soumya,6,0,32,26
1657647088036,MATH 20E,B01,083773,Ciotti; Benjamin,20,0,35,15
1657647088036,MATH 20E,B02,083774,Ciotti; Benjamin,18,0,35,17
1657647094065,MATH 103A,A01,083777,Greenfeld; Be'Eri,3,0,36,33
1657647094065,MATH 103A,A02,083778,Greenfeld; Be'Eri,5,0,36,31
1657647094065,MATH 103A,A03,093561,Greenfeld; Be'Eri,6,0,36,30
1657647094065,MATH 103A,B01,083779,Greenfeld; Be'Eri,7,0,36,29
1657647094065,MATH 103A,B02,083780,Greenfeld; Be'Eri,4,0,36,32
1657647094065,MATH 103A,B03,093562,Greenfeld; Be'Eri,3,0,36,33
1657647100089,MATH 105,A01,085443,Carter; Anne Toulson,15,0,35,20
1657647100089,MATH 105,A02,093477,Carter; Anne Toulson,20,0,35,15
1657647106118,MATH 109,A01,083213,Ganzberger; Geoffrey Michael,2,0,34,32
1657647106118,MATH 109,A02,083214,Ganzberger; Geoffrey Michael,4,0,34,30
1657647106118,MATH 109,A03,093478,Ganzberger; Geoffrey Michael,2,0,34,32
1657647106118,MATH 109,B01,083215,Ganzberger; Geoffrey Michael,1,0,32,31
1657647106118,MATH 109,B02,083216,Ganzberger; Geoffrey Michael,2,0,32,30
1657647106118,MATH 109,B03,093479,Ganzberger; Geoffrey Michael,8,0,32,24
1657647112141,MATH 142A,A01,083219,Chow; Bennett,7,0,32,25
1657647112141,MATH 142A,A02,083220,Chow; Bennett,10,0,32,22
1657647112141,MATH 142A,A03,093480,Chow; Bennett,9,0,32,23
1657647112141,MATH 142A,B03,093481,Chow; Bennett,8,0,32,24
1657647112141,MATH 142A,B04,093558,Chow; Bennett,13,0,32,19
1657647112141,MATH 142A,B05,093559,Chow; Bennett,6,0,32,26
1657647118167,MATH 193A,A01,083224,Rotar; Vladimir,8,0,34,26
1657647118167,MATH 193A,A02,083225,Rotar; Vladimir,9,0,34,25
1657647118167,MATH 193A,A03,083781,Rotar; Vladimir,5,0,34,29
1657647118167,MATH 193A,A04,083782,Rotar; Vladimir,10,0,34,24
1657647118167,MATH 193A,A05,093482,Rotar; Vladimir,10,0,34,24
1657647124265,MATH 197,001,091859,McAuley; Julian John,9999,0,9999,0
1657647124265,MATH 197,002,095566,Kedlaya; Kiran S.,9997,0,9999,2
1657647124265,MATH 197,003,095567,Xiao; Ming,9999,0,9999,0
1657647124265,MATH 197,004,095571,Perols; Johan Lars,9998,0,9999,1
1657647131331,COGS 9,A01,083615,Shannon; Kyle Michael,9,0,75,66
1657647137362,COGS 11,A01,083617,Boyle; Mary E. T.,23,0,48,25
1657647143384,COGS 13,A01,083071,Bastos; Amalia Pinkusfeld,11,0,71,60
1657647149415,COGS 14A,A01,092681,Semenuks; Arturs,5,1,100,95
1657647155442,COGS 14B,A01,083073,Cheng; Tzu-Han,6,0,63,57
1657647161469,COGS 17,A01,092677,Semenuks; Arturs,6,0,81,75
1657647167493,COGS 100,A01,083619,Allen; Michael Gordon,17,0,70,53
1657647173516,COGS 101A,A01,083621,Davis; Joshua Daniel,9,0,68,59
1657647179538,COGS 101B,A01,091572,Allen; Michael Gordon,12,0,65,53
1657647185566,COGS 101C,A01,083625,Delgado; Tania,17,0,35,18
1657647191591,COGS 107A,A01,083627,Boyle; Mary E. T.,13,0,60,47
1657647197617,COGS 118A,A01,083075,Gupta; Anjum,21,0,76,55
1657647203641,CSE 3,A50,083646,Miranda; Gregory Joseph,24,0,50,26
1657647209663,CSE 8A,A50,083650,Miranda; Gregory Joseph,17,1,56,39
1657647215691,CSE 11,A01,083080,Cao; Yingjun,6,15,40,34
1657647221718,CSE 12,A01,083652,Krause-Levy; Sophia Louisa,28,1,120,92
1657647227741,CSE 15L,A01,083654,Morris; Justin Loren,9,0,50,41
1657647227741,CSE 15L,A02,083655,Morris; Justin Loren,9,0,50,41
1657647233766,CSE 20,A01,083657,Tran; Khoa Dang,39,0,80,41
1657647239791,CSE 21,A01,095574,Bach; Quang Tran,22,0,48,26
1657647245819,CSE 30,A01,083084,Eldon; John,6,0,80,74
1657647245819,CSE 30,B01,095061,Bhaskar; Nishant,9,0,50,41
1657647251844,CSE 100,A01,083659,Cao; Yingjun,5,4,70,65
1657647257867,CSE 134B,A01,083661,Powell; Thomas Allan,23,0,100,77
1657647263894,CSE 140,A01,083663,Gungor; Onat,15,0,85,70
1657647269925,CSE 140L,A01,083088,Eldon; John,21,0,100,79
1657647275948,CSE 175,A01,083665,Kumar; Rakesh,3,0,25,22
1657647281986,CSE 190,A00,092507,Dubnov; Shlomo,8,0,20,12
1657647288012,ECE 45,A01,083139,Congero; Spencer William,6,0,75,69
1657647294039,ECE 65,A50,083695,Saad; Andrew S,12,0,30,18
1657647294039,ECE 65,A51,095125,Saad; Andrew S,24,0,26,2
1657647300063,ECE 109,A01,091882,Touri; Behrouz,19,0,70,51
1657647306100,ECE 180,A00,083140,Abi Samra; Nicholas Camill,1,0,30,29
1657647306100,ECE 180,B00,083141,Abi Samra; Nicholas Camill,0,0,30,30
1657647312149,MATH 10A,A01,083735,Patchell; Gregory David,2,0,30,28
1657647312149,MATH 10A,A02,083736,Patchell; Gregory David,20,0,30,10
1657647312149,MATH 10A,A03,083737,Patchell; Gregory David,16,0,30,14
1657647318183,MATH 10B,A01,083207,Lim; Seonhee,8,0,34,26
1657647318183,MATH 10B,A02,083208,Lim; Seonhee,9,0,35,26
1657647318183,MATH 10B,A03,093472,Lim; Seonhee,7,0,34,27
1657647318183,MATH 10B,B01,083739,Sinha; Shubham,12,0,30,18
1657647324206,MATH 18,A01,083743,Cinel; Cameron Alexander,7,0,30,23
1657647324206,MATH 18,A02,083744,Cinel; Cameron Alexander,17,0,30,13
1657647324206,MATH 18,A03,083745,Cinel; Cameron Alexander,9,0,30,21
1657647324206,MATH 18,B01,083748,Rideout; David Porter,5,0,37,32
1657647324206,MATH 18,B02,083749,Rideout; David Porter,5,0,36,31
1657647324206,MATH 18,B03,083750,Rideout; David Porter,3,0,37,34
1657647324206,MATH 18,B04,083751,Rideout; David Porter,6,0,36,30
1657647324206,MATH 18,B05,093473,Rideout; David Porter,6,0,36,30
1657647324206,MATH 18,B06,093474,Rideout; David Porter,6,0,36,30
1657647330233,MATH 20A,A01,083754,Zheng; Zequn,14,0,40,26
1657647336255,MATH 20B,A01,083756,Briones; Jor-el Thomas Caparas,4,0,36,32
1657647336255,MATH 20B,A02,083757,Briones; Jor-el Thomas Caparas,1,0,36,35
1657647336255,MATH 20B,A03,093475,Briones; Jor-el Thomas Caparas,2,0,36,34
1657647342282,MATH 20C,A01,083760,Briones; Jor-el Thomas Caparas,1,0,35,34
1657647342282,MATH 20C,A02,083761,Briones; Jor-el Thomas Caparas,8,0,35,27
1657647342282,MATH 20C,A03,093476,Briones; Jor-el Thomas Caparas,0,1,36,36
1657647342282,MATH 20C,B01,083762,Bach; Quang Tran,1,0,30,29
1657647348322,MATH 20D,A01,083765,Tran; Brian Kha,5,0,30,25
1657647348322,MATH 20D,A02,083766,Tran; Brian Kha,5,0,30,25
1657647348322,MATH 20D,A03,083767,Tran; Brian Kha,5,0,30,25
1657647354359,MATH 20E,A01,083771,Ganguly; Soumya,9,0,32,23
1657647354359,MATH 20E,A02,083772,Ganguly; Soumya,6,0,32,26
1657647354359,MATH 20E,B01,083773,Ciotti; Benjamin,20,0,35,15
1657647354359,MATH 20E,B02,083774,Ciotti; Benjamin,18,0,35,17
1657647360383,MATH 103A,A01,083777,Greenfeld; Be'Eri,3,0,36,33
1657647360383,MATH 103A,A02,083778,Greenfeld; Be'Eri,5,0,36,31
1657647360383,MATH 103A,A03,093561,Greenfeld; Be'Eri,6,0,36,30
1657647360383,MATH 103A,B01,083779,Greenfeld; Be'Eri,7,0,36,29
1657647360383,MATH 103A,B02,083780,Greenfeld; Be'Eri,4,0,36,32
1657647360383,MATH 103A,B03,093562,Greenfeld; Be'Eri,3,0,36,33
1657647366407,MATH 105,A01,085443,Carter; Anne Toulson,15,0,35,20
1657647366407,MATH 105,A02,093477,Carter; Anne Toulson,20,0,35,15
1657647372454,MATH 109,A01,083213,Ganzberger; Geoffrey Michael,2,0,34,32
1657647372454,MATH 109,A02,083214,Ganzberger; Geoffrey Michael,4,0,34,30
1657647372454,MATH 109,A03,093478,Ganzberger; Geoffrey Michael,2,0,34,32
1657647372454,MATH 109,B01,083215,Ganzberger; Geoffrey Michael,1,0,32,31
1657647372454,MATH 109,B02,083216,Ganzberger; Geoffrey Michael,2,0,32,30
1657647372454,MATH 109,B03,093479,Ganzberger; Geoffrey Michael,8,0,32,24
1657647378488,MATH 142A,A01,083219,Chow; Bennett,7,0,32,25
1657647378488,MATH 142A,A02,083220,Chow; Bennett,10,0,32,22
1657647378488,MATH 142A,A03,093480,Chow; Bennett,9,0,32,23
1657647378488,MATH 142A,B03,093481,Chow; Bennett,8,0,32,24
1657647378488,MATH 142A,B04,093558,Chow; Bennett,13,0,32,19
1657647378488,MATH 142A,B05,093559,Chow; Bennett,6,0,32,26
1657647384523,MATH 193A,A01,083224,Rotar; Vladimir,8,0,34,26
1657647384523,MATH 193A,A02,083225,Rotar; Vladimir,9,0,34,25
1657647384523,MATH 193A,A03,083781,Rotar; Vladimir,5,0,34,29
1657647384523,MATH 193A,A04,083782,Rotar; Vladimir,10,0,34,24
1657647384523,MATH 193A,A05,093482,Rotar; Vladimir,10,0,34,24
1657647390545,MATH 197,001,091859,McAuley; Julian John,9999,0,9999,0
1657647390545,MATH 197,002,095566,Kedlaya; Kiran S.,9997,0,9999,2
1657647390545,MATH 197,003,095567,Xiao; Ming,9999,0,9999,0
1657647390545,MATH 197,004,095571,Perols; Johan Lars,9998,0,9999,1
1657647397599,COGS 9,A01,083615,Shannon; Kyle Michael,9,0,75,66
1657647403625,COGS 11,A01,083617,Boyle; Mary E. T.,23,0,48,25
1657647409651,COGS 13,A01,083071,Bastos; Amalia Pinkusfeld,11,0,71,60
1657647415675,COGS 14A,A01,092681,Semenuks; Arturs,5,1,100,95
1657647421700,COGS 14B,A01,083073,Cheng; Tzu-Han,6,0,63,57
1657647427721,COGS 17,A01,092677,Semenuks; Arturs,6,0,81,75
1657647433759,COGS 100,A01,083619,Allen; Michael Gordon,17,0,70,53
1657647439784,COGS 101A,A01,083621,Davis; Joshua Daniel,9,0,68,59
1657647445824,COGS 101B,A01,091572,Allen; Michael Gordon,12,0,65,53
1657647451851,COGS 101C,A01,083625,Delgado; Tania,17,0,35,18
1657647457880,COGS 107A,A01,083627,Boyle; Mary E. T.,13,0,60,47
1657647463903,COGS 118A,A01,083075,Gupta; Anjum,21,0,76,55
1657647469930,CSE 3,A50,083646,Miranda; Gregory Joseph,24,0,50,26
1657647475960,CSE 8A,A50,083650,Miranda; Gregory Joseph,17,1,56,39
1657647481982,CSE 11,A01,083080,Cao; Yingjun,6,15,40,34
1657647488014,CSE 12,A01,083652,Krause-Levy; Sophia Louisa,28,1,120,92
1657647494038,CSE 15L,A01,083654,Morris; Justin Loren,9,0,50,41
1657647494038,CSE 15L,A02,083655,Morris; Justin Loren,9,0,50,41
1657647500064,CSE 20,A01,083657,Tran; Khoa Dang,39,0,80,41
1657647506095,CSE 21,A01,095574,Bach; Quang Tran,22,0,48,26
1657647512120,CSE 30,A01,083084,Eldon; John,6,0,80,74
1657647512120,CSE 30,B01,095061,Bhaskar; Nishant,9,0,50,41
1657647518149,CSE 100,A01,083659,Cao; Yingjun,5,4,70,65
1657647524176,CSE 134B,A01,083661,Powell; Thomas Allan,23,0,100,77
1657647530201,CSE 140,A01,083663,Gungor; Onat,15,0,85,70
1657647536227,CSE 140L,A01,083088,Eldon; John,21,0,100,79
1657647542251,CSE 175,A01,083665,Kumar; Rakesh,3,0,25,22
1657647548277,CSE 190,A00,092507,Dubnov; Shlomo,8,0,20,12
1657647555528,ECE 45,A01,083139,Congero; Spencer William,6,0,75,69
1657647561555,ECE 65,A50,083695,Saad; Andrew S,12,0,30,18
1657647561555,ECE 65,A51,095125,Saad; Andrew S,24,0,26,2
1657647567577,ECE 109,A01,091882,Touri; Behrouz,19,0,70,51
1657647573608,ECE 180,A00,083140,Abi Samra; Nicholas Camill,1,0,30,29
1657647573608,ECE 180,B00,083141,Abi Samra; Nicholas Camill,0,0,30,30
1657647579634,MATH 10A,A01,083735,Patchell; Gregory David,2,0,30,28
1657647579634,MATH 10A,A02,083736,Patchell; Gregory David,20,0,30,10
1657647579634,MATH 10A,A03,083737,Patchell; Gregory David,16,0,30,14
1657647585662,MATH 10B,A01,083207,Lim; Seonhee,8,0,34,26
1657647585662,MATH 10B,A02,083208,Lim; Seonhee,9,0,35,26
1657647585662,MATH 10B,A03,093472,Lim; Seonhee,7,0,34,27
1657647585662,MATH 10B,B01,083739,Sinha; Shubham,12,0,30,18
1657647591691,MATH 18,A01,083743,Cinel; Cameron Alexander,7,0,30,23
1657647591691,MATH 18,A02,083744,Cinel; Cameron Alexander,17,0,30,13
1657647591691,MATH 18,A03,083745,Cinel; Cameron Alexander,9,0,30,21
1657647591691,MATH 18,B01,083748,Rideout; David Porter,5,0,37,32
1657647591691,MATH 18,B02,083749,Rideout; David Porter,5,0,36,31
1657647591691,MATH 18,B03,083750,Rideout; David Porter,3,0,37,34
1657647591691,MATH 18,B04,083751,Rideout; David Porter,6,0,36,30
1657647591691,MATH 18,B05,093473,Rideout; David Porter,6,0,36,30
1657647591691,MATH 18,B06,093474,Rideout; David Porter,6,0,36,30
1657647597725,MATH 20A,A01,083754,Zheng; Zequn,14,0,40,26
1657647603754,MATH 20B,A01,083756,Briones; Jor-el Thomas Caparas,4,0,36,32
1657647603754,MATH 20B,A02,083757,Briones; Jor-el Thomas Caparas,1,0,36,35
1657647603754,MATH 20B,A03,093475,Briones; Jor-el Thomas Caparas,2,0,36,34
1657647609784,MATH 20C,A01,083760,Briones; Jor-el Thomas Caparas,1,0,35,34
1657647609784,MATH 20C,A02,083761,Briones; Jor-el Thomas Caparas,8,0,35,27
1657647609784,MATH 20C,A03,093476,Briones; Jor-el Thomas Caparas,0,1,36,36
1657647609784,MATH 20C,B01,083762,Bach; Quang Tran,1,0,30,29
1657647615806,MATH 20D,A01,083765,Tran; Brian Kha,5,0,30,25
1657647615806,MATH 20D,A02,083766,Tran; Brian Kha,5,0,30,25
1657647615806,MATH 20D,A03,083767,Tran; Brian Kha,5,0,30,25
1657647621839,MATH 20E,A01,083771,Ganguly; Soumya,9,0,32,23
1657647621839,MATH 20E,A02,083772,Ganguly; Soumya,6,0,32,26
1657647621839,MATH 20E,B01,083773,Ciotti; Benjamin,20,0,35,15
1657647621839,MATH 20E,B02,083774,Ciotti; Benjamin,18,0,35,17
1657647627869,MATH 103A,A01,083777,Greenfeld; Be'Eri,3,0,36,33
1657647627869,MATH 103A,A02,083778,Greenfeld; Be'Eri,5,0,36,31
1657647627869,MATH 103A,A03,093561,Greenfeld; Be'Eri,6,0,36,30
1657647627869,MATH 103A,B01,083779,Greenfeld; Be'Eri,7,0,36,29
1657647627869,MATH 103A,B02,083780,Greenfeld; Be'Eri,4,0,36,32
1657647627869,MATH 103A,B03,093562,Greenfeld; Be'Eri,3,0,36,33
1657647633892,MATH 105,A01,085443,Carter; Anne Toulson,15,0,35,20
1657647633892,MATH 105,A02,093477,Carter; Anne Toulson,20,0,35,15
1657647639933,MATH 109,A01,083213,Ganzberger; Geoffrey Michael,2,0,34,32
1657647639933,MATH 109,A02,083214,Ganzberger; Geoffrey Michael,4,0,34,30
1657647639933,MATH 109,A03,093478,Ganzberger; Geoffrey Michael,2,0,34,32
1657647639933,MATH 109,B01,083215,Ganzberger; Geoffrey Michael,1,0,32,31
1657647639933,MATH 109,B02,083216,Ganzberger; Geoffrey Michael,2,0,32,30
1657647639933,MATH 109,B03,093479,Ganzberger; Geoffrey Michael,8,0,32,24
1657647645974,MATH 142A,A01,083219,Chow; Bennett,7,0,32,25
1657647645974,MATH 142A,A02,083220,Chow; Bennett,10,0,32,22
1657647645974,MATH 142A,A03,093480,Chow; Bennett,9,0,32,23
1657647645974,MATH 142A,B03,093481,Chow; Bennett,8,0,32,24
1657647645974,MATH 142A,B04,093558,Chow; Bennett,13,0,32,19
1657647645974,MATH 142A,B05,093559,Chow; Bennett,6,0,32,26
1657647652007,MATH 193A,A01,083224,Rotar; Vladimir,8,0,34,26
1657647652007,MATH 193A,A02,083225,Rotar; Vladimir,9,0,34,25
1657647652007,MATH 193A,A03,083781,Rotar; Vladimir,5,0,34,29
1657647652007,MATH 193A,A04,083782,Rotar; Vladimir,10,0,34,24
1657647652007,MATH 193A,A05,093482,Rotar; Vladimir,10,0,34,24
1657647658034,MATH 197,001,091859,McAuley; Julian John,9999,0,9999,0
1657647658034,MATH 197,002,095566,Kedlaya; Kiran S.,9997,0,9999,2
1657647658034,MATH 197,003,095567,Xiao; Ming,9999,0,9999,0
1657647658034,MATH 197,004,095571,Perols; Johan Lars,9998,0,9999,1
1657647665091,COGS 9,A01,083615,Shannon; Kyle Michael,9,0,75,66
1657647671118,COGS 11,A01,083617,Boyle; Mary E. T.,23,0,48,25
1657647677140,COGS 13,A01,083071,Bastos; Amalia Pinkusfeld,11,0,71,60
1657647683166,COGS 14A,A01,092681,Semenuks; Arturs,5,1,100,95
1657647689189,COGS 14B,A01,083073,Cheng; Tzu-Han,6,0,63,57
1657647695225,COGS 17,A01,092677,Semenuks; Arturs,6,0,81,75
1657647701249,COGS 100,A01,083619,Allen; Michael Gordon,17,0,70,53
1657647707277,COGS 101A,A01,083621,Davis; Joshua Daniel,9,0,68,59
1657647713308,COGS 101B,A01,091572,Allen; Michael Gordon,12,0,65,53
1657647719435,COGS 101C,A01,083625,Delgado; Tania,17,0,35,18
1657647725461,COGS 107A,A01,083627,Boyle; Mary E. T.,13,0,60,47
1657647731495,COGS 118A,A01,083075,Gupta; Anjum,21,0,76,55
1657647737518,CSE 3,A50,083646,Miranda; Gregory Joseph,24,0,50,26
1657647743545,CSE 8A,A50,083650,Miranda; Gregory Joseph,17,1,56,39
1657647749571,CSE 11,A01,083080,Cao; Yingjun,6,15,40,34
1657647755598,CSE 12,A01,083652,Krause-Levy; Sophia Louisa,28,1,120,92
1657647761624,CSE 15L,A01,083654,Morris; Justin Loren,9,0,50,41
1657647761624,CSE 15L,A02,083655,Morris; Justin Loren,9,0,50,41
1657647767663,CSE 20,A01,083657,Tran; Khoa Dang,39,0,80,41
1657647773702,CSE 21,A01,095574,Bach; Quang Tran,22,0,48,26
1657647779726,CSE 30,A01,083084,Eldon; John,6,0,80,74
1657647779726,CSE 30,B01,095061,Bhaskar; Nishant,9,0,50,41
1657647785749,CSE 100,A01,083659,Cao; Yingjun,5,4,70,65
1657647791774,CSE 134B,A01,083661,Powell; Thomas Allan,23,0,100,77
1657647797796,CSE 140,A01,083663,Gungor; Onat,15,0,85,70
1657647803821,CSE 140L,A01,083088,Eldon; John,21,0,100,79
1657647809860,CSE 175,A01,083665,Kumar; Rakesh,3,0,25,22
1657647815881,CSE 190,A00,092507,Dubnov; Shlomo,8,0,20,12
1657647821904,ECE 45,A01,083139,Congero; Spencer William,6,0,75,69
1657647827928,ECE 65,A50,083695,Saad; Andrew S,12,0,30,18
1657647827928,ECE 65,A51,095125,Saad; Andrew S,24,0,26,2
1657647833949,ECE 109,A01,091882,Touri; Behrouz,19,0,70,51
1657647839971,ECE 180,A00,083140,Abi Samra; Nicholas Camill,1,0,30,29
1657647839971,ECE 180,B00,083141,Abi Samra; Nicholas Camill,0,0,30,30
1657647846001,MATH 10A,A01,083735,Patchell; Gregory David,2,0,30,28
1657647846001,MATH 10A,A02,083736,Patchell; Gregory David,20,0,30,10
1657647846001,MATH 10A,A03,083737,Patchell; Gregory David,16,0,30,14
1657647852038,MATH 10B,A01,083207,Lim; Seonhee,8,0,34,26
1657647852038,MATH 10B,A02,083208,Lim; Seonhee,9,0,35,26
1657647852038,MATH 10B,A03,093472,Lim; Seonhee,7,0,34,27
1657647852038,MATH 10B,B01,083739,Sinha; Shubham,12,0,30,18
1657647858068,MATH 18,A01,083743,Cinel; Cameron Alexander,7,0,30,23
1657647858068,MATH 18,A02,083744,Cinel; Cameron Alexander,17,0,30,13
1657647858068,MATH 18,A03,083745,Cinel; Cameron Alexander,9,0,30,21
1657647858068,MATH 18,B01,083748,Rideout; David Porter,5,0,37,32
1657647858068,MATH 18,B02,083749,Rideout; David Porter,5,0,36,31
1657647858068,MATH 18,B03,083750,Rideout; David Porter,3,0,37,34
1657647858068,MATH 18,B04,083751,Rideout; David Porter,6,0,36,30
1657647858068,MATH 18,B05,093473,Rideout; David Porter,6,0,36,30
1657647858068,MATH 18,B06,093474,Rideout; David Porter,6,0,36,30
1657647864091,MATH 20A,A01,083754,Zheng; Zequn,14,0,40,26
1657647870124,MATH 20B,A01,083756,Briones; Jor-el Thomas Caparas,4,0,36,32
1657647870124,MATH 20B,A02,083757,Briones; Jor-el Thomas Caparas,1,0,36,35
1657647870124,MATH 20B,A03,093475,Briones; Jor-el Thomas Caparas,2,0,36,34
1657647876149,MATH 20C,A01,083760,Briones; Jor-el Thomas Caparas,1,0,35,34
1657647876149,MATH 20C,A02,083761,Briones; Jor-el Thomas Caparas,8,0,35,27
1657647876149,MATH 20C,A03,093476,Briones; Jor-el Thomas Caparas,0,1,36,36
1657647876149,MATH 20C,B01,083762,Bach; Quang Tran,1,0,30,29
1657647882174,MATH 20D,A01,083765,Tran; Brian Kha,5,0,30,25
1657647882174,MATH 20D,A02,083766,Tran; Brian Kha,5,0,30,25
1657647882174,MATH 20D,A03,083767,Tran; Brian Kha,5,0,30,25
1657647888196,MATH 20E,A01,083771,Ganguly; Soumya,9,0,32,23
1657647888196,MATH 20E,A02,083772,Ganguly; Soumya,6,0,32,26
1657647888196,MATH 20E,B01,083773,Ciotti; Benjamin,20,0,35,15
1657647888196,MATH 20E,B02,083774,Ciotti; Benjamin,18,0,35,17
1657647894221,MATH 103A,A01,083777,Greenfeld; Be'Eri,3,0,36,33
1657647894221,MATH 103A,A02,083778,Greenfeld; Be'Eri,5,0,36,31
1657647894221,MATH 103A,A03,093561,Greenfeld; Be'Eri,6,0,36,30
1657647894221,MATH 103A,B01,083779,Greenfeld; Be'Eri,7,0,36,29
1657647894221,MATH 103A,B02,083780,Greenfeld; Be'Eri,4,0,36,32
1657647894221,MATH 103A,B03,093562,Greenfeld; Be'Eri,3,0,36,33
1657647900267,MATH 105,A01,085443,Carter; Anne Toulson,15,0,35,20
1657647900267,MATH 105,A02,093477,Carter; Anne Toulson,20,0,35,15
1657647906290,MATH 109,A01,083213,Ganzberger; Geoffrey Michael,2,0,34,32
1657647906290,MATH 109,A02,083214,Ganzberger; Geoffrey Michael,4,0,34,30
1657647906290,MATH 109,A03,093478,Ganzberger; Geoffrey Michael,2,0,34,32
1657647906290,MATH 109,B01,083215,Ganzberger; Geoffrey Michael,1,0,32,31
1657647906290,MATH 109,B02,083216,Ganzberger; Geoffrey Michael,2,0,32,30
1657647906290,MATH 109,B03,093479,Ganzberger; Geoffrey Michael,8,0,32,24
1657647912319,MATH 142A,A01,083219,Chow; Bennett,7,0,32,25
1657647912319,MATH 142A,A02,083220,Chow; Bennett,10,0,32,22
1657647912319,MATH 142A,A03,093480,Chow; Bennett,9,0,32,23
1657647912319,MATH 142A,B03,093481,Chow; Bennett,8,0,32,24
1657647912319,MATH 142A,B04,093558,Chow; Bennett,13,0,32,19
1657647912319,MATH 142A,B05,093559,Chow; Bennett,6,0,32,26
1657647918349,MATH 193A,A01,083224,Rotar; Vladimir,8,0,34,26
1657647918349,MATH 193A,A02,083225,Rotar; Vladimir,9,0,34,25
1657647918349,MATH 193A,A03,083781,Rotar; Vladimir,5,0,34,29
1657647918349,MATH 193A,A04,083782,Rotar; Vladimir,10,0,34,24
1657647918349,MATH 193A,A05,093482,Rotar; Vladimir,10,0,34,24
1657647924374,MATH 197,001,091859,McAuley; Julian John,9999,0,9999,0
1657647924374,MATH 197,002,095566,Kedlaya; Kiran S.,9997,0,9999,2
1657647924374,MATH 197,003,095567,Xiao; Ming,9999,0,9999,0
1657647924374,MATH 197,004,095571,Perols; Johan Lars,9998,0,9999,1
1657647931448,COGS 9,A01,083615,Shannon; Kyle Michael,9,0,75,66
1657647937472,COGS 11,A01,083617,Boyle; Mary E. T.,23,0,48,25
1657647943496,COGS 13,A01,083071,Bastos; Amalia Pinkusfeld,11,0,71,60
1657647949518,COGS 14A,A01,092681,Semenuks; Arturs,5,1,100,95
1657647955541,COGS 14B,A01,083073,Cheng; Tzu-Han,6,0,63,57
1657647961567,COGS 17,A01,092677,Semenuks; Arturs,6,0,81,75
1657647967598,COGS 100,A01,083619,Allen; Michael Gordon,17,0,70,53
1657647973621,COGS 101A,A01,083621,Davis; Joshua Daniel,9,0,68,59
1657647979644,COGS 101B,A01,091572,Allen; Michael Gordon,12,0,65,53
1657647985668,COGS 101C,A01,083625,Delgado; Tania,17,0,35,18
1657647991689,COGS 107A,A01,083627,Boyle; Mary E. T.,13,0,60,47
1657647997720,COGS 118A,A01,083075,Gupta; Anjum,21,0,76,55
1657648003751,CSE 3,A50,083646,Miranda; Gregory Joseph,24,0,50,26
1657648009778,CSE 8A,A50,083650,Miranda; Gregory Joseph,17,1,56,39
1657648015812,CSE 11,A01,083080,Cao; Yingjun,6,15,40,34
1657648021835,CSE 12,A01,083652,Krause-Levy; Sophia Louisa,28,1,120,92
1657648027860,CSE 15L,A01,083654,Morris; Justin Loren,9,0,50,41
1657648027860,CSE 15L,A02,083655,Morris; Justin Loren,9,0,50,41
1657648033887,CSE 20,A01,083657,Tran; Khoa Dang,39,0,80,41
1657648039910,CSE 21,A01,095574,Bach; Quang Tran,22,0,48,26
1657648045938,CSE 30,A01,083084,Eldon; John,6,0,80,74
1657648045938,CSE 30,B01,095061,Bhaskar; Nishant,9,0,50,41
1657648051964,CSE 100,A01,083659,Cao; Yingjun,5,4,70,65
1657648057990,CSE 134B,A01,083661,Powell; Thomas Allan,23,0,100,77
1657648064032,CSE 140,A01,083663,Gungor; Onat,15,0,85,70
1657648070058,CSE 140L,A01,083088,Eldon; John,21,0,100,79
1657648076080,CSE 175,A01,083665,Kumar; Rakesh,3,0,25,22
1657648082116,CSE 190,A00,092507,Dubnov; Shlomo,8,0,20,12
1657648088138,ECE 45,A01,083139,Congero; Spencer William,6,0,75,69
1657648094162,ECE 65,A50,083695,Saad; Andrew S,12,0,30,18
1657648094162,ECE 65,A51,095125,Saad; Andrew S,24,0,26,2
1657648100200,ECE 109,A01,091882,Touri; Behrouz,19,0,70,51
1657648106227,ECE 180,A00,083140,Abi Samra; Nicholas Camill,1,0,30,29
1657648106227,ECE 180,B00,083141,Abi Samra; Nicholas Camill,0,0,30,30
1657648112259,MATH 10A,A01,083735,Patchell; Gregory David,2,0,30,28
1657648112259,MATH 10A,A02,083736,Patchell; Gregory David,20,0,30,10
1657648112259,MATH 10A,A03,083737,Patchell; Gregory David,16,0,30,14
1657648118289,MATH 10B,A01,083207,Lim; Seonhee,8,0,34,26
1657648118289,MATH 10B,A02,083208,Lim; Seonhee,9,0,35,26
1657648118289,MATH 10B,A03,093472,Lim; Seonhee,7,0,34,27
1657648118289,MATH 10B,B01,083739,Sinha; Shubham,12,0,30,18
1657648124315,MATH 18,A01,083743,Cinel; Cameron Alexander,7,0,30,23
1657648124315,MATH 18,A02,083744,Cinel; Cameron Alexander,17,0,30,13
1657648124315,MATH 18,A03,083745,Cinel; Cameron Alexander,9,0,30,21
1657648124315,MATH 18,B01,083748,Rideout; David Porter,5,0,37,32
1657648124315,MATH 18,B02,083749,Rideout; David Porter,5,0,36,31
1657648124315,MATH 18,B03,083750,Rideout; David Porter,3,0,37,34
1657648124315,MATH 18,B04,083751,Rideout; David Porter,6,0,36,30
1657648124315,MATH 18,B05,093473,Rideout; David Porter,6,0,36,30
1657648124315,MATH 18,B06,093474,Rideout; David Porter,6,0,36,30
1657648130344,MATH 20A,A01,083754,Zheng; Zequn,14,0,40,26
1657648136367,MATH 20B,A01,083756,Briones; Jor-el Thomas Caparas,4,0,36,32
1657648136367,MATH 20B,A02,083757,Briones; Jor-el Thomas Caparas,1,0,36,35
1657648136367,MATH 20B,A03,093475,Briones; Jor-el Thomas Caparas,2,0,36,34
1657648142390,MATH 20C,A01,083760,Briones; Jor-el Thomas Caparas,1,0,35,34
1657648142390,MATH 20C,A02,083761,Briones; Jor-el Thomas Caparas,8,0,35,27
1657648142390,MATH 20C,A03,093476,Briones; Jor-el Thomas Caparas,0,1,36,36
1657648142390,MATH 20C,B01,083762,Bach; Quang Tran,1,0,30,29
1657648148418,MATH 20D,A01,083765,Tran; Brian Kha,5,0,30,25
1657648148418,MATH 20D,A02,083766,Tran; Brian Kha,5,0,30,25
1657648148418,MATH 20D,A03,083767,Tran; Brian Kha,5,0,30,25
1657648154448,MATH 20E,A01,083771,Ganguly; Soumya,9,0,32,23
1657648154448,MATH 20E,A02,083772,Ganguly; Soumya,6,0,32,26
1657648154448,MATH 20E,B01,083773,Ciotti; Benjamin,20,0,35,15
1657648154448,MATH 20E,B02,083774,Ciotti; Benjamin,18,0,35,17
1657648160477,MATH 103A,A01,083777,Greenfeld; Be'Eri,3,0,36,33
1657648160477,MATH 103A,A02,083778,Greenfeld; Be'Eri,5,0,36,31
1657648160477,MATH 103A,A03,093561,Greenfeld; Be'Eri,6,0,36,30
1657648160477,MATH 103A,B01,083779,Greenfeld; Be'Eri,7,0,36,29
1657648160477,MATH 103A,B02,083780,Greenfeld; Be'Eri,4,0,36,32
1657648160477,MATH 103A,B03,093562,Greenfeld; Be'Eri,3,0,36,33
1657648166503,MATH 105,A01,085443,Carter; Anne Toulson,15,0,35,20
1657648166503,MATH 105,A02,093477,Carter; Anne Toulson,20,0,35,15
1657648172536,MATH 109,A01,083213,Ganzberger; Geoffrey Michael,2,0,34,32
1657648172536,MATH 109,A02,083214,Ganzberger; Geoffrey Michael,4,0,34,30
1657648172536,MATH 109,A03,093478,Ganzberger; Geoffrey Michael,2,0,34,32
1657648172536,MATH 109,B01,083215,Ganzberger; Geoffrey Michael,1,0,32,31
1657648172536,MATH 109,B02,083216,Ganzberger; Geoffrey Michael,2,0,32,30
1657648172536,MATH 109,B03,093479,Ganzberger; Geoffrey Michael,8,0,32,24
1657648178559,MATH 142A,A01,083219,Chow; Bennett,7,0,32,25
1657648178559,MATH 142A,A02,083220,Chow; Bennett,10,0,32,22
1657648178559,MATH 142A,A03,093480,Chow; Bennett,9,0,32,23
1657648178559,MATH 142A,B03,093481,Chow; Bennett,8,0,32,24
1657648178559,MATH 142A,B04,093558,Chow; Bennett,13,0,32,19
1657648178559,MATH 142A,B05,093559,Chow; Bennett,6,0,32,26
1657648184599,MATH 193A,A01,083224,Rotar; Vladimir,8,0,34,26
1657648184599,MATH 193A,A02,083225,Rotar; Vladimir,9,0,34,25
1657648184599,MATH 193A,A03,083781,Rotar; Vladimir,5,0,34,29
1657648184599,MATH 193A,A04,083782,Rotar; Vladimir,10,0,34,24
1657648184599,MATH 193A,A05,093482,Rotar; Vladimir,10,0,34,24
1657648190634,MATH 197,001,091859,McAuley; Julian John,9999,0,9999,0
1657648190634,MATH 197,002,095566,Kedlaya; Kiran S.,9997,0,9999,2
1657648190634,MATH 197,003,095567,Xiao; Ming,9999,0,9999,0
1657648190634,MATH 197,004,095571,Perols; Johan Lars,9998,0,9999,1
1657648197688,COGS 9,A01,083615,Shannon; Kyle Michael,9,0,75,66
1657648203711,COGS 11,A01,083617,Boyle; Mary E. T.,23,0,48,25
1657648209734,COGS 13,A01,083071,Bastos; Amalia Pinkusfeld,11,0,71,60
1657648215763,COGS 14A,A01,092681,Semenuks; Arturs,5,1,100,95
1657648221788,COGS 14B,A01,083073,Cheng; Tzu-Han,6,0,63,57
1657648227814,COGS 17,A01,092677,Semenuks; Arturs,6,0,81,75
1657648233841,COGS 100,A01,083619,Allen; Michael Gordon,17,0,70,53
1657648239863,COGS 101A,A01,083621,Davis; Joshua Daniel,9,0,68,59
1657648245894,COGS 101B,A01,091572,Allen; Michael Gordon,12,0,65,53
1657648251919,COGS 101C,A01,083625,Delgado; Tania,17,0,35,18
1657648257944,COGS 107A,A01,083627,Boyle; Mary E. T.,13,0,60,47
1657648263969,COGS 118A,A01,083075,Gupta; Anjum,21,0,76,55
1657648269993,CSE 3,A50,083646,Miranda; Gregory Joseph,24,0,50,26
1657648276018,CSE 8A,A50,083650,Miranda; Gregory Joseph,17,1,56,39
1657648282043,CSE 11,A01,083080,Cao; Yingjun,6,15,40,34
1657648288066,CSE 12,A01,083652,Krause-Levy; Sophia Louisa,28,1,120,92
1657648294098,CSE 15L,A01,083654,Morris; Justin Loren,9,0,50,41
1657648294098,CSE 15L,A02,083655,Morris; Justin Loren,9,0,50,41
1657648300125,CSE 20,A01,083657,Tran; Khoa Dang,39,0,80,41
1657648306156,CSE 21,A01,095574,Bach; Quang Tran,22,0,48,26
1657648312187,CSE 30,A01,083084,Eldon; John,6,0,80,74
1657648312187,CSE 30,B01,095061,Bhaskar; Nishant,9,0,50,41
1657648318315,CSE 100,A01,083659,Cao; Yingjun,5,4,70,65
1657648324345,CSE 134B,A01,083661,Powell; Thomas Allan,23,0,100,77
1657648330371,CSE 140,A01,083663,Gungor; Onat,15,0,85,70
1657648336398,CSE 140L,A01,083088,Eldon; John,21,0,100,79
1657648342422,CSE 175,A01,083665,Kumar; Rakesh,3,0,25,22
1657648348451,CSE 190,A00,092507,Dubnov; Shlomo,8,0,20,12
1657648354479,ECE 45,A01,083139,Congero; Spencer William,6,0,75,69
1657648360504,ECE 65,A50,083695,Saad; Andrew S,12,0,30,18
1657648360504,ECE 65,A51,095125,Saad; Andrew S,24,0,26,2
1657648366529,ECE 109,A01,091882,Touri; Behrouz,19,0,70,51
1657648372554,ECE 180,A00,083140,Abi Samra; Nicholas Camill,1,0,30,29
1657648372554,ECE 180,B00,083141,Abi Samra; Nicholas Camill,0,0,30,30
1657648378576,MATH 10A,A01,083735,Patchell; Gregory David,2,0,30,28
1657648378576,MATH 10A,A02,083736,Patchell; Gregory David,20,0,30,10
1657648378576,MATH 10A,A03,083737,Patchell; Gregory David,16,0,30,14
1657648384598,MATH 10B,A01,083207,Lim; Seonhee,8,0,34,26
1657648384598,MATH 10B,A02,083208,Lim; Seonhee,9,0,35,26
1657648384598,MATH 10B,A03,093472,Lim; Seonhee,7,0,34,27
1657648384598,MATH 10B,B01,083739,Sinha; Shubham,12,0,30,18
1657648398373,MATH 18,A01,083743,Cinel; Cameron Alexander,7,0,30,23
1657648398373,MATH 18,A02,083744,Cinel; Cameron Alexander,17,0,30,13
1657648398373,MATH 18,A03,083745,Cinel; Cameron Alexander,9,0,30,21
1657648398373,MATH 18,B01,083748,Rideout; David Porter,5,0,37,32
1657648398373,MATH 18,B02,083749,Rideout; David Porter,5,0,36,31
1657648398373,MATH 18,B03,083750,Rideout; David Porter,3,0,37,34
1657648398373,MATH 18,B04,083751,Rideout; David Porter,6,0,36,30
1657648398373,MATH 18,B05,093473,Rideout; David Porter,6,0,36,30
1657648398373,MATH 18,B06,093474,Rideout; David Porter,6,0,36,30
1657648404399,MATH 20A,A01,083754,Zheng; Zequn,14,0,40,26
1657648410435,MATH 20B,A01,083756,Briones; Jor-el Thomas Caparas,4,0,36,32
1657648410435,MATH 20B,A02,083757,Briones; Jor-el Thomas Caparas,1,0,36,35
1657648410435,MATH 20B,A03,093475,Briones; Jor-el Thomas Caparas,2,0,36,34
1657648416465,MATH 20C,A01,083760,Briones; Jor-el Thomas Caparas,1,0,35,34
1657648416465,MATH 20C,A02,083761,Briones; Jor-el Thomas Caparas,8,0,35,27
1657648416465,MATH 20C,A03,093476,Briones; Jor-el Thomas Caparas,0,1,36,36
1657648416465,MATH 20C,B01,083762,Bach; Quang Tran,1,0,30,29
1657648422494,MATH 20D,A01,083765,Tran; Brian Kha,5,0,30,25
1657648422494,MATH 20D,A02,083766,Tran; Brian Kha,5,0,30,25
1657648422494,MATH 20D,A03,083767,Tran; Brian Kha,5,0,30,25
1657648428519,MATH 20E,A01,083771,Ganguly; Soumya,9,0,32,23
1657648428519,MATH 20E,A02,083772,Ganguly; Soumya,6,0,32,26
1657648428519,MATH 20E,B01,083773,Ciotti; Benjamin,20,0,35,15
1657648428519,MATH 20E,B02,083774,Ciotti; Benjamin,18,0,35,17
1657648434548,MATH 103A,A01,083777,Greenfeld; Be'Eri,3,0,36,33
1657648434548,MATH 103A,A02,083778,Greenfeld; Be'Eri,5,0,36,31
1657648434548,MATH 103A,A03,093561,Greenfeld; Be'Eri,6,0,36,30
1657648434548,MATH 103A,B01,083779,Greenfeld; Be'Eri,7,0,36,29
1657648434548,MATH 103A,B02,083780,Greenfeld; Be'Eri,4,0,36,32
1657648434548,MATH 103A,B03,093562,Greenfeld; Be'Eri,3,0,36,33
1657648440579,MATH 105,A01,085443,Carter; Anne Toulson,15,0,35,20
1657648440579,MATH 105,A02,093477,Carter; Anne Toulson,20,0,35,15
1657648446608,MATH 109,A01,083213,Ganzberger; Geoffrey Michael,2,0,34,32
1657648446608,MATH 109,A02,083214,Ganzberger; Geoffrey Michael,4,0,34,30
1657648446608,MATH 109,A03,093478,Ganzberger; Geoffrey Michael,2,0,34,32
1657648446608,MATH 109,B01,083215,Ganzberger; Geoffrey Michael,1,0,32,31
1657648446608,MATH 109,B02,083216,Ganzberger; Geoffrey Michael,2,0,32,30
1657648446608,MATH 109,B03,093479,Ganzberger; Geoffrey Michael,8,0,32,24
1657648452638,MATH 142A,A01,083219,Chow; Bennett,7,0,32,25
1657648452638,MATH 142A,A02,083220,Chow; Bennett,10,0,32,22
1657648452638,MATH 142A,A03,093480,Chow; Bennett,9,0,32,23
1657648452638,MATH 142A,B03,093481,Chow; Bennett,8,0,32,24
1657648452638,MATH 142A,B04,093558,Chow; Bennett,13,0,32,19
1657648452638,MATH 142A,B05,093559,Chow; Bennett,6,0,32,26
1657648458663,MATH 193A,A01,083224,Rotar; Vladimir,8,0,34,26
1657648458663,MATH 193A,A02,083225,Rotar; Vladimir,9,0,34,25
1657648458663,MATH 193A,A03,083781,Rotar; Vladimir,5,0,34,29
1657648458663,MATH 193A,A04,083782,Rotar; Vladimir,10,0,34,24
1657648458663,MATH 193A,A05,093482,Rotar; Vladimir,10,0,34,24
1657648464688,MATH 197,001,091859,McAuley; Julian John,9999,0,9999,0
1657648464688,MATH 197,002,095566,Kedlaya; Kiran S.,9997,0,9999,2
1657648464688,MATH 197,003,095567,Xiao; Ming,9999,0,9999,0
1657648464688,MATH 197,004,095571,Perols; Johan Lars,9998,0,9999,1
1657648471741,COGS 9,A01,083615,Shannon; Kyle Michael,9,0,75,66
1657648477766,COGS 11,A01,083617,Boyle; Mary E. T.,23,0,48,25
1657648483788,COGS 13,A01,083071,Bastos; Amalia Pinkusfeld,11,0,71,60
1657648489810,COGS 14A,A01,092681,Semenuks; Arturs,5,1,100,95
1657648495831,COGS 14B,A01,083073,Cheng; Tzu-Han,6,0,63,57
1657648501858,COGS 17,A01,092677,Semenuks; Arturs,6,0,81,75
1657648507883,COGS 100,A01,083619,Allen; Michael Gordon,17,0,70,53
1657648513906,COGS 101A,A01,083621,Davis; Joshua Daniel,9,0,68,59
1657648519937,COGS 101B,A01,091572,Allen; Michael Gordon,12,0,65,53
1657648525961,COGS 101C,A01,083625,Delgado; Tania,17,0,35,18
1657648531997,COGS 107A,A01,083627,Boyle; Mary E. T.,13,0,60,47
1657648538028,COGS 118A,A01,083075,Gupta; Anjum,21,0,76,55
1657648544070,CSE 3,A50,083646,Miranda; Gregory Joseph,24,0,50,26
1657648550097,CSE 8A,A50,083650,Miranda; Gregory Joseph,17,1,56,39
1657648556122,CSE 11,A01,083080,Cao; Yingjun,6,15,40,34
1657648562144,CSE 12,A01,083652,Krause-Levy; Sophia Louisa,28,1,120,92
1657648568168,CSE 15L,A01,083654,Morris; Justin Loren,9,0,50,41
1657648568168,CSE 15L,A02,083655,Morris; Justin Loren,9,0,50,41
1657648574197,CSE 20,A01,083657,Tran; Khoa Dang,39,0,80,41
1657648580227,CSE 21,A01,095574,Bach; Quang Tran,22,0,48,26
1657648586265,CSE 30,A01,083084,Eldon; John,6,0,80,74
1657648586265,CSE 30,B01,095061,Bhaskar; Nishant,9,0,50,41
1657648592295,CSE 100,A01,083659,Cao; Yingjun,5,4,70,65
1657648598320,CSE 134B,A01,083661,Powell; Thomas Allan,23,0,100,77
1657648604354,CSE 140,A01,083663,Gungor; Onat,15,0,85,70
1657648610377,CSE 140L,A01,083088,Eldon; John,21,0,100,79
1657648616399,CSE 175,A01,083665,Kumar; Rakesh,3,0,25,22
1657648622437,CSE 190,A00,092507,Dubnov; Shlomo,8,0,20,12
1657648628466,ECE 45,A01,083139,Congero; Spencer William,6,0,75,69
1657648634492,ECE 65,A50,083695,Saad; Andrew S,12,0,30,18
1657648634492,ECE 65,A51,095125,Saad; Andrew S,24,0,26,2
1657648640516,ECE 109,A01,091882,Touri; Behrouz,19,0,70,51
1657648646549,ECE 180,A00,083140,Abi Samra; Nicholas Camill,1,0,30,29
1657648646549,ECE 180,B00,083141,Abi Samra; Nicholas Camill,0,0,30,30
1657648652571,MATH 10A,A01,083735,Patchell; Gregory David,2,0,30,28
1657648652571,MATH 10A,A02,083736,Patchell; Gregory David,20,0,30,10
1657648652571,MATH 10A,A03,083737,Patchell; Gregory David,16,0,30,14
1657648658594,MATH 10B,A01,083207,Lim; Seonhee,8,0,34,26
1657648658594,MATH 10B,A02,083208,Lim; Seonhee,9,0,35,26
1657648658594,MATH 10B,A03,093472,Lim; Seonhee,7,0,34,27
1657648658594,MATH 10B,B01,083739,Sinha; Shubham,12,0,30,18
1657648664617,MATH 18,A01,083743,Cinel; Cameron Alexander,7,0,30,23
1657648664617,MATH 18,A02,083744,Cinel; Cameron Alexander,17,0,30,13
1657648664617,MATH 18,A03,083745,Cinel; Cameron Alexander,10,0,30,20
1657648664617,MATH 18,B01,083748,Rideout; David Porter,5,0,37,32
1657648664617,MATH 18,B02,083749,Rideout; David Porter,5,0,36,31
1657648664617,MATH 18,B03,083750,Rideout; David Porter,3,0,37,34
1657648664617,MATH 18,B04,083751,Rideout; David Porter,6,0,36,30
1657648664617,MATH 18,B05,093473,Rideout; David Porter,6,0,36,30
1657648664617,MATH 18,B06,093474,Rideout; David Porter,6,0,36,30
1657648670640,MATH 20A,A01,083754,Zheng; Zequn,14,0,40,26
1657648676667,MATH 20B,A01,083756,Briones; Jor-el Thomas Caparas,4,0,36,32
1657648676667,MATH 20B,A02,083757,Briones; Jor-el Thomas Caparas,1,0,36,35
1657648676667,MATH 20B,A03,093475,Briones; Jor-el Thomas Caparas,2,0,36,34
1657648682699,MATH 20C,A01,083760,Briones; Jor-el Thomas Caparas,1,0,35,34
1657648682699,MATH 20C,A02,083761,Briones; Jor-el Thomas Caparas,8,0,35,27
1657648682699,MATH 20C,A03,093476,Briones; Jor-el Thomas Caparas,0,1,36,36
1657648682699,MATH 20C,B01,083762,Bach; Quang Tran,1,0,30,29
1657648688726,MATH 20D,A01,083765,Tran; Brian Kha,5,0,30,25
1657648688726,MATH 20D,A02,083766,Tran; Brian Kha,5,0,30,25
1657648688726,MATH 20D,A03,083767,Tran; Brian Kha,5,0,30,25
1657648694759,MATH 20E,A01,083771,Ganguly; Soumya,9,0,32,23
1657648694759,MATH 20E,A02,083772,Ganguly; Soumya,6,0,32,26
1657648694759,MATH 20E,B01,083773,Ciotti; Benjamin,20,0,35,15
1657648694759,MATH 20E,B02,083774,Ciotti; Benjamin,18,0,35,17
1657648700783,MATH 103A,A01,083777,Greenfeld; Be'Eri,3,0,36,33
1657648700783,MATH 103A,A02,083778,Greenfeld; Be'Eri,5,0,36,31
1657648700783,MATH 103A,A03,093561,Greenfeld; Be'Eri,6,0,36,30
1657648700783,MATH 103A,B01,083779,Greenfeld; Be'Eri,7,0,36,29
1657648700783,MATH 103A,B02,083780,Greenfeld; Be'Eri,4,0,36,32
1657648700783,MATH 103A,B03,093562,Greenfeld; Be'Eri,3,0,36,33
1657648706811,MATH 105,A01,085443,Carter; Anne Toulson,15,0,35,20
1657648706811,MATH 105,A02,093477,Carter; Anne Toulson,20,0,35,15
1657648712838,MATH 109,A01,083213,Ganzberger; Geoffrey Michael,2,0,34,32
1657648712838,MATH 109,A02,083214,Ganzberger; Geoffrey Michael,4,0,34,30
1657648712838,MATH 109,A03,093478,Ganzberger; Geoffrey Michael,2,0,34,32
1657648712838,MATH 109,B01,083215,Ganzberger; Geoffrey Michael,1,0,32,31
1657648712838,MATH 109,B02,083216,Ganzberger; Geoffrey Michael,2,0,32,30
1657648712838,MATH 109,B03,093479,Ganzberger; Geoffrey Michael,8,0,32,24
1657648718869,MATH 142A,A01,083219,Chow; Bennett,7,0,32,25
1657648718869,MATH 142A,A02,083220,Chow; Bennett,10,0,32,22
1657648718869,MATH 142A,A03,093480,Chow; Bennett,9,0,32,23
1657648718869,MATH 142A,B03,093481,Chow; Bennett,8,0,32,24
1657648718869,MATH 142A,B04,093558,Chow; Bennett,13,0,32,19
1657648718869,MATH 142A,B05,093559,Chow; Bennett,6,0,32,26
1657648724892,MATH 193A,A01,083224,Rotar; Vladimir,8,0,34,26
1657648724892,MATH 193A,A02,083225,Rotar; Vladimir,9,0,34,25
1657648724892,MATH 193A,A03,083781,Rotar; Vladimir,5,0,34,29
1657648724892,MATH 193A,A04,083782,Rotar; Vladimir,10,0,34,24
1657648724892,MATH 193A,A05,093482,Rotar; Vladimir,10,0,34,24
1657648730916,MATH 197,001,091859,McAuley; Julian John,9999,0,9999,0
1657648730916,MATH 197,002,095566,Kedlaya; Kiran S.,9997,0,9999,2
1657648730916,MATH 197,003,095567,Xiao; Ming,9999,0,9999,0
1657648730916,MATH 197,004,095571,Perols; Johan Lars,9998,0,9999,1
1657648737989,COGS 9,A01,083615,Shannon; Kyle Michael,9,0,75,66
1657648744014,COGS 11,A01,083617,Boyle; Mary E. T.,23,0,48,25
1657648750049,COGS 13,A01,083071,Bastos; Amalia Pinkusfeld,11,0,71,60
1657648756076,COGS 14A,A01,092681,Semenuks; Arturs,5,1,100,95
1657648762101,COGS 14B,A01,083073,Cheng; Tzu-Han,6,0,63,57
1657648768123,COGS 17,A01,092677,Semenuks; Arturs,6,0,81,75
1657648774167,COGS 100,A01,083619,Allen; Michael Gordon,17,0,70,53
1657648780195,COGS 101A,A01,083621,Davis; Joshua Daniel,9,0,68,59
1657648786218,COGS 101B,A01,091572,Allen; Michael Gordon,12,0,65,53
1657648792255,COGS 101C,A01,083625,Delgado; Tania,17,0,35,18
1657648798278,COGS 107A,A01,083627,Boyle; Mary E. T.,13,0,60,47
1657648804302,COGS 118A,A01,083075,Gupta; Anjum,21,0,76,55
1657648810324,CSE 3,A50,083646,Miranda; Gregory Joseph,24,0,50,26
1657648816362,CSE 8A,A50,083650,Miranda; Gregory Joseph,17,1,56,39
1657648822393,CSE 11,A01,083080,Cao; Yingjun,6,15,40,34
1657648828415,CSE 12,A01,083652,Krause-Levy; Sophia Louisa,28,1,120,92
1657648834439,CSE 15L,A01,083654,Morris; Justin Loren,9,0,50,41
1657648834439,CSE 15L,A02,083655,Morris; Justin Loren,9,0,50,41
1657648840460,CSE 20,A01,083657,Tran; Khoa Dang,39,0,80,41
1657648846487,CSE 21,A01,095574,Bach; Quang Tran,22,0,48,26
1657648852512,CSE 30,A01,083084,Eldon; John,6,0,80,74
1657648852512,CSE 30,B01,095061,Bhaskar; Nishant,9,0,50,41
1657648858535,CSE 100,A01,083659,Cao; Yingjun,5,4,70,65
1657648864557,CSE 134B,A01,083661,Powell; Thomas Allan,23,0,100,77
1657648870584,CSE 140,A01,083663,Gungor; Onat,15,0,85,70
1657648876620,CSE 140L,A01,083088,Eldon; John,21,0,100,79
1657648882642,CSE 175,A01,083665,Kumar; Rakesh,3,0,25,22
1657648888664,CSE 190,A00,092507,Dubnov; Shlomo,8,0,20,12
1657648894686,ECE 45,A01,083139,Congero; Spencer William,6,0,75,69
1657648900709,ECE 65,A50,083695,Saad; Andrew S,12,0,30,18
1657648900709,ECE 65,A51,095125,Saad; Andrew S,24,0,26,2
1657648906744,ECE 109,A01,091882,Touri; Behrouz,19,0,70,51
1657648912777,ECE 180,A00,083140,Abi Samra; Nicholas Camill,1,0,30,29
1657648912777,ECE 180,B00,083141,Abi Samra; Nicholas Camill,0,0,30,30
1657648918803,MATH 10A,A01,083735,Patchell; Gregory David,2,0,30,28
1657648918803,MATH 10A,A02,083736,Patchell; Gregory David,20,0,30,10
1657648918803,MATH 10A,A03,083737,Patchell; Gregory David,16,0,30,14
1657648924904,MATH 10B,A01,083207,Lim; Seonhee,8,0,34,26
1657648924904,MATH 10B,A02,083208,Lim; Seonhee,9,0,35,26
1657648924904,MATH 10B,A03,093472,Lim; Seonhee,7,0,34,27
1657648924904,MATH 10B,B01,083739,Sinha; Shubham,12,0,30,18
1657648930942,MATH 18,A01,083743,Cinel; Cameron Alexander,7,0,30,23
1657648930942,MATH 18,A02,083744,Cinel; Cameron Alexander,17,0,30,13
1657648930942,MATH 18,A03,083745,Cinel; Cameron Alexander,10,0,30,20
1657648930942,MATH 18,B01,083748,Rideout; David Porter,5,0,37,32
1657648930942,MATH 18,B02,083749,Rideout; David Porter,5,0,36,31
1657648930942,MATH 18,B03,083750,Rideout; David Porter,3,0,37,34
1657648930942,MATH 18,B04,083751,Rideout; David Porter,6,0,36,30
1657648930942,MATH 18,B05,093473,Rideout; David Porter,6,0,36,30
1657648930942,MATH 18,B06,093474,Rideout; David Porter,6,0,36,30
1657648936964,MATH 20A,A01,083754,Zheng; Zequn,14,0,40,26
1657648943009,MATH 20B,A01,083756,Briones; Jor-el Thomas Caparas,4,0,36,32
1657648943009,MATH 20B,A02,083757,Briones; Jor-el Thomas Caparas,1,0,36,35
1657648943009,MATH 20B,A03,093475,Briones; Jor-el Thomas Caparas,2,0,36,34
1657648949044,MATH 20C,A01,083760,Briones; Jor-el Thomas Caparas,1,0,35,34
1657648949044,MATH 20C,A02,083761,Briones; Jor-el Thomas Caparas,8,0,35,27
1657648949044,MATH 20C,A03,093476,Briones; Jor-el Thomas Caparas,0,1,36,36
1657648949044,MATH 20C,B01,083762,Bach; Quang Tran,1,0,30,29
1657648955069,MATH 20D,A01,083765,Tran; Brian Kha,5,0,30,25
1657648955069,MATH 20D,A02,083766,Tran; Brian Kha,5,0,30,25
1657648955069,MATH 20D,A03,083767,Tran; Brian Kha,5,0,30,25
1657648961106,MATH 20E,A01,083771,Ganguly; Soumya,9,0,32,23
1657648961106,MATH 20E,A02,083772,Ganguly; Soumya,6,0,32,26
1657648961106,MATH 20E,B01,083773,Ciotti; Benjamin,20,0,35,15
1657648961106,MATH 20E,B02,083774,Ciotti; Benjamin,18,0,35,17
1657648967130,MATH 103A,A01,083777,Greenfeld; Be'Eri,3,0,36,33
1657648967130,MATH 103A,A02,083778,Greenfeld; Be'Eri,5,0,36,31
1657648967130,MATH 103A,A03,093561,Greenfeld; Be'Eri,6,0,36,30
1657648967130,MATH 103A,B01,083779,Greenfeld; Be'Eri,7,0,36,29
1657648967130,MATH 103A,B02,083780,Greenfeld; Be'Eri,4,0,36,32
1657648967130,MATH 103A,B03,093562,Greenfeld; Be'Eri,3,0,36,33
1657648973153,MATH 105,A01,085443,Carter; Anne Toulson,15,0,35,20
1657648973153,MATH 105,A02,093477,Carter; Anne Toulson,20,0,35,15
1657648979181,MATH 109,A01,083213,Ganzberger; Geoffrey Michael,2,0,34,32
1657648979181,MATH 109,A02,083214,Ganzberger; Geoffrey Michael,4,0,34,30
1657648979181,MATH 109,A03,093478,Ganzberger; Geoffrey Michael,2,0,34,32
1657648979181,MATH 109,B01,083215,Ganzberger; Geoffrey Michael,1,0,32,31
1657648979181,MATH 109,B02,083216,Ganzberger; Geoffrey Michael,2,0,32,30
1657648979181,MATH 109,B03,093479,Ganzberger; Geoffrey Michael,8,0,32,24
1657648985205,MATH 142A,A01,083219,Chow; Bennett,7,0,32,25
1657648985205,MATH 142A,A02,083220,Chow; Bennett,10,0,32,22
1657648985205,MATH 142A,A03,093480,Chow; Bennett,9,0,32,23
1657648985205,MATH 142A,B03,093481,Chow; Bennett,8,0,32,24
1657648985205,MATH 142A,B04,093558,Chow; Bennett,13,0,32,19
1657648985205,MATH 142A,B05,093559,Chow; Bennett,6,0,32,26
1657648991241,MATH 193A,A01,083224,Rotar; Vladimir,8,0,34,26
1657648991241,MATH 193A,A02,083225,Rotar; Vladimir,9,0,34,25
1657648991241,MATH 193A,A03,083781,Rotar; Vladimir,5,0,34,29
1657648991241,MATH 193A,A04,083782,Rotar; Vladimir,10,0,34,24
1657648991241,MATH 193A,A05,093482,Rotar; Vladimir,10,0,34,24
1657648997262,MATH 197,001,091859,McAuley; Julian John,9999,0,9999,0
1657648997262,MATH 197,002,095566,Kedlaya; Kiran S.,9997,0,9999,2
1657648997262,MATH 197,003,095567,Xiao; Ming,9999,0,9999,0
1657648997262,MATH 197,004,095571,Perols; Johan Lars,9998,0,9999,1
1657649004330,COGS 9,A01,083615,Shannon; Kyle Michael,9,0,75,66
1657649010357,COGS 11,A01,083617,Boyle; Mary E. T.,23,0,48,25
1657649016381,COGS 13,A01,083071,Bastos; Amalia Pinkusfeld,11,0,71,60
1657649022404,COGS 14A,A01,092681,Semenuks; Arturs,5,1,100,95
1657649028437,COGS 14B,A01,083073,Cheng; Tzu-Han,6,0,63,57
1657649034461,COGS 17,A01,092677,Semenuks; Arturs,6,0,81,75
1657649040486,COGS 100,A01,083619,Allen; Michael Gordon,17,0,70,53
1657649046514,COGS 101A,A01,083621,Davis; Joshua Daniel,9,0,68,59
1657649052540,COGS 101B,A01,091572,Allen; Michael Gordon,12,0,65,53
1657649058562,COGS 101C,A01,083625,Delgado; Tania,17,0,35,18
1657649064589,COGS 107A,A01,083627,Boyle; Mary E. T.,13,0,60,47
1657649070615,COGS 118A,A01,083075,Gupta; Anjum,21,0,76,55
1657649076638,CSE 3,A50,083646,Miranda; Gregory Joseph,24,0,50,26
1657649082667,CSE 8A,A50,083650,Miranda; Gregory Joseph,17,1,56,39
1657649088705,CSE 11,A01,083080,Cao; Yingjun,6,15,40,34
1657649094743,CSE 12,A01,083652,Krause-Levy; Sophia Louisa,28,1,120,92
1657649100769,CSE 15L,A01,083654,Morris; Justin Loren,9,0,50,41
1657649100769,CSE 15L,A02,083655,Morris; Justin Loren,9,0,50,41
1657649107383,CSE 20,A01,083657,Tran; Khoa Dang,39,0,80,41
1657649113407,CSE 21,A01,095574,Bach; Quang Tran,22,0,48,26
1657649119434,CSE 30,A01,083084,Eldon; John,6,0,80,74
1657649119434,CSE 30,B01,095061,Bhaskar; Nishant,9,0,50,41
1657649125460,CSE 100,A01,083659,Cao; Yingjun,5,4,70,65
1657649131487,CSE 134B,A01,083661,Powell; Thomas Allan,23,0,100,77
1657649137515,CSE 140,A01,083663,Gungor; Onat,15,0,85,70
1657649143544,CSE 140L,A01,083088,Eldon; John,21,0,100,79
1657649149575,CSE 175,A01,083665,Kumar; Rakesh,3,0,25,22
1657649155597,CSE 190,A00,092507,Dubnov; Shlomo,8,0,20,12
1657649161625,ECE 45,A01,083139,Congero; Spencer William,6,0,75,69
1657649167648,ECE 65,A50,083695,Saad; Andrew S,12,0,30,18
1657649167648,ECE 65,A51,095125,Saad; Andrew S,24,0,26,2
1657649173671,ECE 109,A01,091882,Touri; Behrouz,19,0,70,51
1657649179694,ECE 180,A00,083140,Abi Samra; Nicholas Camill,1,0,30,29
1657649179694,ECE 180,B00,083141,Abi Samra; Nicholas Camill,0,0,30,30
1657649185733,MATH 10A,A01,083735,Patchell; Gregory David,2,0,30,28
1657649185733,MATH 10A,A02,083736,Patchell; Gregory David,20,0,30,10
1657649185733,MATH 10A,A03,083737,Patchell; Gregory David,16,0,30,14
1657649191756,MATH 10B,A01,083207,Lim; Seonhee,8,0,34,26
1657649191756,MATH 10B,A02,083208,Lim; Seonhee,9,0,35,26
1657649191756,MATH 10B,A03,093472,Lim; Seonhee,7,0,34,27
1657649191756,MATH 10B,B01,083739,Sinha; Shubham,12,0,30,18
1657649197780,MATH 18,A01,083743,Cinel; Cameron Alexander,7,0,30,23
1657649197780,MATH 18,A02,083744,Cinel; Cameron Alexander,17,0,30,13
1657649197780,MATH 18,A03,083745,Cinel; Cameron Alexander,10,0,30,20
1657649197780,MATH 18,B01,083748,Rideout; David Porter,5,0,37,32
1657649197780,MATH 18,B02,083749,Rideout; David Porter,5,0,36,31
1657649197780,MATH 18,B03,083750,Rideout; David Porter,3,0,37,34
1657649197780,MATH 18,B04,083751,Rideout; David Porter,6,0,36,30
1657649197780,MATH 18,B05,093473,Rideout; David Porter,6,0,36,30
1657649197780,MATH 18,B06,093474,Rideout; David Porter,6,0,36,30
1657649203809,MATH 20A,A01,083754,Zheng; Zequn,14,0,40,26
1657649209836,MATH 20B,A01,083756,Briones; Jor-el Thomas Caparas,4,0,36,32
1657649209836,MATH 20B,A02,083757,Briones; Jor-el Thomas Caparas,1,0,36,35
1657649209836,MATH 20B,A03,093475,Briones; Jor-el Thomas Caparas,2,0,36,34
1657649215859,MATH 20C,A01,083760,Briones; Jor-el Thomas Caparas,1,0,35,34
1657649215859,MATH 20C,A02,083761,Briones; Jor-el Thomas Caparas,8,0,35,27
1657649215859,MATH 20C,A03,093476,Briones; Jor-el Thomas Caparas,0,1,36,36
1657649215859,MATH 20C,B01,083762,Bach; Quang Tran,1,0,30,29
1657649221887,MATH 20D,A01,083765,Tran; Brian Kha,5,0,30,25
1657649221887,MATH 20D,A02,083766,Tran; Brian Kha,5,0,30,25
1657649221887,MATH 20D,A03,083767,Tran; Brian Kha,5,0,30,25
1657649227922,MATH 20E,A01,083771,Ganguly; Soumya,9,0,32,23
1657649227922,MATH 20E,A02,083772,Ganguly; Soumya,6,0,32,26
1657649227922,MATH 20E,B01,083773,Ciotti; Benjamin,20,0,35,15
1657649227922,MATH 20E,B02,083774,Ciotti; Benjamin,18,0,35,17
1657649233945,MATH 103A,A01,083777,Greenfeld; Be'Eri,3,0,36,33
1657649233945,MATH 103A,A02,083778,Greenfeld; Be'Eri,5,0,36,31
1657649233945,MATH 103A,A03,093561,Greenfeld; Be'Eri,6,0,36,30
1657649233945,MATH 103A,B01,083779,Greenfeld; Be'Eri,7,0,36,29
1657649233945,MATH 103A,B02,083780,Greenfeld; Be'Eri,4,0,36,32
1657649233945,MATH 103A,B03,093562,Greenfeld; Be'Eri,3,0,36,33
1657649239972,MATH 105,A01,085443,Carter; Anne Toulson,15,0,35,20
1657649239972,MATH 105,A02,093477,Carter; Anne Toulson,20,0,35,15
1657649245996,MATH 109,A01,083213,Ganzberger; Geoffrey Michael,2,0,34,32
1657649245996,MATH 109,A02,083214,Ganzberger; Geoffrey Michael,4,0,34,30
1657649245996,MATH 109,A03,093478,Ganzberger; Geoffrey Michael,2,0,34,32
1657649245996,MATH 109,B01,083215,Ganzberger; Geoffrey Michael,1,0,32,31
1657649245996,MATH 109,B02,083216,Ganzberger; Geoffrey Michael,2,0,32,30
1657649245996,MATH 109,B03,093479,Ganzberger; Geoffrey Michael,8,0,32,24
1657649252021,MATH 142A,A01,083219,Chow; Bennett,7,0,32,25
1657649252021,MATH 142A,A02,083220,Chow; Bennett,10,0,32,22
1657649252021,MATH 142A,A03,093480,Chow; Bennett,9,0,32,23
1657649252021,MATH 142A,B03,093481,Chow; Bennett,8,0,32,24
1657649252021,MATH 142A,B04,093558,Chow; Bennett,13,0,32,19
1657649252021,MATH 142A,B05,093559,Chow; Bennett,6,0,32,26
1657649258045,MATH 193A,A01,083224,Rotar; Vladimir,8,0,34,26
1657649258045,MATH 193A,A02,083225,Rotar; Vladimir,9,0,34,25
1657649258045,MATH 193A,A03,083781,Rotar; Vladimir,5,0,34,29
1657649258045,MATH 193A,A04,083782,Rotar; Vladimir,10,0,34,24
1657649258045,MATH 193A,A05,093482,Rotar; Vladimir,10,0,34,24
1657649264071,MATH 197,001,091859,McAuley; Julian John,9999,0,9999,0
1657649264071,MATH 197,002,095566,Kedlaya; Kiran S.,9997,0,9999,2
1657649264071,MATH 197,003,095567,Xiao; Ming,9999,0,9999,0
1657649264071,MATH 197,004,095571,Perols; Johan Lars,9998,0,9999,1
1657649271121,COGS 9,A01,083615,Shannon; Kyle Michael,9,0,75,66
1657649277153,COGS 11,A01,083617,Boyle; Mary E. T.,23,0,48,25
1657649283184,COGS 13,A01,083071,Bastos; Amalia Pinkusfeld,11,0,71,60
1657649289206,COGS 14A,A01,092681,Semenuks; Arturs,5,1,100,95
1657649295235,COGS 14B,A01,083073,Cheng; Tzu-Han,6,0,63,57
1657649301262,COGS 17,A01,092677,Semenuks; Arturs,6,0,81,75
1657649307290,COGS 100,A01,083619,Allen; Michael Gordon,17,0,70,53
1657649313314,COGS 101A,A01,083621,Davis; Joshua Daniel,9,0,68,59
1657649319347,COGS 101B,A01,091572,Allen; Michael Gordon,12,0,65,53
1657649325372,COGS 101C,A01,083625,Delgado; Tania,17,0,35,18
1657649331398,COGS 107A,A01,083627,Boyle; Mary E. T.,13,0,60,47
1657649337424,COGS 118A,A01,083075,Gupta; Anjum,21,0,76,55
1657649343446,CSE 3,A50,083646,Miranda; Gregory Joseph,24,0,50,26
1657649349471,CSE 8A,A50,083650,Miranda; Gregory Joseph,17,1,56,39
1657649355493,CSE 11,A01,083080,Cao; Yingjun,6,15,40,34
1657649361523,CSE 12,A01,083652,Krause-Levy; Sophia Louisa,28,1,120,92
1657649367547,CSE 15L,A01,083654,Morris; Justin Loren,9,0,50,41
1657649367547,CSE 15L,A02,083655,Morris; Justin Loren,9,0,50,41
1657649373572,CSE 20,A01,083657,Tran; Khoa Dang,39,0,80,41
1657649379611,CSE 21,A01,095574,Bach; Quang Tran,22,0,48,26
1657649385635,CSE 30,A01,083084,Eldon; John,6,0,80,74
1657649385635,CSE 30,B01,095061,Bhaskar; Nishant,9,0,50,41
1657649391663,CSE 100,A01,083659,Cao; Yingjun,5,4,70,65
1657649397690,CSE 134B,A01,083661,Powell; Thomas Allan,23,0,100,77
1657649403724,CSE 140,A01,083663,Gungor; Onat,15,0,85,70
1657649409751,CSE 140L,A01,083088,Eldon; John,21,0,100,79
1657649415773,CSE 175,A01,083665,Kumar; Rakesh,3,0,25,22
1657649421809,CSE 190,A00,092507,Dubnov; Shlomo,8,0,20,12
1657649427838,ECE 45,A01,083139,Congero; Spencer William,6,0,75,69
1657649433866,ECE 65,A50,083695,Saad; Andrew S,12,0,30,18
1657649433866,ECE 65,A51,095125,Saad; Andrew S,24,0,26,2
1657649439888,ECE 109,A01,091882,Touri; Behrouz,19,0,70,51
1657649445917,ECE 180,A00,083140,Abi Samra; Nicholas Camill,1,0,30,29
1657649445917,ECE 180,B00,083141,Abi Samra; Nicholas Camill,0,0,30,30
1657649451944,MATH 10A,A01,083735,Patchell; Gregory David,2,0,30,28
1657649451944,MATH 10A,A02,083736,Patchell; Gregory David,20,0,30,10
1657649451944,MATH 10A,A03,083737,Patchell; Gregory David,16,0,30,14
1657649457966,MATH 10B,A01,083207,Lim; Seonhee,8,0,34,26
1657649457966,MATH 10B,A02,083208,Lim; Seonhee,9,0,35,26
1657649457966,MATH 10B,A03,093472,Lim; Seonhee,7,0,34,27
1657649457966,MATH 10B,B01,083739,Sinha; Shubham,12,0,30,18
1657649464006,MATH 18,A01,083743,Cinel; Cameron Alexander,7,0,30,23
1657649464006,MATH 18,A02,083744,Cinel; Cameron Alexander,17,0,30,13
1657649464006,MATH 18,A03,083745,Cinel; Cameron Alexander,10,0,30,20
1657649464006,MATH 18,B01,083748,Rideout; David Porter,5,0,37,32
1657649464006,MATH 18,B02,083749,Rideout; David Porter,5,0,36,31
1657649464006,MATH 18,B03,083750,Rideout; David Porter,3,0,37,34
1657649464006,MATH 18,B04,083751,Rideout; David Porter,6,0,36,30
1657649464006,MATH 18,B05,093473,Rideout; David Porter,6,0,36,30
1657649464006,MATH 18,B06,093474,Rideout; David Porter,6,0,36,30
1657649470028,MATH 20A,A01,083754,Zheng; Zequn,14,0,40,26
1657649476056,MATH 20B,A01,083756,Briones; Jor-el Thomas Caparas,4,0,36,32
1657649476056,MATH 20B,A02,083757,Briones; Jor-el Thomas Caparas,1,0,36,35
1657649476056,MATH 20B,A03,093475,Briones; Jor-el Thomas Caparas,2,0,36,34
1657649482084,MATH 20C,A01,083760,Briones; Jor-el Thomas Caparas,1,0,35,34
1657649482084,MATH 20C,A02,083761,Briones; Jor-el Thomas Caparas,8,0,35,27
1657649482084,MATH 20C,A03,093476,Briones; Jor-el Thomas Caparas,0,1,36,36
1657649482084,MATH 20C,B01,083762,Bach; Quang Tran,1,0,30,29
1657649488119,MATH 20D,A01,083765,Tran; Brian Kha,5,0,30,25
1657649488119,MATH 20D,A02,083766,Tran; Brian Kha,5,0,30,25
1657649488119,MATH 20D,A03,083767,Tran; Brian Kha,5,0,30,25
1657649494145,MATH 20E,A01,083771,Ganguly; Soumya,9,0,32,23
1657649494145,MATH 20E,A02,083772,Ganguly; Soumya,6,0,32,26
1657649494145,MATH 20E,B01,083773,Ciotti; Benjamin,20,0,35,15
1657649494145,MATH 20E,B02,083774,Ciotti; Benjamin,18,0,35,17
1657649500168,MATH 103A,A01,083777,Greenfeld; Be'Eri,3,0,36,33
1657649500168,MATH 103A,A02,083778,Greenfeld; Be'Eri,5,0,36,31
1657649500168,MATH 103A,A03,093561,Greenfeld; Be'Eri,6,0,36,30
1657649500168,MATH 103A,B01,083779,Greenfeld; Be'Eri,7,0,36,29
1657649500168,MATH 103A,B02,083780,Greenfeld; Be'Eri,4,0,36,32
1657649500168,MATH 103A,B03,093562,Greenfeld; Be'Eri,3,0,36,33
1657649506193,MATH 105,A01,085443,Carter; Anne Toulson,15,0,35,20
1657649506193,MATH 105,A02,093477,Carter; Anne Toulson,20,0,35,15
1657649512221,MATH 109,A01,083213,Ganzberger; Geoffrey Michael,2,0,34,32
1657649512221,MATH 109,A02,083214,Ganzberger; Geoffrey Michael,4,0,34,30
1657649512221,MATH 109,A03,093478,Ganzberger; Geoffrey Michael,2,0,34,32
1657649512221,MATH 109,B01,083215,Ganzberger; Geoffrey Michael,1,0,32,31
1657649512221,MATH 109,B02,083216,Ganzberger; Geoffrey Michael,2,0,32,30
1657649512221,MATH 109,B03,093479,Ganzberger; Geoffrey Michael,8,0,32,24
1657649518247,MATH 142A,A01,083219,Chow; Bennett,7,0,32,25
1657649518247,MATH 142A,A02,083220,Chow; Bennett,10,0,32,22
1657649518247,MATH 142A,A03,093480,Chow; Bennett,9,0,32,23
1657649518247,MATH 142A,B03,093481,Chow; Bennett,8,0,32,24
1657649518247,MATH 142A,B04,093558,Chow; Bennett,13,0,32,19
1657649518247,MATH 142A,B05,093559,Chow; Bennett,6,0,32,26
1657649524345,MATH 193A,A01,083224,Rotar; Vladimir,8,0,34,26
1657649524345,MATH 193A,A02,083225,Rotar; Vladimir,9,0,34,25
1657649524345,MATH 193A,A03,083781,Rotar; Vladimir,5,0,34,29
1657649524345,MATH 193A,A04,083782,Rotar; Vladimir,10,0,34,24
1657649524345,MATH 193A,A05,093482,Rotar; Vladimir,10,0,34,24
1657649530371,MATH 197,001,091859,McAuley; Julian John,9999,0,9999,0
1657649530371,MATH 197,002,095566,Kedlaya; Kiran S.,9997,0,9999,2
1657649530371,MATH 197,003,095567,Xiao; Ming,9999,0,9999,0
1657649530371,MATH 197,004,095571,Perols; Johan Lars,9998,0,9999,1
1657649537427,COGS 9,A01,083615,Shannon; Kyle Michael,9,0,75,66
1657649543453,COGS 11,A01,083617,Boyle; Mary E. T.,23,0,48,25
1657649549524,COGS 13,A01,083071,Bastos; Amalia Pinkusfeld,11,0,71,60
1657649555546,COGS 14A,A01,092681,Semenuks; Arturs,5,1,100,95
1657649561570,COGS 14B,A01,083073,Cheng; Tzu-Han,6,0,63,57
1657649567597,COGS 17,A01,092677,Semenuks; Arturs,6,0,81,75
1657649573620,COGS 100,A01,083619,Allen; Michael Gordon,17,0,70,53
1657649579647,COGS 101A,A01,083621,Davis; Joshua Daniel,9,0,68,59
1657649585679,COGS 101B,A01,091572,Allen; Michael Gordon,12,0,65,53
1657649591706,COGS 101C,A01,083625,Delgado; Tania,17,0,35,18
1657649597733,COGS 107A,A01,083627,Boyle; Mary E. T.,13,0,60,47
1657649603760,COGS 118A,A01,083075,Gupta; Anjum,21,0,76,55
1657649609784,CSE 3,A50,083646,Miranda; Gregory Joseph,24,0,50,26
1657649615806,CSE 8A,A50,083650,Miranda; Gregory Joseph,17,1,56,39
1657649621830,CSE 11,A01,083080,Cao; Yingjun,6,15,40,34
1657649627852,CSE 12,A01,083652,Krause-Levy; Sophia Louisa,28,1,120,92
1657649633882,CSE 15L,A01,083654,Morris; Justin Loren,9,0,50,41
1657649633882,CSE 15L,A02,083655,Morris; Justin Loren,9,0,50,41
1657649639912,CSE 20,A01,083657,Tran; Khoa Dang,39,0,80,41
1657649645934,CSE 21,A01,095574,Bach; Quang Tran,22,0,48,26
1657649651961,CSE 30,A01,083084,Eldon; John,6,0,80,74
1657649651961,CSE 30,B01,095061,Bhaskar; Nishant,9,0,50,41
1657649657986,CSE 100,A01,083659,Cao; Yingjun,5,4,70,65
1657649664010,CSE 134B,A01,083661,Powell; Thomas Allan,23,0,100,77
1657649670034,CSE 140,A01,083663,Gungor; Onat,15,0,85,70
1657649676063,CSE 140L,A01,083088,Eldon; John,21,0,100,79
1657649682096,CSE 175,A01,083665,Kumar; Rakesh,3,0,25,22
1657649688123,CSE 190,A00,092507,Dubnov; Shlomo,8,0,20,12
1657649694147,ECE 45,A01,083139,Congero; Spencer William,6,0,75,69
1657649700170,ECE 65,A50,083695,Saad; Andrew S,12,0,30,18
1657649700170,ECE 65,A51,095125,Saad; Andrew S,24,0,26,2
1657649706194,ECE 109,A01,091882,Touri; Behrouz,19,0,70,51
1657649712217,ECE 180,A00,083140,Abi Samra; Nicholas Camill,1,0,30,29
1657649712217,ECE 180,B00,083141,Abi Samra; Nicholas Camill,0,0,30,30
1657649718255,MATH 10A,A01,083735,Patchell; Gregory David,2,0,30,28
1657649718255,MATH 10A,A02,083736,Patchell; Gregory David,20,0,30,10
1657649718255,MATH 10A,A03,083737,Patchell; Gregory David,16,0,30,14
1657649724280,MATH 10B,A01,083207,Lim; Seonhee,8,0,34,26
1657649724280,MATH 10B,A02,083208,Lim; Seonhee,9,0,35,26
1657649724280,MATH 10B,A03,093472,Lim; Seonhee,7,0,34,27
1657649724280,MATH 10B,B01,083739,Sinha; Shubham,12,0,30,18
1657649730312,MATH 18,A01,083743,Cinel; Cameron Alexander,7,0,30,23
1657649730312,MATH 18,A02,083744,Cinel; Cameron Alexander,17,0,30,13
1657649730312,MATH 18,A03,083745,Cinel; Cameron Alexander,10,0,30,20
1657649730312,MATH 18,B01,083748,Rideout; David Porter,5,0,37,32
1657649730312,MATH 18,B02,083749,Rideout; David Porter,5,0,36,31
1657649730312,MATH 18,B03,083750,Rideout; David Porter,3,0,37,34
1657649730312,MATH 18,B04,083751,Rideout; David Porter,6,0,36,30
1657649730312,MATH 18,B05,093473,Rideout; David Porter,6,0,36,30
1657649730312,MATH 18,B06,093474,Rideout; David Porter,6,0,36,30
1657649736335,MATH 20A,A01,083754,Zheng; Zequn,14,0,40,26
1657649742362,MATH 20B,A01,083756,Briones; Jor-el Thomas Caparas,4,0,36,32
1657649742362,MATH 20B,A02,083757,Briones; Jor-el Thomas Caparas,1,0,36,35
1657649742362,MATH 20B,A03,093475,Briones; Jor-el Thomas Caparas,2,0,36,34
1657649748386,MATH 20C,A01,083760,Briones; Jor-el Thomas Caparas,1,0,35,34
1657649748386,MATH 20C,A02,083761,Briones; Jor-el Thomas Caparas,8,0,35,27
1657649748386,MATH 20C,A03,093476,Briones; Jor-el Thomas Caparas,0,1,36,36
1657649748386,MATH 20C,B01,083762,Bach; Quang Tran,1,0,30,29
1657649754415,MATH 20D,A01,083765,Tran; Brian Kha,5,0,30,25
1657649754415,MATH 20D,A02,083766,Tran; Brian Kha,5,0,30,25
1657649754415,MATH 20D,A03,083767,Tran; Brian Kha,5,0,30,25
1657649760438,MATH 20E,A01,083771,Ganguly; Soumya,9,0,32,23
1657649760438,MATH 20E,A02,083772,Ganguly; Soumya,6,0,32,26
1657649760438,MATH 20E,B01,083773,Ciotti; Benjamin,20,0,35,15
1657649760438,MATH 20E,B02,083774,Ciotti; Benjamin,18,0,35,17
1657649766473,MATH 103A,A01,083777,Greenfeld; Be'Eri,3,0,36,33
1657649766473,MATH 103A,A02,083778,Greenfeld; Be'Eri,5,0,36,31
1657649766473,MATH 103A,A03,093561,Greenfeld; Be'Eri,6,0,36,30
1657649766473,MATH 103A,B01,083779,Greenfeld; Be'Eri,7,0,36,29
1657649766473,MATH 103A,B02,083780,Greenfeld; Be'Eri,4,0,36,32
1657649766473,MATH 103A,B03,093562,Greenfeld; Be'Eri,3,0,36,33
1657649772498,MATH 105,A01,085443,Carter; Anne Toulson,15,0,35,20
1657649772498,MATH 105,A02,093477,Carter; Anne Toulson,20,0,35,15
1657649778534,MATH 109,A01,083213,Ganzberger; Geoffrey Michael,2,0,34,32
1657649778534,MATH 109,A02,083214,Ganzberger; Geoffrey Michael,4,0,34,30
1657649778534,MATH 109,A03,093478,Ganzberger; Geoffrey Michael,2,0,34,32
1657649778534,MATH 109,B01,083215,Ganzberger; Geoffrey Michael,1,0,32,31
1657649778534,MATH 109,B02,083216,Ganzberger; Geoffrey Michael,2,0,32,30
1657649778534,MATH 109,B03,093479,Ganzberger; Geoffrey Michael,8,0,32,24
1657649784563,MATH 142A,A01,083219,Chow; Bennett,7,0,32,25
1657649784563,MATH 142A,A02,083220,Chow; Bennett,10,0,32,22
1657649784563,MATH 142A,A03,093480,Chow; Bennett,9,0,32,23
1657649784563,MATH 142A,B03,093481,Chow; Bennett,8,0,32,24
1657649784563,MATH 142A,B04,093558,Chow; Bennett,13,0,32,19
1657649784563,MATH 142A,B05,093559,Chow; Bennett,6,0,32,26
1657649790585,MATH 193A,A01,083224,Rotar; Vladimir,8,0,34,26
1657649790585,MATH 193A,A02,083225,Rotar; Vladimir,9,0,34,25
1657649790585,MATH 193A,A03,083781,Rotar; Vladimir,5,0,34,29
1657649790585,MATH 193A,A04,083782,Rotar; Vladimir,10,0,34,24
1657649790585,MATH 193A,A05,093482,Rotar; Vladimir,10,0,34,24
1657649796612,MATH 197,001,091859,McAuley; Julian John,9999,0,9999,0
1657649796612,MATH 197,002,095566,Kedlaya; Kiran S.,9997,0,9999,2
1657649796612,MATH 197,003,095567,Xiao; Ming,9999,0,9999,0
1657649796612,MATH 197,004,095571,Perols; Johan Lars,9998,0,9999,1
1657649803669,COGS 9,A01,083615,Shannon; Kyle Michael,9,0,75,66
1657649809694,COGS 11,A01,083617,Boyle; Mary E. T.,23,0,48,25
1657649815723,COGS 13,A01,083071,Bastos; Amalia Pinkusfeld,11,0,71,60
1657649821754,COGS 14A,A01,092681,Semenuks; Arturs,5,1,100,95
1657649827776,COGS 14B,A01,083073,Cheng; Tzu-Han,6,0,63,57
1657649833799,COGS 17,A01,092677,Semenuks; Arturs,6,0,81,75
1657649839830,COGS 100,A01,083619,Allen; Michael Gordon,17,0,70,53
1657649845853,COGS 101A,A01,083621,Davis; Joshua Daniel,9,0,68,59
1657649851885,COGS 101B,A01,091572,Allen; Michael Gordon,12,0,65,53
1657649857907,COGS 101C,A01,083625,Delgado; Tania,17,0,35,18
1657649863931,COGS 107A,A01,083627,Boyle; Mary E. T.,13,0,60,47
1657649869954,COGS 118A,A01,083075,Gupta; Anjum,21,0,76,55
1657649876007,CSE 3,A50,083646,Miranda; Gregory Joseph,24,0,50,26
1657649882038,CSE 8A,A50,083650,Miranda; Gregory Joseph,17,1,56,39
1657649888061,CSE 11,A01,083080,Cao; Yingjun,6,15,40,34
1657649894088,CSE 12,A01,083652,Krause-Levy; Sophia Louisa,28,1,120,92
1657649900118,CSE 15L,A01,083654,Morris; Justin Loren,9,0,50,41
1657649900118,CSE 15L,A02,083655,Morris; Justin Loren,9,0,50,41
1657649906147,CSE 20,A01,083657,Tran; Khoa Dang,39,0,80,41
1657649912170,CSE 21,A01,095574,Bach; Quang Tran,22,0,48,26
1657649918194,CSE 30,A01,083084,Eldon; John,6,0,80,74
1657649918194,CSE 30,B01,095061,Bhaskar; Nishant,9,0,50,41
1657649924218,CSE 100,A01,083659,Cao; Yingjun,5,4,70,65
1657649930248,CSE 134B,A01,083661,Powell; Thomas Allan,23,0,100,77
1657649936275,CSE 140,A01,083663,Gungor; Onat,15,0,85,70
1657649942297,CSE 140L,A01,083088,Eldon; John,21,0,100,79
1657649948332,CSE 175,A01,083665,Kumar; Rakesh,3,0,25,22
1657649954355,CSE 190,A00,092507,Dubnov; Shlomo,8,0,20,12
1657649960382,ECE 45,A01,083139,Congero; Spencer William,6,0,75,69
1657649966410,ECE 65,A50,083695,Saad; Andrew S,12,0,30,18
1657649966410,ECE 65,A51,095125,Saad; Andrew S,24,0,26,2
1657649972433,ECE 109,A01,091882,Touri; Behrouz,19,0,70,51
1657649978456,ECE 180,A00,083140,Abi Samra; Nicholas Camill,1,0,30,29
1657649978456,ECE 180,B00,083141,Abi Samra; Nicholas Camill,0,0,30,30
1657649984480,MATH 10A,A01,083735,Patchell; Gregory David,2,0,30,28
1657649984480,MATH 10A,A02,083736,Patchell; Gregory David,20,0,30,10
1657649984480,MATH 10A,A03,083737,Patchell; Gregory David,16,0,30,14
1657649990508,MATH 10B,A01,083207,Lim; Seonhee,8,0,34,26
1657649990508,MATH 10B,A02,083208,Lim; Seonhee,9,0,35,26
1657649990508,MATH 10B,A03,093472,Lim; Seonhee,7,0,34,27
1657649990508,MATH 10B,B01,083739,Sinha; Shubham,12,0,30,18
1657649996533,MATH 18,A01,083743,Cinel; Cameron Alexander,7,0,30,23
1657649996533,MATH 18,A02,083744,Cinel; Cameron Alexander,17,0,30,13
1657649996533,MATH 18,A03,083745,Cinel; Cameron Alexander,10,0,30,20
1657649996533,MATH 18,B01,083748,Rideout; David Porter,5,0,37,32
1657649996533,MATH 18,B02,083749,Rideout; David Porter,5,0,36,31
1657649996533,MATH 18,B03,083750,Rideout; David Porter,3,0,37,34
1657649996533,MATH 18,B04,083751,Rideout; David Porter,6,0,36,30
1657649996533,MATH 18,B05,093473,Rideout; David Porter,6,0,36,30
1657649996533,MATH 18,B06,093474,Rideout; David Porter,6,0,36,30
1657650002559,MATH 20A,A01,083754,Zheng; Zequn,14,0,40,26
1657650008582,MATH 20B,A01,083756,Briones; Jor-el Thomas Caparas,4,0,36,32
1657650008582,MATH 20B,A02,083757,Briones; Jor-el Thomas Caparas,1,0,36,35
1657650008582,MATH 20B,A03,093475,Briones; Jor-el Thomas Caparas,2,0,36,34
1657650014610,MATH 20C,A01,083760,Briones; Jor-el Thomas Caparas,1,0,35,34
1657650014610,MATH 20C,A02,083761,Briones; Jor-el Thomas Caparas,8,0,35,27
1657650014610,MATH 20C,A03,093476,Briones; Jor-el Thomas Caparas,0,1,36,36
1657650014610,MATH 20C,B01,083762,Bach; Quang Tran,1,0,30,29
1657650020641,MATH 20D,A01,083765,Tran; Brian Kha,5,0,30,25
1657650020641,MATH 20D,A02,083766,Tran; Brian Kha,5,0,30,25
1657650020641,MATH 20D,A03,083767,Tran; Brian Kha,5,0,30,25
1657650026675,MATH 20E,A01,083771,Ganguly; Soumya,9,0,32,23
1657650026675,MATH 20E,A02,083772,Ganguly; Soumya,6,0,32,26
1657650026675,MATH 20E,B01,083773,Ciotti; Benjamin,20,0,35,15
1657650026675,MATH 20E,B02,083774,Ciotti; Benjamin,18,0,35,17
1657650032699,MATH 103A,A01,083777,Greenfeld; Be'Eri,3,0,36,33
1657650032699,MATH 103A,A02,083778,Greenfeld; Be'Eri,5,0,36,31
1657650032699,MATH 103A,A03,093561,Greenfeld; Be'Eri,6,0,36,30
1657650032699,MATH 103A,B01,083779,Greenfeld; Be'Eri,7,0,36,29
1657650032699,MATH 103A,B02,083780,Greenfeld; Be'Eri,4,0,36,32
1657650032699,MATH 103A,B03,093562,Greenfeld; Be'Eri,3,0,36,33
1657650038722,MATH 105,A01,085443,Carter; Anne Toulson,15,0,35,20
1657650038722,MATH 105,A02,093477,Carter; Anne Toulson,20,0,35,15
1657650044754,MATH 109,A01,083213,Ganzberger; Geoffrey Michael,2,0,34,32
1657650044754,MATH 109,A02,083214,Ganzberger; Geoffrey Michael,4,0,34,30
1657650044754,MATH 109,A03,093478,Ganzberger; Geoffrey Michael,2,0,34,32
1657650044754,MATH 109,B01,083215,Ganzberger; Geoffrey Michael,1,0,32,31
1657650044754,MATH 109,B02,083216,Ganzberger; Geoffrey Michael,2,0,32,30
1657650044754,MATH 109,B03,093479,Ganzberger; Geoffrey Michael,8,0,32,24
1657650050793,MATH 142A,A01,083219,Chow; Bennett,7,0,32,25
1657650050793,MATH 142A,A02,083220,Chow; Bennett,10,0,32,22
1657650050793,MATH 142A,A03,093480,Chow; Bennett,9,0,32,23
1657650050793,MATH 142A,B03,093481,Chow; Bennett,8,0,32,24
1657650050793,MATH 142A,B04,093558,Chow; Bennett,13,0,32,19
1657650050793,MATH 142A,B05,093559,Chow; Bennett,6,0,32,26
1657650056826,MATH 193A,A01,083224,Rotar; Vladimir,8,0,34,26
1657650056826,MATH 193A,A02,083225,Rotar; Vladimir,9,0,34,25
1657650056826,MATH 193A,A03,083781,Rotar; Vladimir,5,0,34,29
1657650056826,MATH 193A,A04,083782,Rotar; Vladimir,10,0,34,24
1657650056826,MATH 193A,A05,093482,Rotar; Vladimir,10,0,34,24
1657650062849,MATH 197,001,091859,McAuley; Julian John,9999,0,9999,0
1657650062849,MATH 197,002,095566,Kedlaya; Kiran S.,9997,0,9999,2
1657650062849,MATH 197,003,095567,Xiao; Ming,9999,0,9999,0
1657650062849,MATH 197,004,095571,Perols; Johan Lars,9998,0,9999,1
1657650069911,COGS 9,A01,083615,Shannon; Kyle Michael,9,0,75,66
1657650075941,COGS 11,A01,083617,Boyle; Mary E. T.,23,0,48,25
1657650081963,COGS 13,A01,083071,Bastos; Amalia Pinkusfeld,11,0,71,60
1657650087985,COGS 14A,A01,092681,Semenuks; Arturs,5,1,100,95
1657650094009,COGS 14B,A01,083073,Cheng; Tzu-Han,6,0,63,57
1657650100034,COGS 17,A01,092677,Semenuks; Arturs,6,0,81,75
1657650106066,COGS 100,A01,083619,Allen; Michael Gordon,17,0,70,53
1657650112098,COGS 101A,A01,083621,Davis; Joshua Daniel,9,0,68,59
1657650118217,COGS 101B,A01,091572,Allen; Michael Gordon,12,0,65,53
1657650124244,COGS 101C,A01,083625,Delgado; Tania,17,0,35,18
1657650130268,COGS 107A,A01,083627,Boyle; Mary E. T.,13,0,60,47
1657650136291,COGS 118A,A01,083075,Gupta; Anjum,21,0,76,55
1657650142325,CSE 3,A50,083646,Miranda; Gregory Joseph,24,0,50,26
1657650148348,CSE 8A,A50,083650,Miranda; Gregory Joseph,17,1,56,39
1657650154369,CSE 11,A01,083080,Cao; Yingjun,6,15,40,34
1657650160396,CSE 12,A01,083652,Krause-Levy; Sophia Louisa,28,1,120,92
1657650166419,CSE 15L,A01,083654,Morris; Justin Loren,9,0,50,41
1657650166419,CSE 15L,A02,083655,Morris; Justin Loren,9,0,50,41
1657650172441,CSE 20,A01,083657,Tran; Khoa Dang,39,0,80,41
1657650178468,CSE 21,A01,095574,Bach; Quang Tran,22,0,48,26
1657650184493,CSE 30,A01,083084,Eldon; John,6,0,80,74
1657650184493,CSE 30,B01,095061,Bhaskar; Nishant,9,0,50,41
1657650190519,CSE 100,A01,083659,Cao; Yingjun,5,4,70,65
1657650196546,CSE 134B,A01,083661,Powell; Thomas Allan,23,0,100,77
1657650202576,CSE 140,A01,083663,Gungor; Onat,15,0,85,70
1657650208600,CSE 140L,A01,083088,Eldon; John,21,0,100,79
1657650214624,CSE 175,A01,083665,Kumar; Rakesh,3,0,25,22
1657650220656,CSE 190,A00,092507,Dubnov; Shlomo,8,0,20,12
1657650226679,ECE 45,A01,083139,Congero; Spencer William,6,0,75,69
1657650232705,ECE 65,A50,083695,Saad; Andrew S,12,0,30,18
1657650232705,ECE 65,A51,095125,Saad; Andrew S,24,0,26,2
1657650238727,ECE 109,A01,091882,Touri; Behrouz,19,0,70,51
1657650244752,ECE 180,A00,083140,Abi Samra; Nicholas Camill,1,0,30,29
1657650244752,ECE 180,B00,083141,Abi Samra; Nicholas Camill,0,0,30,30
1657650250776,MATH 10A,A01,083735,Patchell; Gregory David,2,0,30,28
1657650250776,MATH 10A,A02,083736,Patchell; Gregory David,20,0,30,10
1657650250776,MATH 10A,A03,083737,Patchell; Gregory David,16,0,30,14
1657650256799,MATH 10B,A01,083207,Lim; Seonhee,8,0,34,26
1657650256799,MATH 10B,A02,083208,Lim; Seonhee,9,0,35,26
1657650256799,MATH 10B,A03,093472,Lim; Seonhee,7,0,34,27
1657650256799,MATH 10B,B01,083739,Sinha; Shubham,12,0,30,18
1657650262823,MATH 18,A01,083743,Cinel; Cameron Alexander,7,0,30,23
1657650262823,MATH 18,A02,083744,Cinel; Cameron Alexander,17,0,30,13
1657650262823,MATH 18,A03,083745,Cinel; Cameron Alexander,10,0,30,20
1657650262823,MATH 18,B01,083748,Rideout; David Porter,5,0,37,32
1657650262823,MATH 18,B02,083749,Rideout; David Porter,5,0,36,31
1657650262823,MATH 18,B03,083750,Rideout; David Porter,3,0,37,34
1657650262823,MATH 18,B04,083751,Rideout; David Porter,6,0,36,30
1657650262823,MATH 18,B05,093473,Rideout; David Porter,6,0,36,30
1657650262823,MATH 18,B06,093474,Rideout; David Porter,6,0,36,30
1657650268856,MATH 20A,A01,083754,Zheng; Zequn,14,0,40,26
1657650274883,MATH 20B,A01,083756,Briones; Jor-el Thomas Caparas,4,0,36,32
1657650274883,MATH 20B,A02,083757,Briones; Jor-el Thomas Caparas,1,0,36,35
1657650274883,MATH 20B,A03,093475,Briones; Jor-el Thomas Caparas,2,0,36,34
1657650280910,MATH 20C,A01,083760,Briones; Jor-el Thomas Caparas,1,0,35,34
1657650280910,MATH 20C,A02,083761,Briones; Jor-el Thomas Caparas,8,0,35,27
1657650280910,MATH 20C,A03,093476,Briones; Jor-el Thomas Caparas,0,1,36,36
1657650280910,MATH 20C,B01,083762,Bach; Quang Tran,1,0,30,29
1657650286939,MATH 20D,A01,083765,Tran; Brian Kha,5,0,30,25
1657650286939,MATH 20D,A02,083766,Tran; Brian Kha,5,0,30,25
1657650286939,MATH 20D,A03,083767,Tran; Brian Kha,5,0,30,25
1657650292972,MATH 20E,A01,083771,Ganguly; Soumya,9,0,32,23
1657650292972,MATH 20E,A02,083772,Ganguly; Soumya,6,0,32,26
1657650292972,MATH 20E,B01,083773,Ciotti; Benjamin,20,0,35,15
1657650292972,MATH 20E,B02,083774,Ciotti; Benjamin,18,0,35,17
1657650299004,MATH 103A,A01,083777,Greenfeld; Be'Eri,3,0,36,33
1657650299004,MATH 103A,A02,083778,Greenfeld; Be'Eri,5,0,36,31
1657650299004,MATH 103A,A03,093561,Greenfeld; Be'Eri,6,0,36,30
1657650299004,MATH 103A,B01,083779,Greenfeld; Be'Eri,7,0,36,29
1657650299004,MATH 103A,B02,083780,Greenfeld; Be'Eri,4,0,36,32
1657650299004,MATH 103A,B03,093562,Greenfeld; Be'Eri,3,0,36,33
1657650305035,MATH 105,A01,085443,Carter; Anne Toulson,15,0,35,20
1657650305035,MATH 105,A02,093477,Carter; Anne Toulson,20,0,35,15
1657650311064,MATH 109,A01,083213,Ganzberger; Geoffrey Michael,2,0,34,32
1657650311064,MATH 109,A02,083214,Ganzberger; Geoffrey Michael,4,0,34,30
1657650311064,MATH 109,A03,093478,Ganzberger; Geoffrey Michael,2,0,34,32
1657650311064,MATH 109,B01,083215,Ganzberger; Geoffrey Michael,1,0,32,31
1657650311064,MATH 109,B02,083216,Ganzberger; Geoffrey Michael,2,0,32,30
1657650311064,MATH 109,B03,093479,Ganzberger; Geoffrey Michael,8,0,32,24
1657650317090,MATH 142A,A01,083219,Chow; Bennett,7,0,32,25
1657650317090,MATH 142A,A02,083220,Chow; Bennett,10,0,32,22
1657650317090,MATH 142A,A03,093480,Chow; Bennett,9,0,32,23
1657650317090,MATH 142A,B03,093481,Chow; Bennett,8,0,32,24
1657650317090,MATH 142A,B04,093558,Chow; Bennett,13,0,32,19
1657650317090,MATH 142A,B05,093559,Chow; Bennett,6,0,32,26
1657650323114,MATH 193A,A01,083224,Rotar; Vladimir,8,0,34,26
1657650323114,MATH 193A,A02,083225,Rotar; Vladimir,9,0,34,25
1657650323114,MATH 193A,A03,083781,Rotar; Vladimir,5,0,34,29
1657650323114,MATH 193A,A04,083782,Rotar; Vladimir,10,0,34,24
1657650323114,MATH 193A,A05,093482,Rotar; Vladimir,10,0,34,24
1657650329139,MATH 197,001,091859,McAuley; Julian John,9999,0,9999,0
1657650329139,MATH 197,002,095566,Kedlaya; Kiran S.,9997,0,9999,2
1657650329139,MATH 197,003,095567,Xiao; Ming,9999,0,9999,0
1657650329139,MATH 197,004,095571,Perols; Johan Lars,9998,0,9999,1
1657650336193,COGS 9,A01,083615,Shannon; Kyle Michael,9,0,75,66
1657650342221,COGS 11,A01,083617,Boyle; Mary E. T.,23,0,48,25
1657650348249,COGS 13,A01,083071,Bastos; Amalia Pinkusfeld,11,0,71,60
1657650354275,COGS 14A,A01,092681,Semenuks; Arturs,5,1,100,95
1657650360308,COGS 14B,A01,083073,Cheng; Tzu-Han,6,0,63,57
1657650366330,COGS 17,A01,092677,Semenuks; Arturs,6,0,81,75
1657650372362,COGS 100,A01,083619,Allen; Michael Gordon,17,0,70,53
1657650378398,COGS 101A,A01,083621,Davis; Joshua Daniel,9,0,68,59
1657650384424,COGS 101B,A01,091572,Allen; Michael Gordon,12,0,65,53
1657650390459,COGS 101C,A01,083625,Delgado; Tania,17,0,35,18
1657650396483,COGS 107A,A01,083627,Boyle; Mary E. T.,13,0,60,47
1657650402507,COGS 118A,A01,083075,Gupta; Anjum,21,0,76,55
1657650408531,CSE 3,A50,083646,Miranda; Gregory Joseph,24,0,50,26
1657650414565,CSE 8A,A50,083650,Miranda; Gregory Joseph,17,1,56,39
1657650420592,CSE 11,A01,083080,Cao; Yingjun,6,15,40,34
1657650426628,CSE 12,A01,083652,Krause-Levy; Sophia Louisa,28,1,120,92
1657650432653,CSE 15L,A01,083654,Morris; Justin Loren,9,0,50,41
1657650432653,CSE 15L,A02,083655,Morris; Justin Loren,9,0,50,41
1657650438679,CSE 20,A01,083657,Tran; Khoa Dang,39,0,80,41
1657650444701,CSE 21,A01,095574,Bach; Quang Tran,22,0,48,26
1657650450729,CSE 30,A01,083084,Eldon; John,6,0,80,74
1657650450729,CSE 30,B01,095061,Bhaskar; Nishant,9,0,50,41
1657650456755,CSE 100,A01,083659,Cao; Yingjun,5,4,70,65
1657650462778,CSE 134B,A01,083661,Powell; Thomas Allan,23,0,100,77
1657650468808,CSE 140,A01,083663,Gungor; Onat,15,0,85,70
1657650474838,CSE 140L,A01,083088,Eldon; John,21,0,100,79
1657650480863,CSE 175,A01,083665,Kumar; Rakesh,3,0,25,22
1657650486889,CSE 190,A00,092507,Dubnov; Shlomo,8,0,20,12
1657650492921,ECE 45,A01,083139,Congero; Spencer William,6,0,75,69
1657650498952,ECE 65,A50,083695,Saad; Andrew S,12,0,30,18
1657650498952,ECE 65,A51,095125,Saad; Andrew S,24,0,26,2
1657650504975,ECE 109,A01,091882,Touri; Behrouz,19,0,70,51
1657650511001,ECE 180,A00,083140,Abi Samra; Nicholas Camill,1,0,30,29
1657650511001,ECE 180,B00,083141,Abi Samra; Nicholas Camill,0,0,30,30
1657650517028,MATH 10A,A01,083735,Patchell; Gregory David,2,0,30,28
1657650517028,MATH 10A,A02,083736,Patchell; Gregory David,20,0,30,10
1657650517028,MATH 10A,A03,083737,Patchell; Gregory David,16,0,30,14
1657650523058,MATH 10B,A01,083207,Lim; Seonhee,8,0,34,26
1657650523058,MATH 10B,A02,083208,Lim; Seonhee,9,0,35,26
1657650523058,MATH 10B,A03,093472,Lim; Seonhee,7,0,34,27
1657650523058,MATH 10B,B01,083739,Sinha; Shubham,12,0,30,18
1657650529094,MATH 18,A01,083743,Cinel; Cameron Alexander,7,0,30,23
1657650529094,MATH 18,A02,083744,Cinel; Cameron Alexander,17,0,30,13
1657650529094,MATH 18,A03,083745,Cinel; Cameron Alexander,10,0,30,20
1657650529094,MATH 18,B01,083748,Rideout; David Porter,5,0,37,32
1657650529094,MATH 18,B02,083749,Rideout; David Porter,5,0,36,31
1657650529094,MATH 18,B03,083750,Rideout; David Porter,3,0,37,34
1657650529094,MATH 18,B04,083751,Rideout; David Porter,6,0,36,30
1657650529094,MATH 18,B05,093473,Rideout; David Porter,6,0,36,30
1657650529094,MATH 18,B06,093474,Rideout; David Porter,6,0,36,30
1657650535117,MATH 20A,A01,083754,Zheng; Zequn,14,0,40,26
1657650541140,MATH 20B,A01,083756,Briones; Jor-el Thomas Caparas,4,0,36,32
1657650541140,MATH 20B,A02,083757,Briones; Jor-el Thomas Caparas,1,0,36,35
1657650541140,MATH 20B,A03,093475,Briones; Jor-el Thomas Caparas,2,0,36,34
1657650547168,MATH 20C,A01,083760,Briones; Jor-el Thomas Caparas,1,0,35,34
1657650547168,MATH 20C,A02,083761,Briones; Jor-el Thomas Caparas,8,0,35,27
1657650547168,MATH 20C,A03,093476,Briones; Jor-el Thomas Caparas,0,1,36,36
1657650547168,MATH 20C,B01,083762,Bach; Quang Tran,1,0,30,29
1657650553195,MATH 20D,A01,083765,Tran; Brian Kha,5,0,30,25
1657650553195,MATH 20D,A02,083766,Tran; Brian Kha,5,0,30,25
1657650553195,MATH 20D,A03,083767,Tran; Brian Kha,5,0,30,25
1657650559219,MATH 20E,A01,083771,Ganguly; Soumya,9,0,32,23
1657650559219,MATH 20E,A02,083772,Ganguly; Soumya,6,0,32,26
1657650559219,MATH 20E,B01,083773,Ciotti; Benjamin,20,0,35,15
1657650559219,MATH 20E,B02,083774,Ciotti; Benjamin,18,0,35,17
1657650565242,MATH 103A,A01,083777,Greenfeld; Be'Eri,3,0,36,33
1657650565242,MATH 103A,A02,083778,Greenfeld; Be'Eri,5,0,36,31
1657650565242,MATH 103A,A03,093561,Greenfeld; Be'Eri,6,0,36,30
1657650565242,MATH 103A,B01,083779,Greenfeld; Be'Eri,7,0,36,29
1657650565242,MATH 103A,B02,083780,Greenfeld; Be'Eri,4,0,36,32
1657650565242,MATH 103A,B03,093562,Greenfeld; Be'Eri,3,0,36,33
1657650571266,MATH 105,A01,085443,Carter; Anne Toulson,15,0,35,20
1657650571266,MATH 105,A02,093477,Carter; Anne Toulson,20,0,35,15
1657650577289,MATH 109,A01,083213,Ganzberger; Geoffrey Michael,2,0,34,32
1657650577289,MATH 109,A02,083214,Ganzberger; Geoffrey Michael,4,0,34,30
1657650577289,MATH 109,A03,093478,Ganzberger; Geoffrey Michael,2,0,34,32
1657650577289,MATH 109,B01,083215,Ganzberger; Geoffrey Michael,1,0,32,31
1657650577289,MATH 109,B02,083216,Ganzberger; Geoffrey Michael,2,0,32,30
1657650577289,MATH 109,B03,093479,Ganzberger; Geoffrey Michael,8,0,32,24
1657650583319,MATH 142A,A01,083219,Chow; Bennett,7,0,32,25
1657650583319,MATH 142A,A02,083220,Chow; Bennett,10,0,32,22
1657650583319,MATH 142A,A03,093480,Chow; Bennett,9,0,32,23
1657650583319,MATH 142A,B03,093481,Chow; Bennett,8,0,32,24
1657650583319,MATH 142A,B04,093558,Chow; Bennett,13,0,32,19
1657650583319,MATH 142A,B05,093559,Chow; Bennett,6,0,32,26
1657650589344,MATH 193A,A01,083224,Rotar; Vladimir,8,0,34,26
1657650589344,MATH 193A,A02,083225,Rotar; Vladimir,9,0,34,25
1657650589344,MATH 193A,A03,083781,Rotar; Vladimir,5,0,34,29
1657650589344,MATH 193A,A04,083782,Rotar; Vladimir,10,0,34,24
1657650589344,MATH 193A,A05,093482,Rotar; Vladimir,10,0,34,24
1657650595371,MATH 197,001,091859,McAuley; Julian John,9999,0,9999,0
1657650595371,MATH 197,002,095566,Kedlaya; Kiran S.,9997,0,9999,2
1657650595371,MATH 197,003,095567,Xiao; Ming,9999,0,9999,0
1657650595371,MATH 197,004,095571,Perols; Johan Lars,9998,0,9999,1
1657650602428,COGS 9,A01,083615,Shannon; Kyle Michael,9,0,75,66
1657650608451,COGS 11,A01,083617,Boyle; Mary E. T.,23,0,48,25
1657650614474,COGS 13,A01,083071,Bastos; Amalia Pinkusfeld,11,0,71,60
1657650620497,COGS 14A,A01,092681,Semenuks; Arturs,5,1,100,95
1657650626520,COGS 14B,A01,083073,Cheng; Tzu-Han,6,0,63,57
1657650632544,COGS 17,A01,092677,Semenuks; Arturs,6,0,81,75
1657650638570,COGS 100,A01,083619,Allen; Michael Gordon,17,0,70,53
1657650644592,COGS 101A,A01,083621,Davis; Joshua Daniel,9,0,68,59
1657650650616,COGS 101B,A01,091572,Allen; Michael Gordon,12,0,65,53
1657650656644,COGS 101C,A01,083625,Delgado; Tania,17,0,35,18
1657650662670,COGS 107A,A01,083627,Boyle; Mary E. T.,13,0,60,47
1657650668693,COGS 118A,A01,083075,Gupta; Anjum,21,0,76,55
1657650674718,CSE 3,A50,083646,Miranda; Gregory Joseph,24,0,50,26
1657650680742,CSE 8A,A50,083650,Miranda; Gregory Joseph,17,1,56,39
1657650686776,CSE 11,A01,083080,Cao; Yingjun,6,15,40,34
1657650692810,CSE 12,A01,083652,Krause-Levy; Sophia Louisa,28,1,120,92
1657650698837,CSE 15L,A01,083654,Morris; Justin Loren,9,0,50,41
1657650698837,CSE 15L,A02,083655,Morris; Justin Loren,9,0,50,41
1657650704877,CSE 20,A01,083657,Tran; Khoa Dang,39,0,80,41
1657650710905,CSE 21,A01,095574,Bach; Quang Tran,22,0,48,26
1657650717012,CSE 30,A01,083084,Eldon; John,6,0,80,74
1657650717012,CSE 30,B01,095061,Bhaskar; Nishant,9,0,50,41
1657650723034,CSE 100,A01,083659,Cao; Yingjun,5,4,70,65
1657650729070,CSE 134B,A01,083661,Powell; Thomas Allan,23,0,100,77
1657650735094,CSE 140,A01,083663,Gungor; Onat,15,0,85,70
1657650741118,CSE 140L,A01,083088,Eldon; John,21,0,100,79
1657650747150,CSE 175,A01,083665,Kumar; Rakesh,3,0,25,22
1657650753173,CSE 190,A00,092507,Dubnov; Shlomo,8,0,20,12
1657650759198,ECE 45,A01,083139,Congero; Spencer William,6,0,75,69
1657650765223,ECE 65,A50,083695,Saad; Andrew S,12,0,30,18
1657650765223,ECE 65,A51,095125,Saad; Andrew S,24,0,26,2
1657650771245,ECE 109,A01,091882,Touri; Behrouz,19,0,70,51
1657650777270,ECE 180,A00,083140,Abi Samra; Nicholas Camill,1,0,30,29
1657650777270,ECE 180,B00,083141,Abi Samra; Nicholas Camill,0,0,30,30
1657650783295,MATH 10A,A01,083735,Patchell; Gregory David,2,0,30,28
1657650783295,MATH 10A,A02,083736,Patchell; Gregory David,20,0,30,10
1657650783295,MATH 10A,A03,083737,Patchell; Gregory David,16,0,30,14
1657650789323,MATH 10B,A01,083207,Lim; Seonhee,8,0,34,26
1657650789323,MATH 10B,A02,083208,Lim; Seonhee,9,0,35,26
1657650789323,MATH 10B,A03,093472,Lim; Seonhee,7,0,34,27
1657650789323,MATH 10B,B01,083739,Sinha; Shubham,12,0,30,18
1657650795347,MATH 18,A01,083743,Cinel; Cameron Alexander,7,0,30,23
1657650795347,MATH 18,A02,083744,Cinel; Cameron Alexander,17,0,30,13
1657650795347,MATH 18,A03,083745,Cinel; Cameron Alexander,10,0,30,20
1657650795347,MATH 18,B01,083748,Rideout; David Porter,5,0,37,32
1657650795347,MATH 18,B02,083749,Rideout; David Porter,5,0,36,31
1657650795347,MATH 18,B03,083750,Rideout; David Porter,3,0,37,34
1657650795347,MATH 18,B04,083751,Rideout; David Porter,6,0,36,30
1657650795347,MATH 18,B05,093473,Rideout; David Porter,6,0,36,30
1657650795347,MATH 18,B06,093474,Rideout; David Porter,6,0,36,30
1657650801373,MATH 20A,A01,083754,Zheng; Zequn,14,0,40,26
1657650807416,MATH 20B,A01,083756,Briones; Jor-el Thomas Caparas,4,0,36,32
1657650807416,MATH 20B,A02,083757,Briones; Jor-el Thomas Caparas,1,0,36,35
1657650807416,MATH 20B,A03,093475,Briones; Jor-el Thomas Caparas,2,0,36,34
1657650813452,MATH 20C,A01,083760,Briones; Jor-el Thomas Caparas,1,0,35,34
1657650813452,MATH 20C,A02,083761,Briones; Jor-el Thomas Caparas,8,0,35,27
1657650813452,MATH 20C,A03,093476,Briones; Jor-el Thomas Caparas,0,1,36,36
1657650813452,MATH 20C,B01,083762,Bach; Quang Tran,1,0,30,29
1657650819487,MATH 20D,A01,083765,Tran; Brian Kha,5,0,30,25
1657650819487,MATH 20D,A02,083766,Tran; Brian Kha,5,0,30,25
1657650819487,MATH 20D,A03,083767,Tran; Brian Kha,5,0,30,25
1657650825509,MATH 20E,A01,083771,Ganguly; Soumya,9,0,32,23
1657650825509,MATH 20E,A02,083772,Ganguly; Soumya,6,0,32,26
1657650825509,MATH 20E,B01,083773,Ciotti; Benjamin,20,0,35,15
1657650825509,MATH 20E,B02,083774,Ciotti; Benjamin,18,0,35,17
1657650831539,MATH 103A,A01,083777,Greenfeld; Be'Eri,3,0,36,33
1657650831539,MATH 103A,A02,083778,Greenfeld; Be'Eri,5,0,36,31
1657650831539,MATH 103A,A03,093561,Greenfeld; Be'Eri,6,0,36,30
1657650831539,MATH 103A,B01,083779,Greenfeld; Be'Eri,7,0,36,29
1657650831539,MATH 103A,B02,083780,Greenfeld; Be'Eri,4,0,36,32
1657650831539,MATH 103A,B03,093562,Greenfeld; Be'Eri,3,0,36,33
1657650837560,MATH 105,A01,085443,Carter; Anne Toulson,15,0,35,20
1657650837560,MATH 105,A02,093477,Carter; Anne Toulson,20,0,35,15
1657650843591,MATH 109,A01,083213,Ganzberger; Geoffrey Michael,2,0,34,32
1657650843591,MATH 109,A02,083214,Ganzberger; Geoffrey Michael,4,0,34,30
1657650843591,MATH 109,A03,093478,Ganzberger; Geoffrey Michael,2,0,34,32
1657650843591,MATH 109,B01,083215,Ganzberger; Geoffrey Michael,1,0,32,31
1657650843591,MATH 109,B02,083216,Ganzberger; Geoffrey Michael,2,0,32,30
1657650843591,MATH 109,B03,093479,Ganzberger; Geoffrey Michael,8,0,32,24
1657650849616,MATH 142A,A01,083219,Chow; Bennett,7,0,32,25
1657650849616,MATH 142A,A02,083220,Chow; Bennett,10,0,32,22
1657650849616,MATH 142A,A03,093480,Chow; Bennett,9,0,32,23
1657650849616,MATH 142A,B03,093481,Chow; Bennett,8,0,32,24
1657650849616,MATH 142A,B04,093558,Chow; Bennett,13,0,32,19
1657650849616,MATH 142A,B05,093559,Chow; Bennett,6,0,32,26
1657650855645,MATH 193A,A01,083224,Rotar; Vladimir,8,0,34,26
1657650855645,MATH 193A,A02,083225,Rotar; Vladimir,9,0,34,25
1657650855645,MATH 193A,A03,083781,Rotar; Vladimir,5,0,34,29
1657650855645,MATH 193A,A04,083782,Rotar; Vladimir,10,0,34,24
1657650855645,MATH 193A,A05,093482,Rotar; Vladimir,10,0,34,24
1657650861668,MATH 197,001,091859,McAuley; Julian John,9999,0,9999,0
1657650861668,MATH 197,002,095566,Kedlaya; Kiran S.,9997,0,9999,2
1657650861668,MATH 197,003,095567,Xiao; Ming,9999,0,9999,0
1657650861668,MATH 197,004,095571,Perols; Johan Lars,9998,0,9999,1
1657650868734,COGS 9,A01,083615,Shannon; Kyle Michael,9,0,75,66
1657650874756,COGS 11,A01,083617,Boyle; Mary E. T.,23,0,48,25
1657650880781,COGS 13,A01,083071,Bastos; Amalia Pinkusfeld,11,0,71,60
1657650886805,COGS 14A,A01,092681,Semenuks; Arturs,5,1,100,95
1657650892827,COGS 14B,A01,083073,Cheng; Tzu-Han,6,0,63,57
1657650898865,COGS 17,A01,092677,Semenuks; Arturs,6,0,81,75
1657650904892,COGS 100,A01,083619,Allen; Michael Gordon,17,0,70,53
1657650910926,COGS 101A,A01,083621,Davis; Joshua Daniel,9,0,68,59
1657650916949,COGS 101B,A01,091572,Allen; Michael Gordon,12,0,65,53
1657650922979,COGS 101C,A01,083625,Delgado; Tania,17,0,35,18
1657650929002,COGS 107A,A01,083627,Boyle; Mary E. T.,13,0,60,47
1657650935026,COGS 118A,A01,083075,Gupta; Anjum,21,0,76,55
1657650941048,CSE 3,A50,083646,Miranda; Gregory Joseph,24,0,50,26
1657650947076,CSE 8A,A50,083650,Miranda; Gregory Joseph,17,1,56,39
1657650953100,CSE 11,A01,083080,Cao; Yingjun,6,15,40,34
1657650959123,CSE 12,A01,083652,Krause-Levy; Sophia Louisa,28,1,120,92
1657650965160,CSE 15L,A01,083654,Morris; Justin Loren,9,0,50,41
1657650965160,CSE 15L,A02,083655,Morris; Justin Loren,9,0,50,41
1657650971184,CSE 20,A01,083657,Tran; Khoa Dang,39,0,80,41
1657650977209,CSE 21,A01,095574,Bach; Quang Tran,22,0,48,26
1657650983232,CSE 30,A01,083084,Eldon; John,6,0,80,74
1657650983232,CSE 30,B01,095061,Bhaskar; Nishant,9,0,50,41
1657650989254,CSE 100,A01,083659,Cao; Yingjun,5,4,70,65
1657650995288,CSE 134B,A01,083661,Powell; Thomas Allan,23,0,100,77
1657651001314,CSE 140,A01,083663,Gungor; Onat,15,0,85,70
1657651007339,CSE 140L,A01,083088,Eldon; John,21,0,100,79
1657651013362,CSE 175,A01,083665,Kumar; Rakesh,3,0,25,22
1657651019384,CSE 190,A00,092507,Dubnov; Shlomo,8,0,20,12
1657651025412,ECE 45,A01,083139,Congero; Spencer William,6,0,75,69
1657651031441,ECE 65,A50,083695,Saad; Andrew S,12,0,30,18
1657651031441,ECE 65,A51,095125,Saad; Andrew S,24,0,26,2
1657651037474,ECE 109,A01,091882,Touri; Behrouz,19,0,70,51
1657651043496,ECE 180,A00,083140,Abi Samra; Nicholas Camill,1,0,30,29
1657651043496,ECE 180,B00,083141,Abi Samra; Nicholas Camill,0,0,30,30
1657651049518,MATH 10A,A01,083735,Patchell; Gregory David,2,0,30,28
1657651049518,MATH 10A,A02,083736,Patchell; Gregory David,20,0,30,10
1657651049518,MATH 10A,A03,083737,Patchell; Gregory David,16,0,30,14
1657651055549,MATH 10B,A01,083207,Lim; Seonhee,8,0,34,26
1657651055549,MATH 10B,A02,083208,Lim; Seonhee,9,0,35,26
1657651055549,MATH 10B,A03,093472,Lim; Seonhee,7,0,34,27
1657651055549,MATH 10B,B01,083739,Sinha; Shubham,12,0,30,18
1657651061574,MATH 18,A01,083743,Cinel; Cameron Alexander,7,0,30,23
1657651061574,MATH 18,A02,083744,Cinel; Cameron Alexander,17,0,30,13
1657651061574,MATH 18,A03,083745,Cinel; Cameron Alexander,10,0,30,20
1657651061574,MATH 18,B01,083748,Rideout; David Porter,5,0,37,32
1657651061574,MATH 18,B02,083749,Rideout; David Porter,5,0,36,31
1657651061574,MATH 18,B03,083750,Rideout; David Porter,3,0,37,34
1657651061574,MATH 18,B04,083751,Rideout; David Porter,6,0,36,30
1657651061574,MATH 18,B05,093473,Rideout; David Porter,6,0,36,30
1657651061574,MATH 18,B06,093474,Rideout; David Porter,6,0,36,30
1657651067596,MATH 20A,A01,083754,Zheng; Zequn,14,0,40,26
1657651073619,MATH 20B,A01,083756,Briones; Jor-el Thomas Caparas,4,0,36,32
1657651073619,MATH 20B,A02,083757,Briones; Jor-el Thomas Caparas,1,0,36,35
1657651073619,MATH 20B,A03,093475,Briones; Jor-el Thomas Caparas,2,0,36,34
1657651079648,MATH 20C,A01,083760,Briones; Jor-el Thomas Caparas,1,0,35,34
1657651079648,MATH 20C,A02,083761,Briones; Jor-el Thomas Caparas,8,0,35,27
1657651079648,MATH 20C,A03,093476,Briones; Jor-el Thomas Caparas,0,1,36,36
1657651079648,MATH 20C,B01,083762,Bach; Quang Tran,1,0,30,29
1657651085678,MATH 20D,A01,083765,Tran; Brian Kha,5,0,30,25
1657651085678,MATH 20D,A02,083766,Tran; Brian Kha,5,0,30,25
1657651085678,MATH 20D,A03,083767,Tran; Brian Kha,5,0,30,25
1657651091704,MATH 20E,A01,083771,Ganguly; Soumya,9,0,32,23
1657651091704,MATH 20E,A02,083772,Ganguly; Soumya,6,0,32,26
1657651091704,MATH 20E,B01,083773,Ciotti; Benjamin,20,0,35,15
1657651091704,MATH 20E,B02,083774,Ciotti; Benjamin,18,0,35,17
1657651097738,MATH 103A,A01,083777,Greenfeld; Be'Eri,3,0,36,33
1657651097738,MATH 103A,A02,083778,Greenfeld; Be'Eri,5,0,36,31
1657651097738,MATH 103A,A03,093561,Greenfeld; Be'Eri,6,0,36,30
1657651097738,MATH 103A,B01,083779,Greenfeld; Be'Eri,7,0,36,29
1657651097738,MATH 103A,B02,083780,Greenfeld; Be'Eri,4,0,36,32
1657651097738,MATH 103A,B03,093562,Greenfeld; Be'Eri,3,0,36,33
1657651103760,MATH 105,A01,085443,Carter; Anne Toulson,15,0,35,20
1657651103760,MATH 105,A02,093477,Carter; Anne Toulson,20,0,35,15
1657651109788,MATH 109,A01,083213,Ganzberger; Geoffrey Michael,2,0,34,32
1657651109788,MATH 109,A02,083214,Ganzberger; Geoffrey Michael,4,0,34,30
1657651109788,MATH 109,A03,093478,Ganzberger; Geoffrey Michael,2,0,34,32
1657651109788,MATH 109,B01,083215,Ganzberger; Geoffrey Michael,1,0,32,31
1657651109788,MATH 109,B02,083216,Ganzberger; Geoffrey Michael,2,0,32,30
1657651109788,MATH 109,B03,093479,Ganzberger; Geoffrey Michael,8,0,32,24
1657651115812,MATH 142A,A01,083219,Chow; Bennett,7,0,32,25
1657651115812,MATH 142A,A02,083220,Chow; Bennett,10,0,32,22
1657651115812,MATH 142A,A03,093480,Chow; Bennett,9,0,32,23
1657651115812,MATH 142A,B03,093481,Chow; Bennett,8,0,32,24
1657651115812,MATH 142A,B04,093558,Chow; Bennett,13,0,32,19
1657651115812,MATH 142A,B05,093559,Chow; Bennett,6,0,32,26
1657651121839,MATH 193A,A01,083224,Rotar; Vladimir,8,0,34,26
1657651121839,MATH 193A,A02,083225,Rotar; Vladimir,9,0,34,25
1657651121839,MATH 193A,A03,083781,Rotar; Vladimir,5,0,34,29
1657651121839,MATH 193A,A04,083782,Rotar; Vladimir,10,0,34,24
1657651121839,MATH 193A,A05,093482,Rotar; Vladimir,10,0,34,24
1657651127862,MATH 197,001,091859,McAuley; Julian John,9999,0,9999,0
1657651127862,MATH 197,002,095566,Kedlaya; Kiran S.,9997,0,9999,2
1657651127862,MATH 197,003,095567,Xiao; Ming,9999,0,9999,0
1657651127862,MATH 197,004,095571,Perols; Johan Lars,9998,0,9999,1
1657651134914,COGS 9,A01,083615,Shannon; Kyle Michael,9,0,75,66
1657651140937,COGS 11,A01,083617,Boyle; Mary E. T.,23,0,48,25
1657651146960,COGS 13,A01,083071,Bastos; Amalia Pinkusfeld,11,0,71,60
1657651152987,COGS 14A,A01,092681,Semenuks; Arturs,5,1,100,95
1657651159019,COGS 14B,A01,083073,Cheng; Tzu-Han,6,0,63,57
1657651165046,COGS 17,A01,092677,Semenuks; Arturs,6,0,81,75
1657651171069,COGS 100,A01,083619,Allen; Michael Gordon,17,0,70,53
1657651177092,COGS 101A,A01,083621,Davis; Joshua Daniel,9,0,68,59
1657651183115,COGS 101B,A01,091572,Allen; Michael Gordon,12,0,65,53
1657651189138,COGS 101C,A01,083625,Delgado; Tania,17,0,35,18
1657651195164,COGS 107A,A01,083627,Boyle; Mary E. T.,13,0,60,47
1657651201188,COGS 118A,A01,083075,Gupta; Anjum,21,0,76,55
1657651207212,CSE 3,A50,083646,Miranda; Gregory Joseph,24,0,50,26
1657651213236,CSE 8A,A50,083650,Miranda; Gregory Joseph,17,1,56,39
1657651219263,CSE 11,A01,083080,Cao; Yingjun,6,15,40,34
1657651225291,CSE 12,A01,083652,Krause-Levy; Sophia Louisa,28,1,120,92
1657651231314,CSE 15L,A01,083654,Morris; Justin Loren,9,0,50,41
1657651231314,CSE 15L,A02,083655,Morris; Justin Loren,9,0,50,41
1657651237338,CSE 20,A01,083657,Tran; Khoa Dang,39,0,80,41
1657651243366,CSE 21,A01,095574,Bach; Quang Tran,22,0,48,26
1657651249400,CSE 30,A01,083084,Eldon; John,6,0,80,74
1657651249400,CSE 30,B01,095061,Bhaskar; Nishant,9,0,50,41
1657651255423,CSE 100,A01,083659,Cao; Yingjun,5,4,70,65
1657651261448,CSE 134B,A01,083661,Powell; Thomas Allan,23,0,100,77
1657651267475,CSE 140,A01,083663,Gungor; Onat,15,0,85,70
1657651273497,CSE 140L,A01,083088,Eldon; John,21,0,100,79
1657651279523,CSE 175,A01,083665,Kumar; Rakesh,3,0,25,22
1657651285550,CSE 190,A00,092507,Dubnov; Shlomo,8,0,20,12
1657651291571,ECE 45,A01,083139,Congero; Spencer William,6,0,75,69
1657651297605,ECE 65,A50,083695,Saad; Andrew S,12,0,30,18
1657651297605,ECE 65,A51,095125,Saad; Andrew S,24,0,26,2
1657651303626,ECE 109,A01,091882,Touri; Behrouz,19,0,70,51
1657651309653,ECE 180,A00,083140,Abi Samra; Nicholas Camill,1,0,30,29
1657651309653,ECE 180,B00,083141,Abi Samra; Nicholas Camill,0,0,30,30
1657651315751,MATH 10A,A01,083735,Patchell; Gregory David,2,0,30,28
1657651315751,MATH 10A,A02,083736,Patchell; Gregory David,20,0,30,10
1657651315751,MATH 10A,A03,083737,Patchell; Gregory David,16,0,30,14
1657651321792,MATH 10B,A01,083207,Lim; Seonhee,8,0,34,26
1657651321792,MATH 10B,A02,083208,Lim; Seonhee,9,0,35,26
1657651321792,MATH 10B,A03,093472,Lim; Seonhee,7,0,34,27
1657651321792,MATH 10B,B01,083739,Sinha; Shubham,12,0,30,18
1657651327823,MATH 18,A01,083743,Cinel; Cameron Alexander,7,0,30,23
1657651327823,MATH 18,A02,083744,Cinel; Cameron Alexander,17,0,30,13
1657651327823,MATH 18,A03,083745,Cinel; Cameron Alexander,10,0,30,20
1657651327823,MATH 18,B01,083748,Rideout; David Porter,5,0,37,32
1657651327823,MATH 18,B02,083749,Rideout; David Porter,5,0,36,31
1657651327823,MATH 18,B03,083750,Rideout; David Porter,3,0,37,34
1657651327823,MATH 18,B04,083751,Rideout; David Porter,6,0,36,30
1657651327823,MATH 18,B05,093473,Rideout; David Porter,6,0,36,30
1657651327823,MATH 18,B06,093474,Rideout; David Porter,6,0,36,30
1657651333847,MATH 20A,A01,083754,Zheng; Zequn,14,0,40,26
1657651339873,MATH 20B,A01,083756,Briones; Jor-el Thomas Caparas,4,0,36,32
1657651339873,MATH 20B,A02,083757,Briones; Jor-el Thomas Caparas,1,0,36,35
1657651339873,MATH 20B,A03,093475,Briones; Jor-el Thomas Caparas,2,0,36,34
1657651345905,MATH 20C,A01,083760,Briones; Jor-el Thomas Caparas,1,0,35,34
1657651345905,MATH 20C,A02,083761,Briones; Jor-el Thomas Caparas,8,0,35,27
1657651345905,MATH 20C,A03,093476,Briones; Jor-el Thomas Caparas,0,1,36,36
1657651345905,MATH 20C,B01,083762,Bach; Quang Tran,1,0,30,29
1657651351929,MATH 20D,A01,083765,Tran; Brian Kha,5,0,30,25
1657651351929,MATH 20D,A02,083766,Tran; Brian Kha,5,0,30,25
1657651351929,MATH 20D,A03,083767,Tran; Brian Kha,5,0,30,25
1657651357950,MATH 20E,A01,083771,Ganguly; Soumya,9,0,32,23
1657651357950,MATH 20E,A02,083772,Ganguly; Soumya,6,0,32,26
1657651357950,MATH 20E,B01,083773,Ciotti; Benjamin,20,0,35,15
1657651357950,MATH 20E,B02,083774,Ciotti; Benjamin,18,0,35,17
1657651363975,MATH 103A,A01,083777,Greenfeld; Be'Eri,3,0,36,33
1657651363975,MATH 103A,A02,083778,Greenfeld; Be'Eri,5,0,36,31
1657651363975,MATH 103A,A03,093561,Greenfeld; Be'Eri,6,0,36,30
1657651363975,MATH 103A,B01,083779,Greenfeld; Be'Eri,7,0,36,29
1657651363975,MATH 103A,B02,083780,Greenfeld; Be'Eri,4,0,36,32
1657651363975,MATH 103A,B03,093562,Greenfeld; Be'Eri,3,0,36,33
1657651370003,MATH 105,A01,085443,Carter; Anne Toulson,15,0,35,20
1657651370003,MATH 105,A02,093477,Carter; Anne Toulson,20,0,35,15
1657651376035,MATH 109,A01,083213,Ganzberger; Geoffrey Michael,2,0,34,32
1657651376035,MATH 109,A02,083214,Ganzberger; Geoffrey Michael,4,0,34,30
1657651376035,MATH 109,A03,093478,Ganzberger; Geoffrey Michael,2,0,34,32
1657651376035,MATH 109,B01,083215,Ganzberger; Geoffrey Michael,1,0,32,31
1657651376035,MATH 109,B02,083216,Ganzberger; Geoffrey Michael,2,0,32,30
1657651376035,MATH 109,B03,093479,Ganzberger; Geoffrey Michael,8,0,32,24
1657651382059,MATH 142A,A01,083219,Chow; Bennett,7,0,32,25
1657651382059,MATH 142A,A02,083220,Chow; Bennett,10,0,32,22
1657651382059,MATH 142A,A03,093480,Chow; Bennett,9,0,32,23
1657651382059,MATH 142A,B03,093481,Chow; Bennett,8,0,32,24
1657651382059,MATH 142A,B04,093558,Chow; Bennett,13,0,32,19
1657651382059,MATH 142A,B05,093559,Chow; Bennett,6,0,32,26
1657651388091,MATH 193A,A01,083224,Rotar; Vladimir,8,0,34,26
1657651388091,MATH 193A,A02,083225,Rotar; Vladimir,9,0,34,25
1657651388091,MATH 193A,A03,083781,Rotar; Vladimir,5,0,34,29
1657651388091,MATH 193A,A04,083782,Rotar; Vladimir,10,0,34,24
1657651388091,MATH 193A,A05,093482,Rotar; Vladimir,10,0,34,24
1657651394128,MATH 197,001,091859,McAuley; Julian John,9999,0,9999,0
1657651394128,MATH 197,002,095566,Kedlaya; Kiran S.,9997,0,9999,2
1657651394128,MATH 197,003,095567,Xiao; Ming,9999,0,9999,0
1657651394128,MATH 197,004,095571,Perols; Johan Lars,9998,0,9999,1
1657651401185,COGS 9,A01,083615,Shannon; Kyle Michael,9,0,75,66
1657651407210,COGS 11,A01,083617,Boyle; Mary E. T.,23,0,48,25
1657651413233,COGS 13,A01,083071,Bastos; Amalia Pinkusfeld,11,0,71,60
1657651419259,COGS 14A,A01,092681,Semenuks; Arturs,5,1,100,95
1657651425284,COGS 14B,A01,083073,Cheng; Tzu-Han,6,0,63,57
1657651431329,COGS 17,A01,092677,Semenuks; Arturs,6,0,81,75
1657651437354,COGS 100,A01,083619,Allen; Michael Gordon,17,0,70,53
1657651443381,COGS 101A,A01,083621,Davis; Joshua Daniel,9,0,68,59
1657651449409,COGS 101B,A01,091572,Allen; Michael Gordon,12,0,65,53
1657651455440,COGS 101C,A01,083625,Delgado; Tania,17,0,35,18
1657651461464,COGS 107A,A01,083627,Boyle; Mary E. T.,13,0,60,47
1657651467497,COGS 118A,A01,083075,Gupta; Anjum,21,0,76,55
1657651473519,CSE 3,A50,083646,Miranda; Gregory Joseph,24,0,50,26
1657651479554,CSE 8A,A50,083650,Miranda; Gregory Joseph,17,1,56,39
1657651485583,CSE 11,A01,083080,Cao; Yingjun,6,15,40,34
1657651491610,CSE 12,A01,083652,Krause-Levy; Sophia Louisa,28,1,120,92
1657651497633,CSE 15L,A01,083654,Morris; Justin Loren,9,0,50,41
1657651497633,CSE 15L,A02,083655,Morris; Justin Loren,9,0,50,41
1657651503655,CSE 20,A01,083657,Tran; Khoa Dang,39,0,80,41
1657651509679,CSE 21,A01,095574,Bach; Quang Tran,22,0,48,26
1657651515712,CSE 30,A01,083084,Eldon; John,6,0,80,74
1657651515712,CSE 30,B01,095061,Bhaskar; Nishant,9,0,50,41
1657651521736,CSE 100,A01,083659,Cao; Yingjun,5,4,70,65
1657651527763,CSE 134B,A01,083661,Powell; Thomas Allan,23,0,100,77
1657651533795,CSE 140,A01,083663,Gungor; Onat,15,0,85,70
1657651539827,CSE 140L,A01,083088,Eldon; John,21,0,100,79
1657651545849,CSE 175,A01,083665,Kumar; Rakesh,3,0,25,22
1657651551871,CSE 190,A00,092507,Dubnov; Shlomo,8,0,20,12
1657651557898,ECE 45,A01,083139,Congero; Spencer William,6,0,75,69
1657651563922,ECE 65,A50,083695,Saad; Andrew S,12,0,30,18
1657651563922,ECE 65,A51,095125,Saad; Andrew S,24,0,26,2
1657651569954,ECE 109,A01,091882,Touri; Behrouz,19,0,70,51
1657651575976,ECE 180,A00,083140,Abi Samra; Nicholas Camill,1,0,30,29
1657651575976,ECE 180,B00,083141,Abi Samra; Nicholas Camill,0,0,30,30
1657651582005,MATH 10A,A01,083735,Patchell; Gregory David,2,0,30,28
1657651582005,MATH 10A,A02,083736,Patchell; Gregory David,20,0,30,10
1657651582005,MATH 10A,A03,083737,Patchell; Gregory David,16,0,30,14
1657651588036,MATH 10B,A01,083207,Lim; Seonhee,8,0,34,26
1657651588036,MATH 10B,A02,083208,Lim; Seonhee,9,0,35,26
1657651588036,MATH 10B,A03,093472,Lim; Seonhee,7,0,34,27
1657651588036,MATH 10B,B01,083739,Sinha; Shubham,12,0,30,18
1657651594068,MATH 18,A01,083743,Cinel; Cameron Alexander,7,0,30,23
1657651594068,MATH 18,A02,083744,Cinel; Cameron Alexander,17,0,30,13
1657651594068,MATH 18,A03,083745,Cinel; Cameron Alexander,10,0,30,20
1657651594068,MATH 18,B01,083748,Rideout; David Porter,5,0,37,32
1657651594068,MATH 18,B02,083749,Rideout; David Porter,5,0,36,31
1657651594068,MATH 18,B03,083750,Rideout; David Porter,3,0,37,34
1657651594068,MATH 18,B04,083751,Rideout; David Porter,6,0,36,30
1657651594068,MATH 18,B05,093473,Rideout; David Porter,6,0,36,30
1657651594068,MATH 18,B06,093474,Rideout; David Porter,6,0,36,30
1657651600093,MATH 20A,A01,083754,Zheng; Zequn,14,0,40,26
1657651606117,MATH 20B,A01,083756,Briones; Jor-el Thomas Caparas,4,0,36,32
1657651606117,MATH 20B,A02,083757,Briones; Jor-el Thomas Caparas,1,0,36,35
1657651606117,MATH 20B,A03,093475,Briones; Jor-el Thomas Caparas,2,0,36,34
1657651612147,MATH 20C,A01,083760,Briones; Jor-el Thomas Caparas,1,0,35,34
1657651612147,MATH 20C,A02,083761,Briones; Jor-el Thomas Caparas,8,0,35,27
1657651612147,MATH 20C,A03,093476,Briones; Jor-el Thomas Caparas,0,1,36,36
1657651612147,MATH 20C,B01,083762,Bach; Quang Tran,1,0,30,29
1657651618180,MATH 20D,A01,083765,Tran; Brian Kha,5,0,30,25
1657651618180,MATH 20D,A02,083766,Tran; Brian Kha,5,0,30,25
1657651618180,MATH 20D,A03,083767,Tran; Brian Kha,5,0,30,25
1657651624208,MATH 20E,A01,083771,Ganguly; Soumya,9,0,32,23
1657651624208,MATH 20E,A02,083772,Ganguly; Soumya,6,0,32,26
1657651624208,MATH 20E,B01,083773,Ciotti; Benjamin,20,0,35,15
1657651624208,MATH 20E,B02,083774,Ciotti; Benjamin,18,0,35,17
1657651630232,MATH 103A,A01,083777,Greenfeld; Be'Eri,3,0,36,33
1657651630232,MATH 103A,A02,083778,Greenfeld; Be'Eri,5,0,36,31
1657651630232,MATH 103A,A03,093561,Greenfeld; Be'Eri,6,0,36,30
1657651630232,MATH 103A,B01,083779,Greenfeld; Be'Eri,7,0,36,29
1657651630232,MATH 103A,B02,083780,Greenfeld; Be'Eri,4,0,36,32
1657651630232,MATH 103A,B03,093562,Greenfeld; Be'Eri,3,0,36,33
1657651636262,MATH 105,A01,085443,Carter; Anne Toulson,15,0,35,20
1657651636262,MATH 105,A02,093477,Carter; Anne Toulson,20,0,35,15
1657651642290,MATH 109,A01,083213,Ganzberger; Geoffrey Michael,2,0,34,32
1657651642290,MATH 109,A02,083214,Ganzberger; Geoffrey Michael,4,0,34,30
1657651642290,MATH 109,A03,093478,Ganzberger; Geoffrey Michael,2,0,34,32
1657651642290,MATH 109,B01,083215,Ganzberger; Geoffrey Michael,1,0,32,31
1657651642290,MATH 109,B02,083216,Ganzberger; Geoffrey Michael,2,0,32,30
1657651642290,MATH 109,B03,093479,Ganzberger; Geoffrey Michael,8,0,32,24
1657651648313,MATH 142A,A01,083219,Chow; Bennett,7,0,32,25
1657651648313,MATH 142A,A02,083220,Chow; Bennett,10,0,32,22
1657651648313,MATH 142A,A03,093480,Chow; Bennett,9,0,32,23
1657651648313,MATH 142A,B03,093481,Chow; Bennett,8,0,32,24
1657651648313,MATH 142A,B04,093558,Chow; Bennett,13,0,32,19
1657651648313,MATH 142A,B05,093559,Chow; Bennett,6,0,32,26
1657651654345,MATH 193A,A01,083224,Rotar; Vladimir,8,0,34,26
1657651654345,MATH 193A,A02,083225,Rotar; Vladimir,9,0,34,25
1657651654345,MATH 193A,A03,083781,Rotar; Vladimir,5,0,34,29
1657651654345,MATH 193A,A04,083782,Rotar; Vladimir,10,0,34,24
1657651654345,MATH 193A,A05,093482,Rotar; Vladimir,10,0,34,24
1657651660371,MATH 197,001,091859,McAuley; Julian John,9999,0,9999,0
1657651660371,MATH 197,002,095566,Kedlaya; Kiran S.,9997,0,9999,2
1657651660371,MATH 197,003,095567,Xiao; Ming,9999,0,9999,0
1657651660371,MATH 197,004,095571,Perols; Johan Lars,9998,0,9999,1
1657651667431,COGS 9,A01,083615,Shannon; Kyle Michael,9,0,75,66
1657651673453,COGS 11,A01,083617,Boyle; Mary E. T.,23,0,48,25
1657651679479,COGS 13,A01,083071,Bastos; Amalia Pinkusfeld,11,0,71,60
1657651685524,COGS 14A,A01,092681,Semenuks; Arturs,5,1,100,95
1657651691552,COGS 14B,A01,083073,Cheng; Tzu-Han,6,0,63,57
1657651697578,COGS 17,A01,092677,Semenuks; Arturs,6,0,81,75
1657651703608,COGS 100,A01,083619,Allen; Michael Gordon,17,0,70,53
1657651709635,COGS 101A,A01,083621,Davis; Joshua Daniel,9,0,68,59
1657651715661,COGS 101B,A01,091572,Allen; Michael Gordon,12,0,65,53
1657651721690,COGS 101C,A01,083625,Delgado; Tania,17,0,35,18
1657651727721,COGS 107A,A01,083627,Boyle; Mary E. T.,13,0,60,47
1657651733747,COGS 118A,A01,083075,Gupta; Anjum,21,0,76,55
1657651739772,CSE 3,A50,083646,Miranda; Gregory Joseph,24,0,50,26
1657651745805,CSE 8A,A50,083650,Miranda; Gregory Joseph,17,1,56,39
1657651751828,CSE 11,A01,083080,Cao; Yingjun,6,15,40,34
1657651757853,CSE 12,A01,083652,Krause-Levy; Sophia Louisa,28,1,120,92
1657651763876,CSE 15L,A01,083654,Morris; Justin Loren,9,0,50,41
1657651763876,CSE 15L,A02,083655,Morris; Justin Loren,9,0,50,41
1657651769897,CSE 20,A01,083657,Tran; Khoa Dang,39,0,80,41
1657651775920,CSE 21,A01,095574,Bach; Quang Tran,22,0,48,26
1657651781950,CSE 30,A01,083084,Eldon; John,6,0,80,74
1657651781950,CSE 30,B01,095061,Bhaskar; Nishant,9,0,50,41
1657651787980,CSE 100,A01,083659,Cao; Yingjun,5,4,70,65
1657651794007,CSE 134B,A01,083661,Powell; Thomas Allan,23,0,100,77
1657651800033,CSE 140,A01,083663,Gungor; Onat,15,0,85,70
1657651806058,CSE 140L,A01,083088,Eldon; John,21,0,100,79
1657651812095,CSE 175,A01,083665,Kumar; Rakesh,3,0,25,22
1657651818124,CSE 190,A00,092507,Dubnov; Shlomo,8,0,20,12
1657651824156,ECE 45,A01,083139,Congero; Spencer William,6,0,75,69
1657651830179,ECE 65,A50,083695,Saad; Andrew S,12,0,30,18
1657651830179,ECE 65,A51,095125,Saad; Andrew S,24,0,26,2
1657651836208,ECE 109,A01,091882,Touri; Behrouz,19,0,70,51
1657651842232,ECE 180,A00,083140,Abi Samra; Nicholas Camill,1,0,30,29
1657651842232,ECE 180,B00,083141,Abi Samra; Nicholas Camill,0,0,30,30
1657651848258,MATH 10A,A01,083735,Patchell; Gregory David,2,0,30,28
1657651848258,MATH 10A,A02,083736,Patchell; Gregory David,20,0,30,10
1657651848258,MATH 10A,A03,083737,Patchell; Gregory David,16,0,30,14
1657651854287,MATH 10B,A01,083207,Lim; Seonhee,8,0,34,26
1657651854287,MATH 10B,A02,083208,Lim; Seonhee,9,0,35,26
1657651854287,MATH 10B,A03,093472,Lim; Seonhee,7,0,34,27
1657651854287,MATH 10B,B01,083739,Sinha; Shubham,12,0,30,18
1657651860312,MATH 18,A01,083743,Cinel; Cameron Alexander,7,0,30,23
1657651860312,MATH 18,A02,083744,Cinel; Cameron Alexander,17,0,30,13
1657651860312,MATH 18,A03,083745,Cinel; Cameron Alexander,10,0,30,20
1657651860312,MATH 18,B01,083748,Rideout; David Porter,5,0,37,32
1657651860312,MATH 18,B02,083749,Rideout; David Porter,5,0,36,31
1657651860312,MATH 18,B03,083750,Rideout; David Porter,3,0,37,34
1657651860312,MATH 18,B04,083751,Rideout; David Porter,6,0,36,30
1657651860312,MATH 18,B05,093473,Rideout; David Porter,6,0,36,30
1657651860312,MATH 18,B06,093474,Rideout; David Porter,6,0,36,30
1657651866335,MATH 20A,A01,083754,Zheng; Zequn,14,0,40,26
1657651872363,MATH 20B,A01,083756,Briones; Jor-el Thomas Caparas,4,0,36,32
1657651872363,MATH 20B,A02,083757,Briones; Jor-el Thomas Caparas,1,0,36,35
1657651872363,MATH 20B,A03,093475,Briones; Jor-el Thomas Caparas,2,0,36,34
1657651878386,MATH 20C,A01,083760,Briones; Jor-el Thomas Caparas,1,0,35,34
1657651878386,MATH 20C,A02,083761,Briones; Jor-el Thomas Caparas,8,0,35,27
1657651878386,MATH 20C,A03,093476,Briones; Jor-el Thomas Caparas,0,1,36,36
1657651878386,MATH 20C,B01,083762,Bach; Quang Tran,1,0,30,29
1657651884414,MATH 20D,A01,083765,Tran; Brian Kha,5,0,30,25
1657651884414,MATH 20D,A02,083766,Tran; Brian Kha,5,0,30,25
1657651884414,MATH 20D,A03,083767,Tran; Brian Kha,5,0,30,25
1657651890444,MATH 20E,A01,083771,Ganguly; Soumya,9,0,32,23
1657651890444,MATH 20E,A02,083772,Ganguly; Soumya,6,0,32,26
1657651890444,MATH 20E,B01,083773,Ciotti; Benjamin,20,0,35,15
1657651890444,MATH 20E,B02,083774,Ciotti; Benjamin,18,0,35,17
1657651896468,MATH 103A,A01,083777,Greenfeld; Be'Eri,3,0,36,33
1657651896468,MATH 103A,A02,083778,Greenfeld; Be'Eri,5,0,36,31
1657651896468,MATH 103A,A03,093561,Greenfeld; Be'Eri,6,0,36,30
1657651896468,MATH 103A,B01,083779,Greenfeld; Be'Eri,7,0,36,29
1657651896468,MATH 103A,B02,083780,Greenfeld; Be'Eri,4,0,36,32
1657651896468,MATH 103A,B03,093562,Greenfeld; Be'Eri,3,0,36,33
1657651902491,MATH 105,A01,085443,Carter; Anne Toulson,15,0,35,20
1657651902491,MATH 105,A02,093477,Carter; Anne Toulson,20,0,35,15
1657651908515,MATH 109,A01,083213,Ganzberger; Geoffrey Michael,2,0,34,32
1657651908515,MATH 109,A02,083214,Ganzberger; Geoffrey Michael,4,0,34,30
1657651908515,MATH 109,A03,093478,Ganzberger; Geoffrey Michael,2,0,34,32
1657651908515,MATH 109,B01,083215,Ganzberger; Geoffrey Michael,1,0,32,31
1657651908515,MATH 109,B02,083216,Ganzberger; Geoffrey Michael,2,0,32,30
1657651908515,MATH 109,B03,093479,Ganzberger; Geoffrey Michael,8,0,32,24
1657651914633,MATH 142A,A01,083219,Chow; Bennett,7,0,32,25
1657651914633,MATH 142A,A02,083220,Chow; Bennett,10,0,32,22
1657651914633,MATH 142A,A03,093480,Chow; Bennett,9,0,32,23
1657651914633,MATH 142A,B03,093481,Chow; Bennett,8,0,32,24
1657651914633,MATH 142A,B04,093558,Chow; Bennett,13,0,32,19
1657651914633,MATH 142A,B05,093559,Chow; Bennett,6,0,32,26
1657651920656,MATH 193A,A01,083224,Rotar; Vladimir,8,0,34,26
1657651920656,MATH 193A,A02,083225,Rotar; Vladimir,9,0,34,25
1657651920656,MATH 193A,A03,083781,Rotar; Vladimir,5,0,34,29
1657651920656,MATH 193A,A04,083782,Rotar; Vladimir,10,0,34,24
1657651920656,MATH 193A,A05,093482,Rotar; Vladimir,10,0,34,24
1657651926682,MATH 197,001,091859,McAuley; Julian John,9999,0,9999,0
1657651926682,MATH 197,002,095566,Kedlaya; Kiran S.,9997,0,9999,2
1657651926682,MATH 197,003,095567,Xiao; Ming,9999,0,9999,0
1657651926682,MATH 197,004,095571,Perols; Johan Lars,9998,0,9999,1
1657651933753,COGS 9,A01,083615,Shannon; Kyle Michael,9,0,75,66
1657651939775,COGS 11,A01,083617,Boyle; Mary E. T.,23,0,48,25
1657651945797,COGS 13,A01,083071,Bastos; Amalia Pinkusfeld,11,0,71,60
1657651951837,COGS 14A,A01,092681,Semenuks; Arturs,5,1,100,95
1657651957865,COGS 14B,A01,083073,Cheng; Tzu-Han,6,0,63,57
1657651963898,COGS 17,A01,092677,Semenuks; Arturs,6,0,81,75
1657651969923,COGS 100,A01,083619,Allen; Michael Gordon,17,0,70,53
1657651975950,COGS 101A,A01,083621,Davis; Joshua Daniel,9,0,68,59
1657651981977,COGS 101B,A01,091572,Allen; Michael Gordon,12,0,65,53
1657651988001,COGS 101C,A01,083625,Delgado; Tania,17,0,35,18
1657651994028,COGS 107A,A01,083627,Boyle; Mary E. T.,13,0,60,47
1657652000051,COGS 118A,A01,083075,Gupta; Anjum,21,0,76,55
1657652006075,CSE 3,A50,083646,Miranda; Gregory Joseph,24,0,50,26
1657652012102,CSE 8A,A50,083650,Miranda; Gregory Joseph,17,1,56,39
1657652018129,CSE 11,A01,083080,Cao; Yingjun,6,15,40,34
1657652024159,CSE 12,A01,083652,Krause-Levy; Sophia Louisa,28,1,120,92
1657652030184,CSE 15L,A01,083654,Morris; Justin Loren,9,0,50,41
1657652030184,CSE 15L,A02,083655,Morris; Justin Loren,9,0,50,41
1657652036207,CSE 20,A01,083657,Tran; Khoa Dang,39,0,80,41
1657652042238,CSE 21,A01,095574,Bach; Quang Tran,22,0,48,26
1657652048260,CSE 30,A01,083084,Eldon; John,6,0,80,74
1657652048260,CSE 30,B01,095061,Bhaskar; Nishant,9,0,50,41
1657652054284,CSE 100,A01,083659,Cao; Yingjun,5,4,70,65
1657652060306,CSE 134B,A01,083661,Powell; Thomas Allan,23,0,100,77
1657652066333,CSE 140,A01,083663,Gungor; Onat,15,0,85,70
1657652072356,CSE 140L,A01,083088,Eldon; John,21,0,100,79
1657652078386,CSE 175,A01,083665,Kumar; Rakesh,3,0,25,22
1657652084410,CSE 190,A00,092507,Dubnov; Shlomo,8,0,20,12
1657652090432,ECE 45,A01,083139,Congero; Spencer William,6,0,75,69
1657652096461,ECE 65,A50,083695,Saad; Andrew S,12,0,30,18
1657652096461,ECE 65,A51,095125,Saad; Andrew S,24,0,26,2
1657652102487,ECE 109,A01,091882,Touri; Behrouz,19,0,70,51
1657652108510,ECE 180,A00,083140,Abi Samra; Nicholas Camill,1,0,30,29
1657652108510,ECE 180,B00,083141,Abi Samra; Nicholas Camill,0,0,30,30
1657652114538,MATH 10A,A01,083735,Patchell; Gregory David,2,0,30,28
1657652114538,MATH 10A,A02,083736,Patchell; Gregory David,20,0,30,10
1657652114538,MATH 10A,A03,083737,Patchell; Gregory David,16,0,30,14
1657652120572,MATH 10B,A01,083207,Lim; Seonhee,8,0,34,26
1657652120572,MATH 10B,A02,083208,Lim; Seonhee,9,0,35,26
1657652120572,MATH 10B,A03,093472,Lim; Seonhee,7,0,34,27
1657652120572,MATH 10B,B01,083739,Sinha; Shubham,12,0,30,18
1657652126595,MATH 18,A01,083743,Cinel; Cameron Alexander,7,0,30,23
1657652126595,MATH 18,A02,083744,Cinel; Cameron Alexander,17,0,30,13
1657652126595,MATH 18,A03,083745,Cinel; Cameron Alexander,10,0,30,20
1657652126595,MATH 18,B01,083748,Rideout; David Porter,5,0,37,32
1657652126595,MATH 18,B02,083749,Rideout; David Porter,5,0,36,31
1657652126595,MATH 18,B03,083750,Rideout; David Porter,3,0,37,34
1657652126595,MATH 18,B04,083751,Rideout; David Porter,6,0,36,30
1657652126595,MATH 18,B05,093473,Rideout; David Porter,6,0,36,30
1657652126595,MATH 18,B06,093474,Rideout; David Porter,6,0,36,30
1657652132622,MATH 20A,A01,083754,Zheng; Zequn,14,0,40,26
1657652138644,MATH 20B,A01,083756,Briones; Jor-el Thomas Caparas,4,0,36,32
1657652138644,MATH 20B,A02,083757,Briones; Jor-el Thomas Caparas,1,0,36,35
1657652138644,MATH 20B,A03,093475,Briones; Jor-el Thomas Caparas,2,0,36,34
1657652144672,MATH 20C,A01,083760,Briones; Jor-el Thomas Caparas,1,0,35,34
1657652144672,MATH 20C,A02,083761,Briones; Jor-el Thomas Caparas,8,0,35,27
1657652144672,MATH 20C,A03,093476,Briones; Jor-el Thomas Caparas,0,1,36,36
1657652144672,MATH 20C,B01,083762,Bach; Quang Tran,1,0,30,29
1657652150700,MATH 20D,A01,083765,Tran; Brian Kha,5,0,30,25
1657652150700,MATH 20D,A02,083766,Tran; Brian Kha,5,0,30,25
1657652150700,MATH 20D,A03,083767,Tran; Brian Kha,5,0,30,25
1657652156728,MATH 20E,A01,083771,Ganguly; Soumya,9,0,32,23
1657652156728,MATH 20E,A02,083772,Ganguly; Soumya,6,0,32,26
1657652156728,MATH 20E,B01,083773,Ciotti; Benjamin,20,0,35,15
1657652156728,MATH 20E,B02,083774,Ciotti; Benjamin,18,0,35,17
1657652162757,MATH 103A,A01,083777,Greenfeld; Be'Eri,3,0,36,33
1657652162757,MATH 103A,A02,083778,Greenfeld; Be'Eri,5,0,36,31
1657652162757,MATH 103A,A03,093561,Greenfeld; Be'Eri,6,0,36,30
1657652162757,MATH 103A,B01,083779,Greenfeld; Be'Eri,7,0,36,29
1657652162757,MATH 103A,B02,083780,Greenfeld; Be'Eri,4,0,36,32
1657652162757,MATH 103A,B03,093562,Greenfeld; Be'Eri,3,0,36,33
1657652168780,MATH 105,A01,085443,Carter; Anne Toulson,15,0,35,20
1657652168780,MATH 105,A02,093477,Carter; Anne Toulson,20,0,35,15
1657652174805,MATH 109,A01,083213,Ganzberger; Geoffrey Michael,2,0,34,32
1657652174805,MATH 109,A02,083214,Ganzberger; Geoffrey Michael,4,0,34,30
1657652174805,MATH 109,A03,093478,Ganzberger; Geoffrey Michael,2,0,34,32
1657652174805,MATH 109,B01,083215,Ganzberger; Geoffrey Michael,1,0,32,31
1657652174805,MATH 109,B02,083216,Ganzberger; Geoffrey Michael,2,0,32,30
1657652174805,MATH 109,B03,093479,Ganzberger; Geoffrey Michael,8,0,32,24
1657652180828,MATH 142A,A01,083219,Chow; Bennett,7,0,32,25
1657652180828,MATH 142A,A02,083220,Chow; Bennett,10,0,32,22
1657652180828,MATH 142A,A03,093480,Chow; Bennett,9,0,32,23
1657652180828,MATH 142A,B03,093481,Chow; Bennett,8,0,32,24
1657652180828,MATH 142A,B04,093558,Chow; Bennett,13,0,32,19
1657652180828,MATH 142A,B05,093559,Chow; Bennett,6,0,32,26
1657652186852,MATH 193A,A01,083224,Rotar; Vladimir,8,0,34,26
1657652186852,MATH 193A,A02,083225,Rotar; Vladimir,9,0,34,25
1657652186852,MATH 193A,A03,083781,Rotar; Vladimir,5,0,34,29
1657652186852,MATH 193A,A04,083782,Rotar; Vladimir,10,0,34,24
1657652186852,MATH 193A,A05,093482,Rotar; Vladimir,10,0,34,24
1657652192880,MATH 197,001,091859,McAuley; Julian John,9999,0,9999,0
1657652192880,MATH 197,002,095566,Kedlaya; Kiran S.,9997,0,9999,2
1657652192880,MATH 197,003,095567,Xiao; Ming,9999,0,9999,0
1657652192880,MATH 197,004,095571,Perols; Johan Lars,9998,0,9999,1
1657652199936,COGS 9,A01,083615,Shannon; Kyle Michael,9,0,75,66
1657652205978,COGS 11,A01,083617,Boyle; Mary E. T.,23,0,48,25
1657652212005,COGS 13,A01,083071,Bastos; Amalia Pinkusfeld,11,0,71,60
1657652218031,COGS 14A,A01,092681,Semenuks; Arturs,5,1,100,95
1657652224054,COGS 14B,A01,083073,Cheng; Tzu-Han,6,0,63,57
1657652230077,COGS 17,A01,092677,Semenuks; Arturs,6,0,81,75
1657652236103,COGS 100,A01,083619,Allen; Michael Gordon,17,0,70,53
1657652242125,COGS 101A,A01,083621,Davis; Joshua Daniel,9,0,68,59
1657652248149,COGS 101B,A01,091572,Allen; Michael Gordon,12,0,65,53
1657652254180,COGS 101C,A01,083625,Delgado; Tania,17,0,35,18
1657652260209,COGS 107A,A01,083627,Boyle; Mary E. T.,13,0,60,47
1657652266232,COGS 118A,A01,083075,Gupta; Anjum,21,0,76,55
1657652272258,CSE 3,A50,083646,Miranda; Gregory Joseph,24,0,50,26
1657652278285,CSE 8A,A50,083650,Miranda; Gregory Joseph,17,1,56,39
1657652284310,CSE 11,A01,083080,Cao; Yingjun,6,15,40,34
1657652290335,CSE 12,A01,083652,Krause-Levy; Sophia Louisa,28,1,120,92
1657652296359,CSE 15L,A01,083654,Morris; Justin Loren,9,0,50,41
1657652296359,CSE 15L,A02,083655,Morris; Justin Loren,9,0,50,41
1657652302386,CSE 20,A01,083657,Tran; Khoa Dang,39,0,80,41
1657652308428,CSE 21,A01,095574,Bach; Quang Tran,22,0,48,26
1657652314455,CSE 30,A01,083084,Eldon; John,6,0,80,74
1657652314455,CSE 30,B01,095061,Bhaskar; Nishant,9,0,50,41
1657652320477,CSE 100,A01,083659,Cao; Yingjun,5,4,70,65
1657652326504,CSE 134B,A01,083661,Powell; Thomas Allan,23,0,100,77
1657652332526,CSE 140,A01,083663,Gungor; Onat,15,0,85,70
1657652338553,CSE 140L,A01,083088,Eldon; John,21,0,100,79
1657652344578,CSE 175,A01,083665,Kumar; Rakesh,3,0,25,22
1657652350602,CSE 190,A00,092507,Dubnov; Shlomo,8,0,20,12
1657652356629,ECE 45,A01,083139,Congero; Spencer William,6,0,75,69
1657652362653,ECE 65,A50,083695,Saad; Andrew S,12,0,30,18
1657652362653,ECE 65,A51,095125,Saad; Andrew S,24,0,26,2
1657652368703,ECE 109,A01,091882,Touri; Behrouz,19,0,70,51
1657652374727,ECE 180,A00,083140,Abi Samra; Nicholas Camill,1,0,30,29
1657652374727,ECE 180,B00,083141,Abi Samra; Nicholas Camill,0,0,30,30
1657652380750,MATH 10A,A01,083735,Patchell; Gregory David,2,0,30,28
1657652380750,MATH 10A,A02,083736,Patchell; Gregory David,20,0,30,10
1657652380750,MATH 10A,A03,083737,Patchell; Gregory David,16,0,30,14
1657652386774,MATH 10B,A01,083207,Lim; Seonhee,8,0,34,26
1657652386774,MATH 10B,A02,083208,Lim; Seonhee,9,0,35,26
1657652386774,MATH 10B,A03,093472,Lim; Seonhee,7,0,34,27
1657652386774,MATH 10B,B01,083739,Sinha; Shubham,12,0,30,18
1657652392807,MATH 18,A01,083743,Cinel; Cameron Alexander,7,0,30,23
1657652392807,MATH 18,A02,083744,Cinel; Cameron Alexander,17,0,30,13
1657652392807,MATH 18,A03,083745,Cinel; Cameron Alexander,10,0,30,20
1657652392807,MATH 18,B01,083748,Rideout; David Porter,5,0,37,32
1657652392807,MATH 18,B02,083749,Rideout; David Porter,5,0,36,31
1657652392807,MATH 18,B03,083750,Rideout; David Porter,3,0,37,34
1657652392807,MATH 18,B04,083751,Rideout; David Porter,6,0,36,30
1657652392807,MATH 18,B05,093473,Rideout; David Porter,6,0,36,30
1657652392807,MATH 18,B06,093474,Rideout; David Porter,6,0,36,30
1657652398836,MATH 20A,A01,083754,Zheng; Zequn,14,0,40,26
1657652404865,MATH 20B,A01,083756,Briones; Jor-el Thomas Caparas,4,0,36,32
1657652404865,MATH 20B,A02,083757,Briones; Jor-el Thomas Caparas,1,0,36,35
1657652404865,MATH 20B,A03,093475,Briones; Jor-el Thomas Caparas,2,0,36,34
1657652410950,MATH 20C,A01,083760,Briones; Jor-el Thomas Caparas,1,0,35,34
1657652410950,MATH 20C,A02,083761,Briones; Jor-el Thomas Caparas,8,0,35,27
1657652410950,MATH 20C,A03,093476,Briones; Jor-el Thomas Caparas,0,1,36,36
1657652410950,MATH 20C,B01,083762,Bach; Quang Tran,1,0,30,29
1657652416980,MATH 20D,A01,083765,Tran; Brian Kha,5,0,30,25
1657652416980,MATH 20D,A02,083766,Tran; Brian Kha,5,0,30,25
1657652416980,MATH 20D,A03,083767,Tran; Brian Kha,5,0,30,25
1657652423018,MATH 20E,A01,083771,Ganguly; Soumya,9,0,32,23
1657652423018,MATH 20E,A02,083772,Ganguly; Soumya,6,0,32,26
1657652423018,MATH 20E,B01,083773,Ciotti; Benjamin,20,0,35,15
1657652423018,MATH 20E,B02,083774,Ciotti; Benjamin,18,0,35,17
1657652429041,MATH 103A,A01,083777,Greenfeld; Be'Eri,3,0,36,33
1657652429041,MATH 103A,A02,083778,Greenfeld; Be'Eri,5,0,36,31
1657652429041,MATH 103A,A03,093561,Greenfeld; Be'Eri,6,0,36,30
1657652429041,MATH 103A,B01,083779,Greenfeld; Be'Eri,7,0,36,29
1657652429041,MATH 103A,B02,083780,Greenfeld; Be'Eri,4,0,36,32
1657652429041,MATH 103A,B03,093562,Greenfeld; Be'Eri,3,0,36,33
1657652435066,MATH 105,A01,085443,Carter; Anne Toulson,15,0,35,20
1657652435066,MATH 105,A02,093477,Carter; Anne Toulson,20,0,35,15
1657652441095,MATH 109,A01,083213,Ganzberger; Geoffrey Michael,2,0,34,32
1657652441095,MATH 109,A02,083214,Ganzberger; Geoffrey Michael,4,0,34,30
1657652441095,MATH 109,A03,093478,Ganzberger; Geoffrey Michael,2,0,34,32
1657652441095,MATH 109,B01,083215,Ganzberger; Geoffrey Michael,1,0,32,31
1657652441095,MATH 109,B02,083216,Ganzberger; Geoffrey Michael,2,0,32,30
1657652441095,MATH 109,B03,093479,Ganzberger; Geoffrey Michael,8,0,32,24
1657652447120,MATH 142A,A01,083219,Chow; Bennett,7,0,32,25
1657652447120,MATH 142A,A02,083220,Chow; Bennett,10,0,32,22
1657652447120,MATH 142A,A03,093480,Chow; Bennett,9,0,32,23
1657652447120,MATH 142A,B03,093481,Chow; Bennett,8,0,32,24
1657652447120,MATH 142A,B04,093558,Chow; Bennett,13,0,32,19
1657652447120,MATH 142A,B05,093559,Chow; Bennett,6,0,32,26
1657652453151,MATH 193A,A01,083224,Rotar; Vladimir,8,0,34,26
1657652453151,MATH 193A,A02,083225,Rotar; Vladimir,9,0,34,25
1657652453151,MATH 193A,A03,083781,Rotar; Vladimir,5,0,34,29
1657652453151,MATH 193A,A04,083782,Rotar; Vladimir,10,0,34,24
1657652453151,MATH 193A,A05,093482,Rotar; Vladimir,10,0,34,24
1657652459182,MATH 197,001,091859,McAuley; Julian John,9999,0,9999,0
1657652459182,MATH 197,002,095566,Kedlaya; Kiran S.,9997,0,9999,2
1657652459182,MATH 197,003,095567,Xiao; Ming,9999,0,9999,0
1657652459182,MATH 197,004,095571,Perols; Johan Lars,9998,0,9999,1
1657652466250,COGS 9,A01,083615,Shannon; Kyle Michael,9,0,75,66
1657652472277,COGS 11,A01,083617,Boyle; Mary E. T.,23,0,48,25
1657652478306,COGS 13,A01,083071,Bastos; Amalia Pinkusfeld,11,0,71,60
1657652484332,COGS 14A,A01,092681,Semenuks; Arturs,5,1,100,95
1657652490353,COGS 14B,A01,083073,Cheng; Tzu-Han,6,0,63,57
1657652496377,COGS 17,A01,092677,Semenuks; Arturs,6,0,81,75
1657652502399,COGS 100,A01,083619,Allen; Michael Gordon,17,0,70,53
1657652508495,COGS 101A,A01,083621,Davis; Joshua Daniel,9,0,68,59
1657652514526,COGS 101B,A01,091572,Allen; Michael Gordon,12,0,65,53
1657652520562,COGS 101C,A01,083625,Delgado; Tania,17,0,35,18
1657652526590,COGS 107A,A01,083627,Boyle; Mary E. T.,13,0,60,47
1657652532616,COGS 118A,A01,083075,Gupta; Anjum,21,0,76,55
1657652538639,CSE 3,A50,083646,Miranda; Gregory Joseph,24,0,50,26
1657652544672,CSE 8A,A50,083650,Miranda; Gregory Joseph,17,1,56,39
1657652550703,CSE 11,A01,083080,Cao; Yingjun,6,15,40,34
1657652556727,CSE 12,A01,083652,Krause-Levy; Sophia Louisa,28,1,120,92
1657652562748,CSE 15L,A01,083654,Morris; Justin Loren,9,0,50,41
1657652562748,CSE 15L,A02,083655,Morris; Justin Loren,9,0,50,41
1657652568774,CSE 20,A01,083657,Tran; Khoa Dang,39,0,80,41
1657652574800,CSE 21,A01,095574,Bach; Quang Tran,22,0,48,26
1657652580823,CSE 30,A01,083084,Eldon; John,6,0,80,74
1657652580823,CSE 30,B01,095061,Bhaskar; Nishant,9,0,50,41
1657652586858,CSE 100,A01,083659,Cao; Yingjun,5,4,70,65
1657652592889,CSE 134B,A01,083661,Powell; Thomas Allan,23,0,100,77
1657652598913,CSE 140,A01,083663,Gungor; Onat,15,0,85,70
1657652604938,CSE 140L,A01,083088,Eldon; John,21,0,100,79
1657652610963,CSE 175,A01,083665,Kumar; Rakesh,3,0,25,22
1657652616989,CSE 190,A00,092507,Dubnov; Shlomo,8,0,20,12
1657652623014,ECE 45,A01,083139,Congero; Spencer William,6,0,75,69
1657652629037,ECE 65,A50,083695,Saad; Andrew S,12,0,30,18
1657652629037,ECE 65,A51,095125,Saad; Andrew S,24,0,26,2
1657652635058,ECE 109,A01,091882,Touri; Behrouz,19,0,70,51
1657652641090,ECE 180,A00,083140,Abi Samra; Nicholas Camill,1,0,30,29
1657652641090,ECE 180,B00,083141,Abi Samra; Nicholas Camill,0,0,30,30
1657652647123,MATH 10A,A01,083735,Patchell; Gregory David,2,0,30,28
1657652647123,MATH 10A,A02,083736,Patchell; Gregory David,20,0,30,10
1657652647123,MATH 10A,A03,083737,Patchell; Gregory David,16,0,30,14
1657652653157,MATH 10B,A01,083207,Lim; Seonhee,8,0,34,26
1657652653157,MATH 10B,A02,083208,Lim; Seonhee,9,0,35,26
1657652653157,MATH 10B,A03,093472,Lim; Seonhee,7,0,34,27
1657652653157,MATH 10B,B01,083739,Sinha; Shubham,12,0,30,18
1657652659189,MATH 18,A01,083743,Cinel; Cameron Alexander,7,0,30,23
1657652659189,MATH 18,A02,083744,Cinel; Cameron Alexander,17,0,30,13
1657652659189,MATH 18,A03,083745,Cinel; Cameron Alexander,10,0,30,20
1657652659189,MATH 18,B01,083748,Rideout; David Porter,5,0,37,32
1657652659189,MATH 18,B02,083749,Rideout; David Porter,5,0,36,31
1657652659189,MATH 18,B03,083750,Rideout; David Porter,3,0,37,34
1657652659189,MATH 18,B04,083751,Rideout; David Porter,6,0,36,30
1657652659189,MATH 18,B05,093473,Rideout; David Porter,6,0,36,30
1657652659189,MATH 18,B06,093474,Rideout; David Porter,6,0,36,30
1657652665215,MATH 20A,A01,083754,Zheng; Zequn,14,0,40,26
1657652671237,MATH 20B,A01,083756,Briones; Jor-el Thomas Caparas,4,0,36,32
1657652671237,MATH 20B,A02,083757,Briones; Jor-el Thomas Caparas,1,0,36,35
1657652671237,MATH 20B,A03,093475,Briones; Jor-el Thomas Caparas,2,0,36,34
1657652677261,MATH 20C,A01,083760,Briones; Jor-el Thomas Caparas,1,0,35,34
1657652677261,MATH 20C,A02,083761,Briones; Jor-el Thomas Caparas,8,0,35,27
1657652677261,MATH 20C,A03,093476,Briones; Jor-el Thomas Caparas,0,1,36,36
1657652677261,MATH 20C,B01,083762,Bach; Quang Tran,1,0,30,29
1657652683288,MATH 20D,A01,083765,Tran; Brian Kha,5,0,30,25
1657652683288,MATH 20D,A02,083766,Tran; Brian Kha,5,0,30,25
1657652683288,MATH 20D,A03,083767,Tran; Brian Kha,5,0,30,25
1657652689314,MATH 20E,A01,083771,Ganguly; Soumya,9,0,32,23
1657652689314,MATH 20E,A02,083772,Ganguly; Soumya,6,0,32,26
1657652689314,MATH 20E,B01,083773,Ciotti; Benjamin,20,0,35,15
1657652689314,MATH 20E,B02,083774,Ciotti; Benjamin,18,0,35,17
1657652695338,MATH 103A,A01,083777,Greenfeld; Be'Eri,3,0,36,33
1657652695338,MATH 103A,A02,083778,Greenfeld; Be'Eri,5,0,36,31
1657652695338,MATH 103A,A03,093561,Greenfeld; Be'Eri,6,0,36,30
1657652695338,MATH 103A,B01,083779,Greenfeld; Be'Eri,7,0,36,29
1657652695338,MATH 103A,B02,083780,Greenfeld; Be'Eri,4,0,36,32
1657652695338,MATH 103A,B03,093562,Greenfeld; Be'Eri,3,0,36,33
1657652701368,MATH 105,A01,085443,Carter; Anne Toulson,15,0,35,20
1657652701368,MATH 105,A02,093477,Carter; Anne Toulson,20,0,35,15
1657652707396,MATH 109,A01,083213,Ganzberger; Geoffrey Michael,2,0,34,32
1657652707396,MATH 109,A02,083214,Ganzberger; Geoffrey Michael,4,0,34,30
1657652707396,MATH 109,A03,093478,Ganzberger; Geoffrey Michael,2,0,34,32
1657652707396,MATH 109,B01,083215,Ganzberger; Geoffrey Michael,1,0,32,31
1657652707396,MATH 109,B02,083216,Ganzberger; Geoffrey Michael,2,0,32,30
1657652707396,MATH 109,B03,093479,Ganzberger; Geoffrey Michael,8,0,32,24
1657652713419,MATH 142A,A01,083219,Chow; Bennett,7,0,32,25
1657652713419,MATH 142A,A02,083220,Chow; Bennett,10,0,32,22
1657652713419,MATH 142A,A03,093480,Chow; Bennett,9,0,32,23
1657652713419,MATH 142A,B03,093481,Chow; Bennett,8,0,32,24
1657652713419,MATH 142A,B04,093558,Chow; Bennett,13,0,32,19
1657652713419,MATH 142A,B05,093559,Chow; Bennett,6,0,32,26
1657652719442,MATH 193A,A01,083224,Rotar; Vladimir,8,0,34,26
1657652719442,MATH 193A,A02,083225,Rotar; Vladimir,9,0,34,25
1657652719442,MATH 193A,A03,083781,Rotar; Vladimir,5,0,34,29
1657652719442,MATH 193A,A04,083782,Rotar; Vladimir,10,0,34,24
1657652719442,MATH 193A,A05,093482,Rotar; Vladimir,10,0,34,24
1657652725465,MATH 197,001,091859,McAuley; Julian John,9999,0,9999,0
1657652725465,MATH 197,002,095566,Kedlaya; Kiran S.,9997,0,9999,2
1657652725465,MATH 197,003,095567,Xiao; Ming,9999,0,9999,0
1657652725465,MATH 197,004,095571,Perols; Johan Lars,9998,0,9999,1
1657652732529,COGS 9,A01,083615,Shannon; Kyle Michael,9,0,75,66
1657652738551,COGS 11,A01,083617,Boyle; Mary E. T.,23,0,48,25
1657652744573,COGS 13,A01,083071,Bastos; Amalia Pinkusfeld,11,0,71,60
1657652750595,COGS 14A,A01,092681,Semenuks; Arturs,5,1,100,95
1657652756623,COGS 14B,A01,083073,Cheng; Tzu-Han,6,0,63,57
1657652762649,COGS 17,A01,092677,Semenuks; Arturs,6,0,81,75
1657652768671,COGS 100,A01,083619,Allen; Michael Gordon,17,0,70,53
1657652774694,COGS 101A,A01,083621,Davis; Joshua Daniel,9,0,68,59
1657652780718,COGS 101B,A01,091572,Allen; Michael Gordon,12,0,65,53
1657652786740,COGS 101C,A01,083625,Delgado; Tania,17,0,35,18
1657652792766,COGS 107A,A01,083627,Boyle; Mary E. T.,13,0,60,47
1657652798794,COGS 118A,A01,083075,Gupta; Anjum,21,0,76,55
1657652804818,CSE 3,A50,083646,Miranda; Gregory Joseph,24,0,50,26
1657652810854,CSE 8A,A50,083650,Miranda; Gregory Joseph,17,1,56,39
1657652816879,CSE 11,A01,083080,Cao; Yingjun,6,15,40,34
1657652822902,CSE 12,A01,083652,Krause-Levy; Sophia Louisa,28,1,120,92
1657652828929,CSE 15L,A01,083654,Morris; Justin Loren,9,0,50,41
1657652828929,CSE 15L,A02,083655,Morris; Justin Loren,9,0,50,41
1657652834955,CSE 20,A01,083657,Tran; Khoa Dang,39,0,80,41
1657652840979,CSE 21,A01,095574,Bach; Quang Tran,22,0,48,26
1657652847009,CSE 30,A01,083084,Eldon; John,6,0,80,74
1657652847009,CSE 30,B01,095061,Bhaskar; Nishant,9,0,50,41
1657652853035,CSE 100,A01,083659,Cao; Yingjun,5,4,70,65
1657652859064,CSE 134B,A01,083661,Powell; Thomas Allan,23,0,100,77
1657652865090,CSE 140,A01,083663,Gungor; Onat,15,0,85,70
1657652871118,CSE 140L,A01,083088,Eldon; John,21,0,100,79
1657652877144,CSE 175,A01,083665,Kumar; Rakesh,3,0,25,22
1657652883184,CSE 190,A00,092507,Dubnov; Shlomo,8,0,20,12
1657652889215,ECE 45,A01,083139,Congero; Spencer William,6,0,75,69
1657652895239,ECE 65,A50,083695,Saad; Andrew S,12,0,30,18
1657652895239,ECE 65,A51,095125,Saad; Andrew S,24,0,26,2
1657652901262,ECE 109,A01,091882,Touri; Behrouz,19,0,70,51
1657652907292,ECE 180,A00,083140,Abi Samra; Nicholas Camill,1,0,30,29
1657652907292,ECE 180,B00,083141,Abi Samra; Nicholas Camill,0,0,30,30
1657652913320,MATH 10A,A01,083735,Patchell; Gregory David,2,0,30,28
1657652913320,MATH 10A,A02,083736,Patchell; Gregory David,20,0,30,10
1657652913320,MATH 10A,A03,083737,Patchell; Gregory David,16,0,30,14
1657652919357,MATH 10B,A01,083207,Lim; Seonhee,8,0,34,26
1657652919357,MATH 10B,A02,083208,Lim; Seonhee,9,0,35,26
1657652919357,MATH 10B,A03,093472,Lim; Seonhee,7,0,34,27
1657652919357,MATH 10B,B01,083739,Sinha; Shubham,12,0,30,18
1657652925382,MATH 18,A01,083743,Cinel; Cameron Alexander,7,0,30,23
1657652925382,MATH 18,A02,083744,Cinel; Cameron Alexander,17,0,30,13
1657652925382,MATH 18,A03,083745,Cinel; Cameron Alexander,10,0,30,20
1657652925382,MATH 18,B01,083748,Rideout; David Porter,5,0,37,32
1657652925382,MATH 18,B02,083749,Rideout; David Porter,5,0,36,31
1657652925382,MATH 18,B03,083750,Rideout; David Porter,3,0,37,34
1657652925382,MATH 18,B04,083751,Rideout; David Porter,6,0,36,30
1657652925382,MATH 18,B05,093473,Rideout; David Porter,6,0,36,30
1657652925382,MATH 18,B06,093474,Rideout; David Porter,6,0,36,30
1657652931404,MATH 20A,A01,083754,Zheng; Zequn,14,0,40,26
1657652937427,MATH 20B,A01,083756,Briones; Jor-el Thomas Caparas,4,0,36,32
1657652937427,MATH 20B,A02,083757,Briones; Jor-el Thomas Caparas,1,0,36,35
1657652937427,MATH 20B,A03,093475,Briones; Jor-el Thomas Caparas,2,0,36,34
1657652943451,MATH 20C,A01,083760,Briones; Jor-el Thomas Caparas,1,0,35,34
1657652943451,MATH 20C,A02,083761,Briones; Jor-el Thomas Caparas,8,0,35,27
1657652943451,MATH 20C,A03,093476,Briones; Jor-el Thomas Caparas,0,1,36,36
1657652943451,MATH 20C,B01,083762,Bach; Quang Tran,1,0,30,29
1657652949478,MATH 20D,A01,083765,Tran; Brian Kha,5,0,30,25
1657652949478,MATH 20D,A02,083766,Tran; Brian Kha,5,0,30,25
1657652949478,MATH 20D,A03,083767,Tran; Brian Kha,5,0,30,25
1657652955501,MATH 20E,A01,083771,Ganguly; Soumya,9,0,32,23
1657652955501,MATH 20E,A02,083772,Ganguly; Soumya,6,0,32,26
1657652955501,MATH 20E,B01,083773,Ciotti; Benjamin,20,0,35,15
1657652955501,MATH 20E,B02,083774,Ciotti; Benjamin,18,0,35,17
1657652961531,MATH 103A,A01,083777,Greenfeld; Be'Eri,3,0,36,33
1657652961531,MATH 103A,A02,083778,Greenfeld; Be'Eri,5,0,36,31
1657652961531,MATH 103A,A03,093561,Greenfeld; Be'Eri,6,0,36,30
1657652961531,MATH 103A,B01,083779,Greenfeld; Be'Eri,7,0,36,29
1657652961531,MATH 103A,B02,083780,Greenfeld; Be'Eri,4,0,36,32
1657652961531,MATH 103A,B03,093562,Greenfeld; Be'Eri,3,0,36,33
1657652967554,MATH 105,A01,085443,Carter; Anne Toulson,15,0,35,20
1657652967554,MATH 105,A02,093477,Carter; Anne Toulson,20,0,35,15
1657652973582,MATH 109,A01,083213,Ganzberger; Geoffrey Michael,2,0,34,32
1657652973582,MATH 109,A02,083214,Ganzberger; Geoffrey Michael,4,0,34,30
1657652973582,MATH 109,A03,093478,Ganzberger; Geoffrey Michael,2,0,34,32
1657652973582,MATH 109,B01,083215,Ganzberger; Geoffrey Michael,1,0,32,31
1657652973582,MATH 109,B02,083216,Ganzberger; Geoffrey Michael,2,0,32,30
1657652973582,MATH 109,B03,093479,Ganzberger; Geoffrey Michael,8,0,32,24
1657652979619,MATH 142A,A01,083219,Chow; Bennett,7,0,32,25
1657652979619,MATH 142A,A02,083220,Chow; Bennett,10,0,32,22
1657652979619,MATH 142A,A03,093480,Chow; Bennett,9,0,32,23
1657652979619,MATH 142A,B03,093481,Chow; Bennett,8,0,32,24
1657652979619,MATH 142A,B04,093558,Chow; Bennett,13,0,32,19
1657652979619,MATH 142A,B05,093559,Chow; Bennett,6,0,32,26
1657652985678,MATH 193A,A01,083224,Rotar; Vladimir,8,0,34,26
1657652985678,MATH 193A,A02,083225,Rotar; Vladimir,9,0,34,25
1657652985678,MATH 193A,A03,083781,Rotar; Vladimir,5,0,34,29
1657652985678,MATH 193A,A04,083782,Rotar; Vladimir,10,0,34,24
1657652985678,MATH 193A,A05,093482,Rotar; Vladimir,10,0,34,24
1657652991702,MATH 197,001,091859,McAuley; Julian John,9999,0,9999,0
1657652991702,MATH 197,002,095566,Kedlaya; Kiran S.,9997,0,9999,2
1657652991702,MATH 197,003,095567,Xiao; Ming,9999,0,9999,0
1657652991702,MATH 197,004,095571,Perols; Johan Lars,9998,0,9999,1
1657652998758,COGS 9,A01,083615,Shannon; Kyle Michael,9,0,75,66
1657653004791,COGS 11,A01,083617,Boyle; Mary E. T.,23,0,48,25
1657653010823,COGS 13,A01,083071,Bastos; Amalia Pinkusfeld,11,0,71,60
1657653016855,COGS 14A,A01,092681,Semenuks; Arturs,5,1,100,95
1657653022878,COGS 14B,A01,083073,Cheng; Tzu-Han,6,0,63,57
1657653028901,COGS 17,A01,092677,Semenuks; Arturs,6,0,81,75
1657653034936,COGS 100,A01,083619,Allen; Michael Gordon,17,0,70,53
1657653040959,COGS 101A,A01,083621,Davis; Joshua Daniel,9,0,68,59
1657653046981,COGS 101B,A01,091572,Allen; Michael Gordon,12,0,65,53
1657653053009,COGS 101C,A01,083625,Delgado; Tania,17,0,35,18
1657653059033,COGS 107A,A01,083627,Boyle; Mary E. T.,13,0,60,47
1657653065056,COGS 118A,A01,083075,Gupta; Anjum,21,0,76,55
1657653071090,CSE 3,A50,083646,Miranda; Gregory Joseph,24,0,50,26
1657653077117,CSE 8A,A50,083650,Miranda; Gregory Joseph,17,1,56,39
1657653083145,CSE 11,A01,083080,Cao; Yingjun,6,15,40,34
1657653089172,CSE 12,A01,083652,Krause-Levy; Sophia Louisa,28,1,120,92
1657653095194,CSE 15L,A01,083654,Morris; Justin Loren,9,0,50,41
1657653095194,CSE 15L,A02,083655,Morris; Justin Loren,9,0,50,41
1657653101225,CSE 20,A01,083657,Tran; Khoa Dang,39,0,80,41
1657653107326,CSE 21,A01,095574,Bach; Quang Tran,22,0,48,26
1657653113354,CSE 30,A01,083084,Eldon; John,6,0,80,74
1657653113354,CSE 30,B01,095061,Bhaskar; Nishant,9,0,50,41
1657653119377,CSE 100,A01,083659,Cao; Yingjun,5,4,70,65
1657653125400,CSE 134B,A01,083661,Powell; Thomas Allan,23,0,100,77
1657653131421,CSE 140,A01,083663,Gungor; Onat,15,0,85,70
1657653137460,CSE 140L,A01,083088,Eldon; John,21,0,100,79
1657653143483,CSE 175,A01,083665,Kumar; Rakesh,3,0,25,22
1657653149511,CSE 190,A00,092507,Dubnov; Shlomo,8,0,20,12
1657653155537,ECE 45,A01,083139,Congero; Spencer William,6,0,75,69
1657653161561,ECE 65,A50,083695,Saad; Andrew S,12,0,30,18
1657653161561,ECE 65,A51,095125,Saad; Andrew S,24,0,26,2
1657653167586,ECE 109,A01,091882,Touri; Behrouz,19,0,70,51
1657653173613,ECE 180,A00,083140,Abi Samra; Nicholas Camill,1,0,30,29
1657653173613,ECE 180,B00,083141,Abi Samra; Nicholas Camill,0,0,30,30
1657653179636,MATH 10A,A01,083735,Patchell; Gregory David,2,0,30,28
1657653179636,MATH 10A,A02,083736,Patchell; Gregory David,20,0,30,10
1657653179636,MATH 10A,A03,083737,Patchell; Gregory David,16,0,30,14
1657653185659,MATH 10B,A01,083207,Lim; Seonhee,8,0,34,26
1657653185659,MATH 10B,A02,083208,Lim; Seonhee,9,0,35,26
1657653185659,MATH 10B,A03,093472,Lim; Seonhee,7,0,34,27
1657653185659,MATH 10B,B01,083739,Sinha; Shubham,12,0,30,18
1657653191683,MATH 18,A01,083743,Cinel; Cameron Alexander,7,0,30,23
1657653191683,MATH 18,A02,083744,Cinel; Cameron Alexander,17,0,30,13
1657653191683,MATH 18,A03,083745,Cinel; Cameron Alexander,10,0,30,20
1657653191683,MATH 18,B01,083748,Rideout; David Porter,5,0,37,32
1657653191683,MATH 18,B02,083749,Rideout; David Porter,5,0,36,31
1657653191683,MATH 18,B03,083750,Rideout; David Porter,3,0,37,34
1657653191683,MATH 18,B04,083751,Rideout; David Porter,6,0,36,30
1657653191683,MATH 18,B05,093473,Rideout; David Porter,6,0,36,30
1657653191683,MATH 18,B06,093474,Rideout; David Porter,6,0,36,30
1657653197714,MATH 20A,A01,083754,Zheng; Zequn,14,0,40,26
1657653203740,MATH 20B,A01,083756,Briones; Jor-el Thomas Caparas,4,0,36,32
1657653203740,MATH 20B,A02,083757,Briones; Jor-el Thomas Caparas,1,0,36,35
1657653203740,MATH 20B,A03,093475,Briones; Jor-el Thomas Caparas,2,0,36,34
1657653209765,MATH 20C,A01,083760,Briones; Jor-el Thomas Caparas,1,0,35,34
1657653209765,MATH 20C,A02,083761,Briones; Jor-el Thomas Caparas,8,0,35,27
1657653209765,MATH 20C,A03,093476,Briones; Jor-el Thomas Caparas,0,1,36,36
1657653209765,MATH 20C,B01,083762,Bach; Quang Tran,1,0,30,29
1657653215789,MATH 20D,A01,083765,Tran; Brian Kha,5,0,30,25
1657653215789,MATH 20D,A02,083766,Tran; Brian Kha,5,0,30,25
1657653215789,MATH 20D,A03,083767,Tran; Brian Kha,5,0,30,25
1657653221818,MATH 20E,A01,083771,Ganguly; Soumya,9,0,32,23
1657653221818,MATH 20E,A02,083772,Ganguly; Soumya,6,0,32,26
1657653221818,MATH 20E,B01,083773,Ciotti; Benjamin,20,0,35,15
1657653221818,MATH 20E,B02,083774,Ciotti; Benjamin,18,0,35,17
1657653227842,MATH 103A,A01,083777,Greenfeld; Be'Eri,3,0,36,33
1657653227842,MATH 103A,A02,083778,Greenfeld; Be'Eri,5,0,36,31
1657653227842,MATH 103A,A03,093561,Greenfeld; Be'Eri,6,0,36,30
1657653227842,MATH 103A,B01,083779,Greenfeld; Be'Eri,7,0,36,29
1657653227842,MATH 103A,B02,083780,Greenfeld; Be'Eri,4,0,36,32
1657653227842,MATH 103A,B03,093562,Greenfeld; Be'Eri,3,0,36,33
1657653233866,MATH 105,A01,085443,Carter; Anne Toulson,15,0,35,20
1657653233866,MATH 105,A02,093477,Carter; Anne Toulson,20,0,35,15
1657653239896,MATH 109,A01,083213,Ganzberger; Geoffrey Michael,2,0,34,32
1657653239896,MATH 109,A02,083214,Ganzberger; Geoffrey Michael,4,0,34,30
1657653239896,MATH 109,A03,093478,Ganzberger; Geoffrey Michael,2,0,34,32
1657653239896,MATH 109,B01,083215,Ganzberger; Geoffrey Michael,1,0,32,31
1657653239896,MATH 109,B02,083216,Ganzberger; Geoffrey Michael,2,0,32,30
1657653239896,MATH 109,B03,093479,Ganzberger; Geoffrey Michael,8,0,32,24
1657653245920,MATH 142A,A01,083219,Chow; Bennett,7,0,32,25
1657653245920,MATH 142A,A02,083220,Chow; Bennett,10,0,32,22
1657653245920,MATH 142A,A03,093480,Chow; Bennett,9,0,32,23
1657653245920,MATH 142A,B03,093481,Chow; Bennett,8,0,32,24
1657653245920,MATH 142A,B04,093558,Chow; Bennett,13,0,32,19
1657653245920,MATH 142A,B05,093559,Chow; Bennett,6,0,32,26
1657653251948,MATH 193A,A01,083224,Rotar; Vladimir,8,0,34,26
1657653251948,MATH 193A,A02,083225,Rotar; Vladimir,9,0,34,25
1657653251948,MATH 193A,A03,083781,Rotar; Vladimir,5,0,34,29
1657653251948,MATH 193A,A04,083782,Rotar; Vladimir,10,0,34,24
1657653251948,MATH 193A,A05,093482,Rotar; Vladimir,10,0,34,24
1657653257970,MATH 197,001,091859,McAuley; Julian John,9999,0,9999,0
1657653257970,MATH 197,002,095566,Kedlaya; Kiran S.,9997,0,9999,2
1657653257970,MATH 197,003,095567,Xiao; Ming,9999,0,9999,0
1657653257970,MATH 197,004,095571,Perols; Johan Lars,9998,0,9999,1
1657653265034,COGS 9,A01,083615,Shannon; Kyle Michael,9,0,75,66
1657653271067,COGS 11,A01,083617,Boyle; Mary E. T.,23,0,48,25
1657653277095,COGS 13,A01,083071,Bastos; Amalia Pinkusfeld,11,0,71,60
1657653283123,COGS 14A,A01,092681,Semenuks; Arturs,5,1,100,95
1657653289152,COGS 14B,A01,083073,Cheng; Tzu-Han,6,0,63,57
1657653295178,COGS 17,A01,092677,Semenuks; Arturs,6,0,81,75
1657653301200,COGS 100,A01,083619,Allen; Michael Gordon,17,0,70,53
1657653307221,COGS 101A,A01,083621,Davis; Joshua Daniel,9,0,68,59
1657653313255,COGS 101B,A01,091572,Allen; Michael Gordon,12,0,65,53
1657653319281,COGS 101C,A01,083625,Delgado; Tania,17,0,35,18
1657653325304,COGS 107A,A01,083627,Boyle; Mary E. T.,13,0,60,47
1657653331330,COGS 118A,A01,083075,Gupta; Anjum,21,0,76,55
1657653337356,CSE 3,A50,083646,Miranda; Gregory Joseph,24,0,50,26
1657653343383,CSE 8A,A50,083650,Miranda; Gregory Joseph,17,1,56,39
1657653349405,CSE 11,A01,083080,Cao; Yingjun,6,15,40,34
1657653355429,CSE 12,A01,083652,Krause-Levy; Sophia Louisa,28,1,120,92
1657653361455,CSE 15L,A01,083654,Morris; Justin Loren,9,0,50,41
1657653361455,CSE 15L,A02,083655,Morris; Justin Loren,9,0,50,41
1657653367485,CSE 20,A01,083657,Tran; Khoa Dang,39,0,80,41
1657653373513,CSE 21,A01,095574,Bach; Quang Tran,22,0,48,26
1657653379540,CSE 30,A01,083084,Eldon; John,6,0,80,74
1657653379540,CSE 30,B01,095061,Bhaskar; Nishant,9,0,50,41
1657653385561,CSE 100,A01,083659,Cao; Yingjun,5,4,70,65
1657653391594,CSE 134B,A01,083661,Powell; Thomas Allan,23,0,100,77
1657653397626,CSE 140,A01,083663,Gungor; Onat,15,0,85,70
1657653403649,CSE 140L,A01,083088,Eldon; John,21,0,100,79
1657653409672,CSE 175,A01,083665,Kumar; Rakesh,3,0,25,22
1657653415696,CSE 190,A00,092507,Dubnov; Shlomo,8,0,20,12
1657653421735,ECE 45,A01,083139,Congero; Spencer William,6,0,75,69
1657653427757,ECE 65,A50,083695,Saad; Andrew S,12,0,30,18
1657653427757,ECE 65,A51,095125,Saad; Andrew S,24,0,26,2
1657653433779,ECE 109,A01,091882,Touri; Behrouz,19,0,70,51
1657653439802,ECE 180,A00,083140,Abi Samra; Nicholas Camill,1,0,30,29
1657653439802,ECE 180,B00,083141,Abi Samra; Nicholas Camill,0,0,30,30
1657653445825,MATH 10A,A01,083735,Patchell; Gregory David,2,0,30,28
1657653445825,MATH 10A,A02,083736,Patchell; Gregory David,20,0,30,10
1657653445825,MATH 10A,A03,083737,Patchell; Gregory David,16,0,30,14
1657653451855,MATH 10B,A01,083207,Lim; Seonhee,8,0,34,26
1657653451855,MATH 10B,A02,083208,Lim; Seonhee,9,0,35,26
1657653451855,MATH 10B,A03,093472,Lim; Seonhee,7,0,34,27
1657653451855,MATH 10B,B01,083739,Sinha; Shubham,12,0,30,18
1657653457886,MATH 18,A01,083743,Cinel; Cameron Alexander,7,0,30,23
1657653457886,MATH 18,A02,083744,Cinel; Cameron Alexander,17,0,30,13
1657653457886,MATH 18,A03,083745,Cinel; Cameron Alexander,10,0,30,20
1657653457886,MATH 18,B01,083748,Rideout; David Porter,5,0,37,32
1657653457886,MATH 18,B02,083749,Rideout; David Porter,5,0,36,31
1657653457886,MATH 18,B03,083750,Rideout; David Porter,3,0,37,34
1657653457886,MATH 18,B04,083751,Rideout; David Porter,6,0,36,30
1657653457886,MATH 18,B05,093473,Rideout; David Porter,6,0,36,30
1657653457886,MATH 18,B06,093474,Rideout; David Porter,6,0,36,30
1657653463912,MATH 20A,A01,083754,Zheng; Zequn,14,0,40,26
1657653469933,MATH 20B,A01,083756,Briones; Jor-el Thomas Caparas,4,0,36,32
1657653469933,MATH 20B,A02,083757,Briones; Jor-el Thomas Caparas,1,0,36,35
1657653469933,MATH 20B,A03,093475,Briones; Jor-el Thomas Caparas,2,0,36,34
1657653475958,MATH 20C,A01,083760,Briones; Jor-el Thomas Caparas,1,0,35,34
1657653475958,MATH 20C,A02,083761,Briones; Jor-el Thomas Caparas,8,0,35,27
1657653475958,MATH 20C,A03,093476,Briones; Jor-el Thomas Caparas,0,1,36,36
1657653475958,MATH 20C,B01,083762,Bach; Quang Tran,1,0,30,29
1657653481981,MATH 20D,A01,083765,Tran; Brian Kha,5,0,30,25
1657653481981,MATH 20D,A02,083766,Tran; Brian Kha,5,0,30,25
1657653481981,MATH 20D,A03,083767,Tran; Brian Kha,5,0,30,25
1657653488011,MATH 20E,A01,083771,Ganguly; Soumya,9,0,32,23
1657653488011,MATH 20E,A02,083772,Ganguly; Soumya,6,0,32,26
1657653488011,MATH 20E,B01,083773,Ciotti; Benjamin,20,0,35,15
1657653488011,MATH 20E,B02,083774,Ciotti; Benjamin,18,0,35,17
1657653494040,MATH 103A,A01,083777,Greenfeld; Be'Eri,3,0,36,33
1657653494040,MATH 103A,A02,083778,Greenfeld; Be'Eri,5,0,36,31
1657653494040,MATH 103A,A03,093561,Greenfeld; Be'Eri,6,0,36,30
1657653494040,MATH 103A,B01,083779,Greenfeld; Be'Eri,7,0,36,29
1657653494040,MATH 103A,B02,083780,Greenfeld; Be'Eri,4,0,36,32
1657653494040,MATH 103A,B03,093562,Greenfeld; Be'Eri,3,0,36,33
1657653500066,MATH 105,A01,085443,Carter; Anne Toulson,15,0,35,20
1657653500066,MATH 105,A02,093477,Carter; Anne Toulson,20,0,35,15
1657653506095,MATH 109,A01,083213,Ganzberger; Geoffrey Michael,2,0,34,32
1657653506095,MATH 109,A02,083214,Ganzberger; Geoffrey Michael,4,0,34,30
1657653506095,MATH 109,A03,093478,Ganzberger; Geoffrey Michael,2,0,34,32
1657653506095,MATH 109,B01,083215,Ganzberger; Geoffrey Michael,1,0,32,31
1657653506095,MATH 109,B02,083216,Ganzberger; Geoffrey Michael,2,0,32,30
1657653506095,MATH 109,B03,093479,Ganzberger; Geoffrey Michael,8,0,32,24
1657653512122,MATH 142A,A01,083219,Chow; Bennett,7,0,32,25
1657653512122,MATH 142A,A02,083220,Chow; Bennett,10,0,32,22
1657653512122,MATH 142A,A03,093480,Chow; Bennett,9,0,32,23
1657653512122,MATH 142A,B03,093481,Chow; Bennett,8,0,32,24
1657653512122,MATH 142A,B04,093558,Chow; Bennett,13,0,32,19
1657653512122,MATH 142A,B05,093559,Chow; Bennett,6,0,32,26
1657653518145,MATH 193A,A01,083224,Rotar; Vladimir,8,0,34,26
1657653518145,MATH 193A,A02,083225,Rotar; Vladimir,9,0,34,25
1657653518145,MATH 193A,A03,083781,Rotar; Vladimir,5,0,34,29
1657653518145,MATH 193A,A04,083782,Rotar; Vladimir,10,0,34,24
1657653518145,MATH 193A,A05,093482,Rotar; Vladimir,10,0,34,24
1657653524170,MATH 197,001,091859,McAuley; Julian John,9999,0,9999,0
1657653524170,MATH 197,002,095566,Kedlaya; Kiran S.,9997,0,9999,2
1657653524170,MATH 197,003,095567,Xiao; Ming,9999,0,9999,0
1657653524170,MATH 197,004,095571,Perols; Johan Lars,9998,0,9999,1
1657653531234,COGS 9,A01,083615,Shannon; Kyle Michael,9,0,75,66
1657653537256,COGS 11,A01,083617,Boyle; Mary E. T.,23,0,48,25
1657653543278,COGS 13,A01,083071,Bastos; Amalia Pinkusfeld,11,0,71,60
1657653549305,COGS 14A,A01,092681,Semenuks; Arturs,5,1,100,95
1657653555331,COGS 14B,A01,083073,Cheng; Tzu-Han,6,0,63,57
1657653561356,COGS 17,A01,092677,Semenuks; Arturs,6,0,81,75
1657653567392,COGS 100,A01,083619,Allen; Michael Gordon,17,0,70,53
1657653573417,COGS 101A,A01,083621,Davis; Joshua Daniel,9,0,68,59
1657653579446,COGS 101B,A01,091572,Allen; Michael Gordon,12,0,65,53
1657653585469,COGS 101C,A01,083625,Delgado; Tania,17,0,35,18
1657653591496,COGS 107A,A01,083627,Boyle; Mary E. T.,13,0,60,47
1657653597523,COGS 118A,A01,083075,Gupta; Anjum,21,0,76,55
1657653603551,CSE 3,A50,083646,Miranda; Gregory Joseph,24,0,50,26
1657653609579,CSE 8A,A50,083650,Miranda; Gregory Joseph,17,1,56,39
1657653615606,CSE 11,A01,083080,Cao; Yingjun,6,15,40,34
1657653621633,CSE 12,A01,083652,Krause-Levy; Sophia Louisa,28,1,120,92
1657653627658,CSE 15L,A01,083654,Morris; Justin Loren,9,0,50,41
1657653627658,CSE 15L,A02,083655,Morris; Justin Loren,9,0,50,41
1657653633689,CSE 20,A01,083657,Tran; Khoa Dang,39,0,80,41
1657653639713,CSE 21,A01,095574,Bach; Quang Tran,22,0,48,26
1657653645736,CSE 30,A01,083084,Eldon; John,6,0,80,74
1657653645736,CSE 30,B01,095061,Bhaskar; Nishant,9,0,50,41
1657653651759,CSE 100,A01,083659,Cao; Yingjun,5,4,70,65
1657653657782,CSE 134B,A01,083661,Powell; Thomas Allan,23,0,100,77
1657653663805,CSE 140,A01,083663,Gungor; Onat,15,0,85,70
1657653669829,CSE 140L,A01,083088,Eldon; John,21,0,100,79
1657653675852,CSE 175,A01,083665,Kumar; Rakesh,3,0,25,22
1657653681877,CSE 190,A00,092507,Dubnov; Shlomo,8,0,20,12
1657653687902,ECE 45,A01,083139,Congero; Spencer William,6,0,75,69
1657653693928,ECE 65,A50,083695,Saad; Andrew S,12,0,30,18
1657653693928,ECE 65,A51,095125,Saad; Andrew S,24,0,26,2
1657653699956,ECE 109,A01,091882,Touri; Behrouz,19,0,70,51
1657653706057,ECE 180,A00,083140,Abi Samra; Nicholas Camill,1,0,30,29
1657653706057,ECE 180,B00,083141,Abi Samra; Nicholas Camill,0,0,30,30
1657653712095,MATH 10A,A01,083735,Patchell; Gregory David,2,0,30,28
1657653712095,MATH 10A,A02,083736,Patchell; Gregory David,20,0,30,10
1657653712095,MATH 10A,A03,083737,Patchell; Gregory David,16,0,30,14
1657653718127,MATH 10B,A01,083207,Lim; Seonhee,8,0,34,26
1657653718127,MATH 10B,A02,083208,Lim; Seonhee,9,0,35,26
1657653718127,MATH 10B,A03,093472,Lim; Seonhee,7,0,34,27
1657653718127,MATH 10B,B01,083739,Sinha; Shubham,12,0,30,18
1657653724150,MATH 18,A01,083743,Cinel; Cameron Alexander,7,0,30,23
1657653724150,MATH 18,A02,083744,Cinel; Cameron Alexander,17,0,30,13
1657653724150,MATH 18,A03,083745,Cinel; Cameron Alexander,10,0,30,20
1657653724150,MATH 18,B01,083748,Rideout; David Porter,5,0,37,32
1657653724150,MATH 18,B02,083749,Rideout; David Porter,5,0,36,31
1657653724150,MATH 18,B03,083750,Rideout; David Porter,3,0,37,34
1657653724150,MATH 18,B04,083751,Rideout; David Porter,6,0,36,30
1657653724150,MATH 18,B05,093473,Rideout; David Porter,6,0,36,30
1657653724150,MATH 18,B06,093474,Rideout; David Porter,6,0,36,30
1657653730197,MATH 20A,A01,083754,Zheng; Zequn,14,0,40,26
1657653736223,MATH 20B,A01,083756,Briones; Jor-el Thomas Caparas,4,0,36,32
1657653736223,MATH 20B,A02,083757,Briones; Jor-el Thomas Caparas,1,0,36,35
1657653736223,MATH 20B,A03,093475,Briones; Jor-el Thomas Caparas,2,0,36,34
1657653742248,MATH 20C,A01,083760,Briones; Jor-el Thomas Caparas,1,0,35,34
1657653742248,MATH 20C,A02,083761,Briones; Jor-el Thomas Caparas,8,0,35,27
1657653742248,MATH 20C,A03,093476,Briones; Jor-el Thomas Caparas,0,1,36,36
1657653742248,MATH 20C,B01,083762,Bach; Quang Tran,1,0,30,29
1657653748294,MATH 20D,A01,083765,Tran; Brian Kha,5,0,30,25
1657653748294,MATH 20D,A02,083766,Tran; Brian Kha,5,0,30,25
1657653748294,MATH 20D,A03,083767,Tran; Brian Kha,5,0,30,25
1657653754318,MATH 20E,A01,083771,Ganguly; Soumya,9,0,32,23
1657653754318,MATH 20E,A02,083772,Ganguly; Soumya,6,0,32,26
1657653754318,MATH 20E,B01,083773,Ciotti; Benjamin,20,0,35,15
1657653754318,MATH 20E,B02,083774,Ciotti; Benjamin,18,0,35,17
1657653760353,MATH 103A,A01,083777,Greenfeld; Be'Eri,3,0,36,33
1657653760353,MATH 103A,A02,083778,Greenfeld; Be'Eri,5,0,36,31
1657653760353,MATH 103A,A03,093561,Greenfeld; Be'Eri,6,0,36,30
1657653760353,MATH 103A,B01,083779,Greenfeld; Be'Eri,7,0,36,29
1657653760353,MATH 103A,B02,083780,Greenfeld; Be'Eri,4,0,36,32
1657653760353,MATH 103A,B03,093562,Greenfeld; Be'Eri,3,0,36,33
1657653766386,MATH 105,A01,085443,Carter; Anne Toulson,15,0,35,20
1657653766386,MATH 105,A02,093477,Carter; Anne Toulson,20,0,35,15
1657653772409,MATH 109,A01,083213,Ganzberger; Geoffrey Michael,2,0,34,32
1657653772409,MATH 109,A02,083214,Ganzberger; Geoffrey Michael,4,0,34,30
1657653772409,MATH 109,A03,093478,Ganzberger; Geoffrey Michael,2,0,34,32
1657653772409,MATH 109,B01,083215,Ganzberger; Geoffrey Michael,1,0,32,31
1657653772409,MATH 109,B02,083216,Ganzberger; Geoffrey Michael,2,0,32,30
1657653772409,MATH 109,B03,093479,Ganzberger; Geoffrey Michael,8,0,32,24
1657653778434,MATH 142A,A01,083219,Chow; Bennett,7,0,32,25
1657653778434,MATH 142A,A02,083220,Chow; Bennett,10,0,32,22
1657653778434,MATH 142A,A03,093480,Chow; Bennett,9,0,32,23
1657653778434,MATH 142A,B03,093481,Chow; Bennett,8,0,32,24
1657653778434,MATH 142A,B04,093558,Chow; Bennett,13,0,32,19
1657653778434,MATH 142A,B05,093559,Chow; Bennett,6,0,32,26
1657653784461,MATH 193A,A01,083224,Rotar; Vladimir,8,0,34,26
1657653784461,MATH 193A,A02,083225,Rotar; Vladimir,9,0,34,25
1657653784461,MATH 193A,A03,083781,Rotar; Vladimir,5,0,34,29
1657653784461,MATH 193A,A04,083782,Rotar; Vladimir,10,0,34,24
1657653784461,MATH 193A,A05,093482,Rotar; Vladimir,10,0,34,24
1657653790522,MATH 197,001,091859,McAuley; Julian John,9999,0,9999,0
1657653790522,MATH 197,002,095566,Kedlaya; Kiran S.,9997,0,9999,2
1657653790522,MATH 197,003,095567,Xiao; Ming,9999,0,9999,0
1657653790522,MATH 197,004,095571,Perols; Johan Lars,9998,0,9999,1
1657653797591,COGS 9,A01,083615,Shannon; Kyle Michael,9,0,75,66
1657653803616,COGS 11,A01,083617,Boyle; Mary E. T.,23,0,48,25
1657653809641,COGS 13,A01,083071,Bastos; Amalia Pinkusfeld,11,0,71,60
1657653815664,COGS 14A,A01,092681,Semenuks; Arturs,5,1,100,95
1657653821688,COGS 14B,A01,083073,Cheng; Tzu-Han,6,0,63,57
1657653827714,COGS 17,A01,092677,Semenuks; Arturs,6,0,81,75
1657653833737,COGS 100,A01,083619,Allen; Michael Gordon,17,0,70,53
1657653839760,COGS 101A,A01,083621,Davis; Joshua Daniel,9,0,68,59
1657653845782,COGS 101B,A01,091572,Allen; Michael Gordon,12,0,65,53
1657653851817,COGS 101C,A01,083625,Delgado; Tania,17,0,35,18
1657653857840,COGS 107A,A01,083627,Boyle; Mary E. T.,13,0,60,47
1657653863865,COGS 118A,A01,083075,Gupta; Anjum,21,0,76,55
1657653869898,CSE 3,A50,083646,Miranda; Gregory Joseph,24,0,50,26
1657653875929,CSE 8A,A50,083650,Miranda; Gregory Joseph,17,1,56,39
1657653881951,CSE 11,A01,083080,Cao; Yingjun,6,15,40,34
1657653887974,CSE 12,A01,083652,Krause-Levy; Sophia Louisa,28,1,120,92
1657653893997,CSE 15L,A01,083654,Morris; Justin Loren,9,0,50,41
1657653893997,CSE 15L,A02,083655,Morris; Justin Loren,9,0,50,41
1657653900023,CSE 20,A01,083657,Tran; Khoa Dang,39,0,80,41
1657653906050,CSE 21,A01,095574,Bach; Quang Tran,22,0,48,26
1657653912075,CSE 30,A01,083084,Eldon; John,6,0,80,74
1657653912075,CSE 30,B01,095061,Bhaskar; Nishant,9,0,50,41
1657653918096,CSE 100,A01,083659,Cao; Yingjun,5,4,70,65
1657653924120,CSE 134B,A01,083661,Powell; Thomas Allan,23,0,100,77
1657653930152,CSE 140,A01,083663,Gungor; Onat,15,0,85,70
1657653936180,CSE 140L,A01,083088,Eldon; John,21,0,100,79
1657653942204,CSE 175,A01,083665,Kumar; Rakesh,3,0,25,22
1657653948229,CSE 190,A00,092507,Dubnov; Shlomo,8,0,20,12
1657653954252,ECE 45,A01,083139,Congero; Spencer William,6,0,75,69
1657653960274,ECE 65,A50,083695,Saad; Andrew S,12,0,30,18
1657653960274,ECE 65,A51,095125,Saad; Andrew S,24,0,26,2
1657653966297,ECE 109,A01,091882,Touri; Behrouz,19,0,70,51
1657653972327,ECE 180,A00,083140,Abi Samra; Nicholas Camill,1,0,30,29
1657653972327,ECE 180,B00,083141,Abi Samra; Nicholas Camill,0,0,30,30
1657653978353,MATH 10A,A01,083735,Patchell; Gregory David,2,0,30,28
1657653978353,MATH 10A,A02,083736,Patchell; Gregory David,20,0,30,10
1657653978353,MATH 10A,A03,083737,Patchell; Gregory David,16,0,30,14
1657653984383,MATH 10B,A01,083207,Lim; Seonhee,8,0,34,26
1657653984383,MATH 10B,A02,083208,Lim; Seonhee,9,0,35,26
1657653984383,MATH 10B,A03,093472,Lim; Seonhee,7,0,34,27
1657653984383,MATH 10B,B01,083739,Sinha; Shubham,13,0,30,17
1657653990412,MATH 18,A01,083743,Cinel; Cameron Alexander,7,0,30,23
1657653990412,MATH 18,A02,083744,Cinel; Cameron Alexander,17,0,30,13
1657653990412,MATH 18,A03,083745,Cinel; Cameron Alexander,10,0,30,20
1657653990412,MATH 18,B01,083748,Rideout; David Porter,5,0,37,32
1657653990412,MATH 18,B02,083749,Rideout; David Porter,5,0,36,31
1657653990412,MATH 18,B03,083750,Rideout; David Porter,3,0,37,34
1657653990412,MATH 18,B04,083751,Rideout; David Porter,6,0,36,30
1657653990412,MATH 18,B05,093473,Rideout; David Porter,6,0,36,30
1657653990412,MATH 18,B06,093474,Rideout; David Porter,6,0,36,30
1657653996440,MATH 20A,A01,083754,Zheng; Zequn,14,0,40,26
1657654002468,MATH 20B,A01,083756,Briones; Jor-el Thomas Caparas,4,0,36,32
1657654002468,MATH 20B,A02,083757,Briones; Jor-el Thomas Caparas,1,0,36,35
1657654002468,MATH 20B,A03,093475,Briones; Jor-el Thomas Caparas,2,0,36,34
1657654008493,MATH 20C,A01,083760,Briones; Jor-el Thomas Caparas,1,0,35,34
1657654008493,MATH 20C,A02,083761,Briones; Jor-el Thomas Caparas,8,0,35,27
1657654008493,MATH 20C,A03,093476,Briones; Jor-el Thomas Caparas,0,1,36,36
1657654008493,MATH 20C,B01,083762,Bach; Quang Tran,1,0,30,29
1657654014520,MATH 20D,A01,083765,Tran; Brian Kha,5,0,30,25
1657654014520,MATH 20D,A02,083766,Tran; Brian Kha,5,0,30,25
1657654014520,MATH 20D,A03,083767,Tran; Brian Kha,5,0,30,25
1657654020543,MATH 20E,A01,083771,Ganguly; Soumya,9,0,32,23
1657654020543,MATH 20E,A02,083772,Ganguly; Soumya,6,0,32,26
1657654020543,MATH 20E,B01,083773,Ciotti; Benjamin,20,0,35,15
1657654020543,MATH 20E,B02,083774,Ciotti; Benjamin,18,0,35,17
1657654026569,MATH 103A,A01,083777,Greenfeld; Be'Eri,3,0,36,33
1657654026569,MATH 103A,A02,083778,Greenfeld; Be'Eri,5,0,36,31
1657654026569,MATH 103A,A03,093561,Greenfeld; Be'Eri,6,0,36,30
1657654026569,MATH 103A,B01,083779,Greenfeld; Be'Eri,7,0,36,29
1657654026569,MATH 103A,B02,083780,Greenfeld; Be'Eri,4,0,36,32
1657654026569,MATH 103A,B03,093562,Greenfeld; Be'Eri,3,0,36,33
1657654032606,MATH 105,A01,085443,Carter; Anne Toulson,15,0,35,20
1657654032606,MATH 105,A02,093477,Carter; Anne Toulson,20,0,35,15
1657654038630,MATH 109,A01,083213,Ganzberger; Geoffrey Michael,2,0,34,32
1657654038630,MATH 109,A02,083214,Ganzberger; Geoffrey Michael,4,0,34,30
1657654038630,MATH 109,A03,093478,Ganzberger; Geoffrey Michael,2,0,34,32
1657654038630,MATH 109,B01,083215,Ganzberger; Geoffrey Michael,1,0,32,31
1657654038630,MATH 109,B02,083216,Ganzberger; Geoffrey Michael,2,0,32,30
1657654038630,MATH 109,B03,093479,Ganzberger; Geoffrey Michael,8,0,32,24
1657654044660,MATH 142A,A01,083219,Chow; Bennett,7,0,32,25
1657654044660,MATH 142A,A02,083220,Chow; Bennett,10,0,32,22
1657654044660,MATH 142A,A03,093480,Chow; Bennett,9,0,32,23
1657654044660,MATH 142A,B03,093481,Chow; Bennett,8,0,32,24
1657654044660,MATH 142A,B04,093558,Chow; Bennett,13,0,32,19
1657654044660,MATH 142A,B05,093559,Chow; Bennett,6,0,32,26
1657654050686,MATH 193A,A01,083224,Rotar; Vladimir,8,0,34,26
1657654050686,MATH 193A,A02,083225,Rotar; Vladimir,9,0,34,25
1657654050686,MATH 193A,A03,083781,Rotar; Vladimir,5,0,34,29
1657654050686,MATH 193A,A04,083782,Rotar; Vladimir,10,0,34,24
1657654050686,MATH 193A,A05,093482,Rotar; Vladimir,10,0,34,24
1657654056713,MATH 197,001,091859,McAuley; Julian John,9999,0,9999,0
1657654056713,MATH 197,002,095566,Kedlaya; Kiran S.,9997,0,9999,2
1657654056713,MATH 197,003,095567,Xiao; Ming,9999,0,9999,0
1657654056713,MATH 197,004,095571,Perols; Johan Lars,9998,0,9999,1
1657654063775,COGS 9,A01,083615,Shannon; Kyle Michael,9,0,75,66
1657654069798,COGS 11,A01,083617,Boyle; Mary E. T.,23,0,48,25
1657654075826,COGS 13,A01,083071,Bastos; Amalia Pinkusfeld,11,0,71,60
1657654081856,COGS 14A,A01,092681,Semenuks; Arturs,5,1,100,95
1657654087878,COGS 14B,A01,083073,Cheng; Tzu-Han,6,0,63,57
1657654093902,COGS 17,A01,092677,Semenuks; Arturs,6,0,81,75
1657654099928,COGS 100,A01,083619,Allen; Michael Gordon,17,0,70,53
1657654105960,COGS 101A,A01,083621,Davis; Joshua Daniel,9,0,68,59
1657654111982,COGS 101B,A01,091572,Allen; Michael Gordon,12,0,65,53
1657654118007,COGS 101C,A01,083625,Delgado; Tania,17,0,35,18
1657654124031,COGS 107A,A01,083627,Boyle; Mary E. T.,13,0,60,47
1657654130058,COGS 118A,A01,083075,Gupta; Anjum,21,0,76,55
1657654136082,CSE 3,A50,083646,Miranda; Gregory Joseph,24,0,50,26
1657654142107,CSE 8A,A50,083650,Miranda; Gregory Joseph,17,1,56,39
1657654148135,CSE 11,A01,083080,Cao; Yingjun,6,15,40,34
1657654154158,CSE 12,A01,083652,Krause-Levy; Sophia Louisa,28,1,120,92
1657654160189,CSE 15L,A01,083654,Morris; Justin Loren,9,0,50,41
1657654160189,CSE 15L,A02,083655,Morris; Justin Loren,9,0,50,41
1657654166218,CSE 20,A01,083657,Tran; Khoa Dang,39,0,80,41
1657654172241,CSE 21,A01,095574,Bach; Quang Tran,22,0,48,26
1657654178265,CSE 30,A01,083084,Eldon; John,6,0,80,74
1657654178265,CSE 30,B01,095061,Bhaskar; Nishant,9,0,50,41
1657654184291,CSE 100,A01,083659,Cao; Yingjun,5,4,70,65
1657654190317,CSE 134B,A01,083661,Powell; Thomas Allan,23,0,100,77
1657654196344,CSE 140,A01,083663,Gungor; Onat,15,0,85,70
1657654202376,CSE 140L,A01,083088,Eldon; John,21,0,100,79
1657654208399,CSE 175,A01,083665,Kumar; Rakesh,3,0,25,22
1657654214422,CSE 190,A00,092507,Dubnov; Shlomo,8,0,20,12
1657654220449,ECE 45,A01,083139,Congero; Spencer William,6,0,75,69
1657654226477,ECE 65,A50,083695,Saad; Andrew S,12,0,30,18
1657654226477,ECE 65,A51,095125,Saad; Andrew S,24,0,26,2
1657654232503,ECE 109,A01,091882,Touri; Behrouz,19,0,70,51
1657654238547,ECE 180,A00,083140,Abi Samra; Nicholas Camill,1,0,30,29
1657654238547,ECE 180,B00,083141,Abi Samra; Nicholas Camill,0,0,30,30
1657654244575,MATH 10A,A01,083735,Patchell; Gregory David,2,0,30,28
1657654244575,MATH 10A,A02,083736,Patchell; Gregory David,20,0,30,10
1657654244575,MATH 10A,A03,083737,Patchell; Gregory David,16,0,30,14
1657654250604,MATH 10B,A01,083207,Lim; Seonhee,8,0,34,26
1657654250604,MATH 10B,A02,083208,Lim; Seonhee,9,0,35,26
1657654250604,MATH 10B,A03,093472,Lim; Seonhee,7,0,34,27
1657654250604,MATH 10B,B01,083739,Sinha; Shubham,13,0,30,17
1657654256637,MATH 18,A01,083743,Cinel; Cameron Alexander,7,0,30,23
1657654256637,MATH 18,A02,083744,Cinel; Cameron Alexander,17,0,30,13
1657654256637,MATH 18,A03,083745,Cinel; Cameron Alexander,10,0,30,20
1657654256637,MATH 18,B01,083748,Rideout; David Porter,5,0,37,32
1657654256637,MATH 18,B02,083749,Rideout; David Porter,5,0,36,31
1657654256637,MATH 18,B03,083750,Rideout; David Porter,3,0,37,34
1657654256637,MATH 18,B04,083751,Rideout; David Porter,6,0,36,30
1657654256637,MATH 18,B05,093473,Rideout; David Porter,6,0,36,30
1657654256637,MATH 18,B06,093474,Rideout; David Porter,6,0,36,30
1657654262668,MATH 20A,A01,083754,Zheng; Zequn,14,0,40,26
1657654268697,MATH 20B,A01,083756,Briones; Jor-el Thomas Caparas,4,0,36,32
1657654268697,MATH 20B,A02,083757,Briones; Jor-el Thomas Caparas,1,0,36,35
1657654268697,MATH 20B,A03,093475,Briones; Jor-el Thomas Caparas,2,0,36,34
1657654274726,MATH 20C,A01,083760,Briones; Jor-el Thomas Caparas,1,0,35,34
1657654274726,MATH 20C,A02,083761,Briones; Jor-el Thomas Caparas,8,0,35,27
1657654274726,MATH 20C,A03,093476,Briones; Jor-el Thomas Caparas,0,1,36,36
1657654274726,MATH 20C,B01,083762,Bach; Quang Tran,1,0,30,29
1657654280757,MATH 20D,A01,083765,Tran; Brian Kha,5,0,30,25
1657654280757,MATH 20D,A02,083766,Tran; Brian Kha,5,0,30,25
1657654280757,MATH 20D,A03,083767,Tran; Brian Kha,5,0,30,25
1657654286800,MATH 20E,A01,083771,Ganguly; Soumya,9,0,32,23
1657654286800,MATH 20E,A02,083772,Ganguly; Soumya,6,0,32,26
1657654286800,MATH 20E,B01,083773,Ciotti; Benjamin,20,0,35,15
1657654286800,MATH 20E,B02,083774,Ciotti; Benjamin,18,0,35,17
1657654292825,MATH 103A,A01,083777,Greenfeld; Be'Eri,3,0,36,33
1657654292825,MATH 103A,A02,083778,Greenfeld; Be'Eri,5,0,36,31
1657654292825,MATH 103A,A03,093561,Greenfeld; Be'Eri,6,0,36,30
1657654292825,MATH 103A,B01,083779,Greenfeld; Be'Eri,7,0,36,29
1657654292825,MATH 103A,B02,083780,Greenfeld; Be'Eri,4,0,36,32
1657654292825,MATH 103A,B03,093562,Greenfeld; Be'Eri,3,0,36,33
1657654298850,MATH 105,A01,085443,Carter; Anne Toulson,15,0,35,20
1657654298850,MATH 105,A02,093477,Carter; Anne Toulson,20,0,35,15
1657654304952,MATH 109,A01,083213,Ganzberger; Geoffrey Michael,2,0,34,32
1657654304952,MATH 109,A02,083214,Ganzberger; Geoffrey Michael,4,0,34,30
1657654304952,MATH 109,A03,093478,Ganzberger; Geoffrey Michael,2,0,34,32
1657654304952,MATH 109,B01,083215,Ganzberger; Geoffrey Michael,1,0,32,31
1657654304952,MATH 109,B02,083216,Ganzberger; Geoffrey Michael,2,0,32,30
1657654304952,MATH 109,B03,093479,Ganzberger; Geoffrey Michael,8,0,32,24
1657654310975,MATH 142A,A01,083219,Chow; Bennett,7,0,32,25
1657654310975,MATH 142A,A02,083220,Chow; Bennett,10,0,32,22
1657654310975,MATH 142A,A03,093480,Chow; Bennett,9,0,32,23
1657654310975,MATH 142A,B03,093481,Chow; Bennett,8,0,32,24
1657654310975,MATH 142A,B04,093558,Chow; Bennett,13,0,32,19
1657654310975,MATH 142A,B05,093559,Chow; Bennett,6,0,32,26
1657654317001,MATH 193A,A01,083224,Rotar; Vladimir,8,0,34,26
1657654317001,MATH 193A,A02,083225,Rotar; Vladimir,9,0,34,25
1657654317001,MATH 193A,A03,083781,Rotar; Vladimir,5,0,34,29
1657654317001,MATH 193A,A04,083782,Rotar; Vladimir,10,0,34,24
1657654317001,MATH 193A,A05,093482,Rotar; Vladimir,10,0,34,24
1657654323037,MATH 197,001,091859,McAuley; Julian John,9999,0,9999,0
1657654323037,MATH 197,002,095566,Kedlaya; Kiran S.,9997,0,9999,2
1657654323037,MATH 197,003,095567,Xiao; Ming,9999,0,9999,0
1657654323037,MATH 197,004,095571,Perols; Johan Lars,9998,0,9999,1
1657654330115,COGS 9,A01,083615,Shannon; Kyle Michael,9,0,75,66
1657654336157,COGS 11,A01,083617,Boyle; Mary E. T.,23,0,48,25
1657654342181,COGS 13,A01,083071,Bastos; Amalia Pinkusfeld,11,0,71,60
1657654348212,COGS 14A,A01,092681,Semenuks; Arturs,5,1,100,95
1657654354237,COGS 14B,A01,083073,Cheng; Tzu-Han,6,0,63,57
1657654360260,COGS 17,A01,092677,Semenuks; Arturs,6,0,81,75
1657654366284,COGS 100,A01,083619,Allen; Michael Gordon,17,0,70,53
1657654372307,COGS 101A,A01,083621,Davis; Joshua Daniel,9,0,68,59
1657654378333,COGS 101B,A01,091572,Allen; Michael Gordon,12,0,65,53
1657654384357,COGS 101C,A01,083625,Delgado; Tania,17,0,35,18
1657654390385,COGS 107A,A01,083627,Boyle; Mary E. T.,13,0,60,47
1657654396409,COGS 118A,A01,083075,Gupta; Anjum,21,0,76,55
1657654402440,CSE 3,A50,083646,Miranda; Gregory Joseph,24,0,50,26
1657654408467,CSE 8A,A50,083650,Miranda; Gregory Joseph,17,1,56,39
1657654414498,CSE 11,A01,083080,Cao; Yingjun,6,15,40,34
1657654420532,CSE 12,A01,083652,Krause-Levy; Sophia Louisa,28,1,120,92
1657654426556,CSE 15L,A01,083654,Morris; Justin Loren,9,0,50,41
1657654426556,CSE 15L,A02,083655,Morris; Justin Loren,9,0,50,41
1657654432579,CSE 20,A01,083657,Tran; Khoa Dang,39,0,80,41
1657654438606,CSE 21,A01,095574,Bach; Quang Tran,22,0,48,26
1657654444628,CSE 30,A01,083084,Eldon; John,6,0,80,74
1657654444628,CSE 30,B01,095061,Bhaskar; Nishant,9,0,50,41
1657654450655,CSE 100,A01,083659,Cao; Yingjun,5,4,70,65
1657654456681,CSE 134B,A01,083661,Powell; Thomas Allan,23,0,100,77
1657654462706,CSE 140,A01,083663,Gungor; Onat,15,0,85,70
1657654468736,CSE 140L,A01,083088,Eldon; John,21,0,100,79
1657654474758,CSE 175,A01,083665,Kumar; Rakesh,3,0,25,22
1657654480780,CSE 190,A00,092507,Dubnov; Shlomo,8,0,20,12
1657654486802,ECE 45,A01,083139,Congero; Spencer William,6,0,75,69
1657654492829,ECE 65,A50,083695,Saad; Andrew S,12,0,30,18
1657654492829,ECE 65,A51,095125,Saad; Andrew S,24,0,26,2
1657654498852,ECE 109,A01,091882,Touri; Behrouz,19,0,70,51
1657654504879,ECE 180,A00,083140,Abi Samra; Nicholas Camill,1,0,30,29
1657654504879,ECE 180,B00,083141,Abi Samra; Nicholas Camill,0,0,30,30
1657654510901,MATH 10A,A01,083735,Patchell; Gregory David,2,0,30,28
1657654510901,MATH 10A,A02,083736,Patchell; Gregory David,20,0,30,10
1657654510901,MATH 10A,A03,083737,Patchell; Gregory David,16,0,30,14
1657654516929,MATH 10B,A01,083207,Lim; Seonhee,8,0,34,26
1657654516929,MATH 10B,A02,083208,Lim; Seonhee,9,0,35,26
1657654516929,MATH 10B,A03,093472,Lim; Seonhee,7,0,34,27
1657654516929,MATH 10B,B01,083739,Sinha; Shubham,13,0,30,17
1657654522953,MATH 18,A01,083743,Cinel; Cameron Alexander,7,0,30,23
1657654522953,MATH 18,A02,083744,Cinel; Cameron Alexander,17,0,30,13
1657654522953,MATH 18,A03,083745,Cinel; Cameron Alexander,10,0,30,20
1657654522953,MATH 18,B01,083748,Rideout; David Porter,5,0,37,32
1657654522953,MATH 18,B02,083749,Rideout; David Porter,5,0,36,31
1657654522953,MATH 18,B03,083750,Rideout; David Porter,3,0,37,34
1657654522953,MATH 18,B04,083751,Rideout; David Porter,6,0,36,30
1657654522953,MATH 18,B05,093473,Rideout; David Porter,6,0,36,30
1657654522953,MATH 18,B06,093474,Rideout; David Porter,6,0,36,30
1657654528979,MATH 20A,A01,083754,Zheng; Zequn,14,0,40,26
1657654535010,MATH 20B,A01,083756,Briones; Jor-el Thomas Caparas,4,0,36,32
1657654535010,MATH 20B,A02,083757,Briones; Jor-el Thomas Caparas,1,0,36,35
1657654535010,MATH 20B,A03,093475,Briones; Jor-el Thomas Caparas,2,0,36,34
1657654541040,MATH 20C,A01,083760,Briones; Jor-el Thomas Caparas,1,0,35,34
1657654541040,MATH 20C,A02,083761,Briones; Jor-el Thomas Caparas,8,0,35,27
1657654541040,MATH 20C,A03,093476,Briones; Jor-el Thomas Caparas,0,1,36,36
1657654541040,MATH 20C,B01,083762,Bach; Quang Tran,1,0,30,29
1657654547068,MATH 20D,A01,083765,Tran; Brian Kha,5,0,30,25
1657654547068,MATH 20D,A02,083766,Tran; Brian Kha,5,0,30,25
1657654547068,MATH 20D,A03,083767,Tran; Brian Kha,5,0,30,25
1657654553097,MATH 20E,A01,083771,Ganguly; Soumya,9,0,32,23
1657654553097,MATH 20E,A02,083772,Ganguly; Soumya,6,0,32,26
1657654553097,MATH 20E,B01,083773,Ciotti; Benjamin,20,0,35,15
1657654553097,MATH 20E,B02,083774,Ciotti; Benjamin,18,0,35,17
1657654559120,MATH 103A,A01,083777,Greenfeld; Be'Eri,3,0,36,33
1657654559120,MATH 103A,A02,083778,Greenfeld; Be'Eri,5,0,36,31
1657654559120,MATH 103A,A03,093561,Greenfeld; Be'Eri,6,0,36,30
1657654559120,MATH 103A,B01,083779,Greenfeld; Be'Eri,7,0,36,29
1657654559120,MATH 103A,B02,083780,Greenfeld; Be'Eri,4,0,36,32
1657654559120,MATH 103A,B03,093562,Greenfeld; Be'Eri,3,0,36,33
1657654565145,MATH 105,A01,085443,Carter; Anne Toulson,15,0,35,20
1657654565145,MATH 105,A02,093477,Carter; Anne Toulson,20,0,35,15
1657654571171,MATH 109,A01,083213,Ganzberger; Geoffrey Michael,2,0,34,32
1657654571171,MATH 109,A02,083214,Ganzberger; Geoffrey Michael,4,0,34,30
1657654571171,MATH 109,A03,093478,Ganzberger; Geoffrey Michael,2,0,34,32
1657654571171,MATH 109,B01,083215,Ganzberger; Geoffrey Michael,1,0,32,31
1657654571171,MATH 109,B02,083216,Ganzberger; Geoffrey Michael,2,0,32,30
1657654571171,MATH 109,B03,093479,Ganzberger; Geoffrey Michael,8,0,32,24
1657654577195,MATH 142A,A01,083219,Chow; Bennett,7,0,32,25
1657654577195,MATH 142A,A02,083220,Chow; Bennett,10,0,32,22
1657654577195,MATH 142A,A03,093480,Chow; Bennett,9,0,32,23
1657654577195,MATH 142A,B03,093481,Chow; Bennett,8,0,32,24
1657654577195,MATH 142A,B04,093558,Chow; Bennett,13,0,32,19
1657654577195,MATH 142A,B05,093559,Chow; Bennett,6,0,32,26
1657654583221,MATH 193A,A01,083224,Rotar; Vladimir,8,0,34,26
1657654583221,MATH 193A,A02,083225,Rotar; Vladimir,9,0,34,25
1657654583221,MATH 193A,A03,083781,Rotar; Vladimir,5,0,34,29
1657654583221,MATH 193A,A04,083782,Rotar; Vladimir,10,0,34,24
1657654583221,MATH 193A,A05,093482,Rotar; Vladimir,10,0,34,24
1657654589248,MATH 197,001,091859,McAuley; Julian John,9999,0,9999,0
1657654589248,MATH 197,002,095566,Kedlaya; Kiran S.,9997,0,9999,2
1657654589248,MATH 197,003,095567,Xiao; Ming,9999,0,9999,0
1657654589248,MATH 197,004,095571,Perols; Johan Lars,9998,0,9999,1
1657654596310,COGS 9,A01,083615,Shannon; Kyle Michael,9,0,75,66
1657654602333,COGS 11,A01,083617,Boyle; Mary E. T.,23,0,48,25
1657654608359,COGS 13,A01,083071,Bastos; Amalia Pinkusfeld,11,0,71,60
1657654614380,COGS 14A,A01,092681,Semenuks; Arturs,5,1,100,95
1657654620407,COGS 14B,A01,083073,Cheng; Tzu-Han,6,0,63,57
1657654626429,COGS 17,A01,092677,Semenuks; Arturs,6,0,81,75
1657654632463,COGS 100,A01,083619,Allen; Michael Gordon,17,0,70,53
1657654638486,COGS 101A,A01,083621,Davis; Joshua Daniel,9,0,68,59
1657654644518,COGS 101B,A01,091572,Allen; Michael Gordon,12,0,65,53
1657654650541,COGS 101C,A01,083625,Delgado; Tania,17,0,35,18
1657654656563,COGS 107A,A01,083627,Boyle; Mary E. T.,13,0,60,47
1657654662585,COGS 118A,A01,083075,Gupta; Anjum,21,0,76,55
1657654668617,CSE 3,A50,083646,Miranda; Gregory Joseph,24,0,50,26
1657654674645,CSE 8A,A50,083650,Miranda; Gregory Joseph,17,1,56,39
1657654680669,CSE 11,A01,083080,Cao; Yingjun,6,15,40,34
1657654686696,CSE 12,A01,083652,Krause-Levy; Sophia Louisa,28,1,120,92
1657654692726,CSE 15L,A01,083654,Morris; Justin Loren,9,0,50,41
1657654692726,CSE 15L,A02,083655,Morris; Justin Loren,9,0,50,41
1657654698753,CSE 20,A01,083657,Tran; Khoa Dang,39,0,80,41
1657654704776,CSE 21,A01,095574,Bach; Quang Tran,22,0,48,26
1657654710803,CSE 30,A01,083084,Eldon; John,6,0,80,74
1657654710803,CSE 30,B01,095061,Bhaskar; Nishant,9,0,50,41
1657654716825,CSE 100,A01,083659,Cao; Yingjun,5,4,70,65
1657654722851,CSE 134B,A01,083661,Powell; Thomas Allan,23,0,100,77
1657654728876,CSE 140,A01,083663,Gungor; Onat,15,0,85,70
1657654734903,CSE 140L,A01,083088,Eldon; John,21,0,100,79
1657654740926,CSE 175,A01,083665,Kumar; Rakesh,3,0,25,22
1657654746960,CSE 190,A00,092507,Dubnov; Shlomo,8,0,20,12
1657654752984,ECE 45,A01,083139,Congero; Spencer William,6,0,75,69
1657654759011,ECE 65,A50,083695,Saad; Andrew S,12,0,30,18
1657654759011,ECE 65,A51,095125,Saad; Andrew S,24,0,26,2
1657654765037,ECE 109,A01,091882,Touri; Behrouz,19,0,70,51
1657654771067,ECE 180,A00,083140,Abi Samra; Nicholas Camill,1,0,30,29
1657654771067,ECE 180,B00,083141,Abi Samra; Nicholas Camill,0,0,30,30
1657654777095,MATH 10A,A01,083735,Patchell; Gregory David,2,0,30,28
1657654777095,MATH 10A,A02,083736,Patchell; Gregory David,20,0,30,10
1657654777095,MATH 10A,A03,083737,Patchell; Gregory David,16,0,30,14
1657654783126,MATH 10B,A01,083207,Lim; Seonhee,8,0,34,26
1657654783126,MATH 10B,A02,083208,Lim; Seonhee,9,0,35,26
1657654783126,MATH 10B,A03,093472,Lim; Seonhee,7,0,34,27
1657654783126,MATH 10B,B01,083739,Sinha; Shubham,13,0,30,17
1657654789161,MATH 18,A01,083743,Cinel; Cameron Alexander,7,0,30,23
1657654789161,MATH 18,A02,083744,Cinel; Cameron Alexander,17,0,30,13
1657654789161,MATH 18,A03,083745,Cinel; Cameron Alexander,10,0,30,20
1657654789161,MATH 18,B01,083748,Rideout; David Porter,5,0,37,32
1657654789161,MATH 18,B02,083749,Rideout; David Porter,5,0,36,31
1657654789161,MATH 18,B03,083750,Rideout; David Porter,3,0,37,34
1657654789161,MATH 18,B04,083751,Rideout; David Porter,6,0,36,30
1657654789161,MATH 18,B05,093473,Rideout; David Porter,6,0,36,30
1657654789161,MATH 18,B06,093474,Rideout; David Porter,6,0,36,30
1657654795183,MATH 20A,A01,083754,Zheng; Zequn,14,0,40,26
1657654801218,MATH 20B,A01,083756,Briones; Jor-el Thomas Caparas,4,0,36,32
1657654801218,MATH 20B,A02,083757,Briones; Jor-el Thomas Caparas,1,0,36,35
1657654801218,MATH 20B,A03,093475,Briones; Jor-el Thomas Caparas,2,0,36,34
1657654807247,MATH 20C,A01,083760,Briones; Jor-el Thomas Caparas,1,0,35,34
1657654807247,MATH 20C,A02,083761,Briones; Jor-el Thomas Caparas,8,0,35,27
1657654807247,MATH 20C,A03,093476,Briones; Jor-el Thomas Caparas,0,1,36,36
1657654807247,MATH 20C,B01,083762,Bach; Quang Tran,1,0,30,29
1657654813275,MATH 20D,A01,083765,Tran; Brian Kha,5,0,30,25
1657654813275,MATH 20D,A02,083766,Tran; Brian Kha,5,0,30,25
1657654813275,MATH 20D,A03,083767,Tran; Brian Kha,5,0,30,25
1657654819309,MATH 20E,A01,083771,Ganguly; Soumya,9,0,32,23
1657654819309,MATH 20E,A02,083772,Ganguly; Soumya,6,0,32,26
1657654819309,MATH 20E,B01,083773,Ciotti; Benjamin,20,0,35,15
1657654819309,MATH 20E,B02,083774,Ciotti; Benjamin,18,0,35,17
1657654825339,MATH 103A,A01,083777,Greenfeld; Be'Eri,3,0,36,33
1657654825339,MATH 103A,A02,083778,Greenfeld; Be'Eri,5,0,36,31
1657654825339,MATH 103A,A03,093561,Greenfeld; Be'Eri,6,0,36,30
1657654825339,MATH 103A,B01,083779,Greenfeld; Be'Eri,7,0,36,29
1657654825339,MATH 103A,B02,083780,Greenfeld; Be'Eri,4,0,36,32
1657654825339,MATH 103A,B03,093562,Greenfeld; Be'Eri,3,0,36,33
1657654831367,MATH 105,A01,085443,Carter; Anne Toulson,15,0,35,20
1657654831367,MATH 105,A02,093477,Carter; Anne Toulson,20,0,35,15
1657654837396,MATH 109,A01,083213,Ganzberger; Geoffrey Michael,2,0,34,32
1657654837396,MATH 109,A02,083214,Ganzberger; Geoffrey Michael,4,0,34,30
1657654837396,MATH 109,A03,093478,Ganzberger; Geoffrey Michael,2,0,34,32
1657654837396,MATH 109,B01,083215,Ganzberger; Geoffrey Michael,1,0,32,31
1657654837396,MATH 109,B02,083216,Ganzberger; Geoffrey Michael,2,0,32,30
1657654837396,MATH 109,B03,093479,Ganzberger; Geoffrey Michael,8,0,32,24
1657654843424,MATH 142A,A01,083219,Chow; Bennett,7,0,32,25
1657654843424,MATH 142A,A02,083220,Chow; Bennett,10,0,32,22
1657654843424,MATH 142A,A03,093480,Chow; Bennett,9,0,32,23
1657654843424,MATH 142A,B03,093481,Chow; Bennett,8,0,32,24
1657654843424,MATH 142A,B04,093558,Chow; Bennett,13,0,32,19
1657654843424,MATH 142A,B05,093559,Chow; Bennett,6,0,32,26
1657654849452,MATH 193A,A01,083224,Rotar; Vladimir,8,0,34,26
1657654849452,MATH 193A,A02,083225,Rotar; Vladimir,9,0,34,25
1657654849452,MATH 193A,A03,083781,Rotar; Vladimir,5,0,34,29
1657654849452,MATH 193A,A04,083782,Rotar; Vladimir,10,0,34,24
1657654849452,MATH 193A,A05,093482,Rotar; Vladimir,10,0,34,24
1657654855492,MATH 197,001,091859,McAuley; Julian John,9999,0,9999,0
1657654855492,MATH 197,002,095566,Kedlaya; Kiran S.,9997,0,9999,2
1657654855492,MATH 197,003,095567,Xiao; Ming,9999,0,9999,0
1657654855492,MATH 197,004,095571,Perols; Johan Lars,9998,0,9999,1
1657654862557,COGS 9,A01,083615,Shannon; Kyle Michael,9,0,75,66
1657654868583,COGS 11,A01,083617,Boyle; Mary E. T.,23,0,48,25
1657654874605,COGS 13,A01,083071,Bastos; Amalia Pinkusfeld,11,0,71,60
1657654880641,COGS 14A,A01,092681,Semenuks; Arturs,5,1,100,95
1657654886673,COGS 14B,A01,083073,Cheng; Tzu-Han,6,0,63,57
1657654892695,COGS 17,A01,092677,Semenuks; Arturs,6,0,81,75
1657654898794,COGS 100,A01,083619,Allen; Michael Gordon,17,0,70,53
1657654904828,COGS 101A,A01,083621,Davis; Joshua Daniel,9,0,68,59
1657654910851,COGS 101B,A01,091572,Allen; Michael Gordon,12,0,65,53
1657654916874,COGS 101C,A01,083625,Delgado; Tania,17,0,35,18
1657654922896,COGS 107A,A01,083627,Boyle; Mary E. T.,13,0,60,47
1657654928919,COGS 118A,A01,083075,Gupta; Anjum,21,0,76,55
1657654934942,CSE 3,A50,083646,Miranda; Gregory Joseph,24,0,50,26
1657654940965,CSE 8A,A50,083650,Miranda; Gregory Joseph,17,1,56,39
1657654947007,CSE 11,A01,083080,Cao; Yingjun,6,15,40,34
1657654953032,CSE 12,A01,083652,Krause-Levy; Sophia Louisa,28,1,120,92
1657654959067,CSE 15L,A01,083654,Morris; Justin Loren,9,0,50,41
1657654959067,CSE 15L,A02,083655,Morris; Justin Loren,9,0,50,41
1657654965093,CSE 20,A01,083657,Tran; Khoa Dang,39,0,80,41
1657654971122,CSE 21,A01,095574,Bach; Quang Tran,22,0,48,26
1657654977155,CSE 30,A01,083084,Eldon; John,6,0,80,74
1657654977155,CSE 30,B01,095061,Bhaskar; Nishant,9,0,50,41
1657654983185,CSE 100,A01,083659,Cao; Yingjun,5,4,70,65
1657654989210,CSE 134B,A01,083661,Powell; Thomas Allan,23,0,100,77
1657654995240,CSE 140,A01,083663,Gungor; Onat,15,0,85,70
1657655001265,CSE 140L,A01,083088,Eldon; John,21,0,100,79
1657655007288,CSE 175,A01,083665,Kumar; Rakesh,3,0,25,22
1657655013318,CSE 190,A00,092507,Dubnov; Shlomo,8,0,20,12
1657655019349,ECE 45,A01,083139,Congero; Spencer William,6,0,75,69
1657655025371,ECE 65,A50,083695,Saad; Andrew S,12,0,30,18
1657655025371,ECE 65,A51,095125,Saad; Andrew S,24,0,26,2
1657655031395,ECE 109,A01,091882,Touri; Behrouz,19,0,70,51
1657655037436,ECE 180,A00,083140,Abi Samra; Nicholas Camill,1,0,30,29
1657655037436,ECE 180,B00,083141,Abi Samra; Nicholas Camill,0,0,30,30
1657655043462,MATH 10A,A01,083735,Patchell; Gregory David,2,0,30,28
1657655043462,MATH 10A,A02,083736,Patchell; Gregory David,20,0,30,10
1657655043462,MATH 10A,A03,083737,Patchell; Gregory David,16,0,30,14
1657655049486,MATH 10B,A01,083207,Lim; Seonhee,8,0,34,26
1657655049486,MATH 10B,A02,083208,Lim; Seonhee,9,0,35,26
1657655049486,MATH 10B,A03,093472,Lim; Seonhee,7,0,34,27
1657655049486,MATH 10B,B01,083739,Sinha; Shubham,13,0,30,17
1657655055510,MATH 18,A01,083743,Cinel; Cameron Alexander,7,0,30,23
1657655055510,MATH 18,A02,083744,Cinel; Cameron Alexander,17,0,30,13
1657655055510,MATH 18,A03,083745,Cinel; Cameron Alexander,10,0,30,20
1657655055510,MATH 18,B01,083748,Rideout; David Porter,5,0,37,32
1657655055510,MATH 18,B02,083749,Rideout; David Porter,5,0,36,31
1657655055510,MATH 18,B03,083750,Rideout; David Porter,3,0,37,34
1657655055510,MATH 18,B04,083751,Rideout; David Porter,6,0,36,30
1657655055510,MATH 18,B05,093473,Rideout; David Porter,6,0,36,30
1657655055510,MATH 18,B06,093474,Rideout; David Porter,6,0,36,30
1657655061540,MATH 20A,A01,083754,Zheng; Zequn,14,0,40,26
1657655067565,MATH 20B,A01,083756,Briones; Jor-el Thomas Caparas,4,0,36,32
1657655067565,MATH 20B,A02,083757,Briones; Jor-el Thomas Caparas,1,0,36,35
1657655067565,MATH 20B,A03,093475,Briones; Jor-el Thomas Caparas,2,0,36,34
1657655073589,MATH 20C,A01,083760,Briones; Jor-el Thomas Caparas,1,0,35,34
1657655073589,MATH 20C,A02,083761,Briones; Jor-el Thomas Caparas,8,0,35,27
1657655073589,MATH 20C,A03,093476,Briones; Jor-el Thomas Caparas,0,1,36,36
1657655073589,MATH 20C,B01,083762,Bach; Quang Tran,1,0,30,29
1657655079611,MATH 20D,A01,083765,Tran; Brian Kha,5,0,30,25
1657655079611,MATH 20D,A02,083766,Tran; Brian Kha,5,0,30,25
1657655079611,MATH 20D,A03,083767,Tran; Brian Kha,5,0,30,25
1657655085652,MATH 20E,A01,083771,Ganguly; Soumya,9,0,32,23
1657655085652,MATH 20E,A02,083772,Ganguly; Soumya,6,0,32,26
1657655085652,MATH 20E,B01,083773,Ciotti; Benjamin,20,0,35,15
1657655085652,MATH 20E,B02,083774,Ciotti; Benjamin,18,0,35,17
1657655091681,MATH 103A,A01,083777,Greenfeld; Be'Eri,3,0,36,33
1657655091681,MATH 103A,A02,083778,Greenfeld; Be'Eri,5,0,36,31
1657655091681,MATH 103A,A03,093561,Greenfeld; Be'Eri,6,0,36,30
1657655091681,MATH 103A,B01,083779,Greenfeld; Be'Eri,7,0,36,29
1657655091681,MATH 103A,B02,083780,Greenfeld; Be'Eri,4,0,36,32
1657655091681,MATH 103A,B03,093562,Greenfeld; Be'Eri,3,0,36,33
1657655097703,MATH 105,A01,085443,Carter; Anne Toulson,15,0,35,20
1657655097703,MATH 105,A02,093477,Carter; Anne Toulson,20,0,35,15
1657655103730,MATH 109,A01,083213,Ganzberger; Geoffrey Michael,2,0,34,32
1657655103730,MATH 109,A02,083214,Ganzberger; Geoffrey Michael,4,0,34,30
1657655103730,MATH 109,A03,093478,Ganzberger; Geoffrey Michael,2,0,34,32
1657655103730,MATH 109,B01,083215,Ganzberger; Geoffrey Michael,1,0,32,31
1657655103730,MATH 109,B02,083216,Ganzberger; Geoffrey Michael,2,0,32,30
1657655103730,MATH 109,B03,093479,Ganzberger; Geoffrey Michael,8,0,32,24
1657655109754,MATH 142A,A01,083219,Chow; Bennett,7,0,32,25
1657655109754,MATH 142A,A02,083220,Chow; Bennett,10,0,32,22
1657655109754,MATH 142A,A03,093480,Chow; Bennett,9,0,32,23
1657655109754,MATH 142A,B03,093481,Chow; Bennett,8,0,32,24
1657655109754,MATH 142A,B04,093558,Chow; Bennett,13,0,32,19
1657655109754,MATH 142A,B05,093559,Chow; Bennett,6,0,32,26
1657655115776,MATH 193A,A01,083224,Rotar; Vladimir,8,0,34,26
1657655115776,MATH 193A,A02,083225,Rotar; Vladimir,9,0,34,25
1657655115776,MATH 193A,A03,083781,Rotar; Vladimir,5,0,34,29
1657655115776,MATH 193A,A04,083782,Rotar; Vladimir,10,0,34,24
1657655115776,MATH 193A,A05,093482,Rotar; Vladimir,10,0,34,24
1657655121808,MATH 197,001,091859,McAuley; Julian John,9999,0,9999,0
1657655121808,MATH 197,002,095566,Kedlaya; Kiran S.,9997,0,9999,2
1657655121808,MATH 197,003,095567,Xiao; Ming,9999,0,9999,0
1657655121808,MATH 197,004,095571,Perols; Johan Lars,9998,0,9999,1
1657655128870,COGS 9,A01,083615,Shannon; Kyle Michael,9,0,75,66
1657655134899,COGS 11,A01,083617,Boyle; Mary E. T.,23,0,48,25
1657655140926,COGS 13,A01,083071,Bastos; Amalia Pinkusfeld,11,0,71,60
1657655146953,COGS 14A,A01,092681,Semenuks; Arturs,5,1,100,95
1657655152974,COGS 14B,A01,083073,Cheng; Tzu-Han,6,0,63,57
1657655159016,COGS 17,A01,092677,Semenuks; Arturs,6,0,81,75
1657655165041,COGS 100,A01,083619,Allen; Michael Gordon,17,0,70,53
1657655171067,COGS 101A,A01,083621,Davis; Joshua Daniel,9,0,68,59
1657655177093,COGS 101B,A01,091572,Allen; Michael Gordon,12,0,65,53
1657655183121,COGS 101C,A01,083625,Delgado; Tania,17,0,35,18
1657655189146,COGS 107A,A01,083627,Boyle; Mary E. T.,13,0,60,47
1657655195172,COGS 118A,A01,083075,Gupta; Anjum,21,0,76,55
1657655201195,CSE 3,A50,083646,Miranda; Gregory Joseph,24,0,50,26
1657655207224,CSE 8A,A50,083650,Miranda; Gregory Joseph,17,1,56,39
1657655213258,CSE 11,A01,083080,Cao; Yingjun,6,15,40,34
1657655219290,CSE 12,A01,083652,Krause-Levy; Sophia Louisa,28,1,120,92
1657655225315,CSE 15L,A01,083654,Morris; Justin Loren,9,0,50,41
1657655225315,CSE 15L,A02,083655,Morris; Justin Loren,9,0,50,41
1657655231338,CSE 20,A01,083657,Tran; Khoa Dang,39,0,80,41
1657655237361,CSE 21,A01,095574,Bach; Quang Tran,22,0,48,26
1657655243389,CSE 30,A01,083084,Eldon; John,6,0,80,74
1657655243389,CSE 30,B01,095061,Bhaskar; Nishant,9,0,50,41
1657655249413,CSE 100,A01,083659,Cao; Yingjun,5,4,70,65
1657655255436,CSE 134B,A01,083661,Powell; Thomas Allan,23,0,100,77
1657655261462,CSE 140,A01,083663,Gungor; Onat,15,0,85,70
1657655267503,CSE 140L,A01,083088,Eldon; John,21,0,100,79
1657655273526,CSE 175,A01,083665,Kumar; Rakesh,3,0,25,22
1657655279553,CSE 190,A00,092507,Dubnov; Shlomo,8,0,20,12
1657655285586,ECE 45,A01,083139,Congero; Spencer William,6,0,75,69
1657655291614,ECE 65,A50,083695,Saad; Andrew S,12,0,30,18
1657655291614,ECE 65,A51,095125,Saad; Andrew S,24,0,26,2
1657655297645,ECE 109,A01,091882,Touri; Behrouz,19,0,70,51
1657655303673,ECE 180,A00,083140,Abi Samra; Nicholas Camill,1,0,30,29
1657655303673,ECE 180,B00,083141,Abi Samra; Nicholas Camill,0,0,30,30
1657655309695,MATH 10A,A01,083735,Patchell; Gregory David,2,0,30,28
1657655309695,MATH 10A,A02,083736,Patchell; Gregory David,20,0,30,10
1657655309695,MATH 10A,A03,083737,Patchell; Gregory David,16,0,30,14
1657655315725,MATH 10B,A01,083207,Lim; Seonhee,8,0,34,26
1657655315725,MATH 10B,A02,083208,Lim; Seonhee,9,0,35,26
1657655315725,MATH 10B,A03,093472,Lim; Seonhee,7,0,34,27
1657655315725,MATH 10B,B01,083739,Sinha; Shubham,13,0,30,17
1657655321755,MATH 18,A01,083743,Cinel; Cameron Alexander,7,0,30,23
1657655321755,MATH 18,A02,083744,Cinel; Cameron Alexander,17,0,30,13
1657655321755,MATH 18,A03,083745,Cinel; Cameron Alexander,10,0,30,20
1657655321755,MATH 18,B01,083748,Rideout; David Porter,5,0,37,32
1657655321755,MATH 18,B02,083749,Rideout; David Porter,5,0,36,31
1657655321755,MATH 18,B03,083750,Rideout; David Porter,3,0,37,34
1657655321755,MATH 18,B04,083751,Rideout; David Porter,6,0,36,30
1657655321755,MATH 18,B05,093473,Rideout; David Porter,6,0,36,30
1657655321755,MATH 18,B06,093474,Rideout; David Porter,6,0,36,30
1657655327779,MATH 20A,A01,083754,Zheng; Zequn,14,0,40,26
1657655333804,MATH 20B,A01,083756,Briones; Jor-el Thomas Caparas,4,0,36,32
1657655333804,MATH 20B,A02,083757,Briones; Jor-el Thomas Caparas,1,0,36,35
1657655333804,MATH 20B,A03,093475,Briones; Jor-el Thomas Caparas,2,0,36,34
1657655339832,MATH 20C,A01,083760,Briones; Jor-el Thomas Caparas,1,0,35,34
1657655339832,MATH 20C,A02,083761,Briones; Jor-el Thomas Caparas,8,0,35,27
1657655339832,MATH 20C,A03,093476,Briones; Jor-el Thomas Caparas,0,1,36,36
1657655339832,MATH 20C,B01,083762,Bach; Quang Tran,1,0,30,29
1657655345860,MATH 20D,A01,083765,Tran; Brian Kha,5,0,30,25
1657655345860,MATH 20D,A02,083766,Tran; Brian Kha,5,0,30,25
1657655345860,MATH 20D,A03,083767,Tran; Brian Kha,5,0,30,25
1657655351884,MATH 20E,A01,083771,Ganguly; Soumya,9,0,32,23
1657655351884,MATH 20E,A02,083772,Ganguly; Soumya,6,0,32,26
1657655351884,MATH 20E,B01,083773,Ciotti; Benjamin,20,0,35,15
1657655351884,MATH 20E,B02,083774,Ciotti; Benjamin,18,0,35,17
1657655357908,MATH 103A,A01,083777,Greenfeld; Be'Eri,3,0,36,33
1657655357908,MATH 103A,A02,083778,Greenfeld; Be'Eri,5,0,36,31
1657655357908,MATH 103A,A03,093561,Greenfeld; Be'Eri,6,0,36,30
1657655357908,MATH 103A,B01,083779,Greenfeld; Be'Eri,7,0,36,29
1657655357908,MATH 103A,B02,083780,Greenfeld; Be'Eri,4,0,36,32
1657655357908,MATH 103A,B03,093562,Greenfeld; Be'Eri,3,0,36,33
1657655363934,MATH 105,A01,085443,Carter; Anne Toulson,15,0,35,20
1657655363934,MATH 105,A02,093477,Carter; Anne Toulson,20,0,35,15
1657655369961,MATH 109,A01,083213,Ganzberger; Geoffrey Michael,2,0,34,32
1657655369961,MATH 109,A02,083214,Ganzberger; Geoffrey Michael,4,0,34,30
1657655369961,MATH 109,A03,093478,Ganzberger; Geoffrey Michael,2,0,34,32
1657655369961,MATH 109,B01,083215,Ganzberger; Geoffrey Michael,1,0,32,31
1657655369961,MATH 109,B02,083216,Ganzberger; Geoffrey Michael,2,0,32,30
1657655369961,MATH 109,B03,093479,Ganzberger; Geoffrey Michael,8,0,32,24
1657655375989,MATH 142A,A01,083219,Chow; Bennett,7,0,32,25
1657655375989,MATH 142A,A02,083220,Chow; Bennett,10,0,32,22
1657655375989,MATH 142A,A03,093480,Chow; Bennett,9,0,32,23
1657655375989,MATH 142A,B03,093481,Chow; Bennett,8,0,32,24
1657655375989,MATH 142A,B04,093558,Chow; Bennett,13,0,32,19
1657655375989,MATH 142A,B05,093559,Chow; Bennett,6,0,32,26
1657655382013,MATH 193A,A01,083224,Rotar; Vladimir,8,0,34,26
1657655382013,MATH 193A,A02,083225,Rotar; Vladimir,9,0,34,25
1657655382013,MATH 193A,A03,083781,Rotar; Vladimir,5,0,34,29
1657655382013,MATH 193A,A04,083782,Rotar; Vladimir,10,0,34,24
1657655382013,MATH 193A,A05,093482,Rotar; Vladimir,10,0,34,24
1657655388036,MATH 197,001,091859,McAuley; Julian John,9999,0,9999,0
1657655388036,MATH 197,002,095566,Kedlaya; Kiran S.,9997,0,9999,2
1657655388036,MATH 197,003,095567,Xiao; Ming,9999,0,9999,0
1657655388036,MATH 197,004,095571,Perols; Johan Lars,9998,0,9999,1
1657655395084,COGS 9,A01,083615,Shannon; Kyle Michael,9,0,75,66
1657655401109,COGS 11,A01,083617,Boyle; Mary E. T.,23,0,48,25
1657655407140,COGS 13,A01,083071,Bastos; Amalia Pinkusfeld,11,0,71,60
1657655413166,COGS 14A,A01,092681,Semenuks; Arturs,5,1,100,95
1657655419193,COGS 14B,A01,083073,Cheng; Tzu-Han,6,0,63,57
1657655425221,COGS 17,A01,092677,Semenuks; Arturs,6,0,81,75
1657655431254,COGS 100,A01,083619,Allen; Michael Gordon,17,0,70,53
1657655437276,COGS 101A,A01,083621,Davis; Joshua Daniel,9,0,68,59
1657655443300,COGS 101B,A01,091572,Allen; Michael Gordon,12,0,65,53
1657655449322,COGS 101C,A01,083625,Delgado; Tania,17,0,35,18
1657655455346,COGS 107A,A01,083627,Boyle; Mary E. T.,13,0,60,47
1657655461369,COGS 118A,A01,083075,Gupta; Anjum,21,0,76,55
1657655467397,CSE 3,A50,083646,Miranda; Gregory Joseph,24,0,50,26
1657655473431,CSE 8A,A50,083650,Miranda; Gregory Joseph,17,1,56,39
1657655479457,CSE 11,A01,083080,Cao; Yingjun,6,15,40,34
1657655485479,CSE 12,A01,083652,Krause-Levy; Sophia Louisa,28,1,120,92
1657655491503,CSE 15L,A01,083654,Morris; Justin Loren,9,0,50,41
1657655491503,CSE 15L,A02,083655,Morris; Justin Loren,9,0,50,41
1657655497631,CSE 20,A01,083657,Tran; Khoa Dang,39,0,80,41
1657655503658,CSE 21,A01,095574,Bach; Quang Tran,22,0,48,26
1657655509683,CSE 30,A01,083084,Eldon; John,6,0,80,74
1657655509683,CSE 30,B01,095061,Bhaskar; Nishant,9,0,50,41
1657655515711,CSE 100,A01,083659,Cao; Yingjun,5,4,70,65
1657655521748,CSE 134B,A01,083661,Powell; Thomas Allan,23,0,100,77
1657655527771,CSE 140,A01,083663,Gungor; Onat,15,0,85,70
1657655533797,CSE 140L,A01,083088,Eldon; John,21,0,100,79
1657655539822,CSE 175,A01,083665,Kumar; Rakesh,3,0,25,22
1657655545849,CSE 190,A00,092507,Dubnov; Shlomo,8,0,20,12
1657655551885,ECE 45,A01,083139,Congero; Spencer William,6,0,75,69
1657655557911,ECE 65,A50,083695,Saad; Andrew S,12,0,30,18
1657655557911,ECE 65,A51,095125,Saad; Andrew S,24,0,26,2
1657655563937,ECE 109,A01,091882,Touri; Behrouz,19,0,70,51
1657655569961,ECE 180,A00,083140,Abi Samra; Nicholas Camill,1,0,30,29
1657655569961,ECE 180,B00,083141,Abi Samra; Nicholas Camill,0,0,30,30
1657655575984,MATH 10A,A01,083735,Patchell; Gregory David,2,0,30,28
1657655575984,MATH 10A,A02,083736,Patchell; Gregory David,20,0,30,10
1657655575984,MATH 10A,A03,083737,Patchell; Gregory David,16,0,30,14
1657655582014,MATH 10B,A01,083207,Lim; Seonhee,8,0,34,26
1657655582014,MATH 10B,A02,083208,Lim; Seonhee,9,0,35,26
1657655582014,MATH 10B,A03,093472,Lim; Seonhee,7,0,34,27
1657655582014,MATH 10B,B01,083739,Sinha; Shubham,13,0,30,17
1657655588039,MATH 18,A01,083743,Cinel; Cameron Alexander,7,0,30,23
1657655588039,MATH 18,A02,083744,Cinel; Cameron Alexander,17,0,30,13
1657655588039,MATH 18,A03,083745,Cinel; Cameron Alexander,10,0,30,20
1657655588039,MATH 18,B01,083748,Rideout; David Porter,5,0,37,32
1657655588039,MATH 18,B02,083749,Rideout; David Porter,5,0,36,31
1657655588039,MATH 18,B03,083750,Rideout; David Porter,3,0,37,34
1657655588039,MATH 18,B04,083751,Rideout; David Porter,6,0,36,30
1657655588039,MATH 18,B05,093473,Rideout; David Porter,6,0,36,30
1657655588039,MATH 18,B06,093474,Rideout; David Porter,6,0,36,30
1657655594070,MATH 20A,A01,083754,Zheng; Zequn,14,0,40,26
1657655600104,MATH 20B,A01,083756,Briones; Jor-el Thomas Caparas,4,0,36,32
1657655600104,MATH 20B,A02,083757,Briones; Jor-el Thomas Caparas,1,0,36,35
1657655600104,MATH 20B,A03,093475,Briones; Jor-el Thomas Caparas,2,0,36,34
1657655606133,MATH 20C,A01,083760,Briones; Jor-el Thomas Caparas,1,0,35,34
1657655606133,MATH 20C,A02,083761,Briones; Jor-el Thomas Caparas,8,0,35,27
1657655606133,MATH 20C,A03,093476,Briones; Jor-el Thomas Caparas,0,1,36,36
1657655606133,MATH 20C,B01,083762,Bach; Quang Tran,1,0,30,29
1657655612158,MATH 20D,A01,083765,Tran; Brian Kha,5,0,30,25
1657655612158,MATH 20D,A02,083766,Tran; Brian Kha,5,0,30,25
1657655612158,MATH 20D,A03,083767,Tran; Brian Kha,5,0,30,25
1657655618186,MATH 20E,A01,083771,Ganguly; Soumya,9,0,32,23
1657655618186,MATH 20E,A02,083772,Ganguly; Soumya,6,0,32,26
1657655618186,MATH 20E,B01,083773,Ciotti; Benjamin,20,0,35,15
1657655618186,MATH 20E,B02,083774,Ciotti; Benjamin,18,0,35,17
1657655624215,MATH 103A,A01,083777,Greenfeld; Be'Eri,3,0,36,33
1657655624215,MATH 103A,A02,083778,Greenfeld; Be'Eri,5,0,36,31
1657655624215,MATH 103A,A03,093561,Greenfeld; Be'Eri,6,0,36,30
1657655624215,MATH 103A,B01,083779,Greenfeld; Be'Eri,7,0,36,29
1657655624215,MATH 103A,B02,083780,Greenfeld; Be'Eri,4,0,36,32
1657655624215,MATH 103A,B03,093562,Greenfeld; Be'Eri,3,0,36,33
1657655630238,MATH 105,A01,085443,Carter; Anne Toulson,15,0,35,20
1657655630238,MATH 105,A02,093477,Carter; Anne Toulson,20,0,35,15
1657655636261,MATH 109,A01,083213,Ganzberger; Geoffrey Michael,2,0,34,32
1657655636261,MATH 109,A02,083214,Ganzberger; Geoffrey Michael,4,0,34,30
1657655636261,MATH 109,A03,093478,Ganzberger; Geoffrey Michael,2,0,34,32
1657655636261,MATH 109,B01,083215,Ganzberger; Geoffrey Michael,1,0,32,31
1657655636261,MATH 109,B02,083216,Ganzberger; Geoffrey Michael,2,0,32,30
1657655636261,MATH 109,B03,093479,Ganzberger; Geoffrey Michael,8,0,32,24
1657655642285,MATH 142A,A01,083219,Chow; Bennett,7,0,32,25
1657655642285,MATH 142A,A02,083220,Chow; Bennett,10,0,32,22
1657655642285,MATH 142A,A03,093480,Chow; Bennett,9,0,32,23
1657655642285,MATH 142A,B03,093481,Chow; Bennett,8,0,32,24
1657655642285,MATH 142A,B04,093558,Chow; Bennett,13,0,32,19
1657655642285,MATH 142A,B05,093559,Chow; Bennett,6,0,32,26
1657655648308,MATH 193A,A01,083224,Rotar; Vladimir,8,0,34,26
1657655648308,MATH 193A,A02,083225,Rotar; Vladimir,9,0,34,25
1657655648308,MATH 193A,A03,083781,Rotar; Vladimir,5,0,34,29
1657655648308,MATH 193A,A04,083782,Rotar; Vladimir,10,0,34,24
1657655648308,MATH 193A,A05,093482,Rotar; Vladimir,10,0,34,24
1657655654345,MATH 197,001,091859,McAuley; Julian John,9999,0,9999,0
1657655654345,MATH 197,002,095566,Kedlaya; Kiran S.,9997,0,9999,2
1657655654345,MATH 197,003,095567,Xiao; Ming,9999,0,9999,0
1657655654345,MATH 197,004,095571,Perols; Johan Lars,9998,0,9999,1
1657655661399,COGS 9,A01,083615,Shannon; Kyle Michael,9,0,75,66
1657655667426,COGS 11,A01,083617,Boyle; Mary E. T.,23,0,48,25
1657655673452,COGS 13,A01,083071,Bastos; Amalia Pinkusfeld,11,0,71,60
1657655679491,COGS 14A,A01,092681,Semenuks; Arturs,5,1,100,95
1657655685513,COGS 14B,A01,083073,Cheng; Tzu-Han,6,0,63,57
1657655691549,COGS 17,A01,092677,Semenuks; Arturs,6,0,81,75
1657655697578,COGS 100,A01,083619,Allen; Michael Gordon,17,0,70,53
1657655703602,COGS 101A,A01,083621,Davis; Joshua Daniel,9,0,68,59
1657655709626,COGS 101B,A01,091572,Allen; Michael Gordon,12,0,65,53
1657655715649,COGS 101C,A01,083625,Delgado; Tania,17,0,35,18
1657655721671,COGS 107A,A01,083627,Boyle; Mary E. T.,13,0,60,47
1657655727694,COGS 118A,A01,083075,Gupta; Anjum,21,0,76,55
1657655733718,CSE 3,A50,083646,Miranda; Gregory Joseph,24,0,50,26
1657655739742,CSE 8A,A50,083650,Miranda; Gregory Joseph,17,1,56,39
1657655745772,CSE 11,A01,083080,Cao; Yingjun,6,15,40,34
1657655751800,CSE 12,A01,083652,Krause-Levy; Sophia Louisa,28,1,120,92
1657655757827,CSE 15L,A01,083654,Morris; Justin Loren,9,0,50,41
1657655757827,CSE 15L,A02,083655,Morris; Justin Loren,9,0,50,41
1657655763852,CSE 20,A01,083657,Tran; Khoa Dang,39,0,80,41
1657655769882,CSE 21,A01,095574,Bach; Quang Tran,22,0,48,26
1657655775906,CSE 30,A01,083084,Eldon; John,6,0,80,74
1657655775906,CSE 30,B01,095061,Bhaskar; Nishant,9,0,50,41
1657655781930,CSE 100,A01,083659,Cao; Yingjun,5,4,70,65
1657655787960,CSE 134B,A01,083661,Powell; Thomas Allan,23,0,100,77
1657655793982,CSE 140,A01,083663,Gungor; Onat,15,0,85,70
1657655800009,CSE 140L,A01,083088,Eldon; John,21,0,100,79
1657655806034,CSE 175,A01,083665,Kumar; Rakesh,3,0,25,22
1657655812072,CSE 190,A00,092507,Dubnov; Shlomo,8,0,20,12
1657655818173,ECE 45,A01,083139,Congero; Spencer William,6,0,75,69
1657655824206,ECE 65,A50,083695,Saad; Andrew S,12,0,30,18
1657655824206,ECE 65,A51,095125,Saad; Andrew S,24,0,26,2
1657655830229,ECE 109,A01,091882,Touri; Behrouz,19,0,70,51
1657655836254,ECE 180,A00,083140,Abi Samra; Nicholas Camill,1,0,30,29
1657655836254,ECE 180,B00,083141,Abi Samra; Nicholas Camill,0,0,30,30
1657655842291,MATH 10A,A01,083735,Patchell; Gregory David,2,0,30,28
1657655842291,MATH 10A,A02,083736,Patchell; Gregory David,20,0,30,10
1657655842291,MATH 10A,A03,083737,Patchell; Gregory David,16,0,30,14
1657655848322,MATH 10B,A01,083207,Lim; Seonhee,8,0,34,26
1657655848322,MATH 10B,A02,083208,Lim; Seonhee,9,0,35,26
1657655848322,MATH 10B,A03,093472,Lim; Seonhee,7,0,34,27
1657655848322,MATH 10B,B01,083739,Sinha; Shubham,13,0,30,17
1657655854348,MATH 18,A01,083743,Cinel; Cameron Alexander,7,0,30,23
1657655854348,MATH 18,A02,083744,Cinel; Cameron Alexander,17,0,30,13
1657655854348,MATH 18,A03,083745,Cinel; Cameron Alexander,10,0,30,20
1657655854348,MATH 18,B01,083748,Rideout; David Porter,5,0,37,32
1657655854348,MATH 18,B02,083749,Rideout; David Porter,5,0,36,31
1657655854348,MATH 18,B03,083750,Rideout; David Porter,3,0,37,34
1657655854348,MATH 18,B04,083751,Rideout; David Porter,6,0,36,30
1657655854348,MATH 18,B05,093473,Rideout; David Porter,6,0,36,30
1657655854348,MATH 18,B06,093474,Rideout; David Porter,6,0,36,30
1657655860374,MATH 20A,A01,083754,Zheng; Zequn,14,0,40,26
1657655866400,MATH 20B,A01,083756,Briones; Jor-el Thomas Caparas,4,0,36,32
1657655866400,MATH 20B,A02,083757,Briones; Jor-el Thomas Caparas,1,0,36,35
1657655866400,MATH 20B,A03,093475,Briones; Jor-el Thomas Caparas,2,0,36,34
1657655872426,MATH 20C,A01,083760,Briones; Jor-el Thomas Caparas,1,0,35,34
1657655872426,MATH 20C,A02,083761,Briones; Jor-el Thomas Caparas,8,0,35,27
1657655872426,MATH 20C,A03,093476,Briones; Jor-el Thomas Caparas,0,1,36,36
1657655872426,MATH 20C,B01,083762,Bach; Quang Tran,1,0,30,29
1657655878455,MATH 20D,A01,083765,Tran; Brian Kha,5,0,30,25
1657655878455,MATH 20D,A02,083766,Tran; Brian Kha,5,0,30,25
1657655878455,MATH 20D,A03,083767,Tran; Brian Kha,5,0,30,25
1657655884478,MATH 20E,A01,083771,Ganguly; Soumya,9,0,32,23
1657655884478,MATH 20E,A02,083772,Ganguly; Soumya,6,0,32,26
1657655884478,MATH 20E,B01,083773,Ciotti; Benjamin,20,0,35,15
1657655884478,MATH 20E,B02,083774,Ciotti; Benjamin,18,0,35,17
1657655890501,MATH 103A,A01,083777,Greenfeld; Be'Eri,3,0,36,33
1657655890501,MATH 103A,A02,083778,Greenfeld; Be'Eri,5,0,36,31
1657655890501,MATH 103A,A03,093561,Greenfeld; Be'Eri,6,0,36,30
1657655890501,MATH 103A,B01,083779,Greenfeld; Be'Eri,7,0,36,29
1657655890501,MATH 103A,B02,083780,Greenfeld; Be'Eri,4,0,36,32
1657655890501,MATH 103A,B03,093562,Greenfeld; Be'Eri,3,0,36,33
1657655896524,MATH 105,A01,085443,Carter; Anne Toulson,15,0,35,20
1657655896524,MATH 105,A02,093477,Carter; Anne Toulson,20,0,35,15
1657655902551,MATH 109,A01,083213,Ganzberger; Geoffrey Michael,2,0,34,32
1657655902551,MATH 109,A02,083214,Ganzberger; Geoffrey Michael,4,0,34,30
1657655902551,MATH 109,A03,093478,Ganzberger; Geoffrey Michael,2,0,34,32
1657655902551,MATH 109,B01,083215,Ganzberger; Geoffrey Michael,1,0,32,31
1657655902551,MATH 109,B02,083216,Ganzberger; Geoffrey Michael,2,0,32,30
1657655902551,MATH 109,B03,093479,Ganzberger; Geoffrey Michael,8,0,32,24
1657655908580,MATH 142A,A01,083219,Chow; Bennett,7,0,32,25
1657655908580,MATH 142A,A02,083220,Chow; Bennett,10,0,32,22
1657655908580,MATH 142A,A03,093480,Chow; Bennett,9,0,32,23
1657655908580,MATH 142A,B03,093481,Chow; Bennett,8,0,32,24
1657655908580,MATH 142A,B04,093558,Chow; Bennett,13,0,32,19
1657655908580,MATH 142A,B05,093559,Chow; Bennett,6,0,32,26
1657655914602,MATH 193A,A01,083224,Rotar; Vladimir,8,0,34,26
1657655914602,MATH 193A,A02,083225,Rotar; Vladimir,9,0,34,25
1657655914602,MATH 193A,A03,083781,Rotar; Vladimir,5,0,34,29
1657655914602,MATH 193A,A04,083782,Rotar; Vladimir,10,0,34,24
1657655914602,MATH 193A,A05,093482,Rotar; Vladimir,10,0,34,24
1657655920629,MATH 197,001,091859,McAuley; Julian John,9999,0,9999,0
1657655920629,MATH 197,002,095566,Kedlaya; Kiran S.,9997,0,9999,2
1657655920629,MATH 197,003,095567,Xiao; Ming,9999,0,9999,0
1657655920629,MATH 197,004,095571,Perols; Johan Lars,9998,0,9999,1
1657655927682,COGS 9,A01,083615,Shannon; Kyle Michael,9,0,75,66
1657655933705,COGS 11,A01,083617,Boyle; Mary E. T.,23,0,48,25
1657655939730,COGS 13,A01,083071,Bastos; Amalia Pinkusfeld,11,0,71,60
1657655945761,COGS 14A,A01,092681,Semenuks; Arturs,5,1,100,95
1657655951784,COGS 14B,A01,083073,Cheng; Tzu-Han,6,0,63,57
1657655957817,COGS 17,A01,092677,Semenuks; Arturs,6,0,81,75
1657655963843,COGS 100,A01,083619,Allen; Michael Gordon,17,0,70,53
1657655969864,COGS 101A,A01,083621,Davis; Joshua Daniel,9,0,68,59
1657655975888,COGS 101B,A01,091572,Allen; Michael Gordon,12,0,65,53
1657655981918,COGS 101C,A01,083625,Delgado; Tania,17,0,35,18
1657655987942,COGS 107A,A01,083627,Boyle; Mary E. T.,13,0,60,47
1657655993969,COGS 118A,A01,083075,Gupta; Anjum,21,0,76,55
1657656000002,CSE 3,A50,083646,Miranda; Gregory Joseph,24,0,50,26
1657656006029,CSE 8A,A50,083650,Miranda; Gregory Joseph,17,1,56,39
1657656012177,CSE 11,A01,083080,Cao; Yingjun,6,15,40,34
1657656018201,CSE 12,A01,083652,Krause-Levy; Sophia Louisa,28,1,120,92
1657656024227,CSE 15L,A01,083654,Morris; Justin Loren,9,0,50,41
1657656024227,CSE 15L,A02,083655,Morris; Justin Loren,9,0,50,41
1657656030253,CSE 20,A01,083657,Tran; Khoa Dang,39,0,80,41
1657656036280,CSE 21,A01,095574,Bach; Quang Tran,22,0,48,26
1657656042305,CSE 30,A01,083084,Eldon; John,6,0,80,74
1657656042305,CSE 30,B01,095061,Bhaskar; Nishant,9,0,50,41
1657656048326,CSE 100,A01,083659,Cao; Yingjun,5,4,70,65
1657656054350,CSE 134B,A01,083661,Powell; Thomas Allan,23,0,100,77
1657656060377,CSE 140,A01,083663,Gungor; Onat,15,0,85,70
1657656066402,CSE 140L,A01,083088,Eldon; John,21,0,100,79
1657656072424,CSE 175,A01,083665,Kumar; Rakesh,3,0,25,22
1657656078446,CSE 190,A00,092507,Dubnov; Shlomo,8,0,20,12
1657656084471,ECE 45,A01,083139,Congero; Spencer William,6,0,75,69
1657656090505,ECE 65,A50,083695,Saad; Andrew S,12,0,30,18
1657656090505,ECE 65,A51,095125,Saad; Andrew S,24,0,26,2
1657656096624,ECE 109,A01,091882,Touri; Behrouz,19,0,70,51
1657656102652,ECE 180,A00,083140,Abi Samra; Nicholas Camill,1,0,30,29
1657656102652,ECE 180,B00,083141,Abi Samra; Nicholas Camill,0,0,30,30
1657656108676,MATH 10A,A01,083735,Patchell; Gregory David,2,0,30,28
1657656108676,MATH 10A,A02,083736,Patchell; Gregory David,20,0,30,10
1657656108676,MATH 10A,A03,083737,Patchell; Gregory David,16,0,30,14
1657656114698,MATH 10B,A01,083207,Lim; Seonhee,8,0,34,26
1657656114698,MATH 10B,A02,083208,Lim; Seonhee,9,0,35,26
1657656114698,MATH 10B,A03,093472,Lim; Seonhee,7,0,34,27
1657656114698,MATH 10B,B01,083739,Sinha; Shubham,13,0,30,17
1657656120726,MATH 18,A01,083743,Cinel; Cameron Alexander,7,0,30,23
1657656120726,MATH 18,A02,083744,Cinel; Cameron Alexander,17,0,30,13
1657656120726,MATH 18,A03,083745,Cinel; Cameron Alexander,10,0,30,20
1657656120726,MATH 18,B01,083748,Rideout; David Porter,5,0,37,32
1657656120726,MATH 18,B02,083749,Rideout; David Porter,5,0,36,31
1657656120726,MATH 18,B03,083750,Rideout; David Porter,3,0,37,34
1657656120726,MATH 18,B04,083751,Rideout; David Porter,6,0,36,30
1657656120726,MATH 18,B05,093473,Rideout; David Porter,6,0,36,30
1657656120726,MATH 18,B06,093474,Rideout; David Porter,6,0,36,30
1657656126752,MATH 20A,A01,083754,Zheng; Zequn,14,0,40,26
1657656132774,MATH 20B,A01,083756,Briones; Jor-el Thomas Caparas,4,0,36,32
1657656132774,MATH 20B,A02,083757,Briones; Jor-el Thomas Caparas,1,0,36,35
1657656132774,MATH 20B,A03,093475,Briones; Jor-el Thomas Caparas,2,0,36,34
1657656138798,MATH 20C,A01,083760,Briones; Jor-el Thomas Caparas,1,0,35,34
1657656138798,MATH 20C,A02,083761,Briones; Jor-el Thomas Caparas,8,0,35,27
1657656138798,MATH 20C,A03,093476,Briones; Jor-el Thomas Caparas,0,1,36,36
1657656138798,MATH 20C,B01,083762,Bach; Quang Tran,1,0,30,29
1657656144826,MATH 20D,A01,083765,Tran; Brian Kha,5,0,30,25
1657656144826,MATH 20D,A02,083766,Tran; Brian Kha,5,0,30,25
1657656144826,MATH 20D,A03,083767,Tran; Brian Kha,5,0,30,25
1657656150853,MATH 20E,A01,083771,Ganguly; Soumya,9,0,32,23
1657656150853,MATH 20E,A02,083772,Ganguly; Soumya,6,0,32,26
1657656150853,MATH 20E,B01,083773,Ciotti; Benjamin,20,0,35,15
1657656150853,MATH 20E,B02,083774,Ciotti; Benjamin,18,0,35,17
1657656156881,MATH 103A,A01,083777,Greenfeld; Be'Eri,3,0,36,33
1657656156881,MATH 103A,A02,083778,Greenfeld; Be'Eri,5,0,36,31
1657656156881,MATH 103A,A03,093561,Greenfeld; Be'Eri,6,0,36,30
1657656156881,MATH 103A,B01,083779,Greenfeld; Be'Eri,7,0,36,29
1657656156881,MATH 103A,B02,083780,Greenfeld; Be'Eri,4,0,36,32
1657656156881,MATH 103A,B03,093562,Greenfeld; Be'Eri,3,0,36,33
1657656162907,MATH 105,A01,085443,Carter; Anne Toulson,15,0,35,20
1657656162907,MATH 105,A02,093477,Carter; Anne Toulson,20,0,35,15
1657656168934,MATH 109,A01,083213,Ganzberger; Geoffrey Michael,2,0,34,32
1657656168934,MATH 109,A02,083214,Ganzberger; Geoffrey Michael,4,0,34,30
1657656168934,MATH 109,A03,093478,Ganzberger; Geoffrey Michael,2,0,34,32
1657656168934,MATH 109,B01,083215,Ganzberger; Geoffrey Michael,1,0,32,31
1657656168934,MATH 109,B02,083216,Ganzberger; Geoffrey Michael,2,0,32,30
1657656168934,MATH 109,B03,093479,Ganzberger; Geoffrey Michael,8,0,32,24
1657656174962,MATH 142A,A01,083219,Chow; Bennett,7,0,32,25
1657656174962,MATH 142A,A02,083220,Chow; Bennett,10,0,32,22
1657656174962,MATH 142A,A03,093480,Chow; Bennett,9,0,32,23
1657656174962,MATH 142A,B03,093481,Chow; Bennett,8,0,32,24
1657656174962,MATH 142A,B04,093558,Chow; Bennett,13,0,32,19
1657656174962,MATH 142A,B05,093559,Chow; Bennett,6,0,32,26
1657656180984,MATH 193A,A01,083224,Rotar; Vladimir,8,0,34,26
1657656180984,MATH 193A,A02,083225,Rotar; Vladimir,9,0,34,25
1657656180984,MATH 193A,A03,083781,Rotar; Vladimir,5,0,34,29
1657656180984,MATH 193A,A04,083782,Rotar; Vladimir,10,0,34,24
1657656180984,MATH 193A,A05,093482,Rotar; Vladimir,10,0,34,24
1657656187007,MATH 197,001,091859,McAuley; Julian John,9999,0,9999,0
1657656187007,MATH 197,002,095566,Kedlaya; Kiran S.,9997,0,9999,2
1657656187007,MATH 197,003,095567,Xiao; Ming,9999,0,9999,0
1657656187007,MATH 197,004,095571,Perols; Johan Lars,9998,0,9999,1
1657656194063,COGS 9,A01,083615,Shannon; Kyle Michael,9,0,75,66
1657656200085,COGS 11,A01,083617,Boyle; Mary E. T.,23,0,48,25
1657656206112,COGS 13,A01,083071,Bastos; Amalia Pinkusfeld,11,0,71,60
1657656212135,COGS 14A,A01,092681,Semenuks; Arturs,5,1,100,95
1657656218167,COGS 14B,A01,083073,Cheng; Tzu-Han,6,0,63,57
1657656224189,COGS 17,A01,092677,Semenuks; Arturs,6,0,81,75
1657656230211,COGS 100,A01,083619,Allen; Michael Gordon,17,0,70,53
1657656236238,COGS 101A,A01,083621,Davis; Joshua Daniel,9,0,68,59
1657656242277,COGS 101B,A01,091572,Allen; Michael Gordon,12,0,65,53
1657656248300,COGS 101C,A01,083625,Delgado; Tania,17,0,35,18
1657656254327,COGS 107A,A01,083627,Boyle; Mary E. T.,13,0,60,47
1657656260378,COGS 118A,A01,083075,Gupta; Anjum,21,0,76,55
1657656266405,CSE 3,A50,083646,Miranda; Gregory Joseph,24,0,50,26
1657656272428,CSE 8A,A50,083650,Miranda; Gregory Joseph,17,1,56,39
1657656278449,CSE 11,A01,083080,Cao; Yingjun,6,15,40,34
1657656284473,CSE 12,A01,083652,Krause-Levy; Sophia Louisa,28,1,120,92
1657656290501,CSE 15L,A01,083654,Morris; Justin Loren,9,0,50,41
1657656290501,CSE 15L,A02,083655,Morris; Justin Loren,9,0,50,41
1657656296523,CSE 20,A01,083657,Tran; Khoa Dang,39,0,80,41
1657656302549,CSE 21,A01,095574,Bach; Quang Tran,22,0,48,26
1657656308575,CSE 30,A01,083084,Eldon; John,6,0,80,74
1657656308575,CSE 30,B01,095061,Bhaskar; Nishant,9,0,50,41
1657656314602,CSE 100,A01,083659,Cao; Yingjun,5,4,70,65
1657656320624,CSE 134B,A01,083661,Powell; Thomas Allan,23,0,100,77
1657656326646,CSE 140,A01,083663,Gungor; Onat,15,0,85,70
1657656332672,CSE 140L,A01,083088,Eldon; John,21,0,100,79
1657656338696,CSE 175,A01,083665,Kumar; Rakesh,3,0,25,22
1657656344717,CSE 190,A00,092507,Dubnov; Shlomo,8,0,20,12
1657656350741,ECE 45,A01,083139,Congero; Spencer William,6,0,75,69
1657656356763,ECE 65,A50,083695,Saad; Andrew S,12,0,30,18
1657656356763,ECE 65,A51,095125,Saad; Andrew S,24,0,26,2
1657656362790,ECE 109,A01,091882,Touri; Behrouz,19,0,70,51
1657656368821,ECE 180,A00,083140,Abi Samra; Nicholas Camill,1,0,30,29
1657656368821,ECE 180,B00,083141,Abi Samra; Nicholas Camill,0,0,30,30
1657656374848,MATH 10A,A01,083735,Patchell; Gregory David,2,0,30,28
1657656374848,MATH 10A,A02,083736,Patchell; Gregory David,20,0,30,10
1657656374848,MATH 10A,A03,083737,Patchell; Gregory David,16,0,30,14
1657656380872,MATH 10B,A01,083207,Lim; Seonhee,8,0,34,26
1657656380872,MATH 10B,A02,083208,Lim; Seonhee,9,0,35,26
1657656380872,MATH 10B,A03,093472,Lim; Seonhee,7,0,34,27
1657656380872,MATH 10B,B01,083739,Sinha; Shubham,13,0,30,17
1657656386902,MATH 18,A01,083743,Cinel; Cameron Alexander,7,0,30,23
1657656386902,MATH 18,A02,083744,Cinel; Cameron Alexander,17,0,30,13
1657656386902,MATH 18,A03,083745,Cinel; Cameron Alexander,10,0,30,20
1657656386902,MATH 18,B01,083748,Rideout; David Porter,5,0,37,32
1657656386902,MATH 18,B02,083749,Rideout; David Porter,5,0,36,31
1657656386902,MATH 18,B03,083750,Rideout; David Porter,3,0,37,34
1657656386902,MATH 18,B04,083751,Rideout; David Porter,6,0,36,30
1657656386902,MATH 18,B05,093473,Rideout; David Porter,6,0,36,30
1657656386902,MATH 18,B06,093474,Rideout; David Porter,6,0,36,30
1657656392928,MATH 20A,A01,083754,Zheng; Zequn,14,0,40,26
1657656398951,MATH 20B,A01,083756,Briones; Jor-el Thomas Caparas,4,0,36,32
1657656398951,MATH 20B,A02,083757,Briones; Jor-el Thomas Caparas,1,0,36,35
1657656398951,MATH 20B,A03,093475,Briones; Jor-el Thomas Caparas,2,0,36,34
1657656404984,MATH 20C,A01,083760,Briones; Jor-el Thomas Caparas,1,0,35,34
1657656404984,MATH 20C,A02,083761,Briones; Jor-el Thomas Caparas,8,0,35,27
1657656404984,MATH 20C,A03,093476,Briones; Jor-el Thomas Caparas,0,1,36,36
1657656404984,MATH 20C,B01,083762,Bach; Quang Tran,1,0,30,29
1657656411012,MATH 20D,A01,083765,Tran; Brian Kha,5,0,30,25
1657656411012,MATH 20D,A02,083766,Tran; Brian Kha,5,0,30,25
1657656411012,MATH 20D,A03,083767,Tran; Brian Kha,5,0,30,25
1657656417035,MATH 20E,A01,083771,Ganguly; Soumya,9,0,32,23
1657656417035,MATH 20E,A02,083772,Ganguly; Soumya,6,0,32,26
1657656417035,MATH 20E,B01,083773,Ciotti; Benjamin,20,0,35,15
1657656417035,MATH 20E,B02,083774,Ciotti; Benjamin,18,0,35,17
1657656423065,MATH 103A,A01,083777,Greenfeld; Be'Eri,3,0,36,33
1657656423065,MATH 103A,A02,083778,Greenfeld; Be'Eri,5,0,36,31
1657656423065,MATH 103A,A03,093561,Greenfeld; Be'Eri,6,0,36,30
1657656423065,MATH 103A,B01,083779,Greenfeld; Be'Eri,7,0,36,29
1657656423065,MATH 103A,B02,083780,Greenfeld; Be'Eri,4,0,36,32
1657656423065,MATH 103A,B03,093562,Greenfeld; Be'Eri,3,0,36,33
1657656429091,MATH 105,A01,085443,Carter; Anne Toulson,15,0,35,20
1657656429091,MATH 105,A02,093477,Carter; Anne Toulson,20,0,35,15
1657656435114,MATH 109,A01,083213,Ganzberger; Geoffrey Michael,2,0,34,32
1657656435114,MATH 109,A02,083214,Ganzberger; Geoffrey Michael,4,0,34,30
1657656435114,MATH 109,A03,093478,Ganzberger; Geoffrey Michael,2,0,34,32
1657656435114,MATH 109,B01,083215,Ganzberger; Geoffrey Michael,1,0,32,31
1657656435114,MATH 109,B02,083216,Ganzberger; Geoffrey Michael,2,0,32,30
1657656435114,MATH 109,B03,093479,Ganzberger; Geoffrey Michael,8,0,32,24
1657656441142,MATH 142A,A01,083219,Chow; Bennett,7,0,32,25
1657656441142,MATH 142A,A02,083220,Chow; Bennett,10,0,32,22
1657656441142,MATH 142A,A03,093480,Chow; Bennett,9,0,32,23
1657656441142,MATH 142A,B03,093481,Chow; Bennett,8,0,32,24
1657656441142,MATH 142A,B04,093558,Chow; Bennett,13,0,32,19
1657656441142,MATH 142A,B05,093559,Chow; Bennett,6,0,32,26
1657656447170,MATH 193A,A01,083224,Rotar; Vladimir,8,0,34,26
1657656447170,MATH 193A,A02,083225,Rotar; Vladimir,9,0,34,25
1657656447170,MATH 193A,A03,083781,Rotar; Vladimir,5,0,34,29
1657656447170,MATH 193A,A04,083782,Rotar; Vladimir,10,0,34,24
1657656447170,MATH 193A,A05,093482,Rotar; Vladimir,10,0,34,24
1657656453197,MATH 197,001,091859,McAuley; Julian John,9999,0,9999,0
1657656453197,MATH 197,002,095566,Kedlaya; Kiran S.,9997,0,9999,2
1657656453197,MATH 197,003,095567,Xiao; Ming,9999,0,9999,0
1657656453197,MATH 197,004,095571,Perols; Johan Lars,9998,0,9999,1
1657656460270,COGS 9,A01,083615,Shannon; Kyle Michael,9,0,75,66
1657656466295,COGS 11,A01,083617,Boyle; Mary E. T.,23,0,48,25
1657656472326,COGS 13,A01,083071,Bastos; Amalia Pinkusfeld,11,0,71,60
1657656478351,COGS 14A,A01,092681,Semenuks; Arturs,5,1,100,95
1657656484377,COGS 14B,A01,083073,Cheng; Tzu-Han,6,0,63,57
1657656490414,COGS 17,A01,092677,Semenuks; Arturs,6,0,81,75
1657656496441,COGS 100,A01,083619,Allen; Michael Gordon,17,0,70,53
1657656502464,COGS 101A,A01,083621,Davis; Joshua Daniel,9,0,68,59
1657656508491,COGS 101B,A01,091572,Allen; Michael Gordon,12,0,65,53
1657656514518,COGS 101C,A01,083625,Delgado; Tania,17,0,35,18
1657656520540,COGS 107A,A01,083627,Boyle; Mary E. T.,13,0,60,47
1657656526568,COGS 118A,A01,083075,Gupta; Anjum,21,0,76,55
1657656532596,CSE 3,A50,083646,Miranda; Gregory Joseph,24,0,50,26
1657656538621,CSE 8A,A50,083650,Miranda; Gregory Joseph,17,1,56,39
1657656544646,CSE 11,A01,083080,Cao; Yingjun,6,15,40,34
1657656550674,CSE 12,A01,083652,Krause-Levy; Sophia Louisa,28,1,120,92
1657656556734,CSE 15L,A01,083654,Morris; Justin Loren,9,0,50,41
1657656556734,CSE 15L,A02,083655,Morris; Justin Loren,9,0,50,41
1657656562769,CSE 20,A01,083657,Tran; Khoa Dang,39,0,80,41
1657656568819,CSE 21,A01,095574,Bach; Quang Tran,22,0,48,26
1657656574860,CSE 30,A01,083084,Eldon; John,6,0,80,74
1657656574860,CSE 30,B01,095061,Bhaskar; Nishant,9,0,50,41
1657656580885,CSE 100,A01,083659,Cao; Yingjun,5,4,70,65
1657656586918,CSE 134B,A01,083661,Powell; Thomas Allan,23,0,100,77
1657656592943,CSE 140,A01,083663,Gungor; Onat,15,0,85,70
1657656598966,CSE 140L,A01,083088,Eldon; John,21,0,100,79
1657656604992,CSE 175,A01,083665,Kumar; Rakesh,3,0,25,22
1657656611014,CSE 190,A00,092507,Dubnov; Shlomo,8,0,20,12
1657656617036,ECE 45,A01,083139,Congero; Spencer William,6,0,75,69
1657656623060,ECE 65,A50,083695,Saad; Andrew S,12,0,30,18
1657656623060,ECE 65,A51,095125,Saad; Andrew S,24,0,26,2
1657656629085,ECE 109,A01,091882,Touri; Behrouz,19,0,70,51
1657656635109,ECE 180,A00,083140,Abi Samra; Nicholas Camill,1,0,30,29
1657656635109,ECE 180,B00,083141,Abi Samra; Nicholas Camill,0,0,30,30
1657656641144,MATH 10A,A01,083735,Patchell; Gregory David,2,0,30,28
1657656641144,MATH 10A,A02,083736,Patchell; Gregory David,20,0,30,10
1657656641144,MATH 10A,A03,083737,Patchell; Gregory David,16,0,30,14
1657656647174,MATH 10B,A01,083207,Lim; Seonhee,8,0,34,26
1657656647174,MATH 10B,A02,083208,Lim; Seonhee,9,0,35,26
1657656647174,MATH 10B,A03,093472,Lim; Seonhee,7,0,34,27
1657656647174,MATH 10B,B01,083739,Sinha; Shubham,13,0,30,17
1657656653228,MATH 18,A01,083743,Cinel; Cameron Alexander,7,0,30,23
1657656653228,MATH 18,A02,083744,Cinel; Cameron Alexander,17,0,30,13
1657656653228,MATH 18,A03,083745,Cinel; Cameron Alexander,10,0,30,20
1657656653228,MATH 18,B01,083748,Rideout; David Porter,5,0,37,32
1657656653228,MATH 18,B02,083749,Rideout; David Porter,5,0,36,31
1657656653228,MATH 18,B03,083750,Rideout; David Porter,3,0,37,34
1657656653228,MATH 18,B04,083751,Rideout; David Porter,6,0,36,30
1657656653228,MATH 18,B05,093473,Rideout; David Porter,6,0,36,30
1657656653228,MATH 18,B06,093474,Rideout; David Porter,6,0,36,30
1657656659256,MATH 20A,A01,083754,Zheng; Zequn,14,0,40,26
1657656665291,MATH 20B,A01,083756,Briones; Jor-el Thomas Caparas,4,0,36,32
1657656665291,MATH 20B,A02,083757,Briones; Jor-el Thomas Caparas,1,0,36,35
1657656665291,MATH 20B,A03,093475,Briones; Jor-el Thomas Caparas,2,0,36,34
1657656671315,MATH 20C,A01,083760,Briones; Jor-el Thomas Caparas,1,0,35,34
1657656671315,MATH 20C,A02,083761,Briones; Jor-el Thomas Caparas,8,0,35,27
1657656671315,MATH 20C,A03,093476,Briones; Jor-el Thomas Caparas,0,1,36,36
1657656671315,MATH 20C,B01,083762,Bach; Quang Tran,1,0,30,29
1657656677348,MATH 20D,A01,083765,Tran; Brian Kha,5,0,30,25
1657656677348,MATH 20D,A02,083766,Tran; Brian Kha,5,0,30,25
1657656677348,MATH 20D,A03,083767,Tran; Brian Kha,5,0,30,25
1657656683376,MATH 20E,A01,083771,Ganguly; Soumya,9,0,32,23
1657656683376,MATH 20E,A02,083772,Ganguly; Soumya,6,0,32,26
1657656683376,MATH 20E,B01,083773,Ciotti; Benjamin,20,0,35,15
1657656683376,MATH 20E,B02,083774,Ciotti; Benjamin,18,0,35,17
1657656689425,MATH 103A,A01,083777,Greenfeld; Be'Eri,3,0,36,33
1657656689425,MATH 103A,A02,083778,Greenfeld; Be'Eri,5,0,36,31
1657656689425,MATH 103A,A03,093561,Greenfeld; Be'Eri,6,0,36,30
1657656689425,MATH 103A,B01,083779,Greenfeld; Be'Eri,7,0,36,29
1657656689425,MATH 103A,B02,083780,Greenfeld; Be'Eri,4,0,36,32
1657656689425,MATH 103A,B03,093562,Greenfeld; Be'Eri,3,0,36,33
1657656695524,MATH 105,A01,085443,Carter; Anne Toulson,15,0,35,20
1657656695524,MATH 105,A02,093477,Carter; Anne Toulson,20,0,35,15
1657656701548,MATH 109,A01,083213,Ganzberger; Geoffrey Michael,2,0,34,32
1657656701548,MATH 109,A02,083214,Ganzberger; Geoffrey Michael,4,0,34,30
1657656701548,MATH 109,A03,093478,Ganzberger; Geoffrey Michael,2,0,34,32
1657656701548,MATH 109,B01,083215,Ganzberger; Geoffrey Michael,1,0,32,31
1657656701548,MATH 109,B02,083216,Ganzberger; Geoffrey Michael,2,0,32,30
1657656701548,MATH 109,B03,093479,Ganzberger; Geoffrey Michael,8,0,32,24
1657656707585,MATH 142A,A01,083219,Chow; Bennett,7,0,32,25
1657656707585,MATH 142A,A02,083220,Chow; Bennett,10,0,32,22
1657656707585,MATH 142A,A03,093480,Chow; Bennett,9,0,32,23
1657656707585,MATH 142A,B03,093481,Chow; Bennett,8,0,32,24
1657656707585,MATH 142A,B04,093558,Chow; Bennett,13,0,32,19
1657656707585,MATH 142A,B05,093559,Chow; Bennett,6,0,32,26
1657656713610,MATH 193A,A01,083224,Rotar; Vladimir,8,0,34,26
1657656713610,MATH 193A,A02,083225,Rotar; Vladimir,9,0,34,25
1657656713610,MATH 193A,A03,083781,Rotar; Vladimir,5,0,34,29
1657656713610,MATH 193A,A04,083782,Rotar; Vladimir,10,0,34,24
1657656713610,MATH 193A,A05,093482,Rotar; Vladimir,10,0,34,24
1657656719644,MATH 197,001,091859,McAuley; Julian John,9999,0,9999,0
1657656719644,MATH 197,002,095566,Kedlaya; Kiran S.,9997,0,9999,2
1657656719644,MATH 197,003,095567,Xiao; Ming,9999,0,9999,0
1657656719644,MATH 197,004,095571,Perols; Johan Lars,9998,0,9999,1
1657656726714,COGS 9,A01,083615,Shannon; Kyle Michael,9,0,75,66
1657656732748,COGS 11,A01,083617,Boyle; Mary E. T.,23,0,48,25
1657656738772,COGS 13,A01,083071,Bastos; Amalia Pinkusfeld,11,0,71,60
1657656744797,COGS 14A,A01,092681,Semenuks; Arturs,5,1,100,95
1657656750826,COGS 14B,A01,083073,Cheng; Tzu-Han,6,0,63,57
1657656756864,COGS 17,A01,092677,Semenuks; Arturs,6,0,81,75
1657656762886,COGS 100,A01,083619,Allen; Michael Gordon,17,0,70,53
1657656768914,COGS 101A,A01,083621,Davis; Joshua Daniel,9,0,68,59
1657656774935,COGS 101B,A01,091572,Allen; Michael Gordon,12,0,65,53
1657656780959,COGS 101C,A01,083625,Delgado; Tania,17,0,35,18
1657656786981,COGS 107A,A01,083627,Boyle; Mary E. T.,13,0,60,47
1657656793005,COGS 118A,A01,083075,Gupta; Anjum,21,0,76,55
1657656799032,CSE 3,A50,083646,Miranda; Gregory Joseph,24,0,50,26
1657656805067,CSE 8A,A50,083650,Miranda; Gregory Joseph,17,1,56,39
1657656811093,CSE 11,A01,083080,Cao; Yingjun,6,15,40,34
1657656817126,CSE 12,A01,083652,Krause-Levy; Sophia Louisa,28,1,120,92
1657656823153,CSE 15L,A01,083654,Morris; Justin Loren,9,0,50,41
1657656823153,CSE 15L,A02,083655,Morris; Justin Loren,9,0,50,41
1657656829179,CSE 20,A01,083657,Tran; Khoa Dang,39,0,80,41
1657656835201,CSE 21,A01,095574,Bach; Quang Tran,22,0,48,26
1657656841225,CSE 30,A01,083084,Eldon; John,6,0,80,74
1657656841225,CSE 30,B01,095061,Bhaskar; Nishant,9,0,50,41
1657656847248,CSE 100,A01,083659,Cao; Yingjun,5,4,70,65
1657656853271,CSE 134B,A01,083661,Powell; Thomas Allan,23,0,100,77
1657656859295,CSE 140,A01,083663,Gungor; Onat,15,0,85,70
1657656865322,CSE 140L,A01,083088,Eldon; John,21,0,100,79
1657656871347,CSE 175,A01,083665,Kumar; Rakesh,3,0,25,22
1657656877369,CSE 190,A00,092507,Dubnov; Shlomo,8,0,20,12
1657656883401,ECE 45,A01,083139,Congero; Spencer William,6,0,75,69
1657656889428,ECE 65,A50,083695,Saad; Andrew S,12,0,30,18
1657656889428,ECE 65,A51,095125,Saad; Andrew S,24,0,26,2
1657656895456,ECE 109,A01,091882,Touri; Behrouz,19,0,70,51
1657656901478,ECE 180,A00,083140,Abi Samra; Nicholas Camill,1,0,30,29
1657656901478,ECE 180,B00,083141,Abi Samra; Nicholas Camill,0,0,30,30
1657656907513,MATH 10A,A01,083735,Patchell; Gregory David,2,0,30,28
1657656907513,MATH 10A,A02,083736,Patchell; Gregory David,20,0,30,10
1657656907513,MATH 10A,A03,083737,Patchell; Gregory David,16,0,30,14
1657656913544,MATH 10B,A01,083207,Lim; Seonhee,8,0,34,26
1657656913544,MATH 10B,A02,083208,Lim; Seonhee,9,0,35,26
1657656913544,MATH 10B,A03,093472,Lim; Seonhee,7,0,34,27
1657656913544,MATH 10B,B01,083739,Sinha; Shubham,13,0,30,17
1657656919567,MATH 18,A01,083743,Cinel; Cameron Alexander,7,0,30,23
1657656919567,MATH 18,A02,083744,Cinel; Cameron Alexander,17,0,30,13
1657656919567,MATH 18,A03,083745,Cinel; Cameron Alexander,10,0,30,20
1657656919567,MATH 18,B01,083748,Rideout; David Porter,5,0,37,32
1657656919567,MATH 18,B02,083749,Rideout; David Porter,5,0,36,31
1657656919567,MATH 18,B03,083750,Rideout; David Porter,3,0,37,34
1657656919567,MATH 18,B04,083751,Rideout; David Porter,6,0,36,30
1657656919567,MATH 18,B05,093473,Rideout; David Porter,6,0,36,30
1657656919567,MATH 18,B06,093474,Rideout; David Porter,6,0,36,30
1657656925590,MATH 20A,A01,083754,Zheng; Zequn,14,0,40,26
1657656931612,MATH 20B,A01,083756,Briones; Jor-el Thomas Caparas,4,0,36,32
1657656931612,MATH 20B,A02,083757,Briones; Jor-el Thomas Caparas,1,0,36,35
1657656931612,MATH 20B,A03,093475,Briones; Jor-el Thomas Caparas,2,0,36,34
1657656937637,MATH 20C,A01,083760,Briones; Jor-el Thomas Caparas,1,0,35,34
1657656937637,MATH 20C,A02,083761,Briones; Jor-el Thomas Caparas,8,0,35,27
1657656937637,MATH 20C,A03,093476,Briones; Jor-el Thomas Caparas,0,1,36,36
1657656937637,MATH 20C,B01,083762,Bach; Quang Tran,1,0,30,29
1657656943660,MATH 20D,A01,083765,Tran; Brian Kha,5,0,30,25
1657656943660,MATH 20D,A02,083766,Tran; Brian Kha,5,0,30,25
1657656943660,MATH 20D,A03,083767,Tran; Brian Kha,5,0,30,25
1657656949685,MATH 20E,A01,083771,Ganguly; Soumya,9,0,32,23
1657656949685,MATH 20E,A02,083772,Ganguly; Soumya,6,0,32,26
1657656949685,MATH 20E,B01,083773,Ciotti; Benjamin,20,0,35,15
1657656949685,MATH 20E,B02,083774,Ciotti; Benjamin,18,0,35,17
1657656955713,MATH 103A,A01,083777,Greenfeld; Be'Eri,3,0,36,33
1657656955713,MATH 103A,A02,083778,Greenfeld; Be'Eri,5,0,36,31
1657656955713,MATH 103A,A03,093561,Greenfeld; Be'Eri,6,0,36,30
1657656955713,MATH 103A,B01,083779,Greenfeld; Be'Eri,7,0,36,29
1657656955713,MATH 103A,B02,083780,Greenfeld; Be'Eri,4,0,36,32
1657656955713,MATH 103A,B03,093562,Greenfeld; Be'Eri,3,0,36,33
1657656961756,MATH 105,A01,085443,Carter; Anne Toulson,15,0,35,20
1657656961756,MATH 105,A02,093477,Carter; Anne Toulson,20,0,35,15
1657656967779,MATH 109,A01,083213,Ganzberger; Geoffrey Michael,2,0,34,32
1657656967779,MATH 109,A02,083214,Ganzberger; Geoffrey Michael,4,0,34,30
1657656967779,MATH 109,A03,093478,Ganzberger; Geoffrey Michael,2,0,34,32
1657656967779,MATH 109,B01,083215,Ganzberger; Geoffrey Michael,1,0,32,31
1657656967779,MATH 109,B02,083216,Ganzberger; Geoffrey Michael,2,0,32,30
1657656967779,MATH 109,B03,093479,Ganzberger; Geoffrey Michael,8,0,32,24
1657656973806,MATH 142A,A01,083219,Chow; Bennett,7,0,32,25
1657656973806,MATH 142A,A02,083220,Chow; Bennett,10,0,32,22
1657656973806,MATH 142A,A03,093480,Chow; Bennett,9,0,32,23
1657656973806,MATH 142A,B03,093481,Chow; Bennett,8,0,32,24
1657656973806,MATH 142A,B04,093558,Chow; Bennett,13,0,32,19
1657656973806,MATH 142A,B05,093559,Chow; Bennett,6,0,32,26
1657656979834,MATH 193A,A01,083224,Rotar; Vladimir,8,0,34,26
1657656979834,MATH 193A,A02,083225,Rotar; Vladimir,9,0,34,25
1657656979834,MATH 193A,A03,083781,Rotar; Vladimir,5,0,34,29
1657656979834,MATH 193A,A04,083782,Rotar; Vladimir,10,0,34,24
1657656979834,MATH 193A,A05,093482,Rotar; Vladimir,10,0,34,24
1657656985856,MATH 197,001,091859,McAuley; Julian John,9999,0,9999,0
1657656985856,MATH 197,002,095566,Kedlaya; Kiran S.,9997,0,9999,2
1657656985856,MATH 197,003,095567,Xiao; Ming,9999,0,9999,0
1657656985856,MATH 197,004,095571,Perols; Johan Lars,9998,0,9999,1
1657656992909,COGS 9,A01,083615,Shannon; Kyle Michael,9,0,75,66
1657656998932,COGS 11,A01,083617,Boyle; Mary E. T.,23,0,48,25
1657657004959,COGS 13,A01,083071,Bastos; Amalia Pinkusfeld,11,0,71,60
1657657010994,COGS 14A,A01,092681,Semenuks; Arturs,5,1,100,95
1657657017021,COGS 14B,A01,083073,Cheng; Tzu-Han,6,0,63,57
1657657023045,COGS 17,A01,092677,Semenuks; Arturs,6,0,81,75
1657657029067,COGS 100,A01,083619,Allen; Michael Gordon,17,0,70,53
1657657035089,COGS 101A,A01,083621,Davis; Joshua Daniel,9,0,68,59
1657657041116,COGS 101B,A01,091572,Allen; Michael Gordon,12,0,65,53
1657657047139,COGS 101C,A01,083625,Delgado; Tania,17,0,35,18
1657657053163,COGS 107A,A01,083627,Boyle; Mary E. T.,13,0,60,47
1657657059189,COGS 118A,A01,083075,Gupta; Anjum,21,0,76,55
1657657065213,CSE 3,A50,083646,Miranda; Gregory Joseph,24,0,50,26
1657657071236,CSE 8A,A50,083650,Miranda; Gregory Joseph,17,1,56,39
1657657077263,CSE 11,A01,083080,Cao; Yingjun,6,15,40,34
1657657083299,CSE 12,A01,083652,Krause-Levy; Sophia Louisa,28,1,120,92
1657657089323,CSE 15L,A01,083654,Morris; Justin Loren,9,0,50,41
1657657089323,CSE 15L,A02,083655,Morris; Justin Loren,9,0,50,41
1657657095347,CSE 20,A01,083657,Tran; Khoa Dang,39,0,80,41
1657657101370,CSE 21,A01,095574,Bach; Quang Tran,22,0,48,26
1657657107400,CSE 30,A01,083084,Eldon; John,6,0,80,74
1657657107400,CSE 30,B01,095061,Bhaskar; Nishant,9,0,50,41
1657657113422,CSE 100,A01,083659,Cao; Yingjun,5,4,70,65
1657657119504,CSE 134B,A01,083661,Powell; Thomas Allan,23,0,100,77
1657657125547,CSE 140,A01,083663,Gungor; Onat,15,0,85,70
1657657131581,CSE 140L,A01,083088,Eldon; John,21,0,100,79
1657657137604,CSE 175,A01,083665,Kumar; Rakesh,3,0,25,22
1657657143640,CSE 190,A00,092507,Dubnov; Shlomo,8,0,20,12
1657657149667,ECE 45,A01,083139,Congero; Spencer William,6,0,75,69
1657657155708,ECE 65,A50,083695,Saad; Andrew S,12,0,30,18
1657657155708,ECE 65,A51,095125,Saad; Andrew S,24,0,26,2
1657657161736,ECE 109,A01,091882,Touri; Behrouz,19,0,70,51
1657657167759,ECE 180,A00,083140,Abi Samra; Nicholas Camill,1,0,30,29
1657657167759,ECE 180,B00,083141,Abi Samra; Nicholas Camill,0,0,30,30
1657657173788,MATH 10A,A01,083735,Patchell; Gregory David,2,0,30,28
1657657173788,MATH 10A,A02,083736,Patchell; Gregory David,20,0,30,10
1657657173788,MATH 10A,A03,083737,Patchell; Gregory David,16,0,30,14
1657657179832,MATH 10B,A01,083207,Lim; Seonhee,8,0,34,26
1657657179832,MATH 10B,A02,083208,Lim; Seonhee,9,0,35,26
1657657179832,MATH 10B,A03,093472,Lim; Seonhee,7,0,34,27
1657657179832,MATH 10B,B01,083739,Sinha; Shubham,13,0,30,17
1657657185858,MATH 18,A01,083743,Cinel; Cameron Alexander,7,0,30,23
1657657185858,MATH 18,A02,083744,Cinel; Cameron Alexander,17,0,30,13
1657657185858,MATH 18,A03,083745,Cinel; Cameron Alexander,10,0,30,20
1657657185858,MATH 18,B01,083748,Rideout; David Porter,5,0,37,32
1657657185858,MATH 18,B02,083749,Rideout; David Porter,5,0,36,31
1657657185858,MATH 18,B03,083750,Rideout; David Porter,3,0,37,34
1657657185858,MATH 18,B04,083751,Rideout; David Porter,6,0,36,30
1657657185858,MATH 18,B05,093473,Rideout; David Porter,6,0,36,30
1657657185858,MATH 18,B06,093474,Rideout; David Porter,6,0,36,30
1657657191884,MATH 20A,A01,083754,Zheng; Zequn,14,0,40,26
1657657197912,MATH 20B,A01,083756,Briones; Jor-el Thomas Caparas,4,0,36,32
1657657197912,MATH 20B,A02,083757,Briones; Jor-el Thomas Caparas,1,0,36,35
1657657197912,MATH 20B,A03,093475,Briones; Jor-el Thomas Caparas,2,0,36,34
1657657203941,MATH 20C,A01,083760,Briones; Jor-el Thomas Caparas,1,0,35,34
1657657203941,MATH 20C,A02,083761,Briones; Jor-el Thomas Caparas,8,0,35,27
1657657203941,MATH 20C,A03,093476,Briones; Jor-el Thomas Caparas,0,1,36,36
1657657203941,MATH 20C,B01,083762,Bach; Quang Tran,1,0,30,29
1657657209972,MATH 20D,A01,083765,Tran; Brian Kha,5,0,30,25
1657657209972,MATH 20D,A02,083766,Tran; Brian Kha,5,0,30,25
1657657209972,MATH 20D,A03,083767,Tran; Brian Kha,5,0,30,25
1657657215994,MATH 20E,A01,083771,Ganguly; Soumya,9,0,32,23
1657657215994,MATH 20E,A02,083772,Ganguly; Soumya,6,0,32,26
1657657215994,MATH 20E,B01,083773,Ciotti; Benjamin,20,0,35,15
1657657215994,MATH 20E,B02,083774,Ciotti; Benjamin,18,0,35,17
1657657222033,MATH 103A,A01,083777,Greenfeld; Be'Eri,3,0,36,33
1657657222033,MATH 103A,A02,083778,Greenfeld; Be'Eri,5,0,36,31
1657657222033,MATH 103A,A03,093561,Greenfeld; Be'Eri,6,0,36,30
1657657222033,MATH 103A,B01,083779,Greenfeld; Be'Eri,7,0,36,29
1657657222033,MATH 103A,B02,083780,Greenfeld; Be'Eri,4,0,36,32
1657657222033,MATH 103A,B03,093562,Greenfeld; Be'Eri,3,0,36,33
1657657228060,MATH 105,A01,085443,Carter; Anne Toulson,15,0,35,20
1657657228060,MATH 105,A02,093477,Carter; Anne Toulson,20,0,35,15
1657657234086,MATH 109,A01,083213,Ganzberger; Geoffrey Michael,2,0,34,32
1657657234086,MATH 109,A02,083214,Ganzberger; Geoffrey Michael,4,0,34,30
1657657234086,MATH 109,A03,093478,Ganzberger; Geoffrey Michael,2,0,34,32
1657657234086,MATH 109,B01,083215,Ganzberger; Geoffrey Michael,1,0,32,31
1657657234086,MATH 109,B02,083216,Ganzberger; Geoffrey Michael,2,0,32,30
1657657234086,MATH 109,B03,093479,Ganzberger; Geoffrey Michael,8,0,32,24
1657657240109,MATH 142A,A01,083219,Chow; Bennett,7,0,32,25
1657657240109,MATH 142A,A02,083220,Chow; Bennett,10,0,32,22
1657657240109,MATH 142A,A03,093480,Chow; Bennett,9,0,32,23
1657657240109,MATH 142A,B03,093481,Chow; Bennett,8,0,32,24
1657657240109,MATH 142A,B04,093558,Chow; Bennett,13,0,32,19
1657657240109,MATH 142A,B05,093559,Chow; Bennett,6,0,32,26
1657657246135,MATH 193A,A01,083224,Rotar; Vladimir,8,0,34,26
1657657246135,MATH 193A,A02,083225,Rotar; Vladimir,9,0,34,25
1657657246135,MATH 193A,A03,083781,Rotar; Vladimir,5,0,34,29
1657657246135,MATH 193A,A04,083782,Rotar; Vladimir,10,0,34,24
1657657246135,MATH 193A,A05,093482,Rotar; Vladimir,10,0,34,24
1657657252159,MATH 197,001,091859,McAuley; Julian John,9999,0,9999,0
1657657252159,MATH 197,002,095566,Kedlaya; Kiran S.,9997,0,9999,2
1657657252159,MATH 197,003,095567,Xiao; Ming,9999,0,9999,0
1657657252159,MATH 197,004,095571,Perols; Johan Lars,9998,0,9999,1
1657657259221,COGS 9,A01,083615,Shannon; Kyle Michael,9,0,75,66
1657657265244,COGS 11,A01,083617,Boyle; Mary E. T.,23,0,48,25
1657657271266,COGS 13,A01,083071,Bastos; Amalia Pinkusfeld,11,0,71,60
1657657277300,COGS 14A,A01,092681,Semenuks; Arturs,5,1,100,95
1657657283325,COGS 14B,A01,083073,Cheng; Tzu-Han,6,0,63,57
1657657289421,COGS 17,A01,092677,Semenuks; Arturs,6,0,81,75
1657657295456,COGS 100,A01,083619,Allen; Michael Gordon,17,0,70,53
1657657301488,COGS 101A,A01,083621,Davis; Joshua Daniel,9,0,68,59
1657657307524,COGS 101B,A01,091572,Allen; Michael Gordon,12,0,65,53
1657657313550,COGS 101C,A01,083625,Delgado; Tania,17,0,35,18
1657657319571,COGS 107A,A01,083627,Boyle; Mary E. T.,13,0,60,47
1657657325599,COGS 118A,A01,083075,Gupta; Anjum,21,0,76,55
1657657331621,CSE 3,A50,083646,Miranda; Gregory Joseph,24,0,50,26
1657657337649,CSE 8A,A50,083650,Miranda; Gregory Joseph,17,1,56,39
1657657343672,CSE 11,A01,083080,Cao; Yingjun,6,15,40,34
1657657349704,CSE 12,A01,083652,Krause-Levy; Sophia Louisa,28,1,120,92
1657657355730,CSE 15L,A01,083654,Morris; Justin Loren,9,0,50,41
1657657355730,CSE 15L,A02,083655,Morris; Justin Loren,9,0,50,41
1657657361753,CSE 20,A01,083657,Tran; Khoa Dang,39,0,80,41
1657657367788,CSE 21,A01,095574,Bach; Quang Tran,22,0,48,26
1657657373814,CSE 30,A01,083084,Eldon; John,6,0,80,74
1657657373814,CSE 30,B01,095061,Bhaskar; Nishant,9,0,50,41
1657657379844,CSE 100,A01,083659,Cao; Yingjun,5,4,70,65
1657657385867,CSE 134B,A01,083661,Powell; Thomas Allan,23,0,100,77
1657657391891,CSE 140,A01,083663,Gungor; Onat,15,0,85,70
1657657397919,CSE 140L,A01,083088,Eldon; John,21,0,100,79
1657657403942,CSE 175,A01,083665,Kumar; Rakesh,3,0,25,22
1657657409967,CSE 190,A00,092507,Dubnov; Shlomo,8,0,20,12
1657657415989,ECE 45,A01,083139,Congero; Spencer William,6,0,75,69
1657657422012,ECE 65,A50,083695,Saad; Andrew S,12,0,30,18
1657657422012,ECE 65,A51,095125,Saad; Andrew S,24,0,26,2
1657657428041,ECE 109,A01,091882,Touri; Behrouz,19,0,70,51
1657657434063,ECE 180,A00,083140,Abi Samra; Nicholas Camill,1,0,30,29
1657657434063,ECE 180,B00,083141,Abi Samra; Nicholas Camill,0,0,30,30
1657657440097,MATH 10A,A01,083735,Patchell; Gregory David,2,0,30,28
1657657440097,MATH 10A,A02,083736,Patchell; Gregory David,20,0,30,10
1657657440097,MATH 10A,A03,083737,Patchell; Gregory David,16,0,30,14
1657657446266,MATH 10B,A01,083207,Lim; Seonhee,8,0,34,26
1657657446266,MATH 10B,A02,083208,Lim; Seonhee,9,0,35,26
1657657446266,MATH 10B,A03,093472,Lim; Seonhee,7,0,34,27
1657657446266,MATH 10B,B01,083739,Sinha; Shubham,13,0,30,17
1657657452291,MATH 18,A01,083743,Cinel; Cameron Alexander,7,0,30,23
1657657452291,MATH 18,A02,083744,Cinel; Cameron Alexander,17,0,30,13
1657657452291,MATH 18,A03,083745,Cinel; Cameron Alexander,10,0,30,20
1657657452291,MATH 18,B01,083748,Rideout; David Porter,5,0,37,32
1657657452291,MATH 18,B02,083749,Rideout; David Porter,5,0,36,31
1657657452291,MATH 18,B03,083750,Rideout; David Porter,3,0,37,34
1657657452291,MATH 18,B04,083751,Rideout; David Porter,6,0,36,30
1657657452291,MATH 18,B05,093473,Rideout; David Porter,6,0,36,30
1657657452291,MATH 18,B06,093474,Rideout; David Porter,6,0,36,30
1657657458315,MATH 20A,A01,083754,Zheng; Zequn,14,0,40,26
1657657464352,MATH 20B,A01,083756,Briones; Jor-el Thomas Caparas,4,0,36,32
1657657464352,MATH 20B,A02,083757,Briones; Jor-el Thomas Caparas,1,0,36,35
1657657464352,MATH 20B,A03,093475,Briones; Jor-el Thomas Caparas,2,0,36,34
1657657470375,MATH 20C,A01,083760,Briones; Jor-el Thomas Caparas,1,0,35,34
1657657470375,MATH 20C,A02,083761,Briones; Jor-el Thomas Caparas,8,0,35,27
1657657470375,MATH 20C,A03,093476,Briones; Jor-el Thomas Caparas,0,1,36,36
1657657470375,MATH 20C,B01,083762,Bach; Quang Tran,1,0,30,29
1657657476400,MATH 20D,A01,083765,Tran; Brian Kha,5,0,30,25
1657657476400,MATH 20D,A02,083766,Tran; Brian Kha,5,0,30,25
1657657476400,MATH 20D,A03,083767,Tran; Brian Kha,5,0,30,25
1657657482427,MATH 20E,A01,083771,Ganguly; Soumya,9,0,32,23
1657657482427,MATH 20E,A02,083772,Ganguly; Soumya,6,0,32,26
1657657482427,MATH 20E,B01,083773,Ciotti; Benjamin,20,0,35,15
1657657482427,MATH 20E,B02,083774,Ciotti; Benjamin,18,0,35,17
1657657488459,MATH 103A,A01,083777,Greenfeld; Be'Eri,3,0,36,33
1657657488459,MATH 103A,A02,083778,Greenfeld; Be'Eri,5,0,36,31
1657657488459,MATH 103A,A03,093561,Greenfeld; Be'Eri,6,0,36,30
1657657488459,MATH 103A,B01,083779,Greenfeld; Be'Eri,7,0,36,29
1657657488459,MATH 103A,B02,083780,Greenfeld; Be'Eri,4,0,36,32
1657657488459,MATH 103A,B03,093562,Greenfeld; Be'Eri,3,0,36,33
1657657494484,MATH 105,A01,085443,Carter; Anne Toulson,15,0,35,20
1657657494484,MATH 105,A02,093477,Carter; Anne Toulson,20,0,35,15
1657657500508,MATH 109,A01,083213,Ganzberger; Geoffrey Michael,2,0,34,32
1657657500508,MATH 109,A02,083214,Ganzberger; Geoffrey Michael,4,0,34,30
1657657500508,MATH 109,A03,093478,Ganzberger; Geoffrey Michael,2,0,34,32
1657657500508,MATH 109,B01,083215,Ganzberger; Geoffrey Michael,1,0,32,31
1657657500508,MATH 109,B02,083216,Ganzberger; Geoffrey Michael,2,0,32,30
1657657500508,MATH 109,B03,093479,Ganzberger; Geoffrey Michael,8,0,32,24
1657657506548,MATH 142A,A01,083219,Chow; Bennett,7,0,32,25
1657657506548,MATH 142A,A02,083220,Chow; Bennett,10,0,32,22
1657657506548,MATH 142A,A03,093480,Chow; Bennett,9,0,32,23
1657657506548,MATH 142A,B03,093481,Chow; Bennett,8,0,32,24
1657657506548,MATH 142A,B04,093558,Chow; Bennett,13,0,32,19
1657657506548,MATH 142A,B05,093559,Chow; Bennett,6,0,32,26
1657657512576,MATH 193A,A01,083224,Rotar; Vladimir,8,0,34,26
1657657512576,MATH 193A,A02,083225,Rotar; Vladimir,9,0,34,25
1657657512576,MATH 193A,A03,083781,Rotar; Vladimir,5,0,34,29
1657657512576,MATH 193A,A04,083782,Rotar; Vladimir,10,0,34,24
1657657512576,MATH 193A,A05,093482,Rotar; Vladimir,10,0,34,24
1657657518602,MATH 197,001,091859,McAuley; Julian John,9999,0,9999,0
1657657518602,MATH 197,002,095566,Kedlaya; Kiran S.,9997,0,9999,2
1657657518602,MATH 197,003,095567,Xiao; Ming,9999,0,9999,0
1657657518602,MATH 197,004,095571,Perols; Johan Lars,9998,0,9999,1
1657657525652,COGS 9,A01,083615,Shannon; Kyle Michael,9,0,75,66
1657657531675,COGS 11,A01,083617,Boyle; Mary E. T.,23,0,48,25
1657657537698,COGS 13,A01,083071,Bastos; Amalia Pinkusfeld,11,0,71,60
1657657543722,COGS 14A,A01,092681,Semenuks; Arturs,5,1,100,95
1657657549747,COGS 14B,A01,083073,Cheng; Tzu-Han,6,0,63,57
1657657555768,COGS 17,A01,092677,Semenuks; Arturs,6,0,81,75
1657657561791,COGS 100,A01,083619,Allen; Michael Gordon,17,0,70,53
1657657567815,COGS 101A,A01,083621,Davis; Joshua Daniel,9,0,68,59
1657657573838,COGS 101B,A01,091572,Allen; Michael Gordon,12,0,65,53
1657657579860,COGS 101C,A01,083625,Delgado; Tania,17,0,35,18
1657657591823,COGS 107A,A01,083627,Boyle; Mary E. T.,13,0,60,47
1657657597845,COGS 118A,A01,083075,Gupta; Anjum,21,0,76,55
1657657603871,CSE 3,A50,083646,Miranda; Gregory Joseph,24,0,50,26
1657657609899,CSE 8A,A50,083650,Miranda; Gregory Joseph,17,1,56,39
1657657615920,CSE 11,A01,083080,Cao; Yingjun,6,15,40,34
1657657621945,CSE 12,A01,083652,Krause-Levy; Sophia Louisa,28,1,120,92
1657657627976,CSE 15L,A01,083654,Morris; Justin Loren,9,0,50,41
1657657627976,CSE 15L,A02,083655,Morris; Justin Loren,9,0,50,41
1657657633998,CSE 20,A01,083657,Tran; Khoa Dang,39,0,80,41
1657657640022,CSE 21,A01,095574,Bach; Quang Tran,22,0,48,26
1657657646046,CSE 30,A01,083084,Eldon; John,6,0,80,74
1657657646046,CSE 30,B01,095061,Bhaskar; Nishant,9,0,50,41
1657657652069,CSE 100,A01,083659,Cao; Yingjun,5,4,70,65
1657657658101,CSE 134B,A01,083661,Powell; Thomas Allan,23,0,100,77
1657657664125,CSE 140,A01,083663,Gungor; Onat,15,0,85,70
1657657670152,CSE 140L,A01,083088,Eldon; John,21,0,100,79
1657657676178,CSE 175,A01,083665,Kumar; Rakesh,3,0,25,22
1657657682204,CSE 190,A00,092507,Dubnov; Shlomo,8,0,20,12
1657657688231,ECE 45,A01,083139,Congero; Spencer William,6,0,75,69
1657657694255,ECE 65,A50,083695,Saad; Andrew S,12,0,30,18
1657657694255,ECE 65,A51,095125,Saad; Andrew S,24,0,26,2
1657657700278,ECE 109,A01,091882,Touri; Behrouz,19,0,70,51
1657657706310,ECE 180,A00,083140,Abi Samra; Nicholas Camill,1,0,30,29
1657657706310,ECE 180,B00,083141,Abi Samra; Nicholas Camill,0,0,30,30
1657657712336,MATH 10A,A01,083735,Patchell; Gregory David,2,0,30,28
1657657712336,MATH 10A,A02,083736,Patchell; Gregory David,20,0,30,10
1657657712336,MATH 10A,A03,083737,Patchell; Gregory David,16,0,30,14
1657657718366,MATH 10B,A01,083207,Lim; Seonhee,8,0,34,26
1657657718366,MATH 10B,A02,083208,Lim; Seonhee,9,0,35,26
1657657718366,MATH 10B,A03,093472,Lim; Seonhee,7,0,34,27
1657657718366,MATH 10B,B01,083739,Sinha; Shubham,13,0,30,17
1657657724397,MATH 18,A01,083743,Cinel; Cameron Alexander,7,0,30,23
1657657724397,MATH 18,A02,083744,Cinel; Cameron Alexander,17,0,30,13
1657657724397,MATH 18,A03,083745,Cinel; Cameron Alexander,10,0,30,20
1657657724397,MATH 18,B01,083748,Rideout; David Porter,5,0,37,32
1657657724397,MATH 18,B02,083749,Rideout; David Porter,5,0,36,31
1657657724397,MATH 18,B03,083750,Rideout; David Porter,3,0,37,34
1657657724397,MATH 18,B04,083751,Rideout; David Porter,6,0,36,30
1657657724397,MATH 18,B05,093473,Rideout; David Porter,6,0,36,30
1657657724397,MATH 18,B06,093474,Rideout; David Porter,6,0,36,30
1657657730421,MATH 20A,A01,083754,Zheng; Zequn,14,0,40,26
1657657736445,MATH 20B,A01,083756,Briones; Jor-el Thomas Caparas,4,0,36,32
1657657736445,MATH 20B,A02,083757,Briones; Jor-el Thomas Caparas,1,0,36,35
1657657736445,MATH 20B,A03,093475,Briones; Jor-el Thomas Caparas,2,0,36,34
1657657742472,MATH 20C,A01,083760,Briones; Jor-el Thomas Caparas,1,0,35,34
1657657742472,MATH 20C,A02,083761,Briones; Jor-el Thomas Caparas,8,0,35,27
1657657742472,MATH 20C,A03,093476,Briones; Jor-el Thomas Caparas,0,1,36,36
1657657742472,MATH 20C,B01,083762,Bach; Quang Tran,1,0,30,29
1657657748498,MATH 20D,A01,083765,Tran; Brian Kha,5,0,30,25
1657657748498,MATH 20D,A02,083766,Tran; Brian Kha,5,0,30,25
1657657748498,MATH 20D,A03,083767,Tran; Brian Kha,5,0,30,25
1657657754521,MATH 20E,A01,083771,Ganguly; Soumya,9,0,32,23
1657657754521,MATH 20E,A02,083772,Ganguly; Soumya,6,0,32,26
1657657754521,MATH 20E,B01,083773,Ciotti; Benjamin,20,0,35,15
1657657754521,MATH 20E,B02,083774,Ciotti; Benjamin,18,0,35,17
1657657760554,MATH 103A,A01,083777,Greenfeld; Be'Eri,3,0,36,33
1657657760554,MATH 103A,A02,083778,Greenfeld; Be'Eri,5,0,36,31
1657657760554,MATH 103A,A03,093561,Greenfeld; Be'Eri,6,0,36,30
1657657760554,MATH 103A,B01,083779,Greenfeld; Be'Eri,7,0,36,29
1657657760554,MATH 103A,B02,083780,Greenfeld; Be'Eri,4,0,36,32
1657657760554,MATH 103A,B03,093562,Greenfeld; Be'Eri,3,0,36,33
1657657766580,MATH 105,A01,085443,Carter; Anne Toulson,15,0,35,20
1657657766580,MATH 105,A02,093477,Carter; Anne Toulson,20,0,35,15
1657657772615,MATH 109,A01,083213,Ganzberger; Geoffrey Michael,2,0,34,32
1657657772615,MATH 109,A02,083214,Ganzberger; Geoffrey Michael,4,0,34,30
1657657772615,MATH 109,A03,093478,Ganzberger; Geoffrey Michael,2,0,34,32
1657657772615,MATH 109,B01,083215,Ganzberger; Geoffrey Michael,1,0,32,31
1657657772615,MATH 109,B02,083216,Ganzberger; Geoffrey Michael,2,0,32,30
1657657772615,MATH 109,B03,093479,Ganzberger; Geoffrey Michael,8,0,32,24
1657657778639,MATH 142A,A01,083219,Chow; Bennett,7,0,32,25
1657657778639,MATH 142A,A02,083220,Chow; Bennett,10,0,32,22
1657657778639,MATH 142A,A03,093480,Chow; Bennett,9,0,32,23
1657657778639,MATH 142A,B03,093481,Chow; Bennett,8,0,32,24
1657657778639,MATH 142A,B04,093558,Chow; Bennett,13,0,32,19
1657657778639,MATH 142A,B05,093559,Chow; Bennett,6,0,32,26
1657657784667,MATH 193A,A01,083224,Rotar; Vladimir,8,0,34,26
1657657784667,MATH 193A,A02,083225,Rotar; Vladimir,9,0,34,25
1657657784667,MATH 193A,A03,083781,Rotar; Vladimir,5,0,34,29
1657657784667,MATH 193A,A04,083782,Rotar; Vladimir,10,0,34,24
1657657784667,MATH 193A,A05,093482,Rotar; Vladimir,10,0,34,24
1657657790690,MATH 197,001,091859,McAuley; Julian John,9999,0,9999,0
1657657790690,MATH 197,002,095566,Kedlaya; Kiran S.,9997,0,9999,2
1657657790690,MATH 197,003,095567,Xiao; Ming,9999,0,9999,0
1657657790690,MATH 197,004,095571,Perols; Johan Lars,9998,0,9999,1
1657657797754,COGS 9,A01,083615,Shannon; Kyle Michael,9,0,75,66
1657657803776,COGS 11,A01,083617,Boyle; Mary E. T.,23,0,48,25
1657657809802,COGS 13,A01,083071,Bastos; Amalia Pinkusfeld,11,0,71,60
1657657815825,COGS 14A,A01,092681,Semenuks; Arturs,5,1,100,95
1657657821855,COGS 14B,A01,083073,Cheng; Tzu-Han,6,0,63,57
1657657827881,COGS 17,A01,092677,Semenuks; Arturs,6,0,81,75
1657657833907,COGS 100,A01,083619,Allen; Michael Gordon,17,0,70,53
1657657839933,COGS 101A,A01,083621,Davis; Joshua Daniel,9,0,68,59
1657657845960,COGS 101B,A01,091572,Allen; Michael Gordon,12,0,65,53
1657657851984,COGS 101C,A01,083625,Delgado; Tania,17,0,35,18
1657657858007,COGS 107A,A01,083627,Boyle; Mary E. T.,13,0,60,47
1657657864038,COGS 118A,A01,083075,Gupta; Anjum,21,0,76,55
1657657870067,CSE 3,A50,083646,Miranda; Gregory Joseph,24,0,50,26
1657657876091,CSE 8A,A50,083650,Miranda; Gregory Joseph,17,1,56,39
1657657882116,CSE 11,A01,083080,Cao; Yingjun,6,15,40,34
1657657888140,CSE 12,A01,083652,Krause-Levy; Sophia Louisa,28,1,120,92
1657657894232,CSE 15L,A01,083654,Morris; Justin Loren,9,0,50,41
1657657894232,CSE 15L,A02,083655,Morris; Justin Loren,9,0,50,41
1657657900255,CSE 20,A01,083657,Tran; Khoa Dang,39,0,80,41
1657657906281,CSE 21,A01,095574,Bach; Quang Tran,22,0,48,26
1657657912309,CSE 30,A01,083084,Eldon; John,6,0,80,74
1657657912309,CSE 30,B01,095061,Bhaskar; Nishant,9,0,50,41
1657657918336,CSE 100,A01,083659,Cao; Yingjun,5,4,70,65
1657657924359,CSE 134B,A01,083661,Powell; Thomas Allan,23,0,100,77
1657657930382,CSE 140,A01,083663,Gungor; Onat,15,0,85,70
1657657936408,CSE 140L,A01,083088,Eldon; John,21,0,100,79
1657657942435,CSE 175,A01,083665,Kumar; Rakesh,3,0,25,22
1657657948465,CSE 190,A00,092507,Dubnov; Shlomo,8,0,20,12
1657657954491,ECE 45,A01,083139,Congero; Spencer William,6,0,75,69
1657657960518,ECE 65,A50,083695,Saad; Andrew S,12,0,30,18
1657657960518,ECE 65,A51,095125,Saad; Andrew S,24,0,26,2
1657657966544,ECE 109,A01,091882,Touri; Behrouz,19,0,70,51
1657657972566,ECE 180,A00,083140,Abi Samra; Nicholas Camill,1,0,30,29
1657657972566,ECE 180,B00,083141,Abi Samra; Nicholas Camill,0,0,30,30
1657657978588,MATH 10A,A01,083735,Patchell; Gregory David,2,0,30,28
1657657978588,MATH 10A,A02,083736,Patchell; Gregory David,20,0,30,10
1657657978588,MATH 10A,A03,083737,Patchell; Gregory David,16,0,30,14
1657657984615,MATH 10B,A01,083207,Lim; Seonhee,8,0,34,26
1657657984615,MATH 10B,A02,083208,Lim; Seonhee,9,0,35,26
1657657984615,MATH 10B,A03,093472,Lim; Seonhee,7,0,34,27
1657657984615,MATH 10B,B01,083739,Sinha; Shubham,13,0,30,17
1657657990645,MATH 18,A01,083743,Cinel; Cameron Alexander,7,0,30,23
1657657990645,MATH 18,A02,083744,Cinel; Cameron Alexander,17,0,30,13
1657657990645,MATH 18,A03,083745,Cinel; Cameron Alexander,10,0,30,20
1657657990645,MATH 18,B01,083748,Rideout; David Porter,5,0,37,32
1657657990645,MATH 18,B02,083749,Rideout; David Porter,5,0,36,31
1657657990645,MATH 18,B03,083750,Rideout; David Porter,3,0,37,34
1657657990645,MATH 18,B04,083751,Rideout; David Porter,6,0,36,30
1657657990645,MATH 18,B05,093473,Rideout; David Porter,6,0,36,30
1657657990645,MATH 18,B06,093474,Rideout; David Porter,6,0,36,30
1657657996671,MATH 20A,A01,083754,Zheng; Zequn,14,0,40,26
1657658002694,MATH 20B,A01,083756,Briones; Jor-el Thomas Caparas,4,0,36,32
1657658002694,MATH 20B,A02,083757,Briones; Jor-el Thomas Caparas,1,0,36,35
1657658002694,MATH 20B,A03,093475,Briones; Jor-el Thomas Caparas,2,0,36,34
1657658008720,MATH 20C,A01,083760,Briones; Jor-el Thomas Caparas,1,0,35,34
1657658008720,MATH 20C,A02,083761,Briones; Jor-el Thomas Caparas,8,0,35,27
1657658008720,MATH 20C,A03,093476,Briones; Jor-el Thomas Caparas,0,1,36,36
1657658008720,MATH 20C,B01,083762,Bach; Quang Tran,1,0,30,29
1657658014742,MATH 20D,A01,083765,Tran; Brian Kha,5,0,30,25
1657658014742,MATH 20D,A02,083766,Tran; Brian Kha,5,0,30,25
1657658014742,MATH 20D,A03,083767,Tran; Brian Kha,5,0,30,25
1657658020769,MATH 20E,A01,083771,Ganguly; Soumya,9,0,32,23
1657658020769,MATH 20E,A02,083772,Ganguly; Soumya,6,0,32,26
1657658020769,MATH 20E,B01,083773,Ciotti; Benjamin,20,0,35,15
1657658020769,MATH 20E,B02,083774,Ciotti; Benjamin,18,0,35,17
1657658026791,MATH 103A,A01,083777,Greenfeld; Be'Eri,3,0,36,33
1657658026791,MATH 103A,A02,083778,Greenfeld; Be'Eri,5,0,36,31
1657658026791,MATH 103A,A03,093561,Greenfeld; Be'Eri,6,0,36,30
1657658026791,MATH 103A,B01,083779,Greenfeld; Be'Eri,7,0,36,29
1657658026791,MATH 103A,B02,083780,Greenfeld; Be'Eri,4,0,36,32
1657658026791,MATH 103A,B03,093562,Greenfeld; Be'Eri,3,0,36,33
1657658032814,MATH 105,A01,085443,Carter; Anne Toulson,15,0,35,20
1657658032814,MATH 105,A02,093477,Carter; Anne Toulson,20,0,35,15
1657658038842,MATH 109,A01,083213,Ganzberger; Geoffrey Michael,2,0,34,32
1657658038842,MATH 109,A02,083214,Ganzberger; Geoffrey Michael,4,0,34,30
1657658038842,MATH 109,A03,093478,Ganzberger; Geoffrey Michael,2,0,34,32
1657658038842,MATH 109,B01,083215,Ganzberger; Geoffrey Michael,1,0,32,31
1657658038842,MATH 109,B02,083216,Ganzberger; Geoffrey Michael,2,0,32,30
1657658038842,MATH 109,B03,093479,Ganzberger; Geoffrey Michael,8,0,32,24
1657658044865,MATH 142A,A01,083219,Chow; Bennett,7,0,32,25
1657658044865,MATH 142A,A02,083220,Chow; Bennett,10,0,32,22
1657658044865,MATH 142A,A03,093480,Chow; Bennett,9,0,32,23
1657658044865,MATH 142A,B03,093481,Chow; Bennett,8,0,32,24
1657658044865,MATH 142A,B04,093558,Chow; Bennett,13,0,32,19
1657658044865,MATH 142A,B05,093559,Chow; Bennett,6,0,32,26
1657658050888,MATH 193A,A01,083224,Rotar; Vladimir,8,0,34,26
1657658050888,MATH 193A,A02,083225,Rotar; Vladimir,9,0,34,25
1657658050888,MATH 193A,A03,083781,Rotar; Vladimir,5,0,34,29
1657658050888,MATH 193A,A04,083782,Rotar; Vladimir,10,0,34,24
1657658050888,MATH 193A,A05,093482,Rotar; Vladimir,10,0,34,24
1657658056910,MATH 197,001,091859,McAuley; Julian John,9999,0,9999,0
1657658056910,MATH 197,002,095566,Kedlaya; Kiran S.,9997,0,9999,2
1657658056910,MATH 197,003,095567,Xiao; Ming,9999,0,9999,0
1657658056910,MATH 197,004,095571,Perols; Johan Lars,9998,0,9999,1
1657658063980,COGS 9,A01,083615,Shannon; Kyle Michael,9,0,75,66
1657658070003,COGS 11,A01,083617,Boyle; Mary E. T.,23,0,48,25
1657658076111,COGS 13,A01,083071,Bastos; Amalia Pinkusfeld,11,0,71,60
1657658082133,COGS 14A,A01,092681,Semenuks; Arturs,5,1,100,95
1657658088161,COGS 14B,A01,083073,Cheng; Tzu-Han,6,0,63,57
1657658094201,COGS 17,A01,092677,Semenuks; Arturs,6,0,81,75
1657658100231,COGS 100,A01,083619,Allen; Michael Gordon,17,0,70,53
1657658106261,COGS 101A,A01,083621,Davis; Joshua Daniel,9,0,68,59
1657658112285,COGS 101B,A01,091572,Allen; Michael Gordon,12,0,65,53
1657658118307,COGS 101C,A01,083625,Delgado; Tania,17,0,35,18
1657658124332,COGS 107A,A01,083627,Boyle; Mary E. T.,13,0,60,47
1657658130361,COGS 118A,A01,083075,Gupta; Anjum,21,0,76,55
1657658136393,CSE 3,A50,083646,Miranda; Gregory Joseph,24,0,50,26
1657658142415,CSE 8A,A50,083650,Miranda; Gregory Joseph,17,1,56,39
1657658148440,CSE 11,A01,083080,Cao; Yingjun,6,15,40,34
1657658154466,CSE 12,A01,083652,Krause-Levy; Sophia Louisa,28,1,120,92
1657658160497,CSE 15L,A01,083654,Morris; Justin Loren,9,0,50,41
1657658160497,CSE 15L,A02,083655,Morris; Justin Loren,9,0,50,41
1657658166519,CSE 20,A01,083657,Tran; Khoa Dang,39,0,80,41
1657658172543,CSE 21,A01,095574,Bach; Quang Tran,22,0,48,26
1657658178565,CSE 30,A01,083084,Eldon; John,6,0,80,74
1657658178565,CSE 30,B01,095061,Bhaskar; Nishant,9,0,50,41
1657658184590,CSE 100,A01,083659,Cao; Yingjun,5,4,70,65
1657658190616,CSE 134B,A01,083661,Powell; Thomas Allan,23,0,100,77
1657658196654,CSE 140,A01,083663,Gungor; Onat,15,0,85,70
1657658202684,CSE 140L,A01,083088,Eldon; John,21,0,100,79
1657658208716,CSE 175,A01,083665,Kumar; Rakesh,3,0,25,22
1657658214751,CSE 190,A00,092507,Dubnov; Shlomo,8,0,20,12
1657658220773,ECE 45,A01,083139,Congero; Spencer William,6,0,75,69
1657658226804,ECE 65,A50,083695,Saad; Andrew S,12,0,30,18
1657658226804,ECE 65,A51,095125,Saad; Andrew S,24,0,26,2
1657658232830,ECE 109,A01,091882,Touri; Behrouz,19,0,70,51
1657658238853,ECE 180,A00,083140,Abi Samra; Nicholas Camill,1,0,30,29
1657658238853,ECE 180,B00,083141,Abi Samra; Nicholas Camill,0,0,30,30
1657658244883,MATH 10A,A01,083735,Patchell; Gregory David,2,0,30,28
1657658244883,MATH 10A,A02,083736,Patchell; Gregory David,20,0,30,10
1657658244883,MATH 10A,A03,083737,Patchell; Gregory David,16,0,30,14
1657658250906,MATH 10B,A01,083207,Lim; Seonhee,8,0,34,26
1657658250906,MATH 10B,A02,083208,Lim; Seonhee,9,0,35,26
1657658250906,MATH 10B,A03,093472,Lim; Seonhee,7,0,34,27
1657658250906,MATH 10B,B01,083739,Sinha; Shubham,13,0,30,17
1657658256935,MATH 18,A01,083743,Cinel; Cameron Alexander,8,0,30,22
1657658256935,MATH 18,A02,083744,Cinel; Cameron Alexander,17,0,30,13
1657658256935,MATH 18,A03,083745,Cinel; Cameron Alexander,10,0,30,20
1657658256935,MATH 18,B01,083748,Rideout; David Porter,5,0,37,32
1657658256935,MATH 18,B02,083749,Rideout; David Porter,5,0,36,31
1657658256935,MATH 18,B03,083750,Rideout; David Porter,3,0,37,34
1657658256935,MATH 18,B04,083751,Rideout; David Porter,6,0,36,30
1657658256935,MATH 18,B05,093473,Rideout; David Porter,6,0,36,30
1657658256935,MATH 18,B06,093474,Rideout; David Porter,6,0,36,30
1657658262966,MATH 20A,A01,083754,Zheng; Zequn,14,0,40,26
1657658268993,MATH 20B,A01,083756,Briones; Jor-el Thomas Caparas,4,0,36,32
1657658268993,MATH 20B,A02,083757,Briones; Jor-el Thomas Caparas,1,0,36,35
1657658268993,MATH 20B,A03,093475,Briones; Jor-el Thomas Caparas,2,0,36,34
1657658275016,MATH 20C,A01,083760,Briones; Jor-el Thomas Caparas,1,0,35,34
1657658275016,MATH 20C,A02,083761,Briones; Jor-el Thomas Caparas,8,0,35,27
1657658275016,MATH 20C,A03,093476,Briones; Jor-el Thomas Caparas,0,1,36,36
1657658275016,MATH 20C,B01,083762,Bach; Quang Tran,1,0,30,29
1657658281042,MATH 20D,A01,083765,Tran; Brian Kha,5,0,30,25
1657658281042,MATH 20D,A02,083766,Tran; Brian Kha,5,0,30,25
1657658281042,MATH 20D,A03,083767,Tran; Brian Kha,5,0,30,25
1657658287076,MATH 20E,A01,083771,Ganguly; Soumya,9,0,32,23
1657658287076,MATH 20E,A02,083772,Ganguly; Soumya,6,0,32,26
1657658287076,MATH 20E,B01,083773,Ciotti; Benjamin,20,0,35,15
1657658287076,MATH 20E,B02,083774,Ciotti; Benjamin,18,0,35,17
1657658293104,MATH 103A,A01,083777,Greenfeld; Be'Eri,3,0,36,33
1657658293104,MATH 103A,A02,083778,Greenfeld; Be'Eri,5,0,36,31
1657658293104,MATH 103A,A03,093561,Greenfeld; Be'Eri,6,0,36,30
1657658293104,MATH 103A,B01,083779,Greenfeld; Be'Eri,7,0,36,29
1657658293104,MATH 103A,B02,083780,Greenfeld; Be'Eri,4,0,36,32
1657658293104,MATH 103A,B03,093562,Greenfeld; Be'Eri,3,0,36,33
1657658299173,MATH 105,A01,085443,Carter; Anne Toulson,15,0,35,20
1657658299173,MATH 105,A02,093477,Carter; Anne Toulson,20,0,35,15
1657658305196,MATH 109,A01,083213,Ganzberger; Geoffrey Michael,2,0,34,32
1657658305196,MATH 109,A02,083214,Ganzberger; Geoffrey Michael,4,0,34,30
1657658305196,MATH 109,A03,093478,Ganzberger; Geoffrey Michael,2,0,34,32
1657658305196,MATH 109,B01,083215,Ganzberger; Geoffrey Michael,1,0,32,31
1657658305196,MATH 109,B02,083216,Ganzberger; Geoffrey Michael,2,0,32,30
1657658305196,MATH 109,B03,093479,Ganzberger; Geoffrey Michael,8,0,32,24
1657658311226,MATH 142A,A01,083219,Chow; Bennett,7,0,32,25
1657658311226,MATH 142A,A02,083220,Chow; Bennett,10,0,32,22
1657658311226,MATH 142A,A03,093480,Chow; Bennett,9,0,32,23
1657658311226,MATH 142A,B03,093481,Chow; Bennett,8,0,32,24
1657658311226,MATH 142A,B04,093558,Chow; Bennett,13,0,32,19
1657658311226,MATH 142A,B05,093559,Chow; Bennett,6,0,32,26
1657658317253,MATH 193A,A01,083224,Rotar; Vladimir,8,0,34,26
1657658317253,MATH 193A,A02,083225,Rotar; Vladimir,9,0,34,25
1657658317253,MATH 193A,A03,083781,Rotar; Vladimir,5,0,34,29
1657658317253,MATH 193A,A04,083782,Rotar; Vladimir,10,0,34,24
1657658317253,MATH 193A,A05,093482,Rotar; Vladimir,10,0,34,24
1657658323277,MATH 197,001,091859,McAuley; Julian John,9999,0,9999,0
1657658323277,MATH 197,002,095566,Kedlaya; Kiran S.,9997,0,9999,2
1657658323277,MATH 197,003,095567,Xiao; Ming,9999,0,9999,0
1657658323277,MATH 197,004,095571,Perols; Johan Lars,9998,0,9999,1
1657658330331,COGS 9,A01,083615,Shannon; Kyle Michael,9,0,75,66
1657658336357,COGS 11,A01,083617,Boyle; Mary E. T.,23,0,48,25
1657658342384,COGS 13,A01,083071,Bastos; Amalia Pinkusfeld,11,0,71,60
1657658348419,COGS 14A,A01,092681,Semenuks; Arturs,5,1,100,95
1657658354440,COGS 14B,A01,083073,Cheng; Tzu-Han,6,0,63,57
1657658360470,COGS 17,A01,092677,Semenuks; Arturs,6,0,81,75
1657658366498,COGS 100,A01,083619,Allen; Michael Gordon,17,0,70,53
1657658372538,COGS 101A,A01,083621,Davis; Joshua Daniel,9,0,68,59
1657658378560,COGS 101B,A01,091572,Allen; Michael Gordon,12,0,65,53
1657658384587,COGS 101C,A01,083625,Delgado; Tania,17,0,35,18
1657658390613,COGS 107A,A01,083627,Boyle; Mary E. T.,13,0,60,47
1657658396644,COGS 118A,A01,083075,Gupta; Anjum,21,0,76,55
1657658402668,CSE 3,A50,083646,Miranda; Gregory Joseph,24,0,50,26
1657658408690,CSE 8A,A50,083650,Miranda; Gregory Joseph,17,1,56,39
1657658414715,CSE 11,A01,083080,Cao; Yingjun,6,15,40,34
1657658420741,CSE 12,A01,083652,Krause-Levy; Sophia Louisa,28,1,120,92
1657658426763,CSE 15L,A01,083654,Morris; Justin Loren,9,0,50,41
1657658426763,CSE 15L,A02,083655,Morris; Justin Loren,9,0,50,41
1657658432794,CSE 20,A01,083657,Tran; Khoa Dang,39,0,80,41
1657658438815,CSE 21,A01,095574,Bach; Quang Tran,22,0,48,26
1657658444841,CSE 30,A01,083084,Eldon; John,6,0,80,74
1657658444841,CSE 30,B01,095061,Bhaskar; Nishant,9,0,50,41
1657658450871,CSE 100,A01,083659,Cao; Yingjun,5,4,70,65
1657658456895,CSE 134B,A01,083661,Powell; Thomas Allan,23,0,100,77
1657658462933,CSE 140,A01,083663,Gungor; Onat,15,0,85,70
1657658468960,CSE 140L,A01,083088,Eldon; John,21,0,100,79
1657658474984,CSE 175,A01,083665,Kumar; Rakesh,3,0,25,22
1657658481006,CSE 190,A00,092507,Dubnov; Shlomo,8,0,20,12
1657658487032,ECE 45,A01,083139,Congero; Spencer William,6,0,75,69
1657658493157,ECE 65,A50,083695,Saad; Andrew S,12,0,30,18
1657658493157,ECE 65,A51,095125,Saad; Andrew S,24,0,26,2
1657658499184,ECE 109,A01,091882,Touri; Behrouz,19,0,70,51
1657658505214,ECE 180,A00,083140,Abi Samra; Nicholas Camill,1,0,30,29
1657658505214,ECE 180,B00,083141,Abi Samra; Nicholas Camill,0,0,30,30
1657658511254,MATH 10A,A01,083735,Patchell; Gregory David,2,0,30,28
1657658511254,MATH 10A,A02,083736,Patchell; Gregory David,20,0,30,10
1657658511254,MATH 10A,A03,083737,Patchell; Gregory David,16,0,30,14
1657658517283,MATH 10B,A01,083207,Lim; Seonhee,8,0,34,26
1657658517283,MATH 10B,A02,083208,Lim; Seonhee,9,0,35,26
1657658517283,MATH 10B,A03,093472,Lim; Seonhee,7,0,34,27
1657658517283,MATH 10B,B01,083739,Sinha; Shubham,13,0,30,17
1657658523307,MATH 18,A01,083743,Cinel; Cameron Alexander,8,0,30,22
1657658523307,MATH 18,A02,083744,Cinel; Cameron Alexander,17,0,30,13
1657658523307,MATH 18,A03,083745,Cinel; Cameron Alexander,10,0,30,20
1657658523307,MATH 18,B01,083748,Rideout; David Porter,5,0,37,32
1657658523307,MATH 18,B02,083749,Rideout; David Porter,5,0,36,31
1657658523307,MATH 18,B03,083750,Rideout; David Porter,3,0,37,34
1657658523307,MATH 18,B04,083751,Rideout; David Porter,6,0,36,30
1657658523307,MATH 18,B05,093473,Rideout; David Porter,6,0,36,30
1657658523307,MATH 18,B06,093474,Rideout; David Porter,6,0,36,30
1657658529340,MATH 20A,A01,083754,Zheng; Zequn,14,0,40,26
1657658535368,MATH 20B,A01,083756,Briones; Jor-el Thomas Caparas,4,0,36,32
1657658535368,MATH 20B,A02,083757,Briones; Jor-el Thomas Caparas,1,0,36,35
1657658535368,MATH 20B,A03,093475,Briones; Jor-el Thomas Caparas,2,0,36,34
1657658541397,MATH 20C,A01,083760,Briones; Jor-el Thomas Caparas,1,0,35,34
1657658541397,MATH 20C,A02,083761,Briones; Jor-el Thomas Caparas,8,0,35,27
1657658541397,MATH 20C,A03,093476,Briones; Jor-el Thomas Caparas,0,1,36,36
1657658541397,MATH 20C,B01,083762,Bach; Quang Tran,1,0,30,29
1657658547421,MATH 20D,A01,083765,Tran; Brian Kha,5,0,30,25
1657658547421,MATH 20D,A02,083766,Tran; Brian Kha,5,0,30,25
1657658547421,MATH 20D,A03,083767,Tran; Brian Kha,5,0,30,25
1657658553448,MATH 20E,A01,083771,Ganguly; Soumya,9,0,32,23
1657658553448,MATH 20E,A02,083772,Ganguly; Soumya,6,0,32,26
1657658553448,MATH 20E,B01,083773,Ciotti; Benjamin,20,0,35,15
1657658553448,MATH 20E,B02,083774,Ciotti; Benjamin,18,0,35,17
1657658559472,MATH 103A,A01,083777,Greenfeld; Be'Eri,3,0,36,33
1657658559472,MATH 103A,A02,083778,Greenfeld; Be'Eri,5,0,36,31
1657658559472,MATH 103A,A03,093561,Greenfeld; Be'Eri,6,0,36,30
1657658559472,MATH 103A,B01,083779,Greenfeld; Be'Eri,7,0,36,29
1657658559472,MATH 103A,B02,083780,Greenfeld; Be'Eri,4,0,36,32
1657658559472,MATH 103A,B03,093562,Greenfeld; Be'Eri,3,0,36,33
1657658565500,MATH 105,A01,085443,Carter; Anne Toulson,15,0,35,20
1657658565500,MATH 105,A02,093477,Carter; Anne Toulson,20,0,35,15
1657658571538,MATH 109,A01,083213,Ganzberger; Geoffrey Michael,2,0,34,32
1657658571538,MATH 109,A02,083214,Ganzberger; Geoffrey Michael,4,0,34,30
1657658571538,MATH 109,A03,093478,Ganzberger; Geoffrey Michael,2,0,34,32
1657658571538,MATH 109,B01,083215,Ganzberger; Geoffrey Michael,1,0,32,31
1657658571538,MATH 109,B02,083216,Ganzberger; Geoffrey Michael,2,0,32,30
1657658571538,MATH 109,B03,093479,Ganzberger; Geoffrey Michael,8,0,32,24
1657658577580,MATH 142A,A01,083219,Chow; Bennett,7,0,32,25
1657658577580,MATH 142A,A02,083220,Chow; Bennett,10,0,32,22
1657658577580,MATH 142A,A03,093480,Chow; Bennett,9,0,32,23
1657658577580,MATH 142A,B03,093481,Chow; Bennett,8,0,32,24
1657658577580,MATH 142A,B04,093558,Chow; Bennett,13,0,32,19
1657658577580,MATH 142A,B05,093559,Chow; Bennett,6,0,32,26
1657658583609,MATH 193A,A01,083224,Rotar; Vladimir,8,0,34,26
1657658583609,MATH 193A,A02,083225,Rotar; Vladimir,9,0,34,25
1657658583609,MATH 193A,A03,083781,Rotar; Vladimir,5,0,34,29
1657658583609,MATH 193A,A04,083782,Rotar; Vladimir,10,0,34,24
1657658583609,MATH 193A,A05,093482,Rotar; Vladimir,10,0,34,24
1657658589637,MATH 197,001,091859,McAuley; Julian John,9999,0,9999,0
1657658589637,MATH 197,002,095566,Kedlaya; Kiran S.,9997,0,9999,2
1657658589637,MATH 197,003,095567,Xiao; Ming,9999,0,9999,0
1657658589637,MATH 197,004,095571,Perols; Johan Lars,9998,0,9999,1
1657658596704,COGS 9,A01,083615,Shannon; Kyle Michael,9,0,75,66
1657658602729,COGS 11,A01,083617,Boyle; Mary E. T.,23,0,48,25
1657658608751,COGS 13,A01,083071,Bastos; Amalia Pinkusfeld,11,0,71,60
1657658614783,COGS 14A,A01,092681,Semenuks; Arturs,5,1,100,95
1657658620804,COGS 14B,A01,083073,Cheng; Tzu-Han,6,0,63,57
1657658626830,COGS 17,A01,092677,Semenuks; Arturs,6,0,81,75
1657658632857,COGS 100,A01,083619,Allen; Michael Gordon,17,0,70,53
1657658638883,COGS 101A,A01,083621,Davis; Joshua Daniel,9,0,68,59
1657658644905,COGS 101B,A01,091572,Allen; Michael Gordon,12,0,65,53
1657658650928,COGS 101C,A01,083625,Delgado; Tania,17,0,35,18
1657658656955,COGS 107A,A01,083627,Boyle; Mary E. T.,13,0,60,47
1657658662982,COGS 118A,A01,083075,Gupta; Anjum,21,0,76,55
1657658669009,CSE 3,A50,083646,Miranda; Gregory Joseph,24,0,50,26
1657658675037,CSE 8A,A50,083650,Miranda; Gregory Joseph,17,1,56,39
1657658681066,CSE 11,A01,083080,Cao; Yingjun,6,15,40,34
1657658687093,CSE 12,A01,083652,Krause-Levy; Sophia Louisa,28,1,120,92
1657658693119,CSE 15L,A01,083654,Morris; Justin Loren,9,0,50,41
1657658693119,CSE 15L,A02,083655,Morris; Justin Loren,9,0,50,41
1657658699152,CSE 20,A01,083657,Tran; Khoa Dang,39,0,80,41
1657658705175,CSE 21,A01,095574,Bach; Quang Tran,22,0,48,26
1657658711198,CSE 30,A01,083084,Eldon; John,6,0,80,74
1657658711198,CSE 30,B01,095061,Bhaskar; Nishant,9,0,50,41
1657658717221,CSE 100,A01,083659,Cao; Yingjun,5,4,70,65
1657658723255,CSE 134B,A01,083661,Powell; Thomas Allan,23,0,100,77
1657658729284,CSE 140,A01,083663,Gungor; Onat,15,0,85,70
1657658735308,CSE 140L,A01,083088,Eldon; John,21,0,100,79
1657658741335,CSE 175,A01,083665,Kumar; Rakesh,3,0,25,22
1657658747360,CSE 190,A00,092507,Dubnov; Shlomo,8,0,20,12
1657658753388,ECE 45,A01,083139,Congero; Spencer William,6,0,75,69
1657658759418,ECE 65,A50,083695,Saad; Andrew S,12,0,30,18
1657658759418,ECE 65,A51,095125,Saad; Andrew S,24,0,26,2
1657658765443,ECE 109,A01,091882,Touri; Behrouz,19,0,70,51
1657658771479,ECE 180,A00,083140,Abi Samra; Nicholas Camill,1,0,30,29
1657658771479,ECE 180,B00,083141,Abi Samra; Nicholas Camill,0,0,30,30
1657658777516,MATH 10A,A01,083735,Patchell; Gregory David,2,0,30,28
1657658777516,MATH 10A,A02,083736,Patchell; Gregory David,20,0,30,10
1657658777516,MATH 10A,A03,083737,Patchell; Gregory David,16,0,30,14
1657658783540,MATH 10B,A01,083207,Lim; Seonhee,8,0,34,26
1657658783540,MATH 10B,A02,083208,Lim; Seonhee,9,0,35,26
1657658783540,MATH 10B,A03,093472,Lim; Seonhee,7,0,34,27
1657658783540,MATH 10B,B01,083739,Sinha; Shubham,13,0,30,17
1657658789570,MATH 18,A01,083743,Cinel; Cameron Alexander,8,0,30,22
1657658789570,MATH 18,A02,083744,Cinel; Cameron Alexander,17,0,30,13
1657658789570,MATH 18,A03,083745,Cinel; Cameron Alexander,10,0,30,20
1657658789570,MATH 18,B01,083748,Rideout; David Porter,5,0,37,32
1657658789570,MATH 18,B02,083749,Rideout; David Porter,5,0,36,31
1657658789570,MATH 18,B03,083750,Rideout; David Porter,3,0,37,34
1657658789570,MATH 18,B04,083751,Rideout; David Porter,6,0,36,30
1657658789570,MATH 18,B05,093473,Rideout; David Porter,6,0,36,30
1657658789570,MATH 18,B06,093474,Rideout; David Porter,6,0,36,30
1657658795593,MATH 20A,A01,083754,Zheng; Zequn,14,0,40,26
1657658801618,MATH 20B,A01,083756,Briones; Jor-el Thomas Caparas,4,0,36,32
1657658801618,MATH 20B,A02,083757,Briones; Jor-el Thomas Caparas,1,0,36,35
1657658801618,MATH 20B,A03,093475,Briones; Jor-el Thomas Caparas,2,0,36,34
1657658807658,MATH 20C,A01,083760,Briones; Jor-el Thomas Caparas,1,0,35,34
1657658807658,MATH 20C,A02,083761,Briones; Jor-el Thomas Caparas,8,0,35,27
1657658807658,MATH 20C,A03,093476,Briones; Jor-el Thomas Caparas,0,1,36,36
1657658807658,MATH 20C,B01,083762,Bach; Quang Tran,1,0,30,29
1657658813682,MATH 20D,A01,083765,Tran; Brian Kha,5,0,30,25
1657658813682,MATH 20D,A02,083766,Tran; Brian Kha,5,0,30,25
1657658813682,MATH 20D,A03,083767,Tran; Brian Kha,5,0,30,25
1657658819708,MATH 20E,A01,083771,Ganguly; Soumya,9,0,32,23
1657658819708,MATH 20E,A02,083772,Ganguly; Soumya,6,0,32,26
1657658819708,MATH 20E,B01,083773,Ciotti; Benjamin,20,0,35,15
1657658819708,MATH 20E,B02,083774,Ciotti; Benjamin,18,0,35,17
1657658825731,MATH 103A,A01,083777,Greenfeld; Be'Eri,3,0,36,33
1657658825731,MATH 103A,A02,083778,Greenfeld; Be'Eri,5,0,36,31
1657658825731,MATH 103A,A03,093561,Greenfeld; Be'Eri,6,0,36,30
1657658825731,MATH 103A,B01,083779,Greenfeld; Be'Eri,7,0,36,29
1657658825731,MATH 103A,B02,083780,Greenfeld; Be'Eri,4,0,36,32
1657658825731,MATH 103A,B03,093562,Greenfeld; Be'Eri,3,0,36,33
1657658831762,MATH 105,A01,085443,Carter; Anne Toulson,15,0,35,20
1657658831762,MATH 105,A02,093477,Carter; Anne Toulson,20,0,35,15
1657658837789,MATH 109,A01,083213,Ganzberger; Geoffrey Michael,2,0,34,32
1657658837789,MATH 109,A02,083214,Ganzberger; Geoffrey Michael,4,0,34,30
1657658837789,MATH 109,A03,093478,Ganzberger; Geoffrey Michael,2,0,34,32
1657658837789,MATH 109,B01,083215,Ganzberger; Geoffrey Michael,1,0,32,31
1657658837789,MATH 109,B02,083216,Ganzberger; Geoffrey Michael,2,0,32,30
1657658837789,MATH 109,B03,093479,Ganzberger; Geoffrey Michael,8,0,32,24
1657658843828,MATH 142A,A01,083219,Chow; Bennett,7,0,32,25
1657658843828,MATH 142A,A02,083220,Chow; Bennett,10,0,32,22
1657658843828,MATH 142A,A03,093480,Chow; Bennett,9,0,32,23
1657658843828,MATH 142A,B03,093481,Chow; Bennett,8,0,32,24
1657658843828,MATH 142A,B04,093558,Chow; Bennett,13,0,32,19
1657658843828,MATH 142A,B05,093559,Chow; Bennett,6,0,32,26
1657658849851,MATH 193A,A01,083224,Rotar; Vladimir,8,0,34,26
1657658849851,MATH 193A,A02,083225,Rotar; Vladimir,9,0,34,25
1657658849851,MATH 193A,A03,083781,Rotar; Vladimir,5,0,34,29
1657658849851,MATH 193A,A04,083782,Rotar; Vladimir,10,0,34,24
1657658849851,MATH 193A,A05,093482,Rotar; Vladimir,10,0,34,24
1657658855889,MATH 197,001,091859,McAuley; Julian John,9999,0,9999,0
1657658855889,MATH 197,002,095566,Kedlaya; Kiran S.,9997,0,9999,2
1657658855889,MATH 197,003,095567,Xiao; Ming,9999,0,9999,0
1657658855889,MATH 197,004,095571,Perols; Johan Lars,9998,0,9999,1
1657658862956,COGS 9,A01,083615,Shannon; Kyle Michael,9,0,75,66
1657658868977,COGS 11,A01,083617,Boyle; Mary E. T.,23,0,48,25
1657658875001,COGS 13,A01,083071,Bastos; Amalia Pinkusfeld,11,0,71,60
1657658881026,COGS 14A,A01,092681,Semenuks; Arturs,5,1,100,95
1657658887049,COGS 14B,A01,083073,Cheng; Tzu-Han,6,0,63,57
1657658893072,COGS 17,A01,092677,Semenuks; Arturs,6,0,81,75
1657658899097,COGS 100,A01,083619,Allen; Michael Gordon,17,0,70,53
1657658905121,COGS 101A,A01,083621,Davis; Joshua Daniel,9,0,68,59
1657658911143,COGS 101B,A01,091572,Allen; Michael Gordon,12,0,65,53
1657658917165,COGS 101C,A01,083625,Delgado; Tania,17,0,35,18
1657658923196,COGS 107A,A01,083627,Boyle; Mary E. T.,13,0,60,47
1657658929226,COGS 118A,A01,083075,Gupta; Anjum,21,0,76,55
1657658935257,CSE 3,A50,083646,Miranda; Gregory Joseph,24,0,50,26
1657658941292,CSE 8A,A50,083650,Miranda; Gregory Joseph,17,1,56,39
1657658947321,CSE 11,A01,083080,Cao; Yingjun,6,15,40,34
1657658953350,CSE 12,A01,083652,Krause-Levy; Sophia Louisa,28,1,120,92
1657658959373,CSE 15L,A01,083654,Morris; Justin Loren,9,0,50,41
1657658959373,CSE 15L,A02,083655,Morris; Justin Loren,9,0,50,41
1657658965400,CSE 20,A01,083657,Tran; Khoa Dang,39,0,80,41
1657658971427,CSE 21,A01,095574,Bach; Quang Tran,22,0,48,26
1657658977454,CSE 30,A01,083084,Eldon; John,6,0,80,74
1657658977454,CSE 30,B01,095061,Bhaskar; Nishant,9,0,50,41
1657658983480,CSE 100,A01,083659,Cao; Yingjun,5,4,70,65
1657658989503,CSE 134B,A01,083661,Powell; Thomas Allan,23,0,100,77
1657658995525,CSE 140,A01,083663,Gungor; Onat,15,0,85,70
1657659001555,CSE 140L,A01,083088,Eldon; John,21,0,100,79
1657659007577,CSE 175,A01,083665,Kumar; Rakesh,3,0,25,22
1657659013601,CSE 190,A00,092507,Dubnov; Shlomo,8,0,20,12
1657659019627,ECE 45,A01,083139,Congero; Spencer William,6,0,75,69
1657659025650,ECE 65,A50,083695,Saad; Andrew S,12,0,30,18
1657659025650,ECE 65,A51,095125,Saad; Andrew S,24,0,26,2
1657659031674,ECE 109,A01,091882,Touri; Behrouz,19,0,70,51
1657659037700,ECE 180,A00,083140,Abi Samra; Nicholas Camill,1,0,30,29
1657659037700,ECE 180,B00,083141,Abi Samra; Nicholas Camill,0,0,30,30
1657659043723,MATH 10A,A01,083735,Patchell; Gregory David,2,0,30,28
1657659043723,MATH 10A,A02,083736,Patchell; Gregory David,20,0,30,10
1657659043723,MATH 10A,A03,083737,Patchell; Gregory David,16,0,30,14
1657659049745,MATH 10B,A01,083207,Lim; Seonhee,8,0,34,26
1657659049745,MATH 10B,A02,083208,Lim; Seonhee,9,0,35,26
1657659049745,MATH 10B,A03,093472,Lim; Seonhee,7,0,34,27
1657659049745,MATH 10B,B01,083739,Sinha; Shubham,13,0,30,17
1657659055786,MATH 18,A01,083743,Cinel; Cameron Alexander,8,0,30,22
1657659055786,MATH 18,A02,083744,Cinel; Cameron Alexander,17,0,30,13
1657659055786,MATH 18,A03,083745,Cinel; Cameron Alexander,10,0,30,20
1657659055786,MATH 18,B01,083748,Rideout; David Porter,5,0,37,32
1657659055786,MATH 18,B02,083749,Rideout; David Porter,5,0,36,31
1657659055786,MATH 18,B03,083750,Rideout; David Porter,3,0,37,34
1657659055786,MATH 18,B04,083751,Rideout; David Porter,6,0,36,30
1657659055786,MATH 18,B05,093473,Rideout; David Porter,6,0,36,30
1657659055786,MATH 18,B06,093474,Rideout; David Porter,6,0,36,30
1657659061809,MATH 20A,A01,083754,Zheng; Zequn,14,0,40,26
1657659067830,MATH 20B,A01,083756,Briones; Jor-el Thomas Caparas,4,0,36,32
1657659067830,MATH 20B,A02,083757,Briones; Jor-el Thomas Caparas,1,0,36,35
1657659067830,MATH 20B,A03,093475,Briones; Jor-el Thomas Caparas,2,0,36,34
1657659073859,MATH 20C,A01,083760,Briones; Jor-el Thomas Caparas,1,0,35,34
1657659073859,MATH 20C,A02,083761,Briones; Jor-el Thomas Caparas,8,0,35,27
1657659073859,MATH 20C,A03,093476,Briones; Jor-el Thomas Caparas,0,1,36,36
1657659073859,MATH 20C,B01,083762,Bach; Quang Tran,1,0,30,29
1657659079882,MATH 20D,A01,083765,Tran; Brian Kha,5,0,30,25
1657659079882,MATH 20D,A02,083766,Tran; Brian Kha,5,0,30,25
1657659079882,MATH 20D,A03,083767,Tran; Brian Kha,5,0,30,25
1657659085909,MATH 20E,A01,083771,Ganguly; Soumya,9,0,32,23
1657659085909,MATH 20E,A02,083772,Ganguly; Soumya,6,0,32,26
1657659085909,MATH 20E,B01,083773,Ciotti; Benjamin,20,0,35,15
1657659085909,MATH 20E,B02,083774,Ciotti; Benjamin,18,0,35,17
1657659092025,MATH 103A,A01,083777,Greenfeld; Be'Eri,3,0,36,33
1657659092025,MATH 103A,A02,083778,Greenfeld; Be'Eri,5,0,36,31
1657659092025,MATH 103A,A03,093561,Greenfeld; Be'Eri,6,0,36,30
1657659092025,MATH 103A,B01,083779,Greenfeld; Be'Eri,7,0,36,29
1657659092025,MATH 103A,B02,083780,Greenfeld; Be'Eri,4,0,36,32
1657659092025,MATH 103A,B03,093562,Greenfeld; Be'Eri,3,0,36,33
1657659098049,MATH 105,A01,085443,Carter; Anne Toulson,15,0,35,20
1657659098049,MATH 105,A02,093477,Carter; Anne Toulson,20,0,35,15
1657659104071,MATH 109,A01,083213,Ganzberger; Geoffrey Michael,2,0,34,32
1657659104071,MATH 109,A02,083214,Ganzberger; Geoffrey Michael,4,0,34,30
1657659104071,MATH 109,A03,093478,Ganzberger; Geoffrey Michael,2,0,34,32
1657659104071,MATH 109,B01,083215,Ganzberger; Geoffrey Michael,1,0,32,31
1657659104071,MATH 109,B02,083216,Ganzberger; Geoffrey Michael,2,0,32,30
1657659104071,MATH 109,B03,093479,Ganzberger; Geoffrey Michael,8,0,32,24
1657659110100,MATH 142A,A01,083219,Chow; Bennett,7,0,32,25
1657659110100,MATH 142A,A02,083220,Chow; Bennett,10,0,32,22
1657659110100,MATH 142A,A03,093480,Chow; Bennett,9,0,32,23
1657659110100,MATH 142A,B03,093481,Chow; Bennett,8,0,32,24
1657659110100,MATH 142A,B04,093558,Chow; Bennett,13,0,32,19
1657659110100,MATH 142A,B05,093559,Chow; Bennett,6,0,32,26
1657659116122,MATH 193A,A01,083224,Rotar; Vladimir,8,0,34,26
1657659116122,MATH 193A,A02,083225,Rotar; Vladimir,9,0,34,25
1657659116122,MATH 193A,A03,083781,Rotar; Vladimir,5,0,34,29
1657659116122,MATH 193A,A04,083782,Rotar; Vladimir,10,0,34,24
1657659116122,MATH 193A,A05,093482,Rotar; Vladimir,10,0,34,24
1657659122146,MATH 197,001,091859,McAuley; Julian John,9999,0,9999,0
1657659122146,MATH 197,002,095566,Kedlaya; Kiran S.,9997,0,9999,2
1657659122146,MATH 197,003,095567,Xiao; Ming,9999,0,9999,0
1657659122146,MATH 197,004,095571,Perols; Johan Lars,9998,0,9999,1
1657659129207,COGS 9,A01,083615,Shannon; Kyle Michael,9,0,75,66
1657659135234,COGS 11,A01,083617,Boyle; Mary E. T.,23,0,48,25
1657659141257,COGS 13,A01,083071,Bastos; Amalia Pinkusfeld,11,0,71,60
1657659147280,COGS 14A,A01,092681,Semenuks; Arturs,5,1,100,95
1657659153322,COGS 14B,A01,083073,Cheng; Tzu-Han,6,0,63,57
1657659159349,COGS 17,A01,092677,Semenuks; Arturs,6,0,81,75
1657659165373,COGS 100,A01,083619,Allen; Michael Gordon,17,0,70,53
1657659171400,COGS 101A,A01,083621,Davis; Joshua Daniel,9,0,68,59
1657659177424,COGS 101B,A01,091572,Allen; Michael Gordon,12,0,65,53
1657659183451,COGS 101C,A01,083625,Delgado; Tania,17,0,35,18
1657659189478,COGS 107A,A01,083627,Boyle; Mary E. T.,13,0,60,47
1657659195508,COGS 118A,A01,083075,Gupta; Anjum,21,0,76,55
1657659201535,CSE 3,A50,083646,Miranda; Gregory Joseph,24,0,50,26
1657659207567,CSE 8A,A50,083650,Miranda; Gregory Joseph,17,1,56,39
1657659213594,CSE 11,A01,083080,Cao; Yingjun,6,15,40,34
1657659219617,CSE 12,A01,083652,Krause-Levy; Sophia Louisa,28,1,120,92
1657659225649,CSE 15L,A01,083654,Morris; Justin Loren,9,0,50,41
1657659225649,CSE 15L,A02,083655,Morris; Justin Loren,9,0,50,41
1657659231675,CSE 20,A01,083657,Tran; Khoa Dang,39,0,80,41
1657659237716,CSE 21,A01,095574,Bach; Quang Tran,22,0,48,26
1657659243749,CSE 30,A01,083084,Eldon; John,6,0,80,74
1657659243749,CSE 30,B01,095061,Bhaskar; Nishant,9,0,50,41
1657659249781,CSE 100,A01,083659,Cao; Yingjun,5,4,70,65
1657659255811,CSE 134B,A01,083661,Powell; Thomas Allan,23,0,100,77
1657659261846,CSE 140,A01,083663,Gungor; Onat,15,0,85,70
1657659267873,CSE 140L,A01,083088,Eldon; John,21,0,100,79
1657659273897,CSE 175,A01,083665,Kumar; Rakesh,3,0,25,22
1657659279921,CSE 190,A00,092507,Dubnov; Shlomo,8,0,20,12
1657659285943,ECE 45,A01,083139,Congero; Spencer William,6,0,75,69
1657659291970,ECE 65,A50,083695,Saad; Andrew S,12,0,30,18
1657659291970,ECE 65,A51,095125,Saad; Andrew S,24,0,26,2
1657659297992,ECE 109,A01,091882,Touri; Behrouz,19,0,70,51
1657659304014,ECE 180,A00,083140,Abi Samra; Nicholas Camill,1,0,30,29
1657659304014,ECE 180,B00,083141,Abi Samra; Nicholas Camill,0,0,30,30
1657659310041,MATH 10A,A01,083735,Patchell; Gregory David,2,0,30,28
1657659310041,MATH 10A,A02,083736,Patchell; Gregory David,20,0,30,10
1657659310041,MATH 10A,A03,083737,Patchell; Gregory David,16,0,30,14
1657659316063,MATH 10B,A01,083207,Lim; Seonhee,8,0,34,26
1657659316063,MATH 10B,A02,083208,Lim; Seonhee,9,0,35,26
1657659316063,MATH 10B,A03,093472,Lim; Seonhee,7,0,34,27
1657659316063,MATH 10B,B01,083739,Sinha; Shubham,13,0,30,17
1657659322089,MATH 18,A01,083743,Cinel; Cameron Alexander,8,0,30,22
1657659322089,MATH 18,A02,083744,Cinel; Cameron Alexander,17,0,30,13
1657659322089,MATH 18,A03,083745,Cinel; Cameron Alexander,10,0,30,20
1657659322089,MATH 18,B01,083748,Rideout; David Porter,5,0,37,32
1657659322089,MATH 18,B02,083749,Rideout; David Porter,5,0,36,31
1657659322089,MATH 18,B03,083750,Rideout; David Porter,3,0,37,34
1657659322089,MATH 18,B04,083751,Rideout; David Porter,6,0,36,30
1657659322089,MATH 18,B05,093473,Rideout; David Porter,6,0,36,30
1657659322089,MATH 18,B06,093474,Rideout; David Porter,6,0,36,30
1657659328115,MATH 20A,A01,083754,Zheng; Zequn,14,0,40,26
1657659334148,MATH 20B,A01,083756,Briones; Jor-el Thomas Caparas,4,0,36,32
1657659334148,MATH 20B,A02,083757,Briones; Jor-el Thomas Caparas,1,0,36,35
1657659334148,MATH 20B,A03,093475,Briones; Jor-el Thomas Caparas,2,0,36,34
1657659340191,MATH 20C,A01,083760,Briones; Jor-el Thomas Caparas,1,0,35,34
1657659340191,MATH 20C,A02,083761,Briones; Jor-el Thomas Caparas,8,0,35,27
1657659340191,MATH 20C,A03,093476,Briones; Jor-el Thomas Caparas,0,1,36,36
1657659340191,MATH 20C,B01,083762,Bach; Quang Tran,1,0,30,29
1657659346219,MATH 20D,A01,083765,Tran; Brian Kha,5,0,30,25
1657659346219,MATH 20D,A02,083766,Tran; Brian Kha,5,0,30,25
1657659346219,MATH 20D,A03,083767,Tran; Brian Kha,5,0,30,25
1657659352242,MATH 20E,A01,083771,Ganguly; Soumya,9,0,32,23
1657659352242,MATH 20E,A02,083772,Ganguly; Soumya,6,0,32,26
1657659352242,MATH 20E,B01,083773,Ciotti; Benjamin,20,0,35,15
1657659352242,MATH 20E,B02,083774,Ciotti; Benjamin,18,0,35,17
1657659358266,MATH 103A,A01,083777,Greenfeld; Be'Eri,3,0,36,33
1657659358266,MATH 103A,A02,083778,Greenfeld; Be'Eri,5,0,36,31
1657659358266,MATH 103A,A03,093561,Greenfeld; Be'Eri,6,0,36,30
1657659358266,MATH 103A,B01,083779,Greenfeld; Be'Eri,7,0,36,29
1657659358266,MATH 103A,B02,083780,Greenfeld; Be'Eri,4,0,36,32
1657659358266,MATH 103A,B03,093562,Greenfeld; Be'Eri,3,0,36,33
1657659364296,MATH 105,A01,085443,Carter; Anne Toulson,15,0,35,20
1657659364296,MATH 105,A02,093477,Carter; Anne Toulson,20,0,35,15
1657659370319,MATH 109,A01,083213,Ganzberger; Geoffrey Michael,2,0,34,32
1657659370319,MATH 109,A02,083214,Ganzberger; Geoffrey Michael,4,0,34,30
1657659370319,MATH 109,A03,093478,Ganzberger; Geoffrey Michael,2,0,34,32
1657659370319,MATH 109,B01,083215,Ganzberger; Geoffrey Michael,1,0,32,31
1657659370319,MATH 109,B02,083216,Ganzberger; Geoffrey Michael,2,0,32,30
1657659370319,MATH 109,B03,093479,Ganzberger; Geoffrey Michael,8,0,32,24
1657659376342,MATH 142A,A01,083219,Chow; Bennett,7,0,32,25
1657659376342,MATH 142A,A02,083220,Chow; Bennett,10,0,32,22
1657659376342,MATH 142A,A03,093480,Chow; Bennett,9,0,32,23
1657659376342,MATH 142A,B03,093481,Chow; Bennett,8,0,32,24
1657659376342,MATH 142A,B04,093558,Chow; Bennett,13,0,32,19
1657659376342,MATH 142A,B05,093559,Chow; Bennett,6,0,32,26
1657659382368,MATH 193A,A01,083224,Rotar; Vladimir,8,0,34,26
1657659382368,MATH 193A,A02,083225,Rotar; Vladimir,9,0,34,25
1657659382368,MATH 193A,A03,083781,Rotar; Vladimir,5,0,34,29
1657659382368,MATH 193A,A04,083782,Rotar; Vladimir,10,0,34,24
1657659382368,MATH 193A,A05,093482,Rotar; Vladimir,10,0,34,24
1657659388390,MATH 197,001,091859,McAuley; Julian John,9999,0,9999,0
1657659388390,MATH 197,002,095566,Kedlaya; Kiran S.,9997,0,9999,2
1657659388390,MATH 197,003,095567,Xiao; Ming,9999,0,9999,0
1657659388390,MATH 197,004,095571,Perols; Johan Lars,9998,0,9999,1
1657659395458,COGS 9,A01,083615,Shannon; Kyle Michael,9,0,75,66
1657659401480,COGS 11,A01,083617,Boyle; Mary E. T.,23,0,48,25
1657659407504,COGS 13,A01,083071,Bastos; Amalia Pinkusfeld,11,0,71,60
1657659413528,COGS 14A,A01,092681,Semenuks; Arturs,5,1,100,95
1657659419550,COGS 14B,A01,083073,Cheng; Tzu-Han,6,0,63,57
1657659425573,COGS 17,A01,092677,Semenuks; Arturs,6,0,81,75
1657659431595,COGS 100,A01,083619,Allen; Michael Gordon,17,0,70,53
1657659437623,COGS 101A,A01,083621,Davis; Joshua Daniel,9,0,68,59
1657659443648,COGS 101B,A01,091572,Allen; Michael Gordon,12,0,65,53
1657659449674,COGS 101C,A01,083625,Delgado; Tania,17,0,35,18
1657659455701,COGS 107A,A01,083627,Boyle; Mary E. T.,13,0,60,47
1657659461726,COGS 118A,A01,083075,Gupta; Anjum,21,0,76,55
1657659467748,CSE 3,A50,083646,Miranda; Gregory Joseph,24,0,50,26
1657659473770,CSE 8A,A50,083650,Miranda; Gregory Joseph,17,1,56,39
1657659479793,CSE 11,A01,083080,Cao; Yingjun,6,15,40,34
1657659485816,CSE 12,A01,083652,Krause-Levy; Sophia Louisa,28,1,120,92
1657659491845,CSE 15L,A01,083654,Morris; Justin Loren,9,0,50,41
1657659491845,CSE 15L,A02,083655,Morris; Justin Loren,9,0,50,41
1657659497871,CSE 20,A01,083657,Tran; Khoa Dang,39,0,80,41
1657659503897,CSE 21,A01,095574,Bach; Quang Tran,22,0,48,26
1657659509923,CSE 30,A01,083084,Eldon; John,6,0,80,74
1657659509923,CSE 30,B01,095061,Bhaskar; Nishant,9,0,50,41
1657659515955,CSE 100,A01,083659,Cao; Yingjun,5,4,70,65
1657659521985,CSE 134B,A01,083661,Powell; Thomas Allan,23,0,100,77
1657659528008,CSE 140,A01,083663,Gungor; Onat,15,0,85,70
1657659534030,CSE 140L,A01,083088,Eldon; John,22,0,100,78
1657659540053,CSE 175,A01,083665,Kumar; Rakesh,3,0,25,22
1657659546079,CSE 190,A00,092507,Dubnov; Shlomo,8,0,20,12
1657659552102,ECE 45,A01,083139,Congero; Spencer William,6,0,75,69
1657659558128,ECE 65,A50,083695,Saad; Andrew S,12,0,30,18
1657659558128,ECE 65,A51,095125,Saad; Andrew S,24,0,26,2
1657659564156,ECE 109,A01,091882,Touri; Behrouz,19,0,70,51
1657659570182,ECE 180,A00,083140,Abi Samra; Nicholas Camill,1,0,30,29
1657659570182,ECE 180,B00,083141,Abi Samra; Nicholas Camill,0,0,30,30
1657659576204,MATH 10A,A01,083735,Patchell; Gregory David,2,0,30,28
1657659576204,MATH 10A,A02,083736,Patchell; Gregory David,20,0,30,10
1657659576204,MATH 10A,A03,083737,Patchell; Gregory David,16,0,30,14
1657659582226,MATH 10B,A01,083207,Lim; Seonhee,8,0,34,26
1657659582226,MATH 10B,A02,083208,Lim; Seonhee,9,0,35,26
1657659582226,MATH 10B,A03,093472,Lim; Seonhee,7,0,34,27
1657659582226,MATH 10B,B01,083739,Sinha; Shubham,13,0,30,17
1657659588251,MATH 18,A01,083743,Cinel; Cameron Alexander,8,0,30,22
1657659588251,MATH 18,A02,083744,Cinel; Cameron Alexander,17,0,30,13
1657659588251,MATH 18,A03,083745,Cinel; Cameron Alexander,10,0,30,20
1657659588251,MATH 18,B01,083748,Rideout; David Porter,5,0,37,32
1657659588251,MATH 18,B02,083749,Rideout; David Porter,5,0,36,31
1657659588251,MATH 18,B03,083750,Rideout; David Porter,3,0,37,34
1657659588251,MATH 18,B04,083751,Rideout; David Porter,6,0,36,30
1657659588251,MATH 18,B05,093473,Rideout; David Porter,6,0,36,30
1657659588251,MATH 18,B06,093474,Rideout; David Porter,6,0,36,30
1657659594274,MATH 20A,A01,083754,Zheng; Zequn,14,0,40,26
1657659600301,MATH 20B,A01,083756,Briones; Jor-el Thomas Caparas,4,0,36,32
1657659600301,MATH 20B,A02,083757,Briones; Jor-el Thomas Caparas,1,0,36,35
1657659600301,MATH 20B,A03,093475,Briones; Jor-el Thomas Caparas,2,0,36,34
1657659606329,MATH 20C,A01,083760,Briones; Jor-el Thomas Caparas,1,0,35,34
1657659606329,MATH 20C,A02,083761,Briones; Jor-el Thomas Caparas,8,0,35,27
1657659606329,MATH 20C,A03,093476,Briones; Jor-el Thomas Caparas,0,1,36,36
1657659606329,MATH 20C,B01,083762,Bach; Quang Tran,1,0,30,29
1657659612358,MATH 20D,A01,083765,Tran; Brian Kha,5,0,30,25
1657659612358,MATH 20D,A02,083766,Tran; Brian Kha,5,0,30,25
1657659612358,MATH 20D,A03,083767,Tran; Brian Kha,5,0,30,25
1657659618386,MATH 20E,A01,083771,Ganguly; Soumya,9,0,32,23
1657659618386,MATH 20E,A02,083772,Ganguly; Soumya,6,0,32,26
1657659618386,MATH 20E,B01,083773,Ciotti; Benjamin,20,0,35,15
1657659618386,MATH 20E,B02,083774,Ciotti; Benjamin,18,0,35,17
1657659624413,MATH 103A,A01,083777,Greenfeld; Be'Eri,3,0,36,33
1657659624413,MATH 103A,A02,083778,Greenfeld; Be'Eri,5,0,36,31
1657659624413,MATH 103A,A03,093561,Greenfeld; Be'Eri,6,0,36,30
1657659624413,MATH 103A,B01,083779,Greenfeld; Be'Eri,7,0,36,29
1657659624413,MATH 103A,B02,083780,Greenfeld; Be'Eri,4,0,36,32
1657659624413,MATH 103A,B03,093562,Greenfeld; Be'Eri,3,0,36,33
1657659630440,MATH 105,A01,085443,Carter; Anne Toulson,15,0,35,20
1657659630440,MATH 105,A02,093477,Carter; Anne Toulson,20,0,35,15
1657659636468,MATH 109,A01,083213,Ganzberger; Geoffrey Michael,2,0,34,32
1657659636468,MATH 109,A02,083214,Ganzberger; Geoffrey Michael,4,0,34,30
1657659636468,MATH 109,A03,093478,Ganzberger; Geoffrey Michael,2,0,34,32
1657659636468,MATH 109,B01,083215,Ganzberger; Geoffrey Michael,1,0,32,31
1657659636468,MATH 109,B02,083216,Ganzberger; Geoffrey Michael,2,0,32,30
1657659636468,MATH 109,B03,093479,Ganzberger; Geoffrey Michael,8,0,32,24
1657659642497,MATH 142A,A01,083219,Chow; Bennett,7,0,32,25
1657659642497,MATH 142A,A02,083220,Chow; Bennett,10,0,32,22
1657659642497,MATH 142A,A03,093480,Chow; Bennett,9,0,32,23
1657659642497,MATH 142A,B03,093481,Chow; Bennett,8,0,32,24
1657659642497,MATH 142A,B04,093558,Chow; Bennett,13,0,32,19
1657659642497,MATH 142A,B05,093559,Chow; Bennett,6,0,32,26
1657659648520,MATH 193A,A01,083224,Rotar; Vladimir,8,0,34,26
1657659648520,MATH 193A,A02,083225,Rotar; Vladimir,9,0,34,25
1657659648520,MATH 193A,A03,083781,Rotar; Vladimir,5,0,34,29
1657659648520,MATH 193A,A04,083782,Rotar; Vladimir,10,0,34,24
1657659648520,MATH 193A,A05,093482,Rotar; Vladimir,10,0,34,24
1657659654546,MATH 197,001,091859,McAuley; Julian John,9999,0,9999,0
1657659654546,MATH 197,002,095566,Kedlaya; Kiran S.,9997,0,9999,2
1657659654546,MATH 197,003,095567,Xiao; Ming,9999,0,9999,0
1657659654546,MATH 197,004,095571,Perols; Johan Lars,9998,0,9999,1
1657659661610,COGS 9,A01,083615,Shannon; Kyle Michael,9,0,75,66
1657659667633,COGS 11,A01,083617,Boyle; Mary E. T.,23,0,48,25
1657659673658,COGS 13,A01,083071,Bastos; Amalia Pinkusfeld,11,0,71,60
1657659679681,COGS 14A,A01,092681,Semenuks; Arturs,5,1,100,95
1657659685778,COGS 14B,A01,083073,Cheng; Tzu-Han,6,0,63,57
1657659691800,COGS 17,A01,092677,Semenuks; Arturs,6,0,81,75
1657659697825,COGS 100,A01,083619,Allen; Michael Gordon,17,0,70,53
1657659703848,COGS 101A,A01,083621,Davis; Joshua Daniel,9,0,68,59
1657659709870,COGS 101B,A01,091572,Allen; Michael Gordon,12,0,65,53
1657659715894,COGS 101C,A01,083625,Delgado; Tania,17,0,35,18
1657659721921,COGS 107A,A01,083627,Boyle; Mary E. T.,13,0,60,47
1657659727946,COGS 118A,A01,083075,Gupta; Anjum,21,0,76,55
1657659733970,CSE 3,A50,083646,Miranda; Gregory Joseph,24,0,50,26
1657659740009,CSE 8A,A50,083650,Miranda; Gregory Joseph,17,1,56,39
1657659746036,CSE 11,A01,083080,Cao; Yingjun,6,15,40,34
1657659752070,CSE 12,A01,083652,Krause-Levy; Sophia Louisa,28,1,120,92
1657659758102,CSE 15L,A01,083654,Morris; Justin Loren,9,0,50,41
1657659758102,CSE 15L,A02,083655,Morris; Justin Loren,9,0,50,41
1657659764123,CSE 20,A01,083657,Tran; Khoa Dang,39,0,80,41
1657659770153,CSE 21,A01,095574,Bach; Quang Tran,22,0,48,26
1657659776177,CSE 30,A01,083084,Eldon; John,6,0,80,74
1657659776177,CSE 30,B01,095061,Bhaskar; Nishant,9,0,50,41
1657659782210,CSE 100,A01,083659,Cao; Yingjun,5,4,70,65
1657659788236,CSE 134B,A01,083661,Powell; Thomas Allan,23,0,100,77
1657659794259,CSE 140,A01,083663,Gungor; Onat,15,0,85,70
1657659800285,CSE 140L,A01,083088,Eldon; John,22,0,100,78
1657659806315,CSE 175,A01,083665,Kumar; Rakesh,3,0,25,22
1657659812340,CSE 190,A00,092507,Dubnov; Shlomo,8,0,20,12
1657659818364,ECE 45,A01,083139,Congero; Spencer William,6,0,75,69
1657659824391,ECE 65,A50,083695,Saad; Andrew S,12,0,30,18
1657659824391,ECE 65,A51,095125,Saad; Andrew S,24,0,26,2
1657659830414,ECE 109,A01,091882,Touri; Behrouz,19,0,70,51
1657659836438,ECE 180,A00,083140,Abi Samra; Nicholas Camill,1,0,30,29
1657659836438,ECE 180,B00,083141,Abi Samra; Nicholas Camill,0,0,30,30
1657659842464,MATH 10A,A01,083735,Patchell; Gregory David,2,0,30,28
1657659842464,MATH 10A,A02,083736,Patchell; Gregory David,20,0,30,10
1657659842464,MATH 10A,A03,083737,Patchell; Gregory David,16,0,30,14
1657659848490,MATH 10B,A01,083207,Lim; Seonhee,8,0,34,26
1657659848490,MATH 10B,A02,083208,Lim; Seonhee,9,0,35,26
1657659848490,MATH 10B,A03,093472,Lim; Seonhee,7,0,34,27
1657659848490,MATH 10B,B01,083739,Sinha; Shubham,13,0,30,17
1657659854521,MATH 18,A01,083743,Cinel; Cameron Alexander,8,0,30,22
1657659854521,MATH 18,A02,083744,Cinel; Cameron Alexander,17,0,30,13
1657659854521,MATH 18,A03,083745,Cinel; Cameron Alexander,10,0,30,20
1657659854521,MATH 18,B01,083748,Rideout; David Porter,5,0,37,32
1657659854521,MATH 18,B02,083749,Rideout; David Porter,5,0,36,31
1657659854521,MATH 18,B03,083750,Rideout; David Porter,3,0,37,34
1657659854521,MATH 18,B04,083751,Rideout; David Porter,6,0,36,30
1657659854521,MATH 18,B05,093473,Rideout; David Porter,6,0,36,30
1657659854521,MATH 18,B06,093474,Rideout; David Porter,6,0,36,30
1657659860543,MATH 20A,A01,083754,Zheng; Zequn,14,0,40,26
1657659866574,MATH 20B,A01,083756,Briones; Jor-el Thomas Caparas,4,0,36,32
1657659866574,MATH 20B,A02,083757,Briones; Jor-el Thomas Caparas,1,0,36,35
1657659866574,MATH 20B,A03,093475,Briones; Jor-el Thomas Caparas,2,0,36,34
1657659872607,MATH 20C,A01,083760,Briones; Jor-el Thomas Caparas,1,0,35,34
1657659872607,MATH 20C,A02,083761,Briones; Jor-el Thomas Caparas,8,0,35,27
1657659872607,MATH 20C,A03,093476,Briones; Jor-el Thomas Caparas,0,1,36,36
1657659872607,MATH 20C,B01,083762,Bach; Quang Tran,1,0,30,29
1657659878632,MATH 20D,A01,083765,Tran; Brian Kha,5,0,30,25
1657659878632,MATH 20D,A02,083766,Tran; Brian Kha,5,0,30,25
1657659878632,MATH 20D,A03,083767,Tran; Brian Kha,5,0,30,25
1657659884660,MATH 20E,A01,083771,Ganguly; Soumya,9,0,32,23
1657659884660,MATH 20E,A02,083772,Ganguly; Soumya,6,0,32,26
1657659884660,MATH 20E,B01,083773,Ciotti; Benjamin,20,0,35,15
1657659884660,MATH 20E,B02,083774,Ciotti; Benjamin,18,0,35,17
1657659890686,MATH 103A,A01,083777,Greenfeld; Be'Eri,3,0,36,33
1657659890686,MATH 103A,A02,083778,Greenfeld; Be'Eri,5,0,36,31
1657659890686,MATH 103A,A03,093561,Greenfeld; Be'Eri,6,0,36,30
1657659890686,MATH 103A,B01,083779,Greenfeld; Be'Eri,7,0,36,29
1657659890686,MATH 103A,B02,083780,Greenfeld; Be'Eri,4,0,36,32
1657659890686,MATH 103A,B03,093562,Greenfeld; Be'Eri,3,0,36,33
1657659896712,MATH 105,A01,085443,Carter; Anne Toulson,15,0,35,20
1657659896712,MATH 105,A02,093477,Carter; Anne Toulson,20,0,35,15
1657659902737,MATH 109,A01,083213,Ganzberger; Geoffrey Michael,2,0,34,32
1657659902737,MATH 109,A02,083214,Ganzberger; Geoffrey Michael,4,0,34,30
1657659902737,MATH 109,A03,093478,Ganzberger; Geoffrey Michael,2,0,34,32
1657659902737,MATH 109,B01,083215,Ganzberger; Geoffrey Michael,1,0,32,31
1657659902737,MATH 109,B02,083216,Ganzberger; Geoffrey Michael,2,0,32,30
1657659902737,MATH 109,B03,093479,Ganzberger; Geoffrey Michael,8,0,32,24
1657659908769,MATH 142A,A01,083219,Chow; Bennett,7,0,32,25
1657659908769,MATH 142A,A02,083220,Chow; Bennett,10,0,32,22
1657659908769,MATH 142A,A03,093480,Chow; Bennett,9,0,32,23
1657659908769,MATH 142A,B03,093481,Chow; Bennett,8,0,32,24
1657659908769,MATH 142A,B04,093558,Chow; Bennett,13,0,32,19
1657659908769,MATH 142A,B05,093559,Chow; Bennett,6,0,32,26
1657659914799,MATH 193A,A01,083224,Rotar; Vladimir,8,0,34,26
1657659914799,MATH 193A,A02,083225,Rotar; Vladimir,9,0,34,25
1657659914799,MATH 193A,A03,083781,Rotar; Vladimir,5,0,34,29
1657659914799,MATH 193A,A04,083782,Rotar; Vladimir,10,0,34,24
1657659914799,MATH 193A,A05,093482,Rotar; Vladimir,10,0,34,24
1657659920835,MATH 197,001,091859,McAuley; Julian John,9999,0,9999,0
1657659920835,MATH 197,002,095566,Kedlaya; Kiran S.,9997,0,9999,2
1657659920835,MATH 197,003,095567,Xiao; Ming,9999,0,9999,0
1657659920835,MATH 197,004,095571,Perols; Johan Lars,9998,0,9999,1
1657659927895,COGS 9,A01,083615,Shannon; Kyle Michael,9,0,75,66
1657659933921,COGS 11,A01,083617,Boyle; Mary E. T.,23,0,48,25
1657659939947,COGS 13,A01,083071,Bastos; Amalia Pinkusfeld,11,0,71,60
1657659945976,COGS 14A,A01,092681,Semenuks; Arturs,5,1,100,95
1657659952002,COGS 14B,A01,083073,Cheng; Tzu-Han,6,0,63,57
1657659958029,COGS 17,A01,092677,Semenuks; Arturs,6,0,81,75
1657659964051,COGS 100,A01,083619,Allen; Michael Gordon,17,0,70,53
1657659970084,COGS 101A,A01,083621,Davis; Joshua Daniel,9,0,68,59
1657659976110,COGS 101B,A01,091572,Allen; Michael Gordon,12,0,65,53
1657659982145,COGS 101C,A01,083625,Delgado; Tania,17,0,35,18
1657659988171,COGS 107A,A01,083627,Boyle; Mary E. T.,13,0,60,47
1657659994209,COGS 118A,A01,083075,Gupta; Anjum,21,0,76,55
1657660000235,CSE 3,A50,083646,Miranda; Gregory Joseph,24,0,50,26
1657660006262,CSE 8A,A50,083650,Miranda; Gregory Joseph,17,1,56,39
1657660012288,CSE 11,A01,083080,Cao; Yingjun,6,15,40,34
1657660018315,CSE 12,A01,083652,Krause-Levy; Sophia Louisa,28,1,120,92
1657660024339,CSE 15L,A01,083654,Morris; Justin Loren,9,0,50,41
1657660024339,CSE 15L,A02,083655,Morris; Justin Loren,9,0,50,41
1657660030362,CSE 20,A01,083657,Tran; Khoa Dang,39,0,80,41
1657660036389,CSE 21,A01,095574,Bach; Quang Tran,22,0,48,26
1657660042416,CSE 30,A01,083084,Eldon; John,6,0,80,74
1657660042416,CSE 30,B01,095061,Bhaskar; Nishant,9,0,50,41
1657660048438,CSE 100,A01,083659,Cao; Yingjun,5,4,70,65
1657660054469,CSE 134B,A01,083661,Powell; Thomas Allan,23,0,100,77
1657660060503,CSE 140,A01,083663,Gungor; Onat,15,0,85,70
1657660066527,CSE 140L,A01,083088,Eldon; John,22,0,100,78
1657660072556,CSE 175,A01,083665,Kumar; Rakesh,3,0,25,22
1657660078579,CSE 190,A00,092507,Dubnov; Shlomo,8,0,20,12
1657660084616,ECE 45,A01,083139,Congero; Spencer William,6,0,75,69
1657660090639,ECE 65,A50,083695,Saad; Andrew S,12,0,30,18
1657660090639,ECE 65,A51,095125,Saad; Andrew S,24,0,26,2
1657660096671,ECE 109,A01,091882,Touri; Behrouz,20,0,70,50
1657660102693,ECE 180,A00,083140,Abi Samra; Nicholas Camill,1,0,30,29
1657660102693,ECE 180,B00,083141,Abi Samra; Nicholas Camill,0,0,30,30
1657660108716,MATH 10A,A01,083735,Patchell; Gregory David,2,0,30,28
1657660108716,MATH 10A,A02,083736,Patchell; Gregory David,20,0,30,10
1657660108716,MATH 10A,A03,083737,Patchell; Gregory David,16,0,30,14
1657660114743,MATH 10B,A01,083207,Lim; Seonhee,8,0,34,26
1657660114743,MATH 10B,A02,083208,Lim; Seonhee,9,0,35,26
1657660114743,MATH 10B,A03,093472,Lim; Seonhee,7,0,34,27
1657660114743,MATH 10B,B01,083739,Sinha; Shubham,13,0,30,17
1657660120772,MATH 18,A01,083743,Cinel; Cameron Alexander,8,0,30,22
1657660120772,MATH 18,A02,083744,Cinel; Cameron Alexander,17,0,30,13
1657660120772,MATH 18,A03,083745,Cinel; Cameron Alexander,10,0,30,20
1657660120772,MATH 18,B01,083748,Rideout; David Porter,5,0,37,32
1657660120772,MATH 18,B02,083749,Rideout; David Porter,5,0,36,31
1657660120772,MATH 18,B03,083750,Rideout; David Porter,3,0,37,34
1657660120772,MATH 18,B04,083751,Rideout; David Porter,6,0,36,30
1657660120772,MATH 18,B05,093473,Rideout; David Porter,6,0,36,30
1657660120772,MATH 18,B06,093474,Rideout; David Porter,6,0,36,30
1657660126796,MATH 20A,A01,083754,Zheng; Zequn,14,0,40,26
1657660132819,MATH 20B,A01,083756,Briones; Jor-el Thomas Caparas,4,0,36,32
1657660132819,MATH 20B,A02,083757,Briones; Jor-el Thomas Caparas,1,0,36,35
1657660132819,MATH 20B,A03,093475,Briones; Jor-el Thomas Caparas,2,0,36,34
1657660138853,MATH 20C,A01,083760,Briones; Jor-el Thomas Caparas,1,0,35,34
1657660138853,MATH 20C,A02,083761,Briones; Jor-el Thomas Caparas,8,0,35,27
1657660138853,MATH 20C,A03,093476,Briones; Jor-el Thomas Caparas,0,1,36,36
1657660138853,MATH 20C,B01,083762,Bach; Quang Tran,1,0,30,29
1657660144876,MATH 20D,A01,083765,Tran; Brian Kha,5,0,30,25
1657660144876,MATH 20D,A02,083766,Tran; Brian Kha,5,0,30,25
1657660144876,MATH 20D,A03,083767,Tran; Brian Kha,5,0,30,25
1657660150902,MATH 20E,A01,083771,Ganguly; Soumya,9,0,32,23
1657660150902,MATH 20E,A02,083772,Ganguly; Soumya,6,0,32,26
1657660150902,MATH 20E,B01,083773,Ciotti; Benjamin,20,0,35,15
1657660150902,MATH 20E,B02,083774,Ciotti; Benjamin,18,0,35,17
1657660156930,MATH 103A,A01,083777,Greenfeld; Be'Eri,3,0,36,33
1657660156930,MATH 103A,A02,083778,Greenfeld; Be'Eri,5,0,36,31
1657660156930,MATH 103A,A03,093561,Greenfeld; Be'Eri,6,0,36,30
1657660156930,MATH 103A,B01,083779,Greenfeld; Be'Eri,7,0,36,29
1657660156930,MATH 103A,B02,083780,Greenfeld; Be'Eri,4,0,36,32
1657660156930,MATH 103A,B03,093562,Greenfeld; Be'Eri,3,0,36,33
1657660162952,MATH 105,A01,085443,Carter; Anne Toulson,15,0,35,20
1657660162952,MATH 105,A02,093477,Carter; Anne Toulson,20,0,35,15
1657660168990,MATH 109,A01,083213,Ganzberger; Geoffrey Michael,2,0,34,32
1657660168990,MATH 109,A02,083214,Ganzberger; Geoffrey Michael,4,0,34,30
1657660168990,MATH 109,A03,093478,Ganzberger; Geoffrey Michael,2,0,34,32
1657660168990,MATH 109,B01,083215,Ganzberger; Geoffrey Michael,1,0,32,31
1657660168990,MATH 109,B02,083216,Ganzberger; Geoffrey Michael,2,0,32,30
1657660168990,MATH 109,B03,093479,Ganzberger; Geoffrey Michael,8,0,32,24
1657660175015,MATH 142A,A01,083219,Chow; Bennett,7,0,32,25
1657660175015,MATH 142A,A02,083220,Chow; Bennett,10,0,32,22
1657660175015,MATH 142A,A03,093480,Chow; Bennett,9,0,32,23
1657660175015,MATH 142A,B03,093481,Chow; Bennett,8,0,32,24
1657660175015,MATH 142A,B04,093558,Chow; Bennett,13,0,32,19
1657660175015,MATH 142A,B05,093559,Chow; Bennett,6,0,32,26
1657660181045,MATH 193A,A01,083224,Rotar; Vladimir,8,0,34,26
1657660181045,MATH 193A,A02,083225,Rotar; Vladimir,9,0,34,25
1657660181045,MATH 193A,A03,083781,Rotar; Vladimir,5,0,34,29
1657660181045,MATH 193A,A04,083782,Rotar; Vladimir,10,0,34,24
1657660181045,MATH 193A,A05,093482,Rotar; Vladimir,10,0,34,24
1657660187070,MATH 197,001,091859,McAuley; Julian John,9999,0,9999,0
1657660187070,MATH 197,002,095566,Kedlaya; Kiran S.,9997,0,9999,2
1657660187070,MATH 197,003,095567,Xiao; Ming,9999,0,9999,0
1657660187070,MATH 197,004,095571,Perols; Johan Lars,9998,0,9999,1
1657660194126,COGS 9,A01,083615,Shannon; Kyle Michael,9,0,75,66
1657660200153,COGS 11,A01,083617,Boyle; Mary E. T.,23,0,48,25
1657660206175,COGS 13,A01,083071,Bastos; Amalia Pinkusfeld,11,0,71,60
1657660212199,COGS 14A,A01,092681,Semenuks; Arturs,5,1,100,95
1657660218223,COGS 14B,A01,083073,Cheng; Tzu-Han,6,0,63,57
1657660224245,COGS 17,A01,092677,Semenuks; Arturs,6,0,81,75
1657660230272,COGS 100,A01,083619,Allen; Michael Gordon,17,0,70,53
1657660236304,COGS 101A,A01,083621,Davis; Joshua Daniel,9,0,68,59
1657660242326,COGS 101B,A01,091572,Allen; Michael Gordon,12,0,65,53
1657660248357,COGS 101C,A01,083625,Delgado; Tania,17,0,35,18
1657660254381,COGS 107A,A01,083627,Boyle; Mary E. T.,13,0,60,47
1657660260409,COGS 118A,A01,083075,Gupta; Anjum,21,0,76,55
1657660266431,CSE 3,A50,083646,Miranda; Gregory Joseph,24,0,50,26
1657660272453,CSE 8A,A50,083650,Miranda; Gregory Joseph,17,1,56,39
1657660278482,CSE 11,A01,083080,Cao; Yingjun,6,15,40,34
1657660284609,CSE 12,A01,083652,Krause-Levy; Sophia Louisa,28,1,120,92
1657660290633,CSE 15L,A01,083654,Morris; Justin Loren,9,0,50,41
1657660290633,CSE 15L,A02,083655,Morris; Justin Loren,9,0,50,41
1657660296658,CSE 20,A01,083657,Tran; Khoa Dang,39,0,80,41
1657660302688,CSE 21,A01,095574,Bach; Quang Tran,22,0,48,26
1657660308711,CSE 30,A01,083084,Eldon; John,6,0,80,74
1657660308711,CSE 30,B01,095061,Bhaskar; Nishant,9,0,50,41
1657660314750,CSE 100,A01,083659,Cao; Yingjun,5,4,70,65
1657660320773,CSE 134B,A01,083661,Powell; Thomas Allan,23,0,100,77
1657660326799,CSE 140,A01,083663,Gungor; Onat,15,0,85,70
1657660332824,CSE 140L,A01,083088,Eldon; John,22,0,100,78
1657660338847,CSE 175,A01,083665,Kumar; Rakesh,3,0,25,22
1657660344871,CSE 190,A00,092507,Dubnov; Shlomo,8,0,20,12
1657660350898,ECE 45,A01,083139,Congero; Spencer William,6,0,75,69
1657660356936,ECE 65,A50,083695,Saad; Andrew S,12,0,30,18
1657660356936,ECE 65,A51,095125,Saad; Andrew S,24,0,26,2
1657660362959,ECE 109,A01,091882,Touri; Behrouz,20,0,70,50
1657660368996,ECE 180,A00,083140,Abi Samra; Nicholas Camill,1,0,30,29
1657660368996,ECE 180,B00,083141,Abi Samra; Nicholas Camill,0,0,30,30
1657660375022,MATH 10A,A01,083735,Patchell; Gregory David,2,0,30,28
1657660375022,MATH 10A,A02,083736,Patchell; Gregory David,20,0,30,10
1657660375022,MATH 10A,A03,083737,Patchell; Gregory David,16,0,30,14
1657660381045,MATH 10B,A01,083207,Lim; Seonhee,8,0,34,26
1657660381045,MATH 10B,A02,083208,Lim; Seonhee,9,0,35,26
1657660381045,MATH 10B,A03,093472,Lim; Seonhee,7,0,34,27
1657660381045,MATH 10B,B01,083739,Sinha; Shubham,13,0,30,17
1657660387080,MATH 18,A01,083743,Cinel; Cameron Alexander,8,0,30,22
1657660387080,MATH 18,A02,083744,Cinel; Cameron Alexander,17,0,30,13
1657660387080,MATH 18,A03,083745,Cinel; Cameron Alexander,10,0,30,20
1657660387080,MATH 18,B01,083748,Rideout; David Porter,5,0,37,32
1657660387080,MATH 18,B02,083749,Rideout; David Porter,5,0,36,31
1657660387080,MATH 18,B03,083750,Rideout; David Porter,3,0,37,34
1657660387080,MATH 18,B04,083751,Rideout; David Porter,6,0,36,30
1657660387080,MATH 18,B05,093473,Rideout; David Porter,6,0,36,30
1657660387080,MATH 18,B06,093474,Rideout; David Porter,6,0,36,30
1657660393105,MATH 20A,A01,083754,Zheng; Zequn,14,0,40,26
1657660399133,MATH 20B,A01,083756,Briones; Jor-el Thomas Caparas,4,0,36,32
1657660399133,MATH 20B,A02,083757,Briones; Jor-el Thomas Caparas,1,0,36,35
1657660399133,MATH 20B,A03,093475,Briones; Jor-el Thomas Caparas,2,0,36,34
1657660405159,MATH 20C,A01,083760,Briones; Jor-el Thomas Caparas,1,0,35,34
1657660405159,MATH 20C,A02,083761,Briones; Jor-el Thomas Caparas,8,0,35,27
1657660405159,MATH 20C,A03,093476,Briones; Jor-el Thomas Caparas,0,1,36,36
1657660405159,MATH 20C,B01,083762,Bach; Quang Tran,1,0,30,29
1657660411190,MATH 20D,A01,083765,Tran; Brian Kha,5,0,30,25
1657660411190,MATH 20D,A02,083766,Tran; Brian Kha,5,0,30,25
1657660411190,MATH 20D,A03,083767,Tran; Brian Kha,5,0,30,25
1657660417217,MATH 20E,A01,083771,Ganguly; Soumya,9,0,32,23
1657660417217,MATH 20E,A02,083772,Ganguly; Soumya,6,0,32,26
1657660417217,MATH 20E,B01,083773,Ciotti; Benjamin,20,0,35,15
1657660417217,MATH 20E,B02,083774,Ciotti; Benjamin,18,0,35,17
1657660423246,MATH 103A,A01,083777,Greenfeld; Be'Eri,3,0,36,33
1657660423246,MATH 103A,A02,083778,Greenfeld; Be'Eri,5,0,36,31
1657660423246,MATH 103A,A03,093561,Greenfeld; Be'Eri,6,0,36,30
1657660423246,MATH 103A,B01,083779,Greenfeld; Be'Eri,7,0,36,29
1657660423246,MATH 103A,B02,083780,Greenfeld; Be'Eri,4,0,36,32
1657660423246,MATH 103A,B03,093562,Greenfeld; Be'Eri,3,0,36,33
1657660429274,MATH 105,A01,085443,Carter; Anne Toulson,15,0,35,20
1657660429274,MATH 105,A02,093477,Carter; Anne Toulson,20,0,35,15
1657660435300,MATH 109,A01,083213,Ganzberger; Geoffrey Michael,2,0,34,32
1657660435300,MATH 109,A02,083214,Ganzberger; Geoffrey Michael,4,0,34,30
1657660435300,MATH 109,A03,093478,Ganzberger; Geoffrey Michael,2,0,34,32
1657660435300,MATH 109,B01,083215,Ganzberger; Geoffrey Michael,1,0,32,31
1657660435300,MATH 109,B02,083216,Ganzberger; Geoffrey Michael,2,0,32,30
1657660435300,MATH 109,B03,093479,Ganzberger; Geoffrey Michael,8,0,32,24
1657660441328,MATH 142A,A01,083219,Chow; Bennett,7,0,32,25
1657660441328,MATH 142A,A02,083220,Chow; Bennett,10,0,32,22
1657660441328,MATH 142A,A03,093480,Chow; Bennett,9,0,32,23
1657660441328,MATH 142A,B03,093481,Chow; Bennett,8,0,32,24
1657660441328,MATH 142A,B04,093558,Chow; Bennett,13,0,32,19
1657660441328,MATH 142A,B05,093559,Chow; Bennett,6,0,32,26
1657660447363,MATH 193A,A01,083224,Rotar; Vladimir,8,0,34,26
1657660447363,MATH 193A,A02,083225,Rotar; Vladimir,9,0,34,25
1657660447363,MATH 193A,A03,083781,Rotar; Vladimir,5,0,34,29
1657660447363,MATH 193A,A04,083782,Rotar; Vladimir,10,0,34,24
1657660447363,MATH 193A,A05,093482,Rotar; Vladimir,10,0,34,24
1657660453390,MATH 197,001,091859,McAuley; Julian John,9999,0,9999,0
1657660453390,MATH 197,002,095566,Kedlaya; Kiran S.,9997,0,9999,2
1657660453390,MATH 197,003,095567,Xiao; Ming,9999,0,9999,0
1657660453390,MATH 197,004,095571,Perols; Johan Lars,9998,0,9999,1
1657660460457,COGS 9,A01,083615,Shannon; Kyle Michael,9,0,75,66
1657660466480,COGS 11,A01,083617,Boyle; Mary E. T.,23,0,48,25
1657660472512,COGS 13,A01,083071,Bastos; Amalia Pinkusfeld,11,0,71,60
1657660478534,COGS 14A,A01,092681,Semenuks; Arturs,5,1,100,95
1657660484557,COGS 14B,A01,083073,Cheng; Tzu-Han,6,0,63,57
1657660490593,COGS 17,A01,092677,Semenuks; Arturs,6,0,81,75
1657660496615,COGS 100,A01,083619,Allen; Michael Gordon,17,0,70,53
1657660502637,COGS 101A,A01,083621,Davis; Joshua Daniel,9,0,68,59
1657660508663,COGS 101B,A01,091572,Allen; Michael Gordon,12,0,65,53
1657660514689,COGS 101C,A01,083625,Delgado; Tania,17,0,35,18
1657660520718,COGS 107A,A01,083627,Boyle; Mary E. T.,13,0,60,47
1657660526745,COGS 118A,A01,083075,Gupta; Anjum,21,0,76,55
1657660532770,CSE 3,A50,083646,Miranda; Gregory Joseph,24,0,50,26
1657660538804,CSE 8A,A50,083650,Miranda; Gregory Joseph,17,1,56,39
1657660544827,CSE 11,A01,083080,Cao; Yingjun,6,15,40,34
1657660550856,CSE 12,A01,083652,Krause-Levy; Sophia Louisa,28,1,120,92
1657660556886,CSE 15L,A01,083654,Morris; Justin Loren,9,0,50,41
1657660556886,CSE 15L,A02,083655,Morris; Justin Loren,9,0,50,41
1657660562907,CSE 20,A01,083657,Tran; Khoa Dang,39,0,80,41
1657660568933,CSE 21,A01,095574,Bach; Quang Tran,22,0,48,26
1657660574959,CSE 30,A01,083084,Eldon; John,6,0,80,74
1657660574959,CSE 30,B01,095061,Bhaskar; Nishant,9,0,50,41
1657660580992,CSE 100,A01,083659,Cao; Yingjun,5,4,70,65
1657660587020,CSE 134B,A01,083661,Powell; Thomas Allan,23,0,100,77
1657660593051,CSE 140,A01,083663,Gungor; Onat,15,0,85,70
1657660599074,CSE 140L,A01,083088,Eldon; John,22,0,100,78
1657660605096,CSE 175,A01,083665,Kumar; Rakesh,3,0,25,22
1657660611122,CSE 190,A00,092507,Dubnov; Shlomo,8,0,20,12
1657660617148,ECE 45,A01,083139,Congero; Spencer William,6,0,75,69
1657660623171,ECE 65,A50,083695,Saad; Andrew S,12,0,30,18
1657660623171,ECE 65,A51,095125,Saad; Andrew S,24,0,26,2
1657660629199,ECE 109,A01,091882,Touri; Behrouz,20,0,70,50
1657660635228,ECE 180,A00,083140,Abi Samra; Nicholas Camill,1,0,30,29
1657660635228,ECE 180,B00,083141,Abi Samra; Nicholas Camill,0,0,30,30
1657660641252,MATH 10A,A01,083735,Patchell; Gregory David,2,0,30,28
1657660641252,MATH 10A,A02,083736,Patchell; Gregory David,20,0,30,10
1657660641252,MATH 10A,A03,083737,Patchell; Gregory David,16,0,30,14
1657660647281,MATH 10B,A01,083207,Lim; Seonhee,8,0,34,26
1657660647281,MATH 10B,A02,083208,Lim; Seonhee,9,0,35,26
1657660647281,MATH 10B,A03,093472,Lim; Seonhee,7,0,34,27
1657660647281,MATH 10B,B01,083739,Sinha; Shubham,13,0,30,17
1657660653307,MATH 18,A01,083743,Cinel; Cameron Alexander,8,0,30,22
1657660653307,MATH 18,A02,083744,Cinel; Cameron Alexander,17,0,30,13
1657660653307,MATH 18,A03,083745,Cinel; Cameron Alexander,10,0,30,20
1657660653307,MATH 18,B01,083748,Rideout; David Porter,5,0,37,32
1657660653307,MATH 18,B02,083749,Rideout; David Porter,5,0,36,31
1657660653307,MATH 18,B03,083750,Rideout; David Porter,3,0,37,34
1657660653307,MATH 18,B04,083751,Rideout; David Porter,6,0,36,30
1657660653307,MATH 18,B05,093473,Rideout; David Porter,6,0,36,30
1657660653307,MATH 18,B06,093474,Rideout; David Porter,6,0,36,30
1657660659344,MATH 20A,A01,083754,Zheng; Zequn,14,0,40,26
1657660665370,MATH 20B,A01,083756,Briones; Jor-el Thomas Caparas,4,0,36,32
1657660665370,MATH 20B,A02,083757,Briones; Jor-el Thomas Caparas,1,0,36,35
1657660665370,MATH 20B,A03,093475,Briones; Jor-el Thomas Caparas,2,0,36,34
1657660671396,MATH 20C,A01,083760,Briones; Jor-el Thomas Caparas,1,0,35,34
1657660671396,MATH 20C,A02,083761,Briones; Jor-el Thomas Caparas,8,0,35,27
1657660671396,MATH 20C,A03,093476,Briones; Jor-el Thomas Caparas,0,1,36,36
1657660671396,MATH 20C,B01,083762,Bach; Quang Tran,1,0,30,29
1657660677425,MATH 20D,A01,083765,Tran; Brian Kha,5,0,30,25
1657660677425,MATH 20D,A02,083766,Tran; Brian Kha,5,0,30,25
1657660677425,MATH 20D,A03,083767,Tran; Brian Kha,5,0,30,25
1657660683450,MATH 20E,A01,083771,Ganguly; Soumya,9,0,32,23
1657660683450,MATH 20E,A02,083772,Ganguly; Soumya,6,0,32,26
1657660683450,MATH 20E,B01,083773,Ciotti; Benjamin,20,0,35,15
1657660683450,MATH 20E,B02,083774,Ciotti; Benjamin,18,0,35,17
1657660689487,MATH 103A,A01,083777,Greenfeld; Be'Eri,3,0,36,33
1657660689487,MATH 103A,A02,083778,Greenfeld; Be'Eri,5,0,36,31
1657660689487,MATH 103A,A03,093561,Greenfeld; Be'Eri,6,0,36,30
1657660689487,MATH 103A,B01,083779,Greenfeld; Be'Eri,7,0,36,29
1657660689487,MATH 103A,B02,083780,Greenfeld; Be'Eri,4,0,36,32
1657660689487,MATH 103A,B03,093562,Greenfeld; Be'Eri,3,0,36,33
1657660695509,MATH 105,A01,085443,Carter; Anne Toulson,15,0,35,20
1657660695509,MATH 105,A02,093477,Carter; Anne Toulson,20,0,35,15
1657660701548,MATH 109,A01,083213,Ganzberger; Geoffrey Michael,2,0,34,32
1657660701548,MATH 109,A02,083214,Ganzberger; Geoffrey Michael,4,0,34,30
1657660701548,MATH 109,A03,093478,Ganzberger; Geoffrey Michael,2,0,34,32
1657660701548,MATH 109,B01,083215,Ganzberger; Geoffrey Michael,1,0,32,31
1657660701548,MATH 109,B02,083216,Ganzberger; Geoffrey Michael,2,0,32,30
1657660701548,MATH 109,B03,093479,Ganzberger; Geoffrey Michael,8,0,32,24
1657660707578,MATH 142A,A01,083219,Chow; Bennett,7,0,32,25
1657660707578,MATH 142A,A02,083220,Chow; Bennett,10,0,32,22
1657660707578,MATH 142A,A03,093480,Chow; Bennett,9,0,32,23
1657660707578,MATH 142A,B03,093481,Chow; Bennett,8,0,32,24
1657660707578,MATH 142A,B04,093558,Chow; Bennett,13,0,32,19
1657660707578,MATH 142A,B05,093559,Chow; Bennett,6,0,32,26
1657660713612,MATH 193A,A01,083224,Rotar; Vladimir,8,0,34,26
1657660713612,MATH 193A,A02,083225,Rotar; Vladimir,9,0,34,25
1657660713612,MATH 193A,A03,083781,Rotar; Vladimir,5,0,34,29
1657660713612,MATH 193A,A04,083782,Rotar; Vladimir,10,0,34,24
1657660713612,MATH 193A,A05,093482,Rotar; Vladimir,10,0,34,24
1657660719637,MATH 197,001,091859,McAuley; Julian John,9999,0,9999,0
1657660719637,MATH 197,002,095566,Kedlaya; Kiran S.,9997,0,9999,2
1657660719637,MATH 197,003,095567,Xiao; Ming,9999,0,9999,0
1657660719637,MATH 197,004,095571,Perols; Johan Lars,9998,0,9999,1
1657660726707,COGS 9,A01,083615,Shannon; Kyle Michael,9,0,75,66
1657660732730,COGS 11,A01,083617,Boyle; Mary E. T.,23,0,48,25
1657660738755,COGS 13,A01,083071,Bastos; Amalia Pinkusfeld,11,0,71,60
1657660744777,COGS 14A,A01,092681,Semenuks; Arturs,5,1,100,95
1657660750800,COGS 14B,A01,083073,Cheng; Tzu-Han,6,0,63,57
1657660756823,COGS 17,A01,092677,Semenuks; Arturs,6,0,81,75
1657660762846,COGS 100,A01,083619,Allen; Michael Gordon,17,0,70,53
1657660768873,COGS 101A,A01,083621,Davis; Joshua Daniel,9,0,68,59
1657660774896,COGS 101B,A01,091572,Allen; Michael Gordon,12,0,65,53
1657660780927,COGS 101C,A01,083625,Delgado; Tania,17,0,35,18
1657660786950,COGS 107A,A01,083627,Boyle; Mary E. T.,13,0,60,47
1657660792975,COGS 118A,A01,083075,Gupta; Anjum,21,0,76,55
1657660798998,CSE 3,A50,083646,Miranda; Gregory Joseph,24,0,50,26
1657660805027,CSE 8A,A50,083650,Miranda; Gregory Joseph,17,1,56,39
1657660811053,CSE 11,A01,083080,Cao; Yingjun,6,15,40,34
1657660817076,CSE 12,A01,083652,Krause-Levy; Sophia Louisa,28,1,120,92
1657660823104,CSE 15L,A01,083654,Morris; Justin Loren,9,0,50,41
1657660823104,CSE 15L,A02,083655,Morris; Justin Loren,9,0,50,41
1657660829128,CSE 20,A01,083657,Tran; Khoa Dang,39,0,80,41
1657660835150,CSE 21,A01,095574,Bach; Quang Tran,22,0,48,26
1657660841173,CSE 30,A01,083084,Eldon; John,6,0,80,74
1657660841173,CSE 30,B01,095061,Bhaskar; Nishant,9,0,50,41
1657660847196,CSE 100,A01,083659,Cao; Yingjun,5,4,70,65
1657660853228,CSE 134B,A01,083661,Powell; Thomas Allan,23,0,100,77
1657660859250,CSE 140,A01,083663,Gungor; Onat,15,0,85,70
1657660865274,CSE 140L,A01,083088,Eldon; John,22,0,100,78
1657660871300,CSE 175,A01,083665,Kumar; Rakesh,3,0,25,22
1657660877329,CSE 190,A00,092507,Dubnov; Shlomo,8,0,20,12
1657660883426,ECE 45,A01,083139,Congero; Spencer William,6,0,75,69
1657660889452,ECE 65,A50,083695,Saad; Andrew S,12,0,30,18
1657660889452,ECE 65,A51,095125,Saad; Andrew S,24,0,26,2
1657660895477,ECE 109,A01,091882,Touri; Behrouz,20,0,70,50
1657660901504,ECE 180,A00,083140,Abi Samra; Nicholas Camill,1,0,30,29
1657660901504,ECE 180,B00,083141,Abi Samra; Nicholas Camill,0,0,30,30
1657660907535,MATH 10A,A01,083735,Patchell; Gregory David,2,0,30,28
1657660907535,MATH 10A,A02,083736,Patchell; Gregory David,20,0,30,10
1657660907535,MATH 10A,A03,083737,Patchell; Gregory David,16,0,30,14
1657660913561,MATH 10B,A01,083207,Lim; Seonhee,8,0,34,26
1657660913561,MATH 10B,A02,083208,Lim; Seonhee,9,0,35,26
1657660913561,MATH 10B,A03,093472,Lim; Seonhee,7,0,34,27
1657660913561,MATH 10B,B01,083739,Sinha; Shubham,13,0,30,17
1657660919592,MATH 18,A01,083743,Cinel; Cameron Alexander,8,0,30,22
1657660919592,MATH 18,A02,083744,Cinel; Cameron Alexander,17,0,30,13
1657660919592,MATH 18,A03,083745,Cinel; Cameron Alexander,10,0,30,20
1657660919592,MATH 18,B01,083748,Rideout; David Porter,5,0,37,32
1657660919592,MATH 18,B02,083749,Rideout; David Porter,5,0,36,31
1657660919592,MATH 18,B03,083750,Rideout; David Porter,3,0,37,34
1657660919592,MATH 18,B04,083751,Rideout; David Porter,6,0,36,30
1657660919592,MATH 18,B05,093473,Rideout; David Porter,6,0,36,30
1657660919592,MATH 18,B06,093474,Rideout; David Porter,6,0,36,30
1657660925625,MATH 20A,A01,083754,Zheng; Zequn,14,0,40,26
1657660931652,MATH 20B,A01,083756,Briones; Jor-el Thomas Caparas,4,0,36,32
1657660931652,MATH 20B,A02,083757,Briones; Jor-el Thomas Caparas,1,0,36,35
1657660931652,MATH 20B,A03,093475,Briones; Jor-el Thomas Caparas,2,0,36,34
1657660937679,MATH 20C,A01,083760,Briones; Jor-el Thomas Caparas,1,0,35,34
1657660937679,MATH 20C,A02,083761,Briones; Jor-el Thomas Caparas,8,0,35,27
1657660937679,MATH 20C,A03,093476,Briones; Jor-el Thomas Caparas,0,1,36,36
1657660937679,MATH 20C,B01,083762,Bach; Quang Tran,1,0,30,29
1657660943706,MATH 20D,A01,083765,Tran; Brian Kha,5,0,30,25
1657660943706,MATH 20D,A02,083766,Tran; Brian Kha,5,0,30,25
1657660943706,MATH 20D,A03,083767,Tran; Brian Kha,5,0,30,25
1657660949734,MATH 20E,A01,083771,Ganguly; Soumya,9,0,32,23
1657660949734,MATH 20E,A02,083772,Ganguly; Soumya,6,0,32,26
1657660949734,MATH 20E,B01,083773,Ciotti; Benjamin,20,0,35,15
1657660949734,MATH 20E,B02,083774,Ciotti; Benjamin,18,0,35,17
1657660955758,MATH 103A,A01,083777,Greenfeld; Be'Eri,3,0,36,33
1657660955758,MATH 103A,A02,083778,Greenfeld; Be'Eri,5,0,36,31
1657660955758,MATH 103A,A03,093561,Greenfeld; Be'Eri,6,0,36,30
1657660955758,MATH 103A,B01,083779,Greenfeld; Be'Eri,7,0,36,29
1657660955758,MATH 103A,B02,083780,Greenfeld; Be'Eri,4,0,36,32
1657660955758,MATH 103A,B03,093562,Greenfeld; Be'Eri,3,0,36,33
1657660961785,MATH 105,A01,085443,Carter; Anne Toulson,15,0,35,20
1657660961785,MATH 105,A02,093477,Carter; Anne Toulson,20,0,35,15
1657660967810,MATH 109,A01,083213,Ganzberger; Geoffrey Michael,2,0,34,32
1657660967810,MATH 109,A02,083214,Ganzberger; Geoffrey Michael,4,0,34,30
1657660967810,MATH 109,A03,093478,Ganzberger; Geoffrey Michael,2,0,34,32
1657660967810,MATH 109,B01,083215,Ganzberger; Geoffrey Michael,1,0,32,31
1657660967810,MATH 109,B02,083216,Ganzberger; Geoffrey Michael,2,0,32,30
1657660967810,MATH 109,B03,093479,Ganzberger; Geoffrey Michael,8,0,32,24
1657660973841,MATH 142A,A01,083219,Chow; Bennett,7,0,32,25
1657660973841,MATH 142A,A02,083220,Chow; Bennett,10,0,32,22
1657660973841,MATH 142A,A03,093480,Chow; Bennett,9,0,32,23
1657660973841,MATH 142A,B03,093481,Chow; Bennett,8,0,32,24
1657660973841,MATH 142A,B04,093558,Chow; Bennett,13,0,32,19
1657660973841,MATH 142A,B05,093559,Chow; Bennett,6,0,32,26
1657660979875,MATH 193A,A01,083224,Rotar; Vladimir,8,0,34,26
1657660979875,MATH 193A,A02,083225,Rotar; Vladimir,9,0,34,25
1657660979875,MATH 193A,A03,083781,Rotar; Vladimir,5,0,34,29
1657660979875,MATH 193A,A04,083782,Rotar; Vladimir,10,0,34,24
1657660979875,MATH 193A,A05,093482,Rotar; Vladimir,10,0,34,24
1657660985903,MATH 197,001,091859,McAuley; Julian John,9999,0,9999,0
1657660985903,MATH 197,002,095566,Kedlaya; Kiran S.,9997,0,9999,2
1657660985903,MATH 197,003,095567,Xiao; Ming,9999,0,9999,0
1657660985903,MATH 197,004,095571,Perols; Johan Lars,9998,0,9999,1
1657660992966,COGS 9,A01,083615,Shannon; Kyle Michael,9,0,75,66
1657660998989,COGS 11,A01,083617,Boyle; Mary E. T.,23,0,48,25
1657661005015,COGS 13,A01,083071,Bastos; Amalia Pinkusfeld,11,0,71,60
1657661011037,COGS 14A,A01,092681,Semenuks; Arturs,5,1,100,95
1657661017064,COGS 14B,A01,083073,Cheng; Tzu-Han,6,0,63,57
1657661023087,COGS 17,A01,092677,Semenuks; Arturs,6,0,81,75
1657661029119,COGS 100,A01,083619,Allen; Michael Gordon,17,0,70,53
1657661035149,COGS 101A,A01,083621,Davis; Joshua Daniel,9,0,68,59
1657661041172,COGS 101B,A01,091572,Allen; Michael Gordon,12,0,65,53
1657661047194,COGS 101C,A01,083625,Delgado; Tania,17,0,35,18
1657661053220,COGS 107A,A01,083627,Boyle; Mary E. T.,13,0,60,47
1657661059247,COGS 118A,A01,083075,Gupta; Anjum,21,0,76,55
1657661065271,CSE 3,A50,083646,Miranda; Gregory Joseph,24,0,50,26
1657661071304,CSE 8A,A50,083650,Miranda; Gregory Joseph,17,1,56,39
1657661077327,CSE 11,A01,083080,Cao; Yingjun,6,15,40,34
1657661083358,CSE 12,A01,083652,Krause-Levy; Sophia Louisa,28,1,120,92
1657661089381,CSE 15L,A01,083654,Morris; Justin Loren,9,0,50,41
1657661089381,CSE 15L,A02,083655,Morris; Justin Loren,9,0,50,41
1657661095403,CSE 20,A01,083657,Tran; Khoa Dang,39,0,80,41
1657661101437,CSE 21,A01,095574,Bach; Quang Tran,22,0,48,26
1657661107461,CSE 30,A01,083084,Eldon; John,6,0,80,74
1657661107461,CSE 30,B01,095061,Bhaskar; Nishant,9,0,50,41
1657661113489,CSE 100,A01,083659,Cao; Yingjun,5,4,70,65
1657661119511,CSE 134B,A01,083661,Powell; Thomas Allan,23,0,100,77
1657661125541,CSE 140,A01,083663,Gungor; Onat,15,0,85,70
1657661131567,CSE 140L,A01,083088,Eldon; John,22,0,100,78
1657661137591,CSE 175,A01,083665,Kumar; Rakesh,3,0,25,22
1657661143616,CSE 190,A00,092507,Dubnov; Shlomo,8,0,20,12
1657661149643,ECE 45,A01,083139,Congero; Spencer William,6,0,75,69
1657661155671,ECE 65,A50,083695,Saad; Andrew S,12,0,30,18
1657661155671,ECE 65,A51,095125,Saad; Andrew S,24,0,26,2
1657661161695,ECE 109,A01,091882,Touri; Behrouz,20,0,70,50
1657661167724,ECE 180,A00,083140,Abi Samra; Nicholas Camill,1,0,30,29
1657661167724,ECE 180,B00,083141,Abi Samra; Nicholas Camill,0,0,30,30
1657661173745,MATH 10A,A01,083735,Patchell; Gregory David,2,0,30,28
1657661173745,MATH 10A,A02,083736,Patchell; Gregory David,20,0,30,10
1657661173745,MATH 10A,A03,083737,Patchell; Gregory David,16,0,30,14
1657661179784,MATH 10B,A01,083207,Lim; Seonhee,8,0,34,26
1657661179784,MATH 10B,A02,083208,Lim; Seonhee,9,0,35,26
1657661179784,MATH 10B,A03,093472,Lim; Seonhee,7,0,34,27
1657661179784,MATH 10B,B01,083739,Sinha; Shubham,13,0,30,17
1657661185814,MATH 18,A01,083743,Cinel; Cameron Alexander,8,0,30,22
1657661185814,MATH 18,A02,083744,Cinel; Cameron Alexander,17,0,30,13
1657661185814,MATH 18,A03,083745,Cinel; Cameron Alexander,10,0,30,20
1657661185814,MATH 18,B01,083748,Rideout; David Porter,5,0,37,32
1657661185814,MATH 18,B02,083749,Rideout; David Porter,5,0,36,31
1657661185814,MATH 18,B03,083750,Rideout; David Porter,3,0,37,34
1657661185814,MATH 18,B04,083751,Rideout; David Porter,6,0,36,30
1657661185814,MATH 18,B05,093473,Rideout; David Porter,6,0,36,30
1657661185814,MATH 18,B06,093474,Rideout; David Porter,6,0,36,30
1657661191837,MATH 20A,A01,083754,Zheng; Zequn,14,0,40,26
1657661197864,MATH 20B,A01,083756,Briones; Jor-el Thomas Caparas,4,0,36,32
1657661197864,MATH 20B,A02,083757,Briones; Jor-el Thomas Caparas,1,0,36,35
1657661197864,MATH 20B,A03,093475,Briones; Jor-el Thomas Caparas,2,0,36,34
1657661203892,MATH 20C,A01,083760,Briones; Jor-el Thomas Caparas,1,0,35,34
1657661203892,MATH 20C,A02,083761,Briones; Jor-el Thomas Caparas,8,0,35,27
1657661203892,MATH 20C,A03,093476,Briones; Jor-el Thomas Caparas,0,1,36,36
1657661203892,MATH 20C,B01,083762,Bach; Quang Tran,1,0,30,29
1657661209916,MATH 20D,A01,083765,Tran; Brian Kha,5,0,30,25
1657661209916,MATH 20D,A02,083766,Tran; Brian Kha,5,0,30,25
1657661209916,MATH 20D,A03,083767,Tran; Brian Kha,5,0,30,25
1657661215946,MATH 20E,A01,083771,Ganguly; Soumya,9,0,32,23
1657661215946,MATH 20E,A02,083772,Ganguly; Soumya,6,0,32,26
1657661215946,MATH 20E,B01,083773,Ciotti; Benjamin,20,0,35,15
1657661215946,MATH 20E,B02,083774,Ciotti; Benjamin,18,0,35,17
1657661221975,MATH 103A,A01,083777,Greenfeld; Be'Eri,3,0,36,33
1657661221975,MATH 103A,A02,083778,Greenfeld; Be'Eri,5,0,36,31
1657661221975,MATH 103A,A03,093561,Greenfeld; Be'Eri,6,0,36,30
1657661221975,MATH 103A,B01,083779,Greenfeld; Be'Eri,7,0,36,29
1657661221975,MATH 103A,B02,083780,Greenfeld; Be'Eri,4,0,36,32
1657661221975,MATH 103A,B03,093562,Greenfeld; Be'Eri,3,0,36,33
1657661227999,MATH 105,A01,085443,Carter; Anne Toulson,15,0,35,20
1657661227999,MATH 105,A02,093477,Carter; Anne Toulson,20,0,35,15
1657661234023,MATH 109,A01,083213,Ganzberger; Geoffrey Michael,2,0,34,32
1657661234023,MATH 109,A02,083214,Ganzberger; Geoffrey Michael,4,0,34,30
1657661234023,MATH 109,A03,093478,Ganzberger; Geoffrey Michael,2,0,34,32
1657661234023,MATH 109,B01,083215,Ganzberger; Geoffrey Michael,1,0,32,31
1657661234023,MATH 109,B02,083216,Ganzberger; Geoffrey Michael,2,0,32,30
1657661234023,MATH 109,B03,093479,Ganzberger; Geoffrey Michael,8,0,32,24
1657661240052,MATH 142A,A01,083219,Chow; Bennett,7,0,32,25
1657661240052,MATH 142A,A02,083220,Chow; Bennett,10,0,32,22
1657661240052,MATH 142A,A03,093480,Chow; Bennett,9,0,32,23
1657661240052,MATH 142A,B03,093481,Chow; Bennett,8,0,32,24
1657661240052,MATH 142A,B04,093558,Chow; Bennett,13,0,32,19
1657661240052,MATH 142A,B05,093559,Chow; Bennett,6,0,32,26
1657661246081,MATH 193A,A01,083224,Rotar; Vladimir,8,0,34,26
1657661246081,MATH 193A,A02,083225,Rotar; Vladimir,9,0,34,25
1657661246081,MATH 193A,A03,083781,Rotar; Vladimir,5,0,34,29
1657661246081,MATH 193A,A04,083782,Rotar; Vladimir,10,0,34,24
1657661246081,MATH 193A,A05,093482,Rotar; Vladimir,10,0,34,24
1657661252108,MATH 197,001,091859,McAuley; Julian John,9999,0,9999,0
1657661252108,MATH 197,002,095566,Kedlaya; Kiran S.,9997,0,9999,2
1657661252108,MATH 197,003,095567,Xiao; Ming,9999,0,9999,0
1657661252108,MATH 197,004,095571,Perols; Johan Lars,9998,0,9999,1
1657661259166,COGS 9,A01,083615,Shannon; Kyle Michael,9,0,75,66
1657661265188,COGS 11,A01,083617,Boyle; Mary E. T.,23,0,48,25
1657661271211,COGS 13,A01,083071,Bastos; Amalia Pinkusfeld,11,0,71,60
1657661277240,COGS 14A,A01,092681,Semenuks; Arturs,5,1,100,95
1657661283263,COGS 14B,A01,083073,Cheng; Tzu-Han,6,0,63,57
1657661289295,COGS 17,A01,092677,Semenuks; Arturs,6,0,81,75
1657661295321,COGS 100,A01,083619,Allen; Michael Gordon,17,0,70,53
1657661301342,COGS 101A,A01,083621,Davis; Joshua Daniel,9,0,68,59
1657661307374,COGS 101B,A01,091572,Allen; Michael Gordon,12,0,65,53
1657661313398,COGS 101C,A01,083625,Delgado; Tania,17,0,35,18
1657661319434,COGS 107A,A01,083627,Boyle; Mary E. T.,13,0,60,47
1657661325470,COGS 118A,A01,083075,Gupta; Anjum,21,0,76,55
1657661331493,CSE 3,A50,083646,Miranda; Gregory Joseph,24,0,50,26
1657661337517,CSE 8A,A50,083650,Miranda; Gregory Joseph,17,1,56,39
1657661343546,CSE 11,A01,083080,Cao; Yingjun,6,15,40,34
1657661349568,CSE 12,A01,083652,Krause-Levy; Sophia Louisa,28,1,120,92
1657661355596,CSE 15L,A01,083654,Morris; Justin Loren,9,0,50,41
1657661355596,CSE 15L,A02,083655,Morris; Justin Loren,9,0,50,41
1657661361620,CSE 20,A01,083657,Tran; Khoa Dang,39,0,80,41
1657661367649,CSE 21,A01,095574,Bach; Quang Tran,22,0,48,26
1657661373674,CSE 30,A01,083084,Eldon; John,6,0,80,74
1657661373674,CSE 30,B01,095061,Bhaskar; Nishant,9,0,50,41
1657661379704,CSE 100,A01,083659,Cao; Yingjun,5,4,70,65
1657661385729,CSE 134B,A01,083661,Powell; Thomas Allan,23,0,100,77
1657661391762,CSE 140,A01,083663,Gungor; Onat,15,0,85,70
1657661397785,CSE 140L,A01,083088,Eldon; John,22,0,100,78
1657661403811,CSE 175,A01,083665,Kumar; Rakesh,3,0,25,22
1657661409836,CSE 190,A00,092507,Dubnov; Shlomo,8,0,20,12
1657661415860,ECE 45,A01,083139,Congero; Spencer William,6,0,75,69
1657661421884,ECE 65,A50,083695,Saad; Andrew S,12,0,30,18
1657661421884,ECE 65,A51,095125,Saad; Andrew S,24,0,26,2
1657661427913,ECE 109,A01,091882,Touri; Behrouz,20,0,70,50
1657661433936,ECE 180,A00,083140,Abi Samra; Nicholas Camill,1,0,30,29
1657661433936,ECE 180,B00,083141,Abi Samra; Nicholas Camill,0,0,30,30
1657661439968,MATH 10A,A01,083735,Patchell; Gregory David,2,0,30,28
1657661439968,MATH 10A,A02,083736,Patchell; Gregory David,20,0,30,10
1657661439968,MATH 10A,A03,083737,Patchell; Gregory David,16,0,30,14
1657661445991,MATH 10B,A01,083207,Lim; Seonhee,8,0,34,26
1657661445991,MATH 10B,A02,083208,Lim; Seonhee,9,0,35,26
1657661445991,MATH 10B,A03,093472,Lim; Seonhee,7,0,34,27
1657661445991,MATH 10B,B01,083739,Sinha; Shubham,13,0,30,17
1657661452020,MATH 18,A01,083743,Cinel; Cameron Alexander,8,0,30,22
1657661452020,MATH 18,A02,083744,Cinel; Cameron Alexander,17,0,30,13
1657661452020,MATH 18,A03,083745,Cinel; Cameron Alexander,10,0,30,20
1657661452020,MATH 18,B01,083748,Rideout; David Porter,5,0,37,32
1657661452020,MATH 18,B02,083749,Rideout; David Porter,5,0,36,31
1657661452020,MATH 18,B03,083750,Rideout; David Porter,3,0,37,34
1657661452020,MATH 18,B04,083751,Rideout; David Porter,6,0,36,30
1657661452020,MATH 18,B05,093473,Rideout; David Porter,6,0,36,30
1657661452020,MATH 18,B06,093474,Rideout; David Porter,6,0,36,30
1657661458043,MATH 20A,A01,083754,Zheng; Zequn,14,0,40,26
1657661464066,MATH 20B,A01,083756,Briones; Jor-el Thomas Caparas,4,0,36,32
1657661464066,MATH 20B,A02,083757,Briones; Jor-el Thomas Caparas,1,0,36,35
1657661464066,MATH 20B,A03,093475,Briones; Jor-el Thomas Caparas,2,0,36,34
1657661470108,MATH 20C,A01,083760,Briones; Jor-el Thomas Caparas,1,0,35,34
1657661470108,MATH 20C,A02,083761,Briones; Jor-el Thomas Caparas,8,0,35,27
1657661470108,MATH 20C,A03,093476,Briones; Jor-el Thomas Caparas,0,1,36,36
1657661470108,MATH 20C,B01,083762,Bach; Quang Tran,1,0,30,29
1657661476150,MATH 20D,A01,083765,Tran; Brian Kha,5,0,30,25
1657661476150,MATH 20D,A02,083766,Tran; Brian Kha,5,0,30,25
1657661476150,MATH 20D,A03,083767,Tran; Brian Kha,5,0,30,25
1657661482251,MATH 20E,A01,083771,Ganguly; Soumya,9,0,32,23
1657661482251,MATH 20E,A02,083772,Ganguly; Soumya,6,0,32,26
1657661482251,MATH 20E,B01,083773,Ciotti; Benjamin,20,0,35,15
1657661482251,MATH 20E,B02,083774,Ciotti; Benjamin,18,0,35,17
1657661488279,MATH 103A,A01,083777,Greenfeld; Be'Eri,3,0,36,33
1657661488279,MATH 103A,A02,083778,Greenfeld; Be'Eri,5,0,36,31
1657661488279,MATH 103A,A03,093561,Greenfeld; Be'Eri,6,0,36,30
1657661488279,MATH 103A,B01,083779,Greenfeld; Be'Eri,7,0,36,29
1657661488279,MATH 103A,B02,083780,Greenfeld; Be'Eri,4,0,36,32
1657661488279,MATH 103A,B03,093562,Greenfeld; Be'Eri,3,0,36,33
1657661494311,MATH 105,A01,085443,Carter; Anne Toulson,15,0,35,20
1657661494311,MATH 105,A02,093477,Carter; Anne Toulson,20,0,35,15
1657661500346,MATH 109,A01,083213,Ganzberger; Geoffrey Michael,2,0,34,32
1657661500346,MATH 109,A02,083214,Ganzberger; Geoffrey Michael,4,0,34,30
1657661500346,MATH 109,A03,093478,Ganzberger; Geoffrey Michael,2,0,34,32
1657661500346,MATH 109,B01,083215,Ganzberger; Geoffrey Michael,1,0,32,31
1657661500346,MATH 109,B02,083216,Ganzberger; Geoffrey Michael,2,0,32,30
1657661500346,MATH 109,B03,093479,Ganzberger; Geoffrey Michael,8,0,32,24
1657661506370,MATH 142A,A01,083219,Chow; Bennett,7,0,32,25
1657661506370,MATH 142A,A02,083220,Chow; Bennett,10,0,32,22
1657661506370,MATH 142A,A03,093480,Chow; Bennett,9,0,32,23
1657661506370,MATH 142A,B03,093481,Chow; Bennett,8,0,32,24
1657661506370,MATH 142A,B04,093558,Chow; Bennett,13,0,32,19
1657661506370,MATH 142A,B05,093559,Chow; Bennett,6,0,32,26
1657661512395,MATH 193A,A01,083224,Rotar; Vladimir,8,0,34,26
1657661512395,MATH 193A,A02,083225,Rotar; Vladimir,9,0,34,25
1657661512395,MATH 193A,A03,083781,Rotar; Vladimir,5,0,34,29
1657661512395,MATH 193A,A04,083782,Rotar; Vladimir,10,0,34,24
1657661512395,MATH 193A,A05,093482,Rotar; Vladimir,10,0,34,24
1657661518423,MATH 197,001,091859,McAuley; Julian John,9999,0,9999,0
1657661518423,MATH 197,002,095566,Kedlaya; Kiran S.,9997,0,9999,2
1657661518423,MATH 197,003,095567,Xiao; Ming,9999,0,9999,0
1657661518423,MATH 197,004,095571,Perols; Johan Lars,9998,0,9999,1
1657661525487,COGS 9,A01,083615,Shannon; Kyle Michael,9,0,75,66
1657661531510,COGS 11,A01,083617,Boyle; Mary E. T.,23,0,48,25
1657661537534,COGS 13,A01,083071,Bastos; Amalia Pinkusfeld,11,0,71,60
1657661543558,COGS 14A,A01,092681,Semenuks; Arturs,5,1,100,95
1657661549580,COGS 14B,A01,083073,Cheng; Tzu-Han,6,0,63,57
1657661555607,COGS 17,A01,092677,Semenuks; Arturs,6,0,81,75
1657661561630,COGS 100,A01,083619,Allen; Michael Gordon,17,0,70,53
1657661567654,COGS 101A,A01,083621,Davis; Joshua Daniel,9,0,68,59
1657661573690,COGS 101B,A01,091572,Allen; Michael Gordon,12,0,65,53
1657661579720,COGS 101C,A01,083625,Delgado; Tania,17,0,35,18
1657661585750,COGS 107A,A01,083627,Boyle; Mary E. T.,13,0,60,47
1657661591781,COGS 118A,A01,083075,Gupta; Anjum,21,0,76,55
1657661597811,CSE 3,A50,083646,Miranda; Gregory Joseph,24,0,50,26
1657661603839,CSE 8A,A50,083650,Miranda; Gregory Joseph,17,1,56,39
1657661609864,CSE 11,A01,083080,Cao; Yingjun,6,15,40,34
1657661615886,CSE 12,A01,083652,Krause-Levy; Sophia Louisa,28,1,120,92
1657661621912,CSE 15L,A01,083654,Morris; Justin Loren,9,0,50,41
1657661621912,CSE 15L,A02,083655,Morris; Justin Loren,9,0,50,41
1657661627935,CSE 20,A01,083657,Tran; Khoa Dang,39,0,80,41
1657661633963,CSE 21,A01,095574,Bach; Quang Tran,22,0,48,26
1657661640003,CSE 30,A01,083084,Eldon; John,6,0,80,74
1657661640003,CSE 30,B01,095061,Bhaskar; Nishant,9,0,50,41
1657661646026,CSE 100,A01,083659,Cao; Yingjun,5,4,70,65
1657661652050,CSE 134B,A01,083661,Powell; Thomas Allan,23,0,100,77
1657661658078,CSE 140,A01,083663,Gungor; Onat,15,0,85,70
1657661664103,CSE 140L,A01,083088,Eldon; John,22,0,100,78
1657661670126,CSE 175,A01,083665,Kumar; Rakesh,3,0,25,22
1657661676160,CSE 190,A00,092507,Dubnov; Shlomo,8,0,20,12
1657661682184,ECE 45,A01,083139,Congero; Spencer William,6,0,75,69
1657661688212,ECE 65,A50,083695,Saad; Andrew S,12,0,30,18
1657661688212,ECE 65,A51,095125,Saad; Andrew S,24,0,26,2
1657661694234,ECE 109,A01,091882,Touri; Behrouz,20,0,70,50
1657661700257,ECE 180,A00,083140,Abi Samra; Nicholas Camill,1,0,30,29
1657661700257,ECE 180,B00,083141,Abi Samra; Nicholas Camill,0,0,30,30
1657661706294,MATH 10A,A01,083735,Patchell; Gregory David,2,0,30,28
1657661706294,MATH 10A,A02,083736,Patchell; Gregory David,20,0,30,10
1657661706294,MATH 10A,A03,083737,Patchell; Gregory David,16,0,30,14
1657661712320,MATH 10B,A01,083207,Lim; Seonhee,8,0,34,26
1657661712320,MATH 10B,A02,083208,Lim; Seonhee,9,0,35,26
1657661712320,MATH 10B,A03,093472,Lim; Seonhee,7,0,34,27
1657661712320,MATH 10B,B01,083739,Sinha; Shubham,13,0,30,17
1657661718345,MATH 18,A01,083743,Cinel; Cameron Alexander,8,0,30,22
1657661718345,MATH 18,A02,083744,Cinel; Cameron Alexander,17,0,30,13
1657661718345,MATH 18,A03,083745,Cinel; Cameron Alexander,10,0,30,20
1657661718345,MATH 18,B01,083748,Rideout; David Porter,5,0,37,32
1657661718345,MATH 18,B02,083749,Rideout; David Porter,5,0,36,31
1657661718345,MATH 18,B03,083750,Rideout; David Porter,3,0,37,34
1657661718345,MATH 18,B04,083751,Rideout; David Porter,6,0,36,30
1657661718345,MATH 18,B05,093473,Rideout; David Porter,6,0,36,30
1657661718345,MATH 18,B06,093474,Rideout; David Porter,6,0,36,30
1657661724372,MATH 20A,A01,083754,Zheng; Zequn,14,0,40,26
1657661730397,MATH 20B,A01,083756,Briones; Jor-el Thomas Caparas,4,0,36,32
1657661730397,MATH 20B,A02,083757,Briones; Jor-el Thomas Caparas,1,0,36,35
1657661730397,MATH 20B,A03,093475,Briones; Jor-el Thomas Caparas,2,0,36,34
1657661736430,MATH 20C,A01,083760,Briones; Jor-el Thomas Caparas,1,0,35,34
1657661736430,MATH 20C,A02,083761,Briones; Jor-el Thomas Caparas,8,0,35,27
1657661736430,MATH 20C,A03,093476,Briones; Jor-el Thomas Caparas,0,1,36,36
1657661736430,MATH 20C,B01,083762,Bach; Quang Tran,1,0,30,29
1657661742459,MATH 20D,A01,083765,Tran; Brian Kha,5,0,30,25
1657661742459,MATH 20D,A02,083766,Tran; Brian Kha,5,0,30,25
1657661742459,MATH 20D,A03,083767,Tran; Brian Kha,5,0,30,25
1657661748484,MATH 20E,A01,083771,Ganguly; Soumya,9,0,32,23
1657661748484,MATH 20E,A02,083772,Ganguly; Soumya,6,0,32,26
1657661748484,MATH 20E,B01,083773,Ciotti; Benjamin,20,0,35,15
1657661748484,MATH 20E,B02,083774,Ciotti; Benjamin,18,0,35,17
1657661754514,MATH 103A,A01,083777,Greenfeld; Be'Eri,3,0,36,33
1657661754514,MATH 103A,A02,083778,Greenfeld; Be'Eri,5,0,36,31
1657661754514,MATH 103A,A03,093561,Greenfeld; Be'Eri,6,0,36,30
1657661754514,MATH 103A,B01,083779,Greenfeld; Be'Eri,7,0,36,29
1657661754514,MATH 103A,B02,083780,Greenfeld; Be'Eri,4,0,36,32
1657661754514,MATH 103A,B03,093562,Greenfeld; Be'Eri,3,0,36,33
1657661760539,MATH 105,A01,085443,Carter; Anne Toulson,15,0,35,20
1657661760539,MATH 105,A02,093477,Carter; Anne Toulson,20,0,35,15
1657661766641,MATH 109,A01,083213,Ganzberger; Geoffrey Michael,2,0,34,32
1657661766641,MATH 109,A02,083214,Ganzberger; Geoffrey Michael,4,0,34,30
1657661766641,MATH 109,A03,093478,Ganzberger; Geoffrey Michael,2,0,34,32
1657661766641,MATH 109,B01,083215,Ganzberger; Geoffrey Michael,1,0,32,31
1657661766641,MATH 109,B02,083216,Ganzberger; Geoffrey Michael,2,0,32,30
1657661766641,MATH 109,B03,093479,Ganzberger; Geoffrey Michael,8,0,32,24
1657661772670,MATH 142A,A01,083219,Chow; Bennett,7,0,32,25
1657661772670,MATH 142A,A02,083220,Chow; Bennett,10,0,32,22
1657661772670,MATH 142A,A03,093480,Chow; Bennett,9,0,32,23
1657661772670,MATH 142A,B03,093481,Chow; Bennett,8,0,32,24
1657661772670,MATH 142A,B04,093558,Chow; Bennett,13,0,32,19
1657661772670,MATH 142A,B05,093559,Chow; Bennett,6,0,32,26
1657661778703,MATH 193A,A01,083224,Rotar; Vladimir,8,0,34,26
1657661778703,MATH 193A,A02,083225,Rotar; Vladimir,9,0,34,25
1657661778703,MATH 193A,A03,083781,Rotar; Vladimir,5,0,34,29
1657661778703,MATH 193A,A04,083782,Rotar; Vladimir,10,0,34,24
1657661778703,MATH 193A,A05,093482,Rotar; Vladimir,10,0,34,24
1657661784733,MATH 197,001,091859,McAuley; Julian John,9999,0,9999,0
1657661784733,MATH 197,002,095566,Kedlaya; Kiran S.,9997,0,9999,2
1657661784733,MATH 197,003,095567,Xiao; Ming,9999,0,9999,0
1657661784733,MATH 197,004,095571,Perols; Johan Lars,9998,0,9999,1
1657661791820,COGS 9,A01,083615,Shannon; Kyle Michael,9,0,75,66
1657661797842,COGS 11,A01,083617,Boyle; Mary E. T.,23,0,48,25
1657661803866,COGS 13,A01,083071,Bastos; Amalia Pinkusfeld,11,0,71,60
1657661809890,COGS 14A,A01,092681,Semenuks; Arturs,5,1,100,95
1657661815917,COGS 14B,A01,083073,Cheng; Tzu-Han,6,0,63,57
1657661821951,COGS 17,A01,092677,Semenuks; Arturs,6,0,81,75
1657661827984,COGS 100,A01,083619,Allen; Michael Gordon,17,0,70,53
1657661834011,COGS 101A,A01,083621,Davis; Joshua Daniel,9,0,68,59
1657661840037,COGS 101B,A01,091572,Allen; Michael Gordon,12,0,65,53
1657661846063,COGS 101C,A01,083625,Delgado; Tania,17,0,35,18
1657661852097,COGS 107A,A01,083627,Boyle; Mary E. T.,13,0,60,47
1657661858120,COGS 118A,A01,083075,Gupta; Anjum,21,0,76,55
1657661864148,CSE 3,A50,083646,Miranda; Gregory Joseph,24,0,50,26
1657661870170,CSE 8A,A50,083650,Miranda; Gregory Joseph,17,1,56,39
1657661876196,CSE 11,A01,083080,Cao; Yingjun,6,15,40,34
1657661882218,CSE 12,A01,083652,Krause-Levy; Sophia Louisa,28,1,120,92
1657661888248,CSE 15L,A01,083654,Morris; Justin Loren,9,0,50,41
1657661888248,CSE 15L,A02,083655,Morris; Justin Loren,9,0,50,41
1657661894281,CSE 20,A01,083657,Tran; Khoa Dang,39,0,80,41
1657661900307,CSE 21,A01,095574,Bach; Quang Tran,22,0,48,26
1657661906331,CSE 30,A01,083084,Eldon; John,6,0,80,74
1657661906331,CSE 30,B01,095061,Bhaskar; Nishant,9,0,50,41
1657661912353,CSE 100,A01,083659,Cao; Yingjun,5,4,70,65
1657661918376,CSE 134B,A01,083661,Powell; Thomas Allan,23,0,100,77
1657661924403,CSE 140,A01,083663,Gungor; Onat,15,0,85,70
1657661930437,CSE 140L,A01,083088,Eldon; John,22,0,100,78
1657661936460,CSE 175,A01,083665,Kumar; Rakesh,3,0,25,22
1657661942483,CSE 190,A00,092507,Dubnov; Shlomo,8,0,20,12
1657661948506,ECE 45,A01,083139,Congero; Spencer William,6,0,75,69
1657661954531,ECE 65,A50,083695,Saad; Andrew S,12,0,30,18
1657661954531,ECE 65,A51,095125,Saad; Andrew S,24,0,26,2
1657661960553,ECE 109,A01,091882,Touri; Behrouz,20,0,70,50
1657661966575,ECE 180,A00,083140,Abi Samra; Nicholas Camill,1,0,30,29
1657661966575,ECE 180,B00,083141,Abi Samra; Nicholas Camill,0,0,30,30
1657661972611,MATH 10A,A01,083735,Patchell; Gregory David,2,0,30,28
1657661972611,MATH 10A,A02,083736,Patchell; Gregory David,20,0,30,10
1657661972611,MATH 10A,A03,083737,Patchell; Gregory David,16,0,30,14
1657661978640,MATH 10B,A01,083207,Lim; Seonhee,8,0,34,26
1657661978640,MATH 10B,A02,083208,Lim; Seonhee,9,0,35,26
1657661978640,MATH 10B,A03,093472,Lim; Seonhee,7,0,34,27
1657661978640,MATH 10B,B01,083739,Sinha; Shubham,13,0,30,17
1657661984671,MATH 18,A01,083743,Cinel; Cameron Alexander,8,0,30,22
1657661984671,MATH 18,A02,083744,Cinel; Cameron Alexander,17,0,30,13
1657661984671,MATH 18,A03,083745,Cinel; Cameron Alexander,10,0,30,20
1657661984671,MATH 18,B01,083748,Rideout; David Porter,5,0,37,32
1657661984671,MATH 18,B02,083749,Rideout; David Porter,5,0,36,31
1657661984671,MATH 18,B03,083750,Rideout; David Porter,3,0,37,34
1657661984671,MATH 18,B04,083751,Rideout; David Porter,6,0,36,30
1657661984671,MATH 18,B05,093473,Rideout; David Porter,6,0,36,30
1657661984671,MATH 18,B06,093474,Rideout; David Porter,6,0,36,30
1657661990700,MATH 20A,A01,083754,Zheng; Zequn,14,0,40,26
1657661996723,MATH 20B,A01,083756,Briones; Jor-el Thomas Caparas,4,0,36,32
1657661996723,MATH 20B,A02,083757,Briones; Jor-el Thomas Caparas,1,0,36,35
1657661996723,MATH 20B,A03,093475,Briones; Jor-el Thomas Caparas,2,0,36,34
1657662002750,MATH 20C,A01,083760,Briones; Jor-el Thomas Caparas,1,0,35,34
1657662002750,MATH 20C,A02,083761,Briones; Jor-el Thomas Caparas,8,0,35,27
1657662002750,MATH 20C,A03,093476,Briones; Jor-el Thomas Caparas,0,1,36,36
1657662002750,MATH 20C,B01,083762,Bach; Quang Tran,1,0,30,29
1657662008779,MATH 20D,A01,083765,Tran; Brian Kha,5,0,30,25
1657662008779,MATH 20D,A02,083766,Tran; Brian Kha,5,0,30,25
1657662008779,MATH 20D,A03,083767,Tran; Brian Kha,5,0,30,25
1657662014814,MATH 20E,A01,083771,Ganguly; Soumya,9,0,32,23
1657662014814,MATH 20E,A02,083772,Ganguly; Soumya,6,0,32,26
1657662014814,MATH 20E,B01,083773,Ciotti; Benjamin,20,0,35,15
1657662014814,MATH 20E,B02,083774,Ciotti; Benjamin,18,0,35,17
1657662020841,MATH 103A,A01,083777,Greenfeld; Be'Eri,3,0,36,33
1657662020841,MATH 103A,A02,083778,Greenfeld; Be'Eri,5,0,36,31
1657662020841,MATH 103A,A03,093561,Greenfeld; Be'Eri,6,0,36,30
1657662020841,MATH 103A,B01,083779,Greenfeld; Be'Eri,7,0,36,29
1657662020841,MATH 103A,B02,083780,Greenfeld; Be'Eri,4,0,36,32
1657662020841,MATH 103A,B03,093562,Greenfeld; Be'Eri,3,0,36,33
1657662026865,MATH 105,A01,085443,Carter; Anne Toulson,15,0,35,20
1657662026865,MATH 105,A02,093477,Carter; Anne Toulson,20,0,35,15
1657662032887,MATH 109,A01,083213,Ganzberger; Geoffrey Michael,2,0,34,32
1657662032887,MATH 109,A02,083214,Ganzberger; Geoffrey Michael,4,0,34,30
1657662032887,MATH 109,A03,093478,Ganzberger; Geoffrey Michael,2,0,34,32
1657662032887,MATH 109,B01,083215,Ganzberger; Geoffrey Michael,1,0,32,31
1657662032887,MATH 109,B02,083216,Ganzberger; Geoffrey Michael,2,0,32,30
1657662032887,MATH 109,B03,093479,Ganzberger; Geoffrey Michael,8,0,32,24
1657662038917,MATH 142A,A01,083219,Chow; Bennett,7,0,32,25
1657662038917,MATH 142A,A02,083220,Chow; Bennett,10,0,32,22
1657662038917,MATH 142A,A03,093480,Chow; Bennett,9,0,32,23
1657662038917,MATH 142A,B03,093481,Chow; Bennett,8,0,32,24
1657662038917,MATH 142A,B04,093558,Chow; Bennett,13,0,32,19
1657662038917,MATH 142A,B05,093559,Chow; Bennett,6,0,32,26
1657662044939,MATH 193A,A01,083224,Rotar; Vladimir,8,0,34,26
1657662044939,MATH 193A,A02,083225,Rotar; Vladimir,9,0,34,25
1657662044939,MATH 193A,A03,083781,Rotar; Vladimir,5,0,34,29
1657662044939,MATH 193A,A04,083782,Rotar; Vladimir,10,0,34,24
1657662044939,MATH 193A,A05,093482,Rotar; Vladimir,10,0,34,24
1657662050967,MATH 197,001,091859,McAuley; Julian John,9999,0,9999,0
1657662050967,MATH 197,002,095566,Kedlaya; Kiran S.,9997,0,9999,2
1657662050967,MATH 197,003,095567,Xiao; Ming,9999,0,9999,0
1657662050967,MATH 197,004,095571,Perols; Johan Lars,9998,0,9999,1
1657662058034,COGS 9,A01,083615,Shannon; Kyle Michael,9,0,75,66
1657662064062,COGS 11,A01,083617,Boyle; Mary E. T.,23,0,48,25
1657662070090,COGS 13,A01,083071,Bastos; Amalia Pinkusfeld,11,0,71,60
1657662076202,COGS 14A,A01,092681,Semenuks; Arturs,5,1,100,95
1657662082230,COGS 14B,A01,083073,Cheng; Tzu-Han,6,0,63,57
1657662088286,COGS 17,A01,092677,Semenuks; Arturs,6,0,81,75
1657662094309,COGS 100,A01,083619,Allen; Michael Gordon,17,0,70,53
1657662100332,COGS 101A,A01,083621,Davis; Joshua Daniel,9,0,68,59
1657662106359,COGS 101B,A01,091572,Allen; Michael Gordon,12,0,65,53
1657662112386,COGS 101C,A01,083625,Delgado; Tania,17,0,35,18
1657662118417,COGS 107A,A01,083627,Boyle; Mary E. T.,13,0,60,47
1657662124447,COGS 118A,A01,083075,Gupta; Anjum,21,0,76,55
1657662130475,CSE 3,A50,083646,Miranda; Gregory Joseph,24,0,50,26
1657662136504,CSE 8A,A50,083650,Miranda; Gregory Joseph,17,1,56,39
1657662142526,CSE 11,A01,083080,Cao; Yingjun,6,15,40,34
1657662148548,CSE 12,A01,083652,Krause-Levy; Sophia Louisa,28,1,120,92
1657662154570,CSE 15L,A01,083654,Morris; Justin Loren,9,0,50,41
1657662154570,CSE 15L,A02,083655,Morris; Justin Loren,9,0,50,41
1657662160595,CSE 20,A01,083657,Tran; Khoa Dang,39,0,80,41
1657662166618,CSE 21,A01,095574,Bach; Quang Tran,22,0,48,26
1657662172639,CSE 30,A01,083084,Eldon; John,6,0,80,74
1657662172639,CSE 30,B01,095061,Bhaskar; Nishant,9,0,50,41
1657662178661,CSE 100,A01,083659,Cao; Yingjun,5,4,70,65
1657662184685,CSE 134B,A01,083661,Powell; Thomas Allan,23,0,100,77
1657662190711,CSE 140,A01,083663,Gungor; Onat,15,0,85,70
1657662196732,CSE 140L,A01,083088,Eldon; John,22,0,100,78
1657662202754,CSE 175,A01,083665,Kumar; Rakesh,3,0,25,22
1657662208776,CSE 190,A00,092507,Dubnov; Shlomo,8,0,20,12
1657662214800,ECE 45,A01,083139,Congero; Spencer William,6,0,75,69
1657662220822,ECE 65,A50,083695,Saad; Andrew S,12,0,30,18
1657662220822,ECE 65,A51,095125,Saad; Andrew S,24,0,26,2
1657662226845,ECE 109,A01,091882,Touri; Behrouz,20,0,70,50
1657662232867,ECE 180,A00,083140,Abi Samra; Nicholas Camill,1,0,30,29
1657662232867,ECE 180,B00,083141,Abi Samra; Nicholas Camill,0,0,30,30
1657662238892,MATH 10A,A01,083735,Patchell; Gregory David,2,0,30,28
1657662238892,MATH 10A,A02,083736,Patchell; Gregory David,20,0,30,10
1657662238892,MATH 10A,A03,083737,Patchell; Gregory David,16,0,30,14
1657662244917,MATH 10B,A01,083207,Lim; Seonhee,8,0,34,26
1657662244917,MATH 10B,A02,083208,Lim; Seonhee,9,0,35,26
1657662244917,MATH 10B,A03,093472,Lim; Seonhee,7,0,34,27
1657662244917,MATH 10B,B01,083739,Sinha; Shubham,13,0,30,17
1657662250946,MATH 18,A01,083743,Cinel; Cameron Alexander,8,0,30,22
1657662250946,MATH 18,A02,083744,Cinel; Cameron Alexander,17,0,30,13
1657662250946,MATH 18,A03,083745,Cinel; Cameron Alexander,10,0,30,20
1657662250946,MATH 18,B01,083748,Rideout; David Porter,5,0,37,32
1657662250946,MATH 18,B02,083749,Rideout; David Porter,5,0,36,31
1657662250946,MATH 18,B03,083750,Rideout; David Porter,3,0,37,34
1657662250946,MATH 18,B04,083751,Rideout; David Porter,6,0,36,30
1657662250946,MATH 18,B05,093473,Rideout; David Porter,6,0,36,30
1657662250946,MATH 18,B06,093474,Rideout; David Porter,6,0,36,30
1657662256968,MATH 20A,A01,083754,Zheng; Zequn,14,0,40,26
1657662262997,MATH 20B,A01,083756,Briones; Jor-el Thomas Caparas,4,0,36,32
1657662262997,MATH 20B,A02,083757,Briones; Jor-el Thomas Caparas,1,0,36,35
1657662262997,MATH 20B,A03,093475,Briones; Jor-el Thomas Caparas,2,0,36,34
1657662269020,MATH 20C,A01,083760,Briones; Jor-el Thomas Caparas,1,0,35,34
1657662269020,MATH 20C,A02,083761,Briones; Jor-el Thomas Caparas,8,0,35,27
1657662269020,MATH 20C,A03,093476,Briones; Jor-el Thomas Caparas,0,1,36,36
1657662269020,MATH 20C,B01,083762,Bach; Quang Tran,1,0,30,29
1657662275044,MATH 20D,A01,083765,Tran; Brian Kha,5,0,30,25
1657662275044,MATH 20D,A02,083766,Tran; Brian Kha,5,0,30,25
1657662275044,MATH 20D,A03,083767,Tran; Brian Kha,5,0,30,25
1657662281081,MATH 20E,A01,083771,Ganguly; Soumya,9,0,32,23
1657662281081,MATH 20E,A02,083772,Ganguly; Soumya,6,0,32,26
1657662281081,MATH 20E,B01,083773,Ciotti; Benjamin,20,0,35,15
1657662281081,MATH 20E,B02,083774,Ciotti; Benjamin,18,0,35,17
1657662287110,MATH 103A,A01,083777,Greenfeld; Be'Eri,3,0,36,33
1657662287110,MATH 103A,A02,083778,Greenfeld; Be'Eri,5,0,36,31
1657662287110,MATH 103A,A03,093561,Greenfeld; Be'Eri,6,0,36,30
1657662287110,MATH 103A,B01,083779,Greenfeld; Be'Eri,7,0,36,29
1657662287110,MATH 103A,B02,083780,Greenfeld; Be'Eri,4,0,36,32
1657662287110,MATH 103A,B03,093562,Greenfeld; Be'Eri,3,0,36,33
1657662293134,MATH 105,A01,085443,Carter; Anne Toulson,15,0,35,20
1657662293134,MATH 105,A02,093477,Carter; Anne Toulson,20,0,35,15
1657662299178,MATH 109,A01,083213,Ganzberger; Geoffrey Michael,2,0,34,32
1657662299178,MATH 109,A02,083214,Ganzberger; Geoffrey Michael,4,0,34,30
1657662299178,MATH 109,A03,093478,Ganzberger; Geoffrey Michael,2,0,34,32
1657662299178,MATH 109,B01,083215,Ganzberger; Geoffrey Michael,1,0,32,31
1657662299178,MATH 109,B02,083216,Ganzberger; Geoffrey Michael,2,0,32,30
1657662299178,MATH 109,B03,093479,Ganzberger; Geoffrey Michael,8,0,32,24
1657662305215,MATH 142A,A01,083219,Chow; Bennett,7,0,32,25
1657662305215,MATH 142A,A02,083220,Chow; Bennett,10,0,32,22
1657662305215,MATH 142A,A03,093480,Chow; Bennett,9,0,32,23
1657662305215,MATH 142A,B03,093481,Chow; Bennett,8,0,32,24
1657662305215,MATH 142A,B04,093558,Chow; Bennett,13,0,32,19
1657662305215,MATH 142A,B05,093559,Chow; Bennett,6,0,32,26
1657662311240,MATH 193A,A01,083224,Rotar; Vladimir,8,0,34,26
1657662311240,MATH 193A,A02,083225,Rotar; Vladimir,9,0,34,25
1657662311240,MATH 193A,A03,083781,Rotar; Vladimir,5,0,34,29
1657662311240,MATH 193A,A04,083782,Rotar; Vladimir,10,0,34,24
1657662311240,MATH 193A,A05,093482,Rotar; Vladimir,10,0,34,24
1657662317268,MATH 197,001,091859,McAuley; Julian John,9999,0,9999,0
1657662317268,MATH 197,002,095566,Kedlaya; Kiran S.,9997,0,9999,2
1657662317268,MATH 197,003,095567,Xiao; Ming,9999,0,9999,0
1657662317268,MATH 197,004,095571,Perols; Johan Lars,9998,0,9999,1
1657662324331,COGS 9,A01,083615,Shannon; Kyle Michael,9,0,75,66
1657662330358,COGS 11,A01,083617,Boyle; Mary E. T.,23,0,48,25
1657662336388,COGS 13,A01,083071,Bastos; Amalia Pinkusfeld,11,0,71,60
1657662342417,COGS 14A,A01,092681,Semenuks; Arturs,5,1,100,95
1657662348445,COGS 14B,A01,083073,Cheng; Tzu-Han,6,0,63,57
1657662354469,COGS 17,A01,092677,Semenuks; Arturs,6,0,81,75
1657662360493,COGS 100,A01,083619,Allen; Michael Gordon,17,0,70,53
1657662366517,COGS 101A,A01,083621,Davis; Joshua Daniel,9,0,68,59
1657662372547,COGS 101B,A01,091572,Allen; Michael Gordon,12,0,65,53
1657662378573,COGS 101C,A01,083625,Delgado; Tania,17,0,35,18
1657662384600,COGS 107A,A01,083627,Boyle; Mary E. T.,13,0,60,47
1657662390629,COGS 118A,A01,083075,Gupta; Anjum,21,0,76,55
1657662396653,CSE 3,A50,083646,Miranda; Gregory Joseph,24,0,50,26
1657662402682,CSE 8A,A50,083650,Miranda; Gregory Joseph,17,1,56,39
1657662408709,CSE 11,A01,083080,Cao; Yingjun,6,15,40,34
1657662414735,CSE 12,A01,083652,Krause-Levy; Sophia Louisa,28,1,120,92
1657662420760,CSE 15L,A01,083654,Morris; Justin Loren,9,0,50,41
1657662420760,CSE 15L,A02,083655,Morris; Justin Loren,9,0,50,41
1657662426801,CSE 20,A01,083657,Tran; Khoa Dang,39,0,80,41
1657662432830,CSE 21,A01,095574,Bach; Quang Tran,22,0,48,26
1657662438858,CSE 30,A01,083084,Eldon; John,6,0,80,74
1657662438858,CSE 30,B01,095061,Bhaskar; Nishant,9,0,50,41
1657662444882,CSE 100,A01,083659,Cao; Yingjun,5,4,70,65
1657662450909,CSE 134B,A01,083661,Powell; Thomas Allan,23,0,100,77
1657662456932,CSE 140,A01,083663,Gungor; Onat,15,0,85,70
1657662462958,CSE 140L,A01,083088,Eldon; John,22,0,100,78
1657662468982,CSE 175,A01,083665,Kumar; Rakesh,3,0,25,22
1657662475010,CSE 190,A00,092507,Dubnov; Shlomo,8,0,20,12
1657662481032,ECE 45,A01,083139,Congero; Spencer William,6,0,75,69
1657662487059,ECE 65,A50,083695,Saad; Andrew S,12,0,30,18
1657662487059,ECE 65,A51,095125,Saad; Andrew S,24,0,26,2
1657662493080,ECE 109,A01,091882,Touri; Behrouz,20,0,70,50
1657662499107,ECE 180,A00,083140,Abi Samra; Nicholas Camill,1,0,30,29
1657662499107,ECE 180,B00,083141,Abi Samra; Nicholas Camill,0,0,30,30
1657662505141,MATH 10A,A01,083735,Patchell; Gregory David,2,0,30,28
1657662505141,MATH 10A,A02,083736,Patchell; Gregory David,20,0,30,10
1657662505141,MATH 10A,A03,083737,Patchell; Gregory David,16,0,30,14
1657662511175,MATH 10B,A01,083207,Lim; Seonhee,8,0,34,26
1657662511175,MATH 10B,A02,083208,Lim; Seonhee,9,0,35,26
1657662511175,MATH 10B,A03,093472,Lim; Seonhee,7,0,34,27
1657662511175,MATH 10B,B01,083739,Sinha; Shubham,13,0,30,17
1657662517199,MATH 18,A01,083743,Cinel; Cameron Alexander,8,0,30,22
1657662517199,MATH 18,A02,083744,Cinel; Cameron Alexander,17,0,30,13
1657662517199,MATH 18,A03,083745,Cinel; Cameron Alexander,10,0,30,20
1657662517199,MATH 18,B01,083748,Rideout; David Porter,5,0,37,32
1657662517199,MATH 18,B02,083749,Rideout; David Porter,5,0,36,31
1657662517199,MATH 18,B03,083750,Rideout; David Porter,3,0,37,34
1657662517199,MATH 18,B04,083751,Rideout; David Porter,6,0,36,30
1657662517199,MATH 18,B05,093473,Rideout; David Porter,6,0,36,30
1657662517199,MATH 18,B06,093474,Rideout; David Porter,6,0,36,30
1657662523226,MATH 20A,A01,083754,Zheng; Zequn,14,0,40,26
1657662529255,MATH 20B,A01,083756,Briones; Jor-el Thomas Caparas,4,0,36,32
1657662529255,MATH 20B,A02,083757,Briones; Jor-el Thomas Caparas,1,0,36,35
1657662529255,MATH 20B,A03,093475,Briones; Jor-el Thomas Caparas,2,0,36,34
1657662535278,MATH 20C,A01,083760,Briones; Jor-el Thomas Caparas,1,0,35,34
1657662535278,MATH 20C,A02,083761,Briones; Jor-el Thomas Caparas,8,0,35,27
1657662535278,MATH 20C,A03,093476,Briones; Jor-el Thomas Caparas,0,1,36,36
1657662535278,MATH 20C,B01,083762,Bach; Quang Tran,1,0,30,29
1657662541302,MATH 20D,A01,083765,Tran; Brian Kha,5,0,30,25
1657662541302,MATH 20D,A02,083766,Tran; Brian Kha,5,0,30,25
1657662541302,MATH 20D,A03,083767,Tran; Brian Kha,5,0,30,25
1657662547327,MATH 20E,A01,083771,Ganguly; Soumya,9,0,32,23
1657662547327,MATH 20E,A02,083772,Ganguly; Soumya,6,0,32,26
1657662547327,MATH 20E,B01,083773,Ciotti; Benjamin,20,0,35,15
1657662547327,MATH 20E,B02,083774,Ciotti; Benjamin,18,0,35,17
1657662553358,MATH 103A,A01,083777,Greenfeld; Be'Eri,3,0,36,33
1657662553358,MATH 103A,A02,083778,Greenfeld; Be'Eri,5,0,36,31
1657662553358,MATH 103A,A03,093561,Greenfeld; Be'Eri,6,0,36,30
1657662553358,MATH 103A,B01,083779,Greenfeld; Be'Eri,7,0,36,29
1657662553358,MATH 103A,B02,083780,Greenfeld; Be'Eri,4,0,36,32
1657662553358,MATH 103A,B03,093562,Greenfeld; Be'Eri,3,0,36,33
1657662559381,MATH 105,A01,085443,Carter; Anne Toulson,15,0,35,20
1657662559381,MATH 105,A02,093477,Carter; Anne Toulson,20,0,35,15
1657662565411,MATH 109,A01,083213,Ganzberger; Geoffrey Michael,2,0,34,32
1657662565411,MATH 109,A02,083214,Ganzberger; Geoffrey Michael,4,0,34,30
1657662565411,MATH 109,A03,093478,Ganzberger; Geoffrey Michael,2,0,34,32
1657662565411,MATH 109,B01,083215,Ganzberger; Geoffrey Michael,1,0,32,31
1657662565411,MATH 109,B02,083216,Ganzberger; Geoffrey Michael,2,0,32,30
1657662565411,MATH 109,B03,093479,Ganzberger; Geoffrey Michael,8,0,32,24
1657662571435,MATH 142A,A01,083219,Chow; Bennett,7,0,32,25
1657662571435,MATH 142A,A02,083220,Chow; Bennett,10,0,32,22
1657662571435,MATH 142A,A03,093480,Chow; Bennett,9,0,32,23
1657662571435,MATH 142A,B03,093481,Chow; Bennett,8,0,32,24
1657662571435,MATH 142A,B04,093558,Chow; Bennett,13,0,32,19
1657662571435,MATH 142A,B05,093559,Chow; Bennett,6,0,32,26
1657662577458,MATH 193A,A01,083224,Rotar; Vladimir,8,0,34,26
1657662577458,MATH 193A,A02,083225,Rotar; Vladimir,9,0,34,25
1657662577458,MATH 193A,A03,083781,Rotar; Vladimir,5,0,34,29
1657662577458,MATH 193A,A04,083782,Rotar; Vladimir,10,0,34,24
1657662577458,MATH 193A,A05,093482,Rotar; Vladimir,10,0,34,24
1657662583481,MATH 197,001,091859,McAuley; Julian John,9999,0,9999,0
1657662583481,MATH 197,002,095566,Kedlaya; Kiran S.,9997,0,9999,2
1657662583481,MATH 197,003,095567,Xiao; Ming,9999,0,9999,0
1657662583481,MATH 197,004,095571,Perols; Johan Lars,9998,0,9999,1
1657662590536,COGS 9,A01,083615,Shannon; Kyle Michael,9,0,75,66
1657662596575,COGS 11,A01,083617,Boyle; Mary E. T.,23,0,48,25
1657662602603,COGS 13,A01,083071,Bastos; Amalia Pinkusfeld,11,0,71,60
1657662608631,COGS 14A,A01,092681,Semenuks; Arturs,5,1,100,95
1657662614660,COGS 14B,A01,083073,Cheng; Tzu-Han,6,0,63,57
1657662620691,COGS 17,A01,092677,Semenuks; Arturs,6,0,81,75
1657662626715,COGS 100,A01,083619,Allen; Michael Gordon,17,0,70,53
1657662632738,COGS 101A,A01,083621,Davis; Joshua Daniel,9,0,68,59
1657662638763,COGS 101B,A01,091572,Allen; Michael Gordon,12,0,65,53
1657662644786,COGS 101C,A01,083625,Delgado; Tania,17,0,35,18
1657662650818,COGS 107A,A01,083627,Boyle; Mary E. T.,13,0,60,47
1657662656845,COGS 118A,A01,083075,Gupta; Anjum,21,0,76,55
1657662662880,CSE 3,A50,083646,Miranda; Gregory Joseph,24,0,50,26
1657662668904,CSE 8A,A50,083650,Miranda; Gregory Joseph,17,1,56,39
1657662675015,CSE 11,A01,083080,Cao; Yingjun,6,15,40,34
1657662681038,CSE 12,A01,083652,Krause-Levy; Sophia Louisa,28,1,120,92
1657662687065,CSE 15L,A01,083654,Morris; Justin Loren,9,0,50,41
1657662687065,CSE 15L,A02,083655,Morris; Justin Loren,9,0,50,41
1657662693090,CSE 20,A01,083657,Tran; Khoa Dang,39,0,80,41
1657662699125,CSE 21,A01,095574,Bach; Quang Tran,22,0,48,26
1657662705148,CSE 30,A01,083084,Eldon; John,6,0,80,74
1657662705148,CSE 30,B01,095061,Bhaskar; Nishant,9,0,50,41
1657662711172,CSE 100,A01,083659,Cao; Yingjun,5,4,70,65
1657662717197,CSE 134B,A01,083661,Powell; Thomas Allan,23,0,100,77
1657662723219,CSE 140,A01,083663,Gungor; Onat,15,0,85,70
1657662729246,CSE 140L,A01,083088,Eldon; John,22,0,100,78
1657662735277,CSE 175,A01,083665,Kumar; Rakesh,3,0,25,22
1657662741310,CSE 190,A00,092507,Dubnov; Shlomo,8,0,20,12
1657662747349,ECE 45,A01,083139,Congero; Spencer William,6,0,75,69
1657662753374,ECE 65,A50,083695,Saad; Andrew S,12,0,30,18
1657662753374,ECE 65,A51,095125,Saad; Andrew S,24,0,26,2
1657662759400,ECE 109,A01,091882,Touri; Behrouz,20,0,70,50
1657662765424,ECE 180,A00,083140,Abi Samra; Nicholas Camill,1,0,30,29
1657662765424,ECE 180,B00,083141,Abi Samra; Nicholas Camill,0,0,30,30
1657662771447,MATH 10A,A01,083735,Patchell; Gregory David,2,0,30,28
1657662771447,MATH 10A,A02,083736,Patchell; Gregory David,20,0,30,10
1657662771447,MATH 10A,A03,083737,Patchell; Gregory David,16,0,30,14
1657662777472,MATH 10B,A01,083207,Lim; Seonhee,8,0,34,26
1657662777472,MATH 10B,A02,083208,Lim; Seonhee,9,0,35,26
1657662777472,MATH 10B,A03,093472,Lim; Seonhee,7,0,34,27
1657662777472,MATH 10B,B01,083739,Sinha; Shubham,13,0,30,17
1657662783496,MATH 18,A01,083743,Cinel; Cameron Alexander,8,0,30,22
1657662783496,MATH 18,A02,083744,Cinel; Cameron Alexander,17,0,30,13
1657662783496,MATH 18,A03,083745,Cinel; Cameron Alexander,10,0,30,20
1657662783496,MATH 18,B01,083748,Rideout; David Porter,5,0,37,32
1657662783496,MATH 18,B02,083749,Rideout; David Porter,5,0,36,31
1657662783496,MATH 18,B03,083750,Rideout; David Porter,3,0,37,34
1657662783496,MATH 18,B04,083751,Rideout; David Porter,6,0,36,30
1657662783496,MATH 18,B05,093473,Rideout; David Porter,6,0,36,30
1657662783496,MATH 18,B06,093474,Rideout; David Porter,6,0,36,30
1657662789518,MATH 20A,A01,083754,Zheng; Zequn,14,0,40,26
1657662795548,MATH 20B,A01,083756,Briones; Jor-el Thomas Caparas,4,0,36,32
1657662795548,MATH 20B,A02,083757,Briones; Jor-el Thomas Caparas,1,0,36,35
1657662795548,MATH 20B,A03,093475,Briones; Jor-el Thomas Caparas,2,0,36,34
1657662801576,MATH 20C,A01,083760,Briones; Jor-el Thomas Caparas,1,0,35,34
1657662801576,MATH 20C,A02,083761,Briones; Jor-el Thomas Caparas,8,0,35,27
1657662801576,MATH 20C,A03,093476,Briones; Jor-el Thomas Caparas,0,1,36,36
1657662801576,MATH 20C,B01,083762,Bach; Quang Tran,1,0,30,29
1657662807605,MATH 20D,A01,083765,Tran; Brian Kha,5,0,30,25
1657662807605,MATH 20D,A02,083766,Tran; Brian Kha,5,0,30,25
1657662807605,MATH 20D,A03,083767,Tran; Brian Kha,5,0,30,25
1657662813641,MATH 20E,A01,083771,Ganguly; Soumya,9,0,32,23
1657662813641,MATH 20E,A02,083772,Ganguly; Soumya,6,0,32,26
1657662813641,MATH 20E,B01,083773,Ciotti; Benjamin,20,0,35,15
1657662813641,MATH 20E,B02,083774,Ciotti; Benjamin,18,0,35,17
1657662819678,MATH 103A,A01,083777,Greenfeld; Be'Eri,3,0,36,33
1657662819678,MATH 103A,A02,083778,Greenfeld; Be'Eri,5,0,36,31
1657662819678,MATH 103A,A03,093561,Greenfeld; Be'Eri,6,0,36,30
1657662819678,MATH 103A,B01,083779,Greenfeld; Be'Eri,7,0,36,29
1657662819678,MATH 103A,B02,083780,Greenfeld; Be'Eri,4,0,36,32
1657662819678,MATH 103A,B03,093562,Greenfeld; Be'Eri,3,0,36,33
1657662825701,MATH 105,A01,085443,Carter; Anne Toulson,15,0,35,20
1657662825701,MATH 105,A02,093477,Carter; Anne Toulson,20,0,35,15
1657662831726,MATH 109,A01,083213,Ganzberger; Geoffrey Michael,2,0,34,32
1657662831726,MATH 109,A02,083214,Ganzberger; Geoffrey Michael,4,0,34,30
1657662831726,MATH 109,A03,093478,Ganzberger; Geoffrey Michael,2,0,34,32
1657662831726,MATH 109,B01,083215,Ganzberger; Geoffrey Michael,1,0,32,31
1657662831726,MATH 109,B02,083216,Ganzberger; Geoffrey Michael,2,0,32,30
1657662831726,MATH 109,B03,093479,Ganzberger; Geoffrey Michael,8,0,32,24
1657662837749,MATH 142A,A01,083219,Chow; Bennett,7,0,32,25
1657662837749,MATH 142A,A02,083220,Chow; Bennett,10,0,32,22
1657662837749,MATH 142A,A03,093480,Chow; Bennett,9,0,32,23
1657662837749,MATH 142A,B03,093481,Chow; Bennett,8,0,32,24
1657662837749,MATH 142A,B04,093558,Chow; Bennett,13,0,32,19
1657662837749,MATH 142A,B05,093559,Chow; Bennett,6,0,32,26
1657662843777,MATH 193A,A01,083224,Rotar; Vladimir,8,0,34,26
1657662843777,MATH 193A,A02,083225,Rotar; Vladimir,9,0,34,25
1657662843777,MATH 193A,A03,083781,Rotar; Vladimir,5,0,34,29
1657662843777,MATH 193A,A04,083782,Rotar; Vladimir,10,0,34,24
1657662843777,MATH 193A,A05,093482,Rotar; Vladimir,10,0,34,24
1657662849802,MATH 197,001,091859,McAuley; Julian John,9999,0,9999,0
1657662849802,MATH 197,002,095566,Kedlaya; Kiran S.,9997,0,9999,2
1657662849802,MATH 197,003,095567,Xiao; Ming,9999,0,9999,0
1657662849802,MATH 197,004,095571,Perols; Johan Lars,9998,0,9999,1
1657662856885,COGS 9,A01,083615,Shannon; Kyle Michael,9,0,75,66
1657662862915,COGS 11,A01,083617,Boyle; Mary E. T.,23,0,48,25
1657662868952,COGS 13,A01,083071,Bastos; Amalia Pinkusfeld,11,0,71,60
1657662874973,COGS 14A,A01,092681,Semenuks; Arturs,5,1,100,95
1657662880997,COGS 14B,A01,083073,Cheng; Tzu-Han,6,0,63,57
1657662887031,COGS 17,A01,092677,Semenuks; Arturs,6,0,81,75
1657662893054,COGS 100,A01,083619,Allen; Michael Gordon,17,0,70,53
1657662899077,COGS 101A,A01,083621,Davis; Joshua Daniel,9,0,68,59
1657662905100,COGS 101B,A01,091572,Allen; Michael Gordon,12,0,65,53
1657662911130,COGS 101C,A01,083625,Delgado; Tania,17,0,35,18
1657662917163,COGS 107A,A01,083627,Boyle; Mary E. T.,13,0,60,47
1657662923187,COGS 118A,A01,083075,Gupta; Anjum,21,0,76,55
1657662929215,CSE 3,A50,083646,Miranda; Gregory Joseph,24,0,50,26
1657662935239,CSE 8A,A50,083650,Miranda; Gregory Joseph,17,1,56,39
1657662941276,CSE 11,A01,083080,Cao; Yingjun,6,15,40,34
1657662947309,CSE 12,A01,083652,Krause-Levy; Sophia Louisa,28,1,120,92
1657662953345,CSE 15L,A01,083654,Morris; Justin Loren,9,0,50,41
1657662953345,CSE 15L,A02,083655,Morris; Justin Loren,9,0,50,41
1657662959366,CSE 20,A01,083657,Tran; Khoa Dang,39,0,80,41
1657662965394,CSE 21,A01,095574,Bach; Quang Tran,22,0,48,26
1657662971432,CSE 30,A01,083084,Eldon; John,6,0,80,74
1657662971432,CSE 30,B01,095061,Bhaskar; Nishant,9,0,50,41
1657662977455,CSE 100,A01,083659,Cao; Yingjun,5,4,70,65
1657662983481,CSE 134B,A01,083661,Powell; Thomas Allan,23,0,100,77
1657662989508,CSE 140,A01,083663,Gungor; Onat,15,0,85,70
1657662995559,CSE 140L,A01,083088,Eldon; John,22,0,100,78
1657663001582,CSE 175,A01,083665,Kumar; Rakesh,3,0,25,22
1657663007606,CSE 190,A00,092507,Dubnov; Shlomo,8,0,20,12
1657663013634,ECE 45,A01,083139,Congero; Spencer William,6,0,75,69
1657663019656,ECE 65,A50,083695,Saad; Andrew S,12,0,30,18
1657663019656,ECE 65,A51,095125,Saad; Andrew S,24,0,26,2
1657663025679,ECE 109,A01,091882,Touri; Behrouz,20,0,70,50
1657663031704,ECE 180,A00,083140,Abi Samra; Nicholas Camill,1,0,30,29
1657663031704,ECE 180,B00,083141,Abi Samra; Nicholas Camill,0,0,30,30
1657663037725,MATH 10A,A01,083735,Patchell; Gregory David,2,0,30,28
1657663037725,MATH 10A,A02,083736,Patchell; Gregory David,20,0,30,10
1657663037725,MATH 10A,A03,083737,Patchell; Gregory David,16,0,30,14
1657663043753,MATH 10B,A01,083207,Lim; Seonhee,8,0,34,26
1657663043753,MATH 10B,A02,083208,Lim; Seonhee,9,0,35,26
1657663043753,MATH 10B,A03,093472,Lim; Seonhee,7,0,34,27
1657663043753,MATH 10B,B01,083739,Sinha; Shubham,13,0,30,17
1657663049785,MATH 18,A01,083743,Cinel; Cameron Alexander,8,0,30,22
1657663049785,MATH 18,A02,083744,Cinel; Cameron Alexander,17,0,30,13
1657663049785,MATH 18,A03,083745,Cinel; Cameron Alexander,10,0,30,20
1657663049785,MATH 18,B01,083748,Rideout; David Porter,5,0,37,32
1657663049785,MATH 18,B02,083749,Rideout; David Porter,5,0,36,31
1657663049785,MATH 18,B03,083750,Rideout; David Porter,3,0,37,34
1657663049785,MATH 18,B04,083751,Rideout; David Porter,6,0,36,30
1657663049785,MATH 18,B05,093473,Rideout; David Porter,6,0,36,30
1657663049785,MATH 18,B06,093474,Rideout; David Porter,6,0,36,30
1657663055817,MATH 20A,A01,083754,Zheng; Zequn,14,0,40,26
1657663061851,MATH 20B,A01,083756,Briones; Jor-el Thomas Caparas,4,0,36,32
1657663061851,MATH 20B,A02,083757,Briones; Jor-el Thomas Caparas,1,0,36,35
1657663061851,MATH 20B,A03,093475,Briones; Jor-el Thomas Caparas,2,0,36,34
1657663067874,MATH 20C,A01,083760,Briones; Jor-el Thomas Caparas,1,0,35,34
1657663067874,MATH 20C,A02,083761,Briones; Jor-el Thomas Caparas,8,0,35,27
1657663067874,MATH 20C,A03,093476,Briones; Jor-el Thomas Caparas,0,1,36,36
1657663067874,MATH 20C,B01,083762,Bach; Quang Tran,1,0,30,29
1657663073907,MATH 20D,A01,083765,Tran; Brian Kha,5,0,30,25
1657663073907,MATH 20D,A02,083766,Tran; Brian Kha,5,0,30,25
1657663073907,MATH 20D,A03,083767,Tran; Brian Kha,5,0,30,25
1657663079940,MATH 20E,A01,083771,Ganguly; Soumya,9,0,32,23
1657663079940,MATH 20E,A02,083772,Ganguly; Soumya,6,0,32,26
1657663079940,MATH 20E,B01,083773,Ciotti; Benjamin,20,0,35,15
1657663079940,MATH 20E,B02,083774,Ciotti; Benjamin,18,0,35,17
1657663085962,MATH 103A,A01,083777,Greenfeld; Be'Eri,3,0,36,33
1657663085962,MATH 103A,A02,083778,Greenfeld; Be'Eri,5,0,36,31
1657663085962,MATH 103A,A03,093561,Greenfeld; Be'Eri,6,0,36,30
1657663085962,MATH 103A,B01,083779,Greenfeld; Be'Eri,7,0,36,29
1657663085962,MATH 103A,B02,083780,Greenfeld; Be'Eri,4,0,36,32
1657663085962,MATH 103A,B03,093562,Greenfeld; Be'Eri,3,0,36,33
1657663091992,MATH 105,A01,085443,Carter; Anne Toulson,15,0,35,20
1657663091992,MATH 105,A02,093477,Carter; Anne Toulson,20,0,35,15
1657663098021,MATH 109,A01,083213,Ganzberger; Geoffrey Michael,2,0,34,32
1657663098021,MATH 109,A02,083214,Ganzberger; Geoffrey Michael,4,0,34,30
1657663098021,MATH 109,A03,093478,Ganzberger; Geoffrey Michael,2,0,34,32
1657663098021,MATH 109,B01,083215,Ganzberger; Geoffrey Michael,1,0,32,31
1657663098021,MATH 109,B02,083216,Ganzberger; Geoffrey Michael,2,0,32,30
1657663098021,MATH 109,B03,093479,Ganzberger; Geoffrey Michael,8,0,32,24
1657663104045,MATH 142A,A01,083219,Chow; Bennett,7,0,32,25
1657663104045,MATH 142A,A02,083220,Chow; Bennett,10,0,32,22
1657663104045,MATH 142A,A03,093480,Chow; Bennett,9,0,32,23
1657663104045,MATH 142A,B03,093481,Chow; Bennett,8,0,32,24
1657663104045,MATH 142A,B04,093558,Chow; Bennett,13,0,32,19
1657663104045,MATH 142A,B05,093559,Chow; Bennett,6,0,32,26
1657663110075,MATH 193A,A01,083224,Rotar; Vladimir,8,0,34,26
1657663110075,MATH 193A,A02,083225,Rotar; Vladimir,9,0,34,25
1657663110075,MATH 193A,A03,083781,Rotar; Vladimir,5,0,34,29
1657663110075,MATH 193A,A04,083782,Rotar; Vladimir,10,0,34,24
1657663110075,MATH 193A,A05,093482,Rotar; Vladimir,10,0,34,24
1657663116105,MATH 197,001,091859,McAuley; Julian John,9999,0,9999,0
1657663116105,MATH 197,002,095566,Kedlaya; Kiran S.,9997,0,9999,2
1657663116105,MATH 197,003,095567,Xiao; Ming,9999,0,9999,0
1657663116105,MATH 197,004,095571,Perols; Johan Lars,9998,0,9999,1
1657663123175,COGS 9,A01,083615,Shannon; Kyle Michael,9,0,75,66
1657663129198,COGS 11,A01,083617,Boyle; Mary E. T.,23,0,48,25
1657663135221,COGS 13,A01,083071,Bastos; Amalia Pinkusfeld,11,0,71,60
1657663141246,COGS 14A,A01,092681,Semenuks; Arturs,5,1,100,95
1657663147274,COGS 14B,A01,083073,Cheng; Tzu-Han,6,0,63,57
1657663153305,COGS 17,A01,092677,Semenuks; Arturs,6,0,81,75
1657663159329,COGS 100,A01,083619,Allen; Michael Gordon,17,0,70,53
1657663165362,COGS 101A,A01,083621,Davis; Joshua Daniel,9,0,68,59
1657663171387,COGS 101B,A01,091572,Allen; Michael Gordon,12,0,65,53
1657663177410,COGS 101C,A01,083625,Delgado; Tania,17,0,35,18
1657663183436,COGS 107A,A01,083627,Boyle; Mary E. T.,13,0,60,47
1657663189459,COGS 118A,A01,083075,Gupta; Anjum,21,0,76,55
1657663195483,CSE 3,A50,083646,Miranda; Gregory Joseph,24,0,50,26
1657663201508,CSE 8A,A50,083650,Miranda; Gregory Joseph,17,1,56,39
1657663207531,CSE 11,A01,083080,Cao; Yingjun,6,15,40,34
1657663213566,CSE 12,A01,083652,Krause-Levy; Sophia Louisa,28,1,120,92
1657663219588,CSE 15L,A01,083654,Morris; Justin Loren,9,0,50,41
1657663219588,CSE 15L,A02,083655,Morris; Justin Loren,9,0,50,41
1657663225621,CSE 20,A01,083657,Tran; Khoa Dang,39,0,80,41
1657663231646,CSE 21,A01,095574,Bach; Quang Tran,22,0,48,26
1657663237674,CSE 30,A01,083084,Eldon; John,6,0,80,74
1657663237674,CSE 30,B01,095061,Bhaskar; Nishant,9,0,50,41
1657663243700,CSE 100,A01,083659,Cao; Yingjun,5,4,70,65
1657663249724,CSE 134B,A01,083661,Powell; Thomas Allan,23,0,100,77
1657663255750,CSE 140,A01,083663,Gungor; Onat,15,0,85,70
1657663261773,CSE 140L,A01,083088,Eldon; John,22,0,100,78
1657663267797,CSE 175,A01,083665,Kumar; Rakesh,3,0,25,22
1657663273910,CSE 190,A00,092507,Dubnov; Shlomo,8,0,20,12
1657663279939,ECE 45,A01,083139,Congero; Spencer William,6,0,75,69
1657663285963,ECE 65,A50,083695,Saad; Andrew S,12,0,30,18
1657663285963,ECE 65,A51,095125,Saad; Andrew S,24,0,26,2
1657663291985,ECE 109,A01,091882,Touri; Behrouz,20,0,70,50
1657663298023,ECE 180,A00,083140,Abi Samra; Nicholas Camill,1,0,30,29
1657663298023,ECE 180,B00,083141,Abi Samra; Nicholas Camill,0,0,30,30
1657663304051,MATH 10A,A01,083735,Patchell; Gregory David,2,0,30,28
1657663304051,MATH 10A,A02,083736,Patchell; Gregory David,20,0,30,10
1657663304051,MATH 10A,A03,083737,Patchell; Gregory David,16,0,30,14
1657663310073,MATH 10B,A01,083207,Lim; Seonhee,8,0,34,26
1657663310073,MATH 10B,A02,083208,Lim; Seonhee,9,0,35,26
1657663310073,MATH 10B,A03,093472,Lim; Seonhee,7,0,34,27
1657663310073,MATH 10B,B01,083739,Sinha; Shubham,13,0,30,17
1657663316102,MATH 18,A01,083743,Cinel; Cameron Alexander,8,0,30,22
1657663316102,MATH 18,A02,083744,Cinel; Cameron Alexander,17,0,30,13
1657663316102,MATH 18,A03,083745,Cinel; Cameron Alexander,10,0,30,20
1657663316102,MATH 18,B01,083748,Rideout; David Porter,5,0,37,32
1657663316102,MATH 18,B02,083749,Rideout; David Porter,5,0,36,31
1657663316102,MATH 18,B03,083750,Rideout; David Porter,3,0,37,34
1657663316102,MATH 18,B04,083751,Rideout; David Porter,6,0,36,30
1657663316102,MATH 18,B05,093473,Rideout; David Porter,6,0,36,30
1657663316102,MATH 18,B06,093474,Rideout; David Porter,6,0,36,30
1657663322127,MATH 20A,A01,083754,Zheng; Zequn,14,0,40,26
1657663328159,MATH 20B,A01,083756,Briones; Jor-el Thomas Caparas,4,0,36,32
1657663328159,MATH 20B,A02,083757,Briones; Jor-el Thomas Caparas,1,0,36,35
1657663328159,MATH 20B,A03,093475,Briones; Jor-el Thomas Caparas,2,0,36,34
1657663334191,MATH 20C,A01,083760,Briones; Jor-el Thomas Caparas,1,0,35,34
1657663334191,MATH 20C,A02,083761,Briones; Jor-el Thomas Caparas,8,0,35,27
1657663334191,MATH 20C,A03,093476,Briones; Jor-el Thomas Caparas,0,1,36,36
1657663334191,MATH 20C,B01,083762,Bach; Quang Tran,1,0,30,29
1657663340223,MATH 20D,A01,083765,Tran; Brian Kha,5,0,30,25
1657663340223,MATH 20D,A02,083766,Tran; Brian Kha,5,0,30,25
1657663340223,MATH 20D,A03,083767,Tran; Brian Kha,5,0,30,25
1657663346251,MATH 20E,A01,083771,Ganguly; Soumya,9,0,32,23
1657663346251,MATH 20E,A02,083772,Ganguly; Soumya,6,0,32,26
1657663346251,MATH 20E,B01,083773,Ciotti; Benjamin,20,0,35,15
1657663346251,MATH 20E,B02,083774,Ciotti; Benjamin,18,0,35,17
1657663352284,MATH 103A,A01,083777,Greenfeld; Be'Eri,3,0,36,33
1657663352284,MATH 103A,A02,083778,Greenfeld; Be'Eri,5,0,36,31
1657663352284,MATH 103A,A03,093561,Greenfeld; Be'Eri,6,0,36,30
1657663352284,MATH 103A,B01,083779,Greenfeld; Be'Eri,7,0,36,29
1657663352284,MATH 103A,B02,083780,Greenfeld; Be'Eri,4,0,36,32
1657663352284,MATH 103A,B03,093562,Greenfeld; Be'Eri,3,0,36,33
1657663358308,MATH 105,A01,085443,Carter; Anne Toulson,15,0,35,20
1657663358308,MATH 105,A02,093477,Carter; Anne Toulson,20,0,35,15
1657663364331,MATH 109,A01,083213,Ganzberger; Geoffrey Michael,2,0,34,32
1657663364331,MATH 109,A02,083214,Ganzberger; Geoffrey Michael,4,0,34,30
1657663364331,MATH 109,A03,093478,Ganzberger; Geoffrey Michael,2,0,34,32
1657663364331,MATH 109,B01,083215,Ganzberger; Geoffrey Michael,1,0,32,31
1657663364331,MATH 109,B02,083216,Ganzberger; Geoffrey Michael,2,0,32,30
1657663364331,MATH 109,B03,093479,Ganzberger; Geoffrey Michael,8,0,32,24
1657663370360,MATH 142A,A01,083219,Chow; Bennett,7,0,32,25
1657663370360,MATH 142A,A02,083220,Chow; Bennett,10,0,32,22
1657663370360,MATH 142A,A03,093480,Chow; Bennett,9,0,32,23
1657663370360,MATH 142A,B03,093481,Chow; Bennett,8,0,32,24
1657663370360,MATH 142A,B04,093558,Chow; Bennett,13,0,32,19
1657663370360,MATH 142A,B05,093559,Chow; Bennett,6,0,32,26
1657663376388,MATH 193A,A01,083224,Rotar; Vladimir,8,0,34,26
1657663376388,MATH 193A,A02,083225,Rotar; Vladimir,9,0,34,25
1657663376388,MATH 193A,A03,083781,Rotar; Vladimir,5,0,34,29
1657663376388,MATH 193A,A04,083782,Rotar; Vladimir,10,0,34,24
1657663376388,MATH 193A,A05,093482,Rotar; Vladimir,10,0,34,24
1657663382415,MATH 197,001,091859,McAuley; Julian John,9999,0,9999,0
1657663382415,MATH 197,002,095566,Kedlaya; Kiran S.,9997,0,9999,2
1657663382415,MATH 197,003,095567,Xiao; Ming,9999,0,9999,0
1657663382415,MATH 197,004,095571,Perols; Johan Lars,9998,0,9999,1
1657663389483,COGS 9,A01,083615,Shannon; Kyle Michael,9,0,75,66
1657663395505,COGS 11,A01,083617,Boyle; Mary E. T.,23,0,48,25
1657663401533,COGS 13,A01,083071,Bastos; Amalia Pinkusfeld,11,0,71,60
1657663407555,COGS 14A,A01,092681,Semenuks; Arturs,5,1,100,95
1657663413587,COGS 14B,A01,083073,Cheng; Tzu-Han,6,0,63,57
1657663419614,COGS 17,A01,092677,Semenuks; Arturs,6,0,81,75
1657663425642,COGS 100,A01,083619,Allen; Michael Gordon,17,0,70,53
1657663431675,COGS 101A,A01,083621,Davis; Joshua Daniel,9,0,68,59
1657663437704,COGS 101B,A01,091572,Allen; Michael Gordon,12,0,65,53
1657663443730,COGS 101C,A01,083625,Delgado; Tania,17,0,35,18
1657663449753,COGS 107A,A01,083627,Boyle; Mary E. T.,13,0,60,47
1657663455782,COGS 118A,A01,083075,Gupta; Anjum,21,0,76,55
1657663461805,CSE 3,A50,083646,Miranda; Gregory Joseph,24,0,50,26
1657663467831,CSE 8A,A50,083650,Miranda; Gregory Joseph,17,1,56,39
1657663473857,CSE 11,A01,083080,Cao; Yingjun,6,15,40,34
1657663479879,CSE 12,A01,083652,Krause-Levy; Sophia Louisa,28,1,120,92
1657663485905,CSE 15L,A01,083654,Morris; Justin Loren,9,0,50,41
1657663485905,CSE 15L,A02,083655,Morris; Justin Loren,9,0,50,41
1657663491932,CSE 20,A01,083657,Tran; Khoa Dang,39,0,80,41
1657663497967,CSE 21,A01,095574,Bach; Quang Tran,22,0,48,26
1657663503992,CSE 30,A01,083084,Eldon; John,6,0,80,74
1657663503992,CSE 30,B01,095061,Bhaskar; Nishant,9,0,50,41
1657663510025,CSE 100,A01,083659,Cao; Yingjun,5,4,70,65
1657663516049,CSE 134B,A01,083661,Powell; Thomas Allan,23,0,100,77
1657663522081,CSE 140,A01,083663,Gungor; Onat,15,0,85,70
1657663528103,CSE 140L,A01,083088,Eldon; John,22,0,100,78
1657663534137,CSE 175,A01,083665,Kumar; Rakesh,3,0,25,22
1657663540163,CSE 190,A00,092507,Dubnov; Shlomo,8,0,20,12
1657663546186,ECE 45,A01,083139,Congero; Spencer William,6,0,75,69
1657663552211,ECE 65,A50,083695,Saad; Andrew S,12,0,30,18
1657663552211,ECE 65,A51,095125,Saad; Andrew S,24,0,26,2
1657663558236,ECE 109,A01,091882,Touri; Behrouz,20,0,70,50
1657663564263,ECE 180,A00,083140,Abi Samra; Nicholas Camill,1,0,30,29
1657663564263,ECE 180,B00,083141,Abi Samra; Nicholas Camill,0,0,30,30
1657663570296,MATH 10A,A01,083735,Patchell; Gregory David,2,0,30,28
1657663570296,MATH 10A,A02,083736,Patchell; Gregory David,20,0,30,10
1657663570296,MATH 10A,A03,083737,Patchell; Gregory David,16,0,30,14
1657663576324,MATH 10B,A01,083207,Lim; Seonhee,8,0,34,26
1657663576324,MATH 10B,A02,083208,Lim; Seonhee,9,0,35,26
1657663576324,MATH 10B,A03,093472,Lim; Seonhee,7,0,34,27
1657663576324,MATH 10B,B01,083739,Sinha; Shubham,13,0,30,17
1657663582352,MATH 18,A01,083743,Cinel; Cameron Alexander,8,0,30,22
1657663582352,MATH 18,A02,083744,Cinel; Cameron Alexander,17,0,30,13
1657663582352,MATH 18,A03,083745,Cinel; Cameron Alexander,10,0,30,20
1657663582352,MATH 18,B01,083748,Rideout; David Porter,5,0,37,32
1657663582352,MATH 18,B02,083749,Rideout; David Porter,5,0,36,31
1657663582352,MATH 18,B03,083750,Rideout; David Porter,3,0,37,34
1657663582352,MATH 18,B04,083751,Rideout; David Porter,6,0,36,30
1657663582352,MATH 18,B05,093473,Rideout; David Porter,6,0,36,30
1657663582352,MATH 18,B06,093474,Rideout; David Porter,6,0,36,30
1657663588380,MATH 20A,A01,083754,Zheng; Zequn,14,0,40,26
1657663594403,MATH 20B,A01,083756,Briones; Jor-el Thomas Caparas,4,0,36,32
1657663594403,MATH 20B,A02,083757,Briones; Jor-el Thomas Caparas,1,0,36,35
1657663594403,MATH 20B,A03,093475,Briones; Jor-el Thomas Caparas,2,0,36,34
1657663600433,MATH 20C,A01,083760,Briones; Jor-el Thomas Caparas,1,0,35,34
1657663600433,MATH 20C,A02,083761,Briones; Jor-el Thomas Caparas,8,0,35,27
1657663600433,MATH 20C,A03,093476,Briones; Jor-el Thomas Caparas,0,1,36,36
1657663600433,MATH 20C,B01,083762,Bach; Quang Tran,1,0,30,29
1657663606458,MATH 20D,A01,083765,Tran; Brian Kha,5,0,30,25
1657663606458,MATH 20D,A02,083766,Tran; Brian Kha,5,0,30,25
1657663606458,MATH 20D,A03,083767,Tran; Brian Kha,5,0,30,25
1657663612484,MATH 20E,A01,083771,Ganguly; Soumya,9,0,32,23
1657663612484,MATH 20E,A02,083772,Ganguly; Soumya,6,0,32,26
1657663612484,MATH 20E,B01,083773,Ciotti; Benjamin,20,0,35,15
1657663612484,MATH 20E,B02,083774,Ciotti; Benjamin,18,0,35,17
1657663618509,MATH 103A,A01,083777,Greenfeld; Be'Eri,3,0,36,33
1657663618509,MATH 103A,A02,083778,Greenfeld; Be'Eri,5,0,36,31
1657663618509,MATH 103A,A03,093561,Greenfeld; Be'Eri,6,0,36,30
1657663618509,MATH 103A,B01,083779,Greenfeld; Be'Eri,7,0,36,29
1657663618509,MATH 103A,B02,083780,Greenfeld; Be'Eri,4,0,36,32
1657663618509,MATH 103A,B03,093562,Greenfeld; Be'Eri,3,0,36,33
1657663624533,MATH 105,A01,085443,Carter; Anne Toulson,15,0,35,20
1657663624533,MATH 105,A02,093477,Carter; Anne Toulson,20,0,35,15
1657663630556,MATH 109,A01,083213,Ganzberger; Geoffrey Michael,2,0,34,32
1657663630556,MATH 109,A02,083214,Ganzberger; Geoffrey Michael,4,0,34,30
1657663630556,MATH 109,A03,093478,Ganzberger; Geoffrey Michael,2,0,34,32
1657663630556,MATH 109,B01,083215,Ganzberger; Geoffrey Michael,1,0,32,31
1657663630556,MATH 109,B02,083216,Ganzberger; Geoffrey Michael,2,0,32,30
1657663630556,MATH 109,B03,093479,Ganzberger; Geoffrey Michael,8,0,32,24
1657663636580,MATH 142A,A01,083219,Chow; Bennett,7,0,32,25
1657663636580,MATH 142A,A02,083220,Chow; Bennett,10,0,32,22
1657663636580,MATH 142A,A03,093480,Chow; Bennett,9,0,32,23
1657663636580,MATH 142A,B03,093481,Chow; Bennett,8,0,32,24
1657663636580,MATH 142A,B04,093558,Chow; Bennett,13,0,32,19
1657663636580,MATH 142A,B05,093559,Chow; Bennett,6,0,32,26
1657663642606,MATH 193A,A01,083224,Rotar; Vladimir,8,0,34,26
1657663642606,MATH 193A,A02,083225,Rotar; Vladimir,9,0,34,25
1657663642606,MATH 193A,A03,083781,Rotar; Vladimir,5,0,34,29
1657663642606,MATH 193A,A04,083782,Rotar; Vladimir,10,0,34,24
1657663642606,MATH 193A,A05,093482,Rotar; Vladimir,10,0,34,24
1657663648633,MATH 197,001,091859,McAuley; Julian John,9999,0,9999,0
1657663648633,MATH 197,002,095566,Kedlaya; Kiran S.,9997,0,9999,2
1657663648633,MATH 197,003,095567,Xiao; Ming,9999,0,9999,0
1657663648633,MATH 197,004,095571,Perols; Johan Lars,9998,0,9999,1
1657663655694,COGS 9,A01,083615,Shannon; Kyle Michael,9,0,75,66
1657663661731,COGS 11,A01,083617,Boyle; Mary E. T.,23,0,48,25
1657663667753,COGS 13,A01,083071,Bastos; Amalia Pinkusfeld,11,0,71,60
1657663673779,COGS 14A,A01,092681,Semenuks; Arturs,5,1,100,95
1657663679803,COGS 14B,A01,083073,Cheng; Tzu-Han,6,0,63,57
1657663685826,COGS 17,A01,092677,Semenuks; Arturs,6,0,81,75
1657663691853,COGS 100,A01,083619,Allen; Michael Gordon,17,0,70,53
1657663697879,COGS 101A,A01,083621,Davis; Joshua Daniel,9,0,68,59
1657663703903,COGS 101B,A01,091572,Allen; Michael Gordon,12,0,65,53
1657663709930,COGS 101C,A01,083625,Delgado; Tania,17,0,35,18
1657663715957,COGS 107A,A01,083627,Boyle; Mary E. T.,13,0,60,47
1657663721987,COGS 118A,A01,083075,Gupta; Anjum,21,0,76,55
1657663728012,CSE 3,A50,083646,Miranda; Gregory Joseph,24,0,50,26
1657663734041,CSE 8A,A50,083650,Miranda; Gregory Joseph,17,1,56,39
1657663740068,CSE 11,A01,083080,Cao; Yingjun,6,15,40,34
1657663746093,CSE 12,A01,083652,Krause-Levy; Sophia Louisa,28,1,120,92
1657663752117,CSE 15L,A01,083654,Morris; Justin Loren,9,0,50,41
1657663752117,CSE 15L,A02,083655,Morris; Justin Loren,9,0,50,41
1657663758144,CSE 20,A01,083657,Tran; Khoa Dang,39,0,80,41
1657663764167,CSE 21,A01,095574,Bach; Quang Tran,22,0,48,26
1657663770191,CSE 30,A01,083084,Eldon; John,6,0,80,74
1657663770191,CSE 30,B01,095061,Bhaskar; Nishant,9,0,50,41
1657663776220,CSE 100,A01,083659,Cao; Yingjun,5,4,70,65
1657663782243,CSE 134B,A01,083661,Powell; Thomas Allan,23,0,100,77
1657663788268,CSE 140,A01,083663,Gungor; Onat,15,0,85,70
1657663794296,CSE 140L,A01,083088,Eldon; John,22,0,100,78
1657663800330,CSE 175,A01,083665,Kumar; Rakesh,3,0,25,22
1657663806356,CSE 190,A00,092507,Dubnov; Shlomo,8,0,20,12
1657663812378,ECE 45,A01,083139,Congero; Spencer William,6,0,75,69
1657663818401,ECE 65,A50,083695,Saad; Andrew S,12,0,30,18
1657663818401,ECE 65,A51,095125,Saad; Andrew S,24,0,26,2
1657663824423,ECE 109,A01,091882,Touri; Behrouz,20,0,70,50
1657663830445,ECE 180,A00,083140,Abi Samra; Nicholas Camill,1,0,30,29
1657663830445,ECE 180,B00,083141,Abi Samra; Nicholas Camill,0,0,30,30
1657663836479,MATH 10A,A01,083735,Patchell; Gregory David,2,0,30,28
1657663836479,MATH 10A,A02,083736,Patchell; Gregory David,20,0,30,10
1657663836479,MATH 10A,A03,083737,Patchell; Gregory David,16,0,30,14
1657663842507,MATH 10B,A01,083207,Lim; Seonhee,8,0,34,26
1657663842507,MATH 10B,A02,083208,Lim; Seonhee,9,0,35,26
1657663842507,MATH 10B,A03,093472,Lim; Seonhee,7,0,34,27
1657663842507,MATH 10B,B01,083739,Sinha; Shubham,13,0,30,17
1657663848539,MATH 18,A01,083743,Cinel; Cameron Alexander,8,0,30,22
1657663848539,MATH 18,A02,083744,Cinel; Cameron Alexander,17,0,30,13
1657663848539,MATH 18,A03,083745,Cinel; Cameron Alexander,10,0,30,20
1657663848539,MATH 18,B01,083748,Rideout; David Porter,5,0,37,32
1657663848539,MATH 18,B02,083749,Rideout; David Porter,5,0,36,31
1657663848539,MATH 18,B03,083750,Rideout; David Porter,3,0,37,34
1657663848539,MATH 18,B04,083751,Rideout; David Porter,6,0,36,30
1657663848539,MATH 18,B05,093473,Rideout; David Porter,6,0,36,30
1657663848539,MATH 18,B06,093474,Rideout; David Porter,6,0,36,30
1657663854574,MATH 20A,A01,083754,Zheng; Zequn,14,0,40,26
1657663860600,MATH 20B,A01,083756,Briones; Jor-el Thomas Caparas,4,0,36,32
1657663860600,MATH 20B,A02,083757,Briones; Jor-el Thomas Caparas,1,0,36,35
1657663860600,MATH 20B,A03,093475,Briones; Jor-el Thomas Caparas,2,0,36,34
1657663866628,MATH 20C,A01,083760,Briones; Jor-el Thomas Caparas,1,0,35,34
1657663866628,MATH 20C,A02,083761,Briones; Jor-el Thomas Caparas,8,0,35,27
1657663866628,MATH 20C,A03,093476,Briones; Jor-el Thomas Caparas,0,1,36,36
1657663866628,MATH 20C,B01,083762,Bach; Quang Tran,1,0,30,29
1657663872742,MATH 20D,A01,083765,Tran; Brian Kha,5,0,30,25
1657663872742,MATH 20D,A02,083766,Tran; Brian Kha,5,0,30,25
1657663872742,MATH 20D,A03,083767,Tran; Brian Kha,5,0,30,25
1657663878770,MATH 20E,A01,083771,Ganguly; Soumya,9,0,32,23
1657663878770,MATH 20E,A02,083772,Ganguly; Soumya,6,0,32,26
1657663878770,MATH 20E,B01,083773,Ciotti; Benjamin,20,0,35,15
1657663878770,MATH 20E,B02,083774,Ciotti; Benjamin,18,0,35,17
1657663884795,MATH 103A,A01,083777,Greenfeld; Be'Eri,3,0,36,33
1657663884795,MATH 103A,A02,083778,Greenfeld; Be'Eri,5,0,36,31
1657663884795,MATH 103A,A03,093561,Greenfeld; Be'Eri,6,0,36,30
1657663884795,MATH 103A,B01,083779,Greenfeld; Be'Eri,7,0,36,29
1657663884795,MATH 103A,B02,083780,Greenfeld; Be'Eri,4,0,36,32
1657663884795,MATH 103A,B03,093562,Greenfeld; Be'Eri,3,0,36,33
1657663890821,MATH 105,A01,085443,Carter; Anne Toulson,15,0,35,20
1657663890821,MATH 105,A02,093477,Carter; Anne Toulson,20,0,35,15
1657663896843,MATH 109,A01,083213,Ganzberger; Geoffrey Michael,2,0,34,32
1657663896843,MATH 109,A02,083214,Ganzberger; Geoffrey Michael,4,0,34,30
1657663896843,MATH 109,A03,093478,Ganzberger; Geoffrey Michael,2,0,34,32
1657663896843,MATH 109,B01,083215,Ganzberger; Geoffrey Michael,1,0,32,31
1657663896843,MATH 109,B02,083216,Ganzberger; Geoffrey Michael,2,0,32,30
1657663896843,MATH 109,B03,093479,Ganzberger; Geoffrey Michael,8,0,32,24
1657663902869,MATH 142A,A01,083219,Chow; Bennett,7,0,32,25
1657663902869,MATH 142A,A02,083220,Chow; Bennett,10,0,32,22
1657663902869,MATH 142A,A03,093480,Chow; Bennett,9,0,32,23
1657663902869,MATH 142A,B03,093481,Chow; Bennett,8,0,32,24
1657663902869,MATH 142A,B04,093558,Chow; Bennett,13,0,32,19
1657663902869,MATH 142A,B05,093559,Chow; Bennett,6,0,32,26
1657663908897,MATH 193A,A01,083224,Rotar; Vladimir,8,0,34,26
1657663908897,MATH 193A,A02,083225,Rotar; Vladimir,9,0,34,25
1657663908897,MATH 193A,A03,083781,Rotar; Vladimir,5,0,34,29
1657663908897,MATH 193A,A04,083782,Rotar; Vladimir,10,0,34,24
1657663908897,MATH 193A,A05,093482,Rotar; Vladimir,10,0,34,24
1657663914920,MATH 197,001,091859,McAuley; Julian John,9999,0,9999,0
1657663914920,MATH 197,002,095566,Kedlaya; Kiran S.,9997,0,9999,2
1657663914920,MATH 197,003,095567,Xiao; Ming,9999,0,9999,0
1657663914920,MATH 197,004,095571,Perols; Johan Lars,9998,0,9999,1
1657663921993,COGS 9,A01,083615,Shannon; Kyle Michael,9,0,75,66
1657663928019,COGS 11,A01,083617,Boyle; Mary E. T.,23,0,48,25
1657663934042,COGS 13,A01,083071,Bastos; Amalia Pinkusfeld,11,0,71,60
1657663940066,COGS 14A,A01,092681,Semenuks; Arturs,5,1,100,95
1657663946096,COGS 14B,A01,083073,Cheng; Tzu-Han,6,0,63,57
1657663952126,COGS 17,A01,092677,Semenuks; Arturs,6,0,81,75
1657663958163,COGS 100,A01,083619,Allen; Michael Gordon,17,0,70,53
1657663964191,COGS 101A,A01,083621,Davis; Joshua Daniel,9,0,68,59
1657663970215,COGS 101B,A01,091572,Allen; Michael Gordon,12,0,65,53
1657663976237,COGS 101C,A01,083625,Delgado; Tania,17,0,35,18
1657663982259,COGS 107A,A01,083627,Boyle; Mary E. T.,13,0,60,47
1657663988284,COGS 118A,A01,083075,Gupta; Anjum,21,0,76,55
1657663994317,CSE 3,A50,083646,Miranda; Gregory Joseph,24,0,50,26
1657664000349,CSE 8A,A50,083650,Miranda; Gregory Joseph,17,1,56,39
1657664006372,CSE 11,A01,083080,Cao; Yingjun,6,15,40,34
1657664012396,CSE 12,A01,083652,Krause-Levy; Sophia Louisa,28,1,120,92
1657664018432,CSE 15L,A01,083654,Morris; Justin Loren,9,0,50,41
1657664018432,CSE 15L,A02,083655,Morris; Justin Loren,9,0,50,41
1657664024458,CSE 20,A01,083657,Tran; Khoa Dang,39,0,80,41
1657664030484,CSE 21,A01,095574,Bach; Quang Tran,22,0,48,26
1657664036512,CSE 30,A01,083084,Eldon; John,6,0,80,74
1657664036512,CSE 30,B01,095061,Bhaskar; Nishant,9,0,50,41
1657664042537,CSE 100,A01,083659,Cao; Yingjun,5,4,70,65
1657664048565,CSE 134B,A01,083661,Powell; Thomas Allan,23,0,100,77
1657664054592,CSE 140,A01,083663,Gungor; Onat,15,0,85,70
1657664060616,CSE 140L,A01,083088,Eldon; John,22,0,100,78
1657664066644,CSE 175,A01,083665,Kumar; Rakesh,3,0,25,22
1657664072669,CSE 190,A00,092507,Dubnov; Shlomo,8,0,20,12
1657664078692,ECE 45,A01,083139,Congero; Spencer William,6,0,75,69
1657664084715,ECE 65,A50,083695,Saad; Andrew S,12,0,30,18
1657664084715,ECE 65,A51,095125,Saad; Andrew S,24,0,26,2
1657664090740,ECE 109,A01,091882,Touri; Behrouz,20,0,70,50
1657664096767,ECE 180,A00,083140,Abi Samra; Nicholas Camill,1,0,30,29
1657664096767,ECE 180,B00,083141,Abi Samra; Nicholas Camill,0,0,30,30
1657664102788,MATH 10A,A01,083735,Patchell; Gregory David,2,0,30,28
1657664102788,MATH 10A,A02,083736,Patchell; Gregory David,20,0,30,10
1657664102788,MATH 10A,A03,083737,Patchell; Gregory David,16,0,30,14
1657664108814,MATH 10B,A01,083207,Lim; Seonhee,8,0,34,26
1657664108814,MATH 10B,A02,083208,Lim; Seonhee,9,0,35,26
1657664108814,MATH 10B,A03,093472,Lim; Seonhee,7,0,34,27
1657664108814,MATH 10B,B01,083739,Sinha; Shubham,13,0,30,17
1657664114849,MATH 18,A01,083743,Cinel; Cameron Alexander,8,0,30,22
1657664114849,MATH 18,A02,083744,Cinel; Cameron Alexander,17,0,30,13
1657664114849,MATH 18,A03,083745,Cinel; Cameron Alexander,10,0,30,20
1657664114849,MATH 18,B01,083748,Rideout; David Porter,5,0,37,32
1657664114849,MATH 18,B02,083749,Rideout; David Porter,5,0,36,31
1657664114849,MATH 18,B03,083750,Rideout; David Porter,3,0,37,34
1657664114849,MATH 18,B04,083751,Rideout; David Porter,6,0,36,30
1657664114849,MATH 18,B05,093473,Rideout; David Porter,6,0,36,30
1657664114849,MATH 18,B06,093474,Rideout; David Porter,6,0,36,30
1657664120876,MATH 20A,A01,083754,Zheng; Zequn,14,0,40,26
1657664126902,MATH 20B,A01,083756,Briones; Jor-el Thomas Caparas,4,0,36,32
1657664126902,MATH 20B,A02,083757,Briones; Jor-el Thomas Caparas,1,0,36,35
1657664126902,MATH 20B,A03,093475,Briones; Jor-el Thomas Caparas,2,0,36,34
1657664132926,MATH 20C,A01,083760,Briones; Jor-el Thomas Caparas,1,0,35,34
1657664132926,MATH 20C,A02,083761,Briones; Jor-el Thomas Caparas,8,0,35,27
1657664132926,MATH 20C,A03,093476,Briones; Jor-el Thomas Caparas,0,1,36,36
1657664132926,MATH 20C,B01,083762,Bach; Quang Tran,1,0,30,29
1657664138955,MATH 20D,A01,083765,Tran; Brian Kha,5,0,30,25
1657664138955,MATH 20D,A02,083766,Tran; Brian Kha,5,0,30,25
1657664138955,MATH 20D,A03,083767,Tran; Brian Kha,5,0,30,25
1657664144978,MATH 20E,A01,083771,Ganguly; Soumya,9,0,32,23
1657664144978,MATH 20E,A02,083772,Ganguly; Soumya,6,0,32,26
1657664144978,MATH 20E,B01,083773,Ciotti; Benjamin,20,0,35,15
1657664144978,MATH 20E,B02,083774,Ciotti; Benjamin,18,0,35,17
1657664151017,MATH 103A,A01,083777,Greenfeld; Be'Eri,3,0,36,33
1657664151017,MATH 103A,A02,083778,Greenfeld; Be'Eri,5,0,36,31
1657664151017,MATH 103A,A03,093561,Greenfeld; Be'Eri,6,0,36,30
1657664151017,MATH 103A,B01,083779,Greenfeld; Be'Eri,7,0,36,29
1657664151017,MATH 103A,B02,083780,Greenfeld; Be'Eri,4,0,36,32
1657664151017,MATH 103A,B03,093562,Greenfeld; Be'Eri,3,0,36,33
1657664157047,MATH 105,A01,085443,Carter; Anne Toulson,15,0,35,20
1657664157047,MATH 105,A02,093477,Carter; Anne Toulson,20,0,35,15
1657664163076,MATH 109,A01,083213,Ganzberger; Geoffrey Michael,2,0,34,32
1657664163076,MATH 109,A02,083214,Ganzberger; Geoffrey Michael,4,0,34,30
1657664163076,MATH 109,A03,093478,Ganzberger; Geoffrey Michael,2,0,34,32
1657664163076,MATH 109,B01,083215,Ganzberger; Geoffrey Michael,1,0,32,31
1657664163076,MATH 109,B02,083216,Ganzberger; Geoffrey Michael,2,0,32,30
1657664163076,MATH 109,B03,093479,Ganzberger; Geoffrey Michael,8,0,32,24
1657664169100,MATH 142A,A01,083219,Chow; Bennett,7,0,32,25
1657664169100,MATH 142A,A02,083220,Chow; Bennett,10,0,32,22
1657664169100,MATH 142A,A03,093480,Chow; Bennett,9,0,32,23
1657664169100,MATH 142A,B03,093481,Chow; Bennett,8,0,32,24
1657664169100,MATH 142A,B04,093558,Chow; Bennett,13,0,32,19
1657664169100,MATH 142A,B05,093559,Chow; Bennett,6,0,32,26
1657664175131,MATH 193A,A01,083224,Rotar; Vladimir,8,0,34,26
1657664175131,MATH 193A,A02,083225,Rotar; Vladimir,9,0,34,25
1657664175131,MATH 193A,A03,083781,Rotar; Vladimir,5,0,34,29
1657664175131,MATH 193A,A04,083782,Rotar; Vladimir,10,0,34,24
1657664175131,MATH 193A,A05,093482,Rotar; Vladimir,10,0,34,24
1657664181159,MATH 197,001,091859,McAuley; Julian John,9999,0,9999,0
1657664181159,MATH 197,002,095566,Kedlaya; Kiran S.,9997,0,9999,2
1657664181159,MATH 197,003,095567,Xiao; Ming,9999,0,9999,0
1657664181159,MATH 197,004,095571,Perols; Johan Lars,9998,0,9999,1
1657664188220,COGS 9,A01,083615,Shannon; Kyle Michael,9,0,75,66
1657664194244,COGS 11,A01,083617,Boyle; Mary E. T.,23,0,48,25
1657664200270,COGS 13,A01,083071,Bastos; Amalia Pinkusfeld,11,0,71,60
1657664206293,COGS 14A,A01,092681,Semenuks; Arturs,5,1,100,95
1657664212320,COGS 14B,A01,083073,Cheng; Tzu-Han,6,0,63,57
1657664218346,COGS 17,A01,092677,Semenuks; Arturs,6,0,81,75
1657664224390,COGS 100,A01,083619,Allen; Michael Gordon,17,0,70,53
1657664230412,COGS 101A,A01,083621,Davis; Joshua Daniel,9,0,68,59
1657664236443,COGS 101B,A01,091572,Allen; Michael Gordon,12,0,65,53
1657664242469,COGS 101C,A01,083625,Delgado; Tania,17,0,35,18
1657664248513,COGS 107A,A01,083627,Boyle; Mary E. T.,13,0,60,47
1657664254546,COGS 118A,A01,083075,Gupta; Anjum,21,0,76,55
1657664260572,CSE 3,A50,083646,Miranda; Gregory Joseph,24,0,50,26
1657664266594,CSE 8A,A50,083650,Miranda; Gregory Joseph,17,1,56,39
1657664272630,CSE 11,A01,083080,Cao; Yingjun,6,15,40,34
1657664278660,CSE 12,A01,083652,Krause-Levy; Sophia Louisa,28,1,120,92
1657664284684,CSE 15L,A01,083654,Morris; Justin Loren,9,0,50,41
1657664284684,CSE 15L,A02,083655,Morris; Justin Loren,9,0,50,41
1657664290710,CSE 20,A01,083657,Tran; Khoa Dang,39,0,80,41
1657664296734,CSE 21,A01,095574,Bach; Quang Tran,22,0,48,26
1657664302758,CSE 30,A01,083084,Eldon; John,6,0,80,74
1657664302758,CSE 30,B01,095061,Bhaskar; Nishant,9,0,50,41
1657664308787,CSE 100,A01,083659,Cao; Yingjun,5,4,70,65
1657664314810,CSE 134B,A01,083661,Powell; Thomas Allan,23,0,100,77
1657664320839,CSE 140,A01,083663,Gungor; Onat,15,0,85,70
1657664326883,CSE 140L,A01,083088,Eldon; John,22,0,100,78
1657664332909,CSE 175,A01,083665,Kumar; Rakesh,3,0,25,22
1657664338934,CSE 190,A00,092507,Dubnov; Shlomo,8,0,20,12
1657664344962,ECE 45,A01,083139,Congero; Spencer William,6,0,75,69
1657664350986,ECE 65,A50,083695,Saad; Andrew S,12,0,30,18
1657664350986,ECE 65,A51,095125,Saad; Andrew S,24,0,26,2
1657664357009,ECE 109,A01,091882,Touri; Behrouz,20,0,70,50
1657664363049,ECE 180,A00,083140,Abi Samra; Nicholas Camill,1,0,30,29
1657664363049,ECE 180,B00,083141,Abi Samra; Nicholas Camill,0,0,30,30
1657664369080,MATH 10A,A01,083735,Patchell; Gregory David,2,0,30,28
1657664369080,MATH 10A,A02,083736,Patchell; Gregory David,20,0,30,10
1657664369080,MATH 10A,A03,083737,Patchell; Gregory David,16,0,30,14
1657664375110,MATH 10B,A01,083207,Lim; Seonhee,8,0,34,26
1657664375110,MATH 10B,A02,083208,Lim; Seonhee,9,0,35,26
1657664375110,MATH 10B,A03,093472,Lim; Seonhee,7,0,34,27
1657664375110,MATH 10B,B01,083739,Sinha; Shubham,13,0,30,17
1657664381141,MATH 18,A01,083743,Cinel; Cameron Alexander,8,0,30,22
1657664381141,MATH 18,A02,083744,Cinel; Cameron Alexander,17,0,30,13
1657664381141,MATH 18,A03,083745,Cinel; Cameron Alexander,10,0,30,20
1657664381141,MATH 18,B01,083748,Rideout; David Porter,5,0,37,32
1657664381141,MATH 18,B02,083749,Rideout; David Porter,5,0,36,31
1657664381141,MATH 18,B03,083750,Rideout; David Porter,3,0,37,34
1657664381141,MATH 18,B04,083751,Rideout; David Porter,6,0,36,30
1657664381141,MATH 18,B05,093473,Rideout; David Porter,6,0,36,30
1657664381141,MATH 18,B06,093474,Rideout; David Porter,6,0,36,30
1657664387181,MATH 20A,A01,083754,Zheng; Zequn,14,0,40,26
1657664393209,MATH 20B,A01,083756,Briones; Jor-el Thomas Caparas,4,0,36,32
1657664393209,MATH 20B,A02,083757,Briones; Jor-el Thomas Caparas,1,0,36,35
1657664393209,MATH 20B,A03,093475,Briones; Jor-el Thomas Caparas,2,0,36,34
1657664399233,MATH 20C,A01,083760,Briones; Jor-el Thomas Caparas,1,0,35,34
1657664399233,MATH 20C,A02,083761,Briones; Jor-el Thomas Caparas,8,0,35,27
1657664399233,MATH 20C,A03,093476,Briones; Jor-el Thomas Caparas,0,1,36,36
1657664399233,MATH 20C,B01,083762,Bach; Quang Tran,1,0,30,29
1657664405259,MATH 20D,A01,083765,Tran; Brian Kha,5,0,30,25
1657664405259,MATH 20D,A02,083766,Tran; Brian Kha,5,0,30,25
1657664405259,MATH 20D,A03,083767,Tran; Brian Kha,5,0,30,25
1657664411300,MATH 20E,A01,083771,Ganguly; Soumya,9,0,32,23
1657664411300,MATH 20E,A02,083772,Ganguly; Soumya,6,0,32,26
1657664411300,MATH 20E,B01,083773,Ciotti; Benjamin,20,0,35,15
1657664411300,MATH 20E,B02,083774,Ciotti; Benjamin,18,0,35,17
1657664417324,MATH 103A,A01,083777,Greenfeld; Be'Eri,3,0,36,33
1657664417324,MATH 103A,A02,083778,Greenfeld; Be'Eri,5,0,36,31
1657664417324,MATH 103A,A03,093561,Greenfeld; Be'Eri,6,0,36,30
1657664417324,MATH 103A,B01,083779,Greenfeld; Be'Eri,7,0,36,29
1657664417324,MATH 103A,B02,083780,Greenfeld; Be'Eri,4,0,36,32
1657664417324,MATH 103A,B03,093562,Greenfeld; Be'Eri,3,0,36,33
1657664423348,MATH 105,A01,085443,Carter; Anne Toulson,15,0,35,20
1657664423348,MATH 105,A02,093477,Carter; Anne Toulson,20,0,35,15
1657664429373,MATH 109,A01,083213,Ganzberger; Geoffrey Michael,2,0,34,32
1657664429373,MATH 109,A02,083214,Ganzberger; Geoffrey Michael,4,0,34,30
1657664429373,MATH 109,A03,093478,Ganzberger; Geoffrey Michael,2,0,34,32
1657664429373,MATH 109,B01,083215,Ganzberger; Geoffrey Michael,1,0,32,31
1657664429373,MATH 109,B02,083216,Ganzberger; Geoffrey Michael,2,0,32,30
1657664429373,MATH 109,B03,093479,Ganzberger; Geoffrey Michael,8,0,32,24
1657664435432,MATH 142A,A01,083219,Chow; Bennett,7,0,32,25
1657664435432,MATH 142A,A02,083220,Chow; Bennett,10,0,32,22
1657664435432,MATH 142A,A03,093480,Chow; Bennett,9,0,32,23
1657664435432,MATH 142A,B03,093481,Chow; Bennett,8,0,32,24
1657664435432,MATH 142A,B04,093558,Chow; Bennett,13,0,32,19
1657664435432,MATH 142A,B05,093559,Chow; Bennett,6,0,32,26
1657664441455,MATH 193A,A01,083224,Rotar; Vladimir,8,0,34,26
1657664441455,MATH 193A,A02,083225,Rotar; Vladimir,9,0,34,25
1657664441455,MATH 193A,A03,083781,Rotar; Vladimir,5,0,34,29
1657664441455,MATH 193A,A04,083782,Rotar; Vladimir,10,0,34,24
1657664441455,MATH 193A,A05,093482,Rotar; Vladimir,10,0,34,24
1657664447485,MATH 197,001,091859,McAuley; Julian John,9999,0,9999,0
1657664447485,MATH 197,002,095566,Kedlaya; Kiran S.,9997,0,9999,2
1657664447485,MATH 197,003,095567,Xiao; Ming,9999,0,9999,0
1657664447485,MATH 197,004,095571,Perols; Johan Lars,9998,0,9999,1
1657664454550,COGS 9,A01,083615,Shannon; Kyle Michael,9,0,75,66
1657664460580,COGS 11,A01,083617,Boyle; Mary E. T.,23,0,48,25
1657664466694,COGS 13,A01,083071,Bastos; Amalia Pinkusfeld,11,0,71,60
1657664472722,COGS 14A,A01,092681,Semenuks; Arturs,5,1,100,95
1657664478744,COGS 14B,A01,083073,Cheng; Tzu-Han,6,0,63,57
1657664484772,COGS 17,A01,092677,Semenuks; Arturs,6,0,81,75
1657664490797,COGS 100,A01,083619,Allen; Michael Gordon,17,0,70,53
1657664496820,COGS 101A,A01,083621,Davis; Joshua Daniel,9,0,68,59
1657664502853,COGS 101B,A01,091572,Allen; Michael Gordon,12,0,65,53
1657664508878,COGS 101C,A01,083625,Delgado; Tania,17,0,35,18
1657664514899,COGS 107A,A01,083627,Boyle; Mary E. T.,13,0,60,47
1657664520923,COGS 118A,A01,083075,Gupta; Anjum,21,0,76,55
1657664526950,CSE 3,A50,083646,Miranda; Gregory Joseph,24,0,50,26
1657664532979,CSE 8A,A50,083650,Miranda; Gregory Joseph,17,1,56,39
1657664539008,CSE 11,A01,083080,Cao; Yingjun,6,15,40,34
1657664545034,CSE 12,A01,083652,Krause-Levy; Sophia Louisa,28,1,120,92
1657664551061,CSE 15L,A01,083654,Morris; Justin Loren,9,0,50,41
1657664551061,CSE 15L,A02,083655,Morris; Justin Loren,9,0,50,41
1657664557084,CSE 20,A01,083657,Tran; Khoa Dang,39,0,80,41
1657664563132,CSE 21,A01,095574,Bach; Quang Tran,22,0,48,26
1657664569154,CSE 30,A01,083084,Eldon; John,6,0,80,74
1657664569154,CSE 30,B01,095061,Bhaskar; Nishant,9,0,50,41
1657664575178,CSE 100,A01,083659,Cao; Yingjun,5,4,70,65
1657664581201,CSE 134B,A01,083661,Powell; Thomas Allan,23,0,100,77
1657664587224,CSE 140,A01,083663,Gungor; Onat,15,0,85,70
1657664593247,CSE 140L,A01,083088,Eldon; John,22,0,100,78
1657664599275,CSE 175,A01,083665,Kumar; Rakesh,3,0,25,22
1657664605296,CSE 190,A00,092507,Dubnov; Shlomo,8,0,20,12
1657664611337,ECE 45,A01,083139,Congero; Spencer William,6,0,75,69
1657664624761,ECE 65,A50,083695,Saad; Andrew S,12,0,30,18
1657664624761,ECE 65,A51,095125,Saad; Andrew S,24,0,26,2
1657664630789,ECE 109,A01,091882,Touri; Behrouz,20,0,70,50
1657664636812,ECE 180,A00,083140,Abi Samra; Nicholas Camill,1,0,30,29
1657664636812,ECE 180,B00,083141,Abi Samra; Nicholas Camill,0,0,30,30
1657664642838,MATH 10A,A01,083735,Patchell; Gregory David,2,0,30,28
1657664642838,MATH 10A,A02,083736,Patchell; Gregory David,20,0,30,10
1657664642838,MATH 10A,A03,083737,Patchell; Gregory David,16,0,30,14
1657664648862,MATH 10B,A01,083207,Lim; Seonhee,8,0,34,26
1657664648862,MATH 10B,A02,083208,Lim; Seonhee,9,0,35,26
1657664648862,MATH 10B,A03,093472,Lim; Seonhee,7,0,34,27
1657664648862,MATH 10B,B01,083739,Sinha; Shubham,13,0,30,17
1657664654887,MATH 18,A01,083743,Cinel; Cameron Alexander,8,0,30,22
1657664654887,MATH 18,A02,083744,Cinel; Cameron Alexander,17,0,30,13
1657664654887,MATH 18,A03,083745,Cinel; Cameron Alexander,10,0,30,20
1657664654887,MATH 18,B01,083748,Rideout; David Porter,5,0,37,32
1657664654887,MATH 18,B02,083749,Rideout; David Porter,5,0,36,31
1657664654887,MATH 18,B03,083750,Rideout; David Porter,3,0,37,34
1657664654887,MATH 18,B04,083751,Rideout; David Porter,6,0,36,30
1657664654887,MATH 18,B05,093473,Rideout; David Porter,6,0,36,30
1657664654887,MATH 18,B06,093474,Rideout; David Porter,6,0,36,30
1657664660912,MATH 20A,A01,083754,Zheng; Zequn,14,0,40,26
1657664666938,MATH 20B,A01,083756,Briones; Jor-el Thomas Caparas,4,0,36,32
1657664666938,MATH 20B,A02,083757,Briones; Jor-el Thomas Caparas,1,0,36,35
1657664666938,MATH 20B,A03,093475,Briones; Jor-el Thomas Caparas,2,0,36,34
1657664672964,MATH 20C,A01,083760,Briones; Jor-el Thomas Caparas,1,0,35,34
1657664672964,MATH 20C,A02,083761,Briones; Jor-el Thomas Caparas,8,0,35,27
1657664672964,MATH 20C,A03,093476,Briones; Jor-el Thomas Caparas,0,1,36,36
1657664672964,MATH 20C,B01,083762,Bach; Quang Tran,1,0,30,29
1657664678987,MATH 20D,A01,083765,Tran; Brian Kha,5,0,30,25
1657664678987,MATH 20D,A02,083766,Tran; Brian Kha,5,0,30,25
1657664678987,MATH 20D,A03,083767,Tran; Brian Kha,5,0,30,25
1657664685020,MATH 20E,A01,083771,Ganguly; Soumya,9,0,32,23
1657664685020,MATH 20E,A02,083772,Ganguly; Soumya,6,0,32,26
1657664685020,MATH 20E,B01,083773,Ciotti; Benjamin,20,0,35,15
1657664685020,MATH 20E,B02,083774,Ciotti; Benjamin,18,0,35,17
1657664691045,MATH 103A,A01,083777,Greenfeld; Be'Eri,3,0,36,33
1657664691045,MATH 103A,A02,083778,Greenfeld; Be'Eri,5,0,36,31
1657664691045,MATH 103A,A03,093561,Greenfeld; Be'Eri,6,0,36,30
1657664691045,MATH 103A,B01,083779,Greenfeld; Be'Eri,7,0,36,29
1657664691045,MATH 103A,B02,083780,Greenfeld; Be'Eri,4,0,36,32
1657664691045,MATH 103A,B03,093562,Greenfeld; Be'Eri,3,0,36,33
1657664697071,MATH 105,A01,085443,Carter; Anne Toulson,15,0,35,20
1657664697071,MATH 105,A02,093477,Carter; Anne Toulson,20,0,35,15
1657664703094,MATH 109,A01,083213,Ganzberger; Geoffrey Michael,2,0,34,32
1657664703094,MATH 109,A02,083214,Ganzberger; Geoffrey Michael,4,0,34,30
1657664703094,MATH 109,A03,093478,Ganzberger; Geoffrey Michael,2,0,34,32
1657664703094,MATH 109,B01,083215,Ganzberger; Geoffrey Michael,1,0,32,31
1657664703094,MATH 109,B02,083216,Ganzberger; Geoffrey Michael,2,0,32,30
1657664703094,MATH 109,B03,093479,Ganzberger; Geoffrey Michael,8,0,32,24
1657664709121,MATH 142A,A01,083219,Chow; Bennett,7,0,32,25
1657664709121,MATH 142A,A02,083220,Chow; Bennett,10,0,32,22
1657664709121,MATH 142A,A03,093480,Chow; Bennett,9,0,32,23
1657664709121,MATH 142A,B03,093481,Chow; Bennett,8,0,32,24
1657664709121,MATH 142A,B04,093558,Chow; Bennett,13,0,32,19
1657664709121,MATH 142A,B05,093559,Chow; Bennett,6,0,32,26
1657664715151,MATH 193A,A01,083224,Rotar; Vladimir,8,0,34,26
1657664715151,MATH 193A,A02,083225,Rotar; Vladimir,9,0,34,25
1657664715151,MATH 193A,A03,083781,Rotar; Vladimir,5,0,34,29
1657664715151,MATH 193A,A04,083782,Rotar; Vladimir,10,0,34,24
1657664715151,MATH 193A,A05,093482,Rotar; Vladimir,10,0,34,24
1657664721173,MATH 197,001,091859,McAuley; Julian John,9999,0,9999,0
1657664721173,MATH 197,002,095566,Kedlaya; Kiran S.,9997,0,9999,2
1657664721173,MATH 197,003,095567,Xiao; Ming,9999,0,9999,0
1657664721173,MATH 197,004,095571,Perols; Johan Lars,9998,0,9999,1
1657664728224,COGS 9,A01,083615,Shannon; Kyle Michael,9,0,75,66
1657664734250,COGS 11,A01,083617,Boyle; Mary E. T.,23,0,48,25
1657664740279,COGS 13,A01,083071,Bastos; Amalia Pinkusfeld,11,0,71,60
1657664746309,COGS 14A,A01,092681,Semenuks; Arturs,5,1,100,95
1657664752352,COGS 14B,A01,083073,Cheng; Tzu-Han,6,0,63,57
1657664758377,COGS 17,A01,092677,Semenuks; Arturs,6,0,81,75
1657664764399,COGS 100,A01,083619,Allen; Michael Gordon,17,0,70,53
1657664770422,COGS 101A,A01,083621,Davis; Joshua Daniel,9,0,68,59
1657664776443,COGS 101B,A01,091572,Allen; Michael Gordon,12,0,65,53
1657664782466,COGS 101C,A01,083625,Delgado; Tania,17,0,35,18
1657664788495,COGS 107A,A01,083627,Boyle; Mary E. T.,13,0,60,47
1657664794519,COGS 118A,A01,083075,Gupta; Anjum,21,0,76,55
1657664800544,CSE 3,A50,083646,Miranda; Gregory Joseph,24,0,50,26
1657664806569,CSE 8A,A50,083650,Miranda; Gregory Joseph,17,1,56,39
1657664812594,CSE 11,A01,083080,Cao; Yingjun,6,15,40,34
1657664818621,CSE 12,A01,083652,Krause-Levy; Sophia Louisa,28,1,120,92
1657664824642,CSE 15L,A01,083654,Morris; Justin Loren,9,0,50,41
1657664824642,CSE 15L,A02,083655,Morris; Justin Loren,9,0,50,41
1657664830673,CSE 20,A01,083657,Tran; Khoa Dang,39,0,80,41
1657664836702,CSE 21,A01,095574,Bach; Quang Tran,22,0,48,26
1657664842734,CSE 30,A01,083084,Eldon; John,6,0,80,74
1657664842734,CSE 30,B01,095061,Bhaskar; Nishant,9,0,50,41
1657664848761,CSE 100,A01,083659,Cao; Yingjun,5,4,70,65
1657664854790,CSE 134B,A01,083661,Powell; Thomas Allan,23,0,100,77
1657664860817,CSE 140,A01,083663,Gungor; Onat,15,0,85,70
1657664866843,CSE 140L,A01,083088,Eldon; John,22,0,100,78
1657664872871,CSE 175,A01,083665,Kumar; Rakesh,3,0,25,22
1657664878900,CSE 190,A00,092507,Dubnov; Shlomo,8,0,20,12
1657664884926,ECE 45,A01,083139,Congero; Spencer William,6,0,75,69
1657664890952,ECE 65,A50,083695,Saad; Andrew S,12,0,30,18
1657664890952,ECE 65,A51,095125,Saad; Andrew S,24,0,26,2
1657664896986,ECE 109,A01,091882,Touri; Behrouz,20,0,70,50
1657664903015,ECE 180,A00,083140,Abi Samra; Nicholas Camill,1,0,30,29
1657664903015,ECE 180,B00,083141,Abi Samra; Nicholas Camill,0,0,30,30
1657664909040,MATH 10A,A01,083735,Patchell; Gregory David,2,0,30,28
1657664909040,MATH 10A,A02,083736,Patchell; Gregory David,20,0,30,10
1657664909040,MATH 10A,A03,083737,Patchell; Gregory David,16,0,30,14
1657664915063,MATH 10B,A01,083207,Lim; Seonhee,8,0,34,26
1657664915063,MATH 10B,A02,083208,Lim; Seonhee,9,0,35,26
1657664915063,MATH 10B,A03,093472,Lim; Seonhee,7,0,34,27
1657664915063,MATH 10B,B01,083739,Sinha; Shubham,13,0,30,17
1657664921098,MATH 18,A01,083743,Cinel; Cameron Alexander,8,0,30,22
1657664921098,MATH 18,A02,083744,Cinel; Cameron Alexander,17,0,30,13
1657664921098,MATH 18,A03,083745,Cinel; Cameron Alexander,10,0,30,20
1657664921098,MATH 18,B01,083748,Rideout; David Porter,5,0,37,32
1657664921098,MATH 18,B02,083749,Rideout; David Porter,5,0,36,31
1657664921098,MATH 18,B03,083750,Rideout; David Porter,3,0,37,34
1657664921098,MATH 18,B04,083751,Rideout; David Porter,6,0,36,30
1657664921098,MATH 18,B05,093473,Rideout; David Porter,6,0,36,30
1657664921098,MATH 18,B06,093474,Rideout; David Porter,6,0,36,30
1657664927121,MATH 20A,A01,083754,Zheng; Zequn,14,0,40,26
1657664933150,MATH 20B,A01,083756,Briones; Jor-el Thomas Caparas,4,0,36,32
1657664933150,MATH 20B,A02,083757,Briones; Jor-el Thomas Caparas,1,0,36,35
1657664933150,MATH 20B,A03,093475,Briones; Jor-el Thomas Caparas,2,0,36,34
1657664939185,MATH 20C,A01,083760,Briones; Jor-el Thomas Caparas,1,0,35,34
1657664939185,MATH 20C,A02,083761,Briones; Jor-el Thomas Caparas,8,0,35,27
1657664939185,MATH 20C,A03,093476,Briones; Jor-el Thomas Caparas,0,1,36,36
1657664939185,MATH 20C,B01,083762,Bach; Quang Tran,1,0,30,29
1657664945209,MATH 20D,A01,083765,Tran; Brian Kha,5,0,30,25
1657664945209,MATH 20D,A02,083766,Tran; Brian Kha,5,0,30,25
1657664945209,MATH 20D,A03,083767,Tran; Brian Kha,5,0,30,25
1657664951237,MATH 20E,A01,083771,Ganguly; Soumya,9,0,32,23
1657664951237,MATH 20E,A02,083772,Ganguly; Soumya,6,0,32,26
1657664951237,MATH 20E,B01,083773,Ciotti; Benjamin,20,0,35,15
1657664951237,MATH 20E,B02,083774,Ciotti; Benjamin,18,0,35,17
1657664957263,MATH 103A,A01,083777,Greenfeld; Be'Eri,3,0,36,33
1657664957263,MATH 103A,A02,083778,Greenfeld; Be'Eri,5,0,36,31
1657664957263,MATH 103A,A03,093561,Greenfeld; Be'Eri,6,0,36,30
1657664957263,MATH 103A,B01,083779,Greenfeld; Be'Eri,7,0,36,29
1657664957263,MATH 103A,B02,083780,Greenfeld; Be'Eri,4,0,36,32
1657664957263,MATH 103A,B03,093562,Greenfeld; Be'Eri,3,0,36,33
1657664963299,MATH 105,A01,085443,Carter; Anne Toulson,15,0,35,20
1657664963299,MATH 105,A02,093477,Carter; Anne Toulson,20,0,35,15
1657664969327,MATH 109,A01,083213,Ganzberger; Geoffrey Michael,2,0,34,32
1657664969327,MATH 109,A02,083214,Ganzberger; Geoffrey Michael,4,0,34,30
1657664969327,MATH 109,A03,093478,Ganzberger; Geoffrey Michael,2,0,34,32
1657664969327,MATH 109,B01,083215,Ganzberger; Geoffrey Michael,1,0,32,31
1657664969327,MATH 109,B02,083216,Ganzberger; Geoffrey Michael,2,0,32,30
1657664969327,MATH 109,B03,093479,Ganzberger; Geoffrey Michael,8,0,32,24
1657664975362,MATH 142A,A01,083219,Chow; Bennett,7,0,32,25
1657664975362,MATH 142A,A02,083220,Chow; Bennett,10,0,32,22
1657664975362,MATH 142A,A03,093480,Chow; Bennett,9,0,32,23
1657664975362,MATH 142A,B03,093481,Chow; Bennett,8,0,32,24
1657664975362,MATH 142A,B04,093558,Chow; Bennett,13,0,32,19
1657664975362,MATH 142A,B05,093559,Chow; Bennett,6,0,32,26
1657664981400,MATH 193A,A01,083224,Rotar; Vladimir,8,0,34,26
1657664981400,MATH 193A,A02,083225,Rotar; Vladimir,9,0,34,25
1657664981400,MATH 193A,A03,083781,Rotar; Vladimir,5,0,34,29
1657664981400,MATH 193A,A04,083782,Rotar; Vladimir,10,0,34,24
1657664981400,MATH 193A,A05,093482,Rotar; Vladimir,10,0,34,24
1657664987429,MATH 197,001,091859,McAuley; Julian John,9999,0,9999,0
1657664987429,MATH 197,002,095566,Kedlaya; Kiran S.,9997,0,9999,2
1657664987429,MATH 197,003,095567,Xiao; Ming,9999,0,9999,0
1657664987429,MATH 197,004,095571,Perols; Johan Lars,9998,0,9999,1
1657664994485,COGS 9,A01,083615,Shannon; Kyle Michael,9,0,75,66
1657665000512,COGS 11,A01,083617,Boyle; Mary E. T.,23,0,48,25
1657665006535,COGS 13,A01,083071,Bastos; Amalia Pinkusfeld,11,0,71,60
1657665012559,COGS 14A,A01,092681,Semenuks; Arturs,5,1,100,95
1657665018595,COGS 14B,A01,083073,Cheng; Tzu-Han,6,0,63,57
1657665024624,COGS 17,A01,092677,Semenuks; Arturs,6,0,81,75
1657665030651,COGS 100,A01,083619,Allen; Michael Gordon,17,0,70,53
1657665036673,COGS 101A,A01,083621,Davis; Joshua Daniel,9,0,68,59
1657665042701,COGS 101B,A01,091572,Allen; Michael Gordon,12,0,65,53
1657665048728,COGS 101C,A01,083625,Delgado; Tania,17,0,35,18
1657665054764,COGS 107A,A01,083627,Boyle; Mary E. T.,13,0,60,47
1657665060800,COGS 118A,A01,083075,Gupta; Anjum,21,0,76,55
1657665066836,CSE 3,A50,083646,Miranda; Gregory Joseph,24,0,50,26
1657665072943,CSE 8A,A50,083650,Miranda; Gregory Joseph,17,1,56,39
1657665078967,CSE 11,A01,083080,Cao; Yingjun,6,15,40,34
1657665084992,CSE 12,A01,083652,Krause-Levy; Sophia Louisa,28,1,120,92
1657665091016,CSE 15L,A01,083654,Morris; Justin Loren,9,0,50,41
1657665091016,CSE 15L,A02,083655,Morris; Justin Loren,9,0,50,41
1657665097040,CSE 20,A01,083657,Tran; Khoa Dang,39,0,80,41
1657665103062,CSE 21,A01,095574,Bach; Quang Tran,22,0,48,26
1657665109087,CSE 30,A01,083084,Eldon; John,6,0,80,74
1657665109087,CSE 30,B01,095061,Bhaskar; Nishant,9,0,50,41
1657665115110,CSE 100,A01,083659,Cao; Yingjun,5,4,70,65
1657665121137,CSE 134B,A01,083661,Powell; Thomas Allan,23,0,100,77
1657665127159,CSE 140,A01,083663,Gungor; Onat,15,0,85,70
1657665133182,CSE 140L,A01,083088,Eldon; John,22,0,100,78
1657665139205,CSE 175,A01,083665,Kumar; Rakesh,3,0,25,22
1657665145234,CSE 190,A00,092507,Dubnov; Shlomo,8,0,20,12
1657665151261,ECE 45,A01,083139,Congero; Spencer William,6,0,75,69
1657665157296,ECE 65,A50,083695,Saad; Andrew S,12,0,30,18
1657665157296,ECE 65,A51,095125,Saad; Andrew S,24,0,26,2
1657665163323,ECE 109,A01,091882,Touri; Behrouz,20,0,70,50
1657665169350,ECE 180,A00,083140,Abi Samra; Nicholas Camill,1,0,30,29
1657665169350,ECE 180,B00,083141,Abi Samra; Nicholas Camill,0,0,30,30
1657665175373,MATH 10A,A01,083735,Patchell; Gregory David,2,0,30,28
1657665175373,MATH 10A,A02,083736,Patchell; Gregory David,20,0,30,10
1657665175373,MATH 10A,A03,083737,Patchell; Gregory David,16,0,30,14
1657665181402,MATH 10B,A01,083207,Lim; Seonhee,8,0,34,26
1657665181402,MATH 10B,A02,083208,Lim; Seonhee,9,0,35,26
1657665181402,MATH 10B,A03,093472,Lim; Seonhee,7,0,34,27
1657665181402,MATH 10B,B01,083739,Sinha; Shubham,13,0,30,17
1657665187437,MATH 18,A01,083743,Cinel; Cameron Alexander,8,0,30,22
1657665187437,MATH 18,A02,083744,Cinel; Cameron Alexander,17,0,30,13
1657665187437,MATH 18,A03,083745,Cinel; Cameron Alexander,10,0,30,20
1657665187437,MATH 18,B01,083748,Rideout; David Porter,5,0,37,32
1657665187437,MATH 18,B02,083749,Rideout; David Porter,5,0,36,31
1657665187437,MATH 18,B03,083750,Rideout; David Porter,3,0,37,34
1657665187437,MATH 18,B04,083751,Rideout; David Porter,6,0,36,30
1657665187437,MATH 18,B05,093473,Rideout; David Porter,6,0,36,30
1657665187437,MATH 18,B06,093474,Rideout; David Porter,6,0,36,30
1657665193461,MATH 20A,A01,083754,Zheng; Zequn,14,0,40,26
1657665199489,MATH 20B,A01,083756,Briones; Jor-el Thomas Caparas,4,0,36,32
1657665199489,MATH 20B,A02,083757,Briones; Jor-el Thomas Caparas,1,0,36,35
1657665199489,MATH 20B,A03,093475,Briones; Jor-el Thomas Caparas,2,0,36,34
1657665205511,MATH 20C,A01,083760,Briones; Jor-el Thomas Caparas,1,0,35,34
1657665205511,MATH 20C,A02,083761,Briones; Jor-el Thomas Caparas,8,0,35,27
1657665205511,MATH 20C,A03,093476,Briones; Jor-el Thomas Caparas,0,1,36,36
1657665205511,MATH 20C,B01,083762,Bach; Quang Tran,1,0,30,29
1657665211538,MATH 20D,A01,083765,Tran; Brian Kha,5,0,30,25
1657665211538,MATH 20D,A02,083766,Tran; Brian Kha,5,0,30,25
1657665211538,MATH 20D,A03,083767,Tran; Brian Kha,5,0,30,25
1657665217563,MATH 20E,A01,083771,Ganguly; Soumya,9,0,32,23
1657665217563,MATH 20E,A02,083772,Ganguly; Soumya,6,0,32,26
1657665217563,MATH 20E,B01,083773,Ciotti; Benjamin,20,0,35,15
1657665217563,MATH 20E,B02,083774,Ciotti; Benjamin,18,0,35,17
1657665223596,MATH 103A,A01,083777,Greenfeld; Be'Eri,3,0,36,33
1657665223596,MATH 103A,A02,083778,Greenfeld; Be'Eri,5,0,36,31
1657665223596,MATH 103A,A03,093561,Greenfeld; Be'Eri,6,0,36,30
1657665223596,MATH 103A,B01,083779,Greenfeld; Be'Eri,7,0,36,29
1657665223596,MATH 103A,B02,083780,Greenfeld; Be'Eri,4,0,36,32
1657665223596,MATH 103A,B03,093562,Greenfeld; Be'Eri,3,0,36,33
1657665229621,MATH 105,A01,085443,Carter; Anne Toulson,15,0,35,20
1657665229621,MATH 105,A02,093477,Carter; Anne Toulson,20,0,35,15
1657665235643,MATH 109,A01,083213,Ganzberger; Geoffrey Michael,2,0,34,32
1657665235643,MATH 109,A02,083214,Ganzberger; Geoffrey Michael,4,0,34,30
1657665235643,MATH 109,A03,093478,Ganzberger; Geoffrey Michael,2,0,34,32
1657665235643,MATH 109,B01,083215,Ganzberger; Geoffrey Michael,1,0,32,31
1657665235643,MATH 109,B02,083216,Ganzberger; Geoffrey Michael,2,0,32,30
1657665235643,MATH 109,B03,093479,Ganzberger; Geoffrey Michael,8,0,32,24
1657665241671,MATH 142A,A01,083219,Chow; Bennett,7,0,32,25
1657665241671,MATH 142A,A02,083220,Chow; Bennett,10,0,32,22
1657665241671,MATH 142A,A03,093480,Chow; Bennett,9,0,32,23
1657665241671,MATH 142A,B03,093481,Chow; Bennett,8,0,32,24
1657665241671,MATH 142A,B04,093558,Chow; Bennett,13,0,32,19
1657665241671,MATH 142A,B05,093559,Chow; Bennett,6,0,32,26
1657665247694,MATH 193A,A01,083224,Rotar; Vladimir,8,0,34,26
1657665247694,MATH 193A,A02,083225,Rotar; Vladimir,9,0,34,25
1657665247694,MATH 193A,A03,083781,Rotar; Vladimir,5,0,34,29
1657665247694,MATH 193A,A04,083782,Rotar; Vladimir,10,0,34,24
1657665247694,MATH 193A,A05,093482,Rotar; Vladimir,10,0,34,24
1657665253717,MATH 197,001,091859,McAuley; Julian John,9999,0,9999,0
1657665253717,MATH 197,002,095566,Kedlaya; Kiran S.,9997,0,9999,2
1657665253717,MATH 197,003,095567,Xiao; Ming,9999,0,9999,0
1657665253717,MATH 197,004,095571,Perols; Johan Lars,9998,0,9999,1
1657665260795,COGS 9,A01,083615,Shannon; Kyle Michael,9,0,75,66
1657665266817,COGS 11,A01,083617,Boyle; Mary E. T.,23,0,48,25
1657665272861,COGS 13,A01,083071,Bastos; Amalia Pinkusfeld,11,0,71,60
1657665278894,COGS 14A,A01,092681,Semenuks; Arturs,5,1,100,95
1657665284918,COGS 14B,A01,083073,Cheng; Tzu-Han,6,0,63,57
1657665290953,COGS 17,A01,092677,Semenuks; Arturs,6,0,81,75
1657665296978,COGS 100,A01,083619,Allen; Michael Gordon,17,0,70,53
1657665303000,COGS 101A,A01,083621,Davis; Joshua Daniel,9,0,68,59
1657665309023,COGS 101B,A01,091572,Allen; Michael Gordon,12,0,65,53
1657665315049,COGS 101C,A01,083625,Delgado; Tania,17,0,35,18
1657665321081,COGS 107A,A01,083627,Boyle; Mary E. T.,13,0,60,47
1657665327107,COGS 118A,A01,083075,Gupta; Anjum,21,0,76,55
1657665333134,CSE 3,A50,083646,Miranda; Gregory Joseph,24,0,50,26
1657665339158,CSE 8A,A50,083650,Miranda; Gregory Joseph,17,1,56,39
1657665345181,CSE 11,A01,083080,Cao; Yingjun,6,15,40,34
1657665351204,CSE 12,A01,083652,Krause-Levy; Sophia Louisa,28,1,120,92
1657665357237,CSE 15L,A01,083654,Morris; Justin Loren,9,0,50,41
1657665357237,CSE 15L,A02,083655,Morris; Justin Loren,9,0,50,41
1657665363264,CSE 20,A01,083657,Tran; Khoa Dang,39,0,80,41
1657665369297,CSE 21,A01,095574,Bach; Quang Tran,22,0,48,26
1657665375324,CSE 30,A01,083084,Eldon; John,6,0,80,74
1657665375324,CSE 30,B01,095061,Bhaskar; Nishant,9,0,50,41
1657665381350,CSE 100,A01,083659,Cao; Yingjun,5,4,70,65
1657665387380,CSE 134B,A01,083661,Powell; Thomas Allan,23,0,100,77
1657665393402,CSE 140,A01,083663,Gungor; Onat,15,0,85,70
1657665399425,CSE 140L,A01,083088,Eldon; John,22,0,100,78
1657665405450,CSE 175,A01,083665,Kumar; Rakesh,3,0,25,22
1657665411477,CSE 190,A00,092507,Dubnov; Shlomo,8,0,20,12
1657665417503,ECE 45,A01,083139,Congero; Spencer William,6,0,75,69
1657665423525,ECE 65,A50,083695,Saad; Andrew S,12,0,30,18
1657665423525,ECE 65,A51,095125,Saad; Andrew S,24,0,26,2
1657665429547,ECE 109,A01,091882,Touri; Behrouz,20,0,70,50
1657665435575,ECE 180,A00,083140,Abi Samra; Nicholas Camill,1,0,30,29
1657665435575,ECE 180,B00,083141,Abi Samra; Nicholas Camill,0,0,30,30
1657665441598,MATH 10A,A01,083735,Patchell; Gregory David,2,0,30,28
1657665441598,MATH 10A,A02,083736,Patchell; Gregory David,20,0,30,10
1657665441598,MATH 10A,A03,083737,Patchell; Gregory David,16,0,30,14
1657665447631,MATH 10B,A01,083207,Lim; Seonhee,8,0,34,26
1657665447631,MATH 10B,A02,083208,Lim; Seonhee,9,0,35,26
1657665447631,MATH 10B,A03,093472,Lim; Seonhee,7,0,34,27
1657665447631,MATH 10B,B01,083739,Sinha; Shubham,13,0,30,17
1657665453655,MATH 18,A01,083743,Cinel; Cameron Alexander,8,0,30,22
1657665453655,MATH 18,A02,083744,Cinel; Cameron Alexander,17,0,30,13
1657665453655,MATH 18,A03,083745,Cinel; Cameron Alexander,10,0,30,20
1657665453655,MATH 18,B01,083748,Rideout; David Porter,5,0,37,32
1657665453655,MATH 18,B02,083749,Rideout; David Porter,5,0,36,31
1657665453655,MATH 18,B03,083750,Rideout; David Porter,3,0,37,34
1657665453655,MATH 18,B04,083751,Rideout; David Porter,6,0,36,30
1657665453655,MATH 18,B05,093473,Rideout; David Porter,6,0,36,30
1657665453655,MATH 18,B06,093474,Rideout; David Porter,6,0,36,30
1657665459684,MATH 20A,A01,083754,Zheng; Zequn,14,0,40,26
1657665465708,MATH 20B,A01,083756,Briones; Jor-el Thomas Caparas,4,0,36,32
1657665465708,MATH 20B,A02,083757,Briones; Jor-el Thomas Caparas,1,0,36,35
1657665465708,MATH 20B,A03,093475,Briones; Jor-el Thomas Caparas,2,0,36,34
1657665471736,MATH 20C,A01,083760,Briones; Jor-el Thomas Caparas,1,0,35,34
1657665471736,MATH 20C,A02,083761,Briones; Jor-el Thomas Caparas,8,0,35,27
1657665471736,MATH 20C,A03,093476,Briones; Jor-el Thomas Caparas,0,1,36,36
1657665471736,MATH 20C,B01,083762,Bach; Quang Tran,1,0,30,29
1657665477763,MATH 20D,A01,083765,Tran; Brian Kha,5,0,30,25
1657665477763,MATH 20D,A02,083766,Tran; Brian Kha,5,0,30,25
1657665477763,MATH 20D,A03,083767,Tran; Brian Kha,5,0,30,25
1657665483790,MATH 20E,A01,083771,Ganguly; Soumya,9,0,32,23
1657665483790,MATH 20E,A02,083772,Ganguly; Soumya,6,0,32,26
1657665483790,MATH 20E,B01,083773,Ciotti; Benjamin,20,0,35,15
1657665483790,MATH 20E,B02,083774,Ciotti; Benjamin,18,0,35,17
1657665489812,MATH 103A,A01,083777,Greenfeld; Be'Eri,3,0,36,33
1657665489812,MATH 103A,A02,083778,Greenfeld; Be'Eri,5,0,36,31
1657665489812,MATH 103A,A03,093561,Greenfeld; Be'Eri,6,0,36,30
1657665489812,MATH 103A,B01,083779,Greenfeld; Be'Eri,7,0,36,29
1657665489812,MATH 103A,B02,083780,Greenfeld; Be'Eri,4,0,36,32
1657665489812,MATH 103A,B03,093562,Greenfeld; Be'Eri,3,0,36,33
1657665495847,MATH 105,A01,085443,Carter; Anne Toulson,15,0,35,20
1657665495847,MATH 105,A02,093477,Carter; Anne Toulson,20,0,35,15
1657665501878,MATH 109,A01,083213,Ganzberger; Geoffrey Michael,2,0,34,32
1657665501878,MATH 109,A02,083214,Ganzberger; Geoffrey Michael,4,0,34,30
1657665501878,MATH 109,A03,093478,Ganzberger; Geoffrey Michael,2,0,34,32
1657665501878,MATH 109,B01,083215,Ganzberger; Geoffrey Michael,1,0,32,31
1657665501878,MATH 109,B02,083216,Ganzberger; Geoffrey Michael,2,0,32,30
1657665501878,MATH 109,B03,093479,Ganzberger; Geoffrey Michael,8,0,32,24
1657665507902,MATH 142A,A01,083219,Chow; Bennett,7,0,32,25
1657665507902,MATH 142A,A02,083220,Chow; Bennett,10,0,32,22
1657665507902,MATH 142A,A03,093480,Chow; Bennett,9,0,32,23
1657665507902,MATH 142A,B03,093481,Chow; Bennett,8,0,32,24
1657665507902,MATH 142A,B04,093558,Chow; Bennett,13,0,32,19
1657665507902,MATH 142A,B05,093559,Chow; Bennett,6,0,32,26
1657665513924,MATH 193A,A01,083224,Rotar; Vladimir,8,0,34,26
1657665513924,MATH 193A,A02,083225,Rotar; Vladimir,9,0,34,25
1657665513924,MATH 193A,A03,083781,Rotar; Vladimir,5,0,34,29
1657665513924,MATH 193A,A04,083782,Rotar; Vladimir,10,0,34,24
1657665513924,MATH 193A,A05,093482,Rotar; Vladimir,10,0,34,24
1657665519947,MATH 197,001,091859,McAuley; Julian John,9999,0,9999,0
1657665519947,MATH 197,002,095566,Kedlaya; Kiran S.,9997,0,9999,2
1657665519947,MATH 197,003,095567,Xiao; Ming,9999,0,9999,0
1657665519947,MATH 197,004,095571,Perols; Johan Lars,9998,0,9999,1
1657665527028,COGS 9,A01,083615,Shannon; Kyle Michael,9,0,75,66
1657665533063,COGS 11,A01,083617,Boyle; Mary E. T.,23,0,48,25
1657665539087,COGS 13,A01,083071,Bastos; Amalia Pinkusfeld,11,0,71,60
1657665545114,COGS 14A,A01,092681,Semenuks; Arturs,5,1,100,95
1657665551141,COGS 14B,A01,083073,Cheng; Tzu-Han,6,0,63,57
1657665557171,COGS 17,A01,092677,Semenuks; Arturs,6,0,81,75
1657665563201,COGS 100,A01,083619,Allen; Michael Gordon,17,0,70,53
1657665569236,COGS 101A,A01,083621,Davis; Joshua Daniel,9,0,68,59
1657665575261,COGS 101B,A01,091572,Allen; Michael Gordon,12,0,65,53
1657665581284,COGS 101C,A01,083625,Delgado; Tania,17,0,35,18
1657665587306,COGS 107A,A01,083627,Boyle; Mary E. T.,13,0,60,47
1657665593333,COGS 118A,A01,083075,Gupta; Anjum,21,0,76,55
1657665599360,CSE 3,A50,083646,Miranda; Gregory Joseph,24,0,50,26
1657665605383,CSE 8A,A50,083650,Miranda; Gregory Joseph,17,1,56,39
1657665611421,CSE 11,A01,083080,Cao; Yingjun,6,15,40,34
1657665617446,CSE 12,A01,083652,Krause-Levy; Sophia Louisa,28,1,120,92
1657665623468,CSE 15L,A01,083654,Morris; Justin Loren,9,0,50,41
1657665623468,CSE 15L,A02,083655,Morris; Justin Loren,9,0,50,41
1657665629491,CSE 20,A01,083657,Tran; Khoa Dang,39,0,80,41
1657665635513,CSE 21,A01,095574,Bach; Quang Tran,22,0,48,26
1657665641536,CSE 30,A01,083084,Eldon; John,6,0,80,74
1657665641536,CSE 30,B01,095061,Bhaskar; Nishant,9,0,50,41
1657665647568,CSE 100,A01,083659,Cao; Yingjun,5,4,70,65
1657665653601,CSE 134B,A01,083661,Powell; Thomas Allan,23,0,100,77
1657665659626,CSE 140,A01,083663,Gungor; Onat,15,0,85,70
1657665665654,CSE 140L,A01,083088,Eldon; John,22,0,100,78
1657665671751,CSE 175,A01,083665,Kumar; Rakesh,3,0,25,22
1657665677775,CSE 190,A00,092507,Dubnov; Shlomo,8,0,20,12
1657665683801,ECE 45,A01,083139,Congero; Spencer William,6,0,75,69
1657665689828,ECE 65,A50,083695,Saad; Andrew S,12,0,30,18
1657665689828,ECE 65,A51,095125,Saad; Andrew S,24,0,26,2
1657665695853,ECE 109,A01,091882,Touri; Behrouz,20,0,70,50
1657665701875,ECE 180,A00,083140,Abi Samra; Nicholas Camill,1,0,30,29
1657665701875,ECE 180,B00,083141,Abi Samra; Nicholas Camill,0,0,30,30
1657665707904,MATH 10A,A01,083735,Patchell; Gregory David,2,0,30,28
1657665707904,MATH 10A,A02,083736,Patchell; Gregory David,20,0,30,10
1657665707904,MATH 10A,A03,083737,Patchell; Gregory David,16,0,30,14
1657665713938,MATH 10B,A01,083207,Lim; Seonhee,8,0,34,26
1657665713938,MATH 10B,A02,083208,Lim; Seonhee,9,0,35,26
1657665713938,MATH 10B,A03,093472,Lim; Seonhee,7,0,34,27
1657665713938,MATH 10B,B01,083739,Sinha; Shubham,13,0,30,17
1657665719969,MATH 18,A01,083743,Cinel; Cameron Alexander,8,0,30,22
1657665719969,MATH 18,A02,083744,Cinel; Cameron Alexander,17,0,30,13
1657665719969,MATH 18,A03,083745,Cinel; Cameron Alexander,10,0,30,20
1657665719969,MATH 18,B01,083748,Rideout; David Porter,5,0,37,32
1657665719969,MATH 18,B02,083749,Rideout; David Porter,5,0,36,31
1657665719969,MATH 18,B03,083750,Rideout; David Porter,3,0,37,34
1657665719969,MATH 18,B04,083751,Rideout; David Porter,6,0,36,30
1657665719969,MATH 18,B05,093473,Rideout; David Porter,6,0,36,30
1657665719969,MATH 18,B06,093474,Rideout; David Porter,6,0,36,30
1657665725994,MATH 20A,A01,083754,Zheng; Zequn,14,0,40,26
1657665732027,MATH 20B,A01,083756,Briones; Jor-el Thomas Caparas,4,0,36,32
1657665732027,MATH 20B,A02,083757,Briones; Jor-el Thomas Caparas,1,0,36,35
1657665732027,MATH 20B,A03,093475,Briones; Jor-el Thomas Caparas,2,0,36,34
1657665738049,MATH 20C,A01,083760,Briones; Jor-el Thomas Caparas,1,0,35,34
1657665738049,MATH 20C,A02,083761,Briones; Jor-el Thomas Caparas,8,0,35,27
1657665738049,MATH 20C,A03,093476,Briones; Jor-el Thomas Caparas,0,1,36,36
1657665738049,MATH 20C,B01,083762,Bach; Quang Tran,1,0,30,29
1657665744076,MATH 20D,A01,083765,Tran; Brian Kha,5,0,30,25
1657665744076,MATH 20D,A02,083766,Tran; Brian Kha,5,0,30,25
1657665744076,MATH 20D,A03,083767,Tran; Brian Kha,5,0,30,25
1657665750120,MATH 20E,A01,083771,Ganguly; Soumya,9,0,32,23
1657665750120,MATH 20E,A02,083772,Ganguly; Soumya,6,0,32,26
1657665750120,MATH 20E,B01,083773,Ciotti; Benjamin,20,0,35,15
1657665750120,MATH 20E,B02,083774,Ciotti; Benjamin,18,0,35,17
1657665756146,MATH 103A,A01,083777,Greenfeld; Be'Eri,3,0,36,33
1657665756146,MATH 103A,A02,083778,Greenfeld; Be'Eri,5,0,36,31
1657665756146,MATH 103A,A03,093561,Greenfeld; Be'Eri,6,0,36,30
1657665756146,MATH 103A,B01,083779,Greenfeld; Be'Eri,7,0,36,29
1657665756146,MATH 103A,B02,083780,Greenfeld; Be'Eri,4,0,36,32
1657665756146,MATH 103A,B03,093562,Greenfeld; Be'Eri,3,0,36,33
1657665762168,MATH 105,A01,085443,Carter; Anne Toulson,15,0,35,20
1657665762168,MATH 105,A02,093477,Carter; Anne Toulson,20,0,35,15
1657665768192,MATH 109,A01,083213,Ganzberger; Geoffrey Michael,2,0,34,32
1657665768192,MATH 109,A02,083214,Ganzberger; Geoffrey Michael,4,0,34,30
1657665768192,MATH 109,A03,093478,Ganzberger; Geoffrey Michael,2,0,34,32
1657665768192,MATH 109,B01,083215,Ganzberger; Geoffrey Michael,1,0,32,31
1657665768192,MATH 109,B02,083216,Ganzberger; Geoffrey Michael,2,0,32,30
1657665768192,MATH 109,B03,093479,Ganzberger; Geoffrey Michael,8,0,32,24
1657665774216,MATH 142A,A01,083219,Chow; Bennett,7,0,32,25
1657665774216,MATH 142A,A02,083220,Chow; Bennett,10,0,32,22
1657665774216,MATH 142A,A03,093480,Chow; Bennett,9,0,32,23
1657665774216,MATH 142A,B03,093481,Chow; Bennett,8,0,32,24
1657665774216,MATH 142A,B04,093558,Chow; Bennett,13,0,32,19
1657665774216,MATH 142A,B05,093559,Chow; Bennett,6,0,32,26
1657665780238,MATH 193A,A01,083224,Rotar; Vladimir,8,0,34,26
1657665780238,MATH 193A,A02,083225,Rotar; Vladimir,9,0,34,25
1657665780238,MATH 193A,A03,083781,Rotar; Vladimir,5,0,34,29
1657665780238,MATH 193A,A04,083782,Rotar; Vladimir,10,0,34,24
1657665780238,MATH 193A,A05,093482,Rotar; Vladimir,10,0,34,24
1657665786264,MATH 197,001,091859,McAuley; Julian John,9999,0,9999,0
1657665786264,MATH 197,002,095566,Kedlaya; Kiran S.,9997,0,9999,2
1657665786264,MATH 197,003,095567,Xiao; Ming,9999,0,9999,0
1657665786264,MATH 197,004,095571,Perols; Johan Lars,9998,0,9999,1
1657665793315,COGS 9,A01,083615,Shannon; Kyle Michael,9,0,75,66
1657665799341,COGS 11,A01,083617,Boyle; Mary E. T.,23,0,48,25
1657665805367,COGS 13,A01,083071,Bastos; Amalia Pinkusfeld,11,0,71,60
1657665811396,COGS 14A,A01,092681,Semenuks; Arturs,5,1,100,95
1657665817422,COGS 14B,A01,083073,Cheng; Tzu-Han,6,0,63,57
1657665823445,COGS 17,A01,092677,Semenuks; Arturs,6,0,81,75
1657665829484,COGS 100,A01,083619,Allen; Michael Gordon,17,0,70,53
1657665835507,COGS 101A,A01,083621,Davis; Joshua Daniel,9,0,68,59
1657665841533,COGS 101B,A01,091572,Allen; Michael Gordon,12,0,65,53
1657665847562,COGS 101C,A01,083625,Delgado; Tania,17,0,35,18
1657665853588,COGS 107A,A01,083627,Boyle; Mary E. T.,13,0,60,47
1657665859611,COGS 118A,A01,083075,Gupta; Anjum,21,0,76,55
1657665865639,CSE 3,A50,083646,Miranda; Gregory Joseph,24,0,50,26
1657665871666,CSE 8A,A50,083650,Miranda; Gregory Joseph,17,1,56,39
1657665877697,CSE 11,A01,083080,Cao; Yingjun,6,15,40,34
1657665883721,CSE 12,A01,083652,Krause-Levy; Sophia Louisa,28,1,120,92
1657665889748,CSE 15L,A01,083654,Morris; Justin Loren,9,0,50,41
1657665889748,CSE 15L,A02,083655,Morris; Justin Loren,9,0,50,41
1657665895773,CSE 20,A01,083657,Tran; Khoa Dang,39,0,80,41
1657665901796,CSE 21,A01,095574,Bach; Quang Tran,22,0,48,26
1657665907818,CSE 30,A01,083084,Eldon; John,6,0,80,74
1657665907818,CSE 30,B01,095061,Bhaskar; Nishant,9,0,50,41
1657665913843,CSE 100,A01,083659,Cao; Yingjun,5,4,70,65
1657665919875,CSE 134B,A01,083661,Powell; Thomas Allan,23,0,100,77
1657665925899,CSE 140,A01,083663,Gungor; Onat,15,0,85,70
1657665931921,CSE 140L,A01,083088,Eldon; John,22,0,100,78
1657665937955,CSE 175,A01,083665,Kumar; Rakesh,3,0,25,22
1657665943987,CSE 190,A00,092507,Dubnov; Shlomo,8,0,20,12
1657665950012,ECE 45,A01,083139,Congero; Spencer William,6,0,75,69
1657665956037,ECE 65,A50,083695,Saad; Andrew S,12,0,30,18
1657665956037,ECE 65,A51,095125,Saad; Andrew S,24,0,26,2
1657665962059,ECE 109,A01,091882,Touri; Behrouz,20,0,70,50
1657665968084,ECE 180,A00,083140,Abi Samra; Nicholas Camill,1,0,30,29
1657665968084,ECE 180,B00,083141,Abi Samra; Nicholas Camill,0,0,30,30
1657665974108,MATH 10A,A01,083735,Patchell; Gregory David,2,0,30,28
1657665974108,MATH 10A,A02,083736,Patchell; Gregory David,20,0,30,10
1657665974108,MATH 10A,A03,083737,Patchell; Gregory David,16,0,30,14
1657665980136,MATH 10B,A01,083207,Lim; Seonhee,8,0,34,26
1657665980136,MATH 10B,A02,083208,Lim; Seonhee,9,0,35,26
1657665980136,MATH 10B,A03,093472,Lim; Seonhee,7,0,34,27
1657665980136,MATH 10B,B01,083739,Sinha; Shubham,13,0,30,17
1657665986166,MATH 18,A01,083743,Cinel; Cameron Alexander,8,0,30,22
1657665986166,MATH 18,A02,083744,Cinel; Cameron Alexander,17,0,30,13
1657665986166,MATH 18,A03,083745,Cinel; Cameron Alexander,10,0,30,20
1657665986166,MATH 18,B01,083748,Rideout; David Porter,5,0,37,32
1657665986166,MATH 18,B02,083749,Rideout; David Porter,5,0,36,31
1657665986166,MATH 18,B03,083750,Rideout; David Porter,3,0,37,34
1657665986166,MATH 18,B04,083751,Rideout; David Porter,6,0,36,30
1657665986166,MATH 18,B05,093473,Rideout; David Porter,6,0,36,30
1657665986166,MATH 18,B06,093474,Rideout; David Porter,6,0,36,30
1657665992189,MATH 20A,A01,083754,Zheng; Zequn,14,0,40,26
1657665998211,MATH 20B,A01,083756,Briones; Jor-el Thomas Caparas,4,0,36,32
1657665998211,MATH 20B,A02,083757,Briones; Jor-el Thomas Caparas,1,0,36,35
1657665998211,MATH 20B,A03,093475,Briones; Jor-el Thomas Caparas,2,0,36,34
1657666004234,MATH 20C,A01,083760,Briones; Jor-el Thomas Caparas,1,0,35,34
1657666004234,MATH 20C,A02,083761,Briones; Jor-el Thomas Caparas,8,0,35,27
1657666004234,MATH 20C,A03,093476,Briones; Jor-el Thomas Caparas,0,1,36,36
1657666004234,MATH 20C,B01,083762,Bach; Quang Tran,1,0,30,29
1657666010262,MATH 20D,A01,083765,Tran; Brian Kha,5,0,30,25
1657666010262,MATH 20D,A02,083766,Tran; Brian Kha,5,0,30,25
1657666010262,MATH 20D,A03,083767,Tran; Brian Kha,5,0,30,25
1657666016287,MATH 20E,A01,083771,Ganguly; Soumya,9,0,32,23
1657666016287,MATH 20E,A02,083772,Ganguly; Soumya,6,0,32,26
1657666016287,MATH 20E,B01,083773,Ciotti; Benjamin,20,0,35,15
1657666016287,MATH 20E,B02,083774,Ciotti; Benjamin,18,0,35,17
1657666022311,MATH 103A,A01,083777,Greenfeld; Be'Eri,3,0,36,33
1657666022311,MATH 103A,A02,083778,Greenfeld; Be'Eri,5,0,36,31
1657666022311,MATH 103A,A03,093561,Greenfeld; Be'Eri,6,0,36,30
1657666022311,MATH 103A,B01,083779,Greenfeld; Be'Eri,7,0,36,29
1657666022311,MATH 103A,B02,083780,Greenfeld; Be'Eri,4,0,36,32
1657666022311,MATH 103A,B03,093562,Greenfeld; Be'Eri,3,0,36,33
1657666028344,MATH 105,A01,085443,Carter; Anne Toulson,15,0,35,20
1657666028344,MATH 105,A02,093477,Carter; Anne Toulson,20,0,35,15
1657666034372,MATH 109,A01,083213,Ganzberger; Geoffrey Michael,2,0,34,32
1657666034372,MATH 109,A02,083214,Ganzberger; Geoffrey Michael,4,0,34,30
1657666034372,MATH 109,A03,093478,Ganzberger; Geoffrey Michael,2,0,34,32
1657666034372,MATH 109,B01,083215,Ganzberger; Geoffrey Michael,1,0,32,31
1657666034372,MATH 109,B02,083216,Ganzberger; Geoffrey Michael,2,0,32,30
1657666034372,MATH 109,B03,093479,Ganzberger; Geoffrey Michael,8,0,32,24
1657666040395,MATH 142A,A01,083219,Chow; Bennett,7,0,32,25
1657666040395,MATH 142A,A02,083220,Chow; Bennett,10,0,32,22
1657666040395,MATH 142A,A03,093480,Chow; Bennett,9,0,32,23
1657666040395,MATH 142A,B03,093481,Chow; Bennett,8,0,32,24
1657666040395,MATH 142A,B04,093558,Chow; Bennett,13,0,32,19
1657666040395,MATH 142A,B05,093559,Chow; Bennett,6,0,32,26
1657666046423,MATH 193A,A01,083224,Rotar; Vladimir,8,0,34,26
1657666046423,MATH 193A,A02,083225,Rotar; Vladimir,9,0,34,25
1657666046423,MATH 193A,A03,083781,Rotar; Vladimir,5,0,34,29
1657666046423,MATH 193A,A04,083782,Rotar; Vladimir,10,0,34,24
1657666046423,MATH 193A,A05,093482,Rotar; Vladimir,10,0,34,24
1657666052451,MATH 197,001,091859,McAuley; Julian John,9999,0,9999,0
1657666052451,MATH 197,002,095566,Kedlaya; Kiran S.,9997,0,9999,2
1657666052451,MATH 197,003,095567,Xiao; Ming,9999,0,9999,0
1657666052451,MATH 197,004,095571,Perols; Johan Lars,9998,0,9999,1
1657666059520,COGS 9,A01,083615,Shannon; Kyle Michael,9,0,75,66
1657666065545,COGS 11,A01,083617,Boyle; Mary E. T.,23,0,48,25
1657666071568,COGS 13,A01,083071,Bastos; Amalia Pinkusfeld,11,0,71,60
1657666077593,COGS 14A,A01,092681,Semenuks; Arturs,5,1,100,95
1657666083623,COGS 14B,A01,083073,Cheng; Tzu-Han,6,0,63,57
1657666089648,COGS 17,A01,092677,Semenuks; Arturs,6,0,81,75
1657666095686,COGS 100,A01,083619,Allen; Michael Gordon,17,0,70,53
1657666101710,COGS 101A,A01,083621,Davis; Joshua Daniel,9,0,68,59
1657666107738,COGS 101B,A01,091572,Allen; Michael Gordon,12,0,65,53
1657666113760,COGS 101C,A01,083625,Delgado; Tania,17,0,35,18
1657666119784,COGS 107A,A01,083627,Boyle; Mary E. T.,13,0,60,47
1657666125814,COGS 118A,A01,083075,Gupta; Anjum,21,0,76,55
1657666131842,CSE 3,A50,083646,Miranda; Gregory Joseph,24,0,50,26
1657666137868,CSE 8A,A50,083650,Miranda; Gregory Joseph,17,1,56,39
1657666143895,CSE 11,A01,083080,Cao; Yingjun,6,15,40,34
1657666149925,CSE 12,A01,083652,Krause-Levy; Sophia Louisa,28,1,120,92
1657666155952,CSE 15L,A01,083654,Morris; Justin Loren,9,0,50,41
1657666155952,CSE 15L,A02,083655,Morris; Justin Loren,9,0,50,41
1657666161974,CSE 20,A01,083657,Tran; Khoa Dang,39,0,80,41
1657666168002,CSE 21,A01,095574,Bach; Quang Tran,22,0,48,26
1657666174024,CSE 30,A01,083084,Eldon; John,6,0,80,74
1657666174024,CSE 30,B01,095061,Bhaskar; Nishant,9,0,50,41
1657666180046,CSE 100,A01,083659,Cao; Yingjun,5,4,70,65
1657666186072,CSE 134B,A01,083661,Powell; Thomas Allan,23,0,100,77
1657666192096,CSE 140,A01,083663,Gungor; Onat,15,0,85,70
1657666198121,CSE 140L,A01,083088,Eldon; John,22,0,100,78
1657666204144,CSE 175,A01,083665,Kumar; Rakesh,3,0,25,22
1657666210170,CSE 190,A00,092507,Dubnov; Shlomo,8,0,20,12
1657666216197,ECE 45,A01,083139,Congero; Spencer William,6,0,75,69
1657666222224,ECE 65,A50,083695,Saad; Andrew S,12,0,30,18
1657666222224,ECE 65,A51,095125,Saad; Andrew S,24,0,26,2
1657666228247,ECE 109,A01,091882,Touri; Behrouz,20,0,70,50
1657666234285,ECE 180,A00,083140,Abi Samra; Nicholas Camill,1,0,30,29
1657666234285,ECE 180,B00,083141,Abi Samra; Nicholas Camill,0,0,30,30
1657666240308,MATH 10A,A01,083735,Patchell; Gregory David,2,0,30,28
1657666240308,MATH 10A,A02,083736,Patchell; Gregory David,20,0,30,10
1657666240308,MATH 10A,A03,083737,Patchell; Gregory David,16,0,30,14
1657666246336,MATH 10B,A01,083207,Lim; Seonhee,8,0,34,26
1657666246336,MATH 10B,A02,083208,Lim; Seonhee,9,0,35,26
1657666246336,MATH 10B,A03,093472,Lim; Seonhee,7,0,34,27
1657666246336,MATH 10B,B01,083739,Sinha; Shubham,13,0,30,17
1657666252360,MATH 18,A01,083743,Cinel; Cameron Alexander,8,0,30,22
1657666252360,MATH 18,A02,083744,Cinel; Cameron Alexander,17,0,30,13
1657666252360,MATH 18,A03,083745,Cinel; Cameron Alexander,10,0,30,20
1657666252360,MATH 18,B01,083748,Rideout; David Porter,5,0,37,32
1657666252360,MATH 18,B02,083749,Rideout; David Porter,5,0,36,31
1657666252360,MATH 18,B03,083750,Rideout; David Porter,3,0,37,34
1657666252360,MATH 18,B04,083751,Rideout; David Porter,6,0,36,30
1657666252360,MATH 18,B05,093473,Rideout; David Porter,6,0,36,30
1657666252360,MATH 18,B06,093474,Rideout; David Porter,6,0,36,30
1657666258381,MATH 20A,A01,083754,Zheng; Zequn,14,0,40,26
1657666264410,MATH 20B,A01,083756,Briones; Jor-el Thomas Caparas,4,0,36,32
1657666264410,MATH 20B,A02,083757,Briones; Jor-el Thomas Caparas,1,0,36,35
1657666264410,MATH 20B,A03,093475,Briones; Jor-el Thomas Caparas,2,0,36,34
1657666270553,MATH 20C,A01,083760,Briones; Jor-el Thomas Caparas,1,0,35,34
1657666270553,MATH 20C,A02,083761,Briones; Jor-el Thomas Caparas,8,0,35,27
1657666270553,MATH 20C,A03,093476,Briones; Jor-el Thomas Caparas,0,1,36,36
1657666270553,MATH 20C,B01,083762,Bach; Quang Tran,1,0,30,29
1657666276577,MATH 20D,A01,083765,Tran; Brian Kha,5,0,30,25
1657666276577,MATH 20D,A02,083766,Tran; Brian Kha,5,0,30,25
1657666276577,MATH 20D,A03,083767,Tran; Brian Kha,5,0,30,25
1657666282599,MATH 20E,A01,083771,Ganguly; Soumya,9,0,32,23
1657666282599,MATH 20E,A02,083772,Ganguly; Soumya,6,0,32,26
1657666282599,MATH 20E,B01,083773,Ciotti; Benjamin,20,0,35,15
1657666282599,MATH 20E,B02,083774,Ciotti; Benjamin,18,0,35,17
1657666288621,MATH 103A,A01,083777,Greenfeld; Be'Eri,3,0,36,33
1657666288621,MATH 103A,A02,083778,Greenfeld; Be'Eri,5,0,36,31
1657666288621,MATH 103A,A03,093561,Greenfeld; Be'Eri,6,0,36,30
1657666288621,MATH 103A,B01,083779,Greenfeld; Be'Eri,7,0,36,29
1657666288621,MATH 103A,B02,083780,Greenfeld; Be'Eri,4,0,36,32
1657666288621,MATH 103A,B03,093562,Greenfeld; Be'Eri,3,0,36,33
1657666294642,MATH 105,A01,085443,Carter; Anne Toulson,15,0,35,20
1657666294642,MATH 105,A02,093477,Carter; Anne Toulson,20,0,35,15
1657666300665,MATH 109,A01,083213,Ganzberger; Geoffrey Michael,2,0,34,32
1657666300665,MATH 109,A02,083214,Ganzberger; Geoffrey Michael,4,0,34,30
1657666300665,MATH 109,A03,093478,Ganzberger; Geoffrey Michael,2,0,34,32
1657666300665,MATH 109,B01,083215,Ganzberger; Geoffrey Michael,1,0,32,31
1657666300665,MATH 109,B02,083216,Ganzberger; Geoffrey Michael,2,0,32,30
1657666300665,MATH 109,B03,093479,Ganzberger; Geoffrey Michael,8,0,32,24
1657666306693,MATH 142A,A01,083219,Chow; Bennett,7,0,32,25
1657666306693,MATH 142A,A02,083220,Chow; Bennett,10,0,32,22
1657666306693,MATH 142A,A03,093480,Chow; Bennett,9,0,32,23
1657666306693,MATH 142A,B03,093481,Chow; Bennett,8,0,32,24
1657666306693,MATH 142A,B04,093558,Chow; Bennett,13,0,32,19
1657666306693,MATH 142A,B05,093559,Chow; Bennett,6,0,32,26
1657666312725,MATH 193A,A01,083224,Rotar; Vladimir,8,0,34,26
1657666312725,MATH 193A,A02,083225,Rotar; Vladimir,9,0,34,25
1657666312725,MATH 193A,A03,083781,Rotar; Vladimir,5,0,34,29
1657666312725,MATH 193A,A04,083782,Rotar; Vladimir,10,0,34,24
1657666312725,MATH 193A,A05,093482,Rotar; Vladimir,10,0,34,24
1657666318749,MATH 197,001,091859,McAuley; Julian John,9999,0,9999,0
1657666318749,MATH 197,002,095566,Kedlaya; Kiran S.,9997,0,9999,2
1657666318749,MATH 197,003,095567,Xiao; Ming,9999,0,9999,0
1657666318749,MATH 197,004,095571,Perols; Johan Lars,9998,0,9999,1
1657666325796,COGS 9,A01,083615,Shannon; Kyle Michael,9,0,75,66
1657666331819,COGS 11,A01,083617,Boyle; Mary E. T.,23,0,48,25
1657666337841,COGS 13,A01,083071,Bastos; Amalia Pinkusfeld,11,0,71,60
1657666343863,COGS 14A,A01,092681,Semenuks; Arturs,5,1,100,95
1657666349892,COGS 14B,A01,083073,Cheng; Tzu-Han,6,0,63,57
1657666355915,COGS 17,A01,092677,Semenuks; Arturs,6,0,81,75
1657666361942,COGS 100,A01,083619,Allen; Michael Gordon,17,0,70,53
1657666367966,COGS 101A,A01,083621,Davis; Joshua Daniel,9,0,68,59
1657666373988,COGS 101B,A01,091572,Allen; Michael Gordon,12,0,65,53
1657666380016,COGS 101C,A01,083625,Delgado; Tania,17,0,35,18
1657666386042,COGS 107A,A01,083627,Boyle; Mary E. T.,13,0,60,47
1657666392065,COGS 118A,A01,083075,Gupta; Anjum,21,0,76,55
1657666398093,CSE 3,A50,083646,Miranda; Gregory Joseph,24,0,50,26
1657666404130,CSE 8A,A50,083650,Miranda; Gregory Joseph,17,1,56,39
1657666410156,CSE 11,A01,083080,Cao; Yingjun,6,15,40,34
1657666416184,CSE 12,A01,083652,Krause-Levy; Sophia Louisa,28,1,120,92
1657666422208,CSE 15L,A01,083654,Morris; Justin Loren,9,0,50,41
1657666422208,CSE 15L,A02,083655,Morris; Justin Loren,9,0,50,41
1657666428231,CSE 20,A01,083657,Tran; Khoa Dang,39,0,80,41
1657666434260,CSE 21,A01,095574,Bach; Quang Tran,22,0,48,26
1657666440283,CSE 30,A01,083084,Eldon; John,6,0,80,74
1657666440283,CSE 30,B01,095061,Bhaskar; Nishant,9,0,50,41
1657666446307,CSE 100,A01,083659,Cao; Yingjun,5,4,70,65
1657666452334,CSE 134B,A01,083661,Powell; Thomas Allan,23,0,100,77
1657666458363,CSE 140,A01,083663,Gungor; Onat,15,0,85,70
1657666464396,CSE 140L,A01,083088,Eldon; John,22,0,100,78
1657666470419,CSE 175,A01,083665,Kumar; Rakesh,3,0,25,22
1657666476445,CSE 190,A00,092507,Dubnov; Shlomo,8,0,20,12
1657666482468,ECE 45,A01,083139,Congero; Spencer William,6,0,75,69
1657666488506,ECE 65,A50,083695,Saad; Andrew S,12,0,30,18
1657666488506,ECE 65,A51,095125,Saad; Andrew S,24,0,26,2
1657666494528,ECE 109,A01,091882,Touri; Behrouz,20,0,70,50
1657666500552,ECE 180,A00,083140,Abi Samra; Nicholas Camill,1,0,30,29
1657666500552,ECE 180,B00,083141,Abi Samra; Nicholas Camill,0,0,30,30
1657666506580,MATH 10A,A01,083735,Patchell; Gregory David,2,0,30,28
1657666506580,MATH 10A,A02,083736,Patchell; Gregory David,20,0,30,10
1657666506580,MATH 10A,A03,083737,Patchell; Gregory David,16,0,30,14
1657666512610,MATH 10B,A01,083207,Lim; Seonhee,8,0,34,26
1657666512610,MATH 10B,A02,083208,Lim; Seonhee,9,0,35,26
1657666512610,MATH 10B,A03,093472,Lim; Seonhee,7,0,34,27
1657666512610,MATH 10B,B01,083739,Sinha; Shubham,13,0,30,17
1657666518640,MATH 18,A01,083743,Cinel; Cameron Alexander,8,0,30,22
1657666518640,MATH 18,A02,083744,Cinel; Cameron Alexander,17,0,30,13
1657666518640,MATH 18,A03,083745,Cinel; Cameron Alexander,10,0,30,20
1657666518640,MATH 18,B01,083748,Rideout; David Porter,5,0,37,32
1657666518640,MATH 18,B02,083749,Rideout; David Porter,5,0,36,31
1657666518640,MATH 18,B03,083750,Rideout; David Porter,3,0,37,34
1657666518640,MATH 18,B04,083751,Rideout; David Porter,6,0,36,30
1657666518640,MATH 18,B05,093473,Rideout; David Porter,6,0,36,30
1657666518640,MATH 18,B06,093474,Rideout; David Porter,6,0,36,30
1657666524664,MATH 20A,A01,083754,Zheng; Zequn,14,0,40,26
1657666530704,MATH 20B,A01,083756,Briones; Jor-el Thomas Caparas,4,0,36,32
1657666530704,MATH 20B,A02,083757,Briones; Jor-el Thomas Caparas,1,0,36,35
1657666530704,MATH 20B,A03,093475,Briones; Jor-el Thomas Caparas,2,0,36,34
1657666536732,MATH 20C,A01,083760,Briones; Jor-el Thomas Caparas,1,0,35,34
1657666536732,MATH 20C,A02,083761,Briones; Jor-el Thomas Caparas,8,0,35,27
1657666536732,MATH 20C,A03,093476,Briones; Jor-el Thomas Caparas,0,1,36,36
1657666536732,MATH 20C,B01,083762,Bach; Quang Tran,1,0,30,29
1657666542762,MATH 20D,A01,083765,Tran; Brian Kha,5,0,30,25
1657666542762,MATH 20D,A02,083766,Tran; Brian Kha,5,0,30,25
1657666542762,MATH 20D,A03,083767,Tran; Brian Kha,5,0,30,25
1657666548791,MATH 20E,A01,083771,Ganguly; Soumya,9,0,32,23
1657666548791,MATH 20E,A02,083772,Ganguly; Soumya,6,0,32,26
1657666548791,MATH 20E,B01,083773,Ciotti; Benjamin,20,0,35,15
1657666548791,MATH 20E,B02,083774,Ciotti; Benjamin,18,0,35,17
1657666554813,MATH 103A,A01,083777,Greenfeld; Be'Eri,3,0,36,33
1657666554813,MATH 103A,A02,083778,Greenfeld; Be'Eri,5,0,36,31
1657666554813,MATH 103A,A03,093561,Greenfeld; Be'Eri,6,0,36,30
1657666554813,MATH 103A,B01,083779,Greenfeld; Be'Eri,7,0,36,29
1657666554813,MATH 103A,B02,083780,Greenfeld; Be'Eri,4,0,36,32
1657666554813,MATH 103A,B03,093562,Greenfeld; Be'Eri,3,0,36,33
1657666560840,MATH 105,A01,085443,Carter; Anne Toulson,15,0,35,20
1657666560840,MATH 105,A02,093477,Carter; Anne Toulson,20,0,35,15
1657666566862,MATH 109,A01,083213,Ganzberger; Geoffrey Michael,2,0,34,32
1657666566862,MATH 109,A02,083214,Ganzberger; Geoffrey Michael,4,0,34,30
1657666566862,MATH 109,A03,093478,Ganzberger; Geoffrey Michael,2,0,34,32
1657666566862,MATH 109,B01,083215,Ganzberger; Geoffrey Michael,1,0,32,31
1657666566862,MATH 109,B02,083216,Ganzberger; Geoffrey Michael,2,0,32,30
1657666566862,MATH 109,B03,093479,Ganzberger; Geoffrey Michael,8,0,32,24
1657666572893,MATH 142A,A01,083219,Chow; Bennett,7,0,32,25
1657666572893,MATH 142A,A02,083220,Chow; Bennett,10,0,32,22
1657666572893,MATH 142A,A03,093480,Chow; Bennett,9,0,32,23
1657666572893,MATH 142A,B03,093481,Chow; Bennett,8,0,32,24
1657666572893,MATH 142A,B04,093558,Chow; Bennett,13,0,32,19
1657666572893,MATH 142A,B05,093559,Chow; Bennett,6,0,32,26
1657666578920,MATH 193A,A01,083224,Rotar; Vladimir,8,0,34,26
1657666578920,MATH 193A,A02,083225,Rotar; Vladimir,9,0,34,25
1657666578920,MATH 193A,A03,083781,Rotar; Vladimir,5,0,34,29
1657666578920,MATH 193A,A04,083782,Rotar; Vladimir,10,0,34,24
1657666578920,MATH 193A,A05,093482,Rotar; Vladimir,10,0,34,24
1657666584944,MATH 197,001,091859,McAuley; Julian John,9999,0,9999,0
1657666584944,MATH 197,002,095566,Kedlaya; Kiran S.,9997,0,9999,2
1657666584944,MATH 197,003,095567,Xiao; Ming,9999,0,9999,0
1657666584944,MATH 197,004,095571,Perols; Johan Lars,9998,0,9999,1
1657666592010,COGS 9,A01,083615,Shannon; Kyle Michael,9,0,75,66
1657666598041,COGS 11,A01,083617,Boyle; Mary E. T.,23,0,48,25
1657666604068,COGS 13,A01,083071,Bastos; Amalia Pinkusfeld,11,0,71,60
1657666610094,COGS 14A,A01,092681,Semenuks; Arturs,5,1,100,95
1657666616117,COGS 14B,A01,083073,Cheng; Tzu-Han,6,0,63,57
1657666622141,COGS 17,A01,092677,Semenuks; Arturs,6,0,81,75
1657666628162,COGS 100,A01,083619,Allen; Michael Gordon,17,0,70,53
1657666634186,COGS 101A,A01,083621,Davis; Joshua Daniel,9,0,68,59
1657666640214,COGS 101B,A01,091572,Allen; Michael Gordon,12,0,65,53
1657666646240,COGS 101C,A01,083625,Delgado; Tania,17,0,35,18
1657666652277,COGS 107A,A01,083627,Boyle; Mary E. T.,13,0,60,47
1657666658306,COGS 118A,A01,083075,Gupta; Anjum,21,0,76,55
1657666664329,CSE 3,A50,083646,Miranda; Gregory Joseph,24,0,50,26
1657666670363,CSE 8A,A50,083650,Miranda; Gregory Joseph,17,1,56,39
1657666676386,CSE 11,A01,083080,Cao; Yingjun,6,15,40,34
1657666682412,CSE 12,A01,083652,Krause-Levy; Sophia Louisa,28,1,120,92
1657666688439,CSE 15L,A01,083654,Morris; Justin Loren,9,0,50,41
1657666688439,CSE 15L,A02,083655,Morris; Justin Loren,9,0,50,41
1657666694464,CSE 20,A01,083657,Tran; Khoa Dang,39,0,80,41
1657666700487,CSE 21,A01,095574,Bach; Quang Tran,22,0,48,26
1657666706515,CSE 30,A01,083084,Eldon; John,6,0,80,74
1657666706515,CSE 30,B01,095061,Bhaskar; Nishant,9,0,50,41
1657666712545,CSE 100,A01,083659,Cao; Yingjun,5,4,70,65
1657666718571,CSE 134B,A01,083661,Powell; Thomas Allan,23,0,100,77
1657666724594,CSE 140,A01,083663,Gungor; Onat,15,0,85,70
1657666730615,CSE 140L,A01,083088,Eldon; John,22,0,100,78
1657666736639,CSE 175,A01,083665,Kumar; Rakesh,3,0,25,22
1657666742664,CSE 190,A00,092507,Dubnov; Shlomo,8,0,20,12
1657666748690,ECE 45,A01,083139,Congero; Spencer William,6,0,75,69
1657666754721,ECE 65,A50,083695,Saad; Andrew S,12,0,30,18
1657666754721,ECE 65,A51,095125,Saad; Andrew S,24,0,26,2
1657666760746,ECE 109,A01,091882,Touri; Behrouz,20,0,70,50
1657666766769,ECE 180,A00,083140,Abi Samra; Nicholas Camill,1,0,30,29
1657666766769,ECE 180,B00,083141,Abi Samra; Nicholas Camill,0,0,30,30
1657666772792,MATH 10A,A01,083735,Patchell; Gregory David,2,0,30,28
1657666772792,MATH 10A,A02,083736,Patchell; Gregory David,20,0,30,10
1657666772792,MATH 10A,A03,083737,Patchell; Gregory David,16,0,30,14
1657666778815,MATH 10B,A01,083207,Lim; Seonhee,8,0,34,26
1657666778815,MATH 10B,A02,083208,Lim; Seonhee,9,0,35,26
1657666778815,MATH 10B,A03,093472,Lim; Seonhee,7,0,34,27
1657666778815,MATH 10B,B01,083739,Sinha; Shubham,13,0,30,17
1657666784848,MATH 18,A01,083743,Cinel; Cameron Alexander,8,0,30,22
1657666784848,MATH 18,A02,083744,Cinel; Cameron Alexander,17,0,30,13
1657666784848,MATH 18,A03,083745,Cinel; Cameron Alexander,10,0,30,20
1657666784848,MATH 18,B01,083748,Rideout; David Porter,5,0,37,32
1657666784848,MATH 18,B02,083749,Rideout; David Porter,5,0,36,31
1657666784848,MATH 18,B03,083750,Rideout; David Porter,3,0,37,34
1657666784848,MATH 18,B04,083751,Rideout; David Porter,6,0,36,30
1657666784848,MATH 18,B05,093473,Rideout; David Porter,6,0,36,30
1657666784848,MATH 18,B06,093474,Rideout; David Porter,6,0,36,30
1657666790873,MATH 20A,A01,083754,Zheng; Zequn,14,0,40,26
1657666796894,MATH 20B,A01,083756,Briones; Jor-el Thomas Caparas,4,0,36,32
1657666796894,MATH 20B,A02,083757,Briones; Jor-el Thomas Caparas,1,0,36,35
1657666796894,MATH 20B,A03,093475,Briones; Jor-el Thomas Caparas,2,0,36,34
1657666802926,MATH 20C,A01,083760,Briones; Jor-el Thomas Caparas,1,0,35,34
1657666802926,MATH 20C,A02,083761,Briones; Jor-el Thomas Caparas,8,0,35,27
1657666802926,MATH 20C,A03,093476,Briones; Jor-el Thomas Caparas,0,1,36,36
1657666802926,MATH 20C,B01,083762,Bach; Quang Tran,1,0,30,29
1657666808961,MATH 20D,A01,083765,Tran; Brian Kha,5,0,30,25
1657666808961,MATH 20D,A02,083766,Tran; Brian Kha,5,0,30,25
1657666808961,MATH 20D,A03,083767,Tran; Brian Kha,5,0,30,25
1657666814992,MATH 20E,A01,083771,Ganguly; Soumya,9,0,32,23
1657666814992,MATH 20E,A02,083772,Ganguly; Soumya,6,0,32,26
1657666814992,MATH 20E,B01,083773,Ciotti; Benjamin,20,0,35,15
1657666814992,MATH 20E,B02,083774,Ciotti; Benjamin,18,0,35,17
1657666821021,MATH 103A,A01,083777,Greenfeld; Be'Eri,3,0,36,33
1657666821021,MATH 103A,A02,083778,Greenfeld; Be'Eri,5,0,36,31
1657666821021,MATH 103A,A03,093561,Greenfeld; Be'Eri,6,0,36,30
1657666821021,MATH 103A,B01,083779,Greenfeld; Be'Eri,7,0,36,29
1657666821021,MATH 103A,B02,083780,Greenfeld; Be'Eri,4,0,36,32
1657666821021,MATH 103A,B03,093562,Greenfeld; Be'Eri,3,0,36,33
1657666827044,MATH 105,A01,085443,Carter; Anne Toulson,15,0,35,20
1657666827044,MATH 105,A02,093477,Carter; Anne Toulson,20,0,35,15
1657666833067,MATH 109,A01,083213,Ganzberger; Geoffrey Michael,2,0,34,32
1657666833067,MATH 109,A02,083214,Ganzberger; Geoffrey Michael,4,0,34,30
1657666833067,MATH 109,A03,093478,Ganzberger; Geoffrey Michael,2,0,34,32
1657666833067,MATH 109,B01,083215,Ganzberger; Geoffrey Michael,1,0,32,31
1657666833067,MATH 109,B02,083216,Ganzberger; Geoffrey Michael,2,0,32,30
1657666833067,MATH 109,B03,093479,Ganzberger; Geoffrey Michael,8,0,32,24
1657666839098,MATH 142A,A01,083219,Chow; Bennett,7,0,32,25
1657666839098,MATH 142A,A02,083220,Chow; Bennett,10,0,32,22
1657666839098,MATH 142A,A03,093480,Chow; Bennett,9,0,32,23
1657666839098,MATH 142A,B03,093481,Chow; Bennett,8,0,32,24
1657666839098,MATH 142A,B04,093558,Chow; Bennett,13,0,32,19
1657666839098,MATH 142A,B05,093559,Chow; Bennett,6,0,32,26
1657666845128,MATH 193A,A01,083224,Rotar; Vladimir,8,0,34,26
1657666845128,MATH 193A,A02,083225,Rotar; Vladimir,9,0,34,25
1657666845128,MATH 193A,A03,083781,Rotar; Vladimir,5,0,34,29
1657666845128,MATH 193A,A04,083782,Rotar; Vladimir,10,0,34,24
1657666845128,MATH 193A,A05,093482,Rotar; Vladimir,10,0,34,24
1657666851154,MATH 197,001,091859,McAuley; Julian John,9999,0,9999,0
1657666851154,MATH 197,002,095566,Kedlaya; Kiran S.,9997,0,9999,2
1657666851154,MATH 197,003,095567,Xiao; Ming,9999,0,9999,0
1657666851154,MATH 197,004,095571,Perols; Johan Lars,9998,0,9999,1
1657666858221,COGS 9,A01,083615,Shannon; Kyle Michael,9,0,75,66
1657666864364,COGS 11,A01,083617,Boyle; Mary E. T.,23,0,48,25
1657666870391,COGS 13,A01,083071,Bastos; Amalia Pinkusfeld,11,0,71,60
1657666876421,COGS 14A,A01,092681,Semenuks; Arturs,5,1,100,95
1657666882444,COGS 14B,A01,083073,Cheng; Tzu-Han,6,0,63,57
1657666888468,COGS 17,A01,092677,Semenuks; Arturs,6,0,81,75
1657666894494,COGS 100,A01,083619,Allen; Michael Gordon,17,0,70,53
1657666900521,COGS 101A,A01,083621,Davis; Joshua Daniel,9,0,68,59
1657666906550,COGS 101B,A01,091572,Allen; Michael Gordon,12,0,65,53
1657666912573,COGS 101C,A01,083625,Delgado; Tania,17,0,35,18
1657666918599,COGS 107A,A01,083627,Boyle; Mary E. T.,13,0,60,47
1657666924621,COGS 118A,A01,083075,Gupta; Anjum,21,0,76,55
1657666930646,CSE 3,A50,083646,Miranda; Gregory Joseph,24,0,50,26
1657666936670,CSE 8A,A50,083650,Miranda; Gregory Joseph,17,1,56,39
1657666942693,CSE 11,A01,083080,Cao; Yingjun,6,15,40,34
1657666948723,CSE 12,A01,083652,Krause-Levy; Sophia Louisa,28,1,120,92
1657666954750,CSE 15L,A01,083654,Morris; Justin Loren,9,0,50,41
1657666954750,CSE 15L,A02,083655,Morris; Justin Loren,9,0,50,41
1657666960777,CSE 20,A01,083657,Tran; Khoa Dang,39,0,80,41
1657666966803,CSE 21,A01,095574,Bach; Quang Tran,22,0,48,26
1657666972835,CSE 30,A01,083084,Eldon; John,6,0,80,74
1657666972835,CSE 30,B01,095061,Bhaskar; Nishant,9,0,50,41
1657666978871,CSE 100,A01,083659,Cao; Yingjun,5,4,70,65
1657666984894,CSE 134B,A01,083661,Powell; Thomas Allan,23,0,100,77
1657666990928,CSE 140,A01,083663,Gungor; Onat,15,0,85,70
1657666996949,CSE 140L,A01,083088,Eldon; John,22,0,100,78
1657667002971,CSE 175,A01,083665,Kumar; Rakesh,3,0,25,22
1657667008997,CSE 190,A00,092507,Dubnov; Shlomo,8,0,20,12
1657667015021,ECE 45,A01,083139,Congero; Spencer William,6,0,75,69
1657667021048,ECE 65,A50,083695,Saad; Andrew S,12,0,30,18
1657667021048,ECE 65,A51,095125,Saad; Andrew S,24,0,26,2
1657667027073,ECE 109,A01,091882,Touri; Behrouz,20,0,70,50
1657667033095,ECE 180,A00,083140,Abi Samra; Nicholas Camill,1,0,30,29
1657667033095,ECE 180,B00,083141,Abi Samra; Nicholas Camill,0,0,30,30
1657667039124,MATH 10A,A01,083735,Patchell; Gregory David,2,0,30,28
1657667039124,MATH 10A,A02,083736,Patchell; Gregory David,20,0,30,10
1657667039124,MATH 10A,A03,083737,Patchell; Gregory David,16,0,30,14
1657667045152,MATH 10B,A01,083207,Lim; Seonhee,8,0,34,26
1657667045152,MATH 10B,A02,083208,Lim; Seonhee,9,0,35,26
1657667045152,MATH 10B,A03,093472,Lim; Seonhee,7,0,34,27
1657667045152,MATH 10B,B01,083739,Sinha; Shubham,13,0,30,17
1657667051177,MATH 18,A01,083743,Cinel; Cameron Alexander,8,0,30,22
1657667051177,MATH 18,A02,083744,Cinel; Cameron Alexander,17,0,30,13
1657667051177,MATH 18,A03,083745,Cinel; Cameron Alexander,10,0,30,20
1657667051177,MATH 18,B01,083748,Rideout; David Porter,5,0,37,32
1657667051177,MATH 18,B02,083749,Rideout; David Porter,5,0,36,31
1657667051177,MATH 18,B03,083750,Rideout; David Porter,3,0,37,34
1657667051177,MATH 18,B04,083751,Rideout; David Porter,6,0,36,30
1657667051177,MATH 18,B05,093473,Rideout; David Porter,6,0,36,30
1657667051177,MATH 18,B06,093474,Rideout; David Porter,6,0,36,30
1657667057206,MATH 20A,A01,083754,Zheng; Zequn,14,0,40,26
1657667063229,MATH 20B,A01,083756,Briones; Jor-el Thomas Caparas,4,0,36,32
1657667063229,MATH 20B,A02,083757,Briones; Jor-el Thomas Caparas,1,0,36,35
1657667063229,MATH 20B,A03,093475,Briones; Jor-el Thomas Caparas,2,0,36,34
1657667069257,MATH 20C,A01,083760,Briones; Jor-el Thomas Caparas,1,0,35,34
1657667069257,MATH 20C,A02,083761,Briones; Jor-el Thomas Caparas,8,0,35,27
1657667069257,MATH 20C,A03,093476,Briones; Jor-el Thomas Caparas,0,1,36,36
1657667069257,MATH 20C,B01,083762,Bach; Quang Tran,1,0,30,29
1657667075286,MATH 20D,A01,083765,Tran; Brian Kha,5,0,30,25
1657667075286,MATH 20D,A02,083766,Tran; Brian Kha,5,0,30,25
1657667075286,MATH 20D,A03,083767,Tran; Brian Kha,5,0,30,25
1657667081316,MATH 20E,A01,083771,Ganguly; Soumya,9,0,32,23
1657667081316,MATH 20E,A02,083772,Ganguly; Soumya,6,0,32,26
1657667081316,MATH 20E,B01,083773,Ciotti; Benjamin,20,0,35,15
1657667081316,MATH 20E,B02,083774,Ciotti; Benjamin,18,0,35,17
1657667087340,MATH 103A,A01,083777,Greenfeld; Be'Eri,3,0,36,33
1657667087340,MATH 103A,A02,083778,Greenfeld; Be'Eri,5,0,36,31
1657667087340,MATH 103A,A03,093561,Greenfeld; Be'Eri,6,0,36,30
1657667087340,MATH 103A,B01,083779,Greenfeld; Be'Eri,7,0,36,29
1657667087340,MATH 103A,B02,083780,Greenfeld; Be'Eri,4,0,36,32
1657667087340,MATH 103A,B03,093562,Greenfeld; Be'Eri,3,0,36,33
1657667093364,MATH 105,A01,085443,Carter; Anne Toulson,15,0,35,20
1657667093364,MATH 105,A02,093477,Carter; Anne Toulson,20,0,35,15
1657667099389,MATH 109,A01,083213,Ganzberger; Geoffrey Michael,2,0,34,32
1657667099389,MATH 109,A02,083214,Ganzberger; Geoffrey Michael,4,0,34,30
1657667099389,MATH 109,A03,093478,Ganzberger; Geoffrey Michael,2,0,34,32
1657667099389,MATH 109,B01,083215,Ganzberger; Geoffrey Michael,1,0,32,31
1657667099389,MATH 109,B02,083216,Ganzberger; Geoffrey Michael,2,0,32,30
1657667099389,MATH 109,B03,093479,Ganzberger; Geoffrey Michael,8,0,32,24
1657667105411,MATH 142A,A01,083219,Chow; Bennett,7,0,32,25
1657667105411,MATH 142A,A02,083220,Chow; Bennett,10,0,32,22
1657667105411,MATH 142A,A03,093480,Chow; Bennett,9,0,32,23
1657667105411,MATH 142A,B03,093481,Chow; Bennett,8,0,32,24
1657667105411,MATH 142A,B04,093558,Chow; Bennett,13,0,32,19
1657667105411,MATH 142A,B05,093559,Chow; Bennett,6,0,32,26
1657667111440,MATH 193A,A01,083224,Rotar; Vladimir,8,0,34,26
1657667111440,MATH 193A,A02,083225,Rotar; Vladimir,9,0,34,25
1657667111440,MATH 193A,A03,083781,Rotar; Vladimir,5,0,34,29
1657667111440,MATH 193A,A04,083782,Rotar; Vladimir,10,0,34,24
1657667111440,MATH 193A,A05,093482,Rotar; Vladimir,10,0,34,24
1657667117461,MATH 197,001,091859,McAuley; Julian John,9999,0,9999,0
1657667117461,MATH 197,002,095566,Kedlaya; Kiran S.,9997,0,9999,2
1657667117461,MATH 197,003,095567,Xiao; Ming,9999,0,9999,0
1657667117461,MATH 197,004,095571,Perols; Johan Lars,9998,0,9999,1
1657667124516,COGS 9,A01,083615,Shannon; Kyle Michael,9,0,75,66
1657667130555,COGS 11,A01,083617,Boyle; Mary E. T.,23,0,48,25
1657667136582,COGS 13,A01,083071,Bastos; Amalia Pinkusfeld,11,0,71,60
1657667142605,COGS 14A,A01,092681,Semenuks; Arturs,5,1,100,95
1657667148628,COGS 14B,A01,083073,Cheng; Tzu-Han,6,0,63,57
1657667154650,COGS 17,A01,092677,Semenuks; Arturs,6,0,81,75
1657667160683,COGS 100,A01,083619,Allen; Michael Gordon,17,0,70,53
1657667166705,COGS 101A,A01,083621,Davis; Joshua Daniel,9,0,68,59
1657667172727,COGS 101B,A01,091572,Allen; Michael Gordon,12,0,65,53
1657667178754,COGS 101C,A01,083625,Delgado; Tania,17,0,35,18
1657667184777,COGS 107A,A01,083627,Boyle; Mary E. T.,13,0,60,47
1657667190803,COGS 118A,A01,083075,Gupta; Anjum,21,0,76,55
1657667196836,CSE 3,A50,083646,Miranda; Gregory Joseph,24,0,50,26
1657667202858,CSE 8A,A50,083650,Miranda; Gregory Joseph,17,1,56,39
1657667208884,CSE 11,A01,083080,Cao; Yingjun,6,15,40,34
1657667214911,CSE 12,A01,083652,Krause-Levy; Sophia Louisa,28,1,120,92
1657667220933,CSE 15L,A01,083654,Morris; Justin Loren,9,0,50,41
1657667220933,CSE 15L,A02,083655,Morris; Justin Loren,9,0,50,41
1657667226961,CSE 20,A01,083657,Tran; Khoa Dang,39,0,80,41
1657667232990,CSE 21,A01,095574,Bach; Quang Tran,22,0,48,26
1657667239021,CSE 30,A01,083084,Eldon; John,6,0,80,74
1657667239021,CSE 30,B01,095061,Bhaskar; Nishant,9,0,50,41
1657667245048,CSE 100,A01,083659,Cao; Yingjun,5,4,70,65
1657667251072,CSE 134B,A01,083661,Powell; Thomas Allan,23,0,100,77
1657667257097,CSE 140,A01,083663,Gungor; Onat,15,0,85,70
1657667263123,CSE 140L,A01,083088,Eldon; John,22,0,100,78
1657667269149,CSE 175,A01,083665,Kumar; Rakesh,3,0,25,22
1657667275172,CSE 190,A00,092507,Dubnov; Shlomo,8,0,20,12
1657667281195,ECE 45,A01,083139,Congero; Spencer William,6,0,75,69
1657667287217,ECE 65,A50,083695,Saad; Andrew S,12,0,30,18
1657667287217,ECE 65,A51,095125,Saad; Andrew S,24,0,26,2
1657667293245,ECE 109,A01,091882,Touri; Behrouz,20,0,70,50
1657667299275,ECE 180,A00,083140,Abi Samra; Nicholas Camill,1,0,30,29
1657667299275,ECE 180,B00,083141,Abi Samra; Nicholas Camill,0,0,30,30
1657667305306,MATH 10A,A01,083735,Patchell; Gregory David,2,0,30,28
1657667305306,MATH 10A,A02,083736,Patchell; Gregory David,20,0,30,10
1657667305306,MATH 10A,A03,083737,Patchell; Gregory David,16,0,30,14
1657667311330,MATH 10B,A01,083207,Lim; Seonhee,8,0,34,26
1657667311330,MATH 10B,A02,083208,Lim; Seonhee,9,0,35,26
1657667311330,MATH 10B,A03,093472,Lim; Seonhee,7,0,34,27
1657667311330,MATH 10B,B01,083739,Sinha; Shubham,13,0,30,17
1657667317362,MATH 18,A01,083743,Cinel; Cameron Alexander,8,0,30,22
1657667317362,MATH 18,A02,083744,Cinel; Cameron Alexander,17,0,30,13
1657667317362,MATH 18,A03,083745,Cinel; Cameron Alexander,10,0,30,20
1657667317362,MATH 18,B01,083748,Rideout; David Porter,5,0,37,32
1657667317362,MATH 18,B02,083749,Rideout; David Porter,5,0,36,31
1657667317362,MATH 18,B03,083750,Rideout; David Porter,3,0,37,34
1657667317362,MATH 18,B04,083751,Rideout; David Porter,6,0,36,30
1657667317362,MATH 18,B05,093473,Rideout; David Porter,6,0,36,30
1657667317362,MATH 18,B06,093474,Rideout; David Porter,6,0,36,30
1657667323389,MATH 20A,A01,083754,Zheng; Zequn,14,0,40,26
1657667329415,MATH 20B,A01,083756,Briones; Jor-el Thomas Caparas,4,0,36,32
1657667329415,MATH 20B,A02,083757,Briones; Jor-el Thomas Caparas,1,0,36,35
1657667329415,MATH 20B,A03,093475,Briones; Jor-el Thomas Caparas,2,0,36,34
1657667335439,MATH 20C,A01,083760,Briones; Jor-el Thomas Caparas,1,0,35,34
1657667335439,MATH 20C,A02,083761,Briones; Jor-el Thomas Caparas,8,0,35,27
1657667335439,MATH 20C,A03,093476,Briones; Jor-el Thomas Caparas,0,1,36,36
1657667335439,MATH 20C,B01,083762,Bach; Quang Tran,1,0,30,29
1657667341468,MATH 20D,A01,083765,Tran; Brian Kha,5,0,30,25
1657667341468,MATH 20D,A02,083766,Tran; Brian Kha,5,0,30,25
1657667341468,MATH 20D,A03,083767,Tran; Brian Kha,5,0,30,25
1657667347500,MATH 20E,A01,083771,Ganguly; Soumya,9,0,32,23
1657667347500,MATH 20E,A02,083772,Ganguly; Soumya,6,0,32,26
1657667347500,MATH 20E,B01,083773,Ciotti; Benjamin,20,0,35,15
1657667347500,MATH 20E,B02,083774,Ciotti; Benjamin,18,0,35,17
1657667353523,MATH 103A,A01,083777,Greenfeld; Be'Eri,3,0,36,33
1657667353523,MATH 103A,A02,083778,Greenfeld; Be'Eri,5,0,36,31
1657667353523,MATH 103A,A03,093561,Greenfeld; Be'Eri,6,0,36,30
1657667353523,MATH 103A,B01,083779,Greenfeld; Be'Eri,7,0,36,29
1657667353523,MATH 103A,B02,083780,Greenfeld; Be'Eri,4,0,36,32
1657667353523,MATH 103A,B03,093562,Greenfeld; Be'Eri,3,0,36,33
1657667359552,MATH 105,A01,085443,Carter; Anne Toulson,15,0,35,20
1657667359552,MATH 105,A02,093477,Carter; Anne Toulson,20,0,35,15
1657667365588,MATH 109,A01,083213,Ganzberger; Geoffrey Michael,2,0,34,32
1657667365588,MATH 109,A02,083214,Ganzberger; Geoffrey Michael,4,0,34,30
1657667365588,MATH 109,A03,093478,Ganzberger; Geoffrey Michael,2,0,34,32
1657667365588,MATH 109,B01,083215,Ganzberger; Geoffrey Michael,1,0,32,31
1657667365588,MATH 109,B02,083216,Ganzberger; Geoffrey Michael,2,0,32,30
1657667365588,MATH 109,B03,093479,Ganzberger; Geoffrey Michael,8,0,32,24
1657667371626,MATH 142A,A01,083219,Chow; Bennett,7,0,32,25
1657667371626,MATH 142A,A02,083220,Chow; Bennett,10,0,32,22
1657667371626,MATH 142A,A03,093480,Chow; Bennett,9,0,32,23
1657667371626,MATH 142A,B03,093481,Chow; Bennett,8,0,32,24
1657667371626,MATH 142A,B04,093558,Chow; Bennett,13,0,32,19
1657667371626,MATH 142A,B05,093559,Chow; Bennett,6,0,32,26
1657667377648,MATH 193A,A01,083224,Rotar; Vladimir,8,0,34,26
1657667377648,MATH 193A,A02,083225,Rotar; Vladimir,9,0,34,25
1657667377648,MATH 193A,A03,083781,Rotar; Vladimir,5,0,34,29
1657667377648,MATH 193A,A04,083782,Rotar; Vladimir,10,0,34,24
1657667377648,MATH 193A,A05,093482,Rotar; Vladimir,10,0,34,24
1657667383673,MATH 197,001,091859,McAuley; Julian John,9999,0,9999,0
1657667383673,MATH 197,002,095566,Kedlaya; Kiran S.,9997,0,9999,2
1657667383673,MATH 197,003,095567,Xiao; Ming,9999,0,9999,0
1657667383673,MATH 197,004,095571,Perols; Johan Lars,9998,0,9999,1
1657667390730,COGS 9,A01,083615,Shannon; Kyle Michael,9,0,75,66
1657667396764,COGS 11,A01,083617,Boyle; Mary E. T.,23,0,48,25
1657667402789,COGS 13,A01,083071,Bastos; Amalia Pinkusfeld,11,0,71,60
1657667408813,COGS 14A,A01,092681,Semenuks; Arturs,5,1,100,95
1657667414847,COGS 14B,A01,083073,Cheng; Tzu-Han,6,0,63,57
1657667420870,COGS 17,A01,092677,Semenuks; Arturs,6,0,81,75
1657667426897,COGS 100,A01,083619,Allen; Michael Gordon,17,0,70,53
1657667432920,COGS 101A,A01,083621,Davis; Joshua Daniel,9,0,68,59
1657667438989,COGS 101B,A01,091572,Allen; Michael Gordon,12,0,65,53
1657667445012,COGS 101C,A01,083625,Delgado; Tania,17,0,35,18
1657667451036,COGS 107A,A01,083627,Boyle; Mary E. T.,13,0,60,47
1657667457062,COGS 118A,A01,083075,Gupta; Anjum,21,0,76,55
1657667463184,CSE 3,A50,083646,Miranda; Gregory Joseph,24,0,50,26
1657667469212,CSE 8A,A50,083650,Miranda; Gregory Joseph,17,1,56,39
1657667475234,CSE 11,A01,083080,Cao; Yingjun,6,15,40,34
1657667481261,CSE 12,A01,083652,Krause-Levy; Sophia Louisa,28,1,120,92
1657667487286,CSE 15L,A01,083654,Morris; Justin Loren,9,0,50,41
1657667487286,CSE 15L,A02,083655,Morris; Justin Loren,9,0,50,41
1657667493310,CSE 20,A01,083657,Tran; Khoa Dang,39,0,80,41
1657667499335,CSE 21,A01,095574,Bach; Quang Tran,22,0,48,26
1657667505361,CSE 30,A01,083084,Eldon; John,6,0,80,74
1657667505361,CSE 30,B01,095061,Bhaskar; Nishant,9,0,50,41
1657667511384,CSE 100,A01,083659,Cao; Yingjun,5,4,70,65
1657667517410,CSE 134B,A01,083661,Powell; Thomas Allan,23,0,100,77
1657667523435,CSE 140,A01,083663,Gungor; Onat,15,0,85,70
1657667529461,CSE 140L,A01,083088,Eldon; John,22,0,100,78
1657667535485,CSE 175,A01,083665,Kumar; Rakesh,3,0,25,22
1657667541510,CSE 190,A00,092507,Dubnov; Shlomo,8,0,20,12
1657667547532,ECE 45,A01,083139,Congero; Spencer William,6,0,75,69
1657667553560,ECE 65,A50,083695,Saad; Andrew S,12,0,30,18
1657667553560,ECE 65,A51,095125,Saad; Andrew S,24,0,26,2
1657667559590,ECE 109,A01,091882,Touri; Behrouz,20,0,70,50
1657667565614,ECE 180,A00,083140,Abi Samra; Nicholas Camill,1,0,30,29
1657667565614,ECE 180,B00,083141,Abi Samra; Nicholas Camill,0,0,30,30
1657667571637,MATH 10A,A01,083735,Patchell; Gregory David,2,0,30,28
1657667571637,MATH 10A,A02,083736,Patchell; Gregory David,20,0,30,10
1657667571637,MATH 10A,A03,083737,Patchell; Gregory David,16,0,30,14
1657667577662,MATH 10B,A01,083207,Lim; Seonhee,8,0,34,26
1657667577662,MATH 10B,A02,083208,Lim; Seonhee,9,0,35,26
1657667577662,MATH 10B,A03,093472,Lim; Seonhee,7,0,34,27
1657667577662,MATH 10B,B01,083739,Sinha; Shubham,13,0,30,17
1657667583685,MATH 18,A01,083743,Cinel; Cameron Alexander,8,0,30,22
1657667583685,MATH 18,A02,083744,Cinel; Cameron Alexander,17,0,30,13
1657667583685,MATH 18,A03,083745,Cinel; Cameron Alexander,10,0,30,20
1657667583685,MATH 18,B01,083748,Rideout; David Porter,5,0,37,32
1657667583685,MATH 18,B02,083749,Rideout; David Porter,5,0,36,31
1657667583685,MATH 18,B03,083750,Rideout; David Porter,3,0,37,34
1657667583685,MATH 18,B04,083751,Rideout; David Porter,6,0,36,30
1657667583685,MATH 18,B05,093473,Rideout; David Porter,6,0,36,30
1657667583685,MATH 18,B06,093474,Rideout; David Porter,6,0,36,30
1657667589718,MATH 20A,A01,083754,Zheng; Zequn,14,0,40,26
1657667595753,MATH 20B,A01,083756,Briones; Jor-el Thomas Caparas,4,0,36,32
1657667595753,MATH 20B,A02,083757,Briones; Jor-el Thomas Caparas,1,0,36,35
1657667595753,MATH 20B,A03,093475,Briones; Jor-el Thomas Caparas,2,0,36,34
1657667601780,MATH 20C,A01,083760,Briones; Jor-el Thomas Caparas,1,0,35,34
1657667601780,MATH 20C,A02,083761,Briones; Jor-el Thomas Caparas,8,0,35,27
1657667601780,MATH 20C,A03,093476,Briones; Jor-el Thomas Caparas,0,1,36,36
1657667601780,MATH 20C,B01,083762,Bach; Quang Tran,1,0,30,29
1657667607803,MATH 20D,A01,083765,Tran; Brian Kha,5,0,30,25
1657667607803,MATH 20D,A02,083766,Tran; Brian Kha,5,0,30,25
1657667607803,MATH 20D,A03,083767,Tran; Brian Kha,5,0,30,25
1657667613837,MATH 20E,A01,083771,Ganguly; Soumya,9,0,32,23
1657667613837,MATH 20E,A02,083772,Ganguly; Soumya,6,0,32,26
1657667613837,MATH 20E,B01,083773,Ciotti; Benjamin,20,0,35,15
1657667613837,MATH 20E,B02,083774,Ciotti; Benjamin,18,0,35,17
1657667619871,MATH 103A,A01,083777,Greenfeld; Be'Eri,3,0,36,33
1657667619871,MATH 103A,A02,083778,Greenfeld; Be'Eri,5,0,36,31
1657667619871,MATH 103A,A03,093561,Greenfeld; Be'Eri,6,0,36,30
1657667619871,MATH 103A,B01,083779,Greenfeld; Be'Eri,7,0,36,29
1657667619871,MATH 103A,B02,083780,Greenfeld; Be'Eri,4,0,36,32
1657667619871,MATH 103A,B03,093562,Greenfeld; Be'Eri,3,0,36,33
1657667625893,MATH 105,A01,085443,Carter; Anne Toulson,15,0,35,20
1657667625893,MATH 105,A02,093477,Carter; Anne Toulson,20,0,35,15
1657667631920,MATH 109,A01,083213,Ganzberger; Geoffrey Michael,2,0,34,32
1657667631920,MATH 109,A02,083214,Ganzberger; Geoffrey Michael,4,0,34,30
1657667631920,MATH 109,A03,093478,Ganzberger; Geoffrey Michael,2,0,34,32
1657667631920,MATH 109,B01,083215,Ganzberger; Geoffrey Michael,1,0,32,31
1657667631920,MATH 109,B02,083216,Ganzberger; Geoffrey Michael,2,0,32,30
1657667631920,MATH 109,B03,093479,Ganzberger; Geoffrey Michael,8,0,32,24
1657667637949,MATH 142A,A01,083219,Chow; Bennett,7,0,32,25
1657667637949,MATH 142A,A02,083220,Chow; Bennett,10,0,32,22
1657667637949,MATH 142A,A03,093480,Chow; Bennett,9,0,32,23
1657667637949,MATH 142A,B03,093481,Chow; Bennett,8,0,32,24
1657667637949,MATH 142A,B04,093558,Chow; Bennett,13,0,32,19
1657667637949,MATH 142A,B05,093559,Chow; Bennett,6,0,32,26
1657667643985,MATH 193A,A01,083224,Rotar; Vladimir,8,0,34,26
1657667643985,MATH 193A,A02,083225,Rotar; Vladimir,9,0,34,25
1657667643985,MATH 193A,A03,083781,Rotar; Vladimir,5,0,34,29
1657667643985,MATH 193A,A04,083782,Rotar; Vladimir,10,0,34,24
1657667643985,MATH 193A,A05,093482,Rotar; Vladimir,10,0,34,24
1657667650013,MATH 197,001,091859,McAuley; Julian John,9999,0,9999,0
1657667650013,MATH 197,002,095566,Kedlaya; Kiran S.,9997,0,9999,2
1657667650013,MATH 197,003,095567,Xiao; Ming,9999,0,9999,0
1657667650013,MATH 197,004,095571,Perols; Johan Lars,9998,0,9999,1
1657667657067,COGS 9,A01,083615,Shannon; Kyle Michael,9,0,75,66
1657667663090,COGS 11,A01,083617,Boyle; Mary E. T.,23,0,48,25
1657667669113,COGS 13,A01,083071,Bastos; Amalia Pinkusfeld,11,0,71,60
1657667675139,COGS 14A,A01,092681,Semenuks; Arturs,5,1,100,95
1657667681163,COGS 14B,A01,083073,Cheng; Tzu-Han,6,0,63,57
1657667687189,COGS 17,A01,092677,Semenuks; Arturs,6,0,81,75
1657667693211,COGS 100,A01,083619,Allen; Michael Gordon,17,0,70,53
1657667699244,COGS 101A,A01,083621,Davis; Joshua Daniel,9,0,68,59
1657667705276,COGS 101B,A01,091572,Allen; Michael Gordon,12,0,65,53
1657667711299,COGS 101C,A01,083625,Delgado; Tania,17,0,35,18
1657667717321,COGS 107A,A01,083627,Boyle; Mary E. T.,13,0,60,47
1657667723346,COGS 118A,A01,083075,Gupta; Anjum,21,0,76,55
1657667729374,CSE 3,A50,083646,Miranda; Gregory Joseph,24,0,50,26
1657667735401,CSE 8A,A50,083650,Miranda; Gregory Joseph,17,1,56,39
1657667741427,CSE 11,A01,083080,Cao; Yingjun,6,15,40,34
1657667747449,CSE 12,A01,083652,Krause-Levy; Sophia Louisa,28,1,120,92
1657667753482,CSE 15L,A01,083654,Morris; Justin Loren,9,0,50,41
1657667753482,CSE 15L,A02,083655,Morris; Justin Loren,9,0,50,41
1657667759508,CSE 20,A01,083657,Tran; Khoa Dang,39,0,80,41
1657667765540,CSE 21,A01,095574,Bach; Quang Tran,22,0,48,26
1657667771567,CSE 30,A01,083084,Eldon; John,6,0,80,74
1657667771567,CSE 30,B01,095061,Bhaskar; Nishant,9,0,50,41
1657667777589,CSE 100,A01,083659,Cao; Yingjun,5,4,70,65
1657667783614,CSE 134B,A01,083661,Powell; Thomas Allan,23,0,100,77
1657667789643,CSE 140,A01,083663,Gungor; Onat,15,0,85,70
1657667795669,CSE 140L,A01,083088,Eldon; John,22,0,100,78
1657667801693,CSE 175,A01,083665,Kumar; Rakesh,3,0,25,22
1657667807715,CSE 190,A00,092507,Dubnov; Shlomo,8,0,20,12
1657667813742,ECE 45,A01,083139,Congero; Spencer William,6,0,75,69
1657667819769,ECE 65,A50,083695,Saad; Andrew S,12,0,30,18
1657667819769,ECE 65,A51,095125,Saad; Andrew S,24,0,26,2
1657667825793,ECE 109,A01,091882,Touri; Behrouz,20,0,70,50
1657667831817,ECE 180,A00,083140,Abi Samra; Nicholas Camill,1,0,30,29
1657667831817,ECE 180,B00,083141,Abi Samra; Nicholas Camill,0,0,30,30
1657667837840,MATH 10A,A01,083735,Patchell; Gregory David,2,0,30,28
1657667837840,MATH 10A,A02,083736,Patchell; Gregory David,20,0,30,10
1657667837840,MATH 10A,A03,083737,Patchell; Gregory David,16,0,30,14
1657667843862,MATH 10B,A01,083207,Lim; Seonhee,8,0,34,26
1657667843862,MATH 10B,A02,083208,Lim; Seonhee,9,0,35,26
1657667843862,MATH 10B,A03,093472,Lim; Seonhee,7,0,34,27
1657667843862,MATH 10B,B01,083739,Sinha; Shubham,13,0,30,17
1657667849904,MATH 18,A01,083743,Cinel; Cameron Alexander,8,0,30,22
1657667849904,MATH 18,A02,083744,Cinel; Cameron Alexander,17,0,30,13
1657667849904,MATH 18,A03,083745,Cinel; Cameron Alexander,10,0,30,20
1657667849904,MATH 18,B01,083748,Rideout; David Porter,5,0,37,32
1657667849904,MATH 18,B02,083749,Rideout; David Porter,5,0,36,31
1657667849904,MATH 18,B03,083750,Rideout; David Porter,3,0,37,34
1657667849904,MATH 18,B04,083751,Rideout; David Porter,6,0,36,30
1657667849904,MATH 18,B05,093473,Rideout; David Porter,6,0,36,30
1657667849904,MATH 18,B06,093474,Rideout; David Porter,6,0,36,30
1657667855927,MATH 20A,A01,083754,Zheng; Zequn,14,0,40,26
1657667861954,MATH 20B,A01,083756,Briones; Jor-el Thomas Caparas,4,0,36,32
1657667861954,MATH 20B,A02,083757,Briones; Jor-el Thomas Caparas,1,0,36,35
1657667861954,MATH 20B,A03,093475,Briones; Jor-el Thomas Caparas,2,0,36,34
1657667867981,MATH 20C,A01,083760,Briones; Jor-el Thomas Caparas,1,0,35,34
1657667867981,MATH 20C,A02,083761,Briones; Jor-el Thomas Caparas,8,0,35,27
1657667867981,MATH 20C,A03,093476,Briones; Jor-el Thomas Caparas,0,1,36,36
1657667867981,MATH 20C,B01,083762,Bach; Quang Tran,1,0,30,29
1657667874011,MATH 20D,A01,083765,Tran; Brian Kha,5,0,30,25
1657667874011,MATH 20D,A02,083766,Tran; Brian Kha,5,0,30,25
1657667874011,MATH 20D,A03,083767,Tran; Brian Kha,5,0,30,25
1657667880039,MATH 20E,A01,083771,Ganguly; Soumya,9,0,32,23
1657667880039,MATH 20E,A02,083772,Ganguly; Soumya,6,0,32,26
1657667880039,MATH 20E,B01,083773,Ciotti; Benjamin,20,0,35,15
1657667880039,MATH 20E,B02,083774,Ciotti; Benjamin,18,0,35,17
1657667886062,MATH 103A,A01,083777,Greenfeld; Be'Eri,3,0,36,33
1657667886062,MATH 103A,A02,083778,Greenfeld; Be'Eri,5,0,36,31
1657667886062,MATH 103A,A03,093561,Greenfeld; Be'Eri,6,0,36,30
1657667886062,MATH 103A,B01,083779,Greenfeld; Be'Eri,7,0,36,29
1657667886062,MATH 103A,B02,083780,Greenfeld; Be'Eri,4,0,36,32
1657667886062,MATH 103A,B03,093562,Greenfeld; Be'Eri,3,0,36,33
1657667892090,MATH 105,A01,085443,Carter; Anne Toulson,15,0,35,20
1657667892090,MATH 105,A02,093477,Carter; Anne Toulson,20,0,35,15
1657667898119,MATH 109,A01,083213,Ganzberger; Geoffrey Michael,2,0,34,32
1657667898119,MATH 109,A02,083214,Ganzberger; Geoffrey Michael,4,0,34,30
1657667898119,MATH 109,A03,093478,Ganzberger; Geoffrey Michael,2,0,34,32
1657667898119,MATH 109,B01,083215,Ganzberger; Geoffrey Michael,1,0,32,31
1657667898119,MATH 109,B02,083216,Ganzberger; Geoffrey Michael,2,0,32,30
1657667898119,MATH 109,B03,093479,Ganzberger; Geoffrey Michael,8,0,32,24
1657667904148,MATH 142A,A01,083219,Chow; Bennett,7,0,32,25
1657667904148,MATH 142A,A02,083220,Chow; Bennett,10,0,32,22
1657667904148,MATH 142A,A03,093480,Chow; Bennett,9,0,32,23
1657667904148,MATH 142A,B03,093481,Chow; Bennett,8,0,32,24
1657667904148,MATH 142A,B04,093558,Chow; Bennett,13,0,32,19
1657667904148,MATH 142A,B05,093559,Chow; Bennett,6,0,32,26
1657667910175,MATH 193A,A01,083224,Rotar; Vladimir,8,0,34,26
1657667910175,MATH 193A,A02,083225,Rotar; Vladimir,9,0,34,25
1657667910175,MATH 193A,A03,083781,Rotar; Vladimir,5,0,34,29
1657667910175,MATH 193A,A04,083782,Rotar; Vladimir,10,0,34,24
1657667910175,MATH 193A,A05,093482,Rotar; Vladimir,10,0,34,24
1657667916198,MATH 197,001,091859,McAuley; Julian John,9999,0,9999,0
1657667916198,MATH 197,002,095566,Kedlaya; Kiran S.,9997,0,9999,2
1657667916198,MATH 197,003,095567,Xiao; Ming,9999,0,9999,0
1657667916198,MATH 197,004,095571,Perols; Johan Lars,9998,0,9999,1
1657667923257,COGS 9,A01,083615,Shannon; Kyle Michael,9,0,75,66
1657667929278,COGS 11,A01,083617,Boyle; Mary E. T.,23,0,48,25
1657667935303,COGS 13,A01,083071,Bastos; Amalia Pinkusfeld,11,0,71,60
1657667941329,COGS 14A,A01,092681,Semenuks; Arturs,5,1,100,95
1657667947351,COGS 14B,A01,083073,Cheng; Tzu-Han,6,0,63,57
1657667953376,COGS 17,A01,092677,Semenuks; Arturs,6,0,81,75
1657667959409,COGS 100,A01,083619,Allen; Michael Gordon,17,0,70,53
1657667965433,COGS 101A,A01,083621,Davis; Joshua Daniel,9,0,68,59
1657667971458,COGS 101B,A01,091572,Allen; Michael Gordon,12,0,65,53
1657667977487,COGS 101C,A01,083625,Delgado; Tania,17,0,35,18
1657667983517,COGS 107A,A01,083627,Boyle; Mary E. T.,13,0,60,47
1657667989545,COGS 118A,A01,083075,Gupta; Anjum,21,0,76,55
1657667995572,CSE 3,A50,083646,Miranda; Gregory Joseph,24,0,50,26
1657668001594,CSE 8A,A50,083650,Miranda; Gregory Joseph,17,1,56,39
1657668007617,CSE 11,A01,083080,Cao; Yingjun,6,15,40,34
1657668013644,CSE 12,A01,083652,Krause-Levy; Sophia Louisa,28,1,120,92
1657668019673,CSE 15L,A01,083654,Morris; Justin Loren,9,0,50,41
1657668019673,CSE 15L,A02,083655,Morris; Justin Loren,9,0,50,41
1657668025704,CSE 20,A01,083657,Tran; Khoa Dang,39,0,80,41
1657668031725,CSE 21,A01,095574,Bach; Quang Tran,22,0,48,26
1657668037751,CSE 30,A01,083084,Eldon; John,6,0,80,74
1657668037751,CSE 30,B01,095061,Bhaskar; Nishant,9,0,50,41
1657668043777,CSE 100,A01,083659,Cao; Yingjun,5,4,70,65
1657668049804,CSE 134B,A01,083661,Powell; Thomas Allan,23,0,100,77
1657668055827,CSE 140,A01,083663,Gungor; Onat,15,0,85,70
1657668061949,CSE 140L,A01,083088,Eldon; John,22,0,100,78
1657668067971,CSE 175,A01,083665,Kumar; Rakesh,3,0,25,22
1657668073995,CSE 190,A00,092507,Dubnov; Shlomo,8,0,20,12
1657668080017,ECE 45,A01,083139,Congero; Spencer William,6,0,75,69
1657668086045,ECE 65,A50,083695,Saad; Andrew S,12,0,30,18
1657668086045,ECE 65,A51,095125,Saad; Andrew S,24,0,26,2
1657668092068,ECE 109,A01,091882,Touri; Behrouz,20,0,70,50
1657668098092,ECE 180,A00,083140,Abi Samra; Nicholas Camill,1,0,30,29
1657668098092,ECE 180,B00,083141,Abi Samra; Nicholas Camill,0,0,30,30
1657668104117,MATH 10A,A01,083735,Patchell; Gregory David,2,0,30,28
1657668104117,MATH 10A,A02,083736,Patchell; Gregory David,20,0,30,10
1657668104117,MATH 10A,A03,083737,Patchell; Gregory David,16,0,30,14
1657668110141,MATH 10B,A01,083207,Lim; Seonhee,8,0,34,26
1657668110141,MATH 10B,A02,083208,Lim; Seonhee,9,0,35,26
1657668110141,MATH 10B,A03,093472,Lim; Seonhee,7,0,34,27
1657668110141,MATH 10B,B01,083739,Sinha; Shubham,13,0,30,17
1657668116172,MATH 18,A01,083743,Cinel; Cameron Alexander,8,0,30,22
1657668116172,MATH 18,A02,083744,Cinel; Cameron Alexander,17,0,30,13
1657668116172,MATH 18,A03,083745,Cinel; Cameron Alexander,10,0,30,20
1657668116172,MATH 18,B01,083748,Rideout; David Porter,5,0,37,32
1657668116172,MATH 18,B02,083749,Rideout; David Porter,5,0,36,31
1657668116172,MATH 18,B03,083750,Rideout; David Porter,3,0,37,34
1657668116172,MATH 18,B04,083751,Rideout; David Porter,6,0,36,30
1657668116172,MATH 18,B05,093473,Rideout; David Porter,6,0,36,30
1657668116172,MATH 18,B06,093474,Rideout; David Porter,6,0,36,30
1657668122199,MATH 20A,A01,083754,Zheng; Zequn,14,0,40,26
1657668128224,MATH 20B,A01,083756,Briones; Jor-el Thomas Caparas,4,0,36,32
1657668128224,MATH 20B,A02,083757,Briones; Jor-el Thomas Caparas,1,0,36,35
1657668128224,MATH 20B,A03,093475,Briones; Jor-el Thomas Caparas,2,0,36,34
1657668134248,MATH 20C,A01,083760,Briones; Jor-el Thomas Caparas,1,0,35,34
1657668134248,MATH 20C,A02,083761,Briones; Jor-el Thomas Caparas,8,0,35,27
1657668134248,MATH 20C,A03,093476,Briones; Jor-el Thomas Caparas,0,1,36,36
1657668134248,MATH 20C,B01,083762,Bach; Quang Tran,1,0,30,29
1657668140273,MATH 20D,A01,083765,Tran; Brian Kha,5,0,30,25
1657668140273,MATH 20D,A02,083766,Tran; Brian Kha,5,0,30,25
1657668140273,MATH 20D,A03,083767,Tran; Brian Kha,5,0,30,25
1657668146302,MATH 20E,A01,083771,Ganguly; Soumya,9,0,32,23
1657668146302,MATH 20E,A02,083772,Ganguly; Soumya,6,0,32,26
1657668146302,MATH 20E,B01,083773,Ciotti; Benjamin,20,0,35,15
1657668146302,MATH 20E,B02,083774,Ciotti; Benjamin,18,0,35,17
1657668152327,MATH 103A,A01,083777,Greenfeld; Be'Eri,3,0,36,33
1657668152327,MATH 103A,A02,083778,Greenfeld; Be'Eri,5,0,36,31
1657668152327,MATH 103A,A03,093561,Greenfeld; Be'Eri,6,0,36,30
1657668152327,MATH 103A,B01,083779,Greenfeld; Be'Eri,7,0,36,29
1657668152327,MATH 103A,B02,083780,Greenfeld; Be'Eri,4,0,36,32
1657668152327,MATH 103A,B03,093562,Greenfeld; Be'Eri,3,0,36,33
1657668158356,MATH 105,A01,085443,Carter; Anne Toulson,15,0,35,20
1657668158356,MATH 105,A02,093477,Carter; Anne Toulson,20,0,35,15
1657668164384,MATH 109,A01,083213,Ganzberger; Geoffrey Michael,2,0,34,32
1657668164384,MATH 109,A02,083214,Ganzberger; Geoffrey Michael,4,0,34,30
1657668164384,MATH 109,A03,093478,Ganzberger; Geoffrey Michael,2,0,34,32
1657668164384,MATH 109,B01,083215,Ganzberger; Geoffrey Michael,1,0,32,31
1657668164384,MATH 109,B02,083216,Ganzberger; Geoffrey Michael,2,0,32,30
1657668164384,MATH 109,B03,093479,Ganzberger; Geoffrey Michael,8,0,32,24
1657668170408,MATH 142A,A01,083219,Chow; Bennett,7,0,32,25
1657668170408,MATH 142A,A02,083220,Chow; Bennett,10,0,32,22
1657668170408,MATH 142A,A03,093480,Chow; Bennett,9,0,32,23
1657668170408,MATH 142A,B03,093481,Chow; Bennett,8,0,32,24
1657668170408,MATH 142A,B04,093558,Chow; Bennett,13,0,32,19
1657668170408,MATH 142A,B05,093559,Chow; Bennett,6,0,32,26
1657668176438,MATH 193A,A01,083224,Rotar; Vladimir,8,0,34,26
1657668176438,MATH 193A,A02,083225,Rotar; Vladimir,9,0,34,25
1657668176438,MATH 193A,A03,083781,Rotar; Vladimir,5,0,34,29
1657668176438,MATH 193A,A04,083782,Rotar; Vladimir,10,0,34,24
1657668176438,MATH 193A,A05,093482,Rotar; Vladimir,10,0,34,24
1657668182466,MATH 197,001,091859,McAuley; Julian John,9999,0,9999,0
1657668182466,MATH 197,002,095566,Kedlaya; Kiran S.,9997,0,9999,2
1657668182466,MATH 197,003,095567,Xiao; Ming,9999,0,9999,0
1657668182466,MATH 197,004,095571,Perols; Johan Lars,9998,0,9999,1
1657668189529,COGS 9,A01,083615,Shannon; Kyle Michael,9,0,75,66
1657668195557,COGS 11,A01,083617,Boyle; Mary E. T.,23,0,48,25
1657668201588,COGS 13,A01,083071,Bastos; Amalia Pinkusfeld,11,0,71,60
1657668207618,COGS 14A,A01,092681,Semenuks; Arturs,5,1,100,95
1657668213641,COGS 14B,A01,083073,Cheng; Tzu-Han,6,0,63,57
1657668219665,COGS 17,A01,092677,Semenuks; Arturs,6,0,81,75
1657668225688,COGS 100,A01,083619,Allen; Michael Gordon,17,0,70,53
1657668231715,COGS 101A,A01,083621,Davis; Joshua Daniel,9,0,68,59
1657668237738,COGS 101B,A01,091572,Allen; Michael Gordon,12,0,65,53
1657668243760,COGS 101C,A01,083625,Delgado; Tania,17,0,35,18
1657668249792,COGS 107A,A01,083627,Boyle; Mary E. T.,13,0,60,47
1657668255814,COGS 118A,A01,083075,Gupta; Anjum,21,0,76,55
1657668261843,CSE 3,A50,083646,Miranda; Gregory Joseph,24,0,50,26
1657668267865,CSE 8A,A50,083650,Miranda; Gregory Joseph,17,1,56,39
1657668273899,CSE 11,A01,083080,Cao; Yingjun,6,15,40,34
1657668279929,CSE 12,A01,083652,Krause-Levy; Sophia Louisa,28,1,120,92
1657668285958,CSE 15L,A01,083654,Morris; Justin Loren,9,0,50,41
1657668285958,CSE 15L,A02,083655,Morris; Justin Loren,9,0,50,41
1657668291979,CSE 20,A01,083657,Tran; Khoa Dang,39,0,80,41
1657668298004,CSE 21,A01,095574,Bach; Quang Tran,22,0,48,26
1657668304029,CSE 30,A01,083084,Eldon; John,6,0,80,74
1657668304029,CSE 30,B01,095061,Bhaskar; Nishant,9,0,50,41
1657668310051,CSE 100,A01,083659,Cao; Yingjun,5,4,70,65
1657668316078,CSE 134B,A01,083661,Powell; Thomas Allan,23,0,100,77
1657668322102,CSE 140,A01,083663,Gungor; Onat,15,0,85,70
1657668328128,CSE 140L,A01,083088,Eldon; John,22,0,100,78
1657668334152,CSE 175,A01,083665,Kumar; Rakesh,3,0,25,22
1657668340178,CSE 190,A00,092507,Dubnov; Shlomo,8,0,20,12
1657668346201,ECE 45,A01,083139,Congero; Spencer William,6,0,75,69
1657668352228,ECE 65,A50,083695,Saad; Andrew S,12,0,30,18
1657668352228,ECE 65,A51,095125,Saad; Andrew S,24,0,26,2
1657668358252,ECE 109,A01,091882,Touri; Behrouz,20,0,70,50
1657668364275,ECE 180,A00,083140,Abi Samra; Nicholas Camill,1,0,30,29
1657668364275,ECE 180,B00,083141,Abi Samra; Nicholas Camill,0,0,30,30
1657668370301,MATH 10A,A01,083735,Patchell; Gregory David,2,0,30,28
1657668370301,MATH 10A,A02,083736,Patchell; Gregory David,20,0,30,10
1657668370301,MATH 10A,A03,083737,Patchell; Gregory David,16,0,30,14
1657668376328,MATH 10B,A01,083207,Lim; Seonhee,8,0,34,26
1657668376328,MATH 10B,A02,083208,Lim; Seonhee,9,0,35,26
1657668376328,MATH 10B,A03,093472,Lim; Seonhee,7,0,34,27
1657668376328,MATH 10B,B01,083739,Sinha; Shubham,13,0,30,17
1657668382355,MATH 18,A01,083743,Cinel; Cameron Alexander,8,0,30,22
1657668382355,MATH 18,A02,083744,Cinel; Cameron Alexander,17,0,30,13
1657668382355,MATH 18,A03,083745,Cinel; Cameron Alexander,10,0,30,20
1657668382355,MATH 18,B01,083748,Rideout; David Porter,5,0,37,32
1657668382355,MATH 18,B02,083749,Rideout; David Porter,5,0,36,31
1657668382355,MATH 18,B03,083750,Rideout; David Porter,3,0,37,34
1657668382355,MATH 18,B04,083751,Rideout; David Porter,6,0,36,30
1657668382355,MATH 18,B05,093473,Rideout; David Porter,6,0,36,30
1657668382355,MATH 18,B06,093474,Rideout; David Porter,6,0,36,30
1657668388378,MATH 20A,A01,083754,Zheng; Zequn,14,0,40,26
1657668394405,MATH 20B,A01,083756,Briones; Jor-el Thomas Caparas,4,0,36,32
1657668394405,MATH 20B,A02,083757,Briones; Jor-el Thomas Caparas,1,0,36,35
1657668394405,MATH 20B,A03,093475,Briones; Jor-el Thomas Caparas,2,0,36,34
1657668400433,MATH 20C,A01,083760,Briones; Jor-el Thomas Caparas,1,0,35,34
1657668400433,MATH 20C,A02,083761,Briones; Jor-el Thomas Caparas,8,0,35,27
1657668400433,MATH 20C,A03,093476,Briones; Jor-el Thomas Caparas,0,1,36,36
1657668400433,MATH 20C,B01,083762,Bach; Quang Tran,1,0,30,29
1657668406457,MATH 20D,A01,083765,Tran; Brian Kha,5,0,30,25
1657668406457,MATH 20D,A02,083766,Tran; Brian Kha,5,0,30,25
1657668406457,MATH 20D,A03,083767,Tran; Brian Kha,5,0,30,25
1657668412485,MATH 20E,A01,083771,Ganguly; Soumya,9,0,32,23
1657668412485,MATH 20E,A02,083772,Ganguly; Soumya,6,0,32,26
1657668412485,MATH 20E,B01,083773,Ciotti; Benjamin,20,0,35,15
1657668412485,MATH 20E,B02,083774,Ciotti; Benjamin,18,0,35,17
1657668418513,MATH 103A,A01,083777,Greenfeld; Be'Eri,3,0,36,33
1657668418513,MATH 103A,A02,083778,Greenfeld; Be'Eri,5,0,36,31
1657668418513,MATH 103A,A03,093561,Greenfeld; Be'Eri,6,0,36,30
1657668418513,MATH 103A,B01,083779,Greenfeld; Be'Eri,7,0,36,29
1657668418513,MATH 103A,B02,083780,Greenfeld; Be'Eri,4,0,36,32
1657668418513,MATH 103A,B03,093562,Greenfeld; Be'Eri,3,0,36,33
1657668424539,MATH 105,A01,085443,Carter; Anne Toulson,15,0,35,20
1657668424539,MATH 105,A02,093477,Carter; Anne Toulson,20,0,35,15
1657668430568,MATH 109,A01,083213,Ganzberger; Geoffrey Michael,2,0,34,32
1657668430568,MATH 109,A02,083214,Ganzberger; Geoffrey Michael,4,0,34,30
1657668430568,MATH 109,A03,093478,Ganzberger; Geoffrey Michael,2,0,34,32
1657668430568,MATH 109,B01,083215,Ganzberger; Geoffrey Michael,1,0,32,31
1657668430568,MATH 109,B02,083216,Ganzberger; Geoffrey Michael,2,0,32,30
1657668430568,MATH 109,B03,093479,Ganzberger; Geoffrey Michael,8,0,32,24
1657668436591,MATH 142A,A01,083219,Chow; Bennett,7,0,32,25
1657668436591,MATH 142A,A02,083220,Chow; Bennett,10,0,32,22
1657668436591,MATH 142A,A03,093480,Chow; Bennett,9,0,32,23
1657668436591,MATH 142A,B03,093481,Chow; Bennett,8,0,32,24
1657668436591,MATH 142A,B04,093558,Chow; Bennett,13,0,32,19
1657668436591,MATH 142A,B05,093559,Chow; Bennett,6,0,32,26
1657668442614,MATH 193A,A01,083224,Rotar; Vladimir,8,0,34,26
1657668442614,MATH 193A,A02,083225,Rotar; Vladimir,9,0,34,25
1657668442614,MATH 193A,A03,083781,Rotar; Vladimir,5,0,34,29
1657668442614,MATH 193A,A04,083782,Rotar; Vladimir,10,0,34,24
1657668442614,MATH 193A,A05,093482,Rotar; Vladimir,10,0,34,24
1657668448637,MATH 197,001,091859,McAuley; Julian John,9999,0,9999,0
1657668448637,MATH 197,002,095566,Kedlaya; Kiran S.,9997,0,9999,2
1657668448637,MATH 197,003,095567,Xiao; Ming,9999,0,9999,0
1657668448637,MATH 197,004,095571,Perols; Johan Lars,9998,0,9999,1
1657668455692,COGS 9,A01,083615,Shannon; Kyle Michael,9,0,75,66
1657668461714,COGS 11,A01,083617,Boyle; Mary E. T.,23,0,48,25
1657668467741,COGS 13,A01,083071,Bastos; Amalia Pinkusfeld,11,0,71,60
1657668473763,COGS 14A,A01,092681,Semenuks; Arturs,5,1,100,95
1657668479798,COGS 14B,A01,083073,Cheng; Tzu-Han,6,0,63,57
1657668485825,COGS 17,A01,092677,Semenuks; Arturs,6,0,81,75
1657668491846,COGS 100,A01,083619,Allen; Michael Gordon,17,0,70,53
1657668497869,COGS 101A,A01,083621,Davis; Joshua Daniel,9,0,68,59
1657668503899,COGS 101B,A01,091572,Allen; Michael Gordon,12,0,65,53
1657668509935,COGS 101C,A01,083625,Delgado; Tania,17,0,35,18
1657668515958,COGS 107A,A01,083627,Boyle; Mary E. T.,13,0,60,47
1657668521983,COGS 118A,A01,083075,Gupta; Anjum,21,0,76,55
1657668528007,CSE 3,A50,083646,Miranda; Gregory Joseph,24,0,50,26
1657668534029,CSE 8A,A50,083650,Miranda; Gregory Joseph,17,1,56,39
1657668540075,CSE 11,A01,083080,Cao; Yingjun,6,15,40,34
1657668546098,CSE 12,A01,083652,Krause-Levy; Sophia Louisa,28,1,120,92
1657668552123,CSE 15L,A01,083654,Morris; Justin Loren,9,0,50,41
1657668552123,CSE 15L,A02,083655,Morris; Justin Loren,9,0,50,41
1657668558146,CSE 20,A01,083657,Tran; Khoa Dang,39,0,80,41
1657668564167,CSE 21,A01,095574,Bach; Quang Tran,22,0,48,26
1657668570190,CSE 30,A01,083084,Eldon; John,6,0,80,74
1657668570190,CSE 30,B01,095061,Bhaskar; Nishant,9,0,50,41
1657668576213,CSE 100,A01,083659,Cao; Yingjun,5,4,70,65
1657668582236,CSE 134B,A01,083661,Powell; Thomas Allan,23,0,100,77
1657668588257,CSE 140,A01,083663,Gungor; Onat,15,0,85,70
1657668594281,CSE 140L,A01,083088,Eldon; John,22,0,100,78
1657668600310,CSE 175,A01,083665,Kumar; Rakesh,3,0,25,22
1657668606337,CSE 190,A00,092507,Dubnov; Shlomo,8,0,20,12
1657668612359,ECE 45,A01,083139,Congero; Spencer William,6,0,75,69
1657668618388,ECE 65,A50,083695,Saad; Andrew S,12,0,30,18
1657668618388,ECE 65,A51,095125,Saad; Andrew S,24,0,26,2
1657668624410,ECE 109,A01,091882,Touri; Behrouz,20,0,70,50
1657668630435,ECE 180,A00,083140,Abi Samra; Nicholas Camill,1,0,30,29
1657668630435,ECE 180,B00,083141,Abi Samra; Nicholas Camill,0,0,30,30
1657668636458,MATH 10A,A01,083735,Patchell; Gregory David,2,0,30,28
1657668636458,MATH 10A,A02,083736,Patchell; Gregory David,20,0,30,10
1657668636458,MATH 10A,A03,083737,Patchell; Gregory David,16,0,30,14
1657668642483,MATH 10B,A01,083207,Lim; Seonhee,8,0,34,26
1657668642483,MATH 10B,A02,083208,Lim; Seonhee,9,0,35,26
1657668642483,MATH 10B,A03,093472,Lim; Seonhee,7,0,34,27
1657668642483,MATH 10B,B01,083739,Sinha; Shubham,13,0,30,17
1657668648505,MATH 18,A01,083743,Cinel; Cameron Alexander,8,0,30,22
1657668648505,MATH 18,A02,083744,Cinel; Cameron Alexander,17,0,30,13
1657668648505,MATH 18,A03,083745,Cinel; Cameron Alexander,10,0,30,20
1657668648505,MATH 18,B01,083748,Rideout; David Porter,5,0,37,32
1657668648505,MATH 18,B02,083749,Rideout; David Porter,5,0,36,31
1657668648505,MATH 18,B03,083750,Rideout; David Porter,3,0,37,34
1657668648505,MATH 18,B04,083751,Rideout; David Porter,6,0,36,30
1657668648505,MATH 18,B05,093473,Rideout; David Porter,6,0,36,30
1657668648505,MATH 18,B06,093474,Rideout; David Porter,6,0,36,30
1657668654530,MATH 20A,A01,083754,Zheng; Zequn,14,0,40,26
1657668660629,MATH 20B,A01,083756,Briones; Jor-el Thomas Caparas,4,0,36,32
1657668660629,MATH 20B,A02,083757,Briones; Jor-el Thomas Caparas,1,0,36,35
1657668660629,MATH 20B,A03,093475,Briones; Jor-el Thomas Caparas,2,0,36,34
1657668666652,MATH 20C,A01,083760,Briones; Jor-el Thomas Caparas,1,0,35,34
1657668666652,MATH 20C,A02,083761,Briones; Jor-el Thomas Caparas,8,0,35,27
1657668666652,MATH 20C,A03,093476,Briones; Jor-el Thomas Caparas,0,1,36,36
1657668666652,MATH 20C,B01,083762,Bach; Quang Tran,1,0,30,29
1657668672679,MATH 20D,A01,083765,Tran; Brian Kha,5,0,30,25
1657668672679,MATH 20D,A02,083766,Tran; Brian Kha,5,0,30,25
1657668672679,MATH 20D,A03,083767,Tran; Brian Kha,5,0,30,25
1657668678708,MATH 20E,A01,083771,Ganguly; Soumya,9,0,32,23
1657668678708,MATH 20E,A02,083772,Ganguly; Soumya,6,0,32,26
1657668678708,MATH 20E,B01,083773,Ciotti; Benjamin,20,0,35,15
1657668678708,MATH 20E,B02,083774,Ciotti; Benjamin,18,0,35,17
1657668684743,MATH 103A,A01,083777,Greenfeld; Be'Eri,3,0,36,33
1657668684743,MATH 103A,A02,083778,Greenfeld; Be'Eri,5,0,36,31
1657668684743,MATH 103A,A03,093561,Greenfeld; Be'Eri,6,0,36,30
1657668684743,MATH 103A,B01,083779,Greenfeld; Be'Eri,7,0,36,29
1657668684743,MATH 103A,B02,083780,Greenfeld; Be'Eri,4,0,36,32
1657668684743,MATH 103A,B03,093562,Greenfeld; Be'Eri,3,0,36,33
1657668690766,MATH 105,A01,085443,Carter; Anne Toulson,15,0,35,20
1657668690766,MATH 105,A02,093477,Carter; Anne Toulson,20,0,35,15
1657668696796,MATH 109,A01,083213,Ganzberger; Geoffrey Michael,2,0,34,32
1657668696796,MATH 109,A02,083214,Ganzberger; Geoffrey Michael,4,0,34,30
1657668696796,MATH 109,A03,093478,Ganzberger; Geoffrey Michael,2,0,34,32
1657668696796,MATH 109,B01,083215,Ganzberger; Geoffrey Michael,1,0,32,31
1657668696796,MATH 109,B02,083216,Ganzberger; Geoffrey Michael,2,0,32,30
1657668696796,MATH 109,B03,093479,Ganzberger; Geoffrey Michael,8,0,32,24
1657668702831,MATH 142A,A01,083219,Chow; Bennett,7,0,32,25
1657668702831,MATH 142A,A02,083220,Chow; Bennett,10,0,32,22
1657668702831,MATH 142A,A03,093480,Chow; Bennett,9,0,32,23
1657668702831,MATH 142A,B03,093481,Chow; Bennett,8,0,32,24
1657668702831,MATH 142A,B04,093558,Chow; Bennett,13,0,32,19
1657668702831,MATH 142A,B05,093559,Chow; Bennett,6,0,32,26
1657668708855,MATH 193A,A01,083224,Rotar; Vladimir,8,0,34,26
1657668708855,MATH 193A,A02,083225,Rotar; Vladimir,9,0,34,25
1657668708855,MATH 193A,A03,083781,Rotar; Vladimir,5,0,34,29
1657668708855,MATH 193A,A04,083782,Rotar; Vladimir,10,0,34,24
1657668708855,MATH 193A,A05,093482,Rotar; Vladimir,10,0,34,24
1657668714880,MATH 197,001,091859,McAuley; Julian John,9999,0,9999,0
1657668714880,MATH 197,002,095566,Kedlaya; Kiran S.,9997,0,9999,2
1657668714880,MATH 197,003,095567,Xiao; Ming,9999,0,9999,0
1657668714880,MATH 197,004,095571,Perols; Johan Lars,9998,0,9999,1
1657668721934,COGS 9,A01,083615,Shannon; Kyle Michael,9,0,75,66
1657668727959,COGS 11,A01,083617,Boyle; Mary E. T.,23,0,48,25
1657668733983,COGS 13,A01,083071,Bastos; Amalia Pinkusfeld,11,0,71,60
1657668740009,COGS 14A,A01,092681,Semenuks; Arturs,5,1,100,95
1657668746037,COGS 14B,A01,083073,Cheng; Tzu-Han,6,0,63,57
1657668752062,COGS 17,A01,092677,Semenuks; Arturs,6,0,81,75
1657668758087,COGS 100,A01,083619,Allen; Michael Gordon,17,0,70,53
1657668764108,COGS 101A,A01,083621,Davis; Joshua Daniel,9,0,68,59
1657668770138,COGS 101B,A01,091572,Allen; Michael Gordon,12,0,65,53
1657668776161,COGS 101C,A01,083625,Delgado; Tania,17,0,35,18
1657668782184,COGS 107A,A01,083627,Boyle; Mary E. T.,13,0,60,47
1657668788213,COGS 118A,A01,083075,Gupta; Anjum,21,0,76,55
1657668794234,CSE 3,A50,083646,Miranda; Gregory Joseph,24,0,50,26
1657668800281,CSE 8A,A50,083650,Miranda; Gregory Joseph,17,1,56,39
1657668806309,CSE 11,A01,083080,Cao; Yingjun,6,15,40,34
1657668812333,CSE 12,A01,083652,Krause-Levy; Sophia Louisa,28,1,120,92
1657668818356,CSE 15L,A01,083654,Morris; Justin Loren,9,0,50,41
1657668818356,CSE 15L,A02,083655,Morris; Justin Loren,9,0,50,41
1657668824377,CSE 20,A01,083657,Tran; Khoa Dang,39,0,80,41
1657668830404,CSE 21,A01,095574,Bach; Quang Tran,22,0,48,26
1657668836431,CSE 30,A01,083084,Eldon; John,6,0,80,74
1657668836431,CSE 30,B01,095061,Bhaskar; Nishant,9,0,50,41
1657668842462,CSE 100,A01,083659,Cao; Yingjun,5,4,70,65
1657668848488,CSE 134B,A01,083661,Powell; Thomas Allan,23,0,100,77
1657668854517,CSE 140,A01,083663,Gungor; Onat,15,0,85,70
1657668860554,CSE 140L,A01,083088,Eldon; John,22,0,100,78
1657668866576,CSE 175,A01,083665,Kumar; Rakesh,3,0,25,22
1657668872598,CSE 190,A00,092507,Dubnov; Shlomo,8,0,20,12
1657668878625,ECE 45,A01,083139,Congero; Spencer William,6,0,75,69
1657668884655,ECE 65,A50,083695,Saad; Andrew S,12,0,30,18
1657668884655,ECE 65,A51,095125,Saad; Andrew S,24,0,26,2
1657668890679,ECE 109,A01,091882,Touri; Behrouz,20,0,70,50
1657668896703,ECE 180,A00,083140,Abi Samra; Nicholas Camill,1,0,30,29
1657668896703,ECE 180,B00,083141,Abi Samra; Nicholas Camill,0,0,30,30
1657668902725,MATH 10A,A01,083735,Patchell; Gregory David,2,0,30,28
1657668902725,MATH 10A,A02,083736,Patchell; Gregory David,20,0,30,10
1657668902725,MATH 10A,A03,083737,Patchell; Gregory David,16,0,30,14
1657668908747,MATH 10B,A01,083207,Lim; Seonhee,8,0,34,26
1657668908747,MATH 10B,A02,083208,Lim; Seonhee,9,0,35,26
1657668908747,MATH 10B,A03,093472,Lim; Seonhee,7,0,34,27
1657668908747,MATH 10B,B01,083739,Sinha; Shubham,13,0,30,17
1657668914777,MATH 18,A01,083743,Cinel; Cameron Alexander,8,0,30,22
1657668914777,MATH 18,A02,083744,Cinel; Cameron Alexander,17,0,30,13
1657668914777,MATH 18,A03,083745,Cinel; Cameron Alexander,10,0,30,20
1657668914777,MATH 18,B01,083748,Rideout; David Porter,5,0,37,32
1657668914777,MATH 18,B02,083749,Rideout; David Porter,5,0,36,31
1657668914777,MATH 18,B03,083750,Rideout; David Porter,3,0,37,34
1657668914777,MATH 18,B04,083751,Rideout; David Porter,6,0,36,30
1657668914777,MATH 18,B05,093473,Rideout; David Porter,6,0,36,30
1657668914777,MATH 18,B06,093474,Rideout; David Porter,6,0,36,30
1657668920803,MATH 20A,A01,083754,Zheng; Zequn,14,0,40,26
1657668926829,MATH 20B,A01,083756,Briones; Jor-el Thomas Caparas,4,0,36,32
1657668926829,MATH 20B,A02,083757,Briones; Jor-el Thomas Caparas,1,0,36,35
1657668926829,MATH 20B,A03,093475,Briones; Jor-el Thomas Caparas,2,0,36,34
1657668932856,MATH 20C,A01,083760,Briones; Jor-el Thomas Caparas,1,0,35,34
1657668932856,MATH 20C,A02,083761,Briones; Jor-el Thomas Caparas,8,0,35,27
1657668932856,MATH 20C,A03,093476,Briones; Jor-el Thomas Caparas,0,1,36,36
1657668932856,MATH 20C,B01,083762,Bach; Quang Tran,1,0,30,29
1657668938883,MATH 20D,A01,083765,Tran; Brian Kha,5,0,30,25
1657668938883,MATH 20D,A02,083766,Tran; Brian Kha,5,0,30,25
1657668938883,MATH 20D,A03,083767,Tran; Brian Kha,5,0,30,25
1657668944918,MATH 20E,A01,083771,Ganguly; Soumya,9,0,32,23
1657668944918,MATH 20E,A02,083772,Ganguly; Soumya,6,0,32,26
1657668944918,MATH 20E,B01,083773,Ciotti; Benjamin,20,0,35,15
1657668944918,MATH 20E,B02,083774,Ciotti; Benjamin,18,0,35,17
1657668950945,MATH 103A,A01,083777,Greenfeld; Be'Eri,3,0,36,33
1657668950945,MATH 103A,A02,083778,Greenfeld; Be'Eri,5,0,36,31
1657668950945,MATH 103A,A03,093561,Greenfeld; Be'Eri,6,0,36,30
1657668950945,MATH 103A,B01,083779,Greenfeld; Be'Eri,7,0,36,29
1657668950945,MATH 103A,B02,083780,Greenfeld; Be'Eri,4,0,36,32
1657668950945,MATH 103A,B03,093562,Greenfeld; Be'Eri,3,0,36,33
1657668956972,MATH 105,A01,085443,Carter; Anne Toulson,15,0,35,20
1657668956972,MATH 105,A02,093477,Carter; Anne Toulson,20,0,35,15
1657668963002,MATH 109,A01,083213,Ganzberger; Geoffrey Michael,2,0,34,32
1657668963002,MATH 109,A02,083214,Ganzberger; Geoffrey Michael,4,0,34,30
1657668963002,MATH 109,A03,093478,Ganzberger; Geoffrey Michael,2,0,34,32
1657668963002,MATH 109,B01,083215,Ganzberger; Geoffrey Michael,1,0,32,31
1657668963002,MATH 109,B02,083216,Ganzberger; Geoffrey Michael,2,0,32,30
1657668963002,MATH 109,B03,093479,Ganzberger; Geoffrey Michael,8,0,32,24
1657668969024,MATH 142A,A01,083219,Chow; Bennett,7,0,32,25
1657668969024,MATH 142A,A02,083220,Chow; Bennett,10,0,32,22
1657668969024,MATH 142A,A03,093480,Chow; Bennett,9,0,32,23
1657668969024,MATH 142A,B03,093481,Chow; Bennett,8,0,32,24
1657668969024,MATH 142A,B04,093558,Chow; Bennett,13,0,32,19
1657668969024,MATH 142A,B05,093559,Chow; Bennett,6,0,32,26
1657668975046,MATH 193A,A01,083224,Rotar; Vladimir,8,0,34,26
1657668975046,MATH 193A,A02,083225,Rotar; Vladimir,9,0,34,25
1657668975046,MATH 193A,A03,083781,Rotar; Vladimir,5,0,34,29
1657668975046,MATH 193A,A04,083782,Rotar; Vladimir,10,0,34,24
1657668975046,MATH 193A,A05,093482,Rotar; Vladimir,10,0,34,24
1657668981068,MATH 197,001,091859,McAuley; Julian John,9999,0,9999,0
1657668981068,MATH 197,002,095566,Kedlaya; Kiran S.,9997,0,9999,2
1657668981068,MATH 197,003,095567,Xiao; Ming,9999,0,9999,0
1657668981068,MATH 197,004,095571,Perols; Johan Lars,9998,0,9999,1
1657668988137,COGS 9,A01,083615,Shannon; Kyle Michael,9,0,75,66
1657668994163,COGS 11,A01,083617,Boyle; Mary E. T.,23,0,48,25
1657669000186,COGS 13,A01,083071,Bastos; Amalia Pinkusfeld,11,0,71,60
1657669006220,COGS 14A,A01,092681,Semenuks; Arturs,5,1,100,95
1657669012247,COGS 14B,A01,083073,Cheng; Tzu-Han,6,0,63,57
1657669018268,COGS 17,A01,092677,Semenuks; Arturs,6,0,81,75
1657669024291,COGS 100,A01,083619,Allen; Michael Gordon,17,0,70,53
1657669030314,COGS 101A,A01,083621,Davis; Joshua Daniel,9,0,68,59
1657669036339,COGS 101B,A01,091572,Allen; Michael Gordon,12,0,65,53
1657669042361,COGS 101C,A01,083625,Delgado; Tania,17,0,35,18
1657669048383,COGS 107A,A01,083627,Boyle; Mary E. T.,13,0,60,47
1657669054405,COGS 118A,A01,083075,Gupta; Anjum,21,0,76,55
1657669060436,CSE 3,A50,083646,Miranda; Gregory Joseph,24,0,50,26
1657669066468,CSE 8A,A50,083650,Miranda; Gregory Joseph,17,1,56,39
1657669072490,CSE 11,A01,083080,Cao; Yingjun,6,15,40,34
1657669078522,CSE 12,A01,083652,Krause-Levy; Sophia Louisa,28,1,120,92
1657669084548,CSE 15L,A01,083654,Morris; Justin Loren,9,0,50,41
1657669084548,CSE 15L,A02,083655,Morris; Justin Loren,9,0,50,41
1657669090572,CSE 20,A01,083657,Tran; Khoa Dang,39,0,80,41
1657669096599,CSE 21,A01,095574,Bach; Quang Tran,22,0,48,26
1657669102634,CSE 30,A01,083084,Eldon; John,6,0,80,74
1657669102634,CSE 30,B01,095061,Bhaskar; Nishant,9,0,50,41
1657669108656,CSE 100,A01,083659,Cao; Yingjun,5,4,70,65
1657669114679,CSE 134B,A01,083661,Powell; Thomas Allan,23,0,100,77
1657669120704,CSE 140,A01,083663,Gungor; Onat,15,0,85,70
1657669126727,CSE 140L,A01,083088,Eldon; John,22,0,100,78
1657669132751,CSE 175,A01,083665,Kumar; Rakesh,3,0,25,22
1657669138772,CSE 190,A00,092507,Dubnov; Shlomo,8,0,20,12
1657669144798,ECE 45,A01,083139,Congero; Spencer William,6,0,75,69
1657669150820,ECE 65,A50,083695,Saad; Andrew S,12,0,30,18
1657669150820,ECE 65,A51,095125,Saad; Andrew S,24,0,26,2
1657669156842,ECE 109,A01,091882,Touri; Behrouz,20,0,70,50
1657669162874,ECE 180,A00,083140,Abi Samra; Nicholas Camill,1,0,30,29
1657669162874,ECE 180,B00,083141,Abi Samra; Nicholas Camill,0,0,30,30
1657669168896,MATH 10A,A01,083735,Patchell; Gregory David,2,0,30,28
1657669168896,MATH 10A,A02,083736,Patchell; Gregory David,20,0,30,10
1657669168896,MATH 10A,A03,083737,Patchell; Gregory David,16,0,30,14
1657669174925,MATH 10B,A01,083207,Lim; Seonhee,8,0,34,26
1657669174925,MATH 10B,A02,083208,Lim; Seonhee,9,0,35,26
1657669174925,MATH 10B,A03,093472,Lim; Seonhee,7,0,34,27
1657669174925,MATH 10B,B01,083739,Sinha; Shubham,13,0,30,17
1657669180956,MATH 18,A01,083743,Cinel; Cameron Alexander,8,0,30,22
1657669180956,MATH 18,A02,083744,Cinel; Cameron Alexander,17,0,30,13
1657669180956,MATH 18,A03,083745,Cinel; Cameron Alexander,10,0,30,20
1657669180956,MATH 18,B01,083748,Rideout; David Porter,5,0,37,32
1657669180956,MATH 18,B02,083749,Rideout; David Porter,5,0,36,31
1657669180956,MATH 18,B03,083750,Rideout; David Porter,3,0,37,34
1657669180956,MATH 18,B04,083751,Rideout; David Porter,6,0,36,30
1657669180956,MATH 18,B05,093473,Rideout; David Porter,6,0,36,30
1657669180956,MATH 18,B06,093474,Rideout; David Porter,6,0,36,30
1657669186984,MATH 20A,A01,083754,Zheng; Zequn,14,0,40,26
1657669193006,MATH 20B,A01,083756,Briones; Jor-el Thomas Caparas,4,0,36,32
1657669193006,MATH 20B,A02,083757,Briones; Jor-el Thomas Caparas,1,0,36,35
1657669193006,MATH 20B,A03,093475,Briones; Jor-el Thomas Caparas,2,0,36,34
1657669199034,MATH 20C,A01,083760,Briones; Jor-el Thomas Caparas,1,0,35,34
1657669199034,MATH 20C,A02,083761,Briones; Jor-el Thomas Caparas,8,0,35,27
1657669199034,MATH 20C,A03,093476,Briones; Jor-el Thomas Caparas,0,1,36,36
1657669199034,MATH 20C,B01,083762,Bach; Quang Tran,1,0,30,29
1657669205057,MATH 20D,A01,083765,Tran; Brian Kha,5,0,30,25
1657669205057,MATH 20D,A02,083766,Tran; Brian Kha,5,0,30,25
1657669205057,MATH 20D,A03,083767,Tran; Brian Kha,5,0,30,25
1657669211085,MATH 20E,A01,083771,Ganguly; Soumya,9,0,32,23
1657669211085,MATH 20E,A02,083772,Ganguly; Soumya,6,0,32,26
1657669211085,MATH 20E,B01,083773,Ciotti; Benjamin,20,0,35,15
1657669211085,MATH 20E,B02,083774,Ciotti; Benjamin,18,0,35,17
1657669217112,MATH 103A,A01,083777,Greenfeld; Be'Eri,3,0,36,33
1657669217112,MATH 103A,A02,083778,Greenfeld; Be'Eri,5,0,36,31
1657669217112,MATH 103A,A03,093561,Greenfeld; Be'Eri,6,0,36,30
1657669217112,MATH 103A,B01,083779,Greenfeld; Be'Eri,7,0,36,29
1657669217112,MATH 103A,B02,083780,Greenfeld; Be'Eri,4,0,36,32
1657669217112,MATH 103A,B03,093562,Greenfeld; Be'Eri,3,0,36,33
1657669223138,MATH 105,A01,085443,Carter; Anne Toulson,15,0,35,20
1657669223138,MATH 105,A02,093477,Carter; Anne Toulson,20,0,35,15
1657669229162,MATH 109,A01,083213,Ganzberger; Geoffrey Michael,2,0,34,32
1657669229162,MATH 109,A02,083214,Ganzberger; Geoffrey Michael,4,0,34,30
1657669229162,MATH 109,A03,093478,Ganzberger; Geoffrey Michael,2,0,34,32
1657669229162,MATH 109,B01,083215,Ganzberger; Geoffrey Michael,1,0,32,31
1657669229162,MATH 109,B02,083216,Ganzberger; Geoffrey Michael,2,0,32,30
1657669229162,MATH 109,B03,093479,Ganzberger; Geoffrey Michael,8,0,32,24
1657669235186,MATH 142A,A01,083219,Chow; Bennett,7,0,32,25
1657669235186,MATH 142A,A02,083220,Chow; Bennett,10,0,32,22
1657669235186,MATH 142A,A03,093480,Chow; Bennett,9,0,32,23
1657669235186,MATH 142A,B03,093481,Chow; Bennett,8,0,32,24
1657669235186,MATH 142A,B04,093558,Chow; Bennett,13,0,32,19
1657669235186,MATH 142A,B05,093559,Chow; Bennett,6,0,32,26
1657669241209,MATH 193A,A01,083224,Rotar; Vladimir,8,0,34,26
1657669241209,MATH 193A,A02,083225,Rotar; Vladimir,9,0,34,25
1657669241209,MATH 193A,A03,083781,Rotar; Vladimir,5,0,34,29
1657669241209,MATH 193A,A04,083782,Rotar; Vladimir,10,0,34,24
1657669241209,MATH 193A,A05,093482,Rotar; Vladimir,10,0,34,24
1657669247233,MATH 197,001,091859,McAuley; Julian John,9999,0,9999,0
1657669247233,MATH 197,002,095566,Kedlaya; Kiran S.,9997,0,9999,2
1657669247233,MATH 197,003,095567,Xiao; Ming,9999,0,9999,0
1657669247233,MATH 197,004,095571,Perols; Johan Lars,9998,0,9999,1
1657669254364,COGS 9,A01,083615,Shannon; Kyle Michael,9,0,75,66
1657669260390,COGS 11,A01,083617,Boyle; Mary E. T.,23,0,48,25
1657669266417,COGS 13,A01,083071,Bastos; Amalia Pinkusfeld,11,0,71,60
1657669272440,COGS 14A,A01,092681,Semenuks; Arturs,5,1,100,95
1657669278468,COGS 14B,A01,083073,Cheng; Tzu-Han,6,0,63,57
1657669284492,COGS 17,A01,092677,Semenuks; Arturs,6,0,81,75
1657669290514,COGS 100,A01,083619,Allen; Michael Gordon,17,0,70,53
1657669296546,COGS 101A,A01,083621,Davis; Joshua Daniel,9,0,68,59
1657669302570,COGS 101B,A01,091572,Allen; Michael Gordon,12,0,65,53
1657669308598,COGS 101C,A01,083625,Delgado; Tania,17,0,35,18
1657669314623,COGS 107A,A01,083627,Boyle; Mary E. T.,13,0,60,47
1657669320651,COGS 118A,A01,083075,Gupta; Anjum,21,0,76,55
1657669326682,CSE 3,A50,083646,Miranda; Gregory Joseph,24,0,50,26
1657669332705,CSE 8A,A50,083650,Miranda; Gregory Joseph,17,1,56,39
1657669338733,CSE 11,A01,083080,Cao; Yingjun,6,15,40,34
1657669344758,CSE 12,A01,083652,Krause-Levy; Sophia Louisa,28,1,120,92
1657669350784,CSE 15L,A01,083654,Morris; Justin Loren,9,0,50,41
1657669350784,CSE 15L,A02,083655,Morris; Justin Loren,9,0,50,41
1657669356808,CSE 20,A01,083657,Tran; Khoa Dang,39,0,80,41
1657669362834,CSE 21,A01,095574,Bach; Quang Tran,22,0,48,26
1657669368861,CSE 30,A01,083084,Eldon; John,6,0,80,74
1657669368861,CSE 30,B01,095061,Bhaskar; Nishant,9,0,50,41
1657669374895,CSE 100,A01,083659,Cao; Yingjun,5,4,70,65
1657669380918,CSE 134B,A01,083661,Powell; Thomas Allan,23,0,100,77
1657669386954,CSE 140,A01,083663,Gungor; Onat,15,0,85,70
1657669392976,CSE 140L,A01,083088,Eldon; John,22,0,100,78
1657669399010,CSE 175,A01,083665,Kumar; Rakesh,3,0,25,22
1657669405037,CSE 190,A00,092507,Dubnov; Shlomo,8,0,20,12
1657669411060,ECE 45,A01,083139,Congero; Spencer William,6,0,75,69
1657669417085,ECE 65,A50,083695,Saad; Andrew S,12,0,30,18
1657669417085,ECE 65,A51,095125,Saad; Andrew S,24,0,26,2
1657669423108,ECE 109,A01,091882,Touri; Behrouz,20,0,70,50
1657669437053,ECE 180,A00,083140,Abi Samra; Nicholas Camill,1,0,30,29
1657669437053,ECE 180,B00,083141,Abi Samra; Nicholas Camill,0,0,30,30
1657669443078,MATH 10A,A01,083735,Patchell; Gregory David,2,0,30,28
1657669443078,MATH 10A,A02,083736,Patchell; Gregory David,20,0,30,10
1657669443078,MATH 10A,A03,083737,Patchell; Gregory David,16,0,30,14
1657669449114,MATH 10B,A01,083207,Lim; Seonhee,8,0,34,26
1657669449114,MATH 10B,A02,083208,Lim; Seonhee,9,0,35,26
1657669449114,MATH 10B,A03,093472,Lim; Seonhee,7,0,34,27
1657669449114,MATH 10B,B01,083739,Sinha; Shubham,13,0,30,17
1657669455152,MATH 18,A01,083743,Cinel; Cameron Alexander,8,0,30,22
1657669455152,MATH 18,A02,083744,Cinel; Cameron Alexander,17,0,30,13
1657669455152,MATH 18,A03,083745,Cinel; Cameron Alexander,10,0,30,20
1657669455152,MATH 18,B01,083748,Rideout; David Porter,5,0,37,32
1657669455152,MATH 18,B02,083749,Rideout; David Porter,5,0,36,31
1657669455152,MATH 18,B03,083750,Rideout; David Porter,3,0,37,34
1657669455152,MATH 18,B04,083751,Rideout; David Porter,6,0,36,30
1657669455152,MATH 18,B05,093473,Rideout; David Porter,6,0,36,30
1657669455152,MATH 18,B06,093474,Rideout; David Porter,6,0,36,30
1657669461175,MATH 20A,A01,083754,Zheng; Zequn,14,0,40,26
1657669467201,MATH 20B,A01,083756,Briones; Jor-el Thomas Caparas,4,0,36,32
1657669467201,MATH 20B,A02,083757,Briones; Jor-el Thomas Caparas,1,0,36,35
1657669467201,MATH 20B,A03,093475,Briones; Jor-el Thomas Caparas,2,0,36,34
1657669473226,MATH 20C,A01,083760,Briones; Jor-el Thomas Caparas,1,0,35,34
1657669473226,MATH 20C,A02,083761,Briones; Jor-el Thomas Caparas,8,0,35,27
1657669473226,MATH 20C,A03,093476,Briones; Jor-el Thomas Caparas,0,1,36,36
1657669473226,MATH 20C,B01,083762,Bach; Quang Tran,1,0,30,29
1657669479249,MATH 20D,A01,083765,Tran; Brian Kha,5,0,30,25
1657669479249,MATH 20D,A02,083766,Tran; Brian Kha,5,0,30,25
1657669479249,MATH 20D,A03,083767,Tran; Brian Kha,5,0,30,25
1657669485271,MATH 20E,A01,083771,Ganguly; Soumya,9,0,32,23
1657669485271,MATH 20E,A02,083772,Ganguly; Soumya,6,0,32,26
1657669485271,MATH 20E,B01,083773,Ciotti; Benjamin,20,0,35,15
1657669485271,MATH 20E,B02,083774,Ciotti; Benjamin,18,0,35,17
1657669491299,MATH 103A,A01,083777,Greenfeld; Be'Eri,3,0,36,33
1657669491299,MATH 103A,A02,083778,Greenfeld; Be'Eri,5,0,36,31
1657669491299,MATH 103A,A03,093561,Greenfeld; Be'Eri,6,0,36,30
1657669491299,MATH 103A,B01,083779,Greenfeld; Be'Eri,7,0,36,29
1657669491299,MATH 103A,B02,083780,Greenfeld; Be'Eri,4,0,36,32
1657669491299,MATH 103A,B03,093562,Greenfeld; Be'Eri,3,0,36,33
1657669497326,MATH 105,A01,085443,Carter; Anne Toulson,15,0,35,20
1657669497326,MATH 105,A02,093477,Carter; Anne Toulson,20,0,35,15
1657669503356,MATH 109,A01,083213,Ganzberger; Geoffrey Michael,2,0,34,32
1657669503356,MATH 109,A02,083214,Ganzberger; Geoffrey Michael,4,0,34,30
1657669503356,MATH 109,A03,093478,Ganzberger; Geoffrey Michael,2,0,34,32
1657669503356,MATH 109,B01,083215,Ganzberger; Geoffrey Michael,1,0,32,31
1657669503356,MATH 109,B02,083216,Ganzberger; Geoffrey Michael,2,0,32,30
1657669503356,MATH 109,B03,093479,Ganzberger; Geoffrey Michael,8,0,32,24
1657669509383,MATH 142A,A01,083219,Chow; Bennett,7,0,32,25
1657669509383,MATH 142A,A02,083220,Chow; Bennett,10,0,32,22
1657669509383,MATH 142A,A03,093480,Chow; Bennett,9,0,32,23
1657669509383,MATH 142A,B03,093481,Chow; Bennett,8,0,32,24
1657669509383,MATH 142A,B04,093558,Chow; Bennett,13,0,32,19
1657669509383,MATH 142A,B05,093559,Chow; Bennett,6,0,32,26
1657669515406,MATH 193A,A01,083224,Rotar; Vladimir,8,0,34,26
1657669515406,MATH 193A,A02,083225,Rotar; Vladimir,9,0,34,25
1657669515406,MATH 193A,A03,083781,Rotar; Vladimir,5,0,34,29
1657669515406,MATH 193A,A04,083782,Rotar; Vladimir,10,0,34,24
1657669515406,MATH 193A,A05,093482,Rotar; Vladimir,10,0,34,24
1657669521431,MATH 197,001,091859,McAuley; Julian John,9999,0,9999,0
1657669521431,MATH 197,002,095566,Kedlaya; Kiran S.,9997,0,9999,2
1657669521431,MATH 197,003,095567,Xiao; Ming,9999,0,9999,0
1657669521431,MATH 197,004,095571,Perols; Johan Lars,9998,0,9999,1
1657669528492,COGS 9,A01,083615,Shannon; Kyle Michael,9,0,75,66
1657669534523,COGS 11,A01,083617,Boyle; Mary E. T.,23,0,48,25
1657669540548,COGS 13,A01,083071,Bastos; Amalia Pinkusfeld,11,0,71,60
1657669546574,COGS 14A,A01,092681,Semenuks; Arturs,5,1,100,95
1657669552598,COGS 14B,A01,083073,Cheng; Tzu-Han,6,0,63,57
1657669558624,COGS 17,A01,092677,Semenuks; Arturs,6,0,81,75
1657669564646,COGS 100,A01,083619,Allen; Michael Gordon,17,0,70,53
1657669570668,COGS 101A,A01,083621,Davis; Joshua Daniel,9,0,68,59
1657669576694,COGS 101B,A01,091572,Allen; Michael Gordon,12,0,65,53
1657669582718,COGS 101C,A01,083625,Delgado; Tania,17,0,35,18
1657669588754,COGS 107A,A01,083627,Boyle; Mary E. T.,13,0,60,47
1657669594780,COGS 118A,A01,083075,Gupta; Anjum,21,0,76,55
1657669600802,CSE 3,A50,083646,Miranda; Gregory Joseph,24,0,50,26
1657669606824,CSE 8A,A50,083650,Miranda; Gregory Joseph,17,1,56,39
1657669612863,CSE 11,A01,083080,Cao; Yingjun,6,15,40,34
1657669618892,CSE 12,A01,083652,Krause-Levy; Sophia Louisa,28,1,120,92
1657669624915,CSE 15L,A01,083654,Morris; Justin Loren,9,0,50,41
1657669624915,CSE 15L,A02,083655,Morris; Justin Loren,9,0,50,41
1657669630938,CSE 20,A01,083657,Tran; Khoa Dang,39,0,80,41
1657669636962,CSE 21,A01,095574,Bach; Quang Tran,22,0,48,26
1657669642986,CSE 30,A01,083084,Eldon; John,6,0,80,74
1657669642986,CSE 30,B01,095061,Bhaskar; Nishant,9,0,50,41
1657669649012,CSE 100,A01,083659,Cao; Yingjun,5,4,70,65
1657669655041,CSE 134B,A01,083661,Powell; Thomas Allan,23,0,100,77
1657669661068,CSE 140,A01,083663,Gungor; Onat,15,0,85,70
1657669667095,CSE 140L,A01,083088,Eldon; John,22,0,100,78
1657669673129,CSE 175,A01,083665,Kumar; Rakesh,3,0,25,22
1657669679151,CSE 190,A00,092507,Dubnov; Shlomo,8,0,20,12
1657669685174,ECE 45,A01,083139,Congero; Spencer William,6,0,75,69
1657669691196,ECE 65,A50,083695,Saad; Andrew S,12,0,30,18
1657669691196,ECE 65,A51,095125,Saad; Andrew S,24,0,26,2
1657669697218,ECE 109,A01,091882,Touri; Behrouz,20,0,70,50
1657669703241,ECE 180,A00,083140,Abi Samra; Nicholas Camill,1,0,30,29
1657669703241,ECE 180,B00,083141,Abi Samra; Nicholas Camill,0,0,30,30
1657669709264,MATH 10A,A01,083735,Patchell; Gregory David,2,0,30,28
1657669709264,MATH 10A,A02,083736,Patchell; Gregory David,20,0,30,10
1657669709264,MATH 10A,A03,083737,Patchell; Gregory David,16,0,30,14
1657669715288,MATH 10B,A01,083207,Lim; Seonhee,8,0,34,26
1657669715288,MATH 10B,A02,083208,Lim; Seonhee,9,0,35,26
1657669715288,MATH 10B,A03,093472,Lim; Seonhee,7,0,34,27
1657669715288,MATH 10B,B01,083739,Sinha; Shubham,13,0,30,17
1657669721321,MATH 18,A01,083743,Cinel; Cameron Alexander,8,0,30,22
1657669721321,MATH 18,A02,083744,Cinel; Cameron Alexander,17,0,30,13
1657669721321,MATH 18,A03,083745,Cinel; Cameron Alexander,10,0,30,20
1657669721321,MATH 18,B01,083748,Rideout; David Porter,5,0,37,32
1657669721321,MATH 18,B02,083749,Rideout; David Porter,5,0,36,31
1657669721321,MATH 18,B03,083750,Rideout; David Porter,3,0,37,34
1657669721321,MATH 18,B04,083751,Rideout; David Porter,6,0,36,30
1657669721321,MATH 18,B05,093473,Rideout; David Porter,6,0,36,30
1657669721321,MATH 18,B06,093474,Rideout; David Porter,6,0,36,30
1657669727348,MATH 20A,A01,083754,Zheng; Zequn,14,0,40,26
1657669733371,MATH 20B,A01,083756,Briones; Jor-el Thomas Caparas,4,0,36,32
1657669733371,MATH 20B,A02,083757,Briones; Jor-el Thomas Caparas,1,0,36,35
1657669733371,MATH 20B,A03,093475,Briones; Jor-el Thomas Caparas,2,0,36,34
1657669739394,MATH 20C,A01,083760,Briones; Jor-el Thomas Caparas,1,0,35,34
1657669739394,MATH 20C,A02,083761,Briones; Jor-el Thomas Caparas,8,0,35,27
1657669739394,MATH 20C,A03,093476,Briones; Jor-el Thomas Caparas,0,1,36,36
1657669739394,MATH 20C,B01,083762,Bach; Quang Tran,1,0,30,29
1657669745423,MATH 20D,A01,083765,Tran; Brian Kha,5,0,30,25
1657669745423,MATH 20D,A02,083766,Tran; Brian Kha,5,0,30,25
1657669745423,MATH 20D,A03,083767,Tran; Brian Kha,5,0,30,25
1657669751446,MATH 20E,A01,083771,Ganguly; Soumya,9,0,32,23
1657669751446,MATH 20E,A02,083772,Ganguly; Soumya,6,0,32,26
1657669751446,MATH 20E,B01,083773,Ciotti; Benjamin,20,0,35,15
1657669751446,MATH 20E,B02,083774,Ciotti; Benjamin,18,0,35,17
1657669757476,MATH 103A,A01,083777,Greenfeld; Be'Eri,3,0,36,33
1657669757476,MATH 103A,A02,083778,Greenfeld; Be'Eri,5,0,36,31
1657669757476,MATH 103A,A03,093561,Greenfeld; Be'Eri,6,0,36,30
1657669757476,MATH 103A,B01,083779,Greenfeld; Be'Eri,7,0,36,29
1657669757476,MATH 103A,B02,083780,Greenfeld; Be'Eri,4,0,36,32
1657669757476,MATH 103A,B03,093562,Greenfeld; Be'Eri,3,0,36,33
1657669763502,MATH 105,A01,085443,Carter; Anne Toulson,15,0,35,20
1657669763502,MATH 105,A02,093477,Carter; Anne Toulson,20,0,35,15
1657669769535,MATH 109,A01,083213,Ganzberger; Geoffrey Michael,2,0,34,32
1657669769535,MATH 109,A02,083214,Ganzberger; Geoffrey Michael,4,0,34,30
1657669769535,MATH 109,A03,093478,Ganzberger; Geoffrey Michael,2,0,34,32
1657669769535,MATH 109,B01,083215,Ganzberger; Geoffrey Michael,1,0,32,31
1657669769535,MATH 109,B02,083216,Ganzberger; Geoffrey Michael,2,0,32,30
1657669769535,MATH 109,B03,093479,Ganzberger; Geoffrey Michael,8,0,32,24
1657669775565,MATH 142A,A01,083219,Chow; Bennett,7,0,32,25
1657669775565,MATH 142A,A02,083220,Chow; Bennett,10,0,32,22
1657669775565,MATH 142A,A03,093480,Chow; Bennett,9,0,32,23
1657669775565,MATH 142A,B03,093481,Chow; Bennett,8,0,32,24
1657669775565,MATH 142A,B04,093558,Chow; Bennett,13,0,32,19
1657669775565,MATH 142A,B05,093559,Chow; Bennett,6,0,32,26
1657669781589,MATH 193A,A01,083224,Rotar; Vladimir,8,0,34,26
1657669781589,MATH 193A,A02,083225,Rotar; Vladimir,9,0,34,25
1657669781589,MATH 193A,A03,083781,Rotar; Vladimir,5,0,34,29
1657669781589,MATH 193A,A04,083782,Rotar; Vladimir,10,0,34,24
1657669781589,MATH 193A,A05,093482,Rotar; Vladimir,10,0,34,24
1657669787615,MATH 197,001,091859,McAuley; Julian John,9999,0,9999,0
1657669787615,MATH 197,002,095566,Kedlaya; Kiran S.,9997,0,9999,2
1657669787615,MATH 197,003,095567,Xiao; Ming,9999,0,9999,0
1657669787615,MATH 197,004,095571,Perols; Johan Lars,9998,0,9999,1
1657669794688,COGS 9,A01,083615,Shannon; Kyle Michael,9,0,75,66
1657669800714,COGS 11,A01,083617,Boyle; Mary E. T.,23,0,48,25
1657669806737,COGS 13,A01,083071,Bastos; Amalia Pinkusfeld,11,0,71,60
1657669812764,COGS 14A,A01,092681,Semenuks; Arturs,5,1,100,95
1657669818819,COGS 14B,A01,083073,Cheng; Tzu-Han,6,0,63,57
1657669824845,COGS 17,A01,092677,Semenuks; Arturs,6,0,81,75
1657669830870,COGS 100,A01,083619,Allen; Michael Gordon,17,0,70,53
1657669836905,COGS 101A,A01,083621,Davis; Joshua Daniel,9,0,68,59
1657669842932,COGS 101B,A01,091572,Allen; Michael Gordon,12,0,65,53
1657669848957,COGS 101C,A01,083625,Delgado; Tania,17,0,35,18
1657669854982,COGS 107A,A01,083627,Boyle; Mary E. T.,13,0,60,47
1657669861108,COGS 118A,A01,083075,Gupta; Anjum,21,0,76,55
1657669867130,CSE 3,A50,083646,Miranda; Gregory Joseph,24,0,50,26
1657669873161,CSE 8A,A50,083650,Miranda; Gregory Joseph,17,1,56,39
1657669879188,CSE 11,A01,083080,Cao; Yingjun,6,15,40,34
1657669885215,CSE 12,A01,083652,Krause-Levy; Sophia Louisa,28,1,120,92
1657669891238,CSE 15L,A01,083654,Morris; Justin Loren,9,0,50,41
1657669891238,CSE 15L,A02,083655,Morris; Justin Loren,9,0,50,41
1657669897268,CSE 20,A01,083657,Tran; Khoa Dang,39,0,80,41
1657669903294,CSE 21,A01,095574,Bach; Quang Tran,22,0,48,26
1657669909317,CSE 30,A01,083084,Eldon; John,6,0,80,74
1657669909317,CSE 30,B01,095061,Bhaskar; Nishant,9,0,50,41
1657669915340,CSE 100,A01,083659,Cao; Yingjun,5,4,70,65
1657669921367,CSE 134B,A01,083661,Powell; Thomas Allan,23,0,100,77
1657669927389,CSE 140,A01,083663,Gungor; Onat,15,0,85,70
1657669933417,CSE 140L,A01,083088,Eldon; John,22,0,100,78
1657669939441,CSE 175,A01,083665,Kumar; Rakesh,3,0,25,22
1657669945473,CSE 190,A00,092507,Dubnov; Shlomo,8,0,20,12
1657669951500,ECE 45,A01,083139,Congero; Spencer William,6,0,75,69
1657669957523,ECE 65,A50,083695,Saad; Andrew S,12,0,30,18
1657669957523,ECE 65,A51,095125,Saad; Andrew S,24,0,26,2
1657669963551,ECE 109,A01,091882,Touri; Behrouz,20,0,70,50
1657669969573,ECE 180,A00,083140,Abi Samra; Nicholas Camill,1,0,30,29
1657669969573,ECE 180,B00,083141,Abi Samra; Nicholas Camill,0,0,30,30
1657669975598,MATH 10A,A01,083735,Patchell; Gregory David,2,0,30,28
1657669975598,MATH 10A,A02,083736,Patchell; Gregory David,20,0,30,10
1657669975598,MATH 10A,A03,083737,Patchell; Gregory David,16,0,30,14
1657669981625,MATH 10B,A01,083207,Lim; Seonhee,8,0,34,26
1657669981625,MATH 10B,A02,083208,Lim; Seonhee,9,0,35,26
1657669981625,MATH 10B,A03,093472,Lim; Seonhee,7,0,34,27
1657669981625,MATH 10B,B01,083739,Sinha; Shubham,13,0,30,17
1657669987649,MATH 18,A01,083743,Cinel; Cameron Alexander,8,0,30,22
1657669987649,MATH 18,A02,083744,Cinel; Cameron Alexander,17,0,30,13
1657669987649,MATH 18,A03,083745,Cinel; Cameron Alexander,10,0,30,20
1657669987649,MATH 18,B01,083748,Rideout; David Porter,5,0,37,32
1657669987649,MATH 18,B02,083749,Rideout; David Porter,5,0,36,31
1657669987649,MATH 18,B03,083750,Rideout; David Porter,3,0,37,34
1657669987649,MATH 18,B04,083751,Rideout; David Porter,6,0,36,30
1657669987649,MATH 18,B05,093473,Rideout; David Porter,6,0,36,30
1657669987649,MATH 18,B06,093474,Rideout; David Porter,6,0,36,30
1657669993673,MATH 20A,A01,083754,Zheng; Zequn,14,0,40,26
1657669999704,MATH 20B,A01,083756,Briones; Jor-el Thomas Caparas,4,0,36,32
1657669999704,MATH 20B,A02,083757,Briones; Jor-el Thomas Caparas,1,0,36,35
1657669999704,MATH 20B,A03,093475,Briones; Jor-el Thomas Caparas,2,0,36,34
1657670005740,MATH 20C,A01,083760,Briones; Jor-el Thomas Caparas,1,0,35,34
1657670005740,MATH 20C,A02,083761,Briones; Jor-el Thomas Caparas,8,0,35,27
1657670005740,MATH 20C,A03,093476,Briones; Jor-el Thomas Caparas,0,1,36,36
1657670005740,MATH 20C,B01,083762,Bach; Quang Tran,1,0,30,29
1657670011768,MATH 20D,A01,083765,Tran; Brian Kha,5,0,30,25
1657670011768,MATH 20D,A02,083766,Tran; Brian Kha,5,0,30,25
1657670011768,MATH 20D,A03,083767,Tran; Brian Kha,5,0,30,25
1657670017793,MATH 20E,A01,083771,Ganguly; Soumya,9,0,32,23
1657670017793,MATH 20E,A02,083772,Ganguly; Soumya,6,0,32,26
1657670017793,MATH 20E,B01,083773,Ciotti; Benjamin,20,0,35,15
1657670017793,MATH 20E,B02,083774,Ciotti; Benjamin,18,0,35,17
1657670023815,MATH 103A,A01,083777,Greenfeld; Be'Eri,3,0,36,33
1657670023815,MATH 103A,A02,083778,Greenfeld; Be'Eri,5,0,36,31
1657670023815,MATH 103A,A03,093561,Greenfeld; Be'Eri,6,0,36,30
1657670023815,MATH 103A,B01,083779,Greenfeld; Be'Eri,7,0,36,29
1657670023815,MATH 103A,B02,083780,Greenfeld; Be'Eri,4,0,36,32
1657670023815,MATH 103A,B03,093562,Greenfeld; Be'Eri,3,0,36,33
1657670029844,MATH 105,A01,085443,Carter; Anne Toulson,15,0,35,20
1657670029844,MATH 105,A02,093477,Carter; Anne Toulson,20,0,35,15
1657670035867,MATH 109,A01,083213,Ganzberger; Geoffrey Michael,2,0,34,32
1657670035867,MATH 109,A02,083214,Ganzberger; Geoffrey Michael,4,0,34,30
1657670035867,MATH 109,A03,093478,Ganzberger; Geoffrey Michael,2,0,34,32
1657670035867,MATH 109,B01,083215,Ganzberger; Geoffrey Michael,1,0,32,31
1657670035867,MATH 109,B02,083216,Ganzberger; Geoffrey Michael,2,0,32,30
1657670035867,MATH 109,B03,093479,Ganzberger; Geoffrey Michael,8,0,32,24
1657670041893,MATH 142A,A01,083219,Chow; Bennett,7,0,32,25
1657670041893,MATH 142A,A02,083220,Chow; Bennett,10,0,32,22
1657670041893,MATH 142A,A03,093480,Chow; Bennett,9,0,32,23
1657670041893,MATH 142A,B03,093481,Chow; Bennett,8,0,32,24
1657670041893,MATH 142A,B04,093558,Chow; Bennett,13,0,32,19
1657670041893,MATH 142A,B05,093559,Chow; Bennett,6,0,32,26
1657670047920,MATH 193A,A01,083224,Rotar; Vladimir,8,0,34,26
1657670047920,MATH 193A,A02,083225,Rotar; Vladimir,9,0,34,25
1657670047920,MATH 193A,A03,083781,Rotar; Vladimir,5,0,34,29
1657670047920,MATH 193A,A04,083782,Rotar; Vladimir,10,0,34,24
1657670047920,MATH 193A,A05,093482,Rotar; Vladimir,10,0,34,24
1657670053944,MATH 197,001,091859,McAuley; Julian John,9999,0,9999,0
1657670053944,MATH 197,002,095566,Kedlaya; Kiran S.,9997,0,9999,2
1657670053944,MATH 197,003,095567,Xiao; Ming,9999,0,9999,0
1657670053944,MATH 197,004,095571,Perols; Johan Lars,9998,0,9999,1
1657670061012,COGS 9,A01,083615,Shannon; Kyle Michael,9,0,75,66
1657670067034,COGS 11,A01,083617,Boyle; Mary E. T.,23,0,48,25
1657670073057,COGS 13,A01,083071,Bastos; Amalia Pinkusfeld,11,0,71,60
1657670079080,COGS 14A,A01,092681,Semenuks; Arturs,5,1,100,95
1657670085110,COGS 14B,A01,083073,Cheng; Tzu-Han,6,0,63,57
1657670091136,COGS 17,A01,092677,Semenuks; Arturs,6,0,81,75
1657670097157,COGS 100,A01,083619,Allen; Michael Gordon,17,0,70,53
1657670103192,COGS 101A,A01,083621,Davis; Joshua Daniel,9,0,68,59
1657670109218,COGS 101B,A01,091572,Allen; Michael Gordon,12,0,65,53
1657670115245,COGS 101C,A01,083625,Delgado; Tania,17,0,35,18
1657670121270,COGS 107A,A01,083627,Boyle; Mary E. T.,13,0,60,47
1657670127293,COGS 118A,A01,083075,Gupta; Anjum,21,0,76,55
1657670133320,CSE 3,A50,083646,Miranda; Gregory Joseph,24,0,50,26
1657670139344,CSE 8A,A50,083650,Miranda; Gregory Joseph,17,1,56,39
1657670145370,CSE 11,A01,083080,Cao; Yingjun,6,15,40,34
1657670151399,CSE 12,A01,083652,Krause-Levy; Sophia Louisa,28,1,120,92
1657670157422,CSE 15L,A01,083654,Morris; Justin Loren,9,0,50,41
1657670157422,CSE 15L,A02,083655,Morris; Justin Loren,9,0,50,41
1657670163448,CSE 20,A01,083657,Tran; Khoa Dang,39,0,80,41
1657670169475,CSE 21,A01,095574,Bach; Quang Tran,22,0,48,26
1657670175502,CSE 30,A01,083084,Eldon; John,6,0,80,74
1657670175502,CSE 30,B01,095061,Bhaskar; Nishant,9,0,50,41
1657670181524,CSE 100,A01,083659,Cao; Yingjun,5,4,70,65
1657670187547,CSE 134B,A01,083661,Powell; Thomas Allan,23,0,100,77
1657670193579,CSE 140,A01,083663,Gungor; Onat,15,0,85,70
1657670199601,CSE 140L,A01,083088,Eldon; John,22,0,100,78
1657670205622,CSE 175,A01,083665,Kumar; Rakesh,3,0,25,22
1657670211644,CSE 190,A00,092507,Dubnov; Shlomo,8,0,20,12
1657670217668,ECE 45,A01,083139,Congero; Spencer William,6,0,75,69
1657670223692,ECE 65,A50,083695,Saad; Andrew S,12,0,30,18
1657670223692,ECE 65,A51,095125,Saad; Andrew S,24,0,26,2
1657670229715,ECE 109,A01,091882,Touri; Behrouz,20,0,70,50
1657670235739,ECE 180,A00,083140,Abi Samra; Nicholas Camill,1,0,30,29
1657670235739,ECE 180,B00,083141,Abi Samra; Nicholas Camill,0,0,30,30
1657670241763,MATH 10A,A01,083735,Patchell; Gregory David,2,0,30,28
1657670241763,MATH 10A,A02,083736,Patchell; Gregory David,20,0,30,10
1657670241763,MATH 10A,A03,083737,Patchell; Gregory David,16,0,30,14
1657670247787,MATH 10B,A01,083207,Lim; Seonhee,8,0,34,26
1657670247787,MATH 10B,A02,083208,Lim; Seonhee,9,0,35,26
1657670247787,MATH 10B,A03,093472,Lim; Seonhee,7,0,34,27
1657670247787,MATH 10B,B01,083739,Sinha; Shubham,13,0,30,17
1657670253811,MATH 18,A01,083743,Cinel; Cameron Alexander,8,0,30,22
1657670253811,MATH 18,A02,083744,Cinel; Cameron Alexander,17,0,30,13
1657670253811,MATH 18,A03,083745,Cinel; Cameron Alexander,10,0,30,20
1657670253811,MATH 18,B01,083748,Rideout; David Porter,5,0,37,32
1657670253811,MATH 18,B02,083749,Rideout; David Porter,5,0,36,31
1657670253811,MATH 18,B03,083750,Rideout; David Porter,3,0,37,34
1657670253811,MATH 18,B04,083751,Rideout; David Porter,6,0,36,30
1657670253811,MATH 18,B05,093473,Rideout; David Porter,6,0,36,30
1657670253811,MATH 18,B06,093474,Rideout; David Porter,6,0,36,30
1657670259834,MATH 20A,A01,083754,Zheng; Zequn,14,0,40,26
1657670265861,MATH 20B,A01,083756,Briones; Jor-el Thomas Caparas,4,0,36,32
1657670265861,MATH 20B,A02,083757,Briones; Jor-el Thomas Caparas,1,0,36,35
1657670265861,MATH 20B,A03,093475,Briones; Jor-el Thomas Caparas,2,0,36,34
1657670271888,MATH 20C,A01,083760,Briones; Jor-el Thomas Caparas,1,0,35,34
1657670271888,MATH 20C,A02,083761,Briones; Jor-el Thomas Caparas,8,0,35,27
1657670271888,MATH 20C,A03,093476,Briones; Jor-el Thomas Caparas,0,1,36,36
1657670271888,MATH 20C,B01,083762,Bach; Quang Tran,1,0,30,29
1657670277916,MATH 20D,A01,083765,Tran; Brian Kha,5,0,30,25
1657670277916,MATH 20D,A02,083766,Tran; Brian Kha,5,0,30,25
1657670277916,MATH 20D,A03,083767,Tran; Brian Kha,5,0,30,25
1657670283940,MATH 20E,A01,083771,Ganguly; Soumya,9,0,32,23
1657670283940,MATH 20E,A02,083772,Ganguly; Soumya,6,0,32,26
1657670283940,MATH 20E,B01,083773,Ciotti; Benjamin,20,0,35,15
1657670283940,MATH 20E,B02,083774,Ciotti; Benjamin,18,0,35,17
1657670289963,MATH 103A,A01,083777,Greenfeld; Be'Eri,3,0,36,33
1657670289963,MATH 103A,A02,083778,Greenfeld; Be'Eri,5,0,36,31
1657670289963,MATH 103A,A03,093561,Greenfeld; Be'Eri,6,0,36,30
1657670289963,MATH 103A,B01,083779,Greenfeld; Be'Eri,7,0,36,29
1657670289963,MATH 103A,B02,083780,Greenfeld; Be'Eri,4,0,36,32
1657670289963,MATH 103A,B03,093562,Greenfeld; Be'Eri,3,0,36,33
1657670295994,MATH 105,A01,085443,Carter; Anne Toulson,15,0,35,20
1657670295994,MATH 105,A02,093477,Carter; Anne Toulson,20,0,35,15
1657670302022,MATH 109,A01,083213,Ganzberger; Geoffrey Michael,2,0,34,32
1657670302022,MATH 109,A02,083214,Ganzberger; Geoffrey Michael,4,0,34,30
1657670302022,MATH 109,A03,093478,Ganzberger; Geoffrey Michael,2,0,34,32
1657670302022,MATH 109,B01,083215,Ganzberger; Geoffrey Michael,1,0,32,31
1657670302022,MATH 109,B02,083216,Ganzberger; Geoffrey Michael,2,0,32,30
1657670302022,MATH 109,B03,093479,Ganzberger; Geoffrey Michael,8,0,32,24
1657670308045,MATH 142A,A01,083219,Chow; Bennett,7,0,32,25
1657670308045,MATH 142A,A02,083220,Chow; Bennett,10,0,32,22
1657670308045,MATH 142A,A03,093480,Chow; Bennett,9,0,32,23
1657670308045,MATH 142A,B03,093481,Chow; Bennett,8,0,32,24
1657670308045,MATH 142A,B04,093558,Chow; Bennett,13,0,32,19
1657670308045,MATH 142A,B05,093559,Chow; Bennett,6,0,32,26
1657670314071,MATH 193A,A01,083224,Rotar; Vladimir,8,0,34,26
1657670314071,MATH 193A,A02,083225,Rotar; Vladimir,9,0,34,25
1657670314071,MATH 193A,A03,083781,Rotar; Vladimir,5,0,34,29
1657670314071,MATH 193A,A04,083782,Rotar; Vladimir,10,0,34,24
1657670314071,MATH 193A,A05,093482,Rotar; Vladimir,10,0,34,24
1657670320094,MATH 197,001,091859,McAuley; Julian John,9999,0,9999,0
1657670320094,MATH 197,002,095566,Kedlaya; Kiran S.,9997,0,9999,2
1657670320094,MATH 197,003,095567,Xiao; Ming,9999,0,9999,0
1657670320094,MATH 197,004,095571,Perols; Johan Lars,9998,0,9999,1
1657670327145,COGS 9,A01,083615,Shannon; Kyle Michael,9,0,75,66
1657670333173,COGS 11,A01,083617,Boyle; Mary E. T.,23,0,48,25
1657670339202,COGS 13,A01,083071,Bastos; Amalia Pinkusfeld,11,0,71,60
1657670345228,COGS 14A,A01,092681,Semenuks; Arturs,5,1,100,95
1657670351255,COGS 14B,A01,083073,Cheng; Tzu-Han,6,0,63,57
1657670357278,COGS 17,A01,092677,Semenuks; Arturs,6,0,81,75
1657670363305,COGS 100,A01,083619,Allen; Michael Gordon,17,0,70,53
1657670369331,COGS 101A,A01,083621,Davis; Joshua Daniel,9,0,68,59
1657670375359,COGS 101B,A01,091572,Allen; Michael Gordon,12,0,65,53
1657670381387,COGS 101C,A01,083625,Delgado; Tania,17,0,35,18
1657670387412,COGS 107A,A01,083627,Boyle; Mary E. T.,13,0,60,47
1657670393440,COGS 118A,A01,083075,Gupta; Anjum,21,0,76,55
1657670399462,CSE 3,A50,083646,Miranda; Gregory Joseph,24,0,50,26
1657670405500,CSE 8A,A50,083650,Miranda; Gregory Joseph,17,1,56,39
1657670411524,CSE 11,A01,083080,Cao; Yingjun,6,15,40,34
1657670417547,CSE 12,A01,083652,Krause-Levy; Sophia Louisa,28,1,120,92
1657670423569,CSE 15L,A01,083654,Morris; Justin Loren,9,0,50,41
1657670423569,CSE 15L,A02,083655,Morris; Justin Loren,9,0,50,41
1657670429593,CSE 20,A01,083657,Tran; Khoa Dang,39,0,80,41
1657670435615,CSE 21,A01,095574,Bach; Quang Tran,22,0,48,26
1657670441642,CSE 30,A01,083084,Eldon; John,6,0,80,74
1657670441642,CSE 30,B01,095061,Bhaskar; Nishant,9,0,50,41
1657670447664,CSE 100,A01,083659,Cao; Yingjun,5,4,70,65
1657670453690,CSE 134B,A01,083661,Powell; Thomas Allan,23,0,100,77
1657670459801,CSE 140,A01,083663,Gungor; Onat,15,0,85,70
1657670465824,CSE 140L,A01,083088,Eldon; John,22,0,100,78
1657670471846,CSE 175,A01,083665,Kumar; Rakesh,3,0,25,22
1657670477871,CSE 190,A00,092507,Dubnov; Shlomo,8,0,20,12
1657670483893,ECE 45,A01,083139,Congero; Spencer William,6,0,75,69
1657670489917,ECE 65,A50,083695,Saad; Andrew S,12,0,30,18
1657670489917,ECE 65,A51,095125,Saad; Andrew S,24,0,26,2
1657670495948,ECE 109,A01,091882,Touri; Behrouz,20,0,70,50
1657670501969,ECE 180,A00,083140,Abi Samra; Nicholas Camill,1,0,30,29
1657670501969,ECE 180,B00,083141,Abi Samra; Nicholas Camill,0,0,30,30
1657670507996,MATH 10A,A01,083735,Patchell; Gregory David,2,0,30,28
1657670507996,MATH 10A,A02,083736,Patchell; Gregory David,20,0,30,10
1657670507996,MATH 10A,A03,083737,Patchell; Gregory David,16,0,30,14
1657670514019,MATH 10B,A01,083207,Lim; Seonhee,8,0,34,26
1657670514019,MATH 10B,A02,083208,Lim; Seonhee,9,0,35,26
1657670514019,MATH 10B,A03,093472,Lim; Seonhee,7,0,34,27
1657670514019,MATH 10B,B01,083739,Sinha; Shubham,13,0,30,17
1657670520044,MATH 18,A01,083743,Cinel; Cameron Alexander,8,0,30,22
1657670520044,MATH 18,A02,083744,Cinel; Cameron Alexander,17,0,30,13
1657670520044,MATH 18,A03,083745,Cinel; Cameron Alexander,10,0,30,20
1657670520044,MATH 18,B01,083748,Rideout; David Porter,5,0,37,32
1657670520044,MATH 18,B02,083749,Rideout; David Porter,5,0,36,31
1657670520044,MATH 18,B03,083750,Rideout; David Porter,3,0,37,34
1657670520044,MATH 18,B04,083751,Rideout; David Porter,6,0,36,30
1657670520044,MATH 18,B05,093473,Rideout; David Porter,6,0,36,30
1657670520044,MATH 18,B06,093474,Rideout; David Porter,6,0,36,30
1657670526069,MATH 20A,A01,083754,Zheng; Zequn,14,0,40,26
1657670532092,MATH 20B,A01,083756,Briones; Jor-el Thomas Caparas,4,0,36,32
1657670532092,MATH 20B,A02,083757,Briones; Jor-el Thomas Caparas,1,0,36,35
1657670532092,MATH 20B,A03,093475,Briones; Jor-el Thomas Caparas,2,0,36,34
1657670538116,MATH 20C,A01,083760,Briones; Jor-el Thomas Caparas,1,0,35,34
1657670538116,MATH 20C,A02,083761,Briones; Jor-el Thomas Caparas,8,0,35,27
1657670538116,MATH 20C,A03,093476,Briones; Jor-el Thomas Caparas,0,1,36,36
1657670538116,MATH 20C,B01,083762,Bach; Quang Tran,1,0,30,29
1657670544140,MATH 20D,A01,083765,Tran; Brian Kha,5,0,30,25
1657670544140,MATH 20D,A02,083766,Tran; Brian Kha,5,0,30,25
1657670544140,MATH 20D,A03,083767,Tran; Brian Kha,5,0,30,25
1657670550163,MATH 20E,A01,083771,Ganguly; Soumya,9,0,32,23
1657670550163,MATH 20E,A02,083772,Ganguly; Soumya,6,0,32,26
1657670550163,MATH 20E,B01,083773,Ciotti; Benjamin,20,0,35,15
1657670550163,MATH 20E,B02,083774,Ciotti; Benjamin,18,0,35,17
1657670556187,MATH 103A,A01,083777,Greenfeld; Be'Eri,3,0,36,33
1657670556187,MATH 103A,A02,083778,Greenfeld; Be'Eri,5,0,36,31
1657670556187,MATH 103A,A03,093561,Greenfeld; Be'Eri,6,0,36,30
1657670556187,MATH 103A,B01,083779,Greenfeld; Be'Eri,7,0,36,29
1657670556187,MATH 103A,B02,083780,Greenfeld; Be'Eri,4,0,36,32
1657670556187,MATH 103A,B03,093562,Greenfeld; Be'Eri,3,0,36,33
1657670562211,MATH 105,A01,085443,Carter; Anne Toulson,15,0,35,20
1657670562211,MATH 105,A02,093477,Carter; Anne Toulson,20,0,35,15
1657670568247,MATH 109,A01,083213,Ganzberger; Geoffrey Michael,2,0,34,32
1657670568247,MATH 109,A02,083214,Ganzberger; Geoffrey Michael,4,0,34,30
1657670568247,MATH 109,A03,093478,Ganzberger; Geoffrey Michael,2,0,34,32
1657670568247,MATH 109,B01,083215,Ganzberger; Geoffrey Michael,1,0,32,31
1657670568247,MATH 109,B02,083216,Ganzberger; Geoffrey Michael,2,0,32,30
1657670568247,MATH 109,B03,093479,Ganzberger; Geoffrey Michael,8,0,32,24
1657670574276,MATH 142A,A01,083219,Chow; Bennett,7,0,32,25
1657670574276,MATH 142A,A02,083220,Chow; Bennett,10,0,32,22
1657670574276,MATH 142A,A03,093480,Chow; Bennett,9,0,32,23
1657670574276,MATH 142A,B03,093481,Chow; Bennett,8,0,32,24
1657670574276,MATH 142A,B04,093558,Chow; Bennett,13,0,32,19
1657670574276,MATH 142A,B05,093559,Chow; Bennett,6,0,32,26
1657670580303,MATH 193A,A01,083224,Rotar; Vladimir,8,0,34,26
1657670580303,MATH 193A,A02,083225,Rotar; Vladimir,9,0,34,25
1657670580303,MATH 193A,A03,083781,Rotar; Vladimir,5,0,34,29
1657670580303,MATH 193A,A04,083782,Rotar; Vladimir,10,0,34,24
1657670580303,MATH 193A,A05,093482,Rotar; Vladimir,10,0,34,24
1657670586333,MATH 197,001,091859,McAuley; Julian John,9999,0,9999,0
1657670586333,MATH 197,002,095566,Kedlaya; Kiran S.,9997,0,9999,2
1657670586333,MATH 197,003,095567,Xiao; Ming,9999,0,9999,0
1657670586333,MATH 197,004,095571,Perols; Johan Lars,9998,0,9999,1
1657670593400,COGS 9,A01,083615,Shannon; Kyle Michael,9,0,75,66
1657670599429,COGS 11,A01,083617,Boyle; Mary E. T.,23,0,48,25
1657670605457,COGS 13,A01,083071,Bastos; Amalia Pinkusfeld,11,0,71,60
1657670611482,COGS 14A,A01,092681,Semenuks; Arturs,5,1,100,95
1657670617511,COGS 14B,A01,083073,Cheng; Tzu-Han,6,0,63,57
1657670623534,COGS 17,A01,092677,Semenuks; Arturs,6,0,81,75
1657670629560,COGS 100,A01,083619,Allen; Michael Gordon,17,0,70,53
1657670635583,COGS 101A,A01,083621,Davis; Joshua Daniel,9,0,68,59
1657670641621,COGS 101B,A01,091572,Allen; Michael Gordon,12,0,65,53
1657670647644,COGS 101C,A01,083625,Delgado; Tania,17,0,35,18
1657670653676,COGS 107A,A01,083627,Boyle; Mary E. T.,13,0,60,47
1657670659700,COGS 118A,A01,083075,Gupta; Anjum,21,0,76,55
1657670665745,CSE 3,A50,083646,Miranda; Gregory Joseph,24,0,50,26
1657670671772,CSE 8A,A50,083650,Miranda; Gregory Joseph,17,1,56,39
1657670677804,CSE 11,A01,083080,Cao; Yingjun,6,15,40,34
1657670683830,CSE 12,A01,083652,Krause-Levy; Sophia Louisa,28,1,120,92
1657670689866,CSE 15L,A01,083654,Morris; Justin Loren,9,0,50,41
1657670689866,CSE 15L,A02,083655,Morris; Justin Loren,9,0,50,41
1657670695893,CSE 20,A01,083657,Tran; Khoa Dang,39,0,80,41
1657670701915,CSE 21,A01,095574,Bach; Quang Tran,22,0,48,26
1657670707942,CSE 30,A01,083084,Eldon; John,6,0,80,74
1657670707942,CSE 30,B01,095061,Bhaskar; Nishant,9,0,50,41
1657670713968,CSE 100,A01,083659,Cao; Yingjun,5,4,70,65
1657670719995,CSE 134B,A01,083661,Powell; Thomas Allan,23,0,100,77
1657670726020,CSE 140,A01,083663,Gungor; Onat,15,0,85,70
1657670732044,CSE 140L,A01,083088,Eldon; John,22,0,100,78
1657670738066,CSE 175,A01,083665,Kumar; Rakesh,3,0,25,22
1657670744094,CSE 190,A00,092507,Dubnov; Shlomo,8,0,20,12
1657670750122,ECE 45,A01,083139,Congero; Spencer William,6,0,75,69
1657670756148,ECE 65,A50,083695,Saad; Andrew S,12,0,30,18
1657670756148,ECE 65,A51,095125,Saad; Andrew S,24,0,26,2
1657670762173,ECE 109,A01,091882,Touri; Behrouz,20,0,70,50
1657670768207,ECE 180,A00,083140,Abi Samra; Nicholas Camill,1,0,30,29
1657670768207,ECE 180,B00,083141,Abi Samra; Nicholas Camill,0,0,30,30
1657670774244,MATH 10A,A01,083735,Patchell; Gregory David,2,0,30,28
1657670774244,MATH 10A,A02,083736,Patchell; Gregory David,20,0,30,10
1657670774244,MATH 10A,A03,083737,Patchell; Gregory David,16,0,30,14
1657670780284,MATH 10B,A01,083207,Lim; Seonhee,8,0,34,26
1657670780284,MATH 10B,A02,083208,Lim; Seonhee,9,0,35,26
1657670780284,MATH 10B,A03,093472,Lim; Seonhee,7,0,34,27
1657670780284,MATH 10B,B01,083739,Sinha; Shubham,13,0,30,17
1657670786312,MATH 18,A01,083743,Cinel; Cameron Alexander,8,0,30,22
1657670786312,MATH 18,A02,083744,Cinel; Cameron Alexander,17,0,30,13
1657670786312,MATH 18,A03,083745,Cinel; Cameron Alexander,10,0,30,20
1657670786312,MATH 18,B01,083748,Rideout; David Porter,5,0,37,32
1657670786312,MATH 18,B02,083749,Rideout; David Porter,5,0,36,31
1657670786312,MATH 18,B03,083750,Rideout; David Porter,3,0,37,34
1657670786312,MATH 18,B04,083751,Rideout; David Porter,6,0,36,30
1657670786312,MATH 18,B05,093473,Rideout; David Porter,6,0,36,30
1657670786312,MATH 18,B06,093474,Rideout; David Porter,6,0,36,30
1657670792339,MATH 20A,A01,083754,Zheng; Zequn,14,0,40,26
1657670798365,MATH 20B,A01,083756,Briones; Jor-el Thomas Caparas,4,0,36,32
1657670798365,MATH 20B,A02,083757,Briones; Jor-el Thomas Caparas,1,0,36,35
1657670798365,MATH 20B,A03,093475,Briones; Jor-el Thomas Caparas,2,0,36,34
1657670804393,MATH 20C,A01,083760,Briones; Jor-el Thomas Caparas,1,0,35,34
1657670804393,MATH 20C,A02,083761,Briones; Jor-el Thomas Caparas,8,0,35,27
1657670804393,MATH 20C,A03,093476,Briones; Jor-el Thomas Caparas,0,1,36,36
1657670804393,MATH 20C,B01,083762,Bach; Quang Tran,1,0,30,29
1657670810422,MATH 20D,A01,083765,Tran; Brian Kha,5,0,30,25
1657670810422,MATH 20D,A02,083766,Tran; Brian Kha,5,0,30,25
1657670810422,MATH 20D,A03,083767,Tran; Brian Kha,5,0,30,25
1657670816446,MATH 20E,A01,083771,Ganguly; Soumya,9,0,32,23
1657670816446,MATH 20E,A02,083772,Ganguly; Soumya,6,0,32,26
1657670816446,MATH 20E,B01,083773,Ciotti; Benjamin,20,0,35,15
1657670816446,MATH 20E,B02,083774,Ciotti; Benjamin,18,0,35,17
1657670822474,MATH 103A,A01,083777,Greenfeld; Be'Eri,3,0,36,33
1657670822474,MATH 103A,A02,083778,Greenfeld; Be'Eri,5,0,36,31
1657670822474,MATH 103A,A03,093561,Greenfeld; Be'Eri,6,0,36,30
1657670822474,MATH 103A,B01,083779,Greenfeld; Be'Eri,7,0,36,29
1657670822474,MATH 103A,B02,083780,Greenfeld; Be'Eri,4,0,36,32
1657670822474,MATH 103A,B03,093562,Greenfeld; Be'Eri,3,0,36,33
1657670828502,MATH 105,A01,085443,Carter; Anne Toulson,15,0,35,20
1657670828502,MATH 105,A02,093477,Carter; Anne Toulson,20,0,35,15
1657670834536,MATH 109,A01,083213,Ganzberger; Geoffrey Michael,2,0,34,32
1657670834536,MATH 109,A02,083214,Ganzberger; Geoffrey Michael,4,0,34,30
1657670834536,MATH 109,A03,093478,Ganzberger; Geoffrey Michael,2,0,34,32
1657670834536,MATH 109,B01,083215,Ganzberger; Geoffrey Michael,1,0,32,31
1657670834536,MATH 109,B02,083216,Ganzberger; Geoffrey Michael,2,0,32,30
1657670834536,MATH 109,B03,093479,Ganzberger; Geoffrey Michael,8,0,32,24
1657670840565,MATH 142A,A01,083219,Chow; Bennett,7,0,32,25
1657670840565,MATH 142A,A02,083220,Chow; Bennett,10,0,32,22
1657670840565,MATH 142A,A03,093480,Chow; Bennett,9,0,32,23
1657670840565,MATH 142A,B03,093481,Chow; Bennett,8,0,32,24
1657670840565,MATH 142A,B04,093558,Chow; Bennett,13,0,32,19
1657670840565,MATH 142A,B05,093559,Chow; Bennett,6,0,32,26
1657670846589,MATH 193A,A01,083224,Rotar; Vladimir,8,0,34,26
1657670846589,MATH 193A,A02,083225,Rotar; Vladimir,9,0,34,25
1657670846589,MATH 193A,A03,083781,Rotar; Vladimir,5,0,34,29
1657670846589,MATH 193A,A04,083782,Rotar; Vladimir,10,0,34,24
1657670846589,MATH 193A,A05,093482,Rotar; Vladimir,10,0,34,24
1657670852616,MATH 197,001,091859,McAuley; Julian John,9999,0,9999,0
1657670852616,MATH 197,002,095566,Kedlaya; Kiran S.,9997,0,9999,2
1657670852616,MATH 197,003,095567,Xiao; Ming,9999,0,9999,0
1657670852616,MATH 197,004,095571,Perols; Johan Lars,9998,0,9999,1
1657670859669,COGS 9,A01,083615,Shannon; Kyle Michael,9,0,75,66
1657670865693,COGS 11,A01,083617,Boyle; Mary E. T.,23,0,48,25
1657670871720,COGS 13,A01,083071,Bastos; Amalia Pinkusfeld,11,0,71,60
1657670877746,COGS 14A,A01,092681,Semenuks; Arturs,5,1,100,95
1657670883770,COGS 14B,A01,083073,Cheng; Tzu-Han,6,0,63,57
1657670889797,COGS 17,A01,092677,Semenuks; Arturs,6,0,81,75
1657670895819,COGS 100,A01,083619,Allen; Michael Gordon,17,0,70,53
1657670901848,COGS 101A,A01,083621,Davis; Joshua Daniel,9,0,68,59
1657670907872,COGS 101B,A01,091572,Allen; Michael Gordon,12,0,65,53
1657670913920,COGS 101C,A01,083625,Delgado; Tania,17,0,35,18
1657670919955,COGS 107A,A01,083627,Boyle; Mary E. T.,13,0,60,47
1657670925987,COGS 118A,A01,083075,Gupta; Anjum,21,0,76,55
1657670932010,CSE 3,A50,083646,Miranda; Gregory Joseph,24,0,50,26
1657670938037,CSE 8A,A50,083650,Miranda; Gregory Joseph,17,1,56,39
1657670944063,CSE 11,A01,083080,Cao; Yingjun,6,15,40,34
1657670950085,CSE 12,A01,083652,Krause-Levy; Sophia Louisa,28,1,120,92
1657670956112,CSE 15L,A01,083654,Morris; Justin Loren,9,0,50,41
1657670956112,CSE 15L,A02,083655,Morris; Justin Loren,9,0,50,41
1657670962137,CSE 20,A01,083657,Tran; Khoa Dang,39,0,80,41
1657670968159,CSE 21,A01,095574,Bach; Quang Tran,22,0,48,26
1657670974185,CSE 30,A01,083084,Eldon; John,6,0,80,74
1657670974185,CSE 30,B01,095061,Bhaskar; Nishant,9,0,50,41
1657670980208,CSE 100,A01,083659,Cao; Yingjun,5,4,70,65
1657670986231,CSE 134B,A01,083661,Powell; Thomas Allan,23,0,100,77
1657670992259,CSE 140,A01,083663,Gungor; Onat,15,0,85,70
1657670998286,CSE 140L,A01,083088,Eldon; John,22,0,100,78
1657671004313,CSE 175,A01,083665,Kumar; Rakesh,3,0,25,22
1657671010336,CSE 190,A00,092507,Dubnov; Shlomo,8,0,20,12
1657671016362,ECE 45,A01,083139,Congero; Spencer William,6,0,75,69
1657671022387,ECE 65,A50,083695,Saad; Andrew S,12,0,30,18
1657671022387,ECE 65,A51,095125,Saad; Andrew S,24,0,26,2
1657671028410,ECE 109,A01,091882,Touri; Behrouz,20,0,70,50
1657671034434,ECE 180,A00,083140,Abi Samra; Nicholas Camill,1,0,30,29
1657671034434,ECE 180,B00,083141,Abi Samra; Nicholas Camill,0,0,30,30
1657671040467,MATH 10A,A01,083735,Patchell; Gregory David,2,0,30,28
1657671040467,MATH 10A,A02,083736,Patchell; Gregory David,20,0,30,10
1657671040467,MATH 10A,A03,083737,Patchell; Gregory David,16,0,30,14
1657671046496,MATH 10B,A01,083207,Lim; Seonhee,8,0,34,26
1657671046496,MATH 10B,A02,083208,Lim; Seonhee,9,0,35,26
1657671046496,MATH 10B,A03,093472,Lim; Seonhee,7,0,34,27
1657671046496,MATH 10B,B01,083739,Sinha; Shubham,13,0,30,17
1657671052518,MATH 18,A01,083743,Cinel; Cameron Alexander,8,0,30,22
1657671052518,MATH 18,A02,083744,Cinel; Cameron Alexander,17,0,30,13
1657671052518,MATH 18,A03,083745,Cinel; Cameron Alexander,10,0,30,20
1657671052518,MATH 18,B01,083748,Rideout; David Porter,5,0,37,32
1657671052518,MATH 18,B02,083749,Rideout; David Porter,5,0,36,31
1657671052518,MATH 18,B03,083750,Rideout; David Porter,3,0,37,34
1657671052518,MATH 18,B04,083751,Rideout; David Porter,6,0,36,30
1657671052518,MATH 18,B05,093473,Rideout; David Porter,6,0,36,30
1657671052518,MATH 18,B06,093474,Rideout; David Porter,6,0,36,30
1657671058616,MATH 20A,A01,083754,Zheng; Zequn,14,0,40,26
1657671064639,MATH 20B,A01,083756,Briones; Jor-el Thomas Caparas,4,0,36,32
1657671064639,MATH 20B,A02,083757,Briones; Jor-el Thomas Caparas,1,0,36,35
1657671064639,MATH 20B,A03,093475,Briones; Jor-el Thomas Caparas,2,0,36,34
1657671070663,MATH 20C,A01,083760,Briones; Jor-el Thomas Caparas,1,0,35,34
1657671070663,MATH 20C,A02,083761,Briones; Jor-el Thomas Caparas,8,0,35,27
1657671070663,MATH 20C,A03,093476,Briones; Jor-el Thomas Caparas,0,1,36,36
1657671070663,MATH 20C,B01,083762,Bach; Quang Tran,1,0,30,29
1657671076700,MATH 20D,A01,083765,Tran; Brian Kha,5,0,30,25
1657671076700,MATH 20D,A02,083766,Tran; Brian Kha,5,0,30,25
1657671076700,MATH 20D,A03,083767,Tran; Brian Kha,5,0,30,25
1657671082724,MATH 20E,A01,083771,Ganguly; Soumya,9,0,32,23
1657671082724,MATH 20E,A02,083772,Ganguly; Soumya,6,0,32,26
1657671082724,MATH 20E,B01,083773,Ciotti; Benjamin,20,0,35,15
1657671082724,MATH 20E,B02,083774,Ciotti; Benjamin,18,0,35,17
1657671088747,MATH 103A,A01,083777,Greenfeld; Be'Eri,3,0,36,33
1657671088747,MATH 103A,A02,083778,Greenfeld; Be'Eri,5,0,36,31
1657671088747,MATH 103A,A03,093561,Greenfeld; Be'Eri,6,0,36,30
1657671088747,MATH 103A,B01,083779,Greenfeld; Be'Eri,7,0,36,29
1657671088747,MATH 103A,B02,083780,Greenfeld; Be'Eri,4,0,36,32
1657671088747,MATH 103A,B03,093562,Greenfeld; Be'Eri,3,0,36,33
1657671094770,MATH 105,A01,085443,Carter; Anne Toulson,15,0,35,20
1657671094770,MATH 105,A02,093477,Carter; Anne Toulson,20,0,35,15
1657671100794,MATH 109,A01,083213,Ganzberger; Geoffrey Michael,2,0,34,32
1657671100794,MATH 109,A02,083214,Ganzberger; Geoffrey Michael,4,0,34,30
1657671100794,MATH 109,A03,093478,Ganzberger; Geoffrey Michael,2,0,34,32
1657671100794,MATH 109,B01,083215,Ganzberger; Geoffrey Michael,1,0,32,31
1657671100794,MATH 109,B02,083216,Ganzberger; Geoffrey Michael,2,0,32,30
1657671100794,MATH 109,B03,093479,Ganzberger; Geoffrey Michael,8,0,32,24
1657671106817,MATH 142A,A01,083219,Chow; Bennett,7,0,32,25
1657671106817,MATH 142A,A02,083220,Chow; Bennett,10,0,32,22
1657671106817,MATH 142A,A03,093480,Chow; Bennett,9,0,32,23
1657671106817,MATH 142A,B03,093481,Chow; Bennett,8,0,32,24
1657671106817,MATH 142A,B04,093558,Chow; Bennett,13,0,32,19
1657671106817,MATH 142A,B05,093559,Chow; Bennett,6,0,32,26
1657671112845,MATH 193A,A01,083224,Rotar; Vladimir,8,0,34,26
1657671112845,MATH 193A,A02,083225,Rotar; Vladimir,9,0,34,25
1657671112845,MATH 193A,A03,083781,Rotar; Vladimir,5,0,34,29
1657671112845,MATH 193A,A04,083782,Rotar; Vladimir,10,0,34,24
1657671112845,MATH 193A,A05,093482,Rotar; Vladimir,10,0,34,24
1657671118868,MATH 197,001,091859,McAuley; Julian John,9999,0,9999,0
1657671118868,MATH 197,002,095566,Kedlaya; Kiran S.,9997,0,9999,2
1657671118868,MATH 197,003,095567,Xiao; Ming,9999,0,9999,0
1657671118868,MATH 197,004,095571,Perols; Johan Lars,9998,0,9999,1
1657671125935,COGS 9,A01,083615,Shannon; Kyle Michael,9,0,75,66
1657671131960,COGS 11,A01,083617,Boyle; Mary E. T.,23,0,48,25
1657671137984,COGS 13,A01,083071,Bastos; Amalia Pinkusfeld,11,0,71,60
1657671144010,COGS 14A,A01,092681,Semenuks; Arturs,5,1,100,95
1657671150037,COGS 14B,A01,083073,Cheng; Tzu-Han,6,0,63,57
1657671156065,COGS 17,A01,092677,Semenuks; Arturs,6,0,81,75
1657671162095,COGS 100,A01,083619,Allen; Michael Gordon,17,0,70,53
1657671168123,COGS 101A,A01,083621,Davis; Joshua Daniel,9,0,68,59
1657671174146,COGS 101B,A01,091572,Allen; Michael Gordon,12,0,65,53
1657671180171,COGS 101C,A01,083625,Delgado; Tania,17,0,35,18
1657671186195,COGS 107A,A01,083627,Boyle; Mary E. T.,13,0,60,47
1657671192222,COGS 118A,A01,083075,Gupta; Anjum,21,0,76,55
1657671198251,CSE 3,A50,083646,Miranda; Gregory Joseph,24,0,50,26
1657671204273,CSE 8A,A50,083650,Miranda; Gregory Joseph,17,1,56,39
1657671210305,CSE 11,A01,083080,Cao; Yingjun,6,15,40,34
1657671216344,CSE 12,A01,083652,Krause-Levy; Sophia Louisa,28,1,120,92
1657671222372,CSE 15L,A01,083654,Morris; Justin Loren,9,0,50,41
1657671222372,CSE 15L,A02,083655,Morris; Justin Loren,9,0,50,41
1657671228401,CSE 20,A01,083657,Tran; Khoa Dang,39,0,80,41
1657671234424,CSE 21,A01,095574,Bach; Quang Tran,22,0,48,26
1657671240450,CSE 30,A01,083084,Eldon; John,6,0,80,74
1657671240450,CSE 30,B01,095061,Bhaskar; Nishant,9,0,50,41
1657671246474,CSE 100,A01,083659,Cao; Yingjun,5,4,70,65
1657671252497,CSE 134B,A01,083661,Powell; Thomas Allan,23,0,100,77
1657671258519,CSE 140,A01,083663,Gungor; Onat,15,0,85,70
1657671264543,CSE 140L,A01,083088,Eldon; John,22,0,100,78
1657671270568,CSE 175,A01,083665,Kumar; Rakesh,3,0,25,22
1657671276590,CSE 190,A00,092507,Dubnov; Shlomo,8,0,20,12
1657671282621,ECE 45,A01,083139,Congero; Spencer William,6,0,75,69
1657671288647,ECE 65,A50,083695,Saad; Andrew S,12,0,30,18
1657671288647,ECE 65,A51,095125,Saad; Andrew S,24,0,26,2
1657671294669,ECE 109,A01,091882,Touri; Behrouz,20,0,70,50
1657671300707,ECE 180,A00,083140,Abi Samra; Nicholas Camill,1,0,30,29
1657671300707,ECE 180,B00,083141,Abi Samra; Nicholas Camill,0,0,30,30
1657671306730,MATH 10A,A01,083735,Patchell; Gregory David,2,0,30,28
1657671306730,MATH 10A,A02,083736,Patchell; Gregory David,20,0,30,10
1657671306730,MATH 10A,A03,083737,Patchell; Gregory David,16,0,30,14
1657671312753,MATH 10B,A01,083207,Lim; Seonhee,8,0,34,26
1657671312753,MATH 10B,A02,083208,Lim; Seonhee,9,0,35,26
1657671312753,MATH 10B,A03,093472,Lim; Seonhee,7,0,34,27
1657671312753,MATH 10B,B01,083739,Sinha; Shubham,13,0,30,17
1657671318780,MATH 18,A01,083743,Cinel; Cameron Alexander,8,0,30,22
1657671318780,MATH 18,A02,083744,Cinel; Cameron Alexander,17,0,30,13
1657671318780,MATH 18,A03,083745,Cinel; Cameron Alexander,10,0,30,20
1657671318780,MATH 18,B01,083748,Rideout; David Porter,5,0,37,32
1657671318780,MATH 18,B02,083749,Rideout; David Porter,5,0,36,31
1657671318780,MATH 18,B03,083750,Rideout; David Porter,3,0,37,34
1657671318780,MATH 18,B04,083751,Rideout; David Porter,6,0,36,30
1657671318780,MATH 18,B05,093473,Rideout; David Porter,6,0,36,30
1657671318780,MATH 18,B06,093474,Rideout; David Porter,6,0,36,30
1657671324807,MATH 20A,A01,083754,Zheng; Zequn,14,0,40,26
1657671330831,MATH 20B,A01,083756,Briones; Jor-el Thomas Caparas,4,0,36,32
1657671330831,MATH 20B,A02,083757,Briones; Jor-el Thomas Caparas,1,0,36,35
1657671330831,MATH 20B,A03,093475,Briones; Jor-el Thomas Caparas,2,0,36,34
1657671336856,MATH 20C,A01,083760,Briones; Jor-el Thomas Caparas,1,0,35,34
1657671336856,MATH 20C,A02,083761,Briones; Jor-el Thomas Caparas,8,0,35,27
1657671336856,MATH 20C,A03,093476,Briones; Jor-el Thomas Caparas,0,1,36,36
1657671336856,MATH 20C,B01,083762,Bach; Quang Tran,1,0,30,29
1657671342878,MATH 20D,A01,083765,Tran; Brian Kha,5,0,30,25
1657671342878,MATH 20D,A02,083766,Tran; Brian Kha,5,0,30,25
1657671342878,MATH 20D,A03,083767,Tran; Brian Kha,5,0,30,25
1657671348910,MATH 20E,A01,083771,Ganguly; Soumya,9,0,32,23
1657671348910,MATH 20E,A02,083772,Ganguly; Soumya,6,0,32,26
1657671348910,MATH 20E,B01,083773,Ciotti; Benjamin,20,0,35,15
1657671348910,MATH 20E,B02,083774,Ciotti; Benjamin,18,0,35,17
1657671354937,MATH 103A,A01,083777,Greenfeld; Be'Eri,3,0,36,33
1657671354937,MATH 103A,A02,083778,Greenfeld; Be'Eri,5,0,36,31
1657671354937,MATH 103A,A03,093561,Greenfeld; Be'Eri,6,0,36,30
1657671354937,MATH 103A,B01,083779,Greenfeld; Be'Eri,7,0,36,29
1657671354937,MATH 103A,B02,083780,Greenfeld; Be'Eri,4,0,36,32
1657671354937,MATH 103A,B03,093562,Greenfeld; Be'Eri,3,0,36,33
1657671360965,MATH 105,A01,085443,Carter; Anne Toulson,15,0,35,20
1657671360965,MATH 105,A02,093477,Carter; Anne Toulson,20,0,35,15
1657671366990,MATH 109,A01,083213,Ganzberger; Geoffrey Michael,2,0,34,32
1657671366990,MATH 109,A02,083214,Ganzberger; Geoffrey Michael,4,0,34,30
1657671366990,MATH 109,A03,093478,Ganzberger; Geoffrey Michael,2,0,34,32
1657671366990,MATH 109,B01,083215,Ganzberger; Geoffrey Michael,1,0,32,31
1657671366990,MATH 109,B02,083216,Ganzberger; Geoffrey Michael,2,0,32,30
1657671366990,MATH 109,B03,093479,Ganzberger; Geoffrey Michael,8,0,32,24
1657671373018,MATH 142A,A01,083219,Chow; Bennett,7,0,32,25
1657671373018,MATH 142A,A02,083220,Chow; Bennett,10,0,32,22
1657671373018,MATH 142A,A03,093480,Chow; Bennett,9,0,32,23
1657671373018,MATH 142A,B03,093481,Chow; Bennett,8,0,32,24
1657671373018,MATH 142A,B04,093558,Chow; Bennett,13,0,32,19
1657671373018,MATH 142A,B05,093559,Chow; Bennett,6,0,32,26
1657671379043,MATH 193A,A01,083224,Rotar; Vladimir,8,0,34,26
1657671379043,MATH 193A,A02,083225,Rotar; Vladimir,9,0,34,25
1657671379043,MATH 193A,A03,083781,Rotar; Vladimir,5,0,34,29
1657671379043,MATH 193A,A04,083782,Rotar; Vladimir,10,0,34,24
1657671379043,MATH 193A,A05,093482,Rotar; Vladimir,10,0,34,24
1657671385067,MATH 197,001,091859,McAuley; Julian John,9999,0,9999,0
1657671385067,MATH 197,002,095566,Kedlaya; Kiran S.,9997,0,9999,2
1657671385067,MATH 197,003,095567,Xiao; Ming,9999,0,9999,0
1657671385067,MATH 197,004,095571,Perols; Johan Lars,9998,0,9999,1
1657671392135,COGS 9,A01,083615,Shannon; Kyle Michael,9,0,75,66
1657671398162,COGS 11,A01,083617,Boyle; Mary E. T.,23,0,48,25
1657671404198,COGS 13,A01,083071,Bastos; Amalia Pinkusfeld,11,0,71,60
1657671410223,COGS 14A,A01,092681,Semenuks; Arturs,5,1,100,95
1657671416247,COGS 14B,A01,083073,Cheng; Tzu-Han,6,0,63,57
1657671422277,COGS 17,A01,092677,Semenuks; Arturs,6,0,81,75
1657671428304,COGS 100,A01,083619,Allen; Michael Gordon,17,0,70,53
1657671434340,COGS 101A,A01,083621,Davis; Joshua Daniel,9,0,68,59
1657671440363,COGS 101B,A01,091572,Allen; Michael Gordon,12,0,65,53
1657671446385,COGS 101C,A01,083625,Delgado; Tania,17,0,35,18
1657671452416,COGS 107A,A01,083627,Boyle; Mary E. T.,13,0,60,47
1657671458439,COGS 118A,A01,083075,Gupta; Anjum,21,0,76,55
1657671464464,CSE 3,A50,083646,Miranda; Gregory Joseph,24,0,50,26
1657671470486,CSE 8A,A50,083650,Miranda; Gregory Joseph,17,1,56,39
1657671476509,CSE 11,A01,083080,Cao; Yingjun,6,15,40,34
1657671482535,CSE 12,A01,083652,Krause-Levy; Sophia Louisa,28,1,120,92
1657671488558,CSE 15L,A01,083654,Morris; Justin Loren,9,0,50,41
1657671488558,CSE 15L,A02,083655,Morris; Justin Loren,9,0,50,41
1657671494584,CSE 20,A01,083657,Tran; Khoa Dang,39,0,80,41
1657671500606,CSE 21,A01,095574,Bach; Quang Tran,22,0,48,26
1657671506629,CSE 30,A01,083084,Eldon; John,6,0,80,74
1657671506629,CSE 30,B01,095061,Bhaskar; Nishant,9,0,50,41
1657671512662,CSE 100,A01,083659,Cao; Yingjun,5,4,70,65
1657671518688,CSE 134B,A01,083661,Powell; Thomas Allan,23,0,100,77
1657671524710,CSE 140,A01,083663,Gungor; Onat,15,0,85,70
1657671530737,CSE 140L,A01,083088,Eldon; John,22,0,100,78
1657671536767,CSE 175,A01,083665,Kumar; Rakesh,3,0,25,22
1657671542791,CSE 190,A00,092507,Dubnov; Shlomo,8,0,20,12
1657671548813,ECE 45,A01,083139,Congero; Spencer William,6,0,75,69
1657671554840,ECE 65,A50,083695,Saad; Andrew S,12,0,30,18
1657671554840,ECE 65,A51,095125,Saad; Andrew S,24,0,26,2
1657671560866,ECE 109,A01,091882,Touri; Behrouz,20,0,70,50
1657671566891,ECE 180,A00,083140,Abi Samra; Nicholas Camill,1,0,30,29
1657671566891,ECE 180,B00,083141,Abi Samra; Nicholas Camill,0,0,30,30
1657671572915,MATH 10A,A01,083735,Patchell; Gregory David,2,0,30,28
1657671572915,MATH 10A,A02,083736,Patchell; Gregory David,20,0,30,10
1657671572915,MATH 10A,A03,083737,Patchell; Gregory David,16,0,30,14
1657671578940,MATH 10B,A01,083207,Lim; Seonhee,8,0,34,26
1657671578940,MATH 10B,A02,083208,Lim; Seonhee,9,0,35,26
1657671578940,MATH 10B,A03,093472,Lim; Seonhee,7,0,34,27
1657671578940,MATH 10B,B01,083739,Sinha; Shubham,13,0,30,17
1657671584964,MATH 18,A01,083743,Cinel; Cameron Alexander,8,0,30,22
1657671584964,MATH 18,A02,083744,Cinel; Cameron Alexander,17,0,30,13
1657671584964,MATH 18,A03,083745,Cinel; Cameron Alexander,10,0,30,20
1657671584964,MATH 18,B01,083748,Rideout; David Porter,5,0,37,32
1657671584964,MATH 18,B02,083749,Rideout; David Porter,5,0,36,31
1657671584964,MATH 18,B03,083750,Rideout; David Porter,3,0,37,34
1657671584964,MATH 18,B04,083751,Rideout; David Porter,6,0,36,30
1657671584964,MATH 18,B05,093473,Rideout; David Porter,6,0,36,30
1657671584964,MATH 18,B06,093474,Rideout; David Porter,6,0,36,30
1657671590989,MATH 20A,A01,083754,Zheng; Zequn,14,0,40,26
1657671597017,MATH 20B,A01,083756,Briones; Jor-el Thomas Caparas,4,0,36,32
1657671597017,MATH 20B,A02,083757,Briones; Jor-el Thomas Caparas,1,0,36,35
1657671597017,MATH 20B,A03,093475,Briones; Jor-el Thomas Caparas,2,0,36,34
1657671603050,MATH 20C,A01,083760,Briones; Jor-el Thomas Caparas,1,0,35,34
1657671603050,MATH 20C,A02,083761,Briones; Jor-el Thomas Caparas,8,0,35,27
1657671603050,MATH 20C,A03,093476,Briones; Jor-el Thomas Caparas,0,1,36,36
1657671603050,MATH 20C,B01,083762,Bach; Quang Tran,1,0,30,29
1657671609080,MATH 20D,A01,083765,Tran; Brian Kha,5,0,30,25
1657671609080,MATH 20D,A02,083766,Tran; Brian Kha,5,0,30,25
1657671609080,MATH 20D,A03,083767,Tran; Brian Kha,5,0,30,25
1657671615103,MATH 20E,A01,083771,Ganguly; Soumya,9,0,32,23
1657671615103,MATH 20E,A02,083772,Ganguly; Soumya,6,0,32,26
1657671615103,MATH 20E,B01,083773,Ciotti; Benjamin,20,0,35,15
1657671615103,MATH 20E,B02,083774,Ciotti; Benjamin,18,0,35,17
1657671621127,MATH 103A,A01,083777,Greenfeld; Be'Eri,3,0,36,33
1657671621127,MATH 103A,A02,083778,Greenfeld; Be'Eri,5,0,36,31
1657671621127,MATH 103A,A03,093561,Greenfeld; Be'Eri,6,0,36,30
1657671621127,MATH 103A,B01,083779,Greenfeld; Be'Eri,7,0,36,29
1657671621127,MATH 103A,B02,083780,Greenfeld; Be'Eri,4,0,36,32
1657671621127,MATH 103A,B03,093562,Greenfeld; Be'Eri,3,0,36,33
1657671627153,MATH 105,A01,085443,Carter; Anne Toulson,15,0,35,20
1657671627153,MATH 105,A02,093477,Carter; Anne Toulson,20,0,35,15
1657671633182,MATH 109,A01,083213,Ganzberger; Geoffrey Michael,2,0,34,32
1657671633182,MATH 109,A02,083214,Ganzberger; Geoffrey Michael,4,0,34,30
1657671633182,MATH 109,A03,093478,Ganzberger; Geoffrey Michael,2,0,34,32
1657671633182,MATH 109,B01,083215,Ganzberger; Geoffrey Michael,1,0,32,31
1657671633182,MATH 109,B02,083216,Ganzberger; Geoffrey Michael,2,0,32,30
1657671633182,MATH 109,B03,093479,Ganzberger; Geoffrey Michael,8,0,32,24
1657671639211,MATH 142A,A01,083219,Chow; Bennett,7,0,32,25
1657671639211,MATH 142A,A02,083220,Chow; Bennett,10,0,32,22
1657671639211,MATH 142A,A03,093480,Chow; Bennett,9,0,32,23
1657671639211,MATH 142A,B03,093481,Chow; Bennett,8,0,32,24
1657671639211,MATH 142A,B04,093558,Chow; Bennett,13,0,32,19
1657671639211,MATH 142A,B05,093559,Chow; Bennett,6,0,32,26
1657671645238,MATH 193A,A01,083224,Rotar; Vladimir,8,0,34,26
1657671645238,MATH 193A,A02,083225,Rotar; Vladimir,9,0,34,25
1657671645238,MATH 193A,A03,083781,Rotar; Vladimir,5,0,34,29
1657671645238,MATH 193A,A04,083782,Rotar; Vladimir,10,0,34,24
1657671645238,MATH 193A,A05,093482,Rotar; Vladimir,10,0,34,24
1657671651260,MATH 197,001,091859,McAuley; Julian John,9999,0,9999,0
1657671651260,MATH 197,002,095566,Kedlaya; Kiran S.,9997,0,9999,2
1657671651260,MATH 197,003,095567,Xiao; Ming,9999,0,9999,0
1657671651260,MATH 197,004,095571,Perols; Johan Lars,9998,0,9999,1
1657671658391,COGS 9,A01,083615,Shannon; Kyle Michael,9,0,75,66
1657671664417,COGS 11,A01,083617,Boyle; Mary E. T.,23,0,48,25
1657671670444,COGS 13,A01,083071,Bastos; Amalia Pinkusfeld,11,0,71,60
1657671676471,COGS 14A,A01,092681,Semenuks; Arturs,5,1,100,95
1657671682498,COGS 14B,A01,083073,Cheng; Tzu-Han,6,0,63,57
1657671688524,COGS 17,A01,092677,Semenuks; Arturs,6,0,81,75
1657671694549,COGS 100,A01,083619,Allen; Michael Gordon,17,0,70,53
1657671700576,COGS 101A,A01,083621,Davis; Joshua Daniel,9,0,68,59
1657671706608,COGS 101B,A01,091572,Allen; Michael Gordon,12,0,65,53
1657671712632,COGS 101C,A01,083625,Delgado; Tania,17,0,35,18
1657671718655,COGS 107A,A01,083627,Boyle; Mary E. T.,13,0,60,47
1657671724678,COGS 118A,A01,083075,Gupta; Anjum,21,0,76,55
1657671730702,CSE 3,A50,083646,Miranda; Gregory Joseph,24,0,50,26
1657671736727,CSE 8A,A50,083650,Miranda; Gregory Joseph,17,1,56,39
1657671742748,CSE 11,A01,083080,Cao; Yingjun,6,15,40,34
1657671748773,CSE 12,A01,083652,Krause-Levy; Sophia Louisa,28,1,120,92
1657671754794,CSE 15L,A01,083654,Morris; Justin Loren,9,0,50,41
1657671754794,CSE 15L,A02,083655,Morris; Justin Loren,9,0,50,41
1657671760817,CSE 20,A01,083657,Tran; Khoa Dang,39,0,80,41
1657671766841,CSE 21,A01,095574,Bach; Quang Tran,22,0,48,26
1657671772865,CSE 30,A01,083084,Eldon; John,6,0,80,74
1657671772865,CSE 30,B01,095061,Bhaskar; Nishant,9,0,50,41
1657671778888,CSE 100,A01,083659,Cao; Yingjun,5,4,70,65
1657671784910,CSE 134B,A01,083661,Powell; Thomas Allan,23,0,100,77
1657671790932,CSE 140,A01,083663,Gungor; Onat,15,0,85,70
1657671796955,CSE 140L,A01,083088,Eldon; John,22,0,100,78
1657671802981,CSE 175,A01,083665,Kumar; Rakesh,3,0,25,22
1657671809007,CSE 190,A00,092507,Dubnov; Shlomo,8,0,20,12
1657671815034,ECE 45,A01,083139,Congero; Spencer William,6,0,75,69
1657671821057,ECE 65,A50,083695,Saad; Andrew S,12,0,30,18
1657671821057,ECE 65,A51,095125,Saad; Andrew S,24,0,26,2
1657671827079,ECE 109,A01,091882,Touri; Behrouz,20,0,70,50
1657671833105,ECE 180,A00,083140,Abi Samra; Nicholas Camill,1,0,30,29
1657671833105,ECE 180,B00,083141,Abi Samra; Nicholas Camill,0,0,30,30
1657671839128,MATH 10A,A01,083735,Patchell; Gregory David,2,0,30,28
1657671839128,MATH 10A,A02,083736,Patchell; Gregory David,20,0,30,10
1657671839128,MATH 10A,A03,083737,Patchell; Gregory David,16,0,30,14
1657671845152,MATH 10B,A01,083207,Lim; Seonhee,8,0,34,26
1657671845152,MATH 10B,A02,083208,Lim; Seonhee,9,0,35,26
1657671845152,MATH 10B,A03,093472,Lim; Seonhee,7,0,34,27
1657671845152,MATH 10B,B01,083739,Sinha; Shubham,13,0,30,17
1657671851182,MATH 18,A01,083743,Cinel; Cameron Alexander,8,0,30,22
1657671851182,MATH 18,A02,083744,Cinel; Cameron Alexander,17,0,30,13
1657671851182,MATH 18,A03,083745,Cinel; Cameron Alexander,10,0,30,20
1657671851182,MATH 18,B01,083748,Rideout; David Porter,5,0,37,32
1657671851182,MATH 18,B02,083749,Rideout; David Porter,5,0,36,31
1657671851182,MATH 18,B03,083750,Rideout; David Porter,3,0,37,34
1657671851182,MATH 18,B04,083751,Rideout; David Porter,6,0,36,30
1657671851182,MATH 18,B05,093473,Rideout; David Porter,6,0,36,30
1657671851182,MATH 18,B06,093474,Rideout; David Porter,6,0,36,30
1657671857205,MATH 20A,A01,083754,Zheng; Zequn,14,0,40,26
1657671863233,MATH 20B,A01,083756,Briones; Jor-el Thomas Caparas,4,0,36,32
1657671863233,MATH 20B,A02,083757,Briones; Jor-el Thomas Caparas,1,0,36,35
1657671863233,MATH 20B,A03,093475,Briones; Jor-el Thomas Caparas,2,0,36,34
1657671869261,MATH 20C,A01,083760,Briones; Jor-el Thomas Caparas,1,0,35,34
1657671869261,MATH 20C,A02,083761,Briones; Jor-el Thomas Caparas,8,0,35,27
1657671869261,MATH 20C,A03,093476,Briones; Jor-el Thomas Caparas,0,1,36,36
1657671869261,MATH 20C,B01,083762,Bach; Quang Tran,1,0,30,29
1657671875283,MATH 20D,A01,083765,Tran; Brian Kha,5,0,30,25
1657671875283,MATH 20D,A02,083766,Tran; Brian Kha,5,0,30,25
1657671875283,MATH 20D,A03,083767,Tran; Brian Kha,5,0,30,25
1657671881307,MATH 20E,A01,083771,Ganguly; Soumya,9,0,32,23
1657671881307,MATH 20E,A02,083772,Ganguly; Soumya,6,0,32,26
1657671881307,MATH 20E,B01,083773,Ciotti; Benjamin,20,0,35,15
1657671881307,MATH 20E,B02,083774,Ciotti; Benjamin,18,0,35,17
1657671887330,MATH 103A,A01,083777,Greenfeld; Be'Eri,3,0,36,33
1657671887330,MATH 103A,A02,083778,Greenfeld; Be'Eri,5,0,36,31
1657671887330,MATH 103A,A03,093561,Greenfeld; Be'Eri,6,0,36,30
1657671887330,MATH 103A,B01,083779,Greenfeld; Be'Eri,7,0,36,29
1657671887330,MATH 103A,B02,083780,Greenfeld; Be'Eri,4,0,36,32
1657671887330,MATH 103A,B03,093562,Greenfeld; Be'Eri,3,0,36,33
1657671893356,MATH 105,A01,085443,Carter; Anne Toulson,15,0,35,20
1657671893356,MATH 105,A02,093477,Carter; Anne Toulson,20,0,35,15
1657671899383,MATH 109,A01,083213,Ganzberger; Geoffrey Michael,2,0,34,32
1657671899383,MATH 109,A02,083214,Ganzberger; Geoffrey Michael,4,0,34,30
1657671899383,MATH 109,A03,093478,Ganzberger; Geoffrey Michael,2,0,34,32
1657671899383,MATH 109,B01,083215,Ganzberger; Geoffrey Michael,1,0,32,31
1657671899383,MATH 109,B02,083216,Ganzberger; Geoffrey Michael,2,0,32,30
1657671899383,MATH 109,B03,093479,Ganzberger; Geoffrey Michael,8,0,32,24
1657671905407,MATH 142A,A01,083219,Chow; Bennett,7,0,32,25
1657671905407,MATH 142A,A02,083220,Chow; Bennett,10,0,32,22
1657671905407,MATH 142A,A03,093480,Chow; Bennett,9,0,32,23
1657671905407,MATH 142A,B03,093481,Chow; Bennett,8,0,32,24
1657671905407,MATH 142A,B04,093558,Chow; Bennett,13,0,32,19
1657671905407,MATH 142A,B05,093559,Chow; Bennett,6,0,32,26
1657671911435,MATH 193A,A01,083224,Rotar; Vladimir,8,0,34,26
1657671911435,MATH 193A,A02,083225,Rotar; Vladimir,9,0,34,25
1657671911435,MATH 193A,A03,083781,Rotar; Vladimir,5,0,34,29
1657671911435,MATH 193A,A04,083782,Rotar; Vladimir,10,0,34,24
1657671911435,MATH 193A,A05,093482,Rotar; Vladimir,10,0,34,24
1657671917459,MATH 197,001,091859,McAuley; Julian John,9999,0,9999,0
1657671917459,MATH 197,002,095566,Kedlaya; Kiran S.,9997,0,9999,2
1657671917459,MATH 197,003,095567,Xiao; Ming,9999,0,9999,0
1657671917459,MATH 197,004,095571,Perols; Johan Lars,9998,0,9999,1
1657671924514,COGS 9,A01,083615,Shannon; Kyle Michael,9,0,75,66
1657671930544,COGS 11,A01,083617,Boyle; Mary E. T.,23,0,48,25
1657671936571,COGS 13,A01,083071,Bastos; Amalia Pinkusfeld,11,0,71,60
1657671942601,COGS 14A,A01,092681,Semenuks; Arturs,5,1,100,95
1657671948626,COGS 14B,A01,083073,Cheng; Tzu-Han,6,0,63,57
1657671954664,COGS 17,A01,092677,Semenuks; Arturs,6,0,81,75
1657671960694,COGS 100,A01,083619,Allen; Michael Gordon,17,0,70,53
1657671966717,COGS 101A,A01,083621,Davis; Joshua Daniel,9,0,68,59
1657671972741,COGS 101B,A01,091572,Allen; Michael Gordon,12,0,65,53
1657671978794,COGS 101C,A01,083625,Delgado; Tania,17,0,35,18
1657671984819,COGS 107A,A01,083627,Boyle; Mary E. T.,13,0,60,47
1657671990843,COGS 118A,A01,083075,Gupta; Anjum,21,0,76,55
1657671996866,CSE 3,A50,083646,Miranda; Gregory Joseph,24,0,50,26
1657672002889,CSE 8A,A50,083650,Miranda; Gregory Joseph,17,1,56,39
1657672008915,CSE 11,A01,083080,Cao; Yingjun,6,15,40,34
1657672014943,CSE 12,A01,083652,Krause-Levy; Sophia Louisa,28,1,120,92
1657672020965,CSE 15L,A01,083654,Morris; Justin Loren,9,0,50,41
1657672020965,CSE 15L,A02,083655,Morris; Justin Loren,9,0,50,41
1657672026989,CSE 20,A01,083657,Tran; Khoa Dang,39,0,80,41
1657672033013,CSE 21,A01,095574,Bach; Quang Tran,22,0,48,26
1657672039043,CSE 30,A01,083084,Eldon; John,6,0,80,74
1657672039043,CSE 30,B01,095061,Bhaskar; Nishant,9,0,50,41
1657672045080,CSE 100,A01,083659,Cao; Yingjun,5,4,70,65
1657672051107,CSE 134B,A01,083661,Powell; Thomas Allan,23,0,100,77
1657672057143,CSE 140,A01,083663,Gungor; Onat,15,0,85,70
1657672063167,CSE 140L,A01,083088,Eldon; John,22,0,100,78
1657672069195,CSE 175,A01,083665,Kumar; Rakesh,3,0,25,22
1657672075217,CSE 190,A00,092507,Dubnov; Shlomo,8,0,20,12
1657672081240,ECE 45,A01,083139,Congero; Spencer William,6,0,75,69
1657672087263,ECE 65,A50,083695,Saad; Andrew S,12,0,30,18
1657672087263,ECE 65,A51,095125,Saad; Andrew S,24,0,26,2
1657672093289,ECE 109,A01,091882,Touri; Behrouz,20,0,70,50
1657672099321,ECE 180,A00,083140,Abi Samra; Nicholas Camill,1,0,30,29
1657672099321,ECE 180,B00,083141,Abi Samra; Nicholas Camill,0,0,30,30
1657672105347,MATH 10A,A01,083735,Patchell; Gregory David,2,0,30,28
1657672105347,MATH 10A,A02,083736,Patchell; Gregory David,20,0,30,10
1657672105347,MATH 10A,A03,083737,Patchell; Gregory David,16,0,30,14
1657672111371,MATH 10B,A01,083207,Lim; Seonhee,8,0,34,26
1657672111371,MATH 10B,A02,083208,Lim; Seonhee,9,0,35,26
1657672111371,MATH 10B,A03,093472,Lim; Seonhee,7,0,34,27
1657672111371,MATH 10B,B01,083739,Sinha; Shubham,13,0,30,17
1657672117401,MATH 18,A01,083743,Cinel; Cameron Alexander,8,0,30,22
1657672117401,MATH 18,A02,083744,Cinel; Cameron Alexander,17,0,30,13
1657672117401,MATH 18,A03,083745,Cinel; Cameron Alexander,10,0,30,20
1657672117401,MATH 18,B01,083748,Rideout; David Porter,5,0,37,32
1657672117401,MATH 18,B02,083749,Rideout; David Porter,5,0,36,31
1657672117401,MATH 18,B03,083750,Rideout; David Porter,3,0,37,34
1657672117401,MATH 18,B04,083751,Rideout; David Porter,6,0,36,30
1657672117401,MATH 18,B05,093473,Rideout; David Porter,6,0,36,30
1657672117401,MATH 18,B06,093474,Rideout; David Porter,6,0,36,30
1657672123428,MATH 20A,A01,083754,Zheng; Zequn,14,0,40,26
1657672129452,MATH 20B,A01,083756,Briones; Jor-el Thomas Caparas,4,0,36,32
1657672129452,MATH 20B,A02,083757,Briones; Jor-el Thomas Caparas,1,0,36,35
1657672129452,MATH 20B,A03,093475,Briones; Jor-el Thomas Caparas,2,0,36,34
1657672135480,MATH 20C,A01,083760,Briones; Jor-el Thomas Caparas,1,0,35,34
1657672135480,MATH 20C,A02,083761,Briones; Jor-el Thomas Caparas,8,0,35,27
1657672135480,MATH 20C,A03,093476,Briones; Jor-el Thomas Caparas,0,1,36,36
1657672135480,MATH 20C,B01,083762,Bach; Quang Tran,1,0,30,29
1657672141503,MATH 20D,A01,083765,Tran; Brian Kha,5,0,30,25
1657672141503,MATH 20D,A02,083766,Tran; Brian Kha,5,0,30,25
1657672141503,MATH 20D,A03,083767,Tran; Brian Kha,5,0,30,25
1657672147530,MATH 20E,A01,083771,Ganguly; Soumya,9,0,32,23
1657672147530,MATH 20E,A02,083772,Ganguly; Soumya,6,0,32,26
1657672147530,MATH 20E,B01,083773,Ciotti; Benjamin,20,0,35,15
1657672147530,MATH 20E,B02,083774,Ciotti; Benjamin,18,0,35,17
1657672153555,MATH 103A,A01,083777,Greenfeld; Be'Eri,3,0,36,33
1657672153555,MATH 103A,A02,083778,Greenfeld; Be'Eri,5,0,36,31
1657672153555,MATH 103A,A03,093561,Greenfeld; Be'Eri,6,0,36,30
1657672153555,MATH 103A,B01,083779,Greenfeld; Be'Eri,7,0,36,29
1657672153555,MATH 103A,B02,083780,Greenfeld; Be'Eri,4,0,36,32
1657672153555,MATH 103A,B03,093562,Greenfeld; Be'Eri,3,0,36,33
1657672159590,MATH 105,A01,085443,Carter; Anne Toulson,15,0,35,20
1657672159590,MATH 105,A02,093477,Carter; Anne Toulson,20,0,35,15
1657672165613,MATH 109,A01,083213,Ganzberger; Geoffrey Michael,2,0,34,32
1657672165613,MATH 109,A02,083214,Ganzberger; Geoffrey Michael,4,0,34,30
1657672165613,MATH 109,A03,093478,Ganzberger; Geoffrey Michael,2,0,34,32
1657672165613,MATH 109,B01,083215,Ganzberger; Geoffrey Michael,1,0,32,31
1657672165613,MATH 109,B02,083216,Ganzberger; Geoffrey Michael,2,0,32,30
1657672165613,MATH 109,B03,093479,Ganzberger; Geoffrey Michael,8,0,32,24
1657672171637,MATH 142A,A01,083219,Chow; Bennett,7,0,32,25
1657672171637,MATH 142A,A02,083220,Chow; Bennett,10,0,32,22
1657672171637,MATH 142A,A03,093480,Chow; Bennett,9,0,32,23
1657672171637,MATH 142A,B03,093481,Chow; Bennett,8,0,32,24
1657672171637,MATH 142A,B04,093558,Chow; Bennett,13,0,32,19
1657672171637,MATH 142A,B05,093559,Chow; Bennett,6,0,32,26
1657672177658,MATH 193A,A01,083224,Rotar; Vladimir,8,0,34,26
1657672177658,MATH 193A,A02,083225,Rotar; Vladimir,9,0,34,25
1657672177658,MATH 193A,A03,083781,Rotar; Vladimir,5,0,34,29
1657672177658,MATH 193A,A04,083782,Rotar; Vladimir,10,0,34,24
1657672177658,MATH 193A,A05,093482,Rotar; Vladimir,10,0,34,24
1657672183685,MATH 197,001,091859,McAuley; Julian John,9999,0,9999,0
1657672183685,MATH 197,002,095566,Kedlaya; Kiran S.,9997,0,9999,2
1657672183685,MATH 197,003,095567,Xiao; Ming,9999,0,9999,0
1657672183685,MATH 197,004,095571,Perols; Johan Lars,9998,0,9999,1
1657672190748,COGS 9,A01,083615,Shannon; Kyle Michael,9,0,75,66
1657672196772,COGS 11,A01,083617,Boyle; Mary E. T.,23,0,48,25
1657672202795,COGS 13,A01,083071,Bastos; Amalia Pinkusfeld,11,0,71,60
1657672208821,COGS 14A,A01,092681,Semenuks; Arturs,5,1,100,95
1657672214843,COGS 14B,A01,083073,Cheng; Tzu-Han,6,0,63,57
1657672220866,COGS 17,A01,092677,Semenuks; Arturs,6,0,81,75
1657672226888,COGS 100,A01,083619,Allen; Michael Gordon,17,0,70,53
1657672232913,COGS 101A,A01,083621,Davis; Joshua Daniel,9,0,68,59
1657672238937,COGS 101B,A01,091572,Allen; Michael Gordon,12,0,65,53
1657672244960,COGS 101C,A01,083625,Delgado; Tania,17,0,35,18
1657672251093,COGS 107A,A01,083627,Boyle; Mary E. T.,13,0,60,47
1657672257117,COGS 118A,A01,083075,Gupta; Anjum,21,0,76,55
1657672263143,CSE 3,A50,083646,Miranda; Gregory Joseph,24,0,50,26
1657672269168,CSE 8A,A50,083650,Miranda; Gregory Joseph,17,1,56,39
1657672275192,CSE 11,A01,083080,Cao; Yingjun,6,15,40,34
1657672281215,CSE 12,A01,083652,Krause-Levy; Sophia Louisa,28,1,120,92
1657672287245,CSE 15L,A01,083654,Morris; Justin Loren,9,0,50,41
1657672287245,CSE 15L,A02,083655,Morris; Justin Loren,9,0,50,41
1657672293268,CSE 20,A01,083657,Tran; Khoa Dang,39,0,80,41
1657672299292,CSE 21,A01,095574,Bach; Quang Tran,22,0,48,26
1657672305322,CSE 30,A01,083084,Eldon; John,6,0,80,74
1657672305322,CSE 30,B01,095061,Bhaskar; Nishant,9,0,50,41
1657672311348,CSE 100,A01,083659,Cao; Yingjun,5,4,70,65
1657672317372,CSE 134B,A01,083661,Powell; Thomas Allan,23,0,100,77
1657672323396,CSE 140,A01,083663,Gungor; Onat,15,0,85,70
1657672329423,CSE 140L,A01,083088,Eldon; John,22,0,100,78
1657672335448,CSE 175,A01,083665,Kumar; Rakesh,3,0,25,22
1657672341475,CSE 190,A00,092507,Dubnov; Shlomo,8,0,20,12
1657672347501,ECE 45,A01,083139,Congero; Spencer William,6,0,75,69
1657672353524,ECE 65,A50,083695,Saad; Andrew S,12,0,30,18
1657672353524,ECE 65,A51,095125,Saad; Andrew S,24,0,26,2
1657672359552,ECE 109,A01,091882,Touri; Behrouz,20,0,70,50
1657672365576,ECE 180,A00,083140,Abi Samra; Nicholas Camill,1,0,30,29
1657672365576,ECE 180,B00,083141,Abi Samra; Nicholas Camill,0,0,30,30
1657672371609,MATH 10A,A01,083735,Patchell; Gregory David,2,0,30,28
1657672371609,MATH 10A,A02,083736,Patchell; Gregory David,20,0,30,10
1657672371609,MATH 10A,A03,083737,Patchell; Gregory David,16,0,30,14
1657672377638,MATH 10B,A01,083207,Lim; Seonhee,8,0,34,26
1657672377638,MATH 10B,A02,083208,Lim; Seonhee,9,0,35,26
1657672377638,MATH 10B,A03,093472,Lim; Seonhee,7,0,34,27
1657672377638,MATH 10B,B01,083739,Sinha; Shubham,13,0,30,17
1657672383662,MATH 18,A01,083743,Cinel; Cameron Alexander,8,0,30,22
1657672383662,MATH 18,A02,083744,Cinel; Cameron Alexander,17,0,30,13
1657672383662,MATH 18,A03,083745,Cinel; Cameron Alexander,10,0,30,20
1657672383662,MATH 18,B01,083748,Rideout; David Porter,5,0,37,32
1657672383662,MATH 18,B02,083749,Rideout; David Porter,5,0,36,31
1657672383662,MATH 18,B03,083750,Rideout; David Porter,3,0,37,34
1657672383662,MATH 18,B04,083751,Rideout; David Porter,6,0,36,30
1657672383662,MATH 18,B05,093473,Rideout; David Porter,6,0,36,30
1657672383662,MATH 18,B06,093474,Rideout; David Porter,6,0,36,30
1657672389686,MATH 20A,A01,083754,Zheng; Zequn,14,0,40,26
1657672395711,MATH 20B,A01,083756,Briones; Jor-el Thomas Caparas,4,0,36,32
1657672395711,MATH 20B,A02,083757,Briones; Jor-el Thomas Caparas,1,0,36,35
1657672395711,MATH 20B,A03,093475,Briones; Jor-el Thomas Caparas,2,0,36,34
1657672401738,MATH 20C,A01,083760,Briones; Jor-el Thomas Caparas,1,0,35,34
1657672401738,MATH 20C,A02,083761,Briones; Jor-el Thomas Caparas,8,0,35,27
1657672401738,MATH 20C,A03,093476,Briones; Jor-el Thomas Caparas,0,1,36,36
1657672401738,MATH 20C,B01,083762,Bach; Quang Tran,1,0,30,29
1657672407772,MATH 20D,A01,083765,Tran; Brian Kha,5,0,30,25
1657672407772,MATH 20D,A02,083766,Tran; Brian Kha,5,0,30,25
1657672407772,MATH 20D,A03,083767,Tran; Brian Kha,5,0,30,25
1657672413796,MATH 20E,A01,083771,Ganguly; Soumya,9,0,32,23
1657672413796,MATH 20E,A02,083772,Ganguly; Soumya,6,0,32,26
1657672413796,MATH 20E,B01,083773,Ciotti; Benjamin,20,0,35,15
1657672413796,MATH 20E,B02,083774,Ciotti; Benjamin,18,0,35,17
1657672419820,MATH 103A,A01,083777,Greenfeld; Be'Eri,3,0,36,33
1657672419820,MATH 103A,A02,083778,Greenfeld; Be'Eri,5,0,36,31
1657672419820,MATH 103A,A03,093561,Greenfeld; Be'Eri,6,0,36,30
1657672419820,MATH 103A,B01,083779,Greenfeld; Be'Eri,7,0,36,29
1657672419820,MATH 103A,B02,083780,Greenfeld; Be'Eri,4,0,36,32
1657672419820,MATH 103A,B03,093562,Greenfeld; Be'Eri,3,0,36,33
1657672425843,MATH 105,A01,085443,Carter; Anne Toulson,15,0,35,20
1657672425843,MATH 105,A02,093477,Carter; Anne Toulson,20,0,35,15
1657672431866,MATH 109,A01,083213,Ganzberger; Geoffrey Michael,2,0,34,32
1657672431866,MATH 109,A02,083214,Ganzberger; Geoffrey Michael,4,0,34,30
1657672431866,MATH 109,A03,093478,Ganzberger; Geoffrey Michael,2,0,34,32
1657672431866,MATH 109,B01,083215,Ganzberger; Geoffrey Michael,1,0,32,31
1657672431866,MATH 109,B02,083216,Ganzberger; Geoffrey Michael,2,0,32,30
1657672431866,MATH 109,B03,093479,Ganzberger; Geoffrey Michael,8,0,32,24
1657672437889,MATH 142A,A01,083219,Chow; Bennett,7,0,32,25
1657672437889,MATH 142A,A02,083220,Chow; Bennett,10,0,32,22
1657672437889,MATH 142A,A03,093480,Chow; Bennett,9,0,32,23
1657672437889,MATH 142A,B03,093481,Chow; Bennett,8,0,32,24
1657672437889,MATH 142A,B04,093558,Chow; Bennett,13,0,32,19
1657672437889,MATH 142A,B05,093559,Chow; Bennett,6,0,32,26
1657672443929,MATH 193A,A01,083224,Rotar; Vladimir,8,0,34,26
1657672443929,MATH 193A,A02,083225,Rotar; Vladimir,9,0,34,25
1657672443929,MATH 193A,A03,083781,Rotar; Vladimir,5,0,34,29
1657672443929,MATH 193A,A04,083782,Rotar; Vladimir,10,0,34,24
1657672443929,MATH 193A,A05,093482,Rotar; Vladimir,10,0,34,24
1657672449951,MATH 197,001,091859,McAuley; Julian John,9999,0,9999,0
1657672449951,MATH 197,002,095566,Kedlaya; Kiran S.,9997,0,9999,2
1657672449951,MATH 197,003,095567,Xiao; Ming,9999,0,9999,0
1657672449951,MATH 197,004,095571,Perols; Johan Lars,9998,0,9999,1
1657672457020,COGS 9,A01,083615,Shannon; Kyle Michael,9,0,75,66
1657672463044,COGS 11,A01,083617,Boyle; Mary E. T.,23,0,48,25
1657672469067,COGS 13,A01,083071,Bastos; Amalia Pinkusfeld,11,0,71,60
1657672475091,COGS 14A,A01,092681,Semenuks; Arturs,5,1,100,95
1657672481115,COGS 14B,A01,083073,Cheng; Tzu-Han,6,0,63,57
1657672487141,COGS 17,A01,092677,Semenuks; Arturs,6,0,81,75
1657672493165,COGS 100,A01,083619,Allen; Michael Gordon,17,0,70,53
1657672499187,COGS 101A,A01,083621,Davis; Joshua Daniel,9,0,68,59
1657672505214,COGS 101B,A01,091572,Allen; Michael Gordon,12,0,65,53
1657672511238,COGS 101C,A01,083625,Delgado; Tania,17,0,35,18
1657672517260,COGS 107A,A01,083627,Boyle; Mary E. T.,13,0,60,47
1657672523286,COGS 118A,A01,083075,Gupta; Anjum,21,0,76,55
1657672529310,CSE 3,A50,083646,Miranda; Gregory Joseph,24,0,50,26
1657672535336,CSE 8A,A50,083650,Miranda; Gregory Joseph,17,1,56,39
1657672541357,CSE 11,A01,083080,Cao; Yingjun,6,15,40,34
1657672547388,CSE 12,A01,083652,Krause-Levy; Sophia Louisa,28,1,120,92
1657672553413,CSE 15L,A01,083654,Morris; Justin Loren,9,0,50,41
1657672553413,CSE 15L,A02,083655,Morris; Justin Loren,9,0,50,41
1657672559440,CSE 20,A01,083657,Tran; Khoa Dang,39,0,80,41
1657672565464,CSE 21,A01,095574,Bach; Quang Tran,22,0,48,26
1657672571490,CSE 30,A01,083084,Eldon; John,6,0,80,74
1657672571490,CSE 30,B01,095061,Bhaskar; Nishant,9,0,50,41
1657672577545,CSE 100,A01,083659,Cao; Yingjun,5,4,70,65
1657672583566,CSE 134B,A01,083661,Powell; Thomas Allan,23,0,100,77
1657672589611,CSE 140,A01,083663,Gungor; Onat,15,0,85,70
1657672595633,CSE 140L,A01,083088,Eldon; John,22,0,100,78
1657672601657,CSE 175,A01,083665,Kumar; Rakesh,3,0,25,22
1657672607679,CSE 190,A00,092507,Dubnov; Shlomo,8,0,20,12
1657672613701,ECE 45,A01,083139,Congero; Spencer William,6,0,75,69
1657672619727,ECE 65,A50,083695,Saad; Andrew S,12,0,30,18
1657672619727,ECE 65,A51,095125,Saad; Andrew S,24,0,26,2
1657672625750,ECE 109,A01,091882,Touri; Behrouz,20,0,70,50
1657672631773,ECE 180,A00,083140,Abi Samra; Nicholas Camill,1,0,30,29
1657672631773,ECE 180,B00,083141,Abi Samra; Nicholas Camill,0,0,30,30
1657672637797,MATH 10A,A01,083735,Patchell; Gregory David,2,0,30,28
1657672637797,MATH 10A,A02,083736,Patchell; Gregory David,20,0,30,10
1657672637797,MATH 10A,A03,083737,Patchell; Gregory David,16,0,30,14
1657672643820,MATH 10B,A01,083207,Lim; Seonhee,8,0,34,26
1657672643820,MATH 10B,A02,083208,Lim; Seonhee,9,0,35,26
1657672643820,MATH 10B,A03,093472,Lim; Seonhee,7,0,34,27
1657672643820,MATH 10B,B01,083739,Sinha; Shubham,13,0,30,17
1657672649844,MATH 18,A01,083743,Cinel; Cameron Alexander,8,0,30,22
1657672649844,MATH 18,A02,083744,Cinel; Cameron Alexander,17,0,30,13
1657672649844,MATH 18,A03,083745,Cinel; Cameron Alexander,10,0,30,20
1657672649844,MATH 18,B01,083748,Rideout; David Porter,5,0,37,32
1657672649844,MATH 18,B02,083749,Rideout; David Porter,5,0,36,31
1657672649844,MATH 18,B03,083750,Rideout; David Porter,3,0,37,34
1657672649844,MATH 18,B04,083751,Rideout; David Porter,6,0,36,30
1657672649844,MATH 18,B05,093473,Rideout; David Porter,6,0,36,30
1657672649844,MATH 18,B06,093474,Rideout; David Porter,6,0,36,30
1657672655867,MATH 20A,A01,083754,Zheng; Zequn,14,0,40,26
1657672661902,MATH 20B,A01,083756,Briones; Jor-el Thomas Caparas,4,0,36,32
1657672661902,MATH 20B,A02,083757,Briones; Jor-el Thomas Caparas,1,0,36,35
1657672661902,MATH 20B,A03,093475,Briones; Jor-el Thomas Caparas,2,0,36,34
1657672667924,MATH 20C,A01,083760,Briones; Jor-el Thomas Caparas,1,0,35,34
1657672667924,MATH 20C,A02,083761,Briones; Jor-el Thomas Caparas,8,0,35,27
1657672667924,MATH 20C,A03,093476,Briones; Jor-el Thomas Caparas,0,1,36,36
1657672667924,MATH 20C,B01,083762,Bach; Quang Tran,1,0,30,29
1657672673949,MATH 20D,A01,083765,Tran; Brian Kha,5,0,30,25
1657672673949,MATH 20D,A02,083766,Tran; Brian Kha,5,0,30,25
1657672673949,MATH 20D,A03,083767,Tran; Brian Kha,5,0,30,25
1657672679973,MATH 20E,A01,083771,Ganguly; Soumya,9,0,32,23
1657672679973,MATH 20E,A02,083772,Ganguly; Soumya,6,0,32,26
1657672679973,MATH 20E,B01,083773,Ciotti; Benjamin,20,0,35,15
1657672679973,MATH 20E,B02,083774,Ciotti; Benjamin,18,0,35,17
1657672686002,MATH 103A,A01,083777,Greenfeld; Be'Eri,3,0,36,33
1657672686002,MATH 103A,A02,083778,Greenfeld; Be'Eri,5,0,36,31
1657672686002,MATH 103A,A03,093561,Greenfeld; Be'Eri,6,0,36,30
1657672686002,MATH 103A,B01,083779,Greenfeld; Be'Eri,7,0,36,29
1657672686002,MATH 103A,B02,083780,Greenfeld; Be'Eri,4,0,36,32
1657672686002,MATH 103A,B03,093562,Greenfeld; Be'Eri,3,0,36,33
1657672692026,MATH 105,A01,085443,Carter; Anne Toulson,15,0,35,20
1657672692026,MATH 105,A02,093477,Carter; Anne Toulson,20,0,35,15
1657672698054,MATH 109,A01,083213,Ganzberger; Geoffrey Michael,2,0,34,32
1657672698054,MATH 109,A02,083214,Ganzberger; Geoffrey Michael,4,0,34,30
1657672698054,MATH 109,A03,093478,Ganzberger; Geoffrey Michael,2,0,34,32
1657672698054,MATH 109,B01,083215,Ganzberger; Geoffrey Michael,1,0,32,31
1657672698054,MATH 109,B02,083216,Ganzberger; Geoffrey Michael,2,0,32,30
1657672698054,MATH 109,B03,093479,Ganzberger; Geoffrey Michael,8,0,32,24
1657672704085,MATH 142A,A01,083219,Chow; Bennett,7,0,32,25
1657672704085,MATH 142A,A02,083220,Chow; Bennett,10,0,32,22
1657672704085,MATH 142A,A03,093480,Chow; Bennett,9,0,32,23
1657672704085,MATH 142A,B03,093481,Chow; Bennett,8,0,32,24
1657672704085,MATH 142A,B04,093558,Chow; Bennett,13,0,32,19
1657672704085,MATH 142A,B05,093559,Chow; Bennett,6,0,32,26
1657672710108,MATH 193A,A01,083224,Rotar; Vladimir,8,0,34,26
1657672710108,MATH 193A,A02,083225,Rotar; Vladimir,9,0,34,25
1657672710108,MATH 193A,A03,083781,Rotar; Vladimir,5,0,34,29
1657672710108,MATH 193A,A04,083782,Rotar; Vladimir,10,0,34,24
1657672710108,MATH 193A,A05,093482,Rotar; Vladimir,10,0,34,24
1657672716130,MATH 197,001,091859,McAuley; Julian John,9999,0,9999,0
1657672716130,MATH 197,002,095566,Kedlaya; Kiran S.,9997,0,9999,2
1657672716130,MATH 197,003,095567,Xiao; Ming,9999,0,9999,0
1657672716130,MATH 197,004,095571,Perols; Johan Lars,9998,0,9999,1
1657672723182,COGS 9,A01,083615,Shannon; Kyle Michael,9,0,75,66
1657672729222,COGS 11,A01,083617,Boyle; Mary E. T.,23,0,48,25
1657672735245,COGS 13,A01,083071,Bastos; Amalia Pinkusfeld,11,0,71,60
1657672741268,COGS 14A,A01,092681,Semenuks; Arturs,5,1,100,95
1657672747294,COGS 14B,A01,083073,Cheng; Tzu-Han,6,0,63,57
1657672753318,COGS 17,A01,092677,Semenuks; Arturs,6,0,81,75
1657672759346,COGS 100,A01,083619,Allen; Michael Gordon,17,0,70,53
1657672765370,COGS 101A,A01,083621,Davis; Joshua Daniel,9,0,68,59
1657672771394,COGS 101B,A01,091572,Allen; Michael Gordon,12,0,65,53
1657672777419,COGS 101C,A01,083625,Delgado; Tania,17,0,35,18
1657672783446,COGS 107A,A01,083627,Boyle; Mary E. T.,13,0,60,47
1657672789470,COGS 118A,A01,083075,Gupta; Anjum,21,0,76,55
1657672795493,CSE 3,A50,083646,Miranda; Gregory Joseph,24,0,50,26
1657672801516,CSE 8A,A50,083650,Miranda; Gregory Joseph,17,1,56,39
1657672807543,CSE 11,A01,083080,Cao; Yingjun,6,15,40,34
1657672813566,CSE 12,A01,083652,Krause-Levy; Sophia Louisa,28,1,120,92
1657672819598,CSE 15L,A01,083654,Morris; Justin Loren,9,0,50,41
1657672819598,CSE 15L,A02,083655,Morris; Justin Loren,9,0,50,41
1657672825621,CSE 20,A01,083657,Tran; Khoa Dang,39,0,80,41
1657672831645,CSE 21,A01,095574,Bach; Quang Tran,22,0,48,26
1657672837666,CSE 30,A01,083084,Eldon; John,6,0,80,74
1657672837666,CSE 30,B01,095061,Bhaskar; Nishant,9,0,50,41
1657672843692,CSE 100,A01,083659,Cao; Yingjun,5,4,70,65
1657672849797,CSE 134B,A01,083661,Powell; Thomas Allan,23,0,100,77
1657672855820,CSE 140,A01,083663,Gungor; Onat,15,0,85,70
1657672861844,CSE 140L,A01,083088,Eldon; John,22,0,100,78
1657672867868,CSE 175,A01,083665,Kumar; Rakesh,3,0,25,22
1657672873890,CSE 190,A00,092507,Dubnov; Shlomo,8,0,20,12
1657672879912,ECE 45,A01,083139,Congero; Spencer William,6,0,75,69
1657672885939,ECE 65,A50,083695,Saad; Andrew S,12,0,30,18
1657672885939,ECE 65,A51,095125,Saad; Andrew S,24,0,26,2
1657672891960,ECE 109,A01,091882,Touri; Behrouz,20,0,70,50
1657672897983,ECE 180,A00,083140,Abi Samra; Nicholas Camill,1,0,30,29
1657672897983,ECE 180,B00,083141,Abi Samra; Nicholas Camill,0,0,30,30
1657672904006,MATH 10A,A01,083735,Patchell; Gregory David,2,0,30,28
1657672904006,MATH 10A,A02,083736,Patchell; Gregory David,20,0,30,10
1657672904006,MATH 10A,A03,083737,Patchell; Gregory David,16,0,30,14
1657672910037,MATH 10B,A01,083207,Lim; Seonhee,8,0,34,26
1657672910037,MATH 10B,A02,083208,Lim; Seonhee,9,0,35,26
1657672910037,MATH 10B,A03,093472,Lim; Seonhee,7,0,34,27
1657672910037,MATH 10B,B01,083739,Sinha; Shubham,13,0,30,17
1657672916067,MATH 18,A01,083743,Cinel; Cameron Alexander,8,0,30,22
1657672916067,MATH 18,A02,083744,Cinel; Cameron Alexander,17,0,30,13
1657672916067,MATH 18,A03,083745,Cinel; Cameron Alexander,10,0,30,20
1657672916067,MATH 18,B01,083748,Rideout; David Porter,5,0,37,32
1657672916067,MATH 18,B02,083749,Rideout; David Porter,5,0,36,31
1657672916067,MATH 18,B03,083750,Rideout; David Porter,3,0,37,34
1657672916067,MATH 18,B04,083751,Rideout; David Porter,6,0,36,30
1657672916067,MATH 18,B05,093473,Rideout; David Porter,6,0,36,30
1657672916067,MATH 18,B06,093474,Rideout; David Porter,6,0,36,30
1657672922094,MATH 20A,A01,083754,Zheng; Zequn,14,0,40,26
1657672928124,MATH 20B,A01,083756,Briones; Jor-el Thomas Caparas,4,0,36,32
1657672928124,MATH 20B,A02,083757,Briones; Jor-el Thomas Caparas,1,0,36,35
1657672928124,MATH 20B,A03,093475,Briones; Jor-el Thomas Caparas,2,0,36,34
1657672934148,MATH 20C,A01,083760,Briones; Jor-el Thomas Caparas,1,0,35,34
1657672934148,MATH 20C,A02,083761,Briones; Jor-el Thomas Caparas,8,0,35,27
1657672934148,MATH 20C,A03,093476,Briones; Jor-el Thomas Caparas,0,1,36,36
1657672934148,MATH 20C,B01,083762,Bach; Quang Tran,1,0,30,29
1657672940177,MATH 20D,A01,083765,Tran; Brian Kha,5,0,30,25
1657672940177,MATH 20D,A02,083766,Tran; Brian Kha,5,0,30,25
1657672940177,MATH 20D,A03,083767,Tran; Brian Kha,5,0,30,25
1657672946206,MATH 20E,A01,083771,Ganguly; Soumya,9,0,32,23
1657672946206,MATH 20E,A02,083772,Ganguly; Soumya,6,0,32,26
1657672946206,MATH 20E,B01,083773,Ciotti; Benjamin,20,0,35,15
1657672946206,MATH 20E,B02,083774,Ciotti; Benjamin,18,0,35,17
1657672952235,MATH 103A,A01,083777,Greenfeld; Be'Eri,3,0,36,33
1657672952235,MATH 103A,A02,083778,Greenfeld; Be'Eri,5,0,36,31
1657672952235,MATH 103A,A03,093561,Greenfeld; Be'Eri,6,0,36,30
1657672952235,MATH 103A,B01,083779,Greenfeld; Be'Eri,7,0,36,29
1657672952235,MATH 103A,B02,083780,Greenfeld; Be'Eri,4,0,36,32
1657672952235,MATH 103A,B03,093562,Greenfeld; Be'Eri,3,0,36,33
1657672958258,MATH 105,A01,085443,Carter; Anne Toulson,15,0,35,20
1657672958258,MATH 105,A02,093477,Carter; Anne Toulson,20,0,35,15
1657672964283,MATH 109,A01,083213,Ganzberger; Geoffrey Michael,2,0,34,32
1657672964283,MATH 109,A02,083214,Ganzberger; Geoffrey Michael,4,0,34,30
1657672964283,MATH 109,A03,093478,Ganzberger; Geoffrey Michael,2,0,34,32
1657672964283,MATH 109,B01,083215,Ganzberger; Geoffrey Michael,1,0,32,31
1657672964283,MATH 109,B02,083216,Ganzberger; Geoffrey Michael,2,0,32,30
1657672964283,MATH 109,B03,093479,Ganzberger; Geoffrey Michael,8,0,32,24
1657672970307,MATH 142A,A01,083219,Chow; Bennett,7,0,32,25
1657672970307,MATH 142A,A02,083220,Chow; Bennett,10,0,32,22
1657672970307,MATH 142A,A03,093480,Chow; Bennett,9,0,32,23
1657672970307,MATH 142A,B03,093481,Chow; Bennett,8,0,32,24
1657672970307,MATH 142A,B04,093558,Chow; Bennett,13,0,32,19
1657672970307,MATH 142A,B05,093559,Chow; Bennett,6,0,32,26
1657672976331,MATH 193A,A01,083224,Rotar; Vladimir,8,0,34,26
1657672976331,MATH 193A,A02,083225,Rotar; Vladimir,9,0,34,25
1657672976331,MATH 193A,A03,083781,Rotar; Vladimir,5,0,34,29
1657672976331,MATH 193A,A04,083782,Rotar; Vladimir,10,0,34,24
1657672976331,MATH 193A,A05,093482,Rotar; Vladimir,10,0,34,24
1657672982359,MATH 197,001,091859,McAuley; Julian John,9999,0,9999,0
1657672982359,MATH 197,002,095566,Kedlaya; Kiran S.,9997,0,9999,2
1657672982359,MATH 197,003,095567,Xiao; Ming,9999,0,9999,0
1657672982359,MATH 197,004,095571,Perols; Johan Lars,9998,0,9999,1
1657672989428,COGS 9,A01,083615,Shannon; Kyle Michael,9,0,75,66
1657672995454,COGS 11,A01,083617,Boyle; Mary E. T.,23,0,48,25
1657673001478,COGS 13,A01,083071,Bastos; Amalia Pinkusfeld,11,0,71,60
1657673007503,COGS 14A,A01,092681,Semenuks; Arturs,5,1,100,95
1657673013526,COGS 14B,A01,083073,Cheng; Tzu-Han,6,0,63,57
1657673019550,COGS 17,A01,092677,Semenuks; Arturs,6,0,81,75
1657673025576,COGS 100,A01,083619,Allen; Michael Gordon,17,0,70,53
1657673031600,COGS 101A,A01,083621,Davis; Joshua Daniel,9,0,68,59
1657673037626,COGS 101B,A01,091572,Allen; Michael Gordon,12,0,65,53
1657673043652,COGS 101C,A01,083625,Delgado; Tania,17,0,35,18
1657673049680,COGS 107A,A01,083627,Boyle; Mary E. T.,13,0,60,47
1657673055707,COGS 118A,A01,083075,Gupta; Anjum,21,0,76,55
1657673061734,CSE 3,A50,083646,Miranda; Gregory Joseph,24,0,50,26
1657673067757,CSE 8A,A50,083650,Miranda; Gregory Joseph,17,1,56,39
1657673073781,CSE 11,A01,083080,Cao; Yingjun,6,15,40,34
1657673079808,CSE 12,A01,083652,Krause-Levy; Sophia Louisa,28,1,120,92
1657673085836,CSE 15L,A01,083654,Morris; Justin Loren,9,0,50,41
1657673085836,CSE 15L,A02,083655,Morris; Justin Loren,9,0,50,41
1657673091861,CSE 20,A01,083657,Tran; Khoa Dang,39,0,80,41
1657673097885,CSE 21,A01,095574,Bach; Quang Tran,22,0,48,26
1657673103914,CSE 30,A01,083084,Eldon; John,6,0,80,74
1657673103914,CSE 30,B01,095061,Bhaskar; Nishant,9,0,50,41
1657673109937,CSE 100,A01,083659,Cao; Yingjun,5,4,70,65
1657673115958,CSE 134B,A01,083661,Powell; Thomas Allan,23,0,100,77
1657673121984,CSE 140,A01,083663,Gungor; Onat,15,0,85,70
1657673128011,CSE 140L,A01,083088,Eldon; John,22,0,100,78
1657673134034,CSE 175,A01,083665,Kumar; Rakesh,3,0,25,22
1657673140060,CSE 190,A00,092507,Dubnov; Shlomo,8,0,20,12
1657673146083,ECE 45,A01,083139,Congero; Spencer William,6,0,75,69
1657673152107,ECE 65,A50,083695,Saad; Andrew S,12,0,30,18
1657673152107,ECE 65,A51,095125,Saad; Andrew S,24,0,26,2
1657673158130,ECE 109,A01,091882,Touri; Behrouz,20,0,70,50
1657673164153,ECE 180,A00,083140,Abi Samra; Nicholas Camill,1,0,30,29
1657673164153,ECE 180,B00,083141,Abi Samra; Nicholas Camill,0,0,30,30
1657673170176,MATH 10A,A01,083735,Patchell; Gregory David,2,0,30,28
1657673170176,MATH 10A,A02,083736,Patchell; Gregory David,20,0,30,10
1657673170176,MATH 10A,A03,083737,Patchell; Gregory David,16,0,30,14
1657673176201,MATH 10B,A01,083207,Lim; Seonhee,8,0,34,26
1657673176201,MATH 10B,A02,083208,Lim; Seonhee,9,0,35,26
1657673176201,MATH 10B,A03,093472,Lim; Seonhee,7,0,34,27
1657673176201,MATH 10B,B01,083739,Sinha; Shubham,13,0,30,17
1657673182235,MATH 18,A01,083743,Cinel; Cameron Alexander,8,0,30,22
1657673182235,MATH 18,A02,083744,Cinel; Cameron Alexander,17,0,30,13
1657673182235,MATH 18,A03,083745,Cinel; Cameron Alexander,10,0,30,20
1657673182235,MATH 18,B01,083748,Rideout; David Porter,5,0,37,32
1657673182235,MATH 18,B02,083749,Rideout; David Porter,5,0,36,31
1657673182235,MATH 18,B03,083750,Rideout; David Porter,3,0,37,34
1657673182235,MATH 18,B04,083751,Rideout; David Porter,6,0,36,30
1657673182235,MATH 18,B05,093473,Rideout; David Porter,6,0,36,30
1657673182235,MATH 18,B06,093474,Rideout; David Porter,6,0,36,30
1657673188261,MATH 20A,A01,083754,Zheng; Zequn,14,0,40,26
1657673194285,MATH 20B,A01,083756,Briones; Jor-el Thomas Caparas,4,0,36,32
1657673194285,MATH 20B,A02,083757,Briones; Jor-el Thomas Caparas,1,0,36,35
1657673194285,MATH 20B,A03,093475,Briones; Jor-el Thomas Caparas,2,0,36,34
1657673200311,MATH 20C,A01,083760,Briones; Jor-el Thomas Caparas,1,0,35,34
1657673200311,MATH 20C,A02,083761,Briones; Jor-el Thomas Caparas,8,0,35,27
1657673200311,MATH 20C,A03,093476,Briones; Jor-el Thomas Caparas,0,1,36,36
1657673200311,MATH 20C,B01,083762,Bach; Quang Tran,1,0,30,29
1657673206346,MATH 20D,A01,083765,Tran; Brian Kha,5,0,30,25
1657673206346,MATH 20D,A02,083766,Tran; Brian Kha,5,0,30,25
1657673206346,MATH 20D,A03,083767,Tran; Brian Kha,5,0,30,25
1657673212376,MATH 20E,A01,083771,Ganguly; Soumya,9,0,32,23
1657673212376,MATH 20E,A02,083772,Ganguly; Soumya,6,0,32,26
1657673212376,MATH 20E,B01,083773,Ciotti; Benjamin,20,0,35,15
1657673212376,MATH 20E,B02,083774,Ciotti; Benjamin,18,0,35,17
1657673218406,MATH 103A,A01,083777,Greenfeld; Be'Eri,3,0,36,33
1657673218406,MATH 103A,A02,083778,Greenfeld; Be'Eri,5,0,36,31
1657673218406,MATH 103A,A03,093561,Greenfeld; Be'Eri,6,0,36,30
1657673218406,MATH 103A,B01,083779,Greenfeld; Be'Eri,7,0,36,29
1657673218406,MATH 103A,B02,083780,Greenfeld; Be'Eri,4,0,36,32
1657673218406,MATH 103A,B03,093562,Greenfeld; Be'Eri,3,0,36,33
1657673224429,MATH 105,A01,085443,Carter; Anne Toulson,15,0,35,20
1657673224429,MATH 105,A02,093477,Carter; Anne Toulson,20,0,35,15
1657673230452,MATH 109,A01,083213,Ganzberger; Geoffrey Michael,2,0,34,32
1657673230452,MATH 109,A02,083214,Ganzberger; Geoffrey Michael,4,0,34,30
1657673230452,MATH 109,A03,093478,Ganzberger; Geoffrey Michael,2,0,34,32
1657673230452,MATH 109,B01,083215,Ganzberger; Geoffrey Michael,1,0,32,31
1657673230452,MATH 109,B02,083216,Ganzberger; Geoffrey Michael,2,0,32,30
1657673230452,MATH 109,B03,093479,Ganzberger; Geoffrey Michael,8,0,32,24
1657673236481,MATH 142A,A01,083219,Chow; Bennett,7,0,32,25
1657673236481,MATH 142A,A02,083220,Chow; Bennett,10,0,32,22
1657673236481,MATH 142A,A03,093480,Chow; Bennett,9,0,32,23
1657673236481,MATH 142A,B03,093481,Chow; Bennett,8,0,32,24
1657673236481,MATH 142A,B04,093558,Chow; Bennett,13,0,32,19
1657673236481,MATH 142A,B05,093559,Chow; Bennett,6,0,32,26
1657673242505,MATH 193A,A01,083224,Rotar; Vladimir,8,0,34,26
1657673242505,MATH 193A,A02,083225,Rotar; Vladimir,9,0,34,25
1657673242505,MATH 193A,A03,083781,Rotar; Vladimir,5,0,34,29
1657673242505,MATH 193A,A04,083782,Rotar; Vladimir,10,0,34,24
1657673242505,MATH 193A,A05,093482,Rotar; Vladimir,10,0,34,24
1657673248529,MATH 197,001,091859,McAuley; Julian John,9999,0,9999,0
1657673248529,MATH 197,002,095566,Kedlaya; Kiran S.,9997,0,9999,2
1657673248529,MATH 197,003,095567,Xiao; Ming,9999,0,9999,0
1657673248529,MATH 197,004,095571,Perols; Johan Lars,9998,0,9999,1
1657673255591,COGS 9,A01,083615,Shannon; Kyle Michael,9,0,75,66
1657673261617,COGS 11,A01,083617,Boyle; Mary E. T.,23,0,48,25
1657673267646,COGS 13,A01,083071,Bastos; Amalia Pinkusfeld,11,0,71,60
1657673273669,COGS 14A,A01,092681,Semenuks; Arturs,5,1,100,95
1657673279692,COGS 14B,A01,083073,Cheng; Tzu-Han,6,0,63,57
1657673285717,COGS 17,A01,092677,Semenuks; Arturs,6,0,81,75
1657673291743,COGS 100,A01,083619,Allen; Michael Gordon,17,0,70,53
1657673297773,COGS 101A,A01,083621,Davis; Joshua Daniel,9,0,68,59
1657673303799,COGS 101B,A01,091572,Allen; Michael Gordon,12,0,65,53
1657673309821,COGS 101C,A01,083625,Delgado; Tania,17,0,35,18
1657673315845,COGS 107A,A01,083627,Boyle; Mary E. T.,13,0,60,47
1657673321868,COGS 118A,A01,083075,Gupta; Anjum,21,0,76,55
1657673327892,CSE 3,A50,083646,Miranda; Gregory Joseph,24,0,50,26
1657673333930,CSE 8A,A50,083650,Miranda; Gregory Joseph,17,1,56,39
1657673339953,CSE 11,A01,083080,Cao; Yingjun,6,15,40,34
1657673345976,CSE 12,A01,083652,Krause-Levy; Sophia Louisa,28,1,120,92
1657673352003,CSE 15L,A01,083654,Morris; Justin Loren,9,0,50,41
1657673352003,CSE 15L,A02,083655,Morris; Justin Loren,9,0,50,41
1657673358024,CSE 20,A01,083657,Tran; Khoa Dang,39,0,80,41
1657673364052,CSE 21,A01,095574,Bach; Quang Tran,22,0,48,26
1657673370082,CSE 30,A01,083084,Eldon; John,6,0,80,74
1657673370082,CSE 30,B01,095061,Bhaskar; Nishant,9,0,50,41
1657673376107,CSE 100,A01,083659,Cao; Yingjun,5,4,70,65
1657673382129,CSE 134B,A01,083661,Powell; Thomas Allan,23,0,100,77
1657673388151,CSE 140,A01,083663,Gungor; Onat,15,0,85,70
1657673394174,CSE 140L,A01,083088,Eldon; John,22,0,100,78
1657673400202,CSE 175,A01,083665,Kumar; Rakesh,3,0,25,22
1657673406226,CSE 190,A00,092507,Dubnov; Shlomo,8,0,20,12
1657673412253,ECE 45,A01,083139,Congero; Spencer William,6,0,75,69
1657673418280,ECE 65,A50,083695,Saad; Andrew S,12,0,30,18
1657673418280,ECE 65,A51,095125,Saad; Andrew S,24,0,26,2
1657673424310,ECE 109,A01,091882,Touri; Behrouz,20,0,70,50
1657673430333,ECE 180,A00,083140,Abi Samra; Nicholas Camill,1,0,30,29
1657673430333,ECE 180,B00,083141,Abi Samra; Nicholas Camill,0,0,30,30
1657673436362,MATH 10A,A01,083735,Patchell; Gregory David,2,0,30,28
1657673436362,MATH 10A,A02,083736,Patchell; Gregory David,20,0,30,10
1657673436362,MATH 10A,A03,083737,Patchell; Gregory David,16,0,30,14
1657673442391,MATH 10B,A01,083207,Lim; Seonhee,8,0,34,26
1657673442391,MATH 10B,A02,083208,Lim; Seonhee,9,0,35,26
1657673442391,MATH 10B,A03,093472,Lim; Seonhee,7,0,34,27
1657673442391,MATH 10B,B01,083739,Sinha; Shubham,13,0,30,17
1657673448518,MATH 18,A01,083743,Cinel; Cameron Alexander,8,0,30,22
1657673448518,MATH 18,A02,083744,Cinel; Cameron Alexander,17,0,30,13
1657673448518,MATH 18,A03,083745,Cinel; Cameron Alexander,10,0,30,20
1657673448518,MATH 18,B01,083748,Rideout; David Porter,5,0,37,32
1657673448518,MATH 18,B02,083749,Rideout; David Porter,5,0,36,31
1657673448518,MATH 18,B03,083750,Rideout; David Porter,3,0,37,34
1657673448518,MATH 18,B04,083751,Rideout; David Porter,6,0,36,30
1657673448518,MATH 18,B05,093473,Rideout; David Porter,6,0,36,30
1657673448518,MATH 18,B06,093474,Rideout; David Porter,6,0,36,30
1657673454543,MATH 20A,A01,083754,Zheng; Zequn,14,0,40,26
1657673460581,MATH 20B,A01,083756,Briones; Jor-el Thomas Caparas,4,0,36,32
1657673460581,MATH 20B,A02,083757,Briones; Jor-el Thomas Caparas,1,0,36,35
1657673460581,MATH 20B,A03,093475,Briones; Jor-el Thomas Caparas,2,0,36,34
1657673466608,MATH 20C,A01,083760,Briones; Jor-el Thomas Caparas,1,0,35,34
1657673466608,MATH 20C,A02,083761,Briones; Jor-el Thomas Caparas,8,0,35,27
1657673466608,MATH 20C,A03,093476,Briones; Jor-el Thomas Caparas,0,1,36,36
1657673466608,MATH 20C,B01,083762,Bach; Quang Tran,1,0,30,29
1657673472639,MATH 20D,A01,083765,Tran; Brian Kha,5,0,30,25
1657673472639,MATH 20D,A02,083766,Tran; Brian Kha,5,0,30,25
1657673472639,MATH 20D,A03,083767,Tran; Brian Kha,5,0,30,25
1657673478661,MATH 20E,A01,083771,Ganguly; Soumya,9,0,32,23
1657673478661,MATH 20E,A02,083772,Ganguly; Soumya,6,0,32,26
1657673478661,MATH 20E,B01,083773,Ciotti; Benjamin,20,0,35,15
1657673478661,MATH 20E,B02,083774,Ciotti; Benjamin,18,0,35,17
1657673484693,MATH 103A,A01,083777,Greenfeld; Be'Eri,3,0,36,33
1657673484693,MATH 103A,A02,083778,Greenfeld; Be'Eri,5,0,36,31
1657673484693,MATH 103A,A03,093561,Greenfeld; Be'Eri,6,0,36,30
1657673484693,MATH 103A,B01,083779,Greenfeld; Be'Eri,7,0,36,29
1657673484693,MATH 103A,B02,083780,Greenfeld; Be'Eri,4,0,36,32
1657673484693,MATH 103A,B03,093562,Greenfeld; Be'Eri,3,0,36,33
1657673490721,MATH 105,A01,085443,Carter; Anne Toulson,15,0,35,20
1657673490721,MATH 105,A02,093477,Carter; Anne Toulson,20,0,35,15
1657673496759,MATH 109,A01,083213,Ganzberger; Geoffrey Michael,2,0,34,32
1657673496759,MATH 109,A02,083214,Ganzberger; Geoffrey Michael,4,0,34,30
1657673496759,MATH 109,A03,093478,Ganzberger; Geoffrey Michael,2,0,34,32
1657673496759,MATH 109,B01,083215,Ganzberger; Geoffrey Michael,1,0,32,31
1657673496759,MATH 109,B02,083216,Ganzberger; Geoffrey Michael,2,0,32,30
1657673496759,MATH 109,B03,093479,Ganzberger; Geoffrey Michael,8,0,32,24
1657673502792,MATH 142A,A01,083219,Chow; Bennett,7,0,32,25
1657673502792,MATH 142A,A02,083220,Chow; Bennett,10,0,32,22
1657673502792,MATH 142A,A03,093480,Chow; Bennett,9,0,32,23
1657673502792,MATH 142A,B03,093481,Chow; Bennett,8,0,32,24
1657673502792,MATH 142A,B04,093558,Chow; Bennett,13,0,32,19
1657673502792,MATH 142A,B05,093559,Chow; Bennett,6,0,32,26
1657673508815,MATH 193A,A01,083224,Rotar; Vladimir,8,0,34,26
1657673508815,MATH 193A,A02,083225,Rotar; Vladimir,9,0,34,25
1657673508815,MATH 193A,A03,083781,Rotar; Vladimir,5,0,34,29
1657673508815,MATH 193A,A04,083782,Rotar; Vladimir,10,0,34,24
1657673508815,MATH 193A,A05,093482,Rotar; Vladimir,10,0,34,24
1657673514840,MATH 197,001,091859,McAuley; Julian John,9999,0,9999,0
1657673514840,MATH 197,002,095566,Kedlaya; Kiran S.,9997,0,9999,2
1657673514840,MATH 197,003,095567,Xiao; Ming,9999,0,9999,0
1657673514840,MATH 197,004,095571,Perols; Johan Lars,9998,0,9999,1
1657673521906,COGS 9,A01,083615,Shannon; Kyle Michael,9,0,75,66
1657673527932,COGS 11,A01,083617,Boyle; Mary E. T.,23,0,48,25
1657673533960,COGS 13,A01,083071,Bastos; Amalia Pinkusfeld,11,0,71,60
1657673539983,COGS 14A,A01,092681,Semenuks; Arturs,5,1,100,95
1657673546005,COGS 14B,A01,083073,Cheng; Tzu-Han,6,0,63,57
1657673552028,COGS 17,A01,092677,Semenuks; Arturs,6,0,81,75
1657673558050,COGS 100,A01,083619,Allen; Michael Gordon,17,0,70,53
1657673564074,COGS 101A,A01,083621,Davis; Joshua Daniel,9,0,68,59
1657673570101,COGS 101B,A01,091572,Allen; Michael Gordon,12,0,65,53
1657673576127,COGS 101C,A01,083625,Delgado; Tania,17,0,35,18
1657673582155,COGS 107A,A01,083627,Boyle; Mary E. T.,13,0,60,47
1657673588181,COGS 118A,A01,083075,Gupta; Anjum,21,0,76,55
1657673594205,CSE 3,A50,083646,Miranda; Gregory Joseph,24,0,50,26
1657673600233,CSE 8A,A50,083650,Miranda; Gregory Joseph,17,1,56,39
1657673606258,CSE 11,A01,083080,Cao; Yingjun,6,15,40,34
1657673612285,CSE 12,A01,083652,Krause-Levy; Sophia Louisa,28,1,120,92
1657673618314,CSE 15L,A01,083654,Morris; Justin Loren,9,0,50,41
1657673618314,CSE 15L,A02,083655,Morris; Justin Loren,9,0,50,41
1657673624336,CSE 20,A01,083657,Tran; Khoa Dang,39,0,80,41
1657673630361,CSE 21,A01,095574,Bach; Quang Tran,22,0,48,26
1657673636384,CSE 30,A01,083084,Eldon; John,6,0,80,74
1657673636384,CSE 30,B01,095061,Bhaskar; Nishant,9,0,50,41
1657673642406,CSE 100,A01,083659,Cao; Yingjun,5,4,70,65
1657673648433,CSE 134B,A01,083661,Powell; Thomas Allan,23,0,100,77
1657673654458,CSE 140,A01,083663,Gungor; Onat,15,0,85,70
1657673660484,CSE 140L,A01,083088,Eldon; John,22,0,100,78
1657673666507,CSE 175,A01,083665,Kumar; Rakesh,3,0,25,22
1657673672529,CSE 190,A00,092507,Dubnov; Shlomo,8,0,20,12
1657673678555,ECE 45,A01,083139,Congero; Spencer William,6,0,75,69
1657673684581,ECE 65,A50,083695,Saad; Andrew S,12,0,30,18
1657673684581,ECE 65,A51,095125,Saad; Andrew S,24,0,26,2
1657673690606,ECE 109,A01,091882,Touri; Behrouz,20,0,70,50
1657673696632,ECE 180,A00,083140,Abi Samra; Nicholas Camill,1,0,30,29
1657673696632,ECE 180,B00,083141,Abi Samra; Nicholas Camill,0,0,30,30
1657673702658,MATH 10A,A01,083735,Patchell; Gregory David,2,0,30,28
1657673702658,MATH 10A,A02,083736,Patchell; Gregory David,20,0,30,10
1657673702658,MATH 10A,A03,083737,Patchell; Gregory David,16,0,30,14
1657673708687,MATH 10B,A01,083207,Lim; Seonhee,8,0,34,26
1657673708687,MATH 10B,A02,083208,Lim; Seonhee,9,0,35,26
1657673708687,MATH 10B,A03,093472,Lim; Seonhee,7,0,34,27
1657673708687,MATH 10B,B01,083739,Sinha; Shubham,13,0,30,17
1657673714717,MATH 18,A01,083743,Cinel; Cameron Alexander,8,0,30,22
1657673714717,MATH 18,A02,083744,Cinel; Cameron Alexander,17,0,30,13
1657673714717,MATH 18,A03,083745,Cinel; Cameron Alexander,10,0,30,20
1657673714717,MATH 18,B01,083748,Rideout; David Porter,5,0,37,32
1657673714717,MATH 18,B02,083749,Rideout; David Porter,5,0,36,31
1657673714717,MATH 18,B03,083750,Rideout; David Porter,3,0,37,34
1657673714717,MATH 18,B04,083751,Rideout; David Porter,6,0,36,30
1657673714717,MATH 18,B05,093473,Rideout; David Porter,6,0,36,30
1657673714717,MATH 18,B06,093474,Rideout; David Porter,6,0,36,30
1657673720739,MATH 20A,A01,083754,Zheng; Zequn,14,0,40,26
1657673726765,MATH 20B,A01,083756,Briones; Jor-el Thomas Caparas,4,0,36,32
1657673726765,MATH 20B,A02,083757,Briones; Jor-el Thomas Caparas,1,0,36,35
1657673726765,MATH 20B,A03,093475,Briones; Jor-el Thomas Caparas,2,0,36,34
1657673732792,MATH 20C,A01,083760,Briones; Jor-el Thomas Caparas,1,0,35,34
1657673732792,MATH 20C,A02,083761,Briones; Jor-el Thomas Caparas,8,0,35,27
1657673732792,MATH 20C,A03,093476,Briones; Jor-el Thomas Caparas,0,1,36,36
1657673732792,MATH 20C,B01,083762,Bach; Quang Tran,1,0,30,29
1657673738815,MATH 20D,A01,083765,Tran; Brian Kha,5,0,30,25
1657673738815,MATH 20D,A02,083766,Tran; Brian Kha,5,0,30,25
1657673738815,MATH 20D,A03,083767,Tran; Brian Kha,5,0,30,25
1657673744837,MATH 20E,A01,083771,Ganguly; Soumya,9,0,32,23
1657673744837,MATH 20E,A02,083772,Ganguly; Soumya,6,0,32,26
1657673744837,MATH 20E,B01,083773,Ciotti; Benjamin,20,0,35,15
1657673744837,MATH 20E,B02,083774,Ciotti; Benjamin,18,0,35,17
1657673750861,MATH 103A,A01,083777,Greenfeld; Be'Eri,3,0,36,33
1657673750861,MATH 103A,A02,083778,Greenfeld; Be'Eri,5,0,36,31
1657673750861,MATH 103A,A03,093561,Greenfeld; Be'Eri,6,0,36,30
1657673750861,MATH 103A,B01,083779,Greenfeld; Be'Eri,7,0,36,29
1657673750861,MATH 103A,B02,083780,Greenfeld; Be'Eri,4,0,36,32
1657673750861,MATH 103A,B03,093562,Greenfeld; Be'Eri,3,0,36,33
1657673756882,MATH 105,A01,085443,Carter; Anne Toulson,15,0,35,20
1657673756882,MATH 105,A02,093477,Carter; Anne Toulson,20,0,35,15
1657673762909,MATH 109,A01,083213,Ganzberger; Geoffrey Michael,2,0,34,32
1657673762909,MATH 109,A02,083214,Ganzberger; Geoffrey Michael,4,0,34,30
1657673762909,MATH 109,A03,093478,Ganzberger; Geoffrey Michael,2,0,34,32
1657673762909,MATH 109,B01,083215,Ganzberger; Geoffrey Michael,1,0,32,31
1657673762909,MATH 109,B02,083216,Ganzberger; Geoffrey Michael,2,0,32,30
1657673762909,MATH 109,B03,093479,Ganzberger; Geoffrey Michael,8,0,32,24
1657673768933,MATH 142A,A01,083219,Chow; Bennett,7,0,32,25
1657673768933,MATH 142A,A02,083220,Chow; Bennett,10,0,32,22
1657673768933,MATH 142A,A03,093480,Chow; Bennett,9,0,32,23
1657673768933,MATH 142A,B03,093481,Chow; Bennett,8,0,32,24
1657673768933,MATH 142A,B04,093558,Chow; Bennett,13,0,32,19
1657673768933,MATH 142A,B05,093559,Chow; Bennett,6,0,32,26
1657673774957,MATH 193A,A01,083224,Rotar; Vladimir,8,0,34,26
1657673774957,MATH 193A,A02,083225,Rotar; Vladimir,9,0,34,25
1657673774957,MATH 193A,A03,083781,Rotar; Vladimir,5,0,34,29
1657673774957,MATH 193A,A04,083782,Rotar; Vladimir,10,0,34,24
1657673774957,MATH 193A,A05,093482,Rotar; Vladimir,10,0,34,24
1657673780982,MATH 197,001,091859,McAuley; Julian John,9999,0,9999,0
1657673780982,MATH 197,002,095566,Kedlaya; Kiran S.,9997,0,9999,2
1657673780982,MATH 197,003,095567,Xiao; Ming,9999,0,9999,0
1657673780982,MATH 197,004,095571,Perols; Johan Lars,9998,0,9999,1
1657673788036,COGS 9,A01,083615,Shannon; Kyle Michael,9,0,75,66
1657673794058,COGS 11,A01,083617,Boyle; Mary E. T.,23,0,48,25
1657673800084,COGS 13,A01,083071,Bastos; Amalia Pinkusfeld,11,0,71,60
1657673806107,COGS 14A,A01,092681,Semenuks; Arturs,5,1,100,95
1657673812138,COGS 14B,A01,083073,Cheng; Tzu-Han,6,0,63,57
1657673818161,COGS 17,A01,092677,Semenuks; Arturs,6,0,81,75
1657673824186,COGS 100,A01,083619,Allen; Michael Gordon,17,0,70,53
1657673830213,COGS 101A,A01,083621,Davis; Joshua Daniel,9,0,68,59
1657673836239,COGS 101B,A01,091572,Allen; Michael Gordon,12,0,65,53
1657673842265,COGS 101C,A01,083625,Delgado; Tania,17,0,35,18
1657673848291,COGS 107A,A01,083627,Boyle; Mary E. T.,13,0,60,47
1657673854317,COGS 118A,A01,083075,Gupta; Anjum,21,0,76,55
1657673860340,CSE 3,A50,083646,Miranda; Gregory Joseph,24,0,50,26
1657673866364,CSE 8A,A50,083650,Miranda; Gregory Joseph,17,1,56,39
1657673872389,CSE 11,A01,083080,Cao; Yingjun,6,15,40,34
1657673878418,CSE 12,A01,083652,Krause-Levy; Sophia Louisa,28,1,120,92
1657673884441,CSE 15L,A01,083654,Morris; Justin Loren,9,0,50,41
1657673884441,CSE 15L,A02,083655,Morris; Justin Loren,9,0,50,41
1657673890467,CSE 20,A01,083657,Tran; Khoa Dang,39,0,80,41
1657673896490,CSE 21,A01,095574,Bach; Quang Tran,22,0,48,26
1657673902513,CSE 30,A01,083084,Eldon; John,6,0,80,74
1657673902513,CSE 30,B01,095061,Bhaskar; Nishant,9,0,50,41
1657673908535,CSE 100,A01,083659,Cao; Yingjun,5,4,70,65
1657673914563,CSE 134B,A01,083661,Powell; Thomas Allan,23,0,100,77
1657673920596,CSE 140,A01,083663,Gungor; Onat,15,0,85,70
1657673926623,CSE 140L,A01,083088,Eldon; John,22,0,100,78
1657673932655,CSE 175,A01,083665,Kumar; Rakesh,3,0,25,22
1657673938681,CSE 190,A00,092507,Dubnov; Shlomo,8,0,20,12
1657673944703,ECE 45,A01,083139,Congero; Spencer William,6,0,75,69
1657673950729,ECE 65,A50,083695,Saad; Andrew S,12,0,30,18
1657673950729,ECE 65,A51,095125,Saad; Andrew S,24,0,26,2
1657673956762,ECE 109,A01,091882,Touri; Behrouz,20,0,70,50
1657673962785,ECE 180,A00,083140,Abi Samra; Nicholas Camill,1,0,30,29
1657673962785,ECE 180,B00,083141,Abi Samra; Nicholas Camill,0,0,30,30
1657673968810,MATH 10A,A01,083735,Patchell; Gregory David,2,0,30,28
1657673968810,MATH 10A,A02,083736,Patchell; Gregory David,20,0,30,10
1657673968810,MATH 10A,A03,083737,Patchell; Gregory David,16,0,30,14
1657673974833,MATH 10B,A01,083207,Lim; Seonhee,8,0,34,26
1657673974833,MATH 10B,A02,083208,Lim; Seonhee,9,0,35,26
1657673974833,MATH 10B,A03,093472,Lim; Seonhee,7,0,34,27
1657673974833,MATH 10B,B01,083739,Sinha; Shubham,13,0,30,17
1657673980864,MATH 18,A01,083743,Cinel; Cameron Alexander,8,0,30,22
1657673980864,MATH 18,A02,083744,Cinel; Cameron Alexander,17,0,30,13
1657673980864,MATH 18,A03,083745,Cinel; Cameron Alexander,10,0,30,20
1657673980864,MATH 18,B01,083748,Rideout; David Porter,5,0,37,32
1657673980864,MATH 18,B02,083749,Rideout; David Porter,5,0,36,31
1657673980864,MATH 18,B03,083750,Rideout; David Porter,3,0,37,34
1657673980864,MATH 18,B04,083751,Rideout; David Porter,6,0,36,30
1657673980864,MATH 18,B05,093473,Rideout; David Porter,6,0,36,30
1657673980864,MATH 18,B06,093474,Rideout; David Porter,6,0,36,30
1657673986887,MATH 20A,A01,083754,Zheng; Zequn,14,0,40,26
1657673992913,MATH 20B,A01,083756,Briones; Jor-el Thomas Caparas,4,0,36,32
1657673992913,MATH 20B,A02,083757,Briones; Jor-el Thomas Caparas,1,0,36,35
1657673992913,MATH 20B,A03,093475,Briones; Jor-el Thomas Caparas,2,0,36,34
1657673998937,MATH 20C,A01,083760,Briones; Jor-el Thomas Caparas,1,0,35,34
1657673998937,MATH 20C,A02,083761,Briones; Jor-el Thomas Caparas,8,0,35,27
1657673998937,MATH 20C,A03,093476,Briones; Jor-el Thomas Caparas,0,1,36,36
1657673998937,MATH 20C,B01,083762,Bach; Quang Tran,1,0,30,29
1657674004960,MATH 20D,A01,083765,Tran; Brian Kha,5,0,30,25
1657674004960,MATH 20D,A02,083766,Tran; Brian Kha,5,0,30,25
1657674004960,MATH 20D,A03,083767,Tran; Brian Kha,5,0,30,25
1657674010983,MATH 20E,A01,083771,Ganguly; Soumya,9,0,32,23
1657674010983,MATH 20E,A02,083772,Ganguly; Soumya,6,0,32,26
1657674010983,MATH 20E,B01,083773,Ciotti; Benjamin,20,0,35,15
1657674010983,MATH 20E,B02,083774,Ciotti; Benjamin,18,0,35,17
1657674017006,MATH 103A,A01,083777,Greenfeld; Be'Eri,3,0,36,33
1657674017006,MATH 103A,A02,083778,Greenfeld; Be'Eri,5,0,36,31
1657674017006,MATH 103A,A03,093561,Greenfeld; Be'Eri,6,0,36,30
1657674017006,MATH 103A,B01,083779,Greenfeld; Be'Eri,7,0,36,29
1657674017006,MATH 103A,B02,083780,Greenfeld; Be'Eri,4,0,36,32
1657674017006,MATH 103A,B03,093562,Greenfeld; Be'Eri,3,0,36,33
1657674023038,MATH 105,A01,085443,Carter; Anne Toulson,15,0,35,20
1657674023038,MATH 105,A02,093477,Carter; Anne Toulson,20,0,35,15
1657674029063,MATH 109,A01,083213,Ganzberger; Geoffrey Michael,2,0,34,32
1657674029063,MATH 109,A02,083214,Ganzberger; Geoffrey Michael,4,0,34,30
1657674029063,MATH 109,A03,093478,Ganzberger; Geoffrey Michael,2,0,34,32
1657674029063,MATH 109,B01,083215,Ganzberger; Geoffrey Michael,1,0,32,31
1657674029063,MATH 109,B02,083216,Ganzberger; Geoffrey Michael,2,0,32,30
1657674029063,MATH 109,B03,093479,Ganzberger; Geoffrey Michael,8,0,32,24
1657674035086,MATH 142A,A01,083219,Chow; Bennett,7,0,32,25
1657674035086,MATH 142A,A02,083220,Chow; Bennett,10,0,32,22
1657674035086,MATH 142A,A03,093480,Chow; Bennett,9,0,32,23
1657674035086,MATH 142A,B03,093481,Chow; Bennett,8,0,32,24
1657674035086,MATH 142A,B04,093558,Chow; Bennett,13,0,32,19
1657674035086,MATH 142A,B05,093559,Chow; Bennett,6,0,32,26
1657674041120,MATH 193A,A01,083224,Rotar; Vladimir,8,0,34,26
1657674041120,MATH 193A,A02,083225,Rotar; Vladimir,9,0,34,25
1657674041120,MATH 193A,A03,083781,Rotar; Vladimir,5,0,34,29
1657674041120,MATH 193A,A04,083782,Rotar; Vladimir,10,0,34,24
1657674041120,MATH 193A,A05,093482,Rotar; Vladimir,10,0,34,24
1657674047226,MATH 197,001,091859,McAuley; Julian John,9999,0,9999,0
1657674047226,MATH 197,002,095566,Kedlaya; Kiran S.,9997,0,9999,2
1657674047226,MATH 197,003,095567,Xiao; Ming,9999,0,9999,0
1657674047226,MATH 197,004,095571,Perols; Johan Lars,9998,0,9999,1
1657674054277,COGS 9,A01,083615,Shannon; Kyle Michael,9,0,75,66
1657674060315,COGS 11,A01,083617,Boyle; Mary E. T.,23,0,48,25
1657674066340,COGS 13,A01,083071,Bastos; Amalia Pinkusfeld,11,0,71,60
1657674072363,COGS 14A,A01,092681,Semenuks; Arturs,5,1,100,95
1657674078386,COGS 14B,A01,083073,Cheng; Tzu-Han,6,0,63,57
1657674084413,COGS 17,A01,092677,Semenuks; Arturs,6,0,81,75
1657674090437,COGS 100,A01,083619,Allen; Michael Gordon,17,0,70,53
1657674096462,COGS 101A,A01,083621,Davis; Joshua Daniel,9,0,68,59
1657674102484,COGS 101B,A01,091572,Allen; Michael Gordon,12,0,65,53
1657674108507,COGS 101C,A01,083625,Delgado; Tania,17,0,35,18
1657674114532,COGS 107A,A01,083627,Boyle; Mary E. T.,13,0,60,47
1657674120563,COGS 118A,A01,083075,Gupta; Anjum,21,0,76,55
1657674126586,CSE 3,A50,083646,Miranda; Gregory Joseph,24,0,50,26
1657674132614,CSE 8A,A50,083650,Miranda; Gregory Joseph,17,1,56,39
1657674138638,CSE 11,A01,083080,Cao; Yingjun,6,15,40,34
1657674144662,CSE 12,A01,083652,Krause-Levy; Sophia Louisa,28,1,120,92
1657674150689,CSE 15L,A01,083654,Morris; Justin Loren,9,0,50,41
1657674150689,CSE 15L,A02,083655,Morris; Justin Loren,9,0,50,41
1657674156713,CSE 20,A01,083657,Tran; Khoa Dang,39,0,80,41
1657674162749,CSE 21,A01,095574,Bach; Quang Tran,22,0,48,26
1657674168772,CSE 30,A01,083084,Eldon; John,6,0,80,74
1657674168772,CSE 30,B01,095061,Bhaskar; Nishant,9,0,50,41
1657674174797,CSE 100,A01,083659,Cao; Yingjun,5,4,70,65
1657674180822,CSE 134B,A01,083661,Powell; Thomas Allan,23,0,100,77
1657674186844,CSE 140,A01,083663,Gungor; Onat,15,0,85,70
1657674192868,CSE 140L,A01,083088,Eldon; John,22,0,100,78
1657674198895,CSE 175,A01,083665,Kumar; Rakesh,3,0,25,22
1657674204923,CSE 190,A00,092507,Dubnov; Shlomo,8,0,20,12
1657674210945,ECE 45,A01,083139,Congero; Spencer William,6,0,75,69
1657674216972,ECE 65,A50,083695,Saad; Andrew S,12,0,30,18
1657674216972,ECE 65,A51,095125,Saad; Andrew S,24,0,26,2
1657674222999,ECE 109,A01,091882,Touri; Behrouz,20,0,70,50
1657674229025,ECE 180,A00,083140,Abi Samra; Nicholas Camill,1,0,30,29
1657674229025,ECE 180,B00,083141,Abi Samra; Nicholas Camill,0,0,30,30
1657674235048,MATH 10A,A01,083735,Patchell; Gregory David,2,0,30,28
1657674235048,MATH 10A,A02,083736,Patchell; Gregory David,20,0,30,10
1657674235048,MATH 10A,A03,083737,Patchell; Gregory David,16,0,30,14
1657674241074,MATH 10B,A01,083207,Lim; Seonhee,8,0,34,26
1657674241074,MATH 10B,A02,083208,Lim; Seonhee,9,0,35,26
1657674241074,MATH 10B,A03,093472,Lim; Seonhee,7,0,34,27
1657674241074,MATH 10B,B01,083739,Sinha; Shubham,13,0,30,17
1657674247105,MATH 18,A01,083743,Cinel; Cameron Alexander,8,0,30,22
1657674247105,MATH 18,A02,083744,Cinel; Cameron Alexander,17,0,30,13
1657674247105,MATH 18,A03,083745,Cinel; Cameron Alexander,10,0,30,20
1657674247105,MATH 18,B01,083748,Rideout; David Porter,5,0,37,32
1657674247105,MATH 18,B02,083749,Rideout; David Porter,5,0,36,31
1657674247105,MATH 18,B03,083750,Rideout; David Porter,3,0,37,34
1657674247105,MATH 18,B04,083751,Rideout; David Porter,6,0,36,30
1657674247105,MATH 18,B05,093473,Rideout; David Porter,6,0,36,30
1657674247105,MATH 18,B06,093474,Rideout; David Porter,6,0,36,30
1657674253128,MATH 20A,A01,083754,Zheng; Zequn,14,0,40,26
1657674259153,MATH 20B,A01,083756,Briones; Jor-el Thomas Caparas,4,0,36,32
1657674259153,MATH 20B,A02,083757,Briones; Jor-el Thomas Caparas,1,0,36,35
1657674259153,MATH 20B,A03,093475,Briones; Jor-el Thomas Caparas,2,0,36,34
1657674265177,MATH 20C,A01,083760,Briones; Jor-el Thomas Caparas,1,0,35,34
1657674265177,MATH 20C,A02,083761,Briones; Jor-el Thomas Caparas,8,0,35,27
1657674265177,MATH 20C,A03,093476,Briones; Jor-el Thomas Caparas,0,1,36,36
1657674265177,MATH 20C,B01,083762,Bach; Quang Tran,1,0,30,29
1657674271200,MATH 20D,A01,083765,Tran; Brian Kha,5,0,30,25
1657674271200,MATH 20D,A02,083766,Tran; Brian Kha,5,0,30,25
1657674271200,MATH 20D,A03,083767,Tran; Brian Kha,5,0,30,25
1657674277233,MATH 20E,A01,083771,Ganguly; Soumya,9,0,32,23
1657674277233,MATH 20E,A02,083772,Ganguly; Soumya,6,0,32,26
1657674277233,MATH 20E,B01,083773,Ciotti; Benjamin,20,0,35,15
1657674277233,MATH 20E,B02,083774,Ciotti; Benjamin,18,0,35,17
1657674283263,MATH 103A,A01,083777,Greenfeld; Be'Eri,3,0,36,33
1657674283263,MATH 103A,A02,083778,Greenfeld; Be'Eri,5,0,36,31
1657674283263,MATH 103A,A03,093561,Greenfeld; Be'Eri,6,0,36,30
1657674283263,MATH 103A,B01,083779,Greenfeld; Be'Eri,7,0,36,29
1657674283263,MATH 103A,B02,083780,Greenfeld; Be'Eri,4,0,36,32
1657674283263,MATH 103A,B03,093562,Greenfeld; Be'Eri,3,0,36,33
1657674289290,MATH 105,A01,085443,Carter; Anne Toulson,15,0,35,20
1657674289290,MATH 105,A02,093477,Carter; Anne Toulson,20,0,35,15
1657674295313,MATH 109,A01,083213,Ganzberger; Geoffrey Michael,2,0,34,32
1657674295313,MATH 109,A02,083214,Ganzberger; Geoffrey Michael,4,0,34,30
1657674295313,MATH 109,A03,093478,Ganzberger; Geoffrey Michael,2,0,34,32
1657674295313,MATH 109,B01,083215,Ganzberger; Geoffrey Michael,1,0,32,31
1657674295313,MATH 109,B02,083216,Ganzberger; Geoffrey Michael,2,0,32,30
1657674295313,MATH 109,B03,093479,Ganzberger; Geoffrey Michael,8,0,32,24
1657674301336,MATH 142A,A01,083219,Chow; Bennett,7,0,32,25
1657674301336,MATH 142A,A02,083220,Chow; Bennett,10,0,32,22
1657674301336,MATH 142A,A03,093480,Chow; Bennett,9,0,32,23
1657674301336,MATH 142A,B03,093481,Chow; Bennett,8,0,32,24
1657674301336,MATH 142A,B04,093558,Chow; Bennett,13,0,32,19
1657674301336,MATH 142A,B05,093559,Chow; Bennett,6,0,32,26
1657674307367,MATH 193A,A01,083224,Rotar; Vladimir,8,0,34,26
1657674307367,MATH 193A,A02,083225,Rotar; Vladimir,9,0,34,25
1657674307367,MATH 193A,A03,083781,Rotar; Vladimir,5,0,34,29
1657674307367,MATH 193A,A04,083782,Rotar; Vladimir,10,0,34,24
1657674307367,MATH 193A,A05,093482,Rotar; Vladimir,10,0,34,24
1657674313395,MATH 197,001,091859,McAuley; Julian John,9999,0,9999,0
1657674313395,MATH 197,002,095566,Kedlaya; Kiran S.,9997,0,9999,2
1657674313395,MATH 197,003,095567,Xiao; Ming,9999,0,9999,0
1657674313395,MATH 197,004,095571,Perols; Johan Lars,9998,0,9999,1
1657674320459,COGS 9,A01,083615,Shannon; Kyle Michael,9,0,75,66
1657674326485,COGS 11,A01,083617,Boyle; Mary E. T.,23,0,48,25
1657674332509,COGS 13,A01,083071,Bastos; Amalia Pinkusfeld,11,0,71,60
1657674338543,COGS 14A,A01,092681,Semenuks; Arturs,5,1,100,95
1657674344568,COGS 14B,A01,083073,Cheng; Tzu-Han,6,0,63,57
1657674350592,COGS 17,A01,092677,Semenuks; Arturs,6,0,81,75
1657674356619,COGS 100,A01,083619,Allen; Michael Gordon,17,0,70,53
1657674362648,COGS 101A,A01,083621,Davis; Joshua Daniel,9,0,68,59
1657674368671,COGS 101B,A01,091572,Allen; Michael Gordon,12,0,65,53
1657674374693,COGS 101C,A01,083625,Delgado; Tania,17,0,35,18
1657674380716,COGS 107A,A01,083627,Boyle; Mary E. T.,13,0,60,47
1657674386742,COGS 118A,A01,083075,Gupta; Anjum,21,0,76,55
1657674392765,CSE 3,A50,083646,Miranda; Gregory Joseph,24,0,50,26
1657674398791,CSE 8A,A50,083650,Miranda; Gregory Joseph,17,1,56,39
1657674404813,CSE 11,A01,083080,Cao; Yingjun,6,15,40,34
1657674410840,CSE 12,A01,083652,Krause-Levy; Sophia Louisa,28,1,120,92
1657674416876,CSE 15L,A01,083654,Morris; Justin Loren,9,0,50,41
1657674416876,CSE 15L,A02,083655,Morris; Justin Loren,9,0,50,41
1657674422898,CSE 20,A01,083657,Tran; Khoa Dang,39,0,80,41
1657674428926,CSE 21,A01,095574,Bach; Quang Tran,22,0,48,26
1657674434949,CSE 30,A01,083084,Eldon; John,6,0,80,74
1657674434949,CSE 30,B01,095061,Bhaskar; Nishant,9,0,50,41
1657674440974,CSE 100,A01,083659,Cao; Yingjun,5,4,70,65
1657674447001,CSE 134B,A01,083661,Powell; Thomas Allan,23,0,100,77
1657674453029,CSE 140,A01,083663,Gungor; Onat,15,0,85,70
1657674459052,CSE 140L,A01,083088,Eldon; John,22,0,100,78
1657674465079,CSE 175,A01,083665,Kumar; Rakesh,3,0,25,22
1657674471102,CSE 190,A00,092507,Dubnov; Shlomo,8,0,20,12
1657674477125,ECE 45,A01,083139,Congero; Spencer William,6,0,75,69
1657674483150,ECE 65,A50,083695,Saad; Andrew S,12,0,30,18
1657674483150,ECE 65,A51,095125,Saad; Andrew S,24,0,26,2
1657674489176,ECE 109,A01,091882,Touri; Behrouz,20,0,70,50
1657674495199,ECE 180,A00,083140,Abi Samra; Nicholas Camill,1,0,30,29
1657674495199,ECE 180,B00,083141,Abi Samra; Nicholas Camill,0,0,30,30
1657674501222,MATH 10A,A01,083735,Patchell; Gregory David,2,0,30,28
1657674501222,MATH 10A,A02,083736,Patchell; Gregory David,20,0,30,10
1657674501222,MATH 10A,A03,083737,Patchell; Gregory David,16,0,30,14
1657674507248,MATH 10B,A01,083207,Lim; Seonhee,8,0,34,26
1657674507248,MATH 10B,A02,083208,Lim; Seonhee,9,0,35,26
1657674507248,MATH 10B,A03,093472,Lim; Seonhee,7,0,34,27
1657674507248,MATH 10B,B01,083739,Sinha; Shubham,13,0,30,17
1657674513276,MATH 18,A01,083743,Cinel; Cameron Alexander,8,0,30,22
1657674513276,MATH 18,A02,083744,Cinel; Cameron Alexander,17,0,30,13
1657674513276,MATH 18,A03,083745,Cinel; Cameron Alexander,10,0,30,20
1657674513276,MATH 18,B01,083748,Rideout; David Porter,5,0,37,32
1657674513276,MATH 18,B02,083749,Rideout; David Porter,5,0,36,31
1657674513276,MATH 18,B03,083750,Rideout; David Porter,3,0,37,34
1657674513276,MATH 18,B04,083751,Rideout; David Porter,6,0,36,30
1657674513276,MATH 18,B05,093473,Rideout; David Porter,6,0,36,30
1657674513276,MATH 18,B06,093474,Rideout; David Porter,6,0,36,30
1657674519302,MATH 20A,A01,083754,Zheng; Zequn,14,0,40,26
1657674525325,MATH 20B,A01,083756,Briones; Jor-el Thomas Caparas,4,0,36,32
1657674525325,MATH 20B,A02,083757,Briones; Jor-el Thomas Caparas,1,0,36,35
1657674525325,MATH 20B,A03,093475,Briones; Jor-el Thomas Caparas,2,0,36,34
1657674531349,MATH 20C,A01,083760,Briones; Jor-el Thomas Caparas,1,0,35,34
1657674531349,MATH 20C,A02,083761,Briones; Jor-el Thomas Caparas,8,0,35,27
1657674531349,MATH 20C,A03,093476,Briones; Jor-el Thomas Caparas,0,1,36,36
1657674531349,MATH 20C,B01,083762,Bach; Quang Tran,1,0,30,29
1657674537373,MATH 20D,A01,083765,Tran; Brian Kha,5,0,30,25
1657674537373,MATH 20D,A02,083766,Tran; Brian Kha,5,0,30,25
1657674537373,MATH 20D,A03,083767,Tran; Brian Kha,5,0,30,25
1657674543417,MATH 20E,A01,083771,Ganguly; Soumya,9,0,32,23
1657674543417,MATH 20E,A02,083772,Ganguly; Soumya,6,0,32,26
1657674543417,MATH 20E,B01,083773,Ciotti; Benjamin,20,0,35,15
1657674543417,MATH 20E,B02,083774,Ciotti; Benjamin,18,0,35,17
1657674549443,MATH 103A,A01,083777,Greenfeld; Be'Eri,3,0,36,33
1657674549443,MATH 103A,A02,083778,Greenfeld; Be'Eri,5,0,36,31
1657674549443,MATH 103A,A03,093561,Greenfeld; Be'Eri,6,0,36,30
1657674549443,MATH 103A,B01,083779,Greenfeld; Be'Eri,7,0,36,29
1657674549443,MATH 103A,B02,083780,Greenfeld; Be'Eri,4,0,36,32
1657674549443,MATH 103A,B03,093562,Greenfeld; Be'Eri,3,0,36,33
1657674555469,MATH 105,A01,085443,Carter; Anne Toulson,15,0,35,20
1657674555469,MATH 105,A02,093477,Carter; Anne Toulson,20,0,35,15
1657674561492,MATH 109,A01,083213,Ganzberger; Geoffrey Michael,2,0,34,32
1657674561492,MATH 109,A02,083214,Ganzberger; Geoffrey Michael,4,0,34,30
1657674561492,MATH 109,A03,093478,Ganzberger; Geoffrey Michael,2,0,34,32
1657674561492,MATH 109,B01,083215,Ganzberger; Geoffrey Michael,1,0,32,31
1657674561492,MATH 109,B02,083216,Ganzberger; Geoffrey Michael,2,0,32,30
1657674561492,MATH 109,B03,093479,Ganzberger; Geoffrey Michael,8,0,32,24
1657674567520,MATH 142A,A01,083219,Chow; Bennett,7,0,32,25
1657674567520,MATH 142A,A02,083220,Chow; Bennett,10,0,32,22
1657674567520,MATH 142A,A03,093480,Chow; Bennett,9,0,32,23
1657674567520,MATH 142A,B03,093481,Chow; Bennett,8,0,32,24
1657674567520,MATH 142A,B04,093558,Chow; Bennett,13,0,32,19
1657674567520,MATH 142A,B05,093559,Chow; Bennett,6,0,32,26
1657674573548,MATH 193A,A01,083224,Rotar; Vladimir,8,0,34,26
1657674573548,MATH 193A,A02,083225,Rotar; Vladimir,9,0,34,25
1657674573548,MATH 193A,A03,083781,Rotar; Vladimir,5,0,34,29
1657674573548,MATH 193A,A04,083782,Rotar; Vladimir,10,0,34,24
1657674573548,MATH 193A,A05,093482,Rotar; Vladimir,10,0,34,24
1657674579574,MATH 197,001,091859,McAuley; Julian John,9999,0,9999,0
1657674579574,MATH 197,002,095566,Kedlaya; Kiran S.,9997,0,9999,2
1657674579574,MATH 197,003,095567,Xiao; Ming,9999,0,9999,0
1657674579574,MATH 197,004,095571,Perols; Johan Lars,9998,0,9999,1
1657674586627,COGS 9,A01,083615,Shannon; Kyle Michael,9,0,75,66
1657674592649,COGS 11,A01,083617,Boyle; Mary E. T.,23,0,48,25
1657674598675,COGS 13,A01,083071,Bastos; Amalia Pinkusfeld,11,0,71,60
1657674604705,COGS 14A,A01,092681,Semenuks; Arturs,5,1,100,95
1657674610728,COGS 14B,A01,083073,Cheng; Tzu-Han,6,0,63,57
1657674616750,COGS 17,A01,092677,Semenuks; Arturs,6,0,81,75
1657674622772,COGS 100,A01,083619,Allen; Michael Gordon,17,0,70,53
1657674628800,COGS 101A,A01,083621,Davis; Joshua Daniel,9,0,68,59
1657674634832,COGS 101B,A01,091572,Allen; Michael Gordon,12,0,65,53
1657674640930,COGS 101C,A01,083625,Delgado; Tania,17,0,35,18
1657674646957,COGS 107A,A01,083627,Boyle; Mary E. T.,13,0,60,47
1657674652982,COGS 118A,A01,083075,Gupta; Anjum,21,0,76,55
1657674659009,CSE 3,A50,083646,Miranda; Gregory Joseph,24,0,50,26
1657674665032,CSE 8A,A50,083650,Miranda; Gregory Joseph,17,1,56,39
1657674671055,CSE 11,A01,083080,Cao; Yingjun,6,15,40,34
1657674677085,CSE 12,A01,083652,Krause-Levy; Sophia Louisa,28,1,120,92
1657674683112,CSE 15L,A01,083654,Morris; Justin Loren,9,0,50,41
1657674683112,CSE 15L,A02,083655,Morris; Justin Loren,9,0,50,41
1657674689139,CSE 20,A01,083657,Tran; Khoa Dang,39,0,80,41
1657674695161,CSE 21,A01,095574,Bach; Quang Tran,22,0,48,26
1657674701183,CSE 30,A01,083084,Eldon; John,6,0,80,74
1657674701183,CSE 30,B01,095061,Bhaskar; Nishant,9,0,50,41
1657674707206,CSE 100,A01,083659,Cao; Yingjun,5,4,70,65
1657674713234,CSE 134B,A01,083661,Powell; Thomas Allan,23,0,100,77
1657674719257,CSE 140,A01,083663,Gungor; Onat,15,0,85,70
1657674725282,CSE 140L,A01,083088,Eldon; John,22,0,100,78
1657674731305,CSE 175,A01,083665,Kumar; Rakesh,3,0,25,22
1657674737327,CSE 190,A00,092507,Dubnov; Shlomo,8,0,20,12
1657674743351,ECE 45,A01,083139,Congero; Spencer William,6,0,75,69
1657674749378,ECE 65,A50,083695,Saad; Andrew S,12,0,30,18
1657674749378,ECE 65,A51,095125,Saad; Andrew S,24,0,26,2
1657674755404,ECE 109,A01,091882,Touri; Behrouz,20,0,70,50
1657674761431,ECE 180,A00,083140,Abi Samra; Nicholas Camill,1,0,30,29
1657674761431,ECE 180,B00,083141,Abi Samra; Nicholas Camill,0,0,30,30
1657674767455,MATH 10A,A01,083735,Patchell; Gregory David,2,0,30,28
1657674767455,MATH 10A,A02,083736,Patchell; Gregory David,20,0,30,10
1657674767455,MATH 10A,A03,083737,Patchell; Gregory David,16,0,30,14
1657674773478,MATH 10B,A01,083207,Lim; Seonhee,8,0,34,26
1657674773478,MATH 10B,A02,083208,Lim; Seonhee,9,0,35,26
1657674773478,MATH 10B,A03,093472,Lim; Seonhee,7,0,34,27
1657674773478,MATH 10B,B01,083739,Sinha; Shubham,13,0,30,17
1657674779509,MATH 18,A01,083743,Cinel; Cameron Alexander,8,0,30,22
1657674779509,MATH 18,A02,083744,Cinel; Cameron Alexander,17,0,30,13
1657674779509,MATH 18,A03,083745,Cinel; Cameron Alexander,10,0,30,20
1657674779509,MATH 18,B01,083748,Rideout; David Porter,5,0,37,32
1657674779509,MATH 18,B02,083749,Rideout; David Porter,5,0,36,31
1657674779509,MATH 18,B03,083750,Rideout; David Porter,3,0,37,34
1657674779509,MATH 18,B04,083751,Rideout; David Porter,6,0,36,30
1657674779509,MATH 18,B05,093473,Rideout; David Porter,6,0,36,30
1657674779509,MATH 18,B06,093474,Rideout; David Porter,6,0,36,30
1657674785532,MATH 20A,A01,083754,Zheng; Zequn,14,0,40,26
1657674791554,MATH 20B,A01,083756,Briones; Jor-el Thomas Caparas,4,0,36,32
1657674791554,MATH 20B,A02,083757,Briones; Jor-el Thomas Caparas,1,0,36,35
1657674791554,MATH 20B,A03,093475,Briones; Jor-el Thomas Caparas,2,0,36,34
1657674797576,MATH 20C,A01,083760,Briones; Jor-el Thomas Caparas,1,0,35,34
1657674797576,MATH 20C,A02,083761,Briones; Jor-el Thomas Caparas,8,0,35,27
1657674797576,MATH 20C,A03,093476,Briones; Jor-el Thomas Caparas,0,1,36,36
1657674797576,MATH 20C,B01,083762,Bach; Quang Tran,1,0,30,29
1657674803599,MATH 20D,A01,083765,Tran; Brian Kha,5,0,30,25
1657674803599,MATH 20D,A02,083766,Tran; Brian Kha,5,0,30,25
1657674803599,MATH 20D,A03,083767,Tran; Brian Kha,5,0,30,25
1657674809623,MATH 20E,A01,083771,Ganguly; Soumya,9,0,32,23
1657674809623,MATH 20E,A02,083772,Ganguly; Soumya,6,0,32,26
1657674809623,MATH 20E,B01,083773,Ciotti; Benjamin,20,0,35,15
1657674809623,MATH 20E,B02,083774,Ciotti; Benjamin,18,0,35,17
1657674815647,MATH 103A,A01,083777,Greenfeld; Be'Eri,3,0,36,33
1657674815647,MATH 103A,A02,083778,Greenfeld; Be'Eri,5,0,36,31
1657674815647,MATH 103A,A03,093561,Greenfeld; Be'Eri,6,0,36,30
1657674815647,MATH 103A,B01,083779,Greenfeld; Be'Eri,7,0,36,29
1657674815647,MATH 103A,B02,083780,Greenfeld; Be'Eri,4,0,36,32
1657674815647,MATH 103A,B03,093562,Greenfeld; Be'Eri,3,0,36,33
1657674821675,MATH 105,A01,085443,Carter; Anne Toulson,15,0,35,20
1657674821675,MATH 105,A02,093477,Carter; Anne Toulson,20,0,35,15
1657674827703,MATH 109,A01,083213,Ganzberger; Geoffrey Michael,2,0,34,32
1657674827703,MATH 109,A02,083214,Ganzberger; Geoffrey Michael,4,0,34,30
1657674827703,MATH 109,A03,093478,Ganzberger; Geoffrey Michael,2,0,34,32
1657674827703,MATH 109,B01,083215,Ganzberger; Geoffrey Michael,1,0,32,31
1657674827703,MATH 109,B02,083216,Ganzberger; Geoffrey Michael,2,0,32,30
1657674827703,MATH 109,B03,093479,Ganzberger; Geoffrey Michael,8,0,32,24
1657674833727,MATH 142A,A01,083219,Chow; Bennett,7,0,32,25
1657674833727,MATH 142A,A02,083220,Chow; Bennett,10,0,32,22
1657674833727,MATH 142A,A03,093480,Chow; Bennett,9,0,32,23
1657674833727,MATH 142A,B03,093481,Chow; Bennett,8,0,32,24
1657674833727,MATH 142A,B04,093558,Chow; Bennett,13,0,32,19
1657674833727,MATH 142A,B05,093559,Chow; Bennett,6,0,32,26
1657674839754,MATH 193A,A01,083224,Rotar; Vladimir,8,0,34,26
1657674839754,MATH 193A,A02,083225,Rotar; Vladimir,9,0,34,25
1657674839754,MATH 193A,A03,083781,Rotar; Vladimir,5,0,34,29
1657674839754,MATH 193A,A04,083782,Rotar; Vladimir,10,0,34,24
1657674839754,MATH 193A,A05,093482,Rotar; Vladimir,10,0,34,24
1657674845776,MATH 197,001,091859,McAuley; Julian John,9999,0,9999,0
1657674845776,MATH 197,002,095566,Kedlaya; Kiran S.,9997,0,9999,2
1657674845776,MATH 197,003,095567,Xiao; Ming,9999,0,9999,0
1657674845776,MATH 197,004,095571,Perols; Johan Lars,9998,0,9999,1
1657674852836,COGS 9,A01,083615,Shannon; Kyle Michael,9,0,75,66
1657674858862,COGS 11,A01,083617,Boyle; Mary E. T.,23,0,48,25
1657674864888,COGS 13,A01,083071,Bastos; Amalia Pinkusfeld,11,0,71,60
1657674870910,COGS 14A,A01,092681,Semenuks; Arturs,5,1,100,95
1657674876931,COGS 14B,A01,083073,Cheng; Tzu-Han,6,0,63,57
1657674882955,COGS 17,A01,092677,Semenuks; Arturs,6,0,81,75
1657674888981,COGS 100,A01,083619,Allen; Michael Gordon,17,0,70,53
1657674895009,COGS 101A,A01,083621,Davis; Joshua Daniel,9,0,68,59
1657674901033,COGS 101B,A01,091572,Allen; Michael Gordon,12,0,65,53
1657674907059,COGS 101C,A01,083625,Delgado; Tania,17,0,35,18
1657674913084,COGS 107A,A01,083627,Boyle; Mary E. T.,13,0,60,47
1657674919106,COGS 118A,A01,083075,Gupta; Anjum,21,0,76,55
1657674925132,CSE 3,A50,083646,Miranda; Gregory Joseph,24,0,50,26
1657674931156,CSE 8A,A50,083650,Miranda; Gregory Joseph,17,1,56,39
1657674937179,CSE 11,A01,083080,Cao; Yingjun,6,15,40,34
1657674943217,CSE 12,A01,083652,Krause-Levy; Sophia Louisa,28,1,120,92
1657674949244,CSE 15L,A01,083654,Morris; Justin Loren,9,0,50,41
1657674949244,CSE 15L,A02,083655,Morris; Justin Loren,9,0,50,41
1657674955270,CSE 20,A01,083657,Tran; Khoa Dang,39,0,80,41
1657674961292,CSE 21,A01,095574,Bach; Quang Tran,22,0,48,26
1657674967314,CSE 30,A01,083084,Eldon; John,6,0,80,74
1657674967314,CSE 30,B01,095061,Bhaskar; Nishant,9,0,50,41
1657674973337,CSE 100,A01,083659,Cao; Yingjun,5,4,70,65
1657674979364,CSE 134B,A01,083661,Powell; Thomas Allan,23,0,100,77
1657674985391,CSE 140,A01,083663,Gungor; Onat,15,0,85,70
1657674991415,CSE 140L,A01,083088,Eldon; John,22,0,100,78
1657674997438,CSE 175,A01,083665,Kumar; Rakesh,3,0,25,22
1657675003464,CSE 190,A00,092507,Dubnov; Shlomo,8,0,20,12
1657675009491,ECE 45,A01,083139,Congero; Spencer William,6,0,75,69
1657675015514,ECE 65,A50,083695,Saad; Andrew S,12,0,30,18
1657675015514,ECE 65,A51,095125,Saad; Andrew S,24,0,26,2
1657675021538,ECE 109,A01,091882,Touri; Behrouz,20,0,70,50
1657675027562,ECE 180,A00,083140,Abi Samra; Nicholas Camill,1,0,30,29
1657675027562,ECE 180,B00,083141,Abi Samra; Nicholas Camill,0,0,30,30
1657675033585,MATH 10A,A01,083735,Patchell; Gregory David,2,0,30,28
1657675033585,MATH 10A,A02,083736,Patchell; Gregory David,20,0,30,10
1657675033585,MATH 10A,A03,083737,Patchell; Gregory David,16,0,30,14
1657675039612,MATH 10B,A01,083207,Lim; Seonhee,8,0,34,26
1657675039612,MATH 10B,A02,083208,Lim; Seonhee,9,0,35,26
1657675039612,MATH 10B,A03,093472,Lim; Seonhee,7,0,34,27
1657675039612,MATH 10B,B01,083739,Sinha; Shubham,13,0,30,17
1657675045638,MATH 18,A01,083743,Cinel; Cameron Alexander,8,0,30,22
1657675045638,MATH 18,A02,083744,Cinel; Cameron Alexander,17,0,30,13
1657675045638,MATH 18,A03,083745,Cinel; Cameron Alexander,10,0,30,20
1657675045638,MATH 18,B01,083748,Rideout; David Porter,5,0,37,32
1657675045638,MATH 18,B02,083749,Rideout; David Porter,5,0,36,31
1657675045638,MATH 18,B03,083750,Rideout; David Porter,3,0,37,34
1657675045638,MATH 18,B04,083751,Rideout; David Porter,6,0,36,30
1657675045638,MATH 18,B05,093473,Rideout; David Porter,6,0,36,30
1657675045638,MATH 18,B06,093474,Rideout; David Porter,6,0,36,30
1657675051687,MATH 20A,A01,083754,Zheng; Zequn,14,0,40,26
1657675057715,MATH 20B,A01,083756,Briones; Jor-el Thomas Caparas,4,0,36,32
1657675057715,MATH 20B,A02,083757,Briones; Jor-el Thomas Caparas,1,0,36,35
1657675057715,MATH 20B,A03,093475,Briones; Jor-el Thomas Caparas,2,0,36,34
1657675063747,MATH 20C,A01,083760,Briones; Jor-el Thomas Caparas,1,0,35,34
1657675063747,MATH 20C,A02,083761,Briones; Jor-el Thomas Caparas,8,0,35,27
1657675063747,MATH 20C,A03,093476,Briones; Jor-el Thomas Caparas,0,1,36,36
1657675063747,MATH 20C,B01,083762,Bach; Quang Tran,1,0,30,29
1657675069774,MATH 20D,A01,083765,Tran; Brian Kha,5,0,30,25
1657675069774,MATH 20D,A02,083766,Tran; Brian Kha,5,0,30,25
1657675069774,MATH 20D,A03,083767,Tran; Brian Kha,5,0,30,25
1657675075802,MATH 20E,A01,083771,Ganguly; Soumya,9,0,32,23
1657675075802,MATH 20E,A02,083772,Ganguly; Soumya,6,0,32,26
1657675075802,MATH 20E,B01,083773,Ciotti; Benjamin,20,0,35,15
1657675075802,MATH 20E,B02,083774,Ciotti; Benjamin,18,0,35,17
1657675081826,MATH 103A,A01,083777,Greenfeld; Be'Eri,3,0,36,33
1657675081826,MATH 103A,A02,083778,Greenfeld; Be'Eri,5,0,36,31
1657675081826,MATH 103A,A03,093561,Greenfeld; Be'Eri,6,0,36,30
1657675081826,MATH 103A,B01,083779,Greenfeld; Be'Eri,7,0,36,29
1657675081826,MATH 103A,B02,083780,Greenfeld; Be'Eri,4,0,36,32
1657675081826,MATH 103A,B03,093562,Greenfeld; Be'Eri,3,0,36,33
1657675087851,MATH 105,A01,085443,Carter; Anne Toulson,15,0,35,20
1657675087851,MATH 105,A02,093477,Carter; Anne Toulson,20,0,35,15
1657675093881,MATH 109,A01,083213,Ganzberger; Geoffrey Michael,2,0,34,32
1657675093881,MATH 109,A02,083214,Ganzberger; Geoffrey Michael,4,0,34,30
1657675093881,MATH 109,A03,093478,Ganzberger; Geoffrey Michael,2,0,34,32
1657675093881,MATH 109,B01,083215,Ganzberger; Geoffrey Michael,1,0,32,31
1657675093881,MATH 109,B02,083216,Ganzberger; Geoffrey Michael,2,0,32,30
1657675093881,MATH 109,B03,093479,Ganzberger; Geoffrey Michael,8,0,32,24
1657675099903,MATH 142A,A01,083219,Chow; Bennett,7,0,32,25
1657675099903,MATH 142A,A02,083220,Chow; Bennett,10,0,32,22
1657675099903,MATH 142A,A03,093480,Chow; Bennett,9,0,32,23
1657675099903,MATH 142A,B03,093481,Chow; Bennett,8,0,32,24
1657675099903,MATH 142A,B04,093558,Chow; Bennett,13,0,32,19
1657675099903,MATH 142A,B05,093559,Chow; Bennett,6,0,32,26
1657675105932,MATH 193A,A01,083224,Rotar; Vladimir,8,0,34,26
1657675105932,MATH 193A,A02,083225,Rotar; Vladimir,9,0,34,25
1657675105932,MATH 193A,A03,083781,Rotar; Vladimir,5,0,34,29
1657675105932,MATH 193A,A04,083782,Rotar; Vladimir,10,0,34,24
1657675105932,MATH 193A,A05,093482,Rotar; Vladimir,10,0,34,24
1657675111954,MATH 197,001,091859,McAuley; Julian John,9999,0,9999,0
1657675111954,MATH 197,002,095566,Kedlaya; Kiran S.,9997,0,9999,2
1657675111954,MATH 197,003,095567,Xiao; Ming,9999,0,9999,0
1657675111954,MATH 197,004,095571,Perols; Johan Lars,9998,0,9999,1
1657675119012,COGS 9,A01,083615,Shannon; Kyle Michael,9,0,75,66
1657675125035,COGS 11,A01,083617,Boyle; Mary E. T.,23,0,48,25
1657675131059,COGS 13,A01,083071,Bastos; Amalia Pinkusfeld,11,0,71,60
1657675137080,COGS 14A,A01,092681,Semenuks; Arturs,5,1,100,95
1657675143104,COGS 14B,A01,083073,Cheng; Tzu-Han,6,0,63,57
1657675149132,COGS 17,A01,092677,Semenuks; Arturs,6,0,81,75
1657675155154,COGS 100,A01,083619,Allen; Michael Gordon,17,0,70,53
1657675161181,COGS 101A,A01,083621,Davis; Joshua Daniel,9,0,68,59
1657675167208,COGS 101B,A01,091572,Allen; Michael Gordon,12,0,65,53
1657675173235,COGS 101C,A01,083625,Delgado; Tania,17,0,35,18
1657675179260,COGS 107A,A01,083627,Boyle; Mary E. T.,13,0,60,47
1657675185288,COGS 118A,A01,083075,Gupta; Anjum,21,0,76,55
1657675191316,CSE 3,A50,083646,Miranda; Gregory Joseph,24,0,50,26
1657675197339,CSE 8A,A50,083650,Miranda; Gregory Joseph,17,1,56,39
1657675203364,CSE 11,A01,083080,Cao; Yingjun,6,15,40,34
1657675209390,CSE 12,A01,083652,Krause-Levy; Sophia Louisa,28,1,120,92
1657675215418,CSE 15L,A01,083654,Morris; Justin Loren,9,0,50,41
1657675215418,CSE 15L,A02,083655,Morris; Justin Loren,9,0,50,41
1657675221443,CSE 20,A01,083657,Tran; Khoa Dang,39,0,80,41
1657675227474,CSE 21,A01,095574,Bach; Quang Tran,22,0,48,26
1657675233511,CSE 30,A01,083084,Eldon; John,6,0,80,74
1657675233511,CSE 30,B01,095061,Bhaskar; Nishant,9,0,50,41
1657675239609,CSE 100,A01,083659,Cao; Yingjun,5,4,70,65
1657675245635,CSE 134B,A01,083661,Powell; Thomas Allan,23,0,100,77
1657675251660,CSE 140,A01,083663,Gungor; Onat,15,0,85,70
1657675257690,CSE 140L,A01,083088,Eldon; John,22,0,100,78
1657675263714,CSE 175,A01,083665,Kumar; Rakesh,3,0,25,22
1657675269739,CSE 190,A00,092507,Dubnov; Shlomo,8,0,20,12
1657675275761,ECE 45,A01,083139,Congero; Spencer William,6,0,75,69
1657675281786,ECE 65,A50,083695,Saad; Andrew S,12,0,30,18
1657675281786,ECE 65,A51,095125,Saad; Andrew S,24,0,26,2
1657675287810,ECE 109,A01,091882,Touri; Behrouz,20,0,70,50
1657675293834,ECE 180,A00,083140,Abi Samra; Nicholas Camill,1,0,30,29
1657675293834,ECE 180,B00,083141,Abi Samra; Nicholas Camill,0,0,30,30
1657675299864,MATH 10A,A01,083735,Patchell; Gregory David,2,0,30,28
1657675299864,MATH 10A,A02,083736,Patchell; Gregory David,20,0,30,10
1657675299864,MATH 10A,A03,083737,Patchell; Gregory David,16,0,30,14
1657675305892,MATH 10B,A01,083207,Lim; Seonhee,8,0,34,26
1657675305892,MATH 10B,A02,083208,Lim; Seonhee,9,0,35,26
1657675305892,MATH 10B,A03,093472,Lim; Seonhee,7,0,34,27
1657675305892,MATH 10B,B01,083739,Sinha; Shubham,13,0,30,17
1657675311917,MATH 18,A01,083743,Cinel; Cameron Alexander,8,0,30,22
1657675311917,MATH 18,A02,083744,Cinel; Cameron Alexander,17,0,30,13
1657675311917,MATH 18,A03,083745,Cinel; Cameron Alexander,10,0,30,20
1657675311917,MATH 18,B01,083748,Rideout; David Porter,5,0,37,32
1657675311917,MATH 18,B02,083749,Rideout; David Porter,5,0,36,31
1657675311917,MATH 18,B03,083750,Rideout; David Porter,3,0,37,34
1657675311917,MATH 18,B04,083751,Rideout; David Porter,6,0,36,30
1657675311917,MATH 18,B05,093473,Rideout; David Porter,6,0,36,30
1657675311917,MATH 18,B06,093474,Rideout; David Porter,6,0,36,30
1657675317942,MATH 20A,A01,083754,Zheng; Zequn,14,0,40,26
1657675323964,MATH 20B,A01,083756,Briones; Jor-el Thomas Caparas,4,0,36,32
1657675323964,MATH 20B,A02,083757,Briones; Jor-el Thomas Caparas,1,0,36,35
1657675323964,MATH 20B,A03,093475,Briones; Jor-el Thomas Caparas,2,0,36,34
1657675329993,MATH 20C,A01,083760,Briones; Jor-el Thomas Caparas,1,0,35,34
1657675329993,MATH 20C,A02,083761,Briones; Jor-el Thomas Caparas,8,0,35,27
1657675329993,MATH 20C,A03,093476,Briones; Jor-el Thomas Caparas,0,1,36,36
1657675329993,MATH 20C,B01,083762,Bach; Quang Tran,1,0,30,29
1657675336016,MATH 20D,A01,083765,Tran; Brian Kha,5,0,30,25
1657675336016,MATH 20D,A02,083766,Tran; Brian Kha,5,0,30,25
1657675336016,MATH 20D,A03,083767,Tran; Brian Kha,5,0,30,25
1657675342044,MATH 20E,A01,083771,Ganguly; Soumya,9,0,32,23
1657675342044,MATH 20E,A02,083772,Ganguly; Soumya,6,0,32,26
1657675342044,MATH 20E,B01,083773,Ciotti; Benjamin,20,0,35,15
1657675342044,MATH 20E,B02,083774,Ciotti; Benjamin,18,0,35,17
1657675348068,MATH 103A,A01,083777,Greenfeld; Be'Eri,3,0,36,33
1657675348068,MATH 103A,A02,083778,Greenfeld; Be'Eri,5,0,36,31
1657675348068,MATH 103A,A03,093561,Greenfeld; Be'Eri,6,0,36,30
1657675348068,MATH 103A,B01,083779,Greenfeld; Be'Eri,7,0,36,29
1657675348068,MATH 103A,B02,083780,Greenfeld; Be'Eri,4,0,36,32
1657675348068,MATH 103A,B03,093562,Greenfeld; Be'Eri,3,0,36,33
1657675354093,MATH 105,A01,085443,Carter; Anne Toulson,15,0,35,20
1657675354093,MATH 105,A02,093477,Carter; Anne Toulson,20,0,35,15
1657675360118,MATH 109,A01,083213,Ganzberger; Geoffrey Michael,2,0,34,32
1657675360118,MATH 109,A02,083214,Ganzberger; Geoffrey Michael,4,0,34,30
1657675360118,MATH 109,A03,093478,Ganzberger; Geoffrey Michael,2,0,34,32
1657675360118,MATH 109,B01,083215,Ganzberger; Geoffrey Michael,1,0,32,31
1657675360118,MATH 109,B02,083216,Ganzberger; Geoffrey Michael,2,0,32,30
1657675360118,MATH 109,B03,093479,Ganzberger; Geoffrey Michael,8,0,32,24
1657675366141,MATH 142A,A01,083219,Chow; Bennett,7,0,32,25
1657675366141,MATH 142A,A02,083220,Chow; Bennett,10,0,32,22
1657675366141,MATH 142A,A03,093480,Chow; Bennett,9,0,32,23
1657675366141,MATH 142A,B03,093481,Chow; Bennett,8,0,32,24
1657675366141,MATH 142A,B04,093558,Chow; Bennett,13,0,32,19
1657675366141,MATH 142A,B05,093559,Chow; Bennett,6,0,32,26
1657675372168,MATH 193A,A01,083224,Rotar; Vladimir,8,0,34,26
1657675372168,MATH 193A,A02,083225,Rotar; Vladimir,9,0,34,25
1657675372168,MATH 193A,A03,083781,Rotar; Vladimir,5,0,34,29
1657675372168,MATH 193A,A04,083782,Rotar; Vladimir,10,0,34,24
1657675372168,MATH 193A,A05,093482,Rotar; Vladimir,10,0,34,24
1657675378196,MATH 197,001,091859,McAuley; Julian John,9999,0,9999,0
1657675378196,MATH 197,002,095566,Kedlaya; Kiran S.,9997,0,9999,2
1657675378196,MATH 197,003,095567,Xiao; Ming,9999,0,9999,0
1657675378196,MATH 197,004,095571,Perols; Johan Lars,9998,0,9999,1
1657675385259,COGS 9,A01,083615,Shannon; Kyle Michael,9,0,75,66
1657675391283,COGS 11,A01,083617,Boyle; Mary E. T.,23,0,48,25
1657675397305,COGS 13,A01,083071,Bastos; Amalia Pinkusfeld,11,0,71,60
1657675403333,COGS 14A,A01,092681,Semenuks; Arturs,5,1,100,95
1657675409356,COGS 14B,A01,083073,Cheng; Tzu-Han,6,0,63,57
1657675415379,COGS 17,A01,092677,Semenuks; Arturs,6,0,81,75
1657675421414,COGS 100,A01,083619,Allen; Michael Gordon,17,0,70,53
1657675427445,COGS 101A,A01,083621,Davis; Joshua Daniel,9,0,68,59
1657675433469,COGS 101B,A01,091572,Allen; Michael Gordon,12,0,65,53
1657675439491,COGS 101C,A01,083625,Delgado; Tania,17,0,35,18
1657675445515,COGS 107A,A01,083627,Boyle; Mary E. T.,13,0,60,47
1657675451548,COGS 118A,A01,083075,Gupta; Anjum,21,0,76,55
1657675457570,CSE 3,A50,083646,Miranda; Gregory Joseph,24,0,50,26
1657675463596,CSE 8A,A50,083650,Miranda; Gregory Joseph,17,1,56,39
1657675469618,CSE 11,A01,083080,Cao; Yingjun,6,15,40,34
1657675475640,CSE 12,A01,083652,Krause-Levy; Sophia Louisa,28,1,120,92
1657675481662,CSE 15L,A01,083654,Morris; Justin Loren,9,0,50,41
1657675481662,CSE 15L,A02,083655,Morris; Justin Loren,9,0,50,41
1657675487685,CSE 20,A01,083657,Tran; Khoa Dang,39,0,80,41
1657675493709,CSE 21,A01,095574,Bach; Quang Tran,22,0,48,26
1657675499732,CSE 30,A01,083084,Eldon; John,6,0,80,74
1657675499732,CSE 30,B01,095061,Bhaskar; Nishant,9,0,50,41
1657675505759,CSE 100,A01,083659,Cao; Yingjun,5,4,70,65
1657675511785,CSE 134B,A01,083661,Powell; Thomas Allan,23,0,100,77
1657675517809,CSE 140,A01,083663,Gungor; Onat,15,0,85,70
1657675523833,CSE 140L,A01,083088,Eldon; John,22,0,100,78
1657675529858,CSE 175,A01,083665,Kumar; Rakesh,3,0,25,22
1657675535886,CSE 190,A00,092507,Dubnov; Shlomo,8,0,20,12
1657675541915,ECE 45,A01,083139,Congero; Spencer William,6,0,75,69
1657675547937,ECE 65,A50,083695,Saad; Andrew S,12,0,30,18
1657675547937,ECE 65,A51,095125,Saad; Andrew S,24,0,26,2
1657675553963,ECE 109,A01,091882,Touri; Behrouz,20,0,70,50
1657675559989,ECE 180,A00,083140,Abi Samra; Nicholas Camill,1,0,30,29
1657675559989,ECE 180,B00,083141,Abi Samra; Nicholas Camill,0,0,30,30
1657675566018,MATH 10A,A01,083735,Patchell; Gregory David,2,0,30,28
1657675566018,MATH 10A,A02,083736,Patchell; Gregory David,20,0,30,10
1657675566018,MATH 10A,A03,083737,Patchell; Gregory David,16,0,30,14
1657675572046,MATH 10B,A01,083207,Lim; Seonhee,8,0,34,26
1657675572046,MATH 10B,A02,083208,Lim; Seonhee,9,0,35,26
1657675572046,MATH 10B,A03,093472,Lim; Seonhee,7,0,34,27
1657675572046,MATH 10B,B01,083739,Sinha; Shubham,13,0,30,17
1657675578070,MATH 18,A01,083743,Cinel; Cameron Alexander,8,0,30,22
1657675578070,MATH 18,A02,083744,Cinel; Cameron Alexander,17,0,30,13
1657675578070,MATH 18,A03,083745,Cinel; Cameron Alexander,10,0,30,20
1657675578070,MATH 18,B01,083748,Rideout; David Porter,5,0,37,32
1657675578070,MATH 18,B02,083749,Rideout; David Porter,5,0,36,31
1657675578070,MATH 18,B03,083750,Rideout; David Porter,3,0,37,34
1657675578070,MATH 18,B04,083751,Rideout; David Porter,6,0,36,30
1657675578070,MATH 18,B05,093473,Rideout; David Porter,6,0,36,30
1657675578070,MATH 18,B06,093474,Rideout; David Porter,6,0,36,30
1657675584096,MATH 20A,A01,083754,Zheng; Zequn,14,0,40,26
1657675590123,MATH 20B,A01,083756,Briones; Jor-el Thomas Caparas,4,0,36,32
1657675590123,MATH 20B,A02,083757,Briones; Jor-el Thomas Caparas,1,0,36,35
1657675590123,MATH 20B,A03,093475,Briones; Jor-el Thomas Caparas,2,0,36,34
1657675596147,MATH 20C,A01,083760,Briones; Jor-el Thomas Caparas,1,0,35,34
1657675596147,MATH 20C,A02,083761,Briones; Jor-el Thomas Caparas,8,0,35,27
1657675596147,MATH 20C,A03,093476,Briones; Jor-el Thomas Caparas,0,1,36,36
1657675596147,MATH 20C,B01,083762,Bach; Quang Tran,1,0,30,29
1657675602174,MATH 20D,A01,083765,Tran; Brian Kha,5,0,30,25
1657675602174,MATH 20D,A02,083766,Tran; Brian Kha,5,0,30,25
1657675602174,MATH 20D,A03,083767,Tran; Brian Kha,5,0,30,25
1657675608198,MATH 20E,A01,083771,Ganguly; Soumya,9,0,32,23
1657675608198,MATH 20E,A02,083772,Ganguly; Soumya,6,0,32,26
1657675608198,MATH 20E,B01,083773,Ciotti; Benjamin,20,0,35,15
1657675608198,MATH 20E,B02,083774,Ciotti; Benjamin,18,0,35,17
1657675614223,MATH 103A,A01,083777,Greenfeld; Be'Eri,3,0,36,33
1657675614223,MATH 103A,A02,083778,Greenfeld; Be'Eri,5,0,36,31
1657675614223,MATH 103A,A03,093561,Greenfeld; Be'Eri,6,0,36,30
1657675614223,MATH 103A,B01,083779,Greenfeld; Be'Eri,7,0,36,29
1657675614223,MATH 103A,B02,083780,Greenfeld; Be'Eri,4,0,36,32
1657675614223,MATH 103A,B03,093562,Greenfeld; Be'Eri,3,0,36,33
1657675620249,MATH 105,A01,085443,Carter; Anne Toulson,15,0,35,20
1657675620249,MATH 105,A02,093477,Carter; Anne Toulson,20,0,35,15
1657675626271,MATH 109,A01,083213,Ganzberger; Geoffrey Michael,2,0,34,32
1657675626271,MATH 109,A02,083214,Ganzberger; Geoffrey Michael,4,0,34,30
1657675626271,MATH 109,A03,093478,Ganzberger; Geoffrey Michael,2,0,34,32
1657675626271,MATH 109,B01,083215,Ganzberger; Geoffrey Michael,1,0,32,31
1657675626271,MATH 109,B02,083216,Ganzberger; Geoffrey Michael,2,0,32,30
1657675626271,MATH 109,B03,093479,Ganzberger; Geoffrey Michael,8,0,32,24
1657675632298,MATH 142A,A01,083219,Chow; Bennett,7,0,32,25
1657675632298,MATH 142A,A02,083220,Chow; Bennett,10,0,32,22
1657675632298,MATH 142A,A03,093480,Chow; Bennett,9,0,32,23
1657675632298,MATH 142A,B03,093481,Chow; Bennett,8,0,32,24
1657675632298,MATH 142A,B04,093558,Chow; Bennett,13,0,32,19
1657675632298,MATH 142A,B05,093559,Chow; Bennett,6,0,32,26
1657675638327,MATH 193A,A01,083224,Rotar; Vladimir,8,0,34,26
1657675638327,MATH 193A,A02,083225,Rotar; Vladimir,9,0,34,25
1657675638327,MATH 193A,A03,083781,Rotar; Vladimir,5,0,34,29
1657675638327,MATH 193A,A04,083782,Rotar; Vladimir,10,0,34,24
1657675638327,MATH 193A,A05,093482,Rotar; Vladimir,10,0,34,24
1657675644349,MATH 197,001,091859,McAuley; Julian John,9999,0,9999,0
1657675644349,MATH 197,002,095566,Kedlaya; Kiran S.,9997,0,9999,2
1657675644349,MATH 197,003,095567,Xiao; Ming,9999,0,9999,0
1657675644349,MATH 197,004,095571,Perols; Johan Lars,9998,0,9999,1
1657675651424,COGS 9,A01,083615,Shannon; Kyle Michael,9,0,75,66
1657675657446,COGS 11,A01,083617,Boyle; Mary E. T.,23,0,48,25
1657675663469,COGS 13,A01,083071,Bastos; Amalia Pinkusfeld,11,0,71,60
1657675669492,COGS 14A,A01,092681,Semenuks; Arturs,5,1,100,95
1657675675525,COGS 14B,A01,083073,Cheng; Tzu-Han,6,0,63,57
1657675681548,COGS 17,A01,092677,Semenuks; Arturs,6,0,81,75
1657675687571,COGS 100,A01,083619,Allen; Michael Gordon,17,0,70,53
1657675693595,COGS 101A,A01,083621,Davis; Joshua Daniel,9,0,68,59
1657675699620,COGS 101B,A01,091572,Allen; Michael Gordon,12,0,65,53
1657675705646,COGS 101C,A01,083625,Delgado; Tania,17,0,35,18
1657675711668,COGS 107A,A01,083627,Boyle; Mary E. T.,13,0,60,47
1657675717696,COGS 118A,A01,083075,Gupta; Anjum,21,0,76,55
1657675723728,CSE 3,A50,083646,Miranda; Gregory Joseph,24,0,50,26
1657675729761,CSE 8A,A50,083650,Miranda; Gregory Joseph,17,1,56,39
1657675735783,CSE 11,A01,083080,Cao; Yingjun,6,15,40,34
1657675741810,CSE 12,A01,083652,Krause-Levy; Sophia Louisa,28,1,120,92
1657675747832,CSE 15L,A01,083654,Morris; Justin Loren,9,0,50,41
1657675747832,CSE 15L,A02,083655,Morris; Justin Loren,9,0,50,41
1657675753855,CSE 20,A01,083657,Tran; Khoa Dang,39,0,80,41
1657675759879,CSE 21,A01,095574,Bach; Quang Tran,22,0,48,26
1657675765902,CSE 30,A01,083084,Eldon; John,6,0,80,74
1657675765902,CSE 30,B01,095061,Bhaskar; Nishant,9,0,50,41
1657675771926,CSE 100,A01,083659,Cao; Yingjun,5,4,70,65
1657675777952,CSE 134B,A01,083661,Powell; Thomas Allan,23,0,100,77
1657675783975,CSE 140,A01,083663,Gungor; Onat,15,0,85,70
1657675789998,CSE 140L,A01,083088,Eldon; John,22,0,100,78
1657675796025,CSE 175,A01,083665,Kumar; Rakesh,3,0,25,22
1657675802057,CSE 190,A00,092507,Dubnov; Shlomo,8,0,20,12
1657675808086,ECE 45,A01,083139,Congero; Spencer William,6,0,75,69
1657675814109,ECE 65,A50,083695,Saad; Andrew S,12,0,30,18
1657675814109,ECE 65,A51,095125,Saad; Andrew S,24,0,26,2
1657675820133,ECE 109,A01,091882,Touri; Behrouz,20,0,70,50
1657675826163,ECE 180,A00,083140,Abi Samra; Nicholas Camill,1,0,30,29
1657675826163,ECE 180,B00,083141,Abi Samra; Nicholas Camill,0,0,30,30
1657675832191,MATH 10A,A01,083735,Patchell; Gregory David,2,0,30,28
1657675832191,MATH 10A,A02,083736,Patchell; Gregory David,20,0,30,10
1657675832191,MATH 10A,A03,083737,Patchell; Gregory David,16,0,30,14
1657675838294,MATH 10B,A01,083207,Lim; Seonhee,8,0,34,26
1657675838294,MATH 10B,A02,083208,Lim; Seonhee,9,0,35,26
1657675838294,MATH 10B,A03,093472,Lim; Seonhee,7,0,34,27
1657675838294,MATH 10B,B01,083739,Sinha; Shubham,13,0,30,17
1657675844318,MATH 18,A01,083743,Cinel; Cameron Alexander,8,0,30,22
1657675844318,MATH 18,A02,083744,Cinel; Cameron Alexander,17,0,30,13
1657675844318,MATH 18,A03,083745,Cinel; Cameron Alexander,10,0,30,20
1657675844318,MATH 18,B01,083748,Rideout; David Porter,5,0,37,32
1657675844318,MATH 18,B02,083749,Rideout; David Porter,5,0,36,31
1657675844318,MATH 18,B03,083750,Rideout; David Porter,3,0,37,34
1657675844318,MATH 18,B04,083751,Rideout; David Porter,6,0,36,30
1657675844318,MATH 18,B05,093473,Rideout; David Porter,6,0,36,30
1657675844318,MATH 18,B06,093474,Rideout; David Porter,6,0,36,30
1657675850342,MATH 20A,A01,083754,Zheng; Zequn,14,0,40,26
1657675856369,MATH 20B,A01,083756,Briones; Jor-el Thomas Caparas,4,0,36,32
1657675856369,MATH 20B,A02,083757,Briones; Jor-el Thomas Caparas,1,0,36,35
1657675856369,MATH 20B,A03,093475,Briones; Jor-el Thomas Caparas,2,0,36,34
1657675862394,MATH 20C,A01,083760,Briones; Jor-el Thomas Caparas,1,0,35,34
1657675862394,MATH 20C,A02,083761,Briones; Jor-el Thomas Caparas,8,0,35,27
1657675862394,MATH 20C,A03,093476,Briones; Jor-el Thomas Caparas,0,1,36,36
1657675862394,MATH 20C,B01,083762,Bach; Quang Tran,1,0,30,29
1657675868424,MATH 20D,A01,083765,Tran; Brian Kha,5,0,30,25
1657675868424,MATH 20D,A02,083766,Tran; Brian Kha,5,0,30,25
1657675868424,MATH 20D,A03,083767,Tran; Brian Kha,5,0,30,25
1657675874453,MATH 20E,A01,083771,Ganguly; Soumya,9,0,32,23
1657675874453,MATH 20E,A02,083772,Ganguly; Soumya,6,0,32,26
1657675874453,MATH 20E,B01,083773,Ciotti; Benjamin,20,0,35,15
1657675874453,MATH 20E,B02,083774,Ciotti; Benjamin,18,0,35,17
1657675880484,MATH 103A,A01,083777,Greenfeld; Be'Eri,3,0,36,33
1657675880484,MATH 103A,A02,083778,Greenfeld; Be'Eri,5,0,36,31
1657675880484,MATH 103A,A03,093561,Greenfeld; Be'Eri,6,0,36,30
1657675880484,MATH 103A,B01,083779,Greenfeld; Be'Eri,7,0,36,29
1657675880484,MATH 103A,B02,083780,Greenfeld; Be'Eri,4,0,36,32
1657675880484,MATH 103A,B03,093562,Greenfeld; Be'Eri,3,0,36,33
1657675886508,MATH 105,A01,085443,Carter; Anne Toulson,15,0,35,20
1657675886508,MATH 105,A02,093477,Carter; Anne Toulson,20,0,35,15
1657675892533,MATH 109,A01,083213,Ganzberger; Geoffrey Michael,2,0,34,32
1657675892533,MATH 109,A02,083214,Ganzberger; Geoffrey Michael,4,0,34,30
1657675892533,MATH 109,A03,093478,Ganzberger; Geoffrey Michael,2,0,34,32
1657675892533,MATH 109,B01,083215,Ganzberger; Geoffrey Michael,1,0,32,31
1657675892533,MATH 109,B02,083216,Ganzberger; Geoffrey Michael,2,0,32,30
1657675892533,MATH 109,B03,093479,Ganzberger; Geoffrey Michael,8,0,32,24
1657675898557,MATH 142A,A01,083219,Chow; Bennett,7,0,32,25
1657675898557,MATH 142A,A02,083220,Chow; Bennett,10,0,32,22
1657675898557,MATH 142A,A03,093480,Chow; Bennett,9,0,32,23
1657675898557,MATH 142A,B03,093481,Chow; Bennett,8,0,32,24
1657675898557,MATH 142A,B04,093558,Chow; Bennett,13,0,32,19
1657675898557,MATH 142A,B05,093559,Chow; Bennett,6,0,32,26
1657675904581,MATH 193A,A01,083224,Rotar; Vladimir,8,0,34,26
1657675904581,MATH 193A,A02,083225,Rotar; Vladimir,9,0,34,25
1657675904581,MATH 193A,A03,083781,Rotar; Vladimir,5,0,34,29
1657675904581,MATH 193A,A04,083782,Rotar; Vladimir,10,0,34,24
1657675904581,MATH 193A,A05,093482,Rotar; Vladimir,10,0,34,24
1657675910604,MATH 197,001,091859,McAuley; Julian John,9999,0,9999,0
1657675910604,MATH 197,002,095566,Kedlaya; Kiran S.,9997,0,9999,2
1657675910604,MATH 197,003,095567,Xiao; Ming,9999,0,9999,0
1657675910604,MATH 197,004,095571,Perols; Johan Lars,9998,0,9999,1
1657675917663,COGS 9,A01,083615,Shannon; Kyle Michael,9,0,75,66
1657675923693,COGS 11,A01,083617,Boyle; Mary E. T.,23,0,48,25
1657675929723,COGS 13,A01,083071,Bastos; Amalia Pinkusfeld,11,0,71,60
1657675935745,COGS 14A,A01,092681,Semenuks; Arturs,5,1,100,95
1657675941768,COGS 14B,A01,083073,Cheng; Tzu-Han,6,0,63,57
1657675947795,COGS 17,A01,092677,Semenuks; Arturs,6,0,81,75
1657675953829,COGS 100,A01,083619,Allen; Michael Gordon,17,0,70,53
1657675959858,COGS 101A,A01,083621,Davis; Joshua Daniel,9,0,68,59
1657675965881,COGS 101B,A01,091572,Allen; Michael Gordon,12,0,65,53
1657675971905,COGS 101C,A01,083625,Delgado; Tania,17,0,35,18
1657675977931,COGS 107A,A01,083627,Boyle; Mary E. T.,13,0,60,47
1657675983955,COGS 118A,A01,083075,Gupta; Anjum,21,0,76,55
1657675989978,CSE 3,A50,083646,Miranda; Gregory Joseph,24,0,50,26
1657675996001,CSE 8A,A50,083650,Miranda; Gregory Joseph,17,1,56,39
1657676002024,CSE 11,A01,083080,Cao; Yingjun,6,15,40,34
1657676008056,CSE 12,A01,083652,Krause-Levy; Sophia Louisa,28,1,120,92
1657676014089,CSE 15L,A01,083654,Morris; Justin Loren,9,0,50,41
1657676014089,CSE 15L,A02,083655,Morris; Justin Loren,9,0,50,41
1657676020129,CSE 20,A01,083657,Tran; Khoa Dang,39,0,80,41
1657676026152,CSE 21,A01,095574,Bach; Quang Tran,22,0,48,26
1657676032176,CSE 30,A01,083084,Eldon; John,6,0,80,74
1657676032176,CSE 30,B01,095061,Bhaskar; Nishant,9,0,50,41
1657676038202,CSE 100,A01,083659,Cao; Yingjun,5,4,70,65
1657676044223,CSE 134B,A01,083661,Powell; Thomas Allan,23,0,100,77
1657676050246,CSE 140,A01,083663,Gungor; Onat,15,0,85,70
1657676056272,CSE 140L,A01,083088,Eldon; John,22,0,100,78
1657676062296,CSE 175,A01,083665,Kumar; Rakesh,3,0,25,22
1657676068323,CSE 190,A00,092507,Dubnov; Shlomo,8,0,20,12
1657676074347,ECE 45,A01,083139,Congero; Spencer William,6,0,75,69
1657676080374,ECE 65,A50,083695,Saad; Andrew S,12,0,30,18
1657676080374,ECE 65,A51,095125,Saad; Andrew S,24,0,26,2
1657676086407,ECE 109,A01,091882,Touri; Behrouz,20,0,70,50
1657676092433,ECE 180,A00,083140,Abi Samra; Nicholas Camill,1,0,30,29
1657676092433,ECE 180,B00,083141,Abi Samra; Nicholas Camill,0,0,30,30
1657676098464,MATH 10A,A01,083735,Patchell; Gregory David,2,0,30,28
1657676098464,MATH 10A,A02,083736,Patchell; Gregory David,20,0,30,10
1657676098464,MATH 10A,A03,083737,Patchell; Gregory David,16,0,30,14
1657676104492,MATH 10B,A01,083207,Lim; Seonhee,8,0,34,26
1657676104492,MATH 10B,A02,083208,Lim; Seonhee,9,0,35,26
1657676104492,MATH 10B,A03,093472,Lim; Seonhee,7,0,34,27
1657676104492,MATH 10B,B01,083739,Sinha; Shubham,13,0,30,17
1657676110522,MATH 18,A01,083743,Cinel; Cameron Alexander,8,0,30,22
1657676110522,MATH 18,A02,083744,Cinel; Cameron Alexander,17,0,30,13
1657676110522,MATH 18,A03,083745,Cinel; Cameron Alexander,10,0,30,20
1657676110522,MATH 18,B01,083748,Rideout; David Porter,5,0,37,32
1657676110522,MATH 18,B02,083749,Rideout; David Porter,5,0,36,31
1657676110522,MATH 18,B03,083750,Rideout; David Porter,3,0,37,34
1657676110522,MATH 18,B04,083751,Rideout; David Porter,6,0,36,30
1657676110522,MATH 18,B05,093473,Rideout; David Porter,6,0,36,30
1657676110522,MATH 18,B06,093474,Rideout; David Porter,6,0,36,30
1657676116546,MATH 20A,A01,083754,Zheng; Zequn,14,0,40,26
1657676122573,MATH 20B,A01,083756,Briones; Jor-el Thomas Caparas,4,0,36,32
1657676122573,MATH 20B,A02,083757,Briones; Jor-el Thomas Caparas,1,0,36,35
1657676122573,MATH 20B,A03,093475,Briones; Jor-el Thomas Caparas,2,0,36,34
1657676128596,MATH 20C,A01,083760,Briones; Jor-el Thomas Caparas,1,0,35,34
1657676128596,MATH 20C,A02,083761,Briones; Jor-el Thomas Caparas,8,0,35,27
1657676128596,MATH 20C,A03,093476,Briones; Jor-el Thomas Caparas,0,1,36,36
1657676128596,MATH 20C,B01,083762,Bach; Quang Tran,1,0,30,29
1657676134622,MATH 20D,A01,083765,Tran; Brian Kha,5,0,30,25
1657676134622,MATH 20D,A02,083766,Tran; Brian Kha,5,0,30,25
1657676134622,MATH 20D,A03,083767,Tran; Brian Kha,5,0,30,25
1657676140649,MATH 20E,A01,083771,Ganguly; Soumya,9,0,32,23
1657676140649,MATH 20E,A02,083772,Ganguly; Soumya,6,0,32,26
1657676140649,MATH 20E,B01,083773,Ciotti; Benjamin,20,0,35,15
1657676140649,MATH 20E,B02,083774,Ciotti; Benjamin,18,0,35,17
1657676146677,MATH 103A,A01,083777,Greenfeld; Be'Eri,3,0,36,33
1657676146677,MATH 103A,A02,083778,Greenfeld; Be'Eri,5,0,36,31
1657676146677,MATH 103A,A03,093561,Greenfeld; Be'Eri,6,0,36,30
1657676146677,MATH 103A,B01,083779,Greenfeld; Be'Eri,7,0,36,29
1657676146677,MATH 103A,B02,083780,Greenfeld; Be'Eri,4,0,36,32
1657676146677,MATH 103A,B03,093562,Greenfeld; Be'Eri,3,0,36,33
1657676152698,MATH 105,A01,085443,Carter; Anne Toulson,15,0,35,20
1657676152698,MATH 105,A02,093477,Carter; Anne Toulson,20,0,35,15
1657676158722,MATH 109,A01,083213,Ganzberger; Geoffrey Michael,2,0,34,32
1657676158722,MATH 109,A02,083214,Ganzberger; Geoffrey Michael,4,0,34,30
1657676158722,MATH 109,A03,093478,Ganzberger; Geoffrey Michael,2,0,34,32
1657676158722,MATH 109,B01,083215,Ganzberger; Geoffrey Michael,1,0,32,31
1657676158722,MATH 109,B02,083216,Ganzberger; Geoffrey Michael,2,0,32,30
1657676158722,MATH 109,B03,093479,Ganzberger; Geoffrey Michael,8,0,32,24
1657676164744,MATH 142A,A01,083219,Chow; Bennett,7,0,32,25
1657676164744,MATH 142A,A02,083220,Chow; Bennett,10,0,32,22
1657676164744,MATH 142A,A03,093480,Chow; Bennett,9,0,32,23
1657676164744,MATH 142A,B03,093481,Chow; Bennett,8,0,32,24
1657676164744,MATH 142A,B04,093558,Chow; Bennett,13,0,32,19
1657676164744,MATH 142A,B05,093559,Chow; Bennett,6,0,32,26
1657676170771,MATH 193A,A01,083224,Rotar; Vladimir,8,0,34,26
1657676170771,MATH 193A,A02,083225,Rotar; Vladimir,9,0,34,25
1657676170771,MATH 193A,A03,083781,Rotar; Vladimir,5,0,34,29
1657676170771,MATH 193A,A04,083782,Rotar; Vladimir,10,0,34,24
1657676170771,MATH 193A,A05,093482,Rotar; Vladimir,10,0,34,24
1657676176796,MATH 197,001,091859,McAuley; Julian John,9999,0,9999,0
1657676176796,MATH 197,002,095566,Kedlaya; Kiran S.,9997,0,9999,2
1657676176796,MATH 197,003,095567,Xiao; Ming,9999,0,9999,0
1657676176796,MATH 197,004,095571,Perols; Johan Lars,9998,0,9999,1
1657676183849,COGS 9,A01,083615,Shannon; Kyle Michael,9,0,75,66
1657676189873,COGS 11,A01,083617,Boyle; Mary E. T.,23,0,48,25
1657676195901,COGS 13,A01,083071,Bastos; Amalia Pinkusfeld,11,0,71,60
1657676201928,COGS 14A,A01,092681,Semenuks; Arturs,5,1,100,95
1657676207958,COGS 14B,A01,083073,Cheng; Tzu-Han,6,0,63,57
1657676213986,COGS 17,A01,092677,Semenuks; Arturs,6,0,81,75
1657676220009,COGS 100,A01,083619,Allen; Michael Gordon,17,0,70,53
1657676226043,COGS 101A,A01,083621,Davis; Joshua Daniel,9,0,68,59
1657676232067,COGS 101B,A01,091572,Allen; Michael Gordon,12,0,65,53
1657676238089,COGS 101C,A01,083625,Delgado; Tania,17,0,35,18
1657676244112,COGS 107A,A01,083627,Boyle; Mary E. T.,13,0,60,47
1657676250138,COGS 118A,A01,083075,Gupta; Anjum,21,0,76,55
1657676256162,CSE 3,A50,083646,Miranda; Gregory Joseph,24,0,50,26
1657676262185,CSE 8A,A50,083650,Miranda; Gregory Joseph,17,1,56,39
1657676268217,CSE 11,A01,083080,Cao; Yingjun,6,15,40,34
1657676274239,CSE 12,A01,083652,Krause-Levy; Sophia Louisa,28,1,120,92
1657676280263,CSE 15L,A01,083654,Morris; Justin Loren,9,0,50,41
1657676280263,CSE 15L,A02,083655,Morris; Justin Loren,9,0,50,41
1657676286290,CSE 20,A01,083657,Tran; Khoa Dang,39,0,80,41
1657676292317,CSE 21,A01,095574,Bach; Quang Tran,22,0,48,26
1657676298346,CSE 30,A01,083084,Eldon; John,6,0,80,74
1657676298346,CSE 30,B01,095061,Bhaskar; Nishant,9,0,50,41
1657676304369,CSE 100,A01,083659,Cao; Yingjun,5,4,70,65
1657676310394,CSE 134B,A01,083661,Powell; Thomas Allan,23,0,100,77
1657676316420,CSE 140,A01,083663,Gungor; Onat,15,0,85,70
1657676322454,CSE 140L,A01,083088,Eldon; John,22,0,100,78
1657676328477,CSE 175,A01,083665,Kumar; Rakesh,3,0,25,22
1657676334498,CSE 190,A00,092507,Dubnov; Shlomo,8,0,20,12
1657676340532,ECE 45,A01,083139,Congero; Spencer William,6,0,75,69
1657676346555,ECE 65,A50,083695,Saad; Andrew S,12,0,30,18
1657676346555,ECE 65,A51,095125,Saad; Andrew S,24,0,26,2
1657676352578,ECE 109,A01,091882,Touri; Behrouz,20,0,70,50
1657676358601,ECE 180,A00,083140,Abi Samra; Nicholas Camill,1,0,30,29
1657676358601,ECE 180,B00,083141,Abi Samra; Nicholas Camill,0,0,30,30
1657676364625,MATH 10A,A01,083735,Patchell; Gregory David,2,0,30,28
1657676364625,MATH 10A,A02,083736,Patchell; Gregory David,20,0,30,10
1657676364625,MATH 10A,A03,083737,Patchell; Gregory David,16,0,30,14
1657676370650,MATH 10B,A01,083207,Lim; Seonhee,8,0,34,26
1657676370650,MATH 10B,A02,083208,Lim; Seonhee,9,0,35,26
1657676370650,MATH 10B,A03,093472,Lim; Seonhee,7,0,34,27
1657676370650,MATH 10B,B01,083739,Sinha; Shubham,13,0,30,17
1657676376688,MATH 18,A01,083743,Cinel; Cameron Alexander,8,0,30,22
1657676376688,MATH 18,A02,083744,Cinel; Cameron Alexander,17,0,30,13
1657676376688,MATH 18,A03,083745,Cinel; Cameron Alexander,10,0,30,20
1657676376688,MATH 18,B01,083748,Rideout; David Porter,5,0,37,32
1657676376688,MATH 18,B02,083749,Rideout; David Porter,5,0,36,31
1657676376688,MATH 18,B03,083750,Rideout; David Porter,3,0,37,34
1657676376688,MATH 18,B04,083751,Rideout; David Porter,6,0,36,30
1657676376688,MATH 18,B05,093473,Rideout; David Porter,6,0,36,30
1657676376688,MATH 18,B06,093474,Rideout; David Porter,6,0,36,30
1657676382714,MATH 20A,A01,083754,Zheng; Zequn,14,0,40,26
1657676388741,MATH 20B,A01,083756,Briones; Jor-el Thomas Caparas,4,0,36,32
1657676388741,MATH 20B,A02,083757,Briones; Jor-el Thomas Caparas,1,0,36,35
1657676388741,MATH 20B,A03,093475,Briones; Jor-el Thomas Caparas,2,0,36,34
1657676394764,MATH 20C,A01,083760,Briones; Jor-el Thomas Caparas,1,0,35,34
1657676394764,MATH 20C,A02,083761,Briones; Jor-el Thomas Caparas,8,0,35,27
1657676394764,MATH 20C,A03,093476,Briones; Jor-el Thomas Caparas,0,1,36,36
1657676394764,MATH 20C,B01,083762,Bach; Quang Tran,1,0,30,29
1657676400796,MATH 20D,A01,083765,Tran; Brian Kha,5,0,30,25
1657676400796,MATH 20D,A02,083766,Tran; Brian Kha,5,0,30,25
1657676400796,MATH 20D,A03,083767,Tran; Brian Kha,5,0,30,25
1657676406819,MATH 20E,A01,083771,Ganguly; Soumya,9,0,32,23
1657676406819,MATH 20E,A02,083772,Ganguly; Soumya,6,0,32,26
1657676406819,MATH 20E,B01,083773,Ciotti; Benjamin,20,0,35,15
1657676406819,MATH 20E,B02,083774,Ciotti; Benjamin,18,0,35,17
1657676412847,MATH 103A,A01,083777,Greenfeld; Be'Eri,3,0,36,33
1657676412847,MATH 103A,A02,083778,Greenfeld; Be'Eri,5,0,36,31
1657676412847,MATH 103A,A03,093561,Greenfeld; Be'Eri,6,0,36,30
1657676412847,MATH 103A,B01,083779,Greenfeld; Be'Eri,7,0,36,29
1657676412847,MATH 103A,B02,083780,Greenfeld; Be'Eri,4,0,36,32
1657676412847,MATH 103A,B03,093562,Greenfeld; Be'Eri,3,0,36,33
1657676418873,MATH 105,A01,085443,Carter; Anne Toulson,15,0,35,20
1657676418873,MATH 105,A02,093477,Carter; Anne Toulson,20,0,35,15
1657676424903,MATH 109,A01,083213,Ganzberger; Geoffrey Michael,2,0,34,32
1657676424903,MATH 109,A02,083214,Ganzberger; Geoffrey Michael,4,0,34,30
1657676424903,MATH 109,A03,093478,Ganzberger; Geoffrey Michael,2,0,34,32
1657676424903,MATH 109,B01,083215,Ganzberger; Geoffrey Michael,1,0,32,31
1657676424903,MATH 109,B02,083216,Ganzberger; Geoffrey Michael,2,0,32,30
1657676424903,MATH 109,B03,093479,Ganzberger; Geoffrey Michael,8,0,32,24
1657676430927,MATH 142A,A01,083219,Chow; Bennett,7,0,32,25
1657676430927,MATH 142A,A02,083220,Chow; Bennett,10,0,32,22
1657676430927,MATH 142A,A03,093480,Chow; Bennett,9,0,32,23
1657676430927,MATH 142A,B03,093481,Chow; Bennett,8,0,32,24
1657676430927,MATH 142A,B04,093558,Chow; Bennett,13,0,32,19
1657676430927,MATH 142A,B05,093559,Chow; Bennett,6,0,32,26
1657676437022,MATH 193A,A01,083224,Rotar; Vladimir,8,0,34,26
1657676437022,MATH 193A,A02,083225,Rotar; Vladimir,9,0,34,25
1657676437022,MATH 193A,A03,083781,Rotar; Vladimir,5,0,34,29
1657676437022,MATH 193A,A04,083782,Rotar; Vladimir,10,0,34,24
1657676437022,MATH 193A,A05,093482,Rotar; Vladimir,10,0,34,24
1657676443048,MATH 197,001,091859,McAuley; Julian John,9999,0,9999,0
1657676443048,MATH 197,002,095566,Kedlaya; Kiran S.,9997,0,9999,2
1657676443048,MATH 197,003,095567,Xiao; Ming,9999,0,9999,0
1657676443048,MATH 197,004,095571,Perols; Johan Lars,9998,0,9999,1
1657676450104,COGS 9,A01,083615,Shannon; Kyle Michael,9,0,75,66
1657676456130,COGS 11,A01,083617,Boyle; Mary E. T.,23,0,48,25
1657676462158,COGS 13,A01,083071,Bastos; Amalia Pinkusfeld,11,0,71,60
1657676468187,COGS 14A,A01,092681,Semenuks; Arturs,5,1,100,95
1657676474213,COGS 14B,A01,083073,Cheng; Tzu-Han,6,0,63,57
1657676480236,COGS 17,A01,092677,Semenuks; Arturs,6,0,81,75
1657676486268,COGS 100,A01,083619,Allen; Michael Gordon,17,0,70,53
1657676492296,COGS 101A,A01,083621,Davis; Joshua Daniel,9,0,68,59
1657676498320,COGS 101B,A01,091572,Allen; Michael Gordon,12,0,65,53
1657676504346,COGS 101C,A01,083625,Delgado; Tania,17,0,35,18
1657676510368,COGS 107A,A01,083627,Boyle; Mary E. T.,13,0,60,47
1657676516391,COGS 118A,A01,083075,Gupta; Anjum,21,0,76,55
1657676522414,CSE 3,A50,083646,Miranda; Gregory Joseph,24,0,50,26
1657676528442,CSE 8A,A50,083650,Miranda; Gregory Joseph,17,1,56,39
1657676534465,CSE 11,A01,083080,Cao; Yingjun,6,15,40,34
1657676540496,CSE 12,A01,083652,Krause-Levy; Sophia Louisa,28,1,120,92
1657676546522,CSE 15L,A01,083654,Morris; Justin Loren,9,0,50,41
1657676546522,CSE 15L,A02,083655,Morris; Justin Loren,9,0,50,41
1657676552552,CSE 20,A01,083657,Tran; Khoa Dang,39,0,80,41
1657676558578,CSE 21,A01,095574,Bach; Quang Tran,22,0,48,26
1657676564601,CSE 30,A01,083084,Eldon; John,6,0,80,74
1657676564601,CSE 30,B01,095061,Bhaskar; Nishant,9,0,50,41
1657676570624,CSE 100,A01,083659,Cao; Yingjun,5,4,70,65
1657676576646,CSE 134B,A01,083661,Powell; Thomas Allan,23,0,100,77
1657676582670,CSE 140,A01,083663,Gungor; Onat,15,0,85,70
1657676588692,CSE 140L,A01,083088,Eldon; John,22,0,100,78
1657676594727,CSE 175,A01,083665,Kumar; Rakesh,3,0,25,22
1657676600751,CSE 190,A00,092507,Dubnov; Shlomo,8,0,20,12
1657676606772,ECE 45,A01,083139,Congero; Spencer William,6,0,75,69
1657676612796,ECE 65,A50,083695,Saad; Andrew S,12,0,30,18
1657676612796,ECE 65,A51,095125,Saad; Andrew S,24,0,26,2
1657676618819,ECE 109,A01,091882,Touri; Behrouz,20,0,70,50
1657676624845,ECE 180,A00,083140,Abi Samra; Nicholas Camill,1,0,30,29
1657676624845,ECE 180,B00,083141,Abi Samra; Nicholas Camill,0,0,30,30
1657676630877,MATH 10A,A01,083735,Patchell; Gregory David,2,0,30,28
1657676630877,MATH 10A,A02,083736,Patchell; Gregory David,20,0,30,10
1657676630877,MATH 10A,A03,083737,Patchell; Gregory David,16,0,30,14
1657676636901,MATH 10B,A01,083207,Lim; Seonhee,8,0,34,26
1657676636901,MATH 10B,A02,083208,Lim; Seonhee,9,0,35,26
1657676636901,MATH 10B,A03,093472,Lim; Seonhee,7,0,34,27
1657676636901,MATH 10B,B01,083739,Sinha; Shubham,13,0,30,17
1657676642931,MATH 18,A01,083743,Cinel; Cameron Alexander,8,0,30,22
1657676642931,MATH 18,A02,083744,Cinel; Cameron Alexander,17,0,30,13
1657676642931,MATH 18,A03,083745,Cinel; Cameron Alexander,10,0,30,20
1657676642931,MATH 18,B01,083748,Rideout; David Porter,5,0,37,32
1657676642931,MATH 18,B02,083749,Rideout; David Porter,5,0,36,31
1657676642931,MATH 18,B03,083750,Rideout; David Porter,3,0,37,34
1657676642931,MATH 18,B04,083751,Rideout; David Porter,6,0,36,30
1657676642931,MATH 18,B05,093473,Rideout; David Porter,6,0,36,30
1657676642931,MATH 18,B06,093474,Rideout; David Porter,6,0,36,30
1657676648958,MATH 20A,A01,083754,Zheng; Zequn,14,0,40,26
1657676654981,MATH 20B,A01,083756,Briones; Jor-el Thomas Caparas,4,0,36,32
1657676654981,MATH 20B,A02,083757,Briones; Jor-el Thomas Caparas,1,0,36,35
1657676654981,MATH 20B,A03,093475,Briones; Jor-el Thomas Caparas,2,0,36,34
1657676661010,MATH 20C,A01,083760,Briones; Jor-el Thomas Caparas,1,0,35,34
1657676661010,MATH 20C,A02,083761,Briones; Jor-el Thomas Caparas,8,0,35,27
1657676661010,MATH 20C,A03,093476,Briones; Jor-el Thomas Caparas,0,1,36,36
1657676661010,MATH 20C,B01,083762,Bach; Quang Tran,1,0,30,29
1657676667033,MATH 20D,A01,083765,Tran; Brian Kha,5,0,30,25
1657676667033,MATH 20D,A02,083766,Tran; Brian Kha,5,0,30,25
1657676667033,MATH 20D,A03,083767,Tran; Brian Kha,5,0,30,25
1657676673060,MATH 20E,A01,083771,Ganguly; Soumya,9,0,32,23
1657676673060,MATH 20E,A02,083772,Ganguly; Soumya,6,0,32,26
1657676673060,MATH 20E,B01,083773,Ciotti; Benjamin,20,0,35,15
1657676673060,MATH 20E,B02,083774,Ciotti; Benjamin,18,0,35,17
1657676679091,MATH 103A,A01,083777,Greenfeld; Be'Eri,3,0,36,33
1657676679091,MATH 103A,A02,083778,Greenfeld; Be'Eri,5,0,36,31
1657676679091,MATH 103A,A03,093561,Greenfeld; Be'Eri,6,0,36,30
1657676679091,MATH 103A,B01,083779,Greenfeld; Be'Eri,7,0,36,29
1657676679091,MATH 103A,B02,083780,Greenfeld; Be'Eri,4,0,36,32
1657676679091,MATH 103A,B03,093562,Greenfeld; Be'Eri,3,0,36,33
1657676685116,MATH 105,A01,085443,Carter; Anne Toulson,15,0,35,20
1657676685116,MATH 105,A02,093477,Carter; Anne Toulson,20,0,35,15
1657676691144,MATH 109,A01,083213,Ganzberger; Geoffrey Michael,2,0,34,32
1657676691144,MATH 109,A02,083214,Ganzberger; Geoffrey Michael,4,0,34,30
1657676691144,MATH 109,A03,093478,Ganzberger; Geoffrey Michael,2,0,34,32
1657676691144,MATH 109,B01,083215,Ganzberger; Geoffrey Michael,1,0,32,31
1657676691144,MATH 109,B02,083216,Ganzberger; Geoffrey Michael,2,0,32,30
1657676691144,MATH 109,B03,093479,Ganzberger; Geoffrey Michael,8,0,32,24
1657676697172,MATH 142A,A01,083219,Chow; Bennett,7,0,32,25
1657676697172,MATH 142A,A02,083220,Chow; Bennett,10,0,32,22
1657676697172,MATH 142A,A03,093480,Chow; Bennett,9,0,32,23
1657676697172,MATH 142A,B03,093481,Chow; Bennett,8,0,32,24
1657676697172,MATH 142A,B04,093558,Chow; Bennett,13,0,32,19
1657676697172,MATH 142A,B05,093559,Chow; Bennett,6,0,32,26
1657676703201,MATH 193A,A01,083224,Rotar; Vladimir,8,0,34,26
1657676703201,MATH 193A,A02,083225,Rotar; Vladimir,9,0,34,25
1657676703201,MATH 193A,A03,083781,Rotar; Vladimir,5,0,34,29
1657676703201,MATH 193A,A04,083782,Rotar; Vladimir,10,0,34,24
1657676703201,MATH 193A,A05,093482,Rotar; Vladimir,10,0,34,24
1657676709226,MATH 197,001,091859,McAuley; Julian John,9999,0,9999,0
1657676709226,MATH 197,002,095566,Kedlaya; Kiran S.,9997,0,9999,2
1657676709226,MATH 197,003,095567,Xiao; Ming,9999,0,9999,0
1657676709226,MATH 197,004,095571,Perols; Johan Lars,9998,0,9999,1
1657676716289,COGS 9,A01,083615,Shannon; Kyle Michael,9,0,75,66
1657676722312,COGS 11,A01,083617,Boyle; Mary E. T.,23,0,48,25
1657676728337,COGS 13,A01,083071,Bastos; Amalia Pinkusfeld,11,0,71,60
1657676734360,COGS 14A,A01,092681,Semenuks; Arturs,5,1,100,95
1657676740391,COGS 14B,A01,083073,Cheng; Tzu-Han,6,0,63,57
1657676746422,COGS 17,A01,092677,Semenuks; Arturs,6,0,81,75
1657676752449,COGS 100,A01,083619,Allen; Michael Gordon,17,0,70,53
1657676758474,COGS 101A,A01,083621,Davis; Joshua Daniel,9,0,68,59
1657676764497,COGS 101B,A01,091572,Allen; Michael Gordon,12,0,65,53
1657676770522,COGS 101C,A01,083625,Delgado; Tania,17,0,35,18
1657676776544,COGS 107A,A01,083627,Boyle; Mary E. T.,13,0,60,47
1657676782573,COGS 118A,A01,083075,Gupta; Anjum,21,0,76,55
1657676788601,CSE 3,A50,083646,Miranda; Gregory Joseph,24,0,50,26
1657676794631,CSE 8A,A50,083650,Miranda; Gregory Joseph,17,1,56,39
1657676800654,CSE 11,A01,083080,Cao; Yingjun,6,15,40,34
1657676806681,CSE 12,A01,083652,Krause-Levy; Sophia Louisa,28,1,120,92
1657676812708,CSE 15L,A01,083654,Morris; Justin Loren,9,0,50,41
1657676812708,CSE 15L,A02,083655,Morris; Justin Loren,9,0,50,41
1657676818735,CSE 20,A01,083657,Tran; Khoa Dang,39,0,80,41
1657676824759,CSE 21,A01,095574,Bach; Quang Tran,22,0,48,26
1657676830782,CSE 30,A01,083084,Eldon; John,6,0,80,74
1657676830782,CSE 30,B01,095061,Bhaskar; Nishant,9,0,50,41
1657676836816,CSE 100,A01,083659,Cao; Yingjun,5,4,70,65
1657676842844,CSE 134B,A01,083661,Powell; Thomas Allan,23,0,100,77
1657676848871,CSE 140,A01,083663,Gungor; Onat,15,0,85,70
1657676854898,CSE 140L,A01,083088,Eldon; John,22,0,100,78
1657676860923,CSE 175,A01,083665,Kumar; Rakesh,3,0,25,22
1657676866945,CSE 190,A00,092507,Dubnov; Shlomo,8,0,20,12
1657676872979,ECE 45,A01,083139,Congero; Spencer William,6,0,75,69
1657676879001,ECE 65,A50,083695,Saad; Andrew S,12,0,30,18
1657676879001,ECE 65,A51,095125,Saad; Andrew S,24,0,26,2
1657676885023,ECE 109,A01,091882,Touri; Behrouz,20,0,70,50
1657676891046,ECE 180,A00,083140,Abi Samra; Nicholas Camill,1,0,30,29
1657676891046,ECE 180,B00,083141,Abi Samra; Nicholas Camill,0,0,30,30
1657676897073,MATH 10A,A01,083735,Patchell; Gregory David,2,0,30,28
1657676897073,MATH 10A,A02,083736,Patchell; Gregory David,20,0,30,10
1657676897073,MATH 10A,A03,083737,Patchell; Gregory David,16,0,30,14
1657676903103,MATH 10B,A01,083207,Lim; Seonhee,8,0,34,26
1657676903103,MATH 10B,A02,083208,Lim; Seonhee,9,0,35,26
1657676903103,MATH 10B,A03,093472,Lim; Seonhee,7,0,34,27
1657676903103,MATH 10B,B01,083739,Sinha; Shubham,13,0,30,17
1657676909141,MATH 18,A01,083743,Cinel; Cameron Alexander,8,0,30,22
1657676909141,MATH 18,A02,083744,Cinel; Cameron Alexander,17,0,30,13
1657676909141,MATH 18,A03,083745,Cinel; Cameron Alexander,10,0,30,20
1657676909141,MATH 18,B01,083748,Rideout; David Porter,5,0,37,32
1657676909141,MATH 18,B02,083749,Rideout; David Porter,5,0,36,31
1657676909141,MATH 18,B03,083750,Rideout; David Porter,3,0,37,34
1657676909141,MATH 18,B04,083751,Rideout; David Porter,6,0,36,30
1657676909141,MATH 18,B05,093473,Rideout; David Porter,6,0,36,30
1657676909141,MATH 18,B06,093474,Rideout; David Porter,6,0,36,30
1657676915167,MATH 20A,A01,083754,Zheng; Zequn,14,0,40,26
1657676921190,MATH 20B,A01,083756,Briones; Jor-el Thomas Caparas,4,0,36,32
1657676921190,MATH 20B,A02,083757,Briones; Jor-el Thomas Caparas,1,0,36,35
1657676921190,MATH 20B,A03,093475,Briones; Jor-el Thomas Caparas,2,0,36,34
1657676927212,MATH 20C,A01,083760,Briones; Jor-el Thomas Caparas,1,0,35,34
1657676927212,MATH 20C,A02,083761,Briones; Jor-el Thomas Caparas,8,0,35,27
1657676927212,MATH 20C,A03,093476,Briones; Jor-el Thomas Caparas,0,1,36,36
1657676927212,MATH 20C,B01,083762,Bach; Quang Tran,1,0,30,29
1657676933242,MATH 20D,A01,083765,Tran; Brian Kha,5,0,30,25
1657676933242,MATH 20D,A02,083766,Tran; Brian Kha,5,0,30,25
1657676933242,MATH 20D,A03,083767,Tran; Brian Kha,5,0,30,25
1657676939273,MATH 20E,A01,083771,Ganguly; Soumya,9,0,32,23
1657676939273,MATH 20E,A02,083772,Ganguly; Soumya,6,0,32,26
1657676939273,MATH 20E,B01,083773,Ciotti; Benjamin,20,0,35,15
1657676939273,MATH 20E,B02,083774,Ciotti; Benjamin,18,0,35,17
1657676945296,MATH 103A,A01,083777,Greenfeld; Be'Eri,3,0,36,33
1657676945296,MATH 103A,A02,083778,Greenfeld; Be'Eri,5,0,36,31
1657676945296,MATH 103A,A03,093561,Greenfeld; Be'Eri,6,0,36,30
1657676945296,MATH 103A,B01,083779,Greenfeld; Be'Eri,7,0,36,29
1657676945296,MATH 103A,B02,083780,Greenfeld; Be'Eri,4,0,36,32
1657676945296,MATH 103A,B03,093562,Greenfeld; Be'Eri,3,0,36,33
1657676951321,MATH 105,A01,085443,Carter; Anne Toulson,15,0,35,20
1657676951321,MATH 105,A02,093477,Carter; Anne Toulson,20,0,35,15
1657676957344,MATH 109,A01,083213,Ganzberger; Geoffrey Michael,2,0,34,32
1657676957344,MATH 109,A02,083214,Ganzberger; Geoffrey Michael,4,0,34,30
1657676957344,MATH 109,A03,093478,Ganzberger; Geoffrey Michael,2,0,34,32
1657676957344,MATH 109,B01,083215,Ganzberger; Geoffrey Michael,1,0,32,31
1657676957344,MATH 109,B02,083216,Ganzberger; Geoffrey Michael,2,0,32,30
1657676957344,MATH 109,B03,093479,Ganzberger; Geoffrey Michael,8,0,32,24
1657676963368,MATH 142A,A01,083219,Chow; Bennett,7,0,32,25
1657676963368,MATH 142A,A02,083220,Chow; Bennett,10,0,32,22
1657676963368,MATH 142A,A03,093480,Chow; Bennett,9,0,32,23
1657676963368,MATH 142A,B03,093481,Chow; Bennett,8,0,32,24
1657676963368,MATH 142A,B04,093558,Chow; Bennett,13,0,32,19
1657676963368,MATH 142A,B05,093559,Chow; Bennett,6,0,32,26
1657676969392,MATH 193A,A01,083224,Rotar; Vladimir,8,0,34,26
1657676969392,MATH 193A,A02,083225,Rotar; Vladimir,9,0,34,25
1657676969392,MATH 193A,A03,083781,Rotar; Vladimir,5,0,34,29
1657676969392,MATH 193A,A04,083782,Rotar; Vladimir,10,0,34,24
1657676969392,MATH 193A,A05,093482,Rotar; Vladimir,10,0,34,24
1657676975418,MATH 197,001,091859,McAuley; Julian John,9999,0,9999,0
1657676975418,MATH 197,002,095566,Kedlaya; Kiran S.,9997,0,9999,2
1657676975418,MATH 197,003,095567,Xiao; Ming,9999,0,9999,0
1657676975418,MATH 197,004,095571,Perols; Johan Lars,9998,0,9999,1
1657676982474,COGS 9,A01,083615,Shannon; Kyle Michael,9,0,75,66
1657676988498,COGS 11,A01,083617,Boyle; Mary E. T.,23,0,48,25
1657676994520,COGS 13,A01,083071,Bastos; Amalia Pinkusfeld,11,0,71,60
1657677000547,COGS 14A,A01,092681,Semenuks; Arturs,5,1,100,95
1657677006569,COGS 14B,A01,083073,Cheng; Tzu-Han,6,0,63,57
1657677012592,COGS 17,A01,092677,Semenuks; Arturs,6,0,81,75
1657677018615,COGS 100,A01,083619,Allen; Michael Gordon,17,0,70,53
1657677024641,COGS 101A,A01,083621,Davis; Joshua Daniel,9,0,68,59
1657677030759,COGS 101B,A01,091572,Allen; Michael Gordon,12,0,65,53
1657677036781,COGS 101C,A01,083625,Delgado; Tania,17,0,35,18
1657677042813,COGS 107A,A01,083627,Boyle; Mary E. T.,13,0,60,47
1657677048838,COGS 118A,A01,083075,Gupta; Anjum,21,0,76,55
1657677054865,CSE 3,A50,083646,Miranda; Gregory Joseph,24,0,50,26
1657677060890,CSE 8A,A50,083650,Miranda; Gregory Joseph,17,1,56,39
1657677066917,CSE 11,A01,083080,Cao; Yingjun,6,15,40,34
1657677072944,CSE 12,A01,083652,Krause-Levy; Sophia Louisa,28,1,120,92
1657677078967,CSE 15L,A01,083654,Morris; Justin Loren,9,0,50,41
1657677078967,CSE 15L,A02,083655,Morris; Justin Loren,9,0,50,41
1657677084989,CSE 20,A01,083657,Tran; Khoa Dang,39,0,80,41
1657677091021,CSE 21,A01,095574,Bach; Quang Tran,22,0,48,26
1657677097058,CSE 30,A01,083084,Eldon; John,6,0,80,74
1657677097058,CSE 30,B01,095061,Bhaskar; Nishant,9,0,50,41
1657677103079,CSE 100,A01,083659,Cao; Yingjun,5,4,70,65
1657677109111,CSE 134B,A01,083661,Powell; Thomas Allan,23,0,100,77
1657677115134,CSE 140,A01,083663,Gungor; Onat,15,0,85,70
1657677121156,CSE 140L,A01,083088,Eldon; John,22,0,100,78
1657677127178,CSE 175,A01,083665,Kumar; Rakesh,3,0,25,22
1657677133210,CSE 190,A00,092507,Dubnov; Shlomo,8,0,20,12
1657677139237,ECE 45,A01,083139,Congero; Spencer William,6,0,75,69
1657677145276,ECE 65,A50,083695,Saad; Andrew S,12,0,30,18
1657677145276,ECE 65,A51,095125,Saad; Andrew S,24,0,26,2
1657677151300,ECE 109,A01,091882,Touri; Behrouz,20,0,70,50
1657677157326,ECE 180,A00,083140,Abi Samra; Nicholas Camill,1,0,30,29
1657677157326,ECE 180,B00,083141,Abi Samra; Nicholas Camill,0,0,30,30
1657677163349,MATH 10A,A01,083735,Patchell; Gregory David,2,0,30,28
1657677163349,MATH 10A,A02,083736,Patchell; Gregory David,20,0,30,10
1657677163349,MATH 10A,A03,083737,Patchell; Gregory David,16,0,30,14
1657677169371,MATH 10B,A01,083207,Lim; Seonhee,8,0,34,26
1657677169371,MATH 10B,A02,083208,Lim; Seonhee,9,0,35,26
1657677169371,MATH 10B,A03,093472,Lim; Seonhee,7,0,34,27
1657677169371,MATH 10B,B01,083739,Sinha; Shubham,13,0,30,17
1657677175397,MATH 18,A01,083743,Cinel; Cameron Alexander,8,0,30,22
1657677175397,MATH 18,A02,083744,Cinel; Cameron Alexander,17,0,30,13
1657677175397,MATH 18,A03,083745,Cinel; Cameron Alexander,10,0,30,20
1657677175397,MATH 18,B01,083748,Rideout; David Porter,5,0,37,32
1657677175397,MATH 18,B02,083749,Rideout; David Porter,5,0,36,31
1657677175397,MATH 18,B03,083750,Rideout; David Porter,3,0,37,34
1657677175397,MATH 18,B04,083751,Rideout; David Porter,6,0,36,30
1657677175397,MATH 18,B05,093473,Rideout; David Porter,6,0,36,30
1657677175397,MATH 18,B06,093474,Rideout; David Porter,6,0,36,30
1657677181419,MATH 20A,A01,083754,Zheng; Zequn,14,0,40,26
1657677187448,MATH 20B,A01,083756,Briones; Jor-el Thomas Caparas,4,0,36,32
1657677187448,MATH 20B,A02,083757,Briones; Jor-el Thomas Caparas,1,0,36,35
1657677187448,MATH 20B,A03,093475,Briones; Jor-el Thomas Caparas,2,0,36,34
1657677193472,MATH 20C,A01,083760,Briones; Jor-el Thomas Caparas,1,0,35,34
1657677193472,MATH 20C,A02,083761,Briones; Jor-el Thomas Caparas,8,0,35,27
1657677193472,MATH 20C,A03,093476,Briones; Jor-el Thomas Caparas,0,1,36,36
1657677193472,MATH 20C,B01,083762,Bach; Quang Tran,1,0,30,29
1657677199500,MATH 20D,A01,083765,Tran; Brian Kha,5,0,30,25
1657677199500,MATH 20D,A02,083766,Tran; Brian Kha,5,0,30,25
1657677199500,MATH 20D,A03,083767,Tran; Brian Kha,5,0,30,25
1657677205534,MATH 20E,A01,083771,Ganguly; Soumya,9,0,32,23
1657677205534,MATH 20E,A02,083772,Ganguly; Soumya,6,0,32,26
1657677205534,MATH 20E,B01,083773,Ciotti; Benjamin,20,0,35,15
1657677205534,MATH 20E,B02,083774,Ciotti; Benjamin,18,0,35,17
1657677211562,MATH 103A,A01,083777,Greenfeld; Be'Eri,3,0,36,33
1657677211562,MATH 103A,A02,083778,Greenfeld; Be'Eri,5,0,36,31
1657677211562,MATH 103A,A03,093561,Greenfeld; Be'Eri,6,0,36,30
1657677211562,MATH 103A,B01,083779,Greenfeld; Be'Eri,7,0,36,29
1657677211562,MATH 103A,B02,083780,Greenfeld; Be'Eri,4,0,36,32
1657677211562,MATH 103A,B03,093562,Greenfeld; Be'Eri,3,0,36,33
1657677217588,MATH 105,A01,085443,Carter; Anne Toulson,15,0,35,20
1657677217588,MATH 105,A02,093477,Carter; Anne Toulson,20,0,35,15
1657677223616,MATH 109,A01,083213,Ganzberger; Geoffrey Michael,2,0,34,32
1657677223616,MATH 109,A02,083214,Ganzberger; Geoffrey Michael,4,0,34,30
1657677223616,MATH 109,A03,093478,Ganzberger; Geoffrey Michael,2,0,34,32
1657677223616,MATH 109,B01,083215,Ganzberger; Geoffrey Michael,1,0,32,31
1657677223616,MATH 109,B02,083216,Ganzberger; Geoffrey Michael,2,0,32,30
1657677223616,MATH 109,B03,093479,Ganzberger; Geoffrey Michael,8,0,32,24
1657677229643,MATH 142A,A01,083219,Chow; Bennett,7,0,32,25
1657677229643,MATH 142A,A02,083220,Chow; Bennett,10,0,32,22
1657677229643,MATH 142A,A03,093480,Chow; Bennett,9,0,32,23
1657677229643,MATH 142A,B03,093481,Chow; Bennett,8,0,32,24
1657677229643,MATH 142A,B04,093558,Chow; Bennett,13,0,32,19
1657677229643,MATH 142A,B05,093559,Chow; Bennett,6,0,32,26
1657677235666,MATH 193A,A01,083224,Rotar; Vladimir,8,0,34,26
1657677235666,MATH 193A,A02,083225,Rotar; Vladimir,9,0,34,25
1657677235666,MATH 193A,A03,083781,Rotar; Vladimir,5,0,34,29
1657677235666,MATH 193A,A04,083782,Rotar; Vladimir,10,0,34,24
1657677235666,MATH 193A,A05,093482,Rotar; Vladimir,10,0,34,24
1657677241688,MATH 197,001,091859,McAuley; Julian John,9999,0,9999,0
1657677241688,MATH 197,002,095566,Kedlaya; Kiran S.,9997,0,9999,2
1657677241688,MATH 197,003,095567,Xiao; Ming,9999,0,9999,0
1657677241688,MATH 197,004,095571,Perols; Johan Lars,9998,0,9999,1
1657677248742,COGS 9,A01,083615,Shannon; Kyle Michael,9,0,75,66
1657677254768,COGS 11,A01,083617,Boyle; Mary E. T.,23,0,48,25
1657677260795,COGS 13,A01,083071,Bastos; Amalia Pinkusfeld,11,0,71,60
1657677266822,COGS 14A,A01,092681,Semenuks; Arturs,5,1,100,95
1657677272844,COGS 14B,A01,083073,Cheng; Tzu-Han,6,0,63,57
1657677278866,COGS 17,A01,092677,Semenuks; Arturs,6,0,81,75
1657677284894,COGS 100,A01,083619,Allen; Michael Gordon,17,0,70,53
1657677290921,COGS 101A,A01,083621,Davis; Joshua Daniel,9,0,68,59
1657677296944,COGS 101B,A01,091572,Allen; Michael Gordon,12,0,65,53
1657677302969,COGS 101C,A01,083625,Delgado; Tania,17,0,35,18
1657677308993,COGS 107A,A01,083627,Boyle; Mary E. T.,13,0,60,47
1657677315015,COGS 118A,A01,083075,Gupta; Anjum,21,0,76,55
1657677321041,CSE 3,A50,083646,Miranda; Gregory Joseph,24,0,50,26
1657677327064,CSE 8A,A50,083650,Miranda; Gregory Joseph,17,1,56,39
1657677333089,CSE 11,A01,083080,Cao; Yingjun,6,15,40,34
1657677339112,CSE 12,A01,083652,Krause-Levy; Sophia Louisa,28,1,120,92
1657677345140,CSE 15L,A01,083654,Morris; Justin Loren,9,0,50,41
1657677345140,CSE 15L,A02,083655,Morris; Justin Loren,9,0,50,41
1657677351164,CSE 20,A01,083657,Tran; Khoa Dang,39,0,80,41
1657677357188,CSE 21,A01,095574,Bach; Quang Tran,22,0,48,26
1657677363216,CSE 30,A01,083084,Eldon; John,6,0,80,74
1657677363216,CSE 30,B01,095061,Bhaskar; Nishant,9,0,50,41
1657677369243,CSE 100,A01,083659,Cao; Yingjun,5,4,70,65
1657677375266,CSE 134B,A01,083661,Powell; Thomas Allan,23,0,100,77
1657677381292,CSE 140,A01,083663,Gungor; Onat,15,0,85,70
1657677387315,CSE 140L,A01,083088,Eldon; John,22,0,100,78
1657677393337,CSE 175,A01,083665,Kumar; Rakesh,3,0,25,22
1657677399362,CSE 190,A00,092507,Dubnov; Shlomo,8,0,20,12
1657677405392,ECE 45,A01,083139,Congero; Spencer William,6,0,75,69
1657677411415,ECE 65,A50,083695,Saad; Andrew S,12,0,30,18
1657677411415,ECE 65,A51,095125,Saad; Andrew S,24,0,26,2
1657677417440,ECE 109,A01,091882,Touri; Behrouz,20,0,70,50
1657677423467,ECE 180,A00,083140,Abi Samra; Nicholas Camill,1,0,30,29
1657677423467,ECE 180,B00,083141,Abi Samra; Nicholas Camill,0,0,30,30
1657677429496,MATH 10A,A01,083735,Patchell; Gregory David,2,0,30,28
1657677429496,MATH 10A,A02,083736,Patchell; Gregory David,20,0,30,10
1657677429496,MATH 10A,A03,083737,Patchell; Gregory David,16,0,30,14
1657677435521,MATH 10B,A01,083207,Lim; Seonhee,8,0,34,26
1657677435521,MATH 10B,A02,083208,Lim; Seonhee,9,0,35,26
1657677435521,MATH 10B,A03,093472,Lim; Seonhee,7,0,34,27
1657677435521,MATH 10B,B01,083739,Sinha; Shubham,13,0,30,17
1657677441546,MATH 18,A01,083743,Cinel; Cameron Alexander,8,0,30,22
1657677441546,MATH 18,A02,083744,Cinel; Cameron Alexander,17,0,30,13
1657677441546,MATH 18,A03,083745,Cinel; Cameron Alexander,10,0,30,20
1657677441546,MATH 18,B01,083748,Rideout; David Porter,5,0,37,32
1657677441546,MATH 18,B02,083749,Rideout; David Porter,5,0,36,31
1657677441546,MATH 18,B03,083750,Rideout; David Porter,3,0,37,34
1657677441546,MATH 18,B04,083751,Rideout; David Porter,6,0,36,30
1657677441546,MATH 18,B05,093473,Rideout; David Porter,6,0,36,30
1657677441546,MATH 18,B06,093474,Rideout; David Porter,6,0,36,30
1657677447569,MATH 20A,A01,083754,Zheng; Zequn,14,0,40,26
1657677453595,MATH 20B,A01,083756,Briones; Jor-el Thomas Caparas,4,0,36,32
1657677453595,MATH 20B,A02,083757,Briones; Jor-el Thomas Caparas,1,0,36,35
1657677453595,MATH 20B,A03,093475,Briones; Jor-el Thomas Caparas,2,0,36,34
1657677459621,MATH 20C,A01,083760,Briones; Jor-el Thomas Caparas,1,0,35,34
1657677459621,MATH 20C,A02,083761,Briones; Jor-el Thomas Caparas,8,0,35,27
1657677459621,MATH 20C,A03,093476,Briones; Jor-el Thomas Caparas,0,1,36,36
1657677459621,MATH 20C,B01,083762,Bach; Quang Tran,1,0,30,29
1657677465645,MATH 20D,A01,083765,Tran; Brian Kha,5,0,30,25
1657677465645,MATH 20D,A02,083766,Tran; Brian Kha,5,0,30,25
1657677465645,MATH 20D,A03,083767,Tran; Brian Kha,5,0,30,25
1657677471674,MATH 20E,A01,083771,Ganguly; Soumya,9,0,32,23
1657677471674,MATH 20E,A02,083772,Ganguly; Soumya,6,0,32,26
1657677471674,MATH 20E,B01,083773,Ciotti; Benjamin,20,0,35,15
1657677471674,MATH 20E,B02,083774,Ciotti; Benjamin,18,0,35,17
1657677477699,MATH 103A,A01,083777,Greenfeld; Be'Eri,3,0,36,33
1657677477699,MATH 103A,A02,083778,Greenfeld; Be'Eri,5,0,36,31
1657677477699,MATH 103A,A03,093561,Greenfeld; Be'Eri,6,0,36,30
1657677477699,MATH 103A,B01,083779,Greenfeld; Be'Eri,7,0,36,29
1657677477699,MATH 103A,B02,083780,Greenfeld; Be'Eri,4,0,36,32
1657677477699,MATH 103A,B03,093562,Greenfeld; Be'Eri,3,0,36,33
1657677483722,MATH 105,A01,085443,Carter; Anne Toulson,15,0,35,20
1657677483722,MATH 105,A02,093477,Carter; Anne Toulson,20,0,35,15
1657677489750,MATH 109,A01,083213,Ganzberger; Geoffrey Michael,2,0,34,32
1657677489750,MATH 109,A02,083214,Ganzberger; Geoffrey Michael,4,0,34,30
1657677489750,MATH 109,A03,093478,Ganzberger; Geoffrey Michael,2,0,34,32
1657677489750,MATH 109,B01,083215,Ganzberger; Geoffrey Michael,1,0,32,31
1657677489750,MATH 109,B02,083216,Ganzberger; Geoffrey Michael,2,0,32,30
1657677489750,MATH 109,B03,093479,Ganzberger; Geoffrey Michael,8,0,32,24
1657677495773,MATH 142A,A01,083219,Chow; Bennett,7,0,32,25
1657677495773,MATH 142A,A02,083220,Chow; Bennett,10,0,32,22
1657677495773,MATH 142A,A03,093480,Chow; Bennett,9,0,32,23
1657677495773,MATH 142A,B03,093481,Chow; Bennett,8,0,32,24
1657677495773,MATH 142A,B04,093558,Chow; Bennett,13,0,32,19
1657677495773,MATH 142A,B05,093559,Chow; Bennett,6,0,32,26
1657677501801,MATH 193A,A01,083224,Rotar; Vladimir,8,0,34,26
1657677501801,MATH 193A,A02,083225,Rotar; Vladimir,9,0,34,25
1657677501801,MATH 193A,A03,083781,Rotar; Vladimir,5,0,34,29
1657677501801,MATH 193A,A04,083782,Rotar; Vladimir,10,0,34,24
1657677501801,MATH 193A,A05,093482,Rotar; Vladimir,10,0,34,24
1657677507824,MATH 197,001,091859,McAuley; Julian John,9999,0,9999,0
1657677507824,MATH 197,002,095566,Kedlaya; Kiran S.,9997,0,9999,2
1657677507824,MATH 197,003,095567,Xiao; Ming,9999,0,9999,0
1657677507824,MATH 197,004,095571,Perols; Johan Lars,9998,0,9999,1
1657677514879,COGS 9,A01,083615,Shannon; Kyle Michael,9,0,75,66
1657677520905,COGS 11,A01,083617,Boyle; Mary E. T.,23,0,48,25
1657677526931,COGS 13,A01,083071,Bastos; Amalia Pinkusfeld,11,0,71,60
1657677532953,COGS 14A,A01,092681,Semenuks; Arturs,5,1,100,95
1657677538981,COGS 14B,A01,083073,Cheng; Tzu-Han,6,0,63,57
1657677545005,COGS 17,A01,092677,Semenuks; Arturs,6,0,81,75
1657677551028,COGS 100,A01,083619,Allen; Michael Gordon,17,0,70,53
1657677557052,COGS 101A,A01,083621,Davis; Joshua Daniel,9,0,68,59
1657677563078,COGS 101B,A01,091572,Allen; Michael Gordon,12,0,65,53
1657677569103,COGS 101C,A01,083625,Delgado; Tania,17,0,35,18
1657677575129,COGS 107A,A01,083627,Boyle; Mary E. T.,13,0,60,47
1657677581155,COGS 118A,A01,083075,Gupta; Anjum,21,0,76,55
1657677587183,CSE 3,A50,083646,Miranda; Gregory Joseph,24,0,50,26
1657677593210,CSE 8A,A50,083650,Miranda; Gregory Joseph,17,1,56,39
1657677599232,CSE 11,A01,083080,Cao; Yingjun,6,15,40,34
1657677605258,CSE 12,A01,083652,Krause-Levy; Sophia Louisa,28,1,120,92
1657677611281,CSE 15L,A01,083654,Morris; Justin Loren,9,0,50,41
1657677611281,CSE 15L,A02,083655,Morris; Justin Loren,9,0,50,41
1657677617313,CSE 20,A01,083657,Tran; Khoa Dang,39,0,80,41
1657677623337,CSE 21,A01,095574,Bach; Quang Tran,22,0,48,26
1657677629463,CSE 30,A01,083084,Eldon; John,6,0,80,74
1657677629463,CSE 30,B01,095061,Bhaskar; Nishant,9,0,50,41
1657677635499,CSE 100,A01,083659,Cao; Yingjun,5,4,70,65
1657677641526,CSE 134B,A01,083661,Powell; Thomas Allan,23,0,100,77
1657677647551,CSE 140,A01,083663,Gungor; Onat,15,0,85,70
1657677653578,CSE 140L,A01,083088,Eldon; John,22,0,100,78
1657677659604,CSE 175,A01,083665,Kumar; Rakesh,3,0,25,22
1657677665633,CSE 190,A00,092507,Dubnov; Shlomo,8,0,20,12
1657677671655,ECE 45,A01,083139,Congero; Spencer William,6,0,75,69
1657677677678,ECE 65,A50,083695,Saad; Andrew S,12,0,30,18
1657677677678,ECE 65,A51,095125,Saad; Andrew S,24,0,26,2
1657677683699,ECE 109,A01,091882,Touri; Behrouz,20,0,70,50
1657677689724,ECE 180,A00,083140,Abi Samra; Nicholas Camill,1,0,30,29
1657677689724,ECE 180,B00,083141,Abi Samra; Nicholas Camill,0,0,30,30
1657677695752,MATH 10A,A01,083735,Patchell; Gregory David,2,0,30,28
1657677695752,MATH 10A,A02,083736,Patchell; Gregory David,20,0,30,10
1657677695752,MATH 10A,A03,083737,Patchell; Gregory David,16,0,30,14
1657677701776,MATH 10B,A01,083207,Lim; Seonhee,8,0,34,26
1657677701776,MATH 10B,A02,083208,Lim; Seonhee,9,0,35,26
1657677701776,MATH 10B,A03,093472,Lim; Seonhee,7,0,34,27
1657677701776,MATH 10B,B01,083739,Sinha; Shubham,13,0,30,17
1657677707811,MATH 18,A01,083743,Cinel; Cameron Alexander,8,0,30,22
1657677707811,MATH 18,A02,083744,Cinel; Cameron Alexander,17,0,30,13
1657677707811,MATH 18,A03,083745,Cinel; Cameron Alexander,10,0,30,20
1657677707811,MATH 18,B01,083748,Rideout; David Porter,5,0,37,32
1657677707811,MATH 18,B02,083749,Rideout; David Porter,5,0,36,31
1657677707811,MATH 18,B03,083750,Rideout; David Porter,3,0,37,34
1657677707811,MATH 18,B04,083751,Rideout; David Porter,6,0,36,30
1657677707811,MATH 18,B05,093473,Rideout; David Porter,6,0,36,30
1657677707811,MATH 18,B06,093474,Rideout; David Porter,6,0,36,30
1657677713843,MATH 20A,A01,083754,Zheng; Zequn,14,0,40,26
1657677719867,MATH 20B,A01,083756,Briones; Jor-el Thomas Caparas,4,0,36,32
1657677719867,MATH 20B,A02,083757,Briones; Jor-el Thomas Caparas,1,0,36,35
1657677719867,MATH 20B,A03,093475,Briones; Jor-el Thomas Caparas,2,0,36,34
1657677725896,MATH 20C,A01,083760,Briones; Jor-el Thomas Caparas,1,0,35,34
1657677725896,MATH 20C,A02,083761,Briones; Jor-el Thomas Caparas,8,0,35,27
1657677725896,MATH 20C,A03,093476,Briones; Jor-el Thomas Caparas,0,1,36,36
1657677725896,MATH 20C,B01,083762,Bach; Quang Tran,1,0,30,29
1657677731919,MATH 20D,A01,083765,Tran; Brian Kha,5,0,30,25
1657677731919,MATH 20D,A02,083766,Tran; Brian Kha,5,0,30,25
1657677731919,MATH 20D,A03,083767,Tran; Brian Kha,5,0,30,25
1657677737943,MATH 20E,A01,083771,Ganguly; Soumya,9,0,32,23
1657677737943,MATH 20E,A02,083772,Ganguly; Soumya,6,0,32,26
1657677737943,MATH 20E,B01,083773,Ciotti; Benjamin,20,0,35,15
1657677737943,MATH 20E,B02,083774,Ciotti; Benjamin,18,0,35,17
1657677743984,MATH 103A,A01,083777,Greenfeld; Be'Eri,3,0,36,33
1657677743984,MATH 103A,A02,083778,Greenfeld; Be'Eri,5,0,36,31
1657677743984,MATH 103A,A03,093561,Greenfeld; Be'Eri,6,0,36,30
1657677743984,MATH 103A,B01,083779,Greenfeld; Be'Eri,7,0,36,29
1657677743984,MATH 103A,B02,083780,Greenfeld; Be'Eri,4,0,36,32
1657677743984,MATH 103A,B03,093562,Greenfeld; Be'Eri,3,0,36,33
1657677750012,MATH 105,A01,085443,Carter; Anne Toulson,15,0,35,20
1657677750012,MATH 105,A02,093477,Carter; Anne Toulson,20,0,35,15
1657677756040,MATH 109,A01,083213,Ganzberger; Geoffrey Michael,2,0,34,32
1657677756040,MATH 109,A02,083214,Ganzberger; Geoffrey Michael,4,0,34,30
1657677756040,MATH 109,A03,093478,Ganzberger; Geoffrey Michael,2,0,34,32
1657677756040,MATH 109,B01,083215,Ganzberger; Geoffrey Michael,1,0,32,31
1657677756040,MATH 109,B02,083216,Ganzberger; Geoffrey Michael,2,0,32,30
1657677756040,MATH 109,B03,093479,Ganzberger; Geoffrey Michael,8,0,32,24
1657677762076,MATH 142A,A01,083219,Chow; Bennett,7,0,32,25
1657677762076,MATH 142A,A02,083220,Chow; Bennett,10,0,32,22
1657677762076,MATH 142A,A03,093480,Chow; Bennett,9,0,32,23
1657677762076,MATH 142A,B03,093481,Chow; Bennett,8,0,32,24
1657677762076,MATH 142A,B04,093558,Chow; Bennett,13,0,32,19
1657677762076,MATH 142A,B05,093559,Chow; Bennett,6,0,32,26
1657677768101,MATH 193A,A01,083224,Rotar; Vladimir,8,0,34,26
1657677768101,MATH 193A,A02,083225,Rotar; Vladimir,9,0,34,25
1657677768101,MATH 193A,A03,083781,Rotar; Vladimir,5,0,34,29
1657677768101,MATH 193A,A04,083782,Rotar; Vladimir,10,0,34,24
1657677768101,MATH 193A,A05,093482,Rotar; Vladimir,10,0,34,24
1657677774126,MATH 197,001,091859,McAuley; Julian John,9999,0,9999,0
1657677774126,MATH 197,002,095566,Kedlaya; Kiran S.,9997,0,9999,2
1657677774126,MATH 197,003,095567,Xiao; Ming,9999,0,9999,0
1657677774126,MATH 197,004,095571,Perols; Johan Lars,9998,0,9999,1
1657677781188,COGS 9,A01,083615,Shannon; Kyle Michael,9,0,75,66
1657677787210,COGS 11,A01,083617,Boyle; Mary E. T.,23,0,48,25
1657677793233,COGS 13,A01,083071,Bastos; Amalia Pinkusfeld,11,0,71,60
1657677799258,COGS 14A,A01,092681,Semenuks; Arturs,5,1,100,95
1657677805285,COGS 14B,A01,083073,Cheng; Tzu-Han,6,0,63,57
1657677811308,COGS 17,A01,092677,Semenuks; Arturs,6,0,81,75
1657677817332,COGS 100,A01,083619,Allen; Michael Gordon,17,0,70,53
1657677823356,COGS 101A,A01,083621,Davis; Joshua Daniel,9,0,68,59
1657677829381,COGS 101B,A01,091572,Allen; Michael Gordon,12,0,65,53
1657677835407,COGS 101C,A01,083625,Delgado; Tania,17,0,35,18
1657677841429,COGS 107A,A01,083627,Boyle; Mary E. T.,13,0,60,47
1657677847457,COGS 118A,A01,083075,Gupta; Anjum,21,0,76,55
1657677853480,CSE 3,A50,083646,Miranda; Gregory Joseph,24,0,50,26
1657677859509,CSE 8A,A50,083650,Miranda; Gregory Joseph,17,1,56,39
1657677865535,CSE 11,A01,083080,Cao; Yingjun,6,15,40,34
1657677871559,CSE 12,A01,083652,Krause-Levy; Sophia Louisa,28,1,120,92
1657677877585,CSE 15L,A01,083654,Morris; Justin Loren,9,0,50,41
1657677877585,CSE 15L,A02,083655,Morris; Justin Loren,9,0,50,41
1657677883611,CSE 20,A01,083657,Tran; Khoa Dang,39,0,80,41
1657677889634,CSE 21,A01,095574,Bach; Quang Tran,22,0,48,26
1657677895663,CSE 30,A01,083084,Eldon; John,6,0,80,74
1657677895663,CSE 30,B01,095061,Bhaskar; Nishant,9,0,50,41
1657677901691,CSE 100,A01,083659,Cao; Yingjun,5,4,70,65
1657677907713,CSE 134B,A01,083661,Powell; Thomas Allan,23,0,100,77
1657677913735,CSE 140,A01,083663,Gungor; Onat,15,0,85,70
1657677919757,CSE 140L,A01,083088,Eldon; John,22,0,100,78
1657677925783,CSE 175,A01,083665,Kumar; Rakesh,3,0,25,22
1657677931804,CSE 190,A00,092507,Dubnov; Shlomo,8,0,20,12
1657677937829,ECE 45,A01,083139,Congero; Spencer William,6,0,75,69
1657677943862,ECE 65,A50,083695,Saad; Andrew S,12,0,30,18
1657677943862,ECE 65,A51,095125,Saad; Andrew S,24,0,26,2
1657677949886,ECE 109,A01,091882,Touri; Behrouz,20,0,70,50
1657677955913,ECE 180,A00,083140,Abi Samra; Nicholas Camill,1,0,30,29
1657677955913,ECE 180,B00,083141,Abi Samra; Nicholas Camill,0,0,30,30
1657677961940,MATH 10A,A01,083735,Patchell; Gregory David,2,0,30,28
1657677961940,MATH 10A,A02,083736,Patchell; Gregory David,20,0,30,10
1657677961940,MATH 10A,A03,083737,Patchell; Gregory David,16,0,30,14
1657677967969,MATH 10B,A01,083207,Lim; Seonhee,8,0,34,26
1657677967969,MATH 10B,A02,083208,Lim; Seonhee,9,0,35,26
1657677967969,MATH 10B,A03,093472,Lim; Seonhee,7,0,34,27
1657677967969,MATH 10B,B01,083739,Sinha; Shubham,13,0,30,17
1657677973999,MATH 18,A01,083743,Cinel; Cameron Alexander,8,0,30,22
1657677973999,MATH 18,A02,083744,Cinel; Cameron Alexander,17,0,30,13
1657677973999,MATH 18,A03,083745,Cinel; Cameron Alexander,10,0,30,20
1657677973999,MATH 18,B01,083748,Rideout; David Porter,5,0,37,32
1657677973999,MATH 18,B02,083749,Rideout; David Porter,5,0,36,31
1657677973999,MATH 18,B03,083750,Rideout; David Porter,3,0,37,34
1657677973999,MATH 18,B04,083751,Rideout; David Porter,6,0,36,30
1657677973999,MATH 18,B05,093473,Rideout; David Porter,6,0,36,30
1657677973999,MATH 18,B06,093474,Rideout; David Porter,6,0,36,30
1657677980025,MATH 20A,A01,083754,Zheng; Zequn,14,0,40,26
1657677986053,MATH 20B,A01,083756,Briones; Jor-el Thomas Caparas,4,0,36,32
1657677986053,MATH 20B,A02,083757,Briones; Jor-el Thomas Caparas,1,0,36,35
1657677986053,MATH 20B,A03,093475,Briones; Jor-el Thomas Caparas,2,0,36,34
1657677992076,MATH 20C,A01,083760,Briones; Jor-el Thomas Caparas,1,0,35,34
1657677992076,MATH 20C,A02,083761,Briones; Jor-el Thomas Caparas,8,0,35,27
1657677992076,MATH 20C,A03,093476,Briones; Jor-el Thomas Caparas,0,1,36,36
1657677992076,MATH 20C,B01,083762,Bach; Quang Tran,1,0,30,29
1657677998105,MATH 20D,A01,083765,Tran; Brian Kha,5,0,30,25
1657677998105,MATH 20D,A02,083766,Tran; Brian Kha,5,0,30,25
1657677998105,MATH 20D,A03,083767,Tran; Brian Kha,5,0,30,25
1657678004133,MATH 20E,A01,083771,Ganguly; Soumya,9,0,32,23
1657678004133,MATH 20E,A02,083772,Ganguly; Soumya,6,0,32,26
1657678004133,MATH 20E,B01,083773,Ciotti; Benjamin,20,0,35,15
1657678004133,MATH 20E,B02,083774,Ciotti; Benjamin,18,0,35,17
1657678010172,MATH 103A,A01,083777,Greenfeld; Be'Eri,3,0,36,33
1657678010172,MATH 103A,A02,083778,Greenfeld; Be'Eri,5,0,36,31
1657678010172,MATH 103A,A03,093561,Greenfeld; Be'Eri,6,0,36,30
1657678010172,MATH 103A,B01,083779,Greenfeld; Be'Eri,7,0,36,29
1657678010172,MATH 103A,B02,083780,Greenfeld; Be'Eri,4,0,36,32
1657678010172,MATH 103A,B03,093562,Greenfeld; Be'Eri,3,0,36,33
1657678016199,MATH 105,A01,085443,Carter; Anne Toulson,15,0,35,20
1657678016199,MATH 105,A02,093477,Carter; Anne Toulson,20,0,35,15
1657678022229,MATH 109,A01,083213,Ganzberger; Geoffrey Michael,2,0,34,32
1657678022229,MATH 109,A02,083214,Ganzberger; Geoffrey Michael,4,0,34,30
1657678022229,MATH 109,A03,093478,Ganzberger; Geoffrey Michael,2,0,34,32
1657678022229,MATH 109,B01,083215,Ganzberger; Geoffrey Michael,1,0,32,31
1657678022229,MATH 109,B02,083216,Ganzberger; Geoffrey Michael,2,0,32,30
1657678022229,MATH 109,B03,093479,Ganzberger; Geoffrey Michael,8,0,32,24
1657678028256,MATH 142A,A01,083219,Chow; Bennett,7,0,32,25
1657678028256,MATH 142A,A02,083220,Chow; Bennett,10,0,32,22
1657678028256,MATH 142A,A03,093480,Chow; Bennett,9,0,32,23
1657678028256,MATH 142A,B03,093481,Chow; Bennett,8,0,32,24
1657678028256,MATH 142A,B04,093558,Chow; Bennett,13,0,32,19
1657678028256,MATH 142A,B05,093559,Chow; Bennett,6,0,32,26
1657678034279,MATH 193A,A01,083224,Rotar; Vladimir,8,0,34,26
1657678034279,MATH 193A,A02,083225,Rotar; Vladimir,9,0,34,25
1657678034279,MATH 193A,A03,083781,Rotar; Vladimir,5,0,34,29
1657678034279,MATH 193A,A04,083782,Rotar; Vladimir,10,0,34,24
1657678034279,MATH 193A,A05,093482,Rotar; Vladimir,10,0,34,24
1657678040309,MATH 197,001,091859,McAuley; Julian John,9999,0,9999,0
1657678040309,MATH 197,002,095566,Kedlaya; Kiran S.,9997,0,9999,2
1657678040309,MATH 197,003,095567,Xiao; Ming,9999,0,9999,0
1657678040309,MATH 197,004,095571,Perols; Johan Lars,9998,0,9999,1
1657678047371,COGS 9,A01,083615,Shannon; Kyle Michael,9,0,75,66
1657678053395,COGS 11,A01,083617,Boyle; Mary E. T.,23,0,48,25
1657678059418,COGS 13,A01,083071,Bastos; Amalia Pinkusfeld,11,0,71,60
1657678065441,COGS 14A,A01,092681,Semenuks; Arturs,5,1,100,95
1657678071464,COGS 14B,A01,083073,Cheng; Tzu-Han,6,0,63,57
1657678077487,COGS 17,A01,092677,Semenuks; Arturs,6,0,81,75
1657678083520,COGS 100,A01,083619,Allen; Michael Gordon,17,0,70,53
1657678089543,COGS 101A,A01,083621,Davis; Joshua Daniel,9,0,68,59
1657678095577,COGS 101B,A01,091572,Allen; Michael Gordon,12,0,65,53
1657678101604,COGS 101C,A01,083625,Delgado; Tania,17,0,35,18
1657678107627,COGS 107A,A01,083627,Boyle; Mary E. T.,13,0,60,47
1657678113652,COGS 118A,A01,083075,Gupta; Anjum,21,0,76,55
1657678119681,CSE 3,A50,083646,Miranda; Gregory Joseph,24,0,50,26
1657678125703,CSE 8A,A50,083650,Miranda; Gregory Joseph,17,1,56,39
1657678131726,CSE 11,A01,083080,Cao; Yingjun,6,15,40,34
1657678137760,CSE 12,A01,083652,Krause-Levy; Sophia Louisa,28,1,120,92
1657678143786,CSE 15L,A01,083654,Morris; Justin Loren,9,0,50,41
1657678143786,CSE 15L,A02,083655,Morris; Justin Loren,9,0,50,41
1657678149808,CSE 20,A01,083657,Tran; Khoa Dang,39,0,80,41
1657678155834,CSE 21,A01,095574,Bach; Quang Tran,22,0,48,26
1657678161870,CSE 30,A01,083084,Eldon; John,6,0,80,74
1657678161870,CSE 30,B01,095061,Bhaskar; Nishant,9,0,50,41
1657678167904,CSE 100,A01,083659,Cao; Yingjun,5,4,70,65
1657678173929,CSE 134B,A01,083661,Powell; Thomas Allan,23,0,100,77
1657678179952,CSE 140,A01,083663,Gungor; Onat,15,0,85,70
1657678185976,CSE 140L,A01,083088,Eldon; John,22,0,100,78
1657678191998,CSE 175,A01,083665,Kumar; Rakesh,3,0,25,22
1657678198021,CSE 190,A00,092507,Dubnov; Shlomo,8,0,20,12
1657678204048,ECE 45,A01,083139,Congero; Spencer William,6,0,75,69
1657678210088,ECE 65,A50,083695,Saad; Andrew S,12,0,30,18
1657678210088,ECE 65,A51,095125,Saad; Andrew S,24,0,26,2
1657678216119,ECE 109,A01,091882,Touri; Behrouz,20,0,70,50
1657678222145,ECE 180,A00,083140,Abi Samra; Nicholas Camill,1,0,30,29
1657678222145,ECE 180,B00,083141,Abi Samra; Nicholas Camill,0,0,30,30
1657678228256,MATH 10A,A01,083735,Patchell; Gregory David,2,0,30,28
1657678228256,MATH 10A,A02,083736,Patchell; Gregory David,20,0,30,10
1657678228256,MATH 10A,A03,083737,Patchell; Gregory David,16,0,30,14
1657678234283,MATH 10B,A01,083207,Lim; Seonhee,8,0,34,26
1657678234283,MATH 10B,A02,083208,Lim; Seonhee,9,0,35,26
1657678234283,MATH 10B,A03,093472,Lim; Seonhee,7,0,34,27
1657678234283,MATH 10B,B01,083739,Sinha; Shubham,13,0,30,17
1657678240314,MATH 18,A01,083743,Cinel; Cameron Alexander,8,0,30,22
1657678240314,MATH 18,A02,083744,Cinel; Cameron Alexander,17,0,30,13
1657678240314,MATH 18,A03,083745,Cinel; Cameron Alexander,10,0,30,20
1657678240314,MATH 18,B01,083748,Rideout; David Porter,5,0,37,32
1657678240314,MATH 18,B02,083749,Rideout; David Porter,5,0,36,31
1657678240314,MATH 18,B03,083750,Rideout; David Porter,3,0,37,34
1657678240314,MATH 18,B04,083751,Rideout; David Porter,6,0,36,30
1657678240314,MATH 18,B05,093473,Rideout; David Porter,6,0,36,30
1657678240314,MATH 18,B06,093474,Rideout; David Porter,6,0,36,30
1657678246336,MATH 20A,A01,083754,Zheng; Zequn,14,0,40,26
1657678252361,MATH 20B,A01,083756,Briones; Jor-el Thomas Caparas,4,0,36,32
1657678252361,MATH 20B,A02,083757,Briones; Jor-el Thomas Caparas,1,0,36,35
1657678252361,MATH 20B,A03,093475,Briones; Jor-el Thomas Caparas,2,0,36,34
1657678258386,MATH 20C,A01,083760,Briones; Jor-el Thomas Caparas,1,0,35,34
1657678258386,MATH 20C,A02,083761,Briones; Jor-el Thomas Caparas,8,0,35,27
1657678258386,MATH 20C,A03,093476,Briones; Jor-el Thomas Caparas,0,1,36,36
1657678258386,MATH 20C,B01,083762,Bach; Quang Tran,1,0,30,29
1657678264414,MATH 20D,A01,083765,Tran; Brian Kha,5,0,30,25
1657678264414,MATH 20D,A02,083766,Tran; Brian Kha,5,0,30,25
1657678264414,MATH 20D,A03,083767,Tran; Brian Kha,5,0,30,25
1657678270437,MATH 20E,A01,083771,Ganguly; Soumya,9,0,32,23
1657678270437,MATH 20E,A02,083772,Ganguly; Soumya,6,0,32,26
1657678270437,MATH 20E,B01,083773,Ciotti; Benjamin,20,0,35,15
1657678270437,MATH 20E,B02,083774,Ciotti; Benjamin,18,0,35,17
1657678276460,MATH 103A,A01,083777,Greenfeld; Be'Eri,3,0,36,33
1657678276460,MATH 103A,A02,083778,Greenfeld; Be'Eri,5,0,36,31
1657678276460,MATH 103A,A03,093561,Greenfeld; Be'Eri,6,0,36,30
1657678276460,MATH 103A,B01,083779,Greenfeld; Be'Eri,7,0,36,29
1657678276460,MATH 103A,B02,083780,Greenfeld; Be'Eri,4,0,36,32
1657678276460,MATH 103A,B03,093562,Greenfeld; Be'Eri,3,0,36,33
1657678282483,MATH 105,A01,085443,Carter; Anne Toulson,15,0,35,20
1657678282483,MATH 105,A02,093477,Carter; Anne Toulson,20,0,35,15
1657678288510,MATH 109,A01,083213,Ganzberger; Geoffrey Michael,2,0,34,32
1657678288510,MATH 109,A02,083214,Ganzberger; Geoffrey Michael,4,0,34,30
1657678288510,MATH 109,A03,093478,Ganzberger; Geoffrey Michael,2,0,34,32
1657678288510,MATH 109,B01,083215,Ganzberger; Geoffrey Michael,1,0,32,31
1657678288510,MATH 109,B02,083216,Ganzberger; Geoffrey Michael,2,0,32,30
1657678288510,MATH 109,B03,093479,Ganzberger; Geoffrey Michael,8,0,32,24
1657678294539,MATH 142A,A01,083219,Chow; Bennett,7,0,32,25
1657678294539,MATH 142A,A02,083220,Chow; Bennett,10,0,32,22
1657678294539,MATH 142A,A03,093480,Chow; Bennett,9,0,32,23
1657678294539,MATH 142A,B03,093481,Chow; Bennett,8,0,32,24
1657678294539,MATH 142A,B04,093558,Chow; Bennett,13,0,32,19
1657678294539,MATH 142A,B05,093559,Chow; Bennett,6,0,32,26
1657678300565,MATH 193A,A01,083224,Rotar; Vladimir,8,0,34,26
1657678300565,MATH 193A,A02,083225,Rotar; Vladimir,9,0,34,25
1657678300565,MATH 193A,A03,083781,Rotar; Vladimir,5,0,34,29
1657678300565,MATH 193A,A04,083782,Rotar; Vladimir,10,0,34,24
1657678300565,MATH 193A,A05,093482,Rotar; Vladimir,10,0,34,24
1657678306590,MATH 197,001,091859,McAuley; Julian John,9999,0,9999,0
1657678306590,MATH 197,002,095566,Kedlaya; Kiran S.,9997,0,9999,2
1657678306590,MATH 197,003,095567,Xiao; Ming,9999,0,9999,0
1657678306590,MATH 197,004,095571,Perols; Johan Lars,9998,0,9999,1
1657678313646,COGS 9,A01,083615,Shannon; Kyle Michael,9,0,75,66
1657678319671,COGS 11,A01,083617,Boyle; Mary E. T.,23,0,48,25
1657678325701,COGS 13,A01,083071,Bastos; Amalia Pinkusfeld,11,0,71,60
1657678331731,COGS 14A,A01,092681,Semenuks; Arturs,5,1,100,95
1657678337754,COGS 14B,A01,083073,Cheng; Tzu-Han,6,0,63,57
1657678343777,COGS 17,A01,092677,Semenuks; Arturs,6,0,81,75
1657678349803,COGS 100,A01,083619,Allen; Michael Gordon,17,0,70,53
1657678355829,COGS 101A,A01,083621,Davis; Joshua Daniel,9,0,68,59
1657678361852,COGS 101B,A01,091572,Allen; Michael Gordon,12,0,65,53
1657678367875,COGS 101C,A01,083625,Delgado; Tania,17,0,35,18
1657678373898,COGS 107A,A01,083627,Boyle; Mary E. T.,13,0,60,47
1657678379921,COGS 118A,A01,083075,Gupta; Anjum,21,0,76,55
1657678385958,CSE 3,A50,083646,Miranda; Gregory Joseph,24,0,50,26
1657678391982,CSE 8A,A50,083650,Miranda; Gregory Joseph,17,1,56,39
1657678398011,CSE 11,A01,083080,Cao; Yingjun,6,15,40,34
1657678404034,CSE 12,A01,083652,Krause-Levy; Sophia Louisa,28,1,120,92
1657678410058,CSE 15L,A01,083654,Morris; Justin Loren,9,0,50,41
1657678410058,CSE 15L,A02,083655,Morris; Justin Loren,9,0,50,41
1657678416084,CSE 20,A01,083657,Tran; Khoa Dang,39,0,80,41
1657678422111,CSE 21,A01,095574,Bach; Quang Tran,22,0,48,26
1657678428133,CSE 30,A01,083084,Eldon; John,6,0,80,74
1657678428133,CSE 30,B01,095061,Bhaskar; Nishant,9,0,50,41
1657678434158,CSE 100,A01,083659,Cao; Yingjun,5,4,70,65
1657678440182,CSE 134B,A01,083661,Powell; Thomas Allan,23,0,100,77
1657678446204,CSE 140,A01,083663,Gungor; Onat,15,0,85,70
1657678452230,CSE 140L,A01,083088,Eldon; John,22,0,100,78
1657678458252,CSE 175,A01,083665,Kumar; Rakesh,3,0,25,22
1657678464277,CSE 190,A00,092507,Dubnov; Shlomo,8,0,20,12
1657678470300,ECE 45,A01,083139,Congero; Spencer William,6,0,75,69
1657678476322,ECE 65,A50,083695,Saad; Andrew S,12,0,30,18
1657678476322,ECE 65,A51,095125,Saad; Andrew S,24,0,26,2
1657678482349,ECE 109,A01,091882,Touri; Behrouz,20,0,70,50
1657678488375,ECE 180,A00,083140,Abi Samra; Nicholas Camill,1,0,30,29
1657678488375,ECE 180,B00,083141,Abi Samra; Nicholas Camill,0,0,30,30
1657678494410,MATH 10A,A01,083735,Patchell; Gregory David,2,0,30,28
1657678494410,MATH 10A,A02,083736,Patchell; Gregory David,20,0,30,10
1657678494410,MATH 10A,A03,083737,Patchell; Gregory David,16,0,30,14
1657678500435,MATH 10B,A01,083207,Lim; Seonhee,8,0,34,26
1657678500435,MATH 10B,A02,083208,Lim; Seonhee,9,0,35,26
1657678500435,MATH 10B,A03,093472,Lim; Seonhee,7,0,34,27
1657678500435,MATH 10B,B01,083739,Sinha; Shubham,13,0,30,17
1657678506465,MATH 18,A01,083743,Cinel; Cameron Alexander,8,0,30,22
1657678506465,MATH 18,A02,083744,Cinel; Cameron Alexander,17,0,30,13
1657678506465,MATH 18,A03,083745,Cinel; Cameron Alexander,10,0,30,20
1657678506465,MATH 18,B01,083748,Rideout; David Porter,5,0,37,32
1657678506465,MATH 18,B02,083749,Rideout; David Porter,5,0,36,31
1657678506465,MATH 18,B03,083750,Rideout; David Porter,3,0,37,34
1657678506465,MATH 18,B04,083751,Rideout; David Porter,6,0,36,30
1657678506465,MATH 18,B05,093473,Rideout; David Porter,6,0,36,30
1657678506465,MATH 18,B06,093474,Rideout; David Porter,6,0,36,30
1657678512492,MATH 20A,A01,083754,Zheng; Zequn,14,0,40,26
1657678518521,MATH 20B,A01,083756,Briones; Jor-el Thomas Caparas,4,0,36,32
1657678518521,MATH 20B,A02,083757,Briones; Jor-el Thomas Caparas,1,0,36,35
1657678518521,MATH 20B,A03,093475,Briones; Jor-el Thomas Caparas,2,0,36,34
1657678524550,MATH 20C,A01,083760,Briones; Jor-el Thomas Caparas,1,0,35,34
1657678524550,MATH 20C,A02,083761,Briones; Jor-el Thomas Caparas,8,0,35,27
1657678524550,MATH 20C,A03,093476,Briones; Jor-el Thomas Caparas,0,1,36,36
1657678524550,MATH 20C,B01,083762,Bach; Quang Tran,1,0,30,29
1657678530574,MATH 20D,A01,083765,Tran; Brian Kha,5,0,30,25
1657678530574,MATH 20D,A02,083766,Tran; Brian Kha,5,0,30,25
1657678530574,MATH 20D,A03,083767,Tran; Brian Kha,5,0,30,25
1657678536600,MATH 20E,A01,083771,Ganguly; Soumya,9,0,32,23
1657678536600,MATH 20E,A02,083772,Ganguly; Soumya,6,0,32,26
1657678536600,MATH 20E,B01,083773,Ciotti; Benjamin,20,0,35,15
1657678536600,MATH 20E,B02,083774,Ciotti; Benjamin,18,0,35,17
1657678542628,MATH 103A,A01,083777,Greenfeld; Be'Eri,3,0,36,33
1657678542628,MATH 103A,A02,083778,Greenfeld; Be'Eri,5,0,36,31
1657678542628,MATH 103A,A03,093561,Greenfeld; Be'Eri,6,0,36,30
1657678542628,MATH 103A,B01,083779,Greenfeld; Be'Eri,7,0,36,29
1657678542628,MATH 103A,B02,083780,Greenfeld; Be'Eri,4,0,36,32
1657678542628,MATH 103A,B03,093562,Greenfeld; Be'Eri,3,0,36,33
1657678548651,MATH 105,A01,085443,Carter; Anne Toulson,15,0,35,20
1657678548651,MATH 105,A02,093477,Carter; Anne Toulson,20,0,35,15
1657678554675,MATH 109,A01,083213,Ganzberger; Geoffrey Michael,2,0,34,32
1657678554675,MATH 109,A02,083214,Ganzberger; Geoffrey Michael,4,0,34,30
1657678554675,MATH 109,A03,093478,Ganzberger; Geoffrey Michael,2,0,34,32
1657678554675,MATH 109,B01,083215,Ganzberger; Geoffrey Michael,1,0,32,31
1657678554675,MATH 109,B02,083216,Ganzberger; Geoffrey Michael,2,0,32,30
1657678554675,MATH 109,B03,093479,Ganzberger; Geoffrey Michael,8,0,32,24
1657678560699,MATH 142A,A01,083219,Chow; Bennett,7,0,32,25
1657678560699,MATH 142A,A02,083220,Chow; Bennett,10,0,32,22
1657678560699,MATH 142A,A03,093480,Chow; Bennett,9,0,32,23
1657678560699,MATH 142A,B03,093481,Chow; Bennett,8,0,32,24
1657678560699,MATH 142A,B04,093558,Chow; Bennett,13,0,32,19
1657678560699,MATH 142A,B05,093559,Chow; Bennett,6,0,32,26
1657678566724,MATH 193A,A01,083224,Rotar; Vladimir,8,0,34,26
1657678566724,MATH 193A,A02,083225,Rotar; Vladimir,9,0,34,25
1657678566724,MATH 193A,A03,083781,Rotar; Vladimir,5,0,34,29
1657678566724,MATH 193A,A04,083782,Rotar; Vladimir,10,0,34,24
1657678566724,MATH 193A,A05,093482,Rotar; Vladimir,10,0,34,24
1657678572749,MATH 197,001,091859,McAuley; Julian John,9999,0,9999,0
1657678572749,MATH 197,002,095566,Kedlaya; Kiran S.,9997,0,9999,2
1657678572749,MATH 197,003,095567,Xiao; Ming,9999,0,9999,0
1657678572749,MATH 197,004,095571,Perols; Johan Lars,9998,0,9999,1
1657678579811,COGS 9,A01,083615,Shannon; Kyle Michael,9,0,75,66
1657678585834,COGS 11,A01,083617,Boyle; Mary E. T.,23,0,48,25
1657678591862,COGS 13,A01,083071,Bastos; Amalia Pinkusfeld,11,0,71,60
1657678597885,COGS 14A,A01,092681,Semenuks; Arturs,5,1,100,95
1657678603909,COGS 14B,A01,083073,Cheng; Tzu-Han,6,0,63,57
1657678609932,COGS 17,A01,092677,Semenuks; Arturs,6,0,81,75
1657678615954,COGS 100,A01,083619,Allen; Michael Gordon,17,0,70,53
1657678621979,COGS 101A,A01,083621,Davis; Joshua Daniel,9,0,68,59
1657678628001,COGS 101B,A01,091572,Allen; Michael Gordon,12,0,65,53
1657678634029,COGS 101C,A01,083625,Delgado; Tania,17,0,35,18
1657678640056,COGS 107A,A01,083627,Boyle; Mary E. T.,13,0,60,47
1657678646079,COGS 118A,A01,083075,Gupta; Anjum,21,0,76,55
1657678652118,CSE 3,A50,083646,Miranda; Gregory Joseph,24,0,50,26
1657678658141,CSE 8A,A50,083650,Miranda; Gregory Joseph,17,1,56,39
1657678664169,CSE 11,A01,083080,Cao; Yingjun,6,15,40,34
1657678670195,CSE 12,A01,083652,Krause-Levy; Sophia Louisa,28,1,120,92
1657678676221,CSE 15L,A01,083654,Morris; Justin Loren,9,0,50,41
1657678676221,CSE 15L,A02,083655,Morris; Justin Loren,9,0,50,41
1657678682248,CSE 20,A01,083657,Tran; Khoa Dang,39,0,80,41
1657678688271,CSE 21,A01,095574,Bach; Quang Tran,22,0,48,26
1657678694298,CSE 30,A01,083084,Eldon; John,6,0,80,74
1657678694298,CSE 30,B01,095061,Bhaskar; Nishant,9,0,50,41
1657678700323,CSE 100,A01,083659,Cao; Yingjun,5,4,70,65
1657678706349,CSE 134B,A01,083661,Powell; Thomas Allan,23,0,100,77
1657678712375,CSE 140,A01,083663,Gungor; Onat,15,0,85,70
1657678718410,CSE 140L,A01,083088,Eldon; John,22,0,100,78
1657678724433,CSE 175,A01,083665,Kumar; Rakesh,3,0,25,22
1657678730464,CSE 190,A00,092507,Dubnov; Shlomo,8,0,20,12
1657678736491,ECE 45,A01,083139,Congero; Spencer William,6,0,75,69
1657678742517,ECE 65,A50,083695,Saad; Andrew S,12,0,30,18
1657678742517,ECE 65,A51,095125,Saad; Andrew S,24,0,26,2
1657678748541,ECE 109,A01,091882,Touri; Behrouz,20,0,70,50
1657678754563,ECE 180,A00,083140,Abi Samra; Nicholas Camill,1,0,30,29
1657678754563,ECE 180,B00,083141,Abi Samra; Nicholas Camill,0,0,30,30
1657678760591,MATH 10A,A01,083735,Patchell; Gregory David,2,0,30,28
1657678760591,MATH 10A,A02,083736,Patchell; Gregory David,20,0,30,10
1657678760591,MATH 10A,A03,083737,Patchell; Gregory David,16,0,30,14
1657678766629,MATH 10B,A01,083207,Lim; Seonhee,8,0,34,26
1657678766629,MATH 10B,A02,083208,Lim; Seonhee,9,0,35,26
1657678766629,MATH 10B,A03,093472,Lim; Seonhee,7,0,34,27
1657678766629,MATH 10B,B01,083739,Sinha; Shubham,13,0,30,17
1657678772657,MATH 18,A01,083743,Cinel; Cameron Alexander,8,0,30,22
1657678772657,MATH 18,A02,083744,Cinel; Cameron Alexander,17,0,30,13
1657678772657,MATH 18,A03,083745,Cinel; Cameron Alexander,10,0,30,20
1657678772657,MATH 18,B01,083748,Rideout; David Porter,5,0,37,32
1657678772657,MATH 18,B02,083749,Rideout; David Porter,5,0,36,31
1657678772657,MATH 18,B03,083750,Rideout; David Porter,3,0,37,34
1657678772657,MATH 18,B04,083751,Rideout; David Porter,6,0,36,30
1657678772657,MATH 18,B05,093473,Rideout; David Porter,6,0,36,30
1657678772657,MATH 18,B06,093474,Rideout; David Porter,6,0,36,30
1657678778693,MATH 20A,A01,083754,Zheng; Zequn,14,0,40,26
1657678784719,MATH 20B,A01,083756,Briones; Jor-el Thomas Caparas,4,0,36,32
1657678784719,MATH 20B,A02,083757,Briones; Jor-el Thomas Caparas,1,0,36,35
1657678784719,MATH 20B,A03,093475,Briones; Jor-el Thomas Caparas,2,0,36,34
1657678790742,MATH 20C,A01,083760,Briones; Jor-el Thomas Caparas,1,0,35,34
1657678790742,MATH 20C,A02,083761,Briones; Jor-el Thomas Caparas,8,0,35,27
1657678790742,MATH 20C,A03,093476,Briones; Jor-el Thomas Caparas,0,1,36,36
1657678790742,MATH 20C,B01,083762,Bach; Quang Tran,1,0,30,29
1657678796771,MATH 20D,A01,083765,Tran; Brian Kha,5,0,30,25
1657678796771,MATH 20D,A02,083766,Tran; Brian Kha,5,0,30,25
1657678796771,MATH 20D,A03,083767,Tran; Brian Kha,5,0,30,25
1657678802801,MATH 20E,A01,083771,Ganguly; Soumya,9,0,32,23
1657678802801,MATH 20E,A02,083772,Ganguly; Soumya,6,0,32,26
1657678802801,MATH 20E,B01,083773,Ciotti; Benjamin,20,0,35,15
1657678802801,MATH 20E,B02,083774,Ciotti; Benjamin,18,0,35,17
1657678808824,MATH 103A,A01,083777,Greenfeld; Be'Eri,3,0,36,33
1657678808824,MATH 103A,A02,083778,Greenfeld; Be'Eri,5,0,36,31
1657678808824,MATH 103A,A03,093561,Greenfeld; Be'Eri,6,0,36,30
1657678808824,MATH 103A,B01,083779,Greenfeld; Be'Eri,7,0,36,29
1657678808824,MATH 103A,B02,083780,Greenfeld; Be'Eri,4,0,36,32
1657678808824,MATH 103A,B03,093562,Greenfeld; Be'Eri,3,0,36,33
1657678814860,MATH 105,A01,085443,Carter; Anne Toulson,15,0,35,20
1657678814860,MATH 105,A02,093477,Carter; Anne Toulson,20,0,35,15
1657678820888,MATH 109,A01,083213,Ganzberger; Geoffrey Michael,2,0,34,32
1657678820888,MATH 109,A02,083214,Ganzberger; Geoffrey Michael,4,0,34,30
1657678820888,MATH 109,A03,093478,Ganzberger; Geoffrey Michael,2,0,34,32
1657678820888,MATH 109,B01,083215,Ganzberger; Geoffrey Michael,1,0,32,31
1657678820888,MATH 109,B02,083216,Ganzberger; Geoffrey Michael,2,0,32,30
1657678820888,MATH 109,B03,093479,Ganzberger; Geoffrey Michael,8,0,32,24
1657678827019,MATH 142A,A01,083219,Chow; Bennett,7,0,32,25
1657678827019,MATH 142A,A02,083220,Chow; Bennett,10,0,32,22
1657678827019,MATH 142A,A03,093480,Chow; Bennett,9,0,32,23
1657678827019,MATH 142A,B03,093481,Chow; Bennett,8,0,32,24
1657678827019,MATH 142A,B04,093558,Chow; Bennett,13,0,32,19
1657678827019,MATH 142A,B05,093559,Chow; Bennett,6,0,32,26
1657678833048,MATH 193A,A01,083224,Rotar; Vladimir,8,0,34,26
1657678833048,MATH 193A,A02,083225,Rotar; Vladimir,9,0,34,25
1657678833048,MATH 193A,A03,083781,Rotar; Vladimir,5,0,34,29
1657678833048,MATH 193A,A04,083782,Rotar; Vladimir,10,0,34,24
1657678833048,MATH 193A,A05,093482,Rotar; Vladimir,10,0,34,24
1657678839090,MATH 197,001,091859,McAuley; Julian John,9999,0,9999,0
1657678839090,MATH 197,002,095566,Kedlaya; Kiran S.,9997,0,9999,2
1657678839090,MATH 197,003,095567,Xiao; Ming,9999,0,9999,0
1657678839090,MATH 197,004,095571,Perols; Johan Lars,9998,0,9999,1
1657678846179,COGS 9,A01,083615,Shannon; Kyle Michael,9,0,75,66
1657678852207,COGS 11,A01,083617,Boyle; Mary E. T.,23,0,48,25
1657678858236,COGS 13,A01,083071,Bastos; Amalia Pinkusfeld,11,0,71,60
1657678864263,COGS 14A,A01,092681,Semenuks; Arturs,5,1,100,95
1657678870293,COGS 14B,A01,083073,Cheng; Tzu-Han,6,0,63,57
1657678876319,COGS 17,A01,092677,Semenuks; Arturs,6,0,81,75
1657678882350,COGS 100,A01,083619,Allen; Michael Gordon,17,0,70,53
1657678888374,COGS 101A,A01,083621,Davis; Joshua Daniel,9,0,68,59
1657678894398,COGS 101B,A01,091572,Allen; Michael Gordon,12,0,65,53
1657678900425,COGS 101C,A01,083625,Delgado; Tania,17,0,35,18
1657678906448,COGS 107A,A01,083627,Boyle; Mary E. T.,13,0,60,47
1657678912482,COGS 118A,A01,083075,Gupta; Anjum,21,0,76,55
1657678918508,CSE 3,A50,083646,Miranda; Gregory Joseph,24,0,50,26
1657678924568,CSE 8A,A50,083650,Miranda; Gregory Joseph,17,1,56,39
1657678930592,CSE 11,A01,083080,Cao; Yingjun,6,15,40,34
1657678936615,CSE 12,A01,083652,Krause-Levy; Sophia Louisa,28,1,120,92
1657678942640,CSE 15L,A01,083654,Morris; Justin Loren,9,0,50,41
1657678942640,CSE 15L,A02,083655,Morris; Justin Loren,9,0,50,41
1657678948662,CSE 20,A01,083657,Tran; Khoa Dang,39,0,80,41
1657678954685,CSE 21,A01,095574,Bach; Quang Tran,22,0,48,26
1657678960725,CSE 30,A01,083084,Eldon; John,6,0,80,74
1657678960725,CSE 30,B01,095061,Bhaskar; Nishant,9,0,50,41
1657678966751,CSE 100,A01,083659,Cao; Yingjun,5,4,70,65
1657678972787,CSE 134B,A01,083661,Powell; Thomas Allan,23,0,100,77
1657678978809,CSE 140,A01,083663,Gungor; Onat,15,0,85,70
1657678984832,CSE 140L,A01,083088,Eldon; John,22,0,100,78
1657678990858,CSE 175,A01,083665,Kumar; Rakesh,3,0,25,22
1657678996883,CSE 190,A00,092507,Dubnov; Shlomo,8,0,20,12
1657679002913,ECE 45,A01,083139,Congero; Spencer William,6,0,75,69
1657679008947,ECE 65,A50,083695,Saad; Andrew S,12,0,30,18
1657679008947,ECE 65,A51,095125,Saad; Andrew S,24,0,26,2
1657679014979,ECE 109,A01,091882,Touri; Behrouz,20,0,70,50
1657679021008,ECE 180,A00,083140,Abi Samra; Nicholas Camill,1,0,30,29
1657679021008,ECE 180,B00,083141,Abi Samra; Nicholas Camill,0,0,30,30
1657679027031,MATH 10A,A01,083735,Patchell; Gregory David,2,0,30,28
1657679027031,MATH 10A,A02,083736,Patchell; Gregory David,20,0,30,10
1657679027031,MATH 10A,A03,083737,Patchell; Gregory David,16,0,30,14
1657679033055,MATH 10B,A01,083207,Lim; Seonhee,8,0,34,26
1657679033055,MATH 10B,A02,083208,Lim; Seonhee,9,0,35,26
1657679033055,MATH 10B,A03,093472,Lim; Seonhee,7,0,34,27
1657679033055,MATH 10B,B01,083739,Sinha; Shubham,13,0,30,17
1657679039086,MATH 18,A01,083743,Cinel; Cameron Alexander,8,0,30,22
1657679039086,MATH 18,A02,083744,Cinel; Cameron Alexander,17,0,30,13
1657679039086,MATH 18,A03,083745,Cinel; Cameron Alexander,10,0,30,20
1657679039086,MATH 18,B01,083748,Rideout; David Porter,5,0,37,32
1657679039086,MATH 18,B02,083749,Rideout; David Porter,5,0,36,31
1657679039086,MATH 18,B03,083750,Rideout; David Porter,3,0,37,34
1657679039086,MATH 18,B04,083751,Rideout; David Porter,6,0,36,30
1657679039086,MATH 18,B05,093473,Rideout; David Porter,6,0,36,30
1657679039086,MATH 18,B06,093474,Rideout; David Porter,6,0,36,30
1657679045116,MATH 20A,A01,083754,Zheng; Zequn,14,0,40,26
1657679051138,MATH 20B,A01,083756,Briones; Jor-el Thomas Caparas,4,0,36,32
1657679051138,MATH 20B,A02,083757,Briones; Jor-el Thomas Caparas,1,0,36,35
1657679051138,MATH 20B,A03,093475,Briones; Jor-el Thomas Caparas,2,0,36,34
1657679057162,MATH 20C,A01,083760,Briones; Jor-el Thomas Caparas,1,0,35,34
1657679057162,MATH 20C,A02,083761,Briones; Jor-el Thomas Caparas,8,0,35,27
1657679057162,MATH 20C,A03,093476,Briones; Jor-el Thomas Caparas,0,1,36,36
1657679057162,MATH 20C,B01,083762,Bach; Quang Tran,1,0,30,29
1657679063188,MATH 20D,A01,083765,Tran; Brian Kha,5,0,30,25
1657679063188,MATH 20D,A02,083766,Tran; Brian Kha,5,0,30,25
1657679063188,MATH 20D,A03,083767,Tran; Brian Kha,5,0,30,25
1657679069217,MATH 20E,A01,083771,Ganguly; Soumya,9,0,32,23
1657679069217,MATH 20E,A02,083772,Ganguly; Soumya,6,0,32,26
1657679069217,MATH 20E,B01,083773,Ciotti; Benjamin,20,0,35,15
1657679069217,MATH 20E,B02,083774,Ciotti; Benjamin,18,0,35,17
1657679075240,MATH 103A,A01,083777,Greenfeld; Be'Eri,3,0,36,33
1657679075240,MATH 103A,A02,083778,Greenfeld; Be'Eri,5,0,36,31
1657679075240,MATH 103A,A03,093561,Greenfeld; Be'Eri,6,0,36,30
1657679075240,MATH 103A,B01,083779,Greenfeld; Be'Eri,7,0,36,29
1657679075240,MATH 103A,B02,083780,Greenfeld; Be'Eri,4,0,36,32
1657679075240,MATH 103A,B03,093562,Greenfeld; Be'Eri,3,0,36,33
1657679081264,MATH 105,A01,085443,Carter; Anne Toulson,15,0,35,20
1657679081264,MATH 105,A02,093477,Carter; Anne Toulson,20,0,35,15
1657679087288,MATH 109,A01,083213,Ganzberger; Geoffrey Michael,2,0,34,32
1657679087288,MATH 109,A02,083214,Ganzberger; Geoffrey Michael,4,0,34,30
1657679087288,MATH 109,A03,093478,Ganzberger; Geoffrey Michael,2,0,34,32
1657679087288,MATH 109,B01,083215,Ganzberger; Geoffrey Michael,1,0,32,31
1657679087288,MATH 109,B02,083216,Ganzberger; Geoffrey Michael,2,0,32,30
1657679087288,MATH 109,B03,093479,Ganzberger; Geoffrey Michael,8,0,32,24
1657679093313,MATH 142A,A01,083219,Chow; Bennett,7,0,32,25
1657679093313,MATH 142A,A02,083220,Chow; Bennett,10,0,32,22
1657679093313,MATH 142A,A03,093480,Chow; Bennett,9,0,32,23
1657679093313,MATH 142A,B03,093481,Chow; Bennett,8,0,32,24
1657679093313,MATH 142A,B04,093558,Chow; Bennett,13,0,32,19
1657679093313,MATH 142A,B05,093559,Chow; Bennett,6,0,32,26
1657679099337,MATH 193A,A01,083224,Rotar; Vladimir,8,0,34,26
1657679099337,MATH 193A,A02,083225,Rotar; Vladimir,9,0,34,25
1657679099337,MATH 193A,A03,083781,Rotar; Vladimir,5,0,34,29
1657679099337,MATH 193A,A04,083782,Rotar; Vladimir,10,0,34,24
1657679099337,MATH 193A,A05,093482,Rotar; Vladimir,10,0,34,24
1657679105371,MATH 197,001,091859,McAuley; Julian John,9999,0,9999,0
1657679105371,MATH 197,002,095566,Kedlaya; Kiran S.,9997,0,9999,2
1657679105371,MATH 197,003,095567,Xiao; Ming,9999,0,9999,0
1657679105371,MATH 197,004,095571,Perols; Johan Lars,9998,0,9999,1
1657679112422,COGS 9,A01,083615,Shannon; Kyle Michael,9,0,75,66
1657679118445,COGS 11,A01,083617,Boyle; Mary E. T.,23,0,48,25
1657679124474,COGS 13,A01,083071,Bastos; Amalia Pinkusfeld,11,0,71,60
1657679130498,COGS 14A,A01,092681,Semenuks; Arturs,5,1,100,95
1657679136525,COGS 14B,A01,083073,Cheng; Tzu-Han,6,0,63,57
1657679142559,COGS 17,A01,092677,Semenuks; Arturs,6,0,81,75
1657679148582,COGS 100,A01,083619,Allen; Michael Gordon,17,0,70,53
1657679154609,COGS 101A,A01,083621,Davis; Joshua Daniel,9,0,68,59
1657679160631,COGS 101B,A01,091572,Allen; Michael Gordon,12,0,65,53
1657679166655,COGS 101C,A01,083625,Delgado; Tania,17,0,35,18
1657679172682,COGS 107A,A01,083627,Boyle; Mary E. T.,13,0,60,47
1657679178704,COGS 118A,A01,083075,Gupta; Anjum,21,0,76,55
1657679184741,CSE 3,A50,083646,Miranda; Gregory Joseph,24,0,50,26
1657679190763,CSE 8A,A50,083650,Miranda; Gregory Joseph,17,1,56,39
1657679196789,CSE 11,A01,083080,Cao; Yingjun,6,15,40,34
1657679202811,CSE 12,A01,083652,Krause-Levy; Sophia Louisa,28,1,120,92
1657679208835,CSE 15L,A01,083654,Morris; Justin Loren,9,0,50,41
1657679208835,CSE 15L,A02,083655,Morris; Justin Loren,9,0,50,41
1657679214863,CSE 20,A01,083657,Tran; Khoa Dang,39,0,80,41
1657679220900,CSE 21,A01,095574,Bach; Quang Tran,22,0,48,26
1657679226924,CSE 30,A01,083084,Eldon; John,6,0,80,74
1657679226924,CSE 30,B01,095061,Bhaskar; Nishant,9,0,50,41
1657679232952,CSE 100,A01,083659,Cao; Yingjun,5,4,70,65
1657679238975,CSE 134B,A01,083661,Powell; Thomas Allan,23,0,100,77
1657679245000,CSE 140,A01,083663,Gungor; Onat,15,0,85,70
1657679251023,CSE 140L,A01,083088,Eldon; John,22,0,100,78
1657679257045,CSE 175,A01,083665,Kumar; Rakesh,3,0,25,22
1657679263071,CSE 190,A00,092507,Dubnov; Shlomo,8,0,20,12
1657679269097,ECE 45,A01,083139,Congero; Spencer William,6,0,75,69
1657679275124,ECE 65,A50,083695,Saad; Andrew S,12,0,30,18
1657679275124,ECE 65,A51,095125,Saad; Andrew S,24,0,26,2
1657679281158,ECE 109,A01,091882,Touri; Behrouz,20,0,70,50
1657679287180,ECE 180,A00,083140,Abi Samra; Nicholas Camill,1,0,30,29
1657679287180,ECE 180,B00,083141,Abi Samra; Nicholas Camill,0,0,30,30
1657679293209,MATH 10A,A01,083735,Patchell; Gregory David,2,0,30,28
1657679293209,MATH 10A,A02,083736,Patchell; Gregory David,20,0,30,10
1657679293209,MATH 10A,A03,083737,Patchell; Gregory David,16,0,30,14
1657679299234,MATH 10B,A01,083207,Lim; Seonhee,8,0,34,26
1657679299234,MATH 10B,A02,083208,Lim; Seonhee,9,0,35,26
1657679299234,MATH 10B,A03,093472,Lim; Seonhee,7,0,34,27
1657679299234,MATH 10B,B01,083739,Sinha; Shubham,13,0,30,17
1657679305260,MATH 18,A01,083743,Cinel; Cameron Alexander,8,0,30,22
1657679305260,MATH 18,A02,083744,Cinel; Cameron Alexander,17,0,30,13
1657679305260,MATH 18,A03,083745,Cinel; Cameron Alexander,10,0,30,20
1657679305260,MATH 18,B01,083748,Rideout; David Porter,5,0,37,32
1657679305260,MATH 18,B02,083749,Rideout; David Porter,5,0,36,31
1657679305260,MATH 18,B03,083750,Rideout; David Porter,3,0,37,34
1657679305260,MATH 18,B04,083751,Rideout; David Porter,6,0,36,30
1657679305260,MATH 18,B05,093473,Rideout; David Porter,6,0,36,30
1657679305260,MATH 18,B06,093474,Rideout; David Porter,6,0,36,30
1657679311284,MATH 20A,A01,083754,Zheng; Zequn,14,0,40,26
1657679317312,MATH 20B,A01,083756,Briones; Jor-el Thomas Caparas,4,0,36,32
1657679317312,MATH 20B,A02,083757,Briones; Jor-el Thomas Caparas,1,0,36,35
1657679317312,MATH 20B,A03,093475,Briones; Jor-el Thomas Caparas,2,0,36,34
1657679323344,MATH 20C,A01,083760,Briones; Jor-el Thomas Caparas,1,0,35,34
1657679323344,MATH 20C,A02,083761,Briones; Jor-el Thomas Caparas,8,0,35,27
1657679323344,MATH 20C,A03,093476,Briones; Jor-el Thomas Caparas,0,1,36,36
1657679323344,MATH 20C,B01,083762,Bach; Quang Tran,1,0,30,29
1657679329371,MATH 20D,A01,083765,Tran; Brian Kha,5,0,30,25
1657679329371,MATH 20D,A02,083766,Tran; Brian Kha,5,0,30,25
1657679329371,MATH 20D,A03,083767,Tran; Brian Kha,5,0,30,25
1657679335400,MATH 20E,A01,083771,Ganguly; Soumya,9,0,32,23
1657679335400,MATH 20E,A02,083772,Ganguly; Soumya,6,0,32,26
1657679335400,MATH 20E,B01,083773,Ciotti; Benjamin,20,0,35,15
1657679335400,MATH 20E,B02,083774,Ciotti; Benjamin,18,0,35,17
1657679341423,MATH 103A,A01,083777,Greenfeld; Be'Eri,3,0,36,33
1657679341423,MATH 103A,A02,083778,Greenfeld; Be'Eri,5,0,36,31
1657679341423,MATH 103A,A03,093561,Greenfeld; Be'Eri,6,0,36,30
1657679341423,MATH 103A,B01,083779,Greenfeld; Be'Eri,7,0,36,29
1657679341423,MATH 103A,B02,083780,Greenfeld; Be'Eri,4,0,36,32
1657679341423,MATH 103A,B03,093562,Greenfeld; Be'Eri,3,0,36,33
1657679347455,MATH 105,A01,085443,Carter; Anne Toulson,15,0,35,20
1657679347455,MATH 105,A02,093477,Carter; Anne Toulson,20,0,35,15
1657679353483,MATH 109,A01,083213,Ganzberger; Geoffrey Michael,2,0,34,32
1657679353483,MATH 109,A02,083214,Ganzberger; Geoffrey Michael,4,0,34,30
1657679353483,MATH 109,A03,093478,Ganzberger; Geoffrey Michael,2,0,34,32
1657679353483,MATH 109,B01,083215,Ganzberger; Geoffrey Michael,1,0,32,31
1657679353483,MATH 109,B02,083216,Ganzberger; Geoffrey Michael,2,0,32,30
1657679353483,MATH 109,B03,093479,Ganzberger; Geoffrey Michael,8,0,32,24
1657679359507,MATH 142A,A01,083219,Chow; Bennett,7,0,32,25
1657679359507,MATH 142A,A02,083220,Chow; Bennett,10,0,32,22
1657679359507,MATH 142A,A03,093480,Chow; Bennett,9,0,32,23
1657679359507,MATH 142A,B03,093481,Chow; Bennett,8,0,32,24
1657679359507,MATH 142A,B04,093558,Chow; Bennett,13,0,32,19
1657679359507,MATH 142A,B05,093559,Chow; Bennett,6,0,32,26
1657679365534,MATH 193A,A01,083224,Rotar; Vladimir,8,0,34,26
1657679365534,MATH 193A,A02,083225,Rotar; Vladimir,9,0,34,25
1657679365534,MATH 193A,A03,083781,Rotar; Vladimir,5,0,34,29
1657679365534,MATH 193A,A04,083782,Rotar; Vladimir,10,0,34,24
1657679365534,MATH 193A,A05,093482,Rotar; Vladimir,10,0,34,24
1657679371559,MATH 197,001,091859,McAuley; Julian John,9999,0,9999,0
1657679371559,MATH 197,002,095566,Kedlaya; Kiran S.,9997,0,9999,2
1657679371559,MATH 197,003,095567,Xiao; Ming,9999,0,9999,0
1657679371559,MATH 197,004,095571,Perols; Johan Lars,9998,0,9999,1
1657679378618,COGS 9,A01,083615,Shannon; Kyle Michael,9,0,75,66
1657679384648,COGS 11,A01,083617,Boyle; Mary E. T.,23,0,48,25
1657679390674,COGS 13,A01,083071,Bastos; Amalia Pinkusfeld,11,0,71,60
1657679396700,COGS 14A,A01,092681,Semenuks; Arturs,5,1,100,95
1657679402724,COGS 14B,A01,083073,Cheng; Tzu-Han,6,0,63,57
1657679408753,COGS 17,A01,092677,Semenuks; Arturs,6,0,81,75
1657679414783,COGS 100,A01,083619,Allen; Michael Gordon,17,0,70,53
1657679420879,COGS 101A,A01,083621,Davis; Joshua Daniel,9,0,68,59
1657679426903,COGS 101B,A01,091572,Allen; Michael Gordon,12,0,65,53
1657679432933,COGS 101C,A01,083625,Delgado; Tania,17,0,35,18
1657679438959,COGS 107A,A01,083627,Boyle; Mary E. T.,13,0,60,47
1657679444987,COGS 118A,A01,083075,Gupta; Anjum,21,0,76,55
1657679451009,CSE 3,A50,083646,Miranda; Gregory Joseph,24,0,50,26
1657679457033,CSE 8A,A50,083650,Miranda; Gregory Joseph,17,1,56,39
1657679463058,CSE 11,A01,083080,Cao; Yingjun,6,15,40,34
1657679469088,CSE 12,A01,083652,Krause-Levy; Sophia Louisa,28,1,120,92
1657679475112,CSE 15L,A01,083654,Morris; Justin Loren,9,0,50,41
1657679475112,CSE 15L,A02,083655,Morris; Justin Loren,9,0,50,41
1657679481136,CSE 20,A01,083657,Tran; Khoa Dang,39,0,80,41
1657679487159,CSE 21,A01,095574,Bach; Quang Tran,22,0,48,26
1657679493185,CSE 30,A01,083084,Eldon; John,6,0,80,74
1657679493185,CSE 30,B01,095061,Bhaskar; Nishant,9,0,50,41
1657679499207,CSE 100,A01,083659,Cao; Yingjun,5,4,70,65
1657679505232,CSE 134B,A01,083661,Powell; Thomas Allan,23,0,100,77
1657679511259,CSE 140,A01,083663,Gungor; Onat,15,0,85,70
1657679517286,CSE 140L,A01,083088,Eldon; John,22,0,100,78
1657679523314,CSE 175,A01,083665,Kumar; Rakesh,3,0,25,22
1657679529343,CSE 190,A00,092507,Dubnov; Shlomo,8,0,20,12
1657679535370,ECE 45,A01,083139,Congero; Spencer William,6,0,75,69
1657679541400,ECE 65,A50,083695,Saad; Andrew S,12,0,30,18
1657679541400,ECE 65,A51,095125,Saad; Andrew S,24,0,26,2
1657679547448,ECE 109,A01,091882,Touri; Behrouz,20,0,70,50
1657679553485,ECE 180,A00,083140,Abi Samra; Nicholas Camill,1,0,30,29
1657679553485,ECE 180,B00,083141,Abi Samra; Nicholas Camill,0,0,30,30
1657679559508,MATH 10A,A01,083735,Patchell; Gregory David,2,0,30,28
1657679559508,MATH 10A,A02,083736,Patchell; Gregory David,20,0,30,10
1657679559508,MATH 10A,A03,083737,Patchell; Gregory David,16,0,30,14
1657679565538,MATH 10B,A01,083207,Lim; Seonhee,8,0,34,26
1657679565538,MATH 10B,A02,083208,Lim; Seonhee,9,0,35,26
1657679565538,MATH 10B,A03,093472,Lim; Seonhee,7,0,34,27
1657679565538,MATH 10B,B01,083739,Sinha; Shubham,13,0,30,17
1657679571565,MATH 18,A01,083743,Cinel; Cameron Alexander,8,0,30,22
1657679571565,MATH 18,A02,083744,Cinel; Cameron Alexander,17,0,30,13
1657679571565,MATH 18,A03,083745,Cinel; Cameron Alexander,10,0,30,20
1657679571565,MATH 18,B01,083748,Rideout; David Porter,5,0,37,32
1657679571565,MATH 18,B02,083749,Rideout; David Porter,5,0,36,31
1657679571565,MATH 18,B03,083750,Rideout; David Porter,3,0,37,34
1657679571565,MATH 18,B04,083751,Rideout; David Porter,6,0,36,30
1657679571565,MATH 18,B05,093473,Rideout; David Porter,6,0,36,30
1657679571565,MATH 18,B06,093474,Rideout; David Porter,6,0,36,30
1657679577598,MATH 20A,A01,083754,Zheng; Zequn,14,0,40,26
1657679583623,MATH 20B,A01,083756,Briones; Jor-el Thomas Caparas,4,0,36,32
1657679583623,MATH 20B,A02,083757,Briones; Jor-el Thomas Caparas,1,0,36,35
1657679583623,MATH 20B,A03,093475,Briones; Jor-el Thomas Caparas,2,0,36,34
1657679589651,MATH 20C,A01,083760,Briones; Jor-el Thomas Caparas,1,0,35,34
1657679589651,MATH 20C,A02,083761,Briones; Jor-el Thomas Caparas,8,0,35,27
1657679589651,MATH 20C,A03,093476,Briones; Jor-el Thomas Caparas,0,1,36,36
1657679589651,MATH 20C,B01,083762,Bach; Quang Tran,1,0,30,29
1657679595679,MATH 20D,A01,083765,Tran; Brian Kha,5,0,30,25
1657679595679,MATH 20D,A02,083766,Tran; Brian Kha,5,0,30,25
1657679595679,MATH 20D,A03,083767,Tran; Brian Kha,5,0,30,25
1657679601706,MATH 20E,A01,083771,Ganguly; Soumya,9,0,32,23
1657679601706,MATH 20E,A02,083772,Ganguly; Soumya,6,0,32,26
1657679601706,MATH 20E,B01,083773,Ciotti; Benjamin,20,0,35,15
1657679601706,MATH 20E,B02,083774,Ciotti; Benjamin,18,0,35,17
1657679607735,MATH 103A,A01,083777,Greenfeld; Be'Eri,3,0,36,33
1657679607735,MATH 103A,A02,083778,Greenfeld; Be'Eri,5,0,36,31
1657679607735,MATH 103A,A03,093561,Greenfeld; Be'Eri,6,0,36,30
1657679607735,MATH 103A,B01,083779,Greenfeld; Be'Eri,7,0,36,29
1657679607735,MATH 103A,B02,083780,Greenfeld; Be'Eri,4,0,36,32
1657679607735,MATH 103A,B03,093562,Greenfeld; Be'Eri,3,0,36,33
1657679613763,MATH 105,A01,085443,Carter; Anne Toulson,15,0,35,20
1657679613763,MATH 105,A02,093477,Carter; Anne Toulson,20,0,35,15
1657679619787,MATH 109,A01,083213,Ganzberger; Geoffrey Michael,2,0,34,32
1657679619787,MATH 109,A02,083214,Ganzberger; Geoffrey Michael,4,0,34,30
1657679619787,MATH 109,A03,093478,Ganzberger; Geoffrey Michael,2,0,34,32
1657679619787,MATH 109,B01,083215,Ganzberger; Geoffrey Michael,1,0,32,31
1657679619787,MATH 109,B02,083216,Ganzberger; Geoffrey Michael,2,0,32,30
1657679619787,MATH 109,B03,093479,Ganzberger; Geoffrey Michael,8,0,32,24
1657679625821,MATH 142A,A01,083219,Chow; Bennett,7,0,32,25
1657679625821,MATH 142A,A02,083220,Chow; Bennett,10,0,32,22
1657679625821,MATH 142A,A03,093480,Chow; Bennett,9,0,32,23
1657679625821,MATH 142A,B03,093481,Chow; Bennett,8,0,32,24
1657679625821,MATH 142A,B04,093558,Chow; Bennett,13,0,32,19
1657679625821,MATH 142A,B05,093559,Chow; Bennett,6,0,32,26
1657679631845,MATH 193A,A01,083224,Rotar; Vladimir,8,0,34,26
1657679631845,MATH 193A,A02,083225,Rotar; Vladimir,9,0,34,25
1657679631845,MATH 193A,A03,083781,Rotar; Vladimir,5,0,34,29
1657679631845,MATH 193A,A04,083782,Rotar; Vladimir,10,0,34,24
1657679631845,MATH 193A,A05,093482,Rotar; Vladimir,10,0,34,24
1657679637869,MATH 197,001,091859,McAuley; Julian John,9999,0,9999,0
1657679637869,MATH 197,002,095566,Kedlaya; Kiran S.,9997,0,9999,2
1657679637869,MATH 197,003,095567,Xiao; Ming,9999,0,9999,0
1657679637869,MATH 197,004,095571,Perols; Johan Lars,9998,0,9999,1
1657679644922,COGS 9,A01,083615,Shannon; Kyle Michael,9,0,75,66
1657679650961,COGS 11,A01,083617,Boyle; Mary E. T.,23,0,48,25
1657679656985,COGS 13,A01,083071,Bastos; Amalia Pinkusfeld,11,0,71,60
1657679663010,COGS 14A,A01,092681,Semenuks; Arturs,5,1,100,95
1657679669034,COGS 14B,A01,083073,Cheng; Tzu-Han,6,0,63,57
1657679675059,COGS 17,A01,092677,Semenuks; Arturs,6,0,81,75
1657679681084,COGS 100,A01,083619,Allen; Michael Gordon,17,0,70,53
1657679687111,COGS 101A,A01,083621,Davis; Joshua Daniel,9,0,68,59
1657679693134,COGS 101B,A01,091572,Allen; Michael Gordon,12,0,65,53
1657679699158,COGS 101C,A01,083625,Delgado; Tania,17,0,35,18
1657679705181,COGS 107A,A01,083627,Boyle; Mary E. T.,13,0,60,47
1657679711204,COGS 118A,A01,083075,Gupta; Anjum,21,0,76,55
1657679717226,CSE 3,A50,083646,Miranda; Gregory Joseph,24,0,50,26
1657679723257,CSE 8A,A50,083650,Miranda; Gregory Joseph,17,1,56,39
1657679729285,CSE 11,A01,083080,Cao; Yingjun,6,15,40,34
1657679735310,CSE 12,A01,083652,Krause-Levy; Sophia Louisa,28,1,120,92
1657679741333,CSE 15L,A01,083654,Morris; Justin Loren,9,0,50,41
1657679741333,CSE 15L,A02,083655,Morris; Justin Loren,9,0,50,41
1657679747371,CSE 20,A01,083657,Tran; Khoa Dang,39,0,80,41
1657679753397,CSE 21,A01,095574,Bach; Quang Tran,22,0,48,26
1657679759423,CSE 30,A01,083084,Eldon; John,6,0,80,74
1657679759423,CSE 30,B01,095061,Bhaskar; Nishant,9,0,50,41
1657679765446,CSE 100,A01,083659,Cao; Yingjun,5,4,70,65
1657679771470,CSE 134B,A01,083661,Powell; Thomas Allan,23,0,100,77
1657679777499,CSE 140,A01,083663,Gungor; Onat,15,0,85,70
1657679783521,CSE 140L,A01,083088,Eldon; John,22,0,100,78
1657679789546,CSE 175,A01,083665,Kumar; Rakesh,3,0,25,22
1657679795568,CSE 190,A00,092507,Dubnov; Shlomo,8,0,20,12
1657679801592,ECE 45,A01,083139,Congero; Spencer William,6,0,75,69
1657679807620,ECE 65,A50,083695,Saad; Andrew S,12,0,30,18
1657679807620,ECE 65,A51,095125,Saad; Andrew S,24,0,26,2
1657679813653,ECE 109,A01,091882,Touri; Behrouz,20,0,70,50
1657679819676,ECE 180,A00,083140,Abi Samra; Nicholas Camill,1,0,30,29
1657679819676,ECE 180,B00,083141,Abi Samra; Nicholas Camill,0,0,30,30
1657679825708,MATH 10A,A01,083735,Patchell; Gregory David,2,0,30,28
1657679825708,MATH 10A,A02,083736,Patchell; Gregory David,20,0,30,10
1657679825708,MATH 10A,A03,083737,Patchell; Gregory David,16,0,30,14
1657679831737,MATH 10B,A01,083207,Lim; Seonhee,8,0,34,26
1657679831737,MATH 10B,A02,083208,Lim; Seonhee,9,0,35,26
1657679831737,MATH 10B,A03,093472,Lim; Seonhee,7,0,34,27
1657679831737,MATH 10B,B01,083739,Sinha; Shubham,13,0,30,17
1657679837762,MATH 18,A01,083743,Cinel; Cameron Alexander,8,0,30,22
1657679837762,MATH 18,A02,083744,Cinel; Cameron Alexander,17,0,30,13
1657679837762,MATH 18,A03,083745,Cinel; Cameron Alexander,10,0,30,20
1657679837762,MATH 18,B01,083748,Rideout; David Porter,5,0,37,32
1657679837762,MATH 18,B02,083749,Rideout; David Porter,5,0,36,31
1657679837762,MATH 18,B03,083750,Rideout; David Porter,3,0,37,34
1657679837762,MATH 18,B04,083751,Rideout; David Porter,6,0,36,30
1657679837762,MATH 18,B05,093473,Rideout; David Porter,6,0,36,30
1657679837762,MATH 18,B06,093474,Rideout; David Porter,6,0,36,30
1657679843785,MATH 20A,A01,083754,Zheng; Zequn,14,0,40,26
1657679849820,MATH 20B,A01,083756,Briones; Jor-el Thomas Caparas,4,0,36,32
1657679849820,MATH 20B,A02,083757,Briones; Jor-el Thomas Caparas,1,0,36,35
1657679849820,MATH 20B,A03,093475,Briones; Jor-el Thomas Caparas,2,0,36,34
1657679855848,MATH 20C,A01,083760,Briones; Jor-el Thomas Caparas,1,0,35,34
1657679855848,MATH 20C,A02,083761,Briones; Jor-el Thomas Caparas,8,0,35,27
1657679855848,MATH 20C,A03,093476,Briones; Jor-el Thomas Caparas,0,1,36,36
1657679855848,MATH 20C,B01,083762,Bach; Quang Tran,1,0,30,29
1657679861873,MATH 20D,A01,083765,Tran; Brian Kha,5,0,30,25
1657679861873,MATH 20D,A02,083766,Tran; Brian Kha,5,0,30,25
1657679861873,MATH 20D,A03,083767,Tran; Brian Kha,5,0,30,25
1657679867897,MATH 20E,A01,083771,Ganguly; Soumya,9,0,32,23
1657679867897,MATH 20E,A02,083772,Ganguly; Soumya,6,0,32,26
1657679867897,MATH 20E,B01,083773,Ciotti; Benjamin,20,0,35,15
1657679867897,MATH 20E,B02,083774,Ciotti; Benjamin,18,0,35,17
1657679873921,MATH 103A,A01,083777,Greenfeld; Be'Eri,3,0,36,33
1657679873921,MATH 103A,A02,083778,Greenfeld; Be'Eri,5,0,36,31
1657679873921,MATH 103A,A03,093561,Greenfeld; Be'Eri,6,0,36,30
1657679873921,MATH 103A,B01,083779,Greenfeld; Be'Eri,7,0,36,29
1657679873921,MATH 103A,B02,083780,Greenfeld; Be'Eri,4,0,36,32
1657679873921,MATH 103A,B03,093562,Greenfeld; Be'Eri,3,0,36,33
1657679879945,MATH 105,A01,085443,Carter; Anne Toulson,15,0,35,20
1657679879945,MATH 105,A02,093477,Carter; Anne Toulson,20,0,35,15
1657679885975,MATH 109,A01,083213,Ganzberger; Geoffrey Michael,2,0,34,32
1657679885975,MATH 109,A02,083214,Ganzberger; Geoffrey Michael,4,0,34,30
1657679885975,MATH 109,A03,093478,Ganzberger; Geoffrey Michael,2,0,34,32
1657679885975,MATH 109,B01,083215,Ganzberger; Geoffrey Michael,1,0,32,31
1657679885975,MATH 109,B02,083216,Ganzberger; Geoffrey Michael,2,0,32,30
1657679885975,MATH 109,B03,093479,Ganzberger; Geoffrey Michael,8,0,32,24
1657679892006,MATH 142A,A01,083219,Chow; Bennett,7,0,32,25
1657679892006,MATH 142A,A02,083220,Chow; Bennett,10,0,32,22
1657679892006,MATH 142A,A03,093480,Chow; Bennett,9,0,32,23
1657679892006,MATH 142A,B03,093481,Chow; Bennett,8,0,32,24
1657679892006,MATH 142A,B04,093558,Chow; Bennett,13,0,32,19
1657679892006,MATH 142A,B05,093559,Chow; Bennett,6,0,32,26
1657679898031,MATH 193A,A01,083224,Rotar; Vladimir,8,0,34,26
1657679898031,MATH 193A,A02,083225,Rotar; Vladimir,9,0,34,25
1657679898031,MATH 193A,A03,083781,Rotar; Vladimir,5,0,34,29
1657679898031,MATH 193A,A04,083782,Rotar; Vladimir,10,0,34,24
1657679898031,MATH 193A,A05,093482,Rotar; Vladimir,10,0,34,24
1657679904055,MATH 197,001,091859,McAuley; Julian John,9999,0,9999,0
1657679904055,MATH 197,002,095566,Kedlaya; Kiran S.,9997,0,9999,2
1657679904055,MATH 197,003,095567,Xiao; Ming,9999,0,9999,0
1657679904055,MATH 197,004,095571,Perols; Johan Lars,9998,0,9999,1
1657679911126,COGS 9,A01,083615,Shannon; Kyle Michael,9,0,75,66
1657679917150,COGS 11,A01,083617,Boyle; Mary E. T.,23,0,48,25
1657679923187,COGS 13,A01,083071,Bastos; Amalia Pinkusfeld,11,0,71,60
1657679929209,COGS 14A,A01,092681,Semenuks; Arturs,5,1,100,95
1657679935241,COGS 14B,A01,083073,Cheng; Tzu-Han,6,0,63,57
1657679941267,COGS 17,A01,092677,Semenuks; Arturs,6,0,81,75
1657679947291,COGS 100,A01,083619,Allen; Michael Gordon,17,0,70,53
1657679953314,COGS 101A,A01,083621,Davis; Joshua Daniel,9,0,68,59
1657679959364,COGS 101B,A01,091572,Allen; Michael Gordon,12,0,65,53
1657679965390,COGS 101C,A01,083625,Delgado; Tania,17,0,35,18
1657679971427,COGS 107A,A01,083627,Boyle; Mary E. T.,13,0,60,47
1657679977449,COGS 118A,A01,083075,Gupta; Anjum,21,0,76,55
1657679983477,CSE 3,A50,083646,Miranda; Gregory Joseph,24,0,50,26
1657679989503,CSE 8A,A50,083650,Miranda; Gregory Joseph,17,1,56,39
1657679995525,CSE 11,A01,083080,Cao; Yingjun,6,15,40,34
1657680001562,CSE 12,A01,083652,Krause-Levy; Sophia Louisa,28,1,120,92
1657680007587,CSE 15L,A01,083654,Morris; Justin Loren,9,0,50,41
1657680007587,CSE 15L,A02,083655,Morris; Justin Loren,9,0,50,41
1657680013611,CSE 20,A01,083657,Tran; Khoa Dang,39,0,80,41
1657680019740,CSE 21,A01,095574,Bach; Quang Tran,22,0,48,26
1657680025762,CSE 30,A01,083084,Eldon; John,6,0,80,74
1657680025762,CSE 30,B01,095061,Bhaskar; Nishant,9,0,50,41
1657680031788,CSE 100,A01,083659,Cao; Yingjun,5,4,70,65
1657680037819,CSE 134B,A01,083661,Powell; Thomas Allan,23,0,100,77
1657680043840,CSE 140,A01,083663,Gungor; Onat,15,0,85,70
1657680049863,CSE 140L,A01,083088,Eldon; John,22,0,100,78
1657680055886,CSE 175,A01,083665,Kumar; Rakesh,3,0,25,22
1657680061909,CSE 190,A00,092507,Dubnov; Shlomo,8,0,20,12
1657680067933,ECE 45,A01,083139,Congero; Spencer William,6,0,75,69
1657680073956,ECE 65,A50,083695,Saad; Andrew S,12,0,30,18
1657680073956,ECE 65,A51,095125,Saad; Andrew S,24,0,26,2
1657680079985,ECE 109,A01,091882,Touri; Behrouz,20,0,70,50
1657680086007,ECE 180,A00,083140,Abi Samra; Nicholas Camill,1,0,30,29
1657680086007,ECE 180,B00,083141,Abi Samra; Nicholas Camill,0,0,30,30
1657680092036,MATH 10A,A01,083735,Patchell; Gregory David,2,0,30,28
1657680092036,MATH 10A,A02,083736,Patchell; Gregory David,20,0,30,10
1657680092036,MATH 10A,A03,083737,Patchell; Gregory David,16,0,30,14
1657680098059,MATH 10B,A01,083207,Lim; Seonhee,8,0,34,26
1657680098059,MATH 10B,A02,083208,Lim; Seonhee,9,0,35,26
1657680098059,MATH 10B,A03,093472,Lim; Seonhee,7,0,34,27
1657680098059,MATH 10B,B01,083739,Sinha; Shubham,13,0,30,17
1657680104089,MATH 18,A01,083743,Cinel; Cameron Alexander,8,0,30,22
1657680104089,MATH 18,A02,083744,Cinel; Cameron Alexander,17,0,30,13
1657680104089,MATH 18,A03,083745,Cinel; Cameron Alexander,10,0,30,20
1657680104089,MATH 18,B01,083748,Rideout; David Porter,5,0,37,32
1657680104089,MATH 18,B02,083749,Rideout; David Porter,5,0,36,31
1657680104089,MATH 18,B03,083750,Rideout; David Porter,3,0,37,34
1657680104089,MATH 18,B04,083751,Rideout; David Porter,6,0,36,30
1657680104089,MATH 18,B05,093473,Rideout; David Porter,6,0,36,30
1657680104089,MATH 18,B06,093474,Rideout; David Porter,6,0,36,30
1657680110122,MATH 20A,A01,083754,Zheng; Zequn,14,0,40,26
1657680116150,MATH 20B,A01,083756,Briones; Jor-el Thomas Caparas,4,0,36,32
1657680116150,MATH 20B,A02,083757,Briones; Jor-el Thomas Caparas,1,0,36,35
1657680116150,MATH 20B,A03,093475,Briones; Jor-el Thomas Caparas,2,0,36,34
1657680122200,MATH 20C,A01,083760,Briones; Jor-el Thomas Caparas,1,0,35,34
1657680122200,MATH 20C,A02,083761,Briones; Jor-el Thomas Caparas,8,0,35,27
1657680122200,MATH 20C,A03,093476,Briones; Jor-el Thomas Caparas,0,1,36,36
1657680122200,MATH 20C,B01,083762,Bach; Quang Tran,1,0,30,29
1657680128224,MATH 20D,A01,083765,Tran; Brian Kha,5,0,30,25
1657680128224,MATH 20D,A02,083766,Tran; Brian Kha,5,0,30,25
1657680128224,MATH 20D,A03,083767,Tran; Brian Kha,5,0,30,25
1657680134250,MATH 20E,A01,083771,Ganguly; Soumya,9,0,32,23
1657680134250,MATH 20E,A02,083772,Ganguly; Soumya,6,0,32,26
1657680134250,MATH 20E,B01,083773,Ciotti; Benjamin,20,0,35,15
1657680134250,MATH 20E,B02,083774,Ciotti; Benjamin,18,0,35,17
1657680140285,MATH 103A,A01,083777,Greenfeld; Be'Eri,3,0,36,33
1657680140285,MATH 103A,A02,083778,Greenfeld; Be'Eri,5,0,36,31
1657680140285,MATH 103A,A03,093561,Greenfeld; Be'Eri,6,0,36,30
1657680140285,MATH 103A,B01,083779,Greenfeld; Be'Eri,7,0,36,29
1657680140285,MATH 103A,B02,083780,Greenfeld; Be'Eri,4,0,36,32
1657680140285,MATH 103A,B03,093562,Greenfeld; Be'Eri,3,0,36,33
1657680146308,MATH 105,A01,085443,Carter; Anne Toulson,15,0,35,20
1657680146308,MATH 105,A02,093477,Carter; Anne Toulson,20,0,35,15
1657680152332,MATH 109,A01,083213,Ganzberger; Geoffrey Michael,2,0,34,32
1657680152332,MATH 109,A02,083214,Ganzberger; Geoffrey Michael,4,0,34,30
1657680152332,MATH 109,A03,093478,Ganzberger; Geoffrey Michael,2,0,34,32
1657680152332,MATH 109,B01,083215,Ganzberger; Geoffrey Michael,1,0,32,31
1657680152332,MATH 109,B02,083216,Ganzberger; Geoffrey Michael,2,0,32,30
1657680152332,MATH 109,B03,093479,Ganzberger; Geoffrey Michael,8,0,32,24
1657680158359,MATH 142A,A01,083219,Chow; Bennett,7,0,32,25
1657680158359,MATH 142A,A02,083220,Chow; Bennett,10,0,32,22
1657680158359,MATH 142A,A03,093480,Chow; Bennett,9,0,32,23
1657680158359,MATH 142A,B03,093481,Chow; Bennett,8,0,32,24
1657680158359,MATH 142A,B04,093558,Chow; Bennett,13,0,32,19
1657680158359,MATH 142A,B05,093559,Chow; Bennett,6,0,32,26
1657680164388,MATH 193A,A01,083224,Rotar; Vladimir,8,0,34,26
1657680164388,MATH 193A,A02,083225,Rotar; Vladimir,9,0,34,25
1657680164388,MATH 193A,A03,083781,Rotar; Vladimir,5,0,34,29
1657680164388,MATH 193A,A04,083782,Rotar; Vladimir,10,0,34,24
1657680164388,MATH 193A,A05,093482,Rotar; Vladimir,10,0,34,24
1657680170413,MATH 197,001,091859,McAuley; Julian John,9999,0,9999,0
1657680170413,MATH 197,002,095566,Kedlaya; Kiran S.,9997,0,9999,2
1657680170413,MATH 197,003,095567,Xiao; Ming,9999,0,9999,0
1657680170413,MATH 197,004,095571,Perols; Johan Lars,9998,0,9999,1
1657680177484,COGS 9,A01,083615,Shannon; Kyle Michael,9,0,75,66
1657680183515,COGS 11,A01,083617,Boyle; Mary E. T.,23,0,48,25
1657680189541,COGS 13,A01,083071,Bastos; Amalia Pinkusfeld,11,0,71,60
1657680195573,COGS 14A,A01,092681,Semenuks; Arturs,5,1,100,95
1657680201604,COGS 14B,A01,083073,Cheng; Tzu-Han,6,0,63,57
1657680207630,COGS 17,A01,092677,Semenuks; Arturs,6,0,81,75
1657680213657,COGS 100,A01,083619,Allen; Michael Gordon,17,0,70,53
1657680219681,COGS 101A,A01,083621,Davis; Joshua Daniel,9,0,68,59
1657680225706,COGS 101B,A01,091572,Allen; Michael Gordon,12,0,65,53
1657680231728,COGS 101C,A01,083625,Delgado; Tania,17,0,35,18
1657680237752,COGS 107A,A01,083627,Boyle; Mary E. T.,13,0,60,47
1657680243775,COGS 118A,A01,083075,Gupta; Anjum,21,0,76,55
1657680249799,CSE 3,A50,083646,Miranda; Gregory Joseph,24,0,50,26
1657680255825,CSE 8A,A50,083650,Miranda; Gregory Joseph,17,1,56,39
1657680261847,CSE 11,A01,083080,Cao; Yingjun,6,15,40,34
1657680267869,CSE 12,A01,083652,Krause-Levy; Sophia Louisa,28,1,120,92
1657680273904,CSE 15L,A01,083654,Morris; Justin Loren,9,0,50,41
1657680273904,CSE 15L,A02,083655,Morris; Justin Loren,9,0,50,41
1657680279925,CSE 20,A01,083657,Tran; Khoa Dang,39,0,80,41
1657680285950,CSE 21,A01,095574,Bach; Quang Tran,22,0,48,26
1657680291981,CSE 30,A01,083084,Eldon; John,6,0,80,74
1657680291981,CSE 30,B01,095061,Bhaskar; Nishant,9,0,50,41
1657680298003,CSE 100,A01,083659,Cao; Yingjun,5,4,70,65
1657680304025,CSE 134B,A01,083661,Powell; Thomas Allan,23,0,100,77
1657680310048,CSE 140,A01,083663,Gungor; Onat,15,0,85,70
1657680316075,CSE 140L,A01,083088,Eldon; John,22,0,100,78
1657680322100,CSE 175,A01,083665,Kumar; Rakesh,3,0,25,22
1657680328147,CSE 190,A00,092507,Dubnov; Shlomo,8,0,20,12
1657680334169,ECE 45,A01,083139,Congero; Spencer William,6,0,75,69
1657680340199,ECE 65,A50,083695,Saad; Andrew S,12,0,30,18
1657680340199,ECE 65,A51,095125,Saad; Andrew S,24,0,26,2
1657680346227,ECE 109,A01,091882,Touri; Behrouz,20,0,70,50
1657680352253,ECE 180,A00,083140,Abi Samra; Nicholas Camill,1,0,30,29
1657680352253,ECE 180,B00,083141,Abi Samra; Nicholas Camill,0,0,30,30
1657680358281,MATH 10A,A01,083735,Patchell; Gregory David,2,0,30,28
1657680358281,MATH 10A,A02,083736,Patchell; Gregory David,20,0,30,10
1657680358281,MATH 10A,A03,083737,Patchell; Gregory David,16,0,30,14
1657680364308,MATH 10B,A01,083207,Lim; Seonhee,8,0,34,26
1657680364308,MATH 10B,A02,083208,Lim; Seonhee,9,0,35,26
1657680364308,MATH 10B,A03,093472,Lim; Seonhee,7,0,34,27
1657680364308,MATH 10B,B01,083739,Sinha; Shubham,13,0,30,17
1657680370340,MATH 18,A01,083743,Cinel; Cameron Alexander,8,0,30,22
1657680370340,MATH 18,A02,083744,Cinel; Cameron Alexander,17,0,30,13
1657680370340,MATH 18,A03,083745,Cinel; Cameron Alexander,10,0,30,20
1657680370340,MATH 18,B01,083748,Rideout; David Porter,5,0,37,32
1657680370340,MATH 18,B02,083749,Rideout; David Porter,5,0,36,31
1657680370340,MATH 18,B03,083750,Rideout; David Porter,3,0,37,34
1657680370340,MATH 18,B04,083751,Rideout; David Porter,6,0,36,30
1657680370340,MATH 18,B05,093473,Rideout; David Porter,6,0,36,30
1657680370340,MATH 18,B06,093474,Rideout; David Porter,6,0,36,30
1657680376362,MATH 20A,A01,083754,Zheng; Zequn,14,0,40,26
1657680382386,MATH 20B,A01,083756,Briones; Jor-el Thomas Caparas,4,0,36,32
1657680382386,MATH 20B,A02,083757,Briones; Jor-el Thomas Caparas,1,0,36,35
1657680382386,MATH 20B,A03,093475,Briones; Jor-el Thomas Caparas,2,0,36,34
1657680388410,MATH 20C,A01,083760,Briones; Jor-el Thomas Caparas,1,0,35,34
1657680388410,MATH 20C,A02,083761,Briones; Jor-el Thomas Caparas,8,0,35,27
1657680388410,MATH 20C,A03,093476,Briones; Jor-el Thomas Caparas,0,1,36,36
1657680388410,MATH 20C,B01,083762,Bach; Quang Tran,1,0,30,29
1657680394435,MATH 20D,A01,083765,Tran; Brian Kha,5,0,30,25
1657680394435,MATH 20D,A02,083766,Tran; Brian Kha,5,0,30,25
1657680394435,MATH 20D,A03,083767,Tran; Brian Kha,5,0,30,25
1657680400465,MATH 20E,A01,083771,Ganguly; Soumya,9,0,32,23
1657680400465,MATH 20E,A02,083772,Ganguly; Soumya,6,0,32,26
1657680400465,MATH 20E,B01,083773,Ciotti; Benjamin,20,0,35,15
1657680400465,MATH 20E,B02,083774,Ciotti; Benjamin,18,0,35,17
1657680406489,MATH 103A,A01,083777,Greenfeld; Be'Eri,3,0,36,33
1657680406489,MATH 103A,A02,083778,Greenfeld; Be'Eri,5,0,36,31
1657680406489,MATH 103A,A03,093561,Greenfeld; Be'Eri,6,0,36,30
1657680406489,MATH 103A,B01,083779,Greenfeld; Be'Eri,7,0,36,29
1657680406489,MATH 103A,B02,083780,Greenfeld; Be'Eri,4,0,36,32
1657680406489,MATH 103A,B03,093562,Greenfeld; Be'Eri,3,0,36,33
1657680412516,MATH 105,A01,085443,Carter; Anne Toulson,15,0,35,20
1657680412516,MATH 105,A02,093477,Carter; Anne Toulson,20,0,35,15
1657680418546,MATH 109,A01,083213,Ganzberger; Geoffrey Michael,2,0,34,32
1657680418546,MATH 109,A02,083214,Ganzberger; Geoffrey Michael,4,0,34,30
1657680418546,MATH 109,A03,093478,Ganzberger; Geoffrey Michael,2,0,34,32
1657680418546,MATH 109,B01,083215,Ganzberger; Geoffrey Michael,1,0,32,31
1657680418546,MATH 109,B02,083216,Ganzberger; Geoffrey Michael,2,0,32,30
1657680418546,MATH 109,B03,093479,Ganzberger; Geoffrey Michael,8,0,32,24
1657680424571,MATH 142A,A01,083219,Chow; Bennett,7,0,32,25
1657680424571,MATH 142A,A02,083220,Chow; Bennett,10,0,32,22
1657680424571,MATH 142A,A03,093480,Chow; Bennett,9,0,32,23
1657680424571,MATH 142A,B03,093481,Chow; Bennett,8,0,32,24
1657680424571,MATH 142A,B04,093558,Chow; Bennett,13,0,32,19
1657680424571,MATH 142A,B05,093559,Chow; Bennett,6,0,32,26
1657680430605,MATH 193A,A01,083224,Rotar; Vladimir,8,0,34,26
1657680430605,MATH 193A,A02,083225,Rotar; Vladimir,9,0,34,25
1657680430605,MATH 193A,A03,083781,Rotar; Vladimir,5,0,34,29
1657680430605,MATH 193A,A04,083782,Rotar; Vladimir,10,0,34,24
1657680430605,MATH 193A,A05,093482,Rotar; Vladimir,10,0,34,24
1657680436635,MATH 197,001,091859,McAuley; Julian John,9999,0,9999,0
1657680436635,MATH 197,002,095566,Kedlaya; Kiran S.,9997,0,9999,2
1657680436635,MATH 197,003,095567,Xiao; Ming,9999,0,9999,0
1657680436635,MATH 197,004,095571,Perols; Johan Lars,9998,0,9999,1
1657680443692,COGS 9,A01,083615,Shannon; Kyle Michael,9,0,75,66
1657680449717,COGS 11,A01,083617,Boyle; Mary E. T.,23,0,48,25
1657680455741,COGS 13,A01,083071,Bastos; Amalia Pinkusfeld,11,0,71,60
1657680461767,COGS 14A,A01,092681,Semenuks; Arturs,5,1,100,95
1657680467868,COGS 14B,A01,083073,Cheng; Tzu-Han,6,0,63,57
1657680473893,COGS 17,A01,092677,Semenuks; Arturs,6,0,81,75
1657680479919,COGS 100,A01,083619,Allen; Michael Gordon,17,0,70,53
1657680485942,COGS 101A,A01,083621,Davis; Joshua Daniel,9,0,68,59
1657680491964,COGS 101B,A01,091572,Allen; Michael Gordon,12,0,65,53
1657680497990,COGS 101C,A01,083625,Delgado; Tania,17,0,35,18
1657680504012,COGS 107A,A01,083627,Boyle; Mary E. T.,13,0,60,47
1657680510037,COGS 118A,A01,083075,Gupta; Anjum,21,0,76,55
1657680516064,CSE 3,A50,083646,Miranda; Gregory Joseph,24,0,50,26
1657680522092,CSE 8A,A50,083650,Miranda; Gregory Joseph,17,1,56,39
1657680528115,CSE 11,A01,083080,Cao; Yingjun,6,15,40,34
1657680534141,CSE 12,A01,083652,Krause-Levy; Sophia Louisa,28,1,120,92
1657680540169,CSE 15L,A01,083654,Morris; Justin Loren,9,0,50,41
1657680540169,CSE 15L,A02,083655,Morris; Justin Loren,9,0,50,41
1657680546193,CSE 20,A01,083657,Tran; Khoa Dang,39,0,80,41
1657680552224,CSE 21,A01,095574,Bach; Quang Tran,22,0,48,26
1657680558250,CSE 30,A01,083084,Eldon; John,6,0,80,74
1657680558250,CSE 30,B01,095061,Bhaskar; Nishant,9,0,50,41
1657680564272,CSE 100,A01,083659,Cao; Yingjun,5,4,70,65
1657680570300,CSE 134B,A01,083661,Powell; Thomas Allan,23,0,100,77
1657680576321,CSE 140,A01,083663,Gungor; Onat,15,0,85,70
1657680582343,CSE 140L,A01,083088,Eldon; John,22,0,100,78
1657680588369,CSE 175,A01,083665,Kumar; Rakesh,3,0,25,22
1657680594396,CSE 190,A00,092507,Dubnov; Shlomo,8,0,20,12
1657680600420,ECE 45,A01,083139,Congero; Spencer William,6,0,75,69
1657680606442,ECE 65,A50,083695,Saad; Andrew S,12,0,30,18
1657680606442,ECE 65,A51,095125,Saad; Andrew S,24,0,26,2
1657680612467,ECE 109,A01,091882,Touri; Behrouz,20,0,70,50
1657680618572,ECE 180,A00,083140,Abi Samra; Nicholas Camill,1,0,30,29
1657680618572,ECE 180,B00,083141,Abi Samra; Nicholas Camill,0,0,30,30
1657680624599,MATH 10A,A01,083735,Patchell; Gregory David,2,0,30,28
1657680624599,MATH 10A,A02,083736,Patchell; Gregory David,20,0,30,10
1657680624599,MATH 10A,A03,083737,Patchell; Gregory David,16,0,30,14
1657680630627,MATH 10B,A01,083207,Lim; Seonhee,8,0,34,26
1657680630627,MATH 10B,A02,083208,Lim; Seonhee,9,0,35,26
1657680630627,MATH 10B,A03,093472,Lim; Seonhee,7,0,34,27
1657680630627,MATH 10B,B01,083739,Sinha; Shubham,13,0,30,17
1657680636653,MATH 18,A01,083743,Cinel; Cameron Alexander,8,0,30,22
1657680636653,MATH 18,A02,083744,Cinel; Cameron Alexander,17,0,30,13
1657680636653,MATH 18,A03,083745,Cinel; Cameron Alexander,10,0,30,20
1657680636653,MATH 18,B01,083748,Rideout; David Porter,5,0,37,32
1657680636653,MATH 18,B02,083749,Rideout; David Porter,5,0,36,31
1657680636653,MATH 18,B03,083750,Rideout; David Porter,3,0,37,34
1657680636653,MATH 18,B04,083751,Rideout; David Porter,6,0,36,30
1657680636653,MATH 18,B05,093473,Rideout; David Porter,6,0,36,30
1657680636653,MATH 18,B06,093474,Rideout; David Porter,6,0,36,30
1657680642676,MATH 20A,A01,083754,Zheng; Zequn,14,0,40,26
1657680648712,MATH 20B,A01,083756,Briones; Jor-el Thomas Caparas,4,0,36,32
1657680648712,MATH 20B,A02,083757,Briones; Jor-el Thomas Caparas,1,0,36,35
1657680648712,MATH 20B,A03,093475,Briones; Jor-el Thomas Caparas,2,0,36,34
1657680654738,MATH 20C,A01,083760,Briones; Jor-el Thomas Caparas,1,0,35,34
1657680654738,MATH 20C,A02,083761,Briones; Jor-el Thomas Caparas,8,0,35,27
1657680654738,MATH 20C,A03,093476,Briones; Jor-el Thomas Caparas,0,1,36,36
1657680654738,MATH 20C,B01,083762,Bach; Quang Tran,1,0,30,29
1657680660772,MATH 20D,A01,083765,Tran; Brian Kha,5,0,30,25
1657680660772,MATH 20D,A02,083766,Tran; Brian Kha,5,0,30,25
1657680660772,MATH 20D,A03,083767,Tran; Brian Kha,5,0,30,25
1657680666794,MATH 20E,A01,083771,Ganguly; Soumya,9,0,32,23
1657680666794,MATH 20E,A02,083772,Ganguly; Soumya,6,0,32,26
1657680666794,MATH 20E,B01,083773,Ciotti; Benjamin,20,0,35,15
1657680666794,MATH 20E,B02,083774,Ciotti; Benjamin,18,0,35,17
1657680672818,MATH 103A,A01,083777,Greenfeld; Be'Eri,3,0,36,33
1657680672818,MATH 103A,A02,083778,Greenfeld; Be'Eri,5,0,36,31
1657680672818,MATH 103A,A03,093561,Greenfeld; Be'Eri,6,0,36,30
1657680672818,MATH 103A,B01,083779,Greenfeld; Be'Eri,7,0,36,29
1657680672818,MATH 103A,B02,083780,Greenfeld; Be'Eri,4,0,36,32
1657680672818,MATH 103A,B03,093562,Greenfeld; Be'Eri,3,0,36,33
1657680678839,MATH 105,A01,085443,Carter; Anne Toulson,15,0,35,20
1657680678839,MATH 105,A02,093477,Carter; Anne Toulson,20,0,35,15
1657680684866,MATH 109,A01,083213,Ganzberger; Geoffrey Michael,2,0,34,32
1657680684866,MATH 109,A02,083214,Ganzberger; Geoffrey Michael,4,0,34,30
1657680684866,MATH 109,A03,093478,Ganzberger; Geoffrey Michael,2,0,34,32
1657680684866,MATH 109,B01,083215,Ganzberger; Geoffrey Michael,1,0,32,31
1657680684866,MATH 109,B02,083216,Ganzberger; Geoffrey Michael,2,0,32,30
1657680684866,MATH 109,B03,093479,Ganzberger; Geoffrey Michael,8,0,32,24
1657680690889,MATH 142A,A01,083219,Chow; Bennett,7,0,32,25
1657680690889,MATH 142A,A02,083220,Chow; Bennett,10,0,32,22
1657680690889,MATH 142A,A03,093480,Chow; Bennett,9,0,32,23
1657680690889,MATH 142A,B03,093481,Chow; Bennett,8,0,32,24
1657680690889,MATH 142A,B04,093558,Chow; Bennett,13,0,32,19
1657680690889,MATH 142A,B05,093559,Chow; Bennett,6,0,32,26
1657680696918,MATH 193A,A01,083224,Rotar; Vladimir,8,0,34,26
1657680696918,MATH 193A,A02,083225,Rotar; Vladimir,9,0,34,25
1657680696918,MATH 193A,A03,083781,Rotar; Vladimir,5,0,34,29
1657680696918,MATH 193A,A04,083782,Rotar; Vladimir,10,0,34,24
1657680696918,MATH 193A,A05,093482,Rotar; Vladimir,10,0,34,24
1657680702943,MATH 197,001,091859,McAuley; Julian John,9999,0,9999,0
1657680702943,MATH 197,002,095566,Kedlaya; Kiran S.,9997,0,9999,2
1657680702943,MATH 197,003,095567,Xiao; Ming,9999,0,9999,0
1657680702943,MATH 197,004,095571,Perols; Johan Lars,9998,0,9999,1
1657680710007,COGS 9,A01,083615,Shannon; Kyle Michael,9,0,75,66
1657680716029,COGS 11,A01,083617,Boyle; Mary E. T.,23,0,48,25
1657680722054,COGS 13,A01,083071,Bastos; Amalia Pinkusfeld,11,0,71,60
1657680728077,COGS 14A,A01,092681,Semenuks; Arturs,5,1,100,95
1657680734102,COGS 14B,A01,083073,Cheng; Tzu-Han,6,0,63,57
1657680740130,COGS 17,A01,092677,Semenuks; Arturs,6,0,81,75
1657680746153,COGS 100,A01,083619,Allen; Michael Gordon,17,0,70,53
1657680752176,COGS 101A,A01,083621,Davis; Joshua Daniel,9,0,68,59
1657680758208,COGS 101B,A01,091572,Allen; Michael Gordon,12,0,65,53
1657680764234,COGS 101C,A01,083625,Delgado; Tania,17,0,35,18
1657680770259,COGS 107A,A01,083627,Boyle; Mary E. T.,13,0,60,47
1657680776286,COGS 118A,A01,083075,Gupta; Anjum,21,0,76,55
1657680782315,CSE 3,A50,083646,Miranda; Gregory Joseph,24,0,50,26
1657680788340,CSE 8A,A50,083650,Miranda; Gregory Joseph,17,1,56,39
1657680794366,CSE 11,A01,083080,Cao; Yingjun,6,15,40,34
1657680800392,CSE 12,A01,083652,Krause-Levy; Sophia Louisa,28,1,120,92
1657680806417,CSE 15L,A01,083654,Morris; Justin Loren,9,0,50,41
1657680806417,CSE 15L,A02,083655,Morris; Justin Loren,9,0,50,41
1657680812442,CSE 20,A01,083657,Tran; Khoa Dang,39,0,80,41
1657680818464,CSE 21,A01,095574,Bach; Quang Tran,22,0,48,26
1657680824491,CSE 30,A01,083084,Eldon; John,6,0,80,74
1657680824491,CSE 30,B01,095061,Bhaskar; Nishant,9,0,50,41
1657680830514,CSE 100,A01,083659,Cao; Yingjun,5,4,70,65
1657680836541,CSE 134B,A01,083661,Powell; Thomas Allan,23,0,100,77
1657680842565,CSE 140,A01,083663,Gungor; Onat,15,0,85,70
1657680848589,CSE 140L,A01,083088,Eldon; John,22,0,100,78
1657680854615,CSE 175,A01,083665,Kumar; Rakesh,3,0,25,22
1657680860641,CSE 190,A00,092507,Dubnov; Shlomo,8,0,20,12
1657680866664,ECE 45,A01,083139,Congero; Spencer William,6,0,75,69
1657680872686,ECE 65,A50,083695,Saad; Andrew S,12,0,30,18
1657680872686,ECE 65,A51,095125,Saad; Andrew S,24,0,26,2
1657680878710,ECE 109,A01,091882,Touri; Behrouz,20,0,70,50
1657680884733,ECE 180,A00,083140,Abi Samra; Nicholas Camill,1,0,30,29
1657680884733,ECE 180,B00,083141,Abi Samra; Nicholas Camill,0,0,30,30
1657680890757,MATH 10A,A01,083735,Patchell; Gregory David,2,0,30,28
1657680890757,MATH 10A,A02,083736,Patchell; Gregory David,20,0,30,10
1657680890757,MATH 10A,A03,083737,Patchell; Gregory David,16,0,30,14
1657680896782,MATH 10B,A01,083207,Lim; Seonhee,8,0,34,26
1657680896782,MATH 10B,A02,083208,Lim; Seonhee,9,0,35,26
1657680896782,MATH 10B,A03,093472,Lim; Seonhee,7,0,34,27
1657680896782,MATH 10B,B01,083739,Sinha; Shubham,13,0,30,17
1657680902813,MATH 18,A01,083743,Cinel; Cameron Alexander,8,0,30,22
1657680902813,MATH 18,A02,083744,Cinel; Cameron Alexander,17,0,30,13
1657680902813,MATH 18,A03,083745,Cinel; Cameron Alexander,10,0,30,20
1657680902813,MATH 18,B01,083748,Rideout; David Porter,5,0,37,32
1657680902813,MATH 18,B02,083749,Rideout; David Porter,5,0,36,31
1657680902813,MATH 18,B03,083750,Rideout; David Porter,3,0,37,34
1657680902813,MATH 18,B04,083751,Rideout; David Porter,6,0,36,30
1657680902813,MATH 18,B05,093473,Rideout; David Porter,6,0,36,30
1657680902813,MATH 18,B06,093474,Rideout; David Porter,6,0,36,30
1657680908835,MATH 20A,A01,083754,Zheng; Zequn,14,0,40,26
1657680914860,MATH 20B,A01,083756,Briones; Jor-el Thomas Caparas,4,0,36,32
1657680914860,MATH 20B,A02,083757,Briones; Jor-el Thomas Caparas,1,0,36,35
1657680914860,MATH 20B,A03,093475,Briones; Jor-el Thomas Caparas,2,0,36,34
1657680920883,MATH 20C,A01,083760,Briones; Jor-el Thomas Caparas,1,0,35,34
1657680920883,MATH 20C,A02,083761,Briones; Jor-el Thomas Caparas,8,0,35,27
1657680920883,MATH 20C,A03,093476,Briones; Jor-el Thomas Caparas,0,1,36,36
1657680920883,MATH 20C,B01,083762,Bach; Quang Tran,1,0,30,29
1657680926907,MATH 20D,A01,083765,Tran; Brian Kha,5,0,30,25
1657680926907,MATH 20D,A02,083766,Tran; Brian Kha,5,0,30,25
1657680926907,MATH 20D,A03,083767,Tran; Brian Kha,5,0,30,25
1657680932931,MATH 20E,A01,083771,Ganguly; Soumya,9,0,32,23
1657680932931,MATH 20E,A02,083772,Ganguly; Soumya,6,0,32,26
1657680932931,MATH 20E,B01,083773,Ciotti; Benjamin,20,0,35,15
1657680932931,MATH 20E,B02,083774,Ciotti; Benjamin,18,0,35,17
1657680938963,MATH 103A,A01,083777,Greenfeld; Be'Eri,3,0,36,33
1657680938963,MATH 103A,A02,083778,Greenfeld; Be'Eri,5,0,36,31
1657680938963,MATH 103A,A03,093561,Greenfeld; Be'Eri,6,0,36,30
1657680938963,MATH 103A,B01,083779,Greenfeld; Be'Eri,7,0,36,29
1657680938963,MATH 103A,B02,083780,Greenfeld; Be'Eri,4,0,36,32
1657680938963,MATH 103A,B03,093562,Greenfeld; Be'Eri,3,0,36,33
1657680944987,MATH 105,A01,085443,Carter; Anne Toulson,15,0,35,20
1657680944987,MATH 105,A02,093477,Carter; Anne Toulson,20,0,35,15
1657680951011,MATH 109,A01,083213,Ganzberger; Geoffrey Michael,2,0,34,32
1657680951011,MATH 109,A02,083214,Ganzberger; Geoffrey Michael,4,0,34,30
1657680951011,MATH 109,A03,093478,Ganzberger; Geoffrey Michael,2,0,34,32
1657680951011,MATH 109,B01,083215,Ganzberger; Geoffrey Michael,1,0,32,31
1657680951011,MATH 109,B02,083216,Ganzberger; Geoffrey Michael,2,0,32,30
1657680951011,MATH 109,B03,093479,Ganzberger; Geoffrey Michael,8,0,32,24
1657680957038,MATH 142A,A01,083219,Chow; Bennett,7,0,32,25
1657680957038,MATH 142A,A02,083220,Chow; Bennett,10,0,32,22
1657680957038,MATH 142A,A03,093480,Chow; Bennett,9,0,32,23
1657680957038,MATH 142A,B03,093481,Chow; Bennett,8,0,32,24
1657680957038,MATH 142A,B04,093558,Chow; Bennett,13,0,32,19
1657680957038,MATH 142A,B05,093559,Chow; Bennett,6,0,32,26
1657680963062,MATH 193A,A01,083224,Rotar; Vladimir,8,0,34,26
1657680963062,MATH 193A,A02,083225,Rotar; Vladimir,9,0,34,25
1657680963062,MATH 193A,A03,083781,Rotar; Vladimir,5,0,34,29
1657680963062,MATH 193A,A04,083782,Rotar; Vladimir,10,0,34,24
1657680963062,MATH 193A,A05,093482,Rotar; Vladimir,10,0,34,24
1657680969084,MATH 197,001,091859,McAuley; Julian John,9999,0,9999,0
1657680969084,MATH 197,002,095566,Kedlaya; Kiran S.,9997,0,9999,2
1657680969084,MATH 197,003,095567,Xiao; Ming,9999,0,9999,0
1657680969084,MATH 197,004,095571,Perols; Johan Lars,9998,0,9999,1
1657680976137,COGS 9,A01,083615,Shannon; Kyle Michael,9,0,75,66
1657680982161,COGS 11,A01,083617,Boyle; Mary E. T.,23,0,48,25
1657680988189,COGS 13,A01,083071,Bastos; Amalia Pinkusfeld,11,0,71,60
1657680994213,COGS 14A,A01,092681,Semenuks; Arturs,5,1,100,95
1657681000236,COGS 14B,A01,083073,Cheng; Tzu-Han,6,0,63,57
1657681006263,COGS 17,A01,092677,Semenuks; Arturs,6,0,81,75
1657681012286,COGS 100,A01,083619,Allen; Michael Gordon,17,0,70,53
1657681018310,COGS 101A,A01,083621,Davis; Joshua Daniel,9,0,68,59
1657681024334,COGS 101B,A01,091572,Allen; Michael Gordon,12,0,65,53
1657681030357,COGS 101C,A01,083625,Delgado; Tania,17,0,35,18
1657681036380,COGS 107A,A01,083627,Boyle; Mary E. T.,13,0,60,47
1657681042402,COGS 118A,A01,083075,Gupta; Anjum,21,0,76,55
1657681048424,CSE 3,A50,083646,Miranda; Gregory Joseph,24,0,50,26
1657681054451,CSE 8A,A50,083650,Miranda; Gregory Joseph,17,1,56,39
1657681060476,CSE 11,A01,083080,Cao; Yingjun,6,15,40,34
1657681066501,CSE 12,A01,083652,Krause-Levy; Sophia Louisa,28,1,120,92
1657681072527,CSE 15L,A01,083654,Morris; Justin Loren,9,0,50,41
1657681072527,CSE 15L,A02,083655,Morris; Justin Loren,9,0,50,41
1657681078553,CSE 20,A01,083657,Tran; Khoa Dang,39,0,80,41
1657681084576,CSE 21,A01,095574,Bach; Quang Tran,22,0,48,26
1657681090605,CSE 30,A01,083084,Eldon; John,6,0,80,74
1657681090605,CSE 30,B01,095061,Bhaskar; Nishant,9,0,50,41
1657681096638,CSE 100,A01,083659,Cao; Yingjun,5,4,70,65
1657681102665,CSE 134B,A01,083661,Powell; Thomas Allan,23,0,100,77
1657681108690,CSE 140,A01,083663,Gungor; Onat,15,0,85,70
1657681114712,CSE 140L,A01,083088,Eldon; John,22,0,100,78
1657681120734,CSE 175,A01,083665,Kumar; Rakesh,3,0,25,22
1657681126756,CSE 190,A00,092507,Dubnov; Shlomo,8,0,20,12
1657681132778,ECE 45,A01,083139,Congero; Spencer William,6,0,75,69
1657681138800,ECE 65,A50,083695,Saad; Andrew S,12,0,30,18
1657681138800,ECE 65,A51,095125,Saad; Andrew S,24,0,26,2
1657681144823,ECE 109,A01,091882,Touri; Behrouz,20,0,70,50
1657681150846,ECE 180,A00,083140,Abi Samra; Nicholas Camill,1,0,30,29
1657681150846,ECE 180,B00,083141,Abi Samra; Nicholas Camill,0,0,30,30
1657681156869,MATH 10A,A01,083735,Patchell; Gregory David,2,0,30,28
1657681156869,MATH 10A,A02,083736,Patchell; Gregory David,20,0,30,10
1657681156869,MATH 10A,A03,083737,Patchell; Gregory David,16,0,30,14
1657681162892,MATH 10B,A01,083207,Lim; Seonhee,8,0,34,26
1657681162892,MATH 10B,A02,083208,Lim; Seonhee,9,0,35,26
1657681162892,MATH 10B,A03,093472,Lim; Seonhee,7,0,34,27
1657681162892,MATH 10B,B01,083739,Sinha; Shubham,13,0,30,17
1657681168922,MATH 18,A01,083743,Cinel; Cameron Alexander,8,0,30,22
1657681168922,MATH 18,A02,083744,Cinel; Cameron Alexander,17,0,30,13
1657681168922,MATH 18,A03,083745,Cinel; Cameron Alexander,10,0,30,20
1657681168922,MATH 18,B01,083748,Rideout; David Porter,5,0,37,32
1657681168922,MATH 18,B02,083749,Rideout; David Porter,5,0,36,31
1657681168922,MATH 18,B03,083750,Rideout; David Porter,3,0,37,34
1657681168922,MATH 18,B04,083751,Rideout; David Porter,6,0,36,30
1657681168922,MATH 18,B05,093473,Rideout; David Porter,6,0,36,30
1657681168922,MATH 18,B06,093474,Rideout; David Porter,6,0,36,30
1657681174944,MATH 20A,A01,083754,Zheng; Zequn,14,0,40,26
1657681180968,MATH 20B,A01,083756,Briones; Jor-el Thomas Caparas,4,0,36,32
1657681180968,MATH 20B,A02,083757,Briones; Jor-el Thomas Caparas,1,0,36,35
1657681180968,MATH 20B,A03,093475,Briones; Jor-el Thomas Caparas,2,0,36,34
1657681186992,MATH 20C,A01,083760,Briones; Jor-el Thomas Caparas,1,0,35,34
1657681186992,MATH 20C,A02,083761,Briones; Jor-el Thomas Caparas,8,0,35,27
1657681186992,MATH 20C,A03,093476,Briones; Jor-el Thomas Caparas,0,1,36,36
1657681186992,MATH 20C,B01,083762,Bach; Quang Tran,1,0,30,29
1657681193018,MATH 20D,A01,083765,Tran; Brian Kha,5,0,30,25
1657681193018,MATH 20D,A02,083766,Tran; Brian Kha,5,0,30,25
1657681193018,MATH 20D,A03,083767,Tran; Brian Kha,5,0,30,25
1657681199040,MATH 20E,A01,083771,Ganguly; Soumya,9,0,32,23
1657681199040,MATH 20E,A02,083772,Ganguly; Soumya,6,0,32,26
1657681199040,MATH 20E,B01,083773,Ciotti; Benjamin,20,0,35,15
1657681199040,MATH 20E,B02,083774,Ciotti; Benjamin,18,0,35,17
1657681205065,MATH 103A,A01,083777,Greenfeld; Be'Eri,3,0,36,33
1657681205065,MATH 103A,A02,083778,Greenfeld; Be'Eri,5,0,36,31
1657681205065,MATH 103A,A03,093561,Greenfeld; Be'Eri,6,0,36,30
1657681205065,MATH 103A,B01,083779,Greenfeld; Be'Eri,7,0,36,29
1657681205065,MATH 103A,B02,083780,Greenfeld; Be'Eri,4,0,36,32
1657681205065,MATH 103A,B03,093562,Greenfeld; Be'Eri,3,0,36,33
1657681211092,MATH 105,A01,085443,Carter; Anne Toulson,15,0,35,20
1657681211092,MATH 105,A02,093477,Carter; Anne Toulson,20,0,35,15
1657681217188,MATH 109,A01,083213,Ganzberger; Geoffrey Michael,2,0,34,32
1657681217188,MATH 109,A02,083214,Ganzberger; Geoffrey Michael,4,0,34,30
1657681217188,MATH 109,A03,093478,Ganzberger; Geoffrey Michael,2,0,34,32
1657681217188,MATH 109,B01,083215,Ganzberger; Geoffrey Michael,1,0,32,31
1657681217188,MATH 109,B02,083216,Ganzberger; Geoffrey Michael,2,0,32,30
1657681217188,MATH 109,B03,093479,Ganzberger; Geoffrey Michael,8,0,32,24
1657681223212,MATH 142A,A01,083219,Chow; Bennett,7,0,32,25
1657681223212,MATH 142A,A02,083220,Chow; Bennett,10,0,32,22
1657681223212,MATH 142A,A03,093480,Chow; Bennett,9,0,32,23
1657681223212,MATH 142A,B03,093481,Chow; Bennett,8,0,32,24
1657681223212,MATH 142A,B04,093558,Chow; Bennett,13,0,32,19
1657681223212,MATH 142A,B05,093559,Chow; Bennett,6,0,32,26
1657681229247,MATH 193A,A01,083224,Rotar; Vladimir,8,0,34,26
1657681229247,MATH 193A,A02,083225,Rotar; Vladimir,9,0,34,25
1657681229247,MATH 193A,A03,083781,Rotar; Vladimir,5,0,34,29
1657681229247,MATH 193A,A04,083782,Rotar; Vladimir,10,0,34,24
1657681229247,MATH 193A,A05,093482,Rotar; Vladimir,10,0,34,24
1657681235269,MATH 197,001,091859,McAuley; Julian John,9999,0,9999,0
1657681235269,MATH 197,002,095566,Kedlaya; Kiran S.,9997,0,9999,2
1657681235269,MATH 197,003,095567,Xiao; Ming,9999,0,9999,0
1657681235269,MATH 197,004,095571,Perols; Johan Lars,9998,0,9999,1
1657681242329,COGS 9,A01,083615,Shannon; Kyle Michael,9,0,75,66
1657681248350,COGS 11,A01,083617,Boyle; Mary E. T.,23,0,48,25
1657681254371,COGS 13,A01,083071,Bastos; Amalia Pinkusfeld,11,0,71,60
1657681260392,COGS 14A,A01,092681,Semenuks; Arturs,5,1,100,95
1657681266414,COGS 14B,A01,083073,Cheng; Tzu-Han,6,0,63,57
1657681272435,COGS 17,A01,092677,Semenuks; Arturs,6,0,81,75
1657681278457,COGS 100,A01,083619,Allen; Michael Gordon,17,0,70,53
1657681284495,COGS 101A,A01,083621,Davis; Joshua Daniel,9,0,68,59
1657681290523,COGS 101B,A01,091572,Allen; Michael Gordon,12,0,65,53
1657681296550,COGS 101C,A01,083625,Delgado; Tania,17,0,35,18
1657681302574,COGS 107A,A01,083627,Boyle; Mary E. T.,13,0,60,47
1657681308596,COGS 118A,A01,083075,Gupta; Anjum,21,0,76,55
1657681314618,CSE 3,A50,083646,Miranda; Gregory Joseph,24,0,50,26
1657681320643,CSE 8A,A50,083650,Miranda; Gregory Joseph,17,1,56,39
1657681326676,CSE 11,A01,083080,Cao; Yingjun,6,15,40,34
1657681332700,CSE 12,A01,083652,Krause-Levy; Sophia Louisa,28,1,120,92
1657681338727,CSE 15L,A01,083654,Morris; Justin Loren,9,0,50,41
1657681338727,CSE 15L,A02,083655,Morris; Justin Loren,9,0,50,41
1657681344754,CSE 20,A01,083657,Tran; Khoa Dang,39,0,80,41
1657681350782,CSE 21,A01,095574,Bach; Quang Tran,22,0,48,26
1657681356805,CSE 30,A01,083084,Eldon; John,6,0,80,74
1657681356805,CSE 30,B01,095061,Bhaskar; Nishant,9,0,50,41
1657681362833,CSE 100,A01,083659,Cao; Yingjun,5,4,70,65
1657681368857,CSE 134B,A01,083661,Powell; Thomas Allan,23,0,100,77
1657681374879,CSE 140,A01,083663,Gungor; Onat,15,0,85,70
1657681380901,CSE 140L,A01,083088,Eldon; John,22,0,100,78
1657681386924,CSE 175,A01,083665,Kumar; Rakesh,3,0,25,22
1657681392947,CSE 190,A00,092507,Dubnov; Shlomo,8,0,20,12
1657681398974,ECE 45,A01,083139,Congero; Spencer William,6,0,75,69
1657681405005,ECE 65,A50,083695,Saad; Andrew S,12,0,30,18
1657681405005,ECE 65,A51,095125,Saad; Andrew S,24,0,26,2
1657681411031,ECE 109,A01,091882,Touri; Behrouz,20,0,70,50
1657681417057,ECE 180,A00,083140,Abi Samra; Nicholas Camill,1,0,30,29
1657681417057,ECE 180,B00,083141,Abi Samra; Nicholas Camill,0,0,30,30
1657681423084,MATH 10A,A01,083735,Patchell; Gregory David,2,0,30,28
1657681423084,MATH 10A,A02,083736,Patchell; Gregory David,20,0,30,10
1657681423084,MATH 10A,A03,083737,Patchell; Gregory David,16,0,30,14
1657681429116,MATH 10B,A01,083207,Lim; Seonhee,8,0,34,26
1657681429116,MATH 10B,A02,083208,Lim; Seonhee,9,0,35,26
1657681429116,MATH 10B,A03,093472,Lim; Seonhee,7,0,34,27
1657681429116,MATH 10B,B01,083739,Sinha; Shubham,13,0,30,17
1657681435140,MATH 18,A01,083743,Cinel; Cameron Alexander,8,0,30,22
1657681435140,MATH 18,A02,083744,Cinel; Cameron Alexander,17,0,30,13
1657681435140,MATH 18,A03,083745,Cinel; Cameron Alexander,10,0,30,20
1657681435140,MATH 18,B01,083748,Rideout; David Porter,5,0,37,32
1657681435140,MATH 18,B02,083749,Rideout; David Porter,5,0,36,31
1657681435140,MATH 18,B03,083750,Rideout; David Porter,3,0,37,34
1657681435140,MATH 18,B04,083751,Rideout; David Porter,6,0,36,30
1657681435140,MATH 18,B05,093473,Rideout; David Porter,6,0,36,30
1657681435140,MATH 18,B06,093474,Rideout; David Porter,6,0,36,30
1657681441166,MATH 20A,A01,083754,Zheng; Zequn,14,0,40,26
1657681447188,MATH 20B,A01,083756,Briones; Jor-el Thomas Caparas,4,0,36,32
1657681447188,MATH 20B,A02,083757,Briones; Jor-el Thomas Caparas,1,0,36,35
1657681447188,MATH 20B,A03,093475,Briones; Jor-el Thomas Caparas,2,0,36,34
1657681453211,MATH 20C,A01,083760,Briones; Jor-el Thomas Caparas,1,0,35,34
1657681453211,MATH 20C,A02,083761,Briones; Jor-el Thomas Caparas,8,0,35,27
1657681453211,MATH 20C,A03,093476,Briones; Jor-el Thomas Caparas,0,1,36,36
1657681453211,MATH 20C,B01,083762,Bach; Quang Tran,1,0,30,29
1657681459232,MATH 20D,A01,083765,Tran; Brian Kha,5,0,30,25
1657681459232,MATH 20D,A02,083766,Tran; Brian Kha,5,0,30,25
1657681459232,MATH 20D,A03,083767,Tran; Brian Kha,5,0,30,25
1657681465259,MATH 20E,A01,083771,Ganguly; Soumya,9,0,32,23
1657681465259,MATH 20E,A02,083772,Ganguly; Soumya,6,0,32,26
1657681465259,MATH 20E,B01,083773,Ciotti; Benjamin,20,0,35,15
1657681465259,MATH 20E,B02,083774,Ciotti; Benjamin,18,0,35,17
1657681471281,MATH 103A,A01,083777,Greenfeld; Be'Eri,3,0,36,33
1657681471281,MATH 103A,A02,083778,Greenfeld; Be'Eri,5,0,36,31
1657681471281,MATH 103A,A03,093561,Greenfeld; Be'Eri,6,0,36,30
1657681471281,MATH 103A,B01,083779,Greenfeld; Be'Eri,7,0,36,29
1657681471281,MATH 103A,B02,083780,Greenfeld; Be'Eri,4,0,36,32
1657681471281,MATH 103A,B03,093562,Greenfeld; Be'Eri,3,0,36,33
1657681477305,MATH 105,A01,085443,Carter; Anne Toulson,15,0,35,20
1657681477305,MATH 105,A02,093477,Carter; Anne Toulson,20,0,35,15
1657681483332,MATH 109,A01,083213,Ganzberger; Geoffrey Michael,2,0,34,32
1657681483332,MATH 109,A02,083214,Ganzberger; Geoffrey Michael,4,0,34,30
1657681483332,MATH 109,A03,093478,Ganzberger; Geoffrey Michael,2,0,34,32
1657681483332,MATH 109,B01,083215,Ganzberger; Geoffrey Michael,1,0,32,31
1657681483332,MATH 109,B02,083216,Ganzberger; Geoffrey Michael,2,0,32,30
1657681483332,MATH 109,B03,093479,Ganzberger; Geoffrey Michael,8,0,32,24
1657681489370,MATH 142A,A01,083219,Chow; Bennett,7,0,32,25
1657681489370,MATH 142A,A02,083220,Chow; Bennett,10,0,32,22
1657681489370,MATH 142A,A03,093480,Chow; Bennett,9,0,32,23
1657681489370,MATH 142A,B03,093481,Chow; Bennett,8,0,32,24
1657681489370,MATH 142A,B04,093558,Chow; Bennett,13,0,32,19
1657681489370,MATH 142A,B05,093559,Chow; Bennett,6,0,32,26
1657681495394,MATH 193A,A01,083224,Rotar; Vladimir,8,0,34,26
1657681495394,MATH 193A,A02,083225,Rotar; Vladimir,9,0,34,25
1657681495394,MATH 193A,A03,083781,Rotar; Vladimir,5,0,34,29
1657681495394,MATH 193A,A04,083782,Rotar; Vladimir,10,0,34,24
1657681495394,MATH 193A,A05,093482,Rotar; Vladimir,10,0,34,24
1657681501420,MATH 197,001,091859,McAuley; Julian John,9999,0,9999,0
1657681501420,MATH 197,002,095566,Kedlaya; Kiran S.,9997,0,9999,2
1657681501420,MATH 197,003,095567,Xiao; Ming,9999,0,9999,0
1657681501420,MATH 197,004,095571,Perols; Johan Lars,9998,0,9999,1
1657681508474,COGS 9,A01,083615,Shannon; Kyle Michael,9,0,75,66
1657681514502,COGS 11,A01,083617,Boyle; Mary E. T.,23,0,48,25
1657681520526,COGS 13,A01,083071,Bastos; Amalia Pinkusfeld,11,0,71,60
1657681526549,COGS 14A,A01,092681,Semenuks; Arturs,5,1,100,95
1657681532574,COGS 14B,A01,083073,Cheng; Tzu-Han,6,0,63,57
1657681538596,COGS 17,A01,092677,Semenuks; Arturs,6,0,81,75
1657681544618,COGS 100,A01,083619,Allen; Michael Gordon,17,0,70,53
1657681550641,COGS 101A,A01,083621,Davis; Joshua Daniel,9,0,68,59
1657681556664,COGS 101B,A01,091572,Allen; Michael Gordon,12,0,65,53
1657681562692,COGS 101C,A01,083625,Delgado; Tania,17,0,35,18
1657681568716,COGS 107A,A01,083627,Boyle; Mary E. T.,13,0,60,47
1657681574741,COGS 118A,A01,083075,Gupta; Anjum,21,0,76,55
1657681580764,CSE 3,A50,083646,Miranda; Gregory Joseph,24,0,50,26
1657681586791,CSE 8A,A50,083650,Miranda; Gregory Joseph,17,1,56,39
1657681592813,CSE 11,A01,083080,Cao; Yingjun,6,15,40,34
1657681598839,CSE 12,A01,083652,Krause-Levy; Sophia Louisa,28,1,120,92
1657681604862,CSE 15L,A01,083654,Morris; Justin Loren,9,0,50,41
1657681604862,CSE 15L,A02,083655,Morris; Justin Loren,9,0,50,41
1657681610883,CSE 20,A01,083657,Tran; Khoa Dang,39,0,80,41
1657681616914,CSE 21,A01,095574,Bach; Quang Tran,22,0,48,26
1657681622941,CSE 30,A01,083084,Eldon; John,6,0,80,74
1657681622941,CSE 30,B01,095061,Bhaskar; Nishant,9,0,50,41
1657681628963,CSE 100,A01,083659,Cao; Yingjun,5,4,70,65
1657681634996,CSE 134B,A01,083661,Powell; Thomas Allan,23,0,100,77
1657681641019,CSE 140,A01,083663,Gungor; Onat,15,0,85,70
1657681647045,CSE 140L,A01,083088,Eldon; John,22,0,100,78
1657681653068,CSE 175,A01,083665,Kumar; Rakesh,3,0,25,22
1657681659091,CSE 190,A00,092507,Dubnov; Shlomo,8,0,20,12
1657681665117,ECE 45,A01,083139,Congero; Spencer William,6,0,75,69
1657681671140,ECE 65,A50,083695,Saad; Andrew S,12,0,30,18
1657681671140,ECE 65,A51,095125,Saad; Andrew S,24,0,26,2
1657681677163,ECE 109,A01,091882,Touri; Behrouz,20,0,70,50
1657681683191,ECE 180,A00,083140,Abi Samra; Nicholas Camill,1,0,30,29
1657681683191,ECE 180,B00,083141,Abi Samra; Nicholas Camill,0,0,30,30
1657681689214,MATH 10A,A01,083735,Patchell; Gregory David,2,0,30,28
1657681689214,MATH 10A,A02,083736,Patchell; Gregory David,20,0,30,10
1657681689214,MATH 10A,A03,083737,Patchell; Gregory David,16,0,30,14
1657681695238,MATH 10B,A01,083207,Lim; Seonhee,8,0,34,26
1657681695238,MATH 10B,A02,083208,Lim; Seonhee,9,0,35,26
1657681695238,MATH 10B,A03,093472,Lim; Seonhee,7,0,34,27
1657681695238,MATH 10B,B01,083739,Sinha; Shubham,13,0,30,17
1657681701262,MATH 18,A01,083743,Cinel; Cameron Alexander,8,0,30,22
1657681701262,MATH 18,A02,083744,Cinel; Cameron Alexander,17,0,30,13
1657681701262,MATH 18,A03,083745,Cinel; Cameron Alexander,10,0,30,20
1657681701262,MATH 18,B01,083748,Rideout; David Porter,5,0,37,32
1657681701262,MATH 18,B02,083749,Rideout; David Porter,5,0,36,31
1657681701262,MATH 18,B03,083750,Rideout; David Porter,3,0,37,34
1657681701262,MATH 18,B04,083751,Rideout; David Porter,6,0,36,30
1657681701262,MATH 18,B05,093473,Rideout; David Porter,6,0,36,30
1657681701262,MATH 18,B06,093474,Rideout; David Porter,6,0,36,30
1657681707288,MATH 20A,A01,083754,Zheng; Zequn,14,0,40,26
1657681713311,MATH 20B,A01,083756,Briones; Jor-el Thomas Caparas,4,0,36,32
1657681713311,MATH 20B,A02,083757,Briones; Jor-el Thomas Caparas,1,0,36,35
1657681713311,MATH 20B,A03,093475,Briones; Jor-el Thomas Caparas,2,0,36,34
1657681719349,MATH 20C,A01,083760,Briones; Jor-el Thomas Caparas,1,0,35,34
1657681719349,MATH 20C,A02,083761,Briones; Jor-el Thomas Caparas,8,0,35,27
1657681719349,MATH 20C,A03,093476,Briones; Jor-el Thomas Caparas,0,1,36,36
1657681719349,MATH 20C,B01,083762,Bach; Quang Tran,1,0,30,29
1657681725373,MATH 20D,A01,083765,Tran; Brian Kha,5,0,30,25
1657681725373,MATH 20D,A02,083766,Tran; Brian Kha,5,0,30,25
1657681725373,MATH 20D,A03,083767,Tran; Brian Kha,5,0,30,25
1657681731395,MATH 20E,A01,083771,Ganguly; Soumya,9,0,32,23
1657681731395,MATH 20E,A02,083772,Ganguly; Soumya,6,0,32,26
1657681731395,MATH 20E,B01,083773,Ciotti; Benjamin,20,0,35,15
1657681731395,MATH 20E,B02,083774,Ciotti; Benjamin,18,0,35,17
1657681737421,MATH 103A,A01,083777,Greenfeld; Be'Eri,3,0,36,33
1657681737421,MATH 103A,A02,083778,Greenfeld; Be'Eri,5,0,36,31
1657681737421,MATH 103A,A03,093561,Greenfeld; Be'Eri,6,0,36,30
1657681737421,MATH 103A,B01,083779,Greenfeld; Be'Eri,7,0,36,29
1657681737421,MATH 103A,B02,083780,Greenfeld; Be'Eri,4,0,36,32
1657681737421,MATH 103A,B03,093562,Greenfeld; Be'Eri,3,0,36,33
1657681743443,MATH 105,A01,085443,Carter; Anne Toulson,15,0,35,20
1657681743443,MATH 105,A02,093477,Carter; Anne Toulson,20,0,35,15
1657681749467,MATH 109,A01,083213,Ganzberger; Geoffrey Michael,2,0,34,32
1657681749467,MATH 109,A02,083214,Ganzberger; Geoffrey Michael,4,0,34,30
1657681749467,MATH 109,A03,093478,Ganzberger; Geoffrey Michael,2,0,34,32
1657681749467,MATH 109,B01,083215,Ganzberger; Geoffrey Michael,1,0,32,31
1657681749467,MATH 109,B02,083216,Ganzberger; Geoffrey Michael,2,0,32,30
1657681749467,MATH 109,B03,093479,Ganzberger; Geoffrey Michael,8,0,32,24
1657681755491,MATH 142A,A01,083219,Chow; Bennett,7,0,32,25
1657681755491,MATH 142A,A02,083220,Chow; Bennett,10,0,32,22
1657681755491,MATH 142A,A03,093480,Chow; Bennett,9,0,32,23
1657681755491,MATH 142A,B03,093481,Chow; Bennett,8,0,32,24
1657681755491,MATH 142A,B04,093558,Chow; Bennett,13,0,32,19
1657681755491,MATH 142A,B05,093559,Chow; Bennett,6,0,32,26
1657681761521,MATH 193A,A01,083224,Rotar; Vladimir,8,0,34,26
1657681761521,MATH 193A,A02,083225,Rotar; Vladimir,9,0,34,25
1657681761521,MATH 193A,A03,083781,Rotar; Vladimir,5,0,34,29
1657681761521,MATH 193A,A04,083782,Rotar; Vladimir,10,0,34,24
1657681761521,MATH 193A,A05,093482,Rotar; Vladimir,10,0,34,24
1657681767548,MATH 197,001,091859,McAuley; Julian John,9999,0,9999,0
1657681767548,MATH 197,002,095566,Kedlaya; Kiran S.,9997,0,9999,2
1657681767548,MATH 197,003,095567,Xiao; Ming,9999,0,9999,0
1657681767548,MATH 197,004,095571,Perols; Johan Lars,9998,0,9999,1
1657681774616,COGS 9,A01,083615,Shannon; Kyle Michael,9,0,75,66
1657681780639,COGS 11,A01,083617,Boyle; Mary E. T.,23,0,48,25
1657681786667,COGS 13,A01,083071,Bastos; Amalia Pinkusfeld,11,0,71,60
1657681792694,COGS 14A,A01,092681,Semenuks; Arturs,5,1,100,95
1657681798716,COGS 14B,A01,083073,Cheng; Tzu-Han,6,0,63,57
1657681804755,COGS 17,A01,092677,Semenuks; Arturs,6,0,81,75
1657681810849,COGS 100,A01,083619,Allen; Michael Gordon,17,0,70,53
1657681816872,COGS 101A,A01,083621,Davis; Joshua Daniel,9,0,68,59
1657681822898,COGS 101B,A01,091572,Allen; Michael Gordon,12,0,65,53
1657681828926,COGS 101C,A01,083625,Delgado; Tania,17,0,35,18
1657681834954,COGS 107A,A01,083627,Boyle; Mary E. T.,13,0,60,47
1657681840993,COGS 118A,A01,083075,Gupta; Anjum,21,0,76,55
1657681847016,CSE 3,A50,083646,Miranda; Gregory Joseph,24,0,50,26
1657681853039,CSE 8A,A50,083650,Miranda; Gregory Joseph,17,1,56,39
1657681859062,CSE 11,A01,083080,Cao; Yingjun,6,15,40,34
1657681865085,CSE 12,A01,083652,Krause-Levy; Sophia Louisa,28,1,120,92
1657681871111,CSE 15L,A01,083654,Morris; Justin Loren,9,0,50,41
1657681871111,CSE 15L,A02,083655,Morris; Justin Loren,9,0,50,41
1657681877134,CSE 20,A01,083657,Tran; Khoa Dang,39,0,80,41
1657681883157,CSE 21,A01,095574,Bach; Quang Tran,22,0,48,26
1657681889191,CSE 30,A01,083084,Eldon; John,6,0,80,74
1657681889191,CSE 30,B01,095061,Bhaskar; Nishant,9,0,50,41
1657681895214,CSE 100,A01,083659,Cao; Yingjun,5,4,70,65
1657681901238,CSE 134B,A01,083661,Powell; Thomas Allan,23,0,100,77
1657681907275,CSE 140,A01,083663,Gungor; Onat,15,0,85,70
1657681913308,CSE 140L,A01,083088,Eldon; John,22,0,100,78
1657681919335,CSE 175,A01,083665,Kumar; Rakesh,3,0,25,22
1657681925363,CSE 190,A00,092507,Dubnov; Shlomo,8,0,20,12
1657681931391,ECE 45,A01,083139,Congero; Spencer William,6,0,75,69
1657681937414,ECE 65,A50,083695,Saad; Andrew S,12,0,30,18
1657681937414,ECE 65,A51,095125,Saad; Andrew S,24,0,26,2
1657681943441,ECE 109,A01,091882,Touri; Behrouz,20,0,70,50
1657681949472,ECE 180,A00,083140,Abi Samra; Nicholas Camill,1,0,30,29
1657681949472,ECE 180,B00,083141,Abi Samra; Nicholas Camill,0,0,30,30
1657681955500,MATH 10A,A01,083735,Patchell; Gregory David,2,0,30,28
1657681955500,MATH 10A,A02,083736,Patchell; Gregory David,20,0,30,10
1657681955500,MATH 10A,A03,083737,Patchell; Gregory David,16,0,30,14
1657681961525,MATH 10B,A01,083207,Lim; Seonhee,8,0,34,26
1657681961525,MATH 10B,A02,083208,Lim; Seonhee,9,0,35,26
1657681961525,MATH 10B,A03,093472,Lim; Seonhee,7,0,34,27
1657681961525,MATH 10B,B01,083739,Sinha; Shubham,13,0,30,17
1657681967548,MATH 18,A01,083743,Cinel; Cameron Alexander,8,0,30,22
1657681967548,MATH 18,A02,083744,Cinel; Cameron Alexander,17,0,30,13
1657681967548,MATH 18,A03,083745,Cinel; Cameron Alexander,10,0,30,20
1657681967548,MATH 18,B01,083748,Rideout; David Porter,5,0,37,32
1657681967548,MATH 18,B02,083749,Rideout; David Porter,5,0,36,31
1657681967548,MATH 18,B03,083750,Rideout; David Porter,3,0,37,34
1657681967548,MATH 18,B04,083751,Rideout; David Porter,6,0,36,30
1657681967548,MATH 18,B05,093473,Rideout; David Porter,6,0,36,30
1657681967548,MATH 18,B06,093474,Rideout; David Porter,6,0,36,30
1657681973575,MATH 20A,A01,083754,Zheng; Zequn,14,0,40,26
1657681979602,MATH 20B,A01,083756,Briones; Jor-el Thomas Caparas,4,0,36,32
1657681979602,MATH 20B,A02,083757,Briones; Jor-el Thomas Caparas,1,0,36,35
1657681979602,MATH 20B,A03,093475,Briones; Jor-el Thomas Caparas,2,0,36,34
1657681985625,MATH 20C,A01,083760,Briones; Jor-el Thomas Caparas,1,0,35,34
1657681985625,MATH 20C,A02,083761,Briones; Jor-el Thomas Caparas,8,0,35,27
1657681985625,MATH 20C,A03,093476,Briones; Jor-el Thomas Caparas,0,1,36,36
1657681985625,MATH 20C,B01,083762,Bach; Quang Tran,1,0,30,29
1657681991651,MATH 20D,A01,083765,Tran; Brian Kha,5,0,30,25
1657681991651,MATH 20D,A02,083766,Tran; Brian Kha,5,0,30,25
1657681991651,MATH 20D,A03,083767,Tran; Brian Kha,5,0,30,25
1657681997674,MATH 20E,A01,083771,Ganguly; Soumya,9,0,32,23
1657681997674,MATH 20E,A02,083772,Ganguly; Soumya,6,0,32,26
1657681997674,MATH 20E,B01,083773,Ciotti; Benjamin,20,0,35,15
1657681997674,MATH 20E,B02,083774,Ciotti; Benjamin,18,0,35,17
1657682003705,MATH 103A,A01,083777,Greenfeld; Be'Eri,3,0,36,33
1657682003705,MATH 103A,A02,083778,Greenfeld; Be'Eri,5,0,36,31
1657682003705,MATH 103A,A03,093561,Greenfeld; Be'Eri,6,0,36,30
1657682003705,MATH 103A,B01,083779,Greenfeld; Be'Eri,7,0,36,29
1657682003705,MATH 103A,B02,083780,Greenfeld; Be'Eri,4,0,36,32
1657682003705,MATH 103A,B03,093562,Greenfeld; Be'Eri,3,0,36,33
1657682009727,MATH 105,A01,085443,Carter; Anne Toulson,15,0,35,20
1657682009727,MATH 105,A02,093477,Carter; Anne Toulson,20,0,35,15
1657682015751,MATH 109,A01,083213,Ganzberger; Geoffrey Michael,2,0,34,32
1657682015751,MATH 109,A02,083214,Ganzberger; Geoffrey Michael,4,0,34,30
1657682015751,MATH 109,A03,093478,Ganzberger; Geoffrey Michael,2,0,34,32
1657682015751,MATH 109,B01,083215,Ganzberger; Geoffrey Michael,1,0,32,31
1657682015751,MATH 109,B02,083216,Ganzberger; Geoffrey Michael,2,0,32,30
1657682015751,MATH 109,B03,093479,Ganzberger; Geoffrey Michael,8,0,32,24
1657682021774,MATH 142A,A01,083219,Chow; Bennett,7,0,32,25
1657682021774,MATH 142A,A02,083220,Chow; Bennett,10,0,32,22
1657682021774,MATH 142A,A03,093480,Chow; Bennett,9,0,32,23
1657682021774,MATH 142A,B03,093481,Chow; Bennett,8,0,32,24
1657682021774,MATH 142A,B04,093558,Chow; Bennett,13,0,32,19
1657682021774,MATH 142A,B05,093559,Chow; Bennett,6,0,32,26
1657682027804,MATH 193A,A01,083224,Rotar; Vladimir,8,0,34,26
1657682027804,MATH 193A,A02,083225,Rotar; Vladimir,9,0,34,25
1657682027804,MATH 193A,A03,083781,Rotar; Vladimir,5,0,34,29
1657682027804,MATH 193A,A04,083782,Rotar; Vladimir,10,0,34,24
1657682027804,MATH 193A,A05,093482,Rotar; Vladimir,10,0,34,24
1657682033827,MATH 197,001,091859,McAuley; Julian John,9999,0,9999,0
1657682033827,MATH 197,002,095566,Kedlaya; Kiran S.,9997,0,9999,2
1657682033827,MATH 197,003,095567,Xiao; Ming,9999,0,9999,0
1657682033827,MATH 197,004,095571,Perols; Johan Lars,9998,0,9999,1
1657682040878,COGS 9,A01,083615,Shannon; Kyle Michael,9,0,75,66
1657682046904,COGS 11,A01,083617,Boyle; Mary E. T.,23,0,48,25
1657682052928,COGS 13,A01,083071,Bastos; Amalia Pinkusfeld,11,0,71,60
1657682058961,COGS 14A,A01,092681,Semenuks; Arturs,5,1,100,95
1657682064985,COGS 14B,A01,083073,Cheng; Tzu-Han,6,0,63,57
1657682071007,COGS 17,A01,092677,Semenuks; Arturs,6,0,81,75
1657682077030,COGS 100,A01,083619,Allen; Michael Gordon,17,0,70,53
1657682083057,COGS 101A,A01,083621,Davis; Joshua Daniel,9,0,68,59
1657682089084,COGS 101B,A01,091572,Allen; Michael Gordon,12,0,65,53
1657682095107,COGS 101C,A01,083625,Delgado; Tania,17,0,35,18
1657682101131,COGS 107A,A01,083627,Boyle; Mary E. T.,13,0,60,47
1657682107157,COGS 118A,A01,083075,Gupta; Anjum,21,0,76,55
1657682113184,CSE 3,A50,083646,Miranda; Gregory Joseph,24,0,50,26
1657682119213,CSE 8A,A50,083650,Miranda; Gregory Joseph,17,1,56,39
1657682125239,CSE 11,A01,083080,Cao; Yingjun,6,15,40,34
1657682131263,CSE 12,A01,083652,Krause-Levy; Sophia Louisa,28,1,120,92
1657682137291,CSE 15L,A01,083654,Morris; Justin Loren,9,0,50,41
1657682137291,CSE 15L,A02,083655,Morris; Justin Loren,9,0,50,41
1657682143315,CSE 20,A01,083657,Tran; Khoa Dang,39,0,80,41
1657682149337,CSE 21,A01,095574,Bach; Quang Tran,22,0,48,26
1657682155365,CSE 30,A01,083084,Eldon; John,6,0,80,74
1657682155365,CSE 30,B01,095061,Bhaskar; Nishant,9,0,50,41
1657682161390,CSE 100,A01,083659,Cao; Yingjun,5,4,70,65
1657682167415,CSE 134B,A01,083661,Powell; Thomas Allan,23,0,100,77
1657682173440,CSE 140,A01,083663,Gungor; Onat,15,0,85,70
1657682179468,CSE 140L,A01,083088,Eldon; John,22,0,100,78
1657682185494,CSE 175,A01,083665,Kumar; Rakesh,3,0,25,22
1657682191518,CSE 190,A00,092507,Dubnov; Shlomo,8,0,20,12
1657682197542,ECE 45,A01,083139,Congero; Spencer William,6,0,75,69
1657682203567,ECE 65,A50,083695,Saad; Andrew S,12,0,30,18
1657682203567,ECE 65,A51,095125,Saad; Andrew S,24,0,26,2
1657682209594,ECE 109,A01,091882,Touri; Behrouz,20,0,70,50
1657682215619,ECE 180,A00,083140,Abi Samra; Nicholas Camill,1,0,30,29
1657682215619,ECE 180,B00,083141,Abi Samra; Nicholas Camill,0,0,30,30
1657682221644,MATH 10A,A01,083735,Patchell; Gregory David,2,0,30,28
1657682221644,MATH 10A,A02,083736,Patchell; Gregory David,20,0,30,10
1657682221644,MATH 10A,A03,083737,Patchell; Gregory David,16,0,30,14
1657682227667,MATH 10B,A01,083207,Lim; Seonhee,8,0,34,26
1657682227667,MATH 10B,A02,083208,Lim; Seonhee,9,0,35,26
1657682227667,MATH 10B,A03,093472,Lim; Seonhee,7,0,34,27
1657682227667,MATH 10B,B01,083739,Sinha; Shubham,13,0,30,17
1657682233700,MATH 18,A01,083743,Cinel; Cameron Alexander,8,0,30,22
1657682233700,MATH 18,A02,083744,Cinel; Cameron Alexander,17,0,30,13
1657682233700,MATH 18,A03,083745,Cinel; Cameron Alexander,10,0,30,20
1657682233700,MATH 18,B01,083748,Rideout; David Porter,5,0,37,32
1657682233700,MATH 18,B02,083749,Rideout; David Porter,5,0,36,31
1657682233700,MATH 18,B03,083750,Rideout; David Porter,3,0,37,34
1657682233700,MATH 18,B04,083751,Rideout; David Porter,6,0,36,30
1657682233700,MATH 18,B05,093473,Rideout; David Porter,6,0,36,30
1657682233700,MATH 18,B06,093474,Rideout; David Porter,6,0,36,30
1657682239724,MATH 20A,A01,083754,Zheng; Zequn,14,0,40,26
1657682245748,MATH 20B,A01,083756,Briones; Jor-el Thomas Caparas,4,0,36,32
1657682245748,MATH 20B,A02,083757,Briones; Jor-el Thomas Caparas,1,0,36,35
1657682245748,MATH 20B,A03,093475,Briones; Jor-el Thomas Caparas,2,0,36,34
1657682251776,MATH 20C,A01,083760,Briones; Jor-el Thomas Caparas,1,0,35,34
1657682251776,MATH 20C,A02,083761,Briones; Jor-el Thomas Caparas,8,0,35,27
1657682251776,MATH 20C,A03,093476,Briones; Jor-el Thomas Caparas,0,1,36,36
1657682251776,MATH 20C,B01,083762,Bach; Quang Tran,1,0,30,29
1657682257798,MATH 20D,A01,083765,Tran; Brian Kha,5,0,30,25
1657682257798,MATH 20D,A02,083766,Tran; Brian Kha,5,0,30,25
1657682257798,MATH 20D,A03,083767,Tran; Brian Kha,5,0,30,25
1657682263828,MATH 20E,A01,083771,Ganguly; Soumya,9,0,32,23
1657682263828,MATH 20E,A02,083772,Ganguly; Soumya,6,0,32,26
1657682263828,MATH 20E,B01,083773,Ciotti; Benjamin,20,0,35,15
1657682263828,MATH 20E,B02,083774,Ciotti; Benjamin,18,0,35,17
1657682269854,MATH 103A,A01,083777,Greenfeld; Be'Eri,3,0,36,33
1657682269854,MATH 103A,A02,083778,Greenfeld; Be'Eri,5,0,36,31
1657682269854,MATH 103A,A03,093561,Greenfeld; Be'Eri,6,0,36,30
1657682269854,MATH 103A,B01,083779,Greenfeld; Be'Eri,7,0,36,29
1657682269854,MATH 103A,B02,083780,Greenfeld; Be'Eri,4,0,36,32
1657682269854,MATH 103A,B03,093562,Greenfeld; Be'Eri,3,0,36,33
1657682275880,MATH 105,A01,085443,Carter; Anne Toulson,15,0,35,20
1657682275880,MATH 105,A02,093477,Carter; Anne Toulson,20,0,35,15
1657682281933,MATH 109,A01,083213,Ganzberger; Geoffrey Michael,2,0,34,32
1657682281933,MATH 109,A02,083214,Ganzberger; Geoffrey Michael,4,0,34,30
1657682281933,MATH 109,A03,093478,Ganzberger; Geoffrey Michael,2,0,34,32
1657682281933,MATH 109,B01,083215,Ganzberger; Geoffrey Michael,1,0,32,31
1657682281933,MATH 109,B02,083216,Ganzberger; Geoffrey Michael,2,0,32,30
1657682281933,MATH 109,B03,093479,Ganzberger; Geoffrey Michael,8,0,32,24
1657682287980,MATH 142A,A01,083219,Chow; Bennett,7,0,32,25
1657682287980,MATH 142A,A02,083220,Chow; Bennett,10,0,32,22
1657682287980,MATH 142A,A03,093480,Chow; Bennett,9,0,32,23
1657682287980,MATH 142A,B03,093481,Chow; Bennett,8,0,32,24
1657682287980,MATH 142A,B04,093558,Chow; Bennett,13,0,32,19
1657682287980,MATH 142A,B05,093559,Chow; Bennett,6,0,32,26
1657682294003,MATH 193A,A01,083224,Rotar; Vladimir,8,0,34,26
1657682294003,MATH 193A,A02,083225,Rotar; Vladimir,9,0,34,25
1657682294003,MATH 193A,A03,083781,Rotar; Vladimir,5,0,34,29
1657682294003,MATH 193A,A04,083782,Rotar; Vladimir,10,0,34,24
1657682294003,MATH 193A,A05,093482,Rotar; Vladimir,10,0,34,24
1657682300030,MATH 197,001,091859,McAuley; Julian John,9999,0,9999,0
1657682300030,MATH 197,002,095566,Kedlaya; Kiran S.,9997,0,9999,2
1657682300030,MATH 197,003,095567,Xiao; Ming,9999,0,9999,0
1657682300030,MATH 197,004,095571,Perols; Johan Lars,9998,0,9999,1
1657682307084,COGS 9,A01,083615,Shannon; Kyle Michael,9,0,75,66
1657682313108,COGS 11,A01,083617,Boyle; Mary E. T.,23,0,48,25
1657682319134,COGS 13,A01,083071,Bastos; Amalia Pinkusfeld,11,0,71,60
1657682325156,COGS 14A,A01,092681,Semenuks; Arturs,5,1,100,95
1657682331184,COGS 14B,A01,083073,Cheng; Tzu-Han,6,0,63,57
1657682337211,COGS 17,A01,092677,Semenuks; Arturs,6,0,81,75
1657682343236,COGS 100,A01,083619,Allen; Michael Gordon,17,0,70,53
1657682349260,COGS 101A,A01,083621,Davis; Joshua Daniel,9,0,68,59
1657682355287,COGS 101B,A01,091572,Allen; Michael Gordon,12,0,65,53
1657682361309,COGS 101C,A01,083625,Delgado; Tania,17,0,35,18
1657682367332,COGS 107A,A01,083627,Boyle; Mary E. T.,13,0,60,47
1657682373355,COGS 118A,A01,083075,Gupta; Anjum,21,0,76,55
1657682379378,CSE 3,A50,083646,Miranda; Gregory Joseph,24,0,50,26
1657682385407,CSE 8A,A50,083650,Miranda; Gregory Joseph,17,1,56,39
1657682391429,CSE 11,A01,083080,Cao; Yingjun,6,15,40,34
1657682397452,CSE 12,A01,083652,Krause-Levy; Sophia Louisa,28,1,120,92
1657682403479,CSE 15L,A01,083654,Morris; Justin Loren,9,0,50,41
1657682403479,CSE 15L,A02,083655,Morris; Justin Loren,9,0,50,41
1657682409571,CSE 20,A01,083657,Tran; Khoa Dang,39,0,80,41
1657682415608,CSE 21,A01,095574,Bach; Quang Tran,22,0,48,26
1657682421637,CSE 30,A01,083084,Eldon; John,6,0,80,74
1657682421637,CSE 30,B01,095061,Bhaskar; Nishant,9,0,50,41
1657682427665,CSE 100,A01,083659,Cao; Yingjun,5,4,70,65
1657682433697,CSE 134B,A01,083661,Powell; Thomas Allan,23,0,100,77
1657682439720,CSE 140,A01,083663,Gungor; Onat,15,0,85,70
1657682445744,CSE 140L,A01,083088,Eldon; John,22,0,100,78
1657682451770,CSE 175,A01,083665,Kumar; Rakesh,3,0,25,22
1657682457793,CSE 190,A00,092507,Dubnov; Shlomo,8,0,20,12
1657682463817,ECE 45,A01,083139,Congero; Spencer William,6,0,75,69
1657682469846,ECE 65,A50,083695,Saad; Andrew S,12,0,30,18
1657682469846,ECE 65,A51,095125,Saad; Andrew S,24,0,26,2
1657682475869,ECE 109,A01,091882,Touri; Behrouz,20,0,70,50
1657682481892,ECE 180,A00,083140,Abi Samra; Nicholas Camill,1,0,30,29
1657682481892,ECE 180,B00,083141,Abi Samra; Nicholas Camill,0,0,30,30
1657682487914,MATH 10A,A01,083735,Patchell; Gregory David,2,0,30,28
1657682487914,MATH 10A,A02,083736,Patchell; Gregory David,20,0,30,10
1657682487914,MATH 10A,A03,083737,Patchell; Gregory David,16,0,30,14
1657682493939,MATH 10B,A01,083207,Lim; Seonhee,8,0,34,26
1657682493939,MATH 10B,A02,083208,Lim; Seonhee,9,0,35,26
1657682493939,MATH 10B,A03,093472,Lim; Seonhee,7,0,34,27
1657682493939,MATH 10B,B01,083739,Sinha; Shubham,13,0,30,17
1657682499962,MATH 18,A01,083743,Cinel; Cameron Alexander,8,0,30,22
1657682499962,MATH 18,A02,083744,Cinel; Cameron Alexander,17,0,30,13
1657682499962,MATH 18,A03,083745,Cinel; Cameron Alexander,10,0,30,20
1657682499962,MATH 18,B01,083748,Rideout; David Porter,5,0,37,32
1657682499962,MATH 18,B02,083749,Rideout; David Porter,5,0,36,31
1657682499962,MATH 18,B03,083750,Rideout; David Porter,3,0,37,34
1657682499962,MATH 18,B04,083751,Rideout; David Porter,6,0,36,30
1657682499962,MATH 18,B05,093473,Rideout; David Porter,6,0,36,30
1657682499962,MATH 18,B06,093474,Rideout; David Porter,6,0,36,30
1657682505984,MATH 20A,A01,083754,Zheng; Zequn,14,0,40,26
1657682512011,MATH 20B,A01,083756,Briones; Jor-el Thomas Caparas,4,0,36,32
1657682512011,MATH 20B,A02,083757,Briones; Jor-el Thomas Caparas,1,0,36,35
1657682512011,MATH 20B,A03,093475,Briones; Jor-el Thomas Caparas,2,0,36,34
1657682518035,MATH 20C,A01,083760,Briones; Jor-el Thomas Caparas,1,0,35,34
1657682518035,MATH 20C,A02,083761,Briones; Jor-el Thomas Caparas,8,0,35,27
1657682518035,MATH 20C,A03,093476,Briones; Jor-el Thomas Caparas,0,1,36,36
1657682518035,MATH 20C,B01,083762,Bach; Quang Tran,1,0,30,29
1657682524063,MATH 20D,A01,083765,Tran; Brian Kha,5,0,30,25
1657682524063,MATH 20D,A02,083766,Tran; Brian Kha,5,0,30,25
1657682524063,MATH 20D,A03,083767,Tran; Brian Kha,5,0,30,25
1657682530086,MATH 20E,A01,083771,Ganguly; Soumya,9,0,32,23
1657682530086,MATH 20E,A02,083772,Ganguly; Soumya,6,0,32,26
1657682530086,MATH 20E,B01,083773,Ciotti; Benjamin,20,0,35,15
1657682530086,MATH 20E,B02,083774,Ciotti; Benjamin,18,0,35,17
1657682536116,MATH 103A,A01,083777,Greenfeld; Be'Eri,3,0,36,33
1657682536116,MATH 103A,A02,083778,Greenfeld; Be'Eri,5,0,36,31
1657682536116,MATH 103A,A03,093561,Greenfeld; Be'Eri,6,0,36,30
1657682536116,MATH 103A,B01,083779,Greenfeld; Be'Eri,7,0,36,29
1657682536116,MATH 103A,B02,083780,Greenfeld; Be'Eri,4,0,36,32
1657682536116,MATH 103A,B03,093562,Greenfeld; Be'Eri,3,0,36,33
1657682542143,MATH 105,A01,085443,Carter; Anne Toulson,15,0,35,20
1657682542143,MATH 105,A02,093477,Carter; Anne Toulson,20,0,35,15
1657682548168,MATH 109,A01,083213,Ganzberger; Geoffrey Michael,2,0,34,32
1657682548168,MATH 109,A02,083214,Ganzberger; Geoffrey Michael,4,0,34,30
1657682548168,MATH 109,A03,093478,Ganzberger; Geoffrey Michael,2,0,34,32
1657682548168,MATH 109,B01,083215,Ganzberger; Geoffrey Michael,1,0,32,31
1657682548168,MATH 109,B02,083216,Ganzberger; Geoffrey Michael,2,0,32,30
1657682548168,MATH 109,B03,093479,Ganzberger; Geoffrey Michael,8,0,32,24
1657682554197,MATH 142A,A01,083219,Chow; Bennett,7,0,32,25
1657682554197,MATH 142A,A02,083220,Chow; Bennett,10,0,32,22
1657682554197,MATH 142A,A03,093480,Chow; Bennett,9,0,32,23
1657682554197,MATH 142A,B03,093481,Chow; Bennett,8,0,32,24
1657682554197,MATH 142A,B04,093558,Chow; Bennett,13,0,32,19
1657682554197,MATH 142A,B05,093559,Chow; Bennett,6,0,32,26
1657682560226,MATH 193A,A01,083224,Rotar; Vladimir,8,0,34,26
1657682560226,MATH 193A,A02,083225,Rotar; Vladimir,9,0,34,25
1657682560226,MATH 193A,A03,083781,Rotar; Vladimir,5,0,34,29
1657682560226,MATH 193A,A04,083782,Rotar; Vladimir,10,0,34,24
1657682560226,MATH 193A,A05,093482,Rotar; Vladimir,10,0,34,24
1657682566249,MATH 197,001,091859,McAuley; Julian John,9999,0,9999,0
1657682566249,MATH 197,002,095566,Kedlaya; Kiran S.,9997,0,9999,2
1657682566249,MATH 197,003,095567,Xiao; Ming,9999,0,9999,0
1657682566249,MATH 197,004,095571,Perols; Johan Lars,9998,0,9999,1
1657682573309,COGS 9,A01,083615,Shannon; Kyle Michael,9,0,75,66
1657682579345,COGS 11,A01,083617,Boyle; Mary E. T.,23,0,48,25
1657682585368,COGS 13,A01,083071,Bastos; Amalia Pinkusfeld,11,0,71,60
1657682591400,COGS 14A,A01,092681,Semenuks; Arturs,5,1,100,95
1657682597428,COGS 14B,A01,083073,Cheng; Tzu-Han,6,0,63,57
1657682603455,COGS 17,A01,092677,Semenuks; Arturs,6,0,81,75
1657682609477,COGS 100,A01,083619,Allen; Michael Gordon,17,0,70,53
1657682615501,COGS 101A,A01,083621,Davis; Joshua Daniel,9,0,68,59
1657682621523,COGS 101B,A01,091572,Allen; Michael Gordon,12,0,65,53
1657682627548,COGS 101C,A01,083625,Delgado; Tania,17,0,35,18
1657682633577,COGS 107A,A01,083627,Boyle; Mary E. T.,13,0,60,47
1657682639599,COGS 118A,A01,083075,Gupta; Anjum,21,0,76,55
1657682645621,CSE 3,A50,083646,Miranda; Gregory Joseph,24,0,50,26
1657682651646,CSE 8A,A50,083650,Miranda; Gregory Joseph,17,1,56,39
1657682657670,CSE 11,A01,083080,Cao; Yingjun,6,15,40,34
1657682663692,CSE 12,A01,083652,Krause-Levy; Sophia Louisa,28,1,120,92
1657682669714,CSE 15L,A01,083654,Morris; Justin Loren,9,0,50,41
1657682669714,CSE 15L,A02,083655,Morris; Justin Loren,9,0,50,41
1657682675741,CSE 20,A01,083657,Tran; Khoa Dang,39,0,80,41
1657682681767,CSE 21,A01,095574,Bach; Quang Tran,22,0,48,26
1657682687792,CSE 30,A01,083084,Eldon; John,6,0,80,74
1657682687792,CSE 30,B01,095061,Bhaskar; Nishant,9,0,50,41
1657682693818,CSE 100,A01,083659,Cao; Yingjun,5,4,70,65
1657682699842,CSE 134B,A01,083661,Powell; Thomas Allan,23,0,100,77
1657682705864,CSE 140,A01,083663,Gungor; Onat,15,0,85,70
1657682711886,CSE 140L,A01,083088,Eldon; John,22,0,100,78
1657682717908,CSE 175,A01,083665,Kumar; Rakesh,3,0,25,22
1657682723935,CSE 190,A00,092507,Dubnov; Shlomo,8,0,20,12
1657682729962,ECE 45,A01,083139,Congero; Spencer William,6,0,75,69
1657682735990,ECE 65,A50,083695,Saad; Andrew S,12,0,30,18
1657682735990,ECE 65,A51,095125,Saad; Andrew S,24,0,26,2
1657682742024,ECE 109,A01,091882,Touri; Behrouz,20,0,70,50
1657682748050,ECE 180,A00,083140,Abi Samra; Nicholas Camill,1,0,30,29
1657682748050,ECE 180,B00,083141,Abi Samra; Nicholas Camill,0,0,30,30
1657682754072,MATH 10A,A01,083735,Patchell; Gregory David,2,0,30,28
1657682754072,MATH 10A,A02,083736,Patchell; Gregory David,20,0,30,10
1657682754072,MATH 10A,A03,083737,Patchell; Gregory David,16,0,30,14
1657682760102,MATH 10B,A01,083207,Lim; Seonhee,8,0,34,26
1657682760102,MATH 10B,A02,083208,Lim; Seonhee,9,0,35,26
1657682760102,MATH 10B,A03,093472,Lim; Seonhee,7,0,34,27
1657682760102,MATH 10B,B01,083739,Sinha; Shubham,13,0,30,17
1657682766126,MATH 18,A01,083743,Cinel; Cameron Alexander,8,0,30,22
1657682766126,MATH 18,A02,083744,Cinel; Cameron Alexander,17,0,30,13
1657682766126,MATH 18,A03,083745,Cinel; Cameron Alexander,10,0,30,20
1657682766126,MATH 18,B01,083748,Rideout; David Porter,5,0,37,32
1657682766126,MATH 18,B02,083749,Rideout; David Porter,5,0,36,31
1657682766126,MATH 18,B03,083750,Rideout; David Porter,3,0,37,34
1657682766126,MATH 18,B04,083751,Rideout; David Porter,6,0,36,30
1657682766126,MATH 18,B05,093473,Rideout; David Porter,6,0,36,30
1657682766126,MATH 18,B06,093474,Rideout; David Porter,6,0,36,30
1657682772151,MATH 20A,A01,083754,Zheng; Zequn,14,0,40,26
1657682778181,MATH 20B,A01,083756,Briones; Jor-el Thomas Caparas,4,0,36,32
1657682778181,MATH 20B,A02,083757,Briones; Jor-el Thomas Caparas,1,0,36,35
1657682778181,MATH 20B,A03,093475,Briones; Jor-el Thomas Caparas,2,0,36,34
1657682784205,MATH 20C,A01,083760,Briones; Jor-el Thomas Caparas,1,0,35,34
1657682784205,MATH 20C,A02,083761,Briones; Jor-el Thomas Caparas,8,0,35,27
1657682784205,MATH 20C,A03,093476,Briones; Jor-el Thomas Caparas,0,1,36,36
1657682784205,MATH 20C,B01,083762,Bach; Quang Tran,1,0,30,29
1657682790228,MATH 20D,A01,083765,Tran; Brian Kha,5,0,30,25
1657682790228,MATH 20D,A02,083766,Tran; Brian Kha,5,0,30,25
1657682790228,MATH 20D,A03,083767,Tran; Brian Kha,5,0,30,25
1657682796255,MATH 20E,A01,083771,Ganguly; Soumya,9,0,32,23
1657682796255,MATH 20E,A02,083772,Ganguly; Soumya,6,0,32,26
1657682796255,MATH 20E,B01,083773,Ciotti; Benjamin,20,0,35,15
1657682796255,MATH 20E,B02,083774,Ciotti; Benjamin,18,0,35,17
1657682802286,MATH 103A,A01,083777,Greenfeld; Be'Eri,3,0,36,33
1657682802286,MATH 103A,A02,083778,Greenfeld; Be'Eri,5,0,36,31
1657682802286,MATH 103A,A03,093561,Greenfeld; Be'Eri,6,0,36,30
1657682802286,MATH 103A,B01,083779,Greenfeld; Be'Eri,7,0,36,29
1657682802286,MATH 103A,B02,083780,Greenfeld; Be'Eri,4,0,36,32
1657682802286,MATH 103A,B03,093562,Greenfeld; Be'Eri,3,0,36,33
1657682808318,MATH 105,A01,085443,Carter; Anne Toulson,15,0,35,20
1657682808318,MATH 105,A02,093477,Carter; Anne Toulson,20,0,35,15
1657682814346,MATH 109,A01,083213,Ganzberger; Geoffrey Michael,2,0,34,32
1657682814346,MATH 109,A02,083214,Ganzberger; Geoffrey Michael,4,0,34,30
1657682814346,MATH 109,A03,093478,Ganzberger; Geoffrey Michael,2,0,34,32
1657682814346,MATH 109,B01,083215,Ganzberger; Geoffrey Michael,1,0,32,31
1657682814346,MATH 109,B02,083216,Ganzberger; Geoffrey Michael,2,0,32,30
1657682814346,MATH 109,B03,093479,Ganzberger; Geoffrey Michael,8,0,32,24
1657682820376,MATH 142A,A01,083219,Chow; Bennett,7,0,32,25
1657682820376,MATH 142A,A02,083220,Chow; Bennett,10,0,32,22
1657682820376,MATH 142A,A03,093480,Chow; Bennett,9,0,32,23
1657682820376,MATH 142A,B03,093481,Chow; Bennett,8,0,32,24
1657682820376,MATH 142A,B04,093558,Chow; Bennett,13,0,32,19
1657682820376,MATH 142A,B05,093559,Chow; Bennett,6,0,32,26
1657682826402,MATH 193A,A01,083224,Rotar; Vladimir,8,0,34,26
1657682826402,MATH 193A,A02,083225,Rotar; Vladimir,9,0,34,25
1657682826402,MATH 193A,A03,083781,Rotar; Vladimir,5,0,34,29
1657682826402,MATH 193A,A04,083782,Rotar; Vladimir,10,0,34,24
1657682826402,MATH 193A,A05,093482,Rotar; Vladimir,10,0,34,24
1657682832428,MATH 197,001,091859,McAuley; Julian John,9999,0,9999,0
1657682832428,MATH 197,002,095566,Kedlaya; Kiran S.,9997,0,9999,2
1657682832428,MATH 197,003,095567,Xiao; Ming,9999,0,9999,0
1657682832428,MATH 197,004,095571,Perols; Johan Lars,9998,0,9999,1
1657682839486,COGS 9,A01,083615,Shannon; Kyle Michael,9,0,75,66
1657682845514,COGS 11,A01,083617,Boyle; Mary E. T.,23,0,48,25
1657682851537,COGS 13,A01,083071,Bastos; Amalia Pinkusfeld,11,0,71,60
1657682857563,COGS 14A,A01,092681,Semenuks; Arturs,5,1,100,95
1657682863592,COGS 14B,A01,083073,Cheng; Tzu-Han,6,0,63,57
1657682869614,COGS 17,A01,092677,Semenuks; Arturs,6,0,81,75
1657682875640,COGS 100,A01,083619,Allen; Michael Gordon,17,0,70,53
1657682881666,COGS 101A,A01,083621,Davis; Joshua Daniel,9,0,68,59
1657682887695,COGS 101B,A01,091572,Allen; Michael Gordon,12,0,65,53
1657682893718,COGS 101C,A01,083625,Delgado; Tania,17,0,35,18
1657682899741,COGS 107A,A01,083627,Boyle; Mary E. T.,13,0,60,47
1657682905768,COGS 118A,A01,083075,Gupta; Anjum,21,0,76,55
1657682911796,CSE 3,A50,083646,Miranda; Gregory Joseph,24,0,50,26
1657682917821,CSE 8A,A50,083650,Miranda; Gregory Joseph,17,1,56,39
1657682923847,CSE 11,A01,083080,Cao; Yingjun,6,15,40,34
1657682929875,CSE 12,A01,083652,Krause-Levy; Sophia Louisa,28,1,120,92
1657682935897,CSE 15L,A01,083654,Morris; Justin Loren,9,0,50,41
1657682935897,CSE 15L,A02,083655,Morris; Justin Loren,9,0,50,41
1657682941921,CSE 20,A01,083657,Tran; Khoa Dang,39,0,80,41
1657682947950,CSE 21,A01,095574,Bach; Quang Tran,22,0,48,26
1657682953973,CSE 30,A01,083084,Eldon; John,6,0,80,74
1657682953973,CSE 30,B01,095061,Bhaskar; Nishant,9,0,50,41
1657682959999,CSE 100,A01,083659,Cao; Yingjun,5,4,70,65
1657682966024,CSE 134B,A01,083661,Powell; Thomas Allan,23,0,100,77
1657682972051,CSE 140,A01,083663,Gungor; Onat,15,0,85,70
1657682978074,CSE 140L,A01,083088,Eldon; John,22,0,100,78
1657682984097,CSE 175,A01,083665,Kumar; Rakesh,3,0,25,22
1657682990119,CSE 190,A00,092507,Dubnov; Shlomo,8,0,20,12
1657682996143,ECE 45,A01,083139,Congero; Spencer William,6,0,75,69
1657683002167,ECE 65,A50,083695,Saad; Andrew S,12,0,30,18
1657683002167,ECE 65,A51,095125,Saad; Andrew S,24,0,26,2
1657683008282,ECE 109,A01,091882,Touri; Behrouz,20,0,70,50
1657683014304,ECE 180,A00,083140,Abi Samra; Nicholas Camill,1,0,30,29
1657683014304,ECE 180,B00,083141,Abi Samra; Nicholas Camill,0,0,30,30
1657683020345,MATH 10A,A01,083735,Patchell; Gregory David,2,0,30,28
1657683020345,MATH 10A,A02,083736,Patchell; Gregory David,20,0,30,10
1657683020345,MATH 10A,A03,083737,Patchell; Gregory David,16,0,30,14
1657683026379,MATH 10B,A01,083207,Lim; Seonhee,8,0,34,26
1657683026379,MATH 10B,A02,083208,Lim; Seonhee,9,0,35,26
1657683026379,MATH 10B,A03,093472,Lim; Seonhee,7,0,34,27
1657683026379,MATH 10B,B01,083739,Sinha; Shubham,13,0,30,17
1657683032404,MATH 18,A01,083743,Cinel; Cameron Alexander,8,0,30,22
1657683032404,MATH 18,A02,083744,Cinel; Cameron Alexander,17,0,30,13
1657683032404,MATH 18,A03,083745,Cinel; Cameron Alexander,10,0,30,20
1657683032404,MATH 18,B01,083748,Rideout; David Porter,5,0,37,32
1657683032404,MATH 18,B02,083749,Rideout; David Porter,5,0,36,31
1657683032404,MATH 18,B03,083750,Rideout; David Porter,3,0,37,34
1657683032404,MATH 18,B04,083751,Rideout; David Porter,6,0,36,30
1657683032404,MATH 18,B05,093473,Rideout; David Porter,6,0,36,30
1657683032404,MATH 18,B06,093474,Rideout; David Porter,6,0,36,30
1657683038426,MATH 20A,A01,083754,Zheng; Zequn,14,0,40,26
1657683044450,MATH 20B,A01,083756,Briones; Jor-el Thomas Caparas,4,0,36,32
1657683044450,MATH 20B,A02,083757,Briones; Jor-el Thomas Caparas,1,0,36,35
1657683044450,MATH 20B,A03,093475,Briones; Jor-el Thomas Caparas,2,0,36,34
1657683050479,MATH 20C,A01,083760,Briones; Jor-el Thomas Caparas,1,0,35,34
1657683050479,MATH 20C,A02,083761,Briones; Jor-el Thomas Caparas,8,0,35,27
1657683050479,MATH 20C,A03,093476,Briones; Jor-el Thomas Caparas,0,1,36,36
1657683050479,MATH 20C,B01,083762,Bach; Quang Tran,1,0,30,29
1657683056504,MATH 20D,A01,083765,Tran; Brian Kha,5,0,30,25
1657683056504,MATH 20D,A02,083766,Tran; Brian Kha,5,0,30,25
1657683056504,MATH 20D,A03,083767,Tran; Brian Kha,5,0,30,25
1657683062533,MATH 20E,A01,083771,Ganguly; Soumya,9,0,32,23
1657683062533,MATH 20E,A02,083772,Ganguly; Soumya,6,0,32,26
1657683062533,MATH 20E,B01,083773,Ciotti; Benjamin,20,0,35,15
1657683062533,MATH 20E,B02,083774,Ciotti; Benjamin,18,0,35,17
1657683068556,MATH 103A,A01,083777,Greenfeld; Be'Eri,3,0,36,33
1657683068556,MATH 103A,A02,083778,Greenfeld; Be'Eri,5,0,36,31
1657683068556,MATH 103A,A03,093561,Greenfeld; Be'Eri,6,0,36,30
1657683068556,MATH 103A,B01,083779,Greenfeld; Be'Eri,7,0,36,29
1657683068556,MATH 103A,B02,083780,Greenfeld; Be'Eri,4,0,36,32
1657683068556,MATH 103A,B03,093562,Greenfeld; Be'Eri,3,0,36,33
1657683074578,MATH 105,A01,085443,Carter; Anne Toulson,15,0,35,20
1657683074578,MATH 105,A02,093477,Carter; Anne Toulson,20,0,35,15
1657683080601,MATH 109,A01,083213,Ganzberger; Geoffrey Michael,2,0,34,32
1657683080601,MATH 109,A02,083214,Ganzberger; Geoffrey Michael,4,0,34,30
1657683080601,MATH 109,A03,093478,Ganzberger; Geoffrey Michael,2,0,34,32
1657683080601,MATH 109,B01,083215,Ganzberger; Geoffrey Michael,1,0,32,31
1657683080601,MATH 109,B02,083216,Ganzberger; Geoffrey Michael,2,0,32,30
1657683080601,MATH 109,B03,093479,Ganzberger; Geoffrey Michael,8,0,32,24
1657683086624,MATH 142A,A01,083219,Chow; Bennett,7,0,32,25
1657683086624,MATH 142A,A02,083220,Chow; Bennett,10,0,32,22
1657683086624,MATH 142A,A03,093480,Chow; Bennett,9,0,32,23
1657683086624,MATH 142A,B03,093481,Chow; Bennett,8,0,32,24
1657683086624,MATH 142A,B04,093558,Chow; Bennett,13,0,32,19
1657683086624,MATH 142A,B05,093559,Chow; Bennett,6,0,32,26
1657683092648,MATH 193A,A01,083224,Rotar; Vladimir,8,0,34,26
1657683092648,MATH 193A,A02,083225,Rotar; Vladimir,9,0,34,25
1657683092648,MATH 193A,A03,083781,Rotar; Vladimir,5,0,34,29
1657683092648,MATH 193A,A04,083782,Rotar; Vladimir,10,0,34,24
1657683092648,MATH 193A,A05,093482,Rotar; Vladimir,10,0,34,24
1657683098671,MATH 197,001,091859,McAuley; Julian John,9999,0,9999,0
1657683098671,MATH 197,002,095566,Kedlaya; Kiran S.,9997,0,9999,2
1657683098671,MATH 197,003,095567,Xiao; Ming,9999,0,9999,0
1657683098671,MATH 197,004,095571,Perols; Johan Lars,9998,0,9999,1
1657683105727,COGS 9,A01,083615,Shannon; Kyle Michael,9,0,75,66
1657683111755,COGS 11,A01,083617,Boyle; Mary E. T.,23,0,48,25
1657683117779,COGS 13,A01,083071,Bastos; Amalia Pinkusfeld,11,0,71,60
1657683123814,COGS 14A,A01,092681,Semenuks; Arturs,5,1,100,95
1657683129841,COGS 14B,A01,083073,Cheng; Tzu-Han,6,0,63,57
1657683135876,COGS 17,A01,092677,Semenuks; Arturs,6,0,81,75
1657683141900,COGS 100,A01,083619,Allen; Michael Gordon,17,0,70,53
1657683147923,COGS 101A,A01,083621,Davis; Joshua Daniel,9,0,68,59
1657683153953,COGS 101B,A01,091572,Allen; Michael Gordon,12,0,65,53
1657683159977,COGS 101C,A01,083625,Delgado; Tania,17,0,35,18
1657683166017,COGS 107A,A01,083627,Boyle; Mary E. T.,13,0,60,47
1657683172044,COGS 118A,A01,083075,Gupta; Anjum,21,0,76,55
1657683178073,CSE 3,A50,083646,Miranda; Gregory Joseph,24,0,50,26
1657683184097,CSE 8A,A50,083650,Miranda; Gregory Joseph,17,1,56,39
1657683190122,CSE 11,A01,083080,Cao; Yingjun,6,15,40,34
1657683196145,CSE 12,A01,083652,Krause-Levy; Sophia Louisa,28,1,120,92
1657683202170,CSE 15L,A01,083654,Morris; Justin Loren,9,0,50,41
1657683202170,CSE 15L,A02,083655,Morris; Justin Loren,9,0,50,41
1657683208192,CSE 20,A01,083657,Tran; Khoa Dang,39,0,80,41
1657683214218,CSE 21,A01,095574,Bach; Quang Tran,22,0,48,26
1657683220245,CSE 30,A01,083084,Eldon; John,6,0,80,74
1657683220245,CSE 30,B01,095061,Bhaskar; Nishant,9,0,50,41
1657683226267,CSE 100,A01,083659,Cao; Yingjun,5,4,70,65
1657683232294,CSE 134B,A01,083661,Powell; Thomas Allan,23,0,100,77
1657683238318,CSE 140,A01,083663,Gungor; Onat,15,0,85,70
1657683244343,CSE 140L,A01,083088,Eldon; John,22,0,100,78
1657683250367,CSE 175,A01,083665,Kumar; Rakesh,3,0,25,22
1657683256394,CSE 190,A00,092507,Dubnov; Shlomo,8,0,20,12
1657683262416,ECE 45,A01,083139,Congero; Spencer William,6,0,75,69
1657683268440,ECE 65,A50,083695,Saad; Andrew S,12,0,30,18
1657683268440,ECE 65,A51,095125,Saad; Andrew S,24,0,26,2
1657683274475,ECE 109,A01,091882,Touri; Behrouz,20,0,70,50
1657683280497,ECE 180,A00,083140,Abi Samra; Nicholas Camill,1,0,30,29
1657683280497,ECE 180,B00,083141,Abi Samra; Nicholas Camill,0,0,30,30
1657683286525,MATH 10A,A01,083735,Patchell; Gregory David,2,0,30,28
1657683286525,MATH 10A,A02,083736,Patchell; Gregory David,20,0,30,10
1657683286525,MATH 10A,A03,083737,Patchell; Gregory David,16,0,30,14
1657683292550,MATH 10B,A01,083207,Lim; Seonhee,8,0,34,26
1657683292550,MATH 10B,A02,083208,Lim; Seonhee,9,0,35,26
1657683292550,MATH 10B,A03,093472,Lim; Seonhee,7,0,34,27
1657683292550,MATH 10B,B01,083739,Sinha; Shubham,13,0,30,17
1657683298574,MATH 18,A01,083743,Cinel; Cameron Alexander,8,0,30,22
1657683298574,MATH 18,A02,083744,Cinel; Cameron Alexander,17,0,30,13
1657683298574,MATH 18,A03,083745,Cinel; Cameron Alexander,10,0,30,20
1657683298574,MATH 18,B01,083748,Rideout; David Porter,5,0,37,32
1657683298574,MATH 18,B02,083749,Rideout; David Porter,5,0,36,31
1657683298574,MATH 18,B03,083750,Rideout; David Porter,3,0,37,34
1657683298574,MATH 18,B04,083751,Rideout; David Porter,6,0,36,30
1657683298574,MATH 18,B05,093473,Rideout; David Porter,6,0,36,30
1657683298574,MATH 18,B06,093474,Rideout; David Porter,6,0,36,30
1657683304597,MATH 20A,A01,083754,Zheng; Zequn,14,0,40,26
1657683310619,MATH 20B,A01,083756,Briones; Jor-el Thomas Caparas,4,0,36,32
1657683310619,MATH 20B,A02,083757,Briones; Jor-el Thomas Caparas,1,0,36,35
1657683310619,MATH 20B,A03,093475,Briones; Jor-el Thomas Caparas,2,0,36,34
1657683316648,MATH 20C,A01,083760,Briones; Jor-el Thomas Caparas,1,0,35,34
1657683316648,MATH 20C,A02,083761,Briones; Jor-el Thomas Caparas,8,0,35,27
1657683316648,MATH 20C,A03,093476,Briones; Jor-el Thomas Caparas,0,1,36,36
1657683316648,MATH 20C,B01,083762,Bach; Quang Tran,1,0,30,29
1657683322675,MATH 20D,A01,083765,Tran; Brian Kha,5,0,30,25
1657683322675,MATH 20D,A02,083766,Tran; Brian Kha,5,0,30,25
1657683322675,MATH 20D,A03,083767,Tran; Brian Kha,5,0,30,25
1657683328702,MATH 20E,A01,083771,Ganguly; Soumya,9,0,32,23
1657683328702,MATH 20E,A02,083772,Ganguly; Soumya,6,0,32,26
1657683328702,MATH 20E,B01,083773,Ciotti; Benjamin,20,0,35,15
1657683328702,MATH 20E,B02,083774,Ciotti; Benjamin,18,0,35,17
1657683334731,MATH 103A,A01,083777,Greenfeld; Be'Eri,3,0,36,33
1657683334731,MATH 103A,A02,083778,Greenfeld; Be'Eri,5,0,36,31
1657683334731,MATH 103A,A03,093561,Greenfeld; Be'Eri,6,0,36,30
1657683334731,MATH 103A,B01,083779,Greenfeld; Be'Eri,7,0,36,29
1657683334731,MATH 103A,B02,083780,Greenfeld; Be'Eri,4,0,36,32
1657683334731,MATH 103A,B03,093562,Greenfeld; Be'Eri,3,0,36,33
1657683340754,MATH 105,A01,085443,Carter; Anne Toulson,15,0,35,20
1657683340754,MATH 105,A02,093477,Carter; Anne Toulson,20,0,35,15
1657683346781,MATH 109,A01,083213,Ganzberger; Geoffrey Michael,2,0,34,32
1657683346781,MATH 109,A02,083214,Ganzberger; Geoffrey Michael,4,0,34,30
1657683346781,MATH 109,A03,093478,Ganzberger; Geoffrey Michael,2,0,34,32
1657683346781,MATH 109,B01,083215,Ganzberger; Geoffrey Michael,1,0,32,31
1657683346781,MATH 109,B02,083216,Ganzberger; Geoffrey Michael,2,0,32,30
1657683346781,MATH 109,B03,093479,Ganzberger; Geoffrey Michael,8,0,32,24
1657683352809,MATH 142A,A01,083219,Chow; Bennett,7,0,32,25
1657683352809,MATH 142A,A02,083220,Chow; Bennett,10,0,32,22
1657683352809,MATH 142A,A03,093480,Chow; Bennett,9,0,32,23
1657683352809,MATH 142A,B03,093481,Chow; Bennett,8,0,32,24
1657683352809,MATH 142A,B04,093558,Chow; Bennett,13,0,32,19
1657683352809,MATH 142A,B05,093559,Chow; Bennett,6,0,32,26
1657683358831,MATH 193A,A01,083224,Rotar; Vladimir,8,0,34,26
1657683358831,MATH 193A,A02,083225,Rotar; Vladimir,9,0,34,25
1657683358831,MATH 193A,A03,083781,Rotar; Vladimir,5,0,34,29
1657683358831,MATH 193A,A04,083782,Rotar; Vladimir,10,0,34,24
1657683358831,MATH 193A,A05,093482,Rotar; Vladimir,10,0,34,24
1657683364854,MATH 197,001,091859,McAuley; Julian John,9999,0,9999,0
1657683364854,MATH 197,002,095566,Kedlaya; Kiran S.,9997,0,9999,2
1657683364854,MATH 197,003,095567,Xiao; Ming,9999,0,9999,0
1657683364854,MATH 197,004,095571,Perols; Johan Lars,9998,0,9999,1
1657683371906,COGS 9,A01,083615,Shannon; Kyle Michael,9,0,75,66
1657683377928,COGS 11,A01,083617,Boyle; Mary E. T.,23,0,48,25
1657683383951,COGS 13,A01,083071,Bastos; Amalia Pinkusfeld,11,0,71,60
1657683389987,COGS 14A,A01,092681,Semenuks; Arturs,5,1,100,95
1657683396012,COGS 14B,A01,083073,Cheng; Tzu-Han,6,0,63,57
1657683402034,COGS 17,A01,092677,Semenuks; Arturs,6,0,81,75
1657683408057,COGS 100,A01,083619,Allen; Michael Gordon,17,0,70,53
1657683414092,COGS 101A,A01,083621,Davis; Joshua Daniel,9,0,68,59
1657683420120,COGS 101B,A01,091572,Allen; Michael Gordon,12,0,65,53
1657683426143,COGS 101C,A01,083625,Delgado; Tania,17,0,35,18
1657683432170,COGS 107A,A01,083627,Boyle; Mary E. T.,13,0,60,47
1657683438204,COGS 118A,A01,083075,Gupta; Anjum,21,0,76,55
1657683444243,CSE 3,A50,083646,Miranda; Gregory Joseph,24,0,50,26
1657683450270,CSE 8A,A50,083650,Miranda; Gregory Joseph,17,1,56,39
1657683456297,CSE 11,A01,083080,Cao; Yingjun,6,15,40,34
1657683462319,CSE 12,A01,083652,Krause-Levy; Sophia Louisa,28,1,120,92
1657683468343,CSE 15L,A01,083654,Morris; Justin Loren,9,0,50,41
1657683468343,CSE 15L,A02,083655,Morris; Justin Loren,9,0,50,41
1657683474373,CSE 20,A01,083657,Tran; Khoa Dang,39,0,80,41
1657683480397,CSE 21,A01,095574,Bach; Quang Tran,22,0,48,26
1657683486421,CSE 30,A01,083084,Eldon; John,6,0,80,74
1657683486421,CSE 30,B01,095061,Bhaskar; Nishant,9,0,50,41
1657683492448,CSE 100,A01,083659,Cao; Yingjun,5,4,70,65
1657683498478,CSE 134B,A01,083661,Powell; Thomas Allan,23,0,100,77
1657683504500,CSE 140,A01,083663,Gungor; Onat,15,0,85,70
1657683510527,CSE 140L,A01,083088,Eldon; John,22,0,100,78
1657683516556,CSE 175,A01,083665,Kumar; Rakesh,3,0,25,22
1657683522581,CSE 190,A00,092507,Dubnov; Shlomo,8,0,20,12
1657683528607,ECE 45,A01,083139,Congero; Spencer William,6,0,75,69
1657683534632,ECE 65,A50,083695,Saad; Andrew S,12,0,30,18
1657683534632,ECE 65,A51,095125,Saad; Andrew S,24,0,26,2
1657683540655,ECE 109,A01,091882,Touri; Behrouz,20,0,70,50
1657683546689,ECE 180,A00,083140,Abi Samra; Nicholas Camill,1,0,30,29
1657683546689,ECE 180,B00,083141,Abi Samra; Nicholas Camill,0,0,30,30
1657683552716,MATH 10A,A01,083735,Patchell; Gregory David,2,0,30,28
1657683552716,MATH 10A,A02,083736,Patchell; Gregory David,20,0,30,10
1657683552716,MATH 10A,A03,083737,Patchell; Gregory David,16,0,30,14
1657683558741,MATH 10B,A01,083207,Lim; Seonhee,8,0,34,26
1657683558741,MATH 10B,A02,083208,Lim; Seonhee,9,0,35,26
1657683558741,MATH 10B,A03,093472,Lim; Seonhee,7,0,34,27
1657683558741,MATH 10B,B01,083739,Sinha; Shubham,13,0,30,17
1657683564765,MATH 18,A01,083743,Cinel; Cameron Alexander,8,0,30,22
1657683564765,MATH 18,A02,083744,Cinel; Cameron Alexander,17,0,30,13
1657683564765,MATH 18,A03,083745,Cinel; Cameron Alexander,10,0,30,20
1657683564765,MATH 18,B01,083748,Rideout; David Porter,5,0,37,32
1657683564765,MATH 18,B02,083749,Rideout; David Porter,5,0,36,31
1657683564765,MATH 18,B03,083750,Rideout; David Porter,3,0,37,34
1657683564765,MATH 18,B04,083751,Rideout; David Porter,6,0,36,30
1657683564765,MATH 18,B05,093473,Rideout; David Porter,6,0,36,30
1657683564765,MATH 18,B06,093474,Rideout; David Porter,6,0,36,30
1657683570787,MATH 20A,A01,083754,Zheng; Zequn,14,0,40,26
1657683576815,MATH 20B,A01,083756,Briones; Jor-el Thomas Caparas,4,0,36,32
1657683576815,MATH 20B,A02,083757,Briones; Jor-el Thomas Caparas,1,0,36,35
1657683576815,MATH 20B,A03,093475,Briones; Jor-el Thomas Caparas,2,0,36,34
1657683582845,MATH 20C,A01,083760,Briones; Jor-el Thomas Caparas,1,0,35,34
1657683582845,MATH 20C,A02,083761,Briones; Jor-el Thomas Caparas,8,0,35,27
1657683582845,MATH 20C,A03,093476,Briones; Jor-el Thomas Caparas,0,1,36,36
1657683582845,MATH 20C,B01,083762,Bach; Quang Tran,1,0,30,29
1657683588874,MATH 20D,A01,083765,Tran; Brian Kha,5,0,30,25
1657683588874,MATH 20D,A02,083766,Tran; Brian Kha,5,0,30,25
1657683588874,MATH 20D,A03,083767,Tran; Brian Kha,5,0,30,25
1657683594901,MATH 20E,A01,083771,Ganguly; Soumya,9,0,32,23
1657683594901,MATH 20E,A02,083772,Ganguly; Soumya,6,0,32,26
1657683594901,MATH 20E,B01,083773,Ciotti; Benjamin,20,0,35,15
1657683594901,MATH 20E,B02,083774,Ciotti; Benjamin,18,0,35,17
1657683600931,MATH 103A,A01,083777,Greenfeld; Be'Eri,3,0,36,33
1657683600931,MATH 103A,A02,083778,Greenfeld; Be'Eri,5,0,36,31
1657683600931,MATH 103A,A03,093561,Greenfeld; Be'Eri,6,0,36,30
1657683600931,MATH 103A,B01,083779,Greenfeld; Be'Eri,7,0,36,29
1657683600931,MATH 103A,B02,083780,Greenfeld; Be'Eri,4,0,36,32
1657683600931,MATH 103A,B03,093562,Greenfeld; Be'Eri,3,0,36,33
1657683607066,MATH 105,A01,085443,Carter; Anne Toulson,15,0,35,20
1657683607066,MATH 105,A02,093477,Carter; Anne Toulson,20,0,35,15
1657683613089,MATH 109,A01,083213,Ganzberger; Geoffrey Michael,2,0,34,32
1657683613089,MATH 109,A02,083214,Ganzberger; Geoffrey Michael,4,0,34,30
1657683613089,MATH 109,A03,093478,Ganzberger; Geoffrey Michael,2,0,34,32
1657683613089,MATH 109,B01,083215,Ganzberger; Geoffrey Michael,1,0,32,31
1657683613089,MATH 109,B02,083216,Ganzberger; Geoffrey Michael,2,0,32,30
1657683613089,MATH 109,B03,093479,Ganzberger; Geoffrey Michael,8,0,32,24
1657683619115,MATH 142A,A01,083219,Chow; Bennett,7,0,32,25
1657683619115,MATH 142A,A02,083220,Chow; Bennett,10,0,32,22
1657683619115,MATH 142A,A03,093480,Chow; Bennett,9,0,32,23
1657683619115,MATH 142A,B03,093481,Chow; Bennett,8,0,32,24
1657683619115,MATH 142A,B04,093558,Chow; Bennett,13,0,32,19
1657683619115,MATH 142A,B05,093559,Chow; Bennett,6,0,32,26
1657683625144,MATH 193A,A01,083224,Rotar; Vladimir,8,0,34,26
1657683625144,MATH 193A,A02,083225,Rotar; Vladimir,9,0,34,25
1657683625144,MATH 193A,A03,083781,Rotar; Vladimir,5,0,34,29
1657683625144,MATH 193A,A04,083782,Rotar; Vladimir,10,0,34,24
1657683625144,MATH 193A,A05,093482,Rotar; Vladimir,10,0,34,24
1657683631167,MATH 197,001,091859,McAuley; Julian John,9999,0,9999,0
1657683631167,MATH 197,002,095566,Kedlaya; Kiran S.,9997,0,9999,2
1657683631167,MATH 197,003,095567,Xiao; Ming,9999,0,9999,0
1657683631167,MATH 197,004,095571,Perols; Johan Lars,9998,0,9999,1
1657683638235,COGS 9,A01,083615,Shannon; Kyle Michael,9,0,75,66
1657683644261,COGS 11,A01,083617,Boyle; Mary E. T.,23,0,48,25
1657683650285,COGS 13,A01,083071,Bastos; Amalia Pinkusfeld,11,0,71,60
1657683656321,COGS 14A,A01,092681,Semenuks; Arturs,5,1,100,95
1657683662350,COGS 14B,A01,083073,Cheng; Tzu-Han,6,0,63,57
1657683668377,COGS 17,A01,092677,Semenuks; Arturs,6,0,81,75
1657683674404,COGS 100,A01,083619,Allen; Michael Gordon,17,0,70,53
1657683680427,COGS 101A,A01,083621,Davis; Joshua Daniel,9,0,68,59
1657683686460,COGS 101B,A01,091572,Allen; Michael Gordon,12,0,65,53
1657683692482,COGS 101C,A01,083625,Delgado; Tania,17,0,35,18
1657683698504,COGS 107A,A01,083627,Boyle; Mary E. T.,13,0,60,47
1657683704526,COGS 118A,A01,083075,Gupta; Anjum,21,0,76,55
1657683710549,CSE 3,A50,083646,Miranda; Gregory Joseph,24,0,50,26
1657683716571,CSE 8A,A50,083650,Miranda; Gregory Joseph,17,1,56,39
1657683722595,CSE 11,A01,083080,Cao; Yingjun,6,15,40,34
1657683728616,CSE 12,A01,083652,Krause-Levy; Sophia Louisa,28,1,120,92
1657683734642,CSE 15L,A01,083654,Morris; Justin Loren,9,0,50,41
1657683734642,CSE 15L,A02,083655,Morris; Justin Loren,9,0,50,41
1657683740666,CSE 20,A01,083657,Tran; Khoa Dang,39,0,80,41
1657683746692,CSE 21,A01,095574,Bach; Quang Tran,22,0,48,26
1657683752716,CSE 30,A01,083084,Eldon; John,6,0,80,74
1657683752716,CSE 30,B01,095061,Bhaskar; Nishant,9,0,50,41
1657683758744,CSE 100,A01,083659,Cao; Yingjun,5,4,70,65
1657683764768,CSE 134B,A01,083661,Powell; Thomas Allan,23,0,100,77
1657683770795,CSE 140,A01,083663,Gungor; Onat,15,0,85,70
1657683776817,CSE 140L,A01,083088,Eldon; John,22,0,100,78
1657683782838,CSE 175,A01,083665,Kumar; Rakesh,3,0,25,22
1657683788863,CSE 190,A00,092507,Dubnov; Shlomo,8,0,20,12
1657683794888,ECE 45,A01,083139,Congero; Spencer William,6,0,75,69
1657683800915,ECE 65,A50,083695,Saad; Andrew S,12,0,30,18
1657683800915,ECE 65,A51,095125,Saad; Andrew S,24,0,26,2
1657683806945,ECE 109,A01,091882,Touri; Behrouz,20,0,70,50
1657683812972,ECE 180,A00,083140,Abi Samra; Nicholas Camill,1,0,30,29
1657683812972,ECE 180,B00,083141,Abi Samra; Nicholas Camill,0,0,30,30
1657683818995,MATH 10A,A01,083735,Patchell; Gregory David,2,0,30,28
1657683818995,MATH 10A,A02,083736,Patchell; Gregory David,20,0,30,10
1657683818995,MATH 10A,A03,083737,Patchell; Gregory David,16,0,30,14
1657683825022,MATH 10B,A01,083207,Lim; Seonhee,8,0,34,26
1657683825022,MATH 10B,A02,083208,Lim; Seonhee,9,0,35,26
1657683825022,MATH 10B,A03,093472,Lim; Seonhee,7,0,34,27
1657683825022,MATH 10B,B01,083739,Sinha; Shubham,13,0,30,17
1657683831052,MATH 18,A01,083743,Cinel; Cameron Alexander,8,0,30,22
1657683831052,MATH 18,A02,083744,Cinel; Cameron Alexander,17,0,30,13
1657683831052,MATH 18,A03,083745,Cinel; Cameron Alexander,10,0,30,20
1657683831052,MATH 18,B01,083748,Rideout; David Porter,5,0,37,32
1657683831052,MATH 18,B02,083749,Rideout; David Porter,5,0,36,31
1657683831052,MATH 18,B03,083750,Rideout; David Porter,3,0,37,34
1657683831052,MATH 18,B04,083751,Rideout; David Porter,6,0,36,30
1657683831052,MATH 18,B05,093473,Rideout; David Porter,6,0,36,30
1657683831052,MATH 18,B06,093474,Rideout; David Porter,6,0,36,30
1657683837074,MATH 20A,A01,083754,Zheng; Zequn,14,0,40,26
1657683843099,MATH 20B,A01,083756,Briones; Jor-el Thomas Caparas,4,0,36,32
1657683843099,MATH 20B,A02,083757,Briones; Jor-el Thomas Caparas,1,0,36,35
1657683843099,MATH 20B,A03,093475,Briones; Jor-el Thomas Caparas,2,0,36,34
1657683849132,MATH 20C,A01,083760,Briones; Jor-el Thomas Caparas,1,0,35,34
1657683849132,MATH 20C,A02,083761,Briones; Jor-el Thomas Caparas,8,0,35,27
1657683849132,MATH 20C,A03,093476,Briones; Jor-el Thomas Caparas,0,1,36,36
1657683849132,MATH 20C,B01,083762,Bach; Quang Tran,1,0,30,29
1657683855161,MATH 20D,A01,083765,Tran; Brian Kha,5,0,30,25
1657683855161,MATH 20D,A02,083766,Tran; Brian Kha,5,0,30,25
1657683855161,MATH 20D,A03,083767,Tran; Brian Kha,5,0,30,25
1657683861184,MATH 20E,A01,083771,Ganguly; Soumya,9,0,32,23
1657683861184,MATH 20E,A02,083772,Ganguly; Soumya,6,0,32,26
1657683861184,MATH 20E,B01,083773,Ciotti; Benjamin,20,0,35,15
1657683861184,MATH 20E,B02,083774,Ciotti; Benjamin,18,0,35,17
1657683867214,MATH 103A,A01,083777,Greenfeld; Be'Eri,3,0,36,33
1657683867214,MATH 103A,A02,083778,Greenfeld; Be'Eri,5,0,36,31
1657683867214,MATH 103A,A03,093561,Greenfeld; Be'Eri,6,0,36,30
1657683867214,MATH 103A,B01,083779,Greenfeld; Be'Eri,7,0,36,29
1657683867214,MATH 103A,B02,083780,Greenfeld; Be'Eri,4,0,36,32
1657683867214,MATH 103A,B03,093562,Greenfeld; Be'Eri,3,0,36,33
1657683873237,MATH 105,A01,085443,Carter; Anne Toulson,15,0,35,20
1657683873237,MATH 105,A02,093477,Carter; Anne Toulson,20,0,35,15
1657683879261,MATH 109,A01,083213,Ganzberger; Geoffrey Michael,2,0,34,32
1657683879261,MATH 109,A02,083214,Ganzberger; Geoffrey Michael,4,0,34,30
1657683879261,MATH 109,A03,093478,Ganzberger; Geoffrey Michael,2,0,34,32
1657683879261,MATH 109,B01,083215,Ganzberger; Geoffrey Michael,1,0,32,31
1657683879261,MATH 109,B02,083216,Ganzberger; Geoffrey Michael,2,0,32,30
1657683879261,MATH 109,B03,093479,Ganzberger; Geoffrey Michael,8,0,32,24
1657683885290,MATH 142A,A01,083219,Chow; Bennett,7,0,32,25
1657683885290,MATH 142A,A02,083220,Chow; Bennett,10,0,32,22
1657683885290,MATH 142A,A03,093480,Chow; Bennett,9,0,32,23
1657683885290,MATH 142A,B03,093481,Chow; Bennett,8,0,32,24
1657683885290,MATH 142A,B04,093558,Chow; Bennett,13,0,32,19
1657683885290,MATH 142A,B05,093559,Chow; Bennett,6,0,32,26
1657683891318,MATH 193A,A01,083224,Rotar; Vladimir,8,0,34,26
1657683891318,MATH 193A,A02,083225,Rotar; Vladimir,9,0,34,25
1657683891318,MATH 193A,A03,083781,Rotar; Vladimir,5,0,34,29
1657683891318,MATH 193A,A04,083782,Rotar; Vladimir,10,0,34,24
1657683891318,MATH 193A,A05,093482,Rotar; Vladimir,10,0,34,24
1657683897343,MATH 197,001,091859,McAuley; Julian John,9999,0,9999,0
1657683897343,MATH 197,002,095566,Kedlaya; Kiran S.,9997,0,9999,2
1657683897343,MATH 197,003,095567,Xiao; Ming,9999,0,9999,0
1657683897343,MATH 197,004,095571,Perols; Johan Lars,9998,0,9999,1
1657683904409,COGS 9,A01,083615,Shannon; Kyle Michael,9,0,75,66
1657683910435,COGS 11,A01,083617,Boyle; Mary E. T.,23,0,48,25
1657683916462,COGS 13,A01,083071,Bastos; Amalia Pinkusfeld,11,0,71,60
1657683922488,COGS 14A,A01,092681,Semenuks; Arturs,5,1,100,95
1657683928512,COGS 14B,A01,083073,Cheng; Tzu-Han,6,0,63,57
1657683934548,COGS 17,A01,092677,Semenuks; Arturs,6,0,81,75
1657683940574,COGS 100,A01,083619,Allen; Michael Gordon,17,0,70,53
1657683946601,COGS 101A,A01,083621,Davis; Joshua Daniel,9,0,68,59
1657683952625,COGS 101B,A01,091572,Allen; Michael Gordon,12,0,65,53
1657683958660,COGS 101C,A01,083625,Delgado; Tania,17,0,35,18
1657683964690,COGS 107A,A01,083627,Boyle; Mary E. T.,13,0,60,47
1657683970720,COGS 118A,A01,083075,Gupta; Anjum,21,0,76,55
1657683976747,CSE 3,A50,083646,Miranda; Gregory Joseph,24,0,50,26
1657683982782,CSE 8A,A50,083650,Miranda; Gregory Joseph,17,1,56,39
1657683988804,CSE 11,A01,083080,Cao; Yingjun,6,15,40,34
1657683994829,CSE 12,A01,083652,Krause-Levy; Sophia Louisa,28,1,120,92
1657684000853,CSE 15L,A01,083654,Morris; Justin Loren,9,0,50,41
1657684000853,CSE 15L,A02,083655,Morris; Justin Loren,9,0,50,41
1657684006876,CSE 20,A01,083657,Tran; Khoa Dang,39,0,80,41
1657684012900,CSE 21,A01,095574,Bach; Quang Tran,22,0,48,26
1657684018925,CSE 30,A01,083084,Eldon; John,6,0,80,74
1657684018925,CSE 30,B01,095061,Bhaskar; Nishant,9,0,50,41
1657684024948,CSE 100,A01,083659,Cao; Yingjun,5,4,70,65
1657684030972,CSE 134B,A01,083661,Powell; Thomas Allan,23,0,100,77
1657684037013,CSE 140,A01,083663,Gungor; Onat,15,0,85,70
1657684043047,CSE 140L,A01,083088,Eldon; John,22,0,100,78
1657684049070,CSE 175,A01,083665,Kumar; Rakesh,3,0,25,22
1657684055096,CSE 190,A00,092507,Dubnov; Shlomo,8,0,20,12
1657684061122,ECE 45,A01,083139,Congero; Spencer William,6,0,75,69
1657684067152,ECE 65,A50,083695,Saad; Andrew S,12,0,30,18
1657684067152,ECE 65,A51,095125,Saad; Andrew S,24,0,26,2
1657684073179,ECE 109,A01,091882,Touri; Behrouz,20,0,70,50
1657684079205,ECE 180,A00,083140,Abi Samra; Nicholas Camill,1,0,30,29
1657684079205,ECE 180,B00,083141,Abi Samra; Nicholas Camill,0,0,30,30
1657684085238,MATH 10A,A01,083735,Patchell; Gregory David,2,0,30,28
1657684085238,MATH 10A,A02,083736,Patchell; Gregory David,20,0,30,10
1657684085238,MATH 10A,A03,083737,Patchell; Gregory David,16,0,30,14
1657684091266,MATH 10B,A01,083207,Lim; Seonhee,8,0,34,26
1657684091266,MATH 10B,A02,083208,Lim; Seonhee,9,0,35,26
1657684091266,MATH 10B,A03,093472,Lim; Seonhee,7,0,34,27
1657684091266,MATH 10B,B01,083739,Sinha; Shubham,13,0,30,17
1657684097290,MATH 18,A01,083743,Cinel; Cameron Alexander,8,0,30,22
1657684097290,MATH 18,A02,083744,Cinel; Cameron Alexander,17,0,30,13
1657684097290,MATH 18,A03,083745,Cinel; Cameron Alexander,10,0,30,20
1657684097290,MATH 18,B01,083748,Rideout; David Porter,5,0,37,32
1657684097290,MATH 18,B02,083749,Rideout; David Porter,5,0,36,31
1657684097290,MATH 18,B03,083750,Rideout; David Porter,3,0,37,34
1657684097290,MATH 18,B04,083751,Rideout; David Porter,6,0,36,30
1657684097290,MATH 18,B05,093473,Rideout; David Porter,6,0,36,30
1657684097290,MATH 18,B06,093474,Rideout; David Porter,6,0,36,30
1657684103321,MATH 20A,A01,083754,Zheng; Zequn,14,0,40,26
1657684109345,MATH 20B,A01,083756,Briones; Jor-el Thomas Caparas,4,0,36,32
1657684109345,MATH 20B,A02,083757,Briones; Jor-el Thomas Caparas,1,0,36,35
1657684109345,MATH 20B,A03,093475,Briones; Jor-el Thomas Caparas,2,0,36,34
1657684115368,MATH 20C,A01,083760,Briones; Jor-el Thomas Caparas,1,0,35,34
1657684115368,MATH 20C,A02,083761,Briones; Jor-el Thomas Caparas,8,0,35,27
1657684115368,MATH 20C,A03,093476,Briones; Jor-el Thomas Caparas,0,1,36,36
1657684115368,MATH 20C,B01,083762,Bach; Quang Tran,1,0,30,29
1657684121393,MATH 20D,A01,083765,Tran; Brian Kha,5,0,30,25
1657684121393,MATH 20D,A02,083766,Tran; Brian Kha,5,0,30,25
1657684121393,MATH 20D,A03,083767,Tran; Brian Kha,5,0,30,25
1657684127421,MATH 20E,A01,083771,Ganguly; Soumya,9,0,32,23
1657684127421,MATH 20E,A02,083772,Ganguly; Soumya,6,0,32,26
1657684127421,MATH 20E,B01,083773,Ciotti; Benjamin,20,0,35,15
1657684127421,MATH 20E,B02,083774,Ciotti; Benjamin,18,0,35,17
1657684133448,MATH 103A,A01,083777,Greenfeld; Be'Eri,3,0,36,33
1657684133448,MATH 103A,A02,083778,Greenfeld; Be'Eri,5,0,36,31
1657684133448,MATH 103A,A03,093561,Greenfeld; Be'Eri,6,0,36,30
1657684133448,MATH 103A,B01,083779,Greenfeld; Be'Eri,7,0,36,29
1657684133448,MATH 103A,B02,083780,Greenfeld; Be'Eri,4,0,36,32
1657684133448,MATH 103A,B03,093562,Greenfeld; Be'Eri,3,0,36,33
1657684139491,MATH 105,A01,085443,Carter; Anne Toulson,15,0,35,20
1657684139491,MATH 105,A02,093477,Carter; Anne Toulson,20,0,35,15
1657684145519,MATH 109,A01,083213,Ganzberger; Geoffrey Michael,2,0,34,32
1657684145519,MATH 109,A02,083214,Ganzberger; Geoffrey Michael,4,0,34,30
1657684145519,MATH 109,A03,093478,Ganzberger; Geoffrey Michael,2,0,34,32
1657684145519,MATH 109,B01,083215,Ganzberger; Geoffrey Michael,1,0,32,31
1657684145519,MATH 109,B02,083216,Ganzberger; Geoffrey Michael,2,0,32,30
1657684145519,MATH 109,B03,093479,Ganzberger; Geoffrey Michael,8,0,32,24
1657684151553,MATH 142A,A01,083219,Chow; Bennett,7,0,32,25
1657684151553,MATH 142A,A02,083220,Chow; Bennett,10,0,32,22
1657684151553,MATH 142A,A03,093480,Chow; Bennett,9,0,32,23
1657684151553,MATH 142A,B03,093481,Chow; Bennett,8,0,32,24
1657684151553,MATH 142A,B04,093558,Chow; Bennett,13,0,32,19
1657684151553,MATH 142A,B05,093559,Chow; Bennett,6,0,32,26
1657684157577,MATH 193A,A01,083224,Rotar; Vladimir,8,0,34,26
1657684157577,MATH 193A,A02,083225,Rotar; Vladimir,9,0,34,25
1657684157577,MATH 193A,A03,083781,Rotar; Vladimir,5,0,34,29
1657684157577,MATH 193A,A04,083782,Rotar; Vladimir,10,0,34,24
1657684157577,MATH 193A,A05,093482,Rotar; Vladimir,10,0,34,24
1657684163611,MATH 197,001,091859,McAuley; Julian John,9999,0,9999,0
1657684163611,MATH 197,002,095566,Kedlaya; Kiran S.,9997,0,9999,2
1657684163611,MATH 197,003,095567,Xiao; Ming,9999,0,9999,0
1657684163611,MATH 197,004,095571,Perols; Johan Lars,9998,0,9999,1
1657684170666,COGS 9,A01,083615,Shannon; Kyle Michael,9,0,75,66
1657684176692,COGS 11,A01,083617,Boyle; Mary E. T.,23,0,48,25
1657684182714,COGS 13,A01,083071,Bastos; Amalia Pinkusfeld,11,0,71,60
1657684188752,COGS 14A,A01,092681,Semenuks; Arturs,5,1,100,95
1657684194785,COGS 14B,A01,083073,Cheng; Tzu-Han,6,0,63,57
1657684200901,COGS 17,A01,092677,Semenuks; Arturs,6,0,81,75
1657684206923,COGS 100,A01,083619,Allen; Michael Gordon,17,0,70,53
1657684212949,COGS 101A,A01,083621,Davis; Joshua Daniel,9,0,68,59
1657684218971,COGS 101B,A01,091572,Allen; Michael Gordon,12,0,65,53
1657684224993,COGS 101C,A01,083625,Delgado; Tania,17,0,35,18
1657684231015,COGS 107A,A01,083627,Boyle; Mary E. T.,13,0,60,47
1657684237041,COGS 118A,A01,083075,Gupta; Anjum,21,0,76,55
1657684243064,CSE 3,A50,083646,Miranda; Gregory Joseph,24,0,50,26
1657684249091,CSE 8A,A50,083650,Miranda; Gregory Joseph,17,1,56,39
1657684255115,CSE 11,A01,083080,Cao; Yingjun,6,15,40,34
1657684261142,CSE 12,A01,083652,Krause-Levy; Sophia Louisa,28,1,120,92
1657684267168,CSE 15L,A01,083654,Morris; Justin Loren,9,0,50,41
1657684267168,CSE 15L,A02,083655,Morris; Justin Loren,9,0,50,41
1657684273192,CSE 20,A01,083657,Tran; Khoa Dang,39,0,80,41
1657684279215,CSE 21,A01,095574,Bach; Quang Tran,22,0,48,26
1657684285251,CSE 30,A01,083084,Eldon; John,6,0,80,74
1657684285251,CSE 30,B01,095061,Bhaskar; Nishant,9,0,50,41
1657684291274,CSE 100,A01,083659,Cao; Yingjun,5,4,70,65
1657684297298,CSE 134B,A01,083661,Powell; Thomas Allan,23,0,100,77
1657684303324,CSE 140,A01,083663,Gungor; Onat,15,0,85,70
1657684309352,CSE 140L,A01,083088,Eldon; John,22,0,100,78
1657684315382,CSE 175,A01,083665,Kumar; Rakesh,3,0,25,22
1657684321409,CSE 190,A00,092507,Dubnov; Shlomo,8,0,20,12
1657684327435,ECE 45,A01,083139,Congero; Spencer William,6,0,75,69
1657684333458,ECE 65,A50,083695,Saad; Andrew S,12,0,30,18
1657684333458,ECE 65,A51,095125,Saad; Andrew S,24,0,26,2
1657684339483,ECE 109,A01,091882,Touri; Behrouz,20,0,70,50
1657684345512,ECE 180,A00,083140,Abi Samra; Nicholas Camill,1,0,30,29
1657684345512,ECE 180,B00,083141,Abi Samra; Nicholas Camill,0,0,30,30
1657684351545,MATH 10A,A01,083735,Patchell; Gregory David,2,0,30,28
1657684351545,MATH 10A,A02,083736,Patchell; Gregory David,20,0,30,10
1657684351545,MATH 10A,A03,083737,Patchell; Gregory David,16,0,30,14
1657684357575,MATH 10B,A01,083207,Lim; Seonhee,8,0,34,26
1657684357575,MATH 10B,A02,083208,Lim; Seonhee,9,0,35,26
1657684357575,MATH 10B,A03,093472,Lim; Seonhee,7,0,34,27
1657684357575,MATH 10B,B01,083739,Sinha; Shubham,13,0,30,17
1657684363599,MATH 18,A01,083743,Cinel; Cameron Alexander,8,0,30,22
1657684363599,MATH 18,A02,083744,Cinel; Cameron Alexander,17,0,30,13
1657684363599,MATH 18,A03,083745,Cinel; Cameron Alexander,10,0,30,20
1657684363599,MATH 18,B01,083748,Rideout; David Porter,5,0,37,32
1657684363599,MATH 18,B02,083749,Rideout; David Porter,5,0,36,31
1657684363599,MATH 18,B03,083750,Rideout; David Porter,3,0,37,34
1657684363599,MATH 18,B04,083751,Rideout; David Porter,6,0,36,30
1657684363599,MATH 18,B05,093473,Rideout; David Porter,6,0,36,30
1657684363599,MATH 18,B06,093474,Rideout; David Porter,6,0,36,30
1657684369620,MATH 20A,A01,083754,Zheng; Zequn,14,0,40,26
1657684375648,MATH 20B,A01,083756,Briones; Jor-el Thomas Caparas,4,0,36,32
1657684375648,MATH 20B,A02,083757,Briones; Jor-el Thomas Caparas,1,0,36,35
1657684375648,MATH 20B,A03,093475,Briones; Jor-el Thomas Caparas,2,0,36,34
1657684381676,MATH 20C,A01,083760,Briones; Jor-el Thomas Caparas,1,0,35,34
1657684381676,MATH 20C,A02,083761,Briones; Jor-el Thomas Caparas,8,0,35,27
1657684381676,MATH 20C,A03,093476,Briones; Jor-el Thomas Caparas,0,1,36,36
1657684381676,MATH 20C,B01,083762,Bach; Quang Tran,1,0,30,29
1657684387703,MATH 20D,A01,083765,Tran; Brian Kha,5,0,30,25
1657684387703,MATH 20D,A02,083766,Tran; Brian Kha,5,0,30,25
1657684387703,MATH 20D,A03,083767,Tran; Brian Kha,5,0,30,25
1657684393726,MATH 20E,A01,083771,Ganguly; Soumya,9,0,32,23
1657684393726,MATH 20E,A02,083772,Ganguly; Soumya,6,0,32,26
1657684393726,MATH 20E,B01,083773,Ciotti; Benjamin,20,0,35,15
1657684393726,MATH 20E,B02,083774,Ciotti; Benjamin,18,0,35,17
1657684399756,MATH 103A,A01,083777,Greenfeld; Be'Eri,3,0,36,33
1657684399756,MATH 103A,A02,083778,Greenfeld; Be'Eri,5,0,36,31
1657684399756,MATH 103A,A03,093561,Greenfeld; Be'Eri,6,0,36,30
1657684399756,MATH 103A,B01,083779,Greenfeld; Be'Eri,7,0,36,29
1657684399756,MATH 103A,B02,083780,Greenfeld; Be'Eri,4,0,36,32
1657684399756,MATH 103A,B03,093562,Greenfeld; Be'Eri,3,0,36,33
1657684405781,MATH 105,A01,085443,Carter; Anne Toulson,15,0,35,20
1657684405781,MATH 105,A02,093477,Carter; Anne Toulson,20,0,35,15
1657684411808,MATH 109,A01,083213,Ganzberger; Geoffrey Michael,2,0,34,32
1657684411808,MATH 109,A02,083214,Ganzberger; Geoffrey Michael,4,0,34,30
1657684411808,MATH 109,A03,093478,Ganzberger; Geoffrey Michael,2,0,34,32
1657684411808,MATH 109,B01,083215,Ganzberger; Geoffrey Michael,1,0,32,31
1657684411808,MATH 109,B02,083216,Ganzberger; Geoffrey Michael,2,0,32,30
1657684411808,MATH 109,B03,093479,Ganzberger; Geoffrey Michael,8,0,32,24
1657684417830,MATH 142A,A01,083219,Chow; Bennett,7,0,32,25
1657684417830,MATH 142A,A02,083220,Chow; Bennett,10,0,32,22
1657684417830,MATH 142A,A03,093480,Chow; Bennett,9,0,32,23
1657684417830,MATH 142A,B03,093481,Chow; Bennett,8,0,32,24
1657684417830,MATH 142A,B04,093558,Chow; Bennett,13,0,32,19
1657684417830,MATH 142A,B05,093559,Chow; Bennett,6,0,32,26
1657684423854,MATH 193A,A01,083224,Rotar; Vladimir,8,0,34,26
1657684423854,MATH 193A,A02,083225,Rotar; Vladimir,9,0,34,25
1657684423854,MATH 193A,A03,083781,Rotar; Vladimir,5,0,34,29
1657684423854,MATH 193A,A04,083782,Rotar; Vladimir,10,0,34,24
1657684423854,MATH 193A,A05,093482,Rotar; Vladimir,10,0,34,24
1657684429877,MATH 197,001,091859,McAuley; Julian John,9999,0,9999,0
1657684429877,MATH 197,002,095566,Kedlaya; Kiran S.,9997,0,9999,2
1657684429877,MATH 197,003,095567,Xiao; Ming,9999,0,9999,0
1657684429877,MATH 197,004,095571,Perols; Johan Lars,9998,0,9999,1
1657684436933,COGS 9,A01,083615,Shannon; Kyle Michael,9,0,75,66
1657684442965,COGS 11,A01,083617,Boyle; Mary E. T.,23,0,48,25
1657684448992,COGS 13,A01,083071,Bastos; Amalia Pinkusfeld,11,0,71,60
1657684455018,COGS 14A,A01,092681,Semenuks; Arturs,5,1,100,95
1657684461042,COGS 14B,A01,083073,Cheng; Tzu-Han,6,0,63,57
1657684467086,COGS 17,A01,092677,Semenuks; Arturs,6,0,81,75
1657684473111,COGS 100,A01,083619,Allen; Michael Gordon,17,0,70,53
1657684479135,COGS 101A,A01,083621,Davis; Joshua Daniel,9,0,68,59
1657684485171,COGS 101B,A01,091572,Allen; Michael Gordon,12,0,65,53
1657684491194,COGS 101C,A01,083625,Delgado; Tania,17,0,35,18
1657684497216,COGS 107A,A01,083627,Boyle; Mary E. T.,13,0,60,47
1657684503242,COGS 118A,A01,083075,Gupta; Anjum,21,0,76,55
1657684509266,CSE 3,A50,083646,Miranda; Gregory Joseph,24,0,50,26
1657684515295,CSE 8A,A50,083650,Miranda; Gregory Joseph,17,1,56,39
1657684521319,CSE 11,A01,083080,Cao; Yingjun,6,15,40,34
1657684527348,CSE 12,A01,083652,Krause-Levy; Sophia Louisa,28,1,120,92
1657684533372,CSE 15L,A01,083654,Morris; Justin Loren,9,0,50,41
1657684533372,CSE 15L,A02,083655,Morris; Justin Loren,9,0,50,41
1657684539397,CSE 20,A01,083657,Tran; Khoa Dang,39,0,80,41
1657684545422,CSE 21,A01,095574,Bach; Quang Tran,22,0,48,26
1657684551443,CSE 30,A01,083084,Eldon; John,6,0,80,74
1657684551443,CSE 30,B01,095061,Bhaskar; Nishant,9,0,50,41
1657684557479,CSE 100,A01,083659,Cao; Yingjun,5,4,70,65
1657684563501,CSE 134B,A01,083661,Powell; Thomas Allan,23,0,100,77
1657684569528,CSE 140,A01,083663,Gungor; Onat,15,0,85,70
1657684575554,CSE 140L,A01,083088,Eldon; John,22,0,100,78
1657684581588,CSE 175,A01,083665,Kumar; Rakesh,3,0,25,22
1657684587612,CSE 190,A00,092507,Dubnov; Shlomo,8,0,20,12
1657684593639,ECE 45,A01,083139,Congero; Spencer William,6,0,75,69
1657684599662,ECE 65,A50,083695,Saad; Andrew S,12,0,30,18
1657684599662,ECE 65,A51,095125,Saad; Andrew S,24,0,26,2
1657684605706,ECE 109,A01,091882,Touri; Behrouz,20,0,70,50
1657684611729,ECE 180,A00,083140,Abi Samra; Nicholas Camill,1,0,30,29
1657684611729,ECE 180,B00,083141,Abi Samra; Nicholas Camill,0,0,30,30
1657684617752,MATH 10A,A01,083735,Patchell; Gregory David,2,0,30,28
1657684617752,MATH 10A,A02,083736,Patchell; Gregory David,20,0,30,10
1657684617752,MATH 10A,A03,083737,Patchell; Gregory David,16,0,30,14
1657684623776,MATH 10B,A01,083207,Lim; Seonhee,8,0,34,26
1657684623776,MATH 10B,A02,083208,Lim; Seonhee,9,0,35,26
1657684623776,MATH 10B,A03,093472,Lim; Seonhee,7,0,34,27
1657684623776,MATH 10B,B01,083739,Sinha; Shubham,13,0,30,17
1657684629812,MATH 18,A01,083743,Cinel; Cameron Alexander,8,0,30,22
1657684629812,MATH 18,A02,083744,Cinel; Cameron Alexander,17,0,30,13
1657684629812,MATH 18,A03,083745,Cinel; Cameron Alexander,10,0,30,20
1657684629812,MATH 18,B01,083748,Rideout; David Porter,5,0,37,32
1657684629812,MATH 18,B02,083749,Rideout; David Porter,5,0,36,31
1657684629812,MATH 18,B03,083750,Rideout; David Porter,3,0,37,34
1657684629812,MATH 18,B04,083751,Rideout; David Porter,6,0,36,30
1657684629812,MATH 18,B05,093473,Rideout; David Porter,6,0,36,30
1657684629812,MATH 18,B06,093474,Rideout; David Porter,6,0,36,30
1657684635837,MATH 20A,A01,083754,Zheng; Zequn,14,0,40,26
1657684641859,MATH 20B,A01,083756,Briones; Jor-el Thomas Caparas,4,0,36,32
1657684641859,MATH 20B,A02,083757,Briones; Jor-el Thomas Caparas,1,0,36,35
1657684641859,MATH 20B,A03,093475,Briones; Jor-el Thomas Caparas,2,0,36,34
1657684647900,MATH 20C,A01,083760,Briones; Jor-el Thomas Caparas,1,0,35,34
1657684647900,MATH 20C,A02,083761,Briones; Jor-el Thomas Caparas,8,0,35,27
1657684647900,MATH 20C,A03,093476,Briones; Jor-el Thomas Caparas,0,1,36,36
1657684647900,MATH 20C,B01,083762,Bach; Quang Tran,1,0,30,29
1657684653939,MATH 20D,A01,083765,Tran; Brian Kha,5,0,30,25
1657684653939,MATH 20D,A02,083766,Tran; Brian Kha,5,0,30,25
1657684653939,MATH 20D,A03,083767,Tran; Brian Kha,5,0,30,25
1657684659968,MATH 20E,A01,083771,Ganguly; Soumya,9,0,32,23
1657684659968,MATH 20E,A02,083772,Ganguly; Soumya,6,0,32,26
1657684659968,MATH 20E,B01,083773,Ciotti; Benjamin,20,0,35,15
1657684659968,MATH 20E,B02,083774,Ciotti; Benjamin,18,0,35,17
1657684666002,MATH 103A,A01,083777,Greenfeld; Be'Eri,3,0,36,33
1657684666002,MATH 103A,A02,083778,Greenfeld; Be'Eri,5,0,36,31
1657684666002,MATH 103A,A03,093561,Greenfeld; Be'Eri,6,0,36,30
1657684666002,MATH 103A,B01,083779,Greenfeld; Be'Eri,7,0,36,29
1657684666002,MATH 103A,B02,083780,Greenfeld; Be'Eri,4,0,36,32
1657684666002,MATH 103A,B03,093562,Greenfeld; Be'Eri,3,0,36,33
1657684672035,MATH 105,A01,085443,Carter; Anne Toulson,15,0,35,20
1657684672035,MATH 105,A02,093477,Carter; Anne Toulson,20,0,35,15
1657684678059,MATH 109,A01,083213,Ganzberger; Geoffrey Michael,2,0,34,32
1657684678059,MATH 109,A02,083214,Ganzberger; Geoffrey Michael,4,0,34,30
1657684678059,MATH 109,A03,093478,Ganzberger; Geoffrey Michael,2,0,34,32
1657684678059,MATH 109,B01,083215,Ganzberger; Geoffrey Michael,1,0,32,31
1657684678059,MATH 109,B02,083216,Ganzberger; Geoffrey Michael,2,0,32,30
1657684678059,MATH 109,B03,093479,Ganzberger; Geoffrey Michael,8,0,32,24
1657684684088,MATH 142A,A01,083219,Chow; Bennett,7,0,32,25
1657684684088,MATH 142A,A02,083220,Chow; Bennett,10,0,32,22
1657684684088,MATH 142A,A03,093480,Chow; Bennett,9,0,32,23
1657684684088,MATH 142A,B03,093481,Chow; Bennett,8,0,32,24
1657684684088,MATH 142A,B04,093558,Chow; Bennett,13,0,32,19
1657684684088,MATH 142A,B05,093559,Chow; Bennett,6,0,32,26
1657684690113,MATH 193A,A01,083224,Rotar; Vladimir,8,0,34,26
1657684690113,MATH 193A,A02,083225,Rotar; Vladimir,9,0,34,25
1657684690113,MATH 193A,A03,083781,Rotar; Vladimir,5,0,34,29
1657684690113,MATH 193A,A04,083782,Rotar; Vladimir,10,0,34,24
1657684690113,MATH 193A,A05,093482,Rotar; Vladimir,10,0,34,24
1657684696138,MATH 197,001,091859,McAuley; Julian John,9999,0,9999,0
1657684696138,MATH 197,002,095566,Kedlaya; Kiran S.,9997,0,9999,2
1657684696138,MATH 197,003,095567,Xiao; Ming,9999,0,9999,0
1657684696138,MATH 197,004,095571,Perols; Johan Lars,9998,0,9999,1
1657684703200,COGS 9,A01,083615,Shannon; Kyle Michael,9,0,75,66
1657684709228,COGS 11,A01,083617,Boyle; Mary E. T.,23,0,48,25
1657684715251,COGS 13,A01,083071,Bastos; Amalia Pinkusfeld,11,0,71,60
1657684721277,COGS 14A,A01,092681,Semenuks; Arturs,5,1,100,95
1657684727303,COGS 14B,A01,083073,Cheng; Tzu-Han,6,0,63,57
1657684733329,COGS 17,A01,092677,Semenuks; Arturs,6,0,81,75
1657684739352,COGS 100,A01,083619,Allen; Michael Gordon,17,0,70,53
1657684745374,COGS 101A,A01,083621,Davis; Joshua Daniel,9,0,68,59
1657684751403,COGS 101B,A01,091572,Allen; Michael Gordon,12,0,65,53
1657684757426,COGS 101C,A01,083625,Delgado; Tania,17,0,35,18
1657684763449,COGS 107A,A01,083627,Boyle; Mary E. T.,13,0,60,47
1657684769480,COGS 118A,A01,083075,Gupta; Anjum,21,0,76,55
1657684775503,CSE 3,A50,083646,Miranda; Gregory Joseph,24,0,50,26
1657684781530,CSE 8A,A50,083650,Miranda; Gregory Joseph,17,1,56,39
1657684787556,CSE 11,A01,083080,Cao; Yingjun,6,15,40,34
1657684793580,CSE 12,A01,083652,Krause-Levy; Sophia Louisa,28,1,120,92
1657684799675,CSE 15L,A01,083654,Morris; Justin Loren,9,0,50,41
1657684799675,CSE 15L,A02,083655,Morris; Justin Loren,9,0,50,41
1657684805701,CSE 20,A01,083657,Tran; Khoa Dang,39,0,80,41
1657684811727,CSE 21,A01,095574,Bach; Quang Tran,22,0,48,26
1657684817749,CSE 30,A01,083084,Eldon; John,6,0,80,74
1657684817749,CSE 30,B01,095061,Bhaskar; Nishant,9,0,50,41
1657684823787,CSE 100,A01,083659,Cao; Yingjun,5,4,70,65
1657684829809,CSE 134B,A01,083661,Powell; Thomas Allan,23,0,100,77
1657684835839,CSE 140,A01,083663,Gungor; Onat,15,0,85,70
1657684841867,CSE 140L,A01,083088,Eldon; John,22,0,100,78
1657684847891,CSE 175,A01,083665,Kumar; Rakesh,3,0,25,22
1657684853917,CSE 190,A00,092507,Dubnov; Shlomo,8,0,20,12
1657684859944,ECE 45,A01,083139,Congero; Spencer William,6,0,75,69
1657684865968,ECE 65,A50,083695,Saad; Andrew S,12,0,30,18
1657684865968,ECE 65,A51,095125,Saad; Andrew S,24,0,26,2
1657684871990,ECE 109,A01,091882,Touri; Behrouz,20,0,70,50
1657684878015,ECE 180,A00,083140,Abi Samra; Nicholas Camill,1,0,30,29
1657684878015,ECE 180,B00,083141,Abi Samra; Nicholas Camill,0,0,30,30
1657684884040,MATH 10A,A01,083735,Patchell; Gregory David,2,0,30,28
1657684884040,MATH 10A,A02,083736,Patchell; Gregory David,20,0,30,10
1657684884040,MATH 10A,A03,083737,Patchell; Gregory David,16,0,30,14
1657684890064,MATH 10B,A01,083207,Lim; Seonhee,8,0,34,26
1657684890064,MATH 10B,A02,083208,Lim; Seonhee,9,0,35,26
1657684890064,MATH 10B,A03,093472,Lim; Seonhee,7,0,34,27
1657684890064,MATH 10B,B01,083739,Sinha; Shubham,13,0,30,17
1657684896101,MATH 18,A01,083743,Cinel; Cameron Alexander,8,0,30,22
1657684896101,MATH 18,A02,083744,Cinel; Cameron Alexander,17,0,30,13
1657684896101,MATH 18,A03,083745,Cinel; Cameron Alexander,10,0,30,20
1657684896101,MATH 18,B01,083748,Rideout; David Porter,5,0,37,32
1657684896101,MATH 18,B02,083749,Rideout; David Porter,5,0,36,31
1657684896101,MATH 18,B03,083750,Rideout; David Porter,3,0,37,34
1657684896101,MATH 18,B04,083751,Rideout; David Porter,6,0,36,30
1657684896101,MATH 18,B05,093473,Rideout; David Porter,6,0,36,30
1657684896101,MATH 18,B06,093474,Rideout; David Porter,6,0,36,30
1657684902125,MATH 20A,A01,083754,Zheng; Zequn,14,0,40,26
1657684908154,MATH 20B,A01,083756,Briones; Jor-el Thomas Caparas,4,0,36,32
1657684908154,MATH 20B,A02,083757,Briones; Jor-el Thomas Caparas,1,0,36,35
1657684908154,MATH 20B,A03,093475,Briones; Jor-el Thomas Caparas,2,0,36,34
1657684914182,MATH 20C,A01,083760,Briones; Jor-el Thomas Caparas,1,0,35,34
1657684914182,MATH 20C,A02,083761,Briones; Jor-el Thomas Caparas,8,0,35,27
1657684914182,MATH 20C,A03,093476,Briones; Jor-el Thomas Caparas,0,1,36,36
1657684914182,MATH 20C,B01,083762,Bach; Quang Tran,1,0,30,29
1657684920211,MATH 20D,A01,083765,Tran; Brian Kha,5,0,30,25
1657684920211,MATH 20D,A02,083766,Tran; Brian Kha,5,0,30,25
1657684920211,MATH 20D,A03,083767,Tran; Brian Kha,5,0,30,25
1657684926242,MATH 20E,A01,083771,Ganguly; Soumya,9,0,32,23
1657684926242,MATH 20E,A02,083772,Ganguly; Soumya,6,0,32,26
1657684926242,MATH 20E,B01,083773,Ciotti; Benjamin,20,0,35,15
1657684926242,MATH 20E,B02,083774,Ciotti; Benjamin,18,0,35,17
1657684932271,MATH 103A,A01,083777,Greenfeld; Be'Eri,3,0,36,33
1657684932271,MATH 103A,A02,083778,Greenfeld; Be'Eri,5,0,36,31
1657684932271,MATH 103A,A03,093561,Greenfeld; Be'Eri,6,0,36,30
1657684932271,MATH 103A,B01,083779,Greenfeld; Be'Eri,7,0,36,29
1657684932271,MATH 103A,B02,083780,Greenfeld; Be'Eri,4,0,36,32
1657684932271,MATH 103A,B03,093562,Greenfeld; Be'Eri,3,0,36,33
1657684938297,MATH 105,A01,085443,Carter; Anne Toulson,15,0,35,20
1657684938297,MATH 105,A02,093477,Carter; Anne Toulson,20,0,35,15
1657684944320,MATH 109,A01,083213,Ganzberger; Geoffrey Michael,2,0,34,32
1657684944320,MATH 109,A02,083214,Ganzberger; Geoffrey Michael,4,0,34,30
1657684944320,MATH 109,A03,093478,Ganzberger; Geoffrey Michael,2,0,34,32
1657684944320,MATH 109,B01,083215,Ganzberger; Geoffrey Michael,1,0,32,31
1657684944320,MATH 109,B02,083216,Ganzberger; Geoffrey Michael,2,0,32,30
1657684944320,MATH 109,B03,093479,Ganzberger; Geoffrey Michael,8,0,32,24
1657684950348,MATH 142A,A01,083219,Chow; Bennett,7,0,32,25
1657684950348,MATH 142A,A02,083220,Chow; Bennett,10,0,32,22
1657684950348,MATH 142A,A03,093480,Chow; Bennett,9,0,32,23
1657684950348,MATH 142A,B03,093481,Chow; Bennett,8,0,32,24
1657684950348,MATH 142A,B04,093558,Chow; Bennett,13,0,32,19
1657684950348,MATH 142A,B05,093559,Chow; Bennett,6,0,32,26
1657684956371,MATH 193A,A01,083224,Rotar; Vladimir,8,0,34,26
1657684956371,MATH 193A,A02,083225,Rotar; Vladimir,9,0,34,25
1657684956371,MATH 193A,A03,083781,Rotar; Vladimir,5,0,34,29
1657684956371,MATH 193A,A04,083782,Rotar; Vladimir,10,0,34,24
1657684956371,MATH 193A,A05,093482,Rotar; Vladimir,10,0,34,24
1657684962394,MATH 197,001,091859,McAuley; Julian John,9999,0,9999,0
1657684962394,MATH 197,002,095566,Kedlaya; Kiran S.,9997,0,9999,2
1657684962394,MATH 197,003,095567,Xiao; Ming,9999,0,9999,0
1657684962394,MATH 197,004,095571,Perols; Johan Lars,9998,0,9999,1
1657684969448,COGS 9,A01,083615,Shannon; Kyle Michael,9,0,75,66
1657684975471,COGS 11,A01,083617,Boyle; Mary E. T.,23,0,48,25
1657684981497,COGS 13,A01,083071,Bastos; Amalia Pinkusfeld,11,0,71,60
1657684987522,COGS 14A,A01,092681,Semenuks; Arturs,5,1,100,95
1657684993544,COGS 14B,A01,083073,Cheng; Tzu-Han,6,0,63,57
1657684999571,COGS 17,A01,092677,Semenuks; Arturs,6,0,81,75
1657685005596,COGS 100,A01,083619,Allen; Michael Gordon,17,0,70,53
1657685011619,COGS 101A,A01,083621,Davis; Joshua Daniel,9,0,68,59
1657685017640,COGS 101B,A01,091572,Allen; Michael Gordon,12,0,65,53
1657685023663,COGS 101C,A01,083625,Delgado; Tania,17,0,35,18
1657685029689,COGS 107A,A01,083627,Boyle; Mary E. T.,13,0,60,47
1657685035721,COGS 118A,A01,083075,Gupta; Anjum,21,0,76,55
1657685041752,CSE 3,A50,083646,Miranda; Gregory Joseph,24,0,50,26
1657685047778,CSE 8A,A50,083650,Miranda; Gregory Joseph,17,1,56,39
1657685053808,CSE 11,A01,083080,Cao; Yingjun,6,15,40,34
1657685059831,CSE 12,A01,083652,Krause-Levy; Sophia Louisa,28,1,120,92
1657685065871,CSE 15L,A01,083654,Morris; Justin Loren,9,0,50,41
1657685065871,CSE 15L,A02,083655,Morris; Justin Loren,9,0,50,41
1657685071894,CSE 20,A01,083657,Tran; Khoa Dang,39,0,80,41
1657685077917,CSE 21,A01,095574,Bach; Quang Tran,22,0,48,26
1657685083944,CSE 30,A01,083084,Eldon; John,6,0,80,74
1657685083944,CSE 30,B01,095061,Bhaskar; Nishant,9,0,50,41
1657685089967,CSE 100,A01,083659,Cao; Yingjun,5,4,70,65
1657685095993,CSE 134B,A01,083661,Powell; Thomas Allan,23,0,100,77
1657685102018,CSE 140,A01,083663,Gungor; Onat,15,0,85,70
1657685108044,CSE 140L,A01,083088,Eldon; John,22,0,100,78
1657685114067,CSE 175,A01,083665,Kumar; Rakesh,3,0,25,22
1657685120093,CSE 190,A00,092507,Dubnov; Shlomo,8,0,20,12
1657685126118,ECE 45,A01,083139,Congero; Spencer William,6,0,75,69
1657685132145,ECE 65,A50,083695,Saad; Andrew S,12,0,30,18
1657685132145,ECE 65,A51,095125,Saad; Andrew S,24,0,26,2
1657685138176,ECE 109,A01,091882,Touri; Behrouz,20,0,70,50
1657685144198,ECE 180,A00,083140,Abi Samra; Nicholas Camill,1,0,30,29
1657685144198,ECE 180,B00,083141,Abi Samra; Nicholas Camill,0,0,30,30
1657685150226,MATH 10A,A01,083735,Patchell; Gregory David,2,0,30,28
1657685150226,MATH 10A,A02,083736,Patchell; Gregory David,20,0,30,10
1657685150226,MATH 10A,A03,083737,Patchell; Gregory David,16,0,30,14
1657685156255,MATH 10B,A01,083207,Lim; Seonhee,8,0,34,26
1657685156255,MATH 10B,A02,083208,Lim; Seonhee,9,0,35,26
1657685156255,MATH 10B,A03,093472,Lim; Seonhee,7,0,34,27
1657685156255,MATH 10B,B01,083739,Sinha; Shubham,13,0,30,17
1657685162280,MATH 18,A01,083743,Cinel; Cameron Alexander,8,0,30,22
1657685162280,MATH 18,A02,083744,Cinel; Cameron Alexander,17,0,30,13
1657685162280,MATH 18,A03,083745,Cinel; Cameron Alexander,10,0,30,20
1657685162280,MATH 18,B01,083748,Rideout; David Porter,5,0,37,32
1657685162280,MATH 18,B02,083749,Rideout; David Porter,5,0,36,31
1657685162280,MATH 18,B03,083750,Rideout; David Porter,3,0,37,34
1657685162280,MATH 18,B04,083751,Rideout; David Porter,6,0,36,30
1657685162280,MATH 18,B05,093473,Rideout; David Porter,6,0,36,30
1657685162280,MATH 18,B06,093474,Rideout; David Porter,6,0,36,30
1657685168301,MATH 20A,A01,083754,Zheng; Zequn,14,0,40,26
1657685174332,MATH 20B,A01,083756,Briones; Jor-el Thomas Caparas,4,0,36,32
1657685174332,MATH 20B,A02,083757,Briones; Jor-el Thomas Caparas,1,0,36,35
1657685174332,MATH 20B,A03,093475,Briones; Jor-el Thomas Caparas,2,0,36,34
1657685180356,MATH 20C,A01,083760,Briones; Jor-el Thomas Caparas,1,0,35,34
1657685180356,MATH 20C,A02,083761,Briones; Jor-el Thomas Caparas,8,0,35,27
1657685180356,MATH 20C,A03,093476,Briones; Jor-el Thomas Caparas,0,1,36,36
1657685180356,MATH 20C,B01,083762,Bach; Quang Tran,1,0,30,29
1657685186384,MATH 20D,A01,083765,Tran; Brian Kha,5,0,30,25
1657685186384,MATH 20D,A02,083766,Tran; Brian Kha,5,0,30,25
1657685186384,MATH 20D,A03,083767,Tran; Brian Kha,5,0,30,25
1657685192409,MATH 20E,A01,083771,Ganguly; Soumya,9,0,32,23
1657685192409,MATH 20E,A02,083772,Ganguly; Soumya,6,0,32,26
1657685192409,MATH 20E,B01,083773,Ciotti; Benjamin,20,0,35,15
1657685192409,MATH 20E,B02,083774,Ciotti; Benjamin,18,0,35,17
1657685198438,MATH 103A,A01,083777,Greenfeld; Be'Eri,3,0,36,33
1657685198438,MATH 103A,A02,083778,Greenfeld; Be'Eri,5,0,36,31
1657685198438,MATH 103A,A03,093561,Greenfeld; Be'Eri,6,0,36,30
1657685198438,MATH 103A,B01,083779,Greenfeld; Be'Eri,7,0,36,29
1657685198438,MATH 103A,B02,083780,Greenfeld; Be'Eri,4,0,36,32
1657685198438,MATH 103A,B03,093562,Greenfeld; Be'Eri,3,0,36,33
1657685204464,MATH 105,A01,085443,Carter; Anne Toulson,15,0,35,20
1657685204464,MATH 105,A02,093477,Carter; Anne Toulson,20,0,35,15
1657685210488,MATH 109,A01,083213,Ganzberger; Geoffrey Michael,2,0,34,32
1657685210488,MATH 109,A02,083214,Ganzberger; Geoffrey Michael,4,0,34,30
1657685210488,MATH 109,A03,093478,Ganzberger; Geoffrey Michael,2,0,34,32
1657685210488,MATH 109,B01,083215,Ganzberger; Geoffrey Michael,1,0,32,31
1657685210488,MATH 109,B02,083216,Ganzberger; Geoffrey Michael,2,0,32,30
1657685210488,MATH 109,B03,093479,Ganzberger; Geoffrey Michael,8,0,32,24
1657685216517,MATH 142A,A01,083219,Chow; Bennett,7,0,32,25
1657685216517,MATH 142A,A02,083220,Chow; Bennett,10,0,32,22
1657685216517,MATH 142A,A03,093480,Chow; Bennett,9,0,32,23
1657685216517,MATH 142A,B03,093481,Chow; Bennett,8,0,32,24
1657685216517,MATH 142A,B04,093558,Chow; Bennett,13,0,32,19
1657685216517,MATH 142A,B05,093559,Chow; Bennett,6,0,32,26
1657685222544,MATH 193A,A01,083224,Rotar; Vladimir,8,0,34,26
1657685222544,MATH 193A,A02,083225,Rotar; Vladimir,9,0,34,25
1657685222544,MATH 193A,A03,083781,Rotar; Vladimir,5,0,34,29
1657685222544,MATH 193A,A04,083782,Rotar; Vladimir,10,0,34,24
1657685222544,MATH 193A,A05,093482,Rotar; Vladimir,10,0,34,24
1657685228567,MATH 197,001,091859,McAuley; Julian John,9999,0,9999,0
1657685228567,MATH 197,002,095566,Kedlaya; Kiran S.,9997,0,9999,2
1657685228567,MATH 197,003,095567,Xiao; Ming,9999,0,9999,0
1657685228567,MATH 197,004,095571,Perols; Johan Lars,9998,0,9999,1
1657685235628,COGS 9,A01,083615,Shannon; Kyle Michael,9,0,75,66
1657685241652,COGS 11,A01,083617,Boyle; Mary E. T.,23,0,48,25
1657685247679,COGS 13,A01,083071,Bastos; Amalia Pinkusfeld,11,0,71,60
1657685253704,COGS 14A,A01,092681,Semenuks; Arturs,5,1,100,95
1657685259727,COGS 14B,A01,083073,Cheng; Tzu-Han,6,0,63,57
1657685265749,COGS 17,A01,092677,Semenuks; Arturs,6,0,81,75
1657685271778,COGS 100,A01,083619,Allen; Michael Gordon,17,0,70,53
1657685277801,COGS 101A,A01,083621,Davis; Joshua Daniel,9,0,68,59
1657685283827,COGS 101B,A01,091572,Allen; Michael Gordon,12,0,65,53
1657685289850,COGS 101C,A01,083625,Delgado; Tania,17,0,35,18
1657685295875,COGS 107A,A01,083627,Boyle; Mary E. T.,13,0,60,47
1657685301900,COGS 118A,A01,083075,Gupta; Anjum,21,0,76,55
1657685307928,CSE 3,A50,083646,Miranda; Gregory Joseph,24,0,50,26
1657685313956,CSE 8A,A50,083650,Miranda; Gregory Joseph,17,1,56,39
1657685319980,CSE 11,A01,083080,Cao; Yingjun,6,15,40,34
1657685326005,CSE 12,A01,083652,Krause-Levy; Sophia Louisa,28,1,120,92
1657685332028,CSE 15L,A01,083654,Morris; Justin Loren,9,0,50,41
1657685332028,CSE 15L,A02,083655,Morris; Justin Loren,9,0,50,41
1657685338054,CSE 20,A01,083657,Tran; Khoa Dang,39,0,80,41
1657685344077,CSE 21,A01,095574,Bach; Quang Tran,22,0,48,26
1657685350104,CSE 30,A01,083084,Eldon; John,6,0,80,74
1657685350104,CSE 30,B01,095061,Bhaskar; Nishant,9,0,50,41
1657685356130,CSE 100,A01,083659,Cao; Yingjun,5,4,70,65
1657685362153,CSE 134B,A01,083661,Powell; Thomas Allan,23,0,100,77
1657685368178,CSE 140,A01,083663,Gungor; Onat,15,0,85,70
1657685374204,CSE 140L,A01,083088,Eldon; John,22,0,100,78
1657685380227,CSE 175,A01,083665,Kumar; Rakesh,3,0,25,22
1657685386250,CSE 190,A00,092507,Dubnov; Shlomo,8,0,20,12
1657685392277,ECE 45,A01,083139,Congero; Spencer William,6,0,75,69
1657685398371,ECE 65,A50,083695,Saad; Andrew S,12,0,30,18
1657685398371,ECE 65,A51,095125,Saad; Andrew S,24,0,26,2
1657685404404,ECE 109,A01,091882,Touri; Behrouz,20,0,70,50
1657685410426,ECE 180,A00,083140,Abi Samra; Nicholas Camill,1,0,30,29
1657685410426,ECE 180,B00,083141,Abi Samra; Nicholas Camill,0,0,30,30
1657685416450,MATH 10A,A01,083735,Patchell; Gregory David,2,0,30,28
1657685416450,MATH 10A,A02,083736,Patchell; Gregory David,20,0,30,10
1657685416450,MATH 10A,A03,083737,Patchell; Gregory David,16,0,30,14
1657685422479,MATH 10B,A01,083207,Lim; Seonhee,8,0,34,26
1657685422479,MATH 10B,A02,083208,Lim; Seonhee,9,0,35,26
1657685422479,MATH 10B,A03,093472,Lim; Seonhee,7,0,34,27
1657685422479,MATH 10B,B01,083739,Sinha; Shubham,13,0,30,17
1657685428509,MATH 18,A01,083743,Cinel; Cameron Alexander,8,0,30,22
1657685428509,MATH 18,A02,083744,Cinel; Cameron Alexander,17,0,30,13
1657685428509,MATH 18,A03,083745,Cinel; Cameron Alexander,10,0,30,20
1657685428509,MATH 18,B01,083748,Rideout; David Porter,5,0,37,32
1657685428509,MATH 18,B02,083749,Rideout; David Porter,5,0,36,31
1657685428509,MATH 18,B03,083750,Rideout; David Porter,3,0,37,34
1657685428509,MATH 18,B04,083751,Rideout; David Porter,6,0,36,30
1657685428509,MATH 18,B05,093473,Rideout; David Porter,6,0,36,30
1657685428509,MATH 18,B06,093474,Rideout; David Porter,6,0,36,30
1657685434534,MATH 20A,A01,083754,Zheng; Zequn,14,0,40,26
1657685440563,MATH 20B,A01,083756,Briones; Jor-el Thomas Caparas,4,0,36,32
1657685440563,MATH 20B,A02,083757,Briones; Jor-el Thomas Caparas,1,0,36,35
1657685440563,MATH 20B,A03,093475,Briones; Jor-el Thomas Caparas,2,0,36,34
1657685446594,MATH 20C,A01,083760,Briones; Jor-el Thomas Caparas,1,0,35,34
1657685446594,MATH 20C,A02,083761,Briones; Jor-el Thomas Caparas,8,0,35,27
1657685446594,MATH 20C,A03,093476,Briones; Jor-el Thomas Caparas,0,1,36,36
1657685446594,MATH 20C,B01,083762,Bach; Quang Tran,1,0,30,29
1657685452617,MATH 20D,A01,083765,Tran; Brian Kha,5,0,30,25
1657685452617,MATH 20D,A02,083766,Tran; Brian Kha,5,0,30,25
1657685452617,MATH 20D,A03,083767,Tran; Brian Kha,5,0,30,25
1657685458644,MATH 20E,A01,083771,Ganguly; Soumya,9,0,32,23
1657685458644,MATH 20E,A02,083772,Ganguly; Soumya,6,0,32,26
1657685458644,MATH 20E,B01,083773,Ciotti; Benjamin,20,0,35,15
1657685458644,MATH 20E,B02,083774,Ciotti; Benjamin,18,0,35,17
1657685464673,MATH 103A,A01,083777,Greenfeld; Be'Eri,3,0,36,33
1657685464673,MATH 103A,A02,083778,Greenfeld; Be'Eri,5,0,36,31
1657685464673,MATH 103A,A03,093561,Greenfeld; Be'Eri,6,0,36,30
1657685464673,MATH 103A,B01,083779,Greenfeld; Be'Eri,7,0,36,29
1657685464673,MATH 103A,B02,083780,Greenfeld; Be'Eri,4,0,36,32
1657685464673,MATH 103A,B03,093562,Greenfeld; Be'Eri,3,0,36,33
1657685470696,MATH 105,A01,085443,Carter; Anne Toulson,15,0,35,20
1657685470696,MATH 105,A02,093477,Carter; Anne Toulson,20,0,35,15
1657685476718,MATH 109,A01,083213,Ganzberger; Geoffrey Michael,2,0,34,32
1657685476718,MATH 109,A02,083214,Ganzberger; Geoffrey Michael,4,0,34,30
1657685476718,MATH 109,A03,093478,Ganzberger; Geoffrey Michael,2,0,34,32
1657685476718,MATH 109,B01,083215,Ganzberger; Geoffrey Michael,1,0,32,31
1657685476718,MATH 109,B02,083216,Ganzberger; Geoffrey Michael,2,0,32,30
1657685476718,MATH 109,B03,093479,Ganzberger; Geoffrey Michael,8,0,32,24
1657685482742,MATH 142A,A01,083219,Chow; Bennett,7,0,32,25
1657685482742,MATH 142A,A02,083220,Chow; Bennett,10,0,32,22
1657685482742,MATH 142A,A03,093480,Chow; Bennett,9,0,32,23
1657685482742,MATH 142A,B03,093481,Chow; Bennett,8,0,32,24
1657685482742,MATH 142A,B04,093558,Chow; Bennett,13,0,32,19
1657685482742,MATH 142A,B05,093559,Chow; Bennett,6,0,32,26
1657685488770,MATH 193A,A01,083224,Rotar; Vladimir,8,0,34,26
1657685488770,MATH 193A,A02,083225,Rotar; Vladimir,9,0,34,25
1657685488770,MATH 193A,A03,083781,Rotar; Vladimir,5,0,34,29
1657685488770,MATH 193A,A04,083782,Rotar; Vladimir,10,0,34,24
1657685488770,MATH 193A,A05,093482,Rotar; Vladimir,10,0,34,24
1657685494792,MATH 197,001,091859,McAuley; Julian John,9999,0,9999,0
1657685494792,MATH 197,002,095566,Kedlaya; Kiran S.,9997,0,9999,2
1657685494792,MATH 197,003,095567,Xiao; Ming,9999,0,9999,0
1657685494792,MATH 197,004,095571,Perols; Johan Lars,9998,0,9999,1
1657685501855,COGS 9,A01,083615,Shannon; Kyle Michael,9,0,75,66
1657685507881,COGS 11,A01,083617,Boyle; Mary E. T.,23,0,48,25
1657685513909,COGS 13,A01,083071,Bastos; Amalia Pinkusfeld,11,0,71,60
1657685519932,COGS 14A,A01,092681,Semenuks; Arturs,5,1,100,95
1657685525957,COGS 14B,A01,083073,Cheng; Tzu-Han,6,0,63,57
1657685531991,COGS 17,A01,092677,Semenuks; Arturs,6,0,81,75
1657685538013,COGS 100,A01,083619,Allen; Michael Gordon,17,0,70,53
1657685544039,COGS 101A,A01,083621,Davis; Joshua Daniel,9,0,68,59
1657685550066,COGS 101B,A01,091572,Allen; Michael Gordon,12,0,65,53
1657685556090,COGS 101C,A01,083625,Delgado; Tania,17,0,35,18
1657685562117,COGS 107A,A01,083627,Boyle; Mary E. T.,13,0,60,47
1657685568140,COGS 118A,A01,083075,Gupta; Anjum,21,0,76,55
1657685574162,CSE 3,A50,083646,Miranda; Gregory Joseph,24,0,50,26
1657685580190,CSE 8A,A50,083650,Miranda; Gregory Joseph,17,1,56,39
1657685586212,CSE 11,A01,083080,Cao; Yingjun,6,15,40,34
1657685592237,CSE 12,A01,083652,Krause-Levy; Sophia Louisa,28,1,120,92
1657685598284,CSE 15L,A01,083654,Morris; Justin Loren,9,0,50,41
1657685598284,CSE 15L,A02,083655,Morris; Justin Loren,9,0,50,41
1657685604311,CSE 20,A01,083657,Tran; Khoa Dang,39,0,80,41
1657685610356,CSE 21,A01,095574,Bach; Quang Tran,22,0,48,26
1657685616380,CSE 30,A01,083084,Eldon; John,6,0,80,74
1657685616380,CSE 30,B01,095061,Bhaskar; Nishant,9,0,50,41
1657685622404,CSE 100,A01,083659,Cao; Yingjun,5,4,70,65
1657685628433,CSE 134B,A01,083661,Powell; Thomas Allan,23,0,100,77
1657685634456,CSE 140,A01,083663,Gungor; Onat,15,0,85,70
1657685640484,CSE 140L,A01,083088,Eldon; John,22,0,100,78
1657685646508,CSE 175,A01,083665,Kumar; Rakesh,3,0,25,22
1657685652544,CSE 190,A00,092507,Dubnov; Shlomo,8,0,20,12
1657685658570,ECE 45,A01,083139,Congero; Spencer William,6,0,75,69
1657685664594,ECE 65,A50,083695,Saad; Andrew S,12,0,30,18
1657685664594,ECE 65,A51,095125,Saad; Andrew S,24,0,26,2
1657685670620,ECE 109,A01,091882,Touri; Behrouz,20,0,70,50
1657685676653,ECE 180,A00,083140,Abi Samra; Nicholas Camill,1,0,30,29
1657685676653,ECE 180,B00,083141,Abi Samra; Nicholas Camill,0,0,30,30
1657685682677,MATH 10A,A01,083735,Patchell; Gregory David,2,0,30,28
1657685682677,MATH 10A,A02,083736,Patchell; Gregory David,20,0,30,10
1657685682677,MATH 10A,A03,083737,Patchell; Gregory David,16,0,30,14
1657685688699,MATH 10B,A01,083207,Lim; Seonhee,8,0,34,26
1657685688699,MATH 10B,A02,083208,Lim; Seonhee,9,0,35,26
1657685688699,MATH 10B,A03,093472,Lim; Seonhee,7,0,34,27
1657685688699,MATH 10B,B01,083739,Sinha; Shubham,13,0,30,17
1657685694730,MATH 18,A01,083743,Cinel; Cameron Alexander,8,0,30,22
1657685694730,MATH 18,A02,083744,Cinel; Cameron Alexander,17,0,30,13
1657685694730,MATH 18,A03,083745,Cinel; Cameron Alexander,10,0,30,20
1657685694730,MATH 18,B01,083748,Rideout; David Porter,5,0,37,32
1657685694730,MATH 18,B02,083749,Rideout; David Porter,5,0,36,31
1657685694730,MATH 18,B03,083750,Rideout; David Porter,3,0,37,34
1657685694730,MATH 18,B04,083751,Rideout; David Porter,6,0,36,30
1657685694730,MATH 18,B05,093473,Rideout; David Porter,6,0,36,30
1657685694730,MATH 18,B06,093474,Rideout; David Porter,6,0,36,30
1657685700755,MATH 20A,A01,083754,Zheng; Zequn,14,0,40,26
1657685706784,MATH 20B,A01,083756,Briones; Jor-el Thomas Caparas,4,0,36,32
1657685706784,MATH 20B,A02,083757,Briones; Jor-el Thomas Caparas,1,0,36,35
1657685706784,MATH 20B,A03,093475,Briones; Jor-el Thomas Caparas,2,0,36,34
1657685712807,MATH 20C,A01,083760,Briones; Jor-el Thomas Caparas,1,0,35,34
1657685712807,MATH 20C,A02,083761,Briones; Jor-el Thomas Caparas,8,0,35,27
1657685712807,MATH 20C,A03,093476,Briones; Jor-el Thomas Caparas,0,1,36,36
1657685712807,MATH 20C,B01,083762,Bach; Quang Tran,1,0,30,29
1657685718830,MATH 20D,A01,083765,Tran; Brian Kha,5,0,30,25
1657685718830,MATH 20D,A02,083766,Tran; Brian Kha,5,0,30,25
1657685718830,MATH 20D,A03,083767,Tran; Brian Kha,5,0,30,25
1657685724859,MATH 20E,A01,083771,Ganguly; Soumya,9,0,32,23
1657685724859,MATH 20E,A02,083772,Ganguly; Soumya,6,0,32,26
1657685724859,MATH 20E,B01,083773,Ciotti; Benjamin,20,0,35,15
1657685724859,MATH 20E,B02,083774,Ciotti; Benjamin,18,0,35,17
1657685730884,MATH 103A,A01,083777,Greenfeld; Be'Eri,3,0,36,33
1657685730884,MATH 103A,A02,083778,Greenfeld; Be'Eri,5,0,36,31
1657685730884,MATH 103A,A03,093561,Greenfeld; Be'Eri,6,0,36,30
1657685730884,MATH 103A,B01,083779,Greenfeld; Be'Eri,7,0,36,29
1657685730884,MATH 103A,B02,083780,Greenfeld; Be'Eri,4,0,36,32
1657685730884,MATH 103A,B03,093562,Greenfeld; Be'Eri,3,0,36,33
1657685736907,MATH 105,A01,085443,Carter; Anne Toulson,15,0,35,20
1657685736907,MATH 105,A02,093477,Carter; Anne Toulson,20,0,35,15
1657685742931,MATH 109,A01,083213,Ganzberger; Geoffrey Michael,2,0,34,32
1657685742931,MATH 109,A02,083214,Ganzberger; Geoffrey Michael,4,0,34,30
1657685742931,MATH 109,A03,093478,Ganzberger; Geoffrey Michael,2,0,34,32
1657685742931,MATH 109,B01,083215,Ganzberger; Geoffrey Michael,1,0,32,31
1657685742931,MATH 109,B02,083216,Ganzberger; Geoffrey Michael,2,0,32,30
1657685742931,MATH 109,B03,093479,Ganzberger; Geoffrey Michael,8,0,32,24
1657685748962,MATH 142A,A01,083219,Chow; Bennett,7,0,32,25
1657685748962,MATH 142A,A02,083220,Chow; Bennett,10,0,32,22
1657685748962,MATH 142A,A03,093480,Chow; Bennett,9,0,32,23
1657685748962,MATH 142A,B03,093481,Chow; Bennett,8,0,32,24
1657685748962,MATH 142A,B04,093558,Chow; Bennett,13,0,32,19
1657685748962,MATH 142A,B05,093559,Chow; Bennett,6,0,32,26
1657685754992,MATH 193A,A01,083224,Rotar; Vladimir,8,0,34,26
1657685754992,MATH 193A,A02,083225,Rotar; Vladimir,9,0,34,25
1657685754992,MATH 193A,A03,083781,Rotar; Vladimir,5,0,34,29
1657685754992,MATH 193A,A04,083782,Rotar; Vladimir,10,0,34,24
1657685754992,MATH 193A,A05,093482,Rotar; Vladimir,10,0,34,24
1657685761014,MATH 197,001,091859,McAuley; Julian John,9999,0,9999,0
1657685761014,MATH 197,002,095566,Kedlaya; Kiran S.,9997,0,9999,2
1657685761014,MATH 197,003,095567,Xiao; Ming,9999,0,9999,0
1657685761014,MATH 197,004,095571,Perols; Johan Lars,9998,0,9999,1
1657685768063,COGS 9,A01,083615,Shannon; Kyle Michael,9,0,75,66
1657685774085,COGS 11,A01,083617,Boyle; Mary E. T.,23,0,48,25
1657685780111,COGS 13,A01,083071,Bastos; Amalia Pinkusfeld,11,0,71,60
1657685786139,COGS 14A,A01,092681,Semenuks; Arturs,5,1,100,95
1657685792166,COGS 14B,A01,083073,Cheng; Tzu-Han,6,0,63,57
1657685798188,COGS 17,A01,092677,Semenuks; Arturs,6,0,81,75
1657685804211,COGS 100,A01,083619,Allen; Michael Gordon,17,0,70,53
1657685810237,COGS 101A,A01,083621,Davis; Joshua Daniel,9,0,68,59
1657685816260,COGS 101B,A01,091572,Allen; Michael Gordon,12,0,65,53
1657685822284,COGS 101C,A01,083625,Delgado; Tania,17,0,35,18
1657685828307,COGS 107A,A01,083627,Boyle; Mary E. T.,13,0,60,47
1657685834330,COGS 118A,A01,083075,Gupta; Anjum,21,0,76,55
1657685840354,CSE 3,A50,083646,Miranda; Gregory Joseph,24,0,50,26
1657685846385,CSE 8A,A50,083650,Miranda; Gregory Joseph,17,1,56,39
1657685852411,CSE 11,A01,083080,Cao; Yingjun,6,15,40,34
1657685858434,CSE 12,A01,083652,Krause-Levy; Sophia Louisa,28,1,120,92
1657685864456,CSE 15L,A01,083654,Morris; Justin Loren,9,0,50,41
1657685864456,CSE 15L,A02,083655,Morris; Justin Loren,9,0,50,41
1657685870480,CSE 20,A01,083657,Tran; Khoa Dang,39,0,80,41
1657685876508,CSE 21,A01,095574,Bach; Quang Tran,22,0,48,26
1657685882534,CSE 30,A01,083084,Eldon; John,6,0,80,74
1657685882534,CSE 30,B01,095061,Bhaskar; Nishant,9,0,50,41
1657685888560,CSE 100,A01,083659,Cao; Yingjun,5,4,70,65
1657685894582,CSE 134B,A01,083661,Powell; Thomas Allan,23,0,100,77
1657685900605,CSE 140,A01,083663,Gungor; Onat,15,0,85,70
1657685906629,CSE 140L,A01,083088,Eldon; John,22,0,100,78
1657685912652,CSE 175,A01,083665,Kumar; Rakesh,3,0,25,22
1657685918673,CSE 190,A00,092507,Dubnov; Shlomo,8,0,20,12
1657685924703,ECE 45,A01,083139,Congero; Spencer William,6,0,75,69
1657685930729,ECE 65,A50,083695,Saad; Andrew S,12,0,30,18
1657685930729,ECE 65,A51,095125,Saad; Andrew S,24,0,26,2
1657685936757,ECE 109,A01,091882,Touri; Behrouz,20,0,70,50
1657685942780,ECE 180,A00,083140,Abi Samra; Nicholas Camill,1,0,30,29
1657685942780,ECE 180,B00,083141,Abi Samra; Nicholas Camill,0,0,30,30
1657685948802,MATH 10A,A01,083735,Patchell; Gregory David,2,0,30,28
1657685948802,MATH 10A,A02,083736,Patchell; Gregory David,20,0,30,10
1657685948802,MATH 10A,A03,083737,Patchell; Gregory David,16,0,30,14
1657685954827,MATH 10B,A01,083207,Lim; Seonhee,8,0,34,26
1657685954827,MATH 10B,A02,083208,Lim; Seonhee,9,0,35,26
1657685954827,MATH 10B,A03,093472,Lim; Seonhee,7,0,34,27
1657685954827,MATH 10B,B01,083739,Sinha; Shubham,13,0,30,17
1657685960850,MATH 18,A01,083743,Cinel; Cameron Alexander,8,0,30,22
1657685960850,MATH 18,A02,083744,Cinel; Cameron Alexander,17,0,30,13
1657685960850,MATH 18,A03,083745,Cinel; Cameron Alexander,10,0,30,20
1657685960850,MATH 18,B01,083748,Rideout; David Porter,5,0,37,32
1657685960850,MATH 18,B02,083749,Rideout; David Porter,5,0,36,31
1657685960850,MATH 18,B03,083750,Rideout; David Porter,3,0,37,34
1657685960850,MATH 18,B04,083751,Rideout; David Porter,6,0,36,30
1657685960850,MATH 18,B05,093473,Rideout; David Porter,6,0,36,30
1657685960850,MATH 18,B06,093474,Rideout; David Porter,6,0,36,30
1657685966875,MATH 20A,A01,083754,Zheng; Zequn,14,0,40,26
1657685972898,MATH 20B,A01,083756,Briones; Jor-el Thomas Caparas,4,0,36,32
1657685972898,MATH 20B,A02,083757,Briones; Jor-el Thomas Caparas,1,0,36,35
1657685972898,MATH 20B,A03,093475,Briones; Jor-el Thomas Caparas,2,0,36,34
1657685978926,MATH 20C,A01,083760,Briones; Jor-el Thomas Caparas,1,0,35,34
1657685978926,MATH 20C,A02,083761,Briones; Jor-el Thomas Caparas,8,0,35,27
1657685978926,MATH 20C,A03,093476,Briones; Jor-el Thomas Caparas,0,1,36,36
1657685978926,MATH 20C,B01,083762,Bach; Quang Tran,1,0,30,29
1657685984950,MATH 20D,A01,083765,Tran; Brian Kha,5,0,30,25
1657685984950,MATH 20D,A02,083766,Tran; Brian Kha,5,0,30,25
1657685984950,MATH 20D,A03,083767,Tran; Brian Kha,5,0,30,25
1657685990973,MATH 20E,A01,083771,Ganguly; Soumya,9,0,32,23
1657685990973,MATH 20E,A02,083772,Ganguly; Soumya,6,0,32,26
1657685990973,MATH 20E,B01,083773,Ciotti; Benjamin,20,0,35,15
1657685990973,MATH 20E,B02,083774,Ciotti; Benjamin,18,0,35,17
1657685997074,MATH 103A,A01,083777,Greenfeld; Be'Eri,3,0,36,33
1657685997074,MATH 103A,A02,083778,Greenfeld; Be'Eri,5,0,36,31
1657685997074,MATH 103A,A03,093561,Greenfeld; Be'Eri,6,0,36,30
1657685997074,MATH 103A,B01,083779,Greenfeld; Be'Eri,7,0,36,29
1657685997074,MATH 103A,B02,083780,Greenfeld; Be'Eri,4,0,36,32
1657685997074,MATH 103A,B03,093562,Greenfeld; Be'Eri,3,0,36,33
1657686003106,MATH 105,A01,085443,Carter; Anne Toulson,15,0,35,20
1657686003106,MATH 105,A02,093477,Carter; Anne Toulson,20,0,35,15
1657686009131,MATH 109,A01,083213,Ganzberger; Geoffrey Michael,2,0,34,32
1657686009131,MATH 109,A02,083214,Ganzberger; Geoffrey Michael,4,0,34,30
1657686009131,MATH 109,A03,093478,Ganzberger; Geoffrey Michael,2,0,34,32
1657686009131,MATH 109,B01,083215,Ganzberger; Geoffrey Michael,1,0,32,31
1657686009131,MATH 109,B02,083216,Ganzberger; Geoffrey Michael,2,0,32,30
1657686009131,MATH 109,B03,093479,Ganzberger; Geoffrey Michael,8,0,32,24
1657686015155,MATH 142A,A01,083219,Chow; Bennett,7,0,32,25
1657686015155,MATH 142A,A02,083220,Chow; Bennett,10,0,32,22
1657686015155,MATH 142A,A03,093480,Chow; Bennett,9,0,32,23
1657686015155,MATH 142A,B03,093481,Chow; Bennett,8,0,32,24
1657686015155,MATH 142A,B04,093558,Chow; Bennett,13,0,32,19
1657686015155,MATH 142A,B05,093559,Chow; Bennett,6,0,32,26
1657686021178,MATH 193A,A01,083224,Rotar; Vladimir,8,0,34,26
1657686021178,MATH 193A,A02,083225,Rotar; Vladimir,9,0,34,25
1657686021178,MATH 193A,A03,083781,Rotar; Vladimir,5,0,34,29
1657686021178,MATH 193A,A04,083782,Rotar; Vladimir,10,0,34,24
1657686021178,MATH 193A,A05,093482,Rotar; Vladimir,10,0,34,24
1657686027205,MATH 197,001,091859,McAuley; Julian John,9999,0,9999,0
1657686027205,MATH 197,002,095566,Kedlaya; Kiran S.,9997,0,9999,2
1657686027205,MATH 197,003,095567,Xiao; Ming,9999,0,9999,0
1657686027205,MATH 197,004,095571,Perols; Johan Lars,9998,0,9999,1
1657686034271,COGS 9,A01,083615,Shannon; Kyle Michael,9,0,75,66
1657686040295,COGS 11,A01,083617,Boyle; Mary E. T.,23,0,48,25
1657686046317,COGS 13,A01,083071,Bastos; Amalia Pinkusfeld,11,0,71,60
1657686052343,COGS 14A,A01,092681,Semenuks; Arturs,5,1,100,95
1657686058366,COGS 14B,A01,083073,Cheng; Tzu-Han,6,0,63,57
1657686064388,COGS 17,A01,092677,Semenuks; Arturs,6,0,81,75
1657686070411,COGS 100,A01,083619,Allen; Michael Gordon,17,0,70,53
1657686076435,COGS 101A,A01,083621,Davis; Joshua Daniel,9,0,68,59
1657686082457,COGS 101B,A01,091572,Allen; Michael Gordon,12,0,65,53
1657686088481,COGS 101C,A01,083625,Delgado; Tania,17,0,35,18
1657686094503,COGS 107A,A01,083627,Boyle; Mary E. T.,13,0,60,47
1657686100530,COGS 118A,A01,083075,Gupta; Anjum,21,0,76,55
1657686106554,CSE 3,A50,083646,Miranda; Gregory Joseph,24,0,50,26
1657686112579,CSE 8A,A50,083650,Miranda; Gregory Joseph,17,1,56,39
1657686118603,CSE 11,A01,083080,Cao; Yingjun,6,15,40,34
1657686124627,CSE 12,A01,083652,Krause-Levy; Sophia Louisa,28,1,120,92
1657686130655,CSE 15L,A01,083654,Morris; Justin Loren,9,0,50,41
1657686130655,CSE 15L,A02,083655,Morris; Justin Loren,9,0,50,41
1657686136678,CSE 20,A01,083657,Tran; Khoa Dang,39,0,80,41
1657686142704,CSE 21,A01,095574,Bach; Quang Tran,22,0,48,26
1657686148726,CSE 30,A01,083084,Eldon; John,6,0,80,74
1657686148726,CSE 30,B01,095061,Bhaskar; Nishant,9,0,50,41
1657686154748,CSE 100,A01,083659,Cao; Yingjun,5,4,70,65
1657686160771,CSE 134B,A01,083661,Powell; Thomas Allan,23,0,100,77
1657686166792,CSE 140,A01,083663,Gungor; Onat,15,0,85,70
1657686172818,CSE 140L,A01,083088,Eldon; John,22,0,100,78
1657686178839,CSE 175,A01,083665,Kumar; Rakesh,3,0,25,22
1657686184863,CSE 190,A00,092507,Dubnov; Shlomo,8,0,20,12
1657686190888,ECE 45,A01,083139,Congero; Spencer William,6,0,75,69
1657686196910,ECE 65,A50,083695,Saad; Andrew S,12,0,30,18
1657686196910,ECE 65,A51,095125,Saad; Andrew S,24,0,26,2
1657686202932,ECE 109,A01,091882,Touri; Behrouz,20,0,70,50
1657686208958,ECE 180,A00,083140,Abi Samra; Nicholas Camill,1,0,30,29
1657686208958,ECE 180,B00,083141,Abi Samra; Nicholas Camill,0,0,30,30
1657686214986,MATH 10A,A01,083735,Patchell; Gregory David,2,0,30,28
1657686214986,MATH 10A,A02,083736,Patchell; Gregory David,20,0,30,10
1657686214986,MATH 10A,A03,083737,Patchell; Gregory David,16,0,30,14
1657686221010,MATH 10B,A01,083207,Lim; Seonhee,8,0,34,26
1657686221010,MATH 10B,A02,083208,Lim; Seonhee,9,0,35,26
1657686221010,MATH 10B,A03,093472,Lim; Seonhee,7,0,34,27
1657686221010,MATH 10B,B01,083739,Sinha; Shubham,13,0,30,17
1657686227033,MATH 18,A01,083743,Cinel; Cameron Alexander,8,0,30,22
1657686227033,MATH 18,A02,083744,Cinel; Cameron Alexander,17,0,30,13
1657686227033,MATH 18,A03,083745,Cinel; Cameron Alexander,10,0,30,20
1657686227033,MATH 18,B01,083748,Rideout; David Porter,5,0,37,32
1657686227033,MATH 18,B02,083749,Rideout; David Porter,5,0,36,31
1657686227033,MATH 18,B03,083750,Rideout; David Porter,3,0,37,34
1657686227033,MATH 18,B04,083751,Rideout; David Porter,6,0,36,30
1657686227033,MATH 18,B05,093473,Rideout; David Porter,6,0,36,30
1657686227033,MATH 18,B06,093474,Rideout; David Porter,6,0,36,30
1657686233057,MATH 20A,A01,083754,Zheng; Zequn,14,0,40,26
1657686239085,MATH 20B,A01,083756,Briones; Jor-el Thomas Caparas,4,0,36,32
1657686239085,MATH 20B,A02,083757,Briones; Jor-el Thomas Caparas,1,0,36,35
1657686239085,MATH 20B,A03,093475,Briones; Jor-el Thomas Caparas,2,0,36,34
1657686245108,MATH 20C,A01,083760,Briones; Jor-el Thomas Caparas,1,0,35,34
1657686245108,MATH 20C,A02,083761,Briones; Jor-el Thomas Caparas,8,0,35,27
1657686245108,MATH 20C,A03,093476,Briones; Jor-el Thomas Caparas,0,1,36,36
1657686245108,MATH 20C,B01,083762,Bach; Quang Tran,1,0,30,29
1657686251134,MATH 20D,A01,083765,Tran; Brian Kha,5,0,30,25
1657686251134,MATH 20D,A02,083766,Tran; Brian Kha,5,0,30,25
1657686251134,MATH 20D,A03,083767,Tran; Brian Kha,5,0,30,25
1657686257162,MATH 20E,A01,083771,Ganguly; Soumya,9,0,32,23
1657686257162,MATH 20E,A02,083772,Ganguly; Soumya,6,0,32,26
1657686257162,MATH 20E,B01,083773,Ciotti; Benjamin,20,0,35,15
1657686257162,MATH 20E,B02,083774,Ciotti; Benjamin,18,0,35,17
1657686263187,MATH 103A,A01,083777,Greenfeld; Be'Eri,3,0,36,33
1657686263187,MATH 103A,A02,083778,Greenfeld; Be'Eri,5,0,36,31
1657686263187,MATH 103A,A03,093561,Greenfeld; Be'Eri,6,0,36,30
1657686263187,MATH 103A,B01,083779,Greenfeld; Be'Eri,7,0,36,29
1657686263187,MATH 103A,B02,083780,Greenfeld; Be'Eri,4,0,36,32
1657686263187,MATH 103A,B03,093562,Greenfeld; Be'Eri,3,0,36,33
1657686269209,MATH 105,A01,085443,Carter; Anne Toulson,15,0,35,20
1657686269209,MATH 105,A02,093477,Carter; Anne Toulson,20,0,35,15
1657686275238,MATH 109,A01,083213,Ganzberger; Geoffrey Michael,2,0,34,32
1657686275238,MATH 109,A02,083214,Ganzberger; Geoffrey Michael,4,0,34,30
1657686275238,MATH 109,A03,093478,Ganzberger; Geoffrey Michael,2,0,34,32
1657686275238,MATH 109,B01,083215,Ganzberger; Geoffrey Michael,1,0,32,31
1657686275238,MATH 109,B02,083216,Ganzberger; Geoffrey Michael,2,0,32,30
1657686275238,MATH 109,B03,093479,Ganzberger; Geoffrey Michael,8,0,32,24
1657686281262,MATH 142A,A01,083219,Chow; Bennett,7,0,32,25
1657686281262,MATH 142A,A02,083220,Chow; Bennett,10,0,32,22
1657686281262,MATH 142A,A03,093480,Chow; Bennett,9,0,32,23
1657686281262,MATH 142A,B03,093481,Chow; Bennett,8,0,32,24
1657686281262,MATH 142A,B04,093558,Chow; Bennett,13,0,32,19
1657686281262,MATH 142A,B05,093559,Chow; Bennett,6,0,32,26
1657686287290,MATH 193A,A01,083224,Rotar; Vladimir,8,0,34,26
1657686287290,MATH 193A,A02,083225,Rotar; Vladimir,9,0,34,25
1657686287290,MATH 193A,A03,083781,Rotar; Vladimir,5,0,34,29
1657686287290,MATH 193A,A04,083782,Rotar; Vladimir,10,0,34,24
1657686287290,MATH 193A,A05,093482,Rotar; Vladimir,10,0,34,24
1657686293314,MATH 197,001,091859,McAuley; Julian John,9999,0,9999,0
1657686293314,MATH 197,002,095566,Kedlaya; Kiran S.,9997,0,9999,2
1657686293314,MATH 197,003,095567,Xiao; Ming,9999,0,9999,0
1657686293314,MATH 197,004,095571,Perols; Johan Lars,9998,0,9999,1
1657686300375,COGS 9,A01,083615,Shannon; Kyle Michael,9,0,75,66
1657686306397,COGS 11,A01,083617,Boyle; Mary E. T.,23,0,48,25
1657686312420,COGS 13,A01,083071,Bastos; Amalia Pinkusfeld,11,0,71,60
1657686318442,COGS 14A,A01,092681,Semenuks; Arturs,5,1,100,95
1657686324468,COGS 14B,A01,083073,Cheng; Tzu-Han,6,0,63,57
1657686330492,COGS 17,A01,092677,Semenuks; Arturs,6,0,81,75
1657686336514,COGS 100,A01,083619,Allen; Michael Gordon,17,0,70,53
1657686342538,COGS 101A,A01,083621,Davis; Joshua Daniel,9,0,68,59
1657686348566,COGS 101B,A01,091572,Allen; Michael Gordon,12,0,65,53
1657686354590,COGS 101C,A01,083625,Delgado; Tania,17,0,35,18
1657686360617,COGS 107A,A01,083627,Boyle; Mary E. T.,13,0,60,47
1657686366647,COGS 118A,A01,083075,Gupta; Anjum,21,0,76,55
1657686372670,CSE 3,A50,083646,Miranda; Gregory Joseph,24,0,50,26
1657686378693,CSE 8A,A50,083650,Miranda; Gregory Joseph,17,1,56,39
1657686384720,CSE 11,A01,083080,Cao; Yingjun,6,15,40,34
1657686390743,CSE 12,A01,083652,Krause-Levy; Sophia Louisa,28,1,120,92
1657686396767,CSE 15L,A01,083654,Morris; Justin Loren,9,0,50,41
1657686396767,CSE 15L,A02,083655,Morris; Justin Loren,9,0,50,41
1657686402790,CSE 20,A01,083657,Tran; Khoa Dang,39,0,80,41
1657686408813,CSE 21,A01,095574,Bach; Quang Tran,22,0,48,26
1657686414839,CSE 30,A01,083084,Eldon; John,6,0,80,74
1657686414839,CSE 30,B01,095061,Bhaskar; Nishant,9,0,50,41
1657686420865,CSE 100,A01,083659,Cao; Yingjun,5,4,70,65
1657686426895,CSE 134B,A01,083661,Powell; Thomas Allan,23,0,100,77
1657686432922,CSE 140,A01,083663,Gungor; Onat,15,0,85,70
1657686438945,CSE 140L,A01,083088,Eldon; John,22,0,100,78
1657686444977,CSE 175,A01,083665,Kumar; Rakesh,3,0,25,22
1657686451003,CSE 190,A00,092507,Dubnov; Shlomo,8,0,20,12
1657686457025,ECE 45,A01,083139,Congero; Spencer William,6,0,75,69
1657686463052,ECE 65,A50,083695,Saad; Andrew S,12,0,30,18
1657686463052,ECE 65,A51,095125,Saad; Andrew S,24,0,26,2
1657686469074,ECE 109,A01,091882,Touri; Behrouz,20,0,70,50
1657686475105,ECE 180,A00,083140,Abi Samra; Nicholas Camill,1,0,30,29
1657686475105,ECE 180,B00,083141,Abi Samra; Nicholas Camill,0,0,30,30
1657686481129,MATH 10A,A01,083735,Patchell; Gregory David,2,0,30,28
1657686481129,MATH 10A,A02,083736,Patchell; Gregory David,20,0,30,10
1657686481129,MATH 10A,A03,083737,Patchell; Gregory David,16,0,30,14
1657686487159,MATH 10B,A01,083207,Lim; Seonhee,8,0,34,26
1657686487159,MATH 10B,A02,083208,Lim; Seonhee,9,0,35,26
1657686487159,MATH 10B,A03,093472,Lim; Seonhee,7,0,34,27
1657686487159,MATH 10B,B01,083739,Sinha; Shubham,13,0,30,17
1657686493191,MATH 18,A01,083743,Cinel; Cameron Alexander,8,0,30,22
1657686493191,MATH 18,A02,083744,Cinel; Cameron Alexander,17,0,30,13
1657686493191,MATH 18,A03,083745,Cinel; Cameron Alexander,10,0,30,20
1657686493191,MATH 18,B01,083748,Rideout; David Porter,5,0,37,32
1657686493191,MATH 18,B02,083749,Rideout; David Porter,5,0,36,31
1657686493191,MATH 18,B03,083750,Rideout; David Porter,3,0,37,34
1657686493191,MATH 18,B04,083751,Rideout; David Porter,6,0,36,30
1657686493191,MATH 18,B05,093473,Rideout; David Porter,6,0,36,30
1657686493191,MATH 18,B06,093474,Rideout; David Porter,6,0,36,30
1657686499213,MATH 20A,A01,083754,Zheng; Zequn,14,0,40,26
1657686505238,MATH 20B,A01,083756,Briones; Jor-el Thomas Caparas,4,0,36,32
1657686505238,MATH 20B,A02,083757,Briones; Jor-el Thomas Caparas,1,0,36,35
1657686505238,MATH 20B,A03,093475,Briones; Jor-el Thomas Caparas,2,0,36,34
1657686511261,MATH 20C,A01,083760,Briones; Jor-el Thomas Caparas,1,0,35,34
1657686511261,MATH 20C,A02,083761,Briones; Jor-el Thomas Caparas,8,0,35,27
1657686511261,MATH 20C,A03,093476,Briones; Jor-el Thomas Caparas,0,1,36,36
1657686511261,MATH 20C,B01,083762,Bach; Quang Tran,1,0,30,29
1657686517285,MATH 20D,A01,083765,Tran; Brian Kha,5,0,30,25
1657686517285,MATH 20D,A02,083766,Tran; Brian Kha,5,0,30,25
1657686517285,MATH 20D,A03,083767,Tran; Brian Kha,5,0,30,25
1657686523321,MATH 20E,A01,083771,Ganguly; Soumya,9,0,32,23
1657686523321,MATH 20E,A02,083772,Ganguly; Soumya,6,0,32,26
1657686523321,MATH 20E,B01,083773,Ciotti; Benjamin,20,0,35,15
1657686523321,MATH 20E,B02,083774,Ciotti; Benjamin,18,0,35,17
1657686529356,MATH 103A,A01,083777,Greenfeld; Be'Eri,3,0,36,33
1657686529356,MATH 103A,A02,083778,Greenfeld; Be'Eri,5,0,36,31
1657686529356,MATH 103A,A03,093561,Greenfeld; Be'Eri,6,0,36,30
1657686529356,MATH 103A,B01,083779,Greenfeld; Be'Eri,7,0,36,29
1657686529356,MATH 103A,B02,083780,Greenfeld; Be'Eri,4,0,36,32
1657686529356,MATH 103A,B03,093562,Greenfeld; Be'Eri,3,0,36,33
1657686535379,MATH 105,A01,085443,Carter; Anne Toulson,15,0,35,20
1657686535379,MATH 105,A02,093477,Carter; Anne Toulson,20,0,35,15
1657686541402,MATH 109,A01,083213,Ganzberger; Geoffrey Michael,2,0,34,32
1657686541402,MATH 109,A02,083214,Ganzberger; Geoffrey Michael,4,0,34,30
1657686541402,MATH 109,A03,093478,Ganzberger; Geoffrey Michael,2,0,34,32
1657686541402,MATH 109,B01,083215,Ganzberger; Geoffrey Michael,1,0,32,31
1657686541402,MATH 109,B02,083216,Ganzberger; Geoffrey Michael,2,0,32,30
1657686541402,MATH 109,B03,093479,Ganzberger; Geoffrey Michael,8,0,32,24
1657686547435,MATH 142A,A01,083219,Chow; Bennett,7,0,32,25
1657686547435,MATH 142A,A02,083220,Chow; Bennett,10,0,32,22
1657686547435,MATH 142A,A03,093480,Chow; Bennett,9,0,32,23
1657686547435,MATH 142A,B03,093481,Chow; Bennett,8,0,32,24
1657686547435,MATH 142A,B04,093558,Chow; Bennett,13,0,32,19
1657686547435,MATH 142A,B05,093559,Chow; Bennett,6,0,32,26
1657686553461,MATH 193A,A01,083224,Rotar; Vladimir,8,0,34,26
1657686553461,MATH 193A,A02,083225,Rotar; Vladimir,9,0,34,25
1657686553461,MATH 193A,A03,083781,Rotar; Vladimir,5,0,34,29
1657686553461,MATH 193A,A04,083782,Rotar; Vladimir,10,0,34,24
1657686553461,MATH 193A,A05,093482,Rotar; Vladimir,10,0,34,24
1657686559485,MATH 197,001,091859,McAuley; Julian John,9999,0,9999,0
1657686559485,MATH 197,002,095566,Kedlaya; Kiran S.,9997,0,9999,2
1657686559485,MATH 197,003,095567,Xiao; Ming,9999,0,9999,0
1657686559485,MATH 197,004,095571,Perols; Johan Lars,9998,0,9999,1
1657686566546,COGS 9,A01,083615,Shannon; Kyle Michael,9,0,75,66
1657686572571,COGS 11,A01,083617,Boyle; Mary E. T.,23,0,48,25
1657686578595,COGS 13,A01,083071,Bastos; Amalia Pinkusfeld,11,0,71,60
1657686584626,COGS 14A,A01,092681,Semenuks; Arturs,5,1,100,95
1657686590725,COGS 14B,A01,083073,Cheng; Tzu-Han,6,0,63,57
1657686596751,COGS 17,A01,092677,Semenuks; Arturs,6,0,81,75
1657686602775,COGS 100,A01,083619,Allen; Michael Gordon,17,0,70,53
1657686608834,COGS 101A,A01,083621,Davis; Joshua Daniel,9,0,68,59
1657686614858,COGS 101B,A01,091572,Allen; Michael Gordon,12,0,65,53
1657686620885,COGS 101C,A01,083625,Delgado; Tania,17,0,35,18
1657686626916,COGS 107A,A01,083627,Boyle; Mary E. T.,13,0,60,47
1657686632939,COGS 118A,A01,083075,Gupta; Anjum,21,0,76,55
1657686638962,CSE 3,A50,083646,Miranda; Gregory Joseph,24,0,50,26
1657686644996,CSE 8A,A50,083650,Miranda; Gregory Joseph,17,1,56,39
1657686651019,CSE 11,A01,083080,Cao; Yingjun,6,15,40,34
1657686657044,CSE 12,A01,083652,Krause-Levy; Sophia Louisa,28,1,120,92
1657686663067,CSE 15L,A01,083654,Morris; Justin Loren,9,0,50,41
1657686663067,CSE 15L,A02,083655,Morris; Justin Loren,9,0,50,41
1657686669101,CSE 20,A01,083657,Tran; Khoa Dang,39,0,80,41
1657686675127,CSE 21,A01,095574,Bach; Quang Tran,22,0,48,26
1657686681148,CSE 30,A01,083084,Eldon; John,6,0,80,74
1657686681148,CSE 30,B01,095061,Bhaskar; Nishant,9,0,50,41
1657686687172,CSE 100,A01,083659,Cao; Yingjun,5,4,70,65
1657686693196,CSE 134B,A01,083661,Powell; Thomas Allan,23,0,100,77
1657686699225,CSE 140,A01,083663,Gungor; Onat,15,0,85,70
1657686705257,CSE 140L,A01,083088,Eldon; John,22,0,100,78
1657686711283,CSE 175,A01,083665,Kumar; Rakesh,3,0,25,22
1657686717309,CSE 190,A00,092507,Dubnov; Shlomo,8,0,20,12
1657686723336,ECE 45,A01,083139,Congero; Spencer William,6,0,75,69
1657686729362,ECE 65,A50,083695,Saad; Andrew S,12,0,30,18
1657686729362,ECE 65,A51,095125,Saad; Andrew S,24,0,26,2
1657686735385,ECE 109,A01,091882,Touri; Behrouz,20,0,70,50
1657686741411,ECE 180,A00,083140,Abi Samra; Nicholas Camill,1,0,30,29
1657686741411,ECE 180,B00,083141,Abi Samra; Nicholas Camill,0,0,30,30
1657686747435,MATH 10A,A01,083735,Patchell; Gregory David,2,0,30,28
1657686747435,MATH 10A,A02,083736,Patchell; Gregory David,20,0,30,10
1657686747435,MATH 10A,A03,083737,Patchell; Gregory David,16,0,30,14
1657686753466,MATH 10B,A01,083207,Lim; Seonhee,8,0,34,26
1657686753466,MATH 10B,A02,083208,Lim; Seonhee,9,0,35,26
1657686753466,MATH 10B,A03,093472,Lim; Seonhee,7,0,34,27
1657686753466,MATH 10B,B01,083739,Sinha; Shubham,13,0,30,17
1657686759507,MATH 18,A01,083743,Cinel; Cameron Alexander,8,0,30,22
1657686759507,MATH 18,A02,083744,Cinel; Cameron Alexander,17,0,30,13
1657686759507,MATH 18,A03,083745,Cinel; Cameron Alexander,10,0,30,20
1657686759507,MATH 18,B01,083748,Rideout; David Porter,5,0,37,32
1657686759507,MATH 18,B02,083749,Rideout; David Porter,5,0,36,31
1657686759507,MATH 18,B03,083750,Rideout; David Porter,3,0,37,34
1657686759507,MATH 18,B04,083751,Rideout; David Porter,6,0,36,30
1657686759507,MATH 18,B05,093473,Rideout; David Porter,6,0,36,30
1657686759507,MATH 18,B06,093474,Rideout; David Porter,6,0,36,30
1657686765530,MATH 20A,A01,083754,Zheng; Zequn,14,0,40,26
1657686771554,MATH 20B,A01,083756,Briones; Jor-el Thomas Caparas,4,0,36,32
1657686771554,MATH 20B,A02,083757,Briones; Jor-el Thomas Caparas,1,0,36,35
1657686771554,MATH 20B,A03,093475,Briones; Jor-el Thomas Caparas,2,0,36,34
1657686777578,MATH 20C,A01,083760,Briones; Jor-el Thomas Caparas,1,0,35,34
1657686777578,MATH 20C,A02,083761,Briones; Jor-el Thomas Caparas,8,0,35,27
1657686777578,MATH 20C,A03,093476,Briones; Jor-el Thomas Caparas,0,1,36,36
1657686777578,MATH 20C,B01,083762,Bach; Quang Tran,1,0,30,29
1657686783607,MATH 20D,A01,083765,Tran; Brian Kha,5,0,30,25
1657686783607,MATH 20D,A02,083766,Tran; Brian Kha,5,0,30,25
1657686783607,MATH 20D,A03,083767,Tran; Brian Kha,5,0,30,25
1657686789631,MATH 20E,A01,083771,Ganguly; Soumya,9,0,32,23
1657686789631,MATH 20E,A02,083772,Ganguly; Soumya,6,0,32,26
1657686789631,MATH 20E,B01,083773,Ciotti; Benjamin,20,0,35,15
1657686789631,MATH 20E,B02,083774,Ciotti; Benjamin,18,0,35,17
1657686795656,MATH 103A,A01,083777,Greenfeld; Be'Eri,3,0,36,33
1657686795656,MATH 103A,A02,083778,Greenfeld; Be'Eri,5,0,36,31
1657686795656,MATH 103A,A03,093561,Greenfeld; Be'Eri,6,0,36,30
1657686795656,MATH 103A,B01,083779,Greenfeld; Be'Eri,7,0,36,29
1657686795656,MATH 103A,B02,083780,Greenfeld; Be'Eri,4,0,36,32
1657686795656,MATH 103A,B03,093562,Greenfeld; Be'Eri,3,0,36,33
1657686801680,MATH 105,A01,085443,Carter; Anne Toulson,15,0,35,20
1657686801680,MATH 105,A02,093477,Carter; Anne Toulson,20,0,35,15
1657686807705,MATH 109,A01,083213,Ganzberger; Geoffrey Michael,2,0,34,32
1657686807705,MATH 109,A02,083214,Ganzberger; Geoffrey Michael,4,0,34,30
1657686807705,MATH 109,A03,093478,Ganzberger; Geoffrey Michael,2,0,34,32
1657686807705,MATH 109,B01,083215,Ganzberger; Geoffrey Michael,1,0,32,31
1657686807705,MATH 109,B02,083216,Ganzberger; Geoffrey Michael,2,0,32,30
1657686807705,MATH 109,B03,093479,Ganzberger; Geoffrey Michael,8,0,32,24
1657686813730,MATH 142A,A01,083219,Chow; Bennett,7,0,32,25
1657686813730,MATH 142A,A02,083220,Chow; Bennett,10,0,32,22
1657686813730,MATH 142A,A03,093480,Chow; Bennett,9,0,32,23
1657686813730,MATH 142A,B03,093481,Chow; Bennett,8,0,32,24
1657686813730,MATH 142A,B04,093558,Chow; Bennett,13,0,32,19
1657686813730,MATH 142A,B05,093559,Chow; Bennett,6,0,32,26
1657686819758,MATH 193A,A01,083224,Rotar; Vladimir,8,0,34,26
1657686819758,MATH 193A,A02,083225,Rotar; Vladimir,9,0,34,25
1657686819758,MATH 193A,A03,083781,Rotar; Vladimir,5,0,34,29
1657686819758,MATH 193A,A04,083782,Rotar; Vladimir,10,0,34,24
1657686819758,MATH 193A,A05,093482,Rotar; Vladimir,10,0,34,24
1657686825781,MATH 197,001,091859,McAuley; Julian John,9999,0,9999,0
1657686825781,MATH 197,002,095566,Kedlaya; Kiran S.,9997,0,9999,2
1657686825781,MATH 197,003,095567,Xiao; Ming,9999,0,9999,0
1657686825781,MATH 197,004,095571,Perols; Johan Lars,9998,0,9999,1
1657686832838,COGS 9,A01,083615,Shannon; Kyle Michael,9,0,75,66
1657686838862,COGS 11,A01,083617,Boyle; Mary E. T.,23,0,48,25
1657686844889,COGS 13,A01,083071,Bastos; Amalia Pinkusfeld,11,0,71,60
1657686850921,COGS 14A,A01,092681,Semenuks; Arturs,5,1,100,95
1657686856946,COGS 14B,A01,083073,Cheng; Tzu-Han,6,0,63,57
1657686862968,COGS 17,A01,092677,Semenuks; Arturs,6,0,81,75
1657686868994,COGS 100,A01,083619,Allen; Michael Gordon,17,0,70,53
1657686875022,COGS 101A,A01,083621,Davis; Joshua Daniel,9,0,68,59
1657686881047,COGS 101B,A01,091572,Allen; Michael Gordon,12,0,65,53
1657686887070,COGS 101C,A01,083625,Delgado; Tania,17,0,35,18
1657686893093,COGS 107A,A01,083627,Boyle; Mary E. T.,13,0,60,47
1657686899116,COGS 118A,A01,083075,Gupta; Anjum,21,0,76,55
1657686905147,CSE 3,A50,083646,Miranda; Gregory Joseph,24,0,50,26
1657686911170,CSE 8A,A50,083650,Miranda; Gregory Joseph,17,1,56,39
1657686917197,CSE 11,A01,083080,Cao; Yingjun,6,15,40,34
1657686923225,CSE 12,A01,083652,Krause-Levy; Sophia Louisa,28,1,120,92
1657686929249,CSE 15L,A01,083654,Morris; Justin Loren,9,0,50,41
1657686929249,CSE 15L,A02,083655,Morris; Justin Loren,9,0,50,41
1657686935271,CSE 20,A01,083657,Tran; Khoa Dang,39,0,80,41
1657686941297,CSE 21,A01,095574,Bach; Quang Tran,22,0,48,26
1657686947321,CSE 30,A01,083084,Eldon; John,6,0,80,74
1657686947321,CSE 30,B01,095061,Bhaskar; Nishant,9,0,50,41
1657686953348,CSE 100,A01,083659,Cao; Yingjun,5,4,70,65
1657686959375,CSE 134B,A01,083661,Powell; Thomas Allan,23,0,100,77
1657686965397,CSE 140,A01,083663,Gungor; Onat,15,0,85,70
1657686971422,CSE 140L,A01,083088,Eldon; John,22,0,100,78
1657686977449,CSE 175,A01,083665,Kumar; Rakesh,3,0,25,22
1657686983479,CSE 190,A00,092507,Dubnov; Shlomo,8,0,20,12
1657686989507,ECE 45,A01,083139,Congero; Spencer William,6,0,75,69
1657686995535,ECE 65,A50,083695,Saad; Andrew S,12,0,30,18
1657686995535,ECE 65,A51,095125,Saad; Andrew S,24,0,26,2
1657687001558,ECE 109,A01,091882,Touri; Behrouz,20,0,70,50
1657687007586,ECE 180,A00,083140,Abi Samra; Nicholas Camill,1,0,30,29
1657687007586,ECE 180,B00,083141,Abi Samra; Nicholas Camill,0,0,30,30
1657687013611,MATH 10A,A01,083735,Patchell; Gregory David,2,0,30,28
1657687013611,MATH 10A,A02,083736,Patchell; Gregory David,20,0,30,10
1657687013611,MATH 10A,A03,083737,Patchell; Gregory David,16,0,30,14
1657687019635,MATH 10B,A01,083207,Lim; Seonhee,8,0,34,26
1657687019635,MATH 10B,A02,083208,Lim; Seonhee,9,0,35,26
1657687019635,MATH 10B,A03,093472,Lim; Seonhee,7,0,34,27
1657687019635,MATH 10B,B01,083739,Sinha; Shubham,13,0,30,17
1657687025660,MATH 18,A01,083743,Cinel; Cameron Alexander,8,0,30,22
1657687025660,MATH 18,A02,083744,Cinel; Cameron Alexander,17,0,30,13
1657687025660,MATH 18,A03,083745,Cinel; Cameron Alexander,10,0,30,20
1657687025660,MATH 18,B01,083748,Rideout; David Porter,5,0,37,32
1657687025660,MATH 18,B02,083749,Rideout; David Porter,5,0,36,31
1657687025660,MATH 18,B03,083750,Rideout; David Porter,3,0,37,34
1657687025660,MATH 18,B04,083751,Rideout; David Porter,6,0,36,30
1657687025660,MATH 18,B05,093473,Rideout; David Porter,6,0,36,30
1657687025660,MATH 18,B06,093474,Rideout; David Porter,6,0,36,30
1657687031686,MATH 20A,A01,083754,Zheng; Zequn,14,0,40,26
1657687037709,MATH 20B,A01,083756,Briones; Jor-el Thomas Caparas,4,0,36,32
1657687037709,MATH 20B,A02,083757,Briones; Jor-el Thomas Caparas,1,0,36,35
1657687037709,MATH 20B,A03,093475,Briones; Jor-el Thomas Caparas,2,0,36,34
1657687043733,MATH 20C,A01,083760,Briones; Jor-el Thomas Caparas,1,0,35,34
1657687043733,MATH 20C,A02,083761,Briones; Jor-el Thomas Caparas,8,0,35,27
1657687043733,MATH 20C,A03,093476,Briones; Jor-el Thomas Caparas,0,1,36,36
1657687043733,MATH 20C,B01,083762,Bach; Quang Tran,1,0,30,29
1657687049763,MATH 20D,A01,083765,Tran; Brian Kha,5,0,30,25
1657687049763,MATH 20D,A02,083766,Tran; Brian Kha,5,0,30,25
1657687049763,MATH 20D,A03,083767,Tran; Brian Kha,5,0,30,25
1657687055785,MATH 20E,A01,083771,Ganguly; Soumya,9,0,32,23
1657687055785,MATH 20E,A02,083772,Ganguly; Soumya,6,0,32,26
1657687055785,MATH 20E,B01,083773,Ciotti; Benjamin,20,0,35,15
1657687055785,MATH 20E,B02,083774,Ciotti; Benjamin,18,0,35,17
1657687061814,MATH 103A,A01,083777,Greenfeld; Be'Eri,3,0,36,33
1657687061814,MATH 103A,A02,083778,Greenfeld; Be'Eri,5,0,36,31
1657687061814,MATH 103A,A03,093561,Greenfeld; Be'Eri,6,0,36,30
1657687061814,MATH 103A,B01,083779,Greenfeld; Be'Eri,7,0,36,29
1657687061814,MATH 103A,B02,083780,Greenfeld; Be'Eri,4,0,36,32
1657687061814,MATH 103A,B03,093562,Greenfeld; Be'Eri,3,0,36,33
1657687067838,MATH 105,A01,085443,Carter; Anne Toulson,15,0,35,20
1657687067838,MATH 105,A02,093477,Carter; Anne Toulson,20,0,35,15
1657687073866,MATH 109,A01,083213,Ganzberger; Geoffrey Michael,2,0,34,32
1657687073866,MATH 109,A02,083214,Ganzberger; Geoffrey Michael,4,0,34,30
1657687073866,MATH 109,A03,093478,Ganzberger; Geoffrey Michael,2,0,34,32
1657687073866,MATH 109,B01,083215,Ganzberger; Geoffrey Michael,1,0,32,31
1657687073866,MATH 109,B02,083216,Ganzberger; Geoffrey Michael,2,0,32,30
1657687073866,MATH 109,B03,093479,Ganzberger; Geoffrey Michael,8,0,32,24
1657687079890,MATH 142A,A01,083219,Chow; Bennett,7,0,32,25
1657687079890,MATH 142A,A02,083220,Chow; Bennett,10,0,32,22
1657687079890,MATH 142A,A03,093480,Chow; Bennett,9,0,32,23
1657687079890,MATH 142A,B03,093481,Chow; Bennett,8,0,32,24
1657687079890,MATH 142A,B04,093558,Chow; Bennett,13,0,32,19
1657687079890,MATH 142A,B05,093559,Chow; Bennett,6,0,32,26
1657687085914,MATH 193A,A01,083224,Rotar; Vladimir,8,0,34,26
1657687085914,MATH 193A,A02,083225,Rotar; Vladimir,9,0,34,25
1657687085914,MATH 193A,A03,083781,Rotar; Vladimir,5,0,34,29
1657687085914,MATH 193A,A04,083782,Rotar; Vladimir,10,0,34,24
1657687085914,MATH 193A,A05,093482,Rotar; Vladimir,10,0,34,24
1657687091940,MATH 197,001,091859,McAuley; Julian John,9999,0,9999,0
1657687091940,MATH 197,002,095566,Kedlaya; Kiran S.,9997,0,9999,2
1657687091940,MATH 197,003,095567,Xiao; Ming,9999,0,9999,0
1657687091940,MATH 197,004,095571,Perols; Johan Lars,9998,0,9999,1
1657687099006,COGS 9,A01,083615,Shannon; Kyle Michael,9,0,75,66
1657687105032,COGS 11,A01,083617,Boyle; Mary E. T.,23,0,48,25
1657687111055,COGS 13,A01,083071,Bastos; Amalia Pinkusfeld,11,0,71,60
1657687117084,COGS 14A,A01,092681,Semenuks; Arturs,5,1,100,95
1657687123118,COGS 14B,A01,083073,Cheng; Tzu-Han,6,0,63,57
1657687129147,COGS 17,A01,092677,Semenuks; Arturs,6,0,81,75
1657687135169,COGS 100,A01,083619,Allen; Michael Gordon,17,0,70,53
1657687141193,COGS 101A,A01,083621,Davis; Joshua Daniel,9,0,68,59
1657687147224,COGS 101B,A01,091572,Allen; Michael Gordon,12,0,65,53
1657687153251,COGS 101C,A01,083625,Delgado; Tania,17,0,35,18
1657687159275,COGS 107A,A01,083627,Boyle; Mary E. T.,13,0,60,47
1657687165298,COGS 118A,A01,083075,Gupta; Anjum,21,0,76,55
1657687171326,CSE 3,A50,083646,Miranda; Gregory Joseph,24,0,50,26
1657687177349,CSE 8A,A50,083650,Miranda; Gregory Joseph,17,1,56,39
1657687183375,CSE 11,A01,083080,Cao; Yingjun,6,15,40,34
1657687189513,CSE 12,A01,083652,Krause-Levy; Sophia Louisa,28,1,120,92
1657687195553,CSE 15L,A01,083654,Morris; Justin Loren,9,0,50,41
1657687195553,CSE 15L,A02,083655,Morris; Justin Loren,9,0,50,41
1657687201579,CSE 20,A01,083657,Tran; Khoa Dang,39,0,80,41
1657687207621,CSE 21,A01,095574,Bach; Quang Tran,22,0,48,26
1657687213648,CSE 30,A01,083084,Eldon; John,6,0,80,74
1657687213648,CSE 30,B01,095061,Bhaskar; Nishant,9,0,50,41
1657687219670,CSE 100,A01,083659,Cao; Yingjun,5,4,70,65
1657687225706,CSE 134B,A01,083661,Powell; Thomas Allan,23,0,100,77
1657687231730,CSE 140,A01,083663,Gungor; Onat,15,0,85,70
1657687237763,CSE 140L,A01,083088,Eldon; John,22,0,100,78
1657687243789,CSE 175,A01,083665,Kumar; Rakesh,3,0,25,22
1657687249814,CSE 190,A00,092507,Dubnov; Shlomo,8,0,20,12
1657687255838,ECE 45,A01,083139,Congero; Spencer William,6,0,75,69
1657687261872,ECE 65,A50,083695,Saad; Andrew S,12,0,30,18
1657687261872,ECE 65,A51,095125,Saad; Andrew S,24,0,26,2
1657687267898,ECE 109,A01,091882,Touri; Behrouz,20,0,70,50
1657687273921,ECE 180,A00,083140,Abi Samra; Nicholas Camill,1,0,30,29
1657687273921,ECE 180,B00,083141,Abi Samra; Nicholas Camill,0,0,30,30
1657687279942,MATH 10A,A01,083735,Patchell; Gregory David,2,0,30,28
1657687279942,MATH 10A,A02,083736,Patchell; Gregory David,20,0,30,10
1657687279942,MATH 10A,A03,083737,Patchell; Gregory David,16,0,30,14
1657687285970,MATH 10B,A01,083207,Lim; Seonhee,8,0,34,26
1657687285970,MATH 10B,A02,083208,Lim; Seonhee,9,0,35,26
1657687285970,MATH 10B,A03,093472,Lim; Seonhee,7,0,34,27
1657687285970,MATH 10B,B01,083739,Sinha; Shubham,13,0,30,17
1657687291994,MATH 18,A01,083743,Cinel; Cameron Alexander,8,0,30,22
1657687291994,MATH 18,A02,083744,Cinel; Cameron Alexander,17,0,30,13
1657687291994,MATH 18,A03,083745,Cinel; Cameron Alexander,10,0,30,20
1657687291994,MATH 18,B01,083748,Rideout; David Porter,5,0,37,32
1657687291994,MATH 18,B02,083749,Rideout; David Porter,5,0,36,31
1657687291994,MATH 18,B03,083750,Rideout; David Porter,3,0,37,34
1657687291994,MATH 18,B04,083751,Rideout; David Porter,6,0,36,30
1657687291994,MATH 18,B05,093473,Rideout; David Porter,6,0,36,30
1657687291994,MATH 18,B06,093474,Rideout; David Porter,6,0,36,30
1657687298016,MATH 20A,A01,083754,Zheng; Zequn,14,0,40,26
1657687304042,MATH 20B,A01,083756,Briones; Jor-el Thomas Caparas,4,0,36,32
1657687304042,MATH 20B,A02,083757,Briones; Jor-el Thomas Caparas,1,0,36,35
1657687304042,MATH 20B,A03,093475,Briones; Jor-el Thomas Caparas,2,0,36,34
1657687310070,MATH 20C,A01,083760,Briones; Jor-el Thomas Caparas,1,0,35,34
1657687310070,MATH 20C,A02,083761,Briones; Jor-el Thomas Caparas,8,0,35,27
1657687310070,MATH 20C,A03,093476,Briones; Jor-el Thomas Caparas,0,1,36,36
1657687310070,MATH 20C,B01,083762,Bach; Quang Tran,1,0,30,29
1657687316099,MATH 20D,A01,083765,Tran; Brian Kha,5,0,30,25
1657687316099,MATH 20D,A02,083766,Tran; Brian Kha,5,0,30,25
1657687316099,MATH 20D,A03,083767,Tran; Brian Kha,5,0,30,25
1657687322123,MATH 20E,A01,083771,Ganguly; Soumya,9,0,32,23
1657687322123,MATH 20E,A02,083772,Ganguly; Soumya,6,0,32,26
1657687322123,MATH 20E,B01,083773,Ciotti; Benjamin,20,0,35,15
1657687322123,MATH 20E,B02,083774,Ciotti; Benjamin,18,0,35,17
1657687328150,MATH 103A,A01,083777,Greenfeld; Be'Eri,3,0,36,33
1657687328150,MATH 103A,A02,083778,Greenfeld; Be'Eri,5,0,36,31
1657687328150,MATH 103A,A03,093561,Greenfeld; Be'Eri,6,0,36,30
1657687328150,MATH 103A,B01,083779,Greenfeld; Be'Eri,7,0,36,29
1657687328150,MATH 103A,B02,083780,Greenfeld; Be'Eri,4,0,36,32
1657687328150,MATH 103A,B03,093562,Greenfeld; Be'Eri,3,0,36,33
1657687334173,MATH 105,A01,085443,Carter; Anne Toulson,15,0,35,20
1657687334173,MATH 105,A02,093477,Carter; Anne Toulson,20,0,35,15
1657687340197,MATH 109,A01,083213,Ganzberger; Geoffrey Michael,2,0,34,32
1657687340197,MATH 109,A02,083214,Ganzberger; Geoffrey Michael,4,0,34,30
1657687340197,MATH 109,A03,093478,Ganzberger; Geoffrey Michael,2,0,34,32
1657687340197,MATH 109,B01,083215,Ganzberger; Geoffrey Michael,1,0,32,31
1657687340197,MATH 109,B02,083216,Ganzberger; Geoffrey Michael,2,0,32,30
1657687340197,MATH 109,B03,093479,Ganzberger; Geoffrey Michael,8,0,32,24
1657687346221,MATH 142A,A01,083219,Chow; Bennett,7,0,32,25
1657687346221,MATH 142A,A02,083220,Chow; Bennett,10,0,32,22
1657687346221,MATH 142A,A03,093480,Chow; Bennett,9,0,32,23
1657687346221,MATH 142A,B03,093481,Chow; Bennett,8,0,32,24
1657687346221,MATH 142A,B04,093558,Chow; Bennett,13,0,32,19
1657687346221,MATH 142A,B05,093559,Chow; Bennett,6,0,32,26
1657687352250,MATH 193A,A01,083224,Rotar; Vladimir,8,0,34,26
1657687352250,MATH 193A,A02,083225,Rotar; Vladimir,9,0,34,25
1657687352250,MATH 193A,A03,083781,Rotar; Vladimir,5,0,34,29
1657687352250,MATH 193A,A04,083782,Rotar; Vladimir,10,0,34,24
1657687352250,MATH 193A,A05,093482,Rotar; Vladimir,10,0,34,24
1657687358277,MATH 197,001,091859,McAuley; Julian John,9999,0,9999,0
1657687358277,MATH 197,002,095566,Kedlaya; Kiran S.,9997,0,9999,2
1657687358277,MATH 197,003,095567,Xiao; Ming,9999,0,9999,0
1657687358277,MATH 197,004,095571,Perols; Johan Lars,9998,0,9999,1
1657687365330,COGS 9,A01,083615,Shannon; Kyle Michael,9,0,75,66
1657687371357,COGS 11,A01,083617,Boyle; Mary E. T.,23,0,48,25
1657687377385,COGS 13,A01,083071,Bastos; Amalia Pinkusfeld,11,0,71,60
1657687383408,COGS 14A,A01,092681,Semenuks; Arturs,5,1,100,95
1657687389433,COGS 14B,A01,083073,Cheng; Tzu-Han,6,0,63,57
1657687395459,COGS 17,A01,092677,Semenuks; Arturs,6,0,81,75
1657687401485,COGS 100,A01,083619,Allen; Michael Gordon,17,0,70,53
1657687407509,COGS 101A,A01,083621,Davis; Joshua Daniel,9,0,68,59
1657687413533,COGS 101B,A01,091572,Allen; Michael Gordon,12,0,65,53
1657687419560,COGS 101C,A01,083625,Delgado; Tania,17,0,35,18
1657687425583,COGS 107A,A01,083627,Boyle; Mary E. T.,13,0,60,47
1657687431606,COGS 118A,A01,083075,Gupta; Anjum,21,0,76,55
1657687437635,CSE 3,A50,083646,Miranda; Gregory Joseph,24,0,50,26
1657687443658,CSE 8A,A50,083650,Miranda; Gregory Joseph,17,1,56,39
1657687449687,CSE 11,A01,083080,Cao; Yingjun,6,15,40,34
1657687455713,CSE 12,A01,083652,Krause-Levy; Sophia Louisa,28,1,120,92
1657687461745,CSE 15L,A01,083654,Morris; Justin Loren,9,0,50,41
1657687461745,CSE 15L,A02,083655,Morris; Justin Loren,9,0,50,41
1657687467772,CSE 20,A01,083657,Tran; Khoa Dang,39,0,80,41
1657687473798,CSE 21,A01,095574,Bach; Quang Tran,22,0,48,26
1657687479820,CSE 30,A01,083084,Eldon; John,6,0,80,74
1657687479820,CSE 30,B01,095061,Bhaskar; Nishant,9,0,50,41
1657687485843,CSE 100,A01,083659,Cao; Yingjun,5,4,70,65
1657687491869,CSE 134B,A01,083661,Powell; Thomas Allan,23,0,100,77
1657687497900,CSE 140,A01,083663,Gungor; Onat,15,0,85,70
1657687503931,CSE 140L,A01,083088,Eldon; John,22,0,100,78
1657687509953,CSE 175,A01,083665,Kumar; Rakesh,3,0,25,22
1657687515978,CSE 190,A00,092507,Dubnov; Shlomo,8,0,20,12
1657687522002,ECE 45,A01,083139,Congero; Spencer William,6,0,75,69
1657687528038,ECE 65,A50,083695,Saad; Andrew S,12,0,30,18
1657687528038,ECE 65,A51,095125,Saad; Andrew S,24,0,26,2
1657687534062,ECE 109,A01,091882,Touri; Behrouz,20,0,70,50
1657687540085,ECE 180,A00,083140,Abi Samra; Nicholas Camill,1,0,30,29
1657687540085,ECE 180,B00,083141,Abi Samra; Nicholas Camill,0,0,30,30
1657687546110,MATH 10A,A01,083735,Patchell; Gregory David,2,0,30,28
1657687546110,MATH 10A,A02,083736,Patchell; Gregory David,20,0,30,10
1657687546110,MATH 10A,A03,083737,Patchell; Gregory David,16,0,30,14
1657687552134,MATH 10B,A01,083207,Lim; Seonhee,8,0,34,26
1657687552134,MATH 10B,A02,083208,Lim; Seonhee,9,0,35,26
1657687552134,MATH 10B,A03,093472,Lim; Seonhee,7,0,34,27
1657687552134,MATH 10B,B01,083739,Sinha; Shubham,13,0,30,17
1657687558159,MATH 18,A01,083743,Cinel; Cameron Alexander,8,0,30,22
1657687558159,MATH 18,A02,083744,Cinel; Cameron Alexander,17,0,30,13
1657687558159,MATH 18,A03,083745,Cinel; Cameron Alexander,10,0,30,20
1657687558159,MATH 18,B01,083748,Rideout; David Porter,5,0,37,32
1657687558159,MATH 18,B02,083749,Rideout; David Porter,5,0,36,31
1657687558159,MATH 18,B03,083750,Rideout; David Porter,3,0,37,34
1657687558159,MATH 18,B04,083751,Rideout; David Porter,6,0,36,30
1657687558159,MATH 18,B05,093473,Rideout; David Porter,6,0,36,30
1657687558159,MATH 18,B06,093474,Rideout; David Porter,6,0,36,30
1657687564186,MATH 20A,A01,083754,Zheng; Zequn,14,0,40,26
1657687570211,MATH 20B,A01,083756,Briones; Jor-el Thomas Caparas,4,0,36,32
1657687570211,MATH 20B,A02,083757,Briones; Jor-el Thomas Caparas,1,0,36,35
1657687570211,MATH 20B,A03,093475,Briones; Jor-el Thomas Caparas,2,0,36,34
1657687576235,MATH 20C,A01,083760,Briones; Jor-el Thomas Caparas,1,0,35,34
1657687576235,MATH 20C,A02,083761,Briones; Jor-el Thomas Caparas,8,0,35,27
1657687576235,MATH 20C,A03,093476,Briones; Jor-el Thomas Caparas,0,1,36,36
1657687576235,MATH 20C,B01,083762,Bach; Quang Tran,1,0,30,29
1657687582258,MATH 20D,A01,083765,Tran; Brian Kha,5,0,30,25
1657687582258,MATH 20D,A02,083766,Tran; Brian Kha,5,0,30,25
1657687582258,MATH 20D,A03,083767,Tran; Brian Kha,5,0,30,25
1657687588287,MATH 20E,A01,083771,Ganguly; Soumya,9,0,32,23
1657687588287,MATH 20E,A02,083772,Ganguly; Soumya,6,0,32,26
1657687588287,MATH 20E,B01,083773,Ciotti; Benjamin,20,0,35,15
1657687588287,MATH 20E,B02,083774,Ciotti; Benjamin,18,0,35,17
1657687594310,MATH 103A,A01,083777,Greenfeld; Be'Eri,3,0,36,33
1657687594310,MATH 103A,A02,083778,Greenfeld; Be'Eri,5,0,36,31
1657687594310,MATH 103A,A03,093561,Greenfeld; Be'Eri,6,0,36,30
1657687594310,MATH 103A,B01,083779,Greenfeld; Be'Eri,7,0,36,29
1657687594310,MATH 103A,B02,083780,Greenfeld; Be'Eri,4,0,36,32
1657687594310,MATH 103A,B03,093562,Greenfeld; Be'Eri,3,0,36,33
1657687600334,MATH 105,A01,085443,Carter; Anne Toulson,15,0,35,20
1657687600334,MATH 105,A02,093477,Carter; Anne Toulson,20,0,35,15
1657687606358,MATH 109,A01,083213,Ganzberger; Geoffrey Michael,2,0,34,32
1657687606358,MATH 109,A02,083214,Ganzberger; Geoffrey Michael,4,0,34,30
1657687606358,MATH 109,A03,093478,Ganzberger; Geoffrey Michael,2,0,34,32
1657687606358,MATH 109,B01,083215,Ganzberger; Geoffrey Michael,1,0,32,31
1657687606358,MATH 109,B02,083216,Ganzberger; Geoffrey Michael,2,0,32,30
1657687606358,MATH 109,B03,093479,Ganzberger; Geoffrey Michael,8,0,32,24
1657687612388,MATH 142A,A01,083219,Chow; Bennett,7,0,32,25
1657687612388,MATH 142A,A02,083220,Chow; Bennett,10,0,32,22
1657687612388,MATH 142A,A03,093480,Chow; Bennett,9,0,32,23
1657687612388,MATH 142A,B03,093481,Chow; Bennett,8,0,32,24
1657687612388,MATH 142A,B04,093558,Chow; Bennett,13,0,32,19
1657687612388,MATH 142A,B05,093559,Chow; Bennett,6,0,32,26
1657687618418,MATH 193A,A01,083224,Rotar; Vladimir,8,0,34,26
1657687618418,MATH 193A,A02,083225,Rotar; Vladimir,9,0,34,25
1657687618418,MATH 193A,A03,083781,Rotar; Vladimir,5,0,34,29
1657687618418,MATH 193A,A04,083782,Rotar; Vladimir,10,0,34,24
1657687618418,MATH 193A,A05,093482,Rotar; Vladimir,10,0,34,24
1657687624440,MATH 197,001,091859,McAuley; Julian John,9999,0,9999,0
1657687624440,MATH 197,002,095566,Kedlaya; Kiran S.,9997,0,9999,2
1657687624440,MATH 197,003,095567,Xiao; Ming,9999,0,9999,0
1657687624440,MATH 197,004,095571,Perols; Johan Lars,9998,0,9999,1
1657687631499,COGS 9,A01,083615,Shannon; Kyle Michael,9,0,75,66
1657687637526,COGS 11,A01,083617,Boyle; Mary E. T.,23,0,48,25
1657687643552,COGS 13,A01,083071,Bastos; Amalia Pinkusfeld,11,0,71,60
1657687649578,COGS 14A,A01,092681,Semenuks; Arturs,5,1,100,95
1657687655601,COGS 14B,A01,083073,Cheng; Tzu-Han,6,0,63,57
1657687661625,COGS 17,A01,092677,Semenuks; Arturs,6,0,81,75
1657687667652,COGS 100,A01,083619,Allen; Michael Gordon,17,0,70,53
1657687673677,COGS 101A,A01,083621,Davis; Joshua Daniel,9,0,68,59
1657687679700,COGS 101B,A01,091572,Allen; Michael Gordon,12,0,65,53
1657687685733,COGS 101C,A01,083625,Delgado; Tania,17,0,35,18
1657687691762,COGS 107A,A01,083627,Boyle; Mary E. T.,13,0,60,47
1657687697789,COGS 118A,A01,083075,Gupta; Anjum,21,0,76,55
1657687703814,CSE 3,A50,083646,Miranda; Gregory Joseph,24,0,50,26
1657687709839,CSE 8A,A50,083650,Miranda; Gregory Joseph,17,1,56,39
1657687715862,CSE 11,A01,083080,Cao; Yingjun,6,15,40,34
1657687721890,CSE 12,A01,083652,Krause-Levy; Sophia Louisa,28,1,120,92
1657687727917,CSE 15L,A01,083654,Morris; Justin Loren,9,0,50,41
1657687727917,CSE 15L,A02,083655,Morris; Justin Loren,9,0,50,41
1657687733964,CSE 20,A01,083657,Tran; Khoa Dang,39,0,80,41
1657687739992,CSE 21,A01,095574,Bach; Quang Tran,22,0,48,26
1657687746016,CSE 30,A01,083084,Eldon; John,6,0,80,74
1657687746016,CSE 30,B01,095061,Bhaskar; Nishant,9,0,50,41
1657687752044,CSE 100,A01,083659,Cao; Yingjun,5,4,70,65
1657687758067,CSE 134B,A01,083661,Powell; Thomas Allan,23,0,100,77
1657687764093,CSE 140,A01,083663,Gungor; Onat,15,0,85,70
1657687770118,CSE 140L,A01,083088,Eldon; John,22,0,100,78
1657687776144,CSE 175,A01,083665,Kumar; Rakesh,3,0,25,22
1657687782167,CSE 190,A00,092507,Dubnov; Shlomo,8,0,20,12
1657687788301,ECE 45,A01,083139,Congero; Spencer William,6,0,75,69
1657687794335,ECE 65,A50,083695,Saad; Andrew S,12,0,30,18
1657687794335,ECE 65,A51,095125,Saad; Andrew S,24,0,26,2
1657687800360,ECE 109,A01,091882,Touri; Behrouz,20,0,70,50
1657687806390,ECE 180,A00,083140,Abi Samra; Nicholas Camill,1,0,30,29
1657687806390,ECE 180,B00,083141,Abi Samra; Nicholas Camill,0,0,30,30
1657687812412,MATH 10A,A01,083735,Patchell; Gregory David,2,0,30,28
1657687812412,MATH 10A,A02,083736,Patchell; Gregory David,20,0,30,10
1657687812412,MATH 10A,A03,083737,Patchell; Gregory David,16,0,30,14
1657687818451,MATH 10B,A01,083207,Lim; Seonhee,8,0,34,26
1657687818451,MATH 10B,A02,083208,Lim; Seonhee,9,0,35,26
1657687818451,MATH 10B,A03,093472,Lim; Seonhee,7,0,34,27
1657687818451,MATH 10B,B01,083739,Sinha; Shubham,13,0,30,17
1657687824477,MATH 18,A01,083743,Cinel; Cameron Alexander,8,0,30,22
1657687824477,MATH 18,A02,083744,Cinel; Cameron Alexander,17,0,30,13
1657687824477,MATH 18,A03,083745,Cinel; Cameron Alexander,10,0,30,20
1657687824477,MATH 18,B01,083748,Rideout; David Porter,5,0,37,32
1657687824477,MATH 18,B02,083749,Rideout; David Porter,5,0,36,31
1657687824477,MATH 18,B03,083750,Rideout; David Porter,3,0,37,34
1657687824477,MATH 18,B04,083751,Rideout; David Porter,6,0,36,30
1657687824477,MATH 18,B05,093473,Rideout; David Porter,6,0,36,30
1657687824477,MATH 18,B06,093474,Rideout; David Porter,6,0,36,30
1657687830502,MATH 20A,A01,083754,Zheng; Zequn,14,0,40,26
1657687836526,MATH 20B,A01,083756,Briones; Jor-el Thomas Caparas,4,0,36,32
1657687836526,MATH 20B,A02,083757,Briones; Jor-el Thomas Caparas,1,0,36,35
1657687836526,MATH 20B,A03,093475,Briones; Jor-el Thomas Caparas,2,0,36,34
1657687842559,MATH 20C,A01,083760,Briones; Jor-el Thomas Caparas,1,0,35,34
1657687842559,MATH 20C,A02,083761,Briones; Jor-el Thomas Caparas,8,0,35,27
1657687842559,MATH 20C,A03,093476,Briones; Jor-el Thomas Caparas,0,1,36,36
1657687842559,MATH 20C,B01,083762,Bach; Quang Tran,1,0,30,29
1657687848589,MATH 20D,A01,083765,Tran; Brian Kha,5,0,30,25
1657687848589,MATH 20D,A02,083766,Tran; Brian Kha,5,0,30,25
1657687848589,MATH 20D,A03,083767,Tran; Brian Kha,5,0,30,25
1657687854611,MATH 20E,A01,083771,Ganguly; Soumya,9,0,32,23
1657687854611,MATH 20E,A02,083772,Ganguly; Soumya,6,0,32,26
1657687854611,MATH 20E,B01,083773,Ciotti; Benjamin,20,0,35,15
1657687854611,MATH 20E,B02,083774,Ciotti; Benjamin,18,0,35,17
1657687860636,MATH 103A,A01,083777,Greenfeld; Be'Eri,3,0,36,33
1657687860636,MATH 103A,A02,083778,Greenfeld; Be'Eri,5,0,36,31
1657687860636,MATH 103A,A03,093561,Greenfeld; Be'Eri,6,0,36,30
1657687860636,MATH 103A,B01,083779,Greenfeld; Be'Eri,7,0,36,29
1657687860636,MATH 103A,B02,083780,Greenfeld; Be'Eri,4,0,36,32
1657687860636,MATH 103A,B03,093562,Greenfeld; Be'Eri,3,0,36,33
1657687866660,MATH 105,A01,085443,Carter; Anne Toulson,15,0,35,20
1657687866660,MATH 105,A02,093477,Carter; Anne Toulson,20,0,35,15
1657687872685,MATH 109,A01,083213,Ganzberger; Geoffrey Michael,2,0,34,32
1657687872685,MATH 109,A02,083214,Ganzberger; Geoffrey Michael,4,0,34,30
1657687872685,MATH 109,A03,093478,Ganzberger; Geoffrey Michael,2,0,34,32
1657687872685,MATH 109,B01,083215,Ganzberger; Geoffrey Michael,1,0,32,31
1657687872685,MATH 109,B02,083216,Ganzberger; Geoffrey Michael,2,0,32,30
1657687872685,MATH 109,B03,093479,Ganzberger; Geoffrey Michael,8,0,32,24
1657687878715,MATH 142A,A01,083219,Chow; Bennett,7,0,32,25
1657687878715,MATH 142A,A02,083220,Chow; Bennett,10,0,32,22
1657687878715,MATH 142A,A03,093480,Chow; Bennett,9,0,32,23
1657687878715,MATH 142A,B03,093481,Chow; Bennett,8,0,32,24
1657687878715,MATH 142A,B04,093558,Chow; Bennett,13,0,32,19
1657687878715,MATH 142A,B05,093559,Chow; Bennett,6,0,32,26
1657687884743,MATH 193A,A01,083224,Rotar; Vladimir,8,0,34,26
1657687884743,MATH 193A,A02,083225,Rotar; Vladimir,9,0,34,25
1657687884743,MATH 193A,A03,083781,Rotar; Vladimir,5,0,34,29
1657687884743,MATH 193A,A04,083782,Rotar; Vladimir,10,0,34,24
1657687884743,MATH 193A,A05,093482,Rotar; Vladimir,10,0,34,24
1657687890770,MATH 197,001,091859,McAuley; Julian John,9999,0,9999,0
1657687890770,MATH 197,002,095566,Kedlaya; Kiran S.,9997,0,9999,2
1657687890770,MATH 197,003,095567,Xiao; Ming,9999,0,9999,0
1657687890770,MATH 197,004,095571,Perols; Johan Lars,9998,0,9999,1
1657687897829,COGS 9,A01,083615,Shannon; Kyle Michael,9,0,75,66
1657687903852,COGS 11,A01,083617,Boyle; Mary E. T.,23,0,48,25
1657687909885,COGS 13,A01,083071,Bastos; Amalia Pinkusfeld,11,0,71,60
1657687915911,COGS 14A,A01,092681,Semenuks; Arturs,5,1,100,95
1657687921941,COGS 14B,A01,083073,Cheng; Tzu-Han,6,0,63,57
1657687927963,COGS 17,A01,092677,Semenuks; Arturs,6,0,81,75
1657687933988,COGS 100,A01,083619,Allen; Michael Gordon,17,0,70,53
1657687940019,COGS 101A,A01,083621,Davis; Joshua Daniel,9,0,68,59
1657687946042,COGS 101B,A01,091572,Allen; Michael Gordon,12,0,65,53
1657687952066,COGS 101C,A01,083625,Delgado; Tania,17,0,35,18
1657687958088,COGS 107A,A01,083627,Boyle; Mary E. T.,13,0,60,47
1657687964111,COGS 118A,A01,083075,Gupta; Anjum,21,0,76,55
1657687970149,CSE 3,A50,083646,Miranda; Gregory Joseph,24,0,50,26
1657687976181,CSE 8A,A50,083650,Miranda; Gregory Joseph,17,1,56,39
1657687982206,CSE 11,A01,083080,Cao; Yingjun,6,15,40,34
1657687988230,CSE 12,A01,083652,Krause-Levy; Sophia Louisa,28,1,120,92
1657687994256,CSE 15L,A01,083654,Morris; Justin Loren,9,0,50,41
1657687994256,CSE 15L,A02,083655,Morris; Justin Loren,9,0,50,41
1657688000278,CSE 20,A01,083657,Tran; Khoa Dang,39,0,80,41
1657688006303,CSE 21,A01,095574,Bach; Quang Tran,22,0,48,26
1657688012328,CSE 30,A01,083084,Eldon; John,6,0,80,74
1657688012328,CSE 30,B01,095061,Bhaskar; Nishant,9,0,50,41
1657688018351,CSE 100,A01,083659,Cao; Yingjun,5,4,70,65
1657688024373,CSE 134B,A01,083661,Powell; Thomas Allan,23,0,100,77
1657688030395,CSE 140,A01,083663,Gungor; Onat,15,0,85,70
1657688036421,CSE 140L,A01,083088,Eldon; John,22,0,100,78
1657688042443,CSE 175,A01,083665,Kumar; Rakesh,3,0,25,22
1657688048467,CSE 190,A00,092507,Dubnov; Shlomo,8,0,20,12
1657688054491,ECE 45,A01,083139,Congero; Spencer William,6,0,75,69
1657688060533,ECE 65,A50,083695,Saad; Andrew S,12,0,30,18
1657688060533,ECE 65,A51,095125,Saad; Andrew S,24,0,26,2
1657688066556,ECE 109,A01,091882,Touri; Behrouz,20,0,70,50
1657688072580,ECE 180,A00,083140,Abi Samra; Nicholas Camill,1,0,30,29
1657688072580,ECE 180,B00,083141,Abi Samra; Nicholas Camill,0,0,30,30
1657688078607,MATH 10A,A01,083735,Patchell; Gregory David,2,0,30,28
1657688078607,MATH 10A,A02,083736,Patchell; Gregory David,20,0,30,10
1657688078607,MATH 10A,A03,083737,Patchell; Gregory David,16,0,30,14
1657688084636,MATH 10B,A01,083207,Lim; Seonhee,8,0,34,26
1657688084636,MATH 10B,A02,083208,Lim; Seonhee,9,0,35,26
1657688084636,MATH 10B,A03,093472,Lim; Seonhee,7,0,34,27
1657688084636,MATH 10B,B01,083739,Sinha; Shubham,13,0,30,17
1657688090661,MATH 18,A01,083743,Cinel; Cameron Alexander,8,0,30,22
1657688090661,MATH 18,A02,083744,Cinel; Cameron Alexander,17,0,30,13
1657688090661,MATH 18,A03,083745,Cinel; Cameron Alexander,10,0,30,20
1657688090661,MATH 18,B01,083748,Rideout; David Porter,5,0,37,32
1657688090661,MATH 18,B02,083749,Rideout; David Porter,5,0,36,31
1657688090661,MATH 18,B03,083750,Rideout; David Porter,3,0,37,34
1657688090661,MATH 18,B04,083751,Rideout; David Porter,6,0,36,30
1657688090661,MATH 18,B05,093473,Rideout; David Porter,6,0,36,30
1657688090661,MATH 18,B06,093474,Rideout; David Porter,6,0,36,30
1657688096683,MATH 20A,A01,083754,Zheng; Zequn,14,0,40,26
1657688102708,MATH 20B,A01,083756,Briones; Jor-el Thomas Caparas,4,0,36,32
1657688102708,MATH 20B,A02,083757,Briones; Jor-el Thomas Caparas,1,0,36,35
1657688102708,MATH 20B,A03,093475,Briones; Jor-el Thomas Caparas,2,0,36,34
1657688108731,MATH 20C,A01,083760,Briones; Jor-el Thomas Caparas,1,0,35,34
1657688108731,MATH 20C,A02,083761,Briones; Jor-el Thomas Caparas,8,0,35,27
1657688108731,MATH 20C,A03,093476,Briones; Jor-el Thomas Caparas,0,1,36,36
1657688108731,MATH 20C,B01,083762,Bach; Quang Tran,1,0,30,29
1657688114757,MATH 20D,A01,083765,Tran; Brian Kha,5,0,30,25
1657688114757,MATH 20D,A02,083766,Tran; Brian Kha,5,0,30,25
1657688114757,MATH 20D,A03,083767,Tran; Brian Kha,5,0,30,25
1657688120781,MATH 20E,A01,083771,Ganguly; Soumya,9,0,32,23
1657688120781,MATH 20E,A02,083772,Ganguly; Soumya,6,0,32,26
1657688120781,MATH 20E,B01,083773,Ciotti; Benjamin,20,0,35,15
1657688120781,MATH 20E,B02,083774,Ciotti; Benjamin,18,0,35,17
1657688126806,MATH 103A,A01,083777,Greenfeld; Be'Eri,3,0,36,33
1657688126806,MATH 103A,A02,083778,Greenfeld; Be'Eri,5,0,36,31
1657688126806,MATH 103A,A03,093561,Greenfeld; Be'Eri,6,0,36,30
1657688126806,MATH 103A,B01,083779,Greenfeld; Be'Eri,7,0,36,29
1657688126806,MATH 103A,B02,083780,Greenfeld; Be'Eri,4,0,36,32
1657688126806,MATH 103A,B03,093562,Greenfeld; Be'Eri,3,0,36,33
1657688132833,MATH 105,A01,085443,Carter; Anne Toulson,15,0,35,20
1657688132833,MATH 105,A02,093477,Carter; Anne Toulson,20,0,35,15
1657688138856,MATH 109,A01,083213,Ganzberger; Geoffrey Michael,2,0,34,32
1657688138856,MATH 109,A02,083214,Ganzberger; Geoffrey Michael,4,0,34,30
1657688138856,MATH 109,A03,093478,Ganzberger; Geoffrey Michael,2,0,34,32
1657688138856,MATH 109,B01,083215,Ganzberger; Geoffrey Michael,1,0,32,31
1657688138856,MATH 109,B02,083216,Ganzberger; Geoffrey Michael,2,0,32,30
1657688138856,MATH 109,B03,093479,Ganzberger; Geoffrey Michael,8,0,32,24
1657688144886,MATH 142A,A01,083219,Chow; Bennett,7,0,32,25
1657688144886,MATH 142A,A02,083220,Chow; Bennett,10,0,32,22
1657688144886,MATH 142A,A03,093480,Chow; Bennett,9,0,32,23
1657688144886,MATH 142A,B03,093481,Chow; Bennett,8,0,32,24
1657688144886,MATH 142A,B04,093558,Chow; Bennett,13,0,32,19
1657688144886,MATH 142A,B05,093559,Chow; Bennett,6,0,32,26
1657688150916,MATH 193A,A01,083224,Rotar; Vladimir,8,0,34,26
1657688150916,MATH 193A,A02,083225,Rotar; Vladimir,9,0,34,25
1657688150916,MATH 193A,A03,083781,Rotar; Vladimir,5,0,34,29
1657688150916,MATH 193A,A04,083782,Rotar; Vladimir,10,0,34,24
1657688150916,MATH 193A,A05,093482,Rotar; Vladimir,10,0,34,24
1657688156944,MATH 197,001,091859,McAuley; Julian John,9999,0,9999,0
1657688156944,MATH 197,002,095566,Kedlaya; Kiran S.,9997,0,9999,2
1657688156944,MATH 197,003,095567,Xiao; Ming,9999,0,9999,0
1657688156944,MATH 197,004,095571,Perols; Johan Lars,9998,0,9999,1
1657688164002,COGS 9,A01,083615,Shannon; Kyle Michael,9,0,75,66
1657688170028,COGS 11,A01,083617,Boyle; Mary E. T.,23,0,48,25
1657688176053,COGS 13,A01,083071,Bastos; Amalia Pinkusfeld,11,0,71,60
1657688182081,COGS 14A,A01,092681,Semenuks; Arturs,5,1,100,95
1657688188105,COGS 14B,A01,083073,Cheng; Tzu-Han,6,0,63,57
1657688194143,COGS 17,A01,092677,Semenuks; Arturs,6,0,81,75
1657688200171,COGS 100,A01,083619,Allen; Michael Gordon,17,0,70,53
1657688206212,COGS 101A,A01,083621,Davis; Joshua Daniel,9,0,68,59
1657688212238,COGS 101B,A01,091572,Allen; Michael Gordon,12,0,65,53
1657688218264,COGS 101C,A01,083625,Delgado; Tania,17,0,35,18
1657688224287,COGS 107A,A01,083627,Boyle; Mary E. T.,13,0,60,47
1657688230311,COGS 118A,A01,083075,Gupta; Anjum,21,0,76,55
1657688236338,CSE 3,A50,083646,Miranda; Gregory Joseph,24,0,50,26
1657688242361,CSE 8A,A50,083650,Miranda; Gregory Joseph,17,1,56,39
1657688248385,CSE 11,A01,083080,Cao; Yingjun,6,15,40,34
1657688254412,CSE 12,A01,083652,Krause-Levy; Sophia Louisa,28,1,120,92
1657688260435,CSE 15L,A01,083654,Morris; Justin Loren,9,0,50,41
1657688260435,CSE 15L,A02,083655,Morris; Justin Loren,9,0,50,41
1657688266458,CSE 20,A01,083657,Tran; Khoa Dang,39,0,80,41
1657688272490,CSE 21,A01,095574,Bach; Quang Tran,22,0,48,26
1657688278517,CSE 30,A01,083084,Eldon; John,6,0,80,74
1657688278517,CSE 30,B01,095061,Bhaskar; Nishant,9,0,50,41
1657688290337,CSE 100,A01,083659,Cao; Yingjun,5,4,70,65
1657688296363,CSE 134B,A01,083661,Powell; Thomas Allan,23,0,100,77
1657688302387,CSE 140,A01,083663,Gungor; Onat,15,0,85,70
1657688308412,CSE 140L,A01,083088,Eldon; John,22,0,100,78
1657688314439,CSE 175,A01,083665,Kumar; Rakesh,3,0,25,22
1657688320463,CSE 190,A00,092507,Dubnov; Shlomo,8,0,20,12
1657688326490,ECE 45,A01,083139,Congero; Spencer William,6,0,75,69
1657688332523,ECE 65,A50,083695,Saad; Andrew S,12,0,30,18
1657688332523,ECE 65,A51,095125,Saad; Andrew S,24,0,26,2
1657688338550,ECE 109,A01,091882,Touri; Behrouz,20,0,70,50
1657688344573,ECE 180,A00,083140,Abi Samra; Nicholas Camill,1,0,30,29
1657688344573,ECE 180,B00,083141,Abi Samra; Nicholas Camill,0,0,30,30
1657688350600,MATH 10A,A01,083735,Patchell; Gregory David,2,0,30,28
1657688350600,MATH 10A,A02,083736,Patchell; Gregory David,20,0,30,10
1657688350600,MATH 10A,A03,083737,Patchell; Gregory David,16,0,30,14
1657688356624,MATH 10B,A01,083207,Lim; Seonhee,8,0,34,26
1657688356624,MATH 10B,A02,083208,Lim; Seonhee,9,0,35,26
1657688356624,MATH 10B,A03,093472,Lim; Seonhee,7,0,34,27
1657688356624,MATH 10B,B01,083739,Sinha; Shubham,13,0,30,17
1657688362654,MATH 18,A01,083743,Cinel; Cameron Alexander,8,0,30,22
1657688362654,MATH 18,A02,083744,Cinel; Cameron Alexander,17,0,30,13
1657688362654,MATH 18,A03,083745,Cinel; Cameron Alexander,10,0,30,20
1657688362654,MATH 18,B01,083748,Rideout; David Porter,5,0,37,32
1657688362654,MATH 18,B02,083749,Rideout; David Porter,5,0,36,31
1657688362654,MATH 18,B03,083750,Rideout; David Porter,3,0,37,34
1657688362654,MATH 18,B04,083751,Rideout; David Porter,6,0,36,30
1657688362654,MATH 18,B05,093473,Rideout; David Porter,6,0,36,30
1657688362654,MATH 18,B06,093474,Rideout; David Porter,6,0,36,30
1657688368679,MATH 20A,A01,083754,Zheng; Zequn,14,0,40,26
1657688374701,MATH 20B,A01,083756,Briones; Jor-el Thomas Caparas,4,0,36,32
1657688374701,MATH 20B,A02,083757,Briones; Jor-el Thomas Caparas,1,0,36,35
1657688374701,MATH 20B,A03,093475,Briones; Jor-el Thomas Caparas,2,0,36,34
1657688380731,MATH 20C,A01,083760,Briones; Jor-el Thomas Caparas,1,0,35,34
1657688380731,MATH 20C,A02,083761,Briones; Jor-el Thomas Caparas,8,0,35,27
1657688380731,MATH 20C,A03,093476,Briones; Jor-el Thomas Caparas,0,1,36,36
1657688380731,MATH 20C,B01,083762,Bach; Quang Tran,1,0,30,29
1657688386759,MATH 20D,A01,083765,Tran; Brian Kha,5,0,30,25
1657688386759,MATH 20D,A02,083766,Tran; Brian Kha,5,0,30,25
1657688386759,MATH 20D,A03,083767,Tran; Brian Kha,5,0,30,25
1657688392878,MATH 20E,A01,083771,Ganguly; Soumya,9,0,32,23
1657688392878,MATH 20E,A02,083772,Ganguly; Soumya,6,0,32,26
1657688392878,MATH 20E,B01,083773,Ciotti; Benjamin,20,0,35,15
1657688392878,MATH 20E,B02,083774,Ciotti; Benjamin,18,0,35,17
1657688398901,MATH 103A,A01,083777,Greenfeld; Be'Eri,3,0,36,33
1657688398901,MATH 103A,A02,083778,Greenfeld; Be'Eri,5,0,36,31
1657688398901,MATH 103A,A03,093561,Greenfeld; Be'Eri,6,0,36,30
1657688398901,MATH 103A,B01,083779,Greenfeld; Be'Eri,7,0,36,29
1657688398901,MATH 103A,B02,083780,Greenfeld; Be'Eri,4,0,36,32
1657688398901,MATH 103A,B03,093562,Greenfeld; Be'Eri,3,0,36,33
1657688404925,MATH 105,A01,085443,Carter; Anne Toulson,15,0,35,20
1657688404925,MATH 105,A02,093477,Carter; Anne Toulson,20,0,35,15
1657688410948,MATH 109,A01,083213,Ganzberger; Geoffrey Michael,2,0,34,32
1657688410948,MATH 109,A02,083214,Ganzberger; Geoffrey Michael,4,0,34,30
1657688410948,MATH 109,A03,093478,Ganzberger; Geoffrey Michael,2,0,34,32
1657688410948,MATH 109,B01,083215,Ganzberger; Geoffrey Michael,1,0,32,31
1657688410948,MATH 109,B02,083216,Ganzberger; Geoffrey Michael,2,0,32,30
1657688410948,MATH 109,B03,093479,Ganzberger; Geoffrey Michael,8,0,32,24
1657688416971,MATH 142A,A01,083219,Chow; Bennett,7,0,32,25
1657688416971,MATH 142A,A02,083220,Chow; Bennett,10,0,32,22
1657688416971,MATH 142A,A03,093480,Chow; Bennett,9,0,32,23
1657688416971,MATH 142A,B03,093481,Chow; Bennett,8,0,32,24
1657688416971,MATH 142A,B04,093558,Chow; Bennett,13,0,32,19
1657688416971,MATH 142A,B05,093559,Chow; Bennett,6,0,32,26
1657688423000,MATH 193A,A01,083224,Rotar; Vladimir,8,0,34,26
1657688423000,MATH 193A,A02,083225,Rotar; Vladimir,9,0,34,25
1657688423000,MATH 193A,A03,083781,Rotar; Vladimir,5,0,34,29
1657688423000,MATH 193A,A04,083782,Rotar; Vladimir,10,0,34,24
1657688423000,MATH 193A,A05,093482,Rotar; Vladimir,10,0,34,24
1657688429022,MATH 197,001,091859,McAuley; Julian John,9999,0,9999,0
1657688429022,MATH 197,002,095566,Kedlaya; Kiran S.,9997,0,9999,2
1657688429022,MATH 197,003,095567,Xiao; Ming,9999,0,9999,0
1657688429022,MATH 197,004,095571,Perols; Johan Lars,9998,0,9999,1
1657688436092,COGS 9,A01,083615,Shannon; Kyle Michael,9,0,75,66
1657688442116,COGS 11,A01,083617,Boyle; Mary E. T.,23,0,48,25
1657688448141,COGS 13,A01,083071,Bastos; Amalia Pinkusfeld,11,0,71,60
1657688454168,COGS 14A,A01,092681,Semenuks; Arturs,5,1,100,95
1657688460194,COGS 14B,A01,083073,Cheng; Tzu-Han,6,0,63,57
1657688466217,COGS 17,A01,092677,Semenuks; Arturs,6,0,81,75
1657688472238,COGS 100,A01,083619,Allen; Michael Gordon,17,0,70,53
1657688478262,COGS 101A,A01,083621,Davis; Joshua Daniel,9,0,68,59
1657688484285,COGS 101B,A01,091572,Allen; Michael Gordon,12,0,65,53
1657688490312,COGS 101C,A01,083625,Delgado; Tania,17,0,35,18
1657688496336,COGS 107A,A01,083627,Boyle; Mary E. T.,13,0,60,47
1657688502359,COGS 118A,A01,083075,Gupta; Anjum,21,0,76,55
1657688508386,CSE 3,A50,083646,Miranda; Gregory Joseph,24,0,50,26
1657688514409,CSE 8A,A50,083650,Miranda; Gregory Joseph,17,1,56,39
1657688520431,CSE 11,A01,083080,Cao; Yingjun,6,15,40,34
1657688526457,CSE 12,A01,083652,Krause-Levy; Sophia Louisa,28,1,120,92
1657688532479,CSE 15L,A01,083654,Morris; Justin Loren,9,0,50,41
1657688532479,CSE 15L,A02,083655,Morris; Justin Loren,9,0,50,41
1657688538507,CSE 20,A01,083657,Tran; Khoa Dang,39,0,80,41
1657688544541,CSE 21,A01,095574,Bach; Quang Tran,22,0,48,26
1657688550567,CSE 30,A01,083084,Eldon; John,6,0,80,74
1657688550567,CSE 30,B01,095061,Bhaskar; Nishant,9,0,50,41
1657688556588,CSE 100,A01,083659,Cao; Yingjun,5,4,70,65
1657688562610,CSE 134B,A01,083661,Powell; Thomas Allan,23,0,100,77
1657688568632,CSE 140,A01,083663,Gungor; Onat,15,0,85,70
1657688574658,CSE 140L,A01,083088,Eldon; John,22,0,100,78
1657688580680,CSE 175,A01,083665,Kumar; Rakesh,3,0,25,22
1657688586702,CSE 190,A00,092507,Dubnov; Shlomo,8,0,20,12
1657688592730,ECE 45,A01,083139,Congero; Spencer William,6,0,75,69
1657688598753,ECE 65,A50,083695,Saad; Andrew S,12,0,30,18
1657688598753,ECE 65,A51,095125,Saad; Andrew S,24,0,26,2
1657688604778,ECE 109,A01,091882,Touri; Behrouz,20,0,70,50
1657688610806,ECE 180,A00,083140,Abi Samra; Nicholas Camill,1,0,30,29
1657688610806,ECE 180,B00,083141,Abi Samra; Nicholas Camill,0,0,30,30
1657688616833,MATH 10A,A01,083735,Patchell; Gregory David,2,0,30,28
1657688616833,MATH 10A,A02,083736,Patchell; Gregory David,20,0,30,10
1657688616833,MATH 10A,A03,083737,Patchell; Gregory David,16,0,30,14
1657688622862,MATH 10B,A01,083207,Lim; Seonhee,8,0,34,26
1657688622862,MATH 10B,A02,083208,Lim; Seonhee,9,0,35,26
1657688622862,MATH 10B,A03,093472,Lim; Seonhee,7,0,34,27
1657688622862,MATH 10B,B01,083739,Sinha; Shubham,13,0,30,17
1657688628889,MATH 18,A01,083743,Cinel; Cameron Alexander,8,0,30,22
1657688628889,MATH 18,A02,083744,Cinel; Cameron Alexander,17,0,30,13
1657688628889,MATH 18,A03,083745,Cinel; Cameron Alexander,10,0,30,20
1657688628889,MATH 18,B01,083748,Rideout; David Porter,5,0,37,32
1657688628889,MATH 18,B02,083749,Rideout; David Porter,5,0,36,31
1657688628889,MATH 18,B03,083750,Rideout; David Porter,3,0,37,34
1657688628889,MATH 18,B04,083751,Rideout; David Porter,6,0,36,30
1657688628889,MATH 18,B05,093473,Rideout; David Porter,6,0,36,30
1657688628889,MATH 18,B06,093474,Rideout; David Porter,6,0,36,30
1657688634911,MATH 20A,A01,083754,Zheng; Zequn,14,0,40,26
1657688640935,MATH 20B,A01,083756,Briones; Jor-el Thomas Caparas,4,0,36,32
1657688640935,MATH 20B,A02,083757,Briones; Jor-el Thomas Caparas,1,0,36,35
1657688640935,MATH 20B,A03,093475,Briones; Jor-el Thomas Caparas,2,0,36,34
1657688646959,MATH 20C,A01,083760,Briones; Jor-el Thomas Caparas,1,0,35,34
1657688646959,MATH 20C,A02,083761,Briones; Jor-el Thomas Caparas,8,0,35,27
1657688646959,MATH 20C,A03,093476,Briones; Jor-el Thomas Caparas,0,1,36,36
1657688646959,MATH 20C,B01,083762,Bach; Quang Tran,1,0,30,29
1657688652995,MATH 20D,A01,083765,Tran; Brian Kha,5,0,30,25
1657688652995,MATH 20D,A02,083766,Tran; Brian Kha,5,0,30,25
1657688652995,MATH 20D,A03,083767,Tran; Brian Kha,5,0,30,25
1657688659018,MATH 20E,A01,083771,Ganguly; Soumya,9,0,32,23
1657688659018,MATH 20E,A02,083772,Ganguly; Soumya,6,0,32,26
1657688659018,MATH 20E,B01,083773,Ciotti; Benjamin,20,0,35,15
1657688659018,MATH 20E,B02,083774,Ciotti; Benjamin,18,0,35,17
1657688665041,MATH 103A,A01,083777,Greenfeld; Be'Eri,3,0,36,33
1657688665041,MATH 103A,A02,083778,Greenfeld; Be'Eri,5,0,36,31
1657688665041,MATH 103A,A03,093561,Greenfeld; Be'Eri,6,0,36,30
1657688665041,MATH 103A,B01,083779,Greenfeld; Be'Eri,7,0,36,29
1657688665041,MATH 103A,B02,083780,Greenfeld; Be'Eri,4,0,36,32
1657688665041,MATH 103A,B03,093562,Greenfeld; Be'Eri,3,0,36,33
1657688671069,MATH 105,A01,085443,Carter; Anne Toulson,15,0,35,20
1657688671069,MATH 105,A02,093477,Carter; Anne Toulson,20,0,35,15
1657688677091,MATH 109,A01,083213,Ganzberger; Geoffrey Michael,2,0,34,32
1657688677091,MATH 109,A02,083214,Ganzberger; Geoffrey Michael,4,0,34,30
1657688677091,MATH 109,A03,093478,Ganzberger; Geoffrey Michael,2,0,34,32
1657688677091,MATH 109,B01,083215,Ganzberger; Geoffrey Michael,1,0,32,31
1657688677091,MATH 109,B02,083216,Ganzberger; Geoffrey Michael,2,0,32,30
1657688677091,MATH 109,B03,093479,Ganzberger; Geoffrey Michael,8,0,32,24
1657688683114,MATH 142A,A01,083219,Chow; Bennett,7,0,32,25
1657688683114,MATH 142A,A02,083220,Chow; Bennett,10,0,32,22
1657688683114,MATH 142A,A03,093480,Chow; Bennett,9,0,32,23
1657688683114,MATH 142A,B03,093481,Chow; Bennett,8,0,32,24
1657688683114,MATH 142A,B04,093558,Chow; Bennett,13,0,32,19
1657688683114,MATH 142A,B05,093559,Chow; Bennett,6,0,32,26
1657688689136,MATH 193A,A01,083224,Rotar; Vladimir,8,0,34,26
1657688689136,MATH 193A,A02,083225,Rotar; Vladimir,9,0,34,25
1657688689136,MATH 193A,A03,083781,Rotar; Vladimir,5,0,34,29
1657688689136,MATH 193A,A04,083782,Rotar; Vladimir,10,0,34,24
1657688689136,MATH 193A,A05,093482,Rotar; Vladimir,10,0,34,24
1657688695162,MATH 197,001,091859,McAuley; Julian John,9999,0,9999,0
1657688695162,MATH 197,002,095566,Kedlaya; Kiran S.,9997,0,9999,2
1657688695162,MATH 197,003,095567,Xiao; Ming,9999,0,9999,0
1657688695162,MATH 197,004,095571,Perols; Johan Lars,9998,0,9999,1
1657688702217,COGS 9,A01,083615,Shannon; Kyle Michael,9,0,75,66
1657688708244,COGS 11,A01,083617,Boyle; Mary E. T.,23,0,48,25
1657688714266,COGS 13,A01,083071,Bastos; Amalia Pinkusfeld,11,0,71,60
1657688720289,COGS 14A,A01,092681,Semenuks; Arturs,5,1,100,95
1657688726314,COGS 14B,A01,083073,Cheng; Tzu-Han,6,0,63,57
1657688732340,COGS 17,A01,092677,Semenuks; Arturs,6,0,81,75
1657688738363,COGS 100,A01,083619,Allen; Michael Gordon,17,0,70,53
1657688744385,COGS 101A,A01,083621,Davis; Joshua Daniel,9,0,68,59
1657688750420,COGS 101B,A01,091572,Allen; Michael Gordon,12,0,65,53
1657688756457,COGS 101C,A01,083625,Delgado; Tania,17,0,35,18
1657688762486,COGS 107A,A01,083627,Boyle; Mary E. T.,13,0,60,47
1657688768545,COGS 118A,A01,083075,Gupta; Anjum,21,0,76,55
1657688774569,CSE 3,A50,083646,Miranda; Gregory Joseph,24,0,50,26
1657688780592,CSE 8A,A50,083650,Miranda; Gregory Joseph,17,1,56,39
1657688786618,CSE 11,A01,083080,Cao; Yingjun,6,15,40,34
1657688792649,CSE 12,A01,083652,Krause-Levy; Sophia Louisa,28,1,120,92
1657688798672,CSE 15L,A01,083654,Morris; Justin Loren,9,0,50,41
1657688798672,CSE 15L,A02,083655,Morris; Justin Loren,9,0,50,41
1657688804698,CSE 20,A01,083657,Tran; Khoa Dang,39,0,80,41
1657688810722,CSE 21,A01,095574,Bach; Quang Tran,22,0,48,26
1657688816750,CSE 30,A01,083084,Eldon; John,6,0,80,74
1657688816750,CSE 30,B01,095061,Bhaskar; Nishant,9,0,50,41
1657688822773,CSE 100,A01,083659,Cao; Yingjun,5,4,70,65
1657688828794,CSE 134B,A01,083661,Powell; Thomas Allan,23,0,100,77
1657688834817,CSE 140,A01,083663,Gungor; Onat,15,0,85,70
1657688840844,CSE 140L,A01,083088,Eldon; John,22,0,100,78
1657688846867,CSE 175,A01,083665,Kumar; Rakesh,3,0,25,22
1657688852890,CSE 190,A00,092507,Dubnov; Shlomo,8,0,20,12
1657688858914,ECE 45,A01,083139,Congero; Spencer William,6,0,75,69
1657688864939,ECE 65,A50,083695,Saad; Andrew S,12,0,30,18
1657688864939,ECE 65,A51,095125,Saad; Andrew S,24,0,26,2
1657688870965,ECE 109,A01,091882,Touri; Behrouz,20,0,70,50
1657688876991,ECE 180,A00,083140,Abi Samra; Nicholas Camill,1,0,30,29
1657688876991,ECE 180,B00,083141,Abi Samra; Nicholas Camill,0,0,30,30
1657688883013,MATH 10A,A01,083735,Patchell; Gregory David,2,0,30,28
1657688883013,MATH 10A,A02,083736,Patchell; Gregory David,20,0,30,10
1657688883013,MATH 10A,A03,083737,Patchell; Gregory David,16,0,30,14
1657688889038,MATH 10B,A01,083207,Lim; Seonhee,8,0,34,26
1657688889038,MATH 10B,A02,083208,Lim; Seonhee,9,0,35,26
1657688889038,MATH 10B,A03,093472,Lim; Seonhee,7,0,34,27
1657688889038,MATH 10B,B01,083739,Sinha; Shubham,13,0,30,17
1657688895067,MATH 18,A01,083743,Cinel; Cameron Alexander,8,0,30,22
1657688895067,MATH 18,A02,083744,Cinel; Cameron Alexander,17,0,30,13
1657688895067,MATH 18,A03,083745,Cinel; Cameron Alexander,10,0,30,20
1657688895067,MATH 18,B01,083748,Rideout; David Porter,5,0,37,32
1657688895067,MATH 18,B02,083749,Rideout; David Porter,5,0,36,31
1657688895067,MATH 18,B03,083750,Rideout; David Porter,3,0,37,34
1657688895067,MATH 18,B04,083751,Rideout; David Porter,6,0,36,30
1657688895067,MATH 18,B05,093473,Rideout; David Porter,6,0,36,30
1657688895067,MATH 18,B06,093474,Rideout; David Porter,6,0,36,30
1657688901089,MATH 20A,A01,083754,Zheng; Zequn,14,0,40,26
1657688907111,MATH 20B,A01,083756,Briones; Jor-el Thomas Caparas,4,0,36,32
1657688907111,MATH 20B,A02,083757,Briones; Jor-el Thomas Caparas,1,0,36,35
1657688907111,MATH 20B,A03,093475,Briones; Jor-el Thomas Caparas,2,0,36,34
1657688913141,MATH 20C,A01,083760,Briones; Jor-el Thomas Caparas,1,0,35,34
1657688913141,MATH 20C,A02,083761,Briones; Jor-el Thomas Caparas,8,0,35,27
1657688913141,MATH 20C,A03,093476,Briones; Jor-el Thomas Caparas,0,1,36,36
1657688913141,MATH 20C,B01,083762,Bach; Quang Tran,1,0,30,29
1657688919169,MATH 20D,A01,083765,Tran; Brian Kha,5,0,30,25
1657688919169,MATH 20D,A02,083766,Tran; Brian Kha,5,0,30,25
1657688919169,MATH 20D,A03,083767,Tran; Brian Kha,5,0,30,25
1657688925194,MATH 20E,A01,083771,Ganguly; Soumya,9,0,32,23
1657688925194,MATH 20E,A02,083772,Ganguly; Soumya,6,0,32,26
1657688925194,MATH 20E,B01,083773,Ciotti; Benjamin,20,0,35,15
1657688925194,MATH 20E,B02,083774,Ciotti; Benjamin,18,0,35,17
1657688931220,MATH 103A,A01,083777,Greenfeld; Be'Eri,3,0,36,33
1657688931220,MATH 103A,A02,083778,Greenfeld; Be'Eri,5,0,36,31
1657688931220,MATH 103A,A03,093561,Greenfeld; Be'Eri,6,0,36,30
1657688931220,MATH 103A,B01,083779,Greenfeld; Be'Eri,7,0,36,29
1657688931220,MATH 103A,B02,083780,Greenfeld; Be'Eri,4,0,36,32
1657688931220,MATH 103A,B03,093562,Greenfeld; Be'Eri,3,0,36,33
1657688937242,MATH 105,A01,085443,Carter; Anne Toulson,15,0,35,20
1657688937242,MATH 105,A02,093477,Carter; Anne Toulson,20,0,35,15
1657688943273,MATH 109,A01,083213,Ganzberger; Geoffrey Michael,2,0,34,32
1657688943273,MATH 109,A02,083214,Ganzberger; Geoffrey Michael,4,0,34,30
1657688943273,MATH 109,A03,093478,Ganzberger; Geoffrey Michael,2,0,34,32
1657688943273,MATH 109,B01,083215,Ganzberger; Geoffrey Michael,1,0,32,31
1657688943273,MATH 109,B02,083216,Ganzberger; Geoffrey Michael,2,0,32,30
1657688943273,MATH 109,B03,093479,Ganzberger; Geoffrey Michael,8,0,32,24
1657688949298,MATH 142A,A01,083219,Chow; Bennett,7,0,32,25
1657688949298,MATH 142A,A02,083220,Chow; Bennett,10,0,32,22
1657688949298,MATH 142A,A03,093480,Chow; Bennett,9,0,32,23
1657688949298,MATH 142A,B03,093481,Chow; Bennett,8,0,32,24
1657688949298,MATH 142A,B04,093558,Chow; Bennett,13,0,32,19
1657688949298,MATH 142A,B05,093559,Chow; Bennett,6,0,32,26
1657688955326,MATH 193A,A01,083224,Rotar; Vladimir,8,0,34,26
1657688955326,MATH 193A,A02,083225,Rotar; Vladimir,9,0,34,25
1657688955326,MATH 193A,A03,083781,Rotar; Vladimir,5,0,34,29
1657688955326,MATH 193A,A04,083782,Rotar; Vladimir,10,0,34,24
1657688955326,MATH 193A,A05,093482,Rotar; Vladimir,10,0,34,24
1657688961348,MATH 197,001,091859,McAuley; Julian John,9999,0,9999,0
1657688961348,MATH 197,002,095566,Kedlaya; Kiran S.,9997,0,9999,2
1657688961348,MATH 197,003,095567,Xiao; Ming,9999,0,9999,0
1657688961348,MATH 197,004,095571,Perols; Johan Lars,9998,0,9999,1
1657688968397,COGS 9,A01,083615,Shannon; Kyle Michael,9,0,75,66
1657688974421,COGS 11,A01,083617,Boyle; Mary E. T.,23,0,48,25
1657688980446,COGS 13,A01,083071,Bastos; Amalia Pinkusfeld,11,0,71,60
1657688986539,COGS 14A,A01,092681,Semenuks; Arturs,5,1,100,95
1657688992563,COGS 14B,A01,083073,Cheng; Tzu-Han,6,0,63,57
1657688998595,COGS 17,A01,092677,Semenuks; Arturs,6,0,81,75
1657689004619,COGS 100,A01,083619,Allen; Michael Gordon,17,0,70,53
1657689010651,COGS 101A,A01,083621,Davis; Joshua Daniel,9,0,68,59
1657689016673,COGS 101B,A01,091572,Allen; Michael Gordon,12,0,65,53
1657689022696,COGS 101C,A01,083625,Delgado; Tania,17,0,35,18
1657689028718,COGS 107A,A01,083627,Boyle; Mary E. T.,13,0,60,47
1657689034740,COGS 118A,A01,083075,Gupta; Anjum,21,0,76,55
1657689040763,CSE 3,A50,083646,Miranda; Gregory Joseph,24,0,50,26
1657689046798,CSE 8A,A50,083650,Miranda; Gregory Joseph,17,1,56,39
1657689052821,CSE 11,A01,083080,Cao; Yingjun,6,15,40,34
1657689058848,CSE 12,A01,083652,Krause-Levy; Sophia Louisa,28,1,120,92
1657689064874,CSE 15L,A01,083654,Morris; Justin Loren,9,0,50,41
1657689064874,CSE 15L,A02,083655,Morris; Justin Loren,9,0,50,41
1657689070897,CSE 20,A01,083657,Tran; Khoa Dang,39,0,80,41
1657689076921,CSE 21,A01,095574,Bach; Quang Tran,22,0,48,26
1657689082944,CSE 30,A01,083084,Eldon; John,6,0,80,74
1657689082944,CSE 30,B01,095061,Bhaskar; Nishant,9,0,50,41
1657689088969,CSE 100,A01,083659,Cao; Yingjun,5,4,70,65
1657689094995,CSE 134B,A01,083661,Powell; Thomas Allan,23,0,100,77
1657689101018,CSE 140,A01,083663,Gungor; Onat,15,0,85,70
1657689107043,CSE 140L,A01,083088,Eldon; John,22,0,100,78
1657689113068,CSE 175,A01,083665,Kumar; Rakesh,3,0,25,22
1657689119093,CSE 190,A00,092507,Dubnov; Shlomo,8,0,20,12
1657689125119,ECE 45,A01,083139,Congero; Spencer William,6,0,75,69
1657689131145,ECE 65,A50,083695,Saad; Andrew S,12,0,30,18
1657689131145,ECE 65,A51,095125,Saad; Andrew S,24,0,26,2
1657689137168,ECE 109,A01,091882,Touri; Behrouz,20,0,70,50
1657689143191,ECE 180,A00,083140,Abi Samra; Nicholas Camill,1,0,30,29
1657689143191,ECE 180,B00,083141,Abi Samra; Nicholas Camill,0,0,30,30
1657689149219,MATH 10A,A01,083735,Patchell; Gregory David,2,0,30,28
1657689149219,MATH 10A,A02,083736,Patchell; Gregory David,20,0,30,10
1657689149219,MATH 10A,A03,083737,Patchell; Gregory David,16,0,30,14
1657689155243,MATH 10B,A01,083207,Lim; Seonhee,8,0,34,26
1657689155243,MATH 10B,A02,083208,Lim; Seonhee,9,0,35,26
1657689155243,MATH 10B,A03,093472,Lim; Seonhee,7,0,34,27
1657689155243,MATH 10B,B01,083739,Sinha; Shubham,13,0,30,17
1657689161267,MATH 18,A01,083743,Cinel; Cameron Alexander,8,0,30,22
1657689161267,MATH 18,A02,083744,Cinel; Cameron Alexander,17,0,30,13
1657689161267,MATH 18,A03,083745,Cinel; Cameron Alexander,10,0,30,20
1657689161267,MATH 18,B01,083748,Rideout; David Porter,5,0,37,32
1657689161267,MATH 18,B02,083749,Rideout; David Porter,5,0,36,31
1657689161267,MATH 18,B03,083750,Rideout; David Porter,3,0,37,34
1657689161267,MATH 18,B04,083751,Rideout; David Porter,6,0,36,30
1657689161267,MATH 18,B05,093473,Rideout; David Porter,6,0,36,30
1657689161267,MATH 18,B06,093474,Rideout; David Porter,6,0,36,30
1657689167290,MATH 20A,A01,083754,Zheng; Zequn,14,0,40,26
1657689173313,MATH 20B,A01,083756,Briones; Jor-el Thomas Caparas,4,0,36,32
1657689173313,MATH 20B,A02,083757,Briones; Jor-el Thomas Caparas,1,0,36,35
1657689173313,MATH 20B,A03,093475,Briones; Jor-el Thomas Caparas,2,0,36,34
1657689179338,MATH 20C,A01,083760,Briones; Jor-el Thomas Caparas,1,0,35,34
1657689179338,MATH 20C,A02,083761,Briones; Jor-el Thomas Caparas,8,0,35,27
1657689179338,MATH 20C,A03,093476,Briones; Jor-el Thomas Caparas,0,1,36,36
1657689179338,MATH 20C,B01,083762,Bach; Quang Tran,1,0,30,29
1657689185372,MATH 20D,A01,083765,Tran; Brian Kha,5,0,30,25
1657689185372,MATH 20D,A02,083766,Tran; Brian Kha,5,0,30,25
1657689185372,MATH 20D,A03,083767,Tran; Brian Kha,5,0,30,25
1657689191400,MATH 20E,A01,083771,Ganguly; Soumya,9,0,32,23
1657689191400,MATH 20E,A02,083772,Ganguly; Soumya,6,0,32,26
1657689191400,MATH 20E,B01,083773,Ciotti; Benjamin,20,0,35,15
1657689191400,MATH 20E,B02,083774,Ciotti; Benjamin,18,0,35,17
1657689197424,MATH 103A,A01,083777,Greenfeld; Be'Eri,3,0,36,33
1657689197424,MATH 103A,A02,083778,Greenfeld; Be'Eri,5,0,36,31
1657689197424,MATH 103A,A03,093561,Greenfeld; Be'Eri,6,0,36,30
1657689197424,MATH 103A,B01,083779,Greenfeld; Be'Eri,7,0,36,29
1657689197424,MATH 103A,B02,083780,Greenfeld; Be'Eri,4,0,36,32
1657689197424,MATH 103A,B03,093562,Greenfeld; Be'Eri,3,0,36,33
1657689203461,MATH 105,A01,085443,Carter; Anne Toulson,15,0,35,20
1657689203461,MATH 105,A02,093477,Carter; Anne Toulson,20,0,35,15
1657689209483,MATH 109,A01,083213,Ganzberger; Geoffrey Michael,2,0,34,32
1657689209483,MATH 109,A02,083214,Ganzberger; Geoffrey Michael,4,0,34,30
1657689209483,MATH 109,A03,093478,Ganzberger; Geoffrey Michael,2,0,34,32
1657689209483,MATH 109,B01,083215,Ganzberger; Geoffrey Michael,1,0,32,31
1657689209483,MATH 109,B02,083216,Ganzberger; Geoffrey Michael,2,0,32,30
1657689209483,MATH 109,B03,093479,Ganzberger; Geoffrey Michael,8,0,32,24
1657689215507,MATH 142A,A01,083219,Chow; Bennett,7,0,32,25
1657689215507,MATH 142A,A02,083220,Chow; Bennett,10,0,32,22
1657689215507,MATH 142A,A03,093480,Chow; Bennett,9,0,32,23
1657689215507,MATH 142A,B03,093481,Chow; Bennett,8,0,32,24
1657689215507,MATH 142A,B04,093558,Chow; Bennett,13,0,32,19
1657689215507,MATH 142A,B05,093559,Chow; Bennett,6,0,32,26
1657689221535,MATH 193A,A01,083224,Rotar; Vladimir,8,0,34,26
1657689221535,MATH 193A,A02,083225,Rotar; Vladimir,9,0,34,25
1657689221535,MATH 193A,A03,083781,Rotar; Vladimir,5,0,34,29
1657689221535,MATH 193A,A04,083782,Rotar; Vladimir,10,0,34,24
1657689221535,MATH 193A,A05,093482,Rotar; Vladimir,10,0,34,24
1657689227562,MATH 197,001,091859,McAuley; Julian John,9999,0,9999,0
1657689227562,MATH 197,002,095566,Kedlaya; Kiran S.,9997,0,9999,2
1657689227562,MATH 197,003,095567,Xiao; Ming,9999,0,9999,0
1657689227562,MATH 197,004,095571,Perols; Johan Lars,9998,0,9999,1
1657689234619,COGS 9,A01,083615,Shannon; Kyle Michael,9,0,75,66
1657689240645,COGS 11,A01,083617,Boyle; Mary E. T.,23,0,48,25
1657689246671,COGS 13,A01,083071,Bastos; Amalia Pinkusfeld,11,0,71,60
1657689252695,COGS 14A,A01,092681,Semenuks; Arturs,5,1,100,95
1657689258719,COGS 14B,A01,083073,Cheng; Tzu-Han,6,0,63,57
1657689264742,COGS 17,A01,092677,Semenuks; Arturs,6,0,81,75
1657689270765,COGS 100,A01,083619,Allen; Michael Gordon,17,0,70,53
1657689276791,COGS 101A,A01,083621,Davis; Joshua Daniel,9,0,68,59
1657689282817,COGS 101B,A01,091572,Allen; Michael Gordon,12,0,65,53
1657689288839,COGS 101C,A01,083625,Delgado; Tania,17,0,35,18
1657689294861,COGS 107A,A01,083627,Boyle; Mary E. T.,13,0,60,47
1657689300888,COGS 118A,A01,083075,Gupta; Anjum,21,0,76,55
1657689306913,CSE 3,A50,083646,Miranda; Gregory Joseph,24,0,50,26
1657689312935,CSE 8A,A50,083650,Miranda; Gregory Joseph,17,1,56,39
1657689318962,CSE 11,A01,083080,Cao; Yingjun,6,15,40,34
1657689324990,CSE 12,A01,083652,Krause-Levy; Sophia Louisa,28,1,120,92
1657689331021,CSE 15L,A01,083654,Morris; Justin Loren,9,0,50,41
1657689331021,CSE 15L,A02,083655,Morris; Justin Loren,9,0,50,41
1657689337047,CSE 20,A01,083657,Tran; Khoa Dang,39,0,80,41
1657689343083,CSE 21,A01,095574,Bach; Quang Tran,22,0,48,26
1657689349108,CSE 30,A01,083084,Eldon; John,6,0,80,74
1657689349108,CSE 30,B01,095061,Bhaskar; Nishant,9,0,50,41
1657689355130,CSE 100,A01,083659,Cao; Yingjun,5,4,70,65
1657689361158,CSE 134B,A01,083661,Powell; Thomas Allan,23,0,100,77
1657689367180,CSE 140,A01,083663,Gungor; Onat,15,0,85,70
1657689373207,CSE 140L,A01,083088,Eldon; John,22,0,100,78
1657689379234,CSE 175,A01,083665,Kumar; Rakesh,3,0,25,22
1657689385260,CSE 190,A00,092507,Dubnov; Shlomo,8,0,20,12
1657689391287,ECE 45,A01,083139,Congero; Spencer William,6,0,75,69
1657689397315,ECE 65,A50,083695,Saad; Andrew S,12,0,30,18
1657689397315,ECE 65,A51,095125,Saad; Andrew S,24,0,26,2
1657689403337,ECE 109,A01,091882,Touri; Behrouz,20,0,70,50
1657689409359,ECE 180,A00,083140,Abi Samra; Nicholas Camill,1,0,30,29
1657689409359,ECE 180,B00,083141,Abi Samra; Nicholas Camill,0,0,30,30
1657689415382,MATH 10A,A01,083735,Patchell; Gregory David,2,0,30,28
1657689415382,MATH 10A,A02,083736,Patchell; Gregory David,20,0,30,10
1657689415382,MATH 10A,A03,083737,Patchell; Gregory David,16,0,30,14
1657689421407,MATH 10B,A01,083207,Lim; Seonhee,8,0,34,26
1657689421407,MATH 10B,A02,083208,Lim; Seonhee,9,0,35,26
1657689421407,MATH 10B,A03,093472,Lim; Seonhee,7,0,34,27
1657689421407,MATH 10B,B01,083739,Sinha; Shubham,13,0,30,17
1657689427452,MATH 18,A01,083743,Cinel; Cameron Alexander,8,0,30,22
1657689427452,MATH 18,A02,083744,Cinel; Cameron Alexander,17,0,30,13
1657689427452,MATH 18,A03,083745,Cinel; Cameron Alexander,10,0,30,20
1657689427452,MATH 18,B01,083748,Rideout; David Porter,5,0,37,32
1657689427452,MATH 18,B02,083749,Rideout; David Porter,5,0,36,31
1657689427452,MATH 18,B03,083750,Rideout; David Porter,3,0,37,34
1657689427452,MATH 18,B04,083751,Rideout; David Porter,6,0,36,30
1657689427452,MATH 18,B05,093473,Rideout; David Porter,6,0,36,30
1657689427452,MATH 18,B06,093474,Rideout; David Porter,6,0,36,30
1657689433477,MATH 20A,A01,083754,Zheng; Zequn,14,0,40,26
1657689439502,MATH 20B,A01,083756,Briones; Jor-el Thomas Caparas,4,0,36,32
1657689439502,MATH 20B,A02,083757,Briones; Jor-el Thomas Caparas,1,0,36,35
1657689439502,MATH 20B,A03,093475,Briones; Jor-el Thomas Caparas,2,0,36,34
1657689445534,MATH 20C,A01,083760,Briones; Jor-el Thomas Caparas,1,0,35,34
1657689445534,MATH 20C,A02,083761,Briones; Jor-el Thomas Caparas,8,0,35,27
1657689445534,MATH 20C,A03,093476,Briones; Jor-el Thomas Caparas,0,1,36,36
1657689445534,MATH 20C,B01,083762,Bach; Quang Tran,1,0,30,29
1657689451558,MATH 20D,A01,083765,Tran; Brian Kha,5,0,30,25
1657689451558,MATH 20D,A02,083766,Tran; Brian Kha,5,0,30,25
1657689451558,MATH 20D,A03,083767,Tran; Brian Kha,5,0,30,25
1657689457587,MATH 20E,A01,083771,Ganguly; Soumya,9,0,32,23
1657689457587,MATH 20E,A02,083772,Ganguly; Soumya,6,0,32,26
1657689457587,MATH 20E,B01,083773,Ciotti; Benjamin,20,0,35,15
1657689457587,MATH 20E,B02,083774,Ciotti; Benjamin,18,0,35,17
1657689463616,MATH 103A,A01,083777,Greenfeld; Be'Eri,3,0,36,33
1657689463616,MATH 103A,A02,083778,Greenfeld; Be'Eri,5,0,36,31
1657689463616,MATH 103A,A03,093561,Greenfeld; Be'Eri,6,0,36,30
1657689463616,MATH 103A,B01,083779,Greenfeld; Be'Eri,7,0,36,29
1657689463616,MATH 103A,B02,083780,Greenfeld; Be'Eri,4,0,36,32
1657689463616,MATH 103A,B03,093562,Greenfeld; Be'Eri,3,0,36,33
1657689469643,MATH 105,A01,085443,Carter; Anne Toulson,15,0,35,20
1657689469643,MATH 105,A02,093477,Carter; Anne Toulson,20,0,35,15
1657689475666,MATH 109,A01,083213,Ganzberger; Geoffrey Michael,2,0,34,32
1657689475666,MATH 109,A02,083214,Ganzberger; Geoffrey Michael,4,0,34,30
1657689475666,MATH 109,A03,093478,Ganzberger; Geoffrey Michael,2,0,34,32
1657689475666,MATH 109,B01,083215,Ganzberger; Geoffrey Michael,1,0,32,31
1657689475666,MATH 109,B02,083216,Ganzberger; Geoffrey Michael,2,0,32,30
1657689475666,MATH 109,B03,093479,Ganzberger; Geoffrey Michael,8,0,32,24
1657689481696,MATH 142A,A01,083219,Chow; Bennett,7,0,32,25
1657689481696,MATH 142A,A02,083220,Chow; Bennett,10,0,32,22
1657689481696,MATH 142A,A03,093480,Chow; Bennett,9,0,32,23
1657689481696,MATH 142A,B03,093481,Chow; Bennett,8,0,32,24
1657689481696,MATH 142A,B04,093558,Chow; Bennett,13,0,32,19
1657689481696,MATH 142A,B05,093559,Chow; Bennett,6,0,32,26
1657689487721,MATH 193A,A01,083224,Rotar; Vladimir,8,0,34,26
1657689487721,MATH 193A,A02,083225,Rotar; Vladimir,9,0,34,25
1657689487721,MATH 193A,A03,083781,Rotar; Vladimir,5,0,34,29
1657689487721,MATH 193A,A04,083782,Rotar; Vladimir,10,0,34,24
1657689487721,MATH 193A,A05,093482,Rotar; Vladimir,10,0,34,24
1657689493761,MATH 197,001,091859,McAuley; Julian John,9999,0,9999,0
1657689493761,MATH 197,002,095566,Kedlaya; Kiran S.,9997,0,9999,2
1657689493761,MATH 197,003,095567,Xiao; Ming,9999,0,9999,0
1657689493761,MATH 197,004,095571,Perols; Johan Lars,9998,0,9999,1
1657689500812,COGS 9,A01,083615,Shannon; Kyle Michael,9,0,75,66
1657689506837,COGS 11,A01,083617,Boyle; Mary E. T.,23,0,48,25
1657689512862,COGS 13,A01,083071,Bastos; Amalia Pinkusfeld,11,0,71,60
1657689518888,COGS 14A,A01,092681,Semenuks; Arturs,5,1,100,95
1657689524911,COGS 14B,A01,083073,Cheng; Tzu-Han,6,0,63,57
1657689530935,COGS 17,A01,092677,Semenuks; Arturs,6,0,81,75
1657689536958,COGS 100,A01,083619,Allen; Michael Gordon,17,0,70,53
1657689542979,COGS 101A,A01,083621,Davis; Joshua Daniel,9,0,68,59
1657689549002,COGS 101B,A01,091572,Allen; Michael Gordon,12,0,65,53
1657689555026,COGS 101C,A01,083625,Delgado; Tania,17,0,35,18
1657689561050,COGS 107A,A01,083627,Boyle; Mary E. T.,13,0,60,47
1657689567077,COGS 118A,A01,083075,Gupta; Anjum,21,0,76,55
1657689573100,CSE 3,A50,083646,Miranda; Gregory Joseph,24,0,50,26
1657689579134,CSE 8A,A50,083650,Miranda; Gregory Joseph,17,1,56,39
1657689585329,CSE 11,A01,083080,Cao; Yingjun,6,15,40,34
1657689591352,CSE 12,A01,083652,Krause-Levy; Sophia Louisa,28,1,120,92
1657689597375,CSE 15L,A01,083654,Morris; Justin Loren,9,0,50,41
1657689597375,CSE 15L,A02,083655,Morris; Justin Loren,9,0,50,41
1657689603402,CSE 20,A01,083657,Tran; Khoa Dang,39,0,80,41
1657689609427,CSE 21,A01,095574,Bach; Quang Tran,22,0,48,26
1657689615454,CSE 30,A01,083084,Eldon; John,6,0,80,74
1657689615454,CSE 30,B01,095061,Bhaskar; Nishant,9,0,50,41
1657689621479,CSE 100,A01,083659,Cao; Yingjun,5,4,70,65
1657689627505,CSE 134B,A01,083661,Powell; Thomas Allan,23,0,100,77
1657689633538,CSE 140,A01,083663,Gungor; Onat,15,0,85,70
1657689639561,CSE 140L,A01,083088,Eldon; John,22,0,100,78
1657689645588,CSE 175,A01,083665,Kumar; Rakesh,3,0,25,22
1657689651614,CSE 190,A00,092507,Dubnov; Shlomo,8,0,20,12
1657689657641,ECE 45,A01,083139,Congero; Spencer William,6,0,75,69
1657689663669,ECE 65,A50,083695,Saad; Andrew S,12,0,30,18
1657689663669,ECE 65,A51,095125,Saad; Andrew S,24,0,26,2
1657689669696,ECE 109,A01,091882,Touri; Behrouz,20,0,70,50
1657689675718,ECE 180,A00,083140,Abi Samra; Nicholas Camill,1,0,30,29
1657689675718,ECE 180,B00,083141,Abi Samra; Nicholas Camill,0,0,30,30
1657689681743,MATH 10A,A01,083735,Patchell; Gregory David,2,0,30,28
1657689681743,MATH 10A,A02,083736,Patchell; Gregory David,20,0,30,10
1657689681743,MATH 10A,A03,083737,Patchell; Gregory David,16,0,30,14
1657689687766,MATH 10B,A01,083207,Lim; Seonhee,8,0,34,26
1657689687766,MATH 10B,A02,083208,Lim; Seonhee,9,0,35,26
1657689687766,MATH 10B,A03,093472,Lim; Seonhee,7,0,34,27
1657689687766,MATH 10B,B01,083739,Sinha; Shubham,13,0,30,17
1657689693790,MATH 18,A01,083743,Cinel; Cameron Alexander,8,0,30,22
1657689693790,MATH 18,A02,083744,Cinel; Cameron Alexander,17,0,30,13
1657689693790,MATH 18,A03,083745,Cinel; Cameron Alexander,10,0,30,20
1657689693790,MATH 18,B01,083748,Rideout; David Porter,5,0,37,32
1657689693790,MATH 18,B02,083749,Rideout; David Porter,5,0,36,31
1657689693790,MATH 18,B03,083750,Rideout; David Porter,3,0,37,34
1657689693790,MATH 18,B04,083751,Rideout; David Porter,6,0,36,30
1657689693790,MATH 18,B05,093473,Rideout; David Porter,6,0,36,30
1657689693790,MATH 18,B06,093474,Rideout; David Porter,6,0,36,30
1657689699813,MATH 20A,A01,083754,Zheng; Zequn,14,0,40,26
1657689705839,MATH 20B,A01,083756,Briones; Jor-el Thomas Caparas,4,0,36,32
1657689705839,MATH 20B,A02,083757,Briones; Jor-el Thomas Caparas,1,0,36,35
1657689705839,MATH 20B,A03,093475,Briones; Jor-el Thomas Caparas,2,0,36,34
1657689711863,MATH 20C,A01,083760,Briones; Jor-el Thomas Caparas,1,0,35,34
1657689711863,MATH 20C,A02,083761,Briones; Jor-el Thomas Caparas,8,0,35,27
1657689711863,MATH 20C,A03,093476,Briones; Jor-el Thomas Caparas,0,1,36,36
1657689711863,MATH 20C,B01,083762,Bach; Quang Tran,1,0,30,29
1657689717890,MATH 20D,A01,083765,Tran; Brian Kha,5,0,30,25
1657689717890,MATH 20D,A02,083766,Tran; Brian Kha,5,0,30,25
1657689717890,MATH 20D,A03,083767,Tran; Brian Kha,5,0,30,25
1657689723914,MATH 20E,A01,083771,Ganguly; Soumya,9,0,32,23
1657689723914,MATH 20E,A02,083772,Ganguly; Soumya,6,0,32,26
1657689723914,MATH 20E,B01,083773,Ciotti; Benjamin,20,0,35,15
1657689723914,MATH 20E,B02,083774,Ciotti; Benjamin,18,0,35,17
1657689729938,MATH 103A,A01,083777,Greenfeld; Be'Eri,3,0,36,33
1657689729938,MATH 103A,A02,083778,Greenfeld; Be'Eri,5,0,36,31
1657689729938,MATH 103A,A03,093561,Greenfeld; Be'Eri,6,0,36,30
1657689729938,MATH 103A,B01,083779,Greenfeld; Be'Eri,7,0,36,29
1657689729938,MATH 103A,B02,083780,Greenfeld; Be'Eri,4,0,36,32
1657689729938,MATH 103A,B03,093562,Greenfeld; Be'Eri,3,0,36,33
1657689735962,MATH 105,A01,085443,Carter; Anne Toulson,15,0,35,20
1657689735962,MATH 105,A02,093477,Carter; Anne Toulson,20,0,35,15
1657689741986,MATH 109,A01,083213,Ganzberger; Geoffrey Michael,2,0,34,32
1657689741986,MATH 109,A02,083214,Ganzberger; Geoffrey Michael,4,0,34,30
1657689741986,MATH 109,A03,093478,Ganzberger; Geoffrey Michael,2,0,34,32
1657689741986,MATH 109,B01,083215,Ganzberger; Geoffrey Michael,1,0,32,31
1657689741986,MATH 109,B02,083216,Ganzberger; Geoffrey Michael,2,0,32,30
1657689741986,MATH 109,B03,093479,Ganzberger; Geoffrey Michael,8,0,32,24
1657689748008,MATH 142A,A01,083219,Chow; Bennett,7,0,32,25
1657689748008,MATH 142A,A02,083220,Chow; Bennett,10,0,32,22
1657689748008,MATH 142A,A03,093480,Chow; Bennett,9,0,32,23
1657689748008,MATH 142A,B03,093481,Chow; Bennett,8,0,32,24
1657689748008,MATH 142A,B04,093558,Chow; Bennett,13,0,32,19
1657689748008,MATH 142A,B05,093559,Chow; Bennett,6,0,32,26
1657689754035,MATH 193A,A01,083224,Rotar; Vladimir,8,0,34,26
1657689754035,MATH 193A,A02,083225,Rotar; Vladimir,9,0,34,25
1657689754035,MATH 193A,A03,083781,Rotar; Vladimir,5,0,34,29
1657689754035,MATH 193A,A04,083782,Rotar; Vladimir,10,0,34,24
1657689754035,MATH 193A,A05,093482,Rotar; Vladimir,10,0,34,24
1657689760059,MATH 197,001,091859,McAuley; Julian John,9999,0,9999,0
1657689760059,MATH 197,002,095566,Kedlaya; Kiran S.,9997,0,9999,2
1657689760059,MATH 197,003,095567,Xiao; Ming,9999,0,9999,0
1657689760059,MATH 197,004,095571,Perols; Johan Lars,9998,0,9999,1
1657689767109,COGS 9,A01,083615,Shannon; Kyle Michael,9,0,75,66
1657689773135,COGS 11,A01,083617,Boyle; Mary E. T.,23,0,48,25
1657689779160,COGS 13,A01,083071,Bastos; Amalia Pinkusfeld,11,0,71,60
1657689785187,COGS 14A,A01,092681,Semenuks; Arturs,5,1,100,95
1657689791211,COGS 14B,A01,083073,Cheng; Tzu-Han,6,0,63,57
1657689797233,COGS 17,A01,092677,Semenuks; Arturs,6,0,81,75
1657689803255,COGS 100,A01,083619,Allen; Michael Gordon,17,0,70,53
1657689809278,COGS 101A,A01,083621,Davis; Joshua Daniel,9,0,68,59
1657689815301,COGS 101B,A01,091572,Allen; Michael Gordon,12,0,65,53
1657689821326,COGS 101C,A01,083625,Delgado; Tania,17,0,35,18
1657689827351,COGS 107A,A01,083627,Boyle; Mary E. T.,13,0,60,47
1657689833379,COGS 118A,A01,083075,Gupta; Anjum,21,0,76,55
1657689839406,CSE 3,A50,083646,Miranda; Gregory Joseph,24,0,50,26
1657689845428,CSE 8A,A50,083650,Miranda; Gregory Joseph,17,1,56,39
1657689851453,CSE 11,A01,083080,Cao; Yingjun,6,15,40,34
1657689857480,CSE 12,A01,083652,Krause-Levy; Sophia Louisa,28,1,120,92
1657689863503,CSE 15L,A01,083654,Morris; Justin Loren,9,0,50,41
1657689863503,CSE 15L,A02,083655,Morris; Justin Loren,9,0,50,41
1657689869529,CSE 20,A01,083657,Tran; Khoa Dang,39,0,80,41
1657689875557,CSE 21,A01,095574,Bach; Quang Tran,22,0,48,26
1657689881584,CSE 30,A01,083084,Eldon; John,6,0,80,74
1657689881584,CSE 30,B01,095061,Bhaskar; Nishant,9,0,50,41
1657689887607,CSE 100,A01,083659,Cao; Yingjun,5,4,70,65
1657689893630,CSE 134B,A01,083661,Powell; Thomas Allan,23,0,100,77
1657689899654,CSE 140,A01,083663,Gungor; Onat,15,0,85,70
1657689905676,CSE 140L,A01,083088,Eldon; John,22,0,100,78
1657689911697,CSE 175,A01,083665,Kumar; Rakesh,3,0,25,22
1657689917721,CSE 190,A00,092507,Dubnov; Shlomo,8,0,20,12
1657689923748,ECE 45,A01,083139,Congero; Spencer William,6,0,75,69
1657689929773,ECE 65,A50,083695,Saad; Andrew S,12,0,30,18
1657689929773,ECE 65,A51,095125,Saad; Andrew S,24,0,26,2
1657689935798,ECE 109,A01,091882,Touri; Behrouz,20,0,70,50
1657689941831,ECE 180,A00,083140,Abi Samra; Nicholas Camill,1,0,30,29
1657689941831,ECE 180,B00,083141,Abi Samra; Nicholas Camill,0,0,30,30
1657689947854,MATH 10A,A01,083735,Patchell; Gregory David,2,0,30,28
1657689947854,MATH 10A,A02,083736,Patchell; Gregory David,20,0,30,10
1657689947854,MATH 10A,A03,083737,Patchell; Gregory David,16,0,30,14
1657689953878,MATH 10B,A01,083207,Lim; Seonhee,8,0,34,26
1657689953878,MATH 10B,A02,083208,Lim; Seonhee,9,0,35,26
1657689953878,MATH 10B,A03,093472,Lim; Seonhee,7,0,34,27
1657689953878,MATH 10B,B01,083739,Sinha; Shubham,13,0,30,17
1657689959901,MATH 18,A01,083743,Cinel; Cameron Alexander,8,0,30,22
1657689959901,MATH 18,A02,083744,Cinel; Cameron Alexander,17,0,30,13
1657689959901,MATH 18,A03,083745,Cinel; Cameron Alexander,10,0,30,20
1657689959901,MATH 18,B01,083748,Rideout; David Porter,5,0,37,32
1657689959901,MATH 18,B02,083749,Rideout; David Porter,5,0,36,31
1657689959901,MATH 18,B03,083750,Rideout; David Porter,3,0,37,34
1657689959901,MATH 18,B04,083751,Rideout; David Porter,6,0,36,30
1657689959901,MATH 18,B05,093473,Rideout; David Porter,6,0,36,30
1657689959901,MATH 18,B06,093474,Rideout; David Porter,6,0,36,30
1657689965924,MATH 20A,A01,083754,Zheng; Zequn,14,0,40,26
1657689971951,MATH 20B,A01,083756,Briones; Jor-el Thomas Caparas,4,0,36,32
1657689971951,MATH 20B,A02,083757,Briones; Jor-el Thomas Caparas,1,0,36,35
1657689971951,MATH 20B,A03,093475,Briones; Jor-el Thomas Caparas,2,0,36,34
1657689977976,MATH 20C,A01,083760,Briones; Jor-el Thomas Caparas,1,0,35,34
1657689977976,MATH 20C,A02,083761,Briones; Jor-el Thomas Caparas,8,0,35,27
1657689977976,MATH 20C,A03,093476,Briones; Jor-el Thomas Caparas,0,1,36,36
1657689977976,MATH 20C,B01,083762,Bach; Quang Tran,1,0,30,29
1657689984000,MATH 20D,A01,083765,Tran; Brian Kha,5,0,30,25
1657689984000,MATH 20D,A02,083766,Tran; Brian Kha,5,0,30,25
1657689984000,MATH 20D,A03,083767,Tran; Brian Kha,5,0,30,25
1657689990027,MATH 20E,A01,083771,Ganguly; Soumya,9,0,32,23
1657689990027,MATH 20E,A02,083772,Ganguly; Soumya,6,0,32,26
1657689990027,MATH 20E,B01,083773,Ciotti; Benjamin,20,0,35,15
1657689990027,MATH 20E,B02,083774,Ciotti; Benjamin,18,0,35,17
1657689996051,MATH 103A,A01,083777,Greenfeld; Be'Eri,3,0,36,33
1657689996051,MATH 103A,A02,083778,Greenfeld; Be'Eri,5,0,36,31
1657689996051,MATH 103A,A03,093561,Greenfeld; Be'Eri,6,0,36,30
1657689996051,MATH 103A,B01,083779,Greenfeld; Be'Eri,7,0,36,29
1657689996051,MATH 103A,B02,083780,Greenfeld; Be'Eri,4,0,36,32
1657689996051,MATH 103A,B03,093562,Greenfeld; Be'Eri,3,0,36,33
1657690002074,MATH 105,A01,085443,Carter; Anne Toulson,15,0,35,20
1657690002074,MATH 105,A02,093477,Carter; Anne Toulson,20,0,35,15
1657690008098,MATH 109,A01,083213,Ganzberger; Geoffrey Michael,2,0,34,32
1657690008098,MATH 109,A02,083214,Ganzberger; Geoffrey Michael,4,0,34,30
1657690008098,MATH 109,A03,093478,Ganzberger; Geoffrey Michael,2,0,34,32
1657690008098,MATH 109,B01,083215,Ganzberger; Geoffrey Michael,1,0,32,31
1657690008098,MATH 109,B02,083216,Ganzberger; Geoffrey Michael,2,0,32,30
1657690008098,MATH 109,B03,093479,Ganzberger; Geoffrey Michael,8,0,32,24
1657690014122,MATH 142A,A01,083219,Chow; Bennett,7,0,32,25
1657690014122,MATH 142A,A02,083220,Chow; Bennett,10,0,32,22
1657690014122,MATH 142A,A03,093480,Chow; Bennett,9,0,32,23
1657690014122,MATH 142A,B03,093481,Chow; Bennett,8,0,32,24
1657690014122,MATH 142A,B04,093558,Chow; Bennett,13,0,32,19
1657690014122,MATH 142A,B05,093559,Chow; Bennett,6,0,32,26
1657690020145,MATH 193A,A01,083224,Rotar; Vladimir,8,0,34,26
1657690020145,MATH 193A,A02,083225,Rotar; Vladimir,9,0,34,25
1657690020145,MATH 193A,A03,083781,Rotar; Vladimir,5,0,34,29
1657690020145,MATH 193A,A04,083782,Rotar; Vladimir,10,0,34,24
1657690020145,MATH 193A,A05,093482,Rotar; Vladimir,10,0,34,24
1657690026176,MATH 197,001,091859,McAuley; Julian John,9999,0,9999,0
1657690026176,MATH 197,002,095566,Kedlaya; Kiran S.,9997,0,9999,2
1657690026176,MATH 197,003,095567,Xiao; Ming,9999,0,9999,0
1657690026176,MATH 197,004,095571,Perols; Johan Lars,9998,0,9999,1
1657690033233,COGS 9,A01,083615,Shannon; Kyle Michael,9,0,75,66
1657690039257,COGS 11,A01,083617,Boyle; Mary E. T.,23,0,48,25
1657690045281,COGS 13,A01,083071,Bastos; Amalia Pinkusfeld,11,0,71,60
1657690051305,COGS 14A,A01,092681,Semenuks; Arturs,5,1,100,95
1657690057335,COGS 14B,A01,083073,Cheng; Tzu-Han,6,0,63,57
1657690063360,COGS 17,A01,092677,Semenuks; Arturs,6,0,81,75
1657690069383,COGS 100,A01,083619,Allen; Michael Gordon,17,0,70,53
1657690075406,COGS 101A,A01,083621,Davis; Joshua Daniel,9,0,68,59
1657690081432,COGS 101B,A01,091572,Allen; Michael Gordon,12,0,65,53
1657690087474,COGS 101C,A01,083625,Delgado; Tania,17,0,35,18
1657690093495,COGS 107A,A01,083627,Boyle; Mary E. T.,13,0,60,47
1657690099522,COGS 118A,A01,083075,Gupta; Anjum,21,0,76,55
1657690105549,CSE 3,A50,083646,Miranda; Gregory Joseph,24,0,50,26
1657690111575,CSE 8A,A50,083650,Miranda; Gregory Joseph,17,1,56,39
1657690117600,CSE 11,A01,083080,Cao; Yingjun,6,15,40,34
1657690123630,CSE 12,A01,083652,Krause-Levy; Sophia Louisa,28,1,120,92
1657690129656,CSE 15L,A01,083654,Morris; Justin Loren,9,0,50,41
1657690129656,CSE 15L,A02,083655,Morris; Justin Loren,9,0,50,41
1657690135682,CSE 20,A01,083657,Tran; Khoa Dang,39,0,80,41
1657690141704,CSE 21,A01,095574,Bach; Quang Tran,22,0,48,26
1657690147726,CSE 30,A01,083084,Eldon; John,6,0,80,74
1657690147726,CSE 30,B01,095061,Bhaskar; Nishant,9,0,50,41
1657690153753,CSE 100,A01,083659,Cao; Yingjun,5,4,70,65
1657690159777,CSE 134B,A01,083661,Powell; Thomas Allan,23,0,100,77
1657690165799,CSE 140,A01,083663,Gungor; Onat,15,0,85,70
1657690171830,CSE 140L,A01,083088,Eldon; John,22,0,100,78
1657690177853,CSE 175,A01,083665,Kumar; Rakesh,3,0,25,22
1657690183967,CSE 190,A00,092507,Dubnov; Shlomo,8,0,20,12
1657690189989,ECE 45,A01,083139,Congero; Spencer William,6,0,75,69
1657690196013,ECE 65,A50,083695,Saad; Andrew S,12,0,30,18
1657690196013,ECE 65,A51,095125,Saad; Andrew S,24,0,26,2
1657690202036,ECE 109,A01,091882,Touri; Behrouz,20,0,70,50
1657690208073,ECE 180,A00,083140,Abi Samra; Nicholas Camill,1,0,30,29
1657690208073,ECE 180,B00,083141,Abi Samra; Nicholas Camill,0,0,30,30
1657690214100,MATH 10A,A01,083735,Patchell; Gregory David,2,0,30,28
1657690214100,MATH 10A,A02,083736,Patchell; Gregory David,20,0,30,10
1657690214100,MATH 10A,A03,083737,Patchell; Gregory David,16,0,30,14
1657690220128,MATH 10B,A01,083207,Lim; Seonhee,8,0,34,26
1657690220128,MATH 10B,A02,083208,Lim; Seonhee,9,0,35,26
1657690220128,MATH 10B,A03,093472,Lim; Seonhee,7,0,34,27
1657690220128,MATH 10B,B01,083739,Sinha; Shubham,13,0,30,17
1657690226162,MATH 18,A01,083743,Cinel; Cameron Alexander,8,0,30,22
1657690226162,MATH 18,A02,083744,Cinel; Cameron Alexander,17,0,30,13
1657690226162,MATH 18,A03,083745,Cinel; Cameron Alexander,10,0,30,20
1657690226162,MATH 18,B01,083748,Rideout; David Porter,5,0,37,32
1657690226162,MATH 18,B02,083749,Rideout; David Porter,5,0,36,31
1657690226162,MATH 18,B03,083750,Rideout; David Porter,3,0,37,34
1657690226162,MATH 18,B04,083751,Rideout; David Porter,6,0,36,30
1657690226162,MATH 18,B05,093473,Rideout; David Porter,6,0,36,30
1657690226162,MATH 18,B06,093474,Rideout; David Porter,6,0,36,30
1657690232207,MATH 20A,A01,083754,Zheng; Zequn,14,0,40,26
1657690238234,MATH 20B,A01,083756,Briones; Jor-el Thomas Caparas,4,0,36,32
1657690238234,MATH 20B,A02,083757,Briones; Jor-el Thomas Caparas,1,0,36,35
1657690238234,MATH 20B,A03,093475,Briones; Jor-el Thomas Caparas,2,0,36,34
1657690244258,MATH 20C,A01,083760,Briones; Jor-el Thomas Caparas,1,0,35,34
1657690244258,MATH 20C,A02,083761,Briones; Jor-el Thomas Caparas,8,0,35,27
1657690244258,MATH 20C,A03,093476,Briones; Jor-el Thomas Caparas,0,1,36,36
1657690244258,MATH 20C,B01,083762,Bach; Quang Tran,1,0,30,29
1657690250289,MATH 20D,A01,083765,Tran; Brian Kha,5,0,30,25
1657690250289,MATH 20D,A02,083766,Tran; Brian Kha,5,0,30,25
1657690250289,MATH 20D,A03,083767,Tran; Brian Kha,5,0,30,25
1657690256313,MATH 20E,A01,083771,Ganguly; Soumya,9,0,32,23
1657690256313,MATH 20E,A02,083772,Ganguly; Soumya,6,0,32,26
1657690256313,MATH 20E,B01,083773,Ciotti; Benjamin,20,0,35,15
1657690256313,MATH 20E,B02,083774,Ciotti; Benjamin,18,0,35,17
1657690262339,MATH 103A,A01,083777,Greenfeld; Be'Eri,3,0,36,33
1657690262339,MATH 103A,A02,083778,Greenfeld; Be'Eri,5,0,36,31
1657690262339,MATH 103A,A03,093561,Greenfeld; Be'Eri,6,0,36,30
1657690262339,MATH 103A,B01,083779,Greenfeld; Be'Eri,7,0,36,29
1657690262339,MATH 103A,B02,083780,Greenfeld; Be'Eri,4,0,36,32
1657690262339,MATH 103A,B03,093562,Greenfeld; Be'Eri,3,0,36,33
1657690268367,MATH 105,A01,085443,Carter; Anne Toulson,15,0,35,20
1657690268367,MATH 105,A02,093477,Carter; Anne Toulson,20,0,35,15
1657690274389,MATH 109,A01,083213,Ganzberger; Geoffrey Michael,2,0,34,32
1657690274389,MATH 109,A02,083214,Ganzberger; Geoffrey Michael,4,0,34,30
1657690274389,MATH 109,A03,093478,Ganzberger; Geoffrey Michael,2,0,34,32
1657690274389,MATH 109,B01,083215,Ganzberger; Geoffrey Michael,1,0,32,31
1657690274389,MATH 109,B02,083216,Ganzberger; Geoffrey Michael,2,0,32,30
1657690274389,MATH 109,B03,093479,Ganzberger; Geoffrey Michael,8,0,32,24
1657690280413,MATH 142A,A01,083219,Chow; Bennett,7,0,32,25
1657690280413,MATH 142A,A02,083220,Chow; Bennett,10,0,32,22
1657690280413,MATH 142A,A03,093480,Chow; Bennett,9,0,32,23
1657690280413,MATH 142A,B03,093481,Chow; Bennett,8,0,32,24
1657690280413,MATH 142A,B04,093558,Chow; Bennett,13,0,32,19
1657690280413,MATH 142A,B05,093559,Chow; Bennett,6,0,32,26
1657690286444,MATH 193A,A01,083224,Rotar; Vladimir,8,0,34,26
1657690286444,MATH 193A,A02,083225,Rotar; Vladimir,9,0,34,25
1657690286444,MATH 193A,A03,083781,Rotar; Vladimir,5,0,34,29
1657690286444,MATH 193A,A04,083782,Rotar; Vladimir,10,0,34,24
1657690286444,MATH 193A,A05,093482,Rotar; Vladimir,10,0,34,24
1657690292467,MATH 197,001,091859,McAuley; Julian John,9999,0,9999,0
1657690292467,MATH 197,002,095566,Kedlaya; Kiran S.,9997,0,9999,2
1657690292467,MATH 197,003,095567,Xiao; Ming,9999,0,9999,0
1657690292467,MATH 197,004,095571,Perols; Johan Lars,9998,0,9999,1
1657690299547,COGS 9,A01,083615,Shannon; Kyle Michael,9,0,75,66
1657690305570,COGS 11,A01,083617,Boyle; Mary E. T.,23,0,48,25
1657690311594,COGS 13,A01,083071,Bastos; Amalia Pinkusfeld,11,0,71,60
1657690317620,COGS 14A,A01,092681,Semenuks; Arturs,5,1,100,95
1657690323643,COGS 14B,A01,083073,Cheng; Tzu-Han,6,0,63,57
1657690329671,COGS 17,A01,092677,Semenuks; Arturs,6,0,81,75
1657690335694,COGS 100,A01,083619,Allen; Michael Gordon,17,0,70,53
1657690341727,COGS 101A,A01,083621,Davis; Joshua Daniel,9,0,68,59
1657690347753,COGS 101B,A01,091572,Allen; Michael Gordon,12,0,65,53
1657690353776,COGS 101C,A01,083625,Delgado; Tania,17,0,35,18
1657690359802,COGS 107A,A01,083627,Boyle; Mary E. T.,13,0,60,47
1657690365826,COGS 118A,A01,083075,Gupta; Anjum,21,0,76,55
1657690371850,CSE 3,A50,083646,Miranda; Gregory Joseph,24,0,50,26
1657690377875,CSE 8A,A50,083650,Miranda; Gregory Joseph,17,1,56,39
1657690383899,CSE 11,A01,083080,Cao; Yingjun,6,15,40,34
1657690389922,CSE 12,A01,083652,Krause-Levy; Sophia Louisa,28,1,120,92
1657690395951,CSE 15L,A01,083654,Morris; Justin Loren,9,0,50,41
1657690395951,CSE 15L,A02,083655,Morris; Justin Loren,9,0,50,41
1657690401982,CSE 20,A01,083657,Tran; Khoa Dang,39,0,80,41
1657690408015,CSE 21,A01,095574,Bach; Quang Tran,22,0,48,26
1657690414046,CSE 30,A01,083084,Eldon; John,6,0,80,74
1657690414046,CSE 30,B01,095061,Bhaskar; Nishant,9,0,50,41
1657690420077,CSE 100,A01,083659,Cao; Yingjun,5,4,70,65
1657690426100,CSE 134B,A01,083661,Powell; Thomas Allan,23,0,100,77
1657690432125,CSE 140,A01,083663,Gungor; Onat,15,0,85,70
1657690438151,CSE 140L,A01,083088,Eldon; John,22,0,100,78
1657690444177,CSE 175,A01,083665,Kumar; Rakesh,3,0,25,22
1657690450206,CSE 190,A00,092507,Dubnov; Shlomo,8,0,20,12
1657690456229,ECE 45,A01,083139,Congero; Spencer William,6,0,75,69
1657690462254,ECE 65,A50,083695,Saad; Andrew S,12,0,30,18
1657690462254,ECE 65,A51,095125,Saad; Andrew S,24,0,26,2
1657690468280,ECE 109,A01,091882,Touri; Behrouz,20,0,70,50
1657690474303,ECE 180,A00,083140,Abi Samra; Nicholas Camill,1,0,30,29
1657690474303,ECE 180,B00,083141,Abi Samra; Nicholas Camill,0,0,30,30
1657690480327,MATH 10A,A01,083735,Patchell; Gregory David,2,0,30,28
1657690480327,MATH 10A,A02,083736,Patchell; Gregory David,20,0,30,10
1657690480327,MATH 10A,A03,083737,Patchell; Gregory David,16,0,30,14
1657690486355,MATH 10B,A01,083207,Lim; Seonhee,8,0,34,26
1657690486355,MATH 10B,A02,083208,Lim; Seonhee,9,0,35,26
1657690486355,MATH 10B,A03,093472,Lim; Seonhee,7,0,34,27
1657690486355,MATH 10B,B01,083739,Sinha; Shubham,13,0,30,17
1657690492385,MATH 18,A01,083743,Cinel; Cameron Alexander,8,0,30,22
1657690492385,MATH 18,A02,083744,Cinel; Cameron Alexander,17,0,30,13
1657690492385,MATH 18,A03,083745,Cinel; Cameron Alexander,10,0,30,20
1657690492385,MATH 18,B01,083748,Rideout; David Porter,5,0,37,32
1657690492385,MATH 18,B02,083749,Rideout; David Porter,5,0,36,31
1657690492385,MATH 18,B03,083750,Rideout; David Porter,3,0,37,34
1657690492385,MATH 18,B04,083751,Rideout; David Porter,6,0,36,30
1657690492385,MATH 18,B05,093473,Rideout; David Porter,6,0,36,30
1657690492385,MATH 18,B06,093474,Rideout; David Porter,6,0,36,30
1657690498409,MATH 20A,A01,083754,Zheng; Zequn,14,0,40,26
1657690504437,MATH 20B,A01,083756,Briones; Jor-el Thomas Caparas,4,0,36,32
1657690504437,MATH 20B,A02,083757,Briones; Jor-el Thomas Caparas,1,0,36,35
1657690504437,MATH 20B,A03,093475,Briones; Jor-el Thomas Caparas,2,0,36,34
1657690510463,MATH 20C,A01,083760,Briones; Jor-el Thomas Caparas,1,0,35,34
1657690510463,MATH 20C,A02,083761,Briones; Jor-el Thomas Caparas,8,0,35,27
1657690510463,MATH 20C,A03,093476,Briones; Jor-el Thomas Caparas,0,1,36,36
1657690510463,MATH 20C,B01,083762,Bach; Quang Tran,1,0,30,29
1657690516487,MATH 20D,A01,083765,Tran; Brian Kha,5,0,30,25
1657690516487,MATH 20D,A02,083766,Tran; Brian Kha,5,0,30,25
1657690516487,MATH 20D,A03,083767,Tran; Brian Kha,5,0,30,25
1657690522509,MATH 20E,A01,083771,Ganguly; Soumya,9,0,32,23
1657690522509,MATH 20E,A02,083772,Ganguly; Soumya,6,0,32,26
1657690522509,MATH 20E,B01,083773,Ciotti; Benjamin,20,0,35,15
1657690522509,MATH 20E,B02,083774,Ciotti; Benjamin,18,0,35,17
1657690528539,MATH 103A,A01,083777,Greenfeld; Be'Eri,3,0,36,33
1657690528539,MATH 103A,A02,083778,Greenfeld; Be'Eri,5,0,36,31
1657690528539,MATH 103A,A03,093561,Greenfeld; Be'Eri,6,0,36,30
1657690528539,MATH 103A,B01,083779,Greenfeld; Be'Eri,7,0,36,29
1657690528539,MATH 103A,B02,083780,Greenfeld; Be'Eri,4,0,36,32
1657690528539,MATH 103A,B03,093562,Greenfeld; Be'Eri,3,0,36,33
1657690534562,MATH 105,A01,085443,Carter; Anne Toulson,15,0,35,20
1657690534562,MATH 105,A02,093477,Carter; Anne Toulson,20,0,35,15
1657690540588,MATH 109,A01,083213,Ganzberger; Geoffrey Michael,2,0,34,32
1657690540588,MATH 109,A02,083214,Ganzberger; Geoffrey Michael,4,0,34,30
1657690540588,MATH 109,A03,093478,Ganzberger; Geoffrey Michael,2,0,34,32
1657690540588,MATH 109,B01,083215,Ganzberger; Geoffrey Michael,1,0,32,31
1657690540588,MATH 109,B02,083216,Ganzberger; Geoffrey Michael,2,0,32,30
1657690540588,MATH 109,B03,093479,Ganzberger; Geoffrey Michael,8,0,32,24
1657690546618,MATH 142A,A01,083219,Chow; Bennett,7,0,32,25
1657690546618,MATH 142A,A02,083220,Chow; Bennett,10,0,32,22
1657690546618,MATH 142A,A03,093480,Chow; Bennett,9,0,32,23
1657690546618,MATH 142A,B03,093481,Chow; Bennett,8,0,32,24
1657690546618,MATH 142A,B04,093558,Chow; Bennett,13,0,32,19
1657690546618,MATH 142A,B05,093559,Chow; Bennett,6,0,32,26
1657690552649,MATH 193A,A01,083224,Rotar; Vladimir,8,0,34,26
1657690552649,MATH 193A,A02,083225,Rotar; Vladimir,9,0,34,25
1657690552649,MATH 193A,A03,083781,Rotar; Vladimir,5,0,34,29
1657690552649,MATH 193A,A04,083782,Rotar; Vladimir,10,0,34,24
1657690552649,MATH 193A,A05,093482,Rotar; Vladimir,10,0,34,24
1657690558673,MATH 197,001,091859,McAuley; Julian John,9999,0,9999,0
1657690558673,MATH 197,002,095566,Kedlaya; Kiran S.,9997,0,9999,2
1657690558673,MATH 197,003,095567,Xiao; Ming,9999,0,9999,0
1657690558673,MATH 197,004,095571,Perols; Johan Lars,9998,0,9999,1
1657690565723,COGS 9,A01,083615,Shannon; Kyle Michael,9,0,75,66
1657690571751,COGS 11,A01,083617,Boyle; Mary E. T.,23,0,48,25
1657690577774,COGS 13,A01,083071,Bastos; Amalia Pinkusfeld,11,0,71,60
1657690583801,COGS 14A,A01,092681,Semenuks; Arturs,5,1,100,95
1657690589825,COGS 14B,A01,083073,Cheng; Tzu-Han,6,0,63,57
1657690595848,COGS 17,A01,092677,Semenuks; Arturs,6,0,81,75
1657690601873,COGS 100,A01,083619,Allen; Michael Gordon,17,0,70,53
1657690607896,COGS 101A,A01,083621,Davis; Joshua Daniel,9,0,68,59
1657690613921,COGS 101B,A01,091572,Allen; Michael Gordon,12,0,65,53
1657690619948,COGS 101C,A01,083625,Delgado; Tania,17,0,35,18
1657690625974,COGS 107A,A01,083627,Boyle; Mary E. T.,13,0,60,47
1657690631999,COGS 118A,A01,083075,Gupta; Anjum,21,0,76,55
1657690638027,CSE 3,A50,083646,Miranda; Gregory Joseph,24,0,50,26
1657690644048,CSE 8A,A50,083650,Miranda; Gregory Joseph,17,1,56,39
1657690650076,CSE 11,A01,083080,Cao; Yingjun,6,15,40,34
1657690656106,CSE 12,A01,083652,Krause-Levy; Sophia Louisa,28,1,120,92
1657690662138,CSE 15L,A01,083654,Morris; Justin Loren,9,0,50,41
1657690662138,CSE 15L,A02,083655,Morris; Justin Loren,9,0,50,41
1657690668175,CSE 20,A01,083657,Tran; Khoa Dang,39,0,80,41
1657690674199,CSE 21,A01,095574,Bach; Quang Tran,22,0,48,26
1657690680229,CSE 30,A01,083084,Eldon; John,6,0,80,74
1657690680229,CSE 30,B01,095061,Bhaskar; Nishant,9,0,50,41
1657690686272,CSE 100,A01,083659,Cao; Yingjun,5,4,70,65
1657690692295,CSE 134B,A01,083661,Powell; Thomas Allan,23,0,100,77
1657690698322,CSE 140,A01,083663,Gungor; Onat,15,0,85,70
1657690704348,CSE 140L,A01,083088,Eldon; John,22,0,100,78
1657690710379,CSE 175,A01,083665,Kumar; Rakesh,3,0,25,22
1657690716405,CSE 190,A00,092507,Dubnov; Shlomo,8,0,20,12
1657690722428,ECE 45,A01,083139,Congero; Spencer William,6,0,75,69
1657690728473,ECE 65,A50,083695,Saad; Andrew S,12,0,30,18
1657690728473,ECE 65,A51,095125,Saad; Andrew S,24,0,26,2
1657690734500,ECE 109,A01,091882,Touri; Behrouz,20,0,70,50
1657690740530,ECE 180,A00,083140,Abi Samra; Nicholas Camill,1,0,30,29
1657690740530,ECE 180,B00,083141,Abi Samra; Nicholas Camill,0,0,30,30
1657690746556,MATH 10A,A01,083735,Patchell; Gregory David,2,0,30,28
1657690746556,MATH 10A,A02,083736,Patchell; Gregory David,20,0,30,10
1657690746556,MATH 10A,A03,083737,Patchell; Gregory David,16,0,30,14
1657690752579,MATH 10B,A01,083207,Lim; Seonhee,8,0,34,26
1657690752579,MATH 10B,A02,083208,Lim; Seonhee,9,0,35,26
1657690752579,MATH 10B,A03,093472,Lim; Seonhee,7,0,34,27
1657690752579,MATH 10B,B01,083739,Sinha; Shubham,13,0,30,17
1657690758604,MATH 18,A01,083743,Cinel; Cameron Alexander,8,0,30,22
1657690758604,MATH 18,A02,083744,Cinel; Cameron Alexander,17,0,30,13
1657690758604,MATH 18,A03,083745,Cinel; Cameron Alexander,10,0,30,20
1657690758604,MATH 18,B01,083748,Rideout; David Porter,5,0,37,32
1657690758604,MATH 18,B02,083749,Rideout; David Porter,5,0,36,31
1657690758604,MATH 18,B03,083750,Rideout; David Porter,3,0,37,34
1657690758604,MATH 18,B04,083751,Rideout; David Porter,6,0,36,30
1657690758604,MATH 18,B05,093473,Rideout; David Porter,6,0,36,30
1657690758604,MATH 18,B06,093474,Rideout; David Porter,6,0,36,30
1657690764631,MATH 20A,A01,083754,Zheng; Zequn,14,0,40,26
1657690770655,MATH 20B,A01,083756,Briones; Jor-el Thomas Caparas,4,0,36,32
1657690770655,MATH 20B,A02,083757,Briones; Jor-el Thomas Caparas,1,0,36,35
1657690770655,MATH 20B,A03,093475,Briones; Jor-el Thomas Caparas,2,0,36,34
1657690776678,MATH 20C,A01,083760,Briones; Jor-el Thomas Caparas,1,0,35,34
1657690776678,MATH 20C,A02,083761,Briones; Jor-el Thomas Caparas,8,0,35,27
1657690776678,MATH 20C,A03,093476,Briones; Jor-el Thomas Caparas,0,1,36,36
1657690776678,MATH 20C,B01,083762,Bach; Quang Tran,1,0,30,29
1657690782796,MATH 20D,A01,083765,Tran; Brian Kha,5,0,30,25
1657690782796,MATH 20D,A02,083766,Tran; Brian Kha,5,0,30,25
1657690782796,MATH 20D,A03,083767,Tran; Brian Kha,5,0,30,25
1657690788824,MATH 20E,A01,083771,Ganguly; Soumya,9,0,32,23
1657690788824,MATH 20E,A02,083772,Ganguly; Soumya,6,0,32,26
1657690788824,MATH 20E,B01,083773,Ciotti; Benjamin,20,0,35,15
1657690788824,MATH 20E,B02,083774,Ciotti; Benjamin,18,0,35,17
1657690794848,MATH 103A,A01,083777,Greenfeld; Be'Eri,3,0,36,33
1657690794848,MATH 103A,A02,083778,Greenfeld; Be'Eri,5,0,36,31
1657690794848,MATH 103A,A03,093561,Greenfeld; Be'Eri,6,0,36,30
1657690794848,MATH 103A,B01,083779,Greenfeld; Be'Eri,7,0,36,29
1657690794848,MATH 103A,B02,083780,Greenfeld; Be'Eri,4,0,36,32
1657690794848,MATH 103A,B03,093562,Greenfeld; Be'Eri,3,0,36,33
1657690800873,MATH 105,A01,085443,Carter; Anne Toulson,15,0,35,20
1657690800873,MATH 105,A02,093477,Carter; Anne Toulson,20,0,35,15
1657690806901,MATH 109,A01,083213,Ganzberger; Geoffrey Michael,2,0,34,32
1657690806901,MATH 109,A02,083214,Ganzberger; Geoffrey Michael,4,0,34,30
1657690806901,MATH 109,A03,093478,Ganzberger; Geoffrey Michael,2,0,34,32
1657690806901,MATH 109,B01,083215,Ganzberger; Geoffrey Michael,1,0,32,31
1657690806901,MATH 109,B02,083216,Ganzberger; Geoffrey Michael,2,0,32,30
1657690806901,MATH 109,B03,093479,Ganzberger; Geoffrey Michael,8,0,32,24
1657690812924,MATH 142A,A01,083219,Chow; Bennett,7,0,32,25
1657690812924,MATH 142A,A02,083220,Chow; Bennett,10,0,32,22
1657690812924,MATH 142A,A03,093480,Chow; Bennett,9,0,32,23
1657690812924,MATH 142A,B03,093481,Chow; Bennett,8,0,32,24
1657690812924,MATH 142A,B04,093558,Chow; Bennett,13,0,32,19
1657690812924,MATH 142A,B05,093559,Chow; Bennett,6,0,32,26
1657690818947,MATH 193A,A01,083224,Rotar; Vladimir,8,0,34,26
1657690818947,MATH 193A,A02,083225,Rotar; Vladimir,9,0,34,25
1657690818947,MATH 193A,A03,083781,Rotar; Vladimir,5,0,34,29
1657690818947,MATH 193A,A04,083782,Rotar; Vladimir,10,0,34,24
1657690818947,MATH 193A,A05,093482,Rotar; Vladimir,10,0,34,24
1657690824974,MATH 197,001,091859,McAuley; Julian John,9999,0,9999,0
1657690824974,MATH 197,002,095566,Kedlaya; Kiran S.,9997,0,9999,2
1657690824974,MATH 197,003,095567,Xiao; Ming,9999,0,9999,0
1657690824974,MATH 197,004,095571,Perols; Johan Lars,9998,0,9999,1
1657690832028,COGS 9,A01,083615,Shannon; Kyle Michael,9,0,75,66
1657690838052,COGS 11,A01,083617,Boyle; Mary E. T.,23,0,48,25
1657690844075,COGS 13,A01,083071,Bastos; Amalia Pinkusfeld,11,0,71,60
1657690850103,COGS 14A,A01,092681,Semenuks; Arturs,5,1,100,95
1657690856136,COGS 14B,A01,083073,Cheng; Tzu-Han,6,0,63,57
1657690862162,COGS 17,A01,092677,Semenuks; Arturs,6,0,81,75
1657690868184,COGS 100,A01,083619,Allen; Michael Gordon,17,0,70,53
1657690874209,COGS 101A,A01,083621,Davis; Joshua Daniel,9,0,68,59
1657690880231,COGS 101B,A01,091572,Allen; Michael Gordon,12,0,65,53
1657690886266,COGS 101C,A01,083625,Delgado; Tania,17,0,35,18
1657690892288,COGS 107A,A01,083627,Boyle; Mary E. T.,13,0,60,47
1657690898311,COGS 118A,A01,083075,Gupta; Anjum,21,0,76,55
1657690904339,CSE 3,A50,083646,Miranda; Gregory Joseph,24,0,50,26
1657690910362,CSE 8A,A50,083650,Miranda; Gregory Joseph,17,1,56,39
1657690916399,CSE 11,A01,083080,Cao; Yingjun,6,15,40,34
1657690922425,CSE 12,A01,083652,Krause-Levy; Sophia Louisa,28,1,120,92
1657690928457,CSE 15L,A01,083654,Morris; Justin Loren,9,0,50,41
1657690928457,CSE 15L,A02,083655,Morris; Justin Loren,9,0,50,41
1657690934487,CSE 20,A01,083657,Tran; Khoa Dang,39,0,80,41
1657690940511,CSE 21,A01,095574,Bach; Quang Tran,22,0,48,26
1657690946538,CSE 30,A01,083084,Eldon; John,6,0,80,74
1657690946538,CSE 30,B01,095061,Bhaskar; Nishant,9,0,50,41
1657690952588,CSE 100,A01,083659,Cao; Yingjun,5,4,70,65
1657690958617,CSE 134B,A01,083661,Powell; Thomas Allan,23,0,100,77
1657690964639,CSE 140,A01,083663,Gungor; Onat,15,0,85,70
1657690970669,CSE 140L,A01,083088,Eldon; John,22,0,100,78
1657690976692,CSE 175,A01,083665,Kumar; Rakesh,3,0,25,22
1657690982716,CSE 190,A00,092507,Dubnov; Shlomo,8,0,20,12
1657690988743,ECE 45,A01,083139,Congero; Spencer William,6,0,75,69
1657690994766,ECE 65,A50,083695,Saad; Andrew S,12,0,30,18
1657690994766,ECE 65,A51,095125,Saad; Andrew S,24,0,26,2
1657691000791,ECE 109,A01,091882,Touri; Behrouz,20,0,70,50
1657691006814,ECE 180,A00,083140,Abi Samra; Nicholas Camill,1,0,30,29
1657691006814,ECE 180,B00,083141,Abi Samra; Nicholas Camill,0,0,30,30
1657691012837,MATH 10A,A01,083735,Patchell; Gregory David,2,0,30,28
1657691012837,MATH 10A,A02,083736,Patchell; Gregory David,20,0,30,10
1657691012837,MATH 10A,A03,083737,Patchell; Gregory David,16,0,30,14
1657691018867,MATH 10B,A01,083207,Lim; Seonhee,8,0,34,26
1657691018867,MATH 10B,A02,083208,Lim; Seonhee,9,0,35,26
1657691018867,MATH 10B,A03,093472,Lim; Seonhee,7,0,34,27
1657691018867,MATH 10B,B01,083739,Sinha; Shubham,13,0,30,17
1657691024890,MATH 18,A01,083743,Cinel; Cameron Alexander,8,0,30,22
1657691024890,MATH 18,A02,083744,Cinel; Cameron Alexander,17,0,30,13
1657691024890,MATH 18,A03,083745,Cinel; Cameron Alexander,10,0,30,20
1657691024890,MATH 18,B01,083748,Rideout; David Porter,5,0,37,32
1657691024890,MATH 18,B02,083749,Rideout; David Porter,5,0,36,31
1657691024890,MATH 18,B03,083750,Rideout; David Porter,3,0,37,34
1657691024890,MATH 18,B04,083751,Rideout; David Porter,6,0,36,30
1657691024890,MATH 18,B05,093473,Rideout; David Porter,6,0,36,30
1657691024890,MATH 18,B06,093474,Rideout; David Porter,6,0,36,30
1657691030919,MATH 20A,A01,083754,Zheng; Zequn,14,0,40,26
1657691036941,MATH 20B,A01,083756,Briones; Jor-el Thomas Caparas,4,0,36,32
1657691036941,MATH 20B,A02,083757,Briones; Jor-el Thomas Caparas,1,0,36,35
1657691036941,MATH 20B,A03,093475,Briones; Jor-el Thomas Caparas,2,0,36,34
1657691042969,MATH 20C,A01,083760,Briones; Jor-el Thomas Caparas,1,0,35,34
1657691042969,MATH 20C,A02,083761,Briones; Jor-el Thomas Caparas,8,0,35,27
1657691042969,MATH 20C,A03,093476,Briones; Jor-el Thomas Caparas,0,1,36,36
1657691042969,MATH 20C,B01,083762,Bach; Quang Tran,1,0,30,29
1657691049000,MATH 20D,A01,083765,Tran; Brian Kha,5,0,30,25
1657691049000,MATH 20D,A02,083766,Tran; Brian Kha,5,0,30,25
1657691049000,MATH 20D,A03,083767,Tran; Brian Kha,5,0,30,25
1657691055022,MATH 20E,A01,083771,Ganguly; Soumya,9,0,32,23
1657691055022,MATH 20E,A02,083772,Ganguly; Soumya,6,0,32,26
1657691055022,MATH 20E,B01,083773,Ciotti; Benjamin,20,0,35,15
1657691055022,MATH 20E,B02,083774,Ciotti; Benjamin,18,0,35,17
1657691061050,MATH 103A,A01,083777,Greenfeld; Be'Eri,3,0,36,33
1657691061050,MATH 103A,A02,083778,Greenfeld; Be'Eri,5,0,36,31
1657691061050,MATH 103A,A03,093561,Greenfeld; Be'Eri,6,0,36,30
1657691061050,MATH 103A,B01,083779,Greenfeld; Be'Eri,7,0,36,29
1657691061050,MATH 103A,B02,083780,Greenfeld; Be'Eri,4,0,36,32
1657691061050,MATH 103A,B03,093562,Greenfeld; Be'Eri,3,0,36,33
1657691067079,MATH 105,A01,085443,Carter; Anne Toulson,15,0,35,20
1657691067079,MATH 105,A02,093477,Carter; Anne Toulson,20,0,35,15
1657691073103,MATH 109,A01,083213,Ganzberger; Geoffrey Michael,2,0,34,32
1657691073103,MATH 109,A02,083214,Ganzberger; Geoffrey Michael,4,0,34,30
1657691073103,MATH 109,A03,093478,Ganzberger; Geoffrey Michael,2,0,34,32
1657691073103,MATH 109,B01,083215,Ganzberger; Geoffrey Michael,1,0,32,31
1657691073103,MATH 109,B02,083216,Ganzberger; Geoffrey Michael,2,0,32,30
1657691073103,MATH 109,B03,093479,Ganzberger; Geoffrey Michael,8,0,32,24
1657691079126,MATH 142A,A01,083219,Chow; Bennett,7,0,32,25
1657691079126,MATH 142A,A02,083220,Chow; Bennett,10,0,32,22
1657691079126,MATH 142A,A03,093480,Chow; Bennett,9,0,32,23
1657691079126,MATH 142A,B03,093481,Chow; Bennett,8,0,32,24
1657691079126,MATH 142A,B04,093558,Chow; Bennett,13,0,32,19
1657691079126,MATH 142A,B05,093559,Chow; Bennett,6,0,32,26
1657691085155,MATH 193A,A01,083224,Rotar; Vladimir,8,0,34,26
1657691085155,MATH 193A,A02,083225,Rotar; Vladimir,9,0,34,25
1657691085155,MATH 193A,A03,083781,Rotar; Vladimir,5,0,34,29
1657691085155,MATH 193A,A04,083782,Rotar; Vladimir,10,0,34,24
1657691085155,MATH 193A,A05,093482,Rotar; Vladimir,10,0,34,24
1657691091177,MATH 197,001,091859,McAuley; Julian John,9999,0,9999,0
1657691091177,MATH 197,002,095566,Kedlaya; Kiran S.,9997,0,9999,2
1657691091177,MATH 197,003,095567,Xiao; Ming,9999,0,9999,0
1657691091177,MATH 197,004,095571,Perols; Johan Lars,9998,0,9999,1
1657691098233,COGS 9,A01,083615,Shannon; Kyle Michael,9,0,75,66
1657691104256,COGS 11,A01,083617,Boyle; Mary E. T.,23,0,48,25
1657691110280,COGS 13,A01,083071,Bastos; Amalia Pinkusfeld,11,0,71,60
1657691116302,COGS 14A,A01,092681,Semenuks; Arturs,5,1,100,95
1657691122326,COGS 14B,A01,083073,Cheng; Tzu-Han,6,0,63,57
1657691128349,COGS 17,A01,092677,Semenuks; Arturs,6,0,81,75
1657691134374,COGS 100,A01,083619,Allen; Michael Gordon,17,0,70,53
1657691140396,COGS 101A,A01,083621,Davis; Joshua Daniel,9,0,68,59
1657691146423,COGS 101B,A01,091572,Allen; Michael Gordon,12,0,65,53
1657691152448,COGS 101C,A01,083625,Delgado; Tania,17,0,35,18
1657691158472,COGS 107A,A01,083627,Boyle; Mary E. T.,13,0,60,47
1657691164494,COGS 118A,A01,083075,Gupta; Anjum,21,0,76,55
1657691170522,CSE 3,A50,083646,Miranda; Gregory Joseph,24,0,50,26
1657691176548,CSE 8A,A50,083650,Miranda; Gregory Joseph,17,1,56,39
1657691182574,CSE 11,A01,083080,Cao; Yingjun,6,15,40,34
1657691188599,CSE 12,A01,083652,Krause-Levy; Sophia Louisa,28,1,120,92
1657691194623,CSE 15L,A01,083654,Morris; Justin Loren,9,0,50,41
1657691194623,CSE 15L,A02,083655,Morris; Justin Loren,9,0,50,41
1657691200652,CSE 20,A01,083657,Tran; Khoa Dang,39,0,80,41
1657691206675,CSE 21,A01,095574,Bach; Quang Tran,22,0,48,26
1657691212704,CSE 30,A01,083084,Eldon; John,6,0,80,74
1657691212704,CSE 30,B01,095061,Bhaskar; Nishant,9,0,50,41
1657691218728,CSE 100,A01,083659,Cao; Yingjun,5,4,70,65
1657691224750,CSE 134B,A01,083661,Powell; Thomas Allan,23,0,100,77
1657691230772,CSE 140,A01,083663,Gungor; Onat,15,0,85,70
1657691236797,CSE 140L,A01,083088,Eldon; John,22,0,100,78
1657691242822,CSE 175,A01,083665,Kumar; Rakesh,3,0,25,22
1657691248844,CSE 190,A00,092507,Dubnov; Shlomo,8,0,20,12
1657691254871,ECE 45,A01,083139,Congero; Spencer William,6,0,75,69
1657691260898,ECE 65,A50,083695,Saad; Andrew S,12,0,30,18
1657691260898,ECE 65,A51,095125,Saad; Andrew S,24,0,26,2
1657691266923,ECE 109,A01,091882,Touri; Behrouz,20,0,70,50
1657691272945,ECE 180,A00,083140,Abi Samra; Nicholas Camill,1,0,30,29
1657691272945,ECE 180,B00,083141,Abi Samra; Nicholas Camill,0,0,30,30
1657691278971,MATH 10A,A01,083735,Patchell; Gregory David,2,0,30,28
1657691278971,MATH 10A,A02,083736,Patchell; Gregory David,20,0,30,10
1657691278971,MATH 10A,A03,083737,Patchell; Gregory David,16,0,30,14
1657691284996,MATH 10B,A01,083207,Lim; Seonhee,8,0,34,26
1657691284996,MATH 10B,A02,083208,Lim; Seonhee,9,0,35,26
1657691284996,MATH 10B,A03,093472,Lim; Seonhee,7,0,34,27
1657691284996,MATH 10B,B01,083739,Sinha; Shubham,13,0,30,17
1657691291027,MATH 18,A01,083743,Cinel; Cameron Alexander,8,0,30,22
1657691291027,MATH 18,A02,083744,Cinel; Cameron Alexander,17,0,30,13
1657691291027,MATH 18,A03,083745,Cinel; Cameron Alexander,10,0,30,20
1657691291027,MATH 18,B01,083748,Rideout; David Porter,5,0,37,32
1657691291027,MATH 18,B02,083749,Rideout; David Porter,5,0,36,31
1657691291027,MATH 18,B03,083750,Rideout; David Porter,3,0,37,34
1657691291027,MATH 18,B04,083751,Rideout; David Porter,6,0,36,30
1657691291027,MATH 18,B05,093473,Rideout; David Porter,6,0,36,30
1657691291027,MATH 18,B06,093474,Rideout; David Porter,6,0,36,30
1657691297050,MATH 20A,A01,083754,Zheng; Zequn,14,0,40,26
1657691303073,MATH 20B,A01,083756,Briones; Jor-el Thomas Caparas,4,0,36,32
1657691303073,MATH 20B,A02,083757,Briones; Jor-el Thomas Caparas,1,0,36,35
1657691303073,MATH 20B,A03,093475,Briones; Jor-el Thomas Caparas,2,0,36,34
1657691309104,MATH 20C,A01,083760,Briones; Jor-el Thomas Caparas,1,0,35,34
1657691309104,MATH 20C,A02,083761,Briones; Jor-el Thomas Caparas,8,0,35,27
1657691309104,MATH 20C,A03,093476,Briones; Jor-el Thomas Caparas,0,1,36,36
1657691309104,MATH 20C,B01,083762,Bach; Quang Tran,1,0,30,29
1657691315132,MATH 20D,A01,083765,Tran; Brian Kha,5,0,30,25
1657691315132,MATH 20D,A02,083766,Tran; Brian Kha,5,0,30,25
1657691315132,MATH 20D,A03,083767,Tran; Brian Kha,5,0,30,25
1657691321155,MATH 20E,A01,083771,Ganguly; Soumya,9,0,32,23
1657691321155,MATH 20E,A02,083772,Ganguly; Soumya,6,0,32,26
1657691321155,MATH 20E,B01,083773,Ciotti; Benjamin,20,0,35,15
1657691321155,MATH 20E,B02,083774,Ciotti; Benjamin,18,0,35,17
1657691327184,MATH 103A,A01,083777,Greenfeld; Be'Eri,3,0,36,33
1657691327184,MATH 103A,A02,083778,Greenfeld; Be'Eri,5,0,36,31
1657691327184,MATH 103A,A03,093561,Greenfeld; Be'Eri,6,0,36,30
1657691327184,MATH 103A,B01,083779,Greenfeld; Be'Eri,7,0,36,29
1657691327184,MATH 103A,B02,083780,Greenfeld; Be'Eri,4,0,36,32
1657691327184,MATH 103A,B03,093562,Greenfeld; Be'Eri,3,0,36,33
1657691333206,MATH 105,A01,085443,Carter; Anne Toulson,15,0,35,20
1657691333206,MATH 105,A02,093477,Carter; Anne Toulson,20,0,35,15
1657691339239,MATH 109,A01,083213,Ganzberger; Geoffrey Michael,2,0,34,32
1657691339239,MATH 109,A02,083214,Ganzberger; Geoffrey Michael,4,0,34,30
1657691339239,MATH 109,A03,093478,Ganzberger; Geoffrey Michael,2,0,34,32
1657691339239,MATH 109,B01,083215,Ganzberger; Geoffrey Michael,1,0,32,31
1657691339239,MATH 109,B02,083216,Ganzberger; Geoffrey Michael,2,0,32,30
1657691339239,MATH 109,B03,093479,Ganzberger; Geoffrey Michael,8,0,32,24
1657691345262,MATH 142A,A01,083219,Chow; Bennett,7,0,32,25
1657691345262,MATH 142A,A02,083220,Chow; Bennett,10,0,32,22
1657691345262,MATH 142A,A03,093480,Chow; Bennett,9,0,32,23
1657691345262,MATH 142A,B03,093481,Chow; Bennett,8,0,32,24
1657691345262,MATH 142A,B04,093558,Chow; Bennett,13,0,32,19
1657691345262,MATH 142A,B05,093559,Chow; Bennett,6,0,32,26
1657691351301,MATH 193A,A01,083224,Rotar; Vladimir,8,0,34,26
1657691351301,MATH 193A,A02,083225,Rotar; Vladimir,9,0,34,25
1657691351301,MATH 193A,A03,083781,Rotar; Vladimir,5,0,34,29
1657691351301,MATH 193A,A04,083782,Rotar; Vladimir,10,0,34,24
1657691351301,MATH 193A,A05,093482,Rotar; Vladimir,10,0,34,24
1657691357327,MATH 197,001,091859,McAuley; Julian John,9999,0,9999,0
1657691357327,MATH 197,002,095566,Kedlaya; Kiran S.,9997,0,9999,2
1657691357327,MATH 197,003,095567,Xiao; Ming,9999,0,9999,0
1657691357327,MATH 197,004,095571,Perols; Johan Lars,9998,0,9999,1
1657691364383,COGS 9,A01,083615,Shannon; Kyle Michael,9,0,75,66
1657691370410,COGS 11,A01,083617,Boyle; Mary E. T.,23,0,48,25
1657691376510,COGS 13,A01,083071,Bastos; Amalia Pinkusfeld,11,0,71,60
1657691382550,COGS 14A,A01,092681,Semenuks; Arturs,5,1,100,95
1657691388576,COGS 14B,A01,083073,Cheng; Tzu-Han,6,0,63,57
1657691394603,COGS 17,A01,092677,Semenuks; Arturs,6,0,81,75
1657691400636,COGS 100,A01,083619,Allen; Michael Gordon,17,0,70,53
1657691406658,COGS 101A,A01,083621,Davis; Joshua Daniel,9,0,68,59
1657691412696,COGS 101B,A01,091572,Allen; Michael Gordon,12,0,65,53
1657691418719,COGS 101C,A01,083625,Delgado; Tania,17,0,35,18
1657691424743,COGS 107A,A01,083627,Boyle; Mary E. T.,13,0,60,47
1657691430769,COGS 118A,A01,083075,Gupta; Anjum,21,0,76,55
1657691436797,CSE 3,A50,083646,Miranda; Gregory Joseph,24,0,50,26
1657691442825,CSE 8A,A50,083650,Miranda; Gregory Joseph,17,1,56,39
1657691448849,CSE 11,A01,083080,Cao; Yingjun,6,15,40,34
1657691454870,CSE 12,A01,083652,Krause-Levy; Sophia Louisa,28,1,120,92
1657691460905,CSE 15L,A01,083654,Morris; Justin Loren,9,0,50,41
1657691460905,CSE 15L,A02,083655,Morris; Justin Loren,9,0,50,41
1657691466935,CSE 20,A01,083657,Tran; Khoa Dang,39,0,80,41
1657691472958,CSE 21,A01,095574,Bach; Quang Tran,22,0,48,26
1657691478986,CSE 30,A01,083084,Eldon; John,6,0,80,74
1657691478986,CSE 30,B01,095061,Bhaskar; Nishant,9,0,50,41
1657691485015,CSE 100,A01,083659,Cao; Yingjun,5,4,70,65
1657691491038,CSE 134B,A01,083661,Powell; Thomas Allan,23,0,100,77
1657691497061,CSE 140,A01,083663,Gungor; Onat,15,0,85,70
1657691503090,CSE 140L,A01,083088,Eldon; John,22,0,100,78
1657691509115,CSE 175,A01,083665,Kumar; Rakesh,3,0,25,22
1657691515141,CSE 190,A00,092507,Dubnov; Shlomo,8,0,20,12
1657691521166,ECE 45,A01,083139,Congero; Spencer William,6,0,75,69
1657691527189,ECE 65,A50,083695,Saad; Andrew S,12,0,30,18
1657691527189,ECE 65,A51,095125,Saad; Andrew S,24,0,26,2
1657691533211,ECE 109,A01,091882,Touri; Behrouz,20,0,70,50
1657691539238,ECE 180,A00,083140,Abi Samra; Nicholas Camill,1,0,30,29
1657691539238,ECE 180,B00,083141,Abi Samra; Nicholas Camill,0,0,30,30
1657691545261,MATH 10A,A01,083735,Patchell; Gregory David,2,0,30,28
1657691545261,MATH 10A,A02,083736,Patchell; Gregory David,20,0,30,10
1657691545261,MATH 10A,A03,083737,Patchell; Gregory David,16,0,30,14
1657691551296,MATH 10B,A01,083207,Lim; Seonhee,8,0,34,26
1657691551296,MATH 10B,A02,083208,Lim; Seonhee,9,0,35,26
1657691551296,MATH 10B,A03,093472,Lim; Seonhee,7,0,34,27
1657691551296,MATH 10B,B01,083739,Sinha; Shubham,13,0,30,17
1657691557326,MATH 18,A01,083743,Cinel; Cameron Alexander,8,0,30,22
1657691557326,MATH 18,A02,083744,Cinel; Cameron Alexander,17,0,30,13
1657691557326,MATH 18,A03,083745,Cinel; Cameron Alexander,10,0,30,20
1657691557326,MATH 18,B01,083748,Rideout; David Porter,5,0,37,32
1657691557326,MATH 18,B02,083749,Rideout; David Porter,5,0,36,31
1657691557326,MATH 18,B03,083750,Rideout; David Porter,3,0,37,34
1657691557326,MATH 18,B04,083751,Rideout; David Porter,6,0,36,30
1657691557326,MATH 18,B05,093473,Rideout; David Porter,6,0,36,30
1657691557326,MATH 18,B06,093474,Rideout; David Porter,6,0,36,30
1657691563351,MATH 20A,A01,083754,Zheng; Zequn,14,0,40,26
1657691569373,MATH 20B,A01,083756,Briones; Jor-el Thomas Caparas,4,0,36,32
1657691569373,MATH 20B,A02,083757,Briones; Jor-el Thomas Caparas,1,0,36,35
1657691569373,MATH 20B,A03,093475,Briones; Jor-el Thomas Caparas,2,0,36,34
1657691575402,MATH 20C,A01,083760,Briones; Jor-el Thomas Caparas,1,0,35,34
1657691575402,MATH 20C,A02,083761,Briones; Jor-el Thomas Caparas,8,0,35,27
1657691575402,MATH 20C,A03,093476,Briones; Jor-el Thomas Caparas,0,1,36,36
1657691575402,MATH 20C,B01,083762,Bach; Quang Tran,1,0,30,29
1657691581442,MATH 20D,A01,083765,Tran; Brian Kha,5,0,30,25
1657691581442,MATH 20D,A02,083766,Tran; Brian Kha,5,0,30,25
1657691581442,MATH 20D,A03,083767,Tran; Brian Kha,5,0,30,25
1657691587465,MATH 20E,A01,083771,Ganguly; Soumya,9,0,32,23
1657691587465,MATH 20E,A02,083772,Ganguly; Soumya,6,0,32,26
1657691587465,MATH 20E,B01,083773,Ciotti; Benjamin,20,0,35,15
1657691587465,MATH 20E,B02,083774,Ciotti; Benjamin,18,0,35,17
1657691593489,MATH 103A,A01,083777,Greenfeld; Be'Eri,3,0,36,33
1657691593489,MATH 103A,A02,083778,Greenfeld; Be'Eri,5,0,36,31
1657691593489,MATH 103A,A03,093561,Greenfeld; Be'Eri,6,0,36,30
1657691593489,MATH 103A,B01,083779,Greenfeld; Be'Eri,7,0,36,29
1657691593489,MATH 103A,B02,083780,Greenfeld; Be'Eri,4,0,36,32
1657691593489,MATH 103A,B03,093562,Greenfeld; Be'Eri,3,0,36,33
1657691599512,MATH 105,A01,085443,Carter; Anne Toulson,15,0,35,20
1657691599512,MATH 105,A02,093477,Carter; Anne Toulson,20,0,35,15
1657691605540,MATH 109,A01,083213,Ganzberger; Geoffrey Michael,2,0,34,32
1657691605540,MATH 109,A02,083214,Ganzberger; Geoffrey Michael,4,0,34,30
1657691605540,MATH 109,A03,093478,Ganzberger; Geoffrey Michael,2,0,34,32
1657691605540,MATH 109,B01,083215,Ganzberger; Geoffrey Michael,1,0,32,31
1657691605540,MATH 109,B02,083216,Ganzberger; Geoffrey Michael,2,0,32,30
1657691605540,MATH 109,B03,093479,Ganzberger; Geoffrey Michael,8,0,32,24
1657691611571,MATH 142A,A01,083219,Chow; Bennett,7,0,32,25
1657691611571,MATH 142A,A02,083220,Chow; Bennett,10,0,32,22
1657691611571,MATH 142A,A03,093480,Chow; Bennett,9,0,32,23
1657691611571,MATH 142A,B03,093481,Chow; Bennett,8,0,32,24
1657691611571,MATH 142A,B04,093558,Chow; Bennett,13,0,32,19
1657691611571,MATH 142A,B05,093559,Chow; Bennett,6,0,32,26
1657691617594,MATH 193A,A01,083224,Rotar; Vladimir,8,0,34,26
1657691617594,MATH 193A,A02,083225,Rotar; Vladimir,9,0,34,25
1657691617594,MATH 193A,A03,083781,Rotar; Vladimir,5,0,34,29
1657691617594,MATH 193A,A04,083782,Rotar; Vladimir,10,0,34,24
1657691617594,MATH 193A,A05,093482,Rotar; Vladimir,10,0,34,24
1657691623616,MATH 197,001,091859,McAuley; Julian John,9999,0,9999,0
1657691623616,MATH 197,002,095566,Kedlaya; Kiran S.,9997,0,9999,2
1657691623616,MATH 197,003,095567,Xiao; Ming,9999,0,9999,0
1657691623616,MATH 197,004,095571,Perols; Johan Lars,9998,0,9999,1
1657691630669,COGS 9,A01,083615,Shannon; Kyle Michael,9,0,75,66
1657691636692,COGS 11,A01,083617,Boyle; Mary E. T.,23,0,48,25
1657691642720,COGS 13,A01,083071,Bastos; Amalia Pinkusfeld,11,0,71,60
1657691648746,COGS 14A,A01,092681,Semenuks; Arturs,5,1,100,95
1657691654770,COGS 14B,A01,083073,Cheng; Tzu-Han,6,0,63,57
1657691660806,COGS 17,A01,092677,Semenuks; Arturs,6,0,81,75
1657691666829,COGS 100,A01,083619,Allen; Michael Gordon,17,0,70,53
1657691672856,COGS 101A,A01,083621,Davis; Joshua Daniel,9,0,68,59
1657691678883,COGS 101B,A01,091572,Allen; Michael Gordon,12,0,65,53
1657691684908,COGS 101C,A01,083625,Delgado; Tania,17,0,35,18
1657691690931,COGS 107A,A01,083627,Boyle; Mary E. T.,13,0,60,47
1657691696963,COGS 118A,A01,083075,Gupta; Anjum,21,0,76,55
1657691702991,CSE 3,A50,083646,Miranda; Gregory Joseph,24,0,50,26
1657691709024,CSE 8A,A50,083650,Miranda; Gregory Joseph,17,1,56,39
1657691715050,CSE 11,A01,083080,Cao; Yingjun,6,15,40,34
1657691721080,CSE 12,A01,083652,Krause-Levy; Sophia Louisa,28,1,120,92
1657691727107,CSE 15L,A01,083654,Morris; Justin Loren,9,0,50,41
1657691727107,CSE 15L,A02,083655,Morris; Justin Loren,9,0,50,41
1657691733132,CSE 20,A01,083657,Tran; Khoa Dang,39,0,80,41
1657691739155,CSE 21,A01,095574,Bach; Quang Tran,22,0,48,26
1657691745178,CSE 30,A01,083084,Eldon; John,6,0,80,74
1657691745178,CSE 30,B01,095061,Bhaskar; Nishant,9,0,50,41
1657691751201,CSE 100,A01,083659,Cao; Yingjun,5,4,70,65
1657691757236,CSE 134B,A01,083661,Powell; Thomas Allan,23,0,100,77
1657691763260,CSE 140,A01,083663,Gungor; Onat,15,0,85,70
1657691769283,CSE 140L,A01,083088,Eldon; John,22,0,100,78
1657691775317,CSE 175,A01,083665,Kumar; Rakesh,3,0,25,22
1657691781340,CSE 190,A00,092507,Dubnov; Shlomo,8,0,20,12
1657691787362,ECE 45,A01,083139,Congero; Spencer William,6,0,75,69
1657691793389,ECE 65,A50,083695,Saad; Andrew S,12,0,30,18
1657691793389,ECE 65,A51,095125,Saad; Andrew S,24,0,26,2
1657691799412,ECE 109,A01,091882,Touri; Behrouz,20,0,70,50
1657691805436,ECE 180,A00,083140,Abi Samra; Nicholas Camill,1,0,30,29
1657691805436,ECE 180,B00,083141,Abi Samra; Nicholas Camill,0,0,30,30
1657691811463,MATH 10A,A01,083735,Patchell; Gregory David,2,0,30,28
1657691811463,MATH 10A,A02,083736,Patchell; Gregory David,20,0,30,10
1657691811463,MATH 10A,A03,083737,Patchell; Gregory David,16,0,30,14
1657691817489,MATH 10B,A01,083207,Lim; Seonhee,8,0,34,26
1657691817489,MATH 10B,A02,083208,Lim; Seonhee,9,0,35,26
1657691817489,MATH 10B,A03,093472,Lim; Seonhee,7,0,34,27
1657691817489,MATH 10B,B01,083739,Sinha; Shubham,13,0,30,17
1657691823512,MATH 18,A01,083743,Cinel; Cameron Alexander,8,0,30,22
1657691823512,MATH 18,A02,083744,Cinel; Cameron Alexander,17,0,30,13
1657691823512,MATH 18,A03,083745,Cinel; Cameron Alexander,10,0,30,20
1657691823512,MATH 18,B01,083748,Rideout; David Porter,5,0,37,32
1657691823512,MATH 18,B02,083749,Rideout; David Porter,5,0,36,31
1657691823512,MATH 18,B03,083750,Rideout; David Porter,3,0,37,34
1657691823512,MATH 18,B04,083751,Rideout; David Porter,6,0,36,30
1657691823512,MATH 18,B05,093473,Rideout; David Porter,6,0,36,30
1657691823512,MATH 18,B06,093474,Rideout; David Porter,6,0,36,30
1657691829541,MATH 20A,A01,083754,Zheng; Zequn,14,0,40,26
1657691835568,MATH 20B,A01,083756,Briones; Jor-el Thomas Caparas,4,0,36,32
1657691835568,MATH 20B,A02,083757,Briones; Jor-el Thomas Caparas,1,0,36,35
1657691835568,MATH 20B,A03,093475,Briones; Jor-el Thomas Caparas,2,0,36,34
1657691841597,MATH 20C,A01,083760,Briones; Jor-el Thomas Caparas,1,0,35,34
1657691841597,MATH 20C,A02,083761,Briones; Jor-el Thomas Caparas,8,0,35,27
1657691841597,MATH 20C,A03,093476,Briones; Jor-el Thomas Caparas,0,1,36,36
1657691841597,MATH 20C,B01,083762,Bach; Quang Tran,1,0,30,29
1657691847620,MATH 20D,A01,083765,Tran; Brian Kha,5,0,30,25
1657691847620,MATH 20D,A02,083766,Tran; Brian Kha,5,0,30,25
1657691847620,MATH 20D,A03,083767,Tran; Brian Kha,5,0,30,25
1657691853643,MATH 20E,A01,083771,Ganguly; Soumya,9,0,32,23
1657691853643,MATH 20E,A02,083772,Ganguly; Soumya,6,0,32,26
1657691853643,MATH 20E,B01,083773,Ciotti; Benjamin,20,0,35,15
1657691853643,MATH 20E,B02,083774,Ciotti; Benjamin,18,0,35,17
1657691859677,MATH 103A,A01,083777,Greenfeld; Be'Eri,3,0,36,33
1657691859677,MATH 103A,A02,083778,Greenfeld; Be'Eri,5,0,36,31
1657691859677,MATH 103A,A03,093561,Greenfeld; Be'Eri,6,0,36,30
1657691859677,MATH 103A,B01,083779,Greenfeld; Be'Eri,7,0,36,29
1657691859677,MATH 103A,B02,083780,Greenfeld; Be'Eri,4,0,36,32
1657691859677,MATH 103A,B03,093562,Greenfeld; Be'Eri,3,0,36,33
1657691865700,MATH 105,A01,085443,Carter; Anne Toulson,15,0,35,20
1657691865700,MATH 105,A02,093477,Carter; Anne Toulson,20,0,35,15
1657691871724,MATH 109,A01,083213,Ganzberger; Geoffrey Michael,2,0,34,32
1657691871724,MATH 109,A02,083214,Ganzberger; Geoffrey Michael,4,0,34,30
1657691871724,MATH 109,A03,093478,Ganzberger; Geoffrey Michael,2,0,34,32
1657691871724,MATH 109,B01,083215,Ganzberger; Geoffrey Michael,1,0,32,31
1657691871724,MATH 109,B02,083216,Ganzberger; Geoffrey Michael,2,0,32,30
1657691871724,MATH 109,B03,093479,Ganzberger; Geoffrey Michael,8,0,32,24
1657691877748,MATH 142A,A01,083219,Chow; Bennett,7,0,32,25
1657691877748,MATH 142A,A02,083220,Chow; Bennett,10,0,32,22
1657691877748,MATH 142A,A03,093480,Chow; Bennett,9,0,32,23
1657691877748,MATH 142A,B03,093481,Chow; Bennett,8,0,32,24
1657691877748,MATH 142A,B04,093558,Chow; Bennett,13,0,32,19
1657691877748,MATH 142A,B05,093559,Chow; Bennett,6,0,32,26
1657691883779,MATH 193A,A01,083224,Rotar; Vladimir,8,0,34,26
1657691883779,MATH 193A,A02,083225,Rotar; Vladimir,9,0,34,25
1657691883779,MATH 193A,A03,083781,Rotar; Vladimir,5,0,34,29
1657691883779,MATH 193A,A04,083782,Rotar; Vladimir,10,0,34,24
1657691883779,MATH 193A,A05,093482,Rotar; Vladimir,10,0,34,24
1657691889803,MATH 197,001,091859,McAuley; Julian John,9999,0,9999,0
1657691889803,MATH 197,002,095566,Kedlaya; Kiran S.,9997,0,9999,2
1657691889803,MATH 197,003,095567,Xiao; Ming,9999,0,9999,0
1657691889803,MATH 197,004,095571,Perols; Johan Lars,9998,0,9999,1
1657691896854,COGS 9,A01,083615,Shannon; Kyle Michael,9,0,75,66
1657691902877,COGS 11,A01,083617,Boyle; Mary E. T.,23,0,48,25
1657691908900,COGS 13,A01,083071,Bastos; Amalia Pinkusfeld,11,0,71,60
1657691914923,COGS 14A,A01,092681,Semenuks; Arturs,5,1,100,95
1657691920956,COGS 14B,A01,083073,Cheng; Tzu-Han,6,0,63,57
1657691926982,COGS 17,A01,092677,Semenuks; Arturs,6,0,81,75
1657691933010,COGS 100,A01,083619,Allen; Michael Gordon,17,0,70,53
1657691939048,COGS 101A,A01,083621,Davis; Joshua Daniel,9,0,68,59
1657691945071,COGS 101B,A01,091572,Allen; Michael Gordon,12,0,65,53
1657691951094,COGS 101C,A01,083625,Delgado; Tania,17,0,35,18
1657691957123,COGS 107A,A01,083627,Boyle; Mary E. T.,13,0,60,47
1657691963148,COGS 118A,A01,083075,Gupta; Anjum,21,0,76,55
1657691969176,CSE 3,A50,083646,Miranda; Gregory Joseph,24,0,50,26
1657691975272,CSE 8A,A50,083650,Miranda; Gregory Joseph,17,1,56,39
1657691981294,CSE 11,A01,083080,Cao; Yingjun,6,15,40,34
1657691987315,CSE 12,A01,083652,Krause-Levy; Sophia Louisa,28,1,120,92
1657691993344,CSE 15L,A01,083654,Morris; Justin Loren,9,0,50,41
1657691993344,CSE 15L,A02,083655,Morris; Justin Loren,9,0,50,41
1657691999372,CSE 20,A01,083657,Tran; Khoa Dang,39,0,80,41
1657692005409,CSE 21,A01,095574,Bach; Quang Tran,22,0,48,26
1657692011431,CSE 30,A01,083084,Eldon; John,6,0,80,74
1657692011431,CSE 30,B01,095061,Bhaskar; Nishant,9,0,50,41
1657692017461,CSE 100,A01,083659,Cao; Yingjun,5,4,70,65
1657692023486,CSE 134B,A01,083661,Powell; Thomas Allan,23,0,100,77
1657692029514,CSE 140,A01,083663,Gungor; Onat,15,0,85,70
1657692035542,CSE 140L,A01,083088,Eldon; John,22,0,100,78
1657692041566,CSE 175,A01,083665,Kumar; Rakesh,3,0,25,22
1657692047599,CSE 190,A00,092507,Dubnov; Shlomo,8,0,20,12
1657692053627,ECE 45,A01,083139,Congero; Spencer William,6,0,75,69
1657692059657,ECE 65,A50,083695,Saad; Andrew S,12,0,30,18
1657692059657,ECE 65,A51,095125,Saad; Andrew S,24,0,26,2
1657692065688,ECE 109,A01,091882,Touri; Behrouz,20,0,70,50
1657692071718,ECE 180,A00,083140,Abi Samra; Nicholas Camill,1,0,30,29
1657692071718,ECE 180,B00,083141,Abi Samra; Nicholas Camill,0,0,30,30
1657692077750,MATH 10A,A01,083735,Patchell; Gregory David,2,0,30,28
1657692077750,MATH 10A,A02,083736,Patchell; Gregory David,20,0,30,10
1657692077750,MATH 10A,A03,083737,Patchell; Gregory David,16,0,30,14
1657692083780,MATH 10B,A01,083207,Lim; Seonhee,8,0,34,26
1657692083780,MATH 10B,A02,083208,Lim; Seonhee,9,0,35,26
1657692083780,MATH 10B,A03,093472,Lim; Seonhee,7,0,34,27
1657692083780,MATH 10B,B01,083739,Sinha; Shubham,13,0,30,17
1657692089815,MATH 18,A01,083743,Cinel; Cameron Alexander,8,0,30,22
1657692089815,MATH 18,A02,083744,Cinel; Cameron Alexander,17,0,30,13
1657692089815,MATH 18,A03,083745,Cinel; Cameron Alexander,10,0,30,20
1657692089815,MATH 18,B01,083748,Rideout; David Porter,5,0,37,32
1657692089815,MATH 18,B02,083749,Rideout; David Porter,5,0,36,31
1657692089815,MATH 18,B03,083750,Rideout; David Porter,3,0,37,34
1657692089815,MATH 18,B04,083751,Rideout; David Porter,6,0,36,30
1657692089815,MATH 18,B05,093473,Rideout; David Porter,6,0,36,30
1657692089815,MATH 18,B06,093474,Rideout; David Porter,6,0,36,30
1657692095841,MATH 20A,A01,083754,Zheng; Zequn,14,0,40,26
1657692101867,MATH 20B,A01,083756,Briones; Jor-el Thomas Caparas,4,0,36,32
1657692101867,MATH 20B,A02,083757,Briones; Jor-el Thomas Caparas,1,0,36,35
1657692101867,MATH 20B,A03,093475,Briones; Jor-el Thomas Caparas,2,0,36,34
1657692107895,MATH 20C,A01,083760,Briones; Jor-el Thomas Caparas,1,0,35,34
1657692107895,MATH 20C,A02,083761,Briones; Jor-el Thomas Caparas,8,0,35,27
1657692107895,MATH 20C,A03,093476,Briones; Jor-el Thomas Caparas,0,1,36,36
1657692107895,MATH 20C,B01,083762,Bach; Quang Tran,1,0,30,29
1657692113920,MATH 20D,A01,083765,Tran; Brian Kha,5,0,30,25
1657692113920,MATH 20D,A02,083766,Tran; Brian Kha,5,0,30,25
1657692113920,MATH 20D,A03,083767,Tran; Brian Kha,5,0,30,25
1657692119950,MATH 20E,A01,083771,Ganguly; Soumya,9,0,32,23
1657692119950,MATH 20E,A02,083772,Ganguly; Soumya,6,0,32,26
1657692119950,MATH 20E,B01,083773,Ciotti; Benjamin,20,0,35,15
1657692119950,MATH 20E,B02,083774,Ciotti; Benjamin,18,0,35,17
1657692125975,MATH 103A,A01,083777,Greenfeld; Be'Eri,3,0,36,33
1657692125975,MATH 103A,A02,083778,Greenfeld; Be'Eri,5,0,36,31
1657692125975,MATH 103A,A03,093561,Greenfeld; Be'Eri,6,0,36,30
1657692125975,MATH 103A,B01,083779,Greenfeld; Be'Eri,7,0,36,29
1657692125975,MATH 103A,B02,083780,Greenfeld; Be'Eri,4,0,36,32
1657692125975,MATH 103A,B03,093562,Greenfeld; Be'Eri,3,0,36,33
1657692131999,MATH 105,A01,085443,Carter; Anne Toulson,15,0,35,20
1657692131999,MATH 105,A02,093477,Carter; Anne Toulson,20,0,35,15
1657692138035,MATH 109,A01,083213,Ganzberger; Geoffrey Michael,2,0,34,32
1657692138035,MATH 109,A02,083214,Ganzberger; Geoffrey Michael,4,0,34,30
1657692138035,MATH 109,A03,093478,Ganzberger; Geoffrey Michael,2,0,34,32
1657692138035,MATH 109,B01,083215,Ganzberger; Geoffrey Michael,1,0,32,31
1657692138035,MATH 109,B02,083216,Ganzberger; Geoffrey Michael,2,0,32,30
1657692138035,MATH 109,B03,093479,Ganzberger; Geoffrey Michael,8,0,32,24
1657692144061,MATH 142A,A01,083219,Chow; Bennett,7,0,32,25
1657692144061,MATH 142A,A02,083220,Chow; Bennett,10,0,32,22
1657692144061,MATH 142A,A03,093480,Chow; Bennett,9,0,32,23
1657692144061,MATH 142A,B03,093481,Chow; Bennett,8,0,32,24
1657692144061,MATH 142A,B04,093558,Chow; Bennett,13,0,32,19
1657692144061,MATH 142A,B05,093559,Chow; Bennett,6,0,32,26
1657692150090,MATH 193A,A01,083224,Rotar; Vladimir,8,0,34,26
1657692150090,MATH 193A,A02,083225,Rotar; Vladimir,9,0,34,25
1657692150090,MATH 193A,A03,083781,Rotar; Vladimir,5,0,34,29
1657692150090,MATH 193A,A04,083782,Rotar; Vladimir,10,0,34,24
1657692150090,MATH 193A,A05,093482,Rotar; Vladimir,10,0,34,24
1657692156117,MATH 197,001,091859,McAuley; Julian John,9999,0,9999,0
1657692156117,MATH 197,002,095566,Kedlaya; Kiran S.,9997,0,9999,2
1657692156117,MATH 197,003,095567,Xiao; Ming,9999,0,9999,0
1657692156117,MATH 197,004,095571,Perols; Johan Lars,9998,0,9999,1
1657692163173,COGS 9,A01,083615,Shannon; Kyle Michael,9,0,75,66
1657692169196,COGS 11,A01,083617,Boyle; Mary E. T.,23,0,48,25
1657692175223,COGS 13,A01,083071,Bastos; Amalia Pinkusfeld,11,0,71,60
1657692181246,COGS 14A,A01,092681,Semenuks; Arturs,5,1,100,95
1657692187270,COGS 14B,A01,083073,Cheng; Tzu-Han,6,0,63,57
1657692193293,COGS 17,A01,092677,Semenuks; Arturs,6,0,81,75
1657692199315,COGS 100,A01,083619,Allen; Michael Gordon,17,0,70,53
1657692205344,COGS 101A,A01,083621,Davis; Joshua Daniel,9,0,68,59
1657692211371,COGS 101B,A01,091572,Allen; Michael Gordon,12,0,65,53
1657692217406,COGS 101C,A01,083625,Delgado; Tania,17,0,35,18
1657692223436,COGS 107A,A01,083627,Boyle; Mary E. T.,13,0,60,47
1657692229459,COGS 118A,A01,083075,Gupta; Anjum,21,0,76,55
1657692235483,CSE 3,A50,083646,Miranda; Gregory Joseph,24,0,50,26
1657692241517,CSE 8A,A50,083650,Miranda; Gregory Joseph,17,1,56,39
1657692247543,CSE 11,A01,083080,Cao; Yingjun,6,15,40,34
1657692253572,CSE 12,A01,083652,Krause-Levy; Sophia Louisa,28,1,120,92
1657692259598,CSE 15L,A01,083654,Morris; Justin Loren,9,0,50,41
1657692259598,CSE 15L,A02,083655,Morris; Justin Loren,9,0,50,41
1657692265622,CSE 20,A01,083657,Tran; Khoa Dang,39,0,80,41
1657692271649,CSE 21,A01,095574,Bach; Quang Tran,22,0,48,26
1657692277672,CSE 30,A01,083084,Eldon; John,6,0,80,74
1657692277672,CSE 30,B01,095061,Bhaskar; Nishant,9,0,50,41
1657692283695,CSE 100,A01,083659,Cao; Yingjun,5,4,70,65
1657692289720,CSE 134B,A01,083661,Powell; Thomas Allan,23,0,100,77
1657692295741,CSE 140,A01,083663,Gungor; Onat,15,0,85,70
1657692301762,CSE 140L,A01,083088,Eldon; John,22,0,100,78
1657692307785,CSE 175,A01,083665,Kumar; Rakesh,3,0,25,22
1657692313808,CSE 190,A00,092507,Dubnov; Shlomo,8,0,20,12
1657692319834,ECE 45,A01,083139,Congero; Spencer William,6,0,75,69
1657692325858,ECE 65,A50,083695,Saad; Andrew S,12,0,30,18
1657692325858,ECE 65,A51,095125,Saad; Andrew S,24,0,26,2
1657692331889,ECE 109,A01,091882,Touri; Behrouz,20,0,70,50
1657692337910,ECE 180,A00,083140,Abi Samra; Nicholas Camill,1,0,30,29
1657692337910,ECE 180,B00,083141,Abi Samra; Nicholas Camill,0,0,30,30
1657692343941,MATH 10A,A01,083735,Patchell; Gregory David,2,0,30,28
1657692343941,MATH 10A,A02,083736,Patchell; Gregory David,20,0,30,10
1657692343941,MATH 10A,A03,083737,Patchell; Gregory David,16,0,30,14
1657692349973,MATH 10B,A01,083207,Lim; Seonhee,8,0,34,26
1657692349973,MATH 10B,A02,083208,Lim; Seonhee,9,0,35,26
1657692349973,MATH 10B,A03,093472,Lim; Seonhee,7,0,34,27
1657692349973,MATH 10B,B01,083739,Sinha; Shubham,13,0,30,17
1657692356008,MATH 18,A01,083743,Cinel; Cameron Alexander,8,0,30,22
1657692356008,MATH 18,A02,083744,Cinel; Cameron Alexander,17,0,30,13
1657692356008,MATH 18,A03,083745,Cinel; Cameron Alexander,10,0,30,20
1657692356008,MATH 18,B01,083748,Rideout; David Porter,5,0,37,32
1657692356008,MATH 18,B02,083749,Rideout; David Porter,5,0,36,31
1657692356008,MATH 18,B03,083750,Rideout; David Porter,3,0,37,34
1657692356008,MATH 18,B04,083751,Rideout; David Porter,6,0,36,30
1657692356008,MATH 18,B05,093473,Rideout; David Porter,6,0,36,30
1657692356008,MATH 18,B06,093474,Rideout; David Porter,6,0,36,30
1657692362031,MATH 20A,A01,083754,Zheng; Zequn,14,0,40,26
1657692368055,MATH 20B,A01,083756,Briones; Jor-el Thomas Caparas,4,0,36,32
1657692368055,MATH 20B,A02,083757,Briones; Jor-el Thomas Caparas,1,0,36,35
1657692368055,MATH 20B,A03,093475,Briones; Jor-el Thomas Caparas,2,0,36,34
1657692374079,MATH 20C,A01,083760,Briones; Jor-el Thomas Caparas,1,0,35,34
1657692374079,MATH 20C,A02,083761,Briones; Jor-el Thomas Caparas,8,0,35,27
1657692374079,MATH 20C,A03,093476,Briones; Jor-el Thomas Caparas,0,1,36,36
1657692374079,MATH 20C,B01,083762,Bach; Quang Tran,1,0,30,29
1657692380104,MATH 20D,A01,083765,Tran; Brian Kha,5,0,30,25
1657692380104,MATH 20D,A02,083766,Tran; Brian Kha,5,0,30,25
1657692380104,MATH 20D,A03,083767,Tran; Brian Kha,5,0,30,25
1657692386130,MATH 20E,A01,083771,Ganguly; Soumya,9,0,32,23
1657692386130,MATH 20E,A02,083772,Ganguly; Soumya,6,0,32,26
1657692386130,MATH 20E,B01,083773,Ciotti; Benjamin,20,0,35,15
1657692386130,MATH 20E,B02,083774,Ciotti; Benjamin,18,0,35,17
1657692392159,MATH 103A,A01,083777,Greenfeld; Be'Eri,3,0,36,33
1657692392159,MATH 103A,A02,083778,Greenfeld; Be'Eri,5,0,36,31
1657692392159,MATH 103A,A03,093561,Greenfeld; Be'Eri,6,0,36,30
1657692392159,MATH 103A,B01,083779,Greenfeld; Be'Eri,7,0,36,29
1657692392159,MATH 103A,B02,083780,Greenfeld; Be'Eri,4,0,36,32
1657692392159,MATH 103A,B03,093562,Greenfeld; Be'Eri,3,0,36,33
1657692398183,MATH 105,A01,085443,Carter; Anne Toulson,15,0,35,20
1657692398183,MATH 105,A02,093477,Carter; Anne Toulson,20,0,35,15
1657692404207,MATH 109,A01,083213,Ganzberger; Geoffrey Michael,2,0,34,32
1657692404207,MATH 109,A02,083214,Ganzberger; Geoffrey Michael,4,0,34,30
1657692404207,MATH 109,A03,093478,Ganzberger; Geoffrey Michael,2,0,34,32
1657692404207,MATH 109,B01,083215,Ganzberger; Geoffrey Michael,1,0,32,31
1657692404207,MATH 109,B02,083216,Ganzberger; Geoffrey Michael,2,0,32,30
1657692404207,MATH 109,B03,093479,Ganzberger; Geoffrey Michael,8,0,32,24
1657692410239,MATH 142A,A01,083219,Chow; Bennett,7,0,32,25
1657692410239,MATH 142A,A02,083220,Chow; Bennett,10,0,32,22
1657692410239,MATH 142A,A03,093480,Chow; Bennett,9,0,32,23
1657692410239,MATH 142A,B03,093481,Chow; Bennett,8,0,32,24
1657692410239,MATH 142A,B04,093558,Chow; Bennett,13,0,32,19
1657692410239,MATH 142A,B05,093559,Chow; Bennett,6,0,32,26
1657692416264,MATH 193A,A01,083224,Rotar; Vladimir,8,0,34,26
1657692416264,MATH 193A,A02,083225,Rotar; Vladimir,9,0,34,25
1657692416264,MATH 193A,A03,083781,Rotar; Vladimir,5,0,34,29
1657692416264,MATH 193A,A04,083782,Rotar; Vladimir,10,0,34,24
1657692416264,MATH 193A,A05,093482,Rotar; Vladimir,10,0,34,24
1657692422306,MATH 197,001,091859,McAuley; Julian John,9999,0,9999,0
1657692422306,MATH 197,002,095566,Kedlaya; Kiran S.,9997,0,9999,2
1657692422306,MATH 197,003,095567,Xiao; Ming,9999,0,9999,0
1657692422306,MATH 197,004,095571,Perols; Johan Lars,9998,0,9999,1
1657692429367,COGS 9,A01,083615,Shannon; Kyle Michael,9,0,75,66
1657692435390,COGS 11,A01,083617,Boyle; Mary E. T.,23,0,48,25
1657692441417,COGS 13,A01,083071,Bastos; Amalia Pinkusfeld,11,0,71,60
1657692447440,COGS 14A,A01,092681,Semenuks; Arturs,5,1,100,95
1657692453467,COGS 14B,A01,083073,Cheng; Tzu-Han,6,0,63,57
1657692459490,COGS 17,A01,092677,Semenuks; Arturs,6,0,81,75
1657692465513,COGS 100,A01,083619,Allen; Michael Gordon,17,0,70,53
1657692471537,COGS 101A,A01,083621,Davis; Joshua Daniel,9,0,68,59
1657692477564,COGS 101B,A01,091572,Allen; Michael Gordon,12,0,65,53
1657692483586,COGS 101C,A01,083625,Delgado; Tania,17,0,35,18
1657692489608,COGS 107A,A01,083627,Boyle; Mary E. T.,13,0,60,47
1657692495635,COGS 118A,A01,083075,Gupta; Anjum,21,0,76,55
1657692501662,CSE 3,A50,083646,Miranda; Gregory Joseph,24,0,50,26
1657692507686,CSE 8A,A50,083650,Miranda; Gregory Joseph,17,1,56,39
1657692513708,CSE 11,A01,083080,Cao; Yingjun,6,15,40,34
1657692519734,CSE 12,A01,083652,Krause-Levy; Sophia Louisa,28,1,120,92
1657692525759,CSE 15L,A01,083654,Morris; Justin Loren,9,0,50,41
1657692525759,CSE 15L,A02,083655,Morris; Justin Loren,9,0,50,41
1657692531782,CSE 20,A01,083657,Tran; Khoa Dang,39,0,80,41
1657692537806,CSE 21,A01,095574,Bach; Quang Tran,22,0,48,26
1657692543829,CSE 30,A01,083084,Eldon; John,6,0,80,74
1657692543829,CSE 30,B01,095061,Bhaskar; Nishant,9,0,50,41
1657692549856,CSE 100,A01,083659,Cao; Yingjun,5,4,70,65
1657692555882,CSE 134B,A01,083661,Powell; Thomas Allan,23,0,100,77
1657692561909,CSE 140,A01,083663,Gungor; Onat,15,0,85,70
1657692567933,CSE 140L,A01,083088,Eldon; John,22,0,100,78
1657692574030,CSE 175,A01,083665,Kumar; Rakesh,3,0,25,22
1657692580054,CSE 190,A00,092507,Dubnov; Shlomo,8,0,20,12
1657692586078,ECE 45,A01,083139,Congero; Spencer William,6,0,75,69
1657692592108,ECE 65,A50,083695,Saad; Andrew S,12,0,30,18
1657692592108,ECE 65,A51,095125,Saad; Andrew S,24,0,26,2
1657692598134,ECE 109,A01,091882,Touri; Behrouz,20,0,70,50
1657692604162,ECE 180,A00,083140,Abi Samra; Nicholas Camill,1,0,30,29
1657692604162,ECE 180,B00,083141,Abi Samra; Nicholas Camill,0,0,30,30
1657692610185,MATH 10A,A01,083735,Patchell; Gregory David,2,0,30,28
1657692610185,MATH 10A,A02,083736,Patchell; Gregory David,20,0,30,10
1657692610185,MATH 10A,A03,083737,Patchell; Gregory David,16,0,30,14
1657692616214,MATH 10B,A01,083207,Lim; Seonhee,8,0,34,26
1657692616214,MATH 10B,A02,083208,Lim; Seonhee,9,0,35,26
1657692616214,MATH 10B,A03,093472,Lim; Seonhee,7,0,34,27
1657692616214,MATH 10B,B01,083739,Sinha; Shubham,13,0,30,17
1657692622241,MATH 18,A01,083743,Cinel; Cameron Alexander,8,0,30,22
1657692622241,MATH 18,A02,083744,Cinel; Cameron Alexander,17,0,30,13
1657692622241,MATH 18,A03,083745,Cinel; Cameron Alexander,10,0,30,20
1657692622241,MATH 18,B01,083748,Rideout; David Porter,5,0,37,32
1657692622241,MATH 18,B02,083749,Rideout; David Porter,5,0,36,31
1657692622241,MATH 18,B03,083750,Rideout; David Porter,3,0,37,34
1657692622241,MATH 18,B04,083751,Rideout; David Porter,6,0,36,30
1657692622241,MATH 18,B05,093473,Rideout; David Porter,6,0,36,30
1657692622241,MATH 18,B06,093474,Rideout; David Porter,6,0,36,30
1657692628263,MATH 20A,A01,083754,Zheng; Zequn,14,0,40,26
1657692634292,MATH 20B,A01,083756,Briones; Jor-el Thomas Caparas,4,0,36,32
1657692634292,MATH 20B,A02,083757,Briones; Jor-el Thomas Caparas,1,0,36,35
1657692634292,MATH 20B,A03,093475,Briones; Jor-el Thomas Caparas,2,0,36,34
1657692640315,MATH 20C,A01,083760,Briones; Jor-el Thomas Caparas,1,0,35,34
1657692640315,MATH 20C,A02,083761,Briones; Jor-el Thomas Caparas,8,0,35,27
1657692640315,MATH 20C,A03,093476,Briones; Jor-el Thomas Caparas,0,1,36,36
1657692640315,MATH 20C,B01,083762,Bach; Quang Tran,1,0,30,29
1657692646338,MATH 20D,A01,083765,Tran; Brian Kha,5,0,30,25
1657692646338,MATH 20D,A02,083766,Tran; Brian Kha,5,0,30,25
1657692646338,MATH 20D,A03,083767,Tran; Brian Kha,5,0,30,25
1657692652362,MATH 20E,A01,083771,Ganguly; Soumya,9,0,32,23
1657692652362,MATH 20E,A02,083772,Ganguly; Soumya,6,0,32,26
1657692652362,MATH 20E,B01,083773,Ciotti; Benjamin,20,0,35,15
1657692652362,MATH 20E,B02,083774,Ciotti; Benjamin,18,0,35,17
1657692658391,MATH 103A,A01,083777,Greenfeld; Be'Eri,3,0,36,33
1657692658391,MATH 103A,A02,083778,Greenfeld; Be'Eri,5,0,36,31
1657692658391,MATH 103A,A03,093561,Greenfeld; Be'Eri,6,0,36,30
1657692658391,MATH 103A,B01,083779,Greenfeld; Be'Eri,7,0,36,29
1657692658391,MATH 103A,B02,083780,Greenfeld; Be'Eri,4,0,36,32
1657692658391,MATH 103A,B03,093562,Greenfeld; Be'Eri,3,0,36,33
1657692664418,MATH 105,A01,085443,Carter; Anne Toulson,15,0,35,20
1657692664418,MATH 105,A02,093477,Carter; Anne Toulson,20,0,35,15
1657692670449,MATH 109,A01,083213,Ganzberger; Geoffrey Michael,2,0,34,32
1657692670449,MATH 109,A02,083214,Ganzberger; Geoffrey Michael,4,0,34,30
1657692670449,MATH 109,A03,093478,Ganzberger; Geoffrey Michael,2,0,34,32
1657692670449,MATH 109,B01,083215,Ganzberger; Geoffrey Michael,1,0,32,31
1657692670449,MATH 109,B02,083216,Ganzberger; Geoffrey Michael,2,0,32,30
1657692670449,MATH 109,B03,093479,Ganzberger; Geoffrey Michael,8,0,32,24
1657692676474,MATH 142A,A01,083219,Chow; Bennett,7,0,32,25
1657692676474,MATH 142A,A02,083220,Chow; Bennett,10,0,32,22
1657692676474,MATH 142A,A03,093480,Chow; Bennett,9,0,32,23
1657692676474,MATH 142A,B03,093481,Chow; Bennett,8,0,32,24
1657692676474,MATH 142A,B04,093558,Chow; Bennett,13,0,32,19
1657692676474,MATH 142A,B05,093559,Chow; Bennett,6,0,32,26
1657692682504,MATH 193A,A01,083224,Rotar; Vladimir,8,0,34,26
1657692682504,MATH 193A,A02,083225,Rotar; Vladimir,9,0,34,25
1657692682504,MATH 193A,A03,083781,Rotar; Vladimir,5,0,34,29
1657692682504,MATH 193A,A04,083782,Rotar; Vladimir,10,0,34,24
1657692682504,MATH 193A,A05,093482,Rotar; Vladimir,10,0,34,24
1657692688528,MATH 197,001,091859,McAuley; Julian John,9999,0,9999,0
1657692688528,MATH 197,002,095566,Kedlaya; Kiran S.,9997,0,9999,2
1657692688528,MATH 197,003,095567,Xiao; Ming,9999,0,9999,0
1657692688528,MATH 197,004,095571,Perols; Johan Lars,9998,0,9999,1
1657692695579,COGS 9,A01,083615,Shannon; Kyle Michael,9,0,75,66
1657692701603,COGS 11,A01,083617,Boyle; Mary E. T.,23,0,48,25
1657692707631,COGS 13,A01,083071,Bastos; Amalia Pinkusfeld,11,0,71,60
1657692713657,COGS 14A,A01,092681,Semenuks; Arturs,5,1,100,95
1657692719684,COGS 14B,A01,083073,Cheng; Tzu-Han,6,0,63,57
1657692725707,COGS 17,A01,092677,Semenuks; Arturs,6,0,81,75
1657692731737,COGS 100,A01,083619,Allen; Michael Gordon,17,0,70,53
1657692737765,COGS 101A,A01,083621,Davis; Joshua Daniel,9,0,68,59
1657692743792,COGS 101B,A01,091572,Allen; Michael Gordon,12,0,65,53
1657692749815,COGS 101C,A01,083625,Delgado; Tania,17,0,35,18
1657692755844,COGS 107A,A01,083627,Boyle; Mary E. T.,13,0,60,47
1657692761871,COGS 118A,A01,083075,Gupta; Anjum,21,0,76,55
1657692767895,CSE 3,A50,083646,Miranda; Gregory Joseph,24,0,50,26
1657692773924,CSE 8A,A50,083650,Miranda; Gregory Joseph,17,1,56,39
1657692779951,CSE 11,A01,083080,Cao; Yingjun,6,15,40,34
1657692785975,CSE 12,A01,083652,Krause-Levy; Sophia Louisa,28,1,120,92
1657692791997,CSE 15L,A01,083654,Morris; Justin Loren,9,0,50,41
1657692791997,CSE 15L,A02,083655,Morris; Justin Loren,9,0,50,41
1657692798021,CSE 20,A01,083657,Tran; Khoa Dang,39,0,80,41
1657692804043,CSE 21,A01,095574,Bach; Quang Tran,22,0,48,26
1657692810071,CSE 30,A01,083084,Eldon; John,6,0,80,74
1657692810071,CSE 30,B01,095061,Bhaskar; Nishant,9,0,50,41
1657692816097,CSE 100,A01,083659,Cao; Yingjun,5,4,70,65
1657692822120,CSE 134B,A01,083661,Powell; Thomas Allan,23,0,100,77
1657692828146,CSE 140,A01,083663,Gungor; Onat,15,0,85,70
1657692834170,CSE 140L,A01,083088,Eldon; John,22,0,100,78
1657692840197,CSE 175,A01,083665,Kumar; Rakesh,3,0,25,22
1657692846221,CSE 190,A00,092507,Dubnov; Shlomo,8,0,20,12
1657692852248,ECE 45,A01,083139,Congero; Spencer William,6,0,75,69
1657692858275,ECE 65,A50,083695,Saad; Andrew S,12,0,30,18
1657692858275,ECE 65,A51,095125,Saad; Andrew S,24,0,26,2
1657692864302,ECE 109,A01,091882,Touri; Behrouz,20,0,70,50
1657692870326,ECE 180,A00,083140,Abi Samra; Nicholas Camill,1,0,30,29
1657692870326,ECE 180,B00,083141,Abi Samra; Nicholas Camill,0,0,30,30
1657692876350,MATH 10A,A01,083735,Patchell; Gregory David,2,0,30,28
1657692876350,MATH 10A,A02,083736,Patchell; Gregory David,20,0,30,10
1657692876350,MATH 10A,A03,083737,Patchell; Gregory David,16,0,30,14
1657692882376,MATH 10B,A01,083207,Lim; Seonhee,8,0,34,26
1657692882376,MATH 10B,A02,083208,Lim; Seonhee,9,0,35,26
1657692882376,MATH 10B,A03,093472,Lim; Seonhee,7,0,34,27
1657692882376,MATH 10B,B01,083739,Sinha; Shubham,13,0,30,17
1657692888400,MATH 18,A01,083743,Cinel; Cameron Alexander,8,0,30,22
1657692888400,MATH 18,A02,083744,Cinel; Cameron Alexander,17,0,30,13
1657692888400,MATH 18,A03,083745,Cinel; Cameron Alexander,10,0,30,20
1657692888400,MATH 18,B01,083748,Rideout; David Porter,5,0,37,32
1657692888400,MATH 18,B02,083749,Rideout; David Porter,5,0,36,31
1657692888400,MATH 18,B03,083750,Rideout; David Porter,3,0,37,34
1657692888400,MATH 18,B04,083751,Rideout; David Porter,6,0,36,30
1657692888400,MATH 18,B05,093473,Rideout; David Porter,6,0,36,30
1657692888400,MATH 18,B06,093474,Rideout; David Porter,6,0,36,30
1657692894427,MATH 20A,A01,083754,Zheng; Zequn,14,0,40,26
1657692900449,MATH 20B,A01,083756,Briones; Jor-el Thomas Caparas,4,0,36,32
1657692900449,MATH 20B,A02,083757,Briones; Jor-el Thomas Caparas,1,0,36,35
1657692900449,MATH 20B,A03,093475,Briones; Jor-el Thomas Caparas,2,0,36,34
1657692906479,MATH 20C,A01,083760,Briones; Jor-el Thomas Caparas,1,0,35,34
1657692906479,MATH 20C,A02,083761,Briones; Jor-el Thomas Caparas,8,0,35,27
1657692906479,MATH 20C,A03,093476,Briones; Jor-el Thomas Caparas,0,1,36,36
1657692906479,MATH 20C,B01,083762,Bach; Quang Tran,1,0,30,29
1657692912502,MATH 20D,A01,083765,Tran; Brian Kha,5,0,30,25
1657692912502,MATH 20D,A02,083766,Tran; Brian Kha,5,0,30,25
1657692912502,MATH 20D,A03,083767,Tran; Brian Kha,5,0,30,25
1657692918531,MATH 20E,A01,083771,Ganguly; Soumya,9,0,32,23
1657692918531,MATH 20E,A02,083772,Ganguly; Soumya,6,0,32,26
1657692918531,MATH 20E,B01,083773,Ciotti; Benjamin,20,0,35,15
1657692918531,MATH 20E,B02,083774,Ciotti; Benjamin,18,0,35,17
1657692924556,MATH 103A,A01,083777,Greenfeld; Be'Eri,3,0,36,33
1657692924556,MATH 103A,A02,083778,Greenfeld; Be'Eri,5,0,36,31
1657692924556,MATH 103A,A03,093561,Greenfeld; Be'Eri,6,0,36,30
1657692924556,MATH 103A,B01,083779,Greenfeld; Be'Eri,7,0,36,29
1657692924556,MATH 103A,B02,083780,Greenfeld; Be'Eri,4,0,36,32
1657692924556,MATH 103A,B03,093562,Greenfeld; Be'Eri,3,0,36,33
1657692930584,MATH 105,A01,085443,Carter; Anne Toulson,15,0,35,20
1657692930584,MATH 105,A02,093477,Carter; Anne Toulson,20,0,35,15
1657692936607,MATH 109,A01,083213,Ganzberger; Geoffrey Michael,2,0,34,32
1657692936607,MATH 109,A02,083214,Ganzberger; Geoffrey Michael,4,0,34,30
1657692936607,MATH 109,A03,093478,Ganzberger; Geoffrey Michael,2,0,34,32
1657692936607,MATH 109,B01,083215,Ganzberger; Geoffrey Michael,1,0,32,31
1657692936607,MATH 109,B02,083216,Ganzberger; Geoffrey Michael,2,0,32,30
1657692936607,MATH 109,B03,093479,Ganzberger; Geoffrey Michael,8,0,32,24
1657692942632,MATH 142A,A01,083219,Chow; Bennett,7,0,32,25
1657692942632,MATH 142A,A02,083220,Chow; Bennett,10,0,32,22
1657692942632,MATH 142A,A03,093480,Chow; Bennett,9,0,32,23
1657692942632,MATH 142A,B03,093481,Chow; Bennett,8,0,32,24
1657692942632,MATH 142A,B04,093558,Chow; Bennett,13,0,32,19
1657692942632,MATH 142A,B05,093559,Chow; Bennett,6,0,32,26
1657692948655,MATH 193A,A01,083224,Rotar; Vladimir,8,0,34,26
1657692948655,MATH 193A,A02,083225,Rotar; Vladimir,9,0,34,25
1657692948655,MATH 193A,A03,083781,Rotar; Vladimir,5,0,34,29
1657692948655,MATH 193A,A04,083782,Rotar; Vladimir,10,0,34,24
1657692948655,MATH 193A,A05,093482,Rotar; Vladimir,10,0,34,24
1657692954678,MATH 197,001,091859,McAuley; Julian John,9999,0,9999,0
1657692954678,MATH 197,002,095566,Kedlaya; Kiran S.,9997,0,9999,2
1657692954678,MATH 197,003,095567,Xiao; Ming,9999,0,9999,0
1657692954678,MATH 197,004,095571,Perols; Johan Lars,9998,0,9999,1
1657692961731,COGS 9,A01,083615,Shannon; Kyle Michael,9,0,75,66
1657692967755,COGS 11,A01,083617,Boyle; Mary E. T.,23,0,48,25
1657692973777,COGS 13,A01,083071,Bastos; Amalia Pinkusfeld,11,0,71,60
1657692979805,COGS 14A,A01,092681,Semenuks; Arturs,5,1,100,95
1657692985832,COGS 14B,A01,083073,Cheng; Tzu-Han,6,0,63,57
1657692991859,COGS 17,A01,092677,Semenuks; Arturs,6,0,81,75
1657692997885,COGS 100,A01,083619,Allen; Michael Gordon,17,0,70,53
1657693003910,COGS 101A,A01,083621,Davis; Joshua Daniel,9,0,68,59
1657693009934,COGS 101B,A01,091572,Allen; Michael Gordon,12,0,65,53
1657693015958,COGS 101C,A01,083625,Delgado; Tania,17,0,35,18
1657693021981,COGS 107A,A01,083627,Boyle; Mary E. T.,13,0,60,47
1657693028003,COGS 118A,A01,083075,Gupta; Anjum,21,0,76,55
1657693034032,CSE 3,A50,083646,Miranda; Gregory Joseph,24,0,50,26
1657693040062,CSE 8A,A50,083650,Miranda; Gregory Joseph,17,1,56,39
1657693046090,CSE 11,A01,083080,Cao; Yingjun,6,15,40,34
1657693052117,CSE 12,A01,083652,Krause-Levy; Sophia Louisa,28,1,120,92
1657693058141,CSE 15L,A01,083654,Morris; Justin Loren,9,0,50,41
1657693058141,CSE 15L,A02,083655,Morris; Justin Loren,9,0,50,41
1657693064169,CSE 20,A01,083657,Tran; Khoa Dang,39,0,80,41
1657693070193,CSE 21,A01,095574,Bach; Quang Tran,22,0,48,26
1657693076223,CSE 30,A01,083084,Eldon; John,6,0,80,74
1657693076223,CSE 30,B01,095061,Bhaskar; Nishant,9,0,50,41
1657693082250,CSE 100,A01,083659,Cao; Yingjun,5,4,70,65
1657693088278,CSE 134B,A01,083661,Powell; Thomas Allan,23,0,100,77
1657693094300,CSE 140,A01,083663,Gungor; Onat,15,0,85,70
1657693100325,CSE 140L,A01,083088,Eldon; John,22,0,100,78
1657693106348,CSE 175,A01,083665,Kumar; Rakesh,3,0,25,22
1657693112379,CSE 190,A00,092507,Dubnov; Shlomo,8,0,20,12
1657693118405,ECE 45,A01,083139,Congero; Spencer William,6,0,75,69
1657693124429,ECE 65,A50,083695,Saad; Andrew S,12,0,30,18
1657693124429,ECE 65,A51,095125,Saad; Andrew S,24,0,26,2
1657693130452,ECE 109,A01,091882,Touri; Behrouz,20,0,70,50
1657693136484,ECE 180,A00,083140,Abi Samra; Nicholas Camill,1,0,30,29
1657693136484,ECE 180,B00,083141,Abi Samra; Nicholas Camill,0,0,30,30
1657693142506,MATH 10A,A01,083735,Patchell; Gregory David,2,0,30,28
1657693142506,MATH 10A,A02,083736,Patchell; Gregory David,20,0,30,10
1657693142506,MATH 10A,A03,083737,Patchell; Gregory David,16,0,30,14
1657693148537,MATH 10B,A01,083207,Lim; Seonhee,8,0,34,26
1657693148537,MATH 10B,A02,083208,Lim; Seonhee,9,0,35,26
1657693148537,MATH 10B,A03,093472,Lim; Seonhee,7,0,34,27
1657693148537,MATH 10B,B01,083739,Sinha; Shubham,13,0,30,17
1657693154569,MATH 18,A01,083743,Cinel; Cameron Alexander,8,0,30,22
1657693154569,MATH 18,A02,083744,Cinel; Cameron Alexander,17,0,30,13
1657693154569,MATH 18,A03,083745,Cinel; Cameron Alexander,10,0,30,20
1657693154569,MATH 18,B01,083748,Rideout; David Porter,5,0,37,32
1657693154569,MATH 18,B02,083749,Rideout; David Porter,5,0,36,31
1657693154569,MATH 18,B03,083750,Rideout; David Porter,3,0,37,34
1657693154569,MATH 18,B04,083751,Rideout; David Porter,6,0,36,30
1657693154569,MATH 18,B05,093473,Rideout; David Porter,6,0,36,30
1657693154569,MATH 18,B06,093474,Rideout; David Porter,6,0,36,30
1657693160593,MATH 20A,A01,083754,Zheng; Zequn,14,0,40,26
1657693166617,MATH 20B,A01,083756,Briones; Jor-el Thomas Caparas,4,0,36,32
1657693166617,MATH 20B,A02,083757,Briones; Jor-el Thomas Caparas,1,0,36,35
1657693166617,MATH 20B,A03,093475,Briones; Jor-el Thomas Caparas,2,0,36,34
1657693172739,MATH 20C,A01,083760,Briones; Jor-el Thomas Caparas,1,0,35,34
1657693172739,MATH 20C,A02,083761,Briones; Jor-el Thomas Caparas,8,0,35,27
1657693172739,MATH 20C,A03,093476,Briones; Jor-el Thomas Caparas,0,1,36,36
1657693172739,MATH 20C,B01,083762,Bach; Quang Tran,1,0,30,29
1657693178764,MATH 20D,A01,083765,Tran; Brian Kha,5,0,30,25
1657693178764,MATH 20D,A02,083766,Tran; Brian Kha,5,0,30,25
1657693178764,MATH 20D,A03,083767,Tran; Brian Kha,5,0,30,25
1657693184794,MATH 20E,A01,083771,Ganguly; Soumya,9,0,32,23
1657693184794,MATH 20E,A02,083772,Ganguly; Soumya,6,0,32,26
1657693184794,MATH 20E,B01,083773,Ciotti; Benjamin,20,0,35,15
1657693184794,MATH 20E,B02,083774,Ciotti; Benjamin,18,0,35,17
1657693190824,MATH 103A,A01,083777,Greenfeld; Be'Eri,3,0,36,33
1657693190824,MATH 103A,A02,083778,Greenfeld; Be'Eri,5,0,36,31
1657693190824,MATH 103A,A03,093561,Greenfeld; Be'Eri,6,0,36,30
1657693190824,MATH 103A,B01,083779,Greenfeld; Be'Eri,7,0,36,29
1657693190824,MATH 103A,B02,083780,Greenfeld; Be'Eri,4,0,36,32
1657693190824,MATH 103A,B03,093562,Greenfeld; Be'Eri,3,0,36,33
1657693196846,MATH 105,A01,085443,Carter; Anne Toulson,15,0,35,20
1657693196846,MATH 105,A02,093477,Carter; Anne Toulson,20,0,35,15
1657693202878,MATH 109,A01,083213,Ganzberger; Geoffrey Michael,2,0,34,32
1657693202878,MATH 109,A02,083214,Ganzberger; Geoffrey Michael,4,0,34,30
1657693202878,MATH 109,A03,093478,Ganzberger; Geoffrey Michael,2,0,34,32
1657693202878,MATH 109,B01,083215,Ganzberger; Geoffrey Michael,1,0,32,31
1657693202878,MATH 109,B02,083216,Ganzberger; Geoffrey Michael,2,0,32,30
1657693202878,MATH 109,B03,093479,Ganzberger; Geoffrey Michael,8,0,32,24
1657693208904,MATH 142A,A01,083219,Chow; Bennett,7,0,32,25
1657693208904,MATH 142A,A02,083220,Chow; Bennett,10,0,32,22
1657693208904,MATH 142A,A03,093480,Chow; Bennett,9,0,32,23
1657693208904,MATH 142A,B03,093481,Chow; Bennett,8,0,32,24
1657693208904,MATH 142A,B04,093558,Chow; Bennett,13,0,32,19
1657693208904,MATH 142A,B05,093559,Chow; Bennett,6,0,32,26
1657693214931,MATH 193A,A01,083224,Rotar; Vladimir,8,0,34,26
1657693214931,MATH 193A,A02,083225,Rotar; Vladimir,9,0,34,25
1657693214931,MATH 193A,A03,083781,Rotar; Vladimir,5,0,34,29
1657693214931,MATH 193A,A04,083782,Rotar; Vladimir,10,0,34,24
1657693214931,MATH 193A,A05,093482,Rotar; Vladimir,10,0,34,24
1657693220957,MATH 197,001,091859,McAuley; Julian John,9999,0,9999,0
1657693220957,MATH 197,002,095566,Kedlaya; Kiran S.,9997,0,9999,2
1657693220957,MATH 197,003,095567,Xiao; Ming,9999,0,9999,0
1657693220957,MATH 197,004,095571,Perols; Johan Lars,9998,0,9999,1
1657693228028,COGS 9,A01,083615,Shannon; Kyle Michael,9,0,75,66
1657693234051,COGS 11,A01,083617,Boyle; Mary E. T.,23,0,48,25
1657693240075,COGS 13,A01,083071,Bastos; Amalia Pinkusfeld,11,0,71,60
1657693246102,COGS 14A,A01,092681,Semenuks; Arturs,5,1,100,95
1657693252144,COGS 14B,A01,083073,Cheng; Tzu-Han,6,0,63,57
1657693258168,COGS 17,A01,092677,Semenuks; Arturs,6,0,81,75
1657693264196,COGS 100,A01,083619,Allen; Michael Gordon,17,0,70,53
1657693270218,COGS 101A,A01,083621,Davis; Joshua Daniel,9,0,68,59
1657693276245,COGS 101B,A01,091572,Allen; Michael Gordon,12,0,65,53
1657693282272,COGS 101C,A01,083625,Delgado; Tania,17,0,35,18
1657693288296,COGS 107A,A01,083627,Boyle; Mary E. T.,13,0,60,47
1657693294319,COGS 118A,A01,083075,Gupta; Anjum,21,0,76,55
1657693300344,CSE 3,A50,083646,Miranda; Gregory Joseph,24,0,50,26
1657693306370,CSE 8A,A50,083650,Miranda; Gregory Joseph,17,1,56,39
1657693312396,CSE 11,A01,083080,Cao; Yingjun,6,15,40,34
1657693318424,CSE 12,A01,083652,Krause-Levy; Sophia Louisa,28,1,120,92
1657693324451,CSE 15L,A01,083654,Morris; Justin Loren,9,0,50,41
1657693324451,CSE 15L,A02,083655,Morris; Justin Loren,9,0,50,41
1657693330474,CSE 20,A01,083657,Tran; Khoa Dang,39,0,80,41
1657693336499,CSE 21,A01,095574,Bach; Quang Tran,22,0,48,26
1657693342524,CSE 30,A01,083084,Eldon; John,6,0,80,74
1657693342524,CSE 30,B01,095061,Bhaskar; Nishant,9,0,50,41
1657693348548,CSE 100,A01,083659,Cao; Yingjun,5,4,70,65
1657693354577,CSE 134B,A01,083661,Powell; Thomas Allan,23,0,100,77
1657693360599,CSE 140,A01,083663,Gungor; Onat,15,0,85,70
1657693366626,CSE 140L,A01,083088,Eldon; John,22,0,100,78
1657693372653,CSE 175,A01,083665,Kumar; Rakesh,3,0,25,22
1657693378682,CSE 190,A00,092507,Dubnov; Shlomo,8,0,20,12
1657693384704,ECE 45,A01,083139,Congero; Spencer William,6,0,75,69
1657693390727,ECE 65,A50,083695,Saad; Andrew S,12,0,30,18
1657693390727,ECE 65,A51,095125,Saad; Andrew S,24,0,26,2
1657693396753,ECE 109,A01,091882,Touri; Behrouz,20,0,70,50
1657693402776,ECE 180,A00,083140,Abi Samra; Nicholas Camill,1,0,30,29
1657693402776,ECE 180,B00,083141,Abi Samra; Nicholas Camill,0,0,30,30
1657693408800,MATH 10A,A01,083735,Patchell; Gregory David,2,0,30,28
1657693408800,MATH 10A,A02,083736,Patchell; Gregory David,20,0,30,10
1657693408800,MATH 10A,A03,083737,Patchell; Gregory David,16,0,30,14
1657693414825,MATH 10B,A01,083207,Lim; Seonhee,8,0,34,26
1657693414825,MATH 10B,A02,083208,Lim; Seonhee,9,0,35,26
1657693414825,MATH 10B,A03,093472,Lim; Seonhee,7,0,34,27
1657693414825,MATH 10B,B01,083739,Sinha; Shubham,13,0,30,17
1657693420849,MATH 18,A01,083743,Cinel; Cameron Alexander,8,0,30,22
1657693420849,MATH 18,A02,083744,Cinel; Cameron Alexander,17,0,30,13
1657693420849,MATH 18,A03,083745,Cinel; Cameron Alexander,10,0,30,20
1657693420849,MATH 18,B01,083748,Rideout; David Porter,5,0,37,32
1657693420849,MATH 18,B02,083749,Rideout; David Porter,5,0,36,31
1657693420849,MATH 18,B03,083750,Rideout; David Porter,3,0,37,34
1657693420849,MATH 18,B04,083751,Rideout; David Porter,6,0,36,30
1657693420849,MATH 18,B05,093473,Rideout; David Porter,6,0,36,30
1657693420849,MATH 18,B06,093474,Rideout; David Porter,6,0,36,30
1657693426872,MATH 20A,A01,083754,Zheng; Zequn,14,0,40,26
1657693432895,MATH 20B,A01,083756,Briones; Jor-el Thomas Caparas,4,0,36,32
1657693432895,MATH 20B,A02,083757,Briones; Jor-el Thomas Caparas,1,0,36,35
1657693432895,MATH 20B,A03,093475,Briones; Jor-el Thomas Caparas,2,0,36,34
1657693438928,MATH 20C,A01,083760,Briones; Jor-el Thomas Caparas,1,0,35,34
1657693438928,MATH 20C,A02,083761,Briones; Jor-el Thomas Caparas,8,0,35,27
1657693438928,MATH 20C,A03,093476,Briones; Jor-el Thomas Caparas,0,1,36,36
1657693438928,MATH 20C,B01,083762,Bach; Quang Tran,1,0,30,29
1657693444952,MATH 20D,A01,083765,Tran; Brian Kha,5,0,30,25
1657693444952,MATH 20D,A02,083766,Tran; Brian Kha,5,0,30,25
1657693444952,MATH 20D,A03,083767,Tran; Brian Kha,5,0,30,25
1657693450980,MATH 20E,A01,083771,Ganguly; Soumya,9,0,32,23
1657693450980,MATH 20E,A02,083772,Ganguly; Soumya,6,0,32,26
1657693450980,MATH 20E,B01,083773,Ciotti; Benjamin,20,0,35,15
1657693450980,MATH 20E,B02,083774,Ciotti; Benjamin,18,0,35,17
1657693457002,MATH 103A,A01,083777,Greenfeld; Be'Eri,3,0,36,33
1657693457002,MATH 103A,A02,083778,Greenfeld; Be'Eri,5,0,36,31
1657693457002,MATH 103A,A03,093561,Greenfeld; Be'Eri,6,0,36,30
1657693457002,MATH 103A,B01,083779,Greenfeld; Be'Eri,7,0,36,29
1657693457002,MATH 103A,B02,083780,Greenfeld; Be'Eri,4,0,36,32
1657693457002,MATH 103A,B03,093562,Greenfeld; Be'Eri,3,0,36,33
1657693463031,MATH 105,A01,085443,Carter; Anne Toulson,15,0,35,20
1657693463031,MATH 105,A02,093477,Carter; Anne Toulson,20,0,35,15
1657693469057,MATH 109,A01,083213,Ganzberger; Geoffrey Michael,2,0,34,32
1657693469057,MATH 109,A02,083214,Ganzberger; Geoffrey Michael,4,0,34,30
1657693469057,MATH 109,A03,093478,Ganzberger; Geoffrey Michael,2,0,34,32
1657693469057,MATH 109,B01,083215,Ganzberger; Geoffrey Michael,1,0,32,31
1657693469057,MATH 109,B02,083216,Ganzberger; Geoffrey Michael,2,0,32,30
1657693469057,MATH 109,B03,093479,Ganzberger; Geoffrey Michael,8,0,32,24
1657693475088,MATH 142A,A01,083219,Chow; Bennett,7,0,32,25
1657693475088,MATH 142A,A02,083220,Chow; Bennett,10,0,32,22
1657693475088,MATH 142A,A03,093480,Chow; Bennett,9,0,32,23
1657693475088,MATH 142A,B03,093481,Chow; Bennett,8,0,32,24
1657693475088,MATH 142A,B04,093558,Chow; Bennett,13,0,32,19
1657693475088,MATH 142A,B05,093559,Chow; Bennett,6,0,32,26
1657693481111,MATH 193A,A01,083224,Rotar; Vladimir,8,0,34,26
1657693481111,MATH 193A,A02,083225,Rotar; Vladimir,9,0,34,25
1657693481111,MATH 193A,A03,083781,Rotar; Vladimir,5,0,34,29
1657693481111,MATH 193A,A04,083782,Rotar; Vladimir,10,0,34,24
1657693481111,MATH 193A,A05,093482,Rotar; Vladimir,10,0,34,24
1657693487133,MATH 197,001,091859,McAuley; Julian John,9999,0,9999,0
1657693487133,MATH 197,002,095566,Kedlaya; Kiran S.,9997,0,9999,2
1657693487133,MATH 197,003,095567,Xiao; Ming,9999,0,9999,0
1657693487133,MATH 197,004,095571,Perols; Johan Lars,9998,0,9999,1
1657693494182,COGS 9,A01,083615,Shannon; Kyle Michael,9,0,75,66
1657693500206,COGS 11,A01,083617,Boyle; Mary E. T.,23,0,48,25
1657693506233,COGS 13,A01,083071,Bastos; Amalia Pinkusfeld,11,0,71,60
1657693512258,COGS 14A,A01,092681,Semenuks; Arturs,5,1,100,95
1657693518281,COGS 14B,A01,083073,Cheng; Tzu-Han,6,0,63,57
1657693524306,COGS 17,A01,092677,Semenuks; Arturs,6,0,81,75
1657693530330,COGS 100,A01,083619,Allen; Michael Gordon,17,0,70,53
1657693536356,COGS 101A,A01,083621,Davis; Joshua Daniel,9,0,68,59
1657693542381,COGS 101B,A01,091572,Allen; Michael Gordon,12,0,65,53
1657693548407,COGS 101C,A01,083625,Delgado; Tania,17,0,35,18
1657693554429,COGS 107A,A01,083627,Boyle; Mary E. T.,13,0,60,47
1657693560452,COGS 118A,A01,083075,Gupta; Anjum,21,0,76,55
1657693566484,CSE 3,A50,083646,Miranda; Gregory Joseph,24,0,50,26
1657693572508,CSE 8A,A50,083650,Miranda; Gregory Joseph,17,1,56,39
1657693578531,CSE 11,A01,083080,Cao; Yingjun,6,15,40,34
1657693584567,CSE 12,A01,083652,Krause-Levy; Sophia Louisa,28,1,120,92
1657693590593,CSE 15L,A01,083654,Morris; Justin Loren,9,0,50,41
1657693590593,CSE 15L,A02,083655,Morris; Justin Loren,9,0,50,41
1657693596617,CSE 20,A01,083657,Tran; Khoa Dang,39,0,80,41
1657693602643,CSE 21,A01,095574,Bach; Quang Tran,22,0,48,26
1657693608681,CSE 30,A01,083084,Eldon; John,6,0,80,74
1657693608681,CSE 30,B01,095061,Bhaskar; Nishant,9,0,50,41
1657693614707,CSE 100,A01,083659,Cao; Yingjun,5,4,70,65
1657693620734,CSE 134B,A01,083661,Powell; Thomas Allan,23,0,100,77
1657693626758,CSE 140,A01,083663,Gungor; Onat,15,0,85,70
1657693632784,CSE 140L,A01,083088,Eldon; John,22,0,100,78
1657693638809,CSE 175,A01,083665,Kumar; Rakesh,3,0,25,22
1657693644838,CSE 190,A00,092507,Dubnov; Shlomo,8,0,20,12
1657693650865,ECE 45,A01,083139,Congero; Spencer William,6,0,75,69
1657693656890,ECE 65,A50,083695,Saad; Andrew S,12,0,30,18
1657693656890,ECE 65,A51,095125,Saad; Andrew S,24,0,26,2
1657693662917,ECE 109,A01,091882,Touri; Behrouz,20,0,70,50
1657693668944,ECE 180,A00,083140,Abi Samra; Nicholas Camill,1,0,30,29
1657693668944,ECE 180,B00,083141,Abi Samra; Nicholas Camill,0,0,30,30
1657693674972,MATH 10A,A01,083735,Patchell; Gregory David,2,0,30,28
1657693674972,MATH 10A,A02,083736,Patchell; Gregory David,20,0,30,10
1657693674972,MATH 10A,A03,083737,Patchell; Gregory David,16,0,30,14
1657693681009,MATH 10B,A01,083207,Lim; Seonhee,8,0,34,26
1657693681009,MATH 10B,A02,083208,Lim; Seonhee,9,0,35,26
1657693681009,MATH 10B,A03,093472,Lim; Seonhee,7,0,34,27
1657693681009,MATH 10B,B01,083739,Sinha; Shubham,13,0,30,17
1657693687033,MATH 18,A01,083743,Cinel; Cameron Alexander,8,0,30,22
1657693687033,MATH 18,A02,083744,Cinel; Cameron Alexander,17,0,30,13
1657693687033,MATH 18,A03,083745,Cinel; Cameron Alexander,10,0,30,20
1657693687033,MATH 18,B01,083748,Rideout; David Porter,5,0,37,32
1657693687033,MATH 18,B02,083749,Rideout; David Porter,5,0,36,31
1657693687033,MATH 18,B03,083750,Rideout; David Porter,3,0,37,34
1657693687033,MATH 18,B04,083751,Rideout; David Porter,6,0,36,30
1657693687033,MATH 18,B05,093473,Rideout; David Porter,6,0,36,30
1657693687033,MATH 18,B06,093474,Rideout; David Porter,6,0,36,30
1657693693055,MATH 20A,A01,083754,Zheng; Zequn,14,0,40,26
1657693699083,MATH 20B,A01,083756,Briones; Jor-el Thomas Caparas,4,0,36,32
1657693699083,MATH 20B,A02,083757,Briones; Jor-el Thomas Caparas,1,0,36,35
1657693699083,MATH 20B,A03,093475,Briones; Jor-el Thomas Caparas,2,0,36,34
1657693705114,MATH 20C,A01,083760,Briones; Jor-el Thomas Caparas,1,0,35,34
1657693705114,MATH 20C,A02,083761,Briones; Jor-el Thomas Caparas,8,0,35,27
1657693705114,MATH 20C,A03,093476,Briones; Jor-el Thomas Caparas,0,1,36,36
1657693705114,MATH 20C,B01,083762,Bach; Quang Tran,1,0,30,29
1657693711139,MATH 20D,A01,083765,Tran; Brian Kha,5,0,30,25
1657693711139,MATH 20D,A02,083766,Tran; Brian Kha,5,0,30,25
1657693711139,MATH 20D,A03,083767,Tran; Brian Kha,5,0,30,25
1657693717168,MATH 20E,A01,083771,Ganguly; Soumya,9,0,32,23
1657693717168,MATH 20E,A02,083772,Ganguly; Soumya,6,0,32,26
1657693717168,MATH 20E,B01,083773,Ciotti; Benjamin,20,0,35,15
1657693717168,MATH 20E,B02,083774,Ciotti; Benjamin,18,0,35,17
1657693723218,MATH 103A,A01,083777,Greenfeld; Be'Eri,3,0,36,33
1657693723218,MATH 103A,A02,083778,Greenfeld; Be'Eri,5,0,36,31
1657693723218,MATH 103A,A03,093561,Greenfeld; Be'Eri,6,0,36,30
1657693723218,MATH 103A,B01,083779,Greenfeld; Be'Eri,7,0,36,29
1657693723218,MATH 103A,B02,083780,Greenfeld; Be'Eri,4,0,36,32
1657693723218,MATH 103A,B03,093562,Greenfeld; Be'Eri,3,0,36,33
1657693729242,MATH 105,A01,085443,Carter; Anne Toulson,15,0,35,20
1657693729242,MATH 105,A02,093477,Carter; Anne Toulson,20,0,35,15
1657693735273,MATH 109,A01,083213,Ganzberger; Geoffrey Michael,2,0,34,32
1657693735273,MATH 109,A02,083214,Ganzberger; Geoffrey Michael,4,0,34,30
1657693735273,MATH 109,A03,093478,Ganzberger; Geoffrey Michael,2,0,34,32
1657693735273,MATH 109,B01,083215,Ganzberger; Geoffrey Michael,1,0,32,31
1657693735273,MATH 109,B02,083216,Ganzberger; Geoffrey Michael,2,0,32,30
1657693735273,MATH 109,B03,093479,Ganzberger; Geoffrey Michael,8,0,32,24
1657693741297,MATH 142A,A01,083219,Chow; Bennett,7,0,32,25
1657693741297,MATH 142A,A02,083220,Chow; Bennett,10,0,32,22
1657693741297,MATH 142A,A03,093480,Chow; Bennett,9,0,32,23
1657693741297,MATH 142A,B03,093481,Chow; Bennett,8,0,32,24
1657693741297,MATH 142A,B04,093558,Chow; Bennett,13,0,32,19
1657693741297,MATH 142A,B05,093559,Chow; Bennett,6,0,32,26
1657693747335,MATH 193A,A01,083224,Rotar; Vladimir,8,0,34,26
1657693747335,MATH 193A,A02,083225,Rotar; Vladimir,9,0,34,25
1657693747335,MATH 193A,A03,083781,Rotar; Vladimir,5,0,34,29
1657693747335,MATH 193A,A04,083782,Rotar; Vladimir,10,0,34,24
1657693747335,MATH 193A,A05,093482,Rotar; Vladimir,10,0,34,24
1657693753360,MATH 197,001,091859,McAuley; Julian John,9999,0,9999,0
1657693753360,MATH 197,002,095566,Kedlaya; Kiran S.,9997,0,9999,2
1657693753360,MATH 197,003,095567,Xiao; Ming,9999,0,9999,0
1657693753360,MATH 197,004,095571,Perols; Johan Lars,9998,0,9999,1
1657693760417,COGS 9,A01,083615,Shannon; Kyle Michael,9,0,75,66
1657693766534,COGS 11,A01,083617,Boyle; Mary E. T.,23,0,48,25
1657693772557,COGS 13,A01,083071,Bastos; Amalia Pinkusfeld,11,0,71,60
1657693778583,COGS 14A,A01,092681,Semenuks; Arturs,5,1,100,95
1657693784610,COGS 14B,A01,083073,Cheng; Tzu-Han,6,0,63,57
1657693790634,COGS 17,A01,092677,Semenuks; Arturs,6,0,81,75
1657693796656,COGS 100,A01,083619,Allen; Michael Gordon,17,0,70,53
1657693802681,COGS 101A,A01,083621,Davis; Joshua Daniel,9,0,68,59
1657693808704,COGS 101B,A01,091572,Allen; Michael Gordon,12,0,65,53
1657693814727,COGS 101C,A01,083625,Delgado; Tania,17,0,35,18
1657693820750,COGS 107A,A01,083627,Boyle; Mary E. T.,13,0,60,47
1657693826772,COGS 118A,A01,083075,Gupta; Anjum,21,0,76,55
1657693832798,CSE 3,A50,083646,Miranda; Gregory Joseph,24,0,50,26
1657693838824,CSE 8A,A50,083650,Miranda; Gregory Joseph,17,1,56,39
1657693844847,CSE 11,A01,083080,Cao; Yingjun,6,15,40,34
1657693850874,CSE 12,A01,083652,Krause-Levy; Sophia Louisa,28,1,120,92
1657693856899,CSE 15L,A01,083654,Morris; Justin Loren,9,0,50,41
1657693856899,CSE 15L,A02,083655,Morris; Justin Loren,9,0,50,41
1657693862927,CSE 20,A01,083657,Tran; Khoa Dang,39,0,80,41
1657693868951,CSE 21,A01,095574,Bach; Quang Tran,22,0,48,26
1657693874986,CSE 30,A01,083084,Eldon; John,6,0,80,74
1657693874986,CSE 30,B01,095061,Bhaskar; Nishant,9,0,50,41
1657693881012,CSE 100,A01,083659,Cao; Yingjun,5,4,70,65
1657693887038,CSE 134B,A01,083661,Powell; Thomas Allan,23,0,100,77
1657693893062,CSE 140,A01,083663,Gungor; Onat,15,0,85,70
1657693899084,CSE 140L,A01,083088,Eldon; John,22,0,100,78
1657693905108,CSE 175,A01,083665,Kumar; Rakesh,3,0,25,22
1657693911131,CSE 190,A00,092507,Dubnov; Shlomo,8,0,20,12
1657693917159,ECE 45,A01,083139,Congero; Spencer William,6,0,75,69
1657693923183,ECE 65,A50,083695,Saad; Andrew S,12,0,30,18
1657693923183,ECE 65,A51,095125,Saad; Andrew S,24,0,26,2
1657693929208,ECE 109,A01,091882,Touri; Behrouz,20,0,70,50
1657693935232,ECE 180,A00,083140,Abi Samra; Nicholas Camill,1,0,30,29
1657693935232,ECE 180,B00,083141,Abi Samra; Nicholas Camill,0,0,30,30
1657693941257,MATH 10A,A01,083735,Patchell; Gregory David,2,0,30,28
1657693941257,MATH 10A,A02,083736,Patchell; Gregory David,20,0,30,10
1657693941257,MATH 10A,A03,083737,Patchell; Gregory David,16,0,30,14
1657693947286,MATH 10B,A01,083207,Lim; Seonhee,8,0,34,26
1657693947286,MATH 10B,A02,083208,Lim; Seonhee,9,0,35,26
1657693947286,MATH 10B,A03,093472,Lim; Seonhee,7,0,34,27
1657693947286,MATH 10B,B01,083739,Sinha; Shubham,13,0,30,17
1657693953317,MATH 18,A01,083743,Cinel; Cameron Alexander,8,0,30,22
1657693953317,MATH 18,A02,083744,Cinel; Cameron Alexander,17,0,30,13
1657693953317,MATH 18,A03,083745,Cinel; Cameron Alexander,10,0,30,20
1657693953317,MATH 18,B01,083748,Rideout; David Porter,5,0,37,32
1657693953317,MATH 18,B02,083749,Rideout; David Porter,5,0,36,31
1657693953317,MATH 18,B03,083750,Rideout; David Porter,3,0,37,34
1657693953317,MATH 18,B04,083751,Rideout; David Porter,6,0,36,30
1657693953317,MATH 18,B05,093473,Rideout; David Porter,6,0,36,30
1657693953317,MATH 18,B06,093474,Rideout; David Porter,6,0,36,30
1657693959342,MATH 20A,A01,083754,Zheng; Zequn,14,0,40,26
1657693965365,MATH 20B,A01,083756,Briones; Jor-el Thomas Caparas,4,0,36,32
1657693965365,MATH 20B,A02,083757,Briones; Jor-el Thomas Caparas,1,0,36,35
1657693965365,MATH 20B,A03,093475,Briones; Jor-el Thomas Caparas,2,0,36,34
1657693971394,MATH 20C,A01,083760,Briones; Jor-el Thomas Caparas,1,0,35,34
1657693971394,MATH 20C,A02,083761,Briones; Jor-el Thomas Caparas,8,0,35,27
1657693971394,MATH 20C,A03,093476,Briones; Jor-el Thomas Caparas,0,1,36,36
1657693971394,MATH 20C,B01,083762,Bach; Quang Tran,1,0,30,29
1657693977419,MATH 20D,A01,083765,Tran; Brian Kha,5,0,30,25
1657693977419,MATH 20D,A02,083766,Tran; Brian Kha,5,0,30,25
1657693977419,MATH 20D,A03,083767,Tran; Brian Kha,5,0,30,25
1657693983447,MATH 20E,A01,083771,Ganguly; Soumya,9,0,32,23
1657693983447,MATH 20E,A02,083772,Ganguly; Soumya,6,0,32,26
1657693983447,MATH 20E,B01,083773,Ciotti; Benjamin,20,0,35,15
1657693983447,MATH 20E,B02,083774,Ciotti; Benjamin,18,0,35,17
1657693989473,MATH 103A,A01,083777,Greenfeld; Be'Eri,3,0,36,33
1657693989473,MATH 103A,A02,083778,Greenfeld; Be'Eri,5,0,36,31
1657693989473,MATH 103A,A03,093561,Greenfeld; Be'Eri,6,0,36,30
1657693989473,MATH 103A,B01,083779,Greenfeld; Be'Eri,7,0,36,29
1657693989473,MATH 103A,B02,083780,Greenfeld; Be'Eri,4,0,36,32
1657693989473,MATH 103A,B03,093562,Greenfeld; Be'Eri,3,0,36,33
1657693995498,MATH 105,A01,085443,Carter; Anne Toulson,15,0,35,20
1657693995498,MATH 105,A02,093477,Carter; Anne Toulson,20,0,35,15
1657694001521,MATH 109,A01,083213,Ganzberger; Geoffrey Michael,2,0,34,32
1657694001521,MATH 109,A02,083214,Ganzberger; Geoffrey Michael,4,0,34,30
1657694001521,MATH 109,A03,093478,Ganzberger; Geoffrey Michael,2,0,34,32
1657694001521,MATH 109,B01,083215,Ganzberger; Geoffrey Michael,1,0,32,31
1657694001521,MATH 109,B02,083216,Ganzberger; Geoffrey Michael,2,0,32,30
1657694001521,MATH 109,B03,093479,Ganzberger; Geoffrey Michael,8,0,32,24
1657694007545,MATH 142A,A01,083219,Chow; Bennett,7,0,32,25
1657694007545,MATH 142A,A02,083220,Chow; Bennett,10,0,32,22
1657694007545,MATH 142A,A03,093480,Chow; Bennett,9,0,32,23
1657694007545,MATH 142A,B03,093481,Chow; Bennett,8,0,32,24
1657694007545,MATH 142A,B04,093558,Chow; Bennett,13,0,32,19
1657694007545,MATH 142A,B05,093559,Chow; Bennett,6,0,32,26
1657694013574,MATH 193A,A01,083224,Rotar; Vladimir,8,0,34,26
1657694013574,MATH 193A,A02,083225,Rotar; Vladimir,9,0,34,25
1657694013574,MATH 193A,A03,083781,Rotar; Vladimir,5,0,34,29
1657694013574,MATH 193A,A04,083782,Rotar; Vladimir,10,0,34,24
1657694013574,MATH 193A,A05,093482,Rotar; Vladimir,10,0,34,24
1657694019598,MATH 197,001,091859,McAuley; Julian John,9999,0,9999,0
1657694019598,MATH 197,002,095566,Kedlaya; Kiran S.,9997,0,9999,2
1657694019598,MATH 197,003,095567,Xiao; Ming,9999,0,9999,0
1657694019598,MATH 197,004,095571,Perols; Johan Lars,9998,0,9999,1
1657694026653,COGS 9,A01,083615,Shannon; Kyle Michael,9,0,75,66
1657694032677,COGS 11,A01,083617,Boyle; Mary E. T.,23,0,48,25
1657694038700,COGS 13,A01,083071,Bastos; Amalia Pinkusfeld,11,0,71,60
1657694044733,COGS 14A,A01,092681,Semenuks; Arturs,5,1,100,95
1657694050756,COGS 14B,A01,083073,Cheng; Tzu-Han,6,0,63,57
1657694056783,COGS 17,A01,092677,Semenuks; Arturs,6,0,81,75
1657694062805,COGS 100,A01,083619,Allen; Michael Gordon,17,0,70,53
1657694068828,COGS 101A,A01,083621,Davis; Joshua Daniel,9,0,68,59
1657694074852,COGS 101B,A01,091572,Allen; Michael Gordon,12,0,65,53
1657694080876,COGS 101C,A01,083625,Delgado; Tania,17,0,35,18
1657694086899,COGS 107A,A01,083627,Boyle; Mary E. T.,13,0,60,47
1657694092923,COGS 118A,A01,083075,Gupta; Anjum,21,0,76,55
1657694098945,CSE 3,A50,083646,Miranda; Gregory Joseph,24,0,50,26
1657694104970,CSE 8A,A50,083650,Miranda; Gregory Joseph,17,1,56,39
1657694110996,CSE 11,A01,083080,Cao; Yingjun,6,15,40,34
1657694117022,CSE 12,A01,083652,Krause-Levy; Sophia Louisa,28,1,120,92
1657694123046,CSE 15L,A01,083654,Morris; Justin Loren,9,0,50,41
1657694123046,CSE 15L,A02,083655,Morris; Justin Loren,9,0,50,41
1657694129068,CSE 20,A01,083657,Tran; Khoa Dang,39,0,80,41
1657694135092,CSE 21,A01,095574,Bach; Quang Tran,22,0,48,26
1657694141119,CSE 30,A01,083084,Eldon; John,6,0,80,74
1657694141119,CSE 30,B01,095061,Bhaskar; Nishant,9,0,50,41
1657694147151,CSE 100,A01,083659,Cao; Yingjun,5,4,70,65
1657694153175,CSE 134B,A01,083661,Powell; Thomas Allan,23,0,100,77
1657694159202,CSE 140,A01,083663,Gungor; Onat,15,0,85,70
1657694165228,CSE 140L,A01,083088,Eldon; John,22,0,100,78
1657694171250,CSE 175,A01,083665,Kumar; Rakesh,3,0,25,22
1657694177272,CSE 190,A00,092507,Dubnov; Shlomo,8,0,20,12
1657694183297,ECE 45,A01,083139,Congero; Spencer William,6,0,75,69
1657694189321,ECE 65,A50,083695,Saad; Andrew S,12,0,30,18
1657694189321,ECE 65,A51,095125,Saad; Andrew S,24,0,26,2
1657694195347,ECE 109,A01,091882,Touri; Behrouz,20,0,70,50
1657694201373,ECE 180,A00,083140,Abi Samra; Nicholas Camill,1,0,30,29
1657694201373,ECE 180,B00,083141,Abi Samra; Nicholas Camill,0,0,30,30
1657694207397,MATH 10A,A01,083735,Patchell; Gregory David,2,0,30,28
1657694207397,MATH 10A,A02,083736,Patchell; Gregory David,20,0,30,10
1657694207397,MATH 10A,A03,083737,Patchell; Gregory David,16,0,30,14
1657694213427,MATH 10B,A01,083207,Lim; Seonhee,8,0,34,26
1657694213427,MATH 10B,A02,083208,Lim; Seonhee,9,0,35,26
1657694213427,MATH 10B,A03,093472,Lim; Seonhee,7,0,34,27
1657694213427,MATH 10B,B01,083739,Sinha; Shubham,13,0,30,17
1657694219459,MATH 18,A01,083743,Cinel; Cameron Alexander,8,0,30,22
1657694219459,MATH 18,A02,083744,Cinel; Cameron Alexander,17,0,30,13
1657694219459,MATH 18,A03,083745,Cinel; Cameron Alexander,10,0,30,20
1657694219459,MATH 18,B01,083748,Rideout; David Porter,5,0,37,32
1657694219459,MATH 18,B02,083749,Rideout; David Porter,5,0,36,31
1657694219459,MATH 18,B03,083750,Rideout; David Porter,3,0,37,34
1657694219459,MATH 18,B04,083751,Rideout; David Porter,6,0,36,30
1657694219459,MATH 18,B05,093473,Rideout; David Porter,6,0,36,30
1657694219459,MATH 18,B06,093474,Rideout; David Porter,6,0,36,30
1657694225480,MATH 20A,A01,083754,Zheng; Zequn,14,0,40,26
1657694231503,MATH 20B,A01,083756,Briones; Jor-el Thomas Caparas,4,0,36,32
1657694231503,MATH 20B,A02,083757,Briones; Jor-el Thomas Caparas,1,0,36,35
1657694231503,MATH 20B,A03,093475,Briones; Jor-el Thomas Caparas,2,0,36,34
1657694237526,MATH 20C,A01,083760,Briones; Jor-el Thomas Caparas,1,0,35,34
1657694237526,MATH 20C,A02,083761,Briones; Jor-el Thomas Caparas,8,0,35,27
1657694237526,MATH 20C,A03,093476,Briones; Jor-el Thomas Caparas,0,1,36,36
1657694237526,MATH 20C,B01,083762,Bach; Quang Tran,1,0,30,29
1657694243560,MATH 20D,A01,083765,Tran; Brian Kha,5,0,30,25
1657694243560,MATH 20D,A02,083766,Tran; Brian Kha,5,0,30,25
1657694243560,MATH 20D,A03,083767,Tran; Brian Kha,5,0,30,25
1657694249587,MATH 20E,A01,083771,Ganguly; Soumya,9,0,32,23
1657694249587,MATH 20E,A02,083772,Ganguly; Soumya,6,0,32,26
1657694249587,MATH 20E,B01,083773,Ciotti; Benjamin,20,0,35,15
1657694249587,MATH 20E,B02,083774,Ciotti; Benjamin,18,0,35,17
1657694255610,MATH 103A,A01,083777,Greenfeld; Be'Eri,3,0,36,33
1657694255610,MATH 103A,A02,083778,Greenfeld; Be'Eri,5,0,36,31
1657694255610,MATH 103A,A03,093561,Greenfeld; Be'Eri,6,0,36,30
1657694255610,MATH 103A,B01,083779,Greenfeld; Be'Eri,7,0,36,29
1657694255610,MATH 103A,B02,083780,Greenfeld; Be'Eri,4,0,36,32
1657694255610,MATH 103A,B03,093562,Greenfeld; Be'Eri,3,0,36,33
1657694261633,MATH 105,A01,085443,Carter; Anne Toulson,15,0,35,20
1657694261633,MATH 105,A02,093477,Carter; Anne Toulson,20,0,35,15
1657694267662,MATH 109,A01,083213,Ganzberger; Geoffrey Michael,2,0,34,32
1657694267662,MATH 109,A02,083214,Ganzberger; Geoffrey Michael,4,0,34,30
1657694267662,MATH 109,A03,093478,Ganzberger; Geoffrey Michael,2,0,34,32
1657694267662,MATH 109,B01,083215,Ganzberger; Geoffrey Michael,1,0,32,31
1657694267662,MATH 109,B02,083216,Ganzberger; Geoffrey Michael,2,0,32,30
1657694267662,MATH 109,B03,093479,Ganzberger; Geoffrey Michael,8,0,32,24
1657694273691,MATH 142A,A01,083219,Chow; Bennett,7,0,32,25
1657694273691,MATH 142A,A02,083220,Chow; Bennett,10,0,32,22
1657694273691,MATH 142A,A03,093480,Chow; Bennett,9,0,32,23
1657694273691,MATH 142A,B03,093481,Chow; Bennett,8,0,32,24
1657694273691,MATH 142A,B04,093558,Chow; Bennett,13,0,32,19
1657694273691,MATH 142A,B05,093559,Chow; Bennett,6,0,32,26
1657694279722,MATH 193A,A01,083224,Rotar; Vladimir,8,0,34,26
1657694279722,MATH 193A,A02,083225,Rotar; Vladimir,9,0,34,25
1657694279722,MATH 193A,A03,083781,Rotar; Vladimir,5,0,34,29
1657694279722,MATH 193A,A04,083782,Rotar; Vladimir,10,0,34,24
1657694279722,MATH 193A,A05,093482,Rotar; Vladimir,10,0,34,24
1657694285746,MATH 197,001,091859,McAuley; Julian John,9999,0,9999,0
1657694285746,MATH 197,002,095566,Kedlaya; Kiran S.,9997,0,9999,2
1657694285746,MATH 197,003,095567,Xiao; Ming,9999,0,9999,0
1657694285746,MATH 197,004,095571,Perols; Johan Lars,9998,0,9999,1
1657694292802,COGS 9,A01,083615,Shannon; Kyle Michael,9,0,75,66
1657694298825,COGS 11,A01,083617,Boyle; Mary E. T.,23,0,48,25
1657694304848,COGS 13,A01,083071,Bastos; Amalia Pinkusfeld,11,0,71,60
1657694310875,COGS 14A,A01,092681,Semenuks; Arturs,5,1,100,95
1657694316897,COGS 14B,A01,083073,Cheng; Tzu-Han,6,0,63,57
1657694322919,COGS 17,A01,092677,Semenuks; Arturs,6,0,81,75
1657694328954,COGS 100,A01,083619,Allen; Michael Gordon,17,0,70,53
1657694334981,COGS 101A,A01,083621,Davis; Joshua Daniel,9,0,68,59
1657694341008,COGS 101B,A01,091572,Allen; Michael Gordon,12,0,65,53
1657694347030,COGS 101C,A01,083625,Delgado; Tania,17,0,35,18
1657694353056,COGS 107A,A01,083627,Boyle; Mary E. T.,13,0,60,47
1657694359094,COGS 118A,A01,083075,Gupta; Anjum,21,0,76,55
1657694365194,CSE 3,A50,083646,Miranda; Gregory Joseph,24,0,50,26
1657694371218,CSE 8A,A50,083650,Miranda; Gregory Joseph,17,1,56,39
1657694377240,CSE 11,A01,083080,Cao; Yingjun,6,15,40,34
1657694383267,CSE 12,A01,083652,Krause-Levy; Sophia Louisa,28,1,120,92
1657694389290,CSE 15L,A01,083654,Morris; Justin Loren,9,0,50,41
1657694389290,CSE 15L,A02,083655,Morris; Justin Loren,9,0,50,41
1657694395316,CSE 20,A01,083657,Tran; Khoa Dang,39,0,80,41
1657694401342,CSE 21,A01,095574,Bach; Quang Tran,22,0,48,26
1657694407368,CSE 30,A01,083084,Eldon; John,6,0,80,74
1657694407368,CSE 30,B01,095061,Bhaskar; Nishant,9,0,50,41
1657694413390,CSE 100,A01,083659,Cao; Yingjun,5,4,70,65
1657694419413,CSE 134B,A01,083661,Powell; Thomas Allan,23,0,100,77
1657694425436,CSE 140,A01,083663,Gungor; Onat,15,0,85,70
1657694431459,CSE 140L,A01,083088,Eldon; John,22,0,100,78
1657694437481,CSE 175,A01,083665,Kumar; Rakesh,3,0,25,22
1657694443506,CSE 190,A00,092507,Dubnov; Shlomo,8,0,20,12
1657694449533,ECE 45,A01,083139,Congero; Spencer William,6,0,75,69
1657694455561,ECE 65,A50,083695,Saad; Andrew S,12,0,30,18
1657694455561,ECE 65,A51,095125,Saad; Andrew S,24,0,26,2
1657694461583,ECE 109,A01,091882,Touri; Behrouz,20,0,70,50
1657694467606,ECE 180,A00,083140,Abi Samra; Nicholas Camill,1,0,30,29
1657694467606,ECE 180,B00,083141,Abi Samra; Nicholas Camill,0,0,30,30
1657694473630,MATH 10A,A01,083735,Patchell; Gregory David,2,0,30,28
1657694473630,MATH 10A,A02,083736,Patchell; Gregory David,20,0,30,10
1657694473630,MATH 10A,A03,083737,Patchell; Gregory David,16,0,30,14
1657694479655,MATH 10B,A01,083207,Lim; Seonhee,8,0,34,26
1657694479655,MATH 10B,A02,083208,Lim; Seonhee,9,0,35,26
1657694479655,MATH 10B,A03,093472,Lim; Seonhee,7,0,34,27
1657694479655,MATH 10B,B01,083739,Sinha; Shubham,13,0,30,17
1657694485686,MATH 18,A01,083743,Cinel; Cameron Alexander,8,0,30,22
1657694485686,MATH 18,A02,083744,Cinel; Cameron Alexander,17,0,30,13
1657694485686,MATH 18,A03,083745,Cinel; Cameron Alexander,10,0,30,20
1657694485686,MATH 18,B01,083748,Rideout; David Porter,5,0,37,32
1657694485686,MATH 18,B02,083749,Rideout; David Porter,5,0,36,31
1657694485686,MATH 18,B03,083750,Rideout; David Porter,3,0,37,34
1657694485686,MATH 18,B04,083751,Rideout; David Porter,6,0,36,30
1657694485686,MATH 18,B05,093473,Rideout; David Porter,6,0,36,30
1657694485686,MATH 18,B06,093474,Rideout; David Porter,6,0,36,30
1657694491711,MATH 20A,A01,083754,Zheng; Zequn,14,0,40,26
1657694497735,MATH 20B,A01,083756,Briones; Jor-el Thomas Caparas,4,0,36,32
1657694497735,MATH 20B,A02,083757,Briones; Jor-el Thomas Caparas,1,0,36,35
1657694497735,MATH 20B,A03,093475,Briones; Jor-el Thomas Caparas,2,0,36,34
1657694503756,MATH 20C,A01,083760,Briones; Jor-el Thomas Caparas,1,0,35,34
1657694503756,MATH 20C,A02,083761,Briones; Jor-el Thomas Caparas,8,0,35,27
1657694503756,MATH 20C,A03,093476,Briones; Jor-el Thomas Caparas,0,1,36,36
1657694503756,MATH 20C,B01,083762,Bach; Quang Tran,1,0,30,29
1657694509777,MATH 20D,A01,083765,Tran; Brian Kha,5,0,30,25
1657694509777,MATH 20D,A02,083766,Tran; Brian Kha,5,0,30,25
1657694509777,MATH 20D,A03,083767,Tran; Brian Kha,5,0,30,25
1657694515809,MATH 20E,A01,083771,Ganguly; Soumya,9,0,32,23
1657694515809,MATH 20E,A02,083772,Ganguly; Soumya,6,0,32,26
1657694515809,MATH 20E,B01,083773,Ciotti; Benjamin,20,0,35,15
1657694515809,MATH 20E,B02,083774,Ciotti; Benjamin,18,0,35,17
1657694521834,MATH 103A,A01,083777,Greenfeld; Be'Eri,3,0,36,33
1657694521834,MATH 103A,A02,083778,Greenfeld; Be'Eri,5,0,36,31
1657694521834,MATH 103A,A03,093561,Greenfeld; Be'Eri,6,0,36,30
1657694521834,MATH 103A,B01,083779,Greenfeld; Be'Eri,7,0,36,29
1657694521834,MATH 103A,B02,083780,Greenfeld; Be'Eri,4,0,36,32
1657694521834,MATH 103A,B03,093562,Greenfeld; Be'Eri,3,0,36,33
1657694527855,MATH 105,A01,085443,Carter; Anne Toulson,15,0,35,20
1657694527855,MATH 105,A02,093477,Carter; Anne Toulson,20,0,35,15
1657694533879,MATH 109,A01,083213,Ganzberger; Geoffrey Michael,2,0,34,32
1657694533879,MATH 109,A02,083214,Ganzberger; Geoffrey Michael,4,0,34,30
1657694533879,MATH 109,A03,093478,Ganzberger; Geoffrey Michael,2,0,34,32
1657694533879,MATH 109,B01,083215,Ganzberger; Geoffrey Michael,1,0,32,31
1657694533879,MATH 109,B02,083216,Ganzberger; Geoffrey Michael,2,0,32,30
1657694533879,MATH 109,B03,093479,Ganzberger; Geoffrey Michael,8,0,32,24
1657694539907,MATH 142A,A01,083219,Chow; Bennett,7,0,32,25
1657694539907,MATH 142A,A02,083220,Chow; Bennett,10,0,32,22
1657694539907,MATH 142A,A03,093480,Chow; Bennett,9,0,32,23
1657694539907,MATH 142A,B03,093481,Chow; Bennett,8,0,32,24
1657694539907,MATH 142A,B04,093558,Chow; Bennett,13,0,32,19
1657694539907,MATH 142A,B05,093559,Chow; Bennett,6,0,32,26
1657694545928,MATH 193A,A01,083224,Rotar; Vladimir,8,0,34,26
1657694545928,MATH 193A,A02,083225,Rotar; Vladimir,9,0,34,25
1657694545928,MATH 193A,A03,083781,Rotar; Vladimir,5,0,34,29
1657694545928,MATH 193A,A04,083782,Rotar; Vladimir,10,0,34,24
1657694545928,MATH 193A,A05,093482,Rotar; Vladimir,10,0,34,24
1657694551959,MATH 197,001,091859,McAuley; Julian John,9999,0,9999,0
1657694551959,MATH 197,002,095566,Kedlaya; Kiran S.,9997,0,9999,2
1657694551959,MATH 197,003,095567,Xiao; Ming,9999,0,9999,0
1657694551959,MATH 197,004,095571,Perols; Johan Lars,9998,0,9999,1
1657694559022,COGS 9,A01,083615,Shannon; Kyle Michael,9,0,75,66
1657694565048,COGS 11,A01,083617,Boyle; Mary E. T.,23,0,48,25
1657694571072,COGS 13,A01,083071,Bastos; Amalia Pinkusfeld,11,0,71,60
1657694577096,COGS 14A,A01,092681,Semenuks; Arturs,5,1,100,95
1657694583119,COGS 14B,A01,083073,Cheng; Tzu-Han,6,0,63,57
1657694589141,COGS 17,A01,092677,Semenuks; Arturs,6,0,81,75
1657694595163,COGS 100,A01,083619,Allen; Michael Gordon,17,0,70,53
1657694601189,COGS 101A,A01,083621,Davis; Joshua Daniel,9,0,68,59
1657694607211,COGS 101B,A01,091572,Allen; Michael Gordon,12,0,65,53
1657694613235,COGS 101C,A01,083625,Delgado; Tania,17,0,35,18
1657694619258,COGS 107A,A01,083627,Boyle; Mary E. T.,13,0,60,47
1657694625283,COGS 118A,A01,083075,Gupta; Anjum,21,0,76,55
1657694631306,CSE 3,A50,083646,Miranda; Gregory Joseph,24,0,50,26
1657694637329,CSE 8A,A50,083650,Miranda; Gregory Joseph,17,1,56,39
1657694643353,CSE 11,A01,083080,Cao; Yingjun,6,15,40,34
1657694649377,CSE 12,A01,083652,Krause-Levy; Sophia Louisa,28,1,120,92
1657694655400,CSE 15L,A01,083654,Morris; Justin Loren,9,0,50,41
1657694655400,CSE 15L,A02,083655,Morris; Justin Loren,9,0,50,41
1657694661421,CSE 20,A01,083657,Tran; Khoa Dang,39,0,80,41
1657694667447,CSE 21,A01,095574,Bach; Quang Tran,22,0,48,26
1657694673470,CSE 30,A01,083084,Eldon; John,6,0,80,74
1657694673470,CSE 30,B01,095061,Bhaskar; Nishant,9,0,50,41
1657694679494,CSE 100,A01,083659,Cao; Yingjun,5,4,70,65
1657694685518,CSE 134B,A01,083661,Powell; Thomas Allan,23,0,100,77
1657694691545,CSE 140,A01,083663,Gungor; Onat,15,0,85,70
1657694697571,CSE 140L,A01,083088,Eldon; John,22,0,100,78
1657694703594,CSE 175,A01,083665,Kumar; Rakesh,3,0,25,22
1657694709620,CSE 190,A00,092507,Dubnov; Shlomo,8,0,20,12
1657694715658,ECE 45,A01,083139,Congero; Spencer William,6,0,75,69
1657694721684,ECE 65,A50,083695,Saad; Andrew S,12,0,30,18
1657694721684,ECE 65,A51,095125,Saad; Andrew S,24,0,26,2
1657694727711,ECE 109,A01,091882,Touri; Behrouz,20,0,70,50
1657694733735,ECE 180,A00,083140,Abi Samra; Nicholas Camill,1,0,30,29
1657694733735,ECE 180,B00,083141,Abi Samra; Nicholas Camill,0,0,30,30
1657694739758,MATH 10A,A01,083735,Patchell; Gregory David,2,0,30,28
1657694739758,MATH 10A,A02,083736,Patchell; Gregory David,20,0,30,10
1657694739758,MATH 10A,A03,083737,Patchell; Gregory David,16,0,30,14
1657694745786,MATH 10B,A01,083207,Lim; Seonhee,8,0,34,26
1657694745786,MATH 10B,A02,083208,Lim; Seonhee,9,0,35,26
1657694745786,MATH 10B,A03,093472,Lim; Seonhee,7,0,34,27
1657694745786,MATH 10B,B01,083739,Sinha; Shubham,13,0,30,17
1657694751824,MATH 18,A01,083743,Cinel; Cameron Alexander,8,0,30,22
1657694751824,MATH 18,A02,083744,Cinel; Cameron Alexander,17,0,30,13
1657694751824,MATH 18,A03,083745,Cinel; Cameron Alexander,10,0,30,20
1657694751824,MATH 18,B01,083748,Rideout; David Porter,5,0,37,32
1657694751824,MATH 18,B02,083749,Rideout; David Porter,5,0,36,31
1657694751824,MATH 18,B03,083750,Rideout; David Porter,3,0,37,34
1657694751824,MATH 18,B04,083751,Rideout; David Porter,6,0,36,30
1657694751824,MATH 18,B05,093473,Rideout; David Porter,6,0,36,30
1657694751824,MATH 18,B06,093474,Rideout; David Porter,6,0,36,30
1657694757857,MATH 20A,A01,083754,Zheng; Zequn,14,0,40,26
1657694763885,MATH 20B,A01,083756,Briones; Jor-el Thomas Caparas,4,0,36,32
1657694763885,MATH 20B,A02,083757,Briones; Jor-el Thomas Caparas,1,0,36,35
1657694763885,MATH 20B,A03,093475,Briones; Jor-el Thomas Caparas,2,0,36,34
1657694769918,MATH 20C,A01,083760,Briones; Jor-el Thomas Caparas,1,0,35,34
1657694769918,MATH 20C,A02,083761,Briones; Jor-el Thomas Caparas,8,0,35,27
1657694769918,MATH 20C,A03,093476,Briones; Jor-el Thomas Caparas,0,1,36,36
1657694769918,MATH 20C,B01,083762,Bach; Quang Tran,1,0,30,29
1657694775947,MATH 20D,A01,083765,Tran; Brian Kha,5,0,30,25
1657694775947,MATH 20D,A02,083766,Tran; Brian Kha,5,0,30,25
1657694775947,MATH 20D,A03,083767,Tran; Brian Kha,5,0,30,25
1657694781971,MATH 20E,A01,083771,Ganguly; Soumya,9,0,32,23
1657694781971,MATH 20E,A02,083772,Ganguly; Soumya,6,0,32,26
1657694781971,MATH 20E,B01,083773,Ciotti; Benjamin,20,0,35,15
1657694781971,MATH 20E,B02,083774,Ciotti; Benjamin,18,0,35,17
1657694787995,MATH 103A,A01,083777,Greenfeld; Be'Eri,3,0,36,33
1657694787995,MATH 103A,A02,083778,Greenfeld; Be'Eri,5,0,36,31
1657694787995,MATH 103A,A03,093561,Greenfeld; Be'Eri,6,0,36,30
1657694787995,MATH 103A,B01,083779,Greenfeld; Be'Eri,7,0,36,29
1657694787995,MATH 103A,B02,083780,Greenfeld; Be'Eri,4,0,36,32
1657694787995,MATH 103A,B03,093562,Greenfeld; Be'Eri,3,0,36,33
1657694794024,MATH 105,A01,085443,Carter; Anne Toulson,15,0,35,20
1657694794024,MATH 105,A02,093477,Carter; Anne Toulson,20,0,35,15
1657694800047,MATH 109,A01,083213,Ganzberger; Geoffrey Michael,2,0,34,32
1657694800047,MATH 109,A02,083214,Ganzberger; Geoffrey Michael,4,0,34,30
1657694800047,MATH 109,A03,093478,Ganzberger; Geoffrey Michael,2,0,34,32
1657694800047,MATH 109,B01,083215,Ganzberger; Geoffrey Michael,1,0,32,31
1657694800047,MATH 109,B02,083216,Ganzberger; Geoffrey Michael,2,0,32,30
1657694800047,MATH 109,B03,093479,Ganzberger; Geoffrey Michael,8,0,32,24
1657694806071,MATH 142A,A01,083219,Chow; Bennett,7,0,32,25
1657694806071,MATH 142A,A02,083220,Chow; Bennett,10,0,32,22
1657694806071,MATH 142A,A03,093480,Chow; Bennett,9,0,32,23
1657694806071,MATH 142A,B03,093481,Chow; Bennett,8,0,32,24
1657694806071,MATH 142A,B04,093558,Chow; Bennett,13,0,32,19
1657694806071,MATH 142A,B05,093559,Chow; Bennett,6,0,32,26
1657694812095,MATH 193A,A01,083224,Rotar; Vladimir,8,0,34,26
1657694812095,MATH 193A,A02,083225,Rotar; Vladimir,9,0,34,25
1657694812095,MATH 193A,A03,083781,Rotar; Vladimir,5,0,34,29
1657694812095,MATH 193A,A04,083782,Rotar; Vladimir,10,0,34,24
1657694812095,MATH 193A,A05,093482,Rotar; Vladimir,10,0,34,24
1657694818118,MATH 197,001,091859,McAuley; Julian John,9999,0,9999,0
1657694818118,MATH 197,002,095566,Kedlaya; Kiran S.,9997,0,9999,2
1657694818118,MATH 197,003,095567,Xiao; Ming,9999,0,9999,0
1657694818118,MATH 197,004,095571,Perols; Johan Lars,9998,0,9999,1
1657694825168,COGS 9,A01,083615,Shannon; Kyle Michael,9,0,75,66
1657694831191,COGS 11,A01,083617,Boyle; Mary E. T.,23,0,48,25
1657694837215,COGS 13,A01,083071,Bastos; Amalia Pinkusfeld,11,0,71,60
1657694843241,COGS 14A,A01,092681,Semenuks; Arturs,5,1,100,95
1657694849265,COGS 14B,A01,083073,Cheng; Tzu-Han,6,0,63,57
1657694855288,COGS 17,A01,092677,Semenuks; Arturs,6,0,81,75
1657694861316,COGS 100,A01,083619,Allen; Michael Gordon,17,0,70,53
1657694867346,COGS 101A,A01,083621,Davis; Joshua Daniel,9,0,68,59
1657694873371,COGS 101B,A01,091572,Allen; Michael Gordon,12,0,65,53
1657694879396,COGS 101C,A01,083625,Delgado; Tania,17,0,35,18
1657694885422,COGS 107A,A01,083627,Boyle; Mary E. T.,13,0,60,47
1657694891448,COGS 118A,A01,083075,Gupta; Anjum,21,0,76,55
1657694897474,CSE 3,A50,083646,Miranda; Gregory Joseph,24,0,50,26
1657694903498,CSE 8A,A50,083650,Miranda; Gregory Joseph,17,1,56,39
1657694909523,CSE 11,A01,083080,Cao; Yingjun,6,15,40,34
1657694915549,CSE 12,A01,083652,Krause-Levy; Sophia Louisa,28,1,120,92
1657694921579,CSE 15L,A01,083654,Morris; Justin Loren,9,0,50,41
1657694921579,CSE 15L,A02,083655,Morris; Justin Loren,9,0,50,41
1657694927604,CSE 20,A01,083657,Tran; Khoa Dang,39,0,80,41
1657694933637,CSE 21,A01,095574,Bach; Quang Tran,22,0,48,26
1657694939662,CSE 30,A01,083084,Eldon; John,6,0,80,74
1657694939662,CSE 30,B01,095061,Bhaskar; Nishant,9,0,50,41
1657694945689,CSE 100,A01,083659,Cao; Yingjun,5,4,70,65
1657694951713,CSE 134B,A01,083661,Powell; Thomas Allan,23,0,100,77
1657694957740,CSE 140,A01,083663,Gungor; Onat,15,0,85,70
1657694963837,CSE 140L,A01,083088,Eldon; John,22,0,100,78
1657694969862,CSE 175,A01,083665,Kumar; Rakesh,3,0,25,22
1657694975889,CSE 190,A00,092507,Dubnov; Shlomo,8,0,20,12
1657694981912,ECE 45,A01,083139,Congero; Spencer William,6,0,75,69
1657694987935,ECE 65,A50,083695,Saad; Andrew S,12,0,30,18
1657694987935,ECE 65,A51,095125,Saad; Andrew S,24,0,26,2
1657694993957,ECE 109,A01,091882,Touri; Behrouz,20,0,70,50
1657694999984,ECE 180,A00,083140,Abi Samra; Nicholas Camill,1,0,30,29
1657694999984,ECE 180,B00,083141,Abi Samra; Nicholas Camill,0,0,30,30
1657695006011,MATH 10A,A01,083735,Patchell; Gregory David,2,0,30,28
1657695006011,MATH 10A,A02,083736,Patchell; Gregory David,20,0,30,10
1657695006011,MATH 10A,A03,083737,Patchell; Gregory David,16,0,30,14
1657695012034,MATH 10B,A01,083207,Lim; Seonhee,8,0,34,26
1657695012034,MATH 10B,A02,083208,Lim; Seonhee,9,0,35,26
1657695012034,MATH 10B,A03,093472,Lim; Seonhee,7,0,34,27
1657695012034,MATH 10B,B01,083739,Sinha; Shubham,13,0,30,17
1657695018059,MATH 18,A01,083743,Cinel; Cameron Alexander,8,0,30,22
1657695018059,MATH 18,A02,083744,Cinel; Cameron Alexander,17,0,30,13
1657695018059,MATH 18,A03,083745,Cinel; Cameron Alexander,10,0,30,20
1657695018059,MATH 18,B01,083748,Rideout; David Porter,5,0,37,32
1657695018059,MATH 18,B02,083749,Rideout; David Porter,5,0,36,31
1657695018059,MATH 18,B03,083750,Rideout; David Porter,3,0,37,34
1657695018059,MATH 18,B04,083751,Rideout; David Porter,6,0,36,30
1657695018059,MATH 18,B05,093473,Rideout; David Porter,6,0,36,30
1657695018059,MATH 18,B06,093474,Rideout; David Porter,6,0,36,30
1657695024082,MATH 20A,A01,083754,Zheng; Zequn,14,0,40,26
1657695030104,MATH 20B,A01,083756,Briones; Jor-el Thomas Caparas,4,0,36,32
1657695030104,MATH 20B,A02,083757,Briones; Jor-el Thomas Caparas,1,0,36,35
1657695030104,MATH 20B,A03,093475,Briones; Jor-el Thomas Caparas,2,0,36,34
1657695036126,MATH 20C,A01,083760,Briones; Jor-el Thomas Caparas,1,0,35,34
1657695036126,MATH 20C,A02,083761,Briones; Jor-el Thomas Caparas,8,0,35,27
1657695036126,MATH 20C,A03,093476,Briones; Jor-el Thomas Caparas,0,1,36,36
1657695036126,MATH 20C,B01,083762,Bach; Quang Tran,1,0,30,29
1657695042151,MATH 20D,A01,083765,Tran; Brian Kha,5,0,30,25
1657695042151,MATH 20D,A02,083766,Tran; Brian Kha,5,0,30,25
1657695042151,MATH 20D,A03,083767,Tran; Brian Kha,5,0,30,25
1657695048197,MATH 20E,A01,083771,Ganguly; Soumya,9,0,32,23
1657695048197,MATH 20E,A02,083772,Ganguly; Soumya,6,0,32,26
1657695048197,MATH 20E,B01,083773,Ciotti; Benjamin,20,0,35,15
1657695048197,MATH 20E,B02,083774,Ciotti; Benjamin,18,0,35,17
1657695054222,MATH 103A,A01,083777,Greenfeld; Be'Eri,3,0,36,33
1657695054222,MATH 103A,A02,083778,Greenfeld; Be'Eri,5,0,36,31
1657695054222,MATH 103A,A03,093561,Greenfeld; Be'Eri,6,0,36,30
1657695054222,MATH 103A,B01,083779,Greenfeld; Be'Eri,7,0,36,29
1657695054222,MATH 103A,B02,083780,Greenfeld; Be'Eri,4,0,36,32
1657695054222,MATH 103A,B03,093562,Greenfeld; Be'Eri,3,0,36,33
1657695060259,MATH 105,A01,085443,Carter; Anne Toulson,15,0,35,20
1657695060259,MATH 105,A02,093477,Carter; Anne Toulson,20,0,35,15
1657695066282,MATH 109,A01,083213,Ganzberger; Geoffrey Michael,2,0,34,32
1657695066282,MATH 109,A02,083214,Ganzberger; Geoffrey Michael,4,0,34,30
1657695066282,MATH 109,A03,093478,Ganzberger; Geoffrey Michael,2,0,34,32
1657695066282,MATH 109,B01,083215,Ganzberger; Geoffrey Michael,1,0,32,31
1657695066282,MATH 109,B02,083216,Ganzberger; Geoffrey Michael,2,0,32,30
1657695066282,MATH 109,B03,093479,Ganzberger; Geoffrey Michael,8,0,32,24
1657695072304,MATH 142A,A01,083219,Chow; Bennett,7,0,32,25
1657695072304,MATH 142A,A02,083220,Chow; Bennett,10,0,32,22
1657695072304,MATH 142A,A03,093480,Chow; Bennett,9,0,32,23
1657695072304,MATH 142A,B03,093481,Chow; Bennett,8,0,32,24
1657695072304,MATH 142A,B04,093558,Chow; Bennett,13,0,32,19
1657695072304,MATH 142A,B05,093559,Chow; Bennett,6,0,32,26
1657695078328,MATH 193A,A01,083224,Rotar; Vladimir,8,0,34,26
1657695078328,MATH 193A,A02,083225,Rotar; Vladimir,9,0,34,25
1657695078328,MATH 193A,A03,083781,Rotar; Vladimir,5,0,34,29
1657695078328,MATH 193A,A04,083782,Rotar; Vladimir,10,0,34,24
1657695078328,MATH 193A,A05,093482,Rotar; Vladimir,10,0,34,24
1657695084354,MATH 197,001,091859,McAuley; Julian John,9999,0,9999,0
1657695084354,MATH 197,002,095566,Kedlaya; Kiran S.,9997,0,9999,2
1657695084354,MATH 197,003,095567,Xiao; Ming,9999,0,9999,0
1657695084354,MATH 197,004,095571,Perols; Johan Lars,9998,0,9999,1
1657695091423,COGS 9,A01,083615,Shannon; Kyle Michael,9,0,75,66
1657695097448,COGS 11,A01,083617,Boyle; Mary E. T.,23,0,48,25
1657695103474,COGS 13,A01,083071,Bastos; Amalia Pinkusfeld,11,0,71,60
1657695109496,COGS 14A,A01,092681,Semenuks; Arturs,5,1,100,95
1657695115518,COGS 14B,A01,083073,Cheng; Tzu-Han,6,0,63,57
1657695121546,COGS 17,A01,092677,Semenuks; Arturs,6,0,81,75
1657695127569,COGS 100,A01,083619,Allen; Michael Gordon,17,0,70,53
1657695133597,COGS 101A,A01,083621,Davis; Joshua Daniel,9,0,68,59
1657695139625,COGS 101B,A01,091572,Allen; Michael Gordon,12,0,65,53
1657695145646,COGS 101C,A01,083625,Delgado; Tania,17,0,35,18
1657695151688,COGS 107A,A01,083627,Boyle; Mary E. T.,13,0,60,47
1657695157710,COGS 118A,A01,083075,Gupta; Anjum,21,0,76,55
1657695163732,CSE 3,A50,083646,Miranda; Gregory Joseph,24,0,50,26
1657695169754,CSE 8A,A50,083650,Miranda; Gregory Joseph,17,1,56,39
1657695175781,CSE 11,A01,083080,Cao; Yingjun,6,15,40,34
1657695181814,CSE 12,A01,083652,Krause-Levy; Sophia Louisa,28,1,120,92
1657695187840,CSE 15L,A01,083654,Morris; Justin Loren,9,0,50,41
1657695187840,CSE 15L,A02,083655,Morris; Justin Loren,9,0,50,41
1657695203824,CSE 20,A01,083657,Tran; Khoa Dang,39,0,80,41
1657695209852,CSE 21,A01,095574,Bach; Quang Tran,22,0,48,26
1657695215880,CSE 30,A01,083084,Eldon; John,6,0,80,74
1657695215880,CSE 30,B01,095061,Bhaskar; Nishant,9,0,50,41
1657695221902,CSE 100,A01,083659,Cao; Yingjun,5,4,70,65
1657695227928,CSE 134B,A01,083661,Powell; Thomas Allan,23,0,100,77
1657695233955,CSE 140,A01,083663,Gungor; Onat,15,0,85,70
1657695239983,CSE 140L,A01,083088,Eldon; John,22,0,100,78
1657695246007,CSE 175,A01,083665,Kumar; Rakesh,3,0,25,22
1657695252032,CSE 190,A00,092507,Dubnov; Shlomo,8,0,20,12
1657695258055,ECE 45,A01,083139,Congero; Spencer William,6,0,75,69
1657695264078,ECE 65,A50,083695,Saad; Andrew S,12,0,30,18
1657695264078,ECE 65,A51,095125,Saad; Andrew S,24,0,26,2
1657695270104,ECE 109,A01,091882,Touri; Behrouz,20,0,70,50
1657695276133,ECE 180,A00,083140,Abi Samra; Nicholas Camill,1,0,30,29
1657695276133,ECE 180,B00,083141,Abi Samra; Nicholas Camill,0,0,30,30
1657695282163,MATH 10A,A01,083735,Patchell; Gregory David,2,0,30,28
1657695282163,MATH 10A,A02,083736,Patchell; Gregory David,20,0,30,10
1657695282163,MATH 10A,A03,083737,Patchell; Gregory David,16,0,30,14
1657695288186,MATH 10B,A01,083207,Lim; Seonhee,8,0,34,26
1657695288186,MATH 10B,A02,083208,Lim; Seonhee,9,0,35,26
1657695288186,MATH 10B,A03,093472,Lim; Seonhee,7,0,34,27
1657695288186,MATH 10B,B01,083739,Sinha; Shubham,13,0,30,17
1657695294219,MATH 18,A01,083743,Cinel; Cameron Alexander,8,0,30,22
1657695294219,MATH 18,A02,083744,Cinel; Cameron Alexander,17,0,30,13
1657695294219,MATH 18,A03,083745,Cinel; Cameron Alexander,10,0,30,20
1657695294219,MATH 18,B01,083748,Rideout; David Porter,5,0,37,32
1657695294219,MATH 18,B02,083749,Rideout; David Porter,5,0,36,31
1657695294219,MATH 18,B03,083750,Rideout; David Porter,3,0,37,34
1657695294219,MATH 18,B04,083751,Rideout; David Porter,6,0,36,30
1657695294219,MATH 18,B05,093473,Rideout; David Porter,6,0,36,30
1657695294219,MATH 18,B06,093474,Rideout; David Porter,6,0,36,30
1657695300245,MATH 20A,A01,083754,Zheng; Zequn,14,0,40,26
1657695306267,MATH 20B,A01,083756,Briones; Jor-el Thomas Caparas,4,0,36,32
1657695306267,MATH 20B,A02,083757,Briones; Jor-el Thomas Caparas,1,0,36,35
1657695306267,MATH 20B,A03,093475,Briones; Jor-el Thomas Caparas,2,0,36,34
1657695312291,MATH 20C,A01,083760,Briones; Jor-el Thomas Caparas,1,0,35,34
1657695312291,MATH 20C,A02,083761,Briones; Jor-el Thomas Caparas,8,0,35,27
1657695312291,MATH 20C,A03,093476,Briones; Jor-el Thomas Caparas,0,1,36,36
1657695312291,MATH 20C,B01,083762,Bach; Quang Tran,1,0,30,29
1657695318318,MATH 20D,A01,083765,Tran; Brian Kha,5,0,30,25
1657695318318,MATH 20D,A02,083766,Tran; Brian Kha,5,0,30,25
1657695318318,MATH 20D,A03,083767,Tran; Brian Kha,5,0,30,25
1657695324348,MATH 20E,A01,083771,Ganguly; Soumya,9,0,32,23
1657695324348,MATH 20E,A02,083772,Ganguly; Soumya,6,0,32,26
1657695324348,MATH 20E,B01,083773,Ciotti; Benjamin,20,0,35,15
1657695324348,MATH 20E,B02,083774,Ciotti; Benjamin,18,0,35,17
1657695330371,MATH 103A,A01,083777,Greenfeld; Be'Eri,3,0,36,33
1657695330371,MATH 103A,A02,083778,Greenfeld; Be'Eri,5,0,36,31
1657695330371,MATH 103A,A03,093561,Greenfeld; Be'Eri,6,0,36,30
1657695330371,MATH 103A,B01,083779,Greenfeld; Be'Eri,7,0,36,29
1657695330371,MATH 103A,B02,083780,Greenfeld; Be'Eri,4,0,36,32
1657695330371,MATH 103A,B03,093562,Greenfeld; Be'Eri,3,0,36,33
1657695336394,MATH 105,A01,085443,Carter; Anne Toulson,15,0,35,20
1657695336394,MATH 105,A02,093477,Carter; Anne Toulson,20,0,35,15
1657695342418,MATH 109,A01,083213,Ganzberger; Geoffrey Michael,2,0,34,32
1657695342418,MATH 109,A02,083214,Ganzberger; Geoffrey Michael,4,0,34,30
1657695342418,MATH 109,A03,093478,Ganzberger; Geoffrey Michael,2,0,34,32
1657695342418,MATH 109,B01,083215,Ganzberger; Geoffrey Michael,1,0,32,31
1657695342418,MATH 109,B02,083216,Ganzberger; Geoffrey Michael,2,0,32,30
1657695342418,MATH 109,B03,093479,Ganzberger; Geoffrey Michael,8,0,32,24
1657695348449,MATH 142A,A01,083219,Chow; Bennett,7,0,32,25
1657695348449,MATH 142A,A02,083220,Chow; Bennett,10,0,32,22
1657695348449,MATH 142A,A03,093480,Chow; Bennett,9,0,32,23
1657695348449,MATH 142A,B03,093481,Chow; Bennett,8,0,32,24
1657695348449,MATH 142A,B04,093558,Chow; Bennett,13,0,32,19
1657695348449,MATH 142A,B05,093559,Chow; Bennett,6,0,32,26
1657695354477,MATH 193A,A01,083224,Rotar; Vladimir,8,0,34,26
1657695354477,MATH 193A,A02,083225,Rotar; Vladimir,9,0,34,25
1657695354477,MATH 193A,A03,083781,Rotar; Vladimir,5,0,34,29
1657695354477,MATH 193A,A04,083782,Rotar; Vladimir,10,0,34,24
1657695354477,MATH 193A,A05,093482,Rotar; Vladimir,10,0,34,24
1657695360500,MATH 197,001,091859,McAuley; Julian John,9999,0,9999,0
1657695360500,MATH 197,002,095566,Kedlaya; Kiran S.,9997,0,9999,2
1657695360500,MATH 197,003,095567,Xiao; Ming,9999,0,9999,0
1657695360500,MATH 197,004,095571,Perols; Johan Lars,9998,0,9999,1
1657695367563,COGS 9,A01,083615,Shannon; Kyle Michael,9,0,75,66
1657695373586,COGS 11,A01,083617,Boyle; Mary E. T.,23,0,48,25
1657695379607,COGS 13,A01,083071,Bastos; Amalia Pinkusfeld,11,0,71,60
1657695385639,COGS 14A,A01,092681,Semenuks; Arturs,5,1,100,95
1657695391683,COGS 14B,A01,083073,Cheng; Tzu-Han,6,0,63,57
1657695397707,COGS 17,A01,092677,Semenuks; Arturs,6,0,81,75
1657695403732,COGS 100,A01,083619,Allen; Michael Gordon,17,0,70,53
1657695409758,COGS 101A,A01,083621,Davis; Joshua Daniel,9,0,68,59
1657695415784,COGS 101B,A01,091572,Allen; Michael Gordon,12,0,65,53
1657695421807,COGS 101C,A01,083625,Delgado; Tania,17,0,35,18
1657695427829,COGS 107A,A01,083627,Boyle; Mary E. T.,13,0,60,47
1657695433851,COGS 118A,A01,083075,Gupta; Anjum,21,0,76,55
1657695439879,CSE 3,A50,083646,Miranda; Gregory Joseph,24,0,50,26
1657695445909,CSE 8A,A50,083650,Miranda; Gregory Joseph,17,1,56,39
1657695451931,CSE 11,A01,083080,Cao; Yingjun,6,15,40,34
1657695457952,CSE 12,A01,083652,Krause-Levy; Sophia Louisa,28,1,120,92
1657695463983,CSE 15L,A01,083654,Morris; Justin Loren,9,0,50,41
1657695463983,CSE 15L,A02,083655,Morris; Justin Loren,9,0,50,41
1657695470007,CSE 20,A01,083657,Tran; Khoa Dang,39,0,80,41
1657695476031,CSE 21,A01,095574,Bach; Quang Tran,22,0,48,26
1657695482065,CSE 30,A01,083084,Eldon; John,6,0,80,74
1657695482065,CSE 30,B01,095061,Bhaskar; Nishant,9,0,50,41
1657695488090,CSE 100,A01,083659,Cao; Yingjun,5,4,70,65
1657695494117,CSE 134B,A01,083661,Powell; Thomas Allan,23,0,100,77
1657695500140,CSE 140,A01,083663,Gungor; Onat,15,0,85,70
1657695506164,CSE 140L,A01,083088,Eldon; John,22,0,100,78
1657695512187,CSE 175,A01,083665,Kumar; Rakesh,3,0,25,22
1657695518211,CSE 190,A00,092507,Dubnov; Shlomo,8,0,20,12
1657695524237,ECE 45,A01,083139,Congero; Spencer William,6,0,75,69
1657695530260,ECE 65,A50,083695,Saad; Andrew S,12,0,30,18
1657695530260,ECE 65,A51,095125,Saad; Andrew S,24,0,26,2
1657695536286,ECE 109,A01,091882,Touri; Behrouz,20,0,70,50
1657695542310,ECE 180,A00,083140,Abi Samra; Nicholas Camill,1,0,30,29
1657695542310,ECE 180,B00,083141,Abi Samra; Nicholas Camill,0,0,30,30
1657695548333,MATH 10A,A01,083735,Patchell; Gregory David,2,0,30,28
1657695548333,MATH 10A,A02,083736,Patchell; Gregory David,20,0,30,10
1657695548333,MATH 10A,A03,083737,Patchell; Gregory David,16,0,30,14
1657695554360,MATH 10B,A01,083207,Lim; Seonhee,8,0,34,26
1657695554360,MATH 10B,A02,083208,Lim; Seonhee,9,0,35,26
1657695554360,MATH 10B,A03,093472,Lim; Seonhee,7,0,34,27
1657695554360,MATH 10B,B01,083739,Sinha; Shubham,13,0,30,17
1657695560392,MATH 18,A01,083743,Cinel; Cameron Alexander,8,0,30,22
1657695560392,MATH 18,A02,083744,Cinel; Cameron Alexander,17,0,30,13
1657695560392,MATH 18,A03,083745,Cinel; Cameron Alexander,10,0,30,20
1657695560392,MATH 18,B01,083748,Rideout; David Porter,5,0,37,32
1657695560392,MATH 18,B02,083749,Rideout; David Porter,5,0,36,31
1657695560392,MATH 18,B03,083750,Rideout; David Porter,3,0,37,34
1657695560392,MATH 18,B04,083751,Rideout; David Porter,6,0,36,30
1657695560392,MATH 18,B05,093473,Rideout; David Porter,6,0,36,30
1657695560392,MATH 18,B06,093474,Rideout; David Porter,6,0,36,30
1657695566420,MATH 20A,A01,083754,Zheng; Zequn,14,0,40,26
1657695572568,MATH 20B,A01,083756,Briones; Jor-el Thomas Caparas,4,0,36,32
1657695572568,MATH 20B,A02,083757,Briones; Jor-el Thomas Caparas,1,0,36,35
1657695572568,MATH 20B,A03,093475,Briones; Jor-el Thomas Caparas,2,0,36,34
1657695578595,MATH 20C,A01,083760,Briones; Jor-el Thomas Caparas,1,0,35,34
1657695578595,MATH 20C,A02,083761,Briones; Jor-el Thomas Caparas,8,0,35,27
1657695578595,MATH 20C,A03,093476,Briones; Jor-el Thomas Caparas,0,1,36,36
1657695578595,MATH 20C,B01,083762,Bach; Quang Tran,1,0,30,29
1657695584620,MATH 20D,A01,083765,Tran; Brian Kha,5,0,30,25
1657695584620,MATH 20D,A02,083766,Tran; Brian Kha,5,0,30,25
1657695584620,MATH 20D,A03,083767,Tran; Brian Kha,5,0,30,25
1657695590645,MATH 20E,A01,083771,Ganguly; Soumya,9,0,32,23
1657695590645,MATH 20E,A02,083772,Ganguly; Soumya,6,0,32,26
1657695590645,MATH 20E,B01,083773,Ciotti; Benjamin,20,0,35,15
1657695590645,MATH 20E,B02,083774,Ciotti; Benjamin,18,0,35,17
1657695596672,MATH 103A,A01,083777,Greenfeld; Be'Eri,3,0,36,33
1657695596672,MATH 103A,A02,083778,Greenfeld; Be'Eri,5,0,36,31
1657695596672,MATH 103A,A03,093561,Greenfeld; Be'Eri,6,0,36,30
1657695596672,MATH 103A,B01,083779,Greenfeld; Be'Eri,7,0,36,29
1657695596672,MATH 103A,B02,083780,Greenfeld; Be'Eri,4,0,36,32
1657695596672,MATH 103A,B03,093562,Greenfeld; Be'Eri,3,0,36,33
1657695602699,MATH 105,A01,085443,Carter; Anne Toulson,15,0,35,20
1657695602699,MATH 105,A02,093477,Carter; Anne Toulson,20,0,35,15
1657695608724,MATH 109,A01,083213,Ganzberger; Geoffrey Michael,2,0,34,32
1657695608724,MATH 109,A02,083214,Ganzberger; Geoffrey Michael,4,0,34,30
1657695608724,MATH 109,A03,093478,Ganzberger; Geoffrey Michael,2,0,34,32
1657695608724,MATH 109,B01,083215,Ganzberger; Geoffrey Michael,1,0,32,31
1657695608724,MATH 109,B02,083216,Ganzberger; Geoffrey Michael,2,0,32,30
1657695608724,MATH 109,B03,093479,Ganzberger; Geoffrey Michael,8,0,32,24
1657695614762,MATH 142A,A01,083219,Chow; Bennett,7,0,32,25
1657695614762,MATH 142A,A02,083220,Chow; Bennett,10,0,32,22
1657695614762,MATH 142A,A03,093480,Chow; Bennett,9,0,32,23
1657695614762,MATH 142A,B03,093481,Chow; Bennett,8,0,32,24
1657695614762,MATH 142A,B04,093558,Chow; Bennett,13,0,32,19
1657695614762,MATH 142A,B05,093559,Chow; Bennett,6,0,32,26
1657695620792,MATH 193A,A01,083224,Rotar; Vladimir,8,0,34,26
1657695620792,MATH 193A,A02,083225,Rotar; Vladimir,9,0,34,25
1657695620792,MATH 193A,A03,083781,Rotar; Vladimir,5,0,34,29
1657695620792,MATH 193A,A04,083782,Rotar; Vladimir,10,0,34,24
1657695620792,MATH 193A,A05,093482,Rotar; Vladimir,10,0,34,24
1657695626815,MATH 197,001,091859,McAuley; Julian John,9999,0,9999,0
1657695626815,MATH 197,002,095566,Kedlaya; Kiran S.,9997,0,9999,2
1657695626815,MATH 197,003,095567,Xiao; Ming,9999,0,9999,0
1657695626815,MATH 197,004,095571,Perols; Johan Lars,9998,0,9999,1
1657695633872,COGS 9,A01,083615,Shannon; Kyle Michael,9,0,75,66
1657695639901,COGS 11,A01,083617,Boyle; Mary E. T.,23,0,48,25
1657695645924,COGS 13,A01,083071,Bastos; Amalia Pinkusfeld,11,0,71,60
1657695651947,COGS 14A,A01,092681,Semenuks; Arturs,5,1,100,95
1657695657974,COGS 14B,A01,083073,Cheng; Tzu-Han,6,0,63,57
1657695664002,COGS 17,A01,092677,Semenuks; Arturs,6,0,81,75
1657695670030,COGS 100,A01,083619,Allen; Michael Gordon,17,0,70,53
1657695676054,COGS 101A,A01,083621,Davis; Joshua Daniel,9,0,68,59
1657695682081,COGS 101B,A01,091572,Allen; Michael Gordon,12,0,65,53
1657695688108,COGS 101C,A01,083625,Delgado; Tania,17,0,35,18
1657695694132,COGS 107A,A01,083627,Boyle; Mary E. T.,13,0,60,47
1657695700159,COGS 118A,A01,083075,Gupta; Anjum,21,0,76,55
1657695706183,CSE 3,A50,083646,Miranda; Gregory Joseph,24,0,50,26
1657695712209,CSE 8A,A50,083650,Miranda; Gregory Joseph,17,1,56,39
1657695718236,CSE 11,A01,083080,Cao; Yingjun,6,15,40,34
1657695724260,CSE 12,A01,083652,Krause-Levy; Sophia Louisa,28,1,120,92
1657695730283,CSE 15L,A01,083654,Morris; Justin Loren,9,0,50,41
1657695730283,CSE 15L,A02,083655,Morris; Justin Loren,9,0,50,41
1657695736310,CSE 20,A01,083657,Tran; Khoa Dang,39,0,80,41
1657695742334,CSE 21,A01,095574,Bach; Quang Tran,22,0,48,26
1657695748368,CSE 30,A01,083084,Eldon; John,6,0,80,74
1657695748368,CSE 30,B01,095061,Bhaskar; Nishant,9,0,50,41
1657695754398,CSE 100,A01,083659,Cao; Yingjun,5,4,70,65
1657695760421,CSE 134B,A01,083661,Powell; Thomas Allan,23,0,100,77
1657695766450,CSE 140,A01,083663,Gungor; Onat,15,0,85,70
1657695772475,CSE 140L,A01,083088,Eldon; John,22,0,100,78
1657695778497,CSE 175,A01,083665,Kumar; Rakesh,3,0,25,22
1657695784533,CSE 190,A00,092507,Dubnov; Shlomo,8,0,20,12
1657695790561,ECE 45,A01,083139,Congero; Spencer William,6,0,75,69
1657695796590,ECE 65,A50,083695,Saad; Andrew S,12,0,30,18
1657695796590,ECE 65,A51,095125,Saad; Andrew S,24,0,26,2
1657695802612,ECE 109,A01,091882,Touri; Behrouz,20,0,70,50
1657695808634,ECE 180,A00,083140,Abi Samra; Nicholas Camill,1,0,30,29
1657695808634,ECE 180,B00,083141,Abi Samra; Nicholas Camill,0,0,30,30
1657695814662,MATH 10A,A01,083735,Patchell; Gregory David,2,0,30,28
1657695814662,MATH 10A,A02,083736,Patchell; Gregory David,20,0,30,10
1657695814662,MATH 10A,A03,083737,Patchell; Gregory David,16,0,30,14
1657695820686,MATH 10B,A01,083207,Lim; Seonhee,8,0,34,26
1657695820686,MATH 10B,A02,083208,Lim; Seonhee,9,0,35,26
1657695820686,MATH 10B,A03,093472,Lim; Seonhee,7,0,34,27
1657695820686,MATH 10B,B01,083739,Sinha; Shubham,13,0,30,17
1657695826716,MATH 18,A01,083743,Cinel; Cameron Alexander,8,0,30,22
1657695826716,MATH 18,A02,083744,Cinel; Cameron Alexander,17,0,30,13
1657695826716,MATH 18,A03,083745,Cinel; Cameron Alexander,10,0,30,20
1657695826716,MATH 18,B01,083748,Rideout; David Porter,5,0,37,32
1657695826716,MATH 18,B02,083749,Rideout; David Porter,5,0,36,31
1657695826716,MATH 18,B03,083750,Rideout; David Porter,3,0,37,34
1657695826716,MATH 18,B04,083751,Rideout; David Porter,6,0,36,30
1657695826716,MATH 18,B05,093473,Rideout; David Porter,6,0,36,30
1657695826716,MATH 18,B06,093474,Rideout; David Porter,6,0,36,30
1657695832742,MATH 20A,A01,083754,Zheng; Zequn,14,0,40,26
1657695838764,MATH 20B,A01,083756,Briones; Jor-el Thomas Caparas,4,0,36,32
1657695838764,MATH 20B,A02,083757,Briones; Jor-el Thomas Caparas,1,0,36,35
1657695838764,MATH 20B,A03,093475,Briones; Jor-el Thomas Caparas,2,0,36,34
1657695844788,MATH 20C,A01,083760,Briones; Jor-el Thomas Caparas,1,0,35,34
1657695844788,MATH 20C,A02,083761,Briones; Jor-el Thomas Caparas,8,0,35,27
1657695844788,MATH 20C,A03,093476,Briones; Jor-el Thomas Caparas,0,1,36,36
1657695844788,MATH 20C,B01,083762,Bach; Quang Tran,1,0,30,29
1657695850823,MATH 20D,A01,083765,Tran; Brian Kha,5,0,30,25
1657695850823,MATH 20D,A02,083766,Tran; Brian Kha,5,0,30,25
1657695850823,MATH 20D,A03,083767,Tran; Brian Kha,5,0,30,25
1657695856845,MATH 20E,A01,083771,Ganguly; Soumya,9,0,32,23
1657695856845,MATH 20E,A02,083772,Ganguly; Soumya,6,0,32,26
1657695856845,MATH 20E,B01,083773,Ciotti; Benjamin,20,0,35,15
1657695856845,MATH 20E,B02,083774,Ciotti; Benjamin,18,0,35,17
1657695862869,MATH 103A,A01,083777,Greenfeld; Be'Eri,3,0,36,33
1657695862869,MATH 103A,A02,083778,Greenfeld; Be'Eri,5,0,36,31
1657695862869,MATH 103A,A03,093561,Greenfeld; Be'Eri,6,0,36,30
1657695862869,MATH 103A,B01,083779,Greenfeld; Be'Eri,7,0,36,29
1657695862869,MATH 103A,B02,083780,Greenfeld; Be'Eri,4,0,36,32
1657695862869,MATH 103A,B03,093562,Greenfeld; Be'Eri,3,0,36,33
1657695868909,MATH 105,A01,085443,Carter; Anne Toulson,15,0,35,20
1657695868909,MATH 105,A02,093477,Carter; Anne Toulson,20,0,35,15
1657695874932,MATH 109,A01,083213,Ganzberger; Geoffrey Michael,2,0,34,32
1657695874932,MATH 109,A02,083214,Ganzberger; Geoffrey Michael,4,0,34,30
1657695874932,MATH 109,A03,093478,Ganzberger; Geoffrey Michael,2,0,34,32
1657695874932,MATH 109,B01,083215,Ganzberger; Geoffrey Michael,1,0,32,31
1657695874932,MATH 109,B02,083216,Ganzberger; Geoffrey Michael,2,0,32,30
1657695874932,MATH 109,B03,093479,Ganzberger; Geoffrey Michael,8,0,32,24
1657695880962,MATH 142A,A01,083219,Chow; Bennett,7,0,32,25
1657695880962,MATH 142A,A02,083220,Chow; Bennett,10,0,32,22
1657695880962,MATH 142A,A03,093480,Chow; Bennett,9,0,32,23
1657695880962,MATH 142A,B03,093481,Chow; Bennett,8,0,32,24
1657695880962,MATH 142A,B04,093558,Chow; Bennett,13,0,32,19
1657695880962,MATH 142A,B05,093559,Chow; Bennett,6,0,32,26
1657695886985,MATH 193A,A01,083224,Rotar; Vladimir,8,0,34,26
1657695886985,MATH 193A,A02,083225,Rotar; Vladimir,9,0,34,25
1657695886985,MATH 193A,A03,083781,Rotar; Vladimir,5,0,34,29
1657695886985,MATH 193A,A04,083782,Rotar; Vladimir,10,0,34,24
1657695886985,MATH 193A,A05,093482,Rotar; Vladimir,10,0,34,24
1657695893025,MATH 197,001,091859,McAuley; Julian John,9999,0,9999,0
1657695893025,MATH 197,002,095566,Kedlaya; Kiran S.,9997,0,9999,2
1657695893025,MATH 197,003,095567,Xiao; Ming,9999,0,9999,0
1657695893025,MATH 197,004,095571,Perols; Johan Lars,9998,0,9999,1
1657695900087,COGS 9,A01,083615,Shannon; Kyle Michael,9,0,75,66
1657695906127,COGS 11,A01,083617,Boyle; Mary E. T.,23,0,48,25
1657695912158,COGS 13,A01,083071,Bastos; Amalia Pinkusfeld,11,0,71,60
1657695918186,COGS 14A,A01,092681,Semenuks; Arturs,5,1,100,95
1657695924209,COGS 14B,A01,083073,Cheng; Tzu-Han,6,0,63,57
1657695930236,COGS 17,A01,092677,Semenuks; Arturs,6,0,81,75
1657695936259,COGS 100,A01,083619,Allen; Michael Gordon,17,0,70,53
1657695942282,COGS 101A,A01,083621,Davis; Joshua Daniel,9,0,68,59
1657695948305,COGS 101B,A01,091572,Allen; Michael Gordon,12,0,65,53
1657695954328,COGS 101C,A01,083625,Delgado; Tania,17,0,35,18
1657695960350,COGS 107A,A01,083627,Boyle; Mary E. T.,13,0,60,47
1657695966375,COGS 118A,A01,083075,Gupta; Anjum,21,0,76,55
1657695972404,CSE 3,A50,083646,Miranda; Gregory Joseph,24,0,50,26
1657695978431,CSE 8A,A50,083650,Miranda; Gregory Joseph,17,1,56,39
1657695984457,CSE 11,A01,083080,Cao; Yingjun,6,15,40,34
1657695990484,CSE 12,A01,083652,Krause-Levy; Sophia Louisa,28,1,120,92
1657695996507,CSE 15L,A01,083654,Morris; Justin Loren,9,0,50,41
1657695996507,CSE 15L,A02,083655,Morris; Justin Loren,9,0,50,41
1657696002531,CSE 20,A01,083657,Tran; Khoa Dang,39,0,80,41
1657696008554,CSE 21,A01,095574,Bach; Quang Tran,22,0,48,26
1657696014577,CSE 30,A01,083084,Eldon; John,6,0,80,74
1657696014577,CSE 30,B01,095061,Bhaskar; Nishant,9,0,50,41
1657696020602,CSE 100,A01,083659,Cao; Yingjun,5,4,70,65
1657696026629,CSE 134B,A01,083661,Powell; Thomas Allan,23,0,100,77
1657696032651,CSE 140,A01,083663,Gungor; Onat,15,0,85,70
1657696038679,CSE 140L,A01,083088,Eldon; John,22,0,100,78
1657696044706,CSE 175,A01,083665,Kumar; Rakesh,3,0,25,22
1657696050732,CSE 190,A00,092507,Dubnov; Shlomo,8,0,20,12
1657696056754,ECE 45,A01,083139,Congero; Spencer William,6,0,75,69
1657696062782,ECE 65,A50,083695,Saad; Andrew S,12,0,30,18
1657696062782,ECE 65,A51,095125,Saad; Andrew S,24,0,26,2
1657696068805,ECE 109,A01,091882,Touri; Behrouz,20,0,70,50
1657696074828,ECE 180,A00,083140,Abi Samra; Nicholas Camill,1,0,30,29
1657696074828,ECE 180,B00,083141,Abi Samra; Nicholas Camill,0,0,30,30
1657696080850,MATH 10A,A01,083735,Patchell; Gregory David,2,0,30,28
1657696080850,MATH 10A,A02,083736,Patchell; Gregory David,20,0,30,10
1657696080850,MATH 10A,A03,083737,Patchell; Gregory David,16,0,30,14
1657696086879,MATH 10B,A01,083207,Lim; Seonhee,8,0,34,26
1657696086879,MATH 10B,A02,083208,Lim; Seonhee,9,0,35,26
1657696086879,MATH 10B,A03,093472,Lim; Seonhee,7,0,34,27
1657696086879,MATH 10B,B01,083739,Sinha; Shubham,13,0,30,17
1657696092910,MATH 18,A01,083743,Cinel; Cameron Alexander,8,0,30,22
1657696092910,MATH 18,A02,083744,Cinel; Cameron Alexander,17,0,30,13
1657696092910,MATH 18,A03,083745,Cinel; Cameron Alexander,10,0,30,20
1657696092910,MATH 18,B01,083748,Rideout; David Porter,5,0,37,32
1657696092910,MATH 18,B02,083749,Rideout; David Porter,5,0,36,31
1657696092910,MATH 18,B03,083750,Rideout; David Porter,3,0,37,34
1657696092910,MATH 18,B04,083751,Rideout; David Porter,6,0,36,30
1657696092910,MATH 18,B05,093473,Rideout; David Porter,6,0,36,30
1657696092910,MATH 18,B06,093474,Rideout; David Porter,6,0,36,30
1657696098933,MATH 20A,A01,083754,Zheng; Zequn,14,0,40,26
1657696104956,MATH 20B,A01,083756,Briones; Jor-el Thomas Caparas,4,0,36,32
1657696104956,MATH 20B,A02,083757,Briones; Jor-el Thomas Caparas,1,0,36,35
1657696104956,MATH 20B,A03,093475,Briones; Jor-el Thomas Caparas,2,0,36,34
1657696110979,MATH 20C,A01,083760,Briones; Jor-el Thomas Caparas,1,0,35,34
1657696110979,MATH 20C,A02,083761,Briones; Jor-el Thomas Caparas,8,0,35,27
1657696110979,MATH 20C,A03,093476,Briones; Jor-el Thomas Caparas,0,1,36,36
1657696110979,MATH 20C,B01,083762,Bach; Quang Tran,1,0,30,29
1657696117008,MATH 20D,A01,083765,Tran; Brian Kha,5,0,30,25
1657696117008,MATH 20D,A02,083766,Tran; Brian Kha,5,0,30,25
1657696117008,MATH 20D,A03,083767,Tran; Brian Kha,5,0,30,25
1657696123030,MATH 20E,A01,083771,Ganguly; Soumya,9,0,32,23
1657696123030,MATH 20E,A02,083772,Ganguly; Soumya,6,0,32,26
1657696123030,MATH 20E,B01,083773,Ciotti; Benjamin,20,0,35,15
1657696123030,MATH 20E,B02,083774,Ciotti; Benjamin,18,0,35,17
1657696129058,MATH 103A,A01,083777,Greenfeld; Be'Eri,3,0,36,33
1657696129058,MATH 103A,A02,083778,Greenfeld; Be'Eri,5,0,36,31
1657696129058,MATH 103A,A03,093561,Greenfeld; Be'Eri,6,0,36,30
1657696129058,MATH 103A,B01,083779,Greenfeld; Be'Eri,7,0,36,29
1657696129058,MATH 103A,B02,083780,Greenfeld; Be'Eri,4,0,36,32
1657696129058,MATH 103A,B03,093562,Greenfeld; Be'Eri,3,0,36,33
1657696135079,MATH 105,A01,085443,Carter; Anne Toulson,15,0,35,20
1657696135079,MATH 105,A02,093477,Carter; Anne Toulson,20,0,35,15
1657696141117,MATH 109,A01,083213,Ganzberger; Geoffrey Michael,2,0,34,32
1657696141117,MATH 109,A02,083214,Ganzberger; Geoffrey Michael,4,0,34,30
1657696141117,MATH 109,A03,093478,Ganzberger; Geoffrey Michael,2,0,34,32
1657696141117,MATH 109,B01,083215,Ganzberger; Geoffrey Michael,1,0,32,31
1657696141117,MATH 109,B02,083216,Ganzberger; Geoffrey Michael,2,0,32,30
1657696141117,MATH 109,B03,093479,Ganzberger; Geoffrey Michael,8,0,32,24
1657696147140,MATH 142A,A01,083219,Chow; Bennett,7,0,32,25
1657696147140,MATH 142A,A02,083220,Chow; Bennett,10,0,32,22
1657696147140,MATH 142A,A03,093480,Chow; Bennett,9,0,32,23
1657696147140,MATH 142A,B03,093481,Chow; Bennett,8,0,32,24
1657696147140,MATH 142A,B04,093558,Chow; Bennett,13,0,32,19
1657696147140,MATH 142A,B05,093559,Chow; Bennett,6,0,32,26
1657696153171,MATH 193A,A01,083224,Rotar; Vladimir,8,0,34,26
1657696153171,MATH 193A,A02,083225,Rotar; Vladimir,9,0,34,25
1657696153171,MATH 193A,A03,083781,Rotar; Vladimir,5,0,34,29
1657696153171,MATH 193A,A04,083782,Rotar; Vladimir,10,0,34,24
1657696153171,MATH 193A,A05,093482,Rotar; Vladimir,10,0,34,24
1657696159194,MATH 197,001,091859,McAuley; Julian John,9999,0,9999,0
1657696159194,MATH 197,002,095566,Kedlaya; Kiran S.,9997,0,9999,2
1657696159194,MATH 197,003,095567,Xiao; Ming,9999,0,9999,0
1657696159194,MATH 197,004,095571,Perols; Johan Lars,9998,0,9999,1
1657696166362,COGS 9,A01,083615,Shannon; Kyle Michael,9,0,75,66
1657696172385,COGS 11,A01,083617,Boyle; Mary E. T.,23,0,48,25
1657696178412,COGS 13,A01,083071,Bastos; Amalia Pinkusfeld,11,0,71,60
1657696184441,COGS 14A,A01,092681,Semenuks; Arturs,5,1,100,95
1657696190463,COGS 14B,A01,083073,Cheng; Tzu-Han,6,0,63,57
1657696196490,COGS 17,A01,092677,Semenuks; Arturs,6,0,81,75
1657696202512,COGS 100,A01,083619,Allen; Michael Gordon,17,0,70,53
1657696208535,COGS 101A,A01,083621,Davis; Joshua Daniel,9,0,68,59
1657696214558,COGS 101B,A01,091572,Allen; Michael Gordon,12,0,65,53
1657696220593,COGS 101C,A01,083625,Delgado; Tania,17,0,35,18
1657696226626,COGS 107A,A01,083627,Boyle; Mary E. T.,13,0,60,47
1657696232652,COGS 118A,A01,083075,Gupta; Anjum,21,0,76,55
1657696238676,CSE 3,A50,083646,Miranda; Gregory Joseph,24,0,50,26
1657696244698,CSE 8A,A50,083650,Miranda; Gregory Joseph,17,1,56,39
1657696250720,CSE 11,A01,083080,Cao; Yingjun,6,15,40,34
1657696256742,CSE 12,A01,083652,Krause-Levy; Sophia Louisa,28,1,120,92
1657696262795,CSE 15L,A01,083654,Morris; Justin Loren,9,0,50,41
1657696262795,CSE 15L,A02,083655,Morris; Justin Loren,9,0,50,41
1657696268818,CSE 20,A01,083657,Tran; Khoa Dang,39,0,80,41
1657696274849,CSE 21,A01,095574,Bach; Quang Tran,22,0,48,26
1657696280875,CSE 30,A01,083084,Eldon; John,6,0,80,74
1657696280875,CSE 30,B01,095061,Bhaskar; Nishant,9,0,50,41
1657696286903,CSE 100,A01,083659,Cao; Yingjun,5,4,70,65
1657696292926,CSE 134B,A01,083661,Powell; Thomas Allan,23,0,100,77
1657696298951,CSE 140,A01,083663,Gungor; Onat,15,0,85,70
1657696304974,CSE 140L,A01,083088,Eldon; John,22,0,100,78
1657696311004,CSE 175,A01,083665,Kumar; Rakesh,3,0,25,22
1657696317027,CSE 190,A00,092507,Dubnov; Shlomo,8,0,20,12
1657696323054,ECE 45,A01,083139,Congero; Spencer William,6,0,75,69
1657696329079,ECE 65,A50,083695,Saad; Andrew S,12,0,30,18
1657696329079,ECE 65,A51,095125,Saad; Andrew S,24,0,26,2
1657696335102,ECE 109,A01,091882,Touri; Behrouz,20,0,70,50
1657696341125,ECE 180,A00,083140,Abi Samra; Nicholas Camill,1,0,30,29
1657696341125,ECE 180,B00,083141,Abi Samra; Nicholas Camill,0,0,30,30
1657696347155,MATH 10A,A01,083735,Patchell; Gregory David,2,0,30,28
1657696347155,MATH 10A,A02,083736,Patchell; Gregory David,20,0,30,10
1657696347155,MATH 10A,A03,083737,Patchell; Gregory David,16,0,30,14
1657696353186,MATH 10B,A01,083207,Lim; Seonhee,8,0,34,26
1657696353186,MATH 10B,A02,083208,Lim; Seonhee,9,0,35,26
1657696353186,MATH 10B,A03,093472,Lim; Seonhee,7,0,34,27
1657696353186,MATH 10B,B01,083739,Sinha; Shubham,13,0,30,17
1657696359212,MATH 18,A01,083743,Cinel; Cameron Alexander,8,0,30,22
1657696359212,MATH 18,A02,083744,Cinel; Cameron Alexander,17,0,30,13
1657696359212,MATH 18,A03,083745,Cinel; Cameron Alexander,10,0,30,20
1657696359212,MATH 18,B01,083748,Rideout; David Porter,5,0,37,32
1657696359212,MATH 18,B02,083749,Rideout; David Porter,5,0,36,31
1657696359212,MATH 18,B03,083750,Rideout; David Porter,3,0,37,34
1657696359212,MATH 18,B04,083751,Rideout; David Porter,6,0,36,30
1657696359212,MATH 18,B05,093473,Rideout; David Porter,6,0,36,30
1657696359212,MATH 18,B06,093474,Rideout; David Porter,6,0,36,30
1657696365239,MATH 20A,A01,083754,Zheng; Zequn,14,0,40,26
1657696371263,MATH 20B,A01,083756,Briones; Jor-el Thomas Caparas,4,0,36,32
1657696371263,MATH 20B,A02,083757,Briones; Jor-el Thomas Caparas,1,0,36,35
1657696371263,MATH 20B,A03,093475,Briones; Jor-el Thomas Caparas,2,0,36,34
1657696377291,MATH 20C,A01,083760,Briones; Jor-el Thomas Caparas,1,0,35,34
1657696377291,MATH 20C,A02,083761,Briones; Jor-el Thomas Caparas,8,0,35,27
1657696377291,MATH 20C,A03,093476,Briones; Jor-el Thomas Caparas,0,1,36,36
1657696377291,MATH 20C,B01,083762,Bach; Quang Tran,1,0,30,29
1657696383321,MATH 20D,A01,083765,Tran; Brian Kha,5,0,30,25
1657696383321,MATH 20D,A02,083766,Tran; Brian Kha,5,0,30,25
1657696383321,MATH 20D,A03,083767,Tran; Brian Kha,5,0,30,25
1657696389350,MATH 20E,A01,083771,Ganguly; Soumya,9,0,32,23
1657696389350,MATH 20E,A02,083772,Ganguly; Soumya,6,0,32,26
1657696389350,MATH 20E,B01,083773,Ciotti; Benjamin,20,0,35,15
1657696389350,MATH 20E,B02,083774,Ciotti; Benjamin,18,0,35,17
1657696395383,MATH 103A,A01,083777,Greenfeld; Be'Eri,3,0,36,33
1657696395383,MATH 103A,A02,083778,Greenfeld; Be'Eri,5,0,36,31
1657696395383,MATH 103A,A03,093561,Greenfeld; Be'Eri,6,0,36,30
1657696395383,MATH 103A,B01,083779,Greenfeld; Be'Eri,7,0,36,29
1657696395383,MATH 103A,B02,083780,Greenfeld; Be'Eri,4,0,36,32
1657696395383,MATH 103A,B03,093562,Greenfeld; Be'Eri,3,0,36,33
1657696401408,MATH 105,A01,085443,Carter; Anne Toulson,15,0,35,20
1657696401408,MATH 105,A02,093477,Carter; Anne Toulson,20,0,35,15
1657696407435,MATH 109,A01,083213,Ganzberger; Geoffrey Michael,2,0,34,32
1657696407435,MATH 109,A02,083214,Ganzberger; Geoffrey Michael,4,0,34,30
1657696407435,MATH 109,A03,093478,Ganzberger; Geoffrey Michael,2,0,34,32
1657696407435,MATH 109,B01,083215,Ganzberger; Geoffrey Michael,1,0,32,31
1657696407435,MATH 109,B02,083216,Ganzberger; Geoffrey Michael,2,0,32,30
1657696407435,MATH 109,B03,093479,Ganzberger; Geoffrey Michael,8,0,32,24
1657696413458,MATH 142A,A01,083219,Chow; Bennett,7,0,32,25
1657696413458,MATH 142A,A02,083220,Chow; Bennett,10,0,32,22
1657696413458,MATH 142A,A03,093480,Chow; Bennett,9,0,32,23
1657696413458,MATH 142A,B03,093481,Chow; Bennett,8,0,32,24
1657696413458,MATH 142A,B04,093558,Chow; Bennett,13,0,32,19
1657696413458,MATH 142A,B05,093559,Chow; Bennett,6,0,32,26
1657696419488,MATH 193A,A01,083224,Rotar; Vladimir,8,0,34,26
1657696419488,MATH 193A,A02,083225,Rotar; Vladimir,9,0,34,25
1657696419488,MATH 193A,A03,083781,Rotar; Vladimir,5,0,34,29
1657696419488,MATH 193A,A04,083782,Rotar; Vladimir,10,0,34,24
1657696419488,MATH 193A,A05,093482,Rotar; Vladimir,10,0,34,24
1657696425512,MATH 197,001,091859,McAuley; Julian John,9999,0,9999,0
1657696425512,MATH 197,002,095566,Kedlaya; Kiran S.,9997,0,9999,2
1657696425512,MATH 197,003,095567,Xiao; Ming,9999,0,9999,0
1657696425512,MATH 197,004,095571,Perols; Johan Lars,9998,0,9999,1
1657696432583,COGS 9,A01,083615,Shannon; Kyle Michael,9,0,75,66
1657696438606,COGS 11,A01,083617,Boyle; Mary E. T.,23,0,48,25
1657696444632,COGS 13,A01,083071,Bastos; Amalia Pinkusfeld,11,0,71,60
1657696450660,COGS 14A,A01,092681,Semenuks; Arturs,5,1,100,95
1657696456682,COGS 14B,A01,083073,Cheng; Tzu-Han,6,0,63,57
1657696462709,COGS 17,A01,092677,Semenuks; Arturs,6,0,81,75
1657696468731,COGS 100,A01,083619,Allen; Michael Gordon,17,0,70,53
1657696474754,COGS 101A,A01,083621,Davis; Joshua Daniel,9,0,68,59
1657696480777,COGS 101B,A01,091572,Allen; Michael Gordon,12,0,65,53
1657696486804,COGS 101C,A01,083625,Delgado; Tania,17,0,35,18
1657696492826,COGS 107A,A01,083627,Boyle; Mary E. T.,13,0,60,47
1657696498849,COGS 118A,A01,083075,Gupta; Anjum,21,0,76,55
1657696504872,CSE 3,A50,083646,Miranda; Gregory Joseph,24,0,50,26
1657696510895,CSE 8A,A50,083650,Miranda; Gregory Joseph,17,1,56,39
1657696516923,CSE 11,A01,083080,Cao; Yingjun,6,15,40,34
1657696522952,CSE 12,A01,083652,Krause-Levy; Sophia Louisa,28,1,120,92
1657696528975,CSE 15L,A01,083654,Morris; Justin Loren,9,0,50,41
1657696528975,CSE 15L,A02,083655,Morris; Justin Loren,9,0,50,41
1657696534998,CSE 20,A01,083657,Tran; Khoa Dang,39,0,80,41
1657696541022,CSE 21,A01,095574,Bach; Quang Tran,22,0,48,26
1657696547050,CSE 30,A01,083084,Eldon; John,6,0,80,74
1657696547050,CSE 30,B01,095061,Bhaskar; Nishant,9,0,50,41
1657696553082,CSE 100,A01,083659,Cao; Yingjun,5,4,70,65
1657696559106,CSE 134B,A01,083661,Powell; Thomas Allan,23,0,100,77
1657696565131,CSE 140,A01,083663,Gungor; Onat,15,0,85,70
1657696571155,CSE 140L,A01,083088,Eldon; John,22,0,100,78
1657696577183,CSE 175,A01,083665,Kumar; Rakesh,3,0,25,22
1657696583212,CSE 190,A00,092507,Dubnov; Shlomo,8,0,20,12
1657696589236,ECE 45,A01,083139,Congero; Spencer William,6,0,75,69
1657696595264,ECE 65,A50,083695,Saad; Andrew S,12,0,30,18
1657696595264,ECE 65,A51,095125,Saad; Andrew S,24,0,26,2
1657696601291,ECE 109,A01,091882,Touri; Behrouz,20,0,70,50
1657696607315,ECE 180,A00,083140,Abi Samra; Nicholas Camill,1,0,30,29
1657696607315,ECE 180,B00,083141,Abi Samra; Nicholas Camill,0,0,30,30
1657696613351,MATH 10A,A01,083735,Patchell; Gregory David,2,0,30,28
1657696613351,MATH 10A,A02,083736,Patchell; Gregory David,20,0,30,10
1657696613351,MATH 10A,A03,083737,Patchell; Gregory David,16,0,30,14
1657696619383,MATH 10B,A01,083207,Lim; Seonhee,8,0,34,26
1657696619383,MATH 10B,A02,083208,Lim; Seonhee,9,0,35,26
1657696619383,MATH 10B,A03,093472,Lim; Seonhee,7,0,34,27
1657696619383,MATH 10B,B01,083739,Sinha; Shubham,13,0,30,17
1657696625418,MATH 18,A01,083743,Cinel; Cameron Alexander,8,0,30,22
1657696625418,MATH 18,A02,083744,Cinel; Cameron Alexander,17,0,30,13
1657696625418,MATH 18,A03,083745,Cinel; Cameron Alexander,10,0,30,20
1657696625418,MATH 18,B01,083748,Rideout; David Porter,5,0,37,32
1657696625418,MATH 18,B02,083749,Rideout; David Porter,5,0,36,31
1657696625418,MATH 18,B03,083750,Rideout; David Porter,3,0,37,34
1657696625418,MATH 18,B04,083751,Rideout; David Porter,6,0,36,30
1657696625418,MATH 18,B05,093473,Rideout; David Porter,6,0,36,30
1657696625418,MATH 18,B06,093474,Rideout; David Porter,6,0,36,30
1657696631441,MATH 20A,A01,083754,Zheng; Zequn,14,0,40,26
1657696637469,MATH 20B,A01,083756,Briones; Jor-el Thomas Caparas,4,0,36,32
1657696637469,MATH 20B,A02,083757,Briones; Jor-el Thomas Caparas,1,0,36,35
1657696637469,MATH 20B,A03,093475,Briones; Jor-el Thomas Caparas,2,0,36,34
1657696643493,MATH 20C,A01,083760,Briones; Jor-el Thomas Caparas,1,0,35,34
1657696643493,MATH 20C,A02,083761,Briones; Jor-el Thomas Caparas,8,0,35,27
1657696643493,MATH 20C,A03,093476,Briones; Jor-el Thomas Caparas,0,1,36,36
1657696643493,MATH 20C,B01,083762,Bach; Quang Tran,1,0,30,29
1657696649528,MATH 20D,A01,083765,Tran; Brian Kha,5,0,30,25
1657696649528,MATH 20D,A02,083766,Tran; Brian Kha,5,0,30,25
1657696649528,MATH 20D,A03,083767,Tran; Brian Kha,5,0,30,25
1657696655552,MATH 20E,A01,083771,Ganguly; Soumya,9,0,32,23
1657696655552,MATH 20E,A02,083772,Ganguly; Soumya,6,0,32,26
1657696655552,MATH 20E,B01,083773,Ciotti; Benjamin,20,0,35,15
1657696655552,MATH 20E,B02,083774,Ciotti; Benjamin,18,0,35,17
1657696661579,MATH 103A,A01,083777,Greenfeld; Be'Eri,3,0,36,33
1657696661579,MATH 103A,A02,083778,Greenfeld; Be'Eri,5,0,36,31
1657696661579,MATH 103A,A03,093561,Greenfeld; Be'Eri,6,0,36,30
1657696661579,MATH 103A,B01,083779,Greenfeld; Be'Eri,7,0,36,29
1657696661579,MATH 103A,B02,083780,Greenfeld; Be'Eri,4,0,36,32
1657696661579,MATH 103A,B03,093562,Greenfeld; Be'Eri,3,0,36,33
1657696667608,MATH 105,A01,085443,Carter; Anne Toulson,15,0,35,20
1657696667608,MATH 105,A02,093477,Carter; Anne Toulson,20,0,35,15
1657696673636,MATH 109,A01,083213,Ganzberger; Geoffrey Michael,2,0,34,32
1657696673636,MATH 109,A02,083214,Ganzberger; Geoffrey Michael,4,0,34,30
1657696673636,MATH 109,A03,093478,Ganzberger; Geoffrey Michael,2,0,34,32
1657696673636,MATH 109,B01,083215,Ganzberger; Geoffrey Michael,1,0,32,31
1657696673636,MATH 109,B02,083216,Ganzberger; Geoffrey Michael,2,0,32,30
1657696673636,MATH 109,B03,093479,Ganzberger; Geoffrey Michael,8,0,32,24
1657696679665,MATH 142A,A01,083219,Chow; Bennett,7,0,32,25
1657696679665,MATH 142A,A02,083220,Chow; Bennett,10,0,32,22
1657696679665,MATH 142A,A03,093480,Chow; Bennett,9,0,32,23
1657696679665,MATH 142A,B03,093481,Chow; Bennett,8,0,32,24
1657696679665,MATH 142A,B04,093558,Chow; Bennett,13,0,32,19
1657696679665,MATH 142A,B05,093559,Chow; Bennett,6,0,32,26
1657696685688,MATH 193A,A01,083224,Rotar; Vladimir,8,0,34,26
1657696685688,MATH 193A,A02,083225,Rotar; Vladimir,9,0,34,25
1657696685688,MATH 193A,A03,083781,Rotar; Vladimir,5,0,34,29
1657696685688,MATH 193A,A04,083782,Rotar; Vladimir,10,0,34,24
1657696685688,MATH 193A,A05,093482,Rotar; Vladimir,10,0,34,24
1657696691716,MATH 197,001,091859,McAuley; Julian John,9999,0,9999,0
1657696691716,MATH 197,002,095566,Kedlaya; Kiran S.,9997,0,9999,2
1657696691716,MATH 197,003,095567,Xiao; Ming,9999,0,9999,0
1657696691716,MATH 197,004,095571,Perols; Johan Lars,9998,0,9999,1
1657696698778,COGS 9,A01,083615,Shannon; Kyle Michael,9,0,75,66
1657696704802,COGS 11,A01,083617,Boyle; Mary E. T.,23,0,48,25
1657696710829,COGS 13,A01,083071,Bastos; Amalia Pinkusfeld,11,0,71,60
1657696716858,COGS 14A,A01,092681,Semenuks; Arturs,5,1,100,95
1657696722893,COGS 14B,A01,083073,Cheng; Tzu-Han,6,0,63,57
1657696728917,COGS 17,A01,092677,Semenuks; Arturs,6,0,81,75
1657696734940,COGS 100,A01,083619,Allen; Michael Gordon,17,0,70,53
1657696740970,COGS 101A,A01,083621,Davis; Joshua Daniel,9,0,68,59
1657696746993,COGS 101B,A01,091572,Allen; Michael Gordon,12,0,65,53
1657696753020,COGS 101C,A01,083625,Delgado; Tania,17,0,35,18
1657696759049,COGS 107A,A01,083627,Boyle; Mary E. T.,13,0,60,47
1657696765147,COGS 118A,A01,083075,Gupta; Anjum,21,0,76,55
1657696771177,CSE 3,A50,083646,Miranda; Gregory Joseph,24,0,50,26
1657696777199,CSE 8A,A50,083650,Miranda; Gregory Joseph,17,1,56,39
1657696783222,CSE 11,A01,083080,Cao; Yingjun,6,15,40,34
1657696789246,CSE 12,A01,083652,Krause-Levy; Sophia Louisa,28,1,120,92
1657696795271,CSE 15L,A01,083654,Morris; Justin Loren,9,0,50,41
1657696795271,CSE 15L,A02,083655,Morris; Justin Loren,9,0,50,41
1657696801297,CSE 20,A01,083657,Tran; Khoa Dang,39,0,80,41
1657696807326,CSE 21,A01,095574,Bach; Quang Tran,22,0,48,26
1657696813348,CSE 30,A01,083084,Eldon; John,6,0,80,74
1657696813348,CSE 30,B01,095061,Bhaskar; Nishant,9,0,50,41
1657696819388,CSE 100,A01,083659,Cao; Yingjun,5,4,70,65
1657696825416,CSE 134B,A01,083661,Powell; Thomas Allan,23,0,100,77
1657696831441,CSE 140,A01,083663,Gungor; Onat,15,0,85,70
1657696837467,CSE 140L,A01,083088,Eldon; John,22,0,100,78
1657696843494,CSE 175,A01,083665,Kumar; Rakesh,3,0,25,22
1657696849522,CSE 190,A00,092507,Dubnov; Shlomo,8,0,20,12
1657696855545,ECE 45,A01,083139,Congero; Spencer William,6,0,75,69
1657696861594,ECE 65,A50,083695,Saad; Andrew S,12,0,30,18
1657696861594,ECE 65,A51,095125,Saad; Andrew S,24,0,26,2
1657696867618,ECE 109,A01,091882,Touri; Behrouz,20,0,70,50
1657696873642,ECE 180,A00,083140,Abi Samra; Nicholas Camill,1,0,30,29
1657696873642,ECE 180,B00,083141,Abi Samra; Nicholas Camill,0,0,30,30
1657696879672,MATH 10A,A01,083735,Patchell; Gregory David,2,0,30,28
1657696879672,MATH 10A,A02,083736,Patchell; Gregory David,20,0,30,10
1657696879672,MATH 10A,A03,083737,Patchell; Gregory David,16,0,30,14
1657696885702,MATH 10B,A01,083207,Lim; Seonhee,8,0,34,26
1657696885702,MATH 10B,A02,083208,Lim; Seonhee,9,0,35,26
1657696885702,MATH 10B,A03,093472,Lim; Seonhee,7,0,34,27
1657696885702,MATH 10B,B01,083739,Sinha; Shubham,13,0,30,17
1657696891728,MATH 18,A01,083743,Cinel; Cameron Alexander,8,0,30,22
1657696891728,MATH 18,A02,083744,Cinel; Cameron Alexander,17,0,30,13
1657696891728,MATH 18,A03,083745,Cinel; Cameron Alexander,10,0,30,20
1657696891728,MATH 18,B01,083748,Rideout; David Porter,5,0,37,32
1657696891728,MATH 18,B02,083749,Rideout; David Porter,5,0,36,31
1657696891728,MATH 18,B03,083750,Rideout; David Porter,3,0,37,34
1657696891728,MATH 18,B04,083751,Rideout; David Porter,6,0,36,30
1657696891728,MATH 18,B05,093473,Rideout; David Porter,6,0,36,30
1657696891728,MATH 18,B06,093474,Rideout; David Porter,6,0,36,30
1657696897753,MATH 20A,A01,083754,Zheng; Zequn,14,0,40,26
1657696903781,MATH 20B,A01,083756,Briones; Jor-el Thomas Caparas,4,0,36,32
1657696903781,MATH 20B,A02,083757,Briones; Jor-el Thomas Caparas,1,0,36,35
1657696903781,MATH 20B,A03,093475,Briones; Jor-el Thomas Caparas,2,0,36,34
1657696909805,MATH 20C,A01,083760,Briones; Jor-el Thomas Caparas,1,0,35,34
1657696909805,MATH 20C,A02,083761,Briones; Jor-el Thomas Caparas,8,0,35,27
1657696909805,MATH 20C,A03,093476,Briones; Jor-el Thomas Caparas,0,1,36,36
1657696909805,MATH 20C,B01,083762,Bach; Quang Tran,1,0,30,29
1657696915827,MATH 20D,A01,083765,Tran; Brian Kha,5,0,30,25
1657696915827,MATH 20D,A02,083766,Tran; Brian Kha,5,0,30,25
1657696915827,MATH 20D,A03,083767,Tran; Brian Kha,5,0,30,25
1657696921859,MATH 20E,A01,083771,Ganguly; Soumya,9,0,32,23
1657696921859,MATH 20E,A02,083772,Ganguly; Soumya,6,0,32,26
1657696921859,MATH 20E,B01,083773,Ciotti; Benjamin,20,0,35,15
1657696921859,MATH 20E,B02,083774,Ciotti; Benjamin,18,0,35,17
1657696927894,MATH 103A,A01,083777,Greenfeld; Be'Eri,3,0,36,33
1657696927894,MATH 103A,A02,083778,Greenfeld; Be'Eri,5,0,36,31
1657696927894,MATH 103A,A03,093561,Greenfeld; Be'Eri,6,0,36,30
1657696927894,MATH 103A,B01,083779,Greenfeld; Be'Eri,7,0,36,29
1657696927894,MATH 103A,B02,083780,Greenfeld; Be'Eri,4,0,36,32
1657696927894,MATH 103A,B03,093562,Greenfeld; Be'Eri,3,0,36,33
1657696933921,MATH 105,A01,085443,Carter; Anne Toulson,15,0,35,20
1657696933921,MATH 105,A02,093477,Carter; Anne Toulson,20,0,35,15
1657696939945,MATH 109,A01,083213,Ganzberger; Geoffrey Michael,2,0,34,32
1657696939945,MATH 109,A02,083214,Ganzberger; Geoffrey Michael,4,0,34,30
1657696939945,MATH 109,A03,093478,Ganzberger; Geoffrey Michael,2,0,34,32
1657696939945,MATH 109,B01,083215,Ganzberger; Geoffrey Michael,1,0,32,31
1657696939945,MATH 109,B02,083216,Ganzberger; Geoffrey Michael,2,0,32,30
1657696939945,MATH 109,B03,093479,Ganzberger; Geoffrey Michael,8,0,32,24
1657696945974,MATH 142A,A01,083219,Chow; Bennett,7,0,32,25
1657696945974,MATH 142A,A02,083220,Chow; Bennett,10,0,32,22
1657696945974,MATH 142A,A03,093480,Chow; Bennett,9,0,32,23
1657696945974,MATH 142A,B03,093481,Chow; Bennett,8,0,32,24
1657696945974,MATH 142A,B04,093558,Chow; Bennett,13,0,32,19
1657696945974,MATH 142A,B05,093559,Chow; Bennett,6,0,32,26
1657696952002,MATH 193A,A01,083224,Rotar; Vladimir,8,0,34,26
1657696952002,MATH 193A,A02,083225,Rotar; Vladimir,9,0,34,25
1657696952002,MATH 193A,A03,083781,Rotar; Vladimir,5,0,34,29
1657696952002,MATH 193A,A04,083782,Rotar; Vladimir,10,0,34,24
1657696952002,MATH 193A,A05,093482,Rotar; Vladimir,10,0,34,24
1657696958026,MATH 197,001,091859,McAuley; Julian John,9999,0,9999,0
1657696958026,MATH 197,002,095566,Kedlaya; Kiran S.,9997,0,9999,2
1657696958026,MATH 197,003,095567,Xiao; Ming,9999,0,9999,0
1657696958026,MATH 197,004,095571,Perols; Johan Lars,9998,0,9999,1
1657696965084,COGS 9,A01,083615,Shannon; Kyle Michael,9,0,75,66
1657696971111,COGS 11,A01,083617,Boyle; Mary E. T.,23,0,48,25
1657696977140,COGS 13,A01,083071,Bastos; Amalia Pinkusfeld,11,0,71,60
1657696983167,COGS 14A,A01,092681,Semenuks; Arturs,5,1,100,95
1657696989190,COGS 14B,A01,083073,Cheng; Tzu-Han,6,0,63,57
1657696995215,COGS 17,A01,092677,Semenuks; Arturs,6,0,81,75
1657697001238,COGS 100,A01,083619,Allen; Michael Gordon,17,0,70,53
1657697007265,COGS 101A,A01,083621,Davis; Joshua Daniel,9,0,68,59
1657697013288,COGS 101B,A01,091572,Allen; Michael Gordon,12,0,65,53
1657697019312,COGS 101C,A01,083625,Delgado; Tania,17,0,35,18
1657697025334,COGS 107A,A01,083627,Boyle; Mary E. T.,13,0,60,47
1657697031356,COGS 118A,A01,083075,Gupta; Anjum,21,0,76,55
1657697037385,CSE 3,A50,083646,Miranda; Gregory Joseph,24,0,50,26
1657697043412,CSE 8A,A50,083650,Miranda; Gregory Joseph,17,1,56,39
1657697049436,CSE 11,A01,083080,Cao; Yingjun,6,15,40,34
1657697055460,CSE 12,A01,083652,Krause-Levy; Sophia Louisa,28,1,120,92
1657697061487,CSE 15L,A01,083654,Morris; Justin Loren,9,0,50,41
1657697061487,CSE 15L,A02,083655,Morris; Justin Loren,9,0,50,41
1657697067511,CSE 20,A01,083657,Tran; Khoa Dang,39,0,80,41
1657697073537,CSE 21,A01,095574,Bach; Quang Tran,22,0,48,26
1657697079565,CSE 30,A01,083084,Eldon; John,6,0,80,74
1657697079565,CSE 30,B01,095061,Bhaskar; Nishant,9,0,50,41
1657697085589,CSE 100,A01,083659,Cao; Yingjun,5,4,70,65
1657697091615,CSE 134B,A01,083661,Powell; Thomas Allan,23,0,100,77
1657697097638,CSE 140,A01,083663,Gungor; Onat,15,0,85,70
1657697103662,CSE 140L,A01,083088,Eldon; John,22,0,100,78
1657697109686,CSE 175,A01,083665,Kumar; Rakesh,3,0,25,22
1657697115709,CSE 190,A00,092507,Dubnov; Shlomo,8,0,20,12
1657697121738,ECE 45,A01,083139,Congero; Spencer William,6,0,75,69
1657697127765,ECE 65,A50,083695,Saad; Andrew S,12,0,30,18
1657697127765,ECE 65,A51,095125,Saad; Andrew S,24,0,26,2
1657697133793,ECE 109,A01,091882,Touri; Behrouz,20,0,70,50
1657697139817,ECE 180,A00,083140,Abi Samra; Nicholas Camill,1,0,30,29
1657697139817,ECE 180,B00,083141,Abi Samra; Nicholas Camill,0,0,30,30
1657697145842,MATH 10A,A01,083735,Patchell; Gregory David,2,0,30,28
1657697145842,MATH 10A,A02,083736,Patchell; Gregory David,20,0,30,10
1657697145842,MATH 10A,A03,083737,Patchell; Gregory David,16,0,30,14
1657697151871,MATH 10B,A01,083207,Lim; Seonhee,8,0,34,26
1657697151871,MATH 10B,A02,083208,Lim; Seonhee,9,0,35,26
1657697151871,MATH 10B,A03,093472,Lim; Seonhee,7,0,34,27
1657697151871,MATH 10B,B01,083739,Sinha; Shubham,13,0,30,17
1657697157896,MATH 18,A01,083743,Cinel; Cameron Alexander,8,0,30,22
1657697157896,MATH 18,A02,083744,Cinel; Cameron Alexander,17,0,30,13
1657697157896,MATH 18,A03,083745,Cinel; Cameron Alexander,10,0,30,20
1657697157896,MATH 18,B01,083748,Rideout; David Porter,5,0,37,32
1657697157896,MATH 18,B02,083749,Rideout; David Porter,5,0,36,31
1657697157896,MATH 18,B03,083750,Rideout; David Porter,3,0,37,34
1657697157896,MATH 18,B04,083751,Rideout; David Porter,6,0,36,30
1657697157896,MATH 18,B05,093473,Rideout; David Porter,6,0,36,30
1657697157896,MATH 18,B06,093474,Rideout; David Porter,6,0,36,30
1657697163919,MATH 20A,A01,083754,Zheng; Zequn,14,0,40,26
1657697169943,MATH 20B,A01,083756,Briones; Jor-el Thomas Caparas,4,0,36,32
1657697169943,MATH 20B,A02,083757,Briones; Jor-el Thomas Caparas,1,0,36,35
1657697169943,MATH 20B,A03,093475,Briones; Jor-el Thomas Caparas,2,0,36,34
1657697175967,MATH 20C,A01,083760,Briones; Jor-el Thomas Caparas,1,0,35,34
1657697175967,MATH 20C,A02,083761,Briones; Jor-el Thomas Caparas,8,0,35,27
1657697175967,MATH 20C,A03,093476,Briones; Jor-el Thomas Caparas,0,1,36,36
1657697175967,MATH 20C,B01,083762,Bach; Quang Tran,1,0,30,29
1657697181995,MATH 20D,A01,083765,Tran; Brian Kha,5,0,30,25
1657697181995,MATH 20D,A02,083766,Tran; Brian Kha,5,0,30,25
1657697181995,MATH 20D,A03,083767,Tran; Brian Kha,5,0,30,25
1657697188026,MATH 20E,A01,083771,Ganguly; Soumya,9,0,32,23
1657697188026,MATH 20E,A02,083772,Ganguly; Soumya,6,0,32,26
1657697188026,MATH 20E,B01,083773,Ciotti; Benjamin,20,0,35,15
1657697188026,MATH 20E,B02,083774,Ciotti; Benjamin,18,0,35,17
1657697194054,MATH 103A,A01,083777,Greenfeld; Be'Eri,3,0,36,33
1657697194054,MATH 103A,A02,083778,Greenfeld; Be'Eri,5,0,36,31
1657697194054,MATH 103A,A03,093561,Greenfeld; Be'Eri,6,0,36,30
1657697194054,MATH 103A,B01,083779,Greenfeld; Be'Eri,7,0,36,29
1657697194054,MATH 103A,B02,083780,Greenfeld; Be'Eri,4,0,36,32
1657697194054,MATH 103A,B03,093562,Greenfeld; Be'Eri,3,0,36,33
1657697200083,MATH 105,A01,085443,Carter; Anne Toulson,15,0,35,20
1657697200083,MATH 105,A02,093477,Carter; Anne Toulson,20,0,35,15
1657697206107,MATH 109,A01,083213,Ganzberger; Geoffrey Michael,2,0,34,32
1657697206107,MATH 109,A02,083214,Ganzberger; Geoffrey Michael,4,0,34,30
1657697206107,MATH 109,A03,093478,Ganzberger; Geoffrey Michael,2,0,34,32
1657697206107,MATH 109,B01,083215,Ganzberger; Geoffrey Michael,1,0,32,31
1657697206107,MATH 109,B02,083216,Ganzberger; Geoffrey Michael,2,0,32,30
1657697206107,MATH 109,B03,093479,Ganzberger; Geoffrey Michael,8,0,32,24
1657697212132,MATH 142A,A01,083219,Chow; Bennett,7,0,32,25
1657697212132,MATH 142A,A02,083220,Chow; Bennett,10,0,32,22
1657697212132,MATH 142A,A03,093480,Chow; Bennett,9,0,32,23
1657697212132,MATH 142A,B03,093481,Chow; Bennett,8,0,32,24
1657697212132,MATH 142A,B04,093558,Chow; Bennett,13,0,32,19
1657697212132,MATH 142A,B05,093559,Chow; Bennett,6,0,32,26
1657697218156,MATH 193A,A01,083224,Rotar; Vladimir,8,0,34,26
1657697218156,MATH 193A,A02,083225,Rotar; Vladimir,9,0,34,25
1657697218156,MATH 193A,A03,083781,Rotar; Vladimir,5,0,34,29
1657697218156,MATH 193A,A04,083782,Rotar; Vladimir,10,0,34,24
1657697218156,MATH 193A,A05,093482,Rotar; Vladimir,10,0,34,24
1657697224186,MATH 197,001,091859,McAuley; Julian John,9999,0,9999,0
1657697224186,MATH 197,002,095566,Kedlaya; Kiran S.,9997,0,9999,2
1657697224186,MATH 197,003,095567,Xiao; Ming,9999,0,9999,0
1657697224186,MATH 197,004,095571,Perols; Johan Lars,9998,0,9999,1
1657697231248,COGS 9,A01,083615,Shannon; Kyle Michael,9,0,75,66
1657697237278,COGS 11,A01,083617,Boyle; Mary E. T.,23,0,48,25
1657697243303,COGS 13,A01,083071,Bastos; Amalia Pinkusfeld,11,0,71,60
1657697249333,COGS 14A,A01,092681,Semenuks; Arturs,5,1,100,95
1657697255357,COGS 14B,A01,083073,Cheng; Tzu-Han,6,0,63,57
1657697261381,COGS 17,A01,092677,Semenuks; Arturs,6,0,81,75
1657697267408,COGS 100,A01,083619,Allen; Michael Gordon,17,0,70,53
1657697273435,COGS 101A,A01,083621,Davis; Joshua Daniel,9,0,68,59
1657697279460,COGS 101B,A01,091572,Allen; Michael Gordon,12,0,65,53
1657697285483,COGS 101C,A01,083625,Delgado; Tania,17,0,35,18
1657697291506,COGS 107A,A01,083627,Boyle; Mary E. T.,13,0,60,47
1657697297529,COGS 118A,A01,083075,Gupta; Anjum,21,0,76,55
1657697303558,CSE 3,A50,083646,Miranda; Gregory Joseph,24,0,50,26
1657697309581,CSE 8A,A50,083650,Miranda; Gregory Joseph,17,1,56,39
1657697315605,CSE 11,A01,083080,Cao; Yingjun,6,15,40,34
1657697321628,CSE 12,A01,083652,Krause-Levy; Sophia Louisa,28,1,120,92
1657697327666,CSE 15L,A01,083654,Morris; Justin Loren,9,0,50,41
1657697327666,CSE 15L,A02,083655,Morris; Justin Loren,9,0,50,41
1657697333688,CSE 20,A01,083657,Tran; Khoa Dang,39,0,80,41
1657697339723,CSE 21,A01,095574,Bach; Quang Tran,22,0,48,26
1657697345746,CSE 30,A01,083084,Eldon; John,6,0,80,74
1657697345746,CSE 30,B01,095061,Bhaskar; Nishant,9,0,50,41
1657697351769,CSE 100,A01,083659,Cao; Yingjun,5,4,70,65
1657697357796,CSE 134B,A01,083661,Powell; Thomas Allan,23,0,100,77
1657697363897,CSE 140,A01,083663,Gungor; Onat,15,0,85,70
1657697369921,CSE 140L,A01,083088,Eldon; John,22,0,100,78
1657697375944,CSE 175,A01,083665,Kumar; Rakesh,3,0,25,22
1657697381965,CSE 190,A00,092507,Dubnov; Shlomo,8,0,20,12
1657697387990,ECE 45,A01,083139,Congero; Spencer William,6,0,75,69
1657697394013,ECE 65,A50,083695,Saad; Andrew S,12,0,30,18
1657697394013,ECE 65,A51,095125,Saad; Andrew S,24,0,26,2
1657697400042,ECE 109,A01,091882,Touri; Behrouz,20,0,70,50
1657697406066,ECE 180,A00,083140,Abi Samra; Nicholas Camill,1,0,30,29
1657697406066,ECE 180,B00,083141,Abi Samra; Nicholas Camill,0,0,30,30
1657697412091,MATH 10A,A01,083735,Patchell; Gregory David,2,0,30,28
1657697412091,MATH 10A,A02,083736,Patchell; Gregory David,20,0,30,10
1657697412091,MATH 10A,A03,083737,Patchell; Gregory David,16,0,30,14
1657697418171,MATH 10B,A01,083207,Lim; Seonhee,8,0,34,26
1657697418171,MATH 10B,A02,083208,Lim; Seonhee,9,0,35,26
1657697418171,MATH 10B,A03,093472,Lim; Seonhee,7,0,34,27
1657697418171,MATH 10B,B01,083739,Sinha; Shubham,13,0,30,17
1657697424195,MATH 18,A01,083743,Cinel; Cameron Alexander,8,0,30,22
1657697424195,MATH 18,A02,083744,Cinel; Cameron Alexander,17,0,30,13
1657697424195,MATH 18,A03,083745,Cinel; Cameron Alexander,10,0,30,20
1657697424195,MATH 18,B01,083748,Rideout; David Porter,5,0,37,32
1657697424195,MATH 18,B02,083749,Rideout; David Porter,5,0,36,31
1657697424195,MATH 18,B03,083750,Rideout; David Porter,3,0,37,34
1657697424195,MATH 18,B04,083751,Rideout; David Porter,6,0,36,30
1657697424195,MATH 18,B05,093473,Rideout; David Porter,6,0,36,30
1657697424195,MATH 18,B06,093474,Rideout; David Porter,6,0,36,30
1657697430220,MATH 20A,A01,083754,Zheng; Zequn,14,0,40,26
1657697436248,MATH 20B,A01,083756,Briones; Jor-el Thomas Caparas,4,0,36,32
1657697436248,MATH 20B,A02,083757,Briones; Jor-el Thomas Caparas,1,0,36,35
1657697436248,MATH 20B,A03,093475,Briones; Jor-el Thomas Caparas,2,0,36,34
1657697442279,MATH 20C,A01,083760,Briones; Jor-el Thomas Caparas,1,0,35,34
1657697442279,MATH 20C,A02,083761,Briones; Jor-el Thomas Caparas,8,0,35,27
1657697442279,MATH 20C,A03,093476,Briones; Jor-el Thomas Caparas,0,1,36,36
1657697442279,MATH 20C,B01,083762,Bach; Quang Tran,1,0,30,29
1657697448316,MATH 20D,A01,083765,Tran; Brian Kha,5,0,30,25
1657697448316,MATH 20D,A02,083766,Tran; Brian Kha,5,0,30,25
1657697448316,MATH 20D,A03,083767,Tran; Brian Kha,5,0,30,25
1657697454346,MATH 20E,A01,083771,Ganguly; Soumya,9,0,32,23
1657697454346,MATH 20E,A02,083772,Ganguly; Soumya,6,0,32,26
1657697454346,MATH 20E,B01,083773,Ciotti; Benjamin,20,0,35,15
1657697454346,MATH 20E,B02,083774,Ciotti; Benjamin,18,0,35,17
1657697460385,MATH 103A,A01,083777,Greenfeld; Be'Eri,3,0,36,33
1657697460385,MATH 103A,A02,083778,Greenfeld; Be'Eri,5,0,36,31
1657697460385,MATH 103A,A03,093561,Greenfeld; Be'Eri,6,0,36,30
1657697460385,MATH 103A,B01,083779,Greenfeld; Be'Eri,7,0,36,29
1657697460385,MATH 103A,B02,083780,Greenfeld; Be'Eri,4,0,36,32
1657697460385,MATH 103A,B03,093562,Greenfeld; Be'Eri,3,0,36,33
1657697466413,MATH 105,A01,085443,Carter; Anne Toulson,15,0,35,20
1657697466413,MATH 105,A02,093477,Carter; Anne Toulson,20,0,35,15
1657697472447,MATH 109,A01,083213,Ganzberger; Geoffrey Michael,2,0,34,32
1657697472447,MATH 109,A02,083214,Ganzberger; Geoffrey Michael,4,0,34,30
1657697472447,MATH 109,A03,093478,Ganzberger; Geoffrey Michael,2,0,34,32
1657697472447,MATH 109,B01,083215,Ganzberger; Geoffrey Michael,1,0,32,31
1657697472447,MATH 109,B02,083216,Ganzberger; Geoffrey Michael,2,0,32,30
1657697472447,MATH 109,B03,093479,Ganzberger; Geoffrey Michael,8,0,32,24
1657697478475,MATH 142A,A01,083219,Chow; Bennett,7,0,32,25
1657697478475,MATH 142A,A02,083220,Chow; Bennett,10,0,32,22
1657697478475,MATH 142A,A03,093480,Chow; Bennett,9,0,32,23
1657697478475,MATH 142A,B03,093481,Chow; Bennett,8,0,32,24
1657697478475,MATH 142A,B04,093558,Chow; Bennett,13,0,32,19
1657697478475,MATH 142A,B05,093559,Chow; Bennett,6,0,32,26
1657697484509,MATH 193A,A01,083224,Rotar; Vladimir,8,0,34,26
1657697484509,MATH 193A,A02,083225,Rotar; Vladimir,9,0,34,25
1657697484509,MATH 193A,A03,083781,Rotar; Vladimir,5,0,34,29
1657697484509,MATH 193A,A04,083782,Rotar; Vladimir,10,0,34,24
1657697484509,MATH 193A,A05,093482,Rotar; Vladimir,10,0,34,24
1657697490539,MATH 197,001,091859,McAuley; Julian John,9999,0,9999,0
1657697490539,MATH 197,002,095566,Kedlaya; Kiran S.,9997,0,9999,2
1657697490539,MATH 197,003,095567,Xiao; Ming,9999,0,9999,0
1657697490539,MATH 197,004,095571,Perols; Johan Lars,9998,0,9999,1
1657697497607,COGS 9,A01,083615,Shannon; Kyle Michael,9,0,75,66
1657697503631,COGS 11,A01,083617,Boyle; Mary E. T.,23,0,48,25
1657697509661,COGS 13,A01,083071,Bastos; Amalia Pinkusfeld,11,0,71,60
1657697515684,COGS 14A,A01,092681,Semenuks; Arturs,5,1,100,95
1657697521715,COGS 14B,A01,083073,Cheng; Tzu-Han,6,0,63,57
1657697527737,COGS 17,A01,092677,Semenuks; Arturs,6,0,81,75
1657697533774,COGS 100,A01,083619,Allen; Michael Gordon,17,0,70,53
1657697539800,COGS 101A,A01,083621,Davis; Joshua Daniel,9,0,68,59
1657697545823,COGS 101B,A01,091572,Allen; Michael Gordon,12,0,65,53
1657697551851,COGS 101C,A01,083625,Delgado; Tania,17,0,35,18
1657697557874,COGS 107A,A01,083627,Boyle; Mary E. T.,13,0,60,47
1657697563901,COGS 118A,A01,083075,Gupta; Anjum,21,0,76,55
1657697569927,CSE 3,A50,083646,Miranda; Gregory Joseph,24,0,50,26
1657697575949,CSE 8A,A50,083650,Miranda; Gregory Joseph,17,1,56,39
1657697581971,CSE 11,A01,083080,Cao; Yingjun,6,15,40,34
1657697587994,CSE 12,A01,083652,Krause-Levy; Sophia Louisa,28,1,120,92
1657697594022,CSE 15L,A01,083654,Morris; Justin Loren,9,0,50,41
1657697594022,CSE 15L,A02,083655,Morris; Justin Loren,9,0,50,41
1657697600049,CSE 20,A01,083657,Tran; Khoa Dang,39,0,80,41
1657697606074,CSE 21,A01,095574,Bach; Quang Tran,22,0,48,26
1657697612100,CSE 30,A01,083084,Eldon; John,6,0,80,74
1657697612100,CSE 30,B01,095061,Bhaskar; Nishant,9,0,50,41
1657697618123,CSE 100,A01,083659,Cao; Yingjun,5,4,70,65
1657697624149,CSE 134B,A01,083661,Powell; Thomas Allan,23,0,100,77
1657697630171,CSE 140,A01,083663,Gungor; Onat,15,0,85,70
1657697636192,CSE 140L,A01,083088,Eldon; John,22,0,100,78
1657697642220,CSE 175,A01,083665,Kumar; Rakesh,3,0,25,22
1657697648253,CSE 190,A00,092507,Dubnov; Shlomo,8,0,20,12
1657697654283,ECE 45,A01,083139,Congero; Spencer William,6,0,75,69
1657697660306,ECE 65,A50,083695,Saad; Andrew S,12,0,30,18
1657697660306,ECE 65,A51,095125,Saad; Andrew S,24,0,26,2
1657697666329,ECE 109,A01,091882,Touri; Behrouz,20,0,70,50
1657697672353,ECE 180,A00,083140,Abi Samra; Nicholas Camill,1,0,30,29
1657697672353,ECE 180,B00,083141,Abi Samra; Nicholas Camill,0,0,30,30
1657697678382,MATH 10A,A01,083735,Patchell; Gregory David,2,0,30,28
1657697678382,MATH 10A,A02,083736,Patchell; Gregory David,20,0,30,10
1657697678382,MATH 10A,A03,083737,Patchell; Gregory David,16,0,30,14
1657697684423,MATH 10B,A01,083207,Lim; Seonhee,8,0,34,26
1657697684423,MATH 10B,A02,083208,Lim; Seonhee,9,0,35,26
1657697684423,MATH 10B,A03,093472,Lim; Seonhee,7,0,34,27
1657697684423,MATH 10B,B01,083739,Sinha; Shubham,13,0,30,17
1657697690454,MATH 18,A01,083743,Cinel; Cameron Alexander,8,0,30,22
1657697690454,MATH 18,A02,083744,Cinel; Cameron Alexander,17,0,30,13
1657697690454,MATH 18,A03,083745,Cinel; Cameron Alexander,10,0,30,20
1657697690454,MATH 18,B01,083748,Rideout; David Porter,5,0,37,32
1657697690454,MATH 18,B02,083749,Rideout; David Porter,5,0,36,31
1657697690454,MATH 18,B03,083750,Rideout; David Porter,3,0,37,34
1657697690454,MATH 18,B04,083751,Rideout; David Porter,6,0,36,30
1657697690454,MATH 18,B05,093473,Rideout; David Porter,6,0,36,30
1657697690454,MATH 18,B06,093474,Rideout; David Porter,6,0,36,30
1657697696484,MATH 20A,A01,083754,Zheng; Zequn,14,0,40,26
1657697702508,MATH 20B,A01,083756,Briones; Jor-el Thomas Caparas,4,0,36,32
1657697702508,MATH 20B,A02,083757,Briones; Jor-el Thomas Caparas,1,0,36,35
1657697702508,MATH 20B,A03,093475,Briones; Jor-el Thomas Caparas,2,0,36,34
1657697708535,MATH 20C,A01,083760,Briones; Jor-el Thomas Caparas,1,0,35,34
1657697708535,MATH 20C,A02,083761,Briones; Jor-el Thomas Caparas,8,0,35,27
1657697708535,MATH 20C,A03,093476,Briones; Jor-el Thomas Caparas,0,1,36,36
1657697708535,MATH 20C,B01,083762,Bach; Quang Tran,1,0,30,29
1657697714559,MATH 20D,A01,083765,Tran; Brian Kha,5,0,30,25
1657697714559,MATH 20D,A02,083766,Tran; Brian Kha,5,0,30,25
1657697714559,MATH 20D,A03,083767,Tran; Brian Kha,5,0,30,25
1657697720583,MATH 20E,A01,083771,Ganguly; Soumya,9,0,32,23
1657697720583,MATH 20E,A02,083772,Ganguly; Soumya,6,0,32,26
1657697720583,MATH 20E,B01,083773,Ciotti; Benjamin,20,0,35,15
1657697720583,MATH 20E,B02,083774,Ciotti; Benjamin,18,0,35,17
1657697726606,MATH 103A,A01,083777,Greenfeld; Be'Eri,3,0,36,33
1657697726606,MATH 103A,A02,083778,Greenfeld; Be'Eri,5,0,36,31
1657697726606,MATH 103A,A03,093561,Greenfeld; Be'Eri,6,0,36,30
1657697726606,MATH 103A,B01,083779,Greenfeld; Be'Eri,7,0,36,29
1657697726606,MATH 103A,B02,083780,Greenfeld; Be'Eri,4,0,36,32
1657697726606,MATH 103A,B03,093562,Greenfeld; Be'Eri,3,0,36,33
1657697732631,MATH 105,A01,085443,Carter; Anne Toulson,15,0,35,20
1657697732631,MATH 105,A02,093477,Carter; Anne Toulson,20,0,35,15
1657697738657,MATH 109,A01,083213,Ganzberger; Geoffrey Michael,2,0,34,32
1657697738657,MATH 109,A02,083214,Ganzberger; Geoffrey Michael,4,0,34,30
1657697738657,MATH 109,A03,093478,Ganzberger; Geoffrey Michael,2,0,34,32
1657697738657,MATH 109,B01,083215,Ganzberger; Geoffrey Michael,1,0,32,31
1657697738657,MATH 109,B02,083216,Ganzberger; Geoffrey Michael,2,0,32,30
1657697738657,MATH 109,B03,093479,Ganzberger; Geoffrey Michael,8,0,32,24
1657697744683,MATH 142A,A01,083219,Chow; Bennett,7,0,32,25
1657697744683,MATH 142A,A02,083220,Chow; Bennett,10,0,32,22
1657697744683,MATH 142A,A03,093480,Chow; Bennett,9,0,32,23
1657697744683,MATH 142A,B03,093481,Chow; Bennett,8,0,32,24
1657697744683,MATH 142A,B04,093558,Chow; Bennett,13,0,32,19
1657697744683,MATH 142A,B05,093559,Chow; Bennett,6,0,32,26
1657697750709,MATH 193A,A01,083224,Rotar; Vladimir,8,0,34,26
1657697750709,MATH 193A,A02,083225,Rotar; Vladimir,9,0,34,25
1657697750709,MATH 193A,A03,083781,Rotar; Vladimir,5,0,34,29
1657697750709,MATH 193A,A04,083782,Rotar; Vladimir,10,0,34,24
1657697750709,MATH 193A,A05,093482,Rotar; Vladimir,10,0,34,24
1657697756739,MATH 197,001,091859,McAuley; Julian John,9999,0,9999,0
1657697756739,MATH 197,002,095566,Kedlaya; Kiran S.,9997,0,9999,2
1657697756739,MATH 197,003,095567,Xiao; Ming,9999,0,9999,0
1657697756739,MATH 197,004,095571,Perols; Johan Lars,9998,0,9999,1
1657697763806,COGS 9,A01,083615,Shannon; Kyle Michael,9,0,75,66
1657697769830,COGS 11,A01,083617,Boyle; Mary E. T.,23,0,48,25
1657697775855,COGS 13,A01,083071,Bastos; Amalia Pinkusfeld,11,0,71,60
1657697781884,COGS 14A,A01,092681,Semenuks; Arturs,5,1,100,95
1657697787914,COGS 14B,A01,083073,Cheng; Tzu-Han,6,0,63,57
1657697793938,COGS 17,A01,092677,Semenuks; Arturs,6,0,81,75
1657697799968,COGS 100,A01,083619,Allen; Michael Gordon,17,0,70,53
1657697805997,COGS 101A,A01,083621,Davis; Joshua Daniel,9,0,68,59
1657697812030,COGS 101B,A01,091572,Allen; Michael Gordon,12,0,65,53
1657697818057,COGS 101C,A01,083625,Delgado; Tania,17,0,35,18
1657697824084,COGS 107A,A01,083627,Boyle; Mary E. T.,13,0,60,47
1657697830121,COGS 118A,A01,083075,Gupta; Anjum,21,0,76,55
1657697836148,CSE 3,A50,083646,Miranda; Gregory Joseph,24,0,50,26
1657697842173,CSE 8A,A50,083650,Miranda; Gregory Joseph,17,1,56,39
1657697848199,CSE 11,A01,083080,Cao; Yingjun,6,15,40,34
1657697854223,CSE 12,A01,083652,Krause-Levy; Sophia Louisa,28,1,120,92
1657697860252,CSE 15L,A01,083654,Morris; Justin Loren,9,0,50,41
1657697860252,CSE 15L,A02,083655,Morris; Justin Loren,9,0,50,41
1657697866282,CSE 20,A01,083657,Tran; Khoa Dang,39,0,80,41
1657697872307,CSE 21,A01,095574,Bach; Quang Tran,22,0,48,26
1657697878337,CSE 30,A01,083084,Eldon; John,6,0,80,74
1657697878337,CSE 30,B01,095061,Bhaskar; Nishant,9,0,50,41
1657697884368,CSE 100,A01,083659,Cao; Yingjun,5,4,70,65
1657697890391,CSE 134B,A01,083661,Powell; Thomas Allan,23,0,100,77
1657697896416,CSE 140,A01,083663,Gungor; Onat,15,0,85,70
1657697902440,CSE 140L,A01,083088,Eldon; John,22,0,100,78
1657697908467,CSE 175,A01,083665,Kumar; Rakesh,3,0,25,22
1657697914492,CSE 190,A00,092507,Dubnov; Shlomo,8,0,20,12
1657697920524,ECE 45,A01,083139,Congero; Spencer William,6,0,75,69
1657697926557,ECE 65,A50,083695,Saad; Andrew S,12,0,30,18
1657697926557,ECE 65,A51,095125,Saad; Andrew S,24,0,26,2
1657697932582,ECE 109,A01,091882,Touri; Behrouz,20,0,70,50
1657697938606,ECE 180,A00,083140,Abi Samra; Nicholas Camill,1,0,30,29
1657697938606,ECE 180,B00,083141,Abi Samra; Nicholas Camill,0,0,30,30
1657697944644,MATH 10A,A01,083735,Patchell; Gregory David,2,0,30,28
1657697944644,MATH 10A,A02,083736,Patchell; Gregory David,20,0,30,10
1657697944644,MATH 10A,A03,083737,Patchell; Gregory David,16,0,30,14
1657697950670,MATH 10B,A01,083207,Lim; Seonhee,8,0,34,26
1657697950670,MATH 10B,A02,083208,Lim; Seonhee,9,0,35,26
1657697950670,MATH 10B,A03,093472,Lim; Seonhee,7,0,34,27
1657697950670,MATH 10B,B01,083739,Sinha; Shubham,13,0,30,17
1657697956704,MATH 18,A01,083743,Cinel; Cameron Alexander,8,0,30,22
1657697956704,MATH 18,A02,083744,Cinel; Cameron Alexander,17,0,30,13
1657697956704,MATH 18,A03,083745,Cinel; Cameron Alexander,10,0,30,20
1657697956704,MATH 18,B01,083748,Rideout; David Porter,5,0,37,32
1657697956704,MATH 18,B02,083749,Rideout; David Porter,5,0,36,31
1657697956704,MATH 18,B03,083750,Rideout; David Porter,3,0,37,34
1657697956704,MATH 18,B04,083751,Rideout; David Porter,6,0,36,30
1657697956704,MATH 18,B05,093473,Rideout; David Porter,6,0,36,30
1657697956704,MATH 18,B06,093474,Rideout; David Porter,6,0,36,30
1657697962798,MATH 20A,A01,083754,Zheng; Zequn,14,0,40,26
1657697968823,MATH 20B,A01,083756,Briones; Jor-el Thomas Caparas,4,0,36,32
1657697968823,MATH 20B,A02,083757,Briones; Jor-el Thomas Caparas,1,0,36,35
1657697968823,MATH 20B,A03,093475,Briones; Jor-el Thomas Caparas,2,0,36,34
1657697974849,MATH 20C,A01,083760,Briones; Jor-el Thomas Caparas,1,0,35,34
1657697974849,MATH 20C,A02,083761,Briones; Jor-el Thomas Caparas,8,0,35,27
1657697974849,MATH 20C,A03,093476,Briones; Jor-el Thomas Caparas,0,1,36,36
1657697974849,MATH 20C,B01,083762,Bach; Quang Tran,1,0,30,29
1657697980879,MATH 20D,A01,083765,Tran; Brian Kha,5,0,30,25
1657697980879,MATH 20D,A02,083766,Tran; Brian Kha,5,0,30,25
1657697980879,MATH 20D,A03,083767,Tran; Brian Kha,5,0,30,25
1657697986929,MATH 20E,A01,083771,Ganguly; Soumya,9,0,32,23
1657697986929,MATH 20E,A02,083772,Ganguly; Soumya,6,0,32,26
1657697986929,MATH 20E,B01,083773,Ciotti; Benjamin,20,0,35,15
1657697986929,MATH 20E,B02,083774,Ciotti; Benjamin,18,0,35,17
1657697992956,MATH 103A,A01,083777,Greenfeld; Be'Eri,3,0,36,33
1657697992956,MATH 103A,A02,083778,Greenfeld; Be'Eri,5,0,36,31
1657697992956,MATH 103A,A03,093561,Greenfeld; Be'Eri,6,0,36,30
1657697992956,MATH 103A,B01,083779,Greenfeld; Be'Eri,7,0,36,29
1657697992956,MATH 103A,B02,083780,Greenfeld; Be'Eri,4,0,36,32
1657697992956,MATH 103A,B03,093562,Greenfeld; Be'Eri,3,0,36,33
1657697998986,MATH 105,A01,085443,Carter; Anne Toulson,15,0,35,20
1657697998986,MATH 105,A02,093477,Carter; Anne Toulson,20,0,35,15
1657698005011,MATH 109,A01,083213,Ganzberger; Geoffrey Michael,2,0,34,32
1657698005011,MATH 109,A02,083214,Ganzberger; Geoffrey Michael,4,0,34,30
1657698005011,MATH 109,A03,093478,Ganzberger; Geoffrey Michael,2,0,34,32
1657698005011,MATH 109,B01,083215,Ganzberger; Geoffrey Michael,1,0,32,31
1657698005011,MATH 109,B02,083216,Ganzberger; Geoffrey Michael,2,0,32,30
1657698005011,MATH 109,B03,093479,Ganzberger; Geoffrey Michael,8,0,32,24
1657698011044,MATH 142A,A01,083219,Chow; Bennett,7,0,32,25
1657698011044,MATH 142A,A02,083220,Chow; Bennett,10,0,32,22
1657698011044,MATH 142A,A03,093480,Chow; Bennett,9,0,32,23
1657698011044,MATH 142A,B03,093481,Chow; Bennett,8,0,32,24
1657698011044,MATH 142A,B04,093558,Chow; Bennett,13,0,32,19
1657698011044,MATH 142A,B05,093559,Chow; Bennett,6,0,32,26
1657698017079,MATH 193A,A01,083224,Rotar; Vladimir,8,0,34,26
1657698017079,MATH 193A,A02,083225,Rotar; Vladimir,9,0,34,25
1657698017079,MATH 193A,A03,083781,Rotar; Vladimir,5,0,34,29
1657698017079,MATH 193A,A04,083782,Rotar; Vladimir,10,0,34,24
1657698017079,MATH 193A,A05,093482,Rotar; Vladimir,10,0,34,24
1657698023106,MATH 197,001,091859,McAuley; Julian John,9999,0,9999,0
1657698023106,MATH 197,002,095566,Kedlaya; Kiran S.,9997,0,9999,2
1657698023106,MATH 197,003,095567,Xiao; Ming,9999,0,9999,0
1657698023106,MATH 197,004,095571,Perols; Johan Lars,9998,0,9999,1
1657698030204,COGS 9,A01,083615,Shannon; Kyle Michael,9,0,75,66
1657698036232,COGS 11,A01,083617,Boyle; Mary E. T.,23,0,48,25
1657698042258,COGS 13,A01,083071,Bastos; Amalia Pinkusfeld,11,0,71,60
1657698048288,COGS 14A,A01,092681,Semenuks; Arturs,5,1,100,95
1657698054315,COGS 14B,A01,083073,Cheng; Tzu-Han,6,0,63,57
1657698060340,COGS 17,A01,092677,Semenuks; Arturs,6,0,81,75
1657698066371,COGS 100,A01,083619,Allen; Michael Gordon,17,0,70,53
1657698072401,COGS 101A,A01,083621,Davis; Joshua Daniel,9,0,68,59
1657698078433,COGS 101B,A01,091572,Allen; Michael Gordon,12,0,65,53
1657698084460,COGS 101C,A01,083625,Delgado; Tania,17,0,35,18
1657698090489,COGS 107A,A01,083627,Boyle; Mary E. T.,13,0,60,47
1657698096518,COGS 118A,A01,083075,Gupta; Anjum,21,0,76,55
1657698102552,CSE 3,A50,083646,Miranda; Gregory Joseph,24,0,50,26
1657698108578,CSE 8A,A50,083650,Miranda; Gregory Joseph,17,1,56,39
1657698114604,CSE 11,A01,083080,Cao; Yingjun,6,15,40,34
1657698120634,CSE 12,A01,083652,Krause-Levy; Sophia Louisa,28,1,120,92
1657698126660,CSE 15L,A01,083654,Morris; Justin Loren,9,0,50,41
1657698126660,CSE 15L,A02,083655,Morris; Justin Loren,9,0,50,41
1657698132690,CSE 20,A01,083657,Tran; Khoa Dang,39,0,80,41
1657698138715,CSE 21,A01,095574,Bach; Quang Tran,22,0,48,26
1657698144748,CSE 30,A01,083084,Eldon; John,6,0,80,74
1657698144748,CSE 30,B01,095061,Bhaskar; Nishant,9,0,50,41
1657698150776,CSE 100,A01,083659,Cao; Yingjun,5,4,70,65
1657698156810,CSE 134B,A01,083661,Powell; Thomas Allan,23,0,100,77
1657698162842,CSE 140,A01,083663,Gungor; Onat,15,0,85,70
1657698168869,CSE 140L,A01,083088,Eldon; John,22,0,100,78
1657698174895,CSE 175,A01,083665,Kumar; Rakesh,3,0,25,22
1657698180920,CSE 190,A00,092507,Dubnov; Shlomo,8,0,20,12
1657698186945,ECE 45,A01,083139,Congero; Spencer William,6,0,75,69
1657698192972,ECE 65,A50,083695,Saad; Andrew S,12,0,30,18
1657698192972,ECE 65,A51,095125,Saad; Andrew S,24,0,26,2
1657698199006,ECE 109,A01,091882,Touri; Behrouz,20,0,70,50
1657698205031,ECE 180,A00,083140,Abi Samra; Nicholas Camill,1,0,30,29
1657698205031,ECE 180,B00,083141,Abi Samra; Nicholas Camill,0,0,30,30
1657698211064,MATH 10A,A01,083735,Patchell; Gregory David,2,0,30,28
1657698211064,MATH 10A,A02,083736,Patchell; Gregory David,20,0,30,10
1657698211064,MATH 10A,A03,083737,Patchell; Gregory David,16,0,30,14
1657698217106,MATH 10B,A01,083207,Lim; Seonhee,8,0,34,26
1657698217106,MATH 10B,A02,083208,Lim; Seonhee,9,0,35,26
1657698217106,MATH 10B,A03,093472,Lim; Seonhee,7,0,34,27
1657698217106,MATH 10B,B01,083739,Sinha; Shubham,13,0,30,17
1657698223145,MATH 18,A01,083743,Cinel; Cameron Alexander,8,0,30,22
1657698223145,MATH 18,A02,083744,Cinel; Cameron Alexander,17,0,30,13
1657698223145,MATH 18,A03,083745,Cinel; Cameron Alexander,10,0,30,20
1657698223145,MATH 18,B01,083748,Rideout; David Porter,5,0,37,32
1657698223145,MATH 18,B02,083749,Rideout; David Porter,5,0,36,31
1657698223145,MATH 18,B03,083750,Rideout; David Porter,3,0,37,34
1657698223145,MATH 18,B04,083751,Rideout; David Porter,6,0,36,30
1657698223145,MATH 18,B05,093473,Rideout; David Porter,6,0,36,30
1657698223145,MATH 18,B06,093474,Rideout; David Porter,6,0,36,30
1657698229171,MATH 20A,A01,083754,Zheng; Zequn,14,0,40,26
1657698235199,MATH 20B,A01,083756,Briones; Jor-el Thomas Caparas,4,0,36,32
1657698235199,MATH 20B,A02,083757,Briones; Jor-el Thomas Caparas,1,0,36,35
1657698235199,MATH 20B,A03,093475,Briones; Jor-el Thomas Caparas,2,0,36,34
1657698241234,MATH 20C,A01,083760,Briones; Jor-el Thomas Caparas,1,0,35,34
1657698241234,MATH 20C,A02,083761,Briones; Jor-el Thomas Caparas,8,0,35,27
1657698241234,MATH 20C,A03,093476,Briones; Jor-el Thomas Caparas,0,1,36,36
1657698241234,MATH 20C,B01,083762,Bach; Quang Tran,1,0,30,29
1657698247269,MATH 20D,A01,083765,Tran; Brian Kha,5,0,30,25
1657698247269,MATH 20D,A02,083766,Tran; Brian Kha,5,0,30,25
1657698247269,MATH 20D,A03,083767,Tran; Brian Kha,5,0,30,25
1657698253298,MATH 20E,A01,083771,Ganguly; Soumya,9,0,32,23
1657698253298,MATH 20E,A02,083772,Ganguly; Soumya,6,0,32,26
1657698253298,MATH 20E,B01,083773,Ciotti; Benjamin,20,0,35,15
1657698253298,MATH 20E,B02,083774,Ciotti; Benjamin,18,0,35,17
1657698259338,MATH 103A,A01,083777,Greenfeld; Be'Eri,3,0,36,33
1657698259338,MATH 103A,A02,083778,Greenfeld; Be'Eri,5,0,36,31
1657698259338,MATH 103A,A03,093561,Greenfeld; Be'Eri,6,0,36,30
1657698259338,MATH 103A,B01,083779,Greenfeld; Be'Eri,7,0,36,29
1657698259338,MATH 103A,B02,083780,Greenfeld; Be'Eri,4,0,36,32
1657698259338,MATH 103A,B03,093562,Greenfeld; Be'Eri,3,0,36,33
1657698265373,MATH 105,A01,085443,Carter; Anne Toulson,15,0,35,20
1657698265373,MATH 105,A02,093477,Carter; Anne Toulson,20,0,35,15
1657698271423,MATH 109,A01,083213,Ganzberger; Geoffrey Michael,2,0,34,32
1657698271423,MATH 109,A02,083214,Ganzberger; Geoffrey Michael,4,0,34,30
1657698271423,MATH 109,A03,093478,Ganzberger; Geoffrey Michael,2,0,34,32
1657698271423,MATH 109,B01,083215,Ganzberger; Geoffrey Michael,1,0,32,31
1657698271423,MATH 109,B02,083216,Ganzberger; Geoffrey Michael,2,0,32,30
1657698271423,MATH 109,B03,093479,Ganzberger; Geoffrey Michael,8,0,32,24
1657698277455,MATH 142A,A01,083219,Chow; Bennett,7,0,32,25
1657698277455,MATH 142A,A02,083220,Chow; Bennett,10,0,32,22
1657698277455,MATH 142A,A03,093480,Chow; Bennett,9,0,32,23
1657698277455,MATH 142A,B03,093481,Chow; Bennett,8,0,32,24
1657698277455,MATH 142A,B04,093558,Chow; Bennett,13,0,32,19
1657698277455,MATH 142A,B05,093559,Chow; Bennett,6,0,32,26
1657698283481,MATH 193A,A01,083224,Rotar; Vladimir,8,0,34,26
1657698283481,MATH 193A,A02,083225,Rotar; Vladimir,9,0,34,25
1657698283481,MATH 193A,A03,083781,Rotar; Vladimir,5,0,34,29
1657698283481,MATH 193A,A04,083782,Rotar; Vladimir,10,0,34,24
1657698283481,MATH 193A,A05,093482,Rotar; Vladimir,10,0,34,24
1657698289507,MATH 197,001,091859,McAuley; Julian John,9999,0,9999,0
1657698289507,MATH 197,002,095566,Kedlaya; Kiran S.,9997,0,9999,2
1657698289507,MATH 197,003,095567,Xiao; Ming,9999,0,9999,0
1657698289507,MATH 197,004,095571,Perols; Johan Lars,9998,0,9999,1
1657698296577,COGS 9,A01,083615,Shannon; Kyle Michael,9,0,75,66
1657698302603,COGS 11,A01,083617,Boyle; Mary E. T.,23,0,48,25
1657698308641,COGS 13,A01,083071,Bastos; Amalia Pinkusfeld,11,0,71,60
1657698314675,COGS 14A,A01,092681,Semenuks; Arturs,5,1,100,95
1657698320699,COGS 14B,A01,083073,Cheng; Tzu-Han,6,0,63,57
1657698326723,COGS 17,A01,092677,Semenuks; Arturs,6,0,81,75
1657698332748,COGS 100,A01,083619,Allen; Michael Gordon,17,0,70,53
1657698338778,COGS 101A,A01,083621,Davis; Joshua Daniel,9,0,68,59
1657698344804,COGS 101B,A01,091572,Allen; Michael Gordon,12,0,65,53
1657698350830,COGS 101C,A01,083625,Delgado; Tania,17,0,35,18
1657698356858,COGS 107A,A01,083627,Boyle; Mary E. T.,13,0,60,47
1657698362885,COGS 118A,A01,083075,Gupta; Anjum,21,0,76,55
1657698368920,CSE 3,A50,083646,Miranda; Gregory Joseph,24,0,50,26
1657698374951,CSE 8A,A50,083650,Miranda; Gregory Joseph,17,1,56,39
1657698380978,CSE 11,A01,083080,Cao; Yingjun,6,15,40,34
1657698387015,CSE 12,A01,083652,Krause-Levy; Sophia Louisa,28,1,120,92
1657698393045,CSE 15L,A01,083654,Morris; Justin Loren,9,0,50,41
1657698393045,CSE 15L,A02,083655,Morris; Justin Loren,9,0,50,41
1657698399075,CSE 20,A01,083657,Tran; Khoa Dang,39,0,80,41
1657698405106,CSE 21,A01,095574,Bach; Quang Tran,22,0,48,26
1657698411145,CSE 30,A01,083084,Eldon; John,6,0,80,74
1657698411145,CSE 30,B01,095061,Bhaskar; Nishant,9,0,50,41
1657698417170,CSE 100,A01,083659,Cao; Yingjun,5,4,70,65
1657698423194,CSE 134B,A01,083661,Powell; Thomas Allan,23,0,100,77
1657698429219,CSE 140,A01,083663,Gungor; Onat,15,0,85,70
1657698435246,CSE 140L,A01,083088,Eldon; John,22,0,100,78
1657698441274,CSE 175,A01,083665,Kumar; Rakesh,3,0,25,22
1657698447299,CSE 190,A00,092507,Dubnov; Shlomo,8,0,20,12
1657698453326,ECE 45,A01,083139,Congero; Spencer William,6,0,75,69
1657698459359,ECE 65,A50,083695,Saad; Andrew S,12,0,30,18
1657698459359,ECE 65,A51,095125,Saad; Andrew S,24,0,26,2
1657698465385,ECE 109,A01,091882,Touri; Behrouz,20,0,70,50
1657698471409,ECE 180,A00,083140,Abi Samra; Nicholas Camill,1,0,30,29
1657698471409,ECE 180,B00,083141,Abi Samra; Nicholas Camill,0,0,30,30
1657698477445,MATH 10A,A01,083735,Patchell; Gregory David,2,0,30,28
1657698477445,MATH 10A,A02,083736,Patchell; Gregory David,20,0,30,10
1657698477445,MATH 10A,A03,083737,Patchell; Gregory David,16,0,30,14
1657698483476,MATH 10B,A01,083207,Lim; Seonhee,8,0,34,26
1657698483476,MATH 10B,A02,083208,Lim; Seonhee,9,0,35,26
1657698483476,MATH 10B,A03,093472,Lim; Seonhee,7,0,34,27
1657698483476,MATH 10B,B01,083739,Sinha; Shubham,13,0,30,17
1657698489507,MATH 18,A01,083743,Cinel; Cameron Alexander,8,0,30,22
1657698489507,MATH 18,A02,083744,Cinel; Cameron Alexander,17,0,30,13
1657698489507,MATH 18,A03,083745,Cinel; Cameron Alexander,10,0,30,20
1657698489507,MATH 18,B01,083748,Rideout; David Porter,5,0,37,32
1657698489507,MATH 18,B02,083749,Rideout; David Porter,5,0,36,31
1657698489507,MATH 18,B03,083750,Rideout; David Porter,3,0,37,34
1657698489507,MATH 18,B04,083751,Rideout; David Porter,6,0,36,30
1657698489507,MATH 18,B05,093473,Rideout; David Porter,6,0,36,30
1657698489507,MATH 18,B06,093474,Rideout; David Porter,6,0,36,30
1657698495538,MATH 20A,A01,083754,Zheng; Zequn,14,0,40,26
1657698501572,MATH 20B,A01,083756,Briones; Jor-el Thomas Caparas,4,0,36,32
1657698501572,MATH 20B,A02,083757,Briones; Jor-el Thomas Caparas,1,0,36,35
1657698501572,MATH 20B,A03,093475,Briones; Jor-el Thomas Caparas,2,0,36,34
1657698507600,MATH 20C,A01,083760,Briones; Jor-el Thomas Caparas,1,0,35,34
1657698507600,MATH 20C,A02,083761,Briones; Jor-el Thomas Caparas,8,0,35,27
1657698507600,MATH 20C,A03,093476,Briones; Jor-el Thomas Caparas,0,1,36,36
1657698507600,MATH 20C,B01,083762,Bach; Quang Tran,1,0,30,29
1657698513626,MATH 20D,A01,083765,Tran; Brian Kha,5,0,30,25
1657698513626,MATH 20D,A02,083766,Tran; Brian Kha,5,0,30,25
1657698513626,MATH 20D,A03,083767,Tran; Brian Kha,5,0,30,25
1657698519654,MATH 20E,A01,083771,Ganguly; Soumya,9,0,32,23
1657698519654,MATH 20E,A02,083772,Ganguly; Soumya,6,0,32,26
1657698519654,MATH 20E,B01,083773,Ciotti; Benjamin,20,0,35,15
1657698519654,MATH 20E,B02,083774,Ciotti; Benjamin,18,0,35,17
1657698525692,MATH 103A,A01,083777,Greenfeld; Be'Eri,3,0,36,33
1657698525692,MATH 103A,A02,083778,Greenfeld; Be'Eri,5,0,36,31
1657698525692,MATH 103A,A03,093561,Greenfeld; Be'Eri,6,0,36,30
1657698525692,MATH 103A,B01,083779,Greenfeld; Be'Eri,7,0,36,29
1657698525692,MATH 103A,B02,083780,Greenfeld; Be'Eri,4,0,36,32
1657698525692,MATH 103A,B03,093562,Greenfeld; Be'Eri,3,0,36,33
1657698531722,MATH 105,A01,085443,Carter; Anne Toulson,15,0,35,20
1657698531722,MATH 105,A02,093477,Carter; Anne Toulson,20,0,35,15
1657698537763,MATH 109,A01,083213,Ganzberger; Geoffrey Michael,2,0,34,32
1657698537763,MATH 109,A02,083214,Ganzberger; Geoffrey Michael,4,0,34,30
1657698537763,MATH 109,A03,093478,Ganzberger; Geoffrey Michael,2,0,34,32
1657698537763,MATH 109,B01,083215,Ganzberger; Geoffrey Michael,1,0,32,31
1657698537763,MATH 109,B02,083216,Ganzberger; Geoffrey Michael,2,0,32,30
1657698537763,MATH 109,B03,093479,Ganzberger; Geoffrey Michael,8,0,32,24
1657698543790,MATH 142A,A01,083219,Chow; Bennett,7,0,32,25
1657698543790,MATH 142A,A02,083220,Chow; Bennett,10,0,32,22
1657698543790,MATH 142A,A03,093480,Chow; Bennett,9,0,32,23
1657698543790,MATH 142A,B03,093481,Chow; Bennett,8,0,32,24
1657698543790,MATH 142A,B04,093558,Chow; Bennett,13,0,32,19
1657698543790,MATH 142A,B05,093559,Chow; Bennett,6,0,32,26
1657698549825,MATH 193A,A01,083224,Rotar; Vladimir,8,0,34,26
1657698549825,MATH 193A,A02,083225,Rotar; Vladimir,9,0,34,25
1657698549825,MATH 193A,A03,083781,Rotar; Vladimir,5,0,34,29
1657698549825,MATH 193A,A04,083782,Rotar; Vladimir,10,0,34,24
1657698549825,MATH 193A,A05,093482,Rotar; Vladimir,10,0,34,24
1657698555855,MATH 197,001,091859,McAuley; Julian John,9999,0,9999,0
1657698555855,MATH 197,002,095566,Kedlaya; Kiran S.,9997,0,9999,2
1657698555855,MATH 197,003,095567,Xiao; Ming,9999,0,9999,0
1657698555855,MATH 197,004,095571,Perols; Johan Lars,9998,0,9999,1
1657698563002,COGS 9,A01,083615,Shannon; Kyle Michael,9,0,75,66
1657698569036,COGS 11,A01,083617,Boyle; Mary E. T.,23,0,48,25
1657698575061,COGS 13,A01,083071,Bastos; Amalia Pinkusfeld,11,0,71,60
1657698581087,COGS 14A,A01,092681,Semenuks; Arturs,5,1,100,95
1657698587112,COGS 14B,A01,083073,Cheng; Tzu-Han,6,0,63,57
1657698593136,COGS 17,A01,092677,Semenuks; Arturs,6,0,81,75
1657698599166,COGS 100,A01,083619,Allen; Michael Gordon,17,0,70,53
1657698605192,COGS 101A,A01,083621,Davis; Joshua Daniel,9,0,68,59
1657698611223,COGS 101B,A01,091572,Allen; Michael Gordon,12,0,65,53
1657698617250,COGS 101C,A01,083625,Delgado; Tania,17,0,35,18
1657698623279,COGS 107A,A01,083627,Boyle; Mary E. T.,13,0,60,47
1657698629305,COGS 118A,A01,083075,Gupta; Anjum,21,0,76,55
1657698635331,CSE 3,A50,083646,Miranda; Gregory Joseph,24,0,50,26
1657698641354,CSE 8A,A50,083650,Miranda; Gregory Joseph,17,1,56,39
1657698647394,CSE 11,A01,083080,Cao; Yingjun,6,15,40,34
1657698653425,CSE 12,A01,083652,Krause-Levy; Sophia Louisa,28,1,120,92
1657698659456,CSE 15L,A01,083654,Morris; Justin Loren,9,0,50,41
1657698659456,CSE 15L,A02,083655,Morris; Justin Loren,9,0,50,41
1657698665487,CSE 20,A01,083657,Tran; Khoa Dang,39,0,80,41
1657698671512,CSE 21,A01,095574,Bach; Quang Tran,22,0,48,26
1657698677551,CSE 30,A01,083084,Eldon; John,6,0,80,74
1657698677551,CSE 30,B01,095061,Bhaskar; Nishant,9,0,50,41
1657698683584,CSE 100,A01,083659,Cao; Yingjun,5,4,70,65
1657698689620,CSE 134B,A01,083661,Powell; Thomas Allan,23,0,100,77
1657698695646,CSE 140,A01,083663,Gungor; Onat,15,0,85,70
1657698701676,CSE 140L,A01,083088,Eldon; John,22,0,100,78
1657698707702,CSE 175,A01,083665,Kumar; Rakesh,3,0,25,22
1657698713726,CSE 190,A00,092507,Dubnov; Shlomo,8,0,20,12
1657698719761,ECE 45,A01,083139,Congero; Spencer William,6,0,75,69
1657698725788,ECE 65,A50,083695,Saad; Andrew S,12,0,30,18
1657698725788,ECE 65,A51,095125,Saad; Andrew S,24,0,26,2
1657698731813,ECE 109,A01,091882,Touri; Behrouz,20,0,70,50
1657698737851,ECE 180,A00,083140,Abi Samra; Nicholas Camill,1,0,30,29
1657698737851,ECE 180,B00,083141,Abi Samra; Nicholas Camill,0,0,30,30
1657698743878,MATH 10A,A01,083735,Patchell; Gregory David,2,0,30,28
1657698743878,MATH 10A,A02,083736,Patchell; Gregory David,20,0,30,10
1657698743878,MATH 10A,A03,083737,Patchell; Gregory David,16,0,30,14
1657698749918,MATH 10B,A01,083207,Lim; Seonhee,8,0,34,26
1657698749918,MATH 10B,A02,083208,Lim; Seonhee,9,0,35,26
1657698749918,MATH 10B,A03,093472,Lim; Seonhee,7,0,34,27
1657698749918,MATH 10B,B01,083739,Sinha; Shubham,13,0,30,17
1657698755956,MATH 18,A01,083743,Cinel; Cameron Alexander,8,0,30,22
1657698755956,MATH 18,A02,083744,Cinel; Cameron Alexander,17,0,30,13
1657698755956,MATH 18,A03,083745,Cinel; Cameron Alexander,10,0,30,20
1657698755956,MATH 18,B01,083748,Rideout; David Porter,5,0,37,32
1657698755956,MATH 18,B02,083749,Rideout; David Porter,5,0,36,31
1657698755956,MATH 18,B03,083750,Rideout; David Porter,3,0,37,34
1657698755956,MATH 18,B04,083751,Rideout; David Porter,6,0,36,30
1657698755956,MATH 18,B05,093473,Rideout; David Porter,6,0,36,30
1657698755956,MATH 18,B06,093474,Rideout; David Porter,6,0,36,30
1657698761981,MATH 20A,A01,083754,Zheng; Zequn,14,0,40,26
1657698768016,MATH 20B,A01,083756,Briones; Jor-el Thomas Caparas,4,0,36,32
1657698768016,MATH 20B,A02,083757,Briones; Jor-el Thomas Caparas,1,0,36,35
1657698768016,MATH 20B,A03,093475,Briones; Jor-el Thomas Caparas,2,0,36,34
1657698774040,MATH 20C,A01,083760,Briones; Jor-el Thomas Caparas,1,0,35,34
1657698774040,MATH 20C,A02,083761,Briones; Jor-el Thomas Caparas,8,0,35,27
1657698774040,MATH 20C,A03,093476,Briones; Jor-el Thomas Caparas,0,1,36,36
1657698774040,MATH 20C,B01,083762,Bach; Quang Tran,1,0,30,29
1657698780065,MATH 20D,A01,083765,Tran; Brian Kha,5,0,30,25
1657698780065,MATH 20D,A02,083766,Tran; Brian Kha,5,0,30,25
1657698780065,MATH 20D,A03,083767,Tran; Brian Kha,5,0,30,25
1657698786091,MATH 20E,A01,083771,Ganguly; Soumya,9,0,32,23
1657698786091,MATH 20E,A02,083772,Ganguly; Soumya,6,0,32,26
1657698786091,MATH 20E,B01,083773,Ciotti; Benjamin,20,0,35,15
1657698786091,MATH 20E,B02,083774,Ciotti; Benjamin,18,0,35,17
1657698792119,MATH 103A,A01,083777,Greenfeld; Be'Eri,3,0,36,33
1657698792119,MATH 103A,A02,083778,Greenfeld; Be'Eri,5,0,36,31
1657698792119,MATH 103A,A03,093561,Greenfeld; Be'Eri,6,0,36,30
1657698792119,MATH 103A,B01,083779,Greenfeld; Be'Eri,7,0,36,29
1657698792119,MATH 103A,B02,083780,Greenfeld; Be'Eri,4,0,36,32
1657698792119,MATH 103A,B03,093562,Greenfeld; Be'Eri,3,0,36,33
1657698798154,MATH 105,A01,085443,Carter; Anne Toulson,15,0,35,20
1657698798154,MATH 105,A02,093477,Carter; Anne Toulson,20,0,35,15
1657698804182,MATH 109,A01,083213,Ganzberger; Geoffrey Michael,2,0,34,32
1657698804182,MATH 109,A02,083214,Ganzberger; Geoffrey Michael,4,0,34,30
1657698804182,MATH 109,A03,093478,Ganzberger; Geoffrey Michael,2,0,34,32
1657698804182,MATH 109,B01,083215,Ganzberger; Geoffrey Michael,1,0,32,31
1657698804182,MATH 109,B02,083216,Ganzberger; Geoffrey Michael,2,0,32,30
1657698804182,MATH 109,B03,093479,Ganzberger; Geoffrey Michael,8,0,32,24
1657698810208,MATH 142A,A01,083219,Chow; Bennett,7,0,32,25
1657698810208,MATH 142A,A02,083220,Chow; Bennett,10,0,32,22
1657698810208,MATH 142A,A03,093480,Chow; Bennett,9,0,32,23
1657698810208,MATH 142A,B03,093481,Chow; Bennett,8,0,32,24
1657698810208,MATH 142A,B04,093558,Chow; Bennett,13,0,32,19
1657698810208,MATH 142A,B05,093559,Chow; Bennett,6,0,32,26
1657698816244,MATH 193A,A01,083224,Rotar; Vladimir,8,0,34,26
1657698816244,MATH 193A,A02,083225,Rotar; Vladimir,9,0,34,25
1657698816244,MATH 193A,A03,083781,Rotar; Vladimir,5,0,34,29
1657698816244,MATH 193A,A04,083782,Rotar; Vladimir,10,0,34,24
1657698816244,MATH 193A,A05,093482,Rotar; Vladimir,10,0,34,24
1657698822269,MATH 197,001,091859,McAuley; Julian John,9999,0,9999,0
1657698822269,MATH 197,002,095566,Kedlaya; Kiran S.,9997,0,9999,2
1657698822269,MATH 197,003,095567,Xiao; Ming,9999,0,9999,0
1657698822269,MATH 197,004,095571,Perols; Johan Lars,9998,0,9999,1
1657698829329,COGS 9,A01,083615,Shannon; Kyle Michael,9,0,75,66
1657698835357,COGS 11,A01,083617,Boyle; Mary E. T.,23,0,48,25
1657698841383,COGS 13,A01,083071,Bastos; Amalia Pinkusfeld,11,0,71,60
1657698847412,COGS 14A,A01,092681,Semenuks; Arturs,5,1,100,95
1657698853442,COGS 14B,A01,083073,Cheng; Tzu-Han,6,0,63,57
1657698859472,COGS 17,A01,092677,Semenuks; Arturs,6,0,81,75
1657698865497,COGS 100,A01,083619,Allen; Michael Gordon,17,0,70,53
1657698871521,COGS 101A,A01,083621,Davis; Joshua Daniel,9,0,68,59
1657698877545,COGS 101B,A01,091572,Allen; Michael Gordon,12,0,65,53
1657698883574,COGS 101C,A01,083625,Delgado; Tania,17,0,35,18
1657698889601,COGS 107A,A01,083627,Boyle; Mary E. T.,13,0,60,47
1657698895625,COGS 118A,A01,083075,Gupta; Anjum,21,0,76,55
1657698901656,CSE 3,A50,083646,Miranda; Gregory Joseph,24,0,50,26
1657698907683,CSE 8A,A50,083650,Miranda; Gregory Joseph,17,1,56,39
1657698913709,CSE 11,A01,083080,Cao; Yingjun,6,15,40,34
1657698919733,CSE 12,A01,083652,Krause-Levy; Sophia Louisa,28,1,120,92
1657698925776,CSE 15L,A01,083654,Morris; Justin Loren,9,0,50,41
1657698925776,CSE 15L,A02,083655,Morris; Justin Loren,9,0,50,41
1657698931805,CSE 20,A01,083657,Tran; Khoa Dang,39,0,80,41
1657698937831,CSE 21,A01,095574,Bach; Quang Tran,22,0,48,26
1657698943861,CSE 30,A01,083084,Eldon; John,6,0,80,74
1657698943861,CSE 30,B01,095061,Bhaskar; Nishant,9,0,50,41
1657698949890,CSE 100,A01,083659,Cao; Yingjun,5,4,70,65
1657698955919,CSE 134B,A01,083661,Powell; Thomas Allan,23,0,100,77
1657698961955,CSE 140,A01,083663,Gungor; Onat,15,0,85,70
1657698967987,CSE 140L,A01,083088,Eldon; John,22,0,100,78
1657698974012,CSE 175,A01,083665,Kumar; Rakesh,3,0,25,22
1657698980045,CSE 190,A00,092507,Dubnov; Shlomo,8,0,20,12
1657698986075,ECE 45,A01,083139,Congero; Spencer William,6,0,75,69
1657698992100,ECE 65,A50,083695,Saad; Andrew S,12,0,30,18
1657698992100,ECE 65,A51,095125,Saad; Andrew S,24,0,26,2
1657698998148,ECE 109,A01,091882,Touri; Behrouz,20,0,70,50
1657699004173,ECE 180,A00,083140,Abi Samra; Nicholas Camill,1,0,30,29
1657699004173,ECE 180,B00,083141,Abi Samra; Nicholas Camill,0,0,30,30
1657699010198,MATH 10A,A01,083735,Patchell; Gregory David,2,0,30,28
1657699010198,MATH 10A,A02,083736,Patchell; Gregory David,20,0,30,10
1657699010198,MATH 10A,A03,083737,Patchell; Gregory David,16,0,30,14
1657699016226,MATH 10B,A01,083207,Lim; Seonhee,8,0,34,26
1657699016226,MATH 10B,A02,083208,Lim; Seonhee,9,0,35,26
1657699016226,MATH 10B,A03,093472,Lim; Seonhee,7,0,34,27
1657699016226,MATH 10B,B01,083739,Sinha; Shubham,13,0,30,17
1657699022264,MATH 18,A01,083743,Cinel; Cameron Alexander,8,0,30,22
1657699022264,MATH 18,A02,083744,Cinel; Cameron Alexander,17,0,30,13
1657699022264,MATH 18,A03,083745,Cinel; Cameron Alexander,10,0,30,20
1657699022264,MATH 18,B01,083748,Rideout; David Porter,5,0,37,32
1657699022264,MATH 18,B02,083749,Rideout; David Porter,5,0,36,31
1657699022264,MATH 18,B03,083750,Rideout; David Porter,3,0,37,34
1657699022264,MATH 18,B04,083751,Rideout; David Porter,6,0,36,30
1657699022264,MATH 18,B05,093473,Rideout; David Porter,6,0,36,30
1657699022264,MATH 18,B06,093474,Rideout; David Porter,6,0,36,30
1657699028295,MATH 20A,A01,083754,Zheng; Zequn,14,0,40,26
1657699034325,MATH 20B,A01,083756,Briones; Jor-el Thomas Caparas,4,0,36,32
1657699034325,MATH 20B,A02,083757,Briones; Jor-el Thomas Caparas,1,0,36,35
1657699034325,MATH 20B,A03,093475,Briones; Jor-el Thomas Caparas,2,0,36,34
1657699040349,MATH 20C,A01,083760,Briones; Jor-el Thomas Caparas,1,0,35,34
1657699040349,MATH 20C,A02,083761,Briones; Jor-el Thomas Caparas,8,0,35,27
1657699040349,MATH 20C,A03,093476,Briones; Jor-el Thomas Caparas,0,1,36,36
1657699040349,MATH 20C,B01,083762,Bach; Quang Tran,1,0,30,29
1657699046379,MATH 20D,A01,083765,Tran; Brian Kha,5,0,30,25
1657699046379,MATH 20D,A02,083766,Tran; Brian Kha,5,0,30,25
1657699046379,MATH 20D,A03,083767,Tran; Brian Kha,5,0,30,25
1657699052403,MATH 20E,A01,083771,Ganguly; Soumya,9,0,32,23
1657699052403,MATH 20E,A02,083772,Ganguly; Soumya,6,0,32,26
1657699052403,MATH 20E,B01,083773,Ciotti; Benjamin,20,0,35,15
1657699052403,MATH 20E,B02,083774,Ciotti; Benjamin,18,0,35,17
1657699058430,MATH 103A,A01,083777,Greenfeld; Be'Eri,3,0,36,33
1657699058430,MATH 103A,A02,083778,Greenfeld; Be'Eri,5,0,36,31
1657699058430,MATH 103A,A03,093561,Greenfeld; Be'Eri,6,0,36,30
1657699058430,MATH 103A,B01,083779,Greenfeld; Be'Eri,7,0,36,29
1657699058430,MATH 103A,B02,083780,Greenfeld; Be'Eri,4,0,36,32
1657699058430,MATH 103A,B03,093562,Greenfeld; Be'Eri,3,0,36,33
1657699064455,MATH 105,A01,085443,Carter; Anne Toulson,15,0,35,20
1657699064455,MATH 105,A02,093477,Carter; Anne Toulson,20,0,35,15
1657699070484,MATH 109,A01,083213,Ganzberger; Geoffrey Michael,2,0,34,32
1657699070484,MATH 109,A02,083214,Ganzberger; Geoffrey Michael,4,0,34,30
1657699070484,MATH 109,A03,093478,Ganzberger; Geoffrey Michael,2,0,34,32
1657699070484,MATH 109,B01,083215,Ganzberger; Geoffrey Michael,1,0,32,31
1657699070484,MATH 109,B02,083216,Ganzberger; Geoffrey Michael,2,0,32,30
1657699070484,MATH 109,B03,093479,Ganzberger; Geoffrey Michael,8,0,32,24
1657699076518,MATH 142A,A01,083219,Chow; Bennett,7,0,32,25
1657699076518,MATH 142A,A02,083220,Chow; Bennett,10,0,32,22
1657699076518,MATH 142A,A03,093480,Chow; Bennett,9,0,32,23
1657699076518,MATH 142A,B03,093481,Chow; Bennett,8,0,32,24
1657699076518,MATH 142A,B04,093558,Chow; Bennett,13,0,32,19
1657699076518,MATH 142A,B05,093559,Chow; Bennett,6,0,32,26
1657699082549,MATH 193A,A01,083224,Rotar; Vladimir,8,0,34,26
1657699082549,MATH 193A,A02,083225,Rotar; Vladimir,9,0,34,25
1657699082549,MATH 193A,A03,083781,Rotar; Vladimir,5,0,34,29
1657699082549,MATH 193A,A04,083782,Rotar; Vladimir,10,0,34,24
1657699082549,MATH 193A,A05,093482,Rotar; Vladimir,10,0,34,24
1657699088573,MATH 197,001,091859,McAuley; Julian John,9999,0,9999,0
1657699088573,MATH 197,002,095566,Kedlaya; Kiran S.,9997,0,9999,2
1657699088573,MATH 197,003,095567,Xiao; Ming,9999,0,9999,0
1657699088573,MATH 197,004,095571,Perols; Johan Lars,9998,0,9999,1
1657699095632,COGS 9,A01,083615,Shannon; Kyle Michael,9,0,75,66
1657699101658,COGS 11,A01,083617,Boyle; Mary E. T.,23,0,48,25
1657699107683,COGS 13,A01,083071,Bastos; Amalia Pinkusfeld,11,0,71,60
1657699113705,COGS 14A,A01,092681,Semenuks; Arturs,5,1,100,95
1657699119730,COGS 14B,A01,083073,Cheng; Tzu-Han,6,0,63,57
1657699125756,COGS 17,A01,092677,Semenuks; Arturs,6,0,81,75
1657699131782,COGS 100,A01,083619,Allen; Michael Gordon,17,0,70,53
1657699137807,COGS 101A,A01,083621,Davis; Joshua Daniel,9,0,68,59
1657699143831,COGS 101B,A01,091572,Allen; Michael Gordon,12,0,65,53
1657699149854,COGS 101C,A01,083625,Delgado; Tania,17,0,35,18
1657699155952,COGS 107A,A01,083627,Boyle; Mary E. T.,13,0,60,47
1657699161980,COGS 118A,A01,083075,Gupta; Anjum,21,0,76,55
1657699168003,CSE 3,A50,083646,Miranda; Gregory Joseph,24,0,50,26
1657699174027,CSE 8A,A50,083650,Miranda; Gregory Joseph,17,1,56,39
1657699180049,CSE 11,A01,083080,Cao; Yingjun,6,15,40,34
1657699186072,CSE 12,A01,083652,Krause-Levy; Sophia Louisa,28,1,120,92
1657699192102,CSE 15L,A01,083654,Morris; Justin Loren,9,0,50,41
1657699192102,CSE 15L,A02,083655,Morris; Justin Loren,9,0,50,41
1657699198130,CSE 20,A01,083657,Tran; Khoa Dang,39,0,80,41
1657699204154,CSE 21,A01,095574,Bach; Quang Tran,22,0,48,26
1657699210183,CSE 30,A01,083084,Eldon; John,6,0,80,74
1657699210183,CSE 30,B01,095061,Bhaskar; Nishant,9,0,50,41
1657699216205,CSE 100,A01,083659,Cao; Yingjun,5,4,70,65
1657699222227,CSE 134B,A01,083661,Powell; Thomas Allan,23,0,100,77
1657699228249,CSE 140,A01,083663,Gungor; Onat,15,0,85,70
1657699234280,CSE 140L,A01,083088,Eldon; John,22,0,100,78
1657699240305,CSE 175,A01,083665,Kumar; Rakesh,3,0,25,22
1657699246329,CSE 190,A00,092507,Dubnov; Shlomo,8,0,20,12
1657699252353,ECE 45,A01,083139,Congero; Spencer William,6,0,75,69
1657699258376,ECE 65,A50,083695,Saad; Andrew S,12,0,30,18
1657699258376,ECE 65,A51,095125,Saad; Andrew S,24,0,26,2
1657699264405,ECE 109,A01,091882,Touri; Behrouz,20,0,70,50
1657699270434,ECE 180,A00,083140,Abi Samra; Nicholas Camill,1,0,30,29
1657699270434,ECE 180,B00,083141,Abi Samra; Nicholas Camill,0,0,30,30
1657699276462,MATH 10A,A01,083735,Patchell; Gregory David,2,0,30,28
1657699276462,MATH 10A,A02,083736,Patchell; Gregory David,20,0,30,10
1657699276462,MATH 10A,A03,083737,Patchell; Gregory David,16,0,30,14
1657699282493,MATH 10B,A01,083207,Lim; Seonhee,8,0,34,26
1657699282493,MATH 10B,A02,083208,Lim; Seonhee,9,0,35,26
1657699282493,MATH 10B,A03,093472,Lim; Seonhee,7,0,34,27
1657699282493,MATH 10B,B01,083739,Sinha; Shubham,13,0,30,17
1657699288533,MATH 18,A01,083743,Cinel; Cameron Alexander,8,0,30,22
1657699288533,MATH 18,A02,083744,Cinel; Cameron Alexander,17,0,30,13
1657699288533,MATH 18,A03,083745,Cinel; Cameron Alexander,10,0,30,20
1657699288533,MATH 18,B01,083748,Rideout; David Porter,5,0,37,32
1657699288533,MATH 18,B02,083749,Rideout; David Porter,5,0,36,31
1657699288533,MATH 18,B03,083750,Rideout; David Porter,3,0,37,34
1657699288533,MATH 18,B04,083751,Rideout; David Porter,6,0,36,30
1657699288533,MATH 18,B05,093473,Rideout; David Porter,6,0,36,30
1657699288533,MATH 18,B06,093474,Rideout; David Porter,6,0,36,30
1657699294564,MATH 20A,A01,083754,Zheng; Zequn,14,0,40,26
1657699300590,MATH 20B,A01,083756,Briones; Jor-el Thomas Caparas,4,0,36,32
1657699300590,MATH 20B,A02,083757,Briones; Jor-el Thomas Caparas,1,0,36,35
1657699300590,MATH 20B,A03,093475,Briones; Jor-el Thomas Caparas,2,0,36,34
1657699306623,MATH 20C,A01,083760,Briones; Jor-el Thomas Caparas,1,0,35,34
1657699306623,MATH 20C,A02,083761,Briones; Jor-el Thomas Caparas,8,0,35,27
1657699306623,MATH 20C,A03,093476,Briones; Jor-el Thomas Caparas,0,1,36,36
1657699306623,MATH 20C,B01,083762,Bach; Quang Tran,1,0,30,29
1657699312647,MATH 20D,A01,083765,Tran; Brian Kha,5,0,30,25
1657699312647,MATH 20D,A02,083766,Tran; Brian Kha,5,0,30,25
1657699312647,MATH 20D,A03,083767,Tran; Brian Kha,5,0,30,25
1657699318681,MATH 20E,A01,083771,Ganguly; Soumya,9,0,32,23
1657699318681,MATH 20E,A02,083772,Ganguly; Soumya,6,0,32,26
1657699318681,MATH 20E,B01,083773,Ciotti; Benjamin,20,0,35,15
1657699318681,MATH 20E,B02,083774,Ciotti; Benjamin,18,0,35,17
1657699324717,MATH 103A,A01,083777,Greenfeld; Be'Eri,3,0,36,33
1657699324717,MATH 103A,A02,083778,Greenfeld; Be'Eri,5,0,36,31
1657699324717,MATH 103A,A03,093561,Greenfeld; Be'Eri,6,0,36,30
1657699324717,MATH 103A,B01,083779,Greenfeld; Be'Eri,7,0,36,29
1657699324717,MATH 103A,B02,083780,Greenfeld; Be'Eri,4,0,36,32
1657699324717,MATH 103A,B03,093562,Greenfeld; Be'Eri,3,0,36,33
1657699330741,MATH 105,A01,085443,Carter; Anne Toulson,15,0,35,20
1657699330741,MATH 105,A02,093477,Carter; Anne Toulson,20,0,35,15
1657699336767,MATH 109,A01,083213,Ganzberger; Geoffrey Michael,2,0,34,32
1657699336767,MATH 109,A02,083214,Ganzberger; Geoffrey Michael,4,0,34,30
1657699336767,MATH 109,A03,093478,Ganzberger; Geoffrey Michael,2,0,34,32
1657699336767,MATH 109,B01,083215,Ganzberger; Geoffrey Michael,1,0,32,31
1657699336767,MATH 109,B02,083216,Ganzberger; Geoffrey Michael,2,0,32,30
1657699336767,MATH 109,B03,093479,Ganzberger; Geoffrey Michael,8,0,32,24
1657699342793,MATH 142A,A01,083219,Chow; Bennett,7,0,32,25
1657699342793,MATH 142A,A02,083220,Chow; Bennett,10,0,32,22
1657699342793,MATH 142A,A03,093480,Chow; Bennett,9,0,32,23
1657699342793,MATH 142A,B03,093481,Chow; Bennett,8,0,32,24
1657699342793,MATH 142A,B04,093558,Chow; Bennett,13,0,32,19
1657699342793,MATH 142A,B05,093559,Chow; Bennett,6,0,32,26
1657699348833,MATH 193A,A01,083224,Rotar; Vladimir,8,0,34,26
1657699348833,MATH 193A,A02,083225,Rotar; Vladimir,9,0,34,25
1657699348833,MATH 193A,A03,083781,Rotar; Vladimir,5,0,34,29
1657699348833,MATH 193A,A04,083782,Rotar; Vladimir,10,0,34,24
1657699348833,MATH 193A,A05,093482,Rotar; Vladimir,10,0,34,24
1657699354864,MATH 197,001,091859,McAuley; Julian John,9999,0,9999,0
1657699354864,MATH 197,002,095566,Kedlaya; Kiran S.,9997,0,9999,2
1657699354864,MATH 197,003,095567,Xiao; Ming,9999,0,9999,0
1657699354864,MATH 197,004,095571,Perols; Johan Lars,9998,0,9999,1
1657699361962,COGS 9,A01,083615,Shannon; Kyle Michael,9,0,75,66
1657699367989,COGS 11,A01,083617,Boyle; Mary E. T.,23,0,48,25
1657699374022,COGS 13,A01,083071,Bastos; Amalia Pinkusfeld,11,0,71,60
1657699380047,COGS 14A,A01,092681,Semenuks; Arturs,5,1,100,95
1657699386075,COGS 14B,A01,083073,Cheng; Tzu-Han,6,0,63,57
1657699392099,COGS 17,A01,092677,Semenuks; Arturs,6,0,81,75
1657699398124,COGS 100,A01,083619,Allen; Michael Gordon,17,0,70,53
1657699404154,COGS 101A,A01,083621,Davis; Joshua Daniel,9,0,68,59
1657699410182,COGS 101B,A01,091572,Allen; Michael Gordon,12,0,65,53
1657699416213,COGS 101C,A01,083625,Delgado; Tania,17,0,35,18
1657699422239,COGS 107A,A01,083627,Boyle; Mary E. T.,13,0,60,47
1657699428263,COGS 118A,A01,083075,Gupta; Anjum,21,0,76,55
1657699434289,CSE 3,A50,083646,Miranda; Gregory Joseph,24,0,50,26
1657699440314,CSE 8A,A50,083650,Miranda; Gregory Joseph,17,1,56,39
1657699446336,CSE 11,A01,083080,Cao; Yingjun,6,15,40,34
1657699452360,CSE 12,A01,083652,Krause-Levy; Sophia Louisa,28,1,120,92
1657699458390,CSE 15L,A01,083654,Morris; Justin Loren,9,0,50,41
1657699458390,CSE 15L,A02,083655,Morris; Justin Loren,9,0,50,41
1657699464416,CSE 20,A01,083657,Tran; Khoa Dang,39,0,80,41
1657699470441,CSE 21,A01,095574,Bach; Quang Tran,22,0,48,26
1657699476472,CSE 30,A01,083084,Eldon; John,6,0,80,74
1657699476472,CSE 30,B01,095061,Bhaskar; Nishant,9,0,50,41
1657699482496,CSE 100,A01,083659,Cao; Yingjun,5,4,70,65
1657699488519,CSE 134B,A01,083661,Powell; Thomas Allan,23,0,100,77
1657699494544,CSE 140,A01,083663,Gungor; Onat,15,0,85,70
1657699500579,CSE 140L,A01,083088,Eldon; John,22,0,100,78
1657699506604,CSE 175,A01,083665,Kumar; Rakesh,3,0,25,22
1657699512631,CSE 190,A00,092507,Dubnov; Shlomo,8,0,20,12
1657699518660,ECE 45,A01,083139,Congero; Spencer William,6,0,75,69
1657699524685,ECE 65,A50,083695,Saad; Andrew S,12,0,30,18
1657699524685,ECE 65,A51,095125,Saad; Andrew S,24,0,26,2
1657699530715,ECE 109,A01,091882,Touri; Behrouz,20,0,70,50
1657699536741,ECE 180,A00,083140,Abi Samra; Nicholas Camill,1,0,30,29
1657699536741,ECE 180,B00,083141,Abi Samra; Nicholas Camill,0,0,30,30
1657699542769,MATH 10A,A01,083735,Patchell; Gregory David,2,0,30,28
1657699542769,MATH 10A,A02,083736,Patchell; Gregory David,20,0,30,10
1657699542769,MATH 10A,A03,083737,Patchell; Gregory David,16,0,30,14
1657699548805,MATH 10B,A01,083207,Lim; Seonhee,8,0,34,26
1657699548805,MATH 10B,A02,083208,Lim; Seonhee,9,0,35,26
1657699548805,MATH 10B,A03,093472,Lim; Seonhee,7,0,34,27
1657699548805,MATH 10B,B01,083739,Sinha; Shubham,13,0,30,17
1657699554846,MATH 18,A01,083743,Cinel; Cameron Alexander,8,0,30,22
1657699554846,MATH 18,A02,083744,Cinel; Cameron Alexander,17,0,30,13
1657699554846,MATH 18,A03,083745,Cinel; Cameron Alexander,10,0,30,20
1657699554846,MATH 18,B01,083748,Rideout; David Porter,5,0,37,32
1657699554846,MATH 18,B02,083749,Rideout; David Porter,5,0,36,31
1657699554846,MATH 18,B03,083750,Rideout; David Porter,3,0,37,34
1657699554846,MATH 18,B04,083751,Rideout; David Porter,6,0,36,30
1657699554846,MATH 18,B05,093473,Rideout; David Porter,6,0,36,30
1657699554846,MATH 18,B06,093474,Rideout; David Porter,6,0,36,30
1657699560870,MATH 20A,A01,083754,Zheng; Zequn,14,0,40,26
1657699566912,MATH 20B,A01,083756,Briones; Jor-el Thomas Caparas,4,0,36,32
1657699566912,MATH 20B,A02,083757,Briones; Jor-el Thomas Caparas,1,0,36,35
1657699566912,MATH 20B,A03,093475,Briones; Jor-el Thomas Caparas,2,0,36,34
1657699572938,MATH 20C,A01,083760,Briones; Jor-el Thomas Caparas,1,0,35,34
1657699572938,MATH 20C,A02,083761,Briones; Jor-el Thomas Caparas,8,0,35,27
1657699572938,MATH 20C,A03,093476,Briones; Jor-el Thomas Caparas,0,1,36,36
1657699572938,MATH 20C,B01,083762,Bach; Quang Tran,1,0,30,29
1657699578971,MATH 20D,A01,083765,Tran; Brian Kha,5,0,30,25
1657699578971,MATH 20D,A02,083766,Tran; Brian Kha,5,0,30,25
1657699578971,MATH 20D,A03,083767,Tran; Brian Kha,5,0,30,25
1657699585006,MATH 20E,A01,083771,Ganguly; Soumya,9,0,32,23
1657699585006,MATH 20E,A02,083772,Ganguly; Soumya,6,0,32,26
1657699585006,MATH 20E,B01,083773,Ciotti; Benjamin,20,0,35,15
1657699585006,MATH 20E,B02,083774,Ciotti; Benjamin,18,0,35,17
1657699591035,MATH 103A,A01,083777,Greenfeld; Be'Eri,3,0,36,33
1657699591035,MATH 103A,A02,083778,Greenfeld; Be'Eri,5,0,36,31
1657699591035,MATH 103A,A03,093561,Greenfeld; Be'Eri,6,0,36,30
1657699591035,MATH 103A,B01,083779,Greenfeld; Be'Eri,7,0,36,29
1657699591035,MATH 103A,B02,083780,Greenfeld; Be'Eri,4,0,36,32
1657699591035,MATH 103A,B03,093562,Greenfeld; Be'Eri,3,0,36,33
1657699597059,MATH 105,A01,085443,Carter; Anne Toulson,15,0,35,20
1657699597059,MATH 105,A02,093477,Carter; Anne Toulson,20,0,35,15
1657699603085,MATH 109,A01,083213,Ganzberger; Geoffrey Michael,2,0,34,32
1657699603085,MATH 109,A02,083214,Ganzberger; Geoffrey Michael,4,0,34,30
1657699603085,MATH 109,A03,093478,Ganzberger; Geoffrey Michael,2,0,34,32
1657699603085,MATH 109,B01,083215,Ganzberger; Geoffrey Michael,1,0,32,31
1657699603085,MATH 109,B02,083216,Ganzberger; Geoffrey Michael,2,0,32,30
1657699603085,MATH 109,B03,093479,Ganzberger; Geoffrey Michael,8,0,32,24
1657699609114,MATH 142A,A01,083219,Chow; Bennett,7,0,32,25
1657699609114,MATH 142A,A02,083220,Chow; Bennett,10,0,32,22
1657699609114,MATH 142A,A03,093480,Chow; Bennett,9,0,32,23
1657699609114,MATH 142A,B03,093481,Chow; Bennett,8,0,32,24
1657699609114,MATH 142A,B04,093558,Chow; Bennett,13,0,32,19
1657699609114,MATH 142A,B05,093559,Chow; Bennett,6,0,32,26
1657699615150,MATH 193A,A01,083224,Rotar; Vladimir,8,0,34,26
1657699615150,MATH 193A,A02,083225,Rotar; Vladimir,9,0,34,25
1657699615150,MATH 193A,A03,083781,Rotar; Vladimir,5,0,34,29
1657699615150,MATH 193A,A04,083782,Rotar; Vladimir,10,0,34,24
1657699615150,MATH 193A,A05,093482,Rotar; Vladimir,10,0,34,24
1657699621181,MATH 197,001,091859,McAuley; Julian John,9999,0,9999,0
1657699621181,MATH 197,002,095566,Kedlaya; Kiran S.,9997,0,9999,2
1657699621181,MATH 197,003,095567,Xiao; Ming,9999,0,9999,0
1657699621181,MATH 197,004,095571,Perols; Johan Lars,9998,0,9999,1
1657699628251,COGS 9,A01,083615,Shannon; Kyle Michael,9,0,75,66
1657699634276,COGS 11,A01,083617,Boyle; Mary E. T.,23,0,48,25
1657699640301,COGS 13,A01,083071,Bastos; Amalia Pinkusfeld,11,0,71,60
1657699646333,COGS 14A,A01,092681,Semenuks; Arturs,5,1,100,95
1657699652357,COGS 14B,A01,083073,Cheng; Tzu-Han,6,0,63,57
1657699658386,COGS 17,A01,092677,Semenuks; Arturs,6,0,81,75
1657699664417,COGS 100,A01,083619,Allen; Michael Gordon,17,0,70,53
1657699670443,COGS 101A,A01,083621,Davis; Joshua Daniel,9,0,68,59
1657699676466,COGS 101B,A01,091572,Allen; Michael Gordon,12,0,65,53
1657699682491,COGS 101C,A01,083625,Delgado; Tania,17,0,35,18
1657699688519,COGS 107A,A01,083627,Boyle; Mary E. T.,13,0,60,47
1657699694543,COGS 118A,A01,083075,Gupta; Anjum,21,0,76,55
1657699700574,CSE 3,A50,083646,Miranda; Gregory Joseph,24,0,50,26
1657699706605,CSE 8A,A50,083650,Miranda; Gregory Joseph,17,1,56,39
1657699712636,CSE 11,A01,083080,Cao; Yingjun,6,15,40,34
1657699718661,CSE 12,A01,083652,Krause-Levy; Sophia Louisa,28,1,120,92
1657699724692,CSE 15L,A01,083654,Morris; Justin Loren,9,0,50,41
1657699724692,CSE 15L,A02,083655,Morris; Justin Loren,9,0,50,41
1657699730721,CSE 20,A01,083657,Tran; Khoa Dang,39,0,80,41
1657699736745,CSE 21,A01,095574,Bach; Quang Tran,22,0,48,26
1657699742770,CSE 30,A01,083084,Eldon; John,6,0,80,74
1657699742770,CSE 30,B01,095061,Bhaskar; Nishant,9,0,50,41
1657699748794,CSE 100,A01,083659,Cao; Yingjun,5,4,70,65
1657699754905,CSE 134B,A01,083661,Powell; Thomas Allan,23,0,100,77
1657699760928,CSE 140,A01,083663,Gungor; Onat,15,0,85,70
1657699766951,CSE 140L,A01,083088,Eldon; John,22,0,100,78
1657699772981,CSE 175,A01,083665,Kumar; Rakesh,3,0,25,22
1657699779022,CSE 190,A00,092507,Dubnov; Shlomo,8,0,20,12
1657699785051,ECE 45,A01,083139,Congero; Spencer William,6,0,75,69
1657699791084,ECE 65,A50,083695,Saad; Andrew S,12,0,30,18
1657699791084,ECE 65,A51,095125,Saad; Andrew S,24,0,26,2
1657699797142,ECE 109,A01,091882,Touri; Behrouz,20,0,70,50
1657699803174,ECE 180,A00,083140,Abi Samra; Nicholas Camill,1,0,30,29
1657699803174,ECE 180,B00,083141,Abi Samra; Nicholas Camill,0,0,30,30
1657699809207,MATH 10A,A01,083735,Patchell; Gregory David,2,0,30,28
1657699809207,MATH 10A,A02,083736,Patchell; Gregory David,20,0,30,10
1657699809207,MATH 10A,A03,083737,Patchell; Gregory David,16,0,30,14
1657699815232,MATH 10B,A01,083207,Lim; Seonhee,8,0,34,26
1657699815232,MATH 10B,A02,083208,Lim; Seonhee,9,0,35,26
1657699815232,MATH 10B,A03,093472,Lim; Seonhee,7,0,34,27
1657699815232,MATH 10B,B01,083739,Sinha; Shubham,13,0,30,17
1657699821259,MATH 18,A01,083743,Cinel; Cameron Alexander,8,0,30,22
1657699821259,MATH 18,A02,083744,Cinel; Cameron Alexander,17,0,30,13
1657699821259,MATH 18,A03,083745,Cinel; Cameron Alexander,10,0,30,20
1657699821259,MATH 18,B01,083748,Rideout; David Porter,5,0,37,32
1657699821259,MATH 18,B02,083749,Rideout; David Porter,5,0,36,31
1657699821259,MATH 18,B03,083750,Rideout; David Porter,3,0,37,34
1657699821259,MATH 18,B04,083751,Rideout; David Porter,6,0,36,30
1657699821259,MATH 18,B05,093473,Rideout; David Porter,6,0,36,30
1657699821259,MATH 18,B06,093474,Rideout; David Porter,6,0,36,30
1657699827291,MATH 20A,A01,083754,Zheng; Zequn,14,0,40,26
1657699833318,MATH 20B,A01,083756,Briones; Jor-el Thomas Caparas,4,0,36,32
1657699833318,MATH 20B,A02,083757,Briones; Jor-el Thomas Caparas,1,0,36,35
1657699833318,MATH 20B,A03,093475,Briones; Jor-el Thomas Caparas,2,0,36,34
1657699839350,MATH 20C,A01,083760,Briones; Jor-el Thomas Caparas,1,0,35,34
1657699839350,MATH 20C,A02,083761,Briones; Jor-el Thomas Caparas,8,0,35,27
1657699839350,MATH 20C,A03,093476,Briones; Jor-el Thomas Caparas,0,1,36,36
1657699839350,MATH 20C,B01,083762,Bach; Quang Tran,1,0,30,29
1657699845374,MATH 20D,A01,083765,Tran; Brian Kha,5,0,30,25
1657699845374,MATH 20D,A02,083766,Tran; Brian Kha,5,0,30,25
1657699845374,MATH 20D,A03,083767,Tran; Brian Kha,5,0,30,25
1657699851402,MATH 20E,A01,083771,Ganguly; Soumya,9,0,32,23
1657699851402,MATH 20E,A02,083772,Ganguly; Soumya,6,0,32,26
1657699851402,MATH 20E,B01,083773,Ciotti; Benjamin,20,0,35,15
1657699851402,MATH 20E,B02,083774,Ciotti; Benjamin,18,0,35,17
1657699857435,MATH 103A,A01,083777,Greenfeld; Be'Eri,3,0,36,33
1657699857435,MATH 103A,A02,083778,Greenfeld; Be'Eri,5,0,36,31
1657699857435,MATH 103A,A03,093561,Greenfeld; Be'Eri,6,0,36,30
1657699857435,MATH 103A,B01,083779,Greenfeld; Be'Eri,7,0,36,29
1657699857435,MATH 103A,B02,083780,Greenfeld; Be'Eri,4,0,36,32
1657699857435,MATH 103A,B03,093562,Greenfeld; Be'Eri,3,0,36,33
1657699863457,MATH 105,A01,085443,Carter; Anne Toulson,15,0,35,20
1657699863457,MATH 105,A02,093477,Carter; Anne Toulson,20,0,35,15
1657699869481,MATH 109,A01,083213,Ganzberger; Geoffrey Michael,2,0,34,32
1657699869481,MATH 109,A02,083214,Ganzberger; Geoffrey Michael,4,0,34,30
1657699869481,MATH 109,A03,093478,Ganzberger; Geoffrey Michael,2,0,34,32
1657699869481,MATH 109,B01,083215,Ganzberger; Geoffrey Michael,1,0,32,31
1657699869481,MATH 109,B02,083216,Ganzberger; Geoffrey Michael,2,0,32,30
1657699869481,MATH 109,B03,093479,Ganzberger; Geoffrey Michael,8,0,32,24
1657699875507,MATH 142A,A01,083219,Chow; Bennett,7,0,32,25
1657699875507,MATH 142A,A02,083220,Chow; Bennett,10,0,32,22
1657699875507,MATH 142A,A03,093480,Chow; Bennett,9,0,32,23
1657699875507,MATH 142A,B03,093481,Chow; Bennett,8,0,32,24
1657699875507,MATH 142A,B04,093558,Chow; Bennett,13,0,32,19
1657699875507,MATH 142A,B05,093559,Chow; Bennett,6,0,32,26
1657699881541,MATH 193A,A01,083224,Rotar; Vladimir,8,0,34,26
1657699881541,MATH 193A,A02,083225,Rotar; Vladimir,9,0,34,25
1657699881541,MATH 193A,A03,083781,Rotar; Vladimir,5,0,34,29
1657699881541,MATH 193A,A04,083782,Rotar; Vladimir,10,0,34,24
1657699881541,MATH 193A,A05,093482,Rotar; Vladimir,10,0,34,24
1657699887568,MATH 197,001,091859,McAuley; Julian John,9999,0,9999,0
1657699887568,MATH 197,002,095566,Kedlaya; Kiran S.,9997,0,9999,2
1657699887568,MATH 197,003,095567,Xiao; Ming,9999,0,9999,0
1657699887568,MATH 197,004,095571,Perols; Johan Lars,9998,0,9999,1
1657699894646,COGS 9,A01,083615,Shannon; Kyle Michael,9,0,75,66
1657699900670,COGS 11,A01,083617,Boyle; Mary E. T.,23,0,48,25
1657699906702,COGS 13,A01,083071,Bastos; Amalia Pinkusfeld,11,0,71,60
1657699912730,COGS 14A,A01,092681,Semenuks; Arturs,5,1,100,95
1657699918755,COGS 14B,A01,083073,Cheng; Tzu-Han,6,0,63,57
1657699924783,COGS 17,A01,092677,Semenuks; Arturs,6,0,81,75
1657699930810,COGS 100,A01,083619,Allen; Michael Gordon,17,0,70,53
1657699936834,COGS 101A,A01,083621,Davis; Joshua Daniel,9,0,68,59
1657699942863,COGS 101B,A01,091572,Allen; Michael Gordon,12,0,65,53
1657699948887,COGS 101C,A01,083625,Delgado; Tania,17,0,35,18
1657699954916,COGS 107A,A01,083627,Boyle; Mary E. T.,13,0,60,47
1657699960940,COGS 118A,A01,083075,Gupta; Anjum,21,0,76,55
1657699966965,CSE 3,A50,083646,Miranda; Gregory Joseph,24,0,50,26
1657699972998,CSE 8A,A50,083650,Miranda; Gregory Joseph,17,1,56,39
1657699979027,CSE 11,A01,083080,Cao; Yingjun,6,15,40,34
1657699985059,CSE 12,A01,083652,Krause-Levy; Sophia Louisa,28,1,120,92
1657699991089,CSE 15L,A01,083654,Morris; Justin Loren,9,0,50,41
1657699991089,CSE 15L,A02,083655,Morris; Justin Loren,9,0,50,41
1657699997119,CSE 20,A01,083657,Tran; Khoa Dang,39,0,80,41
1657700003145,CSE 21,A01,095574,Bach; Quang Tran,22,0,48,26
1657700009182,CSE 30,A01,083084,Eldon; John,6,0,80,74
1657700009182,CSE 30,B01,095061,Bhaskar; Nishant,9,0,50,41
1657700015207,CSE 100,A01,083659,Cao; Yingjun,5,4,70,65
1657700021246,CSE 134B,A01,083661,Powell; Thomas Allan,23,0,100,77
1657700027268,CSE 140,A01,083663,Gungor; Onat,15,0,85,70
1657700033296,CSE 140L,A01,083088,Eldon; John,22,0,100,78
1657700039321,CSE 175,A01,083665,Kumar; Rakesh,3,0,25,22
1657700045349,CSE 190,A00,092507,Dubnov; Shlomo,8,0,20,12
1657700051373,ECE 45,A01,083139,Congero; Spencer William,6,0,75,69
1657700057398,ECE 65,A50,083695,Saad; Andrew S,12,0,30,18
1657700057398,ECE 65,A51,095125,Saad; Andrew S,24,0,26,2
1657700063423,ECE 109,A01,091882,Touri; Behrouz,20,0,70,50
1657700069453,ECE 180,A00,083140,Abi Samra; Nicholas Camill,1,0,30,29
1657700069453,ECE 180,B00,083141,Abi Samra; Nicholas Camill,0,0,30,30
1657700075477,MATH 10A,A01,083735,Patchell; Gregory David,2,0,30,28
1657700075477,MATH 10A,A02,083736,Patchell; Gregory David,20,0,30,10
1657700075477,MATH 10A,A03,083737,Patchell; Gregory David,16,0,30,14
1657700081503,MATH 10B,A01,083207,Lim; Seonhee,8,0,34,26
1657700081503,MATH 10B,A02,083208,Lim; Seonhee,9,0,35,26
1657700081503,MATH 10B,A03,093472,Lim; Seonhee,7,0,34,27
1657700081503,MATH 10B,B01,083739,Sinha; Shubham,13,0,30,17
1657700087530,MATH 18,A01,083743,Cinel; Cameron Alexander,8,0,30,22
1657700087530,MATH 18,A02,083744,Cinel; Cameron Alexander,17,0,30,13
1657700087530,MATH 18,A03,083745,Cinel; Cameron Alexander,10,0,30,20
1657700087530,MATH 18,B01,083748,Rideout; David Porter,5,0,37,32
1657700087530,MATH 18,B02,083749,Rideout; David Porter,5,0,36,31
1657700087530,MATH 18,B03,083750,Rideout; David Porter,3,0,37,34
1657700087530,MATH 18,B04,083751,Rideout; David Porter,6,0,36,30
1657700087530,MATH 18,B05,093473,Rideout; David Porter,6,0,36,30
1657700087530,MATH 18,B06,093474,Rideout; David Porter,6,0,36,30
1657700093561,MATH 20A,A01,083754,Zheng; Zequn,14,0,40,26
1657700099594,MATH 20B,A01,083756,Briones; Jor-el Thomas Caparas,4,0,36,32
1657700099594,MATH 20B,A02,083757,Briones; Jor-el Thomas Caparas,1,0,36,35
1657700099594,MATH 20B,A03,093475,Briones; Jor-el Thomas Caparas,2,0,36,34
1657700105618,MATH 20C,A01,083760,Briones; Jor-el Thomas Caparas,1,0,35,34
1657700105618,MATH 20C,A02,083761,Briones; Jor-el Thomas Caparas,8,0,35,27
1657700105618,MATH 20C,A03,093476,Briones; Jor-el Thomas Caparas,0,1,36,36
1657700105618,MATH 20C,B01,083762,Bach; Quang Tran,1,0,30,29
1657700111648,MATH 20D,A01,083765,Tran; Brian Kha,5,0,30,25
1657700111648,MATH 20D,A02,083766,Tran; Brian Kha,5,0,30,25
1657700111648,MATH 20D,A03,083767,Tran; Brian Kha,5,0,30,25
1657700117673,MATH 20E,A01,083771,Ganguly; Soumya,9,0,32,23
1657700117673,MATH 20E,A02,083772,Ganguly; Soumya,6,0,32,26
1657700117673,MATH 20E,B01,083773,Ciotti; Benjamin,20,0,35,15
1657700117673,MATH 20E,B02,083774,Ciotti; Benjamin,18,0,35,17
1657700123705,MATH 103A,A01,083777,Greenfeld; Be'Eri,3,0,36,33
1657700123705,MATH 103A,A02,083778,Greenfeld; Be'Eri,5,0,36,31
1657700123705,MATH 103A,A03,093561,Greenfeld; Be'Eri,6,0,36,30
1657700123705,MATH 103A,B01,083779,Greenfeld; Be'Eri,7,0,36,29
1657700123705,MATH 103A,B02,083780,Greenfeld; Be'Eri,4,0,36,32
1657700123705,MATH 103A,B03,093562,Greenfeld; Be'Eri,3,0,36,33
1657700129750,MATH 105,A01,085443,Carter; Anne Toulson,15,0,35,20
1657700129750,MATH 105,A02,093477,Carter; Anne Toulson,20,0,35,15
1657700135781,MATH 109,A01,083213,Ganzberger; Geoffrey Michael,2,0,34,32
1657700135781,MATH 109,A02,083214,Ganzberger; Geoffrey Michael,4,0,34,30
1657700135781,MATH 109,A03,093478,Ganzberger; Geoffrey Michael,2,0,34,32
1657700135781,MATH 109,B01,083215,Ganzberger; Geoffrey Michael,1,0,32,31
1657700135781,MATH 109,B02,083216,Ganzberger; Geoffrey Michael,2,0,32,30
1657700135781,MATH 109,B03,093479,Ganzberger; Geoffrey Michael,8,0,32,24
1657700141813,MATH 142A,A01,083219,Chow; Bennett,7,0,32,25
1657700141813,MATH 142A,A02,083220,Chow; Bennett,10,0,32,22
1657700141813,MATH 142A,A03,093480,Chow; Bennett,9,0,32,23
1657700141813,MATH 142A,B03,093481,Chow; Bennett,8,0,32,24
1657700141813,MATH 142A,B04,093558,Chow; Bennett,13,0,32,19
1657700141813,MATH 142A,B05,093559,Chow; Bennett,6,0,32,26
1657700147837,MATH 193A,A01,083224,Rotar; Vladimir,8,0,34,26
1657700147837,MATH 193A,A02,083225,Rotar; Vladimir,9,0,34,25
1657700147837,MATH 193A,A03,083781,Rotar; Vladimir,5,0,34,29
1657700147837,MATH 193A,A04,083782,Rotar; Vladimir,10,0,34,24
1657700147837,MATH 193A,A05,093482,Rotar; Vladimir,10,0,34,24
1657700153862,MATH 197,001,091859,McAuley; Julian John,9999,0,9999,0
1657700153862,MATH 197,002,095566,Kedlaya; Kiran S.,9997,0,9999,2
1657700153862,MATH 197,003,095567,Xiao; Ming,9999,0,9999,0
1657700153862,MATH 197,004,095571,Perols; Johan Lars,9998,0,9999,1
1657700160932,COGS 9,A01,083615,Shannon; Kyle Michael,9,0,75,66
1657700166957,COGS 11,A01,083617,Boyle; Mary E. T.,23,0,48,25
1657700172981,COGS 13,A01,083071,Bastos; Amalia Pinkusfeld,11,0,71,60
1657700179008,COGS 14A,A01,092681,Semenuks; Arturs,5,1,100,95
1657700185032,COGS 14B,A01,083073,Cheng; Tzu-Han,6,0,63,57
1657700191056,COGS 17,A01,092677,Semenuks; Arturs,6,0,81,75
1657700197082,COGS 100,A01,083619,Allen; Michael Gordon,17,0,70,53
1657700203111,COGS 101A,A01,083621,Davis; Joshua Daniel,9,0,68,59
1657700209137,COGS 101B,A01,091572,Allen; Michael Gordon,12,0,65,53
1657700215165,COGS 101C,A01,083625,Delgado; Tania,17,0,35,18
1657700221189,COGS 107A,A01,083627,Boyle; Mary E. T.,13,0,60,47
1657700227213,COGS 118A,A01,083075,Gupta; Anjum,21,0,76,55
1657700233241,CSE 3,A50,083646,Miranda; Gregory Joseph,24,0,50,26
1657700239270,CSE 8A,A50,083650,Miranda; Gregory Joseph,17,1,56,39
1657700245295,CSE 11,A01,083080,Cao; Yingjun,6,15,40,34
1657700251319,CSE 12,A01,083652,Krause-Levy; Sophia Louisa,28,1,120,92
1657700257342,CSE 15L,A01,083654,Morris; Justin Loren,9,0,50,41
1657700257342,CSE 15L,A02,083655,Morris; Justin Loren,9,0,50,41
1657700263368,CSE 20,A01,083657,Tran; Khoa Dang,39,0,80,41
1657700269393,CSE 21,A01,095574,Bach; Quang Tran,22,0,48,26
1657700275418,CSE 30,A01,083084,Eldon; John,6,0,80,74
1657700275418,CSE 30,B01,095061,Bhaskar; Nishant,9,0,50,41
1657700281442,CSE 100,A01,083659,Cao; Yingjun,5,4,70,65
1657700287472,CSE 134B,A01,083661,Powell; Thomas Allan,23,0,100,77
1657700293498,CSE 140,A01,083663,Gungor; Onat,15,0,85,70
1657700299524,CSE 140L,A01,083088,Eldon; John,22,0,100,78
1657700305547,CSE 175,A01,083665,Kumar; Rakesh,3,0,25,22
1657700311575,CSE 190,A00,092507,Dubnov; Shlomo,8,0,20,12
1657700317642,ECE 45,A01,083139,Congero; Spencer William,6,0,75,69
1657700323669,ECE 65,A50,083695,Saad; Andrew S,12,0,30,18
1657700323669,ECE 65,A51,095125,Saad; Andrew S,24,0,26,2
1657700329698,ECE 109,A01,091882,Touri; Behrouz,20,0,70,50
1657700335722,ECE 180,A00,083140,Abi Samra; Nicholas Camill,1,0,30,29
1657700335722,ECE 180,B00,083141,Abi Samra; Nicholas Camill,0,0,30,30
1657700341751,MATH 10A,A01,083735,Patchell; Gregory David,2,0,30,28
1657700341751,MATH 10A,A02,083736,Patchell; Gregory David,20,0,30,10
1657700341751,MATH 10A,A03,083737,Patchell; Gregory David,16,0,30,14
1657700347774,MATH 10B,A01,083207,Lim; Seonhee,8,0,34,26
1657700347774,MATH 10B,A02,083208,Lim; Seonhee,9,0,35,26
1657700347774,MATH 10B,A03,093472,Lim; Seonhee,7,0,34,27
1657700347774,MATH 10B,B01,083739,Sinha; Shubham,13,0,30,17
1657700353872,MATH 18,A01,083743,Cinel; Cameron Alexander,8,0,30,22
1657700353872,MATH 18,A02,083744,Cinel; Cameron Alexander,17,0,30,13
1657700353872,MATH 18,A03,083745,Cinel; Cameron Alexander,10,0,30,20
1657700353872,MATH 18,B01,083748,Rideout; David Porter,5,0,37,32
1657700353872,MATH 18,B02,083749,Rideout; David Porter,5,0,36,31
1657700353872,MATH 18,B03,083750,Rideout; David Porter,3,0,37,34
1657700353872,MATH 18,B04,083751,Rideout; David Porter,6,0,36,30
1657700353872,MATH 18,B05,093473,Rideout; David Porter,6,0,36,30
1657700353872,MATH 18,B06,093474,Rideout; David Porter,6,0,36,30
1657700359908,MATH 20A,A01,083754,Zheng; Zequn,14,0,40,26
1657700365938,MATH 20B,A01,083756,Briones; Jor-el Thomas Caparas,4,0,36,32
1657700365938,MATH 20B,A02,083757,Briones; Jor-el Thomas Caparas,1,0,36,35
1657700365938,MATH 20B,A03,093475,Briones; Jor-el Thomas Caparas,2,0,36,34
1657700371974,MATH 20C,A01,083760,Briones; Jor-el Thomas Caparas,1,0,35,34
1657700371974,MATH 20C,A02,083761,Briones; Jor-el Thomas Caparas,8,0,35,27
1657700371974,MATH 20C,A03,093476,Briones; Jor-el Thomas Caparas,0,1,36,36
1657700371974,MATH 20C,B01,083762,Bach; Quang Tran,1,0,30,29
1657700378008,MATH 20D,A01,083765,Tran; Brian Kha,5,0,30,25
1657700378008,MATH 20D,A02,083766,Tran; Brian Kha,5,0,30,25
1657700378008,MATH 20D,A03,083767,Tran; Brian Kha,5,0,30,25
1657700384036,MATH 20E,A01,083771,Ganguly; Soumya,9,0,32,23
1657700384036,MATH 20E,A02,083772,Ganguly; Soumya,6,0,32,26
1657700384036,MATH 20E,B01,083773,Ciotti; Benjamin,20,0,35,15
1657700384036,MATH 20E,B02,083774,Ciotti; Benjamin,18,0,35,17
1657700390062,MATH 103A,A01,083777,Greenfeld; Be'Eri,3,0,36,33
1657700390062,MATH 103A,A02,083778,Greenfeld; Be'Eri,5,0,36,31
1657700390062,MATH 103A,A03,093561,Greenfeld; Be'Eri,6,0,36,30
1657700390062,MATH 103A,B01,083779,Greenfeld; Be'Eri,7,0,36,29
1657700390062,MATH 103A,B02,083780,Greenfeld; Be'Eri,4,0,36,32
1657700390062,MATH 103A,B03,093562,Greenfeld; Be'Eri,3,0,36,33
1657700396090,MATH 105,A01,085443,Carter; Anne Toulson,15,0,35,20
1657700396090,MATH 105,A02,093477,Carter; Anne Toulson,20,0,35,15
1657700402116,MATH 109,A01,083213,Ganzberger; Geoffrey Michael,2,0,34,32
1657700402116,MATH 109,A02,083214,Ganzberger; Geoffrey Michael,4,0,34,30
1657700402116,MATH 109,A03,093478,Ganzberger; Geoffrey Michael,2,0,34,32
1657700402116,MATH 109,B01,083215,Ganzberger; Geoffrey Michael,1,0,32,31
1657700402116,MATH 109,B02,083216,Ganzberger; Geoffrey Michael,2,0,32,30
1657700402116,MATH 109,B03,093479,Ganzberger; Geoffrey Michael,8,0,32,24
1657700408143,MATH 142A,A01,083219,Chow; Bennett,7,0,32,25
1657700408143,MATH 142A,A02,083220,Chow; Bennett,10,0,32,22
1657700408143,MATH 142A,A03,093480,Chow; Bennett,9,0,32,23
1657700408143,MATH 142A,B03,093481,Chow; Bennett,8,0,32,24
1657700408143,MATH 142A,B04,093558,Chow; Bennett,13,0,32,19
1657700408143,MATH 142A,B05,093559,Chow; Bennett,6,0,32,26
1657700414167,MATH 193A,A01,083224,Rotar; Vladimir,8,0,34,26
1657700414167,MATH 193A,A02,083225,Rotar; Vladimir,9,0,34,25
1657700414167,MATH 193A,A03,083781,Rotar; Vladimir,5,0,34,29
1657700414167,MATH 193A,A04,083782,Rotar; Vladimir,10,0,34,24
1657700414167,MATH 193A,A05,093482,Rotar; Vladimir,10,0,34,24
1657700420196,MATH 197,001,091859,McAuley; Julian John,9999,0,9999,0
1657700420196,MATH 197,002,095566,Kedlaya; Kiran S.,9997,0,9999,2
1657700420196,MATH 197,003,095567,Xiao; Ming,9999,0,9999,0
1657700420196,MATH 197,004,095571,Perols; Johan Lars,9998,0,9999,1
1657700427254,COGS 9,A01,083615,Shannon; Kyle Michael,9,0,75,66
1657700433281,COGS 11,A01,083617,Boyle; Mary E. T.,23,0,48,25
1657700439305,COGS 13,A01,083071,Bastos; Amalia Pinkusfeld,11,0,71,60
1657700445330,COGS 14A,A01,092681,Semenuks; Arturs,5,1,100,95
1657700451366,COGS 14B,A01,083073,Cheng; Tzu-Han,6,0,63,57
1657700457392,COGS 17,A01,092677,Semenuks; Arturs,6,0,81,75
1657700463421,COGS 100,A01,083619,Allen; Michael Gordon,17,0,70,53
1657700469446,COGS 101A,A01,083621,Davis; Joshua Daniel,9,0,68,59
1657700475475,COGS 101B,A01,091572,Allen; Michael Gordon,12,0,65,53
1657700481507,COGS 101C,A01,083625,Delgado; Tania,17,0,35,18
1657700487534,COGS 107A,A01,083627,Boyle; Mary E. T.,13,0,60,47
1657700493563,COGS 118A,A01,083075,Gupta; Anjum,21,0,76,55
1657700499593,CSE 3,A50,083646,Miranda; Gregory Joseph,24,0,50,26
1657700505622,CSE 8A,A50,083650,Miranda; Gregory Joseph,17,1,56,39
1657700511649,CSE 11,A01,083080,Cao; Yingjun,6,15,40,34
1657700517682,CSE 12,A01,083652,Krause-Levy; Sophia Louisa,28,1,120,92
1657700523712,CSE 15L,A01,083654,Morris; Justin Loren,9,0,50,41
1657700523712,CSE 15L,A02,083655,Morris; Justin Loren,9,0,50,41
1657700529742,CSE 20,A01,083657,Tran; Khoa Dang,39,0,80,41
1657700535766,CSE 21,A01,095574,Bach; Quang Tran,22,0,48,26
1657700541793,CSE 30,A01,083084,Eldon; John,6,0,80,74
1657700541793,CSE 30,B01,095061,Bhaskar; Nishant,9,0,50,41
1657700547817,CSE 100,A01,083659,Cao; Yingjun,5,4,70,65
1657700553841,CSE 134B,A01,083661,Powell; Thomas Allan,23,0,100,77
1657700559869,CSE 140,A01,083663,Gungor; Onat,15,0,85,70
1657700565897,CSE 140L,A01,083088,Eldon; John,22,0,100,78
1657700571924,CSE 175,A01,083665,Kumar; Rakesh,3,0,25,22
1657700577948,CSE 190,A00,092507,Dubnov; Shlomo,8,0,20,12
1657700584016,ECE 45,A01,083139,Congero; Spencer William,6,0,75,69
1657700590046,ECE 65,A50,083695,Saad; Andrew S,12,0,30,18
1657700590046,ECE 65,A51,095125,Saad; Andrew S,24,0,26,2
1657700596074,ECE 109,A01,091882,Touri; Behrouz,20,0,70,50
1657700602110,ECE 180,A00,083140,Abi Samra; Nicholas Camill,1,0,30,29
1657700602110,ECE 180,B00,083141,Abi Samra; Nicholas Camill,0,0,30,30
1657700608145,MATH 10A,A01,083735,Patchell; Gregory David,2,0,30,28
1657700608145,MATH 10A,A02,083736,Patchell; Gregory David,20,0,30,10
1657700608145,MATH 10A,A03,083737,Patchell; Gregory David,16,0,30,14
1657700614172,MATH 10B,A01,083207,Lim; Seonhee,8,0,34,26
1657700614172,MATH 10B,A02,083208,Lim; Seonhee,9,0,35,26
1657700614172,MATH 10B,A03,093472,Lim; Seonhee,7,0,34,27
1657700614172,MATH 10B,B01,083739,Sinha; Shubham,13,0,30,17
1657700620200,MATH 18,A01,083743,Cinel; Cameron Alexander,8,0,30,22
1657700620200,MATH 18,A02,083744,Cinel; Cameron Alexander,17,0,30,13
1657700620200,MATH 18,A03,083745,Cinel; Cameron Alexander,10,0,30,20
1657700620200,MATH 18,B01,083748,Rideout; David Porter,5,0,37,32
1657700620200,MATH 18,B02,083749,Rideout; David Porter,5,0,36,31
1657700620200,MATH 18,B03,083750,Rideout; David Porter,3,0,37,34
1657700620200,MATH 18,B04,083751,Rideout; David Porter,6,0,36,30
1657700620200,MATH 18,B05,093473,Rideout; David Porter,6,0,36,30
1657700620200,MATH 18,B06,093474,Rideout; David Porter,6,0,36,30
1657700626229,MATH 20A,A01,083754,Zheng; Zequn,14,0,40,26
1657700632255,MATH 20B,A01,083756,Briones; Jor-el Thomas Caparas,4,0,36,32
1657700632255,MATH 20B,A02,083757,Briones; Jor-el Thomas Caparas,1,0,36,35
1657700632255,MATH 20B,A03,093475,Briones; Jor-el Thomas Caparas,2,0,36,34
1657700638282,MATH 20C,A01,083760,Briones; Jor-el Thomas Caparas,1,0,35,34
1657700638282,MATH 20C,A02,083761,Briones; Jor-el Thomas Caparas,8,0,35,27
1657700638282,MATH 20C,A03,093476,Briones; Jor-el Thomas Caparas,0,1,36,36
1657700638282,MATH 20C,B01,083762,Bach; Quang Tran,1,0,30,29
1657700644308,MATH 20D,A01,083765,Tran; Brian Kha,5,0,30,25
1657700644308,MATH 20D,A02,083766,Tran; Brian Kha,5,0,30,25
1657700644308,MATH 20D,A03,083767,Tran; Brian Kha,5,0,30,25
1657700650341,MATH 20E,A01,083771,Ganguly; Soumya,9,0,32,23
1657700650341,MATH 20E,A02,083772,Ganguly; Soumya,6,0,32,26
1657700650341,MATH 20E,B01,083773,Ciotti; Benjamin,20,0,35,15
1657700650341,MATH 20E,B02,083774,Ciotti; Benjamin,18,0,35,17
1657700656378,MATH 103A,A01,083777,Greenfeld; Be'Eri,3,0,36,33
1657700656378,MATH 103A,A02,083778,Greenfeld; Be'Eri,5,0,36,31
1657700656378,MATH 103A,A03,093561,Greenfeld; Be'Eri,6,0,36,30
1657700656378,MATH 103A,B01,083779,Greenfeld; Be'Eri,7,0,36,29
1657700656378,MATH 103A,B02,083780,Greenfeld; Be'Eri,4,0,36,32
1657700656378,MATH 103A,B03,093562,Greenfeld; Be'Eri,3,0,36,33
1657700662402,MATH 105,A01,085443,Carter; Anne Toulson,15,0,35,20
1657700662402,MATH 105,A02,093477,Carter; Anne Toulson,20,0,35,15
1657700668428,MATH 109,A01,083213,Ganzberger; Geoffrey Michael,2,0,34,32
1657700668428,MATH 109,A02,083214,Ganzberger; Geoffrey Michael,4,0,34,30
1657700668428,MATH 109,A03,093478,Ganzberger; Geoffrey Michael,2,0,34,32
1657700668428,MATH 109,B01,083215,Ganzberger; Geoffrey Michael,1,0,32,31
1657700668428,MATH 109,B02,083216,Ganzberger; Geoffrey Michael,2,0,32,30
1657700668428,MATH 109,B03,093479,Ganzberger; Geoffrey Michael,8,0,32,24
1657700674471,MATH 142A,A01,083219,Chow; Bennett,7,0,32,25
1657700674471,MATH 142A,A02,083220,Chow; Bennett,10,0,32,22
1657700674471,MATH 142A,A03,093480,Chow; Bennett,9,0,32,23
1657700674471,MATH 142A,B03,093481,Chow; Bennett,8,0,32,24
1657700674471,MATH 142A,B04,093558,Chow; Bennett,13,0,32,19
1657700674471,MATH 142A,B05,093559,Chow; Bennett,6,0,32,26
1657700680496,MATH 193A,A01,083224,Rotar; Vladimir,8,0,34,26
1657700680496,MATH 193A,A02,083225,Rotar; Vladimir,9,0,34,25
1657700680496,MATH 193A,A03,083781,Rotar; Vladimir,5,0,34,29
1657700680496,MATH 193A,A04,083782,Rotar; Vladimir,10,0,34,24
1657700680496,MATH 193A,A05,093482,Rotar; Vladimir,10,0,34,24
1657700686524,MATH 197,001,091859,McAuley; Julian John,9999,0,9999,0
1657700686524,MATH 197,002,095566,Kedlaya; Kiran S.,9997,0,9999,2
1657700686524,MATH 197,003,095567,Xiao; Ming,9999,0,9999,0
1657700686524,MATH 197,004,095571,Perols; Johan Lars,9998,0,9999,1
1657700693590,COGS 9,A01,083615,Shannon; Kyle Michael,9,0,75,66
1657700699615,COGS 11,A01,083617,Boyle; Mary E. T.,23,0,48,25
1657700705642,COGS 13,A01,083071,Bastos; Amalia Pinkusfeld,11,0,71,60
1657700711681,COGS 14A,A01,092681,Semenuks; Arturs,5,1,100,95
1657700717706,COGS 14B,A01,083073,Cheng; Tzu-Han,6,0,63,57
1657700723730,COGS 17,A01,092677,Semenuks; Arturs,6,0,81,75
1657700729759,COGS 100,A01,083619,Allen; Michael Gordon,17,0,70,53
1657700735788,COGS 101A,A01,083621,Davis; Joshua Daniel,9,0,68,59
1657700741825,COGS 101B,A01,091572,Allen; Michael Gordon,12,0,65,53
1657700747852,COGS 101C,A01,083625,Delgado; Tania,17,0,35,18
1657700753881,COGS 107A,A01,083627,Boyle; Mary E. T.,13,0,60,47
1657700759913,COGS 118A,A01,083075,Gupta; Anjum,21,0,76,55
1657700765946,CSE 3,A50,083646,Miranda; Gregory Joseph,24,0,50,26
1657700771970,CSE 8A,A50,083650,Miranda; Gregory Joseph,17,1,56,39
1657700777998,CSE 11,A01,083080,Cao; Yingjun,6,15,40,34
1657700784024,CSE 12,A01,083652,Krause-Levy; Sophia Louisa,28,1,120,92
1657700790067,CSE 15L,A01,083654,Morris; Justin Loren,9,0,50,41
1657700790067,CSE 15L,A02,083655,Morris; Justin Loren,9,0,50,41
1657700796095,CSE 20,A01,083657,Tran; Khoa Dang,39,0,80,41
1657700802122,CSE 21,A01,095574,Bach; Quang Tran,22,0,48,26
1657700808173,CSE 30,A01,083084,Eldon; John,6,0,80,74
1657700808173,CSE 30,B01,095061,Bhaskar; Nishant,9,0,50,41
1657700814198,CSE 100,A01,083659,Cao; Yingjun,5,4,70,65
1657700820224,CSE 134B,A01,083661,Powell; Thomas Allan,23,0,100,77
1657700826252,CSE 140,A01,083663,Gungor; Onat,15,0,85,70
1657700832281,CSE 140L,A01,083088,Eldon; John,22,0,100,78
1657700838312,CSE 175,A01,083665,Kumar; Rakesh,3,0,25,22
1657700844337,CSE 190,A00,092507,Dubnov; Shlomo,8,0,20,12
1657700850370,ECE 45,A01,083139,Congero; Spencer William,6,0,75,69
1657700856397,ECE 65,A50,083695,Saad; Andrew S,12,0,30,18
1657700856397,ECE 65,A51,095125,Saad; Andrew S,24,0,26,2
1657700862423,ECE 109,A01,091882,Touri; Behrouz,20,0,70,50
1657700868452,ECE 180,A00,083140,Abi Samra; Nicholas Camill,1,0,30,29
1657700868452,ECE 180,B00,083141,Abi Samra; Nicholas Camill,0,0,30,30
1657700874479,MATH 10A,A01,083735,Patchell; Gregory David,2,0,30,28
1657700874479,MATH 10A,A02,083736,Patchell; Gregory David,20,0,30,10
1657700874479,MATH 10A,A03,083737,Patchell; Gregory David,16,0,30,14
1657700880507,MATH 10B,A01,083207,Lim; Seonhee,8,0,34,26
1657700880507,MATH 10B,A02,083208,Lim; Seonhee,9,0,35,26
1657700880507,MATH 10B,A03,093472,Lim; Seonhee,7,0,34,27
1657700880507,MATH 10B,B01,083739,Sinha; Shubham,13,0,30,17
1657700886536,MATH 18,A01,083743,Cinel; Cameron Alexander,8,0,30,22
1657700886536,MATH 18,A02,083744,Cinel; Cameron Alexander,17,0,30,13
1657700886536,MATH 18,A03,083745,Cinel; Cameron Alexander,10,0,30,20
1657700886536,MATH 18,B01,083748,Rideout; David Porter,5,0,37,32
1657700886536,MATH 18,B02,083749,Rideout; David Porter,5,0,36,31
1657700886536,MATH 18,B03,083750,Rideout; David Porter,3,0,37,34
1657700886536,MATH 18,B04,083751,Rideout; David Porter,6,0,36,30
1657700886536,MATH 18,B05,093473,Rideout; David Porter,6,0,36,30
1657700886536,MATH 18,B06,093474,Rideout; David Porter,6,0,36,30
1657700892561,MATH 20A,A01,083754,Zheng; Zequn,14,0,40,26
1657700898587,MATH 20B,A01,083756,Briones; Jor-el Thomas Caparas,4,0,36,32
1657700898587,MATH 20B,A02,083757,Briones; Jor-el Thomas Caparas,1,0,36,35
1657700898587,MATH 20B,A03,093475,Briones; Jor-el Thomas Caparas,2,0,36,34
1657700904621,MATH 20C,A01,083760,Briones; Jor-el Thomas Caparas,1,0,35,34
1657700904621,MATH 20C,A02,083761,Briones; Jor-el Thomas Caparas,8,0,35,27
1657700904621,MATH 20C,A03,093476,Briones; Jor-el Thomas Caparas,0,1,36,36
1657700904621,MATH 20C,B01,083762,Bach; Quang Tran,1,0,30,29
1657700910649,MATH 20D,A01,083765,Tran; Brian Kha,5,0,30,25
1657700910649,MATH 20D,A02,083766,Tran; Brian Kha,5,0,30,25
1657700910649,MATH 20D,A03,083767,Tran; Brian Kha,5,0,30,25
1657700916675,MATH 20E,A01,083771,Ganguly; Soumya,9,0,32,23
1657700916675,MATH 20E,A02,083772,Ganguly; Soumya,6,0,32,26
1657700916675,MATH 20E,B01,083773,Ciotti; Benjamin,20,0,35,15
1657700916675,MATH 20E,B02,083774,Ciotti; Benjamin,18,0,35,17
1657700922712,MATH 103A,A01,083777,Greenfeld; Be'Eri,3,0,36,33
1657700922712,MATH 103A,A02,083778,Greenfeld; Be'Eri,5,0,36,31
1657700922712,MATH 103A,A03,093561,Greenfeld; Be'Eri,6,0,36,30
1657700922712,MATH 103A,B01,083779,Greenfeld; Be'Eri,7,0,36,29
1657700922712,MATH 103A,B02,083780,Greenfeld; Be'Eri,4,0,36,32
1657700922712,MATH 103A,B03,093562,Greenfeld; Be'Eri,3,0,36,33
1657700928745,MATH 105,A01,085443,Carter; Anne Toulson,15,0,35,20
1657700928745,MATH 105,A02,093477,Carter; Anne Toulson,20,0,35,15
1657700934779,MATH 109,A01,083213,Ganzberger; Geoffrey Michael,2,0,34,32
1657700934779,MATH 109,A02,083214,Ganzberger; Geoffrey Michael,4,0,34,30
1657700934779,MATH 109,A03,093478,Ganzberger; Geoffrey Michael,2,0,34,32
1657700934779,MATH 109,B01,083215,Ganzberger; Geoffrey Michael,1,0,32,31
1657700934779,MATH 109,B02,083216,Ganzberger; Geoffrey Michael,2,0,32,30
1657700934779,MATH 109,B03,093479,Ganzberger; Geoffrey Michael,8,0,32,24
1657700940805,MATH 142A,A01,083219,Chow; Bennett,7,0,32,25
1657700940805,MATH 142A,A02,083220,Chow; Bennett,10,0,32,22
1657700940805,MATH 142A,A03,093480,Chow; Bennett,9,0,32,23
1657700940805,MATH 142A,B03,093481,Chow; Bennett,8,0,32,24
1657700940805,MATH 142A,B04,093558,Chow; Bennett,13,0,32,19
1657700940805,MATH 142A,B05,093559,Chow; Bennett,6,0,32,26
1657700946833,MATH 193A,A01,083224,Rotar; Vladimir,8,0,34,26
1657700946833,MATH 193A,A02,083225,Rotar; Vladimir,9,0,34,25
1657700946833,MATH 193A,A03,083781,Rotar; Vladimir,5,0,34,29
1657700946833,MATH 193A,A04,083782,Rotar; Vladimir,10,0,34,24
1657700946833,MATH 193A,A05,093482,Rotar; Vladimir,10,0,34,24
1657700952950,MATH 197,001,091859,McAuley; Julian John,9999,0,9999,0
1657700952950,MATH 197,002,095566,Kedlaya; Kiran S.,9997,0,9999,2
1657700952950,MATH 197,003,095567,Xiao; Ming,9999,0,9999,0
1657700952950,MATH 197,004,095571,Perols; Johan Lars,9998,0,9999,1
1657700960014,COGS 9,A01,083615,Shannon; Kyle Michael,9,0,75,66
1657700966044,COGS 11,A01,083617,Boyle; Mary E. T.,23,0,48,25
1657700972074,COGS 13,A01,083071,Bastos; Amalia Pinkusfeld,11,0,71,60
1657700978101,COGS 14A,A01,092681,Semenuks; Arturs,5,1,100,95
1657700984126,COGS 14B,A01,083073,Cheng; Tzu-Han,6,0,63,57
1657700990156,COGS 17,A01,092677,Semenuks; Arturs,6,0,81,75
1657700996181,COGS 100,A01,083619,Allen; Michael Gordon,17,0,70,53
1657701002206,COGS 101A,A01,083621,Davis; Joshua Daniel,9,0,68,59
1657701008232,COGS 101B,A01,091572,Allen; Michael Gordon,12,0,65,53
1657701014261,COGS 101C,A01,083625,Delgado; Tania,17,0,35,18
1657701020284,COGS 107A,A01,083627,Boyle; Mary E. T.,13,0,60,47
1657701026311,COGS 118A,A01,083075,Gupta; Anjum,21,0,76,55
1657701032339,CSE 3,A50,083646,Miranda; Gregory Joseph,24,0,50,26
1657701038364,CSE 8A,A50,083650,Miranda; Gregory Joseph,17,1,56,39
1657701044389,CSE 11,A01,083080,Cao; Yingjun,6,15,40,34
1657701050414,CSE 12,A01,083652,Krause-Levy; Sophia Louisa,28,1,120,92
1657701056438,CSE 15L,A01,083654,Morris; Justin Loren,9,0,50,41
1657701056438,CSE 15L,A02,083655,Morris; Justin Loren,9,0,50,41
1657701062466,CSE 20,A01,083657,Tran; Khoa Dang,39,0,80,41
1657701068501,CSE 21,A01,095574,Bach; Quang Tran,22,0,48,26
1657701074529,CSE 30,A01,083084,Eldon; John,6,0,80,74
1657701074529,CSE 30,B01,095061,Bhaskar; Nishant,9,0,50,41
1657701080555,CSE 100,A01,083659,Cao; Yingjun,5,4,70,65
1657701086585,CSE 134B,A01,083661,Powell; Thomas Allan,23,0,100,77
1657701092623,CSE 140,A01,083663,Gungor; Onat,15,0,85,70
1657701098658,CSE 140L,A01,083088,Eldon; John,22,0,100,78
1657701104683,CSE 175,A01,083665,Kumar; Rakesh,3,0,25,22
1657701110710,CSE 190,A00,092507,Dubnov; Shlomo,8,0,20,12
1657701116743,ECE 45,A01,083139,Congero; Spencer William,6,0,75,69
1657701122768,ECE 65,A50,083695,Saad; Andrew S,12,0,30,18
1657701122768,ECE 65,A51,095125,Saad; Andrew S,24,0,26,2
1657701128792,ECE 109,A01,091882,Touri; Behrouz,20,0,70,50
1657701134824,ECE 180,A00,083140,Abi Samra; Nicholas Camill,1,0,30,29
1657701134824,ECE 180,B00,083141,Abi Samra; Nicholas Camill,0,0,30,30
1657701140856,MATH 10A,A01,083735,Patchell; Gregory David,2,0,30,28
1657701140856,MATH 10A,A02,083736,Patchell; Gregory David,20,0,30,10
1657701140856,MATH 10A,A03,083737,Patchell; Gregory David,16,0,30,14
1657701146883,MATH 10B,A01,083207,Lim; Seonhee,8,0,34,26
1657701146883,MATH 10B,A02,083208,Lim; Seonhee,9,0,35,26
1657701146883,MATH 10B,A03,093472,Lim; Seonhee,7,0,34,27
1657701146883,MATH 10B,B01,083739,Sinha; Shubham,13,0,30,17
1657701152924,MATH 18,A01,083743,Cinel; Cameron Alexander,8,0,30,22
1657701152924,MATH 18,A02,083744,Cinel; Cameron Alexander,17,0,30,13
1657701152924,MATH 18,A03,083745,Cinel; Cameron Alexander,10,0,30,20
1657701152924,MATH 18,B01,083748,Rideout; David Porter,5,0,37,32
1657701152924,MATH 18,B02,083749,Rideout; David Porter,5,0,36,31
1657701152924,MATH 18,B03,083750,Rideout; David Porter,3,0,37,34
1657701152924,MATH 18,B04,083751,Rideout; David Porter,6,0,36,30
1657701152924,MATH 18,B05,093473,Rideout; David Porter,6,0,36,30
1657701152924,MATH 18,B06,093474,Rideout; David Porter,6,0,36,30
1657701158954,MATH 20A,A01,083754,Zheng; Zequn,14,0,40,26
1657701164981,MATH 20B,A01,083756,Briones; Jor-el Thomas Caparas,4,0,36,32
1657701164981,MATH 20B,A02,083757,Briones; Jor-el Thomas Caparas,1,0,36,35
1657701164981,MATH 20B,A03,093475,Briones; Jor-el Thomas Caparas,2,0,36,34
1657701171007,MATH 20C,A01,083760,Briones; Jor-el Thomas Caparas,1,0,35,34
1657701171007,MATH 20C,A02,083761,Briones; Jor-el Thomas Caparas,8,0,35,27
1657701171007,MATH 20C,A03,093476,Briones; Jor-el Thomas Caparas,0,1,36,36
1657701171007,MATH 20C,B01,083762,Bach; Quang Tran,1,0,30,29
1657701177043,MATH 20D,A01,083765,Tran; Brian Kha,5,0,30,25
1657701177043,MATH 20D,A02,083766,Tran; Brian Kha,5,0,30,25
1657701177043,MATH 20D,A03,083767,Tran; Brian Kha,5,0,30,25
1657701183072,MATH 20E,A01,083771,Ganguly; Soumya,9,0,32,23
1657701183072,MATH 20E,A02,083772,Ganguly; Soumya,6,0,32,26
1657701183072,MATH 20E,B01,083773,Ciotti; Benjamin,20,0,35,15
1657701183072,MATH 20E,B02,083774,Ciotti; Benjamin,18,0,35,17
1657701189101,MATH 103A,A01,083777,Greenfeld; Be'Eri,3,0,36,33
1657701189101,MATH 103A,A02,083778,Greenfeld; Be'Eri,5,0,36,31
1657701189101,MATH 103A,A03,093561,Greenfeld; Be'Eri,6,0,36,30
1657701189101,MATH 103A,B01,083779,Greenfeld; Be'Eri,7,0,36,29
1657701189101,MATH 103A,B02,083780,Greenfeld; Be'Eri,4,0,36,32
1657701189101,MATH 103A,B03,093562,Greenfeld; Be'Eri,3,0,36,33
1657701195127,MATH 105,A01,085443,Carter; Anne Toulson,15,0,35,20
1657701195127,MATH 105,A02,093477,Carter; Anne Toulson,20,0,35,15
1657701201155,MATH 109,A01,083213,Ganzberger; Geoffrey Michael,2,0,34,32
1657701201155,MATH 109,A02,083214,Ganzberger; Geoffrey Michael,4,0,34,30
1657701201155,MATH 109,A03,093478,Ganzberger; Geoffrey Michael,2,0,34,32
1657701201155,MATH 109,B01,083215,Ganzberger; Geoffrey Michael,1,0,32,31
1657701201155,MATH 109,B02,083216,Ganzberger; Geoffrey Michael,2,0,32,30
1657701201155,MATH 109,B03,093479,Ganzberger; Geoffrey Michael,8,0,32,24
1657701207180,MATH 142A,A01,083219,Chow; Bennett,7,0,32,25
1657701207180,MATH 142A,A02,083220,Chow; Bennett,10,0,32,22
1657701207180,MATH 142A,A03,093480,Chow; Bennett,9,0,32,23
1657701207180,MATH 142A,B03,093481,Chow; Bennett,8,0,32,24
1657701207180,MATH 142A,B04,093558,Chow; Bennett,13,0,32,19
1657701207180,MATH 142A,B05,093559,Chow; Bennett,6,0,32,26
1657701213212,MATH 193A,A01,083224,Rotar; Vladimir,8,0,34,26
1657701213212,MATH 193A,A02,083225,Rotar; Vladimir,9,0,34,25
1657701213212,MATH 193A,A03,083781,Rotar; Vladimir,5,0,34,29
1657701213212,MATH 193A,A04,083782,Rotar; Vladimir,10,0,34,24
1657701213212,MATH 193A,A05,093482,Rotar; Vladimir,10,0,34,24
1657701219237,MATH 197,001,091859,McAuley; Julian John,9999,0,9999,0
1657701219237,MATH 197,002,095566,Kedlaya; Kiran S.,9997,0,9999,2
1657701219237,MATH 197,003,095567,Xiao; Ming,9999,0,9999,0
1657701219237,MATH 197,004,095571,Perols; Johan Lars,9998,0,9999,1
1657701226318,COGS 9,A01,083615,Shannon; Kyle Michael,9,0,75,66
1657701232348,COGS 11,A01,083617,Boyle; Mary E. T.,23,0,48,25
1657701238389,COGS 13,A01,083071,Bastos; Amalia Pinkusfeld,11,0,71,60
1657701244425,COGS 14A,A01,092681,Semenuks; Arturs,5,1,100,95
1657701250449,COGS 14B,A01,083073,Cheng; Tzu-Han,6,0,63,57
1657701256476,COGS 17,A01,092677,Semenuks; Arturs,6,0,81,75
1657701262502,COGS 100,A01,083619,Allen; Michael Gordon,17,0,70,53
1657701268526,COGS 101A,A01,083621,Davis; Joshua Daniel,9,0,68,59
1657701274563,COGS 101B,A01,091572,Allen; Michael Gordon,12,0,65,53
1657701280600,COGS 101C,A01,083625,Delgado; Tania,17,0,35,18
1657701286622,COGS 107A,A01,083627,Boyle; Mary E. T.,13,0,60,47
1657701292645,COGS 118A,A01,083075,Gupta; Anjum,21,0,76,55
1657701298672,CSE 3,A50,083646,Miranda; Gregory Joseph,24,0,50,26
1657701304704,CSE 8A,A50,083650,Miranda; Gregory Joseph,17,1,56,39
1657701310726,CSE 11,A01,083080,Cao; Yingjun,6,15,40,34
1657701316756,CSE 12,A01,083652,Krause-Levy; Sophia Louisa,28,1,120,92
1657701322783,CSE 15L,A01,083654,Morris; Justin Loren,9,0,50,41
1657701322783,CSE 15L,A02,083655,Morris; Justin Loren,9,0,50,41
1657701328820,CSE 20,A01,083657,Tran; Khoa Dang,39,0,80,41
1657701334843,CSE 21,A01,095574,Bach; Quang Tran,22,0,48,26
1657701340869,CSE 30,A01,083084,Eldon; John,6,0,80,74
1657701340869,CSE 30,B01,095061,Bhaskar; Nishant,9,0,50,41
1657701346896,CSE 100,A01,083659,Cao; Yingjun,5,4,70,65
1657701352920,CSE 134B,A01,083661,Powell; Thomas Allan,23,0,100,77
1657701358944,CSE 140,A01,083663,Gungor; Onat,15,0,85,70
1657701364970,CSE 140L,A01,083088,Eldon; John,22,0,100,78
1657701371001,CSE 175,A01,083665,Kumar; Rakesh,3,0,25,22
1657701377030,CSE 190,A00,092507,Dubnov; Shlomo,8,0,20,12
1657701383055,ECE 45,A01,083139,Congero; Spencer William,6,0,75,69
1657701389086,ECE 65,A50,083695,Saad; Andrew S,12,0,30,18
1657701389086,ECE 65,A51,095125,Saad; Andrew S,24,0,26,2
1657701395116,ECE 109,A01,091882,Touri; Behrouz,20,0,70,50
1657701401139,ECE 180,A00,083140,Abi Samra; Nicholas Camill,1,0,30,29
1657701401139,ECE 180,B00,083141,Abi Samra; Nicholas Camill,0,0,30,30
1657701407165,MATH 10A,A01,083735,Patchell; Gregory David,2,0,30,28
1657701407165,MATH 10A,A02,083736,Patchell; Gregory David,20,0,30,10
1657701407165,MATH 10A,A03,083737,Patchell; Gregory David,16,0,30,14
1657701413202,MATH 10B,A01,083207,Lim; Seonhee,8,0,34,26
1657701413202,MATH 10B,A02,083208,Lim; Seonhee,9,0,35,26
1657701413202,MATH 10B,A03,093472,Lim; Seonhee,7,0,34,27
1657701413202,MATH 10B,B01,083739,Sinha; Shubham,13,0,30,17
1657701419240,MATH 18,A01,083743,Cinel; Cameron Alexander,8,0,30,22
1657701419240,MATH 18,A02,083744,Cinel; Cameron Alexander,17,0,30,13
1657701419240,MATH 18,A03,083745,Cinel; Cameron Alexander,10,0,30,20
1657701419240,MATH 18,B01,083748,Rideout; David Porter,5,0,37,32
1657701419240,MATH 18,B02,083749,Rideout; David Porter,5,0,36,31
1657701419240,MATH 18,B03,083750,Rideout; David Porter,3,0,37,34
1657701419240,MATH 18,B04,083751,Rideout; David Porter,6,0,36,30
1657701419240,MATH 18,B05,093473,Rideout; David Porter,6,0,36,30
1657701419240,MATH 18,B06,093474,Rideout; David Porter,6,0,36,30
1657701425273,MATH 20A,A01,083754,Zheng; Zequn,14,0,40,26
1657701431301,MATH 20B,A01,083756,Briones; Jor-el Thomas Caparas,4,0,36,32
1657701431301,MATH 20B,A02,083757,Briones; Jor-el Thomas Caparas,1,0,36,35
1657701431301,MATH 20B,A03,093475,Briones; Jor-el Thomas Caparas,2,0,36,34
1657701437326,MATH 20C,A01,083760,Briones; Jor-el Thomas Caparas,1,0,35,34
1657701437326,MATH 20C,A02,083761,Briones; Jor-el Thomas Caparas,8,0,35,27
1657701437326,MATH 20C,A03,093476,Briones; Jor-el Thomas Caparas,0,1,36,36
1657701437326,MATH 20C,B01,083762,Bach; Quang Tran,1,0,30,29
1657701443356,MATH 20D,A01,083765,Tran; Brian Kha,5,0,30,25
1657701443356,MATH 20D,A02,083766,Tran; Brian Kha,5,0,30,25
1657701443356,MATH 20D,A03,083767,Tran; Brian Kha,5,0,30,25
1657701449389,MATH 20E,A01,083771,Ganguly; Soumya,9,0,32,23
1657701449389,MATH 20E,A02,083772,Ganguly; Soumya,6,0,32,26
1657701449389,MATH 20E,B01,083773,Ciotti; Benjamin,20,0,35,15
1657701449389,MATH 20E,B02,083774,Ciotti; Benjamin,18,0,35,17
1657701455415,MATH 103A,A01,083777,Greenfeld; Be'Eri,3,0,36,33
1657701455415,MATH 103A,A02,083778,Greenfeld; Be'Eri,5,0,36,31
1657701455415,MATH 103A,A03,093561,Greenfeld; Be'Eri,6,0,36,30
1657701455415,MATH 103A,B01,083779,Greenfeld; Be'Eri,7,0,36,29
1657701455415,MATH 103A,B02,083780,Greenfeld; Be'Eri,4,0,36,32
1657701455415,MATH 103A,B03,093562,Greenfeld; Be'Eri,3,0,36,33
1657701461439,MATH 105,A01,085443,Carter; Anne Toulson,15,0,35,20
1657701461439,MATH 105,A02,093477,Carter; Anne Toulson,20,0,35,15
1657701467469,MATH 109,A01,083213,Ganzberger; Geoffrey Michael,2,0,34,32
1657701467469,MATH 109,A02,083214,Ganzberger; Geoffrey Michael,4,0,34,30
1657701467469,MATH 109,A03,093478,Ganzberger; Geoffrey Michael,2,0,34,32
1657701467469,MATH 109,B01,083215,Ganzberger; Geoffrey Michael,1,0,32,31
1657701467469,MATH 109,B02,083216,Ganzberger; Geoffrey Michael,2,0,32,30
1657701467469,MATH 109,B03,093479,Ganzberger; Geoffrey Michael,8,0,32,24
1657701473501,MATH 142A,A01,083219,Chow; Bennett,7,0,32,25
1657701473501,MATH 142A,A02,083220,Chow; Bennett,10,0,32,22
1657701473501,MATH 142A,A03,093480,Chow; Bennett,9,0,32,23
1657701473501,MATH 142A,B03,093481,Chow; Bennett,8,0,32,24
1657701473501,MATH 142A,B04,093558,Chow; Bennett,13,0,32,19
1657701473501,MATH 142A,B05,093559,Chow; Bennett,6,0,32,26
1657701479525,MATH 193A,A01,083224,Rotar; Vladimir,8,0,34,26
1657701479525,MATH 193A,A02,083225,Rotar; Vladimir,9,0,34,25
1657701479525,MATH 193A,A03,083781,Rotar; Vladimir,5,0,34,29
1657701479525,MATH 193A,A04,083782,Rotar; Vladimir,10,0,34,24
1657701479525,MATH 193A,A05,093482,Rotar; Vladimir,10,0,34,24
1657701485549,MATH 197,001,091859,McAuley; Julian John,9999,0,9999,0
1657701485549,MATH 197,002,095566,Kedlaya; Kiran S.,9997,0,9999,2
1657701485549,MATH 197,003,095567,Xiao; Ming,9999,0,9999,0
1657701485549,MATH 197,004,095571,Perols; Johan Lars,9998,0,9999,1
1657701492620,COGS 9,A01,083615,Shannon; Kyle Michael,9,0,75,66
1657701498644,COGS 11,A01,083617,Boyle; Mary E. T.,23,0,48,25
1657701504670,COGS 13,A01,083071,Bastos; Amalia Pinkusfeld,11,0,71,60
1657701510692,COGS 14A,A01,092681,Semenuks; Arturs,5,1,100,95
1657701516720,COGS 14B,A01,083073,Cheng; Tzu-Han,6,0,63,57
1657701522742,COGS 17,A01,092677,Semenuks; Arturs,6,0,81,75
1657701528770,COGS 100,A01,083619,Allen; Michael Gordon,17,0,70,53
1657701534912,COGS 101A,A01,083621,Davis; Joshua Daniel,9,0,68,59
1657701540938,COGS 101B,A01,091572,Allen; Michael Gordon,12,0,65,53
1657701547053,COGS 101C,A01,083625,Delgado; Tania,17,0,35,18
1657701553079,COGS 107A,A01,083627,Boyle; Mary E. T.,13,0,60,47
1657701559105,COGS 118A,A01,083075,Gupta; Anjum,21,0,76,55
1657701565136,CSE 3,A50,083646,Miranda; Gregory Joseph,24,0,50,26
1657701571158,CSE 8A,A50,083650,Miranda; Gregory Joseph,17,1,56,39
1657701577184,CSE 11,A01,083080,Cao; Yingjun,6,15,40,34
1657701583208,CSE 12,A01,083652,Krause-Levy; Sophia Louisa,28,1,120,92
1657701589233,CSE 15L,A01,083654,Morris; Justin Loren,9,0,50,41
1657701589233,CSE 15L,A02,083655,Morris; Justin Loren,9,0,50,41
1657701595256,CSE 20,A01,083657,Tran; Khoa Dang,39,0,80,41
1657701601284,CSE 21,A01,095574,Bach; Quang Tran,22,0,48,26
1657701607313,CSE 30,A01,083084,Eldon; John,6,0,80,74
1657701607313,CSE 30,B01,095061,Bhaskar; Nishant,9,0,50,41
1657701613336,CSE 100,A01,083659,Cao; Yingjun,5,4,70,65
1657701619359,CSE 134B,A01,083661,Powell; Thomas Allan,23,0,100,77
1657701625384,CSE 140,A01,083663,Gungor; Onat,15,0,85,70
1657701631411,CSE 140L,A01,083088,Eldon; John,22,0,100,78
1657701637436,CSE 175,A01,083665,Kumar; Rakesh,3,0,25,22
1657701643459,CSE 190,A00,092507,Dubnov; Shlomo,8,0,20,12
1657701649488,ECE 45,A01,083139,Congero; Spencer William,6,0,75,69
1657701655512,ECE 65,A50,083695,Saad; Andrew S,12,0,30,18
1657701655512,ECE 65,A51,095125,Saad; Andrew S,24,0,26,2
1657701661536,ECE 109,A01,091882,Touri; Behrouz,20,0,70,50
1657701667560,ECE 180,A00,083140,Abi Samra; Nicholas Camill,1,0,30,29
1657701667560,ECE 180,B00,083141,Abi Samra; Nicholas Camill,0,0,30,30
1657701673591,MATH 10A,A01,083735,Patchell; Gregory David,2,0,30,28
1657701673591,MATH 10A,A02,083736,Patchell; Gregory David,20,0,30,10
1657701673591,MATH 10A,A03,083737,Patchell; Gregory David,16,0,30,14
1657701679621,MATH 10B,A01,083207,Lim; Seonhee,8,0,34,26
1657701679621,MATH 10B,A02,083208,Lim; Seonhee,9,0,35,26
1657701679621,MATH 10B,A03,093472,Lim; Seonhee,7,0,34,27
1657701679621,MATH 10B,B01,083739,Sinha; Shubham,13,0,30,17
1657701685655,MATH 18,A01,083743,Cinel; Cameron Alexander,8,0,30,22
1657701685655,MATH 18,A02,083744,Cinel; Cameron Alexander,17,0,30,13
1657701685655,MATH 18,A03,083745,Cinel; Cameron Alexander,10,0,30,20
1657701685655,MATH 18,B01,083748,Rideout; David Porter,5,0,37,32
1657701685655,MATH 18,B02,083749,Rideout; David Porter,5,0,36,31
1657701685655,MATH 18,B03,083750,Rideout; David Porter,3,0,37,34
1657701685655,MATH 18,B04,083751,Rideout; David Porter,6,0,36,30
1657701685655,MATH 18,B05,093473,Rideout; David Porter,6,0,36,30
1657701685655,MATH 18,B06,093474,Rideout; David Porter,6,0,36,30
1657701691678,MATH 20A,A01,083754,Zheng; Zequn,14,0,40,26
1657701697712,MATH 20B,A01,083756,Briones; Jor-el Thomas Caparas,4,0,36,32
1657701697712,MATH 20B,A02,083757,Briones; Jor-el Thomas Caparas,1,0,36,35
1657701697712,MATH 20B,A03,093475,Briones; Jor-el Thomas Caparas,2,0,36,34
1657701703740,MATH 20C,A01,083760,Briones; Jor-el Thomas Caparas,1,0,35,34
1657701703740,MATH 20C,A02,083761,Briones; Jor-el Thomas Caparas,8,0,35,27
1657701703740,MATH 20C,A03,093476,Briones; Jor-el Thomas Caparas,0,1,36,36
1657701703740,MATH 20C,B01,083762,Bach; Quang Tran,1,0,30,29
1657701709764,MATH 20D,A01,083765,Tran; Brian Kha,5,0,30,25
1657701709764,MATH 20D,A02,083766,Tran; Brian Kha,5,0,30,25
1657701709764,MATH 20D,A03,083767,Tran; Brian Kha,5,0,30,25
1657701715799,MATH 20E,A01,083771,Ganguly; Soumya,9,0,32,23
1657701715799,MATH 20E,A02,083772,Ganguly; Soumya,6,0,32,26
1657701715799,MATH 20E,B01,083773,Ciotti; Benjamin,20,0,35,15
1657701715799,MATH 20E,B02,083774,Ciotti; Benjamin,18,0,35,17
1657701721826,MATH 103A,A01,083777,Greenfeld; Be'Eri,3,0,36,33
1657701721826,MATH 103A,A02,083778,Greenfeld; Be'Eri,5,0,36,31
1657701721826,MATH 103A,A03,093561,Greenfeld; Be'Eri,6,0,36,30
1657701721826,MATH 103A,B01,083779,Greenfeld; Be'Eri,7,0,36,29
1657701721826,MATH 103A,B02,083780,Greenfeld; Be'Eri,4,0,36,32
1657701721826,MATH 103A,B03,093562,Greenfeld; Be'Eri,3,0,36,33
1657701727853,MATH 105,A01,085443,Carter; Anne Toulson,15,0,35,20
1657701727853,MATH 105,A02,093477,Carter; Anne Toulson,20,0,35,15
1657701733880,MATH 109,A01,083213,Ganzberger; Geoffrey Michael,2,0,34,32
1657701733880,MATH 109,A02,083214,Ganzberger; Geoffrey Michael,4,0,34,30
1657701733880,MATH 109,A03,093478,Ganzberger; Geoffrey Michael,2,0,34,32
1657701733880,MATH 109,B01,083215,Ganzberger; Geoffrey Michael,1,0,32,31
1657701733880,MATH 109,B02,083216,Ganzberger; Geoffrey Michael,2,0,32,30
1657701733880,MATH 109,B03,093479,Ganzberger; Geoffrey Michael,8,0,32,24
1657701739919,MATH 142A,A01,083219,Chow; Bennett,7,0,32,25
1657701739919,MATH 142A,A02,083220,Chow; Bennett,10,0,32,22
1657701739919,MATH 142A,A03,093480,Chow; Bennett,9,0,32,23
1657701739919,MATH 142A,B03,093481,Chow; Bennett,8,0,32,24
1657701739919,MATH 142A,B04,093558,Chow; Bennett,13,0,32,19
1657701739919,MATH 142A,B05,093559,Chow; Bennett,6,0,32,26
1657701745957,MATH 193A,A01,083224,Rotar; Vladimir,8,0,34,26
1657701745957,MATH 193A,A02,083225,Rotar; Vladimir,9,0,34,25
1657701745957,MATH 193A,A03,083781,Rotar; Vladimir,5,0,34,29
1657701745957,MATH 193A,A04,083782,Rotar; Vladimir,10,0,34,24
1657701745957,MATH 193A,A05,093482,Rotar; Vladimir,10,0,34,24
1657701751981,MATH 197,001,091859,McAuley; Julian John,9999,0,9999,0
1657701751981,MATH 197,002,095566,Kedlaya; Kiran S.,9997,0,9999,2
1657701751981,MATH 197,003,095567,Xiao; Ming,9999,0,9999,0
1657701751981,MATH 197,004,095571,Perols; Johan Lars,9998,0,9999,1
1657701759049,COGS 9,A01,083615,Shannon; Kyle Michael,9,0,75,66
1657701765074,COGS 11,A01,083617,Boyle; Mary E. T.,23,0,48,25
1657701771099,COGS 13,A01,083071,Bastos; Amalia Pinkusfeld,11,0,71,60
1657701777135,COGS 14A,A01,092681,Semenuks; Arturs,5,1,100,95
1657701783182,COGS 14B,A01,083073,Cheng; Tzu-Han,6,0,63,57
1657701789210,COGS 17,A01,092677,Semenuks; Arturs,6,0,81,75
1657701795240,COGS 100,A01,083619,Allen; Michael Gordon,17,0,70,53
1657701801265,COGS 101A,A01,083621,Davis; Joshua Daniel,9,0,68,59
1657701807289,COGS 101B,A01,091572,Allen; Michael Gordon,12,0,65,53
1657701813314,COGS 101C,A01,083625,Delgado; Tania,17,0,35,18
1657701819340,COGS 107A,A01,083627,Boyle; Mary E. T.,13,0,60,47
1657701825371,COGS 118A,A01,083075,Gupta; Anjum,21,0,76,55
1657701831401,CSE 3,A50,083646,Miranda; Gregory Joseph,24,0,50,26
1657701837426,CSE 8A,A50,083650,Miranda; Gregory Joseph,17,1,56,39
1657701843451,CSE 11,A01,083080,Cao; Yingjun,6,15,40,34
1657701849517,CSE 12,A01,083652,Krause-Levy; Sophia Louisa,28,1,120,92
1657701855544,CSE 15L,A01,083654,Morris; Justin Loren,9,0,50,41
1657701855544,CSE 15L,A02,083655,Morris; Justin Loren,9,0,50,41
1657701861568,CSE 20,A01,083657,Tran; Khoa Dang,39,0,80,41
1657701867593,CSE 21,A01,095574,Bach; Quang Tran,22,0,48,26
1657701873621,CSE 30,A01,083084,Eldon; John,6,0,80,74
1657701873621,CSE 30,B01,095061,Bhaskar; Nishant,9,0,50,41
1657701879652,CSE 100,A01,083659,Cao; Yingjun,5,4,70,65
1657701885678,CSE 134B,A01,083661,Powell; Thomas Allan,23,0,100,77
1657701891706,CSE 140,A01,083663,Gungor; Onat,15,0,85,70
1657701897730,CSE 140L,A01,083088,Eldon; John,22,0,100,78
1657701903756,CSE 175,A01,083665,Kumar; Rakesh,3,0,25,22
1657701909781,CSE 190,A00,092507,Dubnov; Shlomo,8,0,20,12
1657701915808,ECE 45,A01,083139,Congero; Spencer William,6,0,75,69
1657701921835,ECE 65,A50,083695,Saad; Andrew S,12,0,30,18
1657701921835,ECE 65,A51,095125,Saad; Andrew S,24,0,26,2
1657701927861,ECE 109,A01,091882,Touri; Behrouz,20,0,70,50
1657701933888,ECE 180,A00,083140,Abi Samra; Nicholas Camill,1,0,30,29
1657701933888,ECE 180,B00,083141,Abi Samra; Nicholas Camill,0,0,30,30
1657701939917,MATH 10A,A01,083735,Patchell; Gregory David,2,0,30,28
1657701939917,MATH 10A,A02,083736,Patchell; Gregory David,20,0,30,10
1657701939917,MATH 10A,A03,083737,Patchell; Gregory David,16,0,30,14
1657701945944,MATH 10B,A01,083207,Lim; Seonhee,8,0,34,26
1657701945944,MATH 10B,A02,083208,Lim; Seonhee,9,0,35,26
1657701945944,MATH 10B,A03,093472,Lim; Seonhee,7,0,34,27
1657701945944,MATH 10B,B01,083739,Sinha; Shubham,13,0,30,17
1657701951982,MATH 18,A01,083743,Cinel; Cameron Alexander,8,0,30,22
1657701951982,MATH 18,A02,083744,Cinel; Cameron Alexander,17,0,30,13
1657701951982,MATH 18,A03,083745,Cinel; Cameron Alexander,10,0,30,20
1657701951982,MATH 18,B01,083748,Rideout; David Porter,5,0,37,32
1657701951982,MATH 18,B02,083749,Rideout; David Porter,5,0,36,31
1657701951982,MATH 18,B03,083750,Rideout; David Porter,3,0,37,34
1657701951982,MATH 18,B04,083751,Rideout; David Porter,6,0,36,30
1657701951982,MATH 18,B05,093473,Rideout; David Porter,6,0,36,30
1657701951982,MATH 18,B06,093474,Rideout; David Porter,6,0,36,30
1657701958006,MATH 20A,A01,083754,Zheng; Zequn,14,0,40,26
1657701964037,MATH 20B,A01,083756,Briones; Jor-el Thomas Caparas,4,0,36,32
1657701964037,MATH 20B,A02,083757,Briones; Jor-el Thomas Caparas,1,0,36,35
1657701964037,MATH 20B,A03,093475,Briones; Jor-el Thomas Caparas,2,0,36,34
1657701970071,MATH 20C,A01,083760,Briones; Jor-el Thomas Caparas,1,0,35,34
1657701970071,MATH 20C,A02,083761,Briones; Jor-el Thomas Caparas,8,0,35,27
1657701970071,MATH 20C,A03,093476,Briones; Jor-el Thomas Caparas,0,1,36,36
1657701970071,MATH 20C,B01,083762,Bach; Quang Tran,1,0,30,29
1657701976097,MATH 20D,A01,083765,Tran; Brian Kha,5,0,30,25
1657701976097,MATH 20D,A02,083766,Tran; Brian Kha,5,0,30,25
1657701976097,MATH 20D,A03,083767,Tran; Brian Kha,5,0,30,25
1657701982123,MATH 20E,A01,083771,Ganguly; Soumya,9,0,32,23
1657701982123,MATH 20E,A02,083772,Ganguly; Soumya,6,0,32,26
1657701982123,MATH 20E,B01,083773,Ciotti; Benjamin,20,0,35,15
1657701982123,MATH 20E,B02,083774,Ciotti; Benjamin,18,0,35,17
1657701988152,MATH 103A,A01,083777,Greenfeld; Be'Eri,3,0,36,33
1657701988152,MATH 103A,A02,083778,Greenfeld; Be'Eri,5,0,36,31
1657701988152,MATH 103A,A03,093561,Greenfeld; Be'Eri,6,0,36,30
1657701988152,MATH 103A,B01,083779,Greenfeld; Be'Eri,7,0,36,29
1657701988152,MATH 103A,B02,083780,Greenfeld; Be'Eri,4,0,36,32
1657701988152,MATH 103A,B03,093562,Greenfeld; Be'Eri,3,0,36,33
1657701994175,MATH 105,A01,085443,Carter; Anne Toulson,15,0,35,20
1657701994175,MATH 105,A02,093477,Carter; Anne Toulson,20,0,35,15
1657702000207,MATH 109,A01,083213,Ganzberger; Geoffrey Michael,2,0,34,32
1657702000207,MATH 109,A02,083214,Ganzberger; Geoffrey Michael,4,0,34,30
1657702000207,MATH 109,A03,093478,Ganzberger; Geoffrey Michael,2,0,34,32
1657702000207,MATH 109,B01,083215,Ganzberger; Geoffrey Michael,1,0,32,31
1657702000207,MATH 109,B02,083216,Ganzberger; Geoffrey Michael,2,0,32,30
1657702000207,MATH 109,B03,093479,Ganzberger; Geoffrey Michael,8,0,32,24
1657702006232,MATH 142A,A01,083219,Chow; Bennett,7,0,32,25
1657702006232,MATH 142A,A02,083220,Chow; Bennett,10,0,32,22
1657702006232,MATH 142A,A03,093480,Chow; Bennett,9,0,32,23
1657702006232,MATH 142A,B03,093481,Chow; Bennett,8,0,32,24
1657702006232,MATH 142A,B04,093558,Chow; Bennett,13,0,32,19
1657702006232,MATH 142A,B05,093559,Chow; Bennett,6,0,32,26
1657702012260,MATH 193A,A01,083224,Rotar; Vladimir,8,0,34,26
1657702012260,MATH 193A,A02,083225,Rotar; Vladimir,9,0,34,25
1657702012260,MATH 193A,A03,083781,Rotar; Vladimir,5,0,34,29
1657702012260,MATH 193A,A04,083782,Rotar; Vladimir,10,0,34,24
1657702012260,MATH 193A,A05,093482,Rotar; Vladimir,10,0,34,24
1657702018285,MATH 197,001,091859,McAuley; Julian John,9999,0,9999,0
1657702018285,MATH 197,002,095566,Kedlaya; Kiran S.,9997,0,9999,2
1657702018285,MATH 197,003,095567,Xiao; Ming,9999,0,9999,0
1657702018285,MATH 197,004,095571,Perols; Johan Lars,9998,0,9999,1
1657702025362,COGS 9,A01,083615,Shannon; Kyle Michael,9,0,75,66
1657702031387,COGS 11,A01,083617,Boyle; Mary E. T.,23,0,48,25
1657702037413,COGS 13,A01,083071,Bastos; Amalia Pinkusfeld,11,0,71,60
1657702043445,COGS 14A,A01,092681,Semenuks; Arturs,5,1,100,95
1657702049482,COGS 14B,A01,083073,Cheng; Tzu-Han,6,0,63,57
1657702055506,COGS 17,A01,092677,Semenuks; Arturs,6,0,81,75
1657702061538,COGS 100,A01,083619,Allen; Michael Gordon,17,0,70,53
1657702067564,COGS 101A,A01,083621,Davis; Joshua Daniel,9,0,68,59
1657702073589,COGS 101B,A01,091572,Allen; Michael Gordon,12,0,65,53
1657702079616,COGS 101C,A01,083625,Delgado; Tania,17,0,35,18
1657702085645,COGS 107A,A01,083627,Boyle; Mary E. T.,13,0,60,47
1657702091674,COGS 118A,A01,083075,Gupta; Anjum,21,0,76,55
1657702097710,CSE 3,A50,083646,Miranda; Gregory Joseph,24,0,50,26
1657702103736,CSE 8A,A50,083650,Miranda; Gregory Joseph,17,1,56,39
1657702109759,CSE 11,A01,083080,Cao; Yingjun,6,15,40,34
1657702115793,CSE 12,A01,083652,Krause-Levy; Sophia Louisa,28,1,120,92
1657702121825,CSE 15L,A01,083654,Morris; Justin Loren,9,0,50,41
1657702121825,CSE 15L,A02,083655,Morris; Justin Loren,9,0,50,41
1657702127850,CSE 20,A01,083657,Tran; Khoa Dang,39,0,80,41
1657702133881,CSE 21,A01,095574,Bach; Quang Tran,22,0,48,26
1657702139909,CSE 30,A01,083084,Eldon; John,6,0,80,74
1657702139909,CSE 30,B01,095061,Bhaskar; Nishant,9,0,50,41
1657702146004,CSE 100,A01,083659,Cao; Yingjun,5,4,70,65
1657702152032,CSE 134B,A01,083661,Powell; Thomas Allan,23,0,100,77
1657702158063,CSE 140,A01,083663,Gungor; Onat,15,0,85,70
1657702164093,CSE 140L,A01,083088,Eldon; John,22,0,100,78
1657702170121,CSE 175,A01,083665,Kumar; Rakesh,3,0,25,22
1657702176146,CSE 190,A00,092507,Dubnov; Shlomo,8,0,20,12
1657702182173,ECE 45,A01,083139,Congero; Spencer William,6,0,75,69
1657702188205,ECE 65,A50,083695,Saad; Andrew S,12,0,30,18
1657702188205,ECE 65,A51,095125,Saad; Andrew S,24,0,26,2
1657702194230,ECE 109,A01,091882,Touri; Behrouz,20,0,70,50
1657702200259,ECE 180,A00,083140,Abi Samra; Nicholas Camill,1,0,30,29
1657702200259,ECE 180,B00,083141,Abi Samra; Nicholas Camill,0,0,30,30
1657702206296,MATH 10A,A01,083735,Patchell; Gregory David,2,0,30,28
1657702206296,MATH 10A,A02,083736,Patchell; Gregory David,20,0,30,10
1657702206296,MATH 10A,A03,083737,Patchell; Gregory David,16,0,30,14
1657702212332,MATH 10B,A01,083207,Lim; Seonhee,8,0,34,26
1657702212332,MATH 10B,A02,083208,Lim; Seonhee,9,0,35,26
1657702212332,MATH 10B,A03,093472,Lim; Seonhee,7,0,34,27
1657702212332,MATH 10B,B01,083739,Sinha; Shubham,13,0,30,17
1657702218375,MATH 18,A01,083743,Cinel; Cameron Alexander,8,0,30,22
1657702218375,MATH 18,A02,083744,Cinel; Cameron Alexander,17,0,30,13
1657702218375,MATH 18,A03,083745,Cinel; Cameron Alexander,10,0,30,20
1657702218375,MATH 18,B01,083748,Rideout; David Porter,5,0,37,32
1657702218375,MATH 18,B02,083749,Rideout; David Porter,5,0,36,31
1657702218375,MATH 18,B03,083750,Rideout; David Porter,3,0,37,34
1657702218375,MATH 18,B04,083751,Rideout; David Porter,6,0,36,30
1657702218375,MATH 18,B05,093473,Rideout; David Porter,6,0,36,30
1657702218375,MATH 18,B06,093474,Rideout; David Porter,6,0,36,30
1657702224400,MATH 20A,A01,083754,Zheng; Zequn,14,0,40,26
1657702230436,MATH 20B,A01,083756,Briones; Jor-el Thomas Caparas,4,0,36,32
1657702230436,MATH 20B,A02,083757,Briones; Jor-el Thomas Caparas,1,0,36,35
1657702230436,MATH 20B,A03,093475,Briones; Jor-el Thomas Caparas,2,0,36,34
1657702236474,MATH 20C,A01,083760,Briones; Jor-el Thomas Caparas,1,0,35,34
1657702236474,MATH 20C,A02,083761,Briones; Jor-el Thomas Caparas,8,0,35,27
1657702236474,MATH 20C,A03,093476,Briones; Jor-el Thomas Caparas,0,1,36,36
1657702236474,MATH 20C,B01,083762,Bach; Quang Tran,1,0,30,29
1657702242506,MATH 20D,A01,083765,Tran; Brian Kha,5,0,30,25
1657702242506,MATH 20D,A02,083766,Tran; Brian Kha,5,0,30,25
1657702242506,MATH 20D,A03,083767,Tran; Brian Kha,5,0,30,25
1657702248550,MATH 20E,A01,083771,Ganguly; Soumya,9,0,32,23
1657702248550,MATH 20E,A02,083772,Ganguly; Soumya,6,0,32,26
1657702248550,MATH 20E,B01,083773,Ciotti; Benjamin,20,0,35,15
1657702248550,MATH 20E,B02,083774,Ciotti; Benjamin,18,0,35,17
1657702254597,MATH 103A,A01,083777,Greenfeld; Be'Eri,3,0,36,33
1657702254597,MATH 103A,A02,083778,Greenfeld; Be'Eri,5,0,36,31
1657702254597,MATH 103A,A03,093561,Greenfeld; Be'Eri,6,0,36,30
1657702254597,MATH 103A,B01,083779,Greenfeld; Be'Eri,7,0,36,29
1657702254597,MATH 103A,B02,083780,Greenfeld; Be'Eri,4,0,36,32
1657702254597,MATH 103A,B03,093562,Greenfeld; Be'Eri,3,0,36,33
1657702260622,MATH 105,A01,085443,Carter; Anne Toulson,15,0,35,20
1657702260622,MATH 105,A02,093477,Carter; Anne Toulson,20,0,35,15
1657702266672,MATH 109,A01,083213,Ganzberger; Geoffrey Michael,2,0,34,32
1657702266672,MATH 109,A02,083214,Ganzberger; Geoffrey Michael,4,0,34,30
1657702266672,MATH 109,A03,093478,Ganzberger; Geoffrey Michael,2,0,34,32
1657702266672,MATH 109,B01,083215,Ganzberger; Geoffrey Michael,1,0,32,31
1657702266672,MATH 109,B02,083216,Ganzberger; Geoffrey Michael,2,0,32,30
1657702266672,MATH 109,B03,093479,Ganzberger; Geoffrey Michael,8,0,32,24
1657702272715,MATH 142A,A01,083219,Chow; Bennett,7,0,32,25
1657702272715,MATH 142A,A02,083220,Chow; Bennett,10,0,32,22
1657702272715,MATH 142A,A03,093480,Chow; Bennett,9,0,32,23
1657702272715,MATH 142A,B03,093481,Chow; Bennett,8,0,32,24
1657702272715,MATH 142A,B04,093558,Chow; Bennett,13,0,32,19
1657702272715,MATH 142A,B05,093559,Chow; Bennett,6,0,32,26
1657702278749,MATH 193A,A01,083224,Rotar; Vladimir,8,0,34,26
1657702278749,MATH 193A,A02,083225,Rotar; Vladimir,9,0,34,25
1657702278749,MATH 193A,A03,083781,Rotar; Vladimir,5,0,34,29
1657702278749,MATH 193A,A04,083782,Rotar; Vladimir,10,0,34,24
1657702278749,MATH 193A,A05,093482,Rotar; Vladimir,10,0,34,24
1657702284779,MATH 197,001,091859,McAuley; Julian John,9999,0,9999,0
1657702284779,MATH 197,002,095566,Kedlaya; Kiran S.,9997,0,9999,2
1657702284779,MATH 197,003,095567,Xiao; Ming,9999,0,9999,0
1657702284779,MATH 197,004,095571,Perols; Johan Lars,9998,0,9999,1
1657702291857,COGS 9,A01,083615,Shannon; Kyle Michael,9,0,75,66
1657702297879,COGS 11,A01,083617,Boyle; Mary E. T.,23,0,48,25
1657702303911,COGS 13,A01,083071,Bastos; Amalia Pinkusfeld,11,0,71,60
1657702309936,COGS 14A,A01,092681,Semenuks; Arturs,5,1,100,95
1657702315962,COGS 14B,A01,083073,Cheng; Tzu-Han,6,0,63,57
1657702321992,COGS 17,A01,092677,Semenuks; Arturs,6,0,81,75
1657702328015,COGS 100,A01,083619,Allen; Michael Gordon,17,0,70,53
1657702334044,COGS 101A,A01,083621,Davis; Joshua Daniel,9,0,68,59
1657702340073,COGS 101B,A01,091572,Allen; Michael Gordon,12,0,65,53
1657702346108,COGS 101C,A01,083625,Delgado; Tania,17,0,35,18
1657702352136,COGS 107A,A01,083627,Boyle; Mary E. T.,13,0,60,47
1657702358161,COGS 118A,A01,083075,Gupta; Anjum,21,0,76,55
1657702364189,CSE 3,A50,083646,Miranda; Gregory Joseph,24,0,50,26
1657702370219,CSE 8A,A50,083650,Miranda; Gregory Joseph,17,1,56,39
1657702376251,CSE 11,A01,083080,Cao; Yingjun,6,15,40,34
1657702382278,CSE 12,A01,083652,Krause-Levy; Sophia Louisa,28,1,120,92
1657702388311,CSE 15L,A01,083654,Morris; Justin Loren,9,0,50,41
1657702388311,CSE 15L,A02,083655,Morris; Justin Loren,9,0,50,41
1657702394335,CSE 20,A01,083657,Tran; Khoa Dang,39,0,80,41
1657702400365,CSE 21,A01,095574,Bach; Quang Tran,22,0,48,26
1657702406402,CSE 30,A01,083084,Eldon; John,6,0,80,74
1657702406402,CSE 30,B01,095061,Bhaskar; Nishant,9,0,50,41
1657702412433,CSE 100,A01,083659,Cao; Yingjun,5,4,70,65
1657702418466,CSE 134B,A01,083661,Powell; Thomas Allan,23,0,100,77
1657702424498,CSE 140,A01,083663,Gungor; Onat,15,0,85,70
1657702430523,CSE 140L,A01,083088,Eldon; John,22,0,100,78
1657702436555,CSE 175,A01,083665,Kumar; Rakesh,3,0,25,22
1657702442588,CSE 190,A00,092507,Dubnov; Shlomo,8,0,20,12
1657702448624,ECE 45,A01,083139,Congero; Spencer William,6,0,75,69
1657702454655,ECE 65,A50,083695,Saad; Andrew S,12,0,30,18
1657702454655,ECE 65,A51,095125,Saad; Andrew S,24,0,26,2
1657702460688,ECE 109,A01,091882,Touri; Behrouz,20,0,70,50
1657702466712,ECE 180,A00,083140,Abi Samra; Nicholas Camill,1,0,30,29
1657702466712,ECE 180,B00,083141,Abi Samra; Nicholas Camill,0,0,30,30
1657702472758,MATH 10A,A01,083735,Patchell; Gregory David,2,0,30,28
1657702472758,MATH 10A,A02,083736,Patchell; Gregory David,20,0,30,10
1657702472758,MATH 10A,A03,083737,Patchell; Gregory David,16,0,30,14
1657702478794,MATH 10B,A01,083207,Lim; Seonhee,8,0,34,26
1657702478794,MATH 10B,A02,083208,Lim; Seonhee,9,0,35,26
1657702478794,MATH 10B,A03,093472,Lim; Seonhee,7,0,34,27
1657702478794,MATH 10B,B01,083739,Sinha; Shubham,13,0,30,17
1657702484823,MATH 18,A01,083743,Cinel; Cameron Alexander,8,0,30,22
1657702484823,MATH 18,A02,083744,Cinel; Cameron Alexander,17,0,30,13
1657702484823,MATH 18,A03,083745,Cinel; Cameron Alexander,10,0,30,20
1657702484823,MATH 18,B01,083748,Rideout; David Porter,5,0,37,32
1657702484823,MATH 18,B02,083749,Rideout; David Porter,5,0,36,31
1657702484823,MATH 18,B03,083750,Rideout; David Porter,3,0,37,34
1657702484823,MATH 18,B04,083751,Rideout; David Porter,6,0,36,30
1657702484823,MATH 18,B05,093473,Rideout; David Porter,6,0,36,30
1657702484823,MATH 18,B06,093474,Rideout; David Porter,6,0,36,30
1657702490858,MATH 20A,A01,083754,Zheng; Zequn,14,0,40,26
1657702496890,MATH 20B,A01,083756,Briones; Jor-el Thomas Caparas,4,0,36,32
1657702496890,MATH 20B,A02,083757,Briones; Jor-el Thomas Caparas,1,0,36,35
1657702496890,MATH 20B,A03,093475,Briones; Jor-el Thomas Caparas,2,0,36,34
1657702502923,MATH 20C,A01,083760,Briones; Jor-el Thomas Caparas,1,0,35,34
1657702502923,MATH 20C,A02,083761,Briones; Jor-el Thomas Caparas,8,0,35,27
1657702502923,MATH 20C,A03,093476,Briones; Jor-el Thomas Caparas,0,1,36,36
1657702502923,MATH 20C,B01,083762,Bach; Quang Tran,1,0,30,29
1657702508950,MATH 20D,A01,083765,Tran; Brian Kha,5,0,30,25
1657702508950,MATH 20D,A02,083766,Tran; Brian Kha,5,0,30,25
1657702508950,MATH 20D,A03,083767,Tran; Brian Kha,5,0,30,25
1657702514990,MATH 20E,A01,083771,Ganguly; Soumya,9,0,32,23
1657702514990,MATH 20E,A02,083772,Ganguly; Soumya,6,0,32,26
1657702514990,MATH 20E,B01,083773,Ciotti; Benjamin,20,0,35,15
1657702514990,MATH 20E,B02,083774,Ciotti; Benjamin,18,0,35,17
1657702521024,MATH 103A,A01,083777,Greenfeld; Be'Eri,3,0,36,33
1657702521024,MATH 103A,A02,083778,Greenfeld; Be'Eri,5,0,36,31
1657702521024,MATH 103A,A03,093561,Greenfeld; Be'Eri,6,0,36,30
1657702521024,MATH 103A,B01,083779,Greenfeld; Be'Eri,7,0,36,29
1657702521024,MATH 103A,B02,083780,Greenfeld; Be'Eri,4,0,36,32
1657702521024,MATH 103A,B03,093562,Greenfeld; Be'Eri,3,0,36,33
1657702527053,MATH 105,A01,085443,Carter; Anne Toulson,15,0,35,20
1657702527053,MATH 105,A02,093477,Carter; Anne Toulson,20,0,35,15
1657702533080,MATH 109,A01,083213,Ganzberger; Geoffrey Michael,2,0,34,32
1657702533080,MATH 109,A02,083214,Ganzberger; Geoffrey Michael,4,0,34,30
1657702533080,MATH 109,A03,093478,Ganzberger; Geoffrey Michael,2,0,34,32
1657702533080,MATH 109,B01,083215,Ganzberger; Geoffrey Michael,1,0,32,31
1657702533080,MATH 109,B02,083216,Ganzberger; Geoffrey Michael,2,0,32,30
1657702533080,MATH 109,B03,093479,Ganzberger; Geoffrey Michael,8,0,32,24
1657702539119,MATH 142A,A01,083219,Chow; Bennett,7,0,32,25
1657702539119,MATH 142A,A02,083220,Chow; Bennett,10,0,32,22
1657702539119,MATH 142A,A03,093480,Chow; Bennett,9,0,32,23
1657702539119,MATH 142A,B03,093481,Chow; Bennett,8,0,32,24
1657702539119,MATH 142A,B04,093558,Chow; Bennett,13,0,32,19
1657702539119,MATH 142A,B05,093559,Chow; Bennett,6,0,32,26
1657702545150,MATH 193A,A01,083224,Rotar; Vladimir,8,0,34,26
1657702545150,MATH 193A,A02,083225,Rotar; Vladimir,9,0,34,25
1657702545150,MATH 193A,A03,083781,Rotar; Vladimir,5,0,34,29
1657702545150,MATH 193A,A04,083782,Rotar; Vladimir,10,0,34,24
1657702545150,MATH 193A,A05,093482,Rotar; Vladimir,10,0,34,24
1657702551173,MATH 197,001,091859,McAuley; Julian John,9999,0,9999,0
1657702551173,MATH 197,002,095566,Kedlaya; Kiran S.,9997,0,9999,2
1657702551173,MATH 197,003,095567,Xiao; Ming,9999,0,9999,0
1657702551173,MATH 197,004,095571,Perols; Johan Lars,9998,0,9999,1
1657702558232,COGS 9,A01,083615,Shannon; Kyle Michael,9,0,75,66
1657702564263,COGS 11,A01,083617,Boyle; Mary E. T.,23,0,48,25
1657702570288,COGS 13,A01,083071,Bastos; Amalia Pinkusfeld,11,0,71,60
1657702576312,COGS 14A,A01,092681,Semenuks; Arturs,5,1,100,95
1657702582344,COGS 14B,A01,083073,Cheng; Tzu-Han,6,0,63,57
1657702588365,COGS 17,A01,092677,Semenuks; Arturs,6,0,81,75
1657702594390,COGS 100,A01,083619,Allen; Michael Gordon,17,0,70,53
1657702600415,COGS 101A,A01,083621,Davis; Joshua Daniel,9,0,68,59
1657702606450,COGS 101B,A01,091572,Allen; Michael Gordon,12,0,65,53
1657702612474,COGS 101C,A01,083625,Delgado; Tania,17,0,35,18
1657702618503,COGS 107A,A01,083627,Boyle; Mary E. T.,13,0,60,47
1657702624531,COGS 118A,A01,083075,Gupta; Anjum,21,0,76,55
1657702630560,CSE 3,A50,083646,Miranda; Gregory Joseph,24,0,50,26
1657702636585,CSE 8A,A50,083650,Miranda; Gregory Joseph,17,1,56,39
1657702642610,CSE 11,A01,083080,Cao; Yingjun,6,15,40,34
1657702648634,CSE 12,A01,083652,Krause-Levy; Sophia Louisa,28,1,120,92
1657702654668,CSE 15L,A01,083654,Morris; Justin Loren,9,0,50,41
1657702654668,CSE 15L,A02,083655,Morris; Justin Loren,9,0,50,41
1657702660696,CSE 20,A01,083657,Tran; Khoa Dang,39,0,80,41
1657702666719,CSE 21,A01,095574,Bach; Quang Tran,22,0,48,26
1657702672743,CSE 30,A01,083084,Eldon; John,6,0,80,74
1657702672743,CSE 30,B01,095061,Bhaskar; Nishant,9,0,50,41
1657702678769,CSE 100,A01,083659,Cao; Yingjun,5,4,70,65
1657702684795,CSE 134B,A01,083661,Powell; Thomas Allan,23,0,100,77
1657702690817,CSE 140,A01,083663,Gungor; Onat,15,0,85,70
1657702696840,CSE 140L,A01,083088,Eldon; John,22,0,100,78
1657702702862,CSE 175,A01,083665,Kumar; Rakesh,3,0,25,22
1657702708885,CSE 190,A00,092507,Dubnov; Shlomo,8,0,20,12
1657702714917,ECE 45,A01,083139,Congero; Spencer William,6,0,75,69
1657702720941,ECE 65,A50,083695,Saad; Andrew S,12,0,30,18
1657702720941,ECE 65,A51,095125,Saad; Andrew S,24,0,26,2
1657702726968,ECE 109,A01,091882,Touri; Behrouz,20,0,70,50
1657702732992,ECE 180,A00,083140,Abi Samra; Nicholas Camill,1,0,30,29
1657702732992,ECE 180,B00,083141,Abi Samra; Nicholas Camill,0,0,30,30
1657702739016,MATH 10A,A01,083735,Patchell; Gregory David,2,0,30,28
1657702739016,MATH 10A,A02,083736,Patchell; Gregory David,20,0,30,10
1657702739016,MATH 10A,A03,083737,Patchell; Gregory David,16,0,30,14
1657702745126,MATH 10B,A01,083207,Lim; Seonhee,8,0,34,26
1657702745126,MATH 10B,A02,083208,Lim; Seonhee,9,0,35,26
1657702745126,MATH 10B,A03,093472,Lim; Seonhee,7,0,34,27
1657702745126,MATH 10B,B01,083739,Sinha; Shubham,13,0,30,17
1657702751161,MATH 18,A01,083743,Cinel; Cameron Alexander,8,0,30,22
1657702751161,MATH 18,A02,083744,Cinel; Cameron Alexander,17,0,30,13
1657702751161,MATH 18,A03,083745,Cinel; Cameron Alexander,10,0,30,20
1657702751161,MATH 18,B01,083748,Rideout; David Porter,5,0,37,32
1657702751161,MATH 18,B02,083749,Rideout; David Porter,5,0,36,31
1657702751161,MATH 18,B03,083750,Rideout; David Porter,3,0,37,34
1657702751161,MATH 18,B04,083751,Rideout; David Porter,6,0,36,30
1657702751161,MATH 18,B05,093473,Rideout; David Porter,6,0,36,30
1657702751161,MATH 18,B06,093474,Rideout; David Porter,6,0,36,30
1657702757186,MATH 20A,A01,083754,Zheng; Zequn,14,0,40,26
1657702763210,MATH 20B,A01,083756,Briones; Jor-el Thomas Caparas,4,0,36,32
1657702763210,MATH 20B,A02,083757,Briones; Jor-el Thomas Caparas,1,0,36,35
1657702763210,MATH 20B,A03,093475,Briones; Jor-el Thomas Caparas,2,0,36,34
1657702769234,MATH 20C,A01,083760,Briones; Jor-el Thomas Caparas,1,0,35,34
1657702769234,MATH 20C,A02,083761,Briones; Jor-el Thomas Caparas,8,0,35,27
1657702769234,MATH 20C,A03,093476,Briones; Jor-el Thomas Caparas,0,1,36,36
1657702769234,MATH 20C,B01,083762,Bach; Quang Tran,1,0,30,29
1657702775264,MATH 20D,A01,083765,Tran; Brian Kha,5,0,30,25
1657702775264,MATH 20D,A02,083766,Tran; Brian Kha,5,0,30,25
1657702775264,MATH 20D,A03,083767,Tran; Brian Kha,5,0,30,25
1657702781297,MATH 20E,A01,083771,Ganguly; Soumya,9,0,32,23
1657702781297,MATH 20E,A02,083772,Ganguly; Soumya,6,0,32,26
1657702781297,MATH 20E,B01,083773,Ciotti; Benjamin,20,0,35,15
1657702781297,MATH 20E,B02,083774,Ciotti; Benjamin,18,0,35,17
1657702787323,MATH 103A,A01,083777,Greenfeld; Be'Eri,3,0,36,33
1657702787323,MATH 103A,A02,083778,Greenfeld; Be'Eri,5,0,36,31
1657702787323,MATH 103A,A03,093561,Greenfeld; Be'Eri,6,0,36,30
1657702787323,MATH 103A,B01,083779,Greenfeld; Be'Eri,7,0,36,29
1657702787323,MATH 103A,B02,083780,Greenfeld; Be'Eri,4,0,36,32
1657702787323,MATH 103A,B03,093562,Greenfeld; Be'Eri,3,0,36,33
1657702793346,MATH 105,A01,085443,Carter; Anne Toulson,15,0,35,20
1657702793346,MATH 105,A02,093477,Carter; Anne Toulson,20,0,35,15
1657702799376,MATH 109,A01,083213,Ganzberger; Geoffrey Michael,2,0,34,32
1657702799376,MATH 109,A02,083214,Ganzberger; Geoffrey Michael,4,0,34,30
1657702799376,MATH 109,A03,093478,Ganzberger; Geoffrey Michael,2,0,34,32
1657702799376,MATH 109,B01,083215,Ganzberger; Geoffrey Michael,1,0,32,31
1657702799376,MATH 109,B02,083216,Ganzberger; Geoffrey Michael,2,0,32,30
1657702799376,MATH 109,B03,093479,Ganzberger; Geoffrey Michael,8,0,32,24
1657702805406,MATH 142A,A01,083219,Chow; Bennett,7,0,32,25
1657702805406,MATH 142A,A02,083220,Chow; Bennett,10,0,32,22
1657702805406,MATH 142A,A03,093480,Chow; Bennett,9,0,32,23
1657702805406,MATH 142A,B03,093481,Chow; Bennett,8,0,32,24
1657702805406,MATH 142A,B04,093558,Chow; Bennett,13,0,32,19
1657702805406,MATH 142A,B05,093559,Chow; Bennett,6,0,32,26
1657702811429,MATH 193A,A01,083224,Rotar; Vladimir,8,0,34,26
1657702811429,MATH 193A,A02,083225,Rotar; Vladimir,9,0,34,25
1657702811429,MATH 193A,A03,083781,Rotar; Vladimir,5,0,34,29
1657702811429,MATH 193A,A04,083782,Rotar; Vladimir,10,0,34,24
1657702811429,MATH 193A,A05,093482,Rotar; Vladimir,10,0,34,24
1657702817452,MATH 197,001,091859,McAuley; Julian John,9999,0,9999,0
1657702817452,MATH 197,002,095566,Kedlaya; Kiran S.,9997,0,9999,2
1657702817452,MATH 197,003,095567,Xiao; Ming,9999,0,9999,0
1657702817452,MATH 197,004,095571,Perols; Johan Lars,9998,0,9999,1
1657702824520,COGS 9,A01,083615,Shannon; Kyle Michael,9,0,75,66
1657702830543,COGS 11,A01,083617,Boyle; Mary E. T.,23,0,48,25
1657702836567,COGS 13,A01,083071,Bastos; Amalia Pinkusfeld,11,0,71,60
1657702842598,COGS 14A,A01,092681,Semenuks; Arturs,5,1,100,95
1657702848621,COGS 14B,A01,083073,Cheng; Tzu-Han,6,0,63,57
1657702854648,COGS 17,A01,092677,Semenuks; Arturs,6,0,81,75
1657702860676,COGS 100,A01,083619,Allen; Michael Gordon,17,0,70,53
1657702866699,COGS 101A,A01,083621,Davis; Joshua Daniel,9,0,68,59
1657702872722,COGS 101B,A01,091572,Allen; Michael Gordon,12,0,65,53
1657702878746,COGS 101C,A01,083625,Delgado; Tania,17,0,35,18
1657702884776,COGS 107A,A01,083627,Boyle; Mary E. T.,13,0,60,47
1657702890800,COGS 118A,A01,083075,Gupta; Anjum,21,0,76,55
1657702896834,CSE 3,A50,083646,Miranda; Gregory Joseph,24,0,50,26
1657702902859,CSE 8A,A50,083650,Miranda; Gregory Joseph,17,1,56,39
1657702908889,CSE 11,A01,083080,Cao; Yingjun,6,15,40,34
1657702914914,CSE 12,A01,083652,Krause-Levy; Sophia Louisa,28,1,120,92
1657702920938,CSE 15L,A01,083654,Morris; Justin Loren,9,0,50,41
1657702920938,CSE 15L,A02,083655,Morris; Justin Loren,9,0,50,41
1657702926961,CSE 20,A01,083657,Tran; Khoa Dang,39,0,80,41
1657702932985,CSE 21,A01,095574,Bach; Quang Tran,22,0,48,26
1657702939012,CSE 30,A01,083084,Eldon; John,6,0,80,74
1657702939012,CSE 30,B01,095061,Bhaskar; Nishant,9,0,50,41
1657702945036,CSE 100,A01,083659,Cao; Yingjun,5,4,70,65
1657702951059,CSE 134B,A01,083661,Powell; Thomas Allan,23,0,100,77
1657702957084,CSE 140,A01,083663,Gungor; Onat,15,0,85,70
1657702963113,CSE 140L,A01,083088,Eldon; John,22,0,100,78
1657702969143,CSE 175,A01,083665,Kumar; Rakesh,3,0,25,22
1657702975173,CSE 190,A00,092507,Dubnov; Shlomo,8,0,20,12
1657702981206,ECE 45,A01,083139,Congero; Spencer William,6,0,75,69
1657702987240,ECE 65,A50,083695,Saad; Andrew S,12,0,30,18
1657702987240,ECE 65,A51,095125,Saad; Andrew S,24,0,26,2
1657702993264,ECE 109,A01,091882,Touri; Behrouz,20,0,70,50
1657702999289,ECE 180,A00,083140,Abi Samra; Nicholas Camill,1,0,30,29
1657702999289,ECE 180,B00,083141,Abi Samra; Nicholas Camill,0,0,30,30
1657703005560,MATH 10A,A01,083735,Patchell; Gregory David,2,0,30,28
1657703005560,MATH 10A,A02,083736,Patchell; Gregory David,20,0,30,10
1657703005560,MATH 10A,A03,083737,Patchell; Gregory David,16,0,30,14
1657703011602,MATH 10B,A01,083207,Lim; Seonhee,8,0,34,26
1657703011602,MATH 10B,A02,083208,Lim; Seonhee,9,0,35,26
1657703011602,MATH 10B,A03,093472,Lim; Seonhee,7,0,34,27
1657703011602,MATH 10B,B01,083739,Sinha; Shubham,13,0,30,17
1657703017629,MATH 18,A01,083743,Cinel; Cameron Alexander,8,0,30,22
1657703017629,MATH 18,A02,083744,Cinel; Cameron Alexander,17,0,30,13
1657703017629,MATH 18,A03,083745,Cinel; Cameron Alexander,10,0,30,20
1657703017629,MATH 18,B01,083748,Rideout; David Porter,5,0,37,32
1657703017629,MATH 18,B02,083749,Rideout; David Porter,5,0,36,31
1657703017629,MATH 18,B03,083750,Rideout; David Porter,3,0,37,34
1657703017629,MATH 18,B04,083751,Rideout; David Porter,6,0,36,30
1657703017629,MATH 18,B05,093473,Rideout; David Porter,6,0,36,30
1657703017629,MATH 18,B06,093474,Rideout; David Porter,6,0,36,30
1657703023653,MATH 20A,A01,083754,Zheng; Zequn,14,0,40,26
1657703029679,MATH 20B,A01,083756,Briones; Jor-el Thomas Caparas,4,0,36,32
1657703029679,MATH 20B,A02,083757,Briones; Jor-el Thomas Caparas,1,0,36,35
1657703029679,MATH 20B,A03,093475,Briones; Jor-el Thomas Caparas,2,0,36,34
1657703035702,MATH 20C,A01,083760,Briones; Jor-el Thomas Caparas,1,0,35,34
1657703035702,MATH 20C,A02,083761,Briones; Jor-el Thomas Caparas,8,0,35,27
1657703035702,MATH 20C,A03,093476,Briones; Jor-el Thomas Caparas,0,1,36,36
1657703035702,MATH 20C,B01,083762,Bach; Quang Tran,1,0,30,29
1657703041735,MATH 20D,A01,083765,Tran; Brian Kha,5,0,30,25
1657703041735,MATH 20D,A02,083766,Tran; Brian Kha,5,0,30,25
1657703041735,MATH 20D,A03,083767,Tran; Brian Kha,5,0,30,25
1657703047761,MATH 20E,A01,083771,Ganguly; Soumya,9,0,32,23
1657703047761,MATH 20E,A02,083772,Ganguly; Soumya,6,0,32,26
1657703047761,MATH 20E,B01,083773,Ciotti; Benjamin,20,0,35,15
1657703047761,MATH 20E,B02,083774,Ciotti; Benjamin,18,0,35,17
1657703053790,MATH 103A,A01,083777,Greenfeld; Be'Eri,3,0,36,33
1657703053790,MATH 103A,A02,083778,Greenfeld; Be'Eri,5,0,36,31
1657703053790,MATH 103A,A03,093561,Greenfeld; Be'Eri,6,0,36,30
1657703053790,MATH 103A,B01,083779,Greenfeld; Be'Eri,7,0,36,29
1657703053790,MATH 103A,B02,083780,Greenfeld; Be'Eri,4,0,36,32
1657703053790,MATH 103A,B03,093562,Greenfeld; Be'Eri,3,0,36,33
1657703059822,MATH 105,A01,085443,Carter; Anne Toulson,15,0,35,20
1657703059822,MATH 105,A02,093477,Carter; Anne Toulson,20,0,35,15
1657703065848,MATH 109,A01,083213,Ganzberger; Geoffrey Michael,2,0,34,32
1657703065848,MATH 109,A02,083214,Ganzberger; Geoffrey Michael,4,0,34,30
1657703065848,MATH 109,A03,093478,Ganzberger; Geoffrey Michael,2,0,34,32
1657703065848,MATH 109,B01,083215,Ganzberger; Geoffrey Michael,1,0,32,31
1657703065848,MATH 109,B02,083216,Ganzberger; Geoffrey Michael,2,0,32,30
1657703065848,MATH 109,B03,093479,Ganzberger; Geoffrey Michael,8,0,32,24
1657703071871,MATH 142A,A01,083219,Chow; Bennett,7,0,32,25
1657703071871,MATH 142A,A02,083220,Chow; Bennett,10,0,32,22
1657703071871,MATH 142A,A03,093480,Chow; Bennett,9,0,32,23
1657703071871,MATH 142A,B03,093481,Chow; Bennett,8,0,32,24
1657703071871,MATH 142A,B04,093558,Chow; Bennett,13,0,32,19
1657703071871,MATH 142A,B05,093559,Chow; Bennett,6,0,32,26
1657703077901,MATH 193A,A01,083224,Rotar; Vladimir,8,0,34,26
1657703077901,MATH 193A,A02,083225,Rotar; Vladimir,9,0,34,25
1657703077901,MATH 193A,A03,083781,Rotar; Vladimir,5,0,34,29
1657703077901,MATH 193A,A04,083782,Rotar; Vladimir,10,0,34,24
1657703077901,MATH 193A,A05,093482,Rotar; Vladimir,10,0,34,24
1657703083928,MATH 197,001,091859,McAuley; Julian John,9999,0,9999,0
1657703083928,MATH 197,002,095566,Kedlaya; Kiran S.,9997,0,9999,2
1657703083928,MATH 197,003,095567,Xiao; Ming,9999,0,9999,0
1657703083928,MATH 197,004,095571,Perols; Johan Lars,9998,0,9999,1
1657703090995,COGS 9,A01,083615,Shannon; Kyle Michael,9,0,75,66
1657703097018,COGS 11,A01,083617,Boyle; Mary E. T.,23,0,48,25
1657703103051,COGS 13,A01,083071,Bastos; Amalia Pinkusfeld,11,0,71,60
1657703109081,COGS 14A,A01,092681,Semenuks; Arturs,5,1,100,95
1657703115107,COGS 14B,A01,083073,Cheng; Tzu-Han,6,0,63,57
1657703121136,COGS 17,A01,092677,Semenuks; Arturs,6,0,81,75
1657703127172,COGS 100,A01,083619,Allen; Michael Gordon,17,0,70,53
1657703133198,COGS 101A,A01,083621,Davis; Joshua Daniel,9,0,68,59
1657703139228,COGS 101B,A01,091572,Allen; Michael Gordon,12,0,65,53
1657703145260,COGS 101C,A01,083625,Delgado; Tania,17,0,35,18
1657703151285,COGS 107A,A01,083627,Boyle; Mary E. T.,13,0,60,47
1657703157313,COGS 118A,A01,083075,Gupta; Anjum,21,0,76,55
1657703163338,CSE 3,A50,083646,Miranda; Gregory Joseph,24,0,50,26
1657703169365,CSE 8A,A50,083650,Miranda; Gregory Joseph,17,1,56,39
1657703175392,CSE 11,A01,083080,Cao; Yingjun,6,15,40,34
1657703181419,CSE 12,A01,083652,Krause-Levy; Sophia Louisa,28,1,120,92
1657703187443,CSE 15L,A01,083654,Morris; Justin Loren,9,0,50,41
1657703187443,CSE 15L,A02,083655,Morris; Justin Loren,9,0,50,41
1657703193471,CSE 20,A01,083657,Tran; Khoa Dang,39,0,80,41
1657703199495,CSE 21,A01,095574,Bach; Quang Tran,22,0,48,26
1657703205522,CSE 30,A01,083084,Eldon; John,6,0,80,74
1657703205522,CSE 30,B01,095061,Bhaskar; Nishant,9,0,50,41
1657703211545,CSE 100,A01,083659,Cao; Yingjun,5,4,70,65
1657703217573,CSE 134B,A01,083661,Powell; Thomas Allan,23,0,100,77
1657703223600,CSE 140,A01,083663,Gungor; Onat,15,0,85,70
1657703229625,CSE 140L,A01,083088,Eldon; John,22,0,100,78
1657703235649,CSE 175,A01,083665,Kumar; Rakesh,3,0,25,22
1657703241677,CSE 190,A00,092507,Dubnov; Shlomo,8,0,20,12
1657703247699,ECE 45,A01,083139,Congero; Spencer William,6,0,75,69
1657703253724,ECE 65,A50,083695,Saad; Andrew S,12,0,30,18
1657703253724,ECE 65,A51,095125,Saad; Andrew S,24,0,26,2
1657703259749,ECE 109,A01,091882,Touri; Behrouz,20,0,70,50
1657703265777,ECE 180,A00,083140,Abi Samra; Nicholas Camill,1,0,30,29
1657703265777,ECE 180,B00,083141,Abi Samra; Nicholas Camill,0,0,30,30
1657703271801,MATH 10A,A01,083735,Patchell; Gregory David,2,0,30,28
1657703271801,MATH 10A,A02,083736,Patchell; Gregory David,20,0,30,10
1657703271801,MATH 10A,A03,083737,Patchell; Gregory David,16,0,30,14
1657703277830,MATH 10B,A01,083207,Lim; Seonhee,8,0,34,26
1657703277830,MATH 10B,A02,083208,Lim; Seonhee,9,0,35,26
1657703277830,MATH 10B,A03,093472,Lim; Seonhee,7,0,34,27
1657703277830,MATH 10B,B01,083739,Sinha; Shubham,13,0,30,17
1657703283855,MATH 18,A01,083743,Cinel; Cameron Alexander,8,0,30,22
1657703283855,MATH 18,A02,083744,Cinel; Cameron Alexander,17,0,30,13
1657703283855,MATH 18,A03,083745,Cinel; Cameron Alexander,10,0,30,20
1657703283855,MATH 18,B01,083748,Rideout; David Porter,5,0,37,32
1657703283855,MATH 18,B02,083749,Rideout; David Porter,5,0,36,31
1657703283855,MATH 18,B03,083750,Rideout; David Porter,3,0,37,34
1657703283855,MATH 18,B04,083751,Rideout; David Porter,6,0,36,30
1657703283855,MATH 18,B05,093473,Rideout; David Porter,6,0,36,30
1657703283855,MATH 18,B06,093474,Rideout; David Porter,6,0,36,30
1657703289886,MATH 20A,A01,083754,Zheng; Zequn,14,0,40,26
1657703295912,MATH 20B,A01,083756,Briones; Jor-el Thomas Caparas,4,0,36,32
1657703295912,MATH 20B,A02,083757,Briones; Jor-el Thomas Caparas,1,0,36,35
1657703295912,MATH 20B,A03,093475,Briones; Jor-el Thomas Caparas,2,0,36,34
1657703301941,MATH 20C,A01,083760,Briones; Jor-el Thomas Caparas,1,0,35,34
1657703301941,MATH 20C,A02,083761,Briones; Jor-el Thomas Caparas,8,0,35,27
1657703301941,MATH 20C,A03,093476,Briones; Jor-el Thomas Caparas,0,1,36,36
1657703301941,MATH 20C,B01,083762,Bach; Quang Tran,1,0,30,29
1657703307969,MATH 20D,A01,083765,Tran; Brian Kha,5,0,30,25
1657703307969,MATH 20D,A02,083766,Tran; Brian Kha,5,0,30,25
1657703307969,MATH 20D,A03,083767,Tran; Brian Kha,5,0,30,25
1657703313998,MATH 20E,A01,083771,Ganguly; Soumya,9,0,32,23
1657703313998,MATH 20E,A02,083772,Ganguly; Soumya,6,0,32,26
1657703313998,MATH 20E,B01,083773,Ciotti; Benjamin,20,0,35,15
1657703313998,MATH 20E,B02,083774,Ciotti; Benjamin,18,0,35,17
1657703320023,MATH 103A,A01,083777,Greenfeld; Be'Eri,3,0,36,33
1657703320023,MATH 103A,A02,083778,Greenfeld; Be'Eri,5,0,36,31
1657703320023,MATH 103A,A03,093561,Greenfeld; Be'Eri,6,0,36,30
1657703320023,MATH 103A,B01,083779,Greenfeld; Be'Eri,7,0,36,29
1657703320023,MATH 103A,B02,083780,Greenfeld; Be'Eri,4,0,36,32
1657703320023,MATH 103A,B03,093562,Greenfeld; Be'Eri,3,0,36,33
1657703326052,MATH 105,A01,085443,Carter; Anne Toulson,15,0,35,20
1657703326052,MATH 105,A02,093477,Carter; Anne Toulson,20,0,35,15
1657703332076,MATH 109,A01,083213,Ganzberger; Geoffrey Michael,2,0,34,32
1657703332076,MATH 109,A02,083214,Ganzberger; Geoffrey Michael,4,0,34,30
1657703332076,MATH 109,A03,093478,Ganzberger; Geoffrey Michael,2,0,34,32
1657703332076,MATH 109,B01,083215,Ganzberger; Geoffrey Michael,1,0,32,31
1657703332076,MATH 109,B02,083216,Ganzberger; Geoffrey Michael,2,0,32,30
1657703332076,MATH 109,B03,093479,Ganzberger; Geoffrey Michael,8,0,32,24
1657703338104,MATH 142A,A01,083219,Chow; Bennett,7,0,32,25
1657703338104,MATH 142A,A02,083220,Chow; Bennett,10,0,32,22
1657703338104,MATH 142A,A03,093480,Chow; Bennett,9,0,32,23
1657703338104,MATH 142A,B03,093481,Chow; Bennett,8,0,32,24
1657703338104,MATH 142A,B04,093558,Chow; Bennett,13,0,32,19
1657703338104,MATH 142A,B05,093559,Chow; Bennett,6,0,32,26
1657703344202,MATH 193A,A01,083224,Rotar; Vladimir,8,0,34,26
1657703344202,MATH 193A,A02,083225,Rotar; Vladimir,9,0,34,25
1657703344202,MATH 193A,A03,083781,Rotar; Vladimir,5,0,34,29
1657703344202,MATH 193A,A04,083782,Rotar; Vladimir,10,0,34,24
1657703344202,MATH 193A,A05,093482,Rotar; Vladimir,10,0,34,24
1657703350229,MATH 197,001,091859,McAuley; Julian John,9999,0,9999,0
1657703350229,MATH 197,002,095566,Kedlaya; Kiran S.,9997,0,9999,2
1657703350229,MATH 197,003,095567,Xiao; Ming,9999,0,9999,0
1657703350229,MATH 197,004,095571,Perols; Johan Lars,9998,0,9999,1
1657703357301,COGS 9,A01,083615,Shannon; Kyle Michael,9,0,75,66
1657703363325,COGS 11,A01,083617,Boyle; Mary E. T.,23,0,48,25
1657703369353,COGS 13,A01,083071,Bastos; Amalia Pinkusfeld,11,0,71,60
1657703375381,COGS 14A,A01,092681,Semenuks; Arturs,5,1,100,95
1657703381405,COGS 14B,A01,083073,Cheng; Tzu-Han,6,0,63,57
1657703387428,COGS 17,A01,092677,Semenuks; Arturs,6,0,81,75
1657703393461,COGS 100,A01,083619,Allen; Michael Gordon,17,0,70,53
1657703399490,COGS 101A,A01,083621,Davis; Joshua Daniel,9,0,68,59
1657703405514,COGS 101B,A01,091572,Allen; Michael Gordon,12,0,65,53
1657703411540,COGS 101C,A01,083625,Delgado; Tania,17,0,35,18
1657703417564,COGS 107A,A01,083627,Boyle; Mary E. T.,13,0,60,47
1657703423593,COGS 118A,A01,083075,Gupta; Anjum,21,0,76,55
1657703429618,CSE 3,A50,083646,Miranda; Gregory Joseph,24,0,50,26
1657703435655,CSE 8A,A50,083650,Miranda; Gregory Joseph,17,1,56,39
1657703441682,CSE 11,A01,083080,Cao; Yingjun,6,15,40,34
1657703447720,CSE 12,A01,083652,Krause-Levy; Sophia Louisa,28,1,120,92
1657703453748,CSE 15L,A01,083654,Morris; Justin Loren,9,0,50,41
1657703453748,CSE 15L,A02,083655,Morris; Justin Loren,9,0,50,41
1657703459772,CSE 20,A01,083657,Tran; Khoa Dang,39,0,80,41
1657703465797,CSE 21,A01,095574,Bach; Quang Tran,22,0,48,26
1657703471824,CSE 30,A01,083084,Eldon; John,6,0,80,74
1657703471824,CSE 30,B01,095061,Bhaskar; Nishant,9,0,50,41
1657703477851,CSE 100,A01,083659,Cao; Yingjun,5,4,70,65
1657703483880,CSE 134B,A01,083661,Powell; Thomas Allan,23,0,100,77
1657703489904,CSE 140,A01,083663,Gungor; Onat,15,0,85,70
1657703495926,CSE 140L,A01,083088,Eldon; John,22,0,100,78
1657703501955,CSE 175,A01,083665,Kumar; Rakesh,3,0,25,22
1657703507982,CSE 190,A00,092507,Dubnov; Shlomo,8,0,20,12
1657703514007,ECE 45,A01,083139,Congero; Spencer William,6,0,75,69
1657703520033,ECE 65,A50,083695,Saad; Andrew S,12,0,30,18
1657703520033,ECE 65,A51,095125,Saad; Andrew S,24,0,26,2
1657703526058,ECE 109,A01,091882,Touri; Behrouz,20,0,70,50
1657703532081,ECE 180,A00,083140,Abi Samra; Nicholas Camill,1,0,30,29
1657703532081,ECE 180,B00,083141,Abi Samra; Nicholas Camill,0,0,30,30
1657703538105,MATH 10A,A01,083735,Patchell; Gregory David,2,0,30,28
1657703538105,MATH 10A,A02,083736,Patchell; Gregory David,20,0,30,10
1657703538105,MATH 10A,A03,083737,Patchell; Gregory David,16,0,30,14
1657703544134,MATH 10B,A01,083207,Lim; Seonhee,8,0,34,26
1657703544134,MATH 10B,A02,083208,Lim; Seonhee,9,0,35,26
1657703544134,MATH 10B,A03,093472,Lim; Seonhee,7,0,34,27
1657703544134,MATH 10B,B01,083739,Sinha; Shubham,13,0,30,17
1657703550162,MATH 18,A01,083743,Cinel; Cameron Alexander,8,0,30,22
1657703550162,MATH 18,A02,083744,Cinel; Cameron Alexander,17,0,30,13
1657703550162,MATH 18,A03,083745,Cinel; Cameron Alexander,10,0,30,20
1657703550162,MATH 18,B01,083748,Rideout; David Porter,5,0,37,32
1657703550162,MATH 18,B02,083749,Rideout; David Porter,5,0,36,31
1657703550162,MATH 18,B03,083750,Rideout; David Porter,3,0,37,34
1657703550162,MATH 18,B04,083751,Rideout; David Porter,6,0,36,30
1657703550162,MATH 18,B05,093473,Rideout; David Porter,6,0,36,30
1657703550162,MATH 18,B06,093474,Rideout; David Porter,6,0,36,30
1657703556190,MATH 20A,A01,083754,Zheng; Zequn,14,0,40,26
1657703562213,MATH 20B,A01,083756,Briones; Jor-el Thomas Caparas,4,0,36,32
1657703562213,MATH 20B,A02,083757,Briones; Jor-el Thomas Caparas,1,0,36,35
1657703562213,MATH 20B,A03,093475,Briones; Jor-el Thomas Caparas,2,0,36,34
1657703568238,MATH 20C,A01,083760,Briones; Jor-el Thomas Caparas,1,0,35,34
1657703568238,MATH 20C,A02,083761,Briones; Jor-el Thomas Caparas,8,0,35,27
1657703568238,MATH 20C,A03,093476,Briones; Jor-el Thomas Caparas,0,1,36,36
1657703568238,MATH 20C,B01,083762,Bach; Quang Tran,1,0,30,29
1657703574263,MATH 20D,A01,083765,Tran; Brian Kha,5,0,30,25
1657703574263,MATH 20D,A02,083766,Tran; Brian Kha,5,0,30,25
1657703574263,MATH 20D,A03,083767,Tran; Brian Kha,5,0,30,25
1657703580289,MATH 20E,A01,083771,Ganguly; Soumya,9,0,32,23
1657703580289,MATH 20E,A02,083772,Ganguly; Soumya,6,0,32,26
1657703580289,MATH 20E,B01,083773,Ciotti; Benjamin,20,0,35,15
1657703580289,MATH 20E,B02,083774,Ciotti; Benjamin,18,0,35,17
1657703586313,MATH 103A,A01,083777,Greenfeld; Be'Eri,3,0,36,33
1657703586313,MATH 103A,A02,083778,Greenfeld; Be'Eri,5,0,36,31
1657703586313,MATH 103A,A03,093561,Greenfeld; Be'Eri,6,0,36,30
1657703586313,MATH 103A,B01,083779,Greenfeld; Be'Eri,7,0,36,29
1657703586313,MATH 103A,B02,083780,Greenfeld; Be'Eri,4,0,36,32
1657703586313,MATH 103A,B03,093562,Greenfeld; Be'Eri,3,0,36,33
1657703592338,MATH 105,A01,085443,Carter; Anne Toulson,15,0,35,20
1657703592338,MATH 105,A02,093477,Carter; Anne Toulson,20,0,35,15
1657703598361,MATH 109,A01,083213,Ganzberger; Geoffrey Michael,2,0,34,32
1657703598361,MATH 109,A02,083214,Ganzberger; Geoffrey Michael,4,0,34,30
1657703598361,MATH 109,A03,093478,Ganzberger; Geoffrey Michael,2,0,34,32
1657703598361,MATH 109,B01,083215,Ganzberger; Geoffrey Michael,1,0,32,31
1657703598361,MATH 109,B02,083216,Ganzberger; Geoffrey Michael,2,0,32,30
1657703598361,MATH 109,B03,093479,Ganzberger; Geoffrey Michael,8,0,32,24
1657703604387,MATH 142A,A01,083219,Chow; Bennett,7,0,32,25
1657703604387,MATH 142A,A02,083220,Chow; Bennett,10,0,32,22
1657703604387,MATH 142A,A03,093480,Chow; Bennett,9,0,32,23
1657703604387,MATH 142A,B03,093481,Chow; Bennett,8,0,32,24
1657703604387,MATH 142A,B04,093558,Chow; Bennett,13,0,32,19
1657703604387,MATH 142A,B05,093559,Chow; Bennett,6,0,32,26
1657703610417,MATH 193A,A01,083224,Rotar; Vladimir,8,0,34,26
1657703610417,MATH 193A,A02,083225,Rotar; Vladimir,9,0,34,25
1657703610417,MATH 193A,A03,083781,Rotar; Vladimir,5,0,34,29
1657703610417,MATH 193A,A04,083782,Rotar; Vladimir,10,0,34,24
1657703610417,MATH 193A,A05,093482,Rotar; Vladimir,10,0,34,24
1657703616440,MATH 197,001,091859,McAuley; Julian John,9999,0,9999,0
1657703616440,MATH 197,002,095566,Kedlaya; Kiran S.,9997,0,9999,2
1657703616440,MATH 197,003,095567,Xiao; Ming,9999,0,9999,0
1657703616440,MATH 197,004,095571,Perols; Johan Lars,9998,0,9999,1
1657703623497,COGS 9,A01,083615,Shannon; Kyle Michael,9,0,75,66
1657703629523,COGS 11,A01,083617,Boyle; Mary E. T.,23,0,48,25
1657703635545,COGS 13,A01,083071,Bastos; Amalia Pinkusfeld,11,0,71,60
1657703641573,COGS 14A,A01,092681,Semenuks; Arturs,5,1,100,95
1657703647597,COGS 14B,A01,083073,Cheng; Tzu-Han,6,0,63,57
1657703653624,COGS 17,A01,092677,Semenuks; Arturs,6,0,81,75
1657703659648,COGS 100,A01,083619,Allen; Michael Gordon,17,0,70,53
1657703665671,COGS 101A,A01,083621,Davis; Joshua Daniel,9,0,68,59
1657703671693,COGS 101B,A01,091572,Allen; Michael Gordon,12,0,65,53
1657703677715,COGS 101C,A01,083625,Delgado; Tania,17,0,35,18
1657703683738,COGS 107A,A01,083627,Boyle; Mary E. T.,13,0,60,47
1657703689766,COGS 118A,A01,083075,Gupta; Anjum,21,0,76,55
1657703695793,CSE 3,A50,083646,Miranda; Gregory Joseph,24,0,50,26
1657703701822,CSE 8A,A50,083650,Miranda; Gregory Joseph,17,1,56,39
1657703707849,CSE 11,A01,083080,Cao; Yingjun,6,15,40,34
1657703713876,CSE 12,A01,083652,Krause-Levy; Sophia Louisa,28,1,120,92
1657703719904,CSE 15L,A01,083654,Morris; Justin Loren,9,0,50,41
1657703719904,CSE 15L,A02,083655,Morris; Justin Loren,9,0,50,41
1657703725926,CSE 20,A01,083657,Tran; Khoa Dang,39,0,80,41
1657703731949,CSE 21,A01,095574,Bach; Quang Tran,22,0,48,26
1657703737976,CSE 30,A01,083084,Eldon; John,6,0,80,74
1657703737976,CSE 30,B01,095061,Bhaskar; Nishant,9,0,50,41
1657703744004,CSE 100,A01,083659,Cao; Yingjun,5,4,70,65
1657703750037,CSE 134B,A01,083661,Powell; Thomas Allan,23,0,100,77
1657703756065,CSE 140,A01,083663,Gungor; Onat,15,0,85,70
1657703762171,CSE 140L,A01,083088,Eldon; John,22,0,100,78
1657703768193,CSE 175,A01,083665,Kumar; Rakesh,3,0,25,22
1657703774221,CSE 190,A00,092507,Dubnov; Shlomo,8,0,20,12
1657703780244,ECE 45,A01,083139,Congero; Spencer William,6,0,75,69
1657703786272,ECE 65,A50,083695,Saad; Andrew S,12,0,30,18
1657703786272,ECE 65,A51,095125,Saad; Andrew S,24,0,26,2
1657703792298,ECE 109,A01,091882,Touri; Behrouz,20,0,70,50
1657703798322,ECE 180,A00,083140,Abi Samra; Nicholas Camill,1,0,30,29
1657703798322,ECE 180,B00,083141,Abi Samra; Nicholas Camill,0,0,30,30
1657703804346,MATH 10A,A01,083735,Patchell; Gregory David,2,0,30,28
1657703804346,MATH 10A,A02,083736,Patchell; Gregory David,20,0,30,10
1657703804346,MATH 10A,A03,083737,Patchell; Gregory David,16,0,30,14
1657703810376,MATH 10B,A01,083207,Lim; Seonhee,8,0,34,26
1657703810376,MATH 10B,A02,083208,Lim; Seonhee,9,0,35,26
1657703810376,MATH 10B,A03,093472,Lim; Seonhee,7,0,34,27
1657703810376,MATH 10B,B01,083739,Sinha; Shubham,13,0,30,17
1657703816401,MATH 18,A01,083743,Cinel; Cameron Alexander,8,0,30,22
1657703816401,MATH 18,A02,083744,Cinel; Cameron Alexander,17,0,30,13
1657703816401,MATH 18,A03,083745,Cinel; Cameron Alexander,10,0,30,20
1657703816401,MATH 18,B01,083748,Rideout; David Porter,5,0,37,32
1657703816401,MATH 18,B02,083749,Rideout; David Porter,5,0,36,31
1657703816401,MATH 18,B03,083750,Rideout; David Porter,3,0,37,34
1657703816401,MATH 18,B04,083751,Rideout; David Porter,6,0,36,30
1657703816401,MATH 18,B05,093473,Rideout; David Porter,6,0,36,30
1657703816401,MATH 18,B06,093474,Rideout; David Porter,6,0,36,30
1657703822424,MATH 20A,A01,083754,Zheng; Zequn,14,0,40,26
1657703828452,MATH 20B,A01,083756,Briones; Jor-el Thomas Caparas,4,0,36,32
1657703828452,MATH 20B,A02,083757,Briones; Jor-el Thomas Caparas,1,0,36,35
1657703828452,MATH 20B,A03,093475,Briones; Jor-el Thomas Caparas,2,0,36,34
1657703834481,MATH 20C,A01,083760,Briones; Jor-el Thomas Caparas,1,0,35,34
1657703834481,MATH 20C,A02,083761,Briones; Jor-el Thomas Caparas,8,0,35,27
1657703834481,MATH 20C,A03,093476,Briones; Jor-el Thomas Caparas,0,1,36,36
1657703834481,MATH 20C,B01,083762,Bach; Quang Tran,1,0,30,29
1657703840510,MATH 20D,A01,083765,Tran; Brian Kha,5,0,30,25
1657703840510,MATH 20D,A02,083766,Tran; Brian Kha,5,0,30,25
1657703840510,MATH 20D,A03,083767,Tran; Brian Kha,5,0,30,25
1657703846534,MATH 20E,A01,083771,Ganguly; Soumya,9,0,32,23
1657703846534,MATH 20E,A02,083772,Ganguly; Soumya,6,0,32,26
1657703846534,MATH 20E,B01,083773,Ciotti; Benjamin,20,0,35,15
1657703846534,MATH 20E,B02,083774,Ciotti; Benjamin,18,0,35,17
1657703852560,MATH 103A,A01,083777,Greenfeld; Be'Eri,3,0,36,33
1657703852560,MATH 103A,A02,083778,Greenfeld; Be'Eri,5,0,36,31
1657703852560,MATH 103A,A03,093561,Greenfeld; Be'Eri,6,0,36,30
1657703852560,MATH 103A,B01,083779,Greenfeld; Be'Eri,7,0,36,29
1657703852560,MATH 103A,B02,083780,Greenfeld; Be'Eri,4,0,36,32
1657703852560,MATH 103A,B03,093562,Greenfeld; Be'Eri,3,0,36,33
1657703858586,MATH 105,A01,085443,Carter; Anne Toulson,15,0,35,20
1657703858586,MATH 105,A02,093477,Carter; Anne Toulson,20,0,35,15
1657703864611,MATH 109,A01,083213,Ganzberger; Geoffrey Michael,2,0,34,32
1657703864611,MATH 109,A02,083214,Ganzberger; Geoffrey Michael,4,0,34,30
1657703864611,MATH 109,A03,093478,Ganzberger; Geoffrey Michael,2,0,34,32
1657703864611,MATH 109,B01,083215,Ganzberger; Geoffrey Michael,1,0,32,31
1657703864611,MATH 109,B02,083216,Ganzberger; Geoffrey Michael,2,0,32,30
1657703864611,MATH 109,B03,093479,Ganzberger; Geoffrey Michael,8,0,32,24
1657703870642,MATH 142A,A01,083219,Chow; Bennett,7,0,32,25
1657703870642,MATH 142A,A02,083220,Chow; Bennett,10,0,32,22
1657703870642,MATH 142A,A03,093480,Chow; Bennett,9,0,32,23
1657703870642,MATH 142A,B03,093481,Chow; Bennett,8,0,32,24
1657703870642,MATH 142A,B04,093558,Chow; Bennett,13,0,32,19
1657703870642,MATH 142A,B05,093559,Chow; Bennett,6,0,32,26
1657703876670,MATH 193A,A01,083224,Rotar; Vladimir,8,0,34,26
1657703876670,MATH 193A,A02,083225,Rotar; Vladimir,9,0,34,25
1657703876670,MATH 193A,A03,083781,Rotar; Vladimir,5,0,34,29
1657703876670,MATH 193A,A04,083782,Rotar; Vladimir,10,0,34,24
1657703876670,MATH 193A,A05,093482,Rotar; Vladimir,10,0,34,24
1657703882693,MATH 197,001,091859,McAuley; Julian John,9999,0,9999,0
1657703882693,MATH 197,002,095566,Kedlaya; Kiran S.,9997,0,9999,2
1657703882693,MATH 197,003,095567,Xiao; Ming,9999,0,9999,0
1657703882693,MATH 197,004,095571,Perols; Johan Lars,9998,0,9999,1
1657703889753,COGS 9,A01,083615,Shannon; Kyle Michael,9,0,75,66
1657703895775,COGS 11,A01,083617,Boyle; Mary E. T.,23,0,48,25
1657703901802,COGS 13,A01,083071,Bastos; Amalia Pinkusfeld,11,0,71,60
1657703907825,COGS 14A,A01,092681,Semenuks; Arturs,5,1,100,95
1657703913847,COGS 14B,A01,083073,Cheng; Tzu-Han,6,0,63,57
1657703919870,COGS 17,A01,092677,Semenuks; Arturs,6,0,81,75
1657703925899,COGS 100,A01,083619,Allen; Michael Gordon,17,0,70,53
1657703931924,COGS 101A,A01,083621,Davis; Joshua Daniel,9,0,68,59
1657703938039,COGS 101B,A01,091572,Allen; Michael Gordon,12,0,65,53
1657703944062,COGS 101C,A01,083625,Delgado; Tania,17,0,35,18
1657703950088,COGS 107A,A01,083627,Boyle; Mary E. T.,13,0,60,47
1657703956116,COGS 118A,A01,083075,Gupta; Anjum,21,0,76,55
1657703962145,CSE 3,A50,083646,Miranda; Gregory Joseph,24,0,50,26
1657703968173,CSE 8A,A50,083650,Miranda; Gregory Joseph,17,1,56,39
1657703974196,CSE 11,A01,083080,Cao; Yingjun,6,15,40,34
1657703980224,CSE 12,A01,083652,Krause-Levy; Sophia Louisa,28,1,120,92
1657703986250,CSE 15L,A01,083654,Morris; Justin Loren,9,0,50,41
1657703986250,CSE 15L,A02,083655,Morris; Justin Loren,9,0,50,41
1657703992274,CSE 20,A01,083657,Tran; Khoa Dang,39,0,80,41
1657703998298,CSE 21,A01,095574,Bach; Quang Tran,22,0,48,26
1657704004320,CSE 30,A01,083084,Eldon; John,6,0,80,74
1657704004320,CSE 30,B01,095061,Bhaskar; Nishant,9,0,50,41
1657704010347,CSE 100,A01,083659,Cao; Yingjun,5,4,70,65
1657704016373,CSE 134B,A01,083661,Powell; Thomas Allan,23,0,100,77
1657704022396,CSE 140,A01,083663,Gungor; Onat,15,0,85,70
1657704028420,CSE 140L,A01,083088,Eldon; John,22,0,100,78
1657704034446,CSE 175,A01,083665,Kumar; Rakesh,3,0,25,22
1657704040471,CSE 190,A00,092507,Dubnov; Shlomo,8,0,20,12
1657704046505,ECE 45,A01,083139,Congero; Spencer William,6,0,75,69
1657704052535,ECE 65,A50,083695,Saad; Andrew S,12,0,30,18
1657704052535,ECE 65,A51,095125,Saad; Andrew S,24,0,26,2
1657704058563,ECE 109,A01,091882,Touri; Behrouz,20,0,70,50
1657704064593,ECE 180,A00,083140,Abi Samra; Nicholas Camill,1,0,30,29
1657704064593,ECE 180,B00,083141,Abi Samra; Nicholas Camill,0,0,30,30
1657704070625,MATH 10A,A01,083735,Patchell; Gregory David,2,0,30,28
1657704070625,MATH 10A,A02,083736,Patchell; Gregory David,20,0,30,10
1657704070625,MATH 10A,A03,083737,Patchell; Gregory David,16,0,30,14
1657704076653,MATH 10B,A01,083207,Lim; Seonhee,8,0,34,26
1657704076653,MATH 10B,A02,083208,Lim; Seonhee,9,0,35,26
1657704076653,MATH 10B,A03,093472,Lim; Seonhee,7,0,34,27
1657704076653,MATH 10B,B01,083739,Sinha; Shubham,13,0,30,17
1657704082691,MATH 18,A01,083743,Cinel; Cameron Alexander,8,0,30,22
1657704082691,MATH 18,A02,083744,Cinel; Cameron Alexander,17,0,30,13
1657704082691,MATH 18,A03,083745,Cinel; Cameron Alexander,10,0,30,20
1657704082691,MATH 18,B01,083748,Rideout; David Porter,5,0,37,32
1657704082691,MATH 18,B02,083749,Rideout; David Porter,5,0,36,31
1657704082691,MATH 18,B03,083750,Rideout; David Porter,3,0,37,34
1657704082691,MATH 18,B04,083751,Rideout; David Porter,6,0,36,30
1657704082691,MATH 18,B05,093473,Rideout; David Porter,6,0,36,30
1657704082691,MATH 18,B06,093474,Rideout; David Porter,6,0,36,30
1657704088722,MATH 20A,A01,083754,Zheng; Zequn,14,0,40,26
1657704094747,MATH 20B,A01,083756,Briones; Jor-el Thomas Caparas,4,0,36,32
1657704094747,MATH 20B,A02,083757,Briones; Jor-el Thomas Caparas,1,0,36,35
1657704094747,MATH 20B,A03,093475,Briones; Jor-el Thomas Caparas,2,0,36,34
1657704100777,MATH 20C,A01,083760,Briones; Jor-el Thomas Caparas,1,0,35,34
1657704100777,MATH 20C,A02,083761,Briones; Jor-el Thomas Caparas,8,0,35,27
1657704100777,MATH 20C,A03,093476,Briones; Jor-el Thomas Caparas,0,1,36,36
1657704100777,MATH 20C,B01,083762,Bach; Quang Tran,1,0,30,29
1657704106808,MATH 20D,A01,083765,Tran; Brian Kha,5,0,30,25
1657704106808,MATH 20D,A02,083766,Tran; Brian Kha,5,0,30,25
1657704106808,MATH 20D,A03,083767,Tran; Brian Kha,5,0,30,25
1657704112836,MATH 20E,A01,083771,Ganguly; Soumya,9,0,32,23
1657704112836,MATH 20E,A02,083772,Ganguly; Soumya,6,0,32,26
1657704112836,MATH 20E,B01,083773,Ciotti; Benjamin,20,0,35,15
1657704112836,MATH 20E,B02,083774,Ciotti; Benjamin,18,0,35,17
1657704118871,MATH 103A,A01,083777,Greenfeld; Be'Eri,3,0,36,33
1657704118871,MATH 103A,A02,083778,Greenfeld; Be'Eri,5,0,36,31
1657704118871,MATH 103A,A03,093561,Greenfeld; Be'Eri,6,0,36,30
1657704118871,MATH 103A,B01,083779,Greenfeld; Be'Eri,7,0,36,29
1657704118871,MATH 103A,B02,083780,Greenfeld; Be'Eri,4,0,36,32
1657704118871,MATH 103A,B03,093562,Greenfeld; Be'Eri,3,0,36,33
1657704124906,MATH 105,A01,085443,Carter; Anne Toulson,15,0,35,20
1657704124906,MATH 105,A02,093477,Carter; Anne Toulson,20,0,35,15
1657704130940,MATH 109,A01,083213,Ganzberger; Geoffrey Michael,2,0,34,32
1657704130940,MATH 109,A02,083214,Ganzberger; Geoffrey Michael,4,0,34,30
1657704130940,MATH 109,A03,093478,Ganzberger; Geoffrey Michael,2,0,34,32
1657704130940,MATH 109,B01,083215,Ganzberger; Geoffrey Michael,1,0,32,31
1657704130940,MATH 109,B02,083216,Ganzberger; Geoffrey Michael,2,0,32,30
1657704130940,MATH 109,B03,093479,Ganzberger; Geoffrey Michael,8,0,32,24
1657704136971,MATH 142A,A01,083219,Chow; Bennett,7,0,32,25
1657704136971,MATH 142A,A02,083220,Chow; Bennett,10,0,32,22
1657704136971,MATH 142A,A03,093480,Chow; Bennett,9,0,32,23
1657704136971,MATH 142A,B03,093481,Chow; Bennett,8,0,32,24
1657704136971,MATH 142A,B04,093558,Chow; Bennett,13,0,32,19
1657704136971,MATH 142A,B05,093559,Chow; Bennett,6,0,32,26
1657704143001,MATH 193A,A01,083224,Rotar; Vladimir,8,0,34,26
1657704143001,MATH 193A,A02,083225,Rotar; Vladimir,9,0,34,25
1657704143001,MATH 193A,A03,083781,Rotar; Vladimir,5,0,34,29
1657704143001,MATH 193A,A04,083782,Rotar; Vladimir,10,0,34,24
1657704143001,MATH 193A,A05,093482,Rotar; Vladimir,10,0,34,24
1657704149030,MATH 197,001,091859,McAuley; Julian John,9999,0,9999,0
1657704149030,MATH 197,002,095566,Kedlaya; Kiran S.,9997,0,9999,2
1657704149030,MATH 197,003,095567,Xiao; Ming,9999,0,9999,0
1657704149030,MATH 197,004,095571,Perols; Johan Lars,9998,0,9999,1
1657704156119,COGS 9,A01,083615,Shannon; Kyle Michael,9,0,75,66
1657704162148,COGS 11,A01,083617,Boyle; Mary E. T.,23,0,48,25
1657704168175,COGS 13,A01,083071,Bastos; Amalia Pinkusfeld,11,0,71,60
1657704174211,COGS 14A,A01,092681,Semenuks; Arturs,5,1,100,95
1657704180235,COGS 14B,A01,083073,Cheng; Tzu-Han,6,0,63,57
1657704186264,COGS 17,A01,092677,Semenuks; Arturs,6,0,81,75
1657704192288,COGS 100,A01,083619,Allen; Michael Gordon,17,0,70,53
1657704198319,COGS 101A,A01,083621,Davis; Joshua Daniel,9,0,68,59
1657704204345,COGS 101B,A01,091572,Allen; Michael Gordon,12,0,65,53
1657704210376,COGS 101C,A01,083625,Delgado; Tania,17,0,35,18
1657704216400,COGS 107A,A01,083627,Boyle; Mary E. T.,13,0,60,47
1657704222425,COGS 118A,A01,083075,Gupta; Anjum,21,0,76,55
1657704228459,CSE 3,A50,083646,Miranda; Gregory Joseph,24,0,50,26
1657704234484,CSE 8A,A50,083650,Miranda; Gregory Joseph,17,1,56,39
1657704240513,CSE 11,A01,083080,Cao; Yingjun,6,15,40,34
1657704246569,CSE 12,A01,083652,Krause-Levy; Sophia Louisa,28,1,120,92
1657704252594,CSE 15L,A01,083654,Morris; Justin Loren,9,0,50,41
1657704252594,CSE 15L,A02,083655,Morris; Justin Loren,9,0,50,41
1657704258625,CSE 20,A01,083657,Tran; Khoa Dang,39,0,80,41
1657704264656,CSE 21,A01,095574,Bach; Quang Tran,22,0,48,26
1657704270683,CSE 30,A01,083084,Eldon; John,6,0,80,74
1657704270683,CSE 30,B01,095061,Bhaskar; Nishant,9,0,50,41
1657704276712,CSE 100,A01,083659,Cao; Yingjun,5,4,70,65
1657704282747,CSE 134B,A01,083661,Powell; Thomas Allan,23,0,100,77
1657704288779,CSE 140,A01,083663,Gungor; Onat,15,0,85,70
1657704294804,CSE 140L,A01,083088,Eldon; John,22,0,100,78
1657704300830,CSE 175,A01,083665,Kumar; Rakesh,3,0,25,22
1657704306865,CSE 190,A00,092507,Dubnov; Shlomo,8,0,20,12
1657704312891,ECE 45,A01,083139,Congero; Spencer William,6,0,75,69
1657704318923,ECE 65,A50,083695,Saad; Andrew S,12,0,30,18
1657704318923,ECE 65,A51,095125,Saad; Andrew S,24,0,26,2
1657704324948,ECE 109,A01,091882,Touri; Behrouz,20,0,70,50
1657704330977,ECE 180,A00,083140,Abi Samra; Nicholas Camill,1,0,30,29
1657704330977,ECE 180,B00,083141,Abi Samra; Nicholas Camill,0,0,30,30
1657704337003,MATH 10A,A01,083735,Patchell; Gregory David,2,0,30,28
1657704337003,MATH 10A,A02,083736,Patchell; Gregory David,20,0,30,10
1657704337003,MATH 10A,A03,083737,Patchell; Gregory David,16,0,30,14
1657704343034,MATH 10B,A01,083207,Lim; Seonhee,8,0,34,26
1657704343034,MATH 10B,A02,083208,Lim; Seonhee,9,0,35,26
1657704343034,MATH 10B,A03,093472,Lim; Seonhee,7,0,34,27
1657704343034,MATH 10B,B01,083739,Sinha; Shubham,13,0,30,17
1657704349064,MATH 18,A01,083743,Cinel; Cameron Alexander,8,0,30,22
1657704349064,MATH 18,A02,083744,Cinel; Cameron Alexander,17,0,30,13
1657704349064,MATH 18,A03,083745,Cinel; Cameron Alexander,10,0,30,20
1657704349064,MATH 18,B01,083748,Rideout; David Porter,5,0,37,32
1657704349064,MATH 18,B02,083749,Rideout; David Porter,5,0,36,31
1657704349064,MATH 18,B03,083750,Rideout; David Porter,3,0,37,34
1657704349064,MATH 18,B04,083751,Rideout; David Porter,6,0,36,30
1657704349064,MATH 18,B05,093473,Rideout; David Porter,6,0,36,30
1657704349064,MATH 18,B06,093474,Rideout; David Porter,6,0,36,30
1657704355089,MATH 20A,A01,083754,Zheng; Zequn,14,0,40,26
1657704361115,MATH 20B,A01,083756,Briones; Jor-el Thomas Caparas,4,0,36,32
1657704361115,MATH 20B,A02,083757,Briones; Jor-el Thomas Caparas,1,0,36,35
1657704361115,MATH 20B,A03,093475,Briones; Jor-el Thomas Caparas,2,0,36,34
1657704367143,MATH 20C,A01,083760,Briones; Jor-el Thomas Caparas,1,0,35,34
1657704367143,MATH 20C,A02,083761,Briones; Jor-el Thomas Caparas,8,0,35,27
1657704367143,MATH 20C,A03,093476,Briones; Jor-el Thomas Caparas,0,1,36,36
1657704367143,MATH 20C,B01,083762,Bach; Quang Tran,1,0,30,29
1657704373176,MATH 20D,A01,083765,Tran; Brian Kha,5,0,30,25
1657704373176,MATH 20D,A02,083766,Tran; Brian Kha,5,0,30,25
1657704373176,MATH 20D,A03,083767,Tran; Brian Kha,5,0,30,25
1657704379202,MATH 20E,A01,083771,Ganguly; Soumya,9,0,32,23
1657704379202,MATH 20E,A02,083772,Ganguly; Soumya,6,0,32,26
1657704379202,MATH 20E,B01,083773,Ciotti; Benjamin,20,0,35,15
1657704379202,MATH 20E,B02,083774,Ciotti; Benjamin,18,0,35,17
1657704385230,MATH 103A,A01,083777,Greenfeld; Be'Eri,3,0,36,33
1657704385230,MATH 103A,A02,083778,Greenfeld; Be'Eri,5,0,36,31
1657704385230,MATH 103A,A03,093561,Greenfeld; Be'Eri,6,0,36,30
1657704385230,MATH 103A,B01,083779,Greenfeld; Be'Eri,7,0,36,29
1657704385230,MATH 103A,B02,083780,Greenfeld; Be'Eri,4,0,36,32
1657704385230,MATH 103A,B03,093562,Greenfeld; Be'Eri,3,0,36,33
1657704391255,MATH 105,A01,085443,Carter; Anne Toulson,15,0,35,20
1657704391255,MATH 105,A02,093477,Carter; Anne Toulson,20,0,35,15
1657704397286,MATH 109,A01,083213,Ganzberger; Geoffrey Michael,2,0,34,32
1657704397286,MATH 109,A02,083214,Ganzberger; Geoffrey Michael,4,0,34,30
1657704397286,MATH 109,A03,093478,Ganzberger; Geoffrey Michael,2,0,34,32
1657704397286,MATH 109,B01,083215,Ganzberger; Geoffrey Michael,1,0,32,31
1657704397286,MATH 109,B02,083216,Ganzberger; Geoffrey Michael,2,0,32,30
1657704397286,MATH 109,B03,093479,Ganzberger; Geoffrey Michael,8,0,32,24
1657704403312,MATH 142A,A01,083219,Chow; Bennett,7,0,32,25
1657704403312,MATH 142A,A02,083220,Chow; Bennett,10,0,32,22
1657704403312,MATH 142A,A03,093480,Chow; Bennett,9,0,32,23
1657704403312,MATH 142A,B03,093481,Chow; Bennett,8,0,32,24
1657704403312,MATH 142A,B04,093558,Chow; Bennett,13,0,32,19
1657704403312,MATH 142A,B05,093559,Chow; Bennett,6,0,32,26
1657704409346,MATH 193A,A01,083224,Rotar; Vladimir,8,0,34,26
1657704409346,MATH 193A,A02,083225,Rotar; Vladimir,9,0,34,25
1657704409346,MATH 193A,A03,083781,Rotar; Vladimir,5,0,34,29
1657704409346,MATH 193A,A04,083782,Rotar; Vladimir,10,0,34,24
1657704409346,MATH 193A,A05,093482,Rotar; Vladimir,10,0,34,24
1657704415378,MATH 197,001,091859,McAuley; Julian John,9999,0,9999,0
1657704415378,MATH 197,002,095566,Kedlaya; Kiran S.,9997,0,9999,2
1657704415378,MATH 197,003,095567,Xiao; Ming,9999,0,9999,0
1657704415378,MATH 197,004,095571,Perols; Johan Lars,9998,0,9999,1
1657704422451,COGS 9,A01,083615,Shannon; Kyle Michael,9,0,75,66
1657704428476,COGS 11,A01,083617,Boyle; Mary E. T.,23,0,48,25
1657704434502,COGS 13,A01,083071,Bastos; Amalia Pinkusfeld,11,0,71,60
1657704440527,COGS 14A,A01,092681,Semenuks; Arturs,5,1,100,95
1657704446556,COGS 14B,A01,083073,Cheng; Tzu-Han,6,0,63,57
1657704452584,COGS 17,A01,092677,Semenuks; Arturs,6,0,81,75
1657704458614,COGS 100,A01,083619,Allen; Michael Gordon,17,0,70,53
1657704464653,COGS 101A,A01,083621,Davis; Joshua Daniel,9,0,68,59
1657704470684,COGS 101B,A01,091572,Allen; Michael Gordon,12,0,65,53
1657704476714,COGS 101C,A01,083625,Delgado; Tania,17,0,35,18
1657704482739,COGS 107A,A01,083627,Boyle; Mary E. T.,13,0,60,47
1657704488770,COGS 118A,A01,083075,Gupta; Anjum,21,0,76,55
1657704494819,CSE 3,A50,083646,Miranda; Gregory Joseph,24,0,50,26
1657704500843,CSE 8A,A50,083650,Miranda; Gregory Joseph,17,1,56,39
1657704506870,CSE 11,A01,083080,Cao; Yingjun,6,15,40,34
1657704512894,CSE 12,A01,083652,Krause-Levy; Sophia Louisa,28,1,120,92
1657704518922,CSE 15L,A01,083654,Morris; Justin Loren,9,0,50,41
1657704518922,CSE 15L,A02,083655,Morris; Justin Loren,9,0,50,41
1657704524946,CSE 20,A01,083657,Tran; Khoa Dang,39,0,80,41
1657704530979,CSE 21,A01,095574,Bach; Quang Tran,22,0,48,26
1657704537086,CSE 30,A01,083084,Eldon; John,6,0,80,74
1657704537086,CSE 30,B01,095061,Bhaskar; Nishant,9,0,50,41
1657704543110,CSE 100,A01,083659,Cao; Yingjun,5,4,70,65
1657704549135,CSE 134B,A01,083661,Powell; Thomas Allan,23,0,100,77
1657704555158,CSE 140,A01,083663,Gungor; Onat,15,0,85,70
1657704561183,CSE 140L,A01,083088,Eldon; John,23,0,100,77
1657704567211,CSE 175,A01,083665,Kumar; Rakesh,3,0,25,22
1657704573234,CSE 190,A00,092507,Dubnov; Shlomo,8,0,20,12
1657704579257,ECE 45,A01,083139,Congero; Spencer William,6,0,75,69
1657704585285,ECE 65,A50,083695,Saad; Andrew S,12,0,30,18
1657704585285,ECE 65,A51,095125,Saad; Andrew S,24,0,26,2
1657704591309,ECE 109,A01,091882,Touri; Behrouz,20,0,70,50
1657704597340,ECE 180,A00,083140,Abi Samra; Nicholas Camill,1,0,30,29
1657704597340,ECE 180,B00,083141,Abi Samra; Nicholas Camill,0,0,30,30
1657704603380,MATH 10A,A01,083735,Patchell; Gregory David,2,0,30,28
1657704603380,MATH 10A,A02,083736,Patchell; Gregory David,20,0,30,10
1657704603380,MATH 10A,A03,083737,Patchell; Gregory David,16,0,30,14
1657704609408,MATH 10B,A01,083207,Lim; Seonhee,8,0,34,26
1657704609408,MATH 10B,A02,083208,Lim; Seonhee,9,0,35,26
1657704609408,MATH 10B,A03,093472,Lim; Seonhee,7,0,34,27
1657704609408,MATH 10B,B01,083739,Sinha; Shubham,13,0,30,17
1657704615445,MATH 18,A01,083743,Cinel; Cameron Alexander,8,0,30,22
1657704615445,MATH 18,A02,083744,Cinel; Cameron Alexander,17,0,30,13
1657704615445,MATH 18,A03,083745,Cinel; Cameron Alexander,10,0,30,20
1657704615445,MATH 18,B01,083748,Rideout; David Porter,5,0,37,32
1657704615445,MATH 18,B02,083749,Rideout; David Porter,5,0,36,31
1657704615445,MATH 18,B03,083750,Rideout; David Porter,3,0,37,34
1657704615445,MATH 18,B04,083751,Rideout; David Porter,6,0,36,30
1657704615445,MATH 18,B05,093473,Rideout; David Porter,6,0,36,30
1657704615445,MATH 18,B06,093474,Rideout; David Porter,6,0,36,30
1657704621476,MATH 20A,A01,083754,Zheng; Zequn,14,0,40,26
1657704627516,MATH 20B,A01,083756,Briones; Jor-el Thomas Caparas,4,0,36,32
1657704627516,MATH 20B,A02,083757,Briones; Jor-el Thomas Caparas,1,0,36,35
1657704627516,MATH 20B,A03,093475,Briones; Jor-el Thomas Caparas,2,0,36,34
1657704633546,MATH 20C,A01,083760,Briones; Jor-el Thomas Caparas,1,0,35,34
1657704633546,MATH 20C,A02,083761,Briones; Jor-el Thomas Caparas,8,0,35,27
1657704633546,MATH 20C,A03,093476,Briones; Jor-el Thomas Caparas,0,1,36,36
1657704633546,MATH 20C,B01,083762,Bach; Quang Tran,1,0,30,29
1657704639572,MATH 20D,A01,083765,Tran; Brian Kha,5,0,30,25
1657704639572,MATH 20D,A02,083766,Tran; Brian Kha,5,0,30,25
1657704639572,MATH 20D,A03,083767,Tran; Brian Kha,5,0,30,25
1657704645603,MATH 20E,A01,083771,Ganguly; Soumya,9,0,32,23
1657704645603,MATH 20E,A02,083772,Ganguly; Soumya,6,0,32,26
1657704645603,MATH 20E,B01,083773,Ciotti; Benjamin,20,0,35,15
1657704645603,MATH 20E,B02,083774,Ciotti; Benjamin,18,0,35,17
1657704651642,MATH 103A,A01,083777,Greenfeld; Be'Eri,3,0,36,33
1657704651642,MATH 103A,A02,083778,Greenfeld; Be'Eri,5,0,36,31
1657704651642,MATH 103A,A03,093561,Greenfeld; Be'Eri,6,0,36,30
1657704651642,MATH 103A,B01,083779,Greenfeld; Be'Eri,7,0,36,29
1657704651642,MATH 103A,B02,083780,Greenfeld; Be'Eri,4,0,36,32
1657704651642,MATH 103A,B03,093562,Greenfeld; Be'Eri,3,0,36,33
1657704657671,MATH 105,A01,085443,Carter; Anne Toulson,15,0,35,20
1657704657671,MATH 105,A02,093477,Carter; Anne Toulson,20,0,35,15
1657704663699,MATH 109,A01,083213,Ganzberger; Geoffrey Michael,2,0,34,32
1657704663699,MATH 109,A02,083214,Ganzberger; Geoffrey Michael,4,0,34,30
1657704663699,MATH 109,A03,093478,Ganzberger; Geoffrey Michael,2,0,34,32
1657704663699,MATH 109,B01,083215,Ganzberger; Geoffrey Michael,1,0,32,31
1657704663699,MATH 109,B02,083216,Ganzberger; Geoffrey Michael,2,0,32,30
1657704663699,MATH 109,B03,093479,Ganzberger; Geoffrey Michael,8,0,32,24
1657704669726,MATH 142A,A01,083219,Chow; Bennett,7,0,32,25
1657704669726,MATH 142A,A02,083220,Chow; Bennett,10,0,32,22
1657704669726,MATH 142A,A03,093480,Chow; Bennett,9,0,32,23
1657704669726,MATH 142A,B03,093481,Chow; Bennett,8,0,32,24
1657704669726,MATH 142A,B04,093558,Chow; Bennett,13,0,32,19
1657704669726,MATH 142A,B05,093559,Chow; Bennett,6,0,32,26
1657704675755,MATH 193A,A01,083224,Rotar; Vladimir,8,0,34,26
1657704675755,MATH 193A,A02,083225,Rotar; Vladimir,9,0,34,25
1657704675755,MATH 193A,A03,083781,Rotar; Vladimir,5,0,34,29
1657704675755,MATH 193A,A04,083782,Rotar; Vladimir,10,0,34,24
1657704675755,MATH 193A,A05,093482,Rotar; Vladimir,10,0,34,24
1657704681781,MATH 197,001,091859,McAuley; Julian John,9999,0,9999,0
1657704681781,MATH 197,002,095566,Kedlaya; Kiran S.,9997,0,9999,2
1657704681781,MATH 197,003,095567,Xiao; Ming,9999,0,9999,0
1657704681781,MATH 197,004,095571,Perols; Johan Lars,9998,0,9999,1
1657704688860,COGS 9,A01,083615,Shannon; Kyle Michael,9,0,75,66
1657704694893,COGS 11,A01,083617,Boyle; Mary E. T.,23,0,48,25
1657704700917,COGS 13,A01,083071,Bastos; Amalia Pinkusfeld,11,0,71,60
1657704706948,COGS 14A,A01,092681,Semenuks; Arturs,5,1,100,95
1657704712972,COGS 14B,A01,083073,Cheng; Tzu-Han,6,0,63,57
1657704719012,COGS 17,A01,092677,Semenuks; Arturs,6,0,81,75
1657704725046,COGS 100,A01,083619,Allen; Michael Gordon,17,0,70,53
1657704731079,COGS 101A,A01,083621,Davis; Joshua Daniel,9,0,68,59
1657704737105,COGS 101B,A01,091572,Allen; Michael Gordon,12,0,65,53
1657704743133,COGS 101C,A01,083625,Delgado; Tania,17,0,35,18
1657704749159,COGS 107A,A01,083627,Boyle; Mary E. T.,13,0,60,47
1657704755190,COGS 118A,A01,083075,Gupta; Anjum,21,0,76,55
1657704761226,CSE 3,A50,083646,Miranda; Gregory Joseph,24,0,50,26
1657704767259,CSE 8A,A50,083650,Miranda; Gregory Joseph,17,1,56,39
1657704773283,CSE 11,A01,083080,Cao; Yingjun,6,15,40,34
1657704779316,CSE 12,A01,083652,Krause-Levy; Sophia Louisa,28,1,120,92
1657704785348,CSE 15L,A01,083654,Morris; Justin Loren,9,0,50,41
1657704785348,CSE 15L,A02,083655,Morris; Justin Loren,9,0,50,41
1657704791376,CSE 20,A01,083657,Tran; Khoa Dang,39,0,80,41
1657704797405,CSE 21,A01,095574,Bach; Quang Tran,22,0,48,26
1657704803432,CSE 30,A01,083084,Eldon; John,6,0,80,74
1657704803432,CSE 30,B01,095061,Bhaskar; Nishant,9,0,50,41
1657704809461,CSE 100,A01,083659,Cao; Yingjun,5,4,70,65
1657704815486,CSE 134B,A01,083661,Powell; Thomas Allan,23,0,100,77
1657704821511,CSE 140,A01,083663,Gungor; Onat,15,0,85,70
1657704827543,CSE 140L,A01,083088,Eldon; John,23,0,100,77
1657704833574,CSE 175,A01,083665,Kumar; Rakesh,3,0,25,22
1657704839604,CSE 190,A00,092507,Dubnov; Shlomo,8,0,20,12
1657704845632,ECE 45,A01,083139,Congero; Spencer William,6,0,75,69
1657704851664,ECE 65,A50,083695,Saad; Andrew S,12,0,30,18
1657704851664,ECE 65,A51,095125,Saad; Andrew S,24,0,26,2
1657704857693,ECE 109,A01,091882,Touri; Behrouz,20,0,70,50
1657704863722,ECE 180,A00,083140,Abi Samra; Nicholas Camill,1,0,30,29
1657704863722,ECE 180,B00,083141,Abi Samra; Nicholas Camill,0,0,30,30
1657704869756,MATH 10A,A01,083735,Patchell; Gregory David,2,0,30,28
1657704869756,MATH 10A,A02,083736,Patchell; Gregory David,20,0,30,10
1657704869756,MATH 10A,A03,083737,Patchell; Gregory David,16,0,30,14
1657704875784,MATH 10B,A01,083207,Lim; Seonhee,8,0,34,26
1657704875784,MATH 10B,A02,083208,Lim; Seonhee,9,0,35,26
1657704875784,MATH 10B,A03,093472,Lim; Seonhee,7,0,34,27
1657704875784,MATH 10B,B01,083739,Sinha; Shubham,13,0,30,17
1657704881809,MATH 18,A01,083743,Cinel; Cameron Alexander,8,0,30,22
1657704881809,MATH 18,A02,083744,Cinel; Cameron Alexander,17,0,30,13
1657704881809,MATH 18,A03,083745,Cinel; Cameron Alexander,10,0,30,20
1657704881809,MATH 18,B01,083748,Rideout; David Porter,5,0,37,32
1657704881809,MATH 18,B02,083749,Rideout; David Porter,5,0,36,31
1657704881809,MATH 18,B03,083750,Rideout; David Porter,3,0,37,34
1657704881809,MATH 18,B04,083751,Rideout; David Porter,6,0,36,30
1657704881809,MATH 18,B05,093473,Rideout; David Porter,6,0,36,30
1657704881809,MATH 18,B06,093474,Rideout; David Porter,6,0,36,30
1657704887833,MATH 20A,A01,083754,Zheng; Zequn,14,0,40,26
1657704893865,MATH 20B,A01,083756,Briones; Jor-el Thomas Caparas,4,0,36,32
1657704893865,MATH 20B,A02,083757,Briones; Jor-el Thomas Caparas,1,0,36,35
1657704893865,MATH 20B,A03,093475,Briones; Jor-el Thomas Caparas,2,0,36,34
1657704899907,MATH 20C,A01,083760,Briones; Jor-el Thomas Caparas,1,0,35,34
1657704899907,MATH 20C,A02,083761,Briones; Jor-el Thomas Caparas,8,0,35,27
1657704899907,MATH 20C,A03,093476,Briones; Jor-el Thomas Caparas,0,1,36,36
1657704899907,MATH 20C,B01,083762,Bach; Quang Tran,1,0,30,29
1657704905932,MATH 20D,A01,083765,Tran; Brian Kha,5,0,30,25
1657704905932,MATH 20D,A02,083766,Tran; Brian Kha,5,0,30,25
1657704905932,MATH 20D,A03,083767,Tran; Brian Kha,5,0,30,25
1657704911957,MATH 20E,A01,083771,Ganguly; Soumya,9,0,32,23
1657704911957,MATH 20E,A02,083772,Ganguly; Soumya,6,0,32,26
1657704911957,MATH 20E,B01,083773,Ciotti; Benjamin,20,0,35,15
1657704911957,MATH 20E,B02,083774,Ciotti; Benjamin,18,0,35,17
1657704917983,MATH 103A,A01,083777,Greenfeld; Be'Eri,3,0,36,33
1657704917983,MATH 103A,A02,083778,Greenfeld; Be'Eri,5,0,36,31
1657704917983,MATH 103A,A03,093561,Greenfeld; Be'Eri,6,0,36,30
1657704917983,MATH 103A,B01,083779,Greenfeld; Be'Eri,7,0,36,29
1657704917983,MATH 103A,B02,083780,Greenfeld; Be'Eri,4,0,36,32
1657704917983,MATH 103A,B03,093562,Greenfeld; Be'Eri,3,0,36,33
1657704924008,MATH 105,A01,085443,Carter; Anne Toulson,15,0,35,20
1657704924008,MATH 105,A02,093477,Carter; Anne Toulson,20,0,35,15
1657704930033,MATH 109,A01,083213,Ganzberger; Geoffrey Michael,2,0,34,32
1657704930033,MATH 109,A02,083214,Ganzberger; Geoffrey Michael,4,0,34,30
1657704930033,MATH 109,A03,093478,Ganzberger; Geoffrey Michael,2,0,34,32
1657704930033,MATH 109,B01,083215,Ganzberger; Geoffrey Michael,1,0,32,31
1657704930033,MATH 109,B02,083216,Ganzberger; Geoffrey Michael,2,0,32,30
1657704930033,MATH 109,B03,093479,Ganzberger; Geoffrey Michael,8,0,32,24
1657704936060,MATH 142A,A01,083219,Chow; Bennett,7,0,32,25
1657704936060,MATH 142A,A02,083220,Chow; Bennett,10,0,32,22
1657704936060,MATH 142A,A03,093480,Chow; Bennett,9,0,32,23
1657704936060,MATH 142A,B03,093481,Chow; Bennett,8,0,32,24
1657704936060,MATH 142A,B04,093558,Chow; Bennett,13,0,32,19
1657704936060,MATH 142A,B05,093559,Chow; Bennett,6,0,32,26
1657704942091,MATH 193A,A01,083224,Rotar; Vladimir,8,0,34,26
1657704942091,MATH 193A,A02,083225,Rotar; Vladimir,9,0,34,25
1657704942091,MATH 193A,A03,083781,Rotar; Vladimir,5,0,34,29
1657704942091,MATH 193A,A04,083782,Rotar; Vladimir,10,0,34,24
1657704942091,MATH 193A,A05,093482,Rotar; Vladimir,10,0,34,24
1657704948116,MATH 197,001,091859,McAuley; Julian John,9999,0,9999,0
1657704948116,MATH 197,002,095566,Kedlaya; Kiran S.,9997,0,9999,2
1657704948116,MATH 197,003,095567,Xiao; Ming,9999,0,9999,0
1657704948116,MATH 197,004,095571,Perols; Johan Lars,9998,0,9999,1
1657704955188,COGS 9,A01,083615,Shannon; Kyle Michael,9,0,75,66
1657704961211,COGS 11,A01,083617,Boyle; Mary E. T.,23,0,48,25
1657704967236,COGS 13,A01,083071,Bastos; Amalia Pinkusfeld,11,0,71,60
1657704973264,COGS 14A,A01,092681,Semenuks; Arturs,5,1,100,95
1657704979288,COGS 14B,A01,083073,Cheng; Tzu-Han,6,0,63,57
1657704985311,COGS 17,A01,092677,Semenuks; Arturs,6,0,81,75
1657704991336,COGS 100,A01,083619,Allen; Michael Gordon,17,0,70,53
1657704997361,COGS 101A,A01,083621,Davis; Joshua Daniel,9,0,68,59
1657705003391,COGS 101B,A01,091572,Allen; Michael Gordon,12,0,65,53
1657705009416,COGS 101C,A01,083625,Delgado; Tania,17,0,35,18
1657705015443,COGS 107A,A01,083627,Boyle; Mary E. T.,13,0,60,47
1657705021470,COGS 118A,A01,083075,Gupta; Anjum,21,0,76,55
1657705027496,CSE 3,A50,083646,Miranda; Gregory Joseph,24,0,50,26
1657705033522,CSE 8A,A50,083650,Miranda; Gregory Joseph,17,1,56,39
1657705039546,CSE 11,A01,083080,Cao; Yingjun,6,15,40,34
1657705045572,CSE 12,A01,083652,Krause-Levy; Sophia Louisa,28,1,120,92
1657705051598,CSE 15L,A01,083654,Morris; Justin Loren,9,0,50,41
1657705051598,CSE 15L,A02,083655,Morris; Justin Loren,9,0,50,41
1657705057628,CSE 20,A01,083657,Tran; Khoa Dang,39,0,80,41
1657705063651,CSE 21,A01,095574,Bach; Quang Tran,22,0,48,26
1657705069679,CSE 30,A01,083084,Eldon; John,6,0,80,74
1657705069679,CSE 30,B01,095061,Bhaskar; Nishant,9,0,50,41
1657705075707,CSE 100,A01,083659,Cao; Yingjun,5,4,70,65
1657705081730,CSE 134B,A01,083661,Powell; Thomas Allan,23,0,100,77
1657705087753,CSE 140,A01,083663,Gungor; Onat,15,0,85,70
1657705093779,CSE 140L,A01,083088,Eldon; John,23,0,100,77
1657705099806,CSE 175,A01,083665,Kumar; Rakesh,3,0,25,22
1657705105833,CSE 190,A00,092507,Dubnov; Shlomo,8,0,20,12
1657705111856,ECE 45,A01,083139,Congero; Spencer William,6,0,75,69
1657705117897,ECE 65,A50,083695,Saad; Andrew S,12,0,30,18
1657705117897,ECE 65,A51,095125,Saad; Andrew S,24,0,26,2
1657705123921,ECE 109,A01,091882,Touri; Behrouz,20,0,70,50
1657705129946,ECE 180,A00,083140,Abi Samra; Nicholas Camill,1,0,30,29
1657705129946,ECE 180,B00,083141,Abi Samra; Nicholas Camill,0,0,30,30
1657705136050,MATH 10A,A01,083735,Patchell; Gregory David,2,0,30,28
1657705136050,MATH 10A,A02,083736,Patchell; Gregory David,20,0,30,10
1657705136050,MATH 10A,A03,083737,Patchell; Gregory David,16,0,30,14
1657705142085,MATH 10B,A01,083207,Lim; Seonhee,8,0,34,26
1657705142085,MATH 10B,A02,083208,Lim; Seonhee,9,0,35,26
1657705142085,MATH 10B,A03,093472,Lim; Seonhee,7,0,34,27
1657705142085,MATH 10B,B01,083739,Sinha; Shubham,13,0,30,17
1657705148120,MATH 18,A01,083743,Cinel; Cameron Alexander,8,0,30,22
1657705148120,MATH 18,A02,083744,Cinel; Cameron Alexander,17,0,30,13
1657705148120,MATH 18,A03,083745,Cinel; Cameron Alexander,10,0,30,20
1657705148120,MATH 18,B01,083748,Rideout; David Porter,5,0,37,32
1657705148120,MATH 18,B02,083749,Rideout; David Porter,5,0,36,31
1657705148120,MATH 18,B03,083750,Rideout; David Porter,3,0,37,34
1657705148120,MATH 18,B04,083751,Rideout; David Porter,6,0,36,30
1657705148120,MATH 18,B05,093473,Rideout; David Porter,6,0,36,30
1657705148120,MATH 18,B06,093474,Rideout; David Porter,6,0,36,30
1657705154154,MATH 20A,A01,083754,Zheng; Zequn,14,0,40,26
1657705160179,MATH 20B,A01,083756,Briones; Jor-el Thomas Caparas,4,0,36,32
1657705160179,MATH 20B,A02,083757,Briones; Jor-el Thomas Caparas,1,0,36,35
1657705160179,MATH 20B,A03,093475,Briones; Jor-el Thomas Caparas,2,0,36,34
1657705166203,MATH 20C,A01,083760,Briones; Jor-el Thomas Caparas,1,0,35,34
1657705166203,MATH 20C,A02,083761,Briones; Jor-el Thomas Caparas,8,0,35,27
1657705166203,MATH 20C,A03,093476,Briones; Jor-el Thomas Caparas,0,1,36,36
1657705166203,MATH 20C,B01,083762,Bach; Quang Tran,1,0,30,29
1657705172235,MATH 20D,A01,083765,Tran; Brian Kha,5,0,30,25
1657705172235,MATH 20D,A02,083766,Tran; Brian Kha,5,0,30,25
1657705172235,MATH 20D,A03,083767,Tran; Brian Kha,5,0,30,25
1657705178275,MATH 20E,A01,083771,Ganguly; Soumya,9,0,32,23
1657705178275,MATH 20E,A02,083772,Ganguly; Soumya,6,0,32,26
1657705178275,MATH 20E,B01,083773,Ciotti; Benjamin,20,0,35,15
1657705178275,MATH 20E,B02,083774,Ciotti; Benjamin,18,0,35,17
1657705184300,MATH 103A,A01,083777,Greenfeld; Be'Eri,3,0,36,33
1657705184300,MATH 103A,A02,083778,Greenfeld; Be'Eri,5,0,36,31
1657705184300,MATH 103A,A03,093561,Greenfeld; Be'Eri,6,0,36,30
1657705184300,MATH 103A,B01,083779,Greenfeld; Be'Eri,7,0,36,29
1657705184300,MATH 103A,B02,083780,Greenfeld; Be'Eri,4,0,36,32
1657705184300,MATH 103A,B03,093562,Greenfeld; Be'Eri,3,0,36,33
1657705190330,MATH 105,A01,085443,Carter; Anne Toulson,15,0,35,20
1657705190330,MATH 105,A02,093477,Carter; Anne Toulson,20,0,35,15
1657705196363,MATH 109,A01,083213,Ganzberger; Geoffrey Michael,2,0,34,32
1657705196363,MATH 109,A02,083214,Ganzberger; Geoffrey Michael,4,0,34,30
1657705196363,MATH 109,A03,093478,Ganzberger; Geoffrey Michael,2,0,34,32
1657705196363,MATH 109,B01,083215,Ganzberger; Geoffrey Michael,1,0,32,31
1657705196363,MATH 109,B02,083216,Ganzberger; Geoffrey Michael,2,0,32,30
1657705196363,MATH 109,B03,093479,Ganzberger; Geoffrey Michael,8,0,32,24
1657705202393,MATH 142A,A01,083219,Chow; Bennett,7,0,32,25
1657705202393,MATH 142A,A02,083220,Chow; Bennett,10,0,32,22
1657705202393,MATH 142A,A03,093480,Chow; Bennett,9,0,32,23
1657705202393,MATH 142A,B03,093481,Chow; Bennett,8,0,32,24
1657705202393,MATH 142A,B04,093558,Chow; Bennett,13,0,32,19
1657705202393,MATH 142A,B05,093559,Chow; Bennett,6,0,32,26
1657705208416,MATH 193A,A01,083224,Rotar; Vladimir,8,0,34,26
1657705208416,MATH 193A,A02,083225,Rotar; Vladimir,9,0,34,25
1657705208416,MATH 193A,A03,083781,Rotar; Vladimir,5,0,34,29
1657705208416,MATH 193A,A04,083782,Rotar; Vladimir,10,0,34,24
1657705208416,MATH 193A,A05,093482,Rotar; Vladimir,10,0,34,24
1657705214443,MATH 197,001,091859,McAuley; Julian John,9999,0,9999,0
1657705214443,MATH 197,002,095566,Kedlaya; Kiran S.,9997,0,9999,2
1657705214443,MATH 197,003,095567,Xiao; Ming,9999,0,9999,0
1657705214443,MATH 197,004,095571,Perols; Johan Lars,9998,0,9999,1
1657705221504,COGS 9,A01,083615,Shannon; Kyle Michael,9,0,75,66
1657705227539,COGS 11,A01,083617,Boyle; Mary E. T.,23,0,48,25
1657705233571,COGS 13,A01,083071,Bastos; Amalia Pinkusfeld,11,0,71,60
1657705239597,COGS 14A,A01,092681,Semenuks; Arturs,5,1,100,95
1657705245625,COGS 14B,A01,083073,Cheng; Tzu-Han,6,0,63,57
1657705251648,COGS 17,A01,092677,Semenuks; Arturs,6,0,81,75
1657705257677,COGS 100,A01,083619,Allen; Michael Gordon,17,0,70,53
1657705263708,COGS 101A,A01,083621,Davis; Joshua Daniel,9,0,68,59
1657705269736,COGS 101B,A01,091572,Allen; Michael Gordon,12,0,65,53
1657705275766,COGS 101C,A01,083625,Delgado; Tania,17,0,35,18
1657705281789,COGS 107A,A01,083627,Boyle; Mary E. T.,13,0,60,47
1657705287817,COGS 118A,A01,083075,Gupta; Anjum,21,0,76,55
1657705293850,CSE 3,A50,083646,Miranda; Gregory Joseph,24,0,50,26
1657705299874,CSE 8A,A50,083650,Miranda; Gregory Joseph,17,1,56,39
1657705305901,CSE 11,A01,083080,Cao; Yingjun,6,15,40,34
1657705311923,CSE 12,A01,083652,Krause-Levy; Sophia Louisa,28,1,120,92
1657705317960,CSE 15L,A01,083654,Morris; Justin Loren,9,0,50,41
1657705317960,CSE 15L,A02,083655,Morris; Justin Loren,9,0,50,41
1657705323988,CSE 20,A01,083657,Tran; Khoa Dang,39,0,80,41
1657705330013,CSE 21,A01,095574,Bach; Quang Tran,22,0,48,26
1657705336038,CSE 30,A01,083084,Eldon; John,6,0,80,74
1657705336038,CSE 30,B01,095061,Bhaskar; Nishant,9,0,50,41
1657705342065,CSE 100,A01,083659,Cao; Yingjun,5,4,70,65
1657705348090,CSE 134B,A01,083661,Powell; Thomas Allan,23,0,100,77
1657705354114,CSE 140,A01,083663,Gungor; Onat,15,0,85,70
1657705360143,CSE 140L,A01,083088,Eldon; John,23,0,100,77
1657705366172,CSE 175,A01,083665,Kumar; Rakesh,3,0,25,22
1657705372194,CSE 190,A00,092507,Dubnov; Shlomo,8,0,20,12
1657705378225,ECE 45,A01,083139,Congero; Spencer William,6,0,75,69
1657705384255,ECE 65,A50,083695,Saad; Andrew S,12,0,30,18
1657705384255,ECE 65,A51,095125,Saad; Andrew S,24,0,26,2
1657705390278,ECE 109,A01,091882,Touri; Behrouz,20,0,70,50
1657705396307,ECE 180,A00,083140,Abi Samra; Nicholas Camill,1,0,30,29
1657705396307,ECE 180,B00,083141,Abi Samra; Nicholas Camill,0,0,30,30
1657705402337,MATH 10A,A01,083735,Patchell; Gregory David,2,0,30,28
1657705402337,MATH 10A,A02,083736,Patchell; Gregory David,20,0,30,10
1657705402337,MATH 10A,A03,083737,Patchell; Gregory David,16,0,30,14
1657705408368,MATH 10B,A01,083207,Lim; Seonhee,8,0,34,26
1657705408368,MATH 10B,A02,083208,Lim; Seonhee,9,0,35,26
1657705408368,MATH 10B,A03,093472,Lim; Seonhee,7,0,34,27
1657705408368,MATH 10B,B01,083739,Sinha; Shubham,13,0,30,17
1657705414395,MATH 18,A01,083743,Cinel; Cameron Alexander,8,0,30,22
1657705414395,MATH 18,A02,083744,Cinel; Cameron Alexander,17,0,30,13
1657705414395,MATH 18,A03,083745,Cinel; Cameron Alexander,10,0,30,20
1657705414395,MATH 18,B01,083748,Rideout; David Porter,5,0,37,32
1657705414395,MATH 18,B02,083749,Rideout; David Porter,5,0,36,31
1657705414395,MATH 18,B03,083750,Rideout; David Porter,3,0,37,34
1657705414395,MATH 18,B04,083751,Rideout; David Porter,6,0,36,30
1657705414395,MATH 18,B05,093473,Rideout; David Porter,6,0,36,30
1657705414395,MATH 18,B06,093474,Rideout; David Porter,6,0,36,30
1657705420425,MATH 20A,A01,083754,Zheng; Zequn,14,0,40,26
1657705426449,MATH 20B,A01,083756,Briones; Jor-el Thomas Caparas,4,0,36,32
1657705426449,MATH 20B,A02,083757,Briones; Jor-el Thomas Caparas,1,0,36,35
1657705426449,MATH 20B,A03,093475,Briones; Jor-el Thomas Caparas,2,0,36,34
1657705432480,MATH 20C,A01,083760,Briones; Jor-el Thomas Caparas,1,0,35,34
1657705432480,MATH 20C,A02,083761,Briones; Jor-el Thomas Caparas,8,0,35,27
1657705432480,MATH 20C,A03,093476,Briones; Jor-el Thomas Caparas,0,1,36,36
1657705432480,MATH 20C,B01,083762,Bach; Quang Tran,1,0,30,29
1657705438512,MATH 20D,A01,083765,Tran; Brian Kha,5,0,30,25
1657705438512,MATH 20D,A02,083766,Tran; Brian Kha,5,0,30,25
1657705438512,MATH 20D,A03,083767,Tran; Brian Kha,5,0,30,25
1657705444546,MATH 20E,A01,083771,Ganguly; Soumya,9,0,32,23
1657705444546,MATH 20E,A02,083772,Ganguly; Soumya,6,0,32,26
1657705444546,MATH 20E,B01,083773,Ciotti; Benjamin,20,0,35,15
1657705444546,MATH 20E,B02,083774,Ciotti; Benjamin,18,0,35,17
1657705450578,MATH 103A,A01,083777,Greenfeld; Be'Eri,3,0,36,33
1657705450578,MATH 103A,A02,083778,Greenfeld; Be'Eri,5,0,36,31
1657705450578,MATH 103A,A03,093561,Greenfeld; Be'Eri,6,0,36,30
1657705450578,MATH 103A,B01,083779,Greenfeld; Be'Eri,7,0,36,29
1657705450578,MATH 103A,B02,083780,Greenfeld; Be'Eri,4,0,36,32
1657705450578,MATH 103A,B03,093562,Greenfeld; Be'Eri,3,0,36,33
1657705456604,MATH 105,A01,085443,Carter; Anne Toulson,15,0,35,20
1657705456604,MATH 105,A02,093477,Carter; Anne Toulson,20,0,35,15
1657705462642,MATH 109,A01,083213,Ganzberger; Geoffrey Michael,2,0,34,32
1657705462642,MATH 109,A02,083214,Ganzberger; Geoffrey Michael,4,0,34,30
1657705462642,MATH 109,A03,093478,Ganzberger; Geoffrey Michael,2,0,34,32
1657705462642,MATH 109,B01,083215,Ganzberger; Geoffrey Michael,1,0,32,31
1657705462642,MATH 109,B02,083216,Ganzberger; Geoffrey Michael,2,0,32,30
1657705462642,MATH 109,B03,093479,Ganzberger; Geoffrey Michael,8,0,32,24
1657705468680,MATH 142A,A01,083219,Chow; Bennett,7,0,32,25
1657705468680,MATH 142A,A02,083220,Chow; Bennett,10,0,32,22
1657705468680,MATH 142A,A03,093480,Chow; Bennett,9,0,32,23
1657705468680,MATH 142A,B03,093481,Chow; Bennett,8,0,32,24
1657705468680,MATH 142A,B04,093558,Chow; Bennett,13,0,32,19
1657705468680,MATH 142A,B05,093559,Chow; Bennett,6,0,32,26
1657705474705,MATH 193A,A01,083224,Rotar; Vladimir,8,0,34,26
1657705474705,MATH 193A,A02,083225,Rotar; Vladimir,9,0,34,25
1657705474705,MATH 193A,A03,083781,Rotar; Vladimir,5,0,34,29
1657705474705,MATH 193A,A04,083782,Rotar; Vladimir,10,0,34,24
1657705474705,MATH 193A,A05,093482,Rotar; Vladimir,10,0,34,24
1657705480731,MATH 197,001,091859,McAuley; Julian John,9999,0,9999,0
1657705480731,MATH 197,002,095566,Kedlaya; Kiran S.,9997,0,9999,2
1657705480731,MATH 197,003,095567,Xiao; Ming,9999,0,9999,0
1657705480731,MATH 197,004,095571,Perols; Johan Lars,9998,0,9999,1
1657705487814,COGS 9,A01,083615,Shannon; Kyle Michael,9,0,75,66
1657705493843,COGS 11,A01,083617,Boyle; Mary E. T.,23,0,48,25
1657705499875,COGS 13,A01,083071,Bastos; Amalia Pinkusfeld,11,0,71,60
1657705505901,COGS 14A,A01,092681,Semenuks; Arturs,5,1,100,95
1657705511924,COGS 14B,A01,083073,Cheng; Tzu-Han,6,0,63,57
1657705517949,COGS 17,A01,092677,Semenuks; Arturs,6,0,81,75
1657705523976,COGS 100,A01,083619,Allen; Michael Gordon,17,0,70,53
1657705530000,COGS 101A,A01,083621,Davis; Joshua Daniel,9,0,68,59
1657705536024,COGS 101B,A01,091572,Allen; Michael Gordon,12,0,65,53
1657705542048,COGS 101C,A01,083625,Delgado; Tania,17,0,35,18
1657705548072,COGS 107A,A01,083627,Boyle; Mary E. T.,13,0,60,47
1657705554097,COGS 118A,A01,083075,Gupta; Anjum,21,0,76,55
1657705560131,CSE 3,A50,083646,Miranda; Gregory Joseph,24,0,50,26
1657705566161,CSE 8A,A50,083650,Miranda; Gregory Joseph,17,1,56,39
1657705572186,CSE 11,A01,083080,Cao; Yingjun,6,15,40,34
1657705578216,CSE 12,A01,083652,Krause-Levy; Sophia Louisa,28,1,120,92
1657705584241,CSE 15L,A01,083654,Morris; Justin Loren,9,0,50,41
1657705584241,CSE 15L,A02,083655,Morris; Justin Loren,9,0,50,41
1657705590271,CSE 20,A01,083657,Tran; Khoa Dang,39,0,80,41
1657705596302,CSE 21,A01,095574,Bach; Quang Tran,22,0,48,26
1657705602333,CSE 30,A01,083084,Eldon; John,6,0,80,74
1657705602333,CSE 30,B01,095061,Bhaskar; Nishant,9,0,50,41
1657705608359,CSE 100,A01,083659,Cao; Yingjun,5,4,70,65
1657705614384,CSE 134B,A01,083661,Powell; Thomas Allan,23,0,100,77
1657705620414,CSE 140,A01,083663,Gungor; Onat,15,0,85,70
1657705626437,CSE 140L,A01,083088,Eldon; John,23,0,100,77
1657705632462,CSE 175,A01,083665,Kumar; Rakesh,3,0,25,22
1657705638491,CSE 190,A00,092507,Dubnov; Shlomo,8,0,20,12
1657705644519,ECE 45,A01,083139,Congero; Spencer William,6,0,75,69
1657705650546,ECE 65,A50,083695,Saad; Andrew S,12,0,30,18
1657705650546,ECE 65,A51,095125,Saad; Andrew S,24,0,26,2
1657705656571,ECE 109,A01,091882,Touri; Behrouz,20,0,70,50
1657705662614,ECE 180,A00,083140,Abi Samra; Nicholas Camill,1,0,30,29
1657705662614,ECE 180,B00,083141,Abi Samra; Nicholas Camill,0,0,30,30
1657705668649,MATH 10A,A01,083735,Patchell; Gregory David,2,0,30,28
1657705668649,MATH 10A,A02,083736,Patchell; Gregory David,20,0,30,10
1657705668649,MATH 10A,A03,083737,Patchell; Gregory David,16,0,30,14
1657705674680,MATH 10B,A01,083207,Lim; Seonhee,8,0,34,26
1657705674680,MATH 10B,A02,083208,Lim; Seonhee,9,0,35,26
1657705674680,MATH 10B,A03,093472,Lim; Seonhee,7,0,34,27
1657705674680,MATH 10B,B01,083739,Sinha; Shubham,13,0,30,17
1657705680708,MATH 18,A01,083743,Cinel; Cameron Alexander,8,0,30,22
1657705680708,MATH 18,A02,083744,Cinel; Cameron Alexander,17,0,30,13
1657705680708,MATH 18,A03,083745,Cinel; Cameron Alexander,10,0,30,20
1657705680708,MATH 18,B01,083748,Rideout; David Porter,5,0,37,32
1657705680708,MATH 18,B02,083749,Rideout; David Porter,5,0,36,31
1657705680708,MATH 18,B03,083750,Rideout; David Porter,3,0,37,34
1657705680708,MATH 18,B04,083751,Rideout; David Porter,6,0,36,30
1657705680708,MATH 18,B05,093473,Rideout; David Porter,6,0,36,30
1657705680708,MATH 18,B06,093474,Rideout; David Porter,6,0,36,30
1657705686734,MATH 20A,A01,083754,Zheng; Zequn,14,0,40,26
1657705692759,MATH 20B,A01,083756,Briones; Jor-el Thomas Caparas,4,0,36,32
1657705692759,MATH 20B,A02,083757,Briones; Jor-el Thomas Caparas,1,0,36,35
1657705692759,MATH 20B,A03,093475,Briones; Jor-el Thomas Caparas,2,0,36,34
1657705698788,MATH 20C,A01,083760,Briones; Jor-el Thomas Caparas,1,0,35,34
1657705698788,MATH 20C,A02,083761,Briones; Jor-el Thomas Caparas,8,0,35,27
1657705698788,MATH 20C,A03,093476,Briones; Jor-el Thomas Caparas,0,1,36,36
1657705698788,MATH 20C,B01,083762,Bach; Quang Tran,1,0,30,29
1657705704827,MATH 20D,A01,083765,Tran; Brian Kha,5,0,30,25
1657705704827,MATH 20D,A02,083766,Tran; Brian Kha,5,0,30,25
1657705704827,MATH 20D,A03,083767,Tran; Brian Kha,5,0,30,25
1657705710861,MATH 20E,A01,083771,Ganguly; Soumya,9,0,32,23
1657705710861,MATH 20E,A02,083772,Ganguly; Soumya,6,0,32,26
1657705710861,MATH 20E,B01,083773,Ciotti; Benjamin,20,0,35,15
1657705710861,MATH 20E,B02,083774,Ciotti; Benjamin,18,0,35,17
1657705716887,MATH 103A,A01,083777,Greenfeld; Be'Eri,3,0,36,33
1657705716887,MATH 103A,A02,083778,Greenfeld; Be'Eri,5,0,36,31
1657705716887,MATH 103A,A03,093561,Greenfeld; Be'Eri,6,0,36,30
1657705716887,MATH 103A,B01,083779,Greenfeld; Be'Eri,7,0,36,29
1657705716887,MATH 103A,B02,083780,Greenfeld; Be'Eri,4,0,36,32
1657705716887,MATH 103A,B03,093562,Greenfeld; Be'Eri,3,0,36,33
1657705722912,MATH 105,A01,085443,Carter; Anne Toulson,15,0,35,20
1657705722912,MATH 105,A02,093477,Carter; Anne Toulson,20,0,35,15
1657705728940,MATH 109,A01,083213,Ganzberger; Geoffrey Michael,2,0,34,32
1657705728940,MATH 109,A02,083214,Ganzberger; Geoffrey Michael,4,0,34,30
1657705728940,MATH 109,A03,093478,Ganzberger; Geoffrey Michael,2,0,34,32
1657705728940,MATH 109,B01,083215,Ganzberger; Geoffrey Michael,1,0,32,31
1657705728940,MATH 109,B02,083216,Ganzberger; Geoffrey Michael,2,0,32,30
1657705728940,MATH 109,B03,093479,Ganzberger; Geoffrey Michael,8,0,32,24
1657705735050,MATH 142A,A01,083219,Chow; Bennett,7,0,32,25
1657705735050,MATH 142A,A02,083220,Chow; Bennett,10,0,32,22
1657705735050,MATH 142A,A03,093480,Chow; Bennett,9,0,32,23
1657705735050,MATH 142A,B03,093481,Chow; Bennett,8,0,32,24
1657705735050,MATH 142A,B04,093558,Chow; Bennett,13,0,32,19
1657705735050,MATH 142A,B05,093559,Chow; Bennett,6,0,32,26
1657705741092,MATH 193A,A01,083224,Rotar; Vladimir,8,0,34,26
1657705741092,MATH 193A,A02,083225,Rotar; Vladimir,9,0,34,25
1657705741092,MATH 193A,A03,083781,Rotar; Vladimir,5,0,34,29
1657705741092,MATH 193A,A04,083782,Rotar; Vladimir,10,0,34,24
1657705741092,MATH 193A,A05,093482,Rotar; Vladimir,10,0,34,24
1657705747121,MATH 197,001,091859,McAuley; Julian John,9999,0,9999,0
1657705747121,MATH 197,002,095566,Kedlaya; Kiran S.,9997,0,9999,2
1657705747121,MATH 197,003,095567,Xiao; Ming,9999,0,9999,0
1657705747121,MATH 197,004,095571,Perols; Johan Lars,9998,0,9999,1
1657705754200,COGS 9,A01,083615,Shannon; Kyle Michael,9,0,75,66
1657705760226,COGS 11,A01,083617,Boyle; Mary E. T.,23,0,48,25
1657705766250,COGS 13,A01,083071,Bastos; Amalia Pinkusfeld,11,0,71,60
1657705772281,COGS 14A,A01,092681,Semenuks; Arturs,5,1,100,95
1657705778315,COGS 14B,A01,083073,Cheng; Tzu-Han,6,0,63,57
1657705784344,COGS 17,A01,092677,Semenuks; Arturs,6,0,81,75
1657705790396,COGS 100,A01,083619,Allen; Michael Gordon,17,0,70,53
1657705796420,COGS 101A,A01,083621,Davis; Joshua Daniel,9,0,68,59
1657705802445,COGS 101B,A01,091572,Allen; Michael Gordon,12,0,65,53
1657705808475,COGS 101C,A01,083625,Delgado; Tania,17,0,35,18
1657705814499,COGS 107A,A01,083627,Boyle; Mary E. T.,13,0,60,47
1657705820522,COGS 118A,A01,083075,Gupta; Anjum,21,0,76,55
1657705826554,CSE 3,A50,083646,Miranda; Gregory Joseph,24,0,50,26
1657705832578,CSE 8A,A50,083650,Miranda; Gregory Joseph,17,1,56,39
1657705838603,CSE 11,A01,083080,Cao; Yingjun,6,15,40,34
1657705844632,CSE 12,A01,083652,Krause-Levy; Sophia Louisa,28,1,120,92
1657705850658,CSE 15L,A01,083654,Morris; Justin Loren,9,0,50,41
1657705850658,CSE 15L,A02,083655,Morris; Justin Loren,9,0,50,41
1657705856682,CSE 20,A01,083657,Tran; Khoa Dang,39,0,80,41
1657705862706,CSE 21,A01,095574,Bach; Quang Tran,22,0,48,26
1657705868738,CSE 30,A01,083084,Eldon; John,6,0,80,74
1657705868738,CSE 30,B01,095061,Bhaskar; Nishant,9,0,50,41
1657705874765,CSE 100,A01,083659,Cao; Yingjun,5,4,70,65
1657705880788,CSE 134B,A01,083661,Powell; Thomas Allan,23,0,100,77
1657705886816,CSE 140,A01,083663,Gungor; Onat,15,0,85,70
1657705892841,CSE 140L,A01,083088,Eldon; John,23,0,100,77
1657705898866,CSE 175,A01,083665,Kumar; Rakesh,3,0,25,22
1657705904889,CSE 190,A00,092507,Dubnov; Shlomo,8,0,20,12
1657705910914,ECE 45,A01,083139,Congero; Spencer William,6,0,75,69
1657705916938,ECE 65,A50,083695,Saad; Andrew S,12,0,30,18
1657705916938,ECE 65,A51,095125,Saad; Andrew S,24,0,26,2
1657705922984,ECE 109,A01,091882,Touri; Behrouz,20,0,70,50
1657705929007,ECE 180,A00,083140,Abi Samra; Nicholas Camill,1,0,30,29
1657705929007,ECE 180,B00,083141,Abi Samra; Nicholas Camill,0,0,30,30
1657705935032,MATH 10A,A01,083735,Patchell; Gregory David,2,0,30,28
1657705935032,MATH 10A,A02,083736,Patchell; Gregory David,20,0,30,10
1657705935032,MATH 10A,A03,083737,Patchell; Gregory David,16,0,30,14
1657705941057,MATH 10B,A01,083207,Lim; Seonhee,8,0,34,26
1657705941057,MATH 10B,A02,083208,Lim; Seonhee,9,0,35,26
1657705941057,MATH 10B,A03,093472,Lim; Seonhee,7,0,34,27
1657705941057,MATH 10B,B01,083739,Sinha; Shubham,13,0,30,17
1657705947082,MATH 18,A01,083743,Cinel; Cameron Alexander,8,0,30,22
1657705947082,MATH 18,A02,083744,Cinel; Cameron Alexander,17,0,30,13
1657705947082,MATH 18,A03,083745,Cinel; Cameron Alexander,10,0,30,20
1657705947082,MATH 18,B01,083748,Rideout; David Porter,5,0,37,32
1657705947082,MATH 18,B02,083749,Rideout; David Porter,5,0,36,31
1657705947082,MATH 18,B03,083750,Rideout; David Porter,3,0,37,34
1657705947082,MATH 18,B04,083751,Rideout; David Porter,6,0,36,30
1657705947082,MATH 18,B05,093473,Rideout; David Porter,6,0,36,30
1657705947082,MATH 18,B06,093474,Rideout; David Porter,6,0,36,30
1657705953106,MATH 20A,A01,083754,Zheng; Zequn,14,0,40,26
1657705959129,MATH 20B,A01,083756,Briones; Jor-el Thomas Caparas,4,0,36,32
1657705959129,MATH 20B,A02,083757,Briones; Jor-el Thomas Caparas,1,0,36,35
1657705959129,MATH 20B,A03,093475,Briones; Jor-el Thomas Caparas,2,0,36,34
1657705965177,MATH 20C,A01,083760,Briones; Jor-el Thomas Caparas,1,0,35,34
1657705965177,MATH 20C,A02,083761,Briones; Jor-el Thomas Caparas,8,0,35,27
1657705965177,MATH 20C,A03,093476,Briones; Jor-el Thomas Caparas,0,1,36,36
1657705965177,MATH 20C,B01,083762,Bach; Quang Tran,1,0,30,29
1657705971202,MATH 20D,A01,083765,Tran; Brian Kha,5,0,30,25
1657705971202,MATH 20D,A02,083766,Tran; Brian Kha,5,0,30,25
1657705971202,MATH 20D,A03,083767,Tran; Brian Kha,5,0,30,25
1657705977226,MATH 20E,A01,083771,Ganguly; Soumya,9,0,32,23
1657705977226,MATH 20E,A02,083772,Ganguly; Soumya,6,0,32,26
1657705977226,MATH 20E,B01,083773,Ciotti; Benjamin,20,0,35,15
1657705977226,MATH 20E,B02,083774,Ciotti; Benjamin,18,0,35,17
1657705983257,MATH 103A,A01,083777,Greenfeld; Be'Eri,3,0,36,33
1657705983257,MATH 103A,A02,083778,Greenfeld; Be'Eri,5,0,36,31
1657705983257,MATH 103A,A03,093561,Greenfeld; Be'Eri,6,0,36,30
1657705983257,MATH 103A,B01,083779,Greenfeld; Be'Eri,7,0,36,29
1657705983257,MATH 103A,B02,083780,Greenfeld; Be'Eri,4,0,36,32
1657705983257,MATH 103A,B03,093562,Greenfeld; Be'Eri,3,0,36,33
1657705989282,MATH 105,A01,085443,Carter; Anne Toulson,15,0,35,20
1657705989282,MATH 105,A02,093477,Carter; Anne Toulson,20,0,35,15
1657705995311,MATH 109,A01,083213,Ganzberger; Geoffrey Michael,2,0,34,32
1657705995311,MATH 109,A02,083214,Ganzberger; Geoffrey Michael,4,0,34,30
1657705995311,MATH 109,A03,093478,Ganzberger; Geoffrey Michael,2,0,34,32
1657705995311,MATH 109,B01,083215,Ganzberger; Geoffrey Michael,1,0,32,31
1657705995311,MATH 109,B02,083216,Ganzberger; Geoffrey Michael,2,0,32,30
1657705995311,MATH 109,B03,093479,Ganzberger; Geoffrey Michael,8,0,32,24
1657706001341,MATH 142A,A01,083219,Chow; Bennett,7,0,32,25
1657706001341,MATH 142A,A02,083220,Chow; Bennett,10,0,32,22
1657706001341,MATH 142A,A03,093480,Chow; Bennett,9,0,32,23
1657706001341,MATH 142A,B03,093481,Chow; Bennett,8,0,32,24
1657706001341,MATH 142A,B04,093558,Chow; Bennett,13,0,32,19
1657706001341,MATH 142A,B05,093559,Chow; Bennett,6,0,32,26
1657706007364,MATH 193A,A01,083224,Rotar; Vladimir,8,0,34,26
1657706007364,MATH 193A,A02,083225,Rotar; Vladimir,9,0,34,25
1657706007364,MATH 193A,A03,083781,Rotar; Vladimir,5,0,34,29
1657706007364,MATH 193A,A04,083782,Rotar; Vladimir,10,0,34,24
1657706007364,MATH 193A,A05,093482,Rotar; Vladimir,10,0,34,24
1657706013390,MATH 197,001,091859,McAuley; Julian John,9999,0,9999,0
1657706013390,MATH 197,002,095566,Kedlaya; Kiran S.,9997,0,9999,2
1657706013390,MATH 197,003,095567,Xiao; Ming,9999,0,9999,0
1657706013390,MATH 197,004,095571,Perols; Johan Lars,9998,0,9999,1
1657706020446,COGS 9,A01,083615,Shannon; Kyle Michael,9,0,75,66
1657706026473,COGS 11,A01,083617,Boyle; Mary E. T.,23,0,48,25
1657706032497,COGS 13,A01,083071,Bastos; Amalia Pinkusfeld,11,0,71,60
1657706038523,COGS 14A,A01,092681,Semenuks; Arturs,5,1,100,95
1657706044555,COGS 14B,A01,083073,Cheng; Tzu-Han,6,0,63,57
1657706050587,COGS 17,A01,092677,Semenuks; Arturs,6,0,81,75
1657706056610,COGS 100,A01,083619,Allen; Michael Gordon,17,0,70,53
1657706062634,COGS 101A,A01,083621,Davis; Joshua Daniel,9,0,68,59
1657706068661,COGS 101B,A01,091572,Allen; Michael Gordon,12,0,65,53
1657706074683,COGS 101C,A01,083625,Delgado; Tania,17,0,35,18
1657706080707,COGS 107A,A01,083627,Boyle; Mary E. T.,13,0,60,47
1657706086734,COGS 118A,A01,083075,Gupta; Anjum,21,0,76,55
1657706092763,CSE 3,A50,083646,Miranda; Gregory Joseph,24,0,50,26
1657706098789,CSE 8A,A50,083650,Miranda; Gregory Joseph,17,1,56,39
1657706104812,CSE 11,A01,083080,Cao; Yingjun,6,15,40,34
1657706110835,CSE 12,A01,083652,Krause-Levy; Sophia Louisa,28,1,120,92
1657706116863,CSE 15L,A01,083654,Morris; Justin Loren,9,0,50,41
1657706116863,CSE 15L,A02,083655,Morris; Justin Loren,9,0,50,41
1657706122886,CSE 20,A01,083657,Tran; Khoa Dang,39,0,80,41
1657706128910,CSE 21,A01,095574,Bach; Quang Tran,22,0,48,26
1657706134934,CSE 30,A01,083084,Eldon; John,6,0,80,74
1657706134934,CSE 30,B01,095061,Bhaskar; Nishant,9,0,50,41
1657706140970,CSE 100,A01,083659,Cao; Yingjun,5,4,70,65
1657706146994,CSE 134B,A01,083661,Powell; Thomas Allan,23,0,100,77
1657706153017,CSE 140,A01,083663,Gungor; Onat,15,0,85,70
1657706159046,CSE 140L,A01,083088,Eldon; John,23,0,100,77
1657706165068,CSE 175,A01,083665,Kumar; Rakesh,3,0,25,22
1657706171096,CSE 190,A00,092507,Dubnov; Shlomo,8,0,20,12
1657706177131,ECE 45,A01,083139,Congero; Spencer William,6,0,75,69
1657706183164,ECE 65,A50,083695,Saad; Andrew S,12,0,30,18
1657706183164,ECE 65,A51,095125,Saad; Andrew S,24,0,26,2
1657706189188,ECE 109,A01,091882,Touri; Behrouz,20,0,70,50
1657706195212,ECE 180,A00,083140,Abi Samra; Nicholas Camill,1,0,30,29
1657706195212,ECE 180,B00,083141,Abi Samra; Nicholas Camill,0,0,30,30
1657706201238,MATH 10A,A01,083735,Patchell; Gregory David,2,0,30,28
1657706201238,MATH 10A,A02,083736,Patchell; Gregory David,20,0,30,10
1657706201238,MATH 10A,A03,083737,Patchell; Gregory David,16,0,30,14
1657706207272,MATH 10B,A01,083207,Lim; Seonhee,8,0,34,26
1657706207272,MATH 10B,A02,083208,Lim; Seonhee,9,0,35,26
1657706207272,MATH 10B,A03,093472,Lim; Seonhee,7,0,34,27
1657706207272,MATH 10B,B01,083739,Sinha; Shubham,13,0,30,17
1657706213298,MATH 18,A01,083743,Cinel; Cameron Alexander,8,0,30,22
1657706213298,MATH 18,A02,083744,Cinel; Cameron Alexander,17,0,30,13
1657706213298,MATH 18,A03,083745,Cinel; Cameron Alexander,10,0,30,20
1657706213298,MATH 18,B01,083748,Rideout; David Porter,5,0,37,32
1657706213298,MATH 18,B02,083749,Rideout; David Porter,5,0,36,31
1657706213298,MATH 18,B03,083750,Rideout; David Porter,3,0,37,34
1657706213298,MATH 18,B04,083751,Rideout; David Porter,6,0,36,30
1657706213298,MATH 18,B05,093473,Rideout; David Porter,6,0,36,30
1657706213298,MATH 18,B06,093474,Rideout; David Porter,6,0,36,30
1657706219322,MATH 20A,A01,083754,Zheng; Zequn,14,0,40,26
1657706225352,MATH 20B,A01,083756,Briones; Jor-el Thomas Caparas,4,0,36,32
1657706225352,MATH 20B,A02,083757,Briones; Jor-el Thomas Caparas,1,0,36,35
1657706225352,MATH 20B,A03,093475,Briones; Jor-el Thomas Caparas,2,0,36,34
1657706231375,MATH 20C,A01,083760,Briones; Jor-el Thomas Caparas,1,0,35,34
1657706231375,MATH 20C,A02,083761,Briones; Jor-el Thomas Caparas,8,0,35,27
1657706231375,MATH 20C,A03,093476,Briones; Jor-el Thomas Caparas,0,1,36,36
1657706231375,MATH 20C,B01,083762,Bach; Quang Tran,1,0,30,29
1657706237399,MATH 20D,A01,083765,Tran; Brian Kha,5,0,30,25
1657706237399,MATH 20D,A02,083766,Tran; Brian Kha,5,0,30,25
1657706237399,MATH 20D,A03,083767,Tran; Brian Kha,5,0,30,25
1657706243425,MATH 20E,A01,083771,Ganguly; Soumya,9,0,32,23
1657706243425,MATH 20E,A02,083772,Ganguly; Soumya,6,0,32,26
1657706243425,MATH 20E,B01,083773,Ciotti; Benjamin,20,0,35,15
1657706243425,MATH 20E,B02,083774,Ciotti; Benjamin,18,0,35,17
1657706249458,MATH 103A,A01,083777,Greenfeld; Be'Eri,3,0,36,33
1657706249458,MATH 103A,A02,083778,Greenfeld; Be'Eri,5,0,36,31
1657706249458,MATH 103A,A03,093561,Greenfeld; Be'Eri,6,0,36,30
1657706249458,MATH 103A,B01,083779,Greenfeld; Be'Eri,7,0,36,29
1657706249458,MATH 103A,B02,083780,Greenfeld; Be'Eri,4,0,36,32
1657706249458,MATH 103A,B03,093562,Greenfeld; Be'Eri,3,0,36,33
1657706255486,MATH 105,A01,085443,Carter; Anne Toulson,15,0,35,20
1657706255486,MATH 105,A02,093477,Carter; Anne Toulson,20,0,35,15
1657706261511,MATH 109,A01,083213,Ganzberger; Geoffrey Michael,2,0,34,32
1657706261511,MATH 109,A02,083214,Ganzberger; Geoffrey Michael,4,0,34,30
1657706261511,MATH 109,A03,093478,Ganzberger; Geoffrey Michael,2,0,34,32
1657706261511,MATH 109,B01,083215,Ganzberger; Geoffrey Michael,1,0,32,31
1657706261511,MATH 109,B02,083216,Ganzberger; Geoffrey Michael,2,0,32,30
1657706261511,MATH 109,B03,093479,Ganzberger; Geoffrey Michael,8,0,32,24
1657706267537,MATH 142A,A01,083219,Chow; Bennett,7,0,32,25
1657706267537,MATH 142A,A02,083220,Chow; Bennett,10,0,32,22
1657706267537,MATH 142A,A03,093480,Chow; Bennett,9,0,32,23
1657706267537,MATH 142A,B03,093481,Chow; Bennett,8,0,32,24
1657706267537,MATH 142A,B04,093558,Chow; Bennett,13,0,32,19
1657706267537,MATH 142A,B05,093559,Chow; Bennett,6,0,32,26
1657706273567,MATH 193A,A01,083224,Rotar; Vladimir,8,0,34,26
1657706273567,MATH 193A,A02,083225,Rotar; Vladimir,9,0,34,25
1657706273567,MATH 193A,A03,083781,Rotar; Vladimir,5,0,34,29
1657706273567,MATH 193A,A04,083782,Rotar; Vladimir,10,0,34,24
1657706273567,MATH 193A,A05,093482,Rotar; Vladimir,10,0,34,24
1657706279591,MATH 197,001,091859,McAuley; Julian John,9999,0,9999,0
1657706279591,MATH 197,002,095566,Kedlaya; Kiran S.,9997,0,9999,2
1657706279591,MATH 197,003,095567,Xiao; Ming,9999,0,9999,0
1657706279591,MATH 197,004,095571,Perols; Johan Lars,9998,0,9999,1
1657706286653,COGS 9,A01,083615,Shannon; Kyle Michael,9,0,75,66
1657706292677,COGS 11,A01,083617,Boyle; Mary E. T.,23,0,48,25
1657706298705,COGS 13,A01,083071,Bastos; Amalia Pinkusfeld,11,0,71,60
1657706304732,COGS 14A,A01,092681,Semenuks; Arturs,5,1,100,95
1657706310757,COGS 14B,A01,083073,Cheng; Tzu-Han,6,0,63,57
1657706316779,COGS 17,A01,092677,Semenuks; Arturs,6,0,81,75
1657706322803,COGS 100,A01,083619,Allen; Michael Gordon,17,0,70,53
1657706328934,COGS 101A,A01,083621,Davis; Joshua Daniel,9,0,68,59
1657706334957,COGS 101B,A01,091572,Allen; Michael Gordon,12,0,65,53
1657706340979,COGS 101C,A01,083625,Delgado; Tania,17,0,35,18
1657706347015,COGS 107A,A01,083627,Boyle; Mary E. T.,13,0,60,47
1657706353037,COGS 118A,A01,083075,Gupta; Anjum,21,0,76,55
1657706359066,CSE 3,A50,083646,Miranda; Gregory Joseph,24,0,50,26
1657706365094,CSE 8A,A50,083650,Miranda; Gregory Joseph,17,1,56,39
1657706371122,CSE 11,A01,083080,Cao; Yingjun,6,15,40,34
1657706377144,CSE 12,A01,083652,Krause-Levy; Sophia Louisa,28,1,120,92
1657706383167,CSE 15L,A01,083654,Morris; Justin Loren,9,0,50,41
1657706383167,CSE 15L,A02,083655,Morris; Justin Loren,9,0,50,41
1657706389191,CSE 20,A01,083657,Tran; Khoa Dang,39,0,80,41
1657706395214,CSE 21,A01,095574,Bach; Quang Tran,22,0,48,26
1657706401243,CSE 30,A01,083084,Eldon; John,6,0,80,74
1657706401243,CSE 30,B01,095061,Bhaskar; Nishant,9,0,50,41
1657706407273,CSE 100,A01,083659,Cao; Yingjun,5,4,70,65
1657706413297,CSE 134B,A01,083661,Powell; Thomas Allan,23,0,100,77
1657706419323,CSE 140,A01,083663,Gungor; Onat,15,0,85,70
1657706425346,CSE 140L,A01,083088,Eldon; John,23,0,100,77
1657706431369,CSE 175,A01,083665,Kumar; Rakesh,3,0,25,22
1657706437392,CSE 190,A00,092507,Dubnov; Shlomo,8,0,20,12
1657706443416,ECE 45,A01,083139,Congero; Spencer William,6,0,75,69
1657706449457,ECE 65,A50,083695,Saad; Andrew S,12,0,30,18
1657706449457,ECE 65,A51,095125,Saad; Andrew S,24,0,26,2
1657706455481,ECE 109,A01,091882,Touri; Behrouz,20,0,70,50
1657706461503,ECE 180,A00,083140,Abi Samra; Nicholas Camill,1,0,30,29
1657706461503,ECE 180,B00,083141,Abi Samra; Nicholas Camill,0,0,30,30
1657706467530,MATH 10A,A01,083735,Patchell; Gregory David,2,0,30,28
1657706467530,MATH 10A,A02,083736,Patchell; Gregory David,20,0,30,10
1657706467530,MATH 10A,A03,083737,Patchell; Gregory David,16,0,30,14
1657706473561,MATH 10B,A01,083207,Lim; Seonhee,8,0,34,26
1657706473561,MATH 10B,A02,083208,Lim; Seonhee,9,0,35,26
1657706473561,MATH 10B,A03,093472,Lim; Seonhee,7,0,34,27
1657706473561,MATH 10B,B01,083739,Sinha; Shubham,13,0,30,17
1657706479594,MATH 18,A01,083743,Cinel; Cameron Alexander,8,0,30,22
1657706479594,MATH 18,A02,083744,Cinel; Cameron Alexander,17,0,30,13
1657706479594,MATH 18,A03,083745,Cinel; Cameron Alexander,10,0,30,20
1657706479594,MATH 18,B01,083748,Rideout; David Porter,5,0,37,32
1657706479594,MATH 18,B02,083749,Rideout; David Porter,5,0,36,31
1657706479594,MATH 18,B03,083750,Rideout; David Porter,3,0,37,34
1657706479594,MATH 18,B04,083751,Rideout; David Porter,6,0,36,30
1657706479594,MATH 18,B05,093473,Rideout; David Porter,6,0,36,30
1657706479594,MATH 18,B06,093474,Rideout; David Porter,6,0,36,30
1657706485620,MATH 20A,A01,083754,Zheng; Zequn,14,0,40,26
1657706491648,MATH 20B,A01,083756,Briones; Jor-el Thomas Caparas,4,0,36,32
1657706491648,MATH 20B,A02,083757,Briones; Jor-el Thomas Caparas,1,0,36,35
1657706491648,MATH 20B,A03,093475,Briones; Jor-el Thomas Caparas,2,0,36,34
1657706497670,MATH 20C,A01,083760,Briones; Jor-el Thomas Caparas,1,0,35,34
1657706497670,MATH 20C,A02,083761,Briones; Jor-el Thomas Caparas,8,0,35,27
1657706497670,MATH 20C,A03,093476,Briones; Jor-el Thomas Caparas,0,1,36,36
1657706497670,MATH 20C,B01,083762,Bach; Quang Tran,1,0,30,29
1657706503698,MATH 20D,A01,083765,Tran; Brian Kha,5,0,30,25
1657706503698,MATH 20D,A02,083766,Tran; Brian Kha,5,0,30,25
1657706503698,MATH 20D,A03,083767,Tran; Brian Kha,5,0,30,25
1657706509721,MATH 20E,A01,083771,Ganguly; Soumya,9,0,32,23
1657706509721,MATH 20E,A02,083772,Ganguly; Soumya,6,0,32,26
1657706509721,MATH 20E,B01,083773,Ciotti; Benjamin,20,0,35,15
1657706509721,MATH 20E,B02,083774,Ciotti; Benjamin,18,0,35,17
1657706515752,MATH 103A,A01,083777,Greenfeld; Be'Eri,3,0,36,33
1657706515752,MATH 103A,A02,083778,Greenfeld; Be'Eri,5,0,36,31
1657706515752,MATH 103A,A03,093561,Greenfeld; Be'Eri,6,0,36,30
1657706515752,MATH 103A,B01,083779,Greenfeld; Be'Eri,7,0,36,29
1657706515752,MATH 103A,B02,083780,Greenfeld; Be'Eri,4,0,36,32
1657706515752,MATH 103A,B03,093562,Greenfeld; Be'Eri,3,0,36,33
1657706521787,MATH 105,A01,085443,Carter; Anne Toulson,15,0,35,20
1657706521787,MATH 105,A02,093477,Carter; Anne Toulson,20,0,35,15
1657706527810,MATH 109,A01,083213,Ganzberger; Geoffrey Michael,2,0,34,32
1657706527810,MATH 109,A02,083214,Ganzberger; Geoffrey Michael,4,0,34,30
1657706527810,MATH 109,A03,093478,Ganzberger; Geoffrey Michael,2,0,34,32
1657706527810,MATH 109,B01,083215,Ganzberger; Geoffrey Michael,1,0,32,31
1657706527810,MATH 109,B02,083216,Ganzberger; Geoffrey Michael,2,0,32,30
1657706527810,MATH 109,B03,093479,Ganzberger; Geoffrey Michael,8,0,32,24
1657706533841,MATH 142A,A01,083219,Chow; Bennett,7,0,32,25
1657706533841,MATH 142A,A02,083220,Chow; Bennett,10,0,32,22
1657706533841,MATH 142A,A03,093480,Chow; Bennett,9,0,32,23
1657706533841,MATH 142A,B03,093481,Chow; Bennett,8,0,32,24
1657706533841,MATH 142A,B04,093558,Chow; Bennett,13,0,32,19
1657706533841,MATH 142A,B05,093559,Chow; Bennett,6,0,32,26
1657706539865,MATH 193A,A01,083224,Rotar; Vladimir,8,0,34,26
1657706539865,MATH 193A,A02,083225,Rotar; Vladimir,9,0,34,25
1657706539865,MATH 193A,A03,083781,Rotar; Vladimir,5,0,34,29
1657706539865,MATH 193A,A04,083782,Rotar; Vladimir,10,0,34,24
1657706539865,MATH 193A,A05,093482,Rotar; Vladimir,10,0,34,24
1657706545889,MATH 197,001,091859,McAuley; Julian John,9999,0,9999,0
1657706545889,MATH 197,002,095566,Kedlaya; Kiran S.,9997,0,9999,2
1657706545889,MATH 197,003,095567,Xiao; Ming,9999,0,9999,0
1657706545889,MATH 197,004,095571,Perols; Johan Lars,9998,0,9999,1
1657706552948,COGS 9,A01,083615,Shannon; Kyle Michael,9,0,75,66
1657706558972,COGS 11,A01,083617,Boyle; Mary E. T.,23,0,48,25
1657706565000,COGS 13,A01,083071,Bastos; Amalia Pinkusfeld,11,0,71,60
1657706571037,COGS 14A,A01,092681,Semenuks; Arturs,5,1,100,95
1657706577063,COGS 14B,A01,083073,Cheng; Tzu-Han,6,0,63,57
1657706583092,COGS 17,A01,092677,Semenuks; Arturs,6,0,81,75
1657706589119,COGS 100,A01,083619,Allen; Michael Gordon,17,0,70,53
1657706595145,COGS 101A,A01,083621,Davis; Joshua Daniel,9,0,68,59
1657706601172,COGS 101B,A01,091572,Allen; Michael Gordon,12,0,65,53
1657706607200,COGS 101C,A01,083625,Delgado; Tania,17,0,35,18
1657706613226,COGS 107A,A01,083627,Boyle; Mary E. T.,13,0,60,47
1657706619254,COGS 118A,A01,083075,Gupta; Anjum,21,0,76,55
1657706625287,CSE 3,A50,083646,Miranda; Gregory Joseph,24,0,50,26
1657706631314,CSE 8A,A50,083650,Miranda; Gregory Joseph,17,1,56,39
1657706637343,CSE 11,A01,083080,Cao; Yingjun,6,15,40,34
1657706643370,CSE 12,A01,083652,Krause-Levy; Sophia Louisa,28,1,120,92
1657706649394,CSE 15L,A01,083654,Morris; Justin Loren,9,0,50,41
1657706649394,CSE 15L,A02,083655,Morris; Justin Loren,9,0,50,41
1657706655417,CSE 20,A01,083657,Tran; Khoa Dang,39,0,80,41
1657706661444,CSE 21,A01,095574,Bach; Quang Tran,22,0,48,26
1657706667471,CSE 30,A01,083084,Eldon; John,6,0,80,74
1657706667471,CSE 30,B01,095061,Bhaskar; Nishant,9,0,50,41
1657706673497,CSE 100,A01,083659,Cao; Yingjun,5,4,70,65
1657706679520,CSE 134B,A01,083661,Powell; Thomas Allan,23,0,100,77
1657706685555,CSE 140,A01,083663,Gungor; Onat,15,0,85,70
1657706691578,CSE 140L,A01,083088,Eldon; John,23,0,100,77
1657706697602,CSE 175,A01,083665,Kumar; Rakesh,3,0,25,22
1657706703624,CSE 190,A00,092507,Dubnov; Shlomo,8,0,20,12
1657706709653,ECE 45,A01,083139,Congero; Spencer William,6,0,75,69
1657706715678,ECE 65,A50,083695,Saad; Andrew S,12,0,30,18
1657706715678,ECE 65,A51,095125,Saad; Andrew S,24,0,26,2
1657706721703,ECE 109,A01,091882,Touri; Behrouz,20,0,70,50
1657706727733,ECE 180,A00,083140,Abi Samra; Nicholas Camill,1,0,30,29
1657706727733,ECE 180,B00,083141,Abi Samra; Nicholas Camill,0,0,30,30
1657706733757,MATH 10A,A01,083735,Patchell; Gregory David,2,0,30,28
1657706733757,MATH 10A,A02,083736,Patchell; Gregory David,20,0,30,10
1657706733757,MATH 10A,A03,083737,Patchell; Gregory David,16,0,30,14
1657706739792,MATH 10B,A01,083207,Lim; Seonhee,8,0,34,26
1657706739792,MATH 10B,A02,083208,Lim; Seonhee,9,0,35,26
1657706739792,MATH 10B,A03,093472,Lim; Seonhee,7,0,34,27
1657706739792,MATH 10B,B01,083739,Sinha; Shubham,13,0,30,17
1657706745818,MATH 18,A01,083743,Cinel; Cameron Alexander,8,0,30,22
1657706745818,MATH 18,A02,083744,Cinel; Cameron Alexander,17,0,30,13
1657706745818,MATH 18,A03,083745,Cinel; Cameron Alexander,10,0,30,20
1657706745818,MATH 18,B01,083748,Rideout; David Porter,5,0,37,32
1657706745818,MATH 18,B02,083749,Rideout; David Porter,5,0,36,31
1657706745818,MATH 18,B03,083750,Rideout; David Porter,3,0,37,34
1657706745818,MATH 18,B04,083751,Rideout; David Porter,6,0,36,30
1657706745818,MATH 18,B05,093473,Rideout; David Porter,6,0,36,30
1657706745818,MATH 18,B06,093474,Rideout; David Porter,6,0,36,30
1657706751846,MATH 20A,A01,083754,Zheng; Zequn,14,0,40,26
1657706757871,MATH 20B,A01,083756,Briones; Jor-el Thomas Caparas,4,0,36,32
1657706757871,MATH 20B,A02,083757,Briones; Jor-el Thomas Caparas,1,0,36,35
1657706757871,MATH 20B,A03,093475,Briones; Jor-el Thomas Caparas,2,0,36,34
1657706763894,MATH 20C,A01,083760,Briones; Jor-el Thomas Caparas,1,0,35,34
1657706763894,MATH 20C,A02,083761,Briones; Jor-el Thomas Caparas,8,0,35,27
1657706763894,MATH 20C,A03,093476,Briones; Jor-el Thomas Caparas,0,1,36,36
1657706763894,MATH 20C,B01,083762,Bach; Quang Tran,1,0,30,29
1657706769925,MATH 20D,A01,083765,Tran; Brian Kha,5,0,30,25
1657706769925,MATH 20D,A02,083766,Tran; Brian Kha,5,0,30,25
1657706769925,MATH 20D,A03,083767,Tran; Brian Kha,5,0,30,25
1657706775953,MATH 20E,A01,083771,Ganguly; Soumya,9,0,32,23
1657706775953,MATH 20E,A02,083772,Ganguly; Soumya,6,0,32,26
1657706775953,MATH 20E,B01,083773,Ciotti; Benjamin,20,0,35,15
1657706775953,MATH 20E,B02,083774,Ciotti; Benjamin,18,0,35,17
1657706781984,MATH 103A,A01,083777,Greenfeld; Be'Eri,3,0,36,33
1657706781984,MATH 103A,A02,083778,Greenfeld; Be'Eri,5,0,36,31
1657706781984,MATH 103A,A03,093561,Greenfeld; Be'Eri,6,0,36,30
1657706781984,MATH 103A,B01,083779,Greenfeld; Be'Eri,7,0,36,29
1657706781984,MATH 103A,B02,083780,Greenfeld; Be'Eri,4,0,36,32
1657706781984,MATH 103A,B03,093562,Greenfeld; Be'Eri,3,0,36,33
1657706788019,MATH 105,A01,085443,Carter; Anne Toulson,15,0,35,20
1657706788019,MATH 105,A02,093477,Carter; Anne Toulson,20,0,35,15
1657706794042,MATH 109,A01,083213,Ganzberger; Geoffrey Michael,2,0,34,32
1657706794042,MATH 109,A02,083214,Ganzberger; Geoffrey Michael,4,0,34,30
1657706794042,MATH 109,A03,093478,Ganzberger; Geoffrey Michael,2,0,34,32
1657706794042,MATH 109,B01,083215,Ganzberger; Geoffrey Michael,1,0,32,31
1657706794042,MATH 109,B02,083216,Ganzberger; Geoffrey Michael,2,0,32,30
1657706794042,MATH 109,B03,093479,Ganzberger; Geoffrey Michael,8,0,32,24
1657706800070,MATH 142A,A01,083219,Chow; Bennett,7,0,32,25
1657706800070,MATH 142A,A02,083220,Chow; Bennett,10,0,32,22
1657706800070,MATH 142A,A03,093480,Chow; Bennett,9,0,32,23
1657706800070,MATH 142A,B03,093481,Chow; Bennett,8,0,32,24
1657706800070,MATH 142A,B04,093558,Chow; Bennett,13,0,32,19
1657706800070,MATH 142A,B05,093559,Chow; Bennett,6,0,32,26
1657706806096,MATH 193A,A01,083224,Rotar; Vladimir,8,0,34,26
1657706806096,MATH 193A,A02,083225,Rotar; Vladimir,9,0,34,25
1657706806096,MATH 193A,A03,083781,Rotar; Vladimir,5,0,34,29
1657706806096,MATH 193A,A04,083782,Rotar; Vladimir,10,0,34,24
1657706806096,MATH 193A,A05,093482,Rotar; Vladimir,10,0,34,24
1657706812120,MATH 197,001,091859,McAuley; Julian John,9999,0,9999,0
1657706812120,MATH 197,002,095566,Kedlaya; Kiran S.,9997,0,9999,2
1657706812120,MATH 197,003,095567,Xiao; Ming,9999,0,9999,0
1657706812120,MATH 197,004,095571,Perols; Johan Lars,9998,0,9999,1
1657706819197,COGS 9,A01,083615,Shannon; Kyle Michael,9,0,75,66
1657706825221,COGS 11,A01,083617,Boyle; Mary E. T.,23,0,48,25
1657706831249,COGS 13,A01,083071,Bastos; Amalia Pinkusfeld,11,0,71,60
1657706837273,COGS 14A,A01,092681,Semenuks; Arturs,5,1,100,95
1657706843297,COGS 14B,A01,083073,Cheng; Tzu-Han,6,0,63,57
1657706849328,COGS 17,A01,092677,Semenuks; Arturs,6,0,81,75
1657706855359,COGS 100,A01,083619,Allen; Michael Gordon,17,0,70,53
1657706861384,COGS 101A,A01,083621,Davis; Joshua Daniel,9,0,68,59
1657706867413,COGS 101B,A01,091572,Allen; Michael Gordon,12,0,65,53
1657706873438,COGS 101C,A01,083625,Delgado; Tania,17,0,35,18
1657706879464,COGS 107A,A01,083627,Boyle; Mary E. T.,13,0,60,47
1657706885488,COGS 118A,A01,083075,Gupta; Anjum,21,0,76,55
1657706891512,CSE 3,A50,083646,Miranda; Gregory Joseph,24,0,50,26
1657706897539,CSE 8A,A50,083650,Miranda; Gregory Joseph,17,1,56,39
1657706903565,CSE 11,A01,083080,Cao; Yingjun,6,15,40,34
1657706909596,CSE 12,A01,083652,Krause-Levy; Sophia Louisa,28,1,120,92
1657706915621,CSE 15L,A01,083654,Morris; Justin Loren,9,0,50,41
1657706915621,CSE 15L,A02,083655,Morris; Justin Loren,9,0,50,41
1657706921648,CSE 20,A01,083657,Tran; Khoa Dang,39,0,80,41
1657706927747,CSE 21,A01,095574,Bach; Quang Tran,22,0,48,26
1657706933774,CSE 30,A01,083084,Eldon; John,6,0,80,74
1657706933774,CSE 30,B01,095061,Bhaskar; Nishant,9,0,50,41
1657706939798,CSE 100,A01,083659,Cao; Yingjun,5,4,70,65
1657706945821,CSE 134B,A01,083661,Powell; Thomas Allan,23,0,100,77
1657706951849,CSE 140,A01,083663,Gungor; Onat,15,0,85,70
1657706957872,CSE 140L,A01,083088,Eldon; John,23,0,100,77
1657706963898,CSE 175,A01,083665,Kumar; Rakesh,3,0,25,22
1657706969922,CSE 190,A00,092507,Dubnov; Shlomo,8,0,20,12
1657706975962,ECE 45,A01,083139,Congero; Spencer William,6,0,75,69
1657706981991,ECE 65,A50,083695,Saad; Andrew S,12,0,30,18
1657706981991,ECE 65,A51,095125,Saad; Andrew S,24,0,26,2
1657706988013,ECE 109,A01,091882,Touri; Behrouz,20,0,70,50
1657706994040,ECE 180,A00,083140,Abi Samra; Nicholas Camill,1,0,30,29
1657706994040,ECE 180,B00,083141,Abi Samra; Nicholas Camill,0,0,30,30
1657707000067,MATH 10A,A01,083735,Patchell; Gregory David,2,0,30,28
1657707000067,MATH 10A,A02,083736,Patchell; Gregory David,20,0,30,10
1657707000067,MATH 10A,A03,083737,Patchell; Gregory David,16,0,30,14
1657707006092,MATH 10B,A01,083207,Lim; Seonhee,8,0,34,26
1657707006092,MATH 10B,A02,083208,Lim; Seonhee,9,0,35,26
1657707006092,MATH 10B,A03,093472,Lim; Seonhee,7,0,34,27
1657707006092,MATH 10B,B01,083739,Sinha; Shubham,13,0,30,17
1657707012118,MATH 18,A01,083743,Cinel; Cameron Alexander,8,0,30,22
1657707012118,MATH 18,A02,083744,Cinel; Cameron Alexander,17,0,30,13
1657707012118,MATH 18,A03,083745,Cinel; Cameron Alexander,10,0,30,20
1657707012118,MATH 18,B01,083748,Rideout; David Porter,5,0,37,32
1657707012118,MATH 18,B02,083749,Rideout; David Porter,5,0,36,31
1657707012118,MATH 18,B03,083750,Rideout; David Porter,3,0,37,34
1657707012118,MATH 18,B04,083751,Rideout; David Porter,6,0,36,30
1657707012118,MATH 18,B05,093473,Rideout; David Porter,6,0,36,30
1657707012118,MATH 18,B06,093474,Rideout; David Porter,6,0,36,30
1657707018144,MATH 20A,A01,083754,Zheng; Zequn,14,0,40,26
1657707024168,MATH 20B,A01,083756,Briones; Jor-el Thomas Caparas,4,0,36,32
1657707024168,MATH 20B,A02,083757,Briones; Jor-el Thomas Caparas,1,0,36,35
1657707024168,MATH 20B,A03,093475,Briones; Jor-el Thomas Caparas,2,0,36,34
1657707030192,MATH 20C,A01,083760,Briones; Jor-el Thomas Caparas,1,0,35,34
1657707030192,MATH 20C,A02,083761,Briones; Jor-el Thomas Caparas,8,0,35,27
1657707030192,MATH 20C,A03,093476,Briones; Jor-el Thomas Caparas,0,1,36,36
1657707030192,MATH 20C,B01,083762,Bach; Quang Tran,1,0,30,29
1657707036217,MATH 20D,A01,083765,Tran; Brian Kha,5,0,30,25
1657707036217,MATH 20D,A02,083766,Tran; Brian Kha,5,0,30,25
1657707036217,MATH 20D,A03,083767,Tran; Brian Kha,5,0,30,25
1657707042242,MATH 20E,A01,083771,Ganguly; Soumya,9,0,32,23
1657707042242,MATH 20E,A02,083772,Ganguly; Soumya,6,0,32,26
1657707042242,MATH 20E,B01,083773,Ciotti; Benjamin,20,0,35,15
1657707042242,MATH 20E,B02,083774,Ciotti; Benjamin,18,0,35,17
1657707048273,MATH 103A,A01,083777,Greenfeld; Be'Eri,3,0,36,33
1657707048273,MATH 103A,A02,083778,Greenfeld; Be'Eri,5,0,36,31
1657707048273,MATH 103A,A03,093561,Greenfeld; Be'Eri,6,0,36,30
1657707048273,MATH 103A,B01,083779,Greenfeld; Be'Eri,7,0,36,29
1657707048273,MATH 103A,B02,083780,Greenfeld; Be'Eri,4,0,36,32
1657707048273,MATH 103A,B03,093562,Greenfeld; Be'Eri,3,0,36,33
1657707054305,MATH 105,A01,085443,Carter; Anne Toulson,15,0,35,20
1657707054305,MATH 105,A02,093477,Carter; Anne Toulson,20,0,35,15
1657707060335,MATH 109,A01,083213,Ganzberger; Geoffrey Michael,2,0,34,32
1657707060335,MATH 109,A02,083214,Ganzberger; Geoffrey Michael,4,0,34,30
1657707060335,MATH 109,A03,093478,Ganzberger; Geoffrey Michael,2,0,34,32
1657707060335,MATH 109,B01,083215,Ganzberger; Geoffrey Michael,1,0,32,31
1657707060335,MATH 109,B02,083216,Ganzberger; Geoffrey Michael,2,0,32,30
1657707060335,MATH 109,B03,093479,Ganzberger; Geoffrey Michael,8,0,32,24
1657707066358,MATH 142A,A01,083219,Chow; Bennett,7,0,32,25
1657707066358,MATH 142A,A02,083220,Chow; Bennett,10,0,32,22
1657707066358,MATH 142A,A03,093480,Chow; Bennett,9,0,32,23
1657707066358,MATH 142A,B03,093481,Chow; Bennett,8,0,32,24
1657707066358,MATH 142A,B04,093558,Chow; Bennett,13,0,32,19
1657707066358,MATH 142A,B05,093559,Chow; Bennett,6,0,32,26
1657707072388,MATH 193A,A01,083224,Rotar; Vladimir,8,0,34,26
1657707072388,MATH 193A,A02,083225,Rotar; Vladimir,9,0,34,25
1657707072388,MATH 193A,A03,083781,Rotar; Vladimir,5,0,34,29
1657707072388,MATH 193A,A04,083782,Rotar; Vladimir,10,0,34,24
1657707072388,MATH 193A,A05,093482,Rotar; Vladimir,10,0,34,24
1657707078416,MATH 197,001,091859,McAuley; Julian John,9999,0,9999,0
1657707078416,MATH 197,002,095566,Kedlaya; Kiran S.,9997,0,9999,2
1657707078416,MATH 197,003,095567,Xiao; Ming,9999,0,9999,0
1657707078416,MATH 197,004,095571,Perols; Johan Lars,9998,0,9999,1
1657707085485,COGS 9,A01,083615,Shannon; Kyle Michael,9,0,75,66
1657707091507,COGS 11,A01,083617,Boyle; Mary E. T.,23,0,48,25
1657707097531,COGS 13,A01,083071,Bastos; Amalia Pinkusfeld,11,0,71,60
1657707103556,COGS 14A,A01,092681,Semenuks; Arturs,5,1,100,95
1657707109581,COGS 14B,A01,083073,Cheng; Tzu-Han,6,0,63,57
1657707115606,COGS 17,A01,092677,Semenuks; Arturs,6,0,81,75
1657707121632,COGS 100,A01,083619,Allen; Michael Gordon,17,0,70,53
1657707127654,COGS 101A,A01,083621,Davis; Joshua Daniel,9,0,68,59
1657707133677,COGS 101B,A01,091572,Allen; Michael Gordon,12,0,65,53
1657707139703,COGS 101C,A01,083625,Delgado; Tania,17,0,35,18
1657707145728,COGS 107A,A01,083627,Boyle; Mary E. T.,13,0,60,47
1657707151754,COGS 118A,A01,083075,Gupta; Anjum,21,0,76,55
1657707157782,CSE 3,A50,083646,Miranda; Gregory Joseph,24,0,50,26
1657707163815,CSE 8A,A50,083650,Miranda; Gregory Joseph,17,1,56,39
1657707169839,CSE 11,A01,083080,Cao; Yingjun,6,15,40,34
1657707175867,CSE 12,A01,083652,Krause-Levy; Sophia Louisa,28,1,120,92
1657707181903,CSE 15L,A01,083654,Morris; Justin Loren,9,0,50,41
1657707181903,CSE 15L,A02,083655,Morris; Justin Loren,9,0,50,41
1657707187930,CSE 20,A01,083657,Tran; Khoa Dang,39,0,80,41
1657707193958,CSE 21,A01,095574,Bach; Quang Tran,22,0,48,26
1657707199981,CSE 30,A01,083084,Eldon; John,6,0,80,74
1657707199981,CSE 30,B01,095061,Bhaskar; Nishant,9,0,50,41
1657707206003,CSE 100,A01,083659,Cao; Yingjun,5,4,70,65
1657707212026,CSE 134B,A01,083661,Powell; Thomas Allan,23,0,100,77
1657707218048,CSE 140,A01,083663,Gungor; Onat,15,0,85,70
1657707224070,CSE 140L,A01,083088,Eldon; John,23,0,100,77
1657707230093,CSE 175,A01,083665,Kumar; Rakesh,3,0,25,22
1657707236117,CSE 190,A00,092507,Dubnov; Shlomo,8,0,20,12
1657707242144,ECE 45,A01,083139,Congero; Spencer William,6,0,75,69
1657707248171,ECE 65,A50,083695,Saad; Andrew S,12,0,30,18
1657707248171,ECE 65,A51,095125,Saad; Andrew S,24,0,26,2
1657707254194,ECE 109,A01,091882,Touri; Behrouz,20,0,70,50
1657707260221,ECE 180,A00,083140,Abi Samra; Nicholas Camill,1,0,30,29
1657707260221,ECE 180,B00,083141,Abi Samra; Nicholas Camill,0,0,30,30
1657707266246,MATH 10A,A01,083735,Patchell; Gregory David,2,0,30,28
1657707266246,MATH 10A,A02,083736,Patchell; Gregory David,20,0,30,10
1657707266246,MATH 10A,A03,083737,Patchell; Gregory David,16,0,30,14
1657707272282,MATH 10B,A01,083207,Lim; Seonhee,8,0,34,26
1657707272282,MATH 10B,A02,083208,Lim; Seonhee,9,0,35,26
1657707272282,MATH 10B,A03,093472,Lim; Seonhee,7,0,34,27
1657707272282,MATH 10B,B01,083739,Sinha; Shubham,13,0,30,17
1657707278319,MATH 18,A01,083743,Cinel; Cameron Alexander,8,0,30,22
1657707278319,MATH 18,A02,083744,Cinel; Cameron Alexander,17,0,30,13
1657707278319,MATH 18,A03,083745,Cinel; Cameron Alexander,10,0,30,20
1657707278319,MATH 18,B01,083748,Rideout; David Porter,5,0,37,32
1657707278319,MATH 18,B02,083749,Rideout; David Porter,5,0,36,31
1657707278319,MATH 18,B03,083750,Rideout; David Porter,3,0,37,34
1657707278319,MATH 18,B04,083751,Rideout; David Porter,6,0,36,30
1657707278319,MATH 18,B05,093473,Rideout; David Porter,6,0,36,30
1657707278319,MATH 18,B06,093474,Rideout; David Porter,6,0,36,30
1657707284342,MATH 20A,A01,083754,Zheng; Zequn,14,0,40,26
1657707290370,MATH 20B,A01,083756,Briones; Jor-el Thomas Caparas,4,0,36,32
1657707290370,MATH 20B,A02,083757,Briones; Jor-el Thomas Caparas,1,0,36,35
1657707290370,MATH 20B,A03,093475,Briones; Jor-el Thomas Caparas,2,0,36,34
1657707296394,MATH 20C,A01,083760,Briones; Jor-el Thomas Caparas,1,0,35,34
1657707296394,MATH 20C,A02,083761,Briones; Jor-el Thomas Caparas,8,0,35,27
1657707296394,MATH 20C,A03,093476,Briones; Jor-el Thomas Caparas,0,1,36,36
1657707296394,MATH 20C,B01,083762,Bach; Quang Tran,1,0,30,29
1657707302418,MATH 20D,A01,083765,Tran; Brian Kha,5,0,30,25
1657707302418,MATH 20D,A02,083766,Tran; Brian Kha,5,0,30,25
1657707302418,MATH 20D,A03,083767,Tran; Brian Kha,5,0,30,25
1657707308447,MATH 20E,A01,083771,Ganguly; Soumya,9,0,32,23
1657707308447,MATH 20E,A02,083772,Ganguly; Soumya,6,0,32,26
1657707308447,MATH 20E,B01,083773,Ciotti; Benjamin,20,0,35,15
1657707308447,MATH 20E,B02,083774,Ciotti; Benjamin,18,0,35,17
1657707314471,MATH 103A,A01,083777,Greenfeld; Be'Eri,3,0,36,33
1657707314471,MATH 103A,A02,083778,Greenfeld; Be'Eri,5,0,36,31
1657707314471,MATH 103A,A03,093561,Greenfeld; Be'Eri,6,0,36,30
1657707314471,MATH 103A,B01,083779,Greenfeld; Be'Eri,7,0,36,29
1657707314471,MATH 103A,B02,083780,Greenfeld; Be'Eri,4,0,36,32
1657707314471,MATH 103A,B03,093562,Greenfeld; Be'Eri,3,0,36,33
1657707320494,MATH 105,A01,085443,Carter; Anne Toulson,15,0,35,20
1657707320494,MATH 105,A02,093477,Carter; Anne Toulson,20,0,35,15
1657707326517,MATH 109,A01,083213,Ganzberger; Geoffrey Michael,2,0,34,32
1657707326517,MATH 109,A02,083214,Ganzberger; Geoffrey Michael,4,0,34,30
1657707326517,MATH 109,A03,093478,Ganzberger; Geoffrey Michael,2,0,34,32
1657707326517,MATH 109,B01,083215,Ganzberger; Geoffrey Michael,1,0,32,31
1657707326517,MATH 109,B02,083216,Ganzberger; Geoffrey Michael,2,0,32,30
1657707326517,MATH 109,B03,093479,Ganzberger; Geoffrey Michael,8,0,32,24
1657707332550,MATH 142A,A01,083219,Chow; Bennett,7,0,32,25
1657707332550,MATH 142A,A02,083220,Chow; Bennett,10,0,32,22
1657707332550,MATH 142A,A03,093480,Chow; Bennett,9,0,32,23
1657707332550,MATH 142A,B03,093481,Chow; Bennett,8,0,32,24
1657707332550,MATH 142A,B04,093558,Chow; Bennett,13,0,32,19
1657707332550,MATH 142A,B05,093559,Chow; Bennett,6,0,32,26
1657707338576,MATH 193A,A01,083224,Rotar; Vladimir,8,0,34,26
1657707338576,MATH 193A,A02,083225,Rotar; Vladimir,9,0,34,25
1657707338576,MATH 193A,A03,083781,Rotar; Vladimir,5,0,34,29
1657707338576,MATH 193A,A04,083782,Rotar; Vladimir,10,0,34,24
1657707338576,MATH 193A,A05,093482,Rotar; Vladimir,10,0,34,24
1657707344600,MATH 197,001,091859,McAuley; Julian John,9999,0,9999,0
1657707344600,MATH 197,002,095566,Kedlaya; Kiran S.,9997,0,9999,2
1657707344600,MATH 197,003,095567,Xiao; Ming,9999,0,9999,0
1657707344600,MATH 197,004,095571,Perols; Johan Lars,9998,0,9999,1
1657707351666,COGS 9,A01,083615,Shannon; Kyle Michael,9,0,75,66
1657707357689,COGS 11,A01,083617,Boyle; Mary E. T.,23,0,48,25
1657707363717,COGS 13,A01,083071,Bastos; Amalia Pinkusfeld,11,0,71,60
1657707369752,COGS 14A,A01,092681,Semenuks; Arturs,5,1,100,95
1657707375777,COGS 14B,A01,083073,Cheng; Tzu-Han,6,0,63,57
1657707381800,COGS 17,A01,092677,Semenuks; Arturs,6,0,81,75
1657707387825,COGS 100,A01,083619,Allen; Michael Gordon,17,0,70,53
1657707393852,COGS 101A,A01,083621,Davis; Joshua Daniel,9,0,68,59
1657707399874,COGS 101B,A01,091572,Allen; Michael Gordon,12,0,65,53
1657707405900,COGS 101C,A01,083625,Delgado; Tania,17,0,35,18
1657707411924,COGS 107A,A01,083627,Boyle; Mary E. T.,13,0,60,47
1657707417947,COGS 118A,A01,083075,Gupta; Anjum,21,0,76,55
1657707423970,CSE 3,A50,083646,Miranda; Gregory Joseph,24,0,50,26
1657707429993,CSE 8A,A50,083650,Miranda; Gregory Joseph,17,1,56,39
1657707436016,CSE 11,A01,083080,Cao; Yingjun,6,15,40,34
1657707442039,CSE 12,A01,083652,Krause-Levy; Sophia Louisa,28,1,120,92
1657707448067,CSE 15L,A01,083654,Morris; Justin Loren,9,0,50,41
1657707448067,CSE 15L,A02,083655,Morris; Justin Loren,9,0,50,41
1657707454090,CSE 20,A01,083657,Tran; Khoa Dang,39,0,80,41
1657707460115,CSE 21,A01,095574,Bach; Quang Tran,22,0,48,26
1657707466144,CSE 30,A01,083084,Eldon; John,6,0,80,74
1657707466144,CSE 30,B01,095061,Bhaskar; Nishant,9,0,50,41
1657707472167,CSE 100,A01,083659,Cao; Yingjun,5,4,70,65
1657707478197,CSE 134B,A01,083661,Powell; Thomas Allan,23,0,100,77
1657707484220,CSE 140,A01,083663,Gungor; Onat,15,0,85,70
1657707490245,CSE 140L,A01,083088,Eldon; John,23,0,100,77
1657707496266,CSE 175,A01,083665,Kumar; Rakesh,3,0,25,22
1657707502292,CSE 190,A00,092507,Dubnov; Shlomo,8,0,20,12
1657707508316,ECE 45,A01,083139,Congero; Spencer William,6,0,75,69
1657707514339,ECE 65,A50,083695,Saad; Andrew S,12,0,30,18
1657707514339,ECE 65,A51,095125,Saad; Andrew S,24,0,26,2
1657707520366,ECE 109,A01,091882,Touri; Behrouz,20,0,70,50
1657707526465,ECE 180,A00,083140,Abi Samra; Nicholas Camill,1,0,30,29
1657707526465,ECE 180,B00,083141,Abi Samra; Nicholas Camill,0,0,30,30
1657707532488,MATH 10A,A01,083735,Patchell; Gregory David,2,0,30,28
1657707532488,MATH 10A,A02,083736,Patchell; Gregory David,20,0,30,10
1657707532488,MATH 10A,A03,083737,Patchell; Gregory David,16,0,30,14
1657707538512,MATH 10B,A01,083207,Lim; Seonhee,8,0,34,26
1657707538512,MATH 10B,A02,083208,Lim; Seonhee,9,0,35,26
1657707538512,MATH 10B,A03,093472,Lim; Seonhee,7,0,34,27
1657707538512,MATH 10B,B01,083739,Sinha; Shubham,13,0,30,17
1657707544540,MATH 18,A01,083743,Cinel; Cameron Alexander,8,0,30,22
1657707544540,MATH 18,A02,083744,Cinel; Cameron Alexander,17,0,30,13
1657707544540,MATH 18,A03,083745,Cinel; Cameron Alexander,10,0,30,20
1657707544540,MATH 18,B01,083748,Rideout; David Porter,5,0,37,32
1657707544540,MATH 18,B02,083749,Rideout; David Porter,5,0,36,31
1657707544540,MATH 18,B03,083750,Rideout; David Porter,3,0,37,34
1657707544540,MATH 18,B04,083751,Rideout; David Porter,6,0,36,30
1657707544540,MATH 18,B05,093473,Rideout; David Porter,6,0,36,30
1657707544540,MATH 18,B06,093474,Rideout; David Porter,6,0,36,30
1657707550563,MATH 20A,A01,083754,Zheng; Zequn,14,0,40,26
1657707556591,MATH 20B,A01,083756,Briones; Jor-el Thomas Caparas,4,0,36,32
1657707556591,MATH 20B,A02,083757,Briones; Jor-el Thomas Caparas,1,0,36,35
1657707556591,MATH 20B,A03,093475,Briones; Jor-el Thomas Caparas,2,0,36,34
1657707562619,MATH 20C,A01,083760,Briones; Jor-el Thomas Caparas,1,0,35,34
1657707562619,MATH 20C,A02,083761,Briones; Jor-el Thomas Caparas,8,0,35,27
1657707562619,MATH 20C,A03,093476,Briones; Jor-el Thomas Caparas,0,1,36,36
1657707562619,MATH 20C,B01,083762,Bach; Quang Tran,1,0,30,29
1657707568645,MATH 20D,A01,083765,Tran; Brian Kha,5,0,30,25
1657707568645,MATH 20D,A02,083766,Tran; Brian Kha,5,0,30,25
1657707568645,MATH 20D,A03,083767,Tran; Brian Kha,5,0,30,25
1657707574673,MATH 20E,A01,083771,Ganguly; Soumya,9,0,32,23
1657707574673,MATH 20E,A02,083772,Ganguly; Soumya,6,0,32,26
1657707574673,MATH 20E,B01,083773,Ciotti; Benjamin,20,0,35,15
1657707574673,MATH 20E,B02,083774,Ciotti; Benjamin,18,0,35,17
1657707580704,MATH 103A,A01,083777,Greenfeld; Be'Eri,3,0,36,33
1657707580704,MATH 103A,A02,083778,Greenfeld; Be'Eri,5,0,36,31
1657707580704,MATH 103A,A03,093561,Greenfeld; Be'Eri,6,0,36,30
1657707580704,MATH 103A,B01,083779,Greenfeld; Be'Eri,7,0,36,29
1657707580704,MATH 103A,B02,083780,Greenfeld; Be'Eri,4,0,36,32
1657707580704,MATH 103A,B03,093562,Greenfeld; Be'Eri,3,0,36,33
1657707586726,MATH 105,A01,085443,Carter; Anne Toulson,15,0,35,20
1657707586726,MATH 105,A02,093477,Carter; Anne Toulson,20,0,35,15
1657707592750,MATH 109,A01,083213,Ganzberger; Geoffrey Michael,2,0,34,32
1657707592750,MATH 109,A02,083214,Ganzberger; Geoffrey Michael,4,0,34,30
1657707592750,MATH 109,A03,093478,Ganzberger; Geoffrey Michael,2,0,34,32
1657707592750,MATH 109,B01,083215,Ganzberger; Geoffrey Michael,1,0,32,31
1657707592750,MATH 109,B02,083216,Ganzberger; Geoffrey Michael,2,0,32,30
1657707592750,MATH 109,B03,093479,Ganzberger; Geoffrey Michael,8,0,32,24
1657707598772,MATH 142A,A01,083219,Chow; Bennett,7,0,32,25
1657707598772,MATH 142A,A02,083220,Chow; Bennett,10,0,32,22
1657707598772,MATH 142A,A03,093480,Chow; Bennett,9,0,32,23
1657707598772,MATH 142A,B03,093481,Chow; Bennett,8,0,32,24
1657707598772,MATH 142A,B04,093558,Chow; Bennett,13,0,32,19
1657707598772,MATH 142A,B05,093559,Chow; Bennett,6,0,32,26
1657707604795,MATH 193A,A01,083224,Rotar; Vladimir,8,0,34,26
1657707604795,MATH 193A,A02,083225,Rotar; Vladimir,9,0,34,25
1657707604795,MATH 193A,A03,083781,Rotar; Vladimir,5,0,34,29
1657707604795,MATH 193A,A04,083782,Rotar; Vladimir,10,0,34,24
1657707604795,MATH 193A,A05,093482,Rotar; Vladimir,10,0,34,24
1657707610818,MATH 197,001,091859,McAuley; Julian John,9999,0,9999,0
1657707610818,MATH 197,002,095566,Kedlaya; Kiran S.,9997,0,9999,2
1657707610818,MATH 197,003,095567,Xiao; Ming,9999,0,9999,0
1657707610818,MATH 197,004,095571,Perols; Johan Lars,9998,0,9999,1
1657707617887,COGS 9,A01,083615,Shannon; Kyle Michael,9,0,75,66
1657707623909,COGS 11,A01,083617,Boyle; Mary E. T.,23,0,48,25
1657707629936,COGS 13,A01,083071,Bastos; Amalia Pinkusfeld,11,0,71,60
1657707635965,COGS 14A,A01,092681,Semenuks; Arturs,5,1,100,95
1657707641987,COGS 14B,A01,083073,Cheng; Tzu-Han,6,0,63,57
1657707648011,COGS 17,A01,092677,Semenuks; Arturs,6,0,81,75
1657707654033,COGS 100,A01,083619,Allen; Michael Gordon,17,0,70,53
1657707660060,COGS 101A,A01,083621,Davis; Joshua Daniel,9,0,68,59
1657707666083,COGS 101B,A01,091572,Allen; Michael Gordon,12,0,65,53
1657707672107,COGS 101C,A01,083625,Delgado; Tania,17,0,35,18
1657707678131,COGS 107A,A01,083627,Boyle; Mary E. T.,13,0,60,47
1657707684154,COGS 118A,A01,083075,Gupta; Anjum,21,0,76,55
1657707690179,CSE 3,A50,083646,Miranda; Gregory Joseph,24,0,50,26
1657707696206,CSE 8A,A50,083650,Miranda; Gregory Joseph,17,1,56,39
1657707702234,CSE 11,A01,083080,Cao; Yingjun,6,15,40,34
1657707708262,CSE 12,A01,083652,Krause-Levy; Sophia Louisa,28,1,120,92
1657707714286,CSE 15L,A01,083654,Morris; Justin Loren,9,0,50,41
1657707714286,CSE 15L,A02,083655,Morris; Justin Loren,9,0,50,41
1657707720319,CSE 20,A01,083657,Tran; Khoa Dang,39,0,80,41
1657707726340,CSE 21,A01,095574,Bach; Quang Tran,22,0,48,26
1657707732368,CSE 30,A01,083084,Eldon; John,6,0,80,74
1657707732368,CSE 30,B01,095061,Bhaskar; Nishant,9,0,50,41
1657707738392,CSE 100,A01,083659,Cao; Yingjun,5,4,70,65
1657707744415,CSE 134B,A01,083661,Powell; Thomas Allan,23,0,100,77
1657707750438,CSE 140,A01,083663,Gungor; Onat,15,0,85,70
1657707756465,CSE 140L,A01,083088,Eldon; John,23,0,100,77
1657707762488,CSE 175,A01,083665,Kumar; Rakesh,3,0,25,22
1657707768511,CSE 190,A00,092507,Dubnov; Shlomo,8,0,20,12
1657707774536,ECE 45,A01,083139,Congero; Spencer William,6,0,75,69
1657707780562,ECE 65,A50,083695,Saad; Andrew S,12,0,30,18
1657707780562,ECE 65,A51,095125,Saad; Andrew S,24,0,26,2
1657707786589,ECE 109,A01,091882,Touri; Behrouz,20,0,70,50
1657707792619,ECE 180,A00,083140,Abi Samra; Nicholas Camill,1,0,30,29
1657707792619,ECE 180,B00,083141,Abi Samra; Nicholas Camill,0,0,30,30
1657707798647,MATH 10A,A01,083735,Patchell; Gregory David,2,0,30,28
1657707798647,MATH 10A,A02,083736,Patchell; Gregory David,20,0,30,10
1657707798647,MATH 10A,A03,083737,Patchell; Gregory David,16,0,30,14
1657707804682,MATH 10B,A01,083207,Lim; Seonhee,8,0,34,26
1657707804682,MATH 10B,A02,083208,Lim; Seonhee,9,0,35,26
1657707804682,MATH 10B,A03,093472,Lim; Seonhee,7,0,34,27
1657707804682,MATH 10B,B01,083739,Sinha; Shubham,13,0,30,17
1657707810722,MATH 18,A01,083743,Cinel; Cameron Alexander,8,0,30,22
1657707810722,MATH 18,A02,083744,Cinel; Cameron Alexander,17,0,30,13
1657707810722,MATH 18,A03,083745,Cinel; Cameron Alexander,10,0,30,20
1657707810722,MATH 18,B01,083748,Rideout; David Porter,5,0,37,32
1657707810722,MATH 18,B02,083749,Rideout; David Porter,5,0,36,31
1657707810722,MATH 18,B03,083750,Rideout; David Porter,3,0,37,34
1657707810722,MATH 18,B04,083751,Rideout; David Porter,6,0,36,30
1657707810722,MATH 18,B05,093473,Rideout; David Porter,6,0,36,30
1657707810722,MATH 18,B06,093474,Rideout; David Porter,6,0,36,30
1657707816751,MATH 20A,A01,083754,Zheng; Zequn,14,0,40,26
1657707822817,MATH 20B,A01,083756,Briones; Jor-el Thomas Caparas,4,0,36,32
1657707822817,MATH 20B,A02,083757,Briones; Jor-el Thomas Caparas,1,0,36,35
1657707822817,MATH 20B,A03,093475,Briones; Jor-el Thomas Caparas,2,0,36,34
1657707828840,MATH 20C,A01,083760,Briones; Jor-el Thomas Caparas,1,0,35,34
1657707828840,MATH 20C,A02,083761,Briones; Jor-el Thomas Caparas,8,0,35,27
1657707828840,MATH 20C,A03,093476,Briones; Jor-el Thomas Caparas,0,1,36,36
1657707828840,MATH 20C,B01,083762,Bach; Quang Tran,1,0,30,29
1657707834869,MATH 20D,A01,083765,Tran; Brian Kha,5,0,30,25
1657707834869,MATH 20D,A02,083766,Tran; Brian Kha,5,0,30,25
1657707834869,MATH 20D,A03,083767,Tran; Brian Kha,5,0,30,25
1657707840897,MATH 20E,A01,083771,Ganguly; Soumya,9,0,32,23
1657707840897,MATH 20E,A02,083772,Ganguly; Soumya,6,0,32,26
1657707840897,MATH 20E,B01,083773,Ciotti; Benjamin,20,0,35,15
1657707840897,MATH 20E,B02,083774,Ciotti; Benjamin,18,0,35,17
1657707846925,MATH 103A,A01,083777,Greenfeld; Be'Eri,3,0,36,33
1657707846925,MATH 103A,A02,083778,Greenfeld; Be'Eri,5,0,36,31
1657707846925,MATH 103A,A03,093561,Greenfeld; Be'Eri,6,0,36,30
1657707846925,MATH 103A,B01,083779,Greenfeld; Be'Eri,7,0,36,29
1657707846925,MATH 103A,B02,083780,Greenfeld; Be'Eri,4,0,36,32
1657707846925,MATH 103A,B03,093562,Greenfeld; Be'Eri,3,0,36,33
1657707852949,MATH 105,A01,085443,Carter; Anne Toulson,15,0,35,20
1657707852949,MATH 105,A02,093477,Carter; Anne Toulson,20,0,35,15
1657707858972,MATH 109,A01,083213,Ganzberger; Geoffrey Michael,2,0,34,32
1657707858972,MATH 109,A02,083214,Ganzberger; Geoffrey Michael,4,0,34,30
1657707858972,MATH 109,A03,093478,Ganzberger; Geoffrey Michael,2,0,34,32
1657707858972,MATH 109,B01,083215,Ganzberger; Geoffrey Michael,1,0,32,31
1657707858972,MATH 109,B02,083216,Ganzberger; Geoffrey Michael,2,0,32,30
1657707858972,MATH 109,B03,093479,Ganzberger; Geoffrey Michael,8,0,32,24
1657707865001,MATH 142A,A01,083219,Chow; Bennett,7,0,32,25
1657707865001,MATH 142A,A02,083220,Chow; Bennett,10,0,32,22
1657707865001,MATH 142A,A03,093480,Chow; Bennett,9,0,32,23
1657707865001,MATH 142A,B03,093481,Chow; Bennett,8,0,32,24
1657707865001,MATH 142A,B04,093558,Chow; Bennett,13,0,32,19
1657707865001,MATH 142A,B05,093559,Chow; Bennett,6,0,32,26
1657707871031,MATH 193A,A01,083224,Rotar; Vladimir,8,0,34,26
1657707871031,MATH 193A,A02,083225,Rotar; Vladimir,9,0,34,25
1657707871031,MATH 193A,A03,083781,Rotar; Vladimir,5,0,34,29
1657707871031,MATH 193A,A04,083782,Rotar; Vladimir,10,0,34,24
1657707871031,MATH 193A,A05,093482,Rotar; Vladimir,10,0,34,24
1657707877057,MATH 197,001,091859,McAuley; Julian John,9999,0,9999,0
1657707877057,MATH 197,002,095566,Kedlaya; Kiran S.,9997,0,9999,2
1657707877057,MATH 197,003,095567,Xiao; Ming,9999,0,9999,0
1657707877057,MATH 197,004,095571,Perols; Johan Lars,9998,0,9999,1
1657707884111,COGS 9,A01,083615,Shannon; Kyle Michael,9,0,75,66
1657707890138,COGS 11,A01,083617,Boyle; Mary E. T.,23,0,48,25
1657707896164,COGS 13,A01,083071,Bastos; Amalia Pinkusfeld,11,0,71,60
1657707902189,COGS 14A,A01,092681,Semenuks; Arturs,5,1,100,95
1657707908212,COGS 14B,A01,083073,Cheng; Tzu-Han,6,0,63,57
1657707914236,COGS 17,A01,092677,Semenuks; Arturs,6,0,81,75
1657707920261,COGS 100,A01,083619,Allen; Michael Gordon,17,0,70,53
1657707926285,COGS 101A,A01,083621,Davis; Joshua Daniel,9,0,68,59
1657707932309,COGS 101B,A01,091572,Allen; Michael Gordon,12,0,65,53
1657707938336,COGS 101C,A01,083625,Delgado; Tania,17,0,35,18
1657707944359,COGS 107A,A01,083627,Boyle; Mary E. T.,13,0,60,47
1657707950402,COGS 118A,A01,083075,Gupta; Anjum,21,0,76,55
1657707956425,CSE 3,A50,083646,Miranda; Gregory Joseph,24,0,50,26
1657707962451,CSE 8A,A50,083650,Miranda; Gregory Joseph,17,1,56,39
1657707968475,CSE 11,A01,083080,Cao; Yingjun,6,15,40,34
1657707974504,CSE 12,A01,083652,Krause-Levy; Sophia Louisa,28,1,120,92
1657707980531,CSE 15L,A01,083654,Morris; Justin Loren,9,0,50,41
1657707980531,CSE 15L,A02,083655,Morris; Justin Loren,9,0,50,41
1657707986559,CSE 20,A01,083657,Tran; Khoa Dang,39,0,80,41
1657707992585,CSE 21,A01,095574,Bach; Quang Tran,22,0,48,26
1657707998612,CSE 30,A01,083084,Eldon; John,6,0,80,74
1657707998612,CSE 30,B01,095061,Bhaskar; Nishant,9,0,50,41
1657708004636,CSE 100,A01,083659,Cao; Yingjun,5,4,70,65
1657708010663,CSE 134B,A01,083661,Powell; Thomas Allan,23,0,100,77
1657708016687,CSE 140,A01,083663,Gungor; Onat,15,0,85,70
1657708022716,CSE 140L,A01,083088,Eldon; John,23,0,100,77
1657708028743,CSE 175,A01,083665,Kumar; Rakesh,3,0,25,22
1657708034770,CSE 190,A00,092507,Dubnov; Shlomo,8,0,20,12
1657708040795,ECE 45,A01,083139,Congero; Spencer William,6,0,75,69
1657708046818,ECE 65,A50,083695,Saad; Andrew S,12,0,30,18
1657708046818,ECE 65,A51,095125,Saad; Andrew S,24,0,26,2
1657708052841,ECE 109,A01,091882,Touri; Behrouz,20,0,70,50
1657708058868,ECE 180,A00,083140,Abi Samra; Nicholas Camill,1,0,30,29
1657708058868,ECE 180,B00,083141,Abi Samra; Nicholas Camill,0,0,30,30
1657708064892,MATH 10A,A01,083735,Patchell; Gregory David,2,0,30,28
1657708064892,MATH 10A,A02,083736,Patchell; Gregory David,20,0,30,10
1657708064892,MATH 10A,A03,083737,Patchell; Gregory David,16,0,30,14
1657708070920,MATH 10B,A01,083207,Lim; Seonhee,8,0,34,26
1657708070920,MATH 10B,A02,083208,Lim; Seonhee,9,0,35,26
1657708070920,MATH 10B,A03,093472,Lim; Seonhee,7,0,34,27
1657708070920,MATH 10B,B01,083739,Sinha; Shubham,13,0,30,17
1657708076951,MATH 18,A01,083743,Cinel; Cameron Alexander,8,0,30,22
1657708076951,MATH 18,A02,083744,Cinel; Cameron Alexander,17,0,30,13
1657708076951,MATH 18,A03,083745,Cinel; Cameron Alexander,10,0,30,20
1657708076951,MATH 18,B01,083748,Rideout; David Porter,5,0,37,32
1657708076951,MATH 18,B02,083749,Rideout; David Porter,5,0,36,31
1657708076951,MATH 18,B03,083750,Rideout; David Porter,3,0,37,34
1657708076951,MATH 18,B04,083751,Rideout; David Porter,6,0,36,30
1657708076951,MATH 18,B05,093473,Rideout; David Porter,6,0,36,30
1657708076951,MATH 18,B06,093474,Rideout; David Porter,6,0,36,30
1657708082982,MATH 20A,A01,083754,Zheng; Zequn,14,0,40,26
1657708089010,MATH 20B,A01,083756,Briones; Jor-el Thomas Caparas,4,0,36,32
1657708089010,MATH 20B,A02,083757,Briones; Jor-el Thomas Caparas,1,0,36,35
1657708089010,MATH 20B,A03,093475,Briones; Jor-el Thomas Caparas,2,0,36,34
1657708095041,MATH 20C,A01,083760,Briones; Jor-el Thomas Caparas,1,0,35,34
1657708095041,MATH 20C,A02,083761,Briones; Jor-el Thomas Caparas,8,0,35,27
1657708095041,MATH 20C,A03,093476,Briones; Jor-el Thomas Caparas,0,1,36,36
1657708095041,MATH 20C,B01,083762,Bach; Quang Tran,1,0,30,29
1657708101068,MATH 20D,A01,083765,Tran; Brian Kha,5,0,30,25
1657708101068,MATH 20D,A02,083766,Tran; Brian Kha,5,0,30,25
1657708101068,MATH 20D,A03,083767,Tran; Brian Kha,5,0,30,25
1657708107093,MATH 20E,A01,083771,Ganguly; Soumya,9,0,32,23
1657708107093,MATH 20E,A02,083772,Ganguly; Soumya,6,0,32,26
1657708107093,MATH 20E,B01,083773,Ciotti; Benjamin,20,0,35,15
1657708107093,MATH 20E,B02,083774,Ciotti; Benjamin,18,0,35,17
1657708113123,MATH 103A,A01,083777,Greenfeld; Be'Eri,3,0,36,33
1657708113123,MATH 103A,A02,083778,Greenfeld; Be'Eri,5,0,36,31
1657708113123,MATH 103A,A03,093561,Greenfeld; Be'Eri,6,0,36,30
1657708113123,MATH 103A,B01,083779,Greenfeld; Be'Eri,7,0,36,29
1657708113123,MATH 103A,B02,083780,Greenfeld; Be'Eri,4,0,36,32
1657708113123,MATH 103A,B03,093562,Greenfeld; Be'Eri,3,0,36,33
1657708119145,MATH 105,A01,085443,Carter; Anne Toulson,15,0,35,20
1657708119145,MATH 105,A02,093477,Carter; Anne Toulson,20,0,35,15
1657708125248,MATH 109,A01,083213,Ganzberger; Geoffrey Michael,2,0,34,32
1657708125248,MATH 109,A02,083214,Ganzberger; Geoffrey Michael,4,0,34,30
1657708125248,MATH 109,A03,093478,Ganzberger; Geoffrey Michael,2,0,34,32
1657708125248,MATH 109,B01,083215,Ganzberger; Geoffrey Michael,1,0,32,31
1657708125248,MATH 109,B02,083216,Ganzberger; Geoffrey Michael,2,0,32,30
1657708125248,MATH 109,B03,093479,Ganzberger; Geoffrey Michael,8,0,32,24
1657708131273,MATH 142A,A01,083219,Chow; Bennett,7,0,32,25
1657708131273,MATH 142A,A02,083220,Chow; Bennett,10,0,32,22
1657708131273,MATH 142A,A03,093480,Chow; Bennett,9,0,32,23
1657708131273,MATH 142A,B03,093481,Chow; Bennett,8,0,32,24
1657708131273,MATH 142A,B04,093558,Chow; Bennett,13,0,32,19
1657708131273,MATH 142A,B05,093559,Chow; Bennett,6,0,32,26
1657708137298,MATH 193A,A01,083224,Rotar; Vladimir,8,0,34,26
1657708137298,MATH 193A,A02,083225,Rotar; Vladimir,9,0,34,25
1657708137298,MATH 193A,A03,083781,Rotar; Vladimir,5,0,34,29
1657708137298,MATH 193A,A04,083782,Rotar; Vladimir,10,0,34,24
1657708137298,MATH 193A,A05,093482,Rotar; Vladimir,10,0,34,24
1657708143322,MATH 197,001,091859,McAuley; Julian John,9999,0,9999,0
1657708143322,MATH 197,002,095566,Kedlaya; Kiran S.,9997,0,9999,2
1657708143322,MATH 197,003,095567,Xiao; Ming,9999,0,9999,0
1657708143322,MATH 197,004,095571,Perols; Johan Lars,9998,0,9999,1
1657708150386,COGS 9,A01,083615,Shannon; Kyle Michael,9,0,75,66
1657708156409,COGS 11,A01,083617,Boyle; Mary E. T.,23,0,48,25
1657708162434,COGS 13,A01,083071,Bastos; Amalia Pinkusfeld,11,0,71,60
1657708168460,COGS 14A,A01,092681,Semenuks; Arturs,5,1,100,95
1657708174491,COGS 14B,A01,083073,Cheng; Tzu-Han,6,0,63,57
1657708180515,COGS 17,A01,092677,Semenuks; Arturs,6,0,81,75
1657708186542,COGS 100,A01,083619,Allen; Michael Gordon,17,0,70,53
1657708192565,COGS 101A,A01,083621,Davis; Joshua Daniel,9,0,68,59
1657708198589,COGS 101B,A01,091572,Allen; Michael Gordon,12,0,65,53
1657708204615,COGS 101C,A01,083625,Delgado; Tania,17,0,35,18
1657708210637,COGS 107A,A01,083627,Boyle; Mary E. T.,13,0,60,47
1657708216659,COGS 118A,A01,083075,Gupta; Anjum,21,0,76,55
1657708222681,CSE 3,A50,083646,Miranda; Gregory Joseph,24,0,50,26
1657708228708,CSE 8A,A50,083650,Miranda; Gregory Joseph,17,1,56,39
1657708234733,CSE 11,A01,083080,Cao; Yingjun,6,15,40,34
1657708240756,CSE 12,A01,083652,Krause-Levy; Sophia Louisa,28,1,120,92
1657708246779,CSE 15L,A01,083654,Morris; Justin Loren,9,0,50,41
1657708246779,CSE 15L,A02,083655,Morris; Justin Loren,9,0,50,41
1657708252812,CSE 20,A01,083657,Tran; Khoa Dang,39,0,80,41
1657708258835,CSE 21,A01,095574,Bach; Quang Tran,22,0,48,26
1657708264858,CSE 30,A01,083084,Eldon; John,6,0,80,74
1657708264858,CSE 30,B01,095061,Bhaskar; Nishant,9,0,50,41
1657708270882,CSE 100,A01,083659,Cao; Yingjun,5,4,70,65
1657708276904,CSE 134B,A01,083661,Powell; Thomas Allan,23,0,100,77
1657708282932,CSE 140,A01,083663,Gungor; Onat,15,0,85,70
1657708288966,CSE 140L,A01,083088,Eldon; John,23,0,100,77
1657708294991,CSE 175,A01,083665,Kumar; Rakesh,3,0,25,22
1657708301020,CSE 190,A00,092507,Dubnov; Shlomo,8,0,20,12
1657708307062,ECE 45,A01,083139,Congero; Spencer William,6,0,75,69
1657708313089,ECE 65,A50,083695,Saad; Andrew S,12,0,30,18
1657708313089,ECE 65,A51,095125,Saad; Andrew S,24,0,26,2
1657708319117,ECE 109,A01,091882,Touri; Behrouz,20,0,70,50
1657708325140,ECE 180,A00,083140,Abi Samra; Nicholas Camill,1,0,30,29
1657708325140,ECE 180,B00,083141,Abi Samra; Nicholas Camill,0,0,30,30
1657708331163,MATH 10A,A01,083735,Patchell; Gregory David,2,0,30,28
1657708331163,MATH 10A,A02,083736,Patchell; Gregory David,20,0,30,10
1657708331163,MATH 10A,A03,083737,Patchell; Gregory David,16,0,30,14
1657708337188,MATH 10B,A01,083207,Lim; Seonhee,8,0,34,26
1657708337188,MATH 10B,A02,083208,Lim; Seonhee,9,0,35,26
1657708337188,MATH 10B,A03,093472,Lim; Seonhee,7,0,34,27
1657708337188,MATH 10B,B01,083739,Sinha; Shubham,13,0,30,17
1657708343217,MATH 18,A01,083743,Cinel; Cameron Alexander,8,0,30,22
1657708343217,MATH 18,A02,083744,Cinel; Cameron Alexander,17,0,30,13
1657708343217,MATH 18,A03,083745,Cinel; Cameron Alexander,10,0,30,20
1657708343217,MATH 18,B01,083748,Rideout; David Porter,5,0,37,32
1657708343217,MATH 18,B02,083749,Rideout; David Porter,5,0,36,31
1657708343217,MATH 18,B03,083750,Rideout; David Porter,3,0,37,34
1657708343217,MATH 18,B04,083751,Rideout; David Porter,6,0,36,30
1657708343217,MATH 18,B05,093473,Rideout; David Porter,6,0,36,30
1657708343217,MATH 18,B06,093474,Rideout; David Porter,6,0,36,30
1657708349246,MATH 20A,A01,083754,Zheng; Zequn,14,0,40,26
1657708355275,MATH 20B,A01,083756,Briones; Jor-el Thomas Caparas,4,0,36,32
1657708355275,MATH 20B,A02,083757,Briones; Jor-el Thomas Caparas,1,0,36,35
1657708355275,MATH 20B,A03,093475,Briones; Jor-el Thomas Caparas,2,0,36,34
1657708361300,MATH 20C,A01,083760,Briones; Jor-el Thomas Caparas,1,0,35,34
1657708361300,MATH 20C,A02,083761,Briones; Jor-el Thomas Caparas,8,0,35,27
1657708361300,MATH 20C,A03,093476,Briones; Jor-el Thomas Caparas,0,1,36,36
1657708361300,MATH 20C,B01,083762,Bach; Quang Tran,1,0,30,29
1657708367327,MATH 20D,A01,083765,Tran; Brian Kha,5,0,30,25
1657708367327,MATH 20D,A02,083766,Tran; Brian Kha,5,0,30,25
1657708367327,MATH 20D,A03,083767,Tran; Brian Kha,5,0,30,25
1657708373352,MATH 20E,A01,083771,Ganguly; Soumya,9,0,32,23
1657708373352,MATH 20E,A02,083772,Ganguly; Soumya,6,0,32,26
1657708373352,MATH 20E,B01,083773,Ciotti; Benjamin,20,0,35,15
1657708373352,MATH 20E,B02,083774,Ciotti; Benjamin,18,0,35,17
1657708379376,MATH 103A,A01,083777,Greenfeld; Be'Eri,3,0,36,33
1657708379376,MATH 103A,A02,083778,Greenfeld; Be'Eri,5,0,36,31
1657708379376,MATH 103A,A03,093561,Greenfeld; Be'Eri,6,0,36,30
1657708379376,MATH 103A,B01,083779,Greenfeld; Be'Eri,7,0,36,29
1657708379376,MATH 103A,B02,083780,Greenfeld; Be'Eri,4,0,36,32
1657708379376,MATH 103A,B03,093562,Greenfeld; Be'Eri,3,0,36,33
1657708385401,MATH 105,A01,085443,Carter; Anne Toulson,15,0,35,20
1657708385401,MATH 105,A02,093477,Carter; Anne Toulson,20,0,35,15
1657708391425,MATH 109,A01,083213,Ganzberger; Geoffrey Michael,2,0,34,32
1657708391425,MATH 109,A02,083214,Ganzberger; Geoffrey Michael,4,0,34,30
1657708391425,MATH 109,A03,093478,Ganzberger; Geoffrey Michael,2,0,34,32
1657708391425,MATH 109,B01,083215,Ganzberger; Geoffrey Michael,1,0,32,31
1657708391425,MATH 109,B02,083216,Ganzberger; Geoffrey Michael,2,0,32,30
1657708391425,MATH 109,B03,093479,Ganzberger; Geoffrey Michael,8,0,32,24
1657708397448,MATH 142A,A01,083219,Chow; Bennett,7,0,32,25
1657708397448,MATH 142A,A02,083220,Chow; Bennett,10,0,32,22
1657708397448,MATH 142A,A03,093480,Chow; Bennett,9,0,32,23
1657708397448,MATH 142A,B03,093481,Chow; Bennett,8,0,32,24
1657708397448,MATH 142A,B04,093558,Chow; Bennett,13,0,32,19
1657708397448,MATH 142A,B05,093559,Chow; Bennett,6,0,32,26
1657708403473,MATH 193A,A01,083224,Rotar; Vladimir,8,0,34,26
1657708403473,MATH 193A,A02,083225,Rotar; Vladimir,9,0,34,25
1657708403473,MATH 193A,A03,083781,Rotar; Vladimir,5,0,34,29
1657708403473,MATH 193A,A04,083782,Rotar; Vladimir,10,0,34,24
1657708403473,MATH 193A,A05,093482,Rotar; Vladimir,10,0,34,24
1657708409496,MATH 197,001,091859,McAuley; Julian John,9999,0,9999,0
1657708409496,MATH 197,002,095566,Kedlaya; Kiran S.,9997,0,9999,2
1657708409496,MATH 197,003,095567,Xiao; Ming,9999,0,9999,0
1657708409496,MATH 197,004,095571,Perols; Johan Lars,9998,0,9999,1
1657708416559,COGS 9,A01,083615,Shannon; Kyle Michael,9,0,75,66
1657708422586,COGS 11,A01,083617,Boyle; Mary E. T.,23,0,48,25
1657708428614,COGS 13,A01,083071,Bastos; Amalia Pinkusfeld,11,0,71,60
1657708434637,COGS 14A,A01,092681,Semenuks; Arturs,5,1,100,95
1657708440661,COGS 14B,A01,083073,Cheng; Tzu-Han,6,0,63,57
1657708446688,COGS 17,A01,092677,Semenuks; Arturs,6,0,81,75
1657708452712,COGS 100,A01,083619,Allen; Michael Gordon,17,0,70,53
1657708458740,COGS 101A,A01,083621,Davis; Joshua Daniel,9,0,68,59
1657708464762,COGS 101B,A01,091572,Allen; Michael Gordon,12,0,65,53
1657708470785,COGS 101C,A01,083625,Delgado; Tania,17,0,35,18
1657708476812,COGS 107A,A01,083627,Boyle; Mary E. T.,13,0,60,47
1657708482835,COGS 118A,A01,083075,Gupta; Anjum,21,0,76,55
1657708488860,CSE 3,A50,083646,Miranda; Gregory Joseph,24,0,50,26
1657708494883,CSE 8A,A50,083650,Miranda; Gregory Joseph,17,1,56,39
1657708500908,CSE 11,A01,083080,Cao; Yingjun,6,15,40,34
1657708506936,CSE 12,A01,083652,Krause-Levy; Sophia Louisa,28,1,120,92
1657708512965,CSE 15L,A01,083654,Morris; Justin Loren,9,0,50,41
1657708512965,CSE 15L,A02,083655,Morris; Justin Loren,9,0,50,41
1657708518988,CSE 20,A01,083657,Tran; Khoa Dang,39,0,80,41
1657708525011,CSE 21,A01,095574,Bach; Quang Tran,22,0,48,26
1657708531037,CSE 30,A01,083084,Eldon; John,6,0,80,74
1657708531037,CSE 30,B01,095061,Bhaskar; Nishant,9,0,50,41
1657708537064,CSE 100,A01,083659,Cao; Yingjun,5,4,70,65
1657708543089,CSE 134B,A01,083661,Powell; Thomas Allan,23,0,100,77
1657708549113,CSE 140,A01,083663,Gungor; Onat,15,0,85,70
1657708555137,CSE 140L,A01,083088,Eldon; John,23,0,100,77
1657708561162,CSE 175,A01,083665,Kumar; Rakesh,3,0,25,22
1657708567189,CSE 190,A00,092507,Dubnov; Shlomo,8,0,20,12
1657708573218,ECE 45,A01,083139,Congero; Spencer William,6,0,75,69
1657708579244,ECE 65,A50,083695,Saad; Andrew S,12,0,30,18
1657708579244,ECE 65,A51,095125,Saad; Andrew S,24,0,26,2
1657708585271,ECE 109,A01,091882,Touri; Behrouz,20,0,70,50
1657708591294,ECE 180,A00,083140,Abi Samra; Nicholas Camill,1,0,30,29
1657708591294,ECE 180,B00,083141,Abi Samra; Nicholas Camill,0,0,30,30
1657708597331,MATH 10A,A01,083735,Patchell; Gregory David,2,0,30,28
1657708597331,MATH 10A,A02,083736,Patchell; Gregory David,20,0,30,10
1657708597331,MATH 10A,A03,083737,Patchell; Gregory David,16,0,30,14
1657708603358,MATH 10B,A01,083207,Lim; Seonhee,8,0,34,26
1657708603358,MATH 10B,A02,083208,Lim; Seonhee,9,0,35,26
1657708603358,MATH 10B,A03,093472,Lim; Seonhee,7,0,34,27
1657708603358,MATH 10B,B01,083739,Sinha; Shubham,13,0,30,17
1657708609391,MATH 18,A01,083743,Cinel; Cameron Alexander,8,0,30,22
1657708609391,MATH 18,A02,083744,Cinel; Cameron Alexander,17,0,30,13
1657708609391,MATH 18,A03,083745,Cinel; Cameron Alexander,10,0,30,20
1657708609391,MATH 18,B01,083748,Rideout; David Porter,5,0,37,32
1657708609391,MATH 18,B02,083749,Rideout; David Porter,5,0,36,31
1657708609391,MATH 18,B03,083750,Rideout; David Porter,3,0,37,34
1657708609391,MATH 18,B04,083751,Rideout; David Porter,6,0,36,30
1657708609391,MATH 18,B05,093473,Rideout; David Porter,6,0,36,30
1657708609391,MATH 18,B06,093474,Rideout; David Porter,6,0,36,30
1657708615416,MATH 20A,A01,083754,Zheng; Zequn,14,0,40,26
1657708621447,MATH 20B,A01,083756,Briones; Jor-el Thomas Caparas,4,0,36,32
1657708621447,MATH 20B,A02,083757,Briones; Jor-el Thomas Caparas,1,0,36,35
1657708621447,MATH 20B,A03,093475,Briones; Jor-el Thomas Caparas,2,0,36,34
1657708627482,MATH 20C,A01,083760,Briones; Jor-el Thomas Caparas,1,0,35,34
1657708627482,MATH 20C,A02,083761,Briones; Jor-el Thomas Caparas,8,0,35,27
1657708627482,MATH 20C,A03,093476,Briones; Jor-el Thomas Caparas,0,1,36,36
1657708627482,MATH 20C,B01,083762,Bach; Quang Tran,1,0,30,29
1657708633506,MATH 20D,A01,083765,Tran; Brian Kha,5,0,30,25
1657708633506,MATH 20D,A02,083766,Tran; Brian Kha,5,0,30,25
1657708633506,MATH 20D,A03,083767,Tran; Brian Kha,5,0,30,25
1657708639532,MATH 20E,A01,083771,Ganguly; Soumya,9,0,32,23
1657708639532,MATH 20E,A02,083772,Ganguly; Soumya,6,0,32,26
1657708639532,MATH 20E,B01,083773,Ciotti; Benjamin,20,0,35,15
1657708639532,MATH 20E,B02,083774,Ciotti; Benjamin,18,0,35,17
1657708645559,MATH 103A,A01,083777,Greenfeld; Be'Eri,3,0,36,33
1657708645559,MATH 103A,A02,083778,Greenfeld; Be'Eri,5,0,36,31
1657708645559,MATH 103A,A03,093561,Greenfeld; Be'Eri,6,0,36,30
1657708645559,MATH 103A,B01,083779,Greenfeld; Be'Eri,7,0,36,29
1657708645559,MATH 103A,B02,083780,Greenfeld; Be'Eri,4,0,36,32
1657708645559,MATH 103A,B03,093562,Greenfeld; Be'Eri,3,0,36,33
1657708651584,MATH 105,A01,085443,Carter; Anne Toulson,15,0,35,20
1657708651584,MATH 105,A02,093477,Carter; Anne Toulson,20,0,35,15
1657708657615,MATH 109,A01,083213,Ganzberger; Geoffrey Michael,2,0,34,32
1657708657615,MATH 109,A02,083214,Ganzberger; Geoffrey Michael,4,0,34,30
1657708657615,MATH 109,A03,093478,Ganzberger; Geoffrey Michael,2,0,34,32
1657708657615,MATH 109,B01,083215,Ganzberger; Geoffrey Michael,1,0,32,31
1657708657615,MATH 109,B02,083216,Ganzberger; Geoffrey Michael,2,0,32,30
1657708657615,MATH 109,B03,093479,Ganzberger; Geoffrey Michael,8,0,32,24
1657708663659,MATH 142A,A01,083219,Chow; Bennett,7,0,32,25
1657708663659,MATH 142A,A02,083220,Chow; Bennett,10,0,32,22
1657708663659,MATH 142A,A03,093480,Chow; Bennett,9,0,32,23
1657708663659,MATH 142A,B03,093481,Chow; Bennett,8,0,32,24
1657708663659,MATH 142A,B04,093558,Chow; Bennett,13,0,32,19
1657708663659,MATH 142A,B05,093559,Chow; Bennett,6,0,32,26
1657708669683,MATH 193A,A01,083224,Rotar; Vladimir,8,0,34,26
1657708669683,MATH 193A,A02,083225,Rotar; Vladimir,9,0,34,25
1657708669683,MATH 193A,A03,083781,Rotar; Vladimir,5,0,34,29
1657708669683,MATH 193A,A04,083782,Rotar; Vladimir,10,0,34,24
1657708669683,MATH 193A,A05,093482,Rotar; Vladimir,10,0,34,24
1657708675715,MATH 197,001,091859,McAuley; Julian John,9999,0,9999,0
1657708675715,MATH 197,002,095566,Kedlaya; Kiran S.,9997,0,9999,2
1657708675715,MATH 197,003,095567,Xiao; Ming,9999,0,9999,0
1657708675715,MATH 197,004,095571,Perols; Johan Lars,9998,0,9999,1
1657708682798,COGS 9,A01,083615,Shannon; Kyle Michael,9,0,75,66
1657708688824,COGS 11,A01,083617,Boyle; Mary E. T.,23,0,48,25
1657708694847,COGS 13,A01,083071,Bastos; Amalia Pinkusfeld,11,0,71,60
1657708700875,COGS 14A,A01,092681,Semenuks; Arturs,5,1,100,95
1657708706905,COGS 14B,A01,083073,Cheng; Tzu-Han,6,0,63,57
1657708712932,COGS 17,A01,092677,Semenuks; Arturs,6,0,81,75
1657708719055,COGS 100,A01,083619,Allen; Michael Gordon,17,0,70,53
1657708725079,COGS 101A,A01,083621,Davis; Joshua Daniel,9,0,68,59
1657708731109,COGS 101B,A01,091572,Allen; Michael Gordon,12,0,65,53
1657708737138,COGS 101C,A01,083625,Delgado; Tania,17,0,35,18
1657708743161,COGS 107A,A01,083627,Boyle; Mary E. T.,13,0,60,47
1657708749190,COGS 118A,A01,083075,Gupta; Anjum,21,0,76,55
1657708755218,CSE 3,A50,083646,Miranda; Gregory Joseph,24,0,50,26
1657708761248,CSE 8A,A50,083650,Miranda; Gregory Joseph,17,1,56,39
1657708767273,CSE 11,A01,083080,Cao; Yingjun,6,15,40,34
1657708773300,CSE 12,A01,083652,Krause-Levy; Sophia Louisa,28,1,120,92
1657708779334,CSE 15L,A01,083654,Morris; Justin Loren,9,0,50,41
1657708779334,CSE 15L,A02,083655,Morris; Justin Loren,9,0,50,41
1657708785372,CSE 20,A01,083657,Tran; Khoa Dang,39,0,80,41
1657708791396,CSE 21,A01,095574,Bach; Quang Tran,22,0,48,26
1657708797429,CSE 30,A01,083084,Eldon; John,6,0,80,74
1657708797429,CSE 30,B01,095061,Bhaskar; Nishant,9,0,50,41
1657708803455,CSE 100,A01,083659,Cao; Yingjun,5,4,70,65
1657708809478,CSE 134B,A01,083661,Powell; Thomas Allan,23,0,100,77
1657708815507,CSE 140,A01,083663,Gungor; Onat,15,0,85,70
1657708821536,CSE 140L,A01,083088,Eldon; John,23,0,100,77
1657708827562,CSE 175,A01,083665,Kumar; Rakesh,3,0,25,22
1657708833592,CSE 190,A00,092507,Dubnov; Shlomo,8,0,20,12
1657708839618,ECE 45,A01,083139,Congero; Spencer William,6,0,75,69
1657708845646,ECE 65,A50,083695,Saad; Andrew S,12,0,30,18
1657708845646,ECE 65,A51,095125,Saad; Andrew S,24,0,26,2
1657708851678,ECE 109,A01,091882,Touri; Behrouz,20,0,70,50
1657708857702,ECE 180,A00,083140,Abi Samra; Nicholas Camill,1,0,30,29
1657708857702,ECE 180,B00,083141,Abi Samra; Nicholas Camill,0,0,30,30
1657708863737,MATH 10A,A01,083735,Patchell; Gregory David,2,0,30,28
1657708863737,MATH 10A,A02,083736,Patchell; Gregory David,20,0,30,10
1657708863737,MATH 10A,A03,083737,Patchell; Gregory David,16,0,30,14
1657708869775,MATH 10B,A01,083207,Lim; Seonhee,8,0,34,26
1657708869775,MATH 10B,A02,083208,Lim; Seonhee,9,0,35,26
1657708869775,MATH 10B,A03,093472,Lim; Seonhee,7,0,34,27
1657708869775,MATH 10B,B01,083739,Sinha; Shubham,13,0,30,17
1657708875815,MATH 18,A01,083743,Cinel; Cameron Alexander,8,0,30,22
1657708875815,MATH 18,A02,083744,Cinel; Cameron Alexander,17,0,30,13
1657708875815,MATH 18,A03,083745,Cinel; Cameron Alexander,10,0,30,20
1657708875815,MATH 18,B01,083748,Rideout; David Porter,5,0,37,32
1657708875815,MATH 18,B02,083749,Rideout; David Porter,5,0,36,31
1657708875815,MATH 18,B03,083750,Rideout; David Porter,3,0,37,34
1657708875815,MATH 18,B04,083751,Rideout; David Porter,6,0,36,30
1657708875815,MATH 18,B05,093473,Rideout; David Porter,6,0,36,30
1657708875815,MATH 18,B06,093474,Rideout; David Porter,6,0,36,30
1657708881838,MATH 20A,A01,083754,Zheng; Zequn,14,0,40,26
1657708887862,MATH 20B,A01,083756,Briones; Jor-el Thomas Caparas,4,0,36,32
1657708887862,MATH 20B,A02,083757,Briones; Jor-el Thomas Caparas,1,0,36,35
1657708887862,MATH 20B,A03,093475,Briones; Jor-el Thomas Caparas,2,0,36,34
1657708893886,MATH 20C,A01,083760,Briones; Jor-el Thomas Caparas,1,0,35,34
1657708893886,MATH 20C,A02,083761,Briones; Jor-el Thomas Caparas,8,0,35,27
1657708893886,MATH 20C,A03,093476,Briones; Jor-el Thomas Caparas,0,1,36,36
1657708893886,MATH 20C,B01,083762,Bach; Quang Tran,1,0,30,29
1657708899918,MATH 20D,A01,083765,Tran; Brian Kha,5,0,30,25
1657708899918,MATH 20D,A02,083766,Tran; Brian Kha,5,0,30,25
1657708899918,MATH 20D,A03,083767,Tran; Brian Kha,5,0,30,25
1657708905943,MATH 20E,A01,083771,Ganguly; Soumya,9,0,32,23
1657708905943,MATH 20E,A02,083772,Ganguly; Soumya,6,0,32,26
1657708905943,MATH 20E,B01,083773,Ciotti; Benjamin,20,0,35,15
1657708905943,MATH 20E,B02,083774,Ciotti; Benjamin,18,0,35,17
1657708911969,MATH 103A,A01,083777,Greenfeld; Be'Eri,3,0,36,33
1657708911969,MATH 103A,A02,083778,Greenfeld; Be'Eri,5,0,36,31
1657708911969,MATH 103A,A03,093561,Greenfeld; Be'Eri,6,0,36,30
1657708911969,MATH 103A,B01,083779,Greenfeld; Be'Eri,7,0,36,29
1657708911969,MATH 103A,B02,083780,Greenfeld; Be'Eri,4,0,36,32
1657708911969,MATH 103A,B03,093562,Greenfeld; Be'Eri,3,0,36,33
1657708918001,MATH 105,A01,085443,Carter; Anne Toulson,15,0,35,20
1657708918001,MATH 105,A02,093477,Carter; Anne Toulson,20,0,35,15
1657708924031,MATH 109,A01,083213,Ganzberger; Geoffrey Michael,2,0,34,32
1657708924031,MATH 109,A02,083214,Ganzberger; Geoffrey Michael,4,0,34,30
1657708924031,MATH 109,A03,093478,Ganzberger; Geoffrey Michael,2,0,34,32
1657708924031,MATH 109,B01,083215,Ganzberger; Geoffrey Michael,1,0,32,31
1657708924031,MATH 109,B02,083216,Ganzberger; Geoffrey Michael,2,0,32,30
1657708924031,MATH 109,B03,093479,Ganzberger; Geoffrey Michael,8,0,32,24
1657708930058,MATH 142A,A01,083219,Chow; Bennett,7,0,32,25
1657708930058,MATH 142A,A02,083220,Chow; Bennett,10,0,32,22
1657708930058,MATH 142A,A03,093480,Chow; Bennett,9,0,32,23
1657708930058,MATH 142A,B03,093481,Chow; Bennett,8,0,32,24
1657708930058,MATH 142A,B04,093558,Chow; Bennett,13,0,32,19
1657708930058,MATH 142A,B05,093559,Chow; Bennett,6,0,32,26
1657708936084,MATH 193A,A01,083224,Rotar; Vladimir,8,0,34,26
1657708936084,MATH 193A,A02,083225,Rotar; Vladimir,9,0,34,25
1657708936084,MATH 193A,A03,083781,Rotar; Vladimir,5,0,34,29
1657708936084,MATH 193A,A04,083782,Rotar; Vladimir,10,0,34,24
1657708936084,MATH 193A,A05,093482,Rotar; Vladimir,10,0,34,24
1657708942108,MATH 197,001,091859,McAuley; Julian John,9999,0,9999,0
1657708942108,MATH 197,002,095566,Kedlaya; Kiran S.,9997,0,9999,2
1657708942108,MATH 197,003,095567,Xiao; Ming,9999,0,9999,0
1657708942108,MATH 197,004,095571,Perols; Johan Lars,9998,0,9999,1
1657708949176,COGS 9,A01,083615,Shannon; Kyle Michael,9,0,75,66
1657708955206,COGS 11,A01,083617,Boyle; Mary E. T.,23,0,48,25
1657708961231,COGS 13,A01,083071,Bastos; Amalia Pinkusfeld,11,0,71,60
1657708967258,COGS 14A,A01,092681,Semenuks; Arturs,5,1,100,95
1657708973282,COGS 14B,A01,083073,Cheng; Tzu-Han,6,0,63,57
1657708979307,COGS 17,A01,092677,Semenuks; Arturs,6,0,81,75
1657708985334,COGS 100,A01,083619,Allen; Michael Gordon,17,0,70,53
1657708991364,COGS 101A,A01,083621,Davis; Joshua Daniel,9,0,68,59
1657708997392,COGS 101B,A01,091572,Allen; Michael Gordon,12,0,65,53
1657709003422,COGS 101C,A01,083625,Delgado; Tania,17,0,35,18
1657709009444,COGS 107A,A01,083627,Boyle; Mary E. T.,13,0,60,47
1657709015473,COGS 118A,A01,083075,Gupta; Anjum,21,0,76,55
1657709021499,CSE 3,A50,083646,Miranda; Gregory Joseph,24,0,50,26
1657709027522,CSE 8A,A50,083650,Miranda; Gregory Joseph,17,1,56,39
1657709033545,CSE 11,A01,083080,Cao; Yingjun,6,15,40,34
1657709039576,CSE 12,A01,083652,Krause-Levy; Sophia Louisa,28,1,120,92
1657709045600,CSE 15L,A01,083654,Morris; Justin Loren,9,0,50,41
1657709045600,CSE 15L,A02,083655,Morris; Justin Loren,9,0,50,41
1657709051634,CSE 20,A01,083657,Tran; Khoa Dang,39,0,80,41
1657709057664,CSE 21,A01,095574,Bach; Quang Tran,22,0,48,26
1657709063689,CSE 30,A01,083084,Eldon; John,6,0,80,74
1657709063689,CSE 30,B01,095061,Bhaskar; Nishant,9,0,50,41
1657709069712,CSE 100,A01,083659,Cao; Yingjun,5,4,70,65
1657709075736,CSE 134B,A01,083661,Powell; Thomas Allan,23,0,100,77
1657709081766,CSE 140,A01,083663,Gungor; Onat,15,0,85,70
1657709087789,CSE 140L,A01,083088,Eldon; John,23,0,100,77
1657709093819,CSE 175,A01,083665,Kumar; Rakesh,3,0,25,22
1657709099844,CSE 190,A00,092507,Dubnov; Shlomo,8,0,20,12
1657709105868,ECE 45,A01,083139,Congero; Spencer William,6,0,75,69
1657709111900,ECE 65,A50,083695,Saad; Andrew S,12,0,30,18
1657709111900,ECE 65,A51,095125,Saad; Andrew S,24,0,26,2
1657709117927,ECE 109,A01,091882,Touri; Behrouz,20,0,70,50
1657709123958,ECE 180,A00,083140,Abi Samra; Nicholas Camill,1,0,30,29
1657709123958,ECE 180,B00,083141,Abi Samra; Nicholas Camill,0,0,30,30
1657709129987,MATH 10A,A01,083735,Patchell; Gregory David,2,0,30,28
1657709129987,MATH 10A,A02,083736,Patchell; Gregory David,20,0,30,10
1657709129987,MATH 10A,A03,083737,Patchell; Gregory David,16,0,30,14
1657709136028,MATH 10B,A01,083207,Lim; Seonhee,8,0,34,26
1657709136028,MATH 10B,A02,083208,Lim; Seonhee,9,0,35,26
1657709136028,MATH 10B,A03,093472,Lim; Seonhee,7,0,34,27
1657709136028,MATH 10B,B01,083739,Sinha; Shubham,13,0,30,17
1657709142058,MATH 18,A01,083743,Cinel; Cameron Alexander,8,0,30,22
1657709142058,MATH 18,A02,083744,Cinel; Cameron Alexander,17,0,30,13
1657709142058,MATH 18,A03,083745,Cinel; Cameron Alexander,10,0,30,20
1657709142058,MATH 18,B01,083748,Rideout; David Porter,5,0,37,32
1657709142058,MATH 18,B02,083749,Rideout; David Porter,5,0,36,31
1657709142058,MATH 18,B03,083750,Rideout; David Porter,3,0,37,34
1657709142058,MATH 18,B04,083751,Rideout; David Porter,6,0,36,30
1657709142058,MATH 18,B05,093473,Rideout; David Porter,6,0,36,30
1657709142058,MATH 18,B06,093474,Rideout; David Porter,6,0,36,30
1657709148087,MATH 20A,A01,083754,Zheng; Zequn,14,0,40,26
1657709154113,MATH 20B,A01,083756,Briones; Jor-el Thomas Caparas,4,0,36,32
1657709154113,MATH 20B,A02,083757,Briones; Jor-el Thomas Caparas,1,0,36,35
1657709154113,MATH 20B,A03,093475,Briones; Jor-el Thomas Caparas,2,0,36,34
1657709160138,MATH 20C,A01,083760,Briones; Jor-el Thomas Caparas,1,0,35,34
1657709160138,MATH 20C,A02,083761,Briones; Jor-el Thomas Caparas,8,0,35,27
1657709160138,MATH 20C,A03,093476,Briones; Jor-el Thomas Caparas,0,1,36,36
1657709160138,MATH 20C,B01,083762,Bach; Quang Tran,1,0,30,29
1657709166168,MATH 20D,A01,083765,Tran; Brian Kha,5,0,30,25
1657709166168,MATH 20D,A02,083766,Tran; Brian Kha,5,0,30,25
1657709166168,MATH 20D,A03,083767,Tran; Brian Kha,5,0,30,25
1657709172196,MATH 20E,A01,083771,Ganguly; Soumya,9,0,32,23
1657709172196,MATH 20E,A02,083772,Ganguly; Soumya,6,0,32,26
1657709172196,MATH 20E,B01,083773,Ciotti; Benjamin,20,0,35,15
1657709172196,MATH 20E,B02,083774,Ciotti; Benjamin,18,0,35,17
1657709178224,MATH 103A,A01,083777,Greenfeld; Be'Eri,3,0,36,33
1657709178224,MATH 103A,A02,083778,Greenfeld; Be'Eri,5,0,36,31
1657709178224,MATH 103A,A03,093561,Greenfeld; Be'Eri,6,0,36,30
1657709178224,MATH 103A,B01,083779,Greenfeld; Be'Eri,7,0,36,29
1657709178224,MATH 103A,B02,083780,Greenfeld; Be'Eri,4,0,36,32
1657709178224,MATH 103A,B03,093562,Greenfeld; Be'Eri,3,0,36,33
1657709184250,MATH 105,A01,085443,Carter; Anne Toulson,15,0,35,20
1657709184250,MATH 105,A02,093477,Carter; Anne Toulson,20,0,35,15
1657709190282,MATH 109,A01,083213,Ganzberger; Geoffrey Michael,2,0,34,32
1657709190282,MATH 109,A02,083214,Ganzberger; Geoffrey Michael,4,0,34,30
1657709190282,MATH 109,A03,093478,Ganzberger; Geoffrey Michael,2,0,34,32
1657709190282,MATH 109,B01,083215,Ganzberger; Geoffrey Michael,1,0,32,31
1657709190282,MATH 109,B02,083216,Ganzberger; Geoffrey Michael,2,0,32,30
1657709190282,MATH 109,B03,093479,Ganzberger; Geoffrey Michael,8,0,32,24
1657709196309,MATH 142A,A01,083219,Chow; Bennett,7,0,32,25
1657709196309,MATH 142A,A02,083220,Chow; Bennett,10,0,32,22
1657709196309,MATH 142A,A03,093480,Chow; Bennett,9,0,32,23
1657709196309,MATH 142A,B03,093481,Chow; Bennett,8,0,32,24
1657709196309,MATH 142A,B04,093558,Chow; Bennett,13,0,32,19
1657709196309,MATH 142A,B05,093559,Chow; Bennett,6,0,32,26
1657709202335,MATH 193A,A01,083224,Rotar; Vladimir,8,0,34,26
1657709202335,MATH 193A,A02,083225,Rotar; Vladimir,9,0,34,25
1657709202335,MATH 193A,A03,083781,Rotar; Vladimir,5,0,34,29
1657709202335,MATH 193A,A04,083782,Rotar; Vladimir,10,0,34,24
1657709202335,MATH 193A,A05,093482,Rotar; Vladimir,10,0,34,24
1657709208360,MATH 197,001,091859,McAuley; Julian John,9999,0,9999,0
1657709208360,MATH 197,002,095566,Kedlaya; Kiran S.,9997,0,9999,2
1657709208360,MATH 197,003,095567,Xiao; Ming,9999,0,9999,0
1657709208360,MATH 197,004,095571,Perols; Johan Lars,9998,0,9999,1
1657709215445,COGS 9,A01,083615,Shannon; Kyle Michael,9,0,75,66
1657709221470,COGS 11,A01,083617,Boyle; Mary E. T.,23,0,48,25
1657709227494,COGS 13,A01,083071,Bastos; Amalia Pinkusfeld,11,0,71,60
1657709233520,COGS 14A,A01,092681,Semenuks; Arturs,5,1,100,95
1657709239550,COGS 14B,A01,083073,Cheng; Tzu-Han,6,0,63,57
1657709245577,COGS 17,A01,092677,Semenuks; Arturs,6,0,81,75
1657709251600,COGS 100,A01,083619,Allen; Michael Gordon,17,0,70,53
1657709257648,COGS 101A,A01,083621,Davis; Joshua Daniel,9,0,68,59
1657709263672,COGS 101B,A01,091572,Allen; Michael Gordon,12,0,65,53
1657709269698,COGS 101C,A01,083625,Delgado; Tania,17,0,35,18
1657709275727,COGS 107A,A01,083627,Boyle; Mary E. T.,13,0,60,47
1657709281756,COGS 118A,A01,083075,Gupta; Anjum,21,0,76,55
1657709287786,CSE 3,A50,083646,Miranda; Gregory Joseph,24,0,50,26
1657709293817,CSE 8A,A50,083650,Miranda; Gregory Joseph,17,1,56,39
1657709299842,CSE 11,A01,083080,Cao; Yingjun,6,15,40,34
1657709305871,CSE 12,A01,083652,Krause-Levy; Sophia Louisa,28,1,120,92
1657709311900,CSE 15L,A01,083654,Morris; Justin Loren,9,0,50,41
1657709311900,CSE 15L,A02,083655,Morris; Justin Loren,9,0,50,41
1657709318011,CSE 20,A01,083657,Tran; Khoa Dang,39,0,80,41
1657709324034,CSE 21,A01,095574,Bach; Quang Tran,22,0,48,26
1657709330060,CSE 30,A01,083084,Eldon; John,6,0,80,74
1657709330060,CSE 30,B01,095061,Bhaskar; Nishant,9,0,50,41
1657709336085,CSE 100,A01,083659,Cao; Yingjun,5,4,70,65
1657709342113,CSE 134B,A01,083661,Powell; Thomas Allan,23,0,100,77
1657709348141,CSE 140,A01,083663,Gungor; Onat,15,0,85,70
1657709354166,CSE 140L,A01,083088,Eldon; John,23,0,100,77
1657709360193,CSE 175,A01,083665,Kumar; Rakesh,3,0,25,22
1657709366218,CSE 190,A00,092507,Dubnov; Shlomo,8,0,20,12
1657709372243,ECE 45,A01,083139,Congero; Spencer William,6,0,75,69
1657709378267,ECE 65,A50,083695,Saad; Andrew S,12,0,30,18
1657709378267,ECE 65,A51,095125,Saad; Andrew S,24,0,26,2
1657709384294,ECE 109,A01,091882,Touri; Behrouz,20,0,70,50
1657709390323,ECE 180,A00,083140,Abi Samra; Nicholas Camill,1,0,30,29
1657709390323,ECE 180,B00,083141,Abi Samra; Nicholas Camill,0,0,30,30
1657709396348,MATH 10A,A01,083735,Patchell; Gregory David,2,0,30,28
1657709396348,MATH 10A,A02,083736,Patchell; Gregory David,20,0,30,10
1657709396348,MATH 10A,A03,083737,Patchell; Gregory David,16,0,30,14
1657709402373,MATH 10B,A01,083207,Lim; Seonhee,8,0,34,26
1657709402373,MATH 10B,A02,083208,Lim; Seonhee,9,0,35,26
1657709402373,MATH 10B,A03,093472,Lim; Seonhee,7,0,34,27
1657709402373,MATH 10B,B01,083739,Sinha; Shubham,13,0,30,17
1657709408399,MATH 18,A01,083743,Cinel; Cameron Alexander,8,0,30,22
1657709408399,MATH 18,A02,083744,Cinel; Cameron Alexander,17,0,30,13
1657709408399,MATH 18,A03,083745,Cinel; Cameron Alexander,10,0,30,20
1657709408399,MATH 18,B01,083748,Rideout; David Porter,5,0,37,32
1657709408399,MATH 18,B02,083749,Rideout; David Porter,5,0,36,31
1657709408399,MATH 18,B03,083750,Rideout; David Porter,3,0,37,34
1657709408399,MATH 18,B04,083751,Rideout; David Porter,6,0,36,30
1657709408399,MATH 18,B05,093473,Rideout; David Porter,6,0,36,30
1657709408399,MATH 18,B06,093474,Rideout; David Porter,6,0,36,30
1657709414426,MATH 20A,A01,083754,Zheng; Zequn,14,0,40,26
1657709420450,MATH 20B,A01,083756,Briones; Jor-el Thomas Caparas,4,0,36,32
1657709420450,MATH 20B,A02,083757,Briones; Jor-el Thomas Caparas,1,0,36,35
1657709420450,MATH 20B,A03,093475,Briones; Jor-el Thomas Caparas,2,0,36,34
1657709426475,MATH 20C,A01,083760,Briones; Jor-el Thomas Caparas,1,0,35,34
1657709426475,MATH 20C,A02,083761,Briones; Jor-el Thomas Caparas,8,0,35,27
1657709426475,MATH 20C,A03,093476,Briones; Jor-el Thomas Caparas,0,1,36,36
1657709426475,MATH 20C,B01,083762,Bach; Quang Tran,1,0,30,29
1657709432505,MATH 20D,A01,083765,Tran; Brian Kha,5,0,30,25
1657709432505,MATH 20D,A02,083766,Tran; Brian Kha,5,0,30,25
1657709432505,MATH 20D,A03,083767,Tran; Brian Kha,5,0,30,25
1657709438535,MATH 20E,A01,083771,Ganguly; Soumya,9,0,32,23
1657709438535,MATH 20E,A02,083772,Ganguly; Soumya,6,0,32,26
1657709438535,MATH 20E,B01,083773,Ciotti; Benjamin,20,0,35,15
1657709438535,MATH 20E,B02,083774,Ciotti; Benjamin,18,0,35,17
1657709444562,MATH 103A,A01,083777,Greenfeld; Be'Eri,3,0,36,33
1657709444562,MATH 103A,A02,083778,Greenfeld; Be'Eri,5,0,36,31
1657709444562,MATH 103A,A03,093561,Greenfeld; Be'Eri,6,0,36,30
1657709444562,MATH 103A,B01,083779,Greenfeld; Be'Eri,7,0,36,29
1657709444562,MATH 103A,B02,083780,Greenfeld; Be'Eri,4,0,36,32
1657709444562,MATH 103A,B03,093562,Greenfeld; Be'Eri,3,0,36,33
1657709450594,MATH 105,A01,085443,Carter; Anne Toulson,15,0,35,20
1657709450594,MATH 105,A02,093477,Carter; Anne Toulson,20,0,35,15
1657709456619,MATH 109,A01,083213,Ganzberger; Geoffrey Michael,2,0,34,32
1657709456619,MATH 109,A02,083214,Ganzberger; Geoffrey Michael,4,0,34,30
1657709456619,MATH 109,A03,093478,Ganzberger; Geoffrey Michael,2,0,34,32
1657709456619,MATH 109,B01,083215,Ganzberger; Geoffrey Michael,1,0,32,31
1657709456619,MATH 109,B02,083216,Ganzberger; Geoffrey Michael,2,0,32,30
1657709456619,MATH 109,B03,093479,Ganzberger; Geoffrey Michael,8,0,32,24
1657709462644,MATH 142A,A01,083219,Chow; Bennett,7,0,32,25
1657709462644,MATH 142A,A02,083220,Chow; Bennett,10,0,32,22
1657709462644,MATH 142A,A03,093480,Chow; Bennett,9,0,32,23
1657709462644,MATH 142A,B03,093481,Chow; Bennett,8,0,32,24
1657709462644,MATH 142A,B04,093558,Chow; Bennett,13,0,32,19
1657709462644,MATH 142A,B05,093559,Chow; Bennett,6,0,32,26
1657709468674,MATH 193A,A01,083224,Rotar; Vladimir,8,0,34,26
1657709468674,MATH 193A,A02,083225,Rotar; Vladimir,9,0,34,25
1657709468674,MATH 193A,A03,083781,Rotar; Vladimir,5,0,34,29
1657709468674,MATH 193A,A04,083782,Rotar; Vladimir,10,0,34,24
1657709468674,MATH 193A,A05,093482,Rotar; Vladimir,10,0,34,24
1657709474703,MATH 197,001,091859,McAuley; Julian John,9999,0,9999,0
1657709474703,MATH 197,002,095566,Kedlaya; Kiran S.,9997,0,9999,2
1657709474703,MATH 197,003,095567,Xiao; Ming,9999,0,9999,0
1657709474703,MATH 197,004,095571,Perols; Johan Lars,9998,0,9999,1
1657709481766,COGS 9,A01,083615,Shannon; Kyle Michael,9,0,75,66
1657709487795,COGS 11,A01,083617,Boyle; Mary E. T.,23,0,48,25
1657709493818,COGS 13,A01,083071,Bastos; Amalia Pinkusfeld,11,0,71,60
1657709499847,COGS 14A,A01,092681,Semenuks; Arturs,5,1,100,95
1657709505871,COGS 14B,A01,083073,Cheng; Tzu-Han,6,0,63,57
1657709511895,COGS 17,A01,092677,Semenuks; Arturs,6,0,81,75
1657709517926,COGS 100,A01,083619,Allen; Michael Gordon,17,0,70,53
1657709523950,COGS 101A,A01,083621,Davis; Joshua Daniel,9,0,68,59
1657709529977,COGS 101B,A01,091572,Allen; Michael Gordon,12,0,65,53
1657709536006,COGS 101C,A01,083625,Delgado; Tania,17,0,35,18
1657709542033,COGS 107A,A01,083627,Boyle; Mary E. T.,13,0,60,47
1657709548057,COGS 118A,A01,083075,Gupta; Anjum,21,0,76,55
1657709554085,CSE 3,A50,083646,Miranda; Gregory Joseph,24,0,50,26
1657709560121,CSE 8A,A50,083650,Miranda; Gregory Joseph,17,1,56,39
1657709566149,CSE 11,A01,083080,Cao; Yingjun,6,15,40,34
1657709572173,CSE 12,A01,083652,Krause-Levy; Sophia Louisa,28,1,120,92
1657709578198,CSE 15L,A01,083654,Morris; Justin Loren,9,0,50,41
1657709578198,CSE 15L,A02,083655,Morris; Justin Loren,9,0,50,41
1657709584222,CSE 20,A01,083657,Tran; Khoa Dang,39,0,80,41
1657709590251,CSE 21,A01,095574,Bach; Quang Tran,22,0,48,26
1657709596282,CSE 30,A01,083084,Eldon; John,6,0,80,74
1657709596282,CSE 30,B01,095061,Bhaskar; Nishant,9,0,50,41
1657709602307,CSE 100,A01,083659,Cao; Yingjun,5,4,70,65
1657709608332,CSE 134B,A01,083661,Powell; Thomas Allan,23,0,100,77
1657709614357,CSE 140,A01,083663,Gungor; Onat,15,0,85,70
1657709620386,CSE 140L,A01,083088,Eldon; John,23,0,100,77
1657709626410,CSE 175,A01,083665,Kumar; Rakesh,3,0,25,22
1657709632433,CSE 190,A00,092507,Dubnov; Shlomo,8,0,20,12
1657709638459,ECE 45,A01,083139,Congero; Spencer William,6,0,75,69
1657709644489,ECE 65,A50,083695,Saad; Andrew S,12,0,30,18
1657709644489,ECE 65,A51,095125,Saad; Andrew S,24,0,26,2
1657709650519,ECE 109,A01,091882,Touri; Behrouz,20,0,70,50
1657709656544,ECE 180,A00,083140,Abi Samra; Nicholas Camill,1,0,30,29
1657709656544,ECE 180,B00,083141,Abi Samra; Nicholas Camill,0,0,30,30
1657709662573,MATH 10A,A01,083735,Patchell; Gregory David,2,0,30,28
1657709662573,MATH 10A,A02,083736,Patchell; Gregory David,20,0,30,10
1657709662573,MATH 10A,A03,083737,Patchell; Gregory David,16,0,30,14
1657709668609,MATH 10B,A01,083207,Lim; Seonhee,8,0,34,26
1657709668609,MATH 10B,A02,083208,Lim; Seonhee,9,0,35,26
1657709668609,MATH 10B,A03,093472,Lim; Seonhee,7,0,34,27
1657709668609,MATH 10B,B01,083739,Sinha; Shubham,13,0,30,17
1657709674636,MATH 18,A01,083743,Cinel; Cameron Alexander,8,0,30,22
1657709674636,MATH 18,A02,083744,Cinel; Cameron Alexander,17,0,30,13
1657709674636,MATH 18,A03,083745,Cinel; Cameron Alexander,10,0,30,20
1657709674636,MATH 18,B01,083748,Rideout; David Porter,5,0,37,32
1657709674636,MATH 18,B02,083749,Rideout; David Porter,5,0,36,31
1657709674636,MATH 18,B03,083750,Rideout; David Porter,3,0,37,34
1657709674636,MATH 18,B04,083751,Rideout; David Porter,6,0,36,30
1657709674636,MATH 18,B05,093473,Rideout; David Porter,6,0,36,30
1657709674636,MATH 18,B06,093474,Rideout; David Porter,6,0,36,30
1657709680660,MATH 20A,A01,083754,Zheng; Zequn,14,0,40,26
1657709686683,MATH 20B,A01,083756,Briones; Jor-el Thomas Caparas,4,0,36,32
1657709686683,MATH 20B,A02,083757,Briones; Jor-el Thomas Caparas,1,0,36,35
1657709686683,MATH 20B,A03,093475,Briones; Jor-el Thomas Caparas,2,0,36,34
1657709692713,MATH 20C,A01,083760,Briones; Jor-el Thomas Caparas,1,0,35,34
1657709692713,MATH 20C,A02,083761,Briones; Jor-el Thomas Caparas,8,0,35,27
1657709692713,MATH 20C,A03,093476,Briones; Jor-el Thomas Caparas,0,1,36,36
1657709692713,MATH 20C,B01,083762,Bach; Quang Tran,1,0,30,29
1657709698742,MATH 20D,A01,083765,Tran; Brian Kha,5,0,30,25
1657709698742,MATH 20D,A02,083766,Tran; Brian Kha,5,0,30,25
1657709698742,MATH 20D,A03,083767,Tran; Brian Kha,5,0,30,25
1657709704776,MATH 20E,A01,083771,Ganguly; Soumya,9,0,32,23
1657709704776,MATH 20E,A02,083772,Ganguly; Soumya,6,0,32,26
1657709704776,MATH 20E,B01,083773,Ciotti; Benjamin,20,0,35,15
1657709704776,MATH 20E,B02,083774,Ciotti; Benjamin,18,0,35,17
1657709710811,MATH 103A,A01,083777,Greenfeld; Be'Eri,3,0,36,33
1657709710811,MATH 103A,A02,083778,Greenfeld; Be'Eri,5,0,36,31
1657709710811,MATH 103A,A03,093561,Greenfeld; Be'Eri,6,0,36,30
1657709710811,MATH 103A,B01,083779,Greenfeld; Be'Eri,7,0,36,29
1657709710811,MATH 103A,B02,083780,Greenfeld; Be'Eri,4,0,36,32
1657709710811,MATH 103A,B03,093562,Greenfeld; Be'Eri,3,0,36,33
1657709716840,MATH 105,A01,085443,Carter; Anne Toulson,15,0,35,20
1657709716840,MATH 105,A02,093477,Carter; Anne Toulson,20,0,35,15
1657709722867,MATH 109,A01,083213,Ganzberger; Geoffrey Michael,2,0,34,32
1657709722867,MATH 109,A02,083214,Ganzberger; Geoffrey Michael,4,0,34,30
1657709722867,MATH 109,A03,093478,Ganzberger; Geoffrey Michael,2,0,34,32
1657709722867,MATH 109,B01,083215,Ganzberger; Geoffrey Michael,1,0,32,31
1657709722867,MATH 109,B02,083216,Ganzberger; Geoffrey Michael,2,0,32,30
1657709722867,MATH 109,B03,093479,Ganzberger; Geoffrey Michael,8,0,32,24
1657709728901,MATH 142A,A01,083219,Chow; Bennett,7,0,32,25
1657709728901,MATH 142A,A02,083220,Chow; Bennett,10,0,32,22
1657709728901,MATH 142A,A03,093480,Chow; Bennett,9,0,32,23
1657709728901,MATH 142A,B03,093481,Chow; Bennett,8,0,32,24
1657709728901,MATH 142A,B04,093558,Chow; Bennett,13,0,32,19
1657709728901,MATH 142A,B05,093559,Chow; Bennett,6,0,32,26
1657709734925,MATH 193A,A01,083224,Rotar; Vladimir,8,0,34,26
1657709734925,MATH 193A,A02,083225,Rotar; Vladimir,9,0,34,25
1657709734925,MATH 193A,A03,083781,Rotar; Vladimir,5,0,34,29
1657709734925,MATH 193A,A04,083782,Rotar; Vladimir,10,0,34,24
1657709734925,MATH 193A,A05,093482,Rotar; Vladimir,10,0,34,24
1657709740956,MATH 197,001,091859,McAuley; Julian John,9999,0,9999,0
1657709740956,MATH 197,002,095566,Kedlaya; Kiran S.,9997,0,9999,2
1657709740956,MATH 197,003,095567,Xiao; Ming,9999,0,9999,0
1657709740956,MATH 197,004,095571,Perols; Johan Lars,9998,0,9999,1
1657709748027,COGS 9,A01,083615,Shannon; Kyle Michael,9,0,75,66
1657709754055,COGS 11,A01,083617,Boyle; Mary E. T.,23,0,48,25
1657709760085,COGS 13,A01,083071,Bastos; Amalia Pinkusfeld,11,0,71,60
1657709766109,COGS 14A,A01,092681,Semenuks; Arturs,5,1,100,95
1657709772136,COGS 14B,A01,083073,Cheng; Tzu-Han,6,0,63,57
1657709778163,COGS 17,A01,092677,Semenuks; Arturs,6,0,81,75
1657709784189,COGS 100,A01,083619,Allen; Michael Gordon,17,0,70,53
1657709790213,COGS 101A,A01,083621,Davis; Joshua Daniel,9,0,68,59
1657709796237,COGS 101B,A01,091572,Allen; Michael Gordon,12,0,65,53
1657709802260,COGS 101C,A01,083625,Delgado; Tania,17,0,35,18
1657709808283,COGS 107A,A01,083627,Boyle; Mary E. T.,13,0,60,47
1657709814311,COGS 118A,A01,083075,Gupta; Anjum,21,0,76,55
1657709820347,CSE 3,A50,083646,Miranda; Gregory Joseph,24,0,50,26
1657709826371,CSE 8A,A50,083650,Miranda; Gregory Joseph,17,1,56,39
1657709832394,CSE 11,A01,083080,Cao; Yingjun,6,15,40,34
1657709838422,CSE 12,A01,083652,Krause-Levy; Sophia Louisa,28,1,120,92
1657709844451,CSE 15L,A01,083654,Morris; Justin Loren,9,0,50,41
1657709844451,CSE 15L,A02,083655,Morris; Justin Loren,9,0,50,41
1657709850480,CSE 20,A01,083657,Tran; Khoa Dang,39,0,80,41
1657709856510,CSE 21,A01,095574,Bach; Quang Tran,22,0,48,26
1657709862538,CSE 30,A01,083084,Eldon; John,6,0,80,74
1657709862538,CSE 30,B01,095061,Bhaskar; Nishant,9,0,50,41
1657709868561,CSE 100,A01,083659,Cao; Yingjun,5,4,70,65
1657709874584,CSE 134B,A01,083661,Powell; Thomas Allan,23,0,100,77
1657709880615,CSE 140,A01,083663,Gungor; Onat,15,0,85,70
1657709886644,CSE 140L,A01,083088,Eldon; John,23,0,100,77
1657709892672,CSE 175,A01,083665,Kumar; Rakesh,3,0,25,22
1657709898696,CSE 190,A00,092507,Dubnov; Shlomo,8,0,20,12
1657709904738,ECE 45,A01,083139,Congero; Spencer William,6,0,75,69
1657709910769,ECE 65,A50,083695,Saad; Andrew S,12,0,30,18
1657709910769,ECE 65,A51,095125,Saad; Andrew S,24,0,26,2
1657709916869,ECE 109,A01,091882,Touri; Behrouz,20,0,70,50
1657709922893,ECE 180,A00,083140,Abi Samra; Nicholas Camill,1,0,30,29
1657709922893,ECE 180,B00,083141,Abi Samra; Nicholas Camill,0,0,30,30
1657709928924,MATH 10A,A01,083735,Patchell; Gregory David,2,0,30,28
1657709928924,MATH 10A,A02,083736,Patchell; Gregory David,20,0,30,10
1657709928924,MATH 10A,A03,083737,Patchell; Gregory David,16,0,30,14
1657709934950,MATH 10B,A01,083207,Lim; Seonhee,8,0,34,26
1657709934950,MATH 10B,A02,083208,Lim; Seonhee,9,0,35,26
1657709934950,MATH 10B,A03,093472,Lim; Seonhee,7,0,34,27
1657709934950,MATH 10B,B01,083739,Sinha; Shubham,13,0,30,17
1657709940977,MATH 18,A01,083743,Cinel; Cameron Alexander,8,0,30,22
1657709940977,MATH 18,A02,083744,Cinel; Cameron Alexander,17,0,30,13
1657709940977,MATH 18,A03,083745,Cinel; Cameron Alexander,10,0,30,20
1657709940977,MATH 18,B01,083748,Rideout; David Porter,5,0,37,32
1657709940977,MATH 18,B02,083749,Rideout; David Porter,5,0,36,31
1657709940977,MATH 18,B03,083750,Rideout; David Porter,3,0,37,34
1657709940977,MATH 18,B04,083751,Rideout; David Porter,6,0,36,30
1657709940977,MATH 18,B05,093473,Rideout; David Porter,6,0,36,30
1657709940977,MATH 18,B06,093474,Rideout; David Porter,6,0,36,30
1657709947001,MATH 20A,A01,083754,Zheng; Zequn,14,0,40,26
1657709953030,MATH 20B,A01,083756,Briones; Jor-el Thomas Caparas,4,0,36,32
1657709953030,MATH 20B,A02,083757,Briones; Jor-el Thomas Caparas,1,0,36,35
1657709953030,MATH 20B,A03,093475,Briones; Jor-el Thomas Caparas,2,0,36,34
1657709959055,MATH 20C,A01,083760,Briones; Jor-el Thomas Caparas,1,0,35,34
1657709959055,MATH 20C,A02,083761,Briones; Jor-el Thomas Caparas,8,0,35,27
1657709959055,MATH 20C,A03,093476,Briones; Jor-el Thomas Caparas,0,1,36,36
1657709959055,MATH 20C,B01,083762,Bach; Quang Tran,1,0,30,29
1657709965085,MATH 20D,A01,083765,Tran; Brian Kha,5,0,30,25
1657709965085,MATH 20D,A02,083766,Tran; Brian Kha,5,0,30,25
1657709965085,MATH 20D,A03,083767,Tran; Brian Kha,5,0,30,25
1657709971120,MATH 20E,A01,083771,Ganguly; Soumya,9,0,32,23
1657709971120,MATH 20E,A02,083772,Ganguly; Soumya,6,0,32,26
1657709971120,MATH 20E,B01,083773,Ciotti; Benjamin,20,0,35,15
1657709971120,MATH 20E,B02,083774,Ciotti; Benjamin,18,0,35,17
1657709977145,MATH 103A,A01,083777,Greenfeld; Be'Eri,3,0,36,33
1657709977145,MATH 103A,A02,083778,Greenfeld; Be'Eri,5,0,36,31
1657709977145,MATH 103A,A03,093561,Greenfeld; Be'Eri,6,0,36,30
1657709977145,MATH 103A,B01,083779,Greenfeld; Be'Eri,7,0,36,29
1657709977145,MATH 103A,B02,083780,Greenfeld; Be'Eri,4,0,36,32
1657709977145,MATH 103A,B03,093562,Greenfeld; Be'Eri,3,0,36,33
1657709983176,MATH 105,A01,085443,Carter; Anne Toulson,15,0,35,20
1657709983176,MATH 105,A02,093477,Carter; Anne Toulson,20,0,35,15
1657709989201,MATH 109,A01,083213,Ganzberger; Geoffrey Michael,2,0,34,32
1657709989201,MATH 109,A02,083214,Ganzberger; Geoffrey Michael,4,0,34,30
1657709989201,MATH 109,A03,093478,Ganzberger; Geoffrey Michael,2,0,34,32
1657709989201,MATH 109,B01,083215,Ganzberger; Geoffrey Michael,1,0,32,31
1657709989201,MATH 109,B02,083216,Ganzberger; Geoffrey Michael,2,0,32,30
1657709989201,MATH 109,B03,093479,Ganzberger; Geoffrey Michael,8,0,32,24
1657709995227,MATH 142A,A01,083219,Chow; Bennett,7,0,32,25
1657709995227,MATH 142A,A02,083220,Chow; Bennett,10,0,32,22
1657709995227,MATH 142A,A03,093480,Chow; Bennett,9,0,32,23
1657709995227,MATH 142A,B03,093481,Chow; Bennett,8,0,32,24
1657709995227,MATH 142A,B04,093558,Chow; Bennett,13,0,32,19
1657709995227,MATH 142A,B05,093559,Chow; Bennett,6,0,32,26
1657710001251,MATH 193A,A01,083224,Rotar; Vladimir,8,0,34,26
1657710001251,MATH 193A,A02,083225,Rotar; Vladimir,9,0,34,25
1657710001251,MATH 193A,A03,083781,Rotar; Vladimir,5,0,34,29
1657710001251,MATH 193A,A04,083782,Rotar; Vladimir,10,0,34,24
1657710001251,MATH 193A,A05,093482,Rotar; Vladimir,10,0,34,24
1657710007277,MATH 197,001,091859,McAuley; Julian John,9999,0,9999,0
1657710007277,MATH 197,002,095566,Kedlaya; Kiran S.,9997,0,9999,2
1657710007277,MATH 197,003,095567,Xiao; Ming,9999,0,9999,0
1657710007277,MATH 197,004,095571,Perols; Johan Lars,9998,0,9999,1
1657710014341,COGS 9,A01,083615,Shannon; Kyle Michael,9,0,75,66
1657710020370,COGS 11,A01,083617,Boyle; Mary E. T.,23,0,48,25
1657710026395,COGS 13,A01,083071,Bastos; Amalia Pinkusfeld,11,0,71,60
1657710032421,COGS 14A,A01,092681,Semenuks; Arturs,5,1,100,95
1657710038449,COGS 14B,A01,083073,Cheng; Tzu-Han,6,0,63,57
1657710044477,COGS 17,A01,092677,Semenuks; Arturs,6,0,81,75
1657710050504,COGS 100,A01,083619,Allen; Michael Gordon,17,0,70,53
1657710056527,COGS 101A,A01,083621,Davis; Joshua Daniel,9,0,68,59
1657710062551,COGS 101B,A01,091572,Allen; Michael Gordon,12,0,65,53
1657710068581,COGS 101C,A01,083625,Delgado; Tania,17,0,35,18
1657710074613,COGS 107A,A01,083627,Boyle; Mary E. T.,13,0,60,47
1657710080636,COGS 118A,A01,083075,Gupta; Anjum,21,0,76,55
1657710086664,CSE 3,A50,083646,Miranda; Gregory Joseph,24,0,50,26
1657710092692,CSE 8A,A50,083650,Miranda; Gregory Joseph,17,1,56,39
1657710098716,CSE 11,A01,083080,Cao; Yingjun,6,15,40,34
1657710104744,CSE 12,A01,083652,Krause-Levy; Sophia Louisa,28,1,120,92
1657710110767,CSE 15L,A01,083654,Morris; Justin Loren,9,0,50,41
1657710110767,CSE 15L,A02,083655,Morris; Justin Loren,9,0,50,41
1657710116795,CSE 20,A01,083657,Tran; Khoa Dang,39,0,80,41
1657710122819,CSE 21,A01,095574,Bach; Quang Tran,22,0,48,26
1657710128861,CSE 30,A01,083084,Eldon; John,6,0,80,74
1657710128861,CSE 30,B01,095061,Bhaskar; Nishant,9,0,50,41
1657710134886,CSE 100,A01,083659,Cao; Yingjun,5,4,70,65
1657710140909,CSE 134B,A01,083661,Powell; Thomas Allan,23,0,100,77
1657710146935,CSE 140,A01,083663,Gungor; Onat,15,0,85,70
1657710152962,CSE 140L,A01,083088,Eldon; John,23,0,100,77
1657710158992,CSE 175,A01,083665,Kumar; Rakesh,3,0,25,22
1657710165032,CSE 190,A00,092507,Dubnov; Shlomo,8,0,20,12
1657710171054,ECE 45,A01,083139,Congero; Spencer William,6,0,75,69
1657710177080,ECE 65,A50,083695,Saad; Andrew S,12,0,30,18
1657710177080,ECE 65,A51,095125,Saad; Andrew S,24,0,26,2
1657710183112,ECE 109,A01,091882,Touri; Behrouz,20,0,70,50
1657710189135,ECE 180,A00,083140,Abi Samra; Nicholas Camill,1,0,30,29
1657710189135,ECE 180,B00,083141,Abi Samra; Nicholas Camill,0,0,30,30
1657710195252,MATH 10A,A01,083735,Patchell; Gregory David,2,0,30,28
1657710195252,MATH 10A,A02,083736,Patchell; Gregory David,20,0,30,10
1657710195252,MATH 10A,A03,083737,Patchell; Gregory David,16,0,30,14
1657710201283,MATH 10B,A01,083207,Lim; Seonhee,8,0,34,26
1657710201283,MATH 10B,A02,083208,Lim; Seonhee,9,0,35,26
1657710201283,MATH 10B,A03,093472,Lim; Seonhee,7,0,34,27
1657710201283,MATH 10B,B01,083739,Sinha; Shubham,13,0,30,17
1657710207331,MATH 18,A01,083743,Cinel; Cameron Alexander,8,0,30,22
1657710207331,MATH 18,A02,083744,Cinel; Cameron Alexander,17,0,30,13
1657710207331,MATH 18,A03,083745,Cinel; Cameron Alexander,10,0,30,20
1657710207331,MATH 18,B01,083748,Rideout; David Porter,5,0,37,32
1657710207331,MATH 18,B02,083749,Rideout; David Porter,5,0,36,31
1657710207331,MATH 18,B03,083750,Rideout; David Porter,3,0,37,34
1657710207331,MATH 18,B04,083751,Rideout; David Porter,6,0,36,30
1657710207331,MATH 18,B05,093473,Rideout; David Porter,6,0,36,30
1657710207331,MATH 18,B06,093474,Rideout; David Porter,6,0,36,30
1657710213360,MATH 20A,A01,083754,Zheng; Zequn,14,0,40,26
